MittausID;Pvm;Vuosi;Kuukausi;Tunti;Viikonpäivä;PP_1;PP_2;PP_YHT;JK_1;JK_2;JK_YHT
294;02.11.2015;2015;11;00;Maanantai;0;0;0;0;0;0
294;02.11.2015;2015;11;01;Maanantai;0;0;0;0;0;0
294;02.11.2015;2015;11;02;Maanantai;0;0;0;0;0;0
294;02.11.2015;2015;11;03;Maanantai;0;0;0;0;0;0
294;02.11.2015;2015;11;04;Maanantai;0;0;0;0;0;0
294;02.11.2015;2015;11;05;Maanantai;0;0;0;0;2;2
294;02.11.2015;2015;11;06;Maanantai;3;3;6;2;2;4
294;02.11.2015;2015;11;07;Maanantai;16;10;26;7;6;13
294;02.11.2015;2015;11;08;Maanantai;21;9;30;5;8;13
294;02.11.2015;2015;11;09;Maanantai;8;11;19;17;11;28
294;02.11.2015;2015;11;10;Maanantai;13;5;18;8;6;14
294;02.11.2015;2015;11;11;Maanantai;11;8;19;25;17;42
294;02.11.2015;2015;11;12;Maanantai;11;14;25;21;14;35
294;02.11.2015;2015;11;13;Maanantai;18;20;38;8;9;17
294;02.11.2015;2015;11;14;Maanantai;14;19;33;22;15;37
294;02.11.2015;2015;11;15;Maanantai;25;21;46;16;12;28
294;02.11.2015;2015;11;16;Maanantai;19;23;42;13;17;30
294;02.11.2015;2015;11;17;Maanantai;16;15;31;13;13;26
294;02.11.2015;2015;11;18;Maanantai;14;11;25;19;22;41
294;02.11.2015;2015;11;19;Maanantai;13;11;24;25;16;41
294;02.11.2015;2015;11;20;Maanantai;8;7;15;7;4;11
294;02.11.2015;2015;11;21;Maanantai;0;2;2;0;4;4
294;02.11.2015;2015;11;22;Maanantai;0;2;2;0;0;0
294;02.11.2015;2015;11;23;Maanantai;2;0;2;0;1;1
294;03.11.2015;2015;11;00;Tiistai;0;0;0;0;0;0
294;03.11.2015;2015;11;01;Tiistai;0;0;0;0;0;0
294;03.11.2015;2015;11;02;Tiistai;0;1;1;0;0;0
294;03.11.2015;2015;11;03;Tiistai;0;0;0;0;0;0
294;03.11.2015;2015;11;04;Tiistai;0;0;0;0;0;0
294;03.11.2015;2015;11;05;Tiistai;0;0;0;0;0;0
294;03.11.2015;2015;11;06;Tiistai;4;2;6;5;2;7
294;03.11.2015;2015;11;07;Tiistai;15;8;23;1;8;9
294;03.11.2015;2015;11;08;Tiistai;16;5;21;14;5;19
294;03.11.2015;2015;11;09;Tiistai;20;5;25;9;16;25
294;03.11.2015;2015;11;10;Tiistai;4;14;18;17;13;30
294;03.11.2015;2015;11;11;Tiistai;5;12;17;10;22;32
294;03.11.2015;2015;11;12;Tiistai;11;12;23;17;26;43
294;03.11.2015;2015;11;13;Tiistai;12;21;33;22;14;36
294;03.11.2015;2015;11;14;Tiistai;11;19;30;7;14;21
294;03.11.2015;2015;11;15;Tiistai;27;24;51;13;15;28
294;03.11.2015;2015;11;16;Tiistai;15;20;35;12;9;21
294;03.11.2015;2015;11;17;Tiistai;18;6;24;7;5;12
294;03.11.2015;2015;11;18;Tiistai;14;11;25;20;15;35
294;03.11.2015;2015;11;19;Tiistai;3;13;16;11;10;21
294;03.11.2015;2015;11;20;Tiistai;1;3;4;4;8;12
294;03.11.2015;2015;11;21;Tiistai;1;3;4;0;1;1
294;03.11.2015;2015;11;22;Tiistai;0;1;1;2;1;3
294;03.11.2015;2015;11;23;Tiistai;0;0;0;0;0;0
294;04.11.2015;2015;11;00;Keskiviikko;0;0;0;0;0;0
294;04.11.2015;2015;11;01;Keskiviikko;0;0;0;0;0;0
294;04.11.2015;2015;11;02;Keskiviikko;0;0;0;0;0;0
294;04.11.2015;2015;11;03;Keskiviikko;0;0;0;0;0;0
294;04.11.2015;2015;11;04;Keskiviikko;0;0;0;0;0;0
294;04.11.2015;2015;11;05;Keskiviikko;0;0;0;0;0;0
294;04.11.2015;2015;11;06;Keskiviikko;3;1;4;2;2;4
294;04.11.2015;2015;11;07;Keskiviikko;25;14;39;6;6;12
294;04.11.2015;2015;11;08;Keskiviikko;22;5;27;13;5;18
294;04.11.2015;2015;11;09;Keskiviikko;8;12;20;11;17;28
294;04.11.2015;2015;11;10;Keskiviikko;12;8;20;9;17;26
294;04.11.2015;2015;11;11;Keskiviikko;12;6;18;24;18;42
294;04.11.2015;2015;11;12;Keskiviikko;8;11;19;11;18;29
294;04.11.2015;2015;11;13;Keskiviikko;10;12;22;12;7;19
294;04.11.2015;2015;11;14;Keskiviikko;17;29;46;12;19;31
294;04.11.2015;2015;11;15;Keskiviikko;28;38;66;16;19;35
294;04.11.2015;2015;11;16;Keskiviikko;14;17;31;8;13;21
294;04.11.2015;2015;11;17;Keskiviikko;11;10;21;17;14;31
294;04.11.2015;2015;11;18;Keskiviikko;17;14;31;23;24;47
294;04.11.2015;2015;11;19;Keskiviikko;7;6;13;7;17;24
294;04.11.2015;2015;11;20;Keskiviikko;3;6;9;5;6;11
294;04.11.2015;2015;11;21;Keskiviikko;1;4;5;2;0;2
294;04.11.2015;2015;11;22;Keskiviikko;0;1;1;2;0;2
294;04.11.2015;2015;11;23;Keskiviikko;0;0;0;0;0;0
294;05.11.2015;2015;11;00;Torstai;0;0;0;0;0;0
294;05.11.2015;2015;11;01;Torstai;0;0;0;0;1;1
294;05.11.2015;2015;11;02;Torstai;0;0;0;0;0;0
294;05.11.2015;2015;11;03;Torstai;0;0;0;1;0;1
294;05.11.2015;2015;11;04;Torstai;0;0;0;0;0;0
294;05.11.2015;2015;11;05;Torstai;0;0;0;0;0;0
294;05.11.2015;2015;11;06;Torstai;3;2;5;2;4;6
294;05.11.2015;2015;11;07;Torstai;10;4;14;8;2;10
294;05.11.2015;2015;11;08;Torstai;23;5;28;9;8;17
294;05.11.2015;2015;11;09;Torstai;15;5;20;13;9;22
294;05.11.2015;2015;11;10;Torstai;8;4;12;6;9;15
294;05.11.2015;2015;11;11;Torstai;5;9;14;29;22;51
294;05.11.2015;2015;11;12;Torstai;7;13;20;7;16;23
294;05.11.2015;2015;11;13;Torstai;13;13;26;17;15;32
294;05.11.2015;2015;11;14;Torstai;17;17;34;16;12;28
294;05.11.2015;2015;11;15;Torstai;15;23;38;5;11;16
294;05.11.2015;2015;11;16;Torstai;21;19;40;12;9;21
294;05.11.2015;2015;11;17;Torstai;12;10;22;14;8;22
294;05.11.2015;2015;11;18;Torstai;9;16;25;15;12;27
294;05.11.2015;2015;11;19;Torstai;4;8;12;14;10;24
294;05.11.2015;2015;11;20;Torstai;4;3;7;7;10;17
294;05.11.2015;2015;11;21;Torstai;2;0;2;1;3;4
294;05.11.2015;2015;11;22;Torstai;0;0;0;2;1;3
294;05.11.2015;2015;11;23;Torstai;1;0;1;0;1;1
294;06.11.2015;2015;11;00;Perjantai;0;0;0;1;0;1
294;06.11.2015;2015;11;01;Perjantai;0;0;0;0;0;0
294;06.11.2015;2015;11;02;Perjantai;0;0;0;0;0;0
294;06.11.2015;2015;11;03;Perjantai;0;0;0;0;0;0
294;06.11.2015;2015;11;04;Perjantai;0;0;0;0;0;0
294;06.11.2015;2015;11;05;Perjantai;0;0;0;0;0;0
294;06.11.2015;2015;11;06;Perjantai;2;2;4;2;3;5
294;06.11.2015;2015;11;07;Perjantai;3;1;4;4;5;9
294;06.11.2015;2015;11;08;Perjantai;12;5;17;7;7;14
294;06.11.2015;2015;11;09;Perjantai;25;17;42;11;14;25
294;06.11.2015;2015;11;10;Perjantai;11;9;20;9;12;21
294;06.11.2015;2015;11;11;Perjantai;16;9;25;14;11;25
294;06.11.2015;2015;11;12;Perjantai;8;11;19;10;12;22
294;06.11.2015;2015;11;13;Perjantai;18;20;38;11;12;23
294;06.11.2015;2015;11;14;Perjantai;13;29;42;15;15;30
294;06.11.2015;2015;11;15;Perjantai;15;20;35;10;14;24
294;06.11.2015;2015;11;16;Perjantai;17;26;43;10;9;19
294;06.11.2015;2015;11;17;Perjantai;12;12;24;7;7;14
294;06.11.2015;2015;11;18;Perjantai;2;3;5;17;5;22
294;06.11.2015;2015;11;19;Perjantai;2;4;6;12;8;20
294;06.11.2015;2015;11;20;Perjantai;8;5;13;3;2;5
294;06.11.2015;2015;11;21;Perjantai;3;4;7;0;0;0
294;06.11.2015;2015;11;22;Perjantai;6;6;12;1;1;2
294;06.11.2015;2015;11;23;Perjantai;0;1;1;0;0;0
294;07.11.2015;2015;11;00;Lauantai;1;0;1;1;0;1
294;07.11.2015;2015;11;01;Lauantai;0;0;0;0;0;0
294;07.11.2015;2015;11;02;Lauantai;0;0;0;0;2;2
294;07.11.2015;2015;11;03;Lauantai;0;0;0;1;0;1
294;07.11.2015;2015;11;04;Lauantai;0;0;0;0;0;0
294;07.11.2015;2015;11;05;Lauantai;0;0;0;0;0;0
294;07.11.2015;2015;11;06;Lauantai;1;1;2;0;1;1
294;07.11.2015;2015;11;07;Lauantai;0;0;0;2;3;5
294;07.11.2015;2015;11;08;Lauantai;0;1;1;1;3;4
294;07.11.2015;2015;11;09;Lauantai;6;7;13;7;11;18
294;07.11.2015;2015;11;10;Lauantai;9;9;18;9;13;22
294;07.11.2015;2015;11;11;Lauantai;2;8;10;1;8;9
294;07.11.2015;2015;11;12;Lauantai;4;10;14;10;9;19
294;07.11.2015;2015;11;13;Lauantai;9;5;14;9;3;12
294;07.11.2015;2015;11;14;Lauantai;10;9;19;5;6;11
294;07.11.2015;2015;11;15;Lauantai;4;5;9;10;7;17
294;07.11.2015;2015;11;16;Lauantai;3;6;9;8;13;21
294;07.11.2015;2015;11;17;Lauantai;5;2;7;11;2;13
294;07.11.2015;2015;11;18;Lauantai;8;1;9;7;9;16
294;07.11.2015;2015;11;19;Lauantai;1;7;8;5;3;8
294;07.11.2015;2015;11;20;Lauantai;7;7;14;7;6;13
294;07.11.2015;2015;11;21;Lauantai;2;0;2;1;1;2
294;07.11.2015;2015;11;22;Lauantai;2;0;2;1;3;4
294;07.11.2015;2015;11;23;Lauantai;2;2;4;0;1;1
294;08.11.2015;2015;11;00;Sunnuntai;0;0;0;1;1;2
294;08.11.2015;2015;11;01;Sunnuntai;0;0;0;0;0;0
294;08.11.2015;2015;11;02;Sunnuntai;0;0;0;0;2;2
294;08.11.2015;2015;11;03;Sunnuntai;0;0;0;0;0;0
294;08.11.2015;2015;11;04;Sunnuntai;0;0;0;0;0;0
294;08.11.2015;2015;11;05;Sunnuntai;0;0;0;0;0;0
294;08.11.2015;2015;11;06;Sunnuntai;1;0;1;0;1;1
294;08.11.2015;2015;11;07;Sunnuntai;0;0;0;0;2;2
294;08.11.2015;2015;11;08;Sunnuntai;2;3;5;3;4;7
294;08.11.2015;2015;11;09;Sunnuntai;3;6;9;4;5;9
294;08.11.2015;2015;11;10;Sunnuntai;4;2;6;11;11;22
294;08.11.2015;2015;11;11;Sunnuntai;6;3;9;8;7;15
294;08.11.2015;2015;11;12;Sunnuntai;7;5;12;13;12;25
294;08.11.2015;2015;11;13;Sunnuntai;3;8;11;9;9;18
294;08.11.2015;2015;11;14;Sunnuntai;4;2;6;17;11;28
294;08.11.2015;2015;11;15;Sunnuntai;7;7;14;13;7;20
294;08.11.2015;2015;11;16;Sunnuntai;4;5;9;9;7;16
294;08.11.2015;2015;11;17;Sunnuntai;5;3;8;7;11;18
294;08.11.2015;2015;11;18;Sunnuntai;0;2;2;10;8;18
294;08.11.2015;2015;11;19;Sunnuntai;1;3;4;9;11;20
294;08.11.2015;2015;11;20;Sunnuntai;1;0;1;10;5;15
294;08.11.2015;2015;11;21;Sunnuntai;1;2;3;0;1;1
294;08.11.2015;2015;11;22;Sunnuntai;0;0;0;0;1;1
294;08.11.2015;2015;11;23;Sunnuntai;0;0;0;1;0;1
294;09.11.2015;2015;11;00;Maanantai;0;0;0;0;0;0
294;09.11.2015;2015;11;01;Maanantai;0;0;0;0;0;0
294;09.11.2015;2015;11;02;Maanantai;0;1;1;0;0;0
294;09.11.2015;2015;11;03;Maanantai;0;0;0;0;0;0
294;09.11.2015;2015;11;04;Maanantai;0;0;0;0;0;0
294;09.11.2015;2015;11;05;Maanantai;1;1;2;1;0;1
294;09.11.2015;2015;11;06;Maanantai;2;2;4;2;2;4
294;09.11.2015;2015;11;07;Maanantai;12;7;19;0;1;1
294;09.11.2015;2015;11;08;Maanantai;28;7;35;18;3;21
294;09.11.2015;2015;11;09;Maanantai;4;9;13;11;9;20
294;09.11.2015;2015;11;10;Maanantai;6;3;9;6;10;16
294;09.11.2015;2015;11;11;Maanantai;4;10;14;15;20;35
294;09.11.2015;2015;11;12;Maanantai;17;19;36;21;8;29
294;09.11.2015;2015;11;13;Maanantai;7;12;19;10;10;20
294;09.11.2015;2015;11;14;Maanantai;12;28;40;12;12;24
294;09.11.2015;2015;11;15;Maanantai;26;19;45;9;14;23
294;09.11.2015;2015;11;16;Maanantai;14;12;26;10;10;20
294;09.11.2015;2015;11;17;Maanantai;10;13;23;6;11;17
294;09.11.2015;2015;11;18;Maanantai;16;13;29;17;18;35
294;09.11.2015;2015;11;19;Maanantai;7;7;14;18;21;39
294;09.11.2015;2015;11;20;Maanantai;6;5;11;10;3;13
294;09.11.2015;2015;11;21;Maanantai;0;0;0;2;1;3
294;09.11.2015;2015;11;22;Maanantai;0;0;0;1;1;2
294;09.11.2015;2015;11;23;Maanantai;1;0;1;1;0;1
294;10.11.2015;2015;11;00;Tiistai;0;0;0;0;0;0
294;10.11.2015;2015;11;01;Tiistai;0;0;0;0;0;0
294;10.11.2015;2015;11;02;Tiistai;0;0;0;0;0;0
294;10.11.2015;2015;11;03;Tiistai;0;0;0;0;0;0
294;10.11.2015;2015;11;04;Tiistai;0;0;0;0;0;0
294;10.11.2015;2015;11;05;Tiistai;0;0;0;0;0;0
294;10.11.2015;2015;11;06;Tiistai;0;1;1;1;1;2
294;10.11.2015;2015;11;07;Tiistai;10;4;14;7;6;13
294;10.11.2015;2015;11;08;Tiistai;14;7;21;8;2;10
294;10.11.2015;2015;11;09;Tiistai;15;3;18;11;9;20
294;10.11.2015;2015;11;10;Tiistai;6;5;11;10;8;18
294;10.11.2015;2015;11;11;Tiistai;6;11;17;9;10;19
294;10.11.2015;2015;11;12;Tiistai;9;7;16;15;10;25
294;10.11.2015;2015;11;13;Tiistai;8;6;14;5;7;12
294;10.11.2015;2015;11;14;Tiistai;12;12;24;7;10;17
294;10.11.2015;2015;11;15;Tiistai;13;18;31;8;9;17
294;10.11.2015;2015;11;16;Tiistai;9;12;21;5;6;11
294;10.11.2015;2015;11;17;Tiistai;13;8;21;8;6;14
294;10.11.2015;2015;11;18;Tiistai;2;8;10;12;7;19
294;10.11.2015;2015;11;19;Tiistai;6;5;11;6;8;14
294;10.11.2015;2015;11;20;Tiistai;4;2;6;1;3;4
294;10.11.2015;2015;11;21;Tiistai;0;0;0;1;0;1
294;10.11.2015;2015;11;22;Tiistai;0;0;0;0;0;0
294;10.11.2015;2015;11;23;Tiistai;1;0;1;0;0;0
294;11.11.2015;2015;11;00;Keskiviikko;0;0;0;0;1;1
294;11.11.2015;2015;11;01;Keskiviikko;0;0;0;0;0;0
294;11.11.2015;2015;11;02;Keskiviikko;0;0;0;0;0;0
294;11.11.2015;2015;11;03;Keskiviikko;0;0;0;0;0;0
294;11.11.2015;2015;11;04;Keskiviikko;0;0;0;0;0;0
294;11.11.2015;2015;11;05;Keskiviikko;0;1;1;0;0;0
294;11.11.2015;2015;11;06;Keskiviikko;1;0;1;6;1;7
294;11.11.2015;2015;11;07;Keskiviikko;25;8;33;8;3;11
294;11.11.2015;2015;11;08;Keskiviikko;11;2;13;4;3;7
294;11.11.2015;2015;11;09;Keskiviikko;10;4;14;10;8;18
294;11.11.2015;2015;11;10;Keskiviikko;2;2;4;6;12;18
294;11.11.2015;2015;11;11;Keskiviikko;10;8;18;27;16;43
294;11.11.2015;2015;11;12;Keskiviikko;6;10;16;11;12;23
294;11.11.2015;2015;11;13;Keskiviikko;9;13;22;7;10;17
294;11.11.2015;2015;11;14;Keskiviikko;13;18;31;12;11;23
294;11.11.2015;2015;11;15;Keskiviikko;17;20;37;11;16;27
294;11.11.2015;2015;11;16;Keskiviikko;11;17;28;8;10;18
294;11.11.2015;2015;11;17;Keskiviikko;23;16;39;17;11;28
294;11.11.2015;2015;11;18;Keskiviikko;7;7;14;12;24;36
294;11.11.2015;2015;11;19;Keskiviikko;11;13;24;14;14;28
294;11.11.2015;2015;11;20;Keskiviikko;5;5;10;12;5;17
294;11.11.2015;2015;11;21;Keskiviikko;3;2;5;0;0;0
294;11.11.2015;2015;11;22;Keskiviikko;0;0;0;0;0;0
294;11.11.2015;2015;11;23;Keskiviikko;2;0;2;0;0;0
294;12.11.2015;2015;11;00;Torstai;0;0;0;0;0;0
294;12.11.2015;2015;11;01;Torstai;0;0;0;0;0;0
294;12.11.2015;2015;11;02;Torstai;0;0;0;0;0;0
294;12.11.2015;2015;11;03;Torstai;0;0;0;0;0;0
294;12.11.2015;2015;11;04;Torstai;1;0;1;0;0;0
294;12.11.2015;2015;11;05;Torstai;0;0;0;0;0;0
294;12.11.2015;2015;11;06;Torstai;1;2;3;2;1;3
294;12.11.2015;2015;11;07;Torstai;7;6;13;3;7;10
294;12.11.2015;2015;11;08;Torstai;20;5;25;11;2;13
294;12.11.2015;2015;11;09;Torstai;16;7;23;8;13;21
294;12.11.2015;2015;11;10;Torstai;1;5;6;12;7;19
294;12.11.2015;2015;11;11;Torstai;4;11;15;23;12;35
294;12.11.2015;2015;11;12;Torstai;6;7;13;12;14;26
294;12.11.2015;2015;11;13;Torstai;9;19;28;16;15;31
294;12.11.2015;2015;11;14;Torstai;11;20;31;14;16;30
294;12.11.2015;2015;11;15;Torstai;9;25;34;14;11;25
294;12.11.2015;2015;11;16;Torstai;20;13;33;9;11;20
294;12.11.2015;2015;11;17;Torstai;15;16;31;8;12;20
294;12.11.2015;2015;11;18;Torstai;10;10;20;12;24;36
294;12.11.2015;2015;11;19;Torstai;12;12;24;14;14;28
294;12.11.2015;2015;11;20;Torstai;12;12;24;12;5;17
294;12.11.2015;2015;11;21;Torstai;1;0;1;0;0;0
294;12.11.2015;2015;11;22;Torstai;1;1;2;0;0;0
294;12.11.2015;2015;11;23;Torstai;1;0;1;0;0;0
294;13.11.2015;2015;11;00;Perjantai;0;0;0;1;0;1
294;13.11.2015;2015;11;01;Perjantai;0;0;0;0;0;0
294;13.11.2015;2015;11;02;Perjantai;0;0;0;0;0;0
294;13.11.2015;2015;11;03;Perjantai;0;0;0;0;0;0
294;13.11.2015;2015;11;04;Perjantai;0;0;0;0;0;0
294;13.11.2015;2015;11;05;Perjantai;1;0;1;0;0;0
294;13.11.2015;2015;11;06;Perjantai;2;2;4;2;3;5
294;13.11.2015;2015;11;07;Perjantai;6;5;11;4;5;9
294;13.11.2015;2015;11;08;Perjantai;6;5;11;7;7;14
294;13.11.2015;2015;11;09;Perjantai;11;11;22;11;14;25
294;13.11.2015;2015;11;10;Perjantai;6;6;12;9;12;21
294;13.11.2015;2015;11;11;Perjantai;12;11;23;14;11;25
294;13.11.2015;2015;11;12;Perjantai;26;26;52;10;12;22
294;13.11.2015;2015;11;13;Perjantai;16;15;31;11;12;23
294;13.11.2015;2015;11;14;Perjantai;21;20;41;15;15;30
294;13.11.2015;2015;11;15;Perjantai;18;17;35;10;14;24
294;13.11.2015;2015;11;16;Perjantai;11;11;22;10;9;19
294;13.11.2015;2015;11;17;Perjantai;10;9;19;7;7;14
294;13.11.2015;2015;11;18;Perjantai;29;28;57;17;5;22
294;13.11.2015;2015;11;19;Perjantai;11;11;22;12;8;20
294;13.11.2015;2015;11;20;Perjantai;8;8;16;3;2;5
294;13.11.2015;2015;11;21;Perjantai;4;4;8;0;0;0
294;13.11.2015;2015;11;22;Perjantai;3;3;6;1;1;2
294;13.11.2015;2015;11;23;Perjantai;1;1;2;0;0;0
294;14.11.2015;2015;11;00;Lauantai;0;0;0;1;0;1
294;14.11.2015;2015;11;01;Lauantai;1;0;1;0;0;0
294;14.11.2015;2015;11;02;Lauantai;0;0;0;0;2;2
294;14.11.2015;2015;11;03;Lauantai;0;0;0;1;0;1
294;14.11.2015;2015;11;04;Lauantai;0;0;0;0;0;0
294;14.11.2015;2015;11;05;Lauantai;0;0;0;0;0;0
294;14.11.2015;2015;11;06;Lauantai;0;0;0;0;1;1
294;14.11.2015;2015;11;07;Lauantai;1;0;1;2;3;5
294;14.11.2015;2015;11;08;Lauantai;1;1;2;1;3;4
294;14.11.2015;2015;11;09;Lauantai;2;1;3;7;11;18
294;14.11.2015;2015;11;10;Lauantai;4;3;7;9;13;22
294;14.11.2015;2015;11;11;Lauantai;9;9;18;1;8;9
294;14.11.2015;2015;11;12;Lauantai;7;7;14;10;9;19
294;14.11.2015;2015;11;13;Lauantai;6;6;12;9;3;12
294;14.11.2015;2015;11;14;Lauantai;7;6;13;5;6;11
294;14.11.2015;2015;11;15;Lauantai;8;7;15;10;7;17
294;14.11.2015;2015;11;16;Lauantai;7;6;13;8;13;21
294;14.11.2015;2015;11;17;Lauantai;6;6;12;11;2;13
294;14.11.2015;2015;11;18;Lauantai;13;12;25;7;9;16
294;14.11.2015;2015;11;19;Lauantai;9;9;18;5;3;8
294;14.11.2015;2015;11;20;Lauantai;2;1;3;7;6;13
294;14.11.2015;2015;11;21;Lauantai;1;0;1;1;1;2
294;14.11.2015;2015;11;22;Lauantai;1;0;1;1;3;4
294;14.11.2015;2015;11;23;Lauantai;2;2;4;0;1;1
294;15.11.2015;2015;11;00;Sunnuntai;0;0;0;1;1;2
294;15.11.2015;2015;11;01;Sunnuntai;1;0;1;0;0;0
294;15.11.2015;2015;11;02;Sunnuntai;0;0;0;0;2;2
294;15.11.2015;2015;11;03;Sunnuntai;0;0;0;0;0;0
294;15.11.2015;2015;11;04;Sunnuntai;1;0;1;0;0;0
294;15.11.2015;2015;11;05;Sunnuntai;0;0;0;0;0;0
294;15.11.2015;2015;11;06;Sunnuntai;1;1;2;0;1;1
294;15.11.2015;2015;11;07;Sunnuntai;0;0;0;0;2;2
294;15.11.2015;2015;11;08;Sunnuntai;2;1;3;3;4;7
294;15.11.2015;2015;11;09;Sunnuntai;4;4;8;4;5;9
294;15.11.2015;2015;11;10;Sunnuntai;3;2;5;11;11;22
294;15.11.2015;2015;11;11;Sunnuntai;3;2;5;8;7;15
294;15.11.2015;2015;11;12;Sunnuntai;3;3;6;13;12;25
294;15.11.2015;2015;11;13;Sunnuntai;1;0;1;9;9;18
294;15.11.2015;2015;11;14;Sunnuntai;4;4;8;17;11;28
294;15.11.2015;2015;11;15;Sunnuntai;3;3;6;13;7;20
294;15.11.2015;2015;11;16;Sunnuntai;4;3;7;9;7;16
294;15.11.2015;2015;11;17;Sunnuntai;8;7;15;7;11;18
294;15.11.2015;2015;11;18;Sunnuntai;6;5;11;9;1;10
294;15.11.2015;2015;11;19;Sunnuntai;3;3;6;4;4;8
294;15.11.2015;2015;11;20;Sunnuntai;1;1;2;4;5;9
294;15.11.2015;2015;11;21;Sunnuntai;1;0;1;1;1;2
294;15.11.2015;2015;11;22;Sunnuntai;0;0;0;1;1;2
294;15.11.2015;2015;11;23;Sunnuntai;0;0;0;2;2;4
294;16.11.2015;2015;11;00;Maanantai;1;0;1;0;0;0
294;16.11.2015;2015;11;01;Maanantai;0;0;0;0;0;0
294;16.11.2015;2015;11;02;Maanantai;0;0;0;0;0;0
294;16.11.2015;2015;11;03;Maanantai;0;0;0;0;0;0
294;16.11.2015;2015;11;04;Maanantai;0;0;0;0;0;0
294;16.11.2015;2015;11;05;Maanantai;0;0;0;0;0;0
294;16.11.2015;2015;11;06;Maanantai;4;1;5;2;3;5
294;16.11.2015;2015;11;07;Maanantai;12;7;19;5;5;10
294;16.11.2015;2015;11;08;Maanantai;23;4;27;42;6;48
294;16.11.2015;2015;11;09;Maanantai;10;8;18;10;21;31
294;16.11.2015;2015;11;10;Maanantai;4;4;8;24;8;32
294;16.11.2015;2015;11;11;Maanantai;7;8;15;22;28;50
294;16.11.2015;2015;11;12;Maanantai;4;2;6;20;17;37
294;16.11.2015;2015;11;13;Maanantai;8;12;20;14;12;26
294;16.11.2015;2015;11;14;Maanantai;9;20;29;18;14;32
294;16.11.2015;2015;11;15;Maanantai;17;17;34;12;15;27
294;16.11.2015;2015;11;16;Maanantai;9;20;29;6;14;20
294;16.11.2015;2015;11;17;Maanantai;10;7;17;8;11;19
294;16.11.2015;2015;11;18;Maanantai;8;6;14;16;23;39
294;16.11.2015;2015;11;19;Maanantai;4;10;14;25;8;33
294;16.11.2015;2015;11;20;Maanantai;3;4;7;9;6;15
294;16.11.2015;2015;11;21;Maanantai;0;0;0;2;1;3
294;16.11.2015;2015;11;22;Maanantai;0;1;1;3;0;3
294;16.11.2015;2015;11;23;Maanantai;0;0;0;0;0;0
294;17.11.2015;2015;11;00;Tiistai;0;0;0;0;0;0
294;17.11.2015;2015;11;01;Tiistai;0;0;0;0;0;0
294;17.11.2015;2015;11;02;Tiistai;0;0;0;0;0;0
294;17.11.2015;2015;11;03;Tiistai;0;0;0;0;0;0
294;17.11.2015;2015;11;04;Tiistai;0;0;0;0;0;0
294;17.11.2015;2015;11;05;Tiistai;0;0;0;0;0;0
294;17.11.2015;2015;11;06;Tiistai;4;1;5;3;2;5
294;17.11.2015;2015;11;07;Tiistai;25;4;29;5;4;9
294;17.11.2015;2015;11;08;Tiistai;10;4;14;16;7;23
294;17.11.2015;2015;11;09;Tiistai;16;9;25;19;8;27
294;17.11.2015;2015;11;10;Tiistai;7;8;15;15;11;26
294;17.11.2015;2015;11;11;Tiistai;4;9;13;12;8;20
294;17.11.2015;2015;11;12;Tiistai;9;16;25;9;19;28
294;17.11.2015;2015;11;13;Tiistai;14;11;25;11;9;20
294;17.11.2015;2015;11;14;Tiistai;12;16;28;9;10;19
294;17.11.2015;2015;11;15;Tiistai;20;24;44;8;16;24
294;17.11.2015;2015;11;16;Tiistai;6;17;23;6;7;13
294;17.11.2015;2015;11;17;Tiistai;10;9;19;9;11;20
294;17.11.2015;2015;11;18;Tiistai;4;6;10;15;11;26
294;17.11.2015;2015;11;19;Tiistai;4;2;6;9;11;20
294;17.11.2015;2015;11;20;Tiistai;1;1;2;8;10;18
294;17.11.2015;2015;11;21;Tiistai;0;1;1;0;0;0
294;17.11.2015;2015;11;22;Tiistai;0;0;0;0;0;0
294;17.11.2015;2015;11;23;Tiistai;0;0;0;0;0;0
294;18.11.2015;2015;11;00;Keskiviikko;0;0;0;0;0;0
294;18.11.2015;2015;11;01;Keskiviikko;0;0;0;0;0;0
294;18.11.2015;2015;11;02;Keskiviikko;0;0;0;0;0;0
294;18.11.2015;2015;11;03;Keskiviikko;0;0;0;0;0;0
294;18.11.2015;2015;11;04;Keskiviikko;1;1;2;0;0;0
294;18.11.2015;2015;11;05;Keskiviikko;0;0;0;1;0;1
294;18.11.2015;2015;11;06;Keskiviikko;1;0;1;4;2;6
294;18.11.2015;2015;11;07;Keskiviikko;15;8;23;5;8;13
294;18.11.2015;2015;11;08;Keskiviikko;19;4;23;6;4;10
294;18.11.2015;2015;11;09;Keskiviikko;8;11;19;27;21;48
294;18.11.2015;2015;11;10;Keskiviikko;7;5;12;10;11;21
294;18.11.2015;2015;11;11;Keskiviikko;8;9;17;60;18;78
294;18.11.2015;2015;11;12;Keskiviikko;4;6;10;22;45;67
294;18.11.2015;2015;11;13;Keskiviikko;7;12;19;7;13;20
294;18.11.2015;2015;11;14;Keskiviikko;8;21;29;9;10;19
294;18.11.2015;2015;11;15;Keskiviikko;6;11;17;13;16;29
294;18.11.2015;2015;11;16;Keskiviikko;18;19;37;11;20;31
294;18.11.2015;2015;11;17;Keskiviikko;10;10;20;12;9;21
294;18.11.2015;2015;11;18;Keskiviikko;5;9;14;13;9;22
294;18.11.2015;2015;11;19;Keskiviikko;8;5;13;9;19;28
294;18.11.2015;2015;11;20;Keskiviikko;6;3;9;12;10;22
294;18.11.2015;2015;11;21;Keskiviikko;1;0;1;2;3;5
294;18.11.2015;2015;11;22;Keskiviikko;0;2;2;0;0;0
294;18.11.2015;2015;11;23;Keskiviikko;0;0;0;0;0;0
294;19.11.2015;2015;11;00;Torstai;0;0;0;0;0;0
294;19.11.2015;2015;11;01;Torstai;0;0;0;0;0;0
294;19.11.2015;2015;11;02;Torstai;0;0;0;0;0;0
294;19.11.2015;2015;11;03;Torstai;0;0;0;0;0;0
294;19.11.2015;2015;11;04;Torstai;0;0;0;0;0;0
294;19.11.2015;2015;11;05;Torstai;0;0;0;0;0;0
294;19.11.2015;2015;11;06;Torstai;5;1;6;2;3;5
294;19.11.2015;2015;11;07;Torstai;14;2;16;10;3;13
294;19.11.2015;2015;11;08;Torstai;21;4;25;8;3;11
294;19.11.2015;2015;11;09;Torstai;19;4;23;3;13;16
294;19.11.2015;2015;11;10;Torstai;5;2;7;17;10;27
294;19.11.2015;2015;11;11;Torstai;10;14;24;15;15;30
294;19.11.2015;2015;11;12;Torstai;8;7;15;9;15;24
294;19.11.2015;2015;11;13;Torstai;10;12;22;24;18;42
294;19.11.2015;2015;11;14;Torstai;20;22;42;10;10;20
294;19.11.2015;2015;11;15;Torstai;15;27;42;5;13;18
294;19.11.2015;2015;11;16;Torstai;19;22;41;14;8;22
294;19.11.2015;2015;11;17;Torstai;14;11;25;10;14;24
294;19.11.2015;2015;11;18;Torstai;2;11;13;18;14;32
294;19.11.2015;2015;11;19;Torstai;9;11;20;9;14;23
294;19.11.2015;2015;11;20;Torstai;2;8;10;8;3;11
294;19.11.2015;2015;11;21;Torstai;1;1;2;5;3;8
294;19.11.2015;2015;11;22;Torstai;0;0;0;1;3;4
294;19.11.2015;2015;11;23;Torstai;1;0;1;0;0;0
294;20.11.2015;2015;11;00;Perjantai;0;0;0;0;0;0
294;20.11.2015;2015;11;01;Perjantai;0;0;0;0;1;1
294;20.11.2015;2015;11;02;Perjantai;0;0;0;0;1;1
294;20.11.2015;2015;11;03;Perjantai;0;0;0;0;0;0
294;20.11.2015;2015;11;04;Perjantai;0;0;0;0;0;0
294;20.11.2015;2015;11;05;Perjantai;0;0;0;1;0;1
294;20.11.2015;2015;11;06;Perjantai;2;0;2;2;1;3
294;20.11.2015;2015;11;07;Perjantai;8;2;10;7;1;8
294;20.11.2015;2015;11;08;Perjantai;20;6;26;10;5;15
294;20.11.2015;2015;11;09;Perjantai;10;4;14;16;5;21
294;20.11.2015;2015;11;10;Perjantai;7;6;13;11;19;30
294;20.11.2015;2015;11;11;Perjantai;9;6;15;11;10;21
294;20.11.2015;2015;11;12;Perjantai;20;17;37;10;11;21
294;20.11.2015;2015;11;13;Perjantai;13;20;33;11;15;26
294;20.11.2015;2015;11;14;Perjantai;16;15;31;11;11;22
294;20.11.2015;2015;11;15;Perjantai;7;16;23;14;13;27
294;20.11.2015;2015;11;16;Perjantai;6;7;13;10;12;22
294;20.11.2015;2015;11;17;Perjantai;13;7;20;11;8;19
294;20.11.2015;2015;11;18;Perjantai;9;13;22;14;13;27
294;20.11.2015;2015;11;19;Perjantai;6;4;10;11;8;19
294;20.11.2015;2015;11;20;Perjantai;3;6;9;13;5;18
294;20.11.2015;2015;11;21;Perjantai;3;4;7;4;7;11
294;20.11.2015;2015;11;22;Perjantai;1;1;2;1;2;3
294;20.11.2015;2015;11;23;Perjantai;3;0;3;3;0;3
294;21.11.2015;2015;11;00;Lauantai;2;0;2;0;1;1
294;21.11.2015;2015;11;01;Lauantai;1;1;2;0;1;1
294;21.11.2015;2015;11;02;Lauantai;0;0;0;0;0;0
294;21.11.2015;2015;11;03;Lauantai;0;0;0;0;0;0
294;21.11.2015;2015;11;04;Lauantai;2;0;2;3;2;5
294;21.11.2015;2015;11;05;Lauantai;0;0;0;4;0;4
294;21.11.2015;2015;11;06;Lauantai;0;1;1;2;2;4
294;21.11.2015;2015;11;07;Lauantai;1;2;3;2;2;4
294;21.11.2015;2015;11;08;Lauantai;2;1;3;3;3;6
294;21.11.2015;2015;11;09;Lauantai;1;2;3;7;10;17
294;21.11.2015;2015;11;10;Lauantai;1;3;4;19;17;36
294;21.11.2015;2015;11;11;Lauantai;8;4;12;14;15;29
294;21.11.2015;2015;11;12;Lauantai;2;4;6;10;9;19
294;21.11.2015;2015;11;13;Lauantai;13;13;26;15;23;38
294;21.11.2015;2015;11;14;Lauantai;3;7;10;11;8;19
294;21.11.2015;2015;11;15;Lauantai;5;9;14;17;12;29
294;21.11.2015;2015;11;16;Lauantai;16;6;22;12;10;22
294;21.11.2015;2015;11;17;Lauantai;8;13;21;17;18;35
294;21.11.2015;2015;11;18;Lauantai;11;10;21;6;9;15
294;21.11.2015;2015;11;19;Lauantai;2;1;3;6;6;12
294;21.11.2015;2015;11;20;Lauantai;0;3;3;6;8;14
294;21.11.2015;2015;11;21;Lauantai;4;3;7;4;6;10
294;21.11.2015;2015;11;22;Lauantai;3;0;3;1;3;4
294;21.11.2015;2015;11;23;Lauantai;0;0;0;0;1;1
294;22.11.2015;2015;11;00;Sunnuntai;2;0;2;3;0;3
294;22.11.2015;2015;11;01;Sunnuntai;0;0;0;0;0;0
294;22.11.2015;2015;11;02;Sunnuntai;0;1;1;0;0;0
294;22.11.2015;2015;11;03;Sunnuntai;1;1;2;0;0;0
294;22.11.2015;2015;11;04;Sunnuntai;0;0;0;0;0;0
294;22.11.2015;2015;11;05;Sunnuntai;0;1;1;5;5;10
294;22.11.2015;2015;11;06;Sunnuntai;0;0;0;2;2;4
294;22.11.2015;2015;11;07;Sunnuntai;0;0;0;1;2;3
294;22.11.2015;2015;11;08;Sunnuntai;1;1;2;3;3;6
294;22.11.2015;2015;11;09;Sunnuntai;3;1;4;11;13;24
294;22.11.2015;2015;11;10;Sunnuntai;1;1;2;10;11;21
294;22.11.2015;2015;11;11;Sunnuntai;6;7;13;8;8;16
294;22.11.2015;2015;11;12;Sunnuntai;7;4;11;8;7;15
294;22.11.2015;2015;11;13;Sunnuntai;1;1;2;4;10;14
294;22.11.2015;2015;11;14;Sunnuntai;1;3;4;12;9;21
294;22.11.2015;2015;11;15;Sunnuntai;5;5;10;8;11;19
294;22.11.2015;2015;11;16;Sunnuntai;6;5;11;11;8;19
294;22.11.2015;2015;11;17;Sunnuntai;4;1;5;4;12;16
294;22.11.2015;2015;11;18;Sunnuntai;5;4;9;15;9;24
294;22.11.2015;2015;11;19;Sunnuntai;6;2;8;7;6;13
294;22.11.2015;2015;11;20;Sunnuntai;1;2;3;8;5;13
294;22.11.2015;2015;11;21;Sunnuntai;0;1;1;0;1;1
294;22.11.2015;2015;11;22;Sunnuntai;1;1;2;0;0;0
294;22.11.2015;2015;11;23;Sunnuntai;1;0;1;1;0;1
294;23.11.2015;2015;11;00;Maanantai;0;0;0;0;0;0
294;23.11.2015;2015;11;01;Maanantai;0;0;0;0;1;1
294;23.11.2015;2015;11;02;Maanantai;0;0;0;0;0;0
294;23.11.2015;2015;11;03;Maanantai;0;0;0;0;0;0
294;23.11.2015;2015;11;04;Maanantai;0;0;0;0;0;0
294;23.11.2015;2015;11;05;Maanantai;0;0;0;0;3;3
294;23.11.2015;2015;11;06;Maanantai;4;0;4;2;1;3
294;23.11.2015;2015;11;07;Maanantai;9;3;12;7;8;15
294;23.11.2015;2015;11;08;Maanantai;24;3;27;15;7;22
294;23.11.2015;2015;11;09;Maanantai;5;2;7;14;12;26
294;23.11.2015;2015;11;10;Maanantai;5;5;10;17;13;30
294;23.11.2015;2015;11;11;Maanantai;4;13;17;14;16;30
294;23.11.2015;2015;11;12;Maanantai;6;4;10;16;17;33
294;23.11.2015;2015;11;13;Maanantai;4;19;23;10;13;23
294;23.11.2015;2015;11;14;Maanantai;12;18;30;4;15;19
294;23.11.2015;2015;11;15;Maanantai;14;13;27;10;11;21
294;23.11.2015;2015;11;16;Maanantai;9;8;17;17;16;33
294;23.11.2015;2015;11;17;Maanantai;5;7;12;16;14;30
294;23.11.2015;2015;11;18;Maanantai;4;6;10;23;17;40
294;23.11.2015;2015;11;19;Maanantai;9;1;10;11;15;26
294;23.11.2015;2015;11;20;Maanantai;2;2;4;5;7;12
294;23.11.2015;2015;11;21;Maanantai;0;0;0;3;1;4
294;23.11.2015;2015;11;22;Maanantai;1;0;1;0;0;0
294;23.11.2015;2015;11;23;Maanantai;1;0;1;0;0;0
294;24.11.2015;2015;11;00;Tiistai;1;1;2;1;0;1
294;24.11.2015;2015;11;01;Tiistai;0;0;0;0;0;0
294;24.11.2015;2015;11;02;Tiistai;0;0;0;0;0;0
294;24.11.2015;2015;11;03;Tiistai;0;0;0;0;0;0
294;24.11.2015;2015;11;04;Tiistai;0;0;0;0;0;0
294;24.11.2015;2015;11;05;Tiistai;1;0;1;0;0;0
294;24.11.2015;2015;11;06;Tiistai;4;1;5;4;5;9
294;24.11.2015;2015;11;07;Tiistai;8;6;14;8;6;14
294;24.11.2015;2015;11;08;Tiistai;14;2;16;13;11;24
294;24.11.2015;2015;11;09;Tiistai;11;3;14;7;12;19
294;24.11.2015;2015;11;10;Tiistai;7;2;9;14;20;34
294;24.11.2015;2015;11;11;Tiistai;5;8;13;11;16;27
294;24.11.2015;2015;11;12;Tiistai;9;10;19;11;9;20
294;24.11.2015;2015;11;13;Tiistai;9;14;23;15;18;33
294;24.11.2015;2015;11;14;Tiistai;10;8;18;9;13;22
294;24.11.2015;2015;11;15;Tiistai;11;23;34;18;7;25
294;24.11.2015;2015;11;16;Tiistai;3;13;16;9;13;22
294;24.11.2015;2015;11;17;Tiistai;9;3;12;24;22;46
294;24.11.2015;2015;11;18;Tiistai;7;8;15;12;13;25
294;24.11.2015;2015;11;19;Tiistai;8;5;13;18;8;26
294;24.11.2015;2015;11;20;Tiistai;2;1;3;7;5;12
294;24.11.2015;2015;11;21;Tiistai;1;1;2;1;1;2
294;24.11.2015;2015;11;22;Tiistai;1;1;2;0;1;1
294;24.11.2015;2015;11;23;Tiistai;1;0;1;0;0;0
294;25.11.2015;2015;11;00;Keskiviikko;0;0;0;0;0;0
294;25.11.2015;2015;11;01;Keskiviikko;0;0;0;0;0;0
294;25.11.2015;2015;11;02;Keskiviikko;0;0;0;0;0;0
294;25.11.2015;2015;11;03;Keskiviikko;0;0;0;0;0;0
294;25.11.2015;2015;11;04;Keskiviikko;0;0;0;0;0;0
294;25.11.2015;2015;11;05;Keskiviikko;0;0;0;1;1;2
294;25.11.2015;2015;11;06;Keskiviikko;2;1;3;2;2;4
294;25.11.2015;2015;11;07;Keskiviikko;18;6;24;7;2;9
294;25.11.2015;2015;11;08;Keskiviikko;21;2;23;4;7;11
294;25.11.2015;2015;11;09;Keskiviikko;4;7;11;9;5;14
294;25.11.2015;2015;11;10;Keskiviikko;3;4;7;6;12;18
294;25.11.2015;2015;11;11;Keskiviikko;1;3;4;4;17;21
294;25.11.2015;2015;11;12;Keskiviikko;2;6;8;12;6;18
294;25.11.2015;2015;11;13;Keskiviikko;6;8;14;9;12;21
294;25.11.2015;2015;11;14;Keskiviikko;6;5;11;8;3;11
294;25.11.2015;2015;11;15;Keskiviikko;7;6;13;10;12;22
294;25.11.2015;2015;11;16;Keskiviikko;11;3;14;11;8;19
294;25.11.2015;2015;11;17;Keskiviikko;7;9;16;11;8;19
294;25.11.2015;2015;11;18;Keskiviikko;6;5;11;12;9;21
294;25.11.2015;2015;11;19;Keskiviikko;3;7;10;3;3;6
294;25.11.2015;2015;11;20;Keskiviikko;3;2;5;1;6;7
294;25.11.2015;2015;11;21;Keskiviikko;0;3;3;0;0;0
294;25.11.2015;2015;11;22;Keskiviikko;2;1;3;2;0;2
294;25.11.2015;2015;11;23;Keskiviikko;1;0;1;0;1;1
294;26.11.2015;2015;11;00;Torstai;0;0;0;0;2;2
294;26.11.2015;2015;11;01;Torstai;0;0;0;0;0;0
294;26.11.2015;2015;11;02;Torstai;0;0;0;0;0;0
294;26.11.2015;2015;11;03;Torstai;0;0;0;0;0;0
294;26.11.2015;2015;11;04;Torstai;0;0;0;0;0;0
294;26.11.2015;2015;11;05;Torstai;1;0;1;1;0;1
294;26.11.2015;2015;11;06;Torstai;1;1;2;1;1;2
294;26.11.2015;2015;11;07;Torstai;6;2;8;8;3;11
294;26.11.2015;2015;11;08;Torstai;16;8;24;10;6;16
294;26.11.2015;2015;11;09;Torstai;12;7;19;8;5;13
294;26.11.2015;2015;11;10;Torstai;2;7;9;7;6;13
294;26.11.2015;2015;11;11;Torstai;5;9;14;6;11;17
294;26.11.2015;2015;11;12;Torstai;5;11;16;16;10;26
294;26.11.2015;2015;11;13;Torstai;12;19;31;12;15;27
294;26.11.2015;2015;11;14;Torstai;5;10;15;14;15;29
294;26.11.2015;2015;11;15;Torstai;12;12;24;7;10;17
294;26.11.2015;2015;11;16;Torstai;8;6;14;11;13;24
294;26.11.2015;2015;11;17;Torstai;5;13;18;8;8;16
294;26.11.2015;2015;11;18;Torstai;13;10;23;14;15;29
294;26.11.2015;2015;11;19;Torstai;6;6;12;8;17;25
294;26.11.2015;2015;11;20;Torstai;1;4;5;13;15;28
294;26.11.2015;2015;11;21;Torstai;0;2;2;1;1;2
294;26.11.2015;2015;11;22;Torstai;0;0;0;1;1;2
294;26.11.2015;2015;11;23;Torstai;1;0;1;0;0;0
294;27.11.2015;2015;11;00;Perjantai;0;0;0;0;0;0
294;27.11.2015;2015;11;01;Perjantai;0;0;0;0;0;0
294;27.11.2015;2015;11;02;Perjantai;0;0;0;0;0;0
294;27.11.2015;2015;11;03;Perjantai;0;0;0;0;0;0
294;27.11.2015;2015;11;04;Perjantai;0;0;0;0;0;0
294;27.11.2015;2015;11;05;Perjantai;0;0;0;0;0;0
294;27.11.2015;2015;11;06;Perjantai;2;0;2;1;0;1
294;27.11.2015;2015;11;07;Perjantai;8;0;8;10;4;14
294;27.11.2015;2015;11;08;Perjantai;17;6;23;8;6;14
294;27.11.2015;2015;11;09;Perjantai;9;10;19;11;11;22
294;27.11.2015;2015;11;10;Perjantai;6;15;21;5;14;19
294;27.11.2015;2015;11;11;Perjantai;7;14;21;10;5;15
294;27.11.2015;2015;11;12;Perjantai;11;11;22;18;12;30
294;27.11.2015;2015;11;13;Perjantai;19;13;32;18;18;36
294;27.11.2015;2015;11;14;Perjantai;10;7;17;20;18;38
294;27.11.2015;2015;11;15;Perjantai;15;14;29;13;20;33
294;27.11.2015;2015;11;16;Perjantai;7;21;28;14;13;27
294;27.11.2015;2015;11;17;Perjantai;17;6;23;12;5;17
294;27.11.2015;2015;11;18;Perjantai;5;7;12;17;16;33
294;27.11.2015;2015;11;19;Perjantai;2;6;8;9;9;18
294;27.11.2015;2015;11;20;Perjantai;9;4;13;16;8;24
294;27.11.2015;2015;11;21;Perjantai;5;5;10;6;3;9
294;27.11.2015;2015;11;22;Perjantai;5;4;9;4;7;11
294;27.11.2015;2015;11;23;Perjantai;4;0;4;0;1;1
294;28.11.2015;2015;11;00;Lauantai;0;1;1;0;0;0
294;28.11.2015;2015;11;01;Lauantai;2;1;3;1;0;1
294;28.11.2015;2015;11;02;Lauantai;1;0;1;0;1;1
294;28.11.2015;2015;11;03;Lauantai;0;1;1;0;0;0
294;28.11.2015;2015;11;04;Lauantai;0;0;0;0;0;0
294;28.11.2015;2015;11;05;Lauantai;0;0;0;0;2;2
294;28.11.2015;2015;11;06;Lauantai;1;0;1;2;1;3
294;28.11.2015;2015;11;07;Lauantai;0;1;1;1;1;2
294;28.11.2015;2015;11;08;Lauantai;1;1;2;0;3;3
294;28.11.2015;2015;11;09;Lauantai;5;2;7;4;4;8
294;28.11.2015;2015;11;10;Lauantai;3;4;7;7;7;14
294;28.11.2015;2015;11;11;Lauantai;1;4;5;6;8;14
294;28.11.2015;2015;11;12;Lauantai;1;2;3;2;5;7
294;28.11.2015;2015;11;13;Lauantai;4;4;8;11;4;15
294;28.11.2015;2015;11;14;Lauantai;3;7;10;6;4;10
294;28.11.2015;2015;11;15;Lauantai;12;9;21;6;4;10
294;28.11.2015;2015;11;16;Lauantai;5;7;12;5;6;11
294;28.11.2015;2015;11;17;Lauantai;3;3;6;5;5;10
294;28.11.2015;2015;11;18;Lauantai;4;2;6;8;2;10
294;28.11.2015;2015;11;19;Lauantai;0;6;6;1;5;6
294;28.11.2015;2015;11;20;Lauantai;3;3;6;4;2;6
294;28.11.2015;2015;11;21;Lauantai;0;0;0;1;6;7
294;28.11.2015;2015;11;22;Lauantai;0;0;0;3;0;3
294;28.11.2015;2015;11;23;Lauantai;0;0;0;0;0;0
294;29.11.2015;2015;11;00;Sunnuntai;0;0;0;1;0;1
294;29.11.2015;2015;11;01;Sunnuntai;0;0;0;0;0;0
294;29.11.2015;2015;11;02;Sunnuntai;0;0;0;0;0;0
294;29.11.2015;2015;11;03;Sunnuntai;0;0;0;0;0;0
294;29.11.2015;2015;11;04;Sunnuntai;0;0;0;0;0;0
294;29.11.2015;2015;11;05;Sunnuntai;0;0;0;0;0;0
294;29.11.2015;2015;11;06;Sunnuntai;0;0;0;1;1;2
294;29.11.2015;2015;11;07;Sunnuntai;0;0;0;3;4;7
294;29.11.2015;2015;11;08;Sunnuntai;1;0;1;1;4;5
294;29.11.2015;2015;11;09;Sunnuntai;3;3;6;12;3;15
294;29.11.2015;2015;11;10;Sunnuntai;0;3;3;8;4;12
294;29.11.2015;2015;11;11;Sunnuntai;4;5;9;6;8;14
294;29.11.2015;2015;11;12;Sunnuntai;6;6;12;13;13;26
294;29.11.2015;2015;11;13;Sunnuntai;6;5;11;10;5;15
294;29.11.2015;2015;11;14;Sunnuntai;5;4;9;23;8;31
294;29.11.2015;2015;11;15;Sunnuntai;5;5;10;8;9;17
294;29.11.2015;2015;11;16;Sunnuntai;2;5;7;4;7;11
294;29.11.2015;2015;11;17;Sunnuntai;2;5;7;9;9;18
294;29.11.2015;2015;11;18;Sunnuntai;6;6;12;5;12;17
294;29.11.2015;2015;11;19;Sunnuntai;7;3;10;10;6;16
294;29.11.2015;2015;11;20;Sunnuntai;2;5;7;3;8;11
294;29.11.2015;2015;11;21;Sunnuntai;3;1;4;4;2;6
294;29.11.2015;2015;11;22;Sunnuntai;0;0;0;2;0;2
294;29.11.2015;2015;11;23;Sunnuntai;1;0;1;0;0;0
294;30.11.2015;2015;11;00;Maanantai;0;0;0;0;1;1
294;30.11.2015;2015;11;01;Maanantai;0;0;0;0;0;0
294;30.11.2015;2015;11;02;Maanantai;0;0;0;0;0;0
294;30.11.2015;2015;11;03;Maanantai;0;0;0;0;0;0
294;30.11.2015;2015;11;04;Maanantai;0;0;0;0;0;0
294;30.11.2015;2015;11;05;Maanantai;0;0;0;0;0;0
294;30.11.2015;2015;11;06;Maanantai;1;1;2;1;1;2
294;30.11.2015;2015;11;07;Maanantai;9;3;12;3;5;8
294;30.11.2015;2015;11;08;Maanantai;11;4;15;12;4;16
294;30.11.2015;2015;11;09;Maanantai;5;5;10;15;10;25
294;30.11.2015;2015;11;10;Maanantai;3;5;8;11;14;25
294;30.11.2015;2015;11;11;Maanantai;6;10;16;16;11;27
294;30.11.2015;2015;11;12;Maanantai;7;10;17;9;10;19
294;30.11.2015;2015;11;13;Maanantai;5;7;12;9;11;20
294;30.11.2015;2015;11;14;Maanantai;17;17;34;17;16;33
294;30.11.2015;2015;11;15;Maanantai;7;19;26;8;16;24
294;30.11.2015;2015;11;16;Maanantai;10;9;19;7;8;15
294;30.11.2015;2015;11;17;Maanantai;3;4;7;6;9;15
294;30.11.2015;2015;11;18;Maanantai;6;8;14;9;13;22
294;30.11.2015;2015;11;19;Maanantai;9;6;15;19;6;25
294;30.11.2015;2015;11;20;Maanantai;2;0;2;12;4;16
294;30.11.2015;2015;11;21;Maanantai;1;0;1;1;2;3
294;30.11.2015;2015;11;22;Maanantai;0;0;0;1;0;1
294;30.11.2015;2015;11;23;Maanantai;0;0;0;0;0;0
294;01.12.2015;2015;12;00;Tiistai;0;0;0;0;0;0
294;01.12.2015;2015;12;01;Tiistai;0;0;0;0;0;0
294;01.12.2015;2015;12;02;Tiistai;0;0;0;0;0;0
294;01.12.2015;2015;12;03;Tiistai;0;0;0;0;0;0
294;01.12.2015;2015;12;04;Tiistai;0;0;0;0;0;0
294;01.12.2015;2015;12;05;Tiistai;0;0;0;2;0;2
294;01.12.2015;2015;12;06;Tiistai;2;1;3;3;3;6
294;01.12.2015;2015;12;07;Tiistai;9;5;14;3;5;8
294;01.12.2015;2015;12;08;Tiistai;22;4;26;11;3;14
294;01.12.2015;2015;12;09;Tiistai;3;5;8;7;11;18
294;01.12.2015;2015;12;10;Tiistai;4;2;6;16;20;36
294;01.12.2015;2015;12;11;Tiistai;6;6;12;17;11;28
294;01.12.2015;2015;12;12;Tiistai;4;9;13;18;20;38
294;01.12.2015;2015;12;13;Tiistai;10;8;18;15;16;31
294;01.12.2015;2015;12;14;Tiistai;13;15;28;16;11;27
294;01.12.2015;2015;12;15;Tiistai;17;19;36;9;17;26
294;01.12.2015;2015;12;16;Tiistai;11;32;43;18;22;40
294;01.12.2015;2015;12;17;Tiistai;9;5;14;13;12;25
294;01.12.2015;2015;12;18;Tiistai;9;6;15;18;19;37
294;01.12.2015;2015;12;19;Tiistai;9;2;11;10;16;26
294;01.12.2015;2015;12;20;Tiistai;1;3;4;14;17;31
294;01.12.2015;2015;12;21;Tiistai;4;1;5;6;4;10
294;01.12.2015;2015;12;22;Tiistai;0;0;0;0;1;1
294;01.12.2015;2015;12;23;Tiistai;0;0;0;1;0;1
294;02.12.2015;2015;12;00;Keskiviikko;0;0;0;0;0;0
294;02.12.2015;2015;12;01;Keskiviikko;0;0;0;0;0;0
294;02.12.2015;2015;12;02;Keskiviikko;0;0;0;0;1;1
294;02.12.2015;2015;12;03;Keskiviikko;0;0;0;0;0;0
294;02.12.2015;2015;12;04;Keskiviikko;0;0;0;0;0;0
294;02.12.2015;2015;12;05;Keskiviikko;0;0;0;7;7;14
294;02.12.2015;2015;12;06;Keskiviikko;1;0;1;3;2;5
294;02.12.2015;2015;12;07;Keskiviikko;15;10;25;7;9;16
294;02.12.2015;2015;12;08;Keskiviikko;17;2;19;8;5;13
294;02.12.2015;2015;12;09;Keskiviikko;6;4;10;13;18;31
294;02.12.2015;2015;12;10;Keskiviikko;2;5;7;25;18;43
294;02.12.2015;2015;12;11;Keskiviikko;8;8;16;23;20;43
294;02.12.2015;2015;12;12;Keskiviikko;9;7;16;12;12;24
294;02.12.2015;2015;12;13;Keskiviikko;9;10;19;24;10;34
294;02.12.2015;2015;12;14;Keskiviikko;9;22;31;13;23;36
294;02.12.2015;2015;12;15;Keskiviikko;11;11;22;7;12;19
294;02.12.2015;2015;12;16;Keskiviikko;15;8;23;21;13;34
294;02.12.2015;2015;12;17;Keskiviikko;13;11;24;10;13;23
294;02.12.2015;2015;12;18;Keskiviikko;10;12;22;16;9;25
294;02.12.2015;2015;12;19;Keskiviikko;6;4;10;6;11;17
294;02.12.2015;2015;12;20;Keskiviikko;1;2;3;10;10;20
294;02.12.2015;2015;12;21;Keskiviikko;2;1;3;0;0;0
294;02.12.2015;2015;12;22;Keskiviikko;0;1;1;1;0;1
294;02.12.2015;2015;12;23;Keskiviikko;0;0;0;0;1;1
294;03.12.2015;2015;12;00;Torstai;0;0;0;0;0;0
294;03.12.2015;2015;12;01;Torstai;0;0;0;0;0;0
294;03.12.2015;2015;12;02;Torstai;0;0;0;0;0;0
294;03.12.2015;2015;12;03;Torstai;0;0;0;0;0;0
294;03.12.2015;2015;12;04;Torstai;0;0;0;0;0;0
294;03.12.2015;2015;12;05;Torstai;0;0;0;1;0;1
294;03.12.2015;2015;12;06;Torstai;3;2;5;2;3;5
294;03.12.2015;2015;12;07;Torstai;8;2;10;4;5;9
294;03.12.2015;2015;12;08;Torstai;16;3;19;9;6;15
294;03.12.2015;2015;12;09;Torstai;7;5;12;3;10;13
294;03.12.2015;2015;12;10;Torstai;2;1;3;20;7;27
294;03.12.2015;2015;12;11;Torstai;5;2;7;20;29;49
294;03.12.2015;2015;12;12;Torstai;5;4;9;15;18;33
294;03.12.2015;2015;12;13;Torstai;5;5;10;22;17;39
294;03.12.2015;2015;12;14;Torstai;12;18;30;11;19;30
294;03.12.2015;2015;12;15;Torstai;5;10;15;12;17;29
294;03.12.2015;2015;12;16;Torstai;3;10;13;17;14;31
294;03.12.2015;2015;12;17;Torstai;4;10;14;15;17;32
294;03.12.2015;2015;12;18;Torstai;8;8;16;16;13;29
294;03.12.2015;2015;12;19;Torstai;4;5;9;11;16;27
294;03.12.2015;2015;12;20;Torstai;1;3;4;13;12;25
294;03.12.2015;2015;12;21;Torstai;4;3;7;4;2;6
294;03.12.2015;2015;12;22;Torstai;0;1;1;0;0;0
294;03.12.2015;2015;12;23;Torstai;0;0;0;0;0;0
294;04.12.2015;2015;12;00;Perjantai;0;0;0;0;0;0
294;04.12.2015;2015;12;01;Perjantai;0;0;0;0;1;1
294;04.12.2015;2015;12;02;Perjantai;0;0;0;0;0;0
294;04.12.2015;2015;12;03;Perjantai;0;0;0;0;0;0
294;04.12.2015;2015;12;04;Perjantai;0;0;0;0;0;0
294;04.12.2015;2015;12;05;Perjantai;0;0;0;0;1;1
294;04.12.2015;2015;12;06;Perjantai;2;0;2;4;1;5
294;04.12.2015;2015;12;07;Perjantai;3;4;7;4;2;6
294;04.12.2015;2015;12;08;Perjantai;8;3;11;9;4;13
294;04.12.2015;2015;12;09;Perjantai;11;3;14;8;9;17
294;04.12.2015;2015;12;10;Perjantai;7;4;11;11;13;24
294;04.12.2015;2015;12;11;Perjantai;7;9;16;18;10;28
294;04.12.2015;2015;12;12;Perjantai;11;15;26;20;12;32
294;04.12.2015;2015;12;13;Perjantai;15;19;34;16;19;35
294;04.12.2015;2015;12;14;Perjantai;8;16;24;16;18;34
294;04.12.2015;2015;12;15;Perjantai;7;10;17;9;10;19
294;04.12.2015;2015;12;16;Perjantai;15;8;23;12;6;18
294;04.12.2015;2015;12;17;Perjantai;6;5;11;4;17;21
294;04.12.2015;2015;12;18;Perjantai;3;5;8;11;6;17
294;04.12.2015;2015;12;19;Perjantai;7;4;11;15;12;27
294;04.12.2015;2015;12;20;Perjantai;4;4;8;13;14;27
294;04.12.2015;2015;12;21;Perjantai;3;4;7;9;7;16
294;04.12.2015;2015;12;22;Perjantai;7;2;9;5;5;10
294;04.12.2015;2015;12;23;Perjantai;0;0;0;1;0;1
294;05.12.2015;2015;12;00;Lauantai;1;0;1;1;0;1
294;05.12.2015;2015;12;01;Lauantai;0;0;0;0;1;1
294;05.12.2015;2015;12;02;Lauantai;0;2;2;2;1;3
294;05.12.2015;2015;12;03;Lauantai;0;0;0;0;0;0
294;05.12.2015;2015;12;04;Lauantai;0;0;0;1;0;1
294;05.12.2015;2015;12;05;Lauantai;0;0;0;1;0;1
294;05.12.2015;2015;12;06;Lauantai;1;0;1;0;1;1
294;05.12.2015;2015;12;07;Lauantai;0;1;1;0;3;3
294;05.12.2015;2015;12;08;Lauantai;0;0;0;4;4;8
294;05.12.2015;2015;12;09;Lauantai;0;1;1;9;7;16
294;05.12.2015;2015;12;10;Lauantai;4;2;6;11;7;18
294;05.12.2015;2015;12;11;Lauantai;2;3;5;11;11;22
294;05.12.2015;2015;12;12;Lauantai;2;4;6;17;13;30
294;05.12.2015;2015;12;13;Lauantai;3;4;7;7;13;20
294;05.12.2015;2015;12;14;Lauantai;7;8;15;14;24;38
294;05.12.2015;2015;12;15;Lauantai;3;6;9;19;9;28
294;05.12.2015;2015;12;16;Lauantai;3;5;8;12;9;21
294;05.12.2015;2015;12;17;Lauantai;4;2;6;11;3;14
294;05.12.2015;2015;12;18;Lauantai;2;3;5;6;3;9
294;05.12.2015;2015;12;19;Lauantai;8;5;13;6;6;12
294;05.12.2015;2015;12;20;Lauantai;2;0;2;4;3;7
294;05.12.2015;2015;12;21;Lauantai;1;0;1;0;2;2
294;05.12.2015;2015;12;22;Lauantai;0;2;2;2;2;4
294;05.12.2015;2015;12;23;Lauantai;1;2;3;0;2;2
294;06.12.2015;2015;12;00;Sunnuntai;0;0;0;0;0;0
294;06.12.2015;2015;12;01;Sunnuntai;0;0;0;1;1;2
294;06.12.2015;2015;12;02;Sunnuntai;0;0;0;0;0;0
294;06.12.2015;2015;12;03;Sunnuntai;0;0;0;0;2;2
294;06.12.2015;2015;12;04;Sunnuntai;0;0;0;0;0;0
294;06.12.2015;2015;12;05;Sunnuntai;0;0;0;1;2;3
294;06.12.2015;2015;12;06;Sunnuntai;0;0;0;1;1;2
294;06.12.2015;2015;12;07;Sunnuntai;0;1;1;0;4;4
294;06.12.2015;2015;12;08;Sunnuntai;2;1;3;7;6;13
294;06.12.2015;2015;12;09;Sunnuntai;8;4;12;11;4;15
294;06.12.2015;2015;12;10;Sunnuntai;0;1;1;7;11;18
294;06.12.2015;2015;12;11;Sunnuntai;3;7;10;14;11;25
294;06.12.2015;2015;12;12;Sunnuntai;6;4;10;9;9;18
294;06.12.2015;2015;12;13;Sunnuntai;6;9;15;3;11;14
294;06.12.2015;2015;12;14;Sunnuntai;3;4;7;18;4;22
294;06.12.2015;2015;12;15;Sunnuntai;9;5;14;6;6;12
294;06.12.2015;2015;12;16;Sunnuntai;6;4;10;12;9;21
294;06.12.2015;2015;12;17;Sunnuntai;1;4;5;5;6;11
294;06.12.2015;2015;12;18;Sunnuntai;3;2;5;9;12;21
294;06.12.2015;2015;12;19;Sunnuntai;1;0;1;8;3;11
294;06.12.2015;2015;12;20;Sunnuntai;0;0;0;1;2;3
294;06.12.2015;2015;12;21;Sunnuntai;0;0;0;3;1;4
294;06.12.2015;2015;12;22;Sunnuntai;0;0;0;1;1;2
294;06.12.2015;2015;12;23;Sunnuntai;0;1;1;1;0;1
294;07.12.2015;2015;12;00;Maanantai;0;0;0;0;0;0
294;07.12.2015;2015;12;01;Maanantai;0;0;0;0;0;0
294;07.12.2015;2015;12;02;Maanantai;0;0;0;0;0;0
294;07.12.2015;2015;12;03;Maanantai;0;0;0;0;0;0
294;07.12.2015;2015;12;04;Maanantai;0;0;0;0;0;0
294;07.12.2015;2015;12;05;Maanantai;0;0;0;0;0;0
294;07.12.2015;2015;12;06;Maanantai;2;0;2;1;2;3
294;07.12.2015;2015;12;07;Maanantai;6;4;10;4;5;9
294;07.12.2015;2015;12;08;Maanantai;11;1;12;16;7;23
294;07.12.2015;2015;12;09;Maanantai;10;2;12;10;13;23
294;07.12.2015;2015;12;10;Maanantai;3;1;4;13;15;28
294;07.12.2015;2015;12;11;Maanantai;2;3;5;26;20;46
294;07.12.2015;2015;12;12;Maanantai;1;8;9;18;22;40
294;07.12.2015;2015;12;13;Maanantai;4;12;16;24;18;42
294;07.12.2015;2015;12;14;Maanantai;3;10;13;10;21;31
294;07.12.2015;2015;12;15;Maanantai;10;7;17;13;20;33
294;07.12.2015;2015;12;16;Maanantai;6;3;9;15;7;22
294;07.12.2015;2015;12;17;Maanantai;0;1;1;4;8;12
294;07.12.2015;2015;12;18;Maanantai;2;2;4;11;22;33
294;07.12.2015;2015;12;19;Maanantai;4;3;7;8;18;26
294;07.12.2015;2015;12;20;Maanantai;1;0;1;9;5;14
294;07.12.2015;2015;12;21;Maanantai;2;5;7;2;1;3
294;07.12.2015;2015;12;22;Maanantai;1;0;1;2;0;2
294;07.12.2015;2015;12;23;Maanantai;0;0;0;2;0;2
294;08.12.2015;2015;12;00;Tiistai;0;0;0;0;0;0
294;08.12.2015;2015;12;01;Tiistai;0;0;0;0;0;0
294;08.12.2015;2015;12;02;Tiistai;0;0;0;0;0;0
294;08.12.2015;2015;12;03;Tiistai;0;0;0;0;0;0
294;08.12.2015;2015;12;04;Tiistai;0;0;0;0;0;0
294;08.12.2015;2015;12;05;Tiistai;1;0;1;2;0;2
294;08.12.2015;2015;12;06;Tiistai;1;1;2;3;1;4
294;08.12.2015;2015;12;07;Tiistai;1;5;6;7;3;10
294;08.12.2015;2015;12;08;Tiistai;20;4;24;11;4;15
294;08.12.2015;2015;12;09;Tiistai;4;7;11;11;14;25
294;08.12.2015;2015;12;10;Tiistai;5;2;7;13;10;23
294;08.12.2015;2015;12;11;Tiistai;7;3;10;18;23;41
294;08.12.2015;2015;12;12;Tiistai;7;5;12;24;23;47
294;08.12.2015;2015;12;13;Tiistai;7;16;23;18;18;36
294;08.12.2015;2015;12;14;Tiistai;13;6;19;25;15;40
294;08.12.2015;2015;12;15;Tiistai;11;24;35;12;29;41
294;08.12.2015;2015;12;16;Tiistai;8;12;20;13;13;26
294;08.12.2015;2015;12;17;Tiistai;6;6;12;12;8;20
294;08.12.2015;2015;12;18;Tiistai;3;5;8;15;19;34
294;08.12.2015;2015;12;19;Tiistai;2;2;4;11;12;23
294;08.12.2015;2015;12;20;Tiistai;2;3;5;8;6;14
294;08.12.2015;2015;12;21;Tiistai;0;1;1;3;1;4
294;08.12.2015;2015;12;22;Tiistai;0;0;0;0;0;0
294;08.12.2015;2015;12;23;Tiistai;1;0;1;1;1;2
294;09.12.2015;2015;12;00;Keskiviikko;0;0;0;0;1;1
294;09.12.2015;2015;12;01;Keskiviikko;0;0;0;0;0;0
294;09.12.2015;2015;12;02;Keskiviikko;0;0;0;0;0;0
294;09.12.2015;2015;12;03;Keskiviikko;4;0;4;3;4;7
294;09.12.2015;2015;12;04;Keskiviikko;0;0;0;0;0;0
294;09.12.2015;2015;12;05;Keskiviikko;0;0;0;0;0;0
294;09.12.2015;2015;12;06;Keskiviikko;1;0;1;6;5;11
294;09.12.2015;2015;12;07;Keskiviikko;10;6;16;9;2;11
294;09.12.2015;2015;12;08;Keskiviikko;10;2;12;7;2;9
294;09.12.2015;2015;12;09;Keskiviikko;2;4;6;18;4;22
294;09.12.2015;2015;12;10;Keskiviikko;3;2;5;17;16;33
294;09.12.2015;2015;12;11;Keskiviikko;3;3;6;18;11;29
294;09.12.2015;2015;12;12;Keskiviikko;3;4;7;10;13;23
294;09.12.2015;2015;12;13;Keskiviikko;3;7;10;13;7;20
294;09.12.2015;2015;12;14;Keskiviikko;3;11;14;11;19;30
294;09.12.2015;2015;12;15;Keskiviikko;7;10;17;13;15;28
294;09.12.2015;2015;12;16;Keskiviikko;5;3;8;6;11;17
294;09.12.2015;2015;12;17;Keskiviikko;6;5;11;6;9;15
294;09.12.2015;2015;12;18;Keskiviikko;0;4;4;7;10;17
294;09.12.2015;2015;12;19;Keskiviikko;2;0;2;4;5;9
294;09.12.2015;2015;12;20;Keskiviikko;0;0;0;3;5;8
294;09.12.2015;2015;12;21;Keskiviikko;1;0;1;0;2;2
294;09.12.2015;2015;12;22;Keskiviikko;0;0;0;0;0;0
294;09.12.2015;2015;12;23;Keskiviikko;1;0;1;0;0;0
294;10.12.2015;2015;12;00;Torstai;0;0;0;0;0;0
294;10.12.2015;2015;12;01;Torstai;0;0;0;1;0;1
294;10.12.2015;2015;12;02;Torstai;0;0;0;0;0;0
294;10.12.2015;2015;12;03;Torstai;0;0;0;0;0;0
294;10.12.2015;2015;12;04;Torstai;0;0;0;0;0;0
294;10.12.2015;2015;12;05;Torstai;0;0;0;1;1;2
294;10.12.2015;2015;12;06;Torstai;0;1;1;4;2;6
294;10.12.2015;2015;12;07;Torstai;4;1;5;6;2;8
294;10.12.2015;2015;12;08;Torstai;12;2;14;10;8;18
294;10.12.2015;2015;12;09;Torstai;8;4;12;8;14;22
294;10.12.2015;2015;12;10;Torstai;1;1;2;26;6;32
294;10.12.2015;2015;12;11;Torstai;3;1;4;14;14;28
294;10.12.2015;2015;12;12;Torstai;3;4;7;17;15;32
294;10.12.2015;2015;12;13;Torstai;5;5;10;12;11;23
294;10.12.2015;2015;12;14;Torstai;5;12;17;22;19;41
294;10.12.2015;2015;12;15;Torstai;6;5;11;14;16;30
294;10.12.2015;2015;12;16;Torstai;7;6;13;8;11;19
294;10.12.2015;2015;12;17;Torstai;5;2;7;11;17;28
294;10.12.2015;2015;12;18;Torstai;3;6;9;23;21;44
294;10.12.2015;2015;12;19;Torstai;2;4;6;8;7;15
294;10.12.2015;2015;12;20;Torstai;7;4;11;6;6;12
294;10.12.2015;2015;12;21;Torstai;2;1;3;1;1;2
294;10.12.2015;2015;12;22;Torstai;0;0;0;0;0;0
294;10.12.2015;2015;12;23;Torstai;0;0;0;0;0;0
294;11.12.2015;2015;12;00;Perjantai;0;0;0;0;0;0
294;11.12.2015;2015;12;01;Perjantai;0;0;0;0;0;0
294;11.12.2015;2015;12;02;Perjantai;0;0;0;0;0;0
294;11.12.2015;2015;12;03;Perjantai;0;0;0;0;0;0
294;11.12.2015;2015;12;04;Perjantai;0;0;0;0;0;0
294;11.12.2015;2015;12;05;Perjantai;0;0;0;2;1;3
294;11.12.2015;2015;12;06;Perjantai;1;1;2;2;0;2
294;11.12.2015;2015;12;07;Perjantai;3;1;4;11;2;13
294;11.12.2015;2015;12;08;Perjantai;9;1;10;8;2;10
294;11.12.2015;2015;12;09;Perjantai;9;1;10;12;11;23
294;11.12.2015;2015;12;10;Perjantai;3;5;8;19;12;31
294;11.12.2015;2015;12;11;Perjantai;5;3;8;21;12;33
294;11.12.2015;2015;12;12;Perjantai;12;8;20;17;26;43
294;11.12.2015;2015;12;13;Perjantai;1;4;5;25;24;49
294;11.12.2015;2015;12;14;Perjantai;7;27;34;16;26;42
294;11.12.2015;2015;12;15;Perjantai;7;3;10;15;17;32
294;11.12.2015;2015;12;16;Perjantai;3;12;15;5;11;16
294;11.12.2015;2015;12;17;Perjantai;6;6;12;6;9;15
294;11.12.2015;2015;12;18;Perjantai;2;3;5;10;10;20
294;11.12.2015;2015;12;19;Perjantai;3;0;3;12;13;25
294;11.12.2015;2015;12;20;Perjantai;0;4;4;8;2;10
294;11.12.2015;2015;12;21;Perjantai;7;5;12;5;2;7
294;11.12.2015;2015;12;22;Perjantai;2;0;2;3;3;6
294;11.12.2015;2015;12;23;Perjantai;1;0;1;2;3;5
294;12.12.2015;2015;12;00;Lauantai;0;0;0;7;2;9
294;12.12.2015;2015;12;01;Lauantai;0;0;0;0;1;1
294;12.12.2015;2015;12;02;Lauantai;0;1;1;0;2;2
294;12.12.2015;2015;12;03;Lauantai;0;0;0;1;0;1
294;12.12.2015;2015;12;04;Lauantai;1;0;1;0;0;0
294;12.12.2015;2015;12;05;Lauantai;0;0;0;1;0;1
294;12.12.2015;2015;12;06;Lauantai;0;0;0;0;2;2
294;12.12.2015;2015;12;07;Lauantai;0;0;0;1;1;2
294;12.12.2015;2015;12;08;Lauantai;1;0;1;4;7;11
294;12.12.2015;2015;12;09;Lauantai;1;1;2;7;5;12
294;12.12.2015;2015;12;10;Lauantai;2;2;4;12;18;30
294;12.12.2015;2015;12;11;Lauantai;2;4;6;11;25;36
294;12.12.2015;2015;12;12;Lauantai;4;4;8;25;10;35
294;12.12.2015;2015;12;13;Lauantai;3;5;8;15;6;21
294;12.12.2015;2015;12;14;Lauantai;2;1;3;18;18;36
294;12.12.2015;2015;12;15;Lauantai;7;5;12;16;12;28
294;12.12.2015;2015;12;16;Lauantai;2;1;3;14;11;25
294;12.12.2015;2015;12;17;Lauantai;9;3;12;14;7;21
294;12.12.2015;2015;12;18;Lauantai;4;2;6;5;6;11
294;12.12.2015;2015;12;19;Lauantai;3;3;6;9;12;21
294;12.12.2015;2015;12;20;Lauantai;2;5;7;6;3;9
294;12.12.2015;2015;12;21;Lauantai;6;3;9;9;6;15
294;12.12.2015;2015;12;22;Lauantai;4;1;5;3;3;6
294;12.12.2015;2015;12;23;Lauantai;0;1;1;2;1;3
294;13.12.2015;2015;12;00;Sunnuntai;0;0;0;1;1;2
294;13.12.2015;2015;12;01;Sunnuntai;1;0;1;0;1;1
294;13.12.2015;2015;12;02;Sunnuntai;0;0;0;1;2;3
294;13.12.2015;2015;12;03;Sunnuntai;1;0;1;0;0;0
294;13.12.2015;2015;12;04;Sunnuntai;1;0;1;0;0;0
294;13.12.2015;2015;12;05;Sunnuntai;0;0;0;0;0;0
294;13.12.2015;2015;12;06;Sunnuntai;0;0;0;0;2;2
294;13.12.2015;2015;12;07;Sunnuntai;0;0;0;0;4;4
294;13.12.2015;2015;12;08;Sunnuntai;0;0;0;4;4;8
294;13.12.2015;2015;12;09;Sunnuntai;2;0;2;9;3;12
294;13.12.2015;2015;12;10;Sunnuntai;0;1;1;14;10;24
294;13.12.2015;2015;12;11;Sunnuntai;0;2;2;9;8;17
294;13.12.2015;2015;12;12;Sunnuntai;4;2;6;8;9;17
294;13.12.2015;2015;12;13;Sunnuntai;1;1;2;17;9;26
294;13.12.2015;2015;12;14;Sunnuntai;0;2;2;13;8;21
294;13.12.2015;2015;12;15;Sunnuntai;2;7;9;16;8;24
294;13.12.2015;2015;12;16;Sunnuntai;3;1;4;6;12;18
294;13.12.2015;2015;12;17;Sunnuntai;2;3;5;13;8;21
294;13.12.2015;2015;12;18;Sunnuntai;7;0;7;10;11;21
294;13.12.2015;2015;12;19;Sunnuntai;1;4;5;8;8;16
294;13.12.2015;2015;12;20;Sunnuntai;0;6;6;4;5;9
294;13.12.2015;2015;12;21;Sunnuntai;1;0;1;2;2;4
294;13.12.2015;2015;12;22;Sunnuntai;0;0;0;0;0;0
294;13.12.2015;2015;12;23;Sunnuntai;0;1;1;0;0;0
294;14.12.2015;2015;12;00;Maanantai;0;0;0;0;0;0
294;14.12.2015;2015;12;01;Maanantai;0;0;0;0;1;1
294;14.12.2015;2015;12;02;Maanantai;0;0;0;0;0;0
294;14.12.2015;2015;12;03;Maanantai;0;0;0;0;0;0
294;14.12.2015;2015;12;04;Maanantai;0;0;0;0;0;0
294;14.12.2015;2015;12;05;Maanantai;1;0;1;0;1;1
294;14.12.2015;2015;12;06;Maanantai;1;1;2;1;2;3
294;14.12.2015;2015;12;07;Maanantai;3;5;8;8;5;13
294;14.12.2015;2015;12;08;Maanantai;16;4;20;11;5;16
294;14.12.2015;2015;12;09;Maanantai;10;2;12;16;14;30
294;14.12.2015;2015;12;10;Maanantai;2;4;6;15;12;27
294;14.12.2015;2015;12;11;Maanantai;2;6;8;25;26;51
294;14.12.2015;2015;12;12;Maanantai;2;3;5;15;21;36
294;14.12.2015;2015;12;13;Maanantai;3;10;13;12;16;28
294;14.12.2015;2015;12;14;Maanantai;13;12;25;20;25;45
294;14.12.2015;2015;12;15;Maanantai;6;8;14;17;15;32
294;14.12.2015;2015;12;16;Maanantai;8;5;13;7;10;17
294;14.12.2015;2015;12;17;Maanantai;3;0;3;9;12;21
294;14.12.2015;2015;12;18;Maanantai;4;9;13;8;7;15
294;14.12.2015;2015;12;19;Maanantai;2;1;3;5;2;7
294;14.12.2015;2015;12;20;Maanantai;2;2;4;7;5;12
294;14.12.2015;2015;12;21;Maanantai;0;0;0;0;2;2
294;14.12.2015;2015;12;22;Maanantai;0;0;0;0;0;0
294;14.12.2015;2015;12;23;Maanantai;0;0;0;0;0;0
294;15.12.2015;2015;12;00;Tiistai;0;0;0;0;0;0
294;15.12.2015;2015;12;01;Tiistai;0;0;0;0;0;0
294;15.12.2015;2015;12;02;Tiistai;0;0;0;0;0;0
294;15.12.2015;2015;12;03;Tiistai;0;0;0;0;0;0
294;15.12.2015;2015;12;04;Tiistai;0;0;0;0;0;0
294;15.12.2015;2015;12;05;Tiistai;0;1;1;0;0;0
294;15.12.2015;2015;12;06;Tiistai;0;0;0;2;2;4
294;15.12.2015;2015;12;07;Tiistai;5;5;10;8;4;12
294;15.12.2015;2015;12;08;Tiistai;10;2;12;11;5;16
294;15.12.2015;2015;12;09;Tiistai;3;4;7;11;8;19
294;15.12.2015;2015;12;10;Tiistai;3;2;5;6;7;13
294;15.12.2015;2015;12;11;Tiistai;5;3;8;12;15;27
294;15.12.2015;2015;12;12;Tiistai;4;6;10;21;20;41
294;15.12.2015;2015;12;13;Tiistai;8;4;12;16;18;34
294;15.12.2015;2015;12;14;Tiistai;6;7;13;16;16;32
294;15.12.2015;2015;12;15;Tiistai;4;12;16;9;15;24
294;15.12.2015;2015;12;16;Tiistai;6;5;11;10;13;23
294;15.12.2015;2015;12;17;Tiistai;10;5;15;15;17;32
294;15.12.2015;2015;12;18;Tiistai;2;11;13;11;12;23
294;15.12.2015;2015;12;19;Tiistai;2;1;3;11;10;21
294;15.12.2015;2015;12;20;Tiistai;3;4;7;11;4;15
294;15.12.2015;2015;12;21;Tiistai;0;0;0;0;0;0
294;15.12.2015;2015;12;22;Tiistai;0;0;0;1;0;1
294;15.12.2015;2015;12;23;Tiistai;0;1;1;0;1;1
294;16.12.2015;2015;12;00;Keskiviikko;0;0;0;0;1;1
294;16.12.2015;2015;12;01;Keskiviikko;0;0;0;0;0;0
294;16.12.2015;2015;12;02;Keskiviikko;0;0;0;0;0;0
294;16.12.2015;2015;12;03;Keskiviikko;0;0;0;0;0;0
294;16.12.2015;2015;12;04;Keskiviikko;0;0;0;0;0;0
294;16.12.2015;2015;12;05;Keskiviikko;0;2;2;1;1;2
294;16.12.2015;2015;12;06;Keskiviikko;4;0;4;2;2;4
294;16.12.2015;2015;12;07;Keskiviikko;6;1;7;9;3;12
294;16.12.2015;2015;12;08;Keskiviikko;12;3;15;5;5;10
294;16.12.2015;2015;12;09;Keskiviikko;3;5;8;10;11;21
294;16.12.2015;2015;12;10;Keskiviikko;4;1;5;12;21;33
294;16.12.2015;2015;12;11;Keskiviikko;6;4;10;17;22;39
294;16.12.2015;2015;12;12;Keskiviikko;8;10;18;21;16;37
294;16.12.2015;2015;12;13;Keskiviikko;4;5;9;16;21;37
294;16.12.2015;2015;12;14;Keskiviikko;6;10;16;17;22;39
294;16.12.2015;2015;12;15;Keskiviikko;8;8;16;12;15;27
294;16.12.2015;2015;12;16;Keskiviikko;6;5;11;9;17;26
294;16.12.2015;2015;12;17;Keskiviikko;2;6;8;8;11;19
294;16.12.2015;2015;12;18;Keskiviikko;1;0;1;6;13;19
294;16.12.2015;2015;12;19;Keskiviikko;1;0;1;4;5;9
294;16.12.2015;2015;12;20;Keskiviikko;1;2;3;2;1;3
294;16.12.2015;2015;12;21;Keskiviikko;1;0;1;0;1;1
294;16.12.2015;2015;12;22;Keskiviikko;0;0;0;1;0;1
294;16.12.2015;2015;12;23;Keskiviikko;0;0;0;0;0;0
294;17.12.2015;2015;12;00;Torstai;0;0;0;0;0;0
294;17.12.2015;2015;12;01;Torstai;0;0;0;0;0;0
294;17.12.2015;2015;12;02;Torstai;0;0;0;0;0;0
294;17.12.2015;2015;12;03;Torstai;0;0;0;1;0;1
294;17.12.2015;2015;12;04;Torstai;0;0;0;0;0;0
294;17.12.2015;2015;12;05;Torstai;0;1;1;2;0;2
294;17.12.2015;2015;12;06;Torstai;0;1;1;2;1;3
294;17.12.2015;2015;12;07;Torstai;1;3;4;7;9;16
294;17.12.2015;2015;12;08;Torstai;18;5;23;11;5;16
294;17.12.2015;2015;12;09;Torstai;0;2;2;6;6;12
294;17.12.2015;2015;12;10;Torstai;3;3;6;6;8;14
294;17.12.2015;2015;12;11;Torstai;3;2;5;17;10;27
294;17.12.2015;2015;12;12;Torstai;5;3;8;11;18;29
294;17.12.2015;2015;12;13;Torstai;14;8;22;12;12;24
294;17.12.2015;2015;12;14;Torstai;15;10;25;21;17;38
294;17.12.2015;2015;12;15;Torstai;3;13;16;8;13;21
294;17.12.2015;2015;12;16;Torstai;7;4;11;11;11;22
294;17.12.2015;2015;12;17;Torstai;3;2;5;13;14;27
294;17.12.2015;2015;12;18;Torstai;1;2;3;10;4;14
294;17.12.2015;2015;12;19;Torstai;4;3;7;7;4;11
294;17.12.2015;2015;12;20;Torstai;1;2;3;7;4;11
294;17.12.2015;2015;12;21;Torstai;0;0;0;0;0;0
294;17.12.2015;2015;12;22;Torstai;1;0;1;0;1;1
294;17.12.2015;2015;12;23;Torstai;0;0;0;1;0;1
294;18.12.2015;2015;12;00;Perjantai;0;0;0;0;0;0
294;18.12.2015;2015;12;01;Perjantai;1;0;1;0;0;0
294;18.12.2015;2015;12;02;Perjantai;0;0;0;0;0;0
294;18.12.2015;2015;12;03;Perjantai;0;0;0;0;0;0
294;18.12.2015;2015;12;04;Perjantai;0;0;0;0;0;0
294;18.12.2015;2015;12;05;Perjantai;0;0;0;1;0;1
294;18.12.2015;2015;12;06;Perjantai;1;0;1;3;3;6
294;18.12.2015;2015;12;07;Perjantai;3;5;8;5;4;9
294;18.12.2015;2015;12;08;Perjantai;5;7;12;9;6;15
294;18.12.2015;2015;12;09;Perjantai;7;0;7;18;8;26
294;18.12.2015;2015;12;10;Perjantai;3;1;4;9;12;21
294;18.12.2015;2015;12;11;Perjantai;6;5;11;20;17;37
294;18.12.2015;2015;12;12;Perjantai;5;7;12;9;14;23
294;18.12.2015;2015;12;13;Perjantai;24;7;31;42;13;55
294;18.12.2015;2015;12;14;Perjantai;8;18;26;12;22;34
294;18.12.2015;2015;12;15;Perjantai;9;4;13;5;9;14
294;18.12.2015;2015;12;16;Perjantai;6;6;12;12;7;19
294;18.12.2015;2015;12;17;Perjantai;6;12;18;7;8;15
294;18.12.2015;2015;12;18;Perjantai;1;0;1;7;9;16
294;18.12.2015;2015;12;19;Perjantai;2;3;5;9;8;17
294;18.12.2015;2015;12;20;Perjantai;1;0;1;3;3;6
294;18.12.2015;2015;12;21;Perjantai;0;2;2;2;6;8
294;18.12.2015;2015;12;22;Perjantai;3;1;4;3;1;4
294;18.12.2015;2015;12;23;Perjantai;1;0;1;0;0;0
294;19.12.2015;2015;12;00;Lauantai;0;0;0;2;2;4
294;19.12.2015;2015;12;01;Lauantai;1;0;1;0;0;0
294;19.12.2015;2015;12;02;Lauantai;0;0;0;0;1;1
294;19.12.2015;2015;12;03;Lauantai;0;0;0;1;1;2
294;19.12.2015;2015;12;04;Lauantai;0;0;0;0;0;0
294;19.12.2015;2015;12;05;Lauantai;0;0;0;0;0;0
294;19.12.2015;2015;12;06;Lauantai;1;0;1;1;4;5
294;19.12.2015;2015;12;07;Lauantai;1;1;2;2;2;4
294;19.12.2015;2015;12;08;Lauantai;4;1;5;5;3;8
294;19.12.2015;2015;12;09;Lauantai;3;3;6;15;8;23
294;19.12.2015;2015;12;10;Lauantai;0;0;0;9;9;18
294;19.12.2015;2015;12;11;Lauantai;2;12;14;10;24;34
294;19.12.2015;2015;12;12;Lauantai;11;6;17;14;13;27
294;19.12.2015;2015;12;13;Lauantai;2;3;5;16;15;31
294;19.12.2015;2015;12;14;Lauantai;5;5;10;10;9;19
294;19.12.2015;2015;12;15;Lauantai;1;4;5;15;18;33
294;19.12.2015;2015;12;16;Lauantai;1;4;5;12;17;29
294;19.12.2015;2015;12;17;Lauantai;4;9;13;14;12;26
294;19.12.2015;2015;12;18;Lauantai;7;2;9;8;10;18
294;19.12.2015;2015;12;19;Lauantai;1;7;8;6;12;18
294;19.12.2015;2015;12;20;Lauantai;0;3;3;6;6;12
294;19.12.2015;2015;12;21;Lauantai;1;3;4;8;1;9
294;19.12.2015;2015;12;22;Lauantai;2;3;5;5;2;7
294;19.12.2015;2015;12;23;Lauantai;4;0;4;1;0;1
294;20.12.2015;2015;12;00;Sunnuntai;0;0;0;0;0;0
294;20.12.2015;2015;12;01;Sunnuntai;1;0;1;0;0;0
294;20.12.2015;2015;12;02;Sunnuntai;0;0;0;0;0;0
294;20.12.2015;2015;12;03;Sunnuntai;0;0;0;0;0;0
294;20.12.2015;2015;12;04;Sunnuntai;0;0;0;0;0;0
294;20.12.2015;2015;12;05;Sunnuntai;1;0;1;0;0;0
294;20.12.2015;2015;12;06;Sunnuntai;0;0;0;3;1;4
294;20.12.2015;2015;12;07;Sunnuntai;0;0;0;0;1;1
294;20.12.2015;2015;12;08;Sunnuntai;0;0;0;3;5;8
294;20.12.2015;2015;12;09;Sunnuntai;0;0;0;10;6;16
294;20.12.2015;2015;12;10;Sunnuntai;2;2;4;21;8;29
294;20.12.2015;2015;12;11;Sunnuntai;0;0;0;5;4;9
294;20.12.2015;2015;12;12;Sunnuntai;2;2;4;15;6;21
294;20.12.2015;2015;12;13;Sunnuntai;5;2;7;6;5;11
294;20.12.2015;2015;12;14;Sunnuntai;1;0;1;3;6;9
294;20.12.2015;2015;12;15;Sunnuntai;0;1;1;8;5;13
294;20.12.2015;2015;12;16;Sunnuntai;4;4;8;19;7;26
294;20.12.2015;2015;12;17;Sunnuntai;1;0;1;9;11;20
294;20.12.2015;2015;12;18;Sunnuntai;3;1;4;7;12;19
294;20.12.2015;2015;12;19;Sunnuntai;2;5;7;5;9;14
294;20.12.2015;2015;12;20;Sunnuntai;1;1;2;1;5;6
294;20.12.2015;2015;12;21;Sunnuntai;1;0;1;2;2;4
294;20.12.2015;2015;12;22;Sunnuntai;2;0;2;2;1;3
294;20.12.2015;2015;12;23;Sunnuntai;0;1;1;1;0;1
294;21.12.2015;2015;12;00;Maanantai;0;0;0;1;0;1
294;21.12.2015;2015;12;01;Maanantai;0;0;0;0;0;0
294;21.12.2015;2015;12;02;Maanantai;0;0;0;0;0;0
294;21.12.2015;2015;12;03;Maanantai;0;0;0;0;0;0
294;21.12.2015;2015;12;04;Maanantai;0;0;0;0;0;0
294;21.12.2015;2015;12;05;Maanantai;0;0;0;0;0;0
294;21.12.2015;2015;12;06;Maanantai;0;1;1;0;2;2
294;21.12.2015;2015;12;07;Maanantai;0;0;0;9;3;12
294;21.12.2015;2015;12;08;Maanantai;1;0;1;3;4;7
294;21.12.2015;2015;12;09;Maanantai;0;0;0;7;6;13
294;21.12.2015;2015;12;10;Maanantai;2;0;2;3;6;9
294;21.12.2015;2015;12;11;Maanantai;2;3;5;12;5;17
294;21.12.2015;2015;12;12;Maanantai;5;5;10;8;10;18
294;21.12.2015;2015;12;13;Maanantai;4;3;7;18;5;23
294;21.12.2015;2015;12;14;Maanantai;3;2;5;9;14;23
294;21.12.2015;2015;12;15;Maanantai;10;4;14;10;10;20
294;21.12.2015;2015;12;16;Maanantai;1;2;3;7;10;17
294;21.12.2015;2015;12;17;Maanantai;2;1;3;4;10;14
294;21.12.2015;2015;12;18;Maanantai;4;11;15;11;8;19
294;21.12.2015;2015;12;19;Maanantai;1;2;3;11;5;16
294;21.12.2015;2015;12;20;Maanantai;2;0;2;4;5;9
294;21.12.2015;2015;12;21;Maanantai;1;0;1;2;4;6
294;21.12.2015;2015;12;22;Maanantai;0;1;1;0;0;0
294;21.12.2015;2015;12;23;Maanantai;2;0;2;0;0;0
294;22.12.2015;2015;12;00;Tiistai;0;0;0;0;0;0
294;22.12.2015;2015;12;01;Tiistai;0;1;1;0;0;0
294;22.12.2015;2015;12;02;Tiistai;0;0;0;1;0;1
294;22.12.2015;2015;12;03;Tiistai;0;0;0;0;0;0
294;22.12.2015;2015;12;04;Tiistai;0;0;0;0;0;0
294;22.12.2015;2015;12;05;Tiistai;0;0;0;0;0;0
294;22.12.2015;2015;12;06;Tiistai;1;1;2;4;1;5
294;22.12.2015;2015;12;07;Tiistai;1;0;1;4;3;7
294;22.12.2015;2015;12;08;Tiistai;0;1;1;3;3;6
294;22.12.2015;2015;12;09;Tiistai;2;0;2;8;7;15
294;22.12.2015;2015;12;10;Tiistai;1;3;4;6;4;10
294;22.12.2015;2015;12;11;Tiistai;2;0;2;6;8;14
294;22.12.2015;2015;12;12;Tiistai;4;1;5;8;12;20
294;22.12.2015;2015;12;13;Tiistai;6;4;10;13;4;17
294;22.12.2015;2015;12;14;Tiistai;4;3;7;6;6;12
294;22.12.2015;2015;12;15;Tiistai;3;7;10;8;11;19
294;22.12.2015;2015;12;16;Tiistai;3;8;11;5;5;10
294;22.12.2015;2015;12;17;Tiistai;3;1;4;7;11;18
294;22.12.2015;2015;12;18;Tiistai;3;3;6;8;5;13
294;22.12.2015;2015;12;19;Tiistai;1;1;2;6;6;12
294;22.12.2015;2015;12;20;Tiistai;0;0;0;8;6;14
294;22.12.2015;2015;12;21;Tiistai;0;1;1;1;2;3
294;22.12.2015;2015;12;22;Tiistai;0;0;0;6;2;8
294;22.12.2015;2015;12;23;Tiistai;0;1;1;0;0;0
294;23.12.2015;2015;12;00;Keskiviikko;0;0;0;0;0;0
294;23.12.2015;2015;12;01;Keskiviikko;0;0;0;0;0;0
294;23.12.2015;2015;12;02;Keskiviikko;0;0;0;1;0;1
294;23.12.2015;2015;12;03;Keskiviikko;0;0;0;0;0;0
294;23.12.2015;2015;12;04;Keskiviikko;0;0;0;0;0;0
294;23.12.2015;2015;12;05;Keskiviikko;0;0;0;1;2;3
294;23.12.2015;2015;12;06;Keskiviikko;0;1;1;1;0;1
294;23.12.2015;2015;12;07;Keskiviikko;0;0;0;1;3;4
294;23.12.2015;2015;12;08;Keskiviikko;1;1;2;8;3;11
294;23.12.2015;2015;12;09;Keskiviikko;1;1;2;7;6;13
294;23.12.2015;2015;12;10;Keskiviikko;2;4;6;3;6;9
294;23.12.2015;2015;12;11;Keskiviikko;0;1;1;7;8;15
294;23.12.2015;2015;12;12;Keskiviikko;2;3;5;12;8;20
294;23.12.2015;2015;12;13;Keskiviikko;8;1;9;16;8;24
294;23.12.2015;2015;12;14;Keskiviikko;3;1;4;6;16;22
294;23.12.2015;2015;12;15;Keskiviikko;5;7;12;10;7;17
294;23.12.2015;2015;12;16;Keskiviikko;2;1;3;5;6;11
294;23.12.2015;2015;12;17;Keskiviikko;1;1;2;7;15;22
294;23.12.2015;2015;12;18;Keskiviikko;1;1;2;18;8;26
294;23.12.2015;2015;12;19;Keskiviikko;2;2;4;7;5;12
294;23.12.2015;2015;12;20;Keskiviikko;2;3;5;4;4;8
294;23.12.2015;2015;12;21;Keskiviikko;1;1;2;1;2;3
294;23.12.2015;2015;12;22;Keskiviikko;0;0;0;0;1;1
294;23.12.2015;2015;12;23;Keskiviikko;1;0;1;2;0;2
294;24.12.2015;2015;12;00;Torstai;0;0;0;0;1;1
294;24.12.2015;2015;12;01;Torstai;0;0;0;0;0;0
294;24.12.2015;2015;12;02;Torstai;0;0;0;0;0;0
294;24.12.2015;2015;12;03;Torstai;3;1;4;3;2;5
294;24.12.2015;2015;12;04;Torstai;0;0;0;0;0;0
294;24.12.2015;2015;12;05;Torstai;0;0;0;0;0;0
294;24.12.2015;2015;12;06;Torstai;0;0;0;4;2;6
294;24.12.2015;2015;12;07;Torstai;0;0;0;3;1;4
294;24.12.2015;2015;12;08;Torstai;0;0;0;8;7;15
294;24.12.2015;2015;12;09;Torstai;3;2;5;8;12;20
294;24.12.2015;2015;12;10;Torstai;2;1;3;11;9;20
294;24.12.2015;2015;12;11;Torstai;1;2;3;8;6;14
294;24.12.2015;2015;12;12;Torstai;0;0;0;2;4;6
294;24.12.2015;2015;12;13;Torstai;0;0;0;5;4;9
294;24.12.2015;2015;12;14;Torstai;0;0;0;6;5;11
294;24.12.2015;2015;12;15;Torstai;1;2;3;4;1;5
294;24.12.2015;2015;12;16;Torstai;5;2;7;1;0;1
294;24.12.2015;2015;12;17;Torstai;0;0;0;1;2;3
294;24.12.2015;2015;12;18;Torstai;0;0;0;5;4;9
294;24.12.2015;2015;12;19;Torstai;0;0;0;4;6;10
294;24.12.2015;2015;12;20;Torstai;0;2;2;2;1;3
294;24.12.2015;2015;12;21;Torstai;0;0;0;2;0;2
294;24.12.2015;2015;12;22;Torstai;0;0;0;3;3;6
294;24.12.2015;2015;12;23;Torstai;0;0;0;0;2;2
294;25.12.2015;2015;12;00;Perjantai;0;0;0;0;0;0
294;25.12.2015;2015;12;01;Perjantai;0;0;0;0;0;0
294;25.12.2015;2015;12;02;Perjantai;0;0;0;0;0;0
294;25.12.2015;2015;12;03;Perjantai;0;0;0;0;0;0
294;25.12.2015;2015;12;04;Perjantai;0;0;0;0;0;0
294;25.12.2015;2015;12;05;Perjantai;0;0;0;0;0;0
294;25.12.2015;2015;12;06;Perjantai;0;0;0;1;1;2
294;25.12.2015;2015;12;07;Perjantai;1;0;1;1;1;2
294;25.12.2015;2015;12;08;Perjantai;1;0;1;2;1;3
294;25.12.2015;2015;12;09;Perjantai;0;0;0;3;4;7
294;25.12.2015;2015;12;10;Perjantai;0;2;2;12;10;22
294;25.12.2015;2015;12;11;Perjantai;1;1;2;3;8;11
294;25.12.2015;2015;12;12;Perjantai;0;0;0;6;16;22
294;25.12.2015;2015;12;13;Perjantai;1;1;2;4;4;8
294;25.12.2015;2015;12;14;Perjantai;3;0;3;8;6;14
294;25.12.2015;2015;12;15;Perjantai;2;2;4;9;7;16
294;25.12.2015;2015;12;16;Perjantai;2;0;2;13;10;23
294;25.12.2015;2015;12;17;Perjantai;1;2;3;7;7;14
294;25.12.2015;2015;12;18;Perjantai;0;0;0;5;8;13
294;25.12.2015;2015;12;19;Perjantai;0;0;0;6;4;10
294;25.12.2015;2015;12;20;Perjantai;0;0;0;6;7;13
294;25.12.2015;2015;12;21;Perjantai;0;0;0;1;4;5
294;25.12.2015;2015;12;22;Perjantai;0;0;0;0;0;0
294;25.12.2015;2015;12;23;Perjantai;0;0;0;0;2;2
294;26.12.2015;2015;12;00;Lauantai;0;0;0;0;0;0
294;26.12.2015;2015;12;01;Lauantai;0;0;0;2;0;2
294;26.12.2015;2015;12;02;Lauantai;0;0;0;0;4;4
294;26.12.2015;2015;12;03;Lauantai;0;0;0;1;0;1
294;26.12.2015;2015;12;04;Lauantai;0;0;0;0;1;1
294;26.12.2015;2015;12;05;Lauantai;1;0;1;0;0;0
294;26.12.2015;2015;12;06;Lauantai;0;0;0;1;2;3
294;26.12.2015;2015;12;07;Lauantai;0;1;1;0;2;2
294;26.12.2015;2015;12;08;Lauantai;0;0;0;2;3;5
294;26.12.2015;2015;12;09;Lauantai;0;0;0;2;3;5
294;26.12.2015;2015;12;10;Lauantai;0;0;0;10;5;15
294;26.12.2015;2015;12;11;Lauantai;2;1;3;10;8;18
294;26.12.2015;2015;12;12;Lauantai;0;2;2;22;18;40
294;26.12.2015;2015;12;13;Lauantai;6;3;9;20;13;33
294;26.12.2015;2015;12;14;Lauantai;0;0;0;13;12;25
294;26.12.2015;2015;12;15;Lauantai;5;1;6;8;12;20
294;26.12.2015;2015;12;16;Lauantai;0;1;1;11;6;17
294;26.12.2015;2015;12;17;Lauantai;3;1;4;8;7;15
294;26.12.2015;2015;12;18;Lauantai;1;4;5;7;6;13
294;26.12.2015;2015;12;19;Lauantai;2;2;4;7;2;9
294;26.12.2015;2015;12;20;Lauantai;0;1;1;7;5;12
294;26.12.2015;2015;12;21;Lauantai;0;0;0;2;2;4
294;26.12.2015;2015;12;22;Lauantai;0;0;0;1;1;2
294;26.12.2015;2015;12;23;Lauantai;0;1;1;0;1;1
294;27.12.2015;2015;12;00;Sunnuntai;0;0;0;0;0;0
294;27.12.2015;2015;12;01;Sunnuntai;0;0;0;0;0;0
294;27.12.2015;2015;12;02;Sunnuntai;0;0;0;0;0;0
294;27.12.2015;2015;12;03;Sunnuntai;0;0;0;1;0;1
294;27.12.2015;2015;12;04;Sunnuntai;0;0;0;0;0;0
294;27.12.2015;2015;12;05;Sunnuntai;0;0;0;1;0;1
294;27.12.2015;2015;12;06;Sunnuntai;0;0;0;1;1;2
294;27.12.2015;2015;12;07;Sunnuntai;0;0;0;1;4;5
294;27.12.2015;2015;12;08;Sunnuntai;0;0;0;1;3;4
294;27.12.2015;2015;12;09;Sunnuntai;0;0;0;11;7;18
294;27.12.2015;2015;12;10;Sunnuntai;0;0;0;9;5;14
294;27.12.2015;2015;12;11;Sunnuntai;0;0;0;10;13;23
294;27.12.2015;2015;12;12;Sunnuntai;4;3;7;19;11;30
294;27.12.2015;2015;12;13;Sunnuntai;0;2;2;8;8;16
294;27.12.2015;2015;12;14;Sunnuntai;1;2;3;18;14;32
294;27.12.2015;2015;12;15;Sunnuntai;3;4;7;5;11;16
294;27.12.2015;2015;12;16;Sunnuntai;2;2;4;11;3;14
294;27.12.2015;2015;12;17;Sunnuntai;1;1;2;10;12;22
294;27.12.2015;2015;12;18;Sunnuntai;3;0;3;9;9;18
294;27.12.2015;2015;12;19;Sunnuntai;2;3;5;16;10;26
294;27.12.2015;2015;12;20;Sunnuntai;3;3;6;3;4;7
294;27.12.2015;2015;12;21;Sunnuntai;0;2;2;1;4;5
294;27.12.2015;2015;12;22;Sunnuntai;0;0;0;0;0;0
294;27.12.2015;2015;12;23;Sunnuntai;2;1;3;1;0;1
294;28.12.2015;2015;12;00;Maanantai;0;0;0;0;1;1
294;28.12.2015;2015;12;01;Maanantai;0;0;0;0;0;0
294;28.12.2015;2015;12;02;Maanantai;0;0;0;0;1;1
294;28.12.2015;2015;12;03;Maanantai;0;0;0;0;0;0
294;28.12.2015;2015;12;04;Maanantai;0;0;0;1;0;1
294;28.12.2015;2015;12;05;Maanantai;0;0;0;0;1;1
294;28.12.2015;2015;12;06;Maanantai;0;0;0;1;4;5
294;28.12.2015;2015;12;07;Maanantai;0;0;0;4;1;5
294;28.12.2015;2015;12;08;Maanantai;0;1;1;6;2;8
294;28.12.2015;2015;12;09;Maanantai;2;0;2;8;8;16
294;28.12.2015;2015;12;10;Maanantai;0;1;1;8;11;19
294;28.12.2015;2015;12;11;Maanantai;3;5;8;10;9;19
294;28.12.2015;2015;12;12;Maanantai;4;5;9;22;10;32
294;28.12.2015;2015;12;13;Maanantai;5;1;6;14;17;31
294;28.12.2015;2015;12;14;Maanantai;4;4;8;21;12;33
294;28.12.2015;2015;12;15;Maanantai;3;5;8;13;18;31
294;28.12.2015;2015;12;16;Maanantai;4;4;8;5;11;16
294;28.12.2015;2015;12;17;Maanantai;4;3;7;7;9;16
294;28.12.2015;2015;12;18;Maanantai;1;2;3;8;8;16
294;28.12.2015;2015;12;19;Maanantai;0;0;0;3;3;6
294;28.12.2015;2015;12;20;Maanantai;1;2;3;2;3;5
294;28.12.2015;2015;12;21;Maanantai;0;0;0;9;2;11
294;28.12.2015;2015;12;22;Maanantai;0;1;1;0;1;1
294;28.12.2015;2015;12;23;Maanantai;1;0;1;1;1;2
294;29.12.2015;2015;12;00;Tiistai;0;0;0;1;0;1
294;29.12.2015;2015;12;01;Tiistai;0;0;0;0;0;0
294;29.12.2015;2015;12;02;Tiistai;0;0;0;0;0;0
294;29.12.2015;2015;12;03;Tiistai;0;0;0;0;0;0
294;29.12.2015;2015;12;04;Tiistai;0;0;0;0;0;0
294;29.12.2015;2015;12;05;Tiistai;0;0;0;2;0;2
294;29.12.2015;2015;12;06;Tiistai;0;1;1;1;0;1
294;29.12.2015;2015;12;07;Tiistai;0;0;0;1;3;4
294;29.12.2015;2015;12;08;Tiistai;0;1;1;5;1;6
294;29.12.2015;2015;12;09;Tiistai;0;2;2;4;4;8
294;29.12.2015;2015;12;10;Tiistai;2;0;2;6;5;11
294;29.12.2015;2015;12;11;Tiistai;2;3;5;6;5;11
294;29.12.2015;2015;12;12;Tiistai;2;0;2;12;15;27
294;29.12.2015;2015;12;13;Tiistai;1;2;3;18;11;29
294;29.12.2015;2015;12;14;Tiistai;3;2;5;13;13;26
294;29.12.2015;2015;12;15;Tiistai;7;4;11;11;12;23
294;29.12.2015;2015;12;16;Tiistai;3;1;4;11;7;18
294;29.12.2015;2015;12;17;Tiistai;0;1;1;8;10;18
294;29.12.2015;2015;12;18;Tiistai;0;0;0;17;12;29
294;29.12.2015;2015;12;19;Tiistai;2;3;5;7;10;17
294;29.12.2015;2015;12;20;Tiistai;3;3;6;12;14;26
294;29.12.2015;2015;12;21;Tiistai;1;0;1;5;1;6
294;29.12.2015;2015;12;22;Tiistai;0;0;0;1;2;3
294;29.12.2015;2015;12;23;Tiistai;0;2;2;2;0;2
294;30.12.2015;2015;12;00;Keskiviikko;0;0;0;1;1;2
294;30.12.2015;2015;12;01;Keskiviikko;0;0;0;0;0;0
294;30.12.2015;2015;12;02;Keskiviikko;0;0;0;0;0;0
294;30.12.2015;2015;12;03;Keskiviikko;1;0;1;0;0;0
294;30.12.2015;2015;12;04;Keskiviikko;0;0;0;0;0;0
294;30.12.2015;2015;12;05;Keskiviikko;0;0;0;2;0;2
294;30.12.2015;2015;12;06;Keskiviikko;0;1;1;3;2;5
294;30.12.2015;2015;12;07;Keskiviikko;1;0;1;1;2;3
294;30.12.2015;2015;12;08;Keskiviikko;0;1;1;6;4;10
294;30.12.2015;2015;12;09;Keskiviikko;1;0;1;13;7;20
294;30.12.2015;2015;12;10;Keskiviikko;0;4;4;13;13;26
294;30.12.2015;2015;12;11;Keskiviikko;1;1;2;12;14;26
294;30.12.2015;2015;12;12;Keskiviikko;2;0;2;15;9;24
294;30.12.2015;2015;12;13;Keskiviikko;3;0;3;6;5;11
294;30.12.2015;2015;12;14;Keskiviikko;3;5;8;9;8;17
294;30.12.2015;2015;12;15;Keskiviikko;3;5;8;11;12;23
294;30.12.2015;2015;12;16;Keskiviikko;0;1;1;12;14;26
294;30.12.2015;2015;12;17;Keskiviikko;1;2;3;20;14;34
294;30.12.2015;2015;12;18;Keskiviikko;1;1;2;17;5;22
294;30.12.2015;2015;12;19;Keskiviikko;6;6;12;20;17;37
294;30.12.2015;2015;12;20;Keskiviikko;3;3;6;7;7;14
294;30.12.2015;2015;12;21;Keskiviikko;5;2;7;6;9;15
294;30.12.2015;2015;12;22;Keskiviikko;1;3;4;6;5;11
294;30.12.2015;2015;12;23;Keskiviikko;0;0;0;1;0;1
294;31.12.2015;2015;12;00;Torstai;0;0;0;0;1;1
294;31.12.2015;2015;12;01;Torstai;0;0;0;0;0;0
294;31.12.2015;2015;12;02;Torstai;0;1;1;0;0;0
294;31.12.2015;2015;12;03;Torstai;0;0;0;0;0;0
294;31.12.2015;2015;12;04;Torstai;0;0;0;0;0;0
294;31.12.2015;2015;12;05;Torstai;0;0;0;1;0;1
294;31.12.2015;2015;12;06;Torstai;0;1;1;3;3;6
294;31.12.2015;2015;12;07;Torstai;1;0;1;0;1;1
294;31.12.2015;2015;12;08;Torstai;0;1;1;5;1;6
294;31.12.2015;2015;12;09;Torstai;2;2;4;8;11;19
294;31.12.2015;2015;12;10;Torstai;1;1;2;14;9;23
294;31.12.2015;2015;12;11;Torstai;4;2;6;18;21;39
294;31.12.2015;2015;12;12;Torstai;2;7;9;31;16;47
294;31.12.2015;2015;12;13;Torstai;3;2;5;11;12;23
294;31.12.2015;2015;12;14;Torstai;7;5;12;14;8;22
294;31.12.2015;2015;12;15;Torstai;7;4;11;10;8;18
294;31.12.2015;2015;12;16;Torstai;9;8;17;13;14;27
294;31.12.2015;2015;12;17;Torstai;3;6;9;7;7;14
294;31.12.2015;2015;12;18;Torstai;0;0;0;10;8;18
294;31.12.2015;2015;12;19;Torstai;0;1;1;9;1;10
294;31.12.2015;2015;12;20;Torstai;0;0;0;10;7;17
294;31.12.2015;2015;12;21;Torstai;2;0;2;3;2;5
294;31.12.2015;2015;12;22;Torstai;1;1;2;1;6;7
294;31.12.2015;2015;12;23;Torstai;1;0;1;4;3;7
294;01.01.2016;2016;01;00;Perjantai;1;0;1;2;0;2
294;01.01.2016;2016;01;01;Perjantai;0;1;1;0;1;1
294;01.01.2016;2016;01;02;Perjantai;4;1;5;1;0;1
294;01.01.2016;2016;01;03;Perjantai;0;1;1;4;1;5
294;01.01.2016;2016;01;04;Perjantai;0;0;0;2;1;3
294;01.01.2016;2016;01;05;Perjantai;0;0;0;1;0;1
294;01.01.2016;2016;01;06;Perjantai;0;0;0;7;8;15
294;01.01.2016;2016;01;07;Perjantai;0;0;0;0;0;0
294;01.01.2016;2016;01;08;Perjantai;0;0;0;3;0;3
294;01.01.2016;2016;01;09;Perjantai;0;1;1;6;5;11
294;01.01.2016;2016;01;10;Perjantai;0;1;1;9;7;16
294;01.01.2016;2016;01;11;Perjantai;1;2;3;16;10;26
294;01.01.2016;2016;01;12;Perjantai;5;1;6;13;5;18
294;01.01.2016;2016;01;13;Perjantai;2;0;2;20;19;39
294;01.01.2016;2016;01;14;Perjantai;2;0;2;16;11;27
294;01.01.2016;2016;01;15;Perjantai;2;0;2;13;11;24
294;01.01.2016;2016;01;16;Perjantai;1;2;3;10;8;18
294;01.01.2016;2016;01;17;Perjantai;0;1;1;15;16;31
294;01.01.2016;2016;01;18;Perjantai;3;6;9;11;12;23
294;01.01.2016;2016;01;19;Perjantai;4;4;8;10;12;22
294;01.01.2016;2016;01;20;Perjantai;0;1;1;8;4;12
294;01.01.2016;2016;01;21;Perjantai;2;0;2;4;2;6
294;01.01.2016;2016;01;22;Perjantai;4;1;5;0;2;2
294;01.01.2016;2016;01;23;Perjantai;2;2;4;0;0;0
294;02.01.2016;2016;01;00;Lauantai;0;0;0;0;0;0
294;02.01.2016;2016;01;01;Lauantai;0;0;0;2;1;3
294;02.01.2016;2016;01;02;Lauantai;0;0;0;0;0;0
294;02.01.2016;2016;01;03;Lauantai;0;0;0;1;0;1
294;02.01.2016;2016;01;04;Lauantai;0;0;0;1;0;1
294;02.01.2016;2016;01;05;Lauantai;1;1;2;1;0;1
294;02.01.2016;2016;01;06;Lauantai;1;0;1;0;0;0
294;02.01.2016;2016;01;07;Lauantai;1;1;2;1;3;4
294;02.01.2016;2016;01;08;Lauantai;0;0;0;4;1;5
294;02.01.2016;2016;01;09;Lauantai;0;0;0;5;3;8
294;02.01.2016;2016;01;10;Lauantai;0;1;1;10;8;18
294;02.01.2016;2016;01;11;Lauantai;3;2;5;5;9;14
294;02.01.2016;2016;01;12;Lauantai;1;0;1;14;21;35
294;02.01.2016;2016;01;13;Lauantai;2;1;3;11;14;25
294;02.01.2016;2016;01;14;Lauantai;1;3;4;10;7;17
294;02.01.2016;2016;01;15;Lauantai;6;5;11;12;8;20
294;02.01.2016;2016;01;16;Lauantai;1;1;2;10;9;19
294;02.01.2016;2016;01;17;Lauantai;2;3;5;12;11;23
294;02.01.2016;2016;01;18;Lauantai;6;4;10;1;4;5
294;02.01.2016;2016;01;19;Lauantai;2;2;4;3;4;7
294;02.01.2016;2016;01;20;Lauantai;2;1;3;3;3;6
294;02.01.2016;2016;01;21;Lauantai;1;2;3;1;4;5
294;02.01.2016;2016;01;22;Lauantai;1;0;1;0;2;2
294;02.01.2016;2016;01;23;Lauantai;1;0;1;0;0;0
294;03.01.2016;2016;01;00;Sunnuntai;1;0;1;0;1;1
294;03.01.2016;2016;01;01;Sunnuntai;1;0;1;0;0;0
294;03.01.2016;2016;01;02;Sunnuntai;0;0;0;0;0;0
294;03.01.2016;2016;01;03;Sunnuntai;0;0;0;0;0;0
294;03.01.2016;2016;01;04;Sunnuntai;0;0;0;0;0;0
294;03.01.2016;2016;01;05;Sunnuntai;0;0;0;0;0;0
294;03.01.2016;2016;01;06;Sunnuntai;0;0;0;3;2;5
294;03.01.2016;2016;01;07;Sunnuntai;0;0;0;0;4;4
294;03.01.2016;2016;01;08;Sunnuntai;0;0;0;1;0;1
294;03.01.2016;2016;01;09;Sunnuntai;0;0;0;13;7;20
294;03.01.2016;2016;01;10;Sunnuntai;1;0;1;8;6;14
294;03.01.2016;2016;01;11;Sunnuntai;1;0;1;4;14;18
294;03.01.2016;2016;01;12;Sunnuntai;0;1;1;12;4;16
294;03.01.2016;2016;01;13;Sunnuntai;2;3;5;9;10;19
294;03.01.2016;2016;01;14;Sunnuntai;1;2;3;9;12;21
294;03.01.2016;2016;01;15;Sunnuntai;1;0;1;13;11;24
294;03.01.2016;2016;01;16;Sunnuntai;3;2;5;10;12;22
294;03.01.2016;2016;01;17;Sunnuntai;7;4;11;21;13;34
294;03.01.2016;2016;01;18;Sunnuntai;1;6;7;11;10;21
294;03.01.2016;2016;01;19;Sunnuntai;2;2;4;15;12;27
294;03.01.2016;2016;01;20;Sunnuntai;4;1;5;3;5;8
294;03.01.2016;2016;01;21;Sunnuntai;0;0;0;3;1;4
294;03.01.2016;2016;01;22;Sunnuntai;0;0;0;0;2;2
294;03.01.2016;2016;01;23;Sunnuntai;0;0;0;0;0;0
294;04.01.2016;2016;01;00;Maanantai;0;0;0;0;0;0
294;04.01.2016;2016;01;01;Maanantai;0;0;0;0;0;0
294;04.01.2016;2016;01;02;Maanantai;0;0;0;0;0;0
294;04.01.2016;2016;01;03;Maanantai;0;0;0;0;0;0
294;04.01.2016;2016;01;04;Maanantai;0;0;0;0;0;0
294;04.01.2016;2016;01;05;Maanantai;0;0;0;1;0;1
294;04.01.2016;2016;01;06;Maanantai;0;0;0;1;1;2
294;04.01.2016;2016;01;07;Maanantai;1;1;2;3;2;5
294;04.01.2016;2016;01;08;Maanantai;0;0;0;4;4;8
294;04.01.2016;2016;01;09;Maanantai;2;1;3;9;6;15
294;04.01.2016;2016;01;10;Maanantai;2;2;4;3;5;8
294;04.01.2016;2016;01;11;Maanantai;1;2;3;7;10;17
294;04.01.2016;2016;01;12;Maanantai;0;0;0;11;14;25
294;04.01.2016;2016;01;13;Maanantai;3;1;4;10;16;26
294;04.01.2016;2016;01;14;Maanantai;1;1;2;11;12;23
294;04.01.2016;2016;01;15;Maanantai;0;1;1;9;13;22
294;04.01.2016;2016;01;16;Maanantai;1;0;1;6;10;16
294;04.01.2016;2016;01;17;Maanantai;4;5;9;17;6;23
294;04.01.2016;2016;01;18;Maanantai;4;2;6;12;5;17
294;04.01.2016;2016;01;19;Maanantai;0;3;3;15;14;29
294;04.01.2016;2016;01;20;Maanantai;3;1;4;6;7;13
294;04.01.2016;2016;01;21;Maanantai;0;2;2;3;2;5
294;04.01.2016;2016;01;22;Maanantai;1;0;1;0;0;0
294;04.01.2016;2016;01;23;Maanantai;0;0;0;0;2;2
294;05.01.2016;2016;01;00;Tiistai;0;0;0;0;0;0
294;05.01.2016;2016;01;01;Tiistai;0;0;0;0;0;0
294;05.01.2016;2016;01;02;Tiistai;0;0;0;0;0;0
294;05.01.2016;2016;01;03;Tiistai;0;0;0;0;0;0
294;05.01.2016;2016;01;04;Tiistai;0;0;0;0;0;0
294;05.01.2016;2016;01;05;Tiistai;0;0;0;1;0;1
294;05.01.2016;2016;01;06;Tiistai;0;1;1;3;2;5
294;05.01.2016;2016;01;07;Tiistai;1;0;1;2;2;4
294;05.01.2016;2016;01;08;Tiistai;0;0;0;6;3;9
294;05.01.2016;2016;01;09;Tiistai;0;1;1;7;6;13
294;05.01.2016;2016;01;10;Tiistai;4;2;6;4;14;18
294;05.01.2016;2016;01;11;Tiistai;4;2;6;4;9;13
294;05.01.2016;2016;01;12;Tiistai;2;1;3;10;6;16
294;05.01.2016;2016;01;13;Tiistai;1;2;3;8;13;21
294;05.01.2016;2016;01;14;Tiistai;4;2;6;11;15;26
294;05.01.2016;2016;01;15;Tiistai;2;6;8;12;9;21
294;05.01.2016;2016;01;16;Tiistai;4;5;9;7;11;18
294;05.01.2016;2016;01;17;Tiistai;0;3;3;8;1;9
294;05.01.2016;2016;01;18;Tiistai;1;0;1;3;1;4
294;05.01.2016;2016;01;19;Tiistai;2;1;3;4;2;6
294;05.01.2016;2016;01;20;Tiistai;0;3;3;2;4;6
294;05.01.2016;2016;01;21;Tiistai;0;0;0;1;0;1
294;05.01.2016;2016;01;22;Tiistai;0;0;0;1;0;1
294;05.01.2016;2016;01;23;Tiistai;1;0;1;0;0;0
294;06.01.2016;2016;01;00;Keskiviikko;1;1;2;1;1;2
294;06.01.2016;2016;01;01;Keskiviikko;1;0;1;0;0;0
294;06.01.2016;2016;01;02;Keskiviikko;0;0;0;0;0;0
294;06.01.2016;2016;01;03;Keskiviikko;0;0;0;1;0;1
294;06.01.2016;2016;01;04;Keskiviikko;0;0;0;0;0;0
294;06.01.2016;2016;01;05;Keskiviikko;0;0;0;0;0;0
294;06.01.2016;2016;01;06;Keskiviikko;0;0;0;1;4;5
294;06.01.2016;2016;01;07;Keskiviikko;0;0;0;0;1;1
294;06.01.2016;2016;01;08;Keskiviikko;1;0;1;0;0;0
294;06.01.2016;2016;01;09;Keskiviikko;0;0;0;2;2;4
294;06.01.2016;2016;01;10;Keskiviikko;0;1;1;0;1;1
294;06.01.2016;2016;01;11;Keskiviikko;0;0;0;3;2;5
294;06.01.2016;2016;01;12;Keskiviikko;2;3;5;10;7;17
294;06.01.2016;2016;01;13;Keskiviikko;1;1;2;7;6;13
294;06.01.2016;2016;01;14;Keskiviikko;2;0;2;3;8;11
294;06.01.2016;2016;01;15;Keskiviikko;0;2;2;3;6;9
294;06.01.2016;2016;01;16;Keskiviikko;0;1;1;3;0;3
294;06.01.2016;2016;01;17;Keskiviikko;4;0;4;4;6;10
294;06.01.2016;2016;01;18;Keskiviikko;0;3;3;2;3;5
294;06.01.2016;2016;01;19;Keskiviikko;0;1;1;1;4;5
294;06.01.2016;2016;01;20;Keskiviikko;0;1;1;4;0;4
294;06.01.2016;2016;01;21;Keskiviikko;0;0;0;2;2;4
294;06.01.2016;2016;01;22;Keskiviikko;0;0;0;0;0;0
294;06.01.2016;2016;01;23;Keskiviikko;1;0;1;0;0;0
294;07.01.2016;2016;01;00;Torstai;0;0;0;0;0;0
294;07.01.2016;2016;01;01;Torstai;0;0;0;0;0;0
294;07.01.2016;2016;01;02;Torstai;0;0;0;0;0;0
294;07.01.2016;2016;01;03;Torstai;0;0;0;0;0;0
294;07.01.2016;2016;01;04;Torstai;0;0;0;0;0;0
294;07.01.2016;2016;01;05;Torstai;1;0;1;0;0;0
294;07.01.2016;2016;01;06;Torstai;1;0;1;2;1;3
294;07.01.2016;2016;01;07;Torstai;1;4;5;5;2;7
294;07.01.2016;2016;01;08;Torstai;4;0;4;14;4;18
294;07.01.2016;2016;01;09;Torstai;1;2;3;8;8;16
294;07.01.2016;2016;01;10;Torstai;0;1;1;10;10;20
294;07.01.2016;2016;01;11;Torstai;0;0;0;21;22;43
294;07.01.2016;2016;01;12;Torstai;1;1;2;10;20;30
294;07.01.2016;2016;01;13;Torstai;0;1;1;15;13;28
294;07.01.2016;2016;01;14;Torstai;2;4;6;14;5;19
294;07.01.2016;2016;01;15;Torstai;1;2;3;3;14;17
294;07.01.2016;2016;01;16;Torstai;5;1;6;4;14;18
294;07.01.2016;2016;01;17;Torstai;1;1;2;6;3;9
294;07.01.2016;2016;01;18;Torstai;0;4;4;4;9;13
294;07.01.2016;2016;01;19;Torstai;0;1;1;1;7;8
294;07.01.2016;2016;01;20;Torstai;1;0;1;2;2;4
294;07.01.2016;2016;01;21;Torstai;0;0;0;0;1;1
294;07.01.2016;2016;01;22;Torstai;0;0;0;0;0;0
294;07.01.2016;2016;01;23;Torstai;0;0;0;0;0;0
294;08.01.2016;2016;01;00;Perjantai;0;0;0;0;0;0
294;08.01.2016;2016;01;01;Perjantai;0;0;0;0;0;0
294;08.01.2016;2016;01;02;Perjantai;0;0;0;0;0;0
294;08.01.2016;2016;01;03;Perjantai;0;0;0;0;0;0
294;08.01.2016;2016;01;04;Perjantai;0;0;0;0;0;0
294;08.01.2016;2016;01;05;Perjantai;0;0;0;0;0;0
294;08.01.2016;2016;01;06;Perjantai;0;0;0;1;1;2
294;08.01.2016;2016;01;07;Perjantai;2;3;5;2;1;3
294;08.01.2016;2016;01;08;Perjantai;4;0;4;9;0;9
294;08.01.2016;2016;01;09;Perjantai;3;1;4;9;7;16
294;08.01.2016;2016;01;10;Perjantai;0;0;0;6;12;18
294;08.01.2016;2016;01;11;Perjantai;1;0;1;8;12;20
294;08.01.2016;2016;01;12;Perjantai;0;3;3;15;14;29
294;08.01.2016;2016;01;13;Perjantai;5;2;7;15;18;33
294;08.01.2016;2016;01;14;Perjantai;1;4;5;20;37;57
294;08.01.2016;2016;01;15;Perjantai;6;4;10;17;14;31
294;08.01.2016;2016;01;16;Perjantai;4;2;6;6;14;20
294;08.01.2016;2016;01;17;Perjantai;2;4;6;12;11;23
294;08.01.2016;2016;01;18;Perjantai;6;1;7;20;4;24
294;08.01.2016;2016;01;19;Perjantai;5;2;7;5;7;12
294;08.01.2016;2016;01;20;Perjantai;3;0;3;11;5;16
294;08.01.2016;2016;01;21;Perjantai;4;4;8;2;4;6
294;08.01.2016;2016;01;22;Perjantai;1;0;1;0;0;0
294;08.01.2016;2016;01;23;Perjantai;3;1;4;0;0;0
294;09.01.2016;2016;01;00;Lauantai;1;0;1;0;1;1
294;09.01.2016;2016;01;01;Lauantai;1;0;1;1;0;1
294;09.01.2016;2016;01;02;Lauantai;0;0;0;0;2;2
294;09.01.2016;2016;01;03;Lauantai;0;0;0;0;0;0
294;09.01.2016;2016;01;04;Lauantai;0;0;0;0;0;0
294;09.01.2016;2016;01;05;Lauantai;0;0;0;0;0;0
294;09.01.2016;2016;01;06;Lauantai;2;0;2;2;2;4
294;09.01.2016;2016;01;07;Lauantai;0;0;0;0;1;1
294;09.01.2016;2016;01;08;Lauantai;0;0;0;2;2;4
294;09.01.2016;2016;01;09;Lauantai;1;0;1;7;5;12
294;09.01.2016;2016;01;10;Lauantai;0;0;0;6;8;14
294;09.01.2016;2016;01;11;Lauantai;2;1;3;6;15;21
294;09.01.2016;2016;01;12;Lauantai;6;1;7;13;10;23
294;09.01.2016;2016;01;13;Lauantai;0;2;2;8;13;21
294;09.01.2016;2016;01;14;Lauantai;2;5;7;10;10;20
294;09.01.2016;2016;01;15;Lauantai;5;7;12;9;4;13
294;09.01.2016;2016;01;16;Lauantai;3;3;6;12;11;23
294;09.01.2016;2016;01;17;Lauantai;4;3;7;24;12;36
294;09.01.2016;2016;01;18;Lauantai;3;5;8;6;11;17
294;09.01.2016;2016;01;19;Lauantai;2;4;6;7;15;22
294;09.01.2016;2016;01;20;Lauantai;0;0;0;6;8;14
294;09.01.2016;2016;01;21;Lauantai;0;2;2;10;3;13
294;09.01.2016;2016;01;22;Lauantai;0;0;0;3;1;4
294;09.01.2016;2016;01;23;Lauantai;2;0;2;0;1;1
294;10.01.2016;2016;01;00;Sunnuntai;0;0;0;0;0;0
294;10.01.2016;2016;01;01;Sunnuntai;0;0;0;0;0;0
294;10.01.2016;2016;01;02;Sunnuntai;0;0;0;0;1;1
294;10.01.2016;2016;01;03;Sunnuntai;0;0;0;0;1;1
294;10.01.2016;2016;01;04;Sunnuntai;0;0;0;0;0;0
294;10.01.2016;2016;01;05;Sunnuntai;0;0;0;1;0;1
294;10.01.2016;2016;01;06;Sunnuntai;0;0;0;2;3;5
294;10.01.2016;2016;01;07;Sunnuntai;0;1;1;0;2;2
294;10.01.2016;2016;01;08;Sunnuntai;0;2;2;2;5;7
294;10.01.2016;2016;01;09;Sunnuntai;1;0;1;10;4;14
294;10.01.2016;2016;01;10;Sunnuntai;1;1;2;8;14;22
294;10.01.2016;2016;01;11;Sunnuntai;4;3;7;15;14;29
294;10.01.2016;2016;01;12;Sunnuntai;2;0;2;20;8;28
294;10.01.2016;2016;01;13;Sunnuntai;1;1;2;12;10;22
294;10.01.2016;2016;01;14;Sunnuntai;1;1;2;13;13;26
294;10.01.2016;2016;01;15;Sunnuntai;5;2;7;18;9;27
294;10.01.2016;2016;01;16;Sunnuntai;0;3;3;5;6;11
294;10.01.2016;2016;01;17;Sunnuntai;0;1;1;11;11;22
294;10.01.2016;2016;01;18;Sunnuntai;4;0;4;16;12;28
294;10.01.2016;2016;01;19;Sunnuntai;1;0;1;10;3;13
294;10.01.2016;2016;01;20;Sunnuntai;1;0;1;2;4;6
294;10.01.2016;2016;01;21;Sunnuntai;1;2;3;2;2;4
294;10.01.2016;2016;01;22;Sunnuntai;0;0;0;0;0;0
294;10.01.2016;2016;01;23;Sunnuntai;1;0;1;0;0;0
294;11.01.2016;2016;01;00;Maanantai;0;0;0;0;0;0
294;11.01.2016;2016;01;01;Maanantai;0;0;0;0;0;0
294;11.01.2016;2016;01;02;Maanantai;0;0;0;0;0;0
294;11.01.2016;2016;01;03;Maanantai;0;0;0;0;0;0
294;11.01.2016;2016;01;04;Maanantai;0;0;0;0;0;0
294;11.01.2016;2016;01;05;Maanantai;0;1;1;1;1;2
294;11.01.2016;2016;01;06;Maanantai;0;1;1;1;2;3
294;11.01.2016;2016;01;07;Maanantai;5;3;8;9;3;12
294;11.01.2016;2016;01;08;Maanantai;5;2;7;10;3;13
294;11.01.2016;2016;01;09;Maanantai;5;1;6;10;10;20
294;11.01.2016;2016;01;10;Maanantai;0;0;0;12;4;16
294;11.01.2016;2016;01;11;Maanantai;1;2;3;13;21;34
294;11.01.2016;2016;01;12;Maanantai;1;3;4;11;15;26
294;11.01.2016;2016;01;13;Maanantai;6;5;11;10;18;28
294;11.01.2016;2016;01;14;Maanantai;4;11;15;9;20;29
294;11.01.2016;2016;01;15;Maanantai;7;5;12;7;9;16
294;11.01.2016;2016;01;16;Maanantai;1;0;1;10;8;18
294;11.01.2016;2016;01;17;Maanantai;3;3;6;11;9;20
294;11.01.2016;2016;01;18;Maanantai;3;1;4;5;8;13
294;11.01.2016;2016;01;19;Maanantai;1;2;3;4;4;8
294;11.01.2016;2016;01;20;Maanantai;0;2;2;6;6;12
294;11.01.2016;2016;01;21;Maanantai;0;1;1;1;1;2
294;11.01.2016;2016;01;22;Maanantai;0;0;0;0;0;0
294;11.01.2016;2016;01;23;Maanantai;0;0;0;0;0;0
294;12.01.2016;2016;01;00;Tiistai;0;0;0;0;0;0
294;12.01.2016;2016;01;01;Tiistai;0;0;0;0;0;0
294;12.01.2016;2016;01;02;Tiistai;0;0;0;0;0;0
294;12.01.2016;2016;01;03;Tiistai;0;0;0;0;0;0
294;12.01.2016;2016;01;04;Tiistai;0;0;0;0;0;0
294;12.01.2016;2016;01;05;Tiistai;0;0;0;1;1;2
294;12.01.2016;2016;01;06;Tiistai;0;0;0;4;2;6
294;12.01.2016;2016;01;07;Tiistai;3;1;4;5;4;9
294;12.01.2016;2016;01;08;Tiistai;4;2;6;17;6;23
294;12.01.2016;2016;01;09;Tiistai;7;0;7;17;15;32
294;12.01.2016;2016;01;10;Tiistai;2;2;4;12;10;22
294;12.01.2016;2016;01;11;Tiistai;2;6;8;9;16;25
294;12.01.2016;2016;01;12;Tiistai;6;3;9;8;12;20
294;12.01.2016;2016;01;13;Tiistai;2;5;7;12;11;23
294;12.01.2016;2016;01;14;Tiistai;1;7;8;11;14;25
294;12.01.2016;2016;01;15;Tiistai;3;3;6;8;17;25
294;12.01.2016;2016;01;16;Tiistai;3;3;6;10;11;21
294;12.01.2016;2016;01;17;Tiistai;0;0;0;9;11;20
294;12.01.2016;2016;01;18;Tiistai;2;1;3;6;10;16
294;12.01.2016;2016;01;19;Tiistai;1;0;1;7;5;12
294;12.01.2016;2016;01;20;Tiistai;0;2;2;1;3;4
294;12.01.2016;2016;01;21;Tiistai;0;0;0;0;0;0
294;12.01.2016;2016;01;22;Tiistai;0;0;0;1;0;1
294;12.01.2016;2016;01;23;Tiistai;0;0;0;1;0;1
294;13.01.2016;2016;01;00;Keskiviikko;0;0;0;0;0;0
294;13.01.2016;2016;01;01;Keskiviikko;0;0;0;0;0;0
294;13.01.2016;2016;01;02;Keskiviikko;0;0;0;0;0;0
294;13.01.2016;2016;01;03;Keskiviikko;0;0;0;0;0;0
294;13.01.2016;2016;01;04;Keskiviikko;0;0;0;0;0;0
294;13.01.2016;2016;01;05;Keskiviikko;0;0;0;2;2;4
294;13.01.2016;2016;01;06;Keskiviikko;0;0;0;2;1;3
294;13.01.2016;2016;01;07;Keskiviikko;2;0;2;10;6;16
294;13.01.2016;2016;01;08;Keskiviikko;8;2;10;3;2;5
294;13.01.2016;2016;01;09;Keskiviikko;5;5;10;8;8;16
294;13.01.2016;2016;01;10;Keskiviikko;3;1;4;9;13;22
294;13.01.2016;2016;01;11;Keskiviikko;2;2;4;7;14;21
294;13.01.2016;2016;01;12;Keskiviikko;4;4;8;9;8;17
294;13.01.2016;2016;01;13;Keskiviikko;4;1;5;8;12;20
294;13.01.2016;2016;01;14;Keskiviikko;2;6;8;5;13;18
294;13.01.2016;2016;01;15;Keskiviikko;5;4;9;8;12;20
294;13.01.2016;2016;01;16;Keskiviikko;4;2;6;5;11;16
294;13.01.2016;2016;01;17;Keskiviikko;2;0;2;11;5;16
294;13.01.2016;2016;01;18;Keskiviikko;2;1;3;9;10;19
294;13.01.2016;2016;01;19;Keskiviikko;2;1;3;4;9;13
294;13.01.2016;2016;01;20;Keskiviikko;0;4;4;8;5;13
294;13.01.2016;2016;01;21;Keskiviikko;1;0;1;1;0;1
294;13.01.2016;2016;01;22;Keskiviikko;0;0;0;0;1;1
294;13.01.2016;2016;01;23;Keskiviikko;0;0;0;0;0;0
294;14.01.2016;2016;01;00;Torstai;0;0;0;0;0;0
294;14.01.2016;2016;01;01;Torstai;0;0;0;0;0;0
294;14.01.2016;2016;01;02;Torstai;0;0;0;0;0;0
294;14.01.2016;2016;01;03;Torstai;0;0;0;0;0;0
294;14.01.2016;2016;01;04;Torstai;0;0;0;0;0;0
294;14.01.2016;2016;01;05;Torstai;0;1;1;1;1;2
294;14.01.2016;2016;01;06;Torstai;0;2;2;2;3;5
294;14.01.2016;2016;01;07;Torstai;4;1;5;8;5;13
294;14.01.2016;2016;01;08;Torstai;7;2;9;4;7;11
294;14.01.2016;2016;01;09;Torstai;2;2;4;8;7;15
294;14.01.2016;2016;01;10;Torstai;2;3;5;11;10;21
294;14.01.2016;2016;01;11;Torstai;7;4;11;30;28;58
294;14.01.2016;2016;01;12;Torstai;2;4;6;23;19;42
294;14.01.2016;2016;01;13;Torstai;5;3;8;15;18;33
294;14.01.2016;2016;01;14;Torstai;5;9;14;16;15;31
294;14.01.2016;2016;01;15;Torstai;5;9;14;20;21;41
294;14.01.2016;2016;01;16;Torstai;5;2;7;12;10;22
294;14.01.2016;2016;01;17;Torstai;5;4;9;17;10;27
294;14.01.2016;2016;01;18;Torstai;0;7;7;6;15;21
294;14.01.2016;2016;01;19;Torstai;2;2;4;12;10;22
294;14.01.2016;2016;01;20;Torstai;2;4;6;11;14;25
294;14.01.2016;2016;01;21;Torstai;0;0;0;3;1;4
294;14.01.2016;2016;01;22;Torstai;1;0;1;0;2;2
294;14.01.2016;2016;01;23;Torstai;0;0;0;0;0;0
294;15.01.2016;2016;01;00;Perjantai;0;0;0;0;0;0
294;15.01.2016;2016;01;01;Perjantai;0;0;0;0;0;0
294;15.01.2016;2016;01;02;Perjantai;0;0;0;0;0;0
294;15.01.2016;2016;01;03;Perjantai;0;0;0;0;0;0
294;15.01.2016;2016;01;04;Perjantai;0;0;0;0;0;0
294;15.01.2016;2016;01;05;Perjantai;0;0;0;2;1;3
294;15.01.2016;2016;01;06;Perjantai;0;1;1;3;2;5
294;15.01.2016;2016;01;07;Perjantai;4;4;8;10;3;13
294;15.01.2016;2016;01;08;Perjantai;3;2;5;12;5;17
294;15.01.2016;2016;01;09;Perjantai;9;2;11;14;3;17
294;15.01.2016;2016;01;10;Perjantai;0;1;1;7;14;21
294;15.01.2016;2016;01;11;Perjantai;0;2;2;22;18;40
294;15.01.2016;2016;01;12;Perjantai;2;8;10;17;21;38
294;15.01.2016;2016;01;13;Perjantai;4;4;8;17;23;40
294;15.01.2016;2016;01;14;Perjantai;6;9;15;19;21;40
294;15.01.2016;2016;01;15;Perjantai;1;3;4;9;6;15
294;15.01.2016;2016;01;16;Perjantai;7;4;11;19;10;29
294;15.01.2016;2016;01;17;Perjantai;3;0;3;11;10;21
294;15.01.2016;2016;01;18;Perjantai;2;1;3;10;9;19
294;15.01.2016;2016;01;19;Perjantai;2;5;7;10;6;16
294;15.01.2016;2016;01;20;Perjantai;1;9;10;7;7;14
294;15.01.2016;2016;01;21;Perjantai;1;0;1;2;3;5
294;15.01.2016;2016;01;22;Perjantai;1;0;1;3;2;5
294;15.01.2016;2016;01;23;Perjantai;0;0;0;0;2;2
294;16.01.2016;2016;01;00;Lauantai;0;0;0;1;0;1
294;16.01.2016;2016;01;01;Lauantai;0;0;0;0;0;0
294;16.01.2016;2016;01;02;Lauantai;0;0;0;0;0;0
294;16.01.2016;2016;01;03;Lauantai;0;0;0;0;0;0
294;16.01.2016;2016;01;04;Lauantai;0;0;0;0;0;0
294;16.01.2016;2016;01;05;Lauantai;0;0;0;1;0;1
294;16.01.2016;2016;01;06;Lauantai;0;1;1;1;2;3
294;16.01.2016;2016;01;07;Lauantai;0;0;0;0;2;2
294;16.01.2016;2016;01;08;Lauantai;1;0;1;5;4;9
294;16.01.2016;2016;01;09;Lauantai;0;0;0;8;8;16
294;16.01.2016;2016;01;10;Lauantai;2;1;3;18;23;41
294;16.01.2016;2016;01;11;Lauantai;8;1;9;13;18;31
294;16.01.2016;2016;01;12;Lauantai;1;3;4;9;14;23
294;16.01.2016;2016;01;13;Lauantai;1;5;6;11;9;20
294;16.01.2016;2016;01;14;Lauantai;4;2;6;14;10;24
294;16.01.2016;2016;01;15;Lauantai;4;8;12;12;11;23
294;16.01.2016;2016;01;16;Lauantai;1;3;4;10;8;18
294;16.01.2016;2016;01;17;Lauantai;3;2;5;12;13;25
294;16.01.2016;2016;01;18;Lauantai;4;2;6;14;9;23
294;16.01.2016;2016;01;19;Lauantai;2;4;6;6;4;10
294;16.01.2016;2016;01;20;Lauantai;0;1;1;5;4;9
294;16.01.2016;2016;01;21;Lauantai;1;0;1;3;5;8
294;16.01.2016;2016;01;22;Lauantai;0;0;0;0;1;1
294;16.01.2016;2016;01;23;Lauantai;0;0;0;0;2;2
294;17.01.2016;2016;01;00;Sunnuntai;0;0;0;0;0;0
294;17.01.2016;2016;01;01;Sunnuntai;0;0;0;2;1;3
294;17.01.2016;2016;01;02;Sunnuntai;0;0;0;0;0;0
294;17.01.2016;2016;01;03;Sunnuntai;0;0;0;0;0;0
294;17.01.2016;2016;01;04;Sunnuntai;0;0;0;0;0;0
294;17.01.2016;2016;01;05;Sunnuntai;0;0;0;0;0;0
294;17.01.2016;2016;01;06;Sunnuntai;0;0;0;1;0;1
294;17.01.2016;2016;01;07;Sunnuntai;0;0;0;1;2;3
294;17.01.2016;2016;01;08;Sunnuntai;0;0;0;0;2;2
294;17.01.2016;2016;01;09;Sunnuntai;0;0;0;0;2;2
294;17.01.2016;2016;01;10;Sunnuntai;0;0;0;4;5;9
294;17.01.2016;2016;01;11;Sunnuntai;0;0;0;2;2;4
294;17.01.2016;2016;01;12;Sunnuntai;0;0;0;5;5;10
294;17.01.2016;2016;01;13;Sunnuntai;0;0;0;5;8;13
294;17.01.2016;2016;01;14;Sunnuntai;2;1;3;3;10;13
294;17.01.2016;2016;01;15;Sunnuntai;3;1;4;6;9;15
294;17.01.2016;2016;01;16;Sunnuntai;0;1;1;1;6;7
294;17.01.2016;2016;01;17;Sunnuntai;1;1;2;7;9;16
294;17.01.2016;2016;01;18;Sunnuntai;1;2;3;2;7;9
294;17.01.2016;2016;01;19;Sunnuntai;0;0;0;3;5;8
294;17.01.2016;2016;01;20;Sunnuntai;0;0;0;2;3;5
294;17.01.2016;2016;01;21;Sunnuntai;0;0;0;0;1;1
294;17.01.2016;2016;01;22;Sunnuntai;0;0;0;1;0;1
294;17.01.2016;2016;01;23;Sunnuntai;0;0;0;0;0;0
294;18.01.2016;2016;01;00;Maanantai;0;0;0;0;0;0
294;18.01.2016;2016;01;01;Maanantai;0;0;0;0;0;0
294;18.01.2016;2016;01;02;Maanantai;0;0;0;0;0;0
294;18.01.2016;2016;01;03;Maanantai;0;0;0;0;0;0
294;18.01.2016;2016;01;04;Maanantai;0;0;0;0;0;0
294;18.01.2016;2016;01;05;Maanantai;0;0;0;2;1;3
294;18.01.2016;2016;01;06;Maanantai;1;0;1;3;4;7
294;18.01.2016;2016;01;07;Maanantai;2;1;3;11;6;17
294;18.01.2016;2016;01;08;Maanantai;2;0;2;8;5;13
294;18.01.2016;2016;01;09;Maanantai;3;1;4;14;10;24
294;18.01.2016;2016;01;10;Maanantai;1;1;2;6;12;18
294;18.01.2016;2016;01;11;Maanantai;3;3;6;22;14;36
294;18.01.2016;2016;01;12;Maanantai;0;5;5;9;10;19
294;18.01.2016;2016;01;13;Maanantai;1;3;4;10;10;20
294;18.01.2016;2016;01;14;Maanantai;3;3;6;14;25;39
294;18.01.2016;2016;01;15;Maanantai;2;3;5;18;4;22
294;18.01.2016;2016;01;16;Maanantai;2;0;2;9;12;21
294;18.01.2016;2016;01;17;Maanantai;2;1;3;4;8;12
294;18.01.2016;2016;01;18;Maanantai;1;4;5;8;6;14
294;18.01.2016;2016;01;19;Maanantai;0;3;3;2;7;9
294;18.01.2016;2016;01;20;Maanantai;3;0;3;1;5;6
294;18.01.2016;2016;01;21;Maanantai;0;1;1;0;0;0
294;18.01.2016;2016;01;22;Maanantai;0;0;0;0;0;0
294;18.01.2016;2016;01;23;Maanantai;0;0;0;0;0;0
294;19.01.2016;2016;01;00;Tiistai;0;0;0;0;0;0
294;19.01.2016;2016;01;01;Tiistai;0;0;0;0;0;0
294;19.01.2016;2016;01;02;Tiistai;0;0;0;0;0;0
294;19.01.2016;2016;01;03;Tiistai;0;0;0;0;0;0
294;19.01.2016;2016;01;04;Tiistai;0;0;0;0;0;0
294;19.01.2016;2016;01;05;Tiistai;0;0;0;1;1;2
294;19.01.2016;2016;01;06;Tiistai;1;1;2;2;1;3
294;19.01.2016;2016;01;07;Tiistai;0;1;1;6;7;13
294;19.01.2016;2016;01;08;Tiistai;2;1;3;7;2;9
294;19.01.2016;2016;01;09;Tiistai;1;2;3;13;13;26
294;19.01.2016;2016;01;10;Tiistai;1;0;1;7;5;12
294;19.01.2016;2016;01;11;Tiistai;1;0;1;16;25;41
294;19.01.2016;2016;01;12;Tiistai;0;3;3;9;12;21
294;19.01.2016;2016;01;13;Tiistai;2;2;4;17;14;31
294;19.01.2016;2016;01;14;Tiistai;1;1;2;17;10;27
294;19.01.2016;2016;01;15;Tiistai;1;6;7;9;12;21
294;19.01.2016;2016;01;16;Tiistai;5;1;6;7;11;18
294;19.01.2016;2016;01;17;Tiistai;1;5;6;5;8;13
294;19.01.2016;2016;01;18;Tiistai;1;1;2;6;6;12
294;19.01.2016;2016;01;19;Tiistai;1;2;3;6;4;10
294;19.01.2016;2016;01;20;Tiistai;0;0;0;0;0;0
294;19.01.2016;2016;01;21;Tiistai;0;0;0;0;0;0
294;19.01.2016;2016;01;22;Tiistai;0;0;0;0;0;0
294;19.01.2016;2016;01;23;Tiistai;0;0;0;0;0;0
294;20.01.2016;2016;01;00;Keskiviikko;0;0;0;0;0;0
294;20.01.2016;2016;01;01;Keskiviikko;0;0;0;0;0;0
294;20.01.2016;2016;01;02;Keskiviikko;0;0;0;0;0;0
294;20.01.2016;2016;01;03;Keskiviikko;0;0;0;0;0;0
294;20.01.2016;2016;01;04;Keskiviikko;0;0;0;0;0;0
294;20.01.2016;2016;01;05;Keskiviikko;0;0;0;0;1;1
294;20.01.2016;2016;01;06;Keskiviikko;0;0;0;3;1;4
294;20.01.2016;2016;01;07;Keskiviikko;3;3;6;6;6;12
294;20.01.2016;2016;01;08;Keskiviikko;2;0;2;6;3;9
294;20.01.2016;2016;01;09;Keskiviikko;2;2;4;8;13;21
294;20.01.2016;2016;01;10;Keskiviikko;0;0;0;4;1;5
294;20.01.2016;2016;01;11;Keskiviikko;0;1;1;10;12;22
294;20.01.2016;2016;01;12;Keskiviikko;0;0;0;12;11;23
294;20.01.2016;2016;01;13;Keskiviikko;1;0;1;9;8;17
294;20.01.2016;2016;01;14;Keskiviikko;1;7;8;9;21;30
294;20.01.2016;2016;01;15;Keskiviikko;3;3;6;17;11;28
294;20.01.2016;2016;01;16;Keskiviikko;2;1;3;8;8;16
294;20.01.2016;2016;01;17;Keskiviikko;1;0;1;6;9;15
294;20.01.2016;2016;01;18;Keskiviikko;1;2;3;5;1;6
294;20.01.2016;2016;01;19;Keskiviikko;1;4;5;1;4;5
294;20.01.2016;2016;01;20;Keskiviikko;1;0;1;3;4;7
294;20.01.2016;2016;01;21;Keskiviikko;0;0;0;0;0;0
294;20.01.2016;2016;01;22;Keskiviikko;0;0;0;0;0;0
294;20.01.2016;2016;01;23;Keskiviikko;0;0;0;0;0;0
294;21.01.2016;2016;01;00;Torstai;0;0;0;0;1;1
294;21.01.2016;2016;01;01;Torstai;0;0;0;0;0;0
294;21.01.2016;2016;01;02;Torstai;0;0;0;0;0;0
294;21.01.2016;2016;01;03;Torstai;0;0;0;0;0;0
294;21.01.2016;2016;01;04;Torstai;0;0;0;0;1;1
294;21.01.2016;2016;01;05;Torstai;0;0;0;0;0;0
294;21.01.2016;2016;01;06;Torstai;1;0;1;3;1;4
294;21.01.2016;2016;01;07;Torstai;0;1;1;3;2;5
294;21.01.2016;2016;01;08;Torstai;3;0;3;14;4;18
294;21.01.2016;2016;01;09;Torstai;1;1;2;8;7;15
294;21.01.2016;2016;01;10;Torstai;0;0;0;5;4;9
294;21.01.2016;2016;01;11;Torstai;1;0;1;9;10;19
294;21.01.2016;2016;01;12;Torstai;0;1;1;9;14;23
294;21.01.2016;2016;01;13;Torstai;0;2;2;18;19;37
294;21.01.2016;2016;01;14;Torstai;2;2;4;21;12;33
294;21.01.2016;2016;01;15;Torstai;2;2;4;4;9;13
294;21.01.2016;2016;01;16;Torstai;4;2;6;7;10;17
294;21.01.2016;2016;01;17;Torstai;0;1;1;9;6;15
294;21.01.2016;2016;01;18;Torstai;0;0;0;1;4;5
294;21.01.2016;2016;01;19;Torstai;0;2;2;4;3;7
294;21.01.2016;2016;01;20;Torstai;0;1;1;2;1;3
294;21.01.2016;2016;01;21;Torstai;1;0;1;0;0;0
294;21.01.2016;2016;01;22;Torstai;0;0;0;0;0;0
294;21.01.2016;2016;01;23;Torstai;0;0;0;0;0;0
294;22.01.2016;2016;01;00;Perjantai;0;0;0;0;0;0
294;22.01.2016;2016;01;01;Perjantai;0;0;0;0;0;0
294;22.01.2016;2016;01;02;Perjantai;0;0;0;0;0;0
294;22.01.2016;2016;01;03;Perjantai;0;0;0;0;0;0
294;22.01.2016;2016;01;04;Perjantai;0;0;0;0;0;0
294;22.01.2016;2016;01;05;Perjantai;0;1;1;1;1;2
294;22.01.2016;2016;01;06;Perjantai;0;0;0;3;1;4
294;22.01.2016;2016;01;07;Perjantai;2;1;3;6;3;9
294;22.01.2016;2016;01;08;Perjantai;1;1;2;6;6;12
294;22.01.2016;2016;01;09;Perjantai;10;2;12;16;7;23
294;22.01.2016;2016;01;10;Perjantai;1;1;2;7;9;16
294;22.01.2016;2016;01;11;Perjantai;3;3;6;10;14;24
294;22.01.2016;2016;01;12;Perjantai;2;7;9;15;17;32
294;22.01.2016;2016;01;13;Perjantai;10;8;18;19;20;39
294;22.01.2016;2016;01;14;Perjantai;1;13;14;16;30;46
294;22.01.2016;2016;01;15;Perjantai;4;3;7;14;11;25
294;22.01.2016;2016;01;16;Perjantai;7;4;11;7;11;18
294;22.01.2016;2016;01;17;Perjantai;3;0;3;14;6;20
294;22.01.2016;2016;01;18;Perjantai;5;4;9;13;12;25
294;22.01.2016;2016;01;19;Perjantai;1;3;4;17;22;39
294;22.01.2016;2016;01;20;Perjantai;0;0;0;11;4;15
294;22.01.2016;2016;01;21;Perjantai;2;2;4;1;1;2
294;22.01.2016;2016;01;22;Perjantai;3;0;3;1;1;2
294;22.01.2016;2016;01;23;Perjantai;0;0;0;1;0;1
294;23.01.2016;2016;01;00;Lauantai;0;0;0;1;0;1
294;23.01.2016;2016;01;01;Lauantai;0;0;0;3;0;3
294;23.01.2016;2016;01;02;Lauantai;0;0;0;0;0;0
294;23.01.2016;2016;01;03;Lauantai;1;0;1;1;1;2
294;23.01.2016;2016;01;04;Lauantai;0;0;0;0;0;0
294;23.01.2016;2016;01;05;Lauantai;0;0;0;1;0;1
294;23.01.2016;2016;01;06;Lauantai;0;0;0;1;2;3
294;23.01.2016;2016;01;07;Lauantai;0;0;0;3;4;7
294;23.01.2016;2016;01;08;Lauantai;1;0;1;5;4;9
294;23.01.2016;2016;01;09;Lauantai;2;1;3;7;5;12
294;23.01.2016;2016;01;10;Lauantai;2;4;6;9;18;27
294;23.01.2016;2016;01;11;Lauantai;2;4;6;22;16;38
294;23.01.2016;2016;01;12;Lauantai;1;2;3;24;19;43
294;23.01.2016;2016;01;13;Lauantai;5;2;7;8;10;18
294;23.01.2016;2016;01;14;Lauantai;4;4;8;21;12;33
294;23.01.2016;2016;01;15;Lauantai;2;4;6;17;12;29
294;23.01.2016;2016;01;16;Lauantai;5;2;7;12;5;17
294;23.01.2016;2016;01;17;Lauantai;2;6;8;13;12;25
294;23.01.2016;2016;01;18;Lauantai;6;3;9;7;6;13
294;23.01.2016;2016;01;19;Lauantai;5;2;7;10;10;20
294;23.01.2016;2016;01;20;Lauantai;8;8;16;4;7;11
294;23.01.2016;2016;01;21;Lauantai;0;2;2;1;2;3
294;23.01.2016;2016;01;22;Lauantai;1;0;1;0;2;2
294;23.01.2016;2016;01;23;Lauantai;2;4;6;0;0;0
294;24.01.2016;2016;01;00;Sunnuntai;1;0;1;2;1;3
294;24.01.2016;2016;01;01;Sunnuntai;0;0;0;0;0;0
294;24.01.2016;2016;01;02;Sunnuntai;0;0;0;0;0;0
294;24.01.2016;2016;01;03;Sunnuntai;0;0;0;0;0;0
294;24.01.2016;2016;01;04;Sunnuntai;0;0;0;0;0;0
294;24.01.2016;2016;01;05;Sunnuntai;0;0;0;1;0;1
294;24.01.2016;2016;01;06;Sunnuntai;0;0;0;1;0;1
294;24.01.2016;2016;01;07;Sunnuntai;0;0;0;1;2;3
294;24.01.2016;2016;01;08;Sunnuntai;0;0;0;4;3;7
294;24.01.2016;2016;01;09;Sunnuntai;1;1;2;8;7;15
294;24.01.2016;2016;01;10;Sunnuntai;0;1;1;14;8;22
294;24.01.2016;2016;01;11;Sunnuntai;1;5;6;6;20;26
294;24.01.2016;2016;01;12;Sunnuntai;3;1;4;19;20;39
294;24.01.2016;2016;01;13;Sunnuntai;8;5;13;8;2;10
294;24.01.2016;2016;01;14;Sunnuntai;2;4;6;8;7;15
294;24.01.2016;2016;01;15;Sunnuntai;5;2;7;6;10;16
294;24.01.2016;2016;01;16;Sunnuntai;2;4;6;4;9;13
294;24.01.2016;2016;01;17;Sunnuntai;2;2;4;5;11;16
294;24.01.2016;2016;01;18;Sunnuntai;2;1;3;21;10;31
294;24.01.2016;2016;01;19;Sunnuntai;1;0;1;16;6;22
294;24.01.2016;2016;01;20;Sunnuntai;0;0;0;3;8;11
294;24.01.2016;2016;01;21;Sunnuntai;2;1;3;1;0;1
294;24.01.2016;2016;01;22;Sunnuntai;0;0;0;0;0;0
294;24.01.2016;2016;01;23;Sunnuntai;0;0;0;0;0;0
294;25.01.2016;2016;01;00;Maanantai;0;0;0;0;1;1
294;25.01.2016;2016;01;01;Maanantai;0;0;0;0;0;0
294;25.01.2016;2016;01;02;Maanantai;0;0;0;0;0;0
294;25.01.2016;2016;01;03;Maanantai;0;0;0;0;0;0
294;25.01.2016;2016;01;04;Maanantai;0;0;0;0;0;0
294;25.01.2016;2016;01;05;Maanantai;2;0;2;4;1;5
294;25.01.2016;2016;01;06;Maanantai;2;4;6;1;2;3
294;25.01.2016;2016;01;07;Maanantai;5;4;9;7;9;16
294;25.01.2016;2016;01;08;Maanantai;16;3;19;14;10;24
294;25.01.2016;2016;01;09;Maanantai;8;4;12;14;15;29
294;25.01.2016;2016;01;10;Maanantai;1;1;2;18;13;31
294;25.01.2016;2016;01;11;Maanantai;4;4;8;32;20;52
294;25.01.2016;2016;01;12;Maanantai;0;7;7;12;22;34
294;25.01.2016;2016;01;13;Maanantai;7;13;20;15;19;34
294;25.01.2016;2016;01;14;Maanantai;3;6;9;17;20;37
294;25.01.2016;2016;01;15;Maanantai;6;7;13;18;13;31
294;25.01.2016;2016;01;16;Maanantai;3;4;7;21;8;29
294;25.01.2016;2016;01;17;Maanantai;4;3;7;14;13;27
294;25.01.2016;2016;01;18;Maanantai;1;2;3;11;12;23
294;25.01.2016;2016;01;19;Maanantai;8;9;17;13;20;33
294;25.01.2016;2016;01;20;Maanantai;2;0;2;7;2;9
294;25.01.2016;2016;01;21;Maanantai;1;2;3;1;2;3
294;25.01.2016;2016;01;22;Maanantai;0;0;0;1;0;1
294;25.01.2016;2016;01;23;Maanantai;1;0;1;0;0;0
294;26.01.2016;2016;01;00;Tiistai;0;0;0;0;0;0
294;26.01.2016;2016;01;01;Tiistai;0;0;0;0;0;0
294;26.01.2016;2016;01;02;Tiistai;0;0;0;0;0;0
294;26.01.2016;2016;01;03;Tiistai;0;0;0;0;0;0
294;26.01.2016;2016;01;04;Tiistai;0;0;0;0;0;0
294;26.01.2016;2016;01;05;Tiistai;0;0;0;2;1;3
294;26.01.2016;2016;01;06;Tiistai;0;0;0;4;1;5
294;26.01.2016;2016;01;07;Tiistai;4;4;8;6;2;8
294;26.01.2016;2016;01;08;Tiistai;11;2;13;10;4;14
294;26.01.2016;2016;01;09;Tiistai;5;5;10;15;9;24
294;26.01.2016;2016;01;10;Tiistai;1;1;2;8;10;18
294;26.01.2016;2016;01;11;Tiistai;4;2;6;26;15;41
294;26.01.2016;2016;01;12;Tiistai;0;3;3;18;18;36
294;26.01.2016;2016;01;13;Tiistai;3;1;4;14;13;27
294;26.01.2016;2016;01;14;Tiistai;0;1;1;8;7;15
294;26.01.2016;2016;01;15;Tiistai;2;13;15;11;20;31
294;26.01.2016;2016;01;16;Tiistai;6;5;11;12;10;22
294;26.01.2016;2016;01;17;Tiistai;2;3;5;14;15;29
294;26.01.2016;2016;01;18;Tiistai;2;2;4;20;17;37
294;26.01.2016;2016;01;19;Tiistai;2;0;2;11;22;33
294;26.01.2016;2016;01;20;Tiistai;1;3;4;11;11;22
294;26.01.2016;2016;01;21;Tiistai;0;0;0;2;2;4
294;26.01.2016;2016;01;22;Tiistai;0;0;0;0;0;0
294;26.01.2016;2016;01;23;Tiistai;0;0;0;0;0;0
294;27.01.2016;2016;01;00;Keskiviikko;0;0;0;0;0;0
294;27.01.2016;2016;01;01;Keskiviikko;0;0;0;0;0;0
294;27.01.2016;2016;01;02;Keskiviikko;0;0;0;0;0;0
294;27.01.2016;2016;01;03;Keskiviikko;0;0;0;0;0;0
294;27.01.2016;2016;01;04;Keskiviikko;0;0;0;0;0;0
294;27.01.2016;2016;01;05;Keskiviikko;1;1;2;1;1;2
294;27.01.2016;2016;01;06;Keskiviikko;1;1;2;3;3;6
294;27.01.2016;2016;01;07;Keskiviikko;5;1;6;11;5;16
294;27.01.2016;2016;01;08;Keskiviikko;8;3;11;6;3;9
294;27.01.2016;2016;01;09;Keskiviikko;2;2;4;14;11;25
294;27.01.2016;2016;01;10;Keskiviikko;3;2;5;17;19;36
294;27.01.2016;2016;01;11;Keskiviikko;3;6;9;19;14;33
294;27.01.2016;2016;01;12;Keskiviikko;4;3;7;17;17;34
294;27.01.2016;2016;01;13;Keskiviikko;4;5;9;19;13;32
294;27.01.2016;2016;01;14;Keskiviikko;4;7;11;11;16;27
294;27.01.2016;2016;01;15;Keskiviikko;6;8;14;22;12;34
294;27.01.2016;2016;01;16;Keskiviikko;1;5;6;12;9;21
294;27.01.2016;2016;01;17;Keskiviikko;2;0;2;19;19;38
294;27.01.2016;2016;01;18;Keskiviikko;1;1;2;23;13;36
294;27.01.2016;2016;01;19;Keskiviikko;3;4;7;11;17;28
294;27.01.2016;2016;01;20;Keskiviikko;1;1;2;8;10;18
294;27.01.2016;2016;01;21;Keskiviikko;1;1;2;0;1;1
294;27.01.2016;2016;01;22;Keskiviikko;0;0;0;0;0;0
294;27.01.2016;2016;01;23;Keskiviikko;0;0;0;0;0;0
294;28.01.2016;2016;01;00;Torstai;0;0;0;0;2;2
294;28.01.2016;2016;01;01;Torstai;0;0;0;0;0;0
294;28.01.2016;2016;01;02;Torstai;0;0;0;0;0;0
294;28.01.2016;2016;01;03;Torstai;0;0;0;0;0;0
294;28.01.2016;2016;01;04;Torstai;0;0;0;0;0;0
294;28.01.2016;2016;01;05;Torstai;0;0;0;1;1;2
294;28.01.2016;2016;01;06;Torstai;0;0;0;5;1;6
294;28.01.2016;2016;01;07;Torstai;1;1;2;5;2;7
294;28.01.2016;2016;01;08;Torstai;4;6;10;14;5;19
294;28.01.2016;2016;01;09;Torstai;4;5;9;18;8;26
294;28.01.2016;2016;01;10;Torstai;1;3;4;11;20;31
294;28.01.2016;2016;01;11;Torstai;3;2;5;10;9;19
294;28.01.2016;2016;01;12;Torstai;2;0;2;14;14;28
294;28.01.2016;2016;01;13;Torstai;3;4;7;13;15;28
294;28.01.2016;2016;01;14;Torstai;5;3;8;14;15;29
294;28.01.2016;2016;01;15;Torstai;4;9;13;10;19;29
294;28.01.2016;2016;01;16;Torstai;12;4;16;10;14;24
294;28.01.2016;2016;01;17;Torstai;5;6;11;20;9;29
294;28.01.2016;2016;01;18;Torstai;1;2;3;13;18;31
294;28.01.2016;2016;01;19;Torstai;1;3;4;14;19;33
294;28.01.2016;2016;01;20;Torstai;2;3;5;6;9;15
294;28.01.2016;2016;01;21;Torstai;0;0;0;0;1;1
294;28.01.2016;2016;01;22;Torstai;0;0;0;1;1;2
294;28.01.2016;2016;01;23;Torstai;0;0;0;0;0;0
294;29.01.2016;2016;01;00;Perjantai;0;0;0;0;0;0
294;29.01.2016;2016;01;01;Perjantai;0;0;0;0;0;0
294;29.01.2016;2016;01;02;Perjantai;0;0;0;0;0;0
294;29.01.2016;2016;01;03;Perjantai;0;0;0;0;0;0
294;29.01.2016;2016;01;04;Perjantai;0;0;0;0;0;0
294;29.01.2016;2016;01;05;Perjantai;0;0;0;1;1;2
294;29.01.2016;2016;01;06;Perjantai;0;0;0;3;2;5
294;29.01.2016;2016;01;07;Perjantai;4;3;7;7;3;10
294;29.01.2016;2016;01;08;Perjantai;5;1;6;11;3;14
294;29.01.2016;2016;01;09;Perjantai;6;1;7;16;8;24
294;29.01.2016;2016;01;10;Perjantai;3;4;7;11;15;26
294;29.01.2016;2016;01;11;Perjantai;3;4;7;10;10;20
294;29.01.2016;2016;01;12;Perjantai;4;4;8;13;22;35
294;29.01.2016;2016;01;13;Perjantai;5;8;13;25;15;40
294;29.01.2016;2016;01;14;Perjantai;3;4;7;14;17;31
294;29.01.2016;2016;01;15;Perjantai;10;12;22;12;17;29
294;29.01.2016;2016;01;16;Perjantai;4;6;10;26;18;44
294;29.01.2016;2016;01;17;Perjantai;6;4;10;17;6;23
294;29.01.2016;2016;01;18;Perjantai;6;7;13;16;17;33
294;29.01.2016;2016;01;19;Perjantai;10;5;15;19;13;32
294;29.01.2016;2016;01;20;Perjantai;1;2;3;10;7;17
294;29.01.2016;2016;01;21;Perjantai;0;1;1;3;3;6
294;29.01.2016;2016;01;22;Perjantai;2;0;2;0;4;4
294;29.01.2016;2016;01;23;Perjantai;1;0;1;0;1;1
294;30.01.2016;2016;01;00;Lauantai;1;1;2;2;0;2
294;30.01.2016;2016;01;01;Lauantai;0;0;0;0;0;0
294;30.01.2016;2016;01;02;Lauantai;0;0;0;1;0;1
294;30.01.2016;2016;01;03;Lauantai;0;0;0;0;1;1
294;30.01.2016;2016;01;04;Lauantai;0;0;0;0;0;0
294;30.01.2016;2016;01;05;Lauantai;5;0;5;8;0;8
294;30.01.2016;2016;01;06;Lauantai;0;1;1;1;1;2
294;30.01.2016;2016;01;07;Lauantai;1;2;3;2;3;5
294;30.01.2016;2016;01;08;Lauantai;0;1;1;7;8;15
294;30.01.2016;2016;01;09;Lauantai;1;2;3;6;9;15
294;30.01.2016;2016;01;10;Lauantai;2;1;3;4;11;15
294;30.01.2016;2016;01;11;Lauantai;4;4;8;15;14;29
294;30.01.2016;2016;01;12;Lauantai;5;3;8;18;15;33
294;30.01.2016;2016;01;13;Lauantai;3;0;3;13;15;28
294;30.01.2016;2016;01;14;Lauantai;2;1;3;23;16;39
294;30.01.2016;2016;01;15;Lauantai;1;3;4;10;11;21
294;30.01.2016;2016;01;16;Lauantai;3;4;7;17;15;32
294;30.01.2016;2016;01;17;Lauantai;5;7;12;11;16;27
294;30.01.2016;2016;01;18;Lauantai;5;4;9;18;13;31
294;30.01.2016;2016;01;19;Lauantai;1;3;4;10;7;17
294;30.01.2016;2016;01;20;Lauantai;1;8;9;6;5;11
294;30.01.2016;2016;01;21;Lauantai;2;2;4;1;4;5
294;30.01.2016;2016;01;22;Lauantai;1;0;1;1;0;1
294;30.01.2016;2016;01;23;Lauantai;1;0;1;0;0;0
294;31.01.2016;2016;01;00;Sunnuntai;0;0;0;0;0;0
294;31.01.2016;2016;01;01;Sunnuntai;0;0;0;2;1;3
294;31.01.2016;2016;01;02;Sunnuntai;0;0;0;0;2;2
294;31.01.2016;2016;01;03;Sunnuntai;0;0;0;1;0;1
294;31.01.2016;2016;01;04;Sunnuntai;0;0;0;0;0;0
294;31.01.2016;2016;01;05;Sunnuntai;0;0;0;2;0;2
294;31.01.2016;2016;01;06;Sunnuntai;0;0;0;0;1;1
294;31.01.2016;2016;01;07;Sunnuntai;0;0;0;1;1;2
294;31.01.2016;2016;01;08;Sunnuntai;0;0;0;1;5;6
294;31.01.2016;2016;01;09;Sunnuntai;2;3;5;10;12;22
294;31.01.2016;2016;01;10;Sunnuntai;1;0;1;8;12;20
294;31.01.2016;2016;01;11;Sunnuntai;0;1;1;9;12;21
294;31.01.2016;2016;01;12;Sunnuntai;0;1;1;12;4;16
294;31.01.2016;2016;01;13;Sunnuntai;3;1;4;12;8;20
294;31.01.2016;2016;01;14;Sunnuntai;2;4;6;8;8;16
294;31.01.2016;2016;01;15;Sunnuntai;0;0;0;15;27;42
294;31.01.2016;2016;01;16;Sunnuntai;2;2;4;11;13;24
294;31.01.2016;2016;01;17;Sunnuntai;5;2;7;12;16;28
294;31.01.2016;2016;01;18;Sunnuntai;4;2;6;17;17;34
294;31.01.2016;2016;01;19;Sunnuntai;0;0;0;7;8;15
294;31.01.2016;2016;01;20;Sunnuntai;0;0;0;13;8;21
294;31.01.2016;2016;01;21;Sunnuntai;0;1;1;0;1;1
294;31.01.2016;2016;01;22;Sunnuntai;0;0;0;2;1;3
294;31.01.2016;2016;01;23;Sunnuntai;0;1;1;0;0;0
294;01.02.2016;2016;02;00;Maanantai;0;0;0;0;0;0
294;01.02.2016;2016;02;01;Maanantai;0;0;0;0;0;0
294;01.02.2016;2016;02;02;Maanantai;0;0;0;0;0;0
294;01.02.2016;2016;02;03;Maanantai;0;0;0;0;0;0
294;01.02.2016;2016;02;04;Maanantai;0;0;0;0;0;0
294;01.02.2016;2016;02;05;Maanantai;0;0;0;0;1;1
294;01.02.2016;2016;02;06;Maanantai;2;0;2;3;2;5
294;01.02.2016;2016;02;07;Maanantai;8;4;12;16;10;26
294;01.02.2016;2016;02;08;Maanantai;7;2;9;9;9;18
294;01.02.2016;2016;02;09;Maanantai;5;5;10;16;12;28
294;01.02.2016;2016;02;10;Maanantai;5;6;11;17;19;36
294;01.02.2016;2016;02;11;Maanantai;4;8;12;18;37;55
294;01.02.2016;2016;02;12;Maanantai;4;4;8;20;19;39
294;01.02.2016;2016;02;13;Maanantai;2;3;5;24;23;47
294;01.02.2016;2016;02;14;Maanantai;6;6;12;22;12;34
294;01.02.2016;2016;02;15;Maanantai;9;9;18;18;17;35
294;01.02.2016;2016;02;16;Maanantai;4;3;7;20;13;33
294;01.02.2016;2016;02;17;Maanantai;4;3;7;16;17;33
294;01.02.2016;2016;02;18;Maanantai;2;5;7;14;16;30
294;01.02.2016;2016;02;19;Maanantai;2;4;6;14;10;24
294;01.02.2016;2016;02;20;Maanantai;2;1;3;11;8;19
294;01.02.2016;2016;02;21;Maanantai;0;0;0;1;4;5
294;01.02.2016;2016;02;22;Maanantai;0;0;0;0;0;0
294;01.02.2016;2016;02;23;Maanantai;0;0;0;0;1;1
294;02.02.2016;2016;02;00;Tiistai;0;0;0;0;0;0
294;02.02.2016;2016;02;01;Tiistai;0;0;0;0;0;0
294;02.02.2016;2016;02;02;Tiistai;0;0;0;0;0;0
294;02.02.2016;2016;02;03;Tiistai;0;0;0;0;0;0
294;02.02.2016;2016;02;04;Tiistai;0;0;0;0;0;0
294;02.02.2016;2016;02;05;Tiistai;0;0;0;1;2;3
294;02.02.2016;2016;02;06;Tiistai;2;0;2;7;4;11
294;02.02.2016;2016;02;07;Tiistai;6;3;9;6;4;10
294;02.02.2016;2016;02;08;Tiistai;5;1;6;15;3;18
294;02.02.2016;2016;02;09;Tiistai;4;3;7;18;12;30
294;02.02.2016;2016;02;10;Tiistai;5;9;14;10;22;32
294;02.02.2016;2016;02;11;Tiistai;2;3;5;24;18;42
294;02.02.2016;2016;02;12;Tiistai;3;3;6;8;12;20
294;02.02.2016;2016;02;13;Tiistai;4;10;14;22;13;35
294;02.02.2016;2016;02;14;Tiistai;3;5;8;15;20;35
294;02.02.2016;2016;02;15;Tiistai;1;5;6;15;20;35
294;02.02.2016;2016;02;16;Tiistai;5;4;9;17;15;32
294;02.02.2016;2016;02;17;Tiistai;5;6;11;13;11;24
294;02.02.2016;2016;02;18;Tiistai;5;1;6;23;22;45
294;02.02.2016;2016;02;19;Tiistai;2;4;6;14;13;27
294;02.02.2016;2016;02;20;Tiistai;0;0;0;7;4;11
294;02.02.2016;2016;02;21;Tiistai;1;1;2;5;0;5
294;02.02.2016;2016;02;22;Tiistai;1;0;1;2;3;5
294;02.02.2016;2016;02;23;Tiistai;0;0;0;0;0;0
294;03.02.2016;2016;02;00;Keskiviikko;0;0;0;0;1;1
294;03.02.2016;2016;02;01;Keskiviikko;0;0;0;0;0;0
294;03.02.2016;2016;02;02;Keskiviikko;0;0;0;0;0;0
294;03.02.2016;2016;02;03;Keskiviikko;0;0;0;0;0;0
294;03.02.2016;2016;02;04;Keskiviikko;0;0;0;0;0;0
294;03.02.2016;2016;02;05;Keskiviikko;1;1;2;1;2;3
294;03.02.2016;2016;02;06;Keskiviikko;0;0;0;2;3;5
294;03.02.2016;2016;02;07;Keskiviikko;12;1;13;16;4;20
294;03.02.2016;2016;02;08;Keskiviikko;7;0;7;7;6;13
294;03.02.2016;2016;02;09;Keskiviikko;6;4;10;14;12;26
294;03.02.2016;2016;02;10;Keskiviikko;2;5;7;13;17;30
294;03.02.2016;2016;02;11;Keskiviikko;3;6;9;18;20;38
294;03.02.2016;2016;02;12;Keskiviikko;3;7;10;14;21;35
294;03.02.2016;2016;02;13;Keskiviikko;6;8;14;17;15;32
294;03.02.2016;2016;02;14;Keskiviikko;7;10;17;17;27;44
294;03.02.2016;2016;02;15;Keskiviikko;15;5;20;21;20;41
294;03.02.2016;2016;02;16;Keskiviikko;8;3;11;18;23;41
294;03.02.2016;2016;02;17;Keskiviikko;7;2;9;24;17;41
294;03.02.2016;2016;02;18;Keskiviikko;3;1;4;19;15;34
294;03.02.2016;2016;02;19;Keskiviikko;3;5;8;18;14;32
294;03.02.2016;2016;02;20;Keskiviikko;0;4;4;5;4;9
294;03.02.2016;2016;02;21;Keskiviikko;4;0;4;2;1;3
294;03.02.2016;2016;02;22;Keskiviikko;0;1;1;0;0;0
294;03.02.2016;2016;02;23;Keskiviikko;0;0;0;0;0;0
294;04.02.2016;2016;02;00;Torstai;0;0;0;0;0;0
294;04.02.2016;2016;02;01;Torstai;0;0;0;0;0;0
294;04.02.2016;2016;02;02;Torstai;0;0;0;0;0;0
294;04.02.2016;2016;02;03;Torstai;0;0;0;0;0;0
294;04.02.2016;2016;02;04;Torstai;0;0;0;0;0;0
294;04.02.2016;2016;02;05;Torstai;0;0;0;1;1;2
294;04.02.2016;2016;02;06;Torstai;0;2;2;3;1;4
294;04.02.2016;2016;02;07;Torstai;7;2;9;2;6;8
294;04.02.2016;2016;02;08;Torstai;9;5;14;13;5;18
294;04.02.2016;2016;02;09;Torstai;2;2;4;15;13;28
294;04.02.2016;2016;02;10;Torstai;0;2;2;10;15;25
294;04.02.2016;2016;02;11;Torstai;1;3;4;12;13;25
294;04.02.2016;2016;02;12;Torstai;4;1;5;24;6;30
294;04.02.2016;2016;02;13;Torstai;2;9;11;14;22;36
294;04.02.2016;2016;02;14;Torstai;3;6;9;22;17;39
294;04.02.2016;2016;02;15;Torstai;7;5;12;13;9;22
294;04.02.2016;2016;02;16;Torstai;7;3;10;9;15;24
294;04.02.2016;2016;02;17;Torstai;3;0;3;15;4;19
294;04.02.2016;2016;02;18;Torstai;3;6;9;17;20;37
294;04.02.2016;2016;02;19;Torstai;4;3;7;9;16;25
294;04.02.2016;2016;02;20;Torstai;3;1;4;9;12;21
294;04.02.2016;2016;02;21;Torstai;0;0;0;0;2;2
294;04.02.2016;2016;02;22;Torstai;0;0;0;1;0;1
294;04.02.2016;2016;02;23;Torstai;0;1;1;0;0;0
294;05.02.2016;2016;02;00;Perjantai;0;0;0;0;0;0
294;05.02.2016;2016;02;01;Perjantai;0;0;0;0;0;0
294;05.02.2016;2016;02;02;Perjantai;0;0;0;0;0;0
294;05.02.2016;2016;02;03;Perjantai;0;0;0;0;0;0
294;05.02.2016;2016;02;04;Perjantai;0;0;0;0;0;0
294;05.02.2016;2016;02;05;Perjantai;0;0;0;0;2;2
294;05.02.2016;2016;02;06;Perjantai;2;1;3;4;1;5
294;05.02.2016;2016;02;07;Perjantai;2;2;4;9;7;16
294;05.02.2016;2016;02;08;Perjantai;8;5;13;3;8;11
294;05.02.2016;2016;02;09;Perjantai;4;1;5;11;6;17
294;05.02.2016;2016;02;10;Perjantai;1;6;7;10;15;25
294;05.02.2016;2016;02;11;Perjantai;3;1;4;18;5;23
294;05.02.2016;2016;02;12;Perjantai;7;5;12;4;21;25
294;05.02.2016;2016;02;13;Perjantai;13;6;19;22;20;42
294;05.02.2016;2016;02;14;Perjantai;8;12;20;24;23;47
294;05.02.2016;2016;02;15;Perjantai;6;5;11;11;9;20
294;05.02.2016;2016;02;16;Perjantai;5;5;10;13;14;27
294;05.02.2016;2016;02;17;Perjantai;2;8;10;20;14;34
294;05.02.2016;2016;02;18;Perjantai;5;2;7;12;21;33
294;05.02.2016;2016;02;19;Perjantai;2;3;5;6;6;12
294;05.02.2016;2016;02;20;Perjantai;5;4;9;3;2;5
294;05.02.2016;2016;02;21;Perjantai;1;0;1;2;6;8
294;05.02.2016;2016;02;22;Perjantai;1;1;2;1;5;6
294;05.02.2016;2016;02;23;Perjantai;0;1;1;1;0;1
294;06.02.2016;2016;02;00;Lauantai;1;0;1;0;0;0
294;06.02.2016;2016;02;01;Lauantai;1;0;1;0;0;0
294;06.02.2016;2016;02;02;Lauantai;0;0;0;0;1;1
294;06.02.2016;2016;02;03;Lauantai;0;0;0;0;1;1
294;06.02.2016;2016;02;04;Lauantai;0;0;0;0;0;0
294;06.02.2016;2016;02;05;Lauantai;0;0;0;1;0;1
294;06.02.2016;2016;02;06;Lauantai;0;0;0;0;3;3
294;06.02.2016;2016;02;07;Lauantai;0;0;0;0;5;5
294;06.02.2016;2016;02;08;Lauantai;0;1;1;3;5;8
294;06.02.2016;2016;02;09;Lauantai;2;0;2;13;17;30
294;06.02.2016;2016;02;10;Lauantai;1;2;3;19;18;37
294;06.02.2016;2016;02;11;Lauantai;4;4;8;22;17;39
294;06.02.2016;2016;02;12;Lauantai;0;4;4;11;14;25
294;06.02.2016;2016;02;13;Lauantai;5;1;6;26;17;43
294;06.02.2016;2016;02;14;Lauantai;7;2;9;10;15;25
294;06.02.2016;2016;02;15;Lauantai;5;5;10;12;9;21
294;06.02.2016;2016;02;16;Lauantai;1;5;6;12;15;27
294;06.02.2016;2016;02;17;Lauantai;3;4;7;15;8;23
294;06.02.2016;2016;02;18;Lauantai;6;7;13;15;5;20
294;06.02.2016;2016;02;19;Lauantai;1;4;5;4;4;8
294;06.02.2016;2016;02;20;Lauantai;1;0;1;2;3;5
294;06.02.2016;2016;02;21;Lauantai;3;0;3;4;5;9
294;06.02.2016;2016;02;22;Lauantai;2;0;2;6;3;9
294;06.02.2016;2016;02;23;Lauantai;1;0;1;0;0;0
294;07.02.2016;2016;02;00;Sunnuntai;0;0;0;0;0;0
294;07.02.2016;2016;02;01;Sunnuntai;0;0;0;1;0;1
294;07.02.2016;2016;02;02;Sunnuntai;0;0;0;1;2;3
294;07.02.2016;2016;02;03;Sunnuntai;0;0;0;0;0;0
294;07.02.2016;2016;02;04;Sunnuntai;0;0;0;4;0;4
294;07.02.2016;2016;02;05;Sunnuntai;0;0;0;1;0;1
294;07.02.2016;2016;02;06;Sunnuntai;0;0;0;1;0;1
294;07.02.2016;2016;02;07;Sunnuntai;0;0;0;0;4;4
294;07.02.2016;2016;02;08;Sunnuntai;0;0;0;1;4;5
294;07.02.2016;2016;02;09;Sunnuntai;0;0;0;12;3;15
294;07.02.2016;2016;02;10;Sunnuntai;1;0;1;9;6;15
294;07.02.2016;2016;02;11;Sunnuntai;0;3;3;5;9;14
294;07.02.2016;2016;02;12;Sunnuntai;2;1;3;12;13;25
294;07.02.2016;2016;02;13;Sunnuntai;2;0;2;14;16;30
294;07.02.2016;2016;02;14;Sunnuntai;1;1;2;12;15;27
294;07.02.2016;2016;02;15;Sunnuntai;3;2;5;9;8;17
294;07.02.2016;2016;02;16;Sunnuntai;0;0;0;5;8;13
294;07.02.2016;2016;02;17;Sunnuntai;3;0;3;14;10;24
294;07.02.2016;2016;02;18;Sunnuntai;0;1;1;15;16;31
294;07.02.2016;2016;02;19;Sunnuntai;0;0;0;19;11;30
294;07.02.2016;2016;02;20;Sunnuntai;0;0;0;6;6;12
294;07.02.2016;2016;02;21;Sunnuntai;0;0;0;1;0;1
294;07.02.2016;2016;02;22;Sunnuntai;0;0;0;0;0;0
294;07.02.2016;2016;02;23;Sunnuntai;0;0;0;0;0;0
294;08.02.2016;2016;02;00;Maanantai;0;0;0;0;1;1
294;08.02.2016;2016;02;01;Maanantai;0;0;0;0;0;0
294;08.02.2016;2016;02;02;Maanantai;0;0;0;0;0;0
294;08.02.2016;2016;02;03;Maanantai;0;0;0;0;0;0
294;08.02.2016;2016;02;04;Maanantai;0;0;0;0;0;0
294;08.02.2016;2016;02;05;Maanantai;0;0;0;1;1;2
294;08.02.2016;2016;02;06;Maanantai;0;0;0;2;0;2
294;08.02.2016;2016;02;07;Maanantai;5;2;7;10;2;12
294;08.02.2016;2016;02;08;Maanantai;2;1;3;9;12;21
294;08.02.2016;2016;02;09;Maanantai;5;0;5;20;13;33
294;08.02.2016;2016;02;10;Maanantai;2;0;2;19;19;38
294;08.02.2016;2016;02;11;Maanantai;1;2;3;19;20;39
294;08.02.2016;2016;02;12;Maanantai;3;1;4;11;13;24
294;08.02.2016;2016;02;13;Maanantai;3;3;6;17;14;31
294;08.02.2016;2016;02;14;Maanantai;3;8;11;14;23;37
294;08.02.2016;2016;02;15;Maanantai;2;2;4;11;17;28
294;08.02.2016;2016;02;16;Maanantai;7;3;10;18;10;28
294;08.02.2016;2016;02;17;Maanantai;2;5;7;17;15;32
294;08.02.2016;2016;02;18;Maanantai;2;3;5;11;16;27
294;08.02.2016;2016;02;19;Maanantai;2;3;5;7;11;18
294;08.02.2016;2016;02;20;Maanantai;2;1;3;8;7;15
294;08.02.2016;2016;02;21;Maanantai;0;0;0;0;0;0
294;08.02.2016;2016;02;22;Maanantai;0;0;0;0;1;1
294;08.02.2016;2016;02;23;Maanantai;0;0;0;0;0;0
294;09.02.2016;2016;02;00;Tiistai;0;0;0;0;0;0
294;09.02.2016;2016;02;01;Tiistai;0;0;0;0;0;0
294;09.02.2016;2016;02;02;Tiistai;0;0;0;0;0;0
294;09.02.2016;2016;02;03;Tiistai;0;0;0;0;0;0
294;09.02.2016;2016;02;04;Tiistai;0;0;0;0;0;0
294;09.02.2016;2016;02;05;Tiistai;0;0;0;1;1;2
294;09.02.2016;2016;02;06;Tiistai;1;0;1;4;0;4
294;09.02.2016;2016;02;07;Tiistai;2;2;4;5;6;11
294;09.02.2016;2016;02;08;Tiistai;1;1;2;9;4;13
294;09.02.2016;2016;02;09;Tiistai;3;0;3;21;9;30
294;09.02.2016;2016;02;10;Tiistai;0;1;1;10;18;28
294;09.02.2016;2016;02;11;Tiistai;3;2;5;29;14;43
294;09.02.2016;2016;02;12;Tiistai;3;4;7;9;15;24
294;09.02.2016;2016;02;13;Tiistai;3;1;4;7;13;20
294;09.02.2016;2016;02;14;Tiistai;0;3;3;12;8;20
294;09.02.2016;2016;02;15;Tiistai;2;7;9;11;14;25
294;09.02.2016;2016;02;16;Tiistai;2;2;4;12;10;22
294;09.02.2016;2016;02;17;Tiistai;3;0;3;8;17;25
294;09.02.2016;2016;02;18;Tiistai;0;1;1;16;6;22
294;09.02.2016;2016;02;19;Tiistai;1;2;3;5;5;10
294;09.02.2016;2016;02;20;Tiistai;1;0;1;4;3;7
294;09.02.2016;2016;02;21;Tiistai;0;0;0;0;0;0
294;09.02.2016;2016;02;22;Tiistai;0;0;0;0;0;0
294;09.02.2016;2016;02;23;Tiistai;0;0;0;0;0;0
294;10.02.2016;2016;02;00;Keskiviikko;0;0;0;0;0;0
294;10.02.2016;2016;02;01;Keskiviikko;0;0;0;0;0;0
294;10.02.2016;2016;02;02;Keskiviikko;0;0;0;0;0;0
294;10.02.2016;2016;02;03;Keskiviikko;0;0;0;0;0;0
294;10.02.2016;2016;02;04;Keskiviikko;0;0;0;0;0;0
294;10.02.2016;2016;02;05;Keskiviikko;0;0;0;1;2;3
294;10.02.2016;2016;02;06;Keskiviikko;1;1;2;1;1;2
294;10.02.2016;2016;02;07;Keskiviikko;2;2;4;11;2;13
294;10.02.2016;2016;02;08;Keskiviikko;6;0;6;11;3;14
294;10.02.2016;2016;02;09;Keskiviikko;2;3;5;13;15;28
294;10.02.2016;2016;02;10;Keskiviikko;2;2;4;12;11;23
294;10.02.2016;2016;02;11;Keskiviikko;2;0;2;11;7;18
294;10.02.2016;2016;02;12;Keskiviikko;0;1;1;7;14;21
294;10.02.2016;2016;02;13;Keskiviikko;1;0;1;5;2;7
294;10.02.2016;2016;02;14;Keskiviikko;6;6;12;7;9;16
294;10.02.2016;2016;02;15;Keskiviikko;4;10;14;12;19;31
294;10.02.2016;2016;02;16;Keskiviikko;4;7;11;7;10;17
294;10.02.2016;2016;02;17;Keskiviikko;3;5;8;8;12;20
294;10.02.2016;2016;02;18;Keskiviikko;0;0;0;13;12;25
294;10.02.2016;2016;02;19;Keskiviikko;3;1;4;4;15;19
294;10.02.2016;2016;02;20;Keskiviikko;1;0;1;2;5;7
294;10.02.2016;2016;02;21;Keskiviikko;0;0;0;1;1;2
294;10.02.2016;2016;02;22;Keskiviikko;0;0;0;1;0;1
294;10.02.2016;2016;02;23;Keskiviikko;0;0;0;0;1;1
294;11.02.2016;2016;02;00;Torstai;0;0;0;0;1;1
294;11.02.2016;2016;02;01;Torstai;0;0;0;0;0;0
294;11.02.2016;2016;02;02;Torstai;0;0;0;0;0;0
294;11.02.2016;2016;02;03;Torstai;0;0;0;0;0;0
294;11.02.2016;2016;02;04;Torstai;0;0;0;0;1;1
294;11.02.2016;2016;02;05;Torstai;0;1;1;2;0;2
294;11.02.2016;2016;02;06;Torstai;0;0;0;3;2;5
294;11.02.2016;2016;02;07;Torstai;2;2;4;4;4;8
294;11.02.2016;2016;02;08;Torstai;6;0;6;9;3;12
294;11.02.2016;2016;02;09;Torstai;3;5;8;16;10;26
294;11.02.2016;2016;02;10;Torstai;0;3;3;10;16;26
294;11.02.2016;2016;02;11;Torstai;2;2;4;22;20;42
294;11.02.2016;2016;02;12;Torstai;2;1;3;13;16;29
294;11.02.2016;2016;02;13;Torstai;4;5;9;12;20;32
294;11.02.2016;2016;02;14;Torstai;13;9;22;25;12;37
294;11.02.2016;2016;02;15;Torstai;3;7;10;12;5;17
294;11.02.2016;2016;02;16;Torstai;3;3;6;14;10;24
294;11.02.2016;2016;02;17;Torstai;3;1;4;8;12;20
294;11.02.2016;2016;02;18;Torstai;1;7;8;13;14;27
294;11.02.2016;2016;02;19;Torstai;4;0;4;6;8;14
294;11.02.2016;2016;02;20;Torstai;0;1;1;1;4;5
294;11.02.2016;2016;02;21;Torstai;0;0;0;2;2;4
294;11.02.2016;2016;02;22;Torstai;0;0;0;0;0;0
294;11.02.2016;2016;02;23;Torstai;0;0;0;0;0;0
294;12.02.2016;2016;02;00;Perjantai;0;0;0;0;0;0
294;12.02.2016;2016;02;01;Perjantai;0;0;0;0;0;0
294;12.02.2016;2016;02;02;Perjantai;0;0;0;0;0;0
294;12.02.2016;2016;02;03;Perjantai;0;0;0;0;0;0
294;12.02.2016;2016;02;04;Perjantai;1;1;2;6;5;11
294;12.02.2016;2016;02;05;Perjantai;0;0;0;1;0;1
294;12.02.2016;2016;02;06;Perjantai;1;0;1;4;0;4
294;12.02.2016;2016;02;07;Perjantai;2;2;4;5;3;8
294;12.02.2016;2016;02;08;Perjantai;3;1;4;8;2;10
294;12.02.2016;2016;02;09;Perjantai;8;1;9;13;11;24
294;12.02.2016;2016;02;10;Perjantai;0;3;3;11;10;21
294;12.02.2016;2016;02;11;Perjantai;4;3;7;7;11;18
294;12.02.2016;2016;02;12;Perjantai;3;5;8;11;20;31
294;12.02.2016;2016;02;13;Perjantai;5;5;10;24;16;40
294;12.02.2016;2016;02;14;Perjantai;2;8;10;11;22;33
294;12.02.2016;2016;02;15;Perjantai;2;9;11;12;7;19
294;12.02.2016;2016;02;16;Perjantai;0;1;1;9;5;14
294;12.02.2016;2016;02;17;Perjantai;0;1;1;6;9;15
294;12.02.2016;2016;02;18;Perjantai;2;1;3;17;19;36
294;12.02.2016;2016;02;19;Perjantai;1;5;6;11;4;15
294;12.02.2016;2016;02;20;Perjantai;1;1;2;6;1;7
294;12.02.2016;2016;02;21;Perjantai;3;0;3;3;0;3
294;12.02.2016;2016;02;22;Perjantai;5;0;5;0;0;0
294;12.02.2016;2016;02;23;Perjantai;1;0;1;0;1;1
294;13.02.2016;2016;02;00;Lauantai;0;1;1;1;0;1
294;13.02.2016;2016;02;01;Lauantai;0;0;0;0;0;0
294;13.02.2016;2016;02;02;Lauantai;1;0;1;0;0;0
294;13.02.2016;2016;02;03;Lauantai;0;0;0;0;1;1
294;13.02.2016;2016;02;04;Lauantai;0;0;0;0;0;0
294;13.02.2016;2016;02;05;Lauantai;0;0;0;2;0;2
294;13.02.2016;2016;02;06;Lauantai;0;1;1;9;5;14
294;13.02.2016;2016;02;07;Lauantai;0;0;0;2;5;7
294;13.02.2016;2016;02;08;Lauantai;0;0;0;3;10;13
294;13.02.2016;2016;02;09;Lauantai;1;0;1;15;8;23
294;13.02.2016;2016;02;10;Lauantai;0;0;0;10;10;20
294;13.02.2016;2016;02;11;Lauantai;3;2;5;13;9;22
294;13.02.2016;2016;02;12;Lauantai;1;2;3;16;25;41
294;13.02.2016;2016;02;13;Lauantai;2;2;4;14;12;26
294;13.02.2016;2016;02;14;Lauantai;2;3;5;14;6;20
294;13.02.2016;2016;02;15;Lauantai;1;1;2;12;8;20
294;13.02.2016;2016;02;16;Lauantai;3;9;12;11;9;20
294;13.02.2016;2016;02;17;Lauantai;6;4;10;15;15;30
294;13.02.2016;2016;02;18;Lauantai;1;0;1;13;2;15
294;13.02.2016;2016;02;19;Lauantai;0;1;1;10;4;14
294;13.02.2016;2016;02;20;Lauantai;1;0;1;6;8;14
294;13.02.2016;2016;02;21;Lauantai;3;4;7;4;5;9
294;13.02.2016;2016;02;22;Lauantai;2;0;2;7;1;8
294;13.02.2016;2016;02;23;Lauantai;1;0;1;0;0;0
294;14.02.2016;2016;02;00;Sunnuntai;0;0;0;1;2;3
294;14.02.2016;2016;02;01;Sunnuntai;0;0;0;0;0;0
294;14.02.2016;2016;02;02;Sunnuntai;0;0;0;0;1;1
294;14.02.2016;2016;02;03;Sunnuntai;0;0;0;1;0;1
294;14.02.2016;2016;02;04;Sunnuntai;0;0;0;0;0;0
294;14.02.2016;2016;02;05;Sunnuntai;0;0;0;0;0;0
294;14.02.2016;2016;02;06;Sunnuntai;0;1;1;1;1;2
294;14.02.2016;2016;02;07;Sunnuntai;0;0;0;0;3;3
294;14.02.2016;2016;02;08;Sunnuntai;1;0;1;7;6;13
294;14.02.2016;2016;02;09;Sunnuntai;2;1;3;10;3;13
294;14.02.2016;2016;02;10;Sunnuntai;0;0;0;9;7;16
294;14.02.2016;2016;02;11;Sunnuntai;0;2;2;11;12;23
294;14.02.2016;2016;02;12;Sunnuntai;1;1;2;15;12;27
294;14.02.2016;2016;02;13;Sunnuntai;3;2;5;21;11;32
294;14.02.2016;2016;02;14;Sunnuntai;2;3;5;7;6;13
294;14.02.2016;2016;02;15;Sunnuntai;4;2;6;6;6;12
294;14.02.2016;2016;02;16;Sunnuntai;0;3;3;11;8;19
294;14.02.2016;2016;02;17;Sunnuntai;1;2;3;12;12;24
294;14.02.2016;2016;02;18;Sunnuntai;4;7;11;18;9;27
294;14.02.2016;2016;02;19;Sunnuntai;2;3;5;8;9;17
294;14.02.2016;2016;02;20;Sunnuntai;0;1;1;8;7;15
294;14.02.2016;2016;02;21;Sunnuntai;0;0;0;4;0;4
294;14.02.2016;2016;02;22;Sunnuntai;0;0;0;0;0;0
294;14.02.2016;2016;02;23;Sunnuntai;0;0;0;0;0;0
294;15.02.2016;2016;02;00;Maanantai;0;0;0;0;0;0
294;15.02.2016;2016;02;01;Maanantai;0;0;0;0;0;0
294;15.02.2016;2016;02;02;Maanantai;0;0;0;0;0;0
294;15.02.2016;2016;02;03;Maanantai;0;0;0;0;0;0
294;15.02.2016;2016;02;04;Maanantai;0;0;0;0;0;0
294;15.02.2016;2016;02;05;Maanantai;0;0;0;2;0;2
294;15.02.2016;2016;02;06;Maanantai;2;0;2;1;5;6
294;15.02.2016;2016;02;07;Maanantai;5;3;8;12;4;16
294;15.02.2016;2016;02;08;Maanantai;8;3;11;16;11;27
294;15.02.2016;2016;02;09;Maanantai;2;5;7;19;19;38
294;15.02.2016;2016;02;10;Maanantai;1;6;7;26;25;51
294;15.02.2016;2016;02;11;Maanantai;3;1;4;25;29;54
294;15.02.2016;2016;02;12;Maanantai;3;7;10;16;23;39
294;15.02.2016;2016;02;13;Maanantai;6;1;7;20;18;38
294;15.02.2016;2016;02;14;Maanantai;4;5;9;20;18;38
294;15.02.2016;2016;02;15;Maanantai;9;11;20;11;28;39
294;15.02.2016;2016;02;16;Maanantai;7;5;12;20;16;36
294;15.02.2016;2016;02;17;Maanantai;7;7;14;15;16;31
294;15.02.2016;2016;02;18;Maanantai;7;4;11;9;16;25
294;15.02.2016;2016;02;19;Maanantai;4;2;6;11;7;18
294;15.02.2016;2016;02;20;Maanantai;0;0;0;8;4;12
294;15.02.2016;2016;02;21;Maanantai;0;1;1;3;3;6
294;15.02.2016;2016;02;22;Maanantai;0;0;0;0;0;0
294;15.02.2016;2016;02;23;Maanantai;0;0;0;0;0;0
294;16.02.2016;2016;02;00;Tiistai;0;0;0;0;0;0
294;16.02.2016;2016;02;01;Tiistai;0;0;0;0;0;0
294;16.02.2016;2016;02;02;Tiistai;0;0;0;0;0;0
294;16.02.2016;2016;02;03;Tiistai;0;0;0;0;0;0
294;16.02.2016;2016;02;04;Tiistai;0;0;0;0;0;0
294;16.02.2016;2016;02;05;Tiistai;0;0;0;2;1;3
294;16.02.2016;2016;02;06;Tiistai;1;0;1;3;0;3
294;16.02.2016;2016;02;07;Tiistai;3;6;9;6;9;15
294;16.02.2016;2016;02;08;Tiistai;2;2;4;11;6;17
294;16.02.2016;2016;02;09;Tiistai;6;2;8;21;10;31
294;16.02.2016;2016;02;10;Tiistai;4;3;7;5;19;24
294;16.02.2016;2016;02;11;Tiistai;0;4;4;26;29;55
294;16.02.2016;2016;02;12;Tiistai;2;4;6;26;33;59
294;16.02.2016;2016;02;13;Tiistai;4;6;10;24;23;47
294;16.02.2016;2016;02;14;Tiistai;3;1;4;19;15;34
294;16.02.2016;2016;02;15;Tiistai;4;6;10;16;28;44
294;16.02.2016;2016;02;16;Tiistai;7;6;13;15;24;39
294;16.02.2016;2016;02;17;Tiistai;2;4;6;7;14;21
294;16.02.2016;2016;02;18;Tiistai;8;1;9;19;9;28
294;16.02.2016;2016;02;19;Tiistai;1;5;6;9;11;20
294;16.02.2016;2016;02;20;Tiistai;1;2;3;9;2;11
294;16.02.2016;2016;02;21;Tiistai;0;1;1;1;1;2
294;16.02.2016;2016;02;22;Tiistai;0;0;0;1;0;1
294;16.02.2016;2016;02;23;Tiistai;0;0;0;0;0;0
294;17.02.2016;2016;02;00;Keskiviikko;0;0;0;0;0;0
294;17.02.2016;2016;02;01;Keskiviikko;0;0;0;0;0;0
294;17.02.2016;2016;02;02;Keskiviikko;0;0;0;0;0;0
294;17.02.2016;2016;02;03;Keskiviikko;0;0;0;0;0;0
294;17.02.2016;2016;02;04;Keskiviikko;0;0;0;0;0;0
294;17.02.2016;2016;02;05;Keskiviikko;0;1;1;2;2;4
294;17.02.2016;2016;02;06;Keskiviikko;1;1;2;5;3;8
294;17.02.2016;2016;02;07;Keskiviikko;6;4;10;10;8;18
294;17.02.2016;2016;02;08;Keskiviikko;5;2;7;11;7;18
294;17.02.2016;2016;02;09;Keskiviikko;8;4;12;35;11;46
294;17.02.2016;2016;02;10;Keskiviikko;3;2;5;7;15;22
294;17.02.2016;2016;02;11;Keskiviikko;4;3;7;21;15;36
294;17.02.2016;2016;02;12;Keskiviikko;3;3;6;10;12;22
294;17.02.2016;2016;02;13;Keskiviikko;4;2;6;15;10;25
294;17.02.2016;2016;02;14;Keskiviikko;4;6;10;18;17;35
294;17.02.2016;2016;02;15;Keskiviikko;11;6;17;16;14;30
294;17.02.2016;2016;02;16;Keskiviikko;1;3;4;15;15;30
294;17.02.2016;2016;02;17;Keskiviikko;3;5;8;16;10;26
294;17.02.2016;2016;02;18;Keskiviikko;2;2;4;22;16;38
294;17.02.2016;2016;02;19;Keskiviikko;3;0;3;12;11;23
294;17.02.2016;2016;02;20;Keskiviikko;1;2;3;7;4;11
294;17.02.2016;2016;02;21;Keskiviikko;0;1;1;1;1;2
294;17.02.2016;2016;02;22;Keskiviikko;0;0;0;0;0;0
294;17.02.2016;2016;02;23;Keskiviikko;0;0;0;0;0;0
294;18.02.2016;2016;02;00;Torstai;0;0;0;0;0;0
294;18.02.2016;2016;02;01;Torstai;0;0;0;0;0;0
294;18.02.2016;2016;02;02;Torstai;0;0;0;0;0;0
294;18.02.2016;2016;02;03;Torstai;0;0;0;0;0;0
294;18.02.2016;2016;02;04;Torstai;0;0;0;0;1;1
294;18.02.2016;2016;02;05;Torstai;0;0;0;1;0;1
294;18.02.2016;2016;02;06;Torstai;0;1;1;4;0;4
294;18.02.2016;2016;02;07;Torstai;5;2;7;11;4;15
294;18.02.2016;2016;02;08;Torstai;7;4;11;6;7;13
294;18.02.2016;2016;02;09;Torstai;3;2;5;26;12;38
294;18.02.2016;2016;02;10;Torstai;3;1;4;21;28;49
294;18.02.2016;2016;02;11;Torstai;3;3;6;15;19;34
294;18.02.2016;2016;02;12;Torstai;2;4;6;22;17;39
294;18.02.2016;2016;02;13;Torstai;0;3;3;14;22;36
294;18.02.2016;2016;02;14;Torstai;4;6;10;18;12;30
294;18.02.2016;2016;02;15;Torstai;5;7;12;12;19;31
294;18.02.2016;2016;02;16;Torstai;6;6;12;17;13;30
294;18.02.2016;2016;02;17;Torstai;9;4;13;12;8;20
294;18.02.2016;2016;02;18;Torstai;0;0;0;11;11;22
294;18.02.2016;2016;02;19;Torstai;1;1;2;10;10;20
294;18.02.2016;2016;02;20;Torstai;0;0;0;11;6;17
294;18.02.2016;2016;02;21;Torstai;0;0;0;1;1;2
294;18.02.2016;2016;02;22;Torstai;0;0;0;1;0;1
294;18.02.2016;2016;02;23;Torstai;0;0;0;0;0;0
294;19.02.2016;2016;02;00;Perjantai;0;0;0;0;0;0
294;19.02.2016;2016;02;01;Perjantai;0;0;0;0;0;0
294;19.02.2016;2016;02;02;Perjantai;0;0;0;0;0;0
294;19.02.2016;2016;02;03;Perjantai;0;0;0;0;0;0
294;19.02.2016;2016;02;04;Perjantai;0;0;0;0;0;0
294;19.02.2016;2016;02;05;Perjantai;7;0;7;4;1;5
294;19.02.2016;2016;02;06;Perjantai;0;1;1;3;3;6
294;19.02.2016;2016;02;07;Perjantai;4;4;8;5;6;11
294;19.02.2016;2016;02;08;Perjantai;3;2;5;9;4;13
294;19.02.2016;2016;02;09;Perjantai;10;4;14;21;15;36
294;19.02.2016;2016;02;10;Perjantai;1;1;2;11;19;30
294;19.02.2016;2016;02;11;Perjantai;3;3;6;15;19;34
294;19.02.2016;2016;02;12;Perjantai;1;4;5;12;21;33
294;19.02.2016;2016;02;13;Perjantai;4;3;7;17;17;34
294;19.02.2016;2016;02;14;Perjantai;5;3;8;24;17;41
294;19.02.2016;2016;02;15;Perjantai;2;5;7;14;13;27
294;19.02.2016;2016;02;16;Perjantai;4;3;7;17;16;33
294;19.02.2016;2016;02;17;Perjantai;5;1;6;18;8;26
294;19.02.2016;2016;02;18;Perjantai;0;1;1;4;6;10
294;19.02.2016;2016;02;19;Perjantai;1;0;1;5;12;17
294;19.02.2016;2016;02;20;Perjantai;0;1;1;3;7;10
294;19.02.2016;2016;02;21;Perjantai;1;2;3;4;1;5
294;19.02.2016;2016;02;22;Perjantai;0;0;0;0;0;0
294;19.02.2016;2016;02;23;Perjantai;0;0;0;0;1;1
294;20.02.2016;2016;02;00;Lauantai;1;1;2;2;0;2
294;20.02.2016;2016;02;01;Lauantai;0;0;0;2;1;3
294;20.02.2016;2016;02;02;Lauantai;0;0;0;0;1;1
294;20.02.2016;2016;02;03;Lauantai;0;0;0;0;0;0
294;20.02.2016;2016;02;04;Lauantai;0;0;0;0;0;0
294;20.02.2016;2016;02;05;Lauantai;0;0;0;3;3;6
294;20.02.2016;2016;02;06;Lauantai;0;0;0;3;1;4
294;20.02.2016;2016;02;07;Lauantai;0;0;0;1;6;7
294;20.02.2016;2016;02;08;Lauantai;0;0;0;2;4;6
294;20.02.2016;2016;02;09;Lauantai;1;1;2;10;8;18
294;20.02.2016;2016;02;10;Lauantai;6;2;8;23;14;37
294;20.02.2016;2016;02;11;Lauantai;6;7;13;17;15;32
294;20.02.2016;2016;02;12;Lauantai;0;2;2;7;17;24
294;20.02.2016;2016;02;13;Lauantai;2;0;2;6;9;15
294;20.02.2016;2016;02;14;Lauantai;0;2;2;10;19;29
294;20.02.2016;2016;02;15;Lauantai;1;1;2;7;8;15
294;20.02.2016;2016;02;16;Lauantai;0;2;2;8;11;19
294;20.02.2016;2016;02;17;Lauantai;2;2;4;17;13;30
294;20.02.2016;2016;02;18;Lauantai;0;1;1;9;6;15
294;20.02.2016;2016;02;19;Lauantai;1;1;2;12;4;16
294;20.02.2016;2016;02;20;Lauantai;1;0;1;6;7;13
294;20.02.2016;2016;02;21;Lauantai;3;1;4;5;2;7
294;20.02.2016;2016;02;22;Lauantai;0;0;0;1;1;2
294;20.02.2016;2016;02;23;Lauantai;0;0;0;2;0;2
294;21.02.2016;2016;02;00;Sunnuntai;1;0;1;4;0;4
294;21.02.2016;2016;02;01;Sunnuntai;0;1;1;0;0;0
294;21.02.2016;2016;02;02;Sunnuntai;0;0;0;3;0;3
294;21.02.2016;2016;02;03;Sunnuntai;0;0;0;0;0;0
294;21.02.2016;2016;02;04;Sunnuntai;0;1;1;1;1;2
294;21.02.2016;2016;02;05;Sunnuntai;0;0;0;2;2;4
294;21.02.2016;2016;02;06;Sunnuntai;3;0;3;5;2;7
294;21.02.2016;2016;02;07;Sunnuntai;0;0;0;1;2;3
294;21.02.2016;2016;02;08;Sunnuntai;0;0;0;3;2;5
294;21.02.2016;2016;02;09;Sunnuntai;1;0;1;12;8;20
294;21.02.2016;2016;02;10;Sunnuntai;0;1;1;2;7;9
294;21.02.2016;2016;02;11;Sunnuntai;1;1;2;7;8;15
294;21.02.2016;2016;02;12;Sunnuntai;2;0;2;9;8;17
294;21.02.2016;2016;02;13;Sunnuntai;2;3;5;8;7;15
294;21.02.2016;2016;02;14;Sunnuntai;2;2;4;7;9;16
294;21.02.2016;2016;02;15;Sunnuntai;3;1;4;5;6;11
294;21.02.2016;2016;02;16;Sunnuntai;2;2;4;16;11;27
294;21.02.2016;2016;02;17;Sunnuntai;3;4;7;21;14;35
294;21.02.2016;2016;02;18;Sunnuntai;1;3;4;9;10;19
294;21.02.2016;2016;02;19;Sunnuntai;3;3;6;10;6;16
294;21.02.2016;2016;02;20;Sunnuntai;1;0;1;8;8;16
294;21.02.2016;2016;02;21;Sunnuntai;0;1;1;2;2;4
294;21.02.2016;2016;02;22;Sunnuntai;0;0;0;2;0;2
294;21.02.2016;2016;02;23;Sunnuntai;0;0;0;0;0;0
294;22.02.2016;2016;02;00;Maanantai;0;0;0;0;0;0
294;22.02.2016;2016;02;01;Maanantai;0;0;0;0;0;0
294;22.02.2016;2016;02;02;Maanantai;0;0;0;0;2;2
294;22.02.2016;2016;02;03;Maanantai;0;0;0;0;0;0
294;22.02.2016;2016;02;04;Maanantai;0;0;0;0;0;0
294;22.02.2016;2016;02;05;Maanantai;0;1;1;1;1;2
294;22.02.2016;2016;02;06;Maanantai;1;1;2;3;2;5
294;22.02.2016;2016;02;07;Maanantai;3;3;6;13;5;18
294;22.02.2016;2016;02;08;Maanantai;7;1;8;9;8;17
294;22.02.2016;2016;02;09;Maanantai;2;1;3;17;9;26
294;22.02.2016;2016;02;10;Maanantai;0;1;1;21;20;41
294;22.02.2016;2016;02;11;Maanantai;1;5;6;25;21;46
294;22.02.2016;2016;02;12;Maanantai;4;5;9;22;21;43
294;22.02.2016;2016;02;13;Maanantai;1;4;5;14;9;23
294;22.02.2016;2016;02;14;Maanantai;7;4;11;15;22;37
294;22.02.2016;2016;02;15;Maanantai;7;6;13;21;17;38
294;22.02.2016;2016;02;16;Maanantai;0;2;2;23;17;40
294;22.02.2016;2016;02;17;Maanantai;4;2;6;9;6;15
294;22.02.2016;2016;02;18;Maanantai;2;2;4;11;13;24
294;22.02.2016;2016;02;19;Maanantai;2;4;6;18;14;32
294;22.02.2016;2016;02;20;Maanantai;0;1;1;8;7;15
294;22.02.2016;2016;02;21;Maanantai;0;1;1;2;1;3
294;22.02.2016;2016;02;22;Maanantai;0;0;0;3;0;3
294;22.02.2016;2016;02;23;Maanantai;0;0;0;1;0;1
294;23.02.2016;2016;02;00;Tiistai;0;0;0;0;0;0
294;23.02.2016;2016;02;01;Tiistai;0;0;0;0;0;0
294;23.02.2016;2016;02;02;Tiistai;0;0;0;0;0;0
294;23.02.2016;2016;02;03;Tiistai;0;0;0;0;0;0
294;23.02.2016;2016;02;04;Tiistai;0;0;0;0;1;1
294;23.02.2016;2016;02;05;Tiistai;0;0;0;1;0;1
294;23.02.2016;2016;02;06;Tiistai;2;1;3;2;5;7
294;23.02.2016;2016;02;07;Tiistai;3;3;6;12;1;13
294;23.02.2016;2016;02;08;Tiistai;6;2;8;18;7;25
294;23.02.2016;2016;02;09;Tiistai;7;0;7;18;14;32
294;23.02.2016;2016;02;10;Tiistai;3;1;4;14;24;38
294;23.02.2016;2016;02;11;Tiistai;3;3;6;18;34;52
294;23.02.2016;2016;02;12;Tiistai;0;2;2;32;21;53
294;23.02.2016;2016;02;13;Tiistai;1;6;7;31;21;52
294;23.02.2016;2016;02;14;Tiistai;3;0;3;22;15;37
294;23.02.2016;2016;02;15;Tiistai;9;9;18;24;18;42
294;23.02.2016;2016;02;16;Tiistai;3;5;8;24;10;34
294;23.02.2016;2016;02;17;Tiistai;1;5;6;15;10;25
294;23.02.2016;2016;02;18;Tiistai;2;2;4;13;7;20
294;23.02.2016;2016;02;19;Tiistai;1;3;4;13;5;18
294;23.02.2016;2016;02;20;Tiistai;1;0;1;12;2;14
294;23.02.2016;2016;02;21;Tiistai;0;0;0;1;2;3
294;23.02.2016;2016;02;22;Tiistai;0;0;0;0;0;0
294;23.02.2016;2016;02;23;Tiistai;1;0;1;0;0;0
294;24.02.2016;2016;02;00;Keskiviikko;0;0;0;0;0;0
294;24.02.2016;2016;02;01;Keskiviikko;0;0;0;0;0;0
294;24.02.2016;2016;02;02;Keskiviikko;0;0;0;0;0;0
294;24.02.2016;2016;02;03;Keskiviikko;0;0;0;0;0;0
294;24.02.2016;2016;02;04;Keskiviikko;0;0;0;0;0;0
294;24.02.2016;2016;02;05;Keskiviikko;0;0;0;1;1;2
294;24.02.2016;2016;02;06;Keskiviikko;1;1;2;5;0;5
294;24.02.2016;2016;02;07;Keskiviikko;6;1;7;14;10;24
294;24.02.2016;2016;02;08;Keskiviikko;4;1;5;18;9;27
294;24.02.2016;2016;02;09;Keskiviikko;3;6;9;24;8;32
294;24.02.2016;2016;02;10;Keskiviikko;1;1;2;15;21;36
294;24.02.2016;2016;02;11;Keskiviikko;3;2;5;19;23;42
294;24.02.2016;2016;02;12;Keskiviikko;2;4;6;15;20;35
294;24.02.2016;2016;02;13;Keskiviikko;2;3;5;21;20;41
294;24.02.2016;2016;02;14;Keskiviikko;1;7;8;17;22;39
294;24.02.2016;2016;02;15;Keskiviikko;5;8;13;26;30;56
294;24.02.2016;2016;02;16;Keskiviikko;4;4;8;13;14;27
294;24.02.2016;2016;02;17;Keskiviikko;2;3;5;20;18;38
294;24.02.2016;2016;02;18;Keskiviikko;1;2;3;11;12;23
294;24.02.2016;2016;02;19;Keskiviikko;3;0;3;10;8;18
294;24.02.2016;2016;02;20;Keskiviikko;0;1;1;5;4;9
294;24.02.2016;2016;02;21;Keskiviikko;0;0;0;1;2;3
294;24.02.2016;2016;02;22;Keskiviikko;0;1;1;5;1;6
294;24.02.2016;2016;02;23;Keskiviikko;1;0;1;1;0;1
294;25.02.2016;2016;02;00;Torstai;0;0;0;0;0;0
294;25.02.2016;2016;02;01;Torstai;0;0;0;0;0;0
294;25.02.2016;2016;02;02;Torstai;0;0;0;0;0;0
294;25.02.2016;2016;02;03;Torstai;0;0;0;0;0;0
294;25.02.2016;2016;02;04;Torstai;0;0;0;0;1;1
294;25.02.2016;2016;02;05;Torstai;0;0;0;1;0;1
294;25.02.2016;2016;02;06;Torstai;0;0;0;4;2;6
294;25.02.2016;2016;02;07;Torstai;6;3;9;13;8;21
294;25.02.2016;2016;02;08;Torstai;3;0;3;12;9;21
294;25.02.2016;2016;02;09;Torstai;2;5;7;23;7;30
294;25.02.2016;2016;02;10;Torstai;1;0;1;25;20;45
294;25.02.2016;2016;02;11;Torstai;3;1;4;26;21;47
294;25.02.2016;2016;02;12;Torstai;4;2;6;19;14;33
294;25.02.2016;2016;02;13;Torstai;1;8;9;20;22;42
294;25.02.2016;2016;02;14;Torstai;7;7;14;24;13;37
294;25.02.2016;2016;02;15;Torstai;5;7;12;15;25;40
294;25.02.2016;2016;02;16;Torstai;2;4;6;15;18;33
294;25.02.2016;2016;02;17;Torstai;5;4;9;10;18;28
294;25.02.2016;2016;02;18;Torstai;1;2;3;18;12;30
294;25.02.2016;2016;02;19;Torstai;2;3;5;4;11;15
294;25.02.2016;2016;02;20;Torstai;0;2;2;9;13;22
294;25.02.2016;2016;02;21;Torstai;0;0;0;4;2;6
294;25.02.2016;2016;02;22;Torstai;0;1;1;0;0;0
294;25.02.2016;2016;02;23;Torstai;0;0;0;0;0;0
294;26.02.2016;2016;02;00;Perjantai;0;0;0;0;0;0
294;26.02.2016;2016;02;01;Perjantai;0;0;0;0;0;0
294;26.02.2016;2016;02;02;Perjantai;0;0;0;0;0;0
294;26.02.2016;2016;02;03;Perjantai;0;0;0;0;0;0
294;26.02.2016;2016;02;04;Perjantai;0;0;0;0;1;1
294;26.02.2016;2016;02;05;Perjantai;4;0;4;15;6;21
294;26.02.2016;2016;02;06;Perjantai;1;0;1;7;1;8
294;26.02.2016;2016;02;07;Perjantai;6;1;7;5;5;10
294;26.02.2016;2016;02;08;Perjantai;2;1;3;5;3;8
294;26.02.2016;2016;02;09;Perjantai;12;4;16;12;6;18
294;26.02.2016;2016;02;10;Perjantai;3;0;3;14;19;33
294;26.02.2016;2016;02;11;Perjantai;1;5;6;19;17;36
294;26.02.2016;2016;02;12;Perjantai;0;3;3;16;21;37
294;26.02.2016;2016;02;13;Perjantai;7;5;12;33;27;60
294;26.02.2016;2016;02;14;Perjantai;6;19;25;28;35;63
294;26.02.2016;2016;02;15;Perjantai;4;5;9;15;16;31
294;26.02.2016;2016;02;16;Perjantai;1;1;2;9;12;21
294;26.02.2016;2016;02;17;Perjantai;7;3;10;15;11;26
294;26.02.2016;2016;02;18;Perjantai;4;6;10;20;9;29
294;26.02.2016;2016;02;19;Perjantai;1;2;3;5;12;17
294;26.02.2016;2016;02;20;Perjantai;2;3;5;6;2;8
294;26.02.2016;2016;02;21;Perjantai;2;0;2;1;3;4
294;26.02.2016;2016;02;22;Perjantai;0;0;0;1;0;1
294;26.02.2016;2016;02;23;Perjantai;0;0;0;2;0;2
294;27.02.2016;2016;02;00;Lauantai;0;0;0;0;0;0
294;27.02.2016;2016;02;01;Lauantai;0;0;0;6;3;9
294;27.02.2016;2016;02;02;Lauantai;0;0;0;2;0;2
294;27.02.2016;2016;02;03;Lauantai;0;0;0;0;3;3
294;27.02.2016;2016;02;04;Lauantai;0;0;0;0;0;0
294;27.02.2016;2016;02;05;Lauantai;0;0;0;1;1;2
294;27.02.2016;2016;02;06;Lauantai;0;0;0;1;3;4
294;27.02.2016;2016;02;07;Lauantai;0;0;0;1;3;4
294;27.02.2016;2016;02;08;Lauantai;0;0;0;5;6;11
294;27.02.2016;2016;02;09;Lauantai;3;2;5;11;9;20
294;27.02.2016;2016;02;10;Lauantai;2;1;3;14;9;23
294;27.02.2016;2016;02;11;Lauantai;0;3;3;10;14;24
294;27.02.2016;2016;02;12;Lauantai;1;3;4;23;15;38
294;27.02.2016;2016;02;13;Lauantai;1;0;1;10;12;22
294;27.02.2016;2016;02;14;Lauantai;1;6;7;14;21;35
294;27.02.2016;2016;02;15;Lauantai;3;3;6;17;14;31
294;27.02.2016;2016;02;16;Lauantai;4;5;9;14;11;25
294;27.02.2016;2016;02;17;Lauantai;5;4;9;25;20;45
294;27.02.2016;2016;02;18;Lauantai;2;6;8;13;14;27
294;27.02.2016;2016;02;19;Lauantai;0;2;2;13;13;26
294;27.02.2016;2016;02;20;Lauantai;1;0;1;6;7;13
294;27.02.2016;2016;02;21;Lauantai;1;1;2;0;0;0
294;27.02.2016;2016;02;22;Lauantai;0;0;0;4;0;4
294;27.02.2016;2016;02;23;Lauantai;1;0;1;1;0;1
294;28.02.2016;2016;02;00;Sunnuntai;0;0;0;0;0;0
294;28.02.2016;2016;02;01;Sunnuntai;0;0;0;1;0;1
294;28.02.2016;2016;02;02;Sunnuntai;0;0;0;2;1;3
294;28.02.2016;2016;02;03;Sunnuntai;0;0;0;0;1;1
294;28.02.2016;2016;02;04;Sunnuntai;0;0;0;0;0;0
294;28.02.2016;2016;02;05;Sunnuntai;0;0;0;1;0;1
294;28.02.2016;2016;02;06;Sunnuntai;0;0;0;0;2;2
294;28.02.2016;2016;02;07;Sunnuntai;1;0;1;1;5;6
294;28.02.2016;2016;02;08;Sunnuntai;0;0;0;2;4;6
294;28.02.2016;2016;02;09;Sunnuntai;1;0;1;20;5;25
294;28.02.2016;2016;02;10;Sunnuntai;0;0;0;10;9;19
294;28.02.2016;2016;02;11;Sunnuntai;1;1;2;13;17;30
294;28.02.2016;2016;02;12;Sunnuntai;3;6;9;21;17;38
294;28.02.2016;2016;02;13;Sunnuntai;6;1;7;20;28;48
294;28.02.2016;2016;02;14;Sunnuntai;5;4;9;29;17;46
294;28.02.2016;2016;02;15;Sunnuntai;0;3;3;10;13;23
294;28.02.2016;2016;02;16;Sunnuntai;3;0;3;7;5;12
294;28.02.2016;2016;02;17;Sunnuntai;0;1;1;6;8;14
294;28.02.2016;2016;02;18;Sunnuntai;0;0;0;16;9;25
294;28.02.2016;2016;02;19;Sunnuntai;4;2;6;4;6;10
294;28.02.2016;2016;02;20;Sunnuntai;0;1;1;6;3;9
294;28.02.2016;2016;02;21;Sunnuntai;0;0;0;1;0;1
294;28.02.2016;2016;02;22;Sunnuntai;0;1;1;0;0;0
294;28.02.2016;2016;02;23;Sunnuntai;0;0;0;0;0;0
294;29.02.2016;2016;02;00;Maanantai;0;0;0;0;0;0
294;29.02.2016;2016;02;01;Maanantai;0;0;0;0;0;0
294;29.02.2016;2016;02;02;Maanantai;0;0;0;0;0;0
294;29.02.2016;2016;02;03;Maanantai;0;0;0;0;0;0
294;29.02.2016;2016;02;04;Maanantai;0;0;0;0;0;0
294;29.02.2016;2016;02;05;Maanantai;0;1;1;1;1;2
294;29.02.2016;2016;02;06;Maanantai;0;0;0;4;3;7
294;29.02.2016;2016;02;07;Maanantai;2;4;6;10;3;13
294;29.02.2016;2016;02;08;Maanantai;4;0;4;8;3;11
294;29.02.2016;2016;02;09;Maanantai;3;3;6;19;13;32
294;29.02.2016;2016;02;10;Maanantai;2;2;4;22;17;39
294;29.02.2016;2016;02;11;Maanantai;3;2;5;16;28;44
294;29.02.2016;2016;02;12;Maanantai;1;1;2;15;23;38
294;29.02.2016;2016;02;13;Maanantai;3;2;5;25;27;52
294;29.02.2016;2016;02;14;Maanantai;8;6;14;24;17;41
294;29.02.2016;2016;02;15;Maanantai;5;9;14;17;23;40
294;29.02.2016;2016;02;16;Maanantai;5;5;10;12;14;26
294;29.02.2016;2016;02;17;Maanantai;4;4;8;19;9;28
294;29.02.2016;2016;02;18;Maanantai;0;6;6;21;22;43
294;29.02.2016;2016;02;19;Maanantai;0;5;5;18;7;25
294;29.02.2016;2016;02;20;Maanantai;2;0;2;10;4;14
294;29.02.2016;2016;02;21;Maanantai;0;0;0;2;1;3
294;29.02.2016;2016;02;22;Maanantai;0;0;0;1;0;1
294;29.02.2016;2016;02;23;Maanantai;1;0;1;0;0;0
294;01.03.2016;2016;03;00;Tiistai;0;0;0;1;0;1
294;01.03.2016;2016;03;01;Tiistai;0;0;0;0;0;0
294;01.03.2016;2016;03;02;Tiistai;0;0;0;0;0;0
294;01.03.2016;2016;03;03;Tiistai;0;0;0;0;0;0
294;01.03.2016;2016;03;04;Tiistai;0;0;0;0;1;1
294;01.03.2016;2016;03;05;Tiistai;0;0;0;1;0;1
294;01.03.2016;2016;03;06;Tiistai;1;1;2;5;2;7
294;01.03.2016;2016;03;07;Tiistai;1;2;3;13;4;17
294;01.03.2016;2016;03;08;Tiistai;7;1;8;14;4;18
294;01.03.2016;2016;03;09;Tiistai;2;1;3;20;9;29
294;01.03.2016;2016;03;10;Tiistai;3;2;5;14;24;38
294;01.03.2016;2016;03;11;Tiistai;1;4;5;27;16;43
294;01.03.2016;2016;03;12;Tiistai;0;4;4;17;16;33
294;01.03.2016;2016;03;13;Tiistai;6;8;14;22;25;47
294;01.03.2016;2016;03;14;Tiistai;4;5;9;20;20;40
294;01.03.2016;2016;03;15;Tiistai;4;12;16;21;34;55
294;01.03.2016;2016;03;16;Tiistai;8;3;11;20;21;41
294;01.03.2016;2016;03;17;Tiistai;1;2;3;20;12;32
294;01.03.2016;2016;03;18;Tiistai;1;1;2;13;20;33
294;01.03.2016;2016;03;19;Tiistai;0;4;4;15;13;28
294;01.03.2016;2016;03;20;Tiistai;1;0;1;4;7;11
294;01.03.2016;2016;03;21;Tiistai;0;0;0;2;2;4
294;01.03.2016;2016;03;22;Tiistai;0;0;0;1;0;1
294;01.03.2016;2016;03;23;Tiistai;0;0;0;1;0;1
294;02.03.2016;2016;03;00;Keskiviikko;0;0;0;0;0;0
294;02.03.2016;2016;03;01;Keskiviikko;0;0;0;0;0;0
294;02.03.2016;2016;03;02;Keskiviikko;0;0;0;1;0;1
294;02.03.2016;2016;03;03;Keskiviikko;0;0;0;0;0;0
294;02.03.2016;2016;03;04;Keskiviikko;0;0;0;0;0;0
294;02.03.2016;2016;03;05;Keskiviikko;0;0;0;2;0;2
294;02.03.2016;2016;03;06;Keskiviikko;0;0;0;4;2;6
294;02.03.2016;2016;03;07;Keskiviikko;5;4;9;14;5;19
294;02.03.2016;2016;03;08;Keskiviikko;1;0;1;19;3;22
294;02.03.2016;2016;03;09;Keskiviikko;3;4;7;22;8;30
294;02.03.2016;2016;03;10;Keskiviikko;3;5;8;16;15;31
294;02.03.2016;2016;03;11;Keskiviikko;5;6;11;19;27;46
294;02.03.2016;2016;03;12;Keskiviikko;5;12;17;19;30;49
294;02.03.2016;2016;03;13;Keskiviikko;7;8;15;31;15;46
294;02.03.2016;2016;03;14;Keskiviikko;2;5;7;22;20;42
294;02.03.2016;2016;03;15;Keskiviikko;6;5;11;19;15;34
294;02.03.2016;2016;03;16;Keskiviikko;3;7;10;16;19;35
294;02.03.2016;2016;03;17;Keskiviikko;4;4;8;24;17;41
294;02.03.2016;2016;03;18;Keskiviikko;4;3;7;19;19;38
294;02.03.2016;2016;03;19;Keskiviikko;2;1;3;17;21;38
294;02.03.2016;2016;03;20;Keskiviikko;0;1;1;5;5;10
294;02.03.2016;2016;03;21;Keskiviikko;0;0;0;1;0;1
294;02.03.2016;2016;03;22;Keskiviikko;0;0;0;0;0;0
294;02.03.2016;2016;03;23;Keskiviikko;1;0;1;0;1;1
294;03.03.2016;2016;03;00;Torstai;0;0;0;0;0;0
294;03.03.2016;2016;03;01;Torstai;0;0;0;0;0;0
294;03.03.2016;2016;03;02;Torstai;0;0;0;0;0;0
294;03.03.2016;2016;03;03;Torstai;0;0;0;0;0;0
294;03.03.2016;2016;03;04;Torstai;0;0;0;0;1;1
294;03.03.2016;2016;03;05;Torstai;0;0;0;3;0;3
294;03.03.2016;2016;03;06;Torstai;0;1;1;3;1;4
294;03.03.2016;2016;03;07;Torstai;3;6;9;7;8;15
294;03.03.2016;2016;03;08;Torstai;4;0;4;13;8;21
294;03.03.2016;2016;03;09;Torstai;4;3;7;22;15;37
294;03.03.2016;2016;03;10;Torstai;1;0;1;20;10;30
294;03.03.2016;2016;03;11;Torstai;3;1;4;21;24;45
294;03.03.2016;2016;03;12;Torstai;2;6;8;21;19;40
294;03.03.2016;2016;03;13;Torstai;2;5;7;26;19;45
294;03.03.2016;2016;03;14;Torstai;5;6;11;20;14;34
294;03.03.2016;2016;03;15;Torstai;4;4;8;12;22;34
294;03.03.2016;2016;03;16;Torstai;3;4;7;23;26;49
294;03.03.2016;2016;03;17;Torstai;1;5;6;19;14;33
294;03.03.2016;2016;03;18;Torstai;1;7;8;24;11;35
294;03.03.2016;2016;03;19;Torstai;3;0;3;16;11;27
294;03.03.2016;2016;03;20;Torstai;1;4;5;4;11;15
294;03.03.2016;2016;03;21;Torstai;0;2;2;2;1;3
294;03.03.2016;2016;03;22;Torstai;0;0;0;0;0;0
294;03.03.2016;2016;03;23;Torstai;0;0;0;0;0;0
294;04.03.2016;2016;03;00;Perjantai;0;0;0;0;0;0
294;04.03.2016;2016;03;01;Perjantai;0;0;0;0;0;0
294;04.03.2016;2016;03;02;Perjantai;0;0;0;0;0;0
294;04.03.2016;2016;03;03;Perjantai;0;0;0;0;0;0
294;04.03.2016;2016;03;04;Perjantai;0;0;0;0;1;1
294;04.03.2016;2016;03;05;Perjantai;0;0;0;1;3;4
294;04.03.2016;2016;03;06;Perjantai;0;3;3;3;2;5
294;04.03.2016;2016;03;07;Perjantai;1;1;2;15;6;21
294;04.03.2016;2016;03;08;Perjantai;1;0;1;17;11;28
294;04.03.2016;2016;03;09;Perjantai;4;1;5;24;9;33
294;04.03.2016;2016;03;10;Perjantai;0;7;7;8;15;23
294;04.03.2016;2016;03;11;Perjantai;2;1;3;19;14;33
294;04.03.2016;2016;03;12;Perjantai;4;6;10;26;30;56
294;04.03.2016;2016;03;13;Perjantai;5;7;12;27;22;49
294;04.03.2016;2016;03;14;Perjantai;5;12;17;16;21;37
294;04.03.2016;2016;03;15;Perjantai;2;9;11;16;18;34
294;04.03.2016;2016;03;16;Perjantai;1;2;3;21;21;42
294;04.03.2016;2016;03;17;Perjantai;1;4;5;7;7;14
294;04.03.2016;2016;03;18;Perjantai;2;1;3;13;10;23
294;04.03.2016;2016;03;19;Perjantai;1;2;3;13;14;27
294;04.03.2016;2016;03;20;Perjantai;5;2;7;16;5;21
294;04.03.2016;2016;03;21;Perjantai;2;3;5;2;2;4
294;04.03.2016;2016;03;22;Perjantai;0;0;0;0;0;0
294;04.03.2016;2016;03;23;Perjantai;0;0;0;1;0;1
294;05.03.2016;2016;03;00;Lauantai;0;0;0;2;0;2
294;05.03.2016;2016;03;01;Lauantai;0;0;0;0;1;1
294;05.03.2016;2016;03;02;Lauantai;1;0;1;0;0;0
294;05.03.2016;2016;03;03;Lauantai;0;0;0;1;0;1
294;05.03.2016;2016;03;04;Lauantai;0;0;0;0;0;0
294;05.03.2016;2016;03;05;Lauantai;0;0;0;1;1;2
294;05.03.2016;2016;03;06;Lauantai;0;0;0;0;1;1
294;05.03.2016;2016;03;07;Lauantai;1;0;1;4;1;5
294;05.03.2016;2016;03;08;Lauantai;0;0;0;6;6;12
294;05.03.2016;2016;03;09;Lauantai;0;1;1;12;8;20
294;05.03.2016;2016;03;10;Lauantai;1;2;3;5;10;15
294;05.03.2016;2016;03;11;Lauantai;4;1;5;13;15;28
294;05.03.2016;2016;03;12;Lauantai;2;5;7;20;16;36
294;05.03.2016;2016;03;13;Lauantai;0;2;2;17;18;35
294;05.03.2016;2016;03;14;Lauantai;7;0;7;15;9;24
294;05.03.2016;2016;03;15;Lauantai;1;0;1;14;11;25
294;05.03.2016;2016;03;16;Lauantai;4;7;11;22;13;35
294;05.03.2016;2016;03;17;Lauantai;0;2;2;16;7;23
294;05.03.2016;2016;03;18;Lauantai;6;3;9;14;10;24
294;05.03.2016;2016;03;19;Lauantai;1;1;2;17;5;22
294;05.03.2016;2016;03;20;Lauantai;0;3;3;4;4;8
294;05.03.2016;2016;03;21;Lauantai;0;0;0;3;1;4
294;05.03.2016;2016;03;22;Lauantai;0;0;0;0;0;0
294;05.03.2016;2016;03;23;Lauantai;1;0;1;3;0;3
294;06.03.2016;2016;03;00;Sunnuntai;0;0;0;0;0;0
294;06.03.2016;2016;03;01;Sunnuntai;0;0;0;0;0;0
294;06.03.2016;2016;03;02;Sunnuntai;0;0;0;0;0;0
294;06.03.2016;2016;03;03;Sunnuntai;0;0;0;0;0;0
294;06.03.2016;2016;03;04;Sunnuntai;0;0;0;0;0;0
294;06.03.2016;2016;03;05;Sunnuntai;0;0;0;0;0;0
294;06.03.2016;2016;03;06;Sunnuntai;0;1;1;10;1;11
294;06.03.2016;2016;03;07;Sunnuntai;0;0;0;1;5;6
294;06.03.2016;2016;03;08;Sunnuntai;0;0;0;9;2;11
294;06.03.2016;2016;03;09;Sunnuntai;0;0;0;6;7;13
294;06.03.2016;2016;03;10;Sunnuntai;2;0;2;12;5;17
294;06.03.2016;2016;03;11;Sunnuntai;2;2;4;12;12;24
294;06.03.2016;2016;03;12;Sunnuntai;2;1;3;10;19;29
294;06.03.2016;2016;03;13;Sunnuntai;0;2;2;12;15;27
294;06.03.2016;2016;03;14;Sunnuntai;3;1;4;13;6;19
294;06.03.2016;2016;03;15;Sunnuntai;2;4;6;5;11;16
294;06.03.2016;2016;03;16;Sunnuntai;3;3;6;9;10;19
294;06.03.2016;2016;03;17;Sunnuntai;0;3;3;15;12;27
294;06.03.2016;2016;03;18;Sunnuntai;1;0;1;10;10;20
294;06.03.2016;2016;03;19;Sunnuntai;2;2;4;17;7;24
294;06.03.2016;2016;03;20;Sunnuntai;1;1;2;2;8;10
294;06.03.2016;2016;03;21;Sunnuntai;0;0;0;3;0;3
294;06.03.2016;2016;03;22;Sunnuntai;0;1;1;0;0;0
294;06.03.2016;2016;03;23;Sunnuntai;0;0;0;0;0;0
294;07.03.2016;2016;03;00;Maanantai;0;0;0;0;1;1
294;07.03.2016;2016;03;01;Maanantai;0;0;0;0;0;0
294;07.03.2016;2016;03;02;Maanantai;0;0;0;1;0;1
294;07.03.2016;2016;03;03;Maanantai;0;0;0;0;0;0
294;07.03.2016;2016;03;04;Maanantai;0;0;0;0;0;0
294;07.03.2016;2016;03;05;Maanantai;0;0;0;1;0;1
294;07.03.2016;2016;03;06;Maanantai;0;0;0;1;1;2
294;07.03.2016;2016;03;07;Maanantai;1;2;3;4;6;10
294;07.03.2016;2016;03;08;Maanantai;0;0;0;8;4;12
294;07.03.2016;2016;03;09;Maanantai;0;2;2;13;18;31
294;07.03.2016;2016;03;10;Maanantai;1;1;2;16;9;25
294;07.03.2016;2016;03;11;Maanantai;1;3;4;11;15;26
294;07.03.2016;2016;03;12;Maanantai;0;2;2;14;7;21
294;07.03.2016;2016;03;13;Maanantai;2;5;7;11;9;20
294;07.03.2016;2016;03;14;Maanantai;2;2;4;12;9;21
294;07.03.2016;2016;03;15;Maanantai;3;2;5;12;9;21
294;07.03.2016;2016;03;16;Maanantai;4;3;7;11;11;22
294;07.03.2016;2016;03;17;Maanantai;0;1;1;13;9;22
294;07.03.2016;2016;03;18;Maanantai;0;1;1;22;16;38
294;07.03.2016;2016;03;19;Maanantai;2;2;4;6;10;16
294;07.03.2016;2016;03;20;Maanantai;3;2;5;4;4;8
294;07.03.2016;2016;03;21;Maanantai;0;2;2;4;0;4
294;07.03.2016;2016;03;22;Maanantai;1;2;3;0;1;1
294;07.03.2016;2016;03;23;Maanantai;0;0;0;0;0;0
294;08.03.2016;2016;03;00;Tiistai;1;0;1;1;0;1
294;08.03.2016;2016;03;01;Tiistai;0;0;0;0;0;0
294;08.03.2016;2016;03;02;Tiistai;0;0;0;0;0;0
294;08.03.2016;2016;03;03;Tiistai;0;0;0;0;0;0
294;08.03.2016;2016;03;04;Tiistai;0;0;0;0;0;0
294;08.03.2016;2016;03;05;Tiistai;0;0;0;1;0;1
294;08.03.2016;2016;03;06;Tiistai;0;0;0;2;0;2
294;08.03.2016;2016;03;07;Tiistai;4;0;4;4;2;6
294;08.03.2016;2016;03;08;Tiistai;3;3;6;6;6;12
294;08.03.2016;2016;03;09;Tiistai;0;2;2;11;8;19
294;08.03.2016;2016;03;10;Tiistai;0;3;3;11;21;32
294;08.03.2016;2016;03;11;Tiistai;1;1;2;12;11;23
294;08.03.2016;2016;03;12;Tiistai;3;3;6;9;10;19
294;08.03.2016;2016;03;13;Tiistai;5;5;10;15;11;26
294;08.03.2016;2016;03;14;Tiistai;8;2;10;8;5;13
294;08.03.2016;2016;03;15;Tiistai;1;3;4;8;10;18
294;08.03.2016;2016;03;16;Tiistai;2;7;9;11;14;25
294;08.03.2016;2016;03;17;Tiistai;1;3;4;11;15;26
294;08.03.2016;2016;03;18;Tiistai;0;3;3;13;14;27
294;08.03.2016;2016;03;19;Tiistai;3;2;5;14;11;25
294;08.03.2016;2016;03;20;Tiistai;0;3;3;5;1;6
294;08.03.2016;2016;03;21;Tiistai;0;0;0;6;5;11
294;08.03.2016;2016;03;22;Tiistai;0;0;0;0;0;0
294;08.03.2016;2016;03;23;Tiistai;0;0;0;0;0;0
294;09.03.2016;2016;03;00;Keskiviikko;0;0;0;1;0;1
294;09.03.2016;2016;03;01;Keskiviikko;0;0;0;0;0;0
294;09.03.2016;2016;03;02;Keskiviikko;0;0;0;0;0;0
294;09.03.2016;2016;03;03;Keskiviikko;0;0;0;0;0;0
294;09.03.2016;2016;03;04;Keskiviikko;0;0;0;0;0;0
294;09.03.2016;2016;03;05;Keskiviikko;0;0;0;1;2;3
294;09.03.2016;2016;03;06;Keskiviikko;0;0;0;1;2;3
294;09.03.2016;2016;03;07;Keskiviikko;0;0;0;7;4;11
294;09.03.2016;2016;03;08;Keskiviikko;1;1;2;9;7;16
294;09.03.2016;2016;03;09;Keskiviikko;2;1;3;7;10;17
294;09.03.2016;2016;03;10;Keskiviikko;0;1;1;17;13;30
294;09.03.2016;2016;03;11;Keskiviikko;4;5;9;3;15;18
294;09.03.2016;2016;03;12;Keskiviikko;3;0;3;10;18;28
294;09.03.2016;2016;03;13;Keskiviikko;1;3;4;13;14;27
294;09.03.2016;2016;03;14;Keskiviikko;1;2;3;8;16;24
294;09.03.2016;2016;03;15;Keskiviikko;3;2;5;9;18;27
294;09.03.2016;2016;03;16;Keskiviikko;2;0;2;14;12;26
294;09.03.2016;2016;03;17;Keskiviikko;0;2;2;9;16;25
294;09.03.2016;2016;03;18;Keskiviikko;4;3;7;19;17;36
294;09.03.2016;2016;03;19;Keskiviikko;1;2;3;14;6;20
294;09.03.2016;2016;03;20;Keskiviikko;1;1;2;5;7;12
294;09.03.2016;2016;03;21;Keskiviikko;0;1;1;0;0;0
294;09.03.2016;2016;03;22;Keskiviikko;1;0;1;1;1;2
294;09.03.2016;2016;03;23;Keskiviikko;0;0;0;0;0;0
294;10.03.2016;2016;03;00;Torstai;0;0;0;3;0;3
294;10.03.2016;2016;03;01;Torstai;0;0;0;0;0;0
294;10.03.2016;2016;03;02;Torstai;0;0;0;1;0;1
294;10.03.2016;2016;03;03;Torstai;0;0;0;0;0;0
294;10.03.2016;2016;03;04;Torstai;0;0;0;0;0;0
294;10.03.2016;2016;03;05;Torstai;3;0;3;1;0;1
294;10.03.2016;2016;03;06;Torstai;0;0;0;2;0;2
294;10.03.2016;2016;03;07;Torstai;1;0;1;4;3;7
294;10.03.2016;2016;03;08;Torstai;0;2;2;2;3;5
294;10.03.2016;2016;03;09;Torstai;1;1;2;14;9;23
294;10.03.2016;2016;03;10;Torstai;0;1;1;11;8;19
294;10.03.2016;2016;03;11;Torstai;2;1;3;10;14;24
294;10.03.2016;2016;03;12;Torstai;2;2;4;20;13;33
294;10.03.2016;2016;03;13;Torstai;0;0;0;15;9;24
294;10.03.2016;2016;03;14;Torstai;0;2;2;4;5;9
294;10.03.2016;2016;03;15;Torstai;2;1;3;12;11;23
294;10.03.2016;2016;03;16;Torstai;2;1;3;13;7;20
294;10.03.2016;2016;03;17;Torstai;0;3;3;13;8;21
294;10.03.2016;2016;03;18;Torstai;2;6;8;20;9;29
294;10.03.2016;2016;03;19;Torstai;0;0;0;11;5;16
294;10.03.2016;2016;03;20;Torstai;0;0;0;9;6;15
294;10.03.2016;2016;03;21;Torstai;2;0;2;5;2;7
294;10.03.2016;2016;03;22;Torstai;0;0;0;1;2;3
294;10.03.2016;2016;03;23;Torstai;0;0;0;1;0;1
294;11.03.2016;2016;03;00;Perjantai;0;0;0;0;0;0
294;11.03.2016;2016;03;01;Perjantai;0;0;0;0;0;0
294;11.03.2016;2016;03;02;Perjantai;0;0;0;0;0;0
294;11.03.2016;2016;03;03;Perjantai;0;0;0;0;0;0
294;11.03.2016;2016;03;04;Perjantai;0;0;0;0;0;0
294;11.03.2016;2016;03;05;Perjantai;0;0;0;1;0;1
294;11.03.2016;2016;03;06;Perjantai;0;0;0;1;2;3
294;11.03.2016;2016;03;07;Perjantai;0;0;0;3;0;3
294;11.03.2016;2016;03;08;Perjantai;1;0;1;8;4;12
294;11.03.2016;2016;03;09;Perjantai;0;1;1;10;4;14
294;11.03.2016;2016;03;10;Perjantai;0;1;1;9;13;22
294;11.03.2016;2016;03;11;Perjantai;2;0;2;12;14;26
294;11.03.2016;2016;03;12;Perjantai;0;1;1;11;11;22
294;11.03.2016;2016;03;13;Perjantai;0;1;1;7;13;20
294;11.03.2016;2016;03;14;Perjantai;0;2;2;8;5;13
294;11.03.2016;2016;03;15;Perjantai;0;3;3;20;20;40
294;11.03.2016;2016;03;16;Perjantai;2;1;3;4;15;19
294;11.03.2016;2016;03;17;Perjantai;2;2;4;14;13;27
294;11.03.2016;2016;03;18;Perjantai;3;3;6;21;9;30
294;11.03.2016;2016;03;19;Perjantai;3;1;4;10;5;15
294;11.03.2016;2016;03;20;Perjantai;1;1;2;12;6;18
294;11.03.2016;2016;03;21;Perjantai;1;2;3;4;3;7
294;11.03.2016;2016;03;22;Perjantai;1;0;1;7;0;7
294;11.03.2016;2016;03;23;Perjantai;0;0;0;0;1;1
294;12.03.2016;2016;03;00;Lauantai;0;0;0;2;2;4
294;12.03.2016;2016;03;01;Lauantai;0;0;0;2;0;2
294;12.03.2016;2016;03;02;Lauantai;0;0;0;1;1;2
294;12.03.2016;2016;03;03;Lauantai;0;0;0;0;0;0
294;12.03.2016;2016;03;04;Lauantai;0;0;0;0;0;0
294;12.03.2016;2016;03;05;Lauantai;0;0;0;1;0;1
294;12.03.2016;2016;03;06;Lauantai;0;0;0;0;4;4
294;12.03.2016;2016;03;07;Lauantai;1;0;1;10;8;18
294;12.03.2016;2016;03;08;Lauantai;1;0;1;5;6;11
294;12.03.2016;2016;03;09;Lauantai;1;2;3;12;16;28
294;12.03.2016;2016;03;10;Lauantai;4;1;5;15;10;25
294;12.03.2016;2016;03;11;Lauantai;0;1;1;16;21;37
294;12.03.2016;2016;03;12;Lauantai;2;7;9;15;11;26
294;12.03.2016;2016;03;13;Lauantai;3;6;9;17;14;31
294;12.03.2016;2016;03;14;Lauantai;4;1;5;12;7;19
294;12.03.2016;2016;03;15;Lauantai;1;4;5;8;17;25
294;12.03.2016;2016;03;16;Lauantai;5;5;10;17;11;28
294;12.03.2016;2016;03;17;Lauantai;1;2;3;13;15;28
294;12.03.2016;2016;03;18;Lauantai;0;2;2;10;7;17
294;12.03.2016;2016;03;19;Lauantai;0;3;3;6;14;20
294;12.03.2016;2016;03;20;Lauantai;0;0;0;6;3;9
294;12.03.2016;2016;03;21;Lauantai;0;4;4;3;1;4
294;12.03.2016;2016;03;22;Lauantai;2;0;2;0;0;0
294;12.03.2016;2016;03;23;Lauantai;0;0;0;1;0;1
294;13.03.2016;2016;03;00;Sunnuntai;0;0;0;1;0;1
294;13.03.2016;2016;03;01;Sunnuntai;0;0;0;0;1;1
294;13.03.2016;2016;03;02;Sunnuntai;0;0;0;0;1;1
294;13.03.2016;2016;03;03;Sunnuntai;0;0;0;0;0;0
294;13.03.2016;2016;03;04;Sunnuntai;0;0;0;0;0;0
294;13.03.2016;2016;03;05;Sunnuntai;0;0;0;1;1;2
294;13.03.2016;2016;03;06;Sunnuntai;0;0;0;1;0;1
294;13.03.2016;2016;03;07;Sunnuntai;0;0;0;0;3;3
294;13.03.2016;2016;03;08;Sunnuntai;0;0;0;4;1;5
294;13.03.2016;2016;03;09;Sunnuntai;0;1;1;9;5;14
294;13.03.2016;2016;03;10;Sunnuntai;2;1;3;11;9;20
294;13.03.2016;2016;03;11;Sunnuntai;0;3;3;14;12;26
294;13.03.2016;2016;03;12;Sunnuntai;6;3;9;5;12;17
294;13.03.2016;2016;03;13;Sunnuntai;2;3;5;1;3;4
294;13.03.2016;2016;03;14;Sunnuntai;0;0;0;15;8;23
294;13.03.2016;2016;03;15;Sunnuntai;2;2;4;7;7;14
294;13.03.2016;2016;03;16;Sunnuntai;5;2;7;12;11;23
294;13.03.2016;2016;03;17;Sunnuntai;0;1;1;15;7;22
294;13.03.2016;2016;03;18;Sunnuntai;5;6;11;7;7;14
294;13.03.2016;2016;03;19;Sunnuntai;4;3;7;12;11;23
294;13.03.2016;2016;03;20;Sunnuntai;0;0;0;6;4;10
294;13.03.2016;2016;03;21;Sunnuntai;0;2;2;0;1;1
294;13.03.2016;2016;03;22;Sunnuntai;0;0;0;0;1;1
294;13.03.2016;2016;03;23;Sunnuntai;0;0;0;1;0;1
294;14.03.2016;2016;03;00;Maanantai;0;0;0;0;0;0
294;14.03.2016;2016;03;01;Maanantai;0;0;0;0;0;0
294;14.03.2016;2016;03;02;Maanantai;0;0;0;0;0;0
294;14.03.2016;2016;03;03;Maanantai;0;0;0;0;0;0
294;14.03.2016;2016;03;04;Maanantai;0;0;0;0;0;0
294;14.03.2016;2016;03;05;Maanantai;0;0;0;2;0;2
294;14.03.2016;2016;03;06;Maanantai;1;0;1;2;2;4
294;14.03.2016;2016;03;07;Maanantai;6;2;8;18;8;26
294;14.03.2016;2016;03;08;Maanantai;6;2;8;13;8;21
294;14.03.2016;2016;03;09;Maanantai;1;1;2;21;23;44
294;14.03.2016;2016;03;10;Maanantai;1;1;2;25;16;41
294;14.03.2016;2016;03;11;Maanantai;3;3;6;26;29;55
294;14.03.2016;2016;03;12;Maanantai;3;3;6;16;24;40
294;14.03.2016;2016;03;13;Maanantai;2;6;8;16;26;42
294;14.03.2016;2016;03;14;Maanantai;6;6;12;16;18;34
294;14.03.2016;2016;03;15;Maanantai;3;6;9;18;18;36
294;14.03.2016;2016;03;16;Maanantai;3;6;9;12;22;34
294;14.03.2016;2016;03;17;Maanantai;4;1;5;22;13;35
294;14.03.2016;2016;03;18;Maanantai;4;2;6;14;17;31
294;14.03.2016;2016;03;19;Maanantai;0;1;1;14;11;25
294;14.03.2016;2016;03;20;Maanantai;0;2;2;9;6;15
294;14.03.2016;2016;03;21;Maanantai;0;0;0;1;3;4
294;14.03.2016;2016;03;22;Maanantai;0;0;0;2;2;4
294;14.03.2016;2016;03;23;Maanantai;0;0;0;1;0;1
294;15.03.2016;2016;03;00;Tiistai;0;0;0;0;1;1
294;15.03.2016;2016;03;01;Tiistai;0;0;0;0;0;0
294;15.03.2016;2016;03;02;Tiistai;0;0;0;0;0;0
294;15.03.2016;2016;03;03;Tiistai;0;0;0;0;0;0
294;15.03.2016;2016;03;04;Tiistai;0;0;0;0;1;1
294;15.03.2016;2016;03;05;Tiistai;0;0;0;1;1;2
294;15.03.2016;2016;03;06;Tiistai;0;2;2;7;1;8
294;15.03.2016;2016;03;07;Tiistai;1;4;5;10;4;14
294;15.03.2016;2016;03;08;Tiistai;3;5;8;17;4;21
294;15.03.2016;2016;03;09;Tiistai;5;3;8;14;9;23
294;15.03.2016;2016;03;10;Tiistai;3;1;4;8;13;21
294;15.03.2016;2016;03;11;Tiistai;2;3;5;19;31;50
294;15.03.2016;2016;03;12;Tiistai;1;4;5;25;14;39
294;15.03.2016;2016;03;13;Tiistai;4;8;12;18;13;31
294;15.03.2016;2016;03;14;Tiistai;5;7;12;10;15;25
294;15.03.2016;2016;03;15;Tiistai;8;13;21;22;24;46
294;15.03.2016;2016;03;16;Tiistai;9;6;15;24;16;40
294;15.03.2016;2016;03;17;Tiistai;3;9;12;17;14;31
294;15.03.2016;2016;03;18;Tiistai;2;2;4;13;18;31
294;15.03.2016;2016;03;19;Tiistai;4;0;4;12;7;19
294;15.03.2016;2016;03;20;Tiistai;0;0;0;11;7;18
294;15.03.2016;2016;03;21;Tiistai;0;0;0;0;2;2
294;15.03.2016;2016;03;22;Tiistai;0;0;0;1;0;1
294;15.03.2016;2016;03;23;Tiistai;0;0;0;0;0;0
294;16.03.2016;2016;03;00;Keskiviikko;0;0;0;1;0;1
294;16.03.2016;2016;03;01;Keskiviikko;0;0;0;0;0;0
294;16.03.2016;2016;03;02;Keskiviikko;0;0;0;0;0;0
294;16.03.2016;2016;03;03;Keskiviikko;0;0;0;0;0;0
294;16.03.2016;2016;03;04;Keskiviikko;0;0;0;0;0;0
294;16.03.2016;2016;03;05;Keskiviikko;0;0;0;1;2;3
294;16.03.2016;2016;03;06;Keskiviikko;0;0;0;2;3;5
294;16.03.2016;2016;03;07;Keskiviikko;9;1;10;9;7;16
294;16.03.2016;2016;03;08;Keskiviikko;4;1;5;15;8;23
294;16.03.2016;2016;03;09;Keskiviikko;0;4;4;13;24;37
294;16.03.2016;2016;03;10;Keskiviikko;0;1;1;22;8;30
294;16.03.2016;2016;03;11;Keskiviikko;5;2;7;14;14;28
294;16.03.2016;2016;03;12;Keskiviikko;1;6;7;11;11;22
294;16.03.2016;2016;03;13;Keskiviikko;3;6;9;12;14;26
294;16.03.2016;2016;03;14;Keskiviikko;5;9;14;27;18;45
294;16.03.2016;2016;03;15;Keskiviikko;7;8;15;20;22;42
294;16.03.2016;2016;03;16;Keskiviikko;4;3;7;8;11;19
294;16.03.2016;2016;03;17;Keskiviikko;4;0;4;15;14;29
294;16.03.2016;2016;03;18;Keskiviikko;2;6;8;8;5;13
294;16.03.2016;2016;03;19;Keskiviikko;2;2;4;15;19;34
294;16.03.2016;2016;03;20;Keskiviikko;0;1;1;5;6;11
294;16.03.2016;2016;03;21;Keskiviikko;0;0;0;2;2;4
294;16.03.2016;2016;03;22;Keskiviikko;0;0;0;1;0;1
294;16.03.2016;2016;03;23;Keskiviikko;0;0;0;0;0;0
294;17.03.2016;2016;03;00;Torstai;0;0;0;0;0;0
294;17.03.2016;2016;03;01;Torstai;0;0;0;0;0;0
294;17.03.2016;2016;03;02;Torstai;0;0;0;0;0;0
294;17.03.2016;2016;03;03;Torstai;0;0;0;0;0;0
294;17.03.2016;2016;03;04;Torstai;0;0;0;0;1;1
294;17.03.2016;2016;03;05;Torstai;0;0;0;1;0;1
294;17.03.2016;2016;03;06;Torstai;1;0;1;2;0;2
294;17.03.2016;2016;03;07;Torstai;2;4;6;4;5;9
294;17.03.2016;2016;03;08;Torstai;6;2;8;23;14;37
294;17.03.2016;2016;03;09;Torstai;3;2;5;16;9;25
294;17.03.2016;2016;03;10;Torstai;0;2;2;21;13;34
294;17.03.2016;2016;03;11;Torstai;1;0;1;24;27;51
294;17.03.2016;2016;03;12;Torstai;0;4;4;29;17;46
294;17.03.2016;2016;03;13;Torstai;5;8;13;19;25;44
294;17.03.2016;2016;03;14;Torstai;11;6;17;25;15;40
294;17.03.2016;2016;03;15;Torstai;2;7;9;16;20;36
294;17.03.2016;2016;03;16;Torstai;5;4;9;11;14;25
294;17.03.2016;2016;03;17;Torstai;0;2;2;12;8;20
294;17.03.2016;2016;03;18;Torstai;3;7;10;9;10;19
294;17.03.2016;2016;03;19;Torstai;2;0;2;9;4;13
294;17.03.2016;2016;03;20;Torstai;2;0;2;8;4;12
294;17.03.2016;2016;03;21;Torstai;2;0;2;2;1;3
294;17.03.2016;2016;03;22;Torstai;0;0;0;0;0;0
294;17.03.2016;2016;03;23;Torstai;0;0;0;1;0;1
294;18.03.2016;2016;03;00;Perjantai;0;0;0;0;0;0
294;18.03.2016;2016;03;01;Perjantai;0;0;0;0;0;0
294;18.03.2016;2016;03;02;Perjantai;0;0;0;0;0;0
294;18.03.2016;2016;03;03;Perjantai;0;0;0;0;0;0
294;18.03.2016;2016;03;04;Perjantai;0;0;0;0;1;1
294;18.03.2016;2016;03;05;Perjantai;0;0;0;1;2;3
294;18.03.2016;2016;03;06;Perjantai;1;0;1;3;1;4
294;18.03.2016;2016;03;07;Perjantai;1;4;5;7;12;19
294;18.03.2016;2016;03;08;Perjantai;4;2;6;12;5;17
294;18.03.2016;2016;03;09;Perjantai;7;1;8;15;8;23
294;18.03.2016;2016;03;10;Perjantai;4;2;6;20;20;40
294;18.03.2016;2016;03;11;Perjantai;5;2;7;31;19;50
294;18.03.2016;2016;03;12;Perjantai;3;9;12;16;34;50
294;18.03.2016;2016;03;13;Perjantai;12;7;19;34;22;56
294;18.03.2016;2016;03;14;Perjantai;11;20;31;23;27;50
294;18.03.2016;2016;03;15;Perjantai;5;5;10;7;15;22
294;18.03.2016;2016;03;16;Perjantai;8;8;16;20;17;37
294;18.03.2016;2016;03;17;Perjantai;2;5;7;26;26;52
294;18.03.2016;2016;03;18;Perjantai;2;2;4;23;16;39
294;18.03.2016;2016;03;19;Perjantai;3;3;6;13;13;26
294;18.03.2016;2016;03;20;Perjantai;1;0;1;5;1;6
294;18.03.2016;2016;03;21;Perjantai;1;6;7;1;4;5
294;18.03.2016;2016;03;22;Perjantai;1;0;1;2;1;3
294;18.03.2016;2016;03;23;Perjantai;3;1;4;1;0;1
294;19.03.2016;2016;03;00;Lauantai;0;0;0;1;0;1
294;19.03.2016;2016;03;01;Lauantai;0;0;0;1;0;1
294;19.03.2016;2016;03;02;Lauantai;0;0;0;0;1;1
294;19.03.2016;2016;03;03;Lauantai;0;0;0;0;0;0
294;19.03.2016;2016;03;04;Lauantai;0;0;0;0;0;0
294;19.03.2016;2016;03;05;Lauantai;0;0;0;0;1;1
294;19.03.2016;2016;03;06;Lauantai;0;0;0;0;3;3
294;19.03.2016;2016;03;07;Lauantai;0;1;1;1;1;2
294;19.03.2016;2016;03;08;Lauantai;1;0;1;3;5;8
294;19.03.2016;2016;03;09;Lauantai;1;2;3;14;12;26
294;19.03.2016;2016;03;10;Lauantai;0;2;2;15;16;31
294;19.03.2016;2016;03;11;Lauantai;2;1;3;9;13;22
294;19.03.2016;2016;03;12;Lauantai;6;3;9;10;15;25
294;19.03.2016;2016;03;13;Lauantai;2;2;4;18;18;36
294;19.03.2016;2016;03;14;Lauantai;7;10;17;27;22;49
294;19.03.2016;2016;03;15;Lauantai;8;5;13;20;14;34
294;19.03.2016;2016;03;16;Lauantai;4;5;9;9;23;32
294;19.03.2016;2016;03;17;Lauantai;1;4;5;24;12;36
294;19.03.2016;2016;03;18;Lauantai;5;5;10;5;8;13
294;19.03.2016;2016;03;19;Lauantai;2;4;6;5;12;17
294;19.03.2016;2016;03;20;Lauantai;3;2;5;8;7;15
294;19.03.2016;2016;03;21;Lauantai;0;0;0;0;0;0
294;19.03.2016;2016;03;22;Lauantai;2;0;2;3;1;4
294;19.03.2016;2016;03;23;Lauantai;0;0;0;1;0;1
294;20.03.2016;2016;03;00;Sunnuntai;0;0;0;0;0;0
294;20.03.2016;2016;03;01;Sunnuntai;0;0;0;0;0;0
294;20.03.2016;2016;03;02;Sunnuntai;0;0;0;0;0;0
294;20.03.2016;2016;03;03;Sunnuntai;0;0;0;0;0;0
294;20.03.2016;2016;03;04;Sunnuntai;0;0;0;0;0;0
294;20.03.2016;2016;03;05;Sunnuntai;0;0;0;0;0;0
294;20.03.2016;2016;03;06;Sunnuntai;0;0;0;1;1;2
294;20.03.2016;2016;03;07;Sunnuntai;0;0;0;2;2;4
294;20.03.2016;2016;03;08;Sunnuntai;0;0;0;2;1;3
294;20.03.2016;2016;03;09;Sunnuntai;0;0;0;12;4;16
294;20.03.2016;2016;03;10;Sunnuntai;0;0;0;11;9;20
294;20.03.2016;2016;03;11;Sunnuntai;0;2;2;9;7;16
294;20.03.2016;2016;03;12;Sunnuntai;1;2;3;15;9;24
294;20.03.2016;2016;03;13;Sunnuntai;3;4;7;7;9;16
294;20.03.2016;2016;03;14;Sunnuntai;3;4;7;15;5;20
294;20.03.2016;2016;03;15;Sunnuntai;6;6;12;9;10;19
294;20.03.2016;2016;03;16;Sunnuntai;4;1;5;11;8;19
294;20.03.2016;2016;03;17;Sunnuntai;1;5;6;8;9;17
294;20.03.2016;2016;03;18;Sunnuntai;2;4;6;17;10;27
294;20.03.2016;2016;03;19;Sunnuntai;3;1;4;9;7;16
294;20.03.2016;2016;03;20;Sunnuntai;0;0;0;4;1;5
294;20.03.2016;2016;03;21;Sunnuntai;0;0;0;0;1;1
294;20.03.2016;2016;03;22;Sunnuntai;0;0;0;0;0;0
294;20.03.2016;2016;03;23;Sunnuntai;0;0;0;0;0;0
294;21.03.2016;2016;03;00;Maanantai;0;0;0;1;0;1
294;21.03.2016;2016;03;01;Maanantai;0;0;0;0;0;0
294;21.03.2016;2016;03;02;Maanantai;0;0;0;0;0;0
294;21.03.2016;2016;03;03;Maanantai;0;0;0;0;0;0
294;21.03.2016;2016;03;04;Maanantai;0;0;0;0;1;1
294;21.03.2016;2016;03;05;Maanantai;0;0;0;0;0;0
294;21.03.2016;2016;03;06;Maanantai;1;0;1;2;3;5
294;21.03.2016;2016;03;07;Maanantai;3;3;6;7;6;13
294;21.03.2016;2016;03;08;Maanantai;5;3;8;13;3;16
294;21.03.2016;2016;03;09;Maanantai;1;6;7;18;17;35
294;21.03.2016;2016;03;10;Maanantai;2;0;2;13;12;25
294;21.03.2016;2016;03;11;Maanantai;1;4;5;15;26;41
294;21.03.2016;2016;03;12;Maanantai;0;5;5;19;20;39
294;21.03.2016;2016;03;13;Maanantai;5;9;14;14;15;29
294;21.03.2016;2016;03;14;Maanantai;8;9;17;22;18;40
294;21.03.2016;2016;03;15;Maanantai;6;2;8;18;14;32
294;21.03.2016;2016;03;16;Maanantai;7;1;8;15;13;28
294;21.03.2016;2016;03;17;Maanantai;3;2;5;8;15;23
294;21.03.2016;2016;03;18;Maanantai;5;6;11;18;16;34
294;21.03.2016;2016;03;19;Maanantai;5;2;7;5;7;12
294;21.03.2016;2016;03;20;Maanantai;0;0;0;3;4;7
294;21.03.2016;2016;03;21;Maanantai;0;2;2;1;1;2
294;21.03.2016;2016;03;22;Maanantai;0;0;0;0;1;1
294;21.03.2016;2016;03;23;Maanantai;0;0;0;0;0;0
294;22.03.2016;2016;03;00;Tiistai;0;0;0;1;0;1
294;22.03.2016;2016;03;01;Tiistai;0;0;0;0;0;0
294;22.03.2016;2016;03;02;Tiistai;0;0;0;0;0;0
294;22.03.2016;2016;03;03;Tiistai;0;0;0;0;0;0
294;22.03.2016;2016;03;04;Tiistai;0;0;0;0;0;0
294;22.03.2016;2016;03;05;Tiistai;0;0;0;1;0;1
294;22.03.2016;2016;03;06;Tiistai;0;1;1;2;1;3
294;22.03.2016;2016;03;07;Tiistai;3;3;6;6;9;15
294;22.03.2016;2016;03;08;Tiistai;2;1;3;13;19;32
294;22.03.2016;2016;03;09;Tiistai;2;1;3;19;14;33
294;22.03.2016;2016;03;10;Tiistai;2;4;6;16;8;24
294;22.03.2016;2016;03;11;Tiistai;10;3;13;23;35;58
294;22.03.2016;2016;03;12;Tiistai;7;12;19;49;24;73
294;22.03.2016;2016;03;13;Tiistai;7;5;12;12;34;46
294;22.03.2016;2016;03;14;Tiistai;2;3;5;16;17;33
294;22.03.2016;2016;03;15;Tiistai;3;4;7;6;14;20
294;22.03.2016;2016;03;16;Tiistai;4;5;9;10;14;24
294;22.03.2016;2016;03;17;Tiistai;4;4;8;13;5;18
294;22.03.2016;2016;03;18;Tiistai;1;2;3;13;9;22
294;22.03.2016;2016;03;19;Tiistai;0;3;3;7;3;10
294;22.03.2016;2016;03;20;Tiistai;1;0;1;7;5;12
294;22.03.2016;2016;03;21;Tiistai;0;0;0;1;2;3
294;22.03.2016;2016;03;22;Tiistai;0;0;0;0;0;0
294;22.03.2016;2016;03;23;Tiistai;0;0;0;1;0;1
294;23.03.2016;2016;03;00;Keskiviikko;0;0;0;0;0;0
294;23.03.2016;2016;03;01;Keskiviikko;0;0;0;0;0;0
294;23.03.2016;2016;03;02;Keskiviikko;0;0;0;0;0;0
294;23.03.2016;2016;03;03;Keskiviikko;0;0;0;0;0;0
294;23.03.2016;2016;03;04;Keskiviikko;0;0;0;0;0;0
294;23.03.2016;2016;03;05;Keskiviikko;0;0;0;0;1;1
294;23.03.2016;2016;03;06;Keskiviikko;2;0;2;6;3;9
294;23.03.2016;2016;03;07;Keskiviikko;3;1;4;11;5;16
294;23.03.2016;2016;03;08;Keskiviikko;5;0;5;21;5;26
294;23.03.2016;2016;03;09;Keskiviikko;1;2;3;20;18;38
294;23.03.2016;2016;03;10;Keskiviikko;1;3;4;7;9;16
294;23.03.2016;2016;03;11;Keskiviikko;2;0;2;21;14;35
294;23.03.2016;2016;03;12;Keskiviikko;0;3;3;12;13;25
294;23.03.2016;2016;03;13;Keskiviikko;2;3;5;5;13;18
294;23.03.2016;2016;03;14;Keskiviikko;4;9;13;9;20;29
294;23.03.2016;2016;03;15;Keskiviikko;7;6;13;14;16;30
294;23.03.2016;2016;03;16;Keskiviikko;2;0;2;4;9;13
294;23.03.2016;2016;03;17;Keskiviikko;2;2;4;9;11;20
294;23.03.2016;2016;03;18;Keskiviikko;3;7;10;13;11;24
294;23.03.2016;2016;03;19;Keskiviikko;3;2;5;16;5;21
294;23.03.2016;2016;03;20;Keskiviikko;0;1;1;9;4;13
294;23.03.2016;2016;03;21;Keskiviikko;1;0;1;0;0;0
294;23.03.2016;2016;03;22;Keskiviikko;0;0;0;0;0;0
294;23.03.2016;2016;03;23;Keskiviikko;0;0;0;0;0;0
294;24.03.2016;2016;03;00;Torstai;0;0;0;0;1;1
294;24.03.2016;2016;03;01;Torstai;0;0;0;0;0;0
294;24.03.2016;2016;03;02;Torstai;0;0;0;0;0;0
294;24.03.2016;2016;03;03;Torstai;0;0;0;0;0;0
294;24.03.2016;2016;03;04;Torstai;0;0;0;0;0;0
294;24.03.2016;2016;03;05;Torstai;0;0;0;1;0;1
294;24.03.2016;2016;03;06;Torstai;1;0;1;3;4;7
294;24.03.2016;2016;03;07;Torstai;1;3;4;7;11;18
294;24.03.2016;2016;03;08;Torstai;2;0;2;13;5;18
294;24.03.2016;2016;03;09;Torstai;2;3;5;13;14;27
294;24.03.2016;2016;03;10;Torstai;1;1;2;26;15;41
294;24.03.2016;2016;03;11;Torstai;3;1;4;18;17;35
294;24.03.2016;2016;03;12;Torstai;1;4;5;8;12;20
294;24.03.2016;2016;03;13;Torstai;1;1;2;10;9;19
294;24.03.2016;2016;03;14;Torstai;4;2;6;16;12;28
294;24.03.2016;2016;03;15;Torstai;8;5;13;13;14;27
294;24.03.2016;2016;03;16;Torstai;7;6;13;10;16;26
294;24.03.2016;2016;03;17;Torstai;2;8;10;13;7;20
294;24.03.2016;2016;03;18;Torstai;2;3;5;10;11;21
294;24.03.2016;2016;03;19;Torstai;1;1;2;7;10;17
294;24.03.2016;2016;03;20;Torstai;2;0;2;3;6;9
294;24.03.2016;2016;03;21;Torstai;2;2;4;6;0;6
294;24.03.2016;2016;03;22;Torstai;0;0;0;1;2;3
294;24.03.2016;2016;03;23;Torstai;0;0;0;3;0;3
294;25.03.2016;2016;03;00;Perjantai;0;0;0;0;0;0
294;25.03.2016;2016;03;01;Perjantai;0;0;0;0;0;0
294;25.03.2016;2016;03;02;Perjantai;0;0;0;0;0;0
294;25.03.2016;2016;03;03;Perjantai;0;0;0;0;0;0
294;25.03.2016;2016;03;04;Perjantai;0;0;0;0;0;0
294;25.03.2016;2016;03;05;Perjantai;0;0;0;0;0;0
294;25.03.2016;2016;03;06;Perjantai;1;0;1;0;4;4
294;25.03.2016;2016;03;07;Perjantai;2;0;2;1;2;3
294;25.03.2016;2016;03;08;Perjantai;0;0;0;1;0;1
294;25.03.2016;2016;03;09;Perjantai;1;1;2;5;7;12
294;25.03.2016;2016;03;10;Perjantai;0;0;0;6;4;10
294;25.03.2016;2016;03;11;Perjantai;2;1;3;8;3;11
294;25.03.2016;2016;03;12;Perjantai;0;2;2;10;10;20
294;25.03.2016;2016;03;13;Perjantai;0;4;4;14;13;27
294;25.03.2016;2016;03;14;Perjantai;6;4;10;5;11;16
294;25.03.2016;2016;03;15;Perjantai;5;5;10;13;11;24
294;25.03.2016;2016;03;16;Perjantai;0;1;1;11;9;20
294;25.03.2016;2016;03;17;Perjantai;5;2;7;10;15;25
294;25.03.2016;2016;03;18;Perjantai;3;8;11;17;14;31
294;25.03.2016;2016;03;19;Perjantai;3;2;5;5;11;16
294;25.03.2016;2016;03;20;Perjantai;3;2;5;9;5;14
294;25.03.2016;2016;03;21;Perjantai;0;0;0;4;2;6
294;25.03.2016;2016;03;22;Perjantai;1;0;1;0;0;0
294;25.03.2016;2016;03;23;Perjantai;0;0;0;1;0;1
294;26.03.2016;2016;03;00;Lauantai;0;0;0;0;1;1
294;26.03.2016;2016;03;01;Lauantai;0;0;0;0;0;0
294;26.03.2016;2016;03;02;Lauantai;0;0;0;0;1;1
294;26.03.2016;2016;03;03;Lauantai;0;0;0;4;0;4
294;26.03.2016;2016;03;04;Lauantai;0;0;0;0;0;0
294;26.03.2016;2016;03;05;Lauantai;0;0;0;0;0;0
294;26.03.2016;2016;03;06;Lauantai;1;1;2;1;4;5
294;26.03.2016;2016;03;07;Lauantai;0;0;0;1;3;4
294;26.03.2016;2016;03;08;Lauantai;0;0;0;5;5;10
294;26.03.2016;2016;03;09;Lauantai;0;0;0;11;8;19
294;26.03.2016;2016;03;10;Lauantai;1;0;1;15;16;31
294;26.03.2016;2016;03;11;Lauantai;3;0;3;4;14;18
294;26.03.2016;2016;03;12;Lauantai;2;3;5;8;21;29
294;26.03.2016;2016;03;13;Lauantai;2;2;4;14;13;27
294;26.03.2016;2016;03;14;Lauantai;2;1;3;11;20;31
294;26.03.2016;2016;03;15;Lauantai;1;6;7;12;3;15
294;26.03.2016;2016;03;16;Lauantai;6;0;6;7;8;15
294;26.03.2016;2016;03;17;Lauantai;0;2;2;14;9;23
294;26.03.2016;2016;03;18;Lauantai;3;2;5;5;6;11
294;26.03.2016;2016;03;19;Lauantai;1;0;1;12;4;16
294;26.03.2016;2016;03;20;Lauantai;5;2;7;5;6;11
294;26.03.2016;2016;03;21;Lauantai;0;0;0;7;3;10
294;26.03.2016;2016;03;22;Lauantai;0;0;0;1;0;1
294;26.03.2016;2016;03;23;Lauantai;0;0;0;2;0;2
294;27.03.2016;2016;03;00;Sunnuntai;0;0;0;0;0;0
294;27.03.2016;2016;03;01;Sunnuntai;0;0;0;0;0;0
294;27.03.2016;2016;03;02;Sunnuntai;0;0;0;0;0;0
294;27.03.2016;2016;03;03;Sunnuntai;0;0;0;0;0;0
294;27.03.2016;2016;03;04;Sunnuntai;0;0;0;0;0;0
294;27.03.2016;2016;03;05;Sunnuntai;0;0;0;0;0;0
294;27.03.2016;2016;03;06;Sunnuntai;0;0;0;0;1;1
294;27.03.2016;2016;03;07;Sunnuntai;1;0;1;1;3;4
294;27.03.2016;2016;03;08;Sunnuntai;0;0;0;2;3;5
294;27.03.2016;2016;03;09;Sunnuntai;0;1;1;8;5;13
294;27.03.2016;2016;03;10;Sunnuntai;0;2;2;13;6;19
294;27.03.2016;2016;03;11;Sunnuntai;2;0;2;8;11;19
294;27.03.2016;2016;03;12;Sunnuntai;0;3;3;11;10;21
294;27.03.2016;2016;03;13;Sunnuntai;9;3;12;9;21;30
294;27.03.2016;2016;03;14;Sunnuntai;7;4;11;15;8;23
294;27.03.2016;2016;03;15;Sunnuntai;3;1;4;12;10;22
294;27.03.2016;2016;03;16;Sunnuntai;1;0;1;13;4;17
294;27.03.2016;2016;03;17;Sunnuntai;0;2;2;15;20;35
294;27.03.2016;2016;03;18;Sunnuntai;4;2;6;11;19;30
294;27.03.2016;2016;03;19;Sunnuntai;6;4;10;19;6;25
294;27.03.2016;2016;03;20;Sunnuntai;6;5;11;16;13;29
294;27.03.2016;2016;03;21;Sunnuntai;1;1;2;10;7;17
294;27.03.2016;2016;03;22;Sunnuntai;1;0;1;7;6;13
294;27.03.2016;2016;03;23;Sunnuntai;2;0;2;7;1;8
294;28.03.2016;2016;03;00;Maanantai;0;0;0;1;0;1
294;28.03.2016;2016;03;01;Maanantai;0;0;0;1;0;1
294;28.03.2016;2016;03;02;Maanantai;0;0;0;0;0;0
294;28.03.2016;2016;03;03;Maanantai;0;0;0;0;2;2
294;28.03.2016;2016;03;04;Maanantai;0;0;0;0;0;0
294;28.03.2016;2016;03;05;Maanantai;0;0;0;0;0;0
294;28.03.2016;2016;03;06;Maanantai;0;1;1;1;1;2
294;28.03.2016;2016;03;07;Maanantai;0;0;0;3;2;5
294;28.03.2016;2016;03;08;Maanantai;1;0;1;3;4;7
294;28.03.2016;2016;03;09;Maanantai;0;2;2;8;8;16
294;28.03.2016;2016;03;10;Maanantai;1;1;2;11;5;16
294;28.03.2016;2016;03;11;Maanantai;2;0;2;10;11;21
294;28.03.2016;2016;03;12;Maanantai;4;9;13;16;13;29
294;28.03.2016;2016;03;13;Maanantai;5;6;11;17;24;41
294;28.03.2016;2016;03;14;Maanantai;2;2;4;7;13;20
294;28.03.2016;2016;03;15;Maanantai;5;2;7;18;27;45
294;28.03.2016;2016;03;16;Maanantai;7;4;11;15;6;21
294;28.03.2016;2016;03;17;Maanantai;3;8;11;12;12;24
294;28.03.2016;2016;03;18;Maanantai;6;10;16;15;20;35
294;28.03.2016;2016;03;19;Maanantai;8;3;11;23;8;31
294;28.03.2016;2016;03;20;Maanantai;3;2;5;6;10;16
294;28.03.2016;2016;03;21;Maanantai;0;1;1;4;0;4
294;28.03.2016;2016;03;22;Maanantai;0;0;0;3;3;6
294;28.03.2016;2016;03;23;Maanantai;0;0;0;0;0;0
294;29.03.2016;2016;03;00;Tiistai;0;0;0;0;0;0
294;29.03.2016;2016;03;01;Tiistai;0;0;0;0;0;0
294;29.03.2016;2016;03;02;Tiistai;0;0;0;0;0;0
294;29.03.2016;2016;03;03;Tiistai;0;0;0;0;0;0
294;29.03.2016;2016;03;04;Tiistai;0;0;0;0;0;0
294;29.03.2016;2016;03;05;Tiistai;0;0;0;1;0;1
294;29.03.2016;2016;03;06;Tiistai;2;4;6;2;0;2
294;29.03.2016;2016;03;07;Tiistai;6;4;10;6;4;10
294;29.03.2016;2016;03;08;Tiistai;6;2;8;6;11;17
294;29.03.2016;2016;03;09;Tiistai;6;2;8;20;16;36
294;29.03.2016;2016;03;10;Tiistai;1;1;2;13;22;35
294;29.03.2016;2016;03;11;Tiistai;2;1;3;20;21;41
294;29.03.2016;2016;03;12;Tiistai;10;6;16;19;19;38
294;29.03.2016;2016;03;13;Tiistai;6;7;13;22;30;52
294;29.03.2016;2016;03;14;Tiistai;5;8;13;29;17;46
294;29.03.2016;2016;03;15;Tiistai;9;12;21;13;33;46
294;29.03.2016;2016;03;16;Tiistai;9;4;13;10;14;24
294;29.03.2016;2016;03;17;Tiistai;10;9;19;22;28;50
294;29.03.2016;2016;03;18;Tiistai;6;6;12;30;20;50
294;29.03.2016;2016;03;19;Tiistai;7;8;15;24;21;45
294;29.03.2016;2016;03;20;Tiistai;3;3;6;11;7;18
294;29.03.2016;2016;03;21;Tiistai;1;0;1;4;5;9
294;29.03.2016;2016;03;22;Tiistai;0;0;0;1;0;1
294;29.03.2016;2016;03;23;Tiistai;0;0;0;0;0;0
294;30.03.2016;2016;03;00;Keskiviikko;0;0;0;0;1;1
294;30.03.2016;2016;03;01;Keskiviikko;0;0;0;0;0;0
294;30.03.2016;2016;03;02;Keskiviikko;0;0;0;0;0;0
294;30.03.2016;2016;03;03;Keskiviikko;0;0;0;0;0;0
294;30.03.2016;2016;03;04;Keskiviikko;0;0;0;0;1;1
294;30.03.2016;2016;03;05;Keskiviikko;0;0;0;1;0;1
294;30.03.2016;2016;03;06;Keskiviikko;1;1;2;5;1;6
294;30.03.2016;2016;03;07;Keskiviikko;2;4;6;5;4;9
294;30.03.2016;2016;03;08;Keskiviikko;9;2;11;21;7;28
294;30.03.2016;2016;03;09;Keskiviikko;2;1;3;21;20;41
294;30.03.2016;2016;03;10;Keskiviikko;0;8;8;13;11;24
294;30.03.2016;2016;03;11;Keskiviikko;3;1;4;7;16;23
294;30.03.2016;2016;03;12;Keskiviikko;5;5;10;26;21;47
294;30.03.2016;2016;03;13;Keskiviikko;7;5;12;28;14;42
294;30.03.2016;2016;03;14;Keskiviikko;9;14;23;19;27;46
294;30.03.2016;2016;03;15;Keskiviikko;14;13;27;23;14;37
294;30.03.2016;2016;03;16;Keskiviikko;3;3;6;10;19;29
294;30.03.2016;2016;03;17;Keskiviikko;7;7;14;9;21;30
294;30.03.2016;2016;03;18;Keskiviikko;6;4;10;24;29;53
294;30.03.2016;2016;03;19;Keskiviikko;4;5;9;21;12;33
294;30.03.2016;2016;03;20;Keskiviikko;2;1;3;5;5;10
294;30.03.2016;2016;03;21;Keskiviikko;2;0;2;5;0;5
294;30.03.2016;2016;03;22;Keskiviikko;0;1;1;0;1;1
294;30.03.2016;2016;03;23;Keskiviikko;0;0;0;0;0;0
294;31.03.2016;2016;03;00;Torstai;0;0;0;0;0;0
294;31.03.2016;2016;03;01;Torstai;0;0;0;0;0;0
294;31.03.2016;2016;03;02;Torstai;0;0;0;0;0;0
294;31.03.2016;2016;03;03;Torstai;0;0;0;0;0;0
294;31.03.2016;2016;03;04;Torstai;0;0;0;0;0;0
294;31.03.2016;2016;03;05;Torstai;0;0;0;0;1;1
294;31.03.2016;2016;03;06;Torstai;0;1;1;1;1;2
294;31.03.2016;2016;03;07;Torstai;7;6;13;7;4;11
294;31.03.2016;2016;03;08;Torstai;7;0;7;9;9;18
294;31.03.2016;2016;03;09;Torstai;5;0;5;17;14;31
294;31.03.2016;2016;03;10;Torstai;6;4;10;9;19;28
294;31.03.2016;2016;03;11;Torstai;1;7;8;16;26;42
294;31.03.2016;2016;03;12;Torstai;5;0;5;27;13;40
294;31.03.2016;2016;03;13;Torstai;4;11;15;14;13;27
294;31.03.2016;2016;03;14;Torstai;13;7;20;23;24;47
294;31.03.2016;2016;03;15;Torstai;18;15;33;16;26;42
294;31.03.2016;2016;03;16;Torstai;11;6;17;8;20;28
294;31.03.2016;2016;03;17;Torstai;6;10;16;20;23;43
294;31.03.2016;2016;03;18;Torstai;8;6;14;17;21;38
294;31.03.2016;2016;03;19;Torstai;3;9;12;16;29;45
294;31.03.2016;2016;03;20;Torstai;6;5;11;10;17;27
294;31.03.2016;2016;03;21;Torstai;1;1;2;7;3;10
294;31.03.2016;2016;03;22;Torstai;0;0;0;0;0;0
294;31.03.2016;2016;03;23;Torstai;0;0;0;0;0;0
294;01.04.2016;2016;04;00;Perjantai;0;0;0;0;0;0
294;01.04.2016;2016;04;01;Perjantai;0;0;0;0;0;0
294;01.04.2016;2016;04;02;Perjantai;0;0;0;0;0;0
294;01.04.2016;2016;04;03;Perjantai;0;0;0;0;0;0
294;01.04.2016;2016;04;04;Perjantai;0;0;0;0;0;0
294;01.04.2016;2016;04;05;Perjantai;0;0;0;0;0;0
294;01.04.2016;2016;04;06;Perjantai;3;2;5;2;1;3
294;01.04.2016;2016;04;07;Perjantai;2;5;7;4;10;14
294;01.04.2016;2016;04;08;Perjantai;10;2;12;3;4;7
294;01.04.2016;2016;04;09;Perjantai;9;2;11;13;8;21
294;01.04.2016;2016;04;10;Perjantai;0;3;3;7;12;19
294;01.04.2016;2016;04;11;Perjantai;7;11;18;12;22;34
294;01.04.2016;2016;04;12;Perjantai;2;10;12;16;20;36
294;01.04.2016;2016;04;13;Perjantai;11;13;24;26;27;53
294;01.04.2016;2016;04;14;Perjantai;24;8;32;19;22;41
294;01.04.2016;2016;04;15;Perjantai;13;11;24;14;17;31
294;01.04.2016;2016;04;16;Perjantai;18;11;29;12;25;37
294;01.04.2016;2016;04;17;Perjantai;7;16;23;15;19;34
294;01.04.2016;2016;04;18;Perjantai;19;17;36;19;13;32
294;01.04.2016;2016;04;19;Perjantai;22;11;33;16;10;26
294;01.04.2016;2016;04;20;Perjantai;7;5;12;10;3;13
294;01.04.2016;2016;04;21;Perjantai;2;4;6;8;4;12
294;01.04.2016;2016;04;22;Perjantai;0;0;0;2;0;2
294;01.04.2016;2016;04;23;Perjantai;1;1;2;0;1;1
294;02.04.2016;2016;04;00;Lauantai;0;0;0;0;1;1
294;02.04.2016;2016;04;01;Lauantai;0;0;0;0;0;0
294;02.04.2016;2016;04;02;Lauantai;0;0;0;1;0;1
294;02.04.2016;2016;04;03;Lauantai;1;0;1;0;0;0
294;02.04.2016;2016;04;04;Lauantai;0;1;1;0;0;0
294;02.04.2016;2016;04;05;Lauantai;1;0;1;1;0;1
294;02.04.2016;2016;04;06;Lauantai;0;2;2;0;3;3
294;02.04.2016;2016;04;07;Lauantai;0;1;1;1;3;4
294;02.04.2016;2016;04;08;Lauantai;10;5;15;13;11;24
294;02.04.2016;2016;04;09;Lauantai;8;7;15;19;13;32
294;02.04.2016;2016;04;10;Lauantai;8;11;19;10;18;28
294;02.04.2016;2016;04;11;Lauantai;9;7;16;19;33;52
294;02.04.2016;2016;04;12;Lauantai;14;13;27;23;18;41
294;02.04.2016;2016;04;13;Lauantai;9;9;18;18;14;32
294;02.04.2016;2016;04;14;Lauantai;15;11;26;13;10;23
294;02.04.2016;2016;04;15;Lauantai;7;13;20;18;21;39
294;02.04.2016;2016;04;16;Lauantai;16;11;27;10;12;22
294;02.04.2016;2016;04;17;Lauantai;6;12;18;11;13;24
294;02.04.2016;2016;04;18;Lauantai;12;15;27;14;12;26
294;02.04.2016;2016;04;19;Lauantai;6;4;10;15;17;32
294;02.04.2016;2016;04;20;Lauantai;8;7;15;7;7;14
294;02.04.2016;2016;04;21;Lauantai;8;4;12;9;3;12
294;02.04.2016;2016;04;22;Lauantai;2;0;2;2;2;4
294;02.04.2016;2016;04;23;Lauantai;0;0;0;2;0;2
294;03.04.2016;2016;04;00;Sunnuntai;0;0;0;1;0;1
294;03.04.2016;2016;04;01;Sunnuntai;1;0;1;1;0;1
294;03.04.2016;2016;04;02;Sunnuntai;0;0;0;0;1;1
294;03.04.2016;2016;04;03;Sunnuntai;0;0;0;0;4;4
294;03.04.2016;2016;04;04;Sunnuntai;0;0;0;0;0;0
294;03.04.2016;2016;04;05;Sunnuntai;1;0;1;0;0;0
294;03.04.2016;2016;04;06;Sunnuntai;0;0;0;0;1;1
294;03.04.2016;2016;04;07;Sunnuntai;0;0;0;1;2;3
294;03.04.2016;2016;04;08;Sunnuntai;0;0;0;6;7;13
294;03.04.2016;2016;04;09;Sunnuntai;1;0;1;9;10;19
294;03.04.2016;2016;04;10;Sunnuntai;1;8;9;16;17;33
294;03.04.2016;2016;04;11;Sunnuntai;16;6;22;19;16;35
294;03.04.2016;2016;04;12;Sunnuntai;6;10;16;8;21;29
294;03.04.2016;2016;04;13;Sunnuntai;12;14;26;11;17;28
294;03.04.2016;2016;04;14;Sunnuntai;13;5;18;18;6;24
294;03.04.2016;2016;04;15;Sunnuntai;20;10;30;12;19;31
294;03.04.2016;2016;04;16;Sunnuntai;13;6;19;14;10;24
294;03.04.2016;2016;04;17;Sunnuntai;12;8;20;13;6;19
294;03.04.2016;2016;04;18;Sunnuntai;11;10;21;19;17;36
294;03.04.2016;2016;04;19;Sunnuntai;10;0;10;15;10;25
294;03.04.2016;2016;04;20;Sunnuntai;3;6;9;5;6;11
294;03.04.2016;2016;04;21;Sunnuntai;3;2;5;2;2;4
294;03.04.2016;2016;04;22;Sunnuntai;0;2;2;0;0;0
294;03.04.2016;2016;04;23;Sunnuntai;1;0;1;0;0;0
294;04.04.2016;2016;04;00;Maanantai;0;0;0;0;0;0
294;04.04.2016;2016;04;01;Maanantai;0;0;0;0;0;0
294;04.04.2016;2016;04;02;Maanantai;0;0;0;0;0;0
294;04.04.2016;2016;04;03;Maanantai;0;0;0;0;0;0
294;04.04.2016;2016;04;04;Maanantai;0;0;0;0;0;0
294;04.04.2016;2016;04;05;Maanantai;0;0;0;0;0;0
294;04.04.2016;2016;04;06;Maanantai;1;4;5;1;2;3
294;04.04.2016;2016;04;07;Maanantai;6;10;16;3;5;8
294;04.04.2016;2016;04;08;Maanantai;8;1;9;11;8;19
294;04.04.2016;2016;04;09;Maanantai;2;1;3;11;12;23
294;04.04.2016;2016;04;10;Maanantai;13;3;16;13;14;27
294;04.04.2016;2016;04;11;Maanantai;7;7;14;16;16;32
294;04.04.2016;2016;04;12;Maanantai;12;13;25;9;20;29
294;04.04.2016;2016;04;13;Maanantai;19;13;32;11;13;24
294;04.04.2016;2016;04;14;Maanantai;22;13;35;14;15;29
294;04.04.2016;2016;04;15;Maanantai;19;10;29;20;18;38
294;04.04.2016;2016;04;16;Maanantai;16;13;29;17;24;41
294;04.04.2016;2016;04;17;Maanantai;11;17;28;27;16;43
294;04.04.2016;2016;04;18;Maanantai;29;24;53;22;23;45
294;04.04.2016;2016;04;19;Maanantai;15;8;23;16;26;42
294;04.04.2016;2016;04;20;Maanantai;7;6;13;11;4;15
294;04.04.2016;2016;04;21;Maanantai;0;2;2;0;2;2
294;04.04.2016;2016;04;22;Maanantai;0;0;0;1;0;1
294;04.04.2016;2016;04;23;Maanantai;0;0;0;1;0;1
294;05.04.2016;2016;04;00;Tiistai;0;0;0;0;0;0
294;05.04.2016;2016;04;01;Tiistai;0;0;0;0;0;0
294;05.04.2016;2016;04;02;Tiistai;0;0;0;0;0;0
294;05.04.2016;2016;04;03;Tiistai;0;0;0;0;0;0
294;05.04.2016;2016;04;04;Tiistai;0;0;0;0;0;0
294;05.04.2016;2016;04;05;Tiistai;0;0;0;1;0;1
294;05.04.2016;2016;04;06;Tiistai;2;0;2;4;0;4
294;05.04.2016;2016;04;07;Tiistai;14;7;21;4;2;6
294;05.04.2016;2016;04;08;Tiistai;2;4;6;15;4;19
294;05.04.2016;2016;04;09;Tiistai;8;2;10;8;10;18
294;05.04.2016;2016;04;10;Tiistai;3;2;5;13;6;19
294;05.04.2016;2016;04;11;Tiistai;3;3;6;10;19;29
294;05.04.2016;2016;04;12;Tiistai;5;6;11;15;19;34
294;05.04.2016;2016;04;13;Tiistai;4;14;18;9;12;21
294;05.04.2016;2016;04;14;Tiistai;12;11;23;10;11;21
294;05.04.2016;2016;04;15;Tiistai;9;15;24;11;11;22
294;05.04.2016;2016;04;16;Tiistai;7;11;18;14;14;28
294;05.04.2016;2016;04;17;Tiistai;10;8;18;9;8;17
294;05.04.2016;2016;04;18;Tiistai;12;9;21;10;12;22
294;05.04.2016;2016;04;19;Tiistai;9;5;14;9;8;17
294;05.04.2016;2016;04;20;Tiistai;8;2;10;7;10;17
294;05.04.2016;2016;04;21;Tiistai;0;1;1;2;1;3
294;05.04.2016;2016;04;22;Tiistai;0;0;0;0;3;3
294;05.04.2016;2016;04;23;Tiistai;0;1;1;1;0;1
294;06.04.2016;2016;04;00;Keskiviikko;0;0;0;0;0;0
294;06.04.2016;2016;04;01;Keskiviikko;0;0;0;0;0;0
294;06.04.2016;2016;04;02;Keskiviikko;0;0;0;0;0;0
294;06.04.2016;2016;04;03;Keskiviikko;0;0;0;0;0;0
294;06.04.2016;2016;04;04;Keskiviikko;0;0;0;0;0;0
294;06.04.2016;2016;04;05;Keskiviikko;0;0;0;0;1;1
294;06.04.2016;2016;04;06;Keskiviikko;1;1;2;3;3;6
294;06.04.2016;2016;04;07;Keskiviikko;6;7;13;7;4;11
294;06.04.2016;2016;04;08;Keskiviikko;8;2;10;10;3;13
294;06.04.2016;2016;04;09;Keskiviikko;3;4;7;9;8;17
294;06.04.2016;2016;04;10;Keskiviikko;1;2;3;6;12;18
294;06.04.2016;2016;04;11;Keskiviikko;10;7;17;11;13;24
294;06.04.2016;2016;04;12;Keskiviikko;5;5;10;12;11;23
294;06.04.2016;2016;04;13;Keskiviikko;12;14;26;6;9;15
294;06.04.2016;2016;04;14;Keskiviikko;13;27;40;12;11;23
294;06.04.2016;2016;04;15;Keskiviikko;19;17;36;10;13;23
294;06.04.2016;2016;04;16;Keskiviikko;11;9;20;5;10;15
294;06.04.2016;2016;04;17;Keskiviikko;2;9;11;7;4;11
294;06.04.2016;2016;04;18;Keskiviikko;3;1;4;6;5;11
294;06.04.2016;2016;04;19;Keskiviikko;2;3;5;1;6;7
294;06.04.2016;2016;04;20;Keskiviikko;1;0;1;0;1;1
294;06.04.2016;2016;04;21;Keskiviikko;0;2;2;0;1;1
294;06.04.2016;2016;04;22;Keskiviikko;0;0;0;0;0;0
294;06.04.2016;2016;04;23;Keskiviikko;0;0;0;0;0;0
294;07.04.2016;2016;04;00;Torstai;0;0;0;0;0;0
294;07.04.2016;2016;04;01;Torstai;0;0;0;0;0;0
294;07.04.2016;2016;04;02;Torstai;0;0;0;0;0;0
294;07.04.2016;2016;04;03;Torstai;0;0;0;0;0;0
294;07.04.2016;2016;04;04;Torstai;0;0;0;0;0;0
294;07.04.2016;2016;04;05;Torstai;0;0;0;0;0;0
294;07.04.2016;2016;04;06;Torstai;1;2;3;2;0;2
294;07.04.2016;2016;04;07;Torstai;3;6;9;4;7;11
294;07.04.2016;2016;04;08;Torstai;10;4;14;7;6;13
294;07.04.2016;2016;04;09;Torstai;11;5;16;16;13;29
294;07.04.2016;2016;04;10;Torstai;12;9;21;12;15;27
294;07.04.2016;2016;04;11;Torstai;4;7;11;8;7;15
294;07.04.2016;2016;04;12;Torstai;5;5;10;10;7;17
294;07.04.2016;2016;04;13;Torstai;7;9;16;8;15;23
294;07.04.2016;2016;04;14;Torstai;16;9;25;19;10;29
294;07.04.2016;2016;04;15;Torstai;13;12;25;12;12;24
294;07.04.2016;2016;04;16;Torstai;9;11;20;8;11;19
294;07.04.2016;2016;04;17;Torstai;12;14;26;14;24;38
294;07.04.2016;2016;04;18;Torstai;13;12;25;18;15;33
294;07.04.2016;2016;04;19;Torstai;12;23;35;13;15;28
294;07.04.2016;2016;04;20;Torstai;1;6;7;14;8;22
294;07.04.2016;2016;04;21;Torstai;0;1;1;3;0;3
294;07.04.2016;2016;04;22;Torstai;0;0;0;0;1;1
294;07.04.2016;2016;04;23;Torstai;1;0;1;0;0;0
294;08.04.2016;2016;04;00;Perjantai;0;0;0;0;0;0
294;08.04.2016;2016;04;01;Perjantai;0;0;0;0;0;0
294;08.04.2016;2016;04;02;Perjantai;0;0;0;0;0;0
294;08.04.2016;2016;04;03;Perjantai;0;0;0;0;0;0
294;08.04.2016;2016;04;04;Perjantai;0;1;1;0;0;0
294;08.04.2016;2016;04;05;Perjantai;0;0;0;0;0;0
294;08.04.2016;2016;04;06;Perjantai;1;1;2;2;2;4
294;08.04.2016;2016;04;07;Perjantai;4;8;12;2;4;6
294;08.04.2016;2016;04;08;Perjantai;7;6;13;17;2;19
294;08.04.2016;2016;04;09;Perjantai;6;5;11;17;7;24
294;08.04.2016;2016;04;10;Perjantai;3;13;16;14;16;30
294;08.04.2016;2016;04;11;Perjantai;6;5;11;4;11;15
294;08.04.2016;2016;04;12;Perjantai;10;23;33;9;6;15
294;08.04.2016;2016;04;13;Perjantai;20;9;29;8;16;24
294;08.04.2016;2016;04;14;Perjantai;15;16;31;13;2;15
294;08.04.2016;2016;04;15;Perjantai;8;17;25;8;10;18
294;08.04.2016;2016;04;16;Perjantai;13;9;22;10;12;22
294;08.04.2016;2016;04;17;Perjantai;22;18;40;10;10;20
294;08.04.2016;2016;04;18;Perjantai;16;16;32;12;12;24
294;08.04.2016;2016;04;19;Perjantai;12;10;22;19;8;27
294;08.04.2016;2016;04;20;Perjantai;4;5;9;4;9;13
294;08.04.2016;2016;04;21;Perjantai;1;3;4;2;5;7
294;08.04.2016;2016;04;22;Perjantai;2;0;2;2;0;2
294;08.04.2016;2016;04;23;Perjantai;2;0;2;0;1;1
294;09.04.2016;2016;04;00;Lauantai;1;0;1;0;0;0
294;09.04.2016;2016;04;01;Lauantai;0;0;0;0;0;0
294;09.04.2016;2016;04;02;Lauantai;0;0;0;0;0;0
294;09.04.2016;2016;04;03;Lauantai;0;0;0;0;0;0
294;09.04.2016;2016;04;04;Lauantai;0;0;0;0;0;0
294;09.04.2016;2016;04;05;Lauantai;1;0;1;0;2;2
294;09.04.2016;2016;04;06;Lauantai;1;1;2;0;0;0
294;09.04.2016;2016;04;07;Lauantai;0;1;1;2;3;5
294;09.04.2016;2016;04;08;Lauantai;2;0;2;5;5;10
294;09.04.2016;2016;04;09;Lauantai;6;5;11;12;8;20
294;09.04.2016;2016;04;10;Lauantai;11;12;23;19;12;31
294;09.04.2016;2016;04;11;Lauantai;23;16;39;5;12;17
294;09.04.2016;2016;04;12;Lauantai;12;10;22;15;11;26
294;09.04.2016;2016;04;13;Lauantai;19;14;33;15;6;21
294;09.04.2016;2016;04;14;Lauantai;18;12;30;14;9;23
294;09.04.2016;2016;04;15;Lauantai;17;29;46;17;19;36
294;09.04.2016;2016;04;16;Lauantai;39;17;56;17;18;35
294;09.04.2016;2016;04;17;Lauantai;13;13;26;7;14;21
294;09.04.2016;2016;04;18;Lauantai;11;7;18;13;10;23
294;09.04.2016;2016;04;19;Lauantai;9;5;14;5;5;10
294;09.04.2016;2016;04;20;Lauantai;11;7;18;10;3;13
294;09.04.2016;2016;04;21;Lauantai;2;3;5;3;6;9
294;09.04.2016;2016;04;22;Lauantai;6;0;6;4;0;4
294;09.04.2016;2016;04;23;Lauantai;0;0;0;0;0;0
294;10.04.2016;2016;04;00;Sunnuntai;5;0;5;1;0;1
294;10.04.2016;2016;04;01;Sunnuntai;0;0;0;0;1;1
294;10.04.2016;2016;04;02;Sunnuntai;0;0;0;0;1;1
294;10.04.2016;2016;04;03;Sunnuntai;0;0;0;0;0;0
294;10.04.2016;2016;04;04;Sunnuntai;0;0;0;0;0;0
294;10.04.2016;2016;04;05;Sunnuntai;0;0;0;0;0;0
294;10.04.2016;2016;04;06;Sunnuntai;0;0;0;2;0;2
294;10.04.2016;2016;04;07;Sunnuntai;1;0;1;1;2;3
294;10.04.2016;2016;04;08;Sunnuntai;3;2;5;11;4;15
294;10.04.2016;2016;04;09;Sunnuntai;5;2;7;8;6;14
294;10.04.2016;2016;04;10;Sunnuntai;6;2;8;10;7;17
294;10.04.2016;2016;04;11;Sunnuntai;9;16;25;9;4;13
294;10.04.2016;2016;04;12;Sunnuntai;9;10;19;8;12;20
294;10.04.2016;2016;04;13;Sunnuntai;9;10;19;10;9;19
294;10.04.2016;2016;04;14;Sunnuntai;11;14;25;12;3;15
294;10.04.2016;2016;04;15;Sunnuntai;18;9;27;5;4;9
294;10.04.2016;2016;04;16;Sunnuntai;4;15;19;11;9;20
294;10.04.2016;2016;04;17;Sunnuntai;12;14;26;8;5;13
294;10.04.2016;2016;04;18;Sunnuntai;18;9;27;14;12;26
294;10.04.2016;2016;04;19;Sunnuntai;8;11;19;7;11;18
294;10.04.2016;2016;04;20;Sunnuntai;12;11;23;4;10;14
294;10.04.2016;2016;04;21;Sunnuntai;4;0;4;1;1;2
294;10.04.2016;2016;04;22;Sunnuntai;1;1;2;2;0;2
294;10.04.2016;2016;04;23;Sunnuntai;0;0;0;0;0;0
294;11.04.2016;2016;04;00;Maanantai;0;0;0;0;0;0
294;11.04.2016;2016;04;01;Maanantai;0;0;0;0;0;0
294;11.04.2016;2016;04;02;Maanantai;0;0;0;0;0;0
294;11.04.2016;2016;04;03;Maanantai;0;0;0;0;0;0
294;11.04.2016;2016;04;04;Maanantai;0;0;0;0;1;1
294;11.04.2016;2016;04;05;Maanantai;0;1;1;0;1;1
294;11.04.2016;2016;04;06;Maanantai;2;1;3;2;3;5
294;11.04.2016;2016;04;07;Maanantai;13;8;21;2;4;6
294;11.04.2016;2016;04;08;Maanantai;15;6;21;10;9;19
294;11.04.2016;2016;04;09;Maanantai;12;6;18;8;14;22
294;11.04.2016;2016;04;10;Maanantai;7;9;16;15;10;25
294;11.04.2016;2016;04;11;Maanantai;13;9;22;13;13;26
294;11.04.2016;2016;04;12;Maanantai;10;19;29;10;11;21
294;11.04.2016;2016;04;13;Maanantai;25;15;40;10;7;17
294;11.04.2016;2016;04;14;Maanantai;17;19;36;9;9;18
294;11.04.2016;2016;04;15;Maanantai;26;26;52;12;9;21
294;11.04.2016;2016;04;16;Maanantai;23;24;47;8;9;17
294;11.04.2016;2016;04;17;Maanantai;28;18;46;23;15;38
294;11.04.2016;2016;04;18;Maanantai;27;18;45;17;19;36
294;11.04.2016;2016;04;19;Maanantai;22;11;33;17;7;24
294;11.04.2016;2016;04;20;Maanantai;3;7;10;7;6;13
294;11.04.2016;2016;04;21;Maanantai;0;2;2;1;3;4
294;11.04.2016;2016;04;22;Maanantai;0;2;2;2;0;2
294;11.04.2016;2016;04;23;Maanantai;1;0;1;0;1;1
294;12.04.2016;2016;04;00;Tiistai;0;0;0;0;0;0
294;12.04.2016;2016;04;01;Tiistai;0;0;0;0;0;0
294;12.04.2016;2016;04;02;Tiistai;0;0;0;0;0;0
294;12.04.2016;2016;04;03;Tiistai;0;0;0;0;0;0
294;12.04.2016;2016;04;04;Tiistai;0;0;0;0;0;0
294;12.04.2016;2016;04;05;Tiistai;0;0;0;0;1;1
294;12.04.2016;2016;04;06;Tiistai;3;3;6;3;0;3
294;12.04.2016;2016;04;07;Tiistai;15;11;26;5;3;8
294;12.04.2016;2016;04;08;Tiistai;9;6;15;8;8;16
294;12.04.2016;2016;04;09;Tiistai;8;5;13;7;6;13
294;12.04.2016;2016;04;10;Tiistai;8;8;16;12;18;30
294;12.04.2016;2016;04;11;Tiistai;7;5;12;16;22;38
294;12.04.2016;2016;04;12;Tiistai;11;13;24;4;7;11
294;12.04.2016;2016;04;13;Tiistai;20;25;45;11;20;31
294;12.04.2016;2016;04;14;Tiistai;17;16;33;20;12;32
294;12.04.2016;2016;04;15;Tiistai;27;24;51;9;6;15
294;12.04.2016;2016;04;16;Tiistai;13;14;27;14;16;30
294;12.04.2016;2016;04;17;Tiistai;17;14;31;12;9;21
294;12.04.2016;2016;04;18;Tiistai;18;23;41;21;13;34
294;12.04.2016;2016;04;19;Tiistai;13;9;22;11;12;23
294;12.04.2016;2016;04;20;Tiistai;8;5;13;8;8;16
294;12.04.2016;2016;04;21;Tiistai;4;2;6;1;9;10
294;12.04.2016;2016;04;22;Tiistai;1;1;2;0;3;3
294;12.04.2016;2016;04;23;Tiistai;1;0;1;0;0;0
294;13.04.2016;2016;04;00;Keskiviikko;0;0;0;0;0;0
294;13.04.2016;2016;04;01;Keskiviikko;0;0;0;0;0;0
294;13.04.2016;2016;04;02;Keskiviikko;1;0;1;0;0;0
294;13.04.2016;2016;04;03;Keskiviikko;0;0;0;0;0;0
294;13.04.2016;2016;04;04;Keskiviikko;0;1;1;0;0;0
294;13.04.2016;2016;04;05;Keskiviikko;0;0;0;0;0;0
294;13.04.2016;2016;04;06;Keskiviikko;4;2;6;1;2;3
294;13.04.2016;2016;04;07;Keskiviikko;11;5;16;4;6;10
294;13.04.2016;2016;04;08;Keskiviikko;10;2;12;10;6;16
294;13.04.2016;2016;04;09;Keskiviikko;12;6;18;9;8;17
294;13.04.2016;2016;04;10;Keskiviikko;9;3;12;17;7;24
294;13.04.2016;2016;04;11;Keskiviikko;9;9;18;10;10;20
294;13.04.2016;2016;04;12;Keskiviikko;6;6;12;5;5;10
294;13.04.2016;2016;04;13;Keskiviikko;8;11;19;10;12;22
294;13.04.2016;2016;04;14;Keskiviikko;17;21;38;16;22;38
294;13.04.2016;2016;04;15;Keskiviikko;27;17;44;20;16;36
294;13.04.2016;2016;04;16;Keskiviikko;11;10;21;5;10;15
294;13.04.2016;2016;04;17;Keskiviikko;15;6;21;12;18;30
294;13.04.2016;2016;04;18;Keskiviikko;5;14;19;20;11;31
294;13.04.2016;2016;04;19;Keskiviikko;5;8;13;11;13;24
294;13.04.2016;2016;04;20;Keskiviikko;6;6;12;12;6;18
294;13.04.2016;2016;04;21;Keskiviikko;4;1;5;2;3;5
294;13.04.2016;2016;04;22;Keskiviikko;0;0;0;0;0;0
294;13.04.2016;2016;04;23;Keskiviikko;0;0;0;0;0;0
294;14.04.2016;2016;04;00;Torstai;0;0;0;0;0;0
294;14.04.2016;2016;04;01;Torstai;0;0;0;0;0;0
294;14.04.2016;2016;04;02;Torstai;0;0;0;0;0;0
294;14.04.2016;2016;04;03;Torstai;0;0;0;0;0;0
294;14.04.2016;2016;04;04;Torstai;0;0;0;0;0;0
294;14.04.2016;2016;04;05;Torstai;0;0;0;3;1;4
294;14.04.2016;2016;04;06;Torstai;1;1;2;3;1;4
294;14.04.2016;2016;04;07;Torstai;14;3;17;4;2;6
294;14.04.2016;2016;04;08;Torstai;16;3;19;11;11;22
294;14.04.2016;2016;04;09;Torstai;9;9;18;8;11;19
294;14.04.2016;2016;04;10;Torstai;6;9;15;10;14;24
294;14.04.2016;2016;04;11;Torstai;6;12;18;18;21;39
294;14.04.2016;2016;04;12;Torstai;7;10;17;27;24;51
294;14.04.2016;2016;04;13;Torstai;17;14;31;18;13;31
294;14.04.2016;2016;04;14;Torstai;14;18;32;8;9;17
294;14.04.2016;2016;04;15;Torstai;17;17;34;14;12;26
294;14.04.2016;2016;04;16;Torstai;26;19;45;17;20;37
294;14.04.2016;2016;04;17;Torstai;25;12;37;12;12;24
294;14.04.2016;2016;04;18;Torstai;16;26;42;14;23;37
294;14.04.2016;2016;04;19;Torstai;11;10;21;21;13;34
294;14.04.2016;2016;04;20;Torstai;6;8;14;6;9;15
294;14.04.2016;2016;04;21;Torstai;2;0;2;1;2;3
294;14.04.2016;2016;04;22;Torstai;0;1;1;0;0;0
294;14.04.2016;2016;04;23;Torstai;1;0;1;0;0;0
294;15.04.2016;2016;04;00;Perjantai;0;0;0;0;0;0
294;15.04.2016;2016;04;01;Perjantai;0;0;0;0;0;0
294;15.04.2016;2016;04;02;Perjantai;0;0;0;0;0;0
294;15.04.2016;2016;04;03;Perjantai;0;0;0;0;0;0
294;15.04.2016;2016;04;04;Perjantai;0;1;1;0;0;0
294;15.04.2016;2016;04;05;Perjantai;0;0;0;1;0;1
294;15.04.2016;2016;04;06;Perjantai;2;0;2;0;0;0
294;15.04.2016;2016;04;07;Perjantai;5;3;8;3;2;5
294;15.04.2016;2016;04;08;Perjantai;3;6;9;11;2;13
294;15.04.2016;2016;04;09;Perjantai;11;1;12;10;1;11
294;15.04.2016;2016;04;10;Perjantai;10;15;25;8;11;19
294;15.04.2016;2016;04;11;Perjantai;5;5;10;18;17;35
294;15.04.2016;2016;04;12;Perjantai;18;24;42;11;6;17
294;15.04.2016;2016;04;13;Perjantai;22;7;29;14;7;21
294;15.04.2016;2016;04;14;Perjantai;21;39;60;11;22;33
294;15.04.2016;2016;04;15;Perjantai;24;16;40;16;11;27
294;15.04.2016;2016;04;16;Perjantai;20;19;39;17;14;31
294;15.04.2016;2016;04;17;Perjantai;18;14;32;8;9;17
294;15.04.2016;2016;04;18;Perjantai;21;22;43;17;16;33
294;15.04.2016;2016;04;19;Perjantai;15;8;23;8;7;15
294;15.04.2016;2016;04;20;Perjantai;10;7;17;7;3;10
294;15.04.2016;2016;04;21;Perjantai;7;3;10;5;1;6
294;15.04.2016;2016;04;22;Perjantai;2;3;5;2;0;2
294;15.04.2016;2016;04;23;Perjantai;1;1;2;2;0;2
294;16.04.2016;2016;04;00;Lauantai;0;1;1;0;1;1
294;16.04.2016;2016;04;01;Lauantai;0;0;0;0;0;0
294;16.04.2016;2016;04;02;Lauantai;0;0;0;0;2;2
294;16.04.2016;2016;04;03;Lauantai;0;0;0;0;0;0
294;16.04.2016;2016;04;04;Lauantai;0;0;0;0;0;0
294;16.04.2016;2016;04;05;Lauantai;0;0;0;0;1;1
294;16.04.2016;2016;04;06;Lauantai;0;1;1;1;2;3
294;16.04.2016;2016;04;07;Lauantai;1;1;2;2;0;2
294;16.04.2016;2016;04;08;Lauantai;4;4;8;5;4;9
294;16.04.2016;2016;04;09;Lauantai;6;8;14;10;7;17
294;16.04.2016;2016;04;10;Lauantai;11;11;22;10;13;23
294;16.04.2016;2016;04;11;Lauantai;17;16;33;10;8;18
294;16.04.2016;2016;04;12;Lauantai;16;14;30;2;8;10
294;16.04.2016;2016;04;13;Lauantai;13;16;29;20;12;32
294;16.04.2016;2016;04;14;Lauantai;23;13;36;13;15;28
294;16.04.2016;2016;04;15;Lauantai;14;11;25;5;4;9
294;16.04.2016;2016;04;16;Lauantai;8;6;14;13;9;22
294;16.04.2016;2016;04;17;Lauantai;7;12;19;4;3;7
294;16.04.2016;2016;04;18;Lauantai;12;11;23;8;7;15
294;16.04.2016;2016;04;19;Lauantai;4;9;13;8;3;11
294;16.04.2016;2016;04;20;Lauantai;4;4;8;9;6;15
294;16.04.2016;2016;04;21;Lauantai;4;7;11;4;2;6
294;16.04.2016;2016;04;22;Lauantai;2;2;4;3;0;3
294;16.04.2016;2016;04;23;Lauantai;2;0;2;1;0;1
294;17.04.2016;2016;04;00;Sunnuntai;1;0;1;0;0;0
294;17.04.2016;2016;04;01;Sunnuntai;5;2;7;1;0;1
294;17.04.2016;2016;04;02;Sunnuntai;0;0;0;0;0;0
294;17.04.2016;2016;04;03;Sunnuntai;0;0;0;0;3;3
294;17.04.2016;2016;04;04;Sunnuntai;0;0;0;0;0;0
294;17.04.2016;2016;04;05;Sunnuntai;0;0;0;0;0;0
294;17.04.2016;2016;04;06;Sunnuntai;0;1;1;0;1;1
294;17.04.2016;2016;04;07;Sunnuntai;0;1;1;1;1;2
294;17.04.2016;2016;04;08;Sunnuntai;4;3;7;4;3;7
294;17.04.2016;2016;04;09;Sunnuntai;1;4;5;0;5;5
294;17.04.2016;2016;04;10;Sunnuntai;2;3;5;3;3;6
294;17.04.2016;2016;04;11;Sunnuntai;0;5;5;6;4;10
294;17.04.2016;2016;04;12;Sunnuntai;5;3;8;5;7;12
294;17.04.2016;2016;04;13;Sunnuntai;6;8;14;11;7;18
294;17.04.2016;2016;04;14;Sunnuntai;14;4;18;9;3;12
294;17.04.2016;2016;04;15;Sunnuntai;7;8;15;6;5;11
294;17.04.2016;2016;04;16;Sunnuntai;13;8;21;7;4;11
294;17.04.2016;2016;04;17;Sunnuntai;14;17;31;16;8;24
294;17.04.2016;2016;04;18;Sunnuntai;10;10;20;12;2;14
294;17.04.2016;2016;04;19;Sunnuntai;7;7;14;12;12;24
294;17.04.2016;2016;04;20;Sunnuntai;6;5;11;8;2;10
294;17.04.2016;2016;04;21;Sunnuntai;2;2;4;1;3;4
294;17.04.2016;2016;04;22;Sunnuntai;0;0;0;2;0;2
294;17.04.2016;2016;04;23;Sunnuntai;0;0;0;0;0;0
294;18.04.2016;2016;04;00;Maanantai;0;1;1;0;0;0
294;18.04.2016;2016;04;01;Maanantai;0;0;0;0;0;0
294;18.04.2016;2016;04;02;Maanantai;0;0;0;0;0;0
294;18.04.2016;2016;04;03;Maanantai;0;0;0;0;0;0
294;18.04.2016;2016;04;04;Maanantai;0;0;0;0;0;0
294;18.04.2016;2016;04;05;Maanantai;0;1;1;0;0;0
294;18.04.2016;2016;04;06;Maanantai;4;0;4;1;4;5
294;18.04.2016;2016;04;07;Maanantai;5;9;14;6;1;7
294;18.04.2016;2016;04;08;Maanantai;12;5;17;9;3;12
294;18.04.2016;2016;04;09;Maanantai;14;12;26;11;10;21
294;18.04.2016;2016;04;10;Maanantai;12;11;23;23;6;29
294;18.04.2016;2016;04;11;Maanantai;11;12;23;14;19;33
294;18.04.2016;2016;04;12;Maanantai;12;11;23;12;13;25
294;18.04.2016;2016;04;13;Maanantai;14;18;32;12;13;25
294;18.04.2016;2016;04;14;Maanantai;19;15;34;11;13;24
294;18.04.2016;2016;04;15;Maanantai;28;27;55;8;14;22
294;18.04.2016;2016;04;16;Maanantai;19;17;36;13;10;23
294;18.04.2016;2016;04;17;Maanantai;14;19;33;10;11;21
294;18.04.2016;2016;04;18;Maanantai;16;22;38;13;9;22
294;18.04.2016;2016;04;19;Maanantai;14;8;22;19;10;29
294;18.04.2016;2016;04;20;Maanantai;6;3;9;3;8;11
294;18.04.2016;2016;04;21;Maanantai;5;1;6;1;3;4
294;18.04.2016;2016;04;22;Maanantai;1;0;1;1;0;1
294;18.04.2016;2016;04;23;Maanantai;0;0;0;0;1;1
294;19.04.2016;2016;04;00;Tiistai;0;0;0;0;0;0
294;19.04.2016;2016;04;01;Tiistai;0;0;0;0;0;0
294;19.04.2016;2016;04;02;Tiistai;0;0;0;0;0;0
294;19.04.2016;2016;04;03;Tiistai;0;0;0;0;0;0
294;19.04.2016;2016;04;04;Tiistai;0;0;0;0;0;0
294;19.04.2016;2016;04;05;Tiistai;1;1;2;0;0;0
294;19.04.2016;2016;04;06;Tiistai;4;3;7;0;0;0
294;19.04.2016;2016;04;07;Tiistai;9;12;21;9;2;11
294;19.04.2016;2016;04;08;Tiistai;13;6;19;8;6;14
294;19.04.2016;2016;04;09;Tiistai;14;3;17;9;13;22
294;19.04.2016;2016;04;10;Tiistai;9;16;25;21;5;26
294;19.04.2016;2016;04;11;Tiistai;11;10;21;16;10;26
294;19.04.2016;2016;04;12;Tiistai;6;19;25;6;15;21
294;19.04.2016;2016;04;13;Tiistai;12;13;25;7;10;17
294;19.04.2016;2016;04;14;Tiistai;13;15;28;13;11;24
294;19.04.2016;2016;04;15;Tiistai;10;21;31;14;13;27
294;19.04.2016;2016;04;16;Tiistai;30;17;47;7;10;17
294;19.04.2016;2016;04;17;Tiistai;17;22;39;14;11;25
294;19.04.2016;2016;04;18;Tiistai;7;9;16;12;15;27
294;19.04.2016;2016;04;19;Tiistai;10;6;16;12;5;17
294;19.04.2016;2016;04;20;Tiistai;2;5;7;3;2;5
294;19.04.2016;2016;04;21;Tiistai;0;1;1;2;0;2
294;19.04.2016;2016;04;22;Tiistai;2;1;3;0;1;1
294;19.04.2016;2016;04;23;Tiistai;0;0;0;1;0;1
294;20.04.2016;2016;04;00;Keskiviikko;0;0;0;1;0;1
294;20.04.2016;2016;04;01;Keskiviikko;0;0;0;0;0;0
294;20.04.2016;2016;04;02;Keskiviikko;0;0;0;0;0;0
294;20.04.2016;2016;04;03;Keskiviikko;0;0;0;0;0;0
294;20.04.2016;2016;04;04;Keskiviikko;0;1;1;0;0;0
294;20.04.2016;2016;04;05;Keskiviikko;1;0;1;1;1;2
294;20.04.2016;2016;04;06;Keskiviikko;3;1;4;2;0;2
294;20.04.2016;2016;04;07;Keskiviikko;8;8;16;5;7;12
294;20.04.2016;2016;04;08;Keskiviikko;12;7;19;8;5;13
294;20.04.2016;2016;04;09;Keskiviikko;11;16;27;4;13;17
294;20.04.2016;2016;04;10;Keskiviikko;8;6;14;7;11;18
294;20.04.2016;2016;04;11;Keskiviikko;11;7;18;8;12;20
294;20.04.2016;2016;04;12;Keskiviikko;8;10;18;8;15;23
294;20.04.2016;2016;04;13;Keskiviikko;9;12;21;7;7;14
294;20.04.2016;2016;04;14;Keskiviikko;11;21;32;11;11;22
294;20.04.2016;2016;04;15;Keskiviikko;21;20;41;10;15;25
294;20.04.2016;2016;04;16;Keskiviikko;16;22;38;15;13;28
294;20.04.2016;2016;04;17;Keskiviikko;17;11;28;12;10;22
294;20.04.2016;2016;04;18;Keskiviikko;11;13;24;17;12;29
294;20.04.2016;2016;04;19;Keskiviikko;11;7;18;12;12;24
294;20.04.2016;2016;04;20;Keskiviikko;6;6;12;8;10;18
294;20.04.2016;2016;04;21;Keskiviikko;5;0;5;0;2;2
294;20.04.2016;2016;04;22;Keskiviikko;0;1;1;1;0;1
294;20.04.2016;2016;04;23;Keskiviikko;0;0;0;0;0;0
294;21.04.2016;2016;04;00;Torstai;0;0;0;0;0;0
294;21.04.2016;2016;04;01;Torstai;0;0;0;0;0;0
294;21.04.2016;2016;04;02;Torstai;0;0;0;0;0;0
294;21.04.2016;2016;04;03;Torstai;0;0;0;0;0;0
294;21.04.2016;2016;04;04;Torstai;0;0;0;0;0;0
294;21.04.2016;2016;04;05;Torstai;1;0;1;1;0;1
294;21.04.2016;2016;04;06;Torstai;1;1;2;3;2;5
294;21.04.2016;2016;04;07;Torstai;9;9;18;2;2;4
294;21.04.2016;2016;04;08;Torstai;15;2;17;11;5;16
294;21.04.2016;2016;04;09;Torstai;14;9;23;9;8;17
294;21.04.2016;2016;04;10;Torstai;3;7;10;13;11;24
294;21.04.2016;2016;04;11;Torstai;8;11;19;16;12;28
294;21.04.2016;2016;04;12;Torstai;8;12;20;7;8;15
294;21.04.2016;2016;04;13;Torstai;14;15;29;15;6;21
294;21.04.2016;2016;04;14;Torstai;15;11;26;7;12;19
294;21.04.2016;2016;04;15;Torstai;16;27;43;13;12;25
294;21.04.2016;2016;04;16;Torstai;20;11;31;13;11;24
294;21.04.2016;2016;04;17;Torstai;22;17;39;13;11;24
294;21.04.2016;2016;04;18;Torstai;10;12;22;6;6;12
294;21.04.2016;2016;04;19;Torstai;10;8;18;14;9;23
294;21.04.2016;2016;04;20;Torstai;4;5;9;5;4;9
294;21.04.2016;2016;04;21;Torstai;0;0;0;1;5;6
294;21.04.2016;2016;04;22;Torstai;1;0;1;0;1;1
294;21.04.2016;2016;04;23;Torstai;1;0;1;0;0;0
294;22.04.2016;2016;04;00;Perjantai;0;0;0;0;0;0
294;22.04.2016;2016;04;01;Perjantai;0;0;0;0;0;0
294;22.04.2016;2016;04;02;Perjantai;0;0;0;0;0;0
294;22.04.2016;2016;04;03;Perjantai;0;0;0;0;0;0
294;22.04.2016;2016;04;04;Perjantai;0;0;0;0;0;0
294;22.04.2016;2016;04;05;Perjantai;1;0;1;0;0;0
294;22.04.2016;2016;04;06;Perjantai;1;3;4;2;1;3
294;22.04.2016;2016;04;07;Perjantai;9;5;14;7;6;13
294;22.04.2016;2016;04;08;Perjantai;6;5;11;6;3;9
294;22.04.2016;2016;04;09;Perjantai;21;11;32;8;6;14
294;22.04.2016;2016;04;10;Perjantai;6;10;16;16;16;32
294;22.04.2016;2016;04;11;Perjantai;9;4;13;24;17;41
294;22.04.2016;2016;04;12;Perjantai;13;13;26;11;16;27
294;22.04.2016;2016;04;13;Perjantai;34;22;56;10;10;20
294;22.04.2016;2016;04;14;Perjantai;14;21;35;15;17;32
294;22.04.2016;2016;04;15;Perjantai;26;29;55;6;16;22
294;22.04.2016;2016;04;16;Perjantai;14;14;28;9;9;18
294;22.04.2016;2016;04;17;Perjantai;22;21;43;7;7;14
294;22.04.2016;2016;04;18;Perjantai;23;17;40;11;13;24
294;22.04.2016;2016;04;19;Perjantai;7;14;21;10;8;18
294;22.04.2016;2016;04;20;Perjantai;5;2;7;9;13;22
294;22.04.2016;2016;04;21;Perjantai;6;6;12;7;3;10
294;22.04.2016;2016;04;22;Perjantai;7;1;8;2;2;4
294;22.04.2016;2016;04;23;Perjantai;2;0;2;4;0;4
294;23.04.2016;2016;04;00;Lauantai;0;1;1;0;0;0
294;23.04.2016;2016;04;01;Lauantai;0;0;0;0;0;0
294;23.04.2016;2016;04;02;Lauantai;0;0;0;0;1;1
294;23.04.2016;2016;04;03;Lauantai;0;0;0;0;0;0
294;23.04.2016;2016;04;04;Lauantai;0;0;0;0;0;0
294;23.04.2016;2016;04;05;Lauantai;0;0;0;0;0;0
294;23.04.2016;2016;04;06;Lauantai;0;2;2;0;1;1
294;23.04.2016;2016;04;07;Lauantai;1;0;1;1;0;1
294;23.04.2016;2016;04;08;Lauantai;1;0;1;5;6;11
294;23.04.2016;2016;04;09;Lauantai;8;7;15;11;3;14
294;23.04.2016;2016;04;10;Lauantai;9;6;15;8;13;21
294;23.04.2016;2016;04;11;Lauantai;18;13;31;7;10;17
294;23.04.2016;2016;04;12;Lauantai;20;13;33;6;5;11
294;23.04.2016;2016;04;13;Lauantai;16;11;27;12;11;23
294;23.04.2016;2016;04;14;Lauantai;9;11;20;6;5;11
294;23.04.2016;2016;04;15;Lauantai;12;14;26;10;5;15
294;23.04.2016;2016;04;16;Lauantai;9;11;20;11;10;21
294;23.04.2016;2016;04;17;Lauantai;25;16;41;14;7;21
294;23.04.2016;2016;04;18;Lauantai;16;11;27;5;8;13
294;23.04.2016;2016;04;19;Lauantai;12;10;22;9;9;18
294;23.04.2016;2016;04;20;Lauantai;10;8;18;3;9;12
294;23.04.2016;2016;04;21;Lauantai;2;1;3;0;2;2
294;23.04.2016;2016;04;22;Lauantai;2;2;4;0;1;1
294;23.04.2016;2016;04;23;Lauantai;2;0;2;0;0;0
294;24.04.2016;2016;04;00;Sunnuntai;0;0;0;0;0;0
294;24.04.2016;2016;04;01;Sunnuntai;0;0;0;0;0;0
294;24.04.2016;2016;04;02;Sunnuntai;0;0;0;0;0;0
294;24.04.2016;2016;04;03;Sunnuntai;0;0;0;0;0;0
294;24.04.2016;2016;04;04;Sunnuntai;0;0;0;1;0;1
294;24.04.2016;2016;04;05;Sunnuntai;1;0;1;0;0;0
294;24.04.2016;2016;04;06;Sunnuntai;0;0;0;1;0;1
294;24.04.2016;2016;04;07;Sunnuntai;2;1;3;3;4;7
294;24.04.2016;2016;04;08;Sunnuntai;5;0;5;5;1;6
294;24.04.2016;2016;04;09;Sunnuntai;6;7;13;10;9;19
294;24.04.2016;2016;04;10;Sunnuntai;12;11;23;8;11;19
294;24.04.2016;2016;04;11;Sunnuntai;15;6;21;10;12;22
294;24.04.2016;2016;04;12;Sunnuntai;19;21;40;8;15;23
294;24.04.2016;2016;04;13;Sunnuntai;13;11;24;12;7;19
294;24.04.2016;2016;04;14;Sunnuntai;10;12;22;16;5;21
294;24.04.2016;2016;04;15;Sunnuntai;20;14;34;6;6;12
294;24.04.2016;2016;04;16;Sunnuntai;14;17;31;3;3;6
294;24.04.2016;2016;04;17;Sunnuntai;18;15;33;11;9;20
294;24.04.2016;2016;04;18;Sunnuntai;21;20;41;13;17;30
294;24.04.2016;2016;04;19;Sunnuntai;18;9;27;10;13;23
294;24.04.2016;2016;04;20;Sunnuntai;1;2;3;6;3;9
294;24.04.2016;2016;04;21;Sunnuntai;1;1;2;0;0;0
294;24.04.2016;2016;04;22;Sunnuntai;1;1;2;0;0;0
294;24.04.2016;2016;04;23;Sunnuntai;1;0;1;0;0;0
294;25.04.2016;2016;04;00;Maanantai;0;0;0;0;0;0
294;25.04.2016;2016;04;01;Maanantai;0;0;0;0;0;0
294;25.04.2016;2016;04;02;Maanantai;0;0;0;0;0;0
294;25.04.2016;2016;04;03;Maanantai;0;0;0;0;0;0
294;25.04.2016;2016;04;04;Maanantai;0;0;0;0;1;1
294;25.04.2016;2016;04;05;Maanantai;1;1;2;0;0;0
294;25.04.2016;2016;04;06;Maanantai;2;6;8;5;1;6
294;25.04.2016;2016;04;07;Maanantai;14;7;21;6;1;7
294;25.04.2016;2016;04;08;Maanantai;17;6;23;13;4;17
294;25.04.2016;2016;04;09;Maanantai;10;8;18;11;10;21
294;25.04.2016;2016;04;10;Maanantai;8;6;14;14;10;24
294;25.04.2016;2016;04;11;Maanantai;3;10;13;12;14;26
294;25.04.2016;2016;04;12;Maanantai;10;11;21;7;11;18
294;25.04.2016;2016;04;13;Maanantai;13;14;27;8;11;19
294;25.04.2016;2016;04;14;Maanantai;19;25;44;4;6;10
294;25.04.2016;2016;04;15;Maanantai;18;12;30;3;1;4
294;25.04.2016;2016;04;16;Maanantai;16;10;26;4;9;13
294;25.04.2016;2016;04;17;Maanantai;4;6;10;6;4;10
294;25.04.2016;2016;04;18;Maanantai;10;7;17;8;4;12
294;25.04.2016;2016;04;19;Maanantai;7;3;10;11;9;20
294;25.04.2016;2016;04;20;Maanantai;1;3;4;9;3;12
294;25.04.2016;2016;04;21;Maanantai;5;1;6;0;2;2
294;25.04.2016;2016;04;22;Maanantai;2;0;2;0;1;1
294;25.04.2016;2016;04;23;Maanantai;0;1;1;1;0;1
294;26.04.2016;2016;04;00;Tiistai;0;0;0;0;0;0
294;26.04.2016;2016;04;01;Tiistai;0;0;0;0;0;0
294;26.04.2016;2016;04;02;Tiistai;0;0;0;0;0;0
294;26.04.2016;2016;04;03;Tiistai;0;0;0;0;0;0
294;26.04.2016;2016;04;04;Tiistai;0;0;0;0;0;0
294;26.04.2016;2016;04;05;Tiistai;1;1;2;1;0;1
294;26.04.2016;2016;04;06;Tiistai;4;1;5;2;0;2
294;26.04.2016;2016;04;07;Tiistai;10;19;29;6;2;8
294;26.04.2016;2016;04;08;Tiistai;8;7;15;9;8;17
294;26.04.2016;2016;04;09;Tiistai;8;11;19;10;4;14
294;26.04.2016;2016;04;10;Tiistai;8;4;12;12;7;19
294;26.04.2016;2016;04;11;Tiistai;7;4;11;17;9;26
294;26.04.2016;2016;04;12;Tiistai;4;13;17;6;13;19
294;26.04.2016;2016;04;13;Tiistai;16;19;35;8;13;21
294;26.04.2016;2016;04;14;Tiistai;14;17;31;19;10;29
294;26.04.2016;2016;04;15;Tiistai;28;21;49;10;12;22
294;26.04.2016;2016;04;16;Tiistai;16;27;43;10;10;20
294;26.04.2016;2016;04;17;Tiistai;13;14;27;10;12;22
294;26.04.2016;2016;04;18;Tiistai;13;9;22;10;11;21
294;26.04.2016;2016;04;19;Tiistai;13;21;34;14;9;23
294;26.04.2016;2016;04;20;Tiistai;10;7;17;5;10;15
294;26.04.2016;2016;04;21;Tiistai;4;0;4;2;2;4
294;26.04.2016;2016;04;22;Tiistai;2;1;3;0;0;0
294;26.04.2016;2016;04;23;Tiistai;0;0;0;0;0;0
294;27.04.2016;2016;04;00;Keskiviikko;0;0;0;0;0;0
294;27.04.2016;2016;04;01;Keskiviikko;0;0;0;0;0;0
294;27.04.2016;2016;04;02;Keskiviikko;0;0;0;0;0;0
294;27.04.2016;2016;04;03;Keskiviikko;0;0;0;0;0;0
294;27.04.2016;2016;04;04;Keskiviikko;0;0;0;0;0;0
294;27.04.2016;2016;04;05;Keskiviikko;1;0;1;0;1;1
294;27.04.2016;2016;04;06;Keskiviikko;1;3;4;0;3;3
294;27.04.2016;2016;04;07;Keskiviikko;10;6;16;4;5;9
294;27.04.2016;2016;04;08;Keskiviikko;11;6;17;8;5;13
294;27.04.2016;2016;04;09;Keskiviikko;11;13;24;7;15;22
294;27.04.2016;2016;04;10;Keskiviikko;4;10;14;17;9;26
294;27.04.2016;2016;04;11;Keskiviikko;16;4;20;13;8;21
294;27.04.2016;2016;04;12;Keskiviikko;7;8;15;8;12;20
294;27.04.2016;2016;04;13;Keskiviikko;10;23;33;21;9;30
294;27.04.2016;2016;04;14;Keskiviikko;11;31;42;8;14;22
294;27.04.2016;2016;04;15;Keskiviikko;26;16;42;5;9;14
294;27.04.2016;2016;04;16;Keskiviikko;23;15;38;12;16;28
294;27.04.2016;2016;04;17;Keskiviikko;18;16;34;13;10;23
294;27.04.2016;2016;04;18;Keskiviikko;10;15;25;18;9;27
294;27.04.2016;2016;04;19;Keskiviikko;8;3;11;15;12;27
294;27.04.2016;2016;04;20;Keskiviikko;1;4;5;5;4;9
294;27.04.2016;2016;04;21;Keskiviikko;3;0;3;2;0;2
294;27.04.2016;2016;04;22;Keskiviikko;2;3;5;0;0;0
294;27.04.2016;2016;04;23;Keskiviikko;0;0;0;0;0;0
294;28.04.2016;2016;04;00;Torstai;0;0;0;0;0;0
294;28.04.2016;2016;04;01;Torstai;0;0;0;0;0;0
294;28.04.2016;2016;04;02;Torstai;0;0;0;0;0;0
294;28.04.2016;2016;04;03;Torstai;0;0;0;0;0;0
294;28.04.2016;2016;04;04;Torstai;0;0;0;0;1;1
294;28.04.2016;2016;04;05;Torstai;1;0;1;1;0;1
294;28.04.2016;2016;04;06;Torstai;3;6;9;3;0;3
294;28.04.2016;2016;04;07;Torstai;11;12;23;9;3;12
294;28.04.2016;2016;04;08;Torstai;18;8;26;5;6;11
294;28.04.2016;2016;04;09;Torstai;11;11;22;14;15;29
294;28.04.2016;2016;04;10;Torstai;6;9;15;14;9;23
294;28.04.2016;2016;04;11;Torstai;10;9;19;17;12;29
294;28.04.2016;2016;04;12;Torstai;8;13;21;13;11;24
294;28.04.2016;2016;04;13;Torstai;17;20;37;18;13;31
294;28.04.2016;2016;04;14;Torstai;26;12;38;13;12;25
294;28.04.2016;2016;04;15;Torstai;12;22;34;7;10;17
294;28.04.2016;2016;04;16;Torstai;13;13;26;14;12;26
294;28.04.2016;2016;04;17;Torstai;19;15;34;15;6;21
294;28.04.2016;2016;04;18;Torstai;25;35;60;11;10;21
294;28.04.2016;2016;04;19;Torstai;26;18;44;14;22;36
294;28.04.2016;2016;04;20;Torstai;13;10;23;6;6;12
294;28.04.2016;2016;04;21;Torstai;5;8;13;2;3;5
294;28.04.2016;2016;04;22;Torstai;2;3;5;0;0;0
294;28.04.2016;2016;04;23;Torstai;2;0;2;0;0;0
294;29.04.2016;2016;04;00;Perjantai;0;0;0;0;1;1
294;29.04.2016;2016;04;01;Perjantai;0;1;1;0;0;0
294;29.04.2016;2016;04;02;Perjantai;0;0;0;0;0;0
294;29.04.2016;2016;04;03;Perjantai;0;0;0;0;0;0
294;29.04.2016;2016;04;04;Perjantai;0;0;0;0;0;0
294;29.04.2016;2016;04;05;Perjantai;0;0;0;0;0;0
294;29.04.2016;2016;04;06;Perjantai;3;3;6;4;0;4
294;29.04.2016;2016;04;07;Perjantai;9;6;15;3;2;5
294;29.04.2016;2016;04;08;Perjantai;16;16;32;12;7;19
294;29.04.2016;2016;04;09;Perjantai;15;7;22;5;6;11
294;29.04.2016;2016;04;10;Perjantai;11;8;19;15;5;20
294;29.04.2016;2016;04;11;Perjantai;21;12;33;13;13;26
294;29.04.2016;2016;04;12;Perjantai;20;33;53;5;7;12
294;29.04.2016;2016;04;13;Perjantai;22;15;37;13;6;19
294;29.04.2016;2016;04;14;Perjantai;16;22;38;12;12;24
294;29.04.2016;2016;04;15;Perjantai;19;22;41;2;6;8
294;29.04.2016;2016;04;16;Perjantai;13;8;21;6;3;9
294;29.04.2016;2016;04;17;Perjantai;6;11;17;4;5;9
294;29.04.2016;2016;04;18;Perjantai;8;11;19;12;7;19
294;29.04.2016;2016;04;19;Perjantai;12;5;17;10;12;22
294;29.04.2016;2016;04;20;Perjantai;8;14;22;10;6;16
294;29.04.2016;2016;04;21;Perjantai;14;8;22;5;2;7
294;29.04.2016;2016;04;22;Perjantai;5;1;6;2;0;2
294;29.04.2016;2016;04;23;Perjantai;4;0;4;2;0;2
294;30.04.2016;2016;04;00;Lauantai;0;2;2;1;0;1
294;30.04.2016;2016;04;01;Lauantai;0;0;0;0;0;0
294;30.04.2016;2016;04;02;Lauantai;0;0;0;0;1;1
294;30.04.2016;2016;04;03;Lauantai;0;0;0;0;0;0
294;30.04.2016;2016;04;04;Lauantai;0;1;1;0;0;0
294;30.04.2016;2016;04;05;Lauantai;0;1;1;0;1;1
294;30.04.2016;2016;04;06;Lauantai;0;0;0;0;0;0
294;30.04.2016;2016;04;07;Lauantai;0;2;2;1;2;3
294;30.04.2016;2016;04;08;Lauantai;1;4;5;3;4;7
294;30.04.2016;2016;04;09;Lauantai;2;10;12;9;3;12
294;30.04.2016;2016;04;10;Lauantai;24;9;33;10;7;17
294;30.04.2016;2016;04;11;Lauantai;14;15;29;12;15;27
294;30.04.2016;2016;04;12;Lauantai;25;22;47;5;10;15
294;30.04.2016;2016;04;13;Lauantai;28;21;49;8;15;23
294;30.04.2016;2016;04;14;Lauantai;28;20;48;15;10;25
294;30.04.2016;2016;04;15;Lauantai;18;23;41;6;12;18
294;30.04.2016;2016;04;16;Lauantai;28;18;46;17;10;27
294;30.04.2016;2016;04;17;Lauantai;25;21;46;5;7;12
294;30.04.2016;2016;04;18;Lauantai;30;25;55;9;10;19
294;30.04.2016;2016;04;19;Lauantai;29;14;43;8;5;13
294;30.04.2016;2016;04;20;Lauantai;18;9;27;0;3;3
294;30.04.2016;2016;04;21;Lauantai;9;10;19;4;1;5
294;30.04.2016;2016;04;22;Lauantai;3;4;7;3;2;5
294;30.04.2016;2016;04;23;Lauantai;2;0;2;2;0;2
294;01.05.2016;2016;05;00;Sunnuntai;4;0;4;0;0;0
294;01.05.2016;2016;05;01;Sunnuntai;0;1;1;0;3;3
294;01.05.2016;2016;05;02;Sunnuntai;0;0;0;0;0;0
294;01.05.2016;2016;05;03;Sunnuntai;0;0;0;0;0;0
294;01.05.2016;2016;05;04;Sunnuntai;0;0;0;0;0;0
294;01.05.2016;2016;05;05;Sunnuntai;0;0;0;0;0;0
294;01.05.2016;2016;05;06;Sunnuntai;0;0;0;4;1;5
294;01.05.2016;2016;05;07;Sunnuntai;0;0;0;0;1;1
294;01.05.2016;2016;05;08;Sunnuntai;6;1;7;6;3;9
294;01.05.2016;2016;05;09;Sunnuntai;9;4;13;4;0;4
294;01.05.2016;2016;05;10;Sunnuntai;20;18;38;5;3;8
294;01.05.2016;2016;05;11;Sunnuntai;17;12;29;5;7;12
294;01.05.2016;2016;05;12;Sunnuntai;25;18;43;8;4;12
294;01.05.2016;2016;05;13;Sunnuntai;36;22;58;16;3;19
294;01.05.2016;2016;05;14;Sunnuntai;18;28;46;13;4;17
294;01.05.2016;2016;05;15;Sunnuntai;31;22;53;6;11;17
294;01.05.2016;2016;05;16;Sunnuntai;18;20;38;11;12;23
294;01.05.2016;2016;05;17;Sunnuntai;25;20;45;18;9;27
294;01.05.2016;2016;05;18;Sunnuntai;11;21;32;23;9;32
294;01.05.2016;2016;05;19;Sunnuntai;27;18;45;8;10;18
294;01.05.2016;2016;05;20;Sunnuntai;16;13;29;8;5;13
294;01.05.2016;2016;05;21;Sunnuntai;4;0;4;2;1;3
294;01.05.2016;2016;05;22;Sunnuntai;3;0;3;0;1;1
294;01.05.2016;2016;05;23;Sunnuntai;0;0;0;0;0;0
294;02.05.2016;2016;05;00;Maanantai;0;0;0;0;0;0
294;02.05.2016;2016;05;01;Maanantai;0;0;0;0;0;0
294;02.05.2016;2016;05;02;Maanantai;0;0;0;0;0;0
294;02.05.2016;2016;05;03;Maanantai;0;0;0;0;0;0
294;02.05.2016;2016;05;04;Maanantai;0;0;0;0;0;0
294;02.05.2016;2016;05;05;Maanantai;2;2;4;0;1;1
294;02.05.2016;2016;05;06;Maanantai;2;1;3;2;1;3
294;02.05.2016;2016;05;07;Maanantai;12;12;24;4;3;7
294;02.05.2016;2016;05;08;Maanantai;17;7;24;4;4;8
294;02.05.2016;2016;05;09;Maanantai;21;12;33;12;4;16
294;02.05.2016;2016;05;10;Maanantai;14;6;20;11;9;20
294;02.05.2016;2016;05;11;Maanantai;17;9;26;12;12;24
294;02.05.2016;2016;05;12;Maanantai;12;10;22;4;5;9
294;02.05.2016;2016;05;13;Maanantai;11;11;22;7;11;18
294;02.05.2016;2016;05;14;Maanantai;13;26;39;8;9;17
294;02.05.2016;2016;05;15;Maanantai;21;17;38;10;9;19
294;02.05.2016;2016;05;16;Maanantai;22;16;38;10;12;22
294;02.05.2016;2016;05;17;Maanantai;33;19;52;14;15;29
294;02.05.2016;2016;05;18;Maanantai;23;25;48;26;30;56
294;02.05.2016;2016;05;19;Maanantai;14;15;29;18;13;31
294;02.05.2016;2016;05;20;Maanantai;9;6;15;9;1;10
294;02.05.2016;2016;05;21;Maanantai;1;1;2;4;3;7
294;02.05.2016;2016;05;22;Maanantai;0;0;0;1;0;1
294;02.05.2016;2016;05;23;Maanantai;1;0;1;0;0;0
294;03.05.2016;2016;05;00;Tiistai;0;0;0;0;0;0
294;03.05.2016;2016;05;01;Tiistai;0;0;0;0;0;0
294;03.05.2016;2016;05;02;Tiistai;0;0;0;1;0;1
294;03.05.2016;2016;05;03;Tiistai;0;0;0;0;0;0
294;03.05.2016;2016;05;04;Tiistai;0;0;0;0;0;0
294;03.05.2016;2016;05;05;Tiistai;1;0;1;0;0;0
294;03.05.2016;2016;05;06;Tiistai;8;3;11;0;2;2
294;03.05.2016;2016;05;07;Tiistai;11;19;30;2;5;7
294;03.05.2016;2016;05;08;Tiistai;11;6;17;10;6;16
294;03.05.2016;2016;05;09;Tiistai;16;7;23;14;6;20
294;03.05.2016;2016;05;10;Tiistai;18;9;27;12;3;15
294;03.05.2016;2016;05;11;Tiistai;21;10;31;7;11;18
294;03.05.2016;2016;05;12;Tiistai;16;21;37;10;6;16
294;03.05.2016;2016;05;13;Tiistai;21;17;38;11;9;20
294;03.05.2016;2016;05;14;Tiistai;22;13;35;5;7;12
294;03.05.2016;2016;05;15;Tiistai;36;41;77;9;9;18
294;03.05.2016;2016;05;16;Tiistai;22;26;48;18;9;27
294;03.05.2016;2016;05;17;Tiistai;30;22;52;7;14;21
294;03.05.2016;2016;05;18;Tiistai;30;28;58;24;16;40
294;03.05.2016;2016;05;19;Tiistai;10;26;36;12;17;29
294;03.05.2016;2016;05;20;Tiistai;10;8;18;9;6;15
294;03.05.2016;2016;05;21;Tiistai;1;2;3;3;6;9
294;03.05.2016;2016;05;22;Tiistai;1;2;3;3;0;3
294;03.05.2016;2016;05;23;Tiistai;2;0;2;0;0;0
294;04.05.2016;2016;05;00;Keskiviikko;0;0;0;0;0;0
294;04.05.2016;2016;05;01;Keskiviikko;0;0;0;0;0;0
294;04.05.2016;2016;05;02;Keskiviikko;0;0;0;0;0;0
294;04.05.2016;2016;05;03;Keskiviikko;0;0;0;0;0;0
294;04.05.2016;2016;05;04;Keskiviikko;0;0;0;0;1;1
294;04.05.2016;2016;05;05;Keskiviikko;1;0;1;2;1;3
294;04.05.2016;2016;05;06;Keskiviikko;5;3;8;1;1;2
294;04.05.2016;2016;05;07;Keskiviikko;24;16;40;5;1;6
294;04.05.2016;2016;05;08;Keskiviikko;17;7;24;8;6;14
294;04.05.2016;2016;05;09;Keskiviikko;12;23;35;4;9;13
294;04.05.2016;2016;05;10;Keskiviikko;16;7;23;15;5;20
294;04.05.2016;2016;05;11;Keskiviikko;20;9;29;14;16;30
294;04.05.2016;2016;05;12;Keskiviikko;12;10;22;8;14;22
294;04.05.2016;2016;05;13;Keskiviikko;18;19;37;18;12;30
294;04.05.2016;2016;05;14;Keskiviikko;27;35;62;18;21;39
294;04.05.2016;2016;05;15;Keskiviikko;42;29;71;19;12;31
294;04.05.2016;2016;05;16;Keskiviikko;27;18;45;11;18;29
294;04.05.2016;2016;05;17;Keskiviikko;28;40;68;17;14;31
294;04.05.2016;2016;05;18;Keskiviikko;25;26;51;14;17;31
294;04.05.2016;2016;05;19;Keskiviikko;38;29;67;15;16;31
294;04.05.2016;2016;05;20;Keskiviikko;20;20;40;19;9;28
294;04.05.2016;2016;05;21;Keskiviikko;3;13;16;0;7;7
294;04.05.2016;2016;05;22;Keskiviikko;6;2;8;2;3;5
294;04.05.2016;2016;05;23;Keskiviikko;1;1;2;0;1;1
294;05.05.2016;2016;05;00;Torstai;1;0;1;0;0;0
294;05.05.2016;2016;05;01;Torstai;0;1;1;0;2;2
294;05.05.2016;2016;05;02;Torstai;0;0;0;1;0;1
294;05.05.2016;2016;05;03;Torstai;3;0;3;1;0;1
294;05.05.2016;2016;05;04;Torstai;0;0;0;0;0;0
294;05.05.2016;2016;05;05;Torstai;0;0;0;0;0;0
294;05.05.2016;2016;05;06;Torstai;1;1;2;0;0;0
294;05.05.2016;2016;05;07;Torstai;1;2;3;1;2;3
294;05.05.2016;2016;05;08;Torstai;3;3;6;6;8;14
294;05.05.2016;2016;05;09;Torstai;9;7;16;4;1;5
294;05.05.2016;2016;05;10;Torstai;25;12;37;10;4;14
294;05.05.2016;2016;05;11;Torstai;22;26;48;12;20;32
294;05.05.2016;2016;05;12;Torstai;35;31;66;14;18;32
294;05.05.2016;2016;05;13;Torstai;27;33;60;5;10;15
294;05.05.2016;2016;05;14;Torstai;43;25;68;10;12;22
294;05.05.2016;2016;05;15;Torstai;15;25;40;10;5;15
294;05.05.2016;2016;05;16;Torstai;32;21;53;6;7;13
294;05.05.2016;2016;05;17;Torstai;36;25;61;12;13;25
294;05.05.2016;2016;05;18;Torstai;22;17;39;5;14;19
294;05.05.2016;2016;05;19;Torstai;11;22;33;7;8;15
294;05.05.2016;2016;05;20;Torstai;12;12;24;8;2;10
294;05.05.2016;2016;05;21;Torstai;9;5;14;2;6;8
294;05.05.2016;2016;05;22;Torstai;3;5;8;3;3;6
294;05.05.2016;2016;05;23;Torstai;2;2;4;0;0;0
294;06.05.2016;2016;05;00;Perjantai;0;0;0;1;0;1
294;06.05.2016;2016;05;01;Perjantai;0;0;0;0;0;0
294;06.05.2016;2016;05;02;Perjantai;2;0;2;0;0;0
294;06.05.2016;2016;05;03;Perjantai;0;0;0;0;0;0
294;06.05.2016;2016;05;04;Perjantai;0;0;0;0;0;0
294;06.05.2016;2016;05;05;Perjantai;0;1;1;0;0;0
294;06.05.2016;2016;05;06;Perjantai;5;2;7;2;0;2
294;06.05.2016;2016;05;07;Perjantai;7;4;11;2;1;3
294;06.05.2016;2016;05;08;Perjantai;3;2;5;1;3;4
294;06.05.2016;2016;05;09;Perjantai;19;7;26;2;1;3
294;06.05.2016;2016;05;10;Perjantai;18;15;33;7;2;9
294;06.05.2016;2016;05;11;Perjantai;28;19;47;3;6;9
294;06.05.2016;2016;05;12;Perjantai;34;15;49;6;5;11
294;06.05.2016;2016;05;13;Perjantai;33;21;54;8;8;16
294;06.05.2016;2016;05;14;Perjantai;16;24;40;9;10;19
294;06.05.2016;2016;05;15;Perjantai;19;18;37;7;10;17
294;06.05.2016;2016;05;16;Perjantai;20;14;34;13;4;17
294;06.05.2016;2016;05;17;Perjantai;13;12;25;15;9;24
294;06.05.2016;2016;05;18;Perjantai;26;39;65;15;18;33
294;06.05.2016;2016;05;19;Perjantai;29;28;57;13;7;20
294;06.05.2016;2016;05;20;Perjantai;13;15;28;5;12;17
294;06.05.2016;2016;05;21;Perjantai;3;4;7;1;2;3
294;06.05.2016;2016;05;22;Perjantai;2;1;3;0;2;2
294;06.05.2016;2016;05;23;Perjantai;3;0;3;0;0;0
294;07.05.2016;2016;05;00;Lauantai;3;0;3;2;0;2
294;07.05.2016;2016;05;01;Lauantai;1;0;1;0;0;0
294;07.05.2016;2016;05;02;Lauantai;0;1;1;0;0;0
294;07.05.2016;2016;05;03;Lauantai;0;0;0;0;0;0
294;07.05.2016;2016;05;04;Lauantai;0;0;0;0;0;0
294;07.05.2016;2016;05;05;Lauantai;0;0;0;0;0;0
294;07.05.2016;2016;05;06;Lauantai;0;1;1;0;2;2
294;07.05.2016;2016;05;07;Lauantai;1;0;1;0;3;3
294;07.05.2016;2016;05;08;Lauantai;4;4;8;7;1;8
294;07.05.2016;2016;05;09;Lauantai;15;6;21;11;2;13
294;07.05.2016;2016;05;10;Lauantai;22;22;44;12;7;19
294;07.05.2016;2016;05;11;Lauantai;19;18;37;2;9;11
294;07.05.2016;2016;05;12;Lauantai;27;20;47;8;12;20
294;07.05.2016;2016;05;13;Lauantai;15;22;37;4;6;10
294;07.05.2016;2016;05;14;Lauantai;21;17;38;3;3;6
294;07.05.2016;2016;05;15;Lauantai;25;33;58;8;13;21
294;07.05.2016;2016;05;16;Lauantai;15;25;40;15;11;26
294;07.05.2016;2016;05;17;Lauantai;34;13;47;9;3;12
294;07.05.2016;2016;05;18;Lauantai;15;20;35;6;5;11
294;07.05.2016;2016;05;19;Lauantai;10;19;29;6;2;8
294;07.05.2016;2016;05;20;Lauantai;9;7;16;2;2;4
294;07.05.2016;2016;05;21;Lauantai;4;2;6;6;3;9
294;07.05.2016;2016;05;22;Lauantai;2;4;6;1;2;3
294;07.05.2016;2016;05;23;Lauantai;1;2;3;0;0;0
294;08.05.2016;2016;05;00;Sunnuntai;0;3;3;0;0;0
294;08.05.2016;2016;05;01;Sunnuntai;1;2;3;1;0;1
294;08.05.2016;2016;05;02;Sunnuntai;1;0;1;0;2;2
294;08.05.2016;2016;05;03;Sunnuntai;0;0;0;0;0;0
294;08.05.2016;2016;05;04;Sunnuntai;0;1;1;0;0;0
294;08.05.2016;2016;05;05;Sunnuntai;0;0;0;0;0;0
294;08.05.2016;2016;05;06;Sunnuntai;1;0;1;0;0;0
294;08.05.2016;2016;05;07;Sunnuntai;7;1;8;2;0;2
294;08.05.2016;2016;05;08;Sunnuntai;0;8;8;1;4;5
294;08.05.2016;2016;05;09;Sunnuntai;2;7;9;10;10;20
294;08.05.2016;2016;05;10;Sunnuntai;19;8;27;14;4;18
294;08.05.2016;2016;05;11;Sunnuntai;19;9;28;8;17;25
294;08.05.2016;2016;05;12;Sunnuntai;21;17;38;10;12;22
294;08.05.2016;2016;05;13;Sunnuntai;34;8;42;4;3;7
294;08.05.2016;2016;05;14;Sunnuntai;20;13;33;4;3;7
294;08.05.2016;2016;05;15;Sunnuntai;13;21;34;10;5;15
294;08.05.2016;2016;05;16;Sunnuntai;12;15;27;8;3;11
294;08.05.2016;2016;05;17;Sunnuntai;19;12;31;10;6;16
294;08.05.2016;2016;05;18;Sunnuntai;16;15;31;5;8;13
294;08.05.2016;2016;05;19;Sunnuntai;22;9;31;11;4;15
294;08.05.2016;2016;05;20;Sunnuntai;6;9;15;14;14;28
294;08.05.2016;2016;05;21;Sunnuntai;2;2;4;4;6;10
294;08.05.2016;2016;05;22;Sunnuntai;1;0;1;1;0;1
294;08.05.2016;2016;05;23;Sunnuntai;0;0;0;0;0;0
294;09.05.2016;2016;05;00;Maanantai;0;0;0;0;0;0
294;09.05.2016;2016;05;01;Maanantai;0;0;0;0;0;0
294;09.05.2016;2016;05;02;Maanantai;0;0;0;0;0;0
294;09.05.2016;2016;05;03;Maanantai;0;0;0;0;0;0
294;09.05.2016;2016;05;04;Maanantai;0;0;0;0;0;0
294;09.05.2016;2016;05;05;Maanantai;1;1;2;1;2;3
294;09.05.2016;2016;05;06;Maanantai;2;4;6;3;3;6
294;09.05.2016;2016;05;07;Maanantai;18;13;31;10;4;14
294;09.05.2016;2016;05;08;Maanantai;15;14;29;3;7;10
294;09.05.2016;2016;05;09;Maanantai;21;14;35;17;12;29
294;09.05.2016;2016;05;10;Maanantai;16;11;27;7;2;9
294;09.05.2016;2016;05;11;Maanantai;10;19;29;8;18;26
294;09.05.2016;2016;05;12;Maanantai;19;16;35;10;11;21
294;09.05.2016;2016;05;13;Maanantai;18;25;43;10;6;16
294;09.05.2016;2016;05;14;Maanantai;32;36;68;19;8;27
294;09.05.2016;2016;05;15;Maanantai;34;34;68;10;11;21
294;09.05.2016;2016;05;16;Maanantai;39;30;69;21;13;34
294;09.05.2016;2016;05;17;Maanantai;19;19;38;6;19;25
294;09.05.2016;2016;05;18;Maanantai;19;29;48;15;14;29
294;09.05.2016;2016;05;19;Maanantai;26;19;45;16;9;25
294;09.05.2016;2016;05;20;Maanantai;9;9;18;3;9;12
294;09.05.2016;2016;05;21;Maanantai;1;0;1;7;0;7
294;09.05.2016;2016;05;22;Maanantai;0;1;1;1;0;1
294;09.05.2016;2016;05;23;Maanantai;0;0;0;0;0;0
294;10.05.2016;2016;05;00;Tiistai;0;0;0;0;0;0
294;10.05.2016;2016;05;01;Tiistai;0;0;0;0;0;0
294;10.05.2016;2016;05;02;Tiistai;0;0;0;0;0;0
294;10.05.2016;2016;05;03;Tiistai;0;0;0;0;0;0
294;10.05.2016;2016;05;04;Tiistai;0;0;0;0;1;1
294;10.05.2016;2016;05;05;Tiistai;1;0;1;2;0;2
294;10.05.2016;2016;05;06;Tiistai;2;2;4;0;0;0
294;10.05.2016;2016;05;07;Tiistai;8;3;11;2;3;5
294;10.05.2016;2016;05;08;Tiistai;6;6;12;3;2;5
294;10.05.2016;2016;05;09;Tiistai;7;3;10;7;2;9
294;10.05.2016;2016;05;10;Tiistai;5;3;8;8;5;13
294;10.05.2016;2016;05;11;Tiistai;9;10;19;4;11;15
294;10.05.2016;2016;05;12;Tiistai;4;6;10;5;9;14
294;10.05.2016;2016;05;13;Tiistai;4;6;10;11;9;20
294;10.05.2016;2016;05;14;Tiistai;14;5;19;12;8;20
294;10.05.2016;2016;05;15;Tiistai;13;29;42;8;15;23
294;10.05.2016;2016;05;16;Tiistai;17;5;22;6;7;13
294;10.05.2016;2016;05;17;Tiistai;24;14;38;9;9;18
294;10.05.2016;2016;05;18;Tiistai;11;5;16;5;6;11
294;10.05.2016;2016;05;19;Tiistai;10;9;19;7;8;15
294;10.05.2016;2016;05;20;Tiistai;5;3;8;5;2;7
294;10.05.2016;2016;05;21;Tiistai;4;2;6;3;5;8
294;10.05.2016;2016;05;22;Tiistai;2;3;5;0;2;2
294;10.05.2016;2016;05;23;Tiistai;0;0;0;0;0;0
294;11.05.2016;2016;05;00;Keskiviikko;0;1;1;0;0;0
294;11.05.2016;2016;05;01;Keskiviikko;0;0;0;0;0;0
294;11.05.2016;2016;05;02;Keskiviikko;0;0;0;0;0;0
294;11.05.2016;2016;05;03;Keskiviikko;0;0;0;0;0;0
294;11.05.2016;2016;05;04;Keskiviikko;0;0;0;0;1;1
294;11.05.2016;2016;05;05;Keskiviikko;0;0;0;2;0;2
294;11.05.2016;2016;05;06;Keskiviikko;3;4;7;5;1;6
294;11.05.2016;2016;05;07;Keskiviikko;21;12;33;5;2;7
294;11.05.2016;2016;05;08;Keskiviikko;13;12;25;7;8;15
294;11.05.2016;2016;05;09;Keskiviikko;10;18;28;7;8;15
294;11.05.2016;2016;05;10;Keskiviikko;17;11;28;4;4;8
294;11.05.2016;2016;05;11;Keskiviikko;11;13;24;13;15;28
294;11.05.2016;2016;05;12;Keskiviikko;17;12;29;9;12;21
294;11.05.2016;2016;05;13;Keskiviikko;18;14;32;13;17;30
294;11.05.2016;2016;05;14;Keskiviikko;20;16;36;12;9;21
294;11.05.2016;2016;05;15;Keskiviikko;24;27;51;6;8;14
294;11.05.2016;2016;05;16;Keskiviikko;22;22;44;11;11;22
294;11.05.2016;2016;05;17;Keskiviikko;25;26;51;6;14;20
294;11.05.2016;2016;05;18;Keskiviikko;21;27;48;21;13;34
294;11.05.2016;2016;05;19;Keskiviikko;21;19;40;18;14;32
294;11.05.2016;2016;05;20;Keskiviikko;12;6;18;4;2;6
294;11.05.2016;2016;05;21;Keskiviikko;3;0;3;0;0;0
294;11.05.2016;2016;05;22;Keskiviikko;1;0;1;0;1;1
294;11.05.2016;2016;05;23;Keskiviikko;0;0;0;0;0;0
294;12.05.2016;2016;05;00;Torstai;0;1;1;0;0;0
294;12.05.2016;2016;05;01;Torstai;0;0;0;0;0;0
294;12.05.2016;2016;05;02;Torstai;0;0;0;0;0;0
294;12.05.2016;2016;05;03;Torstai;0;0;0;0;0;0
294;12.05.2016;2016;05;04;Torstai;0;0;0;0;0;0
294;12.05.2016;2016;05;05;Torstai;2;2;4;1;0;1
294;12.05.2016;2016;05;06;Torstai;1;4;5;2;1;3
294;12.05.2016;2016;05;07;Torstai;15;10;25;3;1;4
294;12.05.2016;2016;05;08;Torstai;20;7;27;9;11;20
294;12.05.2016;2016;05;09;Torstai;10;12;22;11;17;28
294;12.05.2016;2016;05;10;Torstai;12;7;19;17;4;21
294;12.05.2016;2016;05;11;Torstai;11;12;23;11;11;22
294;12.05.2016;2016;05;12;Torstai;16;16;32;8;7;15
294;12.05.2016;2016;05;13;Torstai;30;20;50;8;4;12
294;12.05.2016;2016;05;14;Torstai;25;21;46;16;20;36
294;12.05.2016;2016;05;15;Torstai;29;35;64;4;7;11
294;12.05.2016;2016;05;16;Torstai;27;18;45;13;14;27
294;12.05.2016;2016;05;17;Torstai;24;17;41;9;10;19
294;12.05.2016;2016;05;18;Torstai;34;26;60;7;19;26
294;12.05.2016;2016;05;19;Torstai;35;30;65;13;9;22
294;12.05.2016;2016;05;20;Torstai;17;6;23;4;10;14
294;12.05.2016;2016;05;21;Torstai;5;0;5;2;2;4
294;12.05.2016;2016;05;22;Torstai;0;1;1;0;0;0
294;12.05.2016;2016;05;23;Torstai;0;0;0;0;0;0
294;13.05.2016;2016;05;00;Perjantai;0;0;0;0;0;0
294;13.05.2016;2016;05;01;Perjantai;0;0;0;0;0;0
294;13.05.2016;2016;05;02;Perjantai;0;0;0;0;0;0
294;13.05.2016;2016;05;03;Perjantai;0;0;0;0;0;0
294;13.05.2016;2016;05;04;Perjantai;0;0;0;0;1;1
294;13.05.2016;2016;05;05;Perjantai;1;0;1;2;0;2
294;13.05.2016;2016;05;06;Perjantai;1;4;5;2;4;6
294;13.05.2016;2016;05;07;Perjantai;23;11;34;1;4;5
294;13.05.2016;2016;05;08;Perjantai;9;6;15;8;4;12
294;13.05.2016;2016;05;09;Perjantai;22;8;30;8;5;13
294;13.05.2016;2016;05;10;Perjantai;14;9;23;12;7;19
294;13.05.2016;2016;05;11;Perjantai;12;10;22;13;17;30
294;13.05.2016;2016;05;12;Perjantai;20;20;40;7;17;24
294;13.05.2016;2016;05;13;Perjantai;28;22;50;11;7;18
294;13.05.2016;2016;05;14;Perjantai;27;36;63;6;14;20
294;13.05.2016;2016;05;15;Perjantai;31;23;54;9;10;19
294;13.05.2016;2016;05;16;Perjantai;26;25;51;6;17;23
294;13.05.2016;2016;05;17;Perjantai;17;20;37;11;9;20
294;13.05.2016;2016;05;18;Perjantai;20;15;35;9;11;20
294;13.05.2016;2016;05;19;Perjantai;25;24;49;8;5;13
294;13.05.2016;2016;05;20;Perjantai;13;17;30;7;7;14
294;13.05.2016;2016;05;21;Perjantai;5;3;8;6;2;8
294;13.05.2016;2016;05;22;Perjantai;4;1;5;2;2;4
294;13.05.2016;2016;05;23;Perjantai;0;0;0;0;0;0
294;14.05.2016;2016;05;00;Lauantai;0;0;0;0;0;0
294;14.05.2016;2016;05;01;Lauantai;0;0;0;0;0;0
294;14.05.2016;2016;05;02;Lauantai;0;0;0;0;0;0
294;14.05.2016;2016;05;03;Lauantai;0;0;0;0;0;0
294;14.05.2016;2016;05;04;Lauantai;0;0;0;0;0;0
294;14.05.2016;2016;05;05;Lauantai;0;1;1;0;0;0
294;14.05.2016;2016;05;06;Lauantai;0;2;2;1;2;3
294;14.05.2016;2016;05;07;Lauantai;2;1;3;6;1;7
294;14.05.2016;2016;05;08;Lauantai;4;2;6;7;3;10
294;14.05.2016;2016;05;09;Lauantai;9;9;18;6;2;8
294;14.05.2016;2016;05;10;Lauantai;13;10;23;12;7;19
294;14.05.2016;2016;05;11;Lauantai;18;15;33;8;14;22
294;14.05.2016;2016;05;12;Lauantai;17;22;39;7;6;13
294;14.05.2016;2016;05;13;Lauantai;25;15;40;7;7;14
294;14.05.2016;2016;05;14;Lauantai;13;12;25;4;3;7
294;14.05.2016;2016;05;15;Lauantai;18;9;27;7;5;12
294;14.05.2016;2016;05;16;Lauantai;12;11;23;7;2;9
294;14.05.2016;2016;05;17;Lauantai;24;16;40;12;5;17
294;14.05.2016;2016;05;18;Lauantai;17;33;50;15;17;32
294;14.05.2016;2016;05;19;Lauantai;20;20;40;10;9;19
294;14.05.2016;2016;05;20;Lauantai;8;9;17;2;4;6
294;14.05.2016;2016;05;21;Lauantai;4;5;9;4;2;6
294;14.05.2016;2016;05;22;Lauantai;1;0;1;1;2;3
294;14.05.2016;2016;05;23;Lauantai;0;0;0;2;0;2
294;15.05.2016;2016;05;00;Sunnuntai;2;0;2;0;0;0
294;15.05.2016;2016;05;01;Sunnuntai;0;1;1;1;0;1
294;15.05.2016;2016;05;02;Sunnuntai;0;1;1;1;1;2
294;15.05.2016;2016;05;03;Sunnuntai;0;0;0;0;0;0
294;15.05.2016;2016;05;04;Sunnuntai;0;0;0;0;0;0
294;15.05.2016;2016;05;05;Sunnuntai;0;0;0;0;1;1
294;15.05.2016;2016;05;06;Sunnuntai;0;0;0;0;0;0
294;15.05.2016;2016;05;07;Sunnuntai;0;0;0;1;1;2
294;15.05.2016;2016;05;08;Sunnuntai;1;0;1;3;1;4
294;15.05.2016;2016;05;09;Sunnuntai;9;2;11;11;8;19
294;15.05.2016;2016;05;10;Sunnuntai;8;5;13;10;5;15
294;15.05.2016;2016;05;11;Sunnuntai;15;15;30;10;9;19
294;15.05.2016;2016;05;12;Sunnuntai;22;19;41;14;10;24
294;15.05.2016;2016;05;13;Sunnuntai;5;19;24;5;11;16
294;15.05.2016;2016;05;14;Sunnuntai;8;10;18;6;6;12
294;15.05.2016;2016;05;15;Sunnuntai;9;12;21;4;4;8
294;15.05.2016;2016;05;16;Sunnuntai;16;11;27;3;4;7
294;15.05.2016;2016;05;17;Sunnuntai;6;7;13;2;6;8
294;15.05.2016;2016;05;18;Sunnuntai;26;15;41;7;4;11
294;15.05.2016;2016;05;19;Sunnuntai;6;3;9;8;7;15
294;15.05.2016;2016;05;20;Sunnuntai;2;4;6;3;3;6
294;15.05.2016;2016;05;21;Sunnuntai;0;0;0;1;2;3
294;15.05.2016;2016;05;22;Sunnuntai;2;2;4;0;0;0
294;15.05.2016;2016;05;23;Sunnuntai;0;0;0;0;0;0
294;16.05.2016;2016;05;00;Maanantai;0;0;0;0;0;0
294;16.05.2016;2016;05;01;Maanantai;0;0;0;0;0;0
294;16.05.2016;2016;05;02;Maanantai;0;0;0;0;0;0
294;16.05.2016;2016;05;03;Maanantai;0;0;0;0;0;0
294;16.05.2016;2016;05;04;Maanantai;0;0;0;0;1;1
294;16.05.2016;2016;05;05;Maanantai;0;0;0;1;1;2
294;16.05.2016;2016;05;06;Maanantai;4;4;8;1;3;4
294;16.05.2016;2016;05;07;Maanantai;20;6;26;9;3;12
294;16.05.2016;2016;05;08;Maanantai;16;5;21;6;4;10
294;16.05.2016;2016;05;09;Maanantai;18;11;29;11;7;18
294;16.05.2016;2016;05;10;Maanantai;18;14;32;10;15;25
294;16.05.2016;2016;05;11;Maanantai;25;22;47;9;13;22
294;16.05.2016;2016;05;12;Maanantai;12;15;27;6;9;15
294;16.05.2016;2016;05;13;Maanantai;24;16;40;11;9;20
294;16.05.2016;2016;05;14;Maanantai;15;27;42;8;13;21
294;16.05.2016;2016;05;15;Maanantai;26;22;48;9;7;16
294;16.05.2016;2016;05;16;Maanantai;17;18;35;11;9;20
294;16.05.2016;2016;05;17;Maanantai;36;23;59;12;16;28
294;16.05.2016;2016;05;18;Maanantai;26;25;51;17;20;37
294;16.05.2016;2016;05;19;Maanantai;26;27;53;14;9;23
294;16.05.2016;2016;05;20;Maanantai;13;10;23;12;8;20
294;16.05.2016;2016;05;21;Maanantai;2;7;9;4;3;7
294;16.05.2016;2016;05;22;Maanantai;1;1;2;5;0;5
294;16.05.2016;2016;05;23;Maanantai;1;0;1;0;0;0
294;17.05.2016;2016;05;00;Tiistai;1;0;1;0;2;2
294;17.05.2016;2016;05;01;Tiistai;0;0;0;0;0;0
294;17.05.2016;2016;05;02;Tiistai;0;0;0;0;0;0
294;17.05.2016;2016;05;03;Tiistai;0;0;0;0;0;0
294;17.05.2016;2016;05;04;Tiistai;0;0;0;0;1;1
294;17.05.2016;2016;05;05;Tiistai;0;0;0;0;0;0
294;17.05.2016;2016;05;06;Tiistai;4;1;5;2;0;2
294;17.05.2016;2016;05;07;Tiistai;7;9;16;7;2;9
294;17.05.2016;2016;05;08;Tiistai;9;7;16;6;1;7
294;17.05.2016;2016;05;09;Tiistai;13;5;18;4;5;9
294;17.05.2016;2016;05;10;Tiistai;1;5;6;3;9;12
294;17.05.2016;2016;05;11;Tiistai;11;7;18;8;8;16
294;17.05.2016;2016;05;12;Tiistai;5;13;18;4;9;13
294;17.05.2016;2016;05;13;Tiistai;5;7;12;11;12;23
294;17.05.2016;2016;05;14;Tiistai;9;3;12;8;8;16
294;17.05.2016;2016;05;15;Tiistai;10;22;32;8;9;17
294;17.05.2016;2016;05;16;Tiistai;7;12;19;6;10;16
294;17.05.2016;2016;05;17;Tiistai;13;12;25;10;12;22
294;17.05.2016;2016;05;18;Tiistai;14;14;28;17;14;31
294;17.05.2016;2016;05;19;Tiistai;16;11;27;11;10;21
294;17.05.2016;2016;05;20;Tiistai;0;4;4;3;6;9
294;17.05.2016;2016;05;21;Tiistai;5;0;5;0;0;0
294;17.05.2016;2016;05;22;Tiistai;2;0;2;1;1;2
294;17.05.2016;2016;05;23;Tiistai;1;0;1;0;0;0
294;18.05.2016;2016;05;00;Keskiviikko;0;0;0;0;0;0
294;18.05.2016;2016;05;01;Keskiviikko;0;0;0;0;0;0
294;18.05.2016;2016;05;02;Keskiviikko;0;0;0;0;0;0
294;18.05.2016;2016;05;03;Keskiviikko;0;0;0;0;0;0
294;18.05.2016;2016;05;04;Keskiviikko;0;0;0;0;1;1
294;18.05.2016;2016;05;05;Keskiviikko;1;0;1;0;2;2
294;18.05.2016;2016;05;06;Keskiviikko;4;5;9;3;0;3
294;18.05.2016;2016;05;07;Keskiviikko;25;13;38;5;2;7
294;18.05.2016;2016;05;08;Keskiviikko;24;13;37;5;4;9
294;18.05.2016;2016;05;09;Keskiviikko;31;13;44;8;9;17
294;18.05.2016;2016;05;10;Keskiviikko;11;10;21;7;4;11
294;18.05.2016;2016;05;11;Keskiviikko;16;14;30;12;10;22
294;18.05.2016;2016;05;12;Keskiviikko;10;9;19;4;5;9
294;18.05.2016;2016;05;13;Keskiviikko;19;13;32;8;5;13
294;18.05.2016;2016;05;14;Keskiviikko;15;24;39;9;13;22
294;18.05.2016;2016;05;15;Keskiviikko;20;15;35;2;7;9
294;18.05.2016;2016;05;16;Keskiviikko;18;17;35;5;2;7
294;18.05.2016;2016;05;17;Keskiviikko;3;8;11;2;2;4
294;18.05.2016;2016;05;18;Keskiviikko;4;5;9;4;7;11
294;18.05.2016;2016;05;19;Keskiviikko;3;3;6;4;6;10
294;18.05.2016;2016;05;20;Keskiviikko;1;2;3;7;5;12
294;18.05.2016;2016;05;21;Keskiviikko;0;0;0;1;1;2
294;18.05.2016;2016;05;22;Keskiviikko;0;0;0;0;0;0
294;18.05.2016;2016;05;23;Keskiviikko;0;0;0;0;0;0
294;19.05.2016;2016;05;00;Torstai;0;0;0;0;0;0
294;19.05.2016;2016;05;01;Torstai;0;0;0;0;0;0
294;19.05.2016;2016;05;02;Torstai;0;0;0;0;0;0
294;19.05.2016;2016;05;03;Torstai;0;0;0;0;0;0
294;19.05.2016;2016;05;04;Torstai;0;0;0;0;1;1
294;19.05.2016;2016;05;05;Torstai;1;0;1;0;1;1
294;19.05.2016;2016;05;06;Torstai;2;3;5;0;0;0
294;19.05.2016;2016;05;07;Torstai;5;4;9;6;1;7
294;19.05.2016;2016;05;08;Torstai;13;6;19;13;5;18
294;19.05.2016;2016;05;09;Torstai;7;6;13;8;10;18
294;19.05.2016;2016;05;10;Torstai;7;4;11;1;8;9
294;19.05.2016;2016;05;11;Torstai;6;6;12;10;7;17
294;19.05.2016;2016;05;12;Torstai;4;12;16;12;7;19
294;19.05.2016;2016;05;13;Torstai;22;16;38;14;8;22
294;19.05.2016;2016;05;14;Torstai;16;15;31;13;14;27
294;19.05.2016;2016;05;15;Torstai;21;24;45;9;11;20
294;19.05.2016;2016;05;16;Torstai;22;19;41;8;9;17
294;19.05.2016;2016;05;17;Torstai;14;10;24;3;3;6
294;19.05.2016;2016;05;18;Torstai;7;8;15;8;9;17
294;19.05.2016;2016;05;19;Torstai;15;10;25;13;5;18
294;19.05.2016;2016;05;20;Torstai;6;3;9;4;2;6
294;19.05.2016;2016;05;21;Torstai;1;2;3;0;1;1
294;19.05.2016;2016;05;22;Torstai;0;0;0;0;1;1
294;19.05.2016;2016;05;23;Torstai;0;2;2;0;0;0
294;20.05.2016;2016;05;00;Perjantai;1;0;1;0;0;0
294;20.05.2016;2016;05;01;Perjantai;0;0;0;0;0;0
294;20.05.2016;2016;05;02;Perjantai;0;0;0;0;0;0
294;20.05.2016;2016;05;03;Perjantai;0;0;0;0;0;0
294;20.05.2016;2016;05;04;Perjantai;0;0;0;0;1;1
294;20.05.2016;2016;05;05;Perjantai;1;0;1;0;0;0
294;20.05.2016;2016;05;06;Perjantai;4;3;7;4;0;4
294;20.05.2016;2016;05;07;Perjantai;13;7;20;8;4;12
294;20.05.2016;2016;05;08;Perjantai;12;11;23;4;1;5
294;20.05.2016;2016;05;09;Perjantai;21;13;34;10;6;16
294;20.05.2016;2016;05;10;Perjantai;24;29;53;13;14;27
294;20.05.2016;2016;05;11;Perjantai;18;20;38;12;13;25
294;20.05.2016;2016;05;12;Perjantai;21;19;40;10;7;17
294;20.05.2016;2016;05;13;Perjantai;60;30;90;24;7;31
294;20.05.2016;2016;05;14;Perjantai;28;53;81;6;24;30
294;20.05.2016;2016;05;15;Perjantai;37;34;71;23;13;36
294;20.05.2016;2016;05;16;Perjantai;38;38;76;7;9;16
294;20.05.2016;2016;05;17;Perjantai;26;30;56;16;20;36
294;20.05.2016;2016;05;18;Perjantai;23;33;56;7;12;19
294;20.05.2016;2016;05;19;Perjantai;33;37;70;11;17;28
294;20.05.2016;2016;05;20;Perjantai;14;20;34;9;12;21
294;20.05.2016;2016;05;21;Perjantai;12;4;16;9;1;10
294;20.05.2016;2016;05;22;Perjantai;2;2;4;1;0;1
294;20.05.2016;2016;05;23;Perjantai;2;1;3;0;0;0
294;21.05.2016;2016;05;00;Lauantai;0;0;0;1;0;1
294;21.05.2016;2016;05;01;Lauantai;0;0;0;0;1;1
294;21.05.2016;2016;05;02;Lauantai;0;1;1;0;0;0
294;21.05.2016;2016;05;03;Lauantai;0;0;0;0;2;2
294;21.05.2016;2016;05;04;Lauantai;0;0;0;0;0;0
294;21.05.2016;2016;05;05;Lauantai;0;0;0;0;1;1
294;21.05.2016;2016;05;06;Lauantai;0;0;0;1;0;1
294;21.05.2016;2016;05;07;Lauantai;2;2;4;2;0;2
294;21.05.2016;2016;05;08;Lauantai;6;3;9;6;5;11
294;21.05.2016;2016;05;09;Lauantai;19;12;31;6;4;10
294;21.05.2016;2016;05;10;Lauantai;20;12;32;10;11;21
294;21.05.2016;2016;05;11;Lauantai;31;21;52;8;4;12
294;21.05.2016;2016;05;12;Lauantai;25;20;45;8;12;20
294;21.05.2016;2016;05;13;Lauantai;28;16;44;11;10;21
294;21.05.2016;2016;05;14;Lauantai;17;19;36;8;4;12
294;21.05.2016;2016;05;15;Lauantai;13;11;24;10;8;18
294;21.05.2016;2016;05;16;Lauantai;13;20;33;4;9;13
294;21.05.2016;2016;05;17;Lauantai;14;12;26;12;6;18
294;21.05.2016;2016;05;18;Lauantai;16;11;27;5;9;14
294;21.05.2016;2016;05;19;Lauantai;16;18;34;12;12;24
294;21.05.2016;2016;05;20;Lauantai;11;16;27;14;15;29
294;21.05.2016;2016;05;21;Lauantai;5;9;14;1;2;3
294;21.05.2016;2016;05;22;Lauantai;3;0;3;1;0;1
294;21.05.2016;2016;05;23;Lauantai;1;0;1;0;0;0
294;22.05.2016;2016;05;00;Sunnuntai;0;0;0;0;0;0
294;22.05.2016;2016;05;01;Sunnuntai;1;0;1;0;1;1
294;22.05.2016;2016;05;02;Sunnuntai;0;0;0;0;2;2
294;22.05.2016;2016;05;03;Sunnuntai;0;0;0;0;0;0
294;22.05.2016;2016;05;04;Sunnuntai;0;0;0;0;0;0
294;22.05.2016;2016;05;05;Sunnuntai;0;0;0;0;1;1
294;22.05.2016;2016;05;06;Sunnuntai;0;0;0;0;0;0
294;22.05.2016;2016;05;07;Sunnuntai;0;0;0;1;0;1
294;22.05.2016;2016;05;08;Sunnuntai;0;0;0;1;2;3
294;22.05.2016;2016;05;09;Sunnuntai;3;2;5;1;2;3
294;22.05.2016;2016;05;10;Sunnuntai;3;10;13;10;9;19
294;22.05.2016;2016;05;11;Sunnuntai;16;12;28;7;8;15
294;22.05.2016;2016;05;12;Sunnuntai;13;13;26;10;9;19
294;22.05.2016;2016;05;13;Sunnuntai;27;17;44;7;10;17
294;22.05.2016;2016;05;14;Sunnuntai;29;17;46;11;13;24
294;22.05.2016;2016;05;15;Sunnuntai;16;38;54;10;10;20
294;22.05.2016;2016;05;16;Sunnuntai;24;18;42;8;4;12
294;22.05.2016;2016;05;17;Sunnuntai;31;20;51;7;4;11
294;22.05.2016;2016;05;18;Sunnuntai;29;20;49;15;16;31
294;22.05.2016;2016;05;19;Sunnuntai;17;21;38;19;14;33
294;22.05.2016;2016;05;20;Sunnuntai;15;14;29;4;7;11
294;22.05.2016;2016;05;21;Sunnuntai;3;3;6;2;2;4
294;22.05.2016;2016;05;22;Sunnuntai;2;0;2;1;0;1
294;22.05.2016;2016;05;23;Sunnuntai;0;0;0;0;0;0
294;23.05.2016;2016;05;00;Maanantai;0;0;0;0;0;0
294;23.05.2016;2016;05;01;Maanantai;0;0;0;0;0;0
294;23.05.2016;2016;05;02;Maanantai;0;0;0;0;0;0
294;23.05.2016;2016;05;03;Maanantai;0;0;0;0;0;0
294;23.05.2016;2016;05;04;Maanantai;0;0;0;0;0;0
294;23.05.2016;2016;05;05;Maanantai;2;0;2;1;0;1
294;23.05.2016;2016;05;06;Maanantai;5;5;10;1;4;5
294;23.05.2016;2016;05;07;Maanantai;18;8;26;4;4;8
294;23.05.2016;2016;05;08;Maanantai;18;12;30;7;9;16
294;23.05.2016;2016;05;09;Maanantai;20;9;29;16;9;25
294;23.05.2016;2016;05;10;Maanantai;13;9;22;15;7;22
294;23.05.2016;2016;05;11;Maanantai;15;15;30;8;10;18
294;23.05.2016;2016;05;12;Maanantai;14;15;29;9;12;21
294;23.05.2016;2016;05;13;Maanantai;22;23;45;11;8;19
294;23.05.2016;2016;05;14;Maanantai;21;34;55;16;5;21
294;23.05.2016;2016;05;15;Maanantai;41;41;82;14;10;24
294;23.05.2016;2016;05;16;Maanantai;31;36;67;12;16;28
294;23.05.2016;2016;05;17;Maanantai;31;32;63;15;12;27
294;23.05.2016;2016;05;18;Maanantai;35;45;80;13;11;24
294;23.05.2016;2016;05;19;Maanantai;23;19;42;15;11;26
294;23.05.2016;2016;05;20;Maanantai;6;9;15;8;5;13
294;23.05.2016;2016;05;21;Maanantai;7;7;14;7;4;11
294;23.05.2016;2016;05;22;Maanantai;5;0;5;2;0;2
294;23.05.2016;2016;05;23;Maanantai;1;0;1;1;0;1
294;24.05.2016;2016;05;00;Tiistai;0;0;0;0;0;0
294;24.05.2016;2016;05;01;Tiistai;0;0;0;0;0;0
294;24.05.2016;2016;05;02;Tiistai;0;0;0;0;0;0
294;24.05.2016;2016;05;03;Tiistai;0;0;0;0;0;0
294;24.05.2016;2016;05;04;Tiistai;1;0;1;0;0;0
294;24.05.2016;2016;05;05;Tiistai;0;1;1;0;0;0
294;24.05.2016;2016;05;06;Tiistai;2;7;9;4;1;5
294;24.05.2016;2016;05;07;Tiistai;17;8;25;7;2;9
294;24.05.2016;2016;05;08;Tiistai;21;9;30;4;2;6
294;24.05.2016;2016;05;09;Tiistai;16;12;28;6;12;18
294;24.05.2016;2016;05;10;Tiistai;9;8;17;3;6;9
294;24.05.2016;2016;05;11;Tiistai;8;8;16;10;9;19
294;24.05.2016;2016;05;12;Tiistai;20;20;40;6;13;19
294;24.05.2016;2016;05;13;Tiistai;24;9;33;11;8;19
294;24.05.2016;2016;05;14;Tiistai;33;19;52;14;7;21
294;24.05.2016;2016;05;15;Tiistai;18;54;72;10;14;24
294;24.05.2016;2016;05;16;Tiistai;20;19;39;2;8;10
294;24.05.2016;2016;05;17;Tiistai;14;4;18;3;2;5
294;24.05.2016;2016;05;18;Tiistai;6;12;18;7;6;13
294;24.05.2016;2016;05;19;Tiistai;7;3;10;8;6;14
294;24.05.2016;2016;05;20;Tiistai;4;4;8;5;5;10
294;24.05.2016;2016;05;21;Tiistai;3;0;3;2;0;2
294;24.05.2016;2016;05;22;Tiistai;2;0;2;2;1;3
294;24.05.2016;2016;05;23;Tiistai;0;0;0;0;3;3
294;25.05.2016;2016;05;00;Keskiviikko;0;0;0;0;0;0
294;25.05.2016;2016;05;01;Keskiviikko;0;0;0;0;0;0
294;25.05.2016;2016;05;02;Keskiviikko;0;0;0;0;0;0
294;25.05.2016;2016;05;03;Keskiviikko;0;0;0;1;0;1
294;25.05.2016;2016;05;04;Keskiviikko;0;0;0;0;0;0
294;25.05.2016;2016;05;05;Keskiviikko;0;0;0;0;2;2
294;25.05.2016;2016;05;06;Keskiviikko;1;4;5;1;2;3
294;25.05.2016;2016;05;07;Keskiviikko;17;8;25;5;2;7
294;25.05.2016;2016;05;08;Keskiviikko;8;7;15;8;3;11
294;25.05.2016;2016;05;09;Keskiviikko;11;14;25;7;7;14
294;25.05.2016;2016;05;10;Keskiviikko;14;12;26;3;13;16
294;25.05.2016;2016;05;11;Keskiviikko;21;18;39;7;4;11
294;25.05.2016;2016;05;12;Keskiviikko;24;17;41;11;8;19
294;25.05.2016;2016;05;13;Keskiviikko;17;19;36;8;17;25
294;25.05.2016;2016;05;14;Keskiviikko;14;15;29;6;6;12
294;25.05.2016;2016;05;15;Keskiviikko;17;12;29;5;13;18
294;25.05.2016;2016;05;16;Keskiviikko;14;6;20;5;1;6
294;25.05.2016;2016;05;17;Keskiviikko;7;12;19;10;9;19
294;25.05.2016;2016;05;18;Keskiviikko;8;11;19;6;10;16
294;25.05.2016;2016;05;19;Keskiviikko;18;6;24;8;10;18
294;25.05.2016;2016;05;20;Keskiviikko;5;3;8;5;5;10
294;25.05.2016;2016;05;21;Keskiviikko;0;3;3;3;0;3
294;25.05.2016;2016;05;22;Keskiviikko;1;1;2;2;1;3
294;25.05.2016;2016;05;23;Keskiviikko;0;0;0;0;1;1
294;26.05.2016;2016;05;00;Torstai;0;0;0;0;0;0
294;26.05.2016;2016;05;01;Torstai;0;0;0;0;0;0
294;26.05.2016;2016;05;02;Torstai;0;0;0;0;0;0
294;26.05.2016;2016;05;03;Torstai;0;0;0;0;0;0
294;26.05.2016;2016;05;04;Torstai;0;0;0;0;0;0
294;26.05.2016;2016;05;05;Torstai;1;1;2;0;0;0
294;26.05.2016;2016;05;06;Torstai;3;3;6;4;0;4
294;26.05.2016;2016;05;07;Torstai;10;11;21;6;3;9
294;26.05.2016;2016;05;08;Torstai;13;5;18;6;4;10
294;26.05.2016;2016;05;09;Torstai;15;12;27;9;4;13
294;26.05.2016;2016;05;10;Torstai;17;16;33;8;11;19
294;26.05.2016;2016;05;11;Torstai;38;9;47;12;12;24
294;26.05.2016;2016;05;12;Torstai;14;20;34;8;11;19
294;26.05.2016;2016;05;13;Torstai;22;43;65;12;16;28
294;26.05.2016;2016;05;14;Torstai;16;19;35;10;17;27
294;26.05.2016;2016;05;15;Torstai;30;27;57;8;10;18
294;26.05.2016;2016;05;16;Torstai;40;25;65;11;7;18
294;26.05.2016;2016;05;17;Torstai;20;17;37;8;7;15
294;26.05.2016;2016;05;18;Torstai;23;23;46;8;8;16
294;26.05.2016;2016;05;19;Torstai;24;4;28;6;12;18
294;26.05.2016;2016;05;20;Torstai;15;16;31;16;17;33
294;26.05.2016;2016;05;21;Torstai;10;3;13;2;0;2
294;26.05.2016;2016;05;22;Torstai;3;1;4;2;0;2
294;26.05.2016;2016;05;23;Torstai;0;0;0;0;0;0
294;27.05.2016;2016;05;00;Perjantai;0;0;0;0;0;0
294;27.05.2016;2016;05;01;Perjantai;0;0;0;0;0;0
294;27.05.2016;2016;05;02;Perjantai;0;0;0;0;0;0
294;27.05.2016;2016;05;03;Perjantai;0;0;0;0;0;0
294;27.05.2016;2016;05;04;Perjantai;0;0;0;0;0;0
294;27.05.2016;2016;05;05;Perjantai;0;1;1;0;0;0
294;27.05.2016;2016;05;06;Perjantai;5;5;10;5;0;5
294;27.05.2016;2016;05;07;Perjantai;17;14;31;5;4;9
294;27.05.2016;2016;05;08;Perjantai;19;11;30;8;3;11
294;27.05.2016;2016;05;09;Perjantai;21;13;34;7;5;12
294;27.05.2016;2016;05;10;Perjantai;29;25;54;4;8;12
294;27.05.2016;2016;05;11;Perjantai;7;19;26;6;6;12
294;27.05.2016;2016;05;12;Perjantai;22;47;69;13;13;26
294;27.05.2016;2016;05;13;Perjantai;60;35;95;17;16;33
294;27.05.2016;2016;05;14;Perjantai;25;22;47;11;10;21
294;27.05.2016;2016;05;15;Perjantai;30;22;52;13;12;25
294;27.05.2016;2016;05;16;Perjantai;22;25;47;9;16;25
294;27.05.2016;2016;05;17;Perjantai;26;34;60;6;11;17
294;27.05.2016;2016;05;18;Perjantai;28;22;50;5;5;10
294;27.05.2016;2016;05;19;Perjantai;19;38;57;14;10;24
294;27.05.2016;2016;05;20;Perjantai;21;10;31;6;6;12
294;27.05.2016;2016;05;21;Perjantai;7;14;21;4;3;7
294;27.05.2016;2016;05;22;Perjantai;7;7;14;5;8;13
294;27.05.2016;2016;05;23;Perjantai;7;5;12;0;1;1
294;28.05.2016;2016;05;00;Lauantai;2;10;12;0;1;1
294;28.05.2016;2016;05;01;Lauantai;0;3;3;1;0;1
294;28.05.2016;2016;05;02;Lauantai;1;2;3;0;3;3
294;28.05.2016;2016;05;03;Lauantai;0;0;0;1;1;2
294;28.05.2016;2016;05;04;Lauantai;2;0;2;1;0;1
294;28.05.2016;2016;05;05;Lauantai;1;0;1;0;0;0
294;28.05.2016;2016;05;06;Lauantai;3;0;3;0;0;0
294;28.05.2016;2016;05;07;Lauantai;2;6;8;3;0;3
294;28.05.2016;2016;05;08;Lauantai;1;7;8;0;4;4
294;28.05.2016;2016;05;09;Lauantai;10;5;15;8;7;15
294;28.05.2016;2016;05;10;Lauantai;11;12;23;13;16;29
294;28.05.2016;2016;05;11;Lauantai;26;27;53;11;12;23
294;28.05.2016;2016;05;12;Lauantai;37;25;62;11;9;20
294;28.05.2016;2016;05;13;Lauantai;29;26;55;7;6;13
294;28.05.2016;2016;05;14;Lauantai;12;32;44;9;8;17
294;28.05.2016;2016;05;15;Lauantai;31;35;66;10;8;18
294;28.05.2016;2016;05;16;Lauantai;24;21;45;12;11;23
294;28.05.2016;2016;05;17;Lauantai;29;30;59;11;8;19
294;28.05.2016;2016;05;18;Lauantai;25;25;50;7;9;16
294;28.05.2016;2016;05;19;Lauantai;13;37;50;6;2;8
294;28.05.2016;2016;05;20;Lauantai;25;14;39;6;7;13
294;28.05.2016;2016;05;21;Lauantai;11;5;16;4;2;6
294;28.05.2016;2016;05;22;Lauantai;3;3;6;1;0;1
294;28.05.2016;2016;05;23;Lauantai;3;4;7;0;0;0
294;29.05.2016;2016;05;00;Sunnuntai;0;1;1;0;0;0
294;29.05.2016;2016;05;01;Sunnuntai;4;1;5;0;0;0
294;29.05.2016;2016;05;02;Sunnuntai;1;4;5;0;1;1
294;29.05.2016;2016;05;03;Sunnuntai;0;0;0;0;0;0
294;29.05.2016;2016;05;04;Sunnuntai;0;0;0;0;0;0
294;29.05.2016;2016;05;05;Sunnuntai;1;0;1;0;0;0
294;29.05.2016;2016;05;06;Sunnuntai;2;1;3;0;0;0
294;29.05.2016;2016;05;07;Sunnuntai;2;0;2;1;0;1
294;29.05.2016;2016;05;08;Sunnuntai;3;1;4;3;1;4
294;29.05.2016;2016;05;09;Sunnuntai;9;7;16;11;3;14
294;29.05.2016;2016;05;10;Sunnuntai;13;11;24;5;4;9
294;29.05.2016;2016;05;11;Sunnuntai;21;21;42;4;8;12
294;29.05.2016;2016;05;12;Sunnuntai;31;22;53;7;9;16
294;29.05.2016;2016;05;13;Sunnuntai;35;30;65;5;2;7
294;29.05.2016;2016;05;14;Sunnuntai;24;34;58;6;3;9
294;29.05.2016;2016;05;15;Sunnuntai;16;15;31;12;12;24
294;29.05.2016;2016;05;16;Sunnuntai;12;17;29;3;6;9
294;29.05.2016;2016;05;17;Sunnuntai;23;31;54;8;8;16
294;29.05.2016;2016;05;18;Sunnuntai;24;25;49;6;3;9
294;29.05.2016;2016;05;19;Sunnuntai;24;21;45;10;9;19
294;29.05.2016;2016;05;20;Sunnuntai;10;8;18;7;6;13
294;29.05.2016;2016;05;21;Sunnuntai;9;4;13;3;3;6
294;29.05.2016;2016;05;22;Sunnuntai;4;0;4;0;0;0
294;29.05.2016;2016;05;23;Sunnuntai;0;0;0;0;0;0
294;30.05.2016;2016;05;00;Maanantai;0;0;0;0;0;0
294;30.05.2016;2016;05;01;Maanantai;0;0;0;0;0;0
294;30.05.2016;2016;05;02;Maanantai;0;0;0;0;0;0
294;30.05.2016;2016;05;03;Maanantai;0;0;0;1;0;1
294;30.05.2016;2016;05;04;Maanantai;1;0;1;0;1;1
294;30.05.2016;2016;05;05;Maanantai;0;0;0;1;0;1
294;30.05.2016;2016;05;06;Maanantai;4;4;8;2;2;4
294;30.05.2016;2016;05;07;Maanantai;8;10;18;3;0;3
294;30.05.2016;2016;05;08;Maanantai;25;21;46;4;8;12
294;30.05.2016;2016;05;09;Maanantai;14;13;27;5;8;13
294;30.05.2016;2016;05;10;Maanantai;17;13;30;13;9;22
294;30.05.2016;2016;05;11;Maanantai;18;18;36;9;16;25
294;30.05.2016;2016;05;12;Maanantai;14;17;31;15;7;22
294;30.05.2016;2016;05;13;Maanantai;31;77;108;6;17;23
294;30.05.2016;2016;05;14;Maanantai;43;33;76;10;7;17
294;30.05.2016;2016;05;15;Maanantai;30;37;67;5;12;17
294;30.05.2016;2016;05;16;Maanantai;38;26;64;10;14;24
294;30.05.2016;2016;05;17;Maanantai;32;31;63;14;9;23
294;30.05.2016;2016;05;18;Maanantai;35;30;65;12;10;22
294;30.05.2016;2016;05;19;Maanantai;29;24;53;15;10;25
294;30.05.2016;2016;05;20;Maanantai;21;10;31;3;5;8
294;30.05.2016;2016;05;21;Maanantai;9;12;21;2;3;5
294;30.05.2016;2016;05;22;Maanantai;5;2;7;0;0;0
294;30.05.2016;2016;05;23;Maanantai;0;0;0;0;0;0
294;31.05.2016;2016;05;00;Tiistai;0;0;0;0;0;0
294;31.05.2016;2016;05;01;Tiistai;0;0;0;0;0;0
294;31.05.2016;2016;05;02;Tiistai;0;0;0;0;0;0
294;31.05.2016;2016;05;03;Tiistai;0;0;0;0;0;0
294;31.05.2016;2016;05;04;Tiistai;0;0;0;1;1;2
294;31.05.2016;2016;05;05;Tiistai;2;2;4;1;0;1
294;31.05.2016;2016;05;06;Tiistai;5;2;7;3;0;3
294;31.05.2016;2016;05;07;Tiistai;5;8;13;2;0;2
294;31.05.2016;2016;05;08;Tiistai;21;12;33;6;6;12
294;31.05.2016;2016;05;09;Tiistai;34;16;50;8;7;15
294;31.05.2016;2016;05;10;Tiistai;25;14;39;10;9;19
294;31.05.2016;2016;05;11;Tiistai;16;16;32;17;10;27
294;31.05.2016;2016;05;12;Tiistai;30;31;61;9;16;25
294;31.05.2016;2016;05;13;Tiistai;34;28;62;10;12;22
294;31.05.2016;2016;05;14;Tiistai;20;29;49;6;7;13
294;31.05.2016;2016;05;15;Tiistai;29;27;56;7;10;17
294;31.05.2016;2016;05;16;Tiistai;27;23;50;5;9;14
294;31.05.2016;2016;05;17;Tiistai;23;36;59;10;13;23
294;31.05.2016;2016;05;18;Tiistai;48;29;77;16;10;26
294;31.05.2016;2016;05;19;Tiistai;22;23;45;10;12;22
294;31.05.2016;2016;05;20;Tiistai;13;7;20;9;10;19
294;31.05.2016;2016;05;21;Tiistai;9;4;13;5;3;8
294;31.05.2016;2016;05;22;Tiistai;0;0;0;1;2;3
294;31.05.2016;2016;05;23;Tiistai;0;1;1;0;0;0
294;01.06.2016;2016;06;00;Keskiviikko;0;0;0;0;0;0
294;01.06.2016;2016;06;01;Keskiviikko;0;0;0;0;0;0
294;01.06.2016;2016;06;02;Keskiviikko;0;0;0;0;0;0
294;01.06.2016;2016;06;03;Keskiviikko;0;0;0;0;0;0
294;01.06.2016;2016;06;04;Keskiviikko;0;0;0;0;1;1
294;01.06.2016;2016;06;05;Keskiviikko;1;1;2;1;2;3
294;01.06.2016;2016;06;06;Keskiviikko;4;2;6;0;2;2
294;01.06.2016;2016;06;07;Keskiviikko;23;6;29;2;0;2
294;01.06.2016;2016;06;08;Keskiviikko;12;7;19;7;4;11
294;01.06.2016;2016;06;09;Keskiviikko;13;25;38;14;12;26
294;01.06.2016;2016;06;10;Keskiviikko;9;11;20;3;6;9
294;01.06.2016;2016;06;11;Keskiviikko;10;13;23;3;5;8
294;01.06.2016;2016;06;12;Keskiviikko;25;9;34;18;8;26
294;01.06.2016;2016;06;13;Keskiviikko;18;20;38;11;12;23
294;01.06.2016;2016;06;14;Keskiviikko;20;17;37;13;8;21
294;01.06.2016;2016;06;15;Keskiviikko;21;22;43;3;10;13
294;01.06.2016;2016;06;16;Keskiviikko;29;25;54;18;13;31
294;01.06.2016;2016;06;17;Keskiviikko;23;23;46;7;6;13
294;01.06.2016;2016;06;18;Keskiviikko;23;32;55;10;10;20
294;01.06.2016;2016;06;19;Keskiviikko;22;25;47;11;8;19
294;01.06.2016;2016;06;20;Keskiviikko;12;17;29;8;7;15
294;01.06.2016;2016;06;21;Keskiviikko;11;5;16;7;3;10
294;01.06.2016;2016;06;22;Keskiviikko;7;9;16;1;1;2
294;01.06.2016;2016;06;23;Keskiviikko;0;1;1;0;1;1
294;02.06.2016;2016;06;00;Torstai;0;0;0;0;0;0
294;02.06.2016;2016;06;01;Torstai;1;0;1;0;0;0
294;02.06.2016;2016;06;02;Torstai;0;0;0;0;0;0
294;02.06.2016;2016;06;03;Torstai;0;0;0;0;0;0
294;02.06.2016;2016;06;04;Torstai;0;0;0;0;1;1
294;02.06.2016;2016;06;05;Torstai;0;1;1;1;0;1
294;02.06.2016;2016;06;06;Torstai;3;3;6;0;0;0
294;02.06.2016;2016;06;07;Torstai;16;6;22;3;3;6
294;02.06.2016;2016;06;08;Torstai;18;12;30;5;7;12
294;02.06.2016;2016;06;09;Torstai;123;27;150;7;4;11
294;02.06.2016;2016;06;10;Torstai;10;58;68;14;30;44
294;02.06.2016;2016;06;11;Torstai;26;33;59;15;8;23
294;02.06.2016;2016;06;12;Torstai;23;13;36;12;7;19
294;02.06.2016;2016;06;13;Torstai;34;54;88;11;12;23
294;02.06.2016;2016;06;14;Torstai;18;19;37;7;7;14
294;02.06.2016;2016;06;15;Torstai;31;27;58;11;5;16
294;02.06.2016;2016;06;16;Torstai;33;31;64;8;8;16
294;02.06.2016;2016;06;17;Torstai;28;23;51;8;12;20
294;02.06.2016;2016;06;18;Torstai;22;30;52;7;6;13
294;02.06.2016;2016;06;19;Torstai;17;29;46;7;8;15
294;02.06.2016;2016;06;20;Torstai;12;18;30;11;15;26
294;02.06.2016;2016;06;21;Torstai;13;6;19;2;4;6
294;02.06.2016;2016;06;22;Torstai;1;4;5;2;0;2
294;02.06.2016;2016;06;23;Torstai;0;0;0;1;1;2
294;03.06.2016;2016;06;00;Perjantai;2;0;2;0;0;0
294;03.06.2016;2016;06;01;Perjantai;0;0;0;0;0;0
294;03.06.2016;2016;06;02;Perjantai;0;0;0;0;0;0
294;03.06.2016;2016;06;03;Perjantai;0;0;0;0;0;0
294;03.06.2016;2016;06;04;Perjantai;1;0;1;0;0;0
294;03.06.2016;2016;06;05;Perjantai;0;1;1;0;0;0
294;03.06.2016;2016;06;06;Perjantai;2;1;3;1;0;1
294;03.06.2016;2016;06;07;Perjantai;6;6;12;3;4;7
294;03.06.2016;2016;06;08;Perjantai;13;10;23;3;3;6
294;03.06.2016;2016;06;09;Perjantai;15;9;24;8;10;18
294;03.06.2016;2016;06;10;Perjantai;16;11;27;13;11;24
294;03.06.2016;2016;06;11;Perjantai;13;13;26;12;6;18
294;03.06.2016;2016;06;12;Perjantai;20;93;113;10;18;28
294;03.06.2016;2016;06;13;Perjantai;24;15;39;11;8;19
294;03.06.2016;2016;06;14;Perjantai;25;20;45;9;6;15
294;03.06.2016;2016;06;15;Perjantai;22;29;51;14;11;25
294;03.06.2016;2016;06;16;Perjantai;21;25;46;8;14;22
294;03.06.2016;2016;06;17;Perjantai;18;23;41;11;14;25
294;03.06.2016;2016;06;18;Perjantai;22;16;38;15;8;23
294;03.06.2016;2016;06;19;Perjantai;21;16;37;9;6;15
294;03.06.2016;2016;06;20;Perjantai;11;16;27;8;12;20
294;03.06.2016;2016;06;21;Perjantai;4;0;4;4;4;8
294;03.06.2016;2016;06;22;Perjantai;2;5;7;2;1;3
294;03.06.2016;2016;06;23;Perjantai;3;0;3;3;2;5
294;04.06.2016;2016;06;00;Lauantai;2;0;2;0;0;0
294;04.06.2016;2016;06;01;Lauantai;1;0;1;0;0;0
294;04.06.2016;2016;06;02;Lauantai;0;0;0;0;0;0
294;04.06.2016;2016;06;03;Lauantai;0;0;0;0;0;0
294;04.06.2016;2016;06;04;Lauantai;0;0;0;0;0;0
294;04.06.2016;2016;06;05;Lauantai;1;0;1;0;0;0
294;04.06.2016;2016;06;06;Lauantai;0;1;1;1;1;2
294;04.06.2016;2016;06;07;Lauantai;3;2;5;1;1;2
294;04.06.2016;2016;06;08;Lauantai;33;10;43;5;3;8
294;04.06.2016;2016;06;09;Lauantai;22;30;52;8;4;12
294;04.06.2016;2016;06;10;Lauantai;13;18;31;12;13;25
294;04.06.2016;2016;06;11;Lauantai;17;11;28;6;10;16
294;04.06.2016;2016;06;12;Lauantai;15;18;33;6;6;12
294;04.06.2016;2016;06;13;Lauantai;8;15;23;2;14;16
294;04.06.2016;2016;06;14;Lauantai;26;22;48;11;7;18
294;04.06.2016;2016;06;15;Lauantai;6;8;14;4;9;13
294;04.06.2016;2016;06;16;Lauantai;15;19;34;8;11;19
294;04.06.2016;2016;06;17;Lauantai;28;18;46;4;3;7
294;04.06.2016;2016;06;18;Lauantai;17;19;36;13;8;21
294;04.06.2016;2016;06;19;Lauantai;17;11;28;6;2;8
294;04.06.2016;2016;06;20;Lauantai;13;21;34;4;2;6
294;04.06.2016;2016;06;21;Lauantai;9;3;12;4;5;9
294;04.06.2016;2016;06;22;Lauantai;1;3;4;0;0;0
294;04.06.2016;2016;06;23;Lauantai;4;2;6;0;4;4
294;05.06.2016;2016;06;00;Sunnuntai;0;3;3;0;1;1
294;05.06.2016;2016;06;01;Sunnuntai;0;2;2;0;0;0
294;05.06.2016;2016;06;02;Sunnuntai;0;1;1;0;3;3
294;05.06.2016;2016;06;03;Sunnuntai;3;0;3;0;1;1
294;05.06.2016;2016;06;04;Sunnuntai;1;1;2;0;0;0
294;05.06.2016;2016;06;05;Sunnuntai;1;2;3;0;1;1
294;05.06.2016;2016;06;06;Sunnuntai;2;0;2;0;0;0
294;05.06.2016;2016;06;07;Sunnuntai;1;2;3;1;0;1
294;05.06.2016;2016;06;08;Sunnuntai;1;3;4;2;1;3
294;05.06.2016;2016;06;09;Sunnuntai;9;3;12;4;1;5
294;05.06.2016;2016;06;10;Sunnuntai;6;12;18;3;7;10
294;05.06.2016;2016;06;11;Sunnuntai;9;19;28;9;3;12
294;05.06.2016;2016;06;12;Sunnuntai;24;21;45;6;8;14
294;05.06.2016;2016;06;13;Sunnuntai;28;19;47;4;7;11
294;05.06.2016;2016;06;14;Sunnuntai;11;11;22;4;7;11
294;05.06.2016;2016;06;15;Sunnuntai;16;18;34;4;15;19
294;05.06.2016;2016;06;16;Sunnuntai;10;9;19;8;3;11
294;05.06.2016;2016;06;17;Sunnuntai;16;24;40;3;8;11
294;05.06.2016;2016;06;18;Sunnuntai;23;13;36;8;2;10
294;05.06.2016;2016;06;19;Sunnuntai;7;10;17;7;4;11
294;05.06.2016;2016;06;20;Sunnuntai;5;12;17;2;9;11
294;05.06.2016;2016;06;21;Sunnuntai;2;3;5;0;0;0
294;05.06.2016;2016;06;22;Sunnuntai;0;0;0;1;1;2
294;05.06.2016;2016;06;23;Sunnuntai;9;0;9;2;0;2
294;06.06.2016;2016;06;00;Maanantai;0;0;0;2;0;2
294;06.06.2016;2016;06;01;Maanantai;0;0;0;0;0;0
294;06.06.2016;2016;06;02;Maanantai;0;0;0;0;0;0
294;06.06.2016;2016;06;03;Maanantai;2;0;2;0;0;0
294;06.06.2016;2016;06;04;Maanantai;0;0;0;0;0;0
294;06.06.2016;2016;06;05;Maanantai;0;0;0;1;0;1
294;06.06.2016;2016;06;06;Maanantai;2;3;5;2;2;4
294;06.06.2016;2016;06;07;Maanantai;9;1;10;1;0;1
294;06.06.2016;2016;06;08;Maanantai;8;2;10;0;2;2
294;06.06.2016;2016;06;09;Maanantai;13;14;27;0;10;10
294;06.06.2016;2016;06;10;Maanantai;19;14;33;6;7;13
294;06.06.2016;2016;06;11;Maanantai;6;23;29;12;12;24
294;06.06.2016;2016;06;12;Maanantai;30;17;47;6;6;12
294;06.06.2016;2016;06;13;Maanantai;26;19;45;9;11;20
294;06.06.2016;2016;06;14;Maanantai;24;21;45;13;19;32
294;06.06.2016;2016;06;15;Maanantai;21;31;52;10;9;19
294;06.06.2016;2016;06;16;Maanantai;27;22;49;3;7;10
294;06.06.2016;2016;06;17;Maanantai;36;25;61;4;9;13
294;06.06.2016;2016;06;18;Maanantai;34;26;60;8;7;15
294;06.06.2016;2016;06;19;Maanantai;14;18;32;13;13;26
294;06.06.2016;2016;06;20;Maanantai;10;6;16;5;5;10
294;06.06.2016;2016;06;21;Maanantai;2;4;6;2;0;2
294;06.06.2016;2016;06;22;Maanantai;4;3;7;0;1;1
294;06.06.2016;2016;06;23;Maanantai;1;0;1;1;2;3
294;07.06.2016;2016;06;00;Tiistai;1;0;1;0;0;0
294;07.06.2016;2016;06;01;Tiistai;1;0;1;0;0;0
294;07.06.2016;2016;06;02;Tiistai;0;0;0;0;0;0
294;07.06.2016;2016;06;03;Tiistai;1;0;1;0;0;0
294;07.06.2016;2016;06;04;Tiistai;0;0;0;1;0;1
294;07.06.2016;2016;06;05;Tiistai;0;2;2;0;2;2
294;07.06.2016;2016;06;06;Tiistai;1;5;6;3;4;7
294;07.06.2016;2016;06;07;Tiistai;2;2;4;1;2;3
294;07.06.2016;2016;06;08;Tiistai;8;10;18;1;5;6
294;07.06.2016;2016;06;09;Tiistai;7;9;16;7;5;12
294;07.06.2016;2016;06;10;Tiistai;24;19;43;4;3;7
294;07.06.2016;2016;06;11;Tiistai;26;16;42;9;6;15
294;07.06.2016;2016;06;12;Tiistai;31;16;47;10;4;14
294;07.06.2016;2016;06;13;Tiistai;26;21;47;7;4;11
294;07.06.2016;2016;06;14;Tiistai;37;26;63;17;11;28
294;07.06.2016;2016;06;15;Tiistai;16;14;30;11;20;31
294;07.06.2016;2016;06;16;Tiistai;13;19;32;10;14;24
294;07.06.2016;2016;06;17;Tiistai;36;30;66;14;18;32
294;07.06.2016;2016;06;18;Tiistai;24;27;51;12;16;28
294;07.06.2016;2016;06;19;Tiistai;20;16;36;14;8;22
294;07.06.2016;2016;06;20;Tiistai;27;18;45;8;10;18
294;07.06.2016;2016;06;21;Tiistai;7;4;11;5;4;9
294;07.06.2016;2016;06;22;Tiistai;1;0;1;5;1;6
294;07.06.2016;2016;06;23;Tiistai;0;1;1;0;0;0
294;08.06.2016;2016;06;00;Keskiviikko;0;0;0;0;1;1
294;08.06.2016;2016;06;01;Keskiviikko;1;0;1;1;0;1
294;08.06.2016;2016;06;02;Keskiviikko;2;0;2;0;0;0
294;08.06.2016;2016;06;03;Keskiviikko;0;1;1;0;0;0
294;08.06.2016;2016;06;04;Keskiviikko;0;0;0;0;0;0
294;08.06.2016;2016;06;05;Keskiviikko;0;0;0;0;0;0
294;08.06.2016;2016;06;06;Keskiviikko;0;0;0;0;1;1
294;08.06.2016;2016;06;07;Keskiviikko;3;2;5;1;2;3
294;08.06.2016;2016;06;08;Keskiviikko;3;1;4;7;3;10
294;08.06.2016;2016;06;09;Keskiviikko;7;4;11;5;4;9
294;08.06.2016;2016;06;10;Keskiviikko;3;5;8;0;5;5
294;08.06.2016;2016;06;11;Keskiviikko;9;4;13;1;3;4
294;08.06.2016;2016;06;12;Keskiviikko;2;6;8;4;4;8
294;08.06.2016;2016;06;13;Keskiviikko;5;3;8;3;4;7
294;08.06.2016;2016;06;14;Keskiviikko;4;7;11;3;5;8
294;08.06.2016;2016;06;15;Keskiviikko;7;4;11;2;4;6
294;08.06.2016;2016;06;16;Keskiviikko;4;1;5;5;4;9
294;08.06.2016;2016;06;17;Keskiviikko;6;13;19;1;4;5
294;08.06.2016;2016;06;18;Keskiviikko;8;5;13;6;5;11
294;08.06.2016;2016;06;19;Keskiviikko;3;2;5;7;6;13
294;08.06.2016;2016;06;20;Keskiviikko;9;7;16;5;1;6
294;08.06.2016;2016;06;21;Keskiviikko;7;4;11;1;5;6
294;08.06.2016;2016;06;22;Keskiviikko;1;1;2;1;0;1
294;08.06.2016;2016;06;23;Keskiviikko;0;0;0;0;0;0
294;09.06.2016;2016;06;00;Torstai;0;0;0;0;0;0
294;09.06.2016;2016;06;01;Torstai;0;0;0;0;0;0
294;09.06.2016;2016;06;02;Torstai;0;0;0;0;0;0
294;09.06.2016;2016;06;03;Torstai;0;0;0;0;0;0
294;09.06.2016;2016;06;04;Torstai;1;0;1;0;0;0
294;09.06.2016;2016;06;05;Torstai;0;1;1;0;2;2
294;09.06.2016;2016;06;06;Torstai;0;0;0;2;0;2
294;09.06.2016;2016;06;07;Torstai;3;2;5;2;2;4
294;09.06.2016;2016;06;08;Torstai;2;2;4;4;4;8
294;09.06.2016;2016;06;09;Torstai;10;4;14;5;2;7
294;09.06.2016;2016;06;10;Torstai;10;10;20;2;5;7
294;09.06.2016;2016;06;11;Torstai;12;16;28;7;9;16
294;09.06.2016;2016;06;12;Torstai;8;18;26;9;7;16
294;09.06.2016;2016;06;13;Torstai;20;18;38;8;9;17
294;09.06.2016;2016;06;14;Torstai;17;23;40;8;9;17
294;09.06.2016;2016;06;15;Torstai;17;13;30;15;9;24
294;09.06.2016;2016;06;16;Torstai;11;12;23;7;9;16
294;09.06.2016;2016;06;17;Torstai;21;13;34;11;8;19
294;09.06.2016;2016;06;18;Torstai;24;23;47;6;8;14
294;09.06.2016;2016;06;19;Torstai;15;23;38;14;6;20
294;09.06.2016;2016;06;20;Torstai;13;18;31;7;5;12
294;09.06.2016;2016;06;21;Torstai;4;4;8;3;3;6
294;09.06.2016;2016;06;22;Torstai;1;2;3;1;1;2
294;09.06.2016;2016;06;23;Torstai;2;0;2;0;0;0
294;10.06.2016;2016;06;00;Perjantai;1;0;1;0;0;0
294;10.06.2016;2016;06;01;Perjantai;0;0;0;0;0;0
294;10.06.2016;2016;06;02;Perjantai;0;0;0;0;0;0
294;10.06.2016;2016;06;03;Perjantai;0;0;0;0;0;0
294;10.06.2016;2016;06;04;Perjantai;0;0;0;0;0;0
294;10.06.2016;2016;06;05;Perjantai;1;0;1;0;0;0
294;10.06.2016;2016;06;06;Perjantai;0;1;1;5;1;6
294;10.06.2016;2016;06;07;Perjantai;3;2;5;3;1;4
294;10.06.2016;2016;06;08;Perjantai;3;2;5;3;5;8
294;10.06.2016;2016;06;09;Perjantai;2;4;6;3;2;5
294;10.06.2016;2016;06;10;Perjantai;6;10;16;7;6;13
294;10.06.2016;2016;06;11;Perjantai;12;13;25;7;7;14
294;10.06.2016;2016;06;12;Perjantai;12;14;26;8;7;15
294;10.06.2016;2016;06;13;Perjantai;19;22;41;10;5;15
294;10.06.2016;2016;06;14;Perjantai;18;13;31;18;10;28
294;10.06.2016;2016;06;15;Perjantai;9;8;17;6;10;16
294;10.06.2016;2016;06;16;Perjantai;13;17;30;12;5;17
294;10.06.2016;2016;06;17;Perjantai;19;7;26;7;10;17
294;10.06.2016;2016;06;18;Perjantai;13;22;35;12;4;16
294;10.06.2016;2016;06;19;Perjantai;11;18;29;5;10;15
294;10.06.2016;2016;06;20;Perjantai;12;2;14;9;6;15
294;10.06.2016;2016;06;21;Perjantai;9;6;15;6;2;8
294;10.06.2016;2016;06;22;Perjantai;3;7;10;0;0;0
294;10.06.2016;2016;06;23;Perjantai;6;2;8;0;0;0
294;11.06.2016;2016;06;00;Lauantai;3;4;7;1;1;2
294;11.06.2016;2016;06;01;Lauantai;0;0;0;0;0;0
294;11.06.2016;2016;06;02;Lauantai;0;1;1;0;0;0
294;11.06.2016;2016;06;03;Lauantai;0;0;0;0;1;1
294;11.06.2016;2016;06;04;Lauantai;0;0;0;0;0;0
294;11.06.2016;2016;06;05;Lauantai;2;0;2;0;1;1
294;11.06.2016;2016;06;06;Lauantai;0;1;1;0;0;0
294;11.06.2016;2016;06;07;Lauantai;1;1;2;1;0;1
294;11.06.2016;2016;06;08;Lauantai;1;11;12;0;2;2
294;11.06.2016;2016;06;09;Lauantai;8;3;11;5;9;14
294;11.06.2016;2016;06;10;Lauantai;4;5;9;7;7;14
294;11.06.2016;2016;06;11;Lauantai;22;16;38;11;3;14
294;11.06.2016;2016;06;12;Lauantai;11;20;31;9;5;14
294;11.06.2016;2016;06;13;Lauantai;16;15;31;10;14;24
294;11.06.2016;2016;06;14;Lauantai;13;5;18;8;7;15
294;11.06.2016;2016;06;15;Lauantai;17;13;30;3;7;10
294;11.06.2016;2016;06;16;Lauantai;19;9;28;6;5;11
294;11.06.2016;2016;06;17;Lauantai;19;20;39;5;4;9
294;11.06.2016;2016;06;18;Lauantai;16;8;24;2;2;4
294;11.06.2016;2016;06;19;Lauantai;6;4;10;6;6;12
294;11.06.2016;2016;06;20;Lauantai;7;5;12;1;2;3
294;11.06.2016;2016;06;21;Lauantai;4;11;15;2;4;6
294;11.06.2016;2016;06;22;Lauantai;7;0;7;1;4;5
294;11.06.2016;2016;06;23;Lauantai;0;1;1;1;0;1
294;12.06.2016;2016;06;00;Sunnuntai;3;0;3;2;0;2
294;12.06.2016;2016;06;01;Sunnuntai;1;1;2;1;0;1
294;12.06.2016;2016;06;02;Sunnuntai;5;1;6;0;2;2
294;12.06.2016;2016;06;03;Sunnuntai;1;0;1;1;0;1
294;12.06.2016;2016;06;04;Sunnuntai;0;0;0;0;1;1
294;12.06.2016;2016;06;05;Sunnuntai;0;0;0;0;0;0
294;12.06.2016;2016;06;06;Sunnuntai;0;0;0;2;1;3
294;12.06.2016;2016;06;07;Sunnuntai;0;1;1;0;0;0
294;12.06.2016;2016;06;08;Sunnuntai;3;3;6;1;3;4
294;12.06.2016;2016;06;09;Sunnuntai;5;3;8;6;2;8
294;12.06.2016;2016;06;10;Sunnuntai;16;8;24;10;14;24
294;12.06.2016;2016;06;11;Sunnuntai;12;14;26;6;14;20
294;12.06.2016;2016;06;12;Sunnuntai;16;16;32;6;4;10
294;12.06.2016;2016;06;13;Sunnuntai;16;12;28;6;10;16
294;12.06.2016;2016;06;14;Sunnuntai;17;23;40;12;10;22
294;12.06.2016;2016;06;15;Sunnuntai;21;14;35;4;8;12
294;12.06.2016;2016;06;16;Sunnuntai;10;15;25;7;13;20
294;12.06.2016;2016;06;17;Sunnuntai;20;16;36;6;9;15
294;12.06.2016;2016;06;18;Sunnuntai;24;24;48;10;10;20
294;12.06.2016;2016;06;19;Sunnuntai;16;14;30;9;7;16
294;12.06.2016;2016;06;20;Sunnuntai;22;16;38;13;5;18
294;12.06.2016;2016;06;21;Sunnuntai;9;7;16;2;5;7
294;12.06.2016;2016;06;22;Sunnuntai;1;2;3;3;0;3
294;12.06.2016;2016;06;23;Sunnuntai;0;0;0;0;1;1
294;13.06.2016;2016;06;00;Maanantai;0;0;0;0;1;1
294;13.06.2016;2016;06;01;Maanantai;0;1;1;1;0;1
294;13.06.2016;2016;06;02;Maanantai;0;0;0;0;0;0
294;13.06.2016;2016;06;03;Maanantai;2;3;5;0;0;0
294;13.06.2016;2016;06;04;Maanantai;0;0;0;2;0;2
294;13.06.2016;2016;06;05;Maanantai;0;0;0;2;1;3
294;13.06.2016;2016;06;06;Maanantai;3;5;8;3;0;3
294;13.06.2016;2016;06;07;Maanantai;5;5;10;2;2;4
294;13.06.2016;2016;06;08;Maanantai;9;6;15;2;2;4
294;13.06.2016;2016;06;09;Maanantai;9;14;23;6;2;8
294;13.06.2016;2016;06;10;Maanantai;26;5;31;6;11;17
294;13.06.2016;2016;06;11;Maanantai;18;28;46;6;7;13
294;13.06.2016;2016;06;12;Maanantai;18;27;45;15;17;32
294;13.06.2016;2016;06;13;Maanantai;16;14;30;5;3;8
294;13.06.2016;2016;06;14;Maanantai;21;22;43;3;7;10
294;13.06.2016;2016;06;15;Maanantai;22;20;42;7;6;13
294;13.06.2016;2016;06;16;Maanantai;30;44;74;8;4;12
294;13.06.2016;2016;06;17;Maanantai;16;14;30;14;12;26
294;13.06.2016;2016;06;18;Maanantai;18;19;37;12;8;20
294;13.06.2016;2016;06;19;Maanantai;22;13;35;16;11;27
294;13.06.2016;2016;06;20;Maanantai;17;15;32;10;7;17
294;13.06.2016;2016;06;21;Maanantai;8;11;19;6;5;11
294;13.06.2016;2016;06;22;Maanantai;6;4;10;3;0;3
294;13.06.2016;2016;06;23;Maanantai;1;0;1;0;0;0
294;14.06.2016;2016;06;00;Tiistai;1;0;1;1;2;3
294;14.06.2016;2016;06;01;Tiistai;0;0;0;0;0;0
294;14.06.2016;2016;06;02;Tiistai;3;0;3;0;0;0
294;14.06.2016;2016;06;03;Tiistai;0;0;0;0;0;0
294;14.06.2016;2016;06;04;Tiistai;0;0;0;0;0;0
294;14.06.2016;2016;06;05;Tiistai;0;1;1;1;1;2
294;14.06.2016;2016;06;06;Tiistai;2;0;2;2;3;5
294;14.06.2016;2016;06;07;Tiistai;8;2;10;6;1;7
294;14.06.2016;2016;06;08;Tiistai;9;9;18;4;2;6
294;14.06.2016;2016;06;09;Tiistai;10;8;18;0;3;3
294;14.06.2016;2016;06;10;Tiistai;17;4;21;10;6;16
294;14.06.2016;2016;06;11;Tiistai;17;11;28;8;2;10
294;14.06.2016;2016;06;12;Tiistai;15;20;35;8;11;19
294;14.06.2016;2016;06;13;Tiistai;21;30;51;8;9;17
294;14.06.2016;2016;06;14;Tiistai;30;33;63;13;12;25
294;14.06.2016;2016;06;15;Tiistai;27;24;51;4;4;8
294;14.06.2016;2016;06;16;Tiistai;32;35;67;17;26;43
294;14.06.2016;2016;06;17;Tiistai;16;26;42;12;8;20
294;14.06.2016;2016;06;18;Tiistai;24;32;56;10;5;15
294;14.06.2016;2016;06;19;Tiistai;37;19;56;17;10;27
294;14.06.2016;2016;06;20;Tiistai;22;15;37;4;9;13
294;14.06.2016;2016;06;21;Tiistai;9;6;15;5;4;9
294;14.06.2016;2016;06;22;Tiistai;4;0;4;2;0;2
294;14.06.2016;2016;06;23;Tiistai;2;2;4;0;0;0
294;15.06.2016;2016;06;00;Keskiviikko;0;2;2;0;0;0
294;15.06.2016;2016;06;01;Keskiviikko;1;1;2;0;0;0
294;15.06.2016;2016;06;02;Keskiviikko;0;0;0;0;0;0
294;15.06.2016;2016;06;03;Keskiviikko;0;0;0;0;0;0
294;15.06.2016;2016;06;04;Keskiviikko;1;0;1;0;0;0
294;15.06.2016;2016;06;05;Keskiviikko;0;2;2;0;1;1
294;15.06.2016;2016;06;06;Keskiviikko;1;2;3;3;1;4
294;15.06.2016;2016;06;07;Keskiviikko;7;3;10;4;2;6
294;15.06.2016;2016;06;08;Keskiviikko;14;3;17;1;7;8
294;15.06.2016;2016;06;09;Keskiviikko;15;16;31;7;2;9
294;15.06.2016;2016;06;10;Keskiviikko;19;11;30;8;5;13
294;15.06.2016;2016;06;11;Keskiviikko;27;23;50;5;6;11
294;15.06.2016;2016;06;12;Keskiviikko;24;16;40;4;7;11
294;15.06.2016;2016;06;13;Keskiviikko;19;34;53;6;10;16
294;15.06.2016;2016;06;14;Keskiviikko;36;31;67;7;2;9
294;15.06.2016;2016;06;15;Keskiviikko;27;40;67;7;7;14
294;15.06.2016;2016;06;16;Keskiviikko;25;19;44;9;3;12
294;15.06.2016;2016;06;17;Keskiviikko;10;19;29;7;5;12
294;15.06.2016;2016;06;18;Keskiviikko;23;20;43;19;19;38
294;15.06.2016;2016;06;19;Keskiviikko;7;28;35;11;12;23
294;15.06.2016;2016;06;20;Keskiviikko;19;9;28;5;8;13
294;15.06.2016;2016;06;21;Keskiviikko;16;9;25;10;3;13
294;15.06.2016;2016;06;22;Keskiviikko;3;4;7;2;4;6
294;15.06.2016;2016;06;23;Keskiviikko;3;0;3;0;0;0
294;16.06.2016;2016;06;00;Torstai;0;1;1;0;1;1
294;16.06.2016;2016;06;01;Torstai;0;0;0;0;0;0
294;16.06.2016;2016;06;02;Torstai;1;0;1;0;0;0
294;16.06.2016;2016;06;03;Torstai;0;0;0;0;0;0
294;16.06.2016;2016;06;04;Torstai;0;0;0;0;0;0
294;16.06.2016;2016;06;05;Torstai;1;0;1;1;1;2
294;16.06.2016;2016;06;06;Torstai;1;4;5;2;0;2
294;16.06.2016;2016;06;07;Torstai;11;4;15;3;1;4
294;16.06.2016;2016;06;08;Torstai;6;7;13;4;3;7
294;16.06.2016;2016;06;09;Torstai;11;9;20;6;8;14
294;16.06.2016;2016;06;10;Torstai;24;22;46;11;4;15
294;16.06.2016;2016;06;11;Torstai;24;15;39;10;11;21
294;16.06.2016;2016;06;12;Torstai;18;11;29;12;10;22
294;16.06.2016;2016;06;13;Torstai;30;22;52;6;10;16
294;16.06.2016;2016;06;14;Torstai;13;13;26;4;5;9
294;16.06.2016;2016;06;15;Torstai;11;13;24;7;3;10
294;16.06.2016;2016;06;16;Torstai;10;13;23;2;2;4
294;16.06.2016;2016;06;17;Torstai;6;4;10;1;1;2
294;16.06.2016;2016;06;18;Torstai;6;9;15;1;4;5
294;16.06.2016;2016;06;19;Torstai;3;3;6;2;1;3
294;16.06.2016;2016;06;20;Torstai;3;6;9;3;5;8
294;16.06.2016;2016;06;21;Torstai;1;0;1;3;1;4
294;16.06.2016;2016;06;22;Torstai;2;1;3;1;2;3
294;16.06.2016;2016;06;23;Torstai;0;0;0;2;0;2
294;17.06.2016;2016;06;00;Perjantai;0;0;0;0;0;0
294;17.06.2016;2016;06;01;Perjantai;0;0;0;0;0;0
294;17.06.2016;2016;06;02;Perjantai;0;0;0;1;0;1
294;17.06.2016;2016;06;03;Perjantai;0;0;0;0;0;0
294;17.06.2016;2016;06;04;Perjantai;0;0;0;0;0;0
294;17.06.2016;2016;06;05;Perjantai;0;0;0;0;1;1
294;17.06.2016;2016;06;06;Perjantai;1;1;2;1;0;1
294;17.06.2016;2016;06;07;Perjantai;4;1;5;1;3;4
294;17.06.2016;2016;06;08;Perjantai;2;2;4;3;2;5
294;17.06.2016;2016;06;09;Perjantai;3;6;9;1;1;2
294;17.06.2016;2016;06;10;Perjantai;7;11;18;6;3;9
294;17.06.2016;2016;06;11;Perjantai;9;19;28;24;14;38
294;17.06.2016;2016;06;12;Perjantai;21;14;35;9;11;20
294;17.06.2016;2016;06;13;Perjantai;22;12;34;10;6;16
294;17.06.2016;2016;06;14;Perjantai;8;12;20;4;4;8
294;17.06.2016;2016;06;15;Perjantai;14;8;22;10;8;18
294;17.06.2016;2016;06;16;Perjantai;10;14;24;4;4;8
294;17.06.2016;2016;06;17;Perjantai;12;12;24;4;10;14
294;17.06.2016;2016;06;18;Perjantai;13;18;31;6;15;21
294;17.06.2016;2016;06;19;Perjantai;31;30;61;11;8;19
294;17.06.2016;2016;06;20;Perjantai;22;12;34;4;2;6
294;17.06.2016;2016;06;21;Perjantai;3;2;5;0;2;2
294;17.06.2016;2016;06;22;Perjantai;2;5;7;3;1;4
294;17.06.2016;2016;06;23;Perjantai;0;1;1;1;0;1
294;18.06.2016;2016;06;00;Lauantai;2;0;2;4;0;4
294;18.06.2016;2016;06;01;Lauantai;2;1;3;1;0;1
294;18.06.2016;2016;06;02;Lauantai;0;0;0;0;0;0
294;18.06.2016;2016;06;03;Lauantai;0;0;0;0;0;0
294;18.06.2016;2016;06;04;Lauantai;0;0;0;0;0;0
294;18.06.2016;2016;06;05;Lauantai;2;0;2;0;0;0
294;18.06.2016;2016;06;06;Lauantai;3;0;3;1;0;1
294;18.06.2016;2016;06;07;Lauantai;1;2;3;2;1;3
294;18.06.2016;2016;06;08;Lauantai;6;6;12;2;1;3
294;18.06.2016;2016;06;09;Lauantai;7;12;19;2;3;5
294;18.06.2016;2016;06;10;Lauantai;16;7;23;8;10;18
294;18.06.2016;2016;06;11;Lauantai;11;26;37;4;11;15
294;18.06.2016;2016;06;12;Lauantai;16;8;24;9;3;12
294;18.06.2016;2016;06;13;Lauantai;9;5;14;6;4;10
294;18.06.2016;2016;06;14;Lauantai;12;9;21;6;5;11
294;18.06.2016;2016;06;15;Lauantai;9;10;19;11;5;16
294;18.06.2016;2016;06;16;Lauantai;8;8;16;8;6;14
294;18.06.2016;2016;06;17;Lauantai;20;18;38;10;10;20
294;18.06.2016;2016;06;18;Lauantai;9;9;18;2;3;5
294;18.06.2016;2016;06;19;Lauantai;2;10;12;2;0;2
294;18.06.2016;2016;06;20;Lauantai;7;5;12;5;3;8
294;18.06.2016;2016;06;21;Lauantai;0;1;1;5;5;10
294;18.06.2016;2016;06;22;Lauantai;4;2;6;5;1;6
294;18.06.2016;2016;06;23;Lauantai;1;0;1;0;0;0
294;19.06.2016;2016;06;00;Sunnuntai;0;0;0;1;0;1
294;19.06.2016;2016;06;01;Sunnuntai;0;2;2;0;2;2
294;19.06.2016;2016;06;02;Sunnuntai;0;0;0;0;0;0
294;19.06.2016;2016;06;03;Sunnuntai;0;0;0;0;0;0
294;19.06.2016;2016;06;04;Sunnuntai;0;0;0;0;0;0
294;19.06.2016;2016;06;05;Sunnuntai;0;0;0;0;0;0
294;19.06.2016;2016;06;06;Sunnuntai;1;0;1;2;0;2
294;19.06.2016;2016;06;07;Sunnuntai;1;0;1;3;3;6
294;19.06.2016;2016;06;08;Sunnuntai;3;6;9;7;3;10
294;19.06.2016;2016;06;09;Sunnuntai;2;2;4;4;3;7
294;19.06.2016;2016;06;10;Sunnuntai;2;4;6;6;1;7
294;19.06.2016;2016;06;11;Sunnuntai;12;6;18;6;15;21
294;19.06.2016;2016;06;12;Sunnuntai;19;21;40;8;5;13
294;19.06.2016;2016;06;13;Sunnuntai;18;13;31;7;11;18
294;19.06.2016;2016;06;14;Sunnuntai;20;14;34;13;6;19
294;19.06.2016;2016;06;15;Sunnuntai;7;11;18;6;4;10
294;19.06.2016;2016;06;16;Sunnuntai;6;8;14;4;2;6
294;19.06.2016;2016;06;17;Sunnuntai;1;4;5;5;3;8
294;19.06.2016;2016;06;18;Sunnuntai;9;9;18;5;6;11
294;19.06.2016;2016;06;19;Sunnuntai;14;8;22;6;8;14
294;19.06.2016;2016;06;20;Sunnuntai;10;17;27;11;5;16
294;19.06.2016;2016;06;21;Sunnuntai;11;5;16;3;1;4
294;19.06.2016;2016;06;22;Sunnuntai;2;1;3;3;1;4
294;19.06.2016;2016;06;23;Sunnuntai;0;0;0;0;0;0
294;20.06.2016;2016;06;00;Maanantai;0;3;3;0;0;0
294;20.06.2016;2016;06;01;Maanantai;0;3;3;0;0;0
294;20.06.2016;2016;06;02;Maanantai;0;0;0;1;0;1
294;20.06.2016;2016;06;03;Maanantai;0;0;0;0;0;0
294;20.06.2016;2016;06;04;Maanantai;0;0;0;1;0;1
294;20.06.2016;2016;06;05;Maanantai;0;0;0;0;0;0
294;20.06.2016;2016;06;06;Maanantai;2;2;4;3;2;5
294;20.06.2016;2016;06;07;Maanantai;7;1;8;5;2;7
294;20.06.2016;2016;06;08;Maanantai;8;9;17;7;6;13
294;20.06.2016;2016;06;09;Maanantai;21;9;30;6;5;11
294;20.06.2016;2016;06;10;Maanantai;19;16;35;4;6;10
294;20.06.2016;2016;06;11;Maanantai;25;23;48;13;14;27
294;20.06.2016;2016;06;12;Maanantai;11;18;29;6;5;11
294;20.06.2016;2016;06;13;Maanantai;30;18;48;7;8;15
294;20.06.2016;2016;06;14;Maanantai;29;30;59;10;5;15
294;20.06.2016;2016;06;15;Maanantai;32;30;62;12;10;22
294;20.06.2016;2016;06;16;Maanantai;37;25;62;12;15;27
294;20.06.2016;2016;06;17;Maanantai;32;30;62;11;9;20
294;20.06.2016;2016;06;18;Maanantai;16;26;42;10;14;24
294;20.06.2016;2016;06;19;Maanantai;23;32;55;10;9;19
294;20.06.2016;2016;06;20;Maanantai;23;9;32;16;16;32
294;20.06.2016;2016;06;21;Maanantai;4;9;13;5;5;10
294;20.06.2016;2016;06;22;Maanantai;2;2;4;5;4;9
294;20.06.2016;2016;06;23;Maanantai;1;2;3;1;0;1
294;21.06.2016;2016;06;00;Tiistai;0;0;0;0;0;0
294;21.06.2016;2016;06;01;Tiistai;0;0;0;0;0;0
294;21.06.2016;2016;06;02;Tiistai;2;0;2;0;0;0
294;21.06.2016;2016;06;03;Tiistai;0;0;0;0;0;0
294;21.06.2016;2016;06;04;Tiistai;0;2;2;0;0;0
294;21.06.2016;2016;06;05;Tiistai;0;0;0;0;1;1
294;21.06.2016;2016;06;06;Tiistai;2;3;5;1;0;1
294;21.06.2016;2016;06;07;Tiistai;7;1;8;2;2;4
294;21.06.2016;2016;06;08;Tiistai;4;4;8;3;4;7
294;21.06.2016;2016;06;09;Tiistai;12;7;19;9;8;17
294;21.06.2016;2016;06;10;Tiistai;22;12;34;11;8;19
294;21.06.2016;2016;06;11;Tiistai;17;13;30;8;11;19
294;21.06.2016;2016;06;12;Tiistai;16;14;30;16;15;31
294;21.06.2016;2016;06;13;Tiistai;19;23;42;4;8;12
294;21.06.2016;2016;06;14;Tiistai;20;17;37;10;8;18
294;21.06.2016;2016;06;15;Tiistai;18;20;38;9;10;19
294;21.06.2016;2016;06;16;Tiistai;25;26;51;10;7;17
294;21.06.2016;2016;06;17;Tiistai;20;24;44;5;8;13
294;21.06.2016;2016;06;18;Tiistai;17;29;46;14;9;23
294;21.06.2016;2016;06;19;Tiistai;22;22;44;11;12;23
294;21.06.2016;2016;06;20;Tiistai;13;16;29;8;9;17
294;21.06.2016;2016;06;21;Tiistai;10;4;14;6;5;11
294;21.06.2016;2016;06;22;Tiistai;1;1;2;1;0;1
294;21.06.2016;2016;06;23;Tiistai;7;0;7;1;2;3
294;22.06.2016;2016;06;00;Keskiviikko;0;2;2;0;0;0
294;22.06.2016;2016;06;01;Keskiviikko;0;0;0;0;0;0
294;22.06.2016;2016;06;02;Keskiviikko;0;0;0;0;0;0
294;22.06.2016;2016;06;03;Keskiviikko;0;0;0;0;0;0
294;22.06.2016;2016;06;04;Keskiviikko;0;0;0;0;0;0
294;22.06.2016;2016;06;05;Keskiviikko;0;0;0;0;1;1
294;22.06.2016;2016;06;06;Keskiviikko;2;1;3;0;0;0
294;22.06.2016;2016;06;07;Keskiviikko;9;5;14;3;1;4
294;22.06.2016;2016;06;08;Keskiviikko;3;2;5;2;5;7
294;22.06.2016;2016;06;09;Keskiviikko;15;11;26;11;7;18
294;22.06.2016;2016;06;10;Keskiviikko;17;16;33;15;10;25
294;22.06.2016;2016;06;11;Keskiviikko;16;12;28;12;8;20
294;22.06.2016;2016;06;12;Keskiviikko;25;21;46;3;8;11
294;22.06.2016;2016;06;13;Keskiviikko;15;24;39;7;11;18
294;22.06.2016;2016;06;14;Keskiviikko;33;30;63;12;9;21
294;22.06.2016;2016;06;15;Keskiviikko;17;16;33;9;10;19
294;22.06.2016;2016;06;16;Keskiviikko;19;16;35;4;10;14
294;22.06.2016;2016;06;17;Keskiviikko;23;28;51;9;15;24
294;22.06.2016;2016;06;18;Keskiviikko;18;34;52;19;17;36
294;22.06.2016;2016;06;19;Keskiviikko;20;16;36;7;7;14
294;22.06.2016;2016;06;20;Keskiviikko;18;9;27;10;4;14
294;22.06.2016;2016;06;21;Keskiviikko;10;8;18;4;2;6
294;22.06.2016;2016;06;22;Keskiviikko;2;0;2;1;3;4
294;22.06.2016;2016;06;23;Keskiviikko;2;0;2;0;0;0
294;23.06.2016;2016;06;00;Torstai;1;2;3;0;0;0
294;23.06.2016;2016;06;01;Torstai;1;0;1;1;0;1
294;23.06.2016;2016;06;02;Torstai;0;0;0;0;0;0
294;23.06.2016;2016;06;03;Torstai;0;0;0;0;0;0
294;23.06.2016;2016;06;04;Torstai;2;0;2;0;0;0
294;23.06.2016;2016;06;05;Torstai;0;0;0;2;0;2
294;23.06.2016;2016;06;06;Torstai;2;1;3;1;1;2
294;23.06.2016;2016;06;07;Torstai;10;5;15;1;1;2
294;23.06.2016;2016;06;08;Torstai;5;6;11;1;1;2
294;23.06.2016;2016;06;09;Torstai;20;6;26;4;5;9
294;23.06.2016;2016;06;10;Torstai;15;10;25;6;6;12
294;23.06.2016;2016;06;11;Torstai;14;28;42;15;8;23
294;23.06.2016;2016;06;12;Torstai;14;21;35;7;7;14
294;23.06.2016;2016;06;13;Torstai;24;19;43;6;10;16
294;23.06.2016;2016;06;14;Torstai;29;32;61;13;10;23
294;23.06.2016;2016;06;15;Torstai;27;19;46;13;5;18
294;23.06.2016;2016;06;16;Torstai;32;28;60;5;3;8
294;23.06.2016;2016;06;17;Torstai;19;21;40;8;5;13
294;23.06.2016;2016;06;18;Torstai;23;11;34;6;4;10
294;23.06.2016;2016;06;19;Torstai;18;25;43;3;11;14
294;23.06.2016;2016;06;20;Torstai;26;9;35;7;2;9
294;23.06.2016;2016;06;21;Torstai;8;2;10;2;6;8
294;23.06.2016;2016;06;22;Torstai;9;4;13;2;1;3
294;23.06.2016;2016;06;23;Torstai;3;2;5;0;0;0
294;24.06.2016;2016;06;00;Perjantai;4;1;5;0;1;1
294;24.06.2016;2016;06;01;Perjantai;0;0;0;0;1;1
294;24.06.2016;2016;06;02;Perjantai;0;0;0;0;0;0
294;24.06.2016;2016;06;03;Perjantai;0;0;0;0;0;0
294;24.06.2016;2016;06;04;Perjantai;0;0;0;0;0;0
294;24.06.2016;2016;06;05;Perjantai;1;0;1;0;0;0
294;24.06.2016;2016;06;06;Perjantai;0;0;0;0;2;2
294;24.06.2016;2016;06;07;Perjantai;5;4;9;2;1;3
294;24.06.2016;2016;06;08;Perjantai;3;5;8;3;2;5
294;24.06.2016;2016;06;09;Perjantai;10;6;16;4;5;9
294;24.06.2016;2016;06;10;Perjantai;5;9;14;12;6;18
294;24.06.2016;2016;06;11;Perjantai;16;16;32;8;6;14
294;24.06.2016;2016;06;12;Perjantai;25;14;39;8;9;17
294;24.06.2016;2016;06;13;Perjantai;15;7;22;5;3;8
294;24.06.2016;2016;06;14;Perjantai;15;27;42;5;0;5
294;24.06.2016;2016;06;15;Perjantai;14;13;27;11;3;14
294;24.06.2016;2016;06;16;Perjantai;21;17;38;7;2;9
294;24.06.2016;2016;06;17;Perjantai;12;14;26;8;6;14
294;24.06.2016;2016;06;18;Perjantai;12;8;20;3;7;10
294;24.06.2016;2016;06;19;Perjantai;10;4;14;4;3;7
294;24.06.2016;2016;06;20;Perjantai;11;5;16;3;2;5
294;24.06.2016;2016;06;21;Perjantai;3;2;5;0;1;1
294;24.06.2016;2016;06;22;Perjantai;6;4;10;0;2;2
294;24.06.2016;2016;06;23;Perjantai;1;0;1;1;0;1
294;25.06.2016;2016;06;00;Lauantai;1;6;7;0;0;0
294;25.06.2016;2016;06;01;Lauantai;0;2;2;0;2;2
294;25.06.2016;2016;06;02;Lauantai;3;0;3;1;0;1
294;25.06.2016;2016;06;03;Lauantai;0;1;1;0;0;0
294;25.06.2016;2016;06;04;Lauantai;0;1;1;1;0;1
294;25.06.2016;2016;06;05;Lauantai;0;0;0;0;0;0
294;25.06.2016;2016;06;06;Lauantai;1;0;1;0;2;2
294;25.06.2016;2016;06;07;Lauantai;3;1;4;0;0;0
294;25.06.2016;2016;06;08;Lauantai;3;0;3;0;0;0
294;25.06.2016;2016;06;09;Lauantai;6;2;8;6;0;6
294;25.06.2016;2016;06;10;Lauantai;4;15;19;2;2;4
294;25.06.2016;2016;06;11;Lauantai;11;8;19;1;4;5
294;25.06.2016;2016;06;12;Lauantai;2;3;5;2;0;2
294;25.06.2016;2016;06;13;Lauantai;2;2;4;0;1;1
294;25.06.2016;2016;06;14;Lauantai;1;1;2;4;1;5
294;25.06.2016;2016;06;15;Lauantai;4;3;7;1;0;1
294;25.06.2016;2016;06;16;Lauantai;2;9;11;4;5;9
294;25.06.2016;2016;06;17;Lauantai;10;14;24;9;8;17
294;25.06.2016;2016;06;18;Lauantai;9;10;19;10;7;17
294;25.06.2016;2016;06;19;Lauantai;9;16;25;10;15;25
294;25.06.2016;2016;06;20;Lauantai;13;8;21;5;7;12
294;25.06.2016;2016;06;21;Lauantai;6;5;11;2;3;5
294;25.06.2016;2016;06;22;Lauantai;6;4;10;1;1;2
294;25.06.2016;2016;06;23;Lauantai;0;0;0;3;1;4
294;26.06.2016;2016;06;00;Sunnuntai;2;0;2;3;2;5
294;26.06.2016;2016;06;01;Sunnuntai;0;0;0;1;0;1
294;26.06.2016;2016;06;02;Sunnuntai;1;1;2;1;0;1
294;26.06.2016;2016;06;03;Sunnuntai;0;0;0;0;0;0
294;26.06.2016;2016;06;04;Sunnuntai;0;0;0;0;0;0
294;26.06.2016;2016;06;05;Sunnuntai;1;1;2;2;1;3
294;26.06.2016;2016;06;06;Sunnuntai;2;1;3;0;0;0
294;26.06.2016;2016;06;07;Sunnuntai;0;0;0;1;0;1
294;26.06.2016;2016;06;08;Sunnuntai;5;2;7;0;0;0
294;26.06.2016;2016;06;09;Sunnuntai;9;5;14;4;3;7
294;26.06.2016;2016;06;10;Sunnuntai;8;11;19;8;3;11
294;26.06.2016;2016;06;11;Sunnuntai;8;16;24;3;8;11
294;26.06.2016;2016;06;12;Sunnuntai;13;15;28;7;15;22
294;26.06.2016;2016;06;13;Sunnuntai;14;16;30;13;12;25
294;26.06.2016;2016;06;14;Sunnuntai;16;10;26;3;8;11
294;26.06.2016;2016;06;15;Sunnuntai;20;25;45;14;7;21
294;26.06.2016;2016;06;16;Sunnuntai;32;10;42;9;7;16
294;26.06.2016;2016;06;17;Sunnuntai;9;18;27;11;8;19
294;26.06.2016;2016;06;18;Sunnuntai;18;25;43;12;6;18
294;26.06.2016;2016;06;19;Sunnuntai;15;23;38;10;12;22
294;26.06.2016;2016;06;20;Sunnuntai;13;12;25;6;5;11
294;26.06.2016;2016;06;21;Sunnuntai;2;6;8;2;3;5
294;26.06.2016;2016;06;22;Sunnuntai;3;5;8;0;0;0
294;26.06.2016;2016;06;23;Sunnuntai;1;0;1;1;0;1
294;27.06.2016;2016;06;00;Maanantai;1;0;1;0;0;0
294;27.06.2016;2016;06;01;Maanantai;2;0;2;0;0;0
294;27.06.2016;2016;06;02;Maanantai;0;0;0;0;0;0
294;27.06.2016;2016;06;03;Maanantai;0;0;0;0;0;0
294;27.06.2016;2016;06;04;Maanantai;0;0;0;0;0;0
294;27.06.2016;2016;06;05;Maanantai;0;2;2;0;1;1
294;27.06.2016;2016;06;06;Maanantai;1;2;3;1;1;2
294;27.06.2016;2016;06;07;Maanantai;11;3;14;2;0;2
294;27.06.2016;2016;06;08;Maanantai;8;7;15;2;7;9
294;27.06.2016;2016;06;09;Maanantai;13;9;22;1;4;5
294;27.06.2016;2016;06;10;Maanantai;16;14;30;8;8;16
294;27.06.2016;2016;06;11;Maanantai;10;16;26;8;5;13
294;27.06.2016;2016;06;12;Maanantai;23;21;44;11;11;22
294;27.06.2016;2016;06;13;Maanantai;39;18;57;18;3;21
294;27.06.2016;2016;06;14;Maanantai;18;33;51;2;11;13
294;27.06.2016;2016;06;15;Maanantai;15;20;35;9;8;17
294;27.06.2016;2016;06;16;Maanantai;24;19;43;10;4;14
294;27.06.2016;2016;06;17;Maanantai;23;30;53;5;5;10
294;27.06.2016;2016;06;18;Maanantai;25;23;48;10;8;18
294;27.06.2016;2016;06;19;Maanantai;18;10;28;4;5;9
294;27.06.2016;2016;06;20;Maanantai;15;10;25;6;13;19
294;27.06.2016;2016;06;21;Maanantai;5;15;20;5;5;10
294;27.06.2016;2016;06;22;Maanantai;5;6;11;1;0;1
294;27.06.2016;2016;06;23;Maanantai;2;0;2;0;0;0
294;28.06.2016;2016;06;00;Tiistai;0;0;0;0;0;0
294;28.06.2016;2016;06;01;Tiistai;0;0;0;0;0;0
294;28.06.2016;2016;06;02;Tiistai;0;0;0;0;0;0
294;28.06.2016;2016;06;03;Tiistai;0;0;0;0;0;0
294;28.06.2016;2016;06;04;Tiistai;0;0;0;0;0;0
294;28.06.2016;2016;06;05;Tiistai;0;0;0;0;1;1
294;28.06.2016;2016;06;06;Tiistai;2;0;2;1;1;2
294;28.06.2016;2016;06;07;Tiistai;2;2;4;3;4;7
294;28.06.2016;2016;06;08;Tiistai;2;3;5;4;1;5
294;28.06.2016;2016;06;09;Tiistai;3;3;6;6;4;10
294;28.06.2016;2016;06;10;Tiistai;8;11;19;7;7;14
294;28.06.2016;2016;06;11;Tiistai;11;12;23;10;8;18
294;28.06.2016;2016;06;12;Tiistai;11;12;23;9;3;12
294;28.06.2016;2016;06;13;Tiistai;17;12;29;5;6;11
294;28.06.2016;2016;06;14;Tiistai;7;11;18;5;8;13
294;28.06.2016;2016;06;15;Tiistai;10;24;34;4;7;11
294;28.06.2016;2016;06;16;Tiistai;21;10;31;11;2;13
294;28.06.2016;2016;06;17;Tiistai;25;13;38;8;13;21
294;28.06.2016;2016;06;18;Tiistai;14;25;39;19;10;29
294;28.06.2016;2016;06;19;Tiistai;22;20;42;7;11;18
294;28.06.2016;2016;06;20;Tiistai;24;23;47;13;12;25
294;28.06.2016;2016;06;21;Tiistai;5;8;13;8;4;12
294;28.06.2016;2016;06;22;Tiistai;5;3;8;1;2;3
294;28.06.2016;2016;06;23;Tiistai;0;1;1;0;0;0
294;29.06.2016;2016;06;00;Keskiviikko;0;0;0;0;1;1
294;29.06.2016;2016;06;01;Keskiviikko;2;0;2;0;0;0
294;29.06.2016;2016;06;02;Keskiviikko;0;2;2;0;0;0
294;29.06.2016;2016;06;03;Keskiviikko;0;0;0;0;0;0
294;29.06.2016;2016;06;04;Keskiviikko;0;0;0;0;0;0
294;29.06.2016;2016;06;05;Keskiviikko;0;0;0;1;0;1
294;29.06.2016;2016;06;06;Keskiviikko;1;2;3;0;1;1
294;29.06.2016;2016;06;07;Keskiviikko;10;1;11;2;2;4
294;29.06.2016;2016;06;08;Keskiviikko;5;7;12;2;5;7
294;29.06.2016;2016;06;09;Keskiviikko;14;9;23;10;6;16
294;29.06.2016;2016;06;10;Keskiviikko;12;15;27;9;5;14
294;29.06.2016;2016;06;11;Keskiviikko;22;11;33;11;14;25
294;29.06.2016;2016;06;12;Keskiviikko;18;16;34;18;15;33
294;29.06.2016;2016;06;13;Keskiviikko;16;30;46;2;9;11
294;29.06.2016;2016;06;14;Keskiviikko;13;19;32;6;12;18
294;29.06.2016;2016;06;15;Keskiviikko;30;24;54;15;16;31
294;29.06.2016;2016;06;16;Keskiviikko;19;18;37;9;4;13
294;29.06.2016;2016;06;17;Keskiviikko;7;7;14;1;3;4
294;29.06.2016;2016;06;18;Keskiviikko;13;15;28;8;12;20
294;29.06.2016;2016;06;19;Keskiviikko;8;13;21;22;8;30
294;29.06.2016;2016;06;20;Keskiviikko;10;13;23;8;8;16
294;29.06.2016;2016;06;21;Keskiviikko;12;12;24;1;1;2
294;29.06.2016;2016;06;22;Keskiviikko;3;5;8;2;2;4
294;29.06.2016;2016;06;23;Keskiviikko;0;0;0;1;1;2
294;30.06.2016;2016;06;00;Torstai;0;0;0;1;0;1
294;30.06.2016;2016;06;01;Torstai;0;0;0;0;0;0
294;30.06.2016;2016;06;02;Torstai;0;0;0;0;0;0
294;30.06.2016;2016;06;03;Torstai;0;0;0;0;0;0
294;30.06.2016;2016;06;04;Torstai;0;0;0;0;0;0
294;30.06.2016;2016;06;05;Torstai;0;1;1;1;1;2
294;30.06.2016;2016;06;06;Torstai;3;2;5;2;2;4
294;30.06.2016;2016;06;07;Torstai;6;1;7;3;0;3
294;30.06.2016;2016;06;08;Torstai;10;9;19;2;2;4
294;30.06.2016;2016;06;09;Torstai;15;6;21;2;9;11
294;30.06.2016;2016;06;10;Torstai;16;16;32;11;5;16
294;30.06.2016;2016;06;11;Torstai;17;22;39;23;12;35
294;30.06.2016;2016;06;12;Torstai;29;25;54;15;13;28
294;30.06.2016;2016;06;13;Torstai;19;31;50;16;12;28
294;30.06.2016;2016;06;14;Torstai;20;14;34;15;2;17
294;30.06.2016;2016;06;15;Torstai;20;24;44;10;10;20
294;30.06.2016;2016;06;16;Torstai;6;6;12;3;1;4
294;30.06.2016;2016;06;17;Torstai;2;5;7;4;3;7
294;30.06.2016;2016;06;18;Torstai;6;7;13;10;14;24
294;30.06.2016;2016;06;19;Torstai;21;16;37;7;10;17
294;30.06.2016;2016;06;20;Torstai;11;9;20;9;7;16
294;30.06.2016;2016;06;21;Torstai;9;10;19;4;4;8
294;30.06.2016;2016;06;22;Torstai;3;2;5;3;2;5
294;30.06.2016;2016;06;23;Torstai;0;0;0;0;0;0
294;01.07.2016;2016;07;00;Perjantai;1;0;1;0;0;0
294;01.07.2016;2016;07;01;Perjantai;0;0;0;0;0;0
294;01.07.2016;2016;07;02;Perjantai;0;0;0;0;0;0
294;01.07.2016;2016;07;03;Perjantai;0;0;0;0;0;0
294;01.07.2016;2016;07;04;Perjantai;0;0;0;0;0;0
294;01.07.2016;2016;07;05;Perjantai;0;0;0;0;1;1
294;01.07.2016;2016;07;06;Perjantai;1;1;2;2;1;3
294;01.07.2016;2016;07;07;Perjantai;5;0;5;3;0;3
294;01.07.2016;2016;07;08;Perjantai;11;8;19;0;2;2
294;01.07.2016;2016;07;09;Perjantai;13;6;19;5;8;13
294;01.07.2016;2016;07;10;Perjantai;7;12;19;12;6;18
294;01.07.2016;2016;07;11;Perjantai;14;16;30;9;5;14
294;01.07.2016;2016;07;12;Perjantai;11;13;24;9;7;16
294;01.07.2016;2016;07;13;Perjantai;25;23;48;8;6;14
294;01.07.2016;2016;07;14;Perjantai;14;22;36;13;8;21
294;01.07.2016;2016;07;15;Perjantai;4;6;10;9;5;14
294;01.07.2016;2016;07;16;Perjantai;9;10;19;4;3;7
294;01.07.2016;2016;07;17;Perjantai;24;14;38;6;6;12
294;01.07.2016;2016;07;18;Perjantai;14;22;36;7;11;18
294;01.07.2016;2016;07;19;Perjantai;15;9;24;11;9;20
294;01.07.2016;2016;07;20;Perjantai;15;13;28;10;5;15
294;01.07.2016;2016;07;21;Perjantai;8;8;16;2;8;10
294;01.07.2016;2016;07;22;Perjantai;6;7;13;1;1;2
294;01.07.2016;2016;07;23;Perjantai;5;1;6;0;0;0
294;02.07.2016;2016;07;00;Lauantai;1;1;2;0;0;0
294;02.07.2016;2016;07;01;Lauantai;0;1;1;1;0;1
294;02.07.2016;2016;07;02;Lauantai;1;1;2;1;0;1
294;02.07.2016;2016;07;03;Lauantai;1;0;1;0;0;0
294;02.07.2016;2016;07;04;Lauantai;0;0;0;1;0;1
294;02.07.2016;2016;07;05;Lauantai;1;0;1;0;2;2
294;02.07.2016;2016;07;06;Lauantai;1;1;2;2;1;3
294;02.07.2016;2016;07;07;Lauantai;4;2;6;2;1;3
294;02.07.2016;2016;07;08;Lauantai;0;0;0;4;7;11
294;02.07.2016;2016;07;09;Lauantai;6;4;10;7;4;11
294;02.07.2016;2016;07;10;Lauantai;9;12;21;9;3;12
294;02.07.2016;2016;07;11;Lauantai;13;15;28;6;11;17
294;02.07.2016;2016;07;12;Lauantai;16;22;38;12;7;19
294;02.07.2016;2016;07;13;Lauantai;17;16;33;13;8;21
294;02.07.2016;2016;07;14;Lauantai;22;15;37;3;7;10
294;02.07.2016;2016;07;15;Lauantai;8;15;23;9;6;15
294;02.07.2016;2016;07;16;Lauantai;13;8;21;2;7;9
294;02.07.2016;2016;07;17;Lauantai;15;19;34;9;1;10
294;02.07.2016;2016;07;18;Lauantai;22;12;34;6;6;12
294;02.07.2016;2016;07;19;Lauantai;14;13;27;6;4;10
294;02.07.2016;2016;07;20;Lauantai;19;14;33;4;3;7
294;02.07.2016;2016;07;21;Lauantai;8;7;15;4;2;6
294;02.07.2016;2016;07;22;Lauantai;2;9;11;1;0;1
294;02.07.2016;2016;07;23;Lauantai;2;1;3;1;1;2
294;03.07.2016;2016;07;00;Sunnuntai;6;0;6;1;0;1
294;03.07.2016;2016;07;01;Sunnuntai;0;1;1;0;0;0
294;03.07.2016;2016;07;02;Sunnuntai;0;0;0;5;9;14
294;03.07.2016;2016;07;03;Sunnuntai;1;1;2;0;1;1
294;03.07.2016;2016;07;04;Sunnuntai;0;0;0;0;0;0
294;03.07.2016;2016;07;05;Sunnuntai;0;0;0;0;0;0
294;03.07.2016;2016;07;06;Sunnuntai;0;0;0;0;0;0
294;03.07.2016;2016;07;07;Sunnuntai;1;2;3;1;1;2
294;03.07.2016;2016;07;08;Sunnuntai;1;2;3;1;3;4
294;03.07.2016;2016;07;09;Sunnuntai;2;3;5;1;2;3
294;03.07.2016;2016;07;10;Sunnuntai;0;2;2;4;1;5
294;03.07.2016;2016;07;11;Sunnuntai;9;11;20;2;2;4
294;03.07.2016;2016;07;12;Sunnuntai;3;3;6;1;2;3
294;03.07.2016;2016;07;13;Sunnuntai;5;3;8;3;2;5
294;03.07.2016;2016;07;14;Sunnuntai;8;10;18;5;4;9
294;03.07.2016;2016;07;15;Sunnuntai;6;6;12;5;7;12
294;03.07.2016;2016;07;16;Sunnuntai;19;8;27;8;5;13
294;03.07.2016;2016;07;17;Sunnuntai;19;14;33;10;4;14
294;03.07.2016;2016;07;18;Sunnuntai;12;18;30;8;2;10
294;03.07.2016;2016;07;19;Sunnuntai;22;18;40;13;12;25
294;03.07.2016;2016;07;20;Sunnuntai;12;8;20;4;4;8
294;03.07.2016;2016;07;21;Sunnuntai;18;4;22;5;1;6
294;03.07.2016;2016;07;22;Sunnuntai;5;8;13;1;1;2
294;03.07.2016;2016;07;23;Sunnuntai;1;0;1;0;0;0
294;04.07.2016;2016;07;00;Maanantai;0;0;0;0;0;0
294;04.07.2016;2016;07;01;Maanantai;0;0;0;0;0;0
294;04.07.2016;2016;07;02;Maanantai;0;0;0;0;0;0
294;04.07.2016;2016;07;03;Maanantai;0;0;0;0;0;0
294;04.07.2016;2016;07;04;Maanantai;0;0;0;0;0;0
294;04.07.2016;2016;07;05;Maanantai;0;0;0;1;2;3
294;04.07.2016;2016;07;06;Maanantai;2;1;3;1;0;1
294;04.07.2016;2016;07;07;Maanantai;3;1;4;3;0;3
294;04.07.2016;2016;07;08;Maanantai;7;1;8;1;1;2
294;04.07.2016;2016;07;09;Maanantai;5;3;8;5;3;8
294;04.07.2016;2016;07;10;Maanantai;3;5;8;5;6;11
294;04.07.2016;2016;07;11;Maanantai;6;5;11;6;6;12
294;04.07.2016;2016;07;12;Maanantai;3;13;16;6;4;10
294;04.07.2016;2016;07;13;Maanantai;3;3;6;3;6;9
294;04.07.2016;2016;07;14;Maanantai;10;14;24;8;6;14
294;04.07.2016;2016;07;15;Maanantai;20;12;32;7;5;12
294;04.07.2016;2016;07;16;Maanantai;5;14;19;3;5;8
294;04.07.2016;2016;07;17;Maanantai;22;16;38;10;9;19
294;04.07.2016;2016;07;18;Maanantai;11;14;25;15;5;20
294;04.07.2016;2016;07;19;Maanantai;15;10;25;3;11;14
294;04.07.2016;2016;07;20;Maanantai;20;12;32;10;8;18
294;04.07.2016;2016;07;21;Maanantai;2;3;5;0;0;0
294;04.07.2016;2016;07;22;Maanantai;0;0;0;1;1;2
294;04.07.2016;2016;07;23;Maanantai;1;1;2;0;0;0
294;05.07.2016;2016;07;00;Tiistai;0;0;0;0;1;1
294;05.07.2016;2016;07;01;Tiistai;0;0;0;0;0;0
294;05.07.2016;2016;07;02;Tiistai;0;0;0;0;0;0
294;05.07.2016;2016;07;03;Tiistai;0;0;0;1;0;1
294;05.07.2016;2016;07;04;Tiistai;0;0;0;1;0;1
294;05.07.2016;2016;07;05;Tiistai;0;0;0;0;0;0
294;05.07.2016;2016;07;06;Tiistai;1;1;2;1;0;1
294;05.07.2016;2016;07;07;Tiistai;4;1;5;3;5;8
294;05.07.2016;2016;07;08;Tiistai;5;4;9;6;1;7
294;05.07.2016;2016;07;09;Tiistai;8;7;15;2;10;12
294;05.07.2016;2016;07;10;Tiistai;11;10;21;7;7;14
294;05.07.2016;2016;07;11;Tiistai;14;12;26;8;5;13
294;05.07.2016;2016;07;12;Tiistai;22;22;44;19;15;34
294;05.07.2016;2016;07;13;Tiistai;13;9;22;7;11;18
294;05.07.2016;2016;07;14;Tiistai;6;9;15;16;6;22
294;05.07.2016;2016;07;15;Tiistai;11;16;27;8;9;17
294;05.07.2016;2016;07;16;Tiistai;2;2;4;2;4;6
294;05.07.2016;2016;07;17;Tiistai;1;2;3;1;0;1
294;05.07.2016;2016;07;18;Tiistai;2;1;3;0;3;3
294;05.07.2016;2016;07;19;Tiistai;14;5;19;8;1;9
294;05.07.2016;2016;07;20;Tiistai;4;12;16;1;3;4
294;05.07.2016;2016;07;21;Tiistai;4;0;4;2;3;5
294;05.07.2016;2016;07;22;Tiistai;1;4;5;3;0;3
294;05.07.2016;2016;07;23;Tiistai;0;3;3;0;2;2
294;06.07.2016;2016;07;00;Keskiviikko;2;1;3;0;0;0
294;06.07.2016;2016;07;01;Keskiviikko;0;0;0;1;0;1
294;06.07.2016;2016;07;02;Keskiviikko;0;0;0;0;0;0
294;06.07.2016;2016;07;03;Keskiviikko;0;0;0;0;0;0
294;06.07.2016;2016;07;04;Keskiviikko;0;0;0;1;0;1
294;06.07.2016;2016;07;05;Keskiviikko;0;0;0;0;0;0
294;06.07.2016;2016;07;06;Keskiviikko;0;1;1;2;1;3
294;06.07.2016;2016;07;07;Keskiviikko;0;1;1;0;0;0
294;06.07.2016;2016;07;08;Keskiviikko;2;1;3;3;0;3
294;06.07.2016;2016;07;09;Keskiviikko;9;4;13;1;1;2
294;06.07.2016;2016;07;10;Keskiviikko;8;6;14;6;7;13
294;06.07.2016;2016;07;11;Keskiviikko;15;15;30;12;6;18
294;06.07.2016;2016;07;12;Keskiviikko;19;17;36;12;13;25
294;06.07.2016;2016;07;13;Keskiviikko;20;21;41;10;8;18
294;06.07.2016;2016;07;14;Keskiviikko;16;12;28;6;5;11
294;06.07.2016;2016;07;15;Keskiviikko;18;18;36;7;3;10
294;06.07.2016;2016;07;16;Keskiviikko;10;10;20;3;9;12
294;06.07.2016;2016;07;17;Keskiviikko;4;6;10;7;3;10
294;06.07.2016;2016;07;18;Keskiviikko;1;6;7;3;3;6
294;06.07.2016;2016;07;19;Keskiviikko;11;5;16;7;10;17
294;06.07.2016;2016;07;20;Keskiviikko;12;13;25;5;6;11
294;06.07.2016;2016;07;21;Keskiviikko;4;7;11;6;2;8
294;06.07.2016;2016;07;22;Keskiviikko;0;2;2;1;0;1
294;06.07.2016;2016;07;23;Keskiviikko;0;2;2;0;1;1
294;07.07.2016;2016;07;00;Torstai;1;0;1;0;0;0
294;07.07.2016;2016;07;01;Torstai;0;0;0;0;0;0
294;07.07.2016;2016;07;02;Torstai;0;0;0;0;0;0
294;07.07.2016;2016;07;03;Torstai;0;0;0;0;0;0
294;07.07.2016;2016;07;04;Torstai;0;0;0;0;0;0
294;07.07.2016;2016;07;05;Torstai;0;0;0;0;0;0
294;07.07.2016;2016;07;06;Torstai;3;0;3;3;3;6
294;07.07.2016;2016;07;07;Torstai;3;1;4;2;7;9
294;07.07.2016;2016;07;08;Torstai;4;5;9;0;1;1
294;07.07.2016;2016;07;09;Torstai;4;3;7;6;8;14
294;07.07.2016;2016;07;10;Torstai;5;12;17;5;7;12
294;07.07.2016;2016;07;11;Torstai;7;1;8;4;1;5
294;07.07.2016;2016;07;12;Torstai;5;12;17;4;3;7
294;07.07.2016;2016;07;13;Torstai;10;13;23;11;4;15
294;07.07.2016;2016;07;14;Torstai;19;11;30;17;8;25
294;07.07.2016;2016;07;15;Torstai;7;9;16;7;13;20
294;07.07.2016;2016;07;16;Torstai;16;10;26;5;10;15
294;07.07.2016;2016;07;17;Torstai;9;7;16;8;7;15
294;07.07.2016;2016;07;18;Torstai;10;14;24;9;4;13
294;07.07.2016;2016;07;19;Torstai;17;14;31;15;15;30
294;07.07.2016;2016;07;20;Torstai;15;13;28;9;5;14
294;07.07.2016;2016;07;21;Torstai;8;7;15;5;9;14
294;07.07.2016;2016;07;22;Torstai;5;5;10;0;0;0
294;07.07.2016;2016;07;23;Torstai;3;3;6;0;0;0
294;08.07.2016;2016;07;00;Perjantai;1;1;2;0;0;0
294;08.07.2016;2016;07;01;Perjantai;2;0;2;1;0;1
294;08.07.2016;2016;07;02;Perjantai;0;0;0;0;0;0
294;08.07.2016;2016;07;03;Perjantai;0;0;0;0;0;0
294;08.07.2016;2016;07;04;Perjantai;0;0;0;0;0;0
294;08.07.2016;2016;07;05;Perjantai;0;0;0;1;0;1
294;08.07.2016;2016;07;06;Perjantai;3;0;3;3;0;3
294;08.07.2016;2016;07;07;Perjantai;2;2;4;2;1;3
294;08.07.2016;2016;07;08;Perjantai;6;7;13;5;6;11
294;08.07.2016;2016;07;09;Perjantai;8;9;17;11;6;17
294;08.07.2016;2016;07;10;Perjantai;21;14;35;11;8;19
294;08.07.2016;2016;07;11;Perjantai;14;16;30;11;5;16
294;08.07.2016;2016;07;12;Perjantai;18;26;44;14;6;20
294;08.07.2016;2016;07;13;Perjantai;20;15;35;6;4;10
294;08.07.2016;2016;07;14;Perjantai;12;9;21;6;11;17
294;08.07.2016;2016;07;15;Perjantai;21;5;26;3;4;7
294;08.07.2016;2016;07;16;Perjantai;21;25;46;13;7;20
294;08.07.2016;2016;07;17;Perjantai;22;34;56;13;12;25
294;08.07.2016;2016;07;18;Perjantai;21;25;46;7;9;16
294;08.07.2016;2016;07;19;Perjantai;15;11;26;4;2;6
294;08.07.2016;2016;07;20;Perjantai;6;6;12;4;1;5
294;08.07.2016;2016;07;21;Perjantai;10;6;16;5;2;7
294;08.07.2016;2016;07;22;Perjantai;6;2;8;2;3;5
294;08.07.2016;2016;07;23;Perjantai;1;4;5;3;1;4
294;09.07.2016;2016;07;00;Lauantai;3;4;7;0;1;1
294;09.07.2016;2016;07;01;Lauantai;1;2;3;3;0;3
294;09.07.2016;2016;07;02;Lauantai;1;0;1;1;1;2
294;09.07.2016;2016;07;03;Lauantai;0;0;0;0;0;0
294;09.07.2016;2016;07;04;Lauantai;0;0;0;1;0;1
294;09.07.2016;2016;07;05;Lauantai;0;0;0;0;0;0
294;09.07.2016;2016;07;06;Lauantai;0;0;0;1;2;3
294;09.07.2016;2016;07;07;Lauantai;0;3;3;2;3;5
294;09.07.2016;2016;07;08;Lauantai;4;3;7;2;4;6
294;09.07.2016;2016;07;09;Lauantai;4;5;9;2;4;6
294;09.07.2016;2016;07;10;Lauantai;8;11;19;7;9;16
294;09.07.2016;2016;07;11;Lauantai;13;11;24;5;9;14
294;09.07.2016;2016;07;12;Lauantai;19;21;40;5;6;11
294;09.07.2016;2016;07;13;Lauantai;18;19;37;8;10;18
294;09.07.2016;2016;07;14;Lauantai;13;14;27;15;8;23
294;09.07.2016;2016;07;15;Lauantai;19;14;33;11;9;20
294;09.07.2016;2016;07;16;Lauantai;17;16;33;5;6;11
294;09.07.2016;2016;07;17;Lauantai;13;14;27;6;3;9
294;09.07.2016;2016;07;18;Lauantai;14;23;37;8;5;13
294;09.07.2016;2016;07;19;Lauantai;15;4;19;3;4;7
294;09.07.2016;2016;07;20;Lauantai;10;6;16;5;5;10
294;09.07.2016;2016;07;21;Lauantai;11;4;15;0;3;3
294;09.07.2016;2016;07;22;Lauantai;5;2;7;2;0;2
294;09.07.2016;2016;07;23;Lauantai;1;0;1;0;2;2
294;10.07.2016;2016;07;00;Sunnuntai;1;0;1;1;0;1
294;10.07.2016;2016;07;01;Sunnuntai;0;2;2;0;1;1
294;10.07.2016;2016;07;02;Sunnuntai;3;0;3;1;1;2
294;10.07.2016;2016;07;03;Sunnuntai;1;1;2;0;0;0
294;10.07.2016;2016;07;04;Sunnuntai;0;0;0;2;0;2
294;10.07.2016;2016;07;05;Sunnuntai;0;0;0;0;0;0
294;10.07.2016;2016;07;06;Sunnuntai;0;0;0;1;1;2
294;10.07.2016;2016;07;07;Sunnuntai;3;1;4;0;4;4
294;10.07.2016;2016;07;08;Sunnuntai;2;3;5;0;2;2
294;10.07.2016;2016;07;09;Sunnuntai;6;8;14;5;3;8
294;10.07.2016;2016;07;10;Sunnuntai;11;11;22;9;8;17
294;10.07.2016;2016;07;11;Sunnuntai;10;16;26;10;9;19
294;10.07.2016;2016;07;12;Sunnuntai;15;14;29;11;5;16
294;10.07.2016;2016;07;13;Sunnuntai;17;23;40;10;8;18
294;10.07.2016;2016;07;14;Sunnuntai;26;18;44;36;10;46
294;10.07.2016;2016;07;15;Sunnuntai;13;12;25;5;6;11
294;10.07.2016;2016;07;16;Sunnuntai;22;24;46;7;4;11
294;10.07.2016;2016;07;17;Sunnuntai;28;21;49;10;5;15
294;10.07.2016;2016;07;18;Sunnuntai;23;21;44;4;5;9
294;10.07.2016;2016;07;19;Sunnuntai;29;18;47;10;7;17
294;10.07.2016;2016;07;20;Sunnuntai;16;19;35;3;5;8
294;10.07.2016;2016;07;21;Sunnuntai;9;4;13;5;2;7
294;10.07.2016;2016;07;22;Sunnuntai;8;6;14;0;1;1
294;10.07.2016;2016;07;23;Sunnuntai;0;0;0;0;0;0
294;11.07.2016;2016;07;00;Maanantai;0;0;0;0;0;0
294;11.07.2016;2016;07;01;Maanantai;0;0;0;1;0;1
294;11.07.2016;2016;07;02;Maanantai;0;0;0;0;0;0
294;11.07.2016;2016;07;03;Maanantai;0;0;0;0;0;0
294;11.07.2016;2016;07;04;Maanantai;1;0;1;0;0;0
294;11.07.2016;2016;07;05;Maanantai;0;0;0;0;0;0
294;11.07.2016;2016;07;06;Maanantai;6;1;7;1;0;1
294;11.07.2016;2016;07;07;Maanantai;5;2;7;6;1;7
294;11.07.2016;2016;07;08;Maanantai;5;6;11;3;3;6
294;11.07.2016;2016;07;09;Maanantai;9;2;11;5;3;8
294;11.07.2016;2016;07;10;Maanantai;10;10;20;10;4;14
294;11.07.2016;2016;07;11;Maanantai;23;11;34;4;11;15
294;11.07.2016;2016;07;12;Maanantai;23;30;53;18;9;27
294;11.07.2016;2016;07;13;Maanantai;20;27;47;13;13;26
294;11.07.2016;2016;07;14;Maanantai;25;23;48;8;12;20
294;11.07.2016;2016;07;15;Maanantai;24;15;39;11;8;19
294;11.07.2016;2016;07;16;Maanantai;24;26;50;8;8;16
294;11.07.2016;2016;07;17;Maanantai;21;27;48;10;12;22
294;11.07.2016;2016;07;18;Maanantai;34;31;65;15;11;26
294;11.07.2016;2016;07;19;Maanantai;25;30;55;12;10;22
294;11.07.2016;2016;07;20;Maanantai;28;26;54;5;9;14
294;11.07.2016;2016;07;21;Maanantai;10;7;17;7;4;11
294;11.07.2016;2016;07;22;Maanantai;5;6;11;4;3;7
294;11.07.2016;2016;07;23;Maanantai;0;0;0;3;0;3
294;12.07.2016;2016;07;00;Tiistai;1;0;1;0;0;0
294;12.07.2016;2016;07;01;Tiistai;0;0;0;0;0;0
294;12.07.2016;2016;07;02;Tiistai;0;0;0;0;1;1
294;12.07.2016;2016;07;03;Tiistai;0;0;0;0;0;0
294;12.07.2016;2016;07;04;Tiistai;0;0;0;0;0;0
294;12.07.2016;2016;07;05;Tiistai;0;1;1;1;1;2
294;12.07.2016;2016;07;06;Tiistai;5;1;6;1;0;1
294;12.07.2016;2016;07;07;Tiistai;4;4;8;3;3;6
294;12.07.2016;2016;07;08;Tiistai;4;6;10;9;5;14
294;12.07.2016;2016;07;09;Tiistai;10;7;17;5;3;8
294;12.07.2016;2016;07;10;Tiistai;20;18;38;11;12;23
294;12.07.2016;2016;07;11;Tiistai;18;27;45;10;14;24
294;12.07.2016;2016;07;12;Tiistai;33;25;58;8;15;23
294;12.07.2016;2016;07;13;Tiistai;22;16;38;7;11;18
294;12.07.2016;2016;07;14;Tiistai;19;17;36;13;8;21
294;12.07.2016;2016;07;15;Tiistai;8;21;29;7;10;17
294;12.07.2016;2016;07;16;Tiistai;22;16;38;1;4;5
294;12.07.2016;2016;07;17;Tiistai;22;30;52;14;5;19
294;12.07.2016;2016;07;18;Tiistai;15;24;39;9;6;15
294;12.07.2016;2016;07;19;Tiistai;26;8;34;10;9;19
294;12.07.2016;2016;07;20;Tiistai;14;23;37;5;12;17
294;12.07.2016;2016;07;21;Tiistai;13;5;18;2;7;9
294;12.07.2016;2016;07;22;Tiistai;4;9;13;4;2;6
294;12.07.2016;2016;07;23;Tiistai;9;0;9;1;1;2
294;13.07.2016;2016;07;00;Keskiviikko;2;0;2;1;1;2
294;13.07.2016;2016;07;01;Keskiviikko;0;0;0;0;0;0
294;13.07.2016;2016;07;02;Keskiviikko;0;0;0;0;0;0
294;13.07.2016;2016;07;03;Keskiviikko;3;0;3;0;0;0
294;13.07.2016;2016;07;04;Keskiviikko;0;0;0;1;0;1
294;13.07.2016;2016;07;05;Keskiviikko;0;0;0;0;0;0
294;13.07.2016;2016;07;06;Keskiviikko;3;3;6;1;2;3
294;13.07.2016;2016;07;07;Keskiviikko;4;4;8;2;2;4
294;13.07.2016;2016;07;08;Keskiviikko;6;7;13;0;3;3
294;13.07.2016;2016;07;09;Keskiviikko;2;6;8;5;2;7
294;13.07.2016;2016;07;10;Keskiviikko;11;11;22;4;8;12
294;13.07.2016;2016;07;11;Keskiviikko;21;8;29;12;12;24
294;13.07.2016;2016;07;12;Keskiviikko;16;22;38;11;9;20
294;13.07.2016;2016;07;13;Keskiviikko;10;19;29;7;6;13
294;13.07.2016;2016;07;14;Keskiviikko;17;20;37;19;16;35
294;13.07.2016;2016;07;15;Keskiviikko;21;26;47;24;7;31
294;13.07.2016;2016;07;16;Keskiviikko;20;17;37;6;8;14
294;13.07.2016;2016;07;17;Keskiviikko;14;28;42;4;13;17
294;13.07.2016;2016;07;18;Keskiviikko;30;30;60;10;15;25
294;13.07.2016;2016;07;19;Keskiviikko;15;16;31;16;10;26
294;13.07.2016;2016;07;20;Keskiviikko;16;18;34;11;10;21
294;13.07.2016;2016;07;21;Keskiviikko;10;8;18;5;4;9
294;13.07.2016;2016;07;22;Keskiviikko;14;5;19;3;2;5
294;13.07.2016;2016;07;23;Keskiviikko;2;1;3;0;1;1
294;14.07.2016;2016;07;00;Torstai;1;0;1;0;0;0
294;14.07.2016;2016;07;01;Torstai;0;0;0;0;0;0
294;14.07.2016;2016;07;02;Torstai;0;0;0;0;0;0
294;14.07.2016;2016;07;03;Torstai;0;0;0;0;0;0
294;14.07.2016;2016;07;04;Torstai;0;0;0;0;0;0
294;14.07.2016;2016;07;05;Torstai;0;0;0;0;0;0
294;14.07.2016;2016;07;06;Torstai;3;1;4;2;0;2
294;14.07.2016;2016;07;07;Torstai;4;2;6;1;1;2
294;14.07.2016;2016;07;08;Torstai;5;6;11;4;4;8
294;14.07.2016;2016;07;09;Torstai;10;12;22;7;6;13
294;14.07.2016;2016;07;10;Torstai;10;9;19;4;6;10
294;14.07.2016;2016;07;11;Torstai;18;17;35;12;5;17
294;14.07.2016;2016;07;12;Torstai;11;18;29;10;9;19
294;14.07.2016;2016;07;13;Torstai;13;20;33;14;4;18
294;14.07.2016;2016;07;14;Torstai;23;15;38;7;3;10
294;14.07.2016;2016;07;15;Torstai;29;30;59;17;10;27
294;14.07.2016;2016;07;16;Torstai;34;18;52;5;8;13
294;14.07.2016;2016;07;17;Torstai;13;20;33;5;9;14
294;14.07.2016;2016;07;18;Torstai;16;20;36;11;5;16
294;14.07.2016;2016;07;19;Torstai;23;32;55;10;4;14
294;14.07.2016;2016;07;20;Torstai;22;9;31;10;5;15
294;14.07.2016;2016;07;21;Torstai;9;6;15;6;4;10
294;14.07.2016;2016;07;22;Torstai;6;8;14;1;1;2
294;14.07.2016;2016;07;23;Torstai;3;5;8;1;1;2
294;15.07.2016;2016;07;00;Perjantai;2;0;2;0;2;2
294;15.07.2016;2016;07;01;Perjantai;0;1;1;0;0;0
294;15.07.2016;2016;07;02;Perjantai;3;0;3;1;0;1
294;15.07.2016;2016;07;03;Perjantai;0;0;0;0;1;1
294;15.07.2016;2016;07;04;Perjantai;0;0;0;0;0;0
294;15.07.2016;2016;07;05;Perjantai;1;0;1;0;0;0
294;15.07.2016;2016;07;06;Perjantai;0;1;1;1;1;2
294;15.07.2016;2016;07;07;Perjantai;1;2;3;2;1;3
294;15.07.2016;2016;07;08;Perjantai;4;3;7;2;2;4
294;15.07.2016;2016;07;09;Perjantai;10;4;14;5;1;6
294;15.07.2016;2016;07;10;Perjantai;16;6;22;4;8;12
294;15.07.2016;2016;07;11;Perjantai;13;20;33;10;13;23
294;15.07.2016;2016;07;12;Perjantai;20;16;36;11;10;21
294;15.07.2016;2016;07;13;Perjantai;25;28;53;11;16;27
294;15.07.2016;2016;07;14;Perjantai;25;13;38;8;11;19
294;15.07.2016;2016;07;15;Perjantai;12;14;26;7;4;11
294;15.07.2016;2016;07;16;Perjantai;10;11;21;5;3;8
294;15.07.2016;2016;07;17;Perjantai;12;14;26;3;4;7
294;15.07.2016;2016;07;18;Perjantai;13;14;27;4;4;8
294;15.07.2016;2016;07;19;Perjantai;7;10;17;11;7;18
294;15.07.2016;2016;07;20;Perjantai;14;8;22;2;6;8
294;15.07.2016;2016;07;21;Perjantai;8;8;16;0;4;4
294;15.07.2016;2016;07;22;Perjantai;9;7;16;1;1;2
294;15.07.2016;2016;07;23;Perjantai;5;2;7;2;1;3
294;16.07.2016;2016;07;00;Lauantai;2;1;3;0;1;1
294;16.07.2016;2016;07;01;Lauantai;0;0;0;3;0;3
294;16.07.2016;2016;07;02;Lauantai;2;0;2;0;1;1
294;16.07.2016;2016;07;03;Lauantai;0;0;0;1;0;1
294;16.07.2016;2016;07;04;Lauantai;0;0;0;0;0;0
294;16.07.2016;2016;07;05;Lauantai;0;0;0;0;0;0
294;16.07.2016;2016;07;06;Lauantai;0;0;0;0;0;0
294;16.07.2016;2016;07;07;Lauantai;1;1;2;0;1;1
294;16.07.2016;2016;07;08;Lauantai;1;2;3;3;4;7
294;16.07.2016;2016;07;09;Lauantai;1;2;3;4;2;6
294;16.07.2016;2016;07;10;Lauantai;2;3;5;4;2;6
294;16.07.2016;2016;07;11;Lauantai;12;11;23;6;3;9
294;16.07.2016;2016;07;12;Lauantai;10;9;19;6;7;13
294;16.07.2016;2016;07;13;Lauantai;11;10;21;4;10;14
294;16.07.2016;2016;07;14;Lauantai;6;5;11;2;1;3
294;16.07.2016;2016;07;15;Lauantai;8;6;14;2;3;5
294;16.07.2016;2016;07;16;Lauantai;11;7;18;5;4;9
294;16.07.2016;2016;07;17;Lauantai;20;23;43;5;7;12
294;16.07.2016;2016;07;18;Lauantai;22;26;48;6;11;17
294;16.07.2016;2016;07;19;Lauantai;12;8;20;5;6;11
294;16.07.2016;2016;07;20;Lauantai;16;15;31;8;9;17
294;16.07.2016;2016;07;21;Lauantai;7;9;16;5;5;10
294;16.07.2016;2016;07;22;Lauantai;17;3;20;4;3;7
294;16.07.2016;2016;07;23;Lauantai;1;7;8;4;2;6
294;17.07.2016;2016;07;00;Sunnuntai;1;0;1;1;0;1
294;17.07.2016;2016;07;01;Sunnuntai;4;2;6;2;1;3
294;17.07.2016;2016;07;02;Sunnuntai;5;0;5;0;1;1
294;17.07.2016;2016;07;03;Sunnuntai;0;0;0;0;0;0
294;17.07.2016;2016;07;04;Sunnuntai;0;0;0;0;2;2
294;17.07.2016;2016;07;05;Sunnuntai;0;1;1;1;0;1
294;17.07.2016;2016;07;06;Sunnuntai;1;0;1;1;1;2
294;17.07.2016;2016;07;07;Sunnuntai;3;3;6;2;0;2
294;17.07.2016;2016;07;08;Sunnuntai;2;1;3;2;2;4
294;17.07.2016;2016;07;09;Sunnuntai;0;1;1;6;7;13
294;17.07.2016;2016;07;10;Sunnuntai;10;4;14;4;5;9
294;17.07.2016;2016;07;11;Sunnuntai;11;9;20;10;7;17
294;17.07.2016;2016;07;12;Sunnuntai;14;15;29;8;12;20
294;17.07.2016;2016;07;13;Sunnuntai;11;7;18;5;6;11
294;17.07.2016;2016;07;14;Sunnuntai;21;11;32;6;5;11
294;17.07.2016;2016;07;15;Sunnuntai;10;12;22;4;3;7
294;17.07.2016;2016;07;16;Sunnuntai;11;2;13;1;0;1
294;17.07.2016;2016;07;17;Sunnuntai;2;7;9;2;2;4
294;17.07.2016;2016;07;18;Sunnuntai;21;17;38;13;7;20
294;17.07.2016;2016;07;19;Sunnuntai;19;19;38;15;12;27
294;17.07.2016;2016;07;20;Sunnuntai;19;13;32;5;7;12
294;17.07.2016;2016;07;21;Sunnuntai;9;4;13;4;7;11
294;17.07.2016;2016;07;22;Sunnuntai;3;4;7;3;2;5
294;17.07.2016;2016;07;23;Sunnuntai;0;0;0;0;0;0
294;18.07.2016;2016;07;00;Maanantai;0;1;1;0;0;0
294;18.07.2016;2016;07;01;Maanantai;3;0;3;0;0;0
294;18.07.2016;2016;07;02;Maanantai;0;2;2;1;2;3
294;18.07.2016;2016;07;03;Maanantai;2;0;2;0;0;0
294;18.07.2016;2016;07;04;Maanantai;1;0;1;0;0;0
294;18.07.2016;2016;07;05;Maanantai;0;0;0;0;0;0
294;18.07.2016;2016;07;06;Maanantai;1;3;4;1;1;2
294;18.07.2016;2016;07;07;Maanantai;6;3;9;6;0;6
294;18.07.2016;2016;07;08;Maanantai;6;5;11;3;6;9
294;18.07.2016;2016;07;09;Maanantai;8;7;15;8;7;15
294;18.07.2016;2016;07;10;Maanantai;12;12;24;20;20;40
294;18.07.2016;2016;07;11;Maanantai;14;18;32;37;15;52
294;18.07.2016;2016;07;12;Maanantai;22;27;49;23;16;39
294;18.07.2016;2016;07;13;Maanantai;30;20;50;19;13;32
294;18.07.2016;2016;07;14;Maanantai;23;39;62;20;15;35
294;18.07.2016;2016;07;15;Maanantai;31;27;58;24;12;36
294;18.07.2016;2016;07;16;Maanantai;36;29;65;11;11;22
294;18.07.2016;2016;07;17;Maanantai;30;22;52;11;19;30
294;18.07.2016;2016;07;18;Maanantai;31;29;60;18;16;34
294;18.07.2016;2016;07;19;Maanantai;31;21;52;16;17;33
294;18.07.2016;2016;07;20;Maanantai;27;11;38;13;8;21
294;18.07.2016;2016;07;21;Maanantai;9;8;17;11;7;18
294;18.07.2016;2016;07;22;Maanantai;4;7;11;0;2;2
294;18.07.2016;2016;07;23;Maanantai;1;0;1;3;1;4
294;19.07.2016;2016;07;00;Tiistai;2;0;2;0;1;1
294;19.07.2016;2016;07;01;Tiistai;0;1;1;1;0;1
294;19.07.2016;2016;07;02;Tiistai;1;0;1;0;0;0
294;19.07.2016;2016;07;03;Tiistai;0;1;1;0;0;0
294;19.07.2016;2016;07;04;Tiistai;0;0;0;0;0;0
294;19.07.2016;2016;07;05;Tiistai;0;0;0;0;0;0
294;19.07.2016;2016;07;06;Tiistai;0;1;1;4;0;4
294;19.07.2016;2016;07;07;Tiistai;4;4;8;4;2;6
294;19.07.2016;2016;07;08;Tiistai;7;4;11;2;5;7
294;19.07.2016;2016;07;09;Tiistai;10;12;22;3;4;7
294;19.07.2016;2016;07;10;Tiistai;13;10;23;11;7;18
294;19.07.2016;2016;07;11;Tiistai;18;29;47;10;12;22
294;19.07.2016;2016;07;12;Tiistai;34;20;54;9;14;23
294;19.07.2016;2016;07;13;Tiistai;24;19;43;14;7;21
294;19.07.2016;2016;07;14;Tiistai;16;24;40;13;14;27
294;19.07.2016;2016;07;15;Tiistai;20;24;44;31;13;44
294;19.07.2016;2016;07;16;Tiistai;33;31;64;12;10;22
294;19.07.2016;2016;07;17;Tiistai;19;9;28;11;10;21
294;19.07.2016;2016;07;18;Tiistai;29;30;59;12;11;23
294;19.07.2016;2016;07;19;Tiistai;17;25;42;17;10;27
294;19.07.2016;2016;07;20;Tiistai;31;21;52;10;14;24
294;19.07.2016;2016;07;21;Tiistai;19;6;25;10;3;13
294;19.07.2016;2016;07;22;Tiistai;1;3;4;4;1;5
294;19.07.2016;2016;07;23;Tiistai;3;2;5;1;0;1
294;20.07.2016;2016;07;00;Keskiviikko;3;1;4;2;0;2
294;20.07.2016;2016;07;01;Keskiviikko;0;0;0;0;0;0
294;20.07.2016;2016;07;02;Keskiviikko;0;0;0;1;0;1
294;20.07.2016;2016;07;03;Keskiviikko;0;0;0;0;0;0
294;20.07.2016;2016;07;04;Keskiviikko;1;0;1;0;0;0
294;20.07.2016;2016;07;05;Keskiviikko;0;0;0;0;0;0
294;20.07.2016;2016;07;06;Keskiviikko;3;0;3;1;1;2
294;20.07.2016;2016;07;07;Keskiviikko;7;6;13;3;0;3
294;20.07.2016;2016;07;08;Keskiviikko;5;6;11;5;1;6
294;20.07.2016;2016;07;09;Keskiviikko;4;7;11;13;9;22
294;20.07.2016;2016;07;10;Keskiviikko;9;18;27;10;9;19
294;20.07.2016;2016;07;11;Keskiviikko;15;15;30;11;11;22
294;20.07.2016;2016;07;12;Keskiviikko;26;15;41;44;17;61
294;20.07.2016;2016;07;13;Keskiviikko;22;17;39;12;10;22
294;20.07.2016;2016;07;14;Keskiviikko;28;22;50;9;9;18
294;20.07.2016;2016;07;15;Keskiviikko;14;21;35;8;10;18
294;20.07.2016;2016;07;16;Keskiviikko;34;33;67;10;14;24
294;20.07.2016;2016;07;17;Keskiviikko;17;27;44;11;10;21
294;20.07.2016;2016;07;18;Keskiviikko;29;35;64;17;17;34
294;20.07.2016;2016;07;19;Keskiviikko;20;27;47;15;12;27
294;20.07.2016;2016;07;20;Keskiviikko;13;12;25;12;12;24
294;20.07.2016;2016;07;21;Keskiviikko;11;11;22;9;7;16
294;20.07.2016;2016;07;22;Keskiviikko;1;4;5;8;6;14
294;20.07.2016;2016;07;23;Keskiviikko;2;1;3;1;0;1
294;21.07.2016;2016;07;00;Torstai;0;0;0;0;0;0
294;21.07.2016;2016;07;01;Torstai;1;0;1;0;0;0
294;21.07.2016;2016;07;02;Torstai;0;0;0;0;0;0
294;21.07.2016;2016;07;03;Torstai;0;0;0;0;0;0
294;21.07.2016;2016;07;04;Torstai;0;0;0;1;0;1
294;21.07.2016;2016;07;05;Torstai;0;2;2;0;0;0
294;21.07.2016;2016;07;06;Torstai;3;1;4;2;1;3
294;21.07.2016;2016;07;07;Torstai;5;1;6;5;4;9
294;21.07.2016;2016;07;08;Torstai;3;2;5;1;3;4
294;21.07.2016;2016;07;09;Torstai;11;4;15;13;6;19
294;21.07.2016;2016;07;10;Torstai;13;13;26;15;13;28
294;21.07.2016;2016;07;11;Torstai;23;15;38;66;26;92
294;21.07.2016;2016;07;12;Torstai;17;33;50;129;62;191
294;21.07.2016;2016;07;13;Torstai;23;25;48;27;18;45
294;21.07.2016;2016;07;14;Torstai;28;36;64;14;13;27
294;21.07.2016;2016;07;15;Torstai;22;28;50;23;24;47
294;21.07.2016;2016;07;16;Torstai;28;26;54;6;13;19
294;21.07.2016;2016;07;17;Torstai;28;28;56;14;16;30
294;21.07.2016;2016;07;18;Torstai;29;28;57;12;8;20
294;21.07.2016;2016;07;19;Torstai;21;32;53;19;17;36
294;21.07.2016;2016;07;20;Torstai;22;18;40;7;3;10
294;21.07.2016;2016;07;21;Torstai;11;7;18;15;11;26
294;21.07.2016;2016;07;22;Torstai;4;1;5;1;3;4
294;21.07.2016;2016;07;23;Torstai;4;4;8;2;2;4
294;22.07.2016;2016;07;00;Perjantai;0;1;1;3;0;3
294;22.07.2016;2016;07;01;Perjantai;0;0;0;0;0;0
294;22.07.2016;2016;07;02;Perjantai;0;0;0;0;0;0
294;22.07.2016;2016;07;03;Perjantai;0;1;1;0;0;0
294;22.07.2016;2016;07;04;Perjantai;0;0;0;1;0;1
294;22.07.2016;2016;07;05;Perjantai;0;0;0;0;0;0
294;22.07.2016;2016;07;06;Perjantai;1;3;4;0;1;1
294;22.07.2016;2016;07;07;Perjantai;4;2;6;2;2;4
294;22.07.2016;2016;07;08;Perjantai;5;3;8;2;3;5
294;22.07.2016;2016;07;09;Perjantai;12;11;23;15;6;21
294;22.07.2016;2016;07;10;Perjantai;9;12;21;18;10;28
294;22.07.2016;2016;07;11;Perjantai;21;15;36;40;18;58
294;22.07.2016;2016;07;12;Perjantai;27;29;56;66;64;130
294;22.07.2016;2016;07;13;Perjantai;22;18;40;16;10;26
294;22.07.2016;2016;07;14;Perjantai;20;10;30;11;8;19
294;22.07.2016;2016;07;15;Perjantai;15;21;36;58;29;87
294;22.07.2016;2016;07;16;Perjantai;21;18;39;12;12;24
294;22.07.2016;2016;07;17;Perjantai;28;15;43;8;7;15
294;22.07.2016;2016;07;18;Perjantai;17;14;31;6;10;16
294;22.07.2016;2016;07;19;Perjantai;31;16;47;12;9;21
294;22.07.2016;2016;07;20;Perjantai;12;14;26;5;10;15
294;22.07.2016;2016;07;21;Perjantai;19;11;30;4;2;6
294;22.07.2016;2016;07;22;Perjantai;10;10;20;13;5;18
294;22.07.2016;2016;07;23;Perjantai;4;5;9;3;2;5
294;23.07.2016;2016;07;00;Lauantai;0;0;0;0;0;0
294;23.07.2016;2016;07;01;Lauantai;1;0;1;3;0;3
294;23.07.2016;2016;07;02;Lauantai;0;2;2;0;0;0
294;23.07.2016;2016;07;03;Lauantai;1;0;1;0;0;0
294;23.07.2016;2016;07;04;Lauantai;0;0;0;1;1;2
294;23.07.2016;2016;07;05;Lauantai;0;0;0;0;0;0
294;23.07.2016;2016;07;06;Lauantai;1;0;1;0;2;2
294;23.07.2016;2016;07;07;Lauantai;2;2;4;2;3;5
294;23.07.2016;2016;07;08;Lauantai;3;6;9;1;1;2
294;23.07.2016;2016;07;09;Lauantai;12;8;20;10;10;20
294;23.07.2016;2016;07;10;Lauantai;17;18;35;14;9;23
294;23.07.2016;2016;07;11;Lauantai;10;21;31;4;11;15
294;23.07.2016;2016;07;12;Lauantai;19;20;39;16;16;32
294;23.07.2016;2016;07;13;Lauantai;26;23;49;9;11;20
294;23.07.2016;2016;07;14;Lauantai;27;15;42;19;5;24
294;23.07.2016;2016;07;15;Lauantai;24;21;45;11;15;26
294;23.07.2016;2016;07;16;Lauantai;12;14;26;6;8;14
294;23.07.2016;2016;07;17;Lauantai;24;14;38;5;6;11
294;23.07.2016;2016;07;18;Lauantai;21;25;46;4;5;9
294;23.07.2016;2016;07;19;Lauantai;28;16;44;4;3;7
294;23.07.2016;2016;07;20;Lauantai;22;23;45;5;7;12
294;23.07.2016;2016;07;21;Lauantai;15;19;34;5;4;9
294;23.07.2016;2016;07;22;Lauantai;9;17;26;3;5;8
294;23.07.2016;2016;07;23;Lauantai;8;0;8;0;1;1
294;24.07.2016;2016;07;00;Sunnuntai;2;2;4;0;0;0
294;24.07.2016;2016;07;01;Sunnuntai;1;0;1;0;0;0
294;24.07.2016;2016;07;02;Sunnuntai;0;1;1;0;1;1
294;24.07.2016;2016;07;03;Sunnuntai;0;0;0;0;1;1
294;24.07.2016;2016;07;04;Sunnuntai;0;0;0;0;0;0
294;24.07.2016;2016;07;05;Sunnuntai;0;0;0;0;0;0
294;24.07.2016;2016;07;06;Sunnuntai;2;1;3;0;0;0
294;24.07.2016;2016;07;07;Sunnuntai;2;0;2;2;0;2
294;24.07.2016;2016;07;08;Sunnuntai;3;6;9;2;1;3
294;24.07.2016;2016;07;09;Sunnuntai;7;7;14;10;3;13
294;24.07.2016;2016;07;10;Sunnuntai;16;16;32;3;4;7
294;24.07.2016;2016;07;11;Sunnuntai;9;20;29;5;14;19
294;24.07.2016;2016;07;12;Sunnuntai;26;3;29;8;5;13
294;24.07.2016;2016;07;13;Sunnuntai;15;20;35;5;6;11
294;24.07.2016;2016;07;14;Sunnuntai;19;23;42;8;9;17
294;24.07.2016;2016;07;15;Sunnuntai;10;36;46;6;4;10
294;24.07.2016;2016;07;16;Sunnuntai;7;9;16;8;6;14
294;24.07.2016;2016;07;17;Sunnuntai;15;11;26;1;3;4
294;24.07.2016;2016;07;18;Sunnuntai;29;35;64;12;12;24
294;24.07.2016;2016;07;19;Sunnuntai;23;19;42;14;13;27
294;24.07.2016;2016;07;20;Sunnuntai;11;19;30;9;5;14
294;24.07.2016;2016;07;21;Sunnuntai;6;11;17;5;10;15
294;24.07.2016;2016;07;22;Sunnuntai;4;2;6;8;1;9
294;24.07.2016;2016;07;23;Sunnuntai;5;0;5;1;2;3
294;25.07.2016;2016;07;00;Maanantai;2;2;4;0;0;0
294;25.07.2016;2016;07;01;Maanantai;0;0;0;0;0;0
294;25.07.2016;2016;07;02;Maanantai;0;0;0;0;0;0
294;25.07.2016;2016;07;03;Maanantai;0;0;0;0;0;0
294;25.07.2016;2016;07;04;Maanantai;0;0;0;1;0;1
294;25.07.2016;2016;07;05;Maanantai;0;0;0;0;0;0
294;25.07.2016;2016;07;06;Maanantai;3;2;5;1;3;4
294;25.07.2016;2016;07;07;Maanantai;7;1;8;4;4;8
294;25.07.2016;2016;07;08;Maanantai;11;4;15;5;4;9
294;25.07.2016;2016;07;09;Maanantai;9;8;17;5;4;9
294;25.07.2016;2016;07;10;Maanantai;9;10;19;5;4;9
294;25.07.2016;2016;07;11;Maanantai;13;27;40;12;11;23
294;25.07.2016;2016;07;12;Maanantai;21;25;46;9;10;19
294;25.07.2016;2016;07;13;Maanantai;29;30;59;11;9;20
294;25.07.2016;2016;07;14;Maanantai;27;37;64;21;6;27
294;25.07.2016;2016;07;15;Maanantai;20;30;50;16;13;29
294;25.07.2016;2016;07;16;Maanantai;21;20;41;10;10;20
294;25.07.2016;2016;07;17;Maanantai;21;22;43;19;15;34
294;25.07.2016;2016;07;18;Maanantai;33;20;53;9;18;27
294;25.07.2016;2016;07;19;Maanantai;33;26;59;14;13;27
294;25.07.2016;2016;07;20;Maanantai;25;20;45;5;12;17
294;25.07.2016;2016;07;21;Maanantai;21;10;31;8;9;17
294;25.07.2016;2016;07;22;Maanantai;5;9;14;2;2;4
294;25.07.2016;2016;07;23;Maanantai;7;4;11;0;0;0
294;26.07.2016;2016;07;00;Tiistai;4;3;7;2;0;2
294;26.07.2016;2016;07;01;Tiistai;1;0;1;0;0;0
294;26.07.2016;2016;07;02;Tiistai;0;1;1;0;0;0
294;26.07.2016;2016;07;03;Tiistai;0;0;0;0;0;0
294;26.07.2016;2016;07;04;Tiistai;0;0;0;1;0;1
294;26.07.2016;2016;07;05;Tiistai;0;0;0;0;0;0
294;26.07.2016;2016;07;06;Tiistai;3;3;6;2;0;2
294;26.07.2016;2016;07;07;Tiistai;5;2;7;41;11;52
294;26.07.2016;2016;07;08;Tiistai;6;7;13;42;15;57
294;26.07.2016;2016;07;09;Tiistai;9;11;20;30;11;41
294;26.07.2016;2016;07;10;Tiistai;18;16;34;17;6;23
294;26.07.2016;2016;07;11;Tiistai;24;28;52;30;10;40
294;26.07.2016;2016;07;12;Tiistai;23;25;48;7;12;19
294;26.07.2016;2016;07;13;Tiistai;23;19;42;25;5;30
294;26.07.2016;2016;07;14;Tiistai;20;18;38;10;11;21
294;26.07.2016;2016;07;15;Tiistai;15;20;35;12;10;22
294;26.07.2016;2016;07;16;Tiistai;22;19;41;5;10;15
294;26.07.2016;2016;07;17;Tiistai;39;28;67;5;10;15
294;26.07.2016;2016;07;18;Tiistai;34;32;66;19;11;30
294;26.07.2016;2016;07;19;Tiistai;27;21;48;10;12;22
294;26.07.2016;2016;07;20;Tiistai;17;21;38;9;11;20
294;26.07.2016;2016;07;21;Tiistai;12;8;20;5;7;12
294;26.07.2016;2016;07;22;Tiistai;6;7;13;4;1;5
294;26.07.2016;2016;07;23;Tiistai;7;0;7;1;0;1
294;27.07.2016;2016;07;00;Keskiviikko;1;1;2;0;0;0
294;27.07.2016;2016;07;01;Keskiviikko;3;0;3;1;1;2
294;27.07.2016;2016;07;02;Keskiviikko;0;0;0;0;0;0
294;27.07.2016;2016;07;03;Keskiviikko;0;0;0;1;0;1
294;27.07.2016;2016;07;04;Keskiviikko;0;0;0;1;0;1
294;27.07.2016;2016;07;05;Keskiviikko;0;0;0;1;0;1
294;27.07.2016;2016;07;06;Keskiviikko;3;5;8;3;2;5
294;27.07.2016;2016;07;07;Keskiviikko;9;3;12;2;0;2
294;27.07.2016;2016;07;08;Keskiviikko;2;6;8;1;1;2
294;27.07.2016;2016;07;09;Keskiviikko;1;2;3;0;0;0
294;27.07.2016;2016;07;10;Keskiviikko;1;2;3;1;0;1
294;27.07.2016;2016;07;11;Keskiviikko;6;12;18;4;3;7
294;27.07.2016;2016;07;12;Keskiviikko;22;14;36;7;11;18
294;27.07.2016;2016;07;13;Keskiviikko;15;15;30;8;12;20
294;27.07.2016;2016;07;14;Keskiviikko;20;10;30;6;9;15
294;27.07.2016;2016;07;15;Keskiviikko;18;22;40;8;10;18
294;27.07.2016;2016;07;16;Keskiviikko;15;19;34;7;5;12
294;27.07.2016;2016;07;17;Keskiviikko;32;27;59;10;13;23
294;27.07.2016;2016;07;18;Keskiviikko;21;19;40;14;10;24
294;27.07.2016;2016;07;19;Keskiviikko;24;39;63;22;13;35
294;27.07.2016;2016;07;20;Keskiviikko;24;23;47;22;7;29
294;27.07.2016;2016;07;21;Keskiviikko;13;10;23;4;2;6
294;27.07.2016;2016;07;22;Keskiviikko;7;2;9;3;1;4
294;27.07.2016;2016;07;23;Keskiviikko;3;0;3;0;0;0
294;28.07.2016;2016;07;00;Torstai;3;4;7;0;2;2
294;28.07.2016;2016;07;01;Torstai;0;0;0;0;0;0
294;28.07.2016;2016;07;02;Torstai;0;4;4;0;0;0
294;28.07.2016;2016;07;03;Torstai;0;0;0;0;0;0
294;28.07.2016;2016;07;04;Torstai;0;0;0;0;0;0
294;28.07.2016;2016;07;05;Torstai;1;0;1;1;0;1
294;28.07.2016;2016;07;06;Torstai;0;2;2;1;0;1
294;28.07.2016;2016;07;07;Torstai;5;2;7;2;4;6
294;28.07.2016;2016;07;08;Torstai;5;2;7;5;5;10
294;28.07.2016;2016;07;09;Torstai;10;8;18;17;4;21
294;28.07.2016;2016;07;10;Torstai;9;16;25;5;8;13
294;28.07.2016;2016;07;11;Torstai;13;17;30;10;15;25
294;28.07.2016;2016;07;12;Torstai;16;26;42;7;17;24
294;28.07.2016;2016;07;13;Torstai;19;25;44;9;14;23
294;28.07.2016;2016;07;14;Torstai;19;19;38;24;14;38
294;28.07.2016;2016;07;15;Torstai;16;21;37;10;5;15
294;28.07.2016;2016;07;16;Torstai;20;10;30;11;8;19
294;28.07.2016;2016;07;17;Torstai;29;20;49;8;8;16
294;28.07.2016;2016;07;18;Torstai;21;20;41;12;13;25
294;28.07.2016;2016;07;19;Torstai;11;9;20;11;3;14
294;28.07.2016;2016;07;20;Torstai;14;20;34;8;7;15
294;28.07.2016;2016;07;21;Torstai;7;7;14;5;8;13
294;28.07.2016;2016;07;22;Torstai;5;0;5;2;0;2
294;28.07.2016;2016;07;23;Torstai;2;2;4;2;2;4
294;29.07.2016;2016;07;00;Perjantai;0;2;2;3;0;3
294;29.07.2016;2016;07;01;Perjantai;0;0;0;1;0;1
294;29.07.2016;2016;07;02;Perjantai;0;0;0;0;0;0
294;29.07.2016;2016;07;03;Perjantai;0;0;0;0;0;0
294;29.07.2016;2016;07;04;Perjantai;0;0;0;0;0;0
294;29.07.2016;2016;07;05;Perjantai;0;0;0;0;0;0
294;29.07.2016;2016;07;06;Perjantai;3;2;5;0;0;0
294;29.07.2016;2016;07;07;Perjantai;3;3;6;4;2;6
294;29.07.2016;2016;07;08;Perjantai;7;2;9;3;0;3
294;29.07.2016;2016;07;09;Perjantai;8;9;17;2;6;8
294;29.07.2016;2016;07;10;Perjantai;14;17;31;12;7;19
294;29.07.2016;2016;07;11;Perjantai;19;18;37;3;6;9
294;29.07.2016;2016;07;12;Perjantai;13;19;32;14;7;21
294;29.07.2016;2016;07;13;Perjantai;29;32;61;6;18;24
294;29.07.2016;2016;07;14;Perjantai;22;13;35;14;8;22
294;29.07.2016;2016;07;15;Perjantai;16;19;35;9;5;14
294;29.07.2016;2016;07;16;Perjantai;22;35;57;9;14;23
294;29.07.2016;2016;07;17;Perjantai;23;27;50;7;4;11
294;29.07.2016;2016;07;18;Perjantai;33;29;62;14;10;24
294;29.07.2016;2016;07;19;Perjantai;16;16;32;4;4;8
294;29.07.2016;2016;07;20;Perjantai;14;14;28;4;10;14
294;29.07.2016;2016;07;21;Perjantai;7;7;14;4;1;5
294;29.07.2016;2016;07;22;Perjantai;1;0;1;1;3;4
294;29.07.2016;2016;07;23;Perjantai;3;4;7;1;1;2
294;30.07.2016;2016;07;00;Lauantai;3;2;5;0;0;0
294;30.07.2016;2016;07;01;Lauantai;0;0;0;1;0;1
294;30.07.2016;2016;07;02;Lauantai;3;0;3;0;0;0
294;30.07.2016;2016;07;03;Lauantai;3;0;3;0;0;0
294;30.07.2016;2016;07;04;Lauantai;2;0;2;0;0;0
294;30.07.2016;2016;07;05;Lauantai;1;4;5;0;0;0
294;30.07.2016;2016;07;06;Lauantai;2;1;3;0;1;1
294;30.07.2016;2016;07;07;Lauantai;0;1;1;2;0;2
294;30.07.2016;2016;07;08;Lauantai;1;1;2;2;0;2
294;30.07.2016;2016;07;09;Lauantai;10;7;17;7;7;14
294;30.07.2016;2016;07;10;Lauantai;17;8;25;7;5;12
294;30.07.2016;2016;07;11;Lauantai;6;14;20;14;10;24
294;30.07.2016;2016;07;12;Lauantai;25;22;47;15;12;27
294;30.07.2016;2016;07;13;Lauantai;24;13;37;8;10;18
294;30.07.2016;2016;07;14;Lauantai;14;19;33;10;2;12
294;30.07.2016;2016;07;15;Lauantai;4;5;9;0;1;1
294;30.07.2016;2016;07;16;Lauantai;2;3;5;1;0;1
294;30.07.2016;2016;07;17;Lauantai;17;13;30;3;1;4
294;30.07.2016;2016;07;18;Lauantai;5;8;13;6;3;9
294;30.07.2016;2016;07;19;Lauantai;10;9;19;11;9;20
294;30.07.2016;2016;07;20;Lauantai;19;18;37;6;6;12
294;30.07.2016;2016;07;21;Lauantai;10;10;20;2;5;7
294;30.07.2016;2016;07;22;Lauantai;1;2;3;2;0;2
294;30.07.2016;2016;07;23;Lauantai;3;2;5;0;0;0
294;31.07.2016;2016;07;00;Sunnuntai;3;3;6;0;0;0
294;31.07.2016;2016;07;01;Sunnuntai;2;0;2;0;0;0
294;31.07.2016;2016;07;02;Sunnuntai;0;0;0;1;0;1
294;31.07.2016;2016;07;03;Sunnuntai;0;1;1;1;0;1
294;31.07.2016;2016;07;04;Sunnuntai;0;0;0;0;0;0
294;31.07.2016;2016;07;05;Sunnuntai;0;0;0;1;1;2
294;31.07.2016;2016;07;06;Sunnuntai;0;0;0;0;0;0
294;31.07.2016;2016;07;07;Sunnuntai;0;0;0;1;3;4
294;31.07.2016;2016;07;08;Sunnuntai;3;1;4;2;2;4
294;31.07.2016;2016;07;09;Sunnuntai;3;6;9;5;9;14
294;31.07.2016;2016;07;10;Sunnuntai;7;7;14;8;10;18
294;31.07.2016;2016;07;11;Sunnuntai;12;12;24;7;3;10
294;31.07.2016;2016;07;12;Sunnuntai;15;8;23;14;10;24
294;31.07.2016;2016;07;13;Sunnuntai;6;10;16;4;6;10
294;31.07.2016;2016;07;14;Sunnuntai;10;22;32;3;3;6
294;31.07.2016;2016;07;15;Sunnuntai;9;8;17;4;4;8
294;31.07.2016;2016;07;16;Sunnuntai;12;2;14;1;6;7
294;31.07.2016;2016;07;17;Sunnuntai;12;13;25;2;6;8
294;31.07.2016;2016;07;18;Sunnuntai;10;18;28;9;9;18
294;31.07.2016;2016;07;19;Sunnuntai;18;27;45;2;9;11
294;31.07.2016;2016;07;20;Sunnuntai;9;8;17;8;2;10
294;31.07.2016;2016;07;21;Sunnuntai;11;7;18;1;2;3
294;31.07.2016;2016;07;22;Sunnuntai;4;6;10;2;3;5
294;31.07.2016;2016;07;23;Sunnuntai;0;0;0;0;1;1
294;01.08.2016;2016;08;00;Maanantai;0;0;0;0;0;0
294;01.08.2016;2016;08;01;Maanantai;2;1;3;0;0;0
294;01.08.2016;2016;08;02;Maanantai;0;0;0;0;0;0
294;01.08.2016;2016;08;03;Maanantai;0;0;0;0;0;0
294;01.08.2016;2016;08;04;Maanantai;0;0;0;1;0;1
294;01.08.2016;2016;08;05;Maanantai;0;0;0;0;2;2
294;01.08.2016;2016;08;06;Maanantai;6;2;8;0;4;4
294;01.08.2016;2016;08;07;Maanantai;6;6;12;0;3;3
294;01.08.2016;2016;08;08;Maanantai;5;3;8;4;3;7
294;01.08.2016;2016;08;09;Maanantai;10;9;19;9;2;11
294;01.08.2016;2016;08;10;Maanantai;14;18;32;4;4;8
294;01.08.2016;2016;08;11;Maanantai;11;20;31;9;11;20
294;01.08.2016;2016;08;12;Maanantai;24;23;47;8;15;23
294;01.08.2016;2016;08;13;Maanantai;8;24;32;8;5;13
294;01.08.2016;2016;08;14;Maanantai;27;27;54;41;54;95
294;01.08.2016;2016;08;15;Maanantai;30;32;62;18;24;42
294;01.08.2016;2016;08;16;Maanantai;23;21;44;4;11;15
294;01.08.2016;2016;08;17;Maanantai;33;16;49;14;8;22
294;01.08.2016;2016;08;18;Maanantai;19;31;50;11;10;21
294;01.08.2016;2016;08;19;Maanantai;24;23;47;11;12;23
294;01.08.2016;2016;08;20;Maanantai;19;24;43;8;14;22
294;01.08.2016;2016;08;21;Maanantai;20;13;33;12;7;19
294;01.08.2016;2016;08;22;Maanantai;6;2;8;4;3;7
294;01.08.2016;2016;08;23;Maanantai;1;0;1;0;3;3
294;02.08.2016;2016;08;00;Tiistai;0;0;0;1;0;1
294;02.08.2016;2016;08;01;Tiistai;0;1;1;0;0;0
294;02.08.2016;2016;08;02;Tiistai;0;0;0;0;0;0
294;02.08.2016;2016;08;03;Tiistai;0;0;0;0;0;0
294;02.08.2016;2016;08;04;Tiistai;0;0;0;0;0;0
294;02.08.2016;2016;08;05;Tiistai;1;0;1;1;0;1
294;02.08.2016;2016;08;06;Tiistai;2;5;7;0;0;0
294;02.08.2016;2016;08;07;Tiistai;5;1;6;4;2;6
294;02.08.2016;2016;08;08;Tiistai;1;4;5;3;2;5
294;02.08.2016;2016;08;09;Tiistai;1;1;2;1;1;2
294;02.08.2016;2016;08;10;Tiistai;4;6;10;4;0;4
294;02.08.2016;2016;08;11;Tiistai;13;15;28;8;6;14
294;02.08.2016;2016;08;12;Tiistai;17;26;43;19;14;33
294;02.08.2016;2016;08;13;Tiistai;17;20;37;11;10;21
294;02.08.2016;2016;08;14;Tiistai;17;3;20;4;2;6
294;02.08.2016;2016;08;15;Tiistai;0;4;4;1;0;1
294;02.08.2016;2016;08;16;Tiistai;7;5;12;0;1;1
294;02.08.2016;2016;08;17;Tiistai;21;19;40;11;5;16
294;02.08.2016;2016;08;18;Tiistai;12;14;26;13;10;23
294;02.08.2016;2016;08;19;Tiistai;16;16;32;7;19;26
294;02.08.2016;2016;08;20;Tiistai;10;16;26;11;10;21
294;02.08.2016;2016;08;21;Tiistai;10;13;23;6;5;11
294;02.08.2016;2016;08;22;Tiistai;8;7;15;2;2;4
294;02.08.2016;2016;08;23;Tiistai;3;1;4;0;2;2
294;03.08.2016;2016;08;00;Keskiviikko;0;2;2;0;0;0
294;03.08.2016;2016;08;01;Keskiviikko;0;0;0;0;1;1
294;03.08.2016;2016;08;02;Keskiviikko;0;0;0;2;0;2
294;03.08.2016;2016;08;03;Keskiviikko;0;0;0;0;0;0
294;03.08.2016;2016;08;04;Keskiviikko;0;0;0;1;0;1
294;03.08.2016;2016;08;05;Keskiviikko;0;0;0;0;0;0
294;03.08.2016;2016;08;06;Keskiviikko;1;0;1;1;0;1
294;03.08.2016;2016;08;07;Keskiviikko;5;1;6;3;0;3
294;03.08.2016;2016;08;08;Keskiviikko;5;11;16;6;5;11
294;03.08.2016;2016;08;09;Keskiviikko;14;5;19;6;3;9
294;03.08.2016;2016;08;10;Keskiviikko;17;15;32;15;11;26
294;03.08.2016;2016;08;11;Keskiviikko;21;16;37;10;10;20
294;03.08.2016;2016;08;12;Keskiviikko;28;19;47;10;3;13
294;03.08.2016;2016;08;13;Keskiviikko;21;21;42;4;8;12
294;03.08.2016;2016;08;14;Keskiviikko;16;12;28;6;2;8
294;03.08.2016;2016;08;15;Keskiviikko;15;25;40;8;12;20
294;03.08.2016;2016;08;16;Keskiviikko;12;6;18;4;5;9
294;03.08.2016;2016;08;17;Keskiviikko;7;13;20;7;12;19
294;03.08.2016;2016;08;18;Keskiviikko;13;20;33;11;4;15
294;03.08.2016;2016;08;19;Keskiviikko;23;32;55;8;11;19
294;03.08.2016;2016;08;20;Keskiviikko;19;20;39;13;16;29
294;03.08.2016;2016;08;21;Keskiviikko;9;6;15;6;4;10
294;03.08.2016;2016;08;22;Keskiviikko;2;2;4;4;2;6
294;03.08.2016;2016;08;23;Keskiviikko;0;2;2;2;2;4
294;04.08.2016;2016;08;00;Torstai;0;0;0;0;0;0
294;04.08.2016;2016;08;01;Torstai;0;0;0;0;0;0
294;04.08.2016;2016;08;02;Torstai;0;0;0;0;0;0
294;04.08.2016;2016;08;03;Torstai;0;0;0;1;0;1
294;04.08.2016;2016;08;04;Torstai;0;1;1;1;0;1
294;04.08.2016;2016;08;05;Torstai;0;2;2;0;0;0
294;04.08.2016;2016;08;06;Torstai;4;1;5;2;0;2
294;04.08.2016;2016;08;07;Torstai;7;4;11;3;1;4
294;04.08.2016;2016;08;08;Torstai;2;8;10;4;3;7
294;04.08.2016;2016;08;09;Torstai;13;8;21;10;5;15
294;04.08.2016;2016;08;10;Torstai;11;17;28;11;13;24
294;04.08.2016;2016;08;11;Torstai;19;27;46;7;15;22
294;04.08.2016;2016;08;12;Torstai;29;25;54;9;5;14
294;04.08.2016;2016;08;13;Torstai;16;18;34;5;9;14
294;04.08.2016;2016;08;14;Torstai;19;26;45;9;4;13
294;04.08.2016;2016;08;15;Torstai;34;27;61;3;7;10
294;04.08.2016;2016;08;16;Torstai;28;25;53;11;8;19
294;04.08.2016;2016;08;17;Torstai;26;17;43;4;14;18
294;04.08.2016;2016;08;18;Torstai;22;19;41;8;8;16
294;04.08.2016;2016;08;19;Torstai;30;30;60;14;7;21
294;04.08.2016;2016;08;20;Torstai;16;6;22;16;19;35
294;04.08.2016;2016;08;21;Torstai;7;5;12;4;5;9
294;04.08.2016;2016;08;22;Torstai;5;3;8;3;0;3
294;04.08.2016;2016;08;23;Torstai;0;1;1;1;0;1
294;05.08.2016;2016;08;00;Perjantai;0;0;0;0;0;0
294;05.08.2016;2016;08;01;Perjantai;0;0;0;0;0;0
294;05.08.2016;2016;08;02;Perjantai;0;0;0;0;0;0
294;05.08.2016;2016;08;03;Perjantai;0;0;0;0;0;0
294;05.08.2016;2016;08;04;Perjantai;0;0;0;1;0;1
294;05.08.2016;2016;08;05;Perjantai;0;1;1;0;1;1
294;05.08.2016;2016;08;06;Perjantai;4;5;9;3;2;5
294;05.08.2016;2016;08;07;Perjantai;4;4;8;1;2;3
294;05.08.2016;2016;08;08;Perjantai;2;5;7;1;3;4
294;05.08.2016;2016;08;09;Perjantai;10;7;17;8;3;11
294;05.08.2016;2016;08;10;Perjantai;10;11;21;14;7;21
294;05.08.2016;2016;08;11;Perjantai;18;16;34;5;9;14
294;05.08.2016;2016;08;12;Perjantai;12;12;24;9;14;23
294;05.08.2016;2016;08;13;Perjantai;24;18;42;7;14;21
294;05.08.2016;2016;08;14;Perjantai;24;24;48;8;9;17
294;05.08.2016;2016;08;15;Perjantai;32;36;68;13;10;23
294;05.08.2016;2016;08;16;Perjantai;25;29;54;4;4;8
294;05.08.2016;2016;08;17;Perjantai;30;22;52;14;8;22
294;05.08.2016;2016;08;18;Perjantai;17;25;42;12;13;25
294;05.08.2016;2016;08;19;Perjantai;33;33;66;10;13;23
294;05.08.2016;2016;08;20;Perjantai;17;6;23;12;10;22
294;05.08.2016;2016;08;21;Perjantai;10;9;19;4;2;6
294;05.08.2016;2016;08;22;Perjantai;10;3;13;4;4;8
294;05.08.2016;2016;08;23;Perjantai;1;4;5;1;1;2
294;06.08.2016;2016;08;00;Lauantai;3;0;3;2;3;5
294;06.08.2016;2016;08;01;Lauantai;0;0;0;0;0;0
294;06.08.2016;2016;08;02;Lauantai;0;0;0;0;0;0
294;06.08.2016;2016;08;03;Lauantai;0;0;0;0;0;0
294;06.08.2016;2016;08;04;Lauantai;0;0;0;0;0;0
294;06.08.2016;2016;08;05;Lauantai;0;0;0;0;0;0
294;06.08.2016;2016;08;06;Lauantai;0;0;0;1;1;2
294;06.08.2016;2016;08;07;Lauantai;5;2;7;1;0;1
294;06.08.2016;2016;08;08;Lauantai;1;8;9;4;7;11
294;06.08.2016;2016;08;09;Lauantai;13;16;29;7;4;11
294;06.08.2016;2016;08;10;Lauantai;20;16;36;15;10;25
294;06.08.2016;2016;08;11;Lauantai;15;19;34;9;9;18
294;06.08.2016;2016;08;12;Lauantai;20;32;52;13;10;23
294;06.08.2016;2016;08;13;Lauantai;17;20;37;14;4;18
294;06.08.2016;2016;08;14;Lauantai;22;18;40;8;10;18
294;06.08.2016;2016;08;15;Lauantai;26;10;36;5;7;12
294;06.08.2016;2016;08;16;Lauantai;15;23;38;14;11;25
294;06.08.2016;2016;08;17;Lauantai;25;26;51;13;12;25
294;06.08.2016;2016;08;18;Lauantai;18;14;32;14;9;23
294;06.08.2016;2016;08;19;Lauantai;13;14;27;6;3;9
294;06.08.2016;2016;08;20;Lauantai;15;13;28;2;7;9
294;06.08.2016;2016;08;21;Lauantai;24;7;31;3;5;8
294;06.08.2016;2016;08;22;Lauantai;9;4;13;4;4;8
294;06.08.2016;2016;08;23;Lauantai;4;1;5;2;2;4
294;07.08.2016;2016;08;00;Sunnuntai;1;0;1;1;1;2
294;07.08.2016;2016;08;01;Sunnuntai;0;0;0;0;0;0
294;07.08.2016;2016;08;02;Sunnuntai;0;0;0;0;0;0
294;07.08.2016;2016;08;03;Sunnuntai;0;0;0;1;1;2
294;07.08.2016;2016;08;04;Sunnuntai;0;0;0;0;0;0
294;07.08.2016;2016;08;05;Sunnuntai;0;0;0;0;0;0
294;07.08.2016;2016;08;06;Sunnuntai;1;1;2;2;1;3
294;07.08.2016;2016;08;07;Sunnuntai;0;1;1;0;0;0
294;07.08.2016;2016;08;08;Sunnuntai;3;1;4;3;2;5
294;07.08.2016;2016;08;09;Sunnuntai;7;6;13;6;6;12
294;07.08.2016;2016;08;10;Sunnuntai;11;7;18;9;6;15
294;07.08.2016;2016;08;11;Sunnuntai;4;18;22;8;13;21
294;07.08.2016;2016;08;12;Sunnuntai;15;14;29;5;7;12
294;07.08.2016;2016;08;13;Sunnuntai;15;18;33;6;11;17
294;07.08.2016;2016;08;14;Sunnuntai;12;17;29;11;12;23
294;07.08.2016;2016;08;15;Sunnuntai;17;16;33;10;7;17
294;07.08.2016;2016;08;16;Sunnuntai;18;17;35;17;11;28
294;07.08.2016;2016;08;17;Sunnuntai;37;32;69;10;12;22
294;07.08.2016;2016;08;18;Sunnuntai;27;40;67;11;18;29
294;07.08.2016;2016;08;19;Sunnuntai;29;23;52;11;11;22
294;07.08.2016;2016;08;20;Sunnuntai;30;19;49;6;2;8
294;07.08.2016;2016;08;21;Sunnuntai;10;27;37;10;7;17
294;07.08.2016;2016;08;22;Sunnuntai;6;6;12;1;1;2
294;07.08.2016;2016;08;23;Sunnuntai;3;3;6;0;0;0
294;08.08.2016;2016;08;00;Maanantai;1;0;1;1;0;1
294;08.08.2016;2016;08;01;Maanantai;2;0;2;1;1;2
294;08.08.2016;2016;08;02;Maanantai;1;0;1;0;0;0
294;08.08.2016;2016;08;03;Maanantai;0;0;0;0;0;0
294;08.08.2016;2016;08;04;Maanantai;0;0;0;0;0;0
294;08.08.2016;2016;08;05;Maanantai;0;0;0;0;0;0
294;08.08.2016;2016;08;06;Maanantai;2;0;2;0;1;1
294;08.08.2016;2016;08;07;Maanantai;8;6;14;3;0;3
294;08.08.2016;2016;08;08;Maanantai;6;5;11;5;5;10
294;08.08.2016;2016;08;09;Maanantai;10;6;16;4;6;10
294;08.08.2016;2016;08;10;Maanantai;21;24;45;11;10;21
294;08.08.2016;2016;08;11;Maanantai;27;19;46;14;12;26
294;08.08.2016;2016;08;12;Maanantai;24;32;56;12;14;26
294;08.08.2016;2016;08;13;Maanantai;40;41;81;8;14;22
294;08.08.2016;2016;08;14;Maanantai;35;27;62;13;16;29
294;08.08.2016;2016;08;15;Maanantai;32;44;76;9;11;20
294;08.08.2016;2016;08;16;Maanantai;28;21;49;11;7;18
294;08.08.2016;2016;08;17;Maanantai;40;48;88;13;18;31
294;08.08.2016;2016;08;18;Maanantai;34;37;71;8;8;16
294;08.08.2016;2016;08;19;Maanantai;20;19;39;13;11;24
294;08.08.2016;2016;08;20;Maanantai;16;21;37;7;11;18
294;08.08.2016;2016;08;21;Maanantai;11;10;21;5;7;12
294;08.08.2016;2016;08;22;Maanantai;7;8;15;0;1;1
294;08.08.2016;2016;08;23;Maanantai;3;1;4;1;1;2
294;09.08.2016;2016;08;00;Tiistai;2;0;2;0;0;0
294;09.08.2016;2016;08;01;Tiistai;0;0;0;3;1;4
294;09.08.2016;2016;08;02;Tiistai;0;0;0;1;1;2
294;09.08.2016;2016;08;03;Tiistai;0;0;0;0;0;0
294;09.08.2016;2016;08;04;Tiistai;0;0;0;0;0;0
294;09.08.2016;2016;08;05;Tiistai;1;1;2;0;0;0
294;09.08.2016;2016;08;06;Tiistai;1;0;1;1;3;4
294;09.08.2016;2016;08;07;Tiistai;7;6;13;3;3;6
294;09.08.2016;2016;08;08;Tiistai;2;9;11;2;3;5
294;09.08.2016;2016;08;09;Tiistai;7;10;17;6;5;11
294;09.08.2016;2016;08;10;Tiistai;14;8;22;4;6;10
294;09.08.2016;2016;08;11;Tiistai;9;16;25;8;13;21
294;09.08.2016;2016;08;12;Tiistai;29;17;46;10;7;17
294;09.08.2016;2016;08;13;Tiistai;17;25;42;5;8;13
294;09.08.2016;2016;08;14;Tiistai;19;15;34;7;12;19
294;09.08.2016;2016;08;15;Tiistai;19;17;36;5;3;8
294;09.08.2016;2016;08;16;Tiistai;23;25;48;17;11;28
294;09.08.2016;2016;08;17;Tiistai;18;15;33;9;7;16
294;09.08.2016;2016;08;18;Tiistai;32;23;55;9;7;16
294;09.08.2016;2016;08;19;Tiistai;21;13;34;17;11;28
294;09.08.2016;2016;08;20;Tiistai;10;11;21;10;9;19
294;09.08.2016;2016;08;21;Tiistai;2;4;6;4;4;8
294;09.08.2016;2016;08;22;Tiistai;0;1;1;3;0;3
294;09.08.2016;2016;08;23;Tiistai;0;1;1;0;0;0
294;10.08.2016;2016;08;00;Keskiviikko;1;0;1;0;0;0
294;10.08.2016;2016;08;01;Keskiviikko;0;0;0;0;0;0
294;10.08.2016;2016;08;02;Keskiviikko;0;0;0;0;0;0
294;10.08.2016;2016;08;03;Keskiviikko;0;0;0;0;0;0
294;10.08.2016;2016;08;04;Keskiviikko;0;0;0;0;0;0
294;10.08.2016;2016;08;05;Keskiviikko;0;0;0;0;2;2
294;10.08.2016;2016;08;06;Keskiviikko;1;0;1;1;0;1
294;10.08.2016;2016;08;07;Keskiviikko;2;2;4;4;4;8
294;10.08.2016;2016;08;08;Keskiviikko;20;12;32;19;5;24
294;10.08.2016;2016;08;09;Keskiviikko;9;17;26;10;11;21
294;10.08.2016;2016;08;10;Keskiviikko;4;17;21;9;14;23
294;10.08.2016;2016;08;11;Keskiviikko;13;13;26;9;13;22
294;10.08.2016;2016;08;12;Keskiviikko;15;23;38;11;15;26
294;10.08.2016;2016;08;13;Keskiviikko;33;32;65;17;18;35
294;10.08.2016;2016;08;14;Keskiviikko;27;28;55;13;7;20
294;10.08.2016;2016;08;15;Keskiviikko;28;24;52;19;10;29
294;10.08.2016;2016;08;16;Keskiviikko;22;22;44;11;9;20
294;10.08.2016;2016;08;17;Keskiviikko;15;13;28;8;6;14
294;10.08.2016;2016;08;18;Keskiviikko;16;14;30;12;14;26
294;10.08.2016;2016;08;19;Keskiviikko;15;19;34;8;10;18
294;10.08.2016;2016;08;20;Keskiviikko;18;11;29;12;5;17
294;10.08.2016;2016;08;21;Keskiviikko;5;1;6;2;2;4
294;10.08.2016;2016;08;22;Keskiviikko;0;0;0;2;1;3
294;10.08.2016;2016;08;23;Keskiviikko;0;0;0;0;0;0
294;11.08.2016;2016;08;00;Torstai;0;0;0;0;0;0
294;11.08.2016;2016;08;01;Torstai;0;0;0;0;0;0
294;11.08.2016;2016;08;02;Torstai;0;0;0;0;0;0
294;11.08.2016;2016;08;03;Torstai;0;0;0;0;0;0
294;11.08.2016;2016;08;04;Torstai;0;0;0;0;0;0
294;11.08.2016;2016;08;05;Torstai;0;0;0;1;1;2
294;11.08.2016;2016;08;06;Torstai;2;2;4;6;1;7
294;11.08.2016;2016;08;07;Torstai;10;12;22;3;6;9
294;11.08.2016;2016;08;08;Torstai;21;12;33;13;5;18
294;11.08.2016;2016;08;09;Torstai;6;7;13;12;7;19
294;11.08.2016;2016;08;10;Torstai;13;16;29;27;7;34
294;11.08.2016;2016;08;11;Torstai;9;17;26;8;22;30
294;11.08.2016;2016;08;12;Torstai;8;8;16;12;18;30
294;11.08.2016;2016;08;13;Torstai;30;29;59;19;11;30
294;11.08.2016;2016;08;14;Torstai;30;28;58;21;22;43
294;11.08.2016;2016;08;15;Torstai;19;42;61;7;10;17
294;11.08.2016;2016;08;16;Torstai;22;34;56;7;8;15
294;11.08.2016;2016;08;17;Torstai;26;27;53;17;15;32
294;11.08.2016;2016;08;18;Torstai;36;37;73;3;9;12
294;11.08.2016;2016;08;19;Torstai;21;14;35;8;17;25
294;11.08.2016;2016;08;20;Torstai;8;19;27;5;7;12
294;11.08.2016;2016;08;21;Torstai;2;1;3;1;1;2
294;11.08.2016;2016;08;22;Torstai;0;0;0;1;1;2
294;11.08.2016;2016;08;23;Torstai;0;0;0;0;0;0
294;12.08.2016;2016;08;00;Perjantai;0;0;0;0;0;0
294;12.08.2016;2016;08;01;Perjantai;0;2;2;5;4;9
294;12.08.2016;2016;08;02;Perjantai;0;0;0;0;0;0
294;12.08.2016;2016;08;03;Perjantai;0;0;0;0;0;0
294;12.08.2016;2016;08;04;Perjantai;0;0;0;0;0;0
294;12.08.2016;2016;08;05;Perjantai;0;0;0;0;0;0
294;12.08.2016;2016;08;06;Perjantai;1;1;2;5;2;7
294;12.08.2016;2016;08;07;Perjantai;14;11;25;6;3;9
294;12.08.2016;2016;08;08;Perjantai;17;13;30;4;2;6
294;12.08.2016;2016;08;09;Perjantai;16;5;21;10;5;15
294;12.08.2016;2016;08;10;Perjantai;3;5;8;1;1;2
294;12.08.2016;2016;08;11;Perjantai;8;2;10;4;1;5
294;12.08.2016;2016;08;12;Perjantai;17;20;37;9;20;29
294;12.08.2016;2016;08;13;Perjantai;26;21;47;17;16;33
294;12.08.2016;2016;08;14;Perjantai;40;32;72;19;21;40
294;12.08.2016;2016;08;15;Perjantai;35;11;46;15;12;27
294;12.08.2016;2016;08;16;Perjantai;38;35;73;42;27;69
294;12.08.2016;2016;08;17;Perjantai;64;56;120;37;34;71
294;12.08.2016;2016;08;18;Perjantai;82;62;144;55;69;124
294;12.08.2016;2016;08;19;Perjantai;61;67;128;67;49;116
294;12.08.2016;2016;08;20;Perjantai;43;52;95;38;48;86
294;12.08.2016;2016;08;21;Perjantai;31;39;70;31;30;61
294;12.08.2016;2016;08;22;Perjantai;27;21;48;21;14;35
294;12.08.2016;2016;08;23;Perjantai;8;18;26;3;6;9
294;13.08.2016;2016;08;00;Lauantai;0;4;4;0;5;5
294;13.08.2016;2016;08;01;Lauantai;1;5;6;0;5;5
294;13.08.2016;2016;08;02;Lauantai;1;1;2;0;2;2
294;13.08.2016;2016;08;03;Lauantai;0;1;1;0;4;4
294;13.08.2016;2016;08;04;Lauantai;0;0;0;0;0;0
294;13.08.2016;2016;08;05;Lauantai;0;0;0;0;0;0
294;13.08.2016;2016;08;06;Lauantai;0;0;0;1;2;3
294;13.08.2016;2016;08;07;Lauantai;1;4;5;2;2;4
294;13.08.2016;2016;08;08;Lauantai;1;5;6;5;1;6
294;13.08.2016;2016;08;09;Lauantai;12;12;24;17;6;23
294;13.08.2016;2016;08;10;Lauantai;12;3;15;40;12;52
294;13.08.2016;2016;08;11;Lauantai;13;13;26;50;36;86
294;13.08.2016;2016;08;12;Lauantai;13;20;33;41;45;86
294;13.08.2016;2016;08;13;Lauantai;8;16;24;28;38;66
294;13.08.2016;2016;08;14;Lauantai;18;10;28;16;21;37
294;13.08.2016;2016;08;15;Lauantai;11;17;28;5;15;20
294;13.08.2016;2016;08;16;Lauantai;15;14;29;11;12;23
294;13.08.2016;2016;08;17;Lauantai;12;24;36;10;7;17
294;13.08.2016;2016;08;18;Lauantai;18;17;35;9;7;16
294;13.08.2016;2016;08;19;Lauantai;16;12;28;11;8;19
294;13.08.2016;2016;08;20;Lauantai;10;8;18;4;8;12
294;13.08.2016;2016;08;21;Lauantai;7;9;16;11;5;16
294;13.08.2016;2016;08;22;Lauantai;8;6;14;16;9;25
294;13.08.2016;2016;08;23;Lauantai;3;2;5;5;6;11
294;14.08.2016;2016;08;00;Sunnuntai;2;1;3;0;4;4
294;14.08.2016;2016;08;01;Sunnuntai;0;1;1;0;1;1
294;14.08.2016;2016;08;02;Sunnuntai;1;0;1;0;3;3
294;14.08.2016;2016;08;03;Sunnuntai;0;3;3;0;1;1
294;14.08.2016;2016;08;04;Sunnuntai;1;0;1;0;2;2
294;14.08.2016;2016;08;05;Sunnuntai;0;1;1;0;0;0
294;14.08.2016;2016;08;06;Sunnuntai;0;1;1;1;0;1
294;14.08.2016;2016;08;07;Sunnuntai;0;3;3;2;4;6
294;14.08.2016;2016;08;08;Sunnuntai;2;1;3;1;4;5
294;14.08.2016;2016;08;09;Sunnuntai;1;4;5;9;3;12
294;14.08.2016;2016;08;10;Sunnuntai;8;6;14;5;11;16
294;14.08.2016;2016;08;11;Sunnuntai;10;17;27;12;8;20
294;14.08.2016;2016;08;12;Sunnuntai;23;21;44;5;13;18
294;14.08.2016;2016;08;13;Sunnuntai;25;24;49;14;10;24
294;14.08.2016;2016;08;14;Sunnuntai;21;33;54;14;14;28
294;14.08.2016;2016;08;15;Sunnuntai;20;8;28;10;13;23
294;14.08.2016;2016;08;16;Sunnuntai;24;25;49;10;10;20
294;14.08.2016;2016;08;17;Sunnuntai;24;28;52;9;14;23
294;14.08.2016;2016;08;18;Sunnuntai;25;22;47;18;12;30
294;14.08.2016;2016;08;19;Sunnuntai;33;23;56;13;15;28
294;14.08.2016;2016;08;20;Sunnuntai;19;10;29;13;5;18
294;14.08.2016;2016;08;21;Sunnuntai;8;9;17;5;3;8
294;14.08.2016;2016;08;22;Sunnuntai;1;0;1;1;1;2
294;14.08.2016;2016;08;23;Sunnuntai;1;0;1;0;0;0
294;15.08.2016;2016;08;00;Maanantai;0;0;0;0;0;0
294;15.08.2016;2016;08;01;Maanantai;0;0;0;0;0;0
294;15.08.2016;2016;08;02;Maanantai;0;0;0;0;0;0
294;15.08.2016;2016;08;03;Maanantai;1;0;1;0;0;0
294;15.08.2016;2016;08;04;Maanantai;0;0;0;0;0;0
294;15.08.2016;2016;08;05;Maanantai;0;0;0;1;1;2
294;15.08.2016;2016;08;06;Maanantai;1;2;3;4;2;6
294;15.08.2016;2016;08;07;Maanantai;9;12;21;5;7;12
294;15.08.2016;2016;08;08;Maanantai;24;7;31;10;8;18
294;15.08.2016;2016;08;09;Maanantai;16;16;32;9;7;16
294;15.08.2016;2016;08;10;Maanantai;10;6;16;4;10;14
294;15.08.2016;2016;08;11;Maanantai;2;16;18;18;14;32
294;15.08.2016;2016;08;12;Maanantai;16;20;36;16;15;31
294;15.08.2016;2016;08;13;Maanantai;23;17;40;12;10;22
294;15.08.2016;2016;08;14;Maanantai;28;33;61;20;17;37
294;15.08.2016;2016;08;15;Maanantai;19;32;51;11;10;21
294;15.08.2016;2016;08;16;Maanantai;24;36;60;7;12;19
294;15.08.2016;2016;08;17;Maanantai;36;26;62;16;11;27
294;15.08.2016;2016;08;18;Maanantai;41;32;73;22;16;38
294;15.08.2016;2016;08;19;Maanantai;31;35;66;17;19;36
294;15.08.2016;2016;08;20;Maanantai;9;24;33;5;10;15
294;15.08.2016;2016;08;21;Maanantai;8;11;19;4;4;8
294;15.08.2016;2016;08;22;Maanantai;0;1;1;1;0;1
294;15.08.2016;2016;08;23;Maanantai;0;0;0;0;0;0
294;16.08.2016;2016;08;00;Tiistai;0;0;0;1;0;1
294;16.08.2016;2016;08;01;Tiistai;0;0;0;0;0;0
294;16.08.2016;2016;08;02;Tiistai;0;0;0;0;0;0
294;16.08.2016;2016;08;03;Tiistai;0;0;0;1;0;1
294;16.08.2016;2016;08;04;Tiistai;0;0;0;1;1;2
294;16.08.2016;2016;08;05;Tiistai;0;1;1;0;0;0
294;16.08.2016;2016;08;06;Tiistai;2;3;5;4;0;4
294;16.08.2016;2016;08;07;Tiistai;7;8;15;8;5;13
294;16.08.2016;2016;08;08;Tiistai;24;6;30;5;4;9
294;16.08.2016;2016;08;09;Tiistai;16;6;22;11;10;21
294;16.08.2016;2016;08;10;Tiistai;5;8;13;10;8;18
294;16.08.2016;2016;08;11;Tiistai;7;3;10;10;12;22
294;16.08.2016;2016;08;12;Tiistai;6;5;11;23;36;59
294;16.08.2016;2016;08;13;Tiistai;10;7;17;15;9;24
294;16.08.2016;2016;08;14;Tiistai;12;19;31;6;9;15
294;16.08.2016;2016;08;15;Tiistai;16;31;47;7;21;28
294;16.08.2016;2016;08;16;Tiistai;12;17;29;12;11;23
294;16.08.2016;2016;08;17;Tiistai;13;11;24;7;7;14
294;16.08.2016;2016;08;18;Tiistai;18;19;37;6;6;12
294;16.08.2016;2016;08;19;Tiistai;14;9;23;7;4;11
294;16.08.2016;2016;08;20;Tiistai;7;7;14;8;5;13
294;16.08.2016;2016;08;21;Tiistai;2;1;3;1;1;2
294;16.08.2016;2016;08;22;Tiistai;0;0;0;1;0;1
294;16.08.2016;2016;08;23;Tiistai;0;0;0;0;0;0
294;17.08.2016;2016;08;00;Keskiviikko;0;0;0;0;0;0
294;17.08.2016;2016;08;01;Keskiviikko;0;0;0;0;0;0
294;17.08.2016;2016;08;02;Keskiviikko;0;0;0;0;0;0
294;17.08.2016;2016;08;03;Keskiviikko;0;0;0;0;0;0
294;17.08.2016;2016;08;04;Keskiviikko;0;0;0;0;1;1
294;17.08.2016;2016;08;05;Keskiviikko;0;0;0;0;0;0
294;17.08.2016;2016;08;06;Keskiviikko;2;2;4;0;3;3
294;17.08.2016;2016;08;07;Keskiviikko;10;9;19;7;2;9
294;17.08.2016;2016;08;08;Keskiviikko;23;11;34;10;5;15
294;17.08.2016;2016;08;09;Keskiviikko;9;20;29;11;20;31
294;17.08.2016;2016;08;10;Keskiviikko;12;8;20;16;11;27
294;17.08.2016;2016;08;11;Keskiviikko;11;14;25;17;17;34
294;17.08.2016;2016;08;12;Keskiviikko;17;19;36;7;10;17
294;17.08.2016;2016;08;13;Keskiviikko;21;19;40;12;14;26
294;17.08.2016;2016;08;14;Keskiviikko;20;27;47;11;18;29
294;17.08.2016;2016;08;15;Keskiviikko;30;29;59;11;12;23
294;17.08.2016;2016;08;16;Keskiviikko;23;19;42;11;9;20
294;17.08.2016;2016;08;17;Keskiviikko;25;29;54;16;13;29
294;17.08.2016;2016;08;18;Keskiviikko;24;22;46;14;21;35
294;17.08.2016;2016;08;19;Keskiviikko;11;21;32;13;17;30
294;17.08.2016;2016;08;20;Keskiviikko;17;15;32;8;4;12
294;17.08.2016;2016;08;21;Keskiviikko;5;5;10;1;3;4
294;17.08.2016;2016;08;22;Keskiviikko;1;3;4;0;0;0
294;17.08.2016;2016;08;23;Keskiviikko;0;0;0;0;0;0
294;18.08.2016;2016;08;00;Torstai;0;0;0;0;0;0
294;18.08.2016;2016;08;01;Torstai;0;0;0;0;0;0
294;18.08.2016;2016;08;02;Torstai;0;0;0;1;0;1
294;18.08.2016;2016;08;03;Torstai;0;0;0;0;1;1
294;18.08.2016;2016;08;04;Torstai;0;0;0;0;0;0
294;18.08.2016;2016;08;05;Torstai;1;0;1;0;0;0
294;18.08.2016;2016;08;06;Torstai;1;1;2;4;0;4
294;18.08.2016;2016;08;07;Torstai;17;5;22;7;7;14
294;18.08.2016;2016;08;08;Torstai;24;11;35;3;4;7
294;18.08.2016;2016;08;09;Torstai;19;12;31;19;11;30
294;18.08.2016;2016;08;10;Torstai;12;13;25;9;7;16
294;18.08.2016;2016;08;11;Torstai;15;11;26;14;12;26
294;18.08.2016;2016;08;12;Torstai;19;13;32;9;8;17
294;18.08.2016;2016;08;13;Torstai;13;32;45;10;12;22
294;18.08.2016;2016;08;14;Torstai;18;17;35;22;17;39
294;18.08.2016;2016;08;15;Torstai;21;34;55;6;17;23
294;18.08.2016;2016;08;16;Torstai;18;13;31;9;9;18
294;18.08.2016;2016;08;17;Torstai;29;32;61;4;12;16
294;18.08.2016;2016;08;18;Torstai;28;32;60;14;17;31
294;18.08.2016;2016;08;19;Torstai;19;19;38;11;14;25
294;18.08.2016;2016;08;20;Torstai;14;10;24;3;8;11
294;18.08.2016;2016;08;21;Torstai;2;3;5;3;2;5
294;18.08.2016;2016;08;22;Torstai;1;6;7;0;0;0
294;18.08.2016;2016;08;23;Torstai;0;0;0;0;0;0
294;19.08.2016;2016;08;00;Perjantai;2;0;2;0;0;0
294;19.08.2016;2016;08;01;Perjantai;0;0;0;0;0;0
294;19.08.2016;2016;08;02;Perjantai;0;0;0;0;0;0
294;19.08.2016;2016;08;03;Perjantai;0;0;0;0;0;0
294;19.08.2016;2016;08;04;Perjantai;1;1;2;0;0;0
294;19.08.2016;2016;08;05;Perjantai;0;1;1;0;0;0
294;19.08.2016;2016;08;06;Perjantai;4;2;6;5;2;7
294;19.08.2016;2016;08;07;Perjantai;8;11;19;3;3;6
294;19.08.2016;2016;08;08;Perjantai;16;5;21;7;2;9
294;19.08.2016;2016;08;09;Perjantai;14;8;22;9;7;16
294;19.08.2016;2016;08;10;Perjantai;9;10;19;6;8;14
294;19.08.2016;2016;08;11;Perjantai;13;10;23;8;6;14
294;19.08.2016;2016;08;12;Perjantai;10;16;26;8;9;17
294;19.08.2016;2016;08;13;Perjantai;29;30;59;13;11;24
294;19.08.2016;2016;08;14;Perjantai;33;48;81;8;20;28
294;19.08.2016;2016;08;15;Perjantai;33;28;61;9;14;23
294;19.08.2016;2016;08;16;Perjantai;16;8;24;2;5;7
294;19.08.2016;2016;08;17;Perjantai;9;12;21;6;9;15
294;19.08.2016;2016;08;18;Perjantai;17;20;37;21;8;29
294;19.08.2016;2016;08;19;Perjantai;13;23;36;12;9;21
294;19.08.2016;2016;08;20;Perjantai;13;20;33;16;9;25
294;19.08.2016;2016;08;21;Perjantai;7;8;15;5;9;14
294;19.08.2016;2016;08;22;Perjantai;1;12;13;1;0;1
294;19.08.2016;2016;08;23;Perjantai;6;0;6;2;2;4
294;20.08.2016;2016;08;00;Lauantai;1;1;2;0;0;0
294;20.08.2016;2016;08;01;Lauantai;0;0;0;0;0;0
294;20.08.2016;2016;08;02;Lauantai;0;0;0;0;2;2
294;20.08.2016;2016;08;03;Lauantai;0;1;1;0;0;0
294;20.08.2016;2016;08;04;Lauantai;0;0;0;0;1;1
294;20.08.2016;2016;08;05;Lauantai;0;0;0;0;0;0
294;20.08.2016;2016;08;06;Lauantai;0;0;0;0;0;0
294;20.08.2016;2016;08;07;Lauantai;0;1;1;1;0;1
294;20.08.2016;2016;08;08;Lauantai;5;5;10;2;1;3
294;20.08.2016;2016;08;09;Lauantai;9;7;16;5;9;14
294;20.08.2016;2016;08;10;Lauantai;12;16;28;6;5;11
294;20.08.2016;2016;08;11;Lauantai;18;10;28;6;5;11
294;20.08.2016;2016;08;12;Lauantai;21;18;39;4;9;13
294;20.08.2016;2016;08;13;Lauantai;26;19;45;13;17;30
294;20.08.2016;2016;08;14;Lauantai;21;27;48;8;8;16
294;20.08.2016;2016;08;15;Lauantai;25;19;44;11;9;20
294;20.08.2016;2016;08;16;Lauantai;17;20;37;9;5;14
294;20.08.2016;2016;08;17;Lauantai;29;25;54;3;6;9
294;20.08.2016;2016;08;18;Lauantai;23;28;51;5;9;14
294;20.08.2016;2016;08;19;Lauantai;11;4;15;5;4;9
294;20.08.2016;2016;08;20;Lauantai;5;5;10;4;7;11
294;20.08.2016;2016;08;21;Lauantai;1;6;7;4;3;7
294;20.08.2016;2016;08;22;Lauantai;1;0;1;3;0;3
294;20.08.2016;2016;08;23;Lauantai;3;1;4;0;1;1
294;21.08.2016;2016;08;00;Sunnuntai;10;0;10;1;0;1
294;21.08.2016;2016;08;01;Sunnuntai;10;1;11;4;0;4
294;21.08.2016;2016;08;02;Sunnuntai;0;2;2;6;0;6
294;21.08.2016;2016;08;03;Sunnuntai;0;0;0;0;0;0
294;21.08.2016;2016;08;04;Sunnuntai;0;0;0;0;0;0
294;21.08.2016;2016;08;05;Sunnuntai;0;0;0;1;0;1
294;21.08.2016;2016;08;06;Sunnuntai;1;0;1;1;1;2
294;21.08.2016;2016;08;07;Sunnuntai;0;0;0;0;1;1
294;21.08.2016;2016;08;08;Sunnuntai;2;2;4;0;1;1
294;21.08.2016;2016;08;09;Sunnuntai;3;8;11;11;5;16
294;21.08.2016;2016;08;10;Sunnuntai;12;5;17;14;7;21
294;21.08.2016;2016;08;11;Sunnuntai;5;14;19;9;8;17
294;21.08.2016;2016;08;12;Sunnuntai;7;9;16;8;8;16
294;21.08.2016;2016;08;13;Sunnuntai;7;9;16;14;8;22
294;21.08.2016;2016;08;14;Sunnuntai;15;30;45;16;19;35
294;21.08.2016;2016;08;15;Sunnuntai;7;16;23;17;21;38
294;21.08.2016;2016;08;16;Sunnuntai;16;28;44;12;9;21
294;21.08.2016;2016;08;17;Sunnuntai;28;25;53;8;10;18
294;21.08.2016;2016;08;18;Sunnuntai;30;25;55;11;11;22
294;21.08.2016;2016;08;19;Sunnuntai;12;24;36;17;16;33
294;21.08.2016;2016;08;20;Sunnuntai;9;8;17;1;5;6
294;21.08.2016;2016;08;21;Sunnuntai;9;1;10;4;7;11
294;21.08.2016;2016;08;22;Sunnuntai;1;1;2;2;1;3
294;21.08.2016;2016;08;23;Sunnuntai;1;0;1;0;0;0
294;22.08.2016;2016;08;00;Maanantai;0;0;0;0;0;0
294;22.08.2016;2016;08;01;Maanantai;0;0;0;1;0;1
294;22.08.2016;2016;08;02;Maanantai;0;0;0;0;0;0
294;22.08.2016;2016;08;03;Maanantai;0;0;0;0;0;0
294;22.08.2016;2016;08;04;Maanantai;0;0;0;0;0;0
294;22.08.2016;2016;08;05;Maanantai;1;0;1;0;0;0
294;22.08.2016;2016;08;06;Maanantai;2;2;4;2;0;2
294;22.08.2016;2016;08;07;Maanantai;5;10;15;8;6;14
294;22.08.2016;2016;08;08;Maanantai;12;3;15;4;2;6
294;22.08.2016;2016;08;09;Maanantai;7;5;12;5;3;8
294;22.08.2016;2016;08;10;Maanantai;2;5;7;5;2;7
294;22.08.2016;2016;08;11;Maanantai;6;13;19;8;7;15
294;22.08.2016;2016;08;12;Maanantai;14;14;28;8;10;18
294;22.08.2016;2016;08;13;Maanantai;11;15;26;17;13;30
294;22.08.2016;2016;08;14;Maanantai;17;20;37;13;21;34
294;22.08.2016;2016;08;15;Maanantai;18;22;40;12;9;21
294;22.08.2016;2016;08;16;Maanantai;10;6;16;2;10;12
294;22.08.2016;2016;08;17;Maanantai;12;9;21;7;2;9
294;22.08.2016;2016;08;18;Maanantai;11;18;29;10;8;18
294;22.08.2016;2016;08;19;Maanantai;24;14;38;7;6;13
294;22.08.2016;2016;08;20;Maanantai;6;11;17;6;6;12
294;22.08.2016;2016;08;21;Maanantai;3;1;4;3;5;8
294;22.08.2016;2016;08;22;Maanantai;0;0;0;0;0;0
294;22.08.2016;2016;08;23;Maanantai;1;0;1;0;0;0
294;23.08.2016;2016;08;00;Tiistai;0;0;0;0;1;1
294;23.08.2016;2016;08;01;Tiistai;1;0;1;0;0;0
294;23.08.2016;2016;08;02;Tiistai;0;0;0;0;0;0
294;23.08.2016;2016;08;03;Tiistai;0;0;0;0;0;0
294;23.08.2016;2016;08;04;Tiistai;0;0;0;0;1;1
294;23.08.2016;2016;08;05;Tiistai;1;1;2;0;1;1
294;23.08.2016;2016;08;06;Tiistai;5;3;8;9;1;10
294;23.08.2016;2016;08;07;Tiistai;11;14;25;3;4;7
294;23.08.2016;2016;08;08;Tiistai;23;4;27;11;10;21
294;23.08.2016;2016;08;09;Tiistai;24;4;28;12;6;18
294;23.08.2016;2016;08;10;Tiistai;8;9;17;9;13;22
294;23.08.2016;2016;08;11;Tiistai;11;19;30;15;16;31
294;23.08.2016;2016;08;12;Tiistai;5;14;19;16;13;29
294;23.08.2016;2016;08;13;Tiistai;15;15;30;21;7;28
294;23.08.2016;2016;08;14;Tiistai;26;20;46;9;11;20
294;23.08.2016;2016;08;15;Tiistai;35;46;81;12;13;25
294;23.08.2016;2016;08;16;Tiistai;35;30;65;11;10;21
294;23.08.2016;2016;08;17;Tiistai;44;30;74;5;16;21
294;23.08.2016;2016;08;18;Tiistai;34;40;74;21;20;41
294;23.08.2016;2016;08;19;Tiistai;30;29;59;13;14;27
294;23.08.2016;2016;08;20;Tiistai;16;11;27;9;6;15
294;23.08.2016;2016;08;21;Tiistai;4;5;9;3;1;4
294;23.08.2016;2016;08;22;Tiistai;0;1;1;3;1;4
294;23.08.2016;2016;08;23;Tiistai;1;0;1;1;0;1
294;24.08.2016;2016;08;00;Keskiviikko;0;0;0;0;0;0
294;24.08.2016;2016;08;01;Keskiviikko;0;0;0;0;0;0
294;24.08.2016;2016;08;02;Keskiviikko;0;0;0;0;0;0
294;24.08.2016;2016;08;03;Keskiviikko;0;0;0;0;0;0
294;24.08.2016;2016;08;04;Keskiviikko;0;0;0;0;2;2
294;24.08.2016;2016;08;05;Keskiviikko;1;0;1;0;1;1
294;24.08.2016;2016;08;06;Keskiviikko;5;3;8;1;2;3
294;24.08.2016;2016;08;07;Keskiviikko;19;3;22;6;1;7
294;24.08.2016;2016;08;08;Keskiviikko;33;14;47;8;9;17
294;24.08.2016;2016;08;09;Keskiviikko;16;14;30;11;22;33
294;24.08.2016;2016;08;10;Keskiviikko;9;19;28;16;9;25
294;24.08.2016;2016;08;11;Keskiviikko;13;19;32;23;21;44
294;24.08.2016;2016;08;12;Keskiviikko;13;16;29;16;10;26
294;24.08.2016;2016;08;13;Keskiviikko;15;18;33;12;18;30
294;24.08.2016;2016;08;14;Keskiviikko;24;24;48;11;11;22
294;24.08.2016;2016;08;15;Keskiviikko;40;33;73;15;12;27
294;24.08.2016;2016;08;16;Keskiviikko;29;37;66;13;17;30
294;24.08.2016;2016;08;17;Keskiviikko;39;36;75;14;14;28
294;24.08.2016;2016;08;18;Keskiviikko;45;29;74;21;18;39
294;24.08.2016;2016;08;19;Keskiviikko;19;47;66;9;12;21
294;24.08.2016;2016;08;20;Keskiviikko;12;11;23;4;4;8
294;24.08.2016;2016;08;21;Keskiviikko;1;0;1;4;7;11
294;24.08.2016;2016;08;22;Keskiviikko;0;0;0;1;0;1
294;24.08.2016;2016;08;23;Keskiviikko;2;2;4;0;0;0
294;25.08.2016;2016;08;00;Torstai;0;0;0;0;0;0
294;25.08.2016;2016;08;01;Torstai;0;0;0;0;1;1
294;25.08.2016;2016;08;02;Torstai;0;0;0;0;0;0
294;25.08.2016;2016;08;03;Torstai;0;0;0;0;0;0
294;25.08.2016;2016;08;04;Torstai;0;0;0;0;1;1
294;25.08.2016;2016;08;05;Torstai;0;0;0;0;0;0
294;25.08.2016;2016;08;06;Torstai;2;3;5;3;2;5
294;25.08.2016;2016;08;07;Torstai;15;8;23;9;2;11
294;25.08.2016;2016;08;08;Torstai;23;7;30;9;5;14
294;25.08.2016;2016;08;09;Torstai;11;10;21;9;6;15
294;25.08.2016;2016;08;10;Torstai;3;10;13;2;10;12
294;25.08.2016;2016;08;11;Torstai;5;9;14;16;6;22
294;25.08.2016;2016;08;12;Torstai;5;9;14;8;14;22
294;25.08.2016;2016;08;13;Torstai;11;15;26;10;8;18
294;25.08.2016;2016;08;14;Torstai;24;35;59;12;10;22
294;25.08.2016;2016;08;15;Torstai;32;32;64;4;11;15
294;25.08.2016;2016;08;16;Torstai;15;19;34;5;9;14
294;25.08.2016;2016;08;17;Torstai;22;17;39;7;5;12
294;25.08.2016;2016;08;18;Torstai;17;16;33;8;13;21
294;25.08.2016;2016;08;19;Torstai;16;12;28;12;14;26
294;25.08.2016;2016;08;20;Torstai;7;14;21;2;6;8
294;25.08.2016;2016;08;21;Torstai;2;2;4;7;1;8
294;25.08.2016;2016;08;22;Torstai;0;0;0;0;1;1
294;25.08.2016;2016;08;23;Torstai;1;0;1;0;0;0
294;26.08.2016;2016;08;00;Perjantai;0;0;0;0;0;0
294;26.08.2016;2016;08;01;Perjantai;0;0;0;0;0;0
294;26.08.2016;2016;08;02;Perjantai;0;0;0;0;0;0
294;26.08.2016;2016;08;03;Perjantai;0;0;0;0;0;0
294;26.08.2016;2016;08;04;Perjantai;0;0;0;0;0;0
294;26.08.2016;2016;08;05;Perjantai;0;0;0;1;1;2
294;26.08.2016;2016;08;06;Perjantai;3;3;6;5;3;8
294;26.08.2016;2016;08;07;Perjantai;16;9;25;4;6;10
294;26.08.2016;2016;08;08;Perjantai;16;1;17;7;1;8
294;26.08.2016;2016;08;09;Perjantai;15;15;30;7;3;10
294;26.08.2016;2016;08;10;Perjantai;9;10;19;5;8;13
294;26.08.2016;2016;08;11;Perjantai;15;7;22;14;7;21
294;26.08.2016;2016;08;12;Perjantai;17;20;37;11;15;26
294;26.08.2016;2016;08;13;Perjantai;28;30;58;15;19;34
294;26.08.2016;2016;08;14;Perjantai;23;40;63;12;22;34
294;26.08.2016;2016;08;15;Perjantai;28;36;64;15;15;30
294;26.08.2016;2016;08;16;Perjantai;21;34;55;7;13;20
294;26.08.2016;2016;08;17;Perjantai;20;23;43;9;10;19
294;26.08.2016;2016;08;18;Perjantai;37;43;80;13;12;25
294;26.08.2016;2016;08;19;Perjantai;16;27;43;16;15;31
294;26.08.2016;2016;08;20;Perjantai;18;6;24;5;10;15
294;26.08.2016;2016;08;21;Perjantai;10;6;16;3;5;8
294;26.08.2016;2016;08;22;Perjantai;4;1;5;1;2;3
294;26.08.2016;2016;08;23;Perjantai;2;1;3;0;2;2
294;27.08.2016;2016;08;00;Lauantai;1;0;1;0;0;0
294;27.08.2016;2016;08;01;Lauantai;1;0;1;3;0;3
294;27.08.2016;2016;08;02;Lauantai;1;1;2;0;0;0
294;27.08.2016;2016;08;03;Lauantai;0;0;0;1;1;2
294;27.08.2016;2016;08;04;Lauantai;0;0;0;0;0;0
294;27.08.2016;2016;08;05;Lauantai;0;0;0;0;0;0
294;27.08.2016;2016;08;06;Lauantai;1;0;1;0;0;0
294;27.08.2016;2016;08;07;Lauantai;0;2;2;1;0;1
294;27.08.2016;2016;08;08;Lauantai;2;1;3;2;2;4
294;27.08.2016;2016;08;09;Lauantai;2;3;5;3;3;6
294;27.08.2016;2016;08;10;Lauantai;8;4;12;7;4;11
294;27.08.2016;2016;08;11;Lauantai;8;17;25;8;4;12
294;27.08.2016;2016;08;12;Lauantai;19;10;29;8;17;25
294;27.08.2016;2016;08;13;Lauantai;8;7;15;11;11;22
294;27.08.2016;2016;08;14;Lauantai;9;10;19;8;11;19
294;27.08.2016;2016;08;15;Lauantai;10;7;17;3;2;5
294;27.08.2016;2016;08;16;Lauantai;6;3;9;3;2;5
294;27.08.2016;2016;08;17;Lauantai;12;17;29;9;6;15
294;27.08.2016;2016;08;18;Lauantai;12;12;24;8;10;18
294;27.08.2016;2016;08;19;Lauantai;7;4;11;1;7;8
294;27.08.2016;2016;08;20;Lauantai;3;4;7;6;4;10
294;27.08.2016;2016;08;21;Lauantai;1;3;4;4;4;8
294;27.08.2016;2016;08;22;Lauantai;2;0;2;0;1;1
294;27.08.2016;2016;08;23;Lauantai;1;0;1;0;0;0
294;28.08.2016;2016;08;00;Sunnuntai;0;0;0;0;0;0
294;28.08.2016;2016;08;01;Sunnuntai;0;0;0;0;0;0
294;28.08.2016;2016;08;02;Sunnuntai;0;0;0;0;0;0
294;28.08.2016;2016;08;03;Sunnuntai;0;0;0;0;0;0
294;28.08.2016;2016;08;04;Sunnuntai;0;0;0;0;0;0
294;28.08.2016;2016;08;05;Sunnuntai;0;0;0;0;0;0
294;28.08.2016;2016;08;06;Sunnuntai;1;1;2;1;2;3
294;28.08.2016;2016;08;07;Sunnuntai;2;1;3;0;4;4
294;28.08.2016;2016;08;08;Sunnuntai;2;1;3;4;7;11
294;28.08.2016;2016;08;09;Sunnuntai;4;2;6;10;7;17
294;28.08.2016;2016;08;10;Sunnuntai;6;5;11;10;6;16
294;28.08.2016;2016;08;11;Sunnuntai;12;8;20;6;10;16
294;28.08.2016;2016;08;12;Sunnuntai;12;16;28;18;6;24
294;28.08.2016;2016;08;13;Sunnuntai;17;12;29;11;12;23
294;28.08.2016;2016;08;14;Sunnuntai;8;15;23;6;6;12
294;28.08.2016;2016;08;15;Sunnuntai;10;21;31;6;11;17
294;28.08.2016;2016;08;16;Sunnuntai;15;17;32;11;7;18
294;28.08.2016;2016;08;17;Sunnuntai;29;17;46;14;13;27
294;28.08.2016;2016;08;18;Sunnuntai;21;10;31;7;18;25
294;28.08.2016;2016;08;19;Sunnuntai;16;12;28;7;5;12
294;28.08.2016;2016;08;20;Sunnuntai;9;3;12;1;4;5
294;28.08.2016;2016;08;21;Sunnuntai;1;1;2;4;1;5
294;28.08.2016;2016;08;22;Sunnuntai;1;1;2;0;1;1
294;28.08.2016;2016;08;23;Sunnuntai;0;0;0;0;0;0
294;29.08.2016;2016;08;00;Maanantai;0;0;0;0;0;0
294;29.08.2016;2016;08;01;Maanantai;0;0;0;0;0;0
294;29.08.2016;2016;08;02;Maanantai;0;0;0;0;0;0
294;29.08.2016;2016;08;03;Maanantai;0;0;0;0;0;0
294;29.08.2016;2016;08;04;Maanantai;0;0;0;0;0;0
294;29.08.2016;2016;08;05;Maanantai;0;0;0;0;0;0
294;29.08.2016;2016;08;06;Maanantai;3;1;4;3;2;5
294;29.08.2016;2016;08;07;Maanantai;13;6;19;6;4;10
294;29.08.2016;2016;08;08;Maanantai;22;7;29;7;6;13
294;29.08.2016;2016;08;09;Maanantai;15;9;24;8;7;15
294;29.08.2016;2016;08;10;Maanantai;4;5;9;9;3;12
294;29.08.2016;2016;08;11;Maanantai;10;14;24;12;14;26
294;29.08.2016;2016;08;12;Maanantai;15;28;43;16;12;28
294;29.08.2016;2016;08;13;Maanantai;21;24;45;12;11;23
294;29.08.2016;2016;08;14;Maanantai;31;25;56;12;20;32
294;29.08.2016;2016;08;15;Maanantai;20;31;51;11;8;19
294;29.08.2016;2016;08;16;Maanantai;23;28;51;11;11;22
294;29.08.2016;2016;08;17;Maanantai;29;35;64;9;16;25
294;29.08.2016;2016;08;18;Maanantai;32;30;62;13;20;33
294;29.08.2016;2016;08;19;Maanantai;21;18;39;27;15;42
294;29.08.2016;2016;08;20;Maanantai;27;18;45;11;9;20
294;29.08.2016;2016;08;21;Maanantai;3;1;4;6;1;7
294;29.08.2016;2016;08;22;Maanantai;1;0;1;1;1;2
294;29.08.2016;2016;08;23;Maanantai;0;0;0;0;0;0
294;30.08.2016;2016;08;00;Tiistai;0;0;0;0;0;0
294;30.08.2016;2016;08;01;Tiistai;0;0;0;0;0;0
294;30.08.2016;2016;08;02;Tiistai;0;0;0;0;0;0
294;30.08.2016;2016;08;03;Tiistai;0;0;0;0;0;0
294;30.08.2016;2016;08;04;Tiistai;0;0;0;1;1;2
294;30.08.2016;2016;08;05;Tiistai;0;0;0;0;0;0
294;30.08.2016;2016;08;06;Tiistai;1;3;4;5;2;7
294;30.08.2016;2016;08;07;Tiistai;13;11;24;5;2;7
294;30.08.2016;2016;08;08;Tiistai;18;12;30;6;8;14
294;30.08.2016;2016;08;09;Tiistai;29;13;42;14;9;23
294;30.08.2016;2016;08;10;Tiistai;7;8;15;9;12;21
294;30.08.2016;2016;08;11;Tiistai;10;16;26;5;6;11
294;30.08.2016;2016;08;12;Tiistai;9;18;27;17;10;27
294;30.08.2016;2016;08;13;Tiistai;23;16;39;8;7;15
294;30.08.2016;2016;08;14;Tiistai;18;19;37;9;8;17
294;30.08.2016;2016;08;15;Tiistai;37;40;77;12;11;23
294;30.08.2016;2016;08;16;Tiistai;33;33;66;11;19;30
294;30.08.2016;2016;08;17;Tiistai;30;36;66;10;12;22
294;30.08.2016;2016;08;18;Tiistai;41;29;70;11;17;28
294;30.08.2016;2016;08;19;Tiistai;21;22;43;14;15;29
294;30.08.2016;2016;08;20;Tiistai;11;17;28;6;2;8
294;30.08.2016;2016;08;21;Tiistai;1;3;4;2;3;5
294;30.08.2016;2016;08;22;Tiistai;0;0;0;0;1;1
294;30.08.2016;2016;08;23;Tiistai;0;0;0;1;0;1
294;31.08.2016;2016;08;00;Keskiviikko;0;0;0;0;0;0
294;31.08.2016;2016;08;01;Keskiviikko;0;0;0;0;0;0
294;31.08.2016;2016;08;02;Keskiviikko;0;0;0;0;0;0
294;31.08.2016;2016;08;03;Keskiviikko;0;0;0;0;0;0
294;31.08.2016;2016;08;04;Keskiviikko;0;0;0;0;1;1
294;31.08.2016;2016;08;05;Keskiviikko;0;0;0;0;1;1
294;31.08.2016;2016;08;06;Keskiviikko;4;1;5;1;3;4
294;31.08.2016;2016;08;07;Keskiviikko;12;9;21;9;2;11
294;31.08.2016;2016;08;08;Keskiviikko;22;10;32;8;4;12
294;31.08.2016;2016;08;09;Keskiviikko;7;14;21;12;17;29
294;31.08.2016;2016;08;10;Keskiviikko;10;13;23;12;7;19
294;31.08.2016;2016;08;11;Keskiviikko;7;17;24;11;12;23
294;31.08.2016;2016;08;12;Keskiviikko;11;22;33;16;13;29
294;31.08.2016;2016;08;13;Keskiviikko;29;16;45;10;10;20
294;31.08.2016;2016;08;14;Keskiviikko;23;45;68;10;11;21
294;31.08.2016;2016;08;15;Keskiviikko;42;32;74;8;11;19
294;31.08.2016;2016;08;16;Keskiviikko;29;34;63;7;12;19
294;31.08.2016;2016;08;17;Keskiviikko;32;24;56;17;10;27
294;31.08.2016;2016;08;18;Keskiviikko;36;38;74;21;17;38
294;31.08.2016;2016;08;19;Keskiviikko;18;26;44;17;9;26
294;31.08.2016;2016;08;20;Keskiviikko;12;8;20;3;10;13
294;31.08.2016;2016;08;21;Keskiviikko;4;1;5;4;0;4
294;31.08.2016;2016;08;22;Keskiviikko;0;0;0;0;0;0
294;31.08.2016;2016;08;23;Keskiviikko;0;0;0;0;0;0
294;01.09.2016;2016;09;00;Torstai;1;0;1;0;0;0
294;01.09.2016;2016;09;01;Torstai;0;0;0;0;0;0
294;01.09.2016;2016;09;02;Torstai;0;0;0;0;0;0
294;01.09.2016;2016;09;03;Torstai;0;0;0;0;0;0
294;01.09.2016;2016;09;04;Torstai;0;0;0;0;1;1
294;01.09.2016;2016;09;05;Torstai;1;0;1;1;0;1
294;01.09.2016;2016;09;06;Torstai;2;2;4;4;2;6
294;01.09.2016;2016;09;07;Torstai;17;6;23;7;4;11
294;01.09.2016;2016;09;08;Torstai;15;7;22;5;1;6
294;01.09.2016;2016;09;09;Torstai;8;9;17;4;3;7
294;01.09.2016;2016;09;10;Torstai;5;2;7;7;2;9
294;01.09.2016;2016;09;11;Torstai;5;9;14;11;7;18
294;01.09.2016;2016;09;12;Torstai;7;12;19;9;13;22
294;01.09.2016;2016;09;13;Torstai;17;22;39;16;8;24
294;01.09.2016;2016;09;14;Torstai;27;22;49;16;11;27
294;01.09.2016;2016;09;15;Torstai;17;32;49;11;15;26
294;01.09.2016;2016;09;16;Torstai;25;33;58;16;18;34
294;01.09.2016;2016;09;17;Torstai;27;30;57;17;16;33
294;01.09.2016;2016;09;18;Torstai;27;17;44;17;24;41
294;01.09.2016;2016;09;19;Torstai;25;30;55;16;15;31
294;01.09.2016;2016;09;20;Torstai;17;13;30;11;9;20
294;01.09.2016;2016;09;21;Torstai;3;3;6;5;0;5
294;01.09.2016;2016;09;22;Torstai;0;0;0;0;1;1
294;01.09.2016;2016;09;23;Torstai;1;0;1;0;0;0
294;02.09.2016;2016;09;00;Perjantai;0;0;0;0;0;0
294;02.09.2016;2016;09;01;Perjantai;0;0;0;0;0;0
294;02.09.2016;2016;09;02;Perjantai;0;0;0;0;0;0
294;02.09.2016;2016;09;03;Perjantai;0;0;0;0;0;0
294;02.09.2016;2016;09;04;Perjantai;0;0;0;0;0;0
294;02.09.2016;2016;09;05;Perjantai;0;0;0;0;0;0
294;02.09.2016;2016;09;06;Perjantai;3;4;7;3;3;6
294;02.09.2016;2016;09;07;Perjantai;8;9;17;3;8;11
294;02.09.2016;2016;09;08;Perjantai;17;13;30;5;6;11
294;02.09.2016;2016;09;09;Perjantai;22;7;29;13;3;16
294;02.09.2016;2016;09;10;Perjantai;7;10;17;5;9;14
294;02.09.2016;2016;09;11;Perjantai;11;10;21;9;10;19
294;02.09.2016;2016;09;12;Perjantai;9;21;30;15;9;24
294;02.09.2016;2016;09;13;Perjantai;30;20;50;17;14;31
294;02.09.2016;2016;09;14;Perjantai;22;40;62;19;21;40
294;02.09.2016;2016;09;15;Perjantai;26;26;52;17;12;29
294;02.09.2016;2016;09;16;Perjantai;28;26;54;12;13;25
294;02.09.2016;2016;09;17;Perjantai;23;18;41;14;11;25
294;02.09.2016;2016;09;18;Perjantai;27;42;69;21;15;36
294;02.09.2016;2016;09;19;Perjantai;34;30;64;12;13;25
294;02.09.2016;2016;09;20;Perjantai;5;12;17;7;6;13
294;02.09.2016;2016;09;21;Perjantai;7;4;11;5;1;6
294;02.09.2016;2016;09;22;Perjantai;3;1;4;3;1;4
294;02.09.2016;2016;09;23;Perjantai;2;1;3;2;1;3
294;03.09.2016;2016;09;00;Lauantai;1;0;1;1;2;3
294;03.09.2016;2016;09;01;Lauantai;1;0;1;0;0;0
294;03.09.2016;2016;09;02;Lauantai;1;0;1;0;0;0
294;03.09.2016;2016;09;03;Lauantai;2;0;2;0;0;0
294;03.09.2016;2016;09;04;Lauantai;0;0;0;1;0;1
294;03.09.2016;2016;09;05;Lauantai;0;0;0;0;0;0
294;03.09.2016;2016;09;06;Lauantai;0;1;1;2;0;2
294;03.09.2016;2016;09;07;Lauantai;2;1;3;0;0;0
294;03.09.2016;2016;09;08;Lauantai;6;0;6;6;1;7
294;03.09.2016;2016;09;09;Lauantai;4;11;15;7;8;15
294;03.09.2016;2016;09;10;Lauantai;10;22;32;3;16;19
294;03.09.2016;2016;09;11;Lauantai;11;11;22;18;10;28
294;03.09.2016;2016;09;12;Lauantai;29;12;41;14;12;26
294;03.09.2016;2016;09;13;Lauantai;24;31;55;13;14;27
294;03.09.2016;2016;09;14;Lauantai;17;20;37;6;10;16
294;03.09.2016;2016;09;15;Lauantai;15;19;34;17;12;29
294;03.09.2016;2016;09;16;Lauantai;31;15;46;12;5;17
294;03.09.2016;2016;09;17;Lauantai;22;21;43;8;12;20
294;03.09.2016;2016;09;18;Lauantai;14;12;26;8;8;16
294;03.09.2016;2016;09;19;Lauantai;16;7;23;10;3;13
294;03.09.2016;2016;09;20;Lauantai;10;12;22;1;4;5
294;03.09.2016;2016;09;21;Lauantai;10;10;20;2;3;5
294;03.09.2016;2016;09;22;Lauantai;2;4;6;2;0;2
294;03.09.2016;2016;09;23;Lauantai;2;0;2;1;1;2
294;04.09.2016;2016;09;00;Sunnuntai;0;0;0;0;1;1
294;04.09.2016;2016;09;01;Sunnuntai;0;0;0;0;0;0
294;04.09.2016;2016;09;02;Sunnuntai;1;1;2;0;0;0
294;04.09.2016;2016;09;03;Sunnuntai;0;0;0;0;0;0
294;04.09.2016;2016;09;04;Sunnuntai;0;0;0;0;0;0
294;04.09.2016;2016;09;05;Sunnuntai;0;0;0;0;0;0
294;04.09.2016;2016;09;06;Sunnuntai;0;0;0;0;1;1
294;04.09.2016;2016;09;07;Sunnuntai;1;0;1;1;1;2
294;04.09.2016;2016;09;08;Sunnuntai;0;2;2;2;3;5
294;04.09.2016;2016;09;09;Sunnuntai;11;3;14;4;3;7
294;04.09.2016;2016;09;10;Sunnuntai;2;9;11;6;19;25
294;04.09.2016;2016;09;11;Sunnuntai;17;27;44;8;10;18
294;04.09.2016;2016;09;12;Sunnuntai;20;12;32;16;8;24
294;04.09.2016;2016;09;13;Sunnuntai;15;18;33;9;8;17
294;04.09.2016;2016;09;14;Sunnuntai;27;28;55;11;15;26
294;04.09.2016;2016;09;15;Sunnuntai;18;17;35;6;10;16
294;04.09.2016;2016;09;16;Sunnuntai;19;25;44;12;9;21
294;04.09.2016;2016;09;17;Sunnuntai;25;30;55;9;13;22
294;04.09.2016;2016;09;18;Sunnuntai;18;14;32;11;13;24
294;04.09.2016;2016;09;19;Sunnuntai;18;15;33;14;10;24
294;04.09.2016;2016;09;20;Sunnuntai;2;9;11;2;8;10
294;04.09.2016;2016;09;21;Sunnuntai;2;0;2;2;1;3
294;04.09.2016;2016;09;22;Sunnuntai;0;0;0;1;0;1
294;04.09.2016;2016;09;23;Sunnuntai;0;0;0;0;0;0
294;05.09.2016;2016;09;00;Maanantai;0;0;0;0;0;0
294;05.09.2016;2016;09;01;Maanantai;0;0;0;0;0;0
294;05.09.2016;2016;09;02;Maanantai;0;0;0;0;0;0
294;05.09.2016;2016;09;03;Maanantai;0;0;0;0;0;0
294;05.09.2016;2016;09;04;Maanantai;0;0;0;0;0;0
294;05.09.2016;2016;09;05;Maanantai;0;0;0;0;0;0
294;05.09.2016;2016;09;06;Maanantai;0;2;2;1;1;2
294;05.09.2016;2016;09;07;Maanantai;12;8;20;8;9;17
294;05.09.2016;2016;09;08;Maanantai;23;8;31;12;6;18
294;05.09.2016;2016;09;09;Maanantai;16;17;33;12;13;25
294;05.09.2016;2016;09;10;Maanantai;14;9;23;13;6;19
294;05.09.2016;2016;09;11;Maanantai;7;15;22;19;20;39
294;05.09.2016;2016;09;12;Maanantai;17;18;35;18;18;36
294;05.09.2016;2016;09;13;Maanantai;20;25;45;15;15;30
294;05.09.2016;2016;09;14;Maanantai;30;26;56;26;18;44
294;05.09.2016;2016;09;15;Maanantai;23;51;74;19;15;34
294;05.09.2016;2016;09;16;Maanantai;36;12;48;10;11;21
294;05.09.2016;2016;09;17;Maanantai;20;34;54;12;25;37
294;05.09.2016;2016;09;18;Maanantai;21;23;44;11;18;29
294;05.09.2016;2016;09;19;Maanantai;13;9;22;14;11;25
294;05.09.2016;2016;09;20;Maanantai;10;4;14;6;4;10
294;05.09.2016;2016;09;21;Maanantai;1;1;2;7;3;10
294;05.09.2016;2016;09;22;Maanantai;0;0;0;1;0;1
294;05.09.2016;2016;09;23;Maanantai;0;0;0;0;0;0
294;06.09.2016;2016;09;00;Tiistai;0;0;0;0;0;0
294;06.09.2016;2016;09;01;Tiistai;0;0;0;0;0;0
294;06.09.2016;2016;09;02;Tiistai;0;0;0;0;0;0
294;06.09.2016;2016;09;03;Tiistai;0;0;0;0;0;0
294;06.09.2016;2016;09;04;Tiistai;0;0;0;0;1;1
294;06.09.2016;2016;09;05;Tiistai;0;0;0;0;0;0
294;06.09.2016;2016;09;06;Tiistai;5;2;7;8;5;13
294;06.09.2016;2016;09;07;Tiistai;7;7;14;3;5;8
294;06.09.2016;2016;09;08;Tiistai;16;4;20;7;3;10
294;06.09.2016;2016;09;09;Tiistai;26;23;49;22;10;32
294;06.09.2016;2016;09;10;Tiistai;9;7;16;7;15;22
294;06.09.2016;2016;09;11;Tiistai;31;18;49;19;21;40
294;06.09.2016;2016;09;12;Tiistai;26;17;43;13;9;22
294;06.09.2016;2016;09;13;Tiistai;18;36;54;21;16;37
294;06.09.2016;2016;09;14;Tiistai;31;34;65;14;9;23
294;06.09.2016;2016;09;15;Tiistai;22;48;70;8;20;28
294;06.09.2016;2016;09;16;Tiistai;20;20;40;10;10;20
294;06.09.2016;2016;09;17;Tiistai;30;20;50;18;19;37
294;06.09.2016;2016;09;18;Tiistai;22;24;46;6;18;24
294;06.09.2016;2016;09;19;Tiistai;12;16;28;6;11;17
294;06.09.2016;2016;09;20;Tiistai;11;12;23;2;4;6
294;06.09.2016;2016;09;21;Tiistai;1;3;4;0;2;2
294;06.09.2016;2016;09;22;Tiistai;0;0;0;1;0;1
294;06.09.2016;2016;09;23;Tiistai;0;0;0;0;0;0
294;07.09.2016;2016;09;00;Keskiviikko;0;0;0;0;0;0
294;07.09.2016;2016;09;01;Keskiviikko;0;0;0;0;0;0
294;07.09.2016;2016;09;02;Keskiviikko;0;0;0;0;0;0
294;07.09.2016;2016;09;03;Keskiviikko;0;0;0;0;0;0
294;07.09.2016;2016;09;04;Keskiviikko;0;0;0;0;1;1
294;07.09.2016;2016;09;05;Keskiviikko;0;0;0;0;1;1
294;07.09.2016;2016;09;06;Keskiviikko;3;3;6;5;3;8
294;07.09.2016;2016;09;07;Keskiviikko;19;10;29;3;2;5
294;07.09.2016;2016;09;08;Keskiviikko;24;12;36;8;1;9
294;07.09.2016;2016;09;09;Keskiviikko;16;12;28;20;19;39
294;07.09.2016;2016;09;10;Keskiviikko;12;13;25;26;20;46
294;07.09.2016;2016;09;11;Keskiviikko;6;15;21;6;13;19
294;07.09.2016;2016;09;12;Keskiviikko;9;13;22;13;10;23
294;07.09.2016;2016;09;13;Keskiviikko;16;16;32;6;11;17
294;07.09.2016;2016;09;14;Keskiviikko;30;28;58;18;11;29
294;07.09.2016;2016;09;15;Keskiviikko;25;28;53;7;18;25
294;07.09.2016;2016;09;16;Keskiviikko;12;28;40;14;9;23
294;07.09.2016;2016;09;17;Keskiviikko;24;20;44;3;9;12
294;07.09.2016;2016;09;18;Keskiviikko;21;19;40;17;17;34
294;07.09.2016;2016;09;19;Keskiviikko;15;20;35;13;12;25
294;07.09.2016;2016;09;20;Keskiviikko;7;24;31;11;9;20
294;07.09.2016;2016;09;21;Keskiviikko;5;0;5;1;5;6
294;07.09.2016;2016;09;22;Keskiviikko;0;0;0;0;0;0
294;07.09.2016;2016;09;23;Keskiviikko;0;0;0;0;0;0
294;08.09.2016;2016;09;00;Torstai;0;0;0;0;0;0
294;08.09.2016;2016;09;01;Torstai;0;0;0;0;0;0
294;08.09.2016;2016;09;02;Torstai;0;0;0;0;0;0
294;08.09.2016;2016;09;03;Torstai;0;0;0;0;0;0
294;08.09.2016;2016;09;04;Torstai;0;0;0;0;1;1
294;08.09.2016;2016;09;05;Torstai;0;0;0;0;0;0
294;08.09.2016;2016;09;06;Torstai;0;2;2;4;2;6
294;08.09.2016;2016;09;07;Torstai;25;13;38;6;5;11
294;08.09.2016;2016;09;08;Torstai;20;2;22;11;6;17
294;08.09.2016;2016;09;09;Torstai;17;4;21;16;19;35
294;08.09.2016;2016;09;10;Torstai;9;18;27;10;7;17
294;08.09.2016;2016;09;11;Torstai;12;23;35;20;24;44
294;08.09.2016;2016;09;12;Torstai;10;11;21;10;17;27
294;08.09.2016;2016;09;13;Torstai;22;28;50;12;8;20
294;08.09.2016;2016;09;14;Torstai;30;39;69;4;12;16
294;08.09.2016;2016;09;15;Torstai;30;29;59;14;18;32
294;08.09.2016;2016;09;16;Torstai;27;20;47;12;13;25
294;08.09.2016;2016;09;17;Torstai;37;16;53;6;8;14
294;08.09.2016;2016;09;18;Torstai;16;13;29;11;4;15
294;08.09.2016;2016;09;19;Torstai;18;22;40;9;18;27
294;08.09.2016;2016;09;20;Torstai;3;10;13;7;5;12
294;08.09.2016;2016;09;21;Torstai;1;1;2;2;3;5
294;08.09.2016;2016;09;22;Torstai;0;0;0;0;1;1
294;08.09.2016;2016;09;23;Torstai;0;0;0;0;0;0
294;09.09.2016;2016;09;00;Perjantai;0;0;0;0;0;0
294;09.09.2016;2016;09;01;Perjantai;0;0;0;0;0;0
294;09.09.2016;2016;09;02;Perjantai;0;0;0;0;0;0
294;09.09.2016;2016;09;03;Perjantai;0;0;0;0;0;0
294;09.09.2016;2016;09;04;Perjantai;0;0;0;0;0;0
294;09.09.2016;2016;09;05;Perjantai;0;0;0;0;0;0
294;09.09.2016;2016;09;06;Perjantai;2;3;5;8;3;11
294;09.09.2016;2016;09;07;Perjantai;17;7;24;9;6;15
294;09.09.2016;2016;09;08;Perjantai;12;6;18;8;3;11
294;09.09.2016;2016;09;09;Perjantai;29;9;38;14;4;18
294;09.09.2016;2016;09;10;Perjantai;8;11;19;13;10;23
294;09.09.2016;2016;09;11;Perjantai;18;14;32;20;14;34
294;09.09.2016;2016;09;12;Perjantai;11;23;34;10;13;23
294;09.09.2016;2016;09;13;Perjantai;21;32;53;12;17;29
294;09.09.2016;2016;09;14;Perjantai;20;33;53;10;24;34
294;09.09.2016;2016;09;15;Perjantai;16;8;24;11;10;21
294;09.09.2016;2016;09;16;Perjantai;12;21;33;8;8;16
294;09.09.2016;2016;09;17;Perjantai;27;30;57;9;12;21
294;09.09.2016;2016;09;18;Perjantai;15;14;29;14;16;30
294;09.09.2016;2016;09;19;Perjantai;24;30;54;14;19;33
294;09.09.2016;2016;09;20;Perjantai;9;9;18;7;2;9
294;09.09.2016;2016;09;21;Perjantai;12;16;28;4;1;5
294;09.09.2016;2016;09;22;Perjantai;3;1;4;0;0;0
294;09.09.2016;2016;09;23;Perjantai;2;0;2;0;0;0
294;10.09.2016;2016;09;00;Lauantai;2;0;2;0;0;0
294;10.09.2016;2016;09;01;Lauantai;0;0;0;1;0;1
294;10.09.2016;2016;09;02;Lauantai;0;0;0;0;0;0
294;10.09.2016;2016;09;03;Lauantai;0;0;0;0;0;0
294;10.09.2016;2016;09;04;Lauantai;0;0;0;1;0;1
294;10.09.2016;2016;09;05;Lauantai;0;0;0;0;0;0
294;10.09.2016;2016;09;06;Lauantai;1;0;1;0;0;0
294;10.09.2016;2016;09;07;Lauantai;2;2;4;0;0;0
294;10.09.2016;2016;09;08;Lauantai;2;3;5;0;0;0
294;10.09.2016;2016;09;09;Lauantai;3;2;5;3;2;5
294;10.09.2016;2016;09;10;Lauantai;11;13;24;4;7;11
294;10.09.2016;2016;09;11;Lauantai;17;19;36;6;5;11
294;10.09.2016;2016;09;12;Lauantai;17;11;28;9;9;18
294;10.09.2016;2016;09;13;Lauantai;21;20;41;6;8;14
294;10.09.2016;2016;09;14;Lauantai;24;8;32;2;8;10
294;10.09.2016;2016;09;15;Lauantai;11;18;29;7;10;17
294;10.09.2016;2016;09;16;Lauantai;17;44;61;10;11;21
294;10.09.2016;2016;09;17;Lauantai;17;12;29;5;7;12
294;10.09.2016;2016;09;18;Lauantai;13;17;30;7;10;17
294;10.09.2016;2016;09;19;Lauantai;19;23;42;5;7;12
294;10.09.2016;2016;09;20;Lauantai;20;13;33;5;5;10
294;10.09.2016;2016;09;21;Lauantai;6;6;12;1;2;3
294;10.09.2016;2016;09;22;Lauantai;2;2;4;2;3;5
294;10.09.2016;2016;09;23;Lauantai;1;0;1;0;0;0
294;11.09.2016;2016;09;00;Sunnuntai;0;0;0;0;1;1
294;11.09.2016;2016;09;01;Sunnuntai;0;0;0;0;0;0
294;11.09.2016;2016;09;02;Sunnuntai;0;0;0;1;0;1
294;11.09.2016;2016;09;03;Sunnuntai;0;0;0;0;0;0
294;11.09.2016;2016;09;04;Sunnuntai;0;0;0;1;0;1
294;11.09.2016;2016;09;05;Sunnuntai;1;0;1;1;0;1
294;11.09.2016;2016;09;06;Sunnuntai;0;0;0;0;2;2
294;11.09.2016;2016;09;07;Sunnuntai;1;0;1;1;2;3
294;11.09.2016;2016;09;08;Sunnuntai;3;1;4;3;3;6
294;11.09.2016;2016;09;09;Sunnuntai;6;3;9;8;8;16
294;11.09.2016;2016;09;10;Sunnuntai;4;7;11;14;8;22
294;11.09.2016;2016;09;11;Sunnuntai;15;12;27;11;11;22
294;11.09.2016;2016;09;12;Sunnuntai;16;10;26;10;8;18
294;11.09.2016;2016;09;13;Sunnuntai;6;14;20;9;8;17
294;11.09.2016;2016;09;14;Sunnuntai;15;14;29;10;7;17
294;11.09.2016;2016;09;15;Sunnuntai;14;8;22;7;10;17
294;11.09.2016;2016;09;16;Sunnuntai;13;13;26;11;7;18
294;11.09.2016;2016;09;17;Sunnuntai;16;10;26;5;6;11
294;11.09.2016;2016;09;18;Sunnuntai;6;21;27;11;9;20
294;11.09.2016;2016;09;19;Sunnuntai;15;12;27;9;10;19
294;11.09.2016;2016;09;20;Sunnuntai;11;5;16;8;2;10
294;11.09.2016;2016;09;21;Sunnuntai;2;1;3;1;3;4
294;11.09.2016;2016;09;22;Sunnuntai;0;0;0;0;0;0
294;11.09.2016;2016;09;23;Sunnuntai;0;0;0;0;0;0
294;12.09.2016;2016;09;00;Maanantai;0;0;0;0;0;0
294;12.09.2016;2016;09;01;Maanantai;0;0;0;0;0;0
294;12.09.2016;2016;09;02;Maanantai;0;0;0;0;0;0
294;12.09.2016;2016;09;03;Maanantai;0;0;0;0;0;0
294;12.09.2016;2016;09;04;Maanantai;0;0;0;0;0;0
294;12.09.2016;2016;09;05;Maanantai;0;0;0;0;0;0
294;12.09.2016;2016;09;06;Maanantai;5;2;7;2;3;5
294;12.09.2016;2016;09;07;Maanantai;12;9;21;8;8;16
294;12.09.2016;2016;09;08;Maanantai;23;9;32;10;8;18
294;12.09.2016;2016;09;09;Maanantai;23;6;29;8;8;16
294;12.09.2016;2016;09;10;Maanantai;9;8;17;10;9;19
294;12.09.2016;2016;09;11;Maanantai;3;21;24;12;11;23
294;12.09.2016;2016;09;12;Maanantai;15;20;35;8;7;15
294;12.09.2016;2016;09;13;Maanantai;19;21;40;12;11;23
294;12.09.2016;2016;09;14;Maanantai;23;20;43;9;15;24
294;12.09.2016;2016;09;15;Maanantai;18;41;59;14;23;37
294;12.09.2016;2016;09;16;Maanantai;17;24;41;6;9;15
294;12.09.2016;2016;09;17;Maanantai;15;24;39;8;13;21
294;12.09.2016;2016;09;18;Maanantai;19;16;35;14;12;26
294;12.09.2016;2016;09;19;Maanantai;23;14;37;11;9;20
294;12.09.2016;2016;09;20;Maanantai;11;5;16;7;9;16
294;12.09.2016;2016;09;21;Maanantai;0;4;4;3;1;4
294;12.09.2016;2016;09;22;Maanantai;0;0;0;0;3;3
294;12.09.2016;2016;09;23;Maanantai;1;0;1;0;0;0
294;13.09.2016;2016;09;00;Tiistai;0;0;0;0;0;0
294;13.09.2016;2016;09;01;Tiistai;0;0;0;0;0;0
294;13.09.2016;2016;09;02;Tiistai;0;0;0;0;0;0
294;13.09.2016;2016;09;03;Tiistai;0;0;0;0;0;0
294;13.09.2016;2016;09;04;Tiistai;0;0;0;0;1;1
294;13.09.2016;2016;09;05;Tiistai;1;0;1;0;0;0
294;13.09.2016;2016;09;06;Tiistai;4;2;6;2;3;5
294;13.09.2016;2016;09;07;Tiistai;16;13;29;7;4;11
294;13.09.2016;2016;09;08;Tiistai;20;11;31;11;4;15
294;13.09.2016;2016;09;09;Tiistai;23;7;30;18;9;27
294;13.09.2016;2016;09;10;Tiistai;8;11;19;10;19;29
294;13.09.2016;2016;09;11;Tiistai;13;16;29;16;16;32
294;13.09.2016;2016;09;12;Tiistai;10;11;21;19;14;33
294;13.09.2016;2016;09;13;Tiistai;16;9;25;22;9;31
294;13.09.2016;2016;09;14;Tiistai;19;22;41;15;10;25
294;13.09.2016;2016;09;15;Tiistai;32;51;83;14;22;36
294;13.09.2016;2016;09;16;Tiistai;32;21;53;17;17;34
294;13.09.2016;2016;09;17;Tiistai;37;30;67;17;25;42
294;13.09.2016;2016;09;18;Tiistai;29;27;56;15;18;33
294;13.09.2016;2016;09;19;Tiistai;17;37;54;16;17;33
294;13.09.2016;2016;09;20;Tiistai;17;12;29;8;8;16
294;13.09.2016;2016;09;21;Tiistai;4;5;9;2;3;5
294;13.09.2016;2016;09;22;Tiistai;0;0;0;0;1;1
294;13.09.2016;2016;09;23;Tiistai;1;0;1;0;0;0
294;14.09.2016;2016;09;00;Keskiviikko;0;0;0;2;0;2
294;14.09.2016;2016;09;01;Keskiviikko;0;0;0;0;0;0
294;14.09.2016;2016;09;02;Keskiviikko;0;0;0;0;0;0
294;14.09.2016;2016;09;03;Keskiviikko;0;0;0;0;0;0
294;14.09.2016;2016;09;04;Keskiviikko;0;0;0;0;1;1
294;14.09.2016;2016;09;05;Keskiviikko;0;0;0;1;1;2
294;14.09.2016;2016;09;06;Keskiviikko;2;3;5;1;3;4
294;14.09.2016;2016;09;07;Keskiviikko;17;8;25;4;1;5
294;14.09.2016;2016;09;08;Keskiviikko;24;7;31;10;3;13
294;14.09.2016;2016;09;09;Keskiviikko;18;12;30;14;7;21
294;14.09.2016;2016;09;10;Keskiviikko;12;15;27;14;10;24
294;14.09.2016;2016;09;11;Keskiviikko;11;20;31;15;14;29
294;14.09.2016;2016;09;12;Keskiviikko;29;15;44;6;12;18
294;14.09.2016;2016;09;13;Keskiviikko;24;16;40;17;17;34
294;14.09.2016;2016;09;14;Keskiviikko;35;33;68;15;17;32
294;14.09.2016;2016;09;15;Keskiviikko;29;39;68;13;17;30
294;14.09.2016;2016;09;16;Keskiviikko;22;16;38;7;10;17
294;14.09.2016;2016;09;17;Keskiviikko;29;29;58;10;13;23
294;14.09.2016;2016;09;18;Keskiviikko;32;34;66;17;18;35
294;14.09.2016;2016;09;19;Keskiviikko;25;22;47;16;13;29
294;14.09.2016;2016;09;20;Keskiviikko;13;4;17;9;8;17
294;14.09.2016;2016;09;21;Keskiviikko;4;0;4;5;2;7
294;14.09.2016;2016;09;22;Keskiviikko;0;2;2;0;0;0
294;14.09.2016;2016;09;23;Keskiviikko;0;0;0;0;0;0
294;15.09.2016;2016;09;00;Torstai;0;0;0;0;0;0
294;15.09.2016;2016;09;01;Torstai;0;0;0;1;0;1
294;15.09.2016;2016;09;02;Torstai;0;0;0;0;0;0
294;15.09.2016;2016;09;03;Torstai;0;0;0;0;0;0
294;15.09.2016;2016;09;04;Torstai;0;0;0;0;0;0
294;15.09.2016;2016;09;05;Torstai;0;0;0;0;0;0
294;15.09.2016;2016;09;06;Torstai;3;4;7;1;2;3
294;15.09.2016;2016;09;07;Torstai;16;7;23;1;3;4
294;15.09.2016;2016;09;08;Torstai;25;10;35;9;3;12
294;15.09.2016;2016;09;09;Torstai;18;16;34;10;14;24
294;15.09.2016;2016;09;10;Torstai;5;4;9;7;11;18
294;15.09.2016;2016;09;11;Torstai;6;8;14;18;21;39
294;15.09.2016;2016;09;12;Torstai;7;11;18;7;13;20
294;15.09.2016;2016;09;13;Torstai;17;24;41;15;14;29
294;15.09.2016;2016;09;14;Torstai;35;29;64;15;17;32
294;15.09.2016;2016;09;15;Torstai;14;29;43;11;5;16
294;15.09.2016;2016;09;16;Torstai;20;27;47;7;14;21
294;15.09.2016;2016;09;17;Torstai;28;21;49;13;14;27
294;15.09.2016;2016;09;18;Torstai;25;19;44;22;13;35
294;15.09.2016;2016;09;19;Torstai;9;11;20;12;18;30
294;15.09.2016;2016;09;20;Torstai;5;18;23;6;5;11
294;15.09.2016;2016;09;21;Torstai;1;2;3;4;2;6
294;15.09.2016;2016;09;22;Torstai;0;1;1;0;4;4
294;15.09.2016;2016;09;23;Torstai;0;0;0;1;2;3
294;16.09.2016;2016;09;00;Perjantai;0;1;1;1;0;1
294;16.09.2016;2016;09;01;Perjantai;1;1;2;1;1;2
294;16.09.2016;2016;09;02;Perjantai;0;0;0;0;0;0
294;16.09.2016;2016;09;03;Perjantai;0;0;0;0;0;0
294;16.09.2016;2016;09;04;Perjantai;0;0;0;0;0;0
294;16.09.2016;2016;09;05;Perjantai;0;0;0;1;1;2
294;16.09.2016;2016;09;06;Perjantai;2;2;4;4;2;6
294;16.09.2016;2016;09;07;Perjantai;13;7;20;2;7;9
294;16.09.2016;2016;09;08;Perjantai;12;3;15;6;5;11
294;16.09.2016;2016;09;09;Perjantai;25;12;37;14;11;25
294;16.09.2016;2016;09;10;Perjantai;14;12;26;9;14;23
294;16.09.2016;2016;09;11;Perjantai;11;13;24;25;18;43
294;16.09.2016;2016;09;12;Perjantai;13;24;37;15;19;34
294;16.09.2016;2016;09;13;Perjantai;43;37;80;18;13;31
294;16.09.2016;2016;09;14;Perjantai;33;42;75;13;20;33
294;16.09.2016;2016;09;15;Perjantai;28;29;57;21;12;33
294;16.09.2016;2016;09;16;Perjantai;24;30;54;6;15;21
294;16.09.2016;2016;09;17;Perjantai;24;19;43;7;8;15
294;16.09.2016;2016;09;18;Perjantai;28;21;49;11;13;24
294;16.09.2016;2016;09;19;Perjantai;14;29;43;4;9;13
294;16.09.2016;2016;09;20;Perjantai;20;10;30;11;4;15
294;16.09.2016;2016;09;21;Perjantai;15;4;19;3;1;4
294;16.09.2016;2016;09;22;Perjantai;2;2;4;1;0;1
294;16.09.2016;2016;09;23;Perjantai;2;0;2;0;0;0
294;17.09.2016;2016;09;00;Lauantai;0;0;0;0;0;0
294;17.09.2016;2016;09;01;Lauantai;0;0;0;1;1;2
294;17.09.2016;2016;09;02;Lauantai;0;0;0;0;0;0
294;17.09.2016;2016;09;03;Lauantai;0;0;0;1;0;1
294;17.09.2016;2016;09;04;Lauantai;0;0;0;0;0;0
294;17.09.2016;2016;09;05;Lauantai;2;0;2;0;0;0
294;17.09.2016;2016;09;06;Lauantai;0;0;0;0;2;2
294;17.09.2016;2016;09;07;Lauantai;0;2;2;3;0;3
294;17.09.2016;2016;09;08;Lauantai;1;4;5;3;3;6
294;17.09.2016;2016;09;09;Lauantai;4;7;11;4;9;13
294;17.09.2016;2016;09;10;Lauantai;15;9;24;9;11;20
294;17.09.2016;2016;09;11;Lauantai;19;18;37;15;17;32
294;17.09.2016;2016;09;12;Lauantai;30;46;76;13;8;21
294;17.09.2016;2016;09;13;Lauantai;24;19;43;3;10;13
294;17.09.2016;2016;09;14;Lauantai;15;17;32;4;12;16
294;17.09.2016;2016;09;15;Lauantai;18;18;36;10;8;18
294;17.09.2016;2016;09;16;Lauantai;26;20;46;12;7;19
294;17.09.2016;2016;09;17;Lauantai;21;24;45;18;14;32
294;17.09.2016;2016;09;18;Lauantai;15;26;41;12;17;29
294;17.09.2016;2016;09;19;Lauantai;15;10;25;14;5;19
294;17.09.2016;2016;09;20;Lauantai;9;4;13;7;6;13
294;17.09.2016;2016;09;21;Lauantai;6;13;19;6;6;12
294;17.09.2016;2016;09;22;Lauantai;3;0;3;1;0;1
294;17.09.2016;2016;09;23;Lauantai;2;0;2;0;0;0
294;18.09.2016;2016;09;00;Sunnuntai;0;0;0;0;0;0
294;18.09.2016;2016;09;01;Sunnuntai;1;2;3;1;0;1
294;18.09.2016;2016;09;02;Sunnuntai;0;1;1;0;0;0
294;18.09.2016;2016;09;03;Sunnuntai;0;1;1;0;1;1
294;18.09.2016;2016;09;04;Sunnuntai;0;2;2;0;0;0
294;18.09.2016;2016;09;05;Sunnuntai;0;0;0;1;0;1
294;18.09.2016;2016;09;06;Sunnuntai;1;0;1;1;2;3
294;18.09.2016;2016;09;07;Sunnuntai;1;1;2;1;1;2
294;18.09.2016;2016;09;08;Sunnuntai;1;2;3;2;2;4
294;18.09.2016;2016;09;09;Sunnuntai;4;3;7;7;7;14
294;18.09.2016;2016;09;10;Sunnuntai;5;7;12;15;13;28
294;18.09.2016;2016;09;11;Sunnuntai;3;12;15;5;8;13
294;18.09.2016;2016;09;12;Sunnuntai;15;22;37;8;10;18
294;18.09.2016;2016;09;13;Sunnuntai;10;8;18;9;10;19
294;18.09.2016;2016;09;14;Sunnuntai;17;19;36;20;18;38
294;18.09.2016;2016;09;15;Sunnuntai;14;3;17;7;7;14
294;18.09.2016;2016;09;16;Sunnuntai;19;16;35;5;12;17
294;18.09.2016;2016;09;17;Sunnuntai;17;10;27;6;8;14
294;18.09.2016;2016;09;18;Sunnuntai;21;23;44;9;10;19
294;18.09.2016;2016;09;19;Sunnuntai;11;16;27;4;7;11
294;18.09.2016;2016;09;20;Sunnuntai;3;8;11;1;1;2
294;18.09.2016;2016;09;21;Sunnuntai;1;2;3;2;0;2
294;18.09.2016;2016;09;22;Sunnuntai;0;0;0;0;2;2
294;18.09.2016;2016;09;23;Sunnuntai;0;0;0;0;0;0
294;19.09.2016;2016;09;00;Maanantai;0;0;0;0;0;0
294;19.09.2016;2016;09;01;Maanantai;0;0;0;0;0;0
294;19.09.2016;2016;09;02;Maanantai;0;0;0;0;0;0
294;19.09.2016;2016;09;03;Maanantai;0;0;0;0;0;0
294;19.09.2016;2016;09;04;Maanantai;0;0;0;0;0;0
294;19.09.2016;2016;09;05;Maanantai;0;0;0;0;0;0
294;19.09.2016;2016;09;06;Maanantai;3;1;4;3;2;5
294;19.09.2016;2016;09;07;Maanantai;19;5;24;7;1;8
294;19.09.2016;2016;09;08;Maanantai;20;12;32;7;5;12
294;19.09.2016;2016;09;09;Maanantai;20;14;34;10;10;20
294;19.09.2016;2016;09;10;Maanantai;9;4;13;16;11;27
294;19.09.2016;2016;09;11;Maanantai;8;12;20;16;15;31
294;19.09.2016;2016;09;12;Maanantai;13;25;38;12;15;27
294;19.09.2016;2016;09;13;Maanantai;16;11;27;11;12;23
294;19.09.2016;2016;09;14;Maanantai;15;25;40;10;15;25
294;19.09.2016;2016;09;15;Maanantai;25;37;62;15;16;31
294;19.09.2016;2016;09;16;Maanantai;20;17;37;7;9;16
294;19.09.2016;2016;09;17;Maanantai;29;23;52;18;17;35
294;19.09.2016;2016;09;18;Maanantai;18;19;37;16;22;38
294;19.09.2016;2016;09;19;Maanantai;27;21;48;13;20;33
294;19.09.2016;2016;09;20;Maanantai;10;7;17;8;5;13
294;19.09.2016;2016;09;21;Maanantai;2;0;2;2;3;5
294;19.09.2016;2016;09;22;Maanantai;0;0;0;0;0;0
294;19.09.2016;2016;09;23;Maanantai;0;0;0;0;0;0
294;20.09.2016;2016;09;00;Tiistai;0;0;0;0;0;0
294;20.09.2016;2016;09;01;Tiistai;0;0;0;0;0;0
294;20.09.2016;2016;09;02;Tiistai;0;0;0;0;0;0
294;20.09.2016;2016;09;03;Tiistai;0;0;0;0;0;0
294;20.09.2016;2016;09;04;Tiistai;0;0;0;2;1;3
294;20.09.2016;2016;09;05;Tiistai;0;1;1;1;1;2
294;20.09.2016;2016;09;06;Tiistai;5;5;10;4;3;7
294;20.09.2016;2016;09;07;Tiistai;20;11;31;2;4;6
294;20.09.2016;2016;09;08;Tiistai;18;7;25;9;5;14
294;20.09.2016;2016;09;09;Tiistai;30;13;43;13;10;23
294;20.09.2016;2016;09;10;Tiistai;3;10;13;12;9;21
294;20.09.2016;2016;09;11;Tiistai;9;14;23;22;22;44
294;20.09.2016;2016;09;12;Tiistai;5;18;23;13;8;21
294;20.09.2016;2016;09;13;Tiistai;11;12;23;15;11;26
294;20.09.2016;2016;09;14;Tiistai;12;19;31;14;5;19
294;20.09.2016;2016;09;15;Tiistai;24;36;60;6;16;22
294;20.09.2016;2016;09;16;Tiistai;16;23;39;7;10;17
294;20.09.2016;2016;09;17;Tiistai;20;18;38;8;8;16
294;20.09.2016;2016;09;18;Tiistai;30;17;47;17;14;31
294;20.09.2016;2016;09;19;Tiistai;18;16;34;16;16;32
294;20.09.2016;2016;09;20;Tiistai;6;11;17;6;7;13
294;20.09.2016;2016;09;21;Tiistai;3;1;4;1;0;1
294;20.09.2016;2016;09;22;Tiistai;0;0;0;0;0;0
294;20.09.2016;2016;09;23;Tiistai;0;0;0;0;0;0
294;21.09.2016;2016;09;00;Keskiviikko;0;0;0;0;0;0
294;21.09.2016;2016;09;01;Keskiviikko;0;0;0;0;0;0
294;21.09.2016;2016;09;02;Keskiviikko;0;0;0;0;0;0
294;21.09.2016;2016;09;03;Keskiviikko;0;0;0;0;0;0
294;21.09.2016;2016;09;04;Keskiviikko;0;0;0;0;1;1
294;21.09.2016;2016;09;05;Keskiviikko;0;0;0;0;0;0
294;21.09.2016;2016;09;06;Keskiviikko;5;3;8;1;2;3
294;21.09.2016;2016;09;07;Keskiviikko;18;6;24;7;3;10
294;21.09.2016;2016;09;08;Keskiviikko;22;6;28;9;5;14
294;21.09.2016;2016;09;09;Keskiviikko;9;19;28;15;15;30
294;21.09.2016;2016;09;10;Keskiviikko;7;6;13;12;19;31
294;21.09.2016;2016;09;11;Keskiviikko;12;15;27;19;10;29
294;21.09.2016;2016;09;12;Keskiviikko;12;17;29;11;17;28
294;21.09.2016;2016;09;13;Keskiviikko;10;18;28;10;9;19
294;21.09.2016;2016;09;14;Keskiviikko;20;22;42;16;20;36
294;21.09.2016;2016;09;15;Keskiviikko;23;33;56;11;17;28
294;21.09.2016;2016;09;16;Keskiviikko;16;12;28;8;12;20
294;21.09.2016;2016;09;17;Keskiviikko;29;32;61;16;19;35
294;21.09.2016;2016;09;18;Keskiviikko;23;26;49;24;26;50
294;21.09.2016;2016;09;19;Keskiviikko;23;23;46;12;20;32
294;21.09.2016;2016;09;20;Keskiviikko;7;9;16;9;7;16
294;21.09.2016;2016;09;21;Keskiviikko;2;1;3;6;2;8
294;21.09.2016;2016;09;22;Keskiviikko;1;0;1;0;2;2
294;21.09.2016;2016;09;23;Keskiviikko;0;0;0;0;0;0
294;22.09.2016;2016;09;00;Torstai;0;1;1;0;0;0
294;22.09.2016;2016;09;01;Torstai;0;0;0;0;0;0
294;22.09.2016;2016;09;02;Torstai;0;0;0;0;0;0
294;22.09.2016;2016;09;03;Torstai;1;0;1;0;0;0
294;22.09.2016;2016;09;04;Torstai;0;0;0;0;0;0
294;22.09.2016;2016;09;05;Torstai;0;1;1;0;0;0
294;22.09.2016;2016;09;06;Torstai;4;0;4;2;3;5
294;22.09.2016;2016;09;07;Torstai;26;8;34;9;6;15
294;22.09.2016;2016;09;08;Torstai;19;5;24;13;4;17
294;22.09.2016;2016;09;09;Torstai;9;9;18;13;14;27
294;22.09.2016;2016;09;10;Torstai;8;17;25;10;11;21
294;22.09.2016;2016;09;11;Torstai;12;14;26;21;11;32
294;22.09.2016;2016;09;12;Torstai;9;14;23;13;17;30
294;22.09.2016;2016;09;13;Torstai;28;29;57;14;18;32
294;22.09.2016;2016;09;14;Torstai;18;26;44;5;10;15
294;22.09.2016;2016;09;15;Torstai;29;38;67;15;16;31
294;22.09.2016;2016;09;16;Torstai;27;19;46;19;11;30
294;22.09.2016;2016;09;17;Torstai;26;33;59;4;14;18
294;22.09.2016;2016;09;18;Torstai;21;25;46;12;21;33
294;22.09.2016;2016;09;19;Torstai;11;22;33;13;18;31
294;22.09.2016;2016;09;20;Torstai;3;7;10;4;8;12
294;22.09.2016;2016;09;21;Torstai;4;3;7;2;1;3
294;22.09.2016;2016;09;22;Torstai;0;0;0;0;1;1
294;22.09.2016;2016;09;23;Torstai;0;0;0;2;3;5
294;23.09.2016;2016;09;00;Perjantai;0;0;0;0;0;0
294;23.09.2016;2016;09;01;Perjantai;0;0;0;0;0;0
294;23.09.2016;2016;09;02;Perjantai;0;0;0;0;0;0
294;23.09.2016;2016;09;03;Perjantai;0;0;0;0;0;0
294;23.09.2016;2016;09;04;Perjantai;0;0;0;0;0;0
294;23.09.2016;2016;09;05;Perjantai;1;0;1;0;0;0
294;23.09.2016;2016;09;06;Perjantai;4;1;5;6;1;7
294;23.09.2016;2016;09;07;Perjantai;11;12;23;5;5;10
294;23.09.2016;2016;09;08;Perjantai;21;5;26;7;3;10
294;23.09.2016;2016;09;09;Perjantai;11;11;22;8;5;13
294;23.09.2016;2016;09;10;Perjantai;8;10;18;11;14;25
294;23.09.2016;2016;09;11;Perjantai;9;14;23;10;12;22
294;23.09.2016;2016;09;12;Perjantai;11;28;39;10;15;25
294;23.09.2016;2016;09;13;Perjantai;36;37;73;14;17;31
294;23.09.2016;2016;09;14;Perjantai;21;28;49;14;19;33
294;23.09.2016;2016;09;15;Perjantai;19;20;39;10;7;17
294;23.09.2016;2016;09;16;Perjantai;25;21;46;7;14;21
294;23.09.2016;2016;09;17;Perjantai;13;19;32;8;11;19
294;23.09.2016;2016;09;18;Perjantai;17;19;36;10;13;23
294;23.09.2016;2016;09;19;Perjantai;23;18;41;4;14;18
294;23.09.2016;2016;09;20;Perjantai;6;6;12;6;2;8
294;23.09.2016;2016;09;21;Perjantai;8;12;20;5;0;5
294;23.09.2016;2016;09;22;Perjantai;6;4;10;3;4;7
294;23.09.2016;2016;09;23;Perjantai;4;7;11;0;0;0
294;24.09.2016;2016;09;00;Lauantai;0;3;3;0;0;0
294;24.09.2016;2016;09;01;Lauantai;0;1;1;1;0;1
294;24.09.2016;2016;09;02;Lauantai;0;0;0;1;1;2
294;24.09.2016;2016;09;03;Lauantai;0;0;0;0;2;2
294;24.09.2016;2016;09;04;Lauantai;0;0;0;0;0;0
294;24.09.2016;2016;09;05;Lauantai;0;0;0;0;0;0
294;24.09.2016;2016;09;06;Lauantai;2;1;3;0;0;0
294;24.09.2016;2016;09;07;Lauantai;2;2;4;1;2;3
294;24.09.2016;2016;09;08;Lauantai;2;4;6;2;5;7
294;24.09.2016;2016;09;09;Lauantai;10;4;14;6;8;14
294;24.09.2016;2016;09;10;Lauantai;6;6;12;5;11;16
294;24.09.2016;2016;09;11;Lauantai;5;14;19;6;15;21
294;24.09.2016;2016;09;12;Lauantai;20;13;33;8;9;17
294;24.09.2016;2016;09;13;Lauantai;13;14;27;9;8;17
294;24.09.2016;2016;09;14;Lauantai;17;13;30;6;5;11
294;24.09.2016;2016;09;15;Lauantai;13;13;26;8;12;20
294;24.09.2016;2016;09;16;Lauantai;18;11;29;11;12;23
294;24.09.2016;2016;09;17;Lauantai;18;16;34;6;7;13
294;24.09.2016;2016;09;18;Lauantai;21;17;38;17;3;20
294;24.09.2016;2016;09;19;Lauantai;10;13;23;8;12;20
294;24.09.2016;2016;09;20;Lauantai;9;10;19;5;5;10
294;24.09.2016;2016;09;21;Lauantai;4;3;7;3;4;7
294;24.09.2016;2016;09;22;Lauantai;2;1;3;5;1;6
294;24.09.2016;2016;09;23;Lauantai;3;0;3;2;1;3
294;25.09.2016;2016;09;00;Sunnuntai;2;0;2;0;0;0
294;25.09.2016;2016;09;01;Sunnuntai;1;0;1;0;1;1
294;25.09.2016;2016;09;02;Sunnuntai;0;0;0;1;1;2
294;25.09.2016;2016;09;03;Sunnuntai;0;0;0;1;0;1
294;25.09.2016;2016;09;04;Sunnuntai;0;0;0;0;0;0
294;25.09.2016;2016;09;05;Sunnuntai;0;0;0;0;0;0
294;25.09.2016;2016;09;06;Sunnuntai;2;0;2;1;1;2
294;25.09.2016;2016;09;07;Sunnuntai;1;1;2;3;1;4
294;25.09.2016;2016;09;08;Sunnuntai;2;2;4;3;1;4
294;25.09.2016;2016;09;09;Sunnuntai;3;3;6;9;2;11
294;25.09.2016;2016;09;10;Sunnuntai;4;3;7;11;5;16
294;25.09.2016;2016;09;11;Sunnuntai;9;5;14;13;6;19
294;25.09.2016;2016;09;12;Sunnuntai;15;16;31;13;11;24
294;25.09.2016;2016;09;13;Sunnuntai;12;5;17;7;8;15
294;25.09.2016;2016;09;14;Sunnuntai;5;5;10;6;4;10
294;25.09.2016;2016;09;15;Sunnuntai;16;15;31;6;11;17
294;25.09.2016;2016;09;16;Sunnuntai;20;8;28;12;15;27
294;25.09.2016;2016;09;17;Sunnuntai;31;30;61;5;5;10
294;25.09.2016;2016;09;18;Sunnuntai;24;25;49;13;13;26
294;25.09.2016;2016;09;19;Sunnuntai;17;19;36;22;10;32
294;25.09.2016;2016;09;20;Sunnuntai;12;4;16;4;3;7
294;25.09.2016;2016;09;21;Sunnuntai;1;0;1;1;0;1
294;25.09.2016;2016;09;22;Sunnuntai;0;0;0;1;2;3
294;25.09.2016;2016;09;23;Sunnuntai;0;0;0;0;0;0
294;26.09.2016;2016;09;00;Maanantai;0;0;0;0;0;0
294;26.09.2016;2016;09;01;Maanantai;0;0;0;0;0;0
294;26.09.2016;2016;09;02;Maanantai;0;0;0;0;0;0
294;26.09.2016;2016;09;03;Maanantai;0;0;0;0;0;0
294;26.09.2016;2016;09;04;Maanantai;0;0;0;0;0;0
294;26.09.2016;2016;09;05;Maanantai;0;0;0;0;1;1
294;26.09.2016;2016;09;06;Maanantai;2;3;5;4;3;7
294;26.09.2016;2016;09;07;Maanantai;23;9;32;4;7;11
294;26.09.2016;2016;09;08;Maanantai;24;11;35;6;3;9
294;26.09.2016;2016;09;09;Maanantai;25;16;41;7;10;17
294;26.09.2016;2016;09;10;Maanantai;13;11;24;28;12;40
294;26.09.2016;2016;09;11;Maanantai;8;31;39;14;14;28
294;26.09.2016;2016;09;12;Maanantai;22;14;36;11;6;17
294;26.09.2016;2016;09;13;Maanantai;11;19;30;15;11;26
294;26.09.2016;2016;09;14;Maanantai;22;18;40;20;17;37
294;26.09.2016;2016;09;15;Maanantai;19;44;63;14;9;23
294;26.09.2016;2016;09;16;Maanantai;34;17;51;14;11;25
294;26.09.2016;2016;09;17;Maanantai;20;30;50;17;14;31
294;26.09.2016;2016;09;18;Maanantai;22;22;44;12;9;21
294;26.09.2016;2016;09;19;Maanantai;29;27;56;15;17;32
294;26.09.2016;2016;09;20;Maanantai;9;4;13;3;7;10
294;26.09.2016;2016;09;21;Maanantai;1;1;2;3;7;10
294;26.09.2016;2016;09;22;Maanantai;0;2;2;0;0;0
294;26.09.2016;2016;09;23;Maanantai;0;0;0;0;0;0
294;27.09.2016;2016;09;00;Tiistai;0;0;0;0;0;0
294;27.09.2016;2016;09;01;Tiistai;0;0;0;0;0;0
294;27.09.2016;2016;09;02;Tiistai;0;0;0;0;0;0
294;27.09.2016;2016;09;03;Tiistai;0;0;0;0;0;0
294;27.09.2016;2016;09;04;Tiistai;0;0;0;0;1;1
294;27.09.2016;2016;09;05;Tiistai;1;0;1;1;1;2
294;27.09.2016;2016;09;06;Tiistai;2;1;3;5;2;7
294;27.09.2016;2016;09;07;Tiistai;12;12;24;5;7;12
294;27.09.2016;2016;09;08;Tiistai;24;8;32;6;1;7
294;27.09.2016;2016;09;09;Tiistai;14;8;22;6;2;8
294;27.09.2016;2016;09;10;Tiistai;8;17;25;11;15;26
294;27.09.2016;2016;09;11;Tiistai;17;20;37;7;10;17
294;27.09.2016;2016;09;12;Tiistai;11;12;23;14;11;25
294;27.09.2016;2016;09;13;Tiistai;29;17;46;7;14;21
294;27.09.2016;2016;09;14;Tiistai;25;28;53;19;13;32
294;27.09.2016;2016;09;15;Tiistai;18;34;52;12;8;20
294;27.09.2016;2016;09;16;Tiistai;30;29;59;12;9;21
294;27.09.2016;2016;09;17;Tiistai;24;33;57;5;11;16
294;27.09.2016;2016;09;18;Tiistai;30;16;46;10;16;26
294;27.09.2016;2016;09;19;Tiistai;12;15;27;20;14;34
294;27.09.2016;2016;09;20;Tiistai;9;8;17;4;7;11
294;27.09.2016;2016;09;21;Tiistai;0;5;5;1;4;5
294;27.09.2016;2016;09;22;Tiistai;1;2;3;0;0;0
294;27.09.2016;2016;09;23;Tiistai;1;0;1;0;0;0
294;28.09.2016;2016;09;00;Keskiviikko;0;0;0;0;0;0
294;28.09.2016;2016;09;01;Keskiviikko;0;0;0;0;0;0
294;28.09.2016;2016;09;02;Keskiviikko;0;0;0;0;0;0
294;28.09.2016;2016;09;03;Keskiviikko;0;0;0;0;0;0
294;28.09.2016;2016;09;04;Keskiviikko;0;0;0;0;1;1
294;28.09.2016;2016;09;05;Keskiviikko;0;0;0;0;0;0
294;28.09.2016;2016;09;06;Keskiviikko;2;1;3;5;1;6
294;28.09.2016;2016;09;07;Keskiviikko;18;12;30;4;4;8
294;28.09.2016;2016;09;08;Keskiviikko;42;8;50;16;3;19
294;28.09.2016;2016;09;09;Keskiviikko;19;34;53;5;14;19
294;28.09.2016;2016;09;10;Keskiviikko;8;18;26;8;14;22
294;28.09.2016;2016;09;11;Keskiviikko;9;21;30;11;10;21
294;28.09.2016;2016;09;12;Keskiviikko;24;15;39;7;6;13
294;28.09.2016;2016;09;13;Keskiviikko;16;20;36;3;2;5
294;28.09.2016;2016;09;14;Keskiviikko;26;25;51;7;9;16
294;28.09.2016;2016;09;15;Keskiviikko;19;14;33;12;12;24
294;28.09.2016;2016;09;16;Keskiviikko;19;18;37;13;11;24
294;28.09.2016;2016;09;17;Keskiviikko;16;6;22;0;4;4
294;28.09.2016;2016;09;18;Keskiviikko;9;7;16;2;2;4
294;28.09.2016;2016;09;19;Keskiviikko;3;6;9;7;7;14
294;28.09.2016;2016;09;20;Keskiviikko;3;1;4;7;3;10
294;28.09.2016;2016;09;21;Keskiviikko;1;1;2;0;0;0
294;28.09.2016;2016;09;22;Keskiviikko;0;0;0;0;0;0
294;28.09.2016;2016;09;23;Keskiviikko;1;0;1;0;0;0
294;29.09.2016;2016;09;00;Torstai;0;0;0;0;0;0
294;29.09.2016;2016;09;01;Torstai;0;0;0;0;0;0
294;29.09.2016;2016;09;02;Torstai;0;0;0;0;0;0
294;29.09.2016;2016;09;03;Torstai;0;0;0;0;0;0
294;29.09.2016;2016;09;04;Torstai;0;0;0;0;0;0
294;29.09.2016;2016;09;05;Torstai;1;0;1;0;0;0
294;29.09.2016;2016;09;06;Torstai;2;3;5;4;2;6
294;29.09.2016;2016;09;07;Torstai;16;15;31;2;4;6
294;29.09.2016;2016;09;08;Torstai;20;9;29;11;3;14
294;29.09.2016;2016;09;09;Torstai;12;50;62;14;11;25
294;29.09.2016;2016;09;10;Torstai;5;9;14;4;6;10
294;29.09.2016;2016;09;11;Torstai;51;13;64;7;1;8
294;29.09.2016;2016;09;12;Torstai;19;14;33;5;7;12
294;29.09.2016;2016;09;13;Torstai;11;27;38;9;14;23
294;29.09.2016;2016;09;14;Torstai;24;16;40;10;9;19
294;29.09.2016;2016;09;15;Torstai;15;14;29;9;6;15
294;29.09.2016;2016;09;16;Torstai;21;16;37;11;10;21
294;29.09.2016;2016;09;17;Torstai;14;14;28;8;11;19
294;29.09.2016;2016;09;18;Torstai;21;30;51;16;19;35
294;29.09.2016;2016;09;19;Torstai;12;9;21;6;9;15
294;29.09.2016;2016;09;20;Torstai;0;6;6;2;4;6
294;29.09.2016;2016;09;21;Torstai;2;0;2;0;1;1
294;29.09.2016;2016;09;22;Torstai;0;0;0;0;0;0
294;29.09.2016;2016;09;23;Torstai;0;0;0;0;0;0
294;30.09.2016;2016;09;00;Perjantai;0;0;0;0;0;0
294;30.09.2016;2016;09;01;Perjantai;0;0;0;0;0;0
294;30.09.2016;2016;09;02;Perjantai;0;0;0;0;0;0
294;30.09.2016;2016;09;03;Perjantai;0;0;0;0;0;0
294;30.09.2016;2016;09;04;Perjantai;0;0;0;0;0;0
294;30.09.2016;2016;09;05;Perjantai;1;0;1;0;0;0
294;30.09.2016;2016;09;06;Perjantai;1;2;3;0;0;0
294;30.09.2016;2016;09;07;Perjantai;16;9;25;3;2;5
294;30.09.2016;2016;09;08;Perjantai;21;1;22;6;3;9
294;30.09.2016;2016;09;09;Perjantai;9;10;19;6;7;13
294;30.09.2016;2016;09;10;Perjantai;11;13;24;7;11;18
294;30.09.2016;2016;09;11;Perjantai;14;8;22;15;15;30
294;30.09.2016;2016;09;12;Perjantai;26;32;58;13;16;29
294;30.09.2016;2016;09;13;Perjantai;28;30;58;17;15;32
294;30.09.2016;2016;09;14;Perjantai;26;36;62;13;24;37
294;30.09.2016;2016;09;15;Perjantai;23;20;43;12;12;24
294;30.09.2016;2016;09;16;Perjantai;34;27;61;8;17;25
294;30.09.2016;2016;09;17;Perjantai;44;44;88;14;10;24
294;30.09.2016;2016;09;18;Perjantai;34;28;62;23;18;41
294;30.09.2016;2016;09;19;Perjantai;16;23;39;11;9;20
294;30.09.2016;2016;09;20;Perjantai;18;10;28;1;3;4
294;30.09.2016;2016;09;21;Perjantai;7;0;7;0;1;1
294;30.09.2016;2016;09;22;Perjantai;1;1;2;0;1;1
294;30.09.2016;2016;09;23;Perjantai;6;4;10;2;0;2
294;01.10.2016;2016;10;00;Lauantai;1;0;1;0;0;0
294;01.10.2016;2016;10;01;Lauantai;1;0;1;0;0;0
294;01.10.2016;2016;10;02;Lauantai;1;0;1;1;1;2
294;01.10.2016;2016;10;03;Lauantai;0;0;0;0;0;0
294;01.10.2016;2016;10;04;Lauantai;0;0;0;0;0;0
294;01.10.2016;2016;10;05;Lauantai;0;0;0;0;0;0
294;01.10.2016;2016;10;06;Lauantai;3;0;3;0;3;3
294;01.10.2016;2016;10;07;Lauantai;0;0;0;3;3;6
294;01.10.2016;2016;10;08;Lauantai;2;0;2;3;2;5
294;01.10.2016;2016;10;09;Lauantai;10;6;16;8;6;14
294;01.10.2016;2016;10;10;Lauantai;13;23;36;14;16;30
294;01.10.2016;2016;10;11;Lauantai;20;26;46;6;13;19
294;01.10.2016;2016;10;12;Lauantai;14;15;29;11;10;21
294;01.10.2016;2016;10;13;Lauantai;27;23;50;12;5;17
294;01.10.2016;2016;10;14;Lauantai;16;15;31;12;9;21
294;01.10.2016;2016;10;15;Lauantai;9;14;23;2;6;8
294;01.10.2016;2016;10;16;Lauantai;31;23;54;9;8;17
294;01.10.2016;2016;10;17;Lauantai;22;16;38;18;9;27
294;01.10.2016;2016;10;18;Lauantai;21;26;47;3;10;13
294;01.10.2016;2016;10;19;Lauantai;19;16;35;9;11;20
294;01.10.2016;2016;10;20;Lauantai;13;6;19;3;1;4
294;01.10.2016;2016;10;21;Lauantai;1;2;3;1;2;3
294;01.10.2016;2016;10;22;Lauantai;1;0;1;2;0;2
294;01.10.2016;2016;10;23;Lauantai;1;0;1;0;1;1
294;02.10.2016;2016;10;00;Sunnuntai;0;0;0;1;2;3
294;02.10.2016;2016;10;01;Sunnuntai;1;0;1;0;1;1
294;02.10.2016;2016;10;02;Sunnuntai;1;0;1;0;1;1
294;02.10.2016;2016;10;03;Sunnuntai;0;0;0;0;0;0
294;02.10.2016;2016;10;04;Sunnuntai;0;0;0;1;0;1
294;02.10.2016;2016;10;05;Sunnuntai;1;0;1;0;0;0
294;02.10.2016;2016;10;06;Sunnuntai;0;0;0;2;0;2
294;02.10.2016;2016;10;07;Sunnuntai;0;1;1;1;1;2
294;02.10.2016;2016;10;08;Sunnuntai;3;0;3;2;2;4
294;02.10.2016;2016;10;09;Sunnuntai;7;2;9;8;3;11
294;02.10.2016;2016;10;10;Sunnuntai;10;4;14;8;11;19
294;02.10.2016;2016;10;11;Sunnuntai;10;11;21;3;11;14
294;02.10.2016;2016;10;12;Sunnuntai;12;17;29;8;16;24
294;02.10.2016;2016;10;13;Sunnuntai;20;11;31;4;12;16
294;02.10.2016;2016;10;14;Sunnuntai;12;17;29;5;6;11
294;02.10.2016;2016;10;15;Sunnuntai;9;4;13;10;13;23
294;02.10.2016;2016;10;16;Sunnuntai;9;12;21;10;4;14
294;02.10.2016;2016;10;17;Sunnuntai;24;16;40;9;11;20
294;02.10.2016;2016;10;18;Sunnuntai;14;19;33;18;14;32
294;02.10.2016;2016;10;19;Sunnuntai;15;16;31;12;10;22
294;02.10.2016;2016;10;20;Sunnuntai;6;4;10;6;2;8
294;02.10.2016;2016;10;21;Sunnuntai;0;1;1;3;2;5
294;02.10.2016;2016;10;22;Sunnuntai;0;0;0;1;0;1
294;02.10.2016;2016;10;23;Sunnuntai;0;1;1;0;0;0
294;03.10.2016;2016;10;00;Maanantai;0;0;0;0;0;0
294;03.10.2016;2016;10;01;Maanantai;0;0;0;0;0;0
294;03.10.2016;2016;10;02;Maanantai;0;0;0;0;0;0
294;03.10.2016;2016;10;03;Maanantai;0;0;0;0;0;0
294;03.10.2016;2016;10;04;Maanantai;0;0;0;0;0;0
294;03.10.2016;2016;10;05;Maanantai;0;0;0;0;0;0
294;03.10.2016;2016;10;06;Maanantai;3;2;5;2;3;5
294;03.10.2016;2016;10;07;Maanantai;18;7;25;6;5;11
294;03.10.2016;2016;10;08;Maanantai;23;4;27;15;6;21
294;03.10.2016;2016;10;09;Maanantai;26;13;39;8;17;25
294;03.10.2016;2016;10;10;Maanantai;16;6;22;24;12;36
294;03.10.2016;2016;10;11;Maanantai;12;25;37;22;17;39
294;03.10.2016;2016;10;12;Maanantai;13;12;25;12;14;26
294;03.10.2016;2016;10;13;Maanantai;15;19;34;13;9;22
294;03.10.2016;2016;10;14;Maanantai;15;25;40;12;20;32
294;03.10.2016;2016;10;15;Maanantai;25;34;59;6;10;16
294;03.10.2016;2016;10;16;Maanantai;21;19;40;10;10;20
294;03.10.2016;2016;10;17;Maanantai;21;22;43;11;8;19
294;03.10.2016;2016;10;18;Maanantai;15;24;39;14;8;22
294;03.10.2016;2016;10;19;Maanantai;20;15;35;9;10;19
294;03.10.2016;2016;10;20;Maanantai;2;2;4;8;7;15
294;03.10.2016;2016;10;21;Maanantai;3;4;7;0;1;1
294;03.10.2016;2016;10;22;Maanantai;0;0;0;0;0;0
294;03.10.2016;2016;10;23;Maanantai;0;0;0;0;0;0
294;04.10.2016;2016;10;00;Tiistai;0;0;0;0;0;0
294;04.10.2016;2016;10;01;Tiistai;0;0;0;0;0;0
294;04.10.2016;2016;10;02;Tiistai;0;0;0;0;0;0
294;04.10.2016;2016;10;03;Tiistai;0;0;0;0;0;0
294;04.10.2016;2016;10;04;Tiistai;0;0;0;0;1;1
294;04.10.2016;2016;10;05;Tiistai;1;0;1;0;0;0
294;04.10.2016;2016;10;06;Tiistai;2;1;3;3;2;5
294;04.10.2016;2016;10;07;Tiistai;11;10;21;5;1;6
294;04.10.2016;2016;10;08;Tiistai;24;7;31;5;5;10
294;04.10.2016;2016;10;09;Tiistai;21;9;30;19;14;33
294;04.10.2016;2016;10;10;Tiistai;2;5;7;7;7;14
294;04.10.2016;2016;10;11;Tiistai;15;13;28;12;17;29
294;04.10.2016;2016;10;12;Tiistai;14;9;23;22;16;38
294;04.10.2016;2016;10;13;Tiistai;8;12;20;12;13;25
294;04.10.2016;2016;10;14;Tiistai;14;18;32;19;14;33
294;04.10.2016;2016;10;15;Tiistai;13;32;45;4;13;17
294;04.10.2016;2016;10;16;Tiistai;18;24;42;17;12;29
294;04.10.2016;2016;10;17;Tiistai;30;31;61;11;10;21
294;04.10.2016;2016;10;18;Tiistai;24;20;44;11;18;29
294;04.10.2016;2016;10;19;Tiistai;21;17;38;14;7;21
294;04.10.2016;2016;10;20;Tiistai;4;7;11;8;2;10
294;04.10.2016;2016;10;21;Tiistai;0;0;0;1;1;2
294;04.10.2016;2016;10;22;Tiistai;0;1;1;0;1;1
294;04.10.2016;2016;10;23;Tiistai;0;0;0;0;0;0
294;05.10.2016;2016;10;00;Keskiviikko;0;0;0;0;0;0
294;05.10.2016;2016;10;01;Keskiviikko;0;0;0;0;0;0
294;05.10.2016;2016;10;02;Keskiviikko;0;0;0;0;0;0
294;05.10.2016;2016;10;03;Keskiviikko;0;0;0;0;0;0
294;05.10.2016;2016;10;04;Keskiviikko;0;0;0;0;0;0
294;05.10.2016;2016;10;05;Keskiviikko;0;0;0;0;1;1
294;05.10.2016;2016;10;06;Keskiviikko;5;0;5;2;5;7
294;05.10.2016;2016;10;07;Keskiviikko;15;4;19;4;1;5
294;05.10.2016;2016;10;08;Keskiviikko;19;6;25;9;11;20
294;05.10.2016;2016;10;09;Keskiviikko;8;19;27;13;14;27
294;05.10.2016;2016;10;10;Keskiviikko;11;6;17;23;18;41
294;05.10.2016;2016;10;11;Keskiviikko;12;17;29;17;23;40
294;05.10.2016;2016;10;12;Keskiviikko;13;13;26;11;14;25
294;05.10.2016;2016;10;13;Keskiviikko;16;18;34;18;7;25
294;05.10.2016;2016;10;14;Keskiviikko;10;34;44;8;11;19
294;05.10.2016;2016;10;15;Keskiviikko;22;14;36;14;11;25
294;05.10.2016;2016;10;16;Keskiviikko;16;17;33;7;15;22
294;05.10.2016;2016;10;17;Keskiviikko;19;11;30;5;6;11
294;05.10.2016;2016;10;18;Keskiviikko;14;19;33;11;7;18
294;05.10.2016;2016;10;19;Keskiviikko;16;7;23;12;11;23
294;05.10.2016;2016;10;20;Keskiviikko;4;5;9;4;4;8
294;05.10.2016;2016;10;21;Keskiviikko;0;0;0;1;0;1
294;05.10.2016;2016;10;22;Keskiviikko;0;0;0;0;0;0
294;05.10.2016;2016;10;23;Keskiviikko;0;0;0;0;0;0
294;06.10.2016;2016;10;00;Torstai;0;0;0;0;0;0
294;06.10.2016;2016;10;01;Torstai;0;0;0;0;0;0
294;06.10.2016;2016;10;02;Torstai;0;0;0;0;0;0
294;06.10.2016;2016;10;03;Torstai;0;0;0;0;0;0
294;06.10.2016;2016;10;04;Torstai;0;0;0;0;1;1
294;06.10.2016;2016;10;05;Torstai;1;0;1;0;0;0
294;06.10.2016;2016;10;06;Torstai;4;3;7;3;4;7
294;06.10.2016;2016;10;07;Torstai;16;8;24;4;4;8
294;06.10.2016;2016;10;08;Torstai;25;9;34;8;4;12
294;06.10.2016;2016;10;09;Torstai;21;12;33;7;5;12
294;06.10.2016;2016;10;10;Torstai;5;5;10;10;12;22
294;06.10.2016;2016;10;11;Torstai;7;15;22;15;10;25
294;06.10.2016;2016;10;12;Torstai;10;6;16;11;15;26
294;06.10.2016;2016;10;13;Torstai;9;17;26;8;8;16
294;06.10.2016;2016;10;14;Torstai;18;20;38;20;12;32
294;06.10.2016;2016;10;15;Torstai;17;45;62;11;19;30
294;06.10.2016;2016;10;16;Torstai;30;18;48;13;14;27
294;06.10.2016;2016;10;17;Torstai;20;9;29;12;8;20
294;06.10.2016;2016;10;18;Torstai;11;13;24;19;20;39
294;06.10.2016;2016;10;19;Torstai;12;12;24;5;13;18
294;06.10.2016;2016;10;20;Torstai;4;4;8;2;1;3
294;06.10.2016;2016;10;21;Torstai;2;1;3;0;1;1
294;06.10.2016;2016;10;22;Torstai;0;0;0;0;1;1
294;06.10.2016;2016;10;23;Torstai;0;0;0;0;0;0
294;07.10.2016;2016;10;00;Perjantai;0;0;0;0;0;0
294;07.10.2016;2016;10;01;Perjantai;0;0;0;1;0;1
294;07.10.2016;2016;10;02;Perjantai;0;0;0;0;0;0
294;07.10.2016;2016;10;03;Perjantai;0;0;0;1;0;1
294;07.10.2016;2016;10;04;Perjantai;0;0;0;0;1;1
294;07.10.2016;2016;10;05;Perjantai;0;0;0;0;0;0
294;07.10.2016;2016;10;06;Perjantai;1;2;3;3;2;5
294;07.10.2016;2016;10;07;Perjantai;10;10;20;5;3;8
294;07.10.2016;2016;10;08;Perjantai;14;5;19;8;5;13
294;07.10.2016;2016;10;09;Perjantai;28;8;36;5;10;15
294;07.10.2016;2016;10;10;Perjantai;7;8;15;8;9;17
294;07.10.2016;2016;10;11;Perjantai;14;20;34;13;11;24
294;07.10.2016;2016;10;12;Perjantai;18;34;52;14;19;33
294;07.10.2016;2016;10;13;Perjantai;52;34;86;16;12;28
294;07.10.2016;2016;10;14;Perjantai;19;39;58;7;16;23
294;07.10.2016;2016;10;15;Perjantai;25;30;55;17;18;35
294;07.10.2016;2016;10;16;Perjantai;15;28;43;12;10;22
294;07.10.2016;2016;10;17;Perjantai;19;19;38;13;9;22
294;07.10.2016;2016;10;18;Perjantai;23;12;35;9;4;13
294;07.10.2016;2016;10;19;Perjantai;23;20;43;7;11;18
294;07.10.2016;2016;10;20;Perjantai;11;9;20;6;8;14
294;07.10.2016;2016;10;21;Perjantai;2;1;3;2;4;6
294;07.10.2016;2016;10;22;Perjantai;2;2;4;0;1;1
294;07.10.2016;2016;10;23;Perjantai;0;1;1;2;1;3
294;08.10.2016;2016;10;00;Lauantai;3;1;4;1;1;2
294;08.10.2016;2016;10;01;Lauantai;0;0;0;2;2;4
294;08.10.2016;2016;10;02;Lauantai;0;0;0;0;1;1
294;08.10.2016;2016;10;03;Lauantai;0;0;0;1;3;4
294;08.10.2016;2016;10;04;Lauantai;0;0;0;0;0;0
294;08.10.2016;2016;10;05;Lauantai;1;0;1;0;0;0
294;08.10.2016;2016;10;06;Lauantai;1;1;2;0;0;0
294;08.10.2016;2016;10;07;Lauantai;3;0;3;2;0;2
294;08.10.2016;2016;10;08;Lauantai;0;3;3;6;4;10
294;08.10.2016;2016;10;09;Lauantai;13;10;23;8;4;12
294;08.10.2016;2016;10;10;Lauantai;12;11;23;11;8;19
294;08.10.2016;2016;10;11;Lauantai;13;9;22;15;16;31
294;08.10.2016;2016;10;12;Lauantai;9;9;18;8;7;15
294;08.10.2016;2016;10;13;Lauantai;6;19;25;13;9;22
294;08.10.2016;2016;10;14;Lauantai;26;22;48;16;24;40
294;08.10.2016;2016;10;15;Lauantai;19;21;40;13;8;21
294;08.10.2016;2016;10;16;Lauantai;11;15;26;4;1;5
294;08.10.2016;2016;10;17;Lauantai;24;28;52;6;10;16
294;08.10.2016;2016;10;18;Lauantai;14;19;33;9;14;23
294;08.10.2016;2016;10;19;Lauantai;14;8;22;9;9;18
294;08.10.2016;2016;10;20;Lauantai;3;3;6;6;4;10
294;08.10.2016;2016;10;21;Lauantai;5;1;6;0;2;2
294;08.10.2016;2016;10;22;Lauantai;1;0;1;0;0;0
294;08.10.2016;2016;10;23;Lauantai;4;2;6;1;0;1
294;09.10.2016;2016;10;00;Sunnuntai;0;0;0;0;0;0
294;09.10.2016;2016;10;01;Sunnuntai;0;0;0;0;0;0
294;09.10.2016;2016;10;02;Sunnuntai;0;0;0;1;0;1
294;09.10.2016;2016;10;03;Sunnuntai;0;0;0;0;0;0
294;09.10.2016;2016;10;04;Sunnuntai;0;0;0;0;0;0
294;09.10.2016;2016;10;05;Sunnuntai;0;0;0;0;0;0
294;09.10.2016;2016;10;06;Sunnuntai;0;0;0;0;1;1
294;09.10.2016;2016;10;07;Sunnuntai;1;0;1;3;1;4
294;09.10.2016;2016;10;08;Sunnuntai;0;0;0;3;1;4
294;09.10.2016;2016;10;09;Sunnuntai;8;2;10;11;8;19
294;09.10.2016;2016;10;10;Sunnuntai;2;5;7;9;7;16
294;09.10.2016;2016;10;11;Sunnuntai;8;15;23;5;15;20
294;09.10.2016;2016;10;12;Sunnuntai;12;6;18;10;8;18
294;09.10.2016;2016;10;13;Sunnuntai;20;8;28;10;7;17
294;09.10.2016;2016;10;14;Sunnuntai;12;16;28;7;11;18
294;09.10.2016;2016;10;15;Sunnuntai;15;8;23;7;7;14
294;09.10.2016;2016;10;16;Sunnuntai;8;15;23;8;10;18
294;09.10.2016;2016;10;17;Sunnuntai;2;12;14;7;10;17
294;09.10.2016;2016;10;18;Sunnuntai;17;16;33;11;13;24
294;09.10.2016;2016;10;19;Sunnuntai;14;8;22;17;14;31
294;09.10.2016;2016;10;20;Sunnuntai;1;1;2;4;2;6
294;09.10.2016;2016;10;21;Sunnuntai;0;1;1;1;0;1
294;09.10.2016;2016;10;22;Sunnuntai;1;1;2;0;0;0
294;09.10.2016;2016;10;23;Sunnuntai;0;0;0;0;1;1
294;10.10.2016;2016;10;00;Maanantai;0;0;0;0;0;0
294;10.10.2016;2016;10;01;Maanantai;0;0;0;0;0;0
294;10.10.2016;2016;10;02;Maanantai;0;0;0;0;0;0
294;10.10.2016;2016;10;03;Maanantai;0;0;0;0;0;0
294;10.10.2016;2016;10;04;Maanantai;0;0;0;0;1;1
294;10.10.2016;2016;10;05;Maanantai;0;0;0;0;0;0
294;10.10.2016;2016;10;06;Maanantai;4;2;6;3;2;5
294;10.10.2016;2016;10;07;Maanantai;9;12;21;2;2;4
294;10.10.2016;2016;10;08;Maanantai;23;11;34;13;9;22
294;10.10.2016;2016;10;09;Maanantai;16;13;29;10;13;23
294;10.10.2016;2016;10;10;Maanantai;13;10;23;16;15;31
294;10.10.2016;2016;10;11;Maanantai;5;18;23;15;15;30
294;10.10.2016;2016;10;12;Maanantai;10;22;32;13;13;26
294;10.10.2016;2016;10;13;Maanantai;16;18;34;19;16;35
294;10.10.2016;2016;10;14;Maanantai;27;26;53;20;15;35
294;10.10.2016;2016;10;15;Maanantai;15;28;43;8;7;15
294;10.10.2016;2016;10;16;Maanantai;21;24;45;17;16;33
294;10.10.2016;2016;10;17;Maanantai;17;17;34;13;13;26
294;10.10.2016;2016;10;18;Maanantai;23;20;43;13;9;22
294;10.10.2016;2016;10;19;Maanantai;9;5;14;11;12;23
294;10.10.2016;2016;10;20;Maanantai;6;1;7;6;4;10
294;10.10.2016;2016;10;21;Maanantai;4;3;7;4;3;7
294;10.10.2016;2016;10;22;Maanantai;0;0;0;1;0;1
294;10.10.2016;2016;10;23;Maanantai;0;0;0;1;0;1
294;11.10.2016;2016;10;00;Tiistai;0;0;0;0;0;0
294;11.10.2016;2016;10;01;Tiistai;0;0;0;0;0;0
294;11.10.2016;2016;10;02;Tiistai;0;0;0;0;0;0
294;11.10.2016;2016;10;03;Tiistai;0;0;0;0;0;0
294;11.10.2016;2016;10;04;Tiistai;0;0;0;0;1;1
294;11.10.2016;2016;10;05;Tiistai;1;0;1;0;0;0
294;11.10.2016;2016;10;06;Tiistai;4;1;5;1;3;4
294;11.10.2016;2016;10;07;Tiistai;10;9;19;5;5;10
294;11.10.2016;2016;10;08;Tiistai;23;8;31;9;5;14
294;11.10.2016;2016;10;09;Tiistai;26;12;38;26;11;37
294;11.10.2016;2016;10;10;Tiistai;9;11;20;11;16;27
294;11.10.2016;2016;10;11;Tiistai;11;4;15;24;21;45
294;11.10.2016;2016;10;12;Tiistai;7;17;24;13;19;32
294;11.10.2016;2016;10;13;Tiistai;14;16;30;16;16;32
294;11.10.2016;2016;10;14;Tiistai;32;28;60;14;7;21
294;11.10.2016;2016;10;15;Tiistai;27;41;68;15;15;30
294;11.10.2016;2016;10;16;Tiistai;21;22;43;20;14;34
294;11.10.2016;2016;10;17;Tiistai;21;23;44;14;19;33
294;11.10.2016;2016;10;18;Tiistai;23;17;40;21;24;45
294;11.10.2016;2016;10;19;Tiistai;8;10;18;8;15;23
294;11.10.2016;2016;10;20;Tiistai;4;8;12;3;6;9
294;11.10.2016;2016;10;21;Tiistai;4;0;4;4;1;5
294;11.10.2016;2016;10;22;Tiistai;0;2;2;0;0;0
294;11.10.2016;2016;10;23;Tiistai;1;0;1;0;0;0
294;12.10.2016;2016;10;00;Keskiviikko;0;0;0;0;0;0
294;12.10.2016;2016;10;01;Keskiviikko;0;0;0;0;0;0
294;12.10.2016;2016;10;02;Keskiviikko;0;0;0;0;0;0
294;12.10.2016;2016;10;03;Keskiviikko;0;0;0;0;0;0
294;12.10.2016;2016;10;04;Keskiviikko;0;0;0;0;1;1
294;12.10.2016;2016;10;05;Keskiviikko;0;1;1;0;1;1
294;12.10.2016;2016;10;06;Keskiviikko;3;1;4;0;1;1
294;12.10.2016;2016;10;07;Keskiviikko;13;7;20;10;2;12
294;12.10.2016;2016;10;08;Keskiviikko;25;3;28;12;2;14
294;12.10.2016;2016;10;09;Keskiviikko;13;15;28;18;17;35
294;12.10.2016;2016;10;10;Keskiviikko;7;4;11;9;8;17
294;12.10.2016;2016;10;11;Keskiviikko;5;22;27;22;13;35
294;12.10.2016;2016;10;12;Keskiviikko;15;9;24;12;18;30
294;12.10.2016;2016;10;13;Keskiviikko;15;25;40;4;5;9
294;12.10.2016;2016;10;14;Keskiviikko;29;19;48;9;17;26
294;12.10.2016;2016;10;15;Keskiviikko;20;17;37;11;9;20
294;12.10.2016;2016;10;16;Keskiviikko;18;35;53;11;11;22
294;12.10.2016;2016;10;17;Keskiviikko;14;14;28;10;16;26
294;12.10.2016;2016;10;18;Keskiviikko;18;18;36;15;14;29
294;12.10.2016;2016;10;19;Keskiviikko;15;12;27;22;15;37
294;12.10.2016;2016;10;20;Keskiviikko;3;4;7;3;4;7
294;12.10.2016;2016;10;21;Keskiviikko;1;5;6;2;4;6
294;12.10.2016;2016;10;22;Keskiviikko;0;2;2;0;0;0
294;12.10.2016;2016;10;23;Keskiviikko;1;0;1;0;0;0
294;13.10.2016;2016;10;00;Torstai;0;0;0;0;0;0
294;13.10.2016;2016;10;01;Torstai;0;0;0;0;0;0
294;13.10.2016;2016;10;02;Torstai;0;0;0;0;0;0
294;13.10.2016;2016;10;03;Torstai;0;0;0;0;0;0
294;13.10.2016;2016;10;04;Torstai;0;0;0;0;1;1
294;13.10.2016;2016;10;05;Torstai;1;1;2;0;0;0
294;13.10.2016;2016;10;06;Torstai;3;2;5;3;5;8
294;13.10.2016;2016;10;07;Torstai;18;10;28;4;4;8
294;13.10.2016;2016;10;08;Torstai;20;5;25;12;4;16
294;13.10.2016;2016;10;09;Torstai;16;5;21;11;12;23
294;13.10.2016;2016;10;10;Torstai;5;7;12;11;5;16
294;13.10.2016;2016;10;11;Torstai;14;16;30;20;15;35
294;13.10.2016;2016;10;12;Torstai;19;11;30;20;18;38
294;13.10.2016;2016;10;13;Torstai;25;12;37;14;15;29
294;13.10.2016;2016;10;14;Torstai;27;28;55;21;12;33
294;13.10.2016;2016;10;15;Torstai;16;37;53;16;12;28
294;13.10.2016;2016;10;16;Torstai;27;25;52;16;14;30
294;13.10.2016;2016;10;17;Torstai;27;31;58;12;26;38
294;13.10.2016;2016;10;18;Torstai;19;22;41;11;9;20
294;13.10.2016;2016;10;19;Torstai;9;12;21;10;15;25
294;13.10.2016;2016;10;20;Torstai;3;6;9;4;1;5
294;13.10.2016;2016;10;21;Torstai;1;3;4;5;2;7
294;13.10.2016;2016;10;22;Torstai;0;0;0;0;0;0
294;13.10.2016;2016;10;23;Torstai;1;0;1;0;0;0
294;14.10.2016;2016;10;00;Perjantai;0;0;0;0;0;0
294;14.10.2016;2016;10;01;Perjantai;0;0;0;0;0;0
294;14.10.2016;2016;10;02;Perjantai;0;0;0;0;0;0
294;14.10.2016;2016;10;03;Perjantai;0;0;0;0;0;0
294;14.10.2016;2016;10;04;Perjantai;0;0;0;0;0;0
294;14.10.2016;2016;10;05;Perjantai;0;0;0;0;0;0
294;14.10.2016;2016;10;06;Perjantai;3;1;4;3;2;5
294;14.10.2016;2016;10;07;Perjantai;13;11;24;4;5;9
294;14.10.2016;2016;10;08;Perjantai;10;8;18;8;7;15
294;14.10.2016;2016;10;09;Perjantai;19;8;27;7;10;17
294;14.10.2016;2016;10;10;Perjantai;7;12;19;13;10;23
294;14.10.2016;2016;10;11;Perjantai;12;9;21;18;12;30
294;14.10.2016;2016;10;12;Perjantai;22;16;38;20;21;41
294;14.10.2016;2016;10;13;Perjantai;25;20;45;14;20;34
294;14.10.2016;2016;10;14;Perjantai;24;40;64;11;15;26
294;14.10.2016;2016;10;15;Perjantai;22;24;46;13;12;25
294;14.10.2016;2016;10;16;Perjantai;28;21;49;8;10;18
294;14.10.2016;2016;10;17;Perjantai;10;10;20;12;7;19
294;14.10.2016;2016;10;18;Perjantai;13;16;29;6;8;14
294;14.10.2016;2016;10;19;Perjantai;18;7;25;6;7;13
294;14.10.2016;2016;10;20;Perjantai;4;7;11;6;2;8
294;14.10.2016;2016;10;21;Perjantai;6;0;6;5;0;5
294;14.10.2016;2016;10;22;Perjantai;3;0;3;1;0;1
294;14.10.2016;2016;10;23;Perjantai;2;1;3;0;1;1
294;15.10.2016;2016;10;00;Lauantai;3;0;3;3;0;3
294;15.10.2016;2016;10;01;Lauantai;1;1;2;0;1;1
294;15.10.2016;2016;10;02;Lauantai;0;0;0;0;0;0
294;15.10.2016;2016;10;03;Lauantai;0;0;0;0;0;0
294;15.10.2016;2016;10;04;Lauantai;0;0;0;0;0;0
294;15.10.2016;2016;10;05;Lauantai;1;0;1;0;0;0
294;15.10.2016;2016;10;06;Lauantai;0;1;1;1;1;2
294;15.10.2016;2016;10;07;Lauantai;0;0;0;2;3;5
294;15.10.2016;2016;10;08;Lauantai;1;4;5;4;3;7
294;15.10.2016;2016;10;09;Lauantai;6;4;10;3;5;8
294;15.10.2016;2016;10;10;Lauantai;4;5;9;4;5;9
294;15.10.2016;2016;10;11;Lauantai;8;7;15;13;8;21
294;15.10.2016;2016;10;12;Lauantai;10;6;16;7;6;13
294;15.10.2016;2016;10;13;Lauantai;11;12;23;9;5;14
294;15.10.2016;2016;10;14;Lauantai;9;8;17;10;14;24
294;15.10.2016;2016;10;15;Lauantai;9;13;22;5;6;11
294;15.10.2016;2016;10;16;Lauantai;17;4;21;3;8;11
294;15.10.2016;2016;10;17;Lauantai;7;7;14;13;8;21
294;15.10.2016;2016;10;18;Lauantai;10;7;17;8;4;12
294;15.10.2016;2016;10;19;Lauantai;2;4;6;4;4;8
294;15.10.2016;2016;10;20;Lauantai;0;3;3;1;2;3
294;15.10.2016;2016;10;21;Lauantai;1;1;2;0;1;1
294;15.10.2016;2016;10;22;Lauantai;0;0;0;0;0;0
294;15.10.2016;2016;10;23;Lauantai;2;1;3;0;1;1
294;16.10.2016;2016;10;00;Sunnuntai;0;0;0;1;0;1
294;16.10.2016;2016;10;01;Sunnuntai;1;0;1;0;1;1
294;16.10.2016;2016;10;02;Sunnuntai;0;0;0;0;0;0
294;16.10.2016;2016;10;03;Sunnuntai;1;0;1;0;0;0
294;16.10.2016;2016;10;04;Sunnuntai;1;0;1;0;0;0
294;16.10.2016;2016;10;05;Sunnuntai;0;0;0;0;2;2
294;16.10.2016;2016;10;06;Sunnuntai;1;0;1;1;2;3
294;16.10.2016;2016;10;07;Sunnuntai;1;1;2;2;0;2
294;16.10.2016;2016;10;08;Sunnuntai;2;1;3;0;2;2
294;16.10.2016;2016;10;09;Sunnuntai;5;1;6;9;1;10
294;16.10.2016;2016;10;10;Sunnuntai;1;2;3;8;4;12
294;16.10.2016;2016;10;11;Sunnuntai;5;6;11;11;7;18
294;16.10.2016;2016;10;12;Sunnuntai;4;10;14;6;10;16
294;16.10.2016;2016;10;13;Sunnuntai;6;10;16;3;9;12
294;16.10.2016;2016;10;14;Sunnuntai;1;3;4;12;10;22
294;16.10.2016;2016;10;15;Sunnuntai;6;2;8;7;6;13
294;16.10.2016;2016;10;16;Sunnuntai;5;6;11;8;10;18
294;16.10.2016;2016;10;17;Sunnuntai;10;12;22;7;10;17
294;16.10.2016;2016;10;18;Sunnuntai;8;6;14;13;5;18
294;16.10.2016;2016;10;19;Sunnuntai;8;3;11;10;6;16
294;16.10.2016;2016;10;20;Sunnuntai;2;2;4;4;8;12
294;16.10.2016;2016;10;21;Sunnuntai;1;0;1;4;2;6
294;16.10.2016;2016;10;22;Sunnuntai;0;0;0;0;0;0
294;16.10.2016;2016;10;23;Sunnuntai;0;0;0;0;0;0
294;17.10.2016;2016;10;00;Maanantai;0;0;0;0;0;0
294;17.10.2016;2016;10;01;Maanantai;0;0;0;0;0;0
294;17.10.2016;2016;10;02;Maanantai;0;0;0;0;0;0
294;17.10.2016;2016;10;03;Maanantai;0;0;0;0;0;0
294;17.10.2016;2016;10;04;Maanantai;0;0;0;0;1;1
294;17.10.2016;2016;10;05;Maanantai;1;0;1;1;1;2
294;17.10.2016;2016;10;06;Maanantai;2;1;3;1;3;4
294;17.10.2016;2016;10;07;Maanantai;14;9;23;9;4;13
294;17.10.2016;2016;10;08;Maanantai;22;8;30;15;10;25
294;17.10.2016;2016;10;09;Maanantai;17;10;27;20;15;35
294;17.10.2016;2016;10;10;Maanantai;8;6;14;14;13;27
294;17.10.2016;2016;10;11;Maanantai;12;15;27;26;21;47
294;17.10.2016;2016;10;12;Maanantai;4;2;6;9;14;23
294;17.10.2016;2016;10;13;Maanantai;16;17;33;16;10;26
294;17.10.2016;2016;10;14;Maanantai;17;20;37;20;17;37
294;17.10.2016;2016;10;15;Maanantai;15;24;39;10;10;20
294;17.10.2016;2016;10;16;Maanantai;16;13;29;6;15;21
294;17.10.2016;2016;10;17;Maanantai;11;24;35;11;13;24
294;17.10.2016;2016;10;18;Maanantai;10;8;18;18;14;32
294;17.10.2016;2016;10;19;Maanantai;17;17;34;18;16;34
294;17.10.2016;2016;10;20;Maanantai;5;2;7;8;6;14
294;17.10.2016;2016;10;21;Maanantai;0;1;1;3;4;7
294;17.10.2016;2016;10;22;Maanantai;0;0;0;0;0;0
294;17.10.2016;2016;10;23;Maanantai;0;0;0;1;0;1
294;18.10.2016;2016;10;00;Tiistai;0;0;0;0;0;0
294;18.10.2016;2016;10;01;Tiistai;0;0;0;0;0;0
294;18.10.2016;2016;10;02;Tiistai;0;0;0;0;0;0
294;18.10.2016;2016;10;03;Tiistai;0;0;0;0;0;0
294;18.10.2016;2016;10;04;Tiistai;0;0;0;0;1;1
294;18.10.2016;2016;10;05;Tiistai;0;0;0;1;1;2
294;18.10.2016;2016;10;06;Tiistai;1;2;3;2;6;8
294;18.10.2016;2016;10;07;Tiistai;7;10;17;10;5;15
294;18.10.2016;2016;10;08;Tiistai;18;9;27;5;4;9
294;18.10.2016;2016;10;09;Tiistai;21;7;28;11;8;19
294;18.10.2016;2016;10;10;Tiistai;9;9;18;11;6;17
294;18.10.2016;2016;10;11;Tiistai;5;14;19;20;16;36
294;18.10.2016;2016;10;12;Tiistai;9;14;23;18;23;41
294;18.10.2016;2016;10;13;Tiistai;14;14;28;22;20;42
294;18.10.2016;2016;10;14;Tiistai;19;19;38;8;9;17
294;18.10.2016;2016;10;15;Tiistai;21;35;56;16;14;30
294;18.10.2016;2016;10;16;Tiistai;24;17;41;4;5;9
294;18.10.2016;2016;10;17;Tiistai;25;11;36;11;15;26
294;18.10.2016;2016;10;18;Tiistai;14;19;33;26;18;44
294;18.10.2016;2016;10;19;Tiistai;1;8;9;16;10;26
294;18.10.2016;2016;10;20;Tiistai;2;1;3;8;7;15
294;18.10.2016;2016;10;21;Tiistai;0;1;1;1;1;2
294;18.10.2016;2016;10;22;Tiistai;1;4;5;3;0;3
294;18.10.2016;2016;10;23;Tiistai;0;0;0;0;0;0
294;19.10.2016;2016;10;00;Keskiviikko;0;0;0;0;0;0
294;19.10.2016;2016;10;01;Keskiviikko;0;0;0;0;0;0
294;19.10.2016;2016;10;02;Keskiviikko;0;0;0;0;0;0
294;19.10.2016;2016;10;03;Keskiviikko;0;0;0;0;0;0
294;19.10.2016;2016;10;04;Keskiviikko;0;0;0;0;1;1
294;19.10.2016;2016;10;05;Keskiviikko;0;0;0;1;2;3
294;19.10.2016;2016;10;06;Keskiviikko;2;1;3;2;3;5
294;19.10.2016;2016;10;07;Keskiviikko;15;3;18;4;5;9
294;19.10.2016;2016;10;08;Keskiviikko;26;6;32;15;5;20
294;19.10.2016;2016;10;09;Keskiviikko;20;14;34;10;12;22
294;19.10.2016;2016;10;10;Keskiviikko;14;17;31;14;7;21
294;19.10.2016;2016;10;11;Keskiviikko;10;21;31;18;17;35
294;19.10.2016;2016;10;12;Keskiviikko;10;13;23;10;13;23
294;19.10.2016;2016;10;13;Keskiviikko;13;11;24;9;7;16
294;19.10.2016;2016;10;14;Keskiviikko;20;16;36;7;9;16
294;19.10.2016;2016;10;15;Keskiviikko;18;17;35;10;15;25
294;19.10.2016;2016;10;16;Keskiviikko;16;15;31;9;8;17
294;19.10.2016;2016;10;17;Keskiviikko;12;16;28;8;11;19
294;19.10.2016;2016;10;18;Keskiviikko;14;13;27;32;13;45
294;19.10.2016;2016;10;19;Keskiviikko;11;7;18;16;17;33
294;19.10.2016;2016;10;20;Keskiviikko;5;4;9;14;3;17
294;19.10.2016;2016;10;21;Keskiviikko;0;1;1;4;3;7
294;19.10.2016;2016;10;22;Keskiviikko;0;0;0;1;0;1
294;19.10.2016;2016;10;23;Keskiviikko;0;0;0;0;0;0
294;20.10.2016;2016;10;00;Torstai;0;0;0;0;0;0
294;20.10.2016;2016;10;01;Torstai;0;0;0;0;0;0
294;20.10.2016;2016;10;02;Torstai;0;0;0;0;0;0
294;20.10.2016;2016;10;03;Torstai;0;0;0;0;0;0
294;20.10.2016;2016;10;04;Torstai;0;0;0;1;2;3
294;20.10.2016;2016;10;05;Torstai;0;0;0;0;0;0
294;20.10.2016;2016;10;06;Torstai;0;2;2;3;4;7
294;20.10.2016;2016;10;07;Torstai;22;4;26;3;5;8
294;20.10.2016;2016;10;08;Torstai;19;6;25;9;4;13
294;20.10.2016;2016;10;09;Torstai;11;3;14;12;14;26
294;20.10.2016;2016;10;10;Torstai;11;7;18;12;13;25
294;20.10.2016;2016;10;11;Torstai;11;15;26;17;20;37
294;20.10.2016;2016;10;12;Torstai;7;10;17;14;17;31
294;20.10.2016;2016;10;13;Torstai;11;14;25;11;14;25
294;20.10.2016;2016;10;14;Torstai;22;12;34;12;12;24
294;20.10.2016;2016;10;15;Torstai;14;31;45;11;10;21
294;20.10.2016;2016;10;16;Torstai;17;17;34;3;13;16
294;20.10.2016;2016;10;17;Torstai;17;17;34;15;14;29
294;20.10.2016;2016;10;18;Torstai;13;19;32;9;12;21
294;20.10.2016;2016;10;19;Torstai;8;7;15;13;10;23
294;20.10.2016;2016;10;20;Torstai;1;7;8;4;8;12
294;20.10.2016;2016;10;21;Torstai;0;1;1;3;1;4
294;20.10.2016;2016;10;22;Torstai;0;1;1;0;1;1
294;20.10.2016;2016;10;23;Torstai;0;0;0;1;0;1
294;21.10.2016;2016;10;00;Perjantai;0;0;0;0;0;0
294;21.10.2016;2016;10;01;Perjantai;0;0;0;0;0;0
294;21.10.2016;2016;10;02;Perjantai;0;0;0;0;0;0
294;21.10.2016;2016;10;03;Perjantai;0;0;0;0;0;0
294;21.10.2016;2016;10;04;Perjantai;0;0;0;1;1;2
294;21.10.2016;2016;10;05;Perjantai;0;0;0;0;1;1
294;21.10.2016;2016;10;06;Perjantai;0;1;1;1;6;7
294;21.10.2016;2016;10;07;Perjantai;13;3;16;4;7;11
294;21.10.2016;2016;10;08;Perjantai;11;6;17;5;5;10
294;21.10.2016;2016;10;09;Perjantai;22;12;34;16;6;22
294;21.10.2016;2016;10;10;Perjantai;6;8;14;9;14;23
294;21.10.2016;2016;10;11;Perjantai;12;18;30;18;12;30
294;21.10.2016;2016;10;12;Perjantai;13;22;35;11;13;24
294;21.10.2016;2016;10;13;Perjantai;24;22;46;6;12;18
294;21.10.2016;2016;10;14;Perjantai;17;38;55;10;22;32
294;21.10.2016;2016;10;15;Perjantai;26;17;43;8;11;19
294;21.10.2016;2016;10;16;Perjantai;24;20;44;16;15;31
294;21.10.2016;2016;10;17;Perjantai;10;20;30;15;12;27
294;21.10.2016;2016;10;18;Perjantai;19;15;34;14;20;34
294;21.10.2016;2016;10;19;Perjantai;4;8;12;10;10;20
294;21.10.2016;2016;10;20;Perjantai;4;15;19;1;5;6
294;21.10.2016;2016;10;21;Perjantai;1;2;3;2;3;5
294;21.10.2016;2016;10;22;Perjantai;2;1;3;2;1;3
294;21.10.2016;2016;10;23;Perjantai;1;1;2;0;0;0
294;22.10.2016;2016;10;00;Lauantai;0;0;0;0;1;1
294;22.10.2016;2016;10;01;Lauantai;1;0;1;0;0;0
294;22.10.2016;2016;10;02;Lauantai;0;0;0;0;1;1
294;22.10.2016;2016;10;03;Lauantai;0;0;0;0;0;0
294;22.10.2016;2016;10;04;Lauantai;0;0;0;0;0;0
294;22.10.2016;2016;10;05;Lauantai;0;0;0;1;1;2
294;22.10.2016;2016;10;06;Lauantai;0;0;0;0;3;3
294;22.10.2016;2016;10;07;Lauantai;2;0;2;2;0;2
294;22.10.2016;2016;10;08;Lauantai;3;2;5;1;3;4
294;22.10.2016;2016;10;09;Lauantai;5;3;8;6;3;9
294;22.10.2016;2016;10;10;Lauantai;5;9;14;12;11;23
294;22.10.2016;2016;10;11;Lauantai;9;7;16;11;5;16
294;22.10.2016;2016;10;12;Lauantai;8;11;19;12;18;30
294;22.10.2016;2016;10;13;Lauantai;21;14;35;5;8;13
294;22.10.2016;2016;10;14;Lauantai;11;9;20;11;12;23
294;22.10.2016;2016;10;15;Lauantai;7;8;15;4;4;8
294;22.10.2016;2016;10;16;Lauantai;12;12;24;5;7;12
294;22.10.2016;2016;10;17;Lauantai;8;14;22;14;9;23
294;22.10.2016;2016;10;18;Lauantai;10;16;26;8;9;17
294;22.10.2016;2016;10;19;Lauantai;5;6;11;8;6;14
294;22.10.2016;2016;10;20;Lauantai;5;8;13;3;3;6
294;22.10.2016;2016;10;21;Lauantai;7;3;10;1;0;1
294;22.10.2016;2016;10;22;Lauantai;4;1;5;5;8;13
294;22.10.2016;2016;10;23;Lauantai;1;0;1;0;1;1
294;23.10.2016;2016;10;00;Sunnuntai;0;0;0;0;0;0
294;23.10.2016;2016;10;01;Sunnuntai;0;0;0;0;0;0
294;23.10.2016;2016;10;02;Sunnuntai;0;0;0;1;0;1
294;23.10.2016;2016;10;03;Sunnuntai;0;0;0;0;0;0
294;23.10.2016;2016;10;04;Sunnuntai;0;0;0;1;1;2
294;23.10.2016;2016;10;05;Sunnuntai;0;0;0;1;2;3
294;23.10.2016;2016;10;06;Sunnuntai;0;0;0;0;1;1
294;23.10.2016;2016;10;07;Sunnuntai;2;0;2;3;2;5
294;23.10.2016;2016;10;08;Sunnuntai;0;0;0;3;2;5
294;23.10.2016;2016;10;09;Sunnuntai;9;7;16;5;2;7
294;23.10.2016;2016;10;10;Sunnuntai;4;6;10;7;8;15
294;23.10.2016;2016;10;11;Sunnuntai;6;16;22;7;6;13
294;23.10.2016;2016;10;12;Sunnuntai;7;7;14;10;10;20
294;23.10.2016;2016;10;13;Sunnuntai;11;12;23;8;8;16
294;23.10.2016;2016;10;14;Sunnuntai;9;6;15;9;9;18
294;23.10.2016;2016;10;15;Sunnuntai;1;7;8;4;6;10
294;23.10.2016;2016;10;16;Sunnuntai;7;5;12;4;2;6
294;23.10.2016;2016;10;17;Sunnuntai;7;9;16;8;9;17
294;23.10.2016;2016;10;18;Sunnuntai;13;7;20;13;8;21
294;23.10.2016;2016;10;19;Sunnuntai;14;6;20;4;8;12
294;23.10.2016;2016;10;20;Sunnuntai;4;8;12;5;1;6
294;23.10.2016;2016;10;21;Sunnuntai;1;1;2;2;3;5
294;23.10.2016;2016;10;22;Sunnuntai;2;2;4;0;0;0
294;23.10.2016;2016;10;23;Sunnuntai;0;0;0;0;0;0
294;24.10.2016;2016;10;00;Maanantai;0;0;0;0;0;0
294;24.10.2016;2016;10;01;Maanantai;0;0;0;0;0;0
294;24.10.2016;2016;10;02;Maanantai;0;0;0;0;0;0
294;24.10.2016;2016;10;03;Maanantai;0;0;0;0;0;0
294;24.10.2016;2016;10;04;Maanantai;0;0;0;0;1;1
294;24.10.2016;2016;10;05;Maanantai;0;0;0;2;2;4
294;24.10.2016;2016;10;06;Maanantai;2;1;3;1;0;1
294;24.10.2016;2016;10;07;Maanantai;3;1;4;2;3;5
294;24.10.2016;2016;10;08;Maanantai;4;7;11;6;7;13
294;24.10.2016;2016;10;09;Maanantai;4;6;10;4;3;7
294;24.10.2016;2016;10;10;Maanantai;8;8;16;11;8;19
294;24.10.2016;2016;10;11;Maanantai;13;7;20;10;16;26
294;24.10.2016;2016;10;12;Maanantai;18;13;31;12;15;27
294;24.10.2016;2016;10;13;Maanantai;12;12;24;8;5;13
294;24.10.2016;2016;10;14;Maanantai;16;13;29;11;14;25
294;24.10.2016;2016;10;15;Maanantai;20;30;50;13;15;28
294;24.10.2016;2016;10;16;Maanantai;7;9;16;14;9;23
294;24.10.2016;2016;10;17;Maanantai;11;13;24;11;7;18
294;24.10.2016;2016;10;18;Maanantai;8;7;15;5;10;15
294;24.10.2016;2016;10;19;Maanantai;3;4;7;16;14;30
294;24.10.2016;2016;10;20;Maanantai;4;0;4;5;4;9
294;24.10.2016;2016;10;21;Maanantai;3;1;4;5;0;5
294;24.10.2016;2016;10;22;Maanantai;0;2;2;0;0;0
294;24.10.2016;2016;10;23;Maanantai;0;0;0;0;0;0
294;25.10.2016;2016;10;00;Tiistai;0;0;0;0;0;0
294;25.10.2016;2016;10;01;Tiistai;0;0;0;0;0;0
294;25.10.2016;2016;10;02;Tiistai;0;0;0;0;0;0
294;25.10.2016;2016;10;03;Tiistai;0;0;0;0;0;0
294;25.10.2016;2016;10;04;Tiistai;0;0;0;1;2;3
294;25.10.2016;2016;10;05;Tiistai;0;0;0;0;0;0
294;25.10.2016;2016;10;06;Tiistai;2;0;2;1;2;3
294;25.10.2016;2016;10;07;Tiistai;2;0;2;1;5;6
294;25.10.2016;2016;10;08;Tiistai;6;1;7;7;0;7
294;25.10.2016;2016;10;09;Tiistai;2;5;7;8;7;15
294;25.10.2016;2016;10;10;Tiistai;10;6;16;10;13;23
294;25.10.2016;2016;10;11;Tiistai;6;7;13;13;3;16
294;25.10.2016;2016;10;12;Tiistai;5;10;15;5;6;11
294;25.10.2016;2016;10;13;Tiistai;5;3;8;20;8;28
294;25.10.2016;2016;10;14;Tiistai;7;13;20;5;10;15
294;25.10.2016;2016;10;15;Tiistai;11;10;21;8;10;18
294;25.10.2016;2016;10;16;Tiistai;8;9;17;8;12;20
294;25.10.2016;2016;10;17;Tiistai;10;8;18;8;11;19
294;25.10.2016;2016;10;18;Tiistai;4;8;12;14;10;24
294;25.10.2016;2016;10;19;Tiistai;6;4;10;13;7;20
294;25.10.2016;2016;10;20;Tiistai;2;2;4;8;4;12
294;25.10.2016;2016;10;21;Tiistai;2;3;5;1;0;1
294;25.10.2016;2016;10;22;Tiistai;4;1;5;0;2;2
294;25.10.2016;2016;10;23;Tiistai;0;0;0;0;0;0
294;26.10.2016;2016;10;00;Keskiviikko;0;0;0;0;0;0
294;26.10.2016;2016;10;01;Keskiviikko;0;0;0;0;0;0
294;26.10.2016;2016;10;02;Keskiviikko;0;0;0;0;0;0
294;26.10.2016;2016;10;03;Keskiviikko;0;0;0;0;0;0
294;26.10.2016;2016;10;04;Keskiviikko;1;0;1;0;1;1
294;26.10.2016;2016;10;05;Keskiviikko;0;1;1;3;2;5
294;26.10.2016;2016;10;06;Keskiviikko;0;0;0;0;2;2
294;26.10.2016;2016;10;07;Keskiviikko;3;0;3;6;3;9
294;26.10.2016;2016;10;08;Keskiviikko;3;1;4;5;3;8
294;26.10.2016;2016;10;09;Keskiviikko;1;3;4;6;4;10
294;26.10.2016;2016;10;10;Keskiviikko;2;4;6;12;7;19
294;26.10.2016;2016;10;11;Keskiviikko;7;7;14;12;15;27
294;26.10.2016;2016;10;12;Keskiviikko;16;5;21;15;8;23
294;26.10.2016;2016;10;13;Keskiviikko;8;13;21;14;15;29
294;26.10.2016;2016;10;14;Keskiviikko;10;3;13;6;13;19
294;26.10.2016;2016;10;15;Keskiviikko;2;2;4;8;12;20
294;26.10.2016;2016;10;16;Keskiviikko;2;8;10;9;8;17
294;26.10.2016;2016;10;17;Keskiviikko;7;5;12;12;8;20
294;26.10.2016;2016;10;18;Keskiviikko;6;10;16;7;13;20
294;26.10.2016;2016;10;19;Keskiviikko;9;7;16;14;8;22
294;26.10.2016;2016;10;20;Keskiviikko;5;3;8;5;10;15
294;26.10.2016;2016;10;21;Keskiviikko;0;2;2;2;2;4
294;26.10.2016;2016;10;22;Keskiviikko;3;4;7;1;1;2
294;26.10.2016;2016;10;23;Keskiviikko;1;1;2;0;0;0
294;27.10.2016;2016;10;00;Torstai;0;0;0;0;0;0
294;27.10.2016;2016;10;01;Torstai;0;0;0;0;0;0
294;27.10.2016;2016;10;02;Torstai;0;1;1;6;5;11
294;27.10.2016;2016;10;03;Torstai;0;0;0;0;0;0
294;27.10.2016;2016;10;04;Torstai;0;0;0;1;2;3
294;27.10.2016;2016;10;05;Torstai;0;0;0;0;0;0
294;27.10.2016;2016;10;06;Torstai;0;0;0;0;0;0
294;27.10.2016;2016;10;07;Torstai;1;1;2;4;3;7
294;27.10.2016;2016;10;08;Torstai;2;0;2;8;1;9
294;27.10.2016;2016;10;09;Torstai;3;3;6;3;3;6
294;27.10.2016;2016;10;10;Torstai;3;6;9;8;8;16
294;27.10.2016;2016;10;11;Torstai;4;1;5;10;12;22
294;27.10.2016;2016;10;12;Torstai;3;4;7;10;11;21
294;27.10.2016;2016;10;13;Torstai;6;6;12;10;14;24
294;27.10.2016;2016;10;14;Torstai;4;3;7;13;5;18
294;27.10.2016;2016;10;15;Torstai;12;11;23;13;15;28
294;27.10.2016;2016;10;16;Torstai;7;16;23;11;17;28
294;27.10.2016;2016;10;17;Torstai;7;11;18;16;15;31
294;27.10.2016;2016;10;18;Torstai;5;6;11;13;10;23
294;27.10.2016;2016;10;19;Torstai;3;3;6;9;8;17
294;27.10.2016;2016;10;20;Torstai;5;2;7;7;3;10
294;27.10.2016;2016;10;21;Torstai;0;5;5;4;2;6
294;27.10.2016;2016;10;22;Torstai;0;1;1;0;1;1
294;27.10.2016;2016;10;23;Torstai;1;0;1;0;0;0
294;28.10.2016;2016;10;00;Perjantai;0;0;0;0;0;0
294;28.10.2016;2016;10;01;Perjantai;0;0;0;0;0;0
294;28.10.2016;2016;10;02;Perjantai;0;0;0;0;0;0
294;28.10.2016;2016;10;03;Perjantai;0;0;0;0;0;0
294;28.10.2016;2016;10;04;Perjantai;0;0;0;0;0;0
294;28.10.2016;2016;10;05;Perjantai;0;0;0;1;1;2
294;28.10.2016;2016;10;06;Perjantai;1;0;1;2;0;2
294;28.10.2016;2016;10;07;Perjantai;1;3;4;2;1;3
294;28.10.2016;2016;10;08;Perjantai;2;2;4;3;1;4
294;28.10.2016;2016;10;09;Perjantai;2;1;3;4;2;6
294;28.10.2016;2016;10;10;Perjantai;5;3;8;6;9;15
294;28.10.2016;2016;10;11;Perjantai;2;4;6;8;5;13
294;28.10.2016;2016;10;12;Perjantai;9;8;17;8;10;18
294;28.10.2016;2016;10;13;Perjantai;8;9;17;8;8;16
294;28.10.2016;2016;10;14;Perjantai;6;7;13;3;10;13
294;28.10.2016;2016;10;15;Perjantai;9;8;17;11;7;18
294;28.10.2016;2016;10;16;Perjantai;15;15;30;4;10;14
294;28.10.2016;2016;10;17;Perjantai;14;13;27;9;9;18
294;28.10.2016;2016;10;18;Perjantai;12;13;25;9;10;19
294;28.10.2016;2016;10;19;Perjantai;10;8;18;15;9;24
294;28.10.2016;2016;10;20;Perjantai;5;4;9;9;5;14
294;28.10.2016;2016;10;21;Perjantai;2;1;3;1;3;4
294;28.10.2016;2016;10;22;Perjantai;2;1;3;0;0;0
294;28.10.2016;2016;10;23;Perjantai;2;2;4;0;0;0
294;29.10.2016;2016;10;00;Lauantai;0;0;0;1;1;2
294;29.10.2016;2016;10;01;Lauantai;1;0;1;1;0;1
294;29.10.2016;2016;10;02;Lauantai;0;0;0;1;1;2
294;29.10.2016;2016;10;03;Lauantai;0;0;0;0;1;1
294;29.10.2016;2016;10;04;Lauantai;0;0;0;0;0;0
294;29.10.2016;2016;10;05;Lauantai;0;0;0;1;0;1
294;29.10.2016;2016;10;06;Lauantai;0;0;0;0;2;2
294;29.10.2016;2016;10;07;Lauantai;1;0;1;2;4;6
294;29.10.2016;2016;10;08;Lauantai;1;3;4;3;3;6
294;29.10.2016;2016;10;09;Lauantai;9;2;11;10;9;19
294;29.10.2016;2016;10;10;Lauantai;11;8;19;12;11;23
294;29.10.2016;2016;10;11;Lauantai;9;15;24;16;12;28
294;29.10.2016;2016;10;12;Lauantai;8;12;20;5;10;15
294;29.10.2016;2016;10;13;Lauantai;13;10;23;11;13;24
294;29.10.2016;2016;10;14;Lauantai;10;9;19;5;11;16
294;29.10.2016;2016;10;15;Lauantai;5;5;10;6;9;15
294;29.10.2016;2016;10;16;Lauantai;6;15;21;5;7;12
294;29.10.2016;2016;10;17;Lauantai;15;8;23;10;8;18
294;29.10.2016;2016;10;18;Lauantai;4;7;11;6;5;11
294;29.10.2016;2016;10;19;Lauantai;6;6;12;5;8;13
294;29.10.2016;2016;10;20;Lauantai;6;5;11;6;1;7
294;29.10.2016;2016;10;21;Lauantai;2;1;3;2;1;3
294;29.10.2016;2016;10;22;Lauantai;2;0;2;0;1;1
294;29.10.2016;2016;10;23;Lauantai;2;0;2;1;1;2
294;30.10.2016;2016;10;00;Sunnuntai;0;3;3;1;1;2
294;30.10.2016;2016;10;01;Sunnuntai;1;0;1;2;1;3
294;30.10.2016;2016;10;02;Sunnuntai;0;0;0;0;1;1
294;30.10.2016;2016;10;03;Sunnuntai;0;0;0;0;0;0
294;30.10.2016;2016;10;04;Sunnuntai;0;0;0;0;0;0
294;30.10.2016;2016;10;05;Sunnuntai;0;0;0;0;1;1
294;30.10.2016;2016;10;06;Sunnuntai;0;0;0;0;3;3
294;30.10.2016;2016;10;07;Sunnuntai;1;0;1;1;2;3
294;30.10.2016;2016;10;08;Sunnuntai;3;0;3;5;2;7
294;30.10.2016;2016;10;09;Sunnuntai;5;4;9;12;5;17
294;30.10.2016;2016;10;10;Sunnuntai;7;1;8;17;15;32
294;30.10.2016;2016;10;11;Sunnuntai;3;7;10;6;12;18
294;30.10.2016;2016;10;12;Sunnuntai;6;9;15;14;6;20
294;30.10.2016;2016;10;13;Sunnuntai;10;9;19;6;8;14
294;30.10.2016;2016;10;14;Sunnuntai;12;8;20;6;3;9
294;30.10.2016;2016;10;15;Sunnuntai;7;12;19;13;8;21
294;30.10.2016;2016;10;16;Sunnuntai;7;5;12;15;8;23
294;30.10.2016;2016;10;17;Sunnuntai;8;2;10;8;5;13
294;30.10.2016;2016;10;18;Sunnuntai;5;4;9;9;13;22
294;30.10.2016;2016;10;19;Sunnuntai;4;5;9;10;11;21
294;30.10.2016;2016;10;20;Sunnuntai;1;1;2;4;4;8
294;30.10.2016;2016;10;21;Sunnuntai;0;0;0;4;1;5
294;30.10.2016;2016;10;22;Sunnuntai;0;0;0;0;0;0
294;30.10.2016;2016;10;23;Sunnuntai;1;0;1;0;0;0
294;31.10.2016;2016;10;00;Maanantai;0;0;0;0;0;0
294;31.10.2016;2016;10;01;Maanantai;0;0;0;0;0;0
294;31.10.2016;2016;10;02;Maanantai;0;0;0;0;0;0
294;31.10.2016;2016;10;03;Maanantai;0;0;0;0;0;0
294;31.10.2016;2016;10;04;Maanantai;0;0;0;0;1;1
294;31.10.2016;2016;10;05;Maanantai;0;0;0;0;1;1
294;31.10.2016;2016;10;06;Maanantai;4;1;5;3;4;7
294;31.10.2016;2016;10;07;Maanantai;19;6;25;5;1;6
294;31.10.2016;2016;10;08;Maanantai;18;6;24;15;6;21
294;31.10.2016;2016;10;09;Maanantai;28;8;36;13;10;23
294;31.10.2016;2016;10;10;Maanantai;9;11;20;12;14;26
294;31.10.2016;2016;10;11;Maanantai;14;23;37;16;18;34
294;31.10.2016;2016;10;12;Maanantai;12;9;21;11;11;22
294;31.10.2016;2016;10;13;Maanantai;12;21;33;14;21;35
294;31.10.2016;2016;10;14;Maanantai;18;40;58;12;17;29
294;31.10.2016;2016;10;15;Maanantai;20;25;45;16;15;31
294;31.10.2016;2016;10;16;Maanantai;13;11;24;10;12;22
294;31.10.2016;2016;10;17;Maanantai;14;11;25;17;12;29
294;31.10.2016;2016;10;18;Maanantai;12;9;21;10;11;21
294;31.10.2016;2016;10;19;Maanantai;11;8;19;11;14;25
294;31.10.2016;2016;10;20;Maanantai;1;2;3;6;5;11
294;31.10.2016;2016;10;21;Maanantai;2;0;2;4;0;4
294;31.10.2016;2016;10;22;Maanantai;0;0;0;0;0;0
294;31.10.2016;2016;10;23;Maanantai;1;0;1;0;0;0
294;01.11.2016;2016;11;00;Tiistai;0;0;0;0;0;0
294;01.11.2016;2016;11;01;Tiistai;0;0;0;0;0;0
294;01.11.2016;2016;11;02;Tiistai;0;0;0;0;0;0
294;01.11.2016;2016;11;03;Tiistai;0;0;0;0;0;0
294;01.11.2016;2016;11;04;Tiistai;0;0;0;0;1;1
294;01.11.2016;2016;11;05;Tiistai;0;0;0;1;1;2
294;01.11.2016;2016;11;06;Tiistai;5;2;7;3;3;6
294;01.11.2016;2016;11;07;Tiistai;16;10;26;11;5;16
294;01.11.2016;2016;11;08;Tiistai;15;5;20;5;1;6
294;01.11.2016;2016;11;09;Tiistai;22;7;29;9;7;16
294;01.11.2016;2016;11;10;Tiistai;9;7;16;16;12;28
294;01.11.2016;2016;11;11;Tiistai;7;10;17;14;9;23
294;01.11.2016;2016;11;12;Tiistai;5;7;12;6;19;25
294;01.11.2016;2016;11;13;Tiistai;14;10;24;17;7;24
294;01.11.2016;2016;11;14;Tiistai;12;17;29;2;11;13
294;01.11.2016;2016;11;15;Tiistai;12;25;37;5;17;22
294;01.11.2016;2016;11;16;Tiistai;16;16;32;6;10;16
294;01.11.2016;2016;11;17;Tiistai;7;8;15;17;14;31
294;01.11.2016;2016;11;18;Tiistai;3;6;9;14;12;26
294;01.11.2016;2016;11;19;Tiistai;10;5;15;12;9;21
294;01.11.2016;2016;11;20;Tiistai;1;2;3;8;5;13
294;01.11.2016;2016;11;21;Tiistai;0;2;2;3;2;5
294;01.11.2016;2016;11;22;Tiistai;1;0;1;0;0;0
294;01.11.2016;2016;11;23;Tiistai;0;0;0;0;0;0
294;02.11.2016;2016;11;00;Keskiviikko;0;0;0;1;0;1
294;02.11.2016;2016;11;01;Keskiviikko;0;0;0;0;0;0
294;02.11.2016;2016;11;02;Keskiviikko;0;0;0;0;0;0
294;02.11.2016;2016;11;03;Keskiviikko;0;0;0;0;0;0
294;02.11.2016;2016;11;04;Keskiviikko;0;0;0;0;1;1
294;02.11.2016;2016;11;05;Keskiviikko;0;0;0;3;1;4
294;02.11.2016;2016;11;06;Keskiviikko;7;1;8;1;3;4
294;02.11.2016;2016;11;07;Keskiviikko;14;2;16;14;5;19
294;02.11.2016;2016;11;08;Keskiviikko;18;6;24;12;7;19
294;02.11.2016;2016;11;09;Keskiviikko;10;11;21;17;13;30
294;02.11.2016;2016;11;10;Keskiviikko;6;3;9;13;13;26
294;02.11.2016;2016;11;11;Keskiviikko;9;1;10;22;11;33
294;02.11.2016;2016;11;12;Keskiviikko;7;7;14;9;11;20
294;02.11.2016;2016;11;13;Keskiviikko;4;16;20;11;20;31
294;02.11.2016;2016;11;14;Keskiviikko;14;18;32;24;18;42
294;02.11.2016;2016;11;15;Keskiviikko;17;13;30;19;18;37
294;02.11.2016;2016;11;16;Keskiviikko;12;19;31;11;12;23
294;02.11.2016;2016;11;17;Keskiviikko;8;11;19;9;12;21
294;02.11.2016;2016;11;18;Keskiviikko;16;8;24;10;10;20
294;02.11.2016;2016;11;19;Keskiviikko;14;11;25;11;13;24
294;02.11.2016;2016;11;20;Keskiviikko;3;3;6;4;5;9
294;02.11.2016;2016;11;21;Keskiviikko;0;0;0;1;3;4
294;02.11.2016;2016;11;22;Keskiviikko;0;0;0;0;1;1
294;02.11.2016;2016;11;23;Keskiviikko;0;0;0;0;0;0
294;03.11.2016;2016;11;00;Torstai;0;0;0;0;0;0
294;03.11.2016;2016;11;01;Torstai;0;0;0;0;0;0
294;03.11.2016;2016;11;02;Torstai;0;0;0;0;0;0
294;03.11.2016;2016;11;03;Torstai;0;0;0;0;0;0
294;03.11.2016;2016;11;04;Torstai;0;0;0;0;1;1
294;03.11.2016;2016;11;05;Torstai;0;0;0;2;0;2
294;03.11.2016;2016;11;06;Torstai;2;0;2;2;2;4
294;03.11.2016;2016;11;07;Torstai;9;1;10;10;5;15
294;03.11.2016;2016;11;08;Torstai;18;10;28;13;4;17
294;03.11.2016;2016;11;09;Torstai;10;10;20;19;21;40
294;03.11.2016;2016;11;10;Torstai;7;4;11;13;13;26
294;03.11.2016;2016;11;11;Torstai;5;10;15;17;15;32
294;03.11.2016;2016;11;12;Torstai;3;11;14;18;18;36
294;03.11.2016;2016;11;13;Torstai;5;15;20;13;14;27
294;03.11.2016;2016;11;14;Torstai;10;19;29;11;11;22
294;03.11.2016;2016;11;15;Torstai;15;21;36;14;16;30
294;03.11.2016;2016;11;16;Torstai;12;10;22;4;13;17
294;03.11.2016;2016;11;17;Torstai;14;4;18;18;14;32
294;03.11.2016;2016;11;18;Torstai;7;11;18;16;14;30
294;03.11.2016;2016;11;19;Torstai;7;10;17;14;30;44
294;03.11.2016;2016;11;20;Torstai;2;1;3;11;3;14
294;03.11.2016;2016;11;21;Torstai;1;3;4;2;2;4
294;03.11.2016;2016;11;22;Torstai;0;0;0;1;0;1
294;03.11.2016;2016;11;23;Torstai;0;0;0;0;0;0
294;04.11.2016;2016;11;00;Perjantai;0;0;0;0;0;0
294;04.11.2016;2016;11;01;Perjantai;0;0;0;0;0;0
294;04.11.2016;2016;11;02;Perjantai;0;0;0;0;0;0
294;04.11.2016;2016;11;03;Perjantai;0;0;0;0;0;0
294;04.11.2016;2016;11;04;Perjantai;0;0;0;0;1;1
294;04.11.2016;2016;11;05;Perjantai;1;0;1;2;0;2
294;04.11.2016;2016;11;06;Perjantai;1;0;1;7;3;10
294;04.11.2016;2016;11;07;Perjantai;15;5;20;6;8;14
294;04.11.2016;2016;11;08;Perjantai;19;2;21;12;7;19
294;04.11.2016;2016;11;09;Perjantai;23;7;30;14;6;20
294;04.11.2016;2016;11;10;Perjantai;5;10;15;10;13;23
294;04.11.2016;2016;11;11;Perjantai;7;14;21;13;14;27
294;04.11.2016;2016;11;12;Perjantai;7;19;26;15;11;26
294;04.11.2016;2016;11;13;Perjantai;12;24;36;8;21;29
294;04.11.2016;2016;11;14;Perjantai;18;23;41;11;23;34
294;04.11.2016;2016;11;15;Perjantai;8;6;14;7;12;19
294;04.11.2016;2016;11;16;Perjantai;9;10;19;12;15;27
294;04.11.2016;2016;11;17;Perjantai;8;12;20;8;17;25
294;04.11.2016;2016;11;18;Perjantai;14;14;28;12;12;24
294;04.11.2016;2016;11;19;Perjantai;3;3;6;7;7;14
294;04.11.2016;2016;11;20;Perjantai;6;8;14;2;3;5
294;04.11.2016;2016;11;21;Perjantai;2;0;2;1;0;1
294;04.11.2016;2016;11;22;Perjantai;1;0;1;0;1;1
294;04.11.2016;2016;11;23;Perjantai;3;0;3;0;0;0
294;05.11.2016;2016;11;00;Lauantai;0;0;0;1;0;1
294;05.11.2016;2016;11;01;Lauantai;1;0;1;2;0;2
294;05.11.2016;2016;11;02;Lauantai;0;0;0;2;0;2
294;05.11.2016;2016;11;03;Lauantai;0;0;0;0;1;1
294;05.11.2016;2016;11;04;Lauantai;0;0;0;0;0;0
294;05.11.2016;2016;11;05;Lauantai;0;1;1;0;0;0
294;05.11.2016;2016;11;06;Lauantai;0;0;0;1;3;4
294;05.11.2016;2016;11;07;Lauantai;1;0;1;3;4;7
294;05.11.2016;2016;11;08;Lauantai;1;0;1;3;5;8
294;05.11.2016;2016;11;09;Lauantai;0;3;3;12;5;17
294;05.11.2016;2016;11;10;Lauantai;2;5;7;6;7;13
294;05.11.2016;2016;11;11;Lauantai;1;2;3;7;18;25
294;05.11.2016;2016;11;12;Lauantai;4;5;9;16;12;28
294;05.11.2016;2016;11;13;Lauantai;2;9;11;11;14;25
294;05.11.2016;2016;11;14;Lauantai;4;3;7;11;9;20
294;05.11.2016;2016;11;15;Lauantai;10;5;15;8;10;18
294;05.11.2016;2016;11;16;Lauantai;6;8;14;10;8;18
294;05.11.2016;2016;11;17;Lauantai;0;5;5;6;7;13
294;05.11.2016;2016;11;18;Lauantai;4;3;7;6;3;9
294;05.11.2016;2016;11;19;Lauantai;6;5;11;14;9;23
294;05.11.2016;2016;11;20;Lauantai;3;0;3;5;1;6
294;05.11.2016;2016;11;21;Lauantai;5;2;7;2;2;4
294;05.11.2016;2016;11;22;Lauantai;0;1;1;3;0;3
294;05.11.2016;2016;11;23;Lauantai;0;1;1;0;0;0
294;06.11.2016;2016;11;00;Sunnuntai;0;0;0;1;0;1
294;06.11.2016;2016;11;01;Sunnuntai;0;0;0;0;0;0
294;06.11.2016;2016;11;02;Sunnuntai;0;0;0;0;0;0
294;06.11.2016;2016;11;03;Sunnuntai;0;0;0;0;1;1
294;06.11.2016;2016;11;04;Sunnuntai;0;0;0;0;0;0
294;06.11.2016;2016;11;05;Sunnuntai;0;0;0;1;0;1
294;06.11.2016;2016;11;06;Sunnuntai;0;0;0;3;1;4
294;06.11.2016;2016;11;07;Sunnuntai;0;0;0;0;3;3
294;06.11.2016;2016;11;08;Sunnuntai;0;0;0;0;6;6
294;06.11.2016;2016;11;09;Sunnuntai;3;1;4;4;7;11
294;06.11.2016;2016;11;10;Sunnuntai;1;3;4;12;10;22
294;06.11.2016;2016;11;11;Sunnuntai;1;6;7;6;13;19
294;06.11.2016;2016;11;12;Sunnuntai;3;4;7;9;11;20
294;06.11.2016;2016;11;13;Sunnuntai;6;4;10;13;17;30
294;06.11.2016;2016;11;14;Sunnuntai;5;2;7;12;3;15
294;06.11.2016;2016;11;15;Sunnuntai;3;8;11;4;11;15
294;06.11.2016;2016;11;16;Sunnuntai;2;2;4;8;2;10
294;06.11.2016;2016;11;17;Sunnuntai;4;3;7;6;12;18
294;06.11.2016;2016;11;18;Sunnuntai;6;1;7;7;9;16
294;06.11.2016;2016;11;19;Sunnuntai;4;7;11;7;2;9
294;06.11.2016;2016;11;20;Sunnuntai;4;0;4;5;3;8
294;06.11.2016;2016;11;21;Sunnuntai;0;0;0;1;0;1
294;06.11.2016;2016;11;22;Sunnuntai;0;0;0;1;1;2
294;06.11.2016;2016;11;23;Sunnuntai;0;0;0;0;0;0
294;07.11.2016;2016;11;00;Maanantai;0;0;0;0;0;0
294;07.11.2016;2016;11;01;Maanantai;0;0;0;0;0;0
294;07.11.2016;2016;11;02;Maanantai;0;0;0;0;0;0
294;07.11.2016;2016;11;03;Maanantai;0;0;0;0;0;0
294;07.11.2016;2016;11;04;Maanantai;0;0;0;0;0;0
294;07.11.2016;2016;11;05;Maanantai;0;1;1;3;0;3
294;07.11.2016;2016;11;06;Maanantai;1;0;1;3;1;4
294;07.11.2016;2016;11;07;Maanantai;15;7;22;7;7;14
294;07.11.2016;2016;11;08;Maanantai;14;5;19;12;1;13
294;07.11.2016;2016;11;09;Maanantai;19;2;21;17;14;31
294;07.11.2016;2016;11;10;Maanantai;4;4;8;23;9;32
294;07.11.2016;2016;11;11;Maanantai;7;10;17;19;30;49
294;07.11.2016;2016;11;12;Maanantai;8;13;21;22;14;36
294;07.11.2016;2016;11;13;Maanantai;5;19;24;20;21;41
294;07.11.2016;2016;11;14;Maanantai;10;12;22;16;26;42
294;07.11.2016;2016;11;15;Maanantai;3;13;16;12;12;24
294;07.11.2016;2016;11;16;Maanantai;8;12;20;11;10;21
294;07.11.2016;2016;11;17;Maanantai;7;9;16;8;12;20
294;07.11.2016;2016;11;18;Maanantai;3;8;11;13;9;22
294;07.11.2016;2016;11;19;Maanantai;5;7;12;6;13;19
294;07.11.2016;2016;11;20;Maanantai;2;2;4;8;6;14
294;07.11.2016;2016;11;21;Maanantai;0;1;1;0;1;1
294;07.11.2016;2016;11;22;Maanantai;0;0;0;0;0;0
294;07.11.2016;2016;11;23;Maanantai;0;0;0;0;0;0
294;08.11.2016;2016;11;00;Tiistai;0;0;0;0;0;0
294;08.11.2016;2016;11;01;Tiistai;0;0;0;0;0;0
294;08.11.2016;2016;11;02;Tiistai;0;0;0;0;0;0
294;08.11.2016;2016;11;03;Tiistai;0;0;0;0;0;0
294;08.11.2016;2016;11;04;Tiistai;0;0;0;0;0;0
294;08.11.2016;2016;11;05;Tiistai;0;0;0;2;2;4
294;08.11.2016;2016;11;06;Tiistai;2;1;3;4;7;11
294;08.11.2016;2016;11;07;Tiistai;16;2;18;11;9;20
294;08.11.2016;2016;11;08;Tiistai;17;5;22;10;3;13
294;08.11.2016;2016;11;09;Tiistai;14;5;19;11;6;17
294;08.11.2016;2016;11;10;Tiistai;3;1;4;12;14;26
294;08.11.2016;2016;11;11;Tiistai;6;6;12;4;9;13
294;08.11.2016;2016;11;12;Tiistai;2;5;7;20;21;41
294;08.11.2016;2016;11;13;Tiistai;7;7;14;15;13;28
294;08.11.2016;2016;11;14;Tiistai;9;10;19;11;12;23
294;08.11.2016;2016;11;15;Tiistai;5;19;24;13;16;29
294;08.11.2016;2016;11;16;Tiistai;5;10;15;9;8;17
294;08.11.2016;2016;11;17;Tiistai;9;6;15;8;17;25
294;08.11.2016;2016;11;18;Tiistai;5;5;10;7;12;19
294;08.11.2016;2016;11;19;Tiistai;2;2;4;16;8;24
294;08.11.2016;2016;11;20;Tiistai;1;4;5;8;7;15
294;08.11.2016;2016;11;21;Tiistai;1;1;2;2;0;2
294;08.11.2016;2016;11;22;Tiistai;1;1;2;0;0;0
294;08.11.2016;2016;11;23;Tiistai;1;0;1;0;0;0
294;09.11.2016;2016;11;00;Keskiviikko;0;0;0;0;0;0
294;09.11.2016;2016;11;01;Keskiviikko;0;0;0;0;0;0
294;09.11.2016;2016;11;02;Keskiviikko;0;0;0;0;0;0
294;09.11.2016;2016;11;03;Keskiviikko;0;0;0;0;0;0
294;09.11.2016;2016;11;04;Keskiviikko;0;0;0;0;0;0
294;09.11.2016;2016;11;05;Keskiviikko;0;0;0;3;0;3
294;09.11.2016;2016;11;06;Keskiviikko;4;0;4;3;2;5
294;09.11.2016;2016;11;07;Keskiviikko;11;3;14;7;3;10
294;09.11.2016;2016;11;08;Keskiviikko;20;3;23;6;2;8
294;09.11.2016;2016;11;09;Keskiviikko;10;8;18;9;7;16
294;09.11.2016;2016;11;10;Keskiviikko;0;3;3;14;14;28
294;09.11.2016;2016;11;11;Keskiviikko;4;7;11;13;13;26
294;09.11.2016;2016;11;12;Keskiviikko;6;18;24;14;17;31
294;09.11.2016;2016;11;13;Keskiviikko;6;14;20;18;12;30
294;09.11.2016;2016;11;14;Keskiviikko;3;16;19;12;15;27
294;09.11.2016;2016;11;15;Keskiviikko;12;20;32;16;18;34
294;09.11.2016;2016;11;16;Keskiviikko;10;6;16;18;15;33
294;09.11.2016;2016;11;17;Keskiviikko;6;1;7;11;10;21
294;09.11.2016;2016;11;18;Keskiviikko;5;3;8;16;8;24
294;09.11.2016;2016;11;19;Keskiviikko;0;5;5;5;15;20
294;09.11.2016;2016;11;20;Keskiviikko;4;1;5;9;0;9
294;09.11.2016;2016;11;21;Keskiviikko;0;0;0;0;1;1
294;09.11.2016;2016;11;22;Keskiviikko;0;0;0;0;0;0
294;09.11.2016;2016;11;23;Keskiviikko;1;0;1;0;0;0
294;10.11.2016;2016;11;00;Torstai;0;0;0;0;0;0
294;10.11.2016;2016;11;01;Torstai;0;0;0;0;0;0
294;10.11.2016;2016;11;02;Torstai;0;0;0;0;0;0
294;10.11.2016;2016;11;03;Torstai;0;0;0;0;0;0
294;10.11.2016;2016;11;04;Torstai;0;0;0;0;0;0
294;10.11.2016;2016;11;05;Torstai;0;0;0;2;0;2
294;10.11.2016;2016;11;06;Torstai;3;1;4;3;3;6
294;10.11.2016;2016;11;07;Torstai;12;1;13;4;6;10
294;10.11.2016;2016;11;08;Torstai;13;2;15;11;7;18
294;10.11.2016;2016;11;09;Torstai;13;2;15;14;8;22
294;10.11.2016;2016;11;10;Torstai;4;6;10;13;11;24
294;10.11.2016;2016;11;11;Torstai;2;9;11;23;18;41
294;10.11.2016;2016;11;12;Torstai;2;5;7;30;16;46
294;10.11.2016;2016;11;13;Torstai;8;19;27;21;22;43
294;10.11.2016;2016;11;14;Torstai;10;13;23;18;16;34
294;10.11.2016;2016;11;15;Torstai;3;20;23;13;16;29
294;10.11.2016;2016;11;16;Torstai;13;11;24;4;14;18
294;10.11.2016;2016;11;17;Torstai;4;5;9;6;18;24
294;10.11.2016;2016;11;18;Torstai;5;14;19;14;11;25
294;10.11.2016;2016;11;19;Torstai;4;5;9;10;11;21
294;10.11.2016;2016;11;20;Torstai;1;3;4;6;4;10
294;10.11.2016;2016;11;21;Torstai;1;0;1;1;1;2
294;10.11.2016;2016;11;22;Torstai;0;1;1;0;2;2
294;10.11.2016;2016;11;23;Torstai;0;0;0;0;0;0
294;11.11.2016;2016;11;00;Perjantai;0;0;0;0;0;0
294;11.11.2016;2016;11;01;Perjantai;0;0;0;0;0;0
294;11.11.2016;2016;11;02;Perjantai;0;0;0;0;0;0
294;11.11.2016;2016;11;03;Perjantai;4;0;4;4;0;4
294;11.11.2016;2016;11;04;Perjantai;0;0;0;0;0;0
294;11.11.2016;2016;11;05;Perjantai;0;0;0;2;0;2
294;11.11.2016;2016;11;06;Perjantai;1;0;1;4;1;5
294;11.11.2016;2016;11;07;Perjantai;10;3;13;7;6;13
294;11.11.2016;2016;11;08;Perjantai;18;4;22;4;2;6
294;11.11.2016;2016;11;09;Perjantai;19;8;27;13;12;25
294;11.11.2016;2016;11;10;Perjantai;2;4;6;6;9;15
294;11.11.2016;2016;11;11;Perjantai;4;11;15;12;10;22
294;11.11.2016;2016;11;12;Perjantai;5;7;12;15;24;39
294;11.11.2016;2016;11;13;Perjantai;13;11;24;20;23;43
294;11.11.2016;2016;11;14;Perjantai;7;22;29;19;31;50
294;11.11.2016;2016;11;15;Perjantai;13;7;20;20;15;35
294;11.11.2016;2016;11;16;Perjantai;4;9;13;9;9;18
294;11.11.2016;2016;11;17;Perjantai;5;1;6;9;6;15
294;11.11.2016;2016;11;18;Perjantai;6;10;16;12;8;20
294;11.11.2016;2016;11;19;Perjantai;12;0;12;10;7;17
294;11.11.2016;2016;11;20;Perjantai;2;7;9;9;5;14
294;11.11.2016;2016;11;21;Perjantai;6;1;7;3;5;8
294;11.11.2016;2016;11;22;Perjantai;1;1;2;4;0;4
294;11.11.2016;2016;11;23;Perjantai;1;0;1;2;1;3
294;12.11.2016;2016;11;00;Lauantai;1;0;1;1;1;2
294;12.11.2016;2016;11;01;Lauantai;0;0;0;0;0;0
294;12.11.2016;2016;11;02;Lauantai;0;2;2;0;1;1
294;12.11.2016;2016;11;03;Lauantai;0;0;0;0;0;0
294;12.11.2016;2016;11;04;Lauantai;0;0;0;0;0;0
294;12.11.2016;2016;11;05;Lauantai;0;1;1;1;0;1
294;12.11.2016;2016;11;06;Lauantai;0;0;0;2;1;3
294;12.11.2016;2016;11;07;Lauantai;0;0;0;2;4;6
294;12.11.2016;2016;11;08;Lauantai;0;0;0;4;0;4
294;12.11.2016;2016;11;09;Lauantai;1;2;3;5;5;10
294;12.11.2016;2016;11;10;Lauantai;5;2;7;7;14;21
294;12.11.2016;2016;11;11;Lauantai;4;4;8;18;24;42
294;12.11.2016;2016;11;12;Lauantai;2;6;8;19;16;35
294;12.11.2016;2016;11;13;Lauantai;6;6;12;15;12;27
294;12.11.2016;2016;11;14;Lauantai;2;8;10;19;11;30
294;12.11.2016;2016;11;15;Lauantai;6;12;18;12;10;22
294;12.11.2016;2016;11;16;Lauantai;5;4;9;11;16;27
294;12.11.2016;2016;11;17;Lauantai;3;6;9;16;19;35
294;12.11.2016;2016;11;18;Lauantai;2;4;6;13;6;19
294;12.11.2016;2016;11;19;Lauantai;4;3;7;5;3;8
294;12.11.2016;2016;11;20;Lauantai;1;0;1;4;2;6
294;12.11.2016;2016;11;21;Lauantai;1;0;1;1;2;3
294;12.11.2016;2016;11;22;Lauantai;2;0;2;1;2;3
294;12.11.2016;2016;11;23;Lauantai;2;0;2;0;0;0
294;13.11.2016;2016;11;00;Sunnuntai;0;1;1;0;1;1
294;13.11.2016;2016;11;01;Sunnuntai;1;0;1;1;0;1
294;13.11.2016;2016;11;02;Sunnuntai;0;0;0;0;0;0
294;13.11.2016;2016;11;03;Sunnuntai;0;0;0;0;0;0
294;13.11.2016;2016;11;04;Sunnuntai;0;0;0;0;0;0
294;13.11.2016;2016;11;05;Sunnuntai;0;0;0;1;1;2
294;13.11.2016;2016;11;06;Sunnuntai;0;0;0;1;4;5
294;13.11.2016;2016;11;07;Sunnuntai;0;0;0;0;0;0
294;13.11.2016;2016;11;08;Sunnuntai;0;0;0;5;4;9
294;13.11.2016;2016;11;09;Sunnuntai;3;1;4;6;6;12
294;13.11.2016;2016;11;10;Sunnuntai;0;0;0;8;7;15
294;13.11.2016;2016;11;11;Sunnuntai;3;6;9;7;13;20
294;13.11.2016;2016;11;12;Sunnuntai;2;1;3;14;6;20
294;13.11.2016;2016;11;13;Sunnuntai;2;3;5;6;11;17
294;13.11.2016;2016;11;14;Sunnuntai;3;0;3;5;9;14
294;13.11.2016;2016;11;15;Sunnuntai;1;3;4;1;5;6
294;13.11.2016;2016;11;16;Sunnuntai;6;3;9;4;7;11
294;13.11.2016;2016;11;17;Sunnuntai;2;3;5;10;6;16
294;13.11.2016;2016;11;18;Sunnuntai;6;5;11;8;6;14
294;13.11.2016;2016;11;19;Sunnuntai;1;0;1;7;11;18
294;13.11.2016;2016;11;20;Sunnuntai;1;0;1;6;2;8
294;13.11.2016;2016;11;21;Sunnuntai;0;1;1;3;0;3
294;13.11.2016;2016;11;22;Sunnuntai;1;0;1;1;1;2
294;13.11.2016;2016;11;23;Sunnuntai;0;0;0;0;0;0
294;14.11.2016;2016;11;00;Maanantai;0;0;0;0;0;0
294;14.11.2016;2016;11;01;Maanantai;0;0;0;0;0;0
294;14.11.2016;2016;11;02;Maanantai;0;0;0;0;0;0
294;14.11.2016;2016;11;03;Maanantai;0;0;0;0;0;0
294;14.11.2016;2016;11;04;Maanantai;0;0;0;0;0;0
294;14.11.2016;2016;11;05;Maanantai;0;0;0;2;0;2
294;14.11.2016;2016;11;06;Maanantai;5;1;6;4;3;7
294;14.11.2016;2016;11;07;Maanantai;15;7;22;6;7;13
294;14.11.2016;2016;11;08;Maanantai;16;4;20;40;5;45
294;14.11.2016;2016;11;09;Maanantai;22;8;30;19;36;55
294;14.11.2016;2016;11;10;Maanantai;6;5;11;21;11;32
294;14.11.2016;2016;11;11;Maanantai;2;9;11;25;17;42
294;14.11.2016;2016;11;12;Maanantai;3;10;13;11;14;25
294;14.11.2016;2016;11;13;Maanantai;5;15;20;12;15;27
294;14.11.2016;2016;11;14;Maanantai;8;12;20;10;17;27
294;14.11.2016;2016;11;15;Maanantai;7;18;25;20;19;39
294;14.11.2016;2016;11;16;Maanantai;13;10;23;18;13;31
294;14.11.2016;2016;11;17;Maanantai;5;6;11;11;11;22
294;14.11.2016;2016;11;18;Maanantai;8;4;12;22;10;32
294;14.11.2016;2016;11;19;Maanantai;5;1;6;11;16;27
294;14.11.2016;2016;11;20;Maanantai;2;3;5;3;6;9
294;14.11.2016;2016;11;21;Maanantai;0;0;0;1;2;3
294;14.11.2016;2016;11;22;Maanantai;0;0;0;0;0;0
294;14.11.2016;2016;11;23;Maanantai;0;0;0;0;0;0
294;15.11.2016;2016;11;00;Tiistai;0;0;0;0;0;0
294;15.11.2016;2016;11;01;Tiistai;0;0;0;0;0;0
294;15.11.2016;2016;11;02;Tiistai;0;0;0;0;0;0
294;15.11.2016;2016;11;03;Tiistai;0;0;0;0;0;0
294;15.11.2016;2016;11;04;Tiistai;0;0;0;0;0;0
294;15.11.2016;2016;11;05;Tiistai;0;0;0;2;0;2
294;15.11.2016;2016;11;06;Tiistai;1;2;3;2;0;2
294;15.11.2016;2016;11;07;Tiistai;20;2;22;7;4;11
294;15.11.2016;2016;11;08;Tiistai;15;3;18;10;3;13
294;15.11.2016;2016;11;09;Tiistai;17;3;20;16;13;29
294;15.11.2016;2016;11;10;Tiistai;3;3;6;13;10;23
294;15.11.2016;2016;11;11;Tiistai;4;6;10;12;22;34
294;15.11.2016;2016;11;12;Tiistai;19;6;25;30;26;56
294;15.11.2016;2016;11;13;Tiistai;7;8;15;21;8;29
294;15.11.2016;2016;11;14;Tiistai;6;21;27;7;22;29
294;15.11.2016;2016;11;15;Tiistai;14;30;44;11;19;30
294;15.11.2016;2016;11;16;Tiistai;6;13;19;4;11;15
294;15.11.2016;2016;11;17;Tiistai;4;6;10;13;6;19
294;15.11.2016;2016;11;18;Tiistai;3;4;7;12;11;23
294;15.11.2016;2016;11;19;Tiistai;3;3;6;20;18;38
294;15.11.2016;2016;11;20;Tiistai;0;0;0;10;7;17
294;15.11.2016;2016;11;21;Tiistai;1;0;1;3;0;3
294;15.11.2016;2016;11;22;Tiistai;0;2;2;0;1;1
294;15.11.2016;2016;11;23;Tiistai;0;1;1;0;0;0
294;16.11.2016;2016;11;00;Keskiviikko;0;0;0;0;0;0
294;16.11.2016;2016;11;01;Keskiviikko;0;0;0;0;0;0
294;16.11.2016;2016;11;02;Keskiviikko;0;0;0;0;0;0
294;16.11.2016;2016;11;03;Keskiviikko;1;2;3;7;0;7
294;16.11.2016;2016;11;04;Keskiviikko;0;0;0;0;0;0
294;16.11.2016;2016;11;05;Keskiviikko;0;0;0;2;0;2
294;16.11.2016;2016;11;06;Keskiviikko;1;0;1;0;2;2
294;16.11.2016;2016;11;07;Keskiviikko;11;3;14;15;8;23
294;16.11.2016;2016;11;08;Keskiviikko;21;5;26;11;7;18
294;16.11.2016;2016;11;09;Keskiviikko;11;13;24;25;10;35
294;16.11.2016;2016;11;10;Keskiviikko;4;5;9;15;12;27
294;16.11.2016;2016;11;11;Keskiviikko;3;3;6;17;14;31
294;16.11.2016;2016;11;12;Keskiviikko;5;2;7;21;22;43
294;16.11.2016;2016;11;13;Keskiviikko;5;14;19;13;14;27
294;16.11.2016;2016;11;14;Keskiviikko;7;17;24;27;30;57
294;16.11.2016;2016;11;15;Keskiviikko;6;10;16;16;17;33
294;16.11.2016;2016;11;16;Keskiviikko;18;12;30;19;21;40
294;16.11.2016;2016;11;17;Keskiviikko;5;11;16;9;13;22
294;16.11.2016;2016;11;18;Keskiviikko;5;5;10;15;7;22
294;16.11.2016;2016;11;19;Keskiviikko;4;0;4;9;14;23
294;16.11.2016;2016;11;20;Keskiviikko;2;6;8;7;3;10
294;16.11.2016;2016;11;21;Keskiviikko;0;0;0;1;6;7
294;16.11.2016;2016;11;22;Keskiviikko;0;0;0;0;0;0
294;16.11.2016;2016;11;23;Keskiviikko;0;0;0;0;0;0
294;17.11.2016;2016;11;00;Torstai;0;0;0;0;0;0
294;17.11.2016;2016;11;01;Torstai;0;0;0;0;0;0
294;17.11.2016;2016;11;02;Torstai;0;0;0;0;0;0
294;17.11.2016;2016;11;03;Torstai;0;0;0;5;3;8
294;17.11.2016;2016;11;04;Torstai;0;0;0;0;0;0
294;17.11.2016;2016;11;05;Torstai;0;0;0;3;0;3
294;17.11.2016;2016;11;06;Torstai;1;1;2;1;4;5
294;17.11.2016;2016;11;07;Torstai;4;2;6;11;3;14
294;17.11.2016;2016;11;08;Torstai;14;8;22;14;9;23
294;17.11.2016;2016;11;09;Torstai;7;3;10;16;7;23
294;17.11.2016;2016;11;10;Torstai;4;8;12;14;10;24
294;17.11.2016;2016;11;11;Torstai;7;3;10;19;14;33
294;17.11.2016;2016;11;12;Torstai;7;5;12;20;17;37
294;17.11.2016;2016;11;13;Torstai;4;6;10;14;16;30
294;17.11.2016;2016;11;14;Torstai;15;22;37;17;13;30
294;17.11.2016;2016;11;15;Torstai;13;19;32;7;11;18
294;17.11.2016;2016;11;16;Torstai;7;6;13;10;11;21
294;17.11.2016;2016;11;17;Torstai;6;6;12;16;15;31
294;17.11.2016;2016;11;18;Torstai;12;6;18;17;15;32
294;17.11.2016;2016;11;19;Torstai;11;5;16;14;12;26
294;17.11.2016;2016;11;20;Torstai;1;5;6;5;6;11
294;17.11.2016;2016;11;21;Torstai;0;1;1;1;2;3
294;17.11.2016;2016;11;22;Torstai;0;0;0;0;0;0
294;17.11.2016;2016;11;23;Torstai;0;0;0;0;0;0
294;18.11.2016;2016;11;00;Perjantai;0;0;0;0;0;0
294;18.11.2016;2016;11;01;Perjantai;0;0;0;0;0;0
294;18.11.2016;2016;11;02;Perjantai;0;0;0;0;0;0
294;18.11.2016;2016;11;03;Perjantai;0;0;0;0;0;0
294;18.11.2016;2016;11;04;Perjantai;0;0;0;0;0;0
294;18.11.2016;2016;11;05;Perjantai;0;0;0;4;2;6
294;18.11.2016;2016;11;06;Perjantai;2;1;3;0;2;2
294;18.11.2016;2016;11;07;Perjantai;12;1;13;6;5;11
294;18.11.2016;2016;11;08;Perjantai;16;2;18;7;4;11
294;18.11.2016;2016;11;09;Perjantai;19;5;24;17;7;24
294;18.11.2016;2016;11;10;Perjantai;4;8;12;12;10;22
294;18.11.2016;2016;11;11;Perjantai;3;2;5;12;16;28
294;18.11.2016;2016;11;12;Perjantai;5;15;20;9;14;23
294;18.11.2016;2016;11;13;Perjantai;8;17;25;19;19;38
294;18.11.2016;2016;11;14;Perjantai;10;21;31;7;16;23
294;18.11.2016;2016;11;15;Perjantai;9;5;14;18;15;33
294;18.11.2016;2016;11;16;Perjantai;5;10;15;11;7;18
294;18.11.2016;2016;11;17;Perjantai;8;6;14;14;15;29
294;18.11.2016;2016;11;18;Perjantai;4;2;6;12;5;17
294;18.11.2016;2016;11;19;Perjantai;0;4;4;14;14;28
294;18.11.2016;2016;11;20;Perjantai;3;2;5;4;6;10
294;18.11.2016;2016;11;21;Perjantai;0;0;0;9;10;19
294;18.11.2016;2016;11;22;Perjantai;4;0;4;2;1;3
294;18.11.2016;2016;11;23;Perjantai;0;0;0;0;0;0
294;19.11.2016;2016;11;00;Lauantai;0;0;0;3;1;4
294;19.11.2016;2016;11;01;Lauantai;0;0;0;1;1;2
294;19.11.2016;2016;11;02;Lauantai;4;2;6;3;0;3
294;19.11.2016;2016;11;03;Lauantai;0;0;0;0;1;1
294;19.11.2016;2016;11;04;Lauantai;0;0;0;0;0;0
294;19.11.2016;2016;11;05;Lauantai;0;0;0;2;0;2
294;19.11.2016;2016;11;06;Lauantai;0;0;0;0;1;1
294;19.11.2016;2016;11;07;Lauantai;1;0;1;0;0;0
294;19.11.2016;2016;11;08;Lauantai;1;0;1;0;2;2
294;19.11.2016;2016;11;09;Lauantai;1;2;3;6;5;11
294;19.11.2016;2016;11;10;Lauantai;3;3;6;10;12;22
294;19.11.2016;2016;11;11;Lauantai;4;7;11;20;19;39
294;19.11.2016;2016;11;12;Lauantai;9;3;12;19;12;31
294;19.11.2016;2016;11;13;Lauantai;4;7;11;9;9;18
294;19.11.2016;2016;11;14;Lauantai;5;9;14;8;5;13
294;19.11.2016;2016;11;15;Lauantai;1;1;2;6;11;17
294;19.11.2016;2016;11;16;Lauantai;8;10;18;6;10;16
294;19.11.2016;2016;11;17;Lauantai;6;6;12;3;5;8
294;19.11.2016;2016;11;18;Lauantai;2;2;4;6;5;11
294;19.11.2016;2016;11;19;Lauantai;3;0;3;5;1;6
294;19.11.2016;2016;11;20;Lauantai;0;0;0;6;2;8
294;19.11.2016;2016;11;21;Lauantai;3;2;5;0;3;3
294;19.11.2016;2016;11;22;Lauantai;3;0;3;1;4;5
294;19.11.2016;2016;11;23;Lauantai;0;0;0;2;1;3
294;20.11.2016;2016;11;00;Sunnuntai;0;0;0;1;0;1
294;20.11.2016;2016;11;01;Sunnuntai;0;0;0;0;0;0
294;20.11.2016;2016;11;02;Sunnuntai;0;0;0;0;0;0
294;20.11.2016;2016;11;03;Sunnuntai;0;0;0;1;1;2
294;20.11.2016;2016;11;04;Sunnuntai;0;0;0;1;1;2
294;20.11.2016;2016;11;05;Sunnuntai;0;0;0;0;0;0
294;20.11.2016;2016;11;06;Sunnuntai;2;1;3;3;4;7
294;20.11.2016;2016;11;07;Sunnuntai;2;0;2;0;0;0
294;20.11.2016;2016;11;08;Sunnuntai;0;0;0;2;6;8
294;20.11.2016;2016;11;09;Sunnuntai;6;2;8;4;4;8
294;20.11.2016;2016;11;10;Sunnuntai;0;2;2;8;9;17
294;20.11.2016;2016;11;11;Sunnuntai;3;7;10;9;6;15
294;20.11.2016;2016;11;12;Sunnuntai;3;1;4;14;6;20
294;20.11.2016;2016;11;13;Sunnuntai;1;2;3;4;5;9
294;20.11.2016;2016;11;14;Sunnuntai;2;4;6;14;11;25
294;20.11.2016;2016;11;15;Sunnuntai;7;2;9;8;9;17
294;20.11.2016;2016;11;16;Sunnuntai;2;3;5;11;10;21
294;20.11.2016;2016;11;17;Sunnuntai;3;1;4;8;2;10
294;20.11.2016;2016;11;18;Sunnuntai;7;6;13;13;12;25
294;20.11.2016;2016;11;19;Sunnuntai;1;1;2;7;4;11
294;20.11.2016;2016;11;20;Sunnuntai;4;0;4;6;5;11
294;20.11.2016;2016;11;21;Sunnuntai;0;0;0;1;0;1
294;20.11.2016;2016;11;22;Sunnuntai;0;0;0;0;0;0
294;20.11.2016;2016;11;23;Sunnuntai;0;0;0;0;0;0
294;21.11.2016;2016;11;00;Maanantai;0;0;0;0;0;0
294;21.11.2016;2016;11;01;Maanantai;0;0;0;0;0;0
294;21.11.2016;2016;11;02;Maanantai;0;0;0;0;0;0
294;21.11.2016;2016;11;03;Maanantai;0;0;0;0;0;0
294;21.11.2016;2016;11;04;Maanantai;0;0;0;0;0;0
294;21.11.2016;2016;11;05;Maanantai;0;0;0;2;0;2
294;21.11.2016;2016;11;06;Maanantai;2;1;3;1;1;2
294;21.11.2016;2016;11;07;Maanantai;14;1;15;8;3;11
294;21.11.2016;2016;11;08;Maanantai;13;2;15;20;6;26
294;21.11.2016;2016;11;09;Maanantai;12;4;16;19;10;29
294;21.11.2016;2016;11;10;Maanantai;5;9;14;12;11;23
294;21.11.2016;2016;11;11;Maanantai;10;7;17;17;17;34
294;21.11.2016;2016;11;12;Maanantai;3;11;14;15;13;28
294;21.11.2016;2016;11;13;Maanantai;4;11;15;14;15;29
294;21.11.2016;2016;11;14;Maanantai;8;14;22;13;15;28
294;21.11.2016;2016;11;15;Maanantai;6;12;18;7;12;19
294;21.11.2016;2016;11;16;Maanantai;6;6;12;7;9;16
294;21.11.2016;2016;11;17;Maanantai;7;7;14;5;7;12
294;21.11.2016;2016;11;18;Maanantai;3;4;7;10;3;13
294;21.11.2016;2016;11;19;Maanantai;3;1;4;6;7;13
294;21.11.2016;2016;11;20;Maanantai;0;0;0;4;4;8
294;21.11.2016;2016;11;21;Maanantai;0;0;0;1;0;1
294;21.11.2016;2016;11;22;Maanantai;0;0;0;1;0;1
294;21.11.2016;2016;11;23;Maanantai;0;0;0;0;0;0
294;22.11.2016;2016;11;00;Tiistai;0;0;0;0;0;0
294;22.11.2016;2016;11;01;Tiistai;0;0;0;0;0;0
294;22.11.2016;2016;11;02;Tiistai;0;0;0;0;0;0
294;22.11.2016;2016;11;03;Tiistai;0;0;0;0;0;0
294;22.11.2016;2016;11;04;Tiistai;0;0;0;0;1;1
294;22.11.2016;2016;11;05;Tiistai;0;0;0;2;0;2
294;22.11.2016;2016;11;06;Tiistai;3;2;5;2;2;4
294;22.11.2016;2016;11;07;Tiistai;16;1;17;6;8;14
294;22.11.2016;2016;11;08;Tiistai;13;7;20;13;5;18
294;22.11.2016;2016;11;09;Tiistai;12;9;21;16;10;26
294;22.11.2016;2016;11;10;Tiistai;4;9;13;14;14;28
294;22.11.2016;2016;11;11;Tiistai;6;5;11;11;13;24
294;22.11.2016;2016;11;12;Tiistai;8;9;17;11;14;25
294;22.11.2016;2016;11;13;Tiistai;11;15;26;7;14;21
294;22.11.2016;2016;11;14;Tiistai;6;8;14;13;12;25
294;22.11.2016;2016;11;15;Tiistai;9;3;12;9;15;24
294;22.11.2016;2016;11;16;Tiistai;11;12;23;11;10;21
294;22.11.2016;2016;11;17;Tiistai;7;6;13;16;9;25
294;22.11.2016;2016;11;18;Tiistai;7;4;11;15;10;25
294;22.11.2016;2016;11;19;Tiistai;0;2;2;5;7;12
294;22.11.2016;2016;11;20;Tiistai;3;1;4;5;2;7
294;22.11.2016;2016;11;21;Tiistai;0;1;1;1;0;1
294;22.11.2016;2016;11;22;Tiistai;0;0;0;0;0;0
294;22.11.2016;2016;11;23;Tiistai;0;0;0;0;0;0
294;23.11.2016;2016;11;00;Keskiviikko;0;0;0;1;1;2
294;23.11.2016;2016;11;01;Keskiviikko;0;0;0;0;0;0
294;23.11.2016;2016;11;02;Keskiviikko;0;0;0;0;0;0
294;23.11.2016;2016;11;03;Keskiviikko;0;0;0;0;0;0
294;23.11.2016;2016;11;04;Keskiviikko;0;0;0;1;2;3
294;23.11.2016;2016;11;05;Keskiviikko;0;0;0;1;0;1
294;23.11.2016;2016;11;06;Keskiviikko;2;2;4;1;1;2
294;23.11.2016;2016;11;07;Keskiviikko;10;3;13;7;3;10
294;23.11.2016;2016;11;08;Keskiviikko;20;7;27;12;3;15
294;23.11.2016;2016;11;09;Keskiviikko;12;9;21;7;6;13
294;23.11.2016;2016;11;10;Keskiviikko;7;9;16;6;15;21
294;23.11.2016;2016;11;11;Keskiviikko;8;12;20;8;12;20
294;23.11.2016;2016;11;12;Keskiviikko;7;6;13;11;7;18
294;23.11.2016;2016;11;13;Keskiviikko;6;23;29;13;10;23
294;23.11.2016;2016;11;14;Keskiviikko;13;17;30;13;13;26
294;23.11.2016;2016;11;15;Keskiviikko;11;14;25;6;7;13
294;23.11.2016;2016;11;16;Keskiviikko;12;9;21;5;10;15
294;23.11.2016;2016;11;17;Keskiviikko;8;5;13;12;11;23
294;23.11.2016;2016;11;18;Keskiviikko;6;7;13;7;6;13
294;23.11.2016;2016;11;19;Keskiviikko;0;3;3;10;8;18
294;23.11.2016;2016;11;20;Keskiviikko;4;6;10;7;5;12
294;23.11.2016;2016;11;21;Keskiviikko;0;0;0;2;1;3
294;23.11.2016;2016;11;22;Keskiviikko;1;0;1;2;0;2
294;23.11.2016;2016;11;23;Keskiviikko;0;0;0;0;1;1
294;24.11.2016;2016;11;00;Torstai;0;0;0;0;1;1
294;24.11.2016;2016;11;01;Torstai;0;0;0;1;0;1
294;24.11.2016;2016;11;02;Torstai;0;0;0;0;0;0
294;24.11.2016;2016;11;03;Torstai;0;0;0;0;0;0
294;24.11.2016;2016;11;04;Torstai;0;0;0;0;1;1
294;24.11.2016;2016;11;05;Torstai;0;0;0;0;0;0
294;24.11.2016;2016;11;06;Torstai;3;2;5;3;1;4
294;24.11.2016;2016;11;07;Torstai;8;2;10;11;8;19
294;24.11.2016;2016;11;08;Torstai;11;4;15;9;7;16
294;24.11.2016;2016;11;09;Torstai;8;4;12;6;9;15
294;24.11.2016;2016;11;10;Torstai;3;5;8;23;12;35
294;24.11.2016;2016;11;11;Torstai;3;11;14;17;20;37
294;24.11.2016;2016;11;12;Torstai;9;9;18;13;11;24
294;24.11.2016;2016;11;13;Torstai;12;20;32;19;20;39
294;24.11.2016;2016;11;14;Torstai;10;16;26;14;20;34
294;24.11.2016;2016;11;15;Torstai;9;8;17;14;20;34
294;24.11.2016;2016;11;16;Torstai;9;7;16;11;14;25
294;24.11.2016;2016;11;17;Torstai;3;4;7;7;9;16
294;24.11.2016;2016;11;18;Torstai;11;6;17;26;15;41
294;24.11.2016;2016;11;19;Torstai;5;6;11;8;15;23
294;24.11.2016;2016;11;20;Torstai;3;8;11;2;3;5
294;24.11.2016;2016;11;21;Torstai;0;2;2;3;2;5
294;24.11.2016;2016;11;22;Torstai;0;0;0;0;0;0
294;24.11.2016;2016;11;23;Torstai;0;0;0;0;1;1
294;25.11.2016;2016;11;00;Perjantai;0;0;0;0;0;0
294;25.11.2016;2016;11;01;Perjantai;0;0;0;0;0;0
294;25.11.2016;2016;11;02;Perjantai;0;0;0;0;0;0
294;25.11.2016;2016;11;03;Perjantai;0;0;0;0;0;0
294;25.11.2016;2016;11;04;Perjantai;0;0;0;0;0;0
294;25.11.2016;2016;11;05;Perjantai;1;0;1;0;0;0
294;25.11.2016;2016;11;06;Perjantai;2;1;3;1;3;4
294;25.11.2016;2016;11;07;Perjantai;10;5;15;11;9;20
294;25.11.2016;2016;11;08;Perjantai;17;1;18;20;1;21
294;25.11.2016;2016;11;09;Perjantai;17;8;25;13;7;20
294;25.11.2016;2016;11;10;Perjantai;5;7;12;13;25;38
294;25.11.2016;2016;11;11;Perjantai;1;7;8;12;12;24
294;25.11.2016;2016;11;12;Perjantai;7;17;24;12;13;25
294;25.11.2016;2016;11;13;Perjantai;13;12;25;19;19;38
294;25.11.2016;2016;11;14;Perjantai;13;15;28;11;15;26
294;25.11.2016;2016;11;15;Perjantai;5;11;16;8;11;19
294;25.11.2016;2016;11;16;Perjantai;3;3;6;12;4;16
294;25.11.2016;2016;11;17;Perjantai;2;11;13;7;10;17
294;25.11.2016;2016;11;18;Perjantai;22;10;32;17;21;38
294;25.11.2016;2016;11;19;Perjantai;8;5;13;14;7;21
294;25.11.2016;2016;11;20;Perjantai;16;9;25;9;11;20
294;25.11.2016;2016;11;21;Perjantai;2;4;6;4;3;7
294;25.11.2016;2016;11;22;Perjantai;4;0;4;1;0;1
294;25.11.2016;2016;11;23;Perjantai;1;0;1;0;0;0
294;26.11.2016;2016;11;00;Lauantai;0;0;0;1;1;2
294;26.11.2016;2016;11;01;Lauantai;0;0;0;1;0;1
294;26.11.2016;2016;11;02;Lauantai;0;0;0;0;1;1
294;26.11.2016;2016;11;03;Lauantai;1;0;1;3;0;3
294;26.11.2016;2016;11;04;Lauantai;0;0;0;0;0;0
294;26.11.2016;2016;11;05;Lauantai;1;0;1;0;1;1
294;26.11.2016;2016;11;06;Lauantai;0;1;1;0;1;1
294;26.11.2016;2016;11;07;Lauantai;1;0;1;1;0;1
294;26.11.2016;2016;11;08;Lauantai;1;0;1;3;2;5
294;26.11.2016;2016;11;09;Lauantai;4;2;6;14;7;21
294;26.11.2016;2016;11;10;Lauantai;1;4;5;17;13;30
294;26.11.2016;2016;11;11;Lauantai;6;1;7;15;17;32
294;26.11.2016;2016;11;12;Lauantai;1;1;2;11;13;24
294;26.11.2016;2016;11;13;Lauantai;1;3;4;13;9;22
294;26.11.2016;2016;11;14;Lauantai;5;8;13;9;4;13
294;26.11.2016;2016;11;15;Lauantai;8;13;21;12;11;23
294;26.11.2016;2016;11;16;Lauantai;8;6;14;7;7;14
294;26.11.2016;2016;11;17;Lauantai;4;5;9;8;8;16
294;26.11.2016;2016;11;18;Lauantai;8;5;13;13;8;21
294;26.11.2016;2016;11;19;Lauantai;11;10;21;6;3;9
294;26.11.2016;2016;11;20;Lauantai;8;5;13;4;3;7
294;26.11.2016;2016;11;21;Lauantai;2;2;4;3;0;3
294;26.11.2016;2016;11;22;Lauantai;2;0;2;2;2;4
294;26.11.2016;2016;11;23;Lauantai;0;0;0;0;0;0
294;27.11.2016;2016;11;00;Sunnuntai;0;0;0;0;0;0
294;27.11.2016;2016;11;01;Sunnuntai;1;0;1;1;0;1
294;27.11.2016;2016;11;02;Sunnuntai;0;0;0;0;1;1
294;27.11.2016;2016;11;03;Sunnuntai;0;0;0;0;0;0
294;27.11.2016;2016;11;04;Sunnuntai;0;0;0;1;1;2
294;27.11.2016;2016;11;05;Sunnuntai;0;0;0;0;0;0
294;27.11.2016;2016;11;06;Sunnuntai;1;0;1;0;1;1
294;27.11.2016;2016;11;07;Sunnuntai;1;0;1;2;1;3
294;27.11.2016;2016;11;08;Sunnuntai;0;0;0;2;4;6
294;27.11.2016;2016;11;09;Sunnuntai;2;1;3;11;4;15
294;27.11.2016;2016;11;10;Sunnuntai;2;1;3;11;4;15
294;27.11.2016;2016;11;11;Sunnuntai;3;8;11;8;9;17
294;27.11.2016;2016;11;12;Sunnuntai;2;0;2;11;13;24
294;27.11.2016;2016;11;13;Sunnuntai;2;2;4;16;9;25
294;27.11.2016;2016;11;14;Sunnuntai;4;7;11;5;15;20
294;27.11.2016;2016;11;15;Sunnuntai;3;6;9;4;9;13
294;27.11.2016;2016;11;16;Sunnuntai;5;4;9;11;7;18
294;27.11.2016;2016;11;17;Sunnuntai;3;4;7;4;5;9
294;27.11.2016;2016;11;18;Sunnuntai;5;3;8;10;9;19
294;27.11.2016;2016;11;19;Sunnuntai;2;0;2;11;9;20
294;27.11.2016;2016;11;20;Sunnuntai;2;1;3;4;3;7
294;27.11.2016;2016;11;21;Sunnuntai;1;2;3;0;0;0
294;27.11.2016;2016;11;22;Sunnuntai;0;0;0;0;0;0
294;27.11.2016;2016;11;23;Sunnuntai;0;0;0;0;0;0
294;28.11.2016;2016;11;00;Maanantai;0;0;0;0;0;0
294;28.11.2016;2016;11;01;Maanantai;0;0;0;0;0;0
294;28.11.2016;2016;11;02;Maanantai;0;0;0;0;0;0
294;28.11.2016;2016;11;03;Maanantai;0;0;0;0;0;0
294;28.11.2016;2016;11;04;Maanantai;0;0;0;0;0;0
294;28.11.2016;2016;11;05;Maanantai;0;1;1;0;1;1
294;28.11.2016;2016;11;06;Maanantai;2;2;4;2;4;6
294;28.11.2016;2016;11;07;Maanantai;7;5;12;5;5;10
294;28.11.2016;2016;11;08;Maanantai;11;3;14;14;5;19
294;28.11.2016;2016;11;09;Maanantai;10;5;15;11;6;17
294;28.11.2016;2016;11;10;Maanantai;11;10;21;8;12;20
294;28.11.2016;2016;11;11;Maanantai;5;6;11;18;11;29
294;28.11.2016;2016;11;12;Maanantai;8;14;22;17;12;29
294;28.11.2016;2016;11;13;Maanantai;3;8;11;22;23;45
294;28.11.2016;2016;11;14;Maanantai;11;15;26;14;12;26
294;28.11.2016;2016;11;15;Maanantai;10;15;25;8;16;24
294;28.11.2016;2016;11;16;Maanantai;6;5;11;12;12;24
294;28.11.2016;2016;11;17;Maanantai;4;8;12;7;13;20
294;28.11.2016;2016;11;18;Maanantai;12;3;15;12;16;28
294;28.11.2016;2016;11;19;Maanantai;3;3;6;8;8;16
294;28.11.2016;2016;11;20;Maanantai;1;1;2;5;2;7
294;28.11.2016;2016;11;21;Maanantai;0;0;0;1;1;2
294;28.11.2016;2016;11;22;Maanantai;0;0;0;0;0;0
294;28.11.2016;2016;11;23;Maanantai;0;0;0;0;0;0
294;29.11.2016;2016;11;00;Tiistai;0;0;0;0;0;0
294;29.11.2016;2016;11;01;Tiistai;0;0;0;0;0;0
294;29.11.2016;2016;11;02;Tiistai;0;0;0;0;0;0
294;29.11.2016;2016;11;03;Tiistai;0;0;0;0;0;0
294;29.11.2016;2016;11;04;Tiistai;0;0;0;0;1;1
294;29.11.2016;2016;11;05;Tiistai;0;0;0;2;0;2
294;29.11.2016;2016;11;06;Tiistai;5;1;6;3;2;5
294;29.11.2016;2016;11;07;Tiistai;16;1;17;9;5;14
294;29.11.2016;2016;11;08;Tiistai;12;7;19;9;6;15
294;29.11.2016;2016;11;09;Tiistai;14;5;19;14;8;22
294;29.11.2016;2016;11;10;Tiistai;4;11;15;13;16;29
294;29.11.2016;2016;11;11;Tiistai;2;4;6;19;9;28
294;29.11.2016;2016;11;12;Tiistai;4;0;4;7;11;18
294;29.11.2016;2016;11;13;Tiistai;4;5;9;9;11;20
294;29.11.2016;2016;11;14;Tiistai;6;11;17;8;16;24
294;29.11.2016;2016;11;15;Tiistai;5;7;12;10;12;22
294;29.11.2016;2016;11;16;Tiistai;2;5;7;10;16;26
294;29.11.2016;2016;11;17;Tiistai;2;3;5;12;9;21
294;29.11.2016;2016;11;18;Tiistai;1;1;2;14;15;29
294;29.11.2016;2016;11;19;Tiistai;5;5;10;9;7;16
294;29.11.2016;2016;11;20;Tiistai;9;1;10;8;5;13
294;29.11.2016;2016;11;21;Tiistai;2;0;2;1;1;2
294;29.11.2016;2016;11;22;Tiistai;1;0;1;0;0;0
294;29.11.2016;2016;11;23;Tiistai;0;0;0;0;0;0
294;30.11.2016;2016;11;00;Keskiviikko;0;0;0;0;0;0
294;30.11.2016;2016;11;01;Keskiviikko;0;0;0;0;0;0
294;30.11.2016;2016;11;02;Keskiviikko;0;0;0;0;0;0
294;30.11.2016;2016;11;03;Keskiviikko;1;0;1;2;0;2
294;30.11.2016;2016;11;04;Keskiviikko;0;0;0;0;0;0
294;30.11.2016;2016;11;05;Keskiviikko;1;0;1;2;0;2
294;30.11.2016;2016;11;06;Keskiviikko;3;0;3;3;1;4
294;30.11.2016;2016;11;07;Keskiviikko;9;2;11;11;10;21
294;30.11.2016;2016;11;08;Keskiviikko;12;3;15;10;2;12
294;30.11.2016;2016;11;09;Keskiviikko;6;8;14;10;8;18
294;30.11.2016;2016;11;10;Keskiviikko;4;4;8;14;15;29
294;30.11.2016;2016;11;11;Keskiviikko;1;7;8;8;16;24
294;30.11.2016;2016;11;12;Keskiviikko;8;6;14;11;4;15
294;30.11.2016;2016;11;13;Keskiviikko;4;8;12;10;14;24
294;30.11.2016;2016;11;14;Keskiviikko;10;9;19;11;14;25
294;30.11.2016;2016;11;15;Keskiviikko;6;6;12;13;8;21
294;30.11.2016;2016;11;16;Keskiviikko;13;3;16;16;14;30
294;30.11.2016;2016;11;17;Keskiviikko;5;5;10;13;15;28
294;30.11.2016;2016;11;18;Keskiviikko;3;11;14;15;14;29
294;30.11.2016;2016;11;19;Keskiviikko;2;2;4;20;15;35
294;30.11.2016;2016;11;20;Keskiviikko;5;3;8;11;7;18
294;30.11.2016;2016;11;21;Keskiviikko;1;2;3;1;0;1
294;30.11.2016;2016;11;22;Keskiviikko;0;0;0;3;1;4
294;30.11.2016;2016;11;23;Keskiviikko;0;0;0;0;0;0
294;01.12.2016;2016;12;00;Torstai;0;0;0;0;1;1
294;01.12.2016;2016;12;01;Torstai;0;0;0;0;0;0
294;01.12.2016;2016;12;02;Torstai;0;0;0;0;0;0
294;01.12.2016;2016;12;03;Torstai;0;0;0;0;0;0
294;01.12.2016;2016;12;04;Torstai;0;0;0;0;1;1
294;01.12.2016;2016;12;05;Torstai;0;0;0;2;0;2
294;01.12.2016;2016;12;06;Torstai;2;2;4;3;1;4
294;01.12.2016;2016;12;07;Torstai;8;3;11;8;3;11
294;01.12.2016;2016;12;08;Torstai;12;1;13;18;3;21
294;01.12.2016;2016;12;09;Torstai;6;1;7;20;8;28
294;01.12.2016;2016;12;10;Torstai;2;3;5;12;10;22
294;01.12.2016;2016;12;11;Torstai;6;13;19;19;20;39
294;01.12.2016;2016;12;12;Torstai;9;4;13;13;12;25
294;01.12.2016;2016;12;13;Torstai;6;20;26;18;12;30
294;01.12.2016;2016;12;14;Torstai;11;17;28;16;21;37
294;01.12.2016;2016;12;15;Torstai;3;11;14;14;23;37
294;01.12.2016;2016;12;16;Torstai;10;5;15;17;16;33
294;01.12.2016;2016;12;17;Torstai;7;8;15;16;17;33
294;01.12.2016;2016;12;18;Torstai;6;8;14;19;8;27
294;01.12.2016;2016;12;19;Torstai;3;11;14;9;15;24
294;01.12.2016;2016;12;20;Torstai;4;4;8;8;3;11
294;01.12.2016;2016;12;21;Torstai;3;0;3;4;4;8
294;01.12.2016;2016;12;22;Torstai;0;0;0;1;0;1
294;01.12.2016;2016;12;23;Torstai;0;0;0;0;0;0
294;02.12.2016;2016;12;00;Perjantai;2;0;2;0;0;0
294;02.12.2016;2016;12;01;Perjantai;0;0;0;0;0;0
294;02.12.2016;2016;12;02;Perjantai;0;0;0;0;0;0
294;02.12.2016;2016;12;03;Perjantai;0;0;0;0;0;0
294;02.12.2016;2016;12;04;Perjantai;0;0;0;0;0;0
294;02.12.2016;2016;12;05;Perjantai;0;0;0;2;0;2
294;02.12.2016;2016;12;06;Perjantai;1;3;4;3;1;4
294;02.12.2016;2016;12;07;Perjantai;4;1;5;7;6;13
294;02.12.2016;2016;12;08;Perjantai;3;6;9;9;5;14
294;02.12.2016;2016;12;09;Perjantai;6;2;8;8;10;18
294;02.12.2016;2016;12;10;Perjantai;4;1;5;9;17;26
294;02.12.2016;2016;12;11;Perjantai;6;4;10;12;21;33
294;02.12.2016;2016;12;12;Perjantai;5;8;13;17;21;38
294;02.12.2016;2016;12;13;Perjantai;11;11;22;15;14;29
294;02.12.2016;2016;12;14;Perjantai;10;14;24;6;23;29
294;02.12.2016;2016;12;15;Perjantai;9;14;23;11;15;26
294;02.12.2016;2016;12;16;Perjantai;6;4;10;7;15;22
294;02.12.2016;2016;12;17;Perjantai;9;3;12;9;13;22
294;02.12.2016;2016;12;18;Perjantai;8;9;17;20;15;35
294;02.12.2016;2016;12;19;Perjantai;5;8;13;7;11;18
294;02.12.2016;2016;12;20;Perjantai;4;3;7;11;6;17
294;02.12.2016;2016;12;21;Perjantai;1;0;1;1;2;3
294;02.12.2016;2016;12;22;Perjantai;1;0;1;4;0;4
294;02.12.2016;2016;12;23;Perjantai;2;1;3;1;0;1
294;03.12.2016;2016;12;00;Lauantai;1;0;1;0;0;0
294;03.12.2016;2016;12;01;Lauantai;0;0;0;0;0;0
294;03.12.2016;2016;12;02;Lauantai;0;0;0;0;1;1
294;03.12.2016;2016;12;03;Lauantai;0;0;0;0;0;0
294;03.12.2016;2016;12;04;Lauantai;0;0;0;0;0;0
294;03.12.2016;2016;12;05;Lauantai;1;0;1;0;1;1
294;03.12.2016;2016;12;06;Lauantai;0;0;0;2;4;6
294;03.12.2016;2016;12;07;Lauantai;0;0;0;1;3;4
294;03.12.2016;2016;12;08;Lauantai;0;0;0;7;4;11
294;03.12.2016;2016;12;09;Lauantai;0;0;0;11;5;16
294;03.12.2016;2016;12;10;Lauantai;0;2;2;15;15;30
294;03.12.2016;2016;12;11;Lauantai;1;2;3;11;18;29
294;03.12.2016;2016;12;12;Lauantai;0;3;3;14;19;33
294;03.12.2016;2016;12;13;Lauantai;0;1;1;9;8;17
294;03.12.2016;2016;12;14;Lauantai;1;1;2;15;11;26
294;03.12.2016;2016;12;15;Lauantai;2;3;5;14;13;27
294;03.12.2016;2016;12;16;Lauantai;0;2;2;13;6;19
294;03.12.2016;2016;12;17;Lauantai;2;2;4;10;5;15
294;03.12.2016;2016;12;18;Lauantai;4;3;7;7;4;11
294;03.12.2016;2016;12;19;Lauantai;2;1;3;4;4;8
294;03.12.2016;2016;12;20;Lauantai;1;0;1;2;2;4
294;03.12.2016;2016;12;21;Lauantai;0;0;0;1;1;2
294;03.12.2016;2016;12;22;Lauantai;3;0;3;0;0;0
294;03.12.2016;2016;12;23;Lauantai;0;0;0;0;0;0
294;04.12.2016;2016;12;00;Sunnuntai;0;0;0;0;0;0
294;04.12.2016;2016;12;01;Sunnuntai;0;0;0;0;0;0
294;04.12.2016;2016;12;02;Sunnuntai;0;0;0;0;0;0
294;04.12.2016;2016;12;03;Sunnuntai;0;0;0;0;0;0
294;04.12.2016;2016;12;04;Sunnuntai;0;0;0;1;0;1
294;04.12.2016;2016;12;05;Sunnuntai;0;1;1;0;0;0
294;04.12.2016;2016;12;06;Sunnuntai;0;0;0;1;1;2
294;04.12.2016;2016;12;07;Sunnuntai;1;0;1;1;0;1
294;04.12.2016;2016;12;08;Sunnuntai;0;0;0;2;0;2
294;04.12.2016;2016;12;09;Sunnuntai;2;0;2;3;1;4
294;04.12.2016;2016;12;10;Sunnuntai;0;0;0;6;11;17
294;04.12.2016;2016;12;11;Sunnuntai;0;5;5;8;5;13
294;04.12.2016;2016;12;12;Sunnuntai;3;2;5;6;2;8
294;04.12.2016;2016;12;13;Sunnuntai;4;3;7;12;5;17
294;04.12.2016;2016;12;14;Sunnuntai;2;1;3;6;3;9
294;04.12.2016;2016;12;15;Sunnuntai;3;1;4;6;0;6
294;04.12.2016;2016;12;16;Sunnuntai;1;1;2;8;7;15
294;04.12.2016;2016;12;17;Sunnuntai;2;0;2;7;6;13
294;04.12.2016;2016;12;18;Sunnuntai;0;3;3;5;2;7
294;04.12.2016;2016;12;19;Sunnuntai;1;1;2;5;5;10
294;04.12.2016;2016;12;20;Sunnuntai;4;1;5;6;4;10
294;04.12.2016;2016;12;21;Sunnuntai;0;5;5;2;0;2
294;04.12.2016;2016;12;22;Sunnuntai;0;0;0;2;0;2
294;04.12.2016;2016;12;23;Sunnuntai;0;0;0;1;1;2
294;05.12.2016;2016;12;00;Maanantai;0;1;1;7;0;7
294;05.12.2016;2016;12;01;Maanantai;0;0;0;0;0;0
294;05.12.2016;2016;12;02;Maanantai;0;0;0;0;1;1
294;05.12.2016;2016;12;03;Maanantai;0;0;0;0;0;0
294;05.12.2016;2016;12;04;Maanantai;0;0;0;0;0;0
294;05.12.2016;2016;12;05;Maanantai;0;0;0;2;0;2
294;05.12.2016;2016;12;06;Maanantai;0;1;1;4;0;4
294;05.12.2016;2016;12;07;Maanantai;2;2;4;1;4;5
294;05.12.2016;2016;12;08;Maanantai;1;2;3;8;3;11
294;05.12.2016;2016;12;09;Maanantai;4;0;4;8;7;15
294;05.12.2016;2016;12;10;Maanantai;1;2;3;8;16;24
294;05.12.2016;2016;12;11;Maanantai;3;3;6;10;17;27
294;05.12.2016;2016;12;12;Maanantai;5;6;11;19;26;45
294;05.12.2016;2016;12;13;Maanantai;4;4;8;10;7;17
294;05.12.2016;2016;12;14;Maanantai;5;5;10;16;10;26
294;05.12.2016;2016;12;15;Maanantai;4;5;9;10;9;19
294;05.12.2016;2016;12;16;Maanantai;3;2;5;15;7;22
294;05.12.2016;2016;12;17;Maanantai;1;4;5;9;10;19
294;05.12.2016;2016;12;18;Maanantai;5;2;7;7;4;11
294;05.12.2016;2016;12;19;Maanantai;4;4;8;6;4;10
294;05.12.2016;2016;12;20;Maanantai;6;4;10;6;1;7
294;05.12.2016;2016;12;21;Maanantai;3;0;3;0;1;1
294;05.12.2016;2016;12;22;Maanantai;0;2;2;0;0;0
294;05.12.2016;2016;12;23;Maanantai;1;0;1;0;0;0
294;06.12.2016;2016;12;00;Tiistai;0;0;0;0;0;0
294;06.12.2016;2016;12;01;Tiistai;1;0;1;0;0;0
294;06.12.2016;2016;12;02;Tiistai;0;0;0;0;0;0
294;06.12.2016;2016;12;03;Tiistai;0;0;0;0;0;0
294;06.12.2016;2016;12;04;Tiistai;0;0;0;0;0;0
294;06.12.2016;2016;12;05;Tiistai;0;0;0;2;0;2
294;06.12.2016;2016;12;06;Tiistai;0;0;0;0;1;1
294;06.12.2016;2016;12;07;Tiistai;1;1;2;0;0;0
294;06.12.2016;2016;12;08;Tiistai;0;0;0;1;2;3
294;06.12.2016;2016;12;09;Tiistai;1;1;2;1;1;2
294;06.12.2016;2016;12;10;Tiistai;1;1;2;2;3;5
294;06.12.2016;2016;12;11;Tiistai;0;1;1;3;3;6
294;06.12.2016;2016;12;12;Tiistai;0;1;1;4;4;8
294;06.12.2016;2016;12;13;Tiistai;2;3;5;5;7;12
294;06.12.2016;2016;12;14;Tiistai;2;2;4;4;4;8
294;06.12.2016;2016;12;15;Tiistai;1;1;2;9;6;15
294;06.12.2016;2016;12;16;Tiistai;4;0;4;9;9;18
294;06.12.2016;2016;12;17;Tiistai;3;3;6;7;2;9
294;06.12.2016;2016;12;18;Tiistai;4;1;5;3;4;7
294;06.12.2016;2016;12;19;Tiistai;1;0;1;2;2;4
294;06.12.2016;2016;12;20;Tiistai;0;0;0;2;3;5
294;06.12.2016;2016;12;21;Tiistai;0;0;0;1;1;2
294;06.12.2016;2016;12;22;Tiistai;0;0;0;0;0;0
294;06.12.2016;2016;12;23;Tiistai;0;0;0;1;0;1
294;07.12.2016;2016;12;00;Keskiviikko;0;0;0;0;0;0
294;07.12.2016;2016;12;01;Keskiviikko;0;0;0;0;0;0
294;07.12.2016;2016;12;02;Keskiviikko;0;0;0;0;0;0
294;07.12.2016;2016;12;03;Keskiviikko;1;1;2;0;0;0
294;07.12.2016;2016;12;04;Keskiviikko;0;0;0;0;0;0
294;07.12.2016;2016;12;05;Keskiviikko;0;0;0;0;0;0
294;07.12.2016;2016;12;06;Keskiviikko;1;1;2;0;2;2
294;07.12.2016;2016;12;07;Keskiviikko;7;5;12;14;3;17
294;07.12.2016;2016;12;08;Keskiviikko;9;2;11;9;6;15
294;07.12.2016;2016;12;09;Keskiviikko;5;3;8;24;17;41
294;07.12.2016;2016;12;10;Keskiviikko;5;7;12;12;15;27
294;07.12.2016;2016;12;11;Keskiviikko;6;5;11;18;21;39
294;07.12.2016;2016;12;12;Keskiviikko;3;4;7;21;21;42
294;07.12.2016;2016;12;13;Keskiviikko;16;14;30;28;31;59
294;07.12.2016;2016;12;14;Keskiviikko;15;18;33;18;20;38
294;07.12.2016;2016;12;15;Keskiviikko;9;12;21;15;20;35
294;07.12.2016;2016;12;16;Keskiviikko;5;10;15;11;14;25
294;07.12.2016;2016;12;17;Keskiviikko;4;2;6;8;12;20
294;07.12.2016;2016;12;18;Keskiviikko;2;2;4;13;13;26
294;07.12.2016;2016;12;19;Keskiviikko;2;0;2;13;10;23
294;07.12.2016;2016;12;20;Keskiviikko;1;0;1;5;6;11
294;07.12.2016;2016;12;21;Keskiviikko;1;0;1;4;1;5
294;07.12.2016;2016;12;22;Keskiviikko;1;1;2;0;0;0
294;07.12.2016;2016;12;23;Keskiviikko;0;0;0;0;0;0
294;08.12.2016;2016;12;00;Torstai;0;0;0;0;0;0
294;08.12.2016;2016;12;01;Torstai;0;0;0;0;0;0
294;08.12.2016;2016;12;02;Torstai;0;0;0;0;0;0
294;08.12.2016;2016;12;03;Torstai;0;0;0;0;0;0
294;08.12.2016;2016;12;04;Torstai;0;0;0;0;0;0
294;08.12.2016;2016;12;05;Torstai;0;0;0;2;0;2
294;08.12.2016;2016;12;06;Torstai;3;4;7;1;3;4
294;08.12.2016;2016;12;07;Torstai;6;0;6;7;6;13
294;08.12.2016;2016;12;08;Torstai;10;1;11;9;4;13
294;08.12.2016;2016;12;09;Torstai;7;4;11;15;11;26
294;08.12.2016;2016;12;10;Torstai;3;4;7;11;10;21
294;08.12.2016;2016;12;11;Torstai;3;4;7;12;21;33
294;08.12.2016;2016;12;12;Torstai;1;4;5;13;16;29
294;08.12.2016;2016;12;13;Torstai;10;22;32;29;17;46
294;08.12.2016;2016;12;14;Torstai;16;14;30;17;14;31
294;08.12.2016;2016;12;15;Torstai;4;10;14;10;14;24
294;08.12.2016;2016;12;16;Torstai;2;7;9;10;21;31
294;08.12.2016;2016;12;17;Torstai;8;2;10;11;12;23
294;08.12.2016;2016;12;18;Torstai;13;5;18;10;11;21
294;08.12.2016;2016;12;19;Torstai;2;1;3;20;13;33
294;08.12.2016;2016;12;20;Torstai;0;6;6;6;3;9
294;08.12.2016;2016;12;21;Torstai;2;0;2;0;1;1
294;08.12.2016;2016;12;22;Torstai;0;0;0;0;1;1
294;08.12.2016;2016;12;23;Torstai;0;0;0;0;0;0
294;09.12.2016;2016;12;00;Perjantai;0;0;0;0;1;1
294;09.12.2016;2016;12;01;Perjantai;0;0;0;0;0;0
294;09.12.2016;2016;12;02;Perjantai;0;0;0;0;0;0
294;09.12.2016;2016;12;03;Perjantai;0;0;0;0;0;0
294;09.12.2016;2016;12;04;Perjantai;0;0;0;1;0;1
294;09.12.2016;2016;12;05;Perjantai;0;0;0;2;0;2
294;09.12.2016;2016;12;06;Perjantai;1;2;3;6;6;12
294;09.12.2016;2016;12;07;Perjantai;13;1;14;9;7;16
294;09.12.2016;2016;12;08;Perjantai;10;2;12;10;6;16
294;09.12.2016;2016;12;09;Perjantai;17;8;25;27;10;37
294;09.12.2016;2016;12;10;Perjantai;5;2;7;10;23;33
294;09.12.2016;2016;12;11;Perjantai;10;3;13;21;20;41
294;09.12.2016;2016;12;12;Perjantai;7;20;27;16;18;34
294;09.12.2016;2016;12;13;Perjantai;11;11;22;13;28;41
294;09.12.2016;2016;12;14;Perjantai;7;13;20;15;22;37
294;09.12.2016;2016;12;15;Perjantai;4;10;14;16;15;31
294;09.12.2016;2016;12;16;Perjantai;4;9;13;8;10;18
294;09.12.2016;2016;12;17;Perjantai;1;7;8;5;5;10
294;09.12.2016;2016;12;18;Perjantai;7;5;12;4;5;9
294;09.12.2016;2016;12;19;Perjantai;2;2;4;5;5;10
294;09.12.2016;2016;12;20;Perjantai;7;4;11;6;3;9
294;09.12.2016;2016;12;21;Perjantai;5;1;6;1;0;1
294;09.12.2016;2016;12;22;Perjantai;0;0;0;2;0;2
294;09.12.2016;2016;12;23;Perjantai;0;0;0;0;0;0
294;10.12.2016;2016;12;00;Lauantai;0;0;0;0;0;0
294;10.12.2016;2016;12;01;Lauantai;0;0;0;0;0;0
294;10.12.2016;2016;12;02;Lauantai;0;0;0;0;2;2
294;10.12.2016;2016;12;03;Lauantai;0;0;0;0;0;0
294;10.12.2016;2016;12;04;Lauantai;0;0;0;0;0;0
294;10.12.2016;2016;12;05;Lauantai;0;0;0;1;1;2
294;10.12.2016;2016;12;06;Lauantai;0;0;0;1;1;2
294;10.12.2016;2016;12;07;Lauantai;0;0;0;1;2;3
294;10.12.2016;2016;12;08;Lauantai;1;1;2;9;7;16
294;10.12.2016;2016;12;09;Lauantai;0;0;0;3;5;8
294;10.12.2016;2016;12;10;Lauantai;4;0;4;13;9;22
294;10.12.2016;2016;12;11;Lauantai;1;1;2;16;19;35
294;10.12.2016;2016;12;12;Lauantai;2;6;8;18;13;31
294;10.12.2016;2016;12;13;Lauantai;3;0;3;16;11;27
294;10.12.2016;2016;12;14;Lauantai;2;4;6;10;15;25
294;10.12.2016;2016;12;15;Lauantai;4;8;12;9;12;21
294;10.12.2016;2016;12;16;Lauantai;2;1;3;5;6;11
294;10.12.2016;2016;12;17;Lauantai;1;6;7;6;2;8
294;10.12.2016;2016;12;18;Lauantai;2;2;4;9;7;16
294;10.12.2016;2016;12;19;Lauantai;0;0;0;8;8;16
294;10.12.2016;2016;12;20;Lauantai;2;0;2;4;4;8
294;10.12.2016;2016;12;21;Lauantai;0;0;0;2;0;2
294;10.12.2016;2016;12;22;Lauantai;0;0;0;0;0;0
294;10.12.2016;2016;12;23;Lauantai;0;1;1;0;0;0
294;11.12.2016;2016;12;00;Sunnuntai;0;0;0;0;1;1
294;11.12.2016;2016;12;01;Sunnuntai;0;0;0;0;0;0
294;11.12.2016;2016;12;02;Sunnuntai;0;0;0;0;0;0
294;11.12.2016;2016;12;03;Sunnuntai;0;0;0;0;0;0
294;11.12.2016;2016;12;04;Sunnuntai;0;0;0;0;0;0
294;11.12.2016;2016;12;05;Sunnuntai;0;0;0;0;0;0
294;11.12.2016;2016;12;06;Sunnuntai;0;0;0;2;2;4
294;11.12.2016;2016;12;07;Sunnuntai;0;0;0;1;1;2
294;11.12.2016;2016;12;08;Sunnuntai;0;0;0;3;1;4
294;11.12.2016;2016;12;09;Sunnuntai;0;0;0;2;2;4
294;11.12.2016;2016;12;10;Sunnuntai;0;1;1;4;4;8
294;11.12.2016;2016;12;11;Sunnuntai;1;2;3;6;4;10
294;11.12.2016;2016;12;12;Sunnuntai;7;2;9;3;7;10
294;11.12.2016;2016;12;13;Sunnuntai;0;5;5;7;1;8
294;11.12.2016;2016;12;14;Sunnuntai;1;0;1;8;2;10
294;11.12.2016;2016;12;15;Sunnuntai;1;1;2;4;8;12
294;11.12.2016;2016;12;16;Sunnuntai;3;1;4;0;1;1
294;11.12.2016;2016;12;17;Sunnuntai;2;1;3;1;3;4
294;11.12.2016;2016;12;18;Sunnuntai;2;0;2;8;3;11
294;11.12.2016;2016;12;19;Sunnuntai;1;1;2;4;2;6
294;11.12.2016;2016;12;20;Sunnuntai;0;2;2;2;2;4
294;11.12.2016;2016;12;21;Sunnuntai;1;0;1;2;0;2
294;11.12.2016;2016;12;22;Sunnuntai;0;0;0;0;0;0
294;11.12.2016;2016;12;23;Sunnuntai;0;0;0;0;0;0
294;12.12.2016;2016;12;00;Maanantai;0;0;0;0;0;0
294;12.12.2016;2016;12;01;Maanantai;0;0;0;0;0;0
294;12.12.2016;2016;12;02;Maanantai;0;0;0;0;0;0
294;12.12.2016;2016;12;03;Maanantai;0;0;0;0;0;0
294;12.12.2016;2016;12;04;Maanantai;0;0;0;0;0;0
294;12.12.2016;2016;12;05;Maanantai;0;0;0;2;0;2
294;12.12.2016;2016;12;06;Maanantai;2;1;3;2;1;3
294;12.12.2016;2016;12;07;Maanantai;15;2;17;15;6;21
294;12.12.2016;2016;12;08;Maanantai;5;1;6;14;5;19
294;12.12.2016;2016;12;09;Maanantai;9;6;15;15;10;25
294;12.12.2016;2016;12;10;Maanantai;4;7;11;10;14;24
294;12.12.2016;2016;12;11;Maanantai;3;6;9;18;18;36
294;12.12.2016;2016;12;12;Maanantai;4;4;8;16;12;28
294;12.12.2016;2016;12;13;Maanantai;3;8;11;15;9;24
294;12.12.2016;2016;12;14;Maanantai;2;10;12;12;11;23
294;12.12.2016;2016;12;15;Maanantai;8;8;16;9;14;23
294;12.12.2016;2016;12;16;Maanantai;5;3;8;14;11;25
294;12.12.2016;2016;12;17;Maanantai;0;1;1;4;5;9
294;12.12.2016;2016;12;18;Maanantai;0;1;1;5;7;12
294;12.12.2016;2016;12;19;Maanantai;1;2;3;10;9;19
294;12.12.2016;2016;12;20;Maanantai;0;1;1;2;2;4
294;12.12.2016;2016;12;21;Maanantai;0;0;0;0;1;1
294;12.12.2016;2016;12;22;Maanantai;0;0;0;0;0;0
294;12.12.2016;2016;12;23;Maanantai;0;0;0;0;0;0
294;13.12.2016;2016;12;00;Tiistai;0;0;0;0;0;0
294;13.12.2016;2016;12;01;Tiistai;0;0;0;0;0;0
294;13.12.2016;2016;12;02;Tiistai;0;0;0;0;0;0
294;13.12.2016;2016;12;03;Tiistai;0;0;0;0;0;0
294;13.12.2016;2016;12;04;Tiistai;0;0;0;0;0;0
294;13.12.2016;2016;12;05;Tiistai;1;0;1;3;0;3
294;13.12.2016;2016;12;06;Tiistai;1;0;1;5;2;7
294;13.12.2016;2016;12;07;Tiistai;15;1;16;12;3;15
294;13.12.2016;2016;12;08;Tiistai;11;5;16;18;9;27
294;13.12.2016;2016;12;09;Tiistai;11;5;16;17;7;24
294;13.12.2016;2016;12;10;Tiistai;5;4;9;15;13;28
294;13.12.2016;2016;12;11;Tiistai;2;5;7;18;24;42
294;13.12.2016;2016;12;12;Tiistai;5;2;7;22;11;33
294;13.12.2016;2016;12;13;Tiistai;5;4;9;11;15;26
294;13.12.2016;2016;12;14;Tiistai;7;9;16;12;10;22
294;13.12.2016;2016;12;15;Tiistai;6;20;26;14;26;40
294;13.12.2016;2016;12;16;Tiistai;9;8;17;12;21;33
294;13.12.2016;2016;12;17;Tiistai;5;7;12;10;22;32
294;13.12.2016;2016;12;18;Tiistai;3;4;7;14;17;31
294;13.12.2016;2016;12;19;Tiistai;2;2;4;13;15;28
294;13.12.2016;2016;12;20;Tiistai;1;1;2;6;4;10
294;13.12.2016;2016;12;21;Tiistai;0;1;1;3;0;3
294;13.12.2016;2016;12;22;Tiistai;0;0;0;1;0;1
294;13.12.2016;2016;12;23;Tiistai;0;0;0;0;0;0
294;14.12.2016;2016;12;00;Keskiviikko;0;0;0;0;0;0
294;14.12.2016;2016;12;01;Keskiviikko;0;0;0;0;0;0
294;14.12.2016;2016;12;02;Keskiviikko;0;0;0;0;0;0
294;14.12.2016;2016;12;03;Keskiviikko;0;0;0;0;0;0
294;14.12.2016;2016;12;04;Keskiviikko;0;0;0;0;0;0
294;14.12.2016;2016;12;05;Keskiviikko;0;0;0;2;0;2
294;14.12.2016;2016;12;06;Keskiviikko;0;1;1;6;4;10
294;14.12.2016;2016;12;07;Keskiviikko;13;2;15;13;3;16
294;14.12.2016;2016;12;08;Keskiviikko;13;4;17;12;7;19
294;14.12.2016;2016;12;09;Keskiviikko;10;7;17;15;17;32
294;14.12.2016;2016;12;10;Keskiviikko;8;5;13;16;14;30
294;14.12.2016;2016;12;11;Keskiviikko;5;3;8;14;17;31
294;14.12.2016;2016;12;12;Keskiviikko;2;3;5;7;16;23
294;14.12.2016;2016;12;13;Keskiviikko;3;10;13;22;11;33
294;14.12.2016;2016;12;14;Keskiviikko;8;13;21;16;28;44
294;14.12.2016;2016;12;15;Keskiviikko;10;8;18;12;20;32
294;14.12.2016;2016;12;16;Keskiviikko;8;10;18;15;20;35
294;14.12.2016;2016;12;17;Keskiviikko;7;5;12;10;10;20
294;14.12.2016;2016;12;18;Keskiviikko;4;5;9;9;7;16
294;14.12.2016;2016;12;19;Keskiviikko;6;11;17;6;10;16
294;14.12.2016;2016;12;20;Keskiviikko;1;1;2;5;4;9
294;14.12.2016;2016;12;21;Keskiviikko;1;0;1;2;0;2
294;14.12.2016;2016;12;22;Keskiviikko;0;0;0;1;1;2
294;14.12.2016;2016;12;23;Keskiviikko;0;0;0;0;1;1
294;15.12.2016;2016;12;00;Torstai;0;0;0;0;0;0
294;15.12.2016;2016;12;01;Torstai;0;0;0;0;0;0
294;15.12.2016;2016;12;02;Torstai;0;0;0;0;0;0
294;15.12.2016;2016;12;03;Torstai;0;0;0;0;0;0
294;15.12.2016;2016;12;04;Torstai;0;0;0;0;0;0
294;15.12.2016;2016;12;05;Torstai;0;0;0;1;1;2
294;15.12.2016;2016;12;06;Torstai;4;1;5;4;2;6
294;15.12.2016;2016;12;07;Torstai;9;3;12;10;4;14
294;15.12.2016;2016;12;08;Torstai;8;1;9;12;7;19
294;15.12.2016;2016;12;09;Torstai;11;4;15;15;13;28
294;15.12.2016;2016;12;10;Torstai;1;2;3;8;10;18
294;15.12.2016;2016;12;11;Torstai;4;3;7;21;14;35
294;15.12.2016;2016;12;12;Torstai;7;2;9;19;10;29
294;15.12.2016;2016;12;13;Torstai;5;9;14;19;18;37
294;15.12.2016;2016;12;14;Torstai;10;19;29;17;15;32
294;15.12.2016;2016;12;15;Torstai;7;11;18;15;21;36
294;15.12.2016;2016;12;16;Torstai;8;10;18;15;13;28
294;15.12.2016;2016;12;17;Torstai;5;4;9;8;11;19
294;15.12.2016;2016;12;18;Torstai;2;6;8;19;13;32
294;15.12.2016;2016;12;19;Torstai;6;4;10;4;9;13
294;15.12.2016;2016;12;20;Torstai;2;1;3;2;6;8
294;15.12.2016;2016;12;21;Torstai;0;5;5;0;4;4
294;15.12.2016;2016;12;22;Torstai;0;0;0;1;0;1
294;15.12.2016;2016;12;23;Torstai;0;0;0;1;0;1
294;16.12.2016;2016;12;00;Perjantai;0;0;0;0;0;0
294;16.12.2016;2016;12;01;Perjantai;0;0;0;0;0;0
294;16.12.2016;2016;12;02;Perjantai;0;0;0;0;0;0
294;16.12.2016;2016;12;03;Perjantai;0;0;0;0;0;0
294;16.12.2016;2016;12;04;Perjantai;0;0;0;0;1;1
294;16.12.2016;2016;12;05;Perjantai;1;0;1;2;0;2
294;16.12.2016;2016;12;06;Perjantai;2;2;4;8;2;10
294;16.12.2016;2016;12;07;Perjantai;8;6;14;14;2;16
294;16.12.2016;2016;12;08;Perjantai;16;0;16;15;4;19
294;16.12.2016;2016;12;09;Perjantai;9;3;12;16;6;22
294;16.12.2016;2016;12;10;Perjantai;5;6;11;15;12;27
294;16.12.2016;2016;12;11;Perjantai;7;1;8;17;10;27
294;16.12.2016;2016;12;12;Perjantai;12;13;25;21;22;43
294;16.12.2016;2016;12;13;Perjantai;17;19;36;21;16;37
294;16.12.2016;2016;12;14;Perjantai;6;22;28;15;26;41
294;16.12.2016;2016;12;15;Perjantai;5;6;11;10;9;19
294;16.12.2016;2016;12;16;Perjantai;3;5;8;9;17;26
294;16.12.2016;2016;12;17;Perjantai;6;4;10;10;6;16
294;16.12.2016;2016;12;18;Perjantai;5;4;9;14;5;19
294;16.12.2016;2016;12;19;Perjantai;6;5;11;4;3;7
294;16.12.2016;2016;12;20;Perjantai;6;3;9;14;6;20
294;16.12.2016;2016;12;21;Perjantai;4;3;7;3;0;3
294;16.12.2016;2016;12;22;Perjantai;4;1;5;2;6;8
294;16.12.2016;2016;12;23;Perjantai;0;0;0;0;1;1
294;17.12.2016;2016;12;00;Lauantai;0;0;0;0;0;0
294;17.12.2016;2016;12;01;Lauantai;0;0;0;0;0;0
294;17.12.2016;2016;12;02;Lauantai;0;0;0;0;0;0
294;17.12.2016;2016;12;03;Lauantai;0;0;0;0;0;0
294;17.12.2016;2016;12;04;Lauantai;0;0;0;0;0;0
294;17.12.2016;2016;12;05;Lauantai;0;0;0;0;1;1
294;17.12.2016;2016;12;06;Lauantai;0;0;0;2;2;4
294;17.12.2016;2016;12;07;Lauantai;0;0;0;0;0;0
294;17.12.2016;2016;12;08;Lauantai;1;0;1;5;1;6
294;17.12.2016;2016;12;09;Lauantai;3;3;6;10;6;16
294;17.12.2016;2016;12;10;Lauantai;3;1;4;12;8;20
294;17.12.2016;2016;12;11;Lauantai;4;4;8;12;9;21
294;17.12.2016;2016;12;12;Lauantai;6;6;12;12;10;22
294;17.12.2016;2016;12;13;Lauantai;9;7;16;13;10;23
294;17.12.2016;2016;12;14;Lauantai;4;2;6;11;20;31
294;17.12.2016;2016;12;15;Lauantai;8;0;8;12;7;19
294;17.12.2016;2016;12;16;Lauantai;3;1;4;14;6;20
294;17.12.2016;2016;12;17;Lauantai;4;3;7;7;8;15
294;17.12.2016;2016;12;18;Lauantai;5;8;13;11;8;19
294;17.12.2016;2016;12;19;Lauantai;6;8;14;11;5;16
294;17.12.2016;2016;12;20;Lauantai;6;4;10;2;2;4
294;17.12.2016;2016;12;21;Lauantai;2;0;2;5;1;6
294;17.12.2016;2016;12;22;Lauantai;0;3;3;3;0;3
294;17.12.2016;2016;12;23;Lauantai;1;0;1;1;0;1
294;18.12.2016;2016;12;00;Sunnuntai;0;0;0;0;0;0
294;18.12.2016;2016;12;01;Sunnuntai;0;0;0;0;1;1
294;18.12.2016;2016;12;02;Sunnuntai;0;0;0;0;0;0
294;18.12.2016;2016;12;03;Sunnuntai;0;0;0;0;0;0
294;18.12.2016;2016;12;04;Sunnuntai;0;0;0;1;0;1
294;18.12.2016;2016;12;05;Sunnuntai;0;0;0;1;0;1
294;18.12.2016;2016;12;06;Sunnuntai;0;0;0;2;0;2
294;18.12.2016;2016;12;07;Sunnuntai;0;0;0;1;2;3
294;18.12.2016;2016;12;08;Sunnuntai;1;0;1;4;3;7
294;18.12.2016;2016;12;09;Sunnuntai;0;2;2;11;5;16
294;18.12.2016;2016;12;10;Sunnuntai;1;0;1;18;7;25
294;18.12.2016;2016;12;11;Sunnuntai;2;1;3;11;15;26
294;18.12.2016;2016;12;12;Sunnuntai;4;3;7;15;5;20
294;18.12.2016;2016;12;13;Sunnuntai;3;2;5;9;6;15
294;18.12.2016;2016;12;14;Sunnuntai;2;6;8;6;5;11
294;18.12.2016;2016;12;15;Sunnuntai;0;4;4;15;5;20
294;18.12.2016;2016;12;16;Sunnuntai;7;3;10;6;7;13
294;18.12.2016;2016;12;17;Sunnuntai;4;1;5;8;8;16
294;18.12.2016;2016;12;18;Sunnuntai;7;4;11;16;6;22
294;18.12.2016;2016;12;19;Sunnuntai;3;1;4;5;6;11
294;18.12.2016;2016;12;20;Sunnuntai;1;7;8;5;6;11
294;18.12.2016;2016;12;21;Sunnuntai;1;1;2;1;1;2
294;18.12.2016;2016;12;22;Sunnuntai;0;0;0;0;0;0
294;18.12.2016;2016;12;23;Sunnuntai;0;0;0;0;0;0
294;19.12.2016;2016;12;00;Maanantai;0;0;0;0;0;0
294;19.12.2016;2016;12;01;Maanantai;0;0;0;0;0;0
294;19.12.2016;2016;12;02;Maanantai;0;0;0;0;0;0
294;19.12.2016;2016;12;03;Maanantai;0;0;0;0;0;0
294;19.12.2016;2016;12;04;Maanantai;0;0;0;0;1;1
294;19.12.2016;2016;12;05;Maanantai;0;0;0;2;0;2
294;19.12.2016;2016;12;06;Maanantai;1;0;1;4;2;6
294;19.12.2016;2016;12;07;Maanantai;23;4;27;11;3;14
294;19.12.2016;2016;12;08;Maanantai;15;4;19;11;5;16
294;19.12.2016;2016;12;09;Maanantai;14;13;27;24;6;30
294;19.12.2016;2016;12;10;Maanantai;3;3;6;10;9;19
294;19.12.2016;2016;12;11;Maanantai;5;4;9;14;11;25
294;19.12.2016;2016;12;12;Maanantai;4;7;11;14;11;25
294;19.12.2016;2016;12;13;Maanantai;8;26;34;13;16;29
294;19.12.2016;2016;12;14;Maanantai;8;3;11;21;7;28
294;19.12.2016;2016;12;15;Maanantai;8;13;21;20;8;28
294;19.12.2016;2016;12;16;Maanantai;8;9;17;20;18;38
294;19.12.2016;2016;12;17;Maanantai;10;12;22;14;10;24
294;19.12.2016;2016;12;18;Maanantai;4;7;11;15;9;24
294;19.12.2016;2016;12;19;Maanantai;4;2;6;12;6;18
294;19.12.2016;2016;12;20;Maanantai;2;0;2;6;2;8
294;19.12.2016;2016;12;21;Maanantai;1;0;1;2;1;3
294;19.12.2016;2016;12;22;Maanantai;0;0;0;1;1;2
294;19.12.2016;2016;12;23;Maanantai;0;0;0;1;0;1
294;20.12.2016;2016;12;00;Tiistai;0;0;0;0;0;0
294;20.12.2016;2016;12;01;Tiistai;0;0;0;0;0;0
294;20.12.2016;2016;12;02;Tiistai;0;0;0;0;0;0
294;20.12.2016;2016;12;03;Tiistai;0;0;0;0;0;0
294;20.12.2016;2016;12;04;Tiistai;1;0;1;0;1;1
294;20.12.2016;2016;12;05;Tiistai;0;0;0;2;0;2
294;20.12.2016;2016;12;06;Tiistai;1;2;3;2;0;2
294;20.12.2016;2016;12;07;Tiistai;17;2;19;12;3;15
294;20.12.2016;2016;12;08;Tiistai;7;6;13;11;3;14
294;20.12.2016;2016;12;09;Tiistai;14;3;17;12;9;21
294;20.12.2016;2016;12;10;Tiistai;1;2;3;13;9;22
294;20.12.2016;2016;12;11;Tiistai;1;7;8;12;19;31
294;20.12.2016;2016;12;12;Tiistai;3;3;6;12;12;24
294;20.12.2016;2016;12;13;Tiistai;5;5;10;8;14;22
294;20.12.2016;2016;12;14;Tiistai;8;9;17;15;7;22
294;20.12.2016;2016;12;15;Tiistai;3;15;18;13;30;43
294;20.12.2016;2016;12;16;Tiistai;6;2;8;17;20;37
294;20.12.2016;2016;12;17;Tiistai;7;8;15;15;17;32
294;20.12.2016;2016;12;18;Tiistai;2;4;6;11;11;22
294;20.12.2016;2016;12;19;Tiistai;2;0;2;15;9;24
294;20.12.2016;2016;12;20;Tiistai;0;0;0;3;1;4
294;20.12.2016;2016;12;21;Tiistai;0;0;0;0;0;0
294;20.12.2016;2016;12;22;Tiistai;0;0;0;0;0;0
294;20.12.2016;2016;12;23;Tiistai;0;0;0;0;0;0
294;21.12.2016;2016;12;00;Keskiviikko;0;0;0;0;0;0
294;21.12.2016;2016;12;01;Keskiviikko;0;0;0;0;0;0
294;21.12.2016;2016;12;02;Keskiviikko;0;0;0;0;0;0
294;21.12.2016;2016;12;03;Keskiviikko;0;0;0;0;0;0
294;21.12.2016;2016;12;04;Keskiviikko;0;0;0;0;0;0
294;21.12.2016;2016;12;05;Keskiviikko;1;0;1;2;0;2
294;21.12.2016;2016;12;06;Keskiviikko;0;0;0;0;0;0
294;21.12.2016;2016;12;07;Keskiviikko;0;2;2;4;4;8
294;21.12.2016;2016;12;08;Keskiviikko;12;2;14;17;7;24
294;21.12.2016;2016;12;09;Keskiviikko;8;5;13;18;7;25
294;21.12.2016;2016;12;10;Keskiviikko;5;6;11;10;11;21
294;21.12.2016;2016;12;11;Keskiviikko;7;3;10;12;8;20
294;21.12.2016;2016;12;12;Keskiviikko;3;13;16;12;21;33
294;21.12.2016;2016;12;13;Keskiviikko;8;9;17;13;13;26
294;21.12.2016;2016;12;14;Keskiviikko;11;11;22;20;14;34
294;21.12.2016;2016;12;15;Keskiviikko;3;5;8;11;14;25
294;21.12.2016;2016;12;16;Keskiviikko;7;0;7;8;12;20
294;21.12.2016;2016;12;17;Keskiviikko;0;2;2;5;11;16
294;21.12.2016;2016;12;18;Keskiviikko;3;7;10;14;12;26
294;21.12.2016;2016;12;19;Keskiviikko;4;3;7;6;8;14
294;21.12.2016;2016;12;20;Keskiviikko;1;1;2;5;3;8
294;21.12.2016;2016;12;21;Keskiviikko;2;0;2;6;3;9
294;21.12.2016;2016;12;22;Keskiviikko;0;0;0;0;0;0
294;21.12.2016;2016;12;23;Keskiviikko;0;0;0;0;0;0
294;22.12.2016;2016;12;00;Torstai;0;0;0;1;0;1
294;22.12.2016;2016;12;01;Torstai;0;0;0;0;0;0
294;22.12.2016;2016;12;02;Torstai;0;0;0;0;1;1
294;22.12.2016;2016;12;03;Torstai;0;0;0;0;2;2
294;22.12.2016;2016;12;04;Torstai;0;0;0;0;0;0
294;22.12.2016;2016;12;05;Torstai;0;0;0;0;0;0
294;22.12.2016;2016;12;06;Torstai;0;1;1;1;3;4
294;22.12.2016;2016;12;07;Torstai;0;1;1;4;2;6
294;22.12.2016;2016;12;08;Torstai;0;1;1;8;5;13
294;22.12.2016;2016;12;09;Torstai;1;0;1;5;7;12
294;22.12.2016;2016;12;10;Torstai;0;0;0;10;9;19
294;22.12.2016;2016;12;11;Torstai;1;1;2;7;14;21
294;22.12.2016;2016;12;12;Torstai;16;7;23;28;12;40
294;22.12.2016;2016;12;13;Torstai;1;7;8;13;16;29
294;22.12.2016;2016;12;14;Torstai;3;2;5;12;12;24
294;22.12.2016;2016;12;15;Torstai;4;5;9;16;18;34
294;22.12.2016;2016;12;16;Torstai;4;2;6;12;17;29
294;22.12.2016;2016;12;17;Torstai;2;0;2;5;4;9
294;22.12.2016;2016;12;18;Torstai;3;3;6;7;6;13
294;22.12.2016;2016;12;19;Torstai;8;4;12;9;1;10
294;22.12.2016;2016;12;20;Torstai;2;0;2;4;3;7
294;22.12.2016;2016;12;21;Torstai;0;1;1;6;1;7
294;22.12.2016;2016;12;22;Torstai;5;5;10;4;4;8
294;22.12.2016;2016;12;23;Torstai;1;0;1;1;1;2
294;23.12.2016;2016;12;00;Perjantai;0;0;0;0;0;0
294;23.12.2016;2016;12;01;Perjantai;0;0;0;0;0;0
294;23.12.2016;2016;12;02;Perjantai;0;0;0;0;0;0
294;23.12.2016;2016;12;03;Perjantai;0;1;1;0;0;0
294;23.12.2016;2016;12;04;Perjantai;1;0;1;0;0;0
294;23.12.2016;2016;12;05;Perjantai;0;0;0;2;2;4
294;23.12.2016;2016;12;06;Perjantai;1;0;1;1;1;2
294;23.12.2016;2016;12;07;Perjantai;1;0;1;4;1;5
294;23.12.2016;2016;12;08;Perjantai;2;2;4;7;8;15
294;23.12.2016;2016;12;09;Perjantai;2;1;3;11;9;20
294;23.12.2016;2016;12;10;Perjantai;1;2;3;15;11;26
294;23.12.2016;2016;12;11;Perjantai;8;6;14;8;14;22
294;23.12.2016;2016;12;12;Perjantai;3;3;6;7;6;13
294;23.12.2016;2016;12;13;Perjantai;1;1;2;14;8;22
294;23.12.2016;2016;12;14;Perjantai;5;0;5;7;25;32
294;23.12.2016;2016;12;15;Perjantai;1;4;5;11;12;23
294;23.12.2016;2016;12;16;Perjantai;11;8;19;8;7;15
294;23.12.2016;2016;12;17;Perjantai;4;3;7;15;12;27
294;23.12.2016;2016;12;18;Perjantai;2;0;2;8;6;14
294;23.12.2016;2016;12;19;Perjantai;4;0;4;15;12;27
294;23.12.2016;2016;12;20;Perjantai;0;0;0;3;1;4
294;23.12.2016;2016;12;21;Perjantai;1;0;1;1;7;8
294;23.12.2016;2016;12;22;Perjantai;0;0;0;2;2;4
294;23.12.2016;2016;12;23;Perjantai;0;0;0;0;0;0
294;24.12.2016;2016;12;00;Lauantai;0;0;0;0;0;0
294;24.12.2016;2016;12;01;Lauantai;0;0;0;0;0;0
294;24.12.2016;2016;12;02;Lauantai;0;0;0;0;0;0
294;24.12.2016;2016;12;03;Lauantai;0;0;0;0;0;0
294;24.12.2016;2016;12;04;Lauantai;0;0;0;0;0;0
294;24.12.2016;2016;12;05;Lauantai;0;0;0;2;0;2
294;24.12.2016;2016;12;06;Lauantai;0;0;0;1;1;2
294;24.12.2016;2016;12;07;Lauantai;0;0;0;3;4;7
294;24.12.2016;2016;12;08;Lauantai;1;0;1;7;4;11
294;24.12.2016;2016;12;09;Lauantai;0;1;1;4;5;9
294;24.12.2016;2016;12;10;Lauantai;2;0;2;9;11;20
294;24.12.2016;2016;12;11;Lauantai;1;3;4;15;11;26
294;24.12.2016;2016;12;12;Lauantai;3;1;4;5;4;9
294;24.12.2016;2016;12;13;Lauantai;0;0;0;2;0;2
294;24.12.2016;2016;12;14;Lauantai;0;0;0;5;0;5
294;24.12.2016;2016;12;15;Lauantai;0;0;0;2;2;4
294;24.12.2016;2016;12;16;Lauantai;0;1;1;1;1;2
294;24.12.2016;2016;12;17;Lauantai;0;0;0;0;5;5
294;24.12.2016;2016;12;18;Lauantai;0;0;0;0;3;3
294;24.12.2016;2016;12;19;Lauantai;0;0;0;4;2;6
294;24.12.2016;2016;12;20;Lauantai;0;0;0;2;3;5
294;24.12.2016;2016;12;21;Lauantai;1;0;1;0;0;0
294;24.12.2016;2016;12;22;Lauantai;0;0;0;2;0;2
294;24.12.2016;2016;12;23;Lauantai;0;0;0;0;1;1
294;25.12.2016;2016;12;00;Sunnuntai;0;0;0;0;0;0
294;25.12.2016;2016;12;01;Sunnuntai;0;0;0;0;0;0
294;25.12.2016;2016;12;02;Sunnuntai;0;0;0;0;0;0
294;25.12.2016;2016;12;03;Sunnuntai;0;0;0;0;0;0
294;25.12.2016;2016;12;04;Sunnuntai;0;0;0;0;0;0
294;25.12.2016;2016;12;05;Sunnuntai;0;0;0;0;0;0
294;25.12.2016;2016;12;06;Sunnuntai;0;0;0;0;0;0
294;25.12.2016;2016;12;07;Sunnuntai;0;0;0;0;0;0
294;25.12.2016;2016;12;08;Sunnuntai;1;0;1;0;0;0
294;25.12.2016;2016;12;09;Sunnuntai;0;0;0;0;0;0
294;25.12.2016;2016;12;10;Sunnuntai;1;0;1;0;0;0
294;25.12.2016;2016;12;11;Sunnuntai;3;0;3;5;2;7
294;25.12.2016;2016;12;12;Sunnuntai;7;5;12;8;3;11
294;25.12.2016;2016;12;13;Sunnuntai;3;4;7;8;2;10
294;25.12.2016;2016;12;14;Sunnuntai;3;1;4;2;2;4
294;25.12.2016;2016;12;15;Sunnuntai;3;3;6;3;3;6
294;25.12.2016;2016;12;16;Sunnuntai;0;1;1;4;0;4
294;25.12.2016;2016;12;17;Sunnuntai;2;2;4;4;1;5
294;25.12.2016;2016;12;18;Sunnuntai;3;2;5;0;3;3
294;25.12.2016;2016;12;19;Sunnuntai;4;6;10;3;1;4
294;25.12.2016;2016;12;20;Sunnuntai;2;1;3;1;4;5
294;25.12.2016;2016;12;21;Sunnuntai;0;0;0;0;0;0
294;25.12.2016;2016;12;22;Sunnuntai;1;1;2;0;0;0
294;25.12.2016;2016;12;23;Sunnuntai;0;0;0;0;0;0
294;26.12.2016;2016;12;00;Maanantai;0;0;0;0;0;0
294;26.12.2016;2016;12;01;Maanantai;0;0;0;1;1;2
294;26.12.2016;2016;12;02;Maanantai;0;0;0;0;0;0
294;26.12.2016;2016;12;03;Maanantai;0;0;0;1;2;3
294;26.12.2016;2016;12;04;Maanantai;0;0;0;0;0;0
294;26.12.2016;2016;12;05;Maanantai;0;0;0;0;0;0
294;26.12.2016;2016;12;06;Maanantai;1;0;1;1;0;1
294;26.12.2016;2016;12;07;Maanantai;1;0;1;0;0;0
294;26.12.2016;2016;12;08;Maanantai;0;0;0;2;0;2
294;26.12.2016;2016;12;09;Maanantai;0;0;0;4;0;4
294;26.12.2016;2016;12;10;Maanantai;1;0;1;2;0;2
294;26.12.2016;2016;12;11;Maanantai;2;1;3;3;1;4
294;26.12.2016;2016;12;12;Maanantai;2;0;2;10;2;12
294;26.12.2016;2016;12;13;Maanantai;4;3;7;4;3;7
294;26.12.2016;2016;12;14;Maanantai;2;0;2;1;3;4
294;26.12.2016;2016;12;15;Maanantai;3;3;6;8;0;8
294;26.12.2016;2016;12;16;Maanantai;4;1;5;6;0;6
294;26.12.2016;2016;12;17;Maanantai;2;3;5;2;2;4
294;26.12.2016;2016;12;18;Maanantai;2;4;6;7;1;8
294;26.12.2016;2016;12;19;Maanantai;4;2;6;2;2;4
294;26.12.2016;2016;12;20;Maanantai;4;4;8;3;0;3
294;26.12.2016;2016;12;21;Maanantai;1;0;1;0;0;0
294;26.12.2016;2016;12;22;Maanantai;0;0;0;0;0;0
294;26.12.2016;2016;12;23;Maanantai;0;0;0;0;0;0
294;27.12.2016;2016;12;00;Tiistai;0;0;0;0;0;0
294;27.12.2016;2016;12;01;Tiistai;0;0;0;0;0;0
294;27.12.2016;2016;12;02;Tiistai;0;0;0;0;0;0
294;27.12.2016;2016;12;03;Tiistai;0;0;0;0;0;0
294;27.12.2016;2016;12;04;Tiistai;0;0;0;0;0;0
294;27.12.2016;2016;12;05;Tiistai;0;0;0;0;0;0
294;27.12.2016;2016;12;06;Tiistai;1;0;1;1;1;2
294;27.12.2016;2016;12;07;Tiistai;0;0;0;2;2;4
294;27.12.2016;2016;12;08;Tiistai;1;0;1;6;6;12
294;27.12.2016;2016;12;09;Tiistai;2;1;3;6;6;12
294;27.12.2016;2016;12;10;Tiistai;0;0;0;7;7;14
294;27.12.2016;2016;12;11;Tiistai;2;2;4;14;14;28
294;27.12.2016;2016;12;12;Tiistai;4;4;8;16;16;32
294;27.12.2016;2016;12;13;Tiistai;4;3;7;22;22;44
294;27.12.2016;2016;12;14;Tiistai;3;3;6;12;12;24
294;27.12.2016;2016;12;15;Tiistai;3;3;6;8;8;16
294;27.12.2016;2016;12;16;Tiistai;4;4;8;24;24;48
294;27.12.2016;2016;12;17;Tiistai;3;3;6;10;10;20
294;27.12.2016;2016;12;18;Tiistai;2;1;3;16;16;32
294;27.12.2016;2016;12;19;Tiistai;2;1;3;13;13;26
294;27.12.2016;2016;12;20;Tiistai;4;4;8;6;6;12
294;27.12.2016;2016;12;21;Tiistai;2;1;3;3;3;6
294;27.12.2016;2016;12;22;Tiistai;0;0;0;1;1;2
294;27.12.2016;2016;12;23;Tiistai;0;0;0;0;0;0
294;28.12.2016;2016;12;00;Keskiviikko;0;0;0;0;0;0
294;28.12.2016;2016;12;01;Keskiviikko;0;0;0;0;0;0
294;28.12.2016;2016;12;02;Keskiviikko;0;0;0;0;0;0
294;28.12.2016;2016;12;03;Keskiviikko;0;0;0;0;0;0
294;28.12.2016;2016;12;04;Keskiviikko;0;0;0;0;0;0
294;28.12.2016;2016;12;05;Keskiviikko;0;0;0;0;0;0
294;28.12.2016;2016;12;06;Keskiviikko;0;0;0;3;3;6
294;28.12.2016;2016;12;07;Keskiviikko;1;0;1;1;1;2
294;28.12.2016;2016;12;08;Keskiviikko;1;0;1;3;3;6
294;28.12.2016;2016;12;09;Keskiviikko;2;1;3;4;4;8
294;28.12.2016;2016;12;10;Keskiviikko;3;3;6;8;8;16
294;28.12.2016;2016;12;11;Keskiviikko;2;1;3;16;16;32
294;28.12.2016;2016;12;12;Keskiviikko;2;2;4;11;11;22
294;28.12.2016;2016;12;13;Keskiviikko;6;6;12;11;11;22
294;28.12.2016;2016;12;14;Keskiviikko;7;6;13;13;13;26
294;28.12.2016;2016;12;15;Keskiviikko;4;4;8;11;11;22
294;28.12.2016;2016;12;16;Keskiviikko;4;4;8;23;23;46
294;28.12.2016;2016;12;17;Keskiviikko;4;3;7;6;6;12
294;28.12.2016;2016;12;18;Keskiviikko;3;2;5;11;11;22
294;28.12.2016;2016;12;19;Keskiviikko;3;2;5;8;8;16
294;28.12.2016;2016;12;20;Keskiviikko;2;2;4;2;2;4
294;28.12.2016;2016;12;21;Keskiviikko;1;0;1;3;3;6
294;28.12.2016;2016;12;22;Keskiviikko;1;1;2;0;0;0
294;28.12.2016;2016;12;23;Keskiviikko;0;0;0;0;0;0
294;29.12.2016;2016;12;00;Torstai;0;0;0;0;0;0
294;29.12.2016;2016;12;01;Torstai;0;0;0;0;0;0
294;29.12.2016;2016;12;02;Torstai;0;0;0;0;0;0
294;29.12.2016;2016;12;03;Torstai;0;0;0;0;0;0
294;29.12.2016;2016;12;04;Torstai;0;0;0;0;0;0
294;29.12.2016;2016;12;05;Torstai;0;0;0;0;0;0
294;29.12.2016;2016;12;06;Torstai;1;0;1;1;3;4
294;29.12.2016;2016;12;07;Torstai;0;0;0;2;1;3
294;29.12.2016;2016;12;08;Torstai;2;1;3;6;3;9
294;29.12.2016;2016;12;09;Torstai;1;2;3;6;4;10
294;29.12.2016;2016;12;10;Torstai;0;0;0;7;8;15
294;29.12.2016;2016;12;11;Torstai;2;3;5;14;16;30
294;29.12.2016;2016;12;12;Torstai;6;4;10;16;11;27
294;29.12.2016;2016;12;13;Torstai;4;4;8;22;11;33
294;29.12.2016;2016;12;14;Torstai;3;1;4;12;13;25
294;29.12.2016;2016;12;15;Torstai;1;5;6;8;11;19
294;29.12.2016;2016;12;16;Torstai;3;5;8;24;23;47
294;29.12.2016;2016;12;17;Torstai;4;5;9;10;6;16
294;29.12.2016;2016;12;18;Torstai;3;4;7;16;11;27
294;29.12.2016;2016;12;19;Torstai;6;2;8;13;8;21
294;29.12.2016;2016;12;20;Torstai;5;2;7;6;2;8
294;29.12.2016;2016;12;21;Torstai;0;6;6;3;3;6
294;29.12.2016;2016;12;22;Torstai;0;0;0;1;0;1
294;29.12.2016;2016;12;23;Torstai;0;0;0;0;0;0
294;30.12.2016;2016;12;00;Perjantai;0;0;0;0;0;0
294;30.12.2016;2016;12;01;Perjantai;0;0;0;0;0;0
294;30.12.2016;2016;12;02;Perjantai;1;0;1;0;0;0
294;30.12.2016;2016;12;03;Perjantai;0;0;0;0;0;0
294;30.12.2016;2016;12;04;Perjantai;0;0;0;0;0;0
294;30.12.2016;2016;12;05;Perjantai;0;0;0;1;1;2
294;30.12.2016;2016;12;06;Perjantai;0;0;0;3;0;3
294;30.12.2016;2016;12;07;Perjantai;0;0;0;1;0;1
294;30.12.2016;2016;12;08;Perjantai;1;1;2;5;0;5
294;30.12.2016;2016;12;09;Perjantai;0;0;0;7;1;8
294;30.12.2016;2016;12;10;Perjantai;0;1;1;14;3;17
294;30.12.2016;2016;12;11;Perjantai;0;0;0;7;2;9
294;30.12.2016;2016;12;12;Perjantai;2;2;4;2;1;3
294;30.12.2016;2016;12;13;Perjantai;2;2;4;6;6;12
294;30.12.2016;2016;12;14;Perjantai;0;5;5;8;7;15
294;30.12.2016;2016;12;15;Perjantai;4;0;4;8;5;13
294;30.12.2016;2016;12;16;Perjantai;5;1;6;16;7;23
294;30.12.2016;2016;12;17;Perjantai;0;3;3;3;5;8
294;30.12.2016;2016;12;18;Perjantai;1;1;2;16;11;27
294;30.12.2016;2016;12;19;Perjantai;1;0;1;9;5;14
294;30.12.2016;2016;12;20;Perjantai;5;0;5;7;6;13
294;30.12.2016;2016;12;21;Perjantai;0;0;0;1;0;1
294;30.12.2016;2016;12;22;Perjantai;0;0;0;4;0;4
294;30.12.2016;2016;12;23;Perjantai;0;0;0;0;0;0
294;31.12.2016;2016;12;00;Lauantai;0;0;0;0;0;0
294;31.12.2016;2016;12;01;Lauantai;0;0;0;0;0;0
294;31.12.2016;2016;12;02;Lauantai;0;0;0;0;0;0
294;31.12.2016;2016;12;03;Lauantai;0;0;0;0;0;0
294;31.12.2016;2016;12;04;Lauantai;0;0;0;0;0;0
294;31.12.2016;2016;12;05;Lauantai;0;0;0;2;3;5
294;31.12.2016;2016;12;06;Lauantai;0;0;0;2;0;2
294;31.12.2016;2016;12;07;Lauantai;0;0;0;1;1;2
294;31.12.2016;2016;12;08;Lauantai;0;5;5;7;4;11
294;31.12.2016;2016;12;09;Lauantai;0;0;0;9;12;21
294;31.12.2016;2016;12;10;Lauantai;1;0;1;13;9;22
294;31.12.2016;2016;12;11;Lauantai;2;1;3;17;17;34
294;31.12.2016;2016;12;12;Lauantai;1;4;5;17;9;26
294;31.12.2016;2016;12;13;Lauantai;2;1;3;14;16;30
294;31.12.2016;2016;12;14;Lauantai;0;5;5;10;7;17
294;31.12.2016;2016;12;15;Lauantai;3;2;5;8;10;18
294;31.12.2016;2016;12;16;Lauantai;2;3;5;2;4;6
294;31.12.2016;2016;12;17;Lauantai;1;2;3;10;9;19
294;31.12.2016;2016;12;18;Lauantai;3;2;5;12;9;21
294;31.12.2016;2016;12;19;Lauantai;1;0;1;6;6;12
294;31.12.2016;2016;12;20;Lauantai;0;0;0;3;2;5
294;31.12.2016;2016;12;21;Lauantai;1;2;3;6;1;7
294;31.12.2016;2016;12;22;Lauantai;1;1;2;2;3;5
294;31.12.2016;2016;12;23;Lauantai;0;0;0;3;0;3
294;01.01.2017;2017;01;00;Sunnuntai;0;0;0;1;4;5
294;01.01.2017;2017;01;01;Sunnuntai;1;0;1;1;2;3
294;01.01.2017;2017;01;02;Sunnuntai;0;0;0;0;1;1
294;01.01.2017;2017;01;03;Sunnuntai;0;0;0;0;1;1
294;01.01.2017;2017;01;04;Sunnuntai;0;0;0;2;1;3
294;01.01.2017;2017;01;05;Sunnuntai;0;0;0;0;0;0
294;01.01.2017;2017;01;06;Sunnuntai;0;0;0;1;2;3
294;01.01.2017;2017;01;07;Sunnuntai;0;2;2;1;3;4
294;01.01.2017;2017;01;08;Sunnuntai;1;1;2;1;0;1
294;01.01.2017;2017;01;09;Sunnuntai;1;0;1;8;3;11
294;01.01.2017;2017;01;10;Sunnuntai;1;1;2;5;7;12
294;01.01.2017;2017;01;11;Sunnuntai;0;0;0;9;13;22
294;01.01.2017;2017;01;12;Sunnuntai;0;3;3;4;11;15
294;01.01.2017;2017;01;13;Sunnuntai;0;0;0;12;13;25
294;01.01.2017;2017;01;14;Sunnuntai;4;1;5;6;18;24
294;01.01.2017;2017;01;15;Sunnuntai;3;1;4;15;6;21
294;01.01.2017;2017;01;16;Sunnuntai;1;2;3;10;12;22
294;01.01.2017;2017;01;17;Sunnuntai;2;5;7;22;14;36
294;01.01.2017;2017;01;18;Sunnuntai;1;7;8;8;8;16
294;01.01.2017;2017;01;19;Sunnuntai;2;0;2;6;15;21
294;01.01.2017;2017;01;20;Sunnuntai;4;1;5;5;2;7
294;01.01.2017;2017;01;21;Sunnuntai;1;1;2;2;5;7
294;01.01.2017;2017;01;22;Sunnuntai;0;0;0;1;0;1
294;01.01.2017;2017;01;23;Sunnuntai;0;0;0;0;0;0
294;02.01.2017;2017;01;00;Maanantai;0;0;0;0;0;0
294;02.01.2017;2017;01;01;Maanantai;0;0;0;0;0;0
294;02.01.2017;2017;01;02;Maanantai;0;0;0;0;0;0
294;02.01.2017;2017;01;03;Maanantai;0;0;0;0;0;0
294;02.01.2017;2017;01;04;Maanantai;0;0;0;0;0;0
294;02.01.2017;2017;01;05;Maanantai;0;0;0;2;1;3
294;02.01.2017;2017;01;06;Maanantai;0;0;0;2;1;3
294;02.01.2017;2017;01;07;Maanantai;2;0;2;3;2;5
294;02.01.2017;2017;01;08;Maanantai;0;2;2;7;1;8
294;02.01.2017;2017;01;09;Maanantai;1;1;2;8;6;14
294;02.01.2017;2017;01;10;Maanantai;1;0;1;18;18;36
294;02.01.2017;2017;01;11;Maanantai;2;2;4;8;10;18
294;02.01.2017;2017;01;12;Maanantai;2;6;8;23;22;45
294;02.01.2017;2017;01;13;Maanantai;5;4;9;16;15;31
294;02.01.2017;2017;01;14;Maanantai;3;4;7;11;15;26
294;02.01.2017;2017;01;15;Maanantai;8;6;14;18;15;33
294;02.01.2017;2017;01;16;Maanantai;2;5;7;10;14;24
294;02.01.2017;2017;01;17;Maanantai;1;0;1;9;11;20
294;02.01.2017;2017;01;18;Maanantai;3;3;6;14;15;29
294;02.01.2017;2017;01;19;Maanantai;2;3;5;3;13;16
294;02.01.2017;2017;01;20;Maanantai;3;2;5;2;3;5
294;02.01.2017;2017;01;21;Maanantai;1;0;1;5;4;9
294;02.01.2017;2017;01;22;Maanantai;0;0;0;3;2;5
294;02.01.2017;2017;01;23;Maanantai;0;0;0;0;0;0
294;03.01.2017;2017;01;00;Tiistai;0;0;0;0;0;0
294;03.01.2017;2017;01;01;Tiistai;0;0;0;0;0;0
294;03.01.2017;2017;01;02;Tiistai;0;0;0;0;0;0
294;03.01.2017;2017;01;03;Tiistai;0;0;0;0;0;0
294;03.01.2017;2017;01;04;Tiistai;0;0;0;0;0;0
294;03.01.2017;2017;01;05;Tiistai;0;0;0;2;0;2
294;03.01.2017;2017;01;06;Tiistai;0;1;1;1;1;2
294;03.01.2017;2017;01;07;Tiistai;3;0;3;3;3;6
294;03.01.2017;2017;01;08;Tiistai;3;0;3;4;3;7
294;03.01.2017;2017;01;09;Tiistai;0;1;1;7;6;13
294;03.01.2017;2017;01;10;Tiistai;0;2;2;13;13;26
294;03.01.2017;2017;01;11;Tiistai;3;1;4;13;6;19
294;03.01.2017;2017;01;12;Tiistai;1;2;3;7;17;24
294;03.01.2017;2017;01;13;Tiistai;3;5;8;16;9;25
294;03.01.2017;2017;01;14;Tiistai;6;3;9;19;14;33
294;03.01.2017;2017;01;15;Tiistai;5;4;9;10;7;17
294;03.01.2017;2017;01;16;Tiistai;5;2;7;6;5;11
294;03.01.2017;2017;01;17;Tiistai;1;3;4;6;21;27
294;03.01.2017;2017;01;18;Tiistai;2;4;6;16;8;24
294;03.01.2017;2017;01;19;Tiistai;1;3;4;8;12;20
294;03.01.2017;2017;01;20;Tiistai;0;0;0;5;3;8
294;03.01.2017;2017;01;21;Tiistai;1;0;1;2;2;4
294;03.01.2017;2017;01;22;Tiistai;0;0;0;0;1;1
294;03.01.2017;2017;01;23;Tiistai;0;0;0;0;1;1
294;04.01.2017;2017;01;00;Keskiviikko;0;0;0;0;0;0
294;04.01.2017;2017;01;01;Keskiviikko;0;0;0;0;1;1
294;04.01.2017;2017;01;02;Keskiviikko;0;0;0;0;0;0
294;04.01.2017;2017;01;03;Keskiviikko;0;0;0;0;0;0
294;04.01.2017;2017;01;04;Keskiviikko;0;0;0;0;0;0
294;04.01.2017;2017;01;05;Keskiviikko;0;0;0;1;0;1
294;04.01.2017;2017;01;06;Keskiviikko;0;0;0;1;1;2
294;04.01.2017;2017;01;07;Keskiviikko;2;0;2;2;2;4
294;04.01.2017;2017;01;08;Keskiviikko;0;0;0;3;1;4
294;04.01.2017;2017;01;09;Keskiviikko;1;0;1;4;4;8
294;04.01.2017;2017;01;10;Keskiviikko;0;0;0;3;4;7
294;04.01.2017;2017;01;11;Keskiviikko;0;2;2;9;8;17
294;04.01.2017;2017;01;12;Keskiviikko;2;0;2;8;10;18
294;04.01.2017;2017;01;13;Keskiviikko;1;1;2;10;4;14
294;04.01.2017;2017;01;14;Keskiviikko;1;1;2;6;3;9
294;04.01.2017;2017;01;15;Keskiviikko;1;5;6;6;10;16
294;04.01.2017;2017;01;16;Keskiviikko;1;3;4;8;6;14
294;04.01.2017;2017;01;17;Keskiviikko;2;1;3;1;1;2
294;04.01.2017;2017;01;18;Keskiviikko;0;2;2;4;1;5
294;04.01.2017;2017;01;19;Keskiviikko;2;1;3;4;3;7
294;04.01.2017;2017;01;20;Keskiviikko;1;1;2;4;0;4
294;04.01.2017;2017;01;21;Keskiviikko;1;1;2;0;0;0
294;04.01.2017;2017;01;22;Keskiviikko;0;0;0;5;4;9
294;04.01.2017;2017;01;23;Keskiviikko;0;0;0;1;0;1
294;05.01.2017;2017;01;00;Torstai;0;0;0;0;0;0
294;05.01.2017;2017;01;01;Torstai;0;0;0;0;0;0
294;05.01.2017;2017;01;02;Torstai;0;0;0;0;0;0
294;05.01.2017;2017;01;03;Torstai;0;0;0;0;0;0
294;05.01.2017;2017;01;04;Torstai;0;0;0;0;1;1
294;05.01.2017;2017;01;05;Torstai;0;0;0;0;0;0
294;05.01.2017;2017;01;06;Torstai;0;0;0;1;1;2
294;05.01.2017;2017;01;07;Torstai;0;0;0;2;1;3
294;05.01.2017;2017;01;08;Torstai;0;0;0;4;6;10
294;05.01.2017;2017;01;09;Torstai;1;0;1;6;0;6
294;05.01.2017;2017;01;10;Torstai;0;0;0;6;5;11
294;05.01.2017;2017;01;11;Torstai;0;1;1;4;8;12
294;05.01.2017;2017;01;12;Torstai;0;1;1;3;11;14
294;05.01.2017;2017;01;13;Torstai;1;0;1;8;5;13
294;05.01.2017;2017;01;14;Torstai;1;2;3;5;4;9
294;05.01.2017;2017;01;15;Torstai;0;1;1;6;2;8
294;05.01.2017;2017;01;16;Torstai;2;0;2;9;11;20
294;05.01.2017;2017;01;17;Torstai;0;1;1;7;4;11
294;05.01.2017;2017;01;18;Torstai;1;0;1;5;2;7
294;05.01.2017;2017;01;19;Torstai;0;1;1;3;3;6
294;05.01.2017;2017;01;20;Torstai;2;0;2;1;0;1
294;05.01.2017;2017;01;21;Torstai;0;0;0;2;5;7
294;05.01.2017;2017;01;22;Torstai;1;0;1;0;0;0
294;05.01.2017;2017;01;23;Torstai;0;0;0;0;0;0
294;06.01.2017;2017;01;00;Perjantai;0;0;0;0;2;2
294;06.01.2017;2017;01;01;Perjantai;0;0;0;1;0;1
294;06.01.2017;2017;01;02;Perjantai;0;0;0;0;2;2
294;06.01.2017;2017;01;03;Perjantai;0;0;0;0;0;0
294;06.01.2017;2017;01;04;Perjantai;0;0;0;0;0;0
294;06.01.2017;2017;01;05;Perjantai;0;0;0;0;0;0
294;06.01.2017;2017;01;06;Perjantai;0;0;0;1;0;1
294;06.01.2017;2017;01;07;Perjantai;0;0;0;0;0;0
294;06.01.2017;2017;01;08;Perjantai;0;0;0;0;1;1
294;06.01.2017;2017;01;09;Perjantai;1;0;1;3;6;9
294;06.01.2017;2017;01;10;Perjantai;0;0;0;8;5;13
294;06.01.2017;2017;01;11;Perjantai;1;2;3;4;4;8
294;06.01.2017;2017;01;12;Perjantai;1;2;3;8;9;17
294;06.01.2017;2017;01;13;Perjantai;3;3;6;12;11;23
294;06.01.2017;2017;01;14;Perjantai;3;4;7;12;9;21
294;06.01.2017;2017;01;15;Perjantai;3;1;4;10;7;17
294;06.01.2017;2017;01;16;Perjantai;0;0;0;7;7;14
294;06.01.2017;2017;01;17;Perjantai;0;0;0;5;6;11
294;06.01.2017;2017;01;18;Perjantai;0;0;0;18;11;29
294;06.01.2017;2017;01;19;Perjantai;0;0;0;2;5;7
294;06.01.2017;2017;01;20;Perjantai;3;0;3;5;4;9
294;06.01.2017;2017;01;21;Perjantai;0;0;0;2;0;2
294;06.01.2017;2017;01;22;Perjantai;0;0;0;1;1;2
294;06.01.2017;2017;01;23;Perjantai;0;0;0;3;0;3
294;07.01.2017;2017;01;00;Lauantai;0;0;0;0;0;0
294;07.01.2017;2017;01;01;Lauantai;0;0;0;0;0;0
294;07.01.2017;2017;01;02;Lauantai;0;0;0;0;0;0
294;07.01.2017;2017;01;03;Lauantai;0;0;0;0;0;0
294;07.01.2017;2017;01;04;Lauantai;0;0;0;0;0;0
294;07.01.2017;2017;01;05;Lauantai;0;0;0;2;0;2
294;07.01.2017;2017;01;06;Lauantai;0;0;0;1;0;1
294;07.01.2017;2017;01;07;Lauantai;0;0;0;0;0;0
294;07.01.2017;2017;01;08;Lauantai;2;0;2;1;2;3
294;07.01.2017;2017;01;09;Lauantai;3;2;5;8;1;9
294;07.01.2017;2017;01;10;Lauantai;0;0;0;5;3;8
294;07.01.2017;2017;01;11;Lauantai;3;2;5;11;7;18
294;07.01.2017;2017;01;12;Lauantai;2;2;4;21;8;29
294;07.01.2017;2017;01;13;Lauantai;2;5;7;17;13;30
294;07.01.2017;2017;01;14;Lauantai;5;7;12;13;12;25
294;07.01.2017;2017;01;15;Lauantai;3;1;4;5;11;16
294;07.01.2017;2017;01;16;Lauantai;2;0;2;9;14;23
294;07.01.2017;2017;01;17;Lauantai;1;1;2;11;12;23
294;07.01.2017;2017;01;18;Lauantai;1;1;2;7;14;21
294;07.01.2017;2017;01;19;Lauantai;1;1;2;10;9;19
294;07.01.2017;2017;01;20;Lauantai;2;3;5;5;2;7
294;07.01.2017;2017;01;21;Lauantai;8;2;10;6;0;6
294;07.01.2017;2017;01;22;Lauantai;4;2;6;0;1;1
294;07.01.2017;2017;01;23;Lauantai;0;0;0;1;0;1
294;08.01.2017;2017;01;00;Sunnuntai;0;0;0;0;0;0
294;08.01.2017;2017;01;01;Sunnuntai;0;0;0;0;0;0
294;08.01.2017;2017;01;02;Sunnuntai;0;0;0;0;0;0
294;08.01.2017;2017;01;03;Sunnuntai;0;0;0;0;0;0
294;08.01.2017;2017;01;04;Sunnuntai;0;0;0;0;0;0
294;08.01.2017;2017;01;05;Sunnuntai;0;0;0;0;0;0
294;08.01.2017;2017;01;06;Sunnuntai;0;1;1;2;2;4
294;08.01.2017;2017;01;07;Sunnuntai;0;0;0;0;2;2
294;08.01.2017;2017;01;08;Sunnuntai;1;0;1;1;2;3
294;08.01.2017;2017;01;09;Sunnuntai;1;0;1;9;3;12
294;08.01.2017;2017;01;10;Sunnuntai;1;1;2;4;3;7
294;08.01.2017;2017;01;11;Sunnuntai;2;1;3;6;3;9
294;08.01.2017;2017;01;12;Sunnuntai;1;0;1;7;5;12
294;08.01.2017;2017;01;13;Sunnuntai;1;2;3;6;3;9
294;08.01.2017;2017;01;14;Sunnuntai;4;3;7;6;6;12
294;08.01.2017;2017;01;15;Sunnuntai;3;2;5;11;0;11
294;08.01.2017;2017;01;16;Sunnuntai;3;2;5;8;0;8
294;08.01.2017;2017;01;17;Sunnuntai;2;1;3;1;0;1
294;08.01.2017;2017;01;18;Sunnuntai;1;1;2;0;0;0
294;08.01.2017;2017;01;19;Sunnuntai;1;0;1;0;0;0
294;08.01.2017;2017;01;20;Sunnuntai;1;0;1;0;0;0
294;08.01.2017;2017;01;21;Sunnuntai;0;0;0;2;0;2
294;08.01.2017;2017;01;22;Sunnuntai;0;0;0;1;0;1
294;08.01.2017;2017;01;23;Sunnuntai;0;0;0;0;0;0
294;09.01.2017;2017;01;00;Maanantai;0;0;0;0;0;0
294;09.01.2017;2017;01;01;Maanantai;0;0;0;0;0;0
294;09.01.2017;2017;01;02;Maanantai;0;0;0;0;0;0
294;09.01.2017;2017;01;03;Maanantai;0;0;0;0;0;0
294;09.01.2017;2017;01;04;Maanantai;0;0;0;0;0;0
294;09.01.2017;2017;01;05;Maanantai;0;0;0;2;0;2
294;09.01.2017;2017;01;06;Maanantai;0;2;2;2;4;6
294;09.01.2017;2017;01;07;Maanantai;12;3;15;7;3;10
294;09.01.2017;2017;01;08;Maanantai;13;0;13;19;5;24
294;09.01.2017;2017;01;09;Maanantai;8;7;15;23;10;33
294;09.01.2017;2017;01;10;Maanantai;4;6;10;15;11;26
294;09.01.2017;2017;01;11;Maanantai;3;6;9;16;28;44
294;09.01.2017;2017;01;12;Maanantai;6;14;20;19;14;33
294;09.01.2017;2017;01;13;Maanantai;2;8;10;20;17;37
294;09.01.2017;2017;01;14;Maanantai;11;15;26;12;20;32
294;09.01.2017;2017;01;15;Maanantai;5;14;19;17;22;39
294;09.01.2017;2017;01;16;Maanantai;4;3;7;14;23;37
294;09.01.2017;2017;01;17;Maanantai;4;3;7;12;17;29
294;09.01.2017;2017;01;18;Maanantai;5;5;10;13;19;32
294;09.01.2017;2017;01;19;Maanantai;8;4;12;24;10;34
294;09.01.2017;2017;01;20;Maanantai;1;4;5;11;7;18
294;09.01.2017;2017;01;21;Maanantai;1;1;2;2;1;3
294;09.01.2017;2017;01;22;Maanantai;0;1;1;0;0;0
294;09.01.2017;2017;01;23;Maanantai;0;0;0;0;0;0
294;10.01.2017;2017;01;00;Tiistai;0;0;0;0;0;0
294;10.01.2017;2017;01;01;Tiistai;0;0;0;0;0;0
294;10.01.2017;2017;01;02;Tiistai;0;0;0;0;0;0
294;10.01.2017;2017;01;03;Tiistai;0;0;0;0;0;0
294;10.01.2017;2017;01;04;Tiistai;0;0;0;0;0;0
294;10.01.2017;2017;01;05;Tiistai;0;0;0;2;0;2
294;10.01.2017;2017;01;06;Tiistai;0;1;1;1;0;1
294;10.01.2017;2017;01;07;Tiistai;8;5;13;10;6;16
294;10.01.2017;2017;01;08;Tiistai;14;2;16;9;3;12
294;10.01.2017;2017;01;09;Tiistai;5;0;5;10;5;15
294;10.01.2017;2017;01;10;Tiistai;2;0;2;8;16;24
294;10.01.2017;2017;01;11;Tiistai;4;4;8;19;19;38
294;10.01.2017;2017;01;12;Tiistai;1;2;3;19;11;30
294;10.01.2017;2017;01;13;Tiistai;8;0;8;16;24;40
294;10.01.2017;2017;01;14;Tiistai;4;5;9;28;16;44
294;10.01.2017;2017;01;15;Tiistai;7;9;16;9;22;31
294;10.01.2017;2017;01;16;Tiistai;7;14;21;8;14;22
294;10.01.2017;2017;01;17;Tiistai;7;4;11;22;10;32
294;10.01.2017;2017;01;18;Tiistai;2;4;6;15;15;30
294;10.01.2017;2017;01;19;Tiistai;3;3;6;8;7;15
294;10.01.2017;2017;01;20;Tiistai;0;3;3;5;3;8
294;10.01.2017;2017;01;21;Tiistai;1;2;3;1;0;1
294;10.01.2017;2017;01;22;Tiistai;0;0;0;1;0;1
294;10.01.2017;2017;01;23;Tiistai;0;0;0;0;0;0
294;11.01.2017;2017;01;00;Keskiviikko;0;0;0;0;0;0
294;11.01.2017;2017;01;01;Keskiviikko;0;0;0;0;0;0
294;11.01.2017;2017;01;02;Keskiviikko;0;0;0;0;0;0
294;11.01.2017;2017;01;03;Keskiviikko;0;0;0;0;0;0
294;11.01.2017;2017;01;04;Keskiviikko;0;0;0;0;0;0
294;11.01.2017;2017;01;05;Keskiviikko;1;0;1;1;1;2
294;11.01.2017;2017;01;06;Keskiviikko;1;0;1;3;0;3
294;11.01.2017;2017;01;07;Keskiviikko;2;2;4;4;9;13
294;11.01.2017;2017;01;08;Keskiviikko;14;2;16;17;7;24
294;11.01.2017;2017;01;09;Keskiviikko;9;17;26;21;20;41
294;11.01.2017;2017;01;10;Keskiviikko;4;4;8;16;12;28
294;11.01.2017;2017;01;11;Keskiviikko;7;3;10;27;18;45
294;11.01.2017;2017;01;12;Keskiviikko;7;12;19;28;24;52
294;11.01.2017;2017;01;13;Keskiviikko;6;11;17;19;16;35
294;11.01.2017;2017;01;14;Keskiviikko;6;14;20;8;13;21
294;11.01.2017;2017;01;15;Keskiviikko;7;9;16;13;15;28
294;11.01.2017;2017;01;16;Keskiviikko;9;3;12;15;10;25
294;11.01.2017;2017;01;17;Keskiviikko;5;4;9;12;12;24
294;11.01.2017;2017;01;18;Keskiviikko;3;11;14;8;14;22
294;11.01.2017;2017;01;19;Keskiviikko;6;4;10;9;10;19
294;11.01.2017;2017;01;20;Keskiviikko;2;3;5;8;6;14
294;11.01.2017;2017;01;21;Keskiviikko;2;0;2;3;3;6
294;11.01.2017;2017;01;22;Keskiviikko;0;0;0;2;1;3
294;11.01.2017;2017;01;23;Keskiviikko;0;0;0;0;2;2
294;12.01.2017;2017;01;00;Torstai;0;0;0;0;0;0
294;12.01.2017;2017;01;01;Torstai;0;0;0;0;0;0
294;12.01.2017;2017;01;02;Torstai;0;0;0;0;0;0
294;12.01.2017;2017;01;03;Torstai;0;0;0;0;0;0
294;12.01.2017;2017;01;04;Torstai;0;0;0;0;1;1
294;12.01.2017;2017;01;05;Torstai;0;0;0;2;0;2
294;12.01.2017;2017;01;06;Torstai;1;1;2;4;2;6
294;12.01.2017;2017;01;07;Torstai;1;3;4;9;5;14
294;12.01.2017;2017;01;08;Torstai;8;0;8;9;9;18
294;12.01.2017;2017;01;09;Torstai;3;1;4;25;8;33
294;12.01.2017;2017;01;10;Torstai;1;2;3;9;12;21
294;12.01.2017;2017;01;11;Torstai;8;4;12;15;9;24
294;12.01.2017;2017;01;12;Torstai;3;3;6;22;25;47
294;12.01.2017;2017;01;13;Torstai;0;6;6;20;17;37
294;12.01.2017;2017;01;14;Torstai;7;11;18;12;19;31
294;12.01.2017;2017;01;15;Torstai;7;13;20;22;7;29
294;12.01.2017;2017;01;16;Torstai;8;7;15;11;17;28
294;12.01.2017;2017;01;17;Torstai;5;4;9;18;15;33
294;12.01.2017;2017;01;18;Torstai;7;4;11;11;13;24
294;12.01.2017;2017;01;19;Torstai;3;3;6;7;13;20
294;12.01.2017;2017;01;20;Torstai;1;4;5;5;4;9
294;12.01.2017;2017;01;21;Torstai;0;1;1;1;1;2
294;12.01.2017;2017;01;22;Torstai;0;0;0;1;1;2
294;12.01.2017;2017;01;23;Torstai;0;0;0;1;1;2
294;13.01.2017;2017;01;00;Perjantai;0;0;0;0;0;0
294;13.01.2017;2017;01;01;Perjantai;0;0;0;0;1;1
294;13.01.2017;2017;01;02;Perjantai;0;0;0;0;0;0
294;13.01.2017;2017;01;03;Perjantai;0;0;0;0;0;0
294;13.01.2017;2017;01;04;Perjantai;0;0;0;0;0;0
294;13.01.2017;2017;01;05;Perjantai;0;0;0;2;0;2
294;13.01.2017;2017;01;06;Perjantai;0;1;1;1;1;2
294;13.01.2017;2017;01;07;Perjantai;1;2;3;5;7;12
294;13.01.2017;2017;01;08;Perjantai;5;2;7;10;5;15
294;13.01.2017;2017;01;09;Perjantai;7;5;12;17;8;25
294;13.01.2017;2017;01;10;Perjantai;4;1;5;12;20;32
294;13.01.2017;2017;01;11;Perjantai;7;2;9;23;18;41
294;13.01.2017;2017;01;12;Perjantai;5;17;22;8;19;27
294;13.01.2017;2017;01;13;Perjantai;5;7;12;16;11;27
294;13.01.2017;2017;01;14;Perjantai;8;13;21;14;17;31
294;13.01.2017;2017;01;15;Perjantai;7;2;9;12;11;23
294;13.01.2017;2017;01;16;Perjantai;6;4;10;15;16;31
294;13.01.2017;2017;01;17;Perjantai;6;6;12;12;17;29
294;13.01.2017;2017;01;18;Perjantai;3;4;7;11;10;21
294;13.01.2017;2017;01;19;Perjantai;5;7;12;13;13;26
294;13.01.2017;2017;01;20;Perjantai;3;2;5;8;7;15
294;13.01.2017;2017;01;21;Perjantai;0;1;1;4;1;5
294;13.01.2017;2017;01;22;Perjantai;1;0;1;1;0;1
294;13.01.2017;2017;01;23;Perjantai;0;0;0;0;1;1
294;14.01.2017;2017;01;00;Lauantai;0;0;0;0;0;0
294;14.01.2017;2017;01;01;Lauantai;0;0;0;1;0;1
294;14.01.2017;2017;01;02;Lauantai;0;0;0;1;2;3
294;14.01.2017;2017;01;03;Lauantai;0;0;0;0;0;0
294;14.01.2017;2017;01;04;Lauantai;0;0;0;0;0;0
294;14.01.2017;2017;01;05;Lauantai;1;0;1;0;0;0
294;14.01.2017;2017;01;06;Lauantai;0;0;0;2;3;5
294;14.01.2017;2017;01;07;Lauantai;0;0;0;0;5;5
294;14.01.2017;2017;01;08;Lauantai;2;1;3;1;6;7
294;14.01.2017;2017;01;09;Lauantai;0;0;0;5;10;15
294;14.01.2017;2017;01;10;Lauantai;1;2;3;10;13;23
294;14.01.2017;2017;01;11;Lauantai;3;3;6;19;6;25
294;14.01.2017;2017;01;12;Lauantai;2;0;2;18;17;35
294;14.01.2017;2017;01;13;Lauantai;1;4;5;14;15;29
294;14.01.2017;2017;01;14;Lauantai;0;0;0;19;15;34
294;14.01.2017;2017;01;15;Lauantai;2;5;7;10;12;22
294;14.01.2017;2017;01;16;Lauantai;0;4;4;11;6;17
294;14.01.2017;2017;01;17;Lauantai;2;1;3;14;16;30
294;14.01.2017;2017;01;18;Lauantai;4;5;9;12;6;18
294;14.01.2017;2017;01;19;Lauantai;4;3;7;8;6;14
294;14.01.2017;2017;01;20;Lauantai;3;4;7;5;12;17
294;14.01.2017;2017;01;21;Lauantai;4;0;4;0;2;2
294;14.01.2017;2017;01;22;Lauantai;1;2;3;0;3;3
294;14.01.2017;2017;01;23;Lauantai;0;0;0;1;0;1
294;15.01.2017;2017;01;00;Sunnuntai;0;0;0;1;0;1
294;15.01.2017;2017;01;01;Sunnuntai;0;0;0;0;0;0
294;15.01.2017;2017;01;02;Sunnuntai;0;0;0;0;0;0
294;15.01.2017;2017;01;03;Sunnuntai;0;0;0;1;0;1
294;15.01.2017;2017;01;04;Sunnuntai;0;0;0;0;0;0
294;15.01.2017;2017;01;05;Sunnuntai;0;0;0;0;1;1
294;15.01.2017;2017;01;06;Sunnuntai;0;0;0;2;2;4
294;15.01.2017;2017;01;07;Sunnuntai;0;0;0;2;4;6
294;15.01.2017;2017;01;08;Sunnuntai;0;1;1;4;2;6
294;15.01.2017;2017;01;09;Sunnuntai;3;1;4;17;5;22
294;15.01.2017;2017;01;10;Sunnuntai;0;0;0;13;12;25
294;15.01.2017;2017;01;11;Sunnuntai;0;2;2;14;15;29
294;15.01.2017;2017;01;12;Sunnuntai;1;2;3;10;18;28
294;15.01.2017;2017;01;13;Sunnuntai;4;4;8;9;9;18
294;15.01.2017;2017;01;14;Sunnuntai;2;4;6;13;8;21
294;15.01.2017;2017;01;15;Sunnuntai;1;1;2;8;7;15
294;15.01.2017;2017;01;16;Sunnuntai;1;4;5;13;11;24
294;15.01.2017;2017;01;17;Sunnuntai;6;6;12;7;11;18
294;15.01.2017;2017;01;18;Sunnuntai;3;0;3;19;9;28
294;15.01.2017;2017;01;19;Sunnuntai;2;1;3;7;10;17
294;15.01.2017;2017;01;20;Sunnuntai;1;1;2;4;6;10
294;15.01.2017;2017;01;21;Sunnuntai;3;2;5;2;1;3
294;15.01.2017;2017;01;22;Sunnuntai;1;1;2;3;0;3
294;15.01.2017;2017;01;23;Sunnuntai;0;0;0;0;0;0
294;16.01.2017;2017;01;00;Maanantai;0;0;0;0;0;0
294;16.01.2017;2017;01;01;Maanantai;0;0;0;0;0;0
294;16.01.2017;2017;01;02;Maanantai;0;0;0;0;0;0
294;16.01.2017;2017;01;03;Maanantai;0;0;0;0;0;0
294;16.01.2017;2017;01;04;Maanantai;0;0;0;0;0;0
294;16.01.2017;2017;01;05;Maanantai;1;0;1;2;0;2
294;16.01.2017;2017;01;06;Maanantai;0;1;1;4;1;5
294;16.01.2017;2017;01;07;Maanantai;2;1;3;6;4;10
294;16.01.2017;2017;01;08;Maanantai;5;1;6;13;3;16
294;16.01.2017;2017;01;09;Maanantai;4;2;6;16;11;27
294;16.01.2017;2017;01;10;Maanantai;1;1;2;13;16;29
294;16.01.2017;2017;01;11;Maanantai;4;5;9;23;16;39
294;16.01.2017;2017;01;12;Maanantai;7;4;11;15;27;42
294;16.01.2017;2017;01;13;Maanantai;4;10;14;15;14;29
294;16.01.2017;2017;01;14;Maanantai;6;9;15;20;19;39
294;16.01.2017;2017;01;15;Maanantai;5;9;14;11;21;32
294;16.01.2017;2017;01;16;Maanantai;5;1;6;13;17;30
294;16.01.2017;2017;01;17;Maanantai;6;5;11;12;11;23
294;16.01.2017;2017;01;18;Maanantai;3;3;6;13;17;30
294;16.01.2017;2017;01;19;Maanantai;3;4;7;12;14;26
294;16.01.2017;2017;01;20;Maanantai;1;2;3;3;4;7
294;16.01.2017;2017;01;21;Maanantai;0;0;0;1;3;4
294;16.01.2017;2017;01;22;Maanantai;0;0;0;1;0;1
294;16.01.2017;2017;01;23;Maanantai;0;0;0;0;0;0
294;17.01.2017;2017;01;00;Tiistai;0;0;0;0;1;1
294;17.01.2017;2017;01;01;Tiistai;0;0;0;0;0;0
294;17.01.2017;2017;01;02;Tiistai;0;0;0;0;0;0
294;17.01.2017;2017;01;03;Tiistai;0;0;0;0;0;0
294;17.01.2017;2017;01;04;Tiistai;0;0;0;0;0;0
294;17.01.2017;2017;01;05;Tiistai;0;0;0;3;0;3
294;17.01.2017;2017;01;06;Tiistai;1;3;4;3;0;3
294;17.01.2017;2017;01;07;Tiistai;2;1;3;7;7;14
294;17.01.2017;2017;01;08;Tiistai;10;0;10;17;7;24
294;17.01.2017;2017;01;09;Tiistai;4;4;8;13;9;22
294;17.01.2017;2017;01;10;Tiistai;3;2;5;9;12;21
294;17.01.2017;2017;01;11;Tiistai;7;9;16;19;15;34
294;17.01.2017;2017;01;12;Tiistai;4;4;8;10;21;31
294;17.01.2017;2017;01;13;Tiistai;4;7;11;9;15;24
294;17.01.2017;2017;01;14;Tiistai;5;9;14;16;12;28
294;17.01.2017;2017;01;15;Tiistai;6;10;16;9;15;24
294;17.01.2017;2017;01;16;Tiistai;5;7;12;18;14;32
294;17.01.2017;2017;01;17;Tiistai;5;4;9;5;13;18
294;17.01.2017;2017;01;18;Tiistai;1;6;7;12;8;20
294;17.01.2017;2017;01;19;Tiistai;2;1;3;21;12;33
294;17.01.2017;2017;01;20;Tiistai;0;3;3;2;3;5
294;17.01.2017;2017;01;21;Tiistai;0;1;1;2;1;3
294;17.01.2017;2017;01;22;Tiistai;0;0;0;1;1;2
294;17.01.2017;2017;01;23;Tiistai;0;1;1;1;0;1
294;18.01.2017;2017;01;00;Keskiviikko;0;0;0;0;0;0
294;18.01.2017;2017;01;01;Keskiviikko;0;0;0;0;0;0
294;18.01.2017;2017;01;02;Keskiviikko;0;0;0;0;0;0
294;18.01.2017;2017;01;03;Keskiviikko;0;0;0;0;0;0
294;18.01.2017;2017;01;04;Keskiviikko;0;0;0;0;0;0
294;18.01.2017;2017;01;05;Keskiviikko;0;0;0;1;0;1
294;18.01.2017;2017;01;06;Keskiviikko;0;1;1;3;0;3
294;18.01.2017;2017;01;07;Keskiviikko;9;1;10;10;9;19
294;18.01.2017;2017;01;08;Keskiviikko;11;2;13;12;3;15
294;18.01.2017;2017;01;09;Keskiviikko;4;4;8;13;12;25
294;18.01.2017;2017;01;10;Keskiviikko;5;2;7;11;16;27
294;18.01.2017;2017;01;11;Keskiviikko;8;6;14;24;18;42
294;18.01.2017;2017;01;12;Keskiviikko;4;7;11;12;17;29
294;18.01.2017;2017;01;13;Keskiviikko;4;11;15;16;16;32
294;18.01.2017;2017;01;14;Keskiviikko;12;15;27;11;14;25
294;18.01.2017;2017;01;15;Keskiviikko;7;7;14;7;15;22
294;18.01.2017;2017;01;16;Keskiviikko;1;5;6;10;8;18
294;18.01.2017;2017;01;17;Keskiviikko;5;3;8;12;10;22
294;18.01.2017;2017;01;18;Keskiviikko;4;6;10;17;21;38
294;18.01.2017;2017;01;19;Keskiviikko;7;2;9;12;15;27
294;18.01.2017;2017;01;20;Keskiviikko;2;4;6;7;5;12
294;18.01.2017;2017;01;21;Keskiviikko;0;0;0;0;0;0
294;18.01.2017;2017;01;22;Keskiviikko;0;0;0;0;2;2
294;18.01.2017;2017;01;23;Keskiviikko;0;0;0;2;0;2
294;19.01.2017;2017;01;00;Torstai;0;0;0;0;0;0
294;19.01.2017;2017;01;01;Torstai;0;0;0;0;0;0
294;19.01.2017;2017;01;02;Torstai;0;0;0;0;0;0
294;19.01.2017;2017;01;03;Torstai;0;0;0;0;0;0
294;19.01.2017;2017;01;04;Torstai;0;0;0;0;0;0
294;19.01.2017;2017;01;05;Torstai;1;0;1;1;2;3
294;19.01.2017;2017;01;06;Torstai;1;1;2;3;4;7
294;19.01.2017;2017;01;07;Torstai;14;2;16;19;7;26
294;19.01.2017;2017;01;08;Torstai;5;1;6;22;11;33
294;19.01.2017;2017;01;09;Torstai;6;1;7;14;7;21
294;19.01.2017;2017;01;10;Torstai;2;5;7;15;12;27
294;19.01.2017;2017;01;11;Torstai;2;2;4;13;22;35
294;19.01.2017;2017;01;12;Torstai;1;10;11;22;15;37
294;19.01.2017;2017;01;13;Torstai;3;5;8;8;8;16
294;19.01.2017;2017;01;14;Torstai;6;13;19;11;12;23
294;19.01.2017;2017;01;15;Torstai;5;4;9;7;11;18
294;19.01.2017;2017;01;16;Torstai;3;5;8;6;15;21
294;19.01.2017;2017;01;17;Torstai;6;7;13;6;13;19
294;19.01.2017;2017;01;18;Torstai;2;0;2;7;18;25
294;19.01.2017;2017;01;19;Torstai;2;4;6;8;6;14
294;19.01.2017;2017;01;20;Torstai;0;1;1;2;0;2
294;19.01.2017;2017;01;21;Torstai;0;0;0;2;1;3
294;19.01.2017;2017;01;22;Torstai;0;0;0;0;0;0
294;19.01.2017;2017;01;23;Torstai;0;0;0;0;1;1
294;20.01.2017;2017;01;00;Perjantai;0;0;0;0;0;0
294;20.01.2017;2017;01;01;Perjantai;0;0;0;0;0;0
294;20.01.2017;2017;01;02;Perjantai;0;0;0;0;0;0
294;20.01.2017;2017;01;03;Perjantai;0;0;0;0;0;0
294;20.01.2017;2017;01;04;Perjantai;0;0;0;0;0;0
294;20.01.2017;2017;01;05;Perjantai;0;0;0;2;0;2
294;20.01.2017;2017;01;06;Perjantai;1;1;2;2;5;7
294;20.01.2017;2017;01;07;Perjantai;9;3;12;12;7;19
294;20.01.2017;2017;01;08;Perjantai;7;3;10;17;5;22
294;20.01.2017;2017;01;09;Perjantai;7;0;7;30;10;40
294;20.01.2017;2017;01;10;Perjantai;3;0;3;11;23;34
294;20.01.2017;2017;01;11;Perjantai;6;8;14;13;18;31
294;20.01.2017;2017;01;12;Perjantai;2;13;15;20;25;45
294;20.01.2017;2017;01;13;Perjantai;6;6;12;12;19;31
294;20.01.2017;2017;01;14;Perjantai;5;18;23;21;28;49
294;20.01.2017;2017;01;15;Perjantai;2;6;8;16;18;34
294;20.01.2017;2017;01;16;Perjantai;6;6;12;16;18;34
294;20.01.2017;2017;01;17;Perjantai;2;7;9;16;10;26
294;20.01.2017;2017;01;18;Perjantai;3;1;4;16;14;30
294;20.01.2017;2017;01;19;Perjantai;2;1;3;5;5;10
294;20.01.2017;2017;01;20;Perjantai;6;9;15;6;8;14
294;20.01.2017;2017;01;21;Perjantai;1;0;1;3;1;4
294;20.01.2017;2017;01;22;Perjantai;0;0;0;3;2;5
294;20.01.2017;2017;01;23;Perjantai;1;0;1;1;0;1
294;21.01.2017;2017;01;00;Lauantai;0;0;0;0;1;1
294;21.01.2017;2017;01;01;Lauantai;0;0;0;0;0;0
294;21.01.2017;2017;01;02;Lauantai;0;0;0;1;0;1
294;21.01.2017;2017;01;03;Lauantai;0;0;0;0;0;0
294;21.01.2017;2017;01;04;Lauantai;0;0;0;0;0;0
294;21.01.2017;2017;01;05;Lauantai;0;0;0;1;0;1
294;21.01.2017;2017;01;06;Lauantai;0;0;0;1;1;2
294;21.01.2017;2017;01;07;Lauantai;1;0;1;1;5;6
294;21.01.2017;2017;01;08;Lauantai;0;1;1;3;7;10
294;21.01.2017;2017;01;09;Lauantai;0;0;0;7;10;17
294;21.01.2017;2017;01;10;Lauantai;0;0;0;9;20;29
294;21.01.2017;2017;01;11;Lauantai;4;2;6;18;27;45
294;21.01.2017;2017;01;12;Lauantai;0;2;2;11;19;30
294;21.01.2017;2017;01;13;Lauantai;6;3;9;27;14;41
294;21.01.2017;2017;01;14;Lauantai;2;3;5;23;22;45
294;21.01.2017;2017;01;15;Lauantai;3;5;8;10;16;26
294;21.01.2017;2017;01;16;Lauantai;1;3;4;11;8;19
294;21.01.2017;2017;01;17;Lauantai;2;3;5;10;14;24
294;21.01.2017;2017;01;18;Lauantai;2;1;3;11;8;19
294;21.01.2017;2017;01;19;Lauantai;2;1;3;5;10;15
294;21.01.2017;2017;01;20;Lauantai;4;3;7;2;3;5
294;21.01.2017;2017;01;21;Lauantai;2;1;3;10;3;13
294;21.01.2017;2017;01;22;Lauantai;0;0;0;2;2;4
294;21.01.2017;2017;01;23;Lauantai;0;0;0;2;1;3
294;22.01.2017;2017;01;00;Sunnuntai;0;0;0;0;0;0
294;22.01.2017;2017;01;01;Sunnuntai;0;0;0;1;0;1
294;22.01.2017;2017;01;02;Sunnuntai;0;0;0;0;0;0
294;22.01.2017;2017;01;03;Sunnuntai;0;0;0;0;0;0
294;22.01.2017;2017;01;04;Sunnuntai;0;0;0;0;0;0
294;22.01.2017;2017;01;05;Sunnuntai;0;0;0;0;0;0
294;22.01.2017;2017;01;06;Sunnuntai;0;0;0;2;1;3
294;22.01.2017;2017;01;07;Sunnuntai;0;0;0;1;0;1
294;22.01.2017;2017;01;08;Sunnuntai;0;0;0;6;1;7
294;22.01.2017;2017;01;09;Sunnuntai;0;0;0;8;3;11
294;22.01.2017;2017;01;10;Sunnuntai;0;0;0;14;10;24
294;22.01.2017;2017;01;11;Sunnuntai;1;0;1;6;6;12
294;22.01.2017;2017;01;12;Sunnuntai;0;3;3;10;10;20
294;22.01.2017;2017;01;13;Sunnuntai;0;1;1;19;11;30
294;22.01.2017;2017;01;14;Sunnuntai;1;0;1;10;9;19
294;22.01.2017;2017;01;15;Sunnuntai;1;0;1;5;10;15
294;22.01.2017;2017;01;16;Sunnuntai;1;1;2;8;13;21
294;22.01.2017;2017;01;17;Sunnuntai;2;2;4;19;15;34
294;22.01.2017;2017;01;18;Sunnuntai;2;1;3;6;11;17
294;22.01.2017;2017;01;19;Sunnuntai;3;3;6;5;8;13
294;22.01.2017;2017;01;20;Sunnuntai;1;1;2;6;5;11
294;22.01.2017;2017;01;21;Sunnuntai;1;0;1;2;1;3
294;22.01.2017;2017;01;22;Sunnuntai;0;0;0;0;0;0
294;22.01.2017;2017;01;23;Sunnuntai;0;0;0;0;0;0
294;23.01.2017;2017;01;00;Maanantai;0;0;0;0;0;0
294;23.01.2017;2017;01;01;Maanantai;0;0;0;0;0;0
294;23.01.2017;2017;01;02;Maanantai;0;0;0;0;0;0
294;23.01.2017;2017;01;03;Maanantai;0;0;0;0;0;0
294;23.01.2017;2017;01;04;Maanantai;0;0;0;0;0;0
294;23.01.2017;2017;01;05;Maanantai;0;0;0;2;0;2
294;23.01.2017;2017;01;06;Maanantai;2;0;2;3;0;3
294;23.01.2017;2017;01;07;Maanantai;11;4;15;8;11;19
294;23.01.2017;2017;01;08;Maanantai;10;2;12;20;13;33
294;23.01.2017;2017;01;09;Maanantai;6;0;6;25;11;36
294;23.01.2017;2017;01;10;Maanantai;4;4;8;9;18;27
294;23.01.2017;2017;01;11;Maanantai;1;3;4;13;17;30
294;23.01.2017;2017;01;12;Maanantai;3;5;8;20;20;40
294;23.01.2017;2017;01;13;Maanantai;2;17;19;21;18;39
294;23.01.2017;2017;01;14;Maanantai;7;13;20;15;13;28
294;23.01.2017;2017;01;15;Maanantai;6;18;24;14;18;32
294;23.01.2017;2017;01;16;Maanantai;3;2;5;18;28;46
294;23.01.2017;2017;01;17;Maanantai;2;1;3;16;13;29
294;23.01.2017;2017;01;18;Maanantai;3;3;6;12;15;27
294;23.01.2017;2017;01;19;Maanantai;4;3;7;11;10;21
294;23.01.2017;2017;01;20;Maanantai;2;0;2;4;4;8
294;23.01.2017;2017;01;21;Maanantai;0;0;0;2;1;3
294;23.01.2017;2017;01;22;Maanantai;0;0;0;1;2;3
294;23.01.2017;2017;01;23;Maanantai;0;0;0;0;0;0
294;24.01.2017;2017;01;00;Tiistai;0;0;0;0;0;0
294;24.01.2017;2017;01;01;Tiistai;0;0;0;0;0;0
294;24.01.2017;2017;01;02;Tiistai;0;0;0;0;0;0
294;24.01.2017;2017;01;03;Tiistai;0;0;0;0;0;0
294;24.01.2017;2017;01;04;Tiistai;0;0;0;0;0;0
294;24.01.2017;2017;01;05;Tiistai;1;0;1;1;0;1
294;24.01.2017;2017;01;06;Tiistai;0;2;2;4;2;6
294;24.01.2017;2017;01;07;Tiistai;5;2;7;10;7;17
294;24.01.2017;2017;01;08;Tiistai;9;2;11;13;4;17
294;24.01.2017;2017;01;09;Tiistai;8;1;9;16;5;21
294;24.01.2017;2017;01;10;Tiistai;0;0;0;5;15;20
294;24.01.2017;2017;01;11;Tiistai;2;4;6;12;10;22
294;24.01.2017;2017;01;12;Tiistai;1;0;1;13;7;20
294;24.01.2017;2017;01;13;Tiistai;4;3;7;17;18;35
294;24.01.2017;2017;01;14;Tiistai;5;5;10;22;19;41
294;24.01.2017;2017;01;15;Tiistai;5;15;20;13;22;35
294;24.01.2017;2017;01;16;Tiistai;8;5;13;14;16;30
294;24.01.2017;2017;01;17;Tiistai;2;2;4;5;6;11
294;24.01.2017;2017;01;18;Tiistai;1;0;1;8;6;14
294;24.01.2017;2017;01;19;Tiistai;2;1;3;7;11;18
294;24.01.2017;2017;01;20;Tiistai;0;2;2;4;3;7
294;24.01.2017;2017;01;21;Tiistai;0;0;0;2;2;4
294;24.01.2017;2017;01;22;Tiistai;0;0;0;1;0;1
294;24.01.2017;2017;01;23;Tiistai;0;0;0;0;0;0
294;25.01.2017;2017;01;00;Keskiviikko;0;0;0;0;0;0
294;25.01.2017;2017;01;01;Keskiviikko;0;0;0;0;0;0
294;25.01.2017;2017;01;02;Keskiviikko;0;0;0;0;0;0
294;25.01.2017;2017;01;03;Keskiviikko;0;0;0;0;0;0
294;25.01.2017;2017;01;04;Keskiviikko;0;0;0;0;0;0
294;25.01.2017;2017;01;05;Keskiviikko;0;0;0;2;0;2
294;25.01.2017;2017;01;06;Keskiviikko;0;2;2;1;2;3
294;25.01.2017;2017;01;07;Keskiviikko;5;1;6;15;6;21
294;25.01.2017;2017;01;08;Keskiviikko;9;0;9;10;7;17
294;25.01.2017;2017;01;09;Keskiviikko;9;2;11;17;11;28
294;25.01.2017;2017;01;10;Keskiviikko;1;1;2;11;14;25
294;25.01.2017;2017;01;11;Keskiviikko;4;9;13;19;14;33
294;25.01.2017;2017;01;12;Keskiviikko;5;3;8;19;9;28
294;25.01.2017;2017;01;13;Keskiviikko;8;11;19;12;17;29
294;25.01.2017;2017;01;14;Keskiviikko;3;10;13;10;12;22
294;25.01.2017;2017;01;15;Keskiviikko;7;6;13;14;16;30
294;25.01.2017;2017;01;16;Keskiviikko;8;8;16;17;10;27
294;25.01.2017;2017;01;17;Keskiviikko;5;4;9;12;11;23
294;25.01.2017;2017;01;18;Keskiviikko;4;3;7;9;13;22
294;25.01.2017;2017;01;19;Keskiviikko;2;4;6;6;14;20
294;25.01.2017;2017;01;20;Keskiviikko;0;1;1;6;5;11
294;25.01.2017;2017;01;21;Keskiviikko;0;5;5;2;0;2
294;25.01.2017;2017;01;22;Keskiviikko;0;0;0;1;0;1
294;25.01.2017;2017;01;23;Keskiviikko;0;0;0;0;0;0
294;26.01.2017;2017;01;00;Torstai;0;0;0;0;0;0
294;26.01.2017;2017;01;01;Torstai;0;0;0;0;0;0
294;26.01.2017;2017;01;02;Torstai;0;0;0;0;0;0
294;26.01.2017;2017;01;03;Torstai;0;0;0;0;0;0
294;26.01.2017;2017;01;04;Torstai;0;0;0;0;0;0
294;26.01.2017;2017;01;05;Torstai;0;0;0;1;1;2
294;26.01.2017;2017;01;06;Torstai;0;1;1;3;3;6
294;26.01.2017;2017;01;07;Torstai;23;4;27;11;5;16
294;26.01.2017;2017;01;08;Torstai;12;3;15;19;7;26
294;26.01.2017;2017;01;09;Torstai;5;4;9;33;11;44
294;26.01.2017;2017;01;10;Torstai;0;1;1;10;26;36
294;26.01.2017;2017;01;11;Torstai;4;3;7;16;18;34
294;26.01.2017;2017;01;12;Torstai;3;5;8;25;25;50
294;26.01.2017;2017;01;13;Torstai;0;11;11;21;20;41
294;26.01.2017;2017;01;14;Torstai;7;18;25;23;19;42
294;26.01.2017;2017;01;15;Torstai;5;9;14;19;21;40
294;26.01.2017;2017;01;16;Torstai;5;7;12;17;19;36
294;26.01.2017;2017;01;17;Torstai;14;7;21;19;10;29
294;26.01.2017;2017;01;18;Torstai;5;7;12;11;19;30
294;26.01.2017;2017;01;19;Torstai;4;6;10;12;16;28
294;26.01.2017;2017;01;20;Torstai;1;7;8;4;3;7
294;26.01.2017;2017;01;21;Torstai;0;0;0;2;2;4
294;26.01.2017;2017;01;22;Torstai;0;0;0;0;0;0
294;26.01.2017;2017;01;23;Torstai;0;0;0;0;0;0
294;27.01.2017;2017;01;00;Perjantai;0;0;0;0;0;0
294;27.01.2017;2017;01;01;Perjantai;0;0;0;0;0;0
294;27.01.2017;2017;01;02;Perjantai;0;0;0;0;0;0
294;27.01.2017;2017;01;03;Perjantai;0;0;0;0;0;0
294;27.01.2017;2017;01;04;Perjantai;0;0;0;0;0;0
294;27.01.2017;2017;01;05;Perjantai;1;0;1;1;0;1
294;27.01.2017;2017;01;06;Perjantai;0;1;1;3;1;4
294;27.01.2017;2017;01;07;Perjantai;11;4;15;13;8;21
294;27.01.2017;2017;01;08;Perjantai;9;4;13;16;2;18
294;27.01.2017;2017;01;09;Perjantai;10;1;11;20;10;30
294;27.01.2017;2017;01;10;Perjantai;2;4;6;9;20;29
294;27.01.2017;2017;01;11;Perjantai;6;3;9;15;19;34
294;27.01.2017;2017;01;12;Perjantai;7;13;20;33;26;59
294;27.01.2017;2017;01;13;Perjantai;7;12;19;23;27;50
294;27.01.2017;2017;01;14;Perjantai;6;15;21;21;27;48
294;27.01.2017;2017;01;15;Perjantai;4;5;9;26;23;49
294;27.01.2017;2017;01;16;Perjantai;8;7;15;11;20;31
294;27.01.2017;2017;01;17;Perjantai;5;1;6;13;14;27
294;27.01.2017;2017;01;18;Perjantai;4;4;8;10;12;22
294;27.01.2017;2017;01;19;Perjantai;1;2;3;15;8;23
294;27.01.2017;2017;01;20;Perjantai;4;4;8;12;9;21
294;27.01.2017;2017;01;21;Perjantai;2;2;4;10;4;14
294;27.01.2017;2017;01;22;Perjantai;1;0;1;1;1;2
294;27.01.2017;2017;01;23;Perjantai;2;1;3;0;0;0
294;28.01.2017;2017;01;00;Lauantai;0;1;1;1;1;2
294;28.01.2017;2017;01;01;Lauantai;0;0;0;0;2;2
294;28.01.2017;2017;01;02;Lauantai;0;0;0;0;0;0
294;28.01.2017;2017;01;03;Lauantai;0;0;0;0;0;0
294;28.01.2017;2017;01;04;Lauantai;0;0;0;0;0;0
294;28.01.2017;2017;01;05;Lauantai;0;0;0;0;1;1
294;28.01.2017;2017;01;06;Lauantai;0;0;0;3;2;5
294;28.01.2017;2017;01;07;Lauantai;0;0;0;1;3;4
294;28.01.2017;2017;01;08;Lauantai;0;0;0;3;1;4
294;28.01.2017;2017;01;09;Lauantai;1;1;2;7;7;14
294;28.01.2017;2017;01;10;Lauantai;4;0;4;11;11;22
294;28.01.2017;2017;01;11;Lauantai;5;2;7;17;16;33
294;28.01.2017;2017;01;12;Lauantai;0;1;1;14;12;26
294;28.01.2017;2017;01;13;Lauantai;3;3;6;19;20;39
294;28.01.2017;2017;01;14;Lauantai;3;2;5;21;16;37
294;28.01.2017;2017;01;15;Lauantai;4;5;9;14;9;23
294;28.01.2017;2017;01;16;Lauantai;4;1;5;8;6;14
294;28.01.2017;2017;01;17;Lauantai;2;4;6;11;5;16
294;28.01.2017;2017;01;18;Lauantai;6;5;11;8;5;13
294;28.01.2017;2017;01;19;Lauantai;1;0;1;6;7;13
294;28.01.2017;2017;01;20;Lauantai;6;5;11;6;3;9
294;28.01.2017;2017;01;21;Lauantai;6;0;6;2;3;5
294;28.01.2017;2017;01;22;Lauantai;0;0;0;0;1;1
294;28.01.2017;2017;01;23;Lauantai;0;0;0;0;0;0
294;29.01.2017;2017;01;00;Sunnuntai;0;0;0;0;0;0
294;29.01.2017;2017;01;01;Sunnuntai;0;0;0;0;0;0
294;29.01.2017;2017;01;02;Sunnuntai;0;0;0;0;1;1
294;29.01.2017;2017;01;03;Sunnuntai;0;0;0;1;1;2
294;29.01.2017;2017;01;04;Sunnuntai;0;0;0;0;0;0
294;29.01.2017;2017;01;05;Sunnuntai;0;0;0;0;0;0
294;29.01.2017;2017;01;06;Sunnuntai;0;1;1;2;1;3
294;29.01.2017;2017;01;07;Sunnuntai;0;0;0;4;1;5
294;29.01.2017;2017;01;08;Sunnuntai;0;0;0;1;3;4
294;29.01.2017;2017;01;09;Sunnuntai;1;1;2;12;5;17
294;29.01.2017;2017;01;10;Sunnuntai;0;0;0;10;9;19
294;29.01.2017;2017;01;11;Sunnuntai;2;2;4;9;11;20
294;29.01.2017;2017;01;12;Sunnuntai;1;1;2;11;8;19
294;29.01.2017;2017;01;13;Sunnuntai;5;0;5;6;11;17
294;29.01.2017;2017;01;14;Sunnuntai;3;2;5;16;11;27
294;29.01.2017;2017;01;15;Sunnuntai;7;2;9;11;5;16
294;29.01.2017;2017;01;16;Sunnuntai;0;1;1;14;11;25
294;29.01.2017;2017;01;17;Sunnuntai;3;2;5;14;8;22
294;29.01.2017;2017;01;18;Sunnuntai;6;4;10;21;14;35
294;29.01.2017;2017;01;19;Sunnuntai;6;5;11;10;4;14
294;29.01.2017;2017;01;20;Sunnuntai;0;0;0;3;0;3
294;29.01.2017;2017;01;21;Sunnuntai;0;0;0;4;1;5
294;29.01.2017;2017;01;22;Sunnuntai;0;0;0;0;0;0
294;29.01.2017;2017;01;23;Sunnuntai;0;0;0;0;0;0
294;30.01.2017;2017;01;00;Maanantai;0;0;0;0;0;0
294;30.01.2017;2017;01;01;Maanantai;0;0;0;0;0;0
294;30.01.2017;2017;01;02;Maanantai;0;0;0;0;0;0
294;30.01.2017;2017;01;03;Maanantai;0;0;0;0;0;0
294;30.01.2017;2017;01;04;Maanantai;0;0;0;0;0;0
294;30.01.2017;2017;01;05;Maanantai;0;0;0;2;0;2
294;30.01.2017;2017;01;06;Maanantai;0;1;1;3;0;3
294;30.01.2017;2017;01;07;Maanantai;6;3;9;8;7;15
294;30.01.2017;2017;01;08;Maanantai;12;2;14;13;5;18
294;30.01.2017;2017;01;09;Maanantai;6;6;12;25;11;36
294;30.01.2017;2017;01;10;Maanantai;1;0;1;9;18;27
294;30.01.2017;2017;01;11;Maanantai;1;1;2;13;17;30
294;30.01.2017;2017;01;12;Maanantai;3;2;5;20;20;40
294;30.01.2017;2017;01;13;Maanantai;10;10;20;21;18;39
294;30.01.2017;2017;01;14;Maanantai;8;8;16;15;13;28
294;30.01.2017;2017;01;15;Maanantai;10;9;19;14;18;32
294;30.01.2017;2017;01;16;Maanantai;5;4;9;18;28;46
294;30.01.2017;2017;01;17;Maanantai;6;5;11;16;13;29
294;30.01.2017;2017;01;18;Maanantai;2;2;4;12;15;27
294;30.01.2017;2017;01;19;Maanantai;3;3;6;11;10;21
294;30.01.2017;2017;01;20;Maanantai;4;3;7;4;4;8
294;30.01.2017;2017;01;21;Maanantai;1;1;2;2;1;3
294;30.01.2017;2017;01;22;Maanantai;1;0;1;1;2;3
294;30.01.2017;2017;01;23;Maanantai;0;0;0;0;0;0
294;31.01.2017;2017;01;00;Tiistai;0;0;0;0;0;0
294;31.01.2017;2017;01;01;Tiistai;0;0;0;0;0;0
294;31.01.2017;2017;01;02;Tiistai;0;0;0;0;0;0
294;31.01.2017;2017;01;03;Tiistai;0;0;0;0;0;0
294;31.01.2017;2017;01;04;Tiistai;0;0;0;0;0;0
294;31.01.2017;2017;01;05;Tiistai;0;0;0;1;0;1
294;31.01.2017;2017;01;06;Tiistai;2;2;4;4;2;6
294;31.01.2017;2017;01;07;Tiistai;7;7;14;10;7;17
294;31.01.2017;2017;01;08;Tiistai;3;3;6;13;4;17
294;31.01.2017;2017;01;09;Tiistai;8;7;15;16;5;21
294;31.01.2017;2017;01;10;Tiistai;3;2;5;5;15;20
294;31.01.2017;2017;01;11;Tiistai;4;4;8;12;10;22
294;31.01.2017;2017;01;12;Tiistai;5;4;9;13;7;20
294;31.01.2017;2017;01;13;Tiistai;7;7;14;17;18;35
294;31.01.2017;2017;01;14;Tiistai;5;5;10;22;19;41
294;31.01.2017;2017;01;15;Tiistai;7;6;13;13;22;35
294;31.01.2017;2017;01;16;Tiistai;5;5;10;14;16;30
294;31.01.2017;2017;01;17;Tiistai;4;3;7;5;6;11
294;31.01.2017;2017;01;18;Tiistai;3;3;6;8;6;14
294;31.01.2017;2017;01;19;Tiistai;2;2;4;7;11;18
294;31.01.2017;2017;01;20;Tiistai;1;0;1;4;3;7
294;31.01.2017;2017;01;21;Tiistai;1;1;2;2;2;4
294;31.01.2017;2017;01;22;Tiistai;0;0;0;1;0;1
294;31.01.2017;2017;01;23;Tiistai;0;0;0;0;0;0
294;01.02.2017;2017;02;00;Keskiviikko;0;0;0;0;0;0
294;01.02.2017;2017;02;01;Keskiviikko;0;0;0;0;0;0
294;01.02.2017;2017;02;02;Keskiviikko;0;0;0;0;0;0
294;01.02.2017;2017;02;03;Keskiviikko;0;0;0;0;0;0
294;01.02.2017;2017;02;04;Keskiviikko;0;0;0;0;0;0
294;01.02.2017;2017;02;05;Keskiviikko;1;0;1;2;0;2
294;01.02.2017;2017;02;06;Keskiviikko;1;0;1;1;2;3
294;01.02.2017;2017;02;07;Keskiviikko;6;6;12;15;6;21
294;01.02.2017;2017;02;08;Keskiviikko;5;5;10;10;7;17
294;01.02.2017;2017;02;09;Keskiviikko;8;7;15;17;11;28
294;01.02.2017;2017;02;10;Keskiviikko;3;3;6;11;14;25
294;01.02.2017;2017;02;11;Keskiviikko;9;9;18;19;14;33
294;01.02.2017;2017;02;12;Keskiviikko;5;4;9;19;9;28
294;01.02.2017;2017;02;13;Keskiviikko;13;12;25;12;17;29
294;01.02.2017;2017;02;14;Keskiviikko;11;10;21;10;12;22
294;01.02.2017;2017;02;15;Keskiviikko;10;9;19;14;16;30
294;01.02.2017;2017;02;16;Keskiviikko;13;13;26;17;10;27
294;01.02.2017;2017;02;17;Keskiviikko;3;3;6;12;11;23
294;01.02.2017;2017;02;18;Keskiviikko;5;4;9;9;13;22
294;01.02.2017;2017;02;19;Keskiviikko;7;7;14;6;14;20
294;01.02.2017;2017;02;20;Keskiviikko;0;0;0;6;5;11
294;01.02.2017;2017;02;21;Keskiviikko;0;0;0;2;0;2
294;01.02.2017;2017;02;22;Keskiviikko;0;0;0;1;0;1
294;01.02.2017;2017;02;23;Keskiviikko;0;0;0;0;0;0
294;02.02.2017;2017;02;00;Torstai;0;0;0;0;0;0
294;02.02.2017;2017;02;01;Torstai;0;0;0;0;0;0
294;02.02.2017;2017;02;02;Torstai;0;0;0;0;0;0
294;02.02.2017;2017;02;03;Torstai;0;0;0;0;0;0
294;02.02.2017;2017;02;04;Torstai;0;0;0;0;0;0
294;02.02.2017;2017;02;05;Torstai;1;0;1;1;1;2
294;02.02.2017;2017;02;06;Torstai;2;1;3;3;3;6
294;02.02.2017;2017;02;07;Torstai;10;10;20;11;5;16
294;02.02.2017;2017;02;08;Torstai;6;6;12;19;7;26
294;02.02.2017;2017;02;09;Torstai;5;4;9;33;11;44
294;02.02.2017;2017;02;10;Torstai;2;2;4;10;26;36
294;02.02.2017;2017;02;11;Torstai;6;5;11;16;18;34
294;02.02.2017;2017;02;12;Torstai;6;5;11;25;25;50
294;02.02.2017;2017;02;13;Torstai;16;15;31;21;20;41
294;02.02.2017;2017;02;14;Torstai;12;12;24;23;19;42
294;02.02.2017;2017;02;15;Torstai;8;7;15;19;21;40
294;02.02.2017;2017;02;16;Torstai;5;5;10;17;19;36
294;02.02.2017;2017;02;17;Torstai;7;7;14;19;10;29
294;02.02.2017;2017;02;18;Torstai;1;1;2;11;19;30
294;02.02.2017;2017;02;19;Torstai;3;2;5;12;16;28
294;02.02.2017;2017;02;20;Torstai;1;1;2;4;3;7
294;02.02.2017;2017;02;21;Torstai;1;1;2;2;2;4
294;02.02.2017;2017;02;22;Torstai;0;0;0;0;0;0
294;02.02.2017;2017;02;23;Torstai;0;0;0;0;0;0
294;03.02.2017;2017;02;00;Perjantai;0;0;0;0;0;0
294;03.02.2017;2017;02;01;Perjantai;0;0;0;0;0;0
294;03.02.2017;2017;02;02;Perjantai;0;0;0;0;0;0
294;03.02.2017;2017;02;03;Perjantai;0;0;0;0;0;0
294;03.02.2017;2017;02;04;Perjantai;0;0;0;0;0;0
294;03.02.2017;2017;02;05;Perjantai;1;0;1;1;0;1
294;03.02.2017;2017;02;06;Perjantai;1;1;2;3;1;4
294;03.02.2017;2017;02;07;Perjantai;6;5;11;13;8;21
294;03.02.2017;2017;02;08;Perjantai;9;9;18;16;2;18
294;03.02.2017;2017;02;09;Perjantai;5;4;9;20;10;30
294;03.02.2017;2017;02;10;Perjantai;3;2;5;9;20;29
294;03.02.2017;2017;02;11;Perjantai;4;3;7;15;19;34
294;03.02.2017;2017;02;12;Perjantai;13;13;26;33;26;59
294;03.02.2017;2017;02;13;Perjantai;8;8;16;23;27;50
294;03.02.2017;2017;02;14;Perjantai;11;11;22;21;27;48
294;03.02.2017;2017;02;15;Perjantai;7;7;14;26;23;49
294;03.02.2017;2017;02;16;Perjantai;3;3;6;11;20;31
294;03.02.2017;2017;02;17;Perjantai;8;8;16;13;14;27
294;03.02.2017;2017;02;18;Perjantai;6;6;12;10;12;22
294;03.02.2017;2017;02;19;Perjantai;5;5;10;15;8;23
294;03.02.2017;2017;02;20;Perjantai;3;2;5;12;9;21
294;03.02.2017;2017;02;21;Perjantai;1;0;1;10;4;14
294;03.02.2017;2017;02;22;Perjantai;2;1;3;1;1;2
294;03.02.2017;2017;02;23;Perjantai;0;0;0;0;0;0
294;04.02.2017;2017;02;00;Lauantai;0;0;0;1;1;2
294;04.02.2017;2017;02;01;Lauantai;0;0;0;0;2;2
294;04.02.2017;2017;02;02;Lauantai;0;0;0;0;0;0
294;04.02.2017;2017;02;03;Lauantai;0;0;0;0;0;0
294;04.02.2017;2017;02;04;Lauantai;0;0;0;0;0;0
294;04.02.2017;2017;02;05;Lauantai;0;0;0;0;1;1
294;04.02.2017;2017;02;06;Lauantai;0;0;0;3;2;5
294;04.02.2017;2017;02;07;Lauantai;0;0;0;1;3;4
294;04.02.2017;2017;02;08;Lauantai;0;0;0;3;1;4
294;04.02.2017;2017;02;09;Lauantai;0;0;0;7;7;14
294;04.02.2017;2017;02;10;Lauantai;2;1;3;11;11;22
294;04.02.2017;2017;02;11;Lauantai;2;2;4;17;16;33
294;04.02.2017;2017;02;12;Lauantai;6;5;11;14;12;26
294;04.02.2017;2017;02;13;Lauantai;3;3;6;19;20;39
294;04.02.2017;2017;02;14;Lauantai;4;3;7;21;16;37
294;04.02.2017;2017;02;15;Lauantai;2;0;2;14;9;23
294;04.02.2017;2017;02;16;Lauantai;8;5;13;8;6;14
294;04.02.2017;2017;02;17;Lauantai;1;0;1;11;5;16
294;04.02.2017;2017;02;18;Lauantai;3;1;4;8;5;13
294;04.02.2017;2017;02;19;Lauantai;0;0;0;6;7;13
294;04.02.2017;2017;02;20;Lauantai;1;0;1;6;3;9
294;04.02.2017;2017;02;21;Lauantai;2;0;2;2;3;5
294;04.02.2017;2017;02;22;Lauantai;0;0;0;0;1;1
294;04.02.2017;2017;02;23;Lauantai;2;0;2;0;0;0
294;05.02.2017;2017;02;00;Sunnuntai;1;0;1;0;0;0
294;05.02.2017;2017;02;01;Sunnuntai;0;0;0;1;0;1
294;05.02.2017;2017;02;02;Sunnuntai;0;0;0;0;0;0
294;05.02.2017;2017;02;03;Sunnuntai;0;0;0;0;0;0
294;05.02.2017;2017;02;04;Sunnuntai;0;0;0;0;0;0
294;05.02.2017;2017;02;05;Sunnuntai;0;0;0;0;1;1
294;05.02.2017;2017;02;06;Sunnuntai;0;0;0;0;0;0
294;05.02.2017;2017;02;07;Sunnuntai;0;0;0;0;0;0
294;05.02.2017;2017;02;08;Sunnuntai;0;0;0;0;0;0
294;05.02.2017;2017;02;09;Sunnuntai;0;0;0;5;0;5
294;05.02.2017;2017;02;10;Sunnuntai;0;0;0;3;0;3
294;05.02.2017;2017;02;11;Sunnuntai;3;1;4;1;1;2
294;05.02.2017;2017;02;12;Sunnuntai;7;2;9;3;1;4
294;05.02.2017;2017;02;13;Sunnuntai;3;1;4;4;0;4
294;05.02.2017;2017;02;14;Sunnuntai;3;4;7;8;1;9
294;05.02.2017;2017;02;15;Sunnuntai;3;1;4;3;2;5
294;05.02.2017;2017;02;16;Sunnuntai;2;0;2;5;0;5
294;05.02.2017;2017;02;17;Sunnuntai;3;0;3;8;3;11
294;05.02.2017;2017;02;18;Sunnuntai;5;4;9;7;3;10
294;05.02.2017;2017;02;19;Sunnuntai;2;0;2;2;0;2
294;05.02.2017;2017;02;20;Sunnuntai;3;1;4;0;0;0
294;05.02.2017;2017;02;21;Sunnuntai;0;0;0;0;0;0
294;05.02.2017;2017;02;22;Sunnuntai;0;0;0;0;0;0
294;05.02.2017;2017;02;23;Sunnuntai;0;0;0;0;0;0
294;06.02.2017;2017;02;00;Maanantai;0;0;0;0;0;0
294;06.02.2017;2017;02;01;Maanantai;1;0;1;0;0;0
294;06.02.2017;2017;02;02;Maanantai;0;0;0;0;0;0
294;06.02.2017;2017;02;03;Maanantai;0;0;0;0;0;0
294;06.02.2017;2017;02;04;Maanantai;0;0;0;0;0;0
294;06.02.2017;2017;02;05;Maanantai;0;0;0;2;1;3
294;06.02.2017;2017;02;06;Maanantai;1;1;2;2;1;3
294;06.02.2017;2017;02;07;Maanantai;15;6;21;5;3;8
294;06.02.2017;2017;02;08;Maanantai;7;2;9;11;2;13
294;06.02.2017;2017;02;09;Maanantai;13;3;16;11;4;15
294;06.02.2017;2017;02;10;Maanantai;3;1;4;11;1;12
294;06.02.2017;2017;02;11;Maanantai;4;7;11;10;10;20
294;06.02.2017;2017;02;12;Maanantai;7;12;19;10;5;15
294;06.02.2017;2017;02;13;Maanantai;5;9;14;15;12;27
294;06.02.2017;2017;02;14;Maanantai;6;9;15;13;10;23
294;06.02.2017;2017;02;15;Maanantai;5;22;27;12;9;21
294;06.02.2017;2017;02;16;Maanantai;8;4;12;12;4;16
294;06.02.2017;2017;02;17;Maanantai;7;7;14;11;4;15
294;06.02.2017;2017;02;18;Maanantai;2;3;5;14;9;23
294;06.02.2017;2017;02;19;Maanantai;2;3;5;10;6;16
294;06.02.2017;2017;02;20;Maanantai;4;1;5;2;0;2
294;06.02.2017;2017;02;21;Maanantai;2;0;2;3;0;3
294;06.02.2017;2017;02;22;Maanantai;0;0;0;0;0;0
294;06.02.2017;2017;02;23;Maanantai;0;0;0;0;0;0
294;07.02.2017;2017;02;00;Tiistai;0;0;0;0;0;0
294;07.02.2017;2017;02;01;Tiistai;0;0;0;0;0;0
294;07.02.2017;2017;02;02;Tiistai;0;0;0;0;0;0
294;07.02.2017;2017;02;03;Tiistai;0;0;0;0;0;0
294;07.02.2017;2017;02;04;Tiistai;0;0;0;0;0;0
294;07.02.2017;2017;02;05;Tiistai;0;0;0;1;0;1
294;07.02.2017;2017;02;06;Tiistai;1;1;2;3;0;3
294;07.02.2017;2017;02;07;Tiistai;7;2;9;9;7;16
294;07.02.2017;2017;02;08;Tiistai;9;2;11;8;5;13
294;07.02.2017;2017;02;09;Tiistai;8;1;9;10;4;14
294;07.02.2017;2017;02;10;Tiistai;7;5;12;8;5;13
294;07.02.2017;2017;02;11;Tiistai;1;3;4;12;7;19
294;07.02.2017;2017;02;12;Tiistai;5;2;7;8;9;17
294;07.02.2017;2017;02;13;Tiistai;3;5;8;14;17;31
294;07.02.2017;2017;02;14;Tiistai;8;8;16;6;9;15
294;07.02.2017;2017;02;15;Tiistai;7;13;20;9;24;33
294;07.02.2017;2017;02;16;Tiistai;5;5;10;16;16;32
294;07.02.2017;2017;02;17;Tiistai;5;4;9;13;10;23
294;07.02.2017;2017;02;18;Tiistai;3;4;7;8;8;16
294;07.02.2017;2017;02;19;Tiistai;2;1;3;10;9;19
294;07.02.2017;2017;02;20;Tiistai;4;2;6;4;2;6
294;07.02.2017;2017;02;21;Tiistai;0;0;0;0;0;0
294;07.02.2017;2017;02;22;Tiistai;0;0;0;0;0;0
294;07.02.2017;2017;02;23;Tiistai;0;0;0;0;1;1
294;08.02.2017;2017;02;00;Keskiviikko;0;0;0;0;0;0
294;08.02.2017;2017;02;01;Keskiviikko;0;0;0;0;0;0
294;08.02.2017;2017;02;02;Keskiviikko;0;0;0;0;0;0
294;08.02.2017;2017;02;03;Keskiviikko;0;0;0;0;0;0
294;08.02.2017;2017;02;04;Keskiviikko;0;0;0;0;0;0
294;08.02.2017;2017;02;05;Keskiviikko;0;0;0;1;0;1
294;08.02.2017;2017;02;06;Keskiviikko;0;0;0;2;2;4
294;08.02.2017;2017;02;07;Keskiviikko;5;1;6;6;1;7
294;08.02.2017;2017;02;08;Keskiviikko;3;2;5;13;2;15
294;08.02.2017;2017;02;09;Keskiviikko;6;6;12;11;7;18
294;08.02.2017;2017;02;10;Keskiviikko;1;0;1;5;6;11
294;08.02.2017;2017;02;11;Keskiviikko;3;3;6;16;8;24
294;08.02.2017;2017;02;12;Keskiviikko;2;3;5;11;8;19
294;08.02.2017;2017;02;13;Keskiviikko;2;6;8;18;12;30
294;08.02.2017;2017;02;14;Keskiviikko;4;8;12;18;18;36
294;08.02.2017;2017;02;15;Keskiviikko;10;10;20;12;22;34
294;08.02.2017;2017;02;16;Keskiviikko;6;3;9;17;13;30
294;08.02.2017;2017;02;17;Keskiviikko;0;6;6;5;7;12
294;08.02.2017;2017;02;18;Keskiviikko;0;1;1;12;14;26
294;08.02.2017;2017;02;19;Keskiviikko;4;1;5;6;5;11
294;08.02.2017;2017;02;20;Keskiviikko;0;0;0;3;2;5
294;08.02.2017;2017;02;21;Keskiviikko;0;0;0;0;0;0
294;08.02.2017;2017;02;22;Keskiviikko;0;0;0;2;0;2
294;08.02.2017;2017;02;23;Keskiviikko;0;0;0;0;2;2
294;09.02.2017;2017;02;00;Torstai;0;0;0;0;0;0
294;09.02.2017;2017;02;01;Torstai;0;0;0;0;0;0
294;09.02.2017;2017;02;02;Torstai;0;0;0;0;0;0
294;09.02.2017;2017;02;03;Torstai;0;0;0;0;0;0
294;09.02.2017;2017;02;04;Torstai;0;0;0;0;1;1
294;09.02.2017;2017;02;05;Torstai;0;0;0;0;1;1
294;09.02.2017;2017;02;06;Torstai;0;1;1;1;1;2
294;09.02.2017;2017;02;07;Torstai;12;0;12;8;3;11
294;09.02.2017;2017;02;08;Torstai;7;1;8;11;2;13
294;09.02.2017;2017;02;09;Torstai;7;2;9;9;5;14
294;09.02.2017;2017;02;10;Torstai;1;1;2;5;10;15
294;09.02.2017;2017;02;11;Torstai;1;3;4;12;11;23
294;09.02.2017;2017;02;12;Torstai;1;7;8;16;14;30
294;09.02.2017;2017;02;13;Torstai;5;10;15;5;14;19
294;09.02.2017;2017;02;14;Torstai;8;18;26;18;22;40
294;09.02.2017;2017;02;15;Torstai;5;5;10;24;23;47
294;09.02.2017;2017;02;16;Torstai;5;7;12;13;14;27
294;09.02.2017;2017;02;17;Torstai;2;3;5;15;12;27
294;09.02.2017;2017;02;18;Torstai;2;1;3;14;16;30
294;09.02.2017;2017;02;19;Torstai;2;2;4;11;14;25
294;09.02.2017;2017;02;20;Torstai;2;0;2;10;4;14
294;09.02.2017;2017;02;21;Torstai;0;0;0;2;0;2
294;09.02.2017;2017;02;22;Torstai;0;0;0;0;0;0
294;09.02.2017;2017;02;23;Torstai;0;0;0;0;0;0
294;10.02.2017;2017;02;00;Perjantai;0;0;0;0;0;0
294;10.02.2017;2017;02;01;Perjantai;0;0;0;0;0;0
294;10.02.2017;2017;02;02;Perjantai;0;0;0;0;0;0
294;10.02.2017;2017;02;03;Perjantai;0;0;0;0;0;0
294;10.02.2017;2017;02;04;Perjantai;0;0;0;0;0;0
294;10.02.2017;2017;02;05;Perjantai;0;0;0;3;1;4
294;10.02.2017;2017;02;06;Perjantai;1;1;2;2;3;5
294;10.02.2017;2017;02;07;Perjantai;13;2;15;12;8;20
294;10.02.2017;2017;02;08;Perjantai;8;1;9;9;3;12
294;10.02.2017;2017;02;09;Perjantai;13;3;16;33;9;42
294;10.02.2017;2017;02;10;Perjantai;0;3;3;17;26;43
294;10.02.2017;2017;02;11;Perjantai;6;6;12;10;20;30
294;10.02.2017;2017;02;12;Perjantai;4;13;17;21;21;42
294;10.02.2017;2017;02;13;Perjantai;11;10;21;24;22;46
294;10.02.2017;2017;02;14;Perjantai;7;22;29;24;24;48
294;10.02.2017;2017;02;15;Perjantai;5;6;11;21;20;41
294;10.02.2017;2017;02;16;Perjantai;5;2;7;13;15;28
294;10.02.2017;2017;02;17;Perjantai;8;7;15;16;12;28
294;10.02.2017;2017;02;18;Perjantai;2;4;6;11;13;24
294;10.02.2017;2017;02;19;Perjantai;4;1;5;9;7;16
294;10.02.2017;2017;02;20;Perjantai;4;2;6;10;8;18
294;10.02.2017;2017;02;21;Perjantai;0;0;0;8;5;13
294;10.02.2017;2017;02;22;Perjantai;1;0;1;5;1;6
294;10.02.2017;2017;02;23;Perjantai;1;0;1;0;0;0
294;11.02.2017;2017;02;00;Lauantai;0;0;0;0;0;0
294;11.02.2017;2017;02;01;Lauantai;1;0;1;1;0;1
294;11.02.2017;2017;02;02;Lauantai;0;0;0;0;0;0
294;11.02.2017;2017;02;03;Lauantai;0;0;0;1;2;3
294;11.02.2017;2017;02;04;Lauantai;0;0;0;0;0;0
294;11.02.2017;2017;02;05;Lauantai;0;0;0;1;0;1
294;11.02.2017;2017;02;06;Lauantai;0;0;0;1;1;2
294;11.02.2017;2017;02;07;Lauantai;0;0;0;1;2;3
294;11.02.2017;2017;02;08;Lauantai;0;1;1;2;3;5
294;11.02.2017;2017;02;09;Lauantai;3;0;3;12;3;15
294;11.02.2017;2017;02;10;Lauantai;3;3;6;13;16;29
294;11.02.2017;2017;02;11;Lauantai;4;3;7;11;10;21
294;11.02.2017;2017;02;12;Lauantai;6;2;8;10;13;23
294;11.02.2017;2017;02;13;Lauantai;1;9;10;13;12;25
294;11.02.2017;2017;02;14;Lauantai;1;3;4;11;13;24
294;11.02.2017;2017;02;15;Lauantai;10;7;17;9;10;19
294;11.02.2017;2017;02;16;Lauantai;7;3;10;18;8;26
294;11.02.2017;2017;02;17;Lauantai;3;5;8;16;18;34
294;11.02.2017;2017;02;18;Lauantai;1;0;1;7;12;19
294;11.02.2017;2017;02;19;Lauantai;4;4;8;8;5;13
294;11.02.2017;2017;02;20;Lauantai;0;1;1;2;4;6
294;11.02.2017;2017;02;21;Lauantai;7;0;7;5;3;8
294;11.02.2017;2017;02;22;Lauantai;1;0;1;1;3;4
294;11.02.2017;2017;02;23;Lauantai;0;0;0;1;0;1
294;12.02.2017;2017;02;00;Sunnuntai;0;0;0;0;0;0
294;12.02.2017;2017;02;01;Sunnuntai;0;0;0;0;0;0
294;12.02.2017;2017;02;02;Sunnuntai;1;0;1;0;1;1
294;12.02.2017;2017;02;03;Sunnuntai;0;0;0;0;0;0
294;12.02.2017;2017;02;04;Sunnuntai;0;0;0;0;0;0
294;12.02.2017;2017;02;05;Sunnuntai;0;0;0;0;0;0
294;12.02.2017;2017;02;06;Sunnuntai;0;0;0;2;0;2
294;12.02.2017;2017;02;07;Sunnuntai;0;0;0;2;4;6
294;12.02.2017;2017;02;08;Sunnuntai;0;0;0;0;0;0
294;12.02.2017;2017;02;09;Sunnuntai;1;0;1;17;1;18
294;12.02.2017;2017;02;10;Sunnuntai;0;0;0;10;9;19
294;12.02.2017;2017;02;11;Sunnuntai;2;4;6;8;13;21
294;12.02.2017;2017;02;12;Sunnuntai;2;5;7;13;9;22
294;12.02.2017;2017;02;13;Sunnuntai;3;2;5;21;10;31
294;12.02.2017;2017;02;14;Sunnuntai;3;5;8;9;15;24
294;12.02.2017;2017;02;15;Sunnuntai;5;5;10;11;7;18
294;12.02.2017;2017;02;16;Sunnuntai;4;3;7;11;12;23
294;12.02.2017;2017;02;17;Sunnuntai;6;3;9;8;9;17
294;12.02.2017;2017;02;18;Sunnuntai;2;3;5;9;6;15
294;12.02.2017;2017;02;19;Sunnuntai;2;0;2;4;5;9
294;12.02.2017;2017;02;20;Sunnuntai;1;0;1;6;2;8
294;12.02.2017;2017;02;21;Sunnuntai;1;0;1;2;0;2
294;12.02.2017;2017;02;22;Sunnuntai;0;0;0;1;0;1
294;12.02.2017;2017;02;23;Sunnuntai;0;0;0;0;0;0
294;13.02.2017;2017;02;00;Maanantai;0;0;0;0;0;0
294;13.02.2017;2017;02;01;Maanantai;0;0;0;0;0;0
294;13.02.2017;2017;02;02;Maanantai;0;0;0;0;0;0
294;13.02.2017;2017;02;03;Maanantai;0;0;0;0;0;0
294;13.02.2017;2017;02;04;Maanantai;0;0;0;0;0;0
294;13.02.2017;2017;02;05;Maanantai;0;0;0;2;0;2
294;13.02.2017;2017;02;06;Maanantai;1;1;2;5;3;8
294;13.02.2017;2017;02;07;Maanantai;12;4;16;4;8;12
294;13.02.2017;2017;02;08;Maanantai;8;2;10;14;10;24
294;13.02.2017;2017;02;09;Maanantai;15;6;21;20;6;26
294;13.02.2017;2017;02;10;Maanantai;1;1;2;14;17;31
294;13.02.2017;2017;02;11;Maanantai;3;5;8;21;18;39
294;13.02.2017;2017;02;12;Maanantai;2;6;8;30;21;51
294;13.02.2017;2017;02;13;Maanantai;8;16;24;19;22;41
294;13.02.2017;2017;02;14;Maanantai;10;17;27;27;27;54
294;13.02.2017;2017;02;15;Maanantai;2;17;19;18;33;51
294;13.02.2017;2017;02;16;Maanantai;6;7;13;17;19;36
294;13.02.2017;2017;02;17;Maanantai;2;7;9;9;5;14
294;13.02.2017;2017;02;18;Maanantai;2;5;7;20;15;35
294;13.02.2017;2017;02;19;Maanantai;4;0;4;13;6;19
294;13.02.2017;2017;02;20;Maanantai;1;1;2;2;6;8
294;13.02.2017;2017;02;21;Maanantai;0;0;0;0;1;1
294;13.02.2017;2017;02;22;Maanantai;0;0;0;1;1;2
294;13.02.2017;2017;02;23;Maanantai;0;0;0;0;0;0
294;14.02.2017;2017;02;00;Tiistai;0;0;0;0;0;0
294;14.02.2017;2017;02;01;Tiistai;0;0;0;0;0;0
294;14.02.2017;2017;02;02;Tiistai;0;0;0;0;0;0
294;14.02.2017;2017;02;03;Tiistai;0;0;0;0;0;0
294;14.02.2017;2017;02;04;Tiistai;0;0;0;0;1;1
294;14.02.2017;2017;02;05;Tiistai;1;0;1;3;1;4
294;14.02.2017;2017;02;06;Tiistai;1;2;3;3;1;4
294;14.02.2017;2017;02;07;Tiistai;8;1;9;17;6;23
294;14.02.2017;2017;02;08;Tiistai;7;3;10;12;7;19
294;14.02.2017;2017;02;09;Tiistai;6;2;8;15;10;25
294;14.02.2017;2017;02;10;Tiistai;4;7;11;15;14;29
294;14.02.2017;2017;02;11;Tiistai;7;5;12;15;14;29
294;14.02.2017;2017;02;12;Tiistai;1;4;5;16;29;45
294;14.02.2017;2017;02;13;Tiistai;4;3;7;16;19;35
294;14.02.2017;2017;02;14;Tiistai;6;2;8;26;12;38
294;14.02.2017;2017;02;15;Tiistai;2;15;17;12;20;32
294;14.02.2017;2017;02;16;Tiistai;10;7;17;20;19;39
294;14.02.2017;2017;02;17;Tiistai;8;6;14;14;12;26
294;14.02.2017;2017;02;18;Tiistai;2;3;5;17;18;35
294;14.02.2017;2017;02;19;Tiistai;1;2;3;10;9;19
294;14.02.2017;2017;02;20;Tiistai;2;4;6;6;3;9
294;14.02.2017;2017;02;21;Tiistai;1;0;1;3;1;4
294;14.02.2017;2017;02;22;Tiistai;0;0;0;0;0;0
294;14.02.2017;2017;02;23;Tiistai;0;0;0;0;0;0
294;15.02.2017;2017;02;00;Keskiviikko;0;0;0;0;0;0
294;15.02.2017;2017;02;01;Keskiviikko;0;0;0;0;0;0
294;15.02.2017;2017;02;02;Keskiviikko;0;0;0;0;0;0
294;15.02.2017;2017;02;03;Keskiviikko;0;0;0;0;0;0
294;15.02.2017;2017;02;04;Keskiviikko;0;0;0;0;1;1
294;15.02.2017;2017;02;05;Keskiviikko;0;0;0;2;2;4
294;15.02.2017;2017;02;06;Keskiviikko;1;2;3;7;3;10
294;15.02.2017;2017;02;07;Keskiviikko;6;2;8;8;5;13
294;15.02.2017;2017;02;08;Keskiviikko;8;1;9;11;7;18
294;15.02.2017;2017;02;09;Keskiviikko;11;7;18;23;9;32
294;15.02.2017;2017;02;10;Keskiviikko;5;8;13;20;13;33
294;15.02.2017;2017;02;11;Keskiviikko;5;6;11;17;20;37
294;15.02.2017;2017;02;12;Keskiviikko;4;2;6;20;18;38
294;15.02.2017;2017;02;13;Keskiviikko;5;9;14;13;19;32
294;15.02.2017;2017;02;14;Keskiviikko;9;12;21;15;15;30
294;15.02.2017;2017;02;15;Keskiviikko;7;7;14;19;17;36
294;15.02.2017;2017;02;16;Keskiviikko;3;5;8;10;11;21
294;15.02.2017;2017;02;17;Keskiviikko;6;9;15;11;14;25
294;15.02.2017;2017;02;18;Keskiviikko;1;8;9;9;15;24
294;15.02.2017;2017;02;19;Keskiviikko;4;3;7;12;9;21
294;15.02.2017;2017;02;20;Keskiviikko;1;3;4;5;4;9
294;15.02.2017;2017;02;21;Keskiviikko;0;0;0;4;3;7
294;15.02.2017;2017;02;22;Keskiviikko;0;0;0;0;1;1
294;15.02.2017;2017;02;23;Keskiviikko;0;0;0;1;0;1
294;16.02.2017;2017;02;00;Torstai;0;0;0;0;0;0
294;16.02.2017;2017;02;01;Torstai;0;0;0;0;0;0
294;16.02.2017;2017;02;02;Torstai;0;0;0;0;0;0
294;16.02.2017;2017;02;03;Torstai;0;0;0;0;0;0
294;16.02.2017;2017;02;04;Torstai;0;0;0;0;0;0
294;16.02.2017;2017;02;05;Torstai;0;0;0;2;0;2
294;16.02.2017;2017;02;06;Torstai;2;0;2;3;0;3
294;16.02.2017;2017;02;07;Torstai;15;0;15;18;4;22
294;16.02.2017;2017;02;08;Torstai;7;2;9;14;4;18
294;16.02.2017;2017;02;09;Torstai;6;4;10;23;13;36
294;16.02.2017;2017;02;10;Torstai;3;3;6;21;14;35
294;16.02.2017;2017;02;11;Torstai;2;3;5;26;18;44
294;16.02.2017;2017;02;12;Torstai;3;4;7;18;20;38
294;16.02.2017;2017;02;13;Torstai;4;18;22;16;10;26
294;16.02.2017;2017;02;14;Torstai;10;10;20;18;14;32
294;16.02.2017;2017;02;15;Torstai;8;11;19;16;24;40
294;16.02.2017;2017;02;16;Torstai;6;5;11;18;14;32
294;16.02.2017;2017;02;17;Torstai;6;5;11;27;27;54
294;16.02.2017;2017;02;18;Torstai;4;1;5;23;12;35
294;16.02.2017;2017;02;19;Torstai;1;11;12;15;23;38
294;16.02.2017;2017;02;20;Torstai;2;3;5;4;5;9
294;16.02.2017;2017;02;21;Torstai;0;1;1;3;5;8
294;16.02.2017;2017;02;22;Torstai;0;0;0;3;0;3
294;16.02.2017;2017;02;23;Torstai;0;0;0;0;0;0
294;17.02.2017;2017;02;00;Perjantai;0;0;0;0;0;0
294;17.02.2017;2017;02;01;Perjantai;0;0;0;0;0;0
294;17.02.2017;2017;02;02;Perjantai;0;0;0;0;0;0
294;17.02.2017;2017;02;03;Perjantai;0;0;0;0;0;0
294;17.02.2017;2017;02;04;Perjantai;0;0;0;0;0;0
294;17.02.2017;2017;02;05;Perjantai;1;0;1;2;0;2
294;17.02.2017;2017;02;06;Perjantai;0;2;2;4;2;6
294;17.02.2017;2017;02;07;Perjantai;12;3;15;6;5;11
294;17.02.2017;2017;02;08;Perjantai;7;0;7;10;7;17
294;17.02.2017;2017;02;09;Perjantai;17;4;21;43;8;51
294;17.02.2017;2017;02;10;Perjantai;1;5;6;14;25;39
294;17.02.2017;2017;02;11;Perjantai;4;4;8;15;19;34
294;17.02.2017;2017;02;12;Perjantai;9;7;16;22;16;38
294;17.02.2017;2017;02;13;Perjantai;15;19;34;12;20;32
294;17.02.2017;2017;02;14;Perjantai;5;17;22;18;35;53
294;17.02.2017;2017;02;15;Perjantai;4;4;8;16;26;42
294;17.02.2017;2017;02;16;Perjantai;6;14;20;17;13;30
294;17.02.2017;2017;02;17;Perjantai;2;5;7;12;17;29
294;17.02.2017;2017;02;18;Perjantai;2;4;6;16;10;26
294;17.02.2017;2017;02;19;Perjantai;3;1;4;12;14;26
294;17.02.2017;2017;02;20;Perjantai;3;3;6;7;2;9
294;17.02.2017;2017;02;21;Perjantai;1;1;2;4;3;7
294;17.02.2017;2017;02;22;Perjantai;2;0;2;3;0;3
294;17.02.2017;2017;02;23;Perjantai;0;0;0;2;0;2
294;18.02.2017;2017;02;00;Lauantai;0;0;0;1;0;1
294;18.02.2017;2017;02;01;Lauantai;0;0;0;1;0;1
294;18.02.2017;2017;02;02;Lauantai;0;0;0;0;2;2
294;18.02.2017;2017;02;03;Lauantai;0;0;0;0;0;0
294;18.02.2017;2017;02;04;Lauantai;0;0;0;0;0;0
294;18.02.2017;2017;02;05;Lauantai;0;0;0;1;0;1
294;18.02.2017;2017;02;06;Lauantai;0;0;0;1;0;1
294;18.02.2017;2017;02;07;Lauantai;0;0;0;2;3;5
294;18.02.2017;2017;02;08;Lauantai;1;0;1;4;1;5
294;18.02.2017;2017;02;09;Lauantai;4;1;5;9;13;22
294;18.02.2017;2017;02;10;Lauantai;0;0;0;17;21;38
294;18.02.2017;2017;02;11;Lauantai;1;3;4;27;17;44
294;18.02.2017;2017;02;12;Lauantai;7;2;9;16;44;60
294;18.02.2017;2017;02;13;Lauantai;3;3;6;22;23;45
294;18.02.2017;2017;02;14;Lauantai;6;14;20;24;16;40
294;18.02.2017;2017;02;15;Lauantai;8;6;14;17;19;36
294;18.02.2017;2017;02;16;Lauantai;0;3;3;16;20;36
294;18.02.2017;2017;02;17;Lauantai;1;3;4;15;5;20
294;18.02.2017;2017;02;18;Lauantai;5;3;8;11;9;20
294;18.02.2017;2017;02;19;Lauantai;5;4;9;4;7;11
294;18.02.2017;2017;02;20;Lauantai;1;2;3;2;1;3
294;18.02.2017;2017;02;21;Lauantai;3;2;5;1;1;2
294;18.02.2017;2017;02;22;Lauantai;1;0;1;0;0;0
294;18.02.2017;2017;02;23;Lauantai;0;0;0;0;0;0
294;19.02.2017;2017;02;00;Sunnuntai;0;0;0;2;1;3
294;19.02.2017;2017;02;01;Sunnuntai;0;0;0;0;0;0
294;19.02.2017;2017;02;02;Sunnuntai;0;0;0;0;0;0
294;19.02.2017;2017;02;03;Sunnuntai;0;0;0;0;0;0
294;19.02.2017;2017;02;04;Sunnuntai;0;0;0;1;0;1
294;19.02.2017;2017;02;05;Sunnuntai;0;0;0;2;0;2
294;19.02.2017;2017;02;06;Sunnuntai;1;0;1;2;1;3
294;19.02.2017;2017;02;07;Sunnuntai;0;0;0;3;2;5
294;19.02.2017;2017;02;08;Sunnuntai;0;0;0;1;1;2
294;19.02.2017;2017;02;09;Sunnuntai;4;0;4;12;5;17
294;19.02.2017;2017;02;10;Sunnuntai;0;1;1;12;10;22
294;19.02.2017;2017;02;11;Sunnuntai;1;3;4;4;9;13
294;19.02.2017;2017;02;12;Sunnuntai;1;1;2;10;4;14
294;19.02.2017;2017;02;13;Sunnuntai;0;8;8;16;16;32
294;19.02.2017;2017;02;14;Sunnuntai;1;4;5;14;13;27
294;19.02.2017;2017;02;15;Sunnuntai;1;2;3;14;5;19
294;19.02.2017;2017;02;16;Sunnuntai;2;2;4;12;8;20
294;19.02.2017;2017;02;17;Sunnuntai;5;4;9;10;9;19
294;19.02.2017;2017;02;18;Sunnuntai;7;8;15;10;10;20
294;19.02.2017;2017;02;19;Sunnuntai;3;4;7;7;6;13
294;19.02.2017;2017;02;20;Sunnuntai;2;1;3;3;6;9
294;19.02.2017;2017;02;21;Sunnuntai;1;0;1;1;1;2
294;19.02.2017;2017;02;22;Sunnuntai;0;0;0;0;0;0
294;19.02.2017;2017;02;23;Sunnuntai;0;0;0;0;0;0
294;20.02.2017;2017;02;00;Maanantai;0;0;0;0;0;0
294;20.02.2017;2017;02;01;Maanantai;0;0;0;0;0;0
294;20.02.2017;2017;02;02;Maanantai;0;0;0;0;0;0
294;20.02.2017;2017;02;03;Maanantai;0;0;0;0;0;0
294;20.02.2017;2017;02;04;Maanantai;0;0;0;1;0;1
294;20.02.2017;2017;02;05;Maanantai;0;0;0;2;2;4
294;20.02.2017;2017;02;06;Maanantai;4;0;4;6;4;10
294;20.02.2017;2017;02;07;Maanantai;8;5;13;3;3;6
294;20.02.2017;2017;02;08;Maanantai;11;1;12;14;7;21
294;20.02.2017;2017;02;09;Maanantai;11;5;16;21;11;32
294;20.02.2017;2017;02;10;Maanantai;0;1;1;14;12;26
294;20.02.2017;2017;02;11;Maanantai;4;7;11;19;16;35
294;20.02.2017;2017;02;12;Maanantai;4;3;7;14;17;31
294;20.02.2017;2017;02;13;Maanantai;4;17;21;21;25;46
294;20.02.2017;2017;02;14;Maanantai;9;14;23;21;21;42
294;20.02.2017;2017;02;15;Maanantai;5;9;14;13;11;24
294;20.02.2017;2017;02;16;Maanantai;3;5;8;14;19;33
294;20.02.2017;2017;02;17;Maanantai;7;10;17;12;14;26
294;20.02.2017;2017;02;18;Maanantai;8;9;17;19;17;36
294;20.02.2017;2017;02;19;Maanantai;7;6;13;13;7;20
294;20.02.2017;2017;02;20;Maanantai;4;1;5;4;5;9
294;20.02.2017;2017;02;21;Maanantai;0;0;0;2;1;3
294;20.02.2017;2017;02;22;Maanantai;0;0;0;0;1;1
294;20.02.2017;2017;02;23;Maanantai;0;0;0;0;0;0
294;21.02.2017;2017;02;00;Tiistai;0;0;0;0;0;0
294;21.02.2017;2017;02;01;Tiistai;0;0;0;0;0;0
294;21.02.2017;2017;02;02;Tiistai;0;0;0;0;0;0
294;21.02.2017;2017;02;03;Tiistai;0;0;0;0;0;0
294;21.02.2017;2017;02;04;Tiistai;0;0;0;0;1;1
294;21.02.2017;2017;02;05;Tiistai;0;0;0;2;1;3
294;21.02.2017;2017;02;06;Tiistai;1;1;2;2;2;4
294;21.02.2017;2017;02;07;Tiistai;9;5;14;17;4;21
294;21.02.2017;2017;02;08;Tiistai;7;2;9;15;6;21
294;21.02.2017;2017;02;09;Tiistai;10;1;11;23;11;34
294;21.02.2017;2017;02;10;Tiistai;4;2;6;10;23;33
294;21.02.2017;2017;02;11;Tiistai;3;7;10;28;22;50
294;21.02.2017;2017;02;12;Tiistai;2;10;12;22;27;49
294;21.02.2017;2017;02;13;Tiistai;8;4;12;11;15;26
294;21.02.2017;2017;02;14;Tiistai;5;1;6;21;19;40
294;21.02.2017;2017;02;15;Tiistai;6;9;15;14;19;33
294;21.02.2017;2017;02;16;Tiistai;3;5;8;15;17;32
294;21.02.2017;2017;02;17;Tiistai;15;6;21;14;8;22
294;21.02.2017;2017;02;18;Tiistai;2;1;3;6;12;18
294;21.02.2017;2017;02;19;Tiistai;3;3;6;5;10;15
294;21.02.2017;2017;02;20;Tiistai;0;2;2;7;6;13
294;21.02.2017;2017;02;21;Tiistai;0;1;1;1;0;1
294;21.02.2017;2017;02;22;Tiistai;0;0;0;0;0;0
294;21.02.2017;2017;02;23;Tiistai;1;0;1;0;0;0
294;22.02.2017;2017;02;00;Keskiviikko;0;0;0;0;0;0
294;22.02.2017;2017;02;01;Keskiviikko;0;0;0;0;0;0
294;22.02.2017;2017;02;02;Keskiviikko;0;0;0;0;0;0
294;22.02.2017;2017;02;03;Keskiviikko;0;0;0;0;0;0
294;22.02.2017;2017;02;04;Keskiviikko;0;0;0;1;1;2
294;22.02.2017;2017;02;05;Keskiviikko;1;0;1;1;0;1
294;22.02.2017;2017;02;06;Keskiviikko;0;1;1;2;2;4
294;22.02.2017;2017;02;07;Keskiviikko;6;6;12;9;3;12
294;22.02.2017;2017;02;08;Keskiviikko;5;0;5;7;5;12
294;22.02.2017;2017;02;09;Keskiviikko;7;6;13;17;11;28
294;22.02.2017;2017;02;10;Keskiviikko;5;2;7;11;22;33
294;22.02.2017;2017;02;11;Keskiviikko;9;5;14;24;10;34
294;22.02.2017;2017;02;12;Keskiviikko;6;6;12;11;9;20
294;22.02.2017;2017;02;13;Keskiviikko;5;18;23;12;14;26
294;22.02.2017;2017;02;14;Keskiviikko;9;15;24;18;25;43
294;22.02.2017;2017;02;15;Keskiviikko;5;3;8;15;11;26
294;22.02.2017;2017;02;16;Keskiviikko;4;1;5;24;4;28
294;22.02.2017;2017;02;17;Keskiviikko;4;3;7;21;18;39
294;22.02.2017;2017;02;18;Keskiviikko;4;5;9;16;10;26
294;22.02.2017;2017;02;19;Keskiviikko;5;6;11;9;11;20
294;22.02.2017;2017;02;20;Keskiviikko;1;1;2;6;2;8
294;22.02.2017;2017;02;21;Keskiviikko;0;3;3;0;1;1
294;22.02.2017;2017;02;22;Keskiviikko;0;0;0;1;0;1
294;22.02.2017;2017;02;23;Keskiviikko;1;0;1;0;0;0
294;23.02.2017;2017;02;00;Torstai;0;0;0;0;0;0
294;23.02.2017;2017;02;01;Torstai;0;0;0;0;0;0
294;23.02.2017;2017;02;02;Torstai;0;0;0;0;0;0
294;23.02.2017;2017;02;03;Torstai;0;0;0;0;0;0
294;23.02.2017;2017;02;04;Torstai;0;0;0;1;1;2
294;23.02.2017;2017;02;05;Torstai;0;0;0;1;1;2
294;23.02.2017;2017;02;06;Torstai;1;1;2;3;2;5
294;23.02.2017;2017;02;07;Torstai;13;0;13;14;9;23
294;23.02.2017;2017;02;08;Torstai;11;1;12;10;3;13
294;23.02.2017;2017;02;09;Torstai;6;3;9;20;10;30
294;23.02.2017;2017;02;10;Torstai;0;2;2;10;11;21
294;23.02.2017;2017;02;11;Torstai;3;6;9;15;13;28
294;23.02.2017;2017;02;12;Torstai;5;7;12;11;17;28
294;23.02.2017;2017;02;13;Torstai;3;20;23;12;13;25
294;23.02.2017;2017;02;14;Torstai;4;10;14;15;13;28
294;23.02.2017;2017;02;15;Torstai;2;8;10;10;17;27
294;23.02.2017;2017;02;16;Torstai;2;2;4;7;6;13
294;23.02.2017;2017;02;17;Torstai;9;4;13;15;8;23
294;23.02.2017;2017;02;18;Torstai;10;8;18;10;6;16
294;23.02.2017;2017;02;19;Torstai;2;2;4;7;14;21
294;23.02.2017;2017;02;20;Torstai;2;1;3;4;3;7
294;23.02.2017;2017;02;21;Torstai;1;3;4;2;0;2
294;23.02.2017;2017;02;22;Torstai;0;0;0;1;0;1
294;23.02.2017;2017;02;23;Torstai;0;0;0;0;0;0
294;24.02.2017;2017;02;00;Perjantai;0;0;0;0;0;0
294;24.02.2017;2017;02;01;Perjantai;0;0;0;0;0;0
294;24.02.2017;2017;02;02;Perjantai;0;0;0;0;0;0
294;24.02.2017;2017;02;03;Perjantai;0;0;0;0;0;0
294;24.02.2017;2017;02;04;Perjantai;0;0;0;0;0;0
294;24.02.2017;2017;02;05;Perjantai;0;0;0;2;0;2
294;24.02.2017;2017;02;06;Perjantai;1;2;3;0;2;2
294;24.02.2017;2017;02;07;Perjantai;10;3;13;9;5;14
294;24.02.2017;2017;02;08;Perjantai;5;0;5;7;4;11
294;24.02.2017;2017;02;09;Perjantai;9;2;11;14;8;22
294;24.02.2017;2017;02;10;Perjantai;1;2;3;8;11;19
294;24.02.2017;2017;02;11;Perjantai;3;6;9;6;18;24
294;24.02.2017;2017;02;12;Perjantai;11;14;25;16;28;44
294;24.02.2017;2017;02;13;Perjantai;5;6;11;16;12;28
294;24.02.2017;2017;02;14;Perjantai;1;14;15;16;17;33
294;24.02.2017;2017;02;15;Perjantai;4;7;11;19;13;32
294;24.02.2017;2017;02;16;Perjantai;4;1;5;17;17;34
294;24.02.2017;2017;02;17;Perjantai;5;8;13;8;8;16
294;24.02.2017;2017;02;18;Perjantai;3;7;10;20;14;34
294;24.02.2017;2017;02;19;Perjantai;10;2;12;11;6;17
294;24.02.2017;2017;02;20;Perjantai;3;3;6;5;1;6
294;24.02.2017;2017;02;21;Perjantai;2;3;5;3;1;4
294;24.02.2017;2017;02;22;Perjantai;0;0;0;0;0;0
294;24.02.2017;2017;02;23;Perjantai;1;0;1;0;0;0
294;25.02.2017;2017;02;00;Lauantai;0;0;0;0;0;0
294;25.02.2017;2017;02;01;Lauantai;2;0;2;0;0;0
294;25.02.2017;2017;02;02;Lauantai;0;0;0;0;1;1
294;25.02.2017;2017;02;03;Lauantai;0;0;0;0;0;0
294;25.02.2017;2017;02;04;Lauantai;0;0;0;0;0;0
294;25.02.2017;2017;02;05;Lauantai;0;0;0;3;0;3
294;25.02.2017;2017;02;06;Lauantai;0;0;0;1;0;1
294;25.02.2017;2017;02;07;Lauantai;0;1;1;1;2;3
294;25.02.2017;2017;02;08;Lauantai;0;1;1;7;7;14
294;25.02.2017;2017;02;09;Lauantai;4;2;6;11;13;24
294;25.02.2017;2017;02;10;Lauantai;0;1;1;21;15;36
294;25.02.2017;2017;02;11;Lauantai;1;2;3;14;18;32
294;25.02.2017;2017;02;12;Lauantai;1;3;4;16;22;38
294;25.02.2017;2017;02;13;Lauantai;5;0;5;17;19;36
294;25.02.2017;2017;02;14;Lauantai;3;4;7;14;14;28
294;25.02.2017;2017;02;15;Lauantai;4;9;13;14;13;27
294;25.02.2017;2017;02;16;Lauantai;2;2;4;22;13;35
294;25.02.2017;2017;02;17;Lauantai;5;4;9;6;5;11
294;25.02.2017;2017;02;18;Lauantai;1;2;3;14;11;25
294;25.02.2017;2017;02;19;Lauantai;4;3;7;5;2;7
294;25.02.2017;2017;02;20;Lauantai;0;2;2;0;1;1
294;25.02.2017;2017;02;21;Lauantai;3;1;4;5;0;5
294;25.02.2017;2017;02;22;Lauantai;0;0;0;1;0;1
294;25.02.2017;2017;02;23;Lauantai;0;0;0;2;0;2
294;26.02.2017;2017;02;00;Sunnuntai;0;0;0;1;0;1
294;26.02.2017;2017;02;01;Sunnuntai;0;0;0;0;0;0
294;26.02.2017;2017;02;02;Sunnuntai;0;0;0;1;0;1
294;26.02.2017;2017;02;03;Sunnuntai;0;0;0;0;0;0
294;26.02.2017;2017;02;04;Sunnuntai;0;0;0;0;0;0
294;26.02.2017;2017;02;05;Sunnuntai;0;0;0;3;0;3
294;26.02.2017;2017;02;06;Sunnuntai;0;0;0;2;0;2
294;26.02.2017;2017;02;07;Sunnuntai;0;0;0;0;1;1
294;26.02.2017;2017;02;08;Sunnuntai;0;0;0;3;6;9
294;26.02.2017;2017;02;09;Sunnuntai;1;0;1;15;4;19
294;26.02.2017;2017;02;10;Sunnuntai;0;3;3;9;9;18
294;26.02.2017;2017;02;11;Sunnuntai;2;2;4;13;21;34
294;26.02.2017;2017;02;12;Sunnuntai;4;1;5;19;19;38
294;26.02.2017;2017;02;13;Sunnuntai;5;3;8;12;15;27
294;26.02.2017;2017;02;14;Sunnuntai;1;6;7;10;18;28
294;26.02.2017;2017;02;15;Sunnuntai;5;2;7;14;5;19
294;26.02.2017;2017;02;16;Sunnuntai;3;0;3;11;15;26
294;26.02.2017;2017;02;17;Sunnuntai;3;3;6;14;15;29
294;26.02.2017;2017;02;18;Sunnuntai;4;3;7;2;2;4
294;26.02.2017;2017;02;19;Sunnuntai;2;0;2;5;2;7
294;26.02.2017;2017;02;20;Sunnuntai;0;0;0;1;2;3
294;26.02.2017;2017;02;21;Sunnuntai;0;0;0;1;0;1
294;26.02.2017;2017;02;22;Sunnuntai;0;0;0;0;0;0
294;26.02.2017;2017;02;23;Sunnuntai;0;0;0;0;0;0
294;27.02.2017;2017;02;00;Maanantai;0;0;0;0;0;0
294;27.02.2017;2017;02;01;Maanantai;0;0;0;0;0;0
294;27.02.2017;2017;02;02;Maanantai;0;0;0;0;0;0
294;27.02.2017;2017;02;03;Maanantai;0;0;0;0;0;0
294;27.02.2017;2017;02;04;Maanantai;0;0;0;0;0;0
294;27.02.2017;2017;02;05;Maanantai;0;0;0;2;1;3
294;27.02.2017;2017;02;06;Maanantai;0;0;0;3;2;5
294;27.02.2017;2017;02;07;Maanantai;5;2;7;5;3;8
294;27.02.2017;2017;02;08;Maanantai;10;4;14;10;4;14
294;27.02.2017;2017;02;09;Maanantai;6;0;6;13;7;20
294;27.02.2017;2017;02;10;Maanantai;4;1;5;8;6;14
294;27.02.2017;2017;02;11;Maanantai;1;4;5;24;15;39
294;27.02.2017;2017;02;12;Maanantai;4;3;7;15;18;33
294;27.02.2017;2017;02;13;Maanantai;4;15;19;27;33;60
294;27.02.2017;2017;02;14;Maanantai;5;12;17;23;18;41
294;27.02.2017;2017;02;15;Maanantai;7;13;20;11;19;30
294;27.02.2017;2017;02;16;Maanantai;8;3;11;18;23;41
294;27.02.2017;2017;02;17;Maanantai;3;3;6;10;8;18
294;27.02.2017;2017;02;18;Maanantai;6;1;7;9;8;17
294;27.02.2017;2017;02;19;Maanantai;0;3;3;14;6;20
294;27.02.2017;2017;02;20;Maanantai;1;2;3;4;1;5
294;27.02.2017;2017;02;21;Maanantai;0;0;0;2;1;3
294;27.02.2017;2017;02;22;Maanantai;0;0;0;0;0;0
294;27.02.2017;2017;02;23;Maanantai;0;0;0;0;0;0
294;28.02.2017;2017;02;00;Tiistai;0;0;0;0;0;0
294;28.02.2017;2017;02;01;Tiistai;0;0;0;0;0;0
294;28.02.2017;2017;02;02;Tiistai;0;0;0;0;0;0
294;28.02.2017;2017;02;03;Tiistai;0;0;0;0;0;0
294;28.02.2017;2017;02;04;Tiistai;0;0;0;0;1;1
294;28.02.2017;2017;02;05;Tiistai;1;0;1;2;0;2
294;28.02.2017;2017;02;06;Tiistai;0;3;3;5;1;6
294;28.02.2017;2017;02;07;Tiistai;9;4;13;13;7;20
294;28.02.2017;2017;02;08;Tiistai;8;1;9;17;8;25
294;28.02.2017;2017;02;09;Tiistai;11;4;15;20;8;28
294;28.02.2017;2017;02;10;Tiistai;3;1;4;13;21;34
294;28.02.2017;2017;02;11;Tiistai;4;4;8;18;22;40
294;28.02.2017;2017;02;12;Tiistai;4;4;8;24;13;37
294;28.02.2017;2017;02;13;Tiistai;4;7;11;21;11;32
294;28.02.2017;2017;02;14;Tiistai;9;4;13;18;12;30
294;28.02.2017;2017;02;15;Tiistai;9;23;32;14;21;35
294;28.02.2017;2017;02;16;Tiistai;6;3;9;20;13;33
294;28.02.2017;2017;02;17;Tiistai;5;7;12;13;18;31
294;28.02.2017;2017;02;18;Tiistai;1;4;5;13;15;28
294;28.02.2017;2017;02;19;Tiistai;4;6;10;8;12;20
294;28.02.2017;2017;02;20;Tiistai;3;2;5;9;5;14
294;28.02.2017;2017;02;21;Tiistai;2;0;2;0;2;2
294;28.02.2017;2017;02;22;Tiistai;0;0;0;1;0;1
294;28.02.2017;2017;02;23;Tiistai;1;0;1;0;0;0
294;01.03.2017;2017;03;00;Keskiviikko;0;0;0;0;0;0
294;01.03.2017;2017;03;01;Keskiviikko;0;0;0;0;0;0
294;01.03.2017;2017;03;02;Keskiviikko;0;0;0;0;0;0
294;01.03.2017;2017;03;03;Keskiviikko;0;0;0;0;0;0
294;01.03.2017;2017;03;04;Keskiviikko;0;0;0;0;1;1
294;01.03.2017;2017;03;05;Keskiviikko;0;0;0;1;1;2
294;01.03.2017;2017;03;06;Keskiviikko;1;0;1;4;1;5
294;01.03.2017;2017;03;07;Keskiviikko;3;3;6;10;8;18
294;01.03.2017;2017;03;08;Keskiviikko;3;1;4;16;14;30
294;01.03.2017;2017;03;09;Keskiviikko;4;6;10;34;15;49
294;01.03.2017;2017;03;10;Keskiviikko;2;1;3;18;13;31
294;01.03.2017;2017;03;11;Keskiviikko;5;3;8;19;19;38
294;01.03.2017;2017;03;12;Keskiviikko;1;3;4;13;12;25
294;01.03.2017;2017;03;13;Keskiviikko;3;11;14;19;11;30
294;01.03.2017;2017;03;14;Keskiviikko;1;8;9;12;15;27
294;01.03.2017;2017;03;15;Keskiviikko;8;4;12;7;12;19
294;01.03.2017;2017;03;16;Keskiviikko;1;2;3;10;5;15
294;01.03.2017;2017;03;17;Keskiviikko;4;4;8;16;13;29
294;01.03.2017;2017;03;18;Keskiviikko;6;4;10;15;8;23
294;01.03.2017;2017;03;19;Keskiviikko;0;0;0;13;11;24
294;01.03.2017;2017;03;20;Keskiviikko;2;2;4;4;5;9
294;01.03.2017;2017;03;21;Keskiviikko;0;0;0;6;3;9
294;01.03.2017;2017;03;22;Keskiviikko;0;0;0;0;1;1
294;01.03.2017;2017;03;23;Keskiviikko;0;0;0;0;0;0
294;02.03.2017;2017;03;00;Torstai;0;0;0;0;0;0
294;02.03.2017;2017;03;01;Torstai;0;0;0;0;0;0
294;02.03.2017;2017;03;02;Torstai;0;0;0;0;0;0
294;02.03.2017;2017;03;03;Torstai;0;0;0;0;0;0
294;02.03.2017;2017;03;04;Torstai;0;0;0;0;1;1
294;02.03.2017;2017;03;05;Torstai;1;0;1;2;0;2
294;02.03.2017;2017;03;06;Torstai;1;1;2;3;2;5
294;02.03.2017;2017;03;07;Torstai;10;1;11;13;7;20
294;02.03.2017;2017;03;08;Torstai;7;3;10;21;3;24
294;02.03.2017;2017;03;09;Torstai;2;3;5;11;9;20
294;02.03.2017;2017;03;10;Torstai;0;3;3;14;17;31
294;02.03.2017;2017;03;11;Torstai;0;1;1;15;12;27
294;02.03.2017;2017;03;12;Torstai;2;16;18;19;17;36
294;02.03.2017;2017;03;13;Torstai;3;7;10;16;13;29
294;02.03.2017;2017;03;14;Torstai;7;13;20;20;17;37
294;02.03.2017;2017;03;15;Torstai;4;6;10;10;18;28
294;02.03.2017;2017;03;16;Torstai;0;2;2;15;11;26
294;02.03.2017;2017;03;17;Torstai;2;3;5;9;14;23
294;02.03.2017;2017;03;18;Torstai;3;1;4;21;12;33
294;02.03.2017;2017;03;19;Torstai;0;5;5;8;9;17
294;02.03.2017;2017;03;20;Torstai;0;4;4;6;3;9
294;02.03.2017;2017;03;21;Torstai;0;0;0;3;2;5
294;02.03.2017;2017;03;22;Torstai;0;0;0;2;1;3
294;02.03.2017;2017;03;23;Torstai;0;0;0;0;0;0
294;03.03.2017;2017;03;00;Perjantai;0;0;0;0;0;0
294;03.03.2017;2017;03;01;Perjantai;0;0;0;0;0;0
294;03.03.2017;2017;03;02;Perjantai;0;0;0;0;0;0
294;03.03.2017;2017;03;03;Perjantai;0;0;0;0;0;0
294;03.03.2017;2017;03;04;Perjantai;0;0;0;0;0;0
294;03.03.2017;2017;03;05;Perjantai;0;0;0;2;0;2
294;03.03.2017;2017;03;06;Perjantai;1;0;1;2;2;4
294;03.03.2017;2017;03;07;Perjantai;7;4;11;11;12;23
294;03.03.2017;2017;03;08;Perjantai;8;0;8;11;4;15
294;03.03.2017;2017;03;09;Perjantai;6;2;8;29;6;35
294;03.03.2017;2017;03;10;Perjantai;7;3;10;24;24;48
294;03.03.2017;2017;03;11;Perjantai;4;10;14;23;34;57
294;03.03.2017;2017;03;12;Perjantai;11;11;22;22;24;46
294;03.03.2017;2017;03;13;Perjantai;5;11;16;11;23;34
294;03.03.2017;2017;03;14;Perjantai;4;8;12;17;21;38
294;03.03.2017;2017;03;15;Perjantai;4;8;12;17;25;42
294;03.03.2017;2017;03;16;Perjantai;7;2;9;19;9;28
294;03.03.2017;2017;03;17;Perjantai;3;5;8;16;19;35
294;03.03.2017;2017;03;18;Perjantai;1;1;2;13;9;22
294;03.03.2017;2017;03;19;Perjantai;2;5;7;12;5;17
294;03.03.2017;2017;03;20;Perjantai;5;0;5;4;11;15
294;03.03.2017;2017;03;21;Perjantai;3;0;3;4;2;6
294;03.03.2017;2017;03;22;Perjantai;3;0;3;2;1;3
294;03.03.2017;2017;03;23;Perjantai;0;0;0;0;0;0
294;04.03.2017;2017;03;00;Lauantai;0;0;0;0;0;0
294;04.03.2017;2017;03;01;Lauantai;0;0;0;0;1;1
294;04.03.2017;2017;03;02;Lauantai;0;0;0;0;0;0
294;04.03.2017;2017;03;03;Lauantai;0;0;0;0;0;0
294;04.03.2017;2017;03;04;Lauantai;0;0;0;1;0;1
294;04.03.2017;2017;03;05;Lauantai;0;0;0;1;0;1
294;04.03.2017;2017;03;06;Lauantai;0;0;0;2;2;4
294;04.03.2017;2017;03;07;Lauantai;0;0;0;2;1;3
294;04.03.2017;2017;03;08;Lauantai;0;1;1;8;2;10
294;04.03.2017;2017;03;09;Lauantai;1;1;2;8;6;14
294;04.03.2017;2017;03;10;Lauantai;1;0;1;18;23;41
294;04.03.2017;2017;03;11;Lauantai;1;5;6;23;16;39
294;04.03.2017;2017;03;12;Lauantai;2;1;3;15;13;28
294;04.03.2017;2017;03;13;Lauantai;8;4;12;20;22;42
294;04.03.2017;2017;03;14;Lauantai;3;2;5;17;10;27
294;04.03.2017;2017;03;15;Lauantai;5;3;8;6;12;18
294;04.03.2017;2017;03;16;Lauantai;0;2;2;10;8;18
294;04.03.2017;2017;03;17;Lauantai;3;4;7;10;18;28
294;04.03.2017;2017;03;18;Lauantai;4;0;4;14;4;18
294;04.03.2017;2017;03;19;Lauantai;1;2;3;3;8;11
294;04.03.2017;2017;03;20;Lauantai;2;0;2;4;2;6
294;04.03.2017;2017;03;21;Lauantai;0;1;1;2;3;5
294;04.03.2017;2017;03;22;Lauantai;0;0;0;0;0;0
294;04.03.2017;2017;03;23;Lauantai;0;0;0;0;0;0
294;05.03.2017;2017;03;00;Sunnuntai;0;0;0;0;0;0
294;05.03.2017;2017;03;01;Sunnuntai;0;0;0;0;0;0
294;05.03.2017;2017;03;02;Sunnuntai;0;0;0;0;0;0
294;05.03.2017;2017;03;03;Sunnuntai;0;0;0;0;0;0
294;05.03.2017;2017;03;04;Sunnuntai;0;0;0;0;0;0
294;05.03.2017;2017;03;05;Sunnuntai;0;0;0;1;0;1
294;05.03.2017;2017;03;06;Sunnuntai;0;0;0;2;0;2
294;05.03.2017;2017;03;07;Sunnuntai;0;0;0;2;3;5
294;05.03.2017;2017;03;08;Sunnuntai;0;0;0;3;3;6
294;05.03.2017;2017;03;09;Sunnuntai;0;0;0;5;2;7
294;05.03.2017;2017;03;10;Sunnuntai;0;0;0;7;8;15
294;05.03.2017;2017;03;11;Sunnuntai;2;0;2;10;10;20
294;05.03.2017;2017;03;12;Sunnuntai;3;2;5;24;16;40
294;05.03.2017;2017;03;13;Sunnuntai;3;0;3;11;14;25
294;05.03.2017;2017;03;14;Sunnuntai;1;1;2;17;16;33
294;05.03.2017;2017;03;15;Sunnuntai;5;5;10;14;4;18
294;05.03.2017;2017;03;16;Sunnuntai;1;6;7;6;4;10
294;05.03.2017;2017;03;17;Sunnuntai;3;1;4;11;15;26
294;05.03.2017;2017;03;18;Sunnuntai;2;2;4;6;8;14
294;05.03.2017;2017;03;19;Sunnuntai;0;0;0;5;4;9
294;05.03.2017;2017;03;20;Sunnuntai;4;2;6;4;5;9
294;05.03.2017;2017;03;21;Sunnuntai;0;0;0;0;2;2
294;05.03.2017;2017;03;22;Sunnuntai;0;0;0;2;1;3
294;05.03.2017;2017;03;23;Sunnuntai;0;0;0;1;0;1
294;06.03.2017;2017;03;00;Maanantai;0;0;0;0;0;0
294;06.03.2017;2017;03;01;Maanantai;0;0;0;0;0;0
294;06.03.2017;2017;03;02;Maanantai;0;0;0;0;0;0
294;06.03.2017;2017;03;03;Maanantai;0;0;0;0;0;0
294;06.03.2017;2017;03;04;Maanantai;0;0;0;0;0;0
294;06.03.2017;2017;03;05;Maanantai;0;0;0;1;0;1
294;06.03.2017;2017;03;06;Maanantai;0;0;0;1;2;3
294;06.03.2017;2017;03;07;Maanantai;0;1;1;2;3;5
294;06.03.2017;2017;03;08;Maanantai;0;2;2;10;7;17
294;06.03.2017;2017;03;09;Maanantai;0;0;0;9;7;16
294;06.03.2017;2017;03;10;Maanantai;2;2;4;11;10;21
294;06.03.2017;2017;03;11;Maanantai;2;2;4;9;16;25
294;06.03.2017;2017;03;12;Maanantai;0;5;5;19;15;34
294;06.03.2017;2017;03;13;Maanantai;5;1;6;13;9;22
294;06.03.2017;2017;03;14;Maanantai;4;3;7;15;20;35
294;06.03.2017;2017;03;15;Maanantai;6;5;11;12;21;33
294;06.03.2017;2017;03;16;Maanantai;2;1;3;15;20;35
294;06.03.2017;2017;03;17;Maanantai;2;4;6;19;16;35
294;06.03.2017;2017;03;18;Maanantai;6;3;9;17;11;28
294;06.03.2017;2017;03;19;Maanantai;3;1;4;9;6;15
294;06.03.2017;2017;03;20;Maanantai;1;0;1;3;2;5
294;06.03.2017;2017;03;21;Maanantai;0;2;2;0;3;3
294;06.03.2017;2017;03;22;Maanantai;0;0;0;0;1;1
294;06.03.2017;2017;03;23;Maanantai;1;0;1;0;0;0
294;07.03.2017;2017;03;00;Tiistai;0;0;0;0;0;0
294;07.03.2017;2017;03;01;Tiistai;0;0;0;0;0;0
294;07.03.2017;2017;03;02;Tiistai;0;0;0;0;0;0
294;07.03.2017;2017;03;03;Tiistai;0;0;0;0;0;0
294;07.03.2017;2017;03;04;Tiistai;0;0;0;1;1;2
294;07.03.2017;2017;03;05;Tiistai;0;0;0;1;2;3
294;07.03.2017;2017;03;06;Tiistai;0;0;0;1;1;2
294;07.03.2017;2017;03;07;Tiistai;0;1;1;2;1;3
294;07.03.2017;2017;03;08;Tiistai;0;1;1;7;3;10
294;07.03.2017;2017;03;09;Tiistai;2;0;2;1;3;4
294;07.03.2017;2017;03;10;Tiistai;1;3;4;10;14;24
294;07.03.2017;2017;03;11;Tiistai;3;6;9;19;20;39
294;07.03.2017;2017;03;12;Tiistai;8;5;13;28;16;44
294;07.03.2017;2017;03;13;Tiistai;1;2;3;22;13;35
294;07.03.2017;2017;03;14;Tiistai;1;2;3;20;18;38
294;07.03.2017;2017;03;15;Tiistai;2;2;4;25;11;36
294;07.03.2017;2017;03;16;Tiistai;1;1;2;19;12;31
294;07.03.2017;2017;03;17;Tiistai;4;2;6;6;11;17
294;07.03.2017;2017;03;18;Tiistai;5;5;10;14;9;23
294;07.03.2017;2017;03;19;Tiistai;1;5;6;3;6;9
294;07.03.2017;2017;03;20;Tiistai;2;1;3;3;2;5
294;07.03.2017;2017;03;21;Tiistai;2;0;2;1;2;3
294;07.03.2017;2017;03;22;Tiistai;0;0;0;1;1;2
294;07.03.2017;2017;03;23;Tiistai;0;0;0;1;0;1
294;08.03.2017;2017;03;00;Keskiviikko;0;0;0;0;0;0
294;08.03.2017;2017;03;01;Keskiviikko;0;0;0;0;0;0
294;08.03.2017;2017;03;02;Keskiviikko;0;0;0;0;0;0
294;08.03.2017;2017;03;03;Keskiviikko;0;0;0;0;0;0
294;08.03.2017;2017;03;04;Keskiviikko;0;0;0;0;1;1
294;08.03.2017;2017;03;05;Keskiviikko;0;0;0;1;0;1
294;08.03.2017;2017;03;06;Keskiviikko;1;1;2;1;0;1
294;08.03.2017;2017;03;07;Keskiviikko;0;0;0;3;5;8
294;08.03.2017;2017;03;08;Keskiviikko;1;0;1;5;0;5
294;08.03.2017;2017;03;09;Keskiviikko;1;1;2;10;7;17
294;08.03.2017;2017;03;10;Keskiviikko;6;3;9;6;9;15
294;08.03.2017;2017;03;11;Keskiviikko;1;4;5;7;11;18
294;08.03.2017;2017;03;12;Keskiviikko;4;5;9;15;15;30
294;08.03.2017;2017;03;13;Keskiviikko;0;3;3;22;16;38
294;08.03.2017;2017;03;14;Keskiviikko;1;1;2;15;16;31
294;08.03.2017;2017;03;15;Keskiviikko;3;2;5;12;6;18
294;08.03.2017;2017;03;16;Keskiviikko;1;5;6;13;14;27
294;08.03.2017;2017;03;17;Keskiviikko;1;1;2;13;16;29
294;08.03.2017;2017;03;18;Keskiviikko;5;3;8;19;10;29
294;08.03.2017;2017;03;19;Keskiviikko;2;1;3;3;14;17
294;08.03.2017;2017;03;20;Keskiviikko;2;0;2;7;3;10
294;08.03.2017;2017;03;21;Keskiviikko;2;1;3;2;0;2
294;08.03.2017;2017;03;22;Keskiviikko;1;0;1;0;1;1
294;08.03.2017;2017;03;23;Keskiviikko;1;0;1;1;0;1
294;09.03.2017;2017;03;00;Torstai;0;0;0;0;1;1
294;09.03.2017;2017;03;01;Torstai;0;0;0;0;0;0
294;09.03.2017;2017;03;02;Torstai;0;0;0;0;0;0
294;09.03.2017;2017;03;03;Torstai;0;0;0;0;0;0
294;09.03.2017;2017;03;04;Torstai;0;0;0;0;1;1
294;09.03.2017;2017;03;05;Torstai;0;0;0;2;0;2
294;09.03.2017;2017;03;06;Torstai;0;0;0;1;0;1
294;09.03.2017;2017;03;07;Torstai;0;0;0;2;4;6
294;09.03.2017;2017;03;08;Torstai;2;1;3;4;3;7
294;09.03.2017;2017;03;09;Torstai;1;1;2;10;6;16
294;09.03.2017;2017;03;10;Torstai;1;2;3;13;16;29
294;09.03.2017;2017;03;11;Torstai;2;3;5;10;13;23
294;09.03.2017;2017;03;12;Torstai;4;1;5;16;11;27
294;09.03.2017;2017;03;13;Torstai;1;1;2;6;13;19
294;09.03.2017;2017;03;14;Torstai;1;0;1;7;9;16
294;09.03.2017;2017;03;15;Torstai;1;2;3;8;3;11
294;09.03.2017;2017;03;16;Torstai;3;1;4;11;10;21
294;09.03.2017;2017;03;17;Torstai;3;1;4;6;5;11
294;09.03.2017;2017;03;18;Torstai;1;2;3;8;6;14
294;09.03.2017;2017;03;19;Torstai;2;0;2;13;6;19
294;09.03.2017;2017;03;20;Torstai;0;1;1;2;5;7
294;09.03.2017;2017;03;21;Torstai;1;1;2;5;2;7
294;09.03.2017;2017;03;22;Torstai;1;4;5;1;5;6
294;09.03.2017;2017;03;23;Torstai;1;0;1;0;0;0
294;10.03.2017;2017;03;00;Perjantai;0;0;0;0;0;0
294;10.03.2017;2017;03;01;Perjantai;0;0;0;1;0;1
294;10.03.2017;2017;03;02;Perjantai;0;0;0;2;0;2
294;10.03.2017;2017;03;03;Perjantai;0;0;0;0;0;0
294;10.03.2017;2017;03;04;Perjantai;0;0;0;0;0;0
294;10.03.2017;2017;03;05;Perjantai;0;0;0;2;0;2
294;10.03.2017;2017;03;06;Perjantai;1;0;1;2;1;3
294;10.03.2017;2017;03;07;Perjantai;1;0;1;1;3;4
294;10.03.2017;2017;03;08;Perjantai;0;1;1;6;5;11
294;10.03.2017;2017;03;09;Perjantai;2;1;3;15;7;22
294;10.03.2017;2017;03;10;Perjantai;2;3;5;11;10;21
294;10.03.2017;2017;03;11;Perjantai;4;4;8;9;12;21
294;10.03.2017;2017;03;12;Perjantai;0;2;2;17;9;26
294;10.03.2017;2017;03;13;Perjantai;3;1;4;13;20;33
294;10.03.2017;2017;03;14;Perjantai;2;2;4;5;13;18
294;10.03.2017;2017;03;15;Perjantai;1;2;3;13;8;21
294;10.03.2017;2017;03;16;Perjantai;3;1;4;11;8;19
294;10.03.2017;2017;03;17;Perjantai;1;0;1;6;11;17
294;10.03.2017;2017;03;18;Perjantai;4;2;6;6;8;14
294;10.03.2017;2017;03;19;Perjantai;0;0;0;8;3;11
294;10.03.2017;2017;03;20;Perjantai;2;0;2;2;2;4
294;10.03.2017;2017;03;21;Perjantai;2;0;2;2;0;2
294;10.03.2017;2017;03;22;Perjantai;0;0;0;0;0;0
294;10.03.2017;2017;03;23;Perjantai;1;0;1;0;0;0
294;11.03.2017;2017;03;00;Lauantai;0;0;0;0;2;2
294;11.03.2017;2017;03;01;Lauantai;0;0;0;0;0;0
294;11.03.2017;2017;03;02;Lauantai;0;1;1;0;1;1
294;11.03.2017;2017;03;03;Lauantai;0;0;0;0;0;0
294;11.03.2017;2017;03;04;Lauantai;0;0;0;0;0;0
294;11.03.2017;2017;03;05;Lauantai;0;0;0;0;0;0
294;11.03.2017;2017;03;06;Lauantai;0;0;0;2;0;2
294;11.03.2017;2017;03;07;Lauantai;0;1;1;3;6;9
294;11.03.2017;2017;03;08;Lauantai;0;0;0;4;6;10
294;11.03.2017;2017;03;09;Lauantai;0;0;0;16;14;30
294;11.03.2017;2017;03;10;Lauantai;3;1;4;16;22;38
294;11.03.2017;2017;03;11;Lauantai;1;4;5;18;26;44
294;11.03.2017;2017;03;12;Lauantai;0;3;3;24;19;43
294;11.03.2017;2017;03;13;Lauantai;1;1;2;18;16;34
294;11.03.2017;2017;03;14;Lauantai;2;2;4;15;13;28
294;11.03.2017;2017;03;15;Lauantai;0;1;1;5;3;8
294;11.03.2017;2017;03;16;Lauantai;0;0;0;10;6;16
294;11.03.2017;2017;03;17;Lauantai;0;1;1;9;11;20
294;11.03.2017;2017;03;18;Lauantai;3;2;5;10;12;22
294;11.03.2017;2017;03;19;Lauantai;0;3;3;4;7;11
294;11.03.2017;2017;03;20;Lauantai;1;1;2;8;11;19
294;11.03.2017;2017;03;21;Lauantai;0;1;1;9;4;13
294;11.03.2017;2017;03;22;Lauantai;0;0;0;0;1;1
294;11.03.2017;2017;03;23;Lauantai;0;0;0;0;0;0
294;12.03.2017;2017;03;00;Sunnuntai;0;0;0;0;0;0
294;12.03.2017;2017;03;01;Sunnuntai;0;0;0;0;0;0
294;12.03.2017;2017;03;02;Sunnuntai;0;0;0;1;0;1
294;12.03.2017;2017;03;03;Sunnuntai;0;0;0;1;0;1
294;12.03.2017;2017;03;04;Sunnuntai;0;0;0;0;0;0
294;12.03.2017;2017;03;05;Sunnuntai;0;0;0;1;0;1
294;12.03.2017;2017;03;06;Sunnuntai;0;0;0;2;0;2
294;12.03.2017;2017;03;07;Sunnuntai;0;0;0;1;2;3
294;12.03.2017;2017;03;08;Sunnuntai;0;0;0;3;1;4
294;12.03.2017;2017;03;09;Sunnuntai;0;0;0;11;9;20
294;12.03.2017;2017;03;10;Sunnuntai;2;2;4;10;9;19
294;12.03.2017;2017;03;11;Sunnuntai;0;2;2;8;25;33
294;12.03.2017;2017;03;12;Sunnuntai;3;2;5;12;12;24
294;12.03.2017;2017;03;13;Sunnuntai;0;1;1;15;8;23
294;12.03.2017;2017;03;14;Sunnuntai;4;1;5;10;6;16
294;12.03.2017;2017;03;15;Sunnuntai;1;1;2;9;11;20
294;12.03.2017;2017;03;16;Sunnuntai;2;2;4;11;11;22
294;12.03.2017;2017;03;17;Sunnuntai;2;3;5;7;13;20
294;12.03.2017;2017;03;18;Sunnuntai;1;1;2;8;15;23
294;12.03.2017;2017;03;19;Sunnuntai;5;3;8;23;8;31
294;12.03.2017;2017;03;20;Sunnuntai;2;0;2;9;4;13
294;12.03.2017;2017;03;21;Sunnuntai;0;0;0;1;2;3
294;12.03.2017;2017;03;22;Sunnuntai;0;0;0;0;0;0
294;12.03.2017;2017;03;23;Sunnuntai;0;0;0;0;0;0
294;13.03.2017;2017;03;00;Maanantai;0;0;0;0;0;0
294;13.03.2017;2017;03;01;Maanantai;0;0;0;0;0;0
294;13.03.2017;2017;03;02;Maanantai;0;0;0;0;0;0
294;13.03.2017;2017;03;03;Maanantai;0;0;0;0;0;0
294;13.03.2017;2017;03;04;Maanantai;0;0;0;0;0;0
294;13.03.2017;2017;03;05;Maanantai;0;1;1;3;0;3
294;13.03.2017;2017;03;06;Maanantai;0;0;0;3;5;8
294;13.03.2017;2017;03;07;Maanantai;3;6;9;7;8;15
294;13.03.2017;2017;03;08;Maanantai;7;3;10;17;7;24
294;13.03.2017;2017;03;09;Maanantai;7;4;11;24;12;36
294;13.03.2017;2017;03;10;Maanantai;3;2;5;20;18;38
294;13.03.2017;2017;03;11;Maanantai;1;3;4;31;26;57
294;13.03.2017;2017;03;12;Maanantai;2;2;4;29;19;48
294;13.03.2017;2017;03;13;Maanantai;5;4;9;29;15;44
294;13.03.2017;2017;03;14;Maanantai;5;17;22;23;27;50
294;13.03.2017;2017;03;15;Maanantai;7;7;14;14;28;42
294;13.03.2017;2017;03;16;Maanantai;4;5;9;29;20;49
294;13.03.2017;2017;03;17;Maanantai;6;7;13;19;14;33
294;13.03.2017;2017;03;18;Maanantai;6;3;9;21;16;37
294;13.03.2017;2017;03;19;Maanantai;2;3;5;12;10;22
294;13.03.2017;2017;03;20;Maanantai;0;2;2;11;7;18
294;13.03.2017;2017;03;21;Maanantai;0;0;0;1;0;1
294;13.03.2017;2017;03;22;Maanantai;0;0;0;0;0;0
294;13.03.2017;2017;03;23;Maanantai;0;0;0;0;0;0
294;14.03.2017;2017;03;00;Tiistai;0;0;0;0;0;0
294;14.03.2017;2017;03;01;Tiistai;0;0;0;0;0;0
294;14.03.2017;2017;03;02;Tiistai;0;0;0;0;0;0
294;14.03.2017;2017;03;03;Tiistai;0;0;0;0;0;0
294;14.03.2017;2017;03;04;Tiistai;0;0;0;0;1;1
294;14.03.2017;2017;03;05;Tiistai;0;0;0;0;0;0
294;14.03.2017;2017;03;06;Tiistai;1;1;2;3;3;6
294;14.03.2017;2017;03;07;Tiistai;2;2;4;9;6;15
294;14.03.2017;2017;03;08;Tiistai;7;2;9;11;6;17
294;14.03.2017;2017;03;09;Tiistai;11;2;13;13;7;20
294;14.03.2017;2017;03;10;Tiistai;1;1;2;5;8;13
294;14.03.2017;2017;03;11;Tiistai;2;5;7;20;15;35
294;14.03.2017;2017;03;12;Tiistai;1;1;2;19;10;29
294;14.03.2017;2017;03;13;Tiistai;1;5;6;11;22;33
294;14.03.2017;2017;03;14;Tiistai;6;5;11;28;21;49
294;14.03.2017;2017;03;15;Tiistai;3;9;12;13;20;33
294;14.03.2017;2017;03;16;Tiistai;3;9;12;10;9;19
294;14.03.2017;2017;03;17;Tiistai;2;5;7;8;12;20
294;14.03.2017;2017;03;18;Tiistai;3;5;8;14;14;28
294;14.03.2017;2017;03;19;Tiistai;3;2;5;14;5;19
294;14.03.2017;2017;03;20;Tiistai;1;2;3;10;3;13
294;14.03.2017;2017;03;21;Tiistai;2;0;2;2;1;3
294;14.03.2017;2017;03;22;Tiistai;0;0;0;1;0;1
294;14.03.2017;2017;03;23;Tiistai;0;0;0;0;0;0
294;15.03.2017;2017;03;00;Keskiviikko;0;0;0;0;0;0
294;15.03.2017;2017;03;01;Keskiviikko;0;0;0;0;1;1
294;15.03.2017;2017;03;02;Keskiviikko;0;0;0;0;0;0
294;15.03.2017;2017;03;03;Keskiviikko;0;0;0;0;0;0
294;15.03.2017;2017;03;04;Keskiviikko;0;0;0;0;1;1
294;15.03.2017;2017;03;05;Keskiviikko;0;0;0;3;0;3
294;15.03.2017;2017;03;06;Keskiviikko;1;0;1;2;0;2
294;15.03.2017;2017;03;07;Keskiviikko;3;2;5;15;4;19
294;15.03.2017;2017;03;08;Keskiviikko;4;0;4;17;4;21
294;15.03.2017;2017;03;09;Keskiviikko;7;5;12;16;14;30
294;15.03.2017;2017;03;10;Keskiviikko;3;0;3;15;14;29
294;15.03.2017;2017;03;11;Keskiviikko;4;3;7;13;12;25
294;15.03.2017;2017;03;12;Keskiviikko;1;4;5;13;9;22
294;15.03.2017;2017;03;13;Keskiviikko;4;8;12;11;9;20
294;15.03.2017;2017;03;14;Keskiviikko;3;8;11;12;20;32
294;15.03.2017;2017;03;15;Keskiviikko;6;4;10;23;18;41
294;15.03.2017;2017;03;16;Keskiviikko;3;6;9;19;17;36
294;15.03.2017;2017;03;17;Keskiviikko;4;2;6;8;17;25
294;15.03.2017;2017;03;18;Keskiviikko;3;4;7;14;21;35
294;15.03.2017;2017;03;19;Keskiviikko;3;1;4;11;9;20
294;15.03.2017;2017;03;20;Keskiviikko;0;0;0;4;2;6
294;15.03.2017;2017;03;21;Keskiviikko;0;0;0;5;0;5
294;15.03.2017;2017;03;22;Keskiviikko;0;0;0;1;0;1
294;15.03.2017;2017;03;23;Keskiviikko;1;0;1;0;0;0
294;16.03.2017;2017;03;00;Torstai;0;0;0;0;0;0
294;16.03.2017;2017;03;01;Torstai;0;0;0;0;0;0
294;16.03.2017;2017;03;02;Torstai;0;0;0;0;0;0
294;16.03.2017;2017;03;03;Torstai;0;0;0;0;0;0
294;16.03.2017;2017;03;04;Torstai;0;0;0;0;1;1
294;16.03.2017;2017;03;05;Torstai;0;0;0;2;0;2
294;16.03.2017;2017;03;06;Torstai;1;1;2;4;2;6
294;16.03.2017;2017;03;07;Torstai;8;2;10;15;3;18
294;16.03.2017;2017;03;08;Torstai;5;3;8;15;4;19
294;16.03.2017;2017;03;09;Torstai;4;3;7;25;14;39
294;16.03.2017;2017;03;10;Torstai;2;0;2;18;13;31
294;16.03.2017;2017;03;11;Torstai;2;4;6;14;24;38
294;16.03.2017;2017;03;12;Torstai;1;7;8;17;10;27
294;16.03.2017;2017;03;13;Torstai;3;13;16;18;18;36
294;16.03.2017;2017;03;14;Torstai;11;6;17;20;15;35
294;16.03.2017;2017;03;15;Torstai;5;11;16;13;29;42
294;16.03.2017;2017;03;16;Torstai;5;2;7;6;15;21
294;16.03.2017;2017;03;17;Torstai;5;3;8;13;13;26
294;16.03.2017;2017;03;18;Torstai;4;3;7;17;13;30
294;16.03.2017;2017;03;19;Torstai;1;0;1;13;5;18
294;16.03.2017;2017;03;20;Torstai;0;0;0;5;8;13
294;16.03.2017;2017;03;21;Torstai;0;2;2;0;2;2
294;16.03.2017;2017;03;22;Torstai;0;0;0;3;1;4
294;16.03.2017;2017;03;23;Torstai;0;0;0;0;1;1
294;17.03.2017;2017;03;00;Perjantai;0;0;0;0;0;0
294;17.03.2017;2017;03;01;Perjantai;0;0;0;0;0;0
294;17.03.2017;2017;03;02;Perjantai;0;0;0;0;0;0
294;17.03.2017;2017;03;03;Perjantai;0;0;0;0;0;0
294;17.03.2017;2017;03;04;Perjantai;0;0;0;0;0;0
294;17.03.2017;2017;03;05;Perjantai;0;0;0;2;0;2
294;17.03.2017;2017;03;06;Perjantai;0;0;0;4;1;5
294;17.03.2017;2017;03;07;Perjantai;5;2;7;13;1;14
294;17.03.2017;2017;03;08;Perjantai;4;1;5;13;4;17
294;17.03.2017;2017;03;09;Perjantai;5;1;6;14;5;19
294;17.03.2017;2017;03;10;Perjantai;0;1;1;8;9;17
294;17.03.2017;2017;03;11;Perjantai;5;6;11;14;8;22
294;17.03.2017;2017;03;12;Perjantai;5;6;11;18;24;42
294;17.03.2017;2017;03;13;Perjantai;6;10;16;16;26;42
294;17.03.2017;2017;03;14;Perjantai;3;4;7;13;19;32
294;17.03.2017;2017;03;15;Perjantai;0;4;4;8;7;15
294;17.03.2017;2017;03;16;Perjantai;1;1;2;5;13;18
294;17.03.2017;2017;03;17;Perjantai;3;2;5;10;13;23
294;17.03.2017;2017;03;18;Perjantai;3;1;4;8;9;17
294;17.03.2017;2017;03;19;Perjantai;4;9;13;4;4;8
294;17.03.2017;2017;03;20;Perjantai;2;2;4;5;5;10
294;17.03.2017;2017;03;21;Perjantai;2;0;2;2;2;4
294;17.03.2017;2017;03;22;Perjantai;0;0;0;2;0;2
294;17.03.2017;2017;03;23;Perjantai;0;0;0;0;0;0
294;18.03.2017;2017;03;00;Lauantai;0;0;0;0;0;0
294;18.03.2017;2017;03;01;Lauantai;0;0;0;0;0;0
294;18.03.2017;2017;03;02;Lauantai;0;0;0;0;0;0
294;18.03.2017;2017;03;03;Lauantai;0;0;0;0;0;0
294;18.03.2017;2017;03;04;Lauantai;0;0;0;1;0;1
294;18.03.2017;2017;03;05;Lauantai;0;0;0;0;0;0
294;18.03.2017;2017;03;06;Lauantai;0;0;0;3;0;3
294;18.03.2017;2017;03;07;Lauantai;0;0;0;3;5;8
294;18.03.2017;2017;03;08;Lauantai;0;0;0;3;5;8
294;18.03.2017;2017;03;09;Lauantai;1;1;2;15;9;24
294;18.03.2017;2017;03;10;Lauantai;0;3;3;10;13;23
294;18.03.2017;2017;03;11;Lauantai;2;2;4;11;20;31
294;18.03.2017;2017;03;12;Lauantai;5;7;12;13;13;26
294;18.03.2017;2017;03;13;Lauantai;6;6;12;13;9;22
294;18.03.2017;2017;03;14;Lauantai;8;5;13;15;10;25
294;18.03.2017;2017;03;15;Lauantai;5;6;11;11;9;20
294;18.03.2017;2017;03;16;Lauantai;1;3;4;11;14;25
294;18.03.2017;2017;03;17;Lauantai;1;6;7;15;11;26
294;18.03.2017;2017;03;18;Lauantai;4;0;4;13;10;23
294;18.03.2017;2017;03;19;Lauantai;2;1;3;10;6;16
294;18.03.2017;2017;03;20;Lauantai;0;2;2;7;10;17
294;18.03.2017;2017;03;21;Lauantai;1;0;1;4;2;6
294;18.03.2017;2017;03;22;Lauantai;0;1;1;3;0;3
294;18.03.2017;2017;03;23;Lauantai;0;0;0;1;0;1
294;19.03.2017;2017;03;00;Sunnuntai;0;0;0;0;0;0
294;19.03.2017;2017;03;01;Sunnuntai;0;0;0;0;2;2
294;19.03.2017;2017;03;02;Sunnuntai;0;0;0;3;0;3
294;19.03.2017;2017;03;03;Sunnuntai;0;0;0;0;0;0
294;19.03.2017;2017;03;04;Sunnuntai;0;0;0;0;0;0
294;19.03.2017;2017;03;05;Sunnuntai;0;0;0;0;0;0
294;19.03.2017;2017;03;06;Sunnuntai;0;0;0;2;0;2
294;19.03.2017;2017;03;07;Sunnuntai;0;0;0;2;0;2
294;19.03.2017;2017;03;08;Sunnuntai;1;1;2;4;5;9
294;19.03.2017;2017;03;09;Sunnuntai;1;1;2;7;16;23
294;19.03.2017;2017;03;10;Sunnuntai;0;0;0;19;14;33
294;19.03.2017;2017;03;11;Sunnuntai;0;0;0;6;13;19
294;19.03.2017;2017;03;12;Sunnuntai;3;1;4;12;11;23
294;19.03.2017;2017;03;13;Sunnuntai;0;4;4;21;17;38
294;19.03.2017;2017;03;14;Sunnuntai;4;2;6;17;15;32
294;19.03.2017;2017;03;15;Sunnuntai;4;3;7;7;19;26
294;19.03.2017;2017;03;16;Sunnuntai;2;5;7;17;11;28
294;19.03.2017;2017;03;17;Sunnuntai;0;0;0;9;11;20
294;19.03.2017;2017;03;18;Sunnuntai;5;2;7;17;14;31
294;19.03.2017;2017;03;19;Sunnuntai;3;2;5;10;4;14
294;19.03.2017;2017;03;20;Sunnuntai;2;0;2;3;1;4
294;19.03.2017;2017;03;21;Sunnuntai;0;0;0;2;1;3
294;19.03.2017;2017;03;22;Sunnuntai;1;0;1;1;0;1
294;19.03.2017;2017;03;23;Sunnuntai;0;0;0;0;0;0
294;20.03.2017;2017;03;00;Maanantai;0;0;0;0;0;0
294;20.03.2017;2017;03;01;Maanantai;0;0;0;0;0;0
294;20.03.2017;2017;03;02;Maanantai;0;0;0;0;0;0
294;20.03.2017;2017;03;03;Maanantai;0;0;0;0;0;0
294;20.03.2017;2017;03;04;Maanantai;0;0;0;0;0;0
294;20.03.2017;2017;03;05;Maanantai;0;0;0;3;0;3
294;20.03.2017;2017;03;06;Maanantai;0;1;1;2;1;3
294;20.03.2017;2017;03;07;Maanantai;8;6;14;8;6;14
294;20.03.2017;2017;03;08;Maanantai;12;6;18;12;10;22
294;20.03.2017;2017;03;09;Maanantai;8;3;11;23;12;35
294;20.03.2017;2017;03;10;Maanantai;1;2;3;13;19;32
294;20.03.2017;2017;03;11;Maanantai;2;3;5;21;21;42
294;20.03.2017;2017;03;12;Maanantai;4;4;8;24;18;42
294;20.03.2017;2017;03;13;Maanantai;4;11;15;19;20;39
294;20.03.2017;2017;03;14;Maanantai;5;10;15;22;23;45
294;20.03.2017;2017;03;15;Maanantai;1;12;13;7;28;35
294;20.03.2017;2017;03;16;Maanantai;5;3;8;20;16;36
294;20.03.2017;2017;03;17;Maanantai;3;0;3;19;15;34
294;20.03.2017;2017;03;18;Maanantai;4;6;10;24;21;45
294;20.03.2017;2017;03;19;Maanantai;2;0;2;8;9;17
294;20.03.2017;2017;03;20;Maanantai;4;1;5;7;2;9
294;20.03.2017;2017;03;21;Maanantai;1;0;1;5;0;5
294;20.03.2017;2017;03;22;Maanantai;0;0;0;1;0;1
294;20.03.2017;2017;03;23;Maanantai;0;0;0;0;0;0
294;21.03.2017;2017;03;00;Tiistai;0;0;0;0;0;0
294;21.03.2017;2017;03;01;Tiistai;0;0;0;0;0;0
294;21.03.2017;2017;03;02;Tiistai;1;0;1;0;0;0
294;21.03.2017;2017;03;03;Tiistai;0;0;0;0;0;0
294;21.03.2017;2017;03;04;Tiistai;0;0;0;0;1;1
294;21.03.2017;2017;03;05;Tiistai;0;0;0;3;1;4
294;21.03.2017;2017;03;06;Tiistai;1;1;2;3;2;5
294;21.03.2017;2017;03;07;Tiistai;3;1;4;9;3;12
294;21.03.2017;2017;03;08;Tiistai;4;1;5;9;5;14
294;21.03.2017;2017;03;09;Tiistai;4;1;5;12;11;23
294;21.03.2017;2017;03;10;Tiistai;2;2;4;9;7;16
294;21.03.2017;2017;03;11;Tiistai;2;1;3;30;25;55
294;21.03.2017;2017;03;12;Tiistai;3;10;13;12;13;25
294;21.03.2017;2017;03;13;Tiistai;3;3;6;14;14;28
294;21.03.2017;2017;03;14;Tiistai;0;0;0;11;17;28
294;21.03.2017;2017;03;15;Tiistai;4;9;13;23;22;45
294;21.03.2017;2017;03;16;Tiistai;2;1;3;7;17;24
294;21.03.2017;2017;03;17;Tiistai;0;1;1;8;9;17
294;21.03.2017;2017;03;18;Tiistai;4;1;5;14;16;30
294;21.03.2017;2017;03;19;Tiistai;3;1;4;13;12;25
294;21.03.2017;2017;03;20;Tiistai;0;1;1;3;1;4
294;21.03.2017;2017;03;21;Tiistai;1;0;1;1;1;2
294;21.03.2017;2017;03;22;Tiistai;0;0;0;0;0;0
294;21.03.2017;2017;03;23;Tiistai;0;0;0;1;0;1
294;22.03.2017;2017;03;00;Keskiviikko;0;0;0;0;0;0
294;22.03.2017;2017;03;01;Keskiviikko;0;0;0;0;0;0
294;22.03.2017;2017;03;02;Keskiviikko;0;0;0;0;0;0
294;22.03.2017;2017;03;03;Keskiviikko;0;0;0;0;0;0
294;22.03.2017;2017;03;04;Keskiviikko;0;0;0;1;1;2
294;22.03.2017;2017;03;05;Keskiviikko;0;0;0;4;1;5
294;22.03.2017;2017;03;06;Keskiviikko;1;1;2;0;2;2
294;22.03.2017;2017;03;07;Keskiviikko;7;1;8;7;4;11
294;22.03.2017;2017;03;08;Keskiviikko;2;0;2;12;5;17
294;22.03.2017;2017;03;09;Keskiviikko;11;2;13;14;12;26
294;22.03.2017;2017;03;10;Keskiviikko;1;2;3;13;15;28
294;22.03.2017;2017;03;11;Keskiviikko;5;6;11;28;19;47
294;22.03.2017;2017;03;12;Keskiviikko;5;6;11;27;22;49
294;22.03.2017;2017;03;13;Keskiviikko;4;10;14;20;15;35
294;22.03.2017;2017;03;14;Keskiviikko;5;13;18;13;24;37
294;22.03.2017;2017;03;15;Keskiviikko;9;2;11;17;12;29
294;22.03.2017;2017;03;16;Keskiviikko;3;5;8;8;12;20
294;22.03.2017;2017;03;17;Keskiviikko;3;5;8;11;11;22
294;22.03.2017;2017;03;18;Keskiviikko;5;5;10;11;17;28
294;22.03.2017;2017;03;19;Keskiviikko;4;0;4;14;13;27
294;22.03.2017;2017;03;20;Keskiviikko;1;0;1;5;6;11
294;22.03.2017;2017;03;21;Keskiviikko;1;0;1;4;0;4
294;22.03.2017;2017;03;22;Keskiviikko;0;0;0;1;0;1
294;22.03.2017;2017;03;23;Keskiviikko;0;0;0;1;2;3
294;23.03.2017;2017;03;00;Torstai;0;0;0;0;0;0
294;23.03.2017;2017;03;01;Torstai;0;0;0;0;0;0
294;23.03.2017;2017;03;02;Torstai;0;0;0;0;0;0
294;23.03.2017;2017;03;03;Torstai;0;0;0;0;0;0
294;23.03.2017;2017;03;04;Torstai;0;0;0;0;1;1
294;23.03.2017;2017;03;05;Torstai;0;0;0;2;1;3
294;23.03.2017;2017;03;06;Torstai;0;1;1;4;2;6
294;23.03.2017;2017;03;07;Torstai;6;2;8;20;7;27
294;23.03.2017;2017;03;08;Torstai;9;1;10;12;7;19
294;23.03.2017;2017;03;09;Torstai;8;6;14;25;15;40
294;23.03.2017;2017;03;10;Torstai;0;2;2;14;16;30
294;23.03.2017;2017;03;11;Torstai;2;2;4;20;23;43
294;23.03.2017;2017;03;12;Torstai;0;7;7;19;19;38
294;23.03.2017;2017;03;13;Torstai;4;9;13;18;32;50
294;23.03.2017;2017;03;14;Torstai;13;11;24;22;25;47
294;23.03.2017;2017;03;15;Torstai;2;9;11;15;22;37
294;23.03.2017;2017;03;16;Torstai;3;4;7;12;11;23
294;23.03.2017;2017;03;17;Torstai;2;1;3;17;23;40
294;23.03.2017;2017;03;18;Torstai;8;3;11;30;15;45
294;23.03.2017;2017;03;19;Torstai;2;2;4;14;12;26
294;23.03.2017;2017;03;20;Torstai;2;0;2;2;5;7
294;23.03.2017;2017;03;21;Torstai;0;1;1;3;1;4
294;23.03.2017;2017;03;22;Torstai;0;0;0;0;0;0
294;23.03.2017;2017;03;23;Torstai;0;0;0;1;0;1
294;24.03.2017;2017;03;00;Perjantai;0;0;0;0;0;0
294;24.03.2017;2017;03;01;Perjantai;0;0;0;0;0;0
294;24.03.2017;2017;03;02;Perjantai;0;0;0;0;0;0
294;24.03.2017;2017;03;03;Perjantai;0;0;0;0;0;0
294;24.03.2017;2017;03;04;Perjantai;0;0;0;0;1;1
294;24.03.2017;2017;03;05;Perjantai;0;0;0;2;0;2
294;24.03.2017;2017;03;06;Perjantai;0;1;1;3;0;3
294;24.03.2017;2017;03;07;Perjantai;10;4;14;6;10;16
294;24.03.2017;2017;03;08;Perjantai;4;1;5;7;7;14
294;24.03.2017;2017;03;09;Perjantai;8;3;11;35;13;48
294;24.03.2017;2017;03;10;Perjantai;4;1;5;10;22;32
294;24.03.2017;2017;03;11;Perjantai;2;4;6;13;17;30
294;24.03.2017;2017;03;12;Perjantai;10;14;24;19;21;40
294;24.03.2017;2017;03;13;Perjantai;12;12;24;19;19;38
294;24.03.2017;2017;03;14;Perjantai;4;13;17;23;20;43
294;24.03.2017;2017;03;15;Perjantai;3;5;8;25;21;46
294;24.03.2017;2017;03;16;Perjantai;6;2;8;16;17;33
294;24.03.2017;2017;03;17;Perjantai;9;4;13;12;13;25
294;24.03.2017;2017;03;18;Perjantai;6;2;8;30;21;51
294;24.03.2017;2017;03;19;Perjantai;3;5;8;13;6;19
294;24.03.2017;2017;03;20;Perjantai;3;1;4;6;2;8
294;24.03.2017;2017;03;21;Perjantai;2;0;2;2;3;5
294;24.03.2017;2017;03;22;Perjantai;2;2;4;2;0;2
294;24.03.2017;2017;03;23;Perjantai;1;0;1;0;0;0
294;25.03.2017;2017;03;00;Lauantai;0;0;0;0;0;0
294;25.03.2017;2017;03;01;Lauantai;0;0;0;1;2;3
294;25.03.2017;2017;03;02;Lauantai;0;0;0;1;0;1
294;25.03.2017;2017;03;03;Lauantai;0;0;0;0;0;0
294;25.03.2017;2017;03;04;Lauantai;0;0;0;0;0;0
294;25.03.2017;2017;03;05;Lauantai;1;0;1;2;0;2
294;25.03.2017;2017;03;06;Lauantai;0;0;0;1;1;2
294;25.03.2017;2017;03;07;Lauantai;0;1;1;2;1;3
294;25.03.2017;2017;03;08;Lauantai;0;0;0;2;3;5
294;25.03.2017;2017;03;09;Lauantai;0;1;1;6;3;9
294;25.03.2017;2017;03;10;Lauantai;1;2;3;15;19;34
294;25.03.2017;2017;03;11;Lauantai;4;4;8;12;13;25
294;25.03.2017;2017;03;12;Lauantai;3;7;10;23;19;42
294;25.03.2017;2017;03;13;Lauantai;5;3;8;15;14;29
294;25.03.2017;2017;03;14;Lauantai;4;0;4;9;11;20
294;25.03.2017;2017;03;15;Lauantai;4;4;8;20;17;37
294;25.03.2017;2017;03;16;Lauantai;8;1;9;12;19;31
294;25.03.2017;2017;03;17;Lauantai;1;3;4;11;16;27
294;25.03.2017;2017;03;18;Lauantai;1;3;4;18;21;39
294;25.03.2017;2017;03;19;Lauantai;4;3;7;10;4;14
294;25.03.2017;2017;03;20;Lauantai;2;1;3;11;4;15
294;25.03.2017;2017;03;21;Lauantai;1;2;3;3;0;3
294;25.03.2017;2017;03;22;Lauantai;1;0;1;1;2;3
294;25.03.2017;2017;03;23;Lauantai;0;0;0;4;0;4
294;26.03.2017;2017;03;00;Sunnuntai;0;0;0;0;0;0
294;26.03.2017;2017;03;01;Sunnuntai;0;0;0;0;0;0
294;26.03.2017;2017;03;02;Sunnuntai;0;0;0;0;0;0
294;26.03.2017;2017;03;03;Sunnuntai;0;0;0;0;0;0
294;26.03.2017;2017;03;04;Sunnuntai;0;0;0;0;0;0
294;26.03.2017;2017;03;05;Sunnuntai;0;0;0;1;0;1
294;26.03.2017;2017;03;06;Sunnuntai;0;0;0;1;0;1
294;26.03.2017;2017;03;07;Sunnuntai;0;0;0;0;1;1
294;26.03.2017;2017;03;08;Sunnuntai;0;0;0;2;5;7
294;26.03.2017;2017;03;09;Sunnuntai;1;1;2;14;1;15
294;26.03.2017;2017;03;10;Sunnuntai;2;0;2;5;8;13
294;26.03.2017;2017;03;11;Sunnuntai;0;0;0;12;9;21
294;26.03.2017;2017;03;12;Sunnuntai;0;1;1;15;11;26
294;26.03.2017;2017;03;13;Sunnuntai;3;3;6;16;21;37
294;26.03.2017;2017;03;14;Sunnuntai;3;1;4;19;16;35
294;26.03.2017;2017;03;15;Sunnuntai;5;4;9;15;16;31
294;26.03.2017;2017;03;16;Sunnuntai;0;0;0;19;15;34
294;26.03.2017;2017;03;17;Sunnuntai;4;5;9;9;9;18
294;26.03.2017;2017;03;18;Sunnuntai;1;1;2;8;7;15
294;26.03.2017;2017;03;19;Sunnuntai;3;3;6;12;7;19
294;26.03.2017;2017;03;20;Sunnuntai;3;3;6;5;1;6
294;26.03.2017;2017;03;21;Sunnuntai;0;0;0;3;1;4
294;26.03.2017;2017;03;22;Sunnuntai;0;0;0;0;0;0
294;26.03.2017;2017;03;23;Sunnuntai;0;0;0;0;0;0
294;27.03.2017;2017;03;00;Maanantai;0;0;0;0;0;0
294;27.03.2017;2017;03;01;Maanantai;0;0;0;0;0;0
294;27.03.2017;2017;03;02;Maanantai;0;0;0;0;0;0
294;27.03.2017;2017;03;03;Maanantai;0;0;0;0;0;0
294;27.03.2017;2017;03;04;Maanantai;0;1;1;0;0;0
294;27.03.2017;2017;03;05;Maanantai;0;0;0;1;0;1
294;27.03.2017;2017;03;06;Maanantai;0;1;1;3;0;3
294;27.03.2017;2017;03;07;Maanantai;9;5;14;8;4;12
294;27.03.2017;2017;03;08;Maanantai;11;0;11;14;6;20
294;27.03.2017;2017;03;09;Maanantai;8;6;14;23;12;35
294;27.03.2017;2017;03;10;Maanantai;2;2;4;14;4;18
294;27.03.2017;2017;03;11;Maanantai;2;1;3;21;23;44
294;27.03.2017;2017;03;12;Maanantai;1;4;5;19;17;36
294;27.03.2017;2017;03;13;Maanantai;2;12;14;13;28;41
294;27.03.2017;2017;03;14;Maanantai;5;11;16;9;20;29
294;27.03.2017;2017;03;15;Maanantai;7;10;17;21;21;42
294;27.03.2017;2017;03;16;Maanantai;6;3;9;7;9;16
294;27.03.2017;2017;03;17;Maanantai;5;5;10;14;13;27
294;27.03.2017;2017;03;18;Maanantai;5;3;8;21;15;36
294;27.03.2017;2017;03;19;Maanantai;3;2;5;16;8;24
294;27.03.2017;2017;03;20;Maanantai;3;2;5;10;5;15
294;27.03.2017;2017;03;21;Maanantai;0;1;1;3;2;5
294;27.03.2017;2017;03;22;Maanantai;1;0;1;0;0;0
294;27.03.2017;2017;03;23;Maanantai;0;0;0;0;0;0
294;28.03.2017;2017;03;00;Tiistai;0;0;0;1;0;1
294;28.03.2017;2017;03;01;Tiistai;0;0;0;0;0;0
294;28.03.2017;2017;03;02;Tiistai;0;0;0;0;0;0
294;28.03.2017;2017;03;03;Tiistai;0;0;0;0;0;0
294;28.03.2017;2017;03;04;Tiistai;0;0;0;0;1;1
294;28.03.2017;2017;03;05;Tiistai;0;0;0;3;0;3
294;28.03.2017;2017;03;06;Tiistai;0;2;2;1;2;3
294;28.03.2017;2017;03;07;Tiistai;4;3;7;11;6;17
294;28.03.2017;2017;03;08;Tiistai;10;0;10;12;9;21
294;28.03.2017;2017;03;09;Tiistai;5;5;10;11;13;24
294;28.03.2017;2017;03;10;Tiistai;2;0;2;15;14;29
294;28.03.2017;2017;03;11;Tiistai;2;2;4;21;21;42
294;28.03.2017;2017;03;12;Tiistai;2;3;5;14;12;26
294;28.03.2017;2017;03;13;Tiistai;2;2;4;16;10;26
294;28.03.2017;2017;03;14;Tiistai;6;6;12;19;17;36
294;28.03.2017;2017;03;15;Tiistai;7;12;19;20;27;47
294;28.03.2017;2017;03;16;Tiistai;4;4;8;17;20;37
294;28.03.2017;2017;03;17;Tiistai;2;4;6;20;14;34
294;28.03.2017;2017;03;18;Tiistai;5;7;12;16;27;43
294;28.03.2017;2017;03;19;Tiistai;8;0;8;20;14;34
294;28.03.2017;2017;03;20;Tiistai;0;3;3;8;3;11
294;28.03.2017;2017;03;21;Tiistai;1;0;1;2;2;4
294;28.03.2017;2017;03;22;Tiistai;0;0;0;1;0;1
294;28.03.2017;2017;03;23;Tiistai;0;0;0;0;0;0
294;29.03.2017;2017;03;00;Keskiviikko;0;0;0;0;0;0
294;29.03.2017;2017;03;01;Keskiviikko;0;0;0;0;0;0
294;29.03.2017;2017;03;02;Keskiviikko;0;0;0;0;0;0
294;29.03.2017;2017;03;03;Keskiviikko;0;0;0;0;0;0
294;29.03.2017;2017;03;04;Keskiviikko;0;0;0;0;1;1
294;29.03.2017;2017;03;05;Keskiviikko;0;0;0;2;0;2
294;29.03.2017;2017;03;06;Keskiviikko;0;2;2;5;3;8
294;29.03.2017;2017;03;07;Keskiviikko;2;1;3;11;2;13
294;29.03.2017;2017;03;08;Keskiviikko;9;0;9;8;4;12
294;29.03.2017;2017;03;09;Keskiviikko;6;1;7;15;11;26
294;29.03.2017;2017;03;10;Keskiviikko;2;3;5;11;18;29
294;29.03.2017;2017;03;11;Keskiviikko;1;3;4;21;12;33
294;29.03.2017;2017;03;12;Keskiviikko;7;8;15;9;15;24
294;29.03.2017;2017;03;13;Keskiviikko;1;6;7;19;18;37
294;29.03.2017;2017;03;14;Keskiviikko;3;13;16;19;26;45
294;29.03.2017;2017;03;15;Keskiviikko;7;12;19;16;19;35
294;29.03.2017;2017;03;16;Keskiviikko;5;2;7;16;17;33
294;29.03.2017;2017;03;17;Keskiviikko;6;3;9;8;7;15
294;29.03.2017;2017;03;18;Keskiviikko;5;3;8;20;12;32
294;29.03.2017;2017;03;19;Keskiviikko;6;5;11;14;19;33
294;29.03.2017;2017;03;20;Keskiviikko;1;2;3;13;13;26
294;29.03.2017;2017;03;21;Keskiviikko;0;0;0;0;1;1
294;29.03.2017;2017;03;22;Keskiviikko;0;0;0;0;0;0
294;29.03.2017;2017;03;23;Keskiviikko;0;0;0;0;0;0
294;30.03.2017;2017;03;00;Torstai;0;0;0;0;0;0
294;30.03.2017;2017;03;01;Torstai;0;0;0;0;0;0
294;30.03.2017;2017;03;02;Torstai;0;0;0;0;0;0
294;30.03.2017;2017;03;03;Torstai;0;0;0;0;0;0
294;30.03.2017;2017;03;04;Torstai;0;0;0;0;1;1
294;30.03.2017;2017;03;05;Torstai;0;0;0;2;0;2
294;30.03.2017;2017;03;06;Torstai;0;1;1;1;0;1
294;30.03.2017;2017;03;07;Torstai;8;1;9;16;6;22
294;30.03.2017;2017;03;08;Torstai;3;1;4;13;3;16
294;30.03.2017;2017;03;09;Torstai;5;1;6;8;4;12
294;30.03.2017;2017;03;10;Torstai;0;0;0;12;14;26
294;30.03.2017;2017;03;11;Torstai;0;1;1;8;12;20
294;30.03.2017;2017;03;12;Torstai;1;4;5;9;17;26
294;30.03.2017;2017;03;13;Torstai;2;11;13;13;12;25
294;30.03.2017;2017;03;14;Torstai;6;7;13;13;23;36
294;30.03.2017;2017;03;15;Torstai;3;2;5;19;17;36
294;30.03.2017;2017;03;16;Torstai;3;7;10;15;13;28
294;30.03.2017;2017;03;17;Torstai;4;2;6;9;12;21
294;30.03.2017;2017;03;18;Torstai;8;1;9;6;11;17
294;30.03.2017;2017;03;19;Torstai;0;0;0;13;10;23
294;30.03.2017;2017;03;20;Torstai;1;3;4;3;7;10
294;30.03.2017;2017;03;21;Torstai;0;0;0;1;1;2
294;30.03.2017;2017;03;22;Torstai;0;0;0;1;0;1
294;30.03.2017;2017;03;23;Torstai;0;0;0;0;0;0
294;31.03.2017;2017;03;00;Perjantai;0;0;0;0;0;0
294;31.03.2017;2017;03;01;Perjantai;0;0;0;0;0;0
294;31.03.2017;2017;03;02;Perjantai;0;0;0;0;0;0
294;31.03.2017;2017;03;03;Perjantai;0;0;0;0;0;0
294;31.03.2017;2017;03;04;Perjantai;0;0;0;0;0;0
294;31.03.2017;2017;03;05;Perjantai;0;0;0;2;0;2
294;31.03.2017;2017;03;06;Perjantai;1;0;1;3;10;13
294;31.03.2017;2017;03;07;Perjantai;11;1;12;9;7;16
294;31.03.2017;2017;03;08;Perjantai;10;0;10;17;5;22
294;31.03.2017;2017;03;09;Perjantai;5;2;7;37;7;44
294;31.03.2017;2017;03;10;Perjantai;0;3;3;12;28;40
294;31.03.2017;2017;03;11;Perjantai;0;5;5;18;16;34
294;31.03.2017;2017;03;12;Perjantai;6;9;15;28;28;56
294;31.03.2017;2017;03;13;Perjantai;8;15;23;28;30;58
294;31.03.2017;2017;03;14;Perjantai;9;10;19;19;18;37
294;31.03.2017;2017;03;15;Perjantai;9;6;15;19;9;28
294;31.03.2017;2017;03;16;Perjantai;9;3;12;20;20;40
294;31.03.2017;2017;03;17;Perjantai;4;3;7;13;19;32
294;31.03.2017;2017;03;18;Perjantai;7;9;16;25;20;45
294;31.03.2017;2017;03;19;Perjantai;2;3;5;27;12;39
294;31.03.2017;2017;03;20;Perjantai;6;1;7;2;4;6
294;31.03.2017;2017;03;21;Perjantai;4;7;11;16;8;24
294;31.03.2017;2017;03;22;Perjantai;0;1;1;0;3;3
294;31.03.2017;2017;03;23;Perjantai;0;0;0;0;0;0
294;01.04.2017;2017;04;00;Lauantai;0;0;0;0;0;0
294;01.04.2017;2017;04;01;Lauantai;0;0;0;0;0;0
294;01.04.2017;2017;04;02;Lauantai;0;0;0;0;0;0
294;01.04.2017;2017;04;03;Lauantai;0;0;0;0;0;0
294;01.04.2017;2017;04;04;Lauantai;0;0;0;0;0;0
294;01.04.2017;2017;04;05;Lauantai;0;0;0;0;0;0
294;01.04.2017;2017;04;06;Lauantai;0;0;0;3;0;3
294;01.04.2017;2017;04;07;Lauantai;2;0;2;3;1;4
294;01.04.2017;2017;04;08;Lauantai;1;0;1;5;6;11
294;01.04.2017;2017;04;09;Lauantai;0;0;0;14;13;27
294;01.04.2017;2017;04;10;Lauantai;2;1;3;15;5;20
294;01.04.2017;2017;04;11;Lauantai;1;3;4;6;16;22
294;01.04.2017;2017;04;12;Lauantai;2;4;6;14;11;25
294;01.04.2017;2017;04;13;Lauantai;6;1;7;14;12;26
294;01.04.2017;2017;04;14;Lauantai;2;8;10;14;13;27
294;01.04.2017;2017;04;15;Lauantai;1;4;5;14;3;17
294;01.04.2017;2017;04;16;Lauantai;1;0;1;9;8;17
294;01.04.2017;2017;04;17;Lauantai;2;2;4;11;6;17
294;01.04.2017;2017;04;18;Lauantai;6;5;11;9;2;11
294;01.04.2017;2017;04;19;Lauantai;9;6;15;19;13;32
294;01.04.2017;2017;04;20;Lauantai;0;1;1;5;6;11
294;01.04.2017;2017;04;21;Lauantai;1;1;2;3;5;8
294;01.04.2017;2017;04;22;Lauantai;1;0;1;2;0;2
294;01.04.2017;2017;04;23;Lauantai;0;0;0;1;0;1
294;02.04.2017;2017;04;00;Sunnuntai;1;0;1;0;0;0
294;02.04.2017;2017;04;01;Sunnuntai;0;0;0;0;0;0
294;02.04.2017;2017;04;02;Sunnuntai;2;0;2;0;0;0
294;02.04.2017;2017;04;03;Sunnuntai;0;0;0;0;0;0
294;02.04.2017;2017;04;04;Sunnuntai;0;0;0;0;0;0
294;02.04.2017;2017;04;05;Sunnuntai;0;0;0;0;0;0
294;02.04.2017;2017;04;06;Sunnuntai;1;0;1;0;0;0
294;02.04.2017;2017;04;07;Sunnuntai;1;0;1;1;0;1
294;02.04.2017;2017;04;08;Sunnuntai;0;0;0;5;7;12
294;02.04.2017;2017;04;09;Sunnuntai;1;0;1;16;8;24
294;02.04.2017;2017;04;10;Sunnuntai;1;0;1;11;7;18
294;02.04.2017;2017;04;11;Sunnuntai;0;2;2;2;15;17
294;02.04.2017;2017;04;12;Sunnuntai;1;5;6;11;6;17
294;02.04.2017;2017;04;13;Sunnuntai;1;3;4;11;14;25
294;02.04.2017;2017;04;14;Sunnuntai;8;4;12;17;13;30
294;02.04.2017;2017;04;15;Sunnuntai;3;6;9;9;14;23
294;02.04.2017;2017;04;16;Sunnuntai;6;4;10;12;10;22
294;02.04.2017;2017;04;17;Sunnuntai;7;7;14;15;3;18
294;02.04.2017;2017;04;18;Sunnuntai;3;3;6;11;15;26
294;02.04.2017;2017;04;19;Sunnuntai;3;1;4;14;12;26
294;02.04.2017;2017;04;20;Sunnuntai;0;1;1;6;3;9
294;02.04.2017;2017;04;21;Sunnuntai;0;0;0;1;1;2
294;02.04.2017;2017;04;22;Sunnuntai;0;0;0;1;0;1
294;02.04.2017;2017;04;23;Sunnuntai;0;0;0;1;0;1
294;03.04.2017;2017;04;00;Maanantai;0;0;0;0;0;0
294;03.04.2017;2017;04;01;Maanantai;0;0;0;0;0;0
294;03.04.2017;2017;04;02;Maanantai;0;0;0;0;0;0
294;03.04.2017;2017;04;03;Maanantai;0;0;0;0;0;0
294;03.04.2017;2017;04;04;Maanantai;0;0;0;0;0;0
294;03.04.2017;2017;04;05;Maanantai;0;0;0;0;0;0
294;03.04.2017;2017;04;06;Maanantai;1;1;2;0;0;0
294;03.04.2017;2017;04;07;Maanantai;8;4;12;5;4;9
294;03.04.2017;2017;04;08;Maanantai;17;0;17;9;4;13
294;03.04.2017;2017;04;09;Maanantai;8;3;11;26;16;42
294;03.04.2017;2017;04;10;Maanantai;2;5;7;15;8;23
294;03.04.2017;2017;04;11;Maanantai;5;4;9;31;23;54
294;03.04.2017;2017;04;12;Maanantai;2;4;6;14;16;30
294;03.04.2017;2017;04;13;Maanantai;6;7;13;21;14;35
294;03.04.2017;2017;04;14;Maanantai;4;8;12;22;18;40
294;03.04.2017;2017;04;15;Maanantai;4;19;23;20;19;39
294;03.04.2017;2017;04;16;Maanantai;4;3;7;6;21;27
294;03.04.2017;2017;04;17;Maanantai;2;7;9;13;8;21
294;03.04.2017;2017;04;18;Maanantai;13;6;19;11;11;22
294;03.04.2017;2017;04;19;Maanantai;5;4;9;18;9;27
294;03.04.2017;2017;04;20;Maanantai;2;2;4;7;7;14
294;03.04.2017;2017;04;21;Maanantai;1;0;1;1;1;2
294;03.04.2017;2017;04;22;Maanantai;0;0;0;1;0;1
294;03.04.2017;2017;04;23;Maanantai;0;0;0;0;0;0
294;04.04.2017;2017;04;00;Tiistai;0;0;0;0;0;0
294;04.04.2017;2017;04;01;Tiistai;0;0;0;0;0;0
294;04.04.2017;2017;04;02;Tiistai;0;0;0;0;0;0
294;04.04.2017;2017;04;03;Tiistai;0;0;0;0;0;0
294;04.04.2017;2017;04;04;Tiistai;0;0;0;0;1;1
294;04.04.2017;2017;04;05;Tiistai;0;0;0;0;0;0
294;04.04.2017;2017;04;06;Tiistai;0;2;2;1;4;5
294;04.04.2017;2017;04;07;Tiistai;2;2;4;8;7;15
294;04.04.2017;2017;04;08;Tiistai;9;0;9;15;1;16
294;04.04.2017;2017;04;09;Tiistai;5;0;5;17;18;35
294;04.04.2017;2017;04;10;Tiistai;0;0;0;16;10;26
294;04.04.2017;2017;04;11;Tiistai;1;4;5;18;33;51
294;04.04.2017;2017;04;12;Tiistai;5;2;7;10;17;27
294;04.04.2017;2017;04;13;Tiistai;3;4;7;9;20;29
294;04.04.2017;2017;04;14;Tiistai;6;6;12;7;25;32
294;04.04.2017;2017;04;15;Tiistai;5;9;14;18;31;49
294;04.04.2017;2017;04;16;Tiistai;9;6;15;10;21;31
294;04.04.2017;2017;04;17;Tiistai;12;7;19;21;19;40
294;04.04.2017;2017;04;18;Tiistai;7;7;14;24;27;51
294;04.04.2017;2017;04;19;Tiistai;4;3;7;14;8;22
294;04.04.2017;2017;04;20;Tiistai;4;5;9;5;10;15
294;04.04.2017;2017;04;21;Tiistai;2;0;2;1;3;4
294;04.04.2017;2017;04;22;Tiistai;0;0;0;1;0;1
294;04.04.2017;2017;04;23;Tiistai;0;0;0;0;0;0
294;05.04.2017;2017;04;00;Keskiviikko;0;0;0;0;0;0
294;05.04.2017;2017;04;01;Keskiviikko;0;0;0;0;0;0
294;05.04.2017;2017;04;02;Keskiviikko;0;0;0;1;0;1
294;05.04.2017;2017;04;03;Keskiviikko;0;0;0;0;0;0
294;05.04.2017;2017;04;04;Keskiviikko;0;0;0;0;1;1
294;05.04.2017;2017;04;05;Keskiviikko;1;0;1;0;0;0
294;05.04.2017;2017;04;06;Keskiviikko;0;1;1;2;0;2
294;05.04.2017;2017;04;07;Keskiviikko;7;2;9;4;6;10
294;05.04.2017;2017;04;08;Keskiviikko;9;1;10;19;4;23
294;05.04.2017;2017;04;09;Keskiviikko;14;3;17;18;21;39
294;05.04.2017;2017;04;10;Keskiviikko;1;0;1;19;24;43
294;05.04.2017;2017;04;11;Keskiviikko;4;7;11;18;28;46
294;05.04.2017;2017;04;12;Keskiviikko;1;4;5;20;19;39
294;05.04.2017;2017;04;13;Keskiviikko;2;17;19;22;11;33
294;05.04.2017;2017;04;14;Keskiviikko;6;11;17;20;25;45
294;05.04.2017;2017;04;15;Keskiviikko;10;7;17;17;31;48
294;05.04.2017;2017;04;16;Keskiviikko;9;10;19;17;17;34
294;05.04.2017;2017;04;17;Keskiviikko;6;7;13;25;23;48
294;05.04.2017;2017;04;18;Keskiviikko;5;5;10;22;9;31
294;05.04.2017;2017;04;19;Keskiviikko;3;6;9;21;22;43
294;05.04.2017;2017;04;20;Keskiviikko;5;2;7;8;10;18
294;05.04.2017;2017;04;21;Keskiviikko;1;0;1;4;3;7
294;05.04.2017;2017;04;22;Keskiviikko;0;0;0;0;0;0
294;05.04.2017;2017;04;23;Keskiviikko;0;0;0;0;0;0
294;06.04.2017;2017;04;00;Torstai;0;0;0;0;0;0
294;06.04.2017;2017;04;01;Torstai;0;0;0;0;0;0
294;06.04.2017;2017;04;02;Torstai;0;0;0;0;0;0
294;06.04.2017;2017;04;03;Torstai;0;0;0;0;0;0
294;06.04.2017;2017;04;04;Torstai;0;0;0;0;1;1
294;06.04.2017;2017;04;05;Torstai;0;0;0;0;0;0
294;06.04.2017;2017;04;06;Torstai;0;0;0;0;3;3
294;06.04.2017;2017;04;07;Torstai;17;1;18;18;4;22
294;06.04.2017;2017;04;08;Torstai;8;3;11;11;6;17
294;06.04.2017;2017;04;09;Torstai;7;0;7;21;8;29
294;06.04.2017;2017;04;10;Torstai;0;1;1;9;10;19
294;06.04.2017;2017;04;11;Torstai;3;7;10;27;26;53
294;06.04.2017;2017;04;12;Torstai;1;6;7;18;13;31
294;06.04.2017;2017;04;13;Torstai;8;17;25;8;21;29
294;06.04.2017;2017;04;14;Torstai;7;12;19;13;25;38
294;06.04.2017;2017;04;15;Torstai;3;7;10;8;16;24
294;06.04.2017;2017;04;16;Torstai;5;6;11;17;15;32
294;06.04.2017;2017;04;17;Torstai;4;7;11;20;7;27
294;06.04.2017;2017;04;18;Torstai;9;5;14;19;16;35
294;06.04.2017;2017;04;19;Torstai;3;8;11;8;7;15
294;06.04.2017;2017;04;20;Torstai;5;1;6;5;6;11
294;06.04.2017;2017;04;21;Torstai;0;1;1;2;2;4
294;06.04.2017;2017;04;22;Torstai;0;0;0;0;0;0
294;06.04.2017;2017;04;23;Torstai;0;0;0;1;0;1
294;07.04.2017;2017;04;00;Perjantai;0;0;0;0;0;0
294;07.04.2017;2017;04;01;Perjantai;0;0;0;0;0;0
294;07.04.2017;2017;04;02;Perjantai;0;0;0;0;1;1
294;07.04.2017;2017;04;03;Perjantai;0;0;0;0;0;0
294;07.04.2017;2017;04;04;Perjantai;0;0;0;0;0;0
294;07.04.2017;2017;04;05;Perjantai;0;0;0;0;0;0
294;07.04.2017;2017;04;06;Perjantai;1;0;1;3;3;6
294;07.04.2017;2017;04;07;Perjantai;8;2;10;15;8;23
294;07.04.2017;2017;04;08;Perjantai;11;1;12;22;5;27
294;07.04.2017;2017;04;09;Perjantai;5;2;7;42;21;63
294;07.04.2017;2017;04;10;Perjantai;4;4;8;11;36;47
294;07.04.2017;2017;04;11;Perjantai;2;7;9;32;27;59
294;07.04.2017;2017;04;12;Perjantai;9;18;27;10;37;47
294;07.04.2017;2017;04;13;Perjantai;8;15;23;22;32;54
294;07.04.2017;2017;04;14;Perjantai;1;16;17;19;27;46
294;07.04.2017;2017;04;15;Perjantai;10;10;20;16;16;32
294;07.04.2017;2017;04;16;Perjantai;4;4;8;11;12;23
294;07.04.2017;2017;04;17;Perjantai;3;3;6;11;22;33
294;07.04.2017;2017;04;18;Perjantai;1;0;1;14;5;19
294;07.04.2017;2017;04;19;Perjantai;1;2;3;6;11;17
294;07.04.2017;2017;04;20;Perjantai;3;0;3;5;5;10
294;07.04.2017;2017;04;21;Perjantai;0;1;1;5;9;14
294;07.04.2017;2017;04;22;Perjantai;1;0;1;4;2;6
294;07.04.2017;2017;04;23;Perjantai;1;0;1;0;3;3
294;08.04.2017;2017;04;00;Lauantai;0;0;0;0;0;0
294;08.04.2017;2017;04;01;Lauantai;0;0;0;0;0;0
294;08.04.2017;2017;04;02;Lauantai;0;0;0;0;0;0
294;08.04.2017;2017;04;03;Lauantai;0;0;0;0;0;0
294;08.04.2017;2017;04;04;Lauantai;0;0;0;0;0;0
294;08.04.2017;2017;04;05;Lauantai;0;0;0;0;0;0
294;08.04.2017;2017;04;06;Lauantai;0;0;0;1;1;2
294;08.04.2017;2017;04;07;Lauantai;0;0;0;2;3;5
294;08.04.2017;2017;04;08;Lauantai;0;1;1;3;4;7
294;08.04.2017;2017;04;09;Lauantai;1;0;1;14;12;26
294;08.04.2017;2017;04;10;Lauantai;0;1;1;12;27;39
294;08.04.2017;2017;04;11;Lauantai;3;4;7;40;22;62
294;08.04.2017;2017;04;12;Lauantai;4;3;7;28;17;45
294;08.04.2017;2017;04;13;Lauantai;6;6;12;26;32;58
294;08.04.2017;2017;04;14;Lauantai;3;7;10;31;31;62
294;08.04.2017;2017;04;15;Lauantai;1;1;2;25;23;48
294;08.04.2017;2017;04;16;Lauantai;2;4;6;34;22;56
294;08.04.2017;2017;04;17;Lauantai;4;4;8;26;10;36
294;08.04.2017;2017;04;18;Lauantai;7;9;16;11;18;29
294;08.04.2017;2017;04;19;Lauantai;4;4;8;22;1;23
294;08.04.2017;2017;04;20;Lauantai;6;0;6;9;18;27
294;08.04.2017;2017;04;21;Lauantai;1;0;1;6;0;6
294;08.04.2017;2017;04;22;Lauantai;0;0;0;6;3;9
294;08.04.2017;2017;04;23;Lauantai;0;0;0;4;0;4
294;09.04.2017;2017;04;00;Sunnuntai;0;0;0;0;1;1
294;09.04.2017;2017;04;01;Sunnuntai;0;0;0;0;0;0
294;09.04.2017;2017;04;02;Sunnuntai;0;0;0;0;0;0
294;09.04.2017;2017;04;03;Sunnuntai;0;0;0;0;1;1
294;09.04.2017;2017;04;04;Sunnuntai;0;0;0;0;0;0
294;09.04.2017;2017;04;05;Sunnuntai;0;0;0;0;0;0
294;09.04.2017;2017;04;06;Sunnuntai;0;0;0;2;0;2
294;09.04.2017;2017;04;07;Sunnuntai;1;0;1;3;0;3
294;09.04.2017;2017;04;08;Sunnuntai;0;0;0;3;3;6
294;09.04.2017;2017;04;09;Sunnuntai;2;1;3;23;4;27
294;09.04.2017;2017;04;10;Sunnuntai;1;1;2;2;12;14
294;09.04.2017;2017;04;11;Sunnuntai;1;3;4;4;8;12
294;09.04.2017;2017;04;12;Sunnuntai;2;1;3;9;6;15
294;09.04.2017;2017;04;13;Sunnuntai;2;2;4;6;12;18
294;09.04.2017;2017;04;14;Sunnuntai;3;4;7;7;8;15
294;09.04.2017;2017;04;15;Sunnuntai;4;1;5;6;12;18
294;09.04.2017;2017;04;16;Sunnuntai;5;4;9;31;10;41
294;09.04.2017;2017;04;17;Sunnuntai;3;1;4;9;19;28
294;09.04.2017;2017;04;18;Sunnuntai;2;0;2;11;7;18
294;09.04.2017;2017;04;19;Sunnuntai;0;2;2;11;7;18
294;09.04.2017;2017;04;20;Sunnuntai;3;0;3;11;8;19
294;09.04.2017;2017;04;21;Sunnuntai;1;0;1;2;2;4
294;09.04.2017;2017;04;22;Sunnuntai;0;0;0;1;0;1
294;09.04.2017;2017;04;23;Sunnuntai;0;0;0;0;1;1
294;10.04.2017;2017;04;00;Maanantai;0;0;0;0;0;0
294;10.04.2017;2017;04;01;Maanantai;0;0;0;0;0;0
294;10.04.2017;2017;04;02;Maanantai;0;0;0;0;0;0
294;10.04.2017;2017;04;03;Maanantai;0;0;0;0;0;0
294;10.04.2017;2017;04;04;Maanantai;0;0;0;0;1;1
294;10.04.2017;2017;04;05;Maanantai;0;0;0;3;0;3
294;10.04.2017;2017;04;06;Maanantai;0;0;0;0;1;1
294;10.04.2017;2017;04;07;Maanantai;1;3;4;15;6;21
294;10.04.2017;2017;04;08;Maanantai;6;2;8;17;6;23
294;10.04.2017;2017;04;09;Maanantai;6;1;7;17;8;25
294;10.04.2017;2017;04;10;Maanantai;2;0;2;10;9;19
294;10.04.2017;2017;04;11;Maanantai;0;3;3;21;19;40
294;10.04.2017;2017;04;12;Maanantai;4;2;6;11;23;34
294;10.04.2017;2017;04;13;Maanantai;4;9;13;24;20;44
294;10.04.2017;2017;04;14;Maanantai;2;12;14;15;29;44
294;10.04.2017;2017;04;15;Maanantai;5;13;18;6;22;28
294;10.04.2017;2017;04;16;Maanantai;4;4;8;12;13;25
294;10.04.2017;2017;04;17;Maanantai;0;1;1;10;8;18
294;10.04.2017;2017;04;18;Maanantai;3;1;4;6;1;7
294;10.04.2017;2017;04;19;Maanantai;5;0;5;6;0;6
294;10.04.2017;2017;04;20;Maanantai;0;0;0;3;3;6
294;10.04.2017;2017;04;21;Maanantai;0;0;0;5;0;5
294;10.04.2017;2017;04;22;Maanantai;0;0;0;1;0;1
294;10.04.2017;2017;04;23;Maanantai;0;0;0;0;0;0
294;11.04.2017;2017;04;00;Tiistai;0;0;0;0;0;0
294;11.04.2017;2017;04;01;Tiistai;0;0;0;0;0;0
294;11.04.2017;2017;04;02;Tiistai;0;0;0;0;0;0
294;11.04.2017;2017;04;03;Tiistai;0;0;0;0;0;0
294;11.04.2017;2017;04;04;Tiistai;0;0;0;0;0;0
294;11.04.2017;2017;04;05;Tiistai;0;0;0;2;0;2
294;11.04.2017;2017;04;06;Tiistai;1;0;1;3;1;4
294;11.04.2017;2017;04;07;Tiistai;3;1;4;9;3;12
294;11.04.2017;2017;04;08;Tiistai;2;1;3;18;5;23
294;11.04.2017;2017;04;09;Tiistai;1;0;1;17;3;20
294;11.04.2017;2017;04;10;Tiistai;1;1;2;8;6;14
294;11.04.2017;2017;04;11;Tiistai;3;3;6;9;11;20
294;11.04.2017;2017;04;12;Tiistai;1;1;2;11;14;25
294;11.04.2017;2017;04;13;Tiistai;2;3;5;19;12;31
294;11.04.2017;2017;04;14;Tiistai;2;4;6;14;18;32
294;11.04.2017;2017;04;15;Tiistai;2;6;8;15;48;63
294;11.04.2017;2017;04;16;Tiistai;1;4;5;23;22;45
294;11.04.2017;2017;04;17;Tiistai;7;3;10;19;12;31
294;11.04.2017;2017;04;18;Tiistai;2;0;2;10;29;39
294;11.04.2017;2017;04;19;Tiistai;1;3;4;18;9;27
294;11.04.2017;2017;04;20;Tiistai;1;2;3;9;10;19
294;11.04.2017;2017;04;21;Tiistai;0;1;1;0;1;1
294;11.04.2017;2017;04;22;Tiistai;0;1;1;3;2;5
294;11.04.2017;2017;04;23;Tiistai;0;0;0;0;0;0
294;12.04.2017;2017;04;00;Keskiviikko;0;0;0;0;0;0
294;12.04.2017;2017;04;01;Keskiviikko;0;0;0;0;0;0
294;12.04.2017;2017;04;02;Keskiviikko;0;0;0;0;0;0
294;12.04.2017;2017;04;03;Keskiviikko;0;0;0;0;0;0
294;12.04.2017;2017;04;04;Keskiviikko;0;0;0;0;0;0
294;12.04.2017;2017;04;05;Keskiviikko;0;0;0;2;0;2
294;12.04.2017;2017;04;06;Keskiviikko;0;0;0;1;2;3
294;12.04.2017;2017;04;07;Keskiviikko;3;1;4;24;7;31
294;12.04.2017;2017;04;08;Keskiviikko;3;0;3;20;7;27
294;12.04.2017;2017;04;09;Keskiviikko;4;2;6;33;25;58
294;12.04.2017;2017;04;10;Keskiviikko;0;2;2;32;35;67
294;12.04.2017;2017;04;11;Keskiviikko;5;4;9;37;29;66
294;12.04.2017;2017;04;12;Keskiviikko;1;4;5;27;34;61
294;12.04.2017;2017;04;13;Keskiviikko;3;8;11;24;35;59
294;12.04.2017;2017;04;14;Keskiviikko;3;7;10;36;39;75
294;12.04.2017;2017;04;15;Keskiviikko;9;4;13;36;18;54
294;12.04.2017;2017;04;16;Keskiviikko;4;1;5;12;21;33
294;12.04.2017;2017;04;17;Keskiviikko;3;2;5;15;17;32
294;12.04.2017;2017;04;18;Keskiviikko;3;2;5;15;40;55
294;12.04.2017;2017;04;19;Keskiviikko;1;2;3;25;14;39
294;12.04.2017;2017;04;20;Keskiviikko;2;0;2;16;12;28
294;12.04.2017;2017;04;21;Keskiviikko;0;0;0;2;2;4
294;12.04.2017;2017;04;22;Keskiviikko;0;0;0;0;0;0
294;12.04.2017;2017;04;23;Keskiviikko;0;1;1;0;0;0
294;13.04.2017;2017;04;00;Torstai;0;0;0;0;0;0
294;13.04.2017;2017;04;01;Torstai;0;0;0;0;0;0
294;13.04.2017;2017;04;02;Torstai;0;0;0;0;0;0
294;13.04.2017;2017;04;03;Torstai;0;0;0;0;0;0
294;13.04.2017;2017;04;04;Torstai;0;0;0;0;0;0
294;13.04.2017;2017;04;05;Torstai;0;0;0;4;0;4
294;13.04.2017;2017;04;06;Torstai;0;0;0;1;5;6
294;13.04.2017;2017;04;07;Torstai;3;0;3;25;4;29
294;13.04.2017;2017;04;08;Torstai;3;1;4;21;12;33
294;13.04.2017;2017;04;09;Torstai;3;3;6;20;6;26
294;13.04.2017;2017;04;10;Torstai;2;3;5;13;10;23
294;13.04.2017;2017;04;11;Torstai;6;5;11;18;30;48
294;13.04.2017;2017;04;12;Torstai;3;6;9;18;15;33
294;13.04.2017;2017;04;13;Torstai;12;18;30;17;27;44
294;13.04.2017;2017;04;14;Torstai;10;12;22;19;28;47
294;13.04.2017;2017;04;15;Torstai;4;10;14;10;28;38
294;13.04.2017;2017;04;16;Torstai;5;1;6;15;6;21
294;13.04.2017;2017;04;17;Torstai;1;7;8;10;12;22
294;13.04.2017;2017;04;18;Torstai;3;7;10;25;13;38
294;13.04.2017;2017;04;19;Torstai;5;12;17;10;7;17
294;13.04.2017;2017;04;20;Torstai;2;1;3;12;11;23
294;13.04.2017;2017;04;21;Torstai;0;0;0;5;1;6
294;13.04.2017;2017;04;22;Torstai;0;0;0;1;1;2
294;13.04.2017;2017;04;23;Torstai;0;0;0;3;1;4
294;14.04.2017;2017;04;00;Perjantai;0;0;0;0;0;0
294;14.04.2017;2017;04;01;Perjantai;0;0;0;0;0;0
294;14.04.2017;2017;04;02;Perjantai;0;0;0;0;0;0
294;14.04.2017;2017;04;03;Perjantai;0;0;0;0;0;0
294;14.04.2017;2017;04;04;Perjantai;0;0;0;0;0;0
294;14.04.2017;2017;04;05;Perjantai;0;0;0;1;0;1
294;14.04.2017;2017;04;06;Perjantai;0;0;0;2;0;2
294;14.04.2017;2017;04;07;Perjantai;0;0;0;1;2;3
294;14.04.2017;2017;04;08;Perjantai;0;0;0;3;1;4
294;14.04.2017;2017;04;09;Perjantai;1;1;2;9;12;21
294;14.04.2017;2017;04;10;Perjantai;0;0;0;6;13;19
294;14.04.2017;2017;04;11;Perjantai;2;1;3;6;10;16
294;14.04.2017;2017;04;12;Perjantai;1;5;6;10;12;22
294;14.04.2017;2017;04;13;Perjantai;0;8;8;12;12;24
294;14.04.2017;2017;04;14;Perjantai;4;1;5;11;10;21
294;14.04.2017;2017;04;15;Perjantai;6;1;7;16;8;24
294;14.04.2017;2017;04;16;Perjantai;8;8;16;20;5;25
294;14.04.2017;2017;04;17;Perjantai;7;6;13;6;8;14
294;14.04.2017;2017;04;18;Perjantai;1;2;3;8;6;14
294;14.04.2017;2017;04;19;Perjantai;6;0;6;9;1;10
294;14.04.2017;2017;04;20;Perjantai;2;5;7;4;4;8
294;14.04.2017;2017;04;21;Perjantai;2;3;5;2;1;3
294;14.04.2017;2017;04;22;Perjantai;0;1;1;0;2;2
294;14.04.2017;2017;04;23;Perjantai;0;0;0;0;0;0
294;15.04.2017;2017;04;00;Lauantai;2;0;2;0;0;0
294;15.04.2017;2017;04;01;Lauantai;0;0;0;0;1;1
294;15.04.2017;2017;04;02;Lauantai;0;0;0;0;0;0
294;15.04.2017;2017;04;03;Lauantai;0;0;0;0;0;0
294;15.04.2017;2017;04;04;Lauantai;0;0;0;0;0;0
294;15.04.2017;2017;04;05;Lauantai;0;0;0;0;0;0
294;15.04.2017;2017;04;06;Lauantai;0;0;0;3;0;3
294;15.04.2017;2017;04;07;Lauantai;0;0;0;3;3;6
294;15.04.2017;2017;04;08;Lauantai;0;0;0;1;0;1
294;15.04.2017;2017;04;09;Lauantai;0;1;1;4;5;9
294;15.04.2017;2017;04;10;Lauantai;2;1;3;16;14;30
294;15.04.2017;2017;04;11;Lauantai;0;5;5;10;11;21
294;15.04.2017;2017;04;12;Lauantai;4;4;8;8;11;19
294;15.04.2017;2017;04;13;Lauantai;3;5;8;16;11;27
294;15.04.2017;2017;04;14;Lauantai;6;0;6;10;12;22
294;15.04.2017;2017;04;15;Lauantai;2;4;6;11;9;20
294;15.04.2017;2017;04;16;Lauantai;4;3;7;9;10;19
294;15.04.2017;2017;04;17;Lauantai;4;4;8;9;6;15
294;15.04.2017;2017;04;18;Lauantai;1;4;5;6;3;9
294;15.04.2017;2017;04;19;Lauantai;5;1;6;8;6;14
294;15.04.2017;2017;04;20;Lauantai;3;1;4;7;3;10
294;15.04.2017;2017;04;21;Lauantai;3;2;5;5;2;7
294;15.04.2017;2017;04;22;Lauantai;0;0;0;1;0;1
294;15.04.2017;2017;04;23;Lauantai;0;0;0;0;0;0
294;16.04.2017;2017;04;00;Sunnuntai;0;0;0;0;0;0
294;16.04.2017;2017;04;01;Sunnuntai;0;0;0;1;2;3
294;16.04.2017;2017;04;02;Sunnuntai;0;0;0;0;1;1
294;16.04.2017;2017;04;03;Sunnuntai;0;0;0;0;0;0
294;16.04.2017;2017;04;04;Sunnuntai;0;0;0;0;0;0
294;16.04.2017;2017;04;05;Sunnuntai;0;0;0;0;0;0
294;16.04.2017;2017;04;06;Sunnuntai;0;0;0;3;0;3
294;16.04.2017;2017;04;07;Sunnuntai;0;0;0;0;1;1
294;16.04.2017;2017;04;08;Sunnuntai;0;0;0;6;1;7
294;16.04.2017;2017;04;09;Sunnuntai;0;0;0;8;6;14
294;16.04.2017;2017;04;10;Sunnuntai;0;0;0;16;20;36
294;16.04.2017;2017;04;11;Sunnuntai;0;6;6;7;16;23
294;16.04.2017;2017;04;12;Sunnuntai;2;6;8;20;16;36
294;16.04.2017;2017;04;13;Sunnuntai;1;1;2;2;18;20
294;16.04.2017;2017;04;14;Sunnuntai;3;1;4;14;8;22
294;16.04.2017;2017;04;15;Sunnuntai;4;4;8;7;13;20
294;16.04.2017;2017;04;16;Sunnuntai;2;4;6;11;16;27
294;16.04.2017;2017;04;17;Sunnuntai;2;2;4;11;13;24
294;16.04.2017;2017;04;18;Sunnuntai;4;3;7;10;12;22
294;16.04.2017;2017;04;19;Sunnuntai;5;3;8;5;6;11
294;16.04.2017;2017;04;20;Sunnuntai;10;5;15;5;8;13
294;16.04.2017;2017;04;21;Sunnuntai;2;1;3;1;0;1
294;16.04.2017;2017;04;22;Sunnuntai;2;1;3;1;0;1
294;16.04.2017;2017;04;23;Sunnuntai;1;0;1;0;0;0
294;17.04.2017;2017;04;00;Maanantai;0;0;0;0;0;0
294;17.04.2017;2017;04;01;Maanantai;0;1;1;0;0;0
294;17.04.2017;2017;04;02;Maanantai;0;0;0;0;0;0
294;17.04.2017;2017;04;03;Maanantai;0;0;0;0;0;0
294;17.04.2017;2017;04;04;Maanantai;0;0;0;0;0;0
294;17.04.2017;2017;04;05;Maanantai;0;0;0;0;0;0
294;17.04.2017;2017;04;06;Maanantai;4;0;4;0;0;0
294;17.04.2017;2017;04;07;Maanantai;1;1;2;0;1;1
294;17.04.2017;2017;04;08;Maanantai;2;1;3;1;1;2
294;17.04.2017;2017;04;09;Maanantai;2;5;7;1;1;2
294;17.04.2017;2017;04;10;Maanantai;10;5;15;9;10;19
294;17.04.2017;2017;04;11;Maanantai;18;9;27;13;23;36
294;17.04.2017;2017;04;12;Maanantai;17;8;25;12;14;26
294;17.04.2017;2017;04;13;Maanantai;13;16;29;9;12;21
294;17.04.2017;2017;04;14;Maanantai;7;16;23;22;9;31
294;17.04.2017;2017;04;15;Maanantai;8;13;21;14;9;23
294;17.04.2017;2017;04;16;Maanantai;6;10;16;11;6;17
294;17.04.2017;2017;04;17;Maanantai;7;18;25;16;10;26
294;17.04.2017;2017;04;18;Maanantai;9;15;24;21;10;31
294;17.04.2017;2017;04;19;Maanantai;7;7;14;3;6;9
294;17.04.2017;2017;04;20;Maanantai;5;2;7;2;1;3
294;17.04.2017;2017;04;21;Maanantai;0;1;1;0;0;0
294;17.04.2017;2017;04;22;Maanantai;2;1;3;1;1;2
294;17.04.2017;2017;04;23;Maanantai;0;0;0;0;0;0
294;18.04.2017;2017;04;00;Tiistai;0;0;0;0;0;0
294;18.04.2017;2017;04;01;Tiistai;0;0;0;0;0;0
294;18.04.2017;2017;04;02;Tiistai;0;0;0;0;0;0
294;18.04.2017;2017;04;03;Tiistai;0;0;0;0;0;0
294;18.04.2017;2017;04;04;Tiistai;0;0;0;0;0;0
294;18.04.2017;2017;04;05;Tiistai;1;1;2;1;1;2
294;18.04.2017;2017;04;06;Tiistai;4;1;5;1;1;2
294;18.04.2017;2017;04;07;Tiistai;5;6;11;4;5;9
294;18.04.2017;2017;04;08;Tiistai;9;9;18;8;5;13
294;18.04.2017;2017;04;09;Tiistai;8;9;17;5;5;10
294;18.04.2017;2017;04;10;Tiistai;13;5;18;9;16;25
294;18.04.2017;2017;04;11;Tiistai;21;6;27;13;30;43
294;18.04.2017;2017;04;12;Tiistai;13;5;18;9;17;26
294;18.04.2017;2017;04;13;Tiistai;11;5;16;9;20;29
294;18.04.2017;2017;04;14;Tiistai;7;14;21;17;9;26
294;18.04.2017;2017;04;15;Tiistai;6;27;33;38;18;56
294;18.04.2017;2017;04;16;Tiistai;9;18;27;23;10;33
294;18.04.2017;2017;04;17;Tiistai;7;18;25;16;13;29
294;18.04.2017;2017;04;18;Tiistai;5;11;16;20;9;29
294;18.04.2017;2017;04;19;Tiistai;5;15;20;16;10;26
294;18.04.2017;2017;04;20;Tiistai;3;8;11;11;4;15
294;18.04.2017;2017;04;21;Tiistai;1;5;6;1;4;5
294;18.04.2017;2017;04;22;Tiistai;1;0;1;0;0;0
294;18.04.2017;2017;04;23;Tiistai;0;1;1;0;1;1
294;19.04.2017;2017;04;00;Keskiviikko;0;0;0;0;0;0
294;19.04.2017;2017;04;01;Keskiviikko;0;0;0;0;0;0
294;19.04.2017;2017;04;02;Keskiviikko;0;0;0;0;0;0
294;19.04.2017;2017;04;03;Keskiviikko;0;0;0;0;0;0
294;19.04.2017;2017;04;04;Keskiviikko;0;0;0;0;0;0
294;19.04.2017;2017;04;05;Keskiviikko;0;1;1;0;1;1
294;19.04.2017;2017;04;06;Keskiviikko;4;1;5;1;1;2
294;19.04.2017;2017;04;07;Keskiviikko;2;5;7;1;4;5
294;19.04.2017;2017;04;08;Keskiviikko;5;5;10;16;9;25
294;19.04.2017;2017;04;09;Keskiviikko;7;7;14;22;22;44
294;19.04.2017;2017;04;10;Keskiviikko;5;8;13;15;4;19
294;19.04.2017;2017;04;11;Keskiviikko;9;10;19;5;6;11
294;19.04.2017;2017;04;12;Keskiviikko;7;16;23;22;12;34
294;19.04.2017;2017;04;13;Keskiviikko;8;10;18;14;18;32
294;19.04.2017;2017;04;14;Keskiviikko;9;9;18;28;25;53
294;19.04.2017;2017;04;15;Keskiviikko;7;7;14;19;22;41
294;19.04.2017;2017;04;16;Keskiviikko;7;5;12;22;18;40
294;19.04.2017;2017;04;17;Keskiviikko;9;6;15;5;15;20
294;19.04.2017;2017;04;18;Keskiviikko;12;6;18;23;28;51
294;19.04.2017;2017;04;19;Keskiviikko;6;5;11;14;16;30
294;19.04.2017;2017;04;20;Keskiviikko;4;6;10;11;5;16
294;19.04.2017;2017;04;21;Keskiviikko;1;5;6;1;1;2
294;19.04.2017;2017;04;22;Keskiviikko;1;0;1;0;0;0
294;19.04.2017;2017;04;23;Keskiviikko;0;1;1;0;1;1
294;20.04.2017;2017;04;00;Torstai;0;0;0;0;0;0
294;20.04.2017;2017;04;01;Torstai;0;0;0;0;0;0
294;20.04.2017;2017;04;02;Torstai;0;0;0;0;0;0
294;20.04.2017;2017;04;03;Torstai;0;0;0;0;0;0
294;20.04.2017;2017;04;04;Torstai;0;0;0;0;0;0
294;20.04.2017;2017;04;05;Torstai;0;1;1;0;1;1
294;20.04.2017;2017;04;06;Torstai;1;1;2;1;1;2
294;20.04.2017;2017;04;07;Torstai;10;5;15;9;17;26
294;20.04.2017;2017;04;08;Torstai;9;8;17;8;5;13
294;20.04.2017;2017;04;09;Torstai;13;6;19;8;22;30
294;20.04.2017;2017;04;10;Torstai;16;5;21;9;16;25
294;20.04.2017;2017;04;11;Torstai;12;5;17;8;16;24
294;20.04.2017;2017;04;12;Torstai;11;10;21;23;23;46
294;20.04.2017;2017;04;13;Torstai;7;17;24;19;13;32
294;20.04.2017;2017;04;14;Torstai;7;14;21;19;9;28
294;20.04.2017;2017;04;15;Torstai;6;10;16;5;5;10
294;20.04.2017;2017;04;16;Torstai;4;4;8;4;1;5
294;20.04.2017;2017;04;17;Torstai;5;5;10;1;5;6
294;20.04.2017;2017;04;18;Torstai;6;5;11;5;1;6
294;20.04.2017;2017;04;19;Torstai;1;5;6;1;4;5
294;20.04.2017;2017;04;20;Torstai;5;1;6;4;1;5
294;20.04.2017;2017;04;21;Torstai;0;4;4;0;1;1
294;20.04.2017;2017;04;22;Torstai;1;0;1;1;0;1
294;20.04.2017;2017;04;23;Torstai;0;1;1;0;0;0
294;21.04.2017;2017;04;00;Perjantai;1;0;1;1;0;1
294;21.04.2017;2017;04;01;Perjantai;0;0;0;0;0;0
294;21.04.2017;2017;04;02;Perjantai;0;0;0;0;0;0
294;21.04.2017;2017;04;03;Perjantai;0;0;0;0;0;0
294;21.04.2017;2017;04;04;Perjantai;0;0;0;0;0;0
294;21.04.2017;2017;04;05;Perjantai;0;1;1;0;0;0
294;21.04.2017;2017;04;06;Perjantai;4;1;5;4;1;5
294;21.04.2017;2017;04;07;Perjantai;5;8;13;4;5;9
294;21.04.2017;2017;04;08;Perjantai;8;5;13;5;4;9
294;21.04.2017;2017;04;09;Perjantai;17;8;25;12;23;35
294;21.04.2017;2017;04;10;Perjantai;13;3;16;9;18;27
294;21.04.2017;2017;04;11;Perjantai;17;7;24;12;23;35
294;21.04.2017;2017;04;12;Perjantai;9;9;18;24;23;47
294;21.04.2017;2017;04;13;Perjantai;8;9;17;20;23;43
294;21.04.2017;2017;04;14;Perjantai;19;16;35;28;27;55
294;21.04.2017;2017;04;15;Perjantai;12;16;28;27;27;54
294;21.04.2017;2017;04;16;Perjantai;5;7;12;20;16;36
294;21.04.2017;2017;04;17;Perjantai;4;7;11;19;22;41
294;21.04.2017;2017;04;18;Perjantai;5;11;16;22;23;45
294;21.04.2017;2017;04;19;Perjantai;5;12;17;26;24;50
294;21.04.2017;2017;04;20;Perjantai;4;6;10;13;9;22
294;21.04.2017;2017;04;21;Perjantai;3;5;8;11;10;21
294;21.04.2017;2017;04;22;Perjantai;2;5;7;8;1;9
294;21.04.2017;2017;04;23;Perjantai;1;1;2;1;1;2
294;22.04.2017;2017;04;00;Lauantai;0;0;0;0;0;0
294;22.04.2017;2017;04;01;Lauantai;0;0;0;0;0;0
294;22.04.2017;2017;04;02;Lauantai;0;0;0;0;0;0
294;22.04.2017;2017;04;03;Lauantai;0;0;0;0;0;0
294;22.04.2017;2017;04;04;Lauantai;1;0;1;1;0;1
294;22.04.2017;2017;04;05;Lauantai;0;1;1;0;0;0
294;22.04.2017;2017;04;06;Lauantai;1;1;2;1;1;2
294;22.04.2017;2017;04;07;Lauantai;1;4;5;0;1;1
294;22.04.2017;2017;04;08;Lauantai;8;4;12;8;4;12
294;22.04.2017;2017;04;09;Lauantai;5;8;13;5;8;13
294;22.04.2017;2017;04;10;Lauantai;13;9;22;12;9;21
294;22.04.2017;2017;04;11;Lauantai;9;3;12;9;23;32
294;22.04.2017;2017;04;12;Lauantai;16;6;22;16;23;39
294;22.04.2017;2017;04;13;Lauantai;13;7;20;13;24;37
294;22.04.2017;2017;04;14;Lauantai;10;6;16;10;6;16
294;22.04.2017;2017;04;15;Lauantai;4;17;21;24;14;38
294;22.04.2017;2017;04;16;Lauantai;10;10;20;10;7;17
294;22.04.2017;2017;04;17;Lauantai;3;14;17;20;13;33
294;22.04.2017;2017;04;18;Lauantai;4;14;18;24;14;38
294;22.04.2017;2017;04;19;Lauantai;6;9;15;5;6;11
294;22.04.2017;2017;04;20;Lauantai;8;5;13;5;5;10
294;22.04.2017;2017;04;21;Lauantai;4;5;9;4;4;8
294;22.04.2017;2017;04;22;Lauantai;4;1;5;1;0;1
294;22.04.2017;2017;04;23;Lauantai;0;1;1;0;0;0
294;23.04.2017;2017;04;00;Sunnuntai;1;0;1;0;0;0
294;23.04.2017;2017;04;01;Sunnuntai;1;2;3;1;1;2
294;23.04.2017;2017;04;02;Sunnuntai;0;0;0;0;0;0
294;23.04.2017;2017;04;03;Sunnuntai;0;0;0;0;0;0
294;23.04.2017;2017;04;04;Sunnuntai;0;0;0;0;0;0
294;23.04.2017;2017;04;05;Sunnuntai;0;0;0;0;0;0
294;23.04.2017;2017;04;06;Sunnuntai;1;1;2;1;0;1
294;23.04.2017;2017;04;07;Sunnuntai;0;1;1;0;0;0
294;23.04.2017;2017;04;08;Sunnuntai;1;1;2;1;0;1
294;23.04.2017;2017;04;09;Sunnuntai;5;6;11;5;5;10
294;23.04.2017;2017;04;10;Sunnuntai;9;9;18;9;5;14
294;23.04.2017;2017;04;11;Sunnuntai;9;2;11;8;19;27
294;23.04.2017;2017;04;12;Sunnuntai;13;9;22;13;9;22
294;23.04.2017;2017;04;13;Sunnuntai;9;3;12;9;19;28
294;23.04.2017;2017;04;14;Sunnuntai;12;9;21;12;9;21
294;23.04.2017;2017;04;15;Sunnuntai;6;9;15;5;9;14
294;23.04.2017;2017;04;16;Sunnuntai;3;13;16;23;9;32
294;23.04.2017;2017;04;17;Sunnuntai;2;12;14;19;12;31
294;23.04.2017;2017;04;18;Sunnuntai;3;12;15;23;9;32
294;23.04.2017;2017;04;19;Sunnuntai;9;9;18;5;9;14
294;23.04.2017;2017;04;20;Sunnuntai;9;5;14;5;5;10
294;23.04.2017;2017;04;21;Sunnuntai;1;4;5;0;1;1
294;23.04.2017;2017;04;22;Sunnuntai;0;0;0;0;0;0
294;23.04.2017;2017;04;23;Sunnuntai;0;0;0;0;0;0
294;24.04.2017;2017;04;00;Maanantai;0;0;0;0;0;0
294;24.04.2017;2017;04;01;Maanantai;0;0;0;0;0;0
294;24.04.2017;2017;04;02;Maanantai;0;0;0;0;0;0
294;24.04.2017;2017;04;03;Maanantai;0;0;0;0;0;0
294;24.04.2017;2017;04;04;Maanantai;0;0;0;0;0;0
294;24.04.2017;2017;04;05;Maanantai;0;1;1;0;1;1
294;24.04.2017;2017;04;06;Maanantai;4;0;4;1;0;1
294;24.04.2017;2017;04;07;Maanantai;9;10;19;5;8;13
294;24.04.2017;2017;04;08;Maanantai;17;7;24;12;19;31
294;24.04.2017;2017;04;09;Maanantai;12;6;18;8;19;27
294;24.04.2017;2017;04;10;Maanantai;10;9;19;8;5;13
294;24.04.2017;2017;04;11;Maanantai;21;15;36;13;27;40
294;24.04.2017;2017;04;12;Maanantai;12;11;23;26;23;49
294;24.04.2017;2017;04;13;Maanantai;10;13;23;24;25;49
294;24.04.2017;2017;04;14;Maanantai;11;10;21;23;23;46
294;24.04.2017;2017;04;15;Maanantai;19;19;38;27;30;57
294;24.04.2017;2017;04;16;Maanantai;6;13;19;19;9;28
294;24.04.2017;2017;04;17;Maanantai;13;16;29;9;12;21
294;24.04.2017;2017;04;18;Maanantai;7;17;24;23;12;35
294;24.04.2017;2017;04;19;Maanantai;6;13;19;14;9;23
294;24.04.2017;2017;04;20;Maanantai;6;5;11;8;5;13
294;24.04.2017;2017;04;21;Maanantai;5;5;10;1;4;5
294;24.04.2017;2017;04;22;Maanantai;1;1;2;1;1;2
294;24.04.2017;2017;04;23;Maanantai;0;0;0;0;0;0
294;25.04.2017;2017;04;00;Tiistai;1;0;1;0;0;0
294;25.04.2017;2017;04;01;Tiistai;0;0;0;0;0;0
294;25.04.2017;2017;04;02;Tiistai;0;0;0;0;0;0
294;25.04.2017;2017;04;03;Tiistai;0;0;0;0;0;0
294;25.04.2017;2017;04;04;Tiistai;0;0;0;0;0;0
294;25.04.2017;2017;04;05;Tiistai;1;1;2;1;1;2
294;25.04.2017;2017;04;06;Tiistai;5;1;6;1;1;2
294;25.04.2017;2017;04;07;Tiistai;6;9;15;5;5;10
294;25.04.2017;2017;04;08;Tiistai;13;9;22;8;8;16
294;25.04.2017;2017;04;09;Tiistai;12;6;18;8;14;22
294;25.04.2017;2017;04;10;Tiistai;17;4;21;10;19;29
294;25.04.2017;2017;04;11;Tiistai;14;7;21;9;20;29
294;25.04.2017;2017;04;12;Tiistai;9;5;14;21;20;41
294;25.04.2017;2017;04;13;Tiistai;7;7;14;16;23;39
294;25.04.2017;2017;04;14;Tiistai;12;11;23;27;23;50
294;25.04.2017;2017;04;15;Tiistai;11;15;26;23;26;49
294;25.04.2017;2017;04;16;Tiistai;6;16;22;22;8;30
294;25.04.2017;2017;04;17;Tiistai;7;18;25;22;13;35
294;25.04.2017;2017;04;18;Tiistai;15;21;36;26;13;39
294;25.04.2017;2017;04;19;Tiistai;12;16;28;8;9;17
294;25.04.2017;2017;04;20;Tiistai;17;17;34;13;9;22
294;25.04.2017;2017;04;21;Tiistai;1;4;5;1;1;2
294;25.04.2017;2017;04;22;Tiistai;0;0;0;0;0;0
294;25.04.2017;2017;04;23;Tiistai;0;0;0;0;0;0
294;26.04.2017;2017;04;00;Keskiviikko;0;0;0;0;0;0
294;26.04.2017;2017;04;01;Keskiviikko;0;0;0;0;0;0
294;26.04.2017;2017;04;02;Keskiviikko;1;0;1;1;0;1
294;26.04.2017;2017;04;03;Keskiviikko;0;0;0;0;0;0
294;26.04.2017;2017;04;04;Keskiviikko;0;0;0;0;0;0
294;26.04.2017;2017;04;05;Keskiviikko;0;1;1;0;0;0
294;26.04.2017;2017;04;06;Keskiviikko;4;1;5;1;1;2
294;26.04.2017;2017;04;07;Keskiviikko;6;6;12;5;5;10
294;26.04.2017;2017;04;08;Keskiviikko;4;6;10;11;5;16
294;26.04.2017;2017;04;09;Keskiviikko;2;3;5;18;19;37
294;26.04.2017;2017;04;10;Keskiviikko;5;1;6;4;1;5
294;26.04.2017;2017;04;11;Keskiviikko;6;5;11;5;10;15
294;26.04.2017;2017;04;12;Keskiviikko;9;5;14;5;5;10
294;26.04.2017;2017;04;13;Keskiviikko;8;9;17;4;5;9
294;26.04.2017;2017;04;14;Keskiviikko;7;14;21;22;9;31
294;26.04.2017;2017;04;15;Keskiviikko;4;9;13;9;8;17
294;26.04.2017;2017;04;16;Keskiviikko;5;8;13;9;4;13
294;26.04.2017;2017;04;17;Keskiviikko;5;10;15;9;8;17
294;26.04.2017;2017;04;18;Keskiviikko;5;4;9;4;1;5
294;26.04.2017;2017;04;19;Keskiviikko;4;4;8;1;4;5
294;26.04.2017;2017;04;20;Keskiviikko;5;2;7;4;1;5
294;26.04.2017;2017;04;21;Keskiviikko;0;1;1;0;0;0
294;26.04.2017;2017;04;22;Keskiviikko;0;0;0;0;0;0
294;26.04.2017;2017;04;23;Keskiviikko;0;0;0;0;0;0
294;27.04.2017;2017;04;00;Torstai;0;0;0;0;0;0
294;27.04.2017;2017;04;01;Torstai;0;0;0;0;0;0
294;27.04.2017;2017;04;02;Torstai;0;0;0;0;0;0
294;27.04.2017;2017;04;03;Torstai;0;0;0;0;0;0
294;27.04.2017;2017;04;04;Torstai;0;0;0;0;0;0
294;27.04.2017;2017;04;05;Torstai;0;1;1;0;0;0
294;27.04.2017;2017;04;06;Torstai;4;1;5;1;1;2
294;27.04.2017;2017;04;07;Torstai;12;13;25;8;8;16
294;27.04.2017;2017;04;08;Torstai;9;8;17;5;5;10
294;27.04.2017;2017;04;09;Torstai;8;9;17;4;5;9
294;27.04.2017;2017;04;10;Torstai;8;5;13;5;4;9
294;27.04.2017;2017;04;11;Torstai;7;11;18;23;23;46
294;27.04.2017;2017;04;12;Torstai;7;7;14;22;22;44
294;27.04.2017;2017;04;13;Torstai;11;12;23;23;26;49
294;27.04.2017;2017;04;14;Torstai;11;8;19;23;23;46
294;27.04.2017;2017;04;15;Torstai;15;18;33;26;27;53
294;27.04.2017;2017;04;16;Torstai;7;7;14;22;22;44
294;27.04.2017;2017;04;17;Torstai;8;7;15;14;22;36
294;27.04.2017;2017;04;18;Torstai;7;8;15;16;15;31
294;27.04.2017;2017;04;19;Torstai;6;7;13;19;22;41
294;27.04.2017;2017;04;20;Torstai;8;8;16;5;4;9
294;27.04.2017;2017;04;21;Torstai;1;4;5;0;1;1
294;27.04.2017;2017;04;22;Torstai;5;5;10;4;1;5
294;27.04.2017;2017;04;23;Torstai;0;0;0;0;0;0
294;28.04.2017;2017;04;00;Perjantai;0;0;0;0;0;0
294;28.04.2017;2017;04;01;Perjantai;0;0;0;0;0;0
294;28.04.2017;2017;04;02;Perjantai;0;0;0;0;0;0
294;28.04.2017;2017;04;03;Perjantai;0;0;0;0;0;0
294;28.04.2017;2017;04;04;Perjantai;0;0;0;0;0;0
294;28.04.2017;2017;04;05;Perjantai;0;1;1;0;0;0
294;28.04.2017;2017;04;06;Perjantai;2;2;4;1;1;2
294;28.04.2017;2017;04;07;Perjantai;11;9;20;11;11;22
294;28.04.2017;2017;04;08;Perjantai;17;7;24;12;19;31
294;28.04.2017;2017;04;09;Perjantai;14;7;21;9;22;31
294;28.04.2017;2017;04;10;Perjantai;17;13;30;9;9;18
294;28.04.2017;2017;04;11;Perjantai;17;8;25;9;23;32
294;28.04.2017;2017;04;12;Perjantai;12;11;23;26;23;49
294;28.04.2017;2017;04;13;Perjantai;7;7;14;19;22;41
294;28.04.2017;2017;04;14;Perjantai;8;7;15;23;22;45
294;28.04.2017;2017;04;15;Perjantai;5;6;11;16;19;35
294;28.04.2017;2017;04;16;Perjantai;4;13;17;19;9;28
294;28.04.2017;2017;04;17;Perjantai;8;16;24;13;9;22
294;28.04.2017;2017;04;18;Perjantai;5;10;15;17;8;25
294;28.04.2017;2017;04;19;Perjantai;9;13;22;5;8;13
294;28.04.2017;2017;04;20;Perjantai;6;6;12;22;19;41
294;28.04.2017;2017;04;21;Perjantai;10;13;23;6;9;15
294;28.04.2017;2017;04;22;Perjantai;2;2;4;1;1;2
294;28.04.2017;2017;04;23;Perjantai;0;0;0;0;0;0
294;29.04.2017;2017;04;00;Lauantai;0;0;0;0;0;0
294;29.04.2017;2017;04;01;Lauantai;0;0;0;0;0;0
294;29.04.2017;2017;04;02;Lauantai;0;0;0;0;0;0
294;29.04.2017;2017;04;03;Lauantai;0;1;1;0;0;0
294;29.04.2017;2017;04;04;Lauantai;0;0;0;0;0;0
294;29.04.2017;2017;04;05;Lauantai;0;1;1;0;1;1
294;29.04.2017;2017;04;06;Lauantai;1;1;2;1;0;1
294;29.04.2017;2017;04;07;Lauantai;1;1;2;1;1;2
294;29.04.2017;2017;04;08;Lauantai;5;5;10;5;4;9
294;29.04.2017;2017;04;09;Lauantai;5;5;10;5;5;10
294;29.04.2017;2017;04;10;Lauantai;12;9;21;12;9;21
294;29.04.2017;2017;04;11;Lauantai;13;6;19;13;26;39
294;29.04.2017;2017;04;12;Lauantai;7;13;20;23;13;36
294;29.04.2017;2017;04;13;Lauantai;7;7;14;27;27;54
294;29.04.2017;2017;04;14;Lauantai;7;13;20;23;13;36
294;29.04.2017;2017;04;15;Lauantai;9;9;18;9;9;18
294;29.04.2017;2017;04;16;Lauantai;12;12;24;12;9;21
294;29.04.2017;2017;04;17;Lauantai;12;13;25;9;13;22
294;29.04.2017;2017;04;18;Lauantai;17;27;44;17;23;40
294;29.04.2017;2017;04;19;Lauantai;12;2;14;9;22;31
294;29.04.2017;2017;04;20;Lauantai;9;5;14;8;5;13
294;29.04.2017;2017;04;21;Lauantai;5;5;10;5;5;10
294;29.04.2017;2017;04;22;Lauantai;4;0;4;1;0;1
294;29.04.2017;2017;04;23;Lauantai;1;4;5;1;1;2
294;30.04.2017;2017;04;00;Sunnuntai;0;0;0;0;0;0
294;30.04.2017;2017;04;01;Sunnuntai;0;1;1;0;1;1
294;30.04.2017;2017;04;02;Sunnuntai;0;0;0;0;0;0
294;30.04.2017;2017;04;03;Sunnuntai;0;0;0;0;0;0
294;30.04.2017;2017;04;04;Sunnuntai;0;0;0;0;0;0
294;30.04.2017;2017;04;05;Sunnuntai;0;0;0;0;0;0
294;30.04.2017;2017;04;06;Sunnuntai;1;0;1;1;0;1
294;30.04.2017;2017;04;07;Sunnuntai;1;1;2;1;1;2
294;30.04.2017;2017;04;08;Sunnuntai;4;1;5;4;1;5
294;30.04.2017;2017;04;09;Sunnuntai;4;5;9;1;4;5
294;30.04.2017;2017;04;10;Sunnuntai;5;4;9;5;4;9
294;30.04.2017;2017;04;11;Sunnuntai;5;8;13;4;8;12
294;30.04.2017;2017;04;12;Sunnuntai;9;5;14;6;5;11
294;30.04.2017;2017;04;13;Sunnuntai;6;9;15;5;9;14
294;30.04.2017;2017;04;14;Sunnuntai;8;4;12;5;4;9
294;30.04.2017;2017;04;15;Sunnuntai;5;5;10;4;5;9
294;30.04.2017;2017;04;16;Sunnuntai;5;5;10;5;4;9
294;30.04.2017;2017;04;17;Sunnuntai;6;9;15;5;9;14
294;30.04.2017;2017;04;18;Sunnuntai;6;5;11;5;5;10
294;30.04.2017;2017;04;19;Sunnuntai;5;8;13;5;5;10
294;30.04.2017;2017;04;20;Sunnuntai;4;4;8;4;1;5
294;30.04.2017;2017;04;21;Sunnuntai;1;4;5;1;4;5
294;30.04.2017;2017;04;22;Sunnuntai;5;1;6;4;1;5
294;30.04.2017;2017;04;23;Sunnuntai;0;1;1;0;0;0
294;01.05.2017;2017;05;00;Maanantai;1;0;1;0;0;0
294;01.05.2017;2017;05;01;Maanantai;0;1;1;0;0;0
294;01.05.2017;2017;05;02;Maanantai;0;0;0;0;0;0
294;01.05.2017;2017;05;03;Maanantai;0;1;1;0;0;0
294;01.05.2017;2017;05;04;Maanantai;0;0;0;0;0;0
294;01.05.2017;2017;05;05;Maanantai;0;1;1;0;1;1
294;01.05.2017;2017;05;06;Maanantai;0;0;0;0;0;0
294;01.05.2017;2017;05;07;Maanantai;1;4;5;0;1;1
294;01.05.2017;2017;05;08;Maanantai;5;1;6;1;1;2
294;01.05.2017;2017;05;09;Maanantai;4;5;9;1;4;5
294;01.05.2017;2017;05;10;Maanantai;12;8;20;5;4;9
294;01.05.2017;2017;05;11;Maanantai;10;13;23;5;8;13
294;01.05.2017;2017;05;12;Maanantai;20;20;40;12;9;21
294;01.05.2017;2017;05;13;Maanantai;17;20;37;9;12;21
294;01.05.2017;2017;05;14;Maanantai;17;13;30;9;5;14
294;01.05.2017;2017;05;15;Maanantai;9;13;22;4;5;9
294;01.05.2017;2017;05;16;Maanantai;17;13;30;9;5;14
294;01.05.2017;2017;05;17;Maanantai;16;17;33;8;12;20
294;01.05.2017;2017;05;18;Maanantai;17;16;33;9;8;17
294;01.05.2017;2017;05;19;Maanantai;6;9;15;4;5;9
294;01.05.2017;2017;05;20;Maanantai;8;4;12;4;4;8
294;01.05.2017;2017;05;21;Maanantai;1;5;6;0;1;1
294;01.05.2017;2017;05;22;Maanantai;1;0;1;0;0;0
294;01.05.2017;2017;05;23;Maanantai;0;1;1;0;0;0
294;02.05.2017;2017;05;00;Tiistai;0;0;0;0;0;0
294;02.05.2017;2017;05;01;Tiistai;0;0;0;0;0;0
294;02.05.2017;2017;05;02;Tiistai;0;0;0;0;0;0
294;02.05.2017;2017;05;03;Tiistai;0;0;0;0;0;0
294;02.05.2017;2017;05;04;Tiistai;1;0;1;1;0;1
294;02.05.2017;2017;05;05;Tiistai;0;4;4;0;1;1
294;02.05.2017;2017;05;06;Tiistai;2;1;3;1;1;2
294;02.05.2017;2017;05;07;Tiistai;5;9;14;4;5;9
294;02.05.2017;2017;05;08;Tiistai;13;12;25;8;4;12
294;02.05.2017;2017;05;09;Tiistai;14;17;31;5;9;14
294;02.05.2017;2017;05;10;Tiistai;13;10;23;8;5;13
294;02.05.2017;2017;05;11;Tiistai;21;21;42;12;12;24
294;02.05.2017;2017;05;12;Tiistai;16;16;32;12;8;20
294;02.05.2017;2017;05;13;Tiistai;24;28;52;12;16;28
294;02.05.2017;2017;05;14;Tiistai;21;21;42;13;12;25
294;02.05.2017;2017;05;15;Tiistai;29;29;58;13;17;30
294;02.05.2017;2017;05;16;Tiistai;18;14;32;9;9;18
294;02.05.2017;2017;05;17;Tiistai;16;17;33;8;9;17
294;02.05.2017;2017;05;18;Tiistai;24;21;45;12;12;24
294;02.05.2017;2017;05;19;Tiistai;21;22;43;12;13;25
294;02.05.2017;2017;05;20;Tiistai;12;9;21;5;4;9
294;02.05.2017;2017;05;21;Tiistai;1;5;6;1;1;2
294;02.05.2017;2017;05;22;Tiistai;1;0;1;1;0;1
294;02.05.2017;2017;05;23;Tiistai;0;1;1;0;1;1
294;03.05.2017;2017;05;00;Keskiviikko;0;0;0;0;0;0
294;03.05.2017;2017;05;01;Keskiviikko;0;0;0;0;0;0
294;03.05.2017;2017;05;02;Keskiviikko;1;0;1;0;0;0
294;03.05.2017;2017;05;03;Keskiviikko;0;0;0;0;0;0
294;03.05.2017;2017;05;04;Keskiviikko;0;0;0;0;0;0
294;03.05.2017;2017;05;05;Keskiviikko;1;1;2;0;1;1
294;03.05.2017;2017;05;06;Keskiviikko;2;1;3;1;1;2
294;03.05.2017;2017;05;07;Keskiviikko;5;9;14;4;5;9
294;03.05.2017;2017;05;08;Keskiviikko;17;14;31;9;9;18
294;03.05.2017;2017;05;09;Keskiviikko;21;22;43;12;13;25
294;03.05.2017;2017;05;10;Keskiviikko;9;9;18;5;4;9
294;03.05.2017;2017;05;11;Keskiviikko;24;24;48;12;13;25
294;03.05.2017;2017;05;12;Keskiviikko;18;17;35;12;9;21
294;03.05.2017;2017;05;13;Keskiviikko;17;21;38;9;12;21
294;03.05.2017;2017;05;14;Keskiviikko;21;18;39;12;9;21
294;03.05.2017;2017;05;15;Keskiviikko;21;22;43;12;13;25
294;03.05.2017;2017;05;16;Keskiviikko;18;17;35;9;9;18
294;03.05.2017;2017;05;17;Keskiviikko;12;16;28;8;8;16
294;03.05.2017;2017;05;18;Keskiviikko;20;20;40;12;8;20
294;03.05.2017;2017;05;19;Keskiviikko;17;20;37;8;12;20
294;03.05.2017;2017;05;20;Keskiviikko;8;5;13;4;1;5
294;03.05.2017;2017;05;21;Keskiviikko;2;5;7;1;4;5
294;03.05.2017;2017;05;22;Keskiviikko;0;0;0;0;0;0
294;03.05.2017;2017;05;23;Keskiviikko;0;1;1;0;1;1
294;04.05.2017;2017;05;00;Torstai;1;0;1;0;0;0
294;04.05.2017;2017;05;01;Torstai;0;0;0;0;0;0
294;04.05.2017;2017;05;02;Torstai;0;0;0;0;0;0
294;04.05.2017;2017;05;03;Torstai;0;0;0;0;0;0
294;04.05.2017;2017;05;04;Torstai;5;1;6;4;0;4
294;04.05.2017;2017;05;05;Torstai;1;1;2;0;1;1
294;04.05.2017;2017;05;06;Torstai;5;1;6;1;0;1
294;04.05.2017;2017;05;07;Torstai;12;16;28;5;8;13
294;04.05.2017;2017;05;08;Torstai;16;16;32;8;8;16
294;04.05.2017;2017;05;09;Torstai;16;16;32;8;9;17
294;04.05.2017;2017;05;10;Torstai;13;12;25;8;4;12
294;04.05.2017;2017;05;11;Torstai;26;27;53;13;14;27
294;04.05.2017;2017;05;12;Torstai;14;13;27;9;5;14
294;04.05.2017;2017;05;13;Torstai;26;26;52;13;13;26
294;04.05.2017;2017;05;14;Torstai;29;29;58;16;13;29
294;04.05.2017;2017;05;15;Torstai;20;20;40;12;12;24
294;04.05.2017;2017;05;16;Torstai;17;14;31;9;5;14
294;04.05.2017;2017;05;17;Torstai;14;17;31;5;9;14
294;04.05.2017;2017;05;18;Torstai;17;13;30;9;8;17
294;04.05.2017;2017;05;19;Torstai;16;20;36;8;12;20
294;04.05.2017;2017;05;20;Torstai;9;8;17;5;4;9
294;04.05.2017;2017;05;21;Torstai;5;6;11;1;4;5
294;04.05.2017;2017;05;22;Torstai;1;0;1;1;0;1
294;04.05.2017;2017;05;23;Torstai;0;0;0;0;0;0
294;05.05.2017;2017;05;00;Perjantai;0;0;0;0;0;0
294;05.05.2017;2017;05;01;Perjantai;0;0;0;0;0;0
294;05.05.2017;2017;05;02;Perjantai;0;0;0;0;0;0
294;05.05.2017;2017;05;03;Perjantai;0;1;1;0;0;0
294;05.05.2017;2017;05;04;Perjantai;0;0;0;0;0;0
294;05.05.2017;2017;05;05;Perjantai;0;1;1;0;1;1
294;05.05.2017;2017;05;06;Perjantai;5;1;6;1;0;1
294;05.05.2017;2017;05;07;Perjantai;10;13;23;5;9;14
294;05.05.2017;2017;05;08;Perjantai;13;9;22;8;5;13
294;05.05.2017;2017;05;09;Perjantai;17;17;34;8;9;17
294;05.05.2017;2017;05;10;Perjantai;20;20;40;12;9;21
294;05.05.2017;2017;05;11;Perjantai;21;22;43;12;13;25
294;05.05.2017;2017;05;12;Perjantai;26;22;48;13;13;26
294;05.05.2017;2017;05;13;Perjantai;17;21;38;9;12;21
294;05.05.2017;2017;05;14;Perjantai;29;26;55;17;13;30
294;05.05.2017;2017;05;15;Perjantai;23;26;49;13;14;27
294;05.05.2017;2017;05;16;Perjantai;30;29;59;17;16;33
294;05.05.2017;2017;05;17;Perjantai;16;17;33;8;9;17
294;05.05.2017;2017;05;18;Perjantai;17;17;34;12;9;21
294;05.05.2017;2017;05;19;Perjantai;14;17;31;5;9;14
294;05.05.2017;2017;05;20;Perjantai;10;10;20;5;5;10
294;05.05.2017;2017;05;21;Perjantai;1;5;6;0;1;1
294;05.05.2017;2017;05;22;Perjantai;1;0;1;0;0;0
294;05.05.2017;2017;05;23;Perjantai;0;1;1;0;1;1
294;06.05.2017;2017;05;00;Lauantai;1;1;2;1;0;1
294;06.05.2017;2017;05;01;Lauantai;0;4;4;0;1;1
294;06.05.2017;2017;05;02;Lauantai;1;0;1;0;0;0
294;06.05.2017;2017;05;03;Lauantai;0;0;0;0;0;0
294;06.05.2017;2017;05;04;Lauantai;0;0;0;0;0;0
294;06.05.2017;2017;05;05;Lauantai;0;1;1;0;1;1
294;06.05.2017;2017;05;06;Lauantai;1;0;1;1;0;1
294;06.05.2017;2017;05;07;Lauantai;1;5;6;0;1;1
294;06.05.2017;2017;05;08;Lauantai;6;2;8;1;1;2
294;06.05.2017;2017;05;09;Lauantai;9;12;21;4;5;9
294;06.05.2017;2017;05;10;Lauantai;13;9;22;5;4;9
294;06.05.2017;2017;05;11;Lauantai;13;17;30;8;9;17
294;06.05.2017;2017;05;12;Lauantai;16;12;28;8;5;13
294;06.05.2017;2017;05;13;Lauantai;13;16;29;5;8;13
294;06.05.2017;2017;05;14;Lauantai;14;13;27;9;5;14
294;06.05.2017;2017;05;15;Lauantai;14;18;32;9;9;18
294;06.05.2017;2017;05;16;Lauantai;17;13;30;9;5;14
294;06.05.2017;2017;05;17;Lauantai;13;13;26;5;9;14
294;06.05.2017;2017;05;18;Lauantai;21;17;38;12;9;21
294;06.05.2017;2017;05;19;Lauantai;10;13;23;5;5;10
294;06.05.2017;2017;05;20;Lauantai;9;8;17;4;4;8
294;06.05.2017;2017;05;21;Lauantai;4;5;9;1;4;5
294;06.05.2017;2017;05;22;Lauantai;5;1;6;4;1;5
294;06.05.2017;2017;05;23;Lauantai;0;1;1;0;0;0
294;07.05.2017;2017;05;00;Sunnuntai;1;1;2;1;0;1
294;07.05.2017;2017;05;01;Sunnuntai;0;1;1;0;1;1
294;07.05.2017;2017;05;02;Sunnuntai;1;0;1;1;0;1
294;07.05.2017;2017;05;03;Sunnuntai;0;1;1;0;0;0
294;07.05.2017;2017;05;04;Sunnuntai;1;0;1;0;0;0
294;07.05.2017;2017;05;05;Sunnuntai;1;1;2;0;1;1
294;07.05.2017;2017;05;06;Sunnuntai;1;0;1;1;0;1
294;07.05.2017;2017;05;07;Sunnuntai;1;1;2;0;1;1
294;07.05.2017;2017;05;08;Sunnuntai;5;1;6;4;0;4
294;07.05.2017;2017;05;09;Sunnuntai;5;6;11;1;4;5
294;07.05.2017;2017;05;10;Sunnuntai;9;5;14;4;4;8
294;07.05.2017;2017;05;11;Sunnuntai;9;12;21;4;5;9
294;07.05.2017;2017;05;12;Sunnuntai;17;16;33;9;8;17
294;07.05.2017;2017;05;13;Sunnuntai;14;17;31;9;9;18
294;07.05.2017;2017;05;14;Sunnuntai;13;9;22;8;5;13
294;07.05.2017;2017;05;15;Sunnuntai;14;17;31;5;9;14
294;07.05.2017;2017;05;16;Sunnuntai;13;13;26;8;5;13
294;07.05.2017;2017;05;17;Sunnuntai;8;8;16;4;4;8
294;07.05.2017;2017;05;18;Sunnuntai;9;8;17;5;4;9
294;07.05.2017;2017;05;19;Sunnuntai;10;13;23;5;9;14
294;07.05.2017;2017;05;20;Sunnuntai;8;5;13;4;1;5
294;07.05.2017;2017;05;21;Sunnuntai;1;2;3;0;1;1
294;07.05.2017;2017;05;22;Sunnuntai;1;0;1;0;0;0
294;07.05.2017;2017;05;23;Sunnuntai;1;1;2;0;1;1
294;08.05.2017;2017;05;00;Maanantai;0;0;0;0;0;0
294;08.05.2017;2017;05;01;Maanantai;0;0;0;0;0;0
294;08.05.2017;2017;05;02;Maanantai;0;0;0;0;0;0
294;08.05.2017;2017;05;03;Maanantai;0;0;0;0;0;0
294;08.05.2017;2017;05;04;Maanantai;1;0;1;0;0;0
294;08.05.2017;2017;05;05;Maanantai;0;1;1;0;0;0
294;08.05.2017;2017;05;06;Maanantai;5;2;7;1;1;2
294;08.05.2017;2017;05;07;Maanantai;9;13;22;5;8;13
294;08.05.2017;2017;05;08;Maanantai;17;14;31;9;5;14
294;08.05.2017;2017;05;09;Maanantai;21;22;43;12;13;25
294;08.05.2017;2017;05;10;Maanantai;9;9;18;5;4;9
294;08.05.2017;2017;05;11;Maanantai;12;12;24;4;8;12
294;08.05.2017;2017;05;12;Maanantai;13;13;26;9;5;14
294;08.05.2017;2017;05;13;Maanantai;18;18;36;9;12;21
294;08.05.2017;2017;05;14;Maanantai;20;17;37;12;9;21
294;08.05.2017;2017;05;15;Maanantai;21;21;42;12;13;25
294;08.05.2017;2017;05;16;Maanantai;17;17;34;12;9;21
294;08.05.2017;2017;05;17;Maanantai;14;17;31;9;9;18
294;08.05.2017;2017;05;18;Maanantai;16;13;29;9;8;17
294;08.05.2017;2017;05;19;Maanantai;13;13;26;5;9;14
294;08.05.2017;2017;05;20;Maanantai;4;1;5;1;0;1
294;08.05.2017;2017;05;21;Maanantai;2;5;7;1;1;2
294;08.05.2017;2017;05;22;Maanantai;1;0;1;0;0;0
294;08.05.2017;2017;05;23;Maanantai;0;0;0;0;0;0
294;09.05.2017;2017;05;00;Tiistai;0;0;0;0;0;0
294;09.05.2017;2017;05;01;Tiistai;0;0;0;0;0;0
294;09.05.2017;2017;05;02;Tiistai;0;0;0;0;0;0
294;09.05.2017;2017;05;03;Tiistai;0;0;0;0;0;0
294;09.05.2017;2017;05;04;Tiistai;1;0;1;0;0;0
294;09.05.2017;2017;05;05;Tiistai;1;1;2;0;1;1
294;09.05.2017;2017;05;06;Tiistai;5;1;6;1;0;1
294;09.05.2017;2017;05;07;Tiistai;12;13;25;5;8;13
294;09.05.2017;2017;05;08;Tiistai;12;9;21;5;4;9
294;09.05.2017;2017;05;09;Tiistai;13;17;30;5;9;14
294;09.05.2017;2017;05;10;Tiistai;12;9;21;5;4;9
294;09.05.2017;2017;05;11;Tiistai;10;14;24;5;9;14
294;09.05.2017;2017;05;12;Tiistai;17;14;31;9;8;17
294;09.05.2017;2017;05;13;Tiistai;17;21;38;9;12;21
294;09.05.2017;2017;05;14;Tiistai;17;13;30;9;5;14
294;09.05.2017;2017;05;15;Tiistai;28;29;57;13;16;29
294;09.05.2017;2017;05;16;Tiistai;21;20;41;12;9;21
294;09.05.2017;2017;05;17;Tiistai;8;9;17;4;5;9
294;09.05.2017;2017;05;18;Tiistai;22;22;44;13;13;26
294;09.05.2017;2017;05;19;Tiistai;13;17;30;8;9;17
294;09.05.2017;2017;05;20;Tiistai;9;5;14;5;4;9
294;09.05.2017;2017;05;21;Tiistai;1;5;6;1;1;2
294;09.05.2017;2017;05;22;Tiistai;0;0;0;0;0;0
294;09.05.2017;2017;05;23;Tiistai;0;0;0;0;0;0
294;10.05.2017;2017;05;00;Keskiviikko;0;0;0;0;0;0
294;10.05.2017;2017;05;01;Keskiviikko;0;0;0;0;0;0
294;10.05.2017;2017;05;02;Keskiviikko;0;0;0;0;0;0
294;10.05.2017;2017;05;03;Keskiviikko;0;0;0;0;0;0
294;10.05.2017;2017;05;04;Keskiviikko;0;0;0;0;0;0
294;10.05.2017;2017;05;05;Keskiviikko;1;1;2;0;1;1
294;10.05.2017;2017;05;06;Keskiviikko;6;2;8;1;1;2
294;10.05.2017;2017;05;07;Keskiviikko;8;9;17;4;5;9
294;10.05.2017;2017;05;08;Keskiviikko;16;13;29;9;5;14
294;10.05.2017;2017;05;09;Keskiviikko;18;18;36;9;12;21
294;10.05.2017;2017;05;10;Keskiviikko;9;5;14;5;4;9
294;10.05.2017;2017;05;11;Keskiviikko;25;25;50;13;16;29
294;10.05.2017;2017;05;12;Keskiviikko;13;12;25;8;5;13
294;10.05.2017;2017;05;13;Keskiviikko;13;13;26;5;8;13
294;10.05.2017;2017;05;14;Keskiviikko;25;22;47;13;12;25
294;10.05.2017;2017;05;15;Keskiviikko;16;16;32;8;9;17
294;10.05.2017;2017;05;16;Keskiviikko;18;17;35;12;9;21
294;10.05.2017;2017;05;17;Keskiviikko;8;12;20;4;8;12
294;10.05.2017;2017;05;18;Keskiviikko;17;14;31;9;9;18
294;10.05.2017;2017;05;19;Keskiviikko;14;17;31;5;9;14
294;10.05.2017;2017;05;20;Keskiviikko;9;5;14;4;4;8
294;10.05.2017;2017;05;21;Keskiviikko;1;4;5;0;4;4
294;10.05.2017;2017;05;22;Keskiviikko;0;0;0;0;0;0
294;10.05.2017;2017;05;23;Keskiviikko;0;0;0;0;0;0
294;11.05.2017;2017;05;00;Torstai;1;0;1;0;0;0
294;11.05.2017;2017;05;01;Torstai;0;0;0;0;0;0
294;11.05.2017;2017;05;02;Torstai;0;0;0;0;0;0
294;11.05.2017;2017;05;03;Torstai;0;0;0;0;0;0
294;11.05.2017;2017;05;04;Torstai;0;0;0;0;0;0
294;11.05.2017;2017;05;05;Torstai;0;1;1;0;0;0
294;11.05.2017;2017;05;06;Torstai;4;1;5;4;0;4
294;11.05.2017;2017;05;07;Torstai;12;16;28;5;8;13
294;11.05.2017;2017;05;08;Torstai;13;12;25;8;5;13
294;11.05.2017;2017;05;09;Torstai;18;18;36;9;9;18
294;11.05.2017;2017;05;10;Torstai;9;8;17;4;4;8
294;11.05.2017;2017;05;11;Torstai;17;17;34;9;12;21
294;11.05.2017;2017;05;12;Torstai;16;13;29;9;8;17
294;11.05.2017;2017;05;13;Torstai;16;17;33;8;9;17
294;11.05.2017;2017;05;14;Torstai;29;26;55;16;13;29
294;11.05.2017;2017;05;15;Torstai;18;18;36;9;12;21
294;11.05.2017;2017;05;16;Torstai;17;17;34;9;9;18
294;11.05.2017;2017;05;17;Torstai;25;25;50;12;13;25
294;11.05.2017;2017;05;18;Torstai;25;25;50;16;13;29
294;11.05.2017;2017;05;19;Torstai;10;13;23;5;8;13
294;11.05.2017;2017;05;20;Torstai;9;5;14;4;1;5
294;11.05.2017;2017;05;21;Torstai;5;6;11;1;4;5
294;11.05.2017;2017;05;22;Torstai;4;1;5;1;0;1
294;11.05.2017;2017;05;23;Torstai;0;0;0;0;0;0
294;12.05.2017;2017;05;00;Perjantai;0;0;0;0;0;0
294;12.05.2017;2017;05;01;Perjantai;0;1;1;0;0;0
294;12.05.2017;2017;05;02;Perjantai;1;0;1;0;0;0
294;12.05.2017;2017;05;03;Perjantai;0;0;0;0;0;0
294;12.05.2017;2017;05;04;Perjantai;0;0;0;0;0;0
294;12.05.2017;2017;05;05;Perjantai;0;1;1;0;0;0
294;12.05.2017;2017;05;06;Perjantai;5;1;6;1;1;2
294;12.05.2017;2017;05;07;Perjantai;13;13;26;5;9;14
294;12.05.2017;2017;05;08;Perjantai;13;13;26;9;5;14
294;12.05.2017;2017;05;09;Perjantai;26;26;52;13;16;29
294;12.05.2017;2017;05;10;Perjantai;18;17;35;9;9;18
294;12.05.2017;2017;05;11;Perjantai;14;17;31;9;9;18
294;12.05.2017;2017;05;12;Perjantai;21;21;42;13;9;22
294;12.05.2017;2017;05;13;Perjantai;21;22;43;9;13;22
294;12.05.2017;2017;05;14;Perjantai;29;28;57;16;13;29
294;12.05.2017;2017;05;15;Perjantai;14;17;31;9;9;18
294;12.05.2017;2017;05;16;Perjantai;13;9;22;8;5;13
294;12.05.2017;2017;05;17;Perjantai;14;17;31;6;9;15
294;12.05.2017;2017;05;18;Perjantai;25;21;46;13;12;25
294;12.05.2017;2017;05;19;Perjantai;13;16;29;5;8;13
294;12.05.2017;2017;05;20;Perjantai;9;9;18;5;4;9
294;12.05.2017;2017;05;21;Perjantai;1;5;6;1;4;5
294;12.05.2017;2017;05;22;Perjantai;5;5;10;4;1;5
294;12.05.2017;2017;05;23;Perjantai;0;0;0;0;0;0
294;13.05.2017;2017;05;00;Lauantai;0;0;0;0;0;0
294;13.05.2017;2017;05;01;Lauantai;0;0;0;0;0;0
294;13.05.2017;2017;05;02;Lauantai;0;0;0;0;0;0
294;13.05.2017;2017;05;03;Lauantai;0;0;0;0;0;0
294;13.05.2017;2017;05;04;Lauantai;1;0;1;1;0;1
294;13.05.2017;2017;05;05;Lauantai;0;1;1;0;0;0
294;13.05.2017;2017;05;06;Lauantai;1;0;1;0;0;0
294;13.05.2017;2017;05;07;Lauantai;1;2;3;1;1;2
294;13.05.2017;2017;05;08;Lauantai;6;2;8;1;1;2
294;13.05.2017;2017;05;09;Lauantai;4;8;12;4;4;8
294;13.05.2017;2017;05;10;Lauantai;14;10;24;9;5;14
294;13.05.2017;2017;05;11;Lauantai;14;14;28;5;9;14
294;13.05.2017;2017;05;12;Lauantai;21;20;41;12;9;21
294;13.05.2017;2017;05;13;Lauantai;10;13;23;5;8;13
294;13.05.2017;2017;05;14;Lauantai;11;10;21;6;5;11
294;13.05.2017;2017;05;15;Lauantai;7;11;18;5;6;11
294;13.05.2017;2017;05;16;Lauantai;16;13;29;8;5;13
294;13.05.2017;2017;05;17;Lauantai;21;25;46;12;13;25
294;13.05.2017;2017;05;18;Lauantai;13;13;26;9;5;14
294;13.05.2017;2017;05;19;Lauantai;13;16;29;5;9;14
294;13.05.2017;2017;05;20;Lauantai;9;5;14;4;1;5
294;13.05.2017;2017;05;21;Lauantai;4;5;9;0;4;4
294;13.05.2017;2017;05;22;Lauantai;1;0;1;0;0;0
294;13.05.2017;2017;05;23;Lauantai;0;1;1;0;0;0
294;14.05.2017;2017;05;00;Sunnuntai;0;0;0;0;0;0
294;14.05.2017;2017;05;01;Sunnuntai;0;0;0;0;0;0
294;14.05.2017;2017;05;02;Sunnuntai;0;0;0;0;0;0
294;14.05.2017;2017;05;03;Sunnuntai;0;1;1;0;0;0
294;14.05.2017;2017;05;04;Sunnuntai;0;0;0;0;0;0
294;14.05.2017;2017;05;05;Sunnuntai;0;0;0;0;0;0
294;14.05.2017;2017;05;06;Sunnuntai;0;0;0;0;0;0
294;14.05.2017;2017;05;07;Sunnuntai;1;1;2;0;1;1
294;14.05.2017;2017;05;08;Sunnuntai;2;2;4;1;1;2
294;14.05.2017;2017;05;09;Sunnuntai;2;6;8;1;1;2
294;14.05.2017;2017;05;10;Sunnuntai;5;4;9;4;1;5
294;14.05.2017;2017;05;11;Sunnuntai;4;5;9;0;4;4
294;14.05.2017;2017;05;12;Sunnuntai;5;1;6;4;0;4
294;14.05.2017;2017;05;13;Sunnuntai;1;5;6;0;1;1
294;14.05.2017;2017;05;14;Sunnuntai;4;1;5;1;0;1
294;14.05.2017;2017;05;15;Sunnuntai;1;2;3;0;1;1
294;14.05.2017;2017;05;16;Sunnuntai;5;1;6;1;1;2
294;14.05.2017;2017;05;17;Sunnuntai;5;5;10;1;4;5
294;14.05.2017;2017;05;18;Sunnuntai;5;1;6;4;0;4
294;14.05.2017;2017;05;19;Sunnuntai;1;5;6;1;1;2
294;14.05.2017;2017;05;20;Sunnuntai;5;1;6;1;1;2
294;14.05.2017;2017;05;21;Sunnuntai;1;2;3;1;1;2
294;14.05.2017;2017;05;22;Sunnuntai;0;0;0;0;0;0
294;14.05.2017;2017;05;23;Sunnuntai;0;0;0;0;0;0
294;15.05.2017;2017;05;00;Maanantai;0;0;0;0;0;0
294;15.05.2017;2017;05;01;Maanantai;0;0;0;0;0;0
294;15.05.2017;2017;05;02;Maanantai;0;0;0;0;0;0
294;15.05.2017;2017;05;03;Maanantai;0;0;0;0;0;0
294;15.05.2017;2017;05;04;Maanantai;0;0;0;0;0;0
294;15.05.2017;2017;05;05;Maanantai;0;0;0;0;0;0
294;15.05.2017;2017;05;06;Maanantai;2;4;6;1;1;2
294;15.05.2017;2017;05;07;Maanantai;19;7;26;2;2;4
294;15.05.2017;2017;05;08;Maanantai;30;10;40;9;3;12
294;15.05.2017;2017;05;09;Maanantai;30;15;45;4;7;11
294;15.05.2017;2017;05;10;Maanantai;40;18;58;11;10;21
294;15.05.2017;2017;05;11;Maanantai;13;11;24;19;15;34
294;15.05.2017;2017;05;12;Maanantai;11;18;29;16;8;24
294;15.05.2017;2017;05;13;Maanantai;16;27;43;17;8;25
294;15.05.2017;2017;05;14;Maanantai;13;19;32;12;17;29
294;15.05.2017;2017;05;15;Maanantai;12;33;45;11;17;28
294;15.05.2017;2017;05;16;Maanantai;20;15;35;16;10;26
294;15.05.2017;2017;05;17;Maanantai;7;17;24;18;18;36
294;15.05.2017;2017;05;18;Maanantai;28;27;55;10;17;27
294;15.05.2017;2017;05;19;Maanantai;19;16;35;9;11;20
294;15.05.2017;2017;05;20;Maanantai;6;8;14;4;3;7
294;15.05.2017;2017;05;21;Maanantai;1;1;2;4;3;7
294;15.05.2017;2017;05;22;Maanantai;0;1;1;1;1;2
294;15.05.2017;2017;05;23;Maanantai;0;0;0;0;0;0
294;16.05.2017;2017;05;00;Tiistai;0;0;0;0;0;0
294;16.05.2017;2017;05;01;Tiistai;0;0;0;1;0;1
294;16.05.2017;2017;05;02;Tiistai;0;0;0;0;0;0
294;16.05.2017;2017;05;03;Tiistai;0;0;0;0;0;0
294;16.05.2017;2017;05;04;Tiistai;0;0;0;0;0;0
294;16.05.2017;2017;05;05;Tiistai;1;0;1;0;0;0
294;16.05.2017;2017;05;06;Tiistai;2;3;5;3;2;5
294;16.05.2017;2017;05;07;Tiistai;15;12;27;6;6;12
294;16.05.2017;2017;05;08;Tiistai;13;4;17;8;7;15
294;16.05.2017;2017;05;09;Tiistai;15;13;28;15;8;23
294;16.05.2017;2017;05;10;Tiistai;8;4;12;12;2;14
294;16.05.2017;2017;05;11;Tiistai;10;12;22;16;12;28
294;16.05.2017;2017;05;12;Tiistai;11;3;14;12;15;27
294;16.05.2017;2017;05;13;Tiistai;18;15;33;10;11;21
294;16.05.2017;2017;05;14;Tiistai;25;26;51;15;16;31
294;16.05.2017;2017;05;15;Tiistai;29;40;69;14;20;34
294;16.05.2017;2017;05;16;Tiistai;11;25;36;17;15;32
294;16.05.2017;2017;05;17;Tiistai;26;15;41;12;12;24
294;16.05.2017;2017;05;18;Tiistai;28;9;37;15;17;32
294;16.05.2017;2017;05;19;Tiistai;17;22;39;12;15;27
294;16.05.2017;2017;05;20;Tiistai;9;10;19;6;8;14
294;16.05.2017;2017;05;21;Tiistai;0;4;4;3;2;5
294;16.05.2017;2017;05;22;Tiistai;3;5;8;2;0;2
294;16.05.2017;2017;05;23;Tiistai;1;0;1;0;0;0
294;17.05.2017;2017;05;00;Keskiviikko;0;0;0;0;0;0
294;17.05.2017;2017;05;01;Keskiviikko;0;0;0;0;0;0
294;17.05.2017;2017;05;02;Keskiviikko;0;0;0;0;0;0
294;17.05.2017;2017;05;03;Keskiviikko;0;0;0;0;0;0
294;17.05.2017;2017;05;04;Keskiviikko;0;0;0;0;0;0
294;17.05.2017;2017;05;05;Keskiviikko;0;0;0;0;0;0
294;17.05.2017;2017;05;06;Keskiviikko;3;2;5;2;3;5
294;17.05.2017;2017;05;07;Keskiviikko;15;7;22;5;1;6
294;17.05.2017;2017;05;08;Keskiviikko;19;7;26;6;5;11
294;17.05.2017;2017;05;09;Keskiviikko;19;10;29;6;6;12
294;17.05.2017;2017;05;10;Keskiviikko;5;4;9;6;5;11
294;17.05.2017;2017;05;11;Keskiviikko;5;7;12;6;8;14
294;17.05.2017;2017;05;12;Keskiviikko;6;15;21;1;2;3
294;17.05.2017;2017;05;13;Keskiviikko;8;17;25;9;4;13
294;17.05.2017;2017;05;14;Keskiviikko;10;13;23;4;9;13
294;17.05.2017;2017;05;15;Keskiviikko;19;17;36;9;0;9
294;17.05.2017;2017;05;16;Keskiviikko;8;6;14;6;5;11
294;17.05.2017;2017;05;17;Keskiviikko;3;2;5;5;1;6
294;17.05.2017;2017;05;18;Keskiviikko;3;3;6;8;6;14
294;17.05.2017;2017;05;19;Keskiviikko;7;4;11;5;2;7
294;17.05.2017;2017;05;20;Keskiviikko;3;3;6;4;3;7
294;17.05.2017;2017;05;21;Keskiviikko;0;3;3;0;2;2
294;17.05.2017;2017;05;22;Keskiviikko;0;0;0;0;0;0
294;17.05.2017;2017;05;23;Keskiviikko;2;0;2;0;0;0
294;18.05.2017;2017;05;00;Torstai;0;0;0;0;0;0
294;18.05.2017;2017;05;01;Torstai;0;0;0;0;0;0
294;18.05.2017;2017;05;02;Torstai;0;0;0;0;0;0
294;18.05.2017;2017;05;03;Torstai;0;0;0;0;0;0
294;18.05.2017;2017;05;04;Torstai;0;0;0;0;0;0
294;18.05.2017;2017;05;05;Torstai;0;0;0;0;0;0
294;18.05.2017;2017;05;06;Torstai;4;1;5;3;1;4
294;18.05.2017;2017;05;07;Torstai;24;4;28;5;4;9
294;18.05.2017;2017;05;08;Torstai;19;2;21;7;6;13
294;18.05.2017;2017;05;09;Torstai;15;5;20;7;6;13
294;18.05.2017;2017;05;10;Torstai;7;10;17;6;7;13
294;18.05.2017;2017;05;11;Torstai;16;12;28;12;10;22
294;18.05.2017;2017;05;12;Torstai;5;16;21;8;9;17
294;18.05.2017;2017;05;13;Torstai;19;22;41;10;10;20
294;18.05.2017;2017;05;14;Torstai;25;19;44;11;7;18
294;18.05.2017;2017;05;15;Torstai;11;25;36;6;11;17
294;18.05.2017;2017;05;16;Torstai;19;17;36;12;12;24
294;18.05.2017;2017;05;17;Torstai;17;21;38;11;12;23
294;18.05.2017;2017;05;18;Torstai;14;21;35;10;5;15
294;18.05.2017;2017;05;19;Torstai;12;12;24;16;10;26
294;18.05.2017;2017;05;20;Torstai;13;9;22;8;12;20
294;18.05.2017;2017;05;21;Torstai;3;3;6;2;1;3
294;18.05.2017;2017;05;22;Torstai;0;1;1;1;1;2
294;18.05.2017;2017;05;23;Torstai;1;0;1;0;2;2
294;19.05.2017;2017;05;00;Perjantai;0;0;0;0;0;0
294;19.05.2017;2017;05;01;Perjantai;0;0;0;0;0;0
294;19.05.2017;2017;05;02;Perjantai;0;0;0;1;0;1
294;19.05.2017;2017;05;03;Perjantai;0;0;0;0;0;0
294;19.05.2017;2017;05;04;Perjantai;0;0;0;0;0;0
294;19.05.2017;2017;05;05;Perjantai;0;0;0;0;0;0
294;19.05.2017;2017;05;06;Perjantai;2;0;2;0;0;0
294;19.05.2017;2017;05;07;Perjantai;10;6;16;3;2;5
294;19.05.2017;2017;05;08;Perjantai;10;1;11;5;0;5
294;19.05.2017;2017;05;09;Perjantai;10;4;14;10;2;12
294;19.05.2017;2017;05;10;Perjantai;2;4;6;2;4;6
294;19.05.2017;2017;05;11;Perjantai;8;7;15;6;7;13
294;19.05.2017;2017;05;12;Perjantai;5;7;12;9;11;20
294;19.05.2017;2017;05;13;Perjantai;17;22;39;16;15;31
294;19.05.2017;2017;05;14;Perjantai;7;18;25;16;17;33
294;19.05.2017;2017;05;15;Perjantai;11;10;21;11;11;22
294;19.05.2017;2017;05;16;Perjantai;8;18;26;7;12;19
294;19.05.2017;2017;05;17;Perjantai;10;11;21;8;13;21
294;19.05.2017;2017;05;18;Perjantai;14;18;32;14;10;24
294;19.05.2017;2017;05;19;Perjantai;10;8;18;7;10;17
294;19.05.2017;2017;05;20;Perjantai;6;3;9;12;12;24
294;19.05.2017;2017;05;21;Perjantai;9;4;13;3;4;7
294;19.05.2017;2017;05;22;Perjantai;9;2;11;1;0;1
294;19.05.2017;2017;05;23;Perjantai;2;0;2;0;0;0
294;20.05.2017;2017;05;00;Lauantai;0;0;0;0;0;0
294;20.05.2017;2017;05;01;Lauantai;1;2;3;0;0;0
294;20.05.2017;2017;05;02;Lauantai;0;0;0;0;0;0
294;20.05.2017;2017;05;03;Lauantai;0;0;0;0;0;0
294;20.05.2017;2017;05;04;Lauantai;0;0;0;0;1;1
294;20.05.2017;2017;05;05;Lauantai;1;0;1;0;0;0
294;20.05.2017;2017;05;06;Lauantai;0;0;0;0;0;0
294;20.05.2017;2017;05;07;Lauantai;1;0;1;2;1;3
294;20.05.2017;2017;05;08;Lauantai;4;8;12;5;3;8
294;20.05.2017;2017;05;09;Lauantai;9;5;14;6;6;12
294;20.05.2017;2017;05;10;Lauantai;16;5;21;9;7;16
294;20.05.2017;2017;05;11;Lauantai;25;21;46;12;14;26
294;20.05.2017;2017;05;12;Lauantai;28;16;44;16;10;26
294;20.05.2017;2017;05;13;Lauantai;34;36;70;11;11;22
294;20.05.2017;2017;05;14;Lauantai;27;25;52;18;11;29
294;20.05.2017;2017;05;15;Lauantai;12;26;38;8;8;16
294;20.05.2017;2017;05;16;Lauantai;11;21;32;1;8;9
294;20.05.2017;2017;05;17;Lauantai;14;30;44;17;8;25
294;20.05.2017;2017;05;18;Lauantai;8;11;19;13;14;27
294;20.05.2017;2017;05;19;Lauantai;12;11;23;8;8;16
294;20.05.2017;2017;05;20;Lauantai;23;11;34;6;6;12
294;20.05.2017;2017;05;21;Lauantai;4;3;7;3;5;8
294;20.05.2017;2017;05;22;Lauantai;0;1;1;0;0;0
294;20.05.2017;2017;05;23;Lauantai;3;4;7;1;0;1
294;21.05.2017;2017;05;00;Sunnuntai;1;1;2;2;0;2
294;21.05.2017;2017;05;01;Sunnuntai;0;0;0;0;0;0
294;21.05.2017;2017;05;02;Sunnuntai;0;0;0;0;0;0
294;21.05.2017;2017;05;03;Sunnuntai;0;0;0;0;0;0
294;21.05.2017;2017;05;04;Sunnuntai;1;0;1;0;0;0
294;21.05.2017;2017;05;05;Sunnuntai;0;0;0;0;0;0
294;21.05.2017;2017;05;06;Sunnuntai;0;0;0;2;2;4
294;21.05.2017;2017;05;07;Sunnuntai;0;1;1;1;0;1
294;21.05.2017;2017;05;08;Sunnuntai;3;1;4;3;2;5
294;21.05.2017;2017;05;09;Sunnuntai;6;3;9;5;2;7
294;21.05.2017;2017;05;10;Sunnuntai;12;2;14;17;3;20
294;21.05.2017;2017;05;11;Sunnuntai;15;13;28;11;7;18
294;21.05.2017;2017;05;12;Sunnuntai;16;16;32;10;4;14
294;21.05.2017;2017;05;13;Sunnuntai;17;10;27;8;3;11
294;21.05.2017;2017;05;14;Sunnuntai;20;22;42;7;8;15
294;21.05.2017;2017;05;15;Sunnuntai;22;14;36;10;10;20
294;21.05.2017;2017;05;16;Sunnuntai;24;16;40;13;8;21
294;21.05.2017;2017;05;17;Sunnuntai;21;23;44;8;7;15
294;21.05.2017;2017;05;18;Sunnuntai;17;15;32;10;3;13
294;21.05.2017;2017;05;19;Sunnuntai;10;18;28;10;7;17
294;21.05.2017;2017;05;20;Sunnuntai;9;15;24;8;11;19
294;21.05.2017;2017;05;21;Sunnuntai;3;8;11;5;1;6
294;21.05.2017;2017;05;22;Sunnuntai;1;0;1;0;0;0
294;21.05.2017;2017;05;23;Sunnuntai;0;1;1;0;0;0
294;22.05.2017;2017;05;00;Maanantai;0;0;0;0;0;0
294;22.05.2017;2017;05;01;Maanantai;0;0;0;0;0;0
294;22.05.2017;2017;05;02;Maanantai;1;0;1;0;0;0
294;22.05.2017;2017;05;03;Maanantai;0;0;0;0;0;0
294;22.05.2017;2017;05;04;Maanantai;1;0;1;0;0;0
294;22.05.2017;2017;05;05;Maanantai;0;0;0;0;0;0
294;22.05.2017;2017;05;06;Maanantai;3;3;6;1;1;2
294;22.05.2017;2017;05;07;Maanantai;18;17;35;7;4;11
294;22.05.2017;2017;05;08;Maanantai;22;11;33;10;13;23
294;22.05.2017;2017;05;09;Maanantai;26;14;40;17;9;26
294;22.05.2017;2017;05;10;Maanantai;13;12;25;6;8;14
294;22.05.2017;2017;05;11;Maanantai;10;10;20;23;13;36
294;22.05.2017;2017;05;12;Maanantai;16;19;35;13;11;24
294;22.05.2017;2017;05;13;Maanantai;25;18;43;26;20;46
294;22.05.2017;2017;05;14;Maanantai;21;46;67;21;15;36
294;22.05.2017;2017;05;15;Maanantai;24;22;46;8;15;23
294;22.05.2017;2017;05;16;Maanantai;36;19;55;15;13;28
294;22.05.2017;2017;05;17;Maanantai;11;19;30;15;15;30
294;22.05.2017;2017;05;18;Maanantai;24;30;54;11;16;27
294;22.05.2017;2017;05;19;Maanantai;25;21;46;14;9;23
294;22.05.2017;2017;05;20;Maanantai;9;5;14;10;9;19
294;22.05.2017;2017;05;21;Maanantai;7;6;13;2;3;5
294;22.05.2017;2017;05;22;Maanantai;0;3;3;1;0;1
294;22.05.2017;2017;05;23;Maanantai;0;0;0;0;0;0
294;23.05.2017;2017;05;00;Tiistai;0;0;0;0;0;0
294;23.05.2017;2017;05;01;Tiistai;0;0;0;1;0;1
294;23.05.2017;2017;05;02;Tiistai;0;0;0;0;0;0
294;23.05.2017;2017;05;03;Tiistai;0;0;0;0;0;0
294;23.05.2017;2017;05;04;Tiistai;0;0;0;0;0;0
294;23.05.2017;2017;05;05;Tiistai;1;1;2;0;0;0
294;23.05.2017;2017;05;06;Tiistai;3;2;5;2;0;2
294;23.05.2017;2017;05;07;Tiistai;27;6;33;10;3;13
294;23.05.2017;2017;05;08;Tiistai;10;8;18;10;10;20
294;23.05.2017;2017;05;09;Tiistai;18;9;27;18;7;25
294;23.05.2017;2017;05;10;Tiistai;11;3;14;11;7;18
294;23.05.2017;2017;05;11;Tiistai;9;7;16;12;16;28
294;23.05.2017;2017;05;12;Tiistai;11;18;29;21;17;38
294;23.05.2017;2017;05;13;Tiistai;26;14;40;16;13;29
294;23.05.2017;2017;05;14;Tiistai;32;31;63;6;15;21
294;23.05.2017;2017;05;15;Tiistai;28;44;72;12;16;28
294;23.05.2017;2017;05;16;Tiistai;36;26;62;7;6;13
294;23.05.2017;2017;05;17;Tiistai;28;29;57;5;19;24
294;23.05.2017;2017;05;18;Tiistai;21;31;52;11;10;21
294;23.05.2017;2017;05;19;Tiistai;30;19;49;21;18;39
294;23.05.2017;2017;05;20;Tiistai;5;9;14;7;12;19
294;23.05.2017;2017;05;21;Tiistai;5;0;5;1;0;1
294;23.05.2017;2017;05;22;Tiistai;0;1;1;1;1;2
294;23.05.2017;2017;05;23;Tiistai;0;0;0;0;0;0
294;24.05.2017;2017;05;00;Keskiviikko;0;0;0;0;0;0
294;24.05.2017;2017;05;01;Keskiviikko;0;0;0;0;0;0
294;24.05.2017;2017;05;02;Keskiviikko;0;0;0;0;0;0
294;24.05.2017;2017;05;03;Keskiviikko;0;0;0;0;0;0
294;24.05.2017;2017;05;04;Keskiviikko;0;0;0;0;0;0
294;24.05.2017;2017;05;05;Keskiviikko;0;0;0;0;0;0
294;24.05.2017;2017;05;06;Keskiviikko;2;4;6;2;0;2
294;24.05.2017;2017;05;07;Keskiviikko;22;2;24;4;2;6
294;24.05.2017;2017;05;08;Keskiviikko;17;8;25;6;8;14
294;24.05.2017;2017;05;09;Keskiviikko;25;56;81;11;9;20
294;24.05.2017;2017;05;10;Keskiviikko;16;9;25;13;2;15
294;24.05.2017;2017;05;11;Keskiviikko;32;17;49;15;7;22
294;24.05.2017;2017;05;12;Keskiviikko;37;17;54;11;15;26
294;24.05.2017;2017;05;13;Keskiviikko;29;31;60;13;4;17
294;24.05.2017;2017;05;14;Keskiviikko;39;23;62;12;13;25
294;24.05.2017;2017;05;15;Keskiviikko;43;32;75;16;6;22
294;24.05.2017;2017;05;16;Keskiviikko;30;26;56;11;20;31
294;24.05.2017;2017;05;17;Keskiviikko;25;29;54;9;17;26
294;24.05.2017;2017;05;18;Keskiviikko;29;23;52;16;10;26
294;24.05.2017;2017;05;19;Keskiviikko;32;19;51;7;9;16
294;24.05.2017;2017;05;20;Keskiviikko;12;16;28;2;18;20
294;24.05.2017;2017;05;21;Keskiviikko;21;13;34;5;0;5
294;24.05.2017;2017;05;22;Keskiviikko;10;7;17;2;2;4
294;24.05.2017;2017;05;23;Keskiviikko;1;2;3;0;1;1
294;25.05.2017;2017;05;00;Torstai;1;2;3;0;0;0
294;25.05.2017;2017;05;01;Torstai;1;2;3;0;1;1
294;25.05.2017;2017;05;02;Torstai;0;1;1;0;2;2
294;25.05.2017;2017;05;03;Torstai;0;0;0;1;0;1
294;25.05.2017;2017;05;04;Torstai;1;0;1;0;0;0
294;25.05.2017;2017;05;05;Torstai;0;0;0;1;0;1
294;25.05.2017;2017;05;06;Torstai;0;0;0;0;1;1
294;25.05.2017;2017;05;07;Torstai;0;3;3;4;1;5
294;25.05.2017;2017;05;08;Torstai;3;2;5;3;1;4
294;25.05.2017;2017;05;09;Torstai;4;6;10;4;1;5
294;25.05.2017;2017;05;10;Torstai;20;11;31;11;3;14
294;25.05.2017;2017;05;11;Torstai;14;12;26;0;3;3
294;25.05.2017;2017;05;12;Torstai;23;11;34;1;5;6
294;25.05.2017;2017;05;13;Torstai;27;21;48;8;7;15
294;25.05.2017;2017;05;14;Torstai;27;27;54;11;14;25
294;25.05.2017;2017;05;15;Torstai;20;17;37;12;10;22
294;25.05.2017;2017;05;16;Torstai;38;26;64;6;15;21
294;25.05.2017;2017;05;17;Torstai;23;25;48;6;6;12
294;25.05.2017;2017;05;18;Torstai;35;23;58;6;10;16
294;25.05.2017;2017;05;19;Torstai;16;16;32;11;8;19
294;25.05.2017;2017;05;20;Torstai;13;18;31;14;10;24
294;25.05.2017;2017;05;21;Torstai;1;14;15;4;8;12
294;25.05.2017;2017;05;22;Torstai;0;3;3;4;0;4
294;25.05.2017;2017;05;23;Torstai;1;1;2;0;2;2
294;26.05.2017;2017;05;00;Perjantai;0;0;0;0;0;0
294;26.05.2017;2017;05;01;Perjantai;0;0;0;0;0;0
294;26.05.2017;2017;05;02;Perjantai;0;0;0;0;0;0
294;26.05.2017;2017;05;03;Perjantai;0;0;0;0;0;0
294;26.05.2017;2017;05;04;Perjantai;0;0;0;0;0;0
294;26.05.2017;2017;05;05;Perjantai;1;0;1;0;0;0
294;26.05.2017;2017;05;06;Perjantai;2;3;5;1;0;1
294;26.05.2017;2017;05;07;Perjantai;13;17;30;6;1;7
294;26.05.2017;2017;05;08;Perjantai;31;6;37;5;3;8
294;26.05.2017;2017;05;09;Perjantai;20;12;32;11;3;14
294;26.05.2017;2017;05;10;Perjantai;10;8;18;12;4;16
294;26.05.2017;2017;05;11;Perjantai;14;11;25;11;8;19
294;26.05.2017;2017;05;12;Perjantai;18;41;59;8;16;24
294;26.05.2017;2017;05;13;Perjantai;19;14;33;7;7;14
294;26.05.2017;2017;05;14;Perjantai;16;14;30;5;12;17
294;26.05.2017;2017;05;15;Perjantai;17;17;34;8;7;15
294;26.05.2017;2017;05;16;Perjantai;16;23;39;12;8;20
294;26.05.2017;2017;05;17;Perjantai;25;28;53;4;7;11
294;26.05.2017;2017;05;18;Perjantai;13;8;21;8;13;21
294;26.05.2017;2017;05;19;Perjantai;15;10;25;17;10;27
294;26.05.2017;2017;05;20;Perjantai;16;15;31;4;3;7
294;26.05.2017;2017;05;21;Perjantai;16;12;28;1;2;3
294;26.05.2017;2017;05;22;Perjantai;9;1;10;3;2;5
294;26.05.2017;2017;05;23;Perjantai;0;0;0;0;0;0
294;27.05.2017;2017;05;00;Lauantai;1;1;2;0;0;0
294;27.05.2017;2017;05;01;Lauantai;0;0;0;0;0;0
294;27.05.2017;2017;05;02;Lauantai;0;0;0;0;0;0
294;27.05.2017;2017;05;03;Lauantai;0;0;0;0;0;0
294;27.05.2017;2017;05;04;Lauantai;1;0;1;0;0;0
294;27.05.2017;2017;05;05;Lauantai;1;0;1;0;0;0
294;27.05.2017;2017;05;06;Lauantai;1;0;1;1;0;1
294;27.05.2017;2017;05;07;Lauantai;3;1;4;1;0;1
294;27.05.2017;2017;05;08;Lauantai;0;2;2;2;1;3
294;27.05.2017;2017;05;09;Lauantai;9;4;13;3;1;4
294;27.05.2017;2017;05;10;Lauantai;12;3;15;9;4;13
294;27.05.2017;2017;05;11;Lauantai;16;13;29;9;2;11
294;27.05.2017;2017;05;12;Lauantai;16;14;30;5;8;13
294;27.05.2017;2017;05;13;Lauantai;19;11;30;9;3;12
294;27.05.2017;2017;05;14;Lauantai;27;24;51;6;5;11
294;27.05.2017;2017;05;15;Lauantai;20;15;35;5;9;14
294;27.05.2017;2017;05;16;Lauantai;11;7;18;7;1;8
294;27.05.2017;2017;05;17;Lauantai;10;13;23;5;12;17
294;27.05.2017;2017;05;18;Lauantai;13;5;18;11;2;13
294;27.05.2017;2017;05;19;Lauantai;2;9;11;5;8;13
294;27.05.2017;2017;05;20;Lauantai;11;8;19;4;4;8
294;27.05.2017;2017;05;21;Lauantai;6;4;10;1;5;6
294;27.05.2017;2017;05;22;Lauantai;0;2;2;1;0;1
294;27.05.2017;2017;05;23;Lauantai;0;0;0;0;0;0
294;28.05.2017;2017;05;00;Sunnuntai;3;2;5;0;0;0
294;28.05.2017;2017;05;01;Sunnuntai;0;0;0;0;0;0
294;28.05.2017;2017;05;02;Sunnuntai;1;0;1;0;2;2
294;28.05.2017;2017;05;03;Sunnuntai;0;0;0;0;0;0
294;28.05.2017;2017;05;04;Sunnuntai;1;0;1;0;0;0
294;28.05.2017;2017;05;05;Sunnuntai;0;0;0;0;0;0
294;28.05.2017;2017;05;06;Sunnuntai;0;0;0;1;0;1
294;28.05.2017;2017;05;07;Sunnuntai;0;0;0;0;0;0
294;28.05.2017;2017;05;08;Sunnuntai;0;2;2;2;2;4
294;28.05.2017;2017;05;09;Sunnuntai;2;2;4;8;9;17
294;28.05.2017;2017;05;10;Sunnuntai;2;2;4;4;1;5
294;28.05.2017;2017;05;11;Sunnuntai;3;0;3;1;2;3
294;28.05.2017;2017;05;12;Sunnuntai;2;1;3;2;1;3
294;28.05.2017;2017;05;13;Sunnuntai;2;1;3;2;1;3
294;28.05.2017;2017;05;14;Sunnuntai;1;8;9;5;4;9
294;28.05.2017;2017;05;15;Sunnuntai;9;5;14;5;4;9
294;28.05.2017;2017;05;16;Sunnuntai;3;6;9;3;1;4
294;28.05.2017;2017;05;17;Sunnuntai;3;3;6;3;6;9
294;28.05.2017;2017;05;18;Sunnuntai;5;2;7;8;7;15
294;28.05.2017;2017;05;19;Sunnuntai;4;6;10;5;3;8
294;28.05.2017;2017;05;20;Sunnuntai;2;0;2;5;5;10
294;28.05.2017;2017;05;21;Sunnuntai;1;0;1;1;1;2
294;28.05.2017;2017;05;22;Sunnuntai;0;0;0;0;0;0
294;28.05.2017;2017;05;23;Sunnuntai;0;0;0;0;0;0
294;29.05.2017;2017;05;00;Maanantai;0;0;0;0;0;0
294;29.05.2017;2017;05;01;Maanantai;0;0;0;0;0;0
294;29.05.2017;2017;05;02;Maanantai;0;0;0;0;0;0
294;29.05.2017;2017;05;03;Maanantai;0;0;0;0;0;0
294;29.05.2017;2017;05;04;Maanantai;0;0;0;0;0;0
294;29.05.2017;2017;05;05;Maanantai;0;0;0;0;1;1
294;29.05.2017;2017;05;06;Maanantai;2;3;5;1;5;6
294;29.05.2017;2017;05;07;Maanantai;26;10;36;2;3;5
294;29.05.2017;2017;05;08;Maanantai;19;5;24;9;7;16
294;29.05.2017;2017;05;09;Maanantai;7;5;12;2;6;8
294;29.05.2017;2017;05;10;Maanantai;14;9;23;8;5;13
294;29.05.2017;2017;05;11;Maanantai;11;19;30;4;12;16
294;29.05.2017;2017;05;12;Maanantai;21;28;49;19;19;38
294;29.05.2017;2017;05;13;Maanantai;16;9;25;8;12;20
294;29.05.2017;2017;05;14;Maanantai;12;11;23;12;5;17
294;29.05.2017;2017;05;15;Maanantai;20;20;40;14;5;19
294;29.05.2017;2017;05;16;Maanantai;22;22;44;6;6;12
294;29.05.2017;2017;05;17;Maanantai;30;18;48;14;12;26
294;29.05.2017;2017;05;18;Maanantai;21;16;37;8;25;33
294;29.05.2017;2017;05;19;Maanantai;14;29;43;16;14;30
294;29.05.2017;2017;05;20;Maanantai;10;14;24;7;8;15
294;29.05.2017;2017;05;21;Maanantai;10;6;16;1;1;2
294;29.05.2017;2017;05;22;Maanantai;2;1;3;1;2;3
294;29.05.2017;2017;05;23;Maanantai;0;0;0;0;0;0
294;30.05.2017;2017;05;00;Tiistai;0;0;0;0;0;0
294;30.05.2017;2017;05;01;Tiistai;0;0;0;0;0;0
294;30.05.2017;2017;05;02;Tiistai;0;0;0;0;0;0
294;30.05.2017;2017;05;03;Tiistai;0;0;0;0;0;0
294;30.05.2017;2017;05;04;Tiistai;0;0;0;0;0;0
294;30.05.2017;2017;05;05;Tiistai;1;0;1;0;0;0
294;30.05.2017;2017;05;06;Tiistai;5;4;9;2;0;2
294;30.05.2017;2017;05;07;Tiistai;12;11;23;8;7;15
294;30.05.2017;2017;05;08;Tiistai;16;3;19;5;7;12
294;30.05.2017;2017;05;09;Tiistai;9;8;17;19;6;25
294;30.05.2017;2017;05;10;Tiistai;9;7;16;10;7;17
294;30.05.2017;2017;05;11;Tiistai;30;15;45;15;8;23
294;30.05.2017;2017;05;12;Tiistai;10;9;19;10;16;26
294;30.05.2017;2017;05;13;Tiistai;25;56;81;14;10;24
294;30.05.2017;2017;05;14;Tiistai;16;16;32;8;7;15
294;30.05.2017;2017;05;15;Tiistai;14;27;41;8;10;18
294;30.05.2017;2017;05;16;Tiistai;32;15;47;13;18;31
294;30.05.2017;2017;05;17;Tiistai;18;20;38;14;11;25
294;30.05.2017;2017;05;18;Tiistai;22;19;41;14;6;20
294;30.05.2017;2017;05;19;Tiistai;10;25;35;17;14;31
294;30.05.2017;2017;05;20;Tiistai;12;11;23;4;3;7
294;30.05.2017;2017;05;21;Tiistai;3;6;9;2;1;3
294;30.05.2017;2017;05;22;Tiistai;1;1;2;3;1;4
294;30.05.2017;2017;05;23;Tiistai;1;0;1;0;0;0
294;31.05.2017;2017;05;00;Keskiviikko;0;0;0;0;0;0
294;31.05.2017;2017;05;01;Keskiviikko;0;0;0;0;0;0
294;31.05.2017;2017;05;02;Keskiviikko;0;0;0;0;0;0
294;31.05.2017;2017;05;03;Keskiviikko;0;0;0;0;0;0
294;31.05.2017;2017;05;04;Keskiviikko;0;0;0;0;0;0
294;31.05.2017;2017;05;05;Keskiviikko;0;2;2;0;1;1
294;31.05.2017;2017;05;06;Keskiviikko;3;1;4;1;1;2
294;31.05.2017;2017;05;07;Keskiviikko;4;4;8;6;4;10
294;31.05.2017;2017;05;08;Keskiviikko;17;7;24;8;7;15
294;31.05.2017;2017;05;09;Keskiviikko;13;7;20;29;6;35
294;31.05.2017;2017;05;10;Keskiviikko;3;2;5;0;12;12
294;31.05.2017;2017;05;11;Keskiviikko;6;4;10;4;4;8
294;31.05.2017;2017;05;12;Keskiviikko;10;16;26;3;11;14
294;31.05.2017;2017;05;13;Keskiviikko;18;19;37;12;5;17
294;31.05.2017;2017;05;14;Keskiviikko;12;12;24;15;10;25
294;31.05.2017;2017;05;15;Keskiviikko;22;18;40;6;3;9
294;31.05.2017;2017;05;16;Keskiviikko;15;17;32;8;5;13
294;31.05.2017;2017;05;17;Keskiviikko;7;11;18;7;3;10
294;31.05.2017;2017;05;18;Keskiviikko;7;15;22;10;14;24
294;31.05.2017;2017;05;19;Keskiviikko;26;11;37;9;4;13
294;31.05.2017;2017;05;20;Keskiviikko;4;4;8;4;5;9
294;31.05.2017;2017;05;21;Keskiviikko;4;2;6;3;1;4
294;31.05.2017;2017;05;22;Keskiviikko;1;1;2;0;1;1
294;31.05.2017;2017;05;23;Keskiviikko;1;0;1;0;0;0
294;01.06.2017;2017;06;00;Torstai;0;0;0;0;0;0
294;01.06.2017;2017;06;01;Torstai;1;0;1;1;0;1
294;01.06.2017;2017;06;02;Torstai;0;1;1;0;1;1
294;01.06.2017;2017;06;03;Torstai;0;0;0;0;0;0
294;01.06.2017;2017;06;04;Torstai;1;0;1;0;0;0
294;01.06.2017;2017;06;05;Torstai;1;0;1;1;0;1
294;01.06.2017;2017;06;06;Torstai;3;1;4;1;1;2
294;01.06.2017;2017;06;07;Torstai;6;3;9;7;3;10
294;01.06.2017;2017;06;08;Torstai;13;5;18;4;3;7
294;01.06.2017;2017;06;09;Torstai;15;10;25;0;12;12
294;01.06.2017;2017;06;10;Torstai;11;21;32;11;13;24
294;01.06.2017;2017;06;11;Torstai;2;26;28;7;12;19
294;01.06.2017;2017;06;12;Torstai;26;28;54;29;10;39
294;01.06.2017;2017;06;13;Torstai;37;33;70;10;8;18
294;01.06.2017;2017;06;14;Torstai;10;9;19;9;7;16
294;01.06.2017;2017;06;15;Torstai;8;10;18;5;7;12
294;01.06.2017;2017;06;16;Torstai;6;14;20;8;7;15
294;01.06.2017;2017;06;17;Torstai;9;13;22;9;6;15
294;01.06.2017;2017;06;18;Torstai;11;12;23;8;11;19
294;01.06.2017;2017;06;19;Torstai;7;5;12;7;10;17
294;01.06.2017;2017;06;20;Torstai;7;9;16;4;6;10
294;01.06.2017;2017;06;21;Torstai;4;2;6;4;0;4
294;01.06.2017;2017;06;22;Torstai;0;0;0;0;0;0
294;01.06.2017;2017;06;23;Torstai;3;0;3;1;0;1
294;02.06.2017;2017;06;00;Perjantai;2;1;3;1;0;1
294;02.06.2017;2017;06;01;Perjantai;0;0;0;0;0;0
294;02.06.2017;2017;06;02;Perjantai;0;0;0;0;0;0
294;02.06.2017;2017;06;03;Perjantai;0;0;0;0;0;0
294;02.06.2017;2017;06;04;Perjantai;0;0;0;0;0;0
294;02.06.2017;2017;06;05;Perjantai;0;0;0;0;0;0
294;02.06.2017;2017;06;06;Perjantai;2;4;6;0;0;0
294;02.06.2017;2017;06;07;Perjantai;1;2;3;2;1;3
294;02.06.2017;2017;06;08;Perjantai;4;3;7;1;3;4
294;02.06.2017;2017;06;09;Perjantai;24;4;28;6;4;10
294;02.06.2017;2017;06;10;Perjantai;8;12;20;5;7;12
294;02.06.2017;2017;06;11;Perjantai;8;4;12;6;9;15
294;02.06.2017;2017;06;12;Perjantai;18;40;58;21;36;57
294;02.06.2017;2017;06;13;Perjantai;28;17;45;12;7;19
294;02.06.2017;2017;06;14;Perjantai;14;18;32;15;10;25
294;02.06.2017;2017;06;15;Perjantai;16;18;34;10;10;20
294;02.06.2017;2017;06;16;Perjantai;10;8;18;10;7;17
294;02.06.2017;2017;06;17;Perjantai;2;10;12;4;10;14
294;02.06.2017;2017;06;18;Perjantai;13;17;30;5;5;10
294;02.06.2017;2017;06;19;Perjantai;8;6;14;8;8;16
294;02.06.2017;2017;06;20;Perjantai;8;5;13;6;2;8
294;02.06.2017;2017;06;21;Perjantai;6;0;6;3;4;7
294;02.06.2017;2017;06;22;Perjantai;0;2;2;0;1;1
294;02.06.2017;2017;06;23;Perjantai;1;0;1;0;0;0
294;03.06.2017;2017;06;00;Lauantai;0;2;2;2;0;2
294;03.06.2017;2017;06;01;Lauantai;0;1;1;0;0;0
294;03.06.2017;2017;06;02;Lauantai;0;0;0;0;1;1
294;03.06.2017;2017;06;03;Lauantai;0;0;0;0;0;0
294;03.06.2017;2017;06;04;Lauantai;0;0;0;0;0;0
294;03.06.2017;2017;06;05;Lauantai;0;0;0;0;0;0
294;03.06.2017;2017;06;06;Lauantai;0;0;0;1;2;3
294;03.06.2017;2017;06;07;Lauantai;0;1;1;1;1;2
294;03.06.2017;2017;06;08;Lauantai;29;7;36;4;3;7
294;03.06.2017;2017;06;09;Lauantai;12;42;54;6;20;26
294;03.06.2017;2017;06;10;Lauantai;12;21;33;15;13;28
294;03.06.2017;2017;06;11;Lauantai;16;13;29;8;10;18
294;03.06.2017;2017;06;12;Lauantai;14;12;26;9;7;16
294;03.06.2017;2017;06;13;Lauantai;11;18;29;3;8;11
294;03.06.2017;2017;06;14;Lauantai;9;12;21;4;2;6
294;03.06.2017;2017;06;15;Lauantai;9;7;16;7;5;12
294;03.06.2017;2017;06;16;Lauantai;14;9;23;8;6;14
294;03.06.2017;2017;06;17;Lauantai;8;10;18;8;9;17
294;03.06.2017;2017;06;18;Lauantai;15;4;19;8;5;13
294;03.06.2017;2017;06;19;Lauantai;17;9;26;8;4;12
294;03.06.2017;2017;06;20;Lauantai;12;7;19;5;3;8
294;03.06.2017;2017;06;21;Lauantai;7;7;14;1;3;4
294;03.06.2017;2017;06;22;Lauantai;4;8;12;3;1;4
294;03.06.2017;2017;06;23;Lauantai;1;4;5;1;3;4
294;04.06.2017;2017;06;00;Sunnuntai;0;1;1;0;0;0
294;04.06.2017;2017;06;01;Sunnuntai;0;0;0;0;0;0
294;04.06.2017;2017;06;02;Sunnuntai;1;1;2;2;0;2
294;04.06.2017;2017;06;03;Sunnuntai;1;0;1;1;1;2
294;04.06.2017;2017;06;04;Sunnuntai;0;0;0;0;0;0
294;04.06.2017;2017;06;05;Sunnuntai;0;0;0;0;0;0
294;04.06.2017;2017;06;06;Sunnuntai;0;0;0;0;0;0
294;04.06.2017;2017;06;07;Sunnuntai;1;0;1;0;0;0
294;04.06.2017;2017;06;08;Sunnuntai;1;0;1;5;0;5
294;04.06.2017;2017;06;09;Sunnuntai;7;5;12;5;0;5
294;04.06.2017;2017;06;10;Sunnuntai;6;9;15;10;4;14
294;04.06.2017;2017;06;11;Sunnuntai;12;3;15;9;4;13
294;04.06.2017;2017;06;12;Sunnuntai;15;7;22;6;10;16
294;04.06.2017;2017;06;13;Sunnuntai;19;11;30;3;4;7
294;04.06.2017;2017;06;14;Sunnuntai;15;13;28;5;7;12
294;04.06.2017;2017;06;15;Sunnuntai;16;13;29;10;4;14
294;04.06.2017;2017;06;16;Sunnuntai;10;14;24;4;3;7
294;04.06.2017;2017;06;17;Sunnuntai;19;13;32;13;5;18
294;04.06.2017;2017;06;18;Sunnuntai;19;16;35;10;7;17
294;04.06.2017;2017;06;19;Sunnuntai;19;15;34;11;4;15
294;04.06.2017;2017;06;20;Sunnuntai;11;13;24;3;6;9
294;04.06.2017;2017;06;21;Sunnuntai;8;4;12;4;5;9
294;04.06.2017;2017;06;22;Sunnuntai;2;3;5;3;4;7
294;04.06.2017;2017;06;23;Sunnuntai;3;0;3;0;0;0
294;05.06.2017;2017;06;00;Maanantai;1;0;1;0;0;0
294;05.06.2017;2017;06;01;Maanantai;0;0;0;0;0;0
294;05.06.2017;2017;06;02;Maanantai;0;0;0;0;0;0
294;05.06.2017;2017;06;03;Maanantai;0;0;0;0;0;0
294;05.06.2017;2017;06;04;Maanantai;0;0;0;0;0;0
294;05.06.2017;2017;06;05;Maanantai;0;0;0;0;0;0
294;05.06.2017;2017;06;06;Maanantai;3;4;7;0;1;1
294;05.06.2017;2017;06;07;Maanantai;6;3;9;1;3;4
294;05.06.2017;2017;06;08;Maanantai;3;3;6;3;1;4
294;05.06.2017;2017;06;09;Maanantai;15;9;24;2;0;2
294;05.06.2017;2017;06;10;Maanantai;16;13;29;5;1;6
294;05.06.2017;2017;06;11;Maanantai;28;21;49;13;12;25
294;05.06.2017;2017;06;12;Maanantai;38;27;65;15;7;22
294;05.06.2017;2017;06;13;Maanantai;54;30;84;12;7;19
294;05.06.2017;2017;06;14;Maanantai;47;34;81;10;6;16
294;05.06.2017;2017;06;15;Maanantai;45;26;71;5;10;15
294;05.06.2017;2017;06;16;Maanantai;29;30;59;10;15;25
294;05.06.2017;2017;06;17;Maanantai;36;28;64;7;7;14
294;05.06.2017;2017;06;18;Maanantai;31;30;61;13;12;25
294;05.06.2017;2017;06;19;Maanantai;31;20;51;8;7;15
294;05.06.2017;2017;06;20;Maanantai;9;9;18;3;5;8
294;05.06.2017;2017;06;21;Maanantai;13;4;17;6;2;8
294;05.06.2017;2017;06;22;Maanantai;3;2;5;3;1;4
294;05.06.2017;2017;06;23;Maanantai;1;0;1;0;0;0
294;06.06.2017;2017;06;00;Tiistai;4;0;4;0;0;0
294;06.06.2017;2017;06;01;Tiistai;0;0;0;0;0;0
294;06.06.2017;2017;06;02;Tiistai;0;0;0;0;0;0
294;06.06.2017;2017;06;03;Tiistai;0;0;0;0;0;0
294;06.06.2017;2017;06;04;Tiistai;0;0;0;0;0;0
294;06.06.2017;2017;06;05;Tiistai;0;0;0;0;0;0
294;06.06.2017;2017;06;06;Tiistai;2;1;3;0;0;0
294;06.06.2017;2017;06;07;Tiistai;4;7;11;4;0;4
294;06.06.2017;2017;06;08;Tiistai;7;4;11;4;5;9
294;06.06.2017;2017;06;09;Tiistai;4;2;6;3;4;7
294;06.06.2017;2017;06;10;Tiistai;2;1;3;2;6;8
294;06.06.2017;2017;06;11;Tiistai;7;10;17;14;7;21
294;06.06.2017;2017;06;12;Tiistai;8;11;19;5;6;11
294;06.06.2017;2017;06;13;Tiistai;15;8;23;4;4;8
294;06.06.2017;2017;06;14;Tiistai;24;22;46;13;12;25
294;06.06.2017;2017;06;15;Tiistai;23;29;52;6;4;10
294;06.06.2017;2017;06;16;Tiistai;20;17;37;7;8;15
294;06.06.2017;2017;06;17;Tiistai;18;15;33;14;10;24
294;06.06.2017;2017;06;18;Tiistai;28;37;65;23;17;40
294;06.06.2017;2017;06;19;Tiistai;33;21;54;16;17;33
294;06.06.2017;2017;06;20;Tiistai;13;14;27;14;6;20
294;06.06.2017;2017;06;21;Tiistai;13;5;18;5;5;10
294;06.06.2017;2017;06;22;Tiistai;5;3;8;0;1;1
294;06.06.2017;2017;06;23;Tiistai;3;2;5;1;0;1
294;07.06.2017;2017;06;00;Keskiviikko;4;1;5;1;0;1
294;07.06.2017;2017;06;01;Keskiviikko;1;2;3;1;0;1
294;07.06.2017;2017;06;02;Keskiviikko;0;0;0;1;0;1
294;07.06.2017;2017;06;03;Keskiviikko;0;0;0;0;0;0
294;07.06.2017;2017;06;04;Keskiviikko;1;0;1;0;0;0
294;07.06.2017;2017;06;05;Keskiviikko;0;0;0;0;0;0
294;07.06.2017;2017;06;06;Keskiviikko;6;7;13;1;1;2
294;07.06.2017;2017;06;07;Keskiviikko;12;7;19;1;1;2
294;07.06.2017;2017;06;08;Keskiviikko;4;7;11;4;4;8
294;07.06.2017;2017;06;09;Keskiviikko;20;12;32;4;5;9
294;07.06.2017;2017;06;10;Keskiviikko;17;18;35;13;3;16
294;07.06.2017;2017;06;11;Keskiviikko;23;22;45;10;11;21
294;07.06.2017;2017;06;12;Keskiviikko;34;31;65;11;7;18
294;07.06.2017;2017;06;13;Keskiviikko;38;34;72;4;5;9
294;07.06.2017;2017;06;14;Keskiviikko;32;31;63;10;6;16
294;07.06.2017;2017;06;15;Keskiviikko;28;37;65;7;6;13
294;07.06.2017;2017;06;16;Keskiviikko;26;21;47;6;8;14
294;07.06.2017;2017;06;17;Keskiviikko;22;25;47;7;11;18
294;07.06.2017;2017;06;18;Keskiviikko;34;36;70;7;9;16
294;07.06.2017;2017;06;19;Keskiviikko;13;20;33;8;8;16
294;07.06.2017;2017;06;20;Keskiviikko;23;19;42;10;15;25
294;07.06.2017;2017;06;21;Keskiviikko;22;10;32;7;5;12
294;07.06.2017;2017;06;22;Keskiviikko;6;3;9;0;1;1
294;07.06.2017;2017;06;23;Keskiviikko;0;2;2;0;0;0
294;08.06.2017;2017;06;00;Torstai;0;0;0;0;1;1
294;08.06.2017;2017;06;01;Torstai;0;2;2;0;1;1
294;08.06.2017;2017;06;02;Torstai;0;0;0;0;0;0
294;08.06.2017;2017;06;03;Torstai;0;0;0;0;0;0
294;08.06.2017;2017;06;04;Torstai;0;0;0;0;0;0
294;08.06.2017;2017;06;05;Torstai;0;0;0;0;0;0
294;08.06.2017;2017;06;06;Torstai;3;2;5;2;1;3
294;08.06.2017;2017;06;07;Torstai;10;6;16;5;2;7
294;08.06.2017;2017;06;08;Torstai;10;7;17;4;5;9
294;08.06.2017;2017;06;09;Torstai;10;11;21;2;1;3
294;08.06.2017;2017;06;10;Torstai;13;6;19;4;2;6
294;08.06.2017;2017;06;11;Torstai;20;25;45;9;10;19
294;08.06.2017;2017;06;12;Torstai;21;28;49;5;13;18
294;08.06.2017;2017;06;13;Torstai;43;36;79;10;6;16
294;08.06.2017;2017;06;14;Torstai;28;25;53;5;14;19
294;08.06.2017;2017;06;15;Torstai;22;24;46;11;7;18
294;08.06.2017;2017;06;16;Torstai;23;18;41;7;6;13
294;08.06.2017;2017;06;17;Torstai;19;29;48;11;15;26
294;08.06.2017;2017;06;18;Torstai;32;35;67;13;14;27
294;08.06.2017;2017;06;19;Torstai;22;14;36;11;9;20
294;08.06.2017;2017;06;20;Torstai;10;17;27;13;9;22
294;08.06.2017;2017;06;21;Torstai;21;15;36;5;4;9
294;08.06.2017;2017;06;22;Torstai;8;2;10;3;0;3
294;08.06.2017;2017;06;23;Torstai;1;2;3;0;1;1
294;09.06.2017;2017;06;00;Perjantai;2;1;3;5;4;9
294;09.06.2017;2017;06;01;Perjantai;0;0;0;0;0;0
294;09.06.2017;2017;06;02;Perjantai;0;0;0;0;0;0
294;09.06.2017;2017;06;03;Perjantai;0;0;0;0;0;0
294;09.06.2017;2017;06;04;Perjantai;1;0;1;0;0;0
294;09.06.2017;2017;06;05;Perjantai;0;0;0;1;0;1
294;09.06.2017;2017;06;06;Perjantai;3;3;6;2;4;6
294;09.06.2017;2017;06;07;Perjantai;9;7;16;3;3;6
294;09.06.2017;2017;06;08;Perjantai;11;3;14;4;5;9
294;09.06.2017;2017;06;09;Perjantai;6;11;17;3;4;7
294;09.06.2017;2017;06;10;Perjantai;15;19;34;12;12;24
294;09.06.2017;2017;06;11;Perjantai;22;12;34;16;20;36
294;09.06.2017;2017;06;12;Perjantai;19;21;40;6;3;9
294;09.06.2017;2017;06;13;Perjantai;35;17;52;2;2;4
294;09.06.2017;2017;06;14;Perjantai;46;35;81;9;11;20
294;09.06.2017;2017;06;15;Perjantai;29;32;61;16;13;29
294;09.06.2017;2017;06;16;Perjantai;27;22;49;5;7;12
294;09.06.2017;2017;06;17;Perjantai;27;23;50;6;5;11
294;09.06.2017;2017;06;18;Perjantai;24;30;54;8;2;10
294;09.06.2017;2017;06;19;Perjantai;21;24;45;7;6;13
294;09.06.2017;2017;06;20;Perjantai;17;28;45;7;3;10
294;09.06.2017;2017;06;21;Perjantai;16;7;23;8;6;14
294;09.06.2017;2017;06;22;Perjantai;6;5;11;1;1;2
294;09.06.2017;2017;06;23;Perjantai;0;3;3;0;4;4
294;10.06.2017;2017;06;00;Lauantai;0;0;0;0;0;0
294;10.06.2017;2017;06;01;Lauantai;1;1;2;0;0;0
294;10.06.2017;2017;06;02;Lauantai;1;0;1;0;0;0
294;10.06.2017;2017;06;03;Lauantai;0;0;0;0;0;0
294;10.06.2017;2017;06;04;Lauantai;0;0;0;1;0;1
294;10.06.2017;2017;06;05;Lauantai;0;0;0;1;0;1
294;10.06.2017;2017;06;06;Lauantai;0;0;0;1;1;2
294;10.06.2017;2017;06;07;Lauantai;2;2;4;1;0;1
294;10.06.2017;2017;06;08;Lauantai;4;4;8;0;2;2
294;10.06.2017;2017;06;09;Lauantai;6;6;12;4;3;7
294;10.06.2017;2017;06;10;Lauantai;13;10;23;5;7;12
294;10.06.2017;2017;06;11;Lauantai;13;13;26;5;5;10
294;10.06.2017;2017;06;12;Lauantai;14;11;25;7;4;11
294;10.06.2017;2017;06;13;Lauantai;29;16;45;1;2;3
294;10.06.2017;2017;06;14;Lauantai;15;22;37;7;3;10
294;10.06.2017;2017;06;15;Lauantai;24;27;51;9;9;18
294;10.06.2017;2017;06;16;Lauantai;27;26;53;11;12;23
294;10.06.2017;2017;06;17;Lauantai;20;18;38;7;5;12
294;10.06.2017;2017;06;18;Lauantai;21;16;37;6;13;19
294;10.06.2017;2017;06;19;Lauantai;19;9;28;15;10;25
294;10.06.2017;2017;06;20;Lauantai;4;11;15;7;12;19
294;10.06.2017;2017;06;21;Lauantai;13;6;19;3;3;6
294;10.06.2017;2017;06;22;Lauantai;6;5;11;0;2;2
294;10.06.2017;2017;06;23;Lauantai;0;1;1;0;0;0
294;11.06.2017;2017;06;00;Sunnuntai;3;2;5;0;0;0
294;11.06.2017;2017;06;01;Sunnuntai;0;0;0;2;0;2
294;11.06.2017;2017;06;02;Sunnuntai;0;2;2;1;4;5
294;11.06.2017;2017;06;03;Sunnuntai;0;0;0;0;0;0
294;11.06.2017;2017;06;04;Sunnuntai;1;0;1;0;0;0
294;11.06.2017;2017;06;05;Sunnuntai;0;0;0;0;0;0
294;11.06.2017;2017;06;06;Sunnuntai;0;0;0;0;0;0
294;11.06.2017;2017;06;07;Sunnuntai;1;2;3;1;3;4
294;11.06.2017;2017;06;08;Sunnuntai;1;3;4;4;3;7
294;11.06.2017;2017;06;09;Sunnuntai;6;4;10;8;3;11
294;11.06.2017;2017;06;10;Sunnuntai;9;6;15;1;5;6
294;11.06.2017;2017;06;11;Sunnuntai;18;19;37;6;9;15
294;11.06.2017;2017;06;12;Sunnuntai;28;8;36;5;7;12
294;11.06.2017;2017;06;13;Sunnuntai;20;13;33;5;3;8
294;11.06.2017;2017;06;14;Sunnuntai;21;16;37;9;8;17
294;11.06.2017;2017;06;15;Sunnuntai;33;19;52;6;6;12
294;11.06.2017;2017;06;16;Sunnuntai;24;16;40;4;7;11
294;11.06.2017;2017;06;17;Sunnuntai;27;27;54;10;6;16
294;11.06.2017;2017;06;18;Sunnuntai;19;16;35;11;9;20
294;11.06.2017;2017;06;19;Sunnuntai;16;18;34;7;4;11
294;11.06.2017;2017;06;20;Sunnuntai;14;12;26;7;11;18
294;11.06.2017;2017;06;21;Sunnuntai;16;4;20;7;2;9
294;11.06.2017;2017;06;22;Sunnuntai;1;4;5;2;2;4
294;11.06.2017;2017;06;23;Sunnuntai;1;1;2;0;0;0
294;12.06.2017;2017;06;00;Maanantai;0;0;0;0;0;0
294;12.06.2017;2017;06;01;Maanantai;2;2;4;0;0;0
294;12.06.2017;2017;06;02;Maanantai;0;0;0;0;0;0
294;12.06.2017;2017;06;03;Maanantai;0;0;0;0;0;0
294;12.06.2017;2017;06;04;Maanantai;1;0;1;0;0;0
294;12.06.2017;2017;06;05;Maanantai;1;0;1;0;0;0
294;12.06.2017;2017;06;06;Maanantai;3;3;6;2;0;2
294;12.06.2017;2017;06;07;Maanantai;9;3;12;2;1;3
294;12.06.2017;2017;06;08;Maanantai;5;4;9;7;4;11
294;12.06.2017;2017;06;09;Maanantai;13;9;22;2;8;10
294;12.06.2017;2017;06;10;Maanantai;4;6;10;9;8;17
294;12.06.2017;2017;06;11;Maanantai;8;9;17;9;4;13
294;12.06.2017;2017;06;12;Maanantai;7;2;9;5;11;16
294;12.06.2017;2017;06;13;Maanantai;16;21;37;11;7;18
294;12.06.2017;2017;06;14;Maanantai;13;11;24;12;9;21
294;12.06.2017;2017;06;15;Maanantai;17;13;30;5;9;14
294;12.06.2017;2017;06;16;Maanantai;19;24;43;8;9;17
294;12.06.2017;2017;06;17;Maanantai;25;23;48;7;8;15
294;12.06.2017;2017;06;18;Maanantai;19;17;36;10;11;21
294;12.06.2017;2017;06;19;Maanantai;17;14;31;13;11;24
294;12.06.2017;2017;06;20;Maanantai;13;12;25;7;4;11
294;12.06.2017;2017;06;21;Maanantai;6;8;14;3;3;6
294;12.06.2017;2017;06;22;Maanantai;6;9;15;3;3;6
294;12.06.2017;2017;06;23;Maanantai;6;2;8;1;2;3
294;13.06.2017;2017;06;00;Tiistai;0;0;0;0;1;1
294;13.06.2017;2017;06;01;Tiistai;0;0;0;0;0;0
294;13.06.2017;2017;06;02;Tiistai;0;0;0;0;0;0
294;13.06.2017;2017;06;03;Tiistai;0;0;0;0;0;0
294;13.06.2017;2017;06;04;Tiistai;0;0;0;0;1;1
294;13.06.2017;2017;06;05;Tiistai;0;0;0;0;0;0
294;13.06.2017;2017;06;06;Tiistai;5;1;6;1;0;1
294;13.06.2017;2017;06;07;Tiistai;15;9;24;3;1;4
294;13.06.2017;2017;06;08;Tiistai;5;6;11;10;3;13
294;13.06.2017;2017;06;09;Tiistai;8;6;14;7;6;13
294;13.06.2017;2017;06;10;Tiistai;8;14;22;9;13;22
294;13.06.2017;2017;06;11;Tiistai;5;18;23;14;5;19
294;13.06.2017;2017;06;12;Tiistai;16;18;34;7;10;17
294;13.06.2017;2017;06;13;Tiistai;23;20;43;6;6;12
294;13.06.2017;2017;06;14;Tiistai;22;24;46;11;16;27
294;13.06.2017;2017;06;15;Tiistai;17;17;34;5;4;9
294;13.06.2017;2017;06;16;Tiistai;33;25;58;6;11;17
294;13.06.2017;2017;06;17;Tiistai;19;18;37;17;7;24
294;13.06.2017;2017;06;18;Tiistai;29;13;42;15;13;28
294;13.06.2017;2017;06;19;Tiistai;22;12;34;11;14;25
294;13.06.2017;2017;06;20;Tiistai;11;16;27;5;8;13
294;13.06.2017;2017;06;21;Tiistai;8;9;17;3;5;8
294;13.06.2017;2017;06;22;Tiistai;6;7;13;2;0;2
294;13.06.2017;2017;06;23;Tiistai;1;0;1;0;0;0
294;14.06.2017;2017;06;00;Keskiviikko;0;0;0;0;0;0
294;14.06.2017;2017;06;01;Keskiviikko;0;0;0;0;0;0
294;14.06.2017;2017;06;02;Keskiviikko;0;0;0;0;0;0
294;14.06.2017;2017;06;03;Keskiviikko;0;0;0;0;0;0
294;14.06.2017;2017;06;04;Keskiviikko;0;0;0;0;0;0
294;14.06.2017;2017;06;05;Keskiviikko;0;0;0;2;0;2
294;14.06.2017;2017;06;06;Keskiviikko;3;3;6;1;0;1
294;14.06.2017;2017;06;07;Keskiviikko;9;10;19;3;2;5
294;14.06.2017;2017;06;08;Keskiviikko;3;6;9;1;1;2
294;14.06.2017;2017;06;09;Keskiviikko;11;8;19;5;13;18
294;14.06.2017;2017;06;10;Keskiviikko;15;5;20;7;6;13
294;14.06.2017;2017;06;11;Keskiviikko;22;12;34;13;6;19
294;14.06.2017;2017;06;12;Keskiviikko;18;28;46;13;13;26
294;14.06.2017;2017;06;13;Keskiviikko;26;26;52;8;6;14
294;14.06.2017;2017;06;14;Keskiviikko;17;19;36;5;11;16
294;14.06.2017;2017;06;15;Keskiviikko;22;28;50;6;5;11
294;14.06.2017;2017;06;16;Keskiviikko;24;17;41;9;10;19
294;14.06.2017;2017;06;17;Keskiviikko;18;16;34;6;12;18
294;14.06.2017;2017;06;18;Keskiviikko;35;24;59;27;15;42
294;14.06.2017;2017;06;19;Keskiviikko;25;18;43;8;16;24
294;14.06.2017;2017;06;20;Keskiviikko;15;12;27;9;3;12
294;14.06.2017;2017;06;21;Keskiviikko;10;8;18;4;4;8
294;14.06.2017;2017;06;22;Keskiviikko;5;6;11;1;1;2
294;14.06.2017;2017;06;23;Keskiviikko;3;0;3;1;0;1
294;15.06.2017;2017;06;00;Torstai;1;0;1;1;2;3
294;15.06.2017;2017;06;01;Torstai;0;0;0;0;0;0
294;15.06.2017;2017;06;02;Torstai;0;1;1;1;2;3
294;15.06.2017;2017;06;03;Torstai;0;0;0;0;0;0
294;15.06.2017;2017;06;04;Torstai;1;0;1;0;0;0
294;15.06.2017;2017;06;05;Torstai;0;0;0;0;0;0
294;15.06.2017;2017;06;06;Torstai;3;2;5;0;2;2
294;15.06.2017;2017;06;07;Torstai;6;9;15;2;1;3
294;15.06.2017;2017;06;08;Torstai;6;4;10;5;3;8
294;15.06.2017;2017;06;09;Torstai;8;8;16;4;3;7
294;15.06.2017;2017;06;10;Torstai;16;9;25;6;10;16
294;15.06.2017;2017;06;11;Torstai;14;19;33;11;5;16
294;15.06.2017;2017;06;12;Torstai;33;19;52;17;7;24
294;15.06.2017;2017;06;13;Torstai;24;33;57;6;1;7
294;15.06.2017;2017;06;14;Torstai;20;26;46;6;11;17
294;15.06.2017;2017;06;15;Torstai;28;11;39;12;6;18
294;15.06.2017;2017;06;16;Torstai;28;23;51;5;6;11
294;15.06.2017;2017;06;17;Torstai;26;37;63;7;6;13
294;15.06.2017;2017;06;18;Torstai;69;58;127;4;15;19
294;15.06.2017;2017;06;19;Torstai;27;26;53;14;11;25
294;15.06.2017;2017;06;20;Torstai;19;11;30;6;8;14
294;15.06.2017;2017;06;21;Torstai;8;7;15;4;3;7
294;15.06.2017;2017;06;22;Torstai;1;1;2;0;0;0
294;15.06.2017;2017;06;23;Torstai;0;1;1;1;0;1
294;16.06.2017;2017;06;00;Perjantai;0;0;0;0;0;0
294;16.06.2017;2017;06;01;Perjantai;0;0;0;0;0;0
294;16.06.2017;2017;06;02;Perjantai;0;0;0;0;0;0
294;16.06.2017;2017;06;03;Perjantai;1;0;1;0;0;0
294;16.06.2017;2017;06;04;Perjantai;0;0;0;0;0;0
294;16.06.2017;2017;06;05;Perjantai;0;0;0;0;0;0
294;16.06.2017;2017;06;06;Perjantai;2;4;6;1;0;1
294;16.06.2017;2017;06;07;Perjantai;7;4;11;3;1;4
294;16.06.2017;2017;06;08;Perjantai;9;5;14;0;6;6
294;16.06.2017;2017;06;09;Perjantai;13;10;23;7;2;9
294;16.06.2017;2017;06;10;Perjantai;10;13;23;8;7;15
294;16.06.2017;2017;06;11;Perjantai;20;26;46;11;10;21
294;16.06.2017;2017;06;12;Perjantai;19;17;36;8;5;13
294;16.06.2017;2017;06;13;Perjantai;25;26;51;5;6;11
294;16.06.2017;2017;06;14;Perjantai;29;32;61;5;9;14
294;16.06.2017;2017;06;15;Perjantai;33;20;53;8;10;18
294;16.06.2017;2017;06;16;Perjantai;29;27;56;8;10;18
294;16.06.2017;2017;06;17;Perjantai;28;24;52;12;6;18
294;16.06.2017;2017;06;18;Perjantai;20;26;46;9;4;13
294;16.06.2017;2017;06;19;Perjantai;25;17;42;9;8;17
294;16.06.2017;2017;06;20;Perjantai;26;13;39;9;11;20
294;16.06.2017;2017;06;21;Perjantai;6;9;15;5;4;9
294;16.06.2017;2017;06;22;Perjantai;16;6;22;0;2;2
294;16.06.2017;2017;06;23;Perjantai;1;2;3;2;1;3
294;17.06.2017;2017;06;00;Lauantai;0;0;0;0;0;0
294;17.06.2017;2017;06;01;Lauantai;2;1;3;2;0;2
294;17.06.2017;2017;06;02;Lauantai;1;2;3;0;1;1
294;17.06.2017;2017;06;03;Lauantai;2;1;3;0;0;0
294;17.06.2017;2017;06;04;Lauantai;2;0;2;1;0;1
294;17.06.2017;2017;06;05;Lauantai;0;0;0;0;0;0
294;17.06.2017;2017;06;06;Lauantai;1;0;1;0;0;0
294;17.06.2017;2017;06;07;Lauantai;5;1;6;0;0;0
294;17.06.2017;2017;06;08;Lauantai;9;11;20;8;4;12
294;17.06.2017;2017;06;09;Lauantai;24;10;34;4;5;9
294;17.06.2017;2017;06;10;Lauantai;20;16;36;10;7;17
294;17.06.2017;2017;06;11;Lauantai;28;36;64;9;16;25
294;17.06.2017;2017;06;12;Lauantai;16;30;46;3;6;9
294;17.06.2017;2017;06;13;Lauantai;45;25;70;7;4;11
294;17.06.2017;2017;06;14;Lauantai;24;18;42;13;7;20
294;17.06.2017;2017;06;15;Lauantai;33;20;53;6;9;15
294;17.06.2017;2017;06;16;Lauantai;25;18;43;8;0;8
294;17.06.2017;2017;06;17;Lauantai;14;25;39;10;11;21
294;17.06.2017;2017;06;18;Lauantai;24;19;43;3;5;8
294;17.06.2017;2017;06;19;Lauantai;25;17;42;9;3;12
294;17.06.2017;2017;06;20;Lauantai;18;5;23;7;5;12
294;17.06.2017;2017;06;21;Lauantai;9;6;15;3;1;4
294;17.06.2017;2017;06;22;Lauantai;0;3;3;0;1;1
294;17.06.2017;2017;06;23;Lauantai;3;0;3;1;1;2
294;18.06.2017;2017;06;00;Sunnuntai;2;0;2;0;1;1
294;18.06.2017;2017;06;01;Sunnuntai;0;3;3;0;2;2
294;18.06.2017;2017;06;02;Sunnuntai;0;0;0;1;2;3
294;18.06.2017;2017;06;03;Sunnuntai;0;0;0;0;0;0
294;18.06.2017;2017;06;04;Sunnuntai;0;2;2;0;0;0
294;18.06.2017;2017;06;05;Sunnuntai;1;0;1;0;0;0
294;18.06.2017;2017;06;06;Sunnuntai;0;0;0;0;0;0
294;18.06.2017;2017;06;07;Sunnuntai;0;0;0;0;0;0
294;18.06.2017;2017;06;08;Sunnuntai;1;0;1;2;1;3
294;18.06.2017;2017;06;09;Sunnuntai;0;2;2;0;2;2
294;18.06.2017;2017;06;10;Sunnuntai;0;2;2;2;3;5
294;18.06.2017;2017;06;11;Sunnuntai;2;3;5;3;3;6
294;18.06.2017;2017;06;12;Sunnuntai;5;3;8;2;5;7
294;18.06.2017;2017;06;13;Sunnuntai;7;8;15;5;2;7
294;18.06.2017;2017;06;14;Sunnuntai;6;10;16;8;4;12
294;18.06.2017;2017;06;15;Sunnuntai;13;12;25;9;4;13
294;18.06.2017;2017;06;16;Sunnuntai;17;9;26;8;5;13
294;18.06.2017;2017;06;17;Sunnuntai;6;28;34;3;2;5
294;18.06.2017;2017;06;18;Sunnuntai;13;9;22;6;5;11
294;18.06.2017;2017;06;19;Sunnuntai;10;12;22;8;7;15
294;18.06.2017;2017;06;20;Sunnuntai;12;14;26;8;5;13
294;18.06.2017;2017;06;21;Sunnuntai;10;4;14;2;3;5
294;18.06.2017;2017;06;22;Sunnuntai;1;4;5;2;1;3
294;18.06.2017;2017;06;23;Sunnuntai;2;1;3;1;1;2
294;19.06.2017;2017;06;00;Maanantai;0;0;0;0;0;0
294;19.06.2017;2017;06;01;Maanantai;0;0;0;0;0;0
294;19.06.2017;2017;06;02;Maanantai;0;0;0;0;0;0
294;19.06.2017;2017;06;03;Maanantai;0;0;0;0;0;0
294;19.06.2017;2017;06;04;Maanantai;1;0;1;0;0;0
294;19.06.2017;2017;06;05;Maanantai;0;0;0;1;0;1
294;19.06.2017;2017;06;06;Maanantai;7;4;11;0;0;0
294;19.06.2017;2017;06;07;Maanantai;10;0;10;2;1;3
294;19.06.2017;2017;06;08;Maanantai;4;6;10;6;4;10
294;19.06.2017;2017;06;09;Maanantai;15;14;29;5;5;10
294;19.06.2017;2017;06;10;Maanantai;15;8;23;4;16;20
294;19.06.2017;2017;06;11;Maanantai;20;23;43;13;12;25
294;19.06.2017;2017;06;12;Maanantai;15;23;38;5;2;7
294;19.06.2017;2017;06;13;Maanantai;16;25;41;6;4;10
294;19.06.2017;2017;06;14;Maanantai;34;34;68;14;26;40
294;19.06.2017;2017;06;15;Maanantai;28;33;61;13;14;27
294;19.06.2017;2017;06;16;Maanantai;29;21;50;6;5;11
294;19.06.2017;2017;06;17;Maanantai;28;29;57;10;7;17
294;19.06.2017;2017;06;18;Maanantai;25;25;50;11;9;20
294;19.06.2017;2017;06;19;Maanantai;31;22;53;16;13;29
294;19.06.2017;2017;06;20;Maanantai;17;24;41;10;7;17
294;19.06.2017;2017;06;21;Maanantai;10;9;19;3;3;6
294;19.06.2017;2017;06;22;Maanantai;3;2;5;1;2;3
294;19.06.2017;2017;06;23;Maanantai;2;0;2;0;0;0
294;20.06.2017;2017;06;00;Tiistai;0;0;0;0;0;0
294;20.06.2017;2017;06;01;Tiistai;0;0;0;0;0;0
294;20.06.2017;2017;06;02;Tiistai;0;0;0;0;0;0
294;20.06.2017;2017;06;03;Tiistai;0;0;0;0;0;0
294;20.06.2017;2017;06;04;Tiistai;1;0;1;0;0;0
294;20.06.2017;2017;06;05;Tiistai;0;0;0;2;0;2
294;20.06.2017;2017;06;06;Tiistai;5;5;10;0;1;1
294;20.06.2017;2017;06;07;Tiistai;5;1;6;2;2;4
294;20.06.2017;2017;06;08;Tiistai;6;11;17;2;2;4
294;20.06.2017;2017;06;09;Tiistai;10;7;17;8;7;15
294;20.06.2017;2017;06;10;Tiistai;10;10;20;5;6;11
294;20.06.2017;2017;06;11;Tiistai;25;24;49;8;6;14
294;20.06.2017;2017;06;12;Tiistai;22;23;45;6;8;14
294;20.06.2017;2017;06;13;Tiistai;13;21;34;6;11;17
294;20.06.2017;2017;06;14;Tiistai;25;17;42;8;12;20
294;20.06.2017;2017;06;15;Tiistai;16;24;40;14;14;28
294;20.06.2017;2017;06;16;Tiistai;13;28;41;5;7;12
294;20.06.2017;2017;06;17;Tiistai;25;18;43;12;6;18
294;20.06.2017;2017;06;18;Tiistai;27;27;54;13;5;18
294;20.06.2017;2017;06;19;Tiistai;13;17;30;5;8;13
294;20.06.2017;2017;06;20;Tiistai;11;12;23;7;8;15
294;20.06.2017;2017;06;21;Tiistai;10;7;17;5;4;9
294;20.06.2017;2017;06;22;Tiistai;2;4;6;1;0;1
294;20.06.2017;2017;06;23;Tiistai;0;0;0;0;0;0
294;21.06.2017;2017;06;00;Keskiviikko;0;4;4;0;0;0
294;21.06.2017;2017;06;01;Keskiviikko;0;2;2;0;1;1
294;21.06.2017;2017;06;02;Keskiviikko;0;0;0;0;0;0
294;21.06.2017;2017;06;03;Keskiviikko;0;0;0;0;0;0
294;21.06.2017;2017;06;04;Keskiviikko;1;0;1;0;0;0
294;21.06.2017;2017;06;05;Keskiviikko;0;0;0;1;0;1
294;21.06.2017;2017;06;06;Keskiviikko;3;0;3;1;0;1
294;21.06.2017;2017;06;07;Keskiviikko;7;1;8;2;1;3
294;21.06.2017;2017;06;08;Keskiviikko;4;5;9;2;2;4
294;21.06.2017;2017;06;09;Keskiviikko;10;10;20;11;10;21
294;21.06.2017;2017;06;10;Keskiviikko;4;4;8;10;10;20
294;21.06.2017;2017;06;11;Keskiviikko;10;19;29;14;6;20
294;21.06.2017;2017;06;12;Keskiviikko;11;13;24;12;6;18
294;21.06.2017;2017;06;13;Keskiviikko;12;11;23;9;9;18
294;21.06.2017;2017;06;14;Keskiviikko;12;12;24;4;9;13
294;21.06.2017;2017;06;15;Keskiviikko;14;13;27;12;6;18
294;21.06.2017;2017;06;16;Keskiviikko;10;12;22;7;4;11
294;21.06.2017;2017;06;17;Keskiviikko;11;8;19;7;8;15
294;21.06.2017;2017;06;18;Keskiviikko;10;7;17;6;3;9
294;21.06.2017;2017;06;19;Keskiviikko;4;7;11;6;5;11
294;21.06.2017;2017;06;20;Keskiviikko;11;12;23;9;7;16
294;21.06.2017;2017;06;21;Keskiviikko;10;9;19;3;2;5
294;21.06.2017;2017;06;22;Keskiviikko;4;1;5;1;1;2
294;21.06.2017;2017;06;23;Keskiviikko;1;5;6;1;0;1
294;22.06.2017;2017;06;00;Torstai;0;0;0;0;0;0
294;22.06.2017;2017;06;01;Torstai;0;0;0;0;0;0
294;22.06.2017;2017;06;02;Torstai;0;0;0;0;0;0
294;22.06.2017;2017;06;03;Torstai;1;0;1;0;0;0
294;22.06.2017;2017;06;04;Torstai;0;0;0;0;0;0
294;22.06.2017;2017;06;05;Torstai;0;1;1;0;0;0
294;22.06.2017;2017;06;06;Torstai;3;0;3;1;1;2
294;22.06.2017;2017;06;07;Torstai;5;0;5;1;1;2
294;22.06.2017;2017;06;08;Torstai;5;11;16;1;3;4
294;22.06.2017;2017;06;09;Torstai;5;5;10;2;6;8
294;22.06.2017;2017;06;10;Torstai;12;4;16;4;5;9
294;22.06.2017;2017;06;11;Torstai;6;11;17;4;6;10
294;22.06.2017;2017;06;12;Torstai;23;17;40;9;7;16
294;22.06.2017;2017;06;13;Torstai;7;11;18;15;6;21
294;22.06.2017;2017;06;14;Torstai;9;15;24;7;6;13
294;22.06.2017;2017;06;15;Torstai;11;8;19;4;5;9
294;22.06.2017;2017;06;16;Torstai;13;10;23;2;5;7
294;22.06.2017;2017;06;17;Torstai;13;14;27;4;10;14
294;22.06.2017;2017;06;18;Torstai;12;9;21;6;1;7
294;22.06.2017;2017;06;19;Torstai;7;4;11;6;4;10
294;22.06.2017;2017;06;20;Torstai;0;1;1;7;3;10
294;22.06.2017;2017;06;21;Torstai;2;4;6;1;1;2
294;22.06.2017;2017;06;22;Torstai;3;1;4;1;0;1
294;22.06.2017;2017;06;23;Torstai;1;0;1;3;0;3
294;23.06.2017;2017;06;00;Perjantai;2;0;2;0;5;5
294;23.06.2017;2017;06;01;Perjantai;0;0;0;0;0;0
294;23.06.2017;2017;06;02;Perjantai;0;0;0;3;1;4
294;23.06.2017;2017;06;03;Perjantai;1;0;1;0;1;1
294;23.06.2017;2017;06;04;Perjantai;0;0;0;0;0;0
294;23.06.2017;2017;06;05;Perjantai;0;0;0;0;0;0
294;23.06.2017;2017;06;06;Perjantai;0;0;0;0;0;0
294;23.06.2017;2017;06;07;Perjantai;0;0;0;0;0;0
294;23.06.2017;2017;06;08;Perjantai;2;3;5;1;2;3
294;23.06.2017;2017;06;09;Perjantai;7;5;12;10;4;14
294;23.06.2017;2017;06;10;Perjantai;8;12;20;3;9;12
294;23.06.2017;2017;06;11;Perjantai;16;7;23;9;7;16
294;23.06.2017;2017;06;12;Perjantai;13;14;27;12;9;21
294;23.06.2017;2017;06;13;Perjantai;18;7;25;11;3;14
294;23.06.2017;2017;06;14;Perjantai;13;7;20;2;3;5
294;23.06.2017;2017;06;15;Perjantai;12;15;27;7;6;13
294;23.06.2017;2017;06;16;Perjantai;11;11;22;6;3;9
294;23.06.2017;2017;06;17;Perjantai;9;9;18;1;2;3
294;23.06.2017;2017;06;18;Perjantai;11;9;20;3;2;5
294;23.06.2017;2017;06;19;Perjantai;6;12;18;4;3;7
294;23.06.2017;2017;06;20;Perjantai;4;6;10;2;1;3
294;23.06.2017;2017;06;21;Perjantai;10;13;23;0;0;0
294;23.06.2017;2017;06;22;Perjantai;6;2;8;1;0;1
294;23.06.2017;2017;06;23;Perjantai;1;2;3;1;2;3
294;24.06.2017;2017;06;00;Lauantai;2;2;4;0;0;0
294;24.06.2017;2017;06;01;Lauantai;5;3;8;0;1;1
294;24.06.2017;2017;06;02;Lauantai;0;1;1;0;2;2
294;24.06.2017;2017;06;03;Lauantai;1;0;1;1;0;1
294;24.06.2017;2017;06;04;Lauantai;0;0;0;0;2;2
294;24.06.2017;2017;06;05;Lauantai;0;0;0;0;0;0
294;24.06.2017;2017;06;06;Lauantai;1;1;2;0;2;2
294;24.06.2017;2017;06;07;Lauantai;1;0;1;0;0;0
294;24.06.2017;2017;06;08;Lauantai;1;4;5;0;0;0
294;24.06.2017;2017;06;09;Lauantai;4;1;5;3;2;5
294;24.06.2017;2017;06;10;Lauantai;8;8;16;5;5;10
294;24.06.2017;2017;06;11;Lauantai;7;5;12;6;6;12
294;24.06.2017;2017;06;12;Lauantai;16;11;27;11;10;21
294;24.06.2017;2017;06;13;Lauantai;20;9;29;6;10;16
294;24.06.2017;2017;06;14;Lauantai;20;13;33;7;12;19
294;24.06.2017;2017;06;15;Lauantai;27;23;50;11;8;19
294;24.06.2017;2017;06;16;Lauantai;10;10;20;4;5;9
294;24.06.2017;2017;06;17;Lauantai;12;10;22;5;3;8
294;24.06.2017;2017;06;18;Lauantai;18;25;43;13;5;18
294;24.06.2017;2017;06;19;Lauantai;8;11;19;1;5;6
294;24.06.2017;2017;06;20;Lauantai;18;12;30;6;6;12
294;24.06.2017;2017;06;21;Lauantai;3;8;11;2;0;2
294;24.06.2017;2017;06;22;Lauantai;4;4;8;3;2;5
294;24.06.2017;2017;06;23;Lauantai;2;2;4;0;0;0
294;25.06.2017;2017;06;00;Sunnuntai;1;0;1;1;1;2
294;25.06.2017;2017;06;01;Sunnuntai;0;2;2;2;0;2
294;25.06.2017;2017;06;02;Sunnuntai;0;2;2;1;0;1
294;25.06.2017;2017;06;03;Sunnuntai;0;1;1;0;0;0
294;25.06.2017;2017;06;04;Sunnuntai;1;0;1;0;0;0
294;25.06.2017;2017;06;05;Sunnuntai;0;0;0;0;0;0
294;25.06.2017;2017;06;06;Sunnuntai;0;1;1;0;1;1
294;25.06.2017;2017;06;07;Sunnuntai;0;0;0;0;0;0
294;25.06.2017;2017;06;08;Sunnuntai;1;0;1;2;1;3
294;25.06.2017;2017;06;09;Sunnuntai;5;3;8;6;2;8
294;25.06.2017;2017;06;10;Sunnuntai;1;4;5;6;8;14
294;25.06.2017;2017;06;11;Sunnuntai;8;5;13;4;4;8
294;25.06.2017;2017;06;12;Sunnuntai;2;5;7;2;5;7
294;25.06.2017;2017;06;13;Sunnuntai;10;12;22;4;4;8
294;25.06.2017;2017;06;14;Sunnuntai;7;2;9;5;2;7
294;25.06.2017;2017;06;15;Sunnuntai;7;7;14;5;5;10
294;25.06.2017;2017;06;16;Sunnuntai;6;4;10;3;1;4
294;25.06.2017;2017;06;17;Sunnuntai;1;1;2;1;1;2
294;25.06.2017;2017;06;18;Sunnuntai;10;9;19;3;6;9
294;25.06.2017;2017;06;19;Sunnuntai;8;8;16;5;1;6
294;25.06.2017;2017;06;20;Sunnuntai;3;9;12;1;7;8
294;25.06.2017;2017;06;21;Sunnuntai;2;4;6;5;2;7
294;25.06.2017;2017;06;22;Sunnuntai;0;0;0;1;0;1
294;25.06.2017;2017;06;23;Sunnuntai;0;1;1;0;1;1
294;26.06.2017;2017;06;00;Maanantai;0;1;1;0;1;1
294;26.06.2017;2017;06;01;Maanantai;0;0;0;0;0;0
294;26.06.2017;2017;06;02;Maanantai;1;0;1;0;0;0
294;26.06.2017;2017;06;03;Maanantai;0;0;0;0;0;0
294;26.06.2017;2017;06;04;Maanantai;0;0;0;0;0;0
294;26.06.2017;2017;06;05;Maanantai;0;0;0;0;0;0
294;26.06.2017;2017;06;06;Maanantai;2;1;3;1;1;2
294;26.06.2017;2017;06;07;Maanantai;4;3;7;2;0;2
294;26.06.2017;2017;06;08;Maanantai;3;2;5;3;5;8
294;26.06.2017;2017;06;09;Maanantai;3;1;4;7;7;14
294;26.06.2017;2017;06;10;Maanantai;0;6;6;3;1;4
294;26.06.2017;2017;06;11;Maanantai;5;7;12;6;4;10
294;26.06.2017;2017;06;12;Maanantai;6;10;16;4;3;7
294;26.06.2017;2017;06;13;Maanantai;15;13;28;5;8;13
294;26.06.2017;2017;06;14;Maanantai;15;16;31;10;8;18
294;26.06.2017;2017;06;15;Maanantai;18;27;45;14;10;24
294;26.06.2017;2017;06;16;Maanantai;20;11;31;7;15;22
294;26.06.2017;2017;06;17;Maanantai;17;18;35;14;19;33
294;26.06.2017;2017;06;18;Maanantai;19;15;34;21;21;42
294;26.06.2017;2017;06;19;Maanantai;17;17;34;18;13;31
294;26.06.2017;2017;06;20;Maanantai;20;25;45;11;10;21
294;26.06.2017;2017;06;21;Maanantai;7;13;20;5;3;8
294;26.06.2017;2017;06;22;Maanantai;5;6;11;2;5;7
294;26.06.2017;2017;06;23;Maanantai;1;1;2;0;0;0
294;27.06.2017;2017;06;00;Tiistai;0;0;0;0;0;0
294;27.06.2017;2017;06;01;Tiistai;0;0;0;0;0;0
294;27.06.2017;2017;06;02;Tiistai;0;0;0;0;0;0
294;27.06.2017;2017;06;03;Tiistai;0;0;0;0;0;0
294;27.06.2017;2017;06;04;Tiistai;0;0;0;0;0;0
294;27.06.2017;2017;06;05;Tiistai;1;0;1;0;0;0
294;27.06.2017;2017;06;06;Tiistai;4;3;7;0;0;0
294;27.06.2017;2017;06;07;Tiistai;4;3;7;2;2;4
294;27.06.2017;2017;06;08;Tiistai;6;9;15;2;4;6
294;27.06.2017;2017;06;09;Tiistai;7;8;15;8;4;12
294;27.06.2017;2017;06;10;Tiistai;10;21;31;4;8;12
294;27.06.2017;2017;06;11;Tiistai;12;10;22;10;8;18
294;27.06.2017;2017;06;12;Tiistai;22;26;48;12;15;27
294;27.06.2017;2017;06;13;Tiistai;15;29;44;11;7;18
294;27.06.2017;2017;06;14;Tiistai;13;19;32;8;11;19
294;27.06.2017;2017;06;15;Tiistai;17;23;40;6;11;17
294;27.06.2017;2017;06;16;Tiistai;27;14;41;12;10;22
294;27.06.2017;2017;06;17;Tiistai;14;20;34;4;9;13
294;27.06.2017;2017;06;18;Tiistai;9;14;23;6;1;7
294;27.06.2017;2017;06;19;Tiistai;12;13;25;3;4;7
294;27.06.2017;2017;06;20;Tiistai;3;6;9;4;6;10
294;27.06.2017;2017;06;21;Tiistai;5;4;9;1;0;1
294;27.06.2017;2017;06;22;Tiistai;2;1;3;0;0;0
294;27.06.2017;2017;06;23;Tiistai;2;0;2;0;0;0
294;28.06.2017;2017;06;00;Keskiviikko;0;0;0;0;0;0
294;28.06.2017;2017;06;01;Keskiviikko;0;0;0;0;0;0
294;28.06.2017;2017;06;02;Keskiviikko;0;0;0;0;0;0
294;28.06.2017;2017;06;03;Keskiviikko;0;0;0;0;1;1
294;28.06.2017;2017;06;04;Keskiviikko;0;0;0;0;0;0
294;28.06.2017;2017;06;05;Keskiviikko;0;0;0;1;0;1
294;28.06.2017;2017;06;06;Keskiviikko;4;0;4;1;0;1
294;28.06.2017;2017;06;07;Keskiviikko;7;1;8;2;3;5
294;28.06.2017;2017;06;08;Keskiviikko;0;1;1;2;1;3
294;28.06.2017;2017;06;09;Keskiviikko;2;2;4;5;4;9
294;28.06.2017;2017;06;10;Keskiviikko;4;6;10;5;3;8
294;28.06.2017;2017;06;11;Keskiviikko;12;12;24;9;6;15
294;28.06.2017;2017;06;12;Keskiviikko;10;13;23;5;5;10
294;28.06.2017;2017;06;13;Keskiviikko;12;5;17;9;6;15
294;28.06.2017;2017;06;14;Keskiviikko;12;17;29;10;6;16
294;28.06.2017;2017;06;15;Keskiviikko;10;17;27;5;9;14
294;28.06.2017;2017;06;16;Keskiviikko;17;21;38;6;5;11
294;28.06.2017;2017;06;17;Keskiviikko;5;17;22;9;11;20
294;28.06.2017;2017;06;18;Keskiviikko;13;13;26;11;6;17
294;28.06.2017;2017;06;19;Keskiviikko;7;14;21;13;15;28
294;28.06.2017;2017;06;20;Keskiviikko;12;8;20;13;6;19
294;28.06.2017;2017;06;21;Keskiviikko;5;10;15;3;1;4
294;28.06.2017;2017;06;22;Keskiviikko;3;0;3;3;2;5
294;28.06.2017;2017;06;23;Keskiviikko;1;2;3;0;0;0
294;29.06.2017;2017;06;00;Torstai;0;0;0;0;2;2
294;29.06.2017;2017;06;01;Torstai;0;0;0;0;0;0
294;29.06.2017;2017;06;02;Torstai;0;0;0;0;0;0
294;29.06.2017;2017;06;03;Torstai;0;0;0;0;0;0
294;29.06.2017;2017;06;04;Torstai;0;0;0;0;0;0
294;29.06.2017;2017;06;05;Torstai;2;0;2;0;0;0
294;29.06.2017;2017;06;06;Torstai;5;2;7;0;1;1
294;29.06.2017;2017;06;07;Torstai;10;1;11;3;2;5
294;29.06.2017;2017;06;08;Torstai;2;7;9;2;6;8
294;29.06.2017;2017;06;09;Torstai;4;4;8;5;5;10
294;29.06.2017;2017;06;10;Torstai;10;16;26;5;8;13
294;29.06.2017;2017;06;11;Torstai;20;15;35;10;8;18
294;29.06.2017;2017;06;12;Torstai;22;28;50;14;7;21
294;29.06.2017;2017;06;13;Torstai;32;23;55;8;2;10
294;29.06.2017;2017;06;14;Torstai;24;28;52;4;6;10
294;29.06.2017;2017;06;15;Torstai;32;24;56;10;10;20
294;29.06.2017;2017;06;16;Torstai;30;28;58;7;13;20
294;29.06.2017;2017;06;17;Torstai;22;19;41;7;8;15
294;29.06.2017;2017;06;18;Torstai;25;23;48;6;10;16
294;29.06.2017;2017;06;19;Torstai;11;11;22;12;6;18
294;29.06.2017;2017;06;20;Torstai;10;15;25;10;11;21
294;29.06.2017;2017;06;21;Torstai;10;15;25;6;6;12
294;29.06.2017;2017;06;22;Torstai;2;3;5;3;1;4
294;29.06.2017;2017;06;23;Torstai;0;2;2;1;0;1
294;30.06.2017;2017;06;00;Perjantai;0;0;0;0;0;0
294;30.06.2017;2017;06;01;Perjantai;0;0;0;0;0;0
294;30.06.2017;2017;06;02;Perjantai;0;0;0;0;0;0
294;30.06.2017;2017;06;03;Perjantai;0;0;0;0;0;0
294;30.06.2017;2017;06;04;Perjantai;0;0;0;0;0;0
294;30.06.2017;2017;06;05;Perjantai;0;0;0;0;0;0
294;30.06.2017;2017;06;06;Perjantai;8;1;9;0;0;0
294;30.06.2017;2017;06;07;Perjantai;3;0;3;1;1;2
294;30.06.2017;2017;06;08;Perjantai;3;6;9;3;4;7
294;30.06.2017;2017;06;09;Perjantai;7;6;13;5;2;7
294;30.06.2017;2017;06;10;Perjantai;14;12;26;4;1;5
294;30.06.2017;2017;06;11;Perjantai;18;20;38;10;17;27
294;30.06.2017;2017;06;12;Perjantai;20;23;43;7;8;15
294;30.06.2017;2017;06;13;Perjantai;21;24;45;15;13;28
294;30.06.2017;2017;06;14;Perjantai;18;13;31;7;9;16
294;30.06.2017;2017;06;15;Perjantai;22;16;38;7;9;16
294;30.06.2017;2017;06;16;Perjantai;22;21;43;12;9;21
294;30.06.2017;2017;06;17;Perjantai;20;14;34;6;11;17
294;30.06.2017;2017;06;18;Perjantai;24;12;36;4;7;11
294;30.06.2017;2017;06;19;Perjantai;23;17;40;8;2;10
294;30.06.2017;2017;06;20;Perjantai;20;12;32;5;5;10
294;30.06.2017;2017;06;21;Perjantai;6;9;15;3;3;6
294;30.06.2017;2017;06;22;Perjantai;3;5;8;2;1;3
294;30.06.2017;2017;06;23;Perjantai;2;4;6;1;0;1
294;01.07.2017;2017;07;00;Lauantai;2;6;8;0;0;0
294;01.07.2017;2017;07;01;Lauantai;0;0;0;1;1;2
294;01.07.2017;2017;07;02;Lauantai;0;2;2;0;1;1
294;01.07.2017;2017;07;03;Lauantai;0;0;0;0;0;0
294;01.07.2017;2017;07;04;Lauantai;0;0;0;0;0;0
294;01.07.2017;2017;07;05;Lauantai;0;0;0;0;0;0
294;01.07.2017;2017;07;06;Lauantai;0;0;0;6;0;6
294;01.07.2017;2017;07;07;Lauantai;2;1;3;5;0;5
294;01.07.2017;2017;07;08;Lauantai;2;2;4;1;3;4
294;01.07.2017;2017;07;09;Lauantai;5;6;11;19;6;25
294;01.07.2017;2017;07;10;Lauantai;15;8;23;9;8;17
294;01.07.2017;2017;07;11;Lauantai;24;21;45;29;12;41
294;01.07.2017;2017;07;12;Lauantai;18;13;31;21;3;24
294;01.07.2017;2017;07;13;Lauantai;21;17;38;7;4;11
294;01.07.2017;2017;07;14;Lauantai;7;13;20;4;6;10
294;01.07.2017;2017;07;15;Lauantai;26;21;47;2;7;9
294;01.07.2017;2017;07;16;Lauantai;11;13;24;7;4;11
294;01.07.2017;2017;07;17;Lauantai;21;21;42;8;6;14
294;01.07.2017;2017;07;18;Lauantai;8;11;19;6;5;11
294;01.07.2017;2017;07;19;Lauantai;10;13;23;1;5;6
294;01.07.2017;2017;07;20;Lauantai;5;7;12;7;4;11
294;01.07.2017;2017;07;21;Lauantai;3;5;8;0;2;2
294;01.07.2017;2017;07;22;Lauantai;3;4;7;2;1;3
294;01.07.2017;2017;07;23;Lauantai;0;0;0;1;0;1
294;02.07.2017;2017;07;00;Sunnuntai;1;0;1;1;1;2
294;02.07.2017;2017;07;01;Sunnuntai;0;1;1;0;0;0
294;02.07.2017;2017;07;02;Sunnuntai;0;0;0;0;1;1
294;02.07.2017;2017;07;03;Sunnuntai;0;0;0;0;0;0
294;02.07.2017;2017;07;04;Sunnuntai;0;0;0;0;0;0
294;02.07.2017;2017;07;05;Sunnuntai;0;0;0;0;0;0
294;02.07.2017;2017;07;06;Sunnuntai;0;0;0;1;5;6
294;02.07.2017;2017;07;07;Sunnuntai;2;0;2;2;2;4
294;02.07.2017;2017;07;08;Sunnuntai;2;3;5;1;1;2
294;02.07.2017;2017;07;09;Sunnuntai;6;4;10;6;7;13
294;02.07.2017;2017;07;10;Sunnuntai;12;13;25;4;1;5
294;02.07.2017;2017;07;11;Sunnuntai;6;17;23;2;7;9
294;02.07.2017;2017;07;12;Sunnuntai;14;10;24;6;2;8
294;02.07.2017;2017;07;13;Sunnuntai;19;13;32;12;8;20
294;02.07.2017;2017;07;14;Sunnuntai;12;12;24;5;6;11
294;02.07.2017;2017;07;15;Sunnuntai;18;11;29;3;9;12
294;02.07.2017;2017;07;16;Sunnuntai;10;14;24;7;7;14
294;02.07.2017;2017;07;17;Sunnuntai;28;26;54;6;10;16
294;02.07.2017;2017;07;18;Sunnuntai;15;9;24;7;5;12
294;02.07.2017;2017;07;19;Sunnuntai;13;8;21;5;6;11
294;02.07.2017;2017;07;20;Sunnuntai;13;14;27;7;5;12
294;02.07.2017;2017;07;21;Sunnuntai;6;4;10;5;3;8
294;02.07.2017;2017;07;22;Sunnuntai;0;4;4;1;1;2
294;02.07.2017;2017;07;23;Sunnuntai;0;0;0;0;1;1
294;03.07.2017;2017;07;00;Maanantai;2;2;4;0;0;0
294;03.07.2017;2017;07;01;Maanantai;0;2;2;0;0;0
294;03.07.2017;2017;07;02;Maanantai;0;0;0;0;0;0
294;03.07.2017;2017;07;03;Maanantai;0;1;1;3;4;7
294;03.07.2017;2017;07;04;Maanantai;0;0;0;0;0;0
294;03.07.2017;2017;07;05;Maanantai;0;0;0;0;0;0
294;03.07.2017;2017;07;06;Maanantai;4;0;4;1;0;1
294;03.07.2017;2017;07;07;Maanantai;6;2;8;0;0;0
294;03.07.2017;2017;07;08;Maanantai;4;6;10;7;2;9
294;03.07.2017;2017;07;09;Maanantai;3;6;9;7;5;12
294;03.07.2017;2017;07;10;Maanantai;13;8;21;8;3;11
294;03.07.2017;2017;07;11;Maanantai;15;13;28;7;9;16
294;03.07.2017;2017;07;12;Maanantai;25;27;52;7;9;16
294;03.07.2017;2017;07;13;Maanantai;32;22;54;7;2;9
294;03.07.2017;2017;07;14;Maanantai;23;23;46;11;8;19
294;03.07.2017;2017;07;15;Maanantai;14;16;30;13;10;23
294;03.07.2017;2017;07;16;Maanantai;19;11;30;10;4;14
294;03.07.2017;2017;07;17;Maanantai;14;27;41;15;11;26
294;03.07.2017;2017;07;18;Maanantai;14;23;37;10;15;25
294;03.07.2017;2017;07;19;Maanantai;19;11;30;45;10;55
294;03.07.2017;2017;07;20;Maanantai;9;8;17;12;3;15
294;03.07.2017;2017;07;21;Maanantai;9;6;15;7;1;8
294;03.07.2017;2017;07;22;Maanantai;4;1;5;3;3;6
294;03.07.2017;2017;07;23;Maanantai;1;1;2;0;0;0
294;04.07.2017;2017;07;00;Tiistai;0;0;0;0;0;0
294;04.07.2017;2017;07;01;Tiistai;2;1;3;0;0;0
294;04.07.2017;2017;07;02;Tiistai;1;0;1;1;0;1
294;04.07.2017;2017;07;03;Tiistai;0;0;0;0;0;0
294;04.07.2017;2017;07;04;Tiistai;0;0;0;0;0;0
294;04.07.2017;2017;07;05;Tiistai;0;0;0;0;0;0
294;04.07.2017;2017;07;06;Tiistai;5;0;5;2;0;2
294;04.07.2017;2017;07;07;Tiistai;2;2;4;3;2;5
294;04.07.2017;2017;07;08;Tiistai;3;6;9;4;3;7
294;04.07.2017;2017;07;09;Tiistai;6;9;15;8;3;11
294;04.07.2017;2017;07;10;Tiistai;16;9;25;15;5;20
294;04.07.2017;2017;07;11;Tiistai;16;20;36;7;8;15
294;04.07.2017;2017;07;12;Tiistai;14;20;34;3;7;10
294;04.07.2017;2017;07;13;Tiistai;19;3;22;1;2;3
294;04.07.2017;2017;07;14;Tiistai;6;5;11;6;4;10
294;04.07.2017;2017;07;15;Tiistai;10;12;22;10;4;14
294;04.07.2017;2017;07;16;Tiistai;11;14;25;6;11;17
294;04.07.2017;2017;07;17;Tiistai;18;24;42;12;13;25
294;04.07.2017;2017;07;18;Tiistai;17;19;36;2;12;14
294;04.07.2017;2017;07;19;Tiistai;11;17;28;8;3;11
294;04.07.2017;2017;07;20;Tiistai;7;7;14;9;5;14
294;04.07.2017;2017;07;21;Tiistai;2;3;5;1;2;3
294;04.07.2017;2017;07;22;Tiistai;1;5;6;2;2;4
294;04.07.2017;2017;07;23;Tiistai;0;1;1;1;1;2
294;05.07.2017;2017;07;00;Keskiviikko;0;0;0;0;0;0
294;05.07.2017;2017;07;01;Keskiviikko;0;0;0;0;0;0
294;05.07.2017;2017;07;02;Keskiviikko;0;1;1;0;0;0
294;05.07.2017;2017;07;03;Keskiviikko;0;0;0;0;0;0
294;05.07.2017;2017;07;04;Keskiviikko;0;0;0;0;0;0
294;05.07.2017;2017;07;05;Keskiviikko;0;0;0;0;0;0
294;05.07.2017;2017;07;06;Keskiviikko;4;1;5;5;1;6
294;05.07.2017;2017;07;07;Keskiviikko;3;3;6;1;1;2
294;05.07.2017;2017;07;08;Keskiviikko;2;2;4;2;2;4
294;05.07.2017;2017;07;09;Keskiviikko;7;10;17;5;3;8
294;05.07.2017;2017;07;10;Keskiviikko;8;11;19;6;3;9
294;05.07.2017;2017;07;11;Keskiviikko;14;16;30;8;7;15
294;05.07.2017;2017;07;12;Keskiviikko;16;9;25;9;13;22
294;05.07.2017;2017;07;13;Keskiviikko;19;17;36;9;12;21
294;05.07.2017;2017;07;14;Keskiviikko;20;15;35;27;9;36
294;05.07.2017;2017;07;15;Keskiviikko;21;24;45;7;6;13
294;05.07.2017;2017;07;16;Keskiviikko;17;12;29;8;9;17
294;05.07.2017;2017;07;17;Keskiviikko;11;12;23;6;9;15
294;05.07.2017;2017;07;18;Keskiviikko;10;8;18;9;7;16
294;05.07.2017;2017;07;19;Keskiviikko;3;11;14;15;2;17
294;05.07.2017;2017;07;20;Keskiviikko;11;10;21;4;9;13
294;05.07.2017;2017;07;21;Keskiviikko;12;8;20;8;2;10
294;05.07.2017;2017;07;22;Keskiviikko;3;3;6;0;0;0
294;05.07.2017;2017;07;23;Keskiviikko;0;1;1;0;0;0
294;06.07.2017;2017;07;00;Torstai;0;0;0;2;0;2
294;06.07.2017;2017;07;01;Torstai;1;0;1;0;0;0
294;06.07.2017;2017;07;02;Torstai;0;0;0;0;1;1
294;06.07.2017;2017;07;03;Torstai;0;0;0;0;0;0
294;06.07.2017;2017;07;04;Torstai;0;0;0;1;0;1
294;06.07.2017;2017;07;05;Torstai;0;1;1;0;0;0
294;06.07.2017;2017;07;06;Torstai;4;2;6;1;0;1
294;06.07.2017;2017;07;07;Torstai;1;3;4;2;0;2
294;06.07.2017;2017;07;08;Torstai;4;4;8;2;5;7
294;06.07.2017;2017;07;09;Torstai;2;3;5;0;1;1
294;06.07.2017;2017;07;10;Torstai;0;3;3;0;4;4
294;06.07.2017;2017;07;11;Torstai;2;10;12;6;7;13
294;06.07.2017;2017;07;12;Torstai;16;12;28;13;8;21
294;06.07.2017;2017;07;13;Torstai;14;13;27;8;3;11
294;06.07.2017;2017;07;14;Torstai;10;23;33;16;4;20
294;06.07.2017;2017;07;15;Torstai;14;7;21;4;10;14
294;06.07.2017;2017;07;16;Torstai;19;17;36;8;12;20
294;06.07.2017;2017;07;17;Torstai;16;20;36;6;13;19
294;06.07.2017;2017;07;18;Torstai;12;18;30;7;6;13
294;06.07.2017;2017;07;19;Torstai;10;10;20;9;8;17
294;06.07.2017;2017;07;20;Torstai;2;2;4;8;9;17
294;06.07.2017;2017;07;21;Torstai;5;5;10;7;4;11
294;06.07.2017;2017;07;22;Torstai;6;6;12;2;2;4
294;06.07.2017;2017;07;23;Torstai;5;0;5;0;1;1
294;07.07.2017;2017;07;00;Perjantai;1;0;1;0;0;0
294;07.07.2017;2017;07;01;Perjantai;0;0;0;1;0;1
294;07.07.2017;2017;07;02;Perjantai;0;0;0;0;0;0
294;07.07.2017;2017;07;03;Perjantai;0;0;0;1;1;2
294;07.07.2017;2017;07;04;Perjantai;0;0;0;1;0;1
294;07.07.2017;2017;07;05;Perjantai;0;0;0;1;0;1
294;07.07.2017;2017;07;06;Perjantai;2;3;5;2;0;2
294;07.07.2017;2017;07;07;Perjantai;6;2;8;3;1;4
294;07.07.2017;2017;07;08;Perjantai;4;6;10;4;5;9
294;07.07.2017;2017;07;09;Perjantai;6;2;8;13;8;21
294;07.07.2017;2017;07;10;Perjantai;10;14;24;29;18;47
294;07.07.2017;2017;07;11;Perjantai;13;11;24;35;6;41
294;07.07.2017;2017;07;12;Perjantai;13;21;34;24;12;36
294;07.07.2017;2017;07;13;Perjantai;21;13;34;26;11;37
294;07.07.2017;2017;07;14;Perjantai;16;19;35;20;6;26
294;07.07.2017;2017;07;15;Perjantai;29;24;53;60;17;77
294;07.07.2017;2017;07;16;Perjantai;19;27;46;31;13;44
294;07.07.2017;2017;07;17;Perjantai;21;17;38;11;10;21
294;07.07.2017;2017;07;18;Perjantai;11;13;24;9;8;17
294;07.07.2017;2017;07;19;Perjantai;11;17;28;11;10;21
294;07.07.2017;2017;07;20;Perjantai;7;12;19;3;7;10
294;07.07.2017;2017;07;21;Perjantai;8;4;12;3;2;5
294;07.07.2017;2017;07;22;Perjantai;1;5;6;2;0;2
294;07.07.2017;2017;07;23;Perjantai;4;2;6;1;0;1
294;08.07.2017;2017;07;00;Lauantai;0;1;1;2;0;2
294;08.07.2017;2017;07;01;Lauantai;0;0;0;0;0;0
294;08.07.2017;2017;07;02;Lauantai;0;0;0;0;0;0
294;08.07.2017;2017;07;03;Lauantai;0;0;0;0;0;0
294;08.07.2017;2017;07;04;Lauantai;0;0;0;0;0;0
294;08.07.2017;2017;07;05;Lauantai;0;0;0;0;0;0
294;08.07.2017;2017;07;06;Lauantai;0;0;0;1;0;1
294;08.07.2017;2017;07;07;Lauantai;1;1;2;1;1;2
294;08.07.2017;2017;07;08;Lauantai;3;3;6;3;8;11
294;08.07.2017;2017;07;09;Lauantai;10;5;15;7;4;11
294;08.07.2017;2017;07;10;Lauantai;7;11;18;4;6;10
294;08.07.2017;2017;07;11;Lauantai;22;16;38;16;7;23
294;08.07.2017;2017;07;12;Lauantai;12;23;35;16;9;25
294;08.07.2017;2017;07;13;Lauantai;26;15;41;7;7;14
294;08.07.2017;2017;07;14;Lauantai;26;24;50;10;8;18
294;08.07.2017;2017;07;15;Lauantai;18;17;35;13;2;15
294;08.07.2017;2017;07;16;Lauantai;28;21;49;12;9;21
294;08.07.2017;2017;07;17;Lauantai;15;22;37;10;9;19
294;08.07.2017;2017;07;18;Lauantai;19;17;36;8;11;19
294;08.07.2017;2017;07;19;Lauantai;14;13;27;3;5;8
294;08.07.2017;2017;07;20;Lauantai;12;9;21;7;11;18
294;08.07.2017;2017;07;21;Lauantai;9;8;17;3;5;8
294;08.07.2017;2017;07;22;Lauantai;3;3;6;0;1;1
294;08.07.2017;2017;07;23;Lauantai;4;0;4;1;0;1
294;09.07.2017;2017;07;00;Sunnuntai;1;0;1;0;0;0
294;09.07.2017;2017;07;01;Sunnuntai;2;2;4;1;0;1
294;09.07.2017;2017;07;02;Sunnuntai;0;1;1;2;4;6
294;09.07.2017;2017;07;03;Sunnuntai;0;0;0;0;0;0
294;09.07.2017;2017;07;04;Sunnuntai;1;1;2;0;0;0
294;09.07.2017;2017;07;05;Sunnuntai;0;1;1;0;0;0
294;09.07.2017;2017;07;06;Sunnuntai;1;0;1;1;0;1
294;09.07.2017;2017;07;07;Sunnuntai;0;0;0;1;0;1
294;09.07.2017;2017;07;08;Sunnuntai;2;1;3;1;2;3
294;09.07.2017;2017;07;09;Sunnuntai;7;9;16;9;2;11
294;09.07.2017;2017;07;10;Sunnuntai;4;12;16;11;6;17
294;09.07.2017;2017;07;11;Sunnuntai;11;11;22;4;3;7
294;09.07.2017;2017;07;12;Sunnuntai;13;6;19;6;4;10
294;09.07.2017;2017;07;13;Sunnuntai;19;11;30;6;7;13
294;09.07.2017;2017;07;14;Sunnuntai;18;13;31;2;0;2
294;09.07.2017;2017;07;15;Sunnuntai;13;17;30;8;8;16
294;09.07.2017;2017;07;16;Sunnuntai;42;10;52;4;7;11
294;09.07.2017;2017;07;17;Sunnuntai;16;21;37;6;11;17
294;09.07.2017;2017;07;18;Sunnuntai;19;22;41;7;5;12
294;09.07.2017;2017;07;19;Sunnuntai;13;12;25;5;5;10
294;09.07.2017;2017;07;20;Sunnuntai;25;16;41;9;13;22
294;09.07.2017;2017;07;21;Sunnuntai;15;9;24;6;1;7
294;09.07.2017;2017;07;22;Sunnuntai;10;5;15;8;2;10
294;09.07.2017;2017;07;23;Sunnuntai;2;2;4;1;1;2
294;10.07.2017;2017;07;00;Maanantai;1;1;2;2;0;2
294;10.07.2017;2017;07;01;Maanantai;0;1;1;0;1;1
294;10.07.2017;2017;07;02;Maanantai;1;0;1;0;0;0
294;10.07.2017;2017;07;03;Maanantai;0;0;0;0;0;0
294;10.07.2017;2017;07;04;Maanantai;0;0;0;0;0;0
294;10.07.2017;2017;07;05;Maanantai;0;0;0;0;0;0
294;10.07.2017;2017;07;06;Maanantai;2;1;3;7;1;8
294;10.07.2017;2017;07;07;Maanantai;4;3;7;48;2;50
294;10.07.2017;2017;07;08;Maanantai;5;7;12;6;4;10
294;10.07.2017;2017;07;09;Maanantai;11;10;21;9;1;10
294;10.07.2017;2017;07;10;Maanantai;17;19;36;8;9;17
294;10.07.2017;2017;07;11;Maanantai;22;19;41;11;2;13
294;10.07.2017;2017;07;12;Maanantai;20;22;42;7;11;18
294;10.07.2017;2017;07;13;Maanantai;26;19;45;10;7;17
294;10.07.2017;2017;07;14;Maanantai;13;24;37;7;6;13
294;10.07.2017;2017;07;15;Maanantai;18;15;33;8;2;10
294;10.07.2017;2017;07;16;Maanantai;29;20;49;13;4;17
294;10.07.2017;2017;07;17;Maanantai;21;37;58;10;6;16
294;10.07.2017;2017;07;18;Maanantai;26;20;46;12;6;18
294;10.07.2017;2017;07;19;Maanantai;21;16;37;8;9;17
294;10.07.2017;2017;07;20;Maanantai;15;13;28;7;7;14
294;10.07.2017;2017;07;21;Maanantai;5;13;18;6;5;11
294;10.07.2017;2017;07;22;Maanantai;3;4;7;2;1;3
294;10.07.2017;2017;07;23;Maanantai;1;1;2;1;0;1
294;11.07.2017;2017;07;00;Tiistai;3;2;5;0;0;0
294;11.07.2017;2017;07;01;Tiistai;0;0;0;0;0;0
294;11.07.2017;2017;07;02;Tiistai;0;0;0;0;0;0
294;11.07.2017;2017;07;03;Tiistai;0;0;0;0;0;0
294;11.07.2017;2017;07;04;Tiistai;0;0;0;0;0;0
294;11.07.2017;2017;07;05;Tiistai;0;0;0;0;1;1
294;11.07.2017;2017;07;06;Tiistai;3;3;6;13;4;17
294;11.07.2017;2017;07;07;Tiistai;3;3;6;10;10;20
294;11.07.2017;2017;07;08;Tiistai;6;8;14;10;4;14
294;11.07.2017;2017;07;09;Tiistai;16;14;30;8;13;21
294;11.07.2017;2017;07;10;Tiistai;19;12;31;10;6;16
294;11.07.2017;2017;07;11;Tiistai;14;23;37;12;13;25
294;11.07.2017;2017;07;12;Tiistai;17;16;33;10;17;27
294;11.07.2017;2017;07;13;Tiistai;18;20;38;13;12;25
294;11.07.2017;2017;07;14;Tiistai;23;12;35;10;10;20
294;11.07.2017;2017;07;15;Tiistai;24;20;44;10;9;19
294;11.07.2017;2017;07;16;Tiistai;21;24;45;8;6;14
294;11.07.2017;2017;07;17;Tiistai;30;30;60;13;13;26
294;11.07.2017;2017;07;18;Tiistai;23;33;56;8;7;15
294;11.07.2017;2017;07;19;Tiistai;16;12;28;7;11;18
294;11.07.2017;2017;07;20;Tiistai;9;15;24;6;6;12
294;11.07.2017;2017;07;21;Tiistai;9;6;15;5;4;9
294;11.07.2017;2017;07;22;Tiistai;4;5;9;1;1;2
294;11.07.2017;2017;07;23;Tiistai;3;0;3;0;0;0
294;12.07.2017;2017;07;00;Keskiviikko;1;0;1;0;0;0
294;12.07.2017;2017;07;01;Keskiviikko;0;2;2;0;1;1
294;12.07.2017;2017;07;02;Keskiviikko;0;0;0;0;0;0
294;12.07.2017;2017;07;03;Keskiviikko;0;1;1;0;0;0
294;12.07.2017;2017;07;04;Keskiviikko;1;0;1;0;0;0
294;12.07.2017;2017;07;05;Keskiviikko;0;0;0;1;0;1
294;12.07.2017;2017;07;06;Keskiviikko;1;2;3;1;1;2
294;12.07.2017;2017;07;07;Keskiviikko;0;0;0;1;5;6
294;12.07.2017;2017;07;08;Keskiviikko;4;1;5;2;0;2
294;12.07.2017;2017;07;09;Keskiviikko;3;2;5;5;3;8
294;12.07.2017;2017;07;10;Keskiviikko;1;7;8;3;8;11
294;12.07.2017;2017;07;11;Keskiviikko;11;15;26;2;5;7
294;12.07.2017;2017;07;12;Keskiviikko;9;8;17;4;5;9
294;12.07.2017;2017;07;13;Keskiviikko;8;12;20;7;8;15
294;12.07.2017;2017;07;14;Keskiviikko;20;20;40;11;8;19
294;12.07.2017;2017;07;15;Keskiviikko;24;11;35;11;11;22
294;12.07.2017;2017;07;16;Keskiviikko;14;7;21;4;2;6
294;12.07.2017;2017;07;17;Keskiviikko;5;1;6;3;2;5
294;12.07.2017;2017;07;18;Keskiviikko;5;3;8;7;7;14
294;12.07.2017;2017;07;19;Keskiviikko;3;7;10;7;3;10
294;12.07.2017;2017;07;20;Keskiviikko;3;5;8;3;0;3
294;12.07.2017;2017;07;21;Keskiviikko;1;1;2;2;2;4
294;12.07.2017;2017;07;22;Keskiviikko;0;1;1;1;1;2
294;12.07.2017;2017;07;23;Keskiviikko;1;0;1;1;0;1
294;13.07.2017;2017;07;00;Torstai;1;0;1;0;0;0
294;13.07.2017;2017;07;01;Torstai;0;0;0;0;0;0
294;13.07.2017;2017;07;02;Torstai;0;0;0;0;0;0
294;13.07.2017;2017;07;03;Torstai;0;0;0;0;0;0
294;13.07.2017;2017;07;04;Torstai;0;0;0;0;0;0
294;13.07.2017;2017;07;05;Torstai;1;0;1;0;0;0
294;13.07.2017;2017;07;06;Torstai;1;2;3;1;0;1
294;13.07.2017;2017;07;07;Torstai;0;2;2;1;2;3
294;13.07.2017;2017;07;08;Torstai;2;0;2;3;1;4
294;13.07.2017;2017;07;09;Torstai;3;5;8;4;5;9
294;13.07.2017;2017;07;10;Torstai;13;13;26;8;9;17
294;13.07.2017;2017;07;11;Torstai;14;8;22;6;11;17
294;13.07.2017;2017;07;12;Torstai;10;11;21;6;7;13
294;13.07.2017;2017;07;13;Torstai;20;18;38;14;13;27
294;13.07.2017;2017;07;14;Torstai;21;26;47;8;5;13
294;13.07.2017;2017;07;15;Torstai;40;35;75;20;20;40
294;13.07.2017;2017;07;16;Torstai;36;30;66;6;11;17
294;13.07.2017;2017;07;17;Torstai;20;11;31;3;3;6
294;13.07.2017;2017;07;18;Torstai;6;8;14;3;5;8
294;13.07.2017;2017;07;19;Torstai;5;10;15;6;4;10
294;13.07.2017;2017;07;20;Torstai;7;4;11;6;2;8
294;13.07.2017;2017;07;21;Torstai;10;6;16;4;1;5
294;13.07.2017;2017;07;22;Torstai;1;0;1;0;2;2
294;13.07.2017;2017;07;23;Torstai;3;0;3;1;0;1
294;14.07.2017;2017;07;00;Perjantai;0;0;0;0;0;0
294;14.07.2017;2017;07;01;Perjantai;0;0;0;0;0;0
294;14.07.2017;2017;07;02;Perjantai;0;0;0;0;0;0
294;14.07.2017;2017;07;03;Perjantai;0;0;0;0;0;0
294;14.07.2017;2017;07;04;Perjantai;0;0;0;0;0;0
294;14.07.2017;2017;07;05;Perjantai;0;0;0;0;0;0
294;14.07.2017;2017;07;06;Perjantai;4;1;5;2;0;2
294;14.07.2017;2017;07;07;Perjantai;2;0;2;4;3;7
294;14.07.2017;2017;07;08;Perjantai;1;6;7;0;0;0
294;14.07.2017;2017;07;09;Perjantai;5;5;10;1;4;5
294;14.07.2017;2017;07;10;Perjantai;1;0;1;2;1;3
294;14.07.2017;2017;07;11;Perjantai;2;3;5;0;0;0
294;14.07.2017;2017;07;12;Perjantai;2;3;5;2;1;3
294;14.07.2017;2017;07;13;Perjantai;6;6;12;1;2;3
294;14.07.2017;2017;07;14;Perjantai;14;9;23;6;10;16
294;14.07.2017;2017;07;15;Perjantai;8;19;27;4;2;6
294;14.07.2017;2017;07;16;Perjantai;22;19;41;5;4;9
294;14.07.2017;2017;07;17;Perjantai;6;9;15;10;9;19
294;14.07.2017;2017;07;18;Perjantai;13;10;23;4;16;20
294;14.07.2017;2017;07;19;Perjantai;11;12;23;10;10;20
294;14.07.2017;2017;07;20;Perjantai;22;21;43;9;9;18
294;14.07.2017;2017;07;21;Perjantai;13;7;20;3;1;4
294;14.07.2017;2017;07;22;Perjantai;5;4;9;1;1;2
294;14.07.2017;2017;07;23;Perjantai;0;0;0;0;2;2
294;15.07.2017;2017;07;00;Lauantai;0;0;0;1;0;1
294;15.07.2017;2017;07;01;Lauantai;1;0;1;0;1;1
294;15.07.2017;2017;07;02;Lauantai;0;1;1;0;0;0
294;15.07.2017;2017;07;03;Lauantai;0;0;0;0;0;0
294;15.07.2017;2017;07;04;Lauantai;2;0;2;0;0;0
294;15.07.2017;2017;07;05;Lauantai;0;0;0;0;0;0
294;15.07.2017;2017;07;06;Lauantai;0;1;1;1;1;2
294;15.07.2017;2017;07;07;Lauantai;2;0;2;3;1;4
294;15.07.2017;2017;07;08;Lauantai;1;1;2;4;3;7
294;15.07.2017;2017;07;09;Lauantai;5;7;12;4;5;9
294;15.07.2017;2017;07;10;Lauantai;11;6;17;8;6;14
294;15.07.2017;2017;07;11;Lauantai;14;13;27;5;4;9
294;15.07.2017;2017;07;12;Lauantai;15;15;30;9;8;17
294;15.07.2017;2017;07;13;Lauantai;18;26;44;7;8;15
294;15.07.2017;2017;07;14;Lauantai;20;19;39;13;7;20
294;15.07.2017;2017;07;15;Lauantai;22;13;35;14;4;18
294;15.07.2017;2017;07;16;Lauantai;13;17;30;5;11;16
294;15.07.2017;2017;07;17;Lauantai;15;15;30;11;16;27
294;15.07.2017;2017;07;18;Lauantai;14;15;29;4;4;8
294;15.07.2017;2017;07;19;Lauantai;20;14;34;8;7;15
294;15.07.2017;2017;07;20;Lauantai;6;10;16;6;3;9
294;15.07.2017;2017;07;21;Lauantai;19;6;25;2;3;5
294;15.07.2017;2017;07;22;Lauantai;9;4;13;1;2;3
294;15.07.2017;2017;07;23;Lauantai;4;3;7;1;1;2
294;16.07.2017;2017;07;00;Sunnuntai;1;0;1;1;1;2
294;16.07.2017;2017;07;01;Sunnuntai;2;1;3;0;0;0
294;16.07.2017;2017;07;02;Sunnuntai;0;0;0;0;0;0
294;16.07.2017;2017;07;03;Sunnuntai;0;0;0;0;0;0
294;16.07.2017;2017;07;04;Sunnuntai;0;0;0;0;0;0
294;16.07.2017;2017;07;05;Sunnuntai;1;1;2;0;1;1
294;16.07.2017;2017;07;06;Sunnuntai;1;1;2;0;0;0
294;16.07.2017;2017;07;07;Sunnuntai;2;0;2;1;0;1
294;16.07.2017;2017;07;08;Sunnuntai;1;2;3;4;1;5
294;16.07.2017;2017;07;09;Sunnuntai;6;6;12;6;5;11
294;16.07.2017;2017;07;10;Sunnuntai;7;7;14;1;2;3
294;16.07.2017;2017;07;11;Sunnuntai;23;15;38;6;3;9
294;16.07.2017;2017;07;12;Sunnuntai;8;11;19;4;7;11
294;16.07.2017;2017;07;13;Sunnuntai;25;22;47;8;2;10
294;16.07.2017;2017;07;14;Sunnuntai;21;20;41;3;4;7
294;16.07.2017;2017;07;15;Sunnuntai;29;16;45;5;0;5
294;16.07.2017;2017;07;16;Sunnuntai;19;24;43;2;5;7
294;16.07.2017;2017;07;17;Sunnuntai;13;20;33;3;6;9
294;16.07.2017;2017;07;18;Sunnuntai;19;16;35;6;1;7
294;16.07.2017;2017;07;19;Sunnuntai;18;12;30;11;3;14
294;16.07.2017;2017;07;20;Sunnuntai;7;18;25;9;7;16
294;16.07.2017;2017;07;21;Sunnuntai;7;4;11;2;4;6
294;16.07.2017;2017;07;22;Sunnuntai;2;2;4;1;0;1
294;16.07.2017;2017;07;23;Sunnuntai;3;0;3;1;1;2
294;17.07.2017;2017;07;00;Maanantai;0;0;0;0;0;0
294;17.07.2017;2017;07;01;Maanantai;0;0;0;0;0;0
294;17.07.2017;2017;07;02;Maanantai;0;0;0;0;0;0
294;17.07.2017;2017;07;03;Maanantai;0;0;0;0;0;0
294;17.07.2017;2017;07;04;Maanantai;2;1;3;1;1;2
294;17.07.2017;2017;07;05;Maanantai;1;0;1;0;0;0
294;17.07.2017;2017;07;06;Maanantai;3;0;3;1;1;2
294;17.07.2017;2017;07;07;Maanantai;4;0;4;3;0;3
294;17.07.2017;2017;07;08;Maanantai;3;9;12;4;3;7
294;17.07.2017;2017;07;09;Maanantai;10;9;19;4;4;8
294;17.07.2017;2017;07;10;Maanantai;12;13;25;11;7;18
294;17.07.2017;2017;07;11;Maanantai;18;13;31;13;9;22
294;17.07.2017;2017;07;12;Maanantai;18;19;37;4;5;9
294;17.07.2017;2017;07;13;Maanantai;21;21;42;11;7;18
294;17.07.2017;2017;07;14;Maanantai;30;23;53;12;13;25
294;17.07.2017;2017;07;15;Maanantai;23;15;38;8;12;20
294;17.07.2017;2017;07;16;Maanantai;20;22;42;5;4;9
294;17.07.2017;2017;07;17;Maanantai;21;16;37;7;14;21
294;17.07.2017;2017;07;18;Maanantai;18;12;30;5;5;10
294;17.07.2017;2017;07;19;Maanantai;19;3;22;6;7;13
294;17.07.2017;2017;07;20;Maanantai;6;11;17;7;5;12
294;17.07.2017;2017;07;21;Maanantai;7;9;16;3;2;5
294;17.07.2017;2017;07;22;Maanantai;5;0;5;0;0;0
294;17.07.2017;2017;07;23;Maanantai;0;0;0;1;2;3
294;18.07.2017;2017;07;00;Tiistai;0;1;1;0;0;0
294;18.07.2017;2017;07;01;Tiistai;0;0;0;1;1;2
294;18.07.2017;2017;07;02;Tiistai;0;0;0;1;0;1
294;18.07.2017;2017;07;03;Tiistai;0;0;0;0;0;0
294;18.07.2017;2017;07;04;Tiistai;0;0;0;0;0;0
294;18.07.2017;2017;07;05;Tiistai;0;0;0;0;0;0
294;18.07.2017;2017;07;06;Tiistai;0;1;1;0;0;0
294;18.07.2017;2017;07;07;Tiistai;0;0;0;1;0;1
294;18.07.2017;2017;07;08;Tiistai;2;1;3;0;1;1
294;18.07.2017;2017;07;09;Tiistai;1;3;4;0;0;0
294;18.07.2017;2017;07;10;Tiistai;5;5;10;3;3;6
294;18.07.2017;2017;07;11;Tiistai;8;8;16;6;4;10
294;18.07.2017;2017;07;12;Tiistai;11;6;17;5;1;6
294;18.07.2017;2017;07;13;Tiistai;8;12;20;4;6;10
294;18.07.2017;2017;07;14;Tiistai;10;7;17;7;2;9
294;18.07.2017;2017;07;15;Tiistai;17;22;39;1;11;12
294;18.07.2017;2017;07;16;Tiistai;7;8;15;10;8;18
294;18.07.2017;2017;07;17;Tiistai;3;3;6;6;5;11
294;18.07.2017;2017;07;18;Tiistai;9;16;25;14;10;24
294;18.07.2017;2017;07;19;Tiistai;10;4;14;6;3;9
294;18.07.2017;2017;07;20;Tiistai;4;4;8;3;1;4
294;18.07.2017;2017;07;21;Tiistai;4;0;4;1;1;2
294;18.07.2017;2017;07;22;Tiistai;0;0;0;1;0;1
294;18.07.2017;2017;07;23;Tiistai;0;0;0;0;0;0
294;19.07.2017;2017;07;00;Keskiviikko;1;0;1;0;0;0
294;19.07.2017;2017;07;01;Keskiviikko;0;0;0;0;0;0
294;19.07.2017;2017;07;02;Keskiviikko;0;0;0;0;0;0
294;19.07.2017;2017;07;03;Keskiviikko;0;0;0;0;0;0
294;19.07.2017;2017;07;04;Keskiviikko;0;0;0;0;0;0
294;19.07.2017;2017;07;05;Keskiviikko;0;0;0;1;0;1
294;19.07.2017;2017;07;06;Keskiviikko;0;1;1;1;0;1
294;19.07.2017;2017;07;07;Keskiviikko;2;1;3;0;0;0
294;19.07.2017;2017;07;08;Keskiviikko;4;4;8;1;5;6
294;19.07.2017;2017;07;09;Keskiviikko;5;5;10;5;5;10
294;19.07.2017;2017;07;10;Keskiviikko;12;12;24;6;2;8
294;19.07.2017;2017;07;11;Keskiviikko;9;16;25;10;9;19
294;19.07.2017;2017;07;12;Keskiviikko;22;14;36;16;11;27
294;19.07.2017;2017;07;13;Keskiviikko;17;16;33;5;8;13
294;19.07.2017;2017;07;14;Keskiviikko;16;21;37;19;18;37
294;19.07.2017;2017;07;15;Keskiviikko;25;12;37;9;10;19
294;19.07.2017;2017;07;16;Keskiviikko;16;12;28;5;3;8
294;19.07.2017;2017;07;17;Keskiviikko;9;16;25;5;12;17
294;19.07.2017;2017;07;18;Keskiviikko;25;17;42;9;12;21
294;19.07.2017;2017;07;19;Keskiviikko;8;7;15;12;13;25
294;19.07.2017;2017;07;20;Keskiviikko;10;10;20;6;6;12
294;19.07.2017;2017;07;21;Keskiviikko;9;6;15;9;2;11
294;19.07.2017;2017;07;22;Keskiviikko;4;3;7;0;1;1
294;19.07.2017;2017;07;23;Keskiviikko;0;0;0;0;0;0
294;20.07.2017;2017;07;00;Torstai;0;0;0;0;0;0
294;20.07.2017;2017;07;01;Torstai;0;0;0;0;0;0
294;20.07.2017;2017;07;02;Torstai;0;0;0;0;0;0
294;20.07.2017;2017;07;03;Torstai;0;0;0;0;0;0
294;20.07.2017;2017;07;04;Torstai;1;0;1;0;0;0
294;20.07.2017;2017;07;05;Torstai;0;0;0;1;0;1
294;20.07.2017;2017;07;06;Torstai;0;1;1;2;0;2
294;20.07.2017;2017;07;07;Torstai;2;3;5;1;1;2
294;20.07.2017;2017;07;08;Torstai;7;6;13;1;2;3
294;20.07.2017;2017;07;09;Torstai;6;4;10;7;8;15
294;20.07.2017;2017;07;10;Torstai;5;6;11;14;11;25
294;20.07.2017;2017;07;11;Torstai;4;11;15;17;6;23
294;20.07.2017;2017;07;12;Torstai;16;18;34;6;11;17
294;20.07.2017;2017;07;13;Torstai;20;17;37;7;8;15
294;20.07.2017;2017;07;14;Torstai;18;19;37;9;11;20
294;20.07.2017;2017;07;15;Torstai;11;16;27;8;10;18
294;20.07.2017;2017;07;16;Torstai;22;15;37;9;8;17
294;20.07.2017;2017;07;17;Torstai;12;22;34;10;9;19
294;20.07.2017;2017;07;18;Torstai;19;24;43;10;9;19
294;20.07.2017;2017;07;19;Torstai;17;26;43;11;4;15
294;20.07.2017;2017;07;20;Torstai;7;10;17;9;3;12
294;20.07.2017;2017;07;21;Torstai;12;5;17;2;1;3
294;20.07.2017;2017;07;22;Torstai;6;3;9;4;4;8
294;20.07.2017;2017;07;23;Torstai;3;7;10;0;0;0
294;21.07.2017;2017;07;00;Perjantai;0;0;0;0;0;0
294;21.07.2017;2017;07;01;Perjantai;0;0;0;0;0;0
294;21.07.2017;2017;07;02;Perjantai;0;0;0;0;0;0
294;21.07.2017;2017;07;03;Perjantai;0;0;0;0;0;0
294;21.07.2017;2017;07;04;Perjantai;1;0;1;0;0;0
294;21.07.2017;2017;07;05;Perjantai;0;0;0;0;0;0
294;21.07.2017;2017;07;06;Perjantai;1;0;1;0;2;2
294;21.07.2017;2017;07;07;Perjantai;0;5;5;1;1;2
294;21.07.2017;2017;07;08;Perjantai;6;2;8;3;6;9
294;21.07.2017;2017;07;09;Perjantai;5;7;12;5;5;10
294;21.07.2017;2017;07;10;Perjantai;12;17;29;7;6;13
294;21.07.2017;2017;07;11;Perjantai;11;16;27;8;14;22
294;21.07.2017;2017;07;12;Perjantai;17;12;29;9;13;22
294;21.07.2017;2017;07;13;Perjantai;42;22;64;8;6;14
294;21.07.2017;2017;07;14;Perjantai;17;28;45;18;18;36
294;21.07.2017;2017;07;15;Perjantai;18;16;34;10;6;16
294;21.07.2017;2017;07;16;Perjantai;10;14;24;7;7;14
294;21.07.2017;2017;07;17;Perjantai;8;9;17;4;5;9
294;21.07.2017;2017;07;18;Perjantai;22;24;46;6;11;17
294;21.07.2017;2017;07;19;Perjantai;23;25;48;11;7;18
294;21.07.2017;2017;07;20;Perjantai;17;18;35;6;2;8
294;21.07.2017;2017;07;21;Perjantai;11;13;24;2;4;6
294;21.07.2017;2017;07;22;Perjantai;4;3;7;3;3;6
294;21.07.2017;2017;07;23;Perjantai;2;0;2;0;0;0
294;22.07.2017;2017;07;00;Lauantai;4;0;4;0;0;0
294;22.07.2017;2017;07;01;Lauantai;0;0;0;1;0;1
294;22.07.2017;2017;07;02;Lauantai;0;0;0;0;0;0
294;22.07.2017;2017;07;03;Lauantai;0;0;0;0;0;0
294;22.07.2017;2017;07;04;Lauantai;2;0;2;0;0;0
294;22.07.2017;2017;07;05;Lauantai;1;1;2;0;0;0
294;22.07.2017;2017;07;06;Lauantai;0;1;1;0;3;3
294;22.07.2017;2017;07;07;Lauantai;1;2;3;5;0;5
294;22.07.2017;2017;07;08;Lauantai;2;4;6;2;4;6
294;22.07.2017;2017;07;09;Lauantai;7;7;14;2;6;8
294;22.07.2017;2017;07;10;Lauantai;10;11;21;6;2;8
294;22.07.2017;2017;07;11;Lauantai;20;14;34;4;13;17
294;22.07.2017;2017;07;12;Lauantai;16;17;33;17;16;33
294;22.07.2017;2017;07;13;Lauantai;10;11;21;15;7;22
294;22.07.2017;2017;07;14;Lauantai;19;6;25;5;2;7
294;22.07.2017;2017;07;15;Lauantai;6;12;18;6;7;13
294;22.07.2017;2017;07;16;Lauantai;20;12;32;15;10;25
294;22.07.2017;2017;07;17;Lauantai;7;18;25;3;10;13
294;22.07.2017;2017;07;18;Lauantai;11;15;26;8;4;12
294;22.07.2017;2017;07;19;Lauantai;12;12;24;11;6;17
294;22.07.2017;2017;07;20;Lauantai;13;12;25;4;4;8
294;22.07.2017;2017;07;21;Lauantai;3;8;11;3;5;8
294;22.07.2017;2017;07;22;Lauantai;2;5;7;2;1;3
294;22.07.2017;2017;07;23;Lauantai;2;1;3;0;0;0
294;23.07.2017;2017;07;00;Sunnuntai;1;2;3;0;0;0
294;23.07.2017;2017;07;01;Sunnuntai;0;0;0;3;1;4
294;23.07.2017;2017;07;02;Sunnuntai;2;2;4;4;3;7
294;23.07.2017;2017;07;03;Sunnuntai;0;0;0;1;0;1
294;23.07.2017;2017;07;04;Sunnuntai;2;0;2;0;0;0
294;23.07.2017;2017;07;05;Sunnuntai;0;0;0;0;1;1
294;23.07.2017;2017;07;06;Sunnuntai;1;0;1;0;3;3
294;23.07.2017;2017;07;07;Sunnuntai;2;1;3;2;1;3
294;23.07.2017;2017;07;08;Sunnuntai;3;2;5;2;1;3
294;23.07.2017;2017;07;09;Sunnuntai;9;7;16;3;9;12
294;23.07.2017;2017;07;10;Sunnuntai;24;14;38;9;6;15
294;23.07.2017;2017;07;11;Sunnuntai;20;13;33;7;9;16
294;23.07.2017;2017;07;12;Sunnuntai;10;20;30;12;12;24
294;23.07.2017;2017;07;13;Sunnuntai;28;6;34;9;6;15
294;23.07.2017;2017;07;14;Sunnuntai;19;17;36;4;6;10
294;23.07.2017;2017;07;15;Sunnuntai;14;20;34;9;10;19
294;23.07.2017;2017;07;16;Sunnuntai;7;11;18;4;1;5
294;23.07.2017;2017;07;17;Sunnuntai;15;8;23;5;4;9
294;23.07.2017;2017;07;18;Sunnuntai;11;8;19;7;7;14
294;23.07.2017;2017;07;19;Sunnuntai;4;9;13;6;7;13
294;23.07.2017;2017;07;20;Sunnuntai;9;5;14;2;8;10
294;23.07.2017;2017;07;21;Sunnuntai;2;2;4;4;2;6
294;23.07.2017;2017;07;22;Sunnuntai;2;2;4;1;0;1
294;23.07.2017;2017;07;23;Sunnuntai;0;0;0;1;0;1
294;24.07.2017;2017;07;00;Maanantai;0;0;0;1;0;1
294;24.07.2017;2017;07;01;Maanantai;1;0;1;0;0;0
294;24.07.2017;2017;07;02;Maanantai;0;1;1;0;0;0
294;24.07.2017;2017;07;03;Maanantai;0;0;0;0;0;0
294;24.07.2017;2017;07;04;Maanantai;1;0;1;2;0;2
294;24.07.2017;2017;07;05;Maanantai;0;0;0;1;0;1
294;24.07.2017;2017;07;06;Maanantai;4;1;5;0;1;1
294;24.07.2017;2017;07;07;Maanantai;3;3;6;1;2;3
294;24.07.2017;2017;07;08;Maanantai;5;5;10;3;2;5
294;24.07.2017;2017;07;09;Maanantai;8;9;17;6;5;11
294;24.07.2017;2017;07;10;Maanantai;17;12;29;8;4;12
294;24.07.2017;2017;07;11;Maanantai;15;17;32;4;3;7
294;24.07.2017;2017;07;12;Maanantai;15;18;33;4;15;19
294;24.07.2017;2017;07;13;Maanantai;22;25;47;15;16;31
294;24.07.2017;2017;07;14;Maanantai;23;12;35;9;4;13
294;24.07.2017;2017;07;15;Maanantai;23;17;40;6;13;19
294;24.07.2017;2017;07;16;Maanantai;12;17;29;8;4;12
294;24.07.2017;2017;07;17;Maanantai;18;25;43;12;10;22
294;24.07.2017;2017;07;18;Maanantai;44;22;66;15;14;29
294;24.07.2017;2017;07;19;Maanantai;14;10;24;15;8;23
294;24.07.2017;2017;07;20;Maanantai;10;16;26;2;4;6
294;24.07.2017;2017;07;21;Maanantai;7;6;13;7;3;10
294;24.07.2017;2017;07;22;Maanantai;5;2;7;0;1;1
294;24.07.2017;2017;07;23;Maanantai;0;1;1;0;0;0
294;25.07.2017;2017;07;00;Tiistai;0;0;0;0;0;0
294;25.07.2017;2017;07;01;Tiistai;1;1;2;0;0;0
294;25.07.2017;2017;07;02;Tiistai;0;0;0;0;0;0
294;25.07.2017;2017;07;03;Tiistai;0;0;0;0;0;0
294;25.07.2017;2017;07;04;Tiistai;1;0;1;0;0;0
294;25.07.2017;2017;07;05;Tiistai;0;0;0;1;0;1
294;25.07.2017;2017;07;06;Tiistai;3;1;4;1;0;1
294;25.07.2017;2017;07;07;Tiistai;4;2;6;1;3;4
294;25.07.2017;2017;07;08;Tiistai;4;10;14;2;2;4
294;25.07.2017;2017;07;09;Tiistai;9;9;18;5;5;10
294;25.07.2017;2017;07;10;Tiistai;17;12;29;8;13;21
294;25.07.2017;2017;07;11;Tiistai;25;23;48;9;7;16
294;25.07.2017;2017;07;12;Tiistai;14;19;33;10;9;19
294;25.07.2017;2017;07;13;Tiistai;14;22;36;7;12;19
294;25.07.2017;2017;07;14;Tiistai;31;22;53;7;5;12
294;25.07.2017;2017;07;15;Tiistai;20;18;38;6;11;17
294;25.07.2017;2017;07;16;Tiistai;18;25;43;10;5;15
294;25.07.2017;2017;07;17;Tiistai;33;21;54;8;9;17
294;25.07.2017;2017;07;18;Tiistai;22;25;47;9;13;22
294;25.07.2017;2017;07;19;Tiistai;26;21;47;10;6;16
294;25.07.2017;2017;07;20;Tiistai;13;10;23;5;6;11
294;25.07.2017;2017;07;21;Tiistai;11;6;17;6;1;7
294;25.07.2017;2017;07;22;Tiistai;1;7;8;5;0;5
294;25.07.2017;2017;07;23;Tiistai;0;1;1;0;0;0
294;26.07.2017;2017;07;00;Keskiviikko;1;0;1;0;0;0
294;26.07.2017;2017;07;01;Keskiviikko;0;0;0;0;0;0
294;26.07.2017;2017;07;02;Keskiviikko;0;0;0;0;0;0
294;26.07.2017;2017;07;03;Keskiviikko;0;0;0;0;0;0
294;26.07.2017;2017;07;04;Keskiviikko;1;0;1;0;0;0
294;26.07.2017;2017;07;05;Keskiviikko;0;0;0;0;0;0
294;26.07.2017;2017;07;06;Keskiviikko;1;1;2;2;1;3
294;26.07.2017;2017;07;07;Keskiviikko;2;2;4;0;0;0
294;26.07.2017;2017;07;08;Keskiviikko;4;2;6;2;1;3
294;26.07.2017;2017;07;09;Keskiviikko;13;14;27;5;7;12
294;26.07.2017;2017;07;10;Keskiviikko;17;7;24;6;5;11
294;26.07.2017;2017;07;11;Keskiviikko;13;19;32;6;8;14
294;26.07.2017;2017;07;12;Keskiviikko;11;15;26;7;8;15
294;26.07.2017;2017;07;13;Keskiviikko;25;16;41;9;6;15
294;26.07.2017;2017;07;14;Keskiviikko;29;34;63;9;8;17
294;26.07.2017;2017;07;15;Keskiviikko;25;34;59;15;9;24
294;26.07.2017;2017;07;16;Keskiviikko;24;27;51;14;13;27
294;26.07.2017;2017;07;17;Keskiviikko;17;17;34;6;8;14
294;26.07.2017;2017;07;18;Keskiviikko;19;25;44;11;10;21
294;26.07.2017;2017;07;19;Keskiviikko;22;21;43;5;13;18
294;26.07.2017;2017;07;20;Keskiviikko;11;12;23;13;8;21
294;26.07.2017;2017;07;21;Keskiviikko;15;11;26;1;2;3
294;26.07.2017;2017;07;22;Keskiviikko;1;5;6;1;3;4
294;26.07.2017;2017;07;23;Keskiviikko;7;1;8;2;2;4
294;27.07.2017;2017;07;00;Torstai;1;0;1;1;0;1
294;27.07.2017;2017;07;01;Torstai;0;0;0;2;0;2
294;27.07.2017;2017;07;02;Torstai;0;0;0;0;0;0
294;27.07.2017;2017;07;03;Torstai;1;0;1;0;0;0
294;27.07.2017;2017;07;04;Torstai;1;0;1;1;0;1
294;27.07.2017;2017;07;05;Torstai;1;0;1;1;0;1
294;27.07.2017;2017;07;06;Torstai;1;2;3;1;0;1
294;27.07.2017;2017;07;07;Torstai;3;1;4;2;0;2
294;27.07.2017;2017;07;08;Torstai;5;5;10;2;2;4
294;27.07.2017;2017;07;09;Torstai;12;10;22;1;7;8
294;27.07.2017;2017;07;10;Torstai;15;9;24;14;6;20
294;27.07.2017;2017;07;11;Torstai;18;12;30;9;7;16
294;27.07.2017;2017;07;12;Torstai;30;33;63;9;7;16
294;27.07.2017;2017;07;13;Torstai;27;33;60;5;8;13
294;27.07.2017;2017;07;14;Torstai;24;25;49;14;7;21
294;27.07.2017;2017;07;15;Torstai;21;19;40;11;11;22
294;27.07.2017;2017;07;16;Torstai;19;22;41;11;4;15
294;27.07.2017;2017;07;17;Torstai;27;26;53;10;10;20
294;27.07.2017;2017;07;18;Torstai;25;32;57;21;9;30
294;27.07.2017;2017;07;19;Torstai;11;21;32;13;18;31
294;27.07.2017;2017;07;20;Torstai;13;11;24;4;11;15
294;27.07.2017;2017;07;21;Torstai;14;4;18;5;4;9
294;27.07.2017;2017;07;22;Torstai;3;2;5;5;1;6
294;27.07.2017;2017;07;23;Torstai;2;3;5;3;1;4
294;28.07.2017;2017;07;00;Perjantai;0;0;0;0;0;0
294;28.07.2017;2017;07;01;Perjantai;0;0;0;0;0;0
294;28.07.2017;2017;07;02;Perjantai;1;0;1;0;0;0
294;28.07.2017;2017;07;03;Perjantai;0;0;0;0;0;0
294;28.07.2017;2017;07;04;Perjantai;0;0;0;1;0;1
294;28.07.2017;2017;07;05;Perjantai;0;0;0;1;0;1
294;28.07.2017;2017;07;06;Perjantai;2;0;2;2;1;3
294;28.07.2017;2017;07;07;Perjantai;7;3;10;1;0;1
294;28.07.2017;2017;07;08;Perjantai;7;5;12;5;2;7
294;28.07.2017;2017;07;09;Perjantai;13;10;23;7;5;12
294;28.07.2017;2017;07;10;Perjantai;19;10;29;4;9;13
294;28.07.2017;2017;07;11;Perjantai;15;31;46;8;11;19
294;28.07.2017;2017;07;12;Perjantai;21;10;31;19;11;30
294;28.07.2017;2017;07;13;Perjantai;25;16;41;10;5;15
294;28.07.2017;2017;07;14;Perjantai;16;13;29;4;8;12
294;28.07.2017;2017;07;15;Perjantai;21;23;44;7;5;12
294;28.07.2017;2017;07;16;Perjantai;19;25;44;10;9;19
294;28.07.2017;2017;07;17;Perjantai;24;16;40;9;3;12
294;28.07.2017;2017;07;18;Perjantai;24;17;41;12;6;18
294;28.07.2017;2017;07;19;Perjantai;21;21;42;8;7;15
294;28.07.2017;2017;07;20;Perjantai;15;6;21;3;5;8
294;28.07.2017;2017;07;21;Perjantai;14;8;22;5;4;9
294;28.07.2017;2017;07;22;Perjantai;6;2;8;0;0;0
294;28.07.2017;2017;07;23;Perjantai;1;3;4;0;1;1
294;29.07.2017;2017;07;00;Lauantai;2;0;2;0;1;1
294;29.07.2017;2017;07;01;Lauantai;0;0;0;0;0;0
294;29.07.2017;2017;07;02;Lauantai;0;0;0;0;0;0
294;29.07.2017;2017;07;03;Lauantai;0;0;0;0;0;0
294;29.07.2017;2017;07;04;Lauantai;1;0;1;0;0;0
294;29.07.2017;2017;07;05;Lauantai;1;0;1;0;2;2
294;29.07.2017;2017;07;06;Lauantai;0;0;0;0;0;0
294;29.07.2017;2017;07;07;Lauantai;1;0;1;1;0;1
294;29.07.2017;2017;07;08;Lauantai;6;5;11;2;8;10
294;29.07.2017;2017;07;09;Lauantai;7;4;11;3;4;7
294;29.07.2017;2017;07;10;Lauantai;6;5;11;5;2;7
294;29.07.2017;2017;07;11;Lauantai;14;6;20;2;7;9
294;29.07.2017;2017;07;12;Lauantai;11;7;18;6;5;11
294;29.07.2017;2017;07;13;Lauantai;7;13;20;5;2;7
294;29.07.2017;2017;07;14;Lauantai;13;8;21;5;4;9
294;29.07.2017;2017;07;15;Lauantai;6;6;12;9;1;10
294;29.07.2017;2017;07;16;Lauantai;13;7;20;2;1;3
294;29.07.2017;2017;07;17;Lauantai;8;13;21;5;5;10
294;29.07.2017;2017;07;18;Lauantai;8;12;20;5;5;10
294;29.07.2017;2017;07;19;Lauantai;6;7;13;5;4;9
294;29.07.2017;2017;07;20;Lauantai;7;6;13;5;4;9
294;29.07.2017;2017;07;21;Lauantai;9;3;12;1;2;3
294;29.07.2017;2017;07;22;Lauantai;8;2;10;0;3;3
294;29.07.2017;2017;07;23;Lauantai;0;0;0;0;1;1
294;30.07.2017;2017;07;00;Sunnuntai;0;0;0;1;0;1
294;30.07.2017;2017;07;01;Sunnuntai;0;0;0;0;0;0
294;30.07.2017;2017;07;02;Sunnuntai;0;0;0;1;0;1
294;30.07.2017;2017;07;03;Sunnuntai;0;0;0;0;0;0
294;30.07.2017;2017;07;04;Sunnuntai;1;0;1;0;0;0
294;30.07.2017;2017;07;05;Sunnuntai;1;0;1;0;0;0
294;30.07.2017;2017;07;06;Sunnuntai;0;0;0;0;0;0
294;30.07.2017;2017;07;07;Sunnuntai;2;0;2;0;0;0
294;30.07.2017;2017;07;08;Sunnuntai;3;8;11;3;3;6
294;30.07.2017;2017;07;09;Sunnuntai;7;8;15;4;2;6
294;30.07.2017;2017;07;10;Sunnuntai;9;3;12;7;3;10
294;30.07.2017;2017;07;11;Sunnuntai;20;20;40;4;6;10
294;30.07.2017;2017;07;12;Sunnuntai;9;15;24;3;7;10
294;30.07.2017;2017;07;13;Sunnuntai;14;12;26;5;1;6
294;30.07.2017;2017;07;14;Sunnuntai;26;20;46;7;3;10
294;30.07.2017;2017;07;15;Sunnuntai;17;23;40;4;5;9
294;30.07.2017;2017;07;16;Sunnuntai;27;18;45;3;3;6
294;30.07.2017;2017;07;17;Sunnuntai;21;15;36;8;12;20
294;30.07.2017;2017;07;18;Sunnuntai;14;12;26;4;9;13
294;30.07.2017;2017;07;19;Sunnuntai;10;13;23;7;4;11
294;30.07.2017;2017;07;20;Sunnuntai;10;4;14;5;12;17
294;30.07.2017;2017;07;21;Sunnuntai;1;4;5;2;2;4
294;30.07.2017;2017;07;22;Sunnuntai;4;2;6;7;5;12
294;30.07.2017;2017;07;23;Sunnuntai;1;0;1;0;0;0
294;31.07.2017;2017;07;00;Maanantai;0;0;0;0;0;0
294;31.07.2017;2017;07;01;Maanantai;0;0;0;0;1;1
294;31.07.2017;2017;07;02;Maanantai;0;0;0;0;0;0
294;31.07.2017;2017;07;03;Maanantai;0;0;0;0;0;0
294;31.07.2017;2017;07;04;Maanantai;1;0;1;0;0;0
294;31.07.2017;2017;07;05;Maanantai;0;1;1;1;2;3
294;31.07.2017;2017;07;06;Maanantai;4;2;6;2;0;2
294;31.07.2017;2017;07;07;Maanantai;3;1;4;4;6;10
294;31.07.2017;2017;07;08;Maanantai;3;5;8;1;4;5
294;31.07.2017;2017;07;09;Maanantai;6;6;12;3;3;6
294;31.07.2017;2017;07;10;Maanantai;10;12;22;5;7;12
294;31.07.2017;2017;07;11;Maanantai;7;14;21;9;6;15
294;31.07.2017;2017;07;12;Maanantai;19;22;41;11;8;19
294;31.07.2017;2017;07;13;Maanantai;31;23;54;13;10;23
294;31.07.2017;2017;07;14;Maanantai;27;16;43;9;4;13
294;31.07.2017;2017;07;15;Maanantai;29;19;48;13;9;22
294;31.07.2017;2017;07;16;Maanantai;37;30;67;12;15;27
294;31.07.2017;2017;07;17;Maanantai;26;28;54;6;6;12
294;31.07.2017;2017;07;18;Maanantai;28;24;52;13;11;24
294;31.07.2017;2017;07;19;Maanantai;23;21;44;9;15;24
294;31.07.2017;2017;07;20;Maanantai;17;20;37;4;5;9
294;31.07.2017;2017;07;21;Maanantai;4;4;8;1;2;3
294;31.07.2017;2017;07;22;Maanantai;5;7;12;1;4;5
294;31.07.2017;2017;07;23;Maanantai;0;0;0;0;0;0
294;01.08.2017;2017;08;00;Tiistai;0;0;0;0;0;0
294;01.08.2017;2017;08;01;Tiistai;2;0;2;0;0;0
294;01.08.2017;2017;08;02;Tiistai;1;0;1;0;0;0
294;01.08.2017;2017;08;03;Tiistai;0;0;0;0;0;0
294;01.08.2017;2017;08;04;Tiistai;0;0;0;0;0;0
294;01.08.2017;2017;08;05;Tiistai;0;0;0;0;0;0
294;01.08.2017;2017;08;06;Tiistai;1;2;3;2;3;5
294;01.08.2017;2017;08;07;Tiistai;4;2;6;2;0;2
294;01.08.2017;2017;08;08;Tiistai;5;4;9;1;4;5
294;01.08.2017;2017;08;09;Tiistai;3;6;9;6;5;11
294;01.08.2017;2017;08;10;Tiistai;15;9;24;9;9;18
294;01.08.2017;2017;08;11;Tiistai;14;15;29;8;11;19
294;01.08.2017;2017;08;12;Tiistai;24;24;48;9;6;15
294;01.08.2017;2017;08;13;Tiistai;19;18;37;9;6;15
294;01.08.2017;2017;08;14;Tiistai;28;25;53;9;8;17
294;01.08.2017;2017;08;15;Tiistai;27;29;56;10;5;15
294;01.08.2017;2017;08;16;Tiistai;19;13;32;5;5;10
294;01.08.2017;2017;08;17;Tiistai;29;18;47;6;9;15
294;01.08.2017;2017;08;18;Tiistai;29;20;49;13;10;23
294;01.08.2017;2017;08;19;Tiistai;32;18;50;8;11;19
294;01.08.2017;2017;08;20;Tiistai;9;9;18;7;8;15
294;01.08.2017;2017;08;21;Tiistai;19;12;31;4;5;9
294;01.08.2017;2017;08;22;Tiistai;2;1;3;1;3;4
294;01.08.2017;2017;08;23;Tiistai;1;1;2;0;0;0
294;02.08.2017;2017;08;00;Keskiviikko;0;0;0;0;0;0
294;02.08.2017;2017;08;01;Keskiviikko;0;4;4;0;0;0
294;02.08.2017;2017;08;02;Keskiviikko;3;0;3;1;0;1
294;02.08.2017;2017;08;03;Keskiviikko;0;0;0;0;0;0
294;02.08.2017;2017;08;04;Keskiviikko;1;0;1;0;0;0
294;02.08.2017;2017;08;05;Keskiviikko;0;1;1;0;0;0
294;02.08.2017;2017;08;06;Keskiviikko;3;2;5;0;4;4
294;02.08.2017;2017;08;07;Keskiviikko;6;3;9;0;1;1
294;02.08.2017;2017;08;08;Keskiviikko;2;2;4;10;6;16
294;02.08.2017;2017;08;09;Keskiviikko;4;5;9;2;10;12
294;02.08.2017;2017;08;10;Keskiviikko;13;14;27;13;14;27
294;02.08.2017;2017;08;11;Keskiviikko;8;19;27;13;6;19
294;02.08.2017;2017;08;12;Keskiviikko;32;26;58;10;12;22
294;02.08.2017;2017;08;13;Keskiviikko;30;15;45;14;15;29
294;02.08.2017;2017;08;14;Keskiviikko;30;26;56;11;12;23
294;02.08.2017;2017;08;15;Keskiviikko;17;28;45;9;6;15
294;02.08.2017;2017;08;16;Keskiviikko;29;22;51;9;9;18
294;02.08.2017;2017;08;17;Keskiviikko;27;33;60;6;18;24
294;02.08.2017;2017;08;18;Keskiviikko;30;25;55;14;21;35
294;02.08.2017;2017;08;19;Keskiviikko;23;20;43;12;11;23
294;02.08.2017;2017;08;20;Keskiviikko;20;6;26;11;3;14
294;02.08.2017;2017;08;21;Keskiviikko;13;16;29;3;7;10
294;02.08.2017;2017;08;22;Keskiviikko;2;5;7;2;1;3
294;02.08.2017;2017;08;23;Keskiviikko;2;3;5;1;1;2
294;03.08.2017;2017;08;00;Torstai;0;1;1;0;0;0
294;03.08.2017;2017;08;01;Torstai;1;0;1;1;0;1
294;03.08.2017;2017;08;02;Torstai;0;2;2;0;0;0
294;03.08.2017;2017;08;03;Torstai;0;0;0;0;0;0
294;03.08.2017;2017;08;04;Torstai;1;0;1;0;0;0
294;03.08.2017;2017;08;05;Torstai;1;0;1;0;1;1
294;03.08.2017;2017;08;06;Torstai;1;2;3;1;1;2
294;03.08.2017;2017;08;07;Torstai;1;4;5;4;1;5
294;03.08.2017;2017;08;08;Torstai;4;5;9;2;5;7
294;03.08.2017;2017;08;09;Torstai;13;9;22;10;3;13
294;03.08.2017;2017;08;10;Torstai;12;12;24;1;6;7
294;03.08.2017;2017;08;11;Torstai;13;11;24;8;16;24
294;03.08.2017;2017;08;12;Torstai;16;18;34;6;7;13
294;03.08.2017;2017;08;13;Torstai;28;9;37;8;3;11
294;03.08.2017;2017;08;14;Torstai;20;30;50;4;10;14
294;03.08.2017;2017;08;15;Torstai;21;18;39;6;7;13
294;03.08.2017;2017;08;16;Torstai;31;17;48;10;7;17
294;03.08.2017;2017;08;17;Torstai;32;27;59;4;7;11
294;03.08.2017;2017;08;18;Torstai;21;24;45;11;11;22
294;03.08.2017;2017;08;19;Torstai;23;14;37;13;4;17
294;03.08.2017;2017;08;20;Torstai;10;20;30;7;6;13
294;03.08.2017;2017;08;21;Torstai;11;7;18;8;3;11
294;03.08.2017;2017;08;22;Torstai;4;3;7;3;3;6
294;03.08.2017;2017;08;23;Torstai;1;2;3;1;4;5
294;04.08.2017;2017;08;00;Perjantai;0;0;0;0;0;0
294;04.08.2017;2017;08;01;Perjantai;0;0;0;0;0;0
294;04.08.2017;2017;08;02;Perjantai;0;0;0;0;0;0
294;04.08.2017;2017;08;03;Perjantai;0;0;0;0;0;0
294;04.08.2017;2017;08;04;Perjantai;1;0;1;0;0;0
294;04.08.2017;2017;08;05;Perjantai;1;0;1;0;1;1
294;04.08.2017;2017;08;06;Perjantai;1;3;4;1;1;2
294;04.08.2017;2017;08;07;Perjantai;1;9;10;2;3;5
294;04.08.2017;2017;08;08;Perjantai;5;5;10;4;4;8
294;04.08.2017;2017;08;09;Perjantai;10;11;21;2;6;8
294;04.08.2017;2017;08;10;Perjantai;23;16;39;8;13;21
294;04.08.2017;2017;08;11;Perjantai;26;25;51;5;5;10
294;04.08.2017;2017;08;12;Perjantai;34;11;45;13;11;24
294;04.08.2017;2017;08;13;Perjantai;42;46;88;27;7;34
294;04.08.2017;2017;08;14;Perjantai;61;38;99;47;20;67
294;04.08.2017;2017;08;15;Perjantai;49;63;112;41;40;81
294;04.08.2017;2017;08;16;Perjantai;53;31;84;28;30;58
294;04.08.2017;2017;08;17;Perjantai;53;46;99;60;31;91
294;04.08.2017;2017;08;18;Perjantai;52;37;89;30;37;67
294;04.08.2017;2017;08;19;Perjantai;44;49;93;43;44;87
294;04.08.2017;2017;08;20;Perjantai;41;42;83;26;33;59
294;04.08.2017;2017;08;21;Perjantai;33;27;60;35;23;58
294;04.08.2017;2017;08;22;Perjantai;37;22;59;27;19;46
294;04.08.2017;2017;08;23;Perjantai;9;15;24;9;6;15
294;05.08.2017;2017;08;00;Lauantai;3;17;20;1;7;8
294;05.08.2017;2017;08;01;Lauantai;2;1;3;4;12;16
294;05.08.2017;2017;08;02;Lauantai;1;0;1;0;1;1
294;05.08.2017;2017;08;03;Lauantai;0;1;1;0;4;4
294;05.08.2017;2017;08;04;Lauantai;1;2;3;0;1;1
294;05.08.2017;2017;08;05;Lauantai;1;0;1;0;0;0
294;05.08.2017;2017;08;06;Lauantai;0;0;0;0;2;2
294;05.08.2017;2017;08;07;Lauantai;4;1;5;2;5;7
294;05.08.2017;2017;08;08;Lauantai;3;3;6;3;5;8
294;05.08.2017;2017;08;09;Lauantai;16;9;25;10;2;12
294;05.08.2017;2017;08;10;Lauantai;17;10;27;31;12;43
294;05.08.2017;2017;08;11;Lauantai;29;16;45;73;26;99
294;05.08.2017;2017;08;12;Lauantai;51;36;87;82;62;144
294;05.08.2017;2017;08;13;Lauantai;40;30;70;78;75;153
294;05.08.2017;2017;08;14;Lauantai;54;50;104;74;82;156
294;05.08.2017;2017;08;15;Lauantai;36;64;100;40;53;93
294;05.08.2017;2017;08;16;Lauantai;30;35;65;34;27;61
294;05.08.2017;2017;08;17;Lauantai;41;42;83;27;22;49
294;05.08.2017;2017;08;18;Lauantai;27;34;61;18;21;39
294;05.08.2017;2017;08;19;Lauantai;28;41;69;19;24;43
294;05.08.2017;2017;08;20;Lauantai;24;19;43;8;11;19
294;05.08.2017;2017;08;21;Lauantai;26;21;47;16;10;26
294;05.08.2017;2017;08;22;Lauantai;12;3;15;15;8;23
294;05.08.2017;2017;08;23;Lauantai;8;7;15;9;1;10
294;06.08.2017;2017;08;00;Sunnuntai;2;0;2;0;0;0
294;06.08.2017;2017;08;01;Sunnuntai;3;0;3;0;0;0
294;06.08.2017;2017;08;02;Sunnuntai;2;0;2;0;2;2
294;06.08.2017;2017;08;03;Sunnuntai;3;2;5;0;3;3
294;06.08.2017;2017;08;04;Sunnuntai;1;0;1;0;0;0
294;06.08.2017;2017;08;05;Sunnuntai;0;0;0;0;0;0
294;06.08.2017;2017;08;06;Sunnuntai;1;0;1;0;1;1
294;06.08.2017;2017;08;07;Sunnuntai;0;1;1;1;0;1
294;06.08.2017;2017;08;08;Sunnuntai;1;0;1;2;1;3
294;06.08.2017;2017;08;09;Sunnuntai;3;6;9;14;3;17
294;06.08.2017;2017;08;10;Sunnuntai;8;4;12;7;4;11
294;06.08.2017;2017;08;11;Sunnuntai;4;11;15;8;6;14
294;06.08.2017;2017;08;12;Sunnuntai;13;13;26;6;7;13
294;06.08.2017;2017;08;13;Sunnuntai;21;10;31;11;4;15
294;06.08.2017;2017;08;14;Sunnuntai;9;8;17;11;3;14
294;06.08.2017;2017;08;15;Sunnuntai;14;18;32;4;7;11
294;06.08.2017;2017;08;16;Sunnuntai;24;14;38;16;21;37
294;06.08.2017;2017;08;17;Sunnuntai;8;16;24;5;10;15
294;06.08.2017;2017;08;18;Sunnuntai;15;9;24;7;5;12
294;06.08.2017;2017;08;19;Sunnuntai;24;14;38;10;6;16
294;06.08.2017;2017;08;20;Sunnuntai;8;20;28;6;7;13
294;06.08.2017;2017;08;21;Sunnuntai;4;2;6;1;2;3
294;06.08.2017;2017;08;22;Sunnuntai;4;4;8;1;1;2
294;06.08.2017;2017;08;23;Sunnuntai;3;3;6;0;0;0
294;07.08.2017;2017;08;00;Maanantai;0;0;0;0;0;0
294;07.08.2017;2017;08;01;Maanantai;0;0;0;0;0;0
294;07.08.2017;2017;08;02;Maanantai;0;0;0;0;0;0
294;07.08.2017;2017;08;03;Maanantai;0;0;0;0;0;0
294;07.08.2017;2017;08;04;Maanantai;1;0;1;0;0;0
294;07.08.2017;2017;08;05;Maanantai;0;0;0;0;0;0
294;07.08.2017;2017;08;06;Maanantai;1;2;3;2;2;4
294;07.08.2017;2017;08;07;Maanantai;4;7;11;3;2;5
294;07.08.2017;2017;08;08;Maanantai;9;1;10;2;5;7
294;07.08.2017;2017;08;09;Maanantai;5;11;16;2;8;10
294;07.08.2017;2017;08;10;Maanantai;9;9;18;6;6;12
294;07.08.2017;2017;08;11;Maanantai;24;13;37;9;4;13
294;07.08.2017;2017;08;12;Maanantai;36;18;54;10;7;17
294;07.08.2017;2017;08;13;Maanantai;37;18;55;13;10;23
294;07.08.2017;2017;08;14;Maanantai;40;31;71;16;24;40
294;07.08.2017;2017;08;15;Maanantai;23;34;57;11;12;23
294;07.08.2017;2017;08;16;Maanantai;35;31;66;15;20;35
294;07.08.2017;2017;08;17;Maanantai;30;19;49;9;9;18
294;07.08.2017;2017;08;18;Maanantai;18;30;48;6;8;14
294;07.08.2017;2017;08;19;Maanantai;29;19;48;18;20;38
294;07.08.2017;2017;08;20;Maanantai;20;27;47;13;12;25
294;07.08.2017;2017;08;21;Maanantai;10;7;17;3;7;10
294;07.08.2017;2017;08;22;Maanantai;1;1;2;2;0;2
294;07.08.2017;2017;08;23;Maanantai;3;2;5;0;1;1
294;08.08.2017;2017;08;00;Tiistai;0;1;1;0;0;0
294;08.08.2017;2017;08;01;Tiistai;1;0;1;0;0;0
294;08.08.2017;2017;08;02;Tiistai;0;1;1;0;0;0
294;08.08.2017;2017;08;03;Tiistai;0;0;0;0;0;0
294;08.08.2017;2017;08;04;Tiistai;0;0;0;0;0;0
294;08.08.2017;2017;08;05;Tiistai;0;0;0;0;0;0
294;08.08.2017;2017;08;06;Tiistai;3;0;3;0;1;1
294;08.08.2017;2017;08;07;Tiistai;6;5;11;1;1;2
294;08.08.2017;2017;08;08;Tiistai;2;3;5;7;6;13
294;08.08.2017;2017;08;09;Tiistai;14;6;20;11;3;14
294;08.08.2017;2017;08;10;Tiistai;12;13;25;10;8;18
294;08.08.2017;2017;08;11;Tiistai;24;13;37;15;11;26
294;08.08.2017;2017;08;12;Tiistai;21;29;50;17;16;33
294;08.08.2017;2017;08;13;Tiistai;24;20;44;11;4;15
294;08.08.2017;2017;08;14;Tiistai;32;21;53;10;5;15
294;08.08.2017;2017;08;15;Tiistai;27;29;56;6;11;17
294;08.08.2017;2017;08;16;Tiistai;30;19;49;3;12;15
294;08.08.2017;2017;08;17;Tiistai;36;28;64;11;7;18
294;08.08.2017;2017;08;18;Tiistai;27;23;50;16;12;28
294;08.08.2017;2017;08;19;Tiistai;18;24;42;8;7;15
294;08.08.2017;2017;08;20;Tiistai;13;7;20;4;3;7
294;08.08.2017;2017;08;21;Tiistai;4;5;9;1;1;2
294;08.08.2017;2017;08;22;Tiistai;1;1;2;0;1;1
294;08.08.2017;2017;08;23;Tiistai;3;3;6;2;1;3
294;09.08.2017;2017;08;00;Keskiviikko;0;0;0;0;0;0
294;09.08.2017;2017;08;01;Keskiviikko;0;0;0;0;0;0
294;09.08.2017;2017;08;02;Keskiviikko;0;0;0;0;0;0
294;09.08.2017;2017;08;03;Keskiviikko;0;0;0;0;0;0
294;09.08.2017;2017;08;04;Keskiviikko;0;0;0;1;0;1
294;09.08.2017;2017;08;05;Keskiviikko;0;0;0;0;0;0
294;09.08.2017;2017;08;06;Keskiviikko;2;1;3;2;0;2
294;09.08.2017;2017;08;07;Keskiviikko;3;10;13;1;1;2
294;09.08.2017;2017;08;08;Keskiviikko;4;1;5;4;6;10
294;09.08.2017;2017;08;09;Keskiviikko;9;5;14;7;7;14
294;09.08.2017;2017;08;10;Keskiviikko;8;9;17;3;2;5
294;09.08.2017;2017;08;11;Keskiviikko;14;17;31;13;8;21
294;09.08.2017;2017;08;12;Keskiviikko;21;25;46;6;9;15
294;09.08.2017;2017;08;13;Keskiviikko;33;34;67;9;15;24
294;09.08.2017;2017;08;14;Keskiviikko;24;16;40;18;12;30
294;09.08.2017;2017;08;15;Keskiviikko;24;24;48;15;7;22
294;09.08.2017;2017;08;16;Keskiviikko;23;37;60;8;8;16
294;09.08.2017;2017;08;17;Keskiviikko;38;26;64;13;15;28
294;09.08.2017;2017;08;18;Keskiviikko;32;30;62;13;14;27
294;09.08.2017;2017;08;19;Keskiviikko;20;16;36;10;18;28
294;09.08.2017;2017;08;20;Keskiviikko;13;16;29;8;4;12
294;09.08.2017;2017;08;21;Keskiviikko;4;3;7;0;1;1
294;09.08.2017;2017;08;22;Keskiviikko;2;1;3;1;1;2
294;09.08.2017;2017;08;23;Keskiviikko;0;0;0;0;0;0
294;10.08.2017;2017;08;00;Torstai;0;2;2;0;0;0
294;10.08.2017;2017;08;01;Torstai;2;0;2;0;0;0
294;10.08.2017;2017;08;02;Torstai;0;0;0;0;0;0
294;10.08.2017;2017;08;03;Torstai;0;0;0;0;0;0
294;10.08.2017;2017;08;04;Torstai;0;2;2;0;1;1
294;10.08.2017;2017;08;05;Torstai;2;1;3;1;0;1
294;10.08.2017;2017;08;06;Torstai;2;4;6;3;1;4
294;10.08.2017;2017;08;07;Torstai;4;4;8;4;5;9
294;10.08.2017;2017;08;08;Torstai;38;13;51;10;4;14
294;10.08.2017;2017;08;09;Torstai;14;12;26;9;11;20
294;10.08.2017;2017;08;10;Torstai;9;10;19;8;10;18
294;10.08.2017;2017;08;11;Torstai;9;28;37;5;11;16
294;10.08.2017;2017;08;12;Torstai;31;20;51;6;7;13
294;10.08.2017;2017;08;13;Torstai;10;9;19;2;6;8
294;10.08.2017;2017;08;14;Torstai;6;11;17;2;4;6
294;10.08.2017;2017;08;15;Torstai;11;16;27;10;7;17
294;10.08.2017;2017;08;16;Torstai;13;13;26;4;5;9
294;10.08.2017;2017;08;17;Torstai;16;7;23;10;9;19
294;10.08.2017;2017;08;18;Torstai;13;19;32;9;14;23
294;10.08.2017;2017;08;19;Torstai;22;15;37;12;9;21
294;10.08.2017;2017;08;20;Torstai;5;10;15;3;4;7
294;10.08.2017;2017;08;21;Torstai;4;3;7;1;0;1
294;10.08.2017;2017;08;22;Torstai;0;0;0;0;0;0
294;10.08.2017;2017;08;23;Torstai;0;0;0;0;0;0
294;11.08.2017;2017;08;00;Perjantai;1;0;1;0;0;0
294;11.08.2017;2017;08;01;Perjantai;0;0;0;0;0;0
294;11.08.2017;2017;08;02;Perjantai;0;0;0;0;0;0
294;11.08.2017;2017;08;03;Perjantai;0;0;0;0;0;0
294;11.08.2017;2017;08;04;Perjantai;1;1;2;0;0;0
294;11.08.2017;2017;08;05;Perjantai;0;1;1;1;1;2
294;11.08.2017;2017;08;06;Perjantai;3;1;4;1;1;2
294;11.08.2017;2017;08;07;Perjantai;14;11;25;1;9;10
294;11.08.2017;2017;08;08;Perjantai;23;11;34;9;7;16
294;11.08.2017;2017;08;09;Perjantai;19;11;30;9;8;17
294;11.08.2017;2017;08;10;Perjantai;20;20;40;14;3;17
294;11.08.2017;2017;08;11;Perjantai;11;15;26;10;12;22
294;11.08.2017;2017;08;12;Perjantai;31;28;59;20;28;48
294;11.08.2017;2017;08;13;Perjantai;23;31;54;8;14;22
294;11.08.2017;2017;08;14;Perjantai;32;54;86;13;23;36
294;11.08.2017;2017;08;15;Perjantai;35;18;53;12;8;20
294;11.08.2017;2017;08;16;Perjantai;21;27;48;10;8;18
294;11.08.2017;2017;08;17;Perjantai;33;26;59;18;13;31
294;11.08.2017;2017;08;18;Perjantai;19;26;45;9;9;18
294;11.08.2017;2017;08;19;Perjantai;21;15;36;8;14;22
294;11.08.2017;2017;08;20;Perjantai;18;11;29;6;5;11
294;11.08.2017;2017;08;21;Perjantai;3;4;7;5;2;7
294;11.08.2017;2017;08;22;Perjantai;1;3;4;1;3;4
294;11.08.2017;2017;08;23;Perjantai;1;3;4;0;0;0
294;12.08.2017;2017;08;00;Lauantai;0;3;3;0;0;0
294;12.08.2017;2017;08;01;Lauantai;1;1;2;0;0;0
294;12.08.2017;2017;08;02;Lauantai;0;1;1;0;0;0
294;12.08.2017;2017;08;03;Lauantai;2;0;2;0;4;4
294;12.08.2017;2017;08;04;Lauantai;1;0;1;0;0;0
294;12.08.2017;2017;08;05;Lauantai;0;0;0;0;0;0
294;12.08.2017;2017;08;06;Lauantai;1;1;2;1;0;1
294;12.08.2017;2017;08;07;Lauantai;2;1;3;0;1;1
294;12.08.2017;2017;08;08;Lauantai;3;4;7;4;0;4
294;12.08.2017;2017;08;09;Lauantai;6;4;10;3;5;8
294;12.08.2017;2017;08;10;Lauantai;9;18;27;3;10;13
294;12.08.2017;2017;08;11;Lauantai;46;27;73;10;10;20
294;12.08.2017;2017;08;12;Lauantai;23;30;53;7;8;15
294;12.08.2017;2017;08;13;Lauantai;23;18;41;11;4;15
294;12.08.2017;2017;08;14;Lauantai;25;11;36;14;9;23
294;12.08.2017;2017;08;15;Lauantai;14;14;28;9;5;14
294;12.08.2017;2017;08;16;Lauantai;10;13;23;3;1;4
294;12.08.2017;2017;08;17;Lauantai;23;15;38;3;5;8
294;12.08.2017;2017;08;18;Lauantai;12;30;42;6;5;11
294;12.08.2017;2017;08;19;Lauantai;19;19;38;5;8;13
294;12.08.2017;2017;08;20;Lauantai;7;12;19;4;2;6
294;12.08.2017;2017;08;21;Lauantai;8;4;12;2;0;2
294;12.08.2017;2017;08;22;Lauantai;2;4;6;0;1;1
294;12.08.2017;2017;08;23;Lauantai;2;0;2;0;0;0
294;13.08.2017;2017;08;00;Sunnuntai;1;0;1;1;0;1
294;13.08.2017;2017;08;01;Sunnuntai;1;0;1;1;0;1
294;13.08.2017;2017;08;02;Sunnuntai;0;0;0;0;1;1
294;13.08.2017;2017;08;03;Sunnuntai;0;1;1;0;0;0
294;13.08.2017;2017;08;04;Sunnuntai;0;0;0;0;0;0
294;13.08.2017;2017;08;05;Sunnuntai;0;0;0;0;0;0
294;13.08.2017;2017;08;06;Sunnuntai;0;0;0;0;0;0
294;13.08.2017;2017;08;07;Sunnuntai;0;0;0;0;0;0
294;13.08.2017;2017;08;08;Sunnuntai;1;0;1;0;3;3
294;13.08.2017;2017;08;09;Sunnuntai;4;2;6;2;1;3
294;13.08.2017;2017;08;10;Sunnuntai;7;4;11;9;2;11
294;13.08.2017;2017;08;11;Sunnuntai;2;4;6;2;6;8
294;13.08.2017;2017;08;12;Sunnuntai;5;2;7;3;2;5
294;13.08.2017;2017;08;13;Sunnuntai;1;6;7;1;1;2
294;13.08.2017;2017;08;14;Sunnuntai;4;4;8;1;2;3
294;13.08.2017;2017;08;15;Sunnuntai;14;12;26;7;8;15
294;13.08.2017;2017;08;16;Sunnuntai;9;14;23;6;3;9
294;13.08.2017;2017;08;17;Sunnuntai;7;5;12;10;10;20
294;13.08.2017;2017;08;18;Sunnuntai;16;10;26;11;8;19
294;13.08.2017;2017;08;19;Sunnuntai;11;14;25;6;8;14
294;13.08.2017;2017;08;20;Sunnuntai;7;14;21;6;7;13
294;13.08.2017;2017;08;21;Sunnuntai;4;1;5;2;1;3
294;13.08.2017;2017;08;22;Sunnuntai;0;0;0;0;3;3
294;13.08.2017;2017;08;23;Sunnuntai;0;0;0;0;0;0
294;14.08.2017;2017;08;00;Maanantai;0;0;0;0;0;0
294;14.08.2017;2017;08;01;Maanantai;0;0;0;0;0;0
294;14.08.2017;2017;08;02;Maanantai;0;0;0;0;0;0
294;14.08.2017;2017;08;03;Maanantai;0;0;0;0;0;0
294;14.08.2017;2017;08;04;Maanantai;1;0;1;0;0;0
294;14.08.2017;2017;08;05;Maanantai;0;0;0;0;0;0
294;14.08.2017;2017;08;06;Maanantai;2;2;4;3;1;4
294;14.08.2017;2017;08;07;Maanantai;24;10;34;5;4;9
294;14.08.2017;2017;08;08;Maanantai;40;14;54;10;10;20
294;14.08.2017;2017;08;09;Maanantai;16;6;22;9;4;13
294;14.08.2017;2017;08;10;Maanantai;10;10;20;8;4;12
294;14.08.2017;2017;08;11;Maanantai;16;27;43;7;8;15
294;14.08.2017;2017;08;12;Maanantai;6;7;13;11;9;20
294;14.08.2017;2017;08;13;Maanantai;19;19;38;12;14;26
294;14.08.2017;2017;08;14;Maanantai;22;29;51;11;7;18
294;14.08.2017;2017;08;15;Maanantai;34;36;70;5;13;18
294;14.08.2017;2017;08;16;Maanantai;15;18;33;8;2;10
294;14.08.2017;2017;08;17;Maanantai;21;24;45;8;10;18
294;14.08.2017;2017;08;18;Maanantai;18;19;37;11;18;29
294;14.08.2017;2017;08;19;Maanantai;17;23;40;13;9;22
294;14.08.2017;2017;08;20;Maanantai;7;15;22;4;8;12
294;14.08.2017;2017;08;21;Maanantai;7;1;8;3;2;5
294;14.08.2017;2017;08;22;Maanantai;0;0;0;0;0;0
294;14.08.2017;2017;08;23;Maanantai;1;0;1;0;1;1
294;15.08.2017;2017;08;00;Tiistai;0;0;0;0;0;0
294;15.08.2017;2017;08;01;Tiistai;0;0;0;0;0;0
294;15.08.2017;2017;08;02;Tiistai;0;0;0;0;0;0
294;15.08.2017;2017;08;03;Tiistai;0;0;0;0;0;0
294;15.08.2017;2017;08;04;Tiistai;1;0;1;0;1;1
294;15.08.2017;2017;08;05;Tiistai;0;0;0;0;0;0
294;15.08.2017;2017;08;06;Tiistai;4;3;7;3;0;3
294;15.08.2017;2017;08;07;Tiistai;15;11;26;5;0;5
294;15.08.2017;2017;08;08;Tiistai;23;6;29;8;4;12
294;15.08.2017;2017;08;09;Tiistai;34;9;43;13;8;21
294;15.08.2017;2017;08;10;Tiistai;8;8;16;4;6;10
294;15.08.2017;2017;08;11;Tiistai;19;19;38;15;10;25
294;15.08.2017;2017;08;12;Tiistai;8;12;20;14;15;29
294;15.08.2017;2017;08;13;Tiistai;15;6;21;18;7;25
294;15.08.2017;2017;08;14;Tiistai;12;26;38;11;7;18
294;15.08.2017;2017;08;15;Tiistai;29;50;79;9;11;20
294;15.08.2017;2017;08;16;Tiistai;22;18;40;6;17;23
294;15.08.2017;2017;08;17;Tiistai;22;21;43;12;9;21
294;15.08.2017;2017;08;18;Tiistai;26;28;54;18;12;30
294;15.08.2017;2017;08;19;Tiistai;9;11;20;6;11;17
294;15.08.2017;2017;08;20;Tiistai;10;10;20;9;4;13
294;15.08.2017;2017;08;21;Tiistai;8;4;12;7;5;12
294;15.08.2017;2017;08;22;Tiistai;1;0;1;1;1;2
294;15.08.2017;2017;08;23;Tiistai;2;0;2;0;0;0
294;16.08.2017;2017;08;00;Keskiviikko;0;0;0;0;0;0
294;16.08.2017;2017;08;01;Keskiviikko;0;0;0;0;0;0
294;16.08.2017;2017;08;02;Keskiviikko;0;0;0;0;0;0
294;16.08.2017;2017;08;03;Keskiviikko;0;0;0;0;0;0
294;16.08.2017;2017;08;04;Keskiviikko;0;0;0;0;1;1
294;16.08.2017;2017;08;05;Keskiviikko;2;0;2;0;0;0
294;16.08.2017;2017;08;06;Keskiviikko;3;1;4;3;5;8
294;16.08.2017;2017;08;07;Keskiviikko;24;8;32;7;1;8
294;16.08.2017;2017;08;08;Keskiviikko;24;8;32;4;2;6
294;16.08.2017;2017;08;09;Keskiviikko;10;11;21;6;11;17
294;16.08.2017;2017;08;10;Keskiviikko;8;10;18;16;9;25
294;16.08.2017;2017;08;11;Keskiviikko;18;21;39;11;11;22
294;16.08.2017;2017;08;12;Keskiviikko;11;21;32;13;9;22
294;16.08.2017;2017;08;13;Keskiviikko;22;25;47;9;9;18
294;16.08.2017;2017;08;14;Keskiviikko;15;24;39;6;8;14
294;16.08.2017;2017;08;15;Keskiviikko;28;32;60;11;8;19
294;16.08.2017;2017;08;16;Keskiviikko;26;29;55;5;4;9
294;16.08.2017;2017;08;17;Keskiviikko;21;15;36;15;9;24
294;16.08.2017;2017;08;18;Keskiviikko;29;22;51;25;17;42
294;16.08.2017;2017;08;19;Keskiviikko;19;19;38;8;12;20
294;16.08.2017;2017;08;20;Keskiviikko;10;7;17;9;8;17
294;16.08.2017;2017;08;21;Keskiviikko;3;1;4;2;2;4
294;16.08.2017;2017;08;22;Keskiviikko;1;1;2;2;3;5
294;16.08.2017;2017;08;23;Keskiviikko;0;0;0;5;0;5
294;17.08.2017;2017;08;00;Torstai;0;0;0;1;2;3
294;17.08.2017;2017;08;01;Torstai;0;0;0;0;0;0
294;17.08.2017;2017;08;02;Torstai;0;0;0;0;0;0
294;17.08.2017;2017;08;03;Torstai;0;0;0;0;0;0
294;17.08.2017;2017;08;04;Torstai;0;0;0;0;0;0
294;17.08.2017;2017;08;05;Torstai;0;0;0;0;0;0
294;17.08.2017;2017;08;06;Torstai;2;2;4;5;1;6
294;17.08.2017;2017;08;07;Torstai;20;10;30;3;1;4
294;17.08.2017;2017;08;08;Torstai;27;9;36;7;2;9
294;17.08.2017;2017;08;09;Torstai;21;17;38;11;4;15
294;17.08.2017;2017;08;10;Torstai;12;6;18;5;6;11
294;17.08.2017;2017;08;11;Torstai;15;23;38;22;19;41
294;17.08.2017;2017;08;12;Torstai;10;18;28;14;14;28
294;17.08.2017;2017;08;13;Torstai;10;19;29;10;10;20
294;17.08.2017;2017;08;14;Torstai;22;27;49;8;10;18
294;17.08.2017;2017;08;15;Torstai;12;30;42;11;7;18
294;17.08.2017;2017;08;16;Torstai;25;27;52;8;14;22
294;17.08.2017;2017;08;17;Torstai;26;36;62;8;25;33
294;17.08.2017;2017;08;18;Torstai;12;36;48;12;17;29
294;17.08.2017;2017;08;19;Torstai;27;14;41;16;9;25
294;17.08.2017;2017;08;20;Torstai;5;9;14;4;4;8
294;17.08.2017;2017;08;21;Torstai;4;2;6;2;1;3
294;17.08.2017;2017;08;22;Torstai;1;0;1;1;0;1
294;17.08.2017;2017;08;23;Torstai;0;0;0;1;0;1
294;18.08.2017;2017;08;00;Perjantai;0;0;0;0;0;0
294;18.08.2017;2017;08;01;Perjantai;0;0;0;0;0;0
294;18.08.2017;2017;08;02;Perjantai;0;0;0;0;0;0
294;18.08.2017;2017;08;03;Perjantai;0;0;0;0;0;0
294;18.08.2017;2017;08;04;Perjantai;1;0;1;0;0;0
294;18.08.2017;2017;08;05;Perjantai;0;1;1;0;0;0
294;18.08.2017;2017;08;06;Perjantai;4;2;6;3;5;8
294;18.08.2017;2017;08;07;Perjantai;22;13;35;6;2;8
294;18.08.2017;2017;08;08;Perjantai;8;5;13;11;2;13
294;18.08.2017;2017;08;09;Perjantai;17;7;24;5;6;11
294;18.08.2017;2017;08;10;Perjantai;10;8;18;7;13;20
294;18.08.2017;2017;08;11;Perjantai;24;16;40;22;11;33
294;18.08.2017;2017;08;12;Perjantai;26;45;71;15;9;24
294;18.08.2017;2017;08;13;Perjantai;30;33;63;8;16;24
294;18.08.2017;2017;08;14;Perjantai;30;53;83;11;16;27
294;18.08.2017;2017;08;15;Perjantai;35;24;59;10;7;17
294;18.08.2017;2017;08;16;Perjantai;18;24;42;4;13;17
294;18.08.2017;2017;08;17;Perjantai;19;21;40;6;7;13
294;18.08.2017;2017;08;18;Perjantai;19;14;33;6;8;14
294;18.08.2017;2017;08;19;Perjantai;27;13;40;8;7;15
294;18.08.2017;2017;08;20;Perjantai;10;15;25;4;4;8
294;18.08.2017;2017;08;21;Perjantai;9;9;18;2;5;7
294;18.08.2017;2017;08;22;Perjantai;5;1;6;5;3;8
294;18.08.2017;2017;08;23;Perjantai;1;0;1;0;0;0
294;19.08.2017;2017;08;00;Lauantai;1;1;2;3;0;3
294;19.08.2017;2017;08;01;Lauantai;0;0;0;0;0;0
294;19.08.2017;2017;08;02;Lauantai;0;0;0;0;0;0
294;19.08.2017;2017;08;03;Lauantai;0;0;0;0;0;0
294;19.08.2017;2017;08;04;Lauantai;1;0;1;0;0;0
294;19.08.2017;2017;08;05;Lauantai;0;0;0;0;0;0
294;19.08.2017;2017;08;06;Lauantai;0;1;1;0;0;0
294;19.08.2017;2017;08;07;Lauantai;0;1;1;0;3;3
294;19.08.2017;2017;08;08;Lauantai;1;2;3;1;5;6
294;19.08.2017;2017;08;09;Lauantai;2;3;5;2;5;7
294;19.08.2017;2017;08;10;Lauantai;11;5;16;10;6;16
294;19.08.2017;2017;08;11;Lauantai;15;18;33;12;9;21
294;19.08.2017;2017;08;12;Lauantai;28;21;49;7;4;11
294;19.08.2017;2017;08;13;Lauantai;16;17;33;21;6;27
294;19.08.2017;2017;08;14;Lauantai;21;22;43;8;8;16
294;19.08.2017;2017;08;15;Lauantai;17;26;43;13;7;20
294;19.08.2017;2017;08;16;Lauantai;30;32;62;4;10;14
294;19.08.2017;2017;08;17;Lauantai;21;18;39;6;8;14
294;19.08.2017;2017;08;18;Lauantai;20;20;40;15;8;23
294;19.08.2017;2017;08;19;Lauantai;9;9;18;5;9;14
294;19.08.2017;2017;08;20;Lauantai;10;8;18;2;1;3
294;19.08.2017;2017;08;21;Lauantai;5;5;10;2;0;2
294;19.08.2017;2017;08;22;Lauantai;1;0;1;2;0;2
294;19.08.2017;2017;08;23;Lauantai;19;1;20;2;1;3
294;20.08.2017;2017;08;00;Sunnuntai;5;0;5;0;1;1
294;20.08.2017;2017;08;01;Sunnuntai;2;0;2;0;0;0
294;20.08.2017;2017;08;02;Sunnuntai;0;4;4;0;1;1
294;20.08.2017;2017;08;03;Sunnuntai;0;0;0;0;1;1
294;20.08.2017;2017;08;04;Sunnuntai;0;0;0;0;0;0
294;20.08.2017;2017;08;05;Sunnuntai;1;1;2;0;0;0
294;20.08.2017;2017;08;06;Sunnuntai;1;2;3;0;0;0
294;20.08.2017;2017;08;07;Sunnuntai;0;0;0;0;0;0
294;20.08.2017;2017;08;08;Sunnuntai;3;0;3;2;2;4
294;20.08.2017;2017;08;09;Sunnuntai;2;4;6;4;4;8
294;20.08.2017;2017;08;10;Sunnuntai;6;10;16;7;13;20
294;20.08.2017;2017;08;11;Sunnuntai;7;11;18;6;5;11
294;20.08.2017;2017;08;12;Sunnuntai;6;15;21;4;4;8
294;20.08.2017;2017;08;13;Sunnuntai;9;12;21;10;5;15
294;20.08.2017;2017;08;14;Sunnuntai;15;18;33;3;4;7
294;20.08.2017;2017;08;15;Sunnuntai;18;10;28;7;3;10
294;20.08.2017;2017;08;16;Sunnuntai;7;12;19;6;5;11
294;20.08.2017;2017;08;17;Sunnuntai;12;13;25;4;5;9
294;20.08.2017;2017;08;18;Sunnuntai;14;11;25;5;3;8
294;20.08.2017;2017;08;19;Sunnuntai;9;7;16;2;7;9
294;20.08.2017;2017;08;20;Sunnuntai;8;2;10;8;5;13
294;20.08.2017;2017;08;21;Sunnuntai;1;4;5;5;5;10
294;20.08.2017;2017;08;22;Sunnuntai;0;0;0;0;1;1
294;20.08.2017;2017;08;23;Sunnuntai;0;0;0;0;0;0
294;21.08.2017;2017;08;00;Maanantai;2;2;4;0;0;0
294;21.08.2017;2017;08;01;Maanantai;0;0;0;0;0;0
294;21.08.2017;2017;08;02;Maanantai;0;0;0;0;0;0
294;21.08.2017;2017;08;03;Maanantai;0;0;0;0;0;0
294;21.08.2017;2017;08;04;Maanantai;1;0;1;0;1;1
294;21.08.2017;2017;08;05;Maanantai;0;1;1;0;1;1
294;21.08.2017;2017;08;06;Maanantai;1;1;2;2;0;2
294;21.08.2017;2017;08;07;Maanantai;25;11;36;9;4;13
294;21.08.2017;2017;08;08;Maanantai;28;9;37;6;6;12
294;21.08.2017;2017;08;09;Maanantai;23;14;37;9;13;22
294;21.08.2017;2017;08;10;Maanantai;6;7;13;12;5;17
294;21.08.2017;2017;08;11;Maanantai;30;25;55;16;13;29
294;21.08.2017;2017;08;12;Maanantai;16;14;30;8;9;17
294;21.08.2017;2017;08;13;Maanantai;16;25;41;9;8;17
294;21.08.2017;2017;08;14;Maanantai;23;30;53;11;12;23
294;21.08.2017;2017;08;15;Maanantai;23;41;64;9;13;22
294;21.08.2017;2017;08;16;Maanantai;29;27;56;13;14;27
294;21.08.2017;2017;08;17;Maanantai;22;17;39;12;10;22
294;21.08.2017;2017;08;18;Maanantai;28;31;59;4;12;16
294;21.08.2017;2017;08;19;Maanantai;17;16;33;12;19;31
294;21.08.2017;2017;08;20;Maanantai;8;11;19;4;7;11
294;21.08.2017;2017;08;21;Maanantai;2;2;4;1;0;1
294;21.08.2017;2017;08;22;Maanantai;0;0;0;1;0;1
294;21.08.2017;2017;08;23;Maanantai;0;0;0;0;0;0
294;22.08.2017;2017;08;00;Tiistai;0;0;0;0;0;0
294;22.08.2017;2017;08;01;Tiistai;0;0;0;0;0;0
294;22.08.2017;2017;08;02;Tiistai;0;0;0;0;0;0
294;22.08.2017;2017;08;03;Tiistai;0;0;0;0;0;0
294;22.08.2017;2017;08;04;Tiistai;1;0;1;0;1;1
294;22.08.2017;2017;08;05;Tiistai;0;0;0;0;1;1
294;22.08.2017;2017;08;06;Tiistai;5;2;7;4;2;6
294;22.08.2017;2017;08;07;Tiistai;22;11;33;5;4;9
294;22.08.2017;2017;08;08;Tiistai;36;2;38;6;3;9
294;22.08.2017;2017;08;09;Tiistai;23;7;30;10;9;19
294;22.08.2017;2017;08;10;Tiistai;5;6;11;10;10;20
294;22.08.2017;2017;08;11;Tiistai;8;12;20;19;14;33
294;22.08.2017;2017;08;12;Tiistai;10;10;20;17;16;33
294;22.08.2017;2017;08;13;Tiistai;14;16;30;7;4;11
294;22.08.2017;2017;08;14;Tiistai;13;15;28;3;6;9
294;22.08.2017;2017;08;15;Tiistai;14;51;65;9;14;23
294;22.08.2017;2017;08;16;Tiistai;40;28;68;10;18;28
294;22.08.2017;2017;08;17;Tiistai;24;10;34;17;11;28
294;22.08.2017;2017;08;18;Tiistai;19;26;45;6;15;21
294;22.08.2017;2017;08;19;Tiistai;17;16;33;5;10;15
294;22.08.2017;2017;08;20;Tiistai;14;13;27;6;4;10
294;22.08.2017;2017;08;21;Tiistai;4;6;10;4;5;9
294;22.08.2017;2017;08;22;Tiistai;0;0;0;0;0;0
294;22.08.2017;2017;08;23;Tiistai;0;0;0;0;0;0
294;23.08.2017;2017;08;00;Keskiviikko;0;0;0;0;0;0
294;23.08.2017;2017;08;01;Keskiviikko;0;0;0;0;0;0
294;23.08.2017;2017;08;02;Keskiviikko;0;0;0;0;0;0
294;23.08.2017;2017;08;03;Keskiviikko;0;0;0;0;0;0
294;23.08.2017;2017;08;04;Keskiviikko;0;0;0;0;0;0
294;23.08.2017;2017;08;05;Keskiviikko;0;0;0;0;0;0
294;23.08.2017;2017;08;06;Keskiviikko;5;3;8;3;3;6
294;23.08.2017;2017;08;07;Keskiviikko;22;6;28;5;3;8
294;23.08.2017;2017;08;08;Keskiviikko;23;15;38;9;5;14
294;23.08.2017;2017;08;09;Keskiviikko;14;7;21;6;6;12
294;23.08.2017;2017;08;10;Keskiviikko;8;9;17;11;8;19
294;23.08.2017;2017;08;11;Keskiviikko;9;13;22;12;15;27
294;23.08.2017;2017;08;12;Keskiviikko;6;12;18;11;11;22
294;23.08.2017;2017;08;13;Keskiviikko;10;16;26;10;20;30
294;23.08.2017;2017;08;14;Keskiviikko;9;36;45;14;10;24
294;23.08.2017;2017;08;15;Keskiviikko;40;44;84;18;18;36
294;23.08.2017;2017;08;16;Keskiviikko;26;14;40;10;9;19
294;23.08.2017;2017;08;17;Keskiviikko;22;13;35;9;9;18
294;23.08.2017;2017;08;18;Keskiviikko;11;11;22;10;12;22
294;23.08.2017;2017;08;19;Keskiviikko;9;6;15;8;8;16
294;23.08.2017;2017;08;20;Keskiviikko;7;8;15;4;4;8
294;23.08.2017;2017;08;21;Keskiviikko;3;0;3;3;2;5
294;23.08.2017;2017;08;22;Keskiviikko;0;0;0;0;0;0
294;23.08.2017;2017;08;23;Keskiviikko;0;4;4;0;0;0
294;24.08.2017;2017;08;00;Torstai;0;0;0;0;0;0
294;24.08.2017;2017;08;01;Torstai;0;0;0;0;0;0
294;24.08.2017;2017;08;02;Torstai;0;0;0;0;0;0
294;24.08.2017;2017;08;03;Torstai;0;0;0;0;0;0
294;24.08.2017;2017;08;04;Torstai;1;0;1;0;0;0
294;24.08.2017;2017;08;05;Torstai;0;1;1;0;0;0
294;24.08.2017;2017;08;06;Torstai;3;1;4;6;4;10
294;24.08.2017;2017;08;07;Torstai;9;9;18;4;7;11
294;24.08.2017;2017;08;08;Torstai;30;8;38;7;4;11
294;24.08.2017;2017;08;09;Torstai;17;11;28;5;7;12
294;24.08.2017;2017;08;10;Torstai;7;10;17;6;9;15
294;24.08.2017;2017;08;11;Torstai;15;9;24;21;15;36
294;24.08.2017;2017;08;12;Torstai;12;13;25;11;18;29
294;24.08.2017;2017;08;13;Torstai;13;9;22;8;4;12
294;24.08.2017;2017;08;14;Torstai;20;14;34;9;16;25
294;24.08.2017;2017;08;15;Torstai;24;30;54;8;13;21
294;24.08.2017;2017;08;16;Torstai;21;20;41;16;10;26
294;24.08.2017;2017;08;17;Torstai;24;11;35;10;9;19
294;24.08.2017;2017;08;18;Torstai;15;21;36;7;8;15
294;24.08.2017;2017;08;19;Torstai;15;15;30;9;5;14
294;24.08.2017;2017;08;20;Torstai;4;6;10;2;2;4
294;24.08.2017;2017;08;21;Torstai;1;4;5;1;1;2
294;24.08.2017;2017;08;22;Torstai;0;0;0;0;0;0
294;24.08.2017;2017;08;23;Torstai;0;0;0;0;0;0
294;25.08.2017;2017;08;00;Perjantai;1;0;1;1;0;1
294;25.08.2017;2017;08;01;Perjantai;0;0;0;0;0;0
294;25.08.2017;2017;08;02;Perjantai;0;0;0;0;0;0
294;25.08.2017;2017;08;03;Perjantai;0;0;0;0;0;0
294;25.08.2017;2017;08;04;Perjantai;1;0;1;0;0;0
294;25.08.2017;2017;08;05;Perjantai;0;0;0;1;0;1
294;25.08.2017;2017;08;06;Perjantai;6;2;8;2;2;4
294;25.08.2017;2017;08;07;Perjantai;13;14;27;3;6;9
294;25.08.2017;2017;08;08;Perjantai;14;16;30;6;5;11
294;25.08.2017;2017;08;09;Perjantai;17;6;23;12;5;17
294;25.08.2017;2017;08;10;Perjantai;9;5;14;10;10;20
294;25.08.2017;2017;08;11;Perjantai;20;12;32;18;15;33
294;25.08.2017;2017;08;12;Perjantai;10;17;27;19;16;35
294;25.08.2017;2017;08;13;Perjantai;16;20;36;9;11;20
294;25.08.2017;2017;08;14;Perjantai;16;30;46;9;13;22
294;25.08.2017;2017;08;15;Perjantai;24;20;44;9;11;20
294;25.08.2017;2017;08;16;Perjantai;27;13;40;9;7;16
294;25.08.2017;2017;08;17;Perjantai;14;16;30;8;5;13
294;25.08.2017;2017;08;18;Perjantai;13;12;25;4;5;9
294;25.08.2017;2017;08;19;Perjantai;7;8;15;7;3;10
294;25.08.2017;2017;08;20;Perjantai;8;18;26;2;4;6
294;25.08.2017;2017;08;21;Perjantai;4;2;6;5;2;7
294;25.08.2017;2017;08;22;Perjantai;3;2;5;0;0;0
294;25.08.2017;2017;08;23;Perjantai;2;1;3;0;0;0
294;26.08.2017;2017;08;00;Lauantai;0;0;0;0;0;0
294;26.08.2017;2017;08;01;Lauantai;0;0;0;1;0;1
294;26.08.2017;2017;08;02;Lauantai;0;0;0;0;1;1
294;26.08.2017;2017;08;03;Lauantai;0;0;0;0;1;1
294;26.08.2017;2017;08;04;Lauantai;1;0;1;0;0;0
294;26.08.2017;2017;08;05;Lauantai;0;0;0;0;0;0
294;26.08.2017;2017;08;06;Lauantai;2;1;3;0;0;0
294;26.08.2017;2017;08;07;Lauantai;2;2;4;1;2;3
294;26.08.2017;2017;08;08;Lauantai;1;0;1;3;0;3
294;26.08.2017;2017;08;09;Lauantai;4;1;5;3;4;7
294;26.08.2017;2017;08;10;Lauantai;8;9;17;3;7;10
294;26.08.2017;2017;08;11;Lauantai;10;12;22;6;10;16
294;26.08.2017;2017;08;12;Lauantai;12;9;21;10;4;14
294;26.08.2017;2017;08;13;Lauantai;23;20;43;14;12;26
294;26.08.2017;2017;08;14;Lauantai;22;27;49;8;15;23
294;26.08.2017;2017;08;15;Lauantai;26;28;54;13;3;16
294;26.08.2017;2017;08;16;Lauantai;16;16;32;6;9;15
294;26.08.2017;2017;08;17;Lauantai;24;14;38;9;10;19
294;26.08.2017;2017;08;18;Lauantai;22;22;44;7;9;16
294;26.08.2017;2017;08;19;Lauantai;10;7;17;6;2;8
294;26.08.2017;2017;08;20;Lauantai;5;12;17;3;5;8
294;26.08.2017;2017;08;21;Lauantai;3;10;13;4;3;7
294;26.08.2017;2017;08;22;Lauantai;2;6;8;1;1;2
294;26.08.2017;2017;08;23;Lauantai;2;1;3;5;1;6
294;27.08.2017;2017;08;00;Sunnuntai;1;0;1;0;0;0
294;27.08.2017;2017;08;01;Sunnuntai;2;5;7;0;1;1
294;27.08.2017;2017;08;02;Sunnuntai;0;0;0;0;1;1
294;27.08.2017;2017;08;03;Sunnuntai;1;1;2;2;0;2
294;27.08.2017;2017;08;04;Sunnuntai;0;0;0;0;0;0
294;27.08.2017;2017;08;05;Sunnuntai;1;0;1;0;0;0
294;27.08.2017;2017;08;06;Sunnuntai;0;0;0;1;1;2
294;27.08.2017;2017;08;07;Sunnuntai;0;0;0;1;2;3
294;27.08.2017;2017;08;08;Sunnuntai;1;0;1;2;3;5
294;27.08.2017;2017;08;09;Sunnuntai;3;2;5;4;4;8
294;27.08.2017;2017;08;10;Sunnuntai;5;8;13;3;6;9
294;27.08.2017;2017;08;11;Sunnuntai;9;11;20;7;3;10
294;27.08.2017;2017;08;12;Sunnuntai;8;12;20;9;14;23
294;27.08.2017;2017;08;13;Sunnuntai;7;12;19;1;8;9
294;27.08.2017;2017;08;14;Sunnuntai;13;15;28;7;11;18
294;27.08.2017;2017;08;15;Sunnuntai;26;17;43;19;9;28
294;27.08.2017;2017;08;16;Sunnuntai;14;11;25;5;9;14
294;27.08.2017;2017;08;17;Sunnuntai;14;12;26;10;7;17
294;27.08.2017;2017;08;18;Sunnuntai;16;21;37;5;6;11
294;27.08.2017;2017;08;19;Sunnuntai;10;19;29;10;3;13
294;27.08.2017;2017;08;20;Sunnuntai;7;5;12;6;6;12
294;27.08.2017;2017;08;21;Sunnuntai;4;6;10;4;1;5
294;27.08.2017;2017;08;22;Sunnuntai;0;0;0;0;1;1
294;27.08.2017;2017;08;23;Sunnuntai;0;0;0;0;0;0
294;28.08.2017;2017;08;00;Maanantai;0;0;0;0;0;0
294;28.08.2017;2017;08;01;Maanantai;0;0;0;0;0;0
294;28.08.2017;2017;08;02;Maanantai;0;0;0;0;0;0
294;28.08.2017;2017;08;03;Maanantai;0;0;0;0;0;0
294;28.08.2017;2017;08;04;Maanantai;0;0;0;0;0;0
294;28.08.2017;2017;08;05;Maanantai;0;0;0;0;1;1
294;28.08.2017;2017;08;06;Maanantai;4;1;5;1;3;4
294;28.08.2017;2017;08;07;Maanantai;20;20;40;5;4;9
294;28.08.2017;2017;08;08;Maanantai;28;6;34;4;3;7
294;28.08.2017;2017;08;09;Maanantai;16;10;26;20;7;27
294;28.08.2017;2017;08;10;Maanantai;13;8;21;13;13;26
294;28.08.2017;2017;08;11;Maanantai;14;18;32;16;20;36
294;28.08.2017;2017;08;12;Maanantai;17;13;30;9;16;25
294;28.08.2017;2017;08;13;Maanantai;17;15;32;12;6;18
294;28.08.2017;2017;08;14;Maanantai;19;24;43;8;15;23
294;28.08.2017;2017;08;15;Maanantai;19;25;44;13;17;30
294;28.08.2017;2017;08;16;Maanantai;31;25;56;9;18;27
294;28.08.2017;2017;08;17;Maanantai;24;26;50;9;12;21
294;28.08.2017;2017;08;18;Maanantai;24;24;48;11;13;24
294;28.08.2017;2017;08;19;Maanantai;12;13;25;10;13;23
294;28.08.2017;2017;08;20;Maanantai;11;3;14;7;4;11
294;28.08.2017;2017;08;21;Maanantai;6;4;10;5;2;7
294;28.08.2017;2017;08;22;Maanantai;1;1;2;2;1;3
294;28.08.2017;2017;08;23;Maanantai;0;0;0;0;0;0
294;29.08.2017;2017;08;00;Tiistai;0;0;0;1;0;1
294;29.08.2017;2017;08;01;Tiistai;0;0;0;0;0;0
294;29.08.2017;2017;08;02;Tiistai;0;0;0;0;0;0
294;29.08.2017;2017;08;03;Tiistai;0;0;0;0;0;0
294;29.08.2017;2017;08;04;Tiistai;0;0;0;0;0;0
294;29.08.2017;2017;08;05;Tiistai;1;1;2;1;3;4
294;29.08.2017;2017;08;06;Tiistai;5;2;7;2;1;3
294;29.08.2017;2017;08;07;Tiistai;14;11;25;4;7;11
294;29.08.2017;2017;08;08;Tiistai;31;3;34;1;3;4
294;29.08.2017;2017;08;09;Tiistai;27;3;30;22;4;26
294;29.08.2017;2017;08;10;Tiistai;13;24;37;8;7;15
294;29.08.2017;2017;08;11;Tiistai;23;13;36;11;14;25
294;29.08.2017;2017;08;12;Tiistai;13;12;25;11;19;30
294;29.08.2017;2017;08;13;Tiistai;9;12;21;10;0;10
294;29.08.2017;2017;08;14;Tiistai;22;18;40;6;8;14
294;29.08.2017;2017;08;15;Tiistai;12;41;53;5;13;18
294;29.08.2017;2017;08;16;Tiistai;13;5;18;6;6;12
294;29.08.2017;2017;08;17;Tiistai;3;4;7;3;5;8
294;29.08.2017;2017;08;18;Tiistai;1;6;7;5;7;12
294;29.08.2017;2017;08;19;Tiistai;2;3;5;4;5;9
294;29.08.2017;2017;08;20;Tiistai;2;0;2;5;2;7
294;29.08.2017;2017;08;21;Tiistai;1;2;3;3;1;4
294;29.08.2017;2017;08;22;Tiistai;0;0;0;0;0;0
294;29.08.2017;2017;08;23;Tiistai;0;0;0;0;1;1
294;30.08.2017;2017;08;00;Keskiviikko;0;0;0;0;0;0
294;30.08.2017;2017;08;01;Keskiviikko;0;0;0;0;0;0
294;30.08.2017;2017;08;02;Keskiviikko;0;0;0;0;0;0
294;30.08.2017;2017;08;03;Keskiviikko;0;0;0;0;0;0
294;30.08.2017;2017;08;04;Keskiviikko;0;0;0;0;0;0
294;30.08.2017;2017;08;05;Keskiviikko;0;0;0;0;0;0
294;30.08.2017;2017;08;06;Keskiviikko;4;3;7;4;0;4
294;30.08.2017;2017;08;07;Keskiviikko;19;7;26;3;1;4
294;30.08.2017;2017;08;08;Keskiviikko;25;5;30;7;3;10
294;30.08.2017;2017;08;09;Keskiviikko;4;7;11;2;2;4
294;30.08.2017;2017;08;10;Keskiviikko;1;4;5;5;3;8
294;30.08.2017;2017;08;11;Keskiviikko;3;8;11;7;5;12
294;30.08.2017;2017;08;12;Keskiviikko;5;3;8;4;5;9
294;30.08.2017;2017;08;13;Keskiviikko;4;7;11;7;8;15
294;30.08.2017;2017;08;14;Keskiviikko;11;12;23;9;9;18
294;30.08.2017;2017;08;15;Keskiviikko;18;27;45;11;12;23
294;30.08.2017;2017;08;16;Keskiviikko;19;18;37;11;10;21
294;30.08.2017;2017;08;17;Keskiviikko;20;19;39;16;7;23
294;30.08.2017;2017;08;18;Keskiviikko;20;17;37;14;17;31
294;30.08.2017;2017;08;19;Keskiviikko;12;19;31;15;13;28
294;30.08.2017;2017;08;20;Keskiviikko;18;9;27;6;6;12
294;30.08.2017;2017;08;21;Keskiviikko;3;4;7;4;2;6
294;30.08.2017;2017;08;22;Keskiviikko;0;2;2;0;0;0
294;30.08.2017;2017;08;23;Keskiviikko;0;0;0;0;0;0
294;31.08.2017;2017;08;00;Torstai;0;0;0;0;0;0
294;31.08.2017;2017;08;01;Torstai;0;0;0;0;0;0
294;31.08.2017;2017;08;02;Torstai;0;0;0;0;0;0
294;31.08.2017;2017;08;03;Torstai;0;0;0;0;0;0
294;31.08.2017;2017;08;04;Torstai;0;0;0;0;0;0
294;31.08.2017;2017;08;05;Torstai;2;1;3;0;1;1
294;31.08.2017;2017;08;06;Torstai;4;4;8;3;1;4
294;31.08.2017;2017;08;07;Torstai;7;10;17;5;3;8
294;31.08.2017;2017;08;08;Torstai;21;5;26;3;8;11
294;31.08.2017;2017;08;09;Torstai;46;6;52;12;8;20
294;31.08.2017;2017;08;10;Torstai;10;8;18;11;11;22
294;31.08.2017;2017;08;11;Torstai;17;10;27;28;18;46
294;31.08.2017;2017;08;12;Torstai;16;21;37;7;12;19
294;31.08.2017;2017;08;13;Torstai;21;21;42;10;11;21
294;31.08.2017;2017;08;14;Torstai;15;35;50;13;21;34
294;31.08.2017;2017;08;15;Torstai;18;31;49;10;13;23
294;31.08.2017;2017;08;16;Torstai;22;22;44;7;5;12
294;31.08.2017;2017;08;17;Torstai;19;11;30;10;14;24
294;31.08.2017;2017;08;18;Torstai;20;22;42;16;18;34
294;31.08.2017;2017;08;19;Torstai;18;19;37;9;9;18
294;31.08.2017;2017;08;20;Torstai;9;14;23;6;17;23
294;31.08.2017;2017;08;21;Torstai;2;1;3;2;0;2
294;31.08.2017;2017;08;22;Torstai;0;0;0;1;0;1
294;31.08.2017;2017;08;23;Torstai;0;0;0;0;0;0
294;01.09.2017;2017;09;00;Perjantai;0;0;0;0;0;0
294;01.09.2017;2017;09;01;Perjantai;0;0;0;0;0;0
294;01.09.2017;2017;09;02;Perjantai;0;0;0;0;0;0
294;01.09.2017;2017;09;03;Perjantai;0;0;0;0;0;0
294;01.09.2017;2017;09;04;Perjantai;0;0;0;0;1;1
294;01.09.2017;2017;09;05;Perjantai;0;0;0;0;0;0
294;01.09.2017;2017;09;06;Perjantai;3;2;5;1;1;2
294;01.09.2017;2017;09;07;Perjantai;7;5;12;2;1;3
294;01.09.2017;2017;09;08;Perjantai;3;5;8;4;1;5
294;01.09.2017;2017;09;09;Perjantai;4;2;6;4;3;7
294;01.09.2017;2017;09;10;Perjantai;2;1;3;5;3;8
294;01.09.2017;2017;09;11;Perjantai;6;1;7;7;7;14
294;01.09.2017;2017;09;12;Perjantai;6;9;15;9;10;19
294;01.09.2017;2017;09;13;Perjantai;10;11;21;4;3;7
294;01.09.2017;2017;09;14;Perjantai;9;17;26;3;15;18
294;01.09.2017;2017;09;15;Perjantai;5;8;13;3;13;16
294;01.09.2017;2017;09;16;Perjantai;6;17;23;5;5;10
294;01.09.2017;2017;09;17;Perjantai;10;9;19;6;6;12
294;01.09.2017;2017;09;18;Perjantai;9;11;20;7;8;15
294;01.09.2017;2017;09;19;Perjantai;6;6;12;3;10;13
294;01.09.2017;2017;09;20;Perjantai;9;7;16;4;5;9
294;01.09.2017;2017;09;21;Perjantai;7;4;11;6;0;6
294;01.09.2017;2017;09;22;Perjantai;1;0;1;0;1;1
294;01.09.2017;2017;09;23;Perjantai;0;2;2;0;0;0
294;02.09.2017;2017;09;00;Lauantai;2;0;2;0;0;0
294;02.09.2017;2017;09;01;Lauantai;0;0;0;0;0;0
294;02.09.2017;2017;09;02;Lauantai;0;0;0;1;1;2
294;02.09.2017;2017;09;03;Lauantai;0;0;0;0;0;0
294;02.09.2017;2017;09;04;Lauantai;0;0;0;0;0;0
294;02.09.2017;2017;09;05;Lauantai;1;0;1;0;0;0
294;02.09.2017;2017;09;06;Lauantai;0;0;0;0;3;3
294;02.09.2017;2017;09;07;Lauantai;0;1;1;1;0;1
294;02.09.2017;2017;09;08;Lauantai;2;2;4;3;1;4
294;02.09.2017;2017;09;09;Lauantai;5;6;11;4;5;9
294;02.09.2017;2017;09;10;Lauantai;11;13;24;6;4;10
294;02.09.2017;2017;09;11;Lauantai;15;22;37;9;6;15
294;02.09.2017;2017;09;12;Lauantai;16;14;30;6;13;19
294;02.09.2017;2017;09;13;Lauantai;14;20;34;10;6;16
294;02.09.2017;2017;09;14;Lauantai;22;26;48;11;9;20
294;02.09.2017;2017;09;15;Lauantai;13;17;30;8;4;12
294;02.09.2017;2017;09;16;Lauantai;11;8;19;5;1;6
294;02.09.2017;2017;09;17;Lauantai;19;7;26;5;2;7
294;02.09.2017;2017;09;18;Lauantai;28;17;45;7;4;11
294;02.09.2017;2017;09;19;Lauantai;7;15;22;7;2;9
294;02.09.2017;2017;09;20;Lauantai;9;18;27;11;5;16
294;02.09.2017;2017;09;21;Lauantai;14;6;20;6;4;10
294;02.09.2017;2017;09;22;Lauantai;0;0;0;4;1;5
294;02.09.2017;2017;09;23;Lauantai;4;0;4;0;0;0
294;03.09.2017;2017;09;00;Sunnuntai;0;0;0;4;2;6
294;03.09.2017;2017;09;01;Sunnuntai;0;0;0;0;3;3
294;03.09.2017;2017;09;02;Sunnuntai;1;0;1;0;6;6
294;03.09.2017;2017;09;03;Sunnuntai;1;0;1;0;0;0
294;03.09.2017;2017;09;04;Sunnuntai;0;0;0;0;0;0
294;03.09.2017;2017;09;05;Sunnuntai;2;0;2;0;0;0
294;03.09.2017;2017;09;06;Sunnuntai;0;1;1;0;0;0
294;03.09.2017;2017;09;07;Sunnuntai;0;0;0;0;0;0
294;03.09.2017;2017;09;08;Sunnuntai;1;0;1;3;2;5
294;03.09.2017;2017;09;09;Sunnuntai;4;3;7;5;6;11
294;03.09.2017;2017;09;10;Sunnuntai;3;4;7;9;5;14
294;03.09.2017;2017;09;11;Sunnuntai;4;10;14;8;8;16
294;03.09.2017;2017;09;12;Sunnuntai;10;6;16;6;6;12
294;03.09.2017;2017;09;13;Sunnuntai;10;9;19;7;6;13
294;03.09.2017;2017;09;14;Sunnuntai;14;17;31;9;5;14
294;03.09.2017;2017;09;15;Sunnuntai;14;13;27;7;4;11
294;03.09.2017;2017;09;16;Sunnuntai;20;19;39;15;9;24
294;03.09.2017;2017;09;17;Sunnuntai;24;22;46;7;16;23
294;03.09.2017;2017;09;18;Sunnuntai;20;30;50;6;12;18
294;03.09.2017;2017;09;19;Sunnuntai;16;15;31;4;9;13
294;03.09.2017;2017;09;20;Sunnuntai;11;2;13;4;7;11
294;03.09.2017;2017;09;21;Sunnuntai;7;3;10;5;3;8
294;03.09.2017;2017;09;22;Sunnuntai;1;0;1;0;0;0
294;03.09.2017;2017;09;23;Sunnuntai;0;0;0;1;0;1
294;04.09.2017;2017;09;00;Maanantai;0;0;0;0;1;1
294;04.09.2017;2017;09;01;Maanantai;0;0;0;0;1;1
294;04.09.2017;2017;09;02;Maanantai;1;0;1;1;0;1
294;04.09.2017;2017;09;03;Maanantai;0;2;2;0;0;0
294;04.09.2017;2017;09;04;Maanantai;0;0;0;0;0;0
294;04.09.2017;2017;09;05;Maanantai;0;0;0;1;2;3
294;04.09.2017;2017;09;06;Maanantai;3;3;6;1;4;5
294;04.09.2017;2017;09;07;Maanantai;15;12;27;8;0;8
294;04.09.2017;2017;09;08;Maanantai;34;6;40;8;7;15
294;04.09.2017;2017;09;09;Maanantai;11;12;23;15;9;24
294;04.09.2017;2017;09;10;Maanantai;14;10;24;9;6;15
294;04.09.2017;2017;09;11;Maanantai;11;15;26;13;13;26
294;04.09.2017;2017;09;12;Maanantai;13;12;25;6;12;18
294;04.09.2017;2017;09;13;Maanantai;8;26;34;10;11;21
294;04.09.2017;2017;09;14;Maanantai;16;26;42;9;13;22
294;04.09.2017;2017;09;15;Maanantai;34;32;66;7;10;17
294;04.09.2017;2017;09;16;Maanantai;37;25;62;10;5;15
294;04.09.2017;2017;09;17;Maanantai;24;38;62;7;15;22
294;04.09.2017;2017;09;18;Maanantai;40;40;80;16;11;27
294;04.09.2017;2017;09;19;Maanantai;23;32;55;12;17;29
294;04.09.2017;2017;09;20;Maanantai;13;10;23;3;5;8
294;04.09.2017;2017;09;21;Maanantai;1;1;2;0;4;4
294;04.09.2017;2017;09;22;Maanantai;2;0;2;1;0;1
294;04.09.2017;2017;09;23;Maanantai;0;0;0;0;0;0
294;05.09.2017;2017;09;00;Tiistai;0;0;0;0;0;0
294;05.09.2017;2017;09;01;Tiistai;0;0;0;0;0;0
294;05.09.2017;2017;09;02;Tiistai;0;0;0;0;0;0
294;05.09.2017;2017;09;03;Tiistai;0;0;0;0;0;0
294;05.09.2017;2017;09;04;Tiistai;0;0;0;0;0;0
294;05.09.2017;2017;09;05;Tiistai;1;1;2;0;2;2
294;05.09.2017;2017;09;06;Tiistai;4;3;7;2;1;3
294;05.09.2017;2017;09;07;Tiistai;20;11;31;6;1;7
294;05.09.2017;2017;09;08;Tiistai;40;5;45;5;2;7
294;05.09.2017;2017;09;09;Tiistai;23;7;30;11;11;22
294;05.09.2017;2017;09;10;Tiistai;13;13;26;12;12;24
294;05.09.2017;2017;09;11;Tiistai;20;15;35;15;15;30
294;05.09.2017;2017;09;12;Tiistai;9;9;18;11;12;23
294;05.09.2017;2017;09;13;Tiistai;20;15;35;9;7;16
294;05.09.2017;2017;09;14;Tiistai;20;23;43;12;12;24
294;05.09.2017;2017;09;15;Tiistai;34;54;88;8;16;24
294;05.09.2017;2017;09;16;Tiistai;28;28;56;5;4;9
294;05.09.2017;2017;09;17;Tiistai;19;22;41;10;15;25
294;05.09.2017;2017;09;18;Tiistai;18;20;38;8;14;22
294;05.09.2017;2017;09;19;Tiistai;24;21;45;5;12;17
294;05.09.2017;2017;09;20;Tiistai;4;6;10;2;6;8
294;05.09.2017;2017;09;21;Tiistai;1;0;1;2;2;4
294;05.09.2017;2017;09;22;Tiistai;0;0;0;1;0;1
294;05.09.2017;2017;09;23;Tiistai;0;0;0;0;0;0
294;06.09.2017;2017;09;00;Keskiviikko;0;0;0;0;0;0
294;06.09.2017;2017;09;01;Keskiviikko;0;0;0;0;0;0
294;06.09.2017;2017;09;02;Keskiviikko;0;0;0;0;0;0
294;06.09.2017;2017;09;03;Keskiviikko;0;0;0;0;0;0
294;06.09.2017;2017;09;04;Keskiviikko;0;0;0;0;0;0
294;06.09.2017;2017;09;05;Keskiviikko;0;0;0;0;2;2
294;06.09.2017;2017;09;06;Keskiviikko;2;2;4;2;0;2
294;06.09.2017;2017;09;07;Keskiviikko;22;6;28;4;2;6
294;06.09.2017;2017;09;08;Keskiviikko;28;5;33;15;2;17
294;06.09.2017;2017;09;09;Keskiviikko;7;12;19;14;14;28
294;06.09.2017;2017;09;10;Keskiviikko;14;12;26;12;11;23
294;06.09.2017;2017;09;11;Keskiviikko;10;20;30;22;15;37
294;06.09.2017;2017;09;12;Keskiviikko;13;15;28;16;14;30
294;06.09.2017;2017;09;13;Keskiviikko;11;17;28;8;8;16
294;06.09.2017;2017;09;14;Keskiviikko;14;24;38;7;16;23
294;06.09.2017;2017;09;15;Keskiviikko;31;30;61;14;17;31
294;06.09.2017;2017;09;16;Keskiviikko;33;23;56;7;5;12
294;06.09.2017;2017;09;17;Keskiviikko;17;17;34;13;15;28
294;06.09.2017;2017;09;18;Keskiviikko;16;26;42;16;16;32
294;06.09.2017;2017;09;19;Keskiviikko;13;21;34;14;14;28
294;06.09.2017;2017;09;20;Keskiviikko;16;12;28;7;8;15
294;06.09.2017;2017;09;21;Keskiviikko;0;0;0;3;5;8
294;06.09.2017;2017;09;22;Keskiviikko;0;0;0;0;0;0
294;06.09.2017;2017;09;23;Keskiviikko;0;0;0;1;0;1
294;07.09.2017;2017;09;00;Torstai;0;0;0;0;0;0
294;07.09.2017;2017;09;01;Torstai;0;0;0;0;0;0
294;07.09.2017;2017;09;02;Torstai;0;0;0;0;0;0
294;07.09.2017;2017;09;03;Torstai;0;0;0;0;0;0
294;07.09.2017;2017;09;04;Torstai;0;0;0;0;0;0
294;07.09.2017;2017;09;05;Torstai;1;0;1;0;0;0
294;07.09.2017;2017;09;06;Torstai;2;2;4;1;3;4
294;07.09.2017;2017;09;07;Torstai;14;9;23;4;3;7
294;07.09.2017;2017;09;08;Torstai;28;5;33;10;4;14
294;07.09.2017;2017;09;09;Torstai;20;15;35;7;10;17
294;07.09.2017;2017;09;10;Torstai;7;11;18;12;16;28
294;07.09.2017;2017;09;11;Torstai;7;13;20;15;11;26
294;07.09.2017;2017;09;12;Torstai;10;16;26;17;11;28
294;07.09.2017;2017;09;13;Torstai;11;15;26;7;7;14
294;07.09.2017;2017;09;14;Torstai;14;29;43;6;12;18
294;07.09.2017;2017;09;15;Torstai;33;42;75;8;20;28
294;07.09.2017;2017;09;16;Torstai;23;16;39;13;11;24
294;07.09.2017;2017;09;17;Torstai;13;23;36;7;13;20
294;07.09.2017;2017;09;18;Torstai;21;18;39;15;9;24
294;07.09.2017;2017;09;19;Torstai;18;22;40;13;19;32
294;07.09.2017;2017;09;20;Torstai;7;7;14;4;8;12
294;07.09.2017;2017;09;21;Torstai;5;0;5;0;2;2
294;07.09.2017;2017;09;22;Torstai;0;0;0;2;0;2
294;07.09.2017;2017;09;23;Torstai;0;0;0;0;0;0
294;08.09.2017;2017;09;00;Perjantai;0;0;0;0;0;0
294;08.09.2017;2017;09;01;Perjantai;0;0;0;0;0;0
294;08.09.2017;2017;09;02;Perjantai;0;0;0;0;0;0
294;08.09.2017;2017;09;03;Perjantai;0;0;0;0;0;0
294;08.09.2017;2017;09;04;Perjantai;0;0;0;0;0;0
294;08.09.2017;2017;09;05;Perjantai;0;0;0;0;0;0
294;08.09.2017;2017;09;06;Perjantai;2;1;3;1;4;5
294;08.09.2017;2017;09;07;Perjantai;15;11;26;2;0;2
294;08.09.2017;2017;09;08;Perjantai;7;5;12;11;3;14
294;08.09.2017;2017;09;09;Perjantai;8;2;10;22;9;31
294;08.09.2017;2017;09;10;Perjantai;2;8;10;9;11;20
294;08.09.2017;2017;09;11;Perjantai;13;14;27;3;6;9
294;08.09.2017;2017;09;12;Perjantai;13;14;27;15;16;31
294;08.09.2017;2017;09;13;Perjantai;17;21;38;9;13;22
294;08.09.2017;2017;09;14;Perjantai;18;30;48;10;16;26
294;08.09.2017;2017;09;15;Perjantai;21;16;37;7;7;14
294;08.09.2017;2017;09;16;Perjantai;14;29;43;7;9;16
294;08.09.2017;2017;09;17;Perjantai;12;13;25;9;4;13
294;08.09.2017;2017;09;18;Perjantai;10;7;17;4;14;18
294;08.09.2017;2017;09;19;Perjantai;5;11;16;5;8;13
294;08.09.2017;2017;09;20;Perjantai;7;10;17;3;3;6
294;08.09.2017;2017;09;21;Perjantai;11;6;17;1;2;3
294;08.09.2017;2017;09;22;Perjantai;3;0;3;0;0;0
294;08.09.2017;2017;09;23;Perjantai;0;0;0;0;0;0
294;09.09.2017;2017;09;00;Lauantai;0;0;0;0;0;0
294;09.09.2017;2017;09;01;Lauantai;1;0;1;0;0;0
294;09.09.2017;2017;09;02;Lauantai;1;0;1;0;0;0
294;09.09.2017;2017;09;03;Lauantai;0;0;0;0;0;0
294;09.09.2017;2017;09;04;Lauantai;0;0;0;0;0;0
294;09.09.2017;2017;09;05;Lauantai;0;0;0;0;0;0
294;09.09.2017;2017;09;06;Lauantai;0;1;1;0;1;1
294;09.09.2017;2017;09;07;Lauantai;1;1;2;0;2;2
294;09.09.2017;2017;09;08;Lauantai;2;1;3;4;1;5
294;09.09.2017;2017;09;09;Lauantai;4;0;4;8;4;12
294;09.09.2017;2017;09;10;Lauantai;7;4;11;7;7;14
294;09.09.2017;2017;09;11;Lauantai;12;18;30;7;9;16
294;09.09.2017;2017;09;12;Lauantai;13;17;30;9;9;18
294;09.09.2017;2017;09;13;Lauantai;8;11;19;7;6;13
294;09.09.2017;2017;09;14;Lauantai;16;12;28;5;5;10
294;09.09.2017;2017;09;15;Lauantai;23;6;29;8;6;14
294;09.09.2017;2017;09;16;Lauantai;6;15;21;4;5;9
294;09.09.2017;2017;09;17;Lauantai;20;5;25;7;11;18
294;09.09.2017;2017;09;18;Lauantai;7;9;16;12;5;17
294;09.09.2017;2017;09;19;Lauantai;4;10;14;6;9;15
294;09.09.2017;2017;09;20;Lauantai;14;6;20;3;5;8
294;09.09.2017;2017;09;21;Lauantai;7;0;7;0;0;0
294;09.09.2017;2017;09;22;Lauantai;2;2;4;2;1;3
294;09.09.2017;2017;09;23;Lauantai;2;0;2;1;0;1
294;10.09.2017;2017;09;00;Sunnuntai;0;0;0;0;0;0
294;10.09.2017;2017;09;01;Sunnuntai;0;0;0;0;0;0
294;10.09.2017;2017;09;02;Sunnuntai;1;0;1;0;1;1
294;10.09.2017;2017;09;03;Sunnuntai;2;1;3;0;0;0
294;10.09.2017;2017;09;04;Sunnuntai;0;0;0;0;0;0
294;10.09.2017;2017;09;05;Sunnuntai;0;0;0;0;0;0
294;10.09.2017;2017;09;06;Sunnuntai;0;0;0;0;0;0
294;10.09.2017;2017;09;07;Sunnuntai;0;0;0;1;1;2
294;10.09.2017;2017;09;08;Sunnuntai;1;2;3;2;1;3
294;10.09.2017;2017;09;09;Sunnuntai;4;2;6;1;1;2
294;10.09.2017;2017;09;10;Sunnuntai;1;0;1;0;1;1
294;10.09.2017;2017;09;11;Sunnuntai;4;1;5;2;0;2
294;10.09.2017;2017;09;12;Sunnuntai;2;3;5;2;2;4
294;10.09.2017;2017;09;13;Sunnuntai;4;0;4;1;1;2
294;10.09.2017;2017;09;14;Sunnuntai;1;1;2;3;0;3
294;10.09.2017;2017;09;15;Sunnuntai;1;0;1;2;1;3
294;10.09.2017;2017;09;16;Sunnuntai;2;3;5;0;2;2
294;10.09.2017;2017;09;17;Sunnuntai;3;5;8;3;7;10
294;10.09.2017;2017;09;18;Sunnuntai;2;4;6;8;6;14
294;10.09.2017;2017;09;19;Sunnuntai;6;6;12;7;2;9
294;10.09.2017;2017;09;20;Sunnuntai;3;2;5;3;3;6
294;10.09.2017;2017;09;21;Sunnuntai;0;0;0;2;0;2
294;10.09.2017;2017;09;22;Sunnuntai;1;0;1;0;0;0
294;10.09.2017;2017;09;23;Sunnuntai;0;0;0;0;0;0
294;11.09.2017;2017;09;00;Maanantai;0;0;0;0;0;0
294;11.09.2017;2017;09;01;Maanantai;0;0;0;0;0;0
294;11.09.2017;2017;09;02;Maanantai;0;0;0;0;0;0
294;11.09.2017;2017;09;03;Maanantai;0;0;0;0;0;0
294;11.09.2017;2017;09;04;Maanantai;1;0;1;0;0;0
294;11.09.2017;2017;09;05;Maanantai;1;0;1;0;2;2
294;11.09.2017;2017;09;06;Maanantai;3;2;5;0;1;1
294;11.09.2017;2017;09;07;Maanantai;14;12;26;5;2;7
294;11.09.2017;2017;09;08;Maanantai;14;3;17;6;4;10
294;11.09.2017;2017;09;09;Maanantai;30;9;39;7;6;13
294;11.09.2017;2017;09;10;Maanantai;17;12;29;4;8;12
294;11.09.2017;2017;09;11;Maanantai;11;11;22;13;11;24
294;11.09.2017;2017;09;12;Maanantai;9;12;21;8;7;15
294;11.09.2017;2017;09;13;Maanantai;18;25;43;16;18;34
294;11.09.2017;2017;09;14;Maanantai;20;29;49;11;9;20
294;11.09.2017;2017;09;15;Maanantai;16;35;51;6;11;17
294;11.09.2017;2017;09;16;Maanantai;14;13;27;4;7;11
294;11.09.2017;2017;09;17;Maanantai;33;21;54;4;19;23
294;11.09.2017;2017;09;18;Maanantai;34;20;54;15;18;33
294;11.09.2017;2017;09;19;Maanantai;30;20;50;23;12;35
294;11.09.2017;2017;09;20;Maanantai;11;13;24;6;9;15
294;11.09.2017;2017;09;21;Maanantai;6;1;7;2;2;4
294;11.09.2017;2017;09;22;Maanantai;0;0;0;0;0;0
294;11.09.2017;2017;09;23;Maanantai;0;0;0;0;0;0
294;12.09.2017;2017;09;00;Tiistai;0;0;0;0;0;0
294;12.09.2017;2017;09;01;Tiistai;0;0;0;0;0;0
294;12.09.2017;2017;09;02;Tiistai;0;0;0;0;0;0
294;12.09.2017;2017;09;03;Tiistai;0;0;0;0;0;0
294;12.09.2017;2017;09;04;Tiistai;0;0;0;0;1;1
294;12.09.2017;2017;09;05;Tiistai;0;1;1;0;0;0
294;12.09.2017;2017;09;06;Tiistai;1;2;3;4;2;6
294;12.09.2017;2017;09;07;Tiistai;17;13;30;5;2;7
294;12.09.2017;2017;09;08;Tiistai;25;3;28;7;6;13
294;12.09.2017;2017;09;09;Tiistai;35;9;44;13;23;36
294;12.09.2017;2017;09;10;Tiistai;8;4;12;13;9;22
294;12.09.2017;2017;09;11;Tiistai;16;20;36;32;14;46
294;12.09.2017;2017;09;12;Tiistai;10;14;24;16;9;25
294;12.09.2017;2017;09;13;Tiistai;13;7;20;7;13;20
294;12.09.2017;2017;09;14;Tiistai;20;14;34;9;5;14
294;12.09.2017;2017;09;15;Tiistai;10;36;46;6;11;17
294;12.09.2017;2017;09;16;Tiistai;6;13;19;2;8;10
294;12.09.2017;2017;09;17;Tiistai;7;4;11;6;3;9
294;12.09.2017;2017;09;18;Tiistai;10;8;18;5;6;11
294;12.09.2017;2017;09;19;Tiistai;5;8;13;4;6;10
294;12.09.2017;2017;09;20;Tiistai;5;1;6;2;1;3
294;12.09.2017;2017;09;21;Tiistai;1;1;2;3;2;5
294;12.09.2017;2017;09;22;Tiistai;0;1;1;0;0;0
294;12.09.2017;2017;09;23;Tiistai;1;0;1;0;0;0
294;13.09.2017;2017;09;00;Keskiviikko;0;0;0;0;0;0
294;13.09.2017;2017;09;01;Keskiviikko;0;0;0;0;0;0
294;13.09.2017;2017;09;02;Keskiviikko;0;0;0;0;0;0
294;13.09.2017;2017;09;03;Keskiviikko;1;0;1;0;0;0
294;13.09.2017;2017;09;04;Keskiviikko;0;0;0;0;0;0
294;13.09.2017;2017;09;05;Keskiviikko;0;0;0;0;0;0
294;13.09.2017;2017;09;06;Keskiviikko;4;1;5;1;0;1
294;13.09.2017;2017;09;07;Keskiviikko;14;7;21;7;2;9
294;13.09.2017;2017;09;08;Keskiviikko;26;7;33;9;3;12
294;13.09.2017;2017;09;09;Keskiviikko;6;16;22;8;11;19
294;13.09.2017;2017;09;10;Keskiviikko;12;14;26;14;7;21
294;13.09.2017;2017;09;11;Keskiviikko;18;10;28;15;11;26
294;13.09.2017;2017;09;12;Keskiviikko;12;17;29;8;5;13
294;13.09.2017;2017;09;13;Keskiviikko;12;15;27;10;13;23
294;13.09.2017;2017;09;14;Keskiviikko;14;20;34;6;15;21
294;13.09.2017;2017;09;15;Keskiviikko;15;19;34;7;12;19
294;13.09.2017;2017;09;16;Keskiviikko;31;15;46;6;8;14
294;13.09.2017;2017;09;17;Keskiviikko;16;20;36;12;14;26
294;13.09.2017;2017;09;18;Keskiviikko;24;20;44;17;14;31
294;13.09.2017;2017;09;19;Keskiviikko;21;25;46;13;14;27
294;13.09.2017;2017;09;20;Keskiviikko;9;11;20;7;8;15
294;13.09.2017;2017;09;21;Keskiviikko;4;2;6;2;7;9
294;13.09.2017;2017;09;22;Keskiviikko;0;0;0;0;0;0
294;13.09.2017;2017;09;23;Keskiviikko;0;1;1;1;0;1
294;14.09.2017;2017;09;00;Torstai;0;0;0;0;0;0
294;14.09.2017;2017;09;01;Torstai;0;0;0;0;0;0
294;14.09.2017;2017;09;02;Torstai;0;0;0;0;0;0
294;14.09.2017;2017;09;03;Torstai;0;0;0;0;0;0
294;14.09.2017;2017;09;04;Torstai;1;0;1;0;0;0
294;14.09.2017;2017;09;05;Torstai;1;0;1;0;1;1
294;14.09.2017;2017;09;06;Torstai;2;4;6;1;2;3
294;14.09.2017;2017;09;07;Torstai;14;2;16;3;4;7
294;14.09.2017;2017;09;08;Torstai;27;6;33;9;3;12
294;14.09.2017;2017;09;09;Torstai;23;15;38;11;12;23
294;14.09.2017;2017;09;10;Torstai;2;8;10;11;11;22
294;14.09.2017;2017;09;11;Torstai;8;16;24;16;15;31
294;14.09.2017;2017;09;12;Torstai;7;17;24;13;15;28
294;14.09.2017;2017;09;13;Torstai;14;20;34;11;8;19
294;14.09.2017;2017;09;14;Torstai;23;19;42;13;18;31
294;14.09.2017;2017;09;15;Torstai;22;27;49;12;14;26
294;14.09.2017;2017;09;16;Torstai;30;13;43;12;6;18
294;14.09.2017;2017;09;17;Torstai;24;14;38;8;15;23
294;14.09.2017;2017;09;18;Torstai;14;28;42;9;13;22
294;14.09.2017;2017;09;19;Torstai;20;30;50;8;7;15
294;14.09.2017;2017;09;20;Torstai;9;11;20;5;6;11
294;14.09.2017;2017;09;21;Torstai;1;1;2;1;3;4
294;14.09.2017;2017;09;22;Torstai;0;0;0;0;1;1
294;14.09.2017;2017;09;23;Torstai;0;0;0;1;0;1
294;15.09.2017;2017;09;00;Perjantai;0;0;0;0;0;0
294;15.09.2017;2017;09;01;Perjantai;0;0;0;0;0;0
294;15.09.2017;2017;09;02;Perjantai;0;0;0;0;0;0
294;15.09.2017;2017;09;03;Perjantai;0;0;0;0;0;0
294;15.09.2017;2017;09;04;Perjantai;0;0;0;1;0;1
294;15.09.2017;2017;09;05;Perjantai;0;0;0;0;1;1
294;15.09.2017;2017;09;06;Perjantai;3;0;3;4;3;7
294;15.09.2017;2017;09;07;Perjantai;10;13;23;3;5;8
294;15.09.2017;2017;09;08;Perjantai;13;5;18;10;4;14
294;15.09.2017;2017;09;09;Perjantai;15;9;24;20;6;26
294;15.09.2017;2017;09;10;Perjantai;10;9;19;6;14;20
294;15.09.2017;2017;09;11;Perjantai;20;19;39;18;17;35
294;15.09.2017;2017;09;12;Perjantai;14;31;45;16;17;33
294;15.09.2017;2017;09;13;Perjantai;31;20;51;17;15;32
294;15.09.2017;2017;09;14;Perjantai;20;32;52;11;15;26
294;15.09.2017;2017;09;15;Perjantai;29;14;43;11;9;20
294;15.09.2017;2017;09;16;Perjantai;17;23;40;12;13;25
294;15.09.2017;2017;09;17;Perjantai;13;15;28;8;9;17
294;15.09.2017;2017;09;18;Perjantai;19;21;40;9;4;13
294;15.09.2017;2017;09;19;Perjantai;18;14;32;7;9;16
294;15.09.2017;2017;09;20;Perjantai;13;10;23;0;5;5
294;15.09.2017;2017;09;21;Perjantai;3;5;8;7;2;9
294;15.09.2017;2017;09;22;Perjantai;4;3;7;0;0;0
294;15.09.2017;2017;09;23;Perjantai;0;0;0;0;0;0
294;16.09.2017;2017;09;00;Lauantai;2;0;2;1;0;1
294;16.09.2017;2017;09;01;Lauantai;0;0;0;0;0;0
294;16.09.2017;2017;09;02;Lauantai;1;0;1;0;0;0
294;16.09.2017;2017;09;03;Lauantai;0;0;0;0;0;0
294;16.09.2017;2017;09;04;Lauantai;0;0;0;0;0;0
294;16.09.2017;2017;09;05;Lauantai;0;0;0;0;0;0
294;16.09.2017;2017;09;06;Lauantai;1;0;1;0;2;2
294;16.09.2017;2017;09;07;Lauantai;5;2;7;1;2;3
294;16.09.2017;2017;09;08;Lauantai;3;2;5;2;3;5
294;16.09.2017;2017;09;09;Lauantai;3;3;6;2;2;4
294;16.09.2017;2017;09;10;Lauantai;7;11;18;9;8;17
294;16.09.2017;2017;09;11;Lauantai;11;9;20;9;4;13
294;16.09.2017;2017;09;12;Lauantai;4;2;6;10;2;12
294;16.09.2017;2017;09;13;Lauantai;10;12;22;9;10;19
294;16.09.2017;2017;09;14;Lauantai;14;6;20;10;13;23
294;16.09.2017;2017;09;15;Lauantai;8;20;28;2;3;5
294;16.09.2017;2017;09;16;Lauantai;8;7;15;9;7;16
294;16.09.2017;2017;09;17;Lauantai;12;6;18;5;7;12
294;16.09.2017;2017;09;18;Lauantai;13;20;33;12;6;18
294;16.09.2017;2017;09;19;Lauantai;12;12;24;11;5;16
294;16.09.2017;2017;09;20;Lauantai;8;11;19;4;5;9
294;16.09.2017;2017;09;21;Lauantai;11;3;14;1;6;7
294;16.09.2017;2017;09;22;Lauantai;6;5;11;0;1;1
294;16.09.2017;2017;09;23;Lauantai;1;0;1;0;0;0
294;17.09.2017;2017;09;00;Sunnuntai;0;0;0;2;0;2
294;17.09.2017;2017;09;01;Sunnuntai;0;0;0;0;0;0
294;17.09.2017;2017;09;02;Sunnuntai;1;0;1;0;1;1
294;17.09.2017;2017;09;03;Sunnuntai;0;0;0;0;0;0
294;17.09.2017;2017;09;04;Sunnuntai;0;0;0;1;0;1
294;17.09.2017;2017;09;05;Sunnuntai;0;0;0;0;0;0
294;17.09.2017;2017;09;06;Sunnuntai;0;0;0;0;1;1
294;17.09.2017;2017;09;07;Sunnuntai;1;0;1;2;1;3
294;17.09.2017;2017;09;08;Sunnuntai;2;0;2;2;0;2
294;17.09.2017;2017;09;09;Sunnuntai;2;4;6;3;8;11
294;17.09.2017;2017;09;10;Sunnuntai;4;5;9;5;4;9
294;17.09.2017;2017;09;11;Sunnuntai;11;5;16;6;8;14
294;17.09.2017;2017;09;12;Sunnuntai;5;5;10;10;4;14
294;17.09.2017;2017;09;13;Sunnuntai;6;9;15;4;7;11
294;17.09.2017;2017;09;14;Sunnuntai;3;4;7;3;5;8
294;17.09.2017;2017;09;15;Sunnuntai;6;14;20;8;10;18
294;17.09.2017;2017;09;16;Sunnuntai;8;7;15;9;3;12
294;17.09.2017;2017;09;17;Sunnuntai;5;11;16;8;15;23
294;17.09.2017;2017;09;18;Sunnuntai;8;9;17;7;6;13
294;17.09.2017;2017;09;19;Sunnuntai;7;1;8;4;6;10
294;17.09.2017;2017;09;20;Sunnuntai;6;7;13;3;4;7
294;17.09.2017;2017;09;21;Sunnuntai;0;3;3;0;1;1
294;17.09.2017;2017;09;22;Sunnuntai;0;0;0;0;0;0
294;17.09.2017;2017;09;23;Sunnuntai;1;0;1;0;0;0
294;18.09.2017;2017;09;00;Maanantai;0;0;0;0;0;0
294;18.09.2017;2017;09;01;Maanantai;0;0;0;0;0;0
294;18.09.2017;2017;09;02;Maanantai;0;0;0;0;0;0
294;18.09.2017;2017;09;03;Maanantai;0;0;0;0;0;0
294;18.09.2017;2017;09;04;Maanantai;0;0;0;1;0;1
294;18.09.2017;2017;09;05;Maanantai;0;1;1;0;1;1
294;18.09.2017;2017;09;06;Maanantai;3;0;3;2;4;6
294;18.09.2017;2017;09;07;Maanantai;15;19;34;8;3;11
294;18.09.2017;2017;09;08;Maanantai;25;3;28;6;2;8
294;18.09.2017;2017;09;09;Maanantai;15;8;23;4;5;9
294;18.09.2017;2017;09;10;Maanantai;11;5;16;6;10;16
294;18.09.2017;2017;09;11;Maanantai;5;13;18;19;8;27
294;18.09.2017;2017;09;12;Maanantai;15;14;29;2;9;11
294;18.09.2017;2017;09;13;Maanantai;12;21;33;10;17;27
294;18.09.2017;2017;09;14;Maanantai;13;20;33;8;16;24
294;18.09.2017;2017;09;15;Maanantai;28;27;55;16;16;32
294;18.09.2017;2017;09;16;Maanantai;20;17;37;13;6;19
294;18.09.2017;2017;09;17;Maanantai;14;17;31;9;12;21
294;18.09.2017;2017;09;18;Maanantai;10;21;31;21;14;35
294;18.09.2017;2017;09;19;Maanantai;13;16;29;10;13;23
294;18.09.2017;2017;09;20;Maanantai;7;1;8;2;5;7
294;18.09.2017;2017;09;21;Maanantai;2;0;2;3;2;5
294;18.09.2017;2017;09;22;Maanantai;0;0;0;0;0;0
294;18.09.2017;2017;09;23;Maanantai;0;0;0;0;1;1
294;19.09.2017;2017;09;00;Tiistai;0;0;0;0;0;0
294;19.09.2017;2017;09;01;Tiistai;0;0;0;0;0;0
294;19.09.2017;2017;09;02;Tiistai;0;0;0;0;0;0
294;19.09.2017;2017;09;03;Tiistai;0;0;0;0;0;0
294;19.09.2017;2017;09;04;Tiistai;0;0;0;0;0;0
294;19.09.2017;2017;09;05;Tiistai;0;1;1;0;2;2
294;19.09.2017;2017;09;06;Tiistai;4;3;7;0;2;2
294;19.09.2017;2017;09;07;Tiistai;12;9;21;5;3;8
294;19.09.2017;2017;09;08;Tiistai;19;5;24;11;7;18
294;19.09.2017;2017;09;09;Tiistai;20;2;22;11;2;13
294;19.09.2017;2017;09;10;Tiistai;2;2;4;6;3;9
294;19.09.2017;2017;09;11;Tiistai;4;6;10;7;10;17
294;19.09.2017;2017;09;12;Tiistai;12;6;18;12;13;25
294;19.09.2017;2017;09;13;Tiistai;8;7;15;8;8;16
294;19.09.2017;2017;09;14;Tiistai;14;24;38;11;10;21
294;19.09.2017;2017;09;15;Tiistai;23;30;53;12;18;30
294;19.09.2017;2017;09;16;Tiistai;12;21;33;7;8;15
294;19.09.2017;2017;09;17;Tiistai;13;17;30;4;14;18
294;19.09.2017;2017;09;18;Tiistai;12;13;25;14;19;33
294;19.09.2017;2017;09;19;Tiistai;5;7;12;13;15;28
294;19.09.2017;2017;09;20;Tiistai;6;2;8;3;4;7
294;19.09.2017;2017;09;21;Tiistai;0;1;1;2;1;3
294;19.09.2017;2017;09;22;Tiistai;0;0;0;1;0;1
294;19.09.2017;2017;09;23;Tiistai;0;0;0;0;0;0
294;20.09.2017;2017;09;00;Keskiviikko;0;0;0;0;0;0
294;20.09.2017;2017;09;01;Keskiviikko;0;0;0;0;0;0
294;20.09.2017;2017;09;02;Keskiviikko;0;0;0;0;0;0
294;20.09.2017;2017;09;03;Keskiviikko;0;0;0;0;0;0
294;20.09.2017;2017;09;04;Keskiviikko;0;0;0;0;0;0
294;20.09.2017;2017;09;05;Keskiviikko;0;0;0;0;1;1
294;20.09.2017;2017;09;06;Keskiviikko;6;2;8;2;1;3
294;20.09.2017;2017;09;07;Keskiviikko;16;5;21;9;3;12
294;20.09.2017;2017;09;08;Keskiviikko;28;11;39;11;6;17
294;20.09.2017;2017;09;09;Keskiviikko;7;17;24;11;14;25
294;20.09.2017;2017;09;10;Keskiviikko;11;21;32;8;10;18
294;20.09.2017;2017;09;11;Keskiviikko;18;9;27;12;14;26
294;20.09.2017;2017;09;12;Keskiviikko;8;7;15;16;8;24
294;20.09.2017;2017;09;13;Keskiviikko;17;15;32;10;7;17
294;20.09.2017;2017;09;14;Keskiviikko;17;21;38;17;14;31
294;20.09.2017;2017;09;15;Keskiviikko;16;20;36;4;10;14
294;20.09.2017;2017;09;16;Keskiviikko;14;12;26;15;9;24
294;20.09.2017;2017;09;17;Keskiviikko;17;14;31;21;16;37
294;20.09.2017;2017;09;18;Keskiviikko;9;18;27;12;11;23
294;20.09.2017;2017;09;19;Keskiviikko;11;19;30;15;11;26
294;20.09.2017;2017;09;20;Keskiviikko;11;8;19;4;7;11
294;20.09.2017;2017;09;21;Keskiviikko;0;3;3;4;3;7
294;20.09.2017;2017;09;22;Keskiviikko;0;0;0;0;0;0
294;20.09.2017;2017;09;23;Keskiviikko;0;0;0;0;0;0
294;21.09.2017;2017;09;00;Torstai;0;0;0;0;0;0
294;21.09.2017;2017;09;01;Torstai;0;0;0;0;0;0
294;21.09.2017;2017;09;02;Torstai;0;0;0;0;0;0
294;21.09.2017;2017;09;03;Torstai;0;0;0;0;0;0
294;21.09.2017;2017;09;04;Torstai;0;0;0;0;0;0
294;21.09.2017;2017;09;05;Torstai;1;0;1;0;1;1
294;21.09.2017;2017;09;06;Torstai;3;0;3;2;1;3
294;21.09.2017;2017;09;07;Torstai;17;4;21;4;8;12
294;21.09.2017;2017;09;08;Torstai;16;6;22;7;3;10
294;21.09.2017;2017;09;09;Torstai;11;17;28;12;9;21
294;21.09.2017;2017;09;10;Torstai;8;8;16;10;8;18
294;21.09.2017;2017;09;11;Torstai;9;15;24;11;4;15
294;21.09.2017;2017;09;12;Torstai;24;11;35;3;8;11
294;21.09.2017;2017;09;13;Torstai;11;19;30;6;11;17
294;21.09.2017;2017;09;14;Torstai;13;24;37;12;12;24
294;21.09.2017;2017;09;15;Torstai;40;27;67;9;9;18
294;21.09.2017;2017;09;16;Torstai;22;22;44;9;8;17
294;21.09.2017;2017;09;17;Torstai;20;20;40;16;14;30
294;21.09.2017;2017;09;18;Torstai;19;18;37;14;9;23
294;21.09.2017;2017;09;19;Torstai;7;16;23;7;7;14
294;21.09.2017;2017;09;20;Torstai;7;9;16;7;9;16
294;21.09.2017;2017;09;21;Torstai;2;0;2;0;2;2
294;21.09.2017;2017;09;22;Torstai;0;0;0;0;1;1
294;21.09.2017;2017;09;23;Torstai;0;0;0;1;0;1
294;22.09.2017;2017;09;00;Perjantai;0;0;0;0;0;0
294;22.09.2017;2017;09;01;Perjantai;0;0;0;0;0;0
294;22.09.2017;2017;09;02;Perjantai;0;0;0;0;0;0
294;22.09.2017;2017;09;03;Perjantai;0;0;0;0;0;0
294;22.09.2017;2017;09;04;Perjantai;0;0;0;0;0;0
294;22.09.2017;2017;09;05;Perjantai;0;0;0;2;1;3
294;22.09.2017;2017;09;06;Perjantai;5;0;5;5;1;6
294;22.09.2017;2017;09;07;Perjantai;10;17;27;4;5;9
294;22.09.2017;2017;09;08;Perjantai;12;8;20;5;4;9
294;22.09.2017;2017;09;09;Perjantai;22;6;28;15;8;23
294;22.09.2017;2017;09;10;Perjantai;8;8;16;3;12;15
294;22.09.2017;2017;09;11;Perjantai;11;14;25;11;14;25
294;22.09.2017;2017;09;12;Perjantai;11;26;37;7;13;20
294;22.09.2017;2017;09;13;Perjantai;22;26;48;7;17;24
294;22.09.2017;2017;09;14;Perjantai;22;32;54;14;7;21
294;22.09.2017;2017;09;15;Perjantai;19;24;43;11;10;21
294;22.09.2017;2017;09;16;Perjantai;23;21;44;15;14;29
294;22.09.2017;2017;09;17;Perjantai;14;12;26;15;12;27
294;22.09.2017;2017;09;18;Perjantai;21;11;32;13;13;26
294;22.09.2017;2017;09;19;Perjantai;17;23;40;6;11;17
294;22.09.2017;2017;09;20;Perjantai;13;11;24;7;3;10
294;22.09.2017;2017;09;21;Perjantai;13;11;24;2;1;3
294;22.09.2017;2017;09;22;Perjantai;3;7;10;0;5;5
294;22.09.2017;2017;09;23;Perjantai;3;0;3;2;0;2
294;23.09.2017;2017;09;00;Lauantai;0;1;1;0;1;1
294;23.09.2017;2017;09;01;Lauantai;1;0;1;0;0;0
294;23.09.2017;2017;09;02;Lauantai;0;0;0;0;0;0
294;23.09.2017;2017;09;03;Lauantai;0;0;0;0;0;0
294;23.09.2017;2017;09;04;Lauantai;0;0;0;0;0;0
294;23.09.2017;2017;09;05;Lauantai;0;0;0;0;0;0
294;23.09.2017;2017;09;06;Lauantai;2;0;2;0;1;1
294;23.09.2017;2017;09;07;Lauantai;1;1;2;2;1;3
294;23.09.2017;2017;09;08;Lauantai;2;1;3;0;4;4
294;23.09.2017;2017;09;09;Lauantai;3;4;7;1;6;7
294;23.09.2017;2017;09;10;Lauantai;11;9;20;9;11;20
294;23.09.2017;2017;09;11;Lauantai;23;18;41;12;7;19
294;23.09.2017;2017;09;12;Lauantai;13;9;22;12;9;21
294;23.09.2017;2017;09;13;Lauantai;27;11;38;5;9;14
294;23.09.2017;2017;09;14;Lauantai;14;18;32;8;5;13
294;23.09.2017;2017;09;15;Lauantai;15;8;23;9;8;17
294;23.09.2017;2017;09;16;Lauantai;22;20;42;5;4;9
294;23.09.2017;2017;09;17;Lauantai;20;31;51;9;13;22
294;23.09.2017;2017;09;18;Lauantai;19;12;31;5;5;10
294;23.09.2017;2017;09;19;Lauantai;9;4;13;6;2;8
294;23.09.2017;2017;09;20;Lauantai;8;8;16;4;2;6
294;23.09.2017;2017;09;21;Lauantai;4;2;6;3;1;4
294;23.09.2017;2017;09;22;Lauantai;4;2;6;2;0;2
294;23.09.2017;2017;09;23;Lauantai;5;2;7;2;1;3
294;24.09.2017;2017;09;00;Sunnuntai;0;1;1;1;0;1
294;24.09.2017;2017;09;01;Sunnuntai;0;0;0;0;0;0
294;24.09.2017;2017;09;02;Sunnuntai;0;1;1;1;1;2
294;24.09.2017;2017;09;03;Sunnuntai;0;0;0;0;0;0
294;24.09.2017;2017;09;04;Sunnuntai;0;0;0;0;0;0
294;24.09.2017;2017;09;05;Sunnuntai;0;0;0;0;0;0
294;24.09.2017;2017;09;06;Sunnuntai;2;0;2;0;0;0
294;24.09.2017;2017;09;07;Sunnuntai;0;0;0;0;0;0
294;24.09.2017;2017;09;08;Sunnuntai;0;2;2;3;3;6
294;24.09.2017;2017;09;09;Sunnuntai;4;1;5;3;2;5
294;24.09.2017;2017;09;10;Sunnuntai;5;10;15;4;4;8
294;24.09.2017;2017;09;11;Sunnuntai;8;5;13;5;10;15
294;24.09.2017;2017;09;12;Sunnuntai;14;7;21;9;7;16
294;24.09.2017;2017;09;13;Sunnuntai;9;22;31;15;16;31
294;24.09.2017;2017;09;14;Sunnuntai;9;21;30;10;12;22
294;24.09.2017;2017;09;15;Sunnuntai;18;13;31;8;7;15
294;24.09.2017;2017;09;16;Sunnuntai;20;9;29;7;5;12
294;24.09.2017;2017;09;17;Sunnuntai;16;12;28;3;3;6
294;24.09.2017;2017;09;18;Sunnuntai;6;8;14;11;6;17
294;24.09.2017;2017;09;19;Sunnuntai;12;8;20;6;8;14
294;24.09.2017;2017;09;20;Sunnuntai;1;5;6;7;4;11
294;24.09.2017;2017;09;21;Sunnuntai;0;0;0;5;0;5
294;24.09.2017;2017;09;22;Sunnuntai;0;0;0;0;0;0
294;24.09.2017;2017;09;23;Sunnuntai;0;1;1;0;0;0
294;25.09.2017;2017;09;00;Maanantai;0;0;0;0;0;0
294;25.09.2017;2017;09;01;Maanantai;0;0;0;0;0;0
294;25.09.2017;2017;09;02;Maanantai;0;0;0;0;0;0
294;25.09.2017;2017;09;03;Maanantai;0;0;0;0;0;0
294;25.09.2017;2017;09;04;Maanantai;0;0;0;0;0;0
294;25.09.2017;2017;09;05;Maanantai;0;0;0;0;0;0
294;25.09.2017;2017;09;06;Maanantai;2;2;4;2;4;6
294;25.09.2017;2017;09;07;Maanantai;20;12;32;6;8;14
294;25.09.2017;2017;09;08;Maanantai;20;2;22;5;1;6
294;25.09.2017;2017;09;09;Maanantai;19;12;31;6;16;22
294;25.09.2017;2017;09;10;Maanantai;11;8;19;18;9;27
294;25.09.2017;2017;09;11;Maanantai;14;9;23;13;10;23
294;25.09.2017;2017;09;12;Maanantai;6;8;14;15;9;24
294;25.09.2017;2017;09;13;Maanantai;17;19;36;14;13;27
294;25.09.2017;2017;09;14;Maanantai;21;21;42;12;7;19
294;25.09.2017;2017;09;15;Maanantai;22;32;54;10;15;25
294;25.09.2017;2017;09;16;Maanantai;26;15;41;5;6;11
294;25.09.2017;2017;09;17;Maanantai;24;31;55;13;8;21
294;25.09.2017;2017;09;18;Maanantai;16;29;45;20;15;35
294;25.09.2017;2017;09;19;Maanantai;29;30;59;12;10;22
294;25.09.2017;2017;09;20;Maanantai;3;4;7;6;7;13
294;25.09.2017;2017;09;21;Maanantai;2;1;3;3;1;4
294;25.09.2017;2017;09;22;Maanantai;0;0;0;0;0;0
294;25.09.2017;2017;09;23;Maanantai;0;0;0;0;0;0
294;26.09.2017;2017;09;00;Tiistai;0;0;0;0;0;0
294;26.09.2017;2017;09;01;Tiistai;0;0;0;0;0;0
294;26.09.2017;2017;09;02;Tiistai;0;0;0;0;0;0
294;26.09.2017;2017;09;03;Tiistai;0;0;0;0;0;0
294;26.09.2017;2017;09;04;Tiistai;0;0;0;0;0;0
294;26.09.2017;2017;09;05;Tiistai;0;0;0;0;0;0
294;26.09.2017;2017;09;06;Tiistai;3;2;5;3;1;4
294;26.09.2017;2017;09;07;Tiistai;14;12;26;1;4;5
294;26.09.2017;2017;09;08;Tiistai;37;1;38;2;1;3
294;26.09.2017;2017;09;09;Tiistai;12;7;19;9;5;14
294;26.09.2017;2017;09;10;Tiistai;8;9;17;6;4;10
294;26.09.2017;2017;09;11;Tiistai;16;7;23;9;5;14
294;26.09.2017;2017;09;12;Tiistai;8;16;24;9;4;13
294;26.09.2017;2017;09;13;Tiistai;7;19;26;4;10;14
294;26.09.2017;2017;09;14;Tiistai;21;14;35;11;15;26
294;26.09.2017;2017;09;15;Tiistai;24;29;53;5;14;19
294;26.09.2017;2017;09;16;Tiistai;18;9;27;9;5;14
294;26.09.2017;2017;09;17;Tiistai;16;20;36;6;5;11
294;26.09.2017;2017;09;18;Tiistai;18;12;30;13;8;21
294;26.09.2017;2017;09;19;Tiistai;13;14;27;7;10;17
294;26.09.2017;2017;09;20;Tiistai;12;3;15;2;8;10
294;26.09.2017;2017;09;21;Tiistai;0;0;0;0;2;2
294;26.09.2017;2017;09;22;Tiistai;0;0;0;0;0;0
294;26.09.2017;2017;09;23;Tiistai;0;0;0;0;0;0
294;27.09.2017;2017;09;00;Keskiviikko;0;0;0;0;0;0
294;27.09.2017;2017;09;01;Keskiviikko;0;0;0;0;0;0
294;27.09.2017;2017;09;02;Keskiviikko;0;0;0;0;0;0
294;27.09.2017;2017;09;03;Keskiviikko;0;0;0;0;0;0
294;27.09.2017;2017;09;04;Keskiviikko;0;0;0;0;0;0
294;27.09.2017;2017;09;05;Keskiviikko;0;2;2;1;0;1
294;27.09.2017;2017;09;06;Keskiviikko;3;1;4;3;2;5
294;27.09.2017;2017;09;07;Keskiviikko;15;4;19;1;3;4
294;27.09.2017;2017;09;08;Keskiviikko;23;8;31;6;1;7
294;27.09.2017;2017;09;09;Keskiviikko;10;12;22;9;2;11
294;27.09.2017;2017;09;10;Keskiviikko;7;10;17;3;7;10
294;27.09.2017;2017;09;11;Keskiviikko;12;10;22;7;14;21
294;27.09.2017;2017;09;12;Keskiviikko;12;9;21;9;5;14
294;27.09.2017;2017;09;13;Keskiviikko;6;17;23;4;6;10
294;27.09.2017;2017;09;14;Keskiviikko;20;32;52;12;14;26
294;27.09.2017;2017;09;15;Keskiviikko;37;24;61;6;15;21
294;27.09.2017;2017;09;16;Keskiviikko;17;10;27;10;4;14
294;27.09.2017;2017;09;17;Keskiviikko;14;10;24;12;8;20
294;27.09.2017;2017;09;18;Keskiviikko;15;17;32;18;22;40
294;27.09.2017;2017;09;19;Keskiviikko;11;16;27;17;13;30
294;27.09.2017;2017;09;20;Keskiviikko;10;7;17;4;5;9
294;27.09.2017;2017;09;21;Keskiviikko;5;3;8;4;1;5
294;27.09.2017;2017;09;22;Keskiviikko;0;0;0;0;0;0
294;27.09.2017;2017;09;23;Keskiviikko;0;1;1;0;0;0
294;28.09.2017;2017;09;00;Torstai;0;0;0;0;0;0
294;28.09.2017;2017;09;01;Torstai;0;0;0;0;0;0
294;28.09.2017;2017;09;02;Torstai;0;0;0;0;0;0
294;28.09.2017;2017;09;03;Torstai;0;0;0;0;0;0
294;28.09.2017;2017;09;04;Torstai;0;0;0;0;0;0
294;28.09.2017;2017;09;05;Torstai;1;0;1;0;1;1
294;28.09.2017;2017;09;06;Torstai;3;1;4;1;1;2
294;28.09.2017;2017;09;07;Torstai;8;9;17;7;4;11
294;28.09.2017;2017;09;08;Torstai;13;8;21;4;4;8
294;28.09.2017;2017;09;09;Torstai;10;12;22;7;2;9
294;28.09.2017;2017;09;10;Torstai;8;3;11;5;6;11
294;28.09.2017;2017;09;11;Torstai;6;15;21;13;13;26
294;28.09.2017;2017;09;12;Torstai;9;9;18;10;11;21
294;28.09.2017;2017;09;13;Torstai;6;11;17;7;9;16
294;28.09.2017;2017;09;14;Torstai;18;7;25;12;9;21
294;28.09.2017;2017;09;15;Torstai;18;12;30;7;4;11
294;28.09.2017;2017;09;16;Torstai;25;18;43;14;13;27
294;28.09.2017;2017;09;17;Torstai;12;22;34;11;7;18
294;28.09.2017;2017;09;18;Torstai;16;14;30;18;12;30
294;28.09.2017;2017;09;19;Torstai;16;18;34;8;12;20
294;28.09.2017;2017;09;20;Torstai;5;5;10;3;4;7
294;28.09.2017;2017;09;21;Torstai;3;0;3;2;2;4
294;28.09.2017;2017;09;22;Torstai;2;0;2;0;0;0
294;28.09.2017;2017;09;23;Torstai;0;0;0;1;0;1
294;29.09.2017;2017;09;00;Perjantai;0;0;0;0;0;0
294;29.09.2017;2017;09;01;Perjantai;0;0;0;0;0;0
294;29.09.2017;2017;09;02;Perjantai;0;0;0;0;0;0
294;29.09.2017;2017;09;03;Perjantai;0;0;0;0;0;0
294;29.09.2017;2017;09;04;Perjantai;0;0;0;0;0;0
294;29.09.2017;2017;09;05;Perjantai;1;1;2;0;1;1
294;29.09.2017;2017;09;06;Perjantai;3;1;4;1;1;2
294;29.09.2017;2017;09;07;Perjantai;8;7;15;2;2;4
294;29.09.2017;2017;09;08;Perjantai;10;4;14;6;3;9
294;29.09.2017;2017;09;09;Perjantai;12;7;19;11;6;17
294;29.09.2017;2017;09;10;Perjantai;14;9;23;5;12;17
294;29.09.2017;2017;09;11;Perjantai;8;11;19;9;12;21
294;29.09.2017;2017;09;12;Perjantai;18;18;36;16;10;26
294;29.09.2017;2017;09;13;Perjantai;27;27;54;6;13;19
294;29.09.2017;2017;09;14;Perjantai;15;13;28;10;5;15
294;29.09.2017;2017;09;15;Perjantai;18;25;43;7;11;18
294;29.09.2017;2017;09;16;Perjantai;13;12;25;12;11;23
294;29.09.2017;2017;09;17;Perjantai;16;21;37;9;8;17
294;29.09.2017;2017;09;18;Perjantai;29;18;47;6;17;23
294;29.09.2017;2017;09;19;Perjantai;15;18;33;14;9;23
294;29.09.2017;2017;09;20;Perjantai;15;6;21;4;5;9
294;29.09.2017;2017;09;21;Perjantai;3;4;7;0;1;1
294;29.09.2017;2017;09;22;Perjantai;1;0;1;1;0;1
294;29.09.2017;2017;09;23;Perjantai;4;6;10;1;0;1
294;30.09.2017;2017;09;00;Lauantai;2;0;2;2;0;2
294;30.09.2017;2017;09;01;Lauantai;3;0;3;0;4;4
294;30.09.2017;2017;09;02;Lauantai;0;0;0;0;0;0
294;30.09.2017;2017;09;03;Lauantai;0;0;0;0;0;0
294;30.09.2017;2017;09;04;Lauantai;0;0;0;1;0;1
294;30.09.2017;2017;09;05;Lauantai;0;0;0;0;1;1
294;30.09.2017;2017;09;06;Lauantai;2;0;2;0;0;0
294;30.09.2017;2017;09;07;Lauantai;1;2;3;2;1;3
294;30.09.2017;2017;09;08;Lauantai;0;1;1;4;6;10
294;30.09.2017;2017;09;09;Lauantai;9;11;20;14;15;29
294;30.09.2017;2017;09;10;Lauantai;13;17;30;11;7;18
294;30.09.2017;2017;09;11;Lauantai;10;9;19;14;12;26
294;30.09.2017;2017;09;12;Lauantai;16;15;31;12;10;22
294;30.09.2017;2017;09;13;Lauantai;25;15;40;13;10;23
294;30.09.2017;2017;09;14;Lauantai;15;12;27;13;8;21
294;30.09.2017;2017;09;15;Lauantai;11;12;23;14;9;23
294;30.09.2017;2017;09;16;Lauantai;16;9;25;10;6;16
294;30.09.2017;2017;09;17;Lauantai;26;22;48;3;3;6
294;30.09.2017;2017;09;18;Lauantai;13;11;24;13;7;20
294;30.09.2017;2017;09;19;Lauantai;9;15;24;3;6;9
294;30.09.2017;2017;09;20;Lauantai;3;7;10;8;2;10
294;30.09.2017;2017;09;21;Lauantai;5;2;7;2;0;2
294;30.09.2017;2017;09;22;Lauantai;8;2;10;3;2;5
294;30.09.2017;2017;09;23;Lauantai;1;1;2;1;0;1
294;01.10.2017;2017;10;00;Sunnuntai;0;0;0;0;0;0
294;01.10.2017;2017;10;01;Sunnuntai;0;0;0;0;0;0
294;01.10.2017;2017;10;02;Sunnuntai;0;0;0;0;0;0
294;01.10.2017;2017;10;03;Sunnuntai;1;0;1;0;0;0
294;01.10.2017;2017;10;04;Sunnuntai;0;0;0;0;0;0
294;01.10.2017;2017;10;05;Sunnuntai;1;0;1;0;0;0
294;01.10.2017;2017;10;06;Sunnuntai;0;0;0;0;1;1
294;01.10.2017;2017;10;07;Sunnuntai;0;1;1;0;0;0
294;01.10.2017;2017;10;08;Sunnuntai;0;0;0;3;2;5
294;01.10.2017;2017;10;09;Sunnuntai;3;3;6;2;3;5
294;01.10.2017;2017;10;10;Sunnuntai;1;2;3;7;11;18
294;01.10.2017;2017;10;11;Sunnuntai;9;8;17;18;6;24
294;01.10.2017;2017;10;12;Sunnuntai;7;4;11;11;3;14
294;01.10.2017;2017;10;13;Sunnuntai;4;8;12;10;5;15
294;01.10.2017;2017;10;14;Sunnuntai;7;9;16;5;6;11
294;01.10.2017;2017;10;15;Sunnuntai;5;8;13;8;7;15
294;01.10.2017;2017;10;16;Sunnuntai;7;5;12;5;4;9
294;01.10.2017;2017;10;17;Sunnuntai;20;11;31;9;10;19
294;01.10.2017;2017;10;18;Sunnuntai;8;4;12;8;11;19
294;01.10.2017;2017;10;19;Sunnuntai;4;12;16;3;6;9
294;01.10.2017;2017;10;20;Sunnuntai;6;3;9;4;4;8
294;01.10.2017;2017;10;21;Sunnuntai;0;0;0;0;3;3
294;01.10.2017;2017;10;22;Sunnuntai;1;0;1;2;0;2
294;01.10.2017;2017;10;23;Sunnuntai;0;0;0;1;0;1
294;02.10.2017;2017;10;00;Maanantai;0;0;0;0;0;0
294;02.10.2017;2017;10;01;Maanantai;0;0;0;0;0;0
294;02.10.2017;2017;10;02;Maanantai;0;0;0;0;0;0
294;02.10.2017;2017;10;03;Maanantai;0;0;0;0;0;0
294;02.10.2017;2017;10;04;Maanantai;0;0;0;0;0;0
294;02.10.2017;2017;10;05;Maanantai;0;0;0;0;2;2
294;02.10.2017;2017;10;06;Maanantai;4;1;5;0;2;2
294;02.10.2017;2017;10;07;Maanantai;22;13;35;6;3;9
294;02.10.2017;2017;10;08;Maanantai;17;4;21;12;4;16
294;02.10.2017;2017;10;09;Maanantai;11;9;20;9;8;17
294;02.10.2017;2017;10;10;Maanantai;5;7;12;10;5;15
294;02.10.2017;2017;10;11;Maanantai;23;14;37;16;19;35
294;02.10.2017;2017;10;12;Maanantai;9;5;14;13;10;23
294;02.10.2017;2017;10;13;Maanantai;8;22;30;13;12;25
294;02.10.2017;2017;10;14;Maanantai;32;25;57;24;12;36
294;02.10.2017;2017;10;15;Maanantai;17;25;42;10;14;24
294;02.10.2017;2017;10;16;Maanantai;15;13;28;12;7;19
294;02.10.2017;2017;10;17;Maanantai;8;14;22;7;7;14
294;02.10.2017;2017;10;18;Maanantai;15;5;20;13;7;20
294;02.10.2017;2017;10;19;Maanantai;12;20;32;11;11;22
294;02.10.2017;2017;10;20;Maanantai;2;5;7;0;2;2
294;02.10.2017;2017;10;21;Maanantai;4;3;7;2;0;2
294;02.10.2017;2017;10;22;Maanantai;0;2;2;0;0;0
294;02.10.2017;2017;10;23;Maanantai;0;0;0;1;0;1
294;03.10.2017;2017;10;00;Tiistai;0;0;0;0;0;0
294;03.10.2017;2017;10;01;Tiistai;0;0;0;0;0;0
294;03.10.2017;2017;10;02;Tiistai;0;0;0;0;0;0
294;03.10.2017;2017;10;03;Tiistai;0;0;0;0;0;0
294;03.10.2017;2017;10;04;Tiistai;0;0;0;1;0;1
294;03.10.2017;2017;10;05;Tiistai;0;0;0;1;2;3
294;03.10.2017;2017;10;06;Tiistai;3;1;4;0;0;0
294;03.10.2017;2017;10;07;Tiistai;17;12;29;5;3;8
294;03.10.2017;2017;10;08;Tiistai;23;4;27;5;0;5
294;03.10.2017;2017;10;09;Tiistai;26;0;26;12;4;16
294;03.10.2017;2017;10;10;Tiistai;10;5;15;6;9;15
294;03.10.2017;2017;10;11;Tiistai;9;6;15;25;20;45
294;03.10.2017;2017;10;12;Tiistai;8;12;20;11;10;21
294;03.10.2017;2017;10;13;Tiistai;13;19;32;9;14;23
294;03.10.2017;2017;10;14;Tiistai;5;26;31;13;10;23
294;03.10.2017;2017;10;15;Tiistai;16;25;41;9;8;17
294;03.10.2017;2017;10;16;Tiistai;29;29;58;6;8;14
294;03.10.2017;2017;10;17;Tiistai;17;19;36;11;9;20
294;03.10.2017;2017;10;18;Tiistai;12;8;20;19;14;33
294;03.10.2017;2017;10;19;Tiistai;6;6;12;5;6;11
294;03.10.2017;2017;10;20;Tiistai;4;4;8;4;0;4
294;03.10.2017;2017;10;21;Tiistai;1;1;2;3;1;4
294;03.10.2017;2017;10;22;Tiistai;1;0;1;0;0;0
294;03.10.2017;2017;10;23;Tiistai;0;0;0;0;0;0
294;04.10.2017;2017;10;00;Keskiviikko;0;0;0;0;0;0
294;04.10.2017;2017;10;01;Keskiviikko;0;0;0;0;0;0
294;04.10.2017;2017;10;02;Keskiviikko;0;0;0;0;0;0
294;04.10.2017;2017;10;03;Keskiviikko;0;0;0;0;0;0
294;04.10.2017;2017;10;04;Keskiviikko;0;0;0;0;0;0
294;04.10.2017;2017;10;05;Keskiviikko;0;0;0;0;0;0
294;04.10.2017;2017;10;06;Keskiviikko;4;1;5;2;0;2
294;04.10.2017;2017;10;07;Keskiviikko;12;6;18;9;4;13
294;04.10.2017;2017;10;08;Keskiviikko;16;5;21;6;1;7
294;04.10.2017;2017;10;09;Keskiviikko;13;10;23;9;4;13
294;04.10.2017;2017;10;10;Keskiviikko;3;2;5;8;12;20
294;04.10.2017;2017;10;11;Keskiviikko;6;3;9;14;18;32
294;04.10.2017;2017;10;12;Keskiviikko;8;6;14;8;7;15
294;04.10.2017;2017;10;13;Keskiviikko;7;10;17;5;10;15
294;04.10.2017;2017;10;14;Keskiviikko;11;18;29;11;7;18
294;04.10.2017;2017;10;15;Keskiviikko;9;22;31;6;10;16
294;04.10.2017;2017;10;16;Keskiviikko;13;10;23;6;7;13
294;04.10.2017;2017;10;17;Keskiviikko;18;13;31;10;9;19
294;04.10.2017;2017;10;18;Keskiviikko;13;14;27;16;13;29
294;04.10.2017;2017;10;19;Keskiviikko;8;9;17;9;16;25
294;04.10.2017;2017;10;20;Keskiviikko;5;6;11;7;5;12
294;04.10.2017;2017;10;21;Keskiviikko;3;3;6;2;0;2
294;04.10.2017;2017;10;22;Keskiviikko;0;0;0;0;0;0
294;04.10.2017;2017;10;23;Keskiviikko;0;0;0;2;0;2
294;05.10.2017;2017;10;00;Torstai;0;0;0;0;0;0
294;05.10.2017;2017;10;01;Torstai;0;0;0;0;0;0
294;05.10.2017;2017;10;02;Torstai;0;0;0;0;0;0
294;05.10.2017;2017;10;03;Torstai;0;0;0;0;0;0
294;05.10.2017;2017;10;04;Torstai;0;0;0;0;0;0
294;05.10.2017;2017;10;05;Torstai;0;2;2;0;2;2
294;05.10.2017;2017;10;06;Torstai;2;1;3;0;2;2
294;05.10.2017;2017;10;07;Torstai;8;6;14;8;5;13
294;05.10.2017;2017;10;08;Torstai;17;7;24;8;7;15
294;05.10.2017;2017;10;09;Torstai;18;6;24;10;8;18
294;05.10.2017;2017;10;10;Torstai;9;11;20;10;14;24
294;05.10.2017;2017;10;11;Torstai;7;12;19;27;18;45
294;05.10.2017;2017;10;12;Torstai;14;8;22;14;13;27
294;05.10.2017;2017;10;13;Torstai;16;26;42;17;15;32
294;05.10.2017;2017;10;14;Torstai;16;18;34;11;9;20
294;05.10.2017;2017;10;15;Torstai;14;22;36;10;13;23
294;05.10.2017;2017;10;16;Torstai;16;6;22;9;15;24
294;05.10.2017;2017;10;17;Torstai;12;11;23;10;7;17
294;05.10.2017;2017;10;18;Torstai;11;17;28;12;11;23
294;05.10.2017;2017;10;19;Torstai;12;11;23;20;10;30
294;05.10.2017;2017;10;20;Torstai;7;12;19;8;2;10
294;05.10.2017;2017;10;21;Torstai;1;2;3;2;1;3
294;05.10.2017;2017;10;22;Torstai;0;0;0;0;0;0
294;05.10.2017;2017;10;23;Torstai;0;0;0;1;0;1
294;06.10.2017;2017;10;00;Perjantai;0;0;0;0;0;0
294;06.10.2017;2017;10;01;Perjantai;0;0;0;0;0;0
294;06.10.2017;2017;10;02;Perjantai;0;0;0;0;0;0
294;06.10.2017;2017;10;03;Perjantai;0;0;0;0;0;0
294;06.10.2017;2017;10;04;Perjantai;0;0;0;0;0;0
294;06.10.2017;2017;10;05;Perjantai;0;1;1;0;3;3
294;06.10.2017;2017;10;06;Perjantai;1;0;1;2;1;3
294;06.10.2017;2017;10;07;Perjantai;16;11;27;3;2;5
294;06.10.2017;2017;10;08;Perjantai;25;8;33;5;3;8
294;06.10.2017;2017;10;09;Perjantai;12;17;29;11;15;26
294;06.10.2017;2017;10;10;Perjantai;9;7;16;5;14;19
294;06.10.2017;2017;10;11;Perjantai;12;8;20;15;14;29
294;06.10.2017;2017;10;12;Perjantai;19;26;45;20;18;38
294;06.10.2017;2017;10;13;Perjantai;21;28;49;13;20;33
294;06.10.2017;2017;10;14;Perjantai;25;29;54;12;18;30
294;06.10.2017;2017;10;15;Perjantai;17;23;40;5;8;13
294;06.10.2017;2017;10;16;Perjantai;17;14;31;8;8;16
294;06.10.2017;2017;10;17;Perjantai;14;8;22;8;13;21
294;06.10.2017;2017;10;18;Perjantai;7;12;19;6;6;12
294;06.10.2017;2017;10;19;Perjantai;20;15;35;16;14;30
294;06.10.2017;2017;10;20;Perjantai;9;9;18;6;5;11
294;06.10.2017;2017;10;21;Perjantai;0;1;1;5;1;6
294;06.10.2017;2017;10;22;Perjantai;6;2;8;1;1;2
294;06.10.2017;2017;10;23;Perjantai;0;0;0;0;0;0
294;07.10.2017;2017;10;00;Lauantai;3;0;3;1;0;1
294;07.10.2017;2017;10;01;Lauantai;0;0;0;0;0;0
294;07.10.2017;2017;10;02;Lauantai;1;1;2;1;0;1
294;07.10.2017;2017;10;03;Lauantai;0;0;0;1;1;2
294;07.10.2017;2017;10;04;Lauantai;0;0;0;0;1;1
294;07.10.2017;2017;10;05;Lauantai;0;0;0;0;2;2
294;07.10.2017;2017;10;06;Lauantai;1;2;3;0;0;0
294;07.10.2017;2017;10;07;Lauantai;1;0;1;3;3;6
294;07.10.2017;2017;10;08;Lauantai;1;3;4;2;2;4
294;07.10.2017;2017;10;09;Lauantai;8;3;11;5;6;11
294;07.10.2017;2017;10;10;Lauantai;8;9;17;8;8;16
294;07.10.2017;2017;10;11;Lauantai;14;15;29;12;6;18
294;07.10.2017;2017;10;12;Lauantai;22;9;31;9;10;19
294;07.10.2017;2017;10;13;Lauantai;14;13;27;16;10;26
294;07.10.2017;2017;10;14;Lauantai;14;19;33;10;11;21
294;07.10.2017;2017;10;15;Lauantai;22;22;44;9;1;10
294;07.10.2017;2017;10;16;Lauantai;14;23;37;10;17;27
294;07.10.2017;2017;10;17;Lauantai;11;13;24;13;13;26
294;07.10.2017;2017;10;18;Lauantai;6;9;15;10;7;17
294;07.10.2017;2017;10;19;Lauantai;16;5;21;5;5;10
294;07.10.2017;2017;10;20;Lauantai;11;7;18;1;6;7
294;07.10.2017;2017;10;21;Lauantai;8;2;10;2;1;3
294;07.10.2017;2017;10;22;Lauantai;0;2;2;2;1;3
294;07.10.2017;2017;10;23;Lauantai;5;0;5;0;0;0
294;08.10.2017;2017;10;00;Sunnuntai;0;0;0;0;0;0
294;08.10.2017;2017;10;01;Sunnuntai;0;0;0;0;0;0
294;08.10.2017;2017;10;02;Sunnuntai;0;2;2;0;0;0
294;08.10.2017;2017;10;03;Sunnuntai;0;0;0;0;0;0
294;08.10.2017;2017;10;04;Sunnuntai;0;0;0;0;0;0
294;08.10.2017;2017;10;05;Sunnuntai;0;0;0;1;0;1
294;08.10.2017;2017;10;06;Sunnuntai;0;0;0;0;0;0
294;08.10.2017;2017;10;07;Sunnuntai;1;0;1;1;1;2
294;08.10.2017;2017;10;08;Sunnuntai;0;0;0;1;1;2
294;08.10.2017;2017;10;09;Sunnuntai;0;1;1;6;5;11
294;08.10.2017;2017;10;10;Sunnuntai;8;4;12;6;4;10
294;08.10.2017;2017;10;11;Sunnuntai;3;4;7;7;5;12
294;08.10.2017;2017;10;12;Sunnuntai;7;11;18;10;10;20
294;08.10.2017;2017;10;13;Sunnuntai;12;14;26;10;9;19
294;08.10.2017;2017;10;14;Sunnuntai;7;12;19;5;3;8
294;08.10.2017;2017;10;15;Sunnuntai;13;8;21;7;8;15
294;08.10.2017;2017;10;16;Sunnuntai;9;23;32;13;8;21
294;08.10.2017;2017;10;17;Sunnuntai;18;13;31;8;7;15
294;08.10.2017;2017;10;18;Sunnuntai;12;12;24;11;9;20
294;08.10.2017;2017;10;19;Sunnuntai;9;4;13;5;7;12
294;08.10.2017;2017;10;20;Sunnuntai;5;6;11;5;3;8
294;08.10.2017;2017;10;21;Sunnuntai;1;0;1;1;0;1
294;08.10.2017;2017;10;22;Sunnuntai;0;0;0;0;0;0
294;08.10.2017;2017;10;23;Sunnuntai;0;0;0;0;0;0
294;09.10.2017;2017;10;00;Maanantai;0;0;0;0;0;0
294;09.10.2017;2017;10;01;Maanantai;0;0;0;0;0;0
294;09.10.2017;2017;10;02;Maanantai;0;0;0;0;0;0
294;09.10.2017;2017;10;03;Maanantai;0;0;0;0;0;0
294;09.10.2017;2017;10;04;Maanantai;0;0;0;0;0;0
294;09.10.2017;2017;10;05;Maanantai;0;0;0;0;0;0
294;09.10.2017;2017;10;06;Maanantai;6;3;9;1;1;2
294;09.10.2017;2017;10;07;Maanantai;16;14;30;3;1;4
294;09.10.2017;2017;10;08;Maanantai;26;3;29;15;3;18
294;09.10.2017;2017;10;09;Maanantai;12;9;21;9;12;21
294;09.10.2017;2017;10;10;Maanantai;12;11;23;8;2;10
294;09.10.2017;2017;10;11;Maanantai;10;16;26;19;14;33
294;09.10.2017;2017;10;12;Maanantai;10;9;19;15;15;30
294;09.10.2017;2017;10;13;Maanantai;10;18;28;9;16;25
294;09.10.2017;2017;10;14;Maanantai;18;31;49;12;16;28
294;09.10.2017;2017;10;15;Maanantai;23;27;50;13;16;29
294;09.10.2017;2017;10;16;Maanantai;17;18;35;5;6;11
294;09.10.2017;2017;10;17;Maanantai;16;13;29;11;7;18
294;09.10.2017;2017;10;18;Maanantai;15;15;30;21;15;36
294;09.10.2017;2017;10;19;Maanantai;14;11;25;18;12;30
294;09.10.2017;2017;10;20;Maanantai;2;2;4;3;3;6
294;09.10.2017;2017;10;21;Maanantai;3;1;4;2;2;4
294;09.10.2017;2017;10;22;Maanantai;0;1;1;0;0;0
294;09.10.2017;2017;10;23;Maanantai;0;0;0;0;0;0
294;10.10.2017;2017;10;00;Tiistai;0;0;0;1;0;1
294;10.10.2017;2017;10;01;Tiistai;0;0;0;0;0;0
294;10.10.2017;2017;10;02;Tiistai;0;0;0;0;0;0
294;10.10.2017;2017;10;03;Tiistai;0;0;0;0;0;0
294;10.10.2017;2017;10;04;Tiistai;0;0;0;0;0;0
294;10.10.2017;2017;10;05;Tiistai;1;1;2;0;1;1
294;10.10.2017;2017;10;06;Tiistai;3;1;4;0;1;1
294;10.10.2017;2017;10;07;Tiistai;10;12;22;2;7;9
294;10.10.2017;2017;10;08;Tiistai;29;1;30;7;3;10
294;10.10.2017;2017;10;09;Tiistai;25;4;29;9;7;16
294;10.10.2017;2017;10;10;Tiistai;5;8;13;5;7;12
294;10.10.2017;2017;10;11;Tiistai;5;6;11;13;10;23
294;10.10.2017;2017;10;12;Tiistai;14;8;22;7;5;12
294;10.10.2017;2017;10;13;Tiistai;8;13;21;5;10;15
294;10.10.2017;2017;10;14;Tiistai;11;20;31;9;10;19
294;10.10.2017;2017;10;15;Tiistai;21;15;36;10;15;25
294;10.10.2017;2017;10;16;Tiistai;9;8;17;12;12;24
294;10.10.2017;2017;10;17;Tiistai;8;4;12;17;7;24
294;10.10.2017;2017;10;18;Tiistai;7;4;11;8;8;16
294;10.10.2017;2017;10;19;Tiistai;9;6;15;16;7;23
294;10.10.2017;2017;10;20;Tiistai;1;3;4;2;2;4
294;10.10.2017;2017;10;21;Tiistai;2;2;4;0;0;0
294;10.10.2017;2017;10;22;Tiistai;0;0;0;0;0;0
294;10.10.2017;2017;10;23;Tiistai;0;0;0;0;0;0
294;11.10.2017;2017;10;00;Keskiviikko;0;0;0;0;0;0
294;11.10.2017;2017;10;01;Keskiviikko;0;0;0;0;0;0
294;11.10.2017;2017;10;02;Keskiviikko;0;0;0;0;0;0
294;11.10.2017;2017;10;03;Keskiviikko;0;0;0;0;0;0
294;11.10.2017;2017;10;04;Keskiviikko;0;0;0;0;0;0
294;11.10.2017;2017;10;05;Keskiviikko;0;0;0;0;0;0
294;11.10.2017;2017;10;06;Keskiviikko;3;1;4;2;4;6
294;11.10.2017;2017;10;07;Keskiviikko;18;7;25;6;7;13
294;11.10.2017;2017;10;08;Keskiviikko;19;8;27;8;1;9
294;11.10.2017;2017;10;09;Keskiviikko;7;12;19;4;10;14
294;11.10.2017;2017;10;10;Keskiviikko;6;5;11;12;13;25
294;11.10.2017;2017;10;11;Keskiviikko;5;10;15;21;12;33
294;11.10.2017;2017;10;12;Keskiviikko;12;8;20;12;11;23
294;11.10.2017;2017;10;13;Keskiviikko;5;12;17;22;11;33
294;11.10.2017;2017;10;14;Keskiviikko;13;21;34;13;13;26
294;11.10.2017;2017;10;15;Keskiviikko;23;28;51;10;17;27
294;11.10.2017;2017;10;16;Keskiviikko;18;18;36;10;11;21
294;11.10.2017;2017;10;17;Keskiviikko;15;11;26;13;6;19
294;11.10.2017;2017;10;18;Keskiviikko;18;11;29;17;13;30
294;11.10.2017;2017;10;19;Keskiviikko;13;8;21;16;18;34
294;11.10.2017;2017;10;20;Keskiviikko;4;4;8;8;8;16
294;11.10.2017;2017;10;21;Keskiviikko;1;1;2;0;0;0
294;11.10.2017;2017;10;22;Keskiviikko;0;1;1;0;0;0
294;11.10.2017;2017;10;23;Keskiviikko;0;0;0;0;0;0
294;12.10.2017;2017;10;00;Torstai;0;0;0;0;0;0
294;12.10.2017;2017;10;01;Torstai;0;0;0;0;0;0
294;12.10.2017;2017;10;02;Torstai;0;0;0;0;0;0
294;12.10.2017;2017;10;03;Torstai;0;0;0;0;0;0
294;12.10.2017;2017;10;04;Torstai;0;0;0;0;0;0
294;12.10.2017;2017;10;05;Torstai;0;1;1;1;1;2
294;12.10.2017;2017;10;06;Torstai;3;2;5;4;1;5
294;12.10.2017;2017;10;07;Torstai;8;7;15;6;1;7
294;12.10.2017;2017;10;08;Torstai;21;6;27;10;2;12
294;12.10.2017;2017;10;09;Torstai;23;9;32;6;5;11
294;12.10.2017;2017;10;10;Torstai;12;9;21;4;6;10
294;12.10.2017;2017;10;11;Torstai;12;19;31;11;11;22
294;12.10.2017;2017;10;12;Torstai;9;11;20;15;19;34
294;12.10.2017;2017;10;13;Torstai;11;14;25;10;16;26
294;12.10.2017;2017;10;14;Torstai;21;22;43;10;6;16
294;12.10.2017;2017;10;15;Torstai;27;34;61;6;12;18
294;12.10.2017;2017;10;16;Torstai;10;11;21;10;4;14
294;12.10.2017;2017;10;17;Torstai;19;19;38;9;4;13
294;12.10.2017;2017;10;18;Torstai;12;10;22;14;12;26
294;12.10.2017;2017;10;19;Torstai;15;20;35;11;9;20
294;12.10.2017;2017;10;20;Torstai;5;10;15;7;2;9
294;12.10.2017;2017;10;21;Torstai;0;0;0;4;0;4
294;12.10.2017;2017;10;22;Torstai;0;0;0;0;0;0
294;12.10.2017;2017;10;23;Torstai;0;0;0;0;0;0
294;13.10.2017;2017;10;00;Perjantai;0;0;0;0;0;0
294;13.10.2017;2017;10;01;Perjantai;0;0;0;0;0;0
294;13.10.2017;2017;10;02;Perjantai;0;0;0;0;0;0
294;13.10.2017;2017;10;03;Perjantai;0;0;0;0;0;0
294;13.10.2017;2017;10;04;Perjantai;0;0;0;0;0;0
294;13.10.2017;2017;10;05;Perjantai;0;0;0;0;2;2
294;13.10.2017;2017;10;06;Perjantai;5;0;5;0;2;2
294;13.10.2017;2017;10;07;Perjantai;18;15;33;4;2;6
294;13.10.2017;2017;10;08;Perjantai;18;8;26;4;3;7
294;13.10.2017;2017;10;09;Perjantai;16;10;26;17;7;24
294;13.10.2017;2017;10;10;Perjantai;10;14;24;7;20;27
294;13.10.2017;2017;10;11;Perjantai;11;14;25;11;6;17
294;13.10.2017;2017;10;12;Perjantai;20;31;51;14;15;29
294;13.10.2017;2017;10;13;Perjantai;19;20;39;13;14;27
294;13.10.2017;2017;10;14;Perjantai;34;32;66;11;7;18
294;13.10.2017;2017;10;15;Perjantai;20;19;39;9;12;21
294;13.10.2017;2017;10;16;Perjantai;16;19;35;6;12;18
294;13.10.2017;2017;10;17;Perjantai;16;14;30;11;18;29
294;13.10.2017;2017;10;18;Perjantai;13;11;24;14;14;28
294;13.10.2017;2017;10;19;Perjantai;6;4;10;16;12;28
294;13.10.2017;2017;10;20;Perjantai;7;17;24;4;6;10
294;13.10.2017;2017;10;21;Perjantai;12;6;18;4;1;5
294;13.10.2017;2017;10;22;Perjantai;0;0;0;0;0;0
294;13.10.2017;2017;10;23;Perjantai;0;0;0;0;0;0
294;14.10.2017;2017;10;00;Lauantai;0;1;1;1;0;1
294;14.10.2017;2017;10;01;Lauantai;0;0;0;0;0;0
294;14.10.2017;2017;10;02;Lauantai;0;0;0;0;1;1
294;14.10.2017;2017;10;03;Lauantai;0;0;0;0;0;0
294;14.10.2017;2017;10;04;Lauantai;0;0;0;0;0;0
294;14.10.2017;2017;10;05;Lauantai;0;1;1;2;0;2
294;14.10.2017;2017;10;06;Lauantai;0;0;0;1;0;1
294;14.10.2017;2017;10;07;Lauantai;0;0;0;1;1;2
294;14.10.2017;2017;10;08;Lauantai;4;4;8;5;1;6
294;14.10.2017;2017;10;09;Lauantai;6;6;12;8;8;16
294;14.10.2017;2017;10;10;Lauantai;18;11;29;15;13;28
294;14.10.2017;2017;10;11;Lauantai;17;27;44;9;6;15
294;14.10.2017;2017;10;12;Lauantai;18;16;34;9;8;17
294;14.10.2017;2017;10;13;Lauantai;23;26;49;11;6;17
294;14.10.2017;2017;10;14;Lauantai;26;19;45;11;10;21
294;14.10.2017;2017;10;15;Lauantai;16;26;42;16;12;28
294;14.10.2017;2017;10;16;Lauantai;20;18;38;8;10;18
294;14.10.2017;2017;10;17;Lauantai;2;7;9;1;5;6
294;14.10.2017;2017;10;18;Lauantai;11;12;23;2;4;6
294;14.10.2017;2017;10;19;Lauantai;3;3;6;2;2;4
294;14.10.2017;2017;10;20;Lauantai;8;4;12;2;5;7
294;14.10.2017;2017;10;21;Lauantai;5;9;14;5;2;7
294;14.10.2017;2017;10;22;Lauantai;1;3;4;2;0;2
294;14.10.2017;2017;10;23;Lauantai;1;0;1;0;0;0
294;15.10.2017;2017;10;00;Sunnuntai;0;0;0;0;0;0
294;15.10.2017;2017;10;01;Sunnuntai;0;0;0;0;0;0
294;15.10.2017;2017;10;02;Sunnuntai;0;0;0;0;0;0
294;15.10.2017;2017;10;03;Sunnuntai;0;0;0;0;0;0
294;15.10.2017;2017;10;04;Sunnuntai;0;0;0;1;0;1
294;15.10.2017;2017;10;05;Sunnuntai;0;0;0;0;0;0
294;15.10.2017;2017;10;06;Sunnuntai;0;0;0;0;0;0
294;15.10.2017;2017;10;07;Sunnuntai;0;0;0;0;0;0
294;15.10.2017;2017;10;08;Sunnuntai;0;0;0;2;2;4
294;15.10.2017;2017;10;09;Sunnuntai;3;2;5;6;4;10
294;15.10.2017;2017;10;10;Sunnuntai;2;3;5;8;8;16
294;15.10.2017;2017;10;11;Sunnuntai;6;3;9;2;5;7
294;15.10.2017;2017;10;12;Sunnuntai;8;5;13;7;8;15
294;15.10.2017;2017;10;13;Sunnuntai;4;11;15;12;9;21
294;15.10.2017;2017;10;14;Sunnuntai;9;4;13;11;9;20
294;15.10.2017;2017;10;15;Sunnuntai;13;18;31;14;11;25
294;15.10.2017;2017;10;16;Sunnuntai;8;8;16;15;6;21
294;15.10.2017;2017;10;17;Sunnuntai;12;10;22;14;10;24
294;15.10.2017;2017;10;18;Sunnuntai;10;15;25;9;11;20
294;15.10.2017;2017;10;19;Sunnuntai;8;6;14;18;10;28
294;15.10.2017;2017;10;20;Sunnuntai;6;4;10;3;2;5
294;15.10.2017;2017;10;21;Sunnuntai;1;0;1;1;0;1
294;15.10.2017;2017;10;22;Sunnuntai;0;1;1;0;0;0
294;15.10.2017;2017;10;23;Sunnuntai;0;0;0;2;0;2
294;16.10.2017;2017;10;00;Maanantai;0;0;0;0;0;0
294;16.10.2017;2017;10;01;Maanantai;0;0;0;0;0;0
294;16.10.2017;2017;10;02;Maanantai;0;0;0;0;0;0
294;16.10.2017;2017;10;03;Maanantai;0;0;0;0;0;0
294;16.10.2017;2017;10;04;Maanantai;0;0;0;0;0;0
294;16.10.2017;2017;10;05;Maanantai;0;0;0;0;1;1
294;16.10.2017;2017;10;06;Maanantai;2;1;3;1;1;2
294;16.10.2017;2017;10;07;Maanantai;22;13;35;8;3;11
294;16.10.2017;2017;10;08;Maanantai;21;8;29;7;7;14
294;16.10.2017;2017;10;09;Maanantai;16;10;26;9;6;15
294;16.10.2017;2017;10;10;Maanantai;1;3;4;6;2;8
294;16.10.2017;2017;10;11;Maanantai;4;6;10;23;17;40
294;16.10.2017;2017;10;12;Maanantai;11;3;14;9;5;14
294;16.10.2017;2017;10;13;Maanantai;14;16;30;6;7;13
294;16.10.2017;2017;10;14;Maanantai;15;13;28;7;10;17
294;16.10.2017;2017;10;15;Maanantai;18;27;45;6;4;10
294;16.10.2017;2017;10;16;Maanantai;18;27;45;8;14;22
294;16.10.2017;2017;10;17;Maanantai;6;13;19;15;13;28
294;16.10.2017;2017;10;18;Maanantai;5;7;12;13;14;27
294;16.10.2017;2017;10;19;Maanantai;8;5;13;14;12;26
294;16.10.2017;2017;10;20;Maanantai;1;1;2;3;1;4
294;16.10.2017;2017;10;21;Maanantai;1;1;2;2;2;4
294;16.10.2017;2017;10;22;Maanantai;1;0;1;0;0;0
294;16.10.2017;2017;10;23;Maanantai;0;0;0;0;0;0
294;17.10.2017;2017;10;00;Tiistai;0;0;0;0;0;0
294;17.10.2017;2017;10;01;Tiistai;0;0;0;0;0;0
294;17.10.2017;2017;10;02;Tiistai;0;0;0;0;0;0
294;17.10.2017;2017;10;03;Tiistai;0;0;0;0;0;0
294;17.10.2017;2017;10;04;Tiistai;0;0;0;0;0;0
294;17.10.2017;2017;10;05;Tiistai;0;0;0;0;0;0
294;17.10.2017;2017;10;06;Tiistai;3;1;4;2;2;4
294;17.10.2017;2017;10;07;Tiistai;13;11;24;7;5;12
294;17.10.2017;2017;10;08;Tiistai;25;3;28;4;2;6
294;17.10.2017;2017;10;09;Tiistai;28;3;31;14;4;18
294;17.10.2017;2017;10;10;Tiistai;10;9;19;5;11;16
294;17.10.2017;2017;10;11;Tiistai;8;14;22;15;10;25
294;17.10.2017;2017;10;12;Tiistai;11;10;21;10;9;19
294;17.10.2017;2017;10;13;Tiistai;6;17;23;14;13;27
294;17.10.2017;2017;10;14;Tiistai;16;26;42;7;12;19
294;17.10.2017;2017;10;15;Tiistai;17;16;33;10;12;22
294;17.10.2017;2017;10;16;Tiistai;16;15;31;9;6;15
294;17.10.2017;2017;10;17;Tiistai;14;13;27;15;15;30
294;17.10.2017;2017;10;18;Tiistai;12;10;22;15;10;25
294;17.10.2017;2017;10;19;Tiistai;6;3;9;11;10;21
294;17.10.2017;2017;10;20;Tiistai;3;7;10;2;9;11
294;17.10.2017;2017;10;21;Tiistai;3;0;3;1;0;1
294;17.10.2017;2017;10;22;Tiistai;0;0;0;0;1;1
294;17.10.2017;2017;10;23;Tiistai;0;0;0;0;0;0
294;18.10.2017;2017;10;00;Keskiviikko;0;0;0;0;0;0
294;18.10.2017;2017;10;01;Keskiviikko;0;0;0;0;0;0
294;18.10.2017;2017;10;02;Keskiviikko;0;0;0;0;0;0
294;18.10.2017;2017;10;03;Keskiviikko;0;0;0;0;0;0
294;18.10.2017;2017;10;04;Keskiviikko;0;0;0;0;0;0
294;18.10.2017;2017;10;05;Keskiviikko;0;0;0;0;1;1
294;18.10.2017;2017;10;06;Keskiviikko;4;0;4;1;0;1
294;18.10.2017;2017;10;07;Keskiviikko;11;4;15;9;5;14
294;18.10.2017;2017;10;08;Keskiviikko;21;10;31;9;1;10
294;18.10.2017;2017;10;09;Keskiviikko;10;7;17;10;3;13
294;18.10.2017;2017;10;10;Keskiviikko;5;7;12;2;7;9
294;18.10.2017;2017;10;11;Keskiviikko;10;5;15;14;6;20
294;18.10.2017;2017;10;12;Keskiviikko;9;15;24;11;13;24
294;18.10.2017;2017;10;13;Keskiviikko;12;13;25;8;11;19
294;18.10.2017;2017;10;14;Keskiviikko;8;36;44;5;14;19
294;18.10.2017;2017;10;15;Keskiviikko;23;19;42;7;8;15
294;18.10.2017;2017;10;16;Keskiviikko;16;19;35;11;11;22
294;18.10.2017;2017;10;17;Keskiviikko;9;11;20;9;9;18
294;18.10.2017;2017;10;18;Keskiviikko;13;9;22;6;19;25
294;18.10.2017;2017;10;19;Keskiviikko;8;14;22;10;7;17
294;18.10.2017;2017;10;20;Keskiviikko;8;5;13;4;4;8
294;18.10.2017;2017;10;21;Keskiviikko;3;1;4;1;2;3
294;18.10.2017;2017;10;22;Keskiviikko;0;1;1;1;0;1
294;18.10.2017;2017;10;23;Keskiviikko;0;0;0;0;0;0
294;19.10.2017;2017;10;00;Torstai;0;0;0;0;0;0
294;19.10.2017;2017;10;01;Torstai;0;0;0;0;0;0
294;19.10.2017;2017;10;02;Torstai;0;0;0;0;0;0
294;19.10.2017;2017;10;03;Torstai;0;0;0;0;0;0
294;19.10.2017;2017;10;04;Torstai;0;0;0;1;0;1
294;19.10.2017;2017;10;05;Torstai;1;0;1;0;2;2
294;19.10.2017;2017;10;06;Torstai;2;1;3;0;1;1
294;19.10.2017;2017;10;07;Torstai;12;3;15;2;7;9
294;19.10.2017;2017;10;08;Torstai;17;6;23;2;4;6
294;19.10.2017;2017;10;09;Torstai;27;13;40;7;18;25
294;19.10.2017;2017;10;10;Torstai;6;6;12;9;9;18
294;19.10.2017;2017;10;11;Torstai;4;9;13;13;14;27
294;19.10.2017;2017;10;12;Torstai;9;13;22;13;22;35
294;19.10.2017;2017;10;13;Torstai;7;21;28;8;14;22
294;19.10.2017;2017;10;14;Torstai;16;27;43;17;8;25
294;19.10.2017;2017;10;15;Torstai;23;38;61;7;14;21
294;19.10.2017;2017;10;16;Torstai;24;15;39;18;7;25
294;19.10.2017;2017;10;17;Torstai;14;20;34;9;13;22
294;19.10.2017;2017;10;18;Torstai;8;7;15;11;14;25
294;19.10.2017;2017;10;19;Torstai;16;9;25;7;12;19
294;19.10.2017;2017;10;20;Torstai;5;7;12;9;4;13
294;19.10.2017;2017;10;21;Torstai;4;1;5;3;1;4
294;19.10.2017;2017;10;22;Torstai;0;0;0;1;3;4
294;19.10.2017;2017;10;23;Torstai;0;0;0;1;0;1
294;20.10.2017;2017;10;00;Perjantai;0;0;0;0;0;0
294;20.10.2017;2017;10;01;Perjantai;0;0;0;0;0;0
294;20.10.2017;2017;10;02;Perjantai;0;0;0;0;0;0
294;20.10.2017;2017;10;03;Perjantai;0;0;0;0;0;0
294;20.10.2017;2017;10;04;Perjantai;0;0;0;0;0;0
294;20.10.2017;2017;10;05;Perjantai;0;0;0;0;0;0
294;20.10.2017;2017;10;06;Perjantai;3;0;3;2;1;3
294;20.10.2017;2017;10;07;Perjantai;17;7;24;5;5;10
294;20.10.2017;2017;10;08;Perjantai;15;4;19;9;6;15
294;20.10.2017;2017;10;09;Perjantai;9;5;14;21;6;27
294;20.10.2017;2017;10;10;Perjantai;4;6;10;8;9;17
294;20.10.2017;2017;10;11;Perjantai;4;5;9;10;17;27
294;20.10.2017;2017;10;12;Perjantai;7;22;29;15;20;35
294;20.10.2017;2017;10;13;Perjantai;11;23;34;10;15;25
294;20.10.2017;2017;10;14;Perjantai;13;20;33;10;12;22
294;20.10.2017;2017;10;15;Perjantai;15;16;31;10;14;24
294;20.10.2017;2017;10;16;Perjantai;6;15;21;8;17;25
294;20.10.2017;2017;10;17;Perjantai;12;14;26;17;12;29
294;20.10.2017;2017;10;18;Perjantai;9;20;29;9;7;16
294;20.10.2017;2017;10;19;Perjantai;11;2;13;7;5;12
294;20.10.2017;2017;10;20;Perjantai;12;9;21;6;7;13
294;20.10.2017;2017;10;21;Perjantai;6;5;11;1;3;4
294;20.10.2017;2017;10;22;Perjantai;2;5;7;4;3;7
294;20.10.2017;2017;10;23;Perjantai;6;0;6;2;0;2
294;21.10.2017;2017;10;00;Lauantai;0;0;0;0;0;0
294;21.10.2017;2017;10;01;Lauantai;0;0;0;0;0;0
294;21.10.2017;2017;10;02;Lauantai;0;0;0;0;1;1
294;21.10.2017;2017;10;03;Lauantai;0;0;0;0;0;0
294;21.10.2017;2017;10;04;Lauantai;0;0;0;0;0;0
294;21.10.2017;2017;10;05;Lauantai;0;0;0;0;0;0
294;21.10.2017;2017;10;06;Lauantai;0;2;2;2;2;4
294;21.10.2017;2017;10;07;Lauantai;0;0;0;1;3;4
294;21.10.2017;2017;10;08;Lauantai;1;1;2;4;2;6
294;21.10.2017;2017;10;09;Lauantai;2;3;5;7;5;12
294;21.10.2017;2017;10;10;Lauantai;4;5;9;13;9;22
294;21.10.2017;2017;10;11;Lauantai;5;3;8;11;15;26
294;21.10.2017;2017;10;12;Lauantai;11;10;21;17;14;31
294;21.10.2017;2017;10;13;Lauantai;6;12;18;10;15;25
294;21.10.2017;2017;10;14;Lauantai;8;12;20;9;7;16
294;21.10.2017;2017;10;15;Lauantai;6;12;18;11;9;20
294;21.10.2017;2017;10;16;Lauantai;11;5;16;14;9;23
294;21.10.2017;2017;10;17;Lauantai;4;7;11;19;8;27
294;21.10.2017;2017;10;18;Lauantai;9;11;20;7;5;12
294;21.10.2017;2017;10;19;Lauantai;4;4;8;6;3;9
294;21.10.2017;2017;10;20;Lauantai;7;9;16;4;4;8
294;21.10.2017;2017;10;21;Lauantai;11;2;13;2;3;5
294;21.10.2017;2017;10;22;Lauantai;2;1;3;1;0;1
294;21.10.2017;2017;10;23;Lauantai;0;0;0;0;0;0
294;22.10.2017;2017;10;00;Sunnuntai;0;0;0;0;0;0
294;22.10.2017;2017;10;01;Sunnuntai;0;2;2;0;0;0
294;22.10.2017;2017;10;02;Sunnuntai;0;0;0;0;1;1
294;22.10.2017;2017;10;03;Sunnuntai;0;0;0;0;0;0
294;22.10.2017;2017;10;04;Sunnuntai;0;0;0;0;0;0
294;22.10.2017;2017;10;05;Sunnuntai;0;0;0;0;0;0
294;22.10.2017;2017;10;06;Sunnuntai;0;0;0;0;0;0
294;22.10.2017;2017;10;07;Sunnuntai;1;0;1;1;0;1
294;22.10.2017;2017;10;08;Sunnuntai;0;1;1;1;1;2
294;22.10.2017;2017;10;09;Sunnuntai;3;2;5;8;6;14
294;22.10.2017;2017;10;10;Sunnuntai;2;1;3;4;2;6
294;22.10.2017;2017;10;11;Sunnuntai;3;8;11;8;12;20
294;22.10.2017;2017;10;12;Sunnuntai;1;4;5;8;10;18
294;22.10.2017;2017;10;13;Sunnuntai;4;8;12;12;3;15
294;22.10.2017;2017;10;14;Sunnuntai;7;8;15;6;5;11
294;22.10.2017;2017;10;15;Sunnuntai;5;2;7;5;8;13
294;22.10.2017;2017;10;16;Sunnuntai;3;0;3;6;6;12
294;22.10.2017;2017;10;17;Sunnuntai;3;5;8;10;8;18
294;22.10.2017;2017;10;18;Sunnuntai;6;3;9;4;8;12
294;22.10.2017;2017;10;19;Sunnuntai;0;5;5;3;9;12
294;22.10.2017;2017;10;20;Sunnuntai;4;3;7;6;1;7
294;22.10.2017;2017;10;21;Sunnuntai;1;3;4;0;0;0
294;22.10.2017;2017;10;22;Sunnuntai;10;1;11;2;0;2
294;22.10.2017;2017;10;23;Sunnuntai;0;1;1;0;0;0
294;23.10.2017;2017;10;00;Maanantai;1;0;1;0;0;0
294;23.10.2017;2017;10;01;Maanantai;0;0;0;0;0;0
294;23.10.2017;2017;10;02;Maanantai;0;0;0;0;0;0
294;23.10.2017;2017;10;03;Maanantai;0;0;0;0;0;0
294;23.10.2017;2017;10;04;Maanantai;0;0;0;0;1;1
294;23.10.2017;2017;10;05;Maanantai;0;0;0;0;1;1
294;23.10.2017;2017;10;06;Maanantai;1;0;1;3;1;4
294;23.10.2017;2017;10;07;Maanantai;3;1;4;1;1;2
294;23.10.2017;2017;10;08;Maanantai;0;3;3;4;1;5
294;23.10.2017;2017;10;09;Maanantai;4;1;5;3;5;8
294;23.10.2017;2017;10;10;Maanantai;2;0;2;7;8;15
294;23.10.2017;2017;10;11;Maanantai;7;8;15;12;7;19
294;23.10.2017;2017;10;12;Maanantai;7;7;14;8;5;13
294;23.10.2017;2017;10;13;Maanantai;11;10;21;13;4;17
294;23.10.2017;2017;10;14;Maanantai;2;4;6;12;12;24
294;23.10.2017;2017;10;15;Maanantai;8;9;17;13;10;23
294;23.10.2017;2017;10;16;Maanantai;10;6;16;13;14;27
294;23.10.2017;2017;10;17;Maanantai;3;7;10;10;5;15
294;23.10.2017;2017;10;18;Maanantai;10;6;16;5;13;18
294;23.10.2017;2017;10;19;Maanantai;2;8;10;10;7;17
294;23.10.2017;2017;10;20;Maanantai;4;6;10;3;7;10
294;23.10.2017;2017;10;21;Maanantai;6;6;12;2;1;3
294;23.10.2017;2017;10;22;Maanantai;2;0;2;5;1;6
294;23.10.2017;2017;10;23;Maanantai;0;0;0;1;0;1
294;24.10.2017;2017;10;00;Tiistai;0;0;0;0;0;0
294;24.10.2017;2017;10;01;Tiistai;0;0;0;0;0;0
294;24.10.2017;2017;10;02;Tiistai;2;0;2;0;0;0
294;24.10.2017;2017;10;03;Tiistai;0;0;0;0;0;0
294;24.10.2017;2017;10;04;Tiistai;0;0;0;0;1;1
294;24.10.2017;2017;10;05;Tiistai;0;0;0;0;1;1
294;24.10.2017;2017;10;06;Tiistai;0;0;0;2;2;4
294;24.10.2017;2017;10;07;Tiistai;1;1;2;4;2;6
294;24.10.2017;2017;10;08;Tiistai;4;1;5;2;1;3
294;24.10.2017;2017;10;09;Tiistai;1;1;2;4;2;6
294;24.10.2017;2017;10;10;Tiistai;5;1;6;11;5;16
294;24.10.2017;2017;10;11;Tiistai;5;4;9;9;17;26
294;24.10.2017;2017;10;12;Tiistai;7;11;18;17;15;32
294;24.10.2017;2017;10;13;Tiistai;12;6;18;11;11;22
294;24.10.2017;2017;10;14;Tiistai;6;11;17;12;7;19
294;24.10.2017;2017;10;15;Tiistai;7;6;13;11;8;19
294;24.10.2017;2017;10;16;Tiistai;11;8;19;19;7;26
294;24.10.2017;2017;10;17;Tiistai;4;4;8;7;11;18
294;24.10.2017;2017;10;18;Tiistai;4;3;7;10;13;23
294;24.10.2017;2017;10;19;Tiistai;2;3;5;10;9;19
294;24.10.2017;2017;10;20;Tiistai;2;0;2;5;7;12
294;24.10.2017;2017;10;21;Tiistai;9;2;11;6;2;8
294;24.10.2017;2017;10;22;Tiistai;0;0;0;1;1;2
294;24.10.2017;2017;10;23;Tiistai;0;0;0;0;0;0
294;25.10.2017;2017;10;00;Keskiviikko;0;0;0;0;0;0
294;25.10.2017;2017;10;01;Keskiviikko;0;0;0;0;0;0
294;25.10.2017;2017;10;02;Keskiviikko;0;0;0;0;0;0
294;25.10.2017;2017;10;03;Keskiviikko;0;0;0;2;0;2
294;25.10.2017;2017;10;04;Keskiviikko;0;0;0;0;0;0
294;25.10.2017;2017;10;05;Keskiviikko;0;0;0;0;0;0
294;25.10.2017;2017;10;06;Keskiviikko;0;1;1;1;2;3
294;25.10.2017;2017;10;07;Keskiviikko;3;0;3;3;1;4
294;25.10.2017;2017;10;08;Keskiviikko;1;0;1;3;2;5
294;25.10.2017;2017;10;09;Keskiviikko;3;5;8;4;7;11
294;25.10.2017;2017;10;10;Keskiviikko;5;7;12;8;5;13
294;25.10.2017;2017;10;11;Keskiviikko;7;3;10;6;2;8
294;25.10.2017;2017;10;12;Keskiviikko;5;6;11;7;4;11
294;25.10.2017;2017;10;13;Keskiviikko;10;3;13;3;9;12
294;25.10.2017;2017;10;14;Keskiviikko;6;3;9;11;8;19
294;25.10.2017;2017;10;15;Keskiviikko;4;2;6;5;4;9
294;25.10.2017;2017;10;16;Keskiviikko;8;8;16;16;13;29
294;25.10.2017;2017;10;17;Keskiviikko;11;7;18;9;9;18
294;25.10.2017;2017;10;18;Keskiviikko;3;3;6;11;9;20
294;25.10.2017;2017;10;19;Keskiviikko;2;7;9;12;6;18
294;25.10.2017;2017;10;20;Keskiviikko;2;1;3;1;1;2
294;25.10.2017;2017;10;21;Keskiviikko;2;1;3;5;0;5
294;25.10.2017;2017;10;22;Keskiviikko;1;2;3;0;1;1
294;25.10.2017;2017;10;23;Keskiviikko;0;1;1;0;0;0
294;26.10.2017;2017;10;00;Torstai;1;0;1;0;0;0
294;26.10.2017;2017;10;01;Torstai;0;0;0;0;0;0
294;26.10.2017;2017;10;02;Torstai;1;1;2;0;0;0
294;26.10.2017;2017;10;03;Torstai;0;0;0;0;0;0
294;26.10.2017;2017;10;04;Torstai;0;0;0;0;1;1
294;26.10.2017;2017;10;05;Torstai;0;0;0;0;1;1
294;26.10.2017;2017;10;06;Torstai;1;0;1;0;2;2
294;26.10.2017;2017;10;07;Torstai;0;2;2;4;3;7
294;26.10.2017;2017;10;08;Torstai;2;0;2;4;1;5
294;26.10.2017;2017;10;09;Torstai;4;3;7;5;3;8
294;26.10.2017;2017;10;10;Torstai;1;6;7;3;8;11
294;26.10.2017;2017;10;11;Torstai;9;3;12;11;12;23
294;26.10.2017;2017;10;12;Torstai;6;11;17;15;12;27
294;26.10.2017;2017;10;13;Torstai;10;3;13;13;10;23
294;26.10.2017;2017;10;14;Torstai;5;5;10;12;9;21
294;26.10.2017;2017;10;15;Torstai;10;7;17;8;4;12
294;26.10.2017;2017;10;16;Torstai;8;8;16;8;10;18
294;26.10.2017;2017;10;17;Torstai;4;1;5;10;9;19
294;26.10.2017;2017;10;18;Torstai;7;11;18;15;16;31
294;26.10.2017;2017;10;19;Torstai;5;6;11;5;7;12
294;26.10.2017;2017;10;20;Torstai;5;1;6;5;2;7
294;26.10.2017;2017;10;21;Torstai;0;2;2;2;3;5
294;26.10.2017;2017;10;22;Torstai;2;2;4;3;0;3
294;26.10.2017;2017;10;23;Torstai;0;0;0;0;0;0
294;27.10.2017;2017;10;00;Perjantai;0;0;0;0;1;1
294;27.10.2017;2017;10;01;Perjantai;0;0;0;0;0;0
294;27.10.2017;2017;10;02;Perjantai;0;0;0;0;0;0
294;27.10.2017;2017;10;03;Perjantai;0;0;0;0;0;0
294;27.10.2017;2017;10;04;Perjantai;0;0;0;0;0;0
294;27.10.2017;2017;10;05;Perjantai;0;0;0;0;1;1
294;27.10.2017;2017;10;06;Perjantai;0;1;1;1;0;1
294;27.10.2017;2017;10;07;Perjantai;1;0;1;7;0;7
294;27.10.2017;2017;10;08;Perjantai;3;1;4;6;1;7
294;27.10.2017;2017;10;09;Perjantai;1;3;4;2;4;6
294;27.10.2017;2017;10;10;Perjantai;12;3;15;7;9;16
294;27.10.2017;2017;10;11;Perjantai;4;10;14;8;8;16
294;27.10.2017;2017;10;12;Perjantai;11;12;23;14;7;21
294;27.10.2017;2017;10;13;Perjantai;7;4;11;9;8;17
294;27.10.2017;2017;10;14;Perjantai;7;5;12;10;7;17
294;27.10.2017;2017;10;15;Perjantai;10;4;14;5;8;13
294;27.10.2017;2017;10;16;Perjantai;6;13;19;8;10;18
294;27.10.2017;2017;10;17;Perjantai;12;5;17;16;8;24
294;27.10.2017;2017;10;18;Perjantai;10;10;20;12;14;26
294;27.10.2017;2017;10;19;Perjantai;4;4;8;8;4;12
294;27.10.2017;2017;10;20;Perjantai;1;5;6;1;5;6
294;27.10.2017;2017;10;21;Perjantai;1;3;4;1;5;6
294;27.10.2017;2017;10;22;Perjantai;1;2;3;1;0;1
294;27.10.2017;2017;10;23;Perjantai;1;0;1;3;0;3
294;28.10.2017;2017;10;00;Lauantai;1;0;1;0;0;0
294;28.10.2017;2017;10;01;Lauantai;1;0;1;0;0;0
294;28.10.2017;2017;10;02;Lauantai;0;1;1;0;0;0
294;28.10.2017;2017;10;03;Lauantai;0;1;1;0;0;0
294;28.10.2017;2017;10;04;Lauantai;1;0;1;0;0;0
294;28.10.2017;2017;10;05;Lauantai;1;0;1;0;0;0
294;28.10.2017;2017;10;06;Lauantai;0;1;1;1;0;1
294;28.10.2017;2017;10;07;Lauantai;1;1;2;2;0;2
294;28.10.2017;2017;10;08;Lauantai;1;1;2;0;0;0
294;28.10.2017;2017;10;09;Lauantai;1;0;1;4;6;10
294;28.10.2017;2017;10;10;Lauantai;2;3;5;3;4;7
294;28.10.2017;2017;10;11;Lauantai;4;1;5;9;10;19
294;28.10.2017;2017;10;12;Lauantai;5;3;8;6;3;9
294;28.10.2017;2017;10;13;Lauantai;4;3;7;7;5;12
294;28.10.2017;2017;10;14;Lauantai;6;5;11;7;9;16
294;28.10.2017;2017;10;15;Lauantai;4;3;7;13;7;20
294;28.10.2017;2017;10;16;Lauantai;2;4;6;8;7;15
294;28.10.2017;2017;10;17;Lauantai;9;4;13;3;5;8
294;28.10.2017;2017;10;18;Lauantai;9;3;12;6;6;12
294;28.10.2017;2017;10;19;Lauantai;8;4;12;7;7;14
294;28.10.2017;2017;10;20;Lauantai;4;2;6;4;4;8
294;28.10.2017;2017;10;21;Lauantai;0;1;1;0;0;0
294;28.10.2017;2017;10;22;Lauantai;3;0;3;1;0;1
294;28.10.2017;2017;10;23;Lauantai;1;0;1;1;0;1
294;29.10.2017;2017;10;00;Sunnuntai;1;0;1;0;0;0
294;29.10.2017;2017;10;01;Sunnuntai;0;2;2;0;1;1
294;29.10.2017;2017;10;02;Sunnuntai;0;0;0;0;0;0
294;29.10.2017;2017;10;03;Sunnuntai;1;1;2;1;1;2
294;29.10.2017;2017;10;04;Sunnuntai;0;0;0;0;0;0
294;29.10.2017;2017;10;05;Sunnuntai;0;0;0;0;0;0
294;29.10.2017;2017;10;06;Sunnuntai;3;0;3;11;5;16
294;29.10.2017;2017;10;07;Sunnuntai;0;0;0;1;1;2
294;29.10.2017;2017;10;08;Sunnuntai;0;0;0;6;1;7
294;29.10.2017;2017;10;09;Sunnuntai;1;1;2;7;6;13
294;29.10.2017;2017;10;10;Sunnuntai;2;3;5;2;8;10
294;29.10.2017;2017;10;11;Sunnuntai;1;1;2;7;3;10
294;29.10.2017;2017;10;12;Sunnuntai;0;3;3;3;10;13
294;29.10.2017;2017;10;13;Sunnuntai;0;1;1;12;10;22
294;29.10.2017;2017;10;14;Sunnuntai;1;0;1;6;7;13
294;29.10.2017;2017;10;15;Sunnuntai;5;2;7;6;5;11
294;29.10.2017;2017;10;16;Sunnuntai;1;0;1;5;12;17
294;29.10.2017;2017;10;17;Sunnuntai;3;7;10;7;10;17
294;29.10.2017;2017;10;18;Sunnuntai;9;1;10;8;6;14
294;29.10.2017;2017;10;19;Sunnuntai;2;1;3;5;6;11
294;29.10.2017;2017;10;20;Sunnuntai;0;0;0;3;3;6
294;29.10.2017;2017;10;21;Sunnuntai;1;0;1;1;0;1
294;29.10.2017;2017;10;22;Sunnuntai;0;0;0;0;0;0
294;29.10.2017;2017;10;23;Sunnuntai;1;0;1;2;1;3
294;30.10.2017;2017;10;00;Maanantai;0;0;0;0;0;0
294;30.10.2017;2017;10;01;Maanantai;0;0;0;0;0;0
294;30.10.2017;2017;10;02;Maanantai;0;0;0;0;0;0
294;30.10.2017;2017;10;03;Maanantai;0;0;0;0;0;0
294;30.10.2017;2017;10;04;Maanantai;0;0;0;0;0;0
294;30.10.2017;2017;10;05;Maanantai;0;0;0;0;1;1
294;30.10.2017;2017;10;06;Maanantai;3;1;4;3;0;3
294;30.10.2017;2017;10;07;Maanantai;16;6;22;5;2;7
294;30.10.2017;2017;10;08;Maanantai;20;1;21;7;2;9
294;30.10.2017;2017;10;09;Maanantai;9;4;13;4;13;17
294;30.10.2017;2017;10;10;Maanantai;8;4;12;16;12;28
294;30.10.2017;2017;10;11;Maanantai;4;8;12;25;20;45
294;30.10.2017;2017;10;12;Maanantai;3;1;4;18;15;33
294;30.10.2017;2017;10;13;Maanantai;6;14;20;12;23;35
294;30.10.2017;2017;10;14;Maanantai;9;18;27;13;18;31
294;30.10.2017;2017;10;15;Maanantai;7;11;18;10;12;22
294;30.10.2017;2017;10;16;Maanantai;7;11;18;11;14;25
294;30.10.2017;2017;10;17;Maanantai;4;7;11;14;14;28
294;30.10.2017;2017;10;18;Maanantai;6;3;9;17;11;28
294;30.10.2017;2017;10;19;Maanantai;4;3;7;6;13;19
294;30.10.2017;2017;10;20;Maanantai;0;3;3;2;1;3
294;30.10.2017;2017;10;21;Maanantai;2;0;2;4;0;4
294;30.10.2017;2017;10;22;Maanantai;0;2;2;0;0;0
294;30.10.2017;2017;10;23;Maanantai;0;0;0;0;0;0
294;31.10.2017;2017;10;00;Tiistai;0;0;0;0;0;0
294;31.10.2017;2017;10;01;Tiistai;0;0;0;0;0;0
294;31.10.2017;2017;10;02;Tiistai;0;0;0;0;0;0
294;31.10.2017;2017;10;03;Tiistai;0;0;0;0;0;0
294;31.10.2017;2017;10;04;Tiistai;0;0;0;0;0;0
294;31.10.2017;2017;10;05;Tiistai;0;0;0;2;0;2
294;31.10.2017;2017;10;06;Tiistai;0;0;0;2;1;3
294;31.10.2017;2017;10;07;Tiistai;8;14;22;5;2;7
294;31.10.2017;2017;10;08;Tiistai;24;1;25;9;3;12
294;31.10.2017;2017;10;09;Tiistai;21;6;27;18;9;27
294;31.10.2017;2017;10;10;Tiistai;4;2;6;11;11;22
294;31.10.2017;2017;10;11;Tiistai;5;5;10;16;17;33
294;31.10.2017;2017;10;12;Tiistai;5;4;9;16;20;36
294;31.10.2017;2017;10;13;Tiistai;6;12;18;21;18;39
294;31.10.2017;2017;10;14;Tiistai;4;9;13;7;21;28
294;31.10.2017;2017;10;15;Tiistai;12;18;30;15;22;37
294;31.10.2017;2017;10;16;Tiistai;7;6;13;10;14;24
294;31.10.2017;2017;10;17;Tiistai;5;6;11;5;20;25
294;31.10.2017;2017;10;18;Tiistai;1;4;5;14;14;28
294;31.10.2017;2017;10;19;Tiistai;1;3;4;6;8;14
294;31.10.2017;2017;10;20;Tiistai;2;1;3;10;3;13
294;31.10.2017;2017;10;21;Tiistai;0;1;1;0;2;2
294;31.10.2017;2017;10;22;Tiistai;0;0;0;1;0;1
294;31.10.2017;2017;10;23;Tiistai;0;0;0;0;0;0
294;01.11.2017;2017;11;00;Keskiviikko;0;0;0;0;0;0
294;01.11.2017;2017;11;01;Keskiviikko;0;0;0;0;0;0
294;01.11.2017;2017;11;02;Keskiviikko;0;0;0;0;0;0
294;01.11.2017;2017;11;03;Keskiviikko;0;0;0;0;0;0
294;01.11.2017;2017;11;04;Keskiviikko;0;0;0;0;0;0
294;01.11.2017;2017;11;05;Keskiviikko;0;0;0;2;1;3
294;01.11.2017;2017;11;06;Keskiviikko;1;1;2;3;1;4
294;01.11.2017;2017;11;07;Keskiviikko;15;4;19;9;1;10
294;01.11.2017;2017;11;08;Keskiviikko;16;3;19;8;2;10
294;01.11.2017;2017;11;09;Keskiviikko;9;4;13;11;12;23
294;01.11.2017;2017;11;10;Keskiviikko;3;2;5;11;5;16
294;01.11.2017;2017;11;11;Keskiviikko;3;9;12;15;19;34
294;01.11.2017;2017;11;12;Keskiviikko;2;4;6;27;13;40
294;01.11.2017;2017;11;13;Keskiviikko;3;12;15;14;14;28
294;01.11.2017;2017;11;14;Keskiviikko;3;15;18;12;12;24
294;01.11.2017;2017;11;15;Keskiviikko;8;7;15;12;11;23
294;01.11.2017;2017;11;16;Keskiviikko;4;11;15;12;9;21
294;01.11.2017;2017;11;17;Keskiviikko;7;6;13;12;11;23
294;01.11.2017;2017;11;18;Keskiviikko;12;1;13;13;9;22
294;01.11.2017;2017;11;19;Keskiviikko;5;4;9;9;9;18
294;01.11.2017;2017;11;20;Keskiviikko;1;5;6;1;7;8
294;01.11.2017;2017;11;21;Keskiviikko;1;0;1;0;0;0
294;01.11.2017;2017;11;22;Keskiviikko;0;0;0;0;0;0
294;01.11.2017;2017;11;23;Keskiviikko;0;0;0;1;0;1
294;02.11.2017;2017;11;00;Torstai;1;0;1;0;0;0
294;02.11.2017;2017;11;01;Torstai;0;0;0;0;0;0
294;02.11.2017;2017;11;02;Torstai;1;1;2;0;0;0
294;02.11.2017;2017;11;03;Torstai;0;0;0;0;0;0
294;02.11.2017;2017;11;04;Torstai;0;0;0;0;2;2
294;02.11.2017;2017;11;05;Torstai;0;0;0;0;2;2
294;02.11.2017;2017;11;06;Torstai;1;0;1;0;3;3
294;02.11.2017;2017;11;07;Torstai;0;3;3;6;5;11
294;02.11.2017;2017;11;08;Torstai;3;0;3;6;2;8
294;02.11.2017;2017;11;09;Torstai;5;4;9;8;5;13
294;02.11.2017;2017;11;10;Torstai;1;8;9;5;12;17
294;02.11.2017;2017;11;11;Torstai;11;4;15;17;18;35
294;02.11.2017;2017;11;12;Torstai;8;14;22;23;18;41
294;02.11.2017;2017;11;13;Torstai;13;4;17;20;15;35
294;02.11.2017;2017;11;14;Torstai;6;6;12;18;14;32
294;02.11.2017;2017;11;15;Torstai;13;9;22;12;6;18
294;02.11.2017;2017;11;16;Torstai;10;10;20;12;15;27
294;02.11.2017;2017;11;17;Torstai;5;1;6;15;14;29
294;02.11.2017;2017;11;18;Torstai;9;14;23;23;24;47
294;02.11.2017;2017;11;19;Torstai;6;8;14;8;11;19
294;02.11.2017;2017;11;20;Torstai;6;1;7;8;3;11
294;02.11.2017;2017;11;21;Torstai;0;3;3;3;5;8
294;02.11.2017;2017;11;22;Torstai;3;3;6;5;0;5
294;02.11.2017;2017;11;23;Torstai;0;0;0;0;0;0
294;03.11.2017;2017;11;00;Perjantai;0;0;0;0;0;0
294;03.11.2017;2017;11;01;Perjantai;0;0;0;0;0;0
294;03.11.2017;2017;11;02;Perjantai;0;0;0;0;0;0
294;03.11.2017;2017;11;03;Perjantai;0;0;0;0;0;0
294;03.11.2017;2017;11;04;Perjantai;0;0;0;0;0;0
294;03.11.2017;2017;11;05;Perjantai;0;0;0;2;1;3
294;03.11.2017;2017;11;06;Perjantai;2;0;2;0;0;0
294;03.11.2017;2017;11;07;Perjantai;9;4;13;8;5;13
294;03.11.2017;2017;11;08;Perjantai;20;2;22;11;4;15
294;03.11.2017;2017;11;09;Perjantai;9;6;15;18;6;24
294;03.11.2017;2017;11;10;Perjantai;2;11;13;10;20;30
294;03.11.2017;2017;11;11;Perjantai;7;5;12;13;10;23
294;03.11.2017;2017;11;12;Perjantai;6;4;10;20;18;38
294;03.11.2017;2017;11;13;Perjantai;9;14;23;19;16;35
294;03.11.2017;2017;11;14;Perjantai;8;8;16;15;12;27
294;03.11.2017;2017;11;15;Perjantai;5;9;14;7;19;26
294;03.11.2017;2017;11;16;Perjantai;7;5;12;12;7;19
294;03.11.2017;2017;11;17;Perjantai;5;8;13;13;13;26
294;03.11.2017;2017;11;18;Perjantai;6;6;12;12;9;21
294;03.11.2017;2017;11;19;Perjantai;3;9;12;6;12;18
294;03.11.2017;2017;11;20;Perjantai;6;8;14;9;5;14
294;03.11.2017;2017;11;21;Perjantai;10;2;12;4;3;7
294;03.11.2017;2017;11;22;Perjantai;4;1;5;6;1;7
294;03.11.2017;2017;11;23;Perjantai;2;4;6;0;5;5
294;04.11.2017;2017;11;00;Lauantai;0;1;1;0;0;0
294;04.11.2017;2017;11;01;Lauantai;1;0;1;0;0;0
294;04.11.2017;2017;11;02;Lauantai;0;0;0;0;0;0
294;04.11.2017;2017;11;03;Lauantai;0;0;0;0;0;0
294;04.11.2017;2017;11;04;Lauantai;0;0;0;0;0;0
294;04.11.2017;2017;11;05;Lauantai;1;0;1;1;0;1
294;04.11.2017;2017;11;06;Lauantai;0;0;0;3;0;3
294;04.11.2017;2017;11;07;Lauantai;0;0;0;1;2;3
294;04.11.2017;2017;11;08;Lauantai;0;0;0;1;2;3
294;04.11.2017;2017;11;09;Lauantai;2;1;3;4;5;9
294;04.11.2017;2017;11;10;Lauantai;8;6;14;5;14;19
294;04.11.2017;2017;11;11;Lauantai;5;7;12;7;7;14
294;04.11.2017;2017;11;12;Lauantai;3;6;9;13;17;30
294;04.11.2017;2017;11;13;Lauantai;10;5;15;17;15;32
294;04.11.2017;2017;11;14;Lauantai;4;6;10;14;12;26
294;04.11.2017;2017;11;15;Lauantai;6;10;16;5;5;10
294;04.11.2017;2017;11;16;Lauantai;4;11;15;5;11;16
294;04.11.2017;2017;11;17;Lauantai;4;5;9;7;10;17
294;04.11.2017;2017;11;18;Lauantai;5;3;8;11;1;12
294;04.11.2017;2017;11;19;Lauantai;4;6;10;5;13;18
294;04.11.2017;2017;11;20;Lauantai;9;3;12;0;6;6
294;04.11.2017;2017;11;21;Lauantai;4;1;5;3;0;3
294;04.11.2017;2017;11;22;Lauantai;0;0;0;0;1;1
294;04.11.2017;2017;11;23;Lauantai;0;2;2;2;1;3
294;05.11.2017;2017;11;00;Sunnuntai;0;0;0;0;0;0
294;05.11.2017;2017;11;01;Sunnuntai;0;0;0;0;0;0
294;05.11.2017;2017;11;02;Sunnuntai;0;0;0;0;1;1
294;05.11.2017;2017;11;03;Sunnuntai;0;0;0;0;0;0
294;05.11.2017;2017;11;04;Sunnuntai;0;0;0;0;0;0
294;05.11.2017;2017;11;05;Sunnuntai;0;0;0;0;0;0
294;05.11.2017;2017;11;06;Sunnuntai;0;0;0;1;2;3
294;05.11.2017;2017;11;07;Sunnuntai;0;0;0;0;0;0
294;05.11.2017;2017;11;08;Sunnuntai;0;0;0;2;2;4
294;05.11.2017;2017;11;09;Sunnuntai;3;0;3;9;5;14
294;05.11.2017;2017;11;10;Sunnuntai;2;3;5;11;10;21
294;05.11.2017;2017;11;11;Sunnuntai;1;2;3;9;10;19
294;05.11.2017;2017;11;12;Sunnuntai;1;0;1;9;3;12
294;05.11.2017;2017;11;13;Sunnuntai;3;3;6;10;9;19
294;05.11.2017;2017;11;14;Sunnuntai;5;3;8;10;4;14
294;05.11.2017;2017;11;15;Sunnuntai;3;6;9;5;3;8
294;05.11.2017;2017;11;16;Sunnuntai;3;3;6;2;8;10
294;05.11.2017;2017;11;17;Sunnuntai;6;6;12;5;8;13
294;05.11.2017;2017;11;18;Sunnuntai;5;0;5;10;6;16
294;05.11.2017;2017;11;19;Sunnuntai;4;5;9;4;5;9
294;05.11.2017;2017;11;20;Sunnuntai;4;0;4;4;3;7
294;05.11.2017;2017;11;21;Sunnuntai;0;0;0;1;0;1
294;05.11.2017;2017;11;22;Sunnuntai;0;0;0;0;0;0
294;05.11.2017;2017;11;23;Sunnuntai;0;0;0;0;0;0
294;06.11.2017;2017;11;00;Maanantai;0;0;0;0;0;0
294;06.11.2017;2017;11;01;Maanantai;0;0;0;0;0;0
294;06.11.2017;2017;11;02;Maanantai;0;0;0;0;0;0
294;06.11.2017;2017;11;03;Maanantai;0;0;0;0;0;0
294;06.11.2017;2017;11;04;Maanantai;0;0;0;0;0;0
294;06.11.2017;2017;11;05;Maanantai;0;0;0;2;0;2
294;06.11.2017;2017;11;06;Maanantai;2;1;3;4;1;5
294;06.11.2017;2017;11;07;Maanantai;8;3;11;11;4;15
294;06.11.2017;2017;11;08;Maanantai;12;3;15;6;5;11
294;06.11.2017;2017;11;09;Maanantai;11;4;15;21;6;27
294;06.11.2017;2017;11;10;Maanantai;4;2;6;6;25;31
294;06.11.2017;2017;11;11;Maanantai;6;8;14;21;26;47
294;06.11.2017;2017;11;12;Maanantai;6;5;11;20;16;36
294;06.11.2017;2017;11;13;Maanantai;7;11;18;15;18;33
294;06.11.2017;2017;11;14;Maanantai;7;24;31;9;9;18
294;06.11.2017;2017;11;15;Maanantai;2;5;7;5;10;15
294;06.11.2017;2017;11;16;Maanantai;10;4;14;5;16;21
294;06.11.2017;2017;11;17;Maanantai;6;6;12;12;10;22
294;06.11.2017;2017;11;18;Maanantai;7;5;12;17;19;36
294;06.11.2017;2017;11;19;Maanantai;7;4;11;12;10;22
294;06.11.2017;2017;11;20;Maanantai;0;3;3;3;6;9
294;06.11.2017;2017;11;21;Maanantai;5;0;5;1;2;3
294;06.11.2017;2017;11;22;Maanantai;0;1;1;1;1;2
294;06.11.2017;2017;11;23;Maanantai;0;0;0;0;0;0
294;07.11.2017;2017;11;00;Tiistai;0;0;0;0;0;0
294;07.11.2017;2017;11;01;Tiistai;0;0;0;0;0;0
294;07.11.2017;2017;11;02;Tiistai;0;0;0;0;0;0
294;07.11.2017;2017;11;03;Tiistai;0;0;0;0;0;0
294;07.11.2017;2017;11;04;Tiistai;0;0;0;0;0;0
294;07.11.2017;2017;11;05;Tiistai;0;1;1;2;1;3
294;07.11.2017;2017;11;06;Tiistai;0;0;0;2;1;3
294;07.11.2017;2017;11;07;Tiistai;6;9;15;5;4;9
294;07.11.2017;2017;11;08;Tiistai;28;1;29;20;6;26
294;07.11.2017;2017;11;09;Tiistai;21;5;26;61;5;66
294;07.11.2017;2017;11;10;Tiistai;1;5;6;14;43;57
294;07.11.2017;2017;11;11;Tiistai;5;2;7;32;21;53
294;07.11.2017;2017;11;12;Tiistai;8;2;10;12;12;24
294;07.11.2017;2017;11;13;Tiistai;9;19;28;17;23;40
294;07.11.2017;2017;11;14;Tiistai;8;12;20;20;15;35
294;07.11.2017;2017;11;15;Tiistai;12;19;31;16;23;39
294;07.11.2017;2017;11;16;Tiistai;7;13;20;16;14;30
294;07.11.2017;2017;11;17;Tiistai;6;2;8;16;15;31
294;07.11.2017;2017;11;18;Tiistai;6;6;12;14;8;22
294;07.11.2017;2017;11;19;Tiistai;4;5;9;6;8;14
294;07.11.2017;2017;11;20;Tiistai;2;1;3;4;2;6
294;07.11.2017;2017;11;21;Tiistai;1;0;1;1;1;2
294;07.11.2017;2017;11;22;Tiistai;0;1;1;0;0;0
294;07.11.2017;2017;11;23;Tiistai;0;0;0;1;0;1
294;08.11.2017;2017;11;00;Keskiviikko;0;0;0;0;0;0
294;08.11.2017;2017;11;01;Keskiviikko;0;0;0;0;0;0
294;08.11.2017;2017;11;02;Keskiviikko;0;0;0;0;0;0
294;08.11.2017;2017;11;03;Keskiviikko;0;0;0;0;0;0
294;08.11.2017;2017;11;04;Keskiviikko;0;0;0;0;0;0
294;08.11.2017;2017;11;05;Keskiviikko;0;0;0;4;1;5
294;08.11.2017;2017;11;06;Keskiviikko;0;0;0;2;1;3
294;08.11.2017;2017;11;07;Keskiviikko;11;5;16;6;8;14
294;08.11.2017;2017;11;08;Keskiviikko;13;7;20;5;1;6
294;08.11.2017;2017;11;09;Keskiviikko;10;5;15;10;5;15
294;08.11.2017;2017;11;10;Keskiviikko;8;7;15;9;17;26
294;08.11.2017;2017;11;11;Keskiviikko;3;5;8;19;14;33
294;08.11.2017;2017;11;12;Keskiviikko;10;8;18;14;10;24
294;08.11.2017;2017;11;13;Keskiviikko;5;14;19;9;10;19
294;08.11.2017;2017;11;14;Keskiviikko;11;16;27;12;11;23
294;08.11.2017;2017;11;15;Keskiviikko;9;11;20;14;15;29
294;08.11.2017;2017;11;16;Keskiviikko;13;14;27;18;8;26
294;08.11.2017;2017;11;17;Keskiviikko;13;8;21;7;8;15
294;08.11.2017;2017;11;18;Keskiviikko;8;4;12;20;17;37
294;08.11.2017;2017;11;19;Keskiviikko;8;13;21;12;11;23
294;08.11.2017;2017;11;20;Keskiviikko;5;2;7;3;2;5
294;08.11.2017;2017;11;21;Keskiviikko;0;1;1;1;4;5
294;08.11.2017;2017;11;22;Keskiviikko;0;0;0;0;1;1
294;08.11.2017;2017;11;23;Keskiviikko;0;0;0;1;0;1
294;09.11.2017;2017;11;00;Torstai;0;0;0;0;0;0
294;09.11.2017;2017;11;01;Torstai;0;0;0;0;0;0
294;09.11.2017;2017;11;02;Torstai;0;0;0;0;0;0
294;09.11.2017;2017;11;03;Torstai;0;0;0;0;0;0
294;09.11.2017;2017;11;04;Torstai;0;0;0;0;0;0
294;09.11.2017;2017;11;05;Torstai;0;0;0;2;1;3
294;09.11.2017;2017;11;06;Torstai;2;3;5;1;1;2
294;09.11.2017;2017;11;07;Torstai;6;5;11;7;4;11
294;09.11.2017;2017;11;08;Torstai;16;2;18;12;6;18
294;09.11.2017;2017;11;09;Torstai;16;18;34;11;11;22
294;09.11.2017;2017;11;10;Torstai;6;7;13;5;16;21
294;09.11.2017;2017;11;11;Torstai;7;13;20;23;15;38
294;09.11.2017;2017;11;12;Torstai;5;11;16;9;9;18
294;09.11.2017;2017;11;13;Torstai;12;15;27;16;14;30
294;09.11.2017;2017;11;14;Torstai;14;9;23;12;8;20
294;09.11.2017;2017;11;15;Torstai;11;20;31;7;16;23
294;09.11.2017;2017;11;16;Torstai;10;7;17;11;10;21
294;09.11.2017;2017;11;17;Torstai;5;6;11;11;12;23
294;09.11.2017;2017;11;18;Torstai;6;2;8;15;9;24
294;09.11.2017;2017;11;19;Torstai;5;3;8;4;1;5
294;09.11.2017;2017;11;20;Torstai;4;8;12;2;2;4
294;09.11.2017;2017;11;21;Torstai;2;0;2;0;2;2
294;09.11.2017;2017;11;22;Torstai;0;2;2;0;0;0
294;09.11.2017;2017;11;23;Torstai;0;0;0;0;0;0
294;10.11.2017;2017;11;00;Perjantai;0;0;0;0;0;0
294;10.11.2017;2017;11;01;Perjantai;1;0;1;0;0;0
294;10.11.2017;2017;11;02;Perjantai;0;0;0;0;0;0
294;10.11.2017;2017;11;03;Perjantai;0;0;0;0;0;0
294;10.11.2017;2017;11;04;Perjantai;0;0;0;0;0;0
294;10.11.2017;2017;11;05;Perjantai;0;0;0;2;1;3
294;10.11.2017;2017;11;06;Perjantai;0;0;0;0;0;0
294;10.11.2017;2017;11;07;Perjantai;14;7;21;7;4;11
294;10.11.2017;2017;11;08;Perjantai;15;3;18;10;3;13
294;10.11.2017;2017;11;09;Perjantai;8;10;18;15;7;22
294;10.11.2017;2017;11;10;Perjantai;3;5;8;6;13;19
294;10.11.2017;2017;11;11;Perjantai;12;5;17;8;17;25
294;10.11.2017;2017;11;12;Perjantai;14;22;36;23;17;40
294;10.11.2017;2017;11;13;Perjantai;30;15;45;21;20;41
294;10.11.2017;2017;11;14;Perjantai;18;16;34;18;12;30
294;10.11.2017;2017;11;15;Perjantai;11;12;23;9;15;24
294;10.11.2017;2017;11;16;Perjantai;14;14;28;12;11;23
294;10.11.2017;2017;11;17;Perjantai;7;7;14;10;10;20
294;10.11.2017;2017;11;18;Perjantai;5;6;11;9;12;21
294;10.11.2017;2017;11;19;Perjantai;5;5;10;21;10;31
294;10.11.2017;2017;11;20;Perjantai;2;0;2;2;3;5
294;10.11.2017;2017;11;21;Perjantai;3;1;4;0;2;2
294;10.11.2017;2017;11;22;Perjantai;1;2;3;0;1;1
294;10.11.2017;2017;11;23;Perjantai;0;0;0;1;0;1
294;11.11.2017;2017;11;00;Lauantai;1;0;1;0;0;0
294;11.11.2017;2017;11;01;Lauantai;0;0;0;1;0;1
294;11.11.2017;2017;11;02;Lauantai;0;0;0;0;2;2
294;11.11.2017;2017;11;03;Lauantai;0;0;0;0;0;0
294;11.11.2017;2017;11;04;Lauantai;0;0;0;0;0;0
294;11.11.2017;2017;11;05;Lauantai;0;0;0;1;0;1
294;11.11.2017;2017;11;06;Lauantai;1;0;1;1;0;1
294;11.11.2017;2017;11;07;Lauantai;0;0;0;1;2;3
294;11.11.2017;2017;11;08;Lauantai;0;0;0;2;2;4
294;11.11.2017;2017;11;09;Lauantai;2;8;10;11;10;21
294;11.11.2017;2017;11;10;Lauantai;8;7;15;17;13;30
294;11.11.2017;2017;11;11;Lauantai;5;14;19;13;6;19
294;11.11.2017;2017;11;12;Lauantai;10;7;17;14;8;22
294;11.11.2017;2017;11;13;Lauantai;5;12;17;6;11;17
294;11.11.2017;2017;11;14;Lauantai;11;9;20;5;8;13
294;11.11.2017;2017;11;15;Lauantai;11;4;15;8;13;21
294;11.11.2017;2017;11;16;Lauantai;5;5;10;8;7;15
294;11.11.2017;2017;11;17;Lauantai;7;11;18;5;8;13
294;11.11.2017;2017;11;18;Lauantai;10;3;13;7;5;12
294;11.11.2017;2017;11;19;Lauantai;6;1;7;1;5;6
294;11.11.2017;2017;11;20;Lauantai;3;1;4;6;3;9
294;11.11.2017;2017;11;21;Lauantai;6;1;7;1;2;3
294;11.11.2017;2017;11;22;Lauantai;2;0;2;0;0;0
294;11.11.2017;2017;11;23;Lauantai;1;0;1;1;0;1
294;12.11.2017;2017;11;00;Sunnuntai;0;3;3;0;1;1
294;12.11.2017;2017;11;01;Sunnuntai;0;1;1;0;0;0
294;12.11.2017;2017;11;02;Sunnuntai;0;0;0;1;0;1
294;12.11.2017;2017;11;03;Sunnuntai;0;0;0;0;0;0
294;12.11.2017;2017;11;04;Sunnuntai;0;0;0;0;0;0
294;12.11.2017;2017;11;05;Sunnuntai;0;0;0;0;0;0
294;12.11.2017;2017;11;06;Sunnuntai;1;0;1;2;0;2
294;12.11.2017;2017;11;07;Sunnuntai;0;0;0;1;0;1
294;12.11.2017;2017;11;08;Sunnuntai;0;0;0;2;2;4
294;12.11.2017;2017;11;09;Sunnuntai;4;2;6;6;3;9
294;12.11.2017;2017;11;10;Sunnuntai;4;4;8;12;8;20
294;12.11.2017;2017;11;11;Sunnuntai;1;5;6;10;14;24
294;12.11.2017;2017;11;12;Sunnuntai;6;8;14;8;7;15
294;12.11.2017;2017;11;13;Sunnuntai;5;5;10;4;2;6
294;12.11.2017;2017;11;14;Sunnuntai;3;5;8;3;6;9
294;12.11.2017;2017;11;15;Sunnuntai;2;1;3;4;4;8
294;12.11.2017;2017;11;16;Sunnuntai;3;2;5;10;3;13
294;12.11.2017;2017;11;17;Sunnuntai;2;3;5;8;5;13
294;12.11.2017;2017;11;18;Sunnuntai;3;11;14;15;6;21
294;12.11.2017;2017;11;19;Sunnuntai;2;1;3;11;8;19
294;12.11.2017;2017;11;20;Sunnuntai;1;1;2;6;4;10
294;12.11.2017;2017;11;21;Sunnuntai;0;2;2;1;3;4
294;12.11.2017;2017;11;22;Sunnuntai;0;0;0;2;0;2
294;12.11.2017;2017;11;23;Sunnuntai;0;0;0;0;0;0
294;13.11.2017;2017;11;00;Maanantai;0;0;0;0;0;0
294;13.11.2017;2017;11;01;Maanantai;0;0;0;0;0;0
294;13.11.2017;2017;11;02;Maanantai;0;0;0;0;0;0
294;13.11.2017;2017;11;03;Maanantai;0;0;0;0;0;0
294;13.11.2017;2017;11;04;Maanantai;0;0;0;0;0;0
294;13.11.2017;2017;11;05;Maanantai;1;0;1;3;1;4
294;13.11.2017;2017;11;06;Maanantai;1;0;1;1;0;1
294;13.11.2017;2017;11;07;Maanantai;12;3;15;6;4;10
294;13.11.2017;2017;11;08;Maanantai;17;6;23;8;1;9
294;13.11.2017;2017;11;09;Maanantai;10;2;12;12;10;22
294;13.11.2017;2017;11;10;Maanantai;3;3;6;8;11;19
294;13.11.2017;2017;11;11;Maanantai;8;6;14;14;17;31
294;13.11.2017;2017;11;12;Maanantai;4;4;8;20;20;40
294;13.11.2017;2017;11;13;Maanantai;4;22;26;18;14;32
294;13.11.2017;2017;11;14;Maanantai;9;24;33;17;15;32
294;13.11.2017;2017;11;15;Maanantai;13;8;21;12;13;25
294;13.11.2017;2017;11;16;Maanantai;7;6;13;9;16;25
294;13.11.2017;2017;11;17;Maanantai;4;4;8;9;5;14
294;13.11.2017;2017;11;18;Maanantai;8;13;21;20;21;41
294;13.11.2017;2017;11;19;Maanantai;4;4;8;10;14;24
294;13.11.2017;2017;11;20;Maanantai;5;1;6;12;6;18
294;13.11.2017;2017;11;21;Maanantai;0;1;1;2;0;2
294;13.11.2017;2017;11;22;Maanantai;0;0;0;0;0;0
294;13.11.2017;2017;11;23;Maanantai;0;0;0;0;0;0
294;14.11.2017;2017;11;00;Tiistai;0;0;0;0;0;0
294;14.11.2017;2017;11;01;Tiistai;0;0;0;0;0;0
294;14.11.2017;2017;11;02;Tiistai;0;0;0;0;0;0
294;14.11.2017;2017;11;03;Tiistai;0;0;0;0;0;0
294;14.11.2017;2017;11;04;Tiistai;0;0;0;0;0;0
294;14.11.2017;2017;11;05;Tiistai;0;0;0;2;1;3
294;14.11.2017;2017;11;06;Tiistai;0;1;1;1;1;2
294;14.11.2017;2017;11;07;Tiistai;10;11;21;10;3;13
294;14.11.2017;2017;11;08;Tiistai;22;3;25;12;4;16
294;14.11.2017;2017;11;09;Tiistai;22;4;26;18;9;27
294;14.11.2017;2017;11;10;Tiistai;12;1;13;26;12;38
294;14.11.2017;2017;11;11;Tiistai;12;11;23;9;16;25
294;14.11.2017;2017;11;12;Tiistai;14;4;18;19;18;37
294;14.11.2017;2017;11;13;Tiistai;6;18;24;19;14;33
294;14.11.2017;2017;11;14;Tiistai;9;13;22;12;12;24
294;14.11.2017;2017;11;15;Tiistai;11;10;21;12;10;22
294;14.11.2017;2017;11;16;Tiistai;13;7;20;13;13;26
294;14.11.2017;2017;11;17;Tiistai;3;7;10;19;15;34
294;14.11.2017;2017;11;18;Tiistai;1;5;6;17;22;39
294;14.11.2017;2017;11;19;Tiistai;2;7;9;12;12;24
294;14.11.2017;2017;11;20;Tiistai;2;1;3;6;3;9
294;14.11.2017;2017;11;21;Tiistai;0;1;1;1;1;2
294;14.11.2017;2017;11;22;Tiistai;0;0;0;0;0;0
294;14.11.2017;2017;11;23;Tiistai;0;0;0;0;0;0
294;15.11.2017;2017;11;00;Keskiviikko;0;0;0;0;0;0
294;15.11.2017;2017;11;01;Keskiviikko;0;0;0;0;0;0
294;15.11.2017;2017;11;02;Keskiviikko;0;0;0;0;0;0
294;15.11.2017;2017;11;03;Keskiviikko;0;0;0;0;0;0
294;15.11.2017;2017;11;04;Keskiviikko;0;0;0;0;0;0
294;15.11.2017;2017;11;05;Keskiviikko;0;0;0;4;1;5
294;15.11.2017;2017;11;06;Keskiviikko;0;0;0;2;1;3
294;15.11.2017;2017;11;07;Keskiviikko;11;5;16;7;9;16
294;15.11.2017;2017;11;08;Keskiviikko;13;7;20;5;1;6
294;15.11.2017;2017;11;09;Keskiviikko;10;5;15;11;5;16
294;15.11.2017;2017;11;10;Keskiviikko;8;7;15;10;19;29
294;15.11.2017;2017;11;11;Keskiviikko;3;5;8;21;15;36
294;15.11.2017;2017;11;12;Keskiviikko;10;8;18;15;11;26
294;15.11.2017;2017;11;13;Keskiviikko;5;14;19;10;11;21
294;15.11.2017;2017;11;14;Keskiviikko;11;16;27;13;12;25
294;15.11.2017;2017;11;15;Keskiviikko;9;11;20;15;16;31
294;15.11.2017;2017;11;16;Keskiviikko;13;14;27;20;9;29
294;15.11.2017;2017;11;17;Keskiviikko;13;8;21;8;9;17
294;15.11.2017;2017;11;18;Keskiviikko;8;4;12;22;19;41
294;15.11.2017;2017;11;19;Keskiviikko;8;13;21;13;12;25
294;15.11.2017;2017;11;20;Keskiviikko;5;2;7;3;2;5
294;15.11.2017;2017;11;21;Keskiviikko;0;1;1;1;4;5
294;15.11.2017;2017;11;22;Keskiviikko;0;0;0;0;1;1
294;15.11.2017;2017;11;23;Keskiviikko;0;0;0;1;0;1
294;16.11.2017;2017;11;00;Torstai;0;0;0;0;0;0
294;16.11.2017;2017;11;01;Torstai;0;0;0;0;0;0
294;16.11.2017;2017;11;02;Torstai;0;0;0;0;0;0
294;16.11.2017;2017;11;03;Torstai;0;0;0;0;0;0
294;16.11.2017;2017;11;04;Torstai;0;0;0;0;0;0
294;16.11.2017;2017;11;05;Torstai;0;0;0;3;2;5
294;16.11.2017;2017;11;06;Torstai;2;3;5;2;2;4
294;16.11.2017;2017;11;07;Torstai;6;5;11;10;7;17
294;16.11.2017;2017;11;08;Torstai;15;2;17;17;9;26
294;16.11.2017;2017;11;09;Torstai;15;17;32;16;16;32
294;16.11.2017;2017;11;10;Torstai;6;7;13;8;23;31
294;16.11.2017;2017;11;11;Torstai;7;12;19;33;22;55
294;16.11.2017;2017;11;12;Torstai;5;11;16;13;13;26
294;16.11.2017;2017;11;13;Torstai;12;14;26;23;21;44
294;16.11.2017;2017;11;14;Torstai;13;9;22;17;12;29
294;16.11.2017;2017;11;15;Torstai;11;19;30;10;23;33
294;16.11.2017;2017;11;16;Torstai;10;7;17;16;15;31
294;16.11.2017;2017;11;17;Torstai;5;6;11;16;17;33
294;16.11.2017;2017;11;18;Torstai;6;2;8;22;13;35
294;16.11.2017;2017;11;19;Torstai;5;3;8;7;2;9
294;16.11.2017;2017;11;20;Torstai;4;8;12;3;3;6
294;16.11.2017;2017;11;21;Torstai;2;0;2;0;3;3
294;16.11.2017;2017;11;22;Torstai;0;2;2;0;0;0
294;16.11.2017;2017;11;23;Torstai;0;0;0;0;0;0
294;17.11.2017;2017;11;00;Perjantai;0;0;0;1;0;1
294;17.11.2017;2017;11;01;Perjantai;0;0;0;0;0;0
294;17.11.2017;2017;11;02;Perjantai;0;0;0;0;0;0
294;17.11.2017;2017;11;03;Perjantai;0;0;0;0;0;0
294;17.11.2017;2017;11;04;Perjantai;0;0;0;0;0;0
294;17.11.2017;2017;11;05;Perjantai;0;0;0;1;1;2
294;17.11.2017;2017;11;06;Perjantai;1;0;1;4;1;5
294;17.11.2017;2017;11;07;Perjantai;15;5;20;8;5;13
294;17.11.2017;2017;11;08;Perjantai;17;3;20;16;3;19
294;17.11.2017;2017;11;09;Perjantai;12;0;12;26;8;34
294;17.11.2017;2017;11;10;Perjantai;3;8;11;7;12;19
294;17.11.2017;2017;11;11;Perjantai;4;4;8;7;13;20
294;17.11.2017;2017;11;12;Perjantai;8;36;44;21;17;38
294;17.11.2017;2017;11;13;Perjantai;10;13;23;14;4;18
294;17.11.2017;2017;11;14;Perjantai;3;12;15;9;10;19
294;17.11.2017;2017;11;15;Perjantai;9;10;19;6;9;15
294;17.11.2017;2017;11;16;Perjantai;8;5;13;11;12;23
294;17.11.2017;2017;11;17;Perjantai;1;2;3;9;5;14
294;17.11.2017;2017;11;18;Perjantai;7;6;13;23;7;30
294;17.11.2017;2017;11;19;Perjantai;1;12;13;7;8;15
294;17.11.2017;2017;11;20;Perjantai;3;3;6;9;0;9
294;17.11.2017;2017;11;21;Perjantai;1;0;1;3;4;7
294;17.11.2017;2017;11;22;Perjantai;1;0;1;1;1;2
294;17.11.2017;2017;11;23;Perjantai;0;0;0;1;0;1
294;18.11.2017;2017;11;00;Lauantai;0;0;0;2;0;2
294;18.11.2017;2017;11;01;Lauantai;0;0;0;0;0;0
294;18.11.2017;2017;11;02;Lauantai;0;0;0;0;0;0
294;18.11.2017;2017;11;03;Lauantai;0;0;0;0;0;0
294;18.11.2017;2017;11;04;Lauantai;0;0;0;0;0;0
294;18.11.2017;2017;11;05;Lauantai;0;0;0;1;0;1
294;18.11.2017;2017;11;06;Lauantai;0;0;0;1;0;1
294;18.11.2017;2017;11;07;Lauantai;0;0;0;1;3;4
294;18.11.2017;2017;11;08;Lauantai;0;1;1;1;6;7
294;18.11.2017;2017;11;09;Lauantai;3;3;6;6;6;12
294;18.11.2017;2017;11;10;Lauantai;1;1;2;8;10;18
294;18.11.2017;2017;11;11;Lauantai;3;4;7;13;19;32
294;18.11.2017;2017;11;12;Lauantai;13;6;19;24;15;39
294;18.11.2017;2017;11;13;Lauantai;4;9;13;23;17;40
294;18.11.2017;2017;11;14;Lauantai;5;6;11;14;12;26
294;18.11.2017;2017;11;15;Lauantai;1;5;6;9;9;18
294;18.11.2017;2017;11;16;Lauantai;1;4;5;13;13;26
294;18.11.2017;2017;11;17;Lauantai;8;7;15;11;5;16
294;18.11.2017;2017;11;18;Lauantai;0;3;3;9;9;18
294;18.11.2017;2017;11;19;Lauantai;2;3;5;10;8;18
294;18.11.2017;2017;11;20;Lauantai;5;3;8;2;3;5
294;18.11.2017;2017;11;21;Lauantai;6;1;7;3;0;3
294;18.11.2017;2017;11;22;Lauantai;2;0;2;2;0;2
294;18.11.2017;2017;11;23;Lauantai;1;0;1;0;0;0
294;19.11.2017;2017;11;00;Sunnuntai;0;0;0;0;0;0
294;19.11.2017;2017;11;01;Sunnuntai;0;0;0;0;0;0
294;19.11.2017;2017;11;02;Sunnuntai;0;0;0;0;0;0
294;19.11.2017;2017;11;03;Sunnuntai;0;0;0;0;0;0
294;19.11.2017;2017;11;04;Sunnuntai;0;0;0;0;0;0
294;19.11.2017;2017;11;05;Sunnuntai;0;0;0;0;0;0
294;19.11.2017;2017;11;06;Sunnuntai;0;0;0;1;3;4
294;19.11.2017;2017;11;07;Sunnuntai;0;0;0;1;1;2
294;19.11.2017;2017;11;08;Sunnuntai;0;0;0;3;1;4
294;19.11.2017;2017;11;09;Sunnuntai;5;0;5;8;4;12
294;19.11.2017;2017;11;10;Sunnuntai;0;1;1;7;6;13
294;19.11.2017;2017;11;11;Sunnuntai;0;4;4;8;7;15
294;19.11.2017;2017;11;12;Sunnuntai;2;4;6;10;9;19
294;19.11.2017;2017;11;13;Sunnuntai;2;3;5;9;8;17
294;19.11.2017;2017;11;14;Sunnuntai;3;0;3;10;5;15
294;19.11.2017;2017;11;15;Sunnuntai;4;0;4;12;6;18
294;19.11.2017;2017;11;16;Sunnuntai;0;1;1;6;6;12
294;19.11.2017;2017;11;17;Sunnuntai;1;0;1;13;11;24
294;19.11.2017;2017;11;18;Sunnuntai;0;3;3;16;8;24
294;19.11.2017;2017;11;19;Sunnuntai;2;3;5;9;7;16
294;19.11.2017;2017;11;20;Sunnuntai;2;1;3;2;2;4
294;19.11.2017;2017;11;21;Sunnuntai;0;0;0;0;1;1
294;19.11.2017;2017;11;22;Sunnuntai;0;0;0;1;0;1
294;19.11.2017;2017;11;23;Sunnuntai;1;0;1;1;0;1
294;20.11.2017;2017;11;00;Maanantai;0;0;0;0;2;2
294;20.11.2017;2017;11;01;Maanantai;0;0;0;0;0;0
294;20.11.2017;2017;11;02;Maanantai;0;0;0;0;0;0
294;20.11.2017;2017;11;03;Maanantai;1;0;1;2;0;2
294;20.11.2017;2017;11;04;Maanantai;0;0;0;0;0;0
294;20.11.2017;2017;11;05;Maanantai;0;0;0;2;1;3
294;20.11.2017;2017;11;06;Maanantai;1;1;2;1;2;3
294;20.11.2017;2017;11;07;Maanantai;7;5;12;10;4;14
294;20.11.2017;2017;11;08;Maanantai;10;3;13;8;5;13
294;20.11.2017;2017;11;09;Maanantai;15;2;17;13;11;24
294;20.11.2017;2017;11;10;Maanantai;7;0;7;17;19;36
294;20.11.2017;2017;11;11;Maanantai;2;8;10;17;21;38
294;20.11.2017;2017;11;12;Maanantai;7;12;19;18;11;29
294;20.11.2017;2017;11;13;Maanantai;2;7;9;18;7;25
294;20.11.2017;2017;11;14;Maanantai;10;8;18;15;16;31
294;20.11.2017;2017;11;15;Maanantai;11;12;23;11;4;15
294;20.11.2017;2017;11;16;Maanantai;8;11;19;16;16;32
294;20.11.2017;2017;11;17;Maanantai;2;2;4;11;6;17
294;20.11.2017;2017;11;18;Maanantai;2;4;6;10;17;27
294;20.11.2017;2017;11;19;Maanantai;5;4;9;12;11;23
294;20.11.2017;2017;11;20;Maanantai;1;6;7;10;3;13
294;20.11.2017;2017;11;21;Maanantai;2;0;2;4;1;5
294;20.11.2017;2017;11;22;Maanantai;1;3;4;0;0;0
294;20.11.2017;2017;11;23;Maanantai;0;0;0;0;0;0
294;21.11.2017;2017;11;00;Tiistai;0;0;0;0;0;0
294;21.11.2017;2017;11;01;Tiistai;0;0;0;0;0;0
294;21.11.2017;2017;11;02;Tiistai;0;0;0;0;0;0
294;21.11.2017;2017;11;03;Tiistai;0;0;0;0;0;0
294;21.11.2017;2017;11;04;Tiistai;0;0;0;0;0;0
294;21.11.2017;2017;11;05;Tiistai;0;0;0;2;1;3
294;21.11.2017;2017;11;06;Tiistai;1;1;2;4;2;6
294;21.11.2017;2017;11;07;Tiistai;4;5;9;7;8;15
294;21.11.2017;2017;11;08;Tiistai;21;7;28;11;3;14
294;21.11.2017;2017;11;09;Tiistai;19;1;20;14;9;23
294;21.11.2017;2017;11;10;Tiistai;2;2;4;8;17;25
294;21.11.2017;2017;11;11;Tiistai;4;2;6;20;15;35
294;21.11.2017;2017;11;12;Tiistai;9;15;24;17;21;38
294;21.11.2017;2017;11;13;Tiistai;3;13;16;9;12;21
294;21.11.2017;2017;11;14;Tiistai;6;8;14;12;15;27
294;21.11.2017;2017;11;15;Tiistai;5;10;15;14;8;22
294;21.11.2017;2017;11;16;Tiistai;6;4;10;4;17;21
294;21.11.2017;2017;11;17;Tiistai;4;3;7;19;14;33
294;21.11.2017;2017;11;18;Tiistai;9;0;9;13;16;29
294;21.11.2017;2017;11;19;Tiistai;3;3;6;7;5;12
294;21.11.2017;2017;11;20;Tiistai;6;8;14;2;1;3
294;21.11.2017;2017;11;21;Tiistai;0;0;0;0;1;1
294;21.11.2017;2017;11;22;Tiistai;0;0;0;0;0;0
294;21.11.2017;2017;11;23;Tiistai;0;0;0;0;0;0
294;22.11.2017;2017;11;00;Keskiviikko;0;0;0;0;0;0
294;22.11.2017;2017;11;01;Keskiviikko;0;0;0;0;0;0
294;22.11.2017;2017;11;02;Keskiviikko;0;0;0;0;0;0
294;22.11.2017;2017;11;03;Keskiviikko;0;0;0;0;0;0
294;22.11.2017;2017;11;04;Keskiviikko;0;0;0;0;0;0
294;22.11.2017;2017;11;05;Keskiviikko;0;1;1;2;0;2
294;22.11.2017;2017;11;06;Keskiviikko;0;0;0;1;2;3
294;22.11.2017;2017;11;07;Keskiviikko;9;5;14;7;2;9
294;22.11.2017;2017;11;08;Keskiviikko;14;3;17;7;5;12
294;22.11.2017;2017;11;09;Keskiviikko;12;4;16;13;8;21
294;22.11.2017;2017;11;10;Keskiviikko;5;2;7;12;13;25
294;22.11.2017;2017;11;11;Keskiviikko;4;0;4;24;17;41
294;22.11.2017;2017;11;12;Keskiviikko;6;6;12;18;14;32
294;22.11.2017;2017;11;13;Keskiviikko;2;17;19;11;14;25
294;22.11.2017;2017;11;14;Keskiviikko;11;15;26;8;15;23
294;22.11.2017;2017;11;15;Keskiviikko;12;11;23;9;10;19
294;22.11.2017;2017;11;16;Keskiviikko;9;7;16;11;16;27
294;22.11.2017;2017;11;17;Keskiviikko;5;2;7;17;11;28
294;22.11.2017;2017;11;18;Keskiviikko;9;7;16;11;10;21
294;22.11.2017;2017;11;19;Keskiviikko;5;4;9;9;8;17
294;22.11.2017;2017;11;20;Keskiviikko;2;5;7;4;2;6
294;22.11.2017;2017;11;21;Keskiviikko;0;0;0;4;0;4
294;22.11.2017;2017;11;22;Keskiviikko;0;1;1;0;1;1
294;22.11.2017;2017;11;23;Keskiviikko;0;0;0;1;0;1
294;23.11.2017;2017;11;00;Torstai;0;0;0;0;0;0
294;23.11.2017;2017;11;01;Torstai;0;0;0;0;0;0
294;23.11.2017;2017;11;02;Torstai;0;0;0;0;0;0
294;23.11.2017;2017;11;03;Torstai;0;0;0;0;0;0
294;23.11.2017;2017;11;04;Torstai;0;0;0;0;0;0
294;23.11.2017;2017;11;05;Torstai;0;0;0;0;0;0
294;23.11.2017;2017;11;06;Torstai;0;0;0;1;2;3
294;23.11.2017;2017;11;07;Torstai;7;3;10;3;2;5
294;23.11.2017;2017;11;08;Torstai;7;3;10;8;5;13
294;23.11.2017;2017;11;09;Torstai;10;8;18;13;4;17
294;23.11.2017;2017;11;10;Torstai;9;2;11;18;16;34
294;23.11.2017;2017;11;11;Torstai;4;2;6;15;23;38
294;23.11.2017;2017;11;12;Torstai;2;12;14;7;13;20
294;23.11.2017;2017;11;13;Torstai;8;9;17;13;10;23
294;23.11.2017;2017;11;14;Torstai;7;4;11;6;8;14
294;23.11.2017;2017;11;15;Torstai;6;6;12;15;16;31
294;23.11.2017;2017;11;16;Torstai;6;0;6;6;9;15
294;23.11.2017;2017;11;17;Torstai;4;6;10;13;4;17
294;23.11.2017;2017;11;18;Torstai;2;0;2;5;4;9
294;23.11.2017;2017;11;19;Torstai;2;0;2;0;6;6
294;23.11.2017;2017;11;20;Torstai;2;2;4;4;1;5
294;23.11.2017;2017;11;21;Torstai;1;1;2;5;2;7
294;23.11.2017;2017;11;22;Torstai;0;0;0;0;0;0
294;23.11.2017;2017;11;23;Torstai;0;0;0;0;0;0
294;24.11.2017;2017;11;00;Perjantai;0;0;0;0;0;0
294;24.11.2017;2017;11;01;Perjantai;2;1;3;3;0;3
294;24.11.2017;2017;11;02;Perjantai;0;0;0;0;0;0
294;24.11.2017;2017;11;03;Perjantai;0;0;0;0;0;0
294;24.11.2017;2017;11;04;Perjantai;0;0;0;0;0;0
294;24.11.2017;2017;11;05;Perjantai;0;0;0;0;0;0
294;24.11.2017;2017;11;06;Perjantai;0;0;0;1;1;2
294;24.11.2017;2017;11;07;Perjantai;8;6;14;5;4;9
294;24.11.2017;2017;11;08;Perjantai;7;0;7;14;1;15
294;24.11.2017;2017;11;09;Perjantai;1;1;2;9;4;13
294;24.11.2017;2017;11;10;Perjantai;1;3;4;9;7;16
294;24.11.2017;2017;11;11;Perjantai;1;3;4;10;9;19
294;24.11.2017;2017;11;12;Perjantai;3;14;17;26;19;45
294;24.11.2017;2017;11;13;Perjantai;7;17;24;10;11;21
294;24.11.2017;2017;11;14;Perjantai;2;8;10;20;21;41
294;24.11.2017;2017;11;15;Perjantai;3;8;11;12;4;16
294;24.11.2017;2017;11;16;Perjantai;0;4;4;8;6;14
294;24.11.2017;2017;11;17;Perjantai;1;11;12;11;9;20
294;24.11.2017;2017;11;18;Perjantai;14;12;26;16;17;33
294;24.11.2017;2017;11;19;Perjantai;9;5;14;25;9;34
294;24.11.2017;2017;11;20;Perjantai;8;3;11;10;11;21
294;24.11.2017;2017;11;21;Perjantai;5;3;8;7;8;15
294;24.11.2017;2017;11;22;Perjantai;5;0;5;4;2;6
294;24.11.2017;2017;11;23;Perjantai;0;0;0;1;0;1
294;25.11.2017;2017;11;00;Lauantai;0;2;2;0;0;0
294;25.11.2017;2017;11;01;Lauantai;0;0;0;0;1;1
294;25.11.2017;2017;11;02;Lauantai;0;0;0;0;1;1
294;25.11.2017;2017;11;03;Lauantai;0;0;0;0;0;0
294;25.11.2017;2017;11;04;Lauantai;0;0;0;0;0;0
294;25.11.2017;2017;11;05;Lauantai;0;0;0;0;0;0
294;25.11.2017;2017;11;06;Lauantai;1;1;2;6;8;14
294;25.11.2017;2017;11;07;Lauantai;0;0;0;1;0;1
294;25.11.2017;2017;11;08;Lauantai;3;0;3;6;5;11
294;25.11.2017;2017;11;09;Lauantai;2;1;3;11;5;16
294;25.11.2017;2017;11;10;Lauantai;2;6;8;15;12;27
294;25.11.2017;2017;11;11;Lauantai;2;3;5;7;11;18
294;25.11.2017;2017;11;12;Lauantai;2;3;5;9;3;12
294;25.11.2017;2017;11;13;Lauantai;1;2;3;8;14;22
294;25.11.2017;2017;11;14;Lauantai;6;6;12;15;6;21
294;25.11.2017;2017;11;15;Lauantai;6;4;10;6;8;14
294;25.11.2017;2017;11;16;Lauantai;2;5;7;11;7;18
294;25.11.2017;2017;11;17;Lauantai;5;2;7;7;7;14
294;25.11.2017;2017;11;18;Lauantai;5;1;6;5;4;9
294;25.11.2017;2017;11;19;Lauantai;3;4;7;4;5;9
294;25.11.2017;2017;11;20;Lauantai;4;3;7;2;3;5
294;25.11.2017;2017;11;21;Lauantai;2;2;4;3;1;4
294;25.11.2017;2017;11;22;Lauantai;3;1;4;3;1;4
294;25.11.2017;2017;11;23;Lauantai;0;1;1;0;0;0
294;26.11.2017;2017;11;00;Sunnuntai;0;2;2;0;0;0
294;26.11.2017;2017;11;01;Sunnuntai;0;0;0;0;0;0
294;26.11.2017;2017;11;02;Sunnuntai;0;0;0;0;0;0
294;26.11.2017;2017;11;03;Sunnuntai;0;0;0;0;0;0
294;26.11.2017;2017;11;04;Sunnuntai;0;0;0;4;0;4
294;26.11.2017;2017;11;05;Sunnuntai;0;0;0;0;0;0
294;26.11.2017;2017;11;06;Sunnuntai;0;0;0;0;1;1
294;26.11.2017;2017;11;07;Sunnuntai;0;0;0;1;1;2
294;26.11.2017;2017;11;08;Sunnuntai;0;0;0;2;1;3
294;26.11.2017;2017;11;09;Sunnuntai;1;0;1;12;6;18
294;26.11.2017;2017;11;10;Sunnuntai;2;0;2;3;3;6
294;26.11.2017;2017;11;11;Sunnuntai;0;2;2;16;12;28
294;26.11.2017;2017;11;12;Sunnuntai;1;1;2;11;11;22
294;26.11.2017;2017;11;13;Sunnuntai;2;5;7;10;9;19
294;26.11.2017;2017;11;14;Sunnuntai;0;2;2;13;5;18
294;26.11.2017;2017;11;15;Sunnuntai;1;3;4;5;2;7
294;26.11.2017;2017;11;16;Sunnuntai;1;3;4;11;10;21
294;26.11.2017;2017;11;17;Sunnuntai;1;1;2;11;9;20
294;26.11.2017;2017;11;18;Sunnuntai;1;0;1;12;10;22
294;26.11.2017;2017;11;19;Sunnuntai;5;7;12;4;5;9
294;26.11.2017;2017;11;20;Sunnuntai;2;1;3;3;7;10
294;26.11.2017;2017;11;21;Sunnuntai;1;1;2;2;2;4
294;26.11.2017;2017;11;22;Sunnuntai;0;0;0;1;0;1
294;26.11.2017;2017;11;23;Sunnuntai;0;0;0;0;0;0
294;27.11.2017;2017;11;00;Maanantai;0;0;0;0;0;0
294;27.11.2017;2017;11;01;Maanantai;0;0;0;0;0;0
294;27.11.2017;2017;11;02;Maanantai;0;0;0;0;0;0
294;27.11.2017;2017;11;03;Maanantai;0;0;0;0;0;0
294;27.11.2017;2017;11;04;Maanantai;0;0;0;0;0;0
294;27.11.2017;2017;11;05;Maanantai;0;0;0;0;0;0
294;27.11.2017;2017;11;06;Maanantai;0;0;0;2;1;3
294;27.11.2017;2017;11;07;Maanantai;10;9;19;7;3;10
294;27.11.2017;2017;11;08;Maanantai;18;1;19;9;9;18
294;27.11.2017;2017;11;09;Maanantai;10;4;14;15;8;23
294;27.11.2017;2017;11;10;Maanantai;4;0;4;10;18;28
294;27.11.2017;2017;11;11;Maanantai;1;5;6;22;20;42
294;27.11.2017;2017;11;12;Maanantai;2;6;8;9;20;29
294;27.11.2017;2017;11;13;Maanantai;10;14;24;20;19;39
294;27.11.2017;2017;11;14;Maanantai;13;21;34;11;21;32
294;27.11.2017;2017;11;15;Maanantai;9;4;13;11;8;19
294;27.11.2017;2017;11;16;Maanantai;4;6;10;16;10;26
294;27.11.2017;2017;11;17;Maanantai;5;5;10;11;8;19
294;27.11.2017;2017;11;18;Maanantai;3;7;10;9;12;21
294;27.11.2017;2017;11;19;Maanantai;1;3;4;6;12;18
294;27.11.2017;2017;11;20;Maanantai;4;5;9;6;5;11
294;27.11.2017;2017;11;21;Maanantai;5;1;6;2;4;6
294;27.11.2017;2017;11;22;Maanantai;0;0;0;0;0;0
294;27.11.2017;2017;11;23;Maanantai;0;0;0;0;0;0
294;28.11.2017;2017;11;00;Tiistai;0;0;0;0;0;0
294;28.11.2017;2017;11;01;Tiistai;0;0;0;0;0;0
294;28.11.2017;2017;11;02;Tiistai;0;0;0;0;0;0
294;28.11.2017;2017;11;03;Tiistai;0;0;0;0;0;0
294;28.11.2017;2017;11;04;Tiistai;0;1;1;2;0;2
294;28.11.2017;2017;11;05;Tiistai;0;0;0;2;1;3
294;28.11.2017;2017;11;06;Tiistai;0;0;0;1;0;1
294;28.11.2017;2017;11;07;Tiistai;5;8;13;10;11;21
294;28.11.2017;2017;11;08;Tiistai;22;1;23;15;9;24
294;28.11.2017;2017;11;09;Tiistai;15;3;18;12;10;22
294;28.11.2017;2017;11;10;Tiistai;1;0;1;12;13;25
294;28.11.2017;2017;11;11;Tiistai;3;5;8;11;14;25
294;28.11.2017;2017;11;12;Tiistai;10;2;12;24;21;45
294;28.11.2017;2017;11;13;Tiistai;4;3;7;12;17;29
294;28.11.2017;2017;11;14;Tiistai;4;3;7;19;14;33
294;28.11.2017;2017;11;15;Tiistai;7;16;23;11;20;31
294;28.11.2017;2017;11;16;Tiistai;4;8;12;13;7;20
294;28.11.2017;2017;11;17;Tiistai;8;7;15;11;5;16
294;28.11.2017;2017;11;18;Tiistai;3;3;6;16;13;29
294;28.11.2017;2017;11;19;Tiistai;3;3;6;6;15;21
294;28.11.2017;2017;11;20;Tiistai;4;3;7;7;5;12
294;28.11.2017;2017;11;21;Tiistai;3;1;4;1;2;3
294;28.11.2017;2017;11;22;Tiistai;0;1;1;0;1;1
294;28.11.2017;2017;11;23;Tiistai;0;0;0;0;0;0
294;29.11.2017;2017;11;00;Keskiviikko;0;0;0;0;0;0
294;29.11.2017;2017;11;01;Keskiviikko;0;0;0;0;0;0
294;29.11.2017;2017;11;02;Keskiviikko;0;0;0;0;0;0
294;29.11.2017;2017;11;03;Keskiviikko;0;0;0;0;0;0
294;29.11.2017;2017;11;04;Keskiviikko;0;0;0;0;0;0
294;29.11.2017;2017;11;05;Keskiviikko;0;0;0;2;1;3
294;29.11.2017;2017;11;06;Keskiviikko;1;1;2;3;1;4
294;29.11.2017;2017;11;07;Keskiviikko;19;2;21;9;1;10
294;29.11.2017;2017;11;08;Keskiviikko;21;3;24;9;8;17
294;29.11.2017;2017;11;09;Keskiviikko;8;6;14;11;6;17
294;29.11.2017;2017;11;10;Keskiviikko;1;5;6;14;17;31
294;29.11.2017;2017;11;11;Keskiviikko;2;4;6;13;17;30
294;29.11.2017;2017;11;12;Keskiviikko;3;7;10;14;14;28
294;29.11.2017;2017;11;13;Keskiviikko;7;8;15;13;17;30
294;29.11.2017;2017;11;14;Keskiviikko;5;24;29;11;17;28
294;29.11.2017;2017;11;15;Keskiviikko;8;12;20;10;20;30
294;29.11.2017;2017;11;16;Keskiviikko;6;6;12;8;9;17
294;29.11.2017;2017;11;17;Keskiviikko;5;4;9;9;12;21
294;29.11.2017;2017;11;18;Keskiviikko;6;6;12;8;11;19
294;29.11.2017;2017;11;19;Keskiviikko;4;5;9;6;8;14
294;29.11.2017;2017;11;20;Keskiviikko;2;1;3;3;1;4
294;29.11.2017;2017;11;21;Keskiviikko;0;2;2;5;6;11
294;29.11.2017;2017;11;22;Keskiviikko;0;0;0;0;0;0
294;29.11.2017;2017;11;23;Keskiviikko;0;0;0;0;0;0
294;30.11.2017;2017;11;00;Torstai;0;0;0;0;0;0
294;30.11.2017;2017;11;01;Torstai;0;0;0;0;0;0
294;30.11.2017;2017;11;02;Torstai;0;0;0;0;0;0
294;30.11.2017;2017;11;03;Torstai;0;0;0;0;0;0
294;30.11.2017;2017;11;04;Torstai;2;3;5;3;0;3
294;30.11.2017;2017;11;05;Torstai;0;0;0;2;1;3
294;30.11.2017;2017;11;06;Torstai;0;0;0;2;6;8
294;30.11.2017;2017;11;07;Torstai;1;3;4;7;0;7
294;30.11.2017;2017;11;08;Torstai;16;3;19;9;2;11
294;30.11.2017;2017;11;09;Torstai;10;3;13;16;8;24
294;30.11.2017;2017;11;10;Torstai;0;2;2;12;12;24
294;30.11.2017;2017;11;11;Torstai;6;3;9;18;13;31
294;30.11.2017;2017;11;12;Torstai;1;5;6;18;15;33
294;30.11.2017;2017;11;13;Torstai;11;9;20;14;16;30
294;30.11.2017;2017;11;14;Torstai;10;9;19;13;24;37
294;30.11.2017;2017;11;15;Torstai;6;23;29;8;13;21
294;30.11.2017;2017;11;16;Torstai;6;7;13;15;12;27
294;30.11.2017;2017;11;17;Torstai;2;5;7;13;8;21
294;30.11.2017;2017;11;18;Torstai;4;1;5;6;11;17
294;30.11.2017;2017;11;19;Torstai;3;4;7;4;8;12
294;30.11.2017;2017;11;20;Torstai;0;5;5;5;3;8
294;30.11.2017;2017;11;21;Torstai;1;0;1;0;0;0
294;30.11.2017;2017;11;22;Torstai;0;0;0;0;0;0
294;30.11.2017;2017;11;23;Torstai;0;0;0;2;0;2
294;01.12.2017;2017;12;00;Perjantai;0;0;0;0;0;0
294;01.12.2017;2017;12;01;Perjantai;0;0;0;0;0;0
294;01.12.2017;2017;12;02;Perjantai;0;0;0;0;0;0
294;01.12.2017;2017;12;03;Perjantai;0;0;0;0;0;0
294;01.12.2017;2017;12;04;Perjantai;0;0;0;0;0;0
294;01.12.2017;2017;12;05;Perjantai;1;1;2;1;8;9
294;01.12.2017;2017;12;06;Perjantai;1;0;1;1;0;1
294;01.12.2017;2017;12;07;Perjantai;7;6;13;6;5;11
294;01.12.2017;2017;12;08;Perjantai;5;4;9;11;6;17
294;01.12.2017;2017;12;09;Perjantai;15;1;16;8;9;17
294;01.12.2017;2017;12;10;Perjantai;2;6;8;13;18;31
294;01.12.2017;2017;12;11;Perjantai;13;10;23;19;18;37
294;01.12.2017;2017;12;12;Perjantai;4;14;18;22;18;40
294;01.12.2017;2017;12;13;Perjantai;14;13;27;20;18;38
294;01.12.2017;2017;12;14;Perjantai;5;17;22;15;23;38
294;01.12.2017;2017;12;15;Perjantai;6;9;15;16;13;29
294;01.12.2017;2017;12;16;Perjantai;6;3;9;24;13;37
294;01.12.2017;2017;12;17;Perjantai;6;5;11;11;8;19
294;01.12.2017;2017;12;18;Perjantai;13;14;27;8;10;18
294;01.12.2017;2017;12;19;Perjantai;13;13;26;14;9;23
294;01.12.2017;2017;12;20;Perjantai;5;15;20;0;5;5
294;01.12.2017;2017;12;21;Perjantai;4;5;9;2;3;5
294;01.12.2017;2017;12;22;Perjantai;1;5;6;0;0;0
294;01.12.2017;2017;12;23;Perjantai;1;0;1;3;0;3
294;02.12.2017;2017;12;00;Lauantai;0;0;0;0;0;0
294;02.12.2017;2017;12;01;Lauantai;0;0;0;1;0;1
294;02.12.2017;2017;12;02;Lauantai;0;0;0;0;0;0
294;02.12.2017;2017;12;03;Lauantai;0;0;0;0;1;1
294;02.12.2017;2017;12;04;Lauantai;0;0;0;0;0;0
294;02.12.2017;2017;12;05;Lauantai;0;0;0;0;0;0
294;02.12.2017;2017;12;06;Lauantai;0;0;0;2;2;4
294;02.12.2017;2017;12;07;Lauantai;0;0;0;2;0;2
294;02.12.2017;2017;12;08;Lauantai;0;1;1;4;8;12
294;02.12.2017;2017;12;09;Lauantai;1;0;1;9;9;18
294;02.12.2017;2017;12;10;Lauantai;1;1;2;13;12;25
294;02.12.2017;2017;12;11;Lauantai;1;2;3;15;9;24
294;02.12.2017;2017;12;12;Lauantai;7;3;10;22;15;37
294;02.12.2017;2017;12;13;Lauantai;3;2;5;21;16;37
294;02.12.2017;2017;12;14;Lauantai;3;5;8;13;12;25
294;02.12.2017;2017;12;15;Lauantai;2;4;6;8;11;19
294;02.12.2017;2017;12;16;Lauantai;2;6;8;12;13;25
294;02.12.2017;2017;12;17;Lauantai;3;0;3;16;5;21
294;02.12.2017;2017;12;18;Lauantai;3;4;7;12;8;20
294;02.12.2017;2017;12;19;Lauantai;3;2;5;5;4;9
294;02.12.2017;2017;12;20;Lauantai;4;2;6;4;5;9
294;02.12.2017;2017;12;21;Lauantai;9;4;13;1;1;2
294;02.12.2017;2017;12;22;Lauantai;2;2;4;0;0;0
294;02.12.2017;2017;12;23;Lauantai;4;0;4;0;0;0
294;03.12.2017;2017;12;00;Sunnuntai;5;1;6;1;0;1
294;03.12.2017;2017;12;01;Sunnuntai;0;0;0;0;0;0
294;03.12.2017;2017;12;02;Sunnuntai;1;0;1;0;0;0
294;03.12.2017;2017;12;03;Sunnuntai;0;1;1;0;0;0
294;03.12.2017;2017;12;04;Sunnuntai;0;0;0;0;1;1
294;03.12.2017;2017;12;05;Sunnuntai;0;0;0;0;0;0
294;03.12.2017;2017;12;06;Sunnuntai;0;0;0;1;3;4
294;03.12.2017;2017;12;07;Sunnuntai;0;0;0;1;0;1
294;03.12.2017;2017;12;08;Sunnuntai;0;0;0;4;1;5
294;03.12.2017;2017;12;09;Sunnuntai;8;0;8;8;6;14
294;03.12.2017;2017;12;10;Sunnuntai;0;1;1;5;5;10
294;03.12.2017;2017;12;11;Sunnuntai;1;7;8;6;13;19
294;03.12.2017;2017;12;12;Sunnuntai;1;3;4;3;6;9
294;03.12.2017;2017;12;13;Sunnuntai;4;3;7;12;10;22
294;03.12.2017;2017;12;14;Sunnuntai;6;2;8;13;7;20
294;03.12.2017;2017;12;15;Sunnuntai;3;1;4;4;5;9
294;03.12.2017;2017;12;16;Sunnuntai;3;0;3;3;4;7
294;03.12.2017;2017;12;17;Sunnuntai;3;3;6;12;8;20
294;03.12.2017;2017;12;18;Sunnuntai;5;5;10;9;9;18
294;03.12.2017;2017;12;19;Sunnuntai;6;3;9;9;8;17
294;03.12.2017;2017;12;20;Sunnuntai;0;1;1;3;3;6
294;03.12.2017;2017;12;21;Sunnuntai;2;3;5;0;0;0
294;03.12.2017;2017;12;22;Sunnuntai;0;1;1;1;1;2
294;03.12.2017;2017;12;23;Sunnuntai;0;0;0;0;0;0
294;04.12.2017;2017;12;00;Maanantai;0;0;0;0;0;0
294;04.12.2017;2017;12;01;Maanantai;0;0;0;0;0;0
294;04.12.2017;2017;12;02;Maanantai;0;0;0;0;0;0
294;04.12.2017;2017;12;03;Maanantai;0;0;0;0;0;0
294;04.12.2017;2017;12;04;Maanantai;0;0;0;0;0;0
294;04.12.2017;2017;12;05;Maanantai;1;0;1;1;1;2
294;04.12.2017;2017;12;06;Maanantai;1;1;2;1;1;2
294;04.12.2017;2017;12;07;Maanantai;12;5;17;10;8;18
294;04.12.2017;2017;12;08;Maanantai;17;2;19;10;3;13
294;04.12.2017;2017;12;09;Maanantai;10;2;12;11;8;19
294;04.12.2017;2017;12;10;Maanantai;5;4;9;12;17;29
294;04.12.2017;2017;12;11;Maanantai;3;8;11;19;20;39
294;04.12.2017;2017;12;12;Maanantai;7;1;8;30;16;46
294;04.12.2017;2017;12;13;Maanantai;4;11;15;17;17;34
294;04.12.2017;2017;12;14;Maanantai;5;12;17;7;21;28
294;04.12.2017;2017;12;15;Maanantai;3;6;9;11;18;29
294;04.12.2017;2017;12;16;Maanantai;5;2;7;14;7;21
294;04.12.2017;2017;12;17;Maanantai;0;1;1;8;19;27
294;04.12.2017;2017;12;18;Maanantai;3;1;4;8;10;18
294;04.12.2017;2017;12;19;Maanantai;3;6;9;3;6;9
294;04.12.2017;2017;12;20;Maanantai;6;0;6;2;2;4
294;04.12.2017;2017;12;21;Maanantai;2;1;3;2;0;2
294;04.12.2017;2017;12;22;Maanantai;0;1;1;0;1;1
294;04.12.2017;2017;12;23;Maanantai;0;0;0;0;0;0
294;05.12.2017;2017;12;00;Tiistai;0;0;0;0;0;0
294;05.12.2017;2017;12;01;Tiistai;0;0;0;0;0;0
294;05.12.2017;2017;12;02;Tiistai;0;0;0;0;0;0
294;05.12.2017;2017;12;03;Tiistai;0;0;0;0;0;0
294;05.12.2017;2017;12;04;Tiistai;0;0;0;0;0;0
294;05.12.2017;2017;12;05;Tiistai;0;0;0;2;1;3
294;05.12.2017;2017;12;06;Tiistai;0;1;1;1;1;2
294;05.12.2017;2017;12;07;Tiistai;7;6;13;8;8;16
294;05.12.2017;2017;12;08;Tiistai;22;3;25;10;3;13
294;05.12.2017;2017;12;09;Tiistai;10;4;14;9;16;25
294;05.12.2017;2017;12;10;Tiistai;2;2;4;11;17;28
294;05.12.2017;2017;12;11;Tiistai;7;12;19;6;26;32
294;05.12.2017;2017;12;12;Tiistai;6;4;10;46;17;63
294;05.12.2017;2017;12;13;Tiistai;6;4;10;12;17;29
294;05.12.2017;2017;12;14;Tiistai;7;15;22;25;25;50
294;05.12.2017;2017;12;15;Tiistai;5;4;9;7;16;23
294;05.12.2017;2017;12;16;Tiistai;8;6;14;9;11;20
294;05.12.2017;2017;12;17;Tiistai;3;5;8;8;10;18
294;05.12.2017;2017;12;18;Tiistai;9;6;15;13;5;18
294;05.12.2017;2017;12;19;Tiistai;1;7;8;5;9;14
294;05.12.2017;2017;12;20;Tiistai;8;6;14;4;6;10
294;05.12.2017;2017;12;21;Tiistai;3;2;5;4;1;5
294;05.12.2017;2017;12;22;Tiistai;0;0;0;1;1;2
294;05.12.2017;2017;12;23;Tiistai;0;0;0;0;0;0
294;06.12.2017;2017;12;00;Keskiviikko;1;0;1;0;0;0
294;06.12.2017;2017;12;01;Keskiviikko;0;0;0;0;0;0
294;06.12.2017;2017;12;02;Keskiviikko;0;0;0;0;0;0
294;06.12.2017;2017;12;03;Keskiviikko;0;0;0;0;0;0
294;06.12.2017;2017;12;04;Keskiviikko;0;0;0;0;0;0
294;06.12.2017;2017;12;05;Keskiviikko;0;0;0;1;0;1
294;06.12.2017;2017;12;06;Keskiviikko;0;0;0;1;1;2
294;06.12.2017;2017;12;07;Keskiviikko;0;0;0;0;2;2
294;06.12.2017;2017;12;08;Keskiviikko;0;0;0;9;4;13
294;06.12.2017;2017;12;09;Keskiviikko;0;0;0;4;4;8
294;06.12.2017;2017;12;10;Keskiviikko;1;1;2;10;13;23
294;06.12.2017;2017;12;11;Keskiviikko;2;6;8;11;8;19
294;06.12.2017;2017;12;12;Keskiviikko;3;6;9;8;7;15
294;06.12.2017;2017;12;13;Keskiviikko;4;1;5;10;9;19
294;06.12.2017;2017;12;14;Keskiviikko;6;1;7;9;6;15
294;06.12.2017;2017;12;15;Keskiviikko;0;2;2;5;4;9
294;06.12.2017;2017;12;16;Keskiviikko;2;2;4;10;6;16
294;06.12.2017;2017;12;17;Keskiviikko;1;1;2;10;5;15
294;06.12.2017;2017;12;18;Keskiviikko;2;1;3;7;4;11
294;06.12.2017;2017;12;19;Keskiviikko;0;3;3;0;1;1
294;06.12.2017;2017;12;20;Keskiviikko;2;1;3;2;0;2
294;06.12.2017;2017;12;21;Keskiviikko;0;1;1;0;3;3
294;06.12.2017;2017;12;22;Keskiviikko;0;0;0;1;0;1
294;06.12.2017;2017;12;23;Keskiviikko;0;0;0;1;0;1
294;07.12.2017;2017;12;00;Torstai;0;0;0;0;0;0
294;07.12.2017;2017;12;01;Torstai;0;0;0;0;0;0
294;07.12.2017;2017;12;02;Torstai;0;0;0;0;0;0
294;07.12.2017;2017;12;03;Torstai;0;0;0;0;0;0
294;07.12.2017;2017;12;04;Torstai;0;0;0;0;0;0
294;07.12.2017;2017;12;05;Torstai;0;0;0;2;0;2
294;07.12.2017;2017;12;06;Torstai;0;1;1;0;0;0
294;07.12.2017;2017;12;07;Torstai;5;4;9;7;7;14
294;07.12.2017;2017;12;08;Torstai;17;1;18;7;5;12
294;07.12.2017;2017;12;09;Torstai;9;4;13;2;11;13
294;07.12.2017;2017;12;10;Torstai;2;2;4;15;22;37
294;07.12.2017;2017;12;11;Torstai;7;4;11;17;13;30
294;07.12.2017;2017;12;12;Torstai;2;6;8;12;20;32
294;07.12.2017;2017;12;13;Torstai;6;5;11;17;11;28
294;07.12.2017;2017;12;14;Torstai;3;3;6;18;19;37
294;07.12.2017;2017;12;15;Torstai;7;21;28;11;16;27
294;07.12.2017;2017;12;16;Torstai;7;6;13;11;4;15
294;07.12.2017;2017;12;17;Torstai;4;4;8;17;8;25
294;07.12.2017;2017;12;18;Torstai;3;2;5;9;14;23
294;07.12.2017;2017;12;19;Torstai;2;1;3;3;7;10
294;07.12.2017;2017;12;20;Torstai;1;4;5;3;2;5
294;07.12.2017;2017;12;21;Torstai;1;1;2;1;1;2
294;07.12.2017;2017;12;22;Torstai;0;0;0;1;0;1
294;07.12.2017;2017;12;23;Torstai;0;0;0;0;1;1
294;08.12.2017;2017;12;00;Perjantai;0;0;0;0;0;0
294;08.12.2017;2017;12;01;Perjantai;0;0;0;0;0;0
294;08.12.2017;2017;12;02;Perjantai;0;0;0;0;0;0
294;08.12.2017;2017;12;03;Perjantai;0;0;0;0;0;0
294;08.12.2017;2017;12;04;Perjantai;2;1;3;3;0;3
294;08.12.2017;2017;12;05;Perjantai;0;0;0;0;0;0
294;08.12.2017;2017;12;06;Perjantai;0;0;0;1;0;1
294;08.12.2017;2017;12;07;Perjantai;5;2;7;7;1;8
294;08.12.2017;2017;12;08;Perjantai;4;0;4;7;0;7
294;08.12.2017;2017;12;09;Perjantai;8;1;9;5;4;9
294;08.12.2017;2017;12;10;Perjantai;2;2;4;3;1;4
294;08.12.2017;2017;12;11;Perjantai;3;3;6;8;12;20
294;08.12.2017;2017;12;12;Perjantai;4;5;9;10;12;22
294;08.12.2017;2017;12;13;Perjantai;7;7;14;13;9;22
294;08.12.2017;2017;12;14;Perjantai;4;13;17;13;17;30
294;08.12.2017;2017;12;15;Perjantai;4;2;6;2;4;6
294;08.12.2017;2017;12;16;Perjantai;6;1;7;5;2;7
294;08.12.2017;2017;12;17;Perjantai;1;1;2;6;2;8
294;08.12.2017;2017;12;18;Perjantai;2;3;5;5;3;8
294;08.12.2017;2017;12;19;Perjantai;4;1;5;11;6;17
294;08.12.2017;2017;12;20;Perjantai;4;7;11;4;2;6
294;08.12.2017;2017;12;21;Perjantai;4;0;4;7;3;10
294;08.12.2017;2017;12;22;Perjantai;1;0;1;0;2;2
294;08.12.2017;2017;12;23;Perjantai;1;3;4;0;0;0
294;09.12.2017;2017;12;00;Lauantai;0;0;0;0;0;0
294;09.12.2017;2017;12;01;Lauantai;1;0;1;0;0;0
294;09.12.2017;2017;12;02;Lauantai;0;0;0;0;0;0
294;09.12.2017;2017;12;03;Lauantai;0;0;0;0;0;0
294;09.12.2017;2017;12;04;Lauantai;0;0;0;0;0;0
294;09.12.2017;2017;12;05;Lauantai;0;0;0;1;0;1
294;09.12.2017;2017;12;06;Lauantai;0;0;0;1;0;1
294;09.12.2017;2017;12;07;Lauantai;1;0;1;1;2;3
294;09.12.2017;2017;12;08;Lauantai;0;0;0;4;1;5
294;09.12.2017;2017;12;09;Lauantai;0;0;0;5;14;19
294;09.12.2017;2017;12;10;Lauantai;0;1;1;21;10;31
294;09.12.2017;2017;12;11;Lauantai;1;0;1;15;11;26
294;09.12.2017;2017;12;12;Lauantai;2;3;5;14;12;26
294;09.12.2017;2017;12;13;Lauantai;6;7;13;8;9;17
294;09.12.2017;2017;12;14;Lauantai;5;3;8;7;3;10
294;09.12.2017;2017;12;15;Lauantai;5;2;7;9;9;18
294;09.12.2017;2017;12;16;Lauantai;7;4;11;6;5;11
294;09.12.2017;2017;12;17;Lauantai;0;1;1;4;7;11
294;09.12.2017;2017;12;18;Lauantai;4;1;5;8;4;12
294;09.12.2017;2017;12;19;Lauantai;1;2;3;5;5;10
294;09.12.2017;2017;12;20;Lauantai;2;2;4;4;4;8
294;09.12.2017;2017;12;21;Lauantai;5;1;6;1;2;3
294;09.12.2017;2017;12;22;Lauantai;1;1;2;1;0;1
294;09.12.2017;2017;12;23;Lauantai;0;0;0;0;0;0
294;10.12.2017;2017;12;00;Sunnuntai;0;0;0;0;0;0
294;10.12.2017;2017;12;01;Sunnuntai;0;1;1;0;0;0
294;10.12.2017;2017;12;02;Sunnuntai;0;0;0;0;0;0
294;10.12.2017;2017;12;03;Sunnuntai;0;0;0;1;0;1
294;10.12.2017;2017;12;04;Sunnuntai;0;0;0;0;3;3
294;10.12.2017;2017;12;05;Sunnuntai;0;0;0;1;0;1
294;10.12.2017;2017;12;06;Sunnuntai;0;0;0;1;1;2
294;10.12.2017;2017;12;07;Sunnuntai;0;0;0;2;1;3
294;10.12.2017;2017;12;08;Sunnuntai;0;0;0;5;4;9
294;10.12.2017;2017;12;09;Sunnuntai;5;0;5;8;8;16
294;10.12.2017;2017;12;10;Sunnuntai;0;0;0;8;5;13
294;10.12.2017;2017;12;11;Sunnuntai;2;4;6;7;9;16
294;10.12.2017;2017;12;12;Sunnuntai;0;0;0;10;4;14
294;10.12.2017;2017;12;13;Sunnuntai;2;1;3;4;11;15
294;10.12.2017;2017;12;14;Sunnuntai;1;2;3;9;4;13
294;10.12.2017;2017;12;15;Sunnuntai;2;4;6;12;4;16
294;10.12.2017;2017;12;16;Sunnuntai;1;1;2;15;8;23
294;10.12.2017;2017;12;17;Sunnuntai;1;5;6;6;7;13
294;10.12.2017;2017;12;18;Sunnuntai;3;2;5;12;5;17
294;10.12.2017;2017;12;19;Sunnuntai;3;3;6;7;7;14
294;10.12.2017;2017;12;20;Sunnuntai;2;2;4;4;8;12
294;10.12.2017;2017;12;21;Sunnuntai;0;0;0;0;1;1
294;10.12.2017;2017;12;22;Sunnuntai;0;0;0;0;0;0
294;10.12.2017;2017;12;23;Sunnuntai;0;0;0;0;0;0
294;11.12.2017;2017;12;00;Maanantai;0;0;0;0;0;0
294;11.12.2017;2017;12;01;Maanantai;0;0;0;0;0;0
294;11.12.2017;2017;12;02;Maanantai;0;0;0;0;0;0
294;11.12.2017;2017;12;03;Maanantai;0;0;0;0;0;0
294;11.12.2017;2017;12;04;Maanantai;0;0;0;0;0;0
294;11.12.2017;2017;12;05;Maanantai;0;0;0;1;0;1
294;11.12.2017;2017;12;06;Maanantai;1;0;1;4;3;7
294;11.12.2017;2017;12;07;Maanantai;8;10;18;13;3;16
294;11.12.2017;2017;12;08;Maanantai;12;3;15;7;5;12
294;11.12.2017;2017;12;09;Maanantai;13;0;13;9;5;14
294;11.12.2017;2017;12;10;Maanantai;3;2;5;14;12;26
294;11.12.2017;2017;12;11;Maanantai;7;13;20;9;16;25
294;11.12.2017;2017;12;12;Maanantai;6;1;7;21;11;32
294;11.12.2017;2017;12;13;Maanantai;3;3;6;15;17;32
294;11.12.2017;2017;12;14;Maanantai;6;16;22;17;30;47
294;11.12.2017;2017;12;15;Maanantai;8;5;13;14;20;34
294;11.12.2017;2017;12;16;Maanantai;6;5;11;13;18;31
294;11.12.2017;2017;12;17;Maanantai;4;3;7;11;10;21
294;11.12.2017;2017;12;18;Maanantai;3;1;4;11;11;22
294;11.12.2017;2017;12;19;Maanantai;1;6;7;14;20;34
294;11.12.2017;2017;12;20;Maanantai;1;1;2;5;7;12
294;11.12.2017;2017;12;21;Maanantai;1;4;5;1;3;4
294;11.12.2017;2017;12;22;Maanantai;1;1;2;1;1;2
294;11.12.2017;2017;12;23;Maanantai;0;0;0;0;0;0
294;12.12.2017;2017;12;00;Tiistai;0;0;0;0;0;0
294;12.12.2017;2017;12;01;Tiistai;0;0;0;0;0;0
294;12.12.2017;2017;12;02;Tiistai;0;0;0;0;0;0
294;12.12.2017;2017;12;03;Tiistai;0;0;0;0;0;0
294;12.12.2017;2017;12;04;Tiistai;0;0;0;0;0;0
294;12.12.2017;2017;12;05;Tiistai;0;0;0;2;1;3
294;12.12.2017;2017;12;06;Tiistai;0;1;1;4;2;6
294;12.12.2017;2017;12;07;Tiistai;6;7;13;6;5;11
294;12.12.2017;2017;12;08;Tiistai;26;2;28;11;7;18
294;12.12.2017;2017;12;09;Tiistai;9;0;9;18;4;22
294;12.12.2017;2017;12;10;Tiistai;5;3;8;15;13;28
294;12.12.2017;2017;12;11;Tiistai;3;4;7;19;14;33
294;12.12.2017;2017;12;12;Tiistai;7;6;13;25;11;36
294;12.12.2017;2017;12;13;Tiistai;1;11;12;12;12;24
294;12.12.2017;2017;12;14;Tiistai;4;8;12;10;11;21
294;12.12.2017;2017;12;15;Tiistai;8;4;12;12;16;28
294;12.12.2017;2017;12;16;Tiistai;5;7;12;12;11;23
294;12.12.2017;2017;12;17;Tiistai;0;2;2;15;8;23
294;12.12.2017;2017;12;18;Tiistai;0;3;3;2;4;6
294;12.12.2017;2017;12;19;Tiistai;1;0;1;8;6;14
294;12.12.2017;2017;12;20;Tiistai;0;1;1;4;4;8
294;12.12.2017;2017;12;21;Tiistai;1;2;3;6;3;9
294;12.12.2017;2017;12;22;Tiistai;0;0;0;1;0;1
294;12.12.2017;2017;12;23;Tiistai;1;1;2;0;0;0
294;13.12.2017;2017;12;00;Keskiviikko;0;0;0;0;0;0
294;13.12.2017;2017;12;01;Keskiviikko;0;0;0;0;0;0
294;13.12.2017;2017;12;02;Keskiviikko;0;0;0;0;0;0
294;13.12.2017;2017;12;03;Keskiviikko;2;0;2;1;0;1
294;13.12.2017;2017;12;04;Keskiviikko;0;0;0;0;0;0
294;13.12.2017;2017;12;05;Keskiviikko;0;0;0;2;1;3
294;13.12.2017;2017;12;06;Keskiviikko;0;1;1;3;1;4
294;13.12.2017;2017;12;07;Keskiviikko;7;4;11;13;6;19
294;13.12.2017;2017;12;08;Keskiviikko;13;0;13;6;6;12
294;13.12.2017;2017;12;09;Keskiviikko;4;2;6;12;13;25
294;13.12.2017;2017;12;10;Keskiviikko;1;4;5;8;8;16
294;13.12.2017;2017;12;11;Keskiviikko;5;1;6;12;13;25
294;13.12.2017;2017;12;12;Keskiviikko;5;4;9;20;10;30
294;13.12.2017;2017;12;13;Keskiviikko;5;5;10;12;12;24
294;13.12.2017;2017;12;14;Keskiviikko;11;10;21;10;10;20
294;13.12.2017;2017;12;15;Keskiviikko;7;6;13;12;16;28
294;13.12.2017;2017;12;16;Keskiviikko;7;6;13;15;10;25
294;13.12.2017;2017;12;17;Keskiviikko;4;3;7;4;5;9
294;13.12.2017;2017;12;18;Keskiviikko;5;1;6;6;3;9
294;13.12.2017;2017;12;19;Keskiviikko;4;4;8;5;1;6
294;13.12.2017;2017;12;20;Keskiviikko;3;3;6;2;1;3
294;13.12.2017;2017;12;21;Keskiviikko;2;0;2;2;0;2
294;13.12.2017;2017;12;22;Keskiviikko;2;1;3;1;0;1
294;13.12.2017;2017;12;23;Keskiviikko;0;0;0;1;0;1
294;14.12.2017;2017;12;00;Torstai;0;0;0;0;0;0
294;14.12.2017;2017;12;01;Torstai;0;0;0;0;0;0
294;14.12.2017;2017;12;02;Torstai;0;0;0;0;0;0
294;14.12.2017;2017;12;03;Torstai;0;0;0;0;0;0
294;14.12.2017;2017;12;04;Torstai;0;0;0;0;0;0
294;14.12.2017;2017;12;05;Torstai;0;0;0;0;0;0
294;14.12.2017;2017;12;06;Torstai;0;0;0;1;1;2
294;14.12.2017;2017;12;07;Torstai;5;8;13;5;0;5
294;14.12.2017;2017;12;08;Torstai;10;2;12;12;1;13
294;14.12.2017;2017;12;09;Torstai;7;2;9;3;2;5
294;14.12.2017;2017;12;10;Torstai;1;1;2;2;1;3
294;14.12.2017;2017;12;11;Torstai;3;1;4;5;2;7
294;14.12.2017;2017;12;12;Torstai;0;4;4;15;17;32
294;14.12.2017;2017;12;13;Torstai;4;3;7;27;6;33
294;14.12.2017;2017;12;14;Torstai;6;8;14;9;10;19
294;14.12.2017;2017;12;15;Torstai;7;13;20;10;11;21
294;14.12.2017;2017;12;16;Torstai;4;5;9;9;14;23
294;14.12.2017;2017;12;17;Torstai;2;4;6;21;6;27
294;14.12.2017;2017;12;18;Torstai;2;2;4;8;10;18
294;14.12.2017;2017;12;19;Torstai;2;4;6;9;6;15
294;14.12.2017;2017;12;20;Torstai;3;0;3;4;2;6
294;14.12.2017;2017;12;21;Torstai;2;0;2;4;3;7
294;14.12.2017;2017;12;22;Torstai;0;0;0;1;0;1
294;14.12.2017;2017;12;23;Torstai;0;0;0;1;0;1
294;15.12.2017;2017;12;00;Perjantai;0;0;0;0;0;0
294;15.12.2017;2017;12;01;Perjantai;0;0;0;0;0;0
294;15.12.2017;2017;12;02;Perjantai;0;0;0;0;0;0
294;15.12.2017;2017;12;03;Perjantai;0;0;0;0;0;0
294;15.12.2017;2017;12;04;Perjantai;0;0;0;0;0;0
294;15.12.2017;2017;12;05;Perjantai;0;0;0;2;0;2
294;15.12.2017;2017;12;06;Perjantai;0;0;0;3;3;6
294;15.12.2017;2017;12;07;Perjantai;9;3;12;7;5;12
294;15.12.2017;2017;12;08;Perjantai;7;0;7;15;9;24
294;15.12.2017;2017;12;09;Perjantai;9;3;12;15;8;23
294;15.12.2017;2017;12;10;Perjantai;3;4;7;21;13;34
294;15.12.2017;2017;12;11;Perjantai;6;2;8;12;23;35
294;15.12.2017;2017;12;12;Perjantai;8;6;14;30;20;50
294;15.12.2017;2017;12;13;Perjantai;4;7;11;11;14;25
294;15.12.2017;2017;12;14;Perjantai;12;19;31;16;22;38
294;15.12.2017;2017;12;15;Perjantai;10;4;14;11;9;20
294;15.12.2017;2017;12;16;Perjantai;3;2;5;9;11;20
294;15.12.2017;2017;12;17;Perjantai;3;2;5;11;14;25
294;15.12.2017;2017;12;18;Perjantai;4;8;12;13;10;23
294;15.12.2017;2017;12;19;Perjantai;4;3;7;13;6;19
294;15.12.2017;2017;12;20;Perjantai;4;4;8;9;9;18
294;15.12.2017;2017;12;21;Perjantai;6;4;10;6;6;12
294;15.12.2017;2017;12;22;Perjantai;1;1;2;3;3;6
294;15.12.2017;2017;12;23;Perjantai;4;0;4;0;0;0
294;16.12.2017;2017;12;00;Lauantai;0;0;0;4;2;6
294;16.12.2017;2017;12;01;Lauantai;1;0;1;0;0;0
294;16.12.2017;2017;12;02;Lauantai;0;0;0;0;0;0
294;16.12.2017;2017;12;03;Lauantai;0;0;0;0;2;2
294;16.12.2017;2017;12;04;Lauantai;0;0;0;1;1;2
294;16.12.2017;2017;12;05;Lauantai;0;0;0;1;1;2
294;16.12.2017;2017;12;06;Lauantai;0;0;0;1;2;3
294;16.12.2017;2017;12;07;Lauantai;0;0;0;3;5;8
294;16.12.2017;2017;12;08;Lauantai;0;0;0;1;5;6
294;16.12.2017;2017;12;09;Lauantai;0;2;2;7;10;17
294;16.12.2017;2017;12;10;Lauantai;1;3;4;17;7;24
294;16.12.2017;2017;12;11;Lauantai;7;2;9;11;14;25
294;16.12.2017;2017;12;12;Lauantai;1;5;6;12;16;28
294;16.12.2017;2017;12;13;Lauantai;5;4;9;11;13;24
294;16.12.2017;2017;12;14;Lauantai;7;8;15;10;11;21
294;16.12.2017;2017;12;15;Lauantai;1;1;2;13;7;20
294;16.12.2017;2017;12;16;Lauantai;3;0;3;11;5;16
294;16.12.2017;2017;12;17;Lauantai;1;1;2;8;9;17
294;16.12.2017;2017;12;18;Lauantai;2;0;2;7;13;20
294;16.12.2017;2017;12;19;Lauantai;3;5;8;2;5;7
294;16.12.2017;2017;12;20;Lauantai;2;1;3;3;2;5
294;16.12.2017;2017;12;21;Lauantai;0;4;4;1;2;3
294;16.12.2017;2017;12;22;Lauantai;2;1;3;1;0;1
294;16.12.2017;2017;12;23;Lauantai;0;0;0;0;0;0
294;17.12.2017;2017;12;00;Sunnuntai;1;1;2;0;0;0
294;17.12.2017;2017;12;01;Sunnuntai;1;0;1;0;0;0
294;17.12.2017;2017;12;02;Sunnuntai;0;0;0;0;0;0
294;17.12.2017;2017;12;03;Sunnuntai;0;0;0;0;0;0
294;17.12.2017;2017;12;04;Sunnuntai;0;0;0;4;1;5
294;17.12.2017;2017;12;05;Sunnuntai;0;0;0;0;0;0
294;17.12.2017;2017;12;06;Sunnuntai;0;0;0;2;2;4
294;17.12.2017;2017;12;07;Sunnuntai;0;0;0;1;1;2
294;17.12.2017;2017;12;08;Sunnuntai;0;0;0;3;2;5
294;17.12.2017;2017;12;09;Sunnuntai;0;0;0;8;5;13
294;17.12.2017;2017;12;10;Sunnuntai;0;0;0;4;7;11
294;17.12.2017;2017;12;11;Sunnuntai;0;1;1;15;13;28
294;17.12.2017;2017;12;12;Sunnuntai;0;1;1;13;6;19
294;17.12.2017;2017;12;13;Sunnuntai;9;1;10;5;7;12
294;17.12.2017;2017;12;14;Sunnuntai;2;6;8;4;10;14
294;17.12.2017;2017;12;15;Sunnuntai;0;2;2;11;5;16
294;17.12.2017;2017;12;16;Sunnuntai;2;0;2;9;9;18
294;17.12.2017;2017;12;17;Sunnuntai;0;3;3;2;13;15
294;17.12.2017;2017;12;18;Sunnuntai;8;2;10;18;4;22
294;17.12.2017;2017;12;19;Sunnuntai;5;7;12;7;9;16
294;17.12.2017;2017;12;20;Sunnuntai;1;5;6;3;11;14
294;17.12.2017;2017;12;21;Sunnuntai;0;2;2;1;0;1
294;17.12.2017;2017;12;22;Sunnuntai;2;1;3;0;0;0
294;17.12.2017;2017;12;23;Sunnuntai;0;0;0;0;0;0
294;18.12.2017;2017;12;00;Maanantai;1;0;1;0;0;0
294;18.12.2017;2017;12;01;Maanantai;0;0;0;0;0;0
294;18.12.2017;2017;12;02;Maanantai;0;0;0;0;0;0
294;18.12.2017;2017;12;03;Maanantai;0;0;0;0;0;0
294;18.12.2017;2017;12;04;Maanantai;0;0;0;0;0;0
294;18.12.2017;2017;12;05;Maanantai;0;0;0;2;1;3
294;18.12.2017;2017;12;06;Maanantai;1;0;1;3;2;5
294;18.12.2017;2017;12;07;Maanantai;11;6;17;9;5;14
294;18.12.2017;2017;12;08;Maanantai;15;3;18;13;2;15
294;18.12.2017;2017;12;09;Maanantai;13;3;16;11;6;17
294;18.12.2017;2017;12;10;Maanantai;5;1;6;11;8;19
294;18.12.2017;2017;12;11;Maanantai;2;8;10;8;21;29
294;18.12.2017;2017;12;12;Maanantai;3;3;6;16;14;30
294;18.12.2017;2017;12;13;Maanantai;10;23;33;32;30;62
294;18.12.2017;2017;12;14;Maanantai;7;21;28;24;21;45
294;18.12.2017;2017;12;15;Maanantai;3;8;11;11;15;26
294;18.12.2017;2017;12;16;Maanantai;5;10;15;8;18;26
294;18.12.2017;2017;12;17;Maanantai;6;5;11;9;7;16
294;18.12.2017;2017;12;18;Maanantai;3;3;6;7;14;21
294;18.12.2017;2017;12;19;Maanantai;0;3;3;3;7;10
294;18.12.2017;2017;12;20;Maanantai;2;2;4;6;8;14
294;18.12.2017;2017;12;21;Maanantai;3;2;5;5;2;7
294;18.12.2017;2017;12;22;Maanantai;0;1;1;0;0;0
294;18.12.2017;2017;12;23;Maanantai;0;0;0;1;0;1
294;19.12.2017;2017;12;00;Tiistai;0;0;0;0;0;0
294;19.12.2017;2017;12;01;Tiistai;0;0;0;0;0;0
294;19.12.2017;2017;12;02;Tiistai;0;0;0;0;0;0
294;19.12.2017;2017;12;03;Tiistai;0;0;0;0;0;0
294;19.12.2017;2017;12;04;Tiistai;0;0;0;0;0;0
294;19.12.2017;2017;12;05;Tiistai;0;0;0;3;1;4
294;19.12.2017;2017;12;06;Tiistai;1;1;2;3;1;4
294;19.12.2017;2017;12;07;Tiistai;5;5;10;7;7;14
294;19.12.2017;2017;12;08;Tiistai;21;1;22;12;7;19
294;19.12.2017;2017;12;09;Tiistai;14;2;16;14;12;26
294;19.12.2017;2017;12;10;Tiistai;5;5;10;15;14;29
294;19.12.2017;2017;12;11;Tiistai;5;9;14;23;19;42
294;19.12.2017;2017;12;12;Tiistai;9;6;15;17;16;33
294;19.12.2017;2017;12;13;Tiistai;5;4;9;23;16;39
294;19.12.2017;2017;12;14;Tiistai;9;8;17;15;16;31
294;19.12.2017;2017;12;15;Tiistai;5;20;25;13;21;34
294;19.12.2017;2017;12;16;Tiistai;12;6;18;12;16;28
294;19.12.2017;2017;12;17;Tiistai;1;4;5;14;7;21
294;19.12.2017;2017;12;18;Tiistai;5;5;10;16;12;28
294;19.12.2017;2017;12;19;Tiistai;0;3;3;5;9;14
294;19.12.2017;2017;12;20;Tiistai;0;0;0;8;8;16
294;19.12.2017;2017;12;21;Tiistai;1;2;3;3;2;5
294;19.12.2017;2017;12;22;Tiistai;0;0;0;0;0;0
294;19.12.2017;2017;12;23;Tiistai;0;0;0;0;0;0
294;20.12.2017;2017;12;00;Keskiviikko;0;0;0;0;0;0
294;20.12.2017;2017;12;01;Keskiviikko;0;0;0;0;0;0
294;20.12.2017;2017;12;02;Keskiviikko;0;0;0;0;0;0
294;20.12.2017;2017;12;03;Keskiviikko;0;0;0;0;0;0
294;20.12.2017;2017;12;04;Keskiviikko;0;0;0;0;0;0
294;20.12.2017;2017;12;05;Keskiviikko;0;0;0;2;2;4
294;20.12.2017;2017;12;06;Keskiviikko;0;0;0;2;2;4
294;20.12.2017;2017;12;07;Keskiviikko;10;5;15;12;8;20
294;20.12.2017;2017;12;08;Keskiviikko;14;3;17;13;5;18
294;20.12.2017;2017;12;09;Keskiviikko;5;6;11;5;7;12
294;20.12.2017;2017;12;10;Keskiviikko;3;2;5;7;5;12
294;20.12.2017;2017;12;11;Keskiviikko;4;3;7;10;5;15
294;20.12.2017;2017;12;12;Keskiviikko;2;4;6;11;7;18
294;20.12.2017;2017;12;13;Keskiviikko;3;7;10;2;7;9
294;20.12.2017;2017;12;14;Keskiviikko;3;16;19;11;11;22
294;20.12.2017;2017;12;15;Keskiviikko;3;3;6;16;11;27
294;20.12.2017;2017;12;16;Keskiviikko;2;4;6;5;7;12
294;20.12.2017;2017;12;17;Keskiviikko;7;1;8;5;4;9
294;20.12.2017;2017;12;18;Keskiviikko;0;3;3;7;4;11
294;20.12.2017;2017;12;19;Keskiviikko;0;0;0;7;4;11
294;20.12.2017;2017;12;20;Keskiviikko;1;1;2;3;6;9
294;20.12.2017;2017;12;21;Keskiviikko;0;1;1;0;0;0
294;20.12.2017;2017;12;22;Keskiviikko;0;0;0;0;0;0
294;20.12.2017;2017;12;23;Keskiviikko;0;0;0;2;0;2
294;21.12.2017;2017;12;00;Torstai;0;0;0;0;0;0
294;21.12.2017;2017;12;01;Torstai;0;0;0;0;0;0
294;21.12.2017;2017;12;02;Torstai;0;0;0;0;0;0
294;21.12.2017;2017;12;03;Torstai;0;1;1;0;0;0
294;21.12.2017;2017;12;04;Torstai;2;0;2;0;0;0
294;21.12.2017;2017;12;05;Torstai;0;0;0;4;0;4
294;21.12.2017;2017;12;06;Torstai;0;0;0;4;0;4
294;21.12.2017;2017;12;07;Torstai;3;2;5;20;0;20
294;21.12.2017;2017;12;08;Torstai;6;6;12;18;0;18
294;21.12.2017;2017;12;09;Torstai;3;2;5;12;0;12
294;21.12.2017;2017;12;10;Torstai;2;2;4;12;0;12
294;21.12.2017;2017;12;11;Torstai;0;0;0;15;0;15
294;21.12.2017;2017;12;12;Torstai;2;2;4;18;0;18
294;21.12.2017;2017;12;13;Torstai;7;6;13;9;0;9
294;21.12.2017;2017;12;14;Torstai;5;5;10;22;0;22
294;21.12.2017;2017;12;15;Torstai;13;13;26;27;0;27
294;21.12.2017;2017;12;16;Torstai;4;4;8;12;0;12
294;21.12.2017;2017;12;17;Torstai;3;2;5;9;0;9
294;21.12.2017;2017;12;18;Torstai;7;7;14;11;0;11
294;21.12.2017;2017;12;19;Torstai;4;3;7;11;0;11
294;21.12.2017;2017;12;20;Torstai;1;1;2;9;0;9
294;21.12.2017;2017;12;21;Torstai;1;0;1;0;0;0
294;21.12.2017;2017;12;22;Torstai;1;0;1;0;0;0
294;21.12.2017;2017;12;23;Torstai;2;2;4;2;0;2
294;22.12.2017;2017;12;00;Perjantai;3;2;5;0;0;0
294;22.12.2017;2017;12;01;Perjantai;0;0;0;0;0;0
294;22.12.2017;2017;12;02;Perjantai;0;0;0;0;0;0
294;22.12.2017;2017;12;03;Perjantai;0;0;0;0;0;0
294;22.12.2017;2017;12;04;Perjantai;0;0;0;0;0;0
294;22.12.2017;2017;12;05;Perjantai;0;0;0;4;0;4
294;22.12.2017;2017;12;06;Perjantai;0;0;0;4;0;4
294;22.12.2017;2017;12;07;Perjantai;4;3;7;20;0;20
294;22.12.2017;2017;12;08;Perjantai;3;3;6;18;0;18
294;22.12.2017;2017;12;09;Perjantai;4;3;7;12;0;12
294;22.12.2017;2017;12;10;Perjantai;2;1;3;12;0;12
294;22.12.2017;2017;12;11;Perjantai;11;10;21;15;0;15
294;22.12.2017;2017;12;12;Perjantai;7;6;13;18;0;18
294;22.12.2017;2017;12;13;Perjantai;6;6;12;9;0;9
294;22.12.2017;2017;12;14;Perjantai;2;2;4;22;0;22
294;22.12.2017;2017;12;15;Perjantai;5;5;10;27;0;27
294;22.12.2017;2017;12;16;Perjantai;2;1;3;12;0;12
294;22.12.2017;2017;12;17;Perjantai;1;0;1;9;0;9
294;22.12.2017;2017;12;18;Perjantai;0;0;0;11;0;11
294;22.12.2017;2017;12;19;Perjantai;5;4;9;11;0;11
294;22.12.2017;2017;12;20;Perjantai;4;3;7;9;0;9
294;22.12.2017;2017;12;21;Perjantai;2;1;3;0;0;0
294;22.12.2017;2017;12;22;Perjantai;1;1;2;0;0;0
294;22.12.2017;2017;12;23;Perjantai;0;0;0;2;0;2
294;23.12.2017;2017;12;00;Lauantai;0;0;0;4;0;4
294;23.12.2017;2017;12;01;Lauantai;0;0;0;0;0;0
294;23.12.2017;2017;12;02;Lauantai;0;0;0;0;0;0
294;23.12.2017;2017;12;03;Lauantai;0;0;0;0;0;0
294;23.12.2017;2017;12;04;Lauantai;0;0;0;1;0;1
294;23.12.2017;2017;12;05;Lauantai;0;0;0;1;0;1
294;23.12.2017;2017;12;06;Lauantai;0;0;0;1;0;1
294;23.12.2017;2017;12;07;Lauantai;0;0;0;3;0;3
294;23.12.2017;2017;12;08;Lauantai;0;0;0;1;0;1
294;23.12.2017;2017;12;09;Lauantai;2;2;4;7;0;7
294;23.12.2017;2017;12;10;Lauantai;2;1;3;17;0;17
294;23.12.2017;2017;12;11;Lauantai;1;1;2;11;0;11
294;23.12.2017;2017;12;12;Lauantai;2;1;3;12;0;12
294;23.12.2017;2017;12;13;Lauantai;2;1;3;11;0;11
294;23.12.2017;2017;12;14;Lauantai;1;0;1;10;0;10
294;23.12.2017;2017;12;15;Lauantai;3;3;6;13;0;13
294;23.12.2017;2017;12;16;Lauantai;1;1;2;11;0;11
294;23.12.2017;2017;12;17;Lauantai;2;1;3;8;0;8
294;23.12.2017;2017;12;18;Lauantai;2;2;4;7;0;7
294;23.12.2017;2017;12;19;Lauantai;2;2;4;2;0;2
294;23.12.2017;2017;12;20;Lauantai;0;0;0;3;0;3
294;23.12.2017;2017;12;21;Lauantai;0;0;0;1;0;1
294;23.12.2017;2017;12;22;Lauantai;0;0;0;1;0;1
294;23.12.2017;2017;12;23;Lauantai;0;0;0;0;0;0
294;24.12.2017;2017;12;00;Sunnuntai;0;0;0;1;0;1
294;24.12.2017;2017;12;01;Sunnuntai;0;0;0;0;0;0
294;24.12.2017;2017;12;02;Sunnuntai;2;1;3;0;0;0
294;24.12.2017;2017;12;03;Sunnuntai;0;0;0;0;0;0
294;24.12.2017;2017;12;04;Sunnuntai;0;0;0;1;0;1
294;24.12.2017;2017;12;05;Sunnuntai;0;0;0;1;0;1
294;24.12.2017;2017;12;06;Sunnuntai;0;0;0;1;0;1
294;24.12.2017;2017;12;07;Sunnuntai;0;0;0;1;0;1
294;24.12.2017;2017;12;08;Sunnuntai;0;0;0;1;0;1
294;24.12.2017;2017;12;09;Sunnuntai;0;0;0;2;0;2
294;24.12.2017;2017;12;10;Sunnuntai;2;1;3;5;0;5
294;24.12.2017;2017;12;11;Sunnuntai;1;0;1;3;0;3
294;24.12.2017;2017;12;12;Sunnuntai;2;2;4;3;0;3
294;24.12.2017;2017;12;13;Sunnuntai;0;0;0;3;0;3
294;24.12.2017;2017;12;14;Sunnuntai;0;0;0;3;0;3
294;24.12.2017;2017;12;15;Sunnuntai;0;0;0;4;0;4
294;24.12.2017;2017;12;16;Sunnuntai;1;1;2;3;0;3
294;24.12.2017;2017;12;17;Sunnuntai;0;0;0;2;0;2
294;24.12.2017;2017;12;18;Sunnuntai;0;0;0;2;0;2
294;24.12.2017;2017;12;19;Sunnuntai;0;0;0;1;0;1
294;24.12.2017;2017;12;20;Sunnuntai;0;0;0;1;0;1
294;24.12.2017;2017;12;21;Sunnuntai;0;0;0;1;0;1
294;24.12.2017;2017;12;22;Sunnuntai;0;0;0;1;0;1
294;24.12.2017;2017;12;23;Sunnuntai;0;0;0;0;0;0
294;25.12.2017;2017;12;00;Maanantai;0;0;0;0;0;0
294;25.12.2017;2017;12;01;Maanantai;0;0;0;0;0;0
294;25.12.2017;2017;12;02;Maanantai;0;0;0;0;0;0
294;25.12.2017;2017;12;03;Maanantai;0;0;0;0;0;0
294;25.12.2017;2017;12;04;Maanantai;0;0;0;0;0;0
294;25.12.2017;2017;12;05;Maanantai;0;0;0;0;0;0
294;25.12.2017;2017;12;06;Maanantai;0;0;0;0;0;0
294;25.12.2017;2017;12;07;Maanantai;0;0;0;0;0;0
294;25.12.2017;2017;12;08;Maanantai;0;0;0;0;0;0
294;25.12.2017;2017;12;09;Maanantai;0;0;0;4;0;4
294;25.12.2017;2017;12;10;Maanantai;1;1;2;3;0;3
294;25.12.2017;2017;12;11;Maanantai;2;1;3;2;0;2
294;25.12.2017;2017;12;12;Maanantai;1;0;1;3;0;3
294;25.12.2017;2017;12;13;Maanantai;1;0;1;3;0;3
294;25.12.2017;2017;12;14;Maanantai;1;1;2;1;0;1
294;25.12.2017;2017;12;15;Maanantai;2;1;3;6;0;6
294;25.12.2017;2017;12;16;Maanantai;2;1;3;2;0;2
294;25.12.2017;2017;12;17;Maanantai;3;2;5;3;0;3
294;25.12.2017;2017;12;18;Maanantai;3;2;5;4;0;4
294;25.12.2017;2017;12;19;Maanantai;3;3;6;4;0;4
294;25.12.2017;2017;12;20;Maanantai;2;2;4;0;0;0
294;25.12.2017;2017;12;21;Maanantai;0;0;0;0;0;0
294;25.12.2017;2017;12;22;Maanantai;1;0;1;0;0;0
294;25.12.2017;2017;12;23;Maanantai;0;0;0;0;0;0
294;26.12.2017;2017;12;00;Tiistai;1;1;2;2;0;2
294;26.12.2017;2017;12;01;Tiistai;0;0;0;0;0;0
294;26.12.2017;2017;12;02;Tiistai;0;0;0;0;0;0
294;26.12.2017;2017;12;03;Tiistai;0;0;0;0;0;0
294;26.12.2017;2017;12;04;Tiistai;0;0;0;1;0;1
294;26.12.2017;2017;12;05;Tiistai;0;0;0;1;0;1
294;26.12.2017;2017;12;06;Tiistai;0;0;0;1;0;1
294;26.12.2017;2017;12;07;Tiistai;1;0;1;2;0;2
294;26.12.2017;2017;12;08;Tiistai;0;0;0;1;0;1
294;26.12.2017;2017;12;09;Tiistai;1;1;2;4;0;4
294;26.12.2017;2017;12;10;Tiistai;1;0;1;9;0;9
294;26.12.2017;2017;12;11;Tiistai;1;0;1;6;0;6
294;26.12.2017;2017;12;12;Tiistai;0;0;0;6;0;6
294;26.12.2017;2017;12;13;Tiistai;1;1;2;6;0;6
294;26.12.2017;2017;12;14;Tiistai;1;1;2;5;0;5
294;26.12.2017;2017;12;15;Tiistai;1;0;1;7;0;7
294;26.12.2017;2017;12;16;Tiistai;1;0;1;6;0;6
294;26.12.2017;2017;12;17;Tiistai;2;1;3;4;0;4
294;26.12.2017;2017;12;18;Tiistai;3;3;6;4;0;4
294;26.12.2017;2017;12;19;Tiistai;1;1;2;1;0;1
294;26.12.2017;2017;12;20;Tiistai;2;2;4;2;0;2
294;26.12.2017;2017;12;21;Tiistai;1;0;1;1;0;1
294;26.12.2017;2017;12;22;Tiistai;2;1;3;1;0;1
294;26.12.2017;2017;12;23;Tiistai;0;0;0;0;0;0
294;27.12.2017;2017;12;00;Keskiviikko;1;1;2;0;0;0
294;27.12.2017;2017;12;01;Keskiviikko;0;0;0;0;0;0
294;27.12.2017;2017;12;02;Keskiviikko;0;0;0;0;0;0
294;27.12.2017;2017;12;03;Keskiviikko;0;0;0;0;0;0
294;27.12.2017;2017;12;04;Keskiviikko;0;0;0;0;0;0
294;27.12.2017;2017;12;05;Keskiviikko;0;0;0;2;0;2
294;27.12.2017;2017;12;06;Keskiviikko;0;0;0;2;0;2
294;27.12.2017;2017;12;07;Keskiviikko;0;0;0;12;0;12
294;27.12.2017;2017;12;08;Keskiviikko;1;1;2;11;0;11
294;27.12.2017;2017;12;09;Keskiviikko;0;0;0;7;0;7
294;27.12.2017;2017;12;10;Keskiviikko;0;0;0;7;0;7
294;27.12.2017;2017;12;11;Keskiviikko;1;1;2;9;0;9
294;27.12.2017;2017;12;12;Keskiviikko;1;1;2;11;0;11
294;27.12.2017;2017;12;13;Keskiviikko;2;1;3;5;0;5
294;27.12.2017;2017;12;14;Keskiviikko;3;2;5;13;0;13
294;27.12.2017;2017;12;15;Keskiviikko;1;1;2;16;0;16
294;27.12.2017;2017;12;16;Keskiviikko;1;1;2;7;0;7
294;27.12.2017;2017;12;17;Keskiviikko;1;0;1;5;0;5
294;27.12.2017;2017;12;18;Keskiviikko;2;1;3;7;0;7
294;27.12.2017;2017;12;19;Keskiviikko;2;1;3;7;0;7
294;27.12.2017;2017;12;20;Keskiviikko;1;0;1;5;0;5
294;27.12.2017;2017;12;21;Keskiviikko;3;3;6;0;0;0
294;27.12.2017;2017;12;22;Keskiviikko;0;0;0;0;0;0
294;27.12.2017;2017;12;23;Keskiviikko;1;0;1;1;0;1
294;28.12.2017;2017;12;00;Torstai;0;0;0;0;0;0
294;28.12.2017;2017;12;01;Torstai;0;0;0;0;0;0
294;28.12.2017;2017;12;02;Torstai;0;0;0;0;0;0
294;28.12.2017;2017;12;03;Torstai;0;0;0;0;0;0
294;28.12.2017;2017;12;04;Torstai;0;0;0;0;0;0
294;28.12.2017;2017;12;05;Torstai;0;0;0;4;0;4
294;28.12.2017;2017;12;06;Torstai;0;0;0;4;0;4
294;28.12.2017;2017;12;07;Torstai;0;0;0;20;0;20
294;28.12.2017;2017;12;08;Torstai;1;1;2;18;0;18
294;28.12.2017;2017;12;09;Torstai;1;0;1;12;0;12
294;28.12.2017;2017;12;10;Torstai;0;0;0;12;0;12
294;28.12.2017;2017;12;11;Torstai;3;2;5;15;0;15
294;28.12.2017;2017;12;12;Torstai;2;2;4;18;0;18
294;28.12.2017;2017;12;13;Torstai;2;1;3;9;0;9
294;28.12.2017;2017;12;14;Torstai;1;1;2;22;0;22
294;28.12.2017;2017;12;15;Torstai;5;5;10;27;0;27
294;28.12.2017;2017;12;16;Torstai;1;0;1;12;0;12
294;28.12.2017;2017;12;17;Torstai;4;4;8;9;0;9
294;28.12.2017;2017;12;18;Torstai;3;2;5;11;0;11
294;28.12.2017;2017;12;19;Torstai;4;3;7;11;0;11
294;28.12.2017;2017;12;20;Torstai;2;1;3;9;0;9
294;28.12.2017;2017;12;21;Torstai;3;3;6;0;0;0
294;28.12.2017;2017;12;22;Torstai;3;2;5;0;0;0
294;28.12.2017;2017;12;23;Torstai;1;1;2;2;0;2
294;29.12.2017;2017;12;00;Perjantai;1;0;1;0;0;0
294;29.12.2017;2017;12;01;Perjantai;0;0;0;0;0;0
294;29.12.2017;2017;12;02;Perjantai;0;0;0;0;0;0
294;29.12.2017;2017;12;03;Perjantai;0;0;0;0;0;0
294;29.12.2017;2017;12;04;Perjantai;0;0;0;0;0;0
294;29.12.2017;2017;12;05;Perjantai;0;0;0;4;0;4
294;29.12.2017;2017;12;06;Perjantai;1;1;2;4;0;4
294;29.12.2017;2017;12;07;Perjantai;0;0;0;20;0;20
294;29.12.2017;2017;12;08;Perjantai;1;0;1;18;0;18
294;29.12.2017;2017;12;09;Perjantai;1;0;1;12;0;12
294;29.12.2017;2017;12;10;Perjantai;0;0;0;12;0;12
294;29.12.2017;2017;12;11;Perjantai;2;1;3;15;0;15
294;29.12.2017;2017;12;12;Perjantai;2;2;4;18;0;18
294;29.12.2017;2017;12;13;Perjantai;2;1;3;9;0;9
294;29.12.2017;2017;12;14;Perjantai;3;3;6;22;0;22
294;29.12.2017;2017;12;15;Perjantai;4;3;7;27;0;27
294;29.12.2017;2017;12;16;Perjantai;1;0;1;12;0;12
294;29.12.2017;2017;12;17;Perjantai;2;1;3;9;0;9
294;29.12.2017;2017;12;18;Perjantai;3;2;5;11;0;11
294;29.12.2017;2017;12;19;Perjantai;2;1;3;11;0;11
294;29.12.2017;2017;12;20;Perjantai;1;0;1;9;0;9
294;29.12.2017;2017;12;21;Perjantai;2;1;3;0;0;0
294;29.12.2017;2017;12;22;Perjantai;1;0;1;0;0;0
294;29.12.2017;2017;12;23;Perjantai;1;1;2;2;0;2
294;30.12.2017;2017;12;00;Lauantai;0;0;0;4;0;4
294;30.12.2017;2017;12;01;Lauantai;0;0;0;0;0;0
294;30.12.2017;2017;12;02;Lauantai;0;0;0;0;0;0
294;30.12.2017;2017;12;03;Lauantai;0;0;0;0;0;0
294;30.12.2017;2017;12;04;Lauantai;1;0;1;1;0;1
294;30.12.2017;2017;12;05;Lauantai;0;0;0;1;0;1
294;30.12.2017;2017;12;06;Lauantai;0;0;0;1;0;1
294;30.12.2017;2017;12;07;Lauantai;0;0;0;3;0;3
294;30.12.2017;2017;12;08;Lauantai;0;0;0;1;0;1
294;30.12.2017;2017;12;09;Lauantai;1;0;1;7;0;7
294;30.12.2017;2017;12;10;Lauantai;0;0;0;17;0;17
294;30.12.2017;2017;12;11;Lauantai;4;3;7;11;0;11
294;30.12.2017;2017;12;12;Lauantai;1;0;1;12;0;12
294;30.12.2017;2017;12;13;Lauantai;1;1;2;11;0;11
294;30.12.2017;2017;12;14;Lauantai;5;4;9;10;0;10
294;30.12.2017;2017;12;15;Lauantai;2;2;4;13;0;13
294;30.12.2017;2017;12;16;Lauantai;1;0;1;11;0;11
294;30.12.2017;2017;12;17;Lauantai;1;1;2;8;0;8
294;30.12.2017;2017;12;18;Lauantai;4;3;7;7;0;7
294;30.12.2017;2017;12;19;Lauantai;5;5;10;2;0;2
294;30.12.2017;2017;12;20;Lauantai;4;3;7;3;0;3
294;30.12.2017;2017;12;21;Lauantai;3;3;6;1;0;1
294;30.12.2017;2017;12;22;Lauantai;0;0;0;1;0;1
294;30.12.2017;2017;12;23;Lauantai;1;0;1;0;0;0
294;31.12.2017;2017;12;00;Sunnuntai;0;0;0;4;0;4
294;31.12.2017;2017;12;01;Sunnuntai;0;0;0;0;0;0
294;31.12.2017;2017;12;02;Sunnuntai;0;0;0;0;0;0
294;31.12.2017;2017;12;03;Sunnuntai;0;0;0;0;0;0
294;31.12.2017;2017;12;04;Sunnuntai;0;0;0;1;0;1
294;31.12.2017;2017;12;05;Sunnuntai;0;0;0;1;0;1
294;31.12.2017;2017;12;06;Sunnuntai;0;0;0;1;0;1
294;31.12.2017;2017;12;07;Sunnuntai;0;0;0;3;0;3
294;31.12.2017;2017;12;08;Sunnuntai;0;0;0;1;0;1
294;31.12.2017;2017;12;09;Sunnuntai;1;1;2;7;0;7
294;31.12.2017;2017;12;10;Sunnuntai;1;0;1;17;0;17
294;31.12.2017;2017;12;11;Sunnuntai;2;1;3;11;0;11
294;31.12.2017;2017;12;12;Sunnuntai;2;2;4;12;0;12
294;31.12.2017;2017;12;13;Sunnuntai;3;2;5;11;0;11
294;31.12.2017;2017;12;14;Sunnuntai;2;1;3;10;0;10
294;31.12.2017;2017;12;15;Sunnuntai;3;3;6;13;0;13
294;31.12.2017;2017;12;16;Sunnuntai;2;1;3;11;0;11
294;31.12.2017;2017;12;17;Sunnuntai;1;0;1;8;0;8
294;31.12.2017;2017;12;18;Sunnuntai;3;3;6;7;0;7
294;31.12.2017;2017;12;19;Sunnuntai;1;1;2;2;0;2
294;31.12.2017;2017;12;20;Sunnuntai;1;1;2;3;0;3
294;31.12.2017;2017;12;21;Sunnuntai;1;0;1;1;0;1
294;31.12.2017;2017;12;22;Sunnuntai;1;0;1;1;0;1
294;31.12.2017;2017;12;23;Sunnuntai;1;1;2;0;0;0
294;01.01.2018;2018;01;00;Maanantai;1;0;1;0;0;0
294;01.01.2018;2018;01;01;Maanantai;1;0;1;0;0;0
294;01.01.2018;2018;01;02;Maanantai;1;1;2;0;0;0
294;01.01.2018;2018;01;03;Maanantai;0;0;0;0;0;0
294;01.01.2018;2018;01;04;Maanantai;0;0;0;0;0;0
294;01.01.2018;2018;01;05;Maanantai;0;0;0;0;0;0
294;01.01.2018;2018;01;06;Maanantai;0;0;0;0;0;0
294;01.01.2018;2018;01;07;Maanantai;0;0;0;0;0;0
294;01.01.2018;2018;01;08;Maanantai;0;0;0;0;0;0
294;01.01.2018;2018;01;09;Maanantai;1;0;1;4;0;4
294;01.01.2018;2018;01;10;Maanantai;0;0;0;3;0;3
294;01.01.2018;2018;01;11;Maanantai;1;1;2;2;0;2
294;01.01.2018;2018;01;12;Maanantai;1;1;2;3;0;3
294;01.01.2018;2018;01;13;Maanantai;2;1;3;3;0;3
294;01.01.2018;2018;01;14;Maanantai;2;2;4;1;0;1
294;01.01.2018;2018;01;15;Maanantai;1;1;2;6;0;6
294;01.01.2018;2018;01;16;Maanantai;2;1;3;2;0;2
294;01.01.2018;2018;01;17;Maanantai;4;3;7;3;0;3
294;01.01.2018;2018;01;18;Maanantai;2;2;4;4;0;4
294;01.01.2018;2018;01;19;Maanantai;3;2;5;4;0;4
294;01.01.2018;2018;01;20;Maanantai;2;2;4;0;0;0
294;01.01.2018;2018;01;21;Maanantai;1;1;2;0;0;0
294;01.01.2018;2018;01;22;Maanantai;1;0;1;0;0;0
294;01.01.2018;2018;01;23;Maanantai;0;0;0;0;0;0
294;02.01.2018;2018;01;00;Tiistai;1;0;1;2;0;2
294;02.01.2018;2018;01;01;Tiistai;0;0;0;0;0;0
294;02.01.2018;2018;01;02;Tiistai;0;0;0;0;0;0
294;02.01.2018;2018;01;03;Tiistai;0;0;0;0;0;0
294;02.01.2018;2018;01;04;Tiistai;0;0;0;1;0;1
294;02.01.2018;2018;01;05;Tiistai;1;0;1;1;0;1
294;02.01.2018;2018;01;06;Tiistai;1;1;2;1;0;1
294;02.01.2018;2018;01;07;Tiistai;1;0;1;2;0;2
294;02.01.2018;2018;01;08;Tiistai;1;1;2;1;0;1
294;02.01.2018;2018;01;09;Tiistai;1;0;1;4;0;4
294;02.01.2018;2018;01;10;Tiistai;2;2;4;9;0;9
294;02.01.2018;2018;01;11;Tiistai;2;1;3;6;0;6
294;02.01.2018;2018;01;12;Tiistai;1;1;2;6;0;6
294;02.01.2018;2018;01;13;Tiistai;8;8;16;6;0;6
294;02.01.2018;2018;01;14;Tiistai;5;4;9;5;0;5
294;02.01.2018;2018;01;15;Tiistai;5;5;10;7;0;7
294;02.01.2018;2018;01;16;Tiistai;3;2;5;6;0;6
294;02.01.2018;2018;01;17;Tiistai;5;4;9;4;0;4
294;02.01.2018;2018;01;18;Tiistai;2;1;3;4;0;4
294;02.01.2018;2018;01;19;Tiistai;1;0;1;1;0;1
294;02.01.2018;2018;01;20;Tiistai;1;1;2;2;0;2
294;02.01.2018;2018;01;21;Tiistai;2;2;4;1;0;1
294;02.01.2018;2018;01;22;Tiistai;2;1;3;1;0;1
294;02.01.2018;2018;01;23;Tiistai;0;0;0;0;0;0
294;03.01.2018;2018;01;00;Keskiviikko;0;0;0;0;0;0
294;03.01.2018;2018;01;01;Keskiviikko;0;0;0;0;0;0
294;03.01.2018;2018;01;02;Keskiviikko;0;0;0;0;0;0
294;03.01.2018;2018;01;03;Keskiviikko;0;0;0;0;0;0
294;03.01.2018;2018;01;04;Keskiviikko;0;0;0;0;0;0
294;03.01.2018;2018;01;05;Keskiviikko;0;0;0;2;0;2
294;03.01.2018;2018;01;06;Keskiviikko;0;0;0;2;0;2
294;03.01.2018;2018;01;07;Keskiviikko;1;1;2;12;0;12
294;03.01.2018;2018;01;08;Keskiviikko;1;0;1;11;0;11
294;03.01.2018;2018;01;09;Keskiviikko;1;1;2;7;0;7
294;03.01.2018;2018;01;10;Keskiviikko;1;1;2;7;0;7
294;03.01.2018;2018;01;11;Keskiviikko;3;2;5;9;0;9
294;03.01.2018;2018;01;12;Keskiviikko;2;1;3;11;0;11
294;03.01.2018;2018;01;13;Keskiviikko;4;4;8;5;0;5
294;03.01.2018;2018;01;14;Keskiviikko;3;3;6;13;0;13
294;03.01.2018;2018;01;15;Keskiviikko;3;3;6;16;0;16
294;03.01.2018;2018;01;16;Keskiviikko;2;2;4;7;0;7
294;03.01.2018;2018;01;17;Keskiviikko;6;5;11;5;0;5
294;03.01.2018;2018;01;18;Keskiviikko;9;9;18;7;0;7
294;03.01.2018;2018;01;19;Keskiviikko;6;5;11;7;0;7
294;03.01.2018;2018;01;20;Keskiviikko;1;0;1;5;0;5
294;03.01.2018;2018;01;21;Keskiviikko;1;0;1;0;0;0
294;03.01.2018;2018;01;22;Keskiviikko;0;0;0;0;0;0
294;03.01.2018;2018;01;23;Keskiviikko;3;2;5;1;0;1
294;04.01.2018;2018;01;00;Torstai;0;0;0;0;0;0
294;04.01.2018;2018;01;01;Torstai;0;0;0;0;0;0
294;04.01.2018;2018;01;02;Torstai;0;0;0;0;0;0
294;04.01.2018;2018;01;03;Torstai;0;0;0;0;0;0
294;04.01.2018;2018;01;04;Torstai;0;0;0;0;0;0
294;04.01.2018;2018;01;05;Torstai;0;0;0;4;0;4
294;04.01.2018;2018;01;06;Torstai;0;0;0;4;0;4
294;04.01.2018;2018;01;07;Torstai;0;0;0;20;0;20
294;04.01.2018;2018;01;08;Torstai;2;0;2;18;0;18
294;04.01.2018;2018;01;09;Torstai;1;0;1;12;0;12
294;04.01.2018;2018;01;10;Torstai;0;0;0;12;0;12
294;04.01.2018;2018;01;11;Torstai;5;0;5;15;0;15
294;04.01.2018;2018;01;12;Torstai;4;0;4;18;0;18
294;04.01.2018;2018;01;13;Torstai;3;0;3;9;0;9
294;04.01.2018;2018;01;14;Torstai;2;0;2;22;0;22
294;04.01.2018;2018;01;15;Torstai;10;0;10;27;0;27
294;04.01.2018;2018;01;16;Torstai;1;0;1;12;0;12
294;04.01.2018;2018;01;17;Torstai;8;0;8;9;0;9
294;04.01.2018;2018;01;18;Torstai;5;0;5;11;0;11
294;04.01.2018;2018;01;19;Torstai;7;0;7;11;0;11
294;04.01.2018;2018;01;20;Torstai;3;0;3;9;0;9
294;04.01.2018;2018;01;21;Torstai;6;0;6;0;0;0
294;04.01.2018;2018;01;22;Torstai;5;0;5;0;0;0
294;04.01.2018;2018;01;23;Torstai;2;0;2;2;0;2
294;05.01.2018;2018;01;00;Perjantai;0;0;0;0;0;0
294;05.01.2018;2018;01;01;Perjantai;0;0;0;0;0;0
294;05.01.2018;2018;01;02;Perjantai;0;0;0;0;0;0
294;05.01.2018;2018;01;03;Perjantai;0;0;0;0;0;0
294;05.01.2018;2018;01;04;Perjantai;0;0;0;0;0;0
294;05.01.2018;2018;01;05;Perjantai;0;0;0;0;0;0
294;05.01.2018;2018;01;06;Perjantai;0;0;0;0;0;0
294;05.01.2018;2018;01;07;Perjantai;1;1;2;0;0;0
294;05.01.2018;2018;01;08;Perjantai;2;0;2;5;5;10
294;05.01.2018;2018;01;09;Perjantai;0;1;1;8;4;12
294;05.01.2018;2018;01;10;Perjantai;1;0;1;8;11;19
294;05.01.2018;2018;01;11;Perjantai;2;2;4;8;8;16
294;05.01.2018;2018;01;12;Perjantai;1;1;2;5;9;14
294;05.01.2018;2018;01;13;Perjantai;5;3;8;14;8;22
294;05.01.2018;2018;01;14;Perjantai;2;3;5;13;13;26
294;05.01.2018;2018;01;15;Perjantai;2;1;3;8;9;17
294;05.01.2018;2018;01;16;Perjantai;2;5;7;17;8;25
294;05.01.2018;2018;01;17;Perjantai;1;1;2;7;13;20
294;05.01.2018;2018;01;18;Perjantai;0;1;1;14;9;23
294;05.01.2018;2018;01;19;Perjantai;1;0;1;10;4;14
294;05.01.2018;2018;01;20;Perjantai;2;0;2;2;10;12
294;05.01.2018;2018;01;21;Perjantai;1;1;2;1;2;3
294;05.01.2018;2018;01;22;Perjantai;0;0;0;3;1;4
294;05.01.2018;2018;01;23;Perjantai;0;0;0;2;0;2
294;06.01.2018;2018;01;00;Lauantai;0;0;0;3;0;3
294;06.01.2018;2018;01;01;Lauantai;0;0;0;0;1;1
294;06.01.2018;2018;01;02;Lauantai;0;0;0;0;0;0
294;06.01.2018;2018;01;03;Lauantai;0;0;0;0;0;0
294;06.01.2018;2018;01;04;Lauantai;0;0;0;0;0;0
294;06.01.2018;2018;01;05;Lauantai;2;0;2;1;0;1
294;06.01.2018;2018;01;06;Lauantai;0;0;0;2;1;3
294;06.01.2018;2018;01;07;Lauantai;0;0;0;0;0;0
294;06.01.2018;2018;01;08;Lauantai;0;0;0;6;5;11
294;06.01.2018;2018;01;09;Lauantai;0;2;2;6;2;8
294;06.01.2018;2018;01;10;Lauantai;1;0;1;4;9;13
294;06.01.2018;2018;01;11;Lauantai;0;1;1;9;10;19
294;06.01.2018;2018;01;12;Lauantai;2;3;5;8;7;15
294;06.01.2018;2018;01;13;Lauantai;1;2;3;9;7;16
294;06.01.2018;2018;01;14;Lauantai;1;2;3;14;8;22
294;06.01.2018;2018;01;15;Lauantai;3;0;3;11;10;21
294;06.01.2018;2018;01;16;Lauantai;1;1;2;12;9;21
294;06.01.2018;2018;01;17;Lauantai;2;3;5;6;9;15
294;06.01.2018;2018;01;18;Lauantai;2;2;4;8;6;14
294;06.01.2018;2018;01;19;Lauantai;1;0;1;5;1;6
294;06.01.2018;2018;01;20;Lauantai;4;1;5;4;6;10
294;06.01.2018;2018;01;21;Lauantai;2;1;3;2;5;7
294;06.01.2018;2018;01;22;Lauantai;5;0;5;4;1;5
294;06.01.2018;2018;01;23;Lauantai;1;1;2;4;0;4
294;07.01.2018;2018;01;00;Sunnuntai;1;0;1;0;0;0
294;07.01.2018;2018;01;01;Sunnuntai;0;0;0;0;0;0
294;07.01.2018;2018;01;02;Sunnuntai;0;1;1;0;0;0
294;07.01.2018;2018;01;03;Sunnuntai;0;0;0;0;0;0
294;07.01.2018;2018;01;04;Sunnuntai;0;0;0;0;0;0
294;07.01.2018;2018;01;05;Sunnuntai;0;0;0;1;0;1
294;07.01.2018;2018;01;06;Sunnuntai;0;0;0;2;1;3
294;07.01.2018;2018;01;07;Sunnuntai;0;0;0;2;1;3
294;07.01.2018;2018;01;08;Sunnuntai;0;0;0;0;4;4
294;07.01.2018;2018;01;09;Sunnuntai;1;1;2;5;4;9
294;07.01.2018;2018;01;10;Sunnuntai;0;0;0;5;7;12
294;07.01.2018;2018;01;11;Sunnuntai;0;0;0;12;13;25
294;07.01.2018;2018;01;12;Sunnuntai;1;2;3;8;10;18
294;07.01.2018;2018;01;13;Sunnuntai;0;0;0;10;13;23
294;07.01.2018;2018;01;14;Sunnuntai;1;4;5;17;6;23
294;07.01.2018;2018;01;15;Sunnuntai;1;0;1;6;11;17
294;07.01.2018;2018;01;16;Sunnuntai;3;4;7;13;9;22
294;07.01.2018;2018;01;17;Sunnuntai;3;3;6;7;12;19
294;07.01.2018;2018;01;18;Sunnuntai;2;0;2;9;2;11
294;07.01.2018;2018;01;19;Sunnuntai;0;0;0;3;3;6
294;07.01.2018;2018;01;20;Sunnuntai;0;2;2;5;4;9
294;07.01.2018;2018;01;21;Sunnuntai;1;0;1;0;1;1
294;07.01.2018;2018;01;22;Sunnuntai;0;0;0;0;0;0
294;07.01.2018;2018;01;23;Sunnuntai;0;0;0;1;0;1
294;08.01.2018;2018;01;00;Maanantai;0;0;0;0;0;0
294;08.01.2018;2018;01;01;Maanantai;0;0;0;0;0;0
294;08.01.2018;2018;01;02;Maanantai;0;0;0;0;0;0
294;08.01.2018;2018;01;03;Maanantai;0;0;0;0;0;0
294;08.01.2018;2018;01;04;Maanantai;0;0;0;0;0;0
294;08.01.2018;2018;01;05;Maanantai;0;0;0;1;1;2
294;08.01.2018;2018;01;06;Maanantai;0;0;0;1;2;3
294;08.01.2018;2018;01;07;Maanantai;1;4;5;6;6;12
294;08.01.2018;2018;01;08;Maanantai;6;0;6;13;3;16
294;08.01.2018;2018;01;09;Maanantai;4;1;5;10;5;15
294;08.01.2018;2018;01;10;Maanantai;4;2;6;6;8;14
294;08.01.2018;2018;01;11;Maanantai;1;1;2;17;15;32
294;08.01.2018;2018;01;12;Maanantai;2;5;7;12;14;26
294;08.01.2018;2018;01;13;Maanantai;2;9;11;14;15;29
294;08.01.2018;2018;01;14;Maanantai;0;5;5;13;17;30
294;08.01.2018;2018;01;15;Maanantai;6;16;22;16;20;36
294;08.01.2018;2018;01;16;Maanantai;4;3;7;10;14;24
294;08.01.2018;2018;01;17;Maanantai;0;4;4;12;9;21
294;08.01.2018;2018;01;18;Maanantai;3;0;3;18;14;32
294;08.01.2018;2018;01;19;Maanantai;1;0;1;10;11;21
294;08.01.2018;2018;01;20;Maanantai;2;3;5;7;7;14
294;08.01.2018;2018;01;21;Maanantai;1;0;1;3;2;5
294;08.01.2018;2018;01;22;Maanantai;0;0;0;0;0;0
294;08.01.2018;2018;01;23;Maanantai;0;1;1;1;0;1
294;09.01.2018;2018;01;00;Tiistai;0;0;0;0;0;0
294;09.01.2018;2018;01;01;Tiistai;0;0;0;0;0;0
294;09.01.2018;2018;01;02;Tiistai;0;0;0;0;0;0
294;09.01.2018;2018;01;03;Tiistai;0;0;0;0;0;0
294;09.01.2018;2018;01;04;Tiistai;0;0;0;0;0;0
294;09.01.2018;2018;01;05;Tiistai;0;0;0;2;1;3
294;09.01.2018;2018;01;06;Tiistai;0;1;1;6;0;6
294;09.01.2018;2018;01;07;Tiistai;11;4;15;13;6;19
294;09.01.2018;2018;01;08;Tiistai;8;3;11;19;0;19
294;09.01.2018;2018;01;09;Tiistai;5;0;5;10;5;15
294;09.01.2018;2018;01;10;Tiistai;3;2;5;8;7;15
294;09.01.2018;2018;01;11;Tiistai;5;0;5;16;15;31
294;09.01.2018;2018;01;12;Tiistai;2;6;8;18;11;29
294;09.01.2018;2018;01;13;Tiistai;2;2;4;16;21;37
294;09.01.2018;2018;01;14;Tiistai;1;1;2;20;26;46
294;09.01.2018;2018;01;15;Tiistai;5;19;24;19;30;49
294;09.01.2018;2018;01;16;Tiistai;8;4;12;15;18;33
294;09.01.2018;2018;01;17;Tiistai;4;3;7;16;14;30
294;09.01.2018;2018;01;18;Tiistai;1;0;1;12;18;30
294;09.01.2018;2018;01;19;Tiistai;1;3;4;7;12;19
294;09.01.2018;2018;01;20;Tiistai;2;2;4;9;10;19
294;09.01.2018;2018;01;21;Tiistai;0;0;0;2;2;4
294;09.01.2018;2018;01;22;Tiistai;0;1;1;0;0;0
294;09.01.2018;2018;01;23;Tiistai;0;0;0;0;0;0
294;10.01.2018;2018;01;00;Keskiviikko;0;0;0;0;0;0
294;10.01.2018;2018;01;01;Keskiviikko;0;0;0;0;0;0
294;10.01.2018;2018;01;02;Keskiviikko;0;0;0;0;0;0
294;10.01.2018;2018;01;03;Keskiviikko;0;0;0;0;0;0
294;10.01.2018;2018;01;04;Keskiviikko;0;0;0;0;0;0
294;10.01.2018;2018;01;05;Keskiviikko;2;0;2;2;1;3
294;10.01.2018;2018;01;06;Keskiviikko;0;0;0;2;0;2
294;10.01.2018;2018;01;07;Keskiviikko;2;6;8;7;9;16
294;10.01.2018;2018;01;08;Keskiviikko;11;1;12;14;10;24
294;10.01.2018;2018;01;09;Keskiviikko;7;1;8;10;5;15
294;10.01.2018;2018;01;10;Keskiviikko;2;1;3;8;12;20
294;10.01.2018;2018;01;11;Keskiviikko;2;2;4;34;26;60
294;10.01.2018;2018;01;12;Keskiviikko;3;4;7;16;16;32
294;10.01.2018;2018;01;13;Keskiviikko;3;8;11;13;16;29
294;10.01.2018;2018;01;14;Keskiviikko;3;17;20;11;21;32
294;10.01.2018;2018;01;15;Keskiviikko;8;4;12;20;13;33
294;10.01.2018;2018;01;16;Keskiviikko;5;9;14;13;20;33
294;10.01.2018;2018;01;17;Keskiviikko;7;1;8;12;9;21
294;10.01.2018;2018;01;18;Keskiviikko;2;4;6;16;12;28
294;10.01.2018;2018;01;19;Keskiviikko;3;3;6;12;15;27
294;10.01.2018;2018;01;20;Keskiviikko;2;4;6;6;7;13
294;10.01.2018;2018;01;21;Keskiviikko;0;2;2;1;3;4
294;10.01.2018;2018;01;22;Keskiviikko;0;0;0;0;0;0
294;10.01.2018;2018;01;23;Keskiviikko;0;0;0;0;0;0
294;11.01.2018;2018;01;00;Torstai;0;0;0;0;0;0
294;11.01.2018;2018;01;01;Torstai;0;0;0;0;0;0
294;11.01.2018;2018;01;02;Torstai;0;0;0;0;0;0
294;11.01.2018;2018;01;03;Torstai;0;0;0;0;0;0
294;11.01.2018;2018;01;04;Torstai;0;0;0;0;0;0
294;11.01.2018;2018;01;05;Torstai;0;0;0;1;1;2
294;11.01.2018;2018;01;06;Torstai;1;0;1;4;1;5
294;11.01.2018;2018;01;07;Torstai;2;4;6;8;5;13
294;11.01.2018;2018;01;08;Torstai;10;2;12;15;12;27
294;11.01.2018;2018;01;09;Torstai;7;3;10;16;3;19
294;11.01.2018;2018;01;10;Torstai;1;0;1;9;9;18
294;11.01.2018;2018;01;11;Torstai;2;2;4;20;22;42
294;11.01.2018;2018;01;12;Torstai;5;2;7;18;21;39
294;11.01.2018;2018;01;13;Torstai;9;7;16;10;22;32
294;11.01.2018;2018;01;14;Torstai;3;3;6;20;14;34
294;11.01.2018;2018;01;15;Torstai;4;13;17;8;16;24
294;11.01.2018;2018;01;16;Torstai;5;5;10;24;16;40
294;11.01.2018;2018;01;17;Torstai;4;1;5;15;4;19
294;11.01.2018;2018;01;18;Torstai;3;1;4;6;13;19
294;11.01.2018;2018;01;19;Torstai;6;2;8;6;11;17
294;11.01.2018;2018;01;20;Torstai;1;5;6;5;12;17
294;11.01.2018;2018;01;21;Torstai;0;1;1;3;4;7
294;11.01.2018;2018;01;22;Torstai;0;0;0;0;1;1
294;11.01.2018;2018;01;23;Torstai;0;0;0;1;0;1
294;12.01.2018;2018;01;00;Perjantai;0;0;0;0;0;0
294;12.01.2018;2018;01;01;Perjantai;0;0;0;0;0;0
294;12.01.2018;2018;01;02;Perjantai;0;0;0;0;0;0
294;12.01.2018;2018;01;03;Perjantai;0;0;0;0;0;0
294;12.01.2018;2018;01;04;Perjantai;0;0;0;0;0;0
294;12.01.2018;2018;01;05;Perjantai;0;0;0;2;0;2
294;12.01.2018;2018;01;06;Perjantai;0;0;0;2;0;2
294;12.01.2018;2018;01;07;Perjantai;13;3;16;16;5;21
294;12.01.2018;2018;01;08;Perjantai;8;1;9;10;5;15
294;12.01.2018;2018;01;09;Perjantai;1;1;2;22;7;29
294;12.01.2018;2018;01;10;Perjantai;2;8;10;12;30;42
294;12.01.2018;2018;01;11;Perjantai;3;2;5;20;11;31
294;12.01.2018;2018;01;12;Perjantai;2;3;5;12;12;24
294;12.01.2018;2018;01;13;Perjantai;6;6;12;27;28;55
294;12.01.2018;2018;01;14;Perjantai;6;9;15;19;24;43
294;12.01.2018;2018;01;15;Perjantai;5;3;8;16;19;35
294;12.01.2018;2018;01;16;Perjantai;4;8;12;18;21;39
294;12.01.2018;2018;01;17;Perjantai;2;0;2;14;8;22
294;12.01.2018;2018;01;18;Perjantai;1;1;2;7;7;14
294;12.01.2018;2018;01;19;Perjantai;6;3;9;7;9;16
294;12.01.2018;2018;01;20;Perjantai;3;10;13;2;5;7
294;12.01.2018;2018;01;21;Perjantai;4;1;5;6;7;13
294;12.01.2018;2018;01;22;Perjantai;2;1;3;3;0;3
294;12.01.2018;2018;01;23;Perjantai;2;0;2;0;0;0
294;13.01.2018;2018;01;00;Lauantai;1;0;1;0;0;0
294;13.01.2018;2018;01;01;Lauantai;0;1;1;0;0;0
294;13.01.2018;2018;01;02;Lauantai;0;0;0;0;0;0
294;13.01.2018;2018;01;03;Lauantai;0;0;0;0;1;1
294;13.01.2018;2018;01;04;Lauantai;0;0;0;0;0;0
294;13.01.2018;2018;01;05;Lauantai;0;0;0;0;0;0
294;13.01.2018;2018;01;06;Lauantai;0;0;0;2;2;4
294;13.01.2018;2018;01;07;Lauantai;0;0;0;1;2;3
294;13.01.2018;2018;01;08;Lauantai;2;1;3;6;4;10
294;13.01.2018;2018;01;09;Lauantai;0;0;0;5;10;15
294;13.01.2018;2018;01;10;Lauantai;3;3;6;12;9;21
294;13.01.2018;2018;01;11;Lauantai;0;0;0;19;14;33
294;13.01.2018;2018;01;12;Lauantai;4;3;7;19;15;34
294;13.01.2018;2018;01;13;Lauantai;2;5;7;23;22;45
294;13.01.2018;2018;01;14;Lauantai;3;3;6;16;19;35
294;13.01.2018;2018;01;15;Lauantai;0;1;1;19;7;26
294;13.01.2018;2018;01;16;Lauantai;3;6;9;12;13;25
294;13.01.2018;2018;01;17;Lauantai;4;7;11;15;11;26
294;13.01.2018;2018;01;18;Lauantai;5;5;10;22;14;36
294;13.01.2018;2018;01;19;Lauantai;2;1;3;11;10;21
294;13.01.2018;2018;01;20;Lauantai;3;1;4;2;8;10
294;13.01.2018;2018;01;21;Lauantai;1;2;3;5;4;9
294;13.01.2018;2018;01;22;Lauantai;0;0;0;3;1;4
294;13.01.2018;2018;01;23;Lauantai;0;0;0;0;2;2
294;14.01.2018;2018;01;00;Sunnuntai;0;0;0;0;0;0
294;14.01.2018;2018;01;01;Sunnuntai;0;0;0;4;1;5
294;14.01.2018;2018;01;02;Sunnuntai;0;0;0;0;0;0
294;14.01.2018;2018;01;03;Sunnuntai;0;0;0;0;0;0
294;14.01.2018;2018;01;04;Sunnuntai;0;0;0;0;0;0
294;14.01.2018;2018;01;05;Sunnuntai;0;0;0;0;0;0
294;14.01.2018;2018;01;06;Sunnuntai;0;0;0;2;1;3
294;14.01.2018;2018;01;07;Sunnuntai;0;0;0;2;1;3
294;14.01.2018;2018;01;08;Sunnuntai;0;0;0;1;1;2
294;14.01.2018;2018;01;09;Sunnuntai;3;1;4;14;13;27
294;14.01.2018;2018;01;10;Sunnuntai;0;0;0;8;8;16
294;14.01.2018;2018;01;11;Sunnuntai;1;5;6;14;8;22
294;14.01.2018;2018;01;12;Sunnuntai;5;1;6;13;12;25
294;14.01.2018;2018;01;13;Sunnuntai;1;3;4;14;17;31
294;14.01.2018;2018;01;14;Sunnuntai;0;0;0;8;11;19
294;14.01.2018;2018;01;15;Sunnuntai;0;3;3;24;15;39
294;14.01.2018;2018;01;16;Sunnuntai;5;5;10;10;12;22
294;14.01.2018;2018;01;17;Sunnuntai;1;0;1;11;9;20
294;14.01.2018;2018;01;18;Sunnuntai;2;1;3;11;12;23
294;14.01.2018;2018;01;19;Sunnuntai;1;0;1;7;10;17
294;14.01.2018;2018;01;20;Sunnuntai;3;1;4;6;7;13
294;14.01.2018;2018;01;21;Sunnuntai;1;1;2;3;1;4
294;14.01.2018;2018;01;22;Sunnuntai;0;0;0;0;0;0
294;14.01.2018;2018;01;23;Sunnuntai;0;0;0;0;0;0
294;15.01.2018;2018;01;00;Maanantai;0;0;0;0;0;0
294;15.01.2018;2018;01;01;Maanantai;0;1;1;0;0;0
294;15.01.2018;2018;01;02;Maanantai;0;0;0;0;0;0
294;15.01.2018;2018;01;03;Maanantai;0;0;0;0;0;0
294;15.01.2018;2018;01;04;Maanantai;0;0;0;0;0;0
294;15.01.2018;2018;01;05;Maanantai;0;1;1;2;1;3
294;15.01.2018;2018;01;06;Maanantai;0;0;0;2;3;5
294;15.01.2018;2018;01;07;Maanantai;2;3;5;9;5;14
294;15.01.2018;2018;01;08;Maanantai;14;0;14;14;7;21
294;15.01.2018;2018;01;09;Maanantai;4;0;4;17;9;26
294;15.01.2018;2018;01;10;Maanantai;1;0;1;15;13;28
294;15.01.2018;2018;01;11;Maanantai;6;3;9;29;30;59
294;15.01.2018;2018;01;12;Maanantai;0;4;4;18;20;38
294;15.01.2018;2018;01;13;Maanantai;2;4;6;16;16;32
294;15.01.2018;2018;01;14;Maanantai;6;15;21;17;20;37
294;15.01.2018;2018;01;15;Maanantai;4;10;14;13;14;27
294;15.01.2018;2018;01;16;Maanantai;1;1;2;20;13;33
294;15.01.2018;2018;01;17;Maanantai;3;0;3;11;16;27
294;15.01.2018;2018;01;18;Maanantai;1;2;3;13;11;24
294;15.01.2018;2018;01;19;Maanantai;2;0;2;7;10;17
294;15.01.2018;2018;01;20;Maanantai;4;2;6;4;5;9
294;15.01.2018;2018;01;21;Maanantai;1;1;2;2;2;4
294;15.01.2018;2018;01;22;Maanantai;0;0;0;0;1;1
294;15.01.2018;2018;01;23;Maanantai;0;1;1;0;0;0
294;16.01.2018;2018;01;00;Tiistai;0;0;0;0;0;0
294;16.01.2018;2018;01;01;Tiistai;0;0;0;0;0;0
294;16.01.2018;2018;01;02;Tiistai;0;0;0;0;0;0
294;16.01.2018;2018;01;03;Tiistai;0;0;0;0;0;0
294;16.01.2018;2018;01;04;Tiistai;0;0;0;0;0;0
294;16.01.2018;2018;01;05;Tiistai;0;0;0;2;2;4
294;16.01.2018;2018;01;06;Tiistai;0;0;0;3;2;5
294;16.01.2018;2018;01;07;Tiistai;11;5;16;13;9;22
294;16.01.2018;2018;01;08;Tiistai;17;0;17;11;3;14
294;16.01.2018;2018;01;09;Tiistai;9;1;10;21;5;26
294;16.01.2018;2018;01;10;Tiistai;0;1;1;12;13;25
294;16.01.2018;2018;01;11;Tiistai;2;4;6;17;12;29
294;16.01.2018;2018;01;12;Tiistai;3;3;6;7;20;27
294;16.01.2018;2018;01;13;Tiistai;7;1;8;16;8;24
294;16.01.2018;2018;01;14;Tiistai;4;6;10;9;20;29
294;16.01.2018;2018;01;15;Tiistai;4;8;12;15;24;39
294;16.01.2018;2018;01;16;Tiistai;6;8;14;11;24;35
294;16.01.2018;2018;01;17;Tiistai;1;1;2;9;11;20
294;16.01.2018;2018;01;18;Tiistai;3;0;3;14;14;28
294;16.01.2018;2018;01;19;Tiistai;2;3;5;12;8;20
294;16.01.2018;2018;01;20;Tiistai;0;3;3;2;5;7
294;16.01.2018;2018;01;21;Tiistai;1;0;1;0;0;0
294;16.01.2018;2018;01;22;Tiistai;0;0;0;0;1;1
294;16.01.2018;2018;01;23;Tiistai;0;0;0;1;0;1
294;17.01.2018;2018;01;00;Keskiviikko;0;0;0;0;0;0
294;17.01.2018;2018;01;01;Keskiviikko;0;0;0;0;0;0
294;17.01.2018;2018;01;02;Keskiviikko;0;0;0;0;0;0
294;17.01.2018;2018;01;03;Keskiviikko;0;0;0;0;0;0
294;17.01.2018;2018;01;04;Keskiviikko;0;0;0;0;0;0
294;17.01.2018;2018;01;05;Keskiviikko;0;0;0;2;1;3
294;17.01.2018;2018;01;06;Keskiviikko;0;0;0;3;3;6
294;17.01.2018;2018;01;07;Keskiviikko;8;5;13;10;4;14
294;17.01.2018;2018;01;08;Keskiviikko;9;2;11;10;10;20
294;17.01.2018;2018;01;09;Keskiviikko;4;4;8;30;7;37
294;17.01.2018;2018;01;10;Keskiviikko;0;0;0;15;16;31
294;17.01.2018;2018;01;11;Keskiviikko;8;3;11;24;25;49
294;17.01.2018;2018;01;12;Keskiviikko;2;1;3;19;21;40
294;17.01.2018;2018;01;13;Keskiviikko;1;2;3;16;18;34
294;17.01.2018;2018;01;14;Keskiviikko;1;13;14;17;23;40
294;17.01.2018;2018;01;15;Keskiviikko;6;9;15;5;20;25
294;17.01.2018;2018;01;16;Keskiviikko;4;8;12;22;17;39
294;17.01.2018;2018;01;17;Keskiviikko;8;5;13;18;19;37
294;17.01.2018;2018;01;18;Keskiviikko;3;3;6;10;20;30
294;17.01.2018;2018;01;19;Keskiviikko;1;3;4;14;10;24
294;17.01.2018;2018;01;20;Keskiviikko;1;1;2;5;9;14
294;17.01.2018;2018;01;21;Keskiviikko;2;0;2;1;4;5
294;17.01.2018;2018;01;22;Keskiviikko;0;0;0;0;0;0
294;17.01.2018;2018;01;23;Keskiviikko;0;1;1;1;0;1
294;18.01.2018;2018;01;00;Torstai;0;0;0;0;0;0
294;18.01.2018;2018;01;01;Torstai;0;0;0;0;0;0
294;18.01.2018;2018;01;02;Torstai;0;0;0;0;0;0
294;18.01.2018;2018;01;03;Torstai;0;0;0;0;0;0
294;18.01.2018;2018;01;04;Torstai;0;0;0;0;0;0
294;18.01.2018;2018;01;05;Torstai;0;0;0;2;1;3
294;18.01.2018;2018;01;06;Torstai;0;0;0;3;3;6
294;18.01.2018;2018;01;07;Torstai;2;5;7;8;8;16
294;18.01.2018;2018;01;08;Torstai;10;0;10;15;5;20
294;18.01.2018;2018;01;09;Torstai;8;5;13;7;5;12
294;18.01.2018;2018;01;10;Torstai;0;0;0;9;18;27
294;18.01.2018;2018;01;11;Torstai;4;3;7;18;15;33
294;18.01.2018;2018;01;12;Torstai;4;1;5;20;14;34
294;18.01.2018;2018;01;13;Torstai;3;3;6;22;16;38
294;18.01.2018;2018;01;14;Torstai;2;6;8;20;16;36
294;18.01.2018;2018;01;15;Torstai;4;18;22;14;28;42
294;18.01.2018;2018;01;16;Torstai;5;7;12;13;17;30
294;18.01.2018;2018;01;17;Torstai;2;2;4;9;9;18
294;18.01.2018;2018;01;18;Torstai;3;6;9;7;13;20
294;18.01.2018;2018;01;19;Torstai;2;1;3;6;11;17
294;18.01.2018;2018;01;20;Torstai;3;5;8;8;2;10
294;18.01.2018;2018;01;21;Torstai;2;0;2;1;3;4
294;18.01.2018;2018;01;22;Torstai;0;0;0;0;0;0
294;18.01.2018;2018;01;23;Torstai;0;0;0;4;0;4
294;19.01.2018;2018;01;00;Perjantai;0;0;0;0;2;2
294;19.01.2018;2018;01;01;Perjantai;0;0;0;0;0;0
294;19.01.2018;2018;01;02;Perjantai;0;0;0;0;0;0
294;19.01.2018;2018;01;03;Perjantai;0;0;0;0;0;0
294;19.01.2018;2018;01;04;Perjantai;0;0;0;0;0;0
294;19.01.2018;2018;01;05;Perjantai;0;0;0;2;1;3
294;19.01.2018;2018;01;06;Perjantai;0;1;1;0;0;0
294;19.01.2018;2018;01;07;Perjantai;15;5;20;7;8;15
294;19.01.2018;2018;01;08;Perjantai;2;0;2;11;3;14
294;19.01.2018;2018;01;09;Perjantai;9;1;10;20;18;38
294;19.01.2018;2018;01;10;Perjantai;1;5;6;11;12;23
294;19.01.2018;2018;01;11;Perjantai;4;3;7;23;25;48
294;19.01.2018;2018;01;12;Perjantai;5;6;11;22;19;41
294;19.01.2018;2018;01;13;Perjantai;5;6;11;19;19;38
294;19.01.2018;2018;01;14;Perjantai;5;17;22;25;29;54
294;19.01.2018;2018;01;15;Perjantai;3;6;9;14;10;24
294;19.01.2018;2018;01;16;Perjantai;4;5;9;13;12;25
294;19.01.2018;2018;01;17;Perjantai;2;2;4;5;10;15
294;19.01.2018;2018;01;18;Perjantai;3;2;5;10;4;14
294;19.01.2018;2018;01;19;Perjantai;0;2;2;2;1;3
294;19.01.2018;2018;01;20;Perjantai;7;3;10;4;3;7
294;19.01.2018;2018;01;21;Perjantai;1;0;1;6;1;7
294;19.01.2018;2018;01;22;Perjantai;0;0;0;1;0;1
294;19.01.2018;2018;01;23;Perjantai;0;0;0;0;0;0
294;20.01.2018;2018;01;00;Lauantai;0;0;0;0;1;1
294;20.01.2018;2018;01;01;Lauantai;0;0;0;0;0;0
294;20.01.2018;2018;01;02;Lauantai;0;0;0;0;1;1
294;20.01.2018;2018;01;03;Lauantai;0;0;0;0;0;0
294;20.01.2018;2018;01;04;Lauantai;0;0;0;0;0;0
294;20.01.2018;2018;01;05;Lauantai;0;0;0;0;0;0
294;20.01.2018;2018;01;06;Lauantai;0;0;0;3;2;5
294;20.01.2018;2018;01;07;Lauantai;0;0;0;1;0;1
294;20.01.2018;2018;01;08;Lauantai;2;1;3;8;3;11
294;20.01.2018;2018;01;09;Lauantai;0;0;0;3;4;7
294;20.01.2018;2018;01;10;Lauantai;1;2;3;6;10;16
294;20.01.2018;2018;01;11;Lauantai;6;2;8;16;11;27
294;20.01.2018;2018;01;12;Lauantai;1;3;4;12;14;26
294;20.01.2018;2018;01;13;Lauantai;1;0;1;15;6;21
294;20.01.2018;2018;01;14;Lauantai;0;8;8;8;14;22
294;20.01.2018;2018;01;15;Lauantai;6;4;10;21;10;31
294;20.01.2018;2018;01;16;Lauantai;3;5;8;18;10;28
294;20.01.2018;2018;01;17;Lauantai;6;3;9;6;5;11
294;20.01.2018;2018;01;18;Lauantai;0;1;1;6;8;14
294;20.01.2018;2018;01;19;Lauantai;5;1;6;11;7;18
294;20.01.2018;2018;01;20;Lauantai;0;1;1;11;7;18
294;20.01.2018;2018;01;21;Lauantai;1;0;1;7;4;11
294;20.01.2018;2018;01;22;Lauantai;1;0;1;5;0;5
294;20.01.2018;2018;01;23;Lauantai;0;1;1;0;0;0
294;21.01.2018;2018;01;00;Sunnuntai;0;0;0;0;0;0
294;21.01.2018;2018;01;01;Sunnuntai;0;0;0;0;1;1
294;21.01.2018;2018;01;02;Sunnuntai;0;0;0;0;1;1
294;21.01.2018;2018;01;03;Sunnuntai;0;0;0;0;0;0
294;21.01.2018;2018;01;04;Sunnuntai;0;0;0;0;0;0
294;21.01.2018;2018;01;05;Sunnuntai;0;0;0;0;0;0
294;21.01.2018;2018;01;06;Sunnuntai;0;0;0;2;1;3
294;21.01.2018;2018;01;07;Sunnuntai;0;0;0;1;3;4
294;21.01.2018;2018;01;08;Sunnuntai;0;0;0;2;1;3
294;21.01.2018;2018;01;09;Sunnuntai;3;1;4;6;4;10
294;21.01.2018;2018;01;10;Sunnuntai;0;1;1;13;11;24
294;21.01.2018;2018;01;11;Sunnuntai;0;1;1;19;13;32
294;21.01.2018;2018;01;12;Sunnuntai;1;1;2;10;5;15
294;21.01.2018;2018;01;13;Sunnuntai;0;0;0;5;11;16
294;21.01.2018;2018;01;14;Sunnuntai;1;2;3;14;5;19
294;21.01.2018;2018;01;15;Sunnuntai;1;1;2;4;9;13
294;21.01.2018;2018;01;16;Sunnuntai;0;2;2;14;7;21
294;21.01.2018;2018;01;17;Sunnuntai;0;0;0;9;8;17
294;21.01.2018;2018;01;18;Sunnuntai;1;3;4;4;9;13
294;21.01.2018;2018;01;19;Sunnuntai;1;0;1;6;8;14
294;21.01.2018;2018;01;20;Sunnuntai;0;1;1;5;1;6
294;21.01.2018;2018;01;21;Sunnuntai;0;0;0;1;3;4
294;21.01.2018;2018;01;22;Sunnuntai;0;0;0;1;0;1
294;21.01.2018;2018;01;23;Sunnuntai;0;0;0;0;0;0
294;22.01.2018;2018;01;00;Maanantai;0;0;0;0;0;0
294;22.01.2018;2018;01;01;Maanantai;0;0;0;0;0;0
294;22.01.2018;2018;01;02;Maanantai;0;0;0;0;0;0
294;22.01.2018;2018;01;03;Maanantai;0;0;0;0;0;0
294;22.01.2018;2018;01;04;Maanantai;0;0;0;0;0;0
294;22.01.2018;2018;01;05;Maanantai;0;0;0;2;1;3
294;22.01.2018;2018;01;06;Maanantai;0;0;0;2;2;4
294;22.01.2018;2018;01;07;Maanantai;5;2;7;7;4;11
294;22.01.2018;2018;01;08;Maanantai;11;0;11;9;5;14
294;22.01.2018;2018;01;09;Maanantai;5;3;8;14;13;27
294;22.01.2018;2018;01;10;Maanantai;3;1;4;13;9;22
294;22.01.2018;2018;01;11;Maanantai;3;3;6;7;14;21
294;22.01.2018;2018;01;12;Maanantai;3;12;15;13;23;36
294;22.01.2018;2018;01;13;Maanantai;2;5;7;10;13;23
294;22.01.2018;2018;01;14;Maanantai;5;7;12;13;15;28
294;22.01.2018;2018;01;15;Maanantai;2;3;5;13;12;25
294;22.01.2018;2018;01;16;Maanantai;4;2;6;9;8;17
294;22.01.2018;2018;01;17;Maanantai;0;3;3;4;4;8
294;22.01.2018;2018;01;18;Maanantai;0;2;2;5;7;12
294;22.01.2018;2018;01;19;Maanantai;2;1;3;2;3;5
294;22.01.2018;2018;01;20;Maanantai;0;1;1;3;1;4
294;22.01.2018;2018;01;21;Maanantai;0;0;0;0;0;0
294;22.01.2018;2018;01;22;Maanantai;0;0;0;0;0;0
294;22.01.2018;2018;01;23;Maanantai;0;0;0;0;0;0
294;23.01.2018;2018;01;00;Tiistai;0;0;0;0;0;0
294;23.01.2018;2018;01;01;Tiistai;0;0;0;0;0;0
294;23.01.2018;2018;01;02;Tiistai;0;0;0;0;0;0
294;23.01.2018;2018;01;03;Tiistai;0;0;0;0;0;0
294;23.01.2018;2018;01;04;Tiistai;0;0;0;0;0;0
294;23.01.2018;2018;01;05;Tiistai;0;0;0;0;2;2
294;23.01.2018;2018;01;06;Tiistai;0;0;0;4;0;4
294;23.01.2018;2018;01;07;Tiistai;7;4;11;7;6;13
294;23.01.2018;2018;01;08;Tiistai;17;0;17;15;2;17
294;23.01.2018;2018;01;09;Tiistai;4;3;7;11;8;19
294;23.01.2018;2018;01;10;Tiistai;0;3;3;8;11;19
294;23.01.2018;2018;01;11;Tiistai;2;2;4;13;11;24
294;23.01.2018;2018;01;12;Tiistai;3;1;4;16;16;32
294;23.01.2018;2018;01;13;Tiistai;1;3;4;13;10;23
294;23.01.2018;2018;01;14;Tiistai;2;5;7;15;10;25
294;23.01.2018;2018;01;15;Tiistai;5;16;21;14;20;34
294;23.01.2018;2018;01;16;Tiistai;5;1;6;17;13;30
294;23.01.2018;2018;01;17;Tiistai;1;3;4;14;12;26
294;23.01.2018;2018;01;18;Tiistai;2;1;3;8;12;20
294;23.01.2018;2018;01;19;Tiistai;3;2;5;6;3;9
294;23.01.2018;2018;01;20;Tiistai;1;3;4;2;6;8
294;23.01.2018;2018;01;21;Tiistai;0;0;0;1;0;1
294;23.01.2018;2018;01;22;Tiistai;0;0;0;0;0;0
294;23.01.2018;2018;01;23;Tiistai;0;0;0;2;0;2
294;24.01.2018;2018;01;00;Keskiviikko;0;0;0;0;0;0
294;24.01.2018;2018;01;01;Keskiviikko;0;0;0;0;0;0
294;24.01.2018;2018;01;02;Keskiviikko;0;0;0;0;0;0
294;24.01.2018;2018;01;03;Keskiviikko;0;0;0;0;0;0
294;24.01.2018;2018;01;04;Keskiviikko;2;1;3;5;0;5
294;24.01.2018;2018;01;05;Keskiviikko;0;0;0;2;1;3
294;24.01.2018;2018;01;06;Keskiviikko;0;0;0;3;2;5
294;24.01.2018;2018;01;07;Keskiviikko;4;0;4;8;7;15
294;24.01.2018;2018;01;08;Keskiviikko;12;3;15;16;5;21
294;24.01.2018;2018;01;09;Keskiviikko;7;1;8;21;10;31
294;24.01.2018;2018;01;10;Keskiviikko;2;2;4;10;11;21
294;24.01.2018;2018;01;11;Keskiviikko;4;11;15;14;28;42
294;24.01.2018;2018;01;12;Keskiviikko;2;6;8;27;9;36
294;24.01.2018;2018;01;13;Keskiviikko;4;2;6;22;17;39
294;24.01.2018;2018;01;14;Keskiviikko;2;13;15;11;18;29
294;24.01.2018;2018;01;15;Keskiviikko;6;2;8;9;11;20
294;24.01.2018;2018;01;16;Keskiviikko;1;1;2;16;10;26
294;24.01.2018;2018;01;17;Keskiviikko;0;0;0;3;8;11
294;24.01.2018;2018;01;18;Keskiviikko;2;0;2;5;4;9
294;24.01.2018;2018;01;19;Keskiviikko;4;4;8;11;7;18
294;24.01.2018;2018;01;20;Keskiviikko;0;3;3;8;5;13
294;24.01.2018;2018;01;21;Keskiviikko;0;1;1;0;2;2
294;24.01.2018;2018;01;22;Keskiviikko;0;1;1;1;0;1
294;24.01.2018;2018;01;23;Keskiviikko;0;0;0;0;0;0
294;25.01.2018;2018;01;00;Torstai;1;0;1;7;0;7
294;25.01.2018;2018;01;01;Torstai;0;0;0;0;0;0
294;25.01.2018;2018;01;02;Torstai;0;0;0;0;0;0
294;25.01.2018;2018;01;03;Torstai;0;0;0;0;0;0
294;25.01.2018;2018;01;04;Torstai;0;0;0;0;0;0
294;25.01.2018;2018;01;05;Torstai;0;0;0;1;1;2
294;25.01.2018;2018;01;06;Torstai;1;0;1;2;0;2
294;25.01.2018;2018;01;07;Torstai;0;0;0;12;1;13
294;25.01.2018;2018;01;08;Torstai;8;0;8;19;8;27
294;25.01.2018;2018;01;09;Torstai;6;1;7;8;4;12
294;25.01.2018;2018;01;10;Torstai;0;0;0;8;8;16
294;25.01.2018;2018;01;11;Torstai;8;1;9;14;5;19
294;25.01.2018;2018;01;12;Torstai;3;2;5;15;7;22
294;25.01.2018;2018;01;13;Torstai;3;2;5;9;5;14
294;25.01.2018;2018;01;14;Torstai;1;3;4;3;16;19
294;25.01.2018;2018;01;15;Torstai;1;9;10;4;12;16
294;25.01.2018;2018;01;16;Torstai;3;3;6;12;8;20
294;25.01.2018;2018;01;17;Torstai;1;0;1;9;4;13
294;25.01.2018;2018;01;18;Torstai;3;1;4;6;6;12
294;25.01.2018;2018;01;19;Torstai;2;0;2;8;4;12
294;25.01.2018;2018;01;20;Torstai;2;1;3;3;5;8
294;25.01.2018;2018;01;21;Torstai;1;0;1;3;1;4
294;25.01.2018;2018;01;22;Torstai;0;0;0;2;1;3
294;25.01.2018;2018;01;23;Torstai;0;0;0;0;0;0
294;26.01.2018;2018;01;00;Perjantai;0;0;0;0;0;0
294;26.01.2018;2018;01;01;Perjantai;0;0;0;0;0;0
294;26.01.2018;2018;01;02;Perjantai;0;0;0;0;0;0
294;26.01.2018;2018;01;03;Perjantai;0;0;0;0;0;0
294;26.01.2018;2018;01;04;Perjantai;1;1;2;0;0;0
294;26.01.2018;2018;01;05;Perjantai;0;0;0;0;0;0
294;26.01.2018;2018;01;06;Perjantai;0;0;0;2;0;2
294;26.01.2018;2018;01;07;Perjantai;2;1;3;9;2;11
294;26.01.2018;2018;01;08;Perjantai;1;1;2;4;0;4
294;26.01.2018;2018;01;09;Perjantai;0;0;0;6;3;9
294;26.01.2018;2018;01;10;Perjantai;1;5;6;5;4;9
294;26.01.2018;2018;01;11;Perjantai;4;1;5;6;6;12
294;26.01.2018;2018;01;12;Perjantai;3;4;7;10;8;18
294;26.01.2018;2018;01;13;Perjantai;4;5;9;6;6;12
294;26.01.2018;2018;01;14;Perjantai;1;4;5;13;11;24
294;26.01.2018;2018;01;15;Perjantai;2;3;5;7;8;15
294;26.01.2018;2018;01;16;Perjantai;3;3;6;8;7;15
294;26.01.2018;2018;01;17;Perjantai;5;3;8;7;2;9
294;26.01.2018;2018;01;18;Perjantai;5;1;6;9;5;14
294;26.01.2018;2018;01;19;Perjantai;2;1;3;7;1;8
294;26.01.2018;2018;01;20;Perjantai;2;3;5;7;4;11
294;26.01.2018;2018;01;21;Perjantai;1;1;2;7;2;9
294;26.01.2018;2018;01;22;Perjantai;3;0;3;3;0;3
294;26.01.2018;2018;01;23;Perjantai;0;0;0;0;0;0
294;27.01.2018;2018;01;00;Lauantai;0;0;0;0;0;0
294;27.01.2018;2018;01;01;Lauantai;0;1;1;0;1;1
294;27.01.2018;2018;01;02;Lauantai;0;0;0;0;0;0
294;27.01.2018;2018;01;03;Lauantai;0;0;0;0;0;0
294;27.01.2018;2018;01;04;Lauantai;0;0;0;0;0;0
294;27.01.2018;2018;01;05;Lauantai;0;0;0;0;0;0
294;27.01.2018;2018;01;06;Lauantai;0;0;0;0;0;0
294;27.01.2018;2018;01;07;Lauantai;1;0;1;2;1;3
294;27.01.2018;2018;01;08;Lauantai;0;0;0;4;1;5
294;27.01.2018;2018;01;09;Lauantai;1;0;1;7;4;11
294;27.01.2018;2018;01;10;Lauantai;2;0;2;8;4;12
294;27.01.2018;2018;01;11;Lauantai;4;2;6;6;7;13
294;27.01.2018;2018;01;12;Lauantai;2;4;6;8;9;17
294;27.01.2018;2018;01;13;Lauantai;4;2;6;8;6;14
294;27.01.2018;2018;01;14;Lauantai;2;5;7;17;8;25
294;27.01.2018;2018;01;15;Lauantai;1;0;1;4;1;5
294;27.01.2018;2018;01;16;Lauantai;4;1;5;11;8;19
294;27.01.2018;2018;01;17;Lauantai;3;0;3;2;9;11
294;27.01.2018;2018;01;18;Lauantai;3;4;7;6;4;10
294;27.01.2018;2018;01;19;Lauantai;1;1;2;7;3;10
294;27.01.2018;2018;01;20;Lauantai;2;0;2;5;2;7
294;27.01.2018;2018;01;21;Lauantai;2;1;3;7;5;12
294;27.01.2018;2018;01;22;Lauantai;2;0;2;1;0;1
294;27.01.2018;2018;01;23;Lauantai;1;0;1;4;0;4
294;28.01.2018;2018;01;00;Sunnuntai;0;0;0;0;0;0
294;28.01.2018;2018;01;01;Sunnuntai;0;0;0;2;1;3
294;28.01.2018;2018;01;02;Sunnuntai;0;0;0;0;1;1
294;28.01.2018;2018;01;03;Sunnuntai;0;0;0;0;0;0
294;28.01.2018;2018;01;04;Sunnuntai;0;0;0;1;0;1
294;28.01.2018;2018;01;05;Sunnuntai;0;0;0;0;0;0
294;28.01.2018;2018;01;06;Sunnuntai;0;0;0;1;2;3
294;28.01.2018;2018;01;07;Sunnuntai;0;0;0;0;0;0
294;28.01.2018;2018;01;08;Sunnuntai;1;0;1;1;1;2
294;28.01.2018;2018;01;09;Sunnuntai;2;0;2;8;3;11
294;28.01.2018;2018;01;10;Sunnuntai;1;0;1;7;6;13
294;28.01.2018;2018;01;11;Sunnuntai;0;4;4;9;15;24
294;28.01.2018;2018;01;12;Sunnuntai;3;5;8;13;8;21
294;28.01.2018;2018;01;13;Sunnuntai;4;2;6;8;7;15
294;28.01.2018;2018;01;14;Sunnuntai;3;7;10;8;9;17
294;28.01.2018;2018;01;15;Sunnuntai;5;2;7;9;6;15
294;28.01.2018;2018;01;16;Sunnuntai;2;2;4;7;7;14
294;28.01.2018;2018;01;17;Sunnuntai;2;0;2;11;5;16
294;28.01.2018;2018;01;18;Sunnuntai;0;1;1;3;7;10
294;28.01.2018;2018;01;19;Sunnuntai;3;3;6;7;8;15
294;28.01.2018;2018;01;20;Sunnuntai;0;0;0;0;4;4
294;28.01.2018;2018;01;21;Sunnuntai;0;0;0;5;2;7
294;28.01.2018;2018;01;22;Sunnuntai;0;0;0;1;0;1
294;28.01.2018;2018;01;23;Sunnuntai;0;0;0;0;1;1
294;29.01.2018;2018;01;00;Maanantai;0;0;0;0;0;0
294;29.01.2018;2018;01;01;Maanantai;0;0;0;0;0;0
294;29.01.2018;2018;01;02;Maanantai;0;0;0;0;0;0
294;29.01.2018;2018;01;03;Maanantai;0;0;0;0;0;0
294;29.01.2018;2018;01;04;Maanantai;0;0;0;0;0;0
294;29.01.2018;2018;01;05;Maanantai;0;0;0;2;0;2
294;29.01.2018;2018;01;06;Maanantai;0;0;0;1;1;2
294;29.01.2018;2018;01;07;Maanantai;1;5;6;7;4;11
294;29.01.2018;2018;01;08;Maanantai;7;1;8;11;5;16
294;29.01.2018;2018;01;09;Maanantai;6;3;9;22;11;33
294;29.01.2018;2018;01;10;Maanantai;1;1;2;14;10;24
294;29.01.2018;2018;01;11;Maanantai;2;3;5;11;20;31
294;29.01.2018;2018;01;12;Maanantai;1;7;8;16;31;47
294;29.01.2018;2018;01;13;Maanantai;1;2;3;14;18;32
294;29.01.2018;2018;01;14;Maanantai;0;6;6;14;10;24
294;29.01.2018;2018;01;15;Maanantai;2;12;14;18;15;33
294;29.01.2018;2018;01;16;Maanantai;6;1;7;19;16;35
294;29.01.2018;2018;01;17;Maanantai;2;2;4;18;12;30
294;29.01.2018;2018;01;18;Maanantai;2;2;4;5;10;15
294;29.01.2018;2018;01;19;Maanantai;0;6;6;7;15;22
294;29.01.2018;2018;01;20;Maanantai;1;0;1;6;2;8
294;29.01.2018;2018;01;21;Maanantai;0;1;1;0;0;0
294;29.01.2018;2018;01;22;Maanantai;0;0;0;0;1;1
294;29.01.2018;2018;01;23;Maanantai;0;0;0;0;0;0
294;30.01.2018;2018;01;00;Tiistai;0;0;0;0;1;1
294;30.01.2018;2018;01;01;Tiistai;0;0;0;0;0;0
294;30.01.2018;2018;01;02;Tiistai;0;0;0;0;0;0
294;30.01.2018;2018;01;03;Tiistai;0;0;0;0;0;0
294;30.01.2018;2018;01;04;Tiistai;0;0;0;0;0;0
294;30.01.2018;2018;01;05;Tiistai;0;0;0;3;1;4
294;30.01.2018;2018;01;06;Tiistai;1;0;1;2;1;3
294;30.01.2018;2018;01;07;Tiistai;10;5;15;19;9;28
294;30.01.2018;2018;01;08;Tiistai;13;1;14;30;13;43
294;30.01.2018;2018;01;09;Tiistai;5;0;5;15;5;20
294;30.01.2018;2018;01;10;Tiistai;1;1;2;14;13;27
294;30.01.2018;2018;01;11;Tiistai;3;3;6;23;12;35
294;30.01.2018;2018;01;12;Tiistai;5;3;8;14;14;28
294;30.01.2018;2018;01;13;Tiistai;1;0;1;27;23;50
294;30.01.2018;2018;01;14;Tiistai;6;5;11;12;18;30
294;30.01.2018;2018;01;15;Tiistai;5;11;16;10;19;29
294;30.01.2018;2018;01;16;Tiistai;4;7;11;12;16;28
294;30.01.2018;2018;01;17;Tiistai;0;2;2;14;19;33
294;30.01.2018;2018;01;18;Tiistai;3;4;7;11;8;19
294;30.01.2018;2018;01;19;Tiistai;1;0;1;10;6;16
294;30.01.2018;2018;01;20;Tiistai;4;5;9;5;3;8
294;30.01.2018;2018;01;21;Tiistai;0;0;0;4;1;5
294;30.01.2018;2018;01;22;Tiistai;1;1;2;3;1;4
294;30.01.2018;2018;01;23;Tiistai;0;0;0;0;0;0
294;31.01.2018;2018;01;00;Keskiviikko;0;0;0;0;0;0
294;31.01.2018;2018;01;01;Keskiviikko;0;0;0;0;0;0
294;31.01.2018;2018;01;02;Keskiviikko;0;0;0;0;0;0
294;31.01.2018;2018;01;03;Keskiviikko;0;0;0;0;0;0
294;31.01.2018;2018;01;04;Keskiviikko;0;0;0;0;0;0
294;31.01.2018;2018;01;05;Keskiviikko;0;0;0;2;1;3
294;31.01.2018;2018;01;06;Keskiviikko;0;0;0;1;2;3
294;31.01.2018;2018;01;07;Keskiviikko;1;8;9;9;4;13
294;31.01.2018;2018;01;08;Keskiviikko;4;0;4;16;8;24
294;31.01.2018;2018;01;09;Keskiviikko;5;3;8;30;10;40
294;31.01.2018;2018;01;10;Keskiviikko;0;1;1;18;15;33
294;31.01.2018;2018;01;11;Keskiviikko;2;1;3;17;25;42
294;31.01.2018;2018;01;12;Keskiviikko;1;5;6;16;15;31
294;31.01.2018;2018;01;13;Keskiviikko;2;3;5;23;17;40
294;31.01.2018;2018;01;14;Keskiviikko;5;11;16;17;20;37
294;31.01.2018;2018;01;15;Keskiviikko;4;8;12;28;14;42
294;31.01.2018;2018;01;16;Keskiviikko;2;4;6;12;12;24
294;31.01.2018;2018;01;17;Keskiviikko;2;4;6;18;11;29
294;31.01.2018;2018;01;18;Keskiviikko;2;2;4;12;17;29
294;31.01.2018;2018;01;19;Keskiviikko;4;2;6;14;15;29
294;31.01.2018;2018;01;20;Keskiviikko;0;1;1;9;8;17
294;31.01.2018;2018;01;21;Keskiviikko;0;1;1;2;1;3
294;31.01.2018;2018;01;22;Keskiviikko;0;0;0;0;0;0
294;31.01.2018;2018;01;23;Keskiviikko;0;0;0;1;1;2
294;01.02.2018;2018;02;00;Torstai;0;0;0;0;0;0
294;01.02.2018;2018;02;01;Torstai;0;0;0;0;0;0
294;01.02.2018;2018;02;02;Torstai;0;0;0;0;0;0
294;01.02.2018;2018;02;03;Torstai;0;0;0;0;0;0
294;01.02.2018;2018;02;04;Torstai;0;0;0;0;0;0
294;01.02.2018;2018;02;05;Torstai;0;0;0;2;1;3
294;01.02.2018;2018;02;06;Torstai;0;0;0;3;1;4
294;01.02.2018;2018;02;07;Torstai;4;5;9;11;3;14
294;01.02.2018;2018;02;08;Torstai;1;0;1;13;7;20
294;01.02.2018;2018;02;09;Torstai;4;3;7;7;8;15
294;01.02.2018;2018;02;10;Torstai;0;1;1;7;13;20
294;01.02.2018;2018;02;11;Torstai;2;2;4;14;12;26
294;01.02.2018;2018;02;12;Torstai;2;1;3;10;13;23
294;01.02.2018;2018;02;13;Torstai;3;4;7;12;22;34
294;01.02.2018;2018;02;14;Torstai;2;5;7;14;10;24
294;01.02.2018;2018;02;15;Torstai;5;8;13;6;14;20
294;01.02.2018;2018;02;16;Torstai;3;2;5;11;13;24
294;01.02.2018;2018;02;17;Torstai;0;1;1;7;13;20
294;01.02.2018;2018;02;18;Torstai;4;1;5;10;9;19
294;01.02.2018;2018;02;19;Torstai;4;3;7;2;7;9
294;01.02.2018;2018;02;20;Torstai;2;1;3;4;3;7
294;01.02.2018;2018;02;21;Torstai;0;1;1;3;3;6
294;01.02.2018;2018;02;22;Torstai;0;0;0;0;1;1
294;01.02.2018;2018;02;23;Torstai;0;0;0;0;0;0
294;02.02.2018;2018;02;00;Perjantai;0;0;0;0;0;0
294;02.02.2018;2018;02;01;Perjantai;0;0;0;0;0;0
294;02.02.2018;2018;02;02;Perjantai;0;0;0;0;0;0
294;02.02.2018;2018;02;03;Perjantai;0;0;0;0;0;0
294;02.02.2018;2018;02;04;Perjantai;0;0;0;0;0;0
294;02.02.2018;2018;02;05;Perjantai;0;0;0;2;1;3
294;02.02.2018;2018;02;06;Perjantai;0;0;0;1;0;1
294;02.02.2018;2018;02;07;Perjantai;7;6;13;12;10;22
294;02.02.2018;2018;02;08;Perjantai;4;1;5;9;6;15
294;02.02.2018;2018;02;09;Perjantai;6;2;8;16;8;24
294;02.02.2018;2018;02;10;Perjantai;3;4;7;7;19;26
294;02.02.2018;2018;02;11;Perjantai;0;1;1;9;9;18
294;02.02.2018;2018;02;12;Perjantai;5;1;6;18;18;36
294;02.02.2018;2018;02;13;Perjantai;2;10;12;19;19;38
294;02.02.2018;2018;02;14;Perjantai;7;8;15;16;29;45
294;02.02.2018;2018;02;15;Perjantai;2;3;5;20;15;35
294;02.02.2018;2018;02;16;Perjantai;9;3;12;11;8;19
294;02.02.2018;2018;02;17;Perjantai;0;2;2;24;15;39
294;02.02.2018;2018;02;18;Perjantai;1;4;5;13;6;19
294;02.02.2018;2018;02;19;Perjantai;0;0;0;7;4;11
294;02.02.2018;2018;02;20;Perjantai;2;1;3;4;8;12
294;02.02.2018;2018;02;21;Perjantai;4;1;5;2;3;5
294;02.02.2018;2018;02;22;Perjantai;0;2;2;0;2;2
294;02.02.2018;2018;02;23;Perjantai;0;0;0;0;0;0
294;03.02.2018;2018;02;00;Lauantai;0;0;0;0;0;0
294;03.02.2018;2018;02;01;Lauantai;1;0;1;0;0;0
294;03.02.2018;2018;02;02;Lauantai;0;0;0;0;0;0
294;03.02.2018;2018;02;03;Lauantai;0;0;0;1;0;1
294;03.02.2018;2018;02;04;Lauantai;0;0;0;1;0;1
294;03.02.2018;2018;02;05;Lauantai;0;0;0;1;0;1
294;03.02.2018;2018;02;06;Lauantai;0;0;0;2;1;3
294;03.02.2018;2018;02;07;Lauantai;0;0;0;1;0;1
294;03.02.2018;2018;02;08;Lauantai;2;0;2;1;1;2
294;03.02.2018;2018;02;09;Lauantai;0;1;1;6;4;10
294;03.02.2018;2018;02;10;Lauantai;0;0;0;10;13;23
294;03.02.2018;2018;02;11;Lauantai;0;2;2;20;12;32
294;03.02.2018;2018;02;12;Lauantai;4;4;8;19;27;46
294;03.02.2018;2018;02;13;Lauantai;1;4;5;20;12;32
294;03.02.2018;2018;02;14;Lauantai;2;1;3;16;15;31
294;03.02.2018;2018;02;15;Lauantai;1;6;7;8;8;16
294;03.02.2018;2018;02;16;Lauantai;1;1;2;14;8;22
294;03.02.2018;2018;02;17;Lauantai;3;3;6;5;12;17
294;03.02.2018;2018;02;18;Lauantai;1;0;1;7;8;15
294;03.02.2018;2018;02;19;Lauantai;1;0;1;6;4;10
294;03.02.2018;2018;02;20;Lauantai;1;0;1;1;3;4
294;03.02.2018;2018;02;21;Lauantai;1;2;3;0;2;2
294;03.02.2018;2018;02;22;Lauantai;1;0;1;2;0;2
294;03.02.2018;2018;02;23;Lauantai;0;0;0;0;0;0
294;04.02.2018;2018;02;00;Sunnuntai;0;0;0;1;1;2
294;04.02.2018;2018;02;01;Sunnuntai;0;0;0;0;2;2
294;04.02.2018;2018;02;02;Sunnuntai;0;0;0;1;2;3
294;04.02.2018;2018;02;03;Sunnuntai;0;0;0;0;0;0
294;04.02.2018;2018;02;04;Sunnuntai;0;0;0;0;0;0
294;04.02.2018;2018;02;05;Sunnuntai;0;0;0;0;0;0
294;04.02.2018;2018;02;06;Sunnuntai;0;0;0;0;0;0
294;04.02.2018;2018;02;07;Sunnuntai;0;0;0;0;0;0
294;04.02.2018;2018;02;08;Sunnuntai;0;0;0;4;0;4
294;04.02.2018;2018;02;09;Sunnuntai;0;0;0;8;2;10
294;04.02.2018;2018;02;10;Sunnuntai;0;0;0;2;4;6
294;04.02.2018;2018;02;11;Sunnuntai;0;0;0;3;5;8
294;04.02.2018;2018;02;12;Sunnuntai;0;0;0;9;10;19
294;04.02.2018;2018;02;13;Sunnuntai;0;1;1;9;11;20
294;04.02.2018;2018;02;14;Sunnuntai;4;2;6;16;16;32
294;04.02.2018;2018;02;15;Sunnuntai;0;6;6;7;7;14
294;04.02.2018;2018;02;16;Sunnuntai;1;1;2;10;4;14
294;04.02.2018;2018;02;17;Sunnuntai;0;1;1;1;4;5
294;04.02.2018;2018;02;18;Sunnuntai;2;0;2;3;4;7
294;04.02.2018;2018;02;19;Sunnuntai;0;0;0;3;2;5
294;04.02.2018;2018;02;20;Sunnuntai;0;2;2;2;2;4
294;04.02.2018;2018;02;21;Sunnuntai;0;0;0;1;0;1
294;04.02.2018;2018;02;22;Sunnuntai;0;0;0;0;0;0
294;04.02.2018;2018;02;23;Sunnuntai;0;0;0;0;0;0
294;05.02.2018;2018;02;00;Maanantai;0;0;0;0;0;0
294;05.02.2018;2018;02;01;Maanantai;0;0;0;0;0;0
294;05.02.2018;2018;02;02;Maanantai;0;0;0;0;0;0
294;05.02.2018;2018;02;03;Maanantai;0;0;0;0;0;0
294;05.02.2018;2018;02;04;Maanantai;0;0;0;0;0;0
294;05.02.2018;2018;02;05;Maanantai;0;0;0;0;2;2
294;05.02.2018;2018;02;06;Maanantai;0;0;0;1;1;2
294;05.02.2018;2018;02;07;Maanantai;1;5;6;4;1;5
294;05.02.2018;2018;02;08;Maanantai;4;0;4;14;3;17
294;05.02.2018;2018;02;09;Maanantai;1;0;1;10;8;18
294;05.02.2018;2018;02;10;Maanantai;0;1;1;6;10;16
294;05.02.2018;2018;02;11;Maanantai;1;2;3;12;11;23
294;05.02.2018;2018;02;12;Maanantai;1;2;3;18;19;37
294;05.02.2018;2018;02;13;Maanantai;0;0;0;20;13;33
294;05.02.2018;2018;02;14;Maanantai;2;4;6;7;12;19
294;05.02.2018;2018;02;15;Maanantai;5;3;8;9;13;22
294;05.02.2018;2018;02;16;Maanantai;3;2;5;6;8;14
294;05.02.2018;2018;02;17;Maanantai;1;0;1;5;5;10
294;05.02.2018;2018;02;18;Maanantai;0;0;0;4;5;9
294;05.02.2018;2018;02;19;Maanantai;1;2;3;5;6;11
294;05.02.2018;2018;02;20;Maanantai;0;0;0;3;1;4
294;05.02.2018;2018;02;21;Maanantai;0;0;0;1;0;1
294;05.02.2018;2018;02;22;Maanantai;0;0;0;0;0;0
294;05.02.2018;2018;02;23;Maanantai;0;0;0;0;0;0
294;06.02.2018;2018;02;00;Tiistai;0;0;0;0;0;0
294;06.02.2018;2018;02;01;Tiistai;0;0;0;0;0;0
294;06.02.2018;2018;02;02;Tiistai;0;0;0;0;0;0
294;06.02.2018;2018;02;03;Tiistai;0;0;0;0;0;0
294;06.02.2018;2018;02;04;Tiistai;0;0;0;0;0;0
294;06.02.2018;2018;02;05;Tiistai;0;0;0;1;3;4
294;06.02.2018;2018;02;06;Tiistai;0;0;0;2;1;3
294;06.02.2018;2018;02;07;Tiistai;3;4;7;14;4;18
294;06.02.2018;2018;02;08;Tiistai;11;1;12;12;2;14
294;06.02.2018;2018;02;09;Tiistai;2;0;2;15;6;21
294;06.02.2018;2018;02;10;Tiistai;2;1;3;5;11;16
294;06.02.2018;2018;02;11;Tiistai;2;5;7;16;14;30
294;06.02.2018;2018;02;12;Tiistai;2;6;8;19;22;41
294;06.02.2018;2018;02;13;Tiistai;3;3;6;23;22;45
294;06.02.2018;2018;02;14;Tiistai;5;6;11;20;16;36
294;06.02.2018;2018;02;15;Tiistai;0;12;12;15;21;36
294;06.02.2018;2018;02;16;Tiistai;1;3;4;11;18;29
294;06.02.2018;2018;02;17;Tiistai;3;1;4;9;12;21
294;06.02.2018;2018;02;18;Tiistai;3;1;4;7;16;23
294;06.02.2018;2018;02;19;Tiistai;1;2;3;4;7;11
294;06.02.2018;2018;02;20;Tiistai;2;2;4;2;0;2
294;06.02.2018;2018;02;21;Tiistai;0;0;0;2;1;3
294;06.02.2018;2018;02;22;Tiistai;0;0;0;0;2;2
294;06.02.2018;2018;02;23;Tiistai;0;0;0;0;0;0
294;07.02.2018;2018;02;00;Keskiviikko;0;0;0;0;0;0
294;07.02.2018;2018;02;01;Keskiviikko;0;0;0;2;1;3
294;07.02.2018;2018;02;02;Keskiviikko;0;0;0;0;0;0
294;07.02.2018;2018;02;03;Keskiviikko;1;0;1;3;0;3
294;07.02.2018;2018;02;04;Keskiviikko;0;0;0;0;0;0
294;07.02.2018;2018;02;05;Keskiviikko;0;0;0;3;2;5
294;07.02.2018;2018;02;06;Keskiviikko;0;0;0;3;1;4
294;07.02.2018;2018;02;07;Keskiviikko;3;4;7;5;5;10
294;07.02.2018;2018;02;08;Keskiviikko;5;1;6;9;5;14
294;07.02.2018;2018;02;09;Keskiviikko;3;5;8;15;15;30
294;07.02.2018;2018;02;10;Keskiviikko;0;1;1;14;11;25
294;07.02.2018;2018;02;11;Keskiviikko;7;1;8;13;13;26
294;07.02.2018;2018;02;12;Keskiviikko;0;1;1;16;14;30
294;07.02.2018;2018;02;13;Keskiviikko;3;2;5;12;16;28
294;07.02.2018;2018;02;14;Keskiviikko;2;13;15;13;13;26
294;07.02.2018;2018;02;15;Keskiviikko;12;13;25;23;13;36
294;07.02.2018;2018;02;16;Keskiviikko;6;7;13;12;16;28
294;07.02.2018;2018;02;17;Keskiviikko;1;0;1;14;10;24
294;07.02.2018;2018;02;18;Keskiviikko;5;3;8;11;13;24
294;07.02.2018;2018;02;19;Keskiviikko;6;2;8;12;12;24
294;07.02.2018;2018;02;20;Keskiviikko;2;2;4;1;8;9
294;07.02.2018;2018;02;21;Keskiviikko;1;0;1;0;0;0
294;07.02.2018;2018;02;22;Keskiviikko;0;0;0;0;0;0
294;07.02.2018;2018;02;23;Keskiviikko;0;0;0;1;0;1
294;08.02.2018;2018;02;00;Torstai;0;2;2;0;0;0
294;08.02.2018;2018;02;01;Torstai;0;0;0;0;0;0
294;08.02.2018;2018;02;02;Torstai;0;0;0;0;0;0
294;08.02.2018;2018;02;03;Torstai;0;0;0;0;0;0
294;08.02.2018;2018;02;04;Torstai;0;0;0;0;0;0
294;08.02.2018;2018;02;05;Torstai;0;0;0;2;1;3
294;08.02.2018;2018;02;06;Torstai;0;0;0;4;1;5
294;08.02.2018;2018;02;07;Torstai;0;3;3;8;4;12
294;08.02.2018;2018;02;08;Torstai;14;3;17;13;6;19
294;08.02.2018;2018;02;09;Torstai;9;3;12;13;6;19
294;08.02.2018;2018;02;10;Torstai;0;2;2;6;5;11
294;08.02.2018;2018;02;11;Torstai;5;1;6;14;20;34
294;08.02.2018;2018;02;12;Torstai;2;9;11;15;15;30
294;08.02.2018;2018;02;13;Torstai;4;0;4;28;12;40
294;08.02.2018;2018;02;14;Torstai;2;8;10;15;18;33
294;08.02.2018;2018;02;15;Torstai;5;10;15;14;11;25
294;08.02.2018;2018;02;16;Torstai;1;4;5;20;16;36
294;08.02.2018;2018;02;17;Torstai;3;2;5;8;8;16
294;08.02.2018;2018;02;18;Torstai;2;0;2;11;9;20
294;08.02.2018;2018;02;19;Torstai;0;2;2;11;7;18
294;08.02.2018;2018;02;20;Torstai;4;2;6;7;5;12
294;08.02.2018;2018;02;21;Torstai;0;2;2;4;0;4
294;08.02.2018;2018;02;22;Torstai;0;0;0;0;0;0
294;08.02.2018;2018;02;23;Torstai;0;0;0;0;0;0
294;09.02.2018;2018;02;00;Perjantai;0;0;0;0;0;0
294;09.02.2018;2018;02;01;Perjantai;0;0;0;0;0;0
294;09.02.2018;2018;02;02;Perjantai;0;0;0;0;0;0
294;09.02.2018;2018;02;03;Perjantai;0;0;0;0;0;0
294;09.02.2018;2018;02;04;Perjantai;0;0;0;0;0;0
294;09.02.2018;2018;02;05;Perjantai;0;0;0;2;1;3
294;09.02.2018;2018;02;06;Perjantai;0;0;0;2;0;2
294;09.02.2018;2018;02;07;Perjantai;9;7;16;14;8;22
294;09.02.2018;2018;02;08;Perjantai;5;0;5;5;8;13
294;09.02.2018;2018;02;09;Perjantai;8;5;13;21;13;34
294;09.02.2018;2018;02;10;Perjantai;2;3;5;20;21;41
294;09.02.2018;2018;02;11;Perjantai;6;4;10;26;27;53
294;09.02.2018;2018;02;12;Perjantai;1;4;5;20;22;42
294;09.02.2018;2018;02;13;Perjantai;11;5;16;22;21;43
294;09.02.2018;2018;02;14;Perjantai;5;11;16;18;24;42
294;09.02.2018;2018;02;15;Perjantai;12;14;26;19;20;39
294;09.02.2018;2018;02;16;Perjantai;3;3;6;17;13;30
294;09.02.2018;2018;02;17;Perjantai;4;4;8;18;9;27
294;09.02.2018;2018;02;18;Perjantai;3;2;5;10;11;21
294;09.02.2018;2018;02;19;Perjantai;0;6;6;11;9;20
294;09.02.2018;2018;02;20;Perjantai;7;4;11;7;11;18
294;09.02.2018;2018;02;21;Perjantai;2;6;8;7;3;10
294;09.02.2018;2018;02;22;Perjantai;0;0;0;3;3;6
294;09.02.2018;2018;02;23;Perjantai;1;0;1;2;1;3
294;10.02.2018;2018;02;00;Lauantai;0;0;0;1;0;1
294;10.02.2018;2018;02;01;Lauantai;1;0;1;0;0;0
294;10.02.2018;2018;02;02;Lauantai;0;0;0;0;0;0
294;10.02.2018;2018;02;03;Lauantai;0;0;0;0;0;0
294;10.02.2018;2018;02;04;Lauantai;0;0;0;0;0;0
294;10.02.2018;2018;02;05;Lauantai;0;0;0;0;0;0
294;10.02.2018;2018;02;06;Lauantai;0;0;0;2;2;4
294;10.02.2018;2018;02;07;Lauantai;0;0;0;2;1;3
294;10.02.2018;2018;02;08;Lauantai;0;1;1;1;5;6
294;10.02.2018;2018;02;09;Lauantai;0;1;1;10;2;12
294;10.02.2018;2018;02;10;Lauantai;1;2;3;11;7;18
294;10.02.2018;2018;02;11;Lauantai;4;1;5;12;11;23
294;10.02.2018;2018;02;12;Lauantai;0;2;2;18;14;32
294;10.02.2018;2018;02;13;Lauantai;2;3;5;20;11;31
294;10.02.2018;2018;02;14;Lauantai;0;3;3;7;10;17
294;10.02.2018;2018;02;15;Lauantai;1;2;3;12;13;25
294;10.02.2018;2018;02;16;Lauantai;3;4;7;10;8;18
294;10.02.2018;2018;02;17;Lauantai;1;2;3;11;14;25
294;10.02.2018;2018;02;18;Lauantai;2;2;4;19;10;29
294;10.02.2018;2018;02;19;Lauantai;0;2;2;8;10;18
294;10.02.2018;2018;02;20;Lauantai;3;2;5;7;6;13
294;10.02.2018;2018;02;21;Lauantai;0;0;0;5;3;8
294;10.02.2018;2018;02;22;Lauantai;0;0;0;3;3;6
294;10.02.2018;2018;02;23;Lauantai;0;1;1;3;0;3
294;11.02.2018;2018;02;00;Sunnuntai;0;1;1;2;1;3
294;11.02.2018;2018;02;01;Sunnuntai;1;0;1;0;0;0
294;11.02.2018;2018;02;02;Sunnuntai;0;0;0;1;1;2
294;11.02.2018;2018;02;03;Sunnuntai;0;0;0;0;0;0
294;11.02.2018;2018;02;04;Sunnuntai;0;0;0;0;0;0
294;11.02.2018;2018;02;05;Sunnuntai;0;0;0;0;0;0
294;11.02.2018;2018;02;06;Sunnuntai;0;0;0;2;1;3
294;11.02.2018;2018;02;07;Sunnuntai;0;0;0;1;1;2
294;11.02.2018;2018;02;08;Sunnuntai;0;0;0;0;0;0
294;11.02.2018;2018;02;09;Sunnuntai;0;1;1;3;4;7
294;11.02.2018;2018;02;10;Sunnuntai;1;2;3;5;11;16
294;11.02.2018;2018;02;11;Sunnuntai;1;1;2;9;7;16
294;11.02.2018;2018;02;12;Sunnuntai;0;0;0;12;17;29
294;11.02.2018;2018;02;13;Sunnuntai;1;3;4;10;10;20
294;11.02.2018;2018;02;14;Sunnuntai;4;0;4;12;3;15
294;11.02.2018;2018;02;15;Sunnuntai;0;0;0;9;12;21
294;11.02.2018;2018;02;16;Sunnuntai;2;2;4;8;6;14
294;11.02.2018;2018;02;17;Sunnuntai;1;5;6;10;13;23
294;11.02.2018;2018;02;18;Sunnuntai;0;1;1;7;14;21
294;11.02.2018;2018;02;19;Sunnuntai;0;0;0;5;1;6
294;11.02.2018;2018;02;20;Sunnuntai;1;0;1;4;4;8
294;11.02.2018;2018;02;21;Sunnuntai;1;0;1;2;0;2
294;11.02.2018;2018;02;22;Sunnuntai;0;0;0;3;0;3
294;11.02.2018;2018;02;23;Sunnuntai;0;0;0;1;0;1
294;12.02.2018;2018;02;00;Maanantai;0;0;0;0;0;0
294;12.02.2018;2018;02;01;Maanantai;0;0;0;0;0;0
294;12.02.2018;2018;02;02;Maanantai;0;0;0;0;0;0
294;12.02.2018;2018;02;03;Maanantai;0;0;0;0;0;0
294;12.02.2018;2018;02;04;Maanantai;0;0;0;0;0;0
294;12.02.2018;2018;02;05;Maanantai;0;0;0;2;0;2
294;12.02.2018;2018;02;06;Maanantai;1;0;1;5;2;7
294;12.02.2018;2018;02;07;Maanantai;2;7;9;7;6;13
294;12.02.2018;2018;02;08;Maanantai;10;1;11;22;5;27
294;12.02.2018;2018;02;09;Maanantai;0;4;4;14;10;24
294;12.02.2018;2018;02;10;Maanantai;0;1;1;20;11;31
294;12.02.2018;2018;02;11;Maanantai;5;8;13;13;14;27
294;12.02.2018;2018;02;12;Maanantai;0;8;8;11;26;37
294;12.02.2018;2018;02;13;Maanantai;0;2;2;14;19;33
294;12.02.2018;2018;02;14;Maanantai;3;12;15;23;24;47
294;12.02.2018;2018;02;15;Maanantai;5;5;10;22;20;42
294;12.02.2018;2018;02;16;Maanantai;5;7;12;16;19;35
294;12.02.2018;2018;02;17;Maanantai;1;2;3;16;19;35
294;12.02.2018;2018;02;18;Maanantai;2;5;7;16;14;30
294;12.02.2018;2018;02;19;Maanantai;3;2;5;9;9;18
294;12.02.2018;2018;02;20;Maanantai;2;0;2;6;3;9
294;12.02.2018;2018;02;21;Maanantai;0;1;1;1;1;2
294;12.02.2018;2018;02;22;Maanantai;0;0;0;0;0;0
294;12.02.2018;2018;02;23;Maanantai;0;0;0;3;0;3
294;13.02.2018;2018;02;00;Tiistai;0;0;0;0;0;0
294;13.02.2018;2018;02;01;Tiistai;0;0;0;0;0;0
294;13.02.2018;2018;02;02;Tiistai;0;0;0;0;0;0
294;13.02.2018;2018;02;03;Tiistai;0;0;0;0;0;0
294;13.02.2018;2018;02;04;Tiistai;0;0;0;0;0;0
294;13.02.2018;2018;02;05;Tiistai;0;0;0;3;1;4
294;13.02.2018;2018;02;06;Tiistai;0;0;0;2;4;6
294;13.02.2018;2018;02;07;Tiistai;12;1;13;13;7;20
294;13.02.2018;2018;02;08;Tiistai;15;1;16;17;4;21
294;13.02.2018;2018;02;09;Tiistai;4;1;5;38;10;48
294;13.02.2018;2018;02;10;Tiistai;1;2;3;15;13;28
294;13.02.2018;2018;02;11;Tiistai;2;3;5;9;20;29
294;13.02.2018;2018;02;12;Tiistai;1;6;7;15;10;25
294;13.02.2018;2018;02;13;Tiistai;3;4;7;18;20;38
294;13.02.2018;2018;02;14;Tiistai;3;3;6;26;15;41
294;13.02.2018;2018;02;15;Tiistai;5;18;23;20;31;51
294;13.02.2018;2018;02;16;Tiistai;2;6;8;15;13;28
294;13.02.2018;2018;02;17;Tiistai;1;1;2;9;8;17
294;13.02.2018;2018;02;18;Tiistai;9;3;12;21;21;42
294;13.02.2018;2018;02;19;Tiistai;2;2;4;14;12;26
294;13.02.2018;2018;02;20;Tiistai;1;5;6;9;3;12
294;13.02.2018;2018;02;21;Tiistai;0;0;0;0;0;0
294;13.02.2018;2018;02;22;Tiistai;0;0;0;0;0;0
294;13.02.2018;2018;02;23;Tiistai;0;0;0;0;0;0
294;14.02.2018;2018;02;00;Keskiviikko;0;0;0;0;0;0
294;14.02.2018;2018;02;01;Keskiviikko;0;0;0;3;0;3
294;14.02.2018;2018;02;02;Keskiviikko;0;0;0;0;0;0
294;14.02.2018;2018;02;03;Keskiviikko;1;0;1;3;0;3
294;14.02.2018;2018;02;04;Keskiviikko;0;0;0;0;0;0
294;14.02.2018;2018;02;05;Keskiviikko;0;0;0;5;0;5
294;14.02.2018;2018;02;06;Keskiviikko;0;0;0;4;0;4
294;14.02.2018;2018;02;07;Keskiviikko;7;0;7;10;0;10
294;14.02.2018;2018;02;08;Keskiviikko;6;0;6;14;0;14
294;14.02.2018;2018;02;09;Keskiviikko;8;0;8;30;0;30
294;14.02.2018;2018;02;10;Keskiviikko;1;0;1;25;0;25
294;14.02.2018;2018;02;11;Keskiviikko;8;0;8;26;0;26
294;14.02.2018;2018;02;12;Keskiviikko;1;0;1;30;0;30
294;14.02.2018;2018;02;13;Keskiviikko;5;0;5;28;0;28
294;14.02.2018;2018;02;14;Keskiviikko;15;0;15;26;0;26
294;14.02.2018;2018;02;15;Keskiviikko;25;0;25;36;0;36
294;14.02.2018;2018;02;16;Keskiviikko;13;0;13;28;0;28
294;14.02.2018;2018;02;17;Keskiviikko;1;0;1;24;0;24
294;14.02.2018;2018;02;18;Keskiviikko;8;0;8;24;0;24
294;14.02.2018;2018;02;19;Keskiviikko;8;0;8;24;0;24
294;14.02.2018;2018;02;20;Keskiviikko;4;0;4;9;0;9
294;14.02.2018;2018;02;21;Keskiviikko;1;0;1;0;0;0
294;14.02.2018;2018;02;22;Keskiviikko;0;0;0;0;0;0
294;14.02.2018;2018;02;23;Keskiviikko;0;0;0;1;0;1
294;15.02.2018;2018;02;00;Torstai;2;0;2;0;0;0
294;15.02.2018;2018;02;01;Torstai;0;0;0;0;0;0
294;15.02.2018;2018;02;02;Torstai;0;0;0;0;0;0
294;15.02.2018;2018;02;03;Torstai;0;0;0;0;0;0
294;15.02.2018;2018;02;04;Torstai;0;0;0;0;0;0
294;15.02.2018;2018;02;05;Torstai;0;0;0;3;0;3
294;15.02.2018;2018;02;06;Torstai;0;0;0;5;0;5
294;15.02.2018;2018;02;07;Torstai;3;0;3;12;0;12
294;15.02.2018;2018;02;08;Torstai;17;0;17;19;0;19
294;15.02.2018;2018;02;09;Torstai;12;0;12;19;0;19
294;15.02.2018;2018;02;10;Torstai;2;0;2;11;0;11
294;15.02.2018;2018;02;11;Torstai;6;0;6;34;0;34
294;15.02.2018;2018;02;12;Torstai;11;0;11;30;0;30
294;15.02.2018;2018;02;13;Torstai;4;0;4;40;0;40
294;15.02.2018;2018;02;14;Torstai;10;0;10;33;0;33
294;15.02.2018;2018;02;15;Torstai;15;0;15;25;0;25
294;15.02.2018;2018;02;16;Torstai;5;0;5;36;0;36
294;15.02.2018;2018;02;17;Torstai;5;0;5;16;0;16
294;15.02.2018;2018;02;18;Torstai;2;0;2;20;0;20
294;15.02.2018;2018;02;19;Torstai;2;0;2;18;0;18
294;15.02.2018;2018;02;20;Torstai;6;0;6;12;0;12
294;15.02.2018;2018;02;21;Torstai;2;0;2;4;0;4
294;15.02.2018;2018;02;22;Torstai;0;0;0;0;0;0
294;15.02.2018;2018;02;23;Torstai;0;0;0;0;0;0
294;16.02.2018;2018;02;00;Perjantai;0;0;0;0;0;0
294;16.02.2018;2018;02;01;Perjantai;0;0;0;0;0;0
294;16.02.2018;2018;02;02;Perjantai;0;0;0;0;0;0
294;16.02.2018;2018;02;03;Perjantai;0;0;0;0;0;0
294;16.02.2018;2018;02;04;Perjantai;0;0;0;0;0;0
294;16.02.2018;2018;02;05;Perjantai;0;0;0;3;1;4
294;16.02.2018;2018;02;06;Perjantai;0;0;0;6;4;10
294;16.02.2018;2018;02;07;Perjantai;4;2;6;17;5;22
294;16.02.2018;2018;02;08;Perjantai;2;1;3;17;9;26
294;16.02.2018;2018;02;09;Perjantai;2;2;4;42;9;51
294;16.02.2018;2018;02;10;Perjantai;0;5;5;18;13;31
294;16.02.2018;2018;02;11;Perjantai;0;3;3;16;22;38
294;16.02.2018;2018;02;12;Perjantai;7;7;14;23;29;52
294;16.02.2018;2018;02;13;Perjantai;1;7;8;36;15;51
294;16.02.2018;2018;02;14;Perjantai;1;8;9;22;28;50
294;16.02.2018;2018;02;15;Perjantai;6;5;11;18;15;33
294;16.02.2018;2018;02;16;Perjantai;1;6;7;14;14;28
294;16.02.2018;2018;02;17;Perjantai;2;0;2;10;17;27
294;16.02.2018;2018;02;18;Perjantai;2;0;2;8;7;15
294;16.02.2018;2018;02;19;Perjantai;1;2;3;12;11;23
294;16.02.2018;2018;02;20;Perjantai;0;2;2;7;2;9
294;16.02.2018;2018;02;21;Perjantai;1;0;1;2;3;5
294;16.02.2018;2018;02;22;Perjantai;1;0;1;0;0;0
294;16.02.2018;2018;02;23;Perjantai;0;0;0;2;0;2
294;17.02.2018;2018;02;00;Lauantai;0;0;0;1;0;1
294;17.02.2018;2018;02;01;Lauantai;0;0;0;1;0;1
294;17.02.2018;2018;02;02;Lauantai;0;0;0;1;2;3
294;17.02.2018;2018;02;03;Lauantai;0;0;0;0;0;0
294;17.02.2018;2018;02;04;Lauantai;0;0;0;2;2;4
294;17.02.2018;2018;02;05;Lauantai;0;0;0;1;0;1
294;17.02.2018;2018;02;06;Lauantai;0;0;0;1;2;3
294;17.02.2018;2018;02;07;Lauantai;1;1;2;1;2;3
294;17.02.2018;2018;02;08;Lauantai;0;1;1;4;6;10
294;17.02.2018;2018;02;09;Lauantai;2;3;5;15;6;21
294;17.02.2018;2018;02;10;Lauantai;6;2;8;2;11;13
294;17.02.2018;2018;02;11;Lauantai;2;1;3;12;12;24
294;17.02.2018;2018;02;12;Lauantai;2;4;6;9;14;23
294;17.02.2018;2018;02;13;Lauantai;0;3;3;11;10;21
294;17.02.2018;2018;02;14;Lauantai;4;1;5;15;17;32
294;17.02.2018;2018;02;15;Lauantai;2;4;6;13;13;26
294;17.02.2018;2018;02;16;Lauantai;1;4;5;12;18;30
294;17.02.2018;2018;02;17;Lauantai;3;2;5;15;10;25
294;17.02.2018;2018;02;18;Lauantai;0;2;2;8;7;15
294;17.02.2018;2018;02;19;Lauantai;2;1;3;3;3;6
294;17.02.2018;2018;02;20;Lauantai;1;2;3;6;4;10
294;17.02.2018;2018;02;21;Lauantai;2;0;2;2;4;6
294;17.02.2018;2018;02;22;Lauantai;0;0;0;0;0;0
294;17.02.2018;2018;02;23;Lauantai;0;1;1;0;0;0
294;18.02.2018;2018;02;00;Sunnuntai;0;0;0;0;0;0
294;18.02.2018;2018;02;01;Sunnuntai;0;0;0;0;0;0
294;18.02.2018;2018;02;02;Sunnuntai;0;0;0;0;0;0
294;18.02.2018;2018;02;03;Sunnuntai;0;0;0;0;0;0
294;18.02.2018;2018;02;04;Sunnuntai;0;0;0;0;0;0
294;18.02.2018;2018;02;05;Sunnuntai;0;0;0;1;0;1
294;18.02.2018;2018;02;06;Sunnuntai;0;0;0;1;1;2
294;18.02.2018;2018;02;07;Sunnuntai;0;0;0;1;1;2
294;18.02.2018;2018;02;08;Sunnuntai;0;0;0;2;3;5
294;18.02.2018;2018;02;09;Sunnuntai;1;0;1;4;1;5
294;18.02.2018;2018;02;10;Sunnuntai;0;0;0;5;4;9
294;18.02.2018;2018;02;11;Sunnuntai;0;2;2;5;16;21
294;18.02.2018;2018;02;12;Sunnuntai;0;2;2;18;12;30
294;18.02.2018;2018;02;13;Sunnuntai;6;2;8;15;8;23
294;18.02.2018;2018;02;14;Sunnuntai;2;5;7;7;12;19
294;18.02.2018;2018;02;15;Sunnuntai;3;3;6;16;4;20
294;18.02.2018;2018;02;16;Sunnuntai;2;3;5;5;5;10
294;18.02.2018;2018;02;17;Sunnuntai;2;1;3;18;15;33
294;18.02.2018;2018;02;18;Sunnuntai;6;0;6;11;12;23
294;18.02.2018;2018;02;19;Sunnuntai;1;1;2;11;5;16
294;18.02.2018;2018;02;20;Sunnuntai;1;0;1;2;7;9
294;18.02.2018;2018;02;21;Sunnuntai;1;0;1;2;3;5
294;18.02.2018;2018;02;22;Sunnuntai;0;0;0;0;0;0
294;18.02.2018;2018;02;23;Sunnuntai;0;0;0;0;0;0
294;19.02.2018;2018;02;00;Maanantai;0;0;0;0;0;0
294;19.02.2018;2018;02;01;Maanantai;0;0;0;0;0;0
294;19.02.2018;2018;02;02;Maanantai;0;0;0;0;0;0
294;19.02.2018;2018;02;03;Maanantai;0;0;0;0;0;0
294;19.02.2018;2018;02;04;Maanantai;0;0;0;0;0;0
294;19.02.2018;2018;02;05;Maanantai;0;0;0;1;3;4
294;19.02.2018;2018;02;06;Maanantai;0;1;1;1;2;3
294;19.02.2018;2018;02;07;Maanantai;2;2;4;5;4;9
294;19.02.2018;2018;02;08;Maanantai;5;1;6;13;2;15
294;19.02.2018;2018;02;09;Maanantai;3;2;5;7;5;12
294;19.02.2018;2018;02;10;Maanantai;0;0;0;10;9;19
294;19.02.2018;2018;02;11;Maanantai;1;4;5;21;23;44
294;19.02.2018;2018;02;12;Maanantai;3;5;8;19;18;37
294;19.02.2018;2018;02;13;Maanantai;1;4;5;19;19;38
294;19.02.2018;2018;02;14;Maanantai;1;6;7;15;24;39
294;19.02.2018;2018;02;15;Maanantai;3;6;9;20;23;43
294;19.02.2018;2018;02;16;Maanantai;4;2;6;13;10;23
294;19.02.2018;2018;02;17;Maanantai;1;3;4;13;4;17
294;19.02.2018;2018;02;18;Maanantai;2;1;3;6;11;17
294;19.02.2018;2018;02;19;Maanantai;2;1;3;4;9;13
294;19.02.2018;2018;02;20;Maanantai;1;1;2;1;2;3
294;19.02.2018;2018;02;21;Maanantai;0;1;1;2;0;2
294;19.02.2018;2018;02;22;Maanantai;0;0;0;0;0;0
294;19.02.2018;2018;02;23;Maanantai;0;0;0;0;0;0
294;20.02.2018;2018;02;00;Tiistai;0;0;0;0;0;0
294;20.02.2018;2018;02;01;Tiistai;0;0;0;0;0;0
294;20.02.2018;2018;02;02;Tiistai;0;0;0;0;0;0
294;20.02.2018;2018;02;03;Tiistai;0;0;0;0;0;0
294;20.02.2018;2018;02;04;Tiistai;0;0;0;0;0;0
294;20.02.2018;2018;02;05;Tiistai;0;0;0;0;0;0
294;20.02.2018;2018;02;06;Tiistai;0;0;0;4;0;4
294;20.02.2018;2018;02;07;Tiistai;7;4;11;11;3;14
294;20.02.2018;2018;02;08;Tiistai;9;2;11;22;2;24
294;20.02.2018;2018;02;09;Tiistai;2;0;2;10;4;14
294;20.02.2018;2018;02;10;Tiistai;0;2;2;6;4;10
294;20.02.2018;2018;02;11;Tiistai;0;2;2;16;10;26
294;20.02.2018;2018;02;12;Tiistai;3;0;3;8;12;20
294;20.02.2018;2018;02;13;Tiistai;1;2;3;13;26;39
294;20.02.2018;2018;02;14;Tiistai;2;5;7;15;9;24
294;20.02.2018;2018;02;15;Tiistai;4;16;20;15;24;39
294;20.02.2018;2018;02;16;Tiistai;0;3;3;13;17;30
294;20.02.2018;2018;02;17;Tiistai;4;3;7;4;10;14
294;20.02.2018;2018;02;18;Tiistai;2;2;4;11;11;22
294;20.02.2018;2018;02;19;Tiistai;0;1;1;3;4;7
294;20.02.2018;2018;02;20;Tiistai;2;3;5;4;1;5
294;20.02.2018;2018;02;21;Tiistai;1;1;2;2;0;2
294;20.02.2018;2018;02;22;Tiistai;0;0;0;0;0;0
294;20.02.2018;2018;02;23;Tiistai;0;0;0;0;0;0
294;21.02.2018;2018;02;00;Keskiviikko;0;0;0;0;0;0
294;21.02.2018;2018;02;01;Keskiviikko;0;0;0;0;0;0
294;21.02.2018;2018;02;02;Keskiviikko;0;0;0;0;0;0
294;21.02.2018;2018;02;03;Keskiviikko;0;0;0;0;0;0
294;21.02.2018;2018;02;04;Keskiviikko;0;0;0;0;0;0
294;21.02.2018;2018;02;05;Keskiviikko;0;0;0;3;2;5
294;21.02.2018;2018;02;06;Keskiviikko;0;0;0;4;1;5
294;21.02.2018;2018;02;07;Keskiviikko;2;3;5;8;8;16
294;21.02.2018;2018;02;08;Keskiviikko;4;2;6;20;6;26
294;21.02.2018;2018;02;09;Keskiviikko;1;0;1;13;24;37
294;21.02.2018;2018;02;10;Keskiviikko;0;0;0;8;8;16
294;21.02.2018;2018;02;11;Keskiviikko;5;4;9;15;11;26
294;21.02.2018;2018;02;12;Keskiviikko;0;1;1;15;15;30
294;21.02.2018;2018;02;13;Keskiviikko;0;2;2;24;16;40
294;21.02.2018;2018;02;14;Keskiviikko;3;9;12;23;31;54
294;21.02.2018;2018;02;15;Keskiviikko;6;4;10;13;12;25
294;21.02.2018;2018;02;16;Keskiviikko;5;6;11;15;9;24
294;21.02.2018;2018;02;17;Keskiviikko;1;3;4;21;6;27
294;21.02.2018;2018;02;18;Keskiviikko;1;4;5;7;18;25
294;21.02.2018;2018;02;19;Keskiviikko;0;1;1;12;8;20
294;21.02.2018;2018;02;20;Keskiviikko;1;2;3;8;11;19
294;21.02.2018;2018;02;21;Keskiviikko;0;0;0;3;0;3
294;21.02.2018;2018;02;22;Keskiviikko;0;0;0;0;0;0
294;21.02.2018;2018;02;23;Keskiviikko;0;0;0;0;0;0
294;22.02.2018;2018;02;00;Torstai;0;0;0;0;0;0
294;22.02.2018;2018;02;01;Torstai;0;0;0;0;0;0
294;22.02.2018;2018;02;02;Torstai;0;0;0;0;0;0
294;22.02.2018;2018;02;03;Torstai;0;0;0;0;0;0
294;22.02.2018;2018;02;04;Torstai;0;0;0;0;0;0
294;22.02.2018;2018;02;05;Torstai;0;0;0;2;1;3
294;22.02.2018;2018;02;06;Torstai;0;2;2;2;1;3
294;22.02.2018;2018;02;07;Torstai;3;1;4;9;1;10
294;22.02.2018;2018;02;08;Torstai;6;1;7;21;3;24
294;22.02.2018;2018;02;09;Torstai;2;1;3;14;7;21
294;22.02.2018;2018;02;10;Torstai;1;1;2;10;9;19
294;22.02.2018;2018;02;11;Torstai;2;0;2;26;15;41
294;22.02.2018;2018;02;12;Torstai;2;1;3;10;17;27
294;22.02.2018;2018;02;13;Torstai;1;3;4;24;19;43
294;22.02.2018;2018;02;14;Torstai;3;3;6;14;15;29
294;22.02.2018;2018;02;15;Torstai;5;12;17;15;29;44
294;22.02.2018;2018;02;16;Torstai;6;5;11;14;23;37
294;22.02.2018;2018;02;17;Torstai;2;4;6;16;12;28
294;22.02.2018;2018;02;18;Torstai;5;1;6;13;10;23
294;22.02.2018;2018;02;19;Torstai;1;3;4;5;8;13
294;22.02.2018;2018;02;20;Torstai;0;1;1;5;3;8
294;22.02.2018;2018;02;21;Torstai;0;1;1;1;0;1
294;22.02.2018;2018;02;22;Torstai;0;0;0;1;0;1
294;22.02.2018;2018;02;23;Torstai;0;0;0;0;1;1
294;23.02.2018;2018;02;00;Perjantai;0;0;0;0;0;0
294;23.02.2018;2018;02;01;Perjantai;0;0;0;0;0;0
294;23.02.2018;2018;02;02;Perjantai;0;0;0;0;0;0
294;23.02.2018;2018;02;03;Perjantai;0;0;0;0;0;0
294;23.02.2018;2018;02;04;Perjantai;0;0;0;0;0;0
294;23.02.2018;2018;02;05;Perjantai;1;0;1;2;2;4
294;23.02.2018;2018;02;06;Perjantai;0;0;0;0;1;1
294;23.02.2018;2018;02;07;Perjantai;8;4;12;14;5;19
294;23.02.2018;2018;02;08;Perjantai;0;1;1;13;6;19
294;23.02.2018;2018;02;09;Perjantai;5;1;6;17;7;24
294;23.02.2018;2018;02;10;Perjantai;1;4;5;8;14;22
294;23.02.2018;2018;02;11;Perjantai;2;6;8;26;24;50
294;23.02.2018;2018;02;12;Perjantai;3;2;5;17;27;44
294;23.02.2018;2018;02;13;Perjantai;4;4;8;30;14;44
294;23.02.2018;2018;02;14;Perjantai;2;11;13;25;30;55
294;23.02.2018;2018;02;15;Perjantai;6;6;12;20;27;47
294;23.02.2018;2018;02;16;Perjantai;3;4;7;8;15;23
294;23.02.2018;2018;02;17;Perjantai;8;3;11;20;7;27
294;23.02.2018;2018;02;18;Perjantai;4;12;16;11;15;26
294;23.02.2018;2018;02;19;Perjantai;3;4;7;9;5;14
294;23.02.2018;2018;02;20;Perjantai;2;1;3;8;2;10
294;23.02.2018;2018;02;21;Perjantai;2;2;4;4;4;8
294;23.02.2018;2018;02;22;Perjantai;0;1;1;2;0;2
294;23.02.2018;2018;02;23;Perjantai;2;0;2;0;0;0
294;24.02.2018;2018;02;00;Lauantai;0;0;0;0;0;0
294;24.02.2018;2018;02;01;Lauantai;0;0;0;0;0;0
294;24.02.2018;2018;02;02;Lauantai;0;0;0;0;0;0
294;24.02.2018;2018;02;03;Lauantai;0;0;0;0;0;0
294;24.02.2018;2018;02;04;Lauantai;0;0;0;0;0;0
294;24.02.2018;2018;02;05;Lauantai;0;0;0;0;1;1
294;24.02.2018;2018;02;06;Lauantai;0;0;0;0;0;0
294;24.02.2018;2018;02;07;Lauantai;0;0;0;0;2;2
294;24.02.2018;2018;02;08;Lauantai;0;0;0;3;1;4
294;24.02.2018;2018;02;09;Lauantai;0;0;0;1;2;3
294;24.02.2018;2018;02;10;Lauantai;1;2;3;5;3;8
294;24.02.2018;2018;02;11;Lauantai;2;1;3;5;13;18
294;24.02.2018;2018;02;12;Lauantai;2;0;2;15;10;25
294;24.02.2018;2018;02;13;Lauantai;5;6;11;31;15;46
294;24.02.2018;2018;02;14;Lauantai;5;2;7;18;19;37
294;24.02.2018;2018;02;15;Lauantai;3;3;6;19;19;38
294;24.02.2018;2018;02;16;Lauantai;3;4;7;22;12;34
294;24.02.2018;2018;02;17;Lauantai;2;1;3;10;15;25
294;24.02.2018;2018;02;18;Lauantai;2;1;3;6;8;14
294;24.02.2018;2018;02;19;Lauantai;2;1;3;6;4;10
294;24.02.2018;2018;02;20;Lauantai;2;0;2;4;2;6
294;24.02.2018;2018;02;21;Lauantai;2;0;2;0;0;0
294;24.02.2018;2018;02;22;Lauantai;1;2;3;1;1;2
294;24.02.2018;2018;02;23;Lauantai;0;0;0;0;0;0
294;25.02.2018;2018;02;00;Sunnuntai;0;0;0;1;0;1
294;25.02.2018;2018;02;01;Sunnuntai;0;0;0;0;0;0
294;25.02.2018;2018;02;02;Sunnuntai;0;0;0;0;0;0
294;25.02.2018;2018;02;03;Sunnuntai;0;0;0;0;1;1
294;25.02.2018;2018;02;04;Sunnuntai;0;0;0;0;0;0
294;25.02.2018;2018;02;05;Sunnuntai;0;0;0;0;0;0
294;25.02.2018;2018;02;06;Sunnuntai;0;0;0;2;3;5
294;25.02.2018;2018;02;07;Sunnuntai;0;0;0;2;0;2
294;25.02.2018;2018;02;08;Sunnuntai;0;0;0;1;1;2
294;25.02.2018;2018;02;09;Sunnuntai;0;0;0;1;3;4
294;25.02.2018;2018;02;10;Sunnuntai;0;1;1;7;9;16
294;25.02.2018;2018;02;11;Sunnuntai;1;0;1;13;13;26
294;25.02.2018;2018;02;12;Sunnuntai;3;2;5;7;13;20
294;25.02.2018;2018;02;13;Sunnuntai;0;1;1;9;9;18
294;25.02.2018;2018;02;14;Sunnuntai;2;1;3;7;5;12
294;25.02.2018;2018;02;15;Sunnuntai;2;4;6;5;6;11
294;25.02.2018;2018;02;16;Sunnuntai;3;1;4;4;8;12
294;25.02.2018;2018;02;17;Sunnuntai;1;3;4;10;6;16
294;25.02.2018;2018;02;18;Sunnuntai;0;0;0;7;12;19
294;25.02.2018;2018;02;19;Sunnuntai;1;0;1;6;6;12
294;25.02.2018;2018;02;20;Sunnuntai;1;0;1;6;0;6
294;25.02.2018;2018;02;21;Sunnuntai;0;0;0;3;1;4
294;25.02.2018;2018;02;22;Sunnuntai;0;0;0;0;0;0
294;25.02.2018;2018;02;23;Sunnuntai;0;0;0;0;0;0
294;26.02.2018;2018;02;00;Maanantai;0;0;0;0;0;0
294;26.02.2018;2018;02;01;Maanantai;0;0;0;0;0;0
294;26.02.2018;2018;02;02;Maanantai;0;0;0;0;0;0
294;26.02.2018;2018;02;03;Maanantai;0;0;0;0;0;0
294;26.02.2018;2018;02;04;Maanantai;0;0;0;0;0;0
294;26.02.2018;2018;02;05;Maanantai;0;0;0;2;0;2
294;26.02.2018;2018;02;06;Maanantai;1;0;1;1;3;4
294;26.02.2018;2018;02;07;Maanantai;5;8;13;7;5;12
294;26.02.2018;2018;02;08;Maanantai;8;1;9;18;6;24
294;26.02.2018;2018;02;09;Maanantai;4;3;7;12;7;19
294;26.02.2018;2018;02;10;Maanantai;2;1;3;17;6;23
294;26.02.2018;2018;02;11;Maanantai;1;9;10;20;17;37
294;26.02.2018;2018;02;12;Maanantai;3;3;6;15;15;30
294;26.02.2018;2018;02;13;Maanantai;2;2;4;20;16;36
294;26.02.2018;2018;02;14;Maanantai;6;7;13;18;24;42
294;26.02.2018;2018;02;15;Maanantai;6;11;17;16;28;44
294;26.02.2018;2018;02;16;Maanantai;5;5;10;17;12;29
294;26.02.2018;2018;02;17;Maanantai;0;2;2;11;14;25
294;26.02.2018;2018;02;18;Maanantai;1;2;3;10;15;25
294;26.02.2018;2018;02;19;Maanantai;4;1;5;10;5;15
294;26.02.2018;2018;02;20;Maanantai;2;1;3;6;5;11
294;26.02.2018;2018;02;21;Maanantai;0;0;0;0;1;1
294;26.02.2018;2018;02;22;Maanantai;0;0;0;0;0;0
294;26.02.2018;2018;02;23;Maanantai;0;0;0;0;0;0
294;27.02.2018;2018;02;00;Tiistai;0;0;0;0;0;0
294;27.02.2018;2018;02;01;Tiistai;0;0;0;0;0;0
294;27.02.2018;2018;02;02;Tiistai;0;0;0;0;0;0
294;27.02.2018;2018;02;03;Tiistai;0;0;0;0;0;0
294;27.02.2018;2018;02;04;Tiistai;0;0;0;0;0;0
294;27.02.2018;2018;02;05;Tiistai;0;0;0;4;0;4
294;27.02.2018;2018;02;06;Tiistai;0;0;0;1;0;1
294;27.02.2018;2018;02;07;Tiistai;8;5;13;9;5;14
294;27.02.2018;2018;02;08;Tiistai;13;4;17;17;2;19
294;27.02.2018;2018;02;09;Tiistai;6;4;10;27;4;31
294;27.02.2018;2018;02;10;Tiistai;2;6;8;36;25;61
294;27.02.2018;2018;02;11;Tiistai;5;5;10;23;19;42
294;27.02.2018;2018;02;12;Tiistai;3;1;4;12;20;32
294;27.02.2018;2018;02;13;Tiistai;3;4;7;23;26;49
294;27.02.2018;2018;02;14;Tiistai;9;4;13;20;16;36
294;27.02.2018;2018;02;15;Tiistai;4;7;11;18;22;40
294;27.02.2018;2018;02;16;Tiistai;6;0;6;15;9;24
294;27.02.2018;2018;02;17;Tiistai;3;5;8;5;5;10
294;27.02.2018;2018;02;18;Tiistai;2;0;2;5;5;10
294;27.02.2018;2018;02;19;Tiistai;0;2;2;3;5;8
294;27.02.2018;2018;02;20;Tiistai;1;2;3;3;0;3
294;27.02.2018;2018;02;21;Tiistai;2;1;3;0;0;0
294;27.02.2018;2018;02;22;Tiistai;0;0;0;0;0;0
294;27.02.2018;2018;02;23;Tiistai;0;0;0;0;0;0
294;28.02.2018;2018;02;00;Keskiviikko;0;0;0;0;0;0
294;28.02.2018;2018;02;01;Keskiviikko;0;0;0;0;0;0
294;28.02.2018;2018;02;02;Keskiviikko;0;0;0;0;0;0
294;28.02.2018;2018;02;03;Keskiviikko;0;0;0;0;0;0
294;28.02.2018;2018;02;04;Keskiviikko;0;0;0;0;0;0
294;28.02.2018;2018;02;05;Keskiviikko;0;0;0;0;1;1
294;28.02.2018;2018;02;06;Keskiviikko;0;0;0;2;1;3
294;28.02.2018;2018;02;07;Keskiviikko;0;5;5;4;2;6
294;28.02.2018;2018;02;08;Keskiviikko;6;0;6;7;3;10
294;28.02.2018;2018;02;09;Keskiviikko;0;2;2;8;2;10
294;28.02.2018;2018;02;10;Keskiviikko;0;1;1;1;9;10
294;28.02.2018;2018;02;11;Keskiviikko;4;3;7;17;28;45
294;28.02.2018;2018;02;12;Keskiviikko;1;1;2;23;16;39
294;28.02.2018;2018;02;13;Keskiviikko;4;0;4;21;14;35
294;28.02.2018;2018;02;14;Keskiviikko;1;11;12;17;27;44
294;28.02.2018;2018;02;15;Keskiviikko;7;3;10;10;20;30
294;28.02.2018;2018;02;16;Keskiviikko;2;5;7;22;9;31
294;28.02.2018;2018;02;17;Keskiviikko;2;2;4;9;8;17
294;28.02.2018;2018;02;18;Keskiviikko;1;4;5;9;20;29
294;28.02.2018;2018;02;19;Keskiviikko;0;3;3;6;12;18
294;28.02.2018;2018;02;20;Keskiviikko;0;2;2;9;4;13
294;28.02.2018;2018;02;21;Keskiviikko;0;0;0;1;2;3
294;28.02.2018;2018;02;22;Keskiviikko;0;0;0;0;0;0
294;28.02.2018;2018;02;23;Keskiviikko;0;0;0;1;0;1
294;01.03.2018;2018;03;00;Torstai;0;0;0;1;0;1
294;01.03.2018;2018;03;01;Torstai;0;0;0;0;0;0
294;01.03.2018;2018;03;02;Torstai;0;0;0;0;0;0
294;01.03.2018;2018;03;03;Torstai;0;0;0;0;0;0
294;01.03.2018;2018;03;04;Torstai;0;0;0;0;0;0
294;01.03.2018;2018;03;05;Torstai;0;0;0;2;0;2
294;01.03.2018;2018;03;06;Torstai;1;0;1;1;2;3
294;01.03.2018;2018;03;07;Torstai;0;1;1;12;3;15
294;01.03.2018;2018;03;08;Torstai;6;1;7;16;6;22
294;01.03.2018;2018;03;09;Torstai;3;3;6;11;8;19
294;01.03.2018;2018;03;10;Torstai;3;2;5;5;14;19
294;01.03.2018;2018;03;11;Torstai;2;1;3;18;20;38
294;01.03.2018;2018;03;12;Torstai;3;3;6;9;12;21
294;01.03.2018;2018;03;13;Torstai;4;3;7;15;15;30
294;01.03.2018;2018;03;14;Torstai;5;5;10;14;18;32
294;01.03.2018;2018;03;15;Torstai;2;15;17;22;21;43
294;01.03.2018;2018;03;16;Torstai;1;4;5;14;20;34
294;01.03.2018;2018;03;17;Torstai;2;3;5;16;20;36
294;01.03.2018;2018;03;18;Torstai;1;3;4;11;10;21
294;01.03.2018;2018;03;19;Torstai;3;4;7;7;12;19
294;01.03.2018;2018;03;20;Torstai;3;3;6;3;5;8
294;01.03.2018;2018;03;21;Torstai;0;0;0;1;3;4
294;01.03.2018;2018;03;22;Torstai;0;0;0;0;0;0
294;01.03.2018;2018;03;23;Torstai;0;0;0;1;0;1
294;02.03.2018;2018;03;00;Perjantai;0;0;0;0;0;0
294;02.03.2018;2018;03;01;Perjantai;0;0;0;0;0;0
294;02.03.2018;2018;03;02;Perjantai;0;0;0;0;0;0
294;02.03.2018;2018;03;03;Perjantai;0;0;0;0;0;0
294;02.03.2018;2018;03;04;Perjantai;0;0;0;0;0;0
294;02.03.2018;2018;03;05;Perjantai;0;0;0;2;0;2
294;02.03.2018;2018;03;06;Perjantai;0;0;0;1;3;4
294;02.03.2018;2018;03;07;Perjantai;11;3;14;14;7;21
294;02.03.2018;2018;03;08;Perjantai;4;1;5;7;6;13
294;02.03.2018;2018;03;09;Perjantai;8;1;9;25;12;37
294;02.03.2018;2018;03;10;Perjantai;1;8;9;14;25;39
294;02.03.2018;2018;03;11;Perjantai;3;4;7;16;9;25
294;02.03.2018;2018;03;12;Perjantai;3;4;7;21;16;37
294;02.03.2018;2018;03;13;Perjantai;6;5;11;21;21;42
294;02.03.2018;2018;03;14;Perjantai;1;17;18;21;17;38
294;02.03.2018;2018;03;15;Perjantai;7;7;14;16;20;36
294;02.03.2018;2018;03;16;Perjantai;3;3;6;14;21;35
294;02.03.2018;2018;03;17;Perjantai;3;0;3;13;10;23
294;02.03.2018;2018;03;18;Perjantai;5;2;7;21;7;28
294;02.03.2018;2018;03;19;Perjantai;0;2;2;8;13;21
294;02.03.2018;2018;03;20;Perjantai;0;0;0;8;5;13
294;02.03.2018;2018;03;21;Perjantai;3;2;5;1;2;3
294;02.03.2018;2018;03;22;Perjantai;0;1;1;1;1;2
294;02.03.2018;2018;03;23;Perjantai;0;0;0;1;0;1
294;03.03.2018;2018;03;00;Lauantai;0;0;0;0;0;0
294;03.03.2018;2018;03;01;Lauantai;0;0;0;0;1;1
294;03.03.2018;2018;03;02;Lauantai;0;0;0;0;1;1
294;03.03.2018;2018;03;03;Lauantai;0;0;0;0;1;1
294;03.03.2018;2018;03;04;Lauantai;0;0;0;0;0;0
294;03.03.2018;2018;03;05;Lauantai;0;0;0;0;0;0
294;03.03.2018;2018;03;06;Lauantai;0;0;0;3;2;5
294;03.03.2018;2018;03;07;Lauantai;0;2;2;3;0;3
294;03.03.2018;2018;03;08;Lauantai;0;0;0;6;3;9
294;03.03.2018;2018;03;09;Lauantai;0;0;0;14;9;23
294;03.03.2018;2018;03;10;Lauantai;1;1;2;13;11;24
294;03.03.2018;2018;03;11;Lauantai;0;2;2;17;18;35
294;03.03.2018;2018;03;12;Lauantai;1;1;2;17;13;30
294;03.03.2018;2018;03;13;Lauantai;2;2;4;19;9;28
294;03.03.2018;2018;03;14;Lauantai;1;2;3;10;9;19
294;03.03.2018;2018;03;15;Lauantai;1;3;4;15;10;25
294;03.03.2018;2018;03;16;Lauantai;1;2;3;8;12;20
294;03.03.2018;2018;03;17;Lauantai;2;1;3;17;11;28
294;03.03.2018;2018;03;18;Lauantai;1;5;6;7;4;11
294;03.03.2018;2018;03;19;Lauantai;6;3;9;9;10;19
294;03.03.2018;2018;03;20;Lauantai;0;0;0;4;6;10
294;03.03.2018;2018;03;21;Lauantai;1;3;4;0;1;1
294;03.03.2018;2018;03;22;Lauantai;2;0;2;2;1;3
294;03.03.2018;2018;03;23;Lauantai;1;2;3;1;0;1
294;04.03.2018;2018;03;00;Sunnuntai;2;1;3;4;0;4
294;04.03.2018;2018;03;01;Sunnuntai;0;0;0;1;0;1
294;04.03.2018;2018;03;02;Sunnuntai;0;0;0;1;0;1
294;04.03.2018;2018;03;03;Sunnuntai;0;0;0;0;1;1
294;04.03.2018;2018;03;04;Sunnuntai;0;0;0;0;0;0
294;04.03.2018;2018;03;05;Sunnuntai;0;0;0;0;0;0
294;04.03.2018;2018;03;06;Sunnuntai;0;0;0;2;1;3
294;04.03.2018;2018;03;07;Sunnuntai;0;0;0;2;0;2
294;04.03.2018;2018;03;08;Sunnuntai;0;0;0;3;3;6
294;04.03.2018;2018;03;09;Sunnuntai;0;1;1;15;0;15
294;04.03.2018;2018;03;10;Sunnuntai;1;3;4;6;16;22
294;04.03.2018;2018;03;11;Sunnuntai;0;0;0;8;14;22
294;04.03.2018;2018;03;12;Sunnuntai;1;0;1;6;6;12
294;04.03.2018;2018;03;13;Sunnuntai;1;2;3;13;10;23
294;04.03.2018;2018;03;14;Sunnuntai;2;0;2;0;4;4
294;04.03.2018;2018;03;15;Sunnuntai;1;0;1;6;8;14
294;04.03.2018;2018;03;16;Sunnuntai;1;2;3;3;7;10
294;04.03.2018;2018;03;17;Sunnuntai;1;1;2;3;5;8
294;04.03.2018;2018;03;18;Sunnuntai;3;3;6;7;8;15
294;04.03.2018;2018;03;19;Sunnuntai;0;0;0;3;2;5
294;04.03.2018;2018;03;20;Sunnuntai;0;1;1;4;7;11
294;04.03.2018;2018;03;21;Sunnuntai;2;2;4;4;2;6
294;04.03.2018;2018;03;22;Sunnuntai;1;0;1;0;1;1
294;04.03.2018;2018;03;23;Sunnuntai;0;0;0;1;0;1
294;05.03.2018;2018;03;00;Maanantai;0;0;0;0;0;0
294;05.03.2018;2018;03;01;Maanantai;0;0;0;0;0;0
294;05.03.2018;2018;03;02;Maanantai;0;0;0;0;0;0
294;05.03.2018;2018;03;03;Maanantai;0;0;0;0;0;0
294;05.03.2018;2018;03;04;Maanantai;0;0;0;0;0;0
294;05.03.2018;2018;03;05;Maanantai;0;0;0;1;0;1
294;05.03.2018;2018;03;06;Maanantai;0;0;0;1;2;3
294;05.03.2018;2018;03;07;Maanantai;0;0;0;2;6;8
294;05.03.2018;2018;03;08;Maanantai;0;3;3;7;4;11
294;05.03.2018;2018;03;09;Maanantai;0;1;1;6;5;11
294;05.03.2018;2018;03;10;Maanantai;0;1;1;10;4;14
294;05.03.2018;2018;03;11;Maanantai;2;1;3;10;8;18
294;05.03.2018;2018;03;12;Maanantai;1;0;1;11;17;28
294;05.03.2018;2018;03;13;Maanantai;2;2;4;25;26;51
294;05.03.2018;2018;03;14;Maanantai;7;3;10;22;13;35
294;05.03.2018;2018;03;15;Maanantai;1;2;3;16;9;25
294;05.03.2018;2018;03;16;Maanantai;2;4;6;11;7;18
294;05.03.2018;2018;03;17;Maanantai;1;6;7;13;9;22
294;05.03.2018;2018;03;18;Maanantai;2;4;6;13;20;33
294;05.03.2018;2018;03;19;Maanantai;8;3;11;6;4;10
294;05.03.2018;2018;03;20;Maanantai;1;1;2;11;4;15
294;05.03.2018;2018;03;21;Maanantai;0;1;1;1;0;1
294;05.03.2018;2018;03;22;Maanantai;0;0;0;1;0;1
294;05.03.2018;2018;03;23;Maanantai;0;0;0;1;4;5
294;06.03.2018;2018;03;00;Tiistai;0;0;0;0;0;0
294;06.03.2018;2018;03;01;Tiistai;0;0;0;0;0;0
294;06.03.2018;2018;03;02;Tiistai;0;0;0;0;0;0
294;06.03.2018;2018;03;03;Tiistai;0;0;0;0;0;0
294;06.03.2018;2018;03;04;Tiistai;0;0;0;0;0;0
294;06.03.2018;2018;03;05;Tiistai;0;0;0;2;0;2
294;06.03.2018;2018;03;06;Tiistai;0;0;0;1;1;2
294;06.03.2018;2018;03;07;Tiistai;0;0;0;7;1;8
294;06.03.2018;2018;03;08;Tiistai;0;2;2;8;5;13
294;06.03.2018;2018;03;09;Tiistai;0;0;0;8;2;10
294;06.03.2018;2018;03;10;Tiistai;2;3;5;9;14;23
294;06.03.2018;2018;03;11;Tiistai;1;2;3;17;18;35
294;06.03.2018;2018;03;12;Tiistai;2;3;5;21;14;35
294;06.03.2018;2018;03;13;Tiistai;0;0;0;9;13;22
294;06.03.2018;2018;03;14;Tiistai;3;1;4;18;11;29
294;06.03.2018;2018;03;15;Tiistai;1;4;5;14;11;25
294;06.03.2018;2018;03;16;Tiistai;2;2;4;10;11;21
294;06.03.2018;2018;03;17;Tiistai;1;2;3;13;11;24
294;06.03.2018;2018;03;18;Tiistai;1;3;4;5;11;16
294;06.03.2018;2018;03;19;Tiistai;1;1;2;7;8;15
294;06.03.2018;2018;03;20;Tiistai;0;0;0;4;2;6
294;06.03.2018;2018;03;21;Tiistai;0;0;0;1;0;1
294;06.03.2018;2018;03;22;Tiistai;1;0;1;0;0;0
294;06.03.2018;2018;03;23;Tiistai;0;1;1;0;0;0
294;07.03.2018;2018;03;00;Keskiviikko;0;0;0;0;0;0
294;07.03.2018;2018;03;01;Keskiviikko;0;0;0;0;0;0
294;07.03.2018;2018;03;02;Keskiviikko;0;0;0;0;0;0
294;07.03.2018;2018;03;03;Keskiviikko;0;0;0;0;0;0
294;07.03.2018;2018;03;04;Keskiviikko;0;0;0;0;0;0
294;07.03.2018;2018;03;05;Keskiviikko;0;0;0;2;0;2
294;07.03.2018;2018;03;06;Keskiviikko;0;1;1;1;2;3
294;07.03.2018;2018;03;07;Keskiviikko;0;0;0;3;4;7
294;07.03.2018;2018;03;08;Keskiviikko;0;1;1;4;4;8
294;07.03.2018;2018;03;09;Keskiviikko;0;1;1;9;9;18
294;07.03.2018;2018;03;10;Keskiviikko;1;0;1;10;8;18
294;07.03.2018;2018;03;11;Keskiviikko;1;2;3;16;10;26
294;07.03.2018;2018;03;12;Keskiviikko;2;4;6;25;20;45
294;07.03.2018;2018;03;13;Keskiviikko;3;2;5;12;14;26
294;07.03.2018;2018;03;14;Keskiviikko;1;0;1;16;7;23
294;07.03.2018;2018;03;15;Keskiviikko;2;2;4;11;9;20
294;07.03.2018;2018;03;16;Keskiviikko;1;0;1;6;12;18
294;07.03.2018;2018;03;17;Keskiviikko;2;0;2;7;9;16
294;07.03.2018;2018;03;18;Keskiviikko;5;3;8;7;6;13
294;07.03.2018;2018;03;19;Keskiviikko;2;0;2;9;10;19
294;07.03.2018;2018;03;20;Keskiviikko;1;0;1;5;1;6
294;07.03.2018;2018;03;21;Keskiviikko;1;1;2;1;1;2
294;07.03.2018;2018;03;22;Keskiviikko;0;0;0;2;1;3
294;07.03.2018;2018;03;23;Keskiviikko;0;1;1;0;0;0
294;08.03.2018;2018;03;00;Torstai;0;0;0;0;0;0
294;08.03.2018;2018;03;01;Torstai;0;0;0;0;0;0
294;08.03.2018;2018;03;02;Torstai;0;0;0;0;0;0
294;08.03.2018;2018;03;03;Torstai;0;0;0;0;0;0
294;08.03.2018;2018;03;04;Torstai;0;0;0;0;0;0
294;08.03.2018;2018;03;05;Torstai;0;0;0;2;1;3
294;08.03.2018;2018;03;06;Torstai;0;0;0;3;1;4
294;08.03.2018;2018;03;07;Torstai;2;0;2;4;8;12
294;08.03.2018;2018;03;08;Torstai;2;0;2;5;4;9
294;08.03.2018;2018;03;09;Torstai;1;4;5;4;12;16
294;08.03.2018;2018;03;10;Torstai;1;0;1;8;15;23
294;08.03.2018;2018;03;11;Torstai;0;3;3;9;13;22
294;08.03.2018;2018;03;12;Torstai;2;4;6;15;16;31
294;08.03.2018;2018;03;13;Torstai;3;5;8;32;17;49
294;08.03.2018;2018;03;14;Torstai;3;2;5;17;22;39
294;08.03.2018;2018;03;15;Torstai;0;0;0;6;9;15
294;08.03.2018;2018;03;16;Torstai;1;0;1;10;4;14
294;08.03.2018;2018;03;17;Torstai;0;0;0;8;8;16
294;08.03.2018;2018;03;18;Torstai;3;1;4;6;12;18
294;08.03.2018;2018;03;19;Torstai;1;0;1;6;9;15
294;08.03.2018;2018;03;20;Torstai;0;2;2;8;7;15
294;08.03.2018;2018;03;21;Torstai;1;0;1;0;3;3
294;08.03.2018;2018;03;22;Torstai;1;0;1;1;0;1
294;08.03.2018;2018;03;23;Torstai;0;1;1;1;0;1
294;09.03.2018;2018;03;00;Perjantai;0;0;0;2;1;3
294;09.03.2018;2018;03;01;Perjantai;1;0;1;0;0;0
294;09.03.2018;2018;03;02;Perjantai;0;0;0;0;0;0
294;09.03.2018;2018;03;03;Perjantai;1;0;1;0;0;0
294;09.03.2018;2018;03;04;Perjantai;0;0;0;0;0;0
294;09.03.2018;2018;03;05;Perjantai;0;0;0;1;1;2
294;09.03.2018;2018;03;06;Perjantai;0;0;0;2;0;2
294;09.03.2018;2018;03;07;Perjantai;0;0;0;3;4;7
294;09.03.2018;2018;03;08;Perjantai;7;2;9;5;4;9
294;09.03.2018;2018;03;09;Perjantai;2;4;6;13;13;26
294;09.03.2018;2018;03;10;Perjantai;2;2;4;11;10;21
294;09.03.2018;2018;03;11;Perjantai;1;3;4;13;20;33
294;09.03.2018;2018;03;12;Perjantai;5;5;10;15;9;24
294;09.03.2018;2018;03;13;Perjantai;0;2;2;8;12;20
294;09.03.2018;2018;03;14;Perjantai;0;3;3;8;15;23
294;09.03.2018;2018;03;15;Perjantai;2;4;6;11;10;21
294;09.03.2018;2018;03;16;Perjantai;0;1;1;11;8;19
294;09.03.2018;2018;03;17;Perjantai;3;0;3;11;8;19
294;09.03.2018;2018;03;18;Perjantai;1;7;8;13;8;21
294;09.03.2018;2018;03;19;Perjantai;0;2;2;10;14;24
294;09.03.2018;2018;03;20;Perjantai;1;1;2;7;7;14
294;09.03.2018;2018;03;21;Perjantai;6;1;7;5;3;8
294;09.03.2018;2018;03;22;Perjantai;1;0;1;2;0;2
294;09.03.2018;2018;03;23;Perjantai;1;0;1;0;0;0
294;10.03.2018;2018;03;00;Lauantai;0;0;0;0;0;0
294;10.03.2018;2018;03;01;Lauantai;0;0;0;0;0;0
294;10.03.2018;2018;03;02;Lauantai;0;0;0;0;0;0
294;10.03.2018;2018;03;03;Lauantai;0;0;0;0;0;0
294;10.03.2018;2018;03;04;Lauantai;0;0;0;0;0;0
294;10.03.2018;2018;03;05;Lauantai;1;0;1;3;0;3
294;10.03.2018;2018;03;06;Lauantai;0;0;0;2;3;5
294;10.03.2018;2018;03;07;Lauantai;0;0;0;2;1;3
294;10.03.2018;2018;03;08;Lauantai;0;2;2;2;6;8
294;10.03.2018;2018;03;09;Lauantai;1;0;1;7;12;19
294;10.03.2018;2018;03;10;Lauantai;2;3;5;20;9;29
294;10.03.2018;2018;03;11;Lauantai;2;4;6;17;18;35
294;10.03.2018;2018;03;12;Lauantai;3;0;3;13;13;26
294;10.03.2018;2018;03;13;Lauantai;1;3;4;22;19;41
294;10.03.2018;2018;03;14;Lauantai;1;0;1;14;8;22
294;10.03.2018;2018;03;15;Lauantai;0;1;1;11;8;19
294;10.03.2018;2018;03;16;Lauantai;1;1;2;16;7;23
294;10.03.2018;2018;03;17;Lauantai;1;4;5;10;10;20
294;10.03.2018;2018;03;18;Lauantai;3;2;5;12;10;22
294;10.03.2018;2018;03;19;Lauantai;0;1;1;8;4;12
294;10.03.2018;2018;03;20;Lauantai;0;1;1;9;6;15
294;10.03.2018;2018;03;21;Lauantai;0;0;0;5;0;5
294;10.03.2018;2018;03;22;Lauantai;0;0;0;1;0;1
294;10.03.2018;2018;03;23;Lauantai;0;0;0;2;1;3
294;11.03.2018;2018;03;00;Sunnuntai;0;1;1;1;0;1
294;11.03.2018;2018;03;01;Sunnuntai;0;0;0;0;0;0
294;11.03.2018;2018;03;02;Sunnuntai;0;0;0;0;0;0
294;11.03.2018;2018;03;03;Sunnuntai;0;0;0;0;0;0
294;11.03.2018;2018;03;04;Sunnuntai;0;0;0;1;0;1
294;11.03.2018;2018;03;05;Sunnuntai;0;0;0;1;0;1
294;11.03.2018;2018;03;06;Sunnuntai;0;0;0;1;0;1
294;11.03.2018;2018;03;07;Sunnuntai;0;0;0;2;2;4
294;11.03.2018;2018;03;08;Sunnuntai;2;0;2;3;3;6
294;11.03.2018;2018;03;09;Sunnuntai;1;0;1;7;7;14
294;11.03.2018;2018;03;10;Sunnuntai;0;0;0;5;5;10
294;11.03.2018;2018;03;11;Sunnuntai;1;1;2;8;8;16
294;11.03.2018;2018;03;12;Sunnuntai;1;1;2;12;5;17
294;11.03.2018;2018;03;13;Sunnuntai;2;1;3;5;8;13
294;11.03.2018;2018;03;14;Sunnuntai;0;3;3;8;8;16
294;11.03.2018;2018;03;15;Sunnuntai;1;1;2;14;10;24
294;11.03.2018;2018;03;16;Sunnuntai;1;0;1;10;8;18
294;11.03.2018;2018;03;17;Sunnuntai;2;1;3;3;8;11
294;11.03.2018;2018;03;18;Sunnuntai;0;0;0;10;7;17
294;11.03.2018;2018;03;19;Sunnuntai;0;2;2;5;6;11
294;11.03.2018;2018;03;20;Sunnuntai;2;0;2;4;3;7
294;11.03.2018;2018;03;21;Sunnuntai;0;0;0;3;1;4
294;11.03.2018;2018;03;22;Sunnuntai;0;0;0;0;0;0
294;11.03.2018;2018;03;23;Sunnuntai;7;0;7;9;0;9
294;12.03.2018;2018;03;00;Maanantai;0;0;0;0;0;0
294;12.03.2018;2018;03;01;Maanantai;0;0;0;0;0;0
294;12.03.2018;2018;03;02;Maanantai;0;0;0;0;0;0
294;12.03.2018;2018;03;03;Maanantai;0;0;0;0;0;0
294;12.03.2018;2018;03;04;Maanantai;0;0;0;0;0;0
294;12.03.2018;2018;03;05;Maanantai;0;0;0;2;1;3
294;12.03.2018;2018;03;06;Maanantai;0;0;0;0;4;4
294;12.03.2018;2018;03;07;Maanantai;1;3;4;7;5;12
294;12.03.2018;2018;03;08;Maanantai;13;2;15;15;6;21
294;12.03.2018;2018;03;09;Maanantai;3;1;4;5;12;17
294;12.03.2018;2018;03;10;Maanantai;4;1;5;22;21;43
294;12.03.2018;2018;03;11;Maanantai;3;10;13;24;21;45
294;12.03.2018;2018;03;12;Maanantai;1;0;1;21;24;45
294;12.03.2018;2018;03;13;Maanantai;1;5;6;14;15;29
294;12.03.2018;2018;03;14;Maanantai;0;6;6;13;9;22
294;12.03.2018;2018;03;15;Maanantai;5;9;14;14;13;27
294;12.03.2018;2018;03;16;Maanantai;1;2;3;13;15;28
294;12.03.2018;2018;03;17;Maanantai;4;3;7;16;10;26
294;12.03.2018;2018;03;18;Maanantai;0;5;5;19;22;41
294;12.03.2018;2018;03;19;Maanantai;3;7;10;6;7;13
294;12.03.2018;2018;03;20;Maanantai;5;0;5;8;5;13
294;12.03.2018;2018;03;21;Maanantai;0;0;0;1;0;1
294;12.03.2018;2018;03;22;Maanantai;0;0;0;0;0;0
294;12.03.2018;2018;03;23;Maanantai;0;0;0;0;0;0
294;13.03.2018;2018;03;00;Tiistai;0;0;0;0;0;0
294;13.03.2018;2018;03;01;Tiistai;0;0;0;0;0;0
294;13.03.2018;2018;03;02;Tiistai;0;0;0;0;0;0
294;13.03.2018;2018;03;03;Tiistai;0;0;0;0;0;0
294;13.03.2018;2018;03;04;Tiistai;2;0;2;2;0;2
294;13.03.2018;2018;03;05;Tiistai;0;0;0;2;1;3
294;13.03.2018;2018;03;06;Tiistai;1;0;1;3;1;4
294;13.03.2018;2018;03;07;Tiistai;5;4;9;16;9;25
294;13.03.2018;2018;03;08;Tiistai;5;3;8;21;4;25
294;13.03.2018;2018;03;09;Tiistai;2;2;4;17;9;26
294;13.03.2018;2018;03;10;Tiistai;2;3;5;12;11;23
294;13.03.2018;2018;03;11;Tiistai;1;1;2;15;21;36
294;13.03.2018;2018;03;12;Tiistai;3;1;4;27;23;50
294;13.03.2018;2018;03;13;Tiistai;1;3;4;18;11;29
294;13.03.2018;2018;03;14;Tiistai;1;3;4;21;14;35
294;13.03.2018;2018;03;15;Tiistai;2;11;13;15;14;29
294;13.03.2018;2018;03;16;Tiistai;5;9;14;10;17;27
294;13.03.2018;2018;03;17;Tiistai;1;2;3;7;16;23
294;13.03.2018;2018;03;18;Tiistai;1;2;3;8;5;13
294;13.03.2018;2018;03;19;Tiistai;0;0;0;11;9;20
294;13.03.2018;2018;03;20;Tiistai;2;0;2;8;8;16
294;13.03.2018;2018;03;21;Tiistai;0;0;0;4;0;4
294;13.03.2018;2018;03;22;Tiistai;0;0;0;2;0;2
294;13.03.2018;2018;03;23;Tiistai;0;0;0;0;0;0
294;14.03.2018;2018;03;00;Keskiviikko;0;0;0;0;0;0
294;14.03.2018;2018;03;01;Keskiviikko;0;0;0;0;0;0
294;14.03.2018;2018;03;02;Keskiviikko;0;0;0;0;0;0
294;14.03.2018;2018;03;03;Keskiviikko;0;0;0;0;0;0
294;14.03.2018;2018;03;04;Keskiviikko;1;1;2;5;5;10
294;14.03.2018;2018;03;05;Keskiviikko;0;0;0;2;1;3
294;14.03.2018;2018;03;06;Keskiviikko;0;0;0;3;1;4
294;14.03.2018;2018;03;07;Keskiviikko;3;1;4;8;6;14
294;14.03.2018;2018;03;08;Keskiviikko;7;1;8;11;6;17
294;14.03.2018;2018;03;09;Keskiviikko;1;2;3;18;11;29
294;14.03.2018;2018;03;10;Keskiviikko;0;0;0;14;13;27
294;14.03.2018;2018;03;11;Keskiviikko;6;5;11;20;10;30
294;14.03.2018;2018;03;12;Keskiviikko;3;2;5;14;15;29
294;14.03.2018;2018;03;13;Keskiviikko;1;2;3;12;10;22
294;14.03.2018;2018;03;14;Keskiviikko;1;7;8;12;24;36
294;14.03.2018;2018;03;15;Keskiviikko;2;6;8;19;14;33
294;14.03.2018;2018;03;16;Keskiviikko;2;3;5;14;20;34
294;14.03.2018;2018;03;17;Keskiviikko;2;0;2;24;12;36
294;14.03.2018;2018;03;18;Keskiviikko;2;5;7;12;13;25
294;14.03.2018;2018;03;19;Keskiviikko;1;2;3;15;19;34
294;14.03.2018;2018;03;20;Keskiviikko;0;0;0;10;5;15
294;14.03.2018;2018;03;21;Keskiviikko;1;0;1;1;0;1
294;14.03.2018;2018;03;22;Keskiviikko;0;0;0;0;0;0
294;14.03.2018;2018;03;23;Keskiviikko;0;0;0;0;0;0
294;15.03.2018;2018;03;00;Torstai;0;0;0;0;0;0
294;15.03.2018;2018;03;01;Torstai;0;0;0;0;0;0
294;15.03.2018;2018;03;02;Torstai;0;0;0;0;0;0
294;15.03.2018;2018;03;03;Torstai;0;0;0;0;0;0
294;15.03.2018;2018;03;04;Torstai;0;0;0;0;0;0
294;15.03.2018;2018;03;05;Torstai;0;0;0;2;1;3
294;15.03.2018;2018;03;06;Torstai;0;1;1;1;2;3
294;15.03.2018;2018;03;07;Torstai;1;0;1;10;3;13
294;15.03.2018;2018;03;08;Torstai;4;0;4;13;2;15
294;15.03.2018;2018;03;09;Torstai;2;2;4;11;13;24
294;15.03.2018;2018;03;10;Torstai;2;1;3;10;5;15
294;15.03.2018;2018;03;11;Torstai;2;1;3;35;32;67
294;15.03.2018;2018;03;12;Torstai;2;0;2;26;18;44
294;15.03.2018;2018;03;13;Torstai;1;5;6;18;21;39
294;15.03.2018;2018;03;14;Torstai;0;1;1;23;26;49
294;15.03.2018;2018;03;15;Torstai;3;4;7;26;27;53
294;15.03.2018;2018;03;16;Torstai;5;5;10;19;17;36
294;15.03.2018;2018;03;17;Torstai;3;3;6;21;20;41
294;15.03.2018;2018;03;18;Torstai;1;3;4;10;15;25
294;15.03.2018;2018;03;19;Torstai;0;3;3;13;9;22
294;15.03.2018;2018;03;20;Torstai;0;1;1;6;7;13
294;15.03.2018;2018;03;21;Torstai;0;0;0;1;1;2
294;15.03.2018;2018;03;22;Torstai;0;0;0;1;0;1
294;15.03.2018;2018;03;23;Torstai;0;0;0;0;2;2
294;16.03.2018;2018;03;00;Perjantai;0;0;0;0;0;0
294;16.03.2018;2018;03;01;Perjantai;0;0;0;0;0;0
294;16.03.2018;2018;03;02;Perjantai;0;0;0;0;0;0
294;16.03.2018;2018;03;03;Perjantai;0;0;0;0;0;0
294;16.03.2018;2018;03;04;Perjantai;0;0;0;0;0;0
294;16.03.2018;2018;03;05;Perjantai;0;0;0;2;1;3
294;16.03.2018;2018;03;06;Perjantai;0;0;0;1;3;4
294;16.03.2018;2018;03;07;Perjantai;8;4;12;10;2;12
294;16.03.2018;2018;03;08;Perjantai;4;3;7;10;9;19
294;16.03.2018;2018;03;09;Perjantai;6;2;8;19;10;29
294;16.03.2018;2018;03;10;Perjantai;0;6;6;7;19;26
294;16.03.2018;2018;03;11;Perjantai;1;2;3;36;29;65
294;16.03.2018;2018;03;12;Perjantai;7;6;13;43;17;60
294;16.03.2018;2018;03;13;Perjantai;8;9;17;18;32;50
294;16.03.2018;2018;03;14;Perjantai;5;17;22;27;30;57
294;16.03.2018;2018;03;15;Perjantai;3;3;6;26;16;42
294;16.03.2018;2018;03;16;Perjantai;9;7;16;13;28;41
294;16.03.2018;2018;03;17;Perjantai;7;6;13;21;22;43
294;16.03.2018;2018;03;18;Perjantai;6;5;11;15;10;25
294;16.03.2018;2018;03;19;Perjantai;2;3;5;8;12;20
294;16.03.2018;2018;03;20;Perjantai;2;6;8;14;8;22
294;16.03.2018;2018;03;21;Perjantai;1;3;4;9;7;16
294;16.03.2018;2018;03;22;Perjantai;2;0;2;4;2;6
294;16.03.2018;2018;03;23;Perjantai;0;0;0;0;0;0
294;17.03.2018;2018;03;00;Lauantai;0;0;0;0;0;0
294;17.03.2018;2018;03;01;Lauantai;0;0;0;1;0;1
294;17.03.2018;2018;03;02;Lauantai;0;0;0;0;0;0
294;17.03.2018;2018;03;03;Lauantai;0;0;0;0;0;0
294;17.03.2018;2018;03;04;Lauantai;0;0;0;0;0;0
294;17.03.2018;2018;03;05;Lauantai;0;0;0;0;0;0
294;17.03.2018;2018;03;06;Lauantai;1;0;1;2;1;3
294;17.03.2018;2018;03;07;Lauantai;0;0;0;0;1;1
294;17.03.2018;2018;03;08;Lauantai;0;1;1;3;3;6
294;17.03.2018;2018;03;09;Lauantai;0;0;0;5;5;10
294;17.03.2018;2018;03;10;Lauantai;2;2;4;11;19;30
294;17.03.2018;2018;03;11;Lauantai;3;3;6;15;18;33
294;17.03.2018;2018;03;12;Lauantai;0;0;0;14;10;24
294;17.03.2018;2018;03;13;Lauantai;1;3;4;23;14;37
294;17.03.2018;2018;03;14;Lauantai;3;1;4;13;14;27
294;17.03.2018;2018;03;15;Lauantai;3;2;5;17;14;31
294;17.03.2018;2018;03;16;Lauantai;3;3;6;12;5;17
294;17.03.2018;2018;03;17;Lauantai;2;8;10;5;12;17
294;17.03.2018;2018;03;18;Lauantai;3;4;7;14;7;21
294;17.03.2018;2018;03;19;Lauantai;4;5;9;11;9;20
294;17.03.2018;2018;03;20;Lauantai;7;1;8;8;4;12
294;17.03.2018;2018;03;21;Lauantai;0;0;0;4;1;5
294;17.03.2018;2018;03;22;Lauantai;2;0;2;1;0;1
294;17.03.2018;2018;03;23;Lauantai;0;0;0;1;0;1
294;18.03.2018;2018;03;00;Sunnuntai;0;0;0;0;1;1
294;18.03.2018;2018;03;01;Sunnuntai;0;0;0;0;0;0
294;18.03.2018;2018;03;02;Sunnuntai;0;0;0;0;0;0
294;18.03.2018;2018;03;03;Sunnuntai;0;0;0;0;1;1
294;18.03.2018;2018;03;04;Sunnuntai;0;0;0;0;0;0
294;18.03.2018;2018;03;05;Sunnuntai;0;0;0;0;0;0
294;18.03.2018;2018;03;06;Sunnuntai;0;0;0;2;3;5
294;18.03.2018;2018;03;07;Sunnuntai;0;0;0;1;1;2
294;18.03.2018;2018;03;08;Sunnuntai;0;0;0;3;4;7
294;18.03.2018;2018;03;09;Sunnuntai;2;1;3;11;6;17
294;18.03.2018;2018;03;10;Sunnuntai;2;1;3;15;13;28
294;18.03.2018;2018;03;11;Sunnuntai;0;1;1;18;10;28
294;18.03.2018;2018;03;12;Sunnuntai;3;0;3;9;11;20
294;18.03.2018;2018;03;13;Sunnuntai;0;0;0;11;7;18
294;18.03.2018;2018;03;14;Sunnuntai;4;5;9;13;5;18
294;18.03.2018;2018;03;15;Sunnuntai;0;0;0;7;10;17
294;18.03.2018;2018;03;16;Sunnuntai;3;3;6;8;7;15
294;18.03.2018;2018;03;17;Sunnuntai;0;0;0;6;5;11
294;18.03.2018;2018;03;18;Sunnuntai;1;0;1;7;7;14
294;18.03.2018;2018;03;19;Sunnuntai;0;1;1;7;5;12
294;18.03.2018;2018;03;20;Sunnuntai;0;0;0;6;9;15
294;18.03.2018;2018;03;21;Sunnuntai;1;0;1;0;3;3
294;18.03.2018;2018;03;22;Sunnuntai;0;0;0;0;0;0
294;18.03.2018;2018;03;23;Sunnuntai;0;0;0;0;0;0
294;19.03.2018;2018;03;00;Maanantai;0;0;0;0;0;0
294;19.03.2018;2018;03;01;Maanantai;0;0;0;0;0;0
294;19.03.2018;2018;03;02;Maanantai;0;0;0;0;0;0
294;19.03.2018;2018;03;03;Maanantai;0;0;0;0;0;0
294;19.03.2018;2018;03;04;Maanantai;0;0;0;0;0;0
294;19.03.2018;2018;03;05;Maanantai;0;0;0;2;1;3
294;19.03.2018;2018;03;06;Maanantai;0;0;0;1;2;3
294;19.03.2018;2018;03;07;Maanantai;5;6;11;10;9;19
294;19.03.2018;2018;03;08;Maanantai;15;2;17;17;4;21
294;19.03.2018;2018;03;09;Maanantai;3;2;5;13;6;19
294;19.03.2018;2018;03;10;Maanantai;1;2;3;20;11;31
294;19.03.2018;2018;03;11;Maanantai;0;9;9;26;26;52
294;19.03.2018;2018;03;12;Maanantai;2;6;8;19;22;41
294;19.03.2018;2018;03;13;Maanantai;2;12;14;17;12;29
294;19.03.2018;2018;03;14;Maanantai;2;8;10;30;21;51
294;19.03.2018;2018;03;15;Maanantai;0;8;8;24;27;51
294;19.03.2018;2018;03;16;Maanantai;3;6;9;21;12;33
294;19.03.2018;2018;03;17;Maanantai;4;2;6;20;12;32
294;19.03.2018;2018;03;18;Maanantai;3;3;6;12;22;34
294;19.03.2018;2018;03;19;Maanantai;1;8;9;20;16;36
294;19.03.2018;2018;03;20;Maanantai;2;1;3;5;6;11
294;19.03.2018;2018;03;21;Maanantai;0;1;1;4;1;5
294;19.03.2018;2018;03;22;Maanantai;0;0;0;0;1;1
294;19.03.2018;2018;03;23;Maanantai;0;0;0;0;1;1
294;20.03.2018;2018;03;00;Tiistai;0;0;0;0;0;0
294;20.03.2018;2018;03;01;Tiistai;0;0;0;0;0;0
294;20.03.2018;2018;03;02;Tiistai;0;0;0;0;0;0
294;20.03.2018;2018;03;03;Tiistai;0;0;0;0;0;0
294;20.03.2018;2018;03;04;Tiistai;0;0;0;0;0;0
294;20.03.2018;2018;03;05;Tiistai;1;0;1;2;1;3
294;20.03.2018;2018;03;06;Tiistai;1;0;1;3;1;4
294;20.03.2018;2018;03;07;Tiistai;0;3;3;5;7;12
294;20.03.2018;2018;03;08;Tiistai;7;0;7;19;4;23
294;20.03.2018;2018;03;09;Tiistai;5;2;7;14;7;21
294;20.03.2018;2018;03;10;Tiistai;1;5;6;13;16;29
294;20.03.2018;2018;03;11;Tiistai;2;2;4;18;12;30
294;20.03.2018;2018;03;12;Tiistai;1;6;7;26;29;55
294;20.03.2018;2018;03;13;Tiistai;1;3;4;19;18;37
294;20.03.2018;2018;03;14;Tiistai;2;4;6;32;25;57
294;20.03.2018;2018;03;15;Tiistai;3;7;10;16;30;46
294;20.03.2018;2018;03;16;Tiistai;1;3;4;12;15;27
294;20.03.2018;2018;03;17;Tiistai;2;1;3;6;12;18
294;20.03.2018;2018;03;18;Tiistai;3;1;4;10;10;20
294;20.03.2018;2018;03;19;Tiistai;0;0;0;9;4;13
294;20.03.2018;2018;03;20;Tiistai;3;0;3;4;5;9
294;20.03.2018;2018;03;21;Tiistai;0;0;0;4;1;5
294;20.03.2018;2018;03;22;Tiistai;0;1;1;2;0;2
294;20.03.2018;2018;03;23;Tiistai;0;0;0;2;2;4
294;21.03.2018;2018;03;00;Keskiviikko;0;0;0;0;0;0
294;21.03.2018;2018;03;01;Keskiviikko;0;0;0;0;0;0
294;21.03.2018;2018;03;02;Keskiviikko;0;0;0;0;0;0
294;21.03.2018;2018;03;03;Keskiviikko;0;0;0;0;0;0
294;21.03.2018;2018;03;04;Keskiviikko;0;0;0;0;0;0
294;21.03.2018;2018;03;05;Keskiviikko;0;0;0;2;1;3
294;21.03.2018;2018;03;06;Keskiviikko;0;0;0;2;3;5
294;21.03.2018;2018;03;07;Keskiviikko;1;3;4;6;7;13
294;21.03.2018;2018;03;08;Keskiviikko;10;2;12;9;4;13
294;21.03.2018;2018;03;09;Keskiviikko;2;4;6;15;9;24
294;21.03.2018;2018;03;10;Keskiviikko;2;4;6;22;3;25
294;21.03.2018;2018;03;11;Keskiviikko;2;0;2;12;1;13
294;21.03.2018;2018;03;12;Keskiviikko;1;0;1;13;12;25
294;21.03.2018;2018;03;13;Keskiviikko;3;5;8;7;14;21
294;21.03.2018;2018;03;14;Keskiviikko;3;14;17;19;19;38
294;21.03.2018;2018;03;15;Keskiviikko;9;3;12;14;13;27
294;21.03.2018;2018;03;16;Keskiviikko;0;4;4;11;13;24
294;21.03.2018;2018;03;17;Keskiviikko;3;2;5;16;19;35
294;21.03.2018;2018;03;18;Keskiviikko;0;3;3;17;9;26
294;21.03.2018;2018;03;19;Keskiviikko;2;3;5;14;8;22
294;21.03.2018;2018;03;20;Keskiviikko;2;3;5;1;9;10
294;21.03.2018;2018;03;21;Keskiviikko;1;0;1;1;1;2
294;21.03.2018;2018;03;22;Keskiviikko;0;0;0;0;0;0
294;21.03.2018;2018;03;23;Keskiviikko;2;2;4;3;0;3
294;22.03.2018;2018;03;00;Torstai;0;0;0;0;0;0
294;22.03.2018;2018;03;01;Torstai;0;0;0;0;0;0
294;22.03.2018;2018;03;02;Torstai;0;0;0;0;0;0
294;22.03.2018;2018;03;03;Torstai;0;0;0;0;0;0
294;22.03.2018;2018;03;04;Torstai;0;0;0;0;0;0
294;22.03.2018;2018;03;05;Torstai;0;0;0;2;1;3
294;22.03.2018;2018;03;06;Torstai;1;2;3;3;2;5
294;22.03.2018;2018;03;07;Torstai;4;2;6;7;5;12
294;22.03.2018;2018;03;08;Torstai;9;1;10;14;4;18
294;22.03.2018;2018;03;09;Torstai;3;1;4;14;3;17
294;22.03.2018;2018;03;10;Torstai;4;2;6;6;14;20
294;22.03.2018;2018;03;11;Torstai;1;3;4;34;27;61
294;22.03.2018;2018;03;12;Torstai;1;0;1;21;15;36
294;22.03.2018;2018;03;13;Torstai;7;6;13;15;19;34
294;22.03.2018;2018;03;14;Torstai;2;10;12;18;11;29
294;22.03.2018;2018;03;15;Torstai;5;9;14;8;24;32
294;22.03.2018;2018;03;16;Torstai;2;3;5;18;22;40
294;22.03.2018;2018;03;17;Torstai;2;0;2;15;16;31
294;22.03.2018;2018;03;18;Torstai;1;2;3;12;15;27
294;22.03.2018;2018;03;19;Torstai;2;3;5;14;13;27
294;22.03.2018;2018;03;20;Torstai;2;2;4;3;6;9
294;22.03.2018;2018;03;21;Torstai;0;0;0;0;1;1
294;22.03.2018;2018;03;22;Torstai;1;0;1;0;1;1
294;22.03.2018;2018;03;23;Torstai;0;0;0;0;0;0
294;23.03.2018;2018;03;00;Perjantai;0;0;0;0;0;0
294;23.03.2018;2018;03;01;Perjantai;0;0;0;0;0;0
294;23.03.2018;2018;03;02;Perjantai;0;0;0;0;0;0
294;23.03.2018;2018;03;03;Perjantai;0;0;0;0;0;0
294;23.03.2018;2018;03;04;Perjantai;0;0;0;0;0;0
294;23.03.2018;2018;03;05;Perjantai;0;0;0;2;2;4
294;23.03.2018;2018;03;06;Perjantai;0;1;1;2;0;2
294;23.03.2018;2018;03;07;Perjantai;6;2;8;13;7;20
294;23.03.2018;2018;03;08;Perjantai;3;3;6;8;3;11
294;23.03.2018;2018;03;09;Perjantai;2;0;2;10;6;16
294;23.03.2018;2018;03;10;Perjantai;0;6;6;8;21;29
294;23.03.2018;2018;03;11;Perjantai;2;0;2;30;28;58
294;23.03.2018;2018;03;12;Perjantai;3;2;5;24;32;56
294;23.03.2018;2018;03;13;Perjantai;7;6;13;30;24;54
294;23.03.2018;2018;03;14;Perjantai;7;9;16;26;24;50
294;23.03.2018;2018;03;15;Perjantai;2;2;4;16;18;34
294;23.03.2018;2018;03;16;Perjantai;4;7;11;21;14;35
294;23.03.2018;2018;03;17;Perjantai;2;9;11;19;19;38
294;23.03.2018;2018;03;18;Perjantai;5;2;7;9;9;18
294;23.03.2018;2018;03;19;Perjantai;3;2;5;10;9;19
294;23.03.2018;2018;03;20;Perjantai;9;2;11;5;7;12
294;23.03.2018;2018;03;21;Perjantai;2;4;6;1;3;4
294;23.03.2018;2018;03;22;Perjantai;0;1;1;0;0;0
294;23.03.2018;2018;03;23;Perjantai;2;0;2;1;0;1
294;24.03.2018;2018;03;00;Lauantai;0;0;0;1;0;1
294;24.03.2018;2018;03;01;Lauantai;0;0;0;0;0;0
294;24.03.2018;2018;03;02;Lauantai;0;0;0;0;0;0
294;24.03.2018;2018;03;03;Lauantai;0;1;1;0;1;1
294;24.03.2018;2018;03;04;Lauantai;0;0;0;0;0;0
294;24.03.2018;2018;03;05;Lauantai;0;0;0;1;0;1
294;24.03.2018;2018;03;06;Lauantai;0;0;0;3;0;3
294;24.03.2018;2018;03;07;Lauantai;0;0;0;1;3;4
294;24.03.2018;2018;03;08;Lauantai;1;2;3;1;6;7
294;24.03.2018;2018;03;09;Lauantai;1;0;1;10;11;21
294;24.03.2018;2018;03;10;Lauantai;0;1;1;14;14;28
294;24.03.2018;2018;03;11;Lauantai;2;1;3;15;8;23
294;24.03.2018;2018;03;12;Lauantai;3;2;5;7;19;26
294;24.03.2018;2018;03;13;Lauantai;1;3;4;13;8;21
294;24.03.2018;2018;03;14;Lauantai;4;0;4;4;4;8
294;24.03.2018;2018;03;15;Lauantai;1;2;3;8;5;13
294;24.03.2018;2018;03;16;Lauantai;0;0;0;12;8;20
294;24.03.2018;2018;03;17;Lauantai;4;0;4;17;12;29
294;24.03.2018;2018;03;18;Lauantai;1;1;2;8;6;14
294;24.03.2018;2018;03;19;Lauantai;1;4;5;4;10;14
294;24.03.2018;2018;03;20;Lauantai;1;1;2;3;4;7
294;24.03.2018;2018;03;21;Lauantai;1;0;1;4;1;5
294;24.03.2018;2018;03;22;Lauantai;0;0;0;0;0;0
294;24.03.2018;2018;03;23;Lauantai;0;0;0;3;0;3
294;25.03.2018;2018;03;00;Sunnuntai;0;0;0;0;1;1
294;25.03.2018;2018;03;01;Sunnuntai;0;0;0;1;0;1
294;25.03.2018;2018;03;02;Sunnuntai;1;0;1;0;1;1
294;25.03.2018;2018;03;03;Sunnuntai;0;0;0;0;0;0
294;25.03.2018;2018;03;04;Sunnuntai;0;0;0;0;0;0
294;25.03.2018;2018;03;05;Sunnuntai;0;0;0;0;0;0
294;25.03.2018;2018;03;06;Sunnuntai;0;0;0;3;2;5
294;25.03.2018;2018;03;07;Sunnuntai;0;0;0;0;3;3
294;25.03.2018;2018;03;08;Sunnuntai;0;0;0;2;0;2
294;25.03.2018;2018;03;09;Sunnuntai;1;0;1;4;5;9
294;25.03.2018;2018;03;10;Sunnuntai;1;6;7;11;10;21
294;25.03.2018;2018;03;11;Sunnuntai;1;4;5;14;4;18
294;25.03.2018;2018;03;12;Sunnuntai;0;1;1;7;5;12
294;25.03.2018;2018;03;13;Sunnuntai;1;1;2;8;7;15
294;25.03.2018;2018;03;14;Sunnuntai;2;1;3;11;10;21
294;25.03.2018;2018;03;15;Sunnuntai;3;3;6;4;13;17
294;25.03.2018;2018;03;16;Sunnuntai;2;3;5;19;21;40
294;25.03.2018;2018;03;17;Sunnuntai;2;0;2;9;9;18
294;25.03.2018;2018;03;18;Sunnuntai;2;1;3;6;10;16
294;25.03.2018;2018;03;19;Sunnuntai;4;2;6;11;5;16
294;25.03.2018;2018;03;20;Sunnuntai;4;3;7;3;3;6
294;25.03.2018;2018;03;21;Sunnuntai;2;1;3;4;2;6
294;25.03.2018;2018;03;22;Sunnuntai;0;0;0;1;0;1
294;25.03.2018;2018;03;23;Sunnuntai;0;0;0;1;0;1
294;26.03.2018;2018;03;00;Maanantai;0;0;0;0;0;0
294;26.03.2018;2018;03;01;Maanantai;0;0;0;0;0;0
294;26.03.2018;2018;03;02;Maanantai;0;0;0;0;0;0
294;26.03.2018;2018;03;03;Maanantai;0;0;0;0;0;0
294;26.03.2018;2018;03;04;Maanantai;0;0;0;0;0;0
294;26.03.2018;2018;03;05;Maanantai;0;0;0;2;1;3
294;26.03.2018;2018;03;06;Maanantai;0;0;0;2;1;3
294;26.03.2018;2018;03;07;Maanantai;1;2;3;5;10;15
294;26.03.2018;2018;03;08;Maanantai;8;0;8;14;7;21
294;26.03.2018;2018;03;09;Maanantai;6;3;9;7;6;13
294;26.03.2018;2018;03;10;Maanantai;1;0;1;7;16;23
294;26.03.2018;2018;03;11;Maanantai;2;13;15;19;26;45
294;26.03.2018;2018;03;12;Maanantai;6;5;11;34;32;66
294;26.03.2018;2018;03;13;Maanantai;3;3;6;28;22;50
294;26.03.2018;2018;03;14;Maanantai;3;10;13;19;21;40
294;26.03.2018;2018;03;15;Maanantai;2;0;2;22;22;44
294;26.03.2018;2018;03;16;Maanantai;4;10;14;22;9;31
294;26.03.2018;2018;03;17;Maanantai;3;2;5;11;18;29
294;26.03.2018;2018;03;18;Maanantai;1;3;4;23;18;41
294;26.03.2018;2018;03;19;Maanantai;3;4;7;13;16;29
294;26.03.2018;2018;03;20;Maanantai;0;0;0;5;1;6
294;26.03.2018;2018;03;21;Maanantai;1;0;1;4;3;7
294;26.03.2018;2018;03;22;Maanantai;0;0;0;1;0;1
294;26.03.2018;2018;03;23;Maanantai;0;0;0;0;0;0
294;27.03.2018;2018;03;00;Tiistai;0;0;0;0;0;0
294;27.03.2018;2018;03;01;Tiistai;0;0;0;0;0;0
294;27.03.2018;2018;03;02;Tiistai;0;0;0;0;0;0
294;27.03.2018;2018;03;03;Tiistai;0;0;0;0;0;0
294;27.03.2018;2018;03;04;Tiistai;0;0;0;0;0;0
294;27.03.2018;2018;03;05;Tiistai;0;0;0;2;1;3
294;27.03.2018;2018;03;06;Tiistai;0;0;0;2;0;2
294;27.03.2018;2018;03;07;Tiistai;4;6;10;13;3;16
294;27.03.2018;2018;03;08;Tiistai;3;1;4;10;5;15
294;27.03.2018;2018;03;09;Tiistai;12;1;13;13;5;18
294;27.03.2018;2018;03;10;Tiistai;2;4;6;16;19;35
294;27.03.2018;2018;03;11;Tiistai;0;1;1;9;16;25
294;27.03.2018;2018;03;12;Tiistai;1;3;4;13;16;29
294;27.03.2018;2018;03;13;Tiistai;2;7;9;18;18;36
294;27.03.2018;2018;03;14;Tiistai;3;7;10;9;17;26
294;27.03.2018;2018;03;15;Tiistai;5;12;17;16;24;40
294;27.03.2018;2018;03;16;Tiistai;3;2;5;13;10;23
294;27.03.2018;2018;03;17;Tiistai;0;3;3;9;14;23
294;27.03.2018;2018;03;18;Tiistai;2;3;5;11;11;22
294;27.03.2018;2018;03;19;Tiistai;2;1;3;9;6;15
294;27.03.2018;2018;03;20;Tiistai;5;1;6;5;3;8
294;27.03.2018;2018;03;21;Tiistai;0;1;1;2;0;2
294;27.03.2018;2018;03;22;Tiistai;0;0;0;0;1;1
294;27.03.2018;2018;03;23;Tiistai;0;0;0;1;0;1
294;28.03.2018;2018;03;00;Keskiviikko;0;0;0;0;0;0
294;28.03.2018;2018;03;01;Keskiviikko;0;0;0;0;0;0
294;28.03.2018;2018;03;02;Keskiviikko;0;0;0;0;0;0
294;28.03.2018;2018;03;03;Keskiviikko;0;0;0;0;0;0
294;28.03.2018;2018;03;04;Keskiviikko;0;0;0;0;0;0
294;28.03.2018;2018;03;05;Keskiviikko;0;0;0;2;1;3
294;28.03.2018;2018;03;06;Keskiviikko;1;0;1;3;4;7
294;28.03.2018;2018;03;07;Keskiviikko;0;4;4;5;3;8
294;28.03.2018;2018;03;08;Keskiviikko;6;0;6;10;7;17
294;28.03.2018;2018;03;09;Keskiviikko;1;4;5;14;8;22
294;28.03.2018;2018;03;10;Keskiviikko;5;2;7;12;12;24
294;28.03.2018;2018;03;11;Keskiviikko;4;0;4;9;13;22
294;28.03.2018;2018;03;12;Keskiviikko;14;20;34;28;26;54
294;28.03.2018;2018;03;13;Keskiviikko;13;10;23;30;34;64
294;28.03.2018;2018;03;14;Keskiviikko;5;4;9;15;19;34
294;28.03.2018;2018;03;15;Keskiviikko;0;3;3;14;17;31
294;28.03.2018;2018;03;16;Keskiviikko;3;2;5;21;19;40
294;28.03.2018;2018;03;17;Keskiviikko;7;3;10;9;13;22
294;28.03.2018;2018;03;18;Keskiviikko;3;6;9;17;16;33
294;28.03.2018;2018;03;19;Keskiviikko;2;8;10;11;13;24
294;28.03.2018;2018;03;20;Keskiviikko;2;3;5;9;8;17
294;28.03.2018;2018;03;21;Keskiviikko;0;0;0;0;1;1
294;28.03.2018;2018;03;22;Keskiviikko;0;0;0;0;0;0
294;28.03.2018;2018;03;23;Keskiviikko;0;0;0;1;0;1
294;29.03.2018;2018;03;00;Torstai;0;0;0;0;0;0
294;29.03.2018;2018;03;01;Torstai;0;0;0;0;0;0
294;29.03.2018;2018;03;02;Torstai;0;0;0;0;0;0
294;29.03.2018;2018;03;03;Torstai;0;0;0;0;0;0
294;29.03.2018;2018;03;04;Torstai;0;0;0;0;0;0
294;29.03.2018;2018;03;05;Torstai;0;0;0;2;1;3
294;29.03.2018;2018;03;06;Torstai;0;0;0;3;2;5
294;29.03.2018;2018;03;07;Torstai;1;0;1;10;9;19
294;29.03.2018;2018;03;08;Torstai;6;1;7;12;6;18
294;29.03.2018;2018;03;09;Torstai;4;6;10;15;14;29
294;29.03.2018;2018;03;10;Torstai;2;2;4;21;16;37
294;29.03.2018;2018;03;11;Torstai;1;6;7;15;10;25
294;29.03.2018;2018;03;12;Torstai;1;5;6;14;19;33
294;29.03.2018;2018;03;13;Torstai;2;4;6;14;18;32
294;29.03.2018;2018;03;14;Torstai;8;5;13;21;16;37
294;29.03.2018;2018;03;15;Torstai;3;3;6;15;23;38
294;29.03.2018;2018;03;16;Torstai;1;4;5;18;9;27
294;29.03.2018;2018;03;17;Torstai;0;1;1;6;8;14
294;29.03.2018;2018;03;18;Torstai;4;1;5;10;8;18
294;29.03.2018;2018;03;19;Torstai;0;4;4;6;13;19
294;29.03.2018;2018;03;20;Torstai;7;2;9;8;7;15
294;29.03.2018;2018;03;21;Torstai;2;2;4;6;2;8
294;29.03.2018;2018;03;22;Torstai;3;0;3;3;0;3
294;29.03.2018;2018;03;23;Torstai;0;2;2;0;1;1
294;30.03.2018;2018;03;00;Perjantai;2;5;7;2;0;2
294;30.03.2018;2018;03;01;Perjantai;0;0;0;0;0;0
294;30.03.2018;2018;03;02;Perjantai;0;0;0;0;0;0
294;30.03.2018;2018;03;03;Perjantai;0;0;0;0;0;0
294;30.03.2018;2018;03;04;Perjantai;0;0;0;0;0;0
294;30.03.2018;2018;03;05;Perjantai;0;0;0;2;0;2
294;30.03.2018;2018;03;06;Perjantai;1;0;1;0;4;4
294;30.03.2018;2018;03;07;Perjantai;0;0;0;3;0;3
294;30.03.2018;2018;03;08;Perjantai;0;1;1;3;4;7
294;30.03.2018;2018;03;09;Perjantai;0;0;0;5;5;10
294;30.03.2018;2018;03;10;Perjantai;2;3;5;7;11;18
294;30.03.2018;2018;03;11;Perjantai;0;2;2;19;19;38
294;30.03.2018;2018;03;12;Perjantai;1;6;7;17;10;27
294;30.03.2018;2018;03;13;Perjantai;4;0;4;16;13;29
294;30.03.2018;2018;03;14;Perjantai;2;2;4;10;18;28
294;30.03.2018;2018;03;15;Perjantai;2;4;6;7;11;18
294;30.03.2018;2018;03;16;Perjantai;2;2;4;13;12;25
294;30.03.2018;2018;03;17;Perjantai;1;1;2;15;13;28
294;30.03.2018;2018;03;18;Perjantai;2;3;5;8;2;10
294;30.03.2018;2018;03;19;Perjantai;0;0;0;9;3;12
294;30.03.2018;2018;03;20;Perjantai;0;1;1;4;1;5
294;30.03.2018;2018;03;21;Perjantai;4;4;8;1;2;3
294;30.03.2018;2018;03;22;Perjantai;1;0;1;1;0;1
294;30.03.2018;2018;03;23;Perjantai;0;0;0;2;0;2
294;31.03.2018;2018;03;00;Lauantai;0;0;0;0;0;0
294;31.03.2018;2018;03;01;Lauantai;0;0;0;0;0;0
294;31.03.2018;2018;03;02;Lauantai;0;0;0;0;0;0
294;31.03.2018;2018;03;03;Lauantai;0;0;0;0;0;0
294;31.03.2018;2018;03;04;Lauantai;0;0;0;0;0;0
294;31.03.2018;2018;03;05;Lauantai;0;0;0;0;1;1
294;31.03.2018;2018;03;06;Lauantai;1;0;1;2;0;2
294;31.03.2018;2018;03;07;Lauantai;0;0;0;1;3;4
294;31.03.2018;2018;03;08;Lauantai;0;0;0;0;3;3
294;31.03.2018;2018;03;09;Lauantai;0;1;1;4;7;11
294;31.03.2018;2018;03;10;Lauantai;1;1;2;8;14;22
294;31.03.2018;2018;03;11;Lauantai;1;1;2;13;11;24
294;31.03.2018;2018;03;12;Lauantai;1;4;5;20;14;34
294;31.03.2018;2018;03;13;Lauantai;1;1;2;23;10;33
294;31.03.2018;2018;03;14;Lauantai;0;4;4;12;7;19
294;31.03.2018;2018;03;15;Lauantai;1;1;2;14;9;23
294;31.03.2018;2018;03;16;Lauantai;0;3;3;10;9;19
294;31.03.2018;2018;03;17;Lauantai;2;4;6;11;11;22
294;31.03.2018;2018;03;18;Lauantai;7;6;13;9;5;14
294;31.03.2018;2018;03;19;Lauantai;0;2;2;4;4;8
294;31.03.2018;2018;03;20;Lauantai;3;0;3;6;4;10
294;31.03.2018;2018;03;21;Lauantai;0;2;2;1;0;1
294;31.03.2018;2018;03;22;Lauantai;1;0;1;1;0;1
294;31.03.2018;2018;03;23;Lauantai;0;0;0;2;0;2
294;01.04.2018;2018;04;00;Sunnuntai;0;0;0;0;0;0
294;01.04.2018;2018;04;01;Sunnuntai;1;0;1;0;0;0
294;01.04.2018;2018;04;02;Sunnuntai;0;0;0;0;0;0
294;01.04.2018;2018;04;03;Sunnuntai;0;0;0;0;0;0
294;01.04.2018;2018;04;04;Sunnuntai;0;0;0;0;0;0
294;01.04.2018;2018;04;05;Sunnuntai;0;0;0;0;0;0
294;01.04.2018;2018;04;06;Sunnuntai;0;0;0;3;3;6
294;01.04.2018;2018;04;07;Sunnuntai;0;0;0;5;2;7
294;01.04.2018;2018;04;08;Sunnuntai;0;0;0;2;4;6
294;01.04.2018;2018;04;09;Sunnuntai;0;1;1;3;3;6
294;01.04.2018;2018;04;10;Sunnuntai;1;2;3;16;8;24
294;01.04.2018;2018;04;11;Sunnuntai;2;2;4;12;16;28
294;01.04.2018;2018;04;12;Sunnuntai;2;1;3;20;9;29
294;01.04.2018;2018;04;13;Sunnuntai;6;2;8;11;8;19
294;01.04.2018;2018;04;14;Sunnuntai;2;5;7;6;9;15
294;01.04.2018;2018;04;15;Sunnuntai;3;1;4;15;10;25
294;01.04.2018;2018;04;16;Sunnuntai;0;1;1;5;5;10
294;01.04.2018;2018;04;17;Sunnuntai;1;2;3;10;15;25
294;01.04.2018;2018;04;18;Sunnuntai;2;0;2;13;5;18
294;01.04.2018;2018;04;19;Sunnuntai;0;0;0;6;7;13
294;01.04.2018;2018;04;20;Sunnuntai;2;4;6;7;7;14
294;01.04.2018;2018;04;21;Sunnuntai;2;1;3;4;1;5
294;01.04.2018;2018;04;22;Sunnuntai;0;2;2;2;1;3
294;01.04.2018;2018;04;23;Sunnuntai;0;0;0;1;0;1
294;02.04.2018;2018;04;00;Maanantai;0;0;0;0;0;0
294;02.04.2018;2018;04;01;Maanantai;0;0;0;0;0;0
294;02.04.2018;2018;04;02;Maanantai;0;0;0;0;0;0
294;02.04.2018;2018;04;03;Maanantai;0;0;0;0;1;1
294;02.04.2018;2018;04;04;Maanantai;0;0;0;0;0;0
294;02.04.2018;2018;04;05;Maanantai;0;0;0;0;0;0
294;02.04.2018;2018;04;06;Maanantai;0;0;0;0;2;2
294;02.04.2018;2018;04;07;Maanantai;0;0;0;6;1;7
294;02.04.2018;2018;04;08;Maanantai;1;0;1;1;3;4
294;02.04.2018;2018;04;09;Maanantai;3;0;3;6;7;13
294;02.04.2018;2018;04;10;Maanantai;4;1;5;9;5;14
294;02.04.2018;2018;04;11;Maanantai;2;3;5;16;20;36
294;02.04.2018;2018;04;12;Maanantai;3;2;5;9;8;17
294;02.04.2018;2018;04;13;Maanantai;2;3;5;15;8;23
294;02.04.2018;2018;04;14;Maanantai;1;0;1;17;10;27
294;02.04.2018;2018;04;15;Maanantai;2;4;6;8;6;14
294;02.04.2018;2018;04;16;Maanantai;4;1;5;21;5;26
294;02.04.2018;2018;04;17;Maanantai;3;5;8;8;15;23
294;02.04.2018;2018;04;18;Maanantai;4;1;5;7;5;12
294;02.04.2018;2018;04;19;Maanantai;2;0;2;9;10;19
294;02.04.2018;2018;04;20;Maanantai;2;0;2;3;2;5
294;02.04.2018;2018;04;21;Maanantai;0;1;1;2;1;3
294;02.04.2018;2018;04;22;Maanantai;0;0;0;1;0;1
294;02.04.2018;2018;04;23;Maanantai;0;0;0;0;0;0
294;03.04.2018;2018;04;00;Tiistai;0;0;0;0;0;0
294;03.04.2018;2018;04;01;Tiistai;0;0;0;0;0;0
294;03.04.2018;2018;04;02;Tiistai;0;0;0;0;0;0
294;03.04.2018;2018;04;03;Tiistai;0;0;0;0;0;0
294;03.04.2018;2018;04;04;Tiistai;3;2;5;4;3;7
294;03.04.2018;2018;04;05;Tiistai;0;0;0;0;3;3
294;03.04.2018;2018;04;06;Tiistai;0;0;0;1;3;4
294;03.04.2018;2018;04;07;Tiistai;4;5;9;10;3;13
294;03.04.2018;2018;04;08;Tiistai;7;1;8;13;4;17
294;03.04.2018;2018;04;09;Tiistai;5;1;6;15;4;19
294;03.04.2018;2018;04;10;Tiistai;0;1;1;12;9;21
294;03.04.2018;2018;04;11;Tiistai;8;2;10;11;12;23
294;03.04.2018;2018;04;12;Tiistai;1;6;7;21;20;41
294;03.04.2018;2018;04;13;Tiistai;1;8;9;12;17;29
294;03.04.2018;2018;04;14;Tiistai;3;2;5;14;14;28
294;03.04.2018;2018;04;15;Tiistai;0;3;3;14;11;25
294;03.04.2018;2018;04;16;Tiistai;2;10;12;12;14;26
294;03.04.2018;2018;04;17;Tiistai;0;0;0;13;17;30
294;03.04.2018;2018;04;18;Tiistai;3;0;3;9;9;18
294;03.04.2018;2018;04;19;Tiistai;0;1;1;4;11;15
294;03.04.2018;2018;04;20;Tiistai;0;1;1;7;7;14
294;03.04.2018;2018;04;21;Tiistai;0;1;1;3;1;4
294;03.04.2018;2018;04;22;Tiistai;0;0;0;0;0;0
294;03.04.2018;2018;04;23;Tiistai;0;0;0;0;0;0
294;04.04.2018;2018;04;00;Keskiviikko;0;0;0;0;0;0
294;04.04.2018;2018;04;01;Keskiviikko;0;0;0;1;0;1
294;04.04.2018;2018;04;02;Keskiviikko;0;0;0;0;0;0
294;04.04.2018;2018;04;03;Keskiviikko;0;0;0;0;0;0
294;04.04.2018;2018;04;04;Keskiviikko;0;0;0;0;0;0
294;04.04.2018;2018;04;05;Keskiviikko;0;0;0;0;1;1
294;04.04.2018;2018;04;06;Keskiviikko;0;0;0;3;2;5
294;04.04.2018;2018;04;07;Keskiviikko;1;3;4;5;8;13
294;04.04.2018;2018;04;08;Keskiviikko;1;3;4;18;5;23
294;04.04.2018;2018;04;09;Keskiviikko;1;3;4;18;10;28
294;04.04.2018;2018;04;10;Keskiviikko;1;3;4;6;18;24
294;04.04.2018;2018;04;11;Keskiviikko;1;1;2;32;22;54
294;04.04.2018;2018;04;12;Keskiviikko;3;3;6;31;23;54
294;04.04.2018;2018;04;13;Keskiviikko;0;8;8;22;22;44
294;04.04.2018;2018;04;14;Keskiviikko;3;5;8;18;21;39
294;04.04.2018;2018;04;15;Keskiviikko;3;6;9;25;16;41
294;04.04.2018;2018;04;16;Keskiviikko;0;6;6;20;18;38
294;04.04.2018;2018;04;17;Keskiviikko;1;1;2;14;10;24
294;04.04.2018;2018;04;18;Keskiviikko;2;2;4;10;10;20
294;04.04.2018;2018;04;19;Keskiviikko;0;2;2;15;15;30
294;04.04.2018;2018;04;20;Keskiviikko;1;0;1;6;7;13
294;04.04.2018;2018;04;21;Keskiviikko;0;0;0;4;1;5
294;04.04.2018;2018;04;22;Keskiviikko;0;0;0;0;0;0
294;04.04.2018;2018;04;23;Keskiviikko;0;0;0;0;0;0
294;05.04.2018;2018;04;00;Torstai;0;0;0;0;0;0
294;05.04.2018;2018;04;01;Torstai;0;0;0;0;0;0
294;05.04.2018;2018;04;02;Torstai;0;0;0;0;0;0
294;05.04.2018;2018;04;03;Torstai;0;0;0;0;0;0
294;05.04.2018;2018;04;04;Torstai;0;0;0;0;0;0
294;05.04.2018;2018;04;05;Torstai;6;1;7;4;1;5
294;05.04.2018;2018;04;06;Torstai;0;0;0;3;0;3
294;05.04.2018;2018;04;07;Torstai;1;1;2;5;2;7
294;05.04.2018;2018;04;08;Torstai;4;2;6;13;2;15
294;05.04.2018;2018;04;09;Torstai;4;0;4;13;6;19
294;05.04.2018;2018;04;10;Torstai;1;2;3;6;10;16
294;05.04.2018;2018;04;11;Torstai;4;2;6;15;19;34
294;05.04.2018;2018;04;12;Torstai;4;3;7;15;21;36
294;05.04.2018;2018;04;13;Torstai;1;4;5;16;14;30
294;05.04.2018;2018;04;14;Torstai;1;6;7;11;28;39
294;05.04.2018;2018;04;15;Torstai;4;4;8;15;16;31
294;05.04.2018;2018;04;16;Torstai;2;1;3;20;15;35
294;05.04.2018;2018;04;17;Torstai;1;2;3;13;8;21
294;05.04.2018;2018;04;18;Torstai;7;1;8;17;8;25
294;05.04.2018;2018;04;19;Torstai;2;1;3;11;13;24
294;05.04.2018;2018;04;20;Torstai;1;3;4;8;5;13
294;05.04.2018;2018;04;21;Torstai;0;0;0;2;0;2
294;05.04.2018;2018;04;22;Torstai;0;0;0;0;1;1
294;05.04.2018;2018;04;23;Torstai;0;0;0;0;0;0
294;06.04.2018;2018;04;00;Perjantai;0;0;0;0;0;0
294;06.04.2018;2018;04;01;Perjantai;0;0;0;0;0;0
294;06.04.2018;2018;04;02;Perjantai;0;0;0;0;0;0
294;06.04.2018;2018;04;03;Perjantai;0;0;0;0;0;0
294;06.04.2018;2018;04;04;Perjantai;0;0;0;0;0;0
294;06.04.2018;2018;04;05;Perjantai;0;0;0;0;0;0
294;06.04.2018;2018;04;06;Perjantai;0;0;0;3;1;4
294;06.04.2018;2018;04;07;Perjantai;8;3;11;9;7;16
294;06.04.2018;2018;04;08;Perjantai;7;1;8;13;9;22
294;06.04.2018;2018;04;09;Perjantai;1;1;2;10;8;18
294;06.04.2018;2018;04;10;Perjantai;0;2;2;6;9;15
294;06.04.2018;2018;04;11;Perjantai;1;1;2;13;13;26
294;06.04.2018;2018;04;12;Perjantai;1;3;4;15;21;36
294;06.04.2018;2018;04;13;Perjantai;4;8;12;15;22;37
294;06.04.2018;2018;04;14;Perjantai;2;4;6;9;20;29
294;06.04.2018;2018;04;15;Perjantai;6;1;7;16;10;26
294;06.04.2018;2018;04;16;Perjantai;0;4;4;9;16;25
294;06.04.2018;2018;04;17;Perjantai;1;3;4;7;9;16
294;06.04.2018;2018;04;18;Perjantai;2;1;3;9;19;28
294;06.04.2018;2018;04;19;Perjantai;2;2;4;15;10;25
294;06.04.2018;2018;04;20;Perjantai;2;1;3;6;16;22
294;06.04.2018;2018;04;21;Perjantai;7;0;7;8;1;9
294;06.04.2018;2018;04;22;Perjantai;0;0;0;6;2;8
294;06.04.2018;2018;04;23;Perjantai;0;0;0;3;0;3
294;07.04.2018;2018;04;00;Lauantai;0;0;0;0;0;0
294;07.04.2018;2018;04;01;Lauantai;0;0;0;0;0;0
294;07.04.2018;2018;04;02;Lauantai;0;0;0;0;0;0
294;07.04.2018;2018;04;03;Lauantai;0;0;0;0;1;1
294;07.04.2018;2018;04;04;Lauantai;0;0;0;0;0;0
294;07.04.2018;2018;04;05;Lauantai;0;0;0;0;0;0
294;07.04.2018;2018;04;06;Lauantai;0;1;1;3;1;4
294;07.04.2018;2018;04;07;Lauantai;0;0;0;1;10;11
294;07.04.2018;2018;04;08;Lauantai;1;0;1;10;4;14
294;07.04.2018;2018;04;09;Lauantai;0;1;1;4;10;14
294;07.04.2018;2018;04;10;Lauantai;1;2;3;24;10;34
294;07.04.2018;2018;04;11;Lauantai;0;1;1;30;21;51
294;07.04.2018;2018;04;12;Lauantai;1;4;5;17;13;30
294;07.04.2018;2018;04;13;Lauantai;2;1;3;20;18;38
294;07.04.2018;2018;04;14;Lauantai;1;3;4;11;14;25
294;07.04.2018;2018;04;15;Lauantai;0;2;2;24;12;36
294;07.04.2018;2018;04;16;Lauantai;1;0;1;18;17;35
294;07.04.2018;2018;04;17;Lauantai;0;3;3;9;5;14
294;07.04.2018;2018;04;18;Lauantai;1;8;9;9;7;16
294;07.04.2018;2018;04;19;Lauantai;3;1;4;5;7;12
294;07.04.2018;2018;04;20;Lauantai;4;2;6;8;5;13
294;07.04.2018;2018;04;21;Lauantai;0;0;0;2;2;4
294;07.04.2018;2018;04;22;Lauantai;0;0;0;3;0;3
294;07.04.2018;2018;04;23;Lauantai;0;0;0;4;0;4
294;08.04.2018;2018;04;00;Sunnuntai;3;0;3;3;1;4
294;08.04.2018;2018;04;01;Sunnuntai;0;0;0;1;0;1
294;08.04.2018;2018;04;02;Sunnuntai;0;0;0;0;0;0
294;08.04.2018;2018;04;03;Sunnuntai;0;0;0;0;0;0
294;08.04.2018;2018;04;04;Sunnuntai;0;0;0;0;0;0
294;08.04.2018;2018;04;05;Sunnuntai;0;0;0;0;0;0
294;08.04.2018;2018;04;06;Sunnuntai;0;0;0;3;0;3
294;08.04.2018;2018;04;07;Sunnuntai;0;0;0;3;2;5
294;08.04.2018;2018;04;08;Sunnuntai;0;0;0;3;2;5
294;08.04.2018;2018;04;09;Sunnuntai;0;2;2;7;6;13
294;08.04.2018;2018;04;10;Sunnuntai;1;0;1;11;17;28
294;08.04.2018;2018;04;11;Sunnuntai;4;5;9;12;14;26
294;08.04.2018;2018;04;12;Sunnuntai;2;1;3;19;27;46
294;08.04.2018;2018;04;13;Sunnuntai;1;4;5;18;12;30
294;08.04.2018;2018;04;14;Sunnuntai;3;2;5;13;9;22
294;08.04.2018;2018;04;15;Sunnuntai;0;1;1;15;9;24
294;08.04.2018;2018;04;16;Sunnuntai;1;0;1;7;4;11
294;08.04.2018;2018;04;17;Sunnuntai;3;1;4;7;7;14
294;08.04.2018;2018;04;18;Sunnuntai;5;0;5;17;9;26
294;08.04.2018;2018;04;19;Sunnuntai;2;5;7;3;6;9
294;08.04.2018;2018;04;20;Sunnuntai;1;0;1;7;6;13
294;08.04.2018;2018;04;21;Sunnuntai;2;1;3;3;1;4
294;08.04.2018;2018;04;22;Sunnuntai;0;0;0;3;2;5
294;08.04.2018;2018;04;23;Sunnuntai;0;0;0;2;0;2
294;09.04.2018;2018;04;00;Maanantai;0;0;0;0;0;0
294;09.04.2018;2018;04;01;Maanantai;0;0;0;0;0;0
294;09.04.2018;2018;04;02;Maanantai;0;0;0;0;0;0
294;09.04.2018;2018;04;03;Maanantai;0;0;0;0;0;0
294;09.04.2018;2018;04;04;Maanantai;0;0;0;0;0;0
294;09.04.2018;2018;04;05;Maanantai;0;0;0;2;1;3
294;09.04.2018;2018;04;06;Maanantai;0;0;0;2;3;5
294;09.04.2018;2018;04;07;Maanantai;3;6;9;6;5;11
294;09.04.2018;2018;04;08;Maanantai;7;1;8;21;6;27
294;09.04.2018;2018;04;09;Maanantai;3;2;5;15;11;26
294;09.04.2018;2018;04;10;Maanantai;0;3;3;11;12;23
294;09.04.2018;2018;04;11;Maanantai;0;10;10;25;16;41
294;09.04.2018;2018;04;12;Maanantai;1;1;2;10;13;23
294;09.04.2018;2018;04;13;Maanantai;3;8;11;14;20;34
294;09.04.2018;2018;04;14;Maanantai;5;7;12;20;25;45
294;09.04.2018;2018;04;15;Maanantai;4;5;9;26;18;44
294;09.04.2018;2018;04;16;Maanantai;4;1;5;18;16;34
294;09.04.2018;2018;04;17;Maanantai;3;5;8;21;17;38
294;09.04.2018;2018;04;18;Maanantai;4;2;6;22;12;34
294;09.04.2018;2018;04;19;Maanantai;1;5;6;12;9;21
294;09.04.2018;2018;04;20;Maanantai;4;2;6;6;9;15
294;09.04.2018;2018;04;21;Maanantai;0;0;0;5;3;8
294;09.04.2018;2018;04;22;Maanantai;0;0;0;1;0;1
294;09.04.2018;2018;04;23;Maanantai;0;0;0;0;0;0
294;10.04.2018;2018;04;00;Tiistai;0;0;0;0;0;0
294;10.04.2018;2018;04;01;Tiistai;0;0;0;0;0;0
294;10.04.2018;2018;04;02;Tiistai;0;0;0;0;0;0
294;10.04.2018;2018;04;03;Tiistai;0;0;0;0;0;0
294;10.04.2018;2018;04;04;Tiistai;0;0;0;0;0;0
294;10.04.2018;2018;04;05;Tiistai;0;0;0;3;1;4
294;10.04.2018;2018;04;06;Tiistai;1;0;1;4;2;6
294;10.04.2018;2018;04;07;Tiistai;6;1;7;15;3;18
294;10.04.2018;2018;04;08;Tiistai;11;1;12;12;8;20
294;10.04.2018;2018;04;09;Tiistai;8;0;8;23;10;33
294;10.04.2018;2018;04;10;Tiistai;1;3;4;23;9;32
294;10.04.2018;2018;04;11;Tiistai;1;4;5;36;36;72
294;10.04.2018;2018;04;12;Tiistai;1;3;4;30;16;46
294;10.04.2018;2018;04;13;Tiistai;2;4;6;13;21;34
294;10.04.2018;2018;04;14;Tiistai;9;6;15;14;16;30
294;10.04.2018;2018;04;15;Tiistai;3;7;10;16;19;35
294;10.04.2018;2018;04;16;Tiistai;5;11;16;20;26;46
294;10.04.2018;2018;04;17;Tiistai;7;1;8;18;15;33
294;10.04.2018;2018;04;18;Tiistai;1;0;1;20;28;48
294;10.04.2018;2018;04;19;Tiistai;2;3;5;7;14;21
294;10.04.2018;2018;04;20;Tiistai;3;2;5;7;10;17
294;10.04.2018;2018;04;21;Tiistai;1;1;2;3;0;3
294;10.04.2018;2018;04;22;Tiistai;0;0;0;0;2;2
294;10.04.2018;2018;04;23;Tiistai;0;0;0;0;0;0
294;11.04.2018;2018;04;00;Keskiviikko;0;0;0;0;0;0
294;11.04.2018;2018;04;01;Keskiviikko;0;0;0;0;0;0
294;11.04.2018;2018;04;02;Keskiviikko;0;0;0;0;0;0
294;11.04.2018;2018;04;03;Keskiviikko;0;0;0;0;0;0
294;11.04.2018;2018;04;04;Keskiviikko;0;0;0;0;0;0
294;11.04.2018;2018;04;05;Keskiviikko;0;0;0;2;3;5
294;11.04.2018;2018;04;06;Keskiviikko;0;0;0;3;2;5
294;11.04.2018;2018;04;07;Keskiviikko;1;4;5;6;8;14
294;11.04.2018;2018;04;08;Keskiviikko;6;1;7;9;4;13
294;11.04.2018;2018;04;09;Keskiviikko;8;7;15;5;11;16
294;11.04.2018;2018;04;10;Keskiviikko;2;3;5;20;15;35
294;11.04.2018;2018;04;11;Keskiviikko;6;2;8;23;25;48
294;11.04.2018;2018;04;12;Keskiviikko;0;3;3;26;30;56
294;11.04.2018;2018;04;13;Keskiviikko;4;5;9;22;21;43
294;11.04.2018;2018;04;14;Keskiviikko;3;8;11;21;32;53
294;11.04.2018;2018;04;15;Keskiviikko;9;9;18;17;10;27
294;11.04.2018;2018;04;16;Keskiviikko;3;6;9;16;10;26
294;11.04.2018;2018;04;17;Keskiviikko;8;8;16;15;9;24
294;11.04.2018;2018;04;18;Keskiviikko;2;4;6;23;34;57
294;11.04.2018;2018;04;19;Keskiviikko;5;3;8;6;7;13
294;11.04.2018;2018;04;20;Keskiviikko;0;4;4;5;6;11
294;11.04.2018;2018;04;21;Keskiviikko;2;0;2;5;2;7
294;11.04.2018;2018;04;22;Keskiviikko;0;0;0;0;0;0
294;11.04.2018;2018;04;23;Keskiviikko;0;0;0;1;1;2
294;12.04.2018;2018;04;00;Torstai;0;0;0;0;0;0
294;12.04.2018;2018;04;01;Torstai;0;0;0;0;0;0
294;12.04.2018;2018;04;02;Torstai;0;0;0;0;0;0
294;12.04.2018;2018;04;03;Torstai;0;0;0;0;0;0
294;12.04.2018;2018;04;04;Torstai;1;0;1;0;0;0
294;12.04.2018;2018;04;05;Torstai;0;0;0;2;1;3
294;12.04.2018;2018;04;06;Torstai;0;0;0;2;2;4
294;12.04.2018;2018;04;07;Torstai;3;6;9;9;5;14
294;12.04.2018;2018;04;08;Torstai;3;3;6;14;6;20
294;12.04.2018;2018;04;09;Torstai;9;2;11;24;8;32
294;12.04.2018;2018;04;10;Torstai;1;1;2;16;16;32
294;12.04.2018;2018;04;11;Torstai;1;5;6;19;12;31
294;12.04.2018;2018;04;12;Torstai;2;1;3;23;25;48
294;12.04.2018;2018;04;13;Torstai;3;2;5;27;20;47
294;12.04.2018;2018;04;14;Torstai;3;6;9;21;17;38
294;12.04.2018;2018;04;15;Torstai;2;7;9;20;18;38
294;12.04.2018;2018;04;16;Torstai;5;2;7;19;19;38
294;12.04.2018;2018;04;17;Torstai;1;3;4;9;12;21
294;12.04.2018;2018;04;18;Torstai;5;2;7;14;27;41
294;12.04.2018;2018;04;19;Torstai;3;2;5;19;11;30
294;12.04.2018;2018;04;20;Torstai;1;2;3;8;5;13
294;12.04.2018;2018;04;21;Torstai;2;1;3;1;1;2
294;12.04.2018;2018;04;22;Torstai;0;0;0;0;0;0
294;12.04.2018;2018;04;23;Torstai;0;0;0;2;0;2
294;13.04.2018;2018;04;00;Perjantai;0;0;0;0;0;0
294;13.04.2018;2018;04;01;Perjantai;0;0;0;0;0;0
294;13.04.2018;2018;04;02;Perjantai;0;0;0;0;0;0
294;13.04.2018;2018;04;03;Perjantai;0;0;0;0;0;0
294;13.04.2018;2018;04;04;Perjantai;1;0;1;0;0;0
294;13.04.2018;2018;04;05;Perjantai;0;0;0;2;0;2
294;13.04.2018;2018;04;06;Perjantai;1;0;1;1;0;1
294;13.04.2018;2018;04;07;Perjantai;9;4;13;17;9;26
294;13.04.2018;2018;04;08;Perjantai;1;1;2;5;5;10
294;13.04.2018;2018;04;09;Perjantai;5;0;5;13;7;20
294;13.04.2018;2018;04;10;Perjantai;1;3;4;10;19;29
294;13.04.2018;2018;04;11;Perjantai;3;3;6;26;24;50
294;13.04.2018;2018;04;12;Perjantai;4;3;7;29;23;52
294;13.04.2018;2018;04;13;Perjantai;9;5;14;25;23;48
294;13.04.2018;2018;04;14;Perjantai;5;8;13;18;35;53
294;13.04.2018;2018;04;15;Perjantai;0;8;8;17;23;40
294;13.04.2018;2018;04;16;Perjantai;5;6;11;21;25;46
294;13.04.2018;2018;04;17;Perjantai;9;3;12;29;26;55
294;13.04.2018;2018;04;18;Perjantai;2;7;9;53;33;86
294;13.04.2018;2018;04;19;Perjantai;6;6;12;13;17;30
294;13.04.2018;2018;04;20;Perjantai;7;3;10;10;4;14
294;13.04.2018;2018;04;21;Perjantai;3;5;8;5;5;10
294;13.04.2018;2018;04;22;Perjantai;2;1;3;2;2;4
294;13.04.2018;2018;04;23;Perjantai;0;0;0;1;0;1
294;14.04.2018;2018;04;00;Lauantai;0;0;0;1;0;1
294;14.04.2018;2018;04;01;Lauantai;0;0;0;0;1;1
294;14.04.2018;2018;04;02;Lauantai;0;0;0;0;0;0
294;14.04.2018;2018;04;03;Lauantai;0;0;0;0;0;0
294;14.04.2018;2018;04;04;Lauantai;0;0;0;0;2;2
294;14.04.2018;2018;04;05;Lauantai;0;0;0;0;0;0
294;14.04.2018;2018;04;06;Lauantai;0;0;0;3;0;3
294;14.04.2018;2018;04;07;Lauantai;0;0;0;2;4;6
294;14.04.2018;2018;04;08;Lauantai;0;1;1;4;4;8
294;14.04.2018;2018;04;09;Lauantai;1;0;1;9;8;17
294;14.04.2018;2018;04;10;Lauantai;1;2;3;17;15;32
294;14.04.2018;2018;04;11;Lauantai;1;6;7;13;11;24
294;14.04.2018;2018;04;12;Lauantai;9;8;17;30;18;48
294;14.04.2018;2018;04;13;Lauantai;9;7;16;23;19;42
294;14.04.2018;2018;04;14;Lauantai;5;10;15;19;12;31
294;14.04.2018;2018;04;15;Lauantai;6;5;11;22;15;37
294;14.04.2018;2018;04;16;Lauantai;5;8;13;15;23;38
294;14.04.2018;2018;04;17;Lauantai;5;3;8;6;12;18
294;14.04.2018;2018;04;18;Lauantai;5;2;7;14;5;19
294;14.04.2018;2018;04;19;Lauantai;2;0;2;8;5;13
294;14.04.2018;2018;04;20;Lauantai;3;3;6;6;8;14
294;14.04.2018;2018;04;21;Lauantai;2;2;4;8;6;14
294;14.04.2018;2018;04;22;Lauantai;2;4;6;3;0;3
294;14.04.2018;2018;04;23;Lauantai;2;1;3;3;1;4
294;15.04.2018;2018;04;00;Sunnuntai;0;0;0;0;1;1
294;15.04.2018;2018;04;01;Sunnuntai;0;0;0;0;1;1
294;15.04.2018;2018;04;02;Sunnuntai;0;0;0;0;0;0
294;15.04.2018;2018;04;03;Sunnuntai;0;0;0;0;1;1
294;15.04.2018;2018;04;04;Sunnuntai;0;0;0;0;0;0
294;15.04.2018;2018;04;05;Sunnuntai;0;0;0;0;0;0
294;15.04.2018;2018;04;06;Sunnuntai;1;0;1;2;2;4
294;15.04.2018;2018;04;07;Sunnuntai;0;0;0;1;3;4
294;15.04.2018;2018;04;08;Sunnuntai;0;0;0;2;3;5
294;15.04.2018;2018;04;09;Sunnuntai;4;0;4;8;5;13
294;15.04.2018;2018;04;10;Sunnuntai;0;0;0;7;9;16
294;15.04.2018;2018;04;11;Sunnuntai;3;3;6;13;13;26
294;15.04.2018;2018;04;12;Sunnuntai;4;3;7;29;11;40
294;15.04.2018;2018;04;13;Sunnuntai;1;4;5;7;14;21
294;15.04.2018;2018;04;14;Sunnuntai;6;5;11;6;9;15
294;15.04.2018;2018;04;15;Sunnuntai;2;5;7;10;13;23
294;15.04.2018;2018;04;16;Sunnuntai;5;7;12;21;9;30
294;15.04.2018;2018;04;17;Sunnuntai;5;3;8;18;25;43
294;15.04.2018;2018;04;18;Sunnuntai;6;8;14;14;27;41
294;15.04.2018;2018;04;19;Sunnuntai;4;14;18;18;9;27
294;15.04.2018;2018;04;20;Sunnuntai;5;1;6;17;3;20
294;15.04.2018;2018;04;21;Sunnuntai;0;0;0;2;3;5
294;15.04.2018;2018;04;22;Sunnuntai;0;0;0;0;0;0
294;15.04.2018;2018;04;23;Sunnuntai;0;0;0;0;0;0
294;16.04.2018;2018;04;00;Maanantai;0;0;0;0;0;0
294;16.04.2018;2018;04;01;Maanantai;0;0;0;0;0;0
294;16.04.2018;2018;04;02;Maanantai;0;0;0;0;0;0
294;16.04.2018;2018;04;03;Maanantai;0;0;0;0;0;0
294;16.04.2018;2018;04;04;Maanantai;0;0;0;0;0;0
294;16.04.2018;2018;04;05;Maanantai;0;1;1;2;1;3
294;16.04.2018;2018;04;06;Maanantai;1;0;1;2;1;3
294;16.04.2018;2018;04;07;Maanantai;4;8;12;10;7;17
294;16.04.2018;2018;04;08;Maanantai;9;5;14;13;11;24
294;16.04.2018;2018;04;09;Maanantai;11;3;14;8;9;17
294;16.04.2018;2018;04;10;Maanantai;6;3;9;21;15;36
294;16.04.2018;2018;04;11;Maanantai;10;16;26;33;38;71
294;16.04.2018;2018;04;12;Maanantai;7;9;16;25;18;43
294;16.04.2018;2018;04;13;Maanantai;5;7;12;13;21;34
294;16.04.2018;2018;04;14;Maanantai;12;12;24;17;19;36
294;16.04.2018;2018;04;15;Maanantai;14;8;22;16;18;34
294;16.04.2018;2018;04;16;Maanantai;14;13;27;19;12;31
294;16.04.2018;2018;04;17;Maanantai;14;15;29;18;19;37
294;16.04.2018;2018;04;18;Maanantai;8;16;24;12;24;36
294;16.04.2018;2018;04;19;Maanantai;13;14;27;16;18;34
294;16.04.2018;2018;04;20;Maanantai;4;3;7;10;10;20
294;16.04.2018;2018;04;21;Maanantai;0;0;0;1;3;4
294;16.04.2018;2018;04;22;Maanantai;0;0;0;1;1;2
294;16.04.2018;2018;04;23;Maanantai;0;0;0;0;0;0
294;17.04.2018;2018;04;00;Tiistai;0;0;0;0;0;0
294;17.04.2018;2018;04;01;Tiistai;0;0;0;0;0;0
294;17.04.2018;2018;04;02;Tiistai;0;0;0;0;0;0
294;17.04.2018;2018;04;03;Tiistai;0;0;0;0;0;0
294;17.04.2018;2018;04;04;Tiistai;0;0;0;0;0;0
294;17.04.2018;2018;04;05;Tiistai;0;0;0;2;1;3
294;17.04.2018;2018;04;06;Tiistai;1;0;1;4;1;5
294;17.04.2018;2018;04;07;Tiistai;6;7;13;15;5;20
294;17.04.2018;2018;04;08;Tiistai;14;4;18;15;7;22
294;17.04.2018;2018;04;09;Tiistai;12;1;13;18;12;30
294;17.04.2018;2018;04;10;Tiistai;6;9;15;18;14;32
294;17.04.2018;2018;04;11;Tiistai;3;7;10;18;26;44
294;17.04.2018;2018;04;12;Tiistai;3;0;3;22;27;49
294;17.04.2018;2018;04;13;Tiistai;4;6;10;15;18;33
294;17.04.2018;2018;04;14;Tiistai;18;9;27;26;17;43
294;17.04.2018;2018;04;15;Tiistai;7;20;27;15;31;46
294;17.04.2018;2018;04;16;Tiistai;10;12;22;26;18;44
294;17.04.2018;2018;04;17;Tiistai;9;16;25;28;27;55
294;17.04.2018;2018;04;18;Tiistai;14;21;35;21;27;48
294;17.04.2018;2018;04;19;Tiistai;8;4;12;23;11;34
294;17.04.2018;2018;04;20;Tiistai;5;5;10;4;5;9
294;17.04.2018;2018;04;21;Tiistai;1;1;2;0;1;1
294;17.04.2018;2018;04;22;Tiistai;0;0;0;0;0;0
294;17.04.2018;2018;04;23;Tiistai;0;0;0;0;0;0
294;18.04.2018;2018;04;00;Keskiviikko;0;0;0;0;0;0
294;18.04.2018;2018;04;01;Keskiviikko;0;0;0;0;0;0
294;18.04.2018;2018;04;02;Keskiviikko;0;0;0;0;0;0
294;18.04.2018;2018;04;03;Keskiviikko;0;0;0;0;0;0
294;18.04.2018;2018;04;04;Keskiviikko;0;0;0;0;0;0
294;18.04.2018;2018;04;05;Keskiviikko;0;0;0;2;1;3
294;18.04.2018;2018;04;06;Keskiviikko;3;1;4;1;1;2
294;18.04.2018;2018;04;07;Keskiviikko;6;10;16;8;4;12
294;18.04.2018;2018;04;08;Keskiviikko;14;7;21;12;4;16
294;18.04.2018;2018;04;09;Keskiviikko;10;12;22;9;12;21
294;18.04.2018;2018;04;10;Keskiviikko;3;1;4;12;9;21
294;18.04.2018;2018;04;11;Keskiviikko;11;4;15;15;23;38
294;18.04.2018;2018;04;12;Keskiviikko;7;8;15;11;9;20
294;18.04.2018;2018;04;13;Keskiviikko;9;13;22;17;20;37
294;18.04.2018;2018;04;14;Keskiviikko;6;29;35;14;18;32
294;18.04.2018;2018;04;15;Keskiviikko;28;24;52;22;23;45
294;18.04.2018;2018;04;16;Keskiviikko;17;15;32;23;20;43
294;18.04.2018;2018;04;17;Keskiviikko;10;15;25;24;24;48
294;18.04.2018;2018;04;18;Keskiviikko;14;24;38;35;29;64
294;18.04.2018;2018;04;19;Keskiviikko;18;15;33;21;28;49
294;18.04.2018;2018;04;20;Keskiviikko;5;4;9;7;9;16
294;18.04.2018;2018;04;21;Keskiviikko;3;5;8;5;2;7
294;18.04.2018;2018;04;22;Keskiviikko;0;0;0;1;1;2
294;18.04.2018;2018;04;23;Keskiviikko;0;0;0;0;0;0
294;19.04.2018;2018;04;00;Torstai;0;0;0;0;0;0
294;19.04.2018;2018;04;01;Torstai;0;0;0;0;0;0
294;19.04.2018;2018;04;02;Torstai;0;0;0;0;0;0
294;19.04.2018;2018;04;03;Torstai;0;0;0;0;0;0
294;19.04.2018;2018;04;04;Torstai;0;0;0;0;0;0
294;19.04.2018;2018;04;05;Torstai;0;0;0;0;1;1
294;19.04.2018;2018;04;06;Torstai;3;2;5;2;2;4
294;19.04.2018;2018;04;07;Torstai;10;6;16;6;5;11
294;19.04.2018;2018;04;08;Torstai;20;10;30;13;3;16
294;19.04.2018;2018;04;09;Torstai;5;6;11;15;16;31
294;19.04.2018;2018;04;10;Torstai;6;7;13;13;18;31
294;19.04.2018;2018;04;11;Torstai;10;9;19;39;40;79
294;19.04.2018;2018;04;12;Torstai;10;5;15;14;17;31
294;19.04.2018;2018;04;13;Torstai;5;13;18;19;20;39
294;19.04.2018;2018;04;14;Torstai;19;9;28;8;7;15
294;19.04.2018;2018;04;15;Torstai;19;34;53;14;16;30
294;19.04.2018;2018;04;16;Torstai;13;10;23;17;17;34
294;19.04.2018;2018;04;17;Torstai;18;15;33;19;24;43
294;19.04.2018;2018;04;18;Torstai;15;22;37;27;22;49
294;19.04.2018;2018;04;19;Torstai;6;8;14;14;15;29
294;19.04.2018;2018;04;20;Torstai;8;6;14;5;8;13
294;19.04.2018;2018;04;21;Torstai;0;3;3;1;5;6
294;19.04.2018;2018;04;22;Torstai;0;1;1;0;0;0
294;19.04.2018;2018;04;23;Torstai;0;0;0;0;0;0
294;20.04.2018;2018;04;00;Perjantai;0;0;0;0;0;0
294;20.04.2018;2018;04;01;Perjantai;0;0;0;0;0;0
294;20.04.2018;2018;04;02;Perjantai;0;0;0;0;0;0
294;20.04.2018;2018;04;03;Perjantai;0;0;0;0;0;0
294;20.04.2018;2018;04;04;Perjantai;0;0;0;0;0;0
294;20.04.2018;2018;04;05;Perjantai;0;0;0;2;1;3
294;20.04.2018;2018;04;06;Perjantai;1;2;3;2;0;2
294;20.04.2018;2018;04;07;Perjantai;19;9;28;5;3;8
294;20.04.2018;2018;04;08;Perjantai;4;2;6;2;1;3
294;20.04.2018;2018;04;09;Perjantai;7;0;7;8;3;11
294;20.04.2018;2018;04;10;Perjantai;1;10;11;7;8;15
294;20.04.2018;2018;04;11;Perjantai;5;3;8;13;3;16
294;20.04.2018;2018;04;12;Perjantai;8;6;14;11;6;17
294;20.04.2018;2018;04;13;Perjantai;16;22;38;17;35;52
294;20.04.2018;2018;04;14;Perjantai;6;12;18;16;20;36
294;20.04.2018;2018;04;15;Perjantai;7;11;18;12;14;26
294;20.04.2018;2018;04;16;Perjantai;11;5;16;7;8;15
294;20.04.2018;2018;04;17;Perjantai;3;9;12;13;16;29
294;20.04.2018;2018;04;18;Perjantai;7;6;13;13;11;24
294;20.04.2018;2018;04;19;Perjantai;10;8;18;14;14;28
294;20.04.2018;2018;04;20;Perjantai;11;7;18;7;4;11
294;20.04.2018;2018;04;21;Perjantai;6;5;11;4;2;6
294;20.04.2018;2018;04;22;Perjantai;6;1;7;4;2;6
294;20.04.2018;2018;04;23;Perjantai;0;0;0;3;0;3
294;21.04.2018;2018;04;00;Lauantai;0;2;2;0;1;1
294;21.04.2018;2018;04;01;Lauantai;0;0;0;0;0;0
294;21.04.2018;2018;04;02;Lauantai;0;0;0;6;1;7
294;21.04.2018;2018;04;03;Lauantai;0;0;0;0;0;0
294;21.04.2018;2018;04;04;Lauantai;0;0;0;0;0;0
294;21.04.2018;2018;04;05;Lauantai;0;0;0;1;0;1
294;21.04.2018;2018;04;06;Lauantai;1;0;1;3;1;4
294;21.04.2018;2018;04;07;Lauantai;0;1;1;2;0;2
294;21.04.2018;2018;04;08;Lauantai;1;1;2;3;4;7
294;21.04.2018;2018;04;09;Lauantai;4;3;7;9;8;17
294;21.04.2018;2018;04;10;Lauantai;6;11;17;7;15;22
294;21.04.2018;2018;04;11;Lauantai;18;12;30;9;10;19
294;21.04.2018;2018;04;12;Lauantai;20;23;43;17;15;32
294;21.04.2018;2018;04;13;Lauantai;14;16;30;9;21;30
294;21.04.2018;2018;04;14;Lauantai;18;6;24;18;18;36
294;21.04.2018;2018;04;15;Lauantai;23;18;41;13;19;32
294;21.04.2018;2018;04;16;Lauantai;16;13;29;16;22;38
294;21.04.2018;2018;04;17;Lauantai;10;14;24;21;15;36
294;21.04.2018;2018;04;18;Lauantai;16;6;22;16;10;26
294;21.04.2018;2018;04;19;Lauantai;13;12;25;5;6;11
294;21.04.2018;2018;04;20;Lauantai;7;7;14;8;3;11
294;21.04.2018;2018;04;21;Lauantai;8;1;9;7;5;12
294;21.04.2018;2018;04;22;Lauantai;1;1;2;0;0;0
294;21.04.2018;2018;04;23;Lauantai;0;0;0;2;0;2
294;22.04.2018;2018;04;00;Sunnuntai;0;0;0;0;0;0
294;22.04.2018;2018;04;01;Sunnuntai;0;0;0;2;0;2
294;22.04.2018;2018;04;02;Sunnuntai;0;0;0;0;0;0
294;22.04.2018;2018;04;03;Sunnuntai;0;0;0;0;0;0
294;22.04.2018;2018;04;04;Sunnuntai;0;0;0;0;0;0
294;22.04.2018;2018;04;05;Sunnuntai;0;0;0;1;0;1
294;22.04.2018;2018;04;06;Sunnuntai;0;0;0;2;3;5
294;22.04.2018;2018;04;07;Sunnuntai;0;0;0;0;1;1
294;22.04.2018;2018;04;08;Sunnuntai;0;1;1;4;7;11
294;22.04.2018;2018;04;09;Sunnuntai;8;1;9;9;16;25
294;22.04.2018;2018;04;10;Sunnuntai;3;8;11;17;6;23
294;22.04.2018;2018;04;11;Sunnuntai;10;18;28;18;16;34
294;22.04.2018;2018;04;12;Sunnuntai;25;17;42;15;26;41
294;22.04.2018;2018;04;13;Sunnuntai;15;19;34;13;17;30
294;22.04.2018;2018;04;14;Sunnuntai;25;16;41;11;17;28
294;22.04.2018;2018;04;15;Sunnuntai;10;6;16;7;25;32
294;22.04.2018;2018;04;16;Sunnuntai;8;9;17;9;4;13
294;22.04.2018;2018;04;17;Sunnuntai;15;16;31;10;13;23
294;22.04.2018;2018;04;18;Sunnuntai;11;7;18;16;17;33
294;22.04.2018;2018;04;19;Sunnuntai;7;9;16;14;14;28
294;22.04.2018;2018;04;20;Sunnuntai;3;6;9;2;7;9
294;22.04.2018;2018;04;21;Sunnuntai;0;0;0;3;3;6
294;22.04.2018;2018;04;22;Sunnuntai;0;0;0;0;0;0
294;22.04.2018;2018;04;23;Sunnuntai;0;0;0;2;0;2
294;23.04.2018;2018;04;00;Maanantai;0;0;0;0;0;0
294;23.04.2018;2018;04;01;Maanantai;0;0;0;0;0;0
294;23.04.2018;2018;04;02;Maanantai;0;0;0;0;0;0
294;23.04.2018;2018;04;03;Maanantai;0;0;0;0;0;0
294;23.04.2018;2018;04;04;Maanantai;0;0;0;0;0;0
294;23.04.2018;2018;04;05;Maanantai;0;0;0;1;3;4
294;23.04.2018;2018;04;06;Maanantai;1;0;1;1;2;3
294;23.04.2018;2018;04;07;Maanantai;2;6;8;3;7;10
294;23.04.2018;2018;04;08;Maanantai;25;5;30;6;5;11
294;23.04.2018;2018;04;09;Maanantai;6;10;16;8;10;18
294;23.04.2018;2018;04;10;Maanantai;9;5;14;18;13;31
294;23.04.2018;2018;04;11;Maanantai;7;17;24;21;22;43
294;23.04.2018;2018;04;12;Maanantai;8;6;14;18;19;37
294;23.04.2018;2018;04;13;Maanantai;14;11;25;18;17;35
294;23.04.2018;2018;04;14;Maanantai;16;16;32;24;23;47
294;23.04.2018;2018;04;15;Maanantai;16;16;32;11;12;23
294;23.04.2018;2018;04;16;Maanantai;17;23;40;10;16;26
294;23.04.2018;2018;04;17;Maanantai;29;20;49;22;29;51
294;23.04.2018;2018;04;18;Maanantai;23;26;49;32;19;51
294;23.04.2018;2018;04;19;Maanantai;14;16;30;16;15;31
294;23.04.2018;2018;04;20;Maanantai;10;4;14;5;1;6
294;23.04.2018;2018;04;21;Maanantai;0;4;4;5;7;12
294;23.04.2018;2018;04;22;Maanantai;0;0;0;2;1;3
294;23.04.2018;2018;04;23;Maanantai;0;0;0;0;0;0
294;24.04.2018;2018;04;00;Tiistai;0;0;0;0;0;0
294;24.04.2018;2018;04;01;Tiistai;0;0;0;0;0;0
294;24.04.2018;2018;04;02;Tiistai;0;0;0;0;0;0
294;24.04.2018;2018;04;03;Tiistai;0;0;0;0;0;0
294;24.04.2018;2018;04;04;Tiistai;0;0;0;0;0;0
294;24.04.2018;2018;04;05;Tiistai;0;0;0;0;1;1
294;24.04.2018;2018;04;06;Tiistai;0;0;0;3;4;7
294;24.04.2018;2018;04;07;Tiistai;11;9;20;11;5;16
294;24.04.2018;2018;04;08;Tiistai;24;6;30;14;16;30
294;24.04.2018;2018;04;09;Tiistai;14;7;21;16;13;29
294;24.04.2018;2018;04;10;Tiistai;4;3;7;15;12;27
294;24.04.2018;2018;04;11;Tiistai;4;11;15;24;26;50
294;24.04.2018;2018;04;12;Tiistai;5;8;13;13;9;22
294;24.04.2018;2018;04;13;Tiistai;17;8;25;9;9;18
294;24.04.2018;2018;04;14;Tiistai;11;11;22;13;14;27
294;24.04.2018;2018;04;15;Tiistai;10;18;28;13;18;31
294;24.04.2018;2018;04;16;Tiistai;16;12;28;12;22;34
294;24.04.2018;2018;04;17;Tiistai;6;7;13;9;7;16
294;24.04.2018;2018;04;18;Tiistai;6;8;14;13;16;29
294;24.04.2018;2018;04;19;Tiistai;6;6;12;2;14;16
294;24.04.2018;2018;04;20;Tiistai;3;4;7;8;8;16
294;24.04.2018;2018;04;21;Tiistai;0;1;1;6;2;8
294;24.04.2018;2018;04;22;Tiistai;0;0;0;0;0;0
294;24.04.2018;2018;04;23;Tiistai;0;0;0;0;0;0
294;25.04.2018;2018;04;00;Keskiviikko;0;0;0;0;0;0
294;25.04.2018;2018;04;01;Keskiviikko;0;0;0;0;0;0
294;25.04.2018;2018;04;02;Keskiviikko;0;0;0;0;0;0
294;25.04.2018;2018;04;03;Keskiviikko;0;0;0;0;0;0
294;25.04.2018;2018;04;04;Keskiviikko;0;0;0;0;0;0
294;25.04.2018;2018;04;05;Keskiviikko;0;1;1;0;1;1
294;25.04.2018;2018;04;06;Keskiviikko;2;1;3;2;0;2
294;25.04.2018;2018;04;07;Keskiviikko;1;8;9;6;6;12
294;25.04.2018;2018;04;08;Keskiviikko;18;7;25;13;8;21
294;25.04.2018;2018;04;09;Keskiviikko;6;5;11;11;11;22
294;25.04.2018;2018;04;10;Keskiviikko;2;4;6;10;15;25
294;25.04.2018;2018;04;11;Keskiviikko;11;3;14;29;22;51
294;25.04.2018;2018;04;12;Keskiviikko;3;8;11;13;10;23
294;25.04.2018;2018;04;13;Keskiviikko;8;14;22;15;10;25
294;25.04.2018;2018;04;14;Keskiviikko;15;25;40;9;13;22
294;25.04.2018;2018;04;15;Keskiviikko;13;20;33;7;14;21
294;25.04.2018;2018;04;16;Keskiviikko;16;19;35;13;20;33
294;25.04.2018;2018;04;17;Keskiviikko;22;16;38;10;17;27
294;25.04.2018;2018;04;18;Keskiviikko;19;17;36;25;17;42
294;25.04.2018;2018;04;19;Keskiviikko;10;5;15;6;23;29
294;25.04.2018;2018;04;20;Keskiviikko;3;10;13;8;10;18
294;25.04.2018;2018;04;21;Keskiviikko;4;0;4;1;0;1
294;25.04.2018;2018;04;22;Keskiviikko;0;0;0;0;1;1
294;25.04.2018;2018;04;23;Keskiviikko;0;0;0;0;0;0
294;26.04.2018;2018;04;00;Torstai;0;0;0;0;0;0
294;26.04.2018;2018;04;01;Torstai;0;0;0;0;0;0
294;26.04.2018;2018;04;02;Torstai;0;0;0;0;0;0
294;26.04.2018;2018;04;03;Torstai;0;0;0;0;0;0
294;26.04.2018;2018;04;04;Torstai;0;0;0;0;0;0
294;26.04.2018;2018;04;05;Torstai;0;1;1;1;1;2
294;26.04.2018;2018;04;06;Torstai;0;3;3;1;0;1
294;26.04.2018;2018;04;07;Torstai;8;6;14;7;4;11
294;26.04.2018;2018;04;08;Torstai;15;3;18;10;10;20
294;26.04.2018;2018;04;09;Torstai;12;5;17;19;7;26
294;26.04.2018;2018;04;10;Torstai;4;10;14;5;8;13
294;26.04.2018;2018;04;11;Torstai;6;10;16;26;25;51
294;26.04.2018;2018;04;12;Torstai;8;9;17;14;34;48
294;26.04.2018;2018;04;13;Torstai;5;14;19;22;16;38
294;26.04.2018;2018;04;14;Torstai;20;9;29;20;17;37
294;26.04.2018;2018;04;15;Torstai;17;28;45;6;24;30
294;26.04.2018;2018;04;16;Torstai;13;13;26;27;9;36
294;26.04.2018;2018;04;17;Torstai;20;16;36;27;18;45
294;26.04.2018;2018;04;18;Torstai;19;26;45;18;19;37
294;26.04.2018;2018;04;19;Torstai;17;8;25;12;13;25
294;26.04.2018;2018;04;20;Torstai;5;5;10;4;15;19
294;26.04.2018;2018;04;21;Torstai;3;0;3;3;1;4
294;26.04.2018;2018;04;22;Torstai;0;0;0;0;0;0
294;26.04.2018;2018;04;23;Torstai;0;0;0;0;0;0
294;27.04.2018;2018;04;00;Perjantai;0;0;0;0;0;0
294;27.04.2018;2018;04;01;Perjantai;0;0;0;0;0;0
294;27.04.2018;2018;04;02;Perjantai;0;0;0;0;0;0
294;27.04.2018;2018;04;03;Perjantai;0;0;0;0;0;0
294;27.04.2018;2018;04;04;Perjantai;0;0;0;0;0;0
294;27.04.2018;2018;04;05;Perjantai;0;1;1;0;0;0
294;27.04.2018;2018;04;06;Perjantai;3;1;4;1;2;3
294;27.04.2018;2018;04;07;Perjantai;11;10;21;4;2;6
294;27.04.2018;2018;04;08;Perjantai;6;4;10;9;13;22
294;27.04.2018;2018;04;09;Perjantai;10;1;11;9;8;17
294;27.04.2018;2018;04;10;Perjantai;10;13;23;10;18;28
294;27.04.2018;2018;04;11;Perjantai;23;9;32;16;8;24
294;27.04.2018;2018;04;12;Perjantai;13;16;29;20;17;37
294;27.04.2018;2018;04;13;Perjantai;20;19;39;19;22;41
294;27.04.2018;2018;04;14;Perjantai;13;38;51;27;22;49
294;27.04.2018;2018;04;15;Perjantai;19;18;37;16;15;31
294;27.04.2018;2018;04;16;Perjantai;19;20;39;15;15;30
294;27.04.2018;2018;04;17;Perjantai;16;10;26;16;11;27
294;27.04.2018;2018;04;18;Perjantai;20;16;36;11;13;24
294;27.04.2018;2018;04;19;Perjantai;11;14;25;12;20;32
294;27.04.2018;2018;04;20;Perjantai;8;11;19;4;3;7
294;27.04.2018;2018;04;21;Perjantai;16;10;26;5;8;13
294;27.04.2018;2018;04;22;Perjantai;3;1;4;5;1;6
294;27.04.2018;2018;04;23;Perjantai;1;0;1;0;0;0
294;28.04.2018;2018;04;00;Lauantai;1;0;1;0;0;0
294;28.04.2018;2018;04;01;Lauantai;0;0;0;0;0;0
294;28.04.2018;2018;04;02;Lauantai;0;0;0;0;1;1
294;28.04.2018;2018;04;03;Lauantai;0;0;0;0;0;0
294;28.04.2018;2018;04;04;Lauantai;0;0;0;0;0;0
294;28.04.2018;2018;04;05;Lauantai;0;0;0;0;0;0
294;28.04.2018;2018;04;06;Lauantai;1;1;2;0;0;0
294;28.04.2018;2018;04;07;Lauantai;0;0;0;1;0;1
294;28.04.2018;2018;04;08;Lauantai;0;1;1;6;4;10
294;28.04.2018;2018;04;09;Lauantai;4;10;14;7;2;9
294;28.04.2018;2018;04;10;Lauantai;14;6;20;7;7;14
294;28.04.2018;2018;04;11;Lauantai;8;17;25;9;15;24
294;28.04.2018;2018;04;12;Lauantai;20;24;44;19;6;25
294;28.04.2018;2018;04;13;Lauantai;29;18;47;10;6;16
294;28.04.2018;2018;04;14;Lauantai;29;24;53;17;8;25
294;28.04.2018;2018;04;15;Lauantai;27;17;44;12;18;30
294;28.04.2018;2018;04;16;Lauantai;25;19;44;15;5;20
294;28.04.2018;2018;04;17;Lauantai;15;18;33;11;18;29
294;28.04.2018;2018;04;18;Lauantai;9;14;23;13;9;22
294;28.04.2018;2018;04;19;Lauantai;23;12;35;6;14;20
294;28.04.2018;2018;04;20;Lauantai;8;7;15;7;4;11
294;28.04.2018;2018;04;21;Lauantai;15;7;22;0;2;2
294;28.04.2018;2018;04;22;Lauantai;1;2;3;2;0;2
294;28.04.2018;2018;04;23;Lauantai;0;2;2;0;0;0
294;29.04.2018;2018;04;00;Sunnuntai;1;0;1;0;1;1
294;29.04.2018;2018;04;01;Sunnuntai;0;1;1;4;0;4
294;29.04.2018;2018;04;02;Sunnuntai;0;0;0;0;0;0
294;29.04.2018;2018;04;03;Sunnuntai;0;0;0;0;0;0
294;29.04.2018;2018;04;04;Sunnuntai;0;0;0;1;2;3
294;29.04.2018;2018;04;05;Sunnuntai;0;0;0;0;0;0
294;29.04.2018;2018;04;06;Sunnuntai;0;0;0;0;1;1
294;29.04.2018;2018;04;07;Sunnuntai;2;2;4;4;0;4
294;29.04.2018;2018;04;08;Sunnuntai;1;0;1;2;6;8
294;29.04.2018;2018;04;09;Sunnuntai;4;2;6;4;6;10
294;29.04.2018;2018;04;10;Sunnuntai;4;6;10;6;7;13
294;29.04.2018;2018;04;11;Sunnuntai;6;15;21;7;9;16
294;29.04.2018;2018;04;12;Sunnuntai;11;9;20;6;7;13
294;29.04.2018;2018;04;13;Sunnuntai;13;10;23;12;10;22
294;29.04.2018;2018;04;14;Sunnuntai;9;10;19;13;8;21
294;29.04.2018;2018;04;15;Sunnuntai;7;8;15;4;6;10
294;29.04.2018;2018;04;16;Sunnuntai;6;9;15;13;6;19
294;29.04.2018;2018;04;17;Sunnuntai;19;12;31;14;3;17
294;29.04.2018;2018;04;18;Sunnuntai;14;13;27;4;9;13
294;29.04.2018;2018;04;19;Sunnuntai;14;9;23;13;12;25
294;29.04.2018;2018;04;20;Sunnuntai;15;12;27;7;5;12
294;29.04.2018;2018;04;21;Sunnuntai;10;4;14;9;3;12
294;29.04.2018;2018;04;22;Sunnuntai;0;0;0;0;0;0
294;29.04.2018;2018;04;23;Sunnuntai;1;0;1;0;0;0
294;30.04.2018;2018;04;00;Maanantai;1;2;3;0;0;0
294;30.04.2018;2018;04;01;Maanantai;0;0;0;0;0;0
294;30.04.2018;2018;04;02;Maanantai;0;0;0;0;0;0
294;30.04.2018;2018;04;03;Maanantai;0;0;0;0;0;0
294;30.04.2018;2018;04;04;Maanantai;0;0;0;0;0;0
294;30.04.2018;2018;04;05;Maanantai;0;0;0;0;1;1
294;30.04.2018;2018;04;06;Maanantai;1;2;3;0;0;0
294;30.04.2018;2018;04;07;Maanantai;3;1;4;2;1;3
294;30.04.2018;2018;04;08;Maanantai;0;2;2;5;3;8
294;30.04.2018;2018;04;09;Maanantai;5;3;8;5;6;11
294;30.04.2018;2018;04;10;Maanantai;12;16;28;10;3;13
294;30.04.2018;2018;04;11;Maanantai;11;13;24;10;5;15
294;30.04.2018;2018;04;12;Maanantai;16;7;23;5;4;9
294;30.04.2018;2018;04;13;Maanantai;22;12;34;9;15;24
294;30.04.2018;2018;04;14;Maanantai;29;20;49;13;7;20
294;30.04.2018;2018;04;15;Maanantai;21;33;54;19;9;28
294;30.04.2018;2018;04;16;Maanantai;19;16;35;18;16;34
294;30.04.2018;2018;04;17;Maanantai;13;20;33;15;11;26
294;30.04.2018;2018;04;18;Maanantai;12;15;27;5;7;12
294;30.04.2018;2018;04;19;Maanantai;10;9;19;7;1;8
294;30.04.2018;2018;04;20;Maanantai;7;5;12;4;3;7
294;30.04.2018;2018;04;21;Maanantai;2;2;4;3;1;4
294;30.04.2018;2018;04;22;Maanantai;1;1;2;4;2;6
294;30.04.2018;2018;04;23;Maanantai;0;0;0;3;1;4
294;01.05.2018;2018;05;00;Tiistai;0;0;0;0;1;1
294;01.05.2018;2018;05;01;Tiistai;2;0;2;0;0;0
294;01.05.2018;2018;05;02;Tiistai;0;0;0;0;1;1
294;01.05.2018;2018;05;03;Tiistai;0;0;0;0;0;0
294;01.05.2018;2018;05;04;Tiistai;0;0;0;0;0;0
294;01.05.2018;2018;05;05;Tiistai;0;0;0;2;0;2
294;01.05.2018;2018;05;06;Tiistai;0;0;0;0;0;0
294;01.05.2018;2018;05;07;Tiistai;1;1;2;4;0;4
294;01.05.2018;2018;05;08;Tiistai;5;3;8;5;4;9
294;01.05.2018;2018;05;09;Tiistai;7;8;15;3;6;9
294;01.05.2018;2018;05;10;Tiistai;8;8;16;6;9;15
294;01.05.2018;2018;05;11;Tiistai;7;23;30;8;8;16
294;01.05.2018;2018;05;12;Tiistai;15;9;24;10;5;15
294;01.05.2018;2018;05;13;Tiistai;25;12;37;6;15;21
294;01.05.2018;2018;05;14;Tiistai;10;14;24;6;14;20
294;01.05.2018;2018;05;15;Tiistai;29;23;52;10;15;25
294;01.05.2018;2018;05;16;Tiistai;14;12;26;12;9;21
294;01.05.2018;2018;05;17;Tiistai;18;6;24;8;4;12
294;01.05.2018;2018;05;18;Tiistai;9;9;18;14;8;22
294;01.05.2018;2018;05;19;Tiistai;10;9;19;7;9;16
294;01.05.2018;2018;05;20;Tiistai;11;11;22;8;3;11
294;01.05.2018;2018;05;21;Tiistai;2;4;6;1;2;3
294;01.05.2018;2018;05;22;Tiistai;0;0;0;0;0;0
294;01.05.2018;2018;05;23;Tiistai;0;0;0;0;0;0
294;02.05.2018;2018;05;00;Keskiviikko;0;0;0;0;0;0
294;02.05.2018;2018;05;01;Keskiviikko;0;0;0;0;0;0
294;02.05.2018;2018;05;02;Keskiviikko;0;0;0;0;0;0
294;02.05.2018;2018;05;03;Keskiviikko;0;0;0;0;0;0
294;02.05.2018;2018;05;04;Keskiviikko;0;0;0;0;0;0
294;02.05.2018;2018;05;05;Keskiviikko;0;0;0;0;1;1
294;02.05.2018;2018;05;06;Keskiviikko;3;1;4;1;2;3
294;02.05.2018;2018;05;07;Keskiviikko;6;11;17;5;4;9
294;02.05.2018;2018;05;08;Keskiviikko;14;7;21;14;4;18
294;02.05.2018;2018;05;09;Keskiviikko;3;9;12;5;11;16
294;02.05.2018;2018;05;10;Keskiviikko;7;3;10;10;9;19
294;02.05.2018;2018;05;11;Keskiviikko;12;7;19;12;11;23
294;02.05.2018;2018;05;12;Keskiviikko;6;14;20;10;9;19
294;02.05.2018;2018;05;13;Keskiviikko;9;8;17;4;6;10
294;02.05.2018;2018;05;14;Keskiviikko;9;12;21;4;7;11
294;02.05.2018;2018;05;15;Keskiviikko;21;11;32;10;2;12
294;02.05.2018;2018;05;16;Keskiviikko;12;7;19;11;1;12
294;02.05.2018;2018;05;17;Keskiviikko;4;8;12;5;11;16
294;02.05.2018;2018;05;18;Keskiviikko;13;7;20;14;11;25
294;02.05.2018;2018;05;19;Keskiviikko;9;9;18;8;10;18
294;02.05.2018;2018;05;20;Keskiviikko;5;7;12;9;2;11
294;02.05.2018;2018;05;21;Keskiviikko;2;0;2;2;3;5
294;02.05.2018;2018;05;22;Keskiviikko;0;0;0;0;0;0
294;02.05.2018;2018;05;23;Keskiviikko;0;0;0;0;0;0
294;03.05.2018;2018;05;00;Torstai;0;0;0;0;0;0
294;03.05.2018;2018;05;01;Torstai;0;0;0;0;0;0
294;03.05.2018;2018;05;02;Torstai;0;0;0;0;0;0
294;03.05.2018;2018;05;03;Torstai;0;0;0;0;0;0
294;03.05.2018;2018;05;04;Torstai;0;0;0;0;0;0
294;03.05.2018;2018;05;05;Torstai;0;1;1;0;1;1
294;03.05.2018;2018;05;06;Torstai;2;2;4;0;0;0
294;03.05.2018;2018;05;07;Torstai;8;7;15;4;6;10
294;03.05.2018;2018;05;08;Torstai;18;9;27;12;3;15
294;03.05.2018;2018;05;09;Torstai;11;8;19;8;10;18
294;03.05.2018;2018;05;10;Torstai;6;6;12;12;5;17
294;03.05.2018;2018;05;11;Torstai;10;11;21;27;20;47
294;03.05.2018;2018;05;12;Torstai;12;5;17;13;8;21
294;03.05.2018;2018;05;13;Torstai;16;15;31;16;23;39
294;03.05.2018;2018;05;14;Torstai;14;12;26;8;9;17
294;03.05.2018;2018;05;15;Torstai;16;22;38;11;13;24
294;03.05.2018;2018;05;16;Torstai;11;17;28;9;6;15
294;03.05.2018;2018;05;17;Torstai;19;12;31;7;7;14
294;03.05.2018;2018;05;18;Torstai;14;19;33;9;15;24
294;03.05.2018;2018;05;19;Torstai;19;11;30;12;11;23
294;03.05.2018;2018;05;20;Torstai;8;7;15;4;5;9
294;03.05.2018;2018;05;21;Torstai;0;3;3;6;2;8
294;03.05.2018;2018;05;22;Torstai;1;0;1;3;0;3
294;03.05.2018;2018;05;23;Torstai;0;1;1;1;0;1
294;04.05.2018;2018;05;00;Perjantai;0;0;0;0;0;0
294;04.05.2018;2018;05;01;Perjantai;0;0;0;0;0;0
294;04.05.2018;2018;05;02;Perjantai;0;0;0;0;0;0
294;04.05.2018;2018;05;03;Perjantai;0;0;0;0;0;0
294;04.05.2018;2018;05;04;Perjantai;0;0;0;0;0;0
294;04.05.2018;2018;05;05;Perjantai;0;0;0;0;1;1
294;04.05.2018;2018;05;06;Perjantai;0;0;0;1;0;1
294;04.05.2018;2018;05;07;Perjantai;11;17;28;4;0;4
294;04.05.2018;2018;05;08;Perjantai;4;7;11;3;4;7
294;04.05.2018;2018;05;09;Perjantai;7;2;9;8;6;14
294;04.05.2018;2018;05;10;Perjantai;2;14;16;4;7;11
294;04.05.2018;2018;05;11;Perjantai;4;0;4;5;1;6
294;04.05.2018;2018;05;12;Perjantai;7;1;8;6;6;12
294;04.05.2018;2018;05;13;Perjantai;12;15;27;15;13;28
294;04.05.2018;2018;05;14;Perjantai;9;14;23;13;16;29
294;04.05.2018;2018;05;15;Perjantai;7;7;14;6;5;11
294;04.05.2018;2018;05;16;Perjantai;2;7;9;4;12;16
294;04.05.2018;2018;05;17;Perjantai;6;11;17;3;11;14
294;04.05.2018;2018;05;18;Perjantai;9;5;14;16;19;35
294;04.05.2018;2018;05;19;Perjantai;7;4;11;14;8;22
294;04.05.2018;2018;05;20;Perjantai;4;4;8;12;12;24
294;04.05.2018;2018;05;21;Perjantai;8;1;9;3;0;3
294;04.05.2018;2018;05;22;Perjantai;3;1;4;3;1;4
294;04.05.2018;2018;05;23;Perjantai;1;0;1;1;0;1
294;05.05.2018;2018;05;00;Lauantai;0;0;0;0;0;0
294;05.05.2018;2018;05;01;Lauantai;1;0;1;0;1;1
294;05.05.2018;2018;05;02;Lauantai;0;0;0;0;0;0
294;05.05.2018;2018;05;03;Lauantai;0;0;0;0;0;0
294;05.05.2018;2018;05;04;Lauantai;0;0;0;0;0;0
294;05.05.2018;2018;05;05;Lauantai;0;1;1;1;0;1
294;05.05.2018;2018;05;06;Lauantai;1;0;1;0;1;1
294;05.05.2018;2018;05;07;Lauantai;1;2;3;2;2;4
294;05.05.2018;2018;05;08;Lauantai;2;3;5;2;4;6
294;05.05.2018;2018;05;09;Lauantai;11;3;14;11;9;20
294;05.05.2018;2018;05;10;Lauantai;5;15;20;12;10;22
294;05.05.2018;2018;05;11;Lauantai;21;13;34;15;12;27
294;05.05.2018;2018;05;12;Lauantai;16;14;30;9;13;22
294;05.05.2018;2018;05;13;Lauantai;19;19;38;12;3;15
294;05.05.2018;2018;05;14;Lauantai;15;24;39;9;12;21
294;05.05.2018;2018;05;15;Lauantai;18;9;27;17;8;25
294;05.05.2018;2018;05;16;Lauantai;25;16;41;12;14;26
294;05.05.2018;2018;05;17;Lauantai;25;19;44;15;12;27
294;05.05.2018;2018;05;18;Lauantai;11;15;26;8;7;15
294;05.05.2018;2018;05;19;Lauantai;27;16;43;13;6;19
294;05.05.2018;2018;05;20;Lauantai;20;12;32;9;3;12
294;05.05.2018;2018;05;21;Lauantai;9;10;19;2;11;13
294;05.05.2018;2018;05;22;Lauantai;1;4;5;9;0;9
294;05.05.2018;2018;05;23;Lauantai;2;1;3;1;1;2
294;06.05.2018;2018;05;00;Sunnuntai;2;0;2;1;0;1
294;06.05.2018;2018;05;01;Sunnuntai;0;0;0;0;0;0
294;06.05.2018;2018;05;02;Sunnuntai;2;0;2;0;0;0
294;06.05.2018;2018;05;03;Sunnuntai;0;1;1;0;3;3
294;06.05.2018;2018;05;04;Sunnuntai;1;0;1;0;3;3
294;06.05.2018;2018;05;05;Sunnuntai;3;1;4;1;0;1
294;06.05.2018;2018;05;06;Sunnuntai;0;0;0;1;0;1
294;06.05.2018;2018;05;07;Sunnuntai;1;1;2;3;1;4
294;06.05.2018;2018;05;08;Sunnuntai;2;3;5;3;1;4
294;06.05.2018;2018;05;09;Sunnuntai;12;5;17;6;3;9
294;06.05.2018;2018;05;10;Sunnuntai;17;15;32;5;1;6
294;06.05.2018;2018;05;11;Sunnuntai;17;11;28;5;8;13
294;06.05.2018;2018;05;12;Sunnuntai;13;9;22;7;7;14
294;06.05.2018;2018;05;13;Sunnuntai;29;16;45;4;9;13
294;06.05.2018;2018;05;14;Sunnuntai;12;5;17;5;1;6
294;06.05.2018;2018;05;15;Sunnuntai;7;5;12;8;12;20
294;06.05.2018;2018;05;16;Sunnuntai;23;16;39;15;19;34
294;06.05.2018;2018;05;17;Sunnuntai;15;17;32;9;4;13
294;06.05.2018;2018;05;18;Sunnuntai;20;12;32;15;5;20
294;06.05.2018;2018;05;19;Sunnuntai;15;23;38;7;12;19
294;06.05.2018;2018;05;20;Sunnuntai;4;5;9;7;2;9
294;06.05.2018;2018;05;21;Sunnuntai;4;6;10;4;0;4
294;06.05.2018;2018;05;22;Sunnuntai;2;1;3;0;2;2
294;06.05.2018;2018;05;23;Sunnuntai;0;0;0;0;0;0
294;07.05.2018;2018;05;00;Maanantai;0;0;0;0;0;0
294;07.05.2018;2018;05;01;Maanantai;0;0;0;0;0;0
294;07.05.2018;2018;05;02;Maanantai;0;0;0;0;0;0
294;07.05.2018;2018;05;03;Maanantai;0;0;0;0;0;0
294;07.05.2018;2018;05;04;Maanantai;0;0;0;0;0;0
294;07.05.2018;2018;05;05;Maanantai;1;0;1;0;2;2
294;07.05.2018;2018;05;06;Maanantai;4;4;8;0;1;1
294;07.05.2018;2018;05;07;Maanantai;6;5;11;4;0;4
294;07.05.2018;2018;05;08;Maanantai;18;2;20;6;21;27
294;07.05.2018;2018;05;09;Maanantai;11;1;12;14;3;17
294;07.05.2018;2018;05;10;Maanantai;6;10;16;9;5;14
294;07.05.2018;2018;05;11;Maanantai;16;20;36;11;14;25
294;07.05.2018;2018;05;12;Maanantai;10;9;19;13;4;17
294;07.05.2018;2018;05;13;Maanantai;10;7;17;12;7;19
294;07.05.2018;2018;05;14;Maanantai;9;13;22;7;7;14
294;07.05.2018;2018;05;15;Maanantai;10;27;37;2;8;10
294;07.05.2018;2018;05;16;Maanantai;10;9;19;2;2;4
294;07.05.2018;2018;05;17;Maanantai;5;6;11;9;5;14
294;07.05.2018;2018;05;18;Maanantai;9;15;24;8;16;24
294;07.05.2018;2018;05;19;Maanantai;19;14;33;17;17;34
294;07.05.2018;2018;05;20;Maanantai;11;7;18;9;9;18
294;07.05.2018;2018;05;21;Maanantai;3;1;4;5;2;7
294;07.05.2018;2018;05;22;Maanantai;0;0;0;1;0;1
294;07.05.2018;2018;05;23;Maanantai;0;0;0;0;0;0
294;08.05.2018;2018;05;00;Tiistai;0;0;0;0;0;0
294;08.05.2018;2018;05;01;Tiistai;0;0;0;0;0;0
294;08.05.2018;2018;05;02;Tiistai;0;0;0;0;0;0
294;08.05.2018;2018;05;03;Tiistai;0;0;0;0;0;0
294;08.05.2018;2018;05;04;Tiistai;0;0;0;0;0;0
294;08.05.2018;2018;05;05;Tiistai;0;0;0;0;0;0
294;08.05.2018;2018;05;06;Tiistai;3;2;5;1;1;2
294;08.05.2018;2018;05;07;Tiistai;15;13;28;7;1;8
294;08.05.2018;2018;05;08;Tiistai;37;8;45;21;4;25
294;08.05.2018;2018;05;09;Tiistai;24;15;39;9;8;17
294;08.05.2018;2018;05;10;Tiistai;11;8;19;8;4;12
294;08.05.2018;2018;05;11;Tiistai;7;6;13;20;18;38
294;08.05.2018;2018;05;12;Tiistai;11;18;29;16;12;28
294;08.05.2018;2018;05;13;Tiistai;20;21;41;10;21;31
294;08.05.2018;2018;05;14;Tiistai;13;19;32;4;12;16
294;08.05.2018;2018;05;15;Tiistai;25;46;71;14;15;29
294;08.05.2018;2018;05;16;Tiistai;20;15;35;9;8;17
294;08.05.2018;2018;05;17;Tiistai;27;20;47;16;10;26
294;08.05.2018;2018;05;18;Tiistai;28;16;44;17;18;35
294;08.05.2018;2018;05;19;Tiistai;22;21;43;15;11;26
294;08.05.2018;2018;05;20;Tiistai;19;15;34;7;8;15
294;08.05.2018;2018;05;21;Tiistai;5;2;7;4;1;5
294;08.05.2018;2018;05;22;Tiistai;0;2;2;0;1;1
294;08.05.2018;2018;05;23;Tiistai;0;0;0;0;0;0
294;09.05.2018;2018;05;00;Keskiviikko;0;0;0;1;0;1
294;09.05.2018;2018;05;01;Keskiviikko;0;0;0;0;0;0
294;09.05.2018;2018;05;02;Keskiviikko;0;0;0;0;0;0
294;09.05.2018;2018;05;03;Keskiviikko;0;0;0;0;0;0
294;09.05.2018;2018;05;04;Keskiviikko;0;0;0;0;0;0
294;09.05.2018;2018;05;05;Keskiviikko;0;0;0;1;1;2
294;09.05.2018;2018;05;06;Keskiviikko;3;3;6;1;2;3
294;09.05.2018;2018;05;07;Keskiviikko;17;6;23;0;5;5
294;09.05.2018;2018;05;08;Keskiviikko;12;6;18;8;8;16
294;09.05.2018;2018;05;09;Keskiviikko;8;2;10;5;2;7
294;09.05.2018;2018;05;10;Keskiviikko;7;2;9;12;3;15
294;09.05.2018;2018;05;11;Keskiviikko;12;9;21;11;15;26
294;09.05.2018;2018;05;12;Keskiviikko;8;11;19;14;6;20
294;09.05.2018;2018;05;13;Keskiviikko;9;8;17;5;8;13
294;09.05.2018;2018;05;14;Keskiviikko;10;15;25;4;11;15
294;09.05.2018;2018;05;15;Keskiviikko;24;17;41;6;11;17
294;09.05.2018;2018;05;16;Keskiviikko;19;22;41;18;14;32
294;09.05.2018;2018;05;17;Keskiviikko;21;20;41;7;9;16
294;09.05.2018;2018;05;18;Keskiviikko;29;23;52;16;20;36
294;09.05.2018;2018;05;19;Keskiviikko;21;25;46;11;18;29
294;09.05.2018;2018;05;20;Keskiviikko;26;21;47;35;26;61
294;09.05.2018;2018;05;21;Keskiviikko;11;13;24;4;5;9
294;09.05.2018;2018;05;22;Keskiviikko;5;2;7;1;0;1
294;09.05.2018;2018;05;23;Keskiviikko;1;3;4;0;4;4
294;10.05.2018;2018;05;00;Torstai;4;0;4;0;0;0
294;10.05.2018;2018;05;01;Torstai;0;0;0;0;1;1
294;10.05.2018;2018;05;02;Torstai;0;2;2;0;0;0
294;10.05.2018;2018;05;03;Torstai;0;0;0;1;0;1
294;10.05.2018;2018;05;04;Torstai;0;0;0;0;0;0
294;10.05.2018;2018;05;05;Torstai;1;0;1;1;0;1
294;10.05.2018;2018;05;06;Torstai;1;0;1;1;2;3
294;10.05.2018;2018;05;07;Torstai;0;2;2;1;0;1
294;10.05.2018;2018;05;08;Torstai;6;3;9;6;2;8
294;10.05.2018;2018;05;09;Torstai;10;9;19;3;1;4
294;10.05.2018;2018;05;10;Torstai;12;13;25;4;4;8
294;10.05.2018;2018;05;11;Torstai;22;30;52;8;13;21
294;10.05.2018;2018;05;12;Torstai;29;22;51;16;10;26
294;10.05.2018;2018;05;13;Torstai;37;29;66;17;4;21
294;10.05.2018;2018;05;14;Torstai;43;37;80;8;0;8
294;10.05.2018;2018;05;15;Torstai;25;20;45;8;14;22
294;10.05.2018;2018;05;16;Torstai;27;32;59;12;19;31
294;10.05.2018;2018;05;17;Torstai;51;38;89;20;9;29
294;10.05.2018;2018;05;18;Torstai;22;28;50;11;11;22
294;10.05.2018;2018;05;19;Torstai;20;15;35;10;7;17
294;10.05.2018;2018;05;20;Torstai;16;22;38;9;13;22
294;10.05.2018;2018;05;21;Torstai;11;3;14;3;2;5
294;10.05.2018;2018;05;22;Torstai;1;3;4;0;0;0
294;10.05.2018;2018;05;23;Torstai;4;1;5;0;0;0
294;11.05.2018;2018;05;00;Perjantai;0;0;0;1;1;2
294;11.05.2018;2018;05;01;Perjantai;0;0;0;0;0;0
294;11.05.2018;2018;05;02;Perjantai;0;0;0;0;0;0
294;11.05.2018;2018;05;03;Perjantai;0;0;0;0;0;0
294;11.05.2018;2018;05;04;Perjantai;0;0;0;0;0;0
294;11.05.2018;2018;05;05;Perjantai;0;0;0;0;1;1
294;11.05.2018;2018;05;06;Perjantai;2;1;3;2;1;3
294;11.05.2018;2018;05;07;Perjantai;7;8;15;0;2;2
294;11.05.2018;2018;05;08;Perjantai;3;2;5;6;5;11
294;11.05.2018;2018;05;09;Perjantai;13;14;27;6;9;15
294;11.05.2018;2018;05;10;Perjantai;12;6;18;5;4;9
294;11.05.2018;2018;05;11;Perjantai;11;22;33;12;5;17
294;11.05.2018;2018;05;12;Perjantai;28;19;47;14;20;34
294;11.05.2018;2018;05;13;Perjantai;32;29;61;6;11;17
294;11.05.2018;2018;05;14;Perjantai;28;15;43;9;7;16
294;11.05.2018;2018;05;15;Perjantai;12;20;32;10;11;21
294;11.05.2018;2018;05;16;Perjantai;22;21;43;8;9;17
294;11.05.2018;2018;05;17;Perjantai;30;27;57;12;18;30
294;11.05.2018;2018;05;18;Perjantai;28;21;49;14;10;24
294;11.05.2018;2018;05;19;Perjantai;36;18;54;13;17;30
294;11.05.2018;2018;05;20;Perjantai;22;12;34;4;4;8
294;11.05.2018;2018;05;21;Perjantai;15;8;23;3;8;11
294;11.05.2018;2018;05;22;Perjantai;2;6;8;3;3;6
294;11.05.2018;2018;05;23;Perjantai;3;1;4;0;0;0
294;12.05.2018;2018;05;00;Lauantai;1;2;3;0;0;0
294;12.05.2018;2018;05;01;Lauantai;0;0;0;0;0;0
294;12.05.2018;2018;05;02;Lauantai;0;0;0;0;0;0
294;12.05.2018;2018;05;03;Lauantai;0;0;0;0;1;1
294;12.05.2018;2018;05;04;Lauantai;1;0;1;2;0;2
294;12.05.2018;2018;05;05;Lauantai;1;1;2;0;0;0
294;12.05.2018;2018;05;06;Lauantai;1;1;2;0;0;0
294;12.05.2018;2018;05;07;Lauantai;2;3;5;1;2;3
294;12.05.2018;2018;05;08;Lauantai;7;2;9;1;2;3
294;12.05.2018;2018;05;09;Lauantai;12;13;25;5;3;8
294;12.05.2018;2018;05;10;Lauantai;16;7;23;10;5;15
294;12.05.2018;2018;05;11;Lauantai;28;29;57;11;9;20
294;12.05.2018;2018;05;12;Lauantai;49;31;80;13;6;19
294;12.05.2018;2018;05;13;Lauantai;42;48;90;12;12;24
294;12.05.2018;2018;05;14;Lauantai;43;46;89;14;18;32
294;12.05.2018;2018;05;15;Lauantai;45;40;85;15;9;24
294;12.05.2018;2018;05;16;Lauantai;29;33;62;8;12;20
294;12.05.2018;2018;05;17;Lauantai;22;20;42;12;8;20
294;12.05.2018;2018;05;18;Lauantai;18;21;39;12;9;21
294;12.05.2018;2018;05;19;Lauantai;19;13;32;9;6;15
294;12.05.2018;2018;05;20;Lauantai;24;17;41;5;9;14
294;12.05.2018;2018;05;21;Lauantai;13;11;24;2;1;3
294;12.05.2018;2018;05;22;Lauantai;4;11;15;2;1;3
294;12.05.2018;2018;05;23;Lauantai;0;2;2;3;1;4
294;13.05.2018;2018;05;00;Sunnuntai;1;0;1;0;0;0
294;13.05.2018;2018;05;01;Sunnuntai;0;0;0;0;0;0
294;13.05.2018;2018;05;02;Sunnuntai;0;0;0;0;0;0
294;13.05.2018;2018;05;03;Sunnuntai;0;0;0;0;0;0
294;13.05.2018;2018;05;04;Sunnuntai;0;0;0;0;0;0
294;13.05.2018;2018;05;05;Sunnuntai;0;0;0;0;0;0
294;13.05.2018;2018;05;06;Sunnuntai;0;0;0;0;0;0
294;13.05.2018;2018;05;07;Sunnuntai;0;2;2;2;0;2
294;13.05.2018;2018;05;08;Sunnuntai;0;2;2;4;1;5
294;13.05.2018;2018;05;09;Sunnuntai;7;4;11;6;5;11
294;13.05.2018;2018;05;10;Sunnuntai;19;9;28;4;7;11
294;13.05.2018;2018;05;11;Sunnuntai;8;16;24;4;3;7
294;13.05.2018;2018;05;12;Sunnuntai;21;14;35;4;5;9
294;13.05.2018;2018;05;13;Sunnuntai;15;10;25;4;4;8
294;13.05.2018;2018;05;14;Sunnuntai;22;21;43;6;6;12
294;13.05.2018;2018;05;15;Sunnuntai;14;13;27;7;8;15
294;13.05.2018;2018;05;16;Sunnuntai;14;13;27;7;4;11
294;13.05.2018;2018;05;17;Sunnuntai;27;34;61;4;9;13
294;13.05.2018;2018;05;18;Sunnuntai;23;24;47;7;9;16
294;13.05.2018;2018;05;19;Sunnuntai;25;15;40;2;5;7
294;13.05.2018;2018;05;20;Sunnuntai;12;13;25;11;8;19
294;13.05.2018;2018;05;21;Sunnuntai;1;3;4;5;3;8
294;13.05.2018;2018;05;22;Sunnuntai;2;0;2;1;0;1
294;13.05.2018;2018;05;23;Sunnuntai;0;0;0;1;0;1
294;14.05.2018;2018;05;00;Maanantai;0;0;0;0;0;0
294;14.05.2018;2018;05;01;Maanantai;0;0;0;0;0;0
294;14.05.2018;2018;05;02;Maanantai;0;0;0;0;0;0
294;14.05.2018;2018;05;03;Maanantai;0;0;0;0;0;0
294;14.05.2018;2018;05;04;Maanantai;0;0;0;0;0;0
294;14.05.2018;2018;05;05;Maanantai;0;3;3;1;1;2
294;14.05.2018;2018;05;06;Maanantai;2;1;3;1;0;1
294;14.05.2018;2018;05;07;Maanantai;10;12;22;5;0;5
294;14.05.2018;2018;05;08;Maanantai;24;12;36;10;8;18
294;14.05.2018;2018;05;09;Maanantai;18;11;29;9;6;15
294;14.05.2018;2018;05;10;Maanantai;16;11;27;11;8;19
294;14.05.2018;2018;05;11;Maanantai;14;29;43;15;18;33
294;14.05.2018;2018;05;12;Maanantai;18;11;29;14;14;28
294;14.05.2018;2018;05;13;Maanantai;19;15;34;2;2;4
294;14.05.2018;2018;05;14;Maanantai;14;19;33;10;10;20
294;14.05.2018;2018;05;15;Maanantai;11;26;37;8;10;18
294;14.05.2018;2018;05;16;Maanantai;29;20;49;9;8;17
294;14.05.2018;2018;05;17;Maanantai;24;26;50;10;5;15
294;14.05.2018;2018;05;18;Maanantai;34;27;61;9;10;19
294;14.05.2018;2018;05;19;Maanantai;27;28;55;11;17;28
294;14.05.2018;2018;05;20;Maanantai;14;9;23;5;8;13
294;14.05.2018;2018;05;21;Maanantai;5;2;7;2;4;6
294;14.05.2018;2018;05;22;Maanantai;3;0;3;3;0;3
294;14.05.2018;2018;05;23;Maanantai;1;0;1;1;0;1
294;15.05.2018;2018;05;00;Tiistai;0;0;0;0;0;0
294;15.05.2018;2018;05;01;Tiistai;0;0;0;0;0;0
294;15.05.2018;2018;05;02;Tiistai;0;0;0;0;0;0
294;15.05.2018;2018;05;03;Tiistai;0;0;0;0;0;0
294;15.05.2018;2018;05;04;Tiistai;0;0;0;0;0;0
294;15.05.2018;2018;05;05;Tiistai;0;0;0;2;2;4
294;15.05.2018;2018;05;06;Tiistai;3;5;8;1;1;2
294;15.05.2018;2018;05;07;Tiistai;19;13;32;4;2;6
294;15.05.2018;2018;05;08;Tiistai;25;14;39;9;3;12
294;15.05.2018;2018;05;09;Tiistai;20;10;30;5;5;10
294;15.05.2018;2018;05;10;Tiistai;13;9;22;15;5;20
294;15.05.2018;2018;05;11;Tiistai;12;15;27;24;25;49
294;15.05.2018;2018;05;12;Tiistai;16;18;34;9;10;19
294;15.05.2018;2018;05;13;Tiistai;15;16;31;8;9;17
294;15.05.2018;2018;05;14;Tiistai;22;19;41;8;5;13
294;15.05.2018;2018;05;15;Tiistai;27;45;72;4;17;21
294;15.05.2018;2018;05;16;Tiistai;40;30;70;12;12;24
294;15.05.2018;2018;05;17;Tiistai;20;42;62;16;14;30
294;15.05.2018;2018;05;18;Tiistai;24;30;54;15;12;27
294;15.05.2018;2018;05;19;Tiistai;28;23;51;17;12;29
294;15.05.2018;2018;05;20;Tiistai;20;14;34;5;14;19
294;15.05.2018;2018;05;21;Tiistai;5;3;8;2;2;4
294;15.05.2018;2018;05;22;Tiistai;0;2;2;0;0;0
294;15.05.2018;2018;05;23;Tiistai;0;0;0;0;1;1
294;16.05.2018;2018;05;00;Keskiviikko;0;0;0;0;0;0
294;16.05.2018;2018;05;01;Keskiviikko;0;0;0;0;0;0
294;16.05.2018;2018;05;02;Keskiviikko;0;0;0;0;0;0
294;16.05.2018;2018;05;03;Keskiviikko;0;0;0;0;0;0
294;16.05.2018;2018;05;04;Keskiviikko;1;0;1;1;0;1
294;16.05.2018;2018;05;05;Keskiviikko;0;0;0;1;0;1
294;16.05.2018;2018;05;06;Keskiviikko;4;0;4;1;0;1
294;16.05.2018;2018;05;07;Keskiviikko;11;7;18;1;1;2
294;16.05.2018;2018;05;08;Keskiviikko;20;18;38;9;7;16
294;16.05.2018;2018;05;09;Keskiviikko;13;8;21;5;4;9
294;16.05.2018;2018;05;10;Keskiviikko;9;19;28;13;23;36
294;16.05.2018;2018;05;11;Keskiviikko;27;16;43;21;11;32
294;16.05.2018;2018;05;12;Keskiviikko;33;20;53;6;10;16
294;16.05.2018;2018;05;13;Keskiviikko;20;21;41;9;4;13
294;16.05.2018;2018;05;14;Keskiviikko;24;35;59;8;12;20
294;16.05.2018;2018;05;15;Keskiviikko;35;24;59;13;5;18
294;16.05.2018;2018;05;16;Keskiviikko;21;26;47;7;5;12
294;16.05.2018;2018;05;17;Keskiviikko;18;21;39;5;6;11
294;16.05.2018;2018;05;18;Keskiviikko;31;37;68;7;7;14
294;16.05.2018;2018;05;19;Keskiviikko;33;24;57;9;14;23
294;16.05.2018;2018;05;20;Keskiviikko;10;21;31;13;12;25
294;16.05.2018;2018;05;21;Keskiviikko;16;8;24;3;4;7
294;16.05.2018;2018;05;22;Keskiviikko;0;0;0;1;1;2
294;16.05.2018;2018;05;23;Keskiviikko;0;0;0;2;0;2
294;17.05.2018;2018;05;00;Torstai;0;0;0;0;0;0
294;17.05.2018;2018;05;01;Torstai;0;0;0;0;0;0
294;17.05.2018;2018;05;02;Torstai;0;0;0;0;0;0
294;17.05.2018;2018;05;03;Torstai;0;0;0;0;0;0
294;17.05.2018;2018;05;04;Torstai;0;0;0;0;0;0
294;17.05.2018;2018;05;05;Torstai;0;1;1;0;1;1
294;17.05.2018;2018;05;06;Torstai;2;4;6;2;2;4
294;17.05.2018;2018;05;07;Torstai;8;0;8;2;1;3
294;17.05.2018;2018;05;08;Torstai;23;16;39;1;1;2
294;17.05.2018;2018;05;09;Torstai;20;15;35;14;6;20
294;17.05.2018;2018;05;10;Torstai;13;9;22;5;15;20
294;17.05.2018;2018;05;11;Torstai;21;13;34;15;13;28
294;17.05.2018;2018;05;12;Torstai;12;17;29;9;14;23
294;17.05.2018;2018;05;13;Torstai;12;26;38;10;20;30
294;17.05.2018;2018;05;14;Torstai;20;17;37;11;9;20
294;17.05.2018;2018;05;15;Torstai;23;25;48;28;10;38
294;17.05.2018;2018;05;16;Torstai;27;23;50;7;16;23
294;17.05.2018;2018;05;17;Torstai;15;18;33;2;8;10
294;17.05.2018;2018;05;18;Torstai;17;16;33;10;6;16
294;17.05.2018;2018;05;19;Torstai;24;13;37;4;12;16
294;17.05.2018;2018;05;20;Torstai;11;6;17;4;1;5
294;17.05.2018;2018;05;21;Torstai;1;1;2;5;1;6
294;17.05.2018;2018;05;22;Torstai;0;1;1;0;0;0
294;17.05.2018;2018;05;23;Torstai;0;0;0;1;0;1
294;18.05.2018;2018;05;00;Perjantai;1;0;1;0;0;0
294;18.05.2018;2018;05;01;Perjantai;0;0;0;0;0;0
294;18.05.2018;2018;05;02;Perjantai;0;0;0;0;0;0
294;18.05.2018;2018;05;03;Perjantai;0;0;0;0;0;0
294;18.05.2018;2018;05;04;Perjantai;0;0;0;0;0;0
294;18.05.2018;2018;05;05;Perjantai;0;0;0;0;1;1
294;18.05.2018;2018;05;06;Perjantai;2;1;3;1;0;1
294;18.05.2018;2018;05;07;Perjantai;16;8;24;5;0;5
294;18.05.2018;2018;05;08;Perjantai;10;5;15;7;13;20
294;18.05.2018;2018;05;09;Perjantai;16;12;28;12;7;19
294;18.05.2018;2018;05;10;Perjantai;10;20;30;2;10;12
294;18.05.2018;2018;05;11;Perjantai;15;11;26;28;7;35
294;18.05.2018;2018;05;12;Perjantai;12;21;33;11;14;25
294;18.05.2018;2018;05;13;Perjantai;12;12;24;5;9;14
294;18.05.2018;2018;05;14;Perjantai;14;39;53;14;17;31
294;18.05.2018;2018;05;15;Perjantai;16;11;27;17;12;29
294;18.05.2018;2018;05;16;Perjantai;14;15;29;6;10;16
294;18.05.2018;2018;05;17;Perjantai;9;10;19;7;6;13
294;18.05.2018;2018;05;18;Perjantai;21;21;42;5;8;13
294;18.05.2018;2018;05;19;Perjantai;14;6;20;8;9;17
294;18.05.2018;2018;05;20;Perjantai;22;29;51;6;10;16
294;18.05.2018;2018;05;21;Perjantai;16;16;32;3;2;5
294;18.05.2018;2018;05;22;Perjantai;9;2;11;2;0;2
294;18.05.2018;2018;05;23;Perjantai;4;1;5;3;1;4
294;19.05.2018;2018;05;00;Lauantai;1;0;1;1;1;2
294;19.05.2018;2018;05;01;Lauantai;1;0;1;0;0;0
294;19.05.2018;2018;05;02;Lauantai;0;1;1;0;0;0
294;19.05.2018;2018;05;03;Lauantai;0;0;0;0;0;0
294;19.05.2018;2018;05;04;Lauantai;0;0;0;0;0;0
294;19.05.2018;2018;05;05;Lauantai;1;0;1;0;0;0
294;19.05.2018;2018;05;06;Lauantai;0;0;0;0;1;1
294;19.05.2018;2018;05;07;Lauantai;1;3;4;0;1;1
294;19.05.2018;2018;05;08;Lauantai;1;6;7;1;1;2
294;19.05.2018;2018;05;09;Lauantai;5;7;12;10;5;15
294;19.05.2018;2018;05;10;Lauantai;10;11;21;2;2;4
294;19.05.2018;2018;05;11;Lauantai;22;20;42;5;4;9
294;19.05.2018;2018;05;12;Lauantai;27;20;47;3;12;15
294;19.05.2018;2018;05;13;Lauantai;27;26;53;11;3;14
294;19.05.2018;2018;05;14;Lauantai;25;21;46;6;13;19
294;19.05.2018;2018;05;15;Lauantai;23;20;43;15;11;26
294;19.05.2018;2018;05;16;Lauantai;29;20;49;14;3;17
294;19.05.2018;2018;05;17;Lauantai;15;20;35;6;11;17
294;19.05.2018;2018;05;18;Lauantai;19;10;29;4;7;11
294;19.05.2018;2018;05;19;Lauantai;21;25;46;12;5;17
294;19.05.2018;2018;05;20;Lauantai;10;11;21;6;11;17
294;19.05.2018;2018;05;21;Lauantai;9;8;17;2;4;6
294;19.05.2018;2018;05;22;Lauantai;3;2;5;2;2;4
294;19.05.2018;2018;05;23;Lauantai;3;3;6;3;2;5
294;20.05.2018;2018;05;00;Sunnuntai;3;1;4;0;0;0
294;20.05.2018;2018;05;01;Sunnuntai;0;0;0;1;0;1
294;20.05.2018;2018;05;02;Sunnuntai;0;0;0;3;0;3
294;20.05.2018;2018;05;03;Sunnuntai;0;0;0;0;1;1
294;20.05.2018;2018;05;04;Sunnuntai;0;1;1;0;0;0
294;20.05.2018;2018;05;05;Sunnuntai;0;0;0;0;0;0
294;20.05.2018;2018;05;06;Sunnuntai;0;3;3;0;0;0
294;20.05.2018;2018;05;07;Sunnuntai;0;1;1;0;0;0
294;20.05.2018;2018;05;08;Sunnuntai;1;1;2;0;1;1
294;20.05.2018;2018;05;09;Sunnuntai;10;3;13;3;4;7
294;20.05.2018;2018;05;10;Sunnuntai;9;7;16;4;6;10
294;20.05.2018;2018;05;11;Sunnuntai;8;13;21;7;10;17
294;20.05.2018;2018;05;12;Sunnuntai;21;14;35;8;8;16
294;20.05.2018;2018;05;13;Sunnuntai;18;21;39;5;4;9
294;20.05.2018;2018;05;14;Sunnuntai;17;19;36;6;9;15
294;20.05.2018;2018;05;15;Sunnuntai;14;7;21;4;4;8
294;20.05.2018;2018;05;16;Sunnuntai;18;20;38;7;6;13
294;20.05.2018;2018;05;17;Sunnuntai;12;10;22;11;4;15
294;20.05.2018;2018;05;18;Sunnuntai;16;22;38;3;5;8
294;20.05.2018;2018;05;19;Sunnuntai;11;8;19;4;6;10
294;20.05.2018;2018;05;20;Sunnuntai;18;19;37;7;8;15
294;20.05.2018;2018;05;21;Sunnuntai;8;16;24;3;3;6
294;20.05.2018;2018;05;22;Sunnuntai;1;0;1;0;0;0
294;20.05.2018;2018;05;23;Sunnuntai;0;0;0;1;0;1
294;21.05.2018;2018;05;00;Maanantai;0;0;0;0;0;0
294;21.05.2018;2018;05;01;Maanantai;0;0;0;0;0;0
294;21.05.2018;2018;05;02;Maanantai;0;0;0;0;0;0
294;21.05.2018;2018;05;03;Maanantai;0;0;0;0;0;0
294;21.05.2018;2018;05;04;Maanantai;0;0;0;0;0;0
294;21.05.2018;2018;05;05;Maanantai;2;2;4;0;3;3
294;21.05.2018;2018;05;06;Maanantai;1;6;7;1;0;1
294;21.05.2018;2018;05;07;Maanantai;13;7;20;4;5;9
294;21.05.2018;2018;05;08;Maanantai;23;13;36;10;6;16
294;21.05.2018;2018;05;09;Maanantai;20;12;32;8;10;18
294;21.05.2018;2018;05;10;Maanantai;9;10;19;15;14;29
294;21.05.2018;2018;05;11;Maanantai;13;16;29;19;22;41
294;21.05.2018;2018;05;12;Maanantai;10;15;25;11;8;19
294;21.05.2018;2018;05;13;Maanantai;14;9;23;9;6;15
294;21.05.2018;2018;05;14;Maanantai;28;17;45;15;17;32
294;21.05.2018;2018;05;15;Maanantai;17;39;56;14;12;26
294;21.05.2018;2018;05;16;Maanantai;27;18;45;10;8;18
294;21.05.2018;2018;05;17;Maanantai;26;18;44;12;12;24
294;21.05.2018;2018;05;18;Maanantai;19;32;51;10;13;23
294;21.05.2018;2018;05;19;Maanantai;18;14;32;9;6;15
294;21.05.2018;2018;05;20;Maanantai;8;16;24;10;6;16
294;21.05.2018;2018;05;21;Maanantai;7;5;12;2;6;8
294;21.05.2018;2018;05;22;Maanantai;5;1;6;0;0;0
294;21.05.2018;2018;05;23;Maanantai;0;0;0;1;1;2
294;22.05.2018;2018;05;00;Tiistai;0;0;0;0;0;0
294;22.05.2018;2018;05;01;Tiistai;0;0;0;0;0;0
294;22.05.2018;2018;05;02;Tiistai;0;0;0;0;0;0
294;22.05.2018;2018;05;03;Tiistai;0;0;0;0;0;0
294;22.05.2018;2018;05;04;Tiistai;0;0;0;0;0;0
294;22.05.2018;2018;05;05;Tiistai;0;0;0;0;0;0
294;22.05.2018;2018;05;06;Tiistai;4;2;6;1;1;2
294;22.05.2018;2018;05;07;Tiistai;27;7;34;5;4;9
294;22.05.2018;2018;05;08;Tiistai;23;12;35;4;7;11
294;22.05.2018;2018;05;09;Tiistai;17;14;31;5;5;10
294;22.05.2018;2018;05;10;Tiistai;13;13;26;9;18;27
294;22.05.2018;2018;05;11;Tiistai;18;14;32;23;10;33
294;22.05.2018;2018;05;12;Tiistai;9;12;21;12;12;24
294;22.05.2018;2018;05;13;Tiistai;19;14;33;6;4;10
294;22.05.2018;2018;05;14;Tiistai;20;18;38;11;9;20
294;22.05.2018;2018;05;15;Tiistai;25;51;76;9;6;15
294;22.05.2018;2018;05;16;Tiistai;36;36;72;7;7;14
294;22.05.2018;2018;05;17;Tiistai;30;43;73;14;11;25
294;22.05.2018;2018;05;18;Tiistai;24;23;47;16;11;27
294;22.05.2018;2018;05;19;Tiistai;27;35;62;9;15;24
294;22.05.2018;2018;05;20;Tiistai;15;19;34;5;6;11
294;22.05.2018;2018;05;21;Tiistai;5;2;7;5;3;8
294;22.05.2018;2018;05;22;Tiistai;3;0;3;2;2;4
294;22.05.2018;2018;05;23;Tiistai;0;0;0;0;1;1
294;23.05.2018;2018;05;00;Keskiviikko;0;0;0;0;0;0
294;23.05.2018;2018;05;01;Keskiviikko;0;0;0;0;0;0
294;23.05.2018;2018;05;02;Keskiviikko;0;0;0;0;0;0
294;23.05.2018;2018;05;03;Keskiviikko;0;0;0;0;0;0
294;23.05.2018;2018;05;04;Keskiviikko;0;0;0;0;0;0
294;23.05.2018;2018;05;05;Keskiviikko;0;0;0;0;0;0
294;23.05.2018;2018;05;06;Keskiviikko;7;0;7;2;3;5
294;23.05.2018;2018;05;07;Keskiviikko;15;7;22;2;1;3
294;23.05.2018;2018;05;08;Keskiviikko;9;7;16;5;4;9
294;23.05.2018;2018;05;09;Keskiviikko;21;19;40;7;1;8
294;23.05.2018;2018;05;10;Keskiviikko;5;7;12;8;12;20
294;23.05.2018;2018;05;11;Keskiviikko;9;7;16;8;12;20
294;23.05.2018;2018;05;12;Keskiviikko;13;17;30;40;36;76
294;23.05.2018;2018;05;13;Keskiviikko;20;30;50;12;11;23
294;23.05.2018;2018;05;14;Keskiviikko;16;24;40;11;10;21
294;23.05.2018;2018;05;15;Keskiviikko;22;24;46;8;18;26
294;23.05.2018;2018;05;16;Keskiviikko;19;22;41;11;6;17
294;23.05.2018;2018;05;17;Keskiviikko;19;29;48;6;8;14
294;23.05.2018;2018;05;18;Keskiviikko;16;14;30;7;7;14
294;23.05.2018;2018;05;19;Keskiviikko;23;12;35;4;11;15
294;23.05.2018;2018;05;20;Keskiviikko;7;6;13;14;7;21
294;23.05.2018;2018;05;21;Keskiviikko;2;5;7;0;1;1
294;23.05.2018;2018;05;22;Keskiviikko;0;0;0;0;0;0
294;23.05.2018;2018;05;23;Keskiviikko;0;0;0;1;0;1
294;24.05.2018;2018;05;00;Torstai;0;0;0;0;0;0
294;24.05.2018;2018;05;01;Torstai;0;0;0;0;0;0
294;24.05.2018;2018;05;02;Torstai;0;0;0;0;0;0
294;24.05.2018;2018;05;03;Torstai;0;0;0;0;0;0
294;24.05.2018;2018;05;04;Torstai;1;0;1;0;0;0
294;24.05.2018;2018;05;05;Torstai;0;0;0;0;0;0
294;24.05.2018;2018;05;06;Torstai;1;0;1;1;2;3
294;24.05.2018;2018;05;07;Torstai;11;8;19;6;2;8
294;24.05.2018;2018;05;08;Torstai;26;4;30;5;2;7
294;24.05.2018;2018;05;09;Torstai;12;9;21;5;8;13
294;24.05.2018;2018;05;10;Torstai;8;12;20;3;7;10
294;24.05.2018;2018;05;11;Torstai;9;18;27;5;5;10
294;24.05.2018;2018;05;12;Torstai;3;12;15;8;11;19
294;24.05.2018;2018;05;13;Torstai;10;17;27;9;5;14
294;24.05.2018;2018;05;14;Torstai;14;16;30;9;11;20
294;24.05.2018;2018;05;15;Torstai;17;29;46;7;6;13
294;24.05.2018;2018;05;16;Torstai;18;16;34;8;6;14
294;24.05.2018;2018;05;17;Torstai;6;8;14;6;9;15
294;24.05.2018;2018;05;18;Torstai;12;17;29;18;18;36
294;24.05.2018;2018;05;19;Torstai;17;8;25;8;9;17
294;24.05.2018;2018;05;20;Torstai;3;9;12;2;4;6
294;24.05.2018;2018;05;21;Torstai;1;5;6;2;1;3
294;24.05.2018;2018;05;22;Torstai;3;0;3;1;0;1
294;24.05.2018;2018;05;23;Torstai;0;0;0;0;0;0
294;25.05.2018;2018;05;00;Perjantai;0;0;0;0;0;0
294;25.05.2018;2018;05;01;Perjantai;0;0;0;0;0;0
294;25.05.2018;2018;05;02;Perjantai;0;0;0;0;0;0
294;25.05.2018;2018;05;03;Perjantai;0;0;0;0;1;1
294;25.05.2018;2018;05;04;Perjantai;1;0;1;0;0;0
294;25.05.2018;2018;05;05;Perjantai;0;0;0;0;0;0
294;25.05.2018;2018;05;06;Perjantai;0;5;5;1;1;2
294;25.05.2018;2018;05;07;Perjantai;19;6;25;7;2;9
294;25.05.2018;2018;05;08;Perjantai;15;3;18;4;4;8
294;25.05.2018;2018;05;09;Perjantai;10;1;11;2;1;3
294;25.05.2018;2018;05;10;Perjantai;23;20;43;16;17;33
294;25.05.2018;2018;05;11;Perjantai;21;18;39;18;13;31
294;25.05.2018;2018;05;12;Perjantai;28;31;59;15;15;30
294;25.05.2018;2018;05;13;Perjantai;22;12;34;10;6;16
294;25.05.2018;2018;05;14;Perjantai;16;25;41;11;9;20
294;25.05.2018;2018;05;15;Perjantai;34;22;56;8;6;14
294;25.05.2018;2018;05;16;Perjantai;20;17;37;5;10;15
294;25.05.2018;2018;05;17;Perjantai;17;22;39;12;11;23
294;25.05.2018;2018;05;18;Perjantai;29;18;47;12;9;21
294;25.05.2018;2018;05;19;Perjantai;26;20;46;6;8;14
294;25.05.2018;2018;05;20;Perjantai;29;26;55;5;10;15
294;25.05.2018;2018;05;21;Perjantai;7;13;20;7;8;15
294;25.05.2018;2018;05;22;Perjantai;12;1;13;2;2;4
294;25.05.2018;2018;05;23;Perjantai;2;0;2;0;0;0
294;26.05.2018;2018;05;00;Lauantai;2;0;2;2;2;4
294;26.05.2018;2018;05;01;Lauantai;2;5;7;0;1;1
294;26.05.2018;2018;05;02;Lauantai;3;0;3;0;0;0
294;26.05.2018;2018;05;03;Lauantai;0;0;0;0;1;1
294;26.05.2018;2018;05;04;Lauantai;1;0;1;0;1;1
294;26.05.2018;2018;05;05;Lauantai;0;0;0;0;0;0
294;26.05.2018;2018;05;06;Lauantai;1;1;2;0;0;0
294;26.05.2018;2018;05;07;Lauantai;0;1;1;0;1;1
294;26.05.2018;2018;05;08;Lauantai;5;2;7;2;2;4
294;26.05.2018;2018;05;09;Lauantai;7;6;13;4;2;6
294;26.05.2018;2018;05;10;Lauantai;13;13;26;7;4;11
294;26.05.2018;2018;05;11;Lauantai;16;12;28;7;9;16
294;26.05.2018;2018;05;12;Lauantai;15;28;43;8;11;19
294;26.05.2018;2018;05;13;Lauantai;28;25;53;10;5;15
294;26.05.2018;2018;05;14;Lauantai;14;17;31;12;10;22
294;26.05.2018;2018;05;15;Lauantai;18;12;30;12;9;21
294;26.05.2018;2018;05;16;Lauantai;22;23;45;8;4;12
294;26.05.2018;2018;05;17;Lauantai;18;20;38;8;4;12
294;26.05.2018;2018;05;18;Lauantai;9;13;22;6;8;14
294;26.05.2018;2018;05;19;Lauantai;20;15;35;7;7;14
294;26.05.2018;2018;05;20;Lauantai;21;9;30;4;1;5
294;26.05.2018;2018;05;21;Lauantai;7;14;21;0;1;1
294;26.05.2018;2018;05;22;Lauantai;1;2;3;0;2;2
294;26.05.2018;2018;05;23;Lauantai;4;1;5;3;0;3
294;27.05.2018;2018;05;00;Sunnuntai;0;0;0;0;0;0
294;27.05.2018;2018;05;01;Sunnuntai;2;0;2;0;0;0
294;27.05.2018;2018;05;02;Sunnuntai;0;0;0;1;0;1
294;27.05.2018;2018;05;03;Sunnuntai;0;0;0;0;1;1
294;27.05.2018;2018;05;04;Sunnuntai;1;1;2;0;0;0
294;27.05.2018;2018;05;05;Sunnuntai;0;0;0;1;0;1
294;27.05.2018;2018;05;06;Sunnuntai;1;3;4;1;0;1
294;27.05.2018;2018;05;07;Sunnuntai;2;0;2;0;1;1
294;27.05.2018;2018;05;08;Sunnuntai;3;0;3;2;2;4
294;27.05.2018;2018;05;09;Sunnuntai;2;5;7;2;6;8
294;27.05.2018;2018;05;10;Sunnuntai;5;2;7;8;7;15
294;27.05.2018;2018;05;11;Sunnuntai;8;7;15;18;5;23
294;27.05.2018;2018;05;12;Sunnuntai;19;18;37;13;6;19
294;27.05.2018;2018;05;13;Sunnuntai;14;26;40;9;10;19
294;27.05.2018;2018;05;14;Sunnuntai;24;16;40;4;5;9
294;27.05.2018;2018;05;15;Sunnuntai;14;23;37;2;5;7
294;27.05.2018;2018;05;16;Sunnuntai;30;13;43;8;2;10
294;27.05.2018;2018;05;17;Sunnuntai;10;8;18;3;4;7
294;27.05.2018;2018;05;18;Sunnuntai;29;13;42;6;8;14
294;27.05.2018;2018;05;19;Sunnuntai;21;22;43;6;6;12
294;27.05.2018;2018;05;20;Sunnuntai;6;19;25;4;8;12
294;27.05.2018;2018;05;21;Sunnuntai;3;4;7;2;1;3
294;27.05.2018;2018;05;22;Sunnuntai;0;0;0;1;0;1
294;27.05.2018;2018;05;23;Sunnuntai;0;0;0;0;0;0
294;28.05.2018;2018;05;00;Maanantai;0;0;0;0;0;0
294;28.05.2018;2018;05;01;Maanantai;0;0;0;0;0;0
294;28.05.2018;2018;05;02;Maanantai;0;0;0;0;0;0
294;28.05.2018;2018;05;03;Maanantai;0;0;0;0;0;0
294;28.05.2018;2018;05;04;Maanantai;0;0;0;0;0;0
294;28.05.2018;2018;05;05;Maanantai;0;0;0;2;0;2
294;28.05.2018;2018;05;06;Maanantai;1;4;5;2;1;3
294;28.05.2018;2018;05;07;Maanantai;14;6;20;1;1;2
294;28.05.2018;2018;05;08;Maanantai;34;8;42;5;4;9
294;28.05.2018;2018;05;09;Maanantai;10;4;14;4;4;8
294;28.05.2018;2018;05;10;Maanantai;16;7;23;6;8;14
294;28.05.2018;2018;05;11;Maanantai;17;10;27;27;4;31
294;28.05.2018;2018;05;12;Maanantai;30;17;47;51;7;58
294;28.05.2018;2018;05;13;Maanantai;38;87;125;35;9;44
294;28.05.2018;2018;05;14;Maanantai;20;19;39;13;12;25
294;28.05.2018;2018;05;15;Maanantai;14;17;31;24;7;31
294;28.05.2018;2018;05;16;Maanantai;29;22;51;6;6;12
294;28.05.2018;2018;05;17;Maanantai;17;17;34;9;11;20
294;28.05.2018;2018;05;18;Maanantai;22;34;56;5;13;18
294;28.05.2018;2018;05;19;Maanantai;14;17;31;12;10;22
294;28.05.2018;2018;05;20;Maanantai;10;12;22;4;4;8
294;28.05.2018;2018;05;21;Maanantai;1;6;7;1;4;5
294;28.05.2018;2018;05;22;Maanantai;4;3;7;2;0;2
294;28.05.2018;2018;05;23;Maanantai;6;3;9;7;5;12
294;29.05.2018;2018;05;00;Tiistai;0;0;0;0;0;0
294;29.05.2018;2018;05;01;Tiistai;0;0;0;0;0;0
294;29.05.2018;2018;05;02;Tiistai;0;0;0;0;0;0
294;29.05.2018;2018;05;03;Tiistai;0;0;0;0;0;0
294;29.05.2018;2018;05;04;Tiistai;0;0;0;0;0;0
294;29.05.2018;2018;05;05;Tiistai;0;0;0;0;0;0
294;29.05.2018;2018;05;06;Tiistai;2;1;3;0;1;1
294;29.05.2018;2018;05;07;Tiistai;17;4;21;16;0;16
294;29.05.2018;2018;05;08;Tiistai;17;13;30;51;3;54
294;29.05.2018;2018;05;09;Tiistai;12;12;24;20;6;26
294;29.05.2018;2018;05;10;Tiistai;11;8;19;15;33;48
294;29.05.2018;2018;05;11;Tiistai;9;16;25;129;7;136
294;29.05.2018;2018;05;12;Tiistai;14;14;28;126;5;131
294;29.05.2018;2018;05;13;Tiistai;23;16;39;28;9;37
294;29.05.2018;2018;05;14;Tiistai;15;16;31;109;6;115
294;29.05.2018;2018;05;15;Tiistai;18;23;41;86;12;98
294;29.05.2018;2018;05;16;Tiistai;11;21;32;13;10;23
294;29.05.2018;2018;05;17;Tiistai;23;12;35;9;15;24
294;29.05.2018;2018;05;18;Tiistai;21;17;38;10;5;15
294;29.05.2018;2018;05;19;Tiistai;6;12;18;14;7;21
294;29.05.2018;2018;05;20;Tiistai;17;12;29;5;8;13
294;29.05.2018;2018;05;21;Tiistai;4;7;11;1;2;3
294;29.05.2018;2018;05;22;Tiistai;3;1;4;2;1;3
294;29.05.2018;2018;05;23;Tiistai;0;1;1;1;0;1
294;30.05.2018;2018;05;00;Keskiviikko;1;0;1;0;0;0
294;30.05.2018;2018;05;01;Keskiviikko;0;0;0;0;0;0
294;30.05.2018;2018;05;02;Keskiviikko;0;0;0;0;0;0
294;30.05.2018;2018;05;03;Keskiviikko;0;0;0;0;0;0
294;30.05.2018;2018;05;04;Keskiviikko;1;0;1;0;0;0
294;30.05.2018;2018;05;05;Keskiviikko;0;0;0;0;0;0
294;30.05.2018;2018;05;06;Keskiviikko;2;0;2;8;1;9
294;30.05.2018;2018;05;07;Keskiviikko;13;9;22;99;0;99
294;30.05.2018;2018;05;08;Keskiviikko;23;7;30;246;4;250
294;30.05.2018;2018;05;09;Keskiviikko;8;4;12;69;9;78
294;30.05.2018;2018;05;10;Keskiviikko;7;9;16;11;9;20
294;30.05.2018;2018;05;11;Keskiviikko;11;16;27;24;16;40
294;30.05.2018;2018;05;12;Keskiviikko;22;21;43;19;18;37
294;30.05.2018;2018;05;13;Keskiviikko;13;13;26;124;12;136
294;30.05.2018;2018;05;14;Keskiviikko;15;18;33;12;10;22
294;30.05.2018;2018;05;15;Keskiviikko;16;13;29;18;8;26
294;30.05.2018;2018;05;16;Keskiviikko;12;10;22;12;4;16
294;30.05.2018;2018;05;17;Keskiviikko;15;17;32;6;11;17
294;30.05.2018;2018;05;18;Keskiviikko;25;19;44;15;19;34
294;30.05.2018;2018;05;19;Keskiviikko;14;13;27;64;4;68
294;30.05.2018;2018;05;20;Keskiviikko;5;11;16;5;4;9
294;30.05.2018;2018;05;21;Keskiviikko;5;1;6;6;4;10
294;30.05.2018;2018;05;22;Keskiviikko;0;0;0;1;2;3
294;30.05.2018;2018;05;23;Keskiviikko;2;0;2;2;0;2
294;31.05.2018;2018;05;00;Torstai;0;0;0;0;0;0
294;31.05.2018;2018;05;01;Torstai;0;0;0;0;0;0
294;31.05.2018;2018;05;02;Torstai;0;0;0;0;0;0
294;31.05.2018;2018;05;03;Torstai;0;0;0;0;0;0
294;31.05.2018;2018;05;04;Torstai;2;0;2;0;0;0
294;31.05.2018;2018;05;05;Torstai;0;1;1;0;0;0
294;31.05.2018;2018;05;06;Torstai;2;2;4;1;0;1
294;31.05.2018;2018;05;07;Torstai;12;4;16;5;0;5
294;31.05.2018;2018;05;08;Torstai;20;7;27;13;3;16
294;31.05.2018;2018;05;09;Torstai;93;32;125;20;14;34
294;31.05.2018;2018;05;10;Torstai;23;68;91;20;26;46
294;31.05.2018;2018;05;11;Torstai;23;8;31;96;4;100
294;31.05.2018;2018;05;12;Torstai;19;18;37;343;8;351
294;31.05.2018;2018;05;13;Torstai;24;48;72;145;19;164
294;31.05.2018;2018;05;14;Torstai;17;17;34;84;8;92
294;31.05.2018;2018;05;15;Torstai;20;7;27;34;12;46
294;31.05.2018;2018;05;16;Torstai;24;24;48;18;13;31
294;31.05.2018;2018;05;17;Torstai;27;26;53;14;9;23
294;31.05.2018;2018;05;18;Torstai;15;16;31;13;15;28
294;31.05.2018;2018;05;19;Torstai;20;17;37;8;8;16
294;31.05.2018;2018;05;20;Torstai;8;9;17;8;7;15
294;31.05.2018;2018;05;21;Torstai;10;1;11;2;2;4
294;31.05.2018;2018;05;22;Torstai;0;3;3;1;2;3
294;31.05.2018;2018;05;23;Torstai;0;0;0;0;0;0
294;01.06.2018;2018;06;00;Perjantai;0;0;0;0;0;0
294;01.06.2018;2018;06;01;Perjantai;0;0;0;0;0;0
294;01.06.2018;2018;06;02;Perjantai;0;0;0;0;0;0
294;01.06.2018;2018;06;03;Perjantai;0;0;0;1;0;1
294;01.06.2018;2018;06;04;Perjantai;1;0;1;0;0;0
294;01.06.2018;2018;06;05;Perjantai;0;0;0;0;0;0
294;01.06.2018;2018;06;06;Perjantai;5;0;5;2;0;2
294;01.06.2018;2018;06;07;Perjantai;25;0;25;9;0;9
294;01.06.2018;2018;06;08;Perjantai;18;0;18;8;0;8
294;01.06.2018;2018;06;09;Perjantai;11;0;11;3;0;3
294;01.06.2018;2018;06;10;Perjantai;43;0;43;33;0;33
294;01.06.2018;2018;06;11;Perjantai;39;0;39;31;0;31
294;01.06.2018;2018;06;12;Perjantai;59;0;59;30;0;30
294;01.06.2018;2018;06;13;Perjantai;34;0;34;16;0;16
294;01.06.2018;2018;06;14;Perjantai;41;0;41;20;0;20
294;01.06.2018;2018;06;15;Perjantai;56;0;56;14;0;14
294;01.06.2018;2018;06;16;Perjantai;37;0;37;15;0;15
294;01.06.2018;2018;06;17;Perjantai;39;0;39;23;0;23
294;01.06.2018;2018;06;18;Perjantai;47;0;47;21;0;21
294;01.06.2018;2018;06;19;Perjantai;46;0;46;14;0;14
294;01.06.2018;2018;06;20;Perjantai;55;0;55;15;0;15
294;01.06.2018;2018;06;21;Perjantai;20;0;20;15;0;15
294;01.06.2018;2018;06;22;Perjantai;13;0;13;4;0;4
294;01.06.2018;2018;06;23;Perjantai;2;0;2;0;0;0
294;02.06.2018;2018;06;00;Lauantai;1;1;2;0;0;0
294;02.06.2018;2018;06;01;Lauantai;0;1;1;0;0;0
294;02.06.2018;2018;06;02;Lauantai;1;1;2;0;0;0
294;02.06.2018;2018;06;03;Lauantai;0;0;0;0;0;0
294;02.06.2018;2018;06;04;Lauantai;1;0;1;0;0;0
294;02.06.2018;2018;06;05;Lauantai;0;0;0;0;0;0
294;02.06.2018;2018;06;06;Lauantai;3;0;3;0;0;0
294;02.06.2018;2018;06;07;Lauantai;3;2;5;2;0;2
294;02.06.2018;2018;06;08;Lauantai;30;6;36;12;3;15
294;02.06.2018;2018;06;09;Lauantai;19;18;37;3;4;7
294;02.06.2018;2018;06;10;Lauantai;20;16;36;16;10;26
294;02.06.2018;2018;06;11;Lauantai;24;25;49;107;11;118
294;02.06.2018;2018;06;12;Lauantai;21;22;43;229;9;238
294;02.06.2018;2018;06;13;Lauantai;18;17;35;148;8;156
294;02.06.2018;2018;06;14;Lauantai;28;24;52;53;6;59
294;02.06.2018;2018;06;15;Lauantai;13;17;30;115;10;125
294;02.06.2018;2018;06;16;Lauantai;21;28;49;13;6;19
294;02.06.2018;2018;06;17;Lauantai;31;23;54;12;14;26
294;02.06.2018;2018;06;18;Lauantai;27;30;57;6;5;11
294;02.06.2018;2018;06;19;Lauantai;36;24;60;20;5;25
294;02.06.2018;2018;06;20;Lauantai;18;15;33;8;5;13
294;02.06.2018;2018;06;21;Lauantai;9;10;19;5;5;10
294;02.06.2018;2018;06;22;Lauantai;4;3;7;1;0;1
294;02.06.2018;2018;06;23;Lauantai;7;1;8;2;0;2
294;03.06.2018;2018;06;00;Sunnuntai;0;3;3;0;0;0
294;03.06.2018;2018;06;01;Sunnuntai;2;0;2;2;0;2
294;03.06.2018;2018;06;02;Sunnuntai;2;1;3;2;1;3
294;03.06.2018;2018;06;03;Sunnuntai;0;1;1;0;2;2
294;03.06.2018;2018;06;04;Sunnuntai;1;1;2;0;0;0
294;03.06.2018;2018;06;05;Sunnuntai;0;2;2;0;0;0
294;03.06.2018;2018;06;06;Sunnuntai;1;0;1;0;1;1
294;03.06.2018;2018;06;07;Sunnuntai;1;1;2;1;3;4
294;03.06.2018;2018;06;08;Sunnuntai;5;2;7;46;2;48
294;03.06.2018;2018;06;09;Sunnuntai;13;9;22;22;5;27
294;03.06.2018;2018;06;10;Sunnuntai;8;6;14;8;5;13
294;03.06.2018;2018;06;11;Sunnuntai;21;23;44;66;9;75
294;03.06.2018;2018;06;12;Sunnuntai;16;16;32;229;8;237
294;03.06.2018;2018;06;13;Sunnuntai;17;17;34;145;7;152
294;03.06.2018;2018;06;14;Sunnuntai;14;25;39;43;9;52
294;03.06.2018;2018;06;15;Sunnuntai;14;5;19;10;2;12
294;03.06.2018;2018;06;16;Sunnuntai;5;9;14;4;1;5
294;03.06.2018;2018;06;17;Sunnuntai;12;16;28;3;4;7
294;03.06.2018;2018;06;18;Sunnuntai;18;14;32;8;8;16
294;03.06.2018;2018;06;19;Sunnuntai;1;5;6;6;2;8
294;03.06.2018;2018;06;20;Sunnuntai;9;2;11;8;5;13
294;03.06.2018;2018;06;21;Sunnuntai;4;3;7;3;4;7
294;03.06.2018;2018;06;22;Sunnuntai;1;1;2;0;0;0
294;03.06.2018;2018;06;23;Sunnuntai;0;0;0;0;0;0
294;04.06.2018;2018;06;00;Maanantai;0;1;1;0;1;1
294;04.06.2018;2018;06;01;Maanantai;1;1;2;0;0;0
294;04.06.2018;2018;06;02;Maanantai;0;0;0;0;0;0
294;04.06.2018;2018;06;03;Maanantai;0;0;0;0;0;0
294;04.06.2018;2018;06;04;Maanantai;0;0;0;0;0;0
294;04.06.2018;2018;06;05;Maanantai;0;0;0;0;3;3
294;04.06.2018;2018;06;06;Maanantai;2;1;3;1;1;2
294;04.06.2018;2018;06;07;Maanantai;10;5;15;4;2;6
294;04.06.2018;2018;06;08;Maanantai;2;3;5;5;8;13
294;04.06.2018;2018;06;09;Maanantai;4;5;9;27;3;30
294;04.06.2018;2018;06;10;Maanantai;8;14;22;35;4;39
294;04.06.2018;2018;06;11;Maanantai;14;22;36;158;8;166
294;04.06.2018;2018;06;12;Maanantai;8;8;16;42;7;49
294;04.06.2018;2018;06;13;Maanantai;11;9;20;44;5;49
294;04.06.2018;2018;06;14;Maanantai;9;6;15;33;3;36
294;04.06.2018;2018;06;15;Maanantai;7;15;22;35;5;40
294;04.06.2018;2018;06;16;Maanantai;13;15;28;11;5;16
294;04.06.2018;2018;06;17;Maanantai;18;7;25;10;12;22
294;04.06.2018;2018;06;18;Maanantai;8;10;18;2;5;7
294;04.06.2018;2018;06;19;Maanantai;7;12;19;8;10;18
294;04.06.2018;2018;06;20;Maanantai;10;4;14;3;0;3
294;04.06.2018;2018;06;21;Maanantai;11;5;16;1;3;4
294;04.06.2018;2018;06;22;Maanantai;2;0;2;0;0;0
294;04.06.2018;2018;06;23;Maanantai;0;1;1;0;0;0
294;05.06.2018;2018;06;00;Tiistai;0;0;0;0;0;0
294;05.06.2018;2018;06;01;Tiistai;0;1;1;2;2;4
294;05.06.2018;2018;06;02;Tiistai;1;0;1;0;0;0
294;05.06.2018;2018;06;03;Tiistai;0;0;0;0;0;0
294;05.06.2018;2018;06;04;Tiistai;0;0;0;0;0;0
294;05.06.2018;2018;06;05;Tiistai;0;0;0;0;0;0
294;05.06.2018;2018;06;06;Tiistai;1;3;4;3;1;4
294;05.06.2018;2018;06;07;Tiistai;7;4;11;10;2;12
294;05.06.2018;2018;06;08;Tiistai;4;4;8;99;1;100
294;05.06.2018;2018;06;09;Tiistai;7;5;12;48;2;50
294;05.06.2018;2018;06;10;Tiistai;7;12;19;15;8;23
294;05.06.2018;2018;06;11;Tiistai;12;19;31;48;5;53
294;05.06.2018;2018;06;12;Tiistai;11;15;26;23;10;33
294;05.06.2018;2018;06;13;Tiistai;17;14;31;24;2;26
294;05.06.2018;2018;06;14;Tiistai;10;14;24;3;6;9
294;05.06.2018;2018;06;15;Tiistai;14;15;29;6;8;14
294;05.06.2018;2018;06;16;Tiistai;21;20;41;8;4;12
294;05.06.2018;2018;06;17;Tiistai;8;20;28;7;4;11
294;05.06.2018;2018;06;18;Tiistai;12;13;25;8;9;17
294;05.06.2018;2018;06;19;Tiistai;6;5;11;16;11;27
294;05.06.2018;2018;06;20;Tiistai;8;7;15;3;6;9
294;05.06.2018;2018;06;21;Tiistai;6;0;6;1;1;2
294;05.06.2018;2018;06;22;Tiistai;0;0;0;0;0;0
294;05.06.2018;2018;06;23;Tiistai;3;0;3;0;2;2
294;06.06.2018;2018;06;00;Keskiviikko;0;1;1;1;0;1
294;06.06.2018;2018;06;01;Keskiviikko;0;0;0;0;0;0
294;06.06.2018;2018;06;02;Keskiviikko;0;0;0;0;0;0
294;06.06.2018;2018;06;03;Keskiviikko;0;0;0;0;0;0
294;06.06.2018;2018;06;04;Keskiviikko;0;0;0;0;1;1
294;06.06.2018;2018;06;05;Keskiviikko;0;1;1;1;2;3
294;06.06.2018;2018;06;06;Keskiviikko;2;1;3;0;2;2
294;06.06.2018;2018;06;07;Keskiviikko;4;1;5;47;1;48
294;06.06.2018;2018;06;08;Keskiviikko;4;6;10;53;5;58
294;06.06.2018;2018;06;09;Keskiviikko;11;6;17;9;2;11
294;06.06.2018;2018;06;10;Keskiviikko;3;16;19;7;6;13
294;06.06.2018;2018;06;11;Keskiviikko;15;13;28;13;8;21
294;06.06.2018;2018;06;12;Keskiviikko;6;7;13;7;8;15
294;06.06.2018;2018;06;13;Keskiviikko;14;17;31;11;6;17
294;06.06.2018;2018;06;14;Keskiviikko;28;16;44;12;6;18
294;06.06.2018;2018;06;15;Keskiviikko;22;21;43;5;16;21
294;06.06.2018;2018;06;16;Keskiviikko;9;12;21;12;10;22
294;06.06.2018;2018;06;17;Keskiviikko;7;14;21;4;6;10
294;06.06.2018;2018;06;18;Keskiviikko;5;7;12;9;11;20
294;06.06.2018;2018;06;19;Keskiviikko;12;9;21;6;7;13
294;06.06.2018;2018;06;20;Keskiviikko;7;7;14;7;5;12
294;06.06.2018;2018;06;21;Keskiviikko;5;1;6;2;6;8
294;06.06.2018;2018;06;22;Keskiviikko;1;0;1;3;0;3
294;06.06.2018;2018;06;23;Keskiviikko;3;0;3;0;0;0
294;07.06.2018;2018;06;00;Torstai;0;1;1;0;0;0
294;07.06.2018;2018;06;01;Torstai;0;0;0;0;0;0
294;07.06.2018;2018;06;02;Torstai;0;0;0;0;0;0
294;07.06.2018;2018;06;03;Torstai;0;0;0;0;0;0
294;07.06.2018;2018;06;04;Torstai;1;0;1;0;0;0
294;07.06.2018;2018;06;05;Torstai;0;0;0;0;0;0
294;07.06.2018;2018;06;06;Torstai;4;1;5;2;0;2
294;07.06.2018;2018;06;07;Torstai;3;3;6;4;0;4
294;07.06.2018;2018;06;08;Torstai;1;0;1;2;3;5
294;07.06.2018;2018;06;09;Torstai;4;2;6;1;1;2
294;07.06.2018;2018;06;10;Torstai;1;2;3;1;1;2
294;07.06.2018;2018;06;11;Torstai;4;4;8;4;3;7
294;07.06.2018;2018;06;12;Torstai;2;2;4;5;4;9
294;07.06.2018;2018;06;13;Torstai;9;2;11;11;7;18
294;07.06.2018;2018;06;14;Torstai;1;7;8;4;2;6
294;07.06.2018;2018;06;15;Torstai;5;3;8;9;8;17
294;07.06.2018;2018;06;16;Torstai;6;6;12;13;7;20
294;07.06.2018;2018;06;17;Torstai;2;2;4;4;3;7
294;07.06.2018;2018;06;18;Torstai;14;10;24;5;7;12
294;07.06.2018;2018;06;19;Torstai;12;7;19;9;12;21
294;07.06.2018;2018;06;20;Torstai;3;6;9;7;4;11
294;07.06.2018;2018;06;21;Torstai;3;1;4;8;3;11
294;07.06.2018;2018;06;22;Torstai;1;0;1;0;0;0
294;07.06.2018;2018;06;23;Torstai;0;0;0;0;0;0
294;08.06.2018;2018;06;00;Perjantai;0;0;0;0;0;0
294;08.06.2018;2018;06;01;Perjantai;0;0;0;0;0;0
294;08.06.2018;2018;06;02;Perjantai;0;0;0;0;0;0
294;08.06.2018;2018;06;03;Perjantai;0;0;0;0;0;0
294;08.06.2018;2018;06;04;Perjantai;1;0;1;0;0;0
294;08.06.2018;2018;06;05;Perjantai;0;0;0;0;1;1
294;08.06.2018;2018;06;06;Perjantai;2;1;3;1;1;2
294;08.06.2018;2018;06;07;Perjantai;5;5;10;4;4;8
294;08.06.2018;2018;06;08;Perjantai;0;4;4;2;4;6
294;08.06.2018;2018;06;09;Perjantai;7;6;13;5;4;9
294;08.06.2018;2018;06;10;Perjantai;7;13;20;15;12;27
294;08.06.2018;2018;06;11;Perjantai;8;15;23;7;10;17
294;08.06.2018;2018;06;12;Perjantai;13;12;25;12;8;20
294;08.06.2018;2018;06;13;Perjantai;19;12;31;12;6;18
294;08.06.2018;2018;06;14;Perjantai;16;19;35;30;10;40
294;08.06.2018;2018;06;15;Perjantai;17;9;26;45;14;59
294;08.06.2018;2018;06;16;Perjantai;10;17;27;4;8;12
294;08.06.2018;2018;06;17;Perjantai;11;13;24;10;2;12
294;08.06.2018;2018;06;18;Perjantai;20;18;38;13;11;24
294;08.06.2018;2018;06;19;Perjantai;12;18;30;14;11;25
294;08.06.2018;2018;06;20;Perjantai;4;12;16;4;3;7
294;08.06.2018;2018;06;21;Perjantai;8;10;18;2;1;3
294;08.06.2018;2018;06;22;Perjantai;7;1;8;5;0;5
294;08.06.2018;2018;06;23;Perjantai;1;0;1;0;1;1
294;09.06.2018;2018;06;00;Lauantai;1;0;1;0;0;0
294;09.06.2018;2018;06;01;Lauantai;0;0;0;0;0;0
294;09.06.2018;2018;06;02;Lauantai;0;1;1;0;0;0
294;09.06.2018;2018;06;03;Lauantai;0;0;0;0;0;0
294;09.06.2018;2018;06;04;Lauantai;1;1;2;0;0;0
294;09.06.2018;2018;06;05;Lauantai;0;0;0;0;0;0
294;09.06.2018;2018;06;06;Lauantai;2;1;3;0;0;0
294;09.06.2018;2018;06;07;Lauantai;0;0;0;5;0;5
294;09.06.2018;2018;06;08;Lauantai;2;5;7;0;0;0
294;09.06.2018;2018;06;09;Lauantai;5;2;7;5;6;11
294;09.06.2018;2018;06;10;Lauantai;12;5;17;12;9;21
294;09.06.2018;2018;06;11;Lauantai;6;20;26;10;4;14
294;09.06.2018;2018;06;12;Lauantai;19;14;33;4;5;9
294;09.06.2018;2018;06;13;Lauantai;16;13;29;6;4;10
294;09.06.2018;2018;06;14;Lauantai;13;10;23;8;10;18
294;09.06.2018;2018;06;15;Lauantai;12;10;22;8;7;15
294;09.06.2018;2018;06;16;Lauantai;15;11;26;7;13;20
294;09.06.2018;2018;06;17;Lauantai;19;14;33;6;13;19
294;09.06.2018;2018;06;18;Lauantai;21;12;33;9;11;20
294;09.06.2018;2018;06;19;Lauantai;13;9;22;12;9;21
294;09.06.2018;2018;06;20;Lauantai;11;15;26;4;1;5
294;09.06.2018;2018;06;21;Lauantai;14;6;20;0;4;4
294;09.06.2018;2018;06;22;Lauantai;3;5;8;2;1;3
294;09.06.2018;2018;06;23;Lauantai;7;1;8;1;0;1
294;10.06.2018;2018;06;00;Sunnuntai;5;0;5;2;1;3
294;10.06.2018;2018;06;01;Sunnuntai;0;1;1;1;1;2
294;10.06.2018;2018;06;02;Sunnuntai;1;0;1;0;0;0
294;10.06.2018;2018;06;03;Sunnuntai;1;1;2;0;2;2
294;10.06.2018;2018;06;04;Sunnuntai;1;0;1;0;0;0
294;10.06.2018;2018;06;05;Sunnuntai;1;0;1;0;0;0
294;10.06.2018;2018;06;06;Sunnuntai;0;1;1;1;0;1
294;10.06.2018;2018;06;07;Sunnuntai;1;0;1;1;0;1
294;10.06.2018;2018;06;08;Sunnuntai;1;0;1;0;3;3
294;10.06.2018;2018;06;09;Sunnuntai;2;2;4;4;2;6
294;10.06.2018;2018;06;10;Sunnuntai;7;3;10;6;7;13
294;10.06.2018;2018;06;11;Sunnuntai;7;9;16;4;5;9
294;10.06.2018;2018;06;12;Sunnuntai;12;5;17;10;3;13
294;10.06.2018;2018;06;13;Sunnuntai;12;12;24;6;11;17
294;10.06.2018;2018;06;14;Sunnuntai;6;21;27;7;2;9
294;10.06.2018;2018;06;15;Sunnuntai;20;21;41;5;1;6
294;10.06.2018;2018;06;16;Sunnuntai;11;10;21;6;6;12
294;10.06.2018;2018;06;17;Sunnuntai;11;15;26;2;6;8
294;10.06.2018;2018;06;18;Sunnuntai;19;12;31;8;5;13
294;10.06.2018;2018;06;19;Sunnuntai;23;17;40;6;6;12
294;10.06.2018;2018;06;20;Sunnuntai;19;12;31;7;14;21
294;10.06.2018;2018;06;21;Sunnuntai;5;3;8;3;1;4
294;10.06.2018;2018;06;22;Sunnuntai;1;5;6;2;0;2
294;10.06.2018;2018;06;23;Sunnuntai;1;1;2;1;0;1
294;11.06.2018;2018;06;00;Maanantai;0;0;0;0;0;0
294;11.06.2018;2018;06;01;Maanantai;6;0;6;0;0;0
294;11.06.2018;2018;06;02;Maanantai;0;0;0;0;0;0
294;11.06.2018;2018;06;03;Maanantai;0;0;0;0;0;0
294;11.06.2018;2018;06;04;Maanantai;0;0;0;0;0;0
294;11.06.2018;2018;06;05;Maanantai;1;2;3;0;0;0
294;11.06.2018;2018;06;06;Maanantai;3;3;6;3;0;3
294;11.06.2018;2018;06;07;Maanantai;7;8;15;5;1;6
294;11.06.2018;2018;06;08;Maanantai;6;5;11;7;1;8
294;11.06.2018;2018;06;09;Maanantai;9;7;16;6;4;10
294;11.06.2018;2018;06;10;Maanantai;19;14;33;9;6;15
294;11.06.2018;2018;06;11;Maanantai;16;16;32;9;10;19
294;11.06.2018;2018;06;12;Maanantai;25;28;53;12;13;25
294;11.06.2018;2018;06;13;Maanantai;19;21;40;9;14;23
294;11.06.2018;2018;06;14;Maanantai;27;18;45;32;5;37
294;11.06.2018;2018;06;15;Maanantai;22;29;51;30;6;36
294;11.06.2018;2018;06;16;Maanantai;21;14;35;6;6;12
294;11.06.2018;2018;06;17;Maanantai;19;10;29;8;13;21
294;11.06.2018;2018;06;18;Maanantai;16;22;38;5;12;17
294;11.06.2018;2018;06;19;Maanantai;28;27;55;40;10;50
294;11.06.2018;2018;06;20;Maanantai;10;16;26;14;11;25
294;11.06.2018;2018;06;21;Maanantai;11;5;16;5;2;7
294;11.06.2018;2018;06;22;Maanantai;2;2;4;0;0;0
294;11.06.2018;2018;06;23;Maanantai;1;1;2;0;0;0
294;12.06.2018;2018;06;00;Tiistai;2;1;3;0;1;1
294;12.06.2018;2018;06;01;Tiistai;0;0;0;0;0;0
294;12.06.2018;2018;06;02;Tiistai;0;0;0;1;0;1
294;12.06.2018;2018;06;03;Tiistai;3;0;3;0;0;0
294;12.06.2018;2018;06;04;Tiistai;0;0;0;0;0;0
294;12.06.2018;2018;06;05;Tiistai;0;1;1;0;0;0
294;12.06.2018;2018;06;06;Tiistai;5;0;5;1;1;2
294;12.06.2018;2018;06;07;Tiistai;5;2;7;7;0;7
294;12.06.2018;2018;06;08;Tiistai;8;9;17;29;3;32
294;12.06.2018;2018;06;09;Tiistai;9;0;9;18;8;26
294;12.06.2018;2018;06;10;Tiistai;6;11;17;6;4;10
294;12.06.2018;2018;06;11;Tiistai;15;13;28;119;10;129
294;12.06.2018;2018;06;12;Tiistai;15;19;34;245;7;252
294;12.06.2018;2018;06;13;Tiistai;24;18;42;127;9;136
294;12.06.2018;2018;06;14;Tiistai;13;19;32;44;7;51
294;12.06.2018;2018;06;15;Tiistai;24;15;39;47;15;62
294;12.06.2018;2018;06;16;Tiistai;16;14;30;3;9;12
294;12.06.2018;2018;06;17;Tiistai;18;18;36;12;5;17
294;12.06.2018;2018;06;18;Tiistai;11;15;26;11;9;20
294;12.06.2018;2018;06;19;Tiistai;16;10;26;19;11;30
294;12.06.2018;2018;06;20;Tiistai;3;6;9;4;8;12
294;12.06.2018;2018;06;21;Tiistai;8;7;15;2;5;7
294;12.06.2018;2018;06;22;Tiistai;1;0;1;0;0;0
294;12.06.2018;2018;06;23;Tiistai;0;0;0;1;0;1
294;13.06.2018;2018;06;00;Keskiviikko;0;0;0;0;0;0
294;13.06.2018;2018;06;01;Keskiviikko;0;0;0;0;0;0
294;13.06.2018;2018;06;02;Keskiviikko;0;0;0;0;0;0
294;13.06.2018;2018;06;03;Keskiviikko;0;0;0;0;0;0
294;13.06.2018;2018;06;04;Keskiviikko;0;0;0;0;1;1
294;13.06.2018;2018;06;05;Keskiviikko;1;1;2;1;0;1
294;13.06.2018;2018;06;06;Keskiviikko;2;2;4;0;0;0
294;13.06.2018;2018;06;07;Keskiviikko;8;3;11;4;4;8
294;13.06.2018;2018;06;08;Keskiviikko;4;10;14;5;0;5
294;13.06.2018;2018;06;09;Keskiviikko;18;4;22;3;6;9
294;13.06.2018;2018;06;10;Keskiviikko;12;9;21;14;8;22
294;13.06.2018;2018;06;11;Keskiviikko;11;20;31;13;10;23
294;13.06.2018;2018;06;12;Keskiviikko;17;22;39;12;7;19
294;13.06.2018;2018;06;13;Keskiviikko;17;14;31;9;5;14
294;13.06.2018;2018;06;14;Keskiviikko;15;15;30;8;5;13
294;13.06.2018;2018;06;15;Keskiviikko;16;23;39;20;11;31
294;13.06.2018;2018;06;16;Keskiviikko;20;17;37;6;8;14
294;13.06.2018;2018;06;17;Keskiviikko;22;25;47;9;6;15
294;13.06.2018;2018;06;18;Keskiviikko;24;20;44;11;18;29
294;13.06.2018;2018;06;19;Keskiviikko;16;12;28;18;14;32
294;13.06.2018;2018;06;20;Keskiviikko;12;12;24;6;9;15
294;13.06.2018;2018;06;21;Keskiviikko;5;0;5;2;0;2
294;13.06.2018;2018;06;22;Keskiviikko;2;1;3;1;4;5
294;13.06.2018;2018;06;23;Keskiviikko;0;0;0;1;0;1
294;14.06.2018;2018;06;00;Torstai;0;0;0;0;0;0
294;14.06.2018;2018;06;01;Torstai;0;0;0;0;0;0
294;14.06.2018;2018;06;02;Torstai;0;0;0;0;0;0
294;14.06.2018;2018;06;03;Torstai;0;0;0;0;1;1
294;14.06.2018;2018;06;04;Torstai;0;0;0;0;1;1
294;14.06.2018;2018;06;05;Torstai;1;1;2;0;0;0
294;14.06.2018;2018;06;06;Torstai;4;1;5;0;0;0
294;14.06.2018;2018;06;07;Torstai;5;1;6;6;1;7
294;14.06.2018;2018;06;08;Torstai;7;14;21;5;4;9
294;14.06.2018;2018;06;09;Torstai;14;12;26;4;3;7
294;14.06.2018;2018;06;10;Torstai;13;7;20;1;5;6
294;14.06.2018;2018;06;11;Torstai;15;14;29;7;9;16
294;14.06.2018;2018;06;12;Torstai;19;19;38;10;13;23
294;14.06.2018;2018;06;13;Torstai;22;16;38;10;10;20
294;14.06.2018;2018;06;14;Torstai;21;18;39;7;5;12
294;14.06.2018;2018;06;15;Torstai;24;17;41;14;7;21
294;14.06.2018;2018;06;16;Torstai;16;17;33;6;5;11
294;14.06.2018;2018;06;17;Torstai;24;21;45;9;5;14
294;14.06.2018;2018;06;18;Torstai;22;21;43;11;6;17
294;14.06.2018;2018;06;19;Torstai;12;15;27;10;7;17
294;14.06.2018;2018;06;20;Torstai;17;9;26;3;4;7
294;14.06.2018;2018;06;21;Torstai;5;8;13;1;8;9
294;14.06.2018;2018;06;22;Torstai;1;0;1;0;0;0
294;14.06.2018;2018;06;23;Torstai;1;1;2;0;0;0
294;15.06.2018;2018;06;00;Perjantai;0;0;0;0;0;0
294;15.06.2018;2018;06;01;Perjantai;0;0;0;0;0;0
294;15.06.2018;2018;06;02;Perjantai;2;0;2;0;0;0
294;15.06.2018;2018;06;03;Perjantai;0;0;0;0;0;0
294;15.06.2018;2018;06;04;Perjantai;0;0;0;0;0;0
294;15.06.2018;2018;06;05;Perjantai;0;1;1;0;0;0
294;15.06.2018;2018;06;06;Perjantai;2;1;3;2;0;2
294;15.06.2018;2018;06;07;Perjantai;8;2;10;2;3;5
294;15.06.2018;2018;06;08;Perjantai;2;6;8;7;5;12
294;15.06.2018;2018;06;09;Perjantai;8;5;13;10;17;27
294;15.06.2018;2018;06;10;Perjantai;18;11;29;22;6;28
294;15.06.2018;2018;06;11;Perjantai;15;21;36;5;12;17
294;15.06.2018;2018;06;12;Perjantai;18;12;30;13;12;25
294;15.06.2018;2018;06;13;Perjantai;17;12;29;14;3;17
294;15.06.2018;2018;06;14;Perjantai;15;13;28;10;6;16
294;15.06.2018;2018;06;15;Perjantai;16;18;34;7;5;12
294;15.06.2018;2018;06;16;Perjantai;10;7;17;4;6;10
294;15.06.2018;2018;06;17;Perjantai;10;9;19;6;6;12
294;15.06.2018;2018;06;18;Perjantai;9;4;13;1;2;3
294;15.06.2018;2018;06;19;Perjantai;16;12;28;7;6;13
294;15.06.2018;2018;06;20;Perjantai;13;12;25;4;7;11
294;15.06.2018;2018;06;21;Perjantai;12;9;21;5;1;6
294;15.06.2018;2018;06;22;Perjantai;6;6;12;4;1;5
294;15.06.2018;2018;06;23;Perjantai;3;4;7;1;0;1
294;16.06.2018;2018;06;00;Lauantai;1;0;1;0;0;0
294;16.06.2018;2018;06;01;Lauantai;1;0;1;0;0;0
294;16.06.2018;2018;06;02;Lauantai;0;2;2;1;0;1
294;16.06.2018;2018;06;03;Lauantai;0;0;0;0;0;0
294;16.06.2018;2018;06;04;Lauantai;0;0;0;0;0;0
294;16.06.2018;2018;06;05;Lauantai;0;0;0;1;0;1
294;16.06.2018;2018;06;06;Lauantai;1;0;1;0;0;0
294;16.06.2018;2018;06;07;Lauantai;1;2;3;0;1;1
294;16.06.2018;2018;06;08;Lauantai;6;7;13;4;5;9
294;16.06.2018;2018;06;09;Lauantai;6;3;9;5;5;10
294;16.06.2018;2018;06;10;Lauantai;9;8;17;4;4;8
294;16.06.2018;2018;06;11;Lauantai;12;9;21;5;4;9
294;16.06.2018;2018;06;12;Lauantai;17;24;41;35;3;38
294;16.06.2018;2018;06;13;Lauantai;20;17;37;5;4;9
294;16.06.2018;2018;06;14;Lauantai;13;11;24;4;1;5
294;16.06.2018;2018;06;15;Lauantai;24;11;35;6;6;12
294;16.06.2018;2018;06;16;Lauantai;9;12;21;5;5;10
294;16.06.2018;2018;06;17;Lauantai;9;8;17;6;9;15
294;16.06.2018;2018;06;18;Lauantai;17;7;24;10;4;14
294;16.06.2018;2018;06;19;Lauantai;16;16;32;6;6;12
294;16.06.2018;2018;06;20;Lauantai;6;5;11;4;3;7
294;16.06.2018;2018;06;21;Lauantai;3;3;6;0;3;3
294;16.06.2018;2018;06;22;Lauantai;2;5;7;2;1;3
294;16.06.2018;2018;06;23;Lauantai;5;1;6;3;0;3
294;17.06.2018;2018;06;00;Sunnuntai;1;1;2;2;1;3
294;17.06.2018;2018;06;01;Sunnuntai;0;3;3;0;0;0
294;17.06.2018;2018;06;02;Sunnuntai;0;0;0;0;0;0
294;17.06.2018;2018;06;03;Sunnuntai;0;0;0;1;0;1
294;17.06.2018;2018;06;04;Sunnuntai;0;0;0;3;0;3
294;17.06.2018;2018;06;05;Sunnuntai;1;0;1;0;0;0
294;17.06.2018;2018;06;06;Sunnuntai;2;1;3;0;1;1
294;17.06.2018;2018;06;07;Sunnuntai;2;1;3;0;0;0
294;17.06.2018;2018;06;08;Sunnuntai;3;2;5;4;5;9
294;17.06.2018;2018;06;09;Sunnuntai;7;7;14;4;6;10
294;17.06.2018;2018;06;10;Sunnuntai;9;4;13;4;4;8
294;17.06.2018;2018;06;11;Sunnuntai;14;6;20;9;9;18
294;17.06.2018;2018;06;12;Sunnuntai;14;14;28;45;4;49
294;17.06.2018;2018;06;13;Sunnuntai;18;6;24;7;4;11
294;17.06.2018;2018;06;14;Sunnuntai;16;19;35;9;5;14
294;17.06.2018;2018;06;15;Sunnuntai;12;12;24;20;8;28
294;17.06.2018;2018;06;16;Sunnuntai;16;15;31;5;6;11
294;17.06.2018;2018;06;17;Sunnuntai;15;17;32;4;11;15
294;17.06.2018;2018;06;18;Sunnuntai;21;12;33;12;3;15
294;17.06.2018;2018;06;19;Sunnuntai;8;16;24;11;8;19
294;17.06.2018;2018;06;20;Sunnuntai;22;12;34;4;4;8
294;17.06.2018;2018;06;21;Sunnuntai;5;8;13;3;3;6
294;17.06.2018;2018;06;22;Sunnuntai;5;3;8;1;3;4
294;17.06.2018;2018;06;23;Sunnuntai;4;0;4;1;0;1
294;18.06.2018;2018;06;00;Maanantai;0;0;0;0;0;0
294;18.06.2018;2018;06;01;Maanantai;1;1;2;0;0;0
294;18.06.2018;2018;06;02;Maanantai;0;1;1;0;0;0
294;18.06.2018;2018;06;03;Maanantai;0;0;0;0;0;0
294;18.06.2018;2018;06;04;Maanantai;0;0;0;0;1;1
294;18.06.2018;2018;06;05;Maanantai;0;1;1;0;0;0
294;18.06.2018;2018;06;06;Maanantai;3;0;3;4;0;4
294;18.06.2018;2018;06;07;Maanantai;5;5;10;3;1;4
294;18.06.2018;2018;06;08;Maanantai;8;4;12;5;4;9
294;18.06.2018;2018;06;09;Maanantai;15;8;23;4;0;4
294;18.06.2018;2018;06;10;Maanantai;3;8;11;4;5;9
294;18.06.2018;2018;06;11;Maanantai;8;9;17;3;4;7
294;18.06.2018;2018;06;12;Maanantai;6;7;13;6;4;10
294;18.06.2018;2018;06;13;Maanantai;14;9;23;10;6;16
294;18.06.2018;2018;06;14;Maanantai;7;9;16;13;8;21
294;18.06.2018;2018;06;15;Maanantai;19;17;36;35;10;45
294;18.06.2018;2018;06;16;Maanantai;17;16;33;4;3;7
294;18.06.2018;2018;06;17;Maanantai;13;14;27;6;11;17
294;18.06.2018;2018;06;18;Maanantai;21;11;32;9;2;11
294;18.06.2018;2018;06;19;Maanantai;7;11;18;4;7;11
294;18.06.2018;2018;06;20;Maanantai;18;7;25;5;3;8
294;18.06.2018;2018;06;21;Maanantai;4;4;8;2;2;4
294;18.06.2018;2018;06;22;Maanantai;1;1;2;1;1;2
294;18.06.2018;2018;06;23;Maanantai;1;1;2;0;1;1
294;19.06.2018;2018;06;00;Tiistai;0;0;0;3;1;4
294;19.06.2018;2018;06;01;Tiistai;0;1;1;0;0;0
294;19.06.2018;2018;06;02;Tiistai;0;1;1;0;0;0
294;19.06.2018;2018;06;03;Tiistai;0;0;0;0;0;0
294;19.06.2018;2018;06;04;Tiistai;1;0;1;0;0;0
294;19.06.2018;2018;06;05;Tiistai;1;1;2;0;0;0
294;19.06.2018;2018;06;06;Tiistai;2;1;3;3;0;3
294;19.06.2018;2018;06;07;Tiistai;5;3;8;6;1;7
294;19.06.2018;2018;06;08;Tiistai;4;7;11;2;3;5
294;19.06.2018;2018;06;09;Tiistai;10;5;15;2;5;7
294;19.06.2018;2018;06;10;Tiistai;8;3;11;10;5;15
294;19.06.2018;2018;06;11;Tiistai;8;18;26;3;9;12
294;19.06.2018;2018;06;12;Tiistai;11;8;19;3;4;7
294;19.06.2018;2018;06;13;Tiistai;0;3;3;2;4;6
294;19.06.2018;2018;06;14;Tiistai;5;5;10;4;2;6
294;19.06.2018;2018;06;15;Tiistai;5;5;10;3;1;4
294;19.06.2018;2018;06;16;Tiistai;3;5;8;6;2;8
294;19.06.2018;2018;06;17;Tiistai;3;0;3;4;2;6
294;19.06.2018;2018;06;18;Tiistai;10;5;15;7;4;11
294;19.06.2018;2018;06;19;Tiistai;12;6;18;3;3;6
294;19.06.2018;2018;06;20;Tiistai;3;2;5;0;5;5
294;19.06.2018;2018;06;21;Tiistai;4;2;6;3;6;9
294;19.06.2018;2018;06;22;Tiistai;0;3;3;0;0;0
294;19.06.2018;2018;06;23;Tiistai;3;0;3;1;1;2
294;20.06.2018;2018;06;00;Keskiviikko;0;0;0;0;0;0
294;20.06.2018;2018;06;01;Keskiviikko;0;2;2;0;0;0
294;20.06.2018;2018;06;02;Keskiviikko;0;2;2;0;0;0
294;20.06.2018;2018;06;03;Keskiviikko;0;0;0;0;0;0
294;20.06.2018;2018;06;04;Keskiviikko;0;0;0;0;0;0
294;20.06.2018;2018;06;05;Keskiviikko;0;1;1;0;0;0
294;20.06.2018;2018;06;06;Keskiviikko;1;1;2;2;0;2
294;20.06.2018;2018;06;07;Keskiviikko;5;3;8;6;2;8
294;20.06.2018;2018;06;08;Keskiviikko;3;5;8;9;6;15
294;20.06.2018;2018;06;09;Keskiviikko;4;8;12;5;7;12
294;20.06.2018;2018;06;10;Keskiviikko;12;7;19;10;11;21
294;20.06.2018;2018;06;11;Keskiviikko;10;14;24;13;11;24
294;20.06.2018;2018;06;12;Keskiviikko;9;14;23;12;9;21
294;20.06.2018;2018;06;13;Keskiviikko;24;21;45;12;7;19
294;20.06.2018;2018;06;14;Keskiviikko;14;18;32;8;6;14
294;20.06.2018;2018;06;15;Keskiviikko;20;25;45;6;5;11
294;20.06.2018;2018;06;16;Keskiviikko;20;12;32;8;4;12
294;20.06.2018;2018;06;17;Keskiviikko;19;16;35;4;6;10
294;20.06.2018;2018;06;18;Keskiviikko;12;13;25;9;10;19
294;20.06.2018;2018;06;19;Keskiviikko;17;24;41;8;10;18
294;20.06.2018;2018;06;20;Keskiviikko;13;9;22;6;6;12
294;20.06.2018;2018;06;21;Keskiviikko;4;7;11;2;3;5
294;20.06.2018;2018;06;22;Keskiviikko;1;12;13;3;1;4
294;20.06.2018;2018;06;23;Keskiviikko;1;0;1;0;0;0
294;21.06.2018;2018;06;00;Torstai;2;1;3;1;0;1
294;21.06.2018;2018;06;01;Torstai;1;0;1;0;0;0
294;21.06.2018;2018;06;02;Torstai;0;0;0;0;0;0
294;21.06.2018;2018;06;03;Torstai;0;0;0;0;0;0
294;21.06.2018;2018;06;04;Torstai;1;0;1;0;0;0
294;21.06.2018;2018;06;05;Torstai;0;1;1;0;0;0
294;21.06.2018;2018;06;06;Torstai;2;0;2;0;0;0
294;21.06.2018;2018;06;07;Torstai;6;3;9;1;1;2
294;21.06.2018;2018;06;08;Torstai;5;2;7;5;5;10
294;21.06.2018;2018;06;09;Torstai;6;7;13;8;5;13
294;21.06.2018;2018;06;10;Torstai;16;13;29;8;9;17
294;21.06.2018;2018;06;11;Torstai;11;12;23;7;10;17
294;21.06.2018;2018;06;12;Torstai;18;22;40;6;8;14
294;21.06.2018;2018;06;13;Torstai;15;17;32;9;11;20
294;21.06.2018;2018;06;14;Torstai;26;18;44;13;8;21
294;21.06.2018;2018;06;15;Torstai;13;15;28;11;8;19
294;21.06.2018;2018;06;16;Torstai;19;19;38;6;6;12
294;21.06.2018;2018;06;17;Torstai;17;19;36;8;9;17
294;21.06.2018;2018;06;18;Torstai;15;11;26;8;7;15
294;21.06.2018;2018;06;19;Torstai;12;12;24;9;8;17
294;21.06.2018;2018;06;20;Torstai;15;12;27;8;8;16
294;21.06.2018;2018;06;21;Torstai;6;0;6;2;3;5
294;21.06.2018;2018;06;22;Torstai;3;2;5;1;1;2
294;21.06.2018;2018;06;23;Torstai;3;0;3;0;0;0
294;22.06.2018;2018;06;00;Perjantai;1;0;1;0;1;1
294;22.06.2018;2018;06;01;Perjantai;0;1;1;1;0;1
294;22.06.2018;2018;06;02;Perjantai;0;0;0;1;0;1
294;22.06.2018;2018;06;03;Perjantai;0;0;0;0;0;0
294;22.06.2018;2018;06;04;Perjantai;1;1;2;0;0;0
294;22.06.2018;2018;06;05;Perjantai;0;1;1;0;0;0
294;22.06.2018;2018;06;06;Perjantai;0;0;0;0;2;2
294;22.06.2018;2018;06;07;Perjantai;1;3;4;0;1;1
294;22.06.2018;2018;06;08;Perjantai;2;0;2;0;0;0
294;22.06.2018;2018;06;09;Perjantai;0;0;0;1;0;1
294;22.06.2018;2018;06;10;Perjantai;0;6;6;3;1;4
294;22.06.2018;2018;06;11;Perjantai;4;1;5;1;2;3
294;22.06.2018;2018;06;12;Perjantai;0;1;1;1;0;1
294;22.06.2018;2018;06;13;Perjantai;2;3;5;1;2;3
294;22.06.2018;2018;06;14;Perjantai;4;4;8;6;4;10
294;22.06.2018;2018;06;15;Perjantai;5;4;9;3;3;6
294;22.06.2018;2018;06;16;Perjantai;2;5;7;1;2;3
294;22.06.2018;2018;06;17;Perjantai;6;6;12;1;1;2
294;22.06.2018;2018;06;18;Perjantai;5;1;6;2;2;4
294;22.06.2018;2018;06;19;Perjantai;9;9;18;5;2;7
294;22.06.2018;2018;06;20;Perjantai;15;14;29;13;7;20
294;22.06.2018;2018;06;21;Perjantai;2;1;3;1;2;3
294;22.06.2018;2018;06;22;Perjantai;4;0;4;0;0;0
294;22.06.2018;2018;06;23;Perjantai;1;0;1;3;0;3
294;23.06.2018;2018;06;00;Lauantai;2;4;6;0;0;0
294;23.06.2018;2018;06;01;Lauantai;0;0;0;0;0;0
294;23.06.2018;2018;06;02;Lauantai;0;0;0;1;1;2
294;23.06.2018;2018;06;03;Lauantai;0;0;0;0;0;0
294;23.06.2018;2018;06;04;Lauantai;0;3;3;0;1;1
294;23.06.2018;2018;06;05;Lauantai;0;0;0;0;0;0
294;23.06.2018;2018;06;06;Lauantai;0;2;2;2;0;2
294;23.06.2018;2018;06;07;Lauantai;0;0;0;0;0;0
294;23.06.2018;2018;06;08;Lauantai;1;1;2;0;1;1
294;23.06.2018;2018;06;09;Lauantai;1;2;3;2;1;3
294;23.06.2018;2018;06;10;Lauantai;3;5;8;2;8;10
294;23.06.2018;2018;06;11;Lauantai;5;4;9;2;0;2
294;23.06.2018;2018;06;12;Lauantai;1;3;4;1;4;5
294;23.06.2018;2018;06;13;Lauantai;5;3;8;3;5;8
294;23.06.2018;2018;06;14;Lauantai;4;9;13;5;4;9
294;23.06.2018;2018;06;15;Lauantai;9;1;10;6;2;8
294;23.06.2018;2018;06;16;Lauantai;5;4;9;1;4;5
294;23.06.2018;2018;06;17;Lauantai;5;7;12;3;8;11
294;23.06.2018;2018;06;18;Lauantai;4;8;12;3;5;8
294;23.06.2018;2018;06;19;Lauantai;6;3;9;4;3;7
294;23.06.2018;2018;06;20;Lauantai;15;10;25;8;10;18
294;23.06.2018;2018;06;21;Lauantai;2;2;4;1;0;1
294;23.06.2018;2018;06;22;Lauantai;0;1;1;0;0;0
294;23.06.2018;2018;06;23;Lauantai;0;3;3;2;0;2
294;24.06.2018;2018;06;00;Sunnuntai;0;3;3;2;0;2
294;24.06.2018;2018;06;01;Sunnuntai;2;0;2;1;0;1
294;24.06.2018;2018;06;02;Sunnuntai;0;1;1;0;0;0
294;24.06.2018;2018;06;03;Sunnuntai;0;0;0;0;0;0
294;24.06.2018;2018;06;04;Sunnuntai;1;0;1;0;1;1
294;24.06.2018;2018;06;05;Sunnuntai;0;0;0;0;0;0
294;24.06.2018;2018;06;06;Sunnuntai;0;3;3;2;0;2
294;24.06.2018;2018;06;07;Sunnuntai;2;0;2;1;0;1
294;24.06.2018;2018;06;08;Sunnuntai;5;2;7;0;4;4
294;24.06.2018;2018;06;09;Sunnuntai;2;4;6;7;5;12
294;24.06.2018;2018;06;10;Sunnuntai;3;7;10;2;3;5
294;24.06.2018;2018;06;11;Sunnuntai;5;13;18;5;5;10
294;24.06.2018;2018;06;12;Sunnuntai;17;7;24;5;8;13
294;24.06.2018;2018;06;13;Sunnuntai;15;14;29;6;12;18
294;24.06.2018;2018;06;14;Sunnuntai;11;19;30;9;6;15
294;24.06.2018;2018;06;15;Sunnuntai;14;8;22;3;4;7
294;24.06.2018;2018;06;16;Sunnuntai;18;19;37;10;5;15
294;24.06.2018;2018;06;17;Sunnuntai;11;7;18;6;4;10
294;24.06.2018;2018;06;18;Sunnuntai;22;7;29;8;9;17
294;24.06.2018;2018;06;19;Sunnuntai;12;20;32;6;7;13
294;24.06.2018;2018;06;20;Sunnuntai;8;12;20;9;4;13
294;24.06.2018;2018;06;21;Sunnuntai;17;7;24;5;2;7
294;24.06.2018;2018;06;22;Sunnuntai;3;3;6;1;1;2
294;24.06.2018;2018;06;23;Sunnuntai;1;2;3;2;0;2
294;25.06.2018;2018;06;00;Maanantai;0;2;2;0;2;2
294;25.06.2018;2018;06;01;Maanantai;0;0;0;0;0;0
294;25.06.2018;2018;06;02;Maanantai;0;1;1;0;0;0
294;25.06.2018;2018;06;03;Maanantai;0;0;0;0;0;0
294;25.06.2018;2018;06;04;Maanantai;1;0;1;0;0;0
294;25.06.2018;2018;06;05;Maanantai;1;1;2;1;0;1
294;25.06.2018;2018;06;06;Maanantai;2;2;4;1;0;1
294;25.06.2018;2018;06;07;Maanantai;4;1;5;3;3;6
294;25.06.2018;2018;06;08;Maanantai;9;6;15;4;6;10
294;25.06.2018;2018;06;09;Maanantai;7;7;14;5;1;6
294;25.06.2018;2018;06;10;Maanantai;11;21;32;8;6;14
294;25.06.2018;2018;06;11;Maanantai;23;14;37;7;9;16
294;25.06.2018;2018;06;12;Maanantai;16;28;44;12;8;20
294;25.06.2018;2018;06;13;Maanantai;26;38;64;11;14;25
294;25.06.2018;2018;06;14;Maanantai;22;16;38;9;4;13
294;25.06.2018;2018;06;15;Maanantai;14;17;31;5;8;13
294;25.06.2018;2018;06;16;Maanantai;27;25;52;5;4;9
294;25.06.2018;2018;06;17;Maanantai;21;21;42;7;7;14
294;25.06.2018;2018;06;18;Maanantai;33;30;63;6;13;19
294;25.06.2018;2018;06;19;Maanantai;28;24;52;14;12;26
294;25.06.2018;2018;06;20;Maanantai;18;16;34;4;7;11
294;25.06.2018;2018;06;21;Maanantai;11;15;26;7;4;11
294;25.06.2018;2018;06;22;Maanantai;1;3;4;0;0;0
294;25.06.2018;2018;06;23;Maanantai;1;0;1;0;1;1
294;26.06.2018;2018;06;00;Tiistai;0;0;0;0;0;0
294;26.06.2018;2018;06;01;Tiistai;0;0;0;0;0;0
294;26.06.2018;2018;06;02;Tiistai;0;0;0;0;0;0
294;26.06.2018;2018;06;03;Tiistai;0;0;0;0;0;0
294;26.06.2018;2018;06;04;Tiistai;1;1;2;0;0;0
294;26.06.2018;2018;06;05;Tiistai;0;1;1;2;0;2
294;26.06.2018;2018;06;06;Tiistai;3;3;6;1;1;2
294;26.06.2018;2018;06;07;Tiistai;7;0;7;2;2;4
294;26.06.2018;2018;06;08;Tiistai;4;8;12;3;4;7
294;26.06.2018;2018;06;09;Tiistai;8;5;13;4;4;8
294;26.06.2018;2018;06;10;Tiistai;16;24;40;5;12;17
294;26.06.2018;2018;06;11;Tiistai;19;8;27;11;6;17
294;26.06.2018;2018;06;12;Tiistai;14;14;28;9;8;17
294;26.06.2018;2018;06;13;Tiistai;14;24;38;9;7;16
294;26.06.2018;2018;06;14;Tiistai;18;15;33;3;12;15
294;26.06.2018;2018;06;15;Tiistai;14;18;32;6;6;12
294;26.06.2018;2018;06;16;Tiistai;17;24;41;7;5;12
294;26.06.2018;2018;06;17;Tiistai;19;16;35;7;5;12
294;26.06.2018;2018;06;18;Tiistai;16;22;38;3;6;9
294;26.06.2018;2018;06;19;Tiistai;21;15;36;19;11;30
294;26.06.2018;2018;06;20;Tiistai;19;14;33;12;13;25
294;26.06.2018;2018;06;21;Tiistai;14;7;21;5;5;10
294;26.06.2018;2018;06;22;Tiistai;1;2;3;1;0;1
294;26.06.2018;2018;06;23;Tiistai;3;1;4;1;0;1
294;27.06.2018;2018;06;00;Keskiviikko;0;0;0;0;2;2
294;27.06.2018;2018;06;01;Keskiviikko;0;0;0;0;0;0
294;27.06.2018;2018;06;02;Keskiviikko;0;0;0;0;0;0
294;27.06.2018;2018;06;03;Keskiviikko;0;0;0;0;0;0
294;27.06.2018;2018;06;04;Keskiviikko;1;0;1;0;0;0
294;27.06.2018;2018;06;05;Keskiviikko;0;1;1;0;0;0
294;27.06.2018;2018;06;06;Keskiviikko;3;2;5;0;0;0
294;27.06.2018;2018;06;07;Keskiviikko;2;1;3;32;5;37
294;27.06.2018;2018;06;08;Keskiviikko;2;2;4;8;3;11
294;27.06.2018;2018;06;09;Keskiviikko;4;6;10;34;15;49
294;27.06.2018;2018;06;10;Keskiviikko;9;14;23;24;16;40
294;27.06.2018;2018;06;11;Keskiviikko;14;14;28;32;22;54
294;27.06.2018;2018;06;12;Keskiviikko;15;12;27;31;25;56
294;27.06.2018;2018;06;13;Keskiviikko;16;17;33;21;11;32
294;27.06.2018;2018;06;14;Keskiviikko;15;18;33;92;51;143
294;27.06.2018;2018;06;15;Keskiviikko;13;20;33;39;21;60
294;27.06.2018;2018;06;16;Keskiviikko;22;12;34;12;13;25
294;27.06.2018;2018;06;17;Keskiviikko;14;12;26;13;5;18
294;27.06.2018;2018;06;18;Keskiviikko;14;26;40;9;7;16
294;27.06.2018;2018;06;19;Keskiviikko;18;14;32;9;13;22
294;27.06.2018;2018;06;20;Keskiviikko;15;11;26;10;3;13
294;27.06.2018;2018;06;21;Keskiviikko;8;10;18;3;5;8
294;27.06.2018;2018;06;22;Keskiviikko;1;2;3;6;2;8
294;27.06.2018;2018;06;23;Keskiviikko;1;0;1;3;1;4
294;28.06.2018;2018;06;00;Torstai;0;0;0;0;3;3
294;28.06.2018;2018;06;01;Torstai;0;3;3;0;0;0
294;28.06.2018;2018;06;02;Torstai;1;0;1;0;0;0
294;28.06.2018;2018;06;03;Torstai;0;0;0;0;0;0
294;28.06.2018;2018;06;04;Torstai;0;1;1;0;0;0
294;28.06.2018;2018;06;05;Torstai;1;0;1;0;0;0
294;28.06.2018;2018;06;06;Torstai;2;2;4;1;3;4
294;28.06.2018;2018;06;07;Torstai;2;3;5;2;2;4
294;28.06.2018;2018;06;08;Torstai;2;2;4;4;3;7
294;28.06.2018;2018;06;09;Torstai;2;2;4;2;2;4
294;28.06.2018;2018;06;10;Torstai;2;0;2;2;4;6
294;28.06.2018;2018;06;11;Torstai;0;0;0;1;1;2
294;28.06.2018;2018;06;12;Torstai;0;2;2;1;0;1
294;28.06.2018;2018;06;13;Torstai;1;5;6;4;5;9
294;28.06.2018;2018;06;14;Torstai;7;4;11;5;1;6
294;28.06.2018;2018;06;15;Torstai;1;3;4;2;2;4
294;28.06.2018;2018;06;16;Torstai;6;2;8;2;2;4
294;28.06.2018;2018;06;17;Torstai;1;4;5;5;2;7
294;28.06.2018;2018;06;18;Torstai;1;2;3;0;3;3
294;28.06.2018;2018;06;19;Torstai;5;8;13;12;6;18
294;28.06.2018;2018;06;20;Torstai;11;5;16;6;8;14
294;28.06.2018;2018;06;21;Torstai;4;2;6;2;3;5
294;28.06.2018;2018;06;22;Torstai;1;3;4;0;0;0
294;28.06.2018;2018;06;23;Torstai;0;0;0;1;0;1
294;29.06.2018;2018;06;00;Perjantai;0;0;0;0;1;1
294;29.06.2018;2018;06;01;Perjantai;0;0;0;1;0;1
294;29.06.2018;2018;06;02;Perjantai;0;0;0;0;0;0
294;29.06.2018;2018;06;03;Perjantai;0;0;0;0;0;0
294;29.06.2018;2018;06;04;Perjantai;0;0;0;0;0;0
294;29.06.2018;2018;06;05;Perjantai;1;1;2;1;0;1
294;29.06.2018;2018;06;06;Perjantai;3;3;6;2;0;2
294;29.06.2018;2018;06;07;Perjantai;2;3;5;3;2;5
294;29.06.2018;2018;06;08;Perjantai;4;1;5;2;4;6
294;29.06.2018;2018;06;09;Perjantai;7;6;13;5;5;10
294;29.06.2018;2018;06;10;Perjantai;8;10;18;5;2;7
294;29.06.2018;2018;06;11;Perjantai;13;8;21;11;4;15
294;29.06.2018;2018;06;12;Perjantai;5;10;15;6;10;16
294;29.06.2018;2018;06;13;Perjantai;12;8;20;7;5;12
294;29.06.2018;2018;06;14;Perjantai;8;13;21;9;10;19
294;29.06.2018;2018;06;15;Perjantai;18;13;31;6;7;13
294;29.06.2018;2018;06;16;Perjantai;15;7;22;4;3;7
294;29.06.2018;2018;06;17;Perjantai;11;9;20;8;4;12
294;29.06.2018;2018;06;18;Perjantai;9;12;21;6;4;10
294;29.06.2018;2018;06;19;Perjantai;18;17;35;10;11;21
294;29.06.2018;2018;06;20;Perjantai;10;5;15;5;2;7
294;29.06.2018;2018;06;21;Perjantai;4;1;5;1;4;5
294;29.06.2018;2018;06;22;Perjantai;2;1;3;0;1;1
294;29.06.2018;2018;06;23;Perjantai;2;2;4;1;0;1
294;30.06.2018;2018;06;00;Lauantai;0;0;0;0;1;1
294;30.06.2018;2018;06;01;Lauantai;0;0;0;0;0;0
294;30.06.2018;2018;06;02;Lauantai;0;1;1;0;0;0
294;30.06.2018;2018;06;03;Lauantai;0;0;0;0;0;0
294;30.06.2018;2018;06;04;Lauantai;1;0;1;0;0;0
294;30.06.2018;2018;06;05;Lauantai;0;0;0;9;3;12
294;30.06.2018;2018;06;06;Lauantai;0;0;0;7;10;17
294;30.06.2018;2018;06;07;Lauantai;3;3;6;4;6;10
294;30.06.2018;2018;06;08;Lauantai;1;4;5;6;3;9
294;30.06.2018;2018;06;09;Lauantai;7;4;11;9;11;20
294;30.06.2018;2018;06;10;Lauantai;3;6;9;10;13;23
294;30.06.2018;2018;06;11;Lauantai;15;9;24;6;10;16
294;30.06.2018;2018;06;12;Lauantai;9;6;15;6;9;15
294;30.06.2018;2018;06;13;Lauantai;11;14;25;15;7;22
294;30.06.2018;2018;06;14;Lauantai;16;10;26;10;5;15
294;30.06.2018;2018;06;15;Lauantai;6;12;18;4;7;11
294;30.06.2018;2018;06;16;Lauantai;16;11;27;12;8;20
294;30.06.2018;2018;06;17;Lauantai;8;11;19;11;9;20
294;30.06.2018;2018;06;18;Lauantai;14;9;23;7;3;10
294;30.06.2018;2018;06;19;Lauantai;11;12;23;7;4;11
294;30.06.2018;2018;06;20;Lauantai;3;11;14;4;4;8
294;30.06.2018;2018;06;21;Lauantai;5;4;9;4;2;6
294;30.06.2018;2018;06;22;Lauantai;3;3;6;1;1;2
294;30.06.2018;2018;06;23;Lauantai;1;0;1;1;0;1
294;01.07.2018;2018;07;00;Sunnuntai;0;0;0;0;0;0
294;01.07.2018;2018;07;01;Sunnuntai;0;1;1;0;0;0
294;01.07.2018;2018;07;02;Sunnuntai;0;0;0;0;0;0
294;01.07.2018;2018;07;03;Sunnuntai;0;0;0;0;0;0
294;01.07.2018;2018;07;04;Sunnuntai;1;1;2;0;1;1
294;01.07.2018;2018;07;05;Sunnuntai;0;0;0;0;0;0
294;01.07.2018;2018;07;06;Sunnuntai;0;1;1;0;0;0
294;01.07.2018;2018;07;07;Sunnuntai;2;1;3;1;1;2
294;01.07.2018;2018;07;08;Sunnuntai;1;1;2;1;4;5
294;01.07.2018;2018;07;09;Sunnuntai;2;5;7;2;3;5
294;01.07.2018;2018;07;10;Sunnuntai;9;5;14;5;11;16
294;01.07.2018;2018;07;11;Sunnuntai;9;12;21;5;5;10
294;01.07.2018;2018;07;12;Sunnuntai;6;8;14;3;2;5
294;01.07.2018;2018;07;13;Sunnuntai;7;12;19;1;7;8
294;01.07.2018;2018;07;14;Sunnuntai;18;11;29;8;3;11
294;01.07.2018;2018;07;15;Sunnuntai;11;10;21;4;5;9
294;01.07.2018;2018;07;16;Sunnuntai;12;6;18;4;3;7
294;01.07.2018;2018;07;17;Sunnuntai;14;11;25;11;7;18
294;01.07.2018;2018;07;18;Sunnuntai;13;20;33;6;7;13
294;01.07.2018;2018;07;19;Sunnuntai;11;14;25;4;11;15
294;01.07.2018;2018;07;20;Sunnuntai;11;11;22;6;9;15
294;01.07.2018;2018;07;21;Sunnuntai;13;3;16;6;5;11
294;01.07.2018;2018;07;22;Sunnuntai;6;2;8;1;1;2
294;01.07.2018;2018;07;23;Sunnuntai;0;1;1;2;2;4
294;02.07.2018;2018;07;00;Maanantai;1;0;1;0;1;1
294;02.07.2018;2018;07;01;Maanantai;0;0;0;0;0;0
294;02.07.2018;2018;07;02;Maanantai;0;0;0;0;0;0
294;02.07.2018;2018;07;03;Maanantai;0;0;0;0;0;0
294;02.07.2018;2018;07;04;Maanantai;1;0;1;0;0;0
294;02.07.2018;2018;07;05;Maanantai;1;1;2;0;1;1
294;02.07.2018;2018;07;06;Maanantai;4;1;5;4;0;4
294;02.07.2018;2018;07;07;Maanantai;6;0;6;25;2;27
294;02.07.2018;2018;07;08;Maanantai;9;8;17;5;6;11
294;02.07.2018;2018;07;09;Maanantai;11;11;22;19;10;29
294;02.07.2018;2018;07;10;Maanantai;13;4;17;4;9;13
294;02.07.2018;2018;07;11;Maanantai;14;18;32;11;6;17
294;02.07.2018;2018;07;12;Maanantai;10;10;20;40;23;63
294;02.07.2018;2018;07;13;Maanantai;19;19;38;9;13;22
294;02.07.2018;2018;07;14;Maanantai;19;24;43;11;5;16
294;02.07.2018;2018;07;15;Maanantai;21;19;40;21;14;35
294;02.07.2018;2018;07;16;Maanantai;20;16;36;10;12;22
294;02.07.2018;2018;07;17;Maanantai;13;21;34;9;12;21
294;02.07.2018;2018;07;18;Maanantai;24;20;44;10;11;21
294;02.07.2018;2018;07;19;Maanantai;25;24;49;12;10;22
294;02.07.2018;2018;07;20;Maanantai;15;20;35;9;6;15
294;02.07.2018;2018;07;21;Maanantai;7;6;13;3;3;6
294;02.07.2018;2018;07;22;Maanantai;8;3;11;4;1;5
294;02.07.2018;2018;07;23;Maanantai;0;2;2;1;0;1
294;03.07.2018;2018;07;00;Tiistai;1;0;1;0;0;0
294;03.07.2018;2018;07;01;Tiistai;0;0;0;0;0;0
294;03.07.2018;2018;07;02;Tiistai;0;0;0;0;1;1
294;03.07.2018;2018;07;03;Tiistai;0;0;0;0;0;0
294;03.07.2018;2018;07;04;Tiistai;1;0;1;0;0;0
294;03.07.2018;2018;07;05;Tiistai;0;3;3;7;1;8
294;03.07.2018;2018;07;06;Tiistai;3;0;3;15;10;25
294;03.07.2018;2018;07;07;Tiistai;5;3;8;22;8;30
294;03.07.2018;2018;07;08;Tiistai;8;9;17;5;4;9
294;03.07.2018;2018;07;09;Tiistai;10;11;21;5;9;14
294;03.07.2018;2018;07;10;Tiistai;10;7;17;7;11;18
294;03.07.2018;2018;07;11;Tiistai;4;14;18;11;3;14
294;03.07.2018;2018;07;12;Tiistai;11;8;19;4;13;17
294;03.07.2018;2018;07;13;Tiistai;12;14;26;12;8;20
294;03.07.2018;2018;07;14;Tiistai;26;13;39;12;13;25
294;03.07.2018;2018;07;15;Tiistai;14;14;28;13;6;19
294;03.07.2018;2018;07;16;Tiistai;12;22;34;6;7;13
294;03.07.2018;2018;07;17;Tiistai;9;14;23;6;5;11
294;03.07.2018;2018;07;18;Tiistai;9;15;24;6;8;14
294;03.07.2018;2018;07;19;Tiistai;30;19;49;13;12;25
294;03.07.2018;2018;07;20;Tiistai;11;6;17;4;6;10
294;03.07.2018;2018;07;21;Tiistai;7;5;12;4;2;6
294;03.07.2018;2018;07;22;Tiistai;3;1;4;0;1;1
294;03.07.2018;2018;07;23;Tiistai;0;1;1;0;1;1
294;04.07.2018;2018;07;00;Keskiviikko;0;2;2;0;0;0
294;04.07.2018;2018;07;01;Keskiviikko;1;1;2;0;0;0
294;04.07.2018;2018;07;02;Keskiviikko;0;0;0;0;0;0
294;04.07.2018;2018;07;03;Keskiviikko;0;0;0;0;0;0
294;04.07.2018;2018;07;04;Keskiviikko;0;0;0;0;0;0
294;04.07.2018;2018;07;05;Keskiviikko;0;2;2;0;0;0
294;04.07.2018;2018;07;06;Keskiviikko;1;0;1;0;1;1
294;04.07.2018;2018;07;07;Keskiviikko;2;2;4;1;3;4
294;04.07.2018;2018;07;08;Keskiviikko;3;5;8;4;2;6
294;04.07.2018;2018;07;09;Keskiviikko;4;1;5;0;0;0
294;04.07.2018;2018;07;10;Keskiviikko;2;1;3;3;3;6
294;04.07.2018;2018;07;11;Keskiviikko;3;0;3;3;0;3
294;04.07.2018;2018;07;12;Keskiviikko;5;3;8;3;1;4
294;04.07.2018;2018;07;13;Keskiviikko;7;9;16;3;3;6
294;04.07.2018;2018;07;14;Keskiviikko;13;5;18;6;4;10
294;04.07.2018;2018;07;15;Keskiviikko;8;4;12;5;7;12
294;04.07.2018;2018;07;16;Keskiviikko;15;17;32;5;6;11
294;04.07.2018;2018;07;17;Keskiviikko;20;12;32;2;11;13
294;04.07.2018;2018;07;18;Keskiviikko;18;18;36;13;12;25
294;04.07.2018;2018;07;19;Keskiviikko;23;30;53;6;15;21
294;04.07.2018;2018;07;20;Keskiviikko;7;17;24;12;7;19
294;04.07.2018;2018;07;21;Keskiviikko;14;9;23;8;7;15
294;04.07.2018;2018;07;22;Keskiviikko;7;3;10;2;3;5
294;04.07.2018;2018;07;23;Keskiviikko;3;6;9;1;1;2
294;05.07.2018;2018;07;00;Torstai;2;1;3;0;0;0
294;05.07.2018;2018;07;01;Torstai;0;1;1;0;0;0
294;05.07.2018;2018;07;02;Torstai;2;0;2;0;0;0
294;05.07.2018;2018;07;03;Torstai;1;0;1;1;0;1
294;05.07.2018;2018;07;04;Torstai;1;0;1;0;0;0
294;05.07.2018;2018;07;05;Torstai;1;0;1;0;0;0
294;05.07.2018;2018;07;06;Torstai;3;0;3;2;0;2
294;05.07.2018;2018;07;07;Torstai;4;2;6;5;4;9
294;05.07.2018;2018;07;08;Torstai;10;8;18;3;1;4
294;05.07.2018;2018;07;09;Torstai;11;9;20;6;4;10
294;05.07.2018;2018;07;10;Torstai;16;13;29;7;11;18
294;05.07.2018;2018;07;11;Torstai;17;17;34;24;9;33
294;05.07.2018;2018;07;12;Torstai;16;20;36;10;8;18
294;05.07.2018;2018;07;13;Torstai;11;14;25;9;9;18
294;05.07.2018;2018;07;14;Torstai;13;10;23;3;10;13
294;05.07.2018;2018;07;15;Torstai;15;16;31;11;7;18
294;05.07.2018;2018;07;16;Torstai;15;17;32;3;6;9
294;05.07.2018;2018;07;17;Torstai;9;14;23;9;6;15
294;05.07.2018;2018;07;18;Torstai;19;16;35;7;9;16
294;05.07.2018;2018;07;19;Torstai;16;9;25;8;10;18
294;05.07.2018;2018;07;20;Torstai;5;10;15;3;5;8
294;05.07.2018;2018;07;21;Torstai;0;4;4;3;2;5
294;05.07.2018;2018;07;22;Torstai;2;4;6;0;0;0
294;05.07.2018;2018;07;23;Torstai;2;1;3;0;0;0
294;06.07.2018;2018;07;00;Perjantai;1;0;1;0;0;0
294;06.07.2018;2018;07;01;Perjantai;0;1;1;0;0;0
294;06.07.2018;2018;07;02;Perjantai;0;0;0;0;0;0
294;06.07.2018;2018;07;03;Perjantai;1;0;1;0;0;0
294;06.07.2018;2018;07;04;Perjantai;2;1;3;0;0;0
294;06.07.2018;2018;07;05;Perjantai;0;1;1;0;1;1
294;06.07.2018;2018;07;06;Perjantai;4;0;4;4;1;5
294;06.07.2018;2018;07;07;Perjantai;4;4;8;0;1;1
294;06.07.2018;2018;07;08;Perjantai;6;8;14;6;5;11
294;06.07.2018;2018;07;09;Perjantai;10;7;17;4;3;7
294;06.07.2018;2018;07;10;Perjantai;10;14;24;8;11;19
294;06.07.2018;2018;07;11;Perjantai;11;13;24;18;8;26
294;06.07.2018;2018;07;12;Perjantai;13;23;36;52;26;78
294;06.07.2018;2018;07;13;Perjantai;29;30;59;16;15;31
294;06.07.2018;2018;07;14;Perjantai;17;19;36;12;11;23
294;06.07.2018;2018;07;15;Perjantai;22;19;41;11;8;19
294;06.07.2018;2018;07;16;Perjantai;33;27;60;8;6;14
294;06.07.2018;2018;07;17;Perjantai;20;7;27;3;1;4
294;06.07.2018;2018;07;18;Perjantai;14;31;45;11;11;22
294;06.07.2018;2018;07;19;Perjantai;23;13;36;7;7;14
294;06.07.2018;2018;07;20;Perjantai;20;6;26;5;10;15
294;06.07.2018;2018;07;21;Perjantai;7;4;11;2;4;6
294;06.07.2018;2018;07;22;Perjantai;3;3;6;1;0;1
294;06.07.2018;2018;07;23;Perjantai;2;0;2;3;0;3
294;07.07.2018;2018;07;00;Lauantai;0;1;1;0;1;1
294;07.07.2018;2018;07;01;Lauantai;0;0;0;0;0;0
294;07.07.2018;2018;07;02;Lauantai;0;0;0;0;0;0
294;07.07.2018;2018;07;03;Lauantai;0;0;0;0;0;0
294;07.07.2018;2018;07;04;Lauantai;1;0;1;0;1;1
294;07.07.2018;2018;07;05;Lauantai;0;0;0;0;0;0
294;07.07.2018;2018;07;06;Lauantai;2;1;3;3;0;3
294;07.07.2018;2018;07;07;Lauantai;1;0;1;0;0;0
294;07.07.2018;2018;07;08;Lauantai;5;6;11;4;6;10
294;07.07.2018;2018;07;09;Lauantai;12;13;25;1;3;4
294;07.07.2018;2018;07;10;Lauantai;15;14;29;3;4;7
294;07.07.2018;2018;07;11;Lauantai;13;14;27;7;8;15
294;07.07.2018;2018;07;12;Lauantai;15;19;34;3;6;9
294;07.07.2018;2018;07;13;Lauantai;19;15;34;4;2;6
294;07.07.2018;2018;07;14;Lauantai;19;13;32;7;7;14
294;07.07.2018;2018;07;15;Lauantai;7;12;19;6;6;12
294;07.07.2018;2018;07;16;Lauantai;19;19;38;3;8;11
294;07.07.2018;2018;07;17;Lauantai;16;10;26;5;7;12
294;07.07.2018;2018;07;18;Lauantai;9;15;24;2;4;6
294;07.07.2018;2018;07;19;Lauantai;15;13;28;5;6;11
294;07.07.2018;2018;07;20;Lauantai;13;10;23;2;4;6
294;07.07.2018;2018;07;21;Lauantai;10;1;11;1;1;2
294;07.07.2018;2018;07;22;Lauantai;1;0;1;0;0;0
294;07.07.2018;2018;07;23;Lauantai;2;6;8;0;0;0
294;08.07.2018;2018;07;00;Sunnuntai;0;0;0;0;0;0
294;08.07.2018;2018;07;01;Sunnuntai;1;0;1;0;0;0
294;08.07.2018;2018;07;02;Sunnuntai;0;0;0;1;0;1
294;08.07.2018;2018;07;03;Sunnuntai;0;1;1;0;0;0
294;08.07.2018;2018;07;04;Sunnuntai;1;0;1;0;0;0
294;08.07.2018;2018;07;05;Sunnuntai;0;0;0;0;0;0
294;08.07.2018;2018;07;06;Sunnuntai;0;0;0;1;0;1
294;08.07.2018;2018;07;07;Sunnuntai;3;1;4;2;1;3
294;08.07.2018;2018;07;08;Sunnuntai;2;1;3;1;2;3
294;08.07.2018;2018;07;09;Sunnuntai;3;8;11;4;3;7
294;08.07.2018;2018;07;10;Sunnuntai;1;2;3;3;4;7
294;08.07.2018;2018;07;11;Sunnuntai;12;18;30;3;6;9
294;08.07.2018;2018;07;12;Sunnuntai;14;9;23;3;6;9
294;08.07.2018;2018;07;13;Sunnuntai;11;11;22;8;4;12
294;08.07.2018;2018;07;14;Sunnuntai;22;14;36;7;4;11
294;08.07.2018;2018;07;15;Sunnuntai;15;12;27;5;3;8
294;08.07.2018;2018;07;16;Sunnuntai;7;18;25;8;4;12
294;08.07.2018;2018;07;17;Sunnuntai;18;10;28;7;3;10
294;08.07.2018;2018;07;18;Sunnuntai;17;12;29;6;4;10
294;08.07.2018;2018;07;19;Sunnuntai;27;20;47;12;6;18
294;08.07.2018;2018;07;20;Sunnuntai;15;15;30;1;8;9
294;08.07.2018;2018;07;21;Sunnuntai;6;10;16;4;1;5
294;08.07.2018;2018;07;22;Sunnuntai;3;1;4;1;1;2
294;08.07.2018;2018;07;23;Sunnuntai;5;1;6;2;0;2
294;09.07.2018;2018;07;00;Maanantai;1;2;3;0;1;1
294;09.07.2018;2018;07;01;Maanantai;0;0;0;0;0;0
294;09.07.2018;2018;07;02;Maanantai;0;0;0;0;0;0
294;09.07.2018;2018;07;03;Maanantai;0;0;0;0;0;0
294;09.07.2018;2018;07;04;Maanantai;1;0;1;0;0;0
294;09.07.2018;2018;07;05;Maanantai;0;1;1;1;0;1
294;09.07.2018;2018;07;06;Maanantai;3;0;3;9;0;9
294;09.07.2018;2018;07;07;Maanantai;4;5;9;30;10;40
294;09.07.2018;2018;07;08;Maanantai;7;7;14;13;4;17
294;09.07.2018;2018;07;09;Maanantai;10;7;17;9;2;11
294;09.07.2018;2018;07;10;Maanantai;15;12;27;5;5;10
294;09.07.2018;2018;07;11;Maanantai;19;25;44;9;8;17
294;09.07.2018;2018;07;12;Maanantai;17;20;37;7;5;12
294;09.07.2018;2018;07;13;Maanantai;20;10;30;9;7;16
294;09.07.2018;2018;07;14;Maanantai;22;24;46;6;4;10
294;09.07.2018;2018;07;15;Maanantai;16;22;38;4;6;10
294;09.07.2018;2018;07;16;Maanantai;28;9;37;7;2;9
294;09.07.2018;2018;07;17;Maanantai;16;14;30;6;4;10
294;09.07.2018;2018;07;18;Maanantai;27;15;42;7;5;12
294;09.07.2018;2018;07;19;Maanantai;29;20;49;13;4;17
294;09.07.2018;2018;07;20;Maanantai;14;15;29;7;10;17
294;09.07.2018;2018;07;21;Maanantai;15;17;32;2;2;4
294;09.07.2018;2018;07;22;Maanantai;7;10;17;3;1;4
294;09.07.2018;2018;07;23;Maanantai;5;0;5;0;0;0
294;10.07.2018;2018;07;00;Tiistai;0;0;0;0;0;0
294;10.07.2018;2018;07;01;Tiistai;1;0;1;0;0;0
294;10.07.2018;2018;07;02;Tiistai;1;0;1;0;0;0
294;10.07.2018;2018;07;03;Tiistai;2;0;2;0;0;0
294;10.07.2018;2018;07;04;Tiistai;1;0;1;0;0;0
294;10.07.2018;2018;07;05;Tiistai;0;1;1;0;0;0
294;10.07.2018;2018;07;06;Tiistai;4;1;5;2;0;2
294;10.07.2018;2018;07;07;Tiistai;2;2;4;4;2;6
294;10.07.2018;2018;07;08;Tiistai;9;10;19;2;4;6
294;10.07.2018;2018;07;09;Tiistai;12;10;22;33;15;48
294;10.07.2018;2018;07;10;Tiistai;24;19;43;35;18;53
294;10.07.2018;2018;07;11;Tiistai;19;18;37;13;12;25
294;10.07.2018;2018;07;12;Tiistai;28;26;54;11;9;20
294;10.07.2018;2018;07;13;Tiistai;6;14;20;14;8;22
294;10.07.2018;2018;07;14;Tiistai;16;10;26;8;5;13
294;10.07.2018;2018;07;15;Tiistai;17;11;28;15;6;21
294;10.07.2018;2018;07;16;Tiistai;19;12;31;7;8;15
294;10.07.2018;2018;07;17;Tiistai;13;18;31;4;5;9
294;10.07.2018;2018;07;18;Tiistai;28;24;52;5;4;9
294;10.07.2018;2018;07;19;Tiistai;17;19;36;10;9;19
294;10.07.2018;2018;07;20;Tiistai;8;13;21;4;3;7
294;10.07.2018;2018;07;21;Tiistai;18;6;24;4;4;8
294;10.07.2018;2018;07;22;Tiistai;2;6;8;2;0;2
294;10.07.2018;2018;07;23;Tiistai;3;0;3;0;0;0
294;11.07.2018;2018;07;00;Keskiviikko;1;2;3;0;0;0
294;11.07.2018;2018;07;01;Keskiviikko;5;0;5;0;0;0
294;11.07.2018;2018;07;02;Keskiviikko;0;0;0;0;0;0
294;11.07.2018;2018;07;03;Keskiviikko;0;0;0;0;0;0
294;11.07.2018;2018;07;04;Keskiviikko;0;0;0;0;0;0
294;11.07.2018;2018;07;05;Keskiviikko;1;2;3;1;0;1
294;11.07.2018;2018;07;06;Keskiviikko;3;2;5;0;0;0
294;11.07.2018;2018;07;07;Keskiviikko;8;7;15;72;22;94
294;11.07.2018;2018;07;08;Keskiviikko;5;7;12;5;5;10
294;11.07.2018;2018;07;09;Keskiviikko;8;12;20;26;14;40
294;11.07.2018;2018;07;10;Keskiviikko;10;12;22;15;14;29
294;11.07.2018;2018;07;11;Keskiviikko;22;18;40;69;12;81
294;11.07.2018;2018;07;12;Keskiviikko;23;18;41;160;29;189
294;11.07.2018;2018;07;13;Keskiviikko;19;16;35;11;11;22
294;11.07.2018;2018;07;14;Keskiviikko;16;13;29;15;3;18
294;11.07.2018;2018;07;15;Keskiviikko;16;16;32;59;8;67
294;11.07.2018;2018;07;16;Keskiviikko;12;17;29;6;7;13
294;11.07.2018;2018;07;17;Keskiviikko;13;10;23;7;5;12
294;11.07.2018;2018;07;18;Keskiviikko;28;21;49;11;12;23
294;11.07.2018;2018;07;19;Keskiviikko;15;12;27;14;9;23
294;11.07.2018;2018;07;20;Keskiviikko;12;7;19;7;5;12
294;11.07.2018;2018;07;21;Keskiviikko;12;9;21;3;6;9
294;11.07.2018;2018;07;22;Keskiviikko;9;0;9;1;3;4
294;11.07.2018;2018;07;23;Keskiviikko;0;0;0;0;1;1
294;12.07.2018;2018;07;00;Torstai;1;1;2;0;1;1
294;12.07.2018;2018;07;01;Torstai;0;0;0;0;0;0
294;12.07.2018;2018;07;02;Torstai;0;0;0;0;0;0
294;12.07.2018;2018;07;03;Torstai;0;0;0;0;0;0
294;12.07.2018;2018;07;04;Torstai;0;0;0;0;0;0
294;12.07.2018;2018;07;05;Torstai;1;1;2;0;0;0
294;12.07.2018;2018;07;06;Torstai;1;4;5;1;0;1
294;12.07.2018;2018;07;07;Torstai;3;3;6;1;0;1
294;12.07.2018;2018;07;08;Torstai;4;6;10;2;7;9
294;12.07.2018;2018;07;09;Torstai;7;5;12;18;9;27
294;12.07.2018;2018;07;10;Torstai;7;16;23;14;7;21
294;12.07.2018;2018;07;11;Torstai;31;16;47;40;7;47
294;12.07.2018;2018;07;12;Torstai;25;16;41;60;7;67
294;12.07.2018;2018;07;13;Torstai;15;12;27;33;7;40
294;12.07.2018;2018;07;14;Torstai;25;17;42;7;5;12
294;12.07.2018;2018;07;15;Torstai;25;17;42;13;11;24
294;12.07.2018;2018;07;16;Torstai;34;13;47;5;2;7
294;12.07.2018;2018;07;17;Torstai;25;17;42;5;4;9
294;12.07.2018;2018;07;18;Torstai;14;13;27;5;4;9
294;12.07.2018;2018;07;19;Torstai;19;20;39;4;2;6
294;12.07.2018;2018;07;20;Torstai;14;18;32;8;9;17
294;12.07.2018;2018;07;21;Torstai;12;12;24;3;4;7
294;12.07.2018;2018;07;22;Torstai;6;4;10;0;2;2
294;12.07.2018;2018;07;23;Torstai;2;3;5;1;1;2
294;13.07.2018;2018;07;00;Perjantai;1;4;5;0;0;0
294;13.07.2018;2018;07;01;Perjantai;0;0;0;0;0;0
294;13.07.2018;2018;07;02;Perjantai;0;0;0;0;0;0
294;13.07.2018;2018;07;03;Perjantai;0;0;0;0;0;0
294;13.07.2018;2018;07;04;Perjantai;1;0;1;0;0;0
294;13.07.2018;2018;07;05;Perjantai;0;1;1;0;0;0
294;13.07.2018;2018;07;06;Perjantai;2;0;2;2;0;2
294;13.07.2018;2018;07;07;Perjantai;4;2;6;5;3;8
294;13.07.2018;2018;07;08;Perjantai;6;8;14;2;2;4
294;13.07.2018;2018;07;09;Perjantai;17;10;27;3;4;7
294;13.07.2018;2018;07;10;Perjantai;20;19;39;9;6;15
294;13.07.2018;2018;07;11;Perjantai;19;21;40;19;11;30
294;13.07.2018;2018;07;12;Perjantai;20;15;35;35;13;48
294;13.07.2018;2018;07;13;Perjantai;16;20;36;15;5;20
294;13.07.2018;2018;07;14;Perjantai;8;7;15;18;0;18
294;13.07.2018;2018;07;15;Perjantai;22;23;45;4;6;10
294;13.07.2018;2018;07;16;Perjantai;26;21;47;3;3;6
294;13.07.2018;2018;07;17;Perjantai;21;9;30;4;2;6
294;13.07.2018;2018;07;18;Perjantai;26;10;36;14;2;16
294;13.07.2018;2018;07;19;Perjantai;10;20;30;6;3;9
294;13.07.2018;2018;07;20;Perjantai;19;12;31;4;2;6
294;13.07.2018;2018;07;21;Perjantai;8;4;12;4;8;12
294;13.07.2018;2018;07;22;Perjantai;7;1;8;3;3;6
294;13.07.2018;2018;07;23;Perjantai;1;1;2;0;1;1
294;14.07.2018;2018;07;00;Lauantai;5;0;5;0;0;0
294;14.07.2018;2018;07;01;Lauantai;0;0;0;2;0;2
294;14.07.2018;2018;07;02;Lauantai;1;0;1;0;0;0
294;14.07.2018;2018;07;03;Lauantai;4;1;5;0;0;0
294;14.07.2018;2018;07;04;Lauantai;1;0;1;0;0;0
294;14.07.2018;2018;07;05;Lauantai;0;1;1;0;0;0
294;14.07.2018;2018;07;06;Lauantai;0;2;2;0;0;0
294;14.07.2018;2018;07;07;Lauantai;1;0;1;0;0;0
294;14.07.2018;2018;07;08;Lauantai;4;1;5;4;5;9
294;14.07.2018;2018;07;09;Lauantai;11;10;21;4;3;7
294;14.07.2018;2018;07;10;Lauantai;16;15;31;2;5;7
294;14.07.2018;2018;07;11;Lauantai;16;18;34;8;8;16
294;14.07.2018;2018;07;12;Lauantai;10;18;28;16;9;25
294;14.07.2018;2018;07;13;Lauantai;12;16;28;8;5;13
294;14.07.2018;2018;07;14;Lauantai;21;15;36;2;3;5
294;14.07.2018;2018;07;15;Lauantai;25;12;37;3;2;5
294;14.07.2018;2018;07;16;Lauantai;10;18;28;2;4;6
294;14.07.2018;2018;07;17;Lauantai;21;20;41;8;5;13
294;14.07.2018;2018;07;18;Lauantai;19;17;36;6;3;9
294;14.07.2018;2018;07;19;Lauantai;16;17;33;3;4;7
294;14.07.2018;2018;07;20;Lauantai;18;15;33;6;4;10
294;14.07.2018;2018;07;21;Lauantai;13;7;20;2;2;4
294;14.07.2018;2018;07;22;Lauantai;6;2;8;1;1;2
294;14.07.2018;2018;07;23;Lauantai;3;0;3;2;1;3
294;15.07.2018;2018;07;00;Sunnuntai;5;0;5;0;0;0
294;15.07.2018;2018;07;01;Sunnuntai;2;0;2;0;0;0
294;15.07.2018;2018;07;02;Sunnuntai;0;1;1;1;0;1
294;15.07.2018;2018;07;03;Sunnuntai;0;0;0;0;0;0
294;15.07.2018;2018;07;04;Sunnuntai;1;0;1;0;0;0
294;15.07.2018;2018;07;05;Sunnuntai;1;0;1;0;0;0
294;15.07.2018;2018;07;06;Sunnuntai;2;0;2;0;0;0
294;15.07.2018;2018;07;07;Sunnuntai;3;2;5;10;2;12
294;15.07.2018;2018;07;08;Sunnuntai;2;0;2;3;3;6
294;15.07.2018;2018;07;09;Sunnuntai;16;14;30;6;4;10
294;15.07.2018;2018;07;10;Sunnuntai;9;8;17;12;2;14
294;15.07.2018;2018;07;11;Sunnuntai;20;12;32;24;11;35
294;15.07.2018;2018;07;12;Sunnuntai;13;15;28;22;13;35
294;15.07.2018;2018;07;13;Sunnuntai;20;10;30;5;8;13
294;15.07.2018;2018;07;14;Sunnuntai;15;4;19;5;5;10
294;15.07.2018;2018;07;15;Sunnuntai;15;13;28;6;2;8
294;15.07.2018;2018;07;16;Sunnuntai;18;9;27;2;3;5
294;15.07.2018;2018;07;17;Sunnuntai;11;18;29;5;3;8
294;15.07.2018;2018;07;18;Sunnuntai;16;16;32;5;6;11
294;15.07.2018;2018;07;19;Sunnuntai;17;18;35;4;1;5
294;15.07.2018;2018;07;20;Sunnuntai;31;22;53;5;5;10
294;15.07.2018;2018;07;21;Sunnuntai;12;9;21;8;2;10
294;15.07.2018;2018;07;22;Sunnuntai;5;0;5;1;1;2
294;15.07.2018;2018;07;23;Sunnuntai;6;3;9;0;1;1
294;16.07.2018;2018;07;00;Maanantai;0;0;0;0;0;0
294;16.07.2018;2018;07;01;Maanantai;1;0;1;0;0;0
294;16.07.2018;2018;07;02;Maanantai;0;0;0;0;0;0
294;16.07.2018;2018;07;03;Maanantai;1;0;1;0;0;0
294;16.07.2018;2018;07;04;Maanantai;0;0;0;1;0;1
294;16.07.2018;2018;07;05;Maanantai;0;1;1;0;0;0
294;16.07.2018;2018;07;06;Maanantai;2;0;2;0;0;0
294;16.07.2018;2018;07;07;Maanantai;2;2;4;1;2;3
294;16.07.2018;2018;07;08;Maanantai;6;4;10;5;1;6
294;16.07.2018;2018;07;09;Maanantai;17;12;29;0;1;1
294;16.07.2018;2018;07;10;Maanantai;7;8;15;0;5;5
294;16.07.2018;2018;07;11;Maanantai;31;25;56;11;12;23
294;16.07.2018;2018;07;12;Maanantai;9;14;23;13;11;24
294;16.07.2018;2018;07;13;Maanantai;21;14;35;5;4;9
294;16.07.2018;2018;07;14;Maanantai;7;17;24;4;6;10
294;16.07.2018;2018;07;15;Maanantai;18;28;46;5;9;14
294;16.07.2018;2018;07;16;Maanantai;22;11;33;5;3;8
294;16.07.2018;2018;07;17;Maanantai;17;17;34;5;4;9
294;16.07.2018;2018;07;18;Maanantai;21;26;47;7;7;14
294;16.07.2018;2018;07;19;Maanantai;23;19;42;7;6;13
294;16.07.2018;2018;07;20;Maanantai;18;11;29;5;11;16
294;16.07.2018;2018;07;21;Maanantai;10;7;17;7;6;13
294;16.07.2018;2018;07;22;Maanantai;9;7;16;5;2;7
294;16.07.2018;2018;07;23;Maanantai;3;4;7;3;0;3
294;17.07.2018;2018;07;00;Tiistai;1;3;4;0;1;1
294;17.07.2018;2018;07;01;Tiistai;0;3;3;0;0;0
294;17.07.2018;2018;07;02;Tiistai;0;1;1;0;0;0
294;17.07.2018;2018;07;03;Tiistai;0;0;0;0;0;0
294;17.07.2018;2018;07;04;Tiistai;1;0;1;0;0;0
294;17.07.2018;2018;07;05;Tiistai;0;2;2;0;0;0
294;17.07.2018;2018;07;06;Tiistai;4;3;7;0;0;0
294;17.07.2018;2018;07;07;Tiistai;4;7;11;1;0;1
294;17.07.2018;2018;07;08;Tiistai;9;6;15;3;4;7
294;17.07.2018;2018;07;09;Tiistai;13;12;25;5;4;9
294;17.07.2018;2018;07;10;Tiistai;7;5;12;7;5;12
294;17.07.2018;2018;07;11;Tiistai;12;17;29;4;3;7
294;17.07.2018;2018;07;12;Tiistai;18;16;34;13;7;20
294;17.07.2018;2018;07;13;Tiistai;17;25;42;3;0;3
294;17.07.2018;2018;07;14;Tiistai;19;11;30;6;7;13
294;17.07.2018;2018;07;15;Tiistai;17;26;43;4;2;6
294;17.07.2018;2018;07;16;Tiistai;28;16;44;3;4;7
294;17.07.2018;2018;07;17;Tiistai;19;18;37;1;2;3
294;17.07.2018;2018;07;18;Tiistai;18;10;28;4;2;6
294;17.07.2018;2018;07;19;Tiistai;21;14;35;6;6;12
294;17.07.2018;2018;07;20;Tiistai;28;22;50;4;7;11
294;17.07.2018;2018;07;21;Tiistai;7;8;15;4;3;7
294;17.07.2018;2018;07;22;Tiistai;4;2;6;2;1;3
294;17.07.2018;2018;07;23;Tiistai;3;3;6;2;2;4
294;18.07.2018;2018;07;00;Keskiviikko;2;2;4;1;0;1
294;18.07.2018;2018;07;01;Keskiviikko;0;0;0;0;0;0
294;18.07.2018;2018;07;02;Keskiviikko;0;0;0;0;0;0
294;18.07.2018;2018;07;03;Keskiviikko;1;0;1;0;0;0
294;18.07.2018;2018;07;04;Keskiviikko;1;0;1;0;1;1
294;18.07.2018;2018;07;05;Keskiviikko;0;1;1;0;0;0
294;18.07.2018;2018;07;06;Keskiviikko;2;1;3;6;2;8
294;18.07.2018;2018;07;07;Keskiviikko;3;3;6;4;4;8
294;18.07.2018;2018;07;08;Keskiviikko;6;5;11;5;1;6
294;18.07.2018;2018;07;09;Keskiviikko;11;10;21;3;4;7
294;18.07.2018;2018;07;10;Keskiviikko;20;17;37;5;2;7
294;18.07.2018;2018;07;11;Keskiviikko;12;20;32;25;15;40
294;18.07.2018;2018;07;12;Keskiviikko;11;12;23;164;51;215
294;18.07.2018;2018;07;13;Keskiviikko;18;9;27;109;5;114
294;18.07.2018;2018;07;14;Keskiviikko;15;19;34;10;3;13
294;18.07.2018;2018;07;15;Keskiviikko;19;22;41;43;10;53
294;18.07.2018;2018;07;16;Keskiviikko;15;16;31;6;3;9
294;18.07.2018;2018;07;17;Keskiviikko;20;11;31;7;4;11
294;18.07.2018;2018;07;18;Keskiviikko;23;13;36;5;2;7
294;18.07.2018;2018;07;19;Keskiviikko;16;14;30;37;7;44
294;18.07.2018;2018;07;20;Keskiviikko;18;16;34;8;2;10
294;18.07.2018;2018;07;21;Keskiviikko;12;4;16;6;2;8
294;18.07.2018;2018;07;22;Keskiviikko;12;4;16;3;1;4
294;18.07.2018;2018;07;23;Keskiviikko;2;3;5;1;0;1
294;19.07.2018;2018;07;00;Torstai;0;3;3;0;1;1
294;19.07.2018;2018;07;01;Torstai;0;0;0;0;0;0
294;19.07.2018;2018;07;02;Torstai;0;1;1;0;0;0
294;19.07.2018;2018;07;03;Torstai;0;0;0;0;0;0
294;19.07.2018;2018;07;04;Torstai;2;1;3;0;0;0
294;19.07.2018;2018;07;05;Torstai;0;1;1;3;0;3
294;19.07.2018;2018;07;06;Torstai;4;4;8;62;26;88
294;19.07.2018;2018;07;07;Torstai;5;6;11;54;30;84
294;19.07.2018;2018;07;08;Torstai;5;6;11;6;2;8
294;19.07.2018;2018;07;09;Torstai;9;9;18;16;10;26
294;19.07.2018;2018;07;10;Torstai;16;13;29;74;29;103
294;19.07.2018;2018;07;11;Torstai;17;17;34;237;74;311
294;19.07.2018;2018;07;12;Torstai;15;21;36;473;135;608
294;19.07.2018;2018;07;13;Torstai;27;19;46;179;32;211
294;19.07.2018;2018;07;14;Torstai;15;9;24;44;2;46
294;19.07.2018;2018;07;15;Torstai;16;20;36;194;47;241
294;19.07.2018;2018;07;16;Torstai;12;8;20;69;3;72
294;19.07.2018;2018;07;17;Torstai;23;21;44;4;0;4
294;19.07.2018;2018;07;18;Torstai;16;12;28;1;1;2
294;19.07.2018;2018;07;19;Torstai;20;15;35;39;2;41
294;19.07.2018;2018;07;20;Torstai;19;14;33;5;1;6
294;19.07.2018;2018;07;21;Torstai;11;7;18;2;6;8
294;19.07.2018;2018;07;22;Torstai;9;2;11;0;2;2
294;19.07.2018;2018;07;23;Torstai;1;1;2;1;0;1
294;20.07.2018;2018;07;00;Perjantai;0;0;0;0;1;1
294;20.07.2018;2018;07;01;Perjantai;0;0;0;0;0;0
294;20.07.2018;2018;07;02;Perjantai;1;0;1;0;0;0
294;20.07.2018;2018;07;03;Perjantai;0;0;0;0;0;0
294;20.07.2018;2018;07;04;Perjantai;1;0;1;0;0;0
294;20.07.2018;2018;07;05;Perjantai;0;1;1;1;2;3
294;20.07.2018;2018;07;06;Perjantai;1;1;2;28;10;38
294;20.07.2018;2018;07;07;Perjantai;4;3;7;76;24;100
294;20.07.2018;2018;07;08;Perjantai;5;5;10;2;3;5
294;20.07.2018;2018;07;09;Perjantai;8;10;18;19;3;22
294;20.07.2018;2018;07;10;Perjantai;16;10;26;28;12;40
294;20.07.2018;2018;07;11;Perjantai;13;16;29;190;54;244
294;20.07.2018;2018;07;12;Perjantai;21;23;44;346;68;414
294;20.07.2018;2018;07;13;Perjantai;20;11;31;95;9;104
294;20.07.2018;2018;07;14;Perjantai;18;14;32;38;5;43
294;20.07.2018;2018;07;15;Perjantai;18;17;35;96;17;113
294;20.07.2018;2018;07;16;Perjantai;32;24;56;17;1;18
294;20.07.2018;2018;07;17;Perjantai;11;13;24;11;1;12
294;20.07.2018;2018;07;18;Perjantai;12;9;21;2;6;8
294;20.07.2018;2018;07;19;Perjantai;10;15;25;9;4;13
294;20.07.2018;2018;07;20;Perjantai;22;13;35;3;4;7
294;20.07.2018;2018;07;21;Perjantai;10;6;16;4;3;7
294;20.07.2018;2018;07;22;Perjantai;5;4;9;6;1;7
294;20.07.2018;2018;07;23;Perjantai;9;5;14;1;1;2
294;21.07.2018;2018;07;00;Lauantai;6;2;8;1;1;2
294;21.07.2018;2018;07;01;Lauantai;1;2;3;0;1;1
294;21.07.2018;2018;07;02;Lauantai;2;1;3;0;0;0
294;21.07.2018;2018;07;03;Lauantai;1;0;1;0;1;1
294;21.07.2018;2018;07;04;Lauantai;1;0;1;0;0;0
294;21.07.2018;2018;07;05;Lauantai;0;3;3;0;0;0
294;21.07.2018;2018;07;06;Lauantai;0;1;1;0;1;1
294;21.07.2018;2018;07;07;Lauantai;2;3;5;2;2;4
294;21.07.2018;2018;07;08;Lauantai;6;7;13;5;2;7
294;21.07.2018;2018;07;09;Lauantai;9;7;16;7;2;9
294;21.07.2018;2018;07;10;Lauantai;12;13;25;9;4;13
294;21.07.2018;2018;07;11;Lauantai;18;17;35;8;6;14
294;21.07.2018;2018;07;12;Lauantai;25;13;38;5;5;10
294;21.07.2018;2018;07;13;Lauantai;8;23;31;7;4;11
294;21.07.2018;2018;07;14;Lauantai;10;8;18;5;1;6
294;21.07.2018;2018;07;15;Lauantai;11;16;27;6;1;7
294;21.07.2018;2018;07;16;Lauantai;15;10;25;9;3;12
294;21.07.2018;2018;07;17;Lauantai;21;15;36;4;4;8
294;21.07.2018;2018;07;18;Lauantai;20;17;37;4;3;7
294;21.07.2018;2018;07;19;Lauantai;22;12;34;7;3;10
294;21.07.2018;2018;07;20;Lauantai;13;4;17;6;4;10
294;21.07.2018;2018;07;21;Lauantai;7;6;13;1;0;1
294;21.07.2018;2018;07;22;Lauantai;5;5;10;0;1;1
294;21.07.2018;2018;07;23;Lauantai;1;0;1;5;0;5
294;22.07.2018;2018;07;00;Sunnuntai;0;1;1;0;0;0
294;22.07.2018;2018;07;01;Sunnuntai;0;1;1;0;0;0
294;22.07.2018;2018;07;02;Sunnuntai;1;0;1;1;1;2
294;22.07.2018;2018;07;03;Sunnuntai;0;0;0;0;0;0
294;22.07.2018;2018;07;04;Sunnuntai;1;0;1;0;0;0
294;22.07.2018;2018;07;05;Sunnuntai;0;0;0;1;0;1
294;22.07.2018;2018;07;06;Sunnuntai;0;2;2;0;0;0
294;22.07.2018;2018;07;07;Sunnuntai;0;1;1;0;0;0
294;22.07.2018;2018;07;08;Sunnuntai;1;1;2;0;0;0
294;22.07.2018;2018;07;09;Sunnuntai;10;4;14;2;3;5
294;22.07.2018;2018;07;10;Sunnuntai;7;6;13;1;4;5
294;22.07.2018;2018;07;11;Sunnuntai;6;5;11;32;9;41
294;22.07.2018;2018;07;12;Sunnuntai;10;7;17;87;22;109
294;22.07.2018;2018;07;13;Sunnuntai;5;8;13;19;3;22
294;22.07.2018;2018;07;14;Sunnuntai;7;7;14;0;0;0
294;22.07.2018;2018;07;15;Sunnuntai;15;10;25;1;1;2
294;22.07.2018;2018;07;16;Sunnuntai;17;6;23;2;4;6
294;22.07.2018;2018;07;17;Sunnuntai;5;2;7;0;0;0
294;22.07.2018;2018;07;18;Sunnuntai;12;13;25;7;6;13
294;22.07.2018;2018;07;19;Sunnuntai;14;6;20;2;3;5
294;22.07.2018;2018;07;20;Sunnuntai;5;7;12;3;3;6
294;22.07.2018;2018;07;21;Sunnuntai;2;1;3;5;0;5
294;22.07.2018;2018;07;22;Sunnuntai;7;5;12;2;4;6
294;22.07.2018;2018;07;23;Sunnuntai;2;2;4;0;0;0
294;23.07.2018;2018;07;00;Maanantai;2;1;3;0;0;0
294;23.07.2018;2018;07;01;Maanantai;3;3;6;0;0;0
294;23.07.2018;2018;07;02;Maanantai;0;0;0;0;0;0
294;23.07.2018;2018;07;03;Maanantai;0;0;0;0;0;0
294;23.07.2018;2018;07;04;Maanantai;0;0;0;0;1;1
294;23.07.2018;2018;07;05;Maanantai;0;1;1;0;0;0
294;23.07.2018;2018;07;06;Maanantai;1;0;1;2;2;4
294;23.07.2018;2018;07;07;Maanantai;5;1;6;2;4;6
294;23.07.2018;2018;07;08;Maanantai;9;4;13;3;6;9
294;23.07.2018;2018;07;09;Maanantai;12;4;16;3;3;6
294;23.07.2018;2018;07;10;Maanantai;7;16;23;2;6;8
294;23.07.2018;2018;07;11;Maanantai;19;11;30;7;8;15
294;23.07.2018;2018;07;12;Maanantai;12;11;23;3;2;5
294;23.07.2018;2018;07;13;Maanantai;29;24;53;11;6;17
294;23.07.2018;2018;07;14;Maanantai;21;15;36;7;6;13
294;23.07.2018;2018;07;15;Maanantai;20;23;43;3;3;6
294;23.07.2018;2018;07;16;Maanantai;19;18;37;5;3;8
294;23.07.2018;2018;07;17;Maanantai;18;22;40;6;5;11
294;23.07.2018;2018;07;18;Maanantai;34;21;55;18;11;29
294;23.07.2018;2018;07;19;Maanantai;11;26;37;12;12;24
294;23.07.2018;2018;07;20;Maanantai;27;20;47;8;11;19
294;23.07.2018;2018;07;21;Maanantai;9;10;19;10;4;14
294;23.07.2018;2018;07;22;Maanantai;11;10;21;0;3;3
294;23.07.2018;2018;07;23;Maanantai;2;1;3;0;0;0
294;24.07.2018;2018;07;00;Tiistai;1;1;2;0;0;0
294;24.07.2018;2018;07;01;Tiistai;0;0;0;0;0;0
294;24.07.2018;2018;07;02;Tiistai;0;0;0;0;0;0
294;24.07.2018;2018;07;03;Tiistai;0;0;0;0;0;0
294;24.07.2018;2018;07;04;Tiistai;1;0;1;0;0;0
294;24.07.2018;2018;07;05;Tiistai;0;1;1;0;0;0
294;24.07.2018;2018;07;06;Tiistai;4;1;5;0;1;1
294;24.07.2018;2018;07;07;Tiistai;3;1;4;2;0;2
294;24.07.2018;2018;07;08;Tiistai;5;5;10;4;5;9
294;24.07.2018;2018;07;09;Tiistai;14;9;23;6;4;10
294;24.07.2018;2018;07;10;Tiistai;16;14;30;4;10;14
294;24.07.2018;2018;07;11;Tiistai;18;12;30;11;10;21
294;24.07.2018;2018;07;12;Tiistai;31;18;49;11;4;15
294;24.07.2018;2018;07;13;Tiistai;20;21;41;6;3;9
294;24.07.2018;2018;07;14;Tiistai;10;20;30;1;3;4
294;24.07.2018;2018;07;15;Tiistai;16;18;34;1;5;6
294;24.07.2018;2018;07;16;Tiistai;24;12;36;4;3;7
294;24.07.2018;2018;07;17;Tiistai;21;11;32;3;5;8
294;24.07.2018;2018;07;18;Tiistai;24;23;47;9;6;15
294;24.07.2018;2018;07;19;Tiistai;21;12;33;10;7;17
294;24.07.2018;2018;07;20;Tiistai;25;17;42;2;2;4
294;24.07.2018;2018;07;21;Tiistai;9;7;16;4;9;13
294;24.07.2018;2018;07;22;Tiistai;4;1;5;0;2;2
294;24.07.2018;2018;07;23;Tiistai;3;0;3;2;1;3
294;25.07.2018;2018;07;00;Keskiviikko;1;0;1;2;0;2
294;25.07.2018;2018;07;01;Keskiviikko;0;0;0;0;1;1
294;25.07.2018;2018;07;02;Keskiviikko;0;0;0;0;0;0
294;25.07.2018;2018;07;03;Keskiviikko;0;0;0;0;0;0
294;25.07.2018;2018;07;04;Keskiviikko;1;0;1;0;0;0
294;25.07.2018;2018;07;05;Keskiviikko;0;1;1;0;0;0
294;25.07.2018;2018;07;06;Keskiviikko;4;3;7;0;0;0
294;25.07.2018;2018;07;07;Keskiviikko;5;2;7;1;1;2
294;25.07.2018;2018;07;08;Keskiviikko;2;3;5;4;3;7
294;25.07.2018;2018;07;09;Keskiviikko;12;14;26;2;3;5
294;25.07.2018;2018;07;10;Keskiviikko;11;19;30;1;6;7
294;25.07.2018;2018;07;11;Keskiviikko;21;26;47;21;10;31
294;25.07.2018;2018;07;12;Keskiviikko;17;16;33;55;10;65
294;25.07.2018;2018;07;13;Keskiviikko;34;11;45;28;5;33
294;25.07.2018;2018;07;14;Keskiviikko;14;16;30;8;2;10
294;25.07.2018;2018;07;15;Keskiviikko;13;11;24;4;4;8
294;25.07.2018;2018;07;16;Keskiviikko;25;16;41;3;4;7
294;25.07.2018;2018;07;17;Keskiviikko;25;21;46;7;8;15
294;25.07.2018;2018;07;18;Keskiviikko;24;24;48;6;7;13
294;25.07.2018;2018;07;19;Keskiviikko;30;22;52;7;7;14
294;25.07.2018;2018;07;20;Keskiviikko;18;26;44;10;2;12
294;25.07.2018;2018;07;21;Keskiviikko;6;2;8;1;2;3
294;25.07.2018;2018;07;22;Keskiviikko;4;3;7;0;0;0
294;25.07.2018;2018;07;23;Keskiviikko;2;2;4;1;0;1
294;26.07.2018;2018;07;00;Torstai;0;3;3;0;1;1
294;26.07.2018;2018;07;01;Torstai;2;2;4;1;3;4
294;26.07.2018;2018;07;02;Torstai;0;0;0;0;0;0
294;26.07.2018;2018;07;03;Torstai;0;1;1;0;0;0
294;26.07.2018;2018;07;04;Torstai;1;0;1;1;1;2
294;26.07.2018;2018;07;05;Torstai;0;1;1;3;0;3
294;26.07.2018;2018;07;06;Torstai;0;3;3;2;0;2
294;26.07.2018;2018;07;07;Torstai;3;5;8;3;4;7
294;26.07.2018;2018;07;08;Torstai;2;2;4;4;3;7
294;26.07.2018;2018;07;09;Torstai;7;7;14;1;3;4
294;26.07.2018;2018;07;10;Torstai;12;12;24;8;3;11
294;26.07.2018;2018;07;11;Torstai;13;21;34;2;10;12
294;26.07.2018;2018;07;12;Torstai;18;10;28;17;7;24
294;26.07.2018;2018;07;13;Torstai;22;22;44;6;2;8
294;26.07.2018;2018;07;14;Torstai;20;15;35;10;2;12
294;26.07.2018;2018;07;15;Torstai;20;14;34;2;4;6
294;26.07.2018;2018;07;16;Torstai;13;16;29;1;6;7
294;26.07.2018;2018;07;17;Torstai;16;14;30;7;5;12
294;26.07.2018;2018;07;18;Torstai;13;10;23;2;6;8
294;26.07.2018;2018;07;19;Torstai;16;22;38;6;7;13
294;26.07.2018;2018;07;20;Torstai;13;12;25;5;7;12
294;26.07.2018;2018;07;21;Torstai;8;7;15;6;2;8
294;26.07.2018;2018;07;22;Torstai;7;7;14;3;1;4
294;26.07.2018;2018;07;23;Torstai;0;0;0;1;1;2
294;27.07.2018;2018;07;00;Perjantai;0;1;1;1;0;1
294;27.07.2018;2018;07;01;Perjantai;0;1;1;1;1;2
294;27.07.2018;2018;07;02;Perjantai;0;1;1;0;0;0
294;27.07.2018;2018;07;03;Perjantai;1;0;1;0;0;0
294;27.07.2018;2018;07;04;Perjantai;1;0;1;0;0;0
294;27.07.2018;2018;07;05;Perjantai;0;1;1;5;0;5
294;27.07.2018;2018;07;06;Perjantai;1;1;2;50;100;150
294;27.07.2018;2018;07;07;Perjantai;3;2;5;25;68;93
294;27.07.2018;2018;07;08;Perjantai;6;6;12;11;9;20
294;27.07.2018;2018;07;09;Perjantai;8;9;17;19;29;48
294;27.07.2018;2018;07;10;Perjantai;17;15;32;17;14;31
294;27.07.2018;2018;07;11;Perjantai;7;23;30;62;41;103
294;27.07.2018;2018;07;12;Perjantai;26;18;44;122;26;148
294;27.07.2018;2018;07;13;Perjantai;18;17;35;58;9;67
294;27.07.2018;2018;07;14;Perjantai;13;25;38;11;5;16
294;27.07.2018;2018;07;15;Perjantai;22;18;40;50;11;61
294;27.07.2018;2018;07;16;Perjantai;22;14;36;5;2;7
294;27.07.2018;2018;07;17;Perjantai;10;13;23;8;3;11
294;27.07.2018;2018;07;18;Perjantai;15;25;40;2;6;8
294;27.07.2018;2018;07;19;Perjantai;26;17;43;9;7;16
294;27.07.2018;2018;07;20;Perjantai;13;9;22;1;4;5
294;27.07.2018;2018;07;21;Perjantai;7;4;11;2;0;2
294;27.07.2018;2018;07;22;Perjantai;6;5;11;1;0;1
294;27.07.2018;2018;07;23;Perjantai;6;1;7;0;0;0
294;28.07.2018;2018;07;00;Lauantai;1;2;3;0;0;0
294;28.07.2018;2018;07;01;Lauantai;0;1;1;0;2;2
294;28.07.2018;2018;07;02;Lauantai;0;0;0;1;0;1
294;28.07.2018;2018;07;03;Lauantai;1;0;1;0;0;0
294;28.07.2018;2018;07;04;Lauantai;0;0;0;0;0;0
294;28.07.2018;2018;07;05;Lauantai;2;0;2;4;3;7
294;28.07.2018;2018;07;06;Lauantai;2;2;4;183;60;243
294;28.07.2018;2018;07;07;Lauantai;0;1;1;69;32;101
294;28.07.2018;2018;07;08;Lauantai;5;3;8;21;12;33
294;28.07.2018;2018;07;09;Lauantai;9;13;22;69;33;102
294;28.07.2018;2018;07;10;Lauantai;7;11;18;77;24;101
294;28.07.2018;2018;07;11;Lauantai;8;14;22;80;20;100
294;28.07.2018;2018;07;12;Lauantai;18;24;42;111;27;138
294;28.07.2018;2018;07;13;Lauantai;17;12;29;34;13;47
294;28.07.2018;2018;07;14;Lauantai;23;22;45;4;6;10
294;28.07.2018;2018;07;15;Lauantai;6;10;16;35;12;47
294;28.07.2018;2018;07;16;Lauantai;17;16;33;4;7;11
294;28.07.2018;2018;07;17;Lauantai;16;22;38;4;1;5
294;28.07.2018;2018;07;18;Lauantai;5;12;17;4;3;7
294;28.07.2018;2018;07;19;Lauantai;19;20;39;6;10;16
294;28.07.2018;2018;07;20;Lauantai;10;14;24;7;0;7
294;28.07.2018;2018;07;21;Lauantai;4;5;9;3;1;4
294;28.07.2018;2018;07;22;Lauantai;11;8;19;3;4;7
294;28.07.2018;2018;07;23;Lauantai;3;1;4;3;1;4
294;29.07.2018;2018;07;00;Sunnuntai;0;0;0;1;2;3
294;29.07.2018;2018;07;01;Sunnuntai;0;0;0;1;1;2
294;29.07.2018;2018;07;02;Sunnuntai;0;0;0;0;2;2
294;29.07.2018;2018;07;03;Sunnuntai;0;0;0;0;0;0
294;29.07.2018;2018;07;04;Sunnuntai;1;0;1;0;0;0
294;29.07.2018;2018;07;05;Sunnuntai;2;0;2;0;0;0
294;29.07.2018;2018;07;06;Sunnuntai;1;3;4;5;3;8
294;29.07.2018;2018;07;07;Sunnuntai;2;0;2;13;4;17
294;29.07.2018;2018;07;08;Sunnuntai;2;3;5;7;3;10
294;29.07.2018;2018;07;09;Sunnuntai;7;9;16;18;4;22
294;29.07.2018;2018;07;10;Sunnuntai;12;8;20;31;19;50
294;29.07.2018;2018;07;11;Sunnuntai;8;13;21;62;10;72
294;29.07.2018;2018;07;12;Sunnuntai;10;8;18;60;18;78
294;29.07.2018;2018;07;13;Sunnuntai;20;8;28;6;1;7
294;29.07.2018;2018;07;14;Sunnuntai;20;20;40;4;4;8
294;29.07.2018;2018;07;15;Sunnuntai;13;11;24;9;3;12
294;29.07.2018;2018;07;16;Sunnuntai;19;11;30;3;0;3
294;29.07.2018;2018;07;17;Sunnuntai;15;12;27;6;2;8
294;29.07.2018;2018;07;18;Sunnuntai;19;23;42;6;7;13
294;29.07.2018;2018;07;19;Sunnuntai;14;16;30;8;12;20
294;29.07.2018;2018;07;20;Sunnuntai;9;7;16;2;3;5
294;29.07.2018;2018;07;21;Sunnuntai;16;6;22;5;5;10
294;29.07.2018;2018;07;22;Sunnuntai;2;2;4;0;0;0
294;29.07.2018;2018;07;23;Sunnuntai;1;3;4;2;0;2
294;30.07.2018;2018;07;00;Maanantai;3;1;4;0;0;0
294;30.07.2018;2018;07;01;Maanantai;1;0;1;0;0;0
294;30.07.2018;2018;07;02;Maanantai;0;0;0;0;0;0
294;30.07.2018;2018;07;03;Maanantai;0;0;0;0;0;0
294;30.07.2018;2018;07;04;Maanantai;0;0;0;0;0;0
294;30.07.2018;2018;07;05;Maanantai;0;1;1;2;0;2
294;30.07.2018;2018;07;06;Maanantai;2;2;4;1;0;1
294;30.07.2018;2018;07;07;Maanantai;6;3;9;2;0;2
294;30.07.2018;2018;07;08;Maanantai;8;5;13;7;3;10
294;30.07.2018;2018;07;09;Maanantai;9;7;16;5;1;6
294;30.07.2018;2018;07;10;Maanantai;9;10;19;7;6;13
294;30.07.2018;2018;07;11;Maanantai;15;15;30;5;4;9
294;30.07.2018;2018;07;12;Maanantai;20;23;43;13;12;25
294;30.07.2018;2018;07;13;Maanantai;33;14;47;4;2;6
294;30.07.2018;2018;07;14;Maanantai;26;24;50;5;4;9
294;30.07.2018;2018;07;15;Maanantai;20;17;37;7;2;9
294;30.07.2018;2018;07;16;Maanantai;25;23;48;3;4;7
294;30.07.2018;2018;07;17;Maanantai;15;13;28;7;5;12
294;30.07.2018;2018;07;18;Maanantai;27;17;44;2;3;5
294;30.07.2018;2018;07;19;Maanantai;33;13;46;6;5;11
294;30.07.2018;2018;07;20;Maanantai;14;13;27;4;8;12
294;30.07.2018;2018;07;21;Maanantai;12;4;16;6;1;7
294;30.07.2018;2018;07;22;Maanantai;3;5;8;0;1;1
294;30.07.2018;2018;07;23;Maanantai;3;3;6;2;1;3
294;31.07.2018;2018;07;00;Tiistai;2;1;3;0;0;0
294;31.07.2018;2018;07;01;Tiistai;0;0;0;0;0;0
294;31.07.2018;2018;07;02;Tiistai;0;0;0;2;1;3
294;31.07.2018;2018;07;03;Tiistai;0;0;0;0;0;0
294;31.07.2018;2018;07;04;Tiistai;0;0;0;0;0;0
294;31.07.2018;2018;07;05;Tiistai;0;1;1;0;1;1
294;31.07.2018;2018;07;06;Tiistai;3;1;4;0;0;0
294;31.07.2018;2018;07;07;Tiistai;3;1;4;3;0;3
294;31.07.2018;2018;07;08;Tiistai;7;6;13;1;3;4
294;31.07.2018;2018;07;09;Tiistai;11;6;17;2;1;3
294;31.07.2018;2018;07;10;Tiistai;17;13;30;4;4;8
294;31.07.2018;2018;07;11;Tiistai;6;12;18;6;3;9
294;31.07.2018;2018;07;12;Tiistai;13;22;35;6;6;12
294;31.07.2018;2018;07;13;Tiistai;20;13;33;4;2;6
294;31.07.2018;2018;07;14;Tiistai;25;15;40;6;3;9
294;31.07.2018;2018;07;15;Tiistai;23;31;54;4;1;5
294;31.07.2018;2018;07;16;Tiistai;20;11;31;6;2;8
294;31.07.2018;2018;07;17;Tiistai;14;17;31;5;6;11
294;31.07.2018;2018;07;18;Tiistai;19;16;35;2;2;4
294;31.07.2018;2018;07;19;Tiistai;22;24;46;7;4;11
294;31.07.2018;2018;07;20;Tiistai;23;21;44;4;7;11
294;31.07.2018;2018;07;21;Tiistai;14;11;25;4;4;8
294;31.07.2018;2018;07;22;Tiistai;7;3;10;0;3;3
294;31.07.2018;2018;07;23;Tiistai;4;3;7;0;0;0
294;01.08.2018;2018;08;00;Keskiviikko;0;0;0;1;0;1
294;01.08.2018;2018;08;01;Keskiviikko;0;0;0;0;0;0
294;01.08.2018;2018;08;02;Keskiviikko;0;1;1;0;0;0
294;01.08.2018;2018;08;03;Keskiviikko;0;2;2;2;0;2
294;01.08.2018;2018;08;04;Keskiviikko;1;0;1;0;0;0
294;01.08.2018;2018;08;05;Keskiviikko;0;1;1;2;1;3
294;01.08.2018;2018;08;06;Keskiviikko;1;4;5;1;0;1
294;01.08.2018;2018;08;07;Keskiviikko;4;4;8;1;0;1
294;01.08.2018;2018;08;08;Keskiviikko;3;5;8;9;5;14
294;01.08.2018;2018;08;09;Keskiviikko;12;14;26;4;2;6
294;01.08.2018;2018;08;10;Keskiviikko;12;11;23;6;4;10
294;01.08.2018;2018;08;11;Keskiviikko;22;15;37;6;6;12
294;01.08.2018;2018;08;12;Keskiviikko;17;20;37;5;10;15
294;01.08.2018;2018;08;13;Keskiviikko;27;24;51;13;5;18
294;01.08.2018;2018;08;14;Keskiviikko;19;12;31;5;7;12
294;01.08.2018;2018;08;15;Keskiviikko;22;22;44;6;4;10
294;01.08.2018;2018;08;16;Keskiviikko;17;17;34;4;3;7
294;01.08.2018;2018;08;17;Keskiviikko;18;9;27;4;3;7
294;01.08.2018;2018;08;18;Keskiviikko;15;15;30;6;1;7
294;01.08.2018;2018;08;19;Keskiviikko;24;16;40;5;4;9
294;01.08.2018;2018;08;20;Keskiviikko;27;18;45;3;2;5
294;01.08.2018;2018;08;21;Keskiviikko;14;11;25;4;2;6
294;01.08.2018;2018;08;22;Keskiviikko;10;7;17;8;3;11
294;01.08.2018;2018;08;23;Keskiviikko;3;5;8;0;0;0
294;02.08.2018;2018;08;00;Torstai;2;0;2;1;1;2
294;02.08.2018;2018;08;01;Torstai;0;3;3;0;0;0
294;02.08.2018;2018;08;02;Torstai;1;0;1;0;0;0
294;02.08.2018;2018;08;03;Torstai;1;0;1;0;0;0
294;02.08.2018;2018;08;04;Torstai;1;3;4;0;0;0
294;02.08.2018;2018;08;05;Torstai;0;2;2;0;0;0
294;02.08.2018;2018;08;06;Torstai;2;3;5;2;2;4
294;02.08.2018;2018;08;07;Torstai;6;4;10;0;1;1
294;02.08.2018;2018;08;08;Torstai;4;3;7;9;5;14
294;02.08.2018;2018;08;09;Torstai;14;10;24;2;3;5
294;02.08.2018;2018;08;10;Torstai;6;14;20;5;6;11
294;02.08.2018;2018;08;11;Torstai;11;11;22;8;7;15
294;02.08.2018;2018;08;12;Torstai;15;15;30;8;2;10
294;02.08.2018;2018;08;13;Torstai;16;9;25;3;3;6
294;02.08.2018;2018;08;14;Torstai;15;15;30;8;5;13
294;02.08.2018;2018;08;15;Torstai;13;26;39;2;4;6
294;02.08.2018;2018;08;16;Torstai;23;12;35;5;1;6
294;02.08.2018;2018;08;17;Torstai;24;22;46;14;3;17
294;02.08.2018;2018;08;18;Torstai;29;31;60;8;7;15
294;02.08.2018;2018;08;19;Torstai;23;17;40;6;11;17
294;02.08.2018;2018;08;20;Torstai;15;22;37;7;6;13
294;02.08.2018;2018;08;21;Torstai;11;11;22;5;4;9
294;02.08.2018;2018;08;22;Torstai;3;3;6;2;1;3
294;02.08.2018;2018;08;23;Torstai;3;3;6;0;3;3
294;03.08.2018;2018;08;00;Perjantai;1;0;1;0;0;0
294;03.08.2018;2018;08;01;Perjantai;1;1;2;0;0;0
294;03.08.2018;2018;08;02;Perjantai;0;0;0;0;0;0
294;03.08.2018;2018;08;03;Perjantai;0;0;0;0;0;0
294;03.08.2018;2018;08;04;Perjantai;1;0;1;0;0;0
294;03.08.2018;2018;08;05;Perjantai;0;1;1;0;0;0
294;03.08.2018;2018;08;06;Perjantai;0;3;3;3;4;7
294;03.08.2018;2018;08;07;Perjantai;3;2;5;1;0;1
294;03.08.2018;2018;08;08;Perjantai;3;4;7;5;3;8
294;03.08.2018;2018;08;09;Perjantai;7;7;14;5;2;7
294;03.08.2018;2018;08;10;Perjantai;7;5;12;4;6;10
294;03.08.2018;2018;08;11;Perjantai;1;2;3;2;3;5
294;03.08.2018;2018;08;12;Perjantai;2;3;5;1;1;2
294;03.08.2018;2018;08;13;Perjantai;7;1;8;8;4;12
294;03.08.2018;2018;08;14;Perjantai;39;23;62;17;6;23
294;03.08.2018;2018;08;15;Perjantai;32;43;75;21;23;44
294;03.08.2018;2018;08;16;Perjantai;44;47;91;34;13;47
294;03.08.2018;2018;08;17;Perjantai;51;49;100;31;28;59
294;03.08.2018;2018;08;18;Perjantai;60;35;95;39;32;71
294;03.08.2018;2018;08;19;Perjantai;70;49;119;27;24;51
294;03.08.2018;2018;08;20;Perjantai;36;31;67;25;17;42
294;03.08.2018;2018;08;21;Perjantai;48;32;80;13;30;43
294;03.08.2018;2018;08;22;Perjantai;28;17;45;16;15;31
294;03.08.2018;2018;08;23;Perjantai;23;23;46;20;24;44
294;04.08.2018;2018;08;00;Lauantai;5;12;17;9;9;18
294;04.08.2018;2018;08;01;Lauantai;7;15;22;0;12;12
294;04.08.2018;2018;08;02;Lauantai;1;11;12;0;3;3
294;04.08.2018;2018;08;03;Lauantai;0;5;5;2;0;2
294;04.08.2018;2018;08;04;Lauantai;2;1;3;1;2;3
294;04.08.2018;2018;08;05;Lauantai;0;0;0;0;0;0
294;04.08.2018;2018;08;06;Lauantai;3;3;6;0;0;0
294;04.08.2018;2018;08;07;Lauantai;3;1;4;0;0;0
294;04.08.2018;2018;08;08;Lauantai;7;4;11;3;1;4
294;04.08.2018;2018;08;09;Lauantai;5;9;14;16;6;22
294;04.08.2018;2018;08;10;Lauantai;21;11;32;43;13;56
294;04.08.2018;2018;08;11;Lauantai;43;36;79;64;29;93
294;04.08.2018;2018;08;12;Lauantai;59;71;130;76;83;159
294;04.08.2018;2018;08;13;Lauantai;64;63;127;89;78;167
294;04.08.2018;2018;08;14;Lauantai;78;78;156;61;70;131
294;04.08.2018;2018;08;15;Lauantai;66;66;132;63;73;136
294;04.08.2018;2018;08;16;Lauantai;75;59;134;44;46;90
294;04.08.2018;2018;08;17;Lauantai;30;54;84;27;25;52
294;04.08.2018;2018;08;18;Lauantai;34;29;63;20;21;41
294;04.08.2018;2018;08;19;Lauantai;36;32;68;15;13;28
294;04.08.2018;2018;08;20;Lauantai;40;31;71;31;14;45
294;04.08.2018;2018;08;21;Lauantai;50;29;79;23;24;47
294;04.08.2018;2018;08;22;Lauantai;32;18;50;18;12;30
294;04.08.2018;2018;08;23;Lauantai;12;14;26;6;5;11
294;05.08.2018;2018;08;00;Sunnuntai;6;8;14;0;2;2
294;05.08.2018;2018;08;01;Sunnuntai;1;5;6;1;3;4
294;05.08.2018;2018;08;02;Sunnuntai;3;5;8;1;3;4
294;05.08.2018;2018;08;03;Sunnuntai;1;1;2;0;0;0
294;05.08.2018;2018;08;04;Sunnuntai;1;0;1;0;2;2
294;05.08.2018;2018;08;05;Sunnuntai;0;2;2;0;1;1
294;05.08.2018;2018;08;06;Sunnuntai;1;1;2;0;0;0
294;05.08.2018;2018;08;07;Sunnuntai;0;4;4;1;2;3
294;05.08.2018;2018;08;08;Sunnuntai;3;1;4;1;2;3
294;05.08.2018;2018;08;09;Sunnuntai;7;8;15;10;3;13
294;05.08.2018;2018;08;10;Sunnuntai;9;14;23;6;8;14
294;05.08.2018;2018;08;11;Sunnuntai;9;14;23;5;6;11
294;05.08.2018;2018;08;12;Sunnuntai;15;13;28;5;6;11
294;05.08.2018;2018;08;13;Sunnuntai;10;22;32;8;5;13
294;05.08.2018;2018;08;14;Sunnuntai;2;1;3;0;0;0
294;05.08.2018;2018;08;15;Sunnuntai;1;2;3;2;1;3
294;05.08.2018;2018;08;16;Sunnuntai;7;17;24;6;3;9
294;05.08.2018;2018;08;17;Sunnuntai;14;12;26;9;7;16
294;05.08.2018;2018;08;18;Sunnuntai;14;11;25;13;2;15
294;05.08.2018;2018;08;19;Sunnuntai;16;17;33;7;13;20
294;05.08.2018;2018;08;20;Sunnuntai;17;10;27;11;7;18
294;05.08.2018;2018;08;21;Sunnuntai;9;8;17;3;2;5
294;05.08.2018;2018;08;22;Sunnuntai;3;3;6;0;0;0
294;05.08.2018;2018;08;23;Sunnuntai;2;1;3;1;2;3
294;06.08.2018;2018;08;00;Maanantai;0;0;0;0;0;0
294;06.08.2018;2018;08;01;Maanantai;0;0;0;0;0;0
294;06.08.2018;2018;08;02;Maanantai;0;0;0;0;0;0
294;06.08.2018;2018;08;03;Maanantai;0;0;0;0;0;0
294;06.08.2018;2018;08;04;Maanantai;0;0;0;0;0;0
294;06.08.2018;2018;08;05;Maanantai;1;0;1;0;0;0
294;06.08.2018;2018;08;06;Maanantai;2;1;3;1;0;1
294;06.08.2018;2018;08;07;Maanantai;4;0;4;2;3;5
294;06.08.2018;2018;08;08;Maanantai;3;7;10;1;3;4
294;06.08.2018;2018;08;09;Maanantai;5;6;11;4;0;4
294;06.08.2018;2018;08;10;Maanantai;5;11;16;5;9;14
294;06.08.2018;2018;08;11;Maanantai;12;10;22;3;3;6
294;06.08.2018;2018;08;12;Maanantai;4;4;8;1;5;6
294;06.08.2018;2018;08;13;Maanantai;3;3;6;6;3;9
294;06.08.2018;2018;08;14;Maanantai;5;8;13;8;3;11
294;06.08.2018;2018;08;15;Maanantai;9;15;24;4;5;9
294;06.08.2018;2018;08;16;Maanantai;11;8;19;10;4;14
294;06.08.2018;2018;08;17;Maanantai;5;14;19;5;5;10
294;06.08.2018;2018;08;18;Maanantai;14;7;21;11;17;28
294;06.08.2018;2018;08;19;Maanantai;13;13;26;12;10;22
294;06.08.2018;2018;08;20;Maanantai;10;4;14;8;7;15
294;06.08.2018;2018;08;21;Maanantai;11;5;16;12;2;14
294;06.08.2018;2018;08;22;Maanantai;3;2;5;0;1;1
294;06.08.2018;2018;08;23;Maanantai;1;0;1;2;1;3
294;07.08.2018;2018;08;00;Tiistai;3;0;3;0;0;0
294;07.08.2018;2018;08;01;Tiistai;0;0;0;0;0;0
294;07.08.2018;2018;08;02;Tiistai;0;0;0;3;0;3
294;07.08.2018;2018;08;03;Tiistai;0;0;0;0;0;0
294;07.08.2018;2018;08;04;Tiistai;0;0;0;0;0;0
294;07.08.2018;2018;08;05;Tiistai;1;0;1;1;0;1
294;07.08.2018;2018;08;06;Tiistai;4;0;4;0;0;0
294;07.08.2018;2018;08;07;Tiistai;4;0;4;3;0;3
294;07.08.2018;2018;08;08;Tiistai;13;0;13;4;0;4
294;07.08.2018;2018;08;09;Tiistai;17;0;17;3;0;3
294;07.08.2018;2018;08;10;Tiistai;30;0;30;8;0;8
294;07.08.2018;2018;08;11;Tiistai;18;0;18;9;0;9
294;07.08.2018;2018;08;12;Tiistai;35;0;35;12;0;12
294;07.08.2018;2018;08;13;Tiistai;33;0;33;6;0;6
294;07.08.2018;2018;08;14;Tiistai;40;0;40;9;0;9
294;07.08.2018;2018;08;15;Tiistai;54;0;54;5;0;5
294;07.08.2018;2018;08;16;Tiistai;31;0;31;8;0;8
294;07.08.2018;2018;08;17;Tiistai;31;0;31;11;0;11
294;07.08.2018;2018;08;18;Tiistai;35;0;35;4;0;4
294;07.08.2018;2018;08;19;Tiistai;46;0;46;11;0;11
294;07.08.2018;2018;08;20;Tiistai;44;0;44;11;0;11
294;07.08.2018;2018;08;21;Tiistai;25;0;25;8;0;8
294;07.08.2018;2018;08;22;Tiistai;10;0;10;3;0;3
294;07.08.2018;2018;08;23;Tiistai;7;0;7;0;0;0
294;08.08.2018;2018;08;00;Keskiviikko;0;1;1;0;0;0
294;08.08.2018;2018;08;01;Keskiviikko;0;0;0;0;0;0
294;08.08.2018;2018;08;02;Keskiviikko;0;0;0;0;0;0
294;08.08.2018;2018;08;03;Keskiviikko;0;0;0;0;0;0
294;08.08.2018;2018;08;04;Keskiviikko;0;0;0;0;0;0
294;08.08.2018;2018;08;05;Keskiviikko;2;1;3;0;0;0
294;08.08.2018;2018;08;06;Keskiviikko;7;1;8;0;2;2
294;08.08.2018;2018;08;07;Keskiviikko;3;3;6;2;2;4
294;08.08.2018;2018;08;08;Keskiviikko;5;5;10;4;5;9
294;08.08.2018;2018;08;09;Keskiviikko;8;9;17;7;0;7
294;08.08.2018;2018;08;10;Keskiviikko;11;10;21;9;7;16
294;08.08.2018;2018;08;11;Keskiviikko;15;22;37;8;9;17
294;08.08.2018;2018;08;12;Keskiviikko;25;11;36;8;4;12
294;08.08.2018;2018;08;13;Keskiviikko;25;18;43;5;5;10
294;08.08.2018;2018;08;14;Keskiviikko;12;8;20;9;6;15
294;08.08.2018;2018;08;15;Keskiviikko;14;27;41;8;11;19
294;08.08.2018;2018;08;16;Keskiviikko;16;19;35;14;15;29
294;08.08.2018;2018;08;17;Keskiviikko;20;22;42;9;9;18
294;08.08.2018;2018;08;18;Keskiviikko;27;20;47;18;13;31
294;08.08.2018;2018;08;19;Keskiviikko;43;17;60;7;9;16
294;08.08.2018;2018;08;20;Keskiviikko;20;16;36;5;6;11
294;08.08.2018;2018;08;21;Keskiviikko;5;2;7;2;3;5
294;08.08.2018;2018;08;22;Keskiviikko;3;2;5;4;2;6
294;08.08.2018;2018;08;23;Keskiviikko;0;2;2;0;0;0
294;09.08.2018;2018;08;00;Torstai;0;0;0;0;0;0
294;09.08.2018;2018;08;01;Torstai;0;0;0;0;0;0
294;09.08.2018;2018;08;02;Torstai;0;2;2;0;0;0
294;09.08.2018;2018;08;03;Torstai;0;0;0;2;1;3
294;09.08.2018;2018;08;04;Torstai;0;0;0;0;0;0
294;09.08.2018;2018;08;05;Torstai;1;0;1;0;0;0
294;09.08.2018;2018;08;06;Torstai;1;0;1;4;0;4
294;09.08.2018;2018;08;07;Torstai;5;4;9;0;2;2
294;09.08.2018;2018;08;08;Torstai;25;13;38;7;6;13
294;09.08.2018;2018;08;09;Torstai;10;14;24;9;5;14
294;09.08.2018;2018;08;10;Torstai;7;15;22;4;6;10
294;09.08.2018;2018;08;11;Torstai;10;13;23;8;7;15
294;09.08.2018;2018;08;12;Torstai;20;29;49;8;18;26
294;09.08.2018;2018;08;13;Torstai;23;13;36;5;6;11
294;09.08.2018;2018;08;14;Torstai;16;26;42;6;11;17
294;09.08.2018;2018;08;15;Torstai;22;26;48;9;7;16
294;09.08.2018;2018;08;16;Torstai;14;21;35;11;5;16
294;09.08.2018;2018;08;17;Torstai;15;24;39;9;10;19
294;09.08.2018;2018;08;18;Torstai;21;14;35;12;11;23
294;09.08.2018;2018;08;19;Torstai;19;13;32;12;8;20
294;09.08.2018;2018;08;20;Torstai;16;12;28;9;6;15
294;09.08.2018;2018;08;21;Torstai;6;3;9;0;0;0
294;09.08.2018;2018;08;22;Torstai;0;2;2;2;1;3
294;09.08.2018;2018;08;23;Torstai;0;0;0;0;0;0
294;10.08.2018;2018;08;00;Perjantai;0;1;1;0;0;0
294;10.08.2018;2018;08;01;Perjantai;0;0;0;0;0;0
294;10.08.2018;2018;08;02;Perjantai;0;0;0;0;0;0
294;10.08.2018;2018;08;03;Perjantai;0;0;0;0;0;0
294;10.08.2018;2018;08;04;Perjantai;1;0;1;0;0;0
294;10.08.2018;2018;08;05;Perjantai;1;0;1;0;0;0
294;10.08.2018;2018;08;06;Perjantai;4;1;5;2;2;4
294;10.08.2018;2018;08;07;Perjantai;12;13;25;3;5;8
294;10.08.2018;2018;08;08;Perjantai;9;10;19;6;5;11
294;10.08.2018;2018;08;09;Perjantai;12;13;25;13;10;23
294;10.08.2018;2018;08;10;Perjantai;16;13;29;4;4;8
294;10.08.2018;2018;08;11;Perjantai;22;10;32;13;2;15
294;10.08.2018;2018;08;12;Perjantai;23;41;64;13;21;34
294;10.08.2018;2018;08;13;Perjantai;23;34;57;11;11;22
294;10.08.2018;2018;08;14;Perjantai;29;44;73;12;13;25
294;10.08.2018;2018;08;15;Perjantai;24;17;41;8;5;13
294;10.08.2018;2018;08;16;Perjantai;25;22;47;5;3;8
294;10.08.2018;2018;08;17;Perjantai;25;21;46;4;7;11
294;10.08.2018;2018;08;18;Perjantai;22;32;54;7;6;13
294;10.08.2018;2018;08;19;Perjantai;19;11;30;4;4;8
294;10.08.2018;2018;08;20;Perjantai;13;5;18;4;3;7
294;10.08.2018;2018;08;21;Perjantai;5;2;7;0;1;1
294;10.08.2018;2018;08;22;Perjantai;2;1;3;1;0;1
294;10.08.2018;2018;08;23;Perjantai;1;0;1;3;0;3
294;11.08.2018;2018;08;00;Lauantai;0;0;0;0;0;0
294;11.08.2018;2018;08;01;Lauantai;2;0;2;1;1;2
294;11.08.2018;2018;08;02;Lauantai;2;3;5;1;0;1
294;11.08.2018;2018;08;03;Lauantai;0;0;0;0;0;0
294;11.08.2018;2018;08;04;Lauantai;0;0;0;0;0;0
294;11.08.2018;2018;08;05;Lauantai;0;0;0;0;0;0
294;11.08.2018;2018;08;06;Lauantai;4;2;6;0;1;1
294;11.08.2018;2018;08;07;Lauantai;0;1;1;0;2;2
294;11.08.2018;2018;08;08;Lauantai;0;3;3;0;0;0
294;11.08.2018;2018;08;09;Lauantai;6;10;16;3;5;8
294;11.08.2018;2018;08;10;Lauantai;5;6;11;4;8;12
294;11.08.2018;2018;08;11;Lauantai;7;7;14;12;6;18
294;11.08.2018;2018;08;12;Lauantai;8;21;29;12;7;19
294;11.08.2018;2018;08;13;Lauantai;26;12;38;2;6;8
294;11.08.2018;2018;08;14;Lauantai;13;15;28;15;9;24
294;11.08.2018;2018;08;15;Lauantai;12;16;28;8;5;13
294;11.08.2018;2018;08;16;Lauantai;12;14;26;4;2;6
294;11.08.2018;2018;08;17;Lauantai;9;8;17;7;4;11
294;11.08.2018;2018;08;18;Lauantai;5;9;14;8;11;19
294;11.08.2018;2018;08;19;Lauantai;21;13;34;7;8;15
294;11.08.2018;2018;08;20;Lauantai;10;3;13;4;6;10
294;11.08.2018;2018;08;21;Lauantai;7;7;14;7;4;11
294;11.08.2018;2018;08;22;Lauantai;2;2;4;1;0;1
294;11.08.2018;2018;08;23;Lauantai;1;1;2;1;1;2
294;12.08.2018;2018;08;00;Sunnuntai;0;0;0;8;1;9
294;12.08.2018;2018;08;01;Sunnuntai;0;0;0;0;0;0
294;12.08.2018;2018;08;02;Sunnuntai;1;0;1;1;3;4
294;12.08.2018;2018;08;03;Sunnuntai;0;0;0;0;1;1
294;12.08.2018;2018;08;04;Sunnuntai;0;0;0;0;0;0
294;12.08.2018;2018;08;05;Sunnuntai;1;2;3;0;0;0
294;12.08.2018;2018;08;06;Sunnuntai;1;1;2;0;0;0
294;12.08.2018;2018;08;07;Sunnuntai;0;0;0;1;0;1
294;12.08.2018;2018;08;08;Sunnuntai;1;0;1;5;0;5
294;12.08.2018;2018;08;09;Sunnuntai;1;2;3;4;8;12
294;12.08.2018;2018;08;10;Sunnuntai;6;9;15;3;3;6
294;12.08.2018;2018;08;11;Sunnuntai;13;13;26;6;5;11
294;12.08.2018;2018;08;12;Sunnuntai;22;14;36;5;13;18
294;12.08.2018;2018;08;13;Sunnuntai;22;25;47;8;8;16
294;12.08.2018;2018;08;14;Sunnuntai;19;12;31;9;8;17
294;12.08.2018;2018;08;15;Sunnuntai;22;12;34;2;4;6
294;12.08.2018;2018;08;16;Sunnuntai;7;9;16;4;4;8
294;12.08.2018;2018;08;17;Sunnuntai;4;27;31;9;6;15
294;12.08.2018;2018;08;18;Sunnuntai;14;15;29;0;7;7
294;12.08.2018;2018;08;19;Sunnuntai;25;17;42;4;5;9
294;12.08.2018;2018;08;20;Sunnuntai;11;16;27;6;5;11
294;12.08.2018;2018;08;21;Sunnuntai;7;4;11;0;0;0
294;12.08.2018;2018;08;22;Sunnuntai;1;0;1;0;0;0
294;12.08.2018;2018;08;23;Sunnuntai;0;0;0;0;1;1
294;13.08.2018;2018;08;00;Maanantai;0;0;0;2;1;3
294;13.08.2018;2018;08;01;Maanantai;0;0;0;0;0;0
294;13.08.2018;2018;08;02;Maanantai;0;0;0;0;0;0
294;13.08.2018;2018;08;03;Maanantai;0;0;0;0;0;0
294;13.08.2018;2018;08;04;Maanantai;0;0;0;0;0;0
294;13.08.2018;2018;08;05;Maanantai;2;0;2;0;0;0
294;13.08.2018;2018;08;06;Maanantai;4;3;7;1;3;4
294;13.08.2018;2018;08;07;Maanantai;10;2;12;6;5;11
294;13.08.2018;2018;08;08;Maanantai;24;12;36;8;8;16
294;13.08.2018;2018;08;09;Maanantai;12;5;17;7;6;13
294;13.08.2018;2018;08;10;Maanantai;8;5;13;4;4;8
294;13.08.2018;2018;08;11;Maanantai;12;12;24;21;21;42
294;13.08.2018;2018;08;12;Maanantai;5;9;14;2;2;4
294;13.08.2018;2018;08;13;Maanantai;9;16;25;6;8;14
294;13.08.2018;2018;08;14;Maanantai;14;31;45;5;12;17
294;13.08.2018;2018;08;15;Maanantai;23;19;42;10;8;18
294;13.08.2018;2018;08;16;Maanantai;20;23;43;6;7;13
294;13.08.2018;2018;08;17;Maanantai;22;24;46;8;12;20
294;13.08.2018;2018;08;18;Maanantai;21;15;36;20;12;32
294;13.08.2018;2018;08;19;Maanantai;14;12;26;5;9;14
294;13.08.2018;2018;08;20;Maanantai;8;12;20;4;4;8
294;13.08.2018;2018;08;21;Maanantai;7;3;10;1;0;1
294;13.08.2018;2018;08;22;Maanantai;0;2;2;0;1;1
294;13.08.2018;2018;08;23;Maanantai;0;0;0;1;0;1
294;14.08.2018;2018;08;00;Tiistai;0;0;0;0;0;0
294;14.08.2018;2018;08;01;Tiistai;0;0;0;0;0;0
294;14.08.2018;2018;08;02;Tiistai;0;0;0;0;0;0
294;14.08.2018;2018;08;03;Tiistai;0;0;0;0;0;0
294;14.08.2018;2018;08;04;Tiistai;0;0;0;0;0;0
294;14.08.2018;2018;08;05;Tiistai;2;2;4;0;0;0
294;14.08.2018;2018;08;06;Tiistai;4;7;11;3;0;3
294;14.08.2018;2018;08;07;Tiistai;14;8;22;5;4;9
294;14.08.2018;2018;08;08;Tiistai;24;9;33;10;6;16
294;14.08.2018;2018;08;09;Tiistai;16;8;24;10;8;18
294;14.08.2018;2018;08;10;Tiistai;18;11;29;17;6;23
294;14.08.2018;2018;08;11;Tiistai;14;11;25;17;14;31
294;14.08.2018;2018;08;12;Tiistai;11;13;24;10;9;19
294;14.08.2018;2018;08;13;Tiistai;22;11;33;13;9;22
294;14.08.2018;2018;08;14;Tiistai;12;19;31;13;17;30
294;14.08.2018;2018;08;15;Tiistai;21;37;58;12;16;28
294;14.08.2018;2018;08;16;Tiistai;17;24;41;7;9;16
294;14.08.2018;2018;08;17;Tiistai;20;19;39;15;18;33
294;14.08.2018;2018;08;18;Tiistai;25;13;38;14;18;32
294;14.08.2018;2018;08;19;Tiistai;17;19;36;7;14;21
294;14.08.2018;2018;08;20;Tiistai;23;17;40;14;7;21
294;14.08.2018;2018;08;21;Tiistai;11;3;14;5;3;8
294;14.08.2018;2018;08;22;Tiistai;1;0;1;0;1;1
294;14.08.2018;2018;08;23;Tiistai;0;0;0;2;0;2
294;15.08.2018;2018;08;00;Keskiviikko;0;0;0;0;0;0
294;15.08.2018;2018;08;01;Keskiviikko;0;0;0;0;0;0
294;15.08.2018;2018;08;02;Keskiviikko;0;0;0;0;0;0
294;15.08.2018;2018;08;03;Keskiviikko;0;0;0;0;0;0
294;15.08.2018;2018;08;04;Keskiviikko;0;0;0;0;0;0
294;15.08.2018;2018;08;05;Keskiviikko;1;0;1;0;0;0
294;15.08.2018;2018;08;06;Keskiviikko;4;4;8;3;0;3
294;15.08.2018;2018;08;07;Keskiviikko;23;8;31;4;5;9
294;15.08.2018;2018;08;08;Keskiviikko;22;12;34;8;2;10
294;15.08.2018;2018;08;09;Keskiviikko;15;10;25;9;3;12
294;15.08.2018;2018;08;10;Keskiviikko;12;8;20;6;5;11
294;15.08.2018;2018;08;11;Keskiviikko;21;12;33;11;14;25
294;15.08.2018;2018;08;12;Keskiviikko;11;14;25;7;8;15
294;15.08.2018;2018;08;13;Keskiviikko;15;20;35;8;13;21
294;15.08.2018;2018;08;14;Keskiviikko;21;21;42;11;6;17
294;15.08.2018;2018;08;15;Keskiviikko;9;28;37;12;10;22
294;15.08.2018;2018;08;16;Keskiviikko;17;17;34;14;8;22
294;15.08.2018;2018;08;17;Keskiviikko;19;14;33;8;14;22
294;15.08.2018;2018;08;18;Keskiviikko;22;29;51;16;11;27
294;15.08.2018;2018;08;19;Keskiviikko;30;22;52;2;11;13
294;15.08.2018;2018;08;20;Keskiviikko;11;10;21;12;8;20
294;15.08.2018;2018;08;21;Keskiviikko;3;5;8;2;3;5
294;15.08.2018;2018;08;22;Keskiviikko;2;0;2;1;1;2
294;15.08.2018;2018;08;23;Keskiviikko;2;0;2;0;0;0
294;16.08.2018;2018;08;00;Torstai;1;0;1;0;0;0
294;16.08.2018;2018;08;01;Torstai;0;0;0;0;0;0
294;16.08.2018;2018;08;02;Torstai;0;0;0;0;0;0
294;16.08.2018;2018;08;03;Torstai;0;0;0;0;0;0
294;16.08.2018;2018;08;04;Torstai;1;0;1;0;0;0
294;16.08.2018;2018;08;05;Torstai;0;0;0;0;0;0
294;16.08.2018;2018;08;06;Torstai;4;7;11;2;0;2
294;16.08.2018;2018;08;07;Torstai;14;11;25;3;4;7
294;16.08.2018;2018;08;08;Torstai;32;0;32;13;4;17
294;16.08.2018;2018;08;09;Torstai;23;18;41;14;8;22
294;16.08.2018;2018;08;10;Torstai;15;9;24;5;8;13
294;16.08.2018;2018;08;11;Torstai;12;14;26;19;16;35
294;16.08.2018;2018;08;12;Torstai;15;13;28;9;8;17
294;16.08.2018;2018;08;13;Torstai;12;27;39;10;11;21
294;16.08.2018;2018;08;14;Torstai;12;17;29;12;10;22
294;16.08.2018;2018;08;15;Torstai;13;46;59;5;12;17
294;16.08.2018;2018;08;16;Torstai;20;13;33;5;1;6
294;16.08.2018;2018;08;17;Torstai;11;12;23;7;4;11
294;16.08.2018;2018;08;18;Torstai;18;23;41;7;13;20
294;16.08.2018;2018;08;19;Torstai;25;9;34;16;10;26
294;16.08.2018;2018;08;20;Torstai;11;6;17;3;4;7
294;16.08.2018;2018;08;21;Torstai;5;4;9;1;4;5
294;16.08.2018;2018;08;22;Torstai;1;0;1;0;1;1
294;16.08.2018;2018;08;23;Torstai;2;0;2;1;2;3
294;17.08.2018;2018;08;00;Perjantai;0;0;0;0;0;0
294;17.08.2018;2018;08;01;Perjantai;0;0;0;0;0;0
294;17.08.2018;2018;08;02;Perjantai;0;0;0;0;0;0
294;17.08.2018;2018;08;03;Perjantai;0;0;0;0;0;0
294;17.08.2018;2018;08;04;Perjantai;0;0;0;0;0;0
294;17.08.2018;2018;08;05;Perjantai;0;1;1;0;0;0
294;17.08.2018;2018;08;06;Perjantai;4;0;4;1;0;1
294;17.08.2018;2018;08;07;Perjantai;11;10;21;3;2;5
294;17.08.2018;2018;08;08;Perjantai;15;6;21;5;5;10
294;17.08.2018;2018;08;09;Perjantai;19;12;31;13;4;17
294;17.08.2018;2018;08;10;Perjantai;8;8;16;5;4;9
294;17.08.2018;2018;08;11;Perjantai;21;14;35;7;6;13
294;17.08.2018;2018;08;12;Perjantai;10;21;31;12;16;28
294;17.08.2018;2018;08;13;Perjantai;26;27;53;16;15;31
294;17.08.2018;2018;08;14;Perjantai;25;34;59;10;17;27
294;17.08.2018;2018;08;15;Perjantai;20;22;42;6;12;18
294;17.08.2018;2018;08;16;Perjantai;15;20;35;8;5;13
294;17.08.2018;2018;08;17;Perjantai;13;12;25;10;11;21
294;17.08.2018;2018;08;18;Perjantai;14;10;24;12;8;20
294;17.08.2018;2018;08;19;Perjantai;10;11;21;10;8;18
294;17.08.2018;2018;08;20;Perjantai;14;8;22;1;2;3
294;17.08.2018;2018;08;21;Perjantai;3;0;3;1;3;4
294;17.08.2018;2018;08;22;Perjantai;0;0;0;0;0;0
294;17.08.2018;2018;08;23;Perjantai;0;0;0;1;1;2
294;18.08.2018;2018;08;00;Lauantai;0;1;1;0;0;0
294;18.08.2018;2018;08;01;Lauantai;0;0;0;0;0;0
294;18.08.2018;2018;08;02;Lauantai;0;0;0;0;0;0
294;18.08.2018;2018;08;03;Lauantai;0;0;0;0;0;0
294;18.08.2018;2018;08;04;Lauantai;0;0;0;1;0;1
294;18.08.2018;2018;08;05;Lauantai;1;0;1;0;0;0
294;18.08.2018;2018;08;06;Lauantai;0;1;1;1;0;1
294;18.08.2018;2018;08;07;Lauantai;2;3;5;0;0;0
294;18.08.2018;2018;08;08;Lauantai;2;3;5;1;2;3
294;18.08.2018;2018;08;09;Lauantai;4;3;7;6;6;12
294;18.08.2018;2018;08;10;Lauantai;10;5;15;7;7;14
294;18.08.2018;2018;08;11;Lauantai;11;15;26;7;7;14
294;18.08.2018;2018;08;12;Lauantai;13;16;29;14;10;24
294;18.08.2018;2018;08;13;Lauantai;18;19;37;6;7;13
294;18.08.2018;2018;08;14;Lauantai;12;13;25;6;4;10
294;18.08.2018;2018;08;15;Lauantai;12;20;32;7;10;17
294;18.08.2018;2018;08;16;Lauantai;15;26;41;3;5;8
294;18.08.2018;2018;08;17;Lauantai;30;21;51;10;10;20
294;18.08.2018;2018;08;18;Lauantai;12;11;23;7;5;12
294;18.08.2018;2018;08;19;Lauantai;12;17;29;7;2;9
294;18.08.2018;2018;08;20;Lauantai;12;27;39;7;3;10
294;18.08.2018;2018;08;21;Lauantai;8;7;15;4;4;8
294;18.08.2018;2018;08;22;Lauantai;6;2;8;1;0;1
294;18.08.2018;2018;08;23;Lauantai;10;4;14;1;4;5
294;19.08.2018;2018;08;00;Sunnuntai;11;2;13;0;2;2
294;19.08.2018;2018;08;01;Sunnuntai;6;0;6;1;1;2
294;19.08.2018;2018;08;02;Sunnuntai;2;0;2;3;0;3
294;19.08.2018;2018;08;03;Sunnuntai;0;1;1;0;0;0
294;19.08.2018;2018;08;04;Sunnuntai;0;0;0;0;0;0
294;19.08.2018;2018;08;05;Sunnuntai;0;0;0;0;0;0
294;19.08.2018;2018;08;06;Sunnuntai;0;0;0;0;0;0
294;19.08.2018;2018;08;07;Sunnuntai;1;0;1;1;0;1
294;19.08.2018;2018;08;08;Sunnuntai;1;4;5;3;3;6
294;19.08.2018;2018;08;09;Sunnuntai;10;2;12;8;4;12
294;19.08.2018;2018;08;10;Sunnuntai;5;6;11;5;3;8
294;19.08.2018;2018;08;11;Sunnuntai;5;14;19;4;6;10
294;19.08.2018;2018;08;12;Sunnuntai;4;10;14;9;5;14
294;19.08.2018;2018;08;13;Sunnuntai;9;12;21;14;4;18
294;19.08.2018;2018;08;14;Sunnuntai;6;17;23;7;6;13
294;19.08.2018;2018;08;15;Sunnuntai;13;7;20;7;4;11
294;19.08.2018;2018;08;16;Sunnuntai;13;15;28;7;8;15
294;19.08.2018;2018;08;17;Sunnuntai;14;12;26;11;4;15
294;19.08.2018;2018;08;18;Sunnuntai;2;6;8;5;4;9
294;19.08.2018;2018;08;19;Sunnuntai;7;4;11;6;5;11
294;19.08.2018;2018;08;20;Sunnuntai;9;6;15;5;5;10
294;19.08.2018;2018;08;21;Sunnuntai;4;2;6;2;1;3
294;19.08.2018;2018;08;22;Sunnuntai;1;0;1;0;0;0
294;19.08.2018;2018;08;23;Sunnuntai;0;0;0;0;0;0
294;20.08.2018;2018;08;00;Maanantai;0;0;0;0;0;0
294;20.08.2018;2018;08;01;Maanantai;0;0;0;0;0;0
294;20.08.2018;2018;08;02;Maanantai;0;0;0;0;0;0
294;20.08.2018;2018;08;03;Maanantai;0;0;0;0;0;0
294;20.08.2018;2018;08;04;Maanantai;0;0;0;0;0;0
294;20.08.2018;2018;08;05;Maanantai;1;1;2;0;0;0
294;20.08.2018;2018;08;06;Maanantai;4;3;7;3;1;4
294;20.08.2018;2018;08;07;Maanantai;7;6;13;2;7;9
294;20.08.2018;2018;08;08;Maanantai;22;13;35;9;8;17
294;20.08.2018;2018;08;09;Maanantai;14;15;29;8;4;12
294;20.08.2018;2018;08;10;Maanantai;9;4;13;9;9;18
294;20.08.2018;2018;08;11;Maanantai;15;10;25;28;23;51
294;20.08.2018;2018;08;12;Maanantai;11;13;24;12;6;18
294;20.08.2018;2018;08;13;Maanantai;15;13;28;8;14;22
294;20.08.2018;2018;08;14;Maanantai;9;38;47;16;9;25
294;20.08.2018;2018;08;15;Maanantai;17;36;53;7;7;14
294;20.08.2018;2018;08;16;Maanantai;30;15;45;6;6;12
294;20.08.2018;2018;08;17;Maanantai;10;12;22;11;8;19
294;20.08.2018;2018;08;18;Maanantai;22;10;32;12;5;17
294;20.08.2018;2018;08;19;Maanantai;13;20;33;13;21;34
294;20.08.2018;2018;08;20;Maanantai;16;9;25;5;8;13
294;20.08.2018;2018;08;21;Maanantai;4;1;5;6;2;8
294;20.08.2018;2018;08;22;Maanantai;2;2;4;0;3;3
294;20.08.2018;2018;08;23;Maanantai;0;0;0;0;0;0
294;21.08.2018;2018;08;00;Tiistai;0;0;0;0;0;0
294;21.08.2018;2018;08;01;Tiistai;0;0;0;0;0;0
294;21.08.2018;2018;08;02;Tiistai;0;0;0;0;0;0
294;21.08.2018;2018;08;03;Tiistai;0;0;0;0;0;0
294;21.08.2018;2018;08;04;Tiistai;0;0;0;0;0;0
294;21.08.2018;2018;08;05;Tiistai;1;1;2;0;0;0
294;21.08.2018;2018;08;06;Tiistai;5;4;9;2;2;4
294;21.08.2018;2018;08;07;Tiistai;12;9;21;3;4;7
294;21.08.2018;2018;08;08;Tiistai;22;12;34;4;5;9
294;21.08.2018;2018;08;09;Tiistai;17;11;28;10;11;21
294;21.08.2018;2018;08;10;Tiistai;13;7;20;8;8;16
294;21.08.2018;2018;08;11;Tiistai;17;15;32;13;17;30
294;21.08.2018;2018;08;12;Tiistai;7;10;17;7;13;20
294;21.08.2018;2018;08;13;Tiistai;16;7;23;12;8;20
294;21.08.2018;2018;08;14;Tiistai;18;14;32;6;8;14
294;21.08.2018;2018;08;15;Tiistai;20;46;66;8;11;19
294;21.08.2018;2018;08;16;Tiistai;20;15;35;13;9;22
294;21.08.2018;2018;08;17;Tiistai;16;13;29;13;9;22
294;21.08.2018;2018;08;18;Tiistai;16;24;40;10;3;13
294;21.08.2018;2018;08;19;Tiistai;10;8;18;7;13;20
294;21.08.2018;2018;08;20;Tiistai;5;3;8;4;9;13
294;21.08.2018;2018;08;21;Tiistai;1;1;2;3;3;6
294;21.08.2018;2018;08;22;Tiistai;0;0;0;1;2;3
294;21.08.2018;2018;08;23;Tiistai;0;0;0;1;0;1
294;22.08.2018;2018;08;00;Keskiviikko;0;0;0;0;0;0
294;22.08.2018;2018;08;01;Keskiviikko;0;0;0;0;0;0
294;22.08.2018;2018;08;02;Keskiviikko;0;0;0;0;0;0
294;22.08.2018;2018;08;03;Keskiviikko;0;0;0;0;0;0
294;22.08.2018;2018;08;04;Keskiviikko;0;0;0;0;0;0
294;22.08.2018;2018;08;05;Keskiviikko;2;1;3;1;0;1
294;22.08.2018;2018;08;06;Keskiviikko;4;2;6;2;1;3
294;22.08.2018;2018;08;07;Keskiviikko;30;8;38;2;2;4
294;22.08.2018;2018;08;08;Keskiviikko;21;11;32;6;3;9
294;22.08.2018;2018;08;09;Keskiviikko;14;5;19;6;13;19
294;22.08.2018;2018;08;10;Keskiviikko;9;7;16;10;5;15
294;22.08.2018;2018;08;11;Keskiviikko;18;12;30;15;8;23
294;22.08.2018;2018;08;12;Keskiviikko;16;24;40;17;16;33
294;22.08.2018;2018;08;13;Keskiviikko;14;16;30;10;13;23
294;22.08.2018;2018;08;14;Keskiviikko;18;21;39;13;13;26
294;22.08.2018;2018;08;15;Keskiviikko;6;17;23;11;11;22
294;22.08.2018;2018;08;16;Keskiviikko;29;15;44;5;7;12
294;22.08.2018;2018;08;17;Keskiviikko;17;11;28;10;8;18
294;22.08.2018;2018;08;18;Keskiviikko;16;23;39;10;19;29
294;22.08.2018;2018;08;19;Keskiviikko;25;9;34;15;7;22
294;22.08.2018;2018;08;20;Keskiviikko;10;10;20;3;8;11
294;22.08.2018;2018;08;21;Keskiviikko;2;3;5;2;0;2
294;22.08.2018;2018;08;22;Keskiviikko;0;0;0;1;1;2
294;22.08.2018;2018;08;23;Keskiviikko;0;0;0;1;0;1
294;23.08.2018;2018;08;00;Torstai;0;0;0;0;0;0
294;23.08.2018;2018;08;01;Torstai;0;0;0;0;0;0
294;23.08.2018;2018;08;02;Torstai;0;0;0;0;0;0
294;23.08.2018;2018;08;03;Torstai;0;0;0;0;0;0
294;23.08.2018;2018;08;04;Torstai;0;0;0;0;0;0
294;23.08.2018;2018;08;05;Torstai;0;1;1;0;0;0
294;23.08.2018;2018;08;06;Torstai;4;1;5;1;1;2
294;23.08.2018;2018;08;07;Torstai;17;8;25;8;4;12
294;23.08.2018;2018;08;08;Torstai;15;2;17;3;2;5
294;23.08.2018;2018;08;09;Torstai;8;4;12;2;3;5
294;23.08.2018;2018;08;10;Torstai;1;1;2;2;2;4
294;23.08.2018;2018;08;11;Torstai;6;1;7;11;12;23
294;23.08.2018;2018;08;12;Torstai;2;5;7;5;9;14
294;23.08.2018;2018;08;13;Torstai;6;20;26;13;10;23
294;23.08.2018;2018;08;14;Torstai;10;9;19;8;8;16
294;23.08.2018;2018;08;15;Torstai;12;24;36;5;13;18
294;23.08.2018;2018;08;16;Torstai;21;13;34;8;10;18
294;23.08.2018;2018;08;17;Torstai;16;12;28;6;6;12
294;23.08.2018;2018;08;18;Torstai;17;20;37;18;12;30
294;23.08.2018;2018;08;19;Torstai;17;17;34;9;10;19
294;23.08.2018;2018;08;20;Torstai;13;13;26;6;3;9
294;23.08.2018;2018;08;21;Torstai;5;2;7;1;1;2
294;23.08.2018;2018;08;22;Torstai;0;0;0;0;1;1
294;23.08.2018;2018;08;23;Torstai;0;0;0;0;0;0
294;24.08.2018;2018;08;00;Perjantai;0;1;1;0;0;0
294;24.08.2018;2018;08;01;Perjantai;0;0;0;0;0;0
294;24.08.2018;2018;08;02;Perjantai;0;0;0;0;0;0
294;24.08.2018;2018;08;03;Perjantai;0;0;0;0;0;0
294;24.08.2018;2018;08;04;Perjantai;0;0;0;0;0;0
294;24.08.2018;2018;08;05;Perjantai;1;2;3;1;0;1
294;24.08.2018;2018;08;06;Perjantai;0;6;6;1;1;2
294;24.08.2018;2018;08;07;Perjantai;5;8;13;2;1;3
294;24.08.2018;2018;08;08;Perjantai;6;12;18;10;2;12
294;24.08.2018;2018;08;09;Perjantai;18;6;24;7;7;14
294;24.08.2018;2018;08;10;Perjantai;4;4;8;2;5;7
294;24.08.2018;2018;08;11;Perjantai;11;7;18;9;2;11
294;24.08.2018;2018;08;12;Perjantai;7;30;37;12;15;27
294;24.08.2018;2018;08;13;Perjantai;17;30;47;10;8;18
294;24.08.2018;2018;08;14;Perjantai;19;31;50;16;14;30
294;24.08.2018;2018;08;15;Perjantai;16;11;27;7;8;15
294;24.08.2018;2018;08;16;Perjantai;17;14;31;12;8;20
294;24.08.2018;2018;08;17;Perjantai;9;12;21;7;10;17
294;24.08.2018;2018;08;18;Perjantai;18;23;41;15;11;26
294;24.08.2018;2018;08;19;Perjantai;11;11;22;7;8;15
294;24.08.2018;2018;08;20;Perjantai;8;8;16;13;15;28
294;24.08.2018;2018;08;21;Perjantai;7;10;17;5;6;11
294;24.08.2018;2018;08;22;Perjantai;2;0;2;2;0;2
294;24.08.2018;2018;08;23;Perjantai;0;0;0;1;1;2
294;25.08.2018;2018;08;00;Lauantai;0;1;1;0;0;0
294;25.08.2018;2018;08;01;Lauantai;0;0;0;1;0;1
294;25.08.2018;2018;08;02;Lauantai;0;0;0;0;0;0
294;25.08.2018;2018;08;03;Lauantai;0;0;0;0;1;1
294;25.08.2018;2018;08;04;Lauantai;0;0;0;0;0;0
294;25.08.2018;2018;08;05;Lauantai;0;0;0;1;1;2
294;25.08.2018;2018;08;06;Lauantai;0;1;1;0;1;1
294;25.08.2018;2018;08;07;Lauantai;1;1;2;1;0;1
294;25.08.2018;2018;08;08;Lauantai;2;5;7;1;2;3
294;25.08.2018;2018;08;09;Lauantai;11;7;18;3;5;8
294;25.08.2018;2018;08;10;Lauantai;2;2;4;5;3;8
294;25.08.2018;2018;08;11;Lauantai;8;7;15;2;5;7
294;25.08.2018;2018;08;12;Lauantai;18;10;28;4;3;7
294;25.08.2018;2018;08;13;Lauantai;8;9;17;10;5;15
294;25.08.2018;2018;08;14;Lauantai;22;12;34;6;13;19
294;25.08.2018;2018;08;15;Lauantai;12;8;20;5;8;13
294;25.08.2018;2018;08;16;Lauantai;10;16;26;7;5;12
294;25.08.2018;2018;08;17;Lauantai;14;10;24;17;4;21
294;25.08.2018;2018;08;18;Lauantai;16;9;25;11;7;18
294;25.08.2018;2018;08;19;Lauantai;8;10;18;8;12;20
294;25.08.2018;2018;08;20;Lauantai;23;13;36;5;6;11
294;25.08.2018;2018;08;21;Lauantai;8;9;17;2;4;6
294;25.08.2018;2018;08;22;Lauantai;9;0;9;2;3;5
294;25.08.2018;2018;08;23;Lauantai;5;2;7;0;1;1
294;26.08.2018;2018;08;00;Sunnuntai;0;1;1;0;0;0
294;26.08.2018;2018;08;01;Sunnuntai;0;4;4;0;1;1
294;26.08.2018;2018;08;02;Sunnuntai;0;0;0;3;0;3
294;26.08.2018;2018;08;03;Sunnuntai;0;0;0;0;0;0
294;26.08.2018;2018;08;04;Sunnuntai;0;0;0;0;0;0
294;26.08.2018;2018;08;05;Sunnuntai;1;0;1;0;0;0
294;26.08.2018;2018;08;06;Sunnuntai;1;0;1;0;0;0
294;26.08.2018;2018;08;07;Sunnuntai;3;1;4;0;2;2
294;26.08.2018;2018;08;08;Sunnuntai;1;2;3;4;1;5
294;26.08.2018;2018;08;09;Sunnuntai;2;8;10;4;5;9
294;26.08.2018;2018;08;10;Sunnuntai;13;2;15;8;5;13
294;26.08.2018;2018;08;11;Sunnuntai;10;9;19;11;1;12
294;26.08.2018;2018;08;12;Sunnuntai;15;9;24;3;12;15
294;26.08.2018;2018;08;13;Sunnuntai;9;9;18;5;4;9
294;26.08.2018;2018;08;14;Sunnuntai;3;3;6;3;4;7
294;26.08.2018;2018;08;15;Sunnuntai;11;8;19;4;10;14
294;26.08.2018;2018;08;16;Sunnuntai;5;2;7;4;0;4
294;26.08.2018;2018;08;17;Sunnuntai;10;14;24;4;2;6
294;26.08.2018;2018;08;18;Sunnuntai;11;10;21;6;5;11
294;26.08.2018;2018;08;19;Sunnuntai;4;8;12;2;2;4
294;26.08.2018;2018;08;20;Sunnuntai;9;5;14;2;1;3
294;26.08.2018;2018;08;21;Sunnuntai;1;1;2;0;1;1
294;26.08.2018;2018;08;22;Sunnuntai;1;0;1;0;0;0
294;26.08.2018;2018;08;23;Sunnuntai;0;0;0;0;0;0
294;27.08.2018;2018;08;00;Maanantai;0;0;0;0;0;0
294;27.08.2018;2018;08;01;Maanantai;0;0;0;0;0;0
294;27.08.2018;2018;08;02;Maanantai;0;0;0;1;2;3
294;27.08.2018;2018;08;03;Maanantai;0;0;0;0;0;0
294;27.08.2018;2018;08;04;Maanantai;0;0;0;0;0;0
294;27.08.2018;2018;08;05;Maanantai;1;1;2;0;0;0
294;27.08.2018;2018;08;06;Maanantai;7;4;11;1;2;3
294;27.08.2018;2018;08;07;Maanantai;3;4;7;4;4;8
294;27.08.2018;2018;08;08;Maanantai;28;7;35;8;6;14
294;27.08.2018;2018;08;09;Maanantai;13;9;22;9;3;12
294;27.08.2018;2018;08;10;Maanantai;4;11;15;3;4;7
294;27.08.2018;2018;08;11;Maanantai;9;8;17;8;11;19
294;27.08.2018;2018;08;12;Maanantai;8;10;18;11;7;18
294;27.08.2018;2018;08;13;Maanantai;5;9;14;5;8;13
294;27.08.2018;2018;08;14;Maanantai;5;21;26;9;13;22
294;27.08.2018;2018;08;15;Maanantai;16;26;42;10;12;22
294;27.08.2018;2018;08;16;Maanantai;12;13;25;6;13;19
294;27.08.2018;2018;08;17;Maanantai;17;23;40;10;16;26
294;27.08.2018;2018;08;18;Maanantai;19;15;34;19;11;30
294;27.08.2018;2018;08;19;Maanantai;20;15;35;8;22;30
294;27.08.2018;2018;08;20;Maanantai;8;12;20;1;6;7
294;27.08.2018;2018;08;21;Maanantai;5;2;7;2;0;2
294;27.08.2018;2018;08;22;Maanantai;1;0;1;1;1;2
294;27.08.2018;2018;08;23;Maanantai;1;0;1;0;1;1
294;28.08.2018;2018;08;00;Tiistai;0;0;0;0;0;0
294;28.08.2018;2018;08;01;Tiistai;0;0;0;0;0;0
294;28.08.2018;2018;08;02;Tiistai;0;0;0;0;0;0
294;28.08.2018;2018;08;03;Tiistai;0;0;0;0;0;0
294;28.08.2018;2018;08;04;Tiistai;0;0;0;0;0;0
294;28.08.2018;2018;08;05;Tiistai;0;1;1;0;0;0
294;28.08.2018;2018;08;06;Tiistai;4;1;5;2;3;5
294;28.08.2018;2018;08;07;Tiistai;14;8;22;1;5;6
294;28.08.2018;2018;08;08;Tiistai;24;13;37;8;6;14
294;28.08.2018;2018;08;09;Tiistai;20;9;29;11;8;19
294;28.08.2018;2018;08;10;Tiistai;11;14;25;3;8;11
294;28.08.2018;2018;08;11;Tiistai;16;9;25;11;17;28
294;28.08.2018;2018;08;12;Tiistai;11;15;26;10;17;27
294;28.08.2018;2018;08;13;Tiistai;29;13;42;14;8;22
294;28.08.2018;2018;08;14;Tiistai;15;20;35;11;9;20
294;28.08.2018;2018;08;15;Tiistai;6;30;36;8;32;40
294;28.08.2018;2018;08;16;Tiistai;25;11;36;8;6;14
294;28.08.2018;2018;08;17;Tiistai;26;23;49;13;19;32
294;28.08.2018;2018;08;18;Tiistai;19;26;45;17;13;30
294;28.08.2018;2018;08;19;Tiistai;18;9;27;10;5;15
294;28.08.2018;2018;08;20;Tiistai;12;13;25;12;9;21
294;28.08.2018;2018;08;21;Tiistai;2;2;4;4;5;9
294;28.08.2018;2018;08;22;Tiistai;1;1;2;0;1;1
294;28.08.2018;2018;08;23;Tiistai;1;0;1;0;1;1
294;29.08.2018;2018;08;00;Keskiviikko;0;0;0;0;0;0
294;29.08.2018;2018;08;01;Keskiviikko;0;0;0;0;0;0
294;29.08.2018;2018;08;02;Keskiviikko;0;0;0;0;0;0
294;29.08.2018;2018;08;03;Keskiviikko;0;0;0;0;0;0
294;29.08.2018;2018;08;04;Keskiviikko;0;0;0;0;0;0
294;29.08.2018;2018;08;05;Keskiviikko;1;1;2;0;0;0
294;29.08.2018;2018;08;06;Keskiviikko;2;2;4;1;1;2
294;29.08.2018;2018;08;07;Keskiviikko;23;10;33;7;4;11
294;29.08.2018;2018;08;08;Keskiviikko;27;3;30;8;2;10
294;29.08.2018;2018;08;09;Keskiviikko;14;9;23;2;7;9
294;29.08.2018;2018;08;10;Keskiviikko;10;8;18;6;8;14
294;29.08.2018;2018;08;11;Keskiviikko;13;12;25;10;4;14
294;29.08.2018;2018;08;12;Keskiviikko;13;22;35;14;11;25
294;29.08.2018;2018;08;13;Keskiviikko;12;11;23;11;13;24
294;29.08.2018;2018;08;14;Keskiviikko;10;19;29;6;12;18
294;29.08.2018;2018;08;15;Keskiviikko;8;18;26;9;9;18
294;29.08.2018;2018;08;16;Keskiviikko;29;28;57;9;13;22
294;29.08.2018;2018;08;17;Keskiviikko;20;18;38;14;14;28
294;29.08.2018;2018;08;18;Keskiviikko;22;26;48;10;14;24
294;29.08.2018;2018;08;19;Keskiviikko;20;16;36;14;11;25
294;29.08.2018;2018;08;20;Keskiviikko;16;10;26;6;6;12
294;29.08.2018;2018;08;21;Keskiviikko;10;5;15;2;3;5
294;29.08.2018;2018;08;22;Keskiviikko;0;0;0;0;0;0
294;29.08.2018;2018;08;23;Keskiviikko;0;1;1;0;0;0
294;30.08.2018;2018;08;00;Torstai;0;0;0;0;0;0
294;30.08.2018;2018;08;01;Torstai;0;0;0;0;0;0
294;30.08.2018;2018;08;02;Torstai;0;0;0;0;0;0
294;30.08.2018;2018;08;03;Torstai;0;0;0;0;0;0
294;30.08.2018;2018;08;04;Torstai;0;0;0;0;0;0
294;30.08.2018;2018;08;05;Torstai;1;1;2;0;0;0
294;30.08.2018;2018;08;06;Torstai;3;3;6;0;0;0
294;30.08.2018;2018;08;07;Torstai;5;5;10;2;0;2
294;30.08.2018;2018;08;08;Torstai;24;10;34;14;4;18
294;30.08.2018;2018;08;09;Torstai;26;11;37;14;13;27
294;30.08.2018;2018;08;10;Torstai;4;2;6;10;11;21
294;30.08.2018;2018;08;11;Torstai;15;5;20;14;13;27
294;30.08.2018;2018;08;12;Torstai;4;30;34;6;12;18
294;30.08.2018;2018;08;13;Torstai;7;33;40;10;15;25
294;30.08.2018;2018;08;14;Torstai;18;21;39;9;8;17
294;30.08.2018;2018;08;15;Torstai;5;20;25;11;10;21
294;30.08.2018;2018;08;16;Torstai;15;12;27;7;5;12
294;30.08.2018;2018;08;17;Torstai;13;16;29;4;3;7
294;30.08.2018;2018;08;18;Torstai;24;14;38;4;7;11
294;30.08.2018;2018;08;19;Torstai;11;13;24;8;9;17
294;30.08.2018;2018;08;20;Torstai;3;5;8;3;0;3
294;30.08.2018;2018;08;21;Torstai;2;2;4;2;0;2
294;30.08.2018;2018;08;22;Torstai;0;0;0;0;0;0
294;30.08.2018;2018;08;23;Torstai;0;0;0;0;0;0
294;31.08.2018;2018;08;00;Perjantai;0;0;0;0;0;0
294;31.08.2018;2018;08;01;Perjantai;0;0;0;0;0;0
294;31.08.2018;2018;08;02;Perjantai;0;0;0;0;0;0
294;31.08.2018;2018;08;03;Perjantai;0;0;0;0;0;0
294;31.08.2018;2018;08;04;Perjantai;0;0;0;0;0;0
294;31.08.2018;2018;08;05;Perjantai;1;1;2;0;0;0
294;31.08.2018;2018;08;06;Perjantai;2;1;3;4;2;6
294;31.08.2018;2018;08;07;Perjantai;11;7;18;2;6;8
294;31.08.2018;2018;08;08;Perjantai;12;6;18;5;5;10
294;31.08.2018;2018;08;09;Perjantai;17;13;30;7;9;16
294;31.08.2018;2018;08;10;Perjantai;9;15;24;6;10;16
294;31.08.2018;2018;08;11;Perjantai;23;14;37;8;6;14
294;31.08.2018;2018;08;12;Perjantai;9;23;32;16;23;39
294;31.08.2018;2018;08;13;Perjantai;22;25;47;10;8;18
294;31.08.2018;2018;08;14;Perjantai;20;30;50;11;11;22
294;31.08.2018;2018;08;15;Perjantai;13;19;32;10;9;19
294;31.08.2018;2018;08;16;Perjantai;19;19;38;9;7;16
294;31.08.2018;2018;08;17;Perjantai;13;15;28;7;8;15
294;31.08.2018;2018;08;18;Perjantai;11;15;26;10;10;20
294;31.08.2018;2018;08;19;Perjantai;25;27;52;9;10;19
294;31.08.2018;2018;08;20;Perjantai;10;11;21;8;3;11
294;31.08.2018;2018;08;21;Perjantai;4;3;7;3;3;6
294;31.08.2018;2018;08;22;Perjantai;4;2;6;0;1;1
294;31.08.2018;2018;08;23;Perjantai;3;2;5;1;0;1
294;01.09.2018;2018;09;00;Lauantai;0;0;0;1;1;2
294;01.09.2018;2018;09;01;Lauantai;2;0;2;0;0;0
294;01.09.2018;2018;09;02;Lauantai;2;2;4;0;0;0
294;01.09.2018;2018;09;03;Lauantai;0;0;0;0;1;1
294;01.09.2018;2018;09;04;Lauantai;0;0;0;0;0;0
294;01.09.2018;2018;09;05;Lauantai;0;1;1;0;0;0
294;01.09.2018;2018;09;06;Lauantai;1;6;7;0;0;0
294;01.09.2018;2018;09;07;Lauantai;1;1;2;1;1;2
294;01.09.2018;2018;09;08;Lauantai;5;10;15;3;1;4
294;01.09.2018;2018;09;09;Lauantai;5;5;10;2;0;2
294;01.09.2018;2018;09;10;Lauantai;9;10;19;10;13;23
294;01.09.2018;2018;09;11;Lauantai;19;22;41;8;8;16
294;01.09.2018;2018;09;12;Lauantai;14;10;24;14;13;27
294;01.09.2018;2018;09;13;Lauantai;15;15;30;11;9;20
294;01.09.2018;2018;09;14;Lauantai;21;24;45;6;5;11
294;01.09.2018;2018;09;15;Lauantai;20;18;38;7;5;12
294;01.09.2018;2018;09;16;Lauantai;25;21;46;8;5;13
294;01.09.2018;2018;09;17;Lauantai;17;18;35;15;11;26
294;01.09.2018;2018;09;18;Lauantai;23;20;43;7;9;16
294;01.09.2018;2018;09;19;Lauantai;5;5;10;3;7;10
294;01.09.2018;2018;09;20;Lauantai;7;9;16;3;2;5
294;01.09.2018;2018;09;21;Lauantai;9;4;13;1;1;2
294;01.09.2018;2018;09;22;Lauantai;7;3;10;0;2;2
294;01.09.2018;2018;09;23;Lauantai;3;1;4;1;0;1
294;02.09.2018;2018;09;00;Sunnuntai;2;3;5;0;0;0
294;02.09.2018;2018;09;01;Sunnuntai;0;0;0;0;0;0
294;02.09.2018;2018;09;02;Sunnuntai;0;0;0;1;0;1
294;02.09.2018;2018;09;03;Sunnuntai;0;0;0;0;0;0
294;02.09.2018;2018;09;04;Sunnuntai;0;0;0;0;0;0
294;02.09.2018;2018;09;05;Sunnuntai;1;1;2;0;0;0
294;02.09.2018;2018;09;06;Sunnuntai;2;2;4;0;0;0
294;02.09.2018;2018;09;07;Sunnuntai;0;0;0;0;0;0
294;02.09.2018;2018;09;08;Sunnuntai;1;0;1;5;2;7
294;02.09.2018;2018;09;09;Sunnuntai;5;3;8;10;2;12
294;02.09.2018;2018;09;10;Sunnuntai;0;14;14;8;2;10
294;02.09.2018;2018;09;11;Sunnuntai;6;8;14;12;11;23
294;02.09.2018;2018;09;12;Sunnuntai;9;11;20;4;7;11
294;02.09.2018;2018;09;13;Sunnuntai;7;9;16;4;9;13
294;02.09.2018;2018;09;14;Sunnuntai;33;17;50;3;10;13
294;02.09.2018;2018;09;15;Sunnuntai;21;20;41;6;5;11
294;02.09.2018;2018;09;16;Sunnuntai;17;14;31;9;4;13
294;02.09.2018;2018;09;17;Sunnuntai;22;17;39;3;6;9
294;02.09.2018;2018;09;18;Sunnuntai;13;13;26;6;6;12
294;02.09.2018;2018;09;19;Sunnuntai;15;8;23;4;4;8
294;02.09.2018;2018;09;20;Sunnuntai;7;3;10;3;3;6
294;02.09.2018;2018;09;21;Sunnuntai;2;2;4;1;2;3
294;02.09.2018;2018;09;22;Sunnuntai;0;1;1;1;1;2
294;02.09.2018;2018;09;23;Sunnuntai;4;0;4;8;3;11
294;03.09.2018;2018;09;00;Maanantai;0;0;0;0;0;0
294;03.09.2018;2018;09;01;Maanantai;0;0;0;0;0;0
294;03.09.2018;2018;09;02;Maanantai;0;0;0;0;0;0
294;03.09.2018;2018;09;03;Maanantai;0;0;0;0;0;0
294;03.09.2018;2018;09;04;Maanantai;0;0;0;0;0;0
294;03.09.2018;2018;09;05;Maanantai;1;1;2;0;0;0
294;03.09.2018;2018;09;06;Maanantai;5;4;9;1;2;3
294;03.09.2018;2018;09;07;Maanantai;10;10;20;2;5;7
294;03.09.2018;2018;09;08;Maanantai;20;7;27;10;6;16
294;03.09.2018;2018;09;09;Maanantai;19;13;32;9;10;19
294;03.09.2018;2018;09;10;Maanantai;6;8;14;8;11;19
294;03.09.2018;2018;09;11;Maanantai;14;13;27;26;15;41
294;03.09.2018;2018;09;12;Maanantai;10;4;14;8;10;18
294;03.09.2018;2018;09;13;Maanantai;20;24;44;9;16;25
294;03.09.2018;2018;09;14;Maanantai;8;31;39;14;8;22
294;03.09.2018;2018;09;15;Maanantai;24;18;42;12;10;22
294;03.09.2018;2018;09;16;Maanantai;26;19;45;8;3;11
294;03.09.2018;2018;09;17;Maanantai;19;17;36;3;7;10
294;03.09.2018;2018;09;18;Maanantai;12;23;35;15;18;33
294;03.09.2018;2018;09;19;Maanantai;21;16;37;10;14;24
294;03.09.2018;2018;09;20;Maanantai;10;7;17;8;2;10
294;03.09.2018;2018;09;21;Maanantai;5;6;11;2;2;4
294;03.09.2018;2018;09;22;Maanantai;0;0;0;1;1;2
294;03.09.2018;2018;09;23;Maanantai;0;0;0;1;0;1
294;04.09.2018;2018;09;00;Tiistai;0;0;0;0;0;0
294;04.09.2018;2018;09;01;Tiistai;0;0;0;0;0;0
294;04.09.2018;2018;09;02;Tiistai;0;0;0;0;0;0
294;04.09.2018;2018;09;03;Tiistai;0;0;0;0;0;0
294;04.09.2018;2018;09;04;Tiistai;0;0;0;0;0;0
294;04.09.2018;2018;09;05;Tiistai;0;1;1;0;0;0
294;04.09.2018;2018;09;06;Tiistai;5;1;6;2;2;4
294;04.09.2018;2018;09;07;Tiistai;10;5;15;9;5;14
294;04.09.2018;2018;09;08;Tiistai;22;12;34;10;5;15
294;04.09.2018;2018;09;09;Tiistai;19;5;24;17;6;23
294;04.09.2018;2018;09;10;Tiistai;8;17;25;10;15;25
294;04.09.2018;2018;09;11;Tiistai;8;10;18;19;14;33
294;04.09.2018;2018;09;12;Tiistai;5;7;12;5;14;19
294;04.09.2018;2018;09;13;Tiistai;12;11;23;8;8;16
294;04.09.2018;2018;09;14;Tiistai;10;19;29;10;11;21
294;04.09.2018;2018;09;15;Tiistai;16;37;53;8;13;21
294;04.09.2018;2018;09;16;Tiistai;24;17;41;11;4;15
294;04.09.2018;2018;09;17;Tiistai;14;12;26;12;8;20
294;04.09.2018;2018;09;18;Tiistai;20;25;45;7;9;16
294;04.09.2018;2018;09;19;Tiistai;17;14;31;11;11;22
294;04.09.2018;2018;09;20;Tiistai;6;12;18;5;5;10
294;04.09.2018;2018;09;21;Tiistai;2;4;6;1;3;4
294;04.09.2018;2018;09;22;Tiistai;1;0;1;1;1;2
294;04.09.2018;2018;09;23;Tiistai;0;0;0;1;0;1
294;05.09.2018;2018;09;00;Keskiviikko;0;0;0;0;0;0
294;05.09.2018;2018;09;01;Keskiviikko;0;0;0;0;0;0
294;05.09.2018;2018;09;02;Keskiviikko;0;0;0;0;0;0
294;05.09.2018;2018;09;03;Keskiviikko;0;0;0;0;0;0
294;05.09.2018;2018;09;04;Keskiviikko;0;0;0;0;0;0
294;05.09.2018;2018;09;05;Keskiviikko;1;1;2;0;0;0
294;05.09.2018;2018;09;06;Keskiviikko;9;4;13;2;0;2
294;05.09.2018;2018;09;07;Keskiviikko;19;12;31;5;6;11
294;05.09.2018;2018;09;08;Keskiviikko;29;8;37;9;3;12
294;05.09.2018;2018;09;09;Keskiviikko;16;5;21;10;7;17
294;05.09.2018;2018;09;10;Keskiviikko;6;2;8;8;4;12
294;05.09.2018;2018;09;11;Keskiviikko;10;20;30;7;9;16
294;05.09.2018;2018;09;12;Keskiviikko;14;27;41;7;17;24
294;05.09.2018;2018;09;13;Keskiviikko;15;26;41;28;17;45
294;05.09.2018;2018;09;14;Keskiviikko;21;11;32;8;11;19
294;05.09.2018;2018;09;15;Keskiviikko;15;22;37;8;10;18
294;05.09.2018;2018;09;16;Keskiviikko;21;15;36;7;9;16
294;05.09.2018;2018;09;17;Keskiviikko;25;18;43;11;5;16
294;05.09.2018;2018;09;18;Keskiviikko;15;25;40;9;12;21
294;05.09.2018;2018;09;19;Keskiviikko;14;14;28;8;13;21
294;05.09.2018;2018;09;20;Keskiviikko;8;11;19;8;3;11
294;05.09.2018;2018;09;21;Keskiviikko;5;4;9;3;3;6
294;05.09.2018;2018;09;22;Keskiviikko;0;0;0;1;1;2
294;05.09.2018;2018;09;23;Keskiviikko;0;0;0;0;0;0
294;06.09.2018;2018;09;00;Torstai;0;0;0;0;1;1
294;06.09.2018;2018;09;01;Torstai;0;0;0;0;0;0
294;06.09.2018;2018;09;02;Torstai;0;0;0;0;0;0
294;06.09.2018;2018;09;03;Torstai;0;0;0;0;0;0
294;06.09.2018;2018;09;04;Torstai;0;0;0;0;0;0
294;06.09.2018;2018;09;05;Torstai;1;1;2;0;0;0
294;06.09.2018;2018;09;06;Torstai;4;5;9;3;3;6
294;06.09.2018;2018;09;07;Torstai;12;11;23;3;3;6
294;06.09.2018;2018;09;08;Torstai;24;4;28;5;4;9
294;06.09.2018;2018;09;09;Torstai;20;11;31;12;9;21
294;06.09.2018;2018;09;10;Torstai;9;8;17;5;10;15
294;06.09.2018;2018;09;11;Torstai;8;11;19;17;19;36
294;06.09.2018;2018;09;12;Torstai;10;12;22;12;12;24
294;06.09.2018;2018;09;13;Torstai;10;14;24;10;11;21
294;06.09.2018;2018;09;14;Torstai;12;18;30;10;10;20
294;06.09.2018;2018;09;15;Torstai;23;33;56;9;19;28
294;06.09.2018;2018;09;16;Torstai;15;21;36;18;7;25
294;06.09.2018;2018;09;17;Torstai;14;8;22;9;9;18
294;06.09.2018;2018;09;18;Torstai;19;16;35;3;9;12
294;06.09.2018;2018;09;19;Torstai;20;19;39;11;11;22
294;06.09.2018;2018;09;20;Torstai;13;11;24;2;6;8
294;06.09.2018;2018;09;21;Torstai;5;1;6;2;5;7
294;06.09.2018;2018;09;22;Torstai;0;0;0;0;0;0
294;06.09.2018;2018;09;23;Torstai;0;0;0;0;0;0
294;07.09.2018;2018;09;00;Perjantai;0;0;0;0;0;0
294;07.09.2018;2018;09;01;Perjantai;0;0;0;0;0;0
294;07.09.2018;2018;09;02;Perjantai;0;0;0;0;0;0
294;07.09.2018;2018;09;03;Perjantai;0;0;0;0;0;0
294;07.09.2018;2018;09;04;Perjantai;0;0;0;0;0;0
294;07.09.2018;2018;09;05;Perjantai;2;1;3;0;0;0
294;07.09.2018;2018;09;06;Perjantai;3;8;11;3;3;6
294;07.09.2018;2018;09;07;Perjantai;7;7;14;4;2;6
294;07.09.2018;2018;09;08;Perjantai;9;6;15;2;6;8
294;07.09.2018;2018;09;09;Perjantai;17;12;29;14;6;20
294;07.09.2018;2018;09;10;Perjantai;11;8;19;11;8;19
294;07.09.2018;2018;09;11;Perjantai;22;13;35;14;11;25
294;07.09.2018;2018;09;12;Perjantai;12;29;41;16;16;32
294;07.09.2018;2018;09;13;Perjantai;29;27;56;13;19;32
294;07.09.2018;2018;09;14;Perjantai;18;33;51;13;28;41
294;07.09.2018;2018;09;15;Perjantai;18;17;35;10;12;22
294;07.09.2018;2018;09;16;Perjantai;20;14;34;18;15;33
294;07.09.2018;2018;09;17;Perjantai;17;14;31;8;13;21
294;07.09.2018;2018;09;18;Perjantai;27;22;49;5;3;8
294;07.09.2018;2018;09;19;Perjantai;18;17;35;7;8;15
294;07.09.2018;2018;09;20;Perjantai;7;5;12;6;7;13
294;07.09.2018;2018;09;21;Perjantai;13;7;20;1;2;3
294;07.09.2018;2018;09;22;Perjantai;0;3;3;1;2;3
294;07.09.2018;2018;09;23;Perjantai;1;0;1;0;0;0
294;08.09.2018;2018;09;00;Lauantai;0;0;0;2;0;2
294;08.09.2018;2018;09;01;Lauantai;0;1;1;0;0;0
294;08.09.2018;2018;09;02;Lauantai;0;2;2;1;0;1
294;08.09.2018;2018;09;03;Lauantai;0;0;0;0;0;0
294;08.09.2018;2018;09;04;Lauantai;0;0;0;0;0;0
294;08.09.2018;2018;09;05;Lauantai;1;0;1;0;1;1
294;08.09.2018;2018;09;06;Lauantai;1;4;5;1;1;2
294;08.09.2018;2018;09;07;Lauantai;0;2;2;2;0;2
294;08.09.2018;2018;09;08;Lauantai;2;2;4;2;1;3
294;08.09.2018;2018;09;09;Lauantai;4;3;7;9;4;13
294;08.09.2018;2018;09;10;Lauantai;10;7;17;4;9;13
294;08.09.2018;2018;09;11;Lauantai;29;18;47;11;11;22
294;08.09.2018;2018;09;12;Lauantai;10;11;21;12;7;19
294;08.09.2018;2018;09;13;Lauantai;29;19;48;15;12;27
294;08.09.2018;2018;09;14;Lauantai;21;27;48;6;7;13
294;08.09.2018;2018;09;15;Lauantai;18;16;34;8;3;11
294;08.09.2018;2018;09;16;Lauantai;16;14;30;3;4;7
294;08.09.2018;2018;09;17;Lauantai;21;22;43;14;4;18
294;08.09.2018;2018;09;18;Lauantai;7;14;21;5;8;13
294;08.09.2018;2018;09;19;Lauantai;20;17;37;4;10;14
294;08.09.2018;2018;09;20;Lauantai;12;7;19;6;8;14
294;08.09.2018;2018;09;21;Lauantai;8;10;18;0;1;1
294;08.09.2018;2018;09;22;Lauantai;6;2;8;1;0;1
294;08.09.2018;2018;09;23;Lauantai;2;1;3;1;1;2
294;09.09.2018;2018;09;00;Sunnuntai;0;1;1;0;0;0
294;09.09.2018;2018;09;01;Sunnuntai;0;0;0;0;0;0
294;09.09.2018;2018;09;02;Sunnuntai;0;0;0;1;0;1
294;09.09.2018;2018;09;03;Sunnuntai;0;0;0;0;0;0
294;09.09.2018;2018;09;04;Sunnuntai;1;1;2;0;0;0
294;09.09.2018;2018;09;05;Sunnuntai;0;1;1;0;0;0
294;09.09.2018;2018;09;06;Sunnuntai;0;0;0;0;1;1
294;09.09.2018;2018;09;07;Sunnuntai;1;0;1;1;0;1
294;09.09.2018;2018;09;08;Sunnuntai;2;2;4;2;0;2
294;09.09.2018;2018;09;09;Sunnuntai;6;3;9;4;6;10
294;09.09.2018;2018;09;10;Sunnuntai;5;12;17;7;10;17
294;09.09.2018;2018;09;11;Sunnuntai;7;13;20;9;6;15
294;09.09.2018;2018;09;12;Sunnuntai;11;6;17;3;6;9
294;09.09.2018;2018;09;13;Sunnuntai;12;8;20;15;3;18
294;09.09.2018;2018;09;14;Sunnuntai;16;6;22;6;5;11
294;09.09.2018;2018;09;15;Sunnuntai;6;15;21;11;7;18
294;09.09.2018;2018;09;16;Sunnuntai;12;9;21;7;7;14
294;09.09.2018;2018;09;17;Sunnuntai;17;31;48;8;9;17
294;09.09.2018;2018;09;18;Sunnuntai;14;15;29;9;10;19
294;09.09.2018;2018;09;19;Sunnuntai;9;9;18;11;10;21
294;09.09.2018;2018;09;20;Sunnuntai;8;7;15;2;2;4
294;09.09.2018;2018;09;21;Sunnuntai;2;1;3;4;1;5
294;09.09.2018;2018;09;22;Sunnuntai;0;0;0;0;0;0
294;09.09.2018;2018;09;23;Sunnuntai;0;0;0;0;0;0
294;10.09.2018;2018;09;00;Maanantai;0;0;0;0;0;0
294;10.09.2018;2018;09;01;Maanantai;0;0;0;0;0;0
294;10.09.2018;2018;09;02;Maanantai;0;0;0;0;0;0
294;10.09.2018;2018;09;03;Maanantai;0;0;0;0;0;0
294;10.09.2018;2018;09;04;Maanantai;0;0;0;0;0;0
294;10.09.2018;2018;09;05;Maanantai;2;2;4;0;0;0
294;10.09.2018;2018;09;06;Maanantai;5;2;7;1;1;2
294;10.09.2018;2018;09;07;Maanantai;8;4;12;1;2;3
294;10.09.2018;2018;09;08;Maanantai;20;12;32;10;2;12
294;10.09.2018;2018;09;09;Maanantai;18;8;26;15;6;21
294;10.09.2018;2018;09;10;Maanantai;12;12;24;3;3;6
294;10.09.2018;2018;09;11;Maanantai;19;11;30;12;10;22
294;10.09.2018;2018;09;12;Maanantai;8;6;14;14;11;25
294;10.09.2018;2018;09;13;Maanantai;10;18;28;6;6;12
294;10.09.2018;2018;09;14;Maanantai;11;30;41;17;13;30
294;10.09.2018;2018;09;15;Maanantai;22;24;46;8;7;15
294;10.09.2018;2018;09;16;Maanantai;18;17;35;13;11;24
294;10.09.2018;2018;09;17;Maanantai;16;23;39;11;12;23
294;10.09.2018;2018;09;18;Maanantai;8;16;24;6;17;23
294;10.09.2018;2018;09;19;Maanantai;20;16;36;9;10;19
294;10.09.2018;2018;09;20;Maanantai;10;12;22;9;7;16
294;10.09.2018;2018;09;21;Maanantai;4;1;5;3;2;5
294;10.09.2018;2018;09;22;Maanantai;0;0;0;0;0;0
294;10.09.2018;2018;09;23;Maanantai;0;0;0;0;0;0
294;11.09.2018;2018;09;00;Tiistai;0;0;0;0;0;0
294;11.09.2018;2018;09;01;Tiistai;0;0;0;0;0;0
294;11.09.2018;2018;09;02;Tiistai;0;0;0;0;0;0
294;11.09.2018;2018;09;03;Tiistai;0;0;0;0;0;0
294;11.09.2018;2018;09;04;Tiistai;0;0;0;0;0;0
294;11.09.2018;2018;09;05;Tiistai;0;1;1;0;0;0
294;11.09.2018;2018;09;06;Tiistai;5;1;6;3;2;5
294;11.09.2018;2018;09;07;Tiistai;13;7;20;4;5;9
294;11.09.2018;2018;09;08;Tiistai;18;7;25;7;2;9
294;11.09.2018;2018;09;09;Tiistai;21;5;26;10;6;16
294;11.09.2018;2018;09;10;Tiistai;5;7;12;4;9;13
294;11.09.2018;2018;09;11;Tiistai;13;12;25;14;10;24
294;11.09.2018;2018;09;12;Tiistai;8;7;15;7;13;20
294;11.09.2018;2018;09;13;Tiistai;18;9;27;13;6;19
294;11.09.2018;2018;09;14;Tiistai;13;11;24;12;9;21
294;11.09.2018;2018;09;15;Tiistai;19;47;66;18;14;32
294;11.09.2018;2018;09;16;Tiistai;18;23;41;12;15;27
294;11.09.2018;2018;09;17;Tiistai;7;14;21;4;3;7
294;11.09.2018;2018;09;18;Tiistai;6;10;16;2;5;7
294;11.09.2018;2018;09;19;Tiistai;11;1;12;3;4;7
294;11.09.2018;2018;09;20;Tiistai;1;1;2;2;3;5
294;11.09.2018;2018;09;21;Tiistai;3;0;3;0;0;0
294;11.09.2018;2018;09;22;Tiistai;0;0;0;0;0;0
294;11.09.2018;2018;09;23;Tiistai;0;0;0;0;0;0
294;12.09.2018;2018;09;00;Keskiviikko;1;0;1;0;0;0
294;12.09.2018;2018;09;01;Keskiviikko;0;0;0;0;0;0
294;12.09.2018;2018;09;02;Keskiviikko;0;0;0;0;0;0
294;12.09.2018;2018;09;03;Keskiviikko;0;0;0;0;0;0
294;12.09.2018;2018;09;04;Keskiviikko;0;0;0;0;0;0
294;12.09.2018;2018;09;05;Keskiviikko;0;1;1;1;1;2
294;12.09.2018;2018;09;06;Keskiviikko;4;0;4;1;0;1
294;12.09.2018;2018;09;07;Keskiviikko;17;6;23;5;2;7
294;12.09.2018;2018;09;08;Keskiviikko;18;5;23;12;3;15
294;12.09.2018;2018;09;09;Keskiviikko;6;4;10;5;7;12
294;12.09.2018;2018;09;10;Keskiviikko;4;9;13;5;7;12
294;12.09.2018;2018;09;11;Keskiviikko;12;9;21;11;10;21
294;12.09.2018;2018;09;12;Keskiviikko;11;16;27;11;12;23
294;12.09.2018;2018;09;13;Keskiviikko;11;15;26;8;9;17
294;12.09.2018;2018;09;14;Keskiviikko;9;12;21;7;4;11
294;12.09.2018;2018;09;15;Keskiviikko;5;19;24;4;4;8
294;12.09.2018;2018;09;16;Keskiviikko;11;12;23;7;4;11
294;12.09.2018;2018;09;17;Keskiviikko;9;6;15;4;4;8
294;12.09.2018;2018;09;18;Keskiviikko;10;6;16;14;3;17
294;12.09.2018;2018;09;19;Keskiviikko;18;9;27;8;9;17
294;12.09.2018;2018;09;20;Keskiviikko;7;7;14;2;3;5
294;12.09.2018;2018;09;21;Keskiviikko;4;1;5;2;0;2
294;12.09.2018;2018;09;22;Keskiviikko;1;0;1;0;0;0
294;12.09.2018;2018;09;23;Keskiviikko;0;0;0;0;0;0
294;13.09.2018;2018;09;00;Torstai;1;0;1;0;0;0
294;13.09.2018;2018;09;01;Torstai;0;0;0;0;0;0
294;13.09.2018;2018;09;02;Torstai;0;0;0;0;0;0
294;13.09.2018;2018;09;03;Torstai;0;0;0;0;0;0
294;13.09.2018;2018;09;04;Torstai;0;0;0;0;0;0
294;13.09.2018;2018;09;05;Torstai;0;1;1;1;0;1
294;13.09.2018;2018;09;06;Torstai;5;1;6;0;2;2
294;13.09.2018;2018;09;07;Torstai;15;9;24;3;3;6
294;13.09.2018;2018;09;08;Torstai;20;3;23;12;3;15
294;13.09.2018;2018;09;09;Torstai;19;5;24;10;11;21
294;13.09.2018;2018;09;10;Torstai;8;8;16;8;14;22
294;13.09.2018;2018;09;11;Torstai;15;13;28;19;9;28
294;13.09.2018;2018;09;12;Torstai;7;11;18;9;15;24
294;13.09.2018;2018;09;13;Torstai;21;19;40;7;12;19
294;13.09.2018;2018;09;14;Torstai;16;10;26;15;11;26
294;13.09.2018;2018;09;15;Torstai;29;43;72;12;14;26
294;13.09.2018;2018;09;16;Torstai;16;19;35;16;6;22
294;13.09.2018;2018;09;17;Torstai;15;14;29;6;5;11
294;13.09.2018;2018;09;18;Torstai;24;30;54;11;19;30
294;13.09.2018;2018;09;19;Torstai;18;27;45;6;13;19
294;13.09.2018;2018;09;20;Torstai;12;12;24;9;3;12
294;13.09.2018;2018;09;21;Torstai;4;3;7;1;0;1
294;13.09.2018;2018;09;22;Torstai;1;2;3;0;1;1
294;13.09.2018;2018;09;23;Torstai;0;0;0;1;1;2
294;14.09.2018;2018;09;00;Perjantai;0;0;0;0;0;0
294;14.09.2018;2018;09;01;Perjantai;0;0;0;0;0;0
294;14.09.2018;2018;09;02;Perjantai;0;0;0;0;0;0
294;14.09.2018;2018;09;03;Perjantai;0;0;0;0;0;0
294;14.09.2018;2018;09;04;Perjantai;0;0;0;0;0;0
294;14.09.2018;2018;09;05;Perjantai;1;1;2;0;0;0
294;14.09.2018;2018;09;06;Perjantai;4;3;7;0;0;0
294;14.09.2018;2018;09;07;Perjantai;16;9;25;3;3;6
294;14.09.2018;2018;09;08;Perjantai;15;7;22;4;1;5
294;14.09.2018;2018;09;09;Perjantai;19;10;29;19;8;27
294;14.09.2018;2018;09;10;Perjantai;13;12;25;9;18;27
294;14.09.2018;2018;09;11;Perjantai;17;12;29;14;6;20
294;14.09.2018;2018;09;12;Perjantai;16;23;39;7;14;21
294;14.09.2018;2018;09;13;Perjantai;31;38;69;22;12;34
294;14.09.2018;2018;09;14;Perjantai;34;28;62;10;11;21
294;14.09.2018;2018;09;15;Perjantai;26;21;47;16;11;27
294;14.09.2018;2018;09;16;Perjantai;19;27;46;7;13;20
294;14.09.2018;2018;09;17;Perjantai;20;20;40;5;8;13
294;14.09.2018;2018;09;18;Perjantai;14;8;22;9;8;17
294;14.09.2018;2018;09;19;Perjantai;15;14;29;9;7;16
294;14.09.2018;2018;09;20;Perjantai;15;10;25;6;4;10
294;14.09.2018;2018;09;21;Perjantai;7;5;12;7;4;11
294;14.09.2018;2018;09;22;Perjantai;1;2;3;3;1;4
294;14.09.2018;2018;09;23;Perjantai;2;0;2;1;0;1
294;15.09.2018;2018;09;00;Lauantai;0;0;0;0;0;0
294;15.09.2018;2018;09;01;Lauantai;0;0;0;0;0;0
294;15.09.2018;2018;09;02;Lauantai;1;0;1;0;0;0
294;15.09.2018;2018;09;03;Lauantai;0;0;0;0;0;0
294;15.09.2018;2018;09;04;Lauantai;0;0;0;0;0;0
294;15.09.2018;2018;09;05;Lauantai;1;0;1;0;3;3
294;15.09.2018;2018;09;06;Lauantai;1;2;3;0;2;2
294;15.09.2018;2018;09;07;Lauantai;1;2;3;0;2;2
294;15.09.2018;2018;09;08;Lauantai;0;3;3;2;4;6
294;15.09.2018;2018;09;09;Lauantai;7;8;15;10;11;21
294;15.09.2018;2018;09;10;Lauantai;10;15;25;11;10;21
294;15.09.2018;2018;09;11;Lauantai;9;9;18;15;12;27
294;15.09.2018;2018;09;12;Lauantai;7;13;20;4;5;9
294;15.09.2018;2018;09;13;Lauantai;7;5;12;2;2;4
294;15.09.2018;2018;09;14;Lauantai;10;9;19;2;1;3
294;15.09.2018;2018;09;15;Lauantai;10;8;18;5;5;10
294;15.09.2018;2018;09;16;Lauantai;11;10;21;4;4;8
294;15.09.2018;2018;09;17;Lauantai;10;2;12;9;1;10
294;15.09.2018;2018;09;18;Lauantai;10;9;19;4;6;10
294;15.09.2018;2018;09;19;Lauantai;9;14;23;4;3;7
294;15.09.2018;2018;09;20;Lauantai;11;7;18;1;5;6
294;15.09.2018;2018;09;21;Lauantai;3;5;8;1;0;1
294;15.09.2018;2018;09;22;Lauantai;3;1;4;0;1;1
294;15.09.2018;2018;09;23;Lauantai;0;0;0;1;0;1
294;16.09.2018;2018;09;00;Sunnuntai;1;0;1;1;0;1
294;16.09.2018;2018;09;01;Sunnuntai;0;0;0;0;1;1
294;16.09.2018;2018;09;02;Sunnuntai;0;0;0;0;0;0
294;16.09.2018;2018;09;03;Sunnuntai;0;1;1;0;1;1
294;16.09.2018;2018;09;04;Sunnuntai;0;0;0;0;0;0
294;16.09.2018;2018;09;05;Sunnuntai;0;0;0;0;0;0
294;16.09.2018;2018;09;06;Sunnuntai;2;0;2;0;0;0
294;16.09.2018;2018;09;07;Sunnuntai;1;0;1;0;0;0
294;16.09.2018;2018;09;08;Sunnuntai;2;1;3;2;2;4
294;16.09.2018;2018;09;09;Sunnuntai;5;2;7;5;4;9
294;16.09.2018;2018;09;10;Sunnuntai;5;3;8;10;9;19
294;16.09.2018;2018;09;11;Sunnuntai;6;8;14;4;5;9
294;16.09.2018;2018;09;12;Sunnuntai;14;10;24;11;3;14
294;16.09.2018;2018;09;13;Sunnuntai;10;12;22;6;8;14
294;16.09.2018;2018;09;14;Sunnuntai;7;15;22;1;1;2
294;16.09.2018;2018;09;15;Sunnuntai;12;12;24;1;0;1
294;16.09.2018;2018;09;16;Sunnuntai;15;3;18;4;5;9
294;16.09.2018;2018;09;17;Sunnuntai;10;12;22;7;7;14
294;16.09.2018;2018;09;18;Sunnuntai;24;14;38;9;8;17
294;16.09.2018;2018;09;19;Sunnuntai;8;12;20;5;4;9
294;16.09.2018;2018;09;20;Sunnuntai;11;5;16;5;4;9
294;16.09.2018;2018;09;21;Sunnuntai;0;3;3;0;0;0
294;16.09.2018;2018;09;22;Sunnuntai;1;0;1;0;0;0
294;16.09.2018;2018;09;23;Sunnuntai;0;0;0;0;0;0
294;17.09.2018;2018;09;00;Maanantai;0;0;0;0;0;0
294;17.09.2018;2018;09;01;Maanantai;0;0;0;0;0;0
294;17.09.2018;2018;09;02;Maanantai;0;0;0;0;0;0
294;17.09.2018;2018;09;03;Maanantai;0;0;0;0;0;0
294;17.09.2018;2018;09;04;Maanantai;0;0;0;0;0;0
294;17.09.2018;2018;09;05;Maanantai;0;1;1;0;0;0
294;17.09.2018;2018;09;06;Maanantai;3;4;7;1;1;2
294;17.09.2018;2018;09;07;Maanantai;8;7;15;1;3;4
294;17.09.2018;2018;09;08;Maanantai;21;11;32;9;4;13
294;17.09.2018;2018;09;09;Maanantai;17;10;27;5;1;6
294;17.09.2018;2018;09;10;Maanantai;13;5;18;5;4;9
294;17.09.2018;2018;09;11;Maanantai;6;17;23;20;19;39
294;17.09.2018;2018;09;12;Maanantai;12;9;21;15;15;30
294;17.09.2018;2018;09;13;Maanantai;9;15;24;18;6;24
294;17.09.2018;2018;09;14;Maanantai;13;21;34;11;10;21
294;17.09.2018;2018;09;15;Maanantai;14;20;34;9;12;21
294;17.09.2018;2018;09;16;Maanantai;15;23;38;10;14;24
294;17.09.2018;2018;09;17;Maanantai;26;23;49;13;16;29
294;17.09.2018;2018;09;18;Maanantai;29;33;62;15;9;24
294;17.09.2018;2018;09;19;Maanantai;21;11;32;16;11;27
294;17.09.2018;2018;09;20;Maanantai;5;4;9;2;5;7
294;17.09.2018;2018;09;21;Maanantai;0;2;2;1;1;2
294;17.09.2018;2018;09;22;Maanantai;0;0;0;0;0;0
294;17.09.2018;2018;09;23;Maanantai;0;0;0;0;0;0
294;18.09.2018;2018;09;00;Tiistai;0;0;0;0;0;0
294;18.09.2018;2018;09;01;Tiistai;0;0;0;0;0;0
294;18.09.2018;2018;09;02;Tiistai;0;0;0;0;0;0
294;18.09.2018;2018;09;03;Tiistai;0;0;0;0;0;0
294;18.09.2018;2018;09;04;Tiistai;0;0;0;0;0;0
294;18.09.2018;2018;09;05;Tiistai;0;1;1;0;1;1
294;18.09.2018;2018;09;06;Tiistai;2;2;4;1;3;4
294;18.09.2018;2018;09;07;Tiistai;7;10;17;2;4;6
294;18.09.2018;2018;09;08;Tiistai;22;5;27;4;5;9
294;18.09.2018;2018;09;09;Tiistai;18;5;23;13;1;14
294;18.09.2018;2018;09;10;Tiistai;6;8;14;8;7;15
294;18.09.2018;2018;09;11;Tiistai;11;7;18;6;11;17
294;18.09.2018;2018;09;12;Tiistai;8;11;19;8;12;20
294;18.09.2018;2018;09;13;Tiistai;17;8;25;17;12;29
294;18.09.2018;2018;09;14;Tiistai;20;22;42;4;17;21
294;18.09.2018;2018;09;15;Tiistai;11;34;45;11;10;21
294;18.09.2018;2018;09;16;Tiistai;17;18;35;13;3;16
294;18.09.2018;2018;09;17;Tiistai;16;13;29;11;8;19
294;18.09.2018;2018;09;18;Tiistai;20;21;41;22;16;38
294;18.09.2018;2018;09;19;Tiistai;10;14;24;15;8;23
294;18.09.2018;2018;09;20;Tiistai;10;12;22;5;2;7
294;18.09.2018;2018;09;21;Tiistai;3;1;4;1;0;1
294;18.09.2018;2018;09;22;Tiistai;0;1;1;0;0;0
294;18.09.2018;2018;09;23;Tiistai;0;0;0;0;0;0
294;19.09.2018;2018;09;00;Keskiviikko;0;0;0;0;0;0
294;19.09.2018;2018;09;01;Keskiviikko;0;0;0;0;0;0
294;19.09.2018;2018;09;02;Keskiviikko;0;0;0;0;0;0
294;19.09.2018;2018;09;03;Keskiviikko;0;0;0;0;0;0
294;19.09.2018;2018;09;04;Keskiviikko;0;0;0;0;0;0
294;19.09.2018;2018;09;05;Keskiviikko;0;1;1;0;0;0
294;19.09.2018;2018;09;06;Keskiviikko;4;4;8;1;0;1
294;19.09.2018;2018;09;07;Keskiviikko;18;11;29;2;5;7
294;19.09.2018;2018;09;08;Keskiviikko;26;11;37;7;1;8
294;19.09.2018;2018;09;09;Keskiviikko;5;8;13;7;5;12
294;19.09.2018;2018;09;10;Keskiviikko;3;4;7;12;7;19
294;19.09.2018;2018;09;11;Keskiviikko;15;8;23;14;6;20
294;19.09.2018;2018;09;12;Keskiviikko;4;19;23;4;11;15
294;19.09.2018;2018;09;13;Keskiviikko;11;7;18;7;5;12
294;19.09.2018;2018;09;14;Keskiviikko;7;9;16;5;10;15
294;19.09.2018;2018;09;15;Keskiviikko;12;20;32;7;10;17
294;19.09.2018;2018;09;16;Keskiviikko;13;12;25;5;5;10
294;19.09.2018;2018;09;17;Keskiviikko;13;13;26;5;3;8
294;19.09.2018;2018;09;18;Keskiviikko;10;4;14;5;4;9
294;19.09.2018;2018;09;19;Keskiviikko;9;13;22;4;9;13
294;19.09.2018;2018;09;20;Keskiviikko;7;4;11;6;2;8
294;19.09.2018;2018;09;21;Keskiviikko;4;1;5;1;1;2
294;19.09.2018;2018;09;22;Keskiviikko;0;0;0;0;0;0
294;19.09.2018;2018;09;23;Keskiviikko;0;0;0;1;0;1
294;20.09.2018;2018;09;00;Torstai;0;0;0;0;0;0
294;20.09.2018;2018;09;01;Torstai;2;1;3;0;0;0
294;20.09.2018;2018;09;02;Torstai;0;1;1;0;0;0
294;20.09.2018;2018;09;03;Torstai;0;0;0;0;0;0
294;20.09.2018;2018;09;04;Torstai;0;0;0;0;0;0
294;20.09.2018;2018;09;05;Torstai;0;1;1;0;0;0
294;20.09.2018;2018;09;06;Torstai;4;4;8;2;2;4
294;20.09.2018;2018;09;07;Torstai;13;14;27;1;4;5
294;20.09.2018;2018;09;08;Torstai;17;8;25;7;5;12
294;20.09.2018;2018;09;09;Torstai;13;10;23;7;7;14
294;20.09.2018;2018;09;10;Torstai;8;5;13;7;5;12
294;20.09.2018;2018;09;11;Torstai;13;8;21;10;14;24
294;20.09.2018;2018;09;12;Torstai;7;4;11;13;9;22
294;20.09.2018;2018;09;13;Torstai;7;14;21;15;10;25
294;20.09.2018;2018;09;14;Torstai;6;8;14;7;3;10
294;20.09.2018;2018;09;15;Torstai;5;27;32;2;10;12
294;20.09.2018;2018;09;16;Torstai;25;15;40;8;9;17
294;20.09.2018;2018;09;17;Torstai;13;6;19;7;3;10
294;20.09.2018;2018;09;18;Torstai;16;19;35;10;8;18
294;20.09.2018;2018;09;19;Torstai;7;12;19;15;9;24
294;20.09.2018;2018;09;20;Torstai;6;4;10;7;5;12
294;20.09.2018;2018;09;21;Torstai;0;2;2;1;1;2
294;20.09.2018;2018;09;22;Torstai;1;0;1;0;0;0
294;20.09.2018;2018;09;23;Torstai;0;0;0;1;0;1
294;21.09.2018;2018;09;00;Perjantai;0;0;0;0;0;0
294;21.09.2018;2018;09;01;Perjantai;0;0;0;0;0;0
294;21.09.2018;2018;09;02;Perjantai;0;0;0;0;0;0
294;21.09.2018;2018;09;03;Perjantai;0;0;0;0;0;0
294;21.09.2018;2018;09;04;Perjantai;0;0;0;0;0;0
294;21.09.2018;2018;09;05;Perjantai;0;1;1;0;0;0
294;21.09.2018;2018;09;06;Perjantai;3;1;4;2;1;3
294;21.09.2018;2018;09;07;Perjantai;10;8;18;5;6;11
294;21.09.2018;2018;09;08;Perjantai;3;11;14;3;4;7
294;21.09.2018;2018;09;09;Perjantai;15;7;22;3;5;8
294;21.09.2018;2018;09;10;Perjantai;11;15;26;11;9;20
294;21.09.2018;2018;09;11;Perjantai;13;11;24;5;3;8
294;21.09.2018;2018;09;12;Perjantai;11;20;31;6;8;14
294;21.09.2018;2018;09;13;Perjantai;21;22;43;17;12;29
294;21.09.2018;2018;09;14;Perjantai;17;26;43;15;16;31
294;21.09.2018;2018;09;15;Perjantai;11;13;24;10;4;14
294;21.09.2018;2018;09;16;Perjantai;19;13;32;11;7;18
294;21.09.2018;2018;09;17;Perjantai;12;14;26;4;5;9
294;21.09.2018;2018;09;18;Perjantai;15;20;35;20;11;31
294;21.09.2018;2018;09;19;Perjantai;10;16;26;6;14;20
294;21.09.2018;2018;09;20;Perjantai;6;2;8;7;1;8
294;21.09.2018;2018;09;21;Perjantai;4;1;5;3;0;3
294;21.09.2018;2018;09;22;Perjantai;1;3;4;1;0;1
294;21.09.2018;2018;09;23;Perjantai;3;1;4;1;0;1
294;22.09.2018;2018;09;00;Lauantai;0;6;6;2;1;3
294;22.09.2018;2018;09;01;Lauantai;0;0;0;0;0;0
294;22.09.2018;2018;09;02;Lauantai;0;0;0;0;0;0
294;22.09.2018;2018;09;03;Lauantai;0;0;0;0;0;0
294;22.09.2018;2018;09;04;Lauantai;0;0;0;0;0;0
294;22.09.2018;2018;09;05;Lauantai;0;1;1;0;0;0
294;22.09.2018;2018;09;06;Lauantai;0;1;1;0;0;0
294;22.09.2018;2018;09;07;Lauantai;0;1;1;2;1;3
294;22.09.2018;2018;09;08;Lauantai;1;2;3;1;3;4
294;22.09.2018;2018;09;09;Lauantai;3;3;6;3;3;6
294;22.09.2018;2018;09;10;Lauantai;1;3;4;2;0;2
294;22.09.2018;2018;09;11;Lauantai;13;9;22;1;4;5
294;22.09.2018;2018;09;12;Lauantai;9;10;19;7;4;11
294;22.09.2018;2018;09;13;Lauantai;12;14;26;6;9;15
294;22.09.2018;2018;09;14;Lauantai;9;15;24;6;4;10
294;22.09.2018;2018;09;15;Lauantai;13;11;24;12;10;22
294;22.09.2018;2018;09;16;Lauantai;14;13;27;10;4;14
294;22.09.2018;2018;09;17;Lauantai;10;28;38;17;9;26
294;22.09.2018;2018;09;18;Lauantai;14;5;19;5;4;9
294;22.09.2018;2018;09;19;Lauantai;7;4;11;13;12;25
294;22.09.2018;2018;09;20;Lauantai;8;11;19;2;0;2
294;22.09.2018;2018;09;21;Lauantai;2;0;2;0;1;1
294;22.09.2018;2018;09;22;Lauantai;6;1;7;0;1;1
294;22.09.2018;2018;09;23;Lauantai;2;1;3;1;0;1
294;23.09.2018;2018;09;00;Sunnuntai;2;0;2;1;0;1
294;23.09.2018;2018;09;01;Sunnuntai;0;0;0;0;0;0
294;23.09.2018;2018;09;02;Sunnuntai;1;0;1;1;0;1
294;23.09.2018;2018;09;03;Sunnuntai;0;0;0;0;0;0
294;23.09.2018;2018;09;04;Sunnuntai;0;0;0;0;0;0
294;23.09.2018;2018;09;05;Sunnuntai;0;0;0;0;0;0
294;23.09.2018;2018;09;06;Sunnuntai;1;0;1;0;0;0
294;23.09.2018;2018;09;07;Sunnuntai;1;0;1;0;0;0
294;23.09.2018;2018;09;08;Sunnuntai;0;0;0;2;0;2
294;23.09.2018;2018;09;09;Sunnuntai;8;4;12;6;9;15
294;23.09.2018;2018;09;10;Sunnuntai;3;2;5;9;5;14
294;23.09.2018;2018;09;11;Sunnuntai;5;5;10;3;5;8
294;23.09.2018;2018;09;12;Sunnuntai;5;9;14;6;5;11
294;23.09.2018;2018;09;13;Sunnuntai;17;9;26;4;11;15
294;23.09.2018;2018;09;14;Sunnuntai;12;17;29;7;3;10
294;23.09.2018;2018;09;15;Sunnuntai;14;14;28;4;4;8
294;23.09.2018;2018;09;16;Sunnuntai;14;8;22;6;6;12
294;23.09.2018;2018;09;17;Sunnuntai;4;10;14;7;2;9
294;23.09.2018;2018;09;18;Sunnuntai;10;7;17;10;14;24
294;23.09.2018;2018;09;19;Sunnuntai;5;10;15;9;9;18
294;23.09.2018;2018;09;20;Sunnuntai;4;11;15;5;1;6
294;23.09.2018;2018;09;21;Sunnuntai;3;1;4;1;1;2
294;23.09.2018;2018;09;22;Sunnuntai;0;0;0;0;0;0
294;23.09.2018;2018;09;23;Sunnuntai;0;0;0;1;0;1
294;24.09.2018;2018;09;00;Maanantai;0;0;0;0;0;0
294;24.09.2018;2018;09;01;Maanantai;1;0;1;0;0;0
294;24.09.2018;2018;09;02;Maanantai;0;0;0;0;0;0
294;24.09.2018;2018;09;03;Maanantai;0;0;0;0;0;0
294;24.09.2018;2018;09;04;Maanantai;0;0;0;0;0;0
294;24.09.2018;2018;09;05;Maanantai;0;1;1;0;0;0
294;24.09.2018;2018;09;06;Maanantai;4;1;5;2;2;4
294;24.09.2018;2018;09;07;Maanantai;5;5;10;1;5;6
294;24.09.2018;2018;09;08;Maanantai;10;10;20;6;4;10
294;24.09.2018;2018;09;09;Maanantai;23;8;31;12;3;15
294;24.09.2018;2018;09;10;Maanantai;11;13;24;7;6;13
294;24.09.2018;2018;09;11;Maanantai;6;22;28;12;13;25
294;24.09.2018;2018;09;12;Maanantai;12;14;26;13;14;27
294;24.09.2018;2018;09;13;Maanantai;8;18;26;4;12;16
294;24.09.2018;2018;09;14;Maanantai;13;13;26;19;6;25
294;24.09.2018;2018;09;15;Maanantai;7;15;22;6;9;15
294;24.09.2018;2018;09;16;Maanantai;14;15;29;9;5;14
294;24.09.2018;2018;09;17;Maanantai;9;11;20;6;11;17
294;24.09.2018;2018;09;18;Maanantai;5;11;16;9;10;19
294;24.09.2018;2018;09;19;Maanantai;9;14;23;2;10;12
294;24.09.2018;2018;09;20;Maanantai;11;6;17;2;3;5
294;24.09.2018;2018;09;21;Maanantai;0;0;0;0;0;0
294;24.09.2018;2018;09;22;Maanantai;0;1;1;0;0;0
294;24.09.2018;2018;09;23;Maanantai;0;0;0;0;0;0
294;25.09.2018;2018;09;00;Tiistai;0;0;0;0;0;0
294;25.09.2018;2018;09;01;Tiistai;0;0;0;0;0;0
294;25.09.2018;2018;09;02;Tiistai;0;0;0;0;0;0
294;25.09.2018;2018;09;03;Tiistai;0;0;0;0;0;0
294;25.09.2018;2018;09;04;Tiistai;0;0;0;0;0;0
294;25.09.2018;2018;09;05;Tiistai;1;0;1;1;0;1
294;25.09.2018;2018;09;06;Tiistai;4;0;4;4;0;4
294;25.09.2018;2018;09;07;Tiistai;14;0;14;5;0;5
294;25.09.2018;2018;09;08;Tiistai;22;0;22;8;0;8
294;25.09.2018;2018;09;09;Tiistai;19;0;19;13;0;13
294;25.09.2018;2018;09;10;Tiistai;12;0;12;14;0;14
294;25.09.2018;2018;09;11;Tiistai;14;0;14;15;0;15
294;25.09.2018;2018;09;12;Tiistai;15;0;15;18;0;18
294;25.09.2018;2018;09;13;Tiistai;21;0;21;26;0;26
294;25.09.2018;2018;09;14;Tiistai;34;0;34;19;0;19
294;25.09.2018;2018;09;15;Tiistai;37;0;37;19;0;19
294;25.09.2018;2018;09;16;Tiistai;29;0;29;14;0;14
294;25.09.2018;2018;09;17;Tiistai;23;0;23;17;0;17
294;25.09.2018;2018;09;18;Tiistai;33;0;33;34;0;34
294;25.09.2018;2018;09;19;Tiistai;20;0;20;21;0;21
294;25.09.2018;2018;09;20;Tiistai;18;0;18;6;0;6
294;25.09.2018;2018;09;21;Tiistai;4;0;4;1;0;1
294;25.09.2018;2018;09;22;Tiistai;1;0;1;0;0;0
294;25.09.2018;2018;09;23;Tiistai;0;0;0;0;0;0
294;26.09.2018;2018;09;00;Keskiviikko;0;0;0;0;0;0
294;26.09.2018;2018;09;01;Keskiviikko;0;0;0;0;0;0
294;26.09.2018;2018;09;02;Keskiviikko;0;0;0;0;0;0
294;26.09.2018;2018;09;03;Keskiviikko;0;0;0;0;0;0
294;26.09.2018;2018;09;04;Keskiviikko;0;0;0;0;0;0
294;26.09.2018;2018;09;05;Keskiviikko;0;1;1;0;0;0
294;26.09.2018;2018;09;06;Keskiviikko;2;1;3;0;0;0
294;26.09.2018;2018;09;07;Keskiviikko;21;6;27;4;7;11
294;26.09.2018;2018;09;08;Keskiviikko;18;6;24;7;4;11
294;26.09.2018;2018;09;09;Keskiviikko;5;1;6;3;3;6
294;26.09.2018;2018;09;10;Keskiviikko;2;2;4;2;3;5
294;26.09.2018;2018;09;11;Keskiviikko;5;7;12;5;6;11
294;26.09.2018;2018;09;12;Keskiviikko;4;7;11;5;7;12
294;26.09.2018;2018;09;13;Keskiviikko;5;12;17;5;6;11
294;26.09.2018;2018;09;14;Keskiviikko;6;3;9;8;2;10
294;26.09.2018;2018;09;15;Keskiviikko;7;6;13;3;2;5
294;26.09.2018;2018;09;16;Keskiviikko;8;7;15;4;0;4
294;26.09.2018;2018;09;17;Keskiviikko;7;3;10;3;2;5
294;26.09.2018;2018;09;18;Keskiviikko;4;4;8;10;6;16
294;26.09.2018;2018;09;19;Keskiviikko;7;11;18;8;4;12
294;26.09.2018;2018;09;20;Keskiviikko;7;2;9;5;2;7
294;26.09.2018;2018;09;21;Keskiviikko;3;0;3;3;2;5
294;26.09.2018;2018;09;22;Keskiviikko;1;0;1;0;0;0
294;26.09.2018;2018;09;23;Keskiviikko;0;0;0;0;0;0
294;27.09.2018;2018;09;00;Torstai;0;0;0;0;0;0
294;27.09.2018;2018;09;01;Torstai;0;0;0;0;0;0
294;27.09.2018;2018;09;02;Torstai;0;0;0;0;0;0
294;27.09.2018;2018;09;03;Torstai;0;0;0;0;0;0
294;27.09.2018;2018;09;04;Torstai;0;0;0;0;0;0
294;27.09.2018;2018;09;05;Torstai;0;1;1;0;0;0
294;27.09.2018;2018;09;06;Torstai;1;3;4;1;0;1
294;27.09.2018;2018;09;07;Torstai;12;12;24;1;2;3
294;27.09.2018;2018;09;08;Torstai;10;8;18;6;3;9
294;27.09.2018;2018;09;09;Torstai;9;5;14;6;4;10
294;27.09.2018;2018;09;10;Torstai;4;4;8;3;6;9
294;27.09.2018;2018;09;11;Torstai;9;7;16;14;4;18
294;27.09.2018;2018;09;12;Torstai;2;5;7;5;8;13
294;27.09.2018;2018;09;13;Torstai;5;15;20;6;9;15
294;27.09.2018;2018;09;14;Torstai;12;11;23;17;7;24
294;27.09.2018;2018;09;15;Torstai;10;10;20;8;10;18
294;27.09.2018;2018;09;16;Torstai;10;13;23;5;9;14
294;27.09.2018;2018;09;17;Torstai;7;8;15;7;8;15
294;27.09.2018;2018;09;18;Torstai;2;16;18;15;10;25
294;27.09.2018;2018;09;19;Torstai;15;10;25;7;13;20
294;27.09.2018;2018;09;20;Torstai;5;4;9;7;6;13
294;27.09.2018;2018;09;21;Torstai;2;4;6;2;3;5
294;27.09.2018;2018;09;22;Torstai;1;1;2;0;0;0
294;27.09.2018;2018;09;23;Torstai;0;0;0;0;0;0
294;28.09.2018;2018;09;00;Perjantai;0;0;0;0;0;0
294;28.09.2018;2018;09;01;Perjantai;0;0;0;0;0;0
294;28.09.2018;2018;09;02;Perjantai;0;0;0;0;0;0
294;28.09.2018;2018;09;03;Perjantai;0;0;0;0;0;0
294;28.09.2018;2018;09;04;Perjantai;0;0;0;1;0;1
294;28.09.2018;2018;09;05;Perjantai;0;1;1;0;1;1
294;28.09.2018;2018;09;06;Perjantai;2;2;4;2;2;4
294;28.09.2018;2018;09;07;Perjantai;7;8;15;3;1;4
294;28.09.2018;2018;09;08;Perjantai;11;8;19;9;6;15
294;28.09.2018;2018;09;09;Perjantai;14;8;22;8;5;13
294;28.09.2018;2018;09;10;Perjantai;8;7;15;9;20;29
294;28.09.2018;2018;09;11;Perjantai;9;7;16;4;10;14
294;28.09.2018;2018;09;12;Perjantai;19;25;44;12;10;22
294;28.09.2018;2018;09;13;Perjantai;23;25;48;14;17;31
294;28.09.2018;2018;09;14;Perjantai;8;10;18;11;19;30
294;28.09.2018;2018;09;15;Perjantai;10;15;25;7;6;13
294;28.09.2018;2018;09;16;Perjantai;10;14;24;11;9;20
294;28.09.2018;2018;09;17;Perjantai;15;25;40;8;11;19
294;28.09.2018;2018;09;18;Perjantai;12;2;14;9;7;16
294;28.09.2018;2018;09;19;Perjantai;4;11;15;12;7;19
294;28.09.2018;2018;09;20;Perjantai;8;0;8;3;4;7
294;28.09.2018;2018;09;21;Perjantai;8;8;16;4;5;9
294;28.09.2018;2018;09;22;Perjantai;3;1;4;2;0;2
294;28.09.2018;2018;09;23;Perjantai;1;0;1;1;0;1
294;29.09.2018;2018;09;00;Lauantai;0;0;0;1;3;4
294;29.09.2018;2018;09;01;Lauantai;0;0;0;0;0;0
294;29.09.2018;2018;09;02;Lauantai;0;0;0;0;1;1
294;29.09.2018;2018;09;03;Lauantai;0;0;0;0;0;0
294;29.09.2018;2018;09;04;Lauantai;0;0;0;0;0;0
294;29.09.2018;2018;09;05;Lauantai;0;0;0;0;0;0
294;29.09.2018;2018;09;06;Lauantai;0;1;1;1;1;2
294;29.09.2018;2018;09;07;Lauantai;1;1;2;0;3;3
294;29.09.2018;2018;09;08;Lauantai;2;1;3;6;1;7
294;29.09.2018;2018;09;09;Lauantai;1;1;2;4;5;9
294;29.09.2018;2018;09;10;Lauantai;7;6;13;8;7;15
294;29.09.2018;2018;09;11;Lauantai;8;10;18;5;5;10
294;29.09.2018;2018;09;12;Lauantai;16;13;29;16;12;28
294;29.09.2018;2018;09;13;Lauantai;16;3;19;10;9;19
294;29.09.2018;2018;09;14;Lauantai;8;17;25;10;12;22
294;29.09.2018;2018;09;15;Lauantai;20;24;44;16;6;22
294;29.09.2018;2018;09;16;Lauantai;9;9;18;10;7;17
294;29.09.2018;2018;09;17;Lauantai;10;10;20;5;3;8
294;29.09.2018;2018;09;18;Lauantai;6;15;21;2;6;8
294;29.09.2018;2018;09;19;Lauantai;8;3;11;7;2;9
294;29.09.2018;2018;09;20;Lauantai;15;5;20;3;5;8
294;29.09.2018;2018;09;21;Lauantai;5;0;5;0;0;0
294;29.09.2018;2018;09;22;Lauantai;3;1;4;4;0;4
294;29.09.2018;2018;09;23;Lauantai;2;0;2;0;0;0
294;30.09.2018;2018;09;00;Sunnuntai;0;3;3;1;0;1
294;30.09.2018;2018;09;01;Sunnuntai;0;0;0;0;0;0
294;30.09.2018;2018;09;02;Sunnuntai;0;0;0;0;0;0
294;30.09.2018;2018;09;03;Sunnuntai;1;1;2;0;0;0
294;30.09.2018;2018;09;04;Sunnuntai;0;0;0;0;0;0
294;30.09.2018;2018;09;05;Sunnuntai;0;0;0;0;0;0
294;30.09.2018;2018;09;06;Sunnuntai;0;0;0;1;0;1
294;30.09.2018;2018;09;07;Sunnuntai;1;0;1;1;0;1
294;30.09.2018;2018;09;08;Sunnuntai;1;0;1;3;3;6
294;30.09.2018;2018;09;09;Sunnuntai;4;2;6;6;5;11
294;30.09.2018;2018;09;10;Sunnuntai;1;2;3;7;3;10
294;30.09.2018;2018;09;11;Sunnuntai;4;8;12;4;5;9
294;30.09.2018;2018;09;12;Sunnuntai;8;8;16;12;6;18
294;30.09.2018;2018;09;13;Sunnuntai;2;7;9;8;6;14
294;30.09.2018;2018;09;14;Sunnuntai;9;5;14;4;8;12
294;30.09.2018;2018;09;15;Sunnuntai;11;11;22;5;7;12
294;30.09.2018;2018;09;16;Sunnuntai;8;7;15;9;3;12
294;30.09.2018;2018;09;17;Sunnuntai;14;13;27;2;5;7
294;30.09.2018;2018;09;18;Sunnuntai;10;10;20;5;6;11
294;30.09.2018;2018;09;19;Sunnuntai;6;11;17;8;6;14
294;30.09.2018;2018;09;20;Sunnuntai;4;3;7;3;4;7
294;30.09.2018;2018;09;21;Sunnuntai;0;1;1;0;0;0
294;30.09.2018;2018;09;22;Sunnuntai;1;0;1;0;0;0
294;30.09.2018;2018;09;23;Sunnuntai;2;0;2;0;0;0