MittausID;Pvm;Vuosi;Kuukausi;Tunti;Viikonpäivä;PP_1;PP_2;PP_YHT
626;02.01.2017;2017;01;00;Maanantai;0;0;0
626;02.01.2017;2017;01;01;Maanantai;0;0;0
626;02.01.2017;2017;01;02;Maanantai;1;0;1
626;02.01.2017;2017;01;03;Maanantai;0;0;0
626;02.01.2017;2017;01;04;Maanantai;0;0;0
626;02.01.2017;2017;01;05;Maanantai;0;1;1
626;02.01.2017;2017;01;06;Maanantai;1;4;5
626;02.01.2017;2017;01;07;Maanantai;1;9;10
626;02.01.2017;2017;01;08;Maanantai;7;14;21
626;02.01.2017;2017;01;09;Maanantai;2;19;21
626;02.01.2017;2017;01;10;Maanantai;1;2;3
626;02.01.2017;2017;01;11;Maanantai;3;3;6
626;02.01.2017;2017;01;12;Maanantai;1;1;2
626;02.01.2017;2017;01;13;Maanantai;3;1;4
626;02.01.2017;2017;01;14;Maanantai;1;4;5
626;02.01.2017;2017;01;15;Maanantai;9;4;13
626;02.01.2017;2017;01;16;Maanantai;17;2;19
626;02.01.2017;2017;01;17;Maanantai;15;10;25
626;02.01.2017;2017;01;18;Maanantai;12;4;16
626;02.01.2017;2017;01;19;Maanantai;5;5;10
626;02.01.2017;2017;01;20;Maanantai;0;1;1
626;02.01.2017;2017;01;21;Maanantai;4;2;6
626;02.01.2017;2017;01;22;Maanantai;5;2;7
626;02.01.2017;2017;01;23;Maanantai;0;1;1
626;03.01.2017;2017;01;00;Tiistai;0;0;0
626;03.01.2017;2017;01;01;Tiistai;0;0;0
626;03.01.2017;2017;01;02;Tiistai;1;0;1
626;03.01.2017;2017;01;03;Tiistai;0;0;0
626;03.01.2017;2017;01;04;Tiistai;0;0;0
626;03.01.2017;2017;01;05;Tiistai;1;3;4
626;03.01.2017;2017;01;06;Tiistai;0;3;3
626;03.01.2017;2017;01;07;Tiistai;2;9;11
626;03.01.2017;2017;01;08;Tiistai;5;9;14
626;03.01.2017;2017;01;09;Tiistai;3;14;17
626;03.01.2017;2017;01;10;Tiistai;0;3;3
626;03.01.2017;2017;01;11;Tiistai;2;4;6
626;03.01.2017;2017;01;12;Tiistai;2;3;5
626;03.01.2017;2017;01;13;Tiistai;2;2;4
626;03.01.2017;2017;01;14;Tiistai;4;3;7
626;03.01.2017;2017;01;15;Tiistai;6;2;8
626;03.01.2017;2017;01;16;Tiistai;9;3;12
626;03.01.2017;2017;01;17;Tiistai;12;9;21
626;03.01.2017;2017;01;18;Tiistai;9;7;16
626;03.01.2017;2017;01;19;Tiistai;8;3;11
626;03.01.2017;2017;01;20;Tiistai;4;2;6
626;03.01.2017;2017;01;21;Tiistai;3;1;4
626;03.01.2017;2017;01;22;Tiistai;2;1;3
626;03.01.2017;2017;01;23;Tiistai;0;0;0
626;04.01.2017;2017;01;00;Keskiviikko;0;0;0
626;04.01.2017;2017;01;01;Keskiviikko;0;0;0
626;04.01.2017;2017;01;02;Keskiviikko;0;0;0
626;04.01.2017;2017;01;03;Keskiviikko;0;0;0
626;04.01.2017;2017;01;04;Keskiviikko;0;0;0
626;04.01.2017;2017;01;05;Keskiviikko;0;1;1
626;04.01.2017;2017;01;06;Keskiviikko;0;2;2
626;04.01.2017;2017;01;07;Keskiviikko;2;6;8
626;04.01.2017;2017;01;08;Keskiviikko;6;8;14
626;04.01.2017;2017;01;09;Keskiviikko;0;10;10
626;04.01.2017;2017;01;10;Keskiviikko;0;1;1
626;04.01.2017;2017;01;11;Keskiviikko;1;0;1
626;04.01.2017;2017;01;12;Keskiviikko;1;1;2
626;04.01.2017;2017;01;13;Keskiviikko;1;1;2
626;04.01.2017;2017;01;14;Keskiviikko;1;2;3
626;04.01.2017;2017;01;15;Keskiviikko;4;4;8
626;04.01.2017;2017;01;16;Keskiviikko;4;2;6
626;04.01.2017;2017;01;17;Keskiviikko;11;5;16
626;04.01.2017;2017;01;18;Keskiviikko;6;0;6
626;04.01.2017;2017;01;19;Keskiviikko;4;0;4
626;04.01.2017;2017;01;20;Keskiviikko;1;1;2
626;04.01.2017;2017;01;21;Keskiviikko;2;1;3
626;04.01.2017;2017;01;22;Keskiviikko;0;0;0
626;04.01.2017;2017;01;23;Keskiviikko;0;0;0
626;05.01.2017;2017;01;00;Torstai;0;0;0
626;05.01.2017;2017;01;01;Torstai;0;0;0
626;05.01.2017;2017;01;02;Torstai;0;0;0
626;05.01.2017;2017;01;03;Torstai;0;1;1
626;05.01.2017;2017;01;04;Torstai;0;0;0
626;05.01.2017;2017;01;05;Torstai;0;1;1
626;05.01.2017;2017;01;06;Torstai;1;1;2
626;05.01.2017;2017;01;07;Torstai;1;4;5
626;05.01.2017;2017;01;08;Torstai;2;8;10
626;05.01.2017;2017;01;09;Torstai;0;4;4
626;05.01.2017;2017;01;10;Torstai;2;0;2
626;05.01.2017;2017;01;11;Torstai;0;0;0
626;05.01.2017;2017;01;12;Torstai;1;0;1
626;05.01.2017;2017;01;13;Torstai;1;2;3
626;05.01.2017;2017;01;14;Torstai;0;0;0
626;05.01.2017;2017;01;15;Torstai;5;0;5
626;05.01.2017;2017;01;16;Torstai;1;1;2
626;05.01.2017;2017;01;17;Torstai;9;3;12
626;05.01.2017;2017;01;18;Torstai;3;0;3
626;05.01.2017;2017;01;19;Torstai;3;0;3
626;05.01.2017;2017;01;20;Torstai;1;0;1
626;05.01.2017;2017;01;21;Torstai;0;0;0
626;05.01.2017;2017;01;22;Torstai;1;1;2
626;05.01.2017;2017;01;23;Torstai;0;1;1
626;06.01.2017;2017;01;00;Perjantai;0;0;0
626;06.01.2017;2017;01;01;Perjantai;0;0;0
626;06.01.2017;2017;01;02;Perjantai;0;0;0
626;06.01.2017;2017;01;03;Perjantai;0;0;0
626;06.01.2017;2017;01;04;Perjantai;0;1;1
626;06.01.2017;2017;01;05;Perjantai;0;0;0
626;06.01.2017;2017;01;06;Perjantai;0;2;2
626;06.01.2017;2017;01;07;Perjantai;0;0;0
626;06.01.2017;2017;01;08;Perjantai;0;2;2
626;06.01.2017;2017;01;09;Perjantai;0;0;0
626;06.01.2017;2017;01;10;Perjantai;3;1;4
626;06.01.2017;2017;01;11;Perjantai;1;0;1
626;06.01.2017;2017;01;12;Perjantai;0;0;0
626;06.01.2017;2017;01;13;Perjantai;0;1;1
626;06.01.2017;2017;01;14;Perjantai;3;1;4
626;06.01.2017;2017;01;15;Perjantai;0;3;3
626;06.01.2017;2017;01;16;Perjantai;1;0;1
626;06.01.2017;2017;01;17;Perjantai;1;0;1
626;06.01.2017;2017;01;18;Perjantai;2;1;3
626;06.01.2017;2017;01;19;Perjantai;0;0;0
626;06.01.2017;2017;01;20;Perjantai;0;0;0
626;06.01.2017;2017;01;21;Perjantai;0;1;1
626;06.01.2017;2017;01;22;Perjantai;1;1;2
626;06.01.2017;2017;01;23;Perjantai;1;0;1
626;07.01.2017;2017;01;00;Lauantai;0;0;0
626;07.01.2017;2017;01;01;Lauantai;0;0;0
626;07.01.2017;2017;01;02;Lauantai;0;0;0
626;07.01.2017;2017;01;03;Lauantai;0;0;0
626;07.01.2017;2017;01;04;Lauantai;0;0;0
626;07.01.2017;2017;01;05;Lauantai;0;1;1
626;07.01.2017;2017;01;06;Lauantai;0;1;1
626;07.01.2017;2017;01;07;Lauantai;0;0;0
626;07.01.2017;2017;01;08;Lauantai;0;1;1
626;07.01.2017;2017;01;09;Lauantai;0;0;0
626;07.01.2017;2017;01;10;Lauantai;3;0;3
626;07.01.2017;2017;01;11;Lauantai;1;5;6
626;07.01.2017;2017;01;12;Lauantai;5;4;9
626;07.01.2017;2017;01;13;Lauantai;7;6;13
626;07.01.2017;2017;01;14;Lauantai;5;7;12
626;07.01.2017;2017;01;15;Lauantai;6;3;9
626;07.01.2017;2017;01;16;Lauantai;7;2;9
626;07.01.2017;2017;01;17;Lauantai;0;5;5
626;07.01.2017;2017;01;18;Lauantai;4;1;5
626;07.01.2017;2017;01;19;Lauantai;1;3;4
626;07.01.2017;2017;01;20;Lauantai;1;0;1
626;07.01.2017;2017;01;21;Lauantai;0;0;0
626;07.01.2017;2017;01;22;Lauantai;1;5;6
626;07.01.2017;2017;01;23;Lauantai;2;0;2
626;08.01.2017;2017;01;00;Sunnuntai;0;0;0
626;08.01.2017;2017;01;01;Sunnuntai;0;0;0
626;08.01.2017;2017;01;02;Sunnuntai;0;0;0
626;08.01.2017;2017;01;03;Sunnuntai;1;0;1
626;08.01.2017;2017;01;04;Sunnuntai;0;0;0
626;08.01.2017;2017;01;05;Sunnuntai;0;1;1
626;08.01.2017;2017;01;06;Sunnuntai;0;0;0
626;08.01.2017;2017;01;07;Sunnuntai;0;1;1
626;08.01.2017;2017;01;08;Sunnuntai;2;2;4
626;08.01.2017;2017;01;09;Sunnuntai;1;0;1
626;08.01.2017;2017;01;10;Sunnuntai;1;3;4
626;08.01.2017;2017;01;11;Sunnuntai;2;1;3
626;08.01.2017;2017;01;12;Sunnuntai;0;3;3
626;08.01.2017;2017;01;13;Sunnuntai;3;3;6
626;08.01.2017;2017;01;14;Sunnuntai;7;7;14
626;08.01.2017;2017;01;15;Sunnuntai;4;4;8
626;08.01.2017;2017;01;16;Sunnuntai;7;3;10
626;08.01.2017;2017;01;17;Sunnuntai;5;4;9
626;08.01.2017;2017;01;18;Sunnuntai;3;3;6
626;08.01.2017;2017;01;19;Sunnuntai;2;3;5
626;08.01.2017;2017;01;20;Sunnuntai;2;3;5
626;08.01.2017;2017;01;21;Sunnuntai;2;0;2
626;08.01.2017;2017;01;22;Sunnuntai;3;2;5
626;08.01.2017;2017;01;23;Sunnuntai;0;0;0
626;09.01.2017;2017;01;00;Maanantai;0;0;0
626;09.01.2017;2017;01;01;Maanantai;0;0;0
626;09.01.2017;2017;01;02;Maanantai;1;1;2
626;09.01.2017;2017;01;03;Maanantai;2;0;2
626;09.01.2017;2017;01;04;Maanantai;0;0;0
626;09.01.2017;2017;01;05;Maanantai;0;2;2
626;09.01.2017;2017;01;06;Maanantai;3;6;9
626;09.01.2017;2017;01;07;Maanantai;2;11;13
626;09.01.2017;2017;01;08;Maanantai;10;28;38
626;09.01.2017;2017;01;09;Maanantai;9;19;28
626;09.01.2017;2017;01;10;Maanantai;3;8;11
626;09.01.2017;2017;01;11;Maanantai;3;2;5
626;09.01.2017;2017;01;12;Maanantai;3;4;7
626;09.01.2017;2017;01;13;Maanantai;5;6;11
626;09.01.2017;2017;01;14;Maanantai;4;7;11
626;09.01.2017;2017;01;15;Maanantai;13;8;21
626;09.01.2017;2017;01;16;Maanantai;18;6;24
626;09.01.2017;2017;01;17;Maanantai;31;13;44
626;09.01.2017;2017;01;18;Maanantai;15;12;27
626;09.01.2017;2017;01;19;Maanantai;8;6;14
626;09.01.2017;2017;01;20;Maanantai;9;2;11
626;09.01.2017;2017;01;21;Maanantai;2;2;4
626;09.01.2017;2017;01;22;Maanantai;8;2;10
626;09.01.2017;2017;01;23;Maanantai;1;0;1
626;10.01.2017;2017;01;00;Tiistai;0;0;0
626;10.01.2017;2017;01;01;Tiistai;0;0;0
626;10.01.2017;2017;01;02;Tiistai;0;0;0
626;10.01.2017;2017;01;03;Tiistai;0;0;0
626;10.01.2017;2017;01;04;Tiistai;0;1;1
626;10.01.2017;2017;01;05;Tiistai;0;2;2
626;10.01.2017;2017;01;06;Tiistai;1;8;9
626;10.01.2017;2017;01;07;Tiistai;2;15;17
626;10.01.2017;2017;01;08;Tiistai;12;30;42
626;10.01.2017;2017;01;09;Tiistai;9;23;32
626;10.01.2017;2017;01;10;Tiistai;4;6;10
626;10.01.2017;2017;01;11;Tiistai;1;8;9
626;10.01.2017;2017;01;12;Tiistai;2;6;8
626;10.01.2017;2017;01;13;Tiistai;2;3;5
626;10.01.2017;2017;01;14;Tiistai;2;6;8
626;10.01.2017;2017;01;15;Tiistai;10;0;10
626;10.01.2017;2017;01;16;Tiistai;28;9;37
626;10.01.2017;2017;01;17;Tiistai;28;19;47
626;10.01.2017;2017;01;18;Tiistai;17;8;25
626;10.01.2017;2017;01;19;Tiistai;10;7;17
626;10.01.2017;2017;01;20;Tiistai;4;7;11
626;10.01.2017;2017;01;21;Tiistai;9;2;11
626;10.01.2017;2017;01;22;Tiistai;3;3;6
626;10.01.2017;2017;01;23;Tiistai;2;0;2
626;11.01.2017;2017;01;00;Keskiviikko;0;0;0
626;11.01.2017;2017;01;01;Keskiviikko;0;0;0
626;11.01.2017;2017;01;02;Keskiviikko;1;0;1
626;11.01.2017;2017;01;03;Keskiviikko;0;0;0
626;11.01.2017;2017;01;04;Keskiviikko;0;0;0
626;11.01.2017;2017;01;05;Keskiviikko;0;3;3
626;11.01.2017;2017;01;06;Keskiviikko;2;5;7
626;11.01.2017;2017;01;07;Keskiviikko;6;10;16
626;11.01.2017;2017;01;08;Keskiviikko;9;33;42
626;11.01.2017;2017;01;09;Keskiviikko;10;14;24
626;11.01.2017;2017;01;10;Keskiviikko;2;2;4
626;11.01.2017;2017;01;11;Keskiviikko;4;3;7
626;11.01.2017;2017;01;12;Keskiviikko;1;4;5
626;11.01.2017;2017;01;13;Keskiviikko;2;3;5
626;11.01.2017;2017;01;14;Keskiviikko;3;3;6
626;11.01.2017;2017;01;15;Keskiviikko;11;7;18
626;11.01.2017;2017;01;16;Keskiviikko;8;6;14
626;11.01.2017;2017;01;17;Keskiviikko;16;9;25
626;11.01.2017;2017;01;18;Keskiviikko;9;15;24
626;11.01.2017;2017;01;19;Keskiviikko;9;3;12
626;11.01.2017;2017;01;20;Keskiviikko;4;1;5
626;11.01.2017;2017;01;21;Keskiviikko;1;1;2
626;11.01.2017;2017;01;22;Keskiviikko;3;2;5
626;11.01.2017;2017;01;23;Keskiviikko;2;2;4
626;12.01.2017;2017;01;00;Torstai;0;0;0
626;12.01.2017;2017;01;01;Torstai;0;0;0
626;12.01.2017;2017;01;02;Torstai;0;0;0
626;12.01.2017;2017;01;03;Torstai;0;0;0
626;12.01.2017;2017;01;04;Torstai;0;0;0
626;12.01.2017;2017;01;05;Torstai;0;1;1
626;12.01.2017;2017;01;06;Torstai;3;6;9
626;12.01.2017;2017;01;07;Torstai;3;10;13
626;12.01.2017;2017;01;08;Torstai;6;22;28
626;12.01.2017;2017;01;09;Torstai;8;18;26
626;12.01.2017;2017;01;10;Torstai;2;4;6
626;12.01.2017;2017;01;11;Torstai;0;1;1
626;12.01.2017;2017;01;12;Torstai;3;2;5
626;12.01.2017;2017;01;13;Torstai;2;4;6
626;12.01.2017;2017;01;14;Torstai;1;3;4
626;12.01.2017;2017;01;15;Torstai;9;7;16
626;12.01.2017;2017;01;16;Torstai;10;13;23
626;12.01.2017;2017;01;17;Torstai;18;11;29
626;12.01.2017;2017;01;18;Torstai;10;6;16
626;12.01.2017;2017;01;19;Torstai;7;1;8
626;12.01.2017;2017;01;20;Torstai;3;3;6
626;12.01.2017;2017;01;21;Torstai;3;2;5
626;12.01.2017;2017;01;22;Torstai;3;1;4
626;12.01.2017;2017;01;23;Torstai;1;1;2
626;13.01.2017;2017;01;00;Perjantai;0;0;0
626;13.01.2017;2017;01;01;Perjantai;0;0;0
626;13.01.2017;2017;01;02;Perjantai;0;0;0
626;13.01.2017;2017;01;03;Perjantai;0;0;0
626;13.01.2017;2017;01;04;Perjantai;0;0;0
626;13.01.2017;2017;01;05;Perjantai;0;2;2
626;13.01.2017;2017;01;06;Perjantai;4;4;8
626;13.01.2017;2017;01;07;Perjantai;3;13;16
626;13.01.2017;2017;01;08;Perjantai;10;20;30
626;13.01.2017;2017;01;09;Perjantai;11;12;23
626;13.01.2017;2017;01;10;Perjantai;0;7;7
626;13.01.2017;2017;01;11;Perjantai;3;5;8
626;13.01.2017;2017;01;12;Perjantai;5;4;9
626;13.01.2017;2017;01;13;Perjantai;1;4;5
626;13.01.2017;2017;01;14;Perjantai;4;7;11
626;13.01.2017;2017;01;15;Perjantai;5;7;12
626;13.01.2017;2017;01;16;Perjantai;12;3;15
626;13.01.2017;2017;01;17;Perjantai;13;13;26
626;13.01.2017;2017;01;18;Perjantai;9;7;16
626;13.01.2017;2017;01;19;Perjantai;9;3;12
626;13.01.2017;2017;01;20;Perjantai;6;5;11
626;13.01.2017;2017;01;21;Perjantai;2;2;4
626;13.01.2017;2017;01;22;Perjantai;0;4;4
626;13.01.2017;2017;01;23;Perjantai;0;1;1
626;14.01.2017;2017;01;00;Lauantai;0;0;0
626;14.01.2017;2017;01;01;Lauantai;0;0;0
626;14.01.2017;2017;01;02;Lauantai;0;0;0
626;14.01.2017;2017;01;03;Lauantai;0;0;0
626;14.01.2017;2017;01;04;Lauantai;0;0;0
626;14.01.2017;2017;01;05;Lauantai;0;1;1
626;14.01.2017;2017;01;06;Lauantai;0;1;1
626;14.01.2017;2017;01;07;Lauantai;0;0;0
626;14.01.2017;2017;01;08;Lauantai;0;1;1
626;14.01.2017;2017;01;09;Lauantai;0;0;0
626;14.01.2017;2017;01;10;Lauantai;3;0;3
626;14.01.2017;2017;01;11;Lauantai;1;5;6
626;14.01.2017;2017;01;12;Lauantai;5;4;9
626;14.01.2017;2017;01;13;Lauantai;7;6;13
626;14.01.2017;2017;01;14;Lauantai;5;7;12
626;14.01.2017;2017;01;15;Lauantai;6;3;9
626;14.01.2017;2017;01;16;Lauantai;7;2;9
626;14.01.2017;2017;01;17;Lauantai;0;5;5
626;14.01.2017;2017;01;18;Lauantai;4;1;5
626;14.01.2017;2017;01;19;Lauantai;1;3;4
626;14.01.2017;2017;01;20;Lauantai;1;0;1
626;14.01.2017;2017;01;21;Lauantai;0;0;0
626;14.01.2017;2017;01;22;Lauantai;1;5;6
626;14.01.2017;2017;01;23;Lauantai;2;0;2
626;15.01.2017;2017;01;00;Sunnuntai;0;0;0
626;15.01.2017;2017;01;01;Sunnuntai;0;0;0
626;15.01.2017;2017;01;02;Sunnuntai;0;0;0
626;15.01.2017;2017;01;03;Sunnuntai;1;0;1
626;15.01.2017;2017;01;04;Sunnuntai;0;0;0
626;15.01.2017;2017;01;05;Sunnuntai;0;1;1
626;15.01.2017;2017;01;06;Sunnuntai;0;0;0
626;15.01.2017;2017;01;07;Sunnuntai;0;1;1
626;15.01.2017;2017;01;08;Sunnuntai;2;2;4
626;15.01.2017;2017;01;09;Sunnuntai;1;0;1
626;15.01.2017;2017;01;10;Sunnuntai;1;3;4
626;15.01.2017;2017;01;11;Sunnuntai;2;1;3
626;15.01.2017;2017;01;12;Sunnuntai;0;3;3
626;15.01.2017;2017;01;13;Sunnuntai;3;3;6
626;15.01.2017;2017;01;14;Sunnuntai;7;7;14
626;15.01.2017;2017;01;15;Sunnuntai;4;4;8
626;15.01.2017;2017;01;16;Sunnuntai;7;3;10
626;15.01.2017;2017;01;17;Sunnuntai;5;4;9
626;15.01.2017;2017;01;18;Sunnuntai;3;3;6
626;15.01.2017;2017;01;19;Sunnuntai;2;3;5
626;15.01.2017;2017;01;20;Sunnuntai;2;3;5
626;15.01.2017;2017;01;21;Sunnuntai;2;0;2
626;15.01.2017;2017;01;22;Sunnuntai;3;2;5
626;15.01.2017;2017;01;23;Sunnuntai;0;0;0
626;16.01.2017;2017;01;00;Maanantai;0;0;0
626;16.01.2017;2017;01;01;Maanantai;0;0;0
626;16.01.2017;2017;01;02;Maanantai;1;1;2
626;16.01.2017;2017;01;03;Maanantai;2;0;2
626;16.01.2017;2017;01;04;Maanantai;0;0;0
626;16.01.2017;2017;01;05;Maanantai;0;2;2
626;16.01.2017;2017;01;06;Maanantai;3;6;9
626;16.01.2017;2017;01;07;Maanantai;2;11;13
626;16.01.2017;2017;01;08;Maanantai;10;28;38
626;16.01.2017;2017;01;09;Maanantai;9;19;28
626;16.01.2017;2017;01;10;Maanantai;3;8;11
626;16.01.2017;2017;01;11;Maanantai;3;2;5
626;16.01.2017;2017;01;12;Maanantai;3;4;7
626;16.01.2017;2017;01;13;Maanantai;5;6;11
626;16.01.2017;2017;01;14;Maanantai;4;7;11
626;16.01.2017;2017;01;15;Maanantai;13;8;21
626;16.01.2017;2017;01;16;Maanantai;18;6;24
626;16.01.2017;2017;01;17;Maanantai;31;13;44
626;16.01.2017;2017;01;18;Maanantai;15;12;27
626;16.01.2017;2017;01;19;Maanantai;8;6;14
626;16.01.2017;2017;01;20;Maanantai;9;2;11
626;16.01.2017;2017;01;21;Maanantai;2;2;4
626;16.01.2017;2017;01;22;Maanantai;8;2;10
626;16.01.2017;2017;01;23;Maanantai;1;0;1
626;17.01.2017;2017;01;00;Tiistai;0;0;0
626;17.01.2017;2017;01;01;Tiistai;0;0;0
626;17.01.2017;2017;01;02;Tiistai;0;0;0
626;17.01.2017;2017;01;03;Tiistai;0;0;0
626;17.01.2017;2017;01;04;Tiistai;0;1;1
626;17.01.2017;2017;01;05;Tiistai;0;2;2
626;17.01.2017;2017;01;06;Tiistai;1;8;9
626;17.01.2017;2017;01;07;Tiistai;2;15;17
626;17.01.2017;2017;01;08;Tiistai;12;30;42
626;17.01.2017;2017;01;09;Tiistai;9;23;32
626;17.01.2017;2017;01;10;Tiistai;4;6;10
626;17.01.2017;2017;01;11;Tiistai;1;8;9
626;17.01.2017;2017;01;12;Tiistai;2;6;8
626;17.01.2017;2017;01;13;Tiistai;2;3;5
626;17.01.2017;2017;01;14;Tiistai;2;6;8
626;17.01.2017;2017;01;15;Tiistai;10;0;10
626;17.01.2017;2017;01;16;Tiistai;28;9;37
626;17.01.2017;2017;01;17;Tiistai;28;19;47
626;17.01.2017;2017;01;18;Tiistai;17;8;25
626;17.01.2017;2017;01;19;Tiistai;10;7;17
626;17.01.2017;2017;01;20;Tiistai;4;7;11
626;17.01.2017;2017;01;21;Tiistai;9;2;11
626;17.01.2017;2017;01;22;Tiistai;3;3;6
626;17.01.2017;2017;01;23;Tiistai;2;0;2
626;18.01.2017;2017;01;00;Keskiviikko;0;0;0
626;18.01.2017;2017;01;01;Keskiviikko;0;0;0
626;18.01.2017;2017;01;02;Keskiviikko;1;0;1
626;18.01.2017;2017;01;03;Keskiviikko;0;0;0
626;18.01.2017;2017;01;04;Keskiviikko;0;0;0
626;18.01.2017;2017;01;05;Keskiviikko;0;3;3
626;18.01.2017;2017;01;06;Keskiviikko;2;5;7
626;18.01.2017;2017;01;07;Keskiviikko;6;10;16
626;18.01.2017;2017;01;08;Keskiviikko;9;33;42
626;18.01.2017;2017;01;09;Keskiviikko;10;14;24
626;18.01.2017;2017;01;10;Keskiviikko;2;2;4
626;18.01.2017;2017;01;11;Keskiviikko;4;3;7
626;18.01.2017;2017;01;12;Keskiviikko;7;6;13
626;18.01.2017;2017;01;13;Keskiviikko;0;6;6
626;18.01.2017;2017;01;14;Keskiviikko;7;10;17
626;18.01.2017;2017;01;15;Keskiviikko;10;8;18
626;18.01.2017;2017;01;16;Keskiviikko;15;7;22
626;18.01.2017;2017;01;17;Keskiviikko;34;15;49
626;18.01.2017;2017;01;18;Keskiviikko;17;10;27
626;18.01.2017;2017;01;19;Keskiviikko;6;2;8
626;18.01.2017;2017;01;20;Keskiviikko;8;2;10
626;18.01.2017;2017;01;21;Keskiviikko;5;1;6
626;18.01.2017;2017;01;22;Keskiviikko;3;2;5
626;18.01.2017;2017;01;23;Keskiviikko;3;1;4
626;19.01.2017;2017;01;00;Torstai;0;0;0
626;19.01.2017;2017;01;01;Torstai;1;0;1
626;19.01.2017;2017;01;02;Torstai;0;0;0
626;19.01.2017;2017;01;03;Torstai;0;0;0
626;19.01.2017;2017;01;04;Torstai;0;0;0
626;19.01.2017;2017;01;05;Torstai;0;2;2
626;19.01.2017;2017;01;06;Torstai;4;8;12
626;19.01.2017;2017;01;07;Torstai;2;11;13
626;19.01.2017;2017;01;08;Torstai;9;26;35
626;19.01.2017;2017;01;09;Torstai;6;11;17
626;19.01.2017;2017;01;10;Torstai;2;5;7
626;19.01.2017;2017;01;11;Torstai;2;4;6
626;19.01.2017;2017;01;12;Torstai;1;4;5
626;19.01.2017;2017;01;13;Torstai;3;10;13
626;19.01.2017;2017;01;14;Torstai;3;8;11
626;19.01.2017;2017;01;15;Torstai;7;7;14
626;19.01.2017;2017;01;16;Torstai;8;5;13
626;19.01.2017;2017;01;17;Torstai;12;7;19
626;19.01.2017;2017;01;18;Torstai;9;2;11
626;19.01.2017;2017;01;19;Torstai;7;1;8
626;19.01.2017;2017;01;20;Torstai;3;2;5
626;19.01.2017;2017;01;21;Torstai;2;4;6
626;19.01.2017;2017;01;22;Torstai;3;0;3
626;19.01.2017;2017;01;23;Torstai;1;0;1
626;20.01.2017;2017;01;00;Perjantai;0;0;0
626;20.01.2017;2017;01;01;Perjantai;0;0;0
626;20.01.2017;2017;01;02;Perjantai;0;0;0
626;20.01.2017;2017;01;03;Perjantai;0;0;0
626;20.01.2017;2017;01;04;Perjantai;0;0;0
626;20.01.2017;2017;01;05;Perjantai;0;2;2
626;20.01.2017;2017;01;06;Perjantai;2;1;3
626;20.01.2017;2017;01;07;Perjantai;2;10;12
626;20.01.2017;2017;01;08;Perjantai;7;17;24
626;20.01.2017;2017;01;09;Perjantai;4;10;14
626;20.01.2017;2017;01;10;Perjantai;3;6;9
626;20.01.2017;2017;01;11;Perjantai;4;3;7
626;20.01.2017;2017;01;12;Perjantai;4;6;10
626;20.01.2017;2017;01;13;Perjantai;2;5;7
626;20.01.2017;2017;01;14;Perjantai;3;6;9
626;20.01.2017;2017;01;15;Perjantai;8;5;13
626;20.01.2017;2017;01;16;Perjantai;16;5;21
626;20.01.2017;2017;01;17;Perjantai;12;12;24
626;20.01.2017;2017;01;18;Perjantai;8;3;11
626;20.01.2017;2017;01;19;Perjantai;11;5;16
626;20.01.2017;2017;01;20;Perjantai;2;4;6
626;20.01.2017;2017;01;21;Perjantai;2;3;5
626;20.01.2017;2017;01;22;Perjantai;5;2;7
626;20.01.2017;2017;01;23;Perjantai;0;0;0
626;21.01.2017;2017;01;00;Lauantai;1;0;1
626;21.01.2017;2017;01;01;Lauantai;1;1;2
626;21.01.2017;2017;01;02;Lauantai;0;0;0
626;21.01.2017;2017;01;03;Lauantai;1;0;1
626;21.01.2017;2017;01;04;Lauantai;0;0;0
626;21.01.2017;2017;01;05;Lauantai;0;0;0
626;21.01.2017;2017;01;06;Lauantai;2;0;2
626;21.01.2017;2017;01;07;Lauantai;0;1;1
626;21.01.2017;2017;01;08;Lauantai;1;2;3
626;21.01.2017;2017;01;09;Lauantai;1;2;3
626;21.01.2017;2017;01;10;Lauantai;1;2;3
626;21.01.2017;2017;01;11;Lauantai;3;6;9
626;21.01.2017;2017;01;12;Lauantai;2;3;5
626;21.01.2017;2017;01;13;Lauantai;7;5;12
626;21.01.2017;2017;01;14;Lauantai;4;13;17
626;21.01.2017;2017;01;15;Lauantai;7;5;12
626;21.01.2017;2017;01;16;Lauantai;5;1;6
626;21.01.2017;2017;01;17;Lauantai;4;6;10
626;21.01.2017;2017;01;18;Lauantai;5;4;9
626;21.01.2017;2017;01;19;Lauantai;3;5;8
626;21.01.2017;2017;01;20;Lauantai;0;1;1
626;21.01.2017;2017;01;21;Lauantai;4;1;5
626;21.01.2017;2017;01;22;Lauantai;2;1;3
626;21.01.2017;2017;01;23;Lauantai;2;0;2
626;22.01.2017;2017;01;00;Sunnuntai;0;0;0
626;22.01.2017;2017;01;01;Sunnuntai;0;1;1
626;22.01.2017;2017;01;02;Sunnuntai;0;0;0
626;22.01.2017;2017;01;03;Sunnuntai;0;1;1
626;22.01.2017;2017;01;04;Sunnuntai;0;0;0
626;22.01.2017;2017;01;05;Sunnuntai;0;0;0
626;22.01.2017;2017;01;06;Sunnuntai;1;2;3
626;22.01.2017;2017;01;07;Sunnuntai;0;0;0
626;22.01.2017;2017;01;08;Sunnuntai;1;1;2
626;22.01.2017;2017;01;09;Sunnuntai;0;0;0
626;22.01.2017;2017;01;10;Sunnuntai;1;0;1
626;22.01.2017;2017;01;11;Sunnuntai;3;4;7
626;22.01.2017;2017;01;12;Sunnuntai;5;5;10
626;22.01.2017;2017;01;13;Sunnuntai;5;6;11
626;22.01.2017;2017;01;14;Sunnuntai;12;8;20
626;22.01.2017;2017;01;15;Sunnuntai;11;10;21
626;22.01.2017;2017;01;16;Sunnuntai;1;4;5
626;22.01.2017;2017;01;17;Sunnuntai;5;4;9
626;22.01.2017;2017;01;18;Sunnuntai;4;1;5
626;22.01.2017;2017;01;19;Sunnuntai;5;3;8
626;22.01.2017;2017;01;20;Sunnuntai;1;3;4
626;22.01.2017;2017;01;21;Sunnuntai;4;0;4
626;22.01.2017;2017;01;22;Sunnuntai;0;4;4
626;22.01.2017;2017;01;23;Sunnuntai;2;0;2
626;23.01.2017;2017;01;00;Maanantai;0;0;0
626;23.01.2017;2017;01;01;Maanantai;0;0;0
626;23.01.2017;2017;01;02;Maanantai;0;1;1
626;23.01.2017;2017;01;03;Maanantai;0;0;0
626;23.01.2017;2017;01;04;Maanantai;0;1;1
626;23.01.2017;2017;01;05;Maanantai;0;1;1
626;23.01.2017;2017;01;06;Maanantai;2;7;9
626;23.01.2017;2017;01;07;Maanantai;5;20;25
626;23.01.2017;2017;01;08;Maanantai;10;39;49
626;23.01.2017;2017;01;09;Maanantai;10;25;35
626;23.01.2017;2017;01;10;Maanantai;3;7;10
626;23.01.2017;2017;01;11;Maanantai;2;6;8
626;23.01.2017;2017;01;12;Maanantai;5;2;7
626;23.01.2017;2017;01;13;Maanantai;3;9;12
626;23.01.2017;2017;01;14;Maanantai;8;2;10
626;23.01.2017;2017;01;15;Maanantai;8;8;16
626;23.01.2017;2017;01;16;Maanantai;18;8;26
626;23.01.2017;2017;01;17;Maanantai;42;14;56
626;23.01.2017;2017;01;18;Maanantai;17;8;25
626;23.01.2017;2017;01;19;Maanantai;10;4;14
626;23.01.2017;2017;01;20;Maanantai;4;0;4
626;23.01.2017;2017;01;21;Maanantai;4;2;6
626;23.01.2017;2017;01;22;Maanantai;4;2;6
626;23.01.2017;2017;01;23;Maanantai;1;0;1
626;24.01.2017;2017;01;00;Tiistai;2;1;3
626;24.01.2017;2017;01;01;Tiistai;0;0;0
626;24.01.2017;2017;01;02;Tiistai;0;0;0
626;24.01.2017;2017;01;03;Tiistai;0;0;0
626;24.01.2017;2017;01;04;Tiistai;0;0;0
626;24.01.2017;2017;01;05;Tiistai;0;1;1
626;24.01.2017;2017;01;06;Tiistai;1;9;10
626;24.01.2017;2017;01;07;Tiistai;6;17;23
626;24.01.2017;2017;01;08;Tiistai;9;36;45
626;24.01.2017;2017;01;09;Tiistai;12;17;29
626;24.01.2017;2017;01;10;Tiistai;2;3;5
626;24.01.2017;2017;01;11;Tiistai;1;4;5
626;24.01.2017;2017;01;12;Tiistai;3;5;8
626;24.01.2017;2017;01;13;Tiistai;4;2;6
626;24.01.2017;2017;01;14;Tiistai;0;7;7
626;24.01.2017;2017;01;15;Tiistai;12;3;15
626;24.01.2017;2017;01;16;Tiistai;10;9;19
626;24.01.2017;2017;01;17;Tiistai;33;12;45
626;24.01.2017;2017;01;18;Tiistai;11;8;19
626;24.01.2017;2017;01;19;Tiistai;5;2;7
626;24.01.2017;2017;01;20;Tiistai;0;0;0
626;24.01.2017;2017;01;21;Tiistai;10;2;12
626;24.01.2017;2017;01;22;Tiistai;3;1;4
626;24.01.2017;2017;01;23;Tiistai;1;2;3
626;25.01.2017;2017;01;00;Keskiviikko;0;0;0
626;25.01.2017;2017;01;01;Keskiviikko;0;0;0
626;25.01.2017;2017;01;02;Keskiviikko;0;0;0
626;25.01.2017;2017;01;03;Keskiviikko;0;0;0
626;25.01.2017;2017;01;04;Keskiviikko;0;0;0
626;25.01.2017;2017;01;05;Keskiviikko;0;3;3
626;25.01.2017;2017;01;06;Keskiviikko;2;5;7
626;25.01.2017;2017;01;07;Keskiviikko;5;15;20
626;25.01.2017;2017;01;08;Keskiviikko;5;30;35
626;25.01.2017;2017;01;09;Keskiviikko;8;15;23
626;25.01.2017;2017;01;10;Keskiviikko;4;5;9
626;25.01.2017;2017;01;11;Keskiviikko;4;3;7
626;25.01.2017;2017;01;12;Keskiviikko;2;3;5
626;25.01.2017;2017;01;13;Keskiviikko;3;8;11
626;25.01.2017;2017;01;14;Keskiviikko;4;7;11
626;25.01.2017;2017;01;15;Keskiviikko;7;7;14
626;25.01.2017;2017;01;16;Keskiviikko;15;10;25
626;25.01.2017;2017;01;17;Keskiviikko;32;8;40
626;25.01.2017;2017;01;18;Keskiviikko;12;11;23
626;25.01.2017;2017;01;19;Keskiviikko;6;0;6
626;25.01.2017;2017;01;20;Keskiviikko;5;4;9
626;25.01.2017;2017;01;21;Keskiviikko;2;0;2
626;25.01.2017;2017;01;22;Keskiviikko;3;1;4
626;25.01.2017;2017;01;23;Keskiviikko;1;0;1
626;26.01.2017;2017;01;00;Torstai;0;0;0
626;26.01.2017;2017;01;01;Torstai;0;0;0
626;26.01.2017;2017;01;02;Torstai;0;0;0
626;26.01.2017;2017;01;03;Torstai;0;0;0
626;26.01.2017;2017;01;04;Torstai;1;1;2
626;26.01.2017;2017;01;05;Torstai;2;4;6
626;26.01.2017;2017;01;06;Torstai;4;5;9
626;26.01.2017;2017;01;07;Torstai;3;10;13
626;26.01.2017;2017;01;08;Torstai;8;26;34
626;26.01.2017;2017;01;09;Torstai;10;11;21
626;26.01.2017;2017;01;10;Torstai;5;11;16
626;26.01.2017;2017;01;11;Torstai;3;5;8
626;26.01.2017;2017;01;12;Torstai;8;3;11
626;26.01.2017;2017;01;13;Torstai;2;4;6
626;26.01.2017;2017;01;14;Torstai;2;8;10
626;26.01.2017;2017;01;15;Torstai;15;7;22
626;26.01.2017;2017;01;16;Torstai;11;14;25
626;26.01.2017;2017;01;17;Torstai;20;14;34
626;26.01.2017;2017;01;18;Torstai;11;9;20
626;26.01.2017;2017;01;19;Torstai;4;2;6
626;26.01.2017;2017;01;20;Torstai;4;5;9
626;26.01.2017;2017;01;21;Torstai;5;1;6
626;26.01.2017;2017;01;22;Torstai;2;1;3
626;26.01.2017;2017;01;23;Torstai;2;0;2
626;27.01.2017;2017;01;00;Perjantai;0;0;0
626;27.01.2017;2017;01;01;Perjantai;1;0;1
626;27.01.2017;2017;01;02;Perjantai;0;0;0
626;27.01.2017;2017;01;03;Perjantai;0;0;0
626;27.01.2017;2017;01;04;Perjantai;0;0;0
626;27.01.2017;2017;01;05;Perjantai;0;2;2
626;27.01.2017;2017;01;06;Perjantai;2;7;9
626;27.01.2017;2017;01;07;Perjantai;6;15;21
626;27.01.2017;2017;01;08;Perjantai;12;27;39
626;27.01.2017;2017;01;09;Perjantai;11;23;34
626;27.01.2017;2017;01;10;Perjantai;3;9;12
626;27.01.2017;2017;01;11;Perjantai;2;7;9
626;27.01.2017;2017;01;12;Perjantai;4;9;13
626;27.01.2017;2017;01;13;Perjantai;7;11;18
626;27.01.2017;2017;01;14;Perjantai;9;9;18
626;27.01.2017;2017;01;15;Perjantai;15;17;32
626;27.01.2017;2017;01;16;Perjantai;19;8;27
626;27.01.2017;2017;01;17;Perjantai;22;15;37
626;27.01.2017;2017;01;18;Perjantai;20;9;29
626;27.01.2017;2017;01;19;Perjantai;6;5;11
626;27.01.2017;2017;01;20;Perjantai;3;0;3
626;27.01.2017;2017;01;21;Perjantai;5;3;8
626;27.01.2017;2017;01;22;Perjantai;2;3;5
626;27.01.2017;2017;01;23;Perjantai;1;0;1
626;28.01.2017;2017;01;00;Lauantai;0;1;1
626;28.01.2017;2017;01;01;Lauantai;0;0;0
626;28.01.2017;2017;01;02;Lauantai;0;0;0
626;28.01.2017;2017;01;03;Lauantai;1;0;1
626;28.01.2017;2017;01;04;Lauantai;0;0;0
626;28.01.2017;2017;01;05;Lauantai;0;1;1
626;28.01.2017;2017;01;06;Lauantai;0;2;2
626;28.01.2017;2017;01;07;Lauantai;3;1;4
626;28.01.2017;2017;01;08;Lauantai;0;3;3
626;28.01.2017;2017;01;09;Lauantai;1;2;3
626;28.01.2017;2017;01;10;Lauantai;1;3;4
626;28.01.2017;2017;01;11;Lauantai;2;9;11
626;28.01.2017;2017;01;12;Lauantai;4;10;14
626;28.01.2017;2017;01;13;Lauantai;7;6;13
626;28.01.2017;2017;01;14;Lauantai;9;7;16
626;28.01.2017;2017;01;15;Lauantai;11;12;23
626;28.01.2017;2017;01;16;Lauantai;3;9;12
626;28.01.2017;2017;01;17;Lauantai;7;5;12
626;28.01.2017;2017;01;18;Lauantai;6;4;10
626;28.01.2017;2017;01;19;Lauantai;2;1;3
626;28.01.2017;2017;01;20;Lauantai;7;4;11
626;28.01.2017;2017;01;21;Lauantai;1;1;2
626;28.01.2017;2017;01;22;Lauantai;2;2;4
626;28.01.2017;2017;01;23;Lauantai;3;2;5
626;29.01.2017;2017;01;00;Sunnuntai;0;0;0
626;29.01.2017;2017;01;01;Sunnuntai;0;0;0
626;29.01.2017;2017;01;02;Sunnuntai;0;0;0
626;29.01.2017;2017;01;03;Sunnuntai;0;0;0
626;29.01.2017;2017;01;04;Sunnuntai;0;0;0
626;29.01.2017;2017;01;05;Sunnuntai;1;2;3
626;29.01.2017;2017;01;06;Sunnuntai;0;2;2
626;29.01.2017;2017;01;07;Sunnuntai;0;2;2
626;29.01.2017;2017;01;08;Sunnuntai;2;1;3
626;29.01.2017;2017;01;09;Sunnuntai;3;1;4
626;29.01.2017;2017;01;10;Sunnuntai;1;2;3
626;29.01.2017;2017;01;11;Sunnuntai;6;7;13
626;29.01.2017;2017;01;12;Sunnuntai;8;8;16
626;29.01.2017;2017;01;13;Sunnuntai;5;7;12
626;29.01.2017;2017;01;14;Sunnuntai;4;9;13
626;29.01.2017;2017;01;15;Sunnuntai;5;6;11
626;29.01.2017;2017;01;16;Sunnuntai;8;5;13
626;29.01.2017;2017;01;17;Sunnuntai;7;4;11
626;29.01.2017;2017;01;18;Sunnuntai;4;4;8
626;29.01.2017;2017;01;19;Sunnuntai;5;5;10
626;29.01.2017;2017;01;20;Sunnuntai;3;5;8
626;29.01.2017;2017;01;21;Sunnuntai;1;1;2
626;29.01.2017;2017;01;22;Sunnuntai;5;1;6
626;29.01.2017;2017;01;23;Sunnuntai;0;1;1
626;30.01.2017;2017;01;00;Maanantai;1;1;2
626;30.01.2017;2017;01;01;Maanantai;0;0;0
626;30.01.2017;2017;01;02;Maanantai;0;1;1
626;30.01.2017;2017;01;03;Maanantai;0;0;0
626;30.01.2017;2017;01;04;Maanantai;0;0;0
626;30.01.2017;2017;01;05;Maanantai;1;3;4
626;30.01.2017;2017;01;06;Maanantai;1;4;5
626;30.01.2017;2017;01;07;Maanantai;4;14;18
626;30.01.2017;2017;01;08;Maanantai;10;23;33
626;30.01.2017;2017;01;09;Maanantai;9;22;31
626;30.01.2017;2017;01;10;Maanantai;2;2;4
626;30.01.2017;2017;01;11;Maanantai;1;5;6
626;30.01.2017;2017;01;12;Maanantai;4;3;7
626;30.01.2017;2017;01;13;Maanantai;4;2;6
626;30.01.2017;2017;01;14;Maanantai;4;7;11
626;30.01.2017;2017;01;15;Maanantai;8;5;13
626;30.01.2017;2017;01;16;Maanantai;21;10;31
626;30.01.2017;2017;01;17;Maanantai;20;9;29
626;30.01.2017;2017;01;18;Maanantai;13;8;21
626;30.01.2017;2017;01;19;Maanantai;12;8;20
626;30.01.2017;2017;01;20;Maanantai;10;4;14
626;30.01.2017;2017;01;21;Maanantai;4;4;8
626;30.01.2017;2017;01;22;Maanantai;2;3;5
626;30.01.2017;2017;01;23;Maanantai;1;1;2
626;31.01.2017;2017;01;00;Tiistai;1;0;1
626;31.01.2017;2017;01;01;Tiistai;0;0;0
626;31.01.2017;2017;01;02;Tiistai;0;0;0
626;31.01.2017;2017;01;03;Tiistai;0;0;0
626;31.01.2017;2017;01;04;Tiistai;1;0;1
626;31.01.2017;2017;01;05;Tiistai;1;2;3
626;31.01.2017;2017;01;06;Tiistai;1;7;8
626;31.01.2017;2017;01;07;Tiistai;3;17;20
626;31.01.2017;2017;01;08;Tiistai;10;25;35
626;31.01.2017;2017;01;09;Tiistai;7;20;27
626;31.01.2017;2017;01;10;Tiistai;2;7;9
626;31.01.2017;2017;01;11;Tiistai;3;4;7
626;31.01.2017;2017;01;12;Tiistai;4;8;12
626;31.01.2017;2017;01;13;Tiistai;2;2;4
626;31.01.2017;2017;01;14;Tiistai;8;7;15
626;31.01.2017;2017;01;15;Tiistai;12;5;17
626;31.01.2017;2017;01;16;Tiistai;18;10;28
626;31.01.2017;2017;01;17;Tiistai;27;11;38
626;31.01.2017;2017;01;18;Tiistai;11;10;21
626;31.01.2017;2017;01;19;Tiistai;5;4;9
626;31.01.2017;2017;01;20;Tiistai;7;0;7
626;31.01.2017;2017;01;21;Tiistai;3;2;5
626;31.01.2017;2017;01;22;Tiistai;5;4;9
626;31.01.2017;2017;01;23;Tiistai;1;1;2
626;01.02.2017;2017;02;00;Keskiviikko;2;0;2
626;01.02.2017;2017;02;01;Keskiviikko;0;0;0
626;01.02.2017;2017;02;02;Keskiviikko;1;0;1
626;01.02.2017;2017;02;03;Keskiviikko;0;0;0
626;01.02.2017;2017;02;04;Keskiviikko;0;0;0
626;01.02.2017;2017;02;05;Keskiviikko;0;2;2
626;01.02.2017;2017;02;06;Keskiviikko;1;3;4
626;01.02.2017;2017;02;07;Keskiviikko;2;13;15
626;01.02.2017;2017;02;08;Keskiviikko;8;24;32
626;01.02.2017;2017;02;09;Keskiviikko;7;15;22
626;01.02.2017;2017;02;10;Keskiviikko;4;3;7
626;01.02.2017;2017;02;11;Keskiviikko;1;5;6
626;01.02.2017;2017;02;12;Keskiviikko;3;3;6
626;01.02.2017;2017;02;13;Keskiviikko;4;4;8
626;01.02.2017;2017;02;14;Keskiviikko;12;8;20
626;01.02.2017;2017;02;15;Keskiviikko;10;4;14
626;01.02.2017;2017;02;16;Keskiviikko;17;8;25
626;01.02.2017;2017;02;17;Keskiviikko;25;11;36
626;01.02.2017;2017;02;18;Keskiviikko;17;7;24
626;01.02.2017;2017;02;19;Keskiviikko;4;4;8
626;01.02.2017;2017;02;20;Keskiviikko;2;1;3
626;01.02.2017;2017;02;21;Keskiviikko;4;2;6
626;01.02.2017;2017;02;22;Keskiviikko;1;0;1
626;01.02.2017;2017;02;23;Keskiviikko;3;2;5
626;02.02.2017;2017;02;00;Torstai;0;0;0
626;02.02.2017;2017;02;01;Torstai;1;0;1
626;02.02.2017;2017;02;02;Torstai;0;1;1
626;02.02.2017;2017;02;03;Torstai;0;0;0
626;02.02.2017;2017;02;04;Torstai;0;0;0
626;02.02.2017;2017;02;05;Torstai;0;2;2
626;02.02.2017;2017;02;06;Torstai;0;7;7
626;02.02.2017;2017;02;07;Torstai;3;23;26
626;02.02.2017;2017;02;08;Torstai;6;26;32
626;02.02.2017;2017;02;09;Torstai;8;11;19
626;02.02.2017;2017;02;10;Torstai;6;2;8
626;02.02.2017;2017;02;11;Torstai;1;2;3
626;02.02.2017;2017;02;12;Torstai;2;3;5
626;02.02.2017;2017;02;13;Torstai;5;3;8
626;02.02.2017;2017;02;14;Torstai;6;6;12
626;02.02.2017;2017;02;15;Torstai;7;2;9
626;02.02.2017;2017;02;16;Torstai;21;10;31
626;02.02.2017;2017;02;17;Torstai;15;11;26
626;02.02.2017;2017;02;18;Torstai;7;3;10
626;02.02.2017;2017;02;19;Torstai;13;4;17
626;02.02.2017;2017;02;20;Torstai;2;0;2
626;02.02.2017;2017;02;21;Torstai;3;0;3
626;02.02.2017;2017;02;22;Torstai;2;3;5
626;02.02.2017;2017;02;23;Torstai;2;1;3
626;03.02.2017;2017;02;00;Perjantai;0;2;2
626;03.02.2017;2017;02;01;Perjantai;2;0;2
626;03.02.2017;2017;02;02;Perjantai;0;0;0
626;03.02.2017;2017;02;03;Perjantai;0;0;0
626;03.02.2017;2017;02;04;Perjantai;0;0;0
626;03.02.2017;2017;02;05;Perjantai;0;1;1
626;03.02.2017;2017;02;06;Perjantai;1;6;7
626;03.02.2017;2017;02;07;Perjantai;4;11;15
626;03.02.2017;2017;02;08;Perjantai;9;25;34
626;03.02.2017;2017;02;09;Perjantai;7;10;17
626;03.02.2017;2017;02;10;Perjantai;2;7;9
626;03.02.2017;2017;02;11;Perjantai;3;3;6
626;03.02.2017;2017;02;12;Perjantai;4;4;8
626;03.02.2017;2017;02;13;Perjantai;4;9;13
626;03.02.2017;2017;02;14;Perjantai;9;7;16
626;03.02.2017;2017;02;15;Perjantai;13;9;22
626;03.02.2017;2017;02;16;Perjantai;24;5;29
626;03.02.2017;2017;02;17;Perjantai;20;10;30
626;03.02.2017;2017;02;18;Perjantai;12;10;22
626;03.02.2017;2017;02;19;Perjantai;4;1;5
626;03.02.2017;2017;02;20;Perjantai;4;2;6
626;03.02.2017;2017;02;21;Perjantai;3;2;5
626;03.02.2017;2017;02;22;Perjantai;3;3;6
626;03.02.2017;2017;02;23;Perjantai;2;0;2
626;04.02.2017;2017;02;00;Lauantai;0;0;0
626;04.02.2017;2017;02;01;Lauantai;3;0;3
626;04.02.2017;2017;02;02;Lauantai;0;0;0
626;04.02.2017;2017;02;03;Lauantai;0;0;0
626;04.02.2017;2017;02;04;Lauantai;0;0;0
626;04.02.2017;2017;02;05;Lauantai;0;0;0
626;04.02.2017;2017;02;06;Lauantai;1;0;1
626;04.02.2017;2017;02;07;Lauantai;0;2;2
626;04.02.2017;2017;02;08;Lauantai;0;2;2
626;04.02.2017;2017;02;09;Lauantai;0;2;2
626;04.02.2017;2017;02;10;Lauantai;4;2;6
626;04.02.2017;2017;02;11;Lauantai;1;6;7
626;04.02.2017;2017;02;12;Lauantai;4;1;5
626;04.02.2017;2017;02;13;Lauantai;2;7;9
626;04.02.2017;2017;02;14;Lauantai;6;4;10
626;04.02.2017;2017;02;15;Lauantai;5;3;8
626;04.02.2017;2017;02;16;Lauantai;5;7;12
626;04.02.2017;2017;02;17;Lauantai;9;2;11
626;04.02.2017;2017;02;18;Lauantai;1;3;4
626;04.02.2017;2017;02;19;Lauantai;5;3;8
626;04.02.2017;2017;02;20;Lauantai;0;2;2
626;04.02.2017;2017;02;21;Lauantai;1;1;2
626;04.02.2017;2017;02;22;Lauantai;3;1;4
626;04.02.2017;2017;02;23;Lauantai;3;1;4
626;05.02.2017;2017;02;00;Sunnuntai;0;1;1
626;05.02.2017;2017;02;01;Sunnuntai;1;0;1
626;05.02.2017;2017;02;02;Sunnuntai;0;0;0
626;05.02.2017;2017;02;03;Sunnuntai;0;0;0
626;05.02.2017;2017;02;04;Sunnuntai;0;0;0
626;05.02.2017;2017;02;05;Sunnuntai;1;1;2
626;05.02.2017;2017;02;06;Sunnuntai;0;2;2
626;05.02.2017;2017;02;07;Sunnuntai;0;0;0
626;05.02.2017;2017;02;08;Sunnuntai;0;0;0
626;05.02.2017;2017;02;09;Sunnuntai;1;1;2
626;05.02.2017;2017;02;10;Sunnuntai;2;4;6
626;05.02.2017;2017;02;11;Sunnuntai;5;7;12
626;05.02.2017;2017;02;12;Sunnuntai;1;0;1
626;05.02.2017;2017;02;13;Sunnuntai;3;5;8
626;05.02.2017;2017;02;14;Sunnuntai;5;4;9
626;05.02.2017;2017;02;15;Sunnuntai;9;7;16
626;05.02.2017;2017;02;16;Sunnuntai;2;3;5
626;05.02.2017;2017;02;17;Sunnuntai;4;6;10
626;05.02.2017;2017;02;18;Sunnuntai;3;5;8
626;05.02.2017;2017;02;19;Sunnuntai;6;4;10
626;05.02.2017;2017;02;20;Sunnuntai;2;3;5
626;05.02.2017;2017;02;21;Sunnuntai;2;3;5
626;05.02.2017;2017;02;22;Sunnuntai;0;2;2
626;05.02.2017;2017;02;23;Sunnuntai;2;0;2
626;06.02.2017;2017;02;00;Maanantai;0;0;0
626;06.02.2017;2017;02;01;Maanantai;0;0;0
626;06.02.2017;2017;02;02;Maanantai;1;0;1
626;06.02.2017;2017;02;03;Maanantai;0;0;0
626;06.02.2017;2017;02;04;Maanantai;0;0;0
626;06.02.2017;2017;02;05;Maanantai;0;2;2
626;06.02.2017;2017;02;06;Maanantai;1;3;4
626;06.02.2017;2017;02;07;Maanantai;2;9;11
626;06.02.2017;2017;02;08;Maanantai;10;25;35
626;06.02.2017;2017;02;09;Maanantai;8;16;24
626;06.02.2017;2017;02;10;Maanantai;2;10;12
626;06.02.2017;2017;02;11;Maanantai;3;1;4
626;06.02.2017;2017;02;12;Maanantai;2;4;6
626;06.02.2017;2017;02;13;Maanantai;3;5;8
626;06.02.2017;2017;02;14;Maanantai;9;10;19
626;06.02.2017;2017;02;15;Maanantai;7;13;20
626;06.02.2017;2017;02;16;Maanantai;16;5;21
626;06.02.2017;2017;02;17;Maanantai;30;11;41
626;06.02.2017;2017;02;18;Maanantai;19;8;27
626;06.02.2017;2017;02;19;Maanantai;14;1;15
626;06.02.2017;2017;02;20;Maanantai;6;2;8
626;06.02.2017;2017;02;21;Maanantai;5;2;7
626;06.02.2017;2017;02;22;Maanantai;2;3;5
626;06.02.2017;2017;02;23;Maanantai;1;0;1
626;07.02.2017;2017;02;00;Tiistai;0;1;1
626;07.02.2017;2017;02;01;Tiistai;0;0;0
626;07.02.2017;2017;02;02;Tiistai;0;0;0
626;07.02.2017;2017;02;03;Tiistai;0;0;0
626;07.02.2017;2017;02;04;Tiistai;0;0;0
626;07.02.2017;2017;02;05;Tiistai;0;2;2
626;07.02.2017;2017;02;06;Tiistai;2;5;7
626;07.02.2017;2017;02;07;Tiistai;4;20;24
626;07.02.2017;2017;02;08;Tiistai;8;29;37
626;07.02.2017;2017;02;09;Tiistai;6;15;21
626;07.02.2017;2017;02;10;Tiistai;2;6;8
626;07.02.2017;2017;02;11;Tiistai;2;4;6
626;07.02.2017;2017;02;12;Tiistai;3;7;10
626;07.02.2017;2017;02;13;Tiistai;6;7;13
626;07.02.2017;2017;02;14;Tiistai;4;6;10
626;07.02.2017;2017;02;15;Tiistai;12;6;18
626;07.02.2017;2017;02;16;Tiistai;20;7;27
626;07.02.2017;2017;02;17;Tiistai;28;11;39
626;07.02.2017;2017;02;18;Tiistai;15;9;24
626;07.02.2017;2017;02;19;Tiistai;8;6;14
626;07.02.2017;2017;02;20;Tiistai;8;2;10
626;07.02.2017;2017;02;21;Tiistai;2;1;3
626;07.02.2017;2017;02;22;Tiistai;3;1;4
626;07.02.2017;2017;02;23;Tiistai;1;1;2
626;08.02.2017;2017;02;00;Keskiviikko;1;0;1
626;08.02.2017;2017;02;01;Keskiviikko;0;0;0
626;08.02.2017;2017;02;02;Keskiviikko;0;0;0
626;08.02.2017;2017;02;03;Keskiviikko;0;0;0
626;08.02.2017;2017;02;04;Keskiviikko;0;0;0
626;08.02.2017;2017;02;05;Keskiviikko;0;2;2
626;08.02.2017;2017;02;06;Keskiviikko;1;4;5
626;08.02.2017;2017;02;07;Keskiviikko;2;8;10
626;08.02.2017;2017;02;08;Keskiviikko;9;13;22
626;08.02.2017;2017;02;09;Keskiviikko;6;13;19
626;08.02.2017;2017;02;10;Keskiviikko;2;5;7
626;08.02.2017;2017;02;11;Keskiviikko;2;6;8
626;08.02.2017;2017;02;12;Keskiviikko;1;4;5
626;08.02.2017;2017;02;13;Keskiviikko;2;2;4
626;08.02.2017;2017;02;14;Keskiviikko;2;2;4
626;08.02.2017;2017;02;15;Keskiviikko;9;10;19
626;08.02.2017;2017;02;16;Keskiviikko;15;4;19
626;08.02.2017;2017;02;17;Keskiviikko;26;5;31
626;08.02.2017;2017;02;18;Keskiviikko;6;7;13
626;08.02.2017;2017;02;19;Keskiviikko;8;1;9
626;08.02.2017;2017;02;20;Keskiviikko;3;2;5
626;08.02.2017;2017;02;21;Keskiviikko;1;1;2
626;08.02.2017;2017;02;22;Keskiviikko;1;1;2
626;08.02.2017;2017;02;23;Keskiviikko;1;1;2
626;09.02.2017;2017;02;00;Torstai;1;0;1
626;09.02.2017;2017;02;01;Torstai;0;0;0
626;09.02.2017;2017;02;02;Torstai;2;0;2
626;09.02.2017;2017;02;03;Torstai;0;0;0
626;09.02.2017;2017;02;04;Torstai;0;0;0
626;09.02.2017;2017;02;05;Torstai;0;1;1
626;09.02.2017;2017;02;06;Torstai;3;4;7
626;09.02.2017;2017;02;07;Torstai;1;7;8
626;09.02.2017;2017;02;08;Torstai;5;13;18
626;09.02.2017;2017;02;09;Torstai;4;14;18
626;09.02.2017;2017;02;10;Torstai;2;3;5
626;09.02.2017;2017;02;11;Torstai;4;1;5
626;09.02.2017;2017;02;12;Torstai;2;4;6
626;09.02.2017;2017;02;13;Torstai;2;7;9
626;09.02.2017;2017;02;14;Torstai;4;2;6
626;09.02.2017;2017;02;15;Torstai;9;4;13
626;09.02.2017;2017;02;16;Torstai;7;8;15
626;09.02.2017;2017;02;17;Torstai;17;4;21
626;09.02.2017;2017;02;18;Torstai;4;4;8
626;09.02.2017;2017;02;19;Torstai;6;3;9
626;09.02.2017;2017;02;20;Torstai;5;3;8
626;09.02.2017;2017;02;21;Torstai;5;3;8
626;09.02.2017;2017;02;22;Torstai;5;4;9
626;09.02.2017;2017;02;23;Torstai;1;1;2
626;10.02.2017;2017;02;00;Perjantai;2;0;2
626;10.02.2017;2017;02;01;Perjantai;0;0;0
626;10.02.2017;2017;02;02;Perjantai;0;0;0
626;10.02.2017;2017;02;03;Perjantai;0;0;0
626;10.02.2017;2017;02;04;Perjantai;0;1;1
626;10.02.2017;2017;02;05;Perjantai;0;3;3
626;10.02.2017;2017;02;06;Perjantai;2;2;4
626;10.02.2017;2017;02;07;Perjantai;2;15;17
626;10.02.2017;2017;02;08;Perjantai;14;33;47
626;10.02.2017;2017;02;09;Perjantai;7;14;21
626;10.02.2017;2017;02;10;Perjantai;2;8;10
626;10.02.2017;2017;02;11;Perjantai;2;4;6
626;10.02.2017;2017;02;12;Perjantai;3;9;12
626;10.02.2017;2017;02;13;Perjantai;6;4;10
626;10.02.2017;2017;02;14;Perjantai;8;6;14
626;10.02.2017;2017;02;15;Perjantai;16;5;21
626;10.02.2017;2017;02;16;Perjantai;22;8;30
626;10.02.2017;2017;02;17;Perjantai;28;11;39
626;10.02.2017;2017;02;18;Perjantai;13;4;17
626;10.02.2017;2017;02;19;Perjantai;6;1;7
626;10.02.2017;2017;02;20;Perjantai;5;3;8
626;10.02.2017;2017;02;21;Perjantai;5;5;10
626;10.02.2017;2017;02;22;Perjantai;6;3;9
626;10.02.2017;2017;02;23;Perjantai;0;0;0
626;11.02.2017;2017;02;00;Lauantai;0;0;0
626;11.02.2017;2017;02;01;Lauantai;0;0;0
626;11.02.2017;2017;02;02;Lauantai;0;0;0
626;11.02.2017;2017;02;03;Lauantai;2;1;3
626;11.02.2017;2017;02;04;Lauantai;0;1;1
626;11.02.2017;2017;02;05;Lauantai;1;0;1
626;11.02.2017;2017;02;06;Lauantai;2;2;4
626;11.02.2017;2017;02;07;Lauantai;0;1;1
626;11.02.2017;2017;02;08;Lauantai;3;2;5
626;11.02.2017;2017;02;09;Lauantai;1;0;1
626;11.02.2017;2017;02;10;Lauantai;4;5;9
626;11.02.2017;2017;02;11;Lauantai;5;6;11
626;11.02.2017;2017;02;12;Lauantai;4;11;15
626;11.02.2017;2017;02;13;Lauantai;8;4;12
626;11.02.2017;2017;02;14;Lauantai;7;4;11
626;11.02.2017;2017;02;15;Lauantai;4;6;10
626;11.02.2017;2017;02;16;Lauantai;3;6;9
626;11.02.2017;2017;02;17;Lauantai;6;9;15
626;11.02.2017;2017;02;18;Lauantai;5;1;6
626;11.02.2017;2017;02;19;Lauantai;2;2;4
626;11.02.2017;2017;02;20;Lauantai;4;3;7
626;11.02.2017;2017;02;21;Lauantai;0;2;2
626;11.02.2017;2017;02;22;Lauantai;1;0;1
626;11.02.2017;2017;02;23;Lauantai;0;2;2
626;12.02.2017;2017;02;00;Sunnuntai;1;0;1
626;12.02.2017;2017;02;01;Sunnuntai;1;0;1
626;12.02.2017;2017;02;02;Sunnuntai;1;0;1
626;12.02.2017;2017;02;03;Sunnuntai;0;0;0
626;12.02.2017;2017;02;04;Sunnuntai;1;0;1
626;12.02.2017;2017;02;05;Sunnuntai;0;0;0
626;12.02.2017;2017;02;06;Sunnuntai;0;1;1
626;12.02.2017;2017;02;07;Sunnuntai;0;1;1
626;12.02.2017;2017;02;08;Sunnuntai;1;2;3
626;12.02.2017;2017;02;09;Sunnuntai;1;0;1
626;12.02.2017;2017;02;10;Sunnuntai;1;3;4
626;12.02.2017;2017;02;11;Sunnuntai;2;3;5
626;12.02.2017;2017;02;12;Sunnuntai;5;0;5
626;12.02.2017;2017;02;13;Sunnuntai;7;6;13
626;12.02.2017;2017;02;14;Sunnuntai;6;6;12
626;12.02.2017;2017;02;15;Sunnuntai;10;6;16
626;12.02.2017;2017;02;16;Sunnuntai;4;2;6
626;12.02.2017;2017;02;17;Sunnuntai;4;5;9
626;12.02.2017;2017;02;18;Sunnuntai;1;2;3
626;12.02.2017;2017;02;19;Sunnuntai;0;6;6
626;12.02.2017;2017;02;20;Sunnuntai;3;5;8
626;12.02.2017;2017;02;21;Sunnuntai;5;4;9
626;12.02.2017;2017;02;22;Sunnuntai;1;3;4
626;12.02.2017;2017;02;23;Sunnuntai;1;0;1
626;13.02.2017;2017;02;00;Maanantai;0;0;0
626;13.02.2017;2017;02;01;Maanantai;0;0;0
626;13.02.2017;2017;02;02;Maanantai;0;0;0
626;13.02.2017;2017;02;03;Maanantai;0;0;0
626;13.02.2017;2017;02;04;Maanantai;1;0;1
626;13.02.2017;2017;02;05;Maanantai;0;2;2
626;13.02.2017;2017;02;06;Maanantai;1;4;5
626;13.02.2017;2017;02;07;Maanantai;4;21;25
626;13.02.2017;2017;02;08;Maanantai;9;30;39
626;13.02.2017;2017;02;09;Maanantai;12;28;40
626;13.02.2017;2017;02;10;Maanantai;7;6;13
626;13.02.2017;2017;02;11;Maanantai;6;8;14
626;13.02.2017;2017;02;12;Maanantai;7;8;15
626;13.02.2017;2017;02;13;Maanantai;11;15;26
626;13.02.2017;2017;02;14;Maanantai;10;9;19
626;13.02.2017;2017;02;15;Maanantai;15;5;20
626;13.02.2017;2017;02;16;Maanantai;24;10;34
626;13.02.2017;2017;02;17;Maanantai;30;16;46
626;13.02.2017;2017;02;18;Maanantai;18;8;26
626;13.02.2017;2017;02;19;Maanantai;9;2;11
626;13.02.2017;2017;02;20;Maanantai;6;3;9
626;13.02.2017;2017;02;21;Maanantai;3;3;6
626;13.02.2017;2017;02;22;Maanantai;4;4;8
626;13.02.2017;2017;02;23;Maanantai;3;1;4
626;14.02.2017;2017;02;00;Tiistai;0;0;0
626;14.02.2017;2017;02;01;Tiistai;0;0;0
626;14.02.2017;2017;02;02;Tiistai;0;0;0
626;14.02.2017;2017;02;03;Tiistai;0;0;0
626;14.02.2017;2017;02;04;Tiistai;1;0;1
626;14.02.2017;2017;02;05;Tiistai;0;3;3
626;14.02.2017;2017;02;06;Tiistai;2;8;10
626;14.02.2017;2017;02;07;Tiistai;5;18;23
626;14.02.2017;2017;02;08;Tiistai;11;28;39
626;14.02.2017;2017;02;09;Tiistai;10;19;29
626;14.02.2017;2017;02;10;Tiistai;4;10;14
626;14.02.2017;2017;02;11;Tiistai;2;8;10
626;14.02.2017;2017;02;12;Tiistai;3;8;11
626;14.02.2017;2017;02;13;Tiistai;6;5;11
626;14.02.2017;2017;02;14;Tiistai;6;1;7
626;14.02.2017;2017;02;15;Tiistai;10;7;17
626;14.02.2017;2017;02;16;Tiistai;20;15;35
626;14.02.2017;2017;02;17;Tiistai;33;12;45
626;14.02.2017;2017;02;18;Tiistai;22;7;29
626;14.02.2017;2017;02;19;Tiistai;13;3;16
626;14.02.2017;2017;02;20;Tiistai;4;2;6
626;14.02.2017;2017;02;21;Tiistai;8;3;11
626;14.02.2017;2017;02;22;Tiistai;4;1;5
626;14.02.2017;2017;02;23;Tiistai;3;2;5
626;15.02.2017;2017;02;00;Keskiviikko;0;0;0
626;15.02.2017;2017;02;01;Keskiviikko;0;0;0
626;15.02.2017;2017;02;02;Keskiviikko;0;0;0
626;15.02.2017;2017;02;03;Keskiviikko;0;0;0
626;15.02.2017;2017;02;04;Keskiviikko;0;0;0
626;15.02.2017;2017;02;05;Keskiviikko;0;3;3
626;15.02.2017;2017;02;06;Keskiviikko;3;7;10
626;15.02.2017;2017;02;07;Keskiviikko;5;20;25
626;15.02.2017;2017;02;08;Keskiviikko;8;34;42
626;15.02.2017;2017;02;09;Keskiviikko;6;21;27
626;15.02.2017;2017;02;10;Keskiviikko;3;7;10
626;15.02.2017;2017;02;11;Keskiviikko;5;6;11
626;15.02.2017;2017;02;12;Keskiviikko;5;4;9
626;15.02.2017;2017;02;13;Keskiviikko;2;3;5
626;15.02.2017;2017;02;14;Keskiviikko;10;8;18
626;15.02.2017;2017;02;15;Keskiviikko;10;10;20
626;15.02.2017;2017;02;16;Keskiviikko;21;11;32
626;15.02.2017;2017;02;17;Keskiviikko;29;7;36
626;15.02.2017;2017;02;18;Keskiviikko;17;9;26
626;15.02.2017;2017;02;19;Keskiviikko;11;5;16
626;15.02.2017;2017;02;20;Keskiviikko;7;5;12
626;15.02.2017;2017;02;21;Keskiviikko;5;1;6
626;15.02.2017;2017;02;22;Keskiviikko;1;1;2
626;15.02.2017;2017;02;23;Keskiviikko;7;3;10
626;16.02.2017;2017;02;00;Torstai;0;1;1
626;16.02.2017;2017;02;01;Torstai;0;0;0
626;16.02.2017;2017;02;02;Torstai;0;0;0
626;16.02.2017;2017;02;03;Torstai;0;0;0
626;16.02.2017;2017;02;04;Torstai;0;0;0
626;16.02.2017;2017;02;05;Torstai;0;3;3
626;16.02.2017;2017;02;06;Torstai;3;5;8
626;16.02.2017;2017;02;07;Torstai;5;19;24
626;16.02.2017;2017;02;08;Torstai;8;34;42
626;16.02.2017;2017;02;09;Torstai;11;23;34
626;16.02.2017;2017;02;10;Torstai;2;10;12
626;16.02.2017;2017;02;11;Torstai;6;3;9
626;16.02.2017;2017;02;12;Torstai;3;6;9
626;16.02.2017;2017;02;13;Torstai;3;7;10
626;16.02.2017;2017;02;14;Torstai;10;7;17
626;16.02.2017;2017;02;15;Torstai;12;7;19
626;16.02.2017;2017;02;16;Torstai;19;11;30
626;16.02.2017;2017;02;17;Torstai;39;14;53
626;16.02.2017;2017;02;18;Torstai;11;6;17
626;16.02.2017;2017;02;19;Torstai;17;5;22
626;16.02.2017;2017;02;20;Torstai;5;8;13
626;16.02.2017;2017;02;21;Torstai;3;2;5
626;16.02.2017;2017;02;22;Torstai;3;1;4
626;16.02.2017;2017;02;23;Torstai;2;1;3
626;17.02.2017;2017;02;00;Perjantai;1;2;3
626;17.02.2017;2017;02;01;Perjantai;0;0;0
626;17.02.2017;2017;02;02;Perjantai;0;0;0
626;17.02.2017;2017;02;03;Perjantai;0;0;0
626;17.02.2017;2017;02;04;Perjantai;0;0;0
626;17.02.2017;2017;02;05;Perjantai;0;2;2
626;17.02.2017;2017;02;06;Perjantai;4;9;13
626;17.02.2017;2017;02;07;Perjantai;6;20;26
626;17.02.2017;2017;02;08;Perjantai;7;27;34
626;17.02.2017;2017;02;09;Perjantai;13;13;26
626;17.02.2017;2017;02;10;Perjantai;4;7;11
626;17.02.2017;2017;02;11;Perjantai;5;4;9
626;17.02.2017;2017;02;12;Perjantai;7;3;10
626;17.02.2017;2017;02;13;Perjantai;6;9;15
626;17.02.2017;2017;02;14;Perjantai;14;13;27
626;17.02.2017;2017;02;15;Perjantai;12;9;21
626;17.02.2017;2017;02;16;Perjantai;29;17;46
626;17.02.2017;2017;02;17;Perjantai;21;8;29
626;17.02.2017;2017;02;18;Perjantai;15;7;22
626;17.02.2017;2017;02;19;Perjantai;9;4;13
626;17.02.2017;2017;02;20;Perjantai;3;4;7
626;17.02.2017;2017;02;21;Perjantai;1;2;3
626;17.02.2017;2017;02;22;Perjantai;3;1;4
626;17.02.2017;2017;02;23;Perjantai;4;0;4
626;18.02.2017;2017;02;00;Lauantai;0;0;0
626;18.02.2017;2017;02;01;Lauantai;1;1;2
626;18.02.2017;2017;02;02;Lauantai;0;0;0
626;18.02.2017;2017;02;03;Lauantai;0;1;1
626;18.02.2017;2017;02;04;Lauantai;1;0;1
626;18.02.2017;2017;02;05;Lauantai;1;1;2
626;18.02.2017;2017;02;06;Lauantai;0;3;3
626;18.02.2017;2017;02;07;Lauantai;0;2;2
626;18.02.2017;2017;02;08;Lauantai;1;0;1
626;18.02.2017;2017;02;09;Lauantai;1;1;2
626;18.02.2017;2017;02;10;Lauantai;3;2;5
626;18.02.2017;2017;02;11;Lauantai;3;5;8
626;18.02.2017;2017;02;12;Lauantai;5;4;9
626;18.02.2017;2017;02;13;Lauantai;3;6;9
626;18.02.2017;2017;02;14;Lauantai;5;9;14
626;18.02.2017;2017;02;15;Lauantai;9;6;15
626;18.02.2017;2017;02;16;Lauantai;12;8;20
626;18.02.2017;2017;02;17;Lauantai;2;4;6
626;18.02.2017;2017;02;18;Lauantai;8;10;18
626;18.02.2017;2017;02;19;Lauantai;1;2;3
626;18.02.2017;2017;02;20;Lauantai;4;3;7
626;18.02.2017;2017;02;21;Lauantai;2;2;4
626;18.02.2017;2017;02;22;Lauantai;2;1;3
626;18.02.2017;2017;02;23;Lauantai;4;1;5
626;19.02.2017;2017;02;00;Sunnuntai;1;1;2
626;19.02.2017;2017;02;01;Sunnuntai;2;4;6
626;19.02.2017;2017;02;02;Sunnuntai;2;0;2
626;19.02.2017;2017;02;03;Sunnuntai;0;0;0
626;19.02.2017;2017;02;04;Sunnuntai;1;0;1
626;19.02.2017;2017;02;05;Sunnuntai;0;0;0
626;19.02.2017;2017;02;06;Sunnuntai;1;0;1
626;19.02.2017;2017;02;07;Sunnuntai;1;1;2
626;19.02.2017;2017;02;08;Sunnuntai;0;1;1
626;19.02.2017;2017;02;09;Sunnuntai;3;2;5
626;19.02.2017;2017;02;10;Sunnuntai;0;2;2
626;19.02.2017;2017;02;11;Sunnuntai;2;0;2
626;19.02.2017;2017;02;12;Sunnuntai;1;3;4
626;19.02.2017;2017;02;13;Sunnuntai;4;7;11
626;19.02.2017;2017;02;14;Sunnuntai;7;10;17
626;19.02.2017;2017;02;15;Sunnuntai;3;12;15
626;19.02.2017;2017;02;16;Sunnuntai;4;7;11
626;19.02.2017;2017;02;17;Sunnuntai;4;1;5
626;19.02.2017;2017;02;18;Sunnuntai;6;5;11
626;19.02.2017;2017;02;19;Sunnuntai;0;4;4
626;19.02.2017;2017;02;20;Sunnuntai;2;3;5
626;19.02.2017;2017;02;21;Sunnuntai;2;2;4
626;19.02.2017;2017;02;22;Sunnuntai;4;1;5
626;19.02.2017;2017;02;23;Sunnuntai;0;0;0
626;20.02.2017;2017;02;00;Maanantai;0;1;1
626;20.02.2017;2017;02;01;Maanantai;1;0;1
626;20.02.2017;2017;02;02;Maanantai;0;0;0
626;20.02.2017;2017;02;03;Maanantai;0;0;0
626;20.02.2017;2017;02;04;Maanantai;0;0;0
626;20.02.2017;2017;02;05;Maanantai;0;2;2
626;20.02.2017;2017;02;06;Maanantai;4;8;12
626;20.02.2017;2017;02;07;Maanantai;3;18;21
626;20.02.2017;2017;02;08;Maanantai;6;25;31
626;20.02.2017;2017;02;09;Maanantai;5;23;28
626;20.02.2017;2017;02;10;Maanantai;2;6;8
626;20.02.2017;2017;02;11;Maanantai;6;4;10
626;20.02.2017;2017;02;12;Maanantai;4;5;9
626;20.02.2017;2017;02;13;Maanantai;6;6;12
626;20.02.2017;2017;02;14;Maanantai;7;6;13
626;20.02.2017;2017;02;15;Maanantai;11;6;17
626;20.02.2017;2017;02;16;Maanantai;25;11;36
626;20.02.2017;2017;02;17;Maanantai;28;5;33
626;20.02.2017;2017;02;18;Maanantai;16;3;19
626;20.02.2017;2017;02;19;Maanantai;8;4;12
626;20.02.2017;2017;02;20;Maanantai;5;5;10
626;20.02.2017;2017;02;21;Maanantai;3;3;6
626;20.02.2017;2017;02;22;Maanantai;6;2;8
626;20.02.2017;2017;02;23;Maanantai;2;0;2
626;21.02.2017;2017;02;00;Tiistai;0;0;0
626;21.02.2017;2017;02;01;Tiistai;0;0;0
626;21.02.2017;2017;02;02;Tiistai;0;0;0
626;21.02.2017;2017;02;03;Tiistai;0;0;0
626;21.02.2017;2017;02;04;Tiistai;1;0;1
626;21.02.2017;2017;02;05;Tiistai;0;4;4
626;21.02.2017;2017;02;06;Tiistai;4;7;11
626;21.02.2017;2017;02;07;Tiistai;2;18;20
626;21.02.2017;2017;02;08;Tiistai;7;31;38
626;21.02.2017;2017;02;09;Tiistai;14;15;29
626;21.02.2017;2017;02;10;Tiistai;4;9;13
626;21.02.2017;2017;02;11;Tiistai;3;4;7
626;21.02.2017;2017;02;12;Tiistai;7;8;15
626;21.02.2017;2017;02;13;Tiistai;6;1;7
626;21.02.2017;2017;02;14;Tiistai;9;9;18
626;21.02.2017;2017;02;15;Tiistai;9;8;17
626;21.02.2017;2017;02;16;Tiistai;19;8;27
626;21.02.2017;2017;02;17;Tiistai;31;9;40
626;21.02.2017;2017;02;18;Tiistai;12;11;23
626;21.02.2017;2017;02;19;Tiistai;8;2;10
626;21.02.2017;2017;02;20;Tiistai;6;3;9
626;21.02.2017;2017;02;21;Tiistai;7;1;8
626;21.02.2017;2017;02;22;Tiistai;3;4;7
626;21.02.2017;2017;02;23;Tiistai;0;1;1
626;22.02.2017;2017;02;00;Keskiviikko;0;0;0
626;22.02.2017;2017;02;01;Keskiviikko;0;0;0
626;22.02.2017;2017;02;02;Keskiviikko;0;0;0
626;22.02.2017;2017;02;03;Keskiviikko;0;0;0
626;22.02.2017;2017;02;04;Keskiviikko;0;0;0
626;22.02.2017;2017;02;05;Keskiviikko;0;2;2
626;22.02.2017;2017;02;06;Keskiviikko;2;3;5
626;22.02.2017;2017;02;07;Keskiviikko;3;10;13
626;22.02.2017;2017;02;08;Keskiviikko;5;19;24
626;22.02.2017;2017;02;09;Keskiviikko;8;12;20
626;22.02.2017;2017;02;10;Keskiviikko;2;3;5
626;22.02.2017;2017;02;11;Keskiviikko;3;4;7
626;22.02.2017;2017;02;12;Keskiviikko;2;4;6
626;22.02.2017;2017;02;13;Keskiviikko;6;6;12
626;22.02.2017;2017;02;14;Keskiviikko;7;6;13
626;22.02.2017;2017;02;15;Keskiviikko;9;10;19
626;22.02.2017;2017;02;16;Keskiviikko;18;8;26
626;22.02.2017;2017;02;17;Keskiviikko;26;5;31
626;22.02.2017;2017;02;18;Keskiviikko;10;11;21
626;22.02.2017;2017;02;19;Keskiviikko;5;3;8
626;22.02.2017;2017;02;20;Keskiviikko;5;0;5
626;22.02.2017;2017;02;21;Keskiviikko;3;4;7
626;22.02.2017;2017;02;22;Keskiviikko;3;5;8
626;22.02.2017;2017;02;23;Keskiviikko;0;0;0
626;23.02.2017;2017;02;00;Torstai;0;0;0
626;23.02.2017;2017;02;01;Torstai;0;0;0
626;23.02.2017;2017;02;02;Torstai;0;0;0
626;23.02.2017;2017;02;03;Torstai;0;0;0
626;23.02.2017;2017;02;04;Torstai;1;0;1
626;23.02.2017;2017;02;05;Torstai;0;2;2
626;23.02.2017;2017;02;06;Torstai;5;1;6
626;23.02.2017;2017;02;07;Torstai;3;9;12
626;23.02.2017;2017;02;08;Torstai;5;27;32
626;23.02.2017;2017;02;09;Torstai;4;19;23
626;23.02.2017;2017;02;10;Torstai;2;5;7
626;23.02.2017;2017;02;11;Torstai;5;3;8
626;23.02.2017;2017;02;12;Torstai;1;5;6
626;23.02.2017;2017;02;13;Torstai;4;1;5
626;23.02.2017;2017;02;14;Torstai;3;2;5
626;23.02.2017;2017;02;15;Torstai;10;8;18
626;23.02.2017;2017;02;16;Torstai;12;7;19
626;23.02.2017;2017;02;17;Torstai;21;6;27
626;23.02.2017;2017;02;18;Torstai;11;3;14
626;23.02.2017;2017;02;19;Torstai;7;2;9
626;23.02.2017;2017;02;20;Torstai;3;3;6
626;23.02.2017;2017;02;21;Torstai;5;3;8
626;23.02.2017;2017;02;22;Torstai;1;3;4
626;23.02.2017;2017;02;23;Torstai;3;0;3
626;24.02.2017;2017;02;00;Perjantai;1;0;1
626;24.02.2017;2017;02;01;Perjantai;0;0;0
626;24.02.2017;2017;02;02;Perjantai;0;0;0
626;24.02.2017;2017;02;03;Perjantai;0;0;0
626;24.02.2017;2017;02;04;Perjantai;0;0;0
626;24.02.2017;2017;02;05;Perjantai;0;2;2
626;24.02.2017;2017;02;06;Perjantai;5;5;10
626;24.02.2017;2017;02;07;Perjantai;2;11;13
626;24.02.2017;2017;02;08;Perjantai;6;24;30
626;24.02.2017;2017;02;09;Perjantai;9;15;24
626;24.02.2017;2017;02;10;Perjantai;7;5;12
626;24.02.2017;2017;02;11;Perjantai;3;3;6
626;24.02.2017;2017;02;12;Perjantai;2;9;11
626;24.02.2017;2017;02;13;Perjantai;7;3;10
626;24.02.2017;2017;02;14;Perjantai;3;3;6
626;24.02.2017;2017;02;15;Perjantai;12;10;22
626;24.02.2017;2017;02;16;Perjantai;14;8;22
626;24.02.2017;2017;02;17;Perjantai;18;5;23
626;24.02.2017;2017;02;18;Perjantai;11;4;15
626;24.02.2017;2017;02;19;Perjantai;6;1;7
626;24.02.2017;2017;02;20;Perjantai;2;6;8
626;24.02.2017;2017;02;21;Perjantai;4;4;8
626;24.02.2017;2017;02;22;Perjantai;1;5;6
626;24.02.2017;2017;02;23;Perjantai;2;1;3
626;25.02.2017;2017;02;00;Lauantai;1;0;1
626;25.02.2017;2017;02;01;Lauantai;0;0;0
626;25.02.2017;2017;02;02;Lauantai;0;0;0
626;25.02.2017;2017;02;03;Lauantai;1;0;1
626;25.02.2017;2017;02;04;Lauantai;1;0;1
626;25.02.2017;2017;02;05;Lauantai;0;0;0
626;25.02.2017;2017;02;06;Lauantai;0;1;1
626;25.02.2017;2017;02;07;Lauantai;0;0;0
626;25.02.2017;2017;02;08;Lauantai;7;1;8
626;25.02.2017;2017;02;09;Lauantai;2;1;3
626;25.02.2017;2017;02;10;Lauantai;2;3;5
626;25.02.2017;2017;02;11;Lauantai;1;6;7
626;25.02.2017;2017;02;12;Lauantai;4;5;9
626;25.02.2017;2017;02;13;Lauantai;6;4;10
626;25.02.2017;2017;02;14;Lauantai;2;5;7
626;25.02.2017;2017;02;15;Lauantai;2;6;8
626;25.02.2017;2017;02;16;Lauantai;3;4;7
626;25.02.2017;2017;02;17;Lauantai;9;7;16
626;25.02.2017;2017;02;18;Lauantai;6;6;12
626;25.02.2017;2017;02;19;Lauantai;4;6;10
626;25.02.2017;2017;02;20;Lauantai;5;1;6
626;25.02.2017;2017;02;21;Lauantai;1;0;1
626;25.02.2017;2017;02;22;Lauantai;3;0;3
626;25.02.2017;2017;02;23;Lauantai;3;3;6
626;26.02.2017;2017;02;00;Sunnuntai;0;0;0
626;26.02.2017;2017;02;01;Sunnuntai;0;1;1
626;26.02.2017;2017;02;02;Sunnuntai;1;0;1
626;26.02.2017;2017;02;03;Sunnuntai;0;0;0
626;26.02.2017;2017;02;04;Sunnuntai;2;0;2
626;26.02.2017;2017;02;05;Sunnuntai;0;0;0
626;26.02.2017;2017;02;06;Sunnuntai;0;2;2
626;26.02.2017;2017;02;07;Sunnuntai;1;0;1
626;26.02.2017;2017;02;08;Sunnuntai;0;0;0
626;26.02.2017;2017;02;09;Sunnuntai;1;0;1
626;26.02.2017;2017;02;10;Sunnuntai;0;2;2
626;26.02.2017;2017;02;11;Sunnuntai;3;5;8
626;26.02.2017;2017;02;12;Sunnuntai;2;4;6
626;26.02.2017;2017;02;13;Sunnuntai;3;1;4
626;26.02.2017;2017;02;14;Sunnuntai;6;3;9
626;26.02.2017;2017;02;15;Sunnuntai;4;5;9
626;26.02.2017;2017;02;16;Sunnuntai;3;3;6
626;26.02.2017;2017;02;17;Sunnuntai;4;6;10
626;26.02.2017;2017;02;18;Sunnuntai;3;0;3
626;26.02.2017;2017;02;19;Sunnuntai;1;4;5
626;26.02.2017;2017;02;20;Sunnuntai;2;5;7
626;26.02.2017;2017;02;21;Sunnuntai;4;1;5
626;26.02.2017;2017;02;22;Sunnuntai;2;1;3
626;26.02.2017;2017;02;23;Sunnuntai;2;1;3
626;27.02.2017;2017;02;00;Maanantai;0;1;1
626;27.02.2017;2017;02;01;Maanantai;0;0;0
626;27.02.2017;2017;02;02;Maanantai;0;1;1
626;27.02.2017;2017;02;03;Maanantai;0;0;0
626;27.02.2017;2017;02;04;Maanantai;0;0;0
626;27.02.2017;2017;02;05;Maanantai;0;0;0
626;27.02.2017;2017;02;06;Maanantai;3;6;9
626;27.02.2017;2017;02;07;Maanantai;2;9;11
626;27.02.2017;2017;02;08;Maanantai;3;20;23
626;27.02.2017;2017;02;09;Maanantai;5;10;15
626;27.02.2017;2017;02;10;Maanantai;2;2;4
626;27.02.2017;2017;02;11;Maanantai;1;4;5
626;27.02.2017;2017;02;12;Maanantai;1;4;5
626;27.02.2017;2017;02;13;Maanantai;0;2;2
626;27.02.2017;2017;02;14;Maanantai;5;3;8
626;27.02.2017;2017;02;15;Maanantai;8;5;13
626;27.02.2017;2017;02;16;Maanantai;9;9;18
626;27.02.2017;2017;02;17;Maanantai;18;9;27
626;27.02.2017;2017;02;18;Maanantai;7;6;13
626;27.02.2017;2017;02;19;Maanantai;8;2;10
626;27.02.2017;2017;02;20;Maanantai;6;2;8
626;27.02.2017;2017;02;21;Maanantai;3;1;4
626;27.02.2017;2017;02;22;Maanantai;1;5;6
626;27.02.2017;2017;02;23;Maanantai;1;2;3
626;28.02.2017;2017;02;00;Tiistai;0;0;0
626;28.02.2017;2017;02;01;Tiistai;1;0;1
626;28.02.2017;2017;02;02;Tiistai;0;0;0
626;28.02.2017;2017;02;03;Tiistai;0;1;1
626;28.02.2017;2017;02;04;Tiistai;0;0;0
626;28.02.2017;2017;02;05;Tiistai;0;1;1
626;28.02.2017;2017;02;06;Tiistai;2;6;8
626;28.02.2017;2017;02;07;Tiistai;3;19;22
626;28.02.2017;2017;02;08;Tiistai;12;32;44
626;28.02.2017;2017;02;09;Tiistai;5;24;29
626;28.02.2017;2017;02;10;Tiistai;2;14;16
626;28.02.2017;2017;02;11;Tiistai;5;4;9
626;28.02.2017;2017;02;12;Tiistai;6;5;11
626;28.02.2017;2017;02;13;Tiistai;10;6;16
626;28.02.2017;2017;02;14;Tiistai;6;4;10
626;28.02.2017;2017;02;15;Tiistai;7;6;13
626;28.02.2017;2017;02;16;Tiistai;15;12;27
626;28.02.2017;2017;02;17;Tiistai;24;10;34
626;28.02.2017;2017;02;18;Tiistai;18;3;21
626;28.02.2017;2017;02;19;Tiistai;8;5;13
626;28.02.2017;2017;02;20;Tiistai;9;5;14
626;28.02.2017;2017;02;21;Tiistai;3;2;5
626;28.02.2017;2017;02;22;Tiistai;0;2;2
626;28.02.2017;2017;02;23;Tiistai;2;3;5
626;01.03.2017;2017;03;00;Keskiviikko;1;0;1
626;01.03.2017;2017;03;01;Keskiviikko;0;0;0
626;01.03.2017;2017;03;02;Keskiviikko;0;0;0
626;01.03.2017;2017;03;03;Keskiviikko;0;0;0
626;01.03.2017;2017;03;04;Keskiviikko;0;0;0
626;01.03.2017;2017;03;05;Keskiviikko;0;2;2
626;01.03.2017;2017;03;06;Keskiviikko;3;3;6
626;01.03.2017;2017;03;07;Keskiviikko;2;16;18
626;01.03.2017;2017;03;08;Keskiviikko;6;28;34
626;01.03.2017;2017;03;09;Keskiviikko;8;17;25
626;01.03.2017;2017;03;10;Keskiviikko;4;5;9
626;01.03.2017;2017;03;11;Keskiviikko;1;2;3
626;01.03.2017;2017;03;12;Keskiviikko;1;1;2
626;01.03.2017;2017;03;13;Keskiviikko;4;6;10
626;01.03.2017;2017;03;14;Keskiviikko;8;7;15
626;01.03.2017;2017;03;15;Keskiviikko;4;3;7
626;01.03.2017;2017;03;16;Keskiviikko;15;5;20
626;01.03.2017;2017;03;17;Keskiviikko;19;7;26
626;01.03.2017;2017;03;18;Keskiviikko;3;6;9
626;01.03.2017;2017;03;19;Keskiviikko;11;4;15
626;01.03.2017;2017;03;20;Keskiviikko;6;3;9
626;01.03.2017;2017;03;21;Keskiviikko;3;0;3
626;01.03.2017;2017;03;22;Keskiviikko;4;2;6
626;01.03.2017;2017;03;23;Keskiviikko;0;0;0
626;02.03.2017;2017;03;00;Torstai;0;0;0
626;02.03.2017;2017;03;01;Torstai;0;1;1
626;02.03.2017;2017;03;02;Torstai;3;1;4
626;02.03.2017;2017;03;03;Torstai;0;1;1
626;02.03.2017;2017;03;04;Torstai;0;0;0
626;02.03.2017;2017;03;05;Torstai;0;2;2
626;02.03.2017;2017;03;06;Torstai;2;7;9
626;02.03.2017;2017;03;07;Torstai;3;11;14
626;02.03.2017;2017;03;08;Torstai;9;29;38
626;02.03.2017;2017;03;09;Torstai;4;12;16
626;02.03.2017;2017;03;10;Torstai;3;12;15
626;02.03.2017;2017;03;11;Torstai;4;5;9
626;02.03.2017;2017;03;12;Torstai;2;2;4
626;02.03.2017;2017;03;13;Torstai;5;6;11
626;02.03.2017;2017;03;14;Torstai;7;6;13
626;02.03.2017;2017;03;15;Torstai;7;2;9
626;02.03.2017;2017;03;16;Torstai;12;9;21
626;02.03.2017;2017;03;17;Torstai;18;9;27
626;02.03.2017;2017;03;18;Torstai;17;2;19
626;02.03.2017;2017;03;19;Torstai;8;3;11
626;02.03.2017;2017;03;20;Torstai;7;5;12
626;02.03.2017;2017;03;21;Torstai;5;3;8
626;02.03.2017;2017;03;22;Torstai;2;4;6
626;02.03.2017;2017;03;23;Torstai;1;2;3
626;03.03.2017;2017;03;00;Perjantai;0;1;1
626;03.03.2017;2017;03;01;Perjantai;0;0;0
626;03.03.2017;2017;03;02;Perjantai;0;0;0
626;03.03.2017;2017;03;03;Perjantai;0;0;0
626;03.03.2017;2017;03;04;Perjantai;1;0;1
626;03.03.2017;2017;03;05;Perjantai;1;2;3
626;03.03.2017;2017;03;06;Perjantai;6;3;9
626;03.03.2017;2017;03;07;Perjantai;1;8;9
626;03.03.2017;2017;03;08;Perjantai;8;17;25
626;03.03.2017;2017;03;09;Perjantai;8;11;19
626;03.03.2017;2017;03;10;Perjantai;2;2;4
626;03.03.2017;2017;03;11;Perjantai;3;10;13
626;03.03.2017;2017;03;12;Perjantai;1;3;4
626;03.03.2017;2017;03;13;Perjantai;3;3;6
626;03.03.2017;2017;03;14;Perjantai;5;6;11
626;03.03.2017;2017;03;15;Perjantai;6;7;13
626;03.03.2017;2017;03;16;Perjantai;11;10;21
626;03.03.2017;2017;03;17;Perjantai;19;7;26
626;03.03.2017;2017;03;18;Perjantai;8;3;11
626;03.03.2017;2017;03;19;Perjantai;7;3;10
626;03.03.2017;2017;03;20;Perjantai;2;2;4
626;03.03.2017;2017;03;21;Perjantai;4;0;4
626;03.03.2017;2017;03;22;Perjantai;1;1;2
626;03.03.2017;2017;03;23;Perjantai;0;0;0
626;04.03.2017;2017;03;00;Lauantai;0;0;0
626;04.03.2017;2017;03;01;Lauantai;0;0;0
626;04.03.2017;2017;03;02;Lauantai;0;0;0
626;04.03.2017;2017;03;03;Lauantai;0;0;0
626;04.03.2017;2017;03;04;Lauantai;0;0;0
626;04.03.2017;2017;03;05;Lauantai;0;0;0
626;04.03.2017;2017;03;06;Lauantai;0;2;2
626;04.03.2017;2017;03;07;Lauantai;1;1;2
626;04.03.2017;2017;03;08;Lauantai;1;2;3
626;04.03.2017;2017;03;09;Lauantai;1;0;1
626;04.03.2017;2017;03;10;Lauantai;3;1;4
626;04.03.2017;2017;03;11;Lauantai;0;3;3
626;04.03.2017;2017;03;12;Lauantai;3;8;11
626;04.03.2017;2017;03;13;Lauantai;11;2;13
626;04.03.2017;2017;03;14;Lauantai;6;8;14
626;04.03.2017;2017;03;15;Lauantai;6;6;12
626;04.03.2017;2017;03;16;Lauantai;8;6;14
626;04.03.2017;2017;03;17;Lauantai;3;3;6
626;04.03.2017;2017;03;18;Lauantai;5;3;8
626;04.03.2017;2017;03;19;Lauantai;2;5;7
626;04.03.2017;2017;03;20;Lauantai;1;1;2
626;04.03.2017;2017;03;21;Lauantai;2;1;3
626;04.03.2017;2017;03;22;Lauantai;0;2;2
626;04.03.2017;2017;03;23;Lauantai;1;0;1
626;05.03.2017;2017;03;00;Sunnuntai;0;1;1
626;05.03.2017;2017;03;01;Sunnuntai;1;0;1
626;05.03.2017;2017;03;02;Sunnuntai;0;0;0
626;05.03.2017;2017;03;03;Sunnuntai;1;0;1
626;05.03.2017;2017;03;04;Sunnuntai;0;0;0
626;05.03.2017;2017;03;05;Sunnuntai;0;0;0
626;05.03.2017;2017;03;06;Sunnuntai;0;0;0
626;05.03.2017;2017;03;07;Sunnuntai;0;3;3
626;05.03.2017;2017;03;08;Sunnuntai;0;0;0
626;05.03.2017;2017;03;09;Sunnuntai;0;0;0
626;05.03.2017;2017;03;10;Sunnuntai;4;1;5
626;05.03.2017;2017;03;11;Sunnuntai;3;2;5
626;05.03.2017;2017;03;12;Sunnuntai;2;2;4
626;05.03.2017;2017;03;13;Sunnuntai;1;2;3
626;05.03.2017;2017;03;14;Sunnuntai;4;4;8
626;05.03.2017;2017;03;15;Sunnuntai;4;3;7
626;05.03.2017;2017;03;16;Sunnuntai;2;1;3
626;05.03.2017;2017;03;17;Sunnuntai;2;2;4
626;05.03.2017;2017;03;18;Sunnuntai;2;3;5
626;05.03.2017;2017;03;19;Sunnuntai;4;4;8
626;05.03.2017;2017;03;20;Sunnuntai;2;1;3
626;05.03.2017;2017;03;21;Sunnuntai;1;2;3
626;05.03.2017;2017;03;22;Sunnuntai;0;2;2
626;05.03.2017;2017;03;23;Sunnuntai;0;0;0
626;06.03.2017;2017;03;00;Maanantai;0;0;0
626;06.03.2017;2017;03;01;Maanantai;0;0;0
626;06.03.2017;2017;03;02;Maanantai;0;2;2
626;06.03.2017;2017;03;03;Maanantai;0;0;0
626;06.03.2017;2017;03;04;Maanantai;0;0;0
626;06.03.2017;2017;03;05;Maanantai;0;0;0
626;06.03.2017;2017;03;06;Maanantai;2;3;5
626;06.03.2017;2017;03;07;Maanantai;3;12;15
626;06.03.2017;2017;03;08;Maanantai;7;10;17
626;06.03.2017;2017;03;09;Maanantai;6;13;19
626;06.03.2017;2017;03;10;Maanantai;2;5;7
626;06.03.2017;2017;03;11;Maanantai;1;2;3
626;06.03.2017;2017;03;12;Maanantai;5;6;11
626;06.03.2017;2017;03;13;Maanantai;2;4;6
626;06.03.2017;2017;03;14;Maanantai;9;0;9
626;06.03.2017;2017;03;15;Maanantai;7;4;11
626;06.03.2017;2017;03;16;Maanantai;12;9;21
626;06.03.2017;2017;03;17;Maanantai;16;14;30
626;06.03.2017;2017;03;18;Maanantai;10;8;18
626;06.03.2017;2017;03;19;Maanantai;5;4;9
626;06.03.2017;2017;03;20;Maanantai;4;0;4
626;06.03.2017;2017;03;21;Maanantai;2;1;3
626;06.03.2017;2017;03;22;Maanantai;2;1;3
626;06.03.2017;2017;03;23;Maanantai;0;1;1
626;07.03.2017;2017;03;00;Tiistai;0;0;0
626;07.03.2017;2017;03;01;Tiistai;0;0;0
626;07.03.2017;2017;03;02;Tiistai;0;0;0
626;07.03.2017;2017;03;03;Tiistai;1;0;1
626;07.03.2017;2017;03;04;Tiistai;0;0;0
626;07.03.2017;2017;03;05;Tiistai;1;1;2
626;07.03.2017;2017;03;06;Tiistai;2;4;6
626;07.03.2017;2017;03;07;Tiistai;2;9;11
626;07.03.2017;2017;03;08;Tiistai;3;20;23
626;07.03.2017;2017;03;09;Tiistai;7;10;17
626;07.03.2017;2017;03;10;Tiistai;0;4;4
626;07.03.2017;2017;03;11;Tiistai;1;4;5
626;07.03.2017;2017;03;12;Tiistai;2;7;9
626;07.03.2017;2017;03;13;Tiistai;3;6;9
626;07.03.2017;2017;03;14;Tiistai;5;2;7
626;07.03.2017;2017;03;15;Tiistai;6;7;13
626;07.03.2017;2017;03;16;Tiistai;15;4;19
626;07.03.2017;2017;03;17;Tiistai;16;6;22
626;07.03.2017;2017;03;18;Tiistai;8;9;17
626;07.03.2017;2017;03;19;Tiistai;6;2;8
626;07.03.2017;2017;03;20;Tiistai;2;2;4
626;07.03.2017;2017;03;21;Tiistai;4;2;6
626;07.03.2017;2017;03;22;Tiistai;0;1;1
626;07.03.2017;2017;03;23;Tiistai;1;0;1
626;08.03.2017;2017;03;00;Keskiviikko;1;1;2
626;08.03.2017;2017;03;01;Keskiviikko;1;0;1
626;08.03.2017;2017;03;02;Keskiviikko;0;0;0
626;08.03.2017;2017;03;03;Keskiviikko;0;1;1
626;08.03.2017;2017;03;04;Keskiviikko;0;0;0
626;08.03.2017;2017;03;05;Keskiviikko;0;2;2
626;08.03.2017;2017;03;06;Keskiviikko;5;3;8
626;08.03.2017;2017;03;07;Keskiviikko;5;15;20
626;08.03.2017;2017;03;08;Keskiviikko;3;13;16
626;08.03.2017;2017;03;09;Keskiviikko;4;10;14
626;08.03.2017;2017;03;10;Keskiviikko;1;2;3
626;08.03.2017;2017;03;11;Keskiviikko;5;7;12
626;08.03.2017;2017;03;12;Keskiviikko;4;7;11
626;08.03.2017;2017;03;13;Keskiviikko;6;4;10
626;08.03.2017;2017;03;14;Keskiviikko;2;9;11
626;08.03.2017;2017;03;15;Keskiviikko;6;4;10
626;08.03.2017;2017;03;16;Keskiviikko;15;6;21
626;08.03.2017;2017;03;17;Keskiviikko;15;9;24
626;08.03.2017;2017;03;18;Keskiviikko;3;8;11
626;08.03.2017;2017;03;19;Keskiviikko;4;1;5
626;08.03.2017;2017;03;20;Keskiviikko;5;2;7
626;08.03.2017;2017;03;21;Keskiviikko;4;0;4
626;08.03.2017;2017;03;22;Keskiviikko;1;0;1
626;08.03.2017;2017;03;23;Keskiviikko;2;0;2
626;09.03.2017;2017;03;00;Torstai;0;0;0
626;09.03.2017;2017;03;01;Torstai;0;0;0
626;09.03.2017;2017;03;02;Torstai;1;0;1
626;09.03.2017;2017;03;03;Torstai;0;0;0
626;09.03.2017;2017;03;04;Torstai;0;0;0
626;09.03.2017;2017;03;05;Torstai;0;3;3
626;09.03.2017;2017;03;06;Torstai;8;3;11
626;09.03.2017;2017;03;07;Torstai;2;15;17
626;09.03.2017;2017;03;08;Torstai;5;12;17
626;09.03.2017;2017;03;09;Torstai;6;10;16
626;09.03.2017;2017;03;10;Torstai;2;1;3
626;09.03.2017;2017;03;11;Torstai;4;7;11
626;09.03.2017;2017;03;12;Torstai;5;4;9
626;09.03.2017;2017;03;13;Torstai;2;3;5
626;09.03.2017;2017;03;14;Torstai;3;5;8
626;09.03.2017;2017;03;15;Torstai;5;2;7
626;09.03.2017;2017;03;16;Torstai;9;9;18
626;09.03.2017;2017;03;17;Torstai;11;5;16
626;09.03.2017;2017;03;18;Torstai;3;8;11
626;09.03.2017;2017;03;19;Torstai;5;0;5
626;09.03.2017;2017;03;20;Torstai;3;2;5
626;09.03.2017;2017;03;21;Torstai;2;0;2
626;09.03.2017;2017;03;22;Torstai;2;1;3
626;09.03.2017;2017;03;23;Torstai;2;0;2
626;10.03.2017;2017;03;00;Perjantai;1;0;1
626;10.03.2017;2017;03;01;Perjantai;1;1;2
626;10.03.2017;2017;03;02;Perjantai;0;1;1
626;10.03.2017;2017;03;03;Perjantai;1;0;1
626;10.03.2017;2017;03;04;Perjantai;0;2;2
626;10.03.2017;2017;03;05;Perjantai;2;2;4
626;10.03.2017;2017;03;06;Perjantai;2;1;3
626;10.03.2017;2017;03;07;Perjantai;1;10;11
626;10.03.2017;2017;03;08;Perjantai;2;10;12
626;10.03.2017;2017;03;09;Perjantai;5;9;14
626;10.03.2017;2017;03;10;Perjantai;2;6;8
626;10.03.2017;2017;03;11;Perjantai;0;0;0
626;10.03.2017;2017;03;12;Perjantai;0;3;3
626;10.03.2017;2017;03;13;Perjantai;2;4;6
626;10.03.2017;2017;03;14;Perjantai;5;4;9
626;10.03.2017;2017;03;15;Perjantai;5;7;12
626;10.03.2017;2017;03;16;Perjantai;11;5;16
626;10.03.2017;2017;03;17;Perjantai;8;8;16
626;10.03.2017;2017;03;18;Perjantai;6;5;11
626;10.03.2017;2017;03;19;Perjantai;5;4;9
626;10.03.2017;2017;03;20;Perjantai;3;1;4
626;10.03.2017;2017;03;21;Perjantai;0;0;0
626;10.03.2017;2017;03;22;Perjantai;2;1;3
626;10.03.2017;2017;03;23;Perjantai;1;0;1
626;11.03.2017;2017;03;00;Lauantai;0;0;0
626;11.03.2017;2017;03;01;Lauantai;0;0;0
626;11.03.2017;2017;03;02;Lauantai;0;0;0
626;11.03.2017;2017;03;03;Lauantai;0;0;0
626;11.03.2017;2017;03;04;Lauantai;0;0;0
626;11.03.2017;2017;03;05;Lauantai;0;0;0
626;11.03.2017;2017;03;06;Lauantai;0;1;1
626;11.03.2017;2017;03;07;Lauantai;0;3;3
626;11.03.2017;2017;03;08;Lauantai;0;1;1
626;11.03.2017;2017;03;09;Lauantai;1;0;1
626;11.03.2017;2017;03;10;Lauantai;1;6;7
626;11.03.2017;2017;03;11;Lauantai;4;7;11
626;11.03.2017;2017;03;12;Lauantai;4;2;6
626;11.03.2017;2017;03;13;Lauantai;5;7;12
626;11.03.2017;2017;03;14;Lauantai;5;5;10
626;11.03.2017;2017;03;15;Lauantai;7;10;17
626;11.03.2017;2017;03;16;Lauantai;8;5;13
626;11.03.2017;2017;03;17;Lauantai;4;5;9
626;11.03.2017;2017;03;18;Lauantai;7;3;10
626;11.03.2017;2017;03;19;Lauantai;1;5;6
626;11.03.2017;2017;03;20;Lauantai;0;3;3
626;11.03.2017;2017;03;21;Lauantai;2;0;2
626;11.03.2017;2017;03;22;Lauantai;0;0;0
626;11.03.2017;2017;03;23;Lauantai;2;0;2
626;12.03.2017;2017;03;00;Sunnuntai;0;1;1
626;12.03.2017;2017;03;01;Sunnuntai;0;1;1
626;12.03.2017;2017;03;02;Sunnuntai;1;0;1
626;12.03.2017;2017;03;03;Sunnuntai;1;0;1
626;12.03.2017;2017;03;04;Sunnuntai;0;0;0
626;12.03.2017;2017;03;05;Sunnuntai;1;0;1
626;12.03.2017;2017;03;06;Sunnuntai;0;0;0
626;12.03.2017;2017;03;07;Sunnuntai;0;2;2
626;12.03.2017;2017;03;08;Sunnuntai;1;1;2
626;12.03.2017;2017;03;09;Sunnuntai;0;0;0
626;12.03.2017;2017;03;10;Sunnuntai;1;3;4
626;12.03.2017;2017;03;11;Sunnuntai;3;3;6
626;12.03.2017;2017;03;12;Sunnuntai;4;7;11
626;12.03.2017;2017;03;13;Sunnuntai;5;6;11
626;12.03.2017;2017;03;14;Sunnuntai;2;8;10
626;12.03.2017;2017;03;15;Sunnuntai;6;2;8
626;12.03.2017;2017;03;16;Sunnuntai;5;7;12
626;12.03.2017;2017;03;17;Sunnuntai;5;4;9
626;12.03.2017;2017;03;18;Sunnuntai;3;2;5
626;12.03.2017;2017;03;19;Sunnuntai;4;5;9
626;12.03.2017;2017;03;20;Sunnuntai;1;2;3
626;12.03.2017;2017;03;21;Sunnuntai;0;2;2
626;12.03.2017;2017;03;22;Sunnuntai;2;1;3
626;12.03.2017;2017;03;23;Sunnuntai;0;1;1
626;13.03.2017;2017;03;00;Maanantai;1;1;2
626;13.03.2017;2017;03;01;Maanantai;4;1;5
626;13.03.2017;2017;03;02;Maanantai;0;0;0
626;13.03.2017;2017;03;03;Maanantai;0;0;0
626;13.03.2017;2017;03;04;Maanantai;0;0;0
626;13.03.2017;2017;03;05;Maanantai;0;2;2
626;13.03.2017;2017;03;06;Maanantai;4;4;8
626;13.03.2017;2017;03;07;Maanantai;4;23;27
626;13.03.2017;2017;03;08;Maanantai;7;31;38
626;13.03.2017;2017;03;09;Maanantai;10;26;36
626;13.03.2017;2017;03;10;Maanantai;8;7;15
626;13.03.2017;2017;03;11;Maanantai;4;3;7
626;13.03.2017;2017;03;12;Maanantai;6;8;14
626;13.03.2017;2017;03;13;Maanantai;4;6;10
626;13.03.2017;2017;03;14;Maanantai;8;10;18
626;13.03.2017;2017;03;15;Maanantai;8;10;18
626;13.03.2017;2017;03;16;Maanantai;22;12;34
626;13.03.2017;2017;03;17;Maanantai;24;15;39
626;13.03.2017;2017;03;18;Maanantai;23;11;34
626;13.03.2017;2017;03;19;Maanantai;7;4;11
626;13.03.2017;2017;03;20;Maanantai;9;4;13
626;13.03.2017;2017;03;21;Maanantai;4;1;5
626;13.03.2017;2017;03;22;Maanantai;1;2;3
626;13.03.2017;2017;03;23;Maanantai;2;0;2
626;14.03.2017;2017;03;00;Tiistai;0;0;0
626;14.03.2017;2017;03;01;Tiistai;0;1;1
626;14.03.2017;2017;03;02;Tiistai;0;0;0
626;14.03.2017;2017;03;03;Tiistai;0;0;0
626;14.03.2017;2017;03;04;Tiistai;0;0;0
626;14.03.2017;2017;03;05;Tiistai;0;0;0
626;14.03.2017;2017;03;06;Tiistai;0;6;6
626;14.03.2017;2017;03;07;Tiistai;3;23;26
626;14.03.2017;2017;03;08;Tiistai;6;39;45
626;14.03.2017;2017;03;09;Tiistai;8;12;20
626;14.03.2017;2017;03;10;Tiistai;3;11;14
626;14.03.2017;2017;03;11;Tiistai;0;1;1
626;14.03.2017;2017;03;12;Tiistai;1;3;4
626;14.03.2017;2017;03;13;Tiistai;5;3;8
626;14.03.2017;2017;03;14;Tiistai;8;3;11
626;14.03.2017;2017;03;15;Tiistai;12;2;14
626;14.03.2017;2017;03;16;Tiistai;13;11;24
626;14.03.2017;2017;03;17;Tiistai;23;10;33
626;14.03.2017;2017;03;18;Tiistai;13;4;17
626;14.03.2017;2017;03;19;Tiistai;7;1;8
626;14.03.2017;2017;03;20;Tiistai;4;2;6
626;14.03.2017;2017;03;21;Tiistai;4;3;7
626;14.03.2017;2017;03;22;Tiistai;1;2;3
626;14.03.2017;2017;03;23;Tiistai;2;2;4
626;15.03.2017;2017;03;00;Keskiviikko;0;1;1
626;15.03.2017;2017;03;01;Keskiviikko;1;0;1
626;15.03.2017;2017;03;02;Keskiviikko;0;0;0
626;15.03.2017;2017;03;03;Keskiviikko;0;0;0
626;15.03.2017;2017;03;04;Keskiviikko;0;0;0
626;15.03.2017;2017;03;05;Keskiviikko;0;0;0
626;15.03.2017;2017;03;06;Keskiviikko;1;5;6
626;15.03.2017;2017;03;07;Keskiviikko;3;13;16
626;15.03.2017;2017;03;08;Keskiviikko;3;23;26
626;15.03.2017;2017;03;09;Keskiviikko;9;7;16
626;15.03.2017;2017;03;10;Keskiviikko;3;8;11
626;15.03.2017;2017;03;11;Keskiviikko;2;4;6
626;15.03.2017;2017;03;12;Keskiviikko;4;0;4
626;15.03.2017;2017;03;13;Keskiviikko;3;2;5
626;15.03.2017;2017;03;14;Keskiviikko;3;3;6
626;15.03.2017;2017;03;15;Keskiviikko;15;6;21
626;15.03.2017;2017;03;16;Keskiviikko;12;9;21
626;15.03.2017;2017;03;17;Keskiviikko;17;10;27
626;15.03.2017;2017;03;18;Keskiviikko;5;8;13
626;15.03.2017;2017;03;19;Keskiviikko;13;2;15
626;15.03.2017;2017;03;20;Keskiviikko;7;2;9
626;15.03.2017;2017;03;21;Keskiviikko;3;1;4
626;15.03.2017;2017;03;22;Keskiviikko;2;0;2
626;15.03.2017;2017;03;23;Keskiviikko;0;0;0
626;16.03.2017;2017;03;00;Torstai;0;0;0
626;16.03.2017;2017;03;01;Torstai;1;1;2
626;16.03.2017;2017;03;02;Torstai;0;0;0
626;16.03.2017;2017;03;03;Torstai;0;0;0
626;16.03.2017;2017;03;04;Torstai;0;0;0
626;16.03.2017;2017;03;05;Torstai;0;0;0
626;16.03.2017;2017;03;06;Torstai;0;5;5
626;16.03.2017;2017;03;07;Torstai;5;16;21
626;16.03.2017;2017;03;08;Torstai;9;31;40
626;16.03.2017;2017;03;09;Torstai;7;19;26
626;16.03.2017;2017;03;10;Torstai;5;5;10
626;16.03.2017;2017;03;11;Torstai;2;8;10
626;16.03.2017;2017;03;12;Torstai;4;6;10
626;16.03.2017;2017;03;13;Torstai;4;6;10
626;16.03.2017;2017;03;14;Torstai;10;2;12
626;16.03.2017;2017;03;15;Torstai;9;4;13
626;16.03.2017;2017;03;16;Torstai;9;15;24
626;16.03.2017;2017;03;17;Torstai;22;14;36
626;16.03.2017;2017;03;18;Torstai;13;8;21
626;16.03.2017;2017;03;19;Torstai;9;2;11
626;16.03.2017;2017;03;20;Torstai;8;3;11
626;16.03.2017;2017;03;21;Torstai;3;0;3
626;16.03.2017;2017;03;22;Torstai;4;3;7
626;16.03.2017;2017;03;23;Torstai;0;1;1
626;17.03.2017;2017;03;00;Perjantai;0;2;2
626;17.03.2017;2017;03;01;Perjantai;1;0;1
626;17.03.2017;2017;03;02;Perjantai;0;0;0
626;17.03.2017;2017;03;03;Perjantai;0;0;0
626;17.03.2017;2017;03;04;Perjantai;0;0;0
626;17.03.2017;2017;03;05;Perjantai;0;0;0
626;17.03.2017;2017;03;06;Perjantai;1;5;6
626;17.03.2017;2017;03;07;Perjantai;2;5;7
626;17.03.2017;2017;03;08;Perjantai;6;17;23
626;17.03.2017;2017;03;09;Perjantai;4;8;12
626;17.03.2017;2017;03;10;Perjantai;4;2;6
626;17.03.2017;2017;03;11;Perjantai;0;2;2
626;17.03.2017;2017;03;12;Perjantai;1;4;5
626;17.03.2017;2017;03;13;Perjantai;1;5;6
626;17.03.2017;2017;03;14;Perjantai;3;5;8
626;17.03.2017;2017;03;15;Perjantai;7;5;12
626;17.03.2017;2017;03;16;Perjantai;7;2;9
626;17.03.2017;2017;03;17;Perjantai;9;4;13
626;17.03.2017;2017;03;18;Perjantai;9;1;10
626;17.03.2017;2017;03;19;Perjantai;4;1;5
626;17.03.2017;2017;03;20;Perjantai;1;1;2
626;17.03.2017;2017;03;21;Perjantai;3;0;3
626;17.03.2017;2017;03;22;Perjantai;1;0;1
626;17.03.2017;2017;03;23;Perjantai;2;1;3
626;18.03.2017;2017;03;00;Lauantai;0;0;0
626;18.03.2017;2017;03;01;Lauantai;0;0;0
626;18.03.2017;2017;03;02;Lauantai;0;1;1
626;18.03.2017;2017;03;03;Lauantai;2;0;2
626;18.03.2017;2017;03;04;Lauantai;1;0;1
626;18.03.2017;2017;03;05;Lauantai;0;0;0
626;18.03.2017;2017;03;06;Lauantai;1;1;2
626;18.03.2017;2017;03;07;Lauantai;0;1;1
626;18.03.2017;2017;03;08;Lauantai;1;1;2
626;18.03.2017;2017;03;09;Lauantai;1;1;2
626;18.03.2017;2017;03;10;Lauantai;0;0;0
626;18.03.2017;2017;03;11;Lauantai;0;5;5
626;18.03.2017;2017;03;12;Lauantai;2;8;10
626;18.03.2017;2017;03;13;Lauantai;3;6;9
626;18.03.2017;2017;03;14;Lauantai;1;5;6
626;18.03.2017;2017;03;15;Lauantai;5;7;12
626;18.03.2017;2017;03;16;Lauantai;5;2;7
626;18.03.2017;2017;03;17;Lauantai;5;4;9
626;18.03.2017;2017;03;18;Lauantai;7;2;9
626;18.03.2017;2017;03;19;Lauantai;0;2;2
626;18.03.2017;2017;03;20;Lauantai;1;2;3
626;18.03.2017;2017;03;21;Lauantai;0;0;0
626;18.03.2017;2017;03;22;Lauantai;0;0;0
626;18.03.2017;2017;03;23;Lauantai;1;0;1
626;19.03.2017;2017;03;00;Sunnuntai;2;0;2
626;19.03.2017;2017;03;01;Sunnuntai;0;1;1
626;19.03.2017;2017;03;02;Sunnuntai;1;0;1
626;19.03.2017;2017;03;03;Sunnuntai;0;0;0
626;19.03.2017;2017;03;04;Sunnuntai;1;0;1
626;19.03.2017;2017;03;05;Sunnuntai;0;0;0
626;19.03.2017;2017;03;06;Sunnuntai;0;2;2
626;19.03.2017;2017;03;07;Sunnuntai;1;2;3
626;19.03.2017;2017;03;08;Sunnuntai;0;3;3
626;19.03.2017;2017;03;09;Sunnuntai;2;1;3
626;19.03.2017;2017;03;10;Sunnuntai;0;4;4
626;19.03.2017;2017;03;11;Sunnuntai;3;5;8
626;19.03.2017;2017;03;12;Sunnuntai;3;4;7
626;19.03.2017;2017;03;13;Sunnuntai;1;2;3
626;19.03.2017;2017;03;14;Sunnuntai;9;7;16
626;19.03.2017;2017;03;15;Sunnuntai;2;4;6
626;19.03.2017;2017;03;16;Sunnuntai;0;6;6
626;19.03.2017;2017;03;17;Sunnuntai;3;5;8
626;19.03.2017;2017;03;18;Sunnuntai;5;3;8
626;19.03.2017;2017;03;19;Sunnuntai;2;6;8
626;19.03.2017;2017;03;20;Sunnuntai;0;0;0
626;19.03.2017;2017;03;21;Sunnuntai;4;4;8
626;19.03.2017;2017;03;22;Sunnuntai;0;0;0
626;19.03.2017;2017;03;23;Sunnuntai;3;0;3
626;20.03.2017;2017;03;00;Maanantai;0;0;0
626;20.03.2017;2017;03;01;Maanantai;0;0;0
626;20.03.2017;2017;03;02;Maanantai;0;0;0
626;20.03.2017;2017;03;03;Maanantai;0;0;0
626;20.03.2017;2017;03;04;Maanantai;0;0;0
626;20.03.2017;2017;03;05;Maanantai;0;1;1
626;20.03.2017;2017;03;06;Maanantai;1;7;8
626;20.03.2017;2017;03;07;Maanantai;2;19;21
626;20.03.2017;2017;03;08;Maanantai;6;20;26
626;20.03.2017;2017;03;09;Maanantai;9;22;31
626;20.03.2017;2017;03;10;Maanantai;3;5;8
626;20.03.2017;2017;03;11;Maanantai;4;5;9
626;20.03.2017;2017;03;12;Maanantai;2;4;6
626;20.03.2017;2017;03;13;Maanantai;1;6;7
626;20.03.2017;2017;03;14;Maanantai;4;6;10
626;20.03.2017;2017;03;15;Maanantai;7;3;10
626;20.03.2017;2017;03;16;Maanantai;12;10;22
626;20.03.2017;2017;03;17;Maanantai;23;13;36
626;20.03.2017;2017;03;18;Maanantai;10;6;16
626;20.03.2017;2017;03;19;Maanantai;14;4;18
626;20.03.2017;2017;03;20;Maanantai;3;1;4
626;20.03.2017;2017;03;21;Maanantai;5;1;6
626;20.03.2017;2017;03;22;Maanantai;2;4;6
626;20.03.2017;2017;03;23;Maanantai;3;2;5
626;21.03.2017;2017;03;00;Tiistai;0;0;0
626;21.03.2017;2017;03;01;Tiistai;0;0;0
626;21.03.2017;2017;03;02;Tiistai;0;0;0
626;21.03.2017;2017;03;03;Tiistai;0;0;0
626;21.03.2017;2017;03;04;Tiistai;0;0;0
626;21.03.2017;2017;03;05;Tiistai;0;2;2
626;21.03.2017;2017;03;06;Tiistai;3;4;7
626;21.03.2017;2017;03;07;Tiistai;3;18;21
626;21.03.2017;2017;03;08;Tiistai;8;34;42
626;21.03.2017;2017;03;09;Tiistai;9;21;30
626;21.03.2017;2017;03;10;Tiistai;4;7;11
626;21.03.2017;2017;03;11;Tiistai;6;6;12
626;21.03.2017;2017;03;12;Tiistai;2;8;10
626;21.03.2017;2017;03;13;Tiistai;10;4;14
626;21.03.2017;2017;03;14;Tiistai;3;7;10
626;21.03.2017;2017;03;15;Tiistai;9;6;15
626;21.03.2017;2017;03;16;Tiistai;14;13;27
626;21.03.2017;2017;03;17;Tiistai;21;12;33
626;21.03.2017;2017;03;18;Tiistai;18;8;26
626;21.03.2017;2017;03;19;Tiistai;10;7;17
626;21.03.2017;2017;03;20;Tiistai;3;2;5
626;21.03.2017;2017;03;21;Tiistai;5;5;10
626;21.03.2017;2017;03;22;Tiistai;4;4;8
626;21.03.2017;2017;03;23;Tiistai;4;0;4
626;22.03.2017;2017;03;00;Keskiviikko;1;0;1
626;22.03.2017;2017;03;01;Keskiviikko;0;1;1
626;22.03.2017;2017;03;02;Keskiviikko;0;0;0
626;22.03.2017;2017;03;03;Keskiviikko;0;0;0
626;22.03.2017;2017;03;04;Keskiviikko;0;0;0
626;22.03.2017;2017;03;05;Keskiviikko;0;3;3
626;22.03.2017;2017;03;06;Keskiviikko;4;2;6
626;22.03.2017;2017;03;07;Keskiviikko;2;17;19
626;22.03.2017;2017;03;08;Keskiviikko;4;29;33
626;22.03.2017;2017;03;09;Keskiviikko;10;10;20
626;22.03.2017;2017;03;10;Keskiviikko;1;9;10
626;22.03.2017;2017;03;11;Keskiviikko;2;4;6
626;22.03.2017;2017;03;12;Keskiviikko;4;7;11
626;22.03.2017;2017;03;13;Keskiviikko;5;4;9
626;22.03.2017;2017;03;14;Keskiviikko;7;6;13
626;22.03.2017;2017;03;15;Keskiviikko;5;6;11
626;22.03.2017;2017;03;16;Keskiviikko;16;5;21
626;22.03.2017;2017;03;17;Keskiviikko;20;13;33
626;22.03.2017;2017;03;18;Keskiviikko;7;6;13
626;22.03.2017;2017;03;19;Keskiviikko;3;4;7
626;22.03.2017;2017;03;20;Keskiviikko;5;6;11
626;22.03.2017;2017;03;21;Keskiviikko;4;3;7
626;22.03.2017;2017;03;22;Keskiviikko;1;1;2
626;22.03.2017;2017;03;23;Keskiviikko;3;0;3
626;23.03.2017;2017;03;00;Torstai;2;1;3
626;23.03.2017;2017;03;01;Torstai;0;0;0
626;23.03.2017;2017;03;02;Torstai;0;0;0
626;23.03.2017;2017;03;03;Torstai;0;0;0
626;23.03.2017;2017;03;04;Torstai;0;0;0
626;23.03.2017;2017;03;05;Torstai;1;2;3
626;23.03.2017;2017;03;06;Torstai;1;4;5
626;23.03.2017;2017;03;07;Torstai;2;21;23
626;23.03.2017;2017;03;08;Torstai;9;28;37
626;23.03.2017;2017;03;09;Torstai;9;18;27
626;23.03.2017;2017;03;10;Torstai;1;1;2
626;23.03.2017;2017;03;11;Torstai;4;5;9
626;23.03.2017;2017;03;12;Torstai;2;7;9
626;23.03.2017;2017;03;13;Torstai;2;7;9
626;23.03.2017;2017;03;14;Torstai;8;13;21
626;23.03.2017;2017;03;15;Torstai;12;2;14
626;23.03.2017;2017;03;16;Torstai;17;10;27
626;23.03.2017;2017;03;17;Torstai;20;14;34
626;23.03.2017;2017;03;18;Torstai;22;5;27
626;23.03.2017;2017;03;19;Torstai;8;2;10
626;23.03.2017;2017;03;20;Torstai;2;4;6
626;23.03.2017;2017;03;21;Torstai;0;1;1
626;23.03.2017;2017;03;22;Torstai;3;1;4
626;23.03.2017;2017;03;23;Torstai;1;0;1
626;24.03.2017;2017;03;00;Perjantai;1;1;2
626;24.03.2017;2017;03;01;Perjantai;0;0;0
626;24.03.2017;2017;03;02;Perjantai;0;0;0
626;24.03.2017;2017;03;03;Perjantai;0;0;0
626;24.03.2017;2017;03;04;Perjantai;1;0;1
626;24.03.2017;2017;03;05;Perjantai;0;1;1
626;24.03.2017;2017;03;06;Perjantai;3;4;7
626;24.03.2017;2017;03;07;Perjantai;3;16;19
626;24.03.2017;2017;03;08;Perjantai;7;20;27
626;24.03.2017;2017;03;09;Perjantai;12;14;26
626;24.03.2017;2017;03;10;Perjantai;5;7;12
626;24.03.2017;2017;03;11;Perjantai;2;5;7
626;24.03.2017;2017;03;12;Perjantai;2;8;10
626;24.03.2017;2017;03;13;Perjantai;6;9;15
626;24.03.2017;2017;03;14;Perjantai;2;5;7
626;24.03.2017;2017;03;15;Perjantai;11;5;16
626;24.03.2017;2017;03;16;Perjantai;19;14;33
626;24.03.2017;2017;03;17;Perjantai;10;8;18
626;24.03.2017;2017;03;18;Perjantai;8;6;14
626;24.03.2017;2017;03;19;Perjantai;2;6;8
626;24.03.2017;2017;03;20;Perjantai;4;1;5
626;24.03.2017;2017;03;21;Perjantai;4;3;7
626;24.03.2017;2017;03;22;Perjantai;1;0;1
626;24.03.2017;2017;03;23;Perjantai;1;2;3
626;25.03.2017;2017;03;00;Lauantai;1;2;3
626;25.03.2017;2017;03;01;Lauantai;0;0;0
626;25.03.2017;2017;03;02;Lauantai;2;0;2
626;25.03.2017;2017;03;03;Lauantai;1;0;1
626;25.03.2017;2017;03;04;Lauantai;0;0;0
626;25.03.2017;2017;03;05;Lauantai;0;0;0
626;25.03.2017;2017;03;06;Lauantai;1;0;1
626;25.03.2017;2017;03;07;Lauantai;0;2;2
626;25.03.2017;2017;03;08;Lauantai;1;1;2
626;25.03.2017;2017;03;09;Lauantai;2;1;3
626;25.03.2017;2017;03;10;Lauantai;2;6;8
626;25.03.2017;2017;03;11;Lauantai;4;4;8
626;25.03.2017;2017;03;12;Lauantai;6;5;11
626;25.03.2017;2017;03;13;Lauantai;14;10;24
626;25.03.2017;2017;03;14;Lauantai;3;11;14
626;25.03.2017;2017;03;15;Lauantai;7;6;13
626;25.03.2017;2017;03;16;Lauantai;11;7;18
626;25.03.2017;2017;03;17;Lauantai;5;2;7
626;25.03.2017;2017;03;18;Lauantai;10;7;17
626;25.03.2017;2017;03;19;Lauantai;2;6;8
626;25.03.2017;2017;03;20;Lauantai;0;6;6
626;25.03.2017;2017;03;21;Lauantai;1;0;1
626;25.03.2017;2017;03;22;Lauantai;1;1;2
626;25.03.2017;2017;03;23;Lauantai;3;0;3
626;26.03.2017;2017;03;00;Sunnuntai;1;1;2
626;26.03.2017;2017;03;01;Sunnuntai;2;1;3
626;26.03.2017;2017;03;02;Sunnuntai;0;0;0
626;26.03.2017;2017;03;03;Sunnuntai;0;0;0
626;26.03.2017;2017;03;04;Sunnuntai;0;0;0
626;26.03.2017;2017;03;05;Sunnuntai;1;0;1
626;26.03.2017;2017;03;06;Sunnuntai;0;0;0
626;26.03.2017;2017;03;07;Sunnuntai;0;2;2
626;26.03.2017;2017;03;08;Sunnuntai;0;2;2
626;26.03.2017;2017;03;09;Sunnuntai;1;0;1
626;26.03.2017;2017;03;10;Sunnuntai;4;2;6
626;26.03.2017;2017;03;11;Sunnuntai;1;2;3
626;26.03.2017;2017;03;12;Sunnuntai;3;10;13
626;26.03.2017;2017;03;13;Sunnuntai;4;2;6
626;26.03.2017;2017;03;14;Sunnuntai;8;13;21
626;26.03.2017;2017;03;15;Sunnuntai;7;8;15
626;26.03.2017;2017;03;16;Sunnuntai;3;5;8
626;26.03.2017;2017;03;17;Sunnuntai;8;4;12
626;26.03.2017;2017;03;18;Sunnuntai;6;13;19
626;26.03.2017;2017;03;19;Sunnuntai;4;8;12
626;26.03.2017;2017;03;20;Sunnuntai;2;3;5
626;26.03.2017;2017;03;21;Sunnuntai;5;5;10
626;26.03.2017;2017;03;22;Sunnuntai;2;0;2
626;26.03.2017;2017;03;23;Sunnuntai;0;1;1
626;27.03.2017;2017;03;00;Maanantai;0;0;0
626;27.03.2017;2017;03;01;Maanantai;0;0;0
626;27.03.2017;2017;03;02;Maanantai;0;0;0
626;27.03.2017;2017;03;03;Maanantai;0;0;0
626;27.03.2017;2017;03;04;Maanantai;0;0;0
626;27.03.2017;2017;03;05;Maanantai;0;2;2
626;27.03.2017;2017;03;06;Maanantai;4;7;11
626;27.03.2017;2017;03;07;Maanantai;4;24;28
626;27.03.2017;2017;03;08;Maanantai;11;32;43
626;27.03.2017;2017;03;09;Maanantai;9;16;25
626;27.03.2017;2017;03;10;Maanantai;1;14;15
626;27.03.2017;2017;03;11;Maanantai;6;5;11
626;27.03.2017;2017;03;12;Maanantai;4;4;8
626;27.03.2017;2017;03;13;Maanantai;6;5;11
626;27.03.2017;2017;03;14;Maanantai;8;10;18
626;27.03.2017;2017;03;15;Maanantai;15;4;19
626;27.03.2017;2017;03;16;Maanantai;13;13;26
626;27.03.2017;2017;03;17;Maanantai;31;14;45
626;27.03.2017;2017;03;18;Maanantai;9;5;14
626;27.03.2017;2017;03;19;Maanantai;17;3;20
626;27.03.2017;2017;03;20;Maanantai;8;2;10
626;27.03.2017;2017;03;21;Maanantai;2;3;5
626;27.03.2017;2017;03;22;Maanantai;4;2;6
626;27.03.2017;2017;03;23;Maanantai;2;5;7
626;28.03.2017;2017;03;00;Tiistai;0;1;1
626;28.03.2017;2017;03;01;Tiistai;0;0;0
626;28.03.2017;2017;03;02;Tiistai;0;0;0
626;28.03.2017;2017;03;03;Tiistai;0;0;0
626;28.03.2017;2017;03;04;Tiistai;0;0;0
626;28.03.2017;2017;03;05;Tiistai;0;3;3
626;28.03.2017;2017;03;06;Tiistai;2;9;11
626;28.03.2017;2017;03;07;Tiistai;3;16;19
626;28.03.2017;2017;03;08;Tiistai;8;30;38
626;28.03.2017;2017;03;09;Tiistai;8;17;25
626;28.03.2017;2017;03;10;Tiistai;3;12;15
626;28.03.2017;2017;03;11;Tiistai;8;8;16
626;28.03.2017;2017;03;12;Tiistai;5;9;14
626;28.03.2017;2017;03;13;Tiistai;5;9;14
626;28.03.2017;2017;03;14;Tiistai;4;3;7
626;28.03.2017;2017;03;15;Tiistai;18;12;30
626;28.03.2017;2017;03;16;Tiistai;9;7;16
626;28.03.2017;2017;03;17;Tiistai;22;10;32
626;28.03.2017;2017;03;18;Tiistai;16;6;22
626;28.03.2017;2017;03;19;Tiistai;4;4;8
626;28.03.2017;2017;03;20;Tiistai;6;4;10
626;28.03.2017;2017;03;21;Tiistai;8;1;9
626;28.03.2017;2017;03;22;Tiistai;5;3;8
626;28.03.2017;2017;03;23;Tiistai;4;5;9
626;29.03.2017;2017;03;00;Keskiviikko;1;0;1
626;29.03.2017;2017;03;01;Keskiviikko;0;0;0
626;29.03.2017;2017;03;02;Keskiviikko;0;0;0
626;29.03.2017;2017;03;03;Keskiviikko;0;0;0
626;29.03.2017;2017;03;04;Keskiviikko;0;0;0
626;29.03.2017;2017;03;05;Keskiviikko;0;2;2
626;29.03.2017;2017;03;06;Keskiviikko;6;3;9
626;29.03.2017;2017;03;07;Keskiviikko;4;24;28
626;29.03.2017;2017;03;08;Keskiviikko;6;34;40
626;29.03.2017;2017;03;09;Keskiviikko;7;14;21
626;29.03.2017;2017;03;10;Keskiviikko;1;8;9
626;29.03.2017;2017;03;11;Keskiviikko;2;7;9
626;29.03.2017;2017;03;12;Keskiviikko;2;4;6
626;29.03.2017;2017;03;13;Keskiviikko;3;8;11
626;29.03.2017;2017;03;14;Keskiviikko;12;7;19
626;29.03.2017;2017;03;15;Keskiviikko;12;10;22
626;29.03.2017;2017;03;16;Keskiviikko;16;15;31
626;29.03.2017;2017;03;17;Keskiviikko;14;10;24
626;29.03.2017;2017;03;18;Keskiviikko;19;7;26
626;29.03.2017;2017;03;19;Keskiviikko;7;0;7
626;29.03.2017;2017;03;20;Keskiviikko;6;4;10
626;29.03.2017;2017;03;21;Keskiviikko;3;2;5
626;29.03.2017;2017;03;22;Keskiviikko;4;1;5
626;29.03.2017;2017;03;23;Keskiviikko;2;4;6
626;30.03.2017;2017;03;00;Torstai;1;1;2
626;30.03.2017;2017;03;01;Torstai;0;0;0
626;30.03.2017;2017;03;02;Torstai;0;0;0
626;30.03.2017;2017;03;03;Torstai;1;0;1
626;30.03.2017;2017;03;04;Torstai;0;0;0
626;30.03.2017;2017;03;05;Torstai;0;3;3
626;30.03.2017;2017;03;06;Torstai;2;5;7
626;30.03.2017;2017;03;07;Torstai;4;14;18
626;30.03.2017;2017;03;08;Torstai;11;28;39
626;30.03.2017;2017;03;09;Torstai;9;19;28
626;30.03.2017;2017;03;10;Torstai;6;7;13
626;30.03.2017;2017;03;11;Torstai;4;10;14
626;30.03.2017;2017;03;12;Torstai;5;4;9
626;30.03.2017;2017;03;13;Torstai;9;13;22
626;30.03.2017;2017;03;14;Torstai;7;9;16
626;30.03.2017;2017;03;15;Torstai;13;9;22
626;30.03.2017;2017;03;16;Torstai;11;13;24
626;30.03.2017;2017;03;17;Torstai;22;23;45
626;30.03.2017;2017;03;18;Torstai;11;10;21
626;30.03.2017;2017;03;19;Torstai;10;5;15
626;30.03.2017;2017;03;20;Torstai;8;4;12
626;30.03.2017;2017;03;21;Torstai;4;1;5
626;30.03.2017;2017;03;22;Torstai;10;1;11
626;30.03.2017;2017;03;23;Torstai;4;4;8
626;31.03.2017;2017;03;00;Perjantai;1;1;2
626;31.03.2017;2017;03;01;Perjantai;1;0;1
626;31.03.2017;2017;03;02;Perjantai;0;0;0
626;31.03.2017;2017;03;03;Perjantai;1;0;1
626;31.03.2017;2017;03;04;Perjantai;0;0;0
626;31.03.2017;2017;03;05;Perjantai;0;3;3
626;31.03.2017;2017;03;06;Perjantai;2;7;9
626;31.03.2017;2017;03;07;Perjantai;4;13;17
626;31.03.2017;2017;03;08;Perjantai;5;27;32
626;31.03.2017;2017;03;09;Perjantai;14;19;33
626;31.03.2017;2017;03;10;Perjantai;3;6;9
626;31.03.2017;2017;03;11;Perjantai;3;4;7
626;31.03.2017;2017;03;12;Perjantai;7;5;12
626;31.03.2017;2017;03;13;Perjantai;4;10;14
626;31.03.2017;2017;03;14;Perjantai;8;13;21
626;31.03.2017;2017;03;15;Perjantai;10;9;19
626;31.03.2017;2017;03;16;Perjantai;13;13;26
626;31.03.2017;2017;03;17;Perjantai;24;9;33
626;31.03.2017;2017;03;18;Perjantai;7;5;12
626;31.03.2017;2017;03;19;Perjantai;13;6;19
626;31.03.2017;2017;03;20;Perjantai;6;2;8
626;31.03.2017;2017;03;21;Perjantai;6;3;9
626;31.03.2017;2017;03;22;Perjantai;7;0;7
626;31.03.2017;2017;03;23;Perjantai;0;1;1
626;01.04.2017;2017;04;00;Lauantai;0;0;0
626;01.04.2017;2017;04;01;Lauantai;3;1;4
626;01.04.2017;2017;04;02;Lauantai;1;1;2
626;01.04.2017;2017;04;03;Lauantai;0;0;0
626;01.04.2017;2017;04;04;Lauantai;0;1;1
626;01.04.2017;2017;04;05;Lauantai;2;0;2
626;01.04.2017;2017;04;06;Lauantai;1;1;2
626;01.04.2017;2017;04;07;Lauantai;0;2;2
626;01.04.2017;2017;04;08;Lauantai;2;1;3
626;01.04.2017;2017;04;09;Lauantai;0;1;1
626;01.04.2017;2017;04;10;Lauantai;0;9;9
626;01.04.2017;2017;04;11;Lauantai;1;3;4
626;01.04.2017;2017;04;12;Lauantai;2;3;5
626;01.04.2017;2017;04;13;Lauantai;5;6;11
626;01.04.2017;2017;04;14;Lauantai;10;4;14
626;01.04.2017;2017;04;15;Lauantai;6;4;10
626;01.04.2017;2017;04;16;Lauantai;1;6;7
626;01.04.2017;2017;04;17;Lauantai;3;5;8
626;01.04.2017;2017;04;18;Lauantai;1;2;3
626;01.04.2017;2017;04;19;Lauantai;2;7;9
626;01.04.2017;2017;04;20;Lauantai;2;0;2
626;01.04.2017;2017;04;21;Lauantai;3;0;3
626;01.04.2017;2017;04;22;Lauantai;3;1;4
626;01.04.2017;2017;04;23;Lauantai;0;1;1
626;02.04.2017;2017;04;00;Sunnuntai;1;1;2
626;02.04.2017;2017;04;01;Sunnuntai;0;0;0
626;02.04.2017;2017;04;02;Sunnuntai;2;0;2
626;02.04.2017;2017;04;03;Sunnuntai;1;0;1
626;02.04.2017;2017;04;04;Sunnuntai;1;0;1
626;02.04.2017;2017;04;05;Sunnuntai;0;0;0
626;02.04.2017;2017;04;06;Sunnuntai;1;1;2
626;02.04.2017;2017;04;07;Sunnuntai;0;1;1
626;02.04.2017;2017;04;08;Sunnuntai;3;0;3
626;02.04.2017;2017;04;09;Sunnuntai;4;0;4
626;02.04.2017;2017;04;10;Sunnuntai;1;3;4
626;02.04.2017;2017;04;11;Sunnuntai;1;0;1
626;02.04.2017;2017;04;12;Sunnuntai;7;5;12
626;02.04.2017;2017;04;13;Sunnuntai;5;10;15
626;02.04.2017;2017;04;14;Sunnuntai;9;9;18
626;02.04.2017;2017;04;15;Sunnuntai;6;7;13
626;02.04.2017;2017;04;16;Sunnuntai;7;4;11
626;02.04.2017;2017;04;17;Sunnuntai;6;4;10
626;02.04.2017;2017;04;18;Sunnuntai;1;7;8
626;02.04.2017;2017;04;19;Sunnuntai;4;5;9
626;02.04.2017;2017;04;20;Sunnuntai;2;3;5
626;02.04.2017;2017;04;21;Sunnuntai;0;5;5
626;02.04.2017;2017;04;22;Sunnuntai;2;2;4
626;02.04.2017;2017;04;23;Sunnuntai;4;0;4
626;03.04.2017;2017;04;00;Maanantai;0;0;0
626;03.04.2017;2017;04;01;Maanantai;0;0;0
626;03.04.2017;2017;04;02;Maanantai;0;0;0
626;03.04.2017;2017;04;03;Maanantai;0;0;0
626;03.04.2017;2017;04;04;Maanantai;0;0;0
626;03.04.2017;2017;04;05;Maanantai;0;5;5
626;03.04.2017;2017;04;06;Maanantai;4;5;9
626;03.04.2017;2017;04;07;Maanantai;2;21;23
626;03.04.2017;2017;04;08;Maanantai;9;32;41
626;03.04.2017;2017;04;09;Maanantai;13;15;28
626;03.04.2017;2017;04;10;Maanantai;2;9;11
626;03.04.2017;2017;04;11;Maanantai;1;1;2
626;03.04.2017;2017;04;12;Maanantai;4;5;9
626;03.04.2017;2017;04;13;Maanantai;5;8;13
626;03.04.2017;2017;04;14;Maanantai;11;8;19
626;03.04.2017;2017;04;15;Maanantai;10;14;24
626;03.04.2017;2017;04;16;Maanantai;13;10;23
626;03.04.2017;2017;04;17;Maanantai;23;23;46
626;03.04.2017;2017;04;18;Maanantai;14;6;20
626;03.04.2017;2017;04;19;Maanantai;12;6;18
626;03.04.2017;2017;04;20;Maanantai;9;3;12
626;03.04.2017;2017;04;21;Maanantai;7;4;11
626;03.04.2017;2017;04;22;Maanantai;5;4;9
626;03.04.2017;2017;04;23;Maanantai;1;0;1
626;04.04.2017;2017;04;00;Tiistai;1;0;1
626;04.04.2017;2017;04;01;Tiistai;0;0;0
626;04.04.2017;2017;04;02;Tiistai;0;0;0
626;04.04.2017;2017;04;03;Tiistai;0;0;0
626;04.04.2017;2017;04;04;Tiistai;0;0;0
626;04.04.2017;2017;04;05;Tiistai;1;3;4
626;04.04.2017;2017;04;06;Tiistai;2;4;6
626;04.04.2017;2017;04;07;Tiistai;3;31;34
626;04.04.2017;2017;04;08;Tiistai;12;35;47
626;04.04.2017;2017;04;09;Tiistai;13;16;29
626;04.04.2017;2017;04;10;Tiistai;3;9;12
626;04.04.2017;2017;04;11;Tiistai;9;10;19
626;04.04.2017;2017;04;12;Tiistai;4;13;17
626;04.04.2017;2017;04;13;Tiistai;10;10;20
626;04.04.2017;2017;04;14;Tiistai;11;13;24
626;04.04.2017;2017;04;15;Tiistai;11;10;21
626;04.04.2017;2017;04;16;Tiistai;18;11;29
626;04.04.2017;2017;04;17;Tiistai;25;21;46
626;04.04.2017;2017;04;18;Tiistai;14;11;25
626;04.04.2017;2017;04;19;Tiistai;8;5;13
626;04.04.2017;2017;04;20;Tiistai;11;6;17
626;04.04.2017;2017;04;21;Tiistai;9;7;16
626;04.04.2017;2017;04;22;Tiistai;9;4;13
626;04.04.2017;2017;04;23;Tiistai;1;3;4
626;05.04.2017;2017;04;00;Keskiviikko;2;0;2
626;05.04.2017;2017;04;01;Keskiviikko;0;0;0
626;05.04.2017;2017;04;02;Keskiviikko;0;0;0
626;05.04.2017;2017;04;03;Keskiviikko;0;0;0
626;05.04.2017;2017;04;04;Keskiviikko;0;0;0
626;05.04.2017;2017;04;05;Keskiviikko;1;2;3
626;05.04.2017;2017;04;06;Keskiviikko;2;2;4
626;05.04.2017;2017;04;07;Keskiviikko;4;29;33
626;05.04.2017;2017;04;08;Keskiviikko;11;38;49
626;05.04.2017;2017;04;09;Keskiviikko;8;22;30
626;05.04.2017;2017;04;10;Keskiviikko;2;5;7
626;05.04.2017;2017;04;11;Keskiviikko;4;10;14
626;05.04.2017;2017;04;12;Keskiviikko;6;8;14
626;05.04.2017;2017;04;13;Keskiviikko;9;12;21
626;05.04.2017;2017;04;14;Keskiviikko;12;14;26
626;05.04.2017;2017;04;15;Keskiviikko;18;9;27
626;05.04.2017;2017;04;16;Keskiviikko;26;15;41
626;05.04.2017;2017;04;17;Keskiviikko;35;25;60
626;05.04.2017;2017;04;18;Keskiviikko;15;11;26
626;05.04.2017;2017;04;19;Keskiviikko;15;5;20
626;05.04.2017;2017;04;20;Keskiviikko;14;4;18
626;05.04.2017;2017;04;21;Keskiviikko;7;5;12
626;05.04.2017;2017;04;22;Keskiviikko;3;3;6
626;05.04.2017;2017;04;23;Keskiviikko;1;2;3
626;06.04.2017;2017;04;00;Torstai;0;0;0
626;06.04.2017;2017;04;01;Torstai;0;1;1
626;06.04.2017;2017;04;02;Torstai;0;0;0
626;06.04.2017;2017;04;03;Torstai;0;0;0
626;06.04.2017;2017;04;04;Torstai;0;0;0
626;06.04.2017;2017;04;05;Torstai;0;4;4
626;06.04.2017;2017;04;06;Torstai;3;4;7
626;06.04.2017;2017;04;07;Torstai;7;27;34
626;06.04.2017;2017;04;08;Torstai;9;38;47
626;06.04.2017;2017;04;09;Torstai;8;29;37
626;06.04.2017;2017;04;10;Torstai;3;9;12
626;06.04.2017;2017;04;11;Torstai;3;6;9
626;06.04.2017;2017;04;12;Torstai;6;9;15
626;06.04.2017;2017;04;13;Torstai;8;14;22
626;06.04.2017;2017;04;14;Torstai;12;5;17
626;06.04.2017;2017;04;15;Torstai;17;9;26
626;06.04.2017;2017;04;16;Torstai;31;14;45
626;06.04.2017;2017;04;17;Torstai;27;17;44
626;06.04.2017;2017;04;18;Torstai;22;8;30
626;06.04.2017;2017;04;19;Torstai;16;5;21
626;06.04.2017;2017;04;20;Torstai;4;5;9
626;06.04.2017;2017;04;21;Torstai;8;6;14
626;06.04.2017;2017;04;22;Torstai;0;1;1
626;06.04.2017;2017;04;23;Torstai;2;2;4
626;07.04.2017;2017;04;00;Perjantai;1;0;1
626;07.04.2017;2017;04;01;Perjantai;1;0;1
626;07.04.2017;2017;04;02;Perjantai;0;0;0
626;07.04.2017;2017;04;03;Perjantai;0;0;0
626;07.04.2017;2017;04;04;Perjantai;0;0;0
626;07.04.2017;2017;04;05;Perjantai;0;1;1
626;07.04.2017;2017;04;06;Perjantai;2;6;8
626;07.04.2017;2017;04;07;Perjantai;6;24;30
626;07.04.2017;2017;04;08;Perjantai;7;29;36
626;07.04.2017;2017;04;09;Perjantai;18;21;39
626;07.04.2017;2017;04;10;Perjantai;3;8;11
626;07.04.2017;2017;04;11;Perjantai;6;8;14
626;07.04.2017;2017;04;12;Perjantai;0;5;5
626;07.04.2017;2017;04;13;Perjantai;11;8;19
626;07.04.2017;2017;04;14;Perjantai;8;10;18
626;07.04.2017;2017;04;15;Perjantai;11;14;25
626;07.04.2017;2017;04;16;Perjantai;31;14;45
626;07.04.2017;2017;04;17;Perjantai;18;22;40
626;07.04.2017;2017;04;18;Perjantai;19;8;27
626;07.04.2017;2017;04;19;Perjantai;9;1;10
626;07.04.2017;2017;04;20;Perjantai;3;5;8
626;07.04.2017;2017;04;21;Perjantai;7;2;9
626;07.04.2017;2017;04;22;Perjantai;2;1;3
626;07.04.2017;2017;04;23;Perjantai;1;2;3
626;08.04.2017;2017;04;00;Lauantai;1;0;1
626;08.04.2017;2017;04;01;Lauantai;1;0;1
626;08.04.2017;2017;04;02;Lauantai;1;0;1
626;08.04.2017;2017;04;03;Lauantai;2;0;2
626;08.04.2017;2017;04;04;Lauantai;1;0;1
626;08.04.2017;2017;04;05;Lauantai;0;1;1
626;08.04.2017;2017;04;06;Lauantai;0;1;1
626;08.04.2017;2017;04;07;Lauantai;0;3;3
626;08.04.2017;2017;04;08;Lauantai;0;1;1
626;08.04.2017;2017;04;09;Lauantai;3;4;7
626;08.04.2017;2017;04;10;Lauantai;3;0;3
626;08.04.2017;2017;04;11;Lauantai;0;0;0
626;08.04.2017;2017;04;12;Lauantai;17;35;52
626;08.04.2017;2017;04;13;Lauantai;14;11;25
626;08.04.2017;2017;04;14;Lauantai;16;20;36
626;08.04.2017;2017;04;15;Lauantai;13;9;22
626;08.04.2017;2017;04;16;Lauantai;10;16;26
626;08.04.2017;2017;04;17;Lauantai;8;12;20
626;08.04.2017;2017;04;18;Lauantai;20;8;28
626;08.04.2017;2017;04;19;Lauantai;10;9;19
626;08.04.2017;2017;04;20;Lauantai;2;3;5
626;08.04.2017;2017;04;21;Lauantai;2;0;2
626;08.04.2017;2017;04;22;Lauantai;2;2;4
626;08.04.2017;2017;04;23;Lauantai;3;2;5
626;09.04.2017;2017;04;00;Sunnuntai;0;1;1
626;09.04.2017;2017;04;01;Sunnuntai;1;0;1
626;09.04.2017;2017;04;02;Sunnuntai;1;0;1
626;09.04.2017;2017;04;03;Sunnuntai;1;0;1
626;09.04.2017;2017;04;04;Sunnuntai;0;0;0
626;09.04.2017;2017;04;05;Sunnuntai;0;1;1
626;09.04.2017;2017;04;06;Sunnuntai;0;0;0
626;09.04.2017;2017;04;07;Sunnuntai;0;2;2
626;09.04.2017;2017;04;08;Sunnuntai;1;2;3
626;09.04.2017;2017;04;09;Sunnuntai;1;0;1
626;09.04.2017;2017;04;10;Sunnuntai;5;5;10
626;09.04.2017;2017;04;11;Sunnuntai;3;5;8
626;09.04.2017;2017;04;12;Sunnuntai;4;7;11
626;09.04.2017;2017;04;13;Sunnuntai;1;6;7
626;09.04.2017;2017;04;14;Sunnuntai;6;4;10
626;09.04.2017;2017;04;15;Sunnuntai;5;7;12
626;09.04.2017;2017;04;16;Sunnuntai;6;1;7
626;09.04.2017;2017;04;17;Sunnuntai;11;4;15
626;09.04.2017;2017;04;18;Sunnuntai;8;10;18
626;09.04.2017;2017;04;19;Sunnuntai;1;4;5
626;09.04.2017;2017;04;20;Sunnuntai;2;2;4
626;09.04.2017;2017;04;21;Sunnuntai;1;2;3
626;09.04.2017;2017;04;22;Sunnuntai;0;2;2
626;09.04.2017;2017;04;23;Sunnuntai;2;0;2
626;10.04.2017;2017;04;00;Maanantai;0;0;0
626;10.04.2017;2017;04;01;Maanantai;0;0;0
626;10.04.2017;2017;04;02;Maanantai;1;0;1
626;10.04.2017;2017;04;03;Maanantai;0;0;0
626;10.04.2017;2017;04;04;Maanantai;0;0;0
626;10.04.2017;2017;04;05;Maanantai;0;2;2
626;10.04.2017;2017;04;06;Maanantai;1;7;8
626;10.04.2017;2017;04;07;Maanantai;5;21;26
626;10.04.2017;2017;04;08;Maanantai;10;24;34
626;10.04.2017;2017;04;09;Maanantai;13;21;34
626;10.04.2017;2017;04;10;Maanantai;2;6;8
626;10.04.2017;2017;04;11;Maanantai;3;6;9
626;10.04.2017;2017;04;12;Maanantai;5;10;15
626;10.04.2017;2017;04;13;Maanantai;4;6;10
626;10.04.2017;2017;04;14;Maanantai;4;6;10
626;10.04.2017;2017;04;15;Maanantai;15;10;25
626;10.04.2017;2017;04;16;Maanantai;12;12;24
626;10.04.2017;2017;04;17;Maanantai;16;14;30
626;10.04.2017;2017;04;18;Maanantai;9;1;10
626;10.04.2017;2017;04;19;Maanantai;10;1;11
626;10.04.2017;2017;04;20;Maanantai;3;0;3
626;10.04.2017;2017;04;21;Maanantai;8;1;9
626;10.04.2017;2017;04;22;Maanantai;1;2;3
626;10.04.2017;2017;04;23;Maanantai;1;2;3
626;11.04.2017;2017;04;00;Tiistai;1;1;2
626;11.04.2017;2017;04;01;Tiistai;0;0;0
626;11.04.2017;2017;04;02;Tiistai;0;0;0
626;11.04.2017;2017;04;03;Tiistai;0;0;0
626;11.04.2017;2017;04;04;Tiistai;0;0;0
626;11.04.2017;2017;04;05;Tiistai;0;1;1
626;11.04.2017;2017;04;06;Tiistai;0;5;5
626;11.04.2017;2017;04;07;Tiistai;8;17;25
626;11.04.2017;2017;04;08;Tiistai;6;23;29
626;11.04.2017;2017;04;09;Tiistai;6;20;26
626;11.04.2017;2017;04;10;Tiistai;2;4;6
626;11.04.2017;2017;04;11;Tiistai;2;3;5
626;11.04.2017;2017;04;12;Tiistai;4;4;8
626;11.04.2017;2017;04;13;Tiistai;0;1;1
626;11.04.2017;2017;04;14;Tiistai;2;5;7
626;11.04.2017;2017;04;15;Tiistai;7;3;10
626;11.04.2017;2017;04;16;Tiistai;20;15;35
626;11.04.2017;2017;04;17;Tiistai;25;9;34
626;11.04.2017;2017;04;18;Tiistai;12;1;13
626;11.04.2017;2017;04;19;Tiistai;7;6;13
626;11.04.2017;2017;04;20;Tiistai;8;5;13
626;11.04.2017;2017;04;21;Tiistai;8;1;9
626;11.04.2017;2017;04;22;Tiistai;2;4;6
626;11.04.2017;2017;04;23;Tiistai;0;2;2
626;12.04.2017;2017;04;00;Keskiviikko;1;0;1
626;12.04.2017;2017;04;01;Keskiviikko;0;0;0
626;12.04.2017;2017;04;02;Keskiviikko;0;0;0
626;12.04.2017;2017;04;03;Keskiviikko;0;0;0
626;12.04.2017;2017;04;04;Keskiviikko;0;0;0
626;12.04.2017;2017;04;05;Keskiviikko;0;0;0
626;12.04.2017;2017;04;06;Keskiviikko;2;5;7
626;12.04.2017;2017;04;07;Keskiviikko;7;26;33
626;12.04.2017;2017;04;08;Keskiviikko;16;35;51
626;12.04.2017;2017;04;09;Keskiviikko;9;22;31
626;12.04.2017;2017;04;10;Keskiviikko;7;12;19
626;12.04.2017;2017;04;11;Keskiviikko;4;11;15
626;12.04.2017;2017;04;12;Keskiviikko;10;10;20
626;12.04.2017;2017;04;13;Keskiviikko;5;11;16
626;12.04.2017;2017;04;14;Keskiviikko;16;13;29
626;12.04.2017;2017;04;15;Keskiviikko;10;9;19
626;12.04.2017;2017;04;16;Keskiviikko;32;16;48
626;12.04.2017;2017;04;17;Keskiviikko;32;22;54
626;12.04.2017;2017;04;18;Keskiviikko;16;14;30
626;12.04.2017;2017;04;19;Keskiviikko;9;3;12
626;12.04.2017;2017;04;20;Keskiviikko;11;5;16
626;12.04.2017;2017;04;21;Keskiviikko;5;1;6
626;12.04.2017;2017;04;22;Keskiviikko;1;2;3
626;12.04.2017;2017;04;23;Keskiviikko;2;1;3
626;13.04.2017;2017;04;00;Torstai;0;1;1
626;13.04.2017;2017;04;01;Torstai;0;0;0
626;13.04.2017;2017;04;02;Torstai;0;0;0
626;13.04.2017;2017;04;03;Torstai;0;0;0
626;13.04.2017;2017;04;04;Torstai;0;0;0
626;13.04.2017;2017;04;05;Torstai;0;2;2
626;13.04.2017;2017;04;06;Torstai;2;9;11
626;13.04.2017;2017;04;07;Torstai;7;15;22
626;13.04.2017;2017;04;08;Torstai;11;34;45
626;13.04.2017;2017;04;09;Torstai;9;21;30
626;13.04.2017;2017;04;10;Torstai;4;4;8
626;13.04.2017;2017;04;11;Torstai;5;6;11
626;13.04.2017;2017;04;12;Torstai;4;2;6
626;13.04.2017;2017;04;13;Torstai;7;0;7
626;13.04.2017;2017;04;14;Torstai;22;17;39
626;13.04.2017;2017;04;15;Torstai;15;9;24
626;13.04.2017;2017;04;16;Torstai;19;12;31
626;13.04.2017;2017;04;17;Torstai;21;13;34
626;13.04.2017;2017;04;18;Torstai;7;9;16
626;13.04.2017;2017;04;19;Torstai;7;4;11
626;13.04.2017;2017;04;20;Torstai;4;5;9
626;13.04.2017;2017;04;21;Torstai;5;0;5
626;13.04.2017;2017;04;22;Torstai;4;2;6
626;13.04.2017;2017;04;23;Torstai;1;0;1
626;14.04.2017;2017;04;00;Perjantai;1;1;2
626;14.04.2017;2017;04;01;Perjantai;0;1;1
626;14.04.2017;2017;04;02;Perjantai;0;0;0
626;14.04.2017;2017;04;03;Perjantai;0;0;0
626;14.04.2017;2017;04;04;Perjantai;0;0;0
626;14.04.2017;2017;04;05;Perjantai;0;0;0
626;14.04.2017;2017;04;06;Perjantai;0;1;1
626;14.04.2017;2017;04;07;Perjantai;0;1;1
626;14.04.2017;2017;04;08;Perjantai;1;0;1
626;14.04.2017;2017;04;09;Perjantai;4;1;5
626;14.04.2017;2017;04;10;Perjantai;4;2;6
626;14.04.2017;2017;04;11;Perjantai;4;10;14
626;14.04.2017;2017;04;12;Perjantai;8;8;16
626;14.04.2017;2017;04;13;Perjantai;8;10;18
626;14.04.2017;2017;04;14;Perjantai;11;9;20
626;14.04.2017;2017;04;15;Perjantai;5;3;8
626;14.04.2017;2017;04;16;Perjantai;5;7;12
626;14.04.2017;2017;04;17;Perjantai;9;6;15
626;14.04.2017;2017;04;18;Perjantai;2;3;5
626;14.04.2017;2017;04;19;Perjantai;5;3;8
626;14.04.2017;2017;04;20;Perjantai;3;3;6
626;14.04.2017;2017;04;21;Perjantai;1;1;2
626;14.04.2017;2017;04;22;Perjantai;3;2;5
626;14.04.2017;2017;04;23;Perjantai;4;1;5
626;15.04.2017;2017;04;00;Lauantai;1;4;5
626;15.04.2017;2017;04;01;Lauantai;0;0;0
626;15.04.2017;2017;04;02;Lauantai;3;1;4
626;15.04.2017;2017;04;03;Lauantai;1;0;1
626;15.04.2017;2017;04;04;Lauantai;0;0;0
626;15.04.2017;2017;04;05;Lauantai;0;1;1
626;15.04.2017;2017;04;06;Lauantai;0;2;2
626;15.04.2017;2017;04;07;Lauantai;1;2;3
626;15.04.2017;2017;04;08;Lauantai;0;0;0
626;15.04.2017;2017;04;09;Lauantai;1;2;3
626;15.04.2017;2017;04;10;Lauantai;2;3;5
626;15.04.2017;2017;04;11;Lauantai;1;6;7
626;15.04.2017;2017;04;12;Lauantai;5;4;9
626;15.04.2017;2017;04;13;Lauantai;10;8;18
626;15.04.2017;2017;04;14;Lauantai;7;11;18
626;15.04.2017;2017;04;15;Lauantai;6;8;14
626;15.04.2017;2017;04;16;Lauantai;14;6;20
626;15.04.2017;2017;04;17;Lauantai;3;2;5
626;15.04.2017;2017;04;18;Lauantai;3;3;6
626;15.04.2017;2017;04;19;Lauantai;5;3;8
626;15.04.2017;2017;04;20;Lauantai;2;4;6
626;15.04.2017;2017;04;21;Lauantai;3;2;5
626;15.04.2017;2017;04;22;Lauantai;6;1;7
626;15.04.2017;2017;04;23;Lauantai;0;2;2
626;16.04.2017;2017;04;00;Sunnuntai;1;0;1
626;16.04.2017;2017;04;01;Sunnuntai;1;1;2
626;16.04.2017;2017;04;02;Sunnuntai;1;0;1
626;16.04.2017;2017;04;03;Sunnuntai;0;0;0
626;16.04.2017;2017;04;04;Sunnuntai;1;1;2
626;16.04.2017;2017;04;05;Sunnuntai;0;0;0
626;16.04.2017;2017;04;06;Sunnuntai;0;3;3
626;16.04.2017;2017;04;07;Sunnuntai;0;1;1
626;16.04.2017;2017;04;08;Sunnuntai;0;1;1
626;16.04.2017;2017;04;09;Sunnuntai;1;1;2
626;16.04.2017;2017;04;10;Sunnuntai;1;3;4
626;16.04.2017;2017;04;11;Sunnuntai;5;9;14
626;16.04.2017;2017;04;12;Sunnuntai;3;7;10
626;16.04.2017;2017;04;13;Sunnuntai;8;15;23
626;16.04.2017;2017;04;14;Sunnuntai;12;18;30
626;16.04.2017;2017;04;15;Sunnuntai;17;10;27
626;16.04.2017;2017;04;16;Sunnuntai;7;5;12
626;16.04.2017;2017;04;17;Sunnuntai;9;9;18
626;16.04.2017;2017;04;18;Sunnuntai;5;3;8
626;16.04.2017;2017;04;19;Sunnuntai;4;3;7
626;16.04.2017;2017;04;20;Sunnuntai;6;4;10
626;16.04.2017;2017;04;21;Sunnuntai;2;4;6
626;16.04.2017;2017;04;22;Sunnuntai;3;2;5
626;16.04.2017;2017;04;23;Sunnuntai;2;0;2
626;17.04.2017;2017;04;00;Maanantai;0;0;0
626;17.04.2017;2017;04;01;Maanantai;1;0;1
626;17.04.2017;2017;04;02;Maanantai;0;1;1
626;17.04.2017;2017;04;03;Maanantai;0;0;0
626;17.04.2017;2017;04;04;Maanantai;1;0;1
626;17.04.2017;2017;04;05;Maanantai;0;1;1
626;17.04.2017;2017;04;06;Maanantai;1;3;4
626;17.04.2017;2017;04;07;Maanantai;2;3;5
626;17.04.2017;2017;04;08;Maanantai;0;4;4
626;17.04.2017;2017;04;09;Maanantai;6;2;8
626;17.04.2017;2017;04;10;Maanantai;1;2;3
626;17.04.2017;2017;04;11;Maanantai;7;8;15
626;17.04.2017;2017;04;12;Maanantai;7;10;17
626;17.04.2017;2017;04;13;Maanantai;10;18;28
626;17.04.2017;2017;04;14;Maanantai;9;14;23
626;17.04.2017;2017;04;15;Maanantai;26;25;51
626;17.04.2017;2017;04;16;Maanantai;14;11;25
626;17.04.2017;2017;04;17;Maanantai;8;9;17
626;17.04.2017;2017;04;18;Maanantai;11;11;22
626;17.04.2017;2017;04;19;Maanantai;5;4;9
626;17.04.2017;2017;04;20;Maanantai;4;2;6
626;17.04.2017;2017;04;21;Maanantai;2;2;4
626;17.04.2017;2017;04;22;Maanantai;4;2;6
626;17.04.2017;2017;04;23;Maanantai;1;3;4
626;18.04.2017;2017;04;00;Tiistai;0;0;0
626;18.04.2017;2017;04;01;Tiistai;0;0;0
626;18.04.2017;2017;04;02;Tiistai;0;0;0
626;18.04.2017;2017;04;03;Tiistai;0;0;0
626;18.04.2017;2017;04;04;Tiistai;0;0;0
626;18.04.2017;2017;04;05;Tiistai;0;3;3
626;18.04.2017;2017;04;06;Tiistai;4;9;13
626;18.04.2017;2017;04;07;Tiistai;7;22;29
626;18.04.2017;2017;04;08;Tiistai;13;40;53
626;18.04.2017;2017;04;09;Tiistai;16;28;44
626;18.04.2017;2017;04;10;Tiistai;6;9;15
626;18.04.2017;2017;04;11;Tiistai;11;12;23
626;18.04.2017;2017;04;12;Tiistai;9;17;26
626;18.04.2017;2017;04;13;Tiistai;12;11;23
626;18.04.2017;2017;04;14;Tiistai;15;25;40
626;18.04.2017;2017;04;15;Tiistai;11;8;19
626;18.04.2017;2017;04;16;Tiistai;26;19;45
626;18.04.2017;2017;04;17;Tiistai;36;26;62
626;18.04.2017;2017;04;18;Tiistai;20;15;35
626;18.04.2017;2017;04;19;Tiistai;16;10;26
626;18.04.2017;2017;04;20;Tiistai;9;1;10
626;18.04.2017;2017;04;21;Tiistai;7;5;12
626;18.04.2017;2017;04;22;Tiistai;10;3;13
626;18.04.2017;2017;04;23;Tiistai;3;4;7
626;19.04.2017;2017;04;00;Keskiviikko;0;0;0
626;19.04.2017;2017;04;01;Keskiviikko;0;0;0
626;19.04.2017;2017;04;02;Keskiviikko;0;0;0
626;19.04.2017;2017;04;03;Keskiviikko;0;0;0
626;19.04.2017;2017;04;04;Keskiviikko;0;0;0
626;19.04.2017;2017;04;05;Keskiviikko;0;4;4
626;19.04.2017;2017;04;06;Keskiviikko;4;4;8
626;19.04.2017;2017;04;07;Keskiviikko;4;32;36
626;19.04.2017;2017;04;08;Keskiviikko;16;42;58
626;19.04.2017;2017;04;09;Keskiviikko;10;19;29
626;19.04.2017;2017;04;10;Keskiviikko;4;11;15
626;19.04.2017;2017;04;11;Keskiviikko;3;7;10
626;19.04.2017;2017;04;12;Keskiviikko;11;16;27
626;19.04.2017;2017;04;13;Keskiviikko;11;11;22
626;19.04.2017;2017;04;14;Keskiviikko;18;11;29
626;19.04.2017;2017;04;15;Keskiviikko;13;15;28
626;19.04.2017;2017;04;16;Keskiviikko;26;19;45
626;19.04.2017;2017;04;17;Keskiviikko;42;23;65
626;19.04.2017;2017;04;18;Keskiviikko;15;19;34
626;19.04.2017;2017;04;19;Keskiviikko;15;7;22
626;19.04.2017;2017;04;20;Keskiviikko;15;9;24
626;19.04.2017;2017;04;21;Keskiviikko;9;6;15
626;19.04.2017;2017;04;22;Keskiviikko;10;3;13
626;19.04.2017;2017;04;23;Keskiviikko;4;1;5
626;20.04.2017;2017;04;00;Torstai;0;1;1
626;20.04.2017;2017;04;01;Torstai;0;0;0
626;20.04.2017;2017;04;02;Torstai;0;0;0
626;20.04.2017;2017;04;03;Torstai;0;0;0
626;20.04.2017;2017;04;04;Torstai;0;0;0
626;20.04.2017;2017;04;05;Torstai;0;2;2
626;20.04.2017;2017;04;06;Torstai;3;10;13
626;20.04.2017;2017;04;07;Torstai;6;23;29
626;20.04.2017;2017;04;08;Torstai;15;39;54
626;20.04.2017;2017;04;09;Torstai;13;20;33
626;20.04.2017;2017;04;10;Torstai;3;12;15
626;20.04.2017;2017;04;11;Torstai;6;6;12
626;20.04.2017;2017;04;12;Torstai;8;14;22
626;20.04.2017;2017;04;13;Torstai;11;11;22
626;20.04.2017;2017;04;14;Torstai;8;16;24
626;20.04.2017;2017;04;15;Torstai;13;10;23
626;20.04.2017;2017;04;16;Torstai;21;20;41
626;20.04.2017;2017;04;17;Torstai;25;12;37
626;20.04.2017;2017;04;18;Torstai;7;9;16
626;20.04.2017;2017;04;19;Torstai;7;1;8
626;20.04.2017;2017;04;20;Torstai;6;0;6
626;20.04.2017;2017;04;21;Torstai;6;1;7
626;20.04.2017;2017;04;22;Torstai;8;1;9
626;20.04.2017;2017;04;23;Torstai;1;2;3
626;21.04.2017;2017;04;00;Perjantai;2;2;4
626;21.04.2017;2017;04;01;Perjantai;0;1;1
626;21.04.2017;2017;04;02;Perjantai;0;0;0
626;21.04.2017;2017;04;03;Perjantai;0;0;0
626;21.04.2017;2017;04;04;Perjantai;0;0;0
626;21.04.2017;2017;04;05;Perjantai;1;0;1
626;21.04.2017;2017;04;06;Perjantai;3;7;10
626;21.04.2017;2017;04;07;Perjantai;8;19;27
626;21.04.2017;2017;04;08;Perjantai;10;35;45
626;21.04.2017;2017;04;09;Perjantai;15;20;35
626;21.04.2017;2017;04;10;Perjantai;8;6;14
626;21.04.2017;2017;04;11;Perjantai;7;8;15
626;21.04.2017;2017;04;12;Perjantai;8;23;31
626;21.04.2017;2017;04;13;Perjantai;14;16;30
626;21.04.2017;2017;04;14;Perjantai;21;15;36
626;21.04.2017;2017;04;15;Perjantai;18;18;36
626;21.04.2017;2017;04;16;Perjantai;22;29;51
626;21.04.2017;2017;04;17;Perjantai;22;18;40
626;21.04.2017;2017;04;18;Perjantai;21;15;36
626;21.04.2017;2017;04;19;Perjantai;12;10;22
626;21.04.2017;2017;04;20;Perjantai;13;4;17
626;21.04.2017;2017;04;21;Perjantai;8;1;9
626;21.04.2017;2017;04;22;Perjantai;7;4;11
626;21.04.2017;2017;04;23;Perjantai;4;1;5
626;22.04.2017;2017;04;00;Lauantai;0;3;3
626;22.04.2017;2017;04;01;Lauantai;3;1;4
626;22.04.2017;2017;04;02;Lauantai;1;1;2
626;22.04.2017;2017;04;03;Lauantai;1;0;1
626;22.04.2017;2017;04;04;Lauantai;1;0;1
626;22.04.2017;2017;04;05;Lauantai;0;0;0
626;22.04.2017;2017;04;06;Lauantai;0;1;1
626;22.04.2017;2017;04;07;Lauantai;2;1;3
626;22.04.2017;2017;04;08;Lauantai;1;3;4
626;22.04.2017;2017;04;09;Lauantai;4;6;10
626;22.04.2017;2017;04;10;Lauantai;4;10;14
626;22.04.2017;2017;04;11;Lauantai;12;11;23
626;22.04.2017;2017;04;12;Lauantai;9;20;29
626;22.04.2017;2017;04;13;Lauantai;22;22;44
626;22.04.2017;2017;04;14;Lauantai;16;22;38
626;22.04.2017;2017;04;15;Lauantai;16;11;27
626;22.04.2017;2017;04;16;Lauantai;20;18;38
626;22.04.2017;2017;04;17;Lauantai;8;16;24
626;22.04.2017;2017;04;18;Lauantai;12;11;23
626;22.04.2017;2017;04;19;Lauantai;9;9;18
626;22.04.2017;2017;04;20;Lauantai;4;9;13
626;22.04.2017;2017;04;21;Lauantai;7;7;14
626;22.04.2017;2017;04;22;Lauantai;4;2;6
626;22.04.2017;2017;04;23;Lauantai;2;1;3
626;23.04.2017;2017;04;00;Sunnuntai;2;1;3
626;23.04.2017;2017;04;01;Sunnuntai;2;0;2
626;23.04.2017;2017;04;02;Sunnuntai;1;0;1
626;23.04.2017;2017;04;03;Sunnuntai;1;0;1
626;23.04.2017;2017;04;04;Sunnuntai;1;0;1
626;23.04.2017;2017;04;05;Sunnuntai;1;0;1
626;23.04.2017;2017;04;06;Sunnuntai;0;2;2
626;23.04.2017;2017;04;07;Sunnuntai;0;1;1
626;23.04.2017;2017;04;08;Sunnuntai;1;1;2
626;23.04.2017;2017;04;09;Sunnuntai;1;5;6
626;23.04.2017;2017;04;10;Sunnuntai;4;2;6
626;23.04.2017;2017;04;11;Sunnuntai;3;7;10
626;23.04.2017;2017;04;12;Sunnuntai;9;9;18
626;23.04.2017;2017;04;13;Sunnuntai;16;16;32
626;23.04.2017;2017;04;14;Sunnuntai;13;13;26
626;23.04.2017;2017;04;15;Sunnuntai;19;21;40
626;23.04.2017;2017;04;16;Sunnuntai;13;14;27
626;23.04.2017;2017;04;17;Sunnuntai;10;15;25
626;23.04.2017;2017;04;18;Sunnuntai;7;10;17
626;23.04.2017;2017;04;19;Sunnuntai;6;4;10
626;23.04.2017;2017;04;20;Sunnuntai;10;8;18
626;23.04.2017;2017;04;21;Sunnuntai;5;3;8
626;23.04.2017;2017;04;22;Sunnuntai;2;2;4
626;23.04.2017;2017;04;23;Sunnuntai;0;2;2
626;24.04.2017;2017;04;00;Maanantai;0;2;2
626;24.04.2017;2017;04;01;Maanantai;0;0;0
626;24.04.2017;2017;04;02;Maanantai;2;0;2
626;24.04.2017;2017;04;03;Maanantai;0;0;0
626;24.04.2017;2017;04;04;Maanantai;0;2;2
626;24.04.2017;2017;04;05;Maanantai;0;2;2
626;24.04.2017;2017;04;06;Maanantai;3;9;12
626;24.04.2017;2017;04;07;Maanantai;8;26;34
626;24.04.2017;2017;04;08;Maanantai;16;52;68
626;24.04.2017;2017;04;09;Maanantai;11;29;40
626;24.04.2017;2017;04;10;Maanantai;8;20;28
626;24.04.2017;2017;04;11;Maanantai;7;13;20
626;24.04.2017;2017;04;12;Maanantai;7;13;20
626;24.04.2017;2017;04;13;Maanantai;11;14;25
626;24.04.2017;2017;04;14;Maanantai;14;12;26
626;24.04.2017;2017;04;15;Maanantai;14;14;28
626;24.04.2017;2017;04;16;Maanantai;31;26;57
626;24.04.2017;2017;04;17;Maanantai;45;25;70
626;24.04.2017;2017;04;18;Maanantai;26;11;37
626;24.04.2017;2017;04;19;Maanantai;16;9;25
626;24.04.2017;2017;04;20;Maanantai;13;9;22
626;24.04.2017;2017;04;21;Maanantai;12;6;18
626;24.04.2017;2017;04;22;Maanantai;10;7;17
626;24.04.2017;2017;04;23;Maanantai;2;4;6
626;25.04.2017;2017;04;00;Tiistai;1;0;1
626;25.04.2017;2017;04;01;Tiistai;0;0;0
626;25.04.2017;2017;04;02;Tiistai;1;0;1
626;25.04.2017;2017;04;03;Tiistai;0;0;0
626;25.04.2017;2017;04;04;Tiistai;0;2;2
626;25.04.2017;2017;04;05;Tiistai;0;3;3
626;25.04.2017;2017;04;06;Tiistai;3;7;10
626;25.04.2017;2017;04;07;Tiistai;6;36;42
626;25.04.2017;2017;04;08;Tiistai;18;62;80
626;25.04.2017;2017;04;09;Tiistai;17;35;52
626;25.04.2017;2017;04;10;Tiistai;7;15;22
626;25.04.2017;2017;04;11;Tiistai;11;20;31
626;25.04.2017;2017;04;12;Tiistai;11;21;32
626;25.04.2017;2017;04;13;Tiistai;17;14;31
626;25.04.2017;2017;04;14;Tiistai;20;17;37
626;25.04.2017;2017;04;15;Tiistai;23;27;50
626;25.04.2017;2017;04;16;Tiistai;40;34;74
626;25.04.2017;2017;04;17;Tiistai;48;33;81
626;25.04.2017;2017;04;18;Tiistai;28;15;43
626;25.04.2017;2017;04;19;Tiistai;27;9;36
626;25.04.2017;2017;04;20;Tiistai;21;13;34
626;25.04.2017;2017;04;21;Tiistai;16;14;30
626;25.04.2017;2017;04;22;Tiistai;7;5;12
626;25.04.2017;2017;04;23;Tiistai;2;6;8
626;26.04.2017;2017;04;00;Keskiviikko;1;1;2
626;26.04.2017;2017;04;01;Keskiviikko;1;0;1
626;26.04.2017;2017;04;02;Keskiviikko;0;0;0
626;26.04.2017;2017;04;03;Keskiviikko;0;0;0
626;26.04.2017;2017;04;04;Keskiviikko;1;0;1
626;26.04.2017;2017;04;05;Keskiviikko;0;2;2
626;26.04.2017;2017;04;06;Keskiviikko;4;10;14
626;26.04.2017;2017;04;07;Keskiviikko;3;19;22
626;26.04.2017;2017;04;08;Keskiviikko;17;32;49
626;26.04.2017;2017;04;09;Keskiviikko;11;16;27
626;26.04.2017;2017;04;10;Keskiviikko;0;0;0
626;26.04.2017;2017;04;11;Keskiviikko;2;6;8
626;26.04.2017;2017;04;12;Keskiviikko;0;1;1
626;26.04.2017;2017;04;13;Keskiviikko;4;1;5
626;26.04.2017;2017;04;14;Keskiviikko;5;5;10
626;26.04.2017;2017;04;15;Keskiviikko;14;8;22
626;26.04.2017;2017;04;16;Keskiviikko;19;9;28
626;26.04.2017;2017;04;17;Keskiviikko;15;16;31
626;26.04.2017;2017;04;18;Keskiviikko;15;1;16
626;26.04.2017;2017;04;19;Keskiviikko;7;3;10
626;26.04.2017;2017;04;20;Keskiviikko;6;1;7
626;26.04.2017;2017;04;21;Keskiviikko;3;3;6
626;26.04.2017;2017;04;22;Keskiviikko;2;1;3
626;26.04.2017;2017;04;23;Keskiviikko;3;2;5
626;27.04.2017;2017;04;00;Torstai;0;0;0
626;27.04.2017;2017;04;01;Torstai;0;0;0
626;27.04.2017;2017;04;02;Torstai;0;0;0
626;27.04.2017;2017;04;03;Torstai;1;0;1
626;27.04.2017;2017;04;04;Torstai;0;0;0
626;27.04.2017;2017;04;05;Torstai;0;2;2
626;27.04.2017;2017;04;06;Torstai;3;9;12
626;27.04.2017;2017;04;07;Torstai;3;18;21
626;27.04.2017;2017;04;08;Torstai;7;25;32
626;27.04.2017;2017;04;09;Torstai;11;23;34
626;27.04.2017;2017;04;10;Torstai;4;8;12
626;27.04.2017;2017;04;11;Torstai;6;9;15
626;27.04.2017;2017;04;12;Torstai;1;2;3
626;27.04.2017;2017;04;13;Torstai;6;9;15
626;27.04.2017;2017;04;14;Torstai;9;7;16
626;27.04.2017;2017;04;15;Torstai;15;11;26
626;27.04.2017;2017;04;16;Torstai;25;13;38
626;27.04.2017;2017;04;17;Torstai;24;20;44
626;27.04.2017;2017;04;18;Torstai;18;14;32
626;27.04.2017;2017;04;19;Torstai;12;6;18
626;27.04.2017;2017;04;20;Torstai;12;3;15
626;27.04.2017;2017;04;21;Torstai;2;7;9
626;27.04.2017;2017;04;22;Torstai;6;7;13
626;27.04.2017;2017;04;23;Torstai;4;3;7
626;28.04.2017;2017;04;00;Perjantai;1;0;1
626;28.04.2017;2017;04;01;Perjantai;0;0;0
626;28.04.2017;2017;04;02;Perjantai;0;0;0
626;28.04.2017;2017;04;03;Perjantai;1;0;1
626;28.04.2017;2017;04;04;Perjantai;0;0;0
626;28.04.2017;2017;04;05;Perjantai;0;4;4
626;28.04.2017;2017;04;06;Perjantai;1;7;8
626;28.04.2017;2017;04;07;Perjantai;8;28;36
626;28.04.2017;2017;04;08;Perjantai;15;41;56
626;28.04.2017;2017;04;09;Perjantai;23;25;48
626;28.04.2017;2017;04;10;Perjantai;8;14;22
626;28.04.2017;2017;04;11;Perjantai;9;17;26
626;28.04.2017;2017;04;12;Perjantai;17;18;35
626;28.04.2017;2017;04;13;Perjantai;10;21;31
626;28.04.2017;2017;04;14;Perjantai;19;20;39
626;28.04.2017;2017;04;15;Perjantai;29;16;45
626;28.04.2017;2017;04;16;Perjantai;40;25;65
626;28.04.2017;2017;04;17;Perjantai;31;13;44
626;28.04.2017;2017;04;18;Perjantai;15;23;38
626;28.04.2017;2017;04;19;Perjantai;15;11;26
626;28.04.2017;2017;04;20;Perjantai;14;17;31
626;28.04.2017;2017;04;21;Perjantai;12;5;17
626;28.04.2017;2017;04;22;Perjantai;8;10;18
626;28.04.2017;2017;04;23;Perjantai;4;3;7
626;29.04.2017;2017;04;00;Lauantai;0;3;3
626;29.04.2017;2017;04;01;Lauantai;3;1;4
626;29.04.2017;2017;04;02;Lauantai;1;1;2
626;29.04.2017;2017;04;03;Lauantai;1;0;1
626;29.04.2017;2017;04;04;Lauantai;1;0;1
626;29.04.2017;2017;04;05;Lauantai;0;0;0
626;29.04.2017;2017;04;06;Lauantai;0;1;1
626;29.04.2017;2017;04;07;Lauantai;2;1;3
626;29.04.2017;2017;04;08;Lauantai;1;3;4
626;29.04.2017;2017;04;09;Lauantai;4;6;10
626;29.04.2017;2017;04;10;Lauantai;4;10;14
626;29.04.2017;2017;04;11;Lauantai;12;11;23
626;29.04.2017;2017;04;12;Lauantai;9;20;29
626;29.04.2017;2017;04;13;Lauantai;22;22;44
626;29.04.2017;2017;04;14;Lauantai;16;22;38
626;29.04.2017;2017;04;15;Lauantai;16;11;27
626;29.04.2017;2017;04;16;Lauantai;20;18;38
626;29.04.2017;2017;04;17;Lauantai;8;16;24
626;29.04.2017;2017;04;18;Lauantai;12;11;23
626;29.04.2017;2017;04;19;Lauantai;9;9;18
626;29.04.2017;2017;04;20;Lauantai;4;9;13
626;29.04.2017;2017;04;21;Lauantai;7;7;14
626;29.04.2017;2017;04;22;Lauantai;4;2;6
626;29.04.2017;2017;04;23;Lauantai;2;1;3
626;30.04.2017;2017;04;00;Sunnuntai;2;1;3
626;30.04.2017;2017;04;01;Sunnuntai;2;0;2
626;30.04.2017;2017;04;02;Sunnuntai;1;0;1
626;30.04.2017;2017;04;03;Sunnuntai;1;0;1
626;30.04.2017;2017;04;04;Sunnuntai;1;0;1
626;30.04.2017;2017;04;05;Sunnuntai;1;0;1
626;30.04.2017;2017;04;06;Sunnuntai;0;2;2
626;30.04.2017;2017;04;07;Sunnuntai;0;1;1
626;30.04.2017;2017;04;08;Sunnuntai;1;1;2
626;30.04.2017;2017;04;09;Sunnuntai;1;5;6
626;30.04.2017;2017;04;10;Sunnuntai;4;2;6
626;30.04.2017;2017;04;11;Sunnuntai;3;7;10
626;30.04.2017;2017;04;12;Sunnuntai;9;9;18
626;30.04.2017;2017;04;13;Sunnuntai;16;16;32
626;30.04.2017;2017;04;14;Sunnuntai;13;13;26
626;30.04.2017;2017;04;15;Sunnuntai;19;21;40
626;30.04.2017;2017;04;16;Sunnuntai;13;14;27
626;30.04.2017;2017;04;17;Sunnuntai;10;15;25
626;30.04.2017;2017;04;18;Sunnuntai;7;10;17
626;30.04.2017;2017;04;19;Sunnuntai;6;4;10
626;30.04.2017;2017;04;20;Sunnuntai;10;8;18
626;30.04.2017;2017;04;21;Sunnuntai;5;3;8
626;30.04.2017;2017;04;22;Sunnuntai;2;2;4
626;30.04.2017;2017;04;23;Sunnuntai;0;2;2
626;01.05.2017;2017;05;00;Maanantai;2;1;3
626;01.05.2017;2017;05;01;Maanantai;2;0;2
626;01.05.2017;2017;05;02;Maanantai;1;0;1
626;01.05.2017;2017;05;03;Maanantai;1;0;1
626;01.05.2017;2017;05;04;Maanantai;1;0;1
626;01.05.2017;2017;05;05;Maanantai;1;0;1
626;01.05.2017;2017;05;06;Maanantai;0;2;2
626;01.05.2017;2017;05;07;Maanantai;0;1;1
626;01.05.2017;2017;05;08;Maanantai;1;1;2
626;01.05.2017;2017;05;09;Maanantai;1;5;6
626;01.05.2017;2017;05;10;Maanantai;4;2;6
626;01.05.2017;2017;05;11;Maanantai;3;7;10
626;01.05.2017;2017;05;12;Maanantai;9;9;18
626;01.05.2017;2017;05;13;Maanantai;16;16;32
626;01.05.2017;2017;05;14;Maanantai;13;13;26
626;01.05.2017;2017;05;15;Maanantai;19;21;40
626;01.05.2017;2017;05;16;Maanantai;13;14;27
626;01.05.2017;2017;05;17;Maanantai;10;15;25
626;01.05.2017;2017;05;18;Maanantai;7;10;17
626;01.05.2017;2017;05;19;Maanantai;6;4;10
626;01.05.2017;2017;05;20;Maanantai;10;8;18
626;01.05.2017;2017;05;21;Maanantai;5;3;8
626;01.05.2017;2017;05;22;Maanantai;2;2;4
626;01.05.2017;2017;05;23;Maanantai;0;2;2
626;02.05.2017;2017;05;00;Tiistai;1;0;1
626;02.05.2017;2017;05;01;Tiistai;0;0;0
626;02.05.2017;2017;05;02;Tiistai;1;0;1
626;02.05.2017;2017;05;03;Tiistai;0;0;0
626;02.05.2017;2017;05;04;Tiistai;0;2;2
626;02.05.2017;2017;05;05;Tiistai;0;3;3
626;02.05.2017;2017;05;06;Tiistai;3;7;10
626;02.05.2017;2017;05;07;Tiistai;6;36;42
626;02.05.2017;2017;05;08;Tiistai;18;62;80
626;02.05.2017;2017;05;09;Tiistai;17;35;52
626;02.05.2017;2017;05;10;Tiistai;7;15;22
626;02.05.2017;2017;05;11;Tiistai;11;20;31
626;02.05.2017;2017;05;12;Tiistai;11;21;32
626;02.05.2017;2017;05;13;Tiistai;17;14;31
626;02.05.2017;2017;05;14;Tiistai;20;17;37
626;02.05.2017;2017;05;15;Tiistai;23;27;50
626;02.05.2017;2017;05;16;Tiistai;40;34;74
626;02.05.2017;2017;05;17;Tiistai;48;33;81
626;02.05.2017;2017;05;18;Tiistai;28;15;43
626;02.05.2017;2017;05;19;Tiistai;27;9;36
626;02.05.2017;2017;05;20;Tiistai;21;13;34
626;02.05.2017;2017;05;21;Tiistai;16;14;30
626;02.05.2017;2017;05;22;Tiistai;7;5;12
626;02.05.2017;2017;05;23;Tiistai;2;6;8
626;03.05.2017;2017;05;00;Keskiviikko;0;0;0
626;03.05.2017;2017;05;01;Keskiviikko;0;0;0
626;03.05.2017;2017;05;02;Keskiviikko;0;0;0
626;03.05.2017;2017;05;03;Keskiviikko;0;0;0
626;03.05.2017;2017;05;04;Keskiviikko;0;0;0
626;03.05.2017;2017;05;05;Keskiviikko;0;4;4
626;03.05.2017;2017;05;06;Keskiviikko;4;4;8
626;03.05.2017;2017;05;07;Keskiviikko;4;32;36
626;03.05.2017;2017;05;08;Keskiviikko;16;42;58
626;03.05.2017;2017;05;09;Keskiviikko;10;19;29
626;03.05.2017;2017;05;10;Keskiviikko;4;11;15
626;03.05.2017;2017;05;11;Keskiviikko;3;7;10
626;03.05.2017;2017;05;12;Keskiviikko;11;16;27
626;03.05.2017;2017;05;13;Keskiviikko;11;11;22
626;03.05.2017;2017;05;14;Keskiviikko;18;11;29
626;03.05.2017;2017;05;15;Keskiviikko;13;15;28
626;03.05.2017;2017;05;16;Keskiviikko;26;19;45
626;03.05.2017;2017;05;17;Keskiviikko;42;23;65
626;03.05.2017;2017;05;18;Keskiviikko;15;19;34
626;03.05.2017;2017;05;19;Keskiviikko;15;7;22
626;03.05.2017;2017;05;20;Keskiviikko;15;9;24
626;03.05.2017;2017;05;21;Keskiviikko;9;6;15
626;03.05.2017;2017;05;22;Keskiviikko;10;3;13
626;03.05.2017;2017;05;23;Keskiviikko;4;1;5
626;04.05.2017;2017;05;00;Torstai;0;1;1
626;04.05.2017;2017;05;01;Torstai;2;1;3
626;04.05.2017;2017;05;02;Torstai;0;0;0
626;04.05.2017;2017;05;03;Torstai;0;1;1
626;04.05.2017;2017;05;04;Torstai;0;1;1
626;04.05.2017;2017;05;05;Torstai;1;3;4
626;04.05.2017;2017;05;06;Torstai;6;6;12
626;04.05.2017;2017;05;07;Torstai;9;43;52
626;04.05.2017;2017;05;08;Torstai;19;59;78
626;04.05.2017;2017;05;09;Torstai;24;47;71
626;04.05.2017;2017;05;10;Torstai;16;14;30
626;04.05.2017;2017;05;11;Torstai;15;19;34
626;04.05.2017;2017;05;12;Torstai;10;16;26
626;04.05.2017;2017;05;13;Torstai;21;20;41
626;04.05.2017;2017;05;14;Torstai;14;31;45
626;04.05.2017;2017;05;15;Torstai;21;12;33
626;04.05.2017;2017;05;16;Torstai;42;26;68
626;04.05.2017;2017;05;17;Torstai;78;29;107
626;04.05.2017;2017;05;18;Torstai;29;29;58
626;04.05.2017;2017;05;19;Torstai;27;18;45
626;04.05.2017;2017;05;20;Torstai;19;17;36
626;04.05.2017;2017;05;21;Torstai;17;15;32
626;04.05.2017;2017;05;22;Torstai;16;7;23
626;04.05.2017;2017;05;23;Torstai;4;1;5
626;05.05.2017;2017;05;00;Perjantai;0;1;1
626;05.05.2017;2017;05;01;Perjantai;2;1;3
626;05.05.2017;2017;05;02;Perjantai;0;0;0
626;05.05.2017;2017;05;03;Perjantai;0;1;1
626;05.05.2017;2017;05;04;Perjantai;0;1;1
626;05.05.2017;2017;05;05;Perjantai;1;3;4
626;05.05.2017;2017;05;06;Perjantai;6;6;12
626;05.05.2017;2017;05;07;Perjantai;9;43;52
626;05.05.2017;2017;05;08;Perjantai;19;59;78
626;05.05.2017;2017;05;09;Perjantai;24;47;71
626;05.05.2017;2017;05;10;Perjantai;16;14;30
626;05.05.2017;2017;05;11;Perjantai;21;13;34
626;05.05.2017;2017;05;12;Perjantai;14;22;36
626;05.05.2017;2017;05;13;Perjantai;25;31;56
626;05.05.2017;2017;05;14;Perjantai;23;19;42
626;05.05.2017;2017;05;15;Perjantai;33;17;50
626;05.05.2017;2017;05;16;Perjantai;60;31;91
626;05.05.2017;2017;05;17;Perjantai;63;45;108
626;05.05.2017;2017;05;18;Perjantai;38;23;61
626;05.05.2017;2017;05;19;Perjantai;31;24;55
626;05.05.2017;2017;05;20;Perjantai;25;17;42
626;05.05.2017;2017;05;21;Perjantai;16;8;24
626;05.05.2017;2017;05;22;Perjantai;9;9;18
626;05.05.2017;2017;05;23;Perjantai;5;5;10
626;06.05.2017;2017;05;00;Lauantai;9;0;9
626;06.05.2017;2017;05;01;Lauantai;6;5;11
626;06.05.2017;2017;05;02;Lauantai;2;1;3
626;06.05.2017;2017;05;03;Lauantai;4;1;5
626;06.05.2017;2017;05;04;Lauantai;0;1;1
626;06.05.2017;2017;05;05;Lauantai;1;1;2
626;06.05.2017;2017;05;06;Lauantai;0;5;5
626;06.05.2017;2017;05;07;Lauantai;1;1;2
626;06.05.2017;2017;05;08;Lauantai;6;2;8
626;06.05.2017;2017;05;09;Lauantai;7;14;21
626;06.05.2017;2017;05;10;Lauantai;8;14;22
626;06.05.2017;2017;05;11;Lauantai;26;15;41
626;06.05.2017;2017;05;12;Lauantai;16;12;28
626;06.05.2017;2017;05;13;Lauantai;13;21;34
626;06.05.2017;2017;05;14;Lauantai;18;17;35
626;06.05.2017;2017;05;15;Lauantai;15;15;30
626;06.05.2017;2017;05;16;Lauantai;15;23;38
626;06.05.2017;2017;05;17;Lauantai;24;13;37
626;06.05.2017;2017;05;18;Lauantai;17;18;35
626;06.05.2017;2017;05;19;Lauantai;16;16;32
626;06.05.2017;2017;05;20;Lauantai;12;8;20
626;06.05.2017;2017;05;21;Lauantai;6;7;13
626;06.05.2017;2017;05;22;Lauantai;5;10;15
626;06.05.2017;2017;05;23;Lauantai;3;0;3
626;07.05.2017;2017;05;00;Sunnuntai;1;1;2
626;07.05.2017;2017;05;01;Sunnuntai;1;1;2
626;07.05.2017;2017;05;02;Sunnuntai;4;0;4
626;07.05.2017;2017;05;03;Sunnuntai;2;1;3
626;07.05.2017;2017;05;04;Sunnuntai;1;0;1
626;07.05.2017;2017;05;05;Sunnuntai;1;0;1
626;07.05.2017;2017;05;06;Sunnuntai;1;4;5
626;07.05.2017;2017;05;07;Sunnuntai;2;2;4
626;07.05.2017;2017;05;08;Sunnuntai;2;6;8
626;07.05.2017;2017;05;09;Sunnuntai;8;7;15
626;07.05.2017;2017;05;10;Sunnuntai;13;18;31
626;07.05.2017;2017;05;11;Sunnuntai;34;25;59
626;07.05.2017;2017;05;12;Sunnuntai;21;20;41
626;07.05.2017;2017;05;13;Sunnuntai;20;36;56
626;07.05.2017;2017;05;14;Sunnuntai;25;23;48
626;07.05.2017;2017;05;15;Sunnuntai;21;19;40
626;07.05.2017;2017;05;16;Sunnuntai;23;16;39
626;07.05.2017;2017;05;17;Sunnuntai;9;17;26
626;07.05.2017;2017;05;18;Sunnuntai;11;13;24
626;07.05.2017;2017;05;19;Sunnuntai;10;13;23
626;07.05.2017;2017;05;20;Sunnuntai;9;13;22
626;07.05.2017;2017;05;21;Sunnuntai;7;5;12
626;07.05.2017;2017;05;22;Sunnuntai;4;6;10
626;07.05.2017;2017;05;23;Sunnuntai;3;0;3
626;08.05.2017;2017;05;00;Maanantai;0;1;1
626;08.05.2017;2017;05;01;Maanantai;1;0;1
626;08.05.2017;2017;05;02;Maanantai;0;1;1
626;08.05.2017;2017;05;03;Maanantai;0;0;0
626;08.05.2017;2017;05;04;Maanantai;0;2;2
626;08.05.2017;2017;05;05;Maanantai;0;6;6
626;08.05.2017;2017;05;06;Maanantai;3;10;13
626;08.05.2017;2017;05;07;Maanantai;10;31;41
626;08.05.2017;2017;05;08;Maanantai;21;64;85
626;08.05.2017;2017;05;09;Maanantai;22;49;71
626;08.05.2017;2017;05;10;Maanantai;10;15;25
626;08.05.2017;2017;05;11;Maanantai;10;11;21
626;08.05.2017;2017;05;12;Maanantai;11;11;22
626;08.05.2017;2017;05;13;Maanantai;17;11;28
626;08.05.2017;2017;05;14;Maanantai;22;29;51
626;08.05.2017;2017;05;15;Maanantai;20;16;36
626;08.05.2017;2017;05;16;Maanantai;50;21;71
626;08.05.2017;2017;05;17;Maanantai;61;22;83
626;08.05.2017;2017;05;18;Maanantai;31;20;51
626;08.05.2017;2017;05;19;Maanantai;19;15;34
626;08.05.2017;2017;05;20;Maanantai;14;8;22
626;08.05.2017;2017;05;21;Maanantai;14;9;23
626;08.05.2017;2017;05;22;Maanantai;10;4;14
626;08.05.2017;2017;05;23;Maanantai;6;6;12
626;09.05.2017;2017;05;00;Tiistai;1;0;1
626;09.05.2017;2017;05;01;Tiistai;0;0;0
626;09.05.2017;2017;05;02;Tiistai;0;1;1
626;09.05.2017;2017;05;03;Tiistai;0;0;0
626;09.05.2017;2017;05;04;Tiistai;0;0;0
626;09.05.2017;2017;05;05;Tiistai;0;5;5
626;09.05.2017;2017;05;06;Tiistai;1;10;11
626;09.05.2017;2017;05;07;Tiistai;7;40;47
626;09.05.2017;2017;05;08;Tiistai;19;63;82
626;09.05.2017;2017;05;09;Tiistai;25;40;65
626;09.05.2017;2017;05;10;Tiistai;9;20;29
626;09.05.2017;2017;05;11;Tiistai;13;15;28
626;09.05.2017;2017;05;12;Tiistai;17;16;33
626;09.05.2017;2017;05;13;Tiistai;18;13;31
626;09.05.2017;2017;05;14;Tiistai;9;16;25
626;09.05.2017;2017;05;15;Tiistai;20;13;33
626;09.05.2017;2017;05;16;Tiistai;44;20;64
626;09.05.2017;2017;05;17;Tiistai;67;33;100
626;09.05.2017;2017;05;18;Tiistai;21;18;39
626;09.05.2017;2017;05;19;Tiistai;31;11;42
626;09.05.2017;2017;05;20;Tiistai;23;11;34
626;09.05.2017;2017;05;21;Tiistai;10;8;18
626;09.05.2017;2017;05;22;Tiistai;9;10;19
626;09.05.2017;2017;05;23;Tiistai;4;3;7
626;10.05.2017;2017;05;00;Keskiviikko;0;0;0
626;10.05.2017;2017;05;01;Keskiviikko;1;0;1
626;10.05.2017;2017;05;02;Keskiviikko;0;0;0
626;10.05.2017;2017;05;03;Keskiviikko;0;1;1
626;10.05.2017;2017;05;04;Keskiviikko;0;1;1
626;10.05.2017;2017;05;05;Keskiviikko;1;1;2
626;10.05.2017;2017;05;06;Keskiviikko;1;7;8
626;10.05.2017;2017;05;07;Keskiviikko;8;33;41
626;10.05.2017;2017;05;08;Keskiviikko;14;56;70
626;10.05.2017;2017;05;09;Keskiviikko;23;35;58
626;10.05.2017;2017;05;10;Keskiviikko;12;22;34
626;10.05.2017;2017;05;11;Keskiviikko;3;17;20
626;10.05.2017;2017;05;12;Keskiviikko;9;15;24
626;10.05.2017;2017;05;13;Keskiviikko;13;17;30
626;10.05.2017;2017;05;14;Keskiviikko;15;11;26
626;10.05.2017;2017;05;15;Keskiviikko;24;12;36
626;10.05.2017;2017;05;16;Keskiviikko;35;18;53
626;10.05.2017;2017;05;17;Keskiviikko;52;23;75
626;10.05.2017;2017;05;18;Keskiviikko;28;17;45
626;10.05.2017;2017;05;19;Keskiviikko;20;13;33
626;10.05.2017;2017;05;20;Keskiviikko;10;8;18
626;10.05.2017;2017;05;21;Keskiviikko;12;7;19
626;10.05.2017;2017;05;22;Keskiviikko;9;6;15
626;10.05.2017;2017;05;23;Keskiviikko;4;3;7
626;11.05.2017;2017;05;00;Torstai;1;1;2
626;11.05.2017;2017;05;01;Torstai;0;2;2
626;11.05.2017;2017;05;02;Torstai;0;1;1
626;11.05.2017;2017;05;03;Torstai;0;0;0
626;11.05.2017;2017;05;04;Torstai;0;0;0
626;11.05.2017;2017;05;05;Torstai;1;1;2
626;11.05.2017;2017;05;06;Torstai;5;8;13
626;11.05.2017;2017;05;07;Torstai;9;34;43
626;11.05.2017;2017;05;08;Torstai;20;51;71
626;11.05.2017;2017;05;09;Torstai;20;52;72
626;11.05.2017;2017;05;10;Torstai;8;17;25
626;11.05.2017;2017;05;11;Torstai;8;7;15
626;11.05.2017;2017;05;12;Torstai;10;14;24
626;11.05.2017;2017;05;13;Torstai;7;8;15
626;11.05.2017;2017;05;14;Torstai;14;10;24
626;11.05.2017;2017;05;15;Torstai;19;14;33
626;11.05.2017;2017;05;16;Torstai;34;15;49
626;11.05.2017;2017;05;17;Torstai;50;25;75
626;11.05.2017;2017;05;18;Torstai;31;29;60
626;11.05.2017;2017;05;19;Torstai;25;5;30
626;11.05.2017;2017;05;20;Torstai;20;6;26
626;11.05.2017;2017;05;21;Torstai;8;7;15
626;11.05.2017;2017;05;22;Torstai;9;8;17
626;11.05.2017;2017;05;23;Torstai;3;6;9
626;12.05.2017;2017;05;00;Perjantai;2;3;5
626;12.05.2017;2017;05;01;Perjantai;0;1;1
626;12.05.2017;2017;05;02;Perjantai;0;1;1
626;12.05.2017;2017;05;03;Perjantai;1;0;1
626;12.05.2017;2017;05;04;Perjantai;1;0;1
626;12.05.2017;2017;05;05;Perjantai;0;2;2
626;12.05.2017;2017;05;06;Perjantai;4;6;10
626;12.05.2017;2017;05;07;Perjantai;10;36;46
626;12.05.2017;2017;05;08;Perjantai;17;49;66
626;12.05.2017;2017;05;09;Perjantai;24;35;59
626;12.05.2017;2017;05;10;Perjantai;7;16;23
626;12.05.2017;2017;05;11;Perjantai;12;14;26
626;12.05.2017;2017;05;12;Perjantai;15;16;31
626;12.05.2017;2017;05;13;Perjantai;9;11;20
626;12.05.2017;2017;05;14;Perjantai;24;10;34
626;12.05.2017;2017;05;15;Perjantai;24;24;48
626;12.05.2017;2017;05;16;Perjantai;46;18;64
626;12.05.2017;2017;05;17;Perjantai;35;33;68
626;12.05.2017;2017;05;18;Perjantai;31;17;48
626;12.05.2017;2017;05;19;Perjantai;22;13;35
626;12.05.2017;2017;05;20;Perjantai;14;11;25
626;12.05.2017;2017;05;21;Perjantai;12;7;19
626;12.05.2017;2017;05;22;Perjantai;6;11;17
626;12.05.2017;2017;05;23;Perjantai;5;6;11
626;13.05.2017;2017;05;00;Lauantai;0;3;3
626;13.05.2017;2017;05;01;Lauantai;3;2;5
626;13.05.2017;2017;05;02;Lauantai;1;0;1
626;13.05.2017;2017;05;03;Lauantai;1;0;1
626;13.05.2017;2017;05;04;Lauantai;1;1;2
626;13.05.2017;2017;05;05;Lauantai;3;2;5
626;13.05.2017;2017;05;06;Lauantai;4;3;7
626;13.05.2017;2017;05;07;Lauantai;1;4;5
626;13.05.2017;2017;05;08;Lauantai;4;5;9
626;13.05.2017;2017;05;09;Lauantai;4;5;9
626;13.05.2017;2017;05;10;Lauantai;10;14;24
626;13.05.2017;2017;05;11;Lauantai;14;15;29
626;13.05.2017;2017;05;12;Lauantai;15;15;30
626;13.05.2017;2017;05;13;Lauantai;18;21;39
626;13.05.2017;2017;05;14;Lauantai;19;32;51
626;13.05.2017;2017;05;15;Lauantai;18;24;42
626;13.05.2017;2017;05;16;Lauantai;18;11;29
626;13.05.2017;2017;05;17;Lauantai;18;20;38
626;13.05.2017;2017;05;18;Lauantai;19;17;36
626;13.05.2017;2017;05;19;Lauantai;16;9;25
626;13.05.2017;2017;05;20;Lauantai;7;13;20
626;13.05.2017;2017;05;21;Lauantai;9;4;13
626;13.05.2017;2017;05;22;Lauantai;5;7;12
626;13.05.2017;2017;05;23;Lauantai;8;1;9
626;14.05.2017;2017;05;00;Sunnuntai;1;1;2
626;14.05.2017;2017;05;01;Sunnuntai;1;0;1
626;14.05.2017;2017;05;02;Sunnuntai;3;0;3
626;14.05.2017;2017;05;03;Sunnuntai;1;0;1
626;14.05.2017;2017;05;04;Sunnuntai;1;0;1
626;14.05.2017;2017;05;05;Sunnuntai;1;0;1
626;14.05.2017;2017;05;06;Sunnuntai;0;1;1
626;14.05.2017;2017;05;07;Sunnuntai;0;4;4
626;14.05.2017;2017;05;08;Sunnuntai;2;1;3
626;14.05.2017;2017;05;09;Sunnuntai;5;2;7
626;14.05.2017;2017;05;10;Sunnuntai;2;9;11
626;14.05.2017;2017;05;11;Sunnuntai;9;8;17
626;14.05.2017;2017;05;12;Sunnuntai;8;4;12
626;14.05.2017;2017;05;13;Sunnuntai;10;13;23
626;14.05.2017;2017;05;14;Sunnuntai;4;4;8
626;14.05.2017;2017;05;15;Sunnuntai;4;5;9
626;14.05.2017;2017;05;16;Sunnuntai;4;5;9
626;14.05.2017;2017;05;17;Sunnuntai;2;4;6
626;14.05.2017;2017;05;18;Sunnuntai;1;2;3
626;14.05.2017;2017;05;19;Sunnuntai;5;3;8
626;14.05.2017;2017;05;20;Sunnuntai;4;1;5
626;14.05.2017;2017;05;21;Sunnuntai;0;6;6
626;14.05.2017;2017;05;22;Sunnuntai;3;3;6
626;14.05.2017;2017;05;23;Sunnuntai;4;2;6
626;15.05.2017;2017;05;00;Maanantai;1;0;1
626;15.05.2017;2017;05;01;Maanantai;0;0;0
626;15.05.2017;2017;05;02;Maanantai;1;0;1
626;15.05.2017;2017;05;03;Maanantai;0;0;0
626;15.05.2017;2017;05;04;Maanantai;0;0;0
626;15.05.2017;2017;05;05;Maanantai;0;2;2
626;15.05.2017;2017;05;06;Maanantai;6;6;12
626;15.05.2017;2017;05;07;Maanantai;9;34;43
626;15.05.2017;2017;05;08;Maanantai;26;58;84
626;15.05.2017;2017;05;09;Maanantai;21;44;65
626;15.05.2017;2017;05;10;Maanantai;11;18;29
626;15.05.2017;2017;05;11;Maanantai;6;14;20
626;15.05.2017;2017;05;12;Maanantai;12;20;32
626;15.05.2017;2017;05;13;Maanantai;22;17;39
626;15.05.2017;2017;05;14;Maanantai;22;18;40
626;15.05.2017;2017;05;15;Maanantai;24;28;52
626;15.05.2017;2017;05;16;Maanantai;40;31;71
626;15.05.2017;2017;05;17;Maanantai;58;38;96
626;15.05.2017;2017;05;18;Maanantai;40;27;67
626;15.05.2017;2017;05;19;Maanantai;42;23;65
626;15.05.2017;2017;05;20;Maanantai;26;20;46
626;15.05.2017;2017;05;21;Maanantai;19;13;32
626;15.05.2017;2017;05;22;Maanantai;10;7;17
626;15.05.2017;2017;05;23;Maanantai;4;2;6
626;16.05.2017;2017;05;00;Tiistai;1;0;1
626;16.05.2017;2017;05;01;Tiistai;0;0;0
626;16.05.2017;2017;05;02;Tiistai;0;0;0
626;16.05.2017;2017;05;03;Tiistai;0;0;0
626;16.05.2017;2017;05;04;Tiistai;1;1;2
626;16.05.2017;2017;05;05;Tiistai;0;5;5
626;16.05.2017;2017;05;06;Tiistai;4;8;12
626;16.05.2017;2017;05;07;Tiistai;10;46;56
626;16.05.2017;2017;05;08;Tiistai;26;63;89
626;16.05.2017;2017;05;09;Tiistai;14;49;63
626;16.05.2017;2017;05;10;Tiistai;11;15;26
626;16.05.2017;2017;05;11;Tiistai;14;19;33
626;16.05.2017;2017;05;12;Tiistai;17;12;29
626;16.05.2017;2017;05;13;Tiistai;20;16;36
626;16.05.2017;2017;05;14;Tiistai;19;16;35
626;16.05.2017;2017;05;15;Tiistai;21;25;46
626;16.05.2017;2017;05;16;Tiistai;46;33;79
626;16.05.2017;2017;05;17;Tiistai;83;37;120
626;16.05.2017;2017;05;18;Tiistai;40;18;58
626;16.05.2017;2017;05;19;Tiistai;47;34;81
626;16.05.2017;2017;05;20;Tiistai;23;20;43
626;16.05.2017;2017;05;21;Tiistai;20;12;32
626;16.05.2017;2017;05;22;Tiistai;15;10;25
626;16.05.2017;2017;05;23;Tiistai;4;2;6
626;17.05.2017;2017;05;00;Keskiviikko;1;2;3
626;17.05.2017;2017;05;01;Keskiviikko;1;0;1
626;17.05.2017;2017;05;02;Keskiviikko;0;0;0
626;17.05.2017;2017;05;03;Keskiviikko;0;0;0
626;17.05.2017;2017;05;04;Keskiviikko;0;0;0
626;17.05.2017;2017;05;05;Keskiviikko;0;2;2
626;17.05.2017;2017;05;06;Keskiviikko;0;8;8
626;17.05.2017;2017;05;07;Keskiviikko;10;31;41
626;17.05.2017;2017;05;08;Keskiviikko;13;46;59
626;17.05.2017;2017;05;09;Keskiviikko;15;23;38
626;17.05.2017;2017;05;10;Keskiviikko;4;14;18
626;17.05.2017;2017;05;11;Keskiviikko;0;4;4
626;17.05.2017;2017;05;12;Keskiviikko;2;3;5
626;17.05.2017;2017;05;13;Keskiviikko;4;2;6
626;17.05.2017;2017;05;14;Keskiviikko;4;6;10
626;17.05.2017;2017;05;15;Keskiviikko;7;13;20
626;17.05.2017;2017;05;16;Keskiviikko;28;14;42
626;17.05.2017;2017;05;17;Keskiviikko;34;13;47
626;17.05.2017;2017;05;18;Keskiviikko;18;9;27
626;17.05.2017;2017;05;19;Keskiviikko;12;4;16
626;17.05.2017;2017;05;20;Keskiviikko;10;2;12
626;17.05.2017;2017;05;21;Keskiviikko;6;2;8
626;17.05.2017;2017;05;22;Keskiviikko;5;3;8
626;17.05.2017;2017;05;23;Keskiviikko;2;0;2
626;18.05.2017;2017;05;00;Torstai;2;0;2
626;18.05.2017;2017;05;01;Torstai;0;0;0
626;18.05.2017;2017;05;02;Torstai;0;1;1
626;18.05.2017;2017;05;03;Torstai;1;1;2
626;18.05.2017;2017;05;04;Torstai;0;0;0
626;18.05.2017;2017;05;05;Torstai;0;3;3
626;18.05.2017;2017;05;06;Torstai;5;5;10
626;18.05.2017;2017;05;07;Torstai;10;34;44
626;18.05.2017;2017;05;08;Torstai;19;73;92
626;18.05.2017;2017;05;09;Torstai;16;36;52
626;18.05.2017;2017;05;10;Torstai;7;18;25
626;18.05.2017;2017;05;11;Torstai;5;10;15
626;18.05.2017;2017;05;12;Torstai;12;14;26
626;18.05.2017;2017;05;13;Torstai;14;17;31
626;18.05.2017;2017;05;14;Torstai;29;42;71
626;18.05.2017;2017;05;15;Torstai;26;15;41
626;18.05.2017;2017;05;16;Torstai;45;32;77
626;18.05.2017;2017;05;17;Torstai;109;41;150
626;18.05.2017;2017;05;18;Torstai;35;28;63
626;18.05.2017;2017;05;19;Torstai;22;17;39
626;18.05.2017;2017;05;20;Torstai;20;8;28
626;18.05.2017;2017;05;21;Torstai;11;6;17
626;18.05.2017;2017;05;22;Torstai;10;7;17
626;18.05.2017;2017;05;23;Torstai;6;2;8
626;19.05.2017;2017;05;00;Perjantai;2;1;3
626;19.05.2017;2017;05;01;Perjantai;2;0;2
626;19.05.2017;2017;05;02;Perjantai;0;0;0
626;19.05.2017;2017;05;03;Perjantai;1;0;1
626;19.05.2017;2017;05;04;Perjantai;0;1;1
626;19.05.2017;2017;05;05;Perjantai;0;0;0
626;19.05.2017;2017;05;06;Perjantai;4;3;7
626;19.05.2017;2017;05;07;Perjantai;5;12;17
626;19.05.2017;2017;05;08;Perjantai;9;19;28
626;19.05.2017;2017;05;09;Perjantai;8;7;15
626;19.05.2017;2017;05;10;Perjantai;3;6;9
626;19.05.2017;2017;05;11;Perjantai;3;3;6
626;19.05.2017;2017;05;12;Perjantai;5;5;10
626;19.05.2017;2017;05;13;Perjantai;8;8;16
626;19.05.2017;2017;05;14;Perjantai;12;18;30
626;19.05.2017;2017;05;15;Perjantai;15;15;30
626;19.05.2017;2017;05;16;Perjantai;27;10;37
626;19.05.2017;2017;05;17;Perjantai;32;12;44
626;19.05.2017;2017;05;18;Perjantai;16;8;24
626;19.05.2017;2017;05;19;Perjantai;15;7;22
626;19.05.2017;2017;05;20;Perjantai;7;2;9
626;19.05.2017;2017;05;21;Perjantai;9;5;14
626;19.05.2017;2017;05;22;Perjantai;3;7;10
626;19.05.2017;2017;05;23;Perjantai;4;2;6
626;20.05.2017;2017;05;00;Lauantai;2;2;4
626;20.05.2017;2017;05;01;Lauantai;1;2;3
626;20.05.2017;2017;05;02;Lauantai;3;2;5
626;20.05.2017;2017;05;03;Lauantai;5;1;6
626;20.05.2017;2017;05;04;Lauantai;0;0;0
626;20.05.2017;2017;05;05;Lauantai;2;0;2
626;20.05.2017;2017;05;06;Lauantai;2;2;4
626;20.05.2017;2017;05;07;Lauantai;2;1;3
626;20.05.2017;2017;05;08;Lauantai;7;4;11
626;20.05.2017;2017;05;09;Lauantai;9;14;23
626;20.05.2017;2017;05;10;Lauantai;11;11;22
626;20.05.2017;2017;05;11;Lauantai;18;30;48
626;20.05.2017;2017;05;12;Lauantai;30;24;54
626;20.05.2017;2017;05;13;Lauantai;32;36;68
626;20.05.2017;2017;05;14;Lauantai;38;34;72
626;20.05.2017;2017;05;15;Lauantai;19;24;43
626;20.05.2017;2017;05;16;Lauantai;22;31;53
626;20.05.2017;2017;05;17;Lauantai;29;18;47
626;20.05.2017;2017;05;18;Lauantai;22;25;47
626;20.05.2017;2017;05;19;Lauantai;8;19;27
626;20.05.2017;2017;05;20;Lauantai;15;10;25
626;20.05.2017;2017;05;21;Lauantai;6;7;13
626;20.05.2017;2017;05;22;Lauantai;5;3;8
626;20.05.2017;2017;05;23;Lauantai;4;5;9
626;21.05.2017;2017;05;00;Sunnuntai;1;5;6
626;21.05.2017;2017;05;01;Sunnuntai;6;1;7
626;21.05.2017;2017;05;02;Sunnuntai;0;0;0
626;21.05.2017;2017;05;03;Sunnuntai;2;0;2
626;21.05.2017;2017;05;04;Sunnuntai;4;2;6
626;21.05.2017;2017;05;05;Sunnuntai;1;0;1
626;21.05.2017;2017;05;06;Sunnuntai;0;3;3
626;21.05.2017;2017;05;07;Sunnuntai;1;4;5
626;21.05.2017;2017;05;08;Sunnuntai;4;2;6
626;21.05.2017;2017;05;09;Sunnuntai;6;5;11
626;21.05.2017;2017;05;10;Sunnuntai;7;8;15
626;21.05.2017;2017;05;11;Sunnuntai;18;10;28
626;21.05.2017;2017;05;12;Sunnuntai;17;18;35
626;21.05.2017;2017;05;13;Sunnuntai;33;34;67
626;21.05.2017;2017;05;14;Sunnuntai;25;23;48
626;21.05.2017;2017;05;15;Sunnuntai;26;26;52
626;21.05.2017;2017;05;16;Sunnuntai;17;29;46
626;21.05.2017;2017;05;17;Sunnuntai;27;27;54
626;21.05.2017;2017;05;18;Sunnuntai;17;17;34
626;21.05.2017;2017;05;19;Sunnuntai;14;14;28
626;21.05.2017;2017;05;20;Sunnuntai;17;22;39
626;21.05.2017;2017;05;21;Sunnuntai;5;8;13
626;21.05.2017;2017;05;22;Sunnuntai;7;6;13
626;21.05.2017;2017;05;23;Sunnuntai;6;3;9
626;22.05.2017;2017;05;00;Maanantai;0;0;0
626;22.05.2017;2017;05;01;Maanantai;0;1;1
626;22.05.2017;2017;05;02;Maanantai;0;1;1
626;22.05.2017;2017;05;03;Maanantai;0;0;0
626;22.05.2017;2017;05;04;Maanantai;0;0;0
626;22.05.2017;2017;05;05;Maanantai;1;3;4
626;22.05.2017;2017;05;06;Maanantai;3;7;10
626;22.05.2017;2017;05;07;Maanantai;11;49;60
626;22.05.2017;2017;05;08;Maanantai;30;74;104
626;22.05.2017;2017;05;09;Maanantai;24;49;73
626;22.05.2017;2017;05;10;Maanantai;16;26;42
626;22.05.2017;2017;05;11;Maanantai;12;16;28
626;22.05.2017;2017;05;12;Maanantai;16;17;33
626;22.05.2017;2017;05;13;Maanantai;14;17;31
626;22.05.2017;2017;05;14;Maanantai;22;29;51
626;22.05.2017;2017;05;15;Maanantai;41;33;74
626;22.05.2017;2017;05;16;Maanantai;58;33;91
626;22.05.2017;2017;05;17;Maanantai;81;39;120
626;22.05.2017;2017;05;18;Maanantai;39;38;77
626;22.05.2017;2017;05;19;Maanantai;46;29;75
626;22.05.2017;2017;05;20;Maanantai;30;25;55
626;22.05.2017;2017;05;21;Maanantai;23;22;45
626;22.05.2017;2017;05;22;Maanantai;18;13;31
626;22.05.2017;2017;05;23;Maanantai;6;4;10
626;23.05.2017;2017;05;00;Tiistai;2;1;3
626;23.05.2017;2017;05;01;Tiistai;1;1;2
626;23.05.2017;2017;05;02;Tiistai;0;0;0
626;23.05.2017;2017;05;03;Tiistai;0;1;1
626;23.05.2017;2017;05;04;Tiistai;2;0;2
626;23.05.2017;2017;05;05;Tiistai;0;4;4
626;23.05.2017;2017;05;06;Tiistai;8;10;18
626;23.05.2017;2017;05;07;Tiistai;13;52;65
626;23.05.2017;2017;05;08;Tiistai;30;75;105
626;23.05.2017;2017;05;09;Tiistai;20;63;83
626;23.05.2017;2017;05;10;Tiistai;13;24;37
626;23.05.2017;2017;05;11;Tiistai;18;29;47
626;23.05.2017;2017;05;12;Tiistai;20;26;46
626;23.05.2017;2017;05;13;Tiistai;24;20;44
626;23.05.2017;2017;05;14;Tiistai;21;26;47
626;23.05.2017;2017;05;15;Tiistai;31;20;51
626;23.05.2017;2017;05;16;Tiistai;66;30;96
626;23.05.2017;2017;05;17;Tiistai;85;55;140
626;23.05.2017;2017;05;18;Tiistai;51;36;87
626;23.05.2017;2017;05;19;Tiistai;34;25;59
626;23.05.2017;2017;05;20;Tiistai;27;20;47
626;23.05.2017;2017;05;21;Tiistai;26;21;47
626;23.05.2017;2017;05;22;Tiistai;14;12;26
626;23.05.2017;2017;05;23;Tiistai;6;8;14
626;24.05.2017;2017;05;00;Keskiviikko;2;1;3
626;24.05.2017;2017;05;01;Keskiviikko;3;1;4
626;24.05.2017;2017;05;02;Keskiviikko;0;0;0
626;24.05.2017;2017;05;03;Keskiviikko;0;0;0
626;24.05.2017;2017;05;04;Keskiviikko;0;2;2
626;24.05.2017;2017;05;05;Keskiviikko;0;3;3
626;24.05.2017;2017;05;06;Keskiviikko;3;12;15
626;24.05.2017;2017;05;07;Keskiviikko;14;53;67
626;24.05.2017;2017;05;08;Keskiviikko;30;75;105
626;24.05.2017;2017;05;09;Keskiviikko;24;55;79
626;24.05.2017;2017;05;10;Keskiviikko;11;29;40
626;24.05.2017;2017;05;11;Keskiviikko;13;24;37
626;24.05.2017;2017;05;12;Keskiviikko;22;22;44
626;24.05.2017;2017;05;13;Keskiviikko;27;26;53
626;24.05.2017;2017;05;14;Keskiviikko;31;36;67
626;24.05.2017;2017;05;15;Keskiviikko;50;28;78
626;24.05.2017;2017;05;16;Keskiviikko;62;49;111
626;24.05.2017;2017;05;17;Keskiviikko;73;45;118
626;24.05.2017;2017;05;18;Keskiviikko;53;45;98
626;24.05.2017;2017;05;19;Keskiviikko;45;29;74
626;24.05.2017;2017;05;20;Keskiviikko;28;26;54
626;24.05.2017;2017;05;21;Keskiviikko;21;17;38
626;24.05.2017;2017;05;22;Keskiviikko;18;13;31
626;24.05.2017;2017;05;23;Keskiviikko;13;5;18
626;25.05.2017;2017;05;00;Torstai;4;3;7
626;25.05.2017;2017;05;01;Torstai;2;0;2
626;25.05.2017;2017;05;02;Torstai;1;0;1
626;25.05.2017;2017;05;03;Torstai;0;0;0
626;25.05.2017;2017;05;04;Torstai;3;0;3
626;25.05.2017;2017;05;05;Torstai;0;0;0
626;25.05.2017;2017;05;06;Torstai;1;7;8
626;25.05.2017;2017;05;07;Torstai;1;8;9
626;25.05.2017;2017;05;08;Torstai;5;9;14
626;25.05.2017;2017;05;09;Torstai;7;7;14
626;25.05.2017;2017;05;10;Torstai;16;15;31
626;25.05.2017;2017;05;11;Torstai;21;16;37
626;25.05.2017;2017;05;12;Torstai;30;39;69
626;25.05.2017;2017;05;13;Torstai;28;30;58
626;25.05.2017;2017;05;14;Torstai;31;23;54
626;25.05.2017;2017;05;15;Torstai;29;18;47
626;25.05.2017;2017;05;16;Torstai;23;25;48
626;25.05.2017;2017;05;17;Torstai;38;26;64
626;25.05.2017;2017;05;18;Torstai;14;23;37
626;25.05.2017;2017;05;19;Torstai;20;19;39
626;25.05.2017;2017;05;20;Torstai;20;19;39
626;25.05.2017;2017;05;21;Torstai;16;11;27
626;25.05.2017;2017;05;22;Torstai;10;7;17
626;25.05.2017;2017;05;23;Torstai;3;2;5
626;26.05.2017;2017;05;00;Perjantai;3;2;5
626;26.05.2017;2017;05;01;Perjantai;0;0;0
626;26.05.2017;2017;05;02;Perjantai;0;0;0
626;26.05.2017;2017;05;03;Perjantai;0;0;0
626;26.05.2017;2017;05;04;Perjantai;0;2;2
626;26.05.2017;2017;05;05;Perjantai;0;3;3
626;26.05.2017;2017;05;06;Perjantai;1;10;11
626;26.05.2017;2017;05;07;Perjantai;15;19;34
626;26.05.2017;2017;05;08;Perjantai;24;54;78
626;26.05.2017;2017;05;09;Perjantai;20;32;52
626;26.05.2017;2017;05;10;Perjantai;9;16;25
626;26.05.2017;2017;05;11;Perjantai;12;17;29
626;26.05.2017;2017;05;12;Perjantai;17;18;35
626;26.05.2017;2017;05;13;Perjantai;28;24;52
626;26.05.2017;2017;05;14;Perjantai;26;26;52
626;26.05.2017;2017;05;15;Perjantai;24;19;43
626;26.05.2017;2017;05;16;Perjantai;51;32;83
626;26.05.2017;2017;05;17;Perjantai;62;30;92
626;26.05.2017;2017;05;18;Perjantai;31;15;46
626;26.05.2017;2017;05;19;Perjantai;16;19;35
626;26.05.2017;2017;05;20;Perjantai;24;16;40
626;26.05.2017;2017;05;21;Perjantai;12;11;23
626;26.05.2017;2017;05;22;Perjantai;8;10;18
626;26.05.2017;2017;05;23;Perjantai;5;2;7
626;27.05.2017;2017;05;00;Lauantai;0;4;4
626;27.05.2017;2017;05;01;Lauantai;2;0;2
626;27.05.2017;2017;05;02;Lauantai;1;1;2
626;27.05.2017;2017;05;03;Lauantai;1;1;2
626;27.05.2017;2017;05;04;Lauantai;2;0;2
626;27.05.2017;2017;05;05;Lauantai;2;1;3
626;27.05.2017;2017;05;06;Lauantai;2;6;8
626;27.05.2017;2017;05;07;Lauantai;3;2;5
626;27.05.2017;2017;05;08;Lauantai;2;4;6
626;27.05.2017;2017;05;09;Lauantai;4;8;12
626;27.05.2017;2017;05;10;Lauantai;7;12;19
626;27.05.2017;2017;05;11;Lauantai;14;17;31
626;27.05.2017;2017;05;12;Lauantai;8;4;12
626;27.05.2017;2017;05;13;Lauantai;14;24;38
626;27.05.2017;2017;05;14;Lauantai;21;22;43
626;27.05.2017;2017;05;15;Lauantai;17;15;32
626;27.05.2017;2017;05;16;Lauantai;16;15;31
626;27.05.2017;2017;05;17;Lauantai;10;9;19
626;27.05.2017;2017;05;18;Lauantai;11;11;22
626;27.05.2017;2017;05;19;Lauantai;9;10;19
626;27.05.2017;2017;05;20;Lauantai;10;8;18
626;27.05.2017;2017;05;21;Lauantai;1;3;4
626;27.05.2017;2017;05;22;Lauantai;9;9;18
626;27.05.2017;2017;05;23;Lauantai;5;1;6
626;28.05.2017;2017;05;00;Sunnuntai;5;1;6
626;28.05.2017;2017;05;01;Sunnuntai;1;2;3
626;28.05.2017;2017;05;02;Sunnuntai;0;0;0
626;28.05.2017;2017;05;03;Sunnuntai;1;0;1
626;28.05.2017;2017;05;04;Sunnuntai;0;0;0
626;28.05.2017;2017;05;05;Sunnuntai;2;0;2
626;28.05.2017;2017;05;06;Sunnuntai;1;3;4
626;28.05.2017;2017;05;07;Sunnuntai;0;4;4
626;28.05.2017;2017;05;08;Sunnuntai;0;0;0
626;28.05.2017;2017;05;09;Sunnuntai;4;3;7
626;28.05.2017;2017;05;10;Sunnuntai;6;7;13
626;28.05.2017;2017;05;11;Sunnuntai;5;9;14
626;28.05.2017;2017;05;12;Sunnuntai;2;2;4
626;28.05.2017;2017;05;13;Sunnuntai;2;3;5
626;28.05.2017;2017;05;14;Sunnuntai;0;7;7
626;28.05.2017;2017;05;15;Sunnuntai;4;7;11
626;28.05.2017;2017;05;16;Sunnuntai;11;1;12
626;28.05.2017;2017;05;17;Sunnuntai;7;12;19
626;28.05.2017;2017;05;18;Sunnuntai;7;8;15
626;28.05.2017;2017;05;19;Sunnuntai;5;12;17
626;28.05.2017;2017;05;20;Sunnuntai;5;3;8
626;28.05.2017;2017;05;21;Sunnuntai;6;5;11
626;28.05.2017;2017;05;22;Sunnuntai;2;2;4
626;28.05.2017;2017;05;23;Sunnuntai;4;2;6
626;29.05.2017;2017;05;00;Maanantai;1;0;1
626;29.05.2017;2017;05;01;Maanantai;0;0;0
626;29.05.2017;2017;05;02;Maanantai;1;0;1
626;29.05.2017;2017;05;03;Maanantai;0;0;0
626;29.05.2017;2017;05;04;Maanantai;0;1;1
626;29.05.2017;2017;05;05;Maanantai;0;3;3
626;29.05.2017;2017;05;06;Maanantai;4;8;12
626;29.05.2017;2017;05;07;Maanantai;9;34;43
626;29.05.2017;2017;05;08;Maanantai;33;89;122
626;29.05.2017;2017;05;09;Maanantai;16;33;49
626;29.05.2017;2017;05;10;Maanantai;6;23;29
626;29.05.2017;2017;05;11;Maanantai;26;33;59
626;29.05.2017;2017;05;12;Maanantai;43;38;81
626;29.05.2017;2017;05;13;Maanantai;16;14;30
626;29.05.2017;2017;05;14;Maanantai;32;30;62
626;29.05.2017;2017;05;15;Maanantai;47;36;83
626;29.05.2017;2017;05;16;Maanantai;45;30;75
626;29.05.2017;2017;05;17;Maanantai;61;37;98
626;29.05.2017;2017;05;18;Maanantai;51;27;78
626;29.05.2017;2017;05;19;Maanantai;43;19;62
626;29.05.2017;2017;05;20;Maanantai;22;19;41
626;29.05.2017;2017;05;21;Maanantai;12;6;18
626;29.05.2017;2017;05;22;Maanantai;10;10;20
626;29.05.2017;2017;05;23;Maanantai;9;3;12
626;30.05.2017;2017;05;00;Tiistai;5;2;7
626;30.05.2017;2017;05;01;Tiistai;0;0;0
626;30.05.2017;2017;05;02;Tiistai;0;0;0
626;30.05.2017;2017;05;03;Tiistai;0;0;0
626;30.05.2017;2017;05;04;Tiistai;0;1;1
626;30.05.2017;2017;05;05;Tiistai;0;5;5
626;30.05.2017;2017;05;06;Tiistai;6;4;10
626;30.05.2017;2017;05;07;Tiistai;13;48;61
626;30.05.2017;2017;05;08;Tiistai;21;73;94
626;30.05.2017;2017;05;09;Tiistai;26;56;82
626;30.05.2017;2017;05;10;Tiistai;15;25;40
626;30.05.2017;2017;05;11;Tiistai;18;25;43
626;30.05.2017;2017;05;12;Tiistai;43;39;82
626;30.05.2017;2017;05;13;Tiistai;27;21;48
626;30.05.2017;2017;05;14;Tiistai;38;44;82
626;30.05.2017;2017;05;15;Tiistai;60;43;103
626;30.05.2017;2017;05;16;Tiistai;45;34;79
626;30.05.2017;2017;05;17;Tiistai;84;55;139
626;30.05.2017;2017;05;18;Tiistai;41;31;72
626;30.05.2017;2017;05;19;Tiistai;28;26;54
626;30.05.2017;2017;05;20;Tiistai;42;18;60
626;30.05.2017;2017;05;21;Tiistai;28;21;49
626;30.05.2017;2017;05;22;Tiistai;14;14;28
626;30.05.2017;2017;05;23;Tiistai;7;7;14
626;31.05.2017;2017;05;00;Keskiviikko;0;2;2
626;31.05.2017;2017;05;01;Keskiviikko;4;1;5
626;31.05.2017;2017;05;02;Keskiviikko;0;1;1
626;31.05.2017;2017;05;03;Keskiviikko;1;1;2
626;31.05.2017;2017;05;04;Keskiviikko;0;0;0
626;31.05.2017;2017;05;05;Keskiviikko;0;2;2
626;31.05.2017;2017;05;06;Keskiviikko;5;2;7
626;31.05.2017;2017;05;07;Keskiviikko;14;38;52
626;31.05.2017;2017;05;08;Keskiviikko;17;69;86
626;31.05.2017;2017;05;09;Keskiviikko;19;35;54
626;31.05.2017;2017;05;10;Keskiviikko;7;10;17
626;31.05.2017;2017;05;11;Keskiviikko;3;4;7
626;31.05.2017;2017;05;12;Keskiviikko;8;6;14
626;31.05.2017;2017;05;13;Keskiviikko;11;12;23
626;31.05.2017;2017;05;14;Keskiviikko;16;5;21
626;31.05.2017;2017;05;15;Keskiviikko;23;17;40
626;31.05.2017;2017;05;16;Keskiviikko;25;20;45
626;31.05.2017;2017;05;17;Keskiviikko;58;32;90
626;31.05.2017;2017;05;18;Keskiviikko;25;29;54
626;31.05.2017;2017;05;19;Keskiviikko;22;20;42
626;31.05.2017;2017;05;20;Keskiviikko;23;10;33
626;31.05.2017;2017;05;21;Keskiviikko;17;10;27
626;31.05.2017;2017;05;22;Keskiviikko;11;9;20
626;31.05.2017;2017;05;23;Keskiviikko;4;4;8
626;01.06.2017;2017;06;00;Torstai;1;0;1
626;01.06.2017;2017;06;01;Torstai;0;1;1
626;01.06.2017;2017;06;02;Torstai;0;0;0
626;01.06.2017;2017;06;03;Torstai;0;0;0
626;01.06.2017;2017;06;04;Torstai;0;1;1
626;01.06.2017;2017;06;05;Torstai;0;5;5
626;01.06.2017;2017;06;06;Torstai;7;7;14
626;01.06.2017;2017;06;07;Torstai;11;39;50
626;01.06.2017;2017;06;08;Torstai;23;60;83
626;01.06.2017;2017;06;09;Torstai;24;57;81
626;01.06.2017;2017;06;10;Torstai;15;22;37
626;01.06.2017;2017;06;11;Torstai;13;15;28
626;01.06.2017;2017;06;12;Torstai;21;9;30
626;01.06.2017;2017;06;13;Torstai;12;8;20
626;01.06.2017;2017;06;14;Torstai;15;13;28
626;01.06.2017;2017;06;15;Torstai;18;10;28
626;01.06.2017;2017;06;16;Torstai;25;20;45
626;01.06.2017;2017;06;17;Torstai;58;32;90
626;01.06.2017;2017;06;18;Torstai;25;29;54
626;01.06.2017;2017;06;19;Torstai;22;20;42
626;01.06.2017;2017;06;20;Torstai;23;10;33
626;01.06.2017;2017;06;21;Torstai;17;10;27
626;01.06.2017;2017;06;22;Torstai;11;9;20
626;01.06.2017;2017;06;23;Torstai;4;4;8
626;02.06.2017;2017;06;00;Perjantai;0;2;2
626;02.06.2017;2017;06;01;Perjantai;4;1;5
626;02.06.2017;2017;06;02;Perjantai;0;1;1
626;02.06.2017;2017;06;03;Perjantai;1;1;2
626;02.06.2017;2017;06;04;Perjantai;0;0;0
626;02.06.2017;2017;06;05;Perjantai;0;2;2
626;02.06.2017;2017;06;06;Perjantai;5;2;7
626;02.06.2017;2017;06;07;Perjantai;14;38;52
626;02.06.2017;2017;06;08;Perjantai;17;50;67
626;02.06.2017;2017;06;09;Perjantai;19;35;54
626;02.06.2017;2017;06;10;Perjantai;7;10;17
626;02.06.2017;2017;06;11;Perjantai;3;4;7
626;02.06.2017;2017;06;12;Perjantai;8;6;14
626;02.06.2017;2017;06;13;Perjantai;11;12;23
626;02.06.2017;2017;06;14;Perjantai;16;5;21
626;02.06.2017;2017;06;15;Perjantai;23;17;40
626;02.06.2017;2017;06;16;Perjantai;25;20;45
626;02.06.2017;2017;06;17;Perjantai;58;32;90
626;02.06.2017;2017;06;18;Perjantai;15;9;24
626;02.06.2017;2017;06;19;Perjantai;13;3;16
626;02.06.2017;2017;06;20;Perjantai;12;10;22
626;02.06.2017;2017;06;21;Perjantai;8;11;19
626;02.06.2017;2017;06;22;Perjantai;8;6;14
626;02.06.2017;2017;06;23;Perjantai;3;3;6
626;03.06.2017;2017;06;00;Lauantai;1;2;3
626;03.06.2017;2017;06;01;Lauantai;1;1;2
626;03.06.2017;2017;06;02;Lauantai;2;1;3
626;03.06.2017;2017;06;03;Lauantai;1;0;1
626;03.06.2017;2017;06;04;Lauantai;0;0;0
626;03.06.2017;2017;06;05;Lauantai;3;0;3
626;03.06.2017;2017;06;06;Lauantai;1;3;4
626;03.06.2017;2017;06;07;Lauantai;2;5;7
626;03.06.2017;2017;06;08;Lauantai;1;2;3
626;03.06.2017;2017;06;09;Lauantai;12;10;22
626;03.06.2017;2017;06;10;Lauantai;8;16;24
626;03.06.2017;2017;06;11;Lauantai;13;9;22
626;03.06.2017;2017;06;12;Lauantai;20;16;36
626;03.06.2017;2017;06;13;Lauantai;22;20;42
626;03.06.2017;2017;06;14;Lauantai;17;19;36
626;03.06.2017;2017;06;15;Lauantai;9;12;21
626;03.06.2017;2017;06;16;Lauantai;17;21;38
626;03.06.2017;2017;06;17;Lauantai;14;12;26
626;03.06.2017;2017;06;18;Lauantai;22;15;37
626;03.06.2017;2017;06;19;Lauantai;12;23;35
626;03.06.2017;2017;06;20;Lauantai;2;7;9
626;03.06.2017;2017;06;21;Lauantai;3;3;6
626;03.06.2017;2017;06;22;Lauantai;7;10;17
626;03.06.2017;2017;06;23;Lauantai;5;3;8
626;04.06.2017;2017;06;00;Sunnuntai;2;2;4
626;04.06.2017;2017;06;01;Sunnuntai;2;3;5
626;04.06.2017;2017;06;02;Sunnuntai;4;0;4
626;04.06.2017;2017;06;03;Sunnuntai;4;1;5
626;04.06.2017;2017;06;04;Sunnuntai;3;1;4
626;04.06.2017;2017;06;05;Sunnuntai;1;0;1
626;04.06.2017;2017;06;06;Sunnuntai;1;2;3
626;04.06.2017;2017;06;07;Sunnuntai;4;3;7
626;04.06.2017;2017;06;08;Sunnuntai;3;3;6
626;04.06.2017;2017;06;09;Sunnuntai;5;9;14
626;04.06.2017;2017;06;10;Sunnuntai;8;5;13
626;04.06.2017;2017;06;11;Sunnuntai;15;19;34
626;04.06.2017;2017;06;12;Sunnuntai;15;16;31
626;04.06.2017;2017;06;13;Sunnuntai;26;24;50
626;04.06.2017;2017;06;14;Sunnuntai;23;35;58
626;04.06.2017;2017;06;15;Sunnuntai;25;27;52
626;04.06.2017;2017;06;16;Sunnuntai;26;28;54
626;04.06.2017;2017;06;17;Sunnuntai;25;16;41
626;04.06.2017;2017;06;18;Sunnuntai;16;14;30
626;04.06.2017;2017;06;19;Sunnuntai;17;16;33
626;04.06.2017;2017;06;20;Sunnuntai;10;12;22
626;04.06.2017;2017;06;21;Sunnuntai;6;8;14
626;04.06.2017;2017;06;22;Sunnuntai;9;4;13
626;04.06.2017;2017;06;23;Sunnuntai;3;4;7
626;05.06.2017;2017;06;00;Maanantai;3;1;4
626;05.06.2017;2017;06;01;Maanantai;0;0;0
626;05.06.2017;2017;06;02;Maanantai;0;1;1
626;05.06.2017;2017;06;03;Maanantai;1;1;2
626;05.06.2017;2017;06;04;Maanantai;0;1;1
626;05.06.2017;2017;06;05;Maanantai;1;4;5
626;05.06.2017;2017;06;06;Maanantai;6;13;19
626;05.06.2017;2017;06;07;Maanantai;16;68;84
626;05.06.2017;2017;06;08;Maanantai;33;77;110
626;05.06.2017;2017;06;09;Maanantai;21;59;80
626;05.06.2017;2017;06;10;Maanantai;17;33;50
626;05.06.2017;2017;06;11;Maanantai;17;15;32
626;05.06.2017;2017;06;12;Maanantai;21;32;53
626;05.06.2017;2017;06;13;Maanantai;24;30;54
626;05.06.2017;2017;06;14;Maanantai;32;43;75
626;05.06.2017;2017;06;15;Maanantai;44;33;77
626;05.06.2017;2017;06;16;Maanantai;64;34;98
626;05.06.2017;2017;06;17;Maanantai;97;66;163
626;05.06.2017;2017;06;18;Maanantai;51;37;88
626;05.06.2017;2017;06;19;Maanantai;54;27;81
626;05.06.2017;2017;06;20;Maanantai;27;24;51
626;05.06.2017;2017;06;21;Maanantai;22;13;35
626;05.06.2017;2017;06;22;Maanantai;14;14;28
626;05.06.2017;2017;06;23;Maanantai;7;7;14
626;06.06.2017;2017;06;00;Tiistai;2;0;2
626;06.06.2017;2017;06;01;Tiistai;2;3;5
626;06.06.2017;2017;06;02;Tiistai;2;1;3
626;06.06.2017;2017;06;03;Tiistai;0;1;1
626;06.06.2017;2017;06;04;Tiistai;2;0;2
626;06.06.2017;2017;06;05;Tiistai;0;5;5
626;06.06.2017;2017;06;06;Tiistai;2;12;14
626;06.06.2017;2017;06;07;Tiistai;15;36;51
626;06.06.2017;2017;06;08;Tiistai;13;71;84
626;06.06.2017;2017;06;09;Tiistai;14;32;46
626;06.06.2017;2017;06;10;Tiistai;12;18;30
626;06.06.2017;2017;06;11;Tiistai;8;17;25
626;06.06.2017;2017;06;12;Tiistai;12;11;23
626;06.06.2017;2017;06;13;Tiistai;20;14;34
626;06.06.2017;2017;06;14;Tiistai;15;24;39
626;06.06.2017;2017;06;15;Tiistai;25;24;49
626;06.06.2017;2017;06;16;Tiistai;47;22;69
626;06.06.2017;2017;06;17;Tiistai;68;44;112
626;06.06.2017;2017;06;18;Tiistai;67;40;107
626;06.06.2017;2017;06;19;Tiistai;38;25;63
626;06.06.2017;2017;06;20;Tiistai;34;23;57
626;06.06.2017;2017;06;21;Tiistai;35;25;60
626;06.06.2017;2017;06;22;Tiistai;11;15;26
626;06.06.2017;2017;06;23;Tiistai;4;9;13
626;07.06.2017;2017;06;00;Keskiviikko;6;5;11
626;07.06.2017;2017;06;01;Keskiviikko;1;1;2
626;07.06.2017;2017;06;02;Keskiviikko;0;1;1
626;07.06.2017;2017;06;03;Keskiviikko;1;0;1
626;07.06.2017;2017;06;04;Keskiviikko;1;0;1
626;07.06.2017;2017;06;05;Keskiviikko;0;3;3
626;07.06.2017;2017;06;06;Keskiviikko;1;14;15
626;07.06.2017;2017;06;07;Keskiviikko;20;72;92
626;07.06.2017;2017;06;08;Keskiviikko;31;112;143
626;07.06.2017;2017;06;09;Keskiviikko;29;64;93
626;07.06.2017;2017;06;10;Keskiviikko;26;41;67
626;07.06.2017;2017;06;11;Keskiviikko;22;38;60
626;07.06.2017;2017;06;12;Keskiviikko;33;47;80
626;07.06.2017;2017;06;13;Keskiviikko;33;45;78
626;07.06.2017;2017;06;14;Keskiviikko;48;42;90
626;07.06.2017;2017;06;15;Keskiviikko;40;39;79
626;07.06.2017;2017;06;16;Keskiviikko;109;59;168
626;07.06.2017;2017;06;17;Keskiviikko;128;88;216
626;07.06.2017;2017;06;18;Keskiviikko;80;52;132
626;07.06.2017;2017;06;19;Keskiviikko;70;43;113
626;07.06.2017;2017;06;20;Keskiviikko;48;47;95
626;07.06.2017;2017;06;21;Keskiviikko;41;24;65
626;07.06.2017;2017;06;22;Keskiviikko;27;22;49
626;07.06.2017;2017;06;23;Keskiviikko;18;10;28
626;08.06.2017;2017;06;00;Torstai;3;6;9
626;08.06.2017;2017;06;01;Torstai;2;2;4
626;08.06.2017;2017;06;02;Torstai;4;1;5
626;08.06.2017;2017;06;03;Torstai;4;1;5
626;08.06.2017;2017;06;04;Torstai;1;1;2
626;08.06.2017;2017;06;05;Torstai;0;2;2
626;08.06.2017;2017;06;06;Torstai;7;12;19
626;08.06.2017;2017;06;07;Torstai;21;72;93
626;08.06.2017;2017;06;08;Torstai;37;120;157
626;08.06.2017;2017;06;09;Torstai;29;68;97
626;08.06.2017;2017;06;10;Torstai;22;47;69
626;08.06.2017;2017;06;11;Torstai;25;36;61
626;08.06.2017;2017;06;12;Torstai;24;44;68
626;08.06.2017;2017;06;13;Torstai;46;45;91
626;08.06.2017;2017;06;14;Torstai;44;40;84
626;08.06.2017;2017;06;15;Torstai;54;42;96
626;08.06.2017;2017;06;16;Torstai;86;56;142
626;08.06.2017;2017;06;17;Torstai;124;75;199
626;08.06.2017;2017;06;18;Torstai;72;59;131
626;08.06.2017;2017;06;19;Torstai;60;38;98
626;08.06.2017;2017;06;20;Torstai;49;29;78
626;08.06.2017;2017;06;21;Torstai;38;18;56
626;08.06.2017;2017;06;22;Torstai;25;23;48
626;08.06.2017;2017;06;23;Torstai;17;10;27
626;09.06.2017;2017;06;00;Perjantai;10;2;12
626;09.06.2017;2017;06;01;Perjantai;5;1;6
626;09.06.2017;2017;06;02;Perjantai;4;0;4
626;09.06.2017;2017;06;03;Perjantai;0;1;1
626;09.06.2017;2017;06;04;Perjantai;0;1;1
626;09.06.2017;2017;06;05;Perjantai;1;0;1
626;09.06.2017;2017;06;06;Perjantai;6;13;19
626;09.06.2017;2017;06;07;Perjantai;14;48;62
626;09.06.2017;2017;06;08;Perjantai;24;89;113
626;09.06.2017;2017;06;09;Perjantai;29;46;75
626;09.06.2017;2017;06;10;Perjantai;9;33;42
626;09.06.2017;2017;06;11;Perjantai;19;27;46
626;09.06.2017;2017;06;12;Perjantai;31;37;68
626;09.06.2017;2017;06;13;Perjantai;30;38;68
626;09.06.2017;2017;06;14;Perjantai;40;37;77
626;09.06.2017;2017;06;15;Perjantai;64;39;103
626;09.06.2017;2017;06;16;Perjantai;83;58;141
626;09.06.2017;2017;06;17;Perjantai;86;59;145
626;09.06.2017;2017;06;18;Perjantai;52;46;98
626;09.06.2017;2017;06;19;Perjantai;47;34;81
626;09.06.2017;2017;06;20;Perjantai;31;21;52
626;09.06.2017;2017;06;21;Perjantai;14;29;43
626;09.06.2017;2017;06;22;Perjantai;25;13;38
626;09.06.2017;2017;06;23;Perjantai;14;7;21
626;10.06.2017;2017;06;00;Lauantai;15;8;23
626;10.06.2017;2017;06;01;Lauantai;6;4;10
626;10.06.2017;2017;06;02;Lauantai;14;3;17
626;10.06.2017;2017;06;03;Lauantai;10;1;11
626;10.06.2017;2017;06;04;Lauantai;7;2;9
626;10.06.2017;2017;06;05;Lauantai;4;0;4
626;10.06.2017;2017;06;06;Lauantai;5;4;9
626;10.06.2017;2017;06;07;Lauantai;0;5;5
626;10.06.2017;2017;06;08;Lauantai;6;3;9
626;10.06.2017;2017;06;09;Lauantai;13;13;26
626;10.06.2017;2017;06;10;Lauantai;17;23;40
626;10.06.2017;2017;06;11;Lauantai;30;30;60
626;10.06.2017;2017;06;12;Lauantai;43;37;80
626;10.06.2017;2017;06;13;Lauantai;32;41;73
626;10.06.2017;2017;06;14;Lauantai;43;56;99
626;10.06.2017;2017;06;15;Lauantai;38;43;81
626;10.06.2017;2017;06;16;Lauantai;36;33;69
626;10.06.2017;2017;06;17;Lauantai;36;30;66
626;10.06.2017;2017;06;18;Lauantai;20;27;47
626;10.06.2017;2017;06;19;Lauantai;16;23;39
626;10.06.2017;2017;06;20;Lauantai;17;15;32
626;10.06.2017;2017;06;21;Lauantai;9;10;19
626;10.06.2017;2017;06;22;Lauantai;2;4;6
626;10.06.2017;2017;06;23;Lauantai;6;4;10
626;11.06.2017;2017;06;00;Sunnuntai;6;1;7
626;11.06.2017;2017;06;01;Sunnuntai;1;2;3
626;11.06.2017;2017;06;02;Sunnuntai;5;1;6
626;11.06.2017;2017;06;03;Sunnuntai;6;2;8
626;11.06.2017;2017;06;04;Sunnuntai;0;0;0
626;11.06.2017;2017;06;05;Sunnuntai;2;0;2
626;11.06.2017;2017;06;06;Sunnuntai;2;1;3
626;11.06.2017;2017;06;07;Sunnuntai;1;1;2
626;11.06.2017;2017;06;08;Sunnuntai;1;4;5
626;11.06.2017;2017;06;09;Sunnuntai;5;2;7
626;11.06.2017;2017;06;10;Sunnuntai;11;9;20
626;11.06.2017;2017;06;11;Sunnuntai;17;21;38
626;11.06.2017;2017;06;12;Sunnuntai;30;37;67
626;11.06.2017;2017;06;13;Sunnuntai;27;36;63
626;11.06.2017;2017;06;14;Sunnuntai;31;50;81
626;11.06.2017;2017;06;15;Sunnuntai;34;25;59
626;11.06.2017;2017;06;16;Sunnuntai;30;31;61
626;11.06.2017;2017;06;17;Sunnuntai;28;24;52
626;11.06.2017;2017;06;18;Sunnuntai;13;18;31
626;11.06.2017;2017;06;19;Sunnuntai;15;28;43
626;11.06.2017;2017;06;20;Sunnuntai;18;6;24
626;11.06.2017;2017;06;21;Sunnuntai;19;7;26
626;11.06.2017;2017;06;22;Sunnuntai;12;7;19
626;11.06.2017;2017;06;23;Sunnuntai;1;2;3
626;12.06.2017;2017;06;00;Maanantai;6;2;8
626;12.06.2017;2017;06;01;Maanantai;1;1;2
626;12.06.2017;2017;06;02;Maanantai;0;0;0
626;12.06.2017;2017;06;03;Maanantai;0;0;0
626;12.06.2017;2017;06;04;Maanantai;0;0;0
626;12.06.2017;2017;06;05;Maanantai;0;0;0
626;12.06.2017;2017;06;06;Maanantai;3;5;8
626;12.06.2017;2017;06;07;Maanantai;11;48;59
626;12.06.2017;2017;06;08;Maanantai;29;62;91
626;12.06.2017;2017;06;09;Maanantai;15;21;36
626;12.06.2017;2017;06;10;Maanantai;4;7;11
626;12.06.2017;2017;06;11;Maanantai;2;5;7
626;12.06.2017;2017;06;12;Maanantai;2;8;10
626;12.06.2017;2017;06;13;Maanantai;14;12;26
626;12.06.2017;2017;06;14;Maanantai;18;12;30
626;12.06.2017;2017;06;15;Maanantai;9;14;23
626;12.06.2017;2017;06;16;Maanantai;52;36;88
626;12.06.2017;2017;06;17;Maanantai;70;49;119
626;12.06.2017;2017;06;18;Maanantai;31;19;50
626;12.06.2017;2017;06;19;Maanantai;25;22;47
626;12.06.2017;2017;06;20;Maanantai;17;15;32
626;12.06.2017;2017;06;21;Maanantai;13;19;32
626;12.06.2017;2017;06;22;Maanantai;14;5;19
626;12.06.2017;2017;06;23;Maanantai;6;5;11
626;13.06.2017;2017;06;00;Tiistai;4;2;6
626;13.06.2017;2017;06;01;Tiistai;1;2;3
626;13.06.2017;2017;06;02;Tiistai;1;1;2
626;13.06.2017;2017;06;03;Tiistai;0;0;0
626;13.06.2017;2017;06;04;Tiistai;0;0;0
626;13.06.2017;2017;06;05;Tiistai;4;7;11
626;13.06.2017;2017;06;06;Tiistai;3;13;16
626;13.06.2017;2017;06;07;Tiistai;18;54;72
626;13.06.2017;2017;06;08;Tiistai;27;97;124
626;13.06.2017;2017;06;09;Tiistai;15;43;58
626;13.06.2017;2017;06;10;Tiistai;18;25;43
626;13.06.2017;2017;06;11;Tiistai;18;19;37
626;13.06.2017;2017;06;12;Tiistai;18;26;44
626;13.06.2017;2017;06;13;Tiistai;14;29;43
626;13.06.2017;2017;06;14;Tiistai;24;26;50
626;13.06.2017;2017;06;15;Tiistai;39;32;71
626;13.06.2017;2017;06;16;Tiistai;66;33;99
626;13.06.2017;2017;06;17;Tiistai;95;47;142
626;13.06.2017;2017;06;18;Tiistai;55;40;95
626;13.06.2017;2017;06;19;Tiistai;33;26;59
626;13.06.2017;2017;06;20;Tiistai;42;27;69
626;13.06.2017;2017;06;21;Tiistai;22;18;40
626;13.06.2017;2017;06;22;Tiistai;16;11;27
626;13.06.2017;2017;06;23;Tiistai;7;7;14
626;14.06.2017;2017;06;00;Keskiviikko;2;1;3
626;14.06.2017;2017;06;01;Keskiviikko;4;0;4
626;14.06.2017;2017;06;02;Keskiviikko;1;1;2
626;14.06.2017;2017;06;03;Keskiviikko;3;0;3
626;14.06.2017;2017;06;04;Keskiviikko;1;1;2
626;14.06.2017;2017;06;05;Keskiviikko;0;1;1
626;14.06.2017;2017;06;06;Keskiviikko;8;7;15
626;14.06.2017;2017;06;07;Keskiviikko;14;52;66
626;14.06.2017;2017;06;08;Keskiviikko;26;87;113
626;14.06.2017;2017;06;09;Keskiviikko;24;58;82
626;14.06.2017;2017;06;10;Keskiviikko;25;27;52
626;14.06.2017;2017;06;11;Keskiviikko;12;22;34
626;14.06.2017;2017;06;12;Keskiviikko;16;22;38
626;14.06.2017;2017;06;13;Keskiviikko;24;33;57
626;14.06.2017;2017;06;14;Keskiviikko;31;31;62
626;14.06.2017;2017;06;15;Keskiviikko;39;26;65
626;14.06.2017;2017;06;16;Keskiviikko;81;40;121
626;14.06.2017;2017;06;17;Keskiviikko;92;65;157
626;14.06.2017;2017;06;18;Keskiviikko;57;45;102
626;14.06.2017;2017;06;19;Keskiviikko;37;29;66
626;14.06.2017;2017;06;20;Keskiviikko;31;20;51
626;14.06.2017;2017;06;21;Keskiviikko;28;19;47
626;14.06.2017;2017;06;22;Keskiviikko;9;11;20
626;14.06.2017;2017;06;23;Keskiviikko;9;9;18
626;15.06.2017;2017;06;00;Torstai;3;1;4
626;15.06.2017;2017;06;01;Torstai;3;1;4
626;15.06.2017;2017;06;02;Torstai;3;1;4
626;15.06.2017;2017;06;03;Torstai;2;0;2
626;15.06.2017;2017;06;04;Torstai;1;1;2
626;15.06.2017;2017;06;05;Torstai;0;3;3
626;15.06.2017;2017;06;06;Torstai;5;9;14
626;15.06.2017;2017;06;07;Torstai;12;53;65
626;15.06.2017;2017;06;08;Torstai;31;76;107
626;15.06.2017;2017;06;09;Torstai;17;54;71
626;15.06.2017;2017;06;10;Torstai;10;25;35
626;15.06.2017;2017;06;11;Torstai;17;26;43
626;15.06.2017;2017;06;12;Torstai;33;32;65
626;15.06.2017;2017;06;13;Torstai;16;42;58
626;15.06.2017;2017;06;14;Torstai;34;42;76
626;15.06.2017;2017;06;15;Torstai;44;34;78
626;15.06.2017;2017;06;16;Torstai;72;40;112
626;15.06.2017;2017;06;17;Torstai;100;57;157
626;15.06.2017;2017;06;18;Torstai;76;52;128
626;15.06.2017;2017;06;19;Torstai;48;25;73
626;15.06.2017;2017;06;20;Torstai;37;25;62
626;15.06.2017;2017;06;21;Torstai;31;30;61
626;15.06.2017;2017;06;22;Torstai;26;24;50
626;15.06.2017;2017;06;23;Torstai;11;5;16
626;16.06.2017;2017;06;00;Perjantai;6;4;10
626;16.06.2017;2017;06;01;Perjantai;1;0;1
626;16.06.2017;2017;06;02;Perjantai;1;1;2
626;16.06.2017;2017;06;03;Perjantai;1;0;1
626;16.06.2017;2017;06;04;Perjantai;0;0;0
626;16.06.2017;2017;06;05;Perjantai;0;2;2
626;16.06.2017;2017;06;06;Perjantai;10;12;22
626;16.06.2017;2017;06;07;Perjantai;11;40;51
626;16.06.2017;2017;06;08;Perjantai;21;71;92
626;16.06.2017;2017;06;09;Perjantai;15;40;55
626;16.06.2017;2017;06;10;Perjantai;14;22;36
626;16.06.2017;2017;06;11;Perjantai;11;31;42
626;16.06.2017;2017;06;12;Perjantai;25;37;62
626;16.06.2017;2017;06;13;Perjantai;24;29;53
626;16.06.2017;2017;06;14;Perjantai;26;20;46
626;16.06.2017;2017;06;15;Perjantai;50;37;87
626;16.06.2017;2017;06;16;Perjantai;73;50;123
626;16.06.2017;2017;06;17;Perjantai;71;53;124
626;16.06.2017;2017;06;18;Perjantai;35;29;64
626;16.06.2017;2017;06;19;Perjantai;33;29;62
626;16.06.2017;2017;06;20;Perjantai;36;24;60
626;16.06.2017;2017;06;21;Perjantai;31;19;50
626;16.06.2017;2017;06;22;Perjantai;29;16;45
626;16.06.2017;2017;06;23;Perjantai;14;11;25
626;17.06.2017;2017;06;00;Lauantai;12;4;16
626;17.06.2017;2017;06;01;Lauantai;9;3;12
626;17.06.2017;2017;06;02;Lauantai;12;0;12
626;17.06.2017;2017;06;03;Lauantai;5;1;6
626;17.06.2017;2017;06;04;Lauantai;3;1;4
626;17.06.2017;2017;06;05;Lauantai;5;2;7
626;17.06.2017;2017;06;06;Lauantai;3;4;7
626;17.06.2017;2017;06;07;Lauantai;2;3;5
626;17.06.2017;2017;06;08;Lauantai;2;4;6
626;17.06.2017;2017;06;09;Lauantai;10;14;24
626;17.06.2017;2017;06;10;Lauantai;9;24;33
626;17.06.2017;2017;06;11;Lauantai;23;40;63
626;17.06.2017;2017;06;12;Lauantai;43;38;81
626;17.06.2017;2017;06;13;Lauantai;37;39;76
626;17.06.2017;2017;06;14;Lauantai;28;52;80
626;17.06.2017;2017;06;15;Lauantai;52;36;88
626;17.06.2017;2017;06;16;Lauantai;41;48;89
626;17.06.2017;2017;06;17;Lauantai;26;33;59
626;17.06.2017;2017;06;18;Lauantai;40;31;71
626;17.06.2017;2017;06;19;Lauantai;25;38;63
626;17.06.2017;2017;06;20;Lauantai;17;17;34
626;17.06.2017;2017;06;21;Lauantai;17;11;28
626;17.06.2017;2017;06;22;Lauantai;13;11;24
626;17.06.2017;2017;06;23;Lauantai;7;8;15
626;18.06.2017;2017;06;00;Sunnuntai;7;3;10
626;18.06.2017;2017;06;01;Sunnuntai;2;1;3
626;18.06.2017;2017;06;02;Sunnuntai;3;2;5
626;18.06.2017;2017;06;03;Sunnuntai;7;0;7
626;18.06.2017;2017;06;04;Sunnuntai;2;1;3
626;18.06.2017;2017;06;05;Sunnuntai;4;3;7
626;18.06.2017;2017;06;06;Sunnuntai;0;1;1
626;18.06.2017;2017;06;07;Sunnuntai;1;2;3
626;18.06.2017;2017;06;08;Sunnuntai;1;0;1
626;18.06.2017;2017;06;09;Sunnuntai;1;3;4
626;18.06.2017;2017;06;10;Sunnuntai;7;3;10
626;18.06.2017;2017;06;11;Sunnuntai;6;9;15
626;18.06.2017;2017;06;12;Sunnuntai;11;7;18
626;18.06.2017;2017;06;13;Sunnuntai;11;7;18
626;18.06.2017;2017;06;14;Sunnuntai;13;18;31
626;18.06.2017;2017;06;15;Sunnuntai;10;16;26
626;18.06.2017;2017;06;16;Sunnuntai;17;15;32
626;18.06.2017;2017;06;17;Sunnuntai;11;19;30
626;18.06.2017;2017;06;18;Sunnuntai;18;19;37
626;18.06.2017;2017;06;19;Sunnuntai;11;22;33
626;18.06.2017;2017;06;20;Sunnuntai;6;7;13
626;18.06.2017;2017;06;21;Sunnuntai;8;15;23
626;18.06.2017;2017;06;22;Sunnuntai;5;2;7
626;18.06.2017;2017;06;23;Sunnuntai;5;2;7
626;19.06.2017;2017;06;00;Maanantai;2;3;5
626;19.06.2017;2017;06;01;Maanantai;1;0;1
626;19.06.2017;2017;06;02;Maanantai;1;0;1
626;19.06.2017;2017;06;03;Maanantai;0;1;1
626;19.06.2017;2017;06;04;Maanantai;0;0;0
626;19.06.2017;2017;06;05;Maanantai;0;3;3
626;19.06.2017;2017;06;06;Maanantai;6;10;16
626;19.06.2017;2017;06;07;Maanantai;12;35;47
626;19.06.2017;2017;06;08;Maanantai;20;81;101
626;19.06.2017;2017;06;09;Maanantai;14;34;48
626;19.06.2017;2017;06;10;Maanantai;13;17;30
626;19.06.2017;2017;06;11;Maanantai;6;16;22
626;19.06.2017;2017;06;12;Maanantai;11;21;32
626;19.06.2017;2017;06;13;Maanantai;20;22;42
626;19.06.2017;2017;06;14;Maanantai;21;26;47
626;19.06.2017;2017;06;15;Maanantai;38;32;70
626;19.06.2017;2017;06;16;Maanantai;60;26;86
626;19.06.2017;2017;06;17;Maanantai;90;54;144
626;19.06.2017;2017;06;18;Maanantai;46;38;84
626;19.06.2017;2017;06;19;Maanantai;33;18;51
626;19.06.2017;2017;06;20;Maanantai;28;11;39
626;19.06.2017;2017;06;21;Maanantai;20;9;29
626;19.06.2017;2017;06;22;Maanantai;13;15;28
626;19.06.2017;2017;06;23;Maanantai;6;5;11
626;20.06.2017;2017;06;00;Tiistai;1;1;2
626;20.06.2017;2017;06;01;Tiistai;0;0;0
626;20.06.2017;2017;06;02;Tiistai;0;0;0
626;20.06.2017;2017;06;03;Tiistai;0;0;0
626;20.06.2017;2017;06;04;Tiistai;0;0;0
626;20.06.2017;2017;06;05;Tiistai;0;0;0
626;20.06.2017;2017;06;06;Tiistai;0;0;0
626;20.06.2017;2017;06;07;Tiistai;0;0;0
626;20.06.2017;2017;06;08;Tiistai;0;0;0
626;20.06.2017;2017;06;09;Tiistai;0;0;0
626;20.06.2017;2017;06;10;Tiistai;0;3;3
626;20.06.2017;2017;06;11;Tiistai;19;36;55
626;20.06.2017;2017;06;12;Tiistai;23;27;50
626;20.06.2017;2017;06;13;Tiistai;21;34;55
626;20.06.2017;2017;06;14;Tiistai;23;28;51
626;20.06.2017;2017;06;15;Tiistai;45;34;79
626;20.06.2017;2017;06;16;Tiistai;64;36;100
626;20.06.2017;2017;06;17;Tiistai;90;50;140
626;20.06.2017;2017;06;18;Tiistai;45;34;79
626;20.06.2017;2017;06;19;Tiistai;36;34;70
626;20.06.2017;2017;06;20;Tiistai;45;22;67
626;20.06.2017;2017;06;21;Tiistai;32;26;58
626;20.06.2017;2017;06;22;Tiistai;25;20;45
626;20.06.2017;2017;06;23;Tiistai;10;6;16
626;21.06.2017;2017;06;00;Keskiviikko;5;6;11
626;21.06.2017;2017;06;01;Keskiviikko;3;1;4
626;21.06.2017;2017;06;02;Keskiviikko;2;0;2
626;21.06.2017;2017;06;03;Keskiviikko;2;3;5
626;21.06.2017;2017;06;04;Keskiviikko;2;2;4
626;21.06.2017;2017;06;05;Keskiviikko;0;3;3
626;21.06.2017;2017;06;06;Keskiviikko;4;9;13
626;21.06.2017;2017;06;07;Keskiviikko;13;37;50
626;21.06.2017;2017;06;08;Keskiviikko;18;54;72
626;21.06.2017;2017;06;09;Keskiviikko;26;41;67
626;21.06.2017;2017;06;10;Keskiviikko;12;20;32
626;21.06.2017;2017;06;11;Keskiviikko;17;24;41
626;21.06.2017;2017;06;12;Keskiviikko;23;29;52
626;21.06.2017;2017;06;13;Keskiviikko;17;20;37
626;21.06.2017;2017;06;14;Keskiviikko;20;18;38
626;21.06.2017;2017;06;15;Keskiviikko;29;17;46
626;21.06.2017;2017;06;16;Keskiviikko;46;29;75
626;21.06.2017;2017;06;17;Keskiviikko;65;29;94
626;21.06.2017;2017;06;18;Keskiviikko;36;20;56
626;21.06.2017;2017;06;19;Keskiviikko;30;21;51
626;21.06.2017;2017;06;20;Keskiviikko;18;22;40
626;21.06.2017;2017;06;21;Keskiviikko;14;7;21
626;21.06.2017;2017;06;22;Keskiviikko;8;11;19
626;21.06.2017;2017;06;23;Keskiviikko;7;6;13
626;22.06.2017;2017;06;00;Torstai;0;3;3
626;22.06.2017;2017;06;01;Torstai;3;1;4
626;22.06.2017;2017;06;02;Torstai;6;1;7
626;22.06.2017;2017;06;03;Torstai;0;0;0
626;22.06.2017;2017;06;04;Torstai;0;0;0
626;22.06.2017;2017;06;05;Torstai;0;5;5
626;22.06.2017;2017;06;06;Torstai;3;7;10
626;22.06.2017;2017;06;07;Torstai;8;25;33
626;22.06.2017;2017;06;08;Torstai;15;40;55
626;22.06.2017;2017;06;09;Torstai;12;13;25
626;22.06.2017;2017;06;10;Torstai;11;19;30
626;22.06.2017;2017;06;11;Torstai;12;10;22
626;22.06.2017;2017;06;12;Torstai;12;18;30
626;22.06.2017;2017;06;13;Torstai;16;17;33
626;22.06.2017;2017;06;14;Torstai;29;15;44
626;22.06.2017;2017;06;15;Torstai;21;15;36
626;22.06.2017;2017;06;16;Torstai;38;21;59
626;22.06.2017;2017;06;17;Torstai;35;21;56
626;22.06.2017;2017;06;18;Torstai;17;7;24
626;22.06.2017;2017;06;19;Torstai;13;11;24
626;22.06.2017;2017;06;20;Torstai;16;17;33
626;22.06.2017;2017;06;21;Torstai;10;7;17
626;22.06.2017;2017;06;22;Torstai;7;3;10
626;22.06.2017;2017;06;23;Torstai;4;5;9
626;23.06.2017;2017;06;00;Perjantai;1;2;3
626;23.06.2017;2017;06;01;Perjantai;2;0;2
626;23.06.2017;2017;06;02;Perjantai;2;1;3
626;23.06.2017;2017;06;03;Perjantai;2;1;3
626;23.06.2017;2017;06;04;Perjantai;1;0;1
626;23.06.2017;2017;06;05;Perjantai;1;0;1
626;23.06.2017;2017;06;06;Perjantai;1;1;2
626;23.06.2017;2017;06;07;Perjantai;0;0;0
626;23.06.2017;2017;06;08;Perjantai;3;0;3
626;23.06.2017;2017;06;09;Perjantai;8;6;14
626;23.06.2017;2017;06;10;Perjantai;8;4;12
626;23.06.2017;2017;06;11;Perjantai;8;7;15
626;23.06.2017;2017;06;12;Perjantai;5;9;14
626;23.06.2017;2017;06;13;Perjantai;11;10;21
626;23.06.2017;2017;06;14;Perjantai;17;17;34
626;23.06.2017;2017;06;15;Perjantai;17;15;32
626;23.06.2017;2017;06;16;Perjantai;16;14;30
626;23.06.2017;2017;06;17;Perjantai;17;18;35
626;23.06.2017;2017;06;18;Perjantai;7;14;21
626;23.06.2017;2017;06;19;Perjantai;16;14;30
626;23.06.2017;2017;06;20;Perjantai;5;12;17
626;23.06.2017;2017;06;21;Perjantai;12;13;25
626;23.06.2017;2017;06;22;Perjantai;8;3;11
626;23.06.2017;2017;06;23;Perjantai;3;5;8
626;24.06.2017;2017;06;00;Lauantai;9;1;10
626;24.06.2017;2017;06;01;Lauantai;2;5;7
626;24.06.2017;2017;06;02;Lauantai;6;4;10
626;24.06.2017;2017;06;03;Lauantai;5;2;7
626;24.06.2017;2017;06;04;Lauantai;11;0;11
626;24.06.2017;2017;06;05;Lauantai;1;1;2
626;24.06.2017;2017;06;06;Lauantai;1;3;4
626;24.06.2017;2017;06;07;Lauantai;3;1;4
626;24.06.2017;2017;06;08;Lauantai;1;3;4
626;24.06.2017;2017;06;09;Lauantai;5;4;9
626;24.06.2017;2017;06;10;Lauantai;9;4;13
626;24.06.2017;2017;06;11;Lauantai;8;10;18
626;24.06.2017;2017;06;12;Lauantai;11;23;34
626;24.06.2017;2017;06;13;Lauantai;15;20;35
626;24.06.2017;2017;06;14;Lauantai;30;24;54
626;24.06.2017;2017;06;15;Lauantai;31;28;59
626;24.06.2017;2017;06;16;Lauantai;31;32;63
626;24.06.2017;2017;06;17;Lauantai;23;26;49
626;24.06.2017;2017;06;18;Lauantai;26;18;44
626;24.06.2017;2017;06;19;Lauantai;21;20;41
626;24.06.2017;2017;06;20;Lauantai;8;18;26
626;24.06.2017;2017;06;21;Lauantai;12;18;30
626;24.06.2017;2017;06;22;Lauantai;11;14;25
626;24.06.2017;2017;06;23;Lauantai;9;13;22
626;25.06.2017;2017;06;00;Sunnuntai;6;9;15
626;25.06.2017;2017;06;01;Sunnuntai;2;0;2
626;25.06.2017;2017;06;02;Sunnuntai;2;2;4
626;25.06.2017;2017;06;03;Sunnuntai;4;0;4
626;25.06.2017;2017;06;04;Sunnuntai;2;0;2
626;25.06.2017;2017;06;05;Sunnuntai;2;0;2
626;25.06.2017;2017;06;06;Sunnuntai;0;3;3
626;25.06.2017;2017;06;07;Sunnuntai;2;2;4
626;25.06.2017;2017;06;08;Sunnuntai;4;4;8
626;25.06.2017;2017;06;09;Sunnuntai;4;10;14
626;25.06.2017;2017;06;10;Sunnuntai;11;14;25
626;25.06.2017;2017;06;11;Sunnuntai;14;14;28
626;25.06.2017;2017;06;12;Sunnuntai;4;10;14
626;25.06.2017;2017;06;13;Sunnuntai;4;7;11
626;25.06.2017;2017;06;14;Sunnuntai;8;6;14
626;25.06.2017;2017;06;15;Sunnuntai;9;5;14
626;25.06.2017;2017;06;16;Sunnuntai;7;9;16
626;25.06.2017;2017;06;17;Sunnuntai;4;10;14
626;25.06.2017;2017;06;18;Sunnuntai;5;6;11
626;25.06.2017;2017;06;19;Sunnuntai;6;8;14
626;25.06.2017;2017;06;20;Sunnuntai;7;7;14
626;25.06.2017;2017;06;21;Sunnuntai;11;7;18
626;25.06.2017;2017;06;22;Sunnuntai;0;3;3
626;25.06.2017;2017;06;23;Sunnuntai;3;4;7
626;26.06.2017;2017;06;00;Maanantai;1;3;4
626;26.06.2017;2017;06;01;Maanantai;0;1;1
626;26.06.2017;2017;06;02;Maanantai;0;1;1
626;26.06.2017;2017;06;03;Maanantai;1;1;2
626;26.06.2017;2017;06;04;Maanantai;0;0;0
626;26.06.2017;2017;06;05;Maanantai;1;2;3
626;26.06.2017;2017;06;06;Maanantai;5;7;12
626;26.06.2017;2017;06;07;Maanantai;9;19;28
626;26.06.2017;2017;06;08;Maanantai;18;33;51
626;26.06.2017;2017;06;09;Maanantai;11;27;38
626;26.06.2017;2017;06;10;Maanantai;5;12;17
626;26.06.2017;2017;06;11;Maanantai;5;8;13
626;26.06.2017;2017;06;12;Maanantai;6;4;10
626;26.06.2017;2017;06;13;Maanantai;10;4;14
626;26.06.2017;2017;06;14;Maanantai;11;14;25
626;26.06.2017;2017;06;15;Maanantai;13;18;31
626;26.06.2017;2017;06;16;Maanantai;32;33;65
626;26.06.2017;2017;06;17;Maanantai;39;32;71
626;26.06.2017;2017;06;18;Maanantai;41;35;76
626;26.06.2017;2017;06;19;Maanantai;39;40;79
626;26.06.2017;2017;06;20;Maanantai;37;23;60
626;26.06.2017;2017;06;21;Maanantai;20;17;37
626;26.06.2017;2017;06;22;Maanantai;15;16;31
626;26.06.2017;2017;06;23;Maanantai;7;8;15
626;27.06.2017;2017;06;00;Tiistai;4;3;7
626;27.06.2017;2017;06;01;Tiistai;2;0;2
626;27.06.2017;2017;06;02;Tiistai;1;1;2
626;27.06.2017;2017;06;03;Tiistai;2;0;2
626;27.06.2017;2017;06;04;Tiistai;1;1;2
626;27.06.2017;2017;06;05;Tiistai;0;5;5
626;27.06.2017;2017;06;06;Tiistai;10;16;26
626;27.06.2017;2017;06;07;Tiistai;12;49;61
626;27.06.2017;2017;06;08;Tiistai;27;67;94
626;27.06.2017;2017;06;09;Tiistai;23;52;75
626;27.06.2017;2017;06;10;Tiistai;14;33;47
626;27.06.2017;2017;06;11;Tiistai;17;24;41
626;27.06.2017;2017;06;12;Tiistai;21;29;50
626;27.06.2017;2017;06;13;Tiistai;28;23;51
626;27.06.2017;2017;06;14;Tiistai;29;25;54
626;27.06.2017;2017;06;15;Tiistai;42;39;81
626;27.06.2017;2017;06;16;Tiistai;55;39;94
626;27.06.2017;2017;06;17;Tiistai;66;49;115
626;27.06.2017;2017;06;18;Tiistai;64;34;98
626;27.06.2017;2017;06;19;Tiistai;41;24;65
626;27.06.2017;2017;06;20;Tiistai;22;20;42
626;27.06.2017;2017;06;21;Tiistai;15;9;24
626;27.06.2017;2017;06;22;Tiistai;22;14;36
626;27.06.2017;2017;06;23;Tiistai;10;4;14
626;28.06.2017;2017;06;00;Keskiviikko;2;3;5
626;28.06.2017;2017;06;01;Keskiviikko;1;2;3
626;28.06.2017;2017;06;02;Keskiviikko;1;0;1
626;28.06.2017;2017;06;03;Keskiviikko;1;1;2
626;28.06.2017;2017;06;04;Keskiviikko;1;0;1
626;28.06.2017;2017;06;05;Keskiviikko;0;3;3
626;28.06.2017;2017;06;06;Keskiviikko;4;9;13
626;28.06.2017;2017;06;07;Keskiviikko;13;47;60
626;28.06.2017;2017;06;08;Keskiviikko;27;62;89
626;28.06.2017;2017;06;09;Keskiviikko;19;35;54
626;28.06.2017;2017;06;10;Keskiviikko;9;24;33
626;28.06.2017;2017;06;11;Keskiviikko;10;7;17
626;28.06.2017;2017;06;12;Keskiviikko;15;9;24
626;28.06.2017;2017;06;13;Keskiviikko;11;8;19
626;28.06.2017;2017;06;14;Keskiviikko;14;13;27
626;28.06.2017;2017;06;15;Keskiviikko;21;9;30
626;28.06.2017;2017;06;16;Keskiviikko;45;22;67
626;28.06.2017;2017;06;17;Keskiviikko;54;44;98
626;28.06.2017;2017;06;18;Keskiviikko;37;26;63
626;28.06.2017;2017;06;19;Keskiviikko;28;18;46
626;28.06.2017;2017;06;20;Keskiviikko;22;22;44
626;28.06.2017;2017;06;21;Keskiviikko;22;17;39
626;28.06.2017;2017;06;22;Keskiviikko;10;13;23
626;28.06.2017;2017;06;23;Keskiviikko;4;6;10
626;29.06.2017;2017;06;00;Torstai;9;5;14
626;29.06.2017;2017;06;01;Torstai;2;1;3
626;29.06.2017;2017;06;02;Torstai;3;1;4
626;29.06.2017;2017;06;03;Torstai;0;0;0
626;29.06.2017;2017;06;04;Torstai;1;1;2
626;29.06.2017;2017;06;05;Torstai;2;6;8
626;29.06.2017;2017;06;06;Torstai;7;11;18
626;29.06.2017;2017;06;07;Torstai;18;48;66
626;29.06.2017;2017;06;08;Torstai;24;71;95
626;29.06.2017;2017;06;09;Torstai;28;40;68
626;29.06.2017;2017;06;10;Torstai;12;32;44
626;29.06.2017;2017;06;11;Torstai;17;35;52
626;29.06.2017;2017;06;12;Torstai;35;42;77
626;29.06.2017;2017;06;13;Torstai;37;42;79
626;29.06.2017;2017;06;14;Torstai;33;29;62
626;29.06.2017;2017;06;15;Torstai;45;32;77
626;29.06.2017;2017;06;16;Torstai;20;10;30
626;29.06.2017;2017;06;17;Torstai;137;87;224
626;29.06.2017;2017;06;18;Torstai;60;46;106
626;29.06.2017;2017;06;19;Torstai;47;39;86
626;29.06.2017;2017;06;20;Torstai;42;24;66
626;29.06.2017;2017;06;21;Torstai;24;23;47
626;29.06.2017;2017;06;22;Torstai;21;22;43
626;29.06.2017;2017;06;23;Torstai;12;3;15
626;30.06.2017;2017;06;00;Perjantai;8;3;11
626;30.06.2017;2017;06;01;Perjantai;3;2;5
626;30.06.2017;2017;06;02;Perjantai;3;2;5
626;30.06.2017;2017;06;03;Perjantai;0;1;1
626;30.06.2017;2017;06;04;Perjantai;1;1;2
626;30.06.2017;2017;06;05;Perjantai;0;6;6
626;30.06.2017;2017;06;06;Perjantai;10;14;24
626;30.06.2017;2017;06;07;Perjantai;17;46;63
626;30.06.2017;2017;06;08;Perjantai;30;67;97
626;30.06.2017;2017;06;09;Perjantai;24;34;58
626;30.06.2017;2017;06;10;Perjantai;14;29;43
626;30.06.2017;2017;06;11;Perjantai;22;30;52
626;30.06.2017;2017;06;12;Perjantai;36;35;71
626;30.06.2017;2017;06;13;Perjantai;48;41;89
626;30.06.2017;2017;06;14;Perjantai;46;48;94
626;30.06.2017;2017;06;15;Perjantai;60;38;98
626;30.06.2017;2017;06;16;Perjantai;71;59;130
626;30.06.2017;2017;06;17;Perjantai;82;70;152
626;30.06.2017;2017;06;18;Perjantai;47;40;87
626;30.06.2017;2017;06;19;Perjantai;55;48;103
626;30.06.2017;2017;06;20;Perjantai;42;39;81
626;30.06.2017;2017;06;21;Perjantai;23;20;43
626;30.06.2017;2017;06;22;Perjantai;14;19;33
626;30.06.2017;2017;06;23;Perjantai;15;16;31
626;01.07.2017;2017;07;00;Lauantai;10;5;15
626;01.07.2017;2017;07;01;Lauantai;7;2;9
626;01.07.2017;2017;07;02;Lauantai;8;0;8
626;01.07.2017;2017;07;03;Lauantai;7;0;7
626;01.07.2017;2017;07;04;Lauantai;8;1;9
626;01.07.2017;2017;07;05;Lauantai;8;0;8
626;01.07.2017;2017;07;06;Lauantai;5;1;6
626;01.07.2017;2017;07;07;Lauantai;2;3;5
626;01.07.2017;2017;07;08;Lauantai;5;8;13
626;01.07.2017;2017;07;09;Lauantai;5;18;23
626;01.07.2017;2017;07;10;Lauantai;35;34;69
626;01.07.2017;2017;07;11;Lauantai;36;45;81
626;01.07.2017;2017;07;12;Lauantai;44;38;82
626;01.07.2017;2017;07;13;Lauantai;62;72;134
626;01.07.2017;2017;07;14;Lauantai;66;73;139
626;01.07.2017;2017;07;15;Lauantai;49;64;113
626;01.07.2017;2017;07;16;Lauantai;53;59;112
626;01.07.2017;2017;07;17;Lauantai;53;52;105
626;01.07.2017;2017;07;18;Lauantai;49;49;98
626;01.07.2017;2017;07;19;Lauantai;45;33;78
626;01.07.2017;2017;07;20;Lauantai;30;39;69
626;01.07.2017;2017;07;21;Lauantai;37;34;71
626;01.07.2017;2017;07;22;Lauantai;12;17;29
626;01.07.2017;2017;07;23;Lauantai;12;14;26
626;02.07.2017;2017;07;00;Sunnuntai;10;10;20
626;02.07.2017;2017;07;01;Sunnuntai;12;3;15
626;02.07.2017;2017;07;02;Sunnuntai;16;7;23
626;02.07.2017;2017;07;03;Sunnuntai;5;3;8
626;02.07.2017;2017;07;04;Sunnuntai;9;1;10
626;02.07.2017;2017;07;05;Sunnuntai;6;0;6
626;02.07.2017;2017;07;06;Sunnuntai;3;3;6
626;02.07.2017;2017;07;07;Sunnuntai;2;4;6
626;02.07.2017;2017;07;08;Sunnuntai;4;5;9
626;02.07.2017;2017;07;09;Sunnuntai;8;12;20
626;02.07.2017;2017;07;10;Sunnuntai;15;32;47
626;02.07.2017;2017;07;11;Sunnuntai;19;28;47
626;02.07.2017;2017;07;12;Sunnuntai;40;43;83
626;02.07.2017;2017;07;13;Sunnuntai;38;61;99
626;02.07.2017;2017;07;14;Sunnuntai;39;51;90
626;02.07.2017;2017;07;15;Sunnuntai;37;57;94
626;02.07.2017;2017;07;16;Sunnuntai;49;65;114
626;02.07.2017;2017;07;17;Sunnuntai;45;47;92
626;02.07.2017;2017;07;18;Sunnuntai;37;55;92
626;02.07.2017;2017;07;19;Sunnuntai;32;35;67
626;02.07.2017;2017;07;20;Sunnuntai;40;27;67
626;02.07.2017;2017;07;21;Sunnuntai;28;21;49
626;02.07.2017;2017;07;22;Sunnuntai;19;19;38
626;02.07.2017;2017;07;23;Sunnuntai;9;7;16
626;03.07.2017;2017;07;00;Maanantai;3;3;6
626;03.07.2017;2017;07;01;Maanantai;2;5;7
626;03.07.2017;2017;07;02;Maanantai;1;1;2
626;03.07.2017;2017;07;03;Maanantai;0;1;1
626;03.07.2017;2017;07;04;Maanantai;1;2;3
626;03.07.2017;2017;07;05;Maanantai;5;5;10
626;03.07.2017;2017;07;06;Maanantai;5;12;17
626;03.07.2017;2017;07;07;Maanantai;13;39;52
626;03.07.2017;2017;07;08;Maanantai;25;93;118
626;03.07.2017;2017;07;09;Maanantai;30;46;76
626;03.07.2017;2017;07;10;Maanantai;17;39;56
626;03.07.2017;2017;07;11;Maanantai;23;44;67
626;03.07.2017;2017;07;12;Maanantai;38;45;83
626;03.07.2017;2017;07;13;Maanantai;34;49;83
626;03.07.2017;2017;07;14;Maanantai;49;46;95
626;03.07.2017;2017;07;15;Maanantai;61;43;104
626;03.07.2017;2017;07;16;Maanantai;70;44;114
626;03.07.2017;2017;07;17;Maanantai;84;68;152
626;03.07.2017;2017;07;18;Maanantai;71;58;129
626;03.07.2017;2017;07;19;Maanantai;52;44;96
626;03.07.2017;2017;07;20;Maanantai;34;30;64
626;03.07.2017;2017;07;21;Maanantai;33;16;49
626;03.07.2017;2017;07;22;Maanantai;16;17;33
626;03.07.2017;2017;07;23;Maanantai;15;8;23
626;04.07.2017;2017;07;00;Tiistai;2;6;8
626;04.07.2017;2017;07;01;Tiistai;1;4;5
626;04.07.2017;2017;07;02;Tiistai;3;0;3
626;04.07.2017;2017;07;03;Tiistai;0;2;2
626;04.07.2017;2017;07;04;Tiistai;1;1;2
626;04.07.2017;2017;07;05;Tiistai;0;4;4
626;04.07.2017;2017;07;06;Tiistai;7;6;13
626;04.07.2017;2017;07;07;Tiistai;9;36;45
626;04.07.2017;2017;07;08;Tiistai;19;45;64
626;04.07.2017;2017;07;09;Tiistai;20;45;65
626;04.07.2017;2017;07;10;Tiistai;16;27;43
626;04.07.2017;2017;07;11;Tiistai;25;31;56
626;04.07.2017;2017;07;12;Tiistai;23;22;45
626;04.07.2017;2017;07;13;Tiistai;17;20;37
626;04.07.2017;2017;07;14;Tiistai;18;14;32
626;04.07.2017;2017;07;15;Tiistai;24;25;49
626;04.07.2017;2017;07;16;Tiistai;39;27;66
626;04.07.2017;2017;07;17;Tiistai;52;41;93
626;04.07.2017;2017;07;18;Tiistai;44;23;67
626;04.07.2017;2017;07;19;Tiistai;28;32;60
626;04.07.2017;2017;07;20;Tiistai;29;20;49
626;04.07.2017;2017;07;21;Tiistai;20;19;39
626;04.07.2017;2017;07;22;Tiistai;17;18;35
626;04.07.2017;2017;07;23;Tiistai;4;6;10
626;05.07.2017;2017;07;00;Keskiviikko;4;3;7
626;05.07.2017;2017;07;01;Keskiviikko;0;2;2
626;05.07.2017;2017;07;02;Keskiviikko;3;5;8
626;05.07.2017;2017;07;03;Keskiviikko;2;2;4
626;05.07.2017;2017;07;04;Keskiviikko;1;1;2
626;05.07.2017;2017;07;05;Keskiviikko;1;1;2
626;05.07.2017;2017;07;06;Keskiviikko;7;6;13
626;05.07.2017;2017;07;07;Keskiviikko;10;33;43
626;05.07.2017;2017;07;08;Keskiviikko;15;44;59
626;05.07.2017;2017;07;09;Keskiviikko;22;36;58
626;05.07.2017;2017;07;10;Keskiviikko;10;25;35
626;05.07.2017;2017;07;11;Keskiviikko;10;11;21
626;05.07.2017;2017;07;12;Keskiviikko;15;16;31
626;05.07.2017;2017;07;13;Keskiviikko;21;31;52
626;05.07.2017;2017;07;14;Keskiviikko;15;25;40
626;05.07.2017;2017;07;15;Keskiviikko;27;16;43
626;05.07.2017;2017;07;16;Keskiviikko;49;20;69
626;05.07.2017;2017;07;17;Keskiviikko;48;33;81
626;05.07.2017;2017;07;18;Keskiviikko;36;25;61
626;05.07.2017;2017;07;19;Keskiviikko;21;25;46
626;05.07.2017;2017;07;20;Keskiviikko;25;14;39
626;05.07.2017;2017;07;21;Keskiviikko;15;8;23
626;05.07.2017;2017;07;22;Keskiviikko;11;7;18
626;05.07.2017;2017;07;23;Keskiviikko;6;7;13
626;06.07.2017;2017;07;00;Torstai;3;4;7
626;06.07.2017;2017;07;01;Torstai;1;2;3
626;06.07.2017;2017;07;02;Torstai;1;1;2
626;06.07.2017;2017;07;03;Torstai;2;1;3
626;06.07.2017;2017;07;04;Torstai;2;0;2
626;06.07.2017;2017;07;05;Torstai;1;4;5
626;06.07.2017;2017;07;06;Torstai;6;6;12
626;06.07.2017;2017;07;07;Torstai;10;24;34
626;06.07.2017;2017;07;08;Torstai;10;26;36
626;06.07.2017;2017;07;09;Torstai;18;25;43
626;06.07.2017;2017;07;10;Torstai;6;10;16
626;06.07.2017;2017;07;11;Torstai;6;5;11
626;06.07.2017;2017;07;12;Torstai;4;1;5
626;06.07.2017;2017;07;13;Torstai;11;7;18
626;06.07.2017;2017;07;14;Torstai;13;9;22
626;06.07.2017;2017;07;15;Torstai;21;22;43
626;06.07.2017;2017;07;16;Torstai;24;12;36
626;06.07.2017;2017;07;17;Torstai;39;24;63
626;06.07.2017;2017;07;18;Torstai;22;23;45
626;06.07.2017;2017;07;19;Torstai;30;22;52
626;06.07.2017;2017;07;20;Torstai;14;11;25
626;06.07.2017;2017;07;21;Torstai;16;19;35
626;06.07.2017;2017;07;22;Torstai;13;9;22
626;06.07.2017;2017;07;23;Torstai;8;13;21
626;07.07.2017;2017;07;00;Perjantai;4;4;8
626;07.07.2017;2017;07;01;Perjantai;2;2;4
626;07.07.2017;2017;07;02;Perjantai;2;1;3
626;07.07.2017;2017;07;03;Perjantai;0;0;0
626;07.07.2017;2017;07;04;Perjantai;2;0;2
626;07.07.2017;2017;07;05;Perjantai;1;5;6
626;07.07.2017;2017;07;06;Perjantai;5;7;12
626;07.07.2017;2017;07;07;Perjantai;10;31;41
626;07.07.2017;2017;07;08;Perjantai;18;46;64
626;07.07.2017;2017;07;09;Perjantai;14;31;45
626;07.07.2017;2017;07;10;Perjantai;12;16;28
626;07.07.2017;2017;07;11;Perjantai;20;30;50
626;07.07.2017;2017;07;12;Perjantai;26;31;57
626;07.07.2017;2017;07;13;Perjantai;36;41;77
626;07.07.2017;2017;07;14;Perjantai;39;39;78
626;07.07.2017;2017;07;15;Perjantai;53;50;103
626;07.07.2017;2017;07;16;Perjantai;65;41;106
626;07.07.2017;2017;07;17;Perjantai;62;38;100
626;07.07.2017;2017;07;18;Perjantai;50;44;94
626;07.07.2017;2017;07;19;Perjantai;32;32;64
626;07.07.2017;2017;07;20;Perjantai;27;28;55
626;07.07.2017;2017;07;21;Perjantai;25;38;63
626;07.07.2017;2017;07;22;Perjantai;19;19;38
626;07.07.2017;2017;07;23;Perjantai;13;8;21
626;08.07.2017;2017;07;00;Lauantai;15;6;21
626;08.07.2017;2017;07;01;Lauantai;8;3;11
626;08.07.2017;2017;07;02;Lauantai;7;1;8
626;08.07.2017;2017;07;03;Lauantai;4;2;6
626;08.07.2017;2017;07;04;Lauantai;5;0;5
626;08.07.2017;2017;07;05;Lauantai;3;0;3
626;08.07.2017;2017;07;06;Lauantai;2;4;6
626;08.07.2017;2017;07;07;Lauantai;3;5;8
626;08.07.2017;2017;07;08;Lauantai;4;6;10
626;08.07.2017;2017;07;09;Lauantai;8;10;18
626;08.07.2017;2017;07;10;Lauantai;22;22;44
626;08.07.2017;2017;07;11;Lauantai;23;41;64
626;08.07.2017;2017;07;12;Lauantai;33;52;85
626;08.07.2017;2017;07;13;Lauantai;50;76;126
626;08.07.2017;2017;07;14;Lauantai;57;56;113
626;08.07.2017;2017;07;15;Lauantai;58;60;118
626;08.07.2017;2017;07;16;Lauantai;49;46;95
626;08.07.2017;2017;07;17;Lauantai;61;66;127
626;08.07.2017;2017;07;18;Lauantai;54;46;100
626;08.07.2017;2017;07;19;Lauantai;28;40;68
626;08.07.2017;2017;07;20;Lauantai;40;34;74
626;08.07.2017;2017;07;21;Lauantai;28;32;60
626;08.07.2017;2017;07;22;Lauantai;23;13;36
626;08.07.2017;2017;07;23;Lauantai;16;12;28
626;09.07.2017;2017;07;00;Sunnuntai;17;10;27
626;09.07.2017;2017;07;01;Sunnuntai;10;5;15
626;09.07.2017;2017;07;02;Sunnuntai;8;0;8
626;09.07.2017;2017;07;03;Sunnuntai;8;3;11
626;09.07.2017;2017;07;04;Sunnuntai;15;4;19
626;09.07.2017;2017;07;05;Sunnuntai;9;1;10
626;09.07.2017;2017;07;06;Sunnuntai;0;0;0
626;09.07.2017;2017;07;07;Sunnuntai;3;5;8
626;09.07.2017;2017;07;08;Sunnuntai;3;7;10
626;09.07.2017;2017;07;09;Sunnuntai;4;10;14
626;09.07.2017;2017;07;10;Sunnuntai;16;23;39
626;09.07.2017;2017;07;11;Sunnuntai;23;36;59
626;09.07.2017;2017;07;12;Sunnuntai;29;41;70
626;09.07.2017;2017;07;13;Sunnuntai;48;59;107
626;09.07.2017;2017;07;14;Sunnuntai;46;55;101
626;09.07.2017;2017;07;15;Sunnuntai;49;60;109
626;09.07.2017;2017;07;16;Sunnuntai;61;44;105
626;09.07.2017;2017;07;17;Sunnuntai;61;58;119
626;09.07.2017;2017;07;18;Sunnuntai;36;35;71
626;09.07.2017;2017;07;19;Sunnuntai;28;36;64
626;09.07.2017;2017;07;20;Sunnuntai;31;25;56
626;09.07.2017;2017;07;21;Sunnuntai;26;20;46
626;09.07.2017;2017;07;22;Sunnuntai;12;12;24
626;09.07.2017;2017;07;23;Sunnuntai;8;10;18
626;10.07.2017;2017;07;00;Maanantai;4;3;7
626;10.07.2017;2017;07;01;Maanantai;4;4;8
626;10.07.2017;2017;07;02;Maanantai;0;0;0
626;10.07.2017;2017;07;03;Maanantai;1;1;2
626;10.07.2017;2017;07;04;Maanantai;0;0;0
626;10.07.2017;2017;07;05;Maanantai;0;6;6
626;10.07.2017;2017;07;06;Maanantai;4;9;13
626;10.07.2017;2017;07;07;Maanantai;10;37;47
626;10.07.2017;2017;07;08;Maanantai;28;70;98
626;10.07.2017;2017;07;09;Maanantai;25;54;79
626;10.07.2017;2017;07;10;Maanantai;19;41;60
626;10.07.2017;2017;07;11;Maanantai;32;43;75
626;10.07.2017;2017;07;12;Maanantai;35;46;81
626;10.07.2017;2017;07;13;Maanantai;47;54;101
626;10.07.2017;2017;07;14;Maanantai;61;49;110
626;10.07.2017;2017;07;15;Maanantai;63;63;126
626;10.07.2017;2017;07;16;Maanantai;83;70;153
626;10.07.2017;2017;07;17;Maanantai;81;54;135
626;10.07.2017;2017;07;18;Maanantai;72;53;125
626;10.07.2017;2017;07;19;Maanantai;58;25;83
626;10.07.2017;2017;07;20;Maanantai;42;26;68
626;10.07.2017;2017;07;21;Maanantai;23;24;47
626;10.07.2017;2017;07;22;Maanantai;17;16;33
626;10.07.2017;2017;07;23;Maanantai;8;4;12
626;11.07.2017;2017;07;00;Tiistai;0;3;3
626;11.07.2017;2017;07;01;Tiistai;5;1;6
626;11.07.2017;2017;07;02;Tiistai;3;4;7
626;11.07.2017;2017;07;03;Tiistai;2;0;2
626;11.07.2017;2017;07;04;Tiistai;1;1;2
626;11.07.2017;2017;07;05;Tiistai;0;3;3
626;11.07.2017;2017;07;06;Tiistai;7;13;20
626;11.07.2017;2017;07;07;Tiistai;13;51;64
626;11.07.2017;2017;07;08;Tiistai;29;77;106
626;11.07.2017;2017;07;09;Tiistai;13;49;62
626;11.07.2017;2017;07;10;Tiistai;20;45;65
626;11.07.2017;2017;07;11;Tiistai;31;27;58
626;11.07.2017;2017;07;12;Tiistai;35;56;91
626;11.07.2017;2017;07;13;Tiistai;42;48;90
626;11.07.2017;2017;07;14;Tiistai;66;66;132
626;11.07.2017;2017;07;15;Tiistai;48;53;101
626;11.07.2017;2017;07;16;Tiistai;93;62;155
626;11.07.2017;2017;07;17;Tiistai;85;53;138
626;11.07.2017;2017;07;18;Tiistai;74;47;121
626;11.07.2017;2017;07;19;Tiistai;45;42;87
626;11.07.2017;2017;07;20;Tiistai;44;33;77
626;11.07.2017;2017;07;21;Tiistai;39;21;60
626;11.07.2017;2017;07;22;Tiistai;12;16;28
626;11.07.2017;2017;07;23;Tiistai;6;5;11
626;12.07.2017;2017;07;00;Keskiviikko;0;1;1
626;12.07.2017;2017;07;01;Keskiviikko;6;1;7
626;12.07.2017;2017;07;02;Keskiviikko;1;0;1
626;12.07.2017;2017;07;03;Keskiviikko;2;1;3
626;12.07.2017;2017;07;04;Keskiviikko;0;2;2
626;12.07.2017;2017;07;05;Keskiviikko;0;1;1
626;12.07.2017;2017;07;06;Keskiviikko;4;5;9
626;12.07.2017;2017;07;07;Keskiviikko;11;15;26
626;12.07.2017;2017;07;08;Keskiviikko;15;23;38
626;12.07.2017;2017;07;09;Keskiviikko;12;17;29
626;12.07.2017;2017;07;10;Keskiviikko;3;9;12
626;12.07.2017;2017;07;11;Keskiviikko;5;5;10
626;12.07.2017;2017;07;12;Keskiviikko;6;7;13
626;12.07.2017;2017;07;13;Keskiviikko;9;13;22
626;12.07.2017;2017;07;14;Keskiviikko;11;19;30
626;12.07.2017;2017;07;15;Keskiviikko;12;13;25
626;12.07.2017;2017;07;16;Keskiviikko;17;9;26
626;12.07.2017;2017;07;17;Keskiviikko;17;18;35
626;12.07.2017;2017;07;18;Keskiviikko;20;18;38
626;12.07.2017;2017;07;19;Keskiviikko;13;3;16
626;12.07.2017;2017;07;20;Keskiviikko;6;4;10
626;12.07.2017;2017;07;21;Keskiviikko;9;7;16
626;12.07.2017;2017;07;22;Keskiviikko;6;10;16
626;12.07.2017;2017;07;23;Keskiviikko;3;1;4
626;13.07.2017;2017;07;00;Torstai;2;4;6
626;13.07.2017;2017;07;01;Torstai;1;0;1
626;13.07.2017;2017;07;02;Torstai;1;1;2
626;13.07.2017;2017;07;03;Torstai;1;0;1
626;13.07.2017;2017;07;04;Torstai;0;2;2
626;13.07.2017;2017;07;05;Torstai;1;1;2
626;13.07.2017;2017;07;06;Torstai;4;8;12
626;13.07.2017;2017;07;07;Torstai;10;23;33
626;13.07.2017;2017;07;08;Torstai;18;32;50
626;13.07.2017;2017;07;09;Torstai;18;31;49
626;13.07.2017;2017;07;10;Torstai;11;23;34
626;13.07.2017;2017;07;11;Torstai;15;15;30
626;13.07.2017;2017;07;12;Torstai;18;25;43
626;13.07.2017;2017;07;13;Torstai;14;20;34
626;13.07.2017;2017;07;14;Torstai;33;39;72
626;13.07.2017;2017;07;15;Torstai;40;49;89
626;13.07.2017;2017;07;16;Torstai;58;38;96
626;13.07.2017;2017;07;17;Torstai;56;29;85
626;13.07.2017;2017;07;18;Torstai;33;24;57
626;13.07.2017;2017;07;19;Torstai;29;18;47
626;13.07.2017;2017;07;20;Torstai;15;10;25
626;13.07.2017;2017;07;21;Torstai;14;21;35
626;13.07.2017;2017;07;22;Torstai;13;17;30
626;13.07.2017;2017;07;23;Torstai;6;2;8
626;14.07.2017;2017;07;00;Perjantai;3;2;5
626;14.07.2017;2017;07;01;Perjantai;8;1;9
626;14.07.2017;2017;07;02;Perjantai;2;1;3
626;14.07.2017;2017;07;03;Perjantai;2;1;3
626;14.07.2017;2017;07;04;Perjantai;1;1;2
626;14.07.2017;2017;07;05;Perjantai;3;1;4
626;14.07.2017;2017;07;06;Perjantai;7;7;14
626;14.07.2017;2017;07;07;Perjantai;4;10;14
626;14.07.2017;2017;07;08;Perjantai;7;20;27
626;14.07.2017;2017;07;09;Perjantai;13;10;23
626;14.07.2017;2017;07;10;Perjantai;1;4;5
626;14.07.2017;2017;07;11;Perjantai;6;1;7
626;14.07.2017;2017;07;12;Perjantai;2;2;4
626;14.07.2017;2017;07;13;Perjantai;4;4;8
626;14.07.2017;2017;07;14;Perjantai;0;0;0
626;14.07.2017;2017;07;15;Perjantai;3;3;6
626;14.07.2017;2017;07;16;Perjantai;25;27;52
626;14.07.2017;2017;07;17;Perjantai;20;23;43
626;14.07.2017;2017;07;18;Perjantai;12;19;31
626;14.07.2017;2017;07;19;Perjantai;12;12;24
626;14.07.2017;2017;07;20;Perjantai;11;15;26
626;14.07.2017;2017;07;21;Perjantai;11;7;18
626;14.07.2017;2017;07;22;Perjantai;10;11;21
626;14.07.2017;2017;07;23;Perjantai;3;6;9
626;15.07.2017;2017;07;00;Lauantai;5;5;10
626;15.07.2017;2017;07;01;Lauantai;6;1;7
626;15.07.2017;2017;07;02;Lauantai;6;5;11
626;15.07.2017;2017;07;03;Lauantai;4;1;5
626;15.07.2017;2017;07;04;Lauantai;3;2;5
626;15.07.2017;2017;07;05;Lauantai;0;1;1
626;15.07.2017;2017;07;06;Lauantai;1;2;3
626;15.07.2017;2017;07;07;Lauantai;4;3;7
626;15.07.2017;2017;07;08;Lauantai;7;7;14
626;15.07.2017;2017;07;09;Lauantai;7;15;22
626;15.07.2017;2017;07;10;Lauantai;11;24;35
626;15.07.2017;2017;07;11;Lauantai;33;31;64
626;15.07.2017;2017;07;12;Lauantai;29;38;67
626;15.07.2017;2017;07;13;Lauantai;27;31;58
626;15.07.2017;2017;07;14;Lauantai;39;43;82
626;15.07.2017;2017;07;15;Lauantai;31;31;62
626;15.07.2017;2017;07;16;Lauantai;32;27;59
626;15.07.2017;2017;07;17;Lauantai;33;35;68
626;15.07.2017;2017;07;18;Lauantai;20;33;53
626;15.07.2017;2017;07;19;Lauantai;20;15;35
626;15.07.2017;2017;07;20;Lauantai;18;27;45
626;15.07.2017;2017;07;21;Lauantai;18;11;29
626;15.07.2017;2017;07;22;Lauantai;9;21;30
626;15.07.2017;2017;07;23;Lauantai;7;9;16
626;16.07.2017;2017;07;00;Sunnuntai;6;1;7
626;16.07.2017;2017;07;01;Sunnuntai;7;3;10
626;16.07.2017;2017;07;02;Sunnuntai;6;1;7
626;16.07.2017;2017;07;03;Sunnuntai;6;0;6
626;16.07.2017;2017;07;04;Sunnuntai;10;2;12
626;16.07.2017;2017;07;05;Sunnuntai;3;0;3
626;16.07.2017;2017;07;06;Sunnuntai;2;1;3
626;16.07.2017;2017;07;07;Sunnuntai;3;1;4
626;16.07.2017;2017;07;08;Sunnuntai;1;7;8
626;16.07.2017;2017;07;09;Sunnuntai;4;12;16
626;16.07.2017;2017;07;10;Sunnuntai;17;17;34
626;16.07.2017;2017;07;11;Sunnuntai;24;34;58
626;16.07.2017;2017;07;12;Sunnuntai;31;42;73
626;16.07.2017;2017;07;13;Sunnuntai;50;61;111
626;16.07.2017;2017;07;14;Sunnuntai;40;67;107
626;16.07.2017;2017;07;15;Sunnuntai;43;49;92
626;16.07.2017;2017;07;16;Sunnuntai;56;43;99
626;16.07.2017;2017;07;17;Sunnuntai;48;41;89
626;16.07.2017;2017;07;18;Sunnuntai;31;40;71
626;16.07.2017;2017;07;19;Sunnuntai;20;32;52
626;16.07.2017;2017;07;20;Sunnuntai;28;23;51
626;16.07.2017;2017;07;21;Sunnuntai;24;21;45
626;16.07.2017;2017;07;22;Sunnuntai;21;10;31
626;16.07.2017;2017;07;23;Sunnuntai;7;12;19
626;17.07.2017;2017;07;00;Maanantai;5;2;7
626;17.07.2017;2017;07;01;Maanantai;1;2;3
626;17.07.2017;2017;07;02;Maanantai;1;2;3
626;17.07.2017;2017;07;03;Maanantai;2;2;4
626;17.07.2017;2017;07;04;Maanantai;0;0;0
626;17.07.2017;2017;07;05;Maanantai;1;3;4
626;17.07.2017;2017;07;06;Maanantai;3;6;9
626;17.07.2017;2017;07;07;Maanantai;13;38;51
626;17.07.2017;2017;07;08;Maanantai;21;55;76
626;17.07.2017;2017;07;09;Maanantai;12;43;55
626;17.07.2017;2017;07;10;Maanantai;14;28;42
626;17.07.2017;2017;07;11;Maanantai;21;29;50
626;17.07.2017;2017;07;12;Maanantai;36;39;75
626;17.07.2017;2017;07;13;Maanantai;29;40;69
626;17.07.2017;2017;07;14;Maanantai;52;41;93
626;17.07.2017;2017;07;15;Maanantai;46;44;90
626;17.07.2017;2017;07;16;Maanantai;56;40;96
626;17.07.2017;2017;07;17;Maanantai;85;55;140
626;17.07.2017;2017;07;18;Maanantai;43;33;76
626;17.07.2017;2017;07;19;Maanantai;44;29;73
626;17.07.2017;2017;07;20;Maanantai;38;33;71
626;17.07.2017;2017;07;21;Maanantai;15;17;32
626;17.07.2017;2017;07;22;Maanantai;24;16;40
626;17.07.2017;2017;07;23;Maanantai;8;6;14
626;18.07.2017;2017;07;00;Tiistai;2;8;10
626;18.07.2017;2017;07;01;Tiistai;0;1;1
626;18.07.2017;2017;07;02;Tiistai;5;1;6
626;18.07.2017;2017;07;03;Tiistai;1;0;1
626;18.07.2017;2017;07;04;Tiistai;0;0;0
626;18.07.2017;2017;07;05;Tiistai;0;0;0
626;18.07.2017;2017;07;06;Tiistai;3;1;4
626;18.07.2017;2017;07;07;Tiistai;6;14;20
626;18.07.2017;2017;07;08;Tiistai;8;8;16
626;18.07.2017;2017;07;09;Tiistai;4;2;6
626;18.07.2017;2017;07;10;Tiistai;0;3;3
626;18.07.2017;2017;07;11;Tiistai;5;3;8
626;18.07.2017;2017;07;12;Tiistai;7;11;18
626;18.07.2017;2017;07;13;Tiistai;7;3;10
626;18.07.2017;2017;07;14;Tiistai;8;13;21
626;18.07.2017;2017;07;15;Tiistai;9;5;14
626;18.07.2017;2017;07;16;Tiistai;24;18;42
626;18.07.2017;2017;07;17;Tiistai;18;21;39
626;18.07.2017;2017;07;18;Tiistai;12;12;24
626;18.07.2017;2017;07;19;Tiistai;12;15;27
626;18.07.2017;2017;07;20;Tiistai;11;11;22
626;18.07.2017;2017;07;21;Tiistai;8;8;16
626;18.07.2017;2017;07;22;Tiistai;6;3;9
626;18.07.2017;2017;07;23;Tiistai;2;3;5
626;19.07.2017;2017;07;00;Keskiviikko;0;3;3
626;19.07.2017;2017;07;01;Keskiviikko;0;1;1
626;19.07.2017;2017;07;02;Keskiviikko;0;0;0
626;19.07.2017;2017;07;03;Keskiviikko;0;0;0
626;19.07.2017;2017;07;04;Keskiviikko;1;1;2
626;19.07.2017;2017;07;05;Keskiviikko;2;2;4
626;19.07.2017;2017;07;06;Keskiviikko;2;7;9
626;19.07.2017;2017;07;07;Keskiviikko;7;15;22
626;19.07.2017;2017;07;08;Keskiviikko;11;33;44
626;19.07.2017;2017;07;09;Keskiviikko;11;34;45
626;19.07.2017;2017;07;10;Keskiviikko;7;18;25
626;19.07.2017;2017;07;11;Keskiviikko;7;28;35
626;19.07.2017;2017;07;12;Keskiviikko;15;17;32
626;19.07.2017;2017;07;13;Keskiviikko;21;15;36
626;19.07.2017;2017;07;14;Keskiviikko;19;20;39
626;19.07.2017;2017;07;15;Keskiviikko;28;20;48
626;19.07.2017;2017;07;16;Keskiviikko;26;19;45
626;19.07.2017;2017;07;17;Keskiviikko;34;27;61
626;19.07.2017;2017;07;18;Keskiviikko;30;33;63
626;19.07.2017;2017;07;19;Keskiviikko;28;20;48
626;19.07.2017;2017;07;20;Keskiviikko;13;12;25
626;19.07.2017;2017;07;21;Keskiviikko;20;8;28
626;19.07.2017;2017;07;22;Keskiviikko;13;6;19
626;19.07.2017;2017;07;23;Keskiviikko;6;9;15
626;20.07.2017;2017;07;00;Torstai;7;3;10
626;20.07.2017;2017;07;01;Torstai;4;0;4
626;20.07.2017;2017;07;02;Torstai;0;0;0
626;20.07.2017;2017;07;03;Torstai;0;1;1
626;20.07.2017;2017;07;04;Torstai;2;1;3
626;20.07.2017;2017;07;05;Torstai;2;0;2
626;20.07.2017;2017;07;06;Torstai;5;7;12
626;20.07.2017;2017;07;07;Torstai;9;28;37
626;20.07.2017;2017;07;08;Torstai;19;41;60
626;20.07.2017;2017;07;09;Torstai;12;25;37
626;20.07.2017;2017;07;10;Torstai;12;20;32
626;20.07.2017;2017;07;11;Torstai;11;19;30
626;20.07.2017;2017;07;12;Torstai;16;27;43
626;20.07.2017;2017;07;13;Torstai;20;12;32
626;20.07.2017;2017;07;14;Torstai;25;28;53
626;20.07.2017;2017;07;15;Torstai;25;27;52
626;20.07.2017;2017;07;16;Torstai;37;31;68
626;20.07.2017;2017;07;17;Torstai;55;47;102
626;20.07.2017;2017;07;18;Torstai;29;29;58
626;20.07.2017;2017;07;19;Torstai;27;22;49
626;20.07.2017;2017;07;20;Torstai;40;30;70
626;20.07.2017;2017;07;21;Torstai;24;20;44
626;20.07.2017;2017;07;22;Torstai;7;11;18
626;20.07.2017;2017;07;23;Torstai;10;8;18
626;21.07.2017;2017;07;00;Perjantai;6;3;9
626;21.07.2017;2017;07;01;Perjantai;3;2;5
626;21.07.2017;2017;07;02;Perjantai;2;1;3
626;21.07.2017;2017;07;03;Perjantai;0;0;0
626;21.07.2017;2017;07;04;Perjantai;0;1;1
626;21.07.2017;2017;07;05;Perjantai;5;2;7
626;21.07.2017;2017;07;06;Perjantai;3;3;6
626;21.07.2017;2017;07;07;Perjantai;9;23;32
626;21.07.2017;2017;07;08;Perjantai;12;24;36
626;21.07.2017;2017;07;09;Perjantai;11;29;40
626;21.07.2017;2017;07;10;Perjantai;11;20;31
626;21.07.2017;2017;07;11;Perjantai;12;20;32
626;21.07.2017;2017;07;12;Perjantai;15;21;36
626;21.07.2017;2017;07;13;Perjantai;28;24;52
626;21.07.2017;2017;07;14;Perjantai;18;16;34
626;21.07.2017;2017;07;15;Perjantai;26;30;56
626;21.07.2017;2017;07;16;Perjantai;37;25;62
626;21.07.2017;2017;07;17;Perjantai;34;39;73
626;21.07.2017;2017;07;18;Perjantai;30;19;49
626;21.07.2017;2017;07;19;Perjantai;18;12;30
626;21.07.2017;2017;07;20;Perjantai;11;19;30
626;21.07.2017;2017;07;21;Perjantai;9;22;31
626;21.07.2017;2017;07;22;Perjantai;7;6;13
626;21.07.2017;2017;07;23;Perjantai;4;7;11
626;22.07.2017;2017;07;00;Lauantai;6;1;7
626;22.07.2017;2017;07;01;Lauantai;2;0;2
626;22.07.2017;2017;07;02;Lauantai;5;2;7
626;22.07.2017;2017;07;03;Lauantai;4;2;6
626;22.07.2017;2017;07;04;Lauantai;3;0;3
626;22.07.2017;2017;07;05;Lauantai;2;0;2
626;22.07.2017;2017;07;06;Lauantai;3;2;5
626;22.07.2017;2017;07;07;Lauantai;0;4;4
626;22.07.2017;2017;07;08;Lauantai;4;5;9
626;22.07.2017;2017;07;09;Lauantai;12;9;21
626;22.07.2017;2017;07;10;Lauantai;10;23;33
626;22.07.2017;2017;07;11;Lauantai;26;35;61
626;22.07.2017;2017;07;12;Lauantai;24;37;61
626;22.07.2017;2017;07;13;Lauantai;30;28;58
626;22.07.2017;2017;07;14;Lauantai;30;29;59
626;22.07.2017;2017;07;15;Lauantai;28;20;48
626;22.07.2017;2017;07;16;Lauantai;20;24;44
626;22.07.2017;2017;07;17;Lauantai;25;27;52
626;22.07.2017;2017;07;18;Lauantai;19;26;45
626;22.07.2017;2017;07;19;Lauantai;20;21;41
626;22.07.2017;2017;07;20;Lauantai;18;13;31
626;22.07.2017;2017;07;21;Lauantai;10;22;32
626;22.07.2017;2017;07;22;Lauantai;15;15;30
626;22.07.2017;2017;07;23;Lauantai;11;9;20
626;23.07.2017;2017;07;00;Sunnuntai;4;6;10
626;23.07.2017;2017;07;01;Sunnuntai;4;5;9
626;23.07.2017;2017;07;02;Sunnuntai;3;0;3
626;23.07.2017;2017;07;03;Sunnuntai;3;2;5
626;23.07.2017;2017;07;04;Sunnuntai;6;1;7
626;23.07.2017;2017;07;05;Sunnuntai;9;0;9
626;23.07.2017;2017;07;06;Sunnuntai;2;4;6
626;23.07.2017;2017;07;07;Sunnuntai;2;3;5
626;23.07.2017;2017;07;08;Sunnuntai;2;6;8
626;23.07.2017;2017;07;09;Sunnuntai;5;4;9
626;23.07.2017;2017;07;10;Sunnuntai;16;14;30
626;23.07.2017;2017;07;11;Sunnuntai;23;35;58
626;23.07.2017;2017;07;12;Sunnuntai;26;32;58
626;23.07.2017;2017;07;13;Sunnuntai;34;39;73
626;23.07.2017;2017;07;14;Sunnuntai;35;26;61
626;23.07.2017;2017;07;15;Sunnuntai;29;31;60
626;23.07.2017;2017;07;16;Sunnuntai;32;22;54
626;23.07.2017;2017;07;17;Sunnuntai;16;18;34
626;23.07.2017;2017;07;18;Sunnuntai;9;15;24
626;23.07.2017;2017;07;19;Sunnuntai;6;11;17
626;23.07.2017;2017;07;20;Sunnuntai;11;2;13
626;23.07.2017;2017;07;21;Sunnuntai;5;5;10
626;23.07.2017;2017;07;22;Sunnuntai;10;8;18
626;23.07.2017;2017;07;23;Sunnuntai;9;1;10
626;24.07.2017;2017;07;00;Maanantai;3;0;3
626;24.07.2017;2017;07;01;Maanantai;0;1;1
626;24.07.2017;2017;07;02;Maanantai;2;0;2
626;24.07.2017;2017;07;03;Maanantai;0;1;1
626;24.07.2017;2017;07;04;Maanantai;2;1;3
626;24.07.2017;2017;07;05;Maanantai;0;0;0
626;24.07.2017;2017;07;06;Maanantai;8;5;13
626;24.07.2017;2017;07;07;Maanantai;12;29;41
626;24.07.2017;2017;07;08;Maanantai;19;47;66
626;24.07.2017;2017;07;09;Maanantai;11;31;42
626;24.07.2017;2017;07;10;Maanantai;9;23;32
626;24.07.2017;2017;07;11;Maanantai;24;20;44
626;24.07.2017;2017;07;12;Maanantai;27;36;63
626;24.07.2017;2017;07;13;Maanantai;20;44;64
626;24.07.2017;2017;07;14;Maanantai;29;32;61
626;24.07.2017;2017;07;15;Maanantai;34;33;67
626;24.07.2017;2017;07;16;Maanantai;58;37;95
626;24.07.2017;2017;07;17;Maanantai;65;57;122
626;24.07.2017;2017;07;18;Maanantai;50;49;99
626;24.07.2017;2017;07;19;Maanantai;38;30;68
626;24.07.2017;2017;07;20;Maanantai;29;19;48
626;24.07.2017;2017;07;21;Maanantai;26;13;39
626;24.07.2017;2017;07;22;Maanantai;20;9;29
626;24.07.2017;2017;07;23;Maanantai;12;13;25
626;25.07.2017;2017;07;00;Tiistai;3;2;5
626;25.07.2017;2017;07;01;Tiistai;2;0;2
626;25.07.2017;2017;07;02;Tiistai;0;0;0
626;25.07.2017;2017;07;03;Tiistai;2;0;2
626;25.07.2017;2017;07;04;Tiistai;0;0;0
626;25.07.2017;2017;07;05;Tiistai;0;0;0
626;25.07.2017;2017;07;06;Tiistai;5;6;11
626;25.07.2017;2017;07;07;Tiistai;11;36;47
626;25.07.2017;2017;07;08;Tiistai;28;60;88
626;25.07.2017;2017;07;09;Tiistai;11;35;46
626;25.07.2017;2017;07;10;Tiistai;21;24;45
626;25.07.2017;2017;07;11;Tiistai;32;41;73
626;25.07.2017;2017;07;12;Tiistai;31;47;78
626;25.07.2017;2017;07;13;Tiistai;39;57;96
626;25.07.2017;2017;07;14;Tiistai;37;26;63
626;25.07.2017;2017;07;15;Tiistai;37;33;70
626;25.07.2017;2017;07;16;Tiistai;64;53;117
626;25.07.2017;2017;07;17;Tiistai;77;67;144
626;25.07.2017;2017;07;18;Tiistai;50;38;88
626;25.07.2017;2017;07;19;Tiistai;44;31;75
626;25.07.2017;2017;07;20;Tiistai;43;47;90
626;25.07.2017;2017;07;21;Tiistai;26;17;43
626;25.07.2017;2017;07;22;Tiistai;24;23;47
626;25.07.2017;2017;07;23;Tiistai;8;3;11
626;26.07.2017;2017;07;00;Keskiviikko;7;3;10
626;26.07.2017;2017;07;01;Keskiviikko;1;3;4
626;26.07.2017;2017;07;02;Keskiviikko;1;1;2
626;26.07.2017;2017;07;03;Keskiviikko;2;3;5
626;26.07.2017;2017;07;04;Keskiviikko;1;1;2
626;26.07.2017;2017;07;05;Keskiviikko;0;2;2
626;26.07.2017;2017;07;06;Keskiviikko;4;3;7
626;26.07.2017;2017;07;07;Keskiviikko;12;24;36
626;26.07.2017;2017;07;08;Keskiviikko;15;54;69
626;26.07.2017;2017;07;09;Keskiviikko;7;28;35
626;26.07.2017;2017;07;10;Keskiviikko;10;21;31
626;26.07.2017;2017;07;11;Keskiviikko;32;36;68
626;26.07.2017;2017;07;12;Keskiviikko;39;57;96
626;26.07.2017;2017;07;13;Keskiviikko;41;56;97
626;26.07.2017;2017;07;14;Keskiviikko;52;59;111
626;26.07.2017;2017;07;15;Keskiviikko;47;51;98
626;26.07.2017;2017;07;16;Keskiviikko;77;53;130
626;26.07.2017;2017;07;17;Keskiviikko;99;83;182
626;26.07.2017;2017;07;18;Keskiviikko;77;74;151
626;26.07.2017;2017;07;19;Keskiviikko;75;76;151
626;26.07.2017;2017;07;20;Keskiviikko;58;58;116
626;26.07.2017;2017;07;21;Keskiviikko;51;37;88
626;26.07.2017;2017;07;22;Keskiviikko;33;19;52
626;26.07.2017;2017;07;23;Keskiviikko;17;11;28
626;27.07.2017;2017;07;00;Torstai;9;4;13
626;27.07.2017;2017;07;01;Torstai;5;6;11
626;27.07.2017;2017;07;02;Torstai;9;4;13
626;27.07.2017;2017;07;03;Torstai;3;0;3
626;27.07.2017;2017;07;04;Torstai;3;0;3
626;27.07.2017;2017;07;05;Torstai;2;3;5
626;27.07.2017;2017;07;06;Torstai;7;9;16
626;27.07.2017;2017;07;07;Torstai;13;31;44
626;27.07.2017;2017;07;08;Torstai;31;69;100
626;27.07.2017;2017;07;09;Torstai;17;41;58
626;27.07.2017;2017;07;10;Torstai;18;37;55
626;27.07.2017;2017;07;11;Torstai;18;29;47
626;27.07.2017;2017;07;12;Torstai;45;53;98
626;27.07.2017;2017;07;13;Torstai;31;55;86
626;27.07.2017;2017;07;14;Torstai;52;50;102
626;27.07.2017;2017;07;15;Torstai;37;58;95
626;27.07.2017;2017;07;16;Torstai;74;67;141
626;27.07.2017;2017;07;17;Torstai;99;64;163
626;27.07.2017;2017;07;18;Torstai;53;50;103
626;27.07.2017;2017;07;19;Torstai;54;41;95
626;27.07.2017;2017;07;20;Torstai;48;44;92
626;27.07.2017;2017;07;21;Torstai;27;25;52
626;27.07.2017;2017;07;22;Torstai;33;28;61
626;27.07.2017;2017;07;23;Torstai;23;10;33
626;28.07.2017;2017;07;00;Perjantai;5;2;7
626;28.07.2017;2017;07;01;Perjantai;10;3;13
626;28.07.2017;2017;07;02;Perjantai;3;1;4
626;28.07.2017;2017;07;03;Perjantai;1;1;2
626;28.07.2017;2017;07;04;Perjantai;1;1;2
626;28.07.2017;2017;07;05;Perjantai;1;1;2
626;28.07.2017;2017;07;06;Perjantai;7;4;11
626;28.07.2017;2017;07;07;Perjantai;14;25;39
626;28.07.2017;2017;07;08;Perjantai;17;48;65
626;28.07.2017;2017;07;09;Perjantai;13;36;49
626;28.07.2017;2017;07;10;Perjantai;18;28;46
626;28.07.2017;2017;07;11;Perjantai;24;34;58
626;28.07.2017;2017;07;12;Perjantai;43;53;96
626;28.07.2017;2017;07;13;Perjantai;32;60;92
626;28.07.2017;2017;07;14;Perjantai;47;56;103
626;28.07.2017;2017;07;15;Perjantai;51;79;130
626;28.07.2017;2017;07;16;Perjantai;64;64;128
626;28.07.2017;2017;07;17;Perjantai;56;63;119
626;28.07.2017;2017;07;18;Perjantai;58;57;115
626;28.07.2017;2017;07;19;Perjantai;43;70;113
626;28.07.2017;2017;07;20;Perjantai;32;48;80
626;28.07.2017;2017;07;21;Perjantai;39;47;86
626;28.07.2017;2017;07;22;Perjantai;17;27;44
626;28.07.2017;2017;07;23;Perjantai;17;11;28
626;29.07.2017;2017;07;00;Lauantai;27;6;33
626;29.07.2017;2017;07;01;Lauantai;52;10;62
626;29.07.2017;2017;07;02;Lauantai;61;11;72
626;29.07.2017;2017;07;03;Lauantai;39;3;42
626;29.07.2017;2017;07;04;Lauantai;28;4;32
626;29.07.2017;2017;07;05;Lauantai;11;3;14
626;29.07.2017;2017;07;06;Lauantai;9;1;10
626;29.07.2017;2017;07;07;Lauantai;2;4;6
626;29.07.2017;2017;07;08;Lauantai;4;8;12
626;29.07.2017;2017;07;09;Lauantai;7;6;13
626;29.07.2017;2017;07;10;Lauantai;8;12;20
626;29.07.2017;2017;07;11;Lauantai;16;16;32
626;29.07.2017;2017;07;12;Lauantai;11;10;21
626;29.07.2017;2017;07;13;Lauantai;3;17;20
626;29.07.2017;2017;07;14;Lauantai;17;29;46
626;29.07.2017;2017;07;15;Lauantai;10;27;37
626;29.07.2017;2017;07;16;Lauantai;17;24;41
626;29.07.2017;2017;07;17;Lauantai;17;23;40
626;29.07.2017;2017;07;18;Lauantai;20;31;51
626;29.07.2017;2017;07;19;Lauantai;15;33;48
626;29.07.2017;2017;07;20;Lauantai;15;31;46
626;29.07.2017;2017;07;21;Lauantai;19;26;45
626;29.07.2017;2017;07;22;Lauantai;12;14;26
626;29.07.2017;2017;07;23;Lauantai;8;13;21
626;30.07.2017;2017;07;00;Sunnuntai;12;8;20
626;30.07.2017;2017;07;01;Sunnuntai;39;8;47
626;30.07.2017;2017;07;02;Sunnuntai;44;3;47
626;30.07.2017;2017;07;03;Sunnuntai;20;2;22
626;30.07.2017;2017;07;04;Sunnuntai;20;1;21
626;30.07.2017;2017;07;05;Sunnuntai;16;1;17
626;30.07.2017;2017;07;06;Sunnuntai;6;0;6
626;30.07.2017;2017;07;07;Sunnuntai;7;3;10
626;30.07.2017;2017;07;08;Sunnuntai;3;4;7
626;30.07.2017;2017;07;09;Sunnuntai;4;8;12
626;30.07.2017;2017;07;10;Sunnuntai;17;16;33
626;30.07.2017;2017;07;11;Sunnuntai;30;27;57
626;30.07.2017;2017;07;12;Sunnuntai;37;57;94
626;30.07.2017;2017;07;13;Sunnuntai;68;103;171
626;30.07.2017;2017;07;14;Sunnuntai;92;88;180
626;30.07.2017;2017;07;15;Sunnuntai;87;89;176
626;30.07.2017;2017;07;16;Sunnuntai;79;77;156
626;30.07.2017;2017;07;17;Sunnuntai;65;48;113
626;30.07.2017;2017;07;18;Sunnuntai;48;44;92
626;30.07.2017;2017;07;19;Sunnuntai;35;33;68
626;30.07.2017;2017;07;20;Sunnuntai;39;33;72
626;30.07.2017;2017;07;21;Sunnuntai;22;32;54
626;30.07.2017;2017;07;22;Sunnuntai;13;19;32
626;30.07.2017;2017;07;23;Sunnuntai;9;8;17
626;31.07.2017;2017;07;00;Maanantai;3;2;5
626;31.07.2017;2017;07;01;Maanantai;1;0;1
626;31.07.2017;2017;07;02;Maanantai;0;2;2
626;31.07.2017;2017;07;03;Maanantai;0;0;0
626;31.07.2017;2017;07;04;Maanantai;0;1;1
626;31.07.2017;2017;07;05;Maanantai;0;0;0
626;31.07.2017;2017;07;06;Maanantai;9;10;19
626;31.07.2017;2017;07;07;Maanantai;10;42;52
626;31.07.2017;2017;07;08;Maanantai;29;67;96
626;31.07.2017;2017;07;09;Maanantai;15;41;56
626;31.07.2017;2017;07;10;Maanantai;8;34;42
626;31.07.2017;2017;07;11;Maanantai;16;25;41
626;31.07.2017;2017;07;12;Maanantai;22;26;48
626;31.07.2017;2017;07;13;Maanantai;40;45;85
626;31.07.2017;2017;07;14;Maanantai;30;39;69
626;31.07.2017;2017;07;15;Maanantai;36;39;75
626;31.07.2017;2017;07;16;Maanantai;77;63;140
626;31.07.2017;2017;07;17;Maanantai;81;75;156
626;31.07.2017;2017;07;18;Maanantai;69;60;129
626;31.07.2017;2017;07;19;Maanantai;52;39;91
626;31.07.2017;2017;07;20;Maanantai;38;27;65
626;31.07.2017;2017;07;21;Maanantai;24;17;41
626;31.07.2017;2017;07;22;Maanantai;13;10;23
626;31.07.2017;2017;07;23;Maanantai;13;8;21
626;01.08.2017;2017;08;00;Tiistai;1;0;1
626;01.08.2017;2017;08;01;Tiistai;2;3;5
626;01.08.2017;2017;08;02;Tiistai;3;0;3
626;01.08.2017;2017;08;03;Tiistai;0;0;0
626;01.08.2017;2017;08;04;Tiistai;1;0;1
626;01.08.2017;2017;08;05;Tiistai;0;2;2
626;01.08.2017;2017;08;06;Tiistai;7;9;16
626;01.08.2017;2017;08;07;Tiistai;9;35;44
626;01.08.2017;2017;08;08;Tiistai;22;63;85
626;01.08.2017;2017;08;09;Tiistai;16;55;71
626;01.08.2017;2017;08;10;Tiistai;12;22;34
626;01.08.2017;2017;08;11;Tiistai;18;48;66
626;01.08.2017;2017;08;12;Tiistai;29;28;57
626;01.08.2017;2017;08;13;Tiistai;24;46;70
626;01.08.2017;2017;08;14;Tiistai;41;49;90
626;01.08.2017;2017;08;15;Tiistai;33;54;87
626;01.08.2017;2017;08;16;Tiistai;65;43;108
626;01.08.2017;2017;08;17;Tiistai;84;60;144
626;01.08.2017;2017;08;18;Tiistai;60;37;97
626;01.08.2017;2017;08;19;Tiistai;58;41;99
626;01.08.2017;2017;08;20;Tiistai;35;29;64
626;01.08.2017;2017;08;21;Tiistai;34;15;49
626;01.08.2017;2017;08;22;Tiistai;22;11;33
626;01.08.2017;2017;08;23;Tiistai;11;13;24
626;02.08.2017;2017;08;00;Keskiviikko;7;1;8
626;02.08.2017;2017;08;01;Keskiviikko;0;0;0
626;02.08.2017;2017;08;02;Keskiviikko;1;0;1
626;02.08.2017;2017;08;03;Keskiviikko;0;1;1
626;02.08.2017;2017;08;04;Keskiviikko;1;0;1
626;02.08.2017;2017;08;05;Keskiviikko;2;1;3
626;02.08.2017;2017;08;06;Keskiviikko;6;6;12
626;02.08.2017;2017;08;07;Keskiviikko;15;43;58
626;02.08.2017;2017;08;08;Keskiviikko;34;74;108
626;02.08.2017;2017;08;09;Keskiviikko;23;60;83
626;02.08.2017;2017;08;10;Keskiviikko;16;31;47
626;02.08.2017;2017;08;11;Keskiviikko;26;30;56
626;02.08.2017;2017;08;12;Keskiviikko;41;63;104
626;02.08.2017;2017;08;13;Keskiviikko;36;40;76
626;02.08.2017;2017;08;14;Keskiviikko;37;46;83
626;02.08.2017;2017;08;15;Keskiviikko;34;32;66
626;02.08.2017;2017;08;16;Keskiviikko;64;44;108
626;02.08.2017;2017;08;17;Keskiviikko;86;72;158
626;02.08.2017;2017;08;18;Keskiviikko;59;44;103
626;02.08.2017;2017;08;19;Keskiviikko;46;42;88
626;02.08.2017;2017;08;20;Keskiviikko;24;23;47
626;02.08.2017;2017;08;21;Keskiviikko;35;25;60
626;02.08.2017;2017;08;22;Keskiviikko;31;28;59
626;02.08.2017;2017;08;23;Keskiviikko;14;6;20
626;03.08.2017;2017;08;00;Torstai;6;3;9
626;03.08.2017;2017;08;01;Torstai;2;0;2
626;03.08.2017;2017;08;02;Torstai;0;1;1
626;03.08.2017;2017;08;03;Torstai;0;0;0
626;03.08.2017;2017;08;04;Torstai;2;1;3
626;03.08.2017;2017;08;05;Torstai;0;2;2
626;03.08.2017;2017;08;06;Torstai;10;9;19
626;03.08.2017;2017;08;07;Torstai;8;35;43
626;03.08.2017;2017;08;08;Torstai;19;65;84
626;03.08.2017;2017;08;09;Torstai;15;38;53
626;03.08.2017;2017;08;10;Torstai;18;25;43
626;03.08.2017;2017;08;11;Torstai;17;24;41
626;03.08.2017;2017;08;12;Torstai;32;35;67
626;03.08.2017;2017;08;13;Torstai;22;40;62
626;03.08.2017;2017;08;14;Torstai;38;43;81
626;03.08.2017;2017;08;15;Torstai;40;46;86
626;03.08.2017;2017;08;16;Torstai;66;52;118
626;03.08.2017;2017;08;17;Torstai;67;52;119
626;03.08.2017;2017;08;18;Torstai;44;44;88
626;03.08.2017;2017;08;19;Torstai;55;40;95
626;03.08.2017;2017;08;20;Torstai;38;35;73
626;03.08.2017;2017;08;21;Torstai;27;22;49
626;03.08.2017;2017;08;22;Torstai;21;12;33
626;03.08.2017;2017;08;23;Torstai;14;2;16
626;04.08.2017;2017;08;00;Perjantai;1;1;2
626;04.08.2017;2017;08;01;Perjantai;0;1;1
626;04.08.2017;2017;08;02;Perjantai;2;0;2
626;04.08.2017;2017;08;03;Perjantai;0;0;0
626;04.08.2017;2017;08;04;Perjantai;0;0;0
626;04.08.2017;2017;08;05;Perjantai;0;1;1
626;04.08.2017;2017;08;06;Perjantai;10;11;21
626;04.08.2017;2017;08;07;Perjantai;12;33;45
626;04.08.2017;2017;08;08;Perjantai;23;62;85
626;04.08.2017;2017;08;09;Perjantai;15;39;54
626;04.08.2017;2017;08;10;Perjantai;17;32;49
626;04.08.2017;2017;08;11;Perjantai;27;26;53
626;04.08.2017;2017;08;12;Perjantai;26;31;57
626;04.08.2017;2017;08;13;Perjantai;32;53;85
626;04.08.2017;2017;08;14;Perjantai;29;19;48
626;04.08.2017;2017;08;15;Perjantai;37;50;87
626;04.08.2017;2017;08;16;Perjantai;72;50;122
626;04.08.2017;2017;08;17;Perjantai;72;68;140
626;04.08.2017;2017;08;18;Perjantai;59;41;100
626;04.08.2017;2017;08;19;Perjantai;40;29;69
626;04.08.2017;2017;08;20;Perjantai;35;26;61
626;04.08.2017;2017;08;21;Perjantai;31;24;55
626;04.08.2017;2017;08;22;Perjantai;14;19;33
626;04.08.2017;2017;08;23;Perjantai;24;12;36
626;05.08.2017;2017;08;00;Lauantai;11;6;17
626;05.08.2017;2017;08;01;Lauantai;10;1;11
626;05.08.2017;2017;08;02;Lauantai;4;1;5
626;05.08.2017;2017;08;03;Lauantai;4;2;6
626;05.08.2017;2017;08;04;Lauantai;2;1;3
626;05.08.2017;2017;08;05;Lauantai;3;1;4
626;05.08.2017;2017;08;06;Lauantai;5;1;6
626;05.08.2017;2017;08;07;Lauantai;6;6;12
626;05.08.2017;2017;08;08;Lauantai;5;8;13
626;05.08.2017;2017;08;09;Lauantai;6;6;12
626;05.08.2017;2017;08;10;Lauantai;10;22;32
626;05.08.2017;2017;08;11;Lauantai;18;20;38
626;05.08.2017;2017;08;12;Lauantai;14;16;30
626;05.08.2017;2017;08;13;Lauantai;16;23;39
626;05.08.2017;2017;08;14;Lauantai;29;23;52
626;05.08.2017;2017;08;15;Lauantai;31;17;48
626;05.08.2017;2017;08;16;Lauantai;12;24;36
626;05.08.2017;2017;08;17;Lauantai;21;21;42
626;05.08.2017;2017;08;18;Lauantai;14;19;33
626;05.08.2017;2017;08;19;Lauantai;17;17;34
626;05.08.2017;2017;08;20;Lauantai;10;5;15
626;05.08.2017;2017;08;21;Lauantai;9;2;11
626;05.08.2017;2017;08;22;Lauantai;5;4;9
626;05.08.2017;2017;08;23;Lauantai;4;3;7
626;06.08.2017;2017;08;00;Sunnuntai;5;0;5
626;06.08.2017;2017;08;01;Sunnuntai;2;1;3
626;06.08.2017;2017;08;02;Sunnuntai;0;1;1
626;06.08.2017;2017;08;03;Sunnuntai;8;2;10
626;06.08.2017;2017;08;04;Sunnuntai;4;0;4
626;06.08.2017;2017;08;05;Sunnuntai;0;1;1
626;06.08.2017;2017;08;06;Sunnuntai;1;2;3
626;06.08.2017;2017;08;07;Sunnuntai;3;5;8
626;06.08.2017;2017;08;08;Sunnuntai;3;6;9
626;06.08.2017;2017;08;09;Sunnuntai;7;9;16
626;06.08.2017;2017;08;10;Sunnuntai;9;6;15
626;06.08.2017;2017;08;11;Sunnuntai;12;12;24
626;06.08.2017;2017;08;12;Sunnuntai;7;21;28
626;06.08.2017;2017;08;13;Sunnuntai;10;15;25
626;06.08.2017;2017;08;14;Sunnuntai;20;28;48
626;06.08.2017;2017;08;15;Sunnuntai;17;15;32
626;06.08.2017;2017;08;16;Sunnuntai;9;16;25
626;06.08.2017;2017;08;17;Sunnuntai;21;19;40
626;06.08.2017;2017;08;18;Sunnuntai;18;17;35
626;06.08.2017;2017;08;19;Sunnuntai;9;15;24
626;06.08.2017;2017;08;20;Sunnuntai;18;14;32
626;06.08.2017;2017;08;21;Sunnuntai;7;7;14
626;06.08.2017;2017;08;22;Sunnuntai;8;9;17
626;06.08.2017;2017;08;23;Sunnuntai;4;4;8
626;07.08.2017;2017;08;00;Maanantai;1;2;3
626;07.08.2017;2017;08;01;Maanantai;0;2;2
626;07.08.2017;2017;08;02;Maanantai;2;1;3
626;07.08.2017;2017;08;03;Maanantai;1;0;1
626;07.08.2017;2017;08;04;Maanantai;3;1;4
626;07.08.2017;2017;08;05;Maanantai;0;2;2
626;07.08.2017;2017;08;06;Maanantai;8;9;17
626;07.08.2017;2017;08;07;Maanantai;10;47;57
626;07.08.2017;2017;08;08;Maanantai;31;86;117
626;07.08.2017;2017;08;09;Maanantai;18;36;54
626;07.08.2017;2017;08;10;Maanantai;8;31;39
626;07.08.2017;2017;08;11;Maanantai;21;24;45
626;07.08.2017;2017;08;12;Maanantai;28;22;50
626;07.08.2017;2017;08;13;Maanantai;25;24;49
626;07.08.2017;2017;08;14;Maanantai;22;34;56
626;07.08.2017;2017;08;15;Maanantai;26;24;50
626;07.08.2017;2017;08;16;Maanantai;60;34;94
626;07.08.2017;2017;08;17;Maanantai;94;63;157
626;07.08.2017;2017;08;18;Maanantai;53;36;89
626;07.08.2017;2017;08;19;Maanantai;39;33;72
626;07.08.2017;2017;08;20;Maanantai;38;25;63
626;07.08.2017;2017;08;21;Maanantai;25;25;50
626;07.08.2017;2017;08;22;Maanantai;12;13;25
626;07.08.2017;2017;08;23;Maanantai;6;5;11
626;08.08.2017;2017;08;00;Tiistai;5;0;5
626;08.08.2017;2017;08;01;Tiistai;2;2;4
626;08.08.2017;2017;08;02;Tiistai;0;0;0
626;08.08.2017;2017;08;03;Tiistai;1;0;1
626;08.08.2017;2017;08;04;Tiistai;1;1;2
626;08.08.2017;2017;08;05;Tiistai;1;3;4
626;08.08.2017;2017;08;06;Tiistai;11;7;18
626;08.08.2017;2017;08;07;Tiistai;15;46;61
626;08.08.2017;2017;08;08;Tiistai;32;96;128
626;08.08.2017;2017;08;09;Tiistai;28;49;77
626;08.08.2017;2017;08;10;Tiistai;19;32;51
626;08.08.2017;2017;08;11;Tiistai;23;39;62
626;08.08.2017;2017;08;12;Tiistai;30;36;66
626;08.08.2017;2017;08;13;Tiistai;30;37;67
626;08.08.2017;2017;08;14;Tiistai;35;35;70
626;08.08.2017;2017;08;15;Tiistai;34;50;84
626;08.08.2017;2017;08;16;Tiistai;68;38;106
626;08.08.2017;2017;08;17;Tiistai;99;67;166
626;08.08.2017;2017;08;18;Tiistai;48;43;91
626;08.08.2017;2017;08;19;Tiistai;47;33;80
626;08.08.2017;2017;08;20;Tiistai;25;11;36
626;08.08.2017;2017;08;21;Tiistai;18;11;29
626;08.08.2017;2017;08;22;Tiistai;10;12;22
626;08.08.2017;2017;08;23;Tiistai;4;4;8
626;09.08.2017;2017;08;00;Keskiviikko;1;3;4
626;09.08.2017;2017;08;01;Keskiviikko;2;0;2
626;09.08.2017;2017;08;02;Keskiviikko;1;1;2
626;09.08.2017;2017;08;03;Keskiviikko;0;0;0
626;09.08.2017;2017;08;04;Keskiviikko;0;1;1
626;09.08.2017;2017;08;05;Keskiviikko;2;2;4
626;09.08.2017;2017;08;06;Keskiviikko;10;7;17
626;09.08.2017;2017;08;07;Keskiviikko;14;44;58
626;09.08.2017;2017;08;08;Keskiviikko;29;93;122
626;09.08.2017;2017;08;09;Keskiviikko;18;52;70
626;09.08.2017;2017;08;10;Keskiviikko;12;29;41
626;09.08.2017;2017;08;11;Keskiviikko;20;25;45
626;09.08.2017;2017;08;12;Keskiviikko;20;31;51
626;09.08.2017;2017;08;13;Keskiviikko;30;38;68
626;09.08.2017;2017;08;14;Keskiviikko;36;40;76
626;09.08.2017;2017;08;15;Keskiviikko;41;45;86
626;09.08.2017;2017;08;16;Keskiviikko;55;56;111
626;09.08.2017;2017;08;17;Keskiviikko;91;69;160
626;09.08.2017;2017;08;18;Keskiviikko;65;49;114
626;09.08.2017;2017;08;19;Keskiviikko;45;37;82
626;09.08.2017;2017;08;20;Keskiviikko;41;18;59
626;09.08.2017;2017;08;21;Keskiviikko;31;23;54
626;09.08.2017;2017;08;22;Keskiviikko;26;23;49
626;09.08.2017;2017;08;23;Keskiviikko;8;3;11
626;10.08.2017;2017;08;00;Torstai;1;4;5
626;10.08.2017;2017;08;01;Torstai;1;2;3
626;10.08.2017;2017;08;02;Torstai;4;0;4
626;10.08.2017;2017;08;03;Torstai;1;1;2
626;10.08.2017;2017;08;04;Torstai;1;1;2
626;10.08.2017;2017;08;05;Torstai;1;2;3
626;10.08.2017;2017;08;06;Torstai;12;6;18
626;10.08.2017;2017;08;07;Torstai;10;32;42
626;10.08.2017;2017;08;08;Torstai;21;65;86
626;10.08.2017;2017;08;09;Torstai;23;46;69
626;10.08.2017;2017;08;10;Torstai;16;41;57
626;10.08.2017;2017;08;11;Torstai;17;16;33
626;10.08.2017;2017;08;12;Torstai;13;17;30
626;10.08.2017;2017;08;13;Torstai;10;11;21
626;10.08.2017;2017;08;14;Torstai;11;5;16
626;10.08.2017;2017;08;15;Torstai;19;11;30
626;10.08.2017;2017;08;16;Torstai;40;22;62
626;10.08.2017;2017;08;17;Torstai;34;21;55
626;10.08.2017;2017;08;18;Torstai;26;13;39
626;10.08.2017;2017;08;19;Torstai;25;21;46
626;10.08.2017;2017;08;20;Torstai;9;14;23
626;10.08.2017;2017;08;21;Torstai;15;9;24
626;10.08.2017;2017;08;22;Torstai;8;3;11
626;10.08.2017;2017;08;23;Torstai;3;4;7
626;11.08.2017;2017;08;00;Perjantai;2;0;2
626;11.08.2017;2017;08;01;Perjantai;2;1;3
626;11.08.2017;2017;08;02;Perjantai;1;0;1
626;11.08.2017;2017;08;03;Perjantai;0;0;0
626;11.08.2017;2017;08;04;Perjantai;0;0;0
626;11.08.2017;2017;08;05;Perjantai;0;5;5
626;11.08.2017;2017;08;06;Perjantai;7;11;18
626;11.08.2017;2017;08;07;Perjantai;13;40;53
626;11.08.2017;2017;08;08;Perjantai;23;81;104
626;11.08.2017;2017;08;09;Perjantai;21;48;69
626;11.08.2017;2017;08;10;Perjantai;14;41;55
626;11.08.2017;2017;08;11;Perjantai;14;30;44
626;11.08.2017;2017;08;12;Perjantai;15;21;36
626;11.08.2017;2017;08;13;Perjantai;18;33;51
626;11.08.2017;2017;08;14;Perjantai;37;23;60
626;11.08.2017;2017;08;15;Perjantai;48;34;82
626;11.08.2017;2017;08;16;Perjantai;80;45;125
626;11.08.2017;2017;08;17;Perjantai;60;36;96
626;11.08.2017;2017;08;18;Perjantai;44;36;80
626;11.08.2017;2017;08;19;Perjantai;33;29;62
626;11.08.2017;2017;08;20;Perjantai;12;20;32
626;11.08.2017;2017;08;21;Perjantai;15;14;29
626;11.08.2017;2017;08;22;Perjantai;14;18;32
626;11.08.2017;2017;08;23;Perjantai;8;9;17
626;12.08.2017;2017;08;00;Lauantai;5;5;10
626;12.08.2017;2017;08;01;Lauantai;11;2;13
626;12.08.2017;2017;08;02;Lauantai;5;1;6
626;12.08.2017;2017;08;03;Lauantai;6;0;6
626;12.08.2017;2017;08;04;Lauantai;1;0;1
626;12.08.2017;2017;08;05;Lauantai;1;0;1
626;12.08.2017;2017;08;06;Lauantai;2;3;5
626;12.08.2017;2017;08;07;Lauantai;3;6;9
626;12.08.2017;2017;08;08;Lauantai;7;6;13
626;12.08.2017;2017;08;09;Lauantai;9;22;31
626;12.08.2017;2017;08;10;Lauantai;14;28;42
626;12.08.2017;2017;08;11;Lauantai;22;49;71
626;12.08.2017;2017;08;12;Lauantai;26;35;61
626;12.08.2017;2017;08;13;Lauantai;27;50;77
626;12.08.2017;2017;08;14;Lauantai;35;35;70
626;12.08.2017;2017;08;15;Lauantai;56;60;116
626;12.08.2017;2017;08;16;Lauantai;46;54;100
626;12.08.2017;2017;08;17;Lauantai;39;36;75
626;12.08.2017;2017;08;18;Lauantai;44;35;79
626;12.08.2017;2017;08;19;Lauantai;22;28;50
626;12.08.2017;2017;08;20;Lauantai;29;21;50
626;12.08.2017;2017;08;21;Lauantai;26;10;36
626;12.08.2017;2017;08;22;Lauantai;14;6;20
626;12.08.2017;2017;08;23;Lauantai;11;5;16
626;13.08.2017;2017;08;00;Sunnuntai;12;3;15
626;13.08.2017;2017;08;01;Sunnuntai;6;2;8
626;13.08.2017;2017;08;02;Sunnuntai;1;1;2
626;13.08.2017;2017;08;03;Sunnuntai;1;1;2
626;13.08.2017;2017;08;04;Sunnuntai;2;0;2
626;13.08.2017;2017;08;05;Sunnuntai;0;1;1
626;13.08.2017;2017;08;06;Sunnuntai;1;1;2
626;13.08.2017;2017;08;07;Sunnuntai;0;3;3
626;13.08.2017;2017;08;08;Sunnuntai;0;7;7
626;13.08.2017;2017;08;09;Sunnuntai;2;4;6
626;13.08.2017;2017;08;10;Sunnuntai;4;4;8
626;13.08.2017;2017;08;11;Sunnuntai;5;13;18
626;13.08.2017;2017;08;12;Sunnuntai;4;7;11
626;13.08.2017;2017;08;13;Sunnuntai;5;5;10
626;13.08.2017;2017;08;14;Sunnuntai;9;8;17
626;13.08.2017;2017;08;15;Sunnuntai;10;8;18
626;13.08.2017;2017;08;16;Sunnuntai;9;6;15
626;13.08.2017;2017;08;17;Sunnuntai;10;10;20
626;13.08.2017;2017;08;18;Sunnuntai;5;8;13
626;13.08.2017;2017;08;19;Sunnuntai;11;11;22
626;13.08.2017;2017;08;20;Sunnuntai;18;12;30
626;13.08.2017;2017;08;21;Sunnuntai;12;7;19
626;13.08.2017;2017;08;22;Sunnuntai;4;9;13
626;13.08.2017;2017;08;23;Sunnuntai;4;1;5
626;14.08.2017;2017;08;00;Maanantai;0;1;1
626;14.08.2017;2017;08;01;Maanantai;0;1;1
626;14.08.2017;2017;08;02;Maanantai;0;1;1
626;14.08.2017;2017;08;03;Maanantai;1;1;2
626;14.08.2017;2017;08;04;Maanantai;0;0;0
626;14.08.2017;2017;08;05;Maanantai;0;5;5
626;14.08.2017;2017;08;06;Maanantai;4;10;14
626;14.08.2017;2017;08;07;Maanantai;14;53;67
626;14.08.2017;2017;08;08;Maanantai;26;94;120
626;14.08.2017;2017;08;09;Maanantai;27;55;82
626;14.08.2017;2017;08;10;Maanantai;11;34;45
626;14.08.2017;2017;08;11;Maanantai;14;14;28
626;14.08.2017;2017;08;12;Maanantai;19;20;39
626;14.08.2017;2017;08;13;Maanantai;12;11;23
626;14.08.2017;2017;08;14;Maanantai;16;16;32
626;14.08.2017;2017;08;15;Maanantai;21;24;45
626;14.08.2017;2017;08;16;Maanantai;62;28;90
626;14.08.2017;2017;08;17;Maanantai;65;48;113
626;14.08.2017;2017;08;18;Maanantai;54;34;88
626;14.08.2017;2017;08;19;Maanantai;33;23;56
626;14.08.2017;2017;08;20;Maanantai;20;17;37
626;14.08.2017;2017;08;21;Maanantai;25;7;32
626;14.08.2017;2017;08;22;Maanantai;10;6;16
626;14.08.2017;2017;08;23;Maanantai;4;5;9
626;15.08.2017;2017;08;00;Tiistai;4;0;4
626;15.08.2017;2017;08;01;Tiistai;1;0;1
626;15.08.2017;2017;08;02;Tiistai;0;0;0
626;15.08.2017;2017;08;03;Tiistai;0;1;1
626;15.08.2017;2017;08;04;Tiistai;0;0;0
626;15.08.2017;2017;08;05;Tiistai;0;1;1
626;15.08.2017;2017;08;06;Tiistai;5;9;14
626;15.08.2017;2017;08;07;Tiistai;15;42;57
626;15.08.2017;2017;08;08;Tiistai;33;97;130
626;15.08.2017;2017;08;09;Tiistai;28;56;84
626;15.08.2017;2017;08;10;Tiistai;18;42;60
626;15.08.2017;2017;08;11;Tiistai;17;26;43
626;15.08.2017;2017;08;12;Tiistai;18;27;45
626;15.08.2017;2017;08;13;Tiistai;23;25;48
626;15.08.2017;2017;08;14;Tiistai;17;20;37
626;15.08.2017;2017;08;15;Tiistai;22;19;41
626;15.08.2017;2017;08;16;Tiistai;68;37;105
626;15.08.2017;2017;08;17;Tiistai;95;52;147
626;15.08.2017;2017;08;18;Tiistai;42;23;65
626;15.08.2017;2017;08;19;Tiistai;32;21;53
626;15.08.2017;2017;08;20;Tiistai;38;20;58
626;15.08.2017;2017;08;21;Tiistai;22;18;40
626;15.08.2017;2017;08;22;Tiistai;13;12;25
626;15.08.2017;2017;08;23;Tiistai;4;6;10
626;16.08.2017;2017;08;00;Keskiviikko;3;1;4
626;16.08.2017;2017;08;01;Keskiviikko;0;2;2
626;16.08.2017;2017;08;02;Keskiviikko;1;0;1
626;16.08.2017;2017;08;03;Keskiviikko;0;1;1
626;16.08.2017;2017;08;04;Keskiviikko;0;1;1
626;16.08.2017;2017;08;05;Keskiviikko;1;3;4
626;16.08.2017;2017;08;06;Keskiviikko;9;14;23
626;16.08.2017;2017;08;07;Keskiviikko;16;49;65
626;16.08.2017;2017;08;08;Keskiviikko;39;93;132
626;16.08.2017;2017;08;09;Keskiviikko;20;52;72
626;16.08.2017;2017;08;10;Keskiviikko;17;34;51
626;16.08.2017;2017;08;11;Keskiviikko;20;20;40
626;16.08.2017;2017;08;12;Keskiviikko;22;26;48
626;16.08.2017;2017;08;13;Keskiviikko;19;18;37
626;16.08.2017;2017;08;14;Keskiviikko;23;34;57
626;16.08.2017;2017;08;15;Keskiviikko;43;26;69
626;16.08.2017;2017;08;16;Keskiviikko;69;37;106
626;16.08.2017;2017;08;17;Keskiviikko;77;58;135
626;16.08.2017;2017;08;18;Keskiviikko;39;30;69
626;16.08.2017;2017;08;19;Keskiviikko;33;26;59
626;16.08.2017;2017;08;20;Keskiviikko;31;26;57
626;16.08.2017;2017;08;21;Keskiviikko;23;12;35
626;16.08.2017;2017;08;22;Keskiviikko;9;9;18
626;16.08.2017;2017;08;23;Keskiviikko;3;4;7
626;17.08.2017;2017;08;00;Torstai;3;1;4
626;17.08.2017;2017;08;01;Torstai;0;0;0
626;17.08.2017;2017;08;02;Torstai;2;0;2
626;17.08.2017;2017;08;03;Torstai;2;0;2
626;17.08.2017;2017;08;04;Torstai;0;0;0
626;17.08.2017;2017;08;05;Torstai;0;2;2
626;17.08.2017;2017;08;06;Torstai;2;10;12
626;17.08.2017;2017;08;07;Torstai;11;40;51
626;17.08.2017;2017;08;08;Torstai;31;99;130
626;17.08.2017;2017;08;09;Torstai;22;40;62
626;17.08.2017;2017;08;10;Torstai;14;18;32
626;17.08.2017;2017;08;11;Torstai;11;17;28
626;17.08.2017;2017;08;12;Torstai;17;17;34
626;17.08.2017;2017;08;13;Torstai;19;28;47
626;17.08.2017;2017;08;14;Torstai;34;25;59
626;17.08.2017;2017;08;15;Torstai;37;30;67
626;17.08.2017;2017;08;16;Torstai;53;31;84
626;17.08.2017;2017;08;17;Torstai;77;61;138
626;17.08.2017;2017;08;18;Torstai;28;45;73
626;17.08.2017;2017;08;19;Torstai;36;29;65
626;17.08.2017;2017;08;20;Torstai;25;19;44
626;17.08.2017;2017;08;21;Torstai;32;13;45
626;17.08.2017;2017;08;22;Torstai;17;9;26
626;17.08.2017;2017;08;23;Torstai;11;8;19
626;18.08.2017;2017;08;00;Perjantai;4;0;4
626;18.08.2017;2017;08;01;Perjantai;6;0;6
626;18.08.2017;2017;08;02;Perjantai;4;0;4
626;18.08.2017;2017;08;03;Perjantai;2;0;2
626;18.08.2017;2017;08;04;Perjantai;0;1;1
626;18.08.2017;2017;08;05;Perjantai;2;2;4
626;18.08.2017;2017;08;06;Perjantai;4;10;14
626;18.08.2017;2017;08;07;Perjantai;7;34;41
626;18.08.2017;2017;08;08;Perjantai;26;69;95
626;18.08.2017;2017;08;09;Perjantai;18;27;45
626;18.08.2017;2017;08;10;Perjantai;22;35;57
626;18.08.2017;2017;08;11;Perjantai;14;26;40
626;18.08.2017;2017;08;12;Perjantai;20;26;46
626;18.08.2017;2017;08;13;Perjantai;20;26;46
626;18.08.2017;2017;08;14;Perjantai;0;2;2
626;18.08.2017;2017;08;15;Perjantai;0;0;0
626;18.08.2017;2017;08;16;Perjantai;131;87;218
626;18.08.2017;2017;08;17;Perjantai;49;25;74
626;18.08.2017;2017;08;18;Perjantai;21;15;36
626;18.08.2017;2017;08;19;Perjantai;20;19;39
626;18.08.2017;2017;08;20;Perjantai;19;10;29
626;18.08.2017;2017;08;21;Perjantai;11;8;19
626;18.08.2017;2017;08;22;Perjantai;8;8;16
626;18.08.2017;2017;08;23;Perjantai;4;3;7
626;19.08.2017;2017;08;00;Lauantai;3;1;4
626;19.08.2017;2017;08;01;Lauantai;5;0;5
626;19.08.2017;2017;08;02;Lauantai;2;0;2
626;19.08.2017;2017;08;03;Lauantai;2;0;2
626;19.08.2017;2017;08;04;Lauantai;1;1;2
626;19.08.2017;2017;08;05;Lauantai;0;0;0
626;19.08.2017;2017;08;06;Lauantai;4;1;5
626;19.08.2017;2017;08;07;Lauantai;0;3;3
626;19.08.2017;2017;08;08;Lauantai;1;4;5
626;19.08.2017;2017;08;09;Lauantai;3;9;12
626;19.08.2017;2017;08;10;Lauantai;14;11;25
626;19.08.2017;2017;08;11;Lauantai;13;30;43
626;19.08.2017;2017;08;12;Lauantai;18;22;40
626;19.08.2017;2017;08;13;Lauantai;25;23;48
626;19.08.2017;2017;08;14;Lauantai;33;41;74
626;19.08.2017;2017;08;15;Lauantai;20;38;58
626;19.08.2017;2017;08;16;Lauantai;14;19;33
626;19.08.2017;2017;08;17;Lauantai;36;23;59
626;19.08.2017;2017;08;18;Lauantai;33;22;55
626;19.08.2017;2017;08;19;Lauantai;17;26;43
626;19.08.2017;2017;08;20;Lauantai;5;4;9
626;19.08.2017;2017;08;21;Lauantai;5;2;7
626;19.08.2017;2017;08;22;Lauantai;4;8;12
626;19.08.2017;2017;08;23;Lauantai;2;1;3
626;20.08.2017;2017;08;00;Sunnuntai;1;1;2
626;20.08.2017;2017;08;01;Sunnuntai;2;0;2
626;20.08.2017;2017;08;02;Sunnuntai;0;0;0
626;20.08.2017;2017;08;03;Sunnuntai;1;0;1
626;20.08.2017;2017;08;04;Sunnuntai;2;1;3
626;20.08.2017;2017;08;05;Sunnuntai;2;0;2
626;20.08.2017;2017;08;06;Sunnuntai;0;5;5
626;20.08.2017;2017;08;07;Sunnuntai;0;3;3
626;20.08.2017;2017;08;08;Sunnuntai;1;6;7
626;20.08.2017;2017;08;09;Sunnuntai;6;8;14
626;20.08.2017;2017;08;10;Sunnuntai;5;10;15
626;20.08.2017;2017;08;11;Sunnuntai;14;19;33
626;20.08.2017;2017;08;12;Sunnuntai;22;18;40
626;20.08.2017;2017;08;13;Sunnuntai;17;20;37
626;20.08.2017;2017;08;14;Sunnuntai;19;28;47
626;20.08.2017;2017;08;15;Sunnuntai;17;19;36
626;20.08.2017;2017;08;16;Sunnuntai;10;8;18
626;20.08.2017;2017;08;17;Sunnuntai;12;19;31
626;20.08.2017;2017;08;18;Sunnuntai;13;15;28
626;20.08.2017;2017;08;19;Sunnuntai;5;8;13
626;20.08.2017;2017;08;20;Sunnuntai;12;16;28
626;20.08.2017;2017;08;21;Sunnuntai;13;8;21
626;20.08.2017;2017;08;22;Sunnuntai;7;10;17
626;20.08.2017;2017;08;23;Sunnuntai;4;2;6
626;21.08.2017;2017;08;00;Maanantai;1;1;2
626;21.08.2017;2017;08;01;Maanantai;0;0;0
626;21.08.2017;2017;08;02;Maanantai;1;0;1
626;21.08.2017;2017;08;03;Maanantai;0;0;0
626;21.08.2017;2017;08;04;Maanantai;0;1;1
626;21.08.2017;2017;08;05;Maanantai;0;1;1
626;21.08.2017;2017;08;06;Maanantai;3;11;14
626;21.08.2017;2017;08;07;Maanantai;11;40;51
626;21.08.2017;2017;08;08;Maanantai;35;84;119
626;21.08.2017;2017;08;09;Maanantai;17;40;57
626;21.08.2017;2017;08;10;Maanantai;13;27;40
626;21.08.2017;2017;08;11;Maanantai;13;12;25
626;21.08.2017;2017;08;12;Maanantai;10;8;18
626;21.08.2017;2017;08;13;Maanantai;19;20;39
626;21.08.2017;2017;08;14;Maanantai;22;12;34
626;21.08.2017;2017;08;15;Maanantai;20;16;36
626;21.08.2017;2017;08;16;Maanantai;51;35;86
626;21.08.2017;2017;08;17;Maanantai;76;47;123
626;21.08.2017;2017;08;18;Maanantai;59;33;92
626;21.08.2017;2017;08;19;Maanantai;39;22;61
626;21.08.2017;2017;08;20;Maanantai;22;15;37
626;21.08.2017;2017;08;21;Maanantai;14;12;26
626;21.08.2017;2017;08;22;Maanantai;11;7;18
626;21.08.2017;2017;08;23;Maanantai;2;4;6
626;22.08.2017;2017;08;00;Tiistai;1;1;2
626;22.08.2017;2017;08;01;Tiistai;4;3;7
626;22.08.2017;2017;08;02;Tiistai;2;1;3
626;22.08.2017;2017;08;03;Tiistai;0;0;0
626;22.08.2017;2017;08;04;Tiistai;1;1;2
626;22.08.2017;2017;08;05;Tiistai;0;2;2
626;22.08.2017;2017;08;06;Tiistai;3;11;14
626;22.08.2017;2017;08;07;Tiistai;9;34;43
626;22.08.2017;2017;08;08;Tiistai;30;77;107
626;22.08.2017;2017;08;09;Tiistai;25;41;66
626;22.08.2017;2017;08;10;Tiistai;12;33;45
626;22.08.2017;2017;08;11;Tiistai;14;12;26
626;22.08.2017;2017;08;12;Tiistai;19;22;41
626;22.08.2017;2017;08;13;Tiistai;18;10;28
626;22.08.2017;2017;08;14;Tiistai;17;13;30
626;22.08.2017;2017;08;15;Tiistai;26;17;43
626;22.08.2017;2017;08;16;Tiistai;53;27;80
626;22.08.2017;2017;08;17;Tiistai;78;36;114
626;22.08.2017;2017;08;18;Tiistai;37;23;60
626;22.08.2017;2017;08;19;Tiistai;30;20;50
626;22.08.2017;2017;08;20;Tiistai;31;24;55
626;22.08.2017;2017;08;21;Tiistai;9;10;19
626;22.08.2017;2017;08;22;Tiistai;10;9;19
626;22.08.2017;2017;08;23;Tiistai;5;4;9
626;23.08.2017;2017;08;00;Keskiviikko;1;0;1
626;23.08.2017;2017;08;01;Keskiviikko;2;0;2
626;23.08.2017;2017;08;02;Keskiviikko;0;1;1
626;23.08.2017;2017;08;03;Keskiviikko;0;0;0
626;23.08.2017;2017;08;04;Keskiviikko;1;1;2
626;23.08.2017;2017;08;05;Keskiviikko;0;2;2
626;23.08.2017;2017;08;06;Keskiviikko;7;12;19
626;23.08.2017;2017;08;07;Keskiviikko;16;50;66
626;23.08.2017;2017;08;08;Keskiviikko;29;73;102
626;23.08.2017;2017;08;09;Keskiviikko;16;48;64
626;23.08.2017;2017;08;10;Keskiviikko;15;24;39
626;23.08.2017;2017;08;11;Keskiviikko;15;21;36
626;23.08.2017;2017;08;12;Keskiviikko;17;19;36
626;23.08.2017;2017;08;13;Keskiviikko;18;14;32
626;23.08.2017;2017;08;14;Keskiviikko;19;20;39
626;23.08.2017;2017;08;15;Keskiviikko;32;28;60
626;23.08.2017;2017;08;16;Keskiviikko;68;34;102
626;23.08.2017;2017;08;17;Keskiviikko;76;43;119
626;23.08.2017;2017;08;18;Keskiviikko;39;35;74
626;23.08.2017;2017;08;19;Keskiviikko;41;37;78
626;23.08.2017;2017;08;20;Keskiviikko;23;24;47
626;23.08.2017;2017;08;21;Keskiviikko;24;15;39
626;23.08.2017;2017;08;22;Keskiviikko;16;13;29
626;23.08.2017;2017;08;23;Keskiviikko;7;1;8
626;24.08.2017;2017;08;00;Torstai;3;2;5
626;24.08.2017;2017;08;01;Torstai;0;1;1
626;24.08.2017;2017;08;02;Torstai;4;0;4
626;24.08.2017;2017;08;03;Torstai;0;1;1
626;24.08.2017;2017;08;04;Torstai;3;4;7
626;24.08.2017;2017;08;05;Torstai;0;4;4
626;24.08.2017;2017;08;06;Torstai;8;10;18
626;24.08.2017;2017;08;07;Torstai;9;36;45
626;24.08.2017;2017;08;08;Torstai;37;79;116
626;24.08.2017;2017;08;09;Torstai;22;42;64
626;24.08.2017;2017;08;10;Torstai;18;26;44
626;24.08.2017;2017;08;11;Torstai;6;18;24
626;24.08.2017;2017;08;12;Torstai;15;13;28
626;24.08.2017;2017;08;13;Torstai;17;24;41
626;24.08.2017;2017;08;14;Torstai;26;26;52
626;24.08.2017;2017;08;15;Torstai;30;21;51
626;24.08.2017;2017;08;16;Torstai;51;37;88
626;24.08.2017;2017;08;17;Torstai;75;43;118
626;24.08.2017;2017;08;18;Torstai;46;32;78
626;24.08.2017;2017;08;19;Torstai;26;20;46
626;24.08.2017;2017;08;20;Torstai;23;20;43
626;24.08.2017;2017;08;21;Torstai;22;15;37
626;24.08.2017;2017;08;22;Torstai;15;5;20
626;24.08.2017;2017;08;23;Torstai;5;3;8
626;25.08.2017;2017;08;00;Perjantai;3;1;4
626;25.08.2017;2017;08;01;Perjantai;2;1;3
626;25.08.2017;2017;08;02;Perjantai;1;0;1
626;25.08.2017;2017;08;03;Perjantai;0;0;0
626;25.08.2017;2017;08;04;Perjantai;0;0;0
626;25.08.2017;2017;08;05;Perjantai;0;1;1
626;25.08.2017;2017;08;06;Perjantai;7;9;16
626;25.08.2017;2017;08;07;Perjantai;3;28;31
626;25.08.2017;2017;08;08;Perjantai;8;58;66
626;25.08.2017;2017;08;09;Perjantai;9;24;33
626;25.08.2017;2017;08;10;Perjantai;9;13;22
626;25.08.2017;2017;08;11;Perjantai;6;15;21
626;25.08.2017;2017;08;12;Perjantai;4;10;14
626;25.08.2017;2017;08;13;Perjantai;14;18;32
626;25.08.2017;2017;08;14;Perjantai;12;5;17
626;25.08.2017;2017;08;15;Perjantai;22;9;31
626;25.08.2017;2017;08;16;Perjantai;33;9;42
626;25.08.2017;2017;08;17;Perjantai;39;12;51
626;25.08.2017;2017;08;18;Perjantai;17;13;30
626;25.08.2017;2017;08;19;Perjantai;8;8;16
626;25.08.2017;2017;08;20;Perjantai;7;8;15
626;25.08.2017;2017;08;21;Perjantai;7;7;14
626;25.08.2017;2017;08;22;Perjantai;7;7;14
626;25.08.2017;2017;08;23;Perjantai;3;0;3
626;26.08.2017;2017;08;00;Lauantai;2;2;4
626;26.08.2017;2017;08;01;Lauantai;0;0;0
626;26.08.2017;2017;08;02;Lauantai;0;1;1
626;26.08.2017;2017;08;03;Lauantai;0;0;0
626;26.08.2017;2017;08;04;Lauantai;1;0;1
626;26.08.2017;2017;08;05;Lauantai;0;0;0
626;26.08.2017;2017;08;06;Lauantai;3;2;5
626;26.08.2017;2017;08;07;Lauantai;1;2;3
626;26.08.2017;2017;08;08;Lauantai;1;2;3
626;26.08.2017;2017;08;09;Lauantai;6;4;10
626;26.08.2017;2017;08;10;Lauantai;8;4;12
626;26.08.2017;2017;08;11;Lauantai;7;14;21
626;26.08.2017;2017;08;12;Lauantai;7;13;20
626;26.08.2017;2017;08;13;Lauantai;9;12;21
626;26.08.2017;2017;08;14;Lauantai;13;14;27
626;26.08.2017;2017;08;15;Lauantai;16;13;29
626;26.08.2017;2017;08;16;Lauantai;18;18;36
626;26.08.2017;2017;08;17;Lauantai;23;21;44
626;26.08.2017;2017;08;18;Lauantai;21;19;40
626;26.08.2017;2017;08;19;Lauantai;13;18;31
626;26.08.2017;2017;08;20;Lauantai;10;12;22
626;26.08.2017;2017;08;21;Lauantai;6;10;16
626;26.08.2017;2017;08;22;Lauantai;11;5;16
626;26.08.2017;2017;08;23;Lauantai;3;2;5
626;27.08.2017;2017;08;00;Sunnuntai;4;0;4
626;27.08.2017;2017;08;01;Sunnuntai;2;0;2
626;27.08.2017;2017;08;02;Sunnuntai;4;0;4
626;27.08.2017;2017;08;03;Sunnuntai;1;0;1
626;27.08.2017;2017;08;04;Sunnuntai;0;0;0
626;27.08.2017;2017;08;05;Sunnuntai;2;0;2
626;27.08.2017;2017;08;06;Sunnuntai;1;2;3
626;27.08.2017;2017;08;07;Sunnuntai;0;3;3
626;27.08.2017;2017;08;08;Sunnuntai;2;2;4
626;27.08.2017;2017;08;09;Sunnuntai;5;5;10
626;27.08.2017;2017;08;10;Sunnuntai;6;8;14
626;27.08.2017;2017;08;11;Sunnuntai;10;11;21
626;27.08.2017;2017;08;12;Sunnuntai;15;24;39
626;27.08.2017;2017;08;13;Sunnuntai;17;24;41
626;27.08.2017;2017;08;14;Sunnuntai;22;20;42
626;27.08.2017;2017;08;15;Sunnuntai;17;20;37
626;27.08.2017;2017;08;16;Sunnuntai;21;16;37
626;27.08.2017;2017;08;17;Sunnuntai;18;14;32
626;27.08.2017;2017;08;18;Sunnuntai;21;19;40
626;27.08.2017;2017;08;19;Sunnuntai;14;15;29
626;27.08.2017;2017;08;20;Sunnuntai;9;15;24
626;27.08.2017;2017;08;21;Sunnuntai;4;6;10
626;27.08.2017;2017;08;22;Sunnuntai;4;5;9
626;27.08.2017;2017;08;23;Sunnuntai;3;3;6
626;28.08.2017;2017;08;00;Maanantai;2;0;2
626;28.08.2017;2017;08;01;Maanantai;0;1;1
626;28.08.2017;2017;08;02;Maanantai;1;1;2
626;28.08.2017;2017;08;03;Maanantai;0;0;0
626;28.08.2017;2017;08;04;Maanantai;0;3;3
626;28.08.2017;2017;08;05;Maanantai;1;4;5
626;28.08.2017;2017;08;06;Maanantai;4;11;15
626;28.08.2017;2017;08;07;Maanantai;13;40;53
626;28.08.2017;2017;08;08;Maanantai;34;88;122
626;28.08.2017;2017;08;09;Maanantai;20;59;79
626;28.08.2017;2017;08;10;Maanantai;13;27;40
626;28.08.2017;2017;08;11;Maanantai;12;21;33
626;28.08.2017;2017;08;12;Maanantai;9;20;29
626;28.08.2017;2017;08;13;Maanantai;27;28;55
626;28.08.2017;2017;08;14;Maanantai;19;31;50
626;28.08.2017;2017;08;15;Maanantai;28;28;56
626;28.08.2017;2017;08;16;Maanantai;67;38;105
626;28.08.2017;2017;08;17;Maanantai;86;52;138
626;28.08.2017;2017;08;18;Maanantai;51;37;88
626;28.08.2017;2017;08;19;Maanantai;34;20;54
626;28.08.2017;2017;08;20;Maanantai;36;26;62
626;28.08.2017;2017;08;21;Maanantai;18;17;35
626;28.08.2017;2017;08;22;Maanantai;11;9;20
626;28.08.2017;2017;08;23;Maanantai;5;9;14
626;29.08.2017;2017;08;00;Tiistai;1;1;2
626;29.08.2017;2017;08;01;Tiistai;0;0;0
626;29.08.2017;2017;08;02;Tiistai;1;1;2
626;29.08.2017;2017;08;03;Tiistai;0;0;0
626;29.08.2017;2017;08;04;Tiistai;0;1;1
626;29.08.2017;2017;08;05;Tiistai;0;2;2
626;29.08.2017;2017;08;06;Tiistai;4;7;11
626;29.08.2017;2017;08;07;Tiistai;7;35;42
626;29.08.2017;2017;08;08;Tiistai;31;82;113
626;29.08.2017;2017;08;09;Tiistai;16;50;66
626;29.08.2017;2017;08;10;Tiistai;11;20;31
626;29.08.2017;2017;08;11;Tiistai;9;14;23
626;29.08.2017;2017;08;12;Tiistai;17;17;34
626;29.08.2017;2017;08;13;Tiistai;16;22;38
626;29.08.2017;2017;08;14;Tiistai;19;14;33
626;29.08.2017;2017;08;15;Tiistai;24;12;36
626;29.08.2017;2017;08;16;Tiistai;42;21;63
626;29.08.2017;2017;08;17;Tiistai;49;23;72
626;29.08.2017;2017;08;18;Tiistai;27;11;38
626;29.08.2017;2017;08;19;Tiistai;17;8;25
626;29.08.2017;2017;08;20;Tiistai;13;5;18
626;29.08.2017;2017;08;21;Tiistai;10;8;18
626;29.08.2017;2017;08;22;Tiistai;4;4;8
626;29.08.2017;2017;08;23;Tiistai;3;4;7
626;30.08.2017;2017;08;00;Keskiviikko;0;0;0
626;30.08.2017;2017;08;01;Keskiviikko;0;1;1
626;30.08.2017;2017;08;02;Keskiviikko;0;1;1
626;30.08.2017;2017;08;03;Keskiviikko;1;1;2
626;30.08.2017;2017;08;04;Keskiviikko;0;1;1
626;30.08.2017;2017;08;05;Keskiviikko;1;1;2
626;30.08.2017;2017;08;06;Keskiviikko;2;7;9
626;30.08.2017;2017;08;07;Keskiviikko;6;16;22
626;30.08.2017;2017;08;08;Keskiviikko;15;36;51
626;30.08.2017;2017;08;09;Keskiviikko;12;30;42
626;30.08.2017;2017;08;10;Keskiviikko;3;17;20
626;30.08.2017;2017;08;11;Keskiviikko;7;8;15
626;30.08.2017;2017;08;12;Keskiviikko;5;1;6
626;30.08.2017;2017;08;13;Keskiviikko;5;3;8
626;30.08.2017;2017;08;14;Keskiviikko;11;16;27
626;30.08.2017;2017;08;15;Keskiviikko;17;14;31
626;30.08.2017;2017;08;16;Keskiviikko;37;23;60
626;30.08.2017;2017;08;17;Keskiviikko;40;30;70
626;30.08.2017;2017;08;18;Keskiviikko;21;22;43
626;30.08.2017;2017;08;19;Keskiviikko;32;20;52
626;30.08.2017;2017;08;20;Keskiviikko;13;9;22
626;30.08.2017;2017;08;21;Keskiviikko;18;15;33
626;30.08.2017;2017;08;22;Keskiviikko;7;4;11
626;30.08.2017;2017;08;23;Keskiviikko;3;5;8
626;31.08.2017;2017;08;00;Torstai;0;0;0
626;31.08.2017;2017;08;01;Torstai;0;1;1
626;31.08.2017;2017;08;02;Torstai;0;0;0
626;31.08.2017;2017;08;03;Torstai;0;0;0
626;31.08.2017;2017;08;04;Torstai;1;1;2
626;31.08.2017;2017;08;05;Torstai;0;3;3
626;31.08.2017;2017;08;06;Torstai;2;14;16
626;31.08.2017;2017;08;07;Torstai;10;48;58
626;31.08.2017;2017;08;08;Torstai;35;91;126
626;31.08.2017;2017;08;09;Torstai;20;58;78
626;31.08.2017;2017;08;10;Torstai;17;29;46
626;31.08.2017;2017;08;11;Torstai;19;23;42
626;31.08.2017;2017;08;12;Torstai;32;27;59
626;31.08.2017;2017;08;13;Torstai;18;26;44
626;31.08.2017;2017;08;14;Torstai;31;20;51
626;31.08.2017;2017;08;15;Torstai;36;26;62
626;31.08.2017;2017;08;16;Torstai;64;40;104
626;31.08.2017;2017;08;17;Torstai;86;50;136
626;31.08.2017;2017;08;18;Torstai;51;36;87
626;31.08.2017;2017;08;19;Torstai;29;25;54
626;31.08.2017;2017;08;20;Torstai;31;17;48
626;31.08.2017;2017;08;21;Torstai;33;18;51
626;31.08.2017;2017;08;22;Torstai;12;4;16
626;31.08.2017;2017;08;23;Torstai;3;6;9
626;01.09.2017;2017;09;00;Perjantai;4;2;6
626;01.09.2017;2017;09;01;Perjantai;1;2;3
626;01.09.2017;2017;09;02;Perjantai;0;0;0
626;01.09.2017;2017;09;03;Perjantai;0;0;0
626;01.09.2017;2017;09;04;Perjantai;0;0;0
626;01.09.2017;2017;09;05;Perjantai;0;1;1
626;01.09.2017;2017;09;06;Perjantai;5;8;13
626;01.09.2017;2017;09;07;Perjantai;6;14;20
626;01.09.2017;2017;09;08;Perjantai;9;15;24
626;01.09.2017;2017;09;09;Perjantai;5;9;14
626;01.09.2017;2017;09;10;Perjantai;5;9;14
626;01.09.2017;2017;09;11;Perjantai;3;6;9
626;01.09.2017;2017;09;12;Perjantai;5;6;11
626;01.09.2017;2017;09;13;Perjantai;6;10;16
626;01.09.2017;2017;09;14;Perjantai;6;4;10
626;01.09.2017;2017;09;15;Perjantai;8;9;17
626;01.09.2017;2017;09;16;Perjantai;17;8;25
626;01.09.2017;2017;09;17;Perjantai;17;13;30
626;01.09.2017;2017;09;18;Perjantai;13;8;21
626;01.09.2017;2017;09;19;Perjantai;15;5;20
626;01.09.2017;2017;09;20;Perjantai;7;4;11
626;01.09.2017;2017;09;21;Perjantai;7;4;11
626;01.09.2017;2017;09;22;Perjantai;6;4;10
626;01.09.2017;2017;09;23;Perjantai;4;6;10
626;02.09.2017;2017;09;00;Lauantai;0;1;1
626;02.09.2017;2017;09;01;Lauantai;3;2;5
626;02.09.2017;2017;09;02;Lauantai;3;1;4
626;02.09.2017;2017;09;03;Lauantai;1;0;1
626;02.09.2017;2017;09;04;Lauantai;1;1;2
626;02.09.2017;2017;09;05;Lauantai;0;0;0
626;02.09.2017;2017;09;06;Lauantai;2;0;2
626;02.09.2017;2017;09;07;Lauantai;1;4;5
626;02.09.2017;2017;09;08;Lauantai;1;4;5
626;02.09.2017;2017;09;09;Lauantai;10;9;19
626;02.09.2017;2017;09;10;Lauantai;12;18;30
626;02.09.2017;2017;09;11;Lauantai;14;21;35
626;02.09.2017;2017;09;12;Lauantai;25;18;43
626;02.09.2017;2017;09;13;Lauantai;20;36;56
626;02.09.2017;2017;09;14;Lauantai;18;17;35
626;02.09.2017;2017;09;15;Lauantai;35;44;79
626;02.09.2017;2017;09;16;Lauantai;33;27;60
626;02.09.2017;2017;09;17;Lauantai;23;32;55
626;02.09.2017;2017;09;18;Lauantai;25;27;52
626;02.09.2017;2017;09;19;Lauantai;24;23;47
626;02.09.2017;2017;09;20;Lauantai;12;11;23
626;02.09.2017;2017;09;21;Lauantai;8;8;16
626;02.09.2017;2017;09;22;Lauantai;14;6;20
626;02.09.2017;2017;09;23;Lauantai;5;8;13
626;03.09.2017;2017;09;00;Sunnuntai;5;3;8
626;03.09.2017;2017;09;01;Sunnuntai;4;0;4
626;03.09.2017;2017;09;02;Sunnuntai;3;1;4
626;03.09.2017;2017;09;03;Sunnuntai;2;1;3
626;03.09.2017;2017;09;04;Sunnuntai;2;0;2
626;03.09.2017;2017;09;05;Sunnuntai;2;1;3
626;03.09.2017;2017;09;06;Sunnuntai;1;2;3
626;03.09.2017;2017;09;07;Sunnuntai;1;3;4
626;03.09.2017;2017;09;08;Sunnuntai;2;1;3
626;03.09.2017;2017;09;09;Sunnuntai;5;4;9
626;03.09.2017;2017;09;10;Sunnuntai;6;10;16
626;03.09.2017;2017;09;11;Sunnuntai;19;17;36
626;03.09.2017;2017;09;12;Sunnuntai;22;24;46
626;03.09.2017;2017;09;13;Sunnuntai;25;25;50
626;03.09.2017;2017;09;14;Sunnuntai;40;45;85
626;03.09.2017;2017;09;15;Sunnuntai;20;35;55
626;03.09.2017;2017;09;16;Sunnuntai;30;32;62
626;03.09.2017;2017;09;17;Sunnuntai;26;33;59
626;03.09.2017;2017;09;18;Sunnuntai;26;28;54
626;03.09.2017;2017;09;19;Sunnuntai;20;23;43
626;03.09.2017;2017;09;20;Sunnuntai;18;18;36
626;03.09.2017;2017;09;21;Sunnuntai;15;9;24
626;03.09.2017;2017;09;22;Sunnuntai;4;4;8
626;03.09.2017;2017;09;23;Sunnuntai;5;3;8
626;04.09.2017;2017;09;00;Maanantai;0;3;3
626;04.09.2017;2017;09;01;Maanantai;1;0;1
626;04.09.2017;2017;09;02;Maanantai;0;0;0
626;04.09.2017;2017;09;03;Maanantai;0;1;1
626;04.09.2017;2017;09;04;Maanantai;3;1;4
626;04.09.2017;2017;09;05;Maanantai;0;3;3
626;04.09.2017;2017;09;06;Maanantai;5;14;19
626;04.09.2017;2017;09;07;Maanantai;11;55;66
626;04.09.2017;2017;09;08;Maanantai;23;69;92
626;04.09.2017;2017;09;09;Maanantai;28;56;84
626;04.09.2017;2017;09;10;Maanantai;19;27;46
626;04.09.2017;2017;09;11;Maanantai;18;26;44
626;04.09.2017;2017;09;12;Maanantai;17;24;41
626;04.09.2017;2017;09;13;Maanantai;22;31;53
626;04.09.2017;2017;09;14;Maanantai;27;25;52
626;04.09.2017;2017;09;15;Maanantai;33;25;58
626;04.09.2017;2017;09;16;Maanantai;40;41;81
626;04.09.2017;2017;09;17;Maanantai;74;58;132
626;04.09.2017;2017;09;18;Maanantai;48;35;83
626;04.09.2017;2017;09;19;Maanantai;40;30;70
626;04.09.2017;2017;09;20;Maanantai;30;18;48
626;04.09.2017;2017;09;21;Maanantai;18;17;35
626;04.09.2017;2017;09;22;Maanantai;10;15;25
626;04.09.2017;2017;09;23;Maanantai;7;1;8
626;05.09.2017;2017;09;00;Tiistai;1;1;2
626;05.09.2017;2017;09;01;Tiistai;0;0;0
626;05.09.2017;2017;09;02;Tiistai;1;1;2
626;05.09.2017;2017;09;03;Tiistai;0;0;0
626;05.09.2017;2017;09;04;Tiistai;0;2;2
626;05.09.2017;2017;09;05;Tiistai;0;1;1
626;05.09.2017;2017;09;06;Tiistai;6;18;24
626;05.09.2017;2017;09;07;Tiistai;11;48;59
626;05.09.2017;2017;09;08;Tiistai;21;93;114
626;05.09.2017;2017;09;09;Tiistai;25;45;70
626;05.09.2017;2017;09;10;Tiistai;15;22;37
626;05.09.2017;2017;09;11;Tiistai;18;19;37
626;05.09.2017;2017;09;12;Tiistai;15;29;44
626;05.09.2017;2017;09;13;Tiistai;26;24;50
626;05.09.2017;2017;09;14;Tiistai;23;26;49
626;05.09.2017;2017;09;15;Tiistai;35;31;66
626;05.09.2017;2017;09;16;Tiistai;57;36;93
626;05.09.2017;2017;09;17;Tiistai;106;67;173
626;05.09.2017;2017;09;18;Tiistai;52;39;91
626;05.09.2017;2017;09;19;Tiistai;30;31;61
626;05.09.2017;2017;09;20;Tiistai;32;31;63
626;05.09.2017;2017;09;21;Tiistai;25;9;34
626;05.09.2017;2017;09;22;Tiistai;13;8;21
626;05.09.2017;2017;09;23;Tiistai;9;3;12
626;06.09.2017;2017;09;00;Keskiviikko;0;2;2
626;06.09.2017;2017;09;01;Keskiviikko;0;0;0
626;06.09.2017;2017;09;02;Keskiviikko;0;0;0
626;06.09.2017;2017;09;03;Keskiviikko;1;1;2
626;06.09.2017;2017;09;04;Keskiviikko;0;2;2
626;06.09.2017;2017;09;05;Keskiviikko;2;1;3
626;06.09.2017;2017;09;06;Keskiviikko;5;16;21
626;06.09.2017;2017;09;07;Keskiviikko;12;50;62
626;06.09.2017;2017;09;08;Keskiviikko;33;85;118
626;06.09.2017;2017;09;09;Keskiviikko;22;38;60
626;06.09.2017;2017;09;10;Keskiviikko;16;29;45
626;06.09.2017;2017;09;11;Keskiviikko;15;18;33
626;06.09.2017;2017;09;12;Keskiviikko;24;27;51
626;06.09.2017;2017;09;13;Keskiviikko;25;19;44
626;06.09.2017;2017;09;14;Keskiviikko;32;32;64
626;06.09.2017;2017;09;15;Keskiviikko;46;37;83
626;06.09.2017;2017;09;16;Keskiviikko;71;44;115
626;06.09.2017;2017;09;17;Keskiviikko;102;72;174
626;06.09.2017;2017;09;18;Keskiviikko;47;48;95
626;06.09.2017;2017;09;19;Keskiviikko;38;23;61
626;06.09.2017;2017;09;20;Keskiviikko;35;29;64
626;06.09.2017;2017;09;21;Keskiviikko;13;14;27
626;06.09.2017;2017;09;22;Keskiviikko;14;5;19
626;06.09.2017;2017;09;23;Keskiviikko;8;2;10
626;07.09.2017;2017;09;00;Torstai;3;2;5
626;07.09.2017;2017;09;01;Torstai;0;0;0
626;07.09.2017;2017;09;02;Torstai;1;0;1
626;07.09.2017;2017;09;03;Torstai;1;0;1
626;07.09.2017;2017;09;04;Torstai;2;0;2
626;07.09.2017;2017;09;05;Torstai;0;3;3
626;07.09.2017;2017;09;06;Torstai;5;9;14
626;07.09.2017;2017;09;07;Torstai;11;42;53
626;07.09.2017;2017;09;08;Torstai;33;81;114
626;07.09.2017;2017;09;09;Torstai;15;46;61
626;07.09.2017;2017;09;10;Torstai;17;20;37
626;07.09.2017;2017;09;11;Torstai;5;16;21
626;07.09.2017;2017;09;12;Torstai;9;9;18
626;07.09.2017;2017;09;13;Torstai;16;10;26
626;07.09.2017;2017;09;14;Torstai;23;15;38
626;07.09.2017;2017;09;15;Torstai;25;13;38
626;07.09.2017;2017;09;16;Torstai;51;40;91
626;07.09.2017;2017;09;17;Torstai;73;52;125
626;07.09.2017;2017;09;18;Torstai;27;26;53
626;07.09.2017;2017;09;19;Torstai;28;15;43
626;07.09.2017;2017;09;20;Torstai;29;6;35
626;07.09.2017;2017;09;21;Torstai;13;6;19
626;07.09.2017;2017;09;22;Torstai;6;6;12
626;07.09.2017;2017;09;23;Torstai;2;3;5
626;08.09.2017;2017;09;00;Perjantai;1;1;2
626;08.09.2017;2017;09;01;Perjantai;0;0;0
626;08.09.2017;2017;09;02;Perjantai;1;1;2
626;08.09.2017;2017;09;03;Perjantai;1;0;1
626;08.09.2017;2017;09;04;Perjantai;2;1;3
626;08.09.2017;2017;09;05;Perjantai;0;0;0
626;08.09.2017;2017;09;06;Perjantai;5;9;14
626;08.09.2017;2017;09;07;Perjantai;4;13;17
626;08.09.2017;2017;09;08;Perjantai;13;25;38
626;08.09.2017;2017;09;09;Perjantai;9;21;30
626;08.09.2017;2017;09;10;Perjantai;7;9;16
626;08.09.2017;2017;09;11;Perjantai;8;10;18
626;08.09.2017;2017;09;12;Perjantai;6;10;16
626;08.09.2017;2017;09;13;Perjantai;11;13;24
626;08.09.2017;2017;09;14;Perjantai;12;15;27
626;08.09.2017;2017;09;15;Perjantai;16;10;26
626;08.09.2017;2017;09;16;Perjantai;23;14;37
626;08.09.2017;2017;09;17;Perjantai;36;17;53
626;08.09.2017;2017;09;18;Perjantai;14;14;28
626;08.09.2017;2017;09;19;Perjantai;12;12;24
626;08.09.2017;2017;09;20;Perjantai;7;5;12
626;08.09.2017;2017;09;21;Perjantai;11;5;16
626;08.09.2017;2017;09;22;Perjantai;5;5;10
626;08.09.2017;2017;09;23;Perjantai;1;5;6
626;09.09.2017;2017;09;00;Lauantai;2;4;6
626;09.09.2017;2017;09;01;Lauantai;0;1;1
626;09.09.2017;2017;09;02;Lauantai;1;0;1
626;09.09.2017;2017;09;03;Lauantai;0;0;0
626;09.09.2017;2017;09;04;Lauantai;2;0;2
626;09.09.2017;2017;09;05;Lauantai;0;0;0
626;09.09.2017;2017;09;06;Lauantai;2;2;4
626;09.09.2017;2017;09;07;Lauantai;1;1;2
626;09.09.2017;2017;09;08;Lauantai;1;3;4
626;09.09.2017;2017;09;09;Lauantai;8;5;13
626;09.09.2017;2017;09;10;Lauantai;8;8;16
626;09.09.2017;2017;09;11;Lauantai;7;3;10
626;09.09.2017;2017;09;12;Lauantai;9;20;29
626;09.09.2017;2017;09;13;Lauantai;17;8;25
626;09.09.2017;2017;09;14;Lauantai;12;16;28
626;09.09.2017;2017;09;15;Lauantai;13;12;25
626;09.09.2017;2017;09;16;Lauantai;19;21;40
626;09.09.2017;2017;09;17;Lauantai;11;14;25
626;09.09.2017;2017;09;18;Lauantai;14;13;27
626;09.09.2017;2017;09;19;Lauantai;11;11;22
626;09.09.2017;2017;09;20;Lauantai;11;4;15
626;09.09.2017;2017;09;21;Lauantai;7;6;13
626;09.09.2017;2017;09;22;Lauantai;12;8;20
626;09.09.2017;2017;09;23;Lauantai;1;2;3
626;10.09.2017;2017;09;00;Sunnuntai;0;5;5
626;10.09.2017;2017;09;01;Sunnuntai;3;0;3
626;10.09.2017;2017;09;02;Sunnuntai;0;1;1
626;10.09.2017;2017;09;03;Sunnuntai;1;1;2
626;10.09.2017;2017;09;04;Sunnuntai;3;1;4
626;10.09.2017;2017;09;05;Sunnuntai;1;1;2
626;10.09.2017;2017;09;06;Sunnuntai;0;2;2
626;10.09.2017;2017;09;07;Sunnuntai;1;2;3
626;10.09.2017;2017;09;08;Sunnuntai;1;4;5
626;10.09.2017;2017;09;09;Sunnuntai;3;2;5
626;10.09.2017;2017;09;10;Sunnuntai;1;1;2
626;10.09.2017;2017;09;11;Sunnuntai;3;1;4
626;10.09.2017;2017;09;12;Sunnuntai;3;1;4
626;10.09.2017;2017;09;13;Sunnuntai;0;1;1
626;10.09.2017;2017;09;14;Sunnuntai;1;5;6
626;10.09.2017;2017;09;15;Sunnuntai;3;2;5
626;10.09.2017;2017;09;16;Sunnuntai;2;3;5
626;10.09.2017;2017;09;17;Sunnuntai;4;0;4
626;10.09.2017;2017;09;18;Sunnuntai;2;5;7
626;10.09.2017;2017;09;19;Sunnuntai;4;4;8
626;10.09.2017;2017;09;20;Sunnuntai;0;5;5
626;10.09.2017;2017;09;21;Sunnuntai;3;4;7
626;10.09.2017;2017;09;22;Sunnuntai;1;1;2
626;10.09.2017;2017;09;23;Sunnuntai;2;2;4
626;11.09.2017;2017;09;00;Maanantai;0;1;1
626;11.09.2017;2017;09;01;Maanantai;0;0;0
626;11.09.2017;2017;09;02;Maanantai;0;0;0
626;11.09.2017;2017;09;03;Maanantai;0;1;1
626;11.09.2017;2017;09;04;Maanantai;0;0;0
626;11.09.2017;2017;09;05;Maanantai;0;3;3
626;11.09.2017;2017;09;06;Maanantai;5;7;12
626;11.09.2017;2017;09;07;Maanantai;8;37;45
626;11.09.2017;2017;09;08;Maanantai;23;82;105
626;11.09.2017;2017;09;09;Maanantai;22;52;74
626;11.09.2017;2017;09;10;Maanantai;13;35;48
626;11.09.2017;2017;09;11;Maanantai;18;29;47
626;11.09.2017;2017;09;12;Maanantai;15;18;33
626;11.09.2017;2017;09;13;Maanantai;9;22;31
626;11.09.2017;2017;09;14;Maanantai;20;24;44
626;11.09.2017;2017;09;15;Maanantai;31;20;51
626;11.09.2017;2017;09;16;Maanantai;58;31;89
626;11.09.2017;2017;09;17;Maanantai;76;42;118
626;11.09.2017;2017;09;18;Maanantai;48;35;83
626;11.09.2017;2017;09;19;Maanantai;38;17;55
626;11.09.2017;2017;09;20;Maanantai;27;21;48
626;11.09.2017;2017;09;21;Maanantai;12;8;20
626;11.09.2017;2017;09;22;Maanantai;6;10;16
626;11.09.2017;2017;09;23;Maanantai;8;4;12
626;12.09.2017;2017;09;00;Tiistai;0;3;3
626;12.09.2017;2017;09;01;Tiistai;0;2;2
626;12.09.2017;2017;09;02;Tiistai;0;1;1
626;12.09.2017;2017;09;03;Tiistai;0;0;0
626;12.09.2017;2017;09;04;Tiistai;1;1;2
626;12.09.2017;2017;09;05;Tiistai;0;3;3
626;12.09.2017;2017;09;06;Tiistai;6;9;15
626;12.09.2017;2017;09;07;Tiistai;7;46;53
626;12.09.2017;2017;09;08;Tiistai;17;57;74
626;12.09.2017;2017;09;09;Tiistai;23;51;74
626;12.09.2017;2017;09;10;Tiistai;9;28;37
626;12.09.2017;2017;09;11;Tiistai;18;19;37
626;12.09.2017;2017;09;12;Tiistai;12;18;30
626;12.09.2017;2017;09;13;Tiistai;17;20;37
626;12.09.2017;2017;09;14;Tiistai;20;19;39
626;12.09.2017;2017;09;15;Tiistai;22;11;33
626;12.09.2017;2017;09;16;Tiistai;27;12;39
626;12.09.2017;2017;09;17;Tiistai;38;15;53
626;12.09.2017;2017;09;18;Tiistai;21;6;27
626;12.09.2017;2017;09;19;Tiistai;12;1;13
626;12.09.2017;2017;09;20;Tiistai;13;3;16
626;12.09.2017;2017;09;21;Tiistai;6;4;10
626;12.09.2017;2017;09;22;Tiistai;5;2;7
626;12.09.2017;2017;09;23;Tiistai;6;1;7
626;13.09.2017;2017;09;00;Keskiviikko;0;1;1
626;13.09.2017;2017;09;01;Keskiviikko;0;1;1
626;13.09.2017;2017;09;02;Keskiviikko;0;0;0
626;13.09.2017;2017;09;03;Keskiviikko;0;0;0
626;13.09.2017;2017;09;04;Keskiviikko;0;1;1
626;13.09.2017;2017;09;05;Keskiviikko;0;3;3
626;13.09.2017;2017;09;06;Keskiviikko;4;3;7
626;13.09.2017;2017;09;07;Keskiviikko;11;25;36
626;13.09.2017;2017;09;08;Keskiviikko;17;54;71
626;13.09.2017;2017;09;09;Keskiviikko;13;32;45
626;13.09.2017;2017;09;10;Keskiviikko;8;18;26
626;13.09.2017;2017;09;11;Keskiviikko;7;12;19
626;13.09.2017;2017;09;12;Keskiviikko;6;7;13
626;13.09.2017;2017;09;13;Keskiviikko;8;9;17
626;13.09.2017;2017;09;14;Keskiviikko;21;12;33
626;13.09.2017;2017;09;15;Keskiviikko;18;15;33
626;13.09.2017;2017;09;16;Keskiviikko;37;25;62
626;13.09.2017;2017;09;17;Keskiviikko;45;34;79
626;13.09.2017;2017;09;18;Keskiviikko;23;23;46
626;13.09.2017;2017;09;19;Keskiviikko;28;8;36
626;13.09.2017;2017;09;20;Keskiviikko;19;12;31
626;13.09.2017;2017;09;21;Keskiviikko;12;7;19
626;13.09.2017;2017;09;22;Keskiviikko;7;5;12
626;13.09.2017;2017;09;23;Keskiviikko;5;2;7
626;14.09.2017;2017;09;00;Torstai;1;2;3
626;14.09.2017;2017;09;01;Torstai;0;0;0
626;14.09.2017;2017;09;02;Torstai;0;1;1
626;14.09.2017;2017;09;03;Torstai;0;0;0
626;14.09.2017;2017;09;04;Torstai;0;1;1
626;14.09.2017;2017;09;05;Torstai;0;4;4
626;14.09.2017;2017;09;06;Torstai;4;9;13
626;14.09.2017;2017;09;07;Torstai;9;35;44
626;14.09.2017;2017;09;08;Torstai;24;64;88
626;14.09.2017;2017;09;09;Torstai;15;47;62
626;14.09.2017;2017;09;10;Torstai;9;20;29
626;14.09.2017;2017;09;11;Torstai;11;10;21
626;14.09.2017;2017;09;12;Torstai;16;5;21
626;14.09.2017;2017;09;13;Torstai;14;19;33
626;14.09.2017;2017;09;14;Torstai;18;7;25
626;14.09.2017;2017;09;15;Torstai;23;14;37
626;14.09.2017;2017;09;16;Torstai;48;22;70
626;14.09.2017;2017;09;17;Torstai;63;50;113
626;14.09.2017;2017;09;18;Torstai;30;30;60
626;14.09.2017;2017;09;19;Torstai;36;23;59
626;14.09.2017;2017;09;20;Torstai;21;13;34
626;14.09.2017;2017;09;21;Torstai;8;7;15
626;14.09.2017;2017;09;22;Torstai;6;9;15
626;14.09.2017;2017;09;23;Torstai;5;2;7
626;15.09.2017;2017;09;00;Perjantai;1;1;2
626;15.09.2017;2017;09;01;Perjantai;3;1;4
626;15.09.2017;2017;09;02;Perjantai;1;0;1
626;15.09.2017;2017;09;03;Perjantai;1;0;1
626;15.09.2017;2017;09;04;Perjantai;1;1;2
626;15.09.2017;2017;09;05;Perjantai;0;2;2
626;15.09.2017;2017;09;06;Perjantai;3;9;12
626;15.09.2017;2017;09;07;Perjantai;6;28;34
626;15.09.2017;2017;09;08;Perjantai;17;49;66
626;15.09.2017;2017;09;09;Perjantai;5;26;31
626;15.09.2017;2017;09;10;Perjantai;10;20;30
626;15.09.2017;2017;09;11;Perjantai;9;13;22
626;15.09.2017;2017;09;12;Perjantai;38;53;91
626;15.09.2017;2017;09;13;Perjantai;5;7;12
626;15.09.2017;2017;09;14;Perjantai;35;18;53
626;15.09.2017;2017;09;15;Perjantai;18;11;29
626;15.09.2017;2017;09;16;Perjantai;38;16;54
626;15.09.2017;2017;09;17;Perjantai;39;19;58
626;15.09.2017;2017;09;18;Perjantai;16;11;27
626;15.09.2017;2017;09;19;Perjantai;14;7;21
626;15.09.2017;2017;09;20;Perjantai;9;6;15
626;15.09.2017;2017;09;21;Perjantai;10;5;15
626;15.09.2017;2017;09;22;Perjantai;10;5;15
626;15.09.2017;2017;09;23;Perjantai;5;2;7
626;16.09.2017;2017;09;00;Lauantai;3;2;5
626;16.09.2017;2017;09;01;Lauantai;1;0;1
626;16.09.2017;2017;09;02;Lauantai;0;0;0
626;16.09.2017;2017;09;03;Lauantai;1;0;1
626;16.09.2017;2017;09;04;Lauantai;2;0;2
626;16.09.2017;2017;09;05;Lauantai;1;1;2
626;16.09.2017;2017;09;06;Lauantai;0;1;1
626;16.09.2017;2017;09;07;Lauantai;0;4;4
626;16.09.2017;2017;09;08;Lauantai;2;5;7
626;16.09.2017;2017;09;09;Lauantai;3;8;11
626;16.09.2017;2017;09;10;Lauantai;6;14;20
626;16.09.2017;2017;09;11;Lauantai;6;5;11
626;16.09.2017;2017;09;12;Lauantai;14;7;21
626;16.09.2017;2017;09;13;Lauantai;12;24;36
626;16.09.2017;2017;09;14;Lauantai;9;11;20
626;16.09.2017;2017;09;15;Lauantai;11;8;19
626;16.09.2017;2017;09;16;Lauantai;17;14;31
626;16.09.2017;2017;09;17;Lauantai;15;14;29
626;16.09.2017;2017;09;18;Lauantai;10;11;21
626;16.09.2017;2017;09;19;Lauantai;15;6;21
626;16.09.2017;2017;09;20;Lauantai;5;4;9
626;16.09.2017;2017;09;21;Lauantai;4;4;8
626;16.09.2017;2017;09;22;Lauantai;3;5;8
626;16.09.2017;2017;09;23;Lauantai;1;2;3
626;17.09.2017;2017;09;00;Sunnuntai;4;1;5
626;17.09.2017;2017;09;01;Sunnuntai;0;2;2
626;17.09.2017;2017;09;02;Sunnuntai;2;2;4
626;17.09.2017;2017;09;03;Sunnuntai;2;0;2
626;17.09.2017;2017;09;04;Sunnuntai;0;0;0
626;17.09.2017;2017;09;05;Sunnuntai;2;0;2
626;17.09.2017;2017;09;06;Sunnuntai;1;0;1
626;17.09.2017;2017;09;07;Sunnuntai;0;0;0
626;17.09.2017;2017;09;08;Sunnuntai;2;3;5
626;17.09.2017;2017;09;09;Sunnuntai;2;1;3
626;17.09.2017;2017;09;10;Sunnuntai;5;6;11
626;17.09.2017;2017;09;11;Sunnuntai;6;7;13
626;17.09.2017;2017;09;12;Sunnuntai;10;10;20
626;17.09.2017;2017;09;13;Sunnuntai;12;16;28
626;17.09.2017;2017;09;14;Sunnuntai;15;20;35
626;17.09.2017;2017;09;15;Sunnuntai;24;16;40
626;17.09.2017;2017;09;16;Sunnuntai;6;18;24
626;17.09.2017;2017;09;17;Sunnuntai;12;11;23
626;17.09.2017;2017;09;18;Sunnuntai;13;9;22
626;17.09.2017;2017;09;19;Sunnuntai;10;18;28
626;17.09.2017;2017;09;20;Sunnuntai;12;8;20
626;17.09.2017;2017;09;21;Sunnuntai;9;4;13
626;17.09.2017;2017;09;22;Sunnuntai;5;3;8
626;17.09.2017;2017;09;23;Sunnuntai;0;0;0
626;18.09.2017;2017;09;00;Maanantai;1;0;1
626;18.09.2017;2017;09;01;Maanantai;0;0;0
626;18.09.2017;2017;09;02;Maanantai;1;1;2
626;18.09.2017;2017;09;03;Maanantai;0;0;0
626;18.09.2017;2017;09;04;Maanantai;0;2;2
626;18.09.2017;2017;09;05;Maanantai;0;3;3
626;18.09.2017;2017;09;06;Maanantai;6;8;14
626;18.09.2017;2017;09;07;Maanantai;8;33;41
626;18.09.2017;2017;09;08;Maanantai;13;62;75
626;18.09.2017;2017;09;09;Maanantai;22;25;47
626;18.09.2017;2017;09;10;Maanantai;9;19;28
626;18.09.2017;2017;09;11;Maanantai;12;7;19
626;18.09.2017;2017;09;12;Maanantai;7;10;17
626;18.09.2017;2017;09;13;Maanantai;7;10;17
626;18.09.2017;2017;09;14;Maanantai;9;15;24
626;18.09.2017;2017;09;15;Maanantai;17;11;28
626;18.09.2017;2017;09;16;Maanantai;40;25;65
626;18.09.2017;2017;09;17;Maanantai;56;28;84
626;18.09.2017;2017;09;18;Maanantai;27;24;51
626;18.09.2017;2017;09;19;Maanantai;14;13;27
626;18.09.2017;2017;09;20;Maanantai;15;11;26
626;18.09.2017;2017;09;21;Maanantai;14;5;19
626;18.09.2017;2017;09;22;Maanantai;4;9;13
626;18.09.2017;2017;09;23;Maanantai;2;2;4
626;19.09.2017;2017;09;00;Tiistai;0;0;0
626;19.09.2017;2017;09;01;Tiistai;2;0;2
626;19.09.2017;2017;09;02;Tiistai;0;0;0
626;19.09.2017;2017;09;03;Tiistai;0;0;0
626;19.09.2017;2017;09;04;Tiistai;0;2;2
626;19.09.2017;2017;09;05;Tiistai;0;4;4
626;19.09.2017;2017;09;06;Tiistai;4;8;12
626;19.09.2017;2017;09;07;Tiistai;6;26;32
626;19.09.2017;2017;09;08;Tiistai;19;58;77
626;19.09.2017;2017;09;09;Tiistai;18;30;48
626;19.09.2017;2017;09;10;Tiistai;5;15;20
626;19.09.2017;2017;09;11;Tiistai;4;7;11
626;19.09.2017;2017;09;12;Tiistai;5;3;8
626;19.09.2017;2017;09;13;Tiistai;6;5;11
626;19.09.2017;2017;09;14;Tiistai;7;3;10
626;19.09.2017;2017;09;15;Tiistai;17;12;29
626;19.09.2017;2017;09;16;Tiistai;30;15;45
626;19.09.2017;2017;09;17;Tiistai;48;23;71
626;19.09.2017;2017;09;18;Tiistai;28;18;46
626;19.09.2017;2017;09;19;Tiistai;15;17;32
626;19.09.2017;2017;09;20;Tiistai;18;9;27
626;19.09.2017;2017;09;21;Tiistai;10;5;15
626;19.09.2017;2017;09;22;Tiistai;0;4;4
626;19.09.2017;2017;09;23;Tiistai;3;2;5
626;20.09.2017;2017;09;00;Keskiviikko;0;0;0
626;20.09.2017;2017;09;01;Keskiviikko;0;1;1
626;20.09.2017;2017;09;02;Keskiviikko;0;0;0
626;20.09.2017;2017;09;03;Keskiviikko;0;1;1
626;20.09.2017;2017;09;04;Keskiviikko;0;0;0
626;20.09.2017;2017;09;05;Keskiviikko;0;3;3
626;20.09.2017;2017;09;06;Keskiviikko;4;9;13
626;20.09.2017;2017;09;07;Keskiviikko;5;33;38
626;20.09.2017;2017;09;08;Keskiviikko;16;65;81
626;20.09.2017;2017;09;09;Keskiviikko;17;27;44
626;20.09.2017;2017;09;10;Keskiviikko;8;21;29
626;20.09.2017;2017;09;11;Keskiviikko;9;14;23
626;20.09.2017;2017;09;12;Keskiviikko;16;12;28
626;20.09.2017;2017;09;13;Keskiviikko;15;13;28
626;20.09.2017;2017;09;14;Keskiviikko;16;15;31
626;20.09.2017;2017;09;15;Keskiviikko;24;11;35
626;20.09.2017;2017;09;16;Keskiviikko;47;27;74
626;20.09.2017;2017;09;17;Keskiviikko;56;32;88
626;20.09.2017;2017;09;18;Keskiviikko;29;21;50
626;20.09.2017;2017;09;19;Keskiviikko;30;14;44
626;20.09.2017;2017;09;20;Keskiviikko;12;6;18
626;20.09.2017;2017;09;21;Keskiviikko;15;7;22
626;20.09.2017;2017;09;22;Keskiviikko;7;5;12
626;20.09.2017;2017;09;23;Keskiviikko;6;3;9
626;21.09.2017;2017;09;00;Torstai;1;0;1
626;21.09.2017;2017;09;01;Torstai;0;0;0
626;21.09.2017;2017;09;02;Torstai;0;1;1
626;21.09.2017;2017;09;03;Torstai;1;0;1
626;21.09.2017;2017;09;04;Torstai;0;0;0
626;21.09.2017;2017;09;05;Torstai;0;4;4
626;21.09.2017;2017;09;06;Torstai;3;6;9
626;21.09.2017;2017;09;07;Torstai;9;31;40
626;21.09.2017;2017;09;08;Torstai;18;64;82
626;21.09.2017;2017;09;09;Torstai;20;39;59
626;21.09.2017;2017;09;10;Torstai;8;17;25
626;21.09.2017;2017;09;11;Torstai;9;15;24
626;21.09.2017;2017;09;12;Torstai;14;11;25
626;21.09.2017;2017;09;13;Torstai;14;19;33
626;21.09.2017;2017;09;14;Torstai;17;13;30
626;21.09.2017;2017;09;15;Torstai;16;20;36
626;21.09.2017;2017;09;16;Torstai;41;21;62
626;21.09.2017;2017;09;17;Torstai;63;27;90
626;21.09.2017;2017;09;18;Torstai;30;30;60
626;21.09.2017;2017;09;19;Torstai;22;10;32
626;21.09.2017;2017;09;20;Torstai;18;12;30
626;21.09.2017;2017;09;21;Torstai;14;5;19
626;21.09.2017;2017;09;22;Torstai;5;5;10
626;21.09.2017;2017;09;23;Torstai;5;3;8
626;22.09.2017;2017;09;00;Perjantai;0;0;0
626;22.09.2017;2017;09;01;Perjantai;1;1;2
626;22.09.2017;2017;09;02;Perjantai;0;0;0
626;22.09.2017;2017;09;03;Perjantai;0;0;0
626;22.09.2017;2017;09;04;Perjantai;0;1;1
626;22.09.2017;2017;09;05;Perjantai;0;2;2
626;22.09.2017;2017;09;06;Perjantai;3;9;12
626;22.09.2017;2017;09;07;Perjantai;7;28;35
626;22.09.2017;2017;09;08;Perjantai;12;53;65
626;22.09.2017;2017;09;09;Perjantai;17;28;45
626;22.09.2017;2017;09;10;Perjantai;6;14;20
626;22.09.2017;2017;09;11;Perjantai;11;13;24
626;22.09.2017;2017;09;12;Perjantai;8;7;15
626;22.09.2017;2017;09;13;Perjantai;17;14;31
626;22.09.2017;2017;09;14;Perjantai;21;20;41
626;22.09.2017;2017;09;15;Perjantai;33;30;63
626;22.09.2017;2017;09;16;Perjantai;46;39;85
626;22.09.2017;2017;09;17;Perjantai;55;39;94
626;22.09.2017;2017;09;18;Perjantai;27;26;53
626;22.09.2017;2017;09;19;Perjantai;22;14;36
626;22.09.2017;2017;09;20;Perjantai;20;15;35
626;22.09.2017;2017;09;21;Perjantai;9;6;15
626;22.09.2017;2017;09;22;Perjantai;7;4;11
626;22.09.2017;2017;09;23;Perjantai;3;3;6
626;23.09.2017;2017;09;00;Lauantai;1;0;1
626;23.09.2017;2017;09;01;Lauantai;1;1;2
626;23.09.2017;2017;09;02;Lauantai;3;2;5
626;23.09.2017;2017;09;03;Lauantai;1;2;3
626;23.09.2017;2017;09;04;Lauantai;3;0;3
626;23.09.2017;2017;09;05;Lauantai;2;0;2
626;23.09.2017;2017;09;06;Lauantai;0;3;3
626;23.09.2017;2017;09;07;Lauantai;0;1;1
626;23.09.2017;2017;09;08;Lauantai;2;4;6
626;23.09.2017;2017;09;09;Lauantai;4;5;9
626;23.09.2017;2017;09;10;Lauantai;5;11;16
626;23.09.2017;2017;09;11;Lauantai;10;14;24
626;23.09.2017;2017;09;12;Lauantai;14;8;22
626;23.09.2017;2017;09;13;Lauantai;9;13;22
626;23.09.2017;2017;09;14;Lauantai;20;16;36
626;23.09.2017;2017;09;15;Lauantai;11;22;33
626;23.09.2017;2017;09;16;Lauantai;9;13;22
626;23.09.2017;2017;09;17;Lauantai;18;14;32
626;23.09.2017;2017;09;18;Lauantai;12;19;31
626;23.09.2017;2017;09;19;Lauantai;11;14;25
626;23.09.2017;2017;09;20;Lauantai;3;7;10
626;23.09.2017;2017;09;21;Lauantai;11;4;15
626;23.09.2017;2017;09;22;Lauantai;2;5;7
626;23.09.2017;2017;09;23;Lauantai;2;3;5
626;24.09.2017;2017;09;00;Sunnuntai;0;0;0
626;24.09.2017;2017;09;01;Sunnuntai;1;2;3
626;24.09.2017;2017;09;02;Sunnuntai;2;1;3
626;24.09.2017;2017;09;03;Sunnuntai;1;0;1
626;24.09.2017;2017;09;04;Sunnuntai;0;0;0
626;24.09.2017;2017;09;05;Sunnuntai;2;0;2
626;24.09.2017;2017;09;06;Sunnuntai;0;2;2
626;24.09.2017;2017;09;07;Sunnuntai;1;1;2
626;24.09.2017;2017;09;08;Sunnuntai;1;1;2
626;24.09.2017;2017;09;09;Sunnuntai;0;5;5
626;24.09.2017;2017;09;10;Sunnuntai;3;4;7
626;24.09.2017;2017;09;11;Sunnuntai;4;7;11
626;24.09.2017;2017;09;12;Sunnuntai;8;15;23
626;24.09.2017;2017;09;13;Sunnuntai;14;20;34
626;24.09.2017;2017;09;14;Sunnuntai;17;13;30
626;24.09.2017;2017;09;15;Sunnuntai;19;11;30
626;24.09.2017;2017;09;16;Sunnuntai;16;10;26
626;24.09.2017;2017;09;17;Sunnuntai;10;18;28
626;24.09.2017;2017;09;18;Sunnuntai;9;11;20
626;24.09.2017;2017;09;19;Sunnuntai;13;13;26
626;24.09.2017;2017;09;20;Sunnuntai;4;11;15
626;24.09.2017;2017;09;21;Sunnuntai;8;5;13
626;24.09.2017;2017;09;22;Sunnuntai;6;3;9
626;24.09.2017;2017;09;23;Sunnuntai;2;1;3
626;25.09.2017;2017;09;00;Maanantai;1;0;1
626;25.09.2017;2017;09;01;Maanantai;0;0;0
626;25.09.2017;2017;09;02;Maanantai;0;0;0
626;25.09.2017;2017;09;03;Maanantai;1;1;2
626;25.09.2017;2017;09;04;Maanantai;0;0;0
626;25.09.2017;2017;09;05;Maanantai;2;6;8
626;25.09.2017;2017;09;06;Maanantai;3;8;11
626;25.09.2017;2017;09;07;Maanantai;9;26;35
626;25.09.2017;2017;09;08;Maanantai;14;70;84
626;25.09.2017;2017;09;09;Maanantai;18;44;62
626;25.09.2017;2017;09;10;Maanantai;18;24;42
626;25.09.2017;2017;09;11;Maanantai;10;22;32
626;25.09.2017;2017;09;12;Maanantai;9;9;18
626;25.09.2017;2017;09;13;Maanantai;13;9;22
626;25.09.2017;2017;09;14;Maanantai;24;9;33
626;25.09.2017;2017;09;15;Maanantai;30;22;52
626;25.09.2017;2017;09;16;Maanantai;40;33;73
626;25.09.2017;2017;09;17;Maanantai;68;38;106
626;25.09.2017;2017;09;18;Maanantai;48;29;77
626;25.09.2017;2017;09;19;Maanantai;36;21;57
626;25.09.2017;2017;09;20;Maanantai;21;19;40
626;25.09.2017;2017;09;21;Maanantai;17;12;29
626;25.09.2017;2017;09;22;Maanantai;7;4;11
626;25.09.2017;2017;09;23;Maanantai;6;6;12
626;26.09.2017;2017;09;00;Tiistai;1;3;4
626;26.09.2017;2017;09;01;Tiistai;0;0;0
626;26.09.2017;2017;09;02;Tiistai;0;0;0
626;26.09.2017;2017;09;03;Tiistai;0;0;0
626;26.09.2017;2017;09;04;Tiistai;0;0;0
626;26.09.2017;2017;09;05;Tiistai;0;4;4
626;26.09.2017;2017;09;06;Tiistai;4;6;10
626;26.09.2017;2017;09;07;Tiistai;6;37;43
626;26.09.2017;2017;09;08;Tiistai;18;64;82
626;26.09.2017;2017;09;09;Tiistai;20;50;70
626;26.09.2017;2017;09;10;Tiistai;7;16;23
626;26.09.2017;2017;09;11;Tiistai;11;13;24
626;26.09.2017;2017;09;12;Tiistai;9;17;26
626;26.09.2017;2017;09;13;Tiistai;12;10;22
626;26.09.2017;2017;09;14;Tiistai;15;12;27
626;26.09.2017;2017;09;15;Tiistai;25;16;41
626;26.09.2017;2017;09;16;Tiistai;42;34;76
626;26.09.2017;2017;09;17;Tiistai;61;34;95
626;26.09.2017;2017;09;18;Tiistai;32;20;52
626;26.09.2017;2017;09;19;Tiistai;28;11;39
626;26.09.2017;2017;09;20;Tiistai;12;13;25
626;26.09.2017;2017;09;21;Tiistai;15;9;24
626;26.09.2017;2017;09;22;Tiistai;5;4;9
626;26.09.2017;2017;09;23;Tiistai;3;3;6
626;27.09.2017;2017;09;00;Keskiviikko;0;0;0
626;27.09.2017;2017;09;01;Keskiviikko;1;1;2
626;27.09.2017;2017;09;02;Keskiviikko;1;0;1
626;27.09.2017;2017;09;03;Keskiviikko;0;1;1
626;27.09.2017;2017;09;04;Keskiviikko;0;0;0
626;27.09.2017;2017;09;05;Keskiviikko;0;3;3
626;27.09.2017;2017;09;06;Keskiviikko;4;7;11
626;27.09.2017;2017;09;07;Keskiviikko;6;29;35
626;27.09.2017;2017;09;08;Keskiviikko;23;66;89
626;27.09.2017;2017;09;09;Keskiviikko;17;35;52
626;27.09.2017;2017;09;10;Keskiviikko;9;24;33
626;27.09.2017;2017;09;11;Keskiviikko;10;16;26
626;27.09.2017;2017;09;12;Keskiviikko;19;16;35
626;27.09.2017;2017;09;13;Keskiviikko;15;13;28
626;27.09.2017;2017;09;14;Keskiviikko;24;21;45
626;27.09.2017;2017;09;15;Keskiviikko;22;16;38
626;27.09.2017;2017;09;16;Keskiviikko;36;19;55
626;27.09.2017;2017;09;17;Keskiviikko;45;23;68
626;27.09.2017;2017;09;18;Keskiviikko;29;11;40
626;27.09.2017;2017;09;19;Keskiviikko;33;14;47
626;27.09.2017;2017;09;20;Keskiviikko;12;7;19
626;27.09.2017;2017;09;21;Keskiviikko;20;7;27
626;27.09.2017;2017;09;22;Keskiviikko;2;4;6
626;27.09.2017;2017;09;23;Keskiviikko;3;4;7
626;28.09.2017;2017;09;00;Torstai;1;3;4
626;28.09.2017;2017;09;01;Torstai;0;1;1
626;28.09.2017;2017;09;02;Torstai;1;0;1
626;28.09.2017;2017;09;03;Torstai;0;1;1
626;28.09.2017;2017;09;04;Torstai;0;0;0
626;28.09.2017;2017;09;05;Torstai;1;2;3
626;28.09.2017;2017;09;06;Torstai;3;9;12
626;28.09.2017;2017;09;07;Torstai;7;27;34
626;28.09.2017;2017;09;08;Torstai;23;58;81
626;28.09.2017;2017;09;09;Torstai;14;29;43
626;28.09.2017;2017;09;10;Torstai;6;17;23
626;28.09.2017;2017;09;11;Torstai;17;9;26
626;28.09.2017;2017;09;12;Torstai;15;17;32
626;28.09.2017;2017;09;13;Torstai;4;16;20
626;28.09.2017;2017;09;14;Torstai;13;11;24
626;28.09.2017;2017;09;15;Torstai;23;18;41
626;28.09.2017;2017;09;16;Torstai;41;32;73
626;28.09.2017;2017;09;17;Torstai;34;28;62
626;28.09.2017;2017;09;18;Torstai;30;16;46
626;28.09.2017;2017;09;19;Torstai;26;15;41
626;28.09.2017;2017;09;20;Torstai;9;9;18
626;28.09.2017;2017;09;21;Torstai;16;6;22
626;28.09.2017;2017;09;22;Torstai;9;4;13
626;28.09.2017;2017;09;23;Torstai;4;5;9
626;29.09.2017;2017;09;00;Perjantai;2;3;5
626;29.09.2017;2017;09;01;Perjantai;1;0;1
626;29.09.2017;2017;09;02;Perjantai;1;0;1
626;29.09.2017;2017;09;03;Perjantai;0;1;1
626;29.09.2017;2017;09;04;Perjantai;0;2;2
626;29.09.2017;2017;09;05;Perjantai;0;3;3
626;29.09.2017;2017;09;06;Perjantai;3;9;12
626;29.09.2017;2017;09;07;Perjantai;5;24;29
626;29.09.2017;2017;09;08;Perjantai;17;44;61
626;29.09.2017;2017;09;09;Perjantai;12;26;38
626;29.09.2017;2017;09;10;Perjantai;6;18;24
626;29.09.2017;2017;09;11;Perjantai;11;10;21
626;29.09.2017;2017;09;12;Perjantai;11;13;24
626;29.09.2017;2017;09;13;Perjantai;16;14;30
626;29.09.2017;2017;09;14;Perjantai;20;17;37
626;29.09.2017;2017;09;15;Perjantai;29;21;50
626;29.09.2017;2017;09;16;Perjantai;35;19;54
626;29.09.2017;2017;09;17;Perjantai;40;19;59
626;29.09.2017;2017;09;18;Perjantai;19;11;30
626;29.09.2017;2017;09;19;Perjantai;18;8;26
626;29.09.2017;2017;09;20;Perjantai;11;3;14
626;29.09.2017;2017;09;21;Perjantai;8;3;11
626;29.09.2017;2017;09;22;Perjantai;7;6;13
626;29.09.2017;2017;09;23;Perjantai;2;2;4
626;30.09.2017;2017;09;00;Lauantai;4;2;6
626;30.09.2017;2017;09;01;Lauantai;4;2;6
626;30.09.2017;2017;09;02;Lauantai;1;3;4
626;30.09.2017;2017;09;03;Lauantai;4;1;5
626;30.09.2017;2017;09;04;Lauantai;3;4;7
626;30.09.2017;2017;09;05;Lauantai;0;0;0
626;30.09.2017;2017;09;06;Lauantai;0;2;2
626;30.09.2017;2017;09;07;Lauantai;1;2;3
626;30.09.2017;2017;09;08;Lauantai;4;3;7
626;30.09.2017;2017;09;09;Lauantai;2;6;8
626;30.09.2017;2017;09;10;Lauantai;6;8;14
626;30.09.2017;2017;09;11;Lauantai;11;6;17
626;30.09.2017;2017;09;12;Lauantai;7;10;17
626;30.09.2017;2017;09;13;Lauantai;7;5;12
626;30.09.2017;2017;09;14;Lauantai;10;14;24
626;30.09.2017;2017;09;15;Lauantai;8;18;26
626;30.09.2017;2017;09;16;Lauantai;18;13;31
626;30.09.2017;2017;09;17;Lauantai;18;18;36
626;30.09.2017;2017;09;18;Lauantai;23;13;36
626;30.09.2017;2017;09;19;Lauantai;8;9;17
626;30.09.2017;2017;09;20;Lauantai;12;8;20
626;30.09.2017;2017;09;21;Lauantai;7;4;11
626;30.09.2017;2017;09;22;Lauantai;3;7;10
626;30.09.2017;2017;09;23;Lauantai;5;4;9
626;01.10.2017;2017;10;00;Sunnuntai;1;2;3
626;01.10.2017;2017;10;01;Sunnuntai;0;5;5
626;01.10.2017;2017;10;02;Sunnuntai;5;0;5
626;01.10.2017;2017;10;03;Sunnuntai;2;0;2
626;01.10.2017;2017;10;04;Sunnuntai;1;0;1
626;01.10.2017;2017;10;05;Sunnuntai;0;1;1
626;01.10.2017;2017;10;06;Sunnuntai;0;0;0
626;01.10.2017;2017;10;07;Sunnuntai;2;2;4
626;01.10.2017;2017;10;08;Sunnuntai;1;1;2
626;01.10.2017;2017;10;09;Sunnuntai;3;1;4
626;01.10.2017;2017;10;10;Sunnuntai;2;6;8
626;01.10.2017;2017;10;11;Sunnuntai;6;4;10
626;01.10.2017;2017;10;12;Sunnuntai;10;17;27
626;01.10.2017;2017;10;13;Sunnuntai;14;18;32
626;01.10.2017;2017;10;14;Sunnuntai;15;15;30
626;01.10.2017;2017;10;15;Sunnuntai;11;14;25
626;01.10.2017;2017;10;16;Sunnuntai;9;4;13
626;01.10.2017;2017;10;17;Sunnuntai;13;6;19
626;01.10.2017;2017;10;18;Sunnuntai;13;15;28
626;01.10.2017;2017;10;19;Sunnuntai;3;12;15
626;01.10.2017;2017;10;20;Sunnuntai;4;9;13
626;01.10.2017;2017;10;21;Sunnuntai;3;2;5
626;01.10.2017;2017;10;22;Sunnuntai;5;1;6
626;01.10.2017;2017;10;23;Sunnuntai;1;0;1
626;02.10.2017;2017;10;00;Maanantai;0;1;1
626;02.10.2017;2017;10;01;Maanantai;0;0;0
626;02.10.2017;2017;10;02;Maanantai;0;0;0
626;02.10.2017;2017;10;03;Maanantai;0;0;0
626;02.10.2017;2017;10;04;Maanantai;0;1;1
626;02.10.2017;2017;10;05;Maanantai;0;2;2
626;02.10.2017;2017;10;06;Maanantai;2;9;11
626;02.10.2017;2017;10;07;Maanantai;6;29;35
626;02.10.2017;2017;10;08;Maanantai;14;67;81
626;02.10.2017;2017;10;09;Maanantai;14;34;48
626;02.10.2017;2017;10;10;Maanantai;8;23;31
626;02.10.2017;2017;10;11;Maanantai;7;13;20
626;02.10.2017;2017;10;12;Maanantai;12;10;22
626;02.10.2017;2017;10;13;Maanantai;9;9;18
626;02.10.2017;2017;10;14;Maanantai;9;6;15
626;02.10.2017;2017;10;15;Maanantai;16;11;27
626;02.10.2017;2017;10;16;Maanantai;40;24;64
626;02.10.2017;2017;10;17;Maanantai;49;21;70
626;02.10.2017;2017;10;18;Maanantai;30;20;50
626;02.10.2017;2017;10;19;Maanantai;15;11;26
626;02.10.2017;2017;10;20;Maanantai;12;8;20
626;02.10.2017;2017;10;21;Maanantai;20;4;24
626;02.10.2017;2017;10;22;Maanantai;9;6;15
626;02.10.2017;2017;10;23;Maanantai;4;0;4
626;03.10.2017;2017;10;00;Tiistai;0;3;3
626;03.10.2017;2017;10;01;Tiistai;0;0;0
626;03.10.2017;2017;10;02;Tiistai;0;0;0
626;03.10.2017;2017;10;03;Tiistai;0;0;0
626;03.10.2017;2017;10;04;Tiistai;1;0;1
626;03.10.2017;2017;10;05;Tiistai;1;1;2
626;03.10.2017;2017;10;06;Tiistai;3;8;11
626;03.10.2017;2017;10;07;Tiistai;7;29;36
626;03.10.2017;2017;10;08;Tiistai;19;57;76
626;03.10.2017;2017;10;09;Tiistai;16;30;46
626;03.10.2017;2017;10;10;Tiistai;5;15;20
626;03.10.2017;2017;10;11;Tiistai;2;10;12
626;03.10.2017;2017;10;12;Tiistai;4;4;8
626;03.10.2017;2017;10;13;Tiistai;8;11;19
626;03.10.2017;2017;10;14;Tiistai;7;3;10
626;03.10.2017;2017;10;15;Tiistai;16;10;26
626;03.10.2017;2017;10;16;Tiistai;34;17;51
626;03.10.2017;2017;10;17;Tiistai;35;19;54
626;03.10.2017;2017;10;18;Tiistai;18;9;27
626;03.10.2017;2017;10;19;Tiistai;17;7;24
626;03.10.2017;2017;10;20;Tiistai;16;6;22
626;03.10.2017;2017;10;21;Tiistai;6;1;7
626;03.10.2017;2017;10;22;Tiistai;3;4;7
626;03.10.2017;2017;10;23;Tiistai;6;1;7
626;04.10.2017;2017;10;00;Keskiviikko;0;0;0
626;04.10.2017;2017;10;01;Keskiviikko;0;0;0
626;04.10.2017;2017;10;02;Keskiviikko;0;1;1
626;04.10.2017;2017;10;03;Keskiviikko;0;0;0
626;04.10.2017;2017;10;04;Keskiviikko;0;0;0
626;04.10.2017;2017;10;05;Keskiviikko;0;2;2
626;04.10.2017;2017;10;06;Keskiviikko;1;6;7
626;04.10.2017;2017;10;07;Keskiviikko;5;26;31
626;04.10.2017;2017;10;08;Keskiviikko;11;35;46
626;04.10.2017;2017;10;09;Keskiviikko;13;29;42
626;04.10.2017;2017;10;10;Keskiviikko;6;17;23
626;04.10.2017;2017;10;11;Keskiviikko;8;5;13
626;04.10.2017;2017;10;12;Keskiviikko;5;5;10
626;04.10.2017;2017;10;13;Keskiviikko;11;5;16
626;04.10.2017;2017;10;14;Keskiviikko;8;8;16
626;04.10.2017;2017;10;15;Keskiviikko;12;4;16
626;04.10.2017;2017;10;16;Keskiviikko;23;20;43
626;04.10.2017;2017;10;17;Keskiviikko;38;23;61
626;04.10.2017;2017;10;18;Keskiviikko;18;15;33
626;04.10.2017;2017;10;19;Keskiviikko;17;4;21
626;04.10.2017;2017;10;20;Keskiviikko;9;6;15
626;04.10.2017;2017;10;21;Keskiviikko;5;2;7
626;04.10.2017;2017;10;22;Keskiviikko;3;6;9
626;04.10.2017;2017;10;23;Keskiviikko;2;1;3
626;05.10.2017;2017;10;00;Torstai;0;1;1
626;05.10.2017;2017;10;01;Torstai;0;0;0
626;05.10.2017;2017;10;02;Torstai;0;1;1
626;05.10.2017;2017;10;03;Torstai;0;0;0
626;05.10.2017;2017;10;04;Torstai;0;0;0
626;05.10.2017;2017;10;05;Torstai;0;1;1
626;05.10.2017;2017;10;06;Torstai;4;7;11
626;05.10.2017;2017;10;07;Torstai;7;21;28
626;05.10.2017;2017;10;08;Torstai;17;51;68
626;05.10.2017;2017;10;09;Torstai;8;36;44
626;05.10.2017;2017;10;10;Torstai;2;14;16
626;05.10.2017;2017;10;11;Torstai;6;7;13
626;05.10.2017;2017;10;12;Torstai;10;8;18
626;05.10.2017;2017;10;13;Torstai;4;12;16
626;05.10.2017;2017;10;14;Torstai;8;9;17
626;05.10.2017;2017;10;15;Torstai;14;11;25
626;05.10.2017;2017;10;16;Torstai;31;30;61
626;05.10.2017;2017;10;17;Torstai;36;14;50
626;05.10.2017;2017;10;18;Torstai;16;12;28
626;05.10.2017;2017;10;19;Torstai;18;7;25
626;05.10.2017;2017;10;20;Torstai;12;4;16
626;05.10.2017;2017;10;21;Torstai;3;4;7
626;05.10.2017;2017;10;22;Torstai;5;5;10
626;05.10.2017;2017;10;23;Torstai;3;1;4
626;06.10.2017;2017;10;00;Perjantai;1;1;2
626;06.10.2017;2017;10;01;Perjantai;0;1;1
626;06.10.2017;2017;10;02;Perjantai;1;0;1
626;06.10.2017;2017;10;03;Perjantai;0;0;0
626;06.10.2017;2017;10;04;Perjantai;0;0;0
626;06.10.2017;2017;10;05;Perjantai;1;2;3
626;06.10.2017;2017;10;06;Perjantai;2;9;11
626;06.10.2017;2017;10;07;Perjantai;9;21;30
626;06.10.2017;2017;10;08;Perjantai;6;58;64
626;06.10.2017;2017;10;09;Perjantai;16;35;51
626;06.10.2017;2017;10;10;Perjantai;10;19;29
626;06.10.2017;2017;10;11;Perjantai;14;18;32
626;06.10.2017;2017;10;12;Perjantai;12;13;25
626;06.10.2017;2017;10;13;Perjantai;9;11;20
626;06.10.2017;2017;10;14;Perjantai;17;11;28
626;06.10.2017;2017;10;15;Perjantai;39;21;60
626;06.10.2017;2017;10;16;Perjantai;42;22;64
626;06.10.2017;2017;10;17;Perjantai;54;24;78
626;06.10.2017;2017;10;18;Perjantai;15;14;29
626;06.10.2017;2017;10;19;Perjantai;16;5;21
626;06.10.2017;2017;10;20;Perjantai;19;10;29
626;06.10.2017;2017;10;21;Perjantai;5;6;11
626;06.10.2017;2017;10;22;Perjantai;6;6;12
626;06.10.2017;2017;10;23;Perjantai;2;2;4
626;07.10.2017;2017;10;00;Lauantai;0;3;3
626;07.10.2017;2017;10;01;Lauantai;1;1;2
626;07.10.2017;2017;10;02;Lauantai;1;1;2
626;07.10.2017;2017;10;03;Lauantai;0;0;0
626;07.10.2017;2017;10;04;Lauantai;1;0;1
626;07.10.2017;2017;10;05;Lauantai;0;0;0
626;07.10.2017;2017;10;06;Lauantai;1;0;1
626;07.10.2017;2017;10;07;Lauantai;0;2;2
626;07.10.2017;2017;10;08;Lauantai;1;2;3
626;07.10.2017;2017;10;09;Lauantai;1;2;3
626;07.10.2017;2017;10;10;Lauantai;5;8;13
626;07.10.2017;2017;10;11;Lauantai;12;10;22
626;07.10.2017;2017;10;12;Lauantai;12;14;26
626;07.10.2017;2017;10;13;Lauantai;10;14;24
626;07.10.2017;2017;10;14;Lauantai;11;12;23
626;07.10.2017;2017;10;15;Lauantai;15;18;33
626;07.10.2017;2017;10;16;Lauantai;14;8;22
626;07.10.2017;2017;10;17;Lauantai;12;6;18
626;07.10.2017;2017;10;18;Lauantai;12;9;21
626;07.10.2017;2017;10;19;Lauantai;15;16;31
626;07.10.2017;2017;10;20;Lauantai;12;7;19
626;07.10.2017;2017;10;21;Lauantai;2;3;5
626;07.10.2017;2017;10;22;Lauantai;6;4;10
626;07.10.2017;2017;10;23;Lauantai;1;2;3
626;08.10.2017;2017;10;00;Sunnuntai;1;1;2
626;08.10.2017;2017;10;01;Sunnuntai;0;1;1
626;08.10.2017;2017;10;02;Sunnuntai;1;1;2
626;08.10.2017;2017;10;03;Sunnuntai;0;0;0
626;08.10.2017;2017;10;04;Sunnuntai;1;1;2
626;08.10.2017;2017;10;05;Sunnuntai;0;1;1
626;08.10.2017;2017;10;06;Sunnuntai;2;0;2
626;08.10.2017;2017;10;07;Sunnuntai;1;2;3
626;08.10.2017;2017;10;08;Sunnuntai;4;0;4
626;08.10.2017;2017;10;09;Sunnuntai;1;2;3
626;08.10.2017;2017;10;10;Sunnuntai;3;2;5
626;08.10.2017;2017;10;11;Sunnuntai;4;9;13
626;08.10.2017;2017;10;12;Sunnuntai;8;14;22
626;08.10.2017;2017;10;13;Sunnuntai;16;21;37
626;08.10.2017;2017;10;14;Sunnuntai;19;17;36
626;08.10.2017;2017;10;15;Sunnuntai;11;11;22
626;08.10.2017;2017;10;16;Sunnuntai;13;8;21
626;08.10.2017;2017;10;17;Sunnuntai;12;13;25
626;08.10.2017;2017;10;18;Sunnuntai;12;12;24
626;08.10.2017;2017;10;19;Sunnuntai;8;13;21
626;08.10.2017;2017;10;20;Sunnuntai;1;7;8
626;08.10.2017;2017;10;21;Sunnuntai;5;3;8
626;08.10.2017;2017;10;22;Sunnuntai;6;3;9
626;08.10.2017;2017;10;23;Sunnuntai;1;0;1
626;09.10.2017;2017;10;00;Maanantai;0;0;0
626;09.10.2017;2017;10;01;Maanantai;1;0;1
626;09.10.2017;2017;10;02;Maanantai;1;0;1
626;09.10.2017;2017;10;03;Maanantai;0;0;0
626;09.10.2017;2017;10;04;Maanantai;0;0;0
626;09.10.2017;2017;10;05;Maanantai;0;1;1
626;09.10.2017;2017;10;06;Maanantai;3;8;11
626;09.10.2017;2017;10;07;Maanantai;10;21;31
626;09.10.2017;2017;10;08;Maanantai;13;59;72
626;09.10.2017;2017;10;09;Maanantai;17;42;59
626;09.10.2017;2017;10;10;Maanantai;5;30;35
626;09.10.2017;2017;10;11;Maanantai;10;16;26
626;09.10.2017;2017;10;12;Maanantai;14;17;31
626;09.10.2017;2017;10;13;Maanantai;12;11;23
626;09.10.2017;2017;10;14;Maanantai;13;11;24
626;09.10.2017;2017;10;15;Maanantai;20;15;35
626;09.10.2017;2017;10;16;Maanantai;44;26;70
626;09.10.2017;2017;10;17;Maanantai;70;20;90
626;09.10.2017;2017;10;18;Maanantai;37;29;66
626;09.10.2017;2017;10;19;Maanantai;33;14;47
626;09.10.2017;2017;10;20;Maanantai;20;15;35
626;09.10.2017;2017;10;21;Maanantai;10;5;15
626;09.10.2017;2017;10;22;Maanantai;11;2;13
626;09.10.2017;2017;10;23;Maanantai;2;6;8
626;10.10.2017;2017;10;00;Tiistai;2;1;3
626;10.10.2017;2017;10;01;Tiistai;0;0;0
626;10.10.2017;2017;10;02;Tiistai;0;0;0
626;10.10.2017;2017;10;03;Tiistai;0;0;0
626;10.10.2017;2017;10;04;Tiistai;0;1;1
626;10.10.2017;2017;10;05;Tiistai;0;3;3
626;10.10.2017;2017;10;06;Tiistai;3;11;14
626;10.10.2017;2017;10;07;Tiistai;6;17;23
626;10.10.2017;2017;10;08;Tiistai;10;36;46
626;10.10.2017;2017;10;09;Tiistai;11;21;32
626;10.10.2017;2017;10;10;Tiistai;1;10;11
626;10.10.2017;2017;10;11;Tiistai;3;6;9
626;10.10.2017;2017;10;12;Tiistai;3;6;9
626;10.10.2017;2017;10;13;Tiistai;6;3;9
626;10.10.2017;2017;10;14;Tiistai;7;2;9
626;10.10.2017;2017;10;15;Tiistai;13;7;20
626;10.10.2017;2017;10;16;Tiistai;21;10;31
626;10.10.2017;2017;10;17;Tiistai;32;22;54
626;10.10.2017;2017;10;18;Tiistai;26;9;35
626;10.10.2017;2017;10;19;Tiistai;16;6;22
626;10.10.2017;2017;10;20;Tiistai;10;4;14
626;10.10.2017;2017;10;21;Tiistai;12;4;16
626;10.10.2017;2017;10;22;Tiistai;2;4;6
626;10.10.2017;2017;10;23;Tiistai;0;3;3
626;11.10.2017;2017;10;00;Keskiviikko;2;0;2
626;11.10.2017;2017;10;01;Keskiviikko;0;0;0
626;11.10.2017;2017;10;02;Keskiviikko;0;0;0
626;11.10.2017;2017;10;03;Keskiviikko;0;0;0
626;11.10.2017;2017;10;04;Keskiviikko;0;1;1
626;11.10.2017;2017;10;05;Keskiviikko;1;4;5
626;11.10.2017;2017;10;06;Keskiviikko;3;8;11
626;11.10.2017;2017;10;07;Keskiviikko;7;32;39
626;11.10.2017;2017;10;08;Keskiviikko;16;62;78
626;11.10.2017;2017;10;09;Keskiviikko;12;39;51
626;11.10.2017;2017;10;10;Keskiviikko;10;19;29
626;11.10.2017;2017;10;11;Keskiviikko;11;19;30
626;11.10.2017;2017;10;12;Keskiviikko;10;12;22
626;11.10.2017;2017;10;13;Keskiviikko;20;19;39
626;11.10.2017;2017;10;14;Keskiviikko;18;14;32
626;11.10.2017;2017;10;15;Keskiviikko;28;21;49
626;11.10.2017;2017;10;16;Keskiviikko;38;14;52
626;11.10.2017;2017;10;17;Keskiviikko;48;29;77
626;11.10.2017;2017;10;18;Keskiviikko;23;18;41
626;11.10.2017;2017;10;19;Keskiviikko;5;2;7
626;11.10.2017;2017;10;20;Keskiviikko;12;14;26
626;11.10.2017;2017;10;21;Keskiviikko;18;8;26
626;11.10.2017;2017;10;22;Keskiviikko;5;3;8
626;11.10.2017;2017;10;23;Keskiviikko;6;3;9
626;12.10.2017;2017;10;00;Torstai;3;0;3
626;12.10.2017;2017;10;01;Torstai;0;0;0
626;12.10.2017;2017;10;02;Torstai;1;0;1
626;12.10.2017;2017;10;03;Torstai;1;0;1
626;12.10.2017;2017;10;04;Torstai;0;1;1
626;12.10.2017;2017;10;05;Torstai;0;7;7
626;12.10.2017;2017;10;06;Torstai;2;13;15
626;12.10.2017;2017;10;07;Torstai;11;28;39
626;12.10.2017;2017;10;08;Torstai;12;61;73
626;12.10.2017;2017;10;09;Torstai;18;40;58
626;12.10.2017;2017;10;10;Torstai;7;23;30
626;12.10.2017;2017;10;11;Torstai;11;16;27
626;12.10.2017;2017;10;12;Torstai;18;7;25
626;12.10.2017;2017;10;13;Torstai;15;17;32
626;12.10.2017;2017;10;14;Torstai;23;15;38
626;12.10.2017;2017;10;15;Torstai;17;20;37
626;12.10.2017;2017;10;16;Torstai;40;23;63
626;12.10.2017;2017;10;17;Torstai;51;25;76
626;12.10.2017;2017;10;18;Torstai;30;14;44
626;12.10.2017;2017;10;19;Torstai;31;14;45
626;12.10.2017;2017;10;20;Torstai;19;9;28
626;12.10.2017;2017;10;21;Torstai;8;6;14
626;12.10.2017;2017;10;22;Torstai;11;3;14
626;12.10.2017;2017;10;23;Torstai;3;5;8
626;13.10.2017;2017;10;00;Perjantai;1;0;1
626;13.10.2017;2017;10;01;Perjantai;1;0;1
626;13.10.2017;2017;10;02;Perjantai;0;1;1
626;13.10.2017;2017;10;03;Perjantai;2;0;2
626;13.10.2017;2017;10;04;Perjantai;0;0;0
626;13.10.2017;2017;10;05;Perjantai;0;5;5
626;13.10.2017;2017;10;06;Perjantai;3;12;15
626;13.10.2017;2017;10;07;Perjantai;8;21;29
626;13.10.2017;2017;10;08;Perjantai;17;50;67
626;13.10.2017;2017;10;09;Perjantai;15;25;40
626;13.10.2017;2017;10;10;Perjantai;10;34;44
626;13.10.2017;2017;10;11;Perjantai;7;10;17
626;13.10.2017;2017;10;12;Perjantai;12;11;23
626;13.10.2017;2017;10;13;Perjantai;12;14;26
626;13.10.2017;2017;10;14;Perjantai;24;21;45
626;13.10.2017;2017;10;15;Perjantai;25;14;39
626;13.10.2017;2017;10;16;Perjantai;33;21;54
626;13.10.2017;2017;10;17;Perjantai;41;22;63
626;13.10.2017;2017;10;18;Perjantai;23;11;34
626;13.10.2017;2017;10;19;Perjantai;23;8;31
626;13.10.2017;2017;10;20;Perjantai;11;6;17
626;13.10.2017;2017;10;21;Perjantai;4;2;6
626;13.10.2017;2017;10;22;Perjantai;6;6;12
626;13.10.2017;2017;10;23;Perjantai;4;1;5
626;14.10.2017;2017;10;00;Lauantai;2;1;3
626;14.10.2017;2017;10;01;Lauantai;2;2;4
626;14.10.2017;2017;10;02;Lauantai;1;0;1
626;14.10.2017;2017;10;03;Lauantai;0;0;0
626;14.10.2017;2017;10;04;Lauantai;1;0;1
626;14.10.2017;2017;10;05;Lauantai;1;0;1
626;14.10.2017;2017;10;06;Lauantai;2;4;6
626;14.10.2017;2017;10;07;Lauantai;3;3;6
626;14.10.2017;2017;10;08;Lauantai;1;4;5
626;14.10.2017;2017;10;09;Lauantai;5;7;12
626;14.10.2017;2017;10;10;Lauantai;5;4;9
626;14.10.2017;2017;10;11;Lauantai;6;10;16
626;14.10.2017;2017;10;12;Lauantai;11;17;28
626;14.10.2017;2017;10;13;Lauantai;12;11;23
626;14.10.2017;2017;10;14;Lauantai;11;25;36
626;14.10.2017;2017;10;15;Lauantai;9;12;21
626;14.10.2017;2017;10;16;Lauantai;13;9;22
626;14.10.2017;2017;10;17;Lauantai;10;6;16
626;14.10.2017;2017;10;18;Lauantai;2;3;5
626;14.10.2017;2017;10;19;Lauantai;2;3;5
626;14.10.2017;2017;10;20;Lauantai;6;1;7
626;14.10.2017;2017;10;21;Lauantai;5;2;7
626;14.10.2017;2017;10;22;Lauantai;1;3;4
626;14.10.2017;2017;10;23;Lauantai;2;2;4
626;15.10.2017;2017;10;00;Sunnuntai;0;1;1
626;15.10.2017;2017;10;01;Sunnuntai;0;0;0
626;15.10.2017;2017;10;02;Sunnuntai;1;0;1
626;15.10.2017;2017;10;03;Sunnuntai;1;0;1
626;15.10.2017;2017;10;04;Sunnuntai;0;0;0
626;15.10.2017;2017;10;05;Sunnuntai;0;0;0
626;15.10.2017;2017;10;06;Sunnuntai;1;3;4
626;15.10.2017;2017;10;07;Sunnuntai;2;1;3
626;15.10.2017;2017;10;08;Sunnuntai;0;0;0
626;15.10.2017;2017;10;09;Sunnuntai;0;1;1
626;15.10.2017;2017;10;10;Sunnuntai;3;1;4
626;15.10.2017;2017;10;11;Sunnuntai;10;7;17
626;15.10.2017;2017;10;12;Sunnuntai;6;19;25
626;15.10.2017;2017;10;13;Sunnuntai;10;15;25
626;15.10.2017;2017;10;14;Sunnuntai;26;12;38
626;15.10.2017;2017;10;15;Sunnuntai;18;18;36
626;15.10.2017;2017;10;16;Sunnuntai;19;25;44
626;15.10.2017;2017;10;17;Sunnuntai;13;18;31
626;15.10.2017;2017;10;18;Sunnuntai;7;10;17
626;15.10.2017;2017;10;19;Sunnuntai;12;8;20
626;15.10.2017;2017;10;20;Sunnuntai;4;7;11
626;15.10.2017;2017;10;21;Sunnuntai;9;2;11
626;15.10.2017;2017;10;22;Sunnuntai;1;0;1
626;15.10.2017;2017;10;23;Sunnuntai;2;0;2
626;16.10.2017;2017;10;00;Maanantai;2;2;4
626;16.10.2017;2017;10;01;Maanantai;0;1;1
626;16.10.2017;2017;10;02;Maanantai;0;1;1
626;16.10.2017;2017;10;03;Maanantai;0;0;0
626;16.10.2017;2017;10;04;Maanantai;0;1;1
626;16.10.2017;2017;10;05;Maanantai;0;3;3
626;16.10.2017;2017;10;06;Maanantai;4;2;6
626;16.10.2017;2017;10;07;Maanantai;4;19;23
626;16.10.2017;2017;10;08;Maanantai;4;33;37
626;16.10.2017;2017;10;09;Maanantai;9;19;28
626;16.10.2017;2017;10;10;Maanantai;3;7;10
626;16.10.2017;2017;10;11;Maanantai;4;3;7
626;16.10.2017;2017;10;12;Maanantai;3;1;4
626;16.10.2017;2017;10;13;Maanantai;3;0;3
626;16.10.2017;2017;10;14;Maanantai;0;3;3
626;16.10.2017;2017;10;15;Maanantai;11;9;20
626;16.10.2017;2017;10;16;Maanantai;14;9;23
626;16.10.2017;2017;10;17;Maanantai;33;16;49
626;16.10.2017;2017;10;18;Maanantai;20;17;37
626;16.10.2017;2017;10;19;Maanantai;8;8;16
626;16.10.2017;2017;10;20;Maanantai;5;4;9
626;16.10.2017;2017;10;21;Maanantai;6;1;7
626;16.10.2017;2017;10;22;Maanantai;2;1;3
626;16.10.2017;2017;10;23;Maanantai;0;1;1
626;17.10.2017;2017;10;00;Tiistai;1;2;3
626;17.10.2017;2017;10;01;Tiistai;1;0;1
626;17.10.2017;2017;10;02;Tiistai;0;0;0
626;17.10.2017;2017;10;03;Tiistai;0;0;0
626;17.10.2017;2017;10;04;Tiistai;0;0;0
626;17.10.2017;2017;10;05;Tiistai;0;2;2
626;17.10.2017;2017;10;06;Tiistai;2;3;5
626;17.10.2017;2017;10;07;Tiistai;6;23;29
626;17.10.2017;2017;10;08;Tiistai;17;48;65
626;17.10.2017;2017;10;09;Tiistai;16;33;49
626;17.10.2017;2017;10;10;Tiistai;7;15;22
626;17.10.2017;2017;10;11;Tiistai;13;11;24
626;17.10.2017;2017;10;12;Tiistai;10;12;22
626;17.10.2017;2017;10;13;Tiistai;15;17;32
626;17.10.2017;2017;10;14;Tiistai;11;12;23
626;17.10.2017;2017;10;15;Tiistai;17;11;28
626;17.10.2017;2017;10;16;Tiistai;39;31;70
626;17.10.2017;2017;10;17;Tiistai;49;23;72
626;17.10.2017;2017;10;18;Tiistai;22;17;39
626;17.10.2017;2017;10;19;Tiistai;13;6;19
626;17.10.2017;2017;10;20;Tiistai;15;9;24
626;17.10.2017;2017;10;21;Tiistai;7;8;15
626;17.10.2017;2017;10;22;Tiistai;6;3;9
626;17.10.2017;2017;10;23;Tiistai;7;1;8
626;18.10.2017;2017;10;00;Keskiviikko;1;3;4
626;18.10.2017;2017;10;01;Keskiviikko;0;0;0
626;18.10.2017;2017;10;02;Keskiviikko;0;0;0
626;18.10.2017;2017;10;03;Keskiviikko;0;1;1
626;18.10.2017;2017;10;04;Keskiviikko;0;0;0
626;18.10.2017;2017;10;05;Keskiviikko;0;3;3
626;18.10.2017;2017;10;06;Keskiviikko;3;8;11
626;18.10.2017;2017;10;07;Keskiviikko;8;33;41
626;18.10.2017;2017;10;08;Keskiviikko;21;47;68
626;18.10.2017;2017;10;09;Keskiviikko;13;36;49
626;18.10.2017;2017;10;10;Keskiviikko;6;13;19
626;18.10.2017;2017;10;11;Keskiviikko;7;8;15
626;18.10.2017;2017;10;12;Keskiviikko;13;8;21
626;18.10.2017;2017;10;13;Keskiviikko;16;15;31
626;18.10.2017;2017;10;14;Keskiviikko;6;5;11
626;18.10.2017;2017;10;15;Keskiviikko;15;13;28
626;18.10.2017;2017;10;16;Keskiviikko;45;30;75
626;18.10.2017;2017;10;17;Keskiviikko;51;28;79
626;18.10.2017;2017;10;18;Keskiviikko;33;27;60
626;18.10.2017;2017;10;19;Keskiviikko;25;6;31
626;18.10.2017;2017;10;20;Keskiviikko;17;4;21
626;18.10.2017;2017;10;21;Keskiviikko;7;6;13
626;18.10.2017;2017;10;22;Keskiviikko;12;9;21
626;18.10.2017;2017;10;23;Keskiviikko;2;3;5
626;19.10.2017;2017;10;00;Torstai;0;2;2
626;19.10.2017;2017;10;01;Torstai;0;0;0
626;19.10.2017;2017;10;02;Torstai;0;1;1
626;19.10.2017;2017;10;03;Torstai;0;0;0
626;19.10.2017;2017;10;04;Torstai;0;1;1
626;19.10.2017;2017;10;05;Torstai;0;5;5
626;19.10.2017;2017;10;06;Torstai;3;9;12
626;19.10.2017;2017;10;07;Torstai;7;23;30
626;19.10.2017;2017;10;08;Torstai;13;40;53
626;19.10.2017;2017;10;09;Torstai;17;44;61
626;19.10.2017;2017;10;10;Torstai;14;16;30
626;19.10.2017;2017;10;11;Torstai;4;11;15
626;19.10.2017;2017;10;12;Torstai;13;11;24
626;19.10.2017;2017;10;13;Torstai;6;12;18
626;19.10.2017;2017;10;14;Torstai;19;14;33
626;19.10.2017;2017;10;15;Torstai;24;8;32
626;19.10.2017;2017;10;16;Torstai;35;33;68
626;19.10.2017;2017;10;17;Torstai;33;16;49
626;19.10.2017;2017;10;18;Torstai;24;18;42
626;19.10.2017;2017;10;19;Torstai;19;13;32
626;19.10.2017;2017;10;20;Torstai;15;7;22
626;19.10.2017;2017;10;21;Torstai;7;3;10
626;19.10.2017;2017;10;22;Torstai;3;3;6
626;19.10.2017;2017;10;23;Torstai;3;2;5
626;20.10.2017;2017;10;00;Perjantai;0;2;2
626;20.10.2017;2017;10;01;Perjantai;0;0;0
626;20.10.2017;2017;10;02;Perjantai;1;0;1
626;20.10.2017;2017;10;03;Perjantai;1;0;1
626;20.10.2017;2017;10;04;Perjantai;1;0;1
626;20.10.2017;2017;10;05;Perjantai;0;2;2
626;20.10.2017;2017;10;06;Perjantai;2;8;10
626;20.10.2017;2017;10;07;Perjantai;9;14;23
626;20.10.2017;2017;10;08;Perjantai;11;30;41
626;20.10.2017;2017;10;09;Perjantai;17;20;37
626;20.10.2017;2017;10;10;Perjantai;3;12;15
626;20.10.2017;2017;10;11;Perjantai;1;7;8
626;20.10.2017;2017;10;12;Perjantai;4;3;7
626;20.10.2017;2017;10;13;Perjantai;3;7;10
626;20.10.2017;2017;10;14;Perjantai;7;5;12
626;20.10.2017;2017;10;15;Perjantai;18;9;27
626;20.10.2017;2017;10;16;Perjantai;21;14;35
626;20.10.2017;2017;10;17;Perjantai;12;12;24
626;20.10.2017;2017;10;18;Perjantai;13;6;19
626;20.10.2017;2017;10;19;Perjantai;10;6;16
626;20.10.2017;2017;10;20;Perjantai;2;3;5
626;20.10.2017;2017;10;21;Perjantai;3;0;3
626;20.10.2017;2017;10;22;Perjantai;0;1;1
626;20.10.2017;2017;10;23;Perjantai;1;1;2
626;21.10.2017;2017;10;00;Lauantai;1;0;1
626;21.10.2017;2017;10;01;Lauantai;1;0;1
626;21.10.2017;2017;10;02;Lauantai;0;0;0
626;21.10.2017;2017;10;03;Lauantai;1;0;1
626;21.10.2017;2017;10;04;Lauantai;1;0;1
626;21.10.2017;2017;10;05;Lauantai;1;1;2
626;21.10.2017;2017;10;06;Lauantai;0;1;1
626;21.10.2017;2017;10;07;Lauantai;1;2;3
626;21.10.2017;2017;10;08;Lauantai;1;2;3
626;21.10.2017;2017;10;09;Lauantai;3;3;6
626;21.10.2017;2017;10;10;Lauantai;1;4;5
626;21.10.2017;2017;10;11;Lauantai;2;2;4
626;21.10.2017;2017;10;12;Lauantai;6;4;10
626;21.10.2017;2017;10;13;Lauantai;10;6;16
626;21.10.2017;2017;10;14;Lauantai;4;9;13
626;21.10.2017;2017;10;15;Lauantai;4;2;6
626;21.10.2017;2017;10;16;Lauantai;4;11;15
626;21.10.2017;2017;10;17;Lauantai;9;8;17
626;21.10.2017;2017;10;18;Lauantai;6;6;12
626;21.10.2017;2017;10;19;Lauantai;2;4;6
626;21.10.2017;2017;10;20;Lauantai;5;3;8
626;21.10.2017;2017;10;21;Lauantai;4;3;7
626;21.10.2017;2017;10;22;Lauantai;1;3;4
626;21.10.2017;2017;10;23;Lauantai;2;1;3
626;22.10.2017;2017;10;00;Sunnuntai;1;0;1
626;22.10.2017;2017;10;01;Sunnuntai;0;0;0
626;22.10.2017;2017;10;02;Sunnuntai;0;1;1
626;22.10.2017;2017;10;03;Sunnuntai;0;0;0
626;22.10.2017;2017;10;04;Sunnuntai;3;0;3
626;22.10.2017;2017;10;05;Sunnuntai;1;0;1
626;22.10.2017;2017;10;06;Sunnuntai;0;1;1
626;22.10.2017;2017;10;07;Sunnuntai;0;1;1
626;22.10.2017;2017;10;08;Sunnuntai;0;1;1
626;22.10.2017;2017;10;09;Sunnuntai;2;1;3
626;22.10.2017;2017;10;10;Sunnuntai;3;10;13
626;22.10.2017;2017;10;11;Sunnuntai;3;6;9
626;22.10.2017;2017;10;12;Sunnuntai;4;9;13
626;22.10.2017;2017;10;13;Sunnuntai;8;7;15
626;22.10.2017;2017;10;14;Sunnuntai;7;7;14
626;22.10.2017;2017;10;15;Sunnuntai;11;15;26
626;22.10.2017;2017;10;16;Sunnuntai;8;1;9
626;22.10.2017;2017;10;17;Sunnuntai;9;10;19
626;22.10.2017;2017;10;18;Sunnuntai;8;4;12
626;22.10.2017;2017;10;19;Sunnuntai;8;4;12
626;22.10.2017;2017;10;20;Sunnuntai;2;2;4
626;22.10.2017;2017;10;21;Sunnuntai;2;2;4
626;22.10.2017;2017;10;22;Sunnuntai;2;0;2
626;22.10.2017;2017;10;23;Sunnuntai;0;0;0
626;23.10.2017;2017;10;00;Maanantai;0;1;1
626;23.10.2017;2017;10;01;Maanantai;0;0;0
626;23.10.2017;2017;10;02;Maanantai;0;0;0
626;23.10.2017;2017;10;03;Maanantai;0;0;0
626;23.10.2017;2017;10;04;Maanantai;0;0;0
626;23.10.2017;2017;10;05;Maanantai;0;3;3
626;23.10.2017;2017;10;06;Maanantai;1;4;5
626;23.10.2017;2017;10;07;Maanantai;5;17;22
626;23.10.2017;2017;10;08;Maanantai;4;27;31
626;23.10.2017;2017;10;09;Maanantai;11;17;28
626;23.10.2017;2017;10;10;Maanantai;1;9;10
626;23.10.2017;2017;10;11;Maanantai;1;6;7
626;23.10.2017;2017;10;12;Maanantai;4;6;10
626;23.10.2017;2017;10;13;Maanantai;6;7;13
626;23.10.2017;2017;10;14;Maanantai;12;12;24
626;23.10.2017;2017;10;15;Maanantai;15;4;19
626;23.10.2017;2017;10;16;Maanantai;22;11;33
626;23.10.2017;2017;10;17;Maanantai;31;11;42
626;23.10.2017;2017;10;18;Maanantai;13;12;25
626;23.10.2017;2017;10;19;Maanantai;9;5;14
626;23.10.2017;2017;10;20;Maanantai;9;4;13
626;23.10.2017;2017;10;21;Maanantai;5;2;7
626;23.10.2017;2017;10;22;Maanantai;2;4;6
626;23.10.2017;2017;10;23;Maanantai;2;4;6
626;24.10.2017;2017;10;00;Tiistai;0;0;0
626;24.10.2017;2017;10;01;Tiistai;1;0;1
626;24.10.2017;2017;10;02;Tiistai;0;1;1
626;24.10.2017;2017;10;03;Tiistai;0;1;1
626;24.10.2017;2017;10;04;Tiistai;0;0;0
626;24.10.2017;2017;10;05;Tiistai;0;2;2
626;24.10.2017;2017;10;06;Tiistai;1;8;9
626;24.10.2017;2017;10;07;Tiistai;7;16;23
626;24.10.2017;2017;10;08;Tiistai;9;31;40
626;24.10.2017;2017;10;09;Tiistai;4;12;16
626;24.10.2017;2017;10;10;Tiistai;2;3;5
626;24.10.2017;2017;10;11;Tiistai;2;8;10
626;24.10.2017;2017;10;12;Tiistai;2;4;6
626;24.10.2017;2017;10;13;Tiistai;8;6;14
626;24.10.2017;2017;10;14;Tiistai;5;4;9
626;24.10.2017;2017;10;15;Tiistai;7;4;11
626;24.10.2017;2017;10;16;Tiistai;10;6;16
626;24.10.2017;2017;10;17;Tiistai;20;11;31
626;24.10.2017;2017;10;18;Tiistai;10;6;16
626;24.10.2017;2017;10;19;Tiistai;7;2;9
626;24.10.2017;2017;10;20;Tiistai;7;6;13
626;24.10.2017;2017;10;21;Tiistai;5;3;8
626;24.10.2017;2017;10;22;Tiistai;3;1;4
626;24.10.2017;2017;10;23;Tiistai;2;1;3
626;25.10.2017;2017;10;00;Keskiviikko;0;1;1
626;25.10.2017;2017;10;01;Keskiviikko;0;0;0
626;25.10.2017;2017;10;02;Keskiviikko;0;0;0
626;25.10.2017;2017;10;03;Keskiviikko;1;1;2
626;25.10.2017;2017;10;04;Keskiviikko;0;0;0
626;25.10.2017;2017;10;05;Keskiviikko;0;3;3
626;25.10.2017;2017;10;06;Keskiviikko;4;9;13
626;25.10.2017;2017;10;07;Keskiviikko;5;18;23
626;25.10.2017;2017;10;08;Keskiviikko;5;26;31
626;25.10.2017;2017;10;09;Keskiviikko;9;13;22
626;25.10.2017;2017;10;10;Keskiviikko;6;8;14
626;25.10.2017;2017;10;11;Keskiviikko;3;9;12
626;25.10.2017;2017;10;12;Keskiviikko;4;12;16
626;25.10.2017;2017;10;13;Keskiviikko;6;8;14
626;25.10.2017;2017;10;14;Keskiviikko;11;11;22
626;25.10.2017;2017;10;15;Keskiviikko;14;13;27
626;25.10.2017;2017;10;16;Keskiviikko;20;15;35
626;25.10.2017;2017;10;17;Keskiviikko;31;11;42
626;25.10.2017;2017;10;18;Keskiviikko;13;12;25
626;25.10.2017;2017;10;19;Keskiviikko;9;5;14
626;25.10.2017;2017;10;20;Keskiviikko;3;5;8
626;25.10.2017;2017;10;21;Keskiviikko;10;2;12
626;25.10.2017;2017;10;22;Keskiviikko;1;1;2
626;25.10.2017;2017;10;23;Keskiviikko;4;1;5
626;26.10.2017;2017;10;00;Torstai;0;0;0
626;26.10.2017;2017;10;01;Torstai;0;0;0
626;26.10.2017;2017;10;02;Torstai;0;0;0
626;26.10.2017;2017;10;03;Torstai;0;0;0
626;26.10.2017;2017;10;04;Torstai;0;1;1
626;26.10.2017;2017;10;05;Torstai;0;2;2
626;26.10.2017;2017;10;06;Torstai;3;7;10
626;26.10.2017;2017;10;07;Torstai;4;14;18
626;26.10.2017;2017;10;08;Torstai;7;21;28
626;26.10.2017;2017;10;09;Torstai;2;17;19
626;26.10.2017;2017;10;10;Torstai;5;13;18
626;26.10.2017;2017;10;11;Torstai;3;4;7
626;26.10.2017;2017;10;12;Torstai;6;4;10
626;26.10.2017;2017;10;13;Torstai;2;10;12
626;26.10.2017;2017;10;14;Torstai;11;11;22
626;26.10.2017;2017;10;15;Torstai;14;4;18
626;26.10.2017;2017;10;16;Torstai;20;11;31
626;26.10.2017;2017;10;17;Torstai;31;11;42
626;26.10.2017;2017;10;18;Torstai;13;12;25
626;26.10.2017;2017;10;19;Torstai;9;5;14
626;26.10.2017;2017;10;20;Torstai;9;4;13
626;26.10.2017;2017;10;21;Torstai;5;2;7
626;26.10.2017;2017;10;22;Torstai;2;4;6
626;26.10.2017;2017;10;23;Torstai;2;4;6
626;27.10.2017;2017;10;00;Perjantai;0;1;1
626;27.10.2017;2017;10;01;Perjantai;0;0;0
626;27.10.2017;2017;10;02;Perjantai;0;0;0
626;27.10.2017;2017;10;03;Perjantai;0;0;0
626;27.10.2017;2017;10;04;Perjantai;0;0;0
626;27.10.2017;2017;10;05;Perjantai;0;3;3
626;27.10.2017;2017;10;06;Perjantai;1;4;5
626;27.10.2017;2017;10;07;Perjantai;5;17;22
626;27.10.2017;2017;10;08;Perjantai;4;27;31
626;27.10.2017;2017;10;09;Perjantai;11;17;28
626;27.10.2017;2017;10;10;Perjantai;1;9;10
626;27.10.2017;2017;10;11;Perjantai;1;6;7
626;27.10.2017;2017;10;12;Perjantai;4;6;10
626;27.10.2017;2017;10;13;Perjantai;6;7;13
626;27.10.2017;2017;10;14;Perjantai;12;12;24
626;27.10.2017;2017;10;15;Perjantai;15;4;19
626;27.10.2017;2017;10;16;Perjantai;22;11;33
626;27.10.2017;2017;10;17;Perjantai;31;11;42
626;27.10.2017;2017;10;18;Perjantai;14;12;26
626;27.10.2017;2017;10;19;Perjantai;10;4;14
626;27.10.2017;2017;10;20;Perjantai;9;4;13
626;27.10.2017;2017;10;21;Perjantai;1;3;4
626;27.10.2017;2017;10;22;Perjantai;2;4;6
626;27.10.2017;2017;10;23;Perjantai;0;2;2
626;28.10.2017;2017;10;00;Lauantai;0;0;0
626;28.10.2017;2017;10;01;Lauantai;0;2;2
626;28.10.2017;2017;10;02;Lauantai;0;0;0
626;28.10.2017;2017;10;03;Lauantai;0;0;0
626;28.10.2017;2017;10;04;Lauantai;0;0;0
626;28.10.2017;2017;10;05;Lauantai;1;0;1
626;28.10.2017;2017;10;06;Lauantai;2;0;2
626;28.10.2017;2017;10;07;Lauantai;0;1;1
626;28.10.2017;2017;10;08;Lauantai;0;3;3
626;28.10.2017;2017;10;09;Lauantai;0;1;1
626;28.10.2017;2017;10;10;Lauantai;1;5;6
626;28.10.2017;2017;10;11;Lauantai;1;1;2
626;28.10.2017;2017;10;12;Lauantai;3;2;5
626;28.10.2017;2017;10;13;Lauantai;3;4;7
626;28.10.2017;2017;10;14;Lauantai;3;4;7
626;28.10.2017;2017;10;15;Lauantai;0;2;2
626;28.10.2017;2017;10;16;Lauantai;4;5;9
626;28.10.2017;2017;10;17;Lauantai;4;4;8
626;28.10.2017;2017;10;18;Lauantai;4;2;6
626;28.10.2017;2017;10;19;Lauantai;1;1;2
626;28.10.2017;2017;10;20;Lauantai;2;2;4
626;28.10.2017;2017;10;21;Lauantai;1;1;2
626;28.10.2017;2017;10;22;Lauantai;0;1;1
626;28.10.2017;2017;10;23;Lauantai;1;0;1
626;29.10.2017;2017;10;00;Sunnuntai;0;0;0
626;29.10.2017;2017;10;01;Sunnuntai;1;1;2
626;29.10.2017;2017;10;02;Sunnuntai;1;1;2
626;29.10.2017;2017;10;03;Sunnuntai;0;0;0
626;29.10.2017;2017;10;04;Sunnuntai;0;0;0
626;29.10.2017;2017;10;05;Sunnuntai;0;1;1
626;29.10.2017;2017;10;06;Sunnuntai;2;1;3
626;29.10.2017;2017;10;07;Sunnuntai;1;2;3
626;29.10.2017;2017;10;08;Sunnuntai;1;1;2
626;29.10.2017;2017;10;09;Sunnuntai;0;1;1
626;29.10.2017;2017;10;10;Sunnuntai;1;2;3
626;29.10.2017;2017;10;11;Sunnuntai;0;1;1
626;29.10.2017;2017;10;12;Sunnuntai;3;3;6
626;29.10.2017;2017;10;13;Sunnuntai;2;2;4
626;29.10.2017;2017;10;14;Sunnuntai;1;7;8
626;29.10.2017;2017;10;15;Sunnuntai;4;1;5
626;29.10.2017;2017;10;16;Sunnuntai;2;1;3
626;29.10.2017;2017;10;17;Sunnuntai;2;5;7
626;29.10.2017;2017;10;18;Sunnuntai;2;0;2
626;29.10.2017;2017;10;19;Sunnuntai;0;1;1
626;29.10.2017;2017;10;20;Sunnuntai;1;3;4
626;29.10.2017;2017;10;21;Sunnuntai;4;0;4
626;29.10.2017;2017;10;22;Sunnuntai;1;0;1
626;29.10.2017;2017;10;23;Sunnuntai;2;0;2
626;30.10.2017;2017;10;00;Maanantai;0;1;1
626;30.10.2017;2017;10;01;Maanantai;0;0;0
626;30.10.2017;2017;10;02;Maanantai;0;0;0
626;30.10.2017;2017;10;03;Maanantai;0;0;0
626;30.10.2017;2017;10;04;Maanantai;2;0;2
626;30.10.2017;2017;10;05;Maanantai;1;4;5
626;30.10.2017;2017;10;06;Maanantai;2;7;9
626;30.10.2017;2017;10;07;Maanantai;2;21;23
626;30.10.2017;2017;10;08;Maanantai;8;22;30
626;30.10.2017;2017;10;09;Maanantai;9;27;36
626;30.10.2017;2017;10;10;Maanantai;2;5;7
626;30.10.2017;2017;10;11;Maanantai;0;1;1
626;30.10.2017;2017;10;12;Maanantai;3;6;9
626;30.10.2017;2017;10;13;Maanantai;3;4;7
626;30.10.2017;2017;10;14;Maanantai;0;0;0
626;30.10.2017;2017;10;15;Maanantai;8;3;11
626;30.10.2017;2017;10;16;Maanantai;21;8;29
626;30.10.2017;2017;10;17;Maanantai;21;8;29
626;30.10.2017;2017;10;18;Maanantai;14;9;23
626;30.10.2017;2017;10;19;Maanantai;8;3;11
626;30.10.2017;2017;10;20;Maanantai;3;3;6
626;30.10.2017;2017;10;21;Maanantai;5;2;7
626;30.10.2017;2017;10;22;Maanantai;3;5;8
626;30.10.2017;2017;10;23;Maanantai;0;2;2
626;31.10.2017;2017;10;00;Tiistai;0;1;1
626;31.10.2017;2017;10;01;Tiistai;0;0;0
626;31.10.2017;2017;10;02;Tiistai;0;0;0
626;31.10.2017;2017;10;03;Tiistai;0;0;0
626;31.10.2017;2017;10;04;Tiistai;0;0;0
626;31.10.2017;2017;10;05;Tiistai;0;2;2
626;31.10.2017;2017;10;06;Tiistai;4;7;11
626;31.10.2017;2017;10;07;Tiistai;4;14;18
626;31.10.2017;2017;10;08;Tiistai;11;31;42
626;31.10.2017;2017;10;09;Tiistai;11;16;27
626;31.10.2017;2017;10;10;Tiistai;4;13;17
626;31.10.2017;2017;10;11;Tiistai;4;7;11
626;31.10.2017;2017;10;12;Tiistai;1;2;3
626;31.10.2017;2017;10;13;Tiistai;6;6;12
626;31.10.2017;2017;10;14;Tiistai;10;7;17
626;31.10.2017;2017;10;15;Tiistai;10;8;18
626;31.10.2017;2017;10;16;Tiistai;24;15;39
626;31.10.2017;2017;10;17;Tiistai;32;11;43
626;31.10.2017;2017;10;18;Tiistai;15;6;21
626;31.10.2017;2017;10;19;Tiistai;11;6;17
626;31.10.2017;2017;10;20;Tiistai;8;4;12
626;31.10.2017;2017;10;21;Tiistai;3;4;7
626;31.10.2017;2017;10;22;Tiistai;4;3;7
626;31.10.2017;2017;10;23;Tiistai;4;2;6
626;01.11.2017;2017;11;00;Keskiviikko;0;1;1
626;01.11.2017;2017;11;01;Keskiviikko;0;0;0
626;01.11.2017;2017;11;02;Keskiviikko;0;0;0
626;01.11.2017;2017;11;03;Keskiviikko;0;0;0
626;01.11.2017;2017;11;04;Keskiviikko;1;0;1
626;01.11.2017;2017;11;05;Keskiviikko;0;4;4
626;01.11.2017;2017;11;06;Keskiviikko;3;7;10
626;01.11.2017;2017;11;07;Keskiviikko;4;9;13
626;01.11.2017;2017;11;08;Keskiviikko;6;18;24
626;01.11.2017;2017;11;09;Keskiviikko;8;15;23
626;01.11.2017;2017;11;10;Keskiviikko;3;7;10
626;01.11.2017;2017;11;11;Keskiviikko;2;2;4
626;01.11.2017;2017;11;12;Keskiviikko;4;2;6
626;01.11.2017;2017;11;13;Keskiviikko;3;9;12
626;01.11.2017;2017;11;14;Keskiviikko;4;4;8
626;01.11.2017;2017;11;15;Keskiviikko;10;4;14
626;01.11.2017;2017;11;16;Keskiviikko;19;3;22
626;01.11.2017;2017;11;17;Keskiviikko;21;11;32
626;01.11.2017;2017;11;18;Keskiviikko;17;7;24
626;01.11.2017;2017;11;19;Keskiviikko;3;0;3
626;01.11.2017;2017;11;20;Keskiviikko;8;3;11
626;01.11.2017;2017;11;21;Keskiviikko;4;2;6
626;01.11.2017;2017;11;22;Keskiviikko;6;1;7
626;01.11.2017;2017;11;23;Keskiviikko;0;0;0
626;02.11.2017;2017;11;00;Torstai;1;0;1
626;02.11.2017;2017;11;01;Torstai;0;0;0
626;02.11.2017;2017;11;02;Torstai;0;0;0
626;02.11.2017;2017;11;03;Torstai;0;0;0
626;02.11.2017;2017;11;04;Torstai;0;0;0
626;02.11.2017;2017;11;05;Torstai;0;2;2
626;02.11.2017;2017;11;06;Torstai;3;4;7
626;02.11.2017;2017;11;07;Torstai;2;16;18
626;02.11.2017;2017;11;08;Torstai;9;21;30
626;02.11.2017;2017;11;09;Torstai;8;16;24
626;02.11.2017;2017;11;10;Torstai;7;15;22
626;02.11.2017;2017;11;11;Torstai;1;7;8
626;02.11.2017;2017;11;12;Torstai;4;3;7
626;02.11.2017;2017;11;13;Torstai;6;6;12
626;02.11.2017;2017;11;14;Torstai;6;7;13
626;02.11.2017;2017;11;15;Torstai;10;4;14
626;02.11.2017;2017;11;16;Torstai;14;8;22
626;02.11.2017;2017;11;17;Torstai;30;5;35
626;02.11.2017;2017;11;18;Torstai;7;7;14
626;02.11.2017;2017;11;19;Torstai;11;4;15
626;02.11.2017;2017;11;20;Torstai;5;1;6
626;02.11.2017;2017;11;21;Torstai;3;3;6
626;02.11.2017;2017;11;22;Torstai;2;3;5
626;02.11.2017;2017;11;23;Torstai;2;1;3
626;03.11.2017;2017;11;00;Perjantai;0;1;1
626;03.11.2017;2017;11;01;Perjantai;0;0;0
626;03.11.2017;2017;11;02;Perjantai;0;0;0
626;03.11.2017;2017;11;03;Perjantai;0;1;1
626;03.11.2017;2017;11;04;Perjantai;0;0;0
626;03.11.2017;2017;11;05;Perjantai;0;5;5
626;03.11.2017;2017;11;06;Perjantai;3;8;11
626;03.11.2017;2017;11;07;Perjantai;3;12;15
626;03.11.2017;2017;11;08;Perjantai;3;23;26
626;03.11.2017;2017;11;09;Perjantai;5;16;21
626;03.11.2017;2017;11;10;Perjantai;3;9;12
626;03.11.2017;2017;11;11;Perjantai;2;4;6
626;03.11.2017;2017;11;12;Perjantai;0;1;1
626;03.11.2017;2017;11;13;Perjantai;0;0;0
626;03.11.2017;2017;11;14;Perjantai;0;0;0
626;03.11.2017;2017;11;15;Perjantai;3;2;5
626;03.11.2017;2017;11;16;Perjantai;24;5;29
626;03.11.2017;2017;11;17;Perjantai;16;9;25
626;03.11.2017;2017;11;18;Perjantai;8;6;14
626;03.11.2017;2017;11;19;Perjantai;7;3;10
626;03.11.2017;2017;11;20;Perjantai;6;3;9
626;03.11.2017;2017;11;21;Perjantai;2;4;6
626;03.11.2017;2017;11;22;Perjantai;2;3;5
626;03.11.2017;2017;11;23;Perjantai;2;0;2
626;04.11.2017;2017;11;00;Lauantai;1;1;2
626;04.11.2017;2017;11;01;Lauantai;2;1;3
626;04.11.2017;2017;11;02;Lauantai;2;2;4
626;04.11.2017;2017;11;03;Lauantai;1;0;1
626;04.11.2017;2017;11;04;Lauantai;0;0;0
626;04.11.2017;2017;11;05;Lauantai;0;1;1
626;04.11.2017;2017;11;06;Lauantai;2;3;5
626;04.11.2017;2017;11;07;Lauantai;1;1;2
626;04.11.2017;2017;11;08;Lauantai;0;1;1
626;04.11.2017;2017;11;09;Lauantai;3;1;4
626;04.11.2017;2017;11;10;Lauantai;2;5;7
626;04.11.2017;2017;11;11;Lauantai;7;3;10
626;04.11.2017;2017;11;12;Lauantai;4;9;13
626;04.11.2017;2017;11;13;Lauantai;5;9;14
626;04.11.2017;2017;11;14;Lauantai;8;4;12
626;04.11.2017;2017;11;15;Lauantai;3;6;9
626;04.11.2017;2017;11;16;Lauantai;0;8;8
626;04.11.2017;2017;11;17;Lauantai;4;2;6
626;04.11.2017;2017;11;18;Lauantai;1;2;3
626;04.11.2017;2017;11;19;Lauantai;1;2;3
626;04.11.2017;2017;11;20;Lauantai;2;2;4
626;04.11.2017;2017;11;21;Lauantai;2;0;2
626;04.11.2017;2017;11;22;Lauantai;1;1;2
626;04.11.2017;2017;11;23;Lauantai;4;2;6
626;05.11.2017;2017;11;00;Sunnuntai;0;1;1
626;05.11.2017;2017;11;01;Sunnuntai;1;0;1
626;05.11.2017;2017;11;02;Sunnuntai;1;0;1
626;05.11.2017;2017;11;03;Sunnuntai;1;0;1
626;05.11.2017;2017;11;04;Sunnuntai;0;0;0
626;05.11.2017;2017;11;05;Sunnuntai;1;0;1
626;05.11.2017;2017;11;06;Sunnuntai;1;3;4
626;05.11.2017;2017;11;07;Sunnuntai;1;0;1
626;05.11.2017;2017;11;08;Sunnuntai;1;0;1
626;05.11.2017;2017;11;09;Sunnuntai;2;2;4
626;05.11.2017;2017;11;10;Sunnuntai;5;2;7
626;05.11.2017;2017;11;11;Sunnuntai;5;5;10
626;05.11.2017;2017;11;12;Sunnuntai;4;16;20
626;05.11.2017;2017;11;13;Sunnuntai;6;11;17
626;05.11.2017;2017;11;14;Sunnuntai;10;8;18
626;05.11.2017;2017;11;15;Sunnuntai;4;1;5
626;05.11.2017;2017;11;16;Sunnuntai;6;15;21
626;05.11.2017;2017;11;17;Sunnuntai;6;2;8
626;05.11.2017;2017;11;18;Sunnuntai;1;6;7
626;05.11.2017;2017;11;19;Sunnuntai;2;2;4
626;05.11.2017;2017;11;20;Sunnuntai;3;3;6
626;05.11.2017;2017;11;21;Sunnuntai;4;1;5
626;05.11.2017;2017;11;22;Sunnuntai;3;0;3
626;05.11.2017;2017;11;23;Sunnuntai;2;0;2
626;06.11.2017;2017;11;00;Maanantai;0;0;0
626;06.11.2017;2017;11;01;Maanantai;0;0;0
626;06.11.2017;2017;11;02;Maanantai;0;0;0
626;06.11.2017;2017;11;03;Maanantai;0;0;0
626;06.11.2017;2017;11;04;Maanantai;0;0;0
626;06.11.2017;2017;11;05;Maanantai;0;3;3
626;06.11.2017;2017;11;06;Maanantai;2;6;8
626;06.11.2017;2017;11;07;Maanantai;7;16;23
626;06.11.2017;2017;11;08;Maanantai;8;28;36
626;06.11.2017;2017;11;09;Maanantai;7;23;30
626;06.11.2017;2017;11;10;Maanantai;7;10;17
626;06.11.2017;2017;11;11;Maanantai;3;9;12
626;06.11.2017;2017;11;12;Maanantai;2;10;12
626;06.11.2017;2017;11;13;Maanantai;10;5;15
626;06.11.2017;2017;11;14;Maanantai;6;5;11
626;06.11.2017;2017;11;15;Maanantai;10;2;12
626;06.11.2017;2017;11;16;Maanantai;10;11;21
626;06.11.2017;2017;11;17;Maanantai;22;14;36
626;06.11.2017;2017;11;18;Maanantai;13;8;21
626;06.11.2017;2017;11;19;Maanantai;10;8;18
626;06.11.2017;2017;11;20;Maanantai;8;4;12
626;06.11.2017;2017;11;21;Maanantai;6;1;7
626;06.11.2017;2017;11;22;Maanantai;3;5;8
626;06.11.2017;2017;11;23;Maanantai;2;2;4
626;07.11.2017;2017;11;00;Tiistai;0;0;0
626;07.11.2017;2017;11;01;Tiistai;2;0;2
626;07.11.2017;2017;11;02;Tiistai;0;0;0
626;07.11.2017;2017;11;03;Tiistai;0;0;0
626;07.11.2017;2017;11;04;Tiistai;0;0;0
626;07.11.2017;2017;11;05;Tiistai;1;1;2
626;07.11.2017;2017;11;06;Tiistai;2;6;8
626;07.11.2017;2017;11;07;Tiistai;7;28;35
626;07.11.2017;2017;11;08;Tiistai;9;47;56
626;07.11.2017;2017;11;09;Tiistai;11;26;37
626;07.11.2017;2017;11;10;Tiistai;6;12;18
626;07.11.2017;2017;11;11;Tiistai;5;14;19
626;07.11.2017;2017;11;12;Tiistai;6;15;21
626;07.11.2017;2017;11;13;Tiistai;8;9;17
626;07.11.2017;2017;11;14;Tiistai;10;9;19
626;07.11.2017;2017;11;15;Tiistai;14;11;25
626;07.11.2017;2017;11;16;Tiistai;31;13;44
626;07.11.2017;2017;11;17;Tiistai;37;17;54
626;07.11.2017;2017;11;18;Tiistai;14;9;23
626;07.11.2017;2017;11;19;Tiistai;9;5;14
626;07.11.2017;2017;11;20;Tiistai;10;2;12
626;07.11.2017;2017;11;21;Tiistai;7;1;8
626;07.11.2017;2017;11;22;Tiistai;6;5;11
626;07.11.2017;2017;11;23;Tiistai;1;0;1
626;08.11.2017;2017;11;00;Keskiviikko;0;1;1
626;08.11.2017;2017;11;01;Keskiviikko;0;0;0
626;08.11.2017;2017;11;02;Keskiviikko;0;0;0
626;08.11.2017;2017;11;03;Keskiviikko;0;0;0
626;08.11.2017;2017;11;04;Keskiviikko;0;0;0
626;08.11.2017;2017;11;05;Keskiviikko;0;5;5
626;08.11.2017;2017;11;06;Keskiviikko;5;10;15
626;08.11.2017;2017;11;07;Keskiviikko;7;19;26
626;08.11.2017;2017;11;08;Keskiviikko;9;33;42
626;08.11.2017;2017;11;09;Keskiviikko;7;26;33
626;08.11.2017;2017;11;10;Keskiviikko;5;11;16
626;08.11.2017;2017;11;11;Keskiviikko;1;7;8
626;08.11.2017;2017;11;12;Keskiviikko;11;10;21
626;08.11.2017;2017;11;13;Keskiviikko;10;10;20
626;08.11.2017;2017;11;14;Keskiviikko;7;7;14
626;08.11.2017;2017;11;15;Keskiviikko;15;9;24
626;08.11.2017;2017;11;16;Keskiviikko;23;10;33
626;08.11.2017;2017;11;17;Keskiviikko;34;13;47
626;08.11.2017;2017;11;18;Keskiviikko;19;12;31
626;08.11.2017;2017;11;19;Keskiviikko;13;7;20
626;08.11.2017;2017;11;20;Keskiviikko;6;6;12
626;08.11.2017;2017;11;21;Keskiviikko;8;0;8
626;08.11.2017;2017;11;22;Keskiviikko;3;3;6
626;08.11.2017;2017;11;23;Keskiviikko;0;0;0
626;09.11.2017;2017;11;00;Torstai;0;1;1
626;09.11.2017;2017;11;01;Torstai;0;1;1
626;09.11.2017;2017;11;02;Torstai;0;0;0
626;09.11.2017;2017;11;03;Torstai;0;0;0
626;09.11.2017;2017;11;04;Torstai;1;0;1
626;09.11.2017;2017;11;05;Torstai;0;2;2
626;09.11.2017;2017;11;06;Torstai;4;9;13
626;09.11.2017;2017;11;07;Torstai;5;27;32
626;09.11.2017;2017;11;08;Torstai;5;34;39
626;09.11.2017;2017;11;09;Torstai;8;28;36
626;09.11.2017;2017;11;10;Torstai;1;10;11
626;09.11.2017;2017;11;11;Torstai;3;9;12
626;09.11.2017;2017;11;12;Torstai;8;7;15
626;09.11.2017;2017;11;13;Torstai;9;15;24
626;09.11.2017;2017;11;14;Torstai;7;7;14
626;09.11.2017;2017;11;15;Torstai;17;11;28
626;09.11.2017;2017;11;16;Torstai;23;11;34
626;09.11.2017;2017;11;17;Torstai;33;14;47
626;09.11.2017;2017;11;18;Torstai;20;10;30
626;09.11.2017;2017;11;19;Torstai;13;4;17
626;09.11.2017;2017;11;20;Torstai;11;3;14
626;09.11.2017;2017;11;21;Torstai;4;2;6
626;09.11.2017;2017;11;22;Torstai;3;5;8
626;09.11.2017;2017;11;23;Torstai;1;0;1
626;10.11.2017;2017;11;00;Perjantai;0;1;1
626;10.11.2017;2017;11;01;Perjantai;2;1;3
626;10.11.2017;2017;11;02;Perjantai;0;0;0
626;10.11.2017;2017;11;03;Perjantai;0;1;1
626;10.11.2017;2017;11;04;Perjantai;0;1;1
626;10.11.2017;2017;11;05;Perjantai;2;2;4
626;10.11.2017;2017;11;06;Perjantai;3;11;14
626;10.11.2017;2017;11;07;Perjantai;3;16;19
626;10.11.2017;2017;11;08;Perjantai;9;28;37
626;10.11.2017;2017;11;09;Perjantai;7;23;30
626;10.11.2017;2017;11;10;Perjantai;6;14;20
626;10.11.2017;2017;11;11;Perjantai;6;13;19
626;10.11.2017;2017;11;12;Perjantai;3;4;7
626;10.11.2017;2017;11;13;Perjantai;10;14;24
626;10.11.2017;2017;11;14;Perjantai;9;7;16
626;10.11.2017;2017;11;15;Perjantai;16;4;20
626;10.11.2017;2017;11;16;Perjantai;26;9;35
626;10.11.2017;2017;11;17;Perjantai;18;11;29
626;10.11.2017;2017;11;18;Perjantai;6;9;15
626;10.11.2017;2017;11;19;Perjantai;11;4;15
626;10.11.2017;2017;11;20;Perjantai;4;5;9
626;10.11.2017;2017;11;21;Perjantai;3;2;5
626;10.11.2017;2017;11;22;Perjantai;3;2;5
626;10.11.2017;2017;11;23;Perjantai;3;0;3
626;11.11.2017;2017;11;00;Lauantai;1;0;1
626;11.11.2017;2017;11;01;Lauantai;0;0;0
626;11.11.2017;2017;11;02;Lauantai;0;0;0
626;11.11.2017;2017;11;03;Lauantai;1;0;1
626;11.11.2017;2017;11;04;Lauantai;0;0;0
626;11.11.2017;2017;11;05;Lauantai;0;0;0
626;11.11.2017;2017;11;06;Lauantai;0;1;1
626;11.11.2017;2017;11;07;Lauantai;2;1;3
626;11.11.2017;2017;11;08;Lauantai;1;2;3
626;11.11.2017;2017;11;09;Lauantai;0;6;6
626;11.11.2017;2017;11;10;Lauantai;3;9;12
626;11.11.2017;2017;11;11;Lauantai;7;6;13
626;11.11.2017;2017;11;12;Lauantai;7;7;14
626;11.11.2017;2017;11;13;Lauantai;12;12;24
626;11.11.2017;2017;11;14;Lauantai;10;13;23
626;11.11.2017;2017;11;15;Lauantai;10;8;18
626;11.11.2017;2017;11;16;Lauantai;8;8;16
626;11.11.2017;2017;11;17;Lauantai;7;7;14
626;11.11.2017;2017;11;18;Lauantai;2;5;7
626;11.11.2017;2017;11;19;Lauantai;5;1;6
626;11.11.2017;2017;11;20;Lauantai;2;2;4
626;11.11.2017;2017;11;21;Lauantai;2;1;3
626;11.11.2017;2017;11;22;Lauantai;3;1;4
626;11.11.2017;2017;11;23;Lauantai;1;1;2
626;12.11.2017;2017;11;00;Sunnuntai;3;1;4
626;12.11.2017;2017;11;01;Sunnuntai;0;2;2
626;12.11.2017;2017;11;02;Sunnuntai;1;0;1
626;12.11.2017;2017;11;03;Sunnuntai;0;0;0
626;12.11.2017;2017;11;04;Sunnuntai;0;1;1
626;12.11.2017;2017;11;05;Sunnuntai;0;0;0
626;12.11.2017;2017;11;06;Sunnuntai;0;2;2
626;12.11.2017;2017;11;07;Sunnuntai;1;1;2
626;12.11.2017;2017;11;08;Sunnuntai;0;1;1
626;12.11.2017;2017;11;09;Sunnuntai;1;2;3
626;12.11.2017;2017;11;10;Sunnuntai;0;2;2
626;12.11.2017;2017;11;11;Sunnuntai;4;5;9
626;12.11.2017;2017;11;12;Sunnuntai;5;8;13
626;12.11.2017;2017;11;13;Sunnuntai;11;15;26
626;12.11.2017;2017;11;14;Sunnuntai;10;6;16
626;12.11.2017;2017;11;15;Sunnuntai;7;3;10
626;12.11.2017;2017;11;16;Sunnuntai;3;7;10
626;12.11.2017;2017;11;17;Sunnuntai;5;6;11
626;12.11.2017;2017;11;18;Sunnuntai;1;4;5
626;12.11.2017;2017;11;19;Sunnuntai;3;4;7
626;12.11.2017;2017;11;20;Sunnuntai;4;6;10
626;12.11.2017;2017;11;21;Sunnuntai;7;1;8
626;12.11.2017;2017;11;22;Sunnuntai;1;2;3
626;12.11.2017;2017;11;23;Sunnuntai;1;1;2
626;13.11.2017;2017;11;00;Maanantai;0;0;0
626;13.11.2017;2017;11;01;Maanantai;3;0;3
626;13.11.2017;2017;11;02;Maanantai;0;0;0
626;13.11.2017;2017;11;03;Maanantai;0;0;0
626;13.11.2017;2017;11;04;Maanantai;0;2;2
626;13.11.2017;2017;11;05;Maanantai;1;2;3
626;13.11.2017;2017;11;06;Maanantai;5;8;13
626;13.11.2017;2017;11;07;Maanantai;3;22;25
626;13.11.2017;2017;11;08;Maanantai;4;39;43
626;13.11.2017;2017;11;09;Maanantai;10;27;37
626;13.11.2017;2017;11;10;Maanantai;5;12;17
626;13.11.2017;2017;11;11;Maanantai;4;9;13
626;13.11.2017;2017;11;12;Maanantai;5;10;15
626;13.11.2017;2017;11;13;Maanantai;8;7;15
626;13.11.2017;2017;11;14;Maanantai;8;10;18
626;13.11.2017;2017;11;15;Maanantai;20;10;30
626;13.11.2017;2017;11;16;Maanantai;22;12;34
626;13.11.2017;2017;11;17;Maanantai;26;12;38
626;13.11.2017;2017;11;18;Maanantai;16;12;28
626;13.11.2017;2017;11;19;Maanantai;11;4;15
626;13.11.2017;2017;11;20;Maanantai;5;5;10
626;13.11.2017;2017;11;21;Maanantai;9;4;13
626;13.11.2017;2017;11;22;Maanantai;4;4;8
626;13.11.2017;2017;11;23;Maanantai;2;2;4
626;14.11.2017;2017;11;00;Tiistai;0;0;0
626;14.11.2017;2017;11;01;Tiistai;0;0;0
626;14.11.2017;2017;11;02;Tiistai;0;0;0
626;14.11.2017;2017;11;03;Tiistai;0;0;0
626;14.11.2017;2017;11;04;Tiistai;0;0;0
626;14.11.2017;2017;11;05;Tiistai;0;4;4
626;14.11.2017;2017;11;06;Tiistai;4;9;13
626;14.11.2017;2017;11;07;Tiistai;10;20;30
626;14.11.2017;2017;11;08;Tiistai;11;43;54
626;14.11.2017;2017;11;09;Tiistai;7;22;29
626;14.11.2017;2017;11;10;Tiistai;4;11;15
626;14.11.2017;2017;11;11;Tiistai;4;12;16
626;14.11.2017;2017;11;12;Tiistai;5;5;10
626;14.11.2017;2017;11;13;Tiistai;7;6;13
626;14.11.2017;2017;11;14;Tiistai;6;12;18
626;14.11.2017;2017;11;15;Tiistai;13;9;22
626;14.11.2017;2017;11;16;Tiistai;26;11;37
626;14.11.2017;2017;11;17;Tiistai;32;14;46
626;14.11.2017;2017;11;18;Tiistai;22;5;27
626;14.11.2017;2017;11;19;Tiistai;11;5;16
626;14.11.2017;2017;11;20;Tiistai;15;6;21
626;14.11.2017;2017;11;21;Tiistai;5;3;8
626;14.11.2017;2017;11;22;Tiistai;10;4;14
626;14.11.2017;2017;11;23;Tiistai;4;3;7
626;15.11.2017;2017;11;00;Keskiviikko;0;1;1
626;15.11.2017;2017;11;01;Keskiviikko;0;0;0
626;15.11.2017;2017;11;02;Keskiviikko;0;0;0
626;15.11.2017;2017;11;03;Keskiviikko;0;0;0
626;15.11.2017;2017;11;04;Keskiviikko;0;0;0
626;15.11.2017;2017;11;05;Keskiviikko;0;4;4
626;15.11.2017;2017;11;06;Keskiviikko;2;10;12
626;15.11.2017;2017;11;07;Keskiviikko;5;27;32
626;15.11.2017;2017;11;08;Keskiviikko;9;41;50
626;15.11.2017;2017;11;09;Keskiviikko;8;22;30
626;15.11.2017;2017;11;10;Keskiviikko;0;8;8
626;15.11.2017;2017;11;11;Keskiviikko;2;0;2
626;15.11.2017;2017;11;12;Keskiviikko;2;8;10
626;15.11.2017;2017;11;13;Keskiviikko;2;8;10
626;15.11.2017;2017;11;14;Keskiviikko;6;5;11
626;15.11.2017;2017;11;15;Keskiviikko;9;3;12
626;15.11.2017;2017;11;16;Keskiviikko;19;9;28
626;15.11.2017;2017;11;17;Keskiviikko;16;10;26
626;15.11.2017;2017;11;18;Keskiviikko;16;9;25
626;15.11.2017;2017;11;19;Keskiviikko;9;4;13
626;15.11.2017;2017;11;20;Keskiviikko;9;3;12
626;15.11.2017;2017;11;21;Keskiviikko;8;2;10
626;15.11.2017;2017;11;22;Keskiviikko;7;3;10
626;15.11.2017;2017;11;23;Keskiviikko;2;0;2
626;16.11.2017;2017;11;00;Torstai;0;0;0
626;16.11.2017;2017;11;01;Torstai;0;0;0
626;16.11.2017;2017;11;02;Torstai;0;0;0
626;16.11.2017;2017;11;03;Torstai;0;0;0
626;16.11.2017;2017;11;04;Torstai;0;0;0
626;16.11.2017;2017;11;05;Torstai;0;4;4
626;16.11.2017;2017;11;06;Torstai;2;7;9
626;16.11.2017;2017;11;07;Torstai;5;21;26
626;16.11.2017;2017;11;08;Torstai;4;32;36
626;16.11.2017;2017;11;09;Torstai;8;16;24
626;16.11.2017;2017;11;10;Torstai;2;11;13
626;16.11.2017;2017;11;11;Torstai;6;8;14
626;16.11.2017;2017;11;12;Torstai;7;7;14
626;16.11.2017;2017;11;13;Torstai;6;8;14
626;16.11.2017;2017;11;14;Torstai;9;7;16
626;16.11.2017;2017;11;15;Torstai;11;9;20
626;16.11.2017;2017;11;16;Torstai;32;10;42
626;16.11.2017;2017;11;17;Torstai;35;7;42
626;16.11.2017;2017;11;18;Torstai;21;14;35
626;16.11.2017;2017;11;19;Torstai;10;6;16
626;16.11.2017;2017;11;20;Torstai;6;6;12
626;16.11.2017;2017;11;21;Torstai;7;3;10
626;16.11.2017;2017;11;22;Torstai;5;2;7
626;16.11.2017;2017;11;23;Torstai;2;1;3
626;17.11.2017;2017;11;00;Perjantai;0;2;2
626;17.11.2017;2017;11;01;Perjantai;0;1;1
626;17.11.2017;2017;11;02;Perjantai;0;0;0
626;17.11.2017;2017;11;03;Perjantai;0;0;0
626;17.11.2017;2017;11;04;Perjantai;0;0;0
626;17.11.2017;2017;11;05;Perjantai;0;1;1
626;17.11.2017;2017;11;06;Perjantai;3;6;9
626;17.11.2017;2017;11;07;Perjantai;2;24;26
626;17.11.2017;2017;11;08;Perjantai;9;25;34
626;17.11.2017;2017;11;09;Perjantai;6;20;26
626;17.11.2017;2017;11;10;Perjantai;6;6;12
626;17.11.2017;2017;11;11;Perjantai;2;4;6
626;17.11.2017;2017;11;12;Perjantai;1;5;6
626;17.11.2017;2017;11;13;Perjantai;4;5;9
626;17.11.2017;2017;11;14;Perjantai;10;8;18
626;17.11.2017;2017;11;15;Perjantai;9;4;13
626;17.11.2017;2017;11;16;Perjantai;21;9;30
626;17.11.2017;2017;11;17;Perjantai;18;8;26
626;17.11.2017;2017;11;18;Perjantai;9;4;13
626;17.11.2017;2017;11;19;Perjantai;5;2;7
626;17.11.2017;2017;11;20;Perjantai;4;2;6
626;17.11.2017;2017;11;21;Perjantai;4;1;5
626;17.11.2017;2017;11;22;Perjantai;7;1;8
626;17.11.2017;2017;11;23;Perjantai;0;1;1
626;18.11.2017;2017;11;00;Lauantai;2;0;2
626;18.11.2017;2017;11;01;Lauantai;0;1;1
626;18.11.2017;2017;11;02;Lauantai;0;0;0
626;18.11.2017;2017;11;03;Lauantai;1;0;1
626;18.11.2017;2017;11;04;Lauantai;0;0;0
626;18.11.2017;2017;11;05;Lauantai;0;0;0
626;18.11.2017;2017;11;06;Lauantai;1;4;5
626;18.11.2017;2017;11;07;Lauantai;0;1;1
626;18.11.2017;2017;11;08;Lauantai;0;2;2
626;18.11.2017;2017;11;09;Lauantai;2;3;5
626;18.11.2017;2017;11;10;Lauantai;0;5;5
626;18.11.2017;2017;11;11;Lauantai;2;5;7
626;18.11.2017;2017;11;12;Lauantai;3;2;5
626;18.11.2017;2017;11;13;Lauantai;6;11;17
626;18.11.2017;2017;11;14;Lauantai;7;3;10
626;18.11.2017;2017;11;15;Lauantai;6;4;10
626;18.11.2017;2017;11;16;Lauantai;6;7;13
626;18.11.2017;2017;11;17;Lauantai;7;2;9
626;18.11.2017;2017;11;18;Lauantai;4;2;6
626;18.11.2017;2017;11;19;Lauantai;5;5;10
626;18.11.2017;2017;11;20;Lauantai;2;1;3
626;18.11.2017;2017;11;21;Lauantai;1;4;5
626;18.11.2017;2017;11;22;Lauantai;1;0;1
626;18.11.2017;2017;11;23;Lauantai;1;1;2
626;19.11.2017;2017;11;00;Sunnuntai;1;0;1
626;19.11.2017;2017;11;01;Sunnuntai;1;1;2
626;19.11.2017;2017;11;02;Sunnuntai;1;0;1
626;19.11.2017;2017;11;03;Sunnuntai;0;0;0
626;19.11.2017;2017;11;04;Sunnuntai;0;0;0
626;19.11.2017;2017;11;05;Sunnuntai;1;0;1
626;19.11.2017;2017;11;06;Sunnuntai;0;4;4
626;19.11.2017;2017;11;07;Sunnuntai;0;0;0
626;19.11.2017;2017;11;08;Sunnuntai;0;1;1
626;19.11.2017;2017;11;09;Sunnuntai;1;1;2
626;19.11.2017;2017;11;10;Sunnuntai;1;4;5
626;19.11.2017;2017;11;11;Sunnuntai;1;4;5
626;19.11.2017;2017;11;12;Sunnuntai;4;2;6
626;19.11.2017;2017;11;13;Sunnuntai;7;1;8
626;19.11.2017;2017;11;14;Sunnuntai;7;10;17
626;19.11.2017;2017;11;15;Sunnuntai;4;2;6
626;19.11.2017;2017;11;16;Sunnuntai;3;1;4
626;19.11.2017;2017;11;17;Sunnuntai;1;2;3
626;19.11.2017;2017;11;18;Sunnuntai;5;4;9
626;19.11.2017;2017;11;19;Sunnuntai;4;7;11
626;19.11.2017;2017;11;20;Sunnuntai;1;3;4
626;19.11.2017;2017;11;21;Sunnuntai;4;0;4
626;19.11.2017;2017;11;22;Sunnuntai;2;2;4
626;19.11.2017;2017;11;23;Sunnuntai;3;0;3
626;20.11.2017;2017;11;00;Maanantai;0;1;1
626;20.11.2017;2017;11;01;Maanantai;0;0;0
626;20.11.2017;2017;11;02;Maanantai;0;0;0
626;20.11.2017;2017;11;03;Maanantai;0;1;1
626;20.11.2017;2017;11;04;Maanantai;0;1;1
626;20.11.2017;2017;11;05;Maanantai;0;5;5
626;20.11.2017;2017;11;06;Maanantai;2;7;9
626;20.11.2017;2017;11;07;Maanantai;2;24;26
626;20.11.2017;2017;11;08;Maanantai;9;27;36
626;20.11.2017;2017;11;09;Maanantai;11;27;38
626;20.11.2017;2017;11;10;Maanantai;3;13;16
626;20.11.2017;2017;11;11;Maanantai;4;6;10
626;20.11.2017;2017;11;12;Maanantai;4;5;9
626;20.11.2017;2017;11;13;Maanantai;6;9;15
626;20.11.2017;2017;11;14;Maanantai;9;3;12
626;20.11.2017;2017;11;15;Maanantai;11;4;15
626;20.11.2017;2017;11;16;Maanantai;20;8;28
626;20.11.2017;2017;11;17;Maanantai;28;15;43
626;20.11.2017;2017;11;18;Maanantai;18;12;30
626;20.11.2017;2017;11;19;Maanantai;11;5;16
626;20.11.2017;2017;11;20;Maanantai;11;6;17
626;20.11.2017;2017;11;21;Maanantai;7;0;7
626;20.11.2017;2017;11;22;Maanantai;5;3;8
626;20.11.2017;2017;11;23;Maanantai;0;1;1
626;21.11.2017;2017;11;00;Tiistai;0;2;2
626;21.11.2017;2017;11;01;Tiistai;1;0;1
626;21.11.2017;2017;11;02;Tiistai;0;1;1
626;21.11.2017;2017;11;03;Tiistai;0;0;0
626;21.11.2017;2017;11;04;Tiistai;0;0;0
626;21.11.2017;2017;11;05;Tiistai;0;2;2
626;21.11.2017;2017;11;06;Tiistai;1;10;11
626;21.11.2017;2017;11;07;Tiistai;7;22;29
626;21.11.2017;2017;11;08;Tiistai;7;39;46
626;21.11.2017;2017;11;09;Tiistai;13;21;34
626;21.11.2017;2017;11;10;Tiistai;1;7;8
626;21.11.2017;2017;11;11;Tiistai;2;8;10
626;21.11.2017;2017;11;12;Tiistai;4;6;10
626;21.11.2017;2017;11;13;Tiistai;2;7;9
626;21.11.2017;2017;11;14;Tiistai;11;6;17
626;21.11.2017;2017;11;15;Tiistai;13;6;19
626;21.11.2017;2017;11;16;Tiistai;24;11;35
626;21.11.2017;2017;11;17;Tiistai;29;16;45
626;21.11.2017;2017;11;18;Tiistai;14;7;21
626;21.11.2017;2017;11;19;Tiistai;14;5;19
626;21.11.2017;2017;11;20;Tiistai;5;0;5
626;21.11.2017;2017;11;21;Tiistai;10;3;13
626;21.11.2017;2017;11;22;Tiistai;9;0;9
626;21.11.2017;2017;11;23;Tiistai;3;1;4
626;22.11.2017;2017;11;00;Keskiviikko;1;0;1
626;22.11.2017;2017;11;01;Keskiviikko;0;1;1
626;22.11.2017;2017;11;02;Keskiviikko;0;0;0
626;22.11.2017;2017;11;03;Keskiviikko;0;0;0
626;22.11.2017;2017;11;04;Keskiviikko;0;0;0
626;22.11.2017;2017;11;05;Keskiviikko;0;4;4
626;22.11.2017;2017;11;06;Keskiviikko;2;6;8
626;22.11.2017;2017;11;07;Keskiviikko;6;27;33
626;22.11.2017;2017;11;08;Keskiviikko;10;36;46
626;22.11.2017;2017;11;09;Keskiviikko;10;17;27
626;22.11.2017;2017;11;10;Keskiviikko;3;12;15
626;22.11.2017;2017;11;11;Keskiviikko;0;8;8
626;22.11.2017;2017;11;12;Keskiviikko;6;3;9
626;22.11.2017;2017;11;13;Keskiviikko;4;8;12
626;22.11.2017;2017;11;14;Keskiviikko;10;4;14
626;22.11.2017;2017;11;15;Keskiviikko;11;1;12
626;22.11.2017;2017;11;16;Keskiviikko;27;12;39
626;22.11.2017;2017;11;17;Keskiviikko;23;10;33
626;22.11.2017;2017;11;18;Keskiviikko;24;8;32
626;22.11.2017;2017;11;19;Keskiviikko;9;3;12
626;22.11.2017;2017;11;20;Keskiviikko;7;1;8
626;22.11.2017;2017;11;21;Keskiviikko;7;1;8
626;22.11.2017;2017;11;22;Keskiviikko;2;4;6
626;22.11.2017;2017;11;23;Keskiviikko;0;2;2
626;23.11.2017;2017;11;00;Torstai;0;0;0
626;23.11.2017;2017;11;01;Torstai;0;0;0
626;23.11.2017;2017;11;02;Torstai;0;0;0
626;23.11.2017;2017;11;03;Torstai;0;0;0
626;23.11.2017;2017;11;04;Torstai;0;0;0
626;23.11.2017;2017;11;05;Torstai;0;2;2
626;23.11.2017;2017;11;06;Torstai;3;11;14
626;23.11.2017;2017;11;07;Torstai;1;13;14
626;23.11.2017;2017;11;08;Torstai;11;28;39
626;23.11.2017;2017;11;09;Torstai;6;20;26
626;23.11.2017;2017;11;10;Torstai;5;10;15
626;23.11.2017;2017;11;11;Torstai;6;8;14
626;23.11.2017;2017;11;12;Torstai;5;4;9
626;23.11.2017;2017;11;13;Torstai;3;5;8
626;23.11.2017;2017;11;14;Torstai;10;2;12
626;23.11.2017;2017;11;15;Torstai;9;5;14
626;23.11.2017;2017;11;16;Torstai;11;6;17
626;23.11.2017;2017;11;17;Torstai;15;6;21
626;23.11.2017;2017;11;18;Torstai;14;5;19
626;23.11.2017;2017;11;19;Torstai;9;3;12
626;23.11.2017;2017;11;20;Torstai;8;1;9
626;23.11.2017;2017;11;21;Torstai;3;0;3
626;23.11.2017;2017;11;22;Torstai;0;0;0
626;23.11.2017;2017;11;23;Torstai;2;2;4
626;24.11.2017;2017;11;00;Perjantai;0;0;0
626;24.11.2017;2017;11;01;Perjantai;0;0;0
626;24.11.2017;2017;11;02;Perjantai;0;0;0
626;24.11.2017;2017;11;03;Perjantai;0;0;0
626;24.11.2017;2017;11;04;Perjantai;2;0;2
626;24.11.2017;2017;11;05;Perjantai;0;0;0
626;24.11.2017;2017;11;06;Perjantai;0;8;8
626;24.11.2017;2017;11;07;Perjantai;2;10;12
626;24.11.2017;2017;11;08;Perjantai;5;12;17
626;24.11.2017;2017;11;09;Perjantai;3;11;14
626;24.11.2017;2017;11;10;Perjantai;2;2;4
626;24.11.2017;2017;11;11;Perjantai;1;4;5
626;24.11.2017;2017;11;12;Perjantai;3;2;5
626;24.11.2017;2017;11;13;Perjantai;2;6;8
626;24.11.2017;2017;11;14;Perjantai;5;4;9
626;24.11.2017;2017;11;15;Perjantai;7;5;12
626;24.11.2017;2017;11;16;Perjantai;16;8;24
626;24.11.2017;2017;11;17;Perjantai;16;8;24
626;24.11.2017;2017;11;18;Perjantai;9;6;15
626;24.11.2017;2017;11;19;Perjantai;3;4;7
626;24.11.2017;2017;11;20;Perjantai;2;2;4
626;24.11.2017;2017;11;21;Perjantai;6;2;8
626;24.11.2017;2017;11;22;Perjantai;3;0;3
626;24.11.2017;2017;11;23;Perjantai;3;1;4
626;25.11.2017;2017;11;00;Lauantai;0;0;0
626;25.11.2017;2017;11;01;Lauantai;1;1;2
626;25.11.2017;2017;11;02;Lauantai;1;2;3
626;25.11.2017;2017;11;03;Lauantai;0;0;0
626;25.11.2017;2017;11;04;Lauantai;1;0;1
626;25.11.2017;2017;11;05;Lauantai;1;0;1
626;25.11.2017;2017;11;06;Lauantai;2;1;3
626;25.11.2017;2017;11;07;Lauantai;0;1;1
626;25.11.2017;2017;11;08;Lauantai;0;2;2
626;25.11.2017;2017;11;09;Lauantai;1;2;3
626;25.11.2017;2017;11;10;Lauantai;0;4;4
626;25.11.2017;2017;11;11;Lauantai;3;3;6
626;25.11.2017;2017;11;12;Lauantai;5;2;7
626;25.11.2017;2017;11;13;Lauantai;2;3;5
626;25.11.2017;2017;11;14;Lauantai;3;6;9
626;25.11.2017;2017;11;15;Lauantai;5;3;8
626;25.11.2017;2017;11;16;Lauantai;6;5;11
626;25.11.2017;2017;11;17;Lauantai;3;2;5
626;25.11.2017;2017;11;18;Lauantai;3;2;5
626;25.11.2017;2017;11;19;Lauantai;2;1;3
626;25.11.2017;2017;11;20;Lauantai;2;0;2
626;25.11.2017;2017;11;21;Lauantai;1;1;2
626;25.11.2017;2017;11;22;Lauantai;1;2;3
626;25.11.2017;2017;11;23;Lauantai;1;0;1
626;26.11.2017;2017;11;00;Sunnuntai;1;0;1
626;26.11.2017;2017;11;01;Sunnuntai;1;0;1
626;26.11.2017;2017;11;02;Sunnuntai;1;0;1
626;26.11.2017;2017;11;03;Sunnuntai;2;0;2
626;26.11.2017;2017;11;04;Sunnuntai;0;1;1
626;26.11.2017;2017;11;05;Sunnuntai;0;1;1
626;26.11.2017;2017;11;06;Sunnuntai;0;0;0
626;26.11.2017;2017;11;07;Sunnuntai;0;0;0
626;26.11.2017;2017;11;08;Sunnuntai;0;1;1
626;26.11.2017;2017;11;09;Sunnuntai;0;1;1
626;26.11.2017;2017;11;10;Sunnuntai;3;2;5
626;26.11.2017;2017;11;11;Sunnuntai;1;1;2
626;26.11.2017;2017;11;12;Sunnuntai;1;5;6
626;26.11.2017;2017;11;13;Sunnuntai;4;3;7
626;26.11.2017;2017;11;14;Sunnuntai;2;8;10
626;26.11.2017;2017;11;15;Sunnuntai;7;7;14
626;26.11.2017;2017;11;16;Sunnuntai;4;4;8
626;26.11.2017;2017;11;17;Sunnuntai;4;5;9
626;26.11.2017;2017;11;18;Sunnuntai;2;1;3
626;26.11.2017;2017;11;19;Sunnuntai;0;7;7
626;26.11.2017;2017;11;20;Sunnuntai;3;1;4
626;26.11.2017;2017;11;21;Sunnuntai;4;0;4
626;26.11.2017;2017;11;22;Sunnuntai;2;2;4
626;26.11.2017;2017;11;23;Sunnuntai;1;0;1
626;27.11.2017;2017;11;00;Maanantai;0;0;0
626;27.11.2017;2017;11;01;Maanantai;0;0;0
626;27.11.2017;2017;11;02;Maanantai;0;1;1
626;27.11.2017;2017;11;03;Maanantai;1;0;1
626;27.11.2017;2017;11;04;Maanantai;0;0;0
626;27.11.2017;2017;11;05;Maanantai;0;2;2
626;27.11.2017;2017;11;06;Maanantai;3;5;8
626;27.11.2017;2017;11;07;Maanantai;3;20;23
626;27.11.2017;2017;11;08;Maanantai;2;30;32
626;27.11.2017;2017;11;09;Maanantai;9;19;28
626;27.11.2017;2017;11;10;Maanantai;6;10;16
626;27.11.2017;2017;11;11;Maanantai;1;9;10
626;27.11.2017;2017;11;12;Maanantai;4;5;9
626;27.11.2017;2017;11;13;Maanantai;5;6;11
626;27.11.2017;2017;11;14;Maanantai;4;4;8
626;27.11.2017;2017;11;15;Maanantai;12;11;23
626;27.11.2017;2017;11;16;Maanantai;12;10;22
626;27.11.2017;2017;11;17;Maanantai;25;9;34
626;27.11.2017;2017;11;18;Maanantai;15;9;24
626;27.11.2017;2017;11;19;Maanantai;6;2;8
626;27.11.2017;2017;11;20;Maanantai;10;5;15
626;27.11.2017;2017;11;21;Maanantai;5;1;6
626;27.11.2017;2017;11;22;Maanantai;9;2;11
626;27.11.2017;2017;11;23;Maanantai;2;0;2
626;28.11.2017;2017;11;00;Tiistai;0;1;1
626;28.11.2017;2017;11;01;Tiistai;0;2;2
626;28.11.2017;2017;11;02;Tiistai;0;0;0
626;28.11.2017;2017;11;03;Tiistai;0;0;0
626;28.11.2017;2017;11;04;Tiistai;1;0;1
626;28.11.2017;2017;11;05;Tiistai;0;1;1
626;28.11.2017;2017;11;06;Tiistai;2;8;10
626;28.11.2017;2017;11;07;Tiistai;1;18;19
626;28.11.2017;2017;11;08;Tiistai;7;31;38
626;28.11.2017;2017;11;09;Tiistai;4;7;11
626;28.11.2017;2017;11;10;Tiistai;3;11;14
626;28.11.2017;2017;11;11;Tiistai;4;9;13
626;28.11.2017;2017;11;12;Tiistai;3;4;7
626;28.11.2017;2017;11;13;Tiistai;7;3;10
626;28.11.2017;2017;11;14;Tiistai;7;5;12
626;28.11.2017;2017;11;15;Tiistai;12;7;19
626;28.11.2017;2017;11;16;Tiistai;18;7;25
626;28.11.2017;2017;11;17;Tiistai;24;8;32
626;28.11.2017;2017;11;18;Tiistai;15;7;22
626;28.11.2017;2017;11;19;Tiistai;5;4;9
626;28.11.2017;2017;11;20;Tiistai;4;4;8
626;28.11.2017;2017;11;21;Tiistai;5;0;5
626;28.11.2017;2017;11;22;Tiistai;3;2;5
626;28.11.2017;2017;11;23;Tiistai;0;1;1
626;29.11.2017;2017;11;00;Keskiviikko;0;1;1
626;29.11.2017;2017;11;01;Keskiviikko;0;0;0
626;29.11.2017;2017;11;02;Keskiviikko;1;0;1
626;29.11.2017;2017;11;03;Keskiviikko;0;0;0
626;29.11.2017;2017;11;04;Keskiviikko;0;0;0
626;29.11.2017;2017;11;05;Keskiviikko;0;3;3
626;29.11.2017;2017;11;06;Keskiviikko;2;9;11
626;29.11.2017;2017;11;07;Keskiviikko;4;16;20
626;29.11.2017;2017;11;08;Keskiviikko;7;38;45
626;29.11.2017;2017;11;09;Keskiviikko;9;19;28
626;29.11.2017;2017;11;10;Keskiviikko;2;4;6
626;29.11.2017;2017;11;11;Keskiviikko;2;4;6
626;29.11.2017;2017;11;12;Keskiviikko;1;2;3
626;29.11.2017;2017;11;13;Keskiviikko;7;1;8
626;29.11.2017;2017;11;14;Keskiviikko;7;4;11
626;29.11.2017;2017;11;15;Keskiviikko;9;7;16
626;29.11.2017;2017;11;16;Keskiviikko;21;12;33
626;29.11.2017;2017;11;17;Keskiviikko;18;13;31
626;29.11.2017;2017;11;18;Keskiviikko;15;7;22
626;29.11.2017;2017;11;19;Keskiviikko;8;5;13
626;29.11.2017;2017;11;20;Keskiviikko;7;2;9
626;29.11.2017;2017;11;21;Keskiviikko;4;1;5
626;29.11.2017;2017;11;22;Keskiviikko;3;4;7
626;29.11.2017;2017;11;23;Keskiviikko;1;1;2
626;30.11.2017;2017;11;00;Torstai;1;0;1
626;30.11.2017;2017;11;01;Torstai;0;0;0
626;30.11.2017;2017;11;02;Torstai;0;0;0
626;30.11.2017;2017;11;03;Torstai;0;1;1
626;30.11.2017;2017;11;04;Torstai;0;0;0
626;30.11.2017;2017;11;05;Torstai;0;3;3
626;30.11.2017;2017;11;06;Torstai;3;8;11
626;30.11.2017;2017;11;07;Torstai;5;23;28
626;30.11.2017;2017;11;08;Torstai;8;32;40
626;30.11.2017;2017;11;09;Torstai;7;19;26
626;30.11.2017;2017;11;10;Torstai;2;4;6
626;30.11.2017;2017;11;11;Torstai;5;6;11
626;30.11.2017;2017;11;12;Torstai;7;11;18
626;30.11.2017;2017;11;13;Torstai;5;8;13
626;30.11.2017;2017;11;14;Torstai;12;7;19
626;30.11.2017;2017;11;15;Torstai;8;9;17
626;30.11.2017;2017;11;16;Torstai;16;10;26
626;30.11.2017;2017;11;17;Torstai;19;11;30
626;30.11.2017;2017;11;18;Torstai;13;9;22
626;30.11.2017;2017;11;19;Torstai;16;3;19
626;30.11.2017;2017;11;20;Torstai;5;2;7
626;30.11.2017;2017;11;21;Torstai;3;5;8
626;30.11.2017;2017;11;22;Torstai;5;5;10
626;30.11.2017;2017;11;23;Torstai;2;0;2
626;01.12.2017;2017;12;00;Perjantai;0;1;1
626;01.12.2017;2017;12;01;Perjantai;0;0;0
626;01.12.2017;2017;12;02;Perjantai;0;0;0
626;01.12.2017;2017;12;03;Perjantai;0;0;0
626;01.12.2017;2017;12;04;Perjantai;0;0;0
626;01.12.2017;2017;12;05;Perjantai;0;2;2
626;01.12.2017;2017;12;06;Perjantai;3;8;11
626;01.12.2017;2017;12;07;Perjantai;3;14;17
626;01.12.2017;2017;12;08;Perjantai;17;30;47
626;01.12.2017;2017;12;09;Perjantai;8;21;29
626;01.12.2017;2017;12;10;Perjantai;5;10;15
626;01.12.2017;2017;12;11;Perjantai;6;9;15
626;01.12.2017;2017;12;12;Perjantai;7;8;15
626;01.12.2017;2017;12;13;Perjantai;14;9;23
626;01.12.2017;2017;12;14;Perjantai;22;9;31
626;01.12.2017;2017;12;15;Perjantai;23;12;35
626;01.12.2017;2017;12;16;Perjantai;20;14;34
626;01.12.2017;2017;12;17;Perjantai;22;6;28
626;01.12.2017;2017;12;18;Perjantai;10;11;21
626;01.12.2017;2017;12;19;Perjantai;3;2;5
626;01.12.2017;2017;12;20;Perjantai;5;2;7
626;01.12.2017;2017;12;21;Perjantai;7;2;9
626;01.12.2017;2017;12;22;Perjantai;5;2;7
626;01.12.2017;2017;12;23;Perjantai;1;0;1
626;02.12.2017;2017;12;00;Lauantai;1;1;2
626;02.12.2017;2017;12;01;Lauantai;1;1;2
626;02.12.2017;2017;12;02;Lauantai;0;0;0
626;02.12.2017;2017;12;03;Lauantai;1;0;1
626;02.12.2017;2017;12;04;Lauantai;2;0;2
626;02.12.2017;2017;12;05;Lauantai;0;0;0
626;02.12.2017;2017;12;06;Lauantai;3;3;6
626;02.12.2017;2017;12;07;Lauantai;1;3;4
626;02.12.2017;2017;12;08;Lauantai;3;4;7
626;02.12.2017;2017;12;09;Lauantai;4;3;7
626;02.12.2017;2017;12;10;Lauantai;2;7;9
626;02.12.2017;2017;12;11;Lauantai;7;8;15
626;02.12.2017;2017;12;12;Lauantai;4;4;8
626;02.12.2017;2017;12;13;Lauantai;5;9;14
626;02.12.2017;2017;12;14;Lauantai;6;5;11
626;02.12.2017;2017;12;15;Lauantai;5;5;10
626;02.12.2017;2017;12;16;Lauantai;5;10;15
626;02.12.2017;2017;12;17;Lauantai;2;2;4
626;02.12.2017;2017;12;18;Lauantai;3;5;8
626;02.12.2017;2017;12;19;Lauantai;5;2;7
626;02.12.2017;2017;12;20;Lauantai;2;1;3
626;02.12.2017;2017;12;21;Lauantai;0;1;1
626;02.12.2017;2017;12;22;Lauantai;4;1;5
626;02.12.2017;2017;12;23;Lauantai;0;0;0
626;03.12.2017;2017;12;00;Sunnuntai;1;1;2
626;03.12.2017;2017;12;01;Sunnuntai;0;0;0
626;03.12.2017;2017;12;02;Sunnuntai;1;0;1
626;03.12.2017;2017;12;03;Sunnuntai;0;1;1
626;03.12.2017;2017;12;04;Sunnuntai;1;0;1
626;03.12.2017;2017;12;05;Sunnuntai;0;0;0
626;03.12.2017;2017;12;06;Sunnuntai;2;1;3
626;03.12.2017;2017;12;07;Sunnuntai;0;0;0
626;03.12.2017;2017;12;08;Sunnuntai;0;0;0
626;03.12.2017;2017;12;09;Sunnuntai;1;1;2
626;03.12.2017;2017;12;10;Sunnuntai;2;0;2
626;03.12.2017;2017;12;11;Sunnuntai;2;2;4
626;03.12.2017;2017;12;12;Sunnuntai;3;6;9
626;03.12.2017;2017;12;13;Sunnuntai;5;6;11
626;03.12.2017;2017;12;14;Sunnuntai;2;8;10
626;03.12.2017;2017;12;15;Sunnuntai;6;9;15
626;03.12.2017;2017;12;16;Sunnuntai;2;5;7
626;03.12.2017;2017;12;17;Sunnuntai;5;3;8
626;03.12.2017;2017;12;18;Sunnuntai;1;5;6
626;03.12.2017;2017;12;19;Sunnuntai;4;7;11
626;03.12.2017;2017;12;20;Sunnuntai;2;1;3
626;03.12.2017;2017;12;21;Sunnuntai;4;1;5
626;03.12.2017;2017;12;22;Sunnuntai;1;2;3
626;03.12.2017;2017;12;23;Sunnuntai;3;1;4
626;04.12.2017;2017;12;00;Maanantai;2;1;3
626;04.12.2017;2017;12;01;Maanantai;0;0;0
626;04.12.2017;2017;12;02;Maanantai;0;0;0
626;04.12.2017;2017;12;03;Maanantai;0;0;0
626;04.12.2017;2017;12;04;Maanantai;0;1;1
626;04.12.2017;2017;12;05;Maanantai;0;2;2
626;04.12.2017;2017;12;06;Maanantai;1;5;6
626;04.12.2017;2017;12;07;Maanantai;4;16;20
626;04.12.2017;2017;12;08;Maanantai;9;29;38
626;04.12.2017;2017;12;09;Maanantai;9;23;32
626;04.12.2017;2017;12;10;Maanantai;3;8;11
626;04.12.2017;2017;12;11;Maanantai;6;7;13
626;04.12.2017;2017;12;12;Maanantai;3;17;20
626;04.12.2017;2017;12;13;Maanantai;7;5;12
626;04.12.2017;2017;12;14;Maanantai;12;14;26
626;04.12.2017;2017;12;15;Maanantai;10;7;17
626;04.12.2017;2017;12;16;Maanantai;22;12;34
626;04.12.2017;2017;12;17;Maanantai;23;9;32
626;04.12.2017;2017;12;18;Maanantai;20;8;28
626;04.12.2017;2017;12;19;Maanantai;14;5;19
626;04.12.2017;2017;12;20;Maanantai;9;2;11
626;04.12.2017;2017;12;21;Maanantai;8;1;9
626;04.12.2017;2017;12;22;Maanantai;5;1;6
626;04.12.2017;2017;12;23;Maanantai;2;3;5
626;05.12.2017;2017;12;00;Tiistai;1;1;2
626;05.12.2017;2017;12;01;Tiistai;0;0;0
626;05.12.2017;2017;12;02;Tiistai;0;0;0
626;05.12.2017;2017;12;03;Tiistai;0;0;0
626;05.12.2017;2017;12;04;Tiistai;1;0;1
626;05.12.2017;2017;12;05;Tiistai;0;2;2
626;05.12.2017;2017;12;06;Tiistai;3;5;8
626;05.12.2017;2017;12;07;Tiistai;3;9;12
626;05.12.2017;2017;12;08;Tiistai;9;22;31
626;05.12.2017;2017;12;09;Tiistai;9;22;31
626;05.12.2017;2017;12;10;Tiistai;4;7;11
626;05.12.2017;2017;12;11;Tiistai;6;5;11
626;05.12.2017;2017;12;12;Tiistai;3;1;4
626;05.12.2017;2017;12;13;Tiistai;7;3;10
626;05.12.2017;2017;12;14;Tiistai;6;3;9
626;05.12.2017;2017;12;15;Tiistai;8;10;18
626;05.12.2017;2017;12;16;Tiistai;17;11;28
626;05.12.2017;2017;12;17;Tiistai;18;4;22
626;05.12.2017;2017;12;18;Tiistai;9;6;15
626;05.12.2017;2017;12;19;Tiistai;5;4;9
626;05.12.2017;2017;12;20;Tiistai;4;2;6
626;05.12.2017;2017;12;21;Tiistai;3;3;6
626;05.12.2017;2017;12;22;Tiistai;1;1;2
626;05.12.2017;2017;12;23;Tiistai;4;4;8
626;06.12.2017;2017;12;00;Keskiviikko;0;1;1
626;06.12.2017;2017;12;01;Keskiviikko;0;0;0
626;06.12.2017;2017;12;02;Keskiviikko;0;0;0
626;06.12.2017;2017;12;03;Keskiviikko;0;0;0
626;06.12.2017;2017;12;04;Keskiviikko;1;0;1
626;06.12.2017;2017;12;05;Keskiviikko;1;1;2
626;06.12.2017;2017;12;06;Keskiviikko;0;0;0
626;06.12.2017;2017;12;07;Keskiviikko;0;0;0
626;06.12.2017;2017;12;08;Keskiviikko;1;1;2
626;06.12.2017;2017;12;09;Keskiviikko;1;1;2
626;06.12.2017;2017;12;10;Keskiviikko;1;3;4
626;06.12.2017;2017;12;11;Keskiviikko;1;0;1
626;06.12.2017;2017;12;12;Keskiviikko;2;2;4
626;06.12.2017;2017;12;13;Keskiviikko;3;1;4
626;06.12.2017;2017;12;14;Keskiviikko;8;4;12
626;06.12.2017;2017;12;15;Keskiviikko;2;2;4
626;06.12.2017;2017;12;16;Keskiviikko;3;2;5
626;06.12.2017;2017;12;17;Keskiviikko;2;0;2
626;06.12.2017;2017;12;18;Keskiviikko;0;4;4
626;06.12.2017;2017;12;19;Keskiviikko;1;3;4
626;06.12.2017;2017;12;20;Keskiviikko;3;1;4
626;06.12.2017;2017;12;21;Keskiviikko;1;2;3
626;06.12.2017;2017;12;22;Keskiviikko;2;1;3
626;06.12.2017;2017;12;23;Keskiviikko;0;0;0
626;07.12.2017;2017;12;00;Torstai;1;0;1
626;07.12.2017;2017;12;01;Torstai;1;0;1
626;07.12.2017;2017;12;02;Torstai;0;0;0
626;07.12.2017;2017;12;03;Torstai;0;0;0
626;07.12.2017;2017;12;04;Torstai;0;1;1
626;07.12.2017;2017;12;05;Torstai;0;2;2
626;07.12.2017;2017;12;06;Torstai;1;5;6
626;07.12.2017;2017;12;07;Torstai;1;16;17
626;07.12.2017;2017;12;08;Torstai;8;28;36
626;07.12.2017;2017;12;09;Torstai;9;17;26
626;07.12.2017;2017;12;10;Torstai;1;6;7
626;07.12.2017;2017;12;11;Torstai;6;9;15
626;07.12.2017;2017;12;12;Torstai;3;3;6
626;07.12.2017;2017;12;13;Torstai;7;4;11
626;07.12.2017;2017;12;14;Torstai;8;6;14
626;07.12.2017;2017;12;15;Torstai;10;5;15
626;07.12.2017;2017;12;16;Torstai;14;10;24
626;07.12.2017;2017;12;17;Torstai;23;11;34
626;07.12.2017;2017;12;18;Torstai;12;10;22
626;07.12.2017;2017;12;19;Torstai;10;6;16
626;07.12.2017;2017;12;20;Torstai;4;3;7
626;07.12.2017;2017;12;21;Torstai;4;4;8
626;07.12.2017;2017;12;22;Torstai;2;2;4
626;07.12.2017;2017;12;23;Torstai;6;1;7
626;08.12.2017;2017;12;00;Perjantai;0;0;0
626;08.12.2017;2017;12;01;Perjantai;0;0;0
626;08.12.2017;2017;12;02;Perjantai;0;0;0
626;08.12.2017;2017;12;03;Perjantai;0;0;0
626;08.12.2017;2017;12;04;Perjantai;0;0;0
626;08.12.2017;2017;12;05;Perjantai;0;2;2
626;08.12.2017;2017;12;06;Perjantai;1;5;6
626;08.12.2017;2017;12;07;Perjantai;2;10;12
626;08.12.2017;2017;12;08;Perjantai;6;14;20
626;08.12.2017;2017;12;09;Perjantai;3;8;11
626;08.12.2017;2017;12;10;Perjantai;1;6;7
626;08.12.2017;2017;12;11;Perjantai;2;4;6
626;08.12.2017;2017;12;12;Perjantai;1;1;2
626;08.12.2017;2017;12;13;Perjantai;1;1;2
626;08.12.2017;2017;12;14;Perjantai;4;5;9
626;08.12.2017;2017;12;15;Perjantai;9;4;13
626;08.12.2017;2017;12;16;Perjantai;10;6;16
626;08.12.2017;2017;12;17;Perjantai;10;4;14
626;08.12.2017;2017;12;18;Perjantai;14;2;16
626;08.12.2017;2017;12;19;Perjantai;4;2;6
626;08.12.2017;2017;12;20;Perjantai;2;1;3
626;08.12.2017;2017;12;21;Perjantai;3;1;4
626;08.12.2017;2017;12;22;Perjantai;3;1;4
626;08.12.2017;2017;12;23;Perjantai;1;1;2
626;09.12.2017;2017;12;00;Lauantai;1;2;3
626;09.12.2017;2017;12;01;Lauantai;1;0;1
626;09.12.2017;2017;12;02;Lauantai;1;1;2
626;09.12.2017;2017;12;03;Lauantai;0;0;0
626;09.12.2017;2017;12;04;Lauantai;0;0;0
626;09.12.2017;2017;12;05;Lauantai;1;0;1
626;09.12.2017;2017;12;06;Lauantai;0;3;3
626;09.12.2017;2017;12;07;Lauantai;0;1;1
626;09.12.2017;2017;12;08;Lauantai;0;1;1
626;09.12.2017;2017;12;09;Lauantai;1;3;4
626;09.12.2017;2017;12;10;Lauantai;1;6;7
626;09.12.2017;2017;12;11;Lauantai;4;6;10
626;09.12.2017;2017;12;12;Lauantai;0;6;6
626;09.12.2017;2017;12;13;Lauantai;9;4;13
626;09.12.2017;2017;12;14;Lauantai;7;5;12
626;09.12.2017;2017;12;15;Lauantai;5;7;12
626;09.12.2017;2017;12;16;Lauantai;6;2;8
626;09.12.2017;2017;12;17;Lauantai;2;3;5
626;09.12.2017;2017;12;18;Lauantai;3;2;5
626;09.12.2017;2017;12;19;Lauantai;1;0;1
626;09.12.2017;2017;12;20;Lauantai;2;0;2
626;09.12.2017;2017;12;21;Lauantai;0;0;0
626;09.12.2017;2017;12;22;Lauantai;1;1;2
626;09.12.2017;2017;12;23;Lauantai;0;1;1
626;10.12.2017;2017;12;00;Sunnuntai;0;0;0
626;10.12.2017;2017;12;01;Sunnuntai;0;0;0
626;10.12.2017;2017;12;02;Sunnuntai;0;0;0
626;10.12.2017;2017;12;03;Sunnuntai;0;0;0
626;10.12.2017;2017;12;04;Sunnuntai;0;1;1
626;10.12.2017;2017;12;05;Sunnuntai;0;1;1
626;10.12.2017;2017;12;06;Sunnuntai;0;0;0
626;10.12.2017;2017;12;07;Sunnuntai;0;1;1
626;10.12.2017;2017;12;08;Sunnuntai;0;1;1
626;10.12.2017;2017;12;09;Sunnuntai;1;0;1
626;10.12.2017;2017;12;10;Sunnuntai;2;2;4
626;10.12.2017;2017;12;11;Sunnuntai;1;3;4
626;10.12.2017;2017;12;12;Sunnuntai;1;7;8
626;10.12.2017;2017;12;13;Sunnuntai;3;2;5
626;10.12.2017;2017;12;14;Sunnuntai;2;1;3
626;10.12.2017;2017;12;15;Sunnuntai;2;4;6
626;10.12.2017;2017;12;16;Sunnuntai;4;1;5
626;10.12.2017;2017;12;17;Sunnuntai;1;1;2
626;10.12.2017;2017;12;18;Sunnuntai;1;1;2
626;10.12.2017;2017;12;19;Sunnuntai;0;2;2
626;10.12.2017;2017;12;20;Sunnuntai;3;2;5
626;10.12.2017;2017;12;21;Sunnuntai;3;0;3
626;10.12.2017;2017;12;22;Sunnuntai;2;2;4
626;10.12.2017;2017;12;23;Sunnuntai;0;0;0
626;11.12.2017;2017;12;00;Maanantai;0;0;0
626;11.12.2017;2017;12;01;Maanantai;0;0;0
626;11.12.2017;2017;12;02;Maanantai;0;0;0
626;11.12.2017;2017;12;03;Maanantai;0;0;0
626;11.12.2017;2017;12;04;Maanantai;0;2;2
626;11.12.2017;2017;12;05;Maanantai;0;1;1
626;11.12.2017;2017;12;06;Maanantai;3;4;7
626;11.12.2017;2017;12;07;Maanantai;2;13;15
626;11.12.2017;2017;12;08;Maanantai;4;27;31
626;11.12.2017;2017;12;09;Maanantai;6;16;22
626;11.12.2017;2017;12;10;Maanantai;1;5;6
626;11.12.2017;2017;12;11;Maanantai;4;1;5
626;11.12.2017;2017;12;12;Maanantai;3;5;8
626;11.12.2017;2017;12;13;Maanantai;3;4;7
626;11.12.2017;2017;12;14;Maanantai;7;7;14
626;11.12.2017;2017;12;15;Maanantai;10;6;16
626;11.12.2017;2017;12;16;Maanantai;6;6;12
626;11.12.2017;2017;12;17;Maanantai;31;12;43
626;11.12.2017;2017;12;18;Maanantai;15;9;24
626;11.12.2017;2017;12;19;Maanantai;6;1;7
626;11.12.2017;2017;12;20;Maanantai;2;1;3
626;11.12.2017;2017;12;21;Maanantai;1;0;1
626;11.12.2017;2017;12;22;Maanantai;2;5;7
626;11.12.2017;2017;12;23;Maanantai;1;0;1
626;12.12.2017;2017;12;00;Tiistai;0;0;0
626;12.12.2017;2017;12;01;Tiistai;0;0;0
626;12.12.2017;2017;12;02;Tiistai;0;0;0
626;12.12.2017;2017;12;03;Tiistai;0;0;0
626;12.12.2017;2017;12;04;Tiistai;0;0;0
626;12.12.2017;2017;12;05;Tiistai;0;3;3
626;12.12.2017;2017;12;06;Tiistai;4;9;13
626;12.12.2017;2017;12;07;Tiistai;1;15;16
626;12.12.2017;2017;12;08;Tiistai;8;25;33
626;12.12.2017;2017;12;09;Tiistai;7;15;22
626;12.12.2017;2017;12;10;Tiistai;2;6;8
626;12.12.2017;2017;12;11;Tiistai;3;4;7
626;12.12.2017;2017;12;12;Tiistai;5;5;10
626;12.12.2017;2017;12;13;Tiistai;5;6;11
626;12.12.2017;2017;12;14;Tiistai;8;3;11
626;12.12.2017;2017;12;15;Tiistai;8;8;16
626;12.12.2017;2017;12;16;Tiistai;8;7;15
626;12.12.2017;2017;12;17;Tiistai;23;9;32
626;12.12.2017;2017;12;18;Tiistai;11;7;18
626;12.12.2017;2017;12;19;Tiistai;5;3;8
626;12.12.2017;2017;12;20;Tiistai;3;0;3
626;12.12.2017;2017;12;21;Tiistai;4;1;5
626;12.12.2017;2017;12;22;Tiistai;0;3;3
626;12.12.2017;2017;12;23;Tiistai;2;1;3
626;13.12.2017;2017;12;00;Keskiviikko;0;1;1
626;13.12.2017;2017;12;01;Keskiviikko;0;0;0
626;13.12.2017;2017;12;02;Keskiviikko;0;0;0
626;13.12.2017;2017;12;03;Keskiviikko;0;0;0
626;13.12.2017;2017;12;04;Keskiviikko;0;0;0
626;13.12.2017;2017;12;05;Keskiviikko;0;4;4
626;13.12.2017;2017;12;06;Keskiviikko;1;1;2
626;13.12.2017;2017;12;07;Keskiviikko;3;12;15
626;13.12.2017;2017;12;08;Keskiviikko;3;25;28
626;13.12.2017;2017;12;09;Keskiviikko;3;13;16
626;13.12.2017;2017;12;10;Keskiviikko;3;5;8
626;13.12.2017;2017;12;11;Keskiviikko;3;4;7
626;13.12.2017;2017;12;12;Keskiviikko;1;1;2
626;13.12.2017;2017;12;13;Keskiviikko;6;5;11
626;13.12.2017;2017;12;14;Keskiviikko;7;4;11
626;13.12.2017;2017;12;15;Keskiviikko;6;6;12
626;13.12.2017;2017;12;16;Keskiviikko;6;3;9
626;13.12.2017;2017;12;17;Keskiviikko;14;4;18
626;13.12.2017;2017;12;18;Keskiviikko;7;9;16
626;13.12.2017;2017;12;19;Keskiviikko;3;1;4
626;13.12.2017;2017;12;20;Keskiviikko;3;1;4
626;13.12.2017;2017;12;21;Keskiviikko;1;0;1
626;13.12.2017;2017;12;22;Keskiviikko;0;2;2
626;13.12.2017;2017;12;23;Keskiviikko;2;0;2
626;14.12.2017;2017;12;00;Torstai;1;0;1
626;14.12.2017;2017;12;01;Torstai;0;0;0
626;14.12.2017;2017;12;02;Torstai;0;1;1
626;14.12.2017;2017;12;03;Torstai;0;0;0
626;14.12.2017;2017;12;04;Torstai;1;1;2
626;14.12.2017;2017;12;05;Torstai;0;3;3
626;14.12.2017;2017;12;06;Torstai;1;5;6
626;14.12.2017;2017;12;07;Torstai;1;10;11
626;14.12.2017;2017;12;08;Torstai;5;22;27
626;14.12.2017;2017;12;09;Torstai;5;12;17
626;14.12.2017;2017;12;10;Torstai;1;5;6
626;14.12.2017;2017;12;11;Torstai;1;5;6
626;14.12.2017;2017;12;12;Torstai;2;1;3
626;14.12.2017;2017;12;13;Torstai;3;1;4
626;14.12.2017;2017;12;14;Torstai;4;5;9
626;14.12.2017;2017;12;15;Torstai;4;4;8
626;14.12.2017;2017;12;16;Torstai;17;4;21
626;14.12.2017;2017;12;17;Torstai;13;3;16
626;14.12.2017;2017;12;18;Torstai;5;6;11
626;14.12.2017;2017;12;19;Torstai;9;5;14
626;14.12.2017;2017;12;20;Torstai;5;1;6
626;14.12.2017;2017;12;21;Torstai;1;0;1
626;14.12.2017;2017;12;22;Torstai;4;1;5
626;14.12.2017;2017;12;23;Torstai;2;0;2
626;15.12.2017;2017;12;00;Perjantai;1;0;1
626;15.12.2017;2017;12;01;Perjantai;0;0;0
626;15.12.2017;2017;12;02;Perjantai;0;1;1
626;15.12.2017;2017;12;03;Perjantai;1;1;2
626;15.12.2017;2017;12;04;Perjantai;0;0;0
626;15.12.2017;2017;12;05;Perjantai;0;3;3
626;15.12.2017;2017;12;06;Perjantai;3;7;10
626;15.12.2017;2017;12;07;Perjantai;1;10;11
626;15.12.2017;2017;12;08;Perjantai;3;19;22
626;15.12.2017;2017;12;09;Perjantai;4;9;13
626;15.12.2017;2017;12;10;Perjantai;0;5;5
626;15.12.2017;2017;12;11;Perjantai;1;1;2
626;15.12.2017;2017;12;12;Perjantai;1;3;4
626;15.12.2017;2017;12;13;Perjantai;1;7;8
626;15.12.2017;2017;12;14;Perjantai;5;4;9
626;15.12.2017;2017;12;15;Perjantai;3;3;6
626;15.12.2017;2017;12;16;Perjantai;8;8;16
626;15.12.2017;2017;12;17;Perjantai;19;5;24
626;15.12.2017;2017;12;18;Perjantai;6;4;10
626;15.12.2017;2017;12;19;Perjantai;5;2;7
626;15.12.2017;2017;12;20;Perjantai;3;3;6
626;15.12.2017;2017;12;21;Perjantai;3;1;4
626;15.12.2017;2017;12;22;Perjantai;6;1;7
626;15.12.2017;2017;12;23;Perjantai;0;0;0
626;16.12.2017;2017;12;00;Lauantai;0;0;0
626;16.12.2017;2017;12;01;Lauantai;0;0;0
626;16.12.2017;2017;12;02;Lauantai;1;0;1
626;16.12.2017;2017;12;03;Lauantai;0;1;1
626;16.12.2017;2017;12;04;Lauantai;1;0;1
626;16.12.2017;2017;12;05;Lauantai;0;0;0
626;16.12.2017;2017;12;06;Lauantai;0;0;0
626;16.12.2017;2017;12;07;Lauantai;0;1;1
626;16.12.2017;2017;12;08;Lauantai;0;1;1
626;16.12.2017;2017;12;09;Lauantai;1;1;2
626;16.12.2017;2017;12;10;Lauantai;1;4;5
626;16.12.2017;2017;12;11;Lauantai;0;2;2
626;16.12.2017;2017;12;12;Lauantai;2;3;5
626;16.12.2017;2017;12;13;Lauantai;0;3;3
626;16.12.2017;2017;12;14;Lauantai;0;4;4
626;16.12.2017;2017;12;15;Lauantai;1;7;8
626;16.12.2017;2017;12;16;Lauantai;2;2;4
626;16.12.2017;2017;12;17;Lauantai;4;1;5
626;16.12.2017;2017;12;18;Lauantai;3;2;5
626;16.12.2017;2017;12;19;Lauantai;1;1;2
626;16.12.2017;2017;12;20;Lauantai;0;3;3
626;16.12.2017;2017;12;21;Lauantai;1;1;2
626;16.12.2017;2017;12;22;Lauantai;2;1;3
626;16.12.2017;2017;12;23;Lauantai;1;2;3
626;17.12.2017;2017;12;00;Sunnuntai;1;0;1
626;17.12.2017;2017;12;01;Sunnuntai;2;0;2
626;17.12.2017;2017;12;02;Sunnuntai;0;0;0
626;17.12.2017;2017;12;03;Sunnuntai;1;0;1
626;17.12.2017;2017;12;04;Sunnuntai;0;0;0
626;17.12.2017;2017;12;05;Sunnuntai;1;0;1
626;17.12.2017;2017;12;06;Sunnuntai;0;0;0
626;17.12.2017;2017;12;07;Sunnuntai;0;2;2
626;17.12.2017;2017;12;08;Sunnuntai;0;0;0
626;17.12.2017;2017;12;09;Sunnuntai;0;3;3
626;17.12.2017;2017;12;10;Sunnuntai;0;1;1
626;17.12.2017;2017;12;11;Sunnuntai;0;3;3
626;17.12.2017;2017;12;12;Sunnuntai;3;4;7
626;17.12.2017;2017;12;13;Sunnuntai;3;4;7
626;17.12.2017;2017;12;14;Sunnuntai;2;3;5
626;17.12.2017;2017;12;15;Sunnuntai;7;7;14
626;17.12.2017;2017;12;16;Sunnuntai;7;1;8
626;17.12.2017;2017;12;17;Sunnuntai;5;5;10
626;17.12.2017;2017;12;18;Sunnuntai;1;7;8
626;17.12.2017;2017;12;19;Sunnuntai;2;3;5
626;17.12.2017;2017;12;20;Sunnuntai;4;3;7
626;17.12.2017;2017;12;21;Sunnuntai;2;1;3
626;17.12.2017;2017;12;22;Sunnuntai;2;1;3
626;17.12.2017;2017;12;23;Sunnuntai;2;0;2
626;18.12.2017;2017;12;00;Maanantai;1;0;1
626;18.12.2017;2017;12;01;Maanantai;0;0;0
626;18.12.2017;2017;12;02;Maanantai;0;0;0
626;18.12.2017;2017;12;03;Maanantai;0;0;0
626;18.12.2017;2017;12;04;Maanantai;0;0;0
626;18.12.2017;2017;12;05;Maanantai;0;2;2
626;18.12.2017;2017;12;06;Maanantai;2;11;13
626;18.12.2017;2017;12;07;Maanantai;2;17;19
626;18.12.2017;2017;12;08;Maanantai;6;29;35
626;18.12.2017;2017;12;09;Maanantai;7;23;30
626;18.12.2017;2017;12;10;Maanantai;1;8;9
626;18.12.2017;2017;12;11;Maanantai;1;6;7
626;18.12.2017;2017;12;12;Maanantai;1;6;7
626;18.12.2017;2017;12;13;Maanantai;6;3;9
626;18.12.2017;2017;12;14;Maanantai;8;5;13
626;18.12.2017;2017;12;15;Maanantai;11;10;21
626;18.12.2017;2017;12;16;Maanantai;13;8;21
626;18.12.2017;2017;12;17;Maanantai;20;9;29
626;18.12.2017;2017;12;18;Maanantai;13;4;17
626;18.12.2017;2017;12;19;Maanantai;9;7;16
626;18.12.2017;2017;12;20;Maanantai;6;2;8
626;18.12.2017;2017;12;21;Maanantai;3;2;5
626;18.12.2017;2017;12;22;Maanantai;4;2;6
626;18.12.2017;2017;12;23;Maanantai;1;1;2
626;19.12.2017;2017;12;00;Tiistai;0;1;1
626;19.12.2017;2017;12;01;Tiistai;2;2;4
626;19.12.2017;2017;12;02;Tiistai;0;1;1
626;19.12.2017;2017;12;03;Tiistai;0;0;0
626;19.12.2017;2017;12;04;Tiistai;0;0;0
626;19.12.2017;2017;12;05;Tiistai;0;1;1
626;19.12.2017;2017;12;06;Tiistai;1;10;11
626;19.12.2017;2017;12;07;Tiistai;3;12;15
626;19.12.2017;2017;12;08;Tiistai;9;31;40
626;19.12.2017;2017;12;09;Tiistai;7;18;25
626;19.12.2017;2017;12;10;Tiistai;1;5;6
626;19.12.2017;2017;12;11;Tiistai;4;7;11
626;19.12.2017;2017;12;12;Tiistai;3;4;7
626;19.12.2017;2017;12;13;Tiistai;4;8;12
626;19.12.2017;2017;12;14;Tiistai;7;2;9
626;19.12.2017;2017;12;15;Tiistai;7;9;16
626;19.12.2017;2017;12;16;Tiistai;10;8;18
626;19.12.2017;2017;12;17;Tiistai;21;8;29
626;19.12.2017;2017;12;18;Tiistai;12;10;22
626;19.12.2017;2017;12;19;Tiistai;6;3;9
626;19.12.2017;2017;12;20;Tiistai;4;5;9
626;19.12.2017;2017;12;21;Tiistai;3;2;5
626;19.12.2017;2017;12;22;Tiistai;5;4;9
626;19.12.2017;2017;12;23;Tiistai;2;1;3
626;20.12.2017;2017;12;00;Keskiviikko;1;0;1
626;20.12.2017;2017;12;01;Keskiviikko;0;0;0
626;20.12.2017;2017;12;02;Keskiviikko;1;0;1
626;20.12.2017;2017;12;03;Keskiviikko;0;1;1
626;20.12.2017;2017;12;04;Keskiviikko;0;0;0
626;20.12.2017;2017;12;05;Keskiviikko;0;5;5
626;20.12.2017;2017;12;06;Keskiviikko;1;3;4
626;20.12.2017;2017;12;07;Keskiviikko;1;15;16
626;20.12.2017;2017;12;08;Keskiviikko;8;25;33
626;20.12.2017;2017;12;09;Keskiviikko;7;14;21
626;20.12.2017;2017;12;10;Keskiviikko;1;6;7
626;20.12.2017;2017;12;11;Keskiviikko;5;7;12
626;20.12.2017;2017;12;12;Keskiviikko;4;2;6
626;20.12.2017;2017;12;13;Keskiviikko;1;1;2
626;20.12.2017;2017;12;14;Keskiviikko;7;4;11
626;20.12.2017;2017;12;15;Keskiviikko;3;5;8
626;20.12.2017;2017;12;16;Keskiviikko;2;1;3
626;20.12.2017;2017;12;17;Keskiviikko;18;10;28
626;20.12.2017;2017;12;18;Keskiviikko;11;2;13
626;20.12.2017;2017;12;19;Keskiviikko;8;0;8
626;20.12.2017;2017;12;20;Keskiviikko;3;2;5
626;20.12.2017;2017;12;21;Keskiviikko;4;1;5
626;20.12.2017;2017;12;22;Keskiviikko;0;1;1
626;20.12.2017;2017;12;23;Keskiviikko;3;0;3
626;21.12.2017;2017;12;00;Torstai;1;0;1
626;21.12.2017;2017;12;01;Torstai;0;0;0
626;21.12.2017;2017;12;02;Torstai;0;1;1
626;21.12.2017;2017;12;03;Torstai;0;1;1
626;21.12.2017;2017;12;04;Torstai;0;1;1
626;21.12.2017;2017;12;05;Torstai;0;1;1
626;21.12.2017;2017;12;06;Torstai;2;5;7
626;21.12.2017;2017;12;07;Torstai;3;14;17
626;21.12.2017;2017;12;08;Torstai;7;23;30
626;21.12.2017;2017;12;09;Torstai;5;15;20
626;21.12.2017;2017;12;10;Torstai;0;7;7
626;21.12.2017;2017;12;11;Torstai;2;5;7
626;21.12.2017;2017;12;12;Torstai;3;3;6
626;21.12.2017;2017;12;13;Torstai;5;4;9
626;21.12.2017;2017;12;14;Torstai;4;6;10
626;21.12.2017;2017;12;15;Torstai;13;3;16
626;21.12.2017;2017;12;16;Torstai;5;7;12
626;21.12.2017;2017;12;17;Torstai;13;4;17
626;21.12.2017;2017;12;18;Torstai;11;4;15
626;21.12.2017;2017;12;19;Torstai;5;3;8
626;21.12.2017;2017;12;20;Torstai;2;1;3
626;21.12.2017;2017;12;21;Torstai;6;2;8
626;21.12.2017;2017;12;22;Torstai;4;3;7
626;21.12.2017;2017;12;23;Torstai;1;1;2
626;22.12.2017;2017;12;00;Perjantai;0;0;0
626;22.12.2017;2017;12;01;Perjantai;1;0;1
626;22.12.2017;2017;12;02;Perjantai;0;0;0
626;22.12.2017;2017;12;03;Perjantai;0;0;0
626;22.12.2017;2017;12;04;Perjantai;0;0;0
626;22.12.2017;2017;12;05;Perjantai;1;2;3
626;22.12.2017;2017;12;06;Perjantai;1;7;8
626;22.12.2017;2017;12;07;Perjantai;2;6;8
626;22.12.2017;2017;12;08;Perjantai;3;14;17
626;22.12.2017;2017;12;09;Perjantai;3;11;14
626;22.12.2017;2017;12;10;Perjantai;0;5;5
626;22.12.2017;2017;12;11;Perjantai;2;0;2
626;22.12.2017;2017;12;12;Perjantai;2;4;6
626;22.12.2017;2017;12;13;Perjantai;8;6;14
626;22.12.2017;2017;12;14;Perjantai;8;4;12
626;22.12.2017;2017;12;15;Perjantai;13;6;19
626;22.12.2017;2017;12;16;Perjantai;13;3;16
626;22.12.2017;2017;12;17;Perjantai;7;4;11
626;22.12.2017;2017;12;18;Perjantai;4;2;6
626;22.12.2017;2017;12;19;Perjantai;2;4;6
626;22.12.2017;2017;12;20;Perjantai;1;1;2
626;22.12.2017;2017;12;21;Perjantai;2;1;3
626;22.12.2017;2017;12;22;Perjantai;3;4;7
626;22.12.2017;2017;12;23;Perjantai;3;1;4
626;23.12.2017;2017;12;00;Lauantai;0;0;0
626;23.12.2017;2017;12;01;Lauantai;0;0;0
626;23.12.2017;2017;12;02;Lauantai;0;0;0
626;23.12.2017;2017;12;03;Lauantai;2;0;2
626;23.12.2017;2017;12;04;Lauantai;0;0;0
626;23.12.2017;2017;12;05;Lauantai;0;0;0
626;23.12.2017;2017;12;06;Lauantai;1;1;2
626;23.12.2017;2017;12;07;Lauantai;0;0;0
626;23.12.2017;2017;12;08;Lauantai;0;0;0
626;23.12.2017;2017;12;09;Lauantai;2;1;3
626;23.12.2017;2017;12;10;Lauantai;1;2;3
626;23.12.2017;2017;12;11;Lauantai;1;4;5
626;23.12.2017;2017;12;12;Lauantai;0;0;0
626;23.12.2017;2017;12;13;Lauantai;1;2;3
626;23.12.2017;2017;12;14;Lauantai;0;0;0
626;23.12.2017;2017;12;15;Lauantai;2;0;2
626;23.12.2017;2017;12;16;Lauantai;3;1;4
626;23.12.2017;2017;12;17;Lauantai;0;2;2
626;23.12.2017;2017;12;18;Lauantai;3;2;5
626;23.12.2017;2017;12;19;Lauantai;0;0;0
626;23.12.2017;2017;12;20;Lauantai;0;0;0
626;23.12.2017;2017;12;21;Lauantai;1;0;1
626;23.12.2017;2017;12;22;Lauantai;1;1;2
626;23.12.2017;2017;12;23;Lauantai;0;0;0
626;24.12.2017;2017;12;00;Sunnuntai;3;1;4
626;24.12.2017;2017;12;01;Sunnuntai;0;0;0
626;24.12.2017;2017;12;02;Sunnuntai;0;0;0
626;24.12.2017;2017;12;03;Sunnuntai;0;0;0
626;24.12.2017;2017;12;04;Sunnuntai;1;1;2
626;24.12.2017;2017;12;05;Sunnuntai;0;0;0
626;24.12.2017;2017;12;06;Sunnuntai;1;0;1
626;24.12.2017;2017;12;07;Sunnuntai;1;0;1
626;24.12.2017;2017;12;08;Sunnuntai;1;0;1
626;24.12.2017;2017;12;09;Sunnuntai;0;1;1
626;24.12.2017;2017;12;10;Sunnuntai;1;3;4
626;24.12.2017;2017;12;11;Sunnuntai;1;0;1
626;24.12.2017;2017;12;12;Sunnuntai;1;3;4
626;24.12.2017;2017;12;13;Sunnuntai;4;3;7
626;24.12.2017;2017;12;14;Sunnuntai;1;3;4
626;24.12.2017;2017;12;15;Sunnuntai;2;1;3
626;24.12.2017;2017;12;16;Sunnuntai;1;1;2
626;24.12.2017;2017;12;17;Sunnuntai;0;0;0
626;24.12.2017;2017;12;18;Sunnuntai;0;0;0
626;24.12.2017;2017;12;19;Sunnuntai;1;0;1
626;24.12.2017;2017;12;20;Sunnuntai;1;0;1
626;24.12.2017;2017;12;21;Sunnuntai;0;0;0
626;24.12.2017;2017;12;22;Sunnuntai;0;0;0
626;24.12.2017;2017;12;23;Sunnuntai;1;0;1
626;25.12.2017;2017;12;00;Maanantai;0;0;0
626;25.12.2017;2017;12;01;Maanantai;1;0;1
626;25.12.2017;2017;12;02;Maanantai;0;0;0
626;25.12.2017;2017;12;03;Maanantai;0;0;0
626;25.12.2017;2017;12;04;Maanantai;0;0;0
626;25.12.2017;2017;12;05;Maanantai;0;0;0
626;25.12.2017;2017;12;06;Maanantai;1;0;1
626;25.12.2017;2017;12;07;Maanantai;0;0;0
626;25.12.2017;2017;12;08;Maanantai;0;1;1
626;25.12.2017;2017;12;09;Maanantai;0;1;1
626;25.12.2017;2017;12;10;Maanantai;0;1;1
626;25.12.2017;2017;12;11;Maanantai;0;1;1
626;25.12.2017;2017;12;12;Maanantai;3;1;4
626;25.12.2017;2017;12;13;Maanantai;4;1;5
626;25.12.2017;2017;12;14;Maanantai;1;2;3
626;25.12.2017;2017;12;15;Maanantai;0;1;1
626;25.12.2017;2017;12;16;Maanantai;2;2;4
626;25.12.2017;2017;12;17;Maanantai;1;0;1
626;25.12.2017;2017;12;18;Maanantai;2;1;3
626;25.12.2017;2017;12;19;Maanantai;1;0;1
626;25.12.2017;2017;12;20;Maanantai;0;1;1
626;25.12.2017;2017;12;21;Maanantai;0;0;0
626;25.12.2017;2017;12;22;Maanantai;0;0;0
626;25.12.2017;2017;12;23;Maanantai;3;1;4
626;26.12.2017;2017;12;00;Tiistai;0;0;0
626;26.12.2017;2017;12;01;Tiistai;0;0;0
626;26.12.2017;2017;12;02;Tiistai;0;0;0
626;26.12.2017;2017;12;03;Tiistai;0;0;0
626;26.12.2017;2017;12;04;Tiistai;0;0;0
626;26.12.2017;2017;12;05;Tiistai;0;1;1
626;26.12.2017;2017;12;06;Tiistai;1;1;2
626;26.12.2017;2017;12;07;Tiistai;0;0;0
626;26.12.2017;2017;12;08;Tiistai;0;0;0
626;26.12.2017;2017;12;09;Tiistai;0;1;1
626;26.12.2017;2017;12;10;Tiistai;1;2;3
626;26.12.2017;2017;12;11;Tiistai;0;0;0
626;26.12.2017;2017;12;12;Tiistai;0;1;1
626;26.12.2017;2017;12;13;Tiistai;4;2;6
626;26.12.2017;2017;12;14;Tiistai;2;0;2
626;26.12.2017;2017;12;15;Tiistai;1;2;3
626;26.12.2017;2017;12;16;Tiistai;1;3;4
626;26.12.2017;2017;12;17;Tiistai;3;4;7
626;26.12.2017;2017;12;18;Tiistai;1;0;1
626;26.12.2017;2017;12;19;Tiistai;0;1;1
626;26.12.2017;2017;12;20;Tiistai;2;0;2
626;26.12.2017;2017;12;21;Tiistai;0;0;0
626;26.12.2017;2017;12;22;Tiistai;1;1;2
626;26.12.2017;2017;12;23;Tiistai;1;0;1
626;27.12.2017;2017;12;00;Keskiviikko;0;0;0
626;27.12.2017;2017;12;01;Keskiviikko;0;0;0
626;27.12.2017;2017;12;02;Keskiviikko;0;0;0
626;27.12.2017;2017;12;03;Keskiviikko;0;0;0
626;27.12.2017;2017;12;04;Keskiviikko;0;0;0
626;27.12.2017;2017;12;05;Keskiviikko;0;2;2
626;27.12.2017;2017;12;06;Keskiviikko;1;5;6
626;27.12.2017;2017;12;07;Keskiviikko;1;7;8
626;27.12.2017;2017;12;08;Keskiviikko;1;7;8
626;27.12.2017;2017;12;09;Keskiviikko;3;6;9
626;27.12.2017;2017;12;10;Keskiviikko;0;3;3
626;27.12.2017;2017;12;11;Keskiviikko;2;1;3
626;27.12.2017;2017;12;12;Keskiviikko;0;3;3
626;27.12.2017;2017;12;13;Keskiviikko;1;2;3
626;27.12.2017;2017;12;14;Keskiviikko;4;6;10
626;27.12.2017;2017;12;15;Keskiviikko;5;5;10
626;27.12.2017;2017;12;16;Keskiviikko;6;2;8
626;27.12.2017;2017;12;17;Keskiviikko;8;6;14
626;27.12.2017;2017;12;18;Keskiviikko;10;5;15
626;27.12.2017;2017;12;19;Keskiviikko;3;1;4
626;27.12.2017;2017;12;20;Keskiviikko;2;0;2
626;27.12.2017;2017;12;21;Keskiviikko;1;2;3
626;27.12.2017;2017;12;22;Keskiviikko;1;2;3
626;27.12.2017;2017;12;23;Keskiviikko;2;1;3
626;28.12.2017;2017;12;00;Torstai;1;0;1
626;28.12.2017;2017;12;01;Torstai;0;0;0
626;28.12.2017;2017;12;02;Torstai;0;0;0
626;28.12.2017;2017;12;03;Torstai;0;1;1
626;28.12.2017;2017;12;04;Torstai;0;1;1
626;28.12.2017;2017;12;05;Torstai;0;2;2
626;28.12.2017;2017;12;06;Torstai;1;7;8
626;28.12.2017;2017;12;07;Torstai;0;7;7
626;28.12.2017;2017;12;08;Torstai;1;11;12
626;28.12.2017;2017;12;09;Torstai;4;13;17
626;28.12.2017;2017;12;10;Torstai;3;2;5
626;28.12.2017;2017;12;11;Torstai;1;3;4
626;28.12.2017;2017;12;12;Torstai;8;3;11
626;28.12.2017;2017;12;13;Torstai;5;2;7
626;28.12.2017;2017;12;14;Torstai;2;6;8
626;28.12.2017;2017;12;15;Torstai;7;2;9
626;28.12.2017;2017;12;16;Torstai;7;2;9
626;28.12.2017;2017;12;17;Torstai;11;8;19
626;28.12.2017;2017;12;18;Torstai;5;5;10
626;28.12.2017;2017;12;19;Torstai;3;2;5
626;28.12.2017;2017;12;20;Torstai;2;4;6
626;28.12.2017;2017;12;21;Torstai;0;1;1
626;28.12.2017;2017;12;22;Torstai;2;4;6
626;28.12.2017;2017;12;23;Torstai;0;1;1
626;29.12.2017;2017;12;00;Perjantai;1;0;1
626;29.12.2017;2017;12;01;Perjantai;0;0;0
626;29.12.2017;2017;12;02;Perjantai;0;0;0
626;29.12.2017;2017;12;03;Perjantai;0;0;0
626;29.12.2017;2017;12;04;Perjantai;0;0;0
626;29.12.2017;2017;12;05;Perjantai;0;0;0
626;29.12.2017;2017;12;06;Perjantai;1;4;5
626;29.12.2017;2017;12;07;Perjantai;0;8;8
626;29.12.2017;2017;12;08;Perjantai;3;12;15
626;29.12.2017;2017;12;09;Perjantai;3;7;10
626;29.12.2017;2017;12;10;Perjantai;1;5;6
626;29.12.2017;2017;12;11;Perjantai;1;2;3
626;29.12.2017;2017;12;12;Perjantai;1;1;2
626;29.12.2017;2017;12;13;Perjantai;1;0;1
626;29.12.2017;2017;12;14;Perjantai;5;3;8
626;29.12.2017;2017;12;15;Perjantai;3;2;5
626;29.12.2017;2017;12;16;Perjantai;10;1;11
626;29.12.2017;2017;12;17;Perjantai;13;5;18
626;29.12.2017;2017;12;18;Perjantai;6;7;13
626;29.12.2017;2017;12;19;Perjantai;4;4;8
626;29.12.2017;2017;12;20;Perjantai;3;2;5
626;29.12.2017;2017;12;21;Perjantai;1;3;4
626;29.12.2017;2017;12;22;Perjantai;2;2;4
626;29.12.2017;2017;12;23;Perjantai;0;0;0
626;30.12.2017;2017;12;00;Lauantai;0;2;2
626;30.12.2017;2017;12;01;Lauantai;1;1;2
626;30.12.2017;2017;12;02;Lauantai;0;0;0
626;30.12.2017;2017;12;03;Lauantai;0;1;1
626;30.12.2017;2017;12;04;Lauantai;0;0;0
626;30.12.2017;2017;12;05;Lauantai;0;0;0
626;30.12.2017;2017;12;06;Lauantai;0;2;2
626;30.12.2017;2017;12;07;Lauantai;0;1;1
626;30.12.2017;2017;12;08;Lauantai;1;2;3
626;30.12.2017;2017;12;09;Lauantai;4;2;6
626;30.12.2017;2017;12;10;Lauantai;2;2;4
626;30.12.2017;2017;12;11;Lauantai;0;4;4
626;30.12.2017;2017;12;12;Lauantai;2;3;5
626;30.12.2017;2017;12;13;Lauantai;1;5;6
626;30.12.2017;2017;12;14;Lauantai;6;0;6
626;30.12.2017;2017;12;15;Lauantai;3;2;5
626;30.12.2017;2017;12;16;Lauantai;3;4;7
626;30.12.2017;2017;12;17;Lauantai;2;7;9
626;30.12.2017;2017;12;18;Lauantai;4;1;5
626;30.12.2017;2017;12;19;Lauantai;1;0;1
626;30.12.2017;2017;12;20;Lauantai;2;0;2
626;30.12.2017;2017;12;21;Lauantai;3;1;4
626;30.12.2017;2017;12;22;Lauantai;0;1;1
626;30.12.2017;2017;12;23;Lauantai;0;0;0
626;31.12.2017;2017;12;00;Sunnuntai;0;0;0
626;31.12.2017;2017;12;01;Sunnuntai;0;0;0
626;31.12.2017;2017;12;02;Sunnuntai;0;0;0
626;31.12.2017;2017;12;03;Sunnuntai;0;0;0
626;31.12.2017;2017;12;04;Sunnuntai;0;0;0
626;31.12.2017;2017;12;05;Sunnuntai;0;0;0
626;31.12.2017;2017;12;06;Sunnuntai;0;0;0
626;31.12.2017;2017;12;07;Sunnuntai;0;2;2
626;31.12.2017;2017;12;08;Sunnuntai;0;0;0
626;31.12.2017;2017;12;09;Sunnuntai;0;0;0
626;31.12.2017;2017;12;10;Sunnuntai;2;2;4
626;31.12.2017;2017;12;11;Sunnuntai;0;3;3
626;31.12.2017;2017;12;12;Sunnuntai;0;5;5
626;31.12.2017;2017;12;13;Sunnuntai;5;3;8
626;31.12.2017;2017;12;14;Sunnuntai;4;3;7
626;31.12.2017;2017;12;15;Sunnuntai;4;3;7
626;31.12.2017;2017;12;16;Sunnuntai;4;2;6
626;31.12.2017;2017;12;17;Sunnuntai;3;2;5
626;31.12.2017;2017;12;18;Sunnuntai;3;1;4
626;31.12.2017;2017;12;19;Sunnuntai;2;1;3
626;31.12.2017;2017;12;20;Sunnuntai;0;2;2
626;31.12.2017;2017;12;21;Sunnuntai;0;1;1
626;31.12.2017;2017;12;22;Sunnuntai;1;1;2
626;31.12.2017;2017;12;23;Sunnuntai;1;0;1
626;01.01.2018;2018;01;00;Maanantai;0;0;0
626;01.01.2018;2018;01;01;Maanantai;1;0;1
626;01.01.2018;2018;01;02;Maanantai;0;1;1
626;01.01.2018;2018;01;03;Maanantai;1;0;1
626;01.01.2018;2018;01;04;Maanantai;1;0;1
626;01.01.2018;2018;01;05;Maanantai;0;0;0
626;01.01.2018;2018;01;06;Maanantai;0;0;0
626;01.01.2018;2018;01;07;Maanantai;0;0;0
626;01.01.2018;2018;01;08;Maanantai;1;2;3
626;01.01.2018;2018;01;09;Maanantai;2;1;3
626;01.01.2018;2018;01;10;Maanantai;0;3;3
626;01.01.2018;2018;01;11;Maanantai;2;2;4
626;01.01.2018;2018;01;12;Maanantai;2;1;3
626;01.01.2018;2018;01;13;Maanantai;1;2;3
626;01.01.2018;2018;01;14;Maanantai;2;10;12
626;01.01.2018;2018;01;15;Maanantai;5;3;8
626;01.01.2018;2018;01;16;Maanantai;8;3;11
626;01.01.2018;2018;01;17;Maanantai;0;1;1
626;01.01.2018;2018;01;18;Maanantai;1;2;3
626;01.01.2018;2018;01;19;Maanantai;0;1;1
626;01.01.2018;2018;01;20;Maanantai;0;0;0
626;01.01.2018;2018;01;21;Maanantai;1;0;1
626;01.01.2018;2018;01;22;Maanantai;1;0;1
626;01.01.2018;2018;01;23;Maanantai;2;2;4
626;02.01.2018;2018;01;00;Tiistai;2;1;3
626;02.01.2018;2018;01;01;Tiistai;0;0;0
626;02.01.2018;2018;01;02;Tiistai;0;0;0
626;02.01.2018;2018;01;03;Tiistai;0;0;0
626;02.01.2018;2018;01;04;Tiistai;1;2;3
626;02.01.2018;2018;01;05;Tiistai;0;1;1
626;02.01.2018;2018;01;06;Tiistai;1;4;5
626;02.01.2018;2018;01;07;Tiistai;2;20;22
626;02.01.2018;2018;01;08;Tiistai;3;21;24
626;02.01.2018;2018;01;09;Tiistai;3;16;19
626;02.01.2018;2018;01;10;Tiistai;3;9;12
626;02.01.2018;2018;01;11;Tiistai;1;5;6
626;02.01.2018;2018;01;12;Tiistai;1;5;6
626;02.01.2018;2018;01;13;Tiistai;6;3;9
626;02.01.2018;2018;01;14;Tiistai;3;5;8
626;02.01.2018;2018;01;15;Tiistai;10;2;12
626;02.01.2018;2018;01;16;Tiistai;16;8;24
626;02.01.2018;2018;01;17;Tiistai;17;2;19
626;02.01.2018;2018;01;18;Tiistai;7;3;10
626;02.01.2018;2018;01;19;Tiistai;9;3;12
626;02.01.2018;2018;01;20;Tiistai;3;4;7
626;02.01.2018;2018;01;21;Tiistai;2;2;4
626;02.01.2018;2018;01;22;Tiistai;3;1;4
626;02.01.2018;2018;01;23;Tiistai;2;3;5
626;03.01.2018;2018;01;00;Keskiviikko;0;0;0
626;03.01.2018;2018;01;01;Keskiviikko;0;0;0
626;03.01.2018;2018;01;02;Keskiviikko;0;0;0
626;03.01.2018;2018;01;03;Keskiviikko;0;0;0
626;03.01.2018;2018;01;04;Keskiviikko;0;0;0
626;03.01.2018;2018;01;05;Keskiviikko;0;3;3
626;03.01.2018;2018;01;06;Keskiviikko;3;5;8
626;03.01.2018;2018;01;07;Keskiviikko;3;16;19
626;03.01.2018;2018;01;08;Keskiviikko;2;27;29
626;03.01.2018;2018;01;09;Keskiviikko;3;19;22
626;03.01.2018;2018;01;10;Keskiviikko;1;2;3
626;03.01.2018;2018;01;11;Keskiviikko;2;8;10
626;03.01.2018;2018;01;12;Keskiviikko;2;2;4
626;03.01.2018;2018;01;13;Keskiviikko;4;4;8
626;03.01.2018;2018;01;14;Keskiviikko;4;3;7
626;03.01.2018;2018;01;15;Keskiviikko;7;8;15
626;03.01.2018;2018;01;16;Keskiviikko;15;6;21
626;03.01.2018;2018;01;17;Keskiviikko;37;5;42
626;03.01.2018;2018;01;18;Keskiviikko;22;11;33
626;03.01.2018;2018;01;19;Keskiviikko;7;1;8
626;03.01.2018;2018;01;20;Keskiviikko;9;3;12
626;03.01.2018;2018;01;21;Keskiviikko;5;1;6
626;03.01.2018;2018;01;22;Keskiviikko;1;3;4
626;03.01.2018;2018;01;23;Keskiviikko;4;0;4
626;04.01.2018;2018;01;00;Torstai;1;0;1
626;04.01.2018;2018;01;01;Torstai;0;1;1
626;04.01.2018;2018;01;02;Torstai;0;0;0
626;04.01.2018;2018;01;03;Torstai;0;0;0
626;04.01.2018;2018;01;04;Torstai;0;0;0
626;04.01.2018;2018;01;05;Torstai;1;4;5
626;04.01.2018;2018;01;06;Torstai;3;4;7
626;04.01.2018;2018;01;07;Torstai;1;25;26
626;04.01.2018;2018;01;08;Torstai;5;26;31
626;04.01.2018;2018;01;09;Torstai;3;20;23
626;04.01.2018;2018;01;10;Torstai;1;4;5
626;04.01.2018;2018;01;11;Torstai;2;6;8
626;04.01.2018;2018;01;12;Torstai;6;3;9
626;04.01.2018;2018;01;13;Torstai;1;7;8
626;04.01.2018;2018;01;14;Torstai;5;9;14
626;04.01.2018;2018;01;15;Torstai;6;9;15
626;04.01.2018;2018;01;16;Torstai;17;6;23
626;04.01.2018;2018;01;17;Torstai;21;14;35
626;04.01.2018;2018;01;18;Torstai;15;7;22
626;04.01.2018;2018;01;19;Torstai;7;2;9
626;04.01.2018;2018;01;20;Torstai;6;3;9
626;04.01.2018;2018;01;21;Torstai;2;0;2
626;04.01.2018;2018;01;22;Torstai;3;0;3
626;04.01.2018;2018;01;23;Torstai;2;1;3
626;05.01.2018;2018;01;00;Perjantai;0;3;3
626;05.01.2018;2018;01;01;Perjantai;0;0;0
626;05.01.2018;2018;01;02;Perjantai;0;0;0
626;05.01.2018;2018;01;03;Perjantai;0;1;1
626;05.01.2018;2018;01;04;Perjantai;0;0;0
626;05.01.2018;2018;01;05;Perjantai;0;2;2
626;05.01.2018;2018;01;06;Perjantai;4;4;8
626;05.01.2018;2018;01;07;Perjantai;2;17;19
626;05.01.2018;2018;01;08;Perjantai;6;12;18
626;05.01.2018;2018;01;09;Perjantai;2;12;14
626;05.01.2018;2018;01;10;Perjantai;0;1;1
626;05.01.2018;2018;01;11;Perjantai;0;2;2
626;05.01.2018;2018;01;12;Perjantai;3;3;6
626;05.01.2018;2018;01;13;Perjantai;2;1;3
626;05.01.2018;2018;01;14;Perjantai;8;4;12
626;05.01.2018;2018;01;15;Perjantai;6;4;10
626;05.01.2018;2018;01;16;Perjantai;9;7;16
626;05.01.2018;2018;01;17;Perjantai;15;7;22
626;05.01.2018;2018;01;18;Perjantai;9;2;11
626;05.01.2018;2018;01;19;Perjantai;1;2;3
626;05.01.2018;2018;01;20;Perjantai;0;4;4
626;05.01.2018;2018;01;21;Perjantai;1;1;2
626;05.01.2018;2018;01;22;Perjantai;0;0;0
626;05.01.2018;2018;01;23;Perjantai;2;1;3
626;06.01.2018;2018;01;00;Lauantai;0;0;0
626;06.01.2018;2018;01;01;Lauantai;1;1;2
626;06.01.2018;2018;01;02;Lauantai;1;0;1
626;06.01.2018;2018;01;03;Lauantai;1;1;2
626;06.01.2018;2018;01;04;Lauantai;0;0;0
626;06.01.2018;2018;01;05;Lauantai;0;0;0
626;06.01.2018;2018;01;06;Lauantai;0;0;0
626;06.01.2018;2018;01;07;Lauantai;0;0;0
626;06.01.2018;2018;01;08;Lauantai;0;2;2
626;06.01.2018;2018;01;09;Lauantai;0;0;0
626;06.01.2018;2018;01;10;Lauantai;0;1;1
626;06.01.2018;2018;01;11;Lauantai;1;1;2
626;06.01.2018;2018;01;12;Lauantai;0;3;3
626;06.01.2018;2018;01;13;Lauantai;1;2;3
626;06.01.2018;2018;01;14;Lauantai;1;4;5
626;06.01.2018;2018;01;15;Lauantai;1;1;2
626;06.01.2018;2018;01;16;Lauantai;4;2;6
626;06.01.2018;2018;01;17;Lauantai;3;2;5
626;06.01.2018;2018;01;18;Lauantai;4;2;6
626;06.01.2018;2018;01;19;Lauantai;1;1;2
626;06.01.2018;2018;01;20;Lauantai;0;0;0
626;06.01.2018;2018;01;21;Lauantai;1;2;3
626;06.01.2018;2018;01;22;Lauantai;1;0;1
626;06.01.2018;2018;01;23;Lauantai;1;0;1
626;07.01.2018;2018;01;00;Sunnuntai;0;0;0
626;07.01.2018;2018;01;01;Sunnuntai;0;0;0
626;07.01.2018;2018;01;02;Sunnuntai;0;0;0
626;07.01.2018;2018;01;03;Sunnuntai;0;0;0
626;07.01.2018;2018;01;04;Sunnuntai;1;0;1
626;07.01.2018;2018;01;05;Sunnuntai;0;1;1
626;07.01.2018;2018;01;06;Sunnuntai;2;2;4
626;07.01.2018;2018;01;07;Sunnuntai;0;0;0
626;07.01.2018;2018;01;08;Sunnuntai;0;1;1
626;07.01.2018;2018;01;09;Sunnuntai;0;0;0
626;07.01.2018;2018;01;10;Sunnuntai;2;0;2
626;07.01.2018;2018;01;11;Sunnuntai;1;6;7
626;07.01.2018;2018;01;12;Sunnuntai;2;3;5
626;07.01.2018;2018;01;13;Sunnuntai;0;4;4
626;07.01.2018;2018;01;14;Sunnuntai;0;4;4
626;07.01.2018;2018;01;15;Sunnuntai;3;4;7
626;07.01.2018;2018;01;16;Sunnuntai;0;3;3
626;07.01.2018;2018;01;17;Sunnuntai;2;4;6
626;07.01.2018;2018;01;18;Sunnuntai;1;0;1
626;07.01.2018;2018;01;19;Sunnuntai;2;2;4
626;07.01.2018;2018;01;20;Sunnuntai;1;2;3
626;07.01.2018;2018;01;21;Sunnuntai;3;0;3
626;07.01.2018;2018;01;22;Sunnuntai;2;1;3
626;07.01.2018;2018;01;23;Sunnuntai;1;0;1
626;08.01.2018;2018;01;00;Maanantai;0;0;0
626;08.01.2018;2018;01;01;Maanantai;0;0;0
626;08.01.2018;2018;01;02;Maanantai;0;0;0
626;08.01.2018;2018;01;03;Maanantai;0;0;0
626;08.01.2018;2018;01;04;Maanantai;0;0;0
626;08.01.2018;2018;01;05;Maanantai;0;2;2
626;08.01.2018;2018;01;06;Maanantai;2;5;7
626;08.01.2018;2018;01;07;Maanantai;1;17;18
626;08.01.2018;2018;01;08;Maanantai;4;17;21
626;08.01.2018;2018;01;09;Maanantai;3;12;15
626;08.01.2018;2018;01;10;Maanantai;1;4;5
626;08.01.2018;2018;01;11;Maanantai;3;2;5
626;08.01.2018;2018;01;12;Maanantai;1;5;6
626;08.01.2018;2018;01;13;Maanantai;2;1;3
626;08.01.2018;2018;01;14;Maanantai;0;4;4
626;08.01.2018;2018;01;15;Maanantai;2;4;6
626;08.01.2018;2018;01;16;Maanantai;8;6;14
626;08.01.2018;2018;01;17;Maanantai;12;6;18
626;08.01.2018;2018;01;18;Maanantai;5;6;11
626;08.01.2018;2018;01;19;Maanantai;3;3;6
626;08.01.2018;2018;01;20;Maanantai;3;2;5
626;08.01.2018;2018;01;21;Maanantai;3;0;3
626;08.01.2018;2018;01;22;Maanantai;1;1;2
626;08.01.2018;2018;01;23;Maanantai;1;1;2
626;09.01.2018;2018;01;00;Tiistai;0;3;3
626;09.01.2018;2018;01;01;Tiistai;0;0;0
626;09.01.2018;2018;01;02;Tiistai;1;1;2
626;09.01.2018;2018;01;03;Tiistai;0;0;0
626;09.01.2018;2018;01;04;Tiistai;0;0;0
626;09.01.2018;2018;01;05;Tiistai;0;0;0
626;09.01.2018;2018;01;06;Tiistai;0;5;5
626;09.01.2018;2018;01;07;Tiistai;1;16;17
626;09.01.2018;2018;01;08;Tiistai;2;32;34
626;09.01.2018;2018;01;09;Tiistai;2;18;20
626;09.01.2018;2018;01;10;Tiistai;3;5;8
626;09.01.2018;2018;01;11;Tiistai;0;4;4
626;09.01.2018;2018;01;12;Tiistai;5;3;8
626;09.01.2018;2018;01;13;Tiistai;2;4;6
626;09.01.2018;2018;01;14;Tiistai;4;5;9
626;09.01.2018;2018;01;15;Tiistai;3;5;8
626;09.01.2018;2018;01;16;Tiistai;10;9;19
626;09.01.2018;2018;01;17;Tiistai;21;9;30
626;09.01.2018;2018;01;18;Tiistai;12;5;17
626;09.01.2018;2018;01;19;Tiistai;7;6;13
626;09.01.2018;2018;01;20;Tiistai;6;2;8
626;09.01.2018;2018;01;21;Tiistai;1;3;4
626;09.01.2018;2018;01;22;Tiistai;2;4;6
626;09.01.2018;2018;01;23;Tiistai;2;2;4
626;10.01.2018;2018;01;00;Keskiviikko;0;0;0
626;10.01.2018;2018;01;01;Keskiviikko;0;0;0
626;10.01.2018;2018;01;02;Keskiviikko;0;0;0
626;10.01.2018;2018;01;03;Keskiviikko;0;0;0
626;10.01.2018;2018;01;04;Keskiviikko;0;1;1
626;10.01.2018;2018;01;05;Keskiviikko;0;1;1
626;10.01.2018;2018;01;06;Keskiviikko;2;9;11
626;10.01.2018;2018;01;07;Keskiviikko;0;17;17
626;10.01.2018;2018;01;08;Keskiviikko;5;38;43
626;10.01.2018;2018;01;09;Keskiviikko;6;17;23
626;10.01.2018;2018;01;10;Keskiviikko;1;5;6
626;10.01.2018;2018;01;11;Keskiviikko;2;2;4
626;10.01.2018;2018;01;12;Keskiviikko;1;5;6
626;10.01.2018;2018;01;13;Keskiviikko;1;4;5
626;10.01.2018;2018;01;14;Keskiviikko;6;4;10
626;10.01.2018;2018;01;15;Keskiviikko;6;9;15
626;10.01.2018;2018;01;16;Keskiviikko;11;12;23
626;10.01.2018;2018;01;17;Keskiviikko;18;10;28
626;10.01.2018;2018;01;18;Keskiviikko;6;7;13
626;10.01.2018;2018;01;19;Keskiviikko;6;6;12
626;10.01.2018;2018;01;20;Keskiviikko;8;1;9
626;10.01.2018;2018;01;21;Keskiviikko;5;0;5
626;10.01.2018;2018;01;22;Keskiviikko;1;1;2
626;10.01.2018;2018;01;23;Keskiviikko;2;2;4
626;11.01.2018;2018;01;00;Torstai;1;0;1
626;11.01.2018;2018;01;01;Torstai;0;1;1
626;11.01.2018;2018;01;02;Torstai;0;0;0
626;11.01.2018;2018;01;03;Torstai;0;0;0
626;11.01.2018;2018;01;04;Torstai;1;2;3
626;11.01.2018;2018;01;05;Torstai;0;2;2
626;11.01.2018;2018;01;06;Torstai;3;5;8
626;11.01.2018;2018;01;07;Torstai;3;21;24
626;11.01.2018;2018;01;08;Torstai;4;34;38
626;11.01.2018;2018;01;09;Torstai;2;17;19
626;11.01.2018;2018;01;10;Torstai;1;6;7
626;11.01.2018;2018;01;11;Torstai;3;4;7
626;11.01.2018;2018;01;12;Torstai;2;3;5
626;11.01.2018;2018;01;13;Torstai;2;7;9
626;11.01.2018;2018;01;14;Torstai;3;5;8
626;11.01.2018;2018;01;15;Torstai;4;9;13
626;11.01.2018;2018;01;16;Torstai;12;10;22
626;11.01.2018;2018;01;17;Torstai;11;8;19
626;11.01.2018;2018;01;18;Torstai;5;3;8
626;11.01.2018;2018;01;19;Torstai;9;0;9
626;11.01.2018;2018;01;20;Torstai;3;3;6
626;11.01.2018;2018;01;21;Torstai;1;0;1
626;11.01.2018;2018;01;22;Torstai;2;2;4
626;11.01.2018;2018;01;23;Torstai;0;0;0
626;12.01.2018;2018;01;00;Perjantai;0;0;0
626;12.01.2018;2018;01;01;Perjantai;0;0;0
626;12.01.2018;2018;01;02;Perjantai;0;0;0
626;12.01.2018;2018;01;03;Perjantai;0;0;0
626;12.01.2018;2018;01;04;Perjantai;0;0;0
626;12.01.2018;2018;01;05;Perjantai;0;0;0
626;12.01.2018;2018;01;06;Perjantai;1;9;10
626;12.01.2018;2018;01;07;Perjantai;2;16;18
626;12.01.2018;2018;01;08;Perjantai;3;31;34
626;12.01.2018;2018;01;09;Perjantai;7;9;16
626;12.01.2018;2018;01;10;Perjantai;0;5;5
626;12.01.2018;2018;01;11;Perjantai;3;5;8
626;12.01.2018;2018;01;12;Perjantai;2;3;5
626;12.01.2018;2018;01;13;Perjantai;4;6;10
626;12.01.2018;2018;01;14;Perjantai;4;7;11
626;12.01.2018;2018;01;15;Perjantai;4;5;9
626;12.01.2018;2018;01;16;Perjantai;15;9;24
626;12.01.2018;2018;01;17;Perjantai;8;8;16
626;12.01.2018;2018;01;18;Perjantai;10;9;19
626;12.01.2018;2018;01;19;Perjantai;7;2;9
626;12.01.2018;2018;01;20;Perjantai;1;2;3
626;12.01.2018;2018;01;21;Perjantai;7;2;9
626;12.01.2018;2018;01;22;Perjantai;6;2;8
626;12.01.2018;2018;01;23;Perjantai;1;1;2
626;13.01.2018;2018;01;00;Lauantai;1;0;1
626;13.01.2018;2018;01;01;Lauantai;1;0;1
626;13.01.2018;2018;01;02;Lauantai;0;0;0
626;13.01.2018;2018;01;03;Lauantai;0;0;0
626;13.01.2018;2018;01;04;Lauantai;0;1;1
626;13.01.2018;2018;01;05;Lauantai;0;0;0
626;13.01.2018;2018;01;06;Lauantai;0;2;2
626;13.01.2018;2018;01;07;Lauantai;0;3;3
626;13.01.2018;2018;01;08;Lauantai;0;3;3
626;13.01.2018;2018;01;09;Lauantai;0;2;2
626;13.01.2018;2018;01;10;Lauantai;0;5;5
626;13.01.2018;2018;01;11;Lauantai;3;4;7
626;13.01.2018;2018;01;12;Lauantai;1;6;7
626;13.01.2018;2018;01;13;Lauantai;4;6;10
626;13.01.2018;2018;01;14;Lauantai;12;11;23
626;13.01.2018;2018;01;15;Lauantai;6;4;10
626;13.01.2018;2018;01;16;Lauantai;4;6;10
626;13.01.2018;2018;01;17;Lauantai;4;3;7
626;13.01.2018;2018;01;18;Lauantai;6;3;9
626;13.01.2018;2018;01;19;Lauantai;2;1;3
626;13.01.2018;2018;01;20;Lauantai;3;1;4
626;13.01.2018;2018;01;21;Lauantai;4;0;4
626;13.01.2018;2018;01;22;Lauantai;0;0;0
626;13.01.2018;2018;01;23;Lauantai;1;0;1
626;14.01.2018;2018;01;00;Sunnuntai;0;0;0
626;14.01.2018;2018;01;01;Sunnuntai;0;1;1
626;14.01.2018;2018;01;02;Sunnuntai;1;0;1
626;14.01.2018;2018;01;03;Sunnuntai;0;1;1
626;14.01.2018;2018;01;04;Sunnuntai;0;0;0
626;14.01.2018;2018;01;05;Sunnuntai;0;0;0
626;14.01.2018;2018;01;06;Sunnuntai;0;1;1
626;14.01.2018;2018;01;07;Sunnuntai;2;1;3
626;14.01.2018;2018;01;08;Sunnuntai;0;3;3
626;14.01.2018;2018;01;09;Sunnuntai;0;1;1
626;14.01.2018;2018;01;10;Sunnuntai;2;3;5
626;14.01.2018;2018;01;11;Sunnuntai;1;1;2
626;14.01.2018;2018;01;12;Sunnuntai;1;4;5
626;14.01.2018;2018;01;13;Sunnuntai;4;7;11
626;14.01.2018;2018;01;14;Sunnuntai;4;5;9
626;14.01.2018;2018;01;15;Sunnuntai;6;7;13
626;14.01.2018;2018;01;16;Sunnuntai;2;2;4
626;14.01.2018;2018;01;17;Sunnuntai;2;4;6
626;14.01.2018;2018;01;18;Sunnuntai;2;4;6
626;14.01.2018;2018;01;19;Sunnuntai;1;3;4
626;14.01.2018;2018;01;20;Sunnuntai;5;5;10
626;14.01.2018;2018;01;21;Sunnuntai;1;0;1
626;14.01.2018;2018;01;22;Sunnuntai;2;0;2
626;14.01.2018;2018;01;23;Sunnuntai;3;0;3
626;15.01.2018;2018;01;00;Maanantai;0;0;0
626;15.01.2018;2018;01;01;Maanantai;0;0;0
626;15.01.2018;2018;01;02;Maanantai;0;0;0
626;15.01.2018;2018;01;03;Maanantai;0;0;0
626;15.01.2018;2018;01;04;Maanantai;1;2;3
626;15.01.2018;2018;01;05;Maanantai;0;3;3
626;15.01.2018;2018;01;06;Maanantai;3;10;13
626;15.01.2018;2018;01;07;Maanantai;2;15;17
626;15.01.2018;2018;01;08;Maanantai;2;29;31
626;15.01.2018;2018;01;09;Maanantai;7;19;26
626;15.01.2018;2018;01;10;Maanantai;1;4;5
626;15.01.2018;2018;01;11;Maanantai;2;5;7
626;15.01.2018;2018;01;12;Maanantai;2;4;6
626;15.01.2018;2018;01;13;Maanantai;4;2;6
626;15.01.2018;2018;01;14;Maanantai;5;8;13
626;15.01.2018;2018;01;15;Maanantai;2;4;6
626;15.01.2018;2018;01;16;Maanantai;16;7;23
626;15.01.2018;2018;01;17;Maanantai;18;6;24
626;15.01.2018;2018;01;18;Maanantai;14;6;20
626;15.01.2018;2018;01;19;Maanantai;6;3;9
626;15.01.2018;2018;01;20;Maanantai;8;1;9
626;15.01.2018;2018;01;21;Maanantai;2;3;5
626;15.01.2018;2018;01;22;Maanantai;4;2;6
626;15.01.2018;2018;01;23;Maanantai;2;0;2
626;16.01.2018;2018;01;00;Tiistai;0;0;0
626;16.01.2018;2018;01;01;Tiistai;0;0;0
626;16.01.2018;2018;01;02;Tiistai;0;0;0
626;16.01.2018;2018;01;03;Tiistai;0;1;1
626;16.01.2018;2018;01;04;Tiistai;0;0;0
626;16.01.2018;2018;01;05;Tiistai;0;3;3
626;16.01.2018;2018;01;06;Tiistai;4;5;9
626;16.01.2018;2018;01;07;Tiistai;1;12;13
626;16.01.2018;2018;01;08;Tiistai;7;28;35
626;16.01.2018;2018;01;09;Tiistai;4;9;13
626;16.01.2018;2018;01;10;Tiistai;2;4;6
626;16.01.2018;2018;01;11;Tiistai;2;3;5
626;16.01.2018;2018;01;12;Tiistai;1;2;3
626;16.01.2018;2018;01;13;Tiistai;2;3;5
626;16.01.2018;2018;01;14;Tiistai;5;7;12
626;16.01.2018;2018;01;15;Tiistai;2;7;9
626;16.01.2018;2018;01;16;Tiistai;9;4;13
626;16.01.2018;2018;01;17;Tiistai;21;13;34
626;16.01.2018;2018;01;18;Tiistai;10;1;11
626;16.01.2018;2018;01;19;Tiistai;7;2;9
626;16.01.2018;2018;01;20;Tiistai;5;0;5
626;16.01.2018;2018;01;21;Tiistai;6;1;7
626;16.01.2018;2018;01;22;Tiistai;4;1;5
626;16.01.2018;2018;01;23;Tiistai;1;0;1
626;17.01.2018;2018;01;00;Keskiviikko;0;0;0
626;17.01.2018;2018;01;01;Keskiviikko;0;1;1
626;17.01.2018;2018;01;02;Keskiviikko;1;0;1
626;17.01.2018;2018;01;03;Keskiviikko;0;0;0
626;17.01.2018;2018;01;04;Keskiviikko;0;1;1
626;17.01.2018;2018;01;05;Keskiviikko;0;3;3
626;17.01.2018;2018;01;06;Keskiviikko;3;3;6
626;17.01.2018;2018;01;07;Keskiviikko;1;8;9
626;17.01.2018;2018;01;08;Keskiviikko;1;21;22
626;17.01.2018;2018;01;09;Keskiviikko;6;6;12
626;17.01.2018;2018;01;10;Keskiviikko;0;2;2
626;17.01.2018;2018;01;11;Keskiviikko;0;3;3
626;17.01.2018;2018;01;12;Keskiviikko;1;1;2
626;17.01.2018;2018;01;13;Keskiviikko;2;4;6
626;17.01.2018;2018;01;14;Keskiviikko;5;3;8
626;17.01.2018;2018;01;15;Keskiviikko;3;9;12
626;17.01.2018;2018;01;16;Keskiviikko;11;8;19
626;17.01.2018;2018;01;17;Keskiviikko;14;7;21
626;17.01.2018;2018;01;18;Keskiviikko;10;3;13
626;17.01.2018;2018;01;19;Keskiviikko;5;1;6
626;17.01.2018;2018;01;20;Keskiviikko;0;1;1
626;17.01.2018;2018;01;21;Keskiviikko;3;1;4
626;17.01.2018;2018;01;22;Keskiviikko;2;1;3
626;17.01.2018;2018;01;23;Keskiviikko;0;1;1
626;18.01.2018;2018;01;00;Torstai;2;0;2
626;18.01.2018;2018;01;01;Torstai;0;0;0
626;18.01.2018;2018;01;02;Torstai;1;0;1
626;18.01.2018;2018;01;03;Torstai;0;1;1
626;18.01.2018;2018;01;04;Torstai;0;1;1
626;18.01.2018;2018;01;05;Torstai;0;2;2
626;18.01.2018;2018;01;06;Torstai;3;6;9
626;18.01.2018;2018;01;07;Torstai;1;13;14
626;18.01.2018;2018;01;08;Torstai;5;29;34
626;18.01.2018;2018;01;09;Torstai;4;8;12
626;18.01.2018;2018;01;10;Torstai;3;4;7
626;18.01.2018;2018;01;11;Torstai;5;2;7
626;18.01.2018;2018;01;12;Torstai;1;1;2
626;18.01.2018;2018;01;13;Torstai;5;3;8
626;18.01.2018;2018;01;14;Torstai;5;2;7
626;18.01.2018;2018;01;15;Torstai;6;3;9
626;18.01.2018;2018;01;16;Torstai;10;5;15
626;18.01.2018;2018;01;17;Torstai;19;4;23
626;18.01.2018;2018;01;18;Torstai;10;5;15
626;18.01.2018;2018;01;19;Torstai;6;4;10
626;18.01.2018;2018;01;20;Torstai;8;1;9
626;18.01.2018;2018;01;21;Torstai;9;1;10
626;18.01.2018;2018;01;22;Torstai;3;0;3
626;18.01.2018;2018;01;23;Torstai;1;1;2
626;19.01.2018;2018;01;00;Perjantai;0;0;0
626;19.01.2018;2018;01;01;Perjantai;1;0;1
626;19.01.2018;2018;01;02;Perjantai;0;0;0
626;19.01.2018;2018;01;03;Perjantai;0;0;0
626;19.01.2018;2018;01;04;Perjantai;0;1;1
626;19.01.2018;2018;01;05;Perjantai;1;3;4
626;19.01.2018;2018;01;06;Perjantai;3;8;11
626;19.01.2018;2018;01;07;Perjantai;1;19;20
626;19.01.2018;2018;01;08;Perjantai;6;21;27
626;19.01.2018;2018;01;09;Perjantai;4;7;11
626;19.01.2018;2018;01;10;Perjantai;3;4;7
626;19.01.2018;2018;01;11;Perjantai;1;1;2
626;19.01.2018;2018;01;12;Perjantai;4;4;8
626;19.01.2018;2018;01;13;Perjantai;2;3;5
626;19.01.2018;2018;01;14;Perjantai;7;4;11
626;19.01.2018;2018;01;15;Perjantai;10;6;16
626;19.01.2018;2018;01;16;Perjantai;16;6;22
626;19.01.2018;2018;01;17;Perjantai;13;5;18
626;19.01.2018;2018;01;18;Perjantai;9;2;11
626;19.01.2018;2018;01;19;Perjantai;4;2;6
626;19.01.2018;2018;01;20;Perjantai;2;0;2
626;19.01.2018;2018;01;21;Perjantai;2;2;4
626;19.01.2018;2018;01;22;Perjantai;1;0;1
626;19.01.2018;2018;01;23;Perjantai;1;0;1
626;20.01.2018;2018;01;00;Lauantai;0;0;0
626;20.01.2018;2018;01;01;Lauantai;0;0;0
626;20.01.2018;2018;01;02;Lauantai;1;0;1
626;20.01.2018;2018;01;03;Lauantai;0;0;0
626;20.01.2018;2018;01;04;Lauantai;1;0;1
626;20.01.2018;2018;01;05;Lauantai;0;0;0
626;20.01.2018;2018;01;06;Lauantai;1;1;2
626;20.01.2018;2018;01;07;Lauantai;1;0;1
626;20.01.2018;2018;01;08;Lauantai;1;2;3
626;20.01.2018;2018;01;09;Lauantai;1;0;1
626;20.01.2018;2018;01;10;Lauantai;1;1;2
626;20.01.2018;2018;01;11;Lauantai;1;5;6
626;20.01.2018;2018;01;12;Lauantai;1;6;7
626;20.01.2018;2018;01;13;Lauantai;3;1;4
626;20.01.2018;2018;01;14;Lauantai;1;2;3
626;20.01.2018;2018;01;15;Lauantai;1;1;2
626;20.01.2018;2018;01;16;Lauantai;5;3;8
626;20.01.2018;2018;01;17;Lauantai;2;1;3
626;20.01.2018;2018;01;18;Lauantai;1;3;4
626;20.01.2018;2018;01;19;Lauantai;4;1;5
626;20.01.2018;2018;01;20;Lauantai;1;0;1
626;20.01.2018;2018;01;21;Lauantai;0;2;2
626;20.01.2018;2018;01;22;Lauantai;1;3;4
626;20.01.2018;2018;01;23;Lauantai;0;0;0
626;21.01.2018;2018;01;00;Sunnuntai;0;0;0
626;21.01.2018;2018;01;01;Sunnuntai;0;0;0
626;21.01.2018;2018;01;02;Sunnuntai;0;0;0
626;21.01.2018;2018;01;03;Sunnuntai;0;0;0
626;21.01.2018;2018;01;04;Sunnuntai;0;1;1
626;21.01.2018;2018;01;05;Sunnuntai;0;0;0
626;21.01.2018;2018;01;06;Sunnuntai;0;1;1
626;21.01.2018;2018;01;07;Sunnuntai;0;1;1
626;21.01.2018;2018;01;08;Sunnuntai;0;1;1
626;21.01.2018;2018;01;09;Sunnuntai;0;0;0
626;21.01.2018;2018;01;10;Sunnuntai;1;1;2
626;21.01.2018;2018;01;11;Sunnuntai;1;2;3
626;21.01.2018;2018;01;12;Sunnuntai;2;2;4
626;21.01.2018;2018;01;13;Sunnuntai;1;0;1
626;21.01.2018;2018;01;14;Sunnuntai;3;1;4
626;21.01.2018;2018;01;15;Sunnuntai;3;2;5
626;21.01.2018;2018;01;16;Sunnuntai;2;1;3
626;21.01.2018;2018;01;17;Sunnuntai;2;1;3
626;21.01.2018;2018;01;18;Sunnuntai;2;4;6
626;21.01.2018;2018;01;19;Sunnuntai;1;2;3
626;21.01.2018;2018;01;20;Sunnuntai;3;3;6
626;21.01.2018;2018;01;21;Sunnuntai;2;0;2
626;21.01.2018;2018;01;22;Sunnuntai;0;0;0
626;21.01.2018;2018;01;23;Sunnuntai;0;2;2
626;22.01.2018;2018;01;00;Maanantai;0;0;0
626;22.01.2018;2018;01;01;Maanantai;0;0;0
626;22.01.2018;2018;01;02;Maanantai;0;0;0
626;22.01.2018;2018;01;03;Maanantai;0;0;0
626;22.01.2018;2018;01;04;Maanantai;0;0;0
626;22.01.2018;2018;01;05;Maanantai;1;2;3
626;22.01.2018;2018;01;06;Maanantai;3;6;9
626;22.01.2018;2018;01;07;Maanantai;2;14;16
626;22.01.2018;2018;01;08;Maanantai;1;20;21
626;22.01.2018;2018;01;09;Maanantai;7;8;15
626;22.01.2018;2018;01;10;Maanantai;4;6;10
626;22.01.2018;2018;01;11;Maanantai;3;1;4
626;22.01.2018;2018;01;12;Maanantai;2;0;2
626;22.01.2018;2018;01;13;Maanantai;1;1;2
626;22.01.2018;2018;01;14;Maanantai;6;4;10
626;22.01.2018;2018;01;15;Maanantai;6;6;12
626;22.01.2018;2018;01;16;Maanantai;8;4;12
626;22.01.2018;2018;01;17;Maanantai;18;11;29
626;22.01.2018;2018;01;18;Maanantai;5;3;8
626;22.01.2018;2018;01;19;Maanantai;2;0;2
626;22.01.2018;2018;01;20;Maanantai;7;3;10
626;22.01.2018;2018;01;21;Maanantai;1;1;2
626;22.01.2018;2018;01;22;Maanantai;1;3;4
626;22.01.2018;2018;01;23;Maanantai;1;1;2
626;23.01.2018;2018;01;00;Tiistai;0;0;0
626;23.01.2018;2018;01;01;Tiistai;1;0;1
626;23.01.2018;2018;01;02;Tiistai;0;0;0
626;23.01.2018;2018;01;03;Tiistai;0;0;0
626;23.01.2018;2018;01;04;Tiistai;0;1;1
626;23.01.2018;2018;01;05;Tiistai;1;3;4
626;23.01.2018;2018;01;06;Tiistai;4;4;8
626;23.01.2018;2018;01;07;Tiistai;2;11;13
626;23.01.2018;2018;01;08;Tiistai;4;17;21
626;23.01.2018;2018;01;09;Tiistai;5;7;12
626;23.01.2018;2018;01;10;Tiistai;2;2;4
626;23.01.2018;2018;01;11;Tiistai;1;4;5
626;23.01.2018;2018;01;12;Tiistai;0;1;1
626;23.01.2018;2018;01;13;Tiistai;0;3;3
626;23.01.2018;2018;01;14;Tiistai;1;3;4
626;23.01.2018;2018;01;15;Tiistai;4;7;11
626;23.01.2018;2018;01;16;Tiistai;9;8;17
626;23.01.2018;2018;01;17;Tiistai;13;5;18
626;23.01.2018;2018;01;18;Tiistai;8;3;11
626;23.01.2018;2018;01;19;Tiistai;1;3;4
626;23.01.2018;2018;01;20;Tiistai;0;2;2
626;23.01.2018;2018;01;21;Tiistai;4;0;4
626;23.01.2018;2018;01;22;Tiistai;1;1;2
626;23.01.2018;2018;01;23;Tiistai;1;0;1
626;24.01.2018;2018;01;00;Keskiviikko;0;1;1
626;24.01.2018;2018;01;01;Keskiviikko;0;1;1
626;24.01.2018;2018;01;02;Keskiviikko;0;0;0
626;24.01.2018;2018;01;03;Keskiviikko;0;0;0
626;24.01.2018;2018;01;04;Keskiviikko;0;1;1
626;24.01.2018;2018;01;05;Keskiviikko;0;3;3
626;24.01.2018;2018;01;06;Keskiviikko;4;2;6
626;24.01.2018;2018;01;07;Keskiviikko;3;13;16
626;24.01.2018;2018;01;08;Keskiviikko;4;34;38
626;24.01.2018;2018;01;09;Keskiviikko;8;10;18
626;24.01.2018;2018;01;10;Keskiviikko;3;5;8
626;24.01.2018;2018;01;11;Keskiviikko;1;5;6
626;24.01.2018;2018;01;12;Keskiviikko;1;1;2
626;24.01.2018;2018;01;13;Keskiviikko;3;1;4
626;24.01.2018;2018;01;14;Keskiviikko;2;3;5
626;24.01.2018;2018;01;15;Keskiviikko;9;8;17
626;24.01.2018;2018;01;16;Keskiviikko;9;8;17
626;24.01.2018;2018;01;17;Keskiviikko;20;13;33
626;24.01.2018;2018;01;18;Keskiviikko;10;3;13
626;24.01.2018;2018;01;19;Keskiviikko;7;3;10
626;24.01.2018;2018;01;20;Keskiviikko;1;0;1
626;24.01.2018;2018;01;21;Keskiviikko;3;2;5
626;24.01.2018;2018;01;22;Keskiviikko;1;0;1
626;24.01.2018;2018;01;23;Keskiviikko;2;1;3
626;25.01.2018;2018;01;00;Torstai;1;0;1
626;25.01.2018;2018;01;01;Torstai;1;0;1
626;25.01.2018;2018;01;02;Torstai;0;0;0
626;25.01.2018;2018;01;03;Torstai;0;1;1
626;25.01.2018;2018;01;04;Torstai;0;1;1
626;25.01.2018;2018;01;05;Torstai;0;3;3
626;25.01.2018;2018;01;06;Torstai;3;2;5
626;25.01.2018;2018;01;07;Torstai;1;12;13
626;25.01.2018;2018;01;08;Torstai;2;21;23
626;25.01.2018;2018;01;09;Torstai;6;15;21
626;25.01.2018;2018;01;10;Torstai;0;3;3
626;25.01.2018;2018;01;11;Torstai;2;3;5
626;25.01.2018;2018;01;12;Torstai;1;3;4
626;25.01.2018;2018;01;13;Torstai;4;3;7
626;25.01.2018;2018;01;14;Torstai;3;1;4
626;25.01.2018;2018;01;15;Torstai;4;5;9
626;25.01.2018;2018;01;16;Torstai;11;6;17
626;25.01.2018;2018;01;17;Torstai;19;5;24
626;25.01.2018;2018;01;18;Torstai;12;8;20
626;25.01.2018;2018;01;19;Torstai;5;4;9
626;25.01.2018;2018;01;20;Torstai;1;2;3
626;25.01.2018;2018;01;21;Torstai;3;0;3
626;25.01.2018;2018;01;22;Torstai;2;1;3
626;25.01.2018;2018;01;23;Torstai;3;2;5
626;26.01.2018;2018;01;00;Perjantai;0;1;1
626;26.01.2018;2018;01;01;Perjantai;1;0;1
626;26.01.2018;2018;01;02;Perjantai;0;0;0
626;26.01.2018;2018;01;03;Perjantai;0;0;0
626;26.01.2018;2018;01;04;Perjantai;0;1;1
626;26.01.2018;2018;01;05;Perjantai;1;2;3
626;26.01.2018;2018;01;06;Perjantai;3;7;10
626;26.01.2018;2018;01;07;Perjantai;4;6;10
626;26.01.2018;2018;01;08;Perjantai;3;13;16
626;26.01.2018;2018;01;09;Perjantai;5;7;12
626;26.01.2018;2018;01;10;Perjantai;0;4;4
626;26.01.2018;2018;01;11;Perjantai;0;3;3
626;26.01.2018;2018;01;12;Perjantai;1;2;3
626;26.01.2018;2018;01;13;Perjantai;5;7;12
626;26.01.2018;2018;01;14;Perjantai;6;4;10
626;26.01.2018;2018;01;15;Perjantai;8;6;14
626;26.01.2018;2018;01;16;Perjantai;10;5;15
626;26.01.2018;2018;01;17;Perjantai;11;9;20
626;26.01.2018;2018;01;18;Perjantai;9;7;16
626;26.01.2018;2018;01;19;Perjantai;5;3;8
626;26.01.2018;2018;01;20;Perjantai;6;1;7
626;26.01.2018;2018;01;21;Perjantai;3;1;4
626;26.01.2018;2018;01;22;Perjantai;1;1;2
626;26.01.2018;2018;01;23;Perjantai;4;0;4
626;27.01.2018;2018;01;00;Lauantai;1;1;2
626;27.01.2018;2018;01;01;Lauantai;0;0;0
626;27.01.2018;2018;01;02;Lauantai;0;0;0
626;27.01.2018;2018;01;03;Lauantai;0;0;0
626;27.01.2018;2018;01;04;Lauantai;0;0;0
626;27.01.2018;2018;01;05;Lauantai;0;2;2
626;27.01.2018;2018;01;06;Lauantai;1;0;1
626;27.01.2018;2018;01;07;Lauantai;1;2;3
626;27.01.2018;2018;01;08;Lauantai;0;4;4
626;27.01.2018;2018;01;09;Lauantai;0;2;2
626;27.01.2018;2018;01;10;Lauantai;1;6;7
626;27.01.2018;2018;01;11;Lauantai;3;2;5
626;27.01.2018;2018;01;12;Lauantai;2;4;6
626;27.01.2018;2018;01;13;Lauantai;6;3;9
626;27.01.2018;2018;01;14;Lauantai;6;11;17
626;27.01.2018;2018;01;15;Lauantai;2;6;8
626;27.01.2018;2018;01;16;Lauantai;5;6;11
626;27.01.2018;2018;01;17;Lauantai;4;4;8
626;27.01.2018;2018;01;18;Lauantai;11;3;14
626;27.01.2018;2018;01;19;Lauantai;4;5;9
626;27.01.2018;2018;01;20;Lauantai;2;0;2
626;27.01.2018;2018;01;21;Lauantai;4;2;6
626;27.01.2018;2018;01;22;Lauantai;2;2;4
626;27.01.2018;2018;01;23;Lauantai;2;1;3
626;28.01.2018;2018;01;00;Sunnuntai;0;0;0
626;28.01.2018;2018;01;01;Sunnuntai;0;0;0
626;28.01.2018;2018;01;02;Sunnuntai;0;0;0
626;28.01.2018;2018;01;03;Sunnuntai;1;0;1
626;28.01.2018;2018;01;04;Sunnuntai;0;0;0
626;28.01.2018;2018;01;05;Sunnuntai;0;0;0
626;28.01.2018;2018;01;06;Sunnuntai;1;2;3
626;28.01.2018;2018;01;07;Sunnuntai;1;2;3
626;28.01.2018;2018;01;08;Sunnuntai;0;0;0
626;28.01.2018;2018;01;09;Sunnuntai;0;2;2
626;28.01.2018;2018;01;10;Sunnuntai;2;1;3
626;28.01.2018;2018;01;11;Sunnuntai;0;2;2
626;28.01.2018;2018;01;12;Sunnuntai;2;4;6
626;28.01.2018;2018;01;13;Sunnuntai;5;3;8
626;28.01.2018;2018;01;14;Sunnuntai;8;6;14
626;28.01.2018;2018;01;15;Sunnuntai;0;2;2
626;28.01.2018;2018;01;16;Sunnuntai;2;4;6
626;28.01.2018;2018;01;17;Sunnuntai;0;6;6
626;28.01.2018;2018;01;18;Sunnuntai;3;4;7
626;28.01.2018;2018;01;19;Sunnuntai;3;4;7
626;28.01.2018;2018;01;20;Sunnuntai;2;3;5
626;28.01.2018;2018;01;21;Sunnuntai;1;1;2
626;28.01.2018;2018;01;22;Sunnuntai;1;1;2
626;28.01.2018;2018;01;23;Sunnuntai;3;0;3
626;29.01.2018;2018;01;00;Maanantai;0;0;0
626;29.01.2018;2018;01;01;Maanantai;0;0;0
626;29.01.2018;2018;01;02;Maanantai;1;0;1
626;29.01.2018;2018;01;03;Maanantai;0;0;0
626;29.01.2018;2018;01;04;Maanantai;0;2;2
626;29.01.2018;2018;01;05;Maanantai;0;3;3
626;29.01.2018;2018;01;06;Maanantai;5;7;12
626;29.01.2018;2018;01;07;Maanantai;1;21;22
626;29.01.2018;2018;01;08;Maanantai;3;35;38
626;29.01.2018;2018;01;09;Maanantai;6;22;28
626;29.01.2018;2018;01;10;Maanantai;3;8;11
626;29.01.2018;2018;01;11;Maanantai;9;8;17
626;29.01.2018;2018;01;12;Maanantai;6;2;8
626;29.01.2018;2018;01;13;Maanantai;5;4;9
626;29.01.2018;2018;01;14;Maanantai;12;8;20
626;29.01.2018;2018;01;15;Maanantai;6;10;16
626;29.01.2018;2018;01;16;Maanantai;10;10;20
626;29.01.2018;2018;01;17;Maanantai;23;9;32
626;29.01.2018;2018;01;18;Maanantai;11;5;16
626;29.01.2018;2018;01;19;Maanantai;10;4;14
626;29.01.2018;2018;01;20;Maanantai;5;3;8
626;29.01.2018;2018;01;21;Maanantai;2;1;3
626;29.01.2018;2018;01;22;Maanantai;1;4;5
626;29.01.2018;2018;01;23;Maanantai;0;2;2
626;30.01.2018;2018;01;00;Tiistai;1;1;2
626;30.01.2018;2018;01;01;Tiistai;0;0;0
626;30.01.2018;2018;01;02;Tiistai;0;0;0
626;30.01.2018;2018;01;03;Tiistai;0;1;1
626;30.01.2018;2018;01;04;Tiistai;0;1;1
626;30.01.2018;2018;01;05;Tiistai;0;1;1
626;30.01.2018;2018;01;06;Tiistai;3;6;9
626;30.01.2018;2018;01;07;Tiistai;3;21;24
626;30.01.2018;2018;01;08;Tiistai;6;40;46
626;30.01.2018;2018;01;09;Tiistai;9;11;20
626;30.01.2018;2018;01;10;Tiistai;2;7;9
626;30.01.2018;2018;01;11;Tiistai;1;6;7
626;30.01.2018;2018;01;12;Tiistai;4;4;8
626;30.01.2018;2018;01;13;Tiistai;6;3;9
626;30.01.2018;2018;01;14;Tiistai;6;3;9
626;30.01.2018;2018;01;15;Tiistai;5;9;14
626;30.01.2018;2018;01;16;Tiistai;14;12;26
626;30.01.2018;2018;01;17;Tiistai;23;14;37
626;30.01.2018;2018;01;18;Tiistai;10;4;14
626;30.01.2018;2018;01;19;Tiistai;9;1;10
626;30.01.2018;2018;01;20;Tiistai;2;0;2
626;30.01.2018;2018;01;21;Tiistai;5;1;6
626;30.01.2018;2018;01;22;Tiistai;2;2;4
626;30.01.2018;2018;01;23;Tiistai;1;4;5
626;31.01.2018;2018;01;00;Keskiviikko;0;1;1
626;31.01.2018;2018;01;01;Keskiviikko;1;0;1
626;31.01.2018;2018;01;02;Keskiviikko;0;0;0
626;31.01.2018;2018;01;03;Keskiviikko;0;0;0
626;31.01.2018;2018;01;04;Keskiviikko;0;0;0
626;31.01.2018;2018;01;05;Keskiviikko;0;1;1
626;31.01.2018;2018;01;06;Keskiviikko;3;5;8
626;31.01.2018;2018;01;07;Keskiviikko;4;18;22
626;31.01.2018;2018;01;08;Keskiviikko;4;31;35
626;31.01.2018;2018;01;09;Keskiviikko;11;13;24
626;31.01.2018;2018;01;10;Keskiviikko;2;5;7
626;31.01.2018;2018;01;11;Keskiviikko;0;7;7
626;31.01.2018;2018;01;12;Keskiviikko;3;8;11
626;31.01.2018;2018;01;13;Keskiviikko;4;3;7
626;31.01.2018;2018;01;14;Keskiviikko;5;2;7
626;31.01.2018;2018;01;15;Keskiviikko;7;7;14
626;31.01.2018;2018;01;16;Keskiviikko;18;10;28
626;31.01.2018;2018;01;17;Keskiviikko;17;13;30
626;31.01.2018;2018;01;18;Keskiviikko;11;5;16
626;31.01.2018;2018;01;19;Keskiviikko;7;1;8
626;31.01.2018;2018;01;20;Keskiviikko;3;3;6
626;31.01.2018;2018;01;21;Keskiviikko;3;3;6
626;31.01.2018;2018;01;22;Keskiviikko;2;2;4
626;31.01.2018;2018;01;23;Keskiviikko;2;1;3
626;01.02.2018;2018;02;00;Torstai;1;0;1
626;01.02.2018;2018;02;01;Torstai;0;0;0
626;01.02.2018;2018;02;02;Torstai;0;0;0
626;01.02.2018;2018;02;03;Torstai;0;0;0
626;01.02.2018;2018;02;04;Torstai;0;1;1
626;01.02.2018;2018;02;05;Torstai;0;2;2
626;01.02.2018;2018;02;06;Torstai;2;6;8
626;01.02.2018;2018;02;07;Torstai;3;15;18
626;01.02.2018;2018;02;08;Torstai;5;19;24
626;01.02.2018;2018;02;09;Torstai;4;11;15
626;01.02.2018;2018;02;10;Torstai;1;2;3
626;01.02.2018;2018;02;11;Torstai;0;0;0
626;01.02.2018;2018;02;12;Torstai;2;2;4
626;01.02.2018;2018;02;13;Torstai;3;2;5
626;01.02.2018;2018;02;14;Torstai;4;1;5
626;01.02.2018;2018;02;15;Torstai;5;5;10
626;01.02.2018;2018;02;16;Torstai;9;6;15
626;01.02.2018;2018;02;17;Torstai;10;8;18
626;01.02.2018;2018;02;18;Torstai;5;4;9
626;01.02.2018;2018;02;19;Torstai;3;1;4
626;01.02.2018;2018;02;20;Torstai;2;1;3
626;01.02.2018;2018;02;21;Torstai;1;2;3
626;01.02.2018;2018;02;22;Torstai;1;1;2
626;01.02.2018;2018;02;23;Torstai;1;1;2
626;02.02.2018;2018;02;00;Perjantai;0;0;0
626;02.02.2018;2018;02;01;Perjantai;0;0;0
626;02.02.2018;2018;02;02;Perjantai;0;0;0
626;02.02.2018;2018;02;03;Perjantai;0;0;0
626;02.02.2018;2018;02;04;Perjantai;0;0;0
626;02.02.2018;2018;02;05;Perjantai;0;0;0
626;02.02.2018;2018;02;06;Perjantai;1;3;4
626;02.02.2018;2018;02;07;Perjantai;2;8;10
626;02.02.2018;2018;02;08;Perjantai;2;16;18
626;02.02.2018;2018;02;09;Perjantai;6;7;13
626;02.02.2018;2018;02;10;Perjantai;1;3;4
626;02.02.2018;2018;02;11;Perjantai;0;3;3
626;02.02.2018;2018;02;12;Perjantai;2;4;6
626;02.02.2018;2018;02;13;Perjantai;2;1;3
626;02.02.2018;2018;02;14;Perjantai;3;1;4
626;02.02.2018;2018;02;15;Perjantai;4;4;8
626;02.02.2018;2018;02;16;Perjantai;7;5;12
626;02.02.2018;2018;02;17;Perjantai;10;3;13
626;02.02.2018;2018;02;18;Perjantai;6;4;10
626;02.02.2018;2018;02;19;Perjantai;2;3;5
626;02.02.2018;2018;02;20;Perjantai;4;4;8
626;02.02.2018;2018;02;21;Perjantai;3;1;4
626;02.02.2018;2018;02;22;Perjantai;1;1;2
626;02.02.2018;2018;02;23;Perjantai;0;0;0
626;03.02.2018;2018;02;00;Lauantai;0;0;0
626;03.02.2018;2018;02;01;Lauantai;0;0;0
626;03.02.2018;2018;02;02;Lauantai;0;0;0
626;03.02.2018;2018;02;03;Lauantai;0;0;0
626;03.02.2018;2018;02;04;Lauantai;0;1;1
626;03.02.2018;2018;02;05;Lauantai;0;1;1
626;03.02.2018;2018;02;06;Lauantai;0;0;0
626;03.02.2018;2018;02;07;Lauantai;1;0;1
626;03.02.2018;2018;02;08;Lauantai;0;1;1
626;03.02.2018;2018;02;09;Lauantai;1;2;3
626;03.02.2018;2018;02;10;Lauantai;0;3;3
626;03.02.2018;2018;02;11;Lauantai;0;3;3
626;03.02.2018;2018;02;12;Lauantai;0;0;0
626;03.02.2018;2018;02;13;Lauantai;2;2;4
626;03.02.2018;2018;02;14;Lauantai;1;1;2
626;03.02.2018;2018;02;15;Lauantai;2;1;3
626;03.02.2018;2018;02;16;Lauantai;1;4;5
626;03.02.2018;2018;02;17;Lauantai;3;4;7
626;03.02.2018;2018;02;18;Lauantai;3;2;5
626;03.02.2018;2018;02;19;Lauantai;0;0;0
626;03.02.2018;2018;02;20;Lauantai;0;1;1
626;03.02.2018;2018;02;21;Lauantai;1;0;1
626;03.02.2018;2018;02;22;Lauantai;1;0;1
626;03.02.2018;2018;02;23;Lauantai;0;0;0
626;04.02.2018;2018;02;00;Sunnuntai;0;0;0
626;04.02.2018;2018;02;01;Sunnuntai;0;0;0
626;04.02.2018;2018;02;02;Sunnuntai;0;0;0
626;04.02.2018;2018;02;03;Sunnuntai;0;2;2
626;04.02.2018;2018;02;04;Sunnuntai;0;1;1
626;04.02.2018;2018;02;05;Sunnuntai;0;0;0
626;04.02.2018;2018;02;06;Sunnuntai;0;1;1
626;04.02.2018;2018;02;07;Sunnuntai;0;1;1
626;04.02.2018;2018;02;08;Sunnuntai;0;0;0
626;04.02.2018;2018;02;09;Sunnuntai;0;0;0
626;04.02.2018;2018;02;10;Sunnuntai;2;1;3
626;04.02.2018;2018;02;11;Sunnuntai;1;2;3
626;04.02.2018;2018;02;12;Sunnuntai;0;1;1
626;04.02.2018;2018;02;13;Sunnuntai;1;1;2
626;04.02.2018;2018;02;14;Sunnuntai;1;0;1
626;04.02.2018;2018;02;15;Sunnuntai;1;0;1
626;04.02.2018;2018;02;16;Sunnuntai;1;0;1
626;04.02.2018;2018;02;17;Sunnuntai;0;2;2
626;04.02.2018;2018;02;18;Sunnuntai;1;3;4
626;04.02.2018;2018;02;19;Sunnuntai;2;1;3
626;04.02.2018;2018;02;20;Sunnuntai;0;2;2
626;04.02.2018;2018;02;21;Sunnuntai;1;0;1
626;04.02.2018;2018;02;22;Sunnuntai;1;0;1
626;04.02.2018;2018;02;23;Sunnuntai;0;1;1
626;05.02.2018;2018;02;00;Maanantai;0;0;0
626;05.02.2018;2018;02;01;Maanantai;1;0;1
626;05.02.2018;2018;02;02;Maanantai;0;0;0
626;05.02.2018;2018;02;03;Maanantai;0;0;0
626;05.02.2018;2018;02;04;Maanantai;0;2;2
626;05.02.2018;2018;02;05;Maanantai;0;2;2
626;05.02.2018;2018;02;06;Maanantai;3;3;6
626;05.02.2018;2018;02;07;Maanantai;2;9;11
626;05.02.2018;2018;02;08;Maanantai;2;9;11
626;05.02.2018;2018;02;09;Maanantai;6;7;13
626;05.02.2018;2018;02;10;Maanantai;1;3;4
626;05.02.2018;2018;02;11;Maanantai;1;3;4
626;05.02.2018;2018;02;12;Maanantai;1;2;3
626;05.02.2018;2018;02;13;Maanantai;2;2;4
626;05.02.2018;2018;02;14;Maanantai;2;3;5
626;05.02.2018;2018;02;15;Maanantai;1;3;4
626;05.02.2018;2018;02;16;Maanantai;6;5;11
626;05.02.2018;2018;02;17;Maanantai;11;7;18
626;05.02.2018;2018;02;18;Maanantai;8;2;10
626;05.02.2018;2018;02;19;Maanantai;2;3;5
626;05.02.2018;2018;02;20;Maanantai;3;0;3
626;05.02.2018;2018;02;21;Maanantai;1;1;2
626;05.02.2018;2018;02;22;Maanantai;2;2;4
626;05.02.2018;2018;02;23;Maanantai;0;0;0
626;06.02.2018;2018;02;00;Tiistai;1;1;2
626;06.02.2018;2018;02;01;Tiistai;0;0;0
626;06.02.2018;2018;02;02;Tiistai;0;0;0
626;06.02.2018;2018;02;03;Tiistai;0;0;0
626;06.02.2018;2018;02;04;Tiistai;0;1;1
626;06.02.2018;2018;02;05;Tiistai;0;2;2
626;06.02.2018;2018;02;06;Tiistai;3;5;8
626;06.02.2018;2018;02;07;Tiistai;2;9;11
626;06.02.2018;2018;02;08;Tiistai;3;11;14
626;06.02.2018;2018;02;09;Tiistai;6;9;15
626;06.02.2018;2018;02;10;Tiistai;0;2;2
626;06.02.2018;2018;02;11;Tiistai;0;1;1
626;06.02.2018;2018;02;12;Tiistai;1;2;3
626;06.02.2018;2018;02;13;Tiistai;1;3;4
626;06.02.2018;2018;02;14;Tiistai;0;4;4
626;06.02.2018;2018;02;15;Tiistai;3;5;8
626;06.02.2018;2018;02;16;Tiistai;11;7;18
626;06.02.2018;2018;02;17;Tiistai;8;4;12
626;06.02.2018;2018;02;18;Tiistai;4;4;8
626;06.02.2018;2018;02;19;Tiistai;2;2;4
626;06.02.2018;2018;02;20;Tiistai;2;0;2
626;06.02.2018;2018;02;21;Tiistai;4;1;5
626;06.02.2018;2018;02;22;Tiistai;2;0;2
626;06.02.2018;2018;02;23;Tiistai;2;0;2
626;07.02.2018;2018;02;00;Keskiviikko;0;1;1
626;07.02.2018;2018;02;01;Keskiviikko;0;0;0
626;07.02.2018;2018;02;02;Keskiviikko;0;0;0
626;07.02.2018;2018;02;03;Keskiviikko;0;0;0
626;07.02.2018;2018;02;04;Keskiviikko;0;1;1
626;07.02.2018;2018;02;05;Keskiviikko;1;1;2
626;07.02.2018;2018;02;06;Keskiviikko;3;6;9
626;07.02.2018;2018;02;07;Keskiviikko;2;12;14
626;07.02.2018;2018;02;08;Keskiviikko;3;24;27
626;07.02.2018;2018;02;09;Keskiviikko;5;11;16
626;07.02.2018;2018;02;10;Keskiviikko;0;1;1
626;07.02.2018;2018;02;11;Keskiviikko;0;5;5
626;07.02.2018;2018;02;12;Keskiviikko;0;4;4
626;07.02.2018;2018;02;13;Keskiviikko;4;2;6
626;07.02.2018;2018;02;14;Keskiviikko;5;2;7
626;07.02.2018;2018;02;15;Keskiviikko;9;6;15
626;07.02.2018;2018;02;16;Keskiviikko;7;10;17
626;07.02.2018;2018;02;17;Keskiviikko;19;11;30
626;07.02.2018;2018;02;18;Keskiviikko;19;9;28
626;07.02.2018;2018;02;19;Keskiviikko;7;4;11
626;07.02.2018;2018;02;20;Keskiviikko;4;1;5
626;07.02.2018;2018;02;21;Keskiviikko;5;0;5
626;07.02.2018;2018;02;22;Keskiviikko;1;1;2
626;07.02.2018;2018;02;23;Keskiviikko;3;2;5
626;08.02.2018;2018;02;00;Torstai;1;0;1
626;08.02.2018;2018;02;01;Torstai;0;0;0
626;08.02.2018;2018;02;02;Torstai;0;0;0
626;08.02.2018;2018;02;03;Torstai;0;0;0
626;08.02.2018;2018;02;04;Torstai;0;1;1
626;08.02.2018;2018;02;05;Torstai;1;1;2
626;08.02.2018;2018;02;06;Torstai;3;6;9
626;08.02.2018;2018;02;07;Torstai;1;10;11
626;08.02.2018;2018;02;08;Torstai;7;26;33
626;08.02.2018;2018;02;09;Torstai;4;11;15
626;08.02.2018;2018;02;10;Torstai;2;2;4
626;08.02.2018;2018;02;11;Torstai;4;3;7
626;08.02.2018;2018;02;12;Torstai;1;1;2
626;08.02.2018;2018;02;13;Torstai;4;3;7
626;08.02.2018;2018;02;14;Torstai;2;2;4
626;08.02.2018;2018;02;15;Torstai;6;7;13
626;08.02.2018;2018;02;16;Torstai;15;9;24
626;08.02.2018;2018;02;17;Torstai;26;11;37
626;08.02.2018;2018;02;18;Torstai;10;7;17
626;08.02.2018;2018;02;19;Torstai;6;1;7
626;08.02.2018;2018;02;20;Torstai;1;0;1
626;08.02.2018;2018;02;21;Torstai;5;0;5
626;08.02.2018;2018;02;22;Torstai;2;1;3
626;08.02.2018;2018;02;23;Torstai;1;1;2
626;09.02.2018;2018;02;00;Perjantai;1;1;2
626;09.02.2018;2018;02;01;Perjantai;0;0;0
626;09.02.2018;2018;02;02;Perjantai;0;0;0
626;09.02.2018;2018;02;03;Perjantai;0;0;0
626;09.02.2018;2018;02;04;Perjantai;0;2;2
626;09.02.2018;2018;02;05;Perjantai;0;0;0
626;09.02.2018;2018;02;06;Perjantai;3;5;8
626;09.02.2018;2018;02;07;Perjantai;2;10;12
626;09.02.2018;2018;02;08;Perjantai;5;24;29
626;09.02.2018;2018;02;09;Perjantai;2;7;9
626;09.02.2018;2018;02;10;Perjantai;2;7;9
626;09.02.2018;2018;02;11;Perjantai;1;4;5
626;09.02.2018;2018;02;12;Perjantai;4;2;6
626;09.02.2018;2018;02;13;Perjantai;4;5;9
626;09.02.2018;2018;02;14;Perjantai;7;9;16
626;09.02.2018;2018;02;15;Perjantai;7;10;17
626;09.02.2018;2018;02;16;Perjantai;11;5;16
626;09.02.2018;2018;02;17;Perjantai;13;7;20
626;09.02.2018;2018;02;18;Perjantai;8;7;15
626;09.02.2018;2018;02;19;Perjantai;3;2;5
626;09.02.2018;2018;02;20;Perjantai;3;3;6
626;09.02.2018;2018;02;21;Perjantai;0;1;1
626;09.02.2018;2018;02;22;Perjantai;5;1;6
626;09.02.2018;2018;02;23;Perjantai;1;1;2
626;10.02.2018;2018;02;00;Lauantai;0;0;0
626;10.02.2018;2018;02;01;Lauantai;0;0;0
626;10.02.2018;2018;02;02;Lauantai;1;0;1
626;10.02.2018;2018;02;03;Lauantai;0;0;0
626;10.02.2018;2018;02;04;Lauantai;0;0;0
626;10.02.2018;2018;02;05;Lauantai;1;0;1
626;10.02.2018;2018;02;06;Lauantai;0;2;2
626;10.02.2018;2018;02;07;Lauantai;0;1;1
626;10.02.2018;2018;02;08;Lauantai;0;0;0
626;10.02.2018;2018;02;09;Lauantai;0;1;1
626;10.02.2018;2018;02;10;Lauantai;1;5;6
626;10.02.2018;2018;02;11;Lauantai;0;5;5
626;10.02.2018;2018;02;12;Lauantai;3;7;10
626;10.02.2018;2018;02;13;Lauantai;4;3;7
626;10.02.2018;2018;02;14;Lauantai;5;8;13
626;10.02.2018;2018;02;15;Lauantai;3;1;4
626;10.02.2018;2018;02;16;Lauantai;5;2;7
626;10.02.2018;2018;02;17;Lauantai;1;2;3
626;10.02.2018;2018;02;18;Lauantai;2;2;4
626;10.02.2018;2018;02;19;Lauantai;0;0;0
626;10.02.2018;2018;02;20;Lauantai;2;3;5
626;10.02.2018;2018;02;21;Lauantai;3;0;3
626;10.02.2018;2018;02;22;Lauantai;2;0;2
626;10.02.2018;2018;02;23;Lauantai;0;1;1
626;11.02.2018;2018;02;00;Sunnuntai;0;0;0
626;11.02.2018;2018;02;01;Sunnuntai;0;0;0
626;11.02.2018;2018;02;02;Sunnuntai;0;0;0
626;11.02.2018;2018;02;03;Sunnuntai;0;1;1
626;11.02.2018;2018;02;04;Sunnuntai;0;0;0
626;11.02.2018;2018;02;05;Sunnuntai;0;0;0
626;11.02.2018;2018;02;06;Sunnuntai;1;1;2
626;11.02.2018;2018;02;07;Sunnuntai;0;1;1
626;11.02.2018;2018;02;08;Sunnuntai;0;2;2
626;11.02.2018;2018;02;09;Sunnuntai;1;0;1
626;11.02.2018;2018;02;10;Sunnuntai;0;2;2
626;11.02.2018;2018;02;11;Sunnuntai;2;3;5
626;11.02.2018;2018;02;12;Sunnuntai;0;4;4
626;11.02.2018;2018;02;13;Sunnuntai;2;1;3
626;11.02.2018;2018;02;14;Sunnuntai;4;2;6
626;11.02.2018;2018;02;15;Sunnuntai;5;0;5
626;11.02.2018;2018;02;16;Sunnuntai;6;5;11
626;11.02.2018;2018;02;17;Sunnuntai;2;3;5
626;11.02.2018;2018;02;18;Sunnuntai;1;4;5
626;11.02.2018;2018;02;19;Sunnuntai;4;1;5
626;11.02.2018;2018;02;20;Sunnuntai;3;4;7
626;11.02.2018;2018;02;21;Sunnuntai;0;0;0
626;11.02.2018;2018;02;22;Sunnuntai;0;0;0
626;11.02.2018;2018;02;23;Sunnuntai;1;0;1
626;12.02.2018;2018;02;00;Maanantai;0;0;0
626;12.02.2018;2018;02;01;Maanantai;0;0;0
626;12.02.2018;2018;02;02;Maanantai;0;0;0
626;12.02.2018;2018;02;03;Maanantai;0;0;0
626;12.02.2018;2018;02;04;Maanantai;1;1;2
626;12.02.2018;2018;02;05;Maanantai;2;4;6
626;12.02.2018;2018;02;06;Maanantai;2;7;9
626;12.02.2018;2018;02;07;Maanantai;2;20;22
626;12.02.2018;2018;02;08;Maanantai;4;28;32
626;12.02.2018;2018;02;09;Maanantai;4;17;21
626;12.02.2018;2018;02;10;Maanantai;2;4;6
626;12.02.2018;2018;02;11;Maanantai;3;1;4
626;12.02.2018;2018;02;12;Maanantai;1;3;4
626;12.02.2018;2018;02;13;Maanantai;4;2;6
626;12.02.2018;2018;02;14;Maanantai;7;5;12
626;12.02.2018;2018;02;15;Maanantai;10;7;17
626;12.02.2018;2018;02;16;Maanantai;19;6;25
626;12.02.2018;2018;02;17;Maanantai;22;9;31
626;12.02.2018;2018;02;18;Maanantai;15;6;21
626;12.02.2018;2018;02;19;Maanantai;9;2;11
626;12.02.2018;2018;02;20;Maanantai;1;4;5
626;12.02.2018;2018;02;21;Maanantai;5;3;8
626;12.02.2018;2018;02;22;Maanantai;0;0;0
626;12.02.2018;2018;02;23;Maanantai;1;1;2
626;13.02.2018;2018;02;00;Tiistai;1;3;4
626;13.02.2018;2018;02;01;Tiistai;0;0;0
626;13.02.2018;2018;02;02;Tiistai;0;0;0
626;13.02.2018;2018;02;03;Tiistai;0;1;1
626;13.02.2018;2018;02;04;Tiistai;0;1;1
626;13.02.2018;2018;02;05;Tiistai;0;5;5
626;13.02.2018;2018;02;06;Tiistai;4;8;12
626;13.02.2018;2018;02;07;Tiistai;1;20;21
626;13.02.2018;2018;02;08;Tiistai;4;32;36
626;13.02.2018;2018;02;09;Tiistai;7;16;23
626;13.02.2018;2018;02;10;Tiistai;1;7;8
626;13.02.2018;2018;02;11;Tiistai;2;4;6
626;13.02.2018;2018;02;12;Tiistai;2;1;3
626;13.02.2018;2018;02;13;Tiistai;2;3;5
626;13.02.2018;2018;02;14;Tiistai;5;6;11
626;13.02.2018;2018;02;15;Tiistai;9;9;18
626;13.02.2018;2018;02;16;Tiistai;12;9;21
626;13.02.2018;2018;02;17;Tiistai;30;6;36
626;13.02.2018;2018;02;18;Tiistai;15;8;23
626;13.02.2018;2018;02;19;Tiistai;9;3;12
626;13.02.2018;2018;02;20;Tiistai;2;0;2
626;13.02.2018;2018;02;21;Tiistai;4;0;4
626;13.02.2018;2018;02;22;Tiistai;0;1;1
626;13.02.2018;2018;02;23;Tiistai;1;4;5
626;14.02.2018;2018;02;00;Keskiviikko;1;0;1
626;14.02.2018;2018;02;01;Keskiviikko;0;0;0
626;14.02.2018;2018;02;02;Keskiviikko;0;0;0
626;14.02.2018;2018;02;03;Keskiviikko;0;0;0
626;14.02.2018;2018;02;04;Keskiviikko;0;1;1
626;14.02.2018;2018;02;05;Keskiviikko;0;4;4
626;14.02.2018;2018;02;06;Keskiviikko;2;4;6
626;14.02.2018;2018;02;07;Keskiviikko;2;16;18
626;14.02.2018;2018;02;08;Keskiviikko;5;31;36
626;14.02.2018;2018;02;09;Keskiviikko;5;13;18
626;14.02.2018;2018;02;10;Keskiviikko;2;8;10
626;14.02.2018;2018;02;11;Keskiviikko;3;8;11
626;14.02.2018;2018;02;12;Keskiviikko;8;3;11
626;14.02.2018;2018;02;13;Keskiviikko;8;1;9
626;14.02.2018;2018;02;14;Keskiviikko;6;7;13
626;14.02.2018;2018;02;15;Keskiviikko;11;7;18
626;14.02.2018;2018;02;16;Keskiviikko;13;6;19
626;14.02.2018;2018;02;17;Keskiviikko;19;8;27
626;14.02.2018;2018;02;18;Keskiviikko;10;10;20
626;14.02.2018;2018;02;19;Keskiviikko;10;0;10
626;14.02.2018;2018;02;20;Keskiviikko;2;0;2
626;14.02.2018;2018;02;21;Keskiviikko;3;0;3
626;14.02.2018;2018;02;22;Keskiviikko;3;3;6
626;14.02.2018;2018;02;23;Keskiviikko;3;4;7
626;15.02.2018;2018;02;00;Torstai;2;1;3
626;15.02.2018;2018;02;01;Torstai;0;1;1
626;15.02.2018;2018;02;02;Torstai;0;0;0
626;15.02.2018;2018;02;03;Torstai;1;1;2
626;15.02.2018;2018;02;04;Torstai;0;1;1
626;15.02.2018;2018;02;05;Torstai;1;3;4
626;15.02.2018;2018;02;06;Torstai;5;4;9
626;15.02.2018;2018;02;07;Torstai;1;17;18
626;15.02.2018;2018;02;08;Torstai;7;41;48
626;15.02.2018;2018;02;09;Torstai;8;16;24
626;15.02.2018;2018;02;10;Torstai;3;3;6
626;15.02.2018;2018;02;11;Torstai;1;3;4
626;15.02.2018;2018;02;12;Torstai;3;1;4
626;15.02.2018;2018;02;13;Torstai;1;1;2
626;15.02.2018;2018;02;14;Torstai;4;4;8
626;15.02.2018;2018;02;15;Torstai;7;8;15
626;15.02.2018;2018;02;16;Torstai;13;9;22
626;15.02.2018;2018;02;17;Torstai;26;6;32
626;15.02.2018;2018;02;18;Torstai;7;7;14
626;15.02.2018;2018;02;19;Torstai;6;3;9
626;15.02.2018;2018;02;20;Torstai;8;4;12
626;15.02.2018;2018;02;21;Torstai;5;0;5
626;15.02.2018;2018;02;22;Torstai;0;1;1
626;15.02.2018;2018;02;23;Torstai;1;2;3
626;16.02.2018;2018;02;00;Perjantai;0;0;0
626;16.02.2018;2018;02;01;Perjantai;0;0;0
626;16.02.2018;2018;02;02;Perjantai;0;0;0
626;16.02.2018;2018;02;03;Perjantai;0;0;0
626;16.02.2018;2018;02;04;Perjantai;1;1;2
626;16.02.2018;2018;02;05;Perjantai;0;3;3
626;16.02.2018;2018;02;06;Perjantai;3;4;7
626;16.02.2018;2018;02;07;Perjantai;2;15;17
626;16.02.2018;2018;02;08;Perjantai;6;17;23
626;16.02.2018;2018;02;09;Perjantai;7;8;15
626;16.02.2018;2018;02;10;Perjantai;2;4;6
626;16.02.2018;2018;02;11;Perjantai;2;6;8
626;16.02.2018;2018;02;12;Perjantai;3;2;5
626;16.02.2018;2018;02;13;Perjantai;2;7;9
626;16.02.2018;2018;02;14;Perjantai;8;5;13
626;16.02.2018;2018;02;15;Perjantai;8;9;17
626;16.02.2018;2018;02;16;Perjantai;11;8;19
626;16.02.2018;2018;02;17;Perjantai;18;10;28
626;16.02.2018;2018;02;18;Perjantai;7;3;10
626;16.02.2018;2018;02;19;Perjantai;7;3;10
626;16.02.2018;2018;02;20;Perjantai;2;2;4
626;16.02.2018;2018;02;21;Perjantai;4;3;7
626;16.02.2018;2018;02;22;Perjantai;1;3;4
626;16.02.2018;2018;02;23;Perjantai;1;1;2
626;17.02.2018;2018;02;00;Lauantai;1;1;2
626;17.02.2018;2018;02;01;Lauantai;0;0;0
626;17.02.2018;2018;02;02;Lauantai;0;1;1
626;17.02.2018;2018;02;03;Lauantai;0;0;0
626;17.02.2018;2018;02;04;Lauantai;0;0;0
626;17.02.2018;2018;02;05;Lauantai;1;0;1
626;17.02.2018;2018;02;06;Lauantai;1;2;3
626;17.02.2018;2018;02;07;Lauantai;2;0;2
626;17.02.2018;2018;02;08;Lauantai;0;2;2
626;17.02.2018;2018;02;09;Lauantai;1;5;6
626;17.02.2018;2018;02;10;Lauantai;0;3;3
626;17.02.2018;2018;02;11;Lauantai;0;3;3
626;17.02.2018;2018;02;12;Lauantai;2;0;2
626;17.02.2018;2018;02;13;Lauantai;1;0;1
626;17.02.2018;2018;02;14;Lauantai;5;5;10
626;17.02.2018;2018;02;15;Lauantai;5;5;10
626;17.02.2018;2018;02;16;Lauantai;6;7;13
626;17.02.2018;2018;02;17;Lauantai;3;2;5
626;17.02.2018;2018;02;18;Lauantai;1;3;4
626;17.02.2018;2018;02;19;Lauantai;3;1;4
626;17.02.2018;2018;02;20;Lauantai;2;2;4
626;17.02.2018;2018;02;21;Lauantai;0;0;0
626;17.02.2018;2018;02;22;Lauantai;0;0;0
626;17.02.2018;2018;02;23;Lauantai;0;0;0
626;18.02.2018;2018;02;00;Sunnuntai;0;0;0
626;18.02.2018;2018;02;01;Sunnuntai;0;1;1
626;18.02.2018;2018;02;02;Sunnuntai;1;0;1
626;18.02.2018;2018;02;03;Sunnuntai;1;0;1
626;18.02.2018;2018;02;04;Sunnuntai;0;0;0
626;18.02.2018;2018;02;05;Sunnuntai;0;1;1
626;18.02.2018;2018;02;06;Sunnuntai;0;0;0
626;18.02.2018;2018;02;07;Sunnuntai;0;0;0
626;18.02.2018;2018;02;08;Sunnuntai;0;2;2
626;18.02.2018;2018;02;09;Sunnuntai;1;0;1
626;18.02.2018;2018;02;10;Sunnuntai;1;1;2
626;18.02.2018;2018;02;11;Sunnuntai;1;2;3
626;18.02.2018;2018;02;12;Sunnuntai;1;1;2
626;18.02.2018;2018;02;13;Sunnuntai;0;3;3
626;18.02.2018;2018;02;14;Sunnuntai;2;4;6
626;18.02.2018;2018;02;15;Sunnuntai;5;0;5
626;18.02.2018;2018;02;16;Sunnuntai;2;0;2
626;18.02.2018;2018;02;17;Sunnuntai;2;2;4
626;18.02.2018;2018;02;18;Sunnuntai;1;2;3
626;18.02.2018;2018;02;19;Sunnuntai;0;2;2
626;18.02.2018;2018;02;20;Sunnuntai;1;2;3
626;18.02.2018;2018;02;21;Sunnuntai;0;0;0
626;18.02.2018;2018;02;22;Sunnuntai;1;0;1
626;18.02.2018;2018;02;23;Sunnuntai;0;0;0
626;19.02.2018;2018;02;00;Maanantai;0;0;0
626;19.02.2018;2018;02;01;Maanantai;0;0;0
626;19.02.2018;2018;02;02;Maanantai;0;0;0
626;19.02.2018;2018;02;03;Maanantai;0;0;0
626;19.02.2018;2018;02;04;Maanantai;0;1;1
626;19.02.2018;2018;02;05;Maanantai;1;3;4
626;19.02.2018;2018;02;06;Maanantai;4;5;9
626;19.02.2018;2018;02;07;Maanantai;2;7;9
626;19.02.2018;2018;02;08;Maanantai;3;17;20
626;19.02.2018;2018;02;09;Maanantai;6;11;17
626;19.02.2018;2018;02;10;Maanantai;4;1;5
626;19.02.2018;2018;02;11;Maanantai;0;3;3
626;19.02.2018;2018;02;12;Maanantai;2;3;5
626;19.02.2018;2018;02;13;Maanantai;3;4;7
626;19.02.2018;2018;02;14;Maanantai;2;4;6
626;19.02.2018;2018;02;15;Maanantai;6;8;14
626;19.02.2018;2018;02;16;Maanantai;9;5;14
626;19.02.2018;2018;02;17;Maanantai;9;6;15
626;19.02.2018;2018;02;18;Maanantai;11;4;15
626;19.02.2018;2018;02;19;Maanantai;1;4;5
626;19.02.2018;2018;02;20;Maanantai;4;0;4
626;19.02.2018;2018;02;21;Maanantai;2;1;3
626;19.02.2018;2018;02;22;Maanantai;4;1;5
626;19.02.2018;2018;02;23;Maanantai;0;0;0
626;20.02.2018;2018;02;00;Tiistai;0;0;0
626;20.02.2018;2018;02;01;Tiistai;1;0;1
626;20.02.2018;2018;02;02;Tiistai;0;0;0
626;20.02.2018;2018;02;03;Tiistai;0;0;0
626;20.02.2018;2018;02;04;Tiistai;0;2;2
626;20.02.2018;2018;02;05;Tiistai;1;2;3
626;20.02.2018;2018;02;06;Tiistai;3;3;6
626;20.02.2018;2018;02;07;Tiistai;1;10;11
626;20.02.2018;2018;02;08;Tiistai;4;10;14
626;20.02.2018;2018;02;09;Tiistai;3;6;9
626;20.02.2018;2018;02;10;Tiistai;1;3;4
626;20.02.2018;2018;02;11;Tiistai;0;4;4
626;20.02.2018;2018;02;12;Tiistai;1;0;1
626;20.02.2018;2018;02;13;Tiistai;1;5;6
626;20.02.2018;2018;02;14;Tiistai;1;1;2
626;20.02.2018;2018;02;15;Tiistai;8;2;10
626;20.02.2018;2018;02;16;Tiistai;8;6;14
626;20.02.2018;2018;02;17;Tiistai;9;4;13
626;20.02.2018;2018;02;18;Tiistai;7;3;10
626;20.02.2018;2018;02;19;Tiistai;1;1;2
626;20.02.2018;2018;02;20;Tiistai;2;1;3
626;20.02.2018;2018;02;21;Tiistai;2;1;3
626;20.02.2018;2018;02;22;Tiistai;5;1;6
626;20.02.2018;2018;02;23;Tiistai;0;1;1
626;21.02.2018;2018;02;00;Keskiviikko;0;0;0
626;21.02.2018;2018;02;01;Keskiviikko;0;0;0
626;21.02.2018;2018;02;02;Keskiviikko;0;0;0
626;21.02.2018;2018;02;03;Keskiviikko;0;0;0
626;21.02.2018;2018;02;04;Keskiviikko;0;0;0
626;21.02.2018;2018;02;05;Keskiviikko;1;2;3
626;21.02.2018;2018;02;06;Keskiviikko;3;6;9
626;21.02.2018;2018;02;07;Keskiviikko;1;5;6
626;21.02.2018;2018;02;08;Keskiviikko;3;16;19
626;21.02.2018;2018;02;09;Keskiviikko;3;10;13
626;21.02.2018;2018;02;10;Keskiviikko;1;3;4
626;21.02.2018;2018;02;11;Keskiviikko;0;5;5
626;21.02.2018;2018;02;12;Keskiviikko;0;3;3
626;21.02.2018;2018;02;13;Keskiviikko;5;3;8
626;21.02.2018;2018;02;14;Keskiviikko;5;6;11
626;21.02.2018;2018;02;15;Keskiviikko;11;4;15
626;21.02.2018;2018;02;16;Keskiviikko;7;7;14
626;21.02.2018;2018;02;17;Keskiviikko;16;7;23
626;21.02.2018;2018;02;18;Keskiviikko;8;3;11
626;21.02.2018;2018;02;19;Keskiviikko;7;4;11
626;21.02.2018;2018;02;20;Keskiviikko;2;1;3
626;21.02.2018;2018;02;21;Keskiviikko;4;2;6
626;21.02.2018;2018;02;22;Keskiviikko;1;0;1
626;21.02.2018;2018;02;23;Keskiviikko;2;0;2
626;22.02.2018;2018;02;00;Torstai;1;0;1
626;22.02.2018;2018;02;01;Torstai;0;0;0
626;22.02.2018;2018;02;02;Torstai;0;0;0
626;22.02.2018;2018;02;03;Torstai;0;0;0
626;22.02.2018;2018;02;04;Torstai;1;0;1
626;22.02.2018;2018;02;05;Torstai;1;4;5
626;22.02.2018;2018;02;06;Torstai;5;5;10
626;22.02.2018;2018;02;07;Torstai;4;12;16
626;22.02.2018;2018;02;08;Torstai;2;22;24
626;22.02.2018;2018;02;09;Torstai;3;17;20
626;22.02.2018;2018;02;10;Torstai;1;4;5
626;22.02.2018;2018;02;11;Torstai;0;2;2
626;22.02.2018;2018;02;12;Torstai;3;2;5
626;22.02.2018;2018;02;13;Torstai;2;6;8
626;22.02.2018;2018;02;14;Torstai;1;5;6
626;22.02.2018;2018;02;15;Torstai;8;3;11
626;22.02.2018;2018;02;16;Torstai;10;5;15
626;22.02.2018;2018;02;17;Torstai;20;5;25
626;22.02.2018;2018;02;18;Torstai;8;3;11
626;22.02.2018;2018;02;19;Torstai;5;3;8
626;22.02.2018;2018;02;20;Torstai;3;1;4
626;22.02.2018;2018;02;21;Torstai;3;0;3
626;22.02.2018;2018;02;22;Torstai;1;0;1
626;22.02.2018;2018;02;23;Torstai;3;1;4
626;23.02.2018;2018;02;00;Perjantai;0;0;0
626;23.02.2018;2018;02;01;Perjantai;0;0;0
626;23.02.2018;2018;02;02;Perjantai;0;0;0
626;23.02.2018;2018;02;03;Perjantai;0;1;1
626;23.02.2018;2018;02;04;Perjantai;0;0;0
626;23.02.2018;2018;02;05;Perjantai;0;0;0
626;23.02.2018;2018;02;06;Perjantai;3;9;12
626;23.02.2018;2018;02;07;Perjantai;2;6;8
626;23.02.2018;2018;02;08;Perjantai;5;24;29
626;23.02.2018;2018;02;09;Perjantai;2;10;12
626;23.02.2018;2018;02;10;Perjantai;0;8;8
626;23.02.2018;2018;02;11;Perjantai;2;3;5
626;23.02.2018;2018;02;12;Perjantai;3;1;4
626;23.02.2018;2018;02;13;Perjantai;3;4;7
626;23.02.2018;2018;02;14;Perjantai;3;2;5
626;23.02.2018;2018;02;15;Perjantai;6;6;12
626;23.02.2018;2018;02;16;Perjantai;13;5;18
626;23.02.2018;2018;02;17;Perjantai;21;9;30
626;23.02.2018;2018;02;18;Perjantai;8;7;15
626;23.02.2018;2018;02;19;Perjantai;9;2;11
626;23.02.2018;2018;02;20;Perjantai;3;4;7
626;23.02.2018;2018;02;21;Perjantai;1;0;1
626;23.02.2018;2018;02;22;Perjantai;3;0;3
626;23.02.2018;2018;02;23;Perjantai;1;1;2
626;24.02.2018;2018;02;00;Lauantai;1;0;1
626;24.02.2018;2018;02;01;Lauantai;0;0;0
626;24.02.2018;2018;02;02;Lauantai;0;0;0
626;24.02.2018;2018;02;03;Lauantai;0;0;0
626;24.02.2018;2018;02;04;Lauantai;0;0;0
626;24.02.2018;2018;02;05;Lauantai;0;0;0
626;24.02.2018;2018;02;06;Lauantai;0;1;1
626;24.02.2018;2018;02;07;Lauantai;0;0;0
626;24.02.2018;2018;02;08;Lauantai;0;1;1
626;24.02.2018;2018;02;09;Lauantai;0;0;0
626;24.02.2018;2018;02;10;Lauantai;0;0;0
626;24.02.2018;2018;02;11;Lauantai;0;3;3
626;24.02.2018;2018;02;12;Lauantai;0;0;0
626;24.02.2018;2018;02;13;Lauantai;0;1;1
626;24.02.2018;2018;02;14;Lauantai;2;1;3
626;24.02.2018;2018;02;15;Lauantai;3;3;6
626;24.02.2018;2018;02;16;Lauantai;1;1;2
626;24.02.2018;2018;02;17;Lauantai;1;2;3
626;24.02.2018;2018;02;18;Lauantai;2;3;5
626;24.02.2018;2018;02;19;Lauantai;2;0;2
626;24.02.2018;2018;02;20;Lauantai;0;1;1
626;24.02.2018;2018;02;21;Lauantai;1;2;3
626;24.02.2018;2018;02;22;Lauantai;0;1;1
626;24.02.2018;2018;02;23;Lauantai;0;0;0
626;25.02.2018;2018;02;00;Sunnuntai;0;0;0
626;25.02.2018;2018;02;01;Sunnuntai;0;0;0
626;25.02.2018;2018;02;02;Sunnuntai;0;0;0
626;25.02.2018;2018;02;03;Sunnuntai;0;0;0
626;25.02.2018;2018;02;04;Sunnuntai;0;0;0
626;25.02.2018;2018;02;05;Sunnuntai;0;0;0
626;25.02.2018;2018;02;06;Sunnuntai;1;0;1
626;25.02.2018;2018;02;07;Sunnuntai;0;1;1
626;25.02.2018;2018;02;08;Sunnuntai;0;0;0
626;25.02.2018;2018;02;09;Sunnuntai;1;0;1
626;25.02.2018;2018;02;10;Sunnuntai;0;0;0
626;25.02.2018;2018;02;11;Sunnuntai;1;3;4
626;25.02.2018;2018;02;12;Sunnuntai;1;2;3
626;25.02.2018;2018;02;13;Sunnuntai;2;3;5
626;25.02.2018;2018;02;14;Sunnuntai;1;3;4
626;25.02.2018;2018;02;15;Sunnuntai;3;6;9
626;25.02.2018;2018;02;16;Sunnuntai;0;1;1
626;25.02.2018;2018;02;17;Sunnuntai;1;4;5
626;25.02.2018;2018;02;18;Sunnuntai;0;1;1
626;25.02.2018;2018;02;19;Sunnuntai;0;1;1
626;25.02.2018;2018;02;20;Sunnuntai;1;5;6
626;25.02.2018;2018;02;21;Sunnuntai;0;0;0
626;25.02.2018;2018;02;22;Sunnuntai;0;0;0
626;25.02.2018;2018;02;23;Sunnuntai;0;0;0
626;26.02.2018;2018;02;00;Maanantai;0;0;0
626;26.02.2018;2018;02;01;Maanantai;0;0;0
626;26.02.2018;2018;02;02;Maanantai;0;0;0
626;26.02.2018;2018;02;03;Maanantai;0;0;0
626;26.02.2018;2018;02;04;Maanantai;0;2;2
626;26.02.2018;2018;02;05;Maanantai;0;1;1
626;26.02.2018;2018;02;06;Maanantai;4;4;8
626;26.02.2018;2018;02;07;Maanantai;2;15;17
626;26.02.2018;2018;02;08;Maanantai;3;28;31
626;26.02.2018;2018;02;09;Maanantai;8;15;23
626;26.02.2018;2018;02;10;Maanantai;2;4;6
626;26.02.2018;2018;02;11;Maanantai;1;5;6
626;26.02.2018;2018;02;12;Maanantai;1;0;1
626;26.02.2018;2018;02;13;Maanantai;4;5;9
626;26.02.2018;2018;02;14;Maanantai;5;5;10
626;26.02.2018;2018;02;15;Maanantai;8;8;16
626;26.02.2018;2018;02;16;Maanantai;16;5;21
626;26.02.2018;2018;02;17;Maanantai;22;8;30
626;26.02.2018;2018;02;18;Maanantai;11;2;13
626;26.02.2018;2018;02;19;Maanantai;8;3;11
626;26.02.2018;2018;02;20;Maanantai;9;3;12
626;26.02.2018;2018;02;21;Maanantai;2;0;2
626;26.02.2018;2018;02;22;Maanantai;4;1;5
626;26.02.2018;2018;02;23;Maanantai;2;2;4
626;27.02.2018;2018;02;00;Tiistai;0;0;0
626;27.02.2018;2018;02;01;Tiistai;0;1;1
626;27.02.2018;2018;02;02;Tiistai;0;0;0
626;27.02.2018;2018;02;03;Tiistai;0;0;0
626;27.02.2018;2018;02;04;Tiistai;0;1;1
626;27.02.2018;2018;02;05;Tiistai;0;2;2
626;27.02.2018;2018;02;06;Tiistai;6;4;10
626;27.02.2018;2018;02;07;Tiistai;2;16;18
626;27.02.2018;2018;02;08;Tiistai;6;18;24
626;27.02.2018;2018;02;09;Tiistai;1;12;13
626;27.02.2018;2018;02;10;Tiistai;1;2;3
626;27.02.2018;2018;02;11;Tiistai;1;3;4
626;27.02.2018;2018;02;12;Tiistai;1;2;3
626;27.02.2018;2018;02;13;Tiistai;1;2;3
626;27.02.2018;2018;02;14;Tiistai;5;3;8
626;27.02.2018;2018;02;15;Tiistai;6;6;12
626;27.02.2018;2018;02;16;Tiistai;13;4;17
626;27.02.2018;2018;02;17;Tiistai;20;3;23
626;27.02.2018;2018;02;18;Tiistai;4;3;7
626;27.02.2018;2018;02;19;Tiistai;5;1;6
626;27.02.2018;2018;02;20;Tiistai;2;0;2
626;27.02.2018;2018;02;21;Tiistai;4;0;4
626;27.02.2018;2018;02;22;Tiistai;2;0;2
626;27.02.2018;2018;02;23;Tiistai;0;2;2
626;28.02.2018;2018;02;00;Keskiviikko;0;0;0
626;28.02.2018;2018;02;01;Keskiviikko;0;0;0
626;28.02.2018;2018;02;02;Keskiviikko;0;0;0
626;28.02.2018;2018;02;03;Keskiviikko;0;1;1
626;28.02.2018;2018;02;04;Keskiviikko;0;1;1
626;28.02.2018;2018;02;05;Keskiviikko;0;1;1
626;28.02.2018;2018;02;06;Keskiviikko;3;3;6
626;28.02.2018;2018;02;07;Keskiviikko;1;5;6
626;28.02.2018;2018;02;08;Keskiviikko;5;13;18
626;28.02.2018;2018;02;09;Keskiviikko;1;8;9
626;28.02.2018;2018;02;10;Keskiviikko;0;1;1
626;28.02.2018;2018;02;11;Keskiviikko;1;2;3
626;28.02.2018;2018;02;12;Keskiviikko;1;3;4
626;28.02.2018;2018;02;13;Keskiviikko;3;3;6
626;28.02.2018;2018;02;14;Keskiviikko;1;2;3
626;28.02.2018;2018;02;15;Keskiviikko;2;7;9
626;28.02.2018;2018;02;16;Keskiviikko;8;1;9
626;28.02.2018;2018;02;17;Keskiviikko;14;4;18
626;28.02.2018;2018;02;18;Keskiviikko;3;5;8
626;28.02.2018;2018;02;19;Keskiviikko;5;0;5
626;28.02.2018;2018;02;20;Keskiviikko;2;2;4
626;28.02.2018;2018;02;21;Keskiviikko;3;0;3
626;28.02.2018;2018;02;22;Keskiviikko;2;0;2
626;28.02.2018;2018;02;23;Keskiviikko;0;2;2
626;01.03.2018;2018;03;00;Torstai;1;0;1
626;01.03.2018;2018;03;01;Torstai;0;0;0
626;01.03.2018;2018;03;02;Torstai;0;0;0
626;01.03.2018;2018;03;03;Torstai;0;0;0
626;01.03.2018;2018;03;04;Torstai;0;2;2
626;01.03.2018;2018;03;05;Torstai;0;1;1
626;01.03.2018;2018;03;06;Torstai;3;9;12
626;01.03.2018;2018;03;07;Torstai;1;16;17
626;01.03.2018;2018;03;08;Torstai;8;22;30
626;01.03.2018;2018;03;09;Torstai;2;14;16
626;01.03.2018;2018;03;10;Torstai;2;5;7
626;01.03.2018;2018;03;11;Torstai;2;2;4
626;01.03.2018;2018;03;12;Torstai;1;2;3
626;01.03.2018;2018;03;13;Torstai;1;4;5
626;01.03.2018;2018;03;14;Torstai;6;1;7
626;01.03.2018;2018;03;15;Torstai;9;6;15
626;01.03.2018;2018;03;16;Torstai;14;9;23
626;01.03.2018;2018;03;17;Torstai;16;6;22
626;01.03.2018;2018;03;18;Torstai;10;9;19
626;01.03.2018;2018;03;19;Torstai;8;2;10
626;01.03.2018;2018;03;20;Torstai;5;1;6
626;01.03.2018;2018;03;21;Torstai;2;1;3
626;01.03.2018;2018;03;22;Torstai;4;0;4
626;01.03.2018;2018;03;23;Torstai;2;1;3
626;02.03.2018;2018;03;00;Perjantai;0;1;1
626;02.03.2018;2018;03;01;Perjantai;1;0;1
626;02.03.2018;2018;03;02;Perjantai;0;0;0
626;02.03.2018;2018;03;03;Perjantai;0;0;0
626;02.03.2018;2018;03;04;Perjantai;0;1;1
626;02.03.2018;2018;03;05;Perjantai;0;1;1
626;02.03.2018;2018;03;06;Perjantai;4;5;9
626;02.03.2018;2018;03;07;Perjantai;2;10;12
626;02.03.2018;2018;03;08;Perjantai;8;24;32
626;02.03.2018;2018;03;09;Perjantai;2;10;12
626;02.03.2018;2018;03;10;Perjantai;2;6;8
626;02.03.2018;2018;03;11;Perjantai;0;3;3
626;02.03.2018;2018;03;12;Perjantai;2;4;6
626;02.03.2018;2018;03;13;Perjantai;3;7;10
626;02.03.2018;2018;03;14;Perjantai;5;4;9
626;02.03.2018;2018;03;15;Perjantai;11;12;23
626;02.03.2018;2018;03;16;Perjantai;8;7;15
626;02.03.2018;2018;03;17;Perjantai;23;7;30
626;02.03.2018;2018;03;18;Perjantai;8;4;12
626;02.03.2018;2018;03;19;Perjantai;3;2;5
626;02.03.2018;2018;03;20;Perjantai;3;1;4
626;02.03.2018;2018;03;21;Perjantai;1;2;3
626;02.03.2018;2018;03;22;Perjantai;7;0;7
626;02.03.2018;2018;03;23;Perjantai;1;2;3
626;03.03.2018;2018;03;00;Lauantai;0;0;0
626;03.03.2018;2018;03;01;Lauantai;0;0;0
626;03.03.2018;2018;03;02;Lauantai;0;0;0
626;03.03.2018;2018;03;03;Lauantai;0;0;0
626;03.03.2018;2018;03;04;Lauantai;0;0;0
626;03.03.2018;2018;03;05;Lauantai;1;2;3
626;03.03.2018;2018;03;06;Lauantai;0;2;2
626;03.03.2018;2018;03;07;Lauantai;0;0;0
626;03.03.2018;2018;03;08;Lauantai;0;1;1
626;03.03.2018;2018;03;09;Lauantai;0;1;1
626;03.03.2018;2018;03;10;Lauantai;0;6;6
626;03.03.2018;2018;03;11;Lauantai;3;6;9
626;03.03.2018;2018;03;12;Lauantai;4;4;8
626;03.03.2018;2018;03;13;Lauantai;1;7;8
626;03.03.2018;2018;03;14;Lauantai;1;7;8
626;03.03.2018;2018;03;15;Lauantai;5;1;6
626;03.03.2018;2018;03;16;Lauantai;2;5;7
626;03.03.2018;2018;03;17;Lauantai;3;2;5
626;03.03.2018;2018;03;18;Lauantai;5;1;6
626;03.03.2018;2018;03;19;Lauantai;1;3;4
626;03.03.2018;2018;03;20;Lauantai;0;2;2
626;03.03.2018;2018;03;21;Lauantai;1;0;1
626;03.03.2018;2018;03;22;Lauantai;2;2;4
626;03.03.2018;2018;03;23;Lauantai;1;0;1
626;04.03.2018;2018;03;00;Sunnuntai;0;1;1
626;04.03.2018;2018;03;01;Sunnuntai;0;0;0
626;04.03.2018;2018;03;02;Sunnuntai;0;0;0
626;04.03.2018;2018;03;03;Sunnuntai;1;0;1
626;04.03.2018;2018;03;04;Sunnuntai;0;0;0
626;04.03.2018;2018;03;05;Sunnuntai;0;0;0
626;04.03.2018;2018;03;06;Sunnuntai;0;0;0
626;04.03.2018;2018;03;07;Sunnuntai;1;0;1
626;04.03.2018;2018;03;08;Sunnuntai;0;0;0
626;04.03.2018;2018;03;09;Sunnuntai;0;2;2
626;04.03.2018;2018;03;10;Sunnuntai;3;3;6
626;04.03.2018;2018;03;11;Sunnuntai;1;3;4
626;04.03.2018;2018;03;12;Sunnuntai;1;3;4
626;04.03.2018;2018;03;13;Sunnuntai;6;2;8
626;04.03.2018;2018;03;14;Sunnuntai;1;6;7
626;04.03.2018;2018;03;15;Sunnuntai;5;6;11
626;04.03.2018;2018;03;16;Sunnuntai;4;3;7
626;04.03.2018;2018;03;17;Sunnuntai;0;8;8
626;04.03.2018;2018;03;18;Sunnuntai;4;3;7
626;04.03.2018;2018;03;19;Sunnuntai;1;3;4
626;04.03.2018;2018;03;20;Sunnuntai;2;2;4
626;04.03.2018;2018;03;21;Sunnuntai;3;0;3
626;04.03.2018;2018;03;22;Sunnuntai;1;2;3
626;04.03.2018;2018;03;23;Sunnuntai;2;0;2
626;05.03.2018;2018;03;00;Maanantai;0;0;0
626;05.03.2018;2018;03;01;Maanantai;0;0;0
626;05.03.2018;2018;03;02;Maanantai;0;0;0
626;05.03.2018;2018;03;03;Maanantai;0;0;0
626;05.03.2018;2018;03;04;Maanantai;0;2;2
626;05.03.2018;2018;03;05;Maanantai;0;1;1
626;05.03.2018;2018;03;06;Maanantai;4;7;11
626;05.03.2018;2018;03;07;Maanantai;0;8;8
626;05.03.2018;2018;03;08;Maanantai;3;13;16
626;05.03.2018;2018;03;09;Maanantai;1;8;9
626;05.03.2018;2018;03;10;Maanantai;1;4;5
626;05.03.2018;2018;03;11;Maanantai;1;5;6
626;05.03.2018;2018;03;12;Maanantai;1;5;6
626;05.03.2018;2018;03;13;Maanantai;5;1;6
626;05.03.2018;2018;03;14;Maanantai;1;6;7
626;05.03.2018;2018;03;15;Maanantai;7;3;10
626;05.03.2018;2018;03;16;Maanantai;7;2;9
626;05.03.2018;2018;03;17;Maanantai;13;8;21
626;05.03.2018;2018;03;18;Maanantai;8;3;11
626;05.03.2018;2018;03;19;Maanantai;1;1;2
626;05.03.2018;2018;03;20;Maanantai;4;1;5
626;05.03.2018;2018;03;21;Maanantai;4;0;4
626;05.03.2018;2018;03;22;Maanantai;1;2;3
626;05.03.2018;2018;03;23;Maanantai;1;0;1
626;06.03.2018;2018;03;00;Tiistai;0;0;0
626;06.03.2018;2018;03;01;Tiistai;0;0;0
626;06.03.2018;2018;03;02;Tiistai;0;0;0
626;06.03.2018;2018;03;03;Tiistai;0;0;0
626;06.03.2018;2018;03;04;Tiistai;0;0;0
626;06.03.2018;2018;03;05;Tiistai;0;2;2
626;06.03.2018;2018;03;06;Tiistai;3;4;7
626;06.03.2018;2018;03;07;Tiistai;0;9;9
626;06.03.2018;2018;03;08;Tiistai;1;11;12
626;06.03.2018;2018;03;09;Tiistai;3;7;10
626;06.03.2018;2018;03;10;Tiistai;2;3;5
626;06.03.2018;2018;03;11;Tiistai;1;4;5
626;06.03.2018;2018;03;12;Tiistai;2;2;4
626;06.03.2018;2018;03;13;Tiistai;4;3;7
626;06.03.2018;2018;03;14;Tiistai;2;4;6
626;06.03.2018;2018;03;15;Tiistai;6;4;10
626;06.03.2018;2018;03;16;Tiistai;12;6;18
626;06.03.2018;2018;03;17;Tiistai;10;4;14
626;06.03.2018;2018;03;18;Tiistai;6;4;10
626;06.03.2018;2018;03;19;Tiistai;2;1;3
626;06.03.2018;2018;03;20;Tiistai;3;0;3
626;06.03.2018;2018;03;21;Tiistai;1;0;1
626;06.03.2018;2018;03;22;Tiistai;1;3;4
626;06.03.2018;2018;03;23;Tiistai;0;0;0
626;07.03.2018;2018;03;00;Keskiviikko;0;0;0
626;07.03.2018;2018;03;01;Keskiviikko;0;0;0
626;07.03.2018;2018;03;02;Keskiviikko;1;0;1
626;07.03.2018;2018;03;03;Keskiviikko;0;0;0
626;07.03.2018;2018;03;04;Keskiviikko;0;0;0
626;07.03.2018;2018;03;05;Keskiviikko;1;5;6
626;07.03.2018;2018;03;06;Keskiviikko;3;3;6
626;07.03.2018;2018;03;07;Keskiviikko;1;14;15
626;07.03.2018;2018;03;08;Keskiviikko;2;16;18
626;07.03.2018;2018;03;09;Keskiviikko;2;7;9
626;07.03.2018;2018;03;10;Keskiviikko;0;3;3
626;07.03.2018;2018;03;11;Keskiviikko;1;5;6
626;07.03.2018;2018;03;12;Keskiviikko;1;2;3
626;07.03.2018;2018;03;13;Keskiviikko;2;4;6
626;07.03.2018;2018;03;14;Keskiviikko;7;4;11
626;07.03.2018;2018;03;15;Keskiviikko;6;3;9
626;07.03.2018;2018;03;16;Keskiviikko;10;4;14
626;07.03.2018;2018;03;17;Keskiviikko;12;5;17
626;07.03.2018;2018;03;18;Keskiviikko;8;4;12
626;07.03.2018;2018;03;19;Keskiviikko;1;0;1
626;07.03.2018;2018;03;20;Keskiviikko;3;3;6
626;07.03.2018;2018;03;21;Keskiviikko;2;0;2
626;07.03.2018;2018;03;22;Keskiviikko;3;4;7
626;07.03.2018;2018;03;23;Keskiviikko;2;0;2
626;08.03.2018;2018;03;00;Torstai;0;1;1
626;08.03.2018;2018;03;01;Torstai;0;0;0
626;08.03.2018;2018;03;02;Torstai;0;0;0
626;08.03.2018;2018;03;03;Torstai;0;0;0
626;08.03.2018;2018;03;04;Torstai;1;1;2
626;08.03.2018;2018;03;05;Torstai;0;5;5
626;08.03.2018;2018;03;06;Torstai;4;3;7
626;08.03.2018;2018;03;07;Torstai;0;15;15
626;08.03.2018;2018;03;08;Torstai;4;19;23
626;08.03.2018;2018;03;09;Torstai;6;8;14
626;08.03.2018;2018;03;10;Torstai;1;3;4
626;08.03.2018;2018;03;11;Torstai;2;6;8
626;08.03.2018;2018;03;12;Torstai;3;3;6
626;08.03.2018;2018;03;13;Torstai;4;4;8
626;08.03.2018;2018;03;14;Torstai;2;7;9
626;08.03.2018;2018;03;15;Torstai;9;6;15
626;08.03.2018;2018;03;16;Torstai;10;4;14
626;08.03.2018;2018;03;17;Torstai;13;12;25
626;08.03.2018;2018;03;18;Torstai;9;4;13
626;08.03.2018;2018;03;19;Torstai;3;2;5
626;08.03.2018;2018;03;20;Torstai;2;1;3
626;08.03.2018;2018;03;21;Torstai;2;0;2
626;08.03.2018;2018;03;22;Torstai;3;2;5
626;08.03.2018;2018;03;23;Torstai;0;0;0
626;09.03.2018;2018;03;00;Perjantai;0;0;0
626;09.03.2018;2018;03;01;Perjantai;0;0;0
626;09.03.2018;2018;03;02;Perjantai;1;0;1
626;09.03.2018;2018;03;03;Perjantai;0;0;0
626;09.03.2018;2018;03;04;Perjantai;0;0;0
626;09.03.2018;2018;03;05;Perjantai;0;5;5
626;09.03.2018;2018;03;06;Perjantai;4;4;8
626;09.03.2018;2018;03;07;Perjantai;0;9;9
626;09.03.2018;2018;03;08;Perjantai;5;19;24
626;09.03.2018;2018;03;09;Perjantai;1;7;8
626;09.03.2018;2018;03;10;Perjantai;2;5;7
626;09.03.2018;2018;03;11;Perjantai;1;6;7
626;09.03.2018;2018;03;12;Perjantai;3;4;7
626;09.03.2018;2018;03;13;Perjantai;3;2;5
626;09.03.2018;2018;03;14;Perjantai;3;1;4
626;09.03.2018;2018;03;15;Perjantai;3;6;9
626;09.03.2018;2018;03;16;Perjantai;8;2;10
626;09.03.2018;2018;03;17;Perjantai;11;6;17
626;09.03.2018;2018;03;18;Perjantai;2;5;7
626;09.03.2018;2018;03;19;Perjantai;3;2;5
626;09.03.2018;2018;03;20;Perjantai;3;2;5
626;09.03.2018;2018;03;21;Perjantai;0;2;2
626;09.03.2018;2018;03;22;Perjantai;5;1;6
626;09.03.2018;2018;03;23;Perjantai;0;0;0
626;10.03.2018;2018;03;00;Lauantai;0;0;0
626;10.03.2018;2018;03;01;Lauantai;0;0;0
626;10.03.2018;2018;03;02;Lauantai;1;0;1
626;10.03.2018;2018;03;03;Lauantai;0;0;0
626;10.03.2018;2018;03;04;Lauantai;0;0;0
626;10.03.2018;2018;03;05;Lauantai;2;1;3
626;10.03.2018;2018;03;06;Lauantai;0;3;3
626;10.03.2018;2018;03;07;Lauantai;0;0;0
626;10.03.2018;2018;03;08;Lauantai;1;3;4
626;10.03.2018;2018;03;09;Lauantai;0;1;1
626;10.03.2018;2018;03;10;Lauantai;2;5;7
626;10.03.2018;2018;03;11;Lauantai;1;3;4
626;10.03.2018;2018;03;12;Lauantai;3;4;7
626;10.03.2018;2018;03;13;Lauantai;3;0;3
626;10.03.2018;2018;03;14;Lauantai;3;3;6
626;10.03.2018;2018;03;15;Lauantai;2;2;4
626;10.03.2018;2018;03;16;Lauantai;1;2;3
626;10.03.2018;2018;03;17;Lauantai;4;1;5
626;10.03.2018;2018;03;18;Lauantai;4;7;11
626;10.03.2018;2018;03;19;Lauantai;3;2;5
626;10.03.2018;2018;03;20;Lauantai;2;3;5
626;10.03.2018;2018;03;21;Lauantai;0;0;0
626;10.03.2018;2018;03;22;Lauantai;2;1;3
626;10.03.2018;2018;03;23;Lauantai;0;1;1
626;11.03.2018;2018;03;00;Sunnuntai;1;0;1
626;11.03.2018;2018;03;01;Sunnuntai;0;0;0
626;11.03.2018;2018;03;02;Sunnuntai;0;0;0
626;11.03.2018;2018;03;03;Sunnuntai;0;0;0
626;11.03.2018;2018;03;04;Sunnuntai;1;0;1
626;11.03.2018;2018;03;05;Sunnuntai;0;0;0
626;11.03.2018;2018;03;06;Sunnuntai;1;1;2
626;11.03.2018;2018;03;07;Sunnuntai;0;0;0
626;11.03.2018;2018;03;08;Sunnuntai;0;0;0
626;11.03.2018;2018;03;09;Sunnuntai;1;1;2
626;11.03.2018;2018;03;10;Sunnuntai;3;3;6
626;11.03.2018;2018;03;11;Sunnuntai;0;1;1
626;11.03.2018;2018;03;12;Sunnuntai;0;3;3
626;11.03.2018;2018;03;13;Sunnuntai;3;4;7
626;11.03.2018;2018;03;14;Sunnuntai;2;2;4
626;11.03.2018;2018;03;15;Sunnuntai;1;2;3
626;11.03.2018;2018;03;16;Sunnuntai;1;2;3
626;11.03.2018;2018;03;17;Sunnuntai;2;3;5
626;11.03.2018;2018;03;18;Sunnuntai;3;2;5
626;11.03.2018;2018;03;19;Sunnuntai;2;3;5
626;11.03.2018;2018;03;20;Sunnuntai;1;3;4
626;11.03.2018;2018;03;21;Sunnuntai;4;1;5
626;11.03.2018;2018;03;22;Sunnuntai;0;0;0
626;11.03.2018;2018;03;23;Sunnuntai;2;1;3
626;12.03.2018;2018;03;00;Maanantai;0;0;0
626;12.03.2018;2018;03;01;Maanantai;0;1;1
626;12.03.2018;2018;03;02;Maanantai;0;0;0
626;12.03.2018;2018;03;03;Maanantai;0;0;0
626;12.03.2018;2018;03;04;Maanantai;0;0;0
626;12.03.2018;2018;03;05;Maanantai;0;3;3
626;12.03.2018;2018;03;06;Maanantai;4;6;10
626;12.03.2018;2018;03;07;Maanantai;5;15;20
626;12.03.2018;2018;03;08;Maanantai;2;31;33
626;12.03.2018;2018;03;09;Maanantai;4;14;18
626;12.03.2018;2018;03;10;Maanantai;1;6;7
626;12.03.2018;2018;03;11;Maanantai;6;14;20
626;12.03.2018;2018;03;12;Maanantai;3;3;6
626;12.03.2018;2018;03;13;Maanantai;4;5;9
626;12.03.2018;2018;03;14;Maanantai;8;3;11
626;12.03.2018;2018;03;15;Maanantai;4;12;16
626;12.03.2018;2018;03;16;Maanantai;19;4;23
626;12.03.2018;2018;03;17;Maanantai;21;9;30
626;12.03.2018;2018;03;18;Maanantai;6;7;13
626;12.03.2018;2018;03;19;Maanantai;5;2;7
626;12.03.2018;2018;03;20;Maanantai;5;2;7
626;12.03.2018;2018;03;21;Maanantai;2;0;2
626;12.03.2018;2018;03;22;Maanantai;6;2;8
626;12.03.2018;2018;03;23;Maanantai;0;1;1
626;13.03.2018;2018;03;00;Tiistai;1;1;2
626;13.03.2018;2018;03;01;Tiistai;0;0;0
626;13.03.2018;2018;03;02;Tiistai;0;1;1
626;13.03.2018;2018;03;03;Tiistai;0;0;0
626;13.03.2018;2018;03;04;Tiistai;0;0;0
626;13.03.2018;2018;03;05;Tiistai;4;3;7
626;13.03.2018;2018;03;06;Tiistai;2;7;9
626;13.03.2018;2018;03;07;Tiistai;2;14;16
626;13.03.2018;2018;03;08;Tiistai;7;24;31
626;13.03.2018;2018;03;09;Tiistai;3;19;22
626;13.03.2018;2018;03;10;Tiistai;1;4;5
626;13.03.2018;2018;03;11;Tiistai;1;4;5
626;13.03.2018;2018;03;12;Tiistai;4;6;10
626;13.03.2018;2018;03;13;Tiistai;4;4;8
626;13.03.2018;2018;03;14;Tiistai;5;2;7
626;13.03.2018;2018;03;15;Tiistai;5;5;10
626;13.03.2018;2018;03;16;Tiistai;15;3;18
626;13.03.2018;2018;03;17;Tiistai;18;8;26
626;13.03.2018;2018;03;18;Tiistai;8;2;10
626;13.03.2018;2018;03;19;Tiistai;7;2;9
626;13.03.2018;2018;03;20;Tiistai;1;1;2
626;13.03.2018;2018;03;21;Tiistai;4;0;4
626;13.03.2018;2018;03;22;Tiistai;1;3;4
626;13.03.2018;2018;03;23;Tiistai;1;2;3
626;14.03.2018;2018;03;00;Keskiviikko;0;0;0
626;14.03.2018;2018;03;01;Keskiviikko;0;1;1
626;14.03.2018;2018;03;02;Keskiviikko;0;0;0
626;14.03.2018;2018;03;03;Keskiviikko;0;1;1
626;14.03.2018;2018;03;04;Keskiviikko;0;0;0
626;14.03.2018;2018;03;05;Keskiviikko;2;7;9
626;14.03.2018;2018;03;06;Keskiviikko;3;3;6
626;14.03.2018;2018;03;07;Keskiviikko;2;14;16
626;14.03.2018;2018;03;08;Keskiviikko;3;24;27
626;14.03.2018;2018;03;09;Keskiviikko;4;15;19
626;14.03.2018;2018;03;10;Keskiviikko;1;2;3
626;14.03.2018;2018;03;11;Keskiviikko;1;3;4
626;14.03.2018;2018;03;12;Keskiviikko;2;6;8
626;14.03.2018;2018;03;13;Keskiviikko;1;1;2
626;14.03.2018;2018;03;14;Keskiviikko;4;5;9
626;14.03.2018;2018;03;15;Keskiviikko;6;4;10
626;14.03.2018;2018;03;16;Keskiviikko;7;9;16
626;14.03.2018;2018;03;17;Keskiviikko;18;10;28
626;14.03.2018;2018;03;18;Keskiviikko;6;9;15
626;14.03.2018;2018;03;19;Keskiviikko;8;2;10
626;14.03.2018;2018;03;20;Keskiviikko;6;3;9
626;14.03.2018;2018;03;21;Keskiviikko;2;1;3
626;14.03.2018;2018;03;22;Keskiviikko;1;3;4
626;14.03.2018;2018;03;23;Keskiviikko;1;3;4
626;15.03.2018;2018;03;00;Torstai;0;0;0
626;15.03.2018;2018;03;01;Torstai;0;0;0
626;15.03.2018;2018;03;02;Torstai;0;0;0
626;15.03.2018;2018;03;03;Torstai;1;1;2
626;15.03.2018;2018;03;04;Torstai;1;0;1
626;15.03.2018;2018;03;05;Torstai;0;2;2
626;15.03.2018;2018;03;06;Torstai;2;8;10
626;15.03.2018;2018;03;07;Torstai;2;11;13
626;15.03.2018;2018;03;08;Torstai;3;23;26
626;15.03.2018;2018;03;09;Torstai;6;13;19
626;15.03.2018;2018;03;10;Torstai;1;8;9
626;15.03.2018;2018;03;11;Torstai;1;1;2
626;15.03.2018;2018;03;12;Torstai;3;3;6
626;15.03.2018;2018;03;13;Torstai;2;4;6
626;15.03.2018;2018;03;14;Torstai;7;3;10
626;15.03.2018;2018;03;15;Torstai;4;5;9
626;15.03.2018;2018;03;16;Torstai;8;5;13
626;15.03.2018;2018;03;17;Torstai;19;4;23
626;15.03.2018;2018;03;18;Torstai;9;4;13
626;15.03.2018;2018;03;19;Torstai;3;2;5
626;15.03.2018;2018;03;20;Torstai;5;3;8
626;15.03.2018;2018;03;21;Torstai;7;1;8
626;15.03.2018;2018;03;22;Torstai;1;4;5
626;15.03.2018;2018;03;23;Torstai;1;1;2
626;16.03.2018;2018;03;00;Perjantai;0;1;1
626;16.03.2018;2018;03;01;Perjantai;0;0;0
626;16.03.2018;2018;03;02;Perjantai;0;0;0
626;16.03.2018;2018;03;03;Perjantai;0;0;0
626;16.03.2018;2018;03;04;Perjantai;0;1;1
626;16.03.2018;2018;03;05;Perjantai;0;0;0
626;16.03.2018;2018;03;06;Perjantai;2;5;7
626;16.03.2018;2018;03;07;Perjantai;2;5;7
626;16.03.2018;2018;03;08;Perjantai;5;15;20
626;16.03.2018;2018;03;09;Perjantai;5;6;11
626;16.03.2018;2018;03;10;Perjantai;2;6;8
626;16.03.2018;2018;03;11;Perjantai;4;5;9
626;16.03.2018;2018;03;12;Perjantai;1;6;7
626;16.03.2018;2018;03;13;Perjantai;2;6;8
626;16.03.2018;2018;03;14;Perjantai;3;1;4
626;16.03.2018;2018;03;15;Perjantai;5;6;11
626;16.03.2018;2018;03;16;Perjantai;8;7;15
626;16.03.2018;2018;03;17;Perjantai;13;6;19
626;16.03.2018;2018;03;18;Perjantai;7;4;11
626;16.03.2018;2018;03;19;Perjantai;7;3;10
626;16.03.2018;2018;03;20;Perjantai;2;0;2
626;16.03.2018;2018;03;21;Perjantai;3;1;4
626;16.03.2018;2018;03;22;Perjantai;4;4;8
626;16.03.2018;2018;03;23;Perjantai;0;1;1
626;17.03.2018;2018;03;00;Lauantai;0;0;0
626;17.03.2018;2018;03;01;Lauantai;0;0;0
626;17.03.2018;2018;03;02;Lauantai;0;0;0
626;17.03.2018;2018;03;03;Lauantai;0;0;0
626;17.03.2018;2018;03;04;Lauantai;0;0;0
626;17.03.2018;2018;03;05;Lauantai;0;1;1
626;17.03.2018;2018;03;06;Lauantai;0;0;0
626;17.03.2018;2018;03;07;Lauantai;1;1;2
626;17.03.2018;2018;03;08;Lauantai;0;0;0
626;17.03.2018;2018;03;09;Lauantai;0;2;2
626;17.03.2018;2018;03;10;Lauantai;0;2;2
626;17.03.2018;2018;03;11;Lauantai;2;1;3
626;17.03.2018;2018;03;12;Lauantai;1;6;7
626;17.03.2018;2018;03;13;Lauantai;1;2;3
626;17.03.2018;2018;03;14;Lauantai;4;7;11
626;17.03.2018;2018;03;15;Lauantai;1;8;9
626;17.03.2018;2018;03;16;Lauantai;4;4;8
626;17.03.2018;2018;03;17;Lauantai;3;1;4
626;17.03.2018;2018;03;18;Lauantai;2;1;3
626;17.03.2018;2018;03;19;Lauantai;1;0;1
626;17.03.2018;2018;03;20;Lauantai;0;0;0
626;17.03.2018;2018;03;21;Lauantai;0;0;0
626;17.03.2018;2018;03;22;Lauantai;0;0;0
626;17.03.2018;2018;03;23;Lauantai;0;0;0
626;18.03.2018;2018;03;00;Sunnuntai;1;0;1
626;18.03.2018;2018;03;01;Sunnuntai;0;0;0
626;18.03.2018;2018;03;02;Sunnuntai;0;0;0
626;18.03.2018;2018;03;03;Sunnuntai;0;0;0
626;18.03.2018;2018;03;04;Sunnuntai;1;0;1
626;18.03.2018;2018;03;05;Sunnuntai;0;0;0
626;18.03.2018;2018;03;06;Sunnuntai;1;1;2
626;18.03.2018;2018;03;07;Sunnuntai;0;0;0
626;18.03.2018;2018;03;08;Sunnuntai;0;0;0
626;18.03.2018;2018;03;09;Sunnuntai;1;1;2
626;18.03.2018;2018;03;10;Sunnuntai;3;3;6
626;18.03.2018;2018;03;11;Sunnuntai;0;1;1
626;18.03.2018;2018;03;12;Sunnuntai;0;3;3
626;18.03.2018;2018;03;13;Sunnuntai;3;4;7
626;18.03.2018;2018;03;14;Sunnuntai;2;2;4
626;18.03.2018;2018;03;15;Sunnuntai;1;2;3
626;18.03.2018;2018;03;16;Sunnuntai;1;2;3
626;18.03.2018;2018;03;17;Sunnuntai;2;3;5
626;18.03.2018;2018;03;18;Sunnuntai;3;2;5
626;18.03.2018;2018;03;19;Sunnuntai;2;3;5
626;18.03.2018;2018;03;20;Sunnuntai;1;3;4
626;18.03.2018;2018;03;21;Sunnuntai;4;1;5
626;18.03.2018;2018;03;22;Sunnuntai;0;0;0
626;18.03.2018;2018;03;23;Sunnuntai;2;1;3
626;19.03.2018;2018;03;00;Maanantai;0;0;0
626;19.03.2018;2018;03;01;Maanantai;0;0;0
626;19.03.2018;2018;03;02;Maanantai;0;0;0
626;19.03.2018;2018;03;03;Maanantai;1;0;1
626;19.03.2018;2018;03;04;Maanantai;0;0;0
626;19.03.2018;2018;03;05;Maanantai;0;2;2
626;19.03.2018;2018;03;06;Maanantai;3;6;9
626;19.03.2018;2018;03;07;Maanantai;3;18;21
626;19.03.2018;2018;03;08;Maanantai;7;29;36
626;19.03.2018;2018;03;09;Maanantai;8;15;23
626;19.03.2018;2018;03;10;Maanantai;3;3;6
626;19.03.2018;2018;03;11;Maanantai;3;6;9
626;19.03.2018;2018;03;12;Maanantai;4;5;9
626;19.03.2018;2018;03;13;Maanantai;2;2;4
626;19.03.2018;2018;03;14;Maanantai;9;6;15
626;19.03.2018;2018;03;15;Maanantai;8;13;21
626;19.03.2018;2018;03;16;Maanantai;16;12;28
626;19.03.2018;2018;03;17;Maanantai;18;12;30
626;19.03.2018;2018;03;18;Maanantai;11;8;19
626;19.03.2018;2018;03;19;Maanantai;6;2;8
626;19.03.2018;2018;03;20;Maanantai;5;0;5
626;19.03.2018;2018;03;21;Maanantai;6;1;7
626;19.03.2018;2018;03;22;Maanantai;2;1;3
626;19.03.2018;2018;03;23;Maanantai;2;0;2
626;20.03.2018;2018;03;00;Tiistai;0;0;0
626;20.03.2018;2018;03;01;Tiistai;0;0;0
626;20.03.2018;2018;03;02;Tiistai;0;0;0
626;20.03.2018;2018;03;03;Tiistai;1;0;1
626;20.03.2018;2018;03;04;Tiistai;0;0;0
626;20.03.2018;2018;03;05;Tiistai;0;2;2
626;20.03.2018;2018;03;06;Tiistai;3;6;9
626;20.03.2018;2018;03;07;Tiistai;3;21;24
626;20.03.2018;2018;03;08;Tiistai;7;32;39
626;20.03.2018;2018;03;09;Tiistai;8;17;25
626;20.03.2018;2018;03;10;Tiistai;2;2;4
626;20.03.2018;2018;03;11;Tiistai;0;7;7
626;20.03.2018;2018;03;12;Tiistai;7;7;14
626;20.03.2018;2018;03;13;Tiistai;3;3;6
626;20.03.2018;2018;03;14;Tiistai;3;5;8
626;20.03.2018;2018;03;15;Tiistai;8;7;15
626;20.03.2018;2018;03;16;Tiistai;16;9;25
626;20.03.2018;2018;03;17;Tiistai;22;8;30
626;20.03.2018;2018;03;18;Tiistai;8;1;9
626;20.03.2018;2018;03;19;Tiistai;5;3;8
626;20.03.2018;2018;03;20;Tiistai;3;1;4
626;20.03.2018;2018;03;21;Tiistai;2;1;3
626;20.03.2018;2018;03;22;Tiistai;1;0;1
626;20.03.2018;2018;03;23;Tiistai;0;2;2
626;21.03.2018;2018;03;00;Keskiviikko;1;0;1
626;21.03.2018;2018;03;01;Keskiviikko;0;0;0
626;21.03.2018;2018;03;02;Keskiviikko;0;0;0
626;21.03.2018;2018;03;03;Keskiviikko;0;0;0
626;21.03.2018;2018;03;04;Keskiviikko;0;0;0
626;21.03.2018;2018;03;05;Keskiviikko;0;3;3
626;21.03.2018;2018;03;06;Keskiviikko;4;5;9
626;21.03.2018;2018;03;07;Keskiviikko;1;14;15
626;21.03.2018;2018;03;08;Keskiviikko;3;21;24
626;21.03.2018;2018;03;09;Keskiviikko;10;17;27
626;21.03.2018;2018;03;10;Keskiviikko;1;2;3
626;21.03.2018;2018;03;11;Keskiviikko;1;1;2
626;21.03.2018;2018;03;12;Keskiviikko;2;3;5
626;21.03.2018;2018;03;13;Keskiviikko;2;4;6
626;21.03.2018;2018;03;14;Keskiviikko;2;3;5
626;21.03.2018;2018;03;15;Keskiviikko;8;6;14
626;21.03.2018;2018;03;16;Keskiviikko;13;8;21
626;21.03.2018;2018;03;17;Keskiviikko;21;8;29
626;21.03.2018;2018;03;18;Keskiviikko;5;8;13
626;21.03.2018;2018;03;19;Keskiviikko;13;1;14
626;21.03.2018;2018;03;20;Keskiviikko;1;0;1
626;21.03.2018;2018;03;21;Keskiviikko;1;3;4
626;21.03.2018;2018;03;22;Keskiviikko;3;1;4
626;21.03.2018;2018;03;23;Keskiviikko;2;1;3
626;22.03.2018;2018;03;00;Torstai;0;0;0
626;22.03.2018;2018;03;01;Torstai;0;0;0
626;22.03.2018;2018;03;02;Torstai;0;0;0
626;22.03.2018;2018;03;03;Torstai;0;0;0
626;22.03.2018;2018;03;04;Torstai;0;1;1
626;22.03.2018;2018;03;05;Torstai;0;4;4
626;22.03.2018;2018;03;06;Torstai;4;6;10
626;22.03.2018;2018;03;07;Torstai;2;14;16
626;22.03.2018;2018;03;08;Torstai;3;21;24
626;22.03.2018;2018;03;09;Torstai;8;18;26
626;22.03.2018;2018;03;10;Torstai;2;5;7
626;22.03.2018;2018;03;11;Torstai;2;5;7
626;22.03.2018;2018;03;12;Torstai;2;3;5
626;22.03.2018;2018;03;13;Torstai;5;6;11
626;22.03.2018;2018;03;14;Torstai;7;6;13
626;22.03.2018;2018;03;15;Torstai;7;10;17
626;22.03.2018;2018;03;16;Torstai;16;9;25
626;22.03.2018;2018;03;17;Torstai;18;10;28
626;22.03.2018;2018;03;18;Torstai;14;1;15
626;22.03.2018;2018;03;19;Torstai;7;4;11
626;22.03.2018;2018;03;20;Torstai;2;0;2
626;22.03.2018;2018;03;21;Torstai;2;2;4
626;22.03.2018;2018;03;22;Torstai;1;1;2
626;22.03.2018;2018;03;23;Torstai;2;0;2
626;23.03.2018;2018;03;00;Perjantai;0;0;0
626;23.03.2018;2018;03;01;Perjantai;1;0;1
626;23.03.2018;2018;03;02;Perjantai;0;0;0
626;23.03.2018;2018;03;03;Perjantai;0;0;0
626;23.03.2018;2018;03;04;Perjantai;0;0;0
626;23.03.2018;2018;03;05;Perjantai;0;2;2
626;23.03.2018;2018;03;06;Perjantai;7;4;11
626;23.03.2018;2018;03;07;Perjantai;1;11;12
626;23.03.2018;2018;03;08;Perjantai;6;17;23
626;23.03.2018;2018;03;09;Perjantai;4;8;12
626;23.03.2018;2018;03;10;Perjantai;4;3;7
626;23.03.2018;2018;03;11;Perjantai;1;3;4
626;23.03.2018;2018;03;12;Perjantai;5;7;12
626;23.03.2018;2018;03;13;Perjantai;4;9;13
626;23.03.2018;2018;03;14;Perjantai;5;7;12
626;23.03.2018;2018;03;15;Perjantai;6;11;17
626;23.03.2018;2018;03;16;Perjantai;8;7;15
626;23.03.2018;2018;03;17;Perjantai;20;5;25
626;23.03.2018;2018;03;18;Perjantai;9;1;10
626;23.03.2018;2018;03;19;Perjantai;3;3;6
626;23.03.2018;2018;03;20;Perjantai;1;1;2
626;23.03.2018;2018;03;21;Perjantai;2;3;5
626;23.03.2018;2018;03;22;Perjantai;1;1;2
626;23.03.2018;2018;03;23;Perjantai;1;1;2
626;24.03.2018;2018;03;00;Lauantai;0;1;1
626;24.03.2018;2018;03;01;Lauantai;0;0;0
626;24.03.2018;2018;03;02;Lauantai;0;1;1
626;24.03.2018;2018;03;03;Lauantai;0;0;0
626;24.03.2018;2018;03;04;Lauantai;0;0;0
626;24.03.2018;2018;03;05;Lauantai;0;1;1
626;24.03.2018;2018;03;06;Lauantai;3;1;4
626;24.03.2018;2018;03;07;Lauantai;0;2;2
626;24.03.2018;2018;03;08;Lauantai;0;0;0
626;24.03.2018;2018;03;09;Lauantai;3;2;5
626;24.03.2018;2018;03;10;Lauantai;0;1;1
626;24.03.2018;2018;03;11;Lauantai;0;3;3
626;24.03.2018;2018;03;12;Lauantai;3;4;7
626;24.03.2018;2018;03;13;Lauantai;1;3;4
626;24.03.2018;2018;03;14;Lauantai;2;4;6
626;24.03.2018;2018;03;15;Lauantai;4;5;9
626;24.03.2018;2018;03;16;Lauantai;1;1;2
626;24.03.2018;2018;03;17;Lauantai;4;2;6
626;24.03.2018;2018;03;18;Lauantai;1;0;1
626;24.03.2018;2018;03;19;Lauantai;3;0;3
626;24.03.2018;2018;03;20;Lauantai;0;1;1
626;24.03.2018;2018;03;21;Lauantai;0;2;2
626;24.03.2018;2018;03;22;Lauantai;2;2;4
626;24.03.2018;2018;03;23;Lauantai;1;0;1
626;25.03.2018;2018;03;00;Sunnuntai;0;2;2
626;25.03.2018;2018;03;01;Sunnuntai;1;1;2
626;25.03.2018;2018;03;02;Sunnuntai;0;0;0
626;25.03.2018;2018;03;03;Sunnuntai;0;0;0
626;25.03.2018;2018;03;04;Sunnuntai;0;0;0
626;25.03.2018;2018;03;05;Sunnuntai;0;0;0
626;25.03.2018;2018;03;06;Sunnuntai;2;0;2
626;25.03.2018;2018;03;07;Sunnuntai;1;1;2
626;25.03.2018;2018;03;08;Sunnuntai;0;1;1
626;25.03.2018;2018;03;09;Sunnuntai;1;2;3
626;25.03.2018;2018;03;10;Sunnuntai;0;1;1
626;25.03.2018;2018;03;11;Sunnuntai;1;2;3
626;25.03.2018;2018;03;12;Sunnuntai;1;1;2
626;25.03.2018;2018;03;13;Sunnuntai;1;4;5
626;25.03.2018;2018;03;14;Sunnuntai;3;9;12
626;25.03.2018;2018;03;15;Sunnuntai;4;7;11
626;25.03.2018;2018;03;16;Sunnuntai;5;3;8
626;25.03.2018;2018;03;17;Sunnuntai;3;5;8
626;25.03.2018;2018;03;18;Sunnuntai;4;3;7
626;25.03.2018;2018;03;19;Sunnuntai;10;4;14
626;25.03.2018;2018;03;20;Sunnuntai;0;1;1
626;25.03.2018;2018;03;21;Sunnuntai;0;1;1
626;25.03.2018;2018;03;22;Sunnuntai;2;0;2
626;25.03.2018;2018;03;23;Sunnuntai;1;0;1
626;26.03.2018;2018;03;00;Maanantai;0;0;0
626;26.03.2018;2018;03;01;Maanantai;0;0;0
626;26.03.2018;2018;03;02;Maanantai;0;0;0
626;26.03.2018;2018;03;03;Maanantai;0;0;0
626;26.03.2018;2018;03;04;Maanantai;0;0;0
626;26.03.2018;2018;03;05;Maanantai;1;3;4
626;26.03.2018;2018;03;06;Maanantai;1;3;4
626;26.03.2018;2018;03;07;Maanantai;2;12;14
626;26.03.2018;2018;03;08;Maanantai;3;19;22
626;26.03.2018;2018;03;09;Maanantai;5;17;22
626;26.03.2018;2018;03;10;Maanantai;0;4;4
626;26.03.2018;2018;03;11;Maanantai;1;8;9
626;26.03.2018;2018;03;12;Maanantai;4;2;6
626;26.03.2018;2018;03;13;Maanantai;3;4;7
626;26.03.2018;2018;03;14;Maanantai;3;6;9
626;26.03.2018;2018;03;15;Maanantai;9;5;14
626;26.03.2018;2018;03;16;Maanantai;10;5;15
626;26.03.2018;2018;03;17;Maanantai;13;11;24
626;26.03.2018;2018;03;18;Maanantai;9;4;13
626;26.03.2018;2018;03;19;Maanantai;11;5;16
626;26.03.2018;2018;03;20;Maanantai;4;3;7
626;26.03.2018;2018;03;21;Maanantai;3;1;4
626;26.03.2018;2018;03;22;Maanantai;1;2;3
626;26.03.2018;2018;03;23;Maanantai;0;2;2
626;27.03.2018;2018;03;00;Tiistai;0;0;0
626;27.03.2018;2018;03;01;Tiistai;0;0;0
626;27.03.2018;2018;03;02;Tiistai;0;0;0
626;27.03.2018;2018;03;03;Tiistai;0;1;1
626;27.03.2018;2018;03;04;Tiistai;0;0;0
626;27.03.2018;2018;03;05;Tiistai;0;3;3
626;27.03.2018;2018;03;06;Tiistai;3;5;8
626;27.03.2018;2018;03;07;Tiistai;2;8;10
626;27.03.2018;2018;03;08;Tiistai;3;19;22
626;27.03.2018;2018;03;09;Tiistai;8;12;20
626;27.03.2018;2018;03;10;Tiistai;0;5;5
626;27.03.2018;2018;03;11;Tiistai;0;2;2
626;27.03.2018;2018;03;12;Tiistai;2;1;3
626;27.03.2018;2018;03;13;Tiistai;3;2;5
626;27.03.2018;2018;03;14;Tiistai;30;32;62
626;27.03.2018;2018;03;15;Tiistai;2;10;12
626;27.03.2018;2018;03;16;Tiistai;14;6;20
626;27.03.2018;2018;03;17;Tiistai;29;14;43
626;27.03.2018;2018;03;18;Tiistai;8;4;12
626;27.03.2018;2018;03;19;Tiistai;9;1;10
626;27.03.2018;2018;03;20;Tiistai;4;0;4
626;27.03.2018;2018;03;21;Tiistai;0;1;1
626;27.03.2018;2018;03;22;Tiistai;0;0;0
626;27.03.2018;2018;03;23;Tiistai;0;1;1
626;28.03.2018;2018;03;00;Keskiviikko;0;0;0
626;28.03.2018;2018;03;01;Keskiviikko;0;1;1
626;28.03.2018;2018;03;02;Keskiviikko;0;0;0
626;28.03.2018;2018;03;03;Keskiviikko;0;0;0
626;28.03.2018;2018;03;04;Keskiviikko;0;0;0
626;28.03.2018;2018;03;05;Keskiviikko;1;3;4
626;28.03.2018;2018;03;06;Keskiviikko;1;3;4
626;28.03.2018;2018;03;07;Keskiviikko;3;11;14
626;28.03.2018;2018;03;08;Keskiviikko;5;18;23
626;28.03.2018;2018;03;09;Keskiviikko;7;16;23
626;28.03.2018;2018;03;10;Keskiviikko;3;2;5
626;28.03.2018;2018;03;11;Keskiviikko;8;6;14
626;28.03.2018;2018;03;12;Keskiviikko;0;2;2
626;28.03.2018;2018;03;13;Keskiviikko;7;4;11
626;28.03.2018;2018;03;14;Keskiviikko;9;5;14
626;28.03.2018;2018;03;15;Keskiviikko;5;10;15
626;28.03.2018;2018;03;16;Keskiviikko;11;8;19
626;28.03.2018;2018;03;17;Keskiviikko;14;8;22
626;28.03.2018;2018;03;18;Keskiviikko;12;9;21
626;28.03.2018;2018;03;19;Keskiviikko;3;8;11
626;28.03.2018;2018;03;20;Keskiviikko;0;1;1
626;28.03.2018;2018;03;21;Keskiviikko;2;3;5
626;28.03.2018;2018;03;22;Keskiviikko;1;1;2
626;28.03.2018;2018;03;23;Keskiviikko;0;1;1
626;29.03.2018;2018;03;00;Torstai;0;0;0
626;29.03.2018;2018;03;01;Torstai;0;0;0
626;29.03.2018;2018;03;02;Torstai;1;0;1
626;29.03.2018;2018;03;03;Torstai;1;0;1
626;29.03.2018;2018;03;04;Torstai;0;1;1
626;29.03.2018;2018;03;05;Torstai;0;4;4
626;29.03.2018;2018;03;06;Torstai;2;7;9
626;29.03.2018;2018;03;07;Torstai;3;8;11
626;29.03.2018;2018;03;08;Torstai;3;24;27
626;29.03.2018;2018;03;09;Torstai;5;12;17
626;29.03.2018;2018;03;10;Torstai;4;4;8
626;29.03.2018;2018;03;11;Torstai;0;4;4
626;29.03.2018;2018;03;12;Torstai;1;5;6
626;29.03.2018;2018;03;13;Torstai;5;8;13
626;29.03.2018;2018;03;14;Torstai;8;8;16
626;29.03.2018;2018;03;15;Torstai;10;9;19
626;29.03.2018;2018;03;16;Torstai;14;6;20
626;29.03.2018;2018;03;17;Torstai;17;7;24
626;29.03.2018;2018;03;18;Torstai;5;2;7
626;29.03.2018;2018;03;19;Torstai;3;2;5
626;29.03.2018;2018;03;20;Torstai;2;6;8
626;29.03.2018;2018;03;21;Torstai;2;1;3
626;29.03.2018;2018;03;22;Torstai;1;6;7
626;29.03.2018;2018;03;23;Torstai;2;0;2
626;30.03.2018;2018;03;00;Perjantai;2;1;3
626;30.03.2018;2018;03;01;Perjantai;0;0;0
626;30.03.2018;2018;03;02;Perjantai;0;0;0
626;30.03.2018;2018;03;03;Perjantai;0;0;0
626;30.03.2018;2018;03;04;Perjantai;0;0;0
626;30.03.2018;2018;03;05;Perjantai;0;0;0
626;30.03.2018;2018;03;06;Perjantai;0;1;1
626;30.03.2018;2018;03;07;Perjantai;0;1;1
626;30.03.2018;2018;03;08;Perjantai;0;2;2
626;30.03.2018;2018;03;09;Perjantai;1;0;1
626;30.03.2018;2018;03;10;Perjantai;1;0;1
626;30.03.2018;2018;03;11;Perjantai;1;3;4
626;30.03.2018;2018;03;12;Perjantai;0;4;4
626;30.03.2018;2018;03;13;Perjantai;3;9;12
626;30.03.2018;2018;03;14;Perjantai;3;3;6
626;30.03.2018;2018;03;15;Perjantai;10;7;17
626;30.03.2018;2018;03;16;Perjantai;3;4;7
626;30.03.2018;2018;03;17;Perjantai;5;2;7
626;30.03.2018;2018;03;18;Perjantai;2;8;10
626;30.03.2018;2018;03;19;Perjantai;1;3;4
626;30.03.2018;2018;03;20;Perjantai;3;5;8
626;30.03.2018;2018;03;21;Perjantai;2;0;2
626;30.03.2018;2018;03;22;Perjantai;1;0;1
626;30.03.2018;2018;03;23;Perjantai;1;0;1
626;31.03.2018;2018;03;00;Lauantai;0;0;0
626;31.03.2018;2018;03;01;Lauantai;0;0;0
626;31.03.2018;2018;03;02;Lauantai;0;0;0
626;31.03.2018;2018;03;03;Lauantai;0;0;0
626;31.03.2018;2018;03;04;Lauantai;0;2;2
626;31.03.2018;2018;03;05;Lauantai;0;0;0
626;31.03.2018;2018;03;06;Lauantai;0;2;2
626;31.03.2018;2018;03;07;Lauantai;1;0;1
626;31.03.2018;2018;03;08;Lauantai;0;2;2
626;31.03.2018;2018;03;09;Lauantai;1;1;2
626;31.03.2018;2018;03;10;Lauantai;3;3;6
626;31.03.2018;2018;03;11;Lauantai;1;4;5
626;31.03.2018;2018;03;12;Lauantai;0;7;7
626;31.03.2018;2018;03;13;Lauantai;5;6;11
626;31.03.2018;2018;03;14;Lauantai;4;10;14
626;31.03.2018;2018;03;15;Lauantai;9;2;11
626;31.03.2018;2018;03;16;Lauantai;1;5;6
626;31.03.2018;2018;03;17;Lauantai;5;4;9
626;31.03.2018;2018;03;18;Lauantai;2;4;6
626;31.03.2018;2018;03;19;Lauantai;2;1;3
626;31.03.2018;2018;03;20;Lauantai;3;1;4
626;31.03.2018;2018;03;21;Lauantai;3;3;6
626;31.03.2018;2018;03;22;Lauantai;5;0;5
626;31.03.2018;2018;03;23;Lauantai;2;0;2
626;01.04.2018;2018;04;00;Sunnuntai;0;0;0
626;01.04.2018;2018;04;01;Sunnuntai;0;0;0
626;01.04.2018;2018;04;02;Sunnuntai;0;1;1
626;01.04.2018;2018;04;03;Sunnuntai;0;0;0
626;01.04.2018;2018;04;04;Sunnuntai;1;0;1
626;01.04.2018;2018;04;05;Sunnuntai;0;0;0
626;01.04.2018;2018;04;06;Sunnuntai;1;2;3
626;01.04.2018;2018;04;07;Sunnuntai;0;1;1
626;01.04.2018;2018;04;08;Sunnuntai;0;1;1
626;01.04.2018;2018;04;09;Sunnuntai;2;0;2
626;01.04.2018;2018;04;10;Sunnuntai;3;2;5
626;01.04.2018;2018;04;11;Sunnuntai;1;2;3
626;01.04.2018;2018;04;12;Sunnuntai;2;5;7
626;01.04.2018;2018;04;13;Sunnuntai;3;3;6
626;01.04.2018;2018;04;14;Sunnuntai;4;11;15
626;01.04.2018;2018;04;15;Sunnuntai;5;6;11
626;01.04.2018;2018;04;16;Sunnuntai;6;7;13
626;01.04.2018;2018;04;17;Sunnuntai;1;5;6
626;01.04.2018;2018;04;18;Sunnuntai;1;5;6
626;01.04.2018;2018;04;19;Sunnuntai;6;1;7
626;01.04.2018;2018;04;20;Sunnuntai;2;2;4
626;01.04.2018;2018;04;21;Sunnuntai;2;0;2
626;01.04.2018;2018;04;22;Sunnuntai;1;0;1
626;01.04.2018;2018;04;23;Sunnuntai;2;0;2
626;02.04.2018;2018;04;00;Maanantai;0;0;0
626;02.04.2018;2018;04;01;Maanantai;0;0;0
626;02.04.2018;2018;04;02;Maanantai;0;0;0
626;02.04.2018;2018;04;03;Maanantai;0;0;0
626;02.04.2018;2018;04;04;Maanantai;0;0;0
626;02.04.2018;2018;04;05;Maanantai;0;0;0
626;02.04.2018;2018;04;06;Maanantai;0;1;1
626;02.04.2018;2018;04;07;Maanantai;0;0;0
626;02.04.2018;2018;04;08;Maanantai;1;1;2
626;02.04.2018;2018;04;09;Maanantai;1;1;2
626;02.04.2018;2018;04;10;Maanantai;3;2;5
626;02.04.2018;2018;04;11;Maanantai;1;2;3
626;02.04.2018;2018;04;12;Maanantai;1;6;7
626;02.04.2018;2018;04;13;Maanantai;3;5;8
626;02.04.2018;2018;04;14;Maanantai;3;6;9
626;02.04.2018;2018;04;15;Maanantai;3;7;10
626;02.04.2018;2018;04;16;Maanantai;3;7;10
626;02.04.2018;2018;04;17;Maanantai;4;3;7
626;02.04.2018;2018;04;18;Maanantai;2;6;8
626;02.04.2018;2018;04;19;Maanantai;2;4;6
626;02.04.2018;2018;04;20;Maanantai;2;2;4
626;02.04.2018;2018;04;21;Maanantai;2;1;3
626;02.04.2018;2018;04;22;Maanantai;1;2;3
626;02.04.2018;2018;04;23;Maanantai;1;0;1
626;03.04.2018;2018;04;00;Tiistai;0;0;0
626;03.04.2018;2018;04;01;Tiistai;0;0;0
626;03.04.2018;2018;04;02;Tiistai;0;0;0
626;03.04.2018;2018;04;03;Tiistai;0;2;2
626;03.04.2018;2018;04;04;Tiistai;0;1;1
626;03.04.2018;2018;04;05;Tiistai;0;3;3
626;03.04.2018;2018;04;06;Tiistai;3;7;10
626;03.04.2018;2018;04;07;Tiistai;3;6;9
626;03.04.2018;2018;04;08;Tiistai;4;20;24
626;03.04.2018;2018;04;09;Tiistai;7;13;20
626;03.04.2018;2018;04;10;Tiistai;1;6;7
626;03.04.2018;2018;04;11;Tiistai;0;5;5
626;03.04.2018;2018;04;12;Tiistai;1;5;6
626;03.04.2018;2018;04;13;Tiistai;4;2;6
626;03.04.2018;2018;04;14;Tiistai;4;3;7
626;03.04.2018;2018;04;15;Tiistai;6;6;12
626;03.04.2018;2018;04;16;Tiistai;8;4;12
626;03.04.2018;2018;04;17;Tiistai;15;7;22
626;03.04.2018;2018;04;18;Tiistai;8;7;15
626;03.04.2018;2018;04;19;Tiistai;7;2;9
626;03.04.2018;2018;04;20;Tiistai;6;3;9
626;03.04.2018;2018;04;21;Tiistai;3;1;4
626;03.04.2018;2018;04;22;Tiistai;3;3;6
626;03.04.2018;2018;04;23;Tiistai;0;0;0
626;04.04.2018;2018;04;00;Keskiviikko;0;0;0
626;04.04.2018;2018;04;01;Keskiviikko;0;0;0
626;04.04.2018;2018;04;02;Keskiviikko;0;0;0
626;04.04.2018;2018;04;03;Keskiviikko;0;0;0
626;04.04.2018;2018;04;04;Keskiviikko;0;0;0
626;04.04.2018;2018;04;05;Keskiviikko;0;1;1
626;04.04.2018;2018;04;06;Keskiviikko;3;4;7
626;04.04.2018;2018;04;07;Keskiviikko;3;16;19
626;04.04.2018;2018;04;08;Keskiviikko;8;16;24
626;04.04.2018;2018;04;09;Keskiviikko;2;16;18
626;04.04.2018;2018;04;10;Keskiviikko;2;4;6
626;04.04.2018;2018;04;11;Keskiviikko;4;3;7
626;04.04.2018;2018;04;12;Keskiviikko;2;6;8
626;04.04.2018;2018;04;13;Keskiviikko;1;2;3
626;04.04.2018;2018;04;14;Keskiviikko;5;7;12
626;04.04.2018;2018;04;15;Keskiviikko;7;15;22
626;04.04.2018;2018;04;16;Keskiviikko;14;10;24
626;04.04.2018;2018;04;17;Keskiviikko;20;14;34
626;04.04.2018;2018;04;18;Keskiviikko;11;6;17
626;04.04.2018;2018;04;19;Keskiviikko;7;2;9
626;04.04.2018;2018;04;20;Keskiviikko;3;5;8
626;04.04.2018;2018;04;21;Keskiviikko;10;2;12
626;04.04.2018;2018;04;22;Keskiviikko;3;1;4
626;04.04.2018;2018;04;23;Keskiviikko;2;0;2
626;05.04.2018;2018;04;00;Torstai;1;0;1
626;05.04.2018;2018;04;01;Torstai;1;0;1
626;05.04.2018;2018;04;02;Torstai;0;0;0
626;05.04.2018;2018;04;03;Torstai;0;0;0
626;05.04.2018;2018;04;04;Torstai;1;2;3
626;05.04.2018;2018;04;05;Torstai;0;2;2
626;05.04.2018;2018;04;06;Torstai;4;6;10
626;05.04.2018;2018;04;07;Torstai;2;10;12
626;05.04.2018;2018;04;08;Torstai;4;15;19
626;05.04.2018;2018;04;09;Torstai;4;17;21
626;05.04.2018;2018;04;10;Torstai;1;3;4
626;05.04.2018;2018;04;11;Torstai;3;6;9
626;05.04.2018;2018;04;12;Torstai;3;4;7
626;05.04.2018;2018;04;13;Torstai;3;0;3
626;05.04.2018;2018;04;14;Torstai;3;5;8
626;05.04.2018;2018;04;15;Torstai;6;11;17
626;05.04.2018;2018;04;16;Torstai;12;11;23
626;05.04.2018;2018;04;17;Torstai;21;5;26
626;05.04.2018;2018;04;18;Torstai;13;4;17
626;05.04.2018;2018;04;19;Torstai;8;2;10
626;05.04.2018;2018;04;20;Torstai;6;4;10
626;05.04.2018;2018;04;21;Torstai;6;6;12
626;05.04.2018;2018;04;22;Torstai;4;2;6
626;05.04.2018;2018;04;23;Torstai;2;0;2
626;06.04.2018;2018;04;00;Perjantai;1;0;1
626;06.04.2018;2018;04;01;Perjantai;0;1;1
626;06.04.2018;2018;04;02;Perjantai;0;0;0
626;06.04.2018;2018;04;03;Perjantai;0;0;0
626;06.04.2018;2018;04;04;Perjantai;0;0;0
626;06.04.2018;2018;04;05;Perjantai;0;0;0
626;06.04.2018;2018;04;06;Perjantai;4;4;8
626;06.04.2018;2018;04;07;Perjantai;1;9;10
626;06.04.2018;2018;04;08;Perjantai;6;12;18
626;06.04.2018;2018;04;09;Perjantai;5;11;16
626;06.04.2018;2018;04;10;Perjantai;4;3;7
626;06.04.2018;2018;04;11;Perjantai;0;6;6
626;06.04.2018;2018;04;12;Perjantai;1;5;6
626;06.04.2018;2018;04;13;Perjantai;6;1;7
626;06.04.2018;2018;04;14;Perjantai;3;4;7
626;06.04.2018;2018;04;15;Perjantai;5;6;11
626;06.04.2018;2018;04;16;Perjantai;6;6;12
626;06.04.2018;2018;04;17;Perjantai;12;7;19
626;06.04.2018;2018;04;18;Perjantai;6;5;11
626;06.04.2018;2018;04;19;Perjantai;6;2;8
626;06.04.2018;2018;04;20;Perjantai;2;3;5
626;06.04.2018;2018;04;21;Perjantai;2;2;4
626;06.04.2018;2018;04;22;Perjantai;2;4;6
626;06.04.2018;2018;04;23;Perjantai;2;1;3
626;07.04.2018;2018;04;00;Lauantai;1;0;1
626;07.04.2018;2018;04;01;Lauantai;2;0;2
626;07.04.2018;2018;04;02;Lauantai;1;0;1
626;07.04.2018;2018;04;03;Lauantai;0;0;0
626;07.04.2018;2018;04;04;Lauantai;0;0;0
626;07.04.2018;2018;04;05;Lauantai;0;0;0
626;07.04.2018;2018;04;06;Lauantai;0;0;0
626;07.04.2018;2018;04;07;Lauantai;0;1;1
626;07.04.2018;2018;04;08;Lauantai;0;0;0
626;07.04.2018;2018;04;09;Lauantai;2;4;6
626;07.04.2018;2018;04;10;Lauantai;2;6;8
626;07.04.2018;2018;04;11;Lauantai;0;3;3
626;07.04.2018;2018;04;12;Lauantai;8;7;15
626;07.04.2018;2018;04;13;Lauantai;7;9;16
626;07.04.2018;2018;04;14;Lauantai;7;10;17
626;07.04.2018;2018;04;15;Lauantai;15;10;25
626;07.04.2018;2018;04;16;Lauantai;3;5;8
626;07.04.2018;2018;04;17;Lauantai;5;2;7
626;07.04.2018;2018;04;18;Lauantai;2;4;6
626;07.04.2018;2018;04;19;Lauantai;2;4;6
626;07.04.2018;2018;04;20;Lauantai;3;3;6
626;07.04.2018;2018;04;21;Lauantai;3;3;6
626;07.04.2018;2018;04;22;Lauantai;2;1;3
626;07.04.2018;2018;04;23;Lauantai;1;0;1
626;08.04.2018;2018;04;00;Sunnuntai;1;0;1
626;08.04.2018;2018;04;01;Sunnuntai;0;0;0
626;08.04.2018;2018;04;02;Sunnuntai;0;0;0
626;08.04.2018;2018;04;03;Sunnuntai;1;1;2
626;08.04.2018;2018;04;04;Sunnuntai;0;0;0
626;08.04.2018;2018;04;05;Sunnuntai;0;0;0
626;08.04.2018;2018;04;06;Sunnuntai;0;2;2
626;08.04.2018;2018;04;07;Sunnuntai;0;0;0
626;08.04.2018;2018;04;08;Sunnuntai;0;0;0
626;08.04.2018;2018;04;09;Sunnuntai;0;1;1
626;08.04.2018;2018;04;10;Sunnuntai;3;4;7
626;08.04.2018;2018;04;11;Sunnuntai;0;2;2
626;08.04.2018;2018;04;12;Sunnuntai;3;7;10
626;08.04.2018;2018;04;13;Sunnuntai;2;5;7
626;08.04.2018;2018;04;14;Sunnuntai;3;5;8
626;08.04.2018;2018;04;15;Sunnuntai;4;3;7
626;08.04.2018;2018;04;16;Sunnuntai;7;2;9
626;08.04.2018;2018;04;17;Sunnuntai;0;3;3
626;08.04.2018;2018;04;18;Sunnuntai;2;5;7
626;08.04.2018;2018;04;19;Sunnuntai;6;6;12
626;08.04.2018;2018;04;20;Sunnuntai;4;1;5
626;08.04.2018;2018;04;21;Sunnuntai;4;1;5
626;08.04.2018;2018;04;22;Sunnuntai;1;0;1
626;08.04.2018;2018;04;23;Sunnuntai;1;0;1
626;09.04.2018;2018;04;00;Maanantai;0;0;0
626;09.04.2018;2018;04;01;Maanantai;0;0;0
626;09.04.2018;2018;04;02;Maanantai;0;0;0
626;09.04.2018;2018;04;03;Maanantai;1;0;1
626;09.04.2018;2018;04;04;Maanantai;0;1;1
626;09.04.2018;2018;04;05;Maanantai;0;0;0
626;09.04.2018;2018;04;06;Maanantai;4;10;14
626;09.04.2018;2018;04;07;Maanantai;2;18;20
626;09.04.2018;2018;04;08;Maanantai;5;18;23
626;09.04.2018;2018;04;09;Maanantai;8;25;33
626;09.04.2018;2018;04;10;Maanantai;2;6;8
626;09.04.2018;2018;04;11;Maanantai;2;3;5
626;09.04.2018;2018;04;12;Maanantai;1;3;4
626;09.04.2018;2018;04;13;Maanantai;7;4;11
626;09.04.2018;2018;04;14;Maanantai;8;5;13
626;09.04.2018;2018;04;15;Maanantai;12;8;20
626;09.04.2018;2018;04;16;Maanantai;17;9;26
626;09.04.2018;2018;04;17;Maanantai;20;12;32
626;09.04.2018;2018;04;18;Maanantai;10;8;18
626;09.04.2018;2018;04;19;Maanantai;5;3;8
626;09.04.2018;2018;04;20;Maanantai;3;3;6
626;09.04.2018;2018;04;21;Maanantai;5;0;5
626;09.04.2018;2018;04;22;Maanantai;4;3;7
626;09.04.2018;2018;04;23;Maanantai;2;2;4
626;10.04.2018;2018;04;00;Tiistai;0;1;1
626;10.04.2018;2018;04;01;Tiistai;0;0;0
626;10.04.2018;2018;04;02;Tiistai;0;0;0
626;10.04.2018;2018;04;03;Tiistai;0;0;0
626;10.04.2018;2018;04;04;Tiistai;0;0;0
626;10.04.2018;2018;04;05;Tiistai;0;1;1
626;10.04.2018;2018;04;06;Tiistai;4;10;14
626;10.04.2018;2018;04;07;Tiistai;3;21;24
626;10.04.2018;2018;04;08;Tiistai;5;24;29
626;10.04.2018;2018;04;09;Tiistai;6;31;37
626;10.04.2018;2018;04;10;Tiistai;4;6;10
626;10.04.2018;2018;04;11;Tiistai;7;8;15
626;10.04.2018;2018;04;12;Tiistai;2;3;5
626;10.04.2018;2018;04;13;Tiistai;5;9;14
626;10.04.2018;2018;04;14;Tiistai;4;10;14
626;10.04.2018;2018;04;15;Tiistai;7;10;17
626;10.04.2018;2018;04;16;Tiistai;11;8;19
626;10.04.2018;2018;04;17;Tiistai;13;12;25
626;10.04.2018;2018;04;18;Tiistai;13;7;20
626;10.04.2018;2018;04;19;Tiistai;8;3;11
626;10.04.2018;2018;04;20;Tiistai;2;3;5
626;10.04.2018;2018;04;21;Tiistai;3;1;4
626;10.04.2018;2018;04;22;Tiistai;5;2;7
626;10.04.2018;2018;04;23;Tiistai;1;4;5
626;11.04.2018;2018;04;00;Keskiviikko;0;0;0
626;11.04.2018;2018;04;01;Keskiviikko;0;0;0
626;11.04.2018;2018;04;02;Keskiviikko;1;2;3
626;11.04.2018;2018;04;03;Keskiviikko;0;0;0
626;11.04.2018;2018;04;04;Keskiviikko;1;0;1
626;11.04.2018;2018;04;05;Keskiviikko;1;0;1
626;11.04.2018;2018;04;06;Keskiviikko;3;6;9
626;11.04.2018;2018;04;07;Keskiviikko;2;17;19
626;11.04.2018;2018;04;08;Keskiviikko;8;31;39
626;11.04.2018;2018;04;09;Keskiviikko;5;21;26
626;11.04.2018;2018;04;10;Keskiviikko;2;8;10
626;11.04.2018;2018;04;11;Keskiviikko;4;5;9
626;11.04.2018;2018;04;12;Keskiviikko;2;4;6
626;11.04.2018;2018;04;13;Keskiviikko;5;12;17
626;11.04.2018;2018;04;14;Keskiviikko;5;9;14
626;11.04.2018;2018;04;15;Keskiviikko;6;10;16
626;11.04.2018;2018;04;16;Keskiviikko;17;10;27
626;11.04.2018;2018;04;17;Keskiviikko;20;12;32
626;11.04.2018;2018;04;18;Keskiviikko;14;7;21
626;11.04.2018;2018;04;19;Keskiviikko;11;3;14
626;11.04.2018;2018;04;20;Keskiviikko;7;3;10
626;11.04.2018;2018;04;21;Keskiviikko;9;3;12
626;11.04.2018;2018;04;22;Keskiviikko;8;2;10
626;11.04.2018;2018;04;23;Keskiviikko;0;1;1
626;12.04.2018;2018;04;00;Torstai;0;1;1
626;12.04.2018;2018;04;01;Torstai;0;1;1
626;12.04.2018;2018;04;02;Torstai;0;0;0
626;12.04.2018;2018;04;03;Torstai;0;0;0
626;12.04.2018;2018;04;04;Torstai;0;0;0
626;12.04.2018;2018;04;05;Torstai;0;2;2
626;12.04.2018;2018;04;06;Torstai;4;8;12
626;12.04.2018;2018;04;07;Torstai;1;21;22
626;12.04.2018;2018;04;08;Torstai;9;32;41
626;12.04.2018;2018;04;09;Torstai;10;20;30
626;12.04.2018;2018;04;10;Torstai;0;7;7
626;12.04.2018;2018;04;11;Torstai;3;11;14
626;12.04.2018;2018;04;12;Torstai;11;4;15
626;12.04.2018;2018;04;13;Torstai;4;7;11
626;12.04.2018;2018;04;14;Torstai;4;10;14
626;12.04.2018;2018;04;15;Torstai;9;11;20
626;12.04.2018;2018;04;16;Torstai;24;10;34
626;12.04.2018;2018;04;17;Torstai;26;13;39
626;12.04.2018;2018;04;18;Torstai;10;7;17
626;12.04.2018;2018;04;19;Torstai;10;3;13
626;12.04.2018;2018;04;20;Torstai;5;3;8
626;12.04.2018;2018;04;21;Torstai;8;3;11
626;12.04.2018;2018;04;22;Torstai;5;0;5
626;12.04.2018;2018;04;23;Torstai;1;3;4
626;13.04.2018;2018;04;00;Perjantai;0;2;2
626;13.04.2018;2018;04;01;Perjantai;0;0;0
626;13.04.2018;2018;04;02;Perjantai;0;0;0
626;13.04.2018;2018;04;03;Perjantai;0;0;0
626;13.04.2018;2018;04;04;Perjantai;1;0;1
626;13.04.2018;2018;04;05;Perjantai;0;2;2
626;13.04.2018;2018;04;06;Perjantai;5;6;11
626;13.04.2018;2018;04;07;Perjantai;4;23;27
626;13.04.2018;2018;04;08;Perjantai;7;31;38
626;13.04.2018;2018;04;09;Perjantai;11;19;30
626;13.04.2018;2018;04;10;Perjantai;3;7;10
626;13.04.2018;2018;04;11;Perjantai;4;7;11
626;13.04.2018;2018;04;12;Perjantai;3;2;5
626;13.04.2018;2018;04;13;Perjantai;7;14;21
626;13.04.2018;2018;04;14;Perjantai;9;15;24
626;13.04.2018;2018;04;15;Perjantai;7;13;20
626;13.04.2018;2018;04;16;Perjantai;20;10;30
626;13.04.2018;2018;04;17;Perjantai;23;11;34
626;13.04.2018;2018;04;18;Perjantai;12;5;17
626;13.04.2018;2018;04;19;Perjantai;11;3;14
626;13.04.2018;2018;04;20;Perjantai;6;10;16
626;13.04.2018;2018;04;21;Perjantai;6;3;9
626;13.04.2018;2018;04;22;Perjantai;4;1;5
626;13.04.2018;2018;04;23;Perjantai;3;0;3
626;14.04.2018;2018;04;00;Lauantai;0;0;0
626;14.04.2018;2018;04;01;Lauantai;0;0;0
626;14.04.2018;2018;04;02;Lauantai;1;1;2
626;14.04.2018;2018;04;03;Lauantai;0;0;0
626;14.04.2018;2018;04;04;Lauantai;0;0;0
626;14.04.2018;2018;04;05;Lauantai;1;0;1
626;14.04.2018;2018;04;06;Lauantai;1;1;2
626;14.04.2018;2018;04;07;Lauantai;1;0;1
626;14.04.2018;2018;04;08;Lauantai;0;2;2
626;14.04.2018;2018;04;09;Lauantai;2;4;6
626;14.04.2018;2018;04;10;Lauantai;5;9;14
626;14.04.2018;2018;04;11;Lauantai;5;13;18
626;14.04.2018;2018;04;12;Lauantai;6;5;11
626;14.04.2018;2018;04;13;Lauantai;9;9;18
626;14.04.2018;2018;04;14;Lauantai;21;25;46
626;14.04.2018;2018;04;15;Lauantai;13;9;22
626;14.04.2018;2018;04;16;Lauantai;13;17;30
626;14.04.2018;2018;04;17;Lauantai;9;9;18
626;14.04.2018;2018;04;18;Lauantai;11;10;21
626;14.04.2018;2018;04;19;Lauantai;9;11;20
626;14.04.2018;2018;04;20;Lauantai;4;6;10
626;14.04.2018;2018;04;21;Lauantai;8;5;13
626;14.04.2018;2018;04;22;Lauantai;6;5;11
626;14.04.2018;2018;04;23;Lauantai;3;1;4
626;15.04.2018;2018;04;00;Sunnuntai;1;1;2
626;15.04.2018;2018;04;01;Sunnuntai;0;0;0
626;15.04.2018;2018;04;02;Sunnuntai;1;0;1
626;15.04.2018;2018;04;03;Sunnuntai;0;0;0
626;15.04.2018;2018;04;04;Sunnuntai;0;0;0
626;15.04.2018;2018;04;05;Sunnuntai;1;0;1
626;15.04.2018;2018;04;06;Sunnuntai;1;0;1
626;15.04.2018;2018;04;07;Sunnuntai;0;4;4
626;15.04.2018;2018;04;08;Sunnuntai;3;3;6
626;15.04.2018;2018;04;09;Sunnuntai;4;5;9
626;15.04.2018;2018;04;10;Sunnuntai;1;5;6
626;15.04.2018;2018;04;11;Sunnuntai;10;14;24
626;15.04.2018;2018;04;12;Sunnuntai;6;17;23
626;15.04.2018;2018;04;13;Sunnuntai;29;14;43
626;15.04.2018;2018;04;14;Sunnuntai;20;19;39
626;15.04.2018;2018;04;15;Sunnuntai;19;31;50
626;15.04.2018;2018;04;16;Sunnuntai;21;23;44
626;15.04.2018;2018;04;17;Sunnuntai;12;22;34
626;15.04.2018;2018;04;18;Sunnuntai;21;19;40
626;15.04.2018;2018;04;19;Sunnuntai;16;15;31
626;15.04.2018;2018;04;20;Sunnuntai;6;6;12
626;15.04.2018;2018;04;21;Sunnuntai;5;1;6
626;15.04.2018;2018;04;22;Sunnuntai;2;3;5
626;15.04.2018;2018;04;23;Sunnuntai;2;0;2
626;16.04.2018;2018;04;00;Maanantai;1;1;2
626;16.04.2018;2018;04;01;Maanantai;0;0;0
626;16.04.2018;2018;04;02;Maanantai;0;0;0
626;16.04.2018;2018;04;03;Maanantai;0;0;0
626;16.04.2018;2018;04;04;Maanantai;0;1;1
626;16.04.2018;2018;04;05;Maanantai;1;1;2
626;16.04.2018;2018;04;06;Maanantai;5;9;14
626;16.04.2018;2018;04;07;Maanantai;5;25;30
626;16.04.2018;2018;04;08;Maanantai;13;54;67
626;16.04.2018;2018;04;09;Maanantai;9;22;31
626;16.04.2018;2018;04;10;Maanantai;9;12;21
626;16.04.2018;2018;04;11;Maanantai;4;7;11
626;16.04.2018;2018;04;12;Maanantai;5;14;19
626;16.04.2018;2018;04;13;Maanantai;10;17;27
626;16.04.2018;2018;04;14;Maanantai;9;11;20
626;16.04.2018;2018;04;15;Maanantai;20;21;41
626;16.04.2018;2018;04;16;Maanantai;36;19;55
626;16.04.2018;2018;04;17;Maanantai;40;19;59
626;16.04.2018;2018;04;18;Maanantai;20;17;37
626;16.04.2018;2018;04;19;Maanantai;15;8;23
626;16.04.2018;2018;04;20;Maanantai;10;5;15
626;16.04.2018;2018;04;21;Maanantai;8;3;11
626;16.04.2018;2018;04;22;Maanantai;4;1;5
626;16.04.2018;2018;04;23;Maanantai;1;4;5
626;17.04.2018;2018;04;00;Tiistai;1;0;1
626;17.04.2018;2018;04;01;Tiistai;0;2;2
626;17.04.2018;2018;04;02;Tiistai;0;0;0
626;17.04.2018;2018;04;03;Tiistai;0;0;0
626;17.04.2018;2018;04;04;Tiistai;0;1;1
626;17.04.2018;2018;04;05;Tiistai;0;1;1
626;17.04.2018;2018;04;06;Tiistai;5;8;13
626;17.04.2018;2018;04;07;Tiistai;6;21;27
626;17.04.2018;2018;04;08;Tiistai;17;53;70
626;17.04.2018;2018;04;09;Tiistai;8;33;41
626;17.04.2018;2018;04;10;Tiistai;4;13;17
626;17.04.2018;2018;04;11;Tiistai;2;2;4
626;17.04.2018;2018;04;12;Tiistai;7;12;19
626;17.04.2018;2018;04;13;Tiistai;11;7;18
626;17.04.2018;2018;04;14;Tiistai;6;6;12
626;17.04.2018;2018;04;15;Tiistai;12;15;27
626;17.04.2018;2018;04;16;Tiistai;35;19;54
626;17.04.2018;2018;04;17;Tiistai;44;33;77
626;17.04.2018;2018;04;18;Tiistai;30;22;52
626;17.04.2018;2018;04;19;Tiistai;13;12;25
626;17.04.2018;2018;04;20;Tiistai;8;3;11
626;17.04.2018;2018;04;21;Tiistai;7;3;10
626;17.04.2018;2018;04;22;Tiistai;5;1;6
626;17.04.2018;2018;04;23;Tiistai;1;1;2
626;18.04.2018;2018;04;00;Keskiviikko;0;1;1
626;18.04.2018;2018;04;01;Keskiviikko;1;0;1
626;18.04.2018;2018;04;02;Keskiviikko;0;0;0
626;18.04.2018;2018;04;03;Keskiviikko;0;0;0
626;18.04.2018;2018;04;04;Keskiviikko;0;0;0
626;18.04.2018;2018;04;05;Keskiviikko;1;2;3
626;18.04.2018;2018;04;06;Keskiviikko;5;9;14
626;18.04.2018;2018;04;07;Keskiviikko;2;28;30
626;18.04.2018;2018;04;08;Keskiviikko;14;42;56
626;18.04.2018;2018;04;09;Keskiviikko;10;31;41
626;18.04.2018;2018;04;10;Keskiviikko;5;21;26
626;18.04.2018;2018;04;11;Keskiviikko;12;18;30
626;18.04.2018;2018;04;12;Keskiviikko;15;15;30
626;18.04.2018;2018;04;13;Keskiviikko;16;15;31
626;18.04.2018;2018;04;14;Keskiviikko;18;18;36
626;18.04.2018;2018;04;15;Keskiviikko;16;21;37
626;18.04.2018;2018;04;16;Keskiviikko;37;18;55
626;18.04.2018;2018;04;17;Keskiviikko;44;23;67
626;18.04.2018;2018;04;18;Keskiviikko;29;20;49
626;18.04.2018;2018;04;19;Keskiviikko;21;12;33
626;18.04.2018;2018;04;20;Keskiviikko;10;12;22
626;18.04.2018;2018;04;21;Keskiviikko;13;10;23
626;18.04.2018;2018;04;22;Keskiviikko;7;3;10
626;18.04.2018;2018;04;23;Keskiviikko;5;3;8
626;19.04.2018;2018;04;00;Torstai;1;1;2
626;19.04.2018;2018;04;01;Torstai;0;0;0
626;19.04.2018;2018;04;02;Torstai;0;1;1
626;19.04.2018;2018;04;03;Torstai;0;0;0
626;19.04.2018;2018;04;04;Torstai;0;1;1
626;19.04.2018;2018;04;05;Torstai;1;2;3
626;19.04.2018;2018;04;06;Torstai;6;9;15
626;19.04.2018;2018;04;07;Torstai;4;32;36
626;19.04.2018;2018;04;08;Torstai;12;49;61
626;19.04.2018;2018;04;09;Torstai;7;39;46
626;19.04.2018;2018;04;10;Torstai;6;15;21
626;19.04.2018;2018;04;11;Torstai;7;12;19
626;19.04.2018;2018;04;12;Torstai;8;14;22
626;19.04.2018;2018;04;13;Torstai;7;19;26
626;19.04.2018;2018;04;14;Torstai;17;12;29
626;19.04.2018;2018;04;15;Torstai;23;18;41
626;19.04.2018;2018;04;16;Torstai;40;21;61
626;19.04.2018;2018;04;17;Torstai;45;15;60
626;19.04.2018;2018;04;18;Torstai;15;16;31
626;19.04.2018;2018;04;19;Torstai;20;11;31
626;19.04.2018;2018;04;20;Torstai;11;10;21
626;19.04.2018;2018;04;21;Torstai;6;6;12
626;19.04.2018;2018;04;22;Torstai;9;1;10
626;19.04.2018;2018;04;23;Torstai;3;3;6
626;20.04.2018;2018;04;00;Perjantai;2;1;3
626;20.04.2018;2018;04;01;Perjantai;1;0;1
626;20.04.2018;2018;04;02;Perjantai;0;0;0
626;20.04.2018;2018;04;03;Perjantai;1;0;1
626;20.04.2018;2018;04;04;Perjantai;3;1;4
626;20.04.2018;2018;04;05;Perjantai;1;1;2
626;20.04.2018;2018;04;06;Perjantai;6;6;12
626;20.04.2018;2018;04;07;Perjantai;1;17;18
626;20.04.2018;2018;04;08;Perjantai;12;16;28
626;20.04.2018;2018;04;09;Perjantai;6;11;17
626;20.04.2018;2018;04;10;Perjantai;0;3;3
626;20.04.2018;2018;04;11;Perjantai;2;3;5
626;20.04.2018;2018;04;12;Perjantai;5;6;11
626;20.04.2018;2018;04;13;Perjantai;8;8;16
626;20.04.2018;2018;04;14;Perjantai;2;6;8
626;20.04.2018;2018;04;15;Perjantai;11;16;27
626;20.04.2018;2018;04;16;Perjantai;22;11;33
626;20.04.2018;2018;04;17;Perjantai;17;10;27
626;20.04.2018;2018;04;18;Perjantai;14;8;22
626;20.04.2018;2018;04;19;Perjantai;5;7;12
626;20.04.2018;2018;04;20;Perjantai;8;10;18
626;20.04.2018;2018;04;21;Perjantai;9;1;10
626;20.04.2018;2018;04;22;Perjantai;2;6;8
626;20.04.2018;2018;04;23;Perjantai;6;2;8
626;21.04.2018;2018;04;00;Lauantai;2;0;2
626;21.04.2018;2018;04;01;Lauantai;3;0;3
626;21.04.2018;2018;04;02;Lauantai;3;0;3
626;21.04.2018;2018;04;03;Lauantai;1;0;1
626;21.04.2018;2018;04;04;Lauantai;0;0;0
626;21.04.2018;2018;04;05;Lauantai;0;0;0
626;21.04.2018;2018;04;06;Lauantai;2;3;5
626;21.04.2018;2018;04;07;Lauantai;1;3;4
626;21.04.2018;2018;04;08;Lauantai;0;2;2
626;21.04.2018;2018;04;09;Lauantai;5;7;12
626;21.04.2018;2018;04;10;Lauantai;10;12;22
626;21.04.2018;2018;04;11;Lauantai;8;18;26
626;21.04.2018;2018;04;12;Lauantai;19;16;35
626;21.04.2018;2018;04;13;Lauantai;13;18;31
626;21.04.2018;2018;04;14;Lauantai;15;15;30
626;21.04.2018;2018;04;15;Lauantai;14;15;29
626;21.04.2018;2018;04;16;Lauantai;15;14;29
626;21.04.2018;2018;04;17;Lauantai;24;12;36
626;21.04.2018;2018;04;18;Lauantai;5;10;15
626;21.04.2018;2018;04;19;Lauantai;6;18;24
626;21.04.2018;2018;04;20;Lauantai;4;8;12
626;21.04.2018;2018;04;21;Lauantai;5;5;10
626;21.04.2018;2018;04;22;Lauantai;3;3;6
626;21.04.2018;2018;04;23;Lauantai;2;2;4
626;22.04.2018;2018;04;00;Sunnuntai;3;1;4
626;22.04.2018;2018;04;01;Sunnuntai;2;0;2
626;22.04.2018;2018;04;02;Sunnuntai;0;0;0
626;22.04.2018;2018;04;03;Sunnuntai;2;0;2
626;22.04.2018;2018;04;04;Sunnuntai;2;0;2
626;22.04.2018;2018;04;05;Sunnuntai;3;0;3
626;22.04.2018;2018;04;06;Sunnuntai;1;1;2
626;22.04.2018;2018;04;07;Sunnuntai;0;1;1
626;22.04.2018;2018;04;08;Sunnuntai;1;4;5
626;22.04.2018;2018;04;09;Sunnuntai;2;6;8
626;22.04.2018;2018;04;10;Sunnuntai;7;8;15
626;22.04.2018;2018;04;11;Sunnuntai;10;19;29
626;22.04.2018;2018;04;12;Sunnuntai;21;32;53
626;22.04.2018;2018;04;13;Sunnuntai;30;15;45
626;22.04.2018;2018;04;14;Sunnuntai;25;23;48
626;22.04.2018;2018;04;15;Sunnuntai;18;25;43
626;22.04.2018;2018;04;16;Sunnuntai;14;20;34
626;22.04.2018;2018;04;17;Sunnuntai;19;26;45
626;22.04.2018;2018;04;18;Sunnuntai;21;19;40
626;22.04.2018;2018;04;19;Sunnuntai;18;17;35
626;22.04.2018;2018;04;20;Sunnuntai;10;11;21
626;22.04.2018;2018;04;21;Sunnuntai;10;8;18
626;22.04.2018;2018;04;22;Sunnuntai;2;4;6
626;22.04.2018;2018;04;23;Sunnuntai;2;1;3
626;23.04.2018;2018;04;00;Maanantai;1;0;1
626;23.04.2018;2018;04;01;Maanantai;0;0;0
626;23.04.2018;2018;04;02;Maanantai;0;0;0
626;23.04.2018;2018;04;03;Maanantai;0;0;0
626;23.04.2018;2018;04;04;Maanantai;2;2;4
626;23.04.2018;2018;04;05;Maanantai;0;3;3
626;23.04.2018;2018;04;06;Maanantai;4;7;11
626;23.04.2018;2018;04;07;Maanantai;7;44;51
626;23.04.2018;2018;04;08;Maanantai;24;65;89
626;23.04.2018;2018;04;09;Maanantai;15;43;58
626;23.04.2018;2018;04;10;Maanantai;8;14;22
626;23.04.2018;2018;04;11;Maanantai;12;13;25
626;23.04.2018;2018;04;12;Maanantai;16;18;34
626;23.04.2018;2018;04;13;Maanantai;13;19;32
626;23.04.2018;2018;04;14;Maanantai;17;19;36
626;23.04.2018;2018;04;15;Maanantai;18;26;44
626;23.04.2018;2018;04;16;Maanantai;57;23;80
626;23.04.2018;2018;04;17;Maanantai;53;24;77
626;23.04.2018;2018;04;18;Maanantai;32;23;55
626;23.04.2018;2018;04;19;Maanantai;32;13;45
626;23.04.2018;2018;04;20;Maanantai;20;18;38
626;23.04.2018;2018;04;21;Maanantai;17;8;25
626;23.04.2018;2018;04;22;Maanantai;5;7;12
626;23.04.2018;2018;04;23;Maanantai;4;5;9
626;24.04.2018;2018;04;00;Tiistai;1;1;2
626;24.04.2018;2018;04;01;Tiistai;1;0;1
626;24.04.2018;2018;04;02;Tiistai;1;1;2
626;24.04.2018;2018;04;03;Tiistai;1;0;1
626;24.04.2018;2018;04;04;Tiistai;0;0;0
626;24.04.2018;2018;04;05;Tiistai;0;2;2
626;24.04.2018;2018;04;06;Tiistai;5;12;17
626;24.04.2018;2018;04;07;Tiistai;8;41;49
626;24.04.2018;2018;04;08;Tiistai;15;57;72
626;24.04.2018;2018;04;09;Tiistai;13;42;55
626;24.04.2018;2018;04;10;Tiistai;3;18;21
626;24.04.2018;2018;04;11;Tiistai;8;11;19
626;24.04.2018;2018;04;12;Tiistai;9;14;23
626;24.04.2018;2018;04;13;Tiistai;7;9;16
626;24.04.2018;2018;04;14;Tiistai;13;10;23
626;24.04.2018;2018;04;15;Tiistai;10;14;24
626;24.04.2018;2018;04;16;Tiistai;46;22;68
626;24.04.2018;2018;04;17;Tiistai;67;22;89
626;24.04.2018;2018;04;18;Tiistai;23;9;32
626;24.04.2018;2018;04;19;Tiistai;21;4;25
626;24.04.2018;2018;04;20;Tiistai;10;5;15
626;24.04.2018;2018;04;21;Tiistai;8;5;13
626;24.04.2018;2018;04;22;Tiistai;9;5;14
626;24.04.2018;2018;04;23;Tiistai;5;5;10
626;25.04.2018;2018;04;00;Keskiviikko;0;1;1
626;25.04.2018;2018;04;01;Keskiviikko;0;2;2
626;25.04.2018;2018;04;02;Keskiviikko;0;0;0
626;25.04.2018;2018;04;03;Keskiviikko;0;1;1
626;25.04.2018;2018;04;04;Keskiviikko;0;0;0
626;25.04.2018;2018;04;05;Keskiviikko;1;6;7
626;25.04.2018;2018;04;06;Keskiviikko;4;9;13
626;25.04.2018;2018;04;07;Keskiviikko;6;33;39
626;25.04.2018;2018;04;08;Keskiviikko;16;54;70
626;25.04.2018;2018;04;09;Keskiviikko;45;63;108
626;25.04.2018;2018;04;10;Keskiviikko;6;22;28
626;25.04.2018;2018;04;11;Keskiviikko;8;13;21
626;25.04.2018;2018;04;12;Keskiviikko;48;34;82
626;25.04.2018;2018;04;13;Keskiviikko;11;17;28
626;25.04.2018;2018;04;14;Keskiviikko;18;11;29
626;25.04.2018;2018;04;15;Keskiviikko;20;25;45
626;25.04.2018;2018;04;16;Keskiviikko;39;14;53
626;25.04.2018;2018;04;17;Keskiviikko;51;31;82
626;25.04.2018;2018;04;18;Keskiviikko;29;28;57
626;25.04.2018;2018;04;19;Keskiviikko;18;6;24
626;25.04.2018;2018;04;20;Keskiviikko;15;5;20
626;25.04.2018;2018;04;21;Keskiviikko;10;8;18
626;25.04.2018;2018;04;22;Keskiviikko;8;3;11
626;25.04.2018;2018;04;23;Keskiviikko;7;5;12
626;26.04.2018;2018;04;00;Torstai;2;0;2
626;26.04.2018;2018;04;01;Torstai;1;0;1
626;26.04.2018;2018;04;02;Torstai;0;1;1
626;26.04.2018;2018;04;03;Torstai;1;1;2
626;26.04.2018;2018;04;04;Torstai;0;0;0
626;26.04.2018;2018;04;05;Torstai;0;2;2
626;26.04.2018;2018;04;06;Torstai;5;10;15
626;26.04.2018;2018;04;07;Torstai;4;42;46
626;26.04.2018;2018;04;08;Torstai;19;55;74
626;26.04.2018;2018;04;09;Torstai;10;28;38
626;26.04.2018;2018;04;10;Torstai;6;18;24
626;26.04.2018;2018;04;11;Torstai;10;11;21
626;26.04.2018;2018;04;12;Torstai;9;13;22
626;26.04.2018;2018;04;13;Torstai;14;17;31
626;26.04.2018;2018;04;14;Torstai;17;9;26
626;26.04.2018;2018;04;15;Torstai;22;18;40
626;26.04.2018;2018;04;16;Torstai;53;19;72
626;26.04.2018;2018;04;17;Torstai;61;25;86
626;26.04.2018;2018;04;18;Torstai;23;24;47
626;26.04.2018;2018;04;19;Torstai;17;10;27
626;26.04.2018;2018;04;20;Torstai;13;10;23
626;26.04.2018;2018;04;21;Torstai;7;7;14
626;26.04.2018;2018;04;22;Torstai;11;8;19
626;26.04.2018;2018;04;23;Torstai;3;5;8
626;27.04.2018;2018;04;00;Perjantai;2;2;4
626;27.04.2018;2018;04;01;Perjantai;0;1;1
626;27.04.2018;2018;04;02;Perjantai;1;1;2
626;27.04.2018;2018;04;03;Perjantai;1;0;1
626;27.04.2018;2018;04;04;Perjantai;0;1;1
626;27.04.2018;2018;04;05;Perjantai;1;2;3
626;27.04.2018;2018;04;06;Perjantai;7;9;16
626;27.04.2018;2018;04;07;Perjantai;4;36;40
626;27.04.2018;2018;04;08;Perjantai;17;48;65
626;27.04.2018;2018;04;09;Perjantai;11;36;47
626;27.04.2018;2018;04;10;Perjantai;4;14;18
626;27.04.2018;2018;04;11;Perjantai;9;21;30
626;27.04.2018;2018;04;12;Perjantai;11;18;29
626;27.04.2018;2018;04;13;Perjantai;20;20;40
626;27.04.2018;2018;04;14;Perjantai;21;24;45
626;27.04.2018;2018;04;15;Perjantai;34;27;61
626;27.04.2018;2018;04;16;Perjantai;46;26;72
626;27.04.2018;2018;04;17;Perjantai;46;34;80
626;27.04.2018;2018;04;18;Perjantai;49;22;71
626;27.04.2018;2018;04;19;Perjantai;23;15;38
626;27.04.2018;2018;04;20;Perjantai;25;17;42
626;27.04.2018;2018;04;21;Perjantai;13;6;19
626;27.04.2018;2018;04;22;Perjantai;9;7;16
626;27.04.2018;2018;04;23;Perjantai;1;2;3
626;28.04.2018;2018;04;00;Lauantai;1;2;3
626;28.04.2018;2018;04;01;Lauantai;3;0;3
626;28.04.2018;2018;04;02;Lauantai;2;0;2
626;28.04.2018;2018;04;03;Lauantai;3;0;3
626;28.04.2018;2018;04;04;Lauantai;0;1;1
626;28.04.2018;2018;04;05;Lauantai;1;0;1
626;28.04.2018;2018;04;06;Lauantai;6;3;9
626;28.04.2018;2018;04;07;Lauantai;1;1;2
626;28.04.2018;2018;04;08;Lauantai;4;6;10
626;28.04.2018;2018;04;09;Lauantai;4;8;12
626;28.04.2018;2018;04;10;Lauantai;12;18;30
626;28.04.2018;2018;04;11;Lauantai;19;14;33
626;28.04.2018;2018;04;12;Lauantai;21;31;52
626;28.04.2018;2018;04;13;Lauantai;18;36;54
626;28.04.2018;2018;04;14;Lauantai;29;27;56
626;28.04.2018;2018;04;15;Lauantai;22;22;44
626;28.04.2018;2018;04;16;Lauantai;25;22;47
626;28.04.2018;2018;04;17;Lauantai;17;19;36
626;28.04.2018;2018;04;18;Lauantai;20;13;33
626;28.04.2018;2018;04;19;Lauantai;24;14;38
626;28.04.2018;2018;04;20;Lauantai;6;5;11
626;28.04.2018;2018;04;21;Lauantai;5;7;12
626;28.04.2018;2018;04;22;Lauantai;5;7;12
626;28.04.2018;2018;04;23;Lauantai;3;1;4
626;29.04.2018;2018;04;00;Sunnuntai;7;3;10
626;29.04.2018;2018;04;01;Sunnuntai;4;1;5
626;29.04.2018;2018;04;02;Sunnuntai;0;1;1
626;29.04.2018;2018;04;03;Sunnuntai;4;0;4
626;29.04.2018;2018;04;04;Sunnuntai;0;0;0
626;29.04.2018;2018;04;05;Sunnuntai;0;1;1
626;29.04.2018;2018;04;06;Sunnuntai;4;2;6
626;29.04.2018;2018;04;07;Sunnuntai;1;2;3
626;29.04.2018;2018;04;08;Sunnuntai;4;4;8
626;29.04.2018;2018;04;09;Sunnuntai;3;6;9
626;29.04.2018;2018;04;10;Sunnuntai;7;12;19
626;29.04.2018;2018;04;11;Sunnuntai;14;10;24
626;29.04.2018;2018;04;12;Sunnuntai;12;20;32
626;29.04.2018;2018;04;13;Sunnuntai;25;24;49
626;29.04.2018;2018;04;14;Sunnuntai;8;10;18
626;29.04.2018;2018;04;15;Sunnuntai;24;20;44
626;29.04.2018;2018;04;16;Sunnuntai;17;26;43
626;29.04.2018;2018;04;17;Sunnuntai;25;25;50
626;29.04.2018;2018;04;18;Sunnuntai;23;23;46
626;29.04.2018;2018;04;19;Sunnuntai;18;20;38
626;29.04.2018;2018;04;20;Sunnuntai;7;9;16
626;29.04.2018;2018;04;21;Sunnuntai;12;14;26
626;29.04.2018;2018;04;22;Sunnuntai;7;5;12
626;29.04.2018;2018;04;23;Sunnuntai;1;1;2
626;30.04.2018;2018;04;00;Maanantai;0;0;0
626;30.04.2018;2018;04;01;Maanantai;2;0;2
626;30.04.2018;2018;04;02;Maanantai;1;0;1
626;30.04.2018;2018;04;03;Maanantai;0;1;1
626;30.04.2018;2018;04;04;Maanantai;1;1;2
626;30.04.2018;2018;04;05;Maanantai;1;3;4
626;30.04.2018;2018;04;06;Maanantai;6;14;20
626;30.04.2018;2018;04;07;Maanantai;5;29;34
626;30.04.2018;2018;04;08;Maanantai;14;43;57
626;30.04.2018;2018;04;09;Maanantai;16;25;41
626;30.04.2018;2018;04;10;Maanantai;10;15;25
626;30.04.2018;2018;04;11;Maanantai;14;16;30
626;30.04.2018;2018;04;12;Maanantai;13;13;26
626;30.04.2018;2018;04;13;Maanantai;21;15;36
626;30.04.2018;2018;04;14;Maanantai;27;15;42
626;30.04.2018;2018;04;15;Maanantai;32;29;61
626;30.04.2018;2018;04;16;Maanantai;29;25;54
626;30.04.2018;2018;04;17;Maanantai;52;31;83
626;30.04.2018;2018;04;18;Maanantai;22;21;43
626;30.04.2018;2018;04;19;Maanantai;16;11;27
626;30.04.2018;2018;04;20;Maanantai;9;8;17
626;30.04.2018;2018;04;21;Maanantai;9;7;16
626;30.04.2018;2018;04;22;Maanantai;9;5;14
626;30.04.2018;2018;04;23;Maanantai;4;4;8
626;01.05.2018;2018;05;00;Tiistai;2;4;6
626;01.05.2018;2018;05;01;Tiistai;1;2;3
626;01.05.2018;2018;05;02;Tiistai;0;2;2
626;01.05.2018;2018;05;03;Tiistai;4;1;5
626;01.05.2018;2018;05;04;Tiistai;0;0;0
626;01.05.2018;2018;05;05;Tiistai;3;0;3
626;01.05.2018;2018;05;06;Tiistai;2;3;5
626;01.05.2018;2018;05;07;Tiistai;4;4;8
626;01.05.2018;2018;05;08;Tiistai;3;7;10
626;01.05.2018;2018;05;09;Tiistai;4;10;14
626;01.05.2018;2018;05;10;Tiistai;6;14;20
626;01.05.2018;2018;05;11;Tiistai;9;12;21
626;01.05.2018;2018;05;12;Tiistai;12;32;44
626;01.05.2018;2018;05;13;Tiistai;23;56;79
626;01.05.2018;2018;05;14;Tiistai;60;64;124
626;01.05.2018;2018;05;15;Tiistai;39;33;72
626;01.05.2018;2018;05;16;Tiistai;24;35;59
626;01.05.2018;2018;05;17;Tiistai;23;26;49
626;01.05.2018;2018;05;18;Tiistai;38;14;52
626;01.05.2018;2018;05;19;Tiistai;34;17;51
626;01.05.2018;2018;05;20;Tiistai;23;9;32
626;01.05.2018;2018;05;21;Tiistai;9;6;15
626;01.05.2018;2018;05;22;Tiistai;11;5;16
626;01.05.2018;2018;05;23;Tiistai;3;3;6
626;02.05.2018;2018;05;00;Keskiviikko;1;1;2
626;02.05.2018;2018;05;01;Keskiviikko;1;0;1
626;02.05.2018;2018;05;02;Keskiviikko;0;0;0
626;02.05.2018;2018;05;03;Keskiviikko;2;1;3
626;02.05.2018;2018;05;04;Keskiviikko;0;1;1
626;02.05.2018;2018;05;05;Keskiviikko;0;2;2
626;02.05.2018;2018;05;06;Keskiviikko;6;8;14
626;02.05.2018;2018;05;07;Keskiviikko;7;32;39
626;02.05.2018;2018;05;08;Keskiviikko;19;41;60
626;02.05.2018;2018;05;09;Keskiviikko;17;27;44
626;02.05.2018;2018;05;10;Keskiviikko;3;16;19
626;02.05.2018;2018;05;11;Keskiviikko;6;5;11
626;02.05.2018;2018;05;12;Keskiviikko;5;7;12
626;02.05.2018;2018;05;13;Keskiviikko;6;13;19
626;02.05.2018;2018;05;14;Keskiviikko;13;8;21
626;02.05.2018;2018;05;15;Keskiviikko;15;11;26
626;02.05.2018;2018;05;16;Keskiviikko;34;15;49
626;02.05.2018;2018;05;17;Keskiviikko;40;17;57
626;02.05.2018;2018;05;18;Keskiviikko;21;14;35
626;02.05.2018;2018;05;19;Keskiviikko;13;5;18
626;02.05.2018;2018;05;20;Keskiviikko;8;5;13
626;02.05.2018;2018;05;21;Keskiviikko;9;8;17
626;02.05.2018;2018;05;22;Keskiviikko;9;7;16
626;02.05.2018;2018;05;23;Keskiviikko;4;0;4
626;03.05.2018;2018;05;00;Torstai;0;1;1
626;03.05.2018;2018;05;01;Torstai;0;0;0
626;03.05.2018;2018;05;02;Torstai;0;0;0
626;03.05.2018;2018;05;03;Torstai;0;0;0
626;03.05.2018;2018;05;04;Torstai;1;1;2
626;03.05.2018;2018;05;05;Torstai;0;4;4
626;03.05.2018;2018;05;06;Torstai;7;11;18
626;03.05.2018;2018;05;07;Torstai;9;40;49
626;03.05.2018;2018;05;08;Torstai;27;60;87
626;03.05.2018;2018;05;09;Torstai;8;31;39
626;03.05.2018;2018;05;10;Torstai;6;19;25
626;03.05.2018;2018;05;11;Torstai;9;13;22
626;03.05.2018;2018;05;12;Torstai;17;5;22
626;03.05.2018;2018;05;13;Torstai;16;17;33
626;03.05.2018;2018;05;14;Torstai;26;41;67
626;03.05.2018;2018;05;15;Torstai;16;18;34
626;03.05.2018;2018;05;16;Torstai;41;23;64
626;03.05.2018;2018;05;17;Torstai;56;41;97
626;03.05.2018;2018;05;18;Torstai;33;16;49
626;03.05.2018;2018;05;19;Torstai;28;9;37
626;03.05.2018;2018;05;20;Torstai;14;13;27
626;03.05.2018;2018;05;21;Torstai;19;6;25
626;03.05.2018;2018;05;22;Torstai;14;3;17
626;03.05.2018;2018;05;23;Torstai;5;4;9
626;04.05.2018;2018;05;00;Perjantai;0;2;2
626;04.05.2018;2018;05;01;Perjantai;0;2;2
626;04.05.2018;2018;05;02;Perjantai;0;0;0
626;04.05.2018;2018;05;03;Perjantai;0;0;0
626;04.05.2018;2018;05;04;Perjantai;0;0;0
626;04.05.2018;2018;05;05;Perjantai;1;2;3
626;04.05.2018;2018;05;06;Perjantai;3;3;6
626;04.05.2018;2018;05;07;Perjantai;8;23;31
626;04.05.2018;2018;05;08;Perjantai;15;22;37
626;04.05.2018;2018;05;09;Perjantai;7;15;22
626;04.05.2018;2018;05;10;Perjantai;3;9;12
626;04.05.2018;2018;05;11;Perjantai;5;3;8
626;04.05.2018;2018;05;12;Perjantai;1;1;2
626;04.05.2018;2018;05;13;Perjantai;2;4;6
626;04.05.2018;2018;05;14;Perjantai;3;2;5
626;04.05.2018;2018;05;15;Perjantai;7;11;18
626;04.05.2018;2018;05;16;Perjantai;19;12;31
626;04.05.2018;2018;05;17;Perjantai;21;15;36
626;04.05.2018;2018;05;18;Perjantai;16;3;19
626;04.05.2018;2018;05;19;Perjantai;8;4;12
626;04.05.2018;2018;05;20;Perjantai;5;2;7
626;04.05.2018;2018;05;21;Perjantai;4;5;9
626;04.05.2018;2018;05;22;Perjantai;3;9;12
626;04.05.2018;2018;05;23;Perjantai;1;1;2
626;05.05.2018;2018;05;00;Lauantai;0;1;1
626;05.05.2018;2018;05;01;Lauantai;0;2;2
626;05.05.2018;2018;05;02;Lauantai;1;0;1
626;05.05.2018;2018;05;03;Lauantai;1;0;1
626;05.05.2018;2018;05;04;Lauantai;0;0;0
626;05.05.2018;2018;05;05;Lauantai;0;1;1
626;05.05.2018;2018;05;06;Lauantai;2;0;2
626;05.05.2018;2018;05;07;Lauantai;1;1;2
626;05.05.2018;2018;05;08;Lauantai;2;3;5
626;05.05.2018;2018;05;09;Lauantai;1;5;6
626;05.05.2018;2018;05;10;Lauantai;10;18;28
626;05.05.2018;2018;05;11;Lauantai;11;18;29
626;05.05.2018;2018;05;12;Lauantai;19;17;36
626;05.05.2018;2018;05;13;Lauantai;33;34;67
626;05.05.2018;2018;05;14;Lauantai;18;29;47
626;05.05.2018;2018;05;15;Lauantai;28;15;43
626;05.05.2018;2018;05;16;Lauantai;27;24;51
626;05.05.2018;2018;05;17;Lauantai;27;22;49
626;05.05.2018;2018;05;18;Lauantai;6;15;21
626;05.05.2018;2018;05;19;Lauantai;12;18;30
626;05.05.2018;2018;05;20;Lauantai;11;14;25
626;05.05.2018;2018;05;21;Lauantai;13;12;25
626;05.05.2018;2018;05;22;Lauantai;8;11;19
626;05.05.2018;2018;05;23;Lauantai;4;5;9
626;06.05.2018;2018;05;00;Sunnuntai;1;2;3
626;06.05.2018;2018;05;01;Sunnuntai;1;0;1
626;06.05.2018;2018;05;02;Sunnuntai;6;1;7
626;06.05.2018;2018;05;03;Sunnuntai;0;1;1
626;06.05.2018;2018;05;04;Sunnuntai;2;0;2
626;06.05.2018;2018;05;05;Sunnuntai;3;0;3
626;06.05.2018;2018;05;06;Sunnuntai;4;1;5
626;06.05.2018;2018;05;07;Sunnuntai;1;5;6
626;06.05.2018;2018;05;08;Sunnuntai;5;9;14
626;06.05.2018;2018;05;09;Sunnuntai;3;7;10
626;06.05.2018;2018;05;10;Sunnuntai;12;14;26
626;06.05.2018;2018;05;11;Sunnuntai;16;15;31
626;06.05.2018;2018;05;12;Sunnuntai;31;31;62
626;06.05.2018;2018;05;13;Sunnuntai;26;28;54
626;06.05.2018;2018;05;14;Sunnuntai;24;27;51
626;06.05.2018;2018;05;15;Sunnuntai;15;14;29
626;06.05.2018;2018;05;16;Sunnuntai;27;27;54
626;06.05.2018;2018;05;17;Sunnuntai;22;28;50
626;06.05.2018;2018;05;18;Sunnuntai;20;36;56
626;06.05.2018;2018;05;19;Sunnuntai;27;15;42
626;06.05.2018;2018;05;20;Sunnuntai;19;20;39
626;06.05.2018;2018;05;21;Sunnuntai;14;6;20
626;06.05.2018;2018;05;22;Sunnuntai;5;6;11
626;06.05.2018;2018;05;23;Sunnuntai;1;2;3
626;07.05.2018;2018;05;00;Maanantai;2;2;4
626;07.05.2018;2018;05;01;Maanantai;0;0;0
626;07.05.2018;2018;05;02;Maanantai;0;0;0
626;07.05.2018;2018;05;03;Maanantai;0;1;1
626;07.05.2018;2018;05;04;Maanantai;0;2;2
626;07.05.2018;2018;05;05;Maanantai;1;2;3
626;07.05.2018;2018;05;06;Maanantai;9;15;24
626;07.05.2018;2018;05;07;Maanantai;12;38;50
626;07.05.2018;2018;05;08;Maanantai;21;70;91
626;07.05.2018;2018;05;09;Maanantai;11;35;46
626;07.05.2018;2018;05;10;Maanantai;7;20;27
626;07.05.2018;2018;05;11;Maanantai;10;17;27
626;07.05.2018;2018;05;12;Maanantai;16;13;29
626;07.05.2018;2018;05;13;Maanantai;8;12;20
626;07.05.2018;2018;05;14;Maanantai;16;8;24
626;07.05.2018;2018;05;15;Maanantai;17;16;33
626;07.05.2018;2018;05;16;Maanantai;47;21;68
626;07.05.2018;2018;05;17;Maanantai;46;23;69
626;07.05.2018;2018;05;18;Maanantai;19;14;33
626;07.05.2018;2018;05;19;Maanantai;12;9;21
626;07.05.2018;2018;05;20;Maanantai;18;10;28
626;07.05.2018;2018;05;21;Maanantai;10;14;24
626;07.05.2018;2018;05;22;Maanantai;14;10;24
626;07.05.2018;2018;05;23;Maanantai;2;2;4
626;08.05.2018;2018;05;00;Tiistai;1;1;2
626;08.05.2018;2018;05;01;Tiistai;2;1;3
626;08.05.2018;2018;05;02;Tiistai;0;0;0
626;08.05.2018;2018;05;03;Tiistai;0;0;0
626;08.05.2018;2018;05;04;Tiistai;0;1;1
626;08.05.2018;2018;05;05;Tiistai;0;4;4
626;08.05.2018;2018;05;06;Tiistai;11;14;25
626;08.05.2018;2018;05;07;Tiistai;12;63;75
626;08.05.2018;2018;05;08;Tiistai;35;80;115
626;08.05.2018;2018;05;09;Tiistai;21;48;69
626;08.05.2018;2018;05;10;Tiistai;12;25;37
626;08.05.2018;2018;05;11;Tiistai;10;30;40
626;08.05.2018;2018;05;12;Tiistai;14;26;40
626;08.05.2018;2018;05;13;Tiistai;23;23;46
626;08.05.2018;2018;05;14;Tiistai;25;26;51
626;08.05.2018;2018;05;15;Tiistai;38;29;67
626;08.05.2018;2018;05;16;Tiistai;72;28;100
626;08.05.2018;2018;05;17;Tiistai;82;50;132
626;08.05.2018;2018;05;18;Tiistai;56;31;87
626;08.05.2018;2018;05;19;Tiistai;31;21;52
626;08.05.2018;2018;05;20;Tiistai;41;24;65
626;08.05.2018;2018;05;21;Tiistai;21;15;36
626;08.05.2018;2018;05;22;Tiistai;12;9;21
626;08.05.2018;2018;05;23;Tiistai;3;5;8
626;09.05.2018;2018;05;00;Keskiviikko;1;0;1
626;09.05.2018;2018;05;01;Keskiviikko;1;1;2
626;09.05.2018;2018;05;02;Keskiviikko;0;2;2
626;09.05.2018;2018;05;03;Keskiviikko;0;0;0
626;09.05.2018;2018;05;04;Keskiviikko;0;1;1
626;09.05.2018;2018;05;05;Keskiviikko;3;2;5
626;09.05.2018;2018;05;06;Keskiviikko;9;16;25
626;09.05.2018;2018;05;07;Keskiviikko;10;40;50
626;09.05.2018;2018;05;08;Keskiviikko;32;73;105
626;09.05.2018;2018;05;09;Keskiviikko;20;60;80
626;09.05.2018;2018;05;10;Keskiviikko;12;26;38
626;09.05.2018;2018;05;11;Keskiviikko;12;21;33
626;09.05.2018;2018;05;12;Keskiviikko;10;16;26
626;09.05.2018;2018;05;13;Keskiviikko;13;14;27
626;09.05.2018;2018;05;14;Keskiviikko;23;23;46
626;09.05.2018;2018;05;15;Keskiviikko;38;28;66
626;09.05.2018;2018;05;16;Keskiviikko;67;30;97
626;09.05.2018;2018;05;17;Keskiviikko;64;54;118
626;09.05.2018;2018;05;18;Keskiviikko;51;50;101
626;09.05.2018;2018;05;19;Keskiviikko;36;34;70
626;09.05.2018;2018;05;20;Keskiviikko;24;12;36
626;09.05.2018;2018;05;21;Keskiviikko;19;11;30
626;09.05.2018;2018;05;22;Keskiviikko;22;17;39
626;09.05.2018;2018;05;23;Keskiviikko;3;5;8
626;10.05.2018;2018;05;00;Torstai;3;2;5
626;10.05.2018;2018;05;01;Torstai;5;4;9
626;10.05.2018;2018;05;02;Torstai;3;0;3
626;10.05.2018;2018;05;03;Torstai;0;1;1
626;10.05.2018;2018;05;04;Torstai;0;0;0
626;10.05.2018;2018;05;05;Torstai;1;2;3
626;10.05.2018;2018;05;06;Torstai;5;11;16
626;10.05.2018;2018;05;07;Torstai;5;11;16
626;10.05.2018;2018;05;08;Torstai;9;8;17
626;10.05.2018;2018;05;09;Torstai;6;14;20
626;10.05.2018;2018;05;10;Torstai;18;12;30
626;10.05.2018;2018;05;11;Torstai;25;29;54
626;10.05.2018;2018;05;12;Torstai;46;47;93
626;10.05.2018;2018;05;13;Torstai;45;54;99
626;10.05.2018;2018;05;14;Torstai;56;75;131
626;10.05.2018;2018;05;15;Torstai;66;65;131
626;10.05.2018;2018;05;16;Torstai;57;69;126
626;10.05.2018;2018;05;17;Torstai;53;36;89
626;10.05.2018;2018;05;18;Torstai;55;48;103
626;10.05.2018;2018;05;19;Torstai;26;31;57
626;10.05.2018;2018;05;20;Torstai;25;30;55
626;10.05.2018;2018;05;21;Torstai;21;12;33
626;10.05.2018;2018;05;22;Torstai;16;10;26
626;10.05.2018;2018;05;23;Torstai;9;3;12
626;11.05.2018;2018;05;00;Perjantai;0;2;2
626;11.05.2018;2018;05;01;Perjantai;1;1;2
626;11.05.2018;2018;05;02;Perjantai;2;1;3
626;11.05.2018;2018;05;03;Perjantai;1;1;2
626;11.05.2018;2018;05;04;Perjantai;1;2;3
626;11.05.2018;2018;05;05;Perjantai;1;0;1
626;11.05.2018;2018;05;06;Perjantai;5;13;18
626;11.05.2018;2018;05;07;Perjantai;12;39;51
626;11.05.2018;2018;05;08;Perjantai;20;66;86
626;11.05.2018;2018;05;09;Perjantai;28;40;68
626;11.05.2018;2018;05;10;Perjantai;8;26;34
626;11.05.2018;2018;05;11;Perjantai;8;34;42
626;11.05.2018;2018;05;12;Perjantai;20;36;56
626;11.05.2018;2018;05;13;Perjantai;21;40;61
626;11.05.2018;2018;05;14;Perjantai;46;46;92
626;11.05.2018;2018;05;15;Perjantai;39;27;66
626;11.05.2018;2018;05;16;Perjantai;69;50;119
626;11.05.2018;2018;05;17;Perjantai;72;58;130
626;11.05.2018;2018;05;18;Perjantai;39;40;79
626;11.05.2018;2018;05;19;Perjantai;42;29;71
626;11.05.2018;2018;05;20;Perjantai;30;22;52
626;11.05.2018;2018;05;21;Perjantai;26;17;43
626;11.05.2018;2018;05;22;Perjantai;18;14;32
626;11.05.2018;2018;05;23;Perjantai;17;9;26
626;12.05.2018;2018;05;00;Lauantai;4;4;8
626;12.05.2018;2018;05;01;Lauantai;2;1;3
626;12.05.2018;2018;05;02;Lauantai;0;0;0
626;12.05.2018;2018;05;03;Lauantai;2;0;2
626;12.05.2018;2018;05;04;Lauantai;1;1;2
626;12.05.2018;2018;05;05;Lauantai;4;1;5
626;12.05.2018;2018;05;06;Lauantai;6;6;12
626;12.05.2018;2018;05;07;Lauantai;2;5;7
626;12.05.2018;2018;05;08;Lauantai;4;9;13
626;12.05.2018;2018;05;09;Lauantai;15;10;25
626;12.05.2018;2018;05;10;Lauantai;18;32;50
626;12.05.2018;2018;05;11;Lauantai;43;45;88
626;12.05.2018;2018;05;12;Lauantai;31;50;81
626;12.05.2018;2018;05;13;Lauantai;59;61;120
626;12.05.2018;2018;05;14;Lauantai;64;92;156
626;12.05.2018;2018;05;15;Lauantai;42;58;100
626;12.05.2018;2018;05;16;Lauantai;69;61;130
626;12.05.2018;2018;05;17;Lauantai;56;49;105
626;12.05.2018;2018;05;18;Lauantai;60;59;119
626;12.05.2018;2018;05;19;Lauantai;38;24;62
626;12.05.2018;2018;05;20;Lauantai;30;15;45
626;12.05.2018;2018;05;21;Lauantai;10;14;24
626;12.05.2018;2018;05;22;Lauantai;17;9;26
626;12.05.2018;2018;05;23;Lauantai;14;5;19
626;13.05.2018;2018;05;00;Sunnuntai;4;3;7
626;13.05.2018;2018;05;01;Sunnuntai;9;1;10
626;13.05.2018;2018;05;02;Sunnuntai;5;3;8
626;13.05.2018;2018;05;03;Sunnuntai;2;2;4
626;13.05.2018;2018;05;04;Sunnuntai;0;0;0
626;13.05.2018;2018;05;05;Sunnuntai;5;0;5
626;13.05.2018;2018;05;06;Sunnuntai;3;2;5
626;13.05.2018;2018;05;07;Sunnuntai;1;2;3
626;13.05.2018;2018;05;08;Sunnuntai;3;6;9
626;13.05.2018;2018;05;09;Sunnuntai;6;3;9
626;13.05.2018;2018;05;10;Sunnuntai;9;12;21
626;13.05.2018;2018;05;11;Sunnuntai;23;20;43
626;13.05.2018;2018;05;12;Sunnuntai;43;45;88
626;13.05.2018;2018;05;13;Sunnuntai;34;56;90
626;13.05.2018;2018;05;14;Sunnuntai;57;33;90
626;13.05.2018;2018;05;15;Sunnuntai;41;37;78
626;13.05.2018;2018;05;16;Sunnuntai;54;47;101
626;13.05.2018;2018;05;17;Sunnuntai;44;51;95
626;13.05.2018;2018;05;18;Sunnuntai;41;42;83
626;13.05.2018;2018;05;19;Sunnuntai;31;44;75
626;13.05.2018;2018;05;20;Sunnuntai;30;26;56
626;13.05.2018;2018;05;21;Sunnuntai;13;16;29
626;13.05.2018;2018;05;22;Sunnuntai;13;12;25
626;13.05.2018;2018;05;23;Sunnuntai;3;2;5
626;14.05.2018;2018;05;00;Maanantai;1;1;2
626;14.05.2018;2018;05;01;Maanantai;0;0;0
626;14.05.2018;2018;05;02;Maanantai;0;0;0
626;14.05.2018;2018;05;03;Maanantai;0;1;1
626;14.05.2018;2018;05;04;Maanantai;0;5;5
626;14.05.2018;2018;05;05;Maanantai;4;8;12
626;14.05.2018;2018;05;06;Maanantai;10;13;23
626;14.05.2018;2018;05;07;Maanantai;16;60;76
626;14.05.2018;2018;05;08;Maanantai;38;130;168
626;14.05.2018;2018;05;09;Maanantai;34;69;103
626;14.05.2018;2018;05;10;Maanantai;8;40;48
626;14.05.2018;2018;05;11;Maanantai;21;27;48
626;14.05.2018;2018;05;12;Maanantai;34;47;81
626;14.05.2018;2018;05;13;Maanantai;34;36;70
626;14.05.2018;2018;05;14;Maanantai;42;46;88
626;14.05.2018;2018;05;15;Maanantai;56;40;96
626;14.05.2018;2018;05;16;Maanantai;80;49;129
626;14.05.2018;2018;05;17;Maanantai;138;62;200
626;14.05.2018;2018;05;18;Maanantai;74;56;130
626;14.05.2018;2018;05;19;Maanantai;44;29;73
626;14.05.2018;2018;05;20;Maanantai;42;17;59
626;14.05.2018;2018;05;21;Maanantai;20;21;41
626;14.05.2018;2018;05;22;Maanantai;26;19;45
626;14.05.2018;2018;05;23;Maanantai;12;12;24
626;15.05.2018;2018;05;00;Tiistai;3;2;5
626;15.05.2018;2018;05;01;Tiistai;3;0;3
626;15.05.2018;2018;05;02;Tiistai;2;2;4
626;15.05.2018;2018;05;03;Tiistai;1;0;1
626;15.05.2018;2018;05;04;Tiistai;0;1;1
626;15.05.2018;2018;05;05;Tiistai;2;5;7
626;15.05.2018;2018;05;06;Tiistai;15;9;24
626;15.05.2018;2018;05;07;Tiistai;21;66;87
626;15.05.2018;2018;05;08;Tiistai;50;140;190
626;15.05.2018;2018;05;09;Tiistai;30;66;96
626;15.05.2018;2018;05;10;Tiistai;14;46;60
626;15.05.2018;2018;05;11;Tiistai;15;20;35
626;15.05.2018;2018;05;12;Tiistai;27;23;50
626;15.05.2018;2018;05;13;Tiistai;28;35;63
626;15.05.2018;2018;05;14;Tiistai;41;43;84
626;15.05.2018;2018;05;15;Tiistai;35;28;63
626;15.05.2018;2018;05;16;Tiistai;67;42;109
626;15.05.2018;2018;05;17;Tiistai;161;71;232
626;15.05.2018;2018;05;18;Tiistai;67;60;127
626;15.05.2018;2018;05;19;Tiistai;63;42;105
626;15.05.2018;2018;05;20;Tiistai;45;35;80
626;15.05.2018;2018;05;21;Tiistai;21;21;42
626;15.05.2018;2018;05;22;Tiistai;25;19;44
626;15.05.2018;2018;05;23;Tiistai;10;10;20
626;16.05.2018;2018;05;00;Keskiviikko;1;4;5
626;16.05.2018;2018;05;01;Keskiviikko;1;2;3
626;16.05.2018;2018;05;02;Keskiviikko;0;0;0
626;16.05.2018;2018;05;03;Keskiviikko;0;0;0
626;16.05.2018;2018;05;04;Keskiviikko;1;0;1
626;16.05.2018;2018;05;05;Keskiviikko;1;2;3
626;16.05.2018;2018;05;06;Keskiviikko;15;9;24
626;16.05.2018;2018;05;07;Keskiviikko;14;75;89
626;16.05.2018;2018;05;08;Keskiviikko;47;123;170
626;16.05.2018;2018;05;09;Keskiviikko;31;79;110
626;16.05.2018;2018;05;10;Keskiviikko;19;35;54
626;16.05.2018;2018;05;11;Keskiviikko;23;31;54
626;16.05.2018;2018;05;12;Keskiviikko;32;43;75
626;16.05.2018;2018;05;13;Keskiviikko;10;11;21
626;16.05.2018;2018;05;14;Keskiviikko;44;58;102
626;16.05.2018;2018;05;15;Keskiviikko;5;6;11
626;16.05.2018;2018;05;16;Keskiviikko;133;87;220
626;16.05.2018;2018;05;17;Keskiviikko;136;78;214
626;16.05.2018;2018;05;18;Keskiviikko;72;53;125
626;16.05.2018;2018;05;19;Keskiviikko;60;53;113
626;16.05.2018;2018;05;20;Keskiviikko;45;35;80
626;16.05.2018;2018;05;21;Keskiviikko;34;35;69
626;16.05.2018;2018;05;22;Keskiviikko;22;21;43
626;16.05.2018;2018;05;23;Keskiviikko;14;7;21
626;17.05.2018;2018;05;00;Torstai;5;3;8
626;17.05.2018;2018;05;01;Torstai;3;3;6
626;17.05.2018;2018;05;02;Torstai;1;1;2
626;17.05.2018;2018;05;03;Torstai;1;0;1
626;17.05.2018;2018;05;04;Torstai;3;0;3
626;17.05.2018;2018;05;05;Torstai;0;4;4
626;17.05.2018;2018;05;06;Torstai;17;5;22
626;17.05.2018;2018;05;07;Torstai;13;63;76
626;17.05.2018;2018;05;08;Torstai;37;106;143
626;17.05.2018;2018;05;09;Torstai;22;60;82
626;17.05.2018;2018;05;10;Torstai;20;29;49
626;17.05.2018;2018;05;11;Torstai;20;38;58
626;17.05.2018;2018;05;12;Torstai;13;24;37
626;17.05.2018;2018;05;13;Torstai;14;18;32
626;17.05.2018;2018;05;14;Torstai;28;24;52
626;17.05.2018;2018;05;15;Torstai;47;29;76
626;17.05.2018;2018;05;16;Torstai;62;33;95
626;17.05.2018;2018;05;17;Torstai;102;47;149
626;17.05.2018;2018;05;18;Torstai;36;28;64
626;17.05.2018;2018;05;19;Torstai;42;22;64
626;17.05.2018;2018;05;20;Torstai;33;19;52
626;17.05.2018;2018;05;21;Torstai;17;14;31
626;17.05.2018;2018;05;22;Torstai;13;9;22
626;17.05.2018;2018;05;23;Torstai;3;7;10
626;18.05.2018;2018;05;00;Perjantai;3;1;4
626;18.05.2018;2018;05;01;Perjantai;2;3;5
626;18.05.2018;2018;05;02;Perjantai;0;0;0
626;18.05.2018;2018;05;03;Perjantai;0;1;1
626;18.05.2018;2018;05;04;Perjantai;0;0;0
626;18.05.2018;2018;05;05;Perjantai;0;1;1
626;18.05.2018;2018;05;06;Perjantai;13;13;26
626;18.05.2018;2018;05;07;Perjantai;14;36;50
626;18.05.2018;2018;05;08;Perjantai;30;77;107
626;18.05.2018;2018;05;09;Perjantai;18;50;68
626;18.05.2018;2018;05;10;Perjantai;13;26;39
626;18.05.2018;2018;05;11;Perjantai;17;12;29
626;18.05.2018;2018;05;12;Perjantai;11;23;34
626;18.05.2018;2018;05;13;Perjantai;11;19;30
626;18.05.2018;2018;05;14;Perjantai;28;11;39
626;18.05.2018;2018;05;15;Perjantai;34;26;60
626;18.05.2018;2018;05;16;Perjantai;55;29;84
626;18.05.2018;2018;05;17;Perjantai;47;36;83
626;18.05.2018;2018;05;18;Perjantai;37;31;68
626;18.05.2018;2018;05;19;Perjantai;30;8;38
626;18.05.2018;2018;05;20;Perjantai;25;19;44
626;18.05.2018;2018;05;21;Perjantai;19;17;36
626;18.05.2018;2018;05;22;Perjantai;11;11;22
626;18.05.2018;2018;05;23;Perjantai;5;6;11
626;19.05.2018;2018;05;00;Lauantai;7;4;11
626;19.05.2018;2018;05;01;Lauantai;5;3;8
626;19.05.2018;2018;05;02;Lauantai;2;0;2
626;19.05.2018;2018;05;03;Lauantai;2;2;4
626;19.05.2018;2018;05;04;Lauantai;3;2;5
626;19.05.2018;2018;05;05;Lauantai;4;0;4
626;19.05.2018;2018;05;06;Lauantai;6;5;11
626;19.05.2018;2018;05;07;Lauantai;0;3;3
626;19.05.2018;2018;05;08;Lauantai;1;7;8
626;19.05.2018;2018;05;09;Lauantai;14;12;26
626;19.05.2018;2018;05;10;Lauantai;15;22;37
626;19.05.2018;2018;05;11;Lauantai;29;27;56
626;19.05.2018;2018;05;12;Lauantai;25;23;48
626;19.05.2018;2018;05;13;Lauantai;32;50;82
626;19.05.2018;2018;05;14;Lauantai;29;33;62
626;19.05.2018;2018;05;15;Lauantai;39;35;74
626;19.05.2018;2018;05;16;Lauantai;47;38;85
626;19.05.2018;2018;05;17;Lauantai;31;22;53
626;19.05.2018;2018;05;18;Lauantai;13;28;41
626;19.05.2018;2018;05;19;Lauantai;16;20;36
626;19.05.2018;2018;05;20;Lauantai;13;16;29
626;19.05.2018;2018;05;21;Lauantai;10;12;22
626;19.05.2018;2018;05;22;Lauantai;13;8;21
626;19.05.2018;2018;05;23;Lauantai;10;7;17
626;20.05.2018;2018;05;00;Sunnuntai;5;2;7
626;20.05.2018;2018;05;01;Sunnuntai;4;4;8
626;20.05.2018;2018;05;02;Sunnuntai;2;0;2
626;20.05.2018;2018;05;03;Sunnuntai;3;0;3
626;20.05.2018;2018;05;04;Sunnuntai;2;0;2
626;20.05.2018;2018;05;05;Sunnuntai;2;0;2
626;20.05.2018;2018;05;06;Sunnuntai;1;9;10
626;20.05.2018;2018;05;07;Sunnuntai;1;1;2
626;20.05.2018;2018;05;08;Sunnuntai;2;8;10
626;20.05.2018;2018;05;09;Sunnuntai;10;8;18
626;20.05.2018;2018;05;10;Sunnuntai;11;20;31
626;20.05.2018;2018;05;11;Sunnuntai;19;20;39
626;20.05.2018;2018;05;12;Sunnuntai;20;30;50
626;20.05.2018;2018;05;13;Sunnuntai;39;38;77
626;20.05.2018;2018;05;14;Sunnuntai;21;32;53
626;20.05.2018;2018;05;15;Sunnuntai;29;31;60
626;20.05.2018;2018;05;16;Sunnuntai;36;30;66
626;20.05.2018;2018;05;17;Sunnuntai;25;17;42
626;20.05.2018;2018;05;18;Sunnuntai;25;32;57
626;20.05.2018;2018;05;19;Sunnuntai;16;25;41
626;20.05.2018;2018;05;20;Sunnuntai;14;25;39
626;20.05.2018;2018;05;21;Sunnuntai;13;11;24
626;20.05.2018;2018;05;22;Sunnuntai;17;7;24
626;20.05.2018;2018;05;23;Sunnuntai;4;2;6
626;21.05.2018;2018;05;00;Maanantai;1;2;3
626;21.05.2018;2018;05;01;Maanantai;1;1;2
626;21.05.2018;2018;05;02;Maanantai;0;0;0
626;21.05.2018;2018;05;03;Maanantai;0;1;1
626;21.05.2018;2018;05;04;Maanantai;1;1;2
626;21.05.2018;2018;05;05;Maanantai;1;3;4
626;21.05.2018;2018;05;06;Maanantai;11;20;31
626;21.05.2018;2018;05;07;Maanantai;16;68;84
626;21.05.2018;2018;05;08;Maanantai;50;115;165
626;21.05.2018;2018;05;09;Maanantai;32;59;91
626;21.05.2018;2018;05;10;Maanantai;12;41;53
626;21.05.2018;2018;05;11;Maanantai;28;21;49
626;21.05.2018;2018;05;12;Maanantai;24;36;60
626;21.05.2018;2018;05;13;Maanantai;29;28;57
626;21.05.2018;2018;05;14;Maanantai;33;38;71
626;21.05.2018;2018;05;15;Maanantai;39;40;79
626;21.05.2018;2018;05;16;Maanantai;75;48;123
626;21.05.2018;2018;05;17;Maanantai;130;65;195
626;21.05.2018;2018;05;18;Maanantai;58;50;108
626;21.05.2018;2018;05;19;Maanantai;47;46;93
626;21.05.2018;2018;05;20;Maanantai;37;34;71
626;21.05.2018;2018;05;21;Maanantai;26;15;41
626;21.05.2018;2018;05;22;Maanantai;31;16;47
626;21.05.2018;2018;05;23;Maanantai;8;10;18
626;22.05.2018;2018;05;00;Tiistai;1;5;6
626;22.05.2018;2018;05;01;Tiistai;3;4;7
626;22.05.2018;2018;05;02;Tiistai;0;0;0
626;22.05.2018;2018;05;03;Tiistai;0;1;1
626;22.05.2018;2018;05;04;Tiistai;1;0;1
626;22.05.2018;2018;05;05;Tiistai;0;3;3
626;22.05.2018;2018;05;06;Tiistai;9;14;23
626;22.05.2018;2018;05;07;Tiistai;23;87;110
626;22.05.2018;2018;05;08;Tiistai;57;122;179
626;22.05.2018;2018;05;09;Tiistai;28;83;111
626;22.05.2018;2018;05;10;Tiistai;20;45;65
626;22.05.2018;2018;05;11;Tiistai;23;44;67
626;22.05.2018;2018;05;12;Tiistai;19;39;58
626;22.05.2018;2018;05;13;Tiistai;30;34;64
626;22.05.2018;2018;05;14;Tiistai;39;42;81
626;22.05.2018;2018;05;15;Tiistai;49;32;81
626;22.05.2018;2018;05;16;Tiistai;102;59;161
626;22.05.2018;2018;05;17;Tiistai;141;83;224
626;22.05.2018;2018;05;18;Tiistai;71;58;129
626;22.05.2018;2018;05;19;Tiistai;55;37;92
626;22.05.2018;2018;05;20;Tiistai;43;31;74
626;22.05.2018;2018;05;21;Tiistai;39;26;65
626;22.05.2018;2018;05;22;Tiistai;14;15;29
626;22.05.2018;2018;05;23;Tiistai;15;12;27
626;23.05.2018;2018;05;00;Keskiviikko;5;2;7
626;23.05.2018;2018;05;01;Keskiviikko;1;2;3
626;23.05.2018;2018;05;02;Keskiviikko;2;2;4
626;23.05.2018;2018;05;03;Keskiviikko;0;0;0
626;23.05.2018;2018;05;04;Keskiviikko;0;0;0
626;23.05.2018;2018;05;05;Keskiviikko;0;2;2
626;23.05.2018;2018;05;06;Keskiviikko;8;12;20
626;23.05.2018;2018;05;07;Keskiviikko;12;43;55
626;23.05.2018;2018;05;08;Keskiviikko;41;94;135
626;23.05.2018;2018;05;09;Keskiviikko;23;75;98
626;23.05.2018;2018;05;10;Keskiviikko;7;13;20
626;23.05.2018;2018;05;11;Keskiviikko;13;19;32
626;23.05.2018;2018;05;12;Keskiviikko;11;15;26
626;23.05.2018;2018;05;13;Keskiviikko;17;19;36
626;23.05.2018;2018;05;14;Keskiviikko;23;12;35
626;23.05.2018;2018;05;15;Keskiviikko;34;18;52
626;23.05.2018;2018;05;16;Keskiviikko;63;24;87
626;23.05.2018;2018;05;17;Keskiviikko;88;46;134
626;23.05.2018;2018;05;18;Keskiviikko;44;37;81
626;23.05.2018;2018;05;19;Keskiviikko;23;16;39
626;23.05.2018;2018;05;20;Keskiviikko;16;13;29
626;23.05.2018;2018;05;21;Keskiviikko;23;11;34
626;23.05.2018;2018;05;22;Keskiviikko;10;16;26
626;23.05.2018;2018;05;23;Keskiviikko;7;3;10
626;24.05.2018;2018;05;00;Torstai;5;3;8
626;24.05.2018;2018;05;01;Torstai;1;3;4
626;24.05.2018;2018;05;02;Torstai;1;0;1
626;24.05.2018;2018;05;03;Torstai;1;0;1
626;24.05.2018;2018;05;04;Torstai;0;0;0
626;24.05.2018;2018;05;05;Torstai;0;4;4
626;24.05.2018;2018;05;06;Torstai;6;12;18
626;24.05.2018;2018;05;07;Torstai;14;43;57
626;24.05.2018;2018;05;08;Torstai;32;99;131
626;24.05.2018;2018;05;09;Torstai;25;73;98
626;24.05.2018;2018;05;10;Torstai;12;27;39
626;24.05.2018;2018;05;11;Torstai;8;11;19
626;24.05.2018;2018;05;12;Torstai;11;18;29
626;24.05.2018;2018;05;13;Torstai;21;24;45
626;24.05.2018;2018;05;14;Torstai;25;20;45
626;24.05.2018;2018;05;15;Torstai;37;35;72
626;24.05.2018;2018;05;16;Torstai;65;35;100
626;24.05.2018;2018;05;17;Torstai;86;42;128
626;24.05.2018;2018;05;18;Torstai;40;25;65
626;24.05.2018;2018;05;19;Torstai;30;23;53
626;24.05.2018;2018;05;20;Torstai;29;26;55
626;24.05.2018;2018;05;21;Torstai;17;9;26
626;24.05.2018;2018;05;22;Torstai;8;9;17
626;24.05.2018;2018;05;23;Torstai;3;10;13
626;25.05.2018;2018;05;00;Perjantai;6;3;9
626;25.05.2018;2018;05;01;Perjantai;2;1;3
626;25.05.2018;2018;05;02;Perjantai;0;0;0
626;25.05.2018;2018;05;03;Perjantai;1;0;1
626;25.05.2018;2018;05;04;Perjantai;0;2;2
626;25.05.2018;2018;05;05;Perjantai;0;3;3
626;25.05.2018;2018;05;06;Perjantai;6;10;16
626;25.05.2018;2018;05;07;Perjantai;16;52;68
626;25.05.2018;2018;05;08;Perjantai;38;89;127
626;25.05.2018;2018;05;09;Perjantai;19;61;80
626;25.05.2018;2018;05;10;Perjantai;11;23;34
626;25.05.2018;2018;05;11;Perjantai;14;13;27
626;25.05.2018;2018;05;12;Perjantai;11;25;36
626;25.05.2018;2018;05;13;Perjantai;19;21;40
626;25.05.2018;2018;05;14;Perjantai;45;43;88
626;25.05.2018;2018;05;15;Perjantai;50;37;87
626;25.05.2018;2018;05;16;Perjantai;69;40;109
626;25.05.2018;2018;05;17;Perjantai;70;54;124
626;25.05.2018;2018;05;18;Perjantai;43;33;76
626;25.05.2018;2018;05;19;Perjantai;35;21;56
626;25.05.2018;2018;05;20;Perjantai;20;25;45
626;25.05.2018;2018;05;21;Perjantai;21;22;43
626;25.05.2018;2018;05;22;Perjantai;21;17;38
626;25.05.2018;2018;05;23;Perjantai;13;4;17
626;26.05.2018;2018;05;00;Lauantai;5;1;6
626;26.05.2018;2018;05;01;Lauantai;6;0;6
626;26.05.2018;2018;05;02;Lauantai;5;0;5
626;26.05.2018;2018;05;03;Lauantai;3;0;3
626;26.05.2018;2018;05;04;Lauantai;3;0;3
626;26.05.2018;2018;05;05;Lauantai;3;1;4
626;26.05.2018;2018;05;06;Lauantai;1;4;5
626;26.05.2018;2018;05;07;Lauantai;3;4;7
626;26.05.2018;2018;05;08;Lauantai;2;7;9
626;26.05.2018;2018;05;09;Lauantai;10;14;24
626;26.05.2018;2018;05;10;Lauantai;9;21;30
626;26.05.2018;2018;05;11;Lauantai;16;14;30
626;26.05.2018;2018;05;12;Lauantai;23;22;45
626;26.05.2018;2018;05;13;Lauantai;29;51;80
626;26.05.2018;2018;05;14;Lauantai;32;27;59
626;26.05.2018;2018;05;15;Lauantai;24;21;45
626;26.05.2018;2018;05;16;Lauantai;21;10;31
626;26.05.2018;2018;05;17;Lauantai;21;24;45
626;26.05.2018;2018;05;18;Lauantai;13;17;30
626;26.05.2018;2018;05;19;Lauantai;9;9;18
626;26.05.2018;2018;05;20;Lauantai;13;19;32
626;26.05.2018;2018;05;21;Lauantai;6;6;12
626;26.05.2018;2018;05;22;Lauantai;6;8;14
626;26.05.2018;2018;05;23;Lauantai;5;4;9
626;27.05.2018;2018;05;00;Sunnuntai;6;0;6
626;27.05.2018;2018;05;01;Sunnuntai;5;0;5
626;27.05.2018;2018;05;02;Sunnuntai;6;0;6
626;27.05.2018;2018;05;03;Sunnuntai;6;0;6
626;27.05.2018;2018;05;04;Sunnuntai;4;0;4
626;27.05.2018;2018;05;05;Sunnuntai;2;0;2
626;27.05.2018;2018;05;06;Sunnuntai;2;0;2
626;27.05.2018;2018;05;07;Sunnuntai;3;0;3
626;27.05.2018;2018;05;08;Sunnuntai;6;0;6
626;27.05.2018;2018;05;09;Sunnuntai;14;0;14
626;27.05.2018;2018;05;10;Sunnuntai;19;0;19
626;27.05.2018;2018;05;11;Sunnuntai;28;0;28
626;27.05.2018;2018;05;12;Sunnuntai;30;0;30
626;27.05.2018;2018;05;13;Sunnuntai;38;0;38
626;27.05.2018;2018;05;14;Sunnuntai;32;0;32
626;27.05.2018;2018;05;15;Sunnuntai;31;0;31
626;27.05.2018;2018;05;16;Sunnuntai;30;0;30
626;27.05.2018;2018;05;17;Sunnuntai;17;0;17
626;27.05.2018;2018;05;18;Sunnuntai;32;0;32
626;27.05.2018;2018;05;19;Sunnuntai;25;0;25
626;27.05.2018;2018;05;20;Sunnuntai;25;0;25
626;27.05.2018;2018;05;21;Sunnuntai;11;0;11
626;27.05.2018;2018;05;22;Sunnuntai;7;0;7
626;27.05.2018;2018;05;23;Sunnuntai;2;0;2
626;28.05.2018;2018;05;00;Maanantai;3;0;3
626;28.05.2018;2018;05;01;Maanantai;2;0;2
626;28.05.2018;2018;05;02;Maanantai;0;0;0
626;28.05.2018;2018;05;03;Maanantai;1;0;1
626;28.05.2018;2018;05;04;Maanantai;2;0;2
626;28.05.2018;2018;05;05;Maanantai;4;0;4
626;28.05.2018;2018;05;06;Maanantai;31;0;31
626;28.05.2018;2018;05;07;Maanantai;84;0;84
626;28.05.2018;2018;05;08;Maanantai;165;0;165
626;28.05.2018;2018;05;09;Maanantai;91;0;91
626;28.05.2018;2018;05;10;Maanantai;53;0;53
626;28.05.2018;2018;05;11;Maanantai;49;0;49
626;28.05.2018;2018;05;12;Maanantai;52;0;52
626;28.05.2018;2018;05;13;Maanantai;56;0;56
626;28.05.2018;2018;05;14;Maanantai;60;0;60
626;28.05.2018;2018;05;15;Maanantai;87;0;87
626;28.05.2018;2018;05;16;Maanantai;128;0;128
626;28.05.2018;2018;05;17;Maanantai;194;0;194
626;28.05.2018;2018;05;18;Maanantai;91;0;91
626;28.05.2018;2018;05;19;Maanantai;82;0;82
626;28.05.2018;2018;05;20;Maanantai;48;0;48
626;28.05.2018;2018;05;21;Maanantai;46;0;46
626;28.05.2018;2018;05;22;Maanantai;24;0;24
626;28.05.2018;2018;05;23;Maanantai;14;0;14
626;29.05.2018;2018;05;00;Tiistai;2;3;5
626;29.05.2018;2018;05;01;Tiistai;0;0;0
626;29.05.2018;2018;05;02;Tiistai;0;2;2
626;29.05.2018;2018;05;03;Tiistai;1;0;1
626;29.05.2018;2018;05;04;Tiistai;0;0;0
626;29.05.2018;2018;05;05;Tiistai;0;5;5
626;29.05.2018;2018;05;06;Tiistai;12;15;27
626;29.05.2018;2018;05;07;Tiistai;17;59;76
626;29.05.2018;2018;05;08;Tiistai;46;109;155
626;29.05.2018;2018;05;09;Tiistai;71;134;205
626;29.05.2018;2018;05;10;Tiistai;18;32;50
626;29.05.2018;2018;05;11;Tiistai;14;28;42
626;29.05.2018;2018;05;12;Tiistai;72;69;141
626;29.05.2018;2018;05;13;Tiistai;17;34;51
626;29.05.2018;2018;05;14;Tiistai;0;0;0
626;29.05.2018;2018;05;15;Tiistai;39;47;86
626;29.05.2018;2018;05;16;Tiistai;83;36;119
626;29.05.2018;2018;05;17;Tiistai;101;66;167
626;29.05.2018;2018;05;18;Tiistai;48;32;80
626;29.05.2018;2018;05;19;Tiistai;30;20;50
626;29.05.2018;2018;05;20;Tiistai;29;25;54
626;29.05.2018;2018;05;21;Tiistai;21;14;35
626;29.05.2018;2018;05;22;Tiistai;17;17;34
626;29.05.2018;2018;05;23;Tiistai;4;5;9
626;30.05.2018;2018;05;00;Keskiviikko;1;1;2
626;30.05.2018;2018;05;01;Keskiviikko;3;0;3
626;30.05.2018;2018;05;02;Keskiviikko;0;1;1
626;30.05.2018;2018;05;03;Keskiviikko;1;0;1
626;30.05.2018;2018;05;04;Keskiviikko;2;0;2
626;30.05.2018;2018;05;05;Keskiviikko;0;3;3
626;30.05.2018;2018;05;06;Keskiviikko;10;14;24
626;30.05.2018;2018;05;07;Keskiviikko;17;57;74
626;30.05.2018;2018;05;08;Keskiviikko;33;107;140
626;30.05.2018;2018;05;09;Keskiviikko;33;75;108
626;30.05.2018;2018;05;10;Keskiviikko;15;35;50
626;30.05.2018;2018;05;11;Keskiviikko;15;20;35
626;30.05.2018;2018;05;12;Keskiviikko;14;18;32
626;30.05.2018;2018;05;13;Keskiviikko;28;29;57
626;30.05.2018;2018;05;14;Keskiviikko;22;31;53
626;30.05.2018;2018;05;15;Keskiviikko;37;29;66
626;30.05.2018;2018;05;16;Keskiviikko;66;41;107
626;30.05.2018;2018;05;17;Keskiviikko;86;46;132
626;30.05.2018;2018;05;18;Keskiviikko;53;34;87
626;30.05.2018;2018;05;19;Keskiviikko;35;15;50
626;30.05.2018;2018;05;20;Keskiviikko;33;27;60
626;30.05.2018;2018;05;21;Keskiviikko;22;15;37
626;30.05.2018;2018;05;22;Keskiviikko;15;9;24
626;30.05.2018;2018;05;23;Keskiviikko;6;8;14
626;31.05.2018;2018;05;00;Torstai;2;2;4
626;31.05.2018;2018;05;01;Torstai;0;0;0
626;31.05.2018;2018;05;02;Torstai;1;1;2
626;31.05.2018;2018;05;03;Torstai;0;1;1
626;31.05.2018;2018;05;04;Torstai;0;0;0
626;31.05.2018;2018;05;05;Torstai;0;3;3
626;31.05.2018;2018;05;06;Torstai;6;13;19
626;31.05.2018;2018;05;07;Torstai;10;57;67
626;31.05.2018;2018;05;08;Torstai;24;84;108
626;31.05.2018;2018;05;09;Torstai;28;70;98
626;31.05.2018;2018;05;10;Torstai;18;26;44
626;31.05.2018;2018;05;11;Torstai;13;30;43
626;31.05.2018;2018;05;12;Torstai;25;22;47
626;31.05.2018;2018;05;13;Torstai;40;29;69
626;31.05.2018;2018;05;14;Torstai;31;23;54
626;31.05.2018;2018;05;15;Torstai;33;35;68
626;31.05.2018;2018;05;16;Torstai;70;46;116
626;31.05.2018;2018;05;17;Torstai;89;65;154
626;31.05.2018;2018;05;18;Torstai;55;40;95
626;31.05.2018;2018;05;19;Torstai;38;27;65
626;31.05.2018;2018;05;20;Torstai;33;17;50
626;31.05.2018;2018;05;21;Torstai;27;17;44
626;31.05.2018;2018;05;22;Torstai;17;14;31
626;31.05.2018;2018;05;23;Torstai;6;6;12
626;01.06.2018;2018;06;00;Perjantai;3;1;4
626;01.06.2018;2018;06;01;Perjantai;3;1;4
626;01.06.2018;2018;06;02;Perjantai;3;0;3
626;01.06.2018;2018;06;03;Perjantai;1;0;1
626;01.06.2018;2018;06;04;Perjantai;0;0;0
626;01.06.2018;2018;06;05;Perjantai;1;2;3
626;01.06.2018;2018;06;06;Perjantai;10;10;20
626;01.06.2018;2018;06;07;Perjantai;11;56;67
626;01.06.2018;2018;06;08;Perjantai;35;88;123
626;01.06.2018;2018;06;09;Perjantai;26;50;76
626;01.06.2018;2018;06;10;Perjantai;8;39;47
626;01.06.2018;2018;06;11;Perjantai;14;16;30
626;01.06.2018;2018;06;12;Perjantai;15;23;38
626;01.06.2018;2018;06;13;Perjantai;29;31;60
626;01.06.2018;2018;06;14;Perjantai;35;37;72
626;01.06.2018;2018;06;15;Perjantai;47;33;80
626;01.06.2018;2018;06;16;Perjantai;56;41;97
626;01.06.2018;2018;06;17;Perjantai;86;59;145
626;01.06.2018;2018;06;18;Perjantai;41;37;78
626;01.06.2018;2018;06;19;Perjantai;33;20;53
626;01.06.2018;2018;06;20;Perjantai;16;11;27
626;01.06.2018;2018;06;21;Perjantai;28;22;50
626;01.06.2018;2018;06;22;Perjantai;14;26;40
626;01.06.2018;2018;06;23;Perjantai;11;4;15
626;02.06.2018;2018;06;00;Lauantai;3;4;7
626;02.06.2018;2018;06;01;Lauantai;4;3;7
626;02.06.2018;2018;06;02;Lauantai;3;2;5
626;02.06.2018;2018;06;03;Lauantai;6;0;6
626;02.06.2018;2018;06;04;Lauantai;1;1;2
626;02.06.2018;2018;06;05;Lauantai;2;0;2
626;02.06.2018;2018;06;06;Lauantai;7;4;11
626;02.06.2018;2018;06;07;Lauantai;3;3;6
626;02.06.2018;2018;06;08;Lauantai;5;7;12
626;02.06.2018;2018;06;09;Lauantai;15;9;24
626;02.06.2018;2018;06;10;Lauantai;17;26;43
626;02.06.2018;2018;06;11;Lauantai;23;46;69
626;02.06.2018;2018;06;12;Lauantai;33;43;76
626;02.06.2018;2018;06;13;Lauantai;46;46;92
626;02.06.2018;2018;06;14;Lauantai;33;52;85
626;02.06.2018;2018;06;15;Lauantai;50;41;91
626;02.06.2018;2018;06;16;Lauantai;45;44;89
626;02.06.2018;2018;06;17;Lauantai;29;29;58
626;02.06.2018;2018;06;18;Lauantai;25;26;51
626;02.06.2018;2018;06;19;Lauantai;19;27;46
626;02.06.2018;2018;06;20;Lauantai;16;25;41
626;02.06.2018;2018;06;21;Lauantai;12;9;21
626;02.06.2018;2018;06;22;Lauantai;12;18;30
626;02.06.2018;2018;06;23;Lauantai;13;16;29
626;03.06.2018;2018;06;00;Sunnuntai;7;4;11
626;03.06.2018;2018;06;01;Sunnuntai;7;9;16
626;03.06.2018;2018;06;02;Sunnuntai;9;4;13
626;03.06.2018;2018;06;03;Sunnuntai;13;1;14
626;03.06.2018;2018;06;04;Sunnuntai;8;2;10
626;03.06.2018;2018;06;05;Sunnuntai;6;0;6
626;03.06.2018;2018;06;06;Sunnuntai;3;2;5
626;03.06.2018;2018;06;07;Sunnuntai;3;5;8
626;03.06.2018;2018;06;08;Sunnuntai;4;6;10
626;03.06.2018;2018;06;09;Sunnuntai;4;10;14
626;03.06.2018;2018;06;10;Sunnuntai;9;15;24
626;03.06.2018;2018;06;11;Sunnuntai;19;15;34
626;03.06.2018;2018;06;12;Sunnuntai;18;26;44
626;03.06.2018;2018;06;13;Sunnuntai;30;33;63
626;03.06.2018;2018;06;14;Sunnuntai;24;31;55
626;03.06.2018;2018;06;15;Sunnuntai;26;24;50
626;03.06.2018;2018;06;16;Sunnuntai;35;35;70
626;03.06.2018;2018;06;17;Sunnuntai;31;30;61
626;03.06.2018;2018;06;18;Sunnuntai;24;24;48
626;03.06.2018;2018;06;19;Sunnuntai;24;21;45
626;03.06.2018;2018;06;20;Sunnuntai;16;19;35
626;03.06.2018;2018;06;21;Sunnuntai;11;13;24
626;03.06.2018;2018;06;22;Sunnuntai;12;6;18
626;03.06.2018;2018;06;23;Sunnuntai;8;2;10
626;04.06.2018;2018;06;00;Maanantai;2;1;3
626;04.06.2018;2018;06;01;Maanantai;1;0;1
626;04.06.2018;2018;06;02;Maanantai;0;1;1
626;04.06.2018;2018;06;03;Maanantai;1;2;3
626;04.06.2018;2018;06;04;Maanantai;1;1;2
626;04.06.2018;2018;06;05;Maanantai;0;2;2
626;04.06.2018;2018;06;06;Maanantai;10;7;17
626;04.06.2018;2018;06;07;Maanantai;10;43;53
626;04.06.2018;2018;06;08;Maanantai;21;48;69
626;04.06.2018;2018;06;09;Maanantai;10;26;36
626;04.06.2018;2018;06;10;Maanantai;3;9;12
626;04.06.2018;2018;06;11;Maanantai;9;8;17
626;04.06.2018;2018;06;12;Maanantai;7;6;13
626;04.06.2018;2018;06;13;Maanantai;8;6;14
626;04.06.2018;2018;06;14;Maanantai;10;8;18
626;04.06.2018;2018;06;15;Maanantai;19;16;35
626;04.06.2018;2018;06;16;Maanantai;42;18;60
626;04.06.2018;2018;06;17;Maanantai;42;24;66
626;04.06.2018;2018;06;18;Maanantai;29;8;37
626;04.06.2018;2018;06;19;Maanantai;16;6;22
626;04.06.2018;2018;06;20;Maanantai;7;4;11
626;04.06.2018;2018;06;21;Maanantai;4;4;8
626;04.06.2018;2018;06;22;Maanantai;3;5;8
626;04.06.2018;2018;06;23;Maanantai;1;4;5
626;05.06.2018;2018;06;00;Tiistai;2;2;4
626;05.06.2018;2018;06;01;Tiistai;1;2;3
626;05.06.2018;2018;06;02;Tiistai;0;1;1
626;05.06.2018;2018;06;03;Tiistai;0;0;0
626;05.06.2018;2018;06;04;Tiistai;0;0;0
626;05.06.2018;2018;06;05;Tiistai;0;3;3
626;05.06.2018;2018;06;06;Tiistai;7;3;10
626;05.06.2018;2018;06;07;Tiistai;8;44;52
626;05.06.2018;2018;06;08;Tiistai;23;40;63
626;05.06.2018;2018;06;09;Tiistai;17;31;48
626;05.06.2018;2018;06;10;Tiistai;12;12;24
626;05.06.2018;2018;06;11;Tiistai;11;20;31
626;05.06.2018;2018;06;12;Tiistai;12;14;26
626;05.06.2018;2018;06;13;Tiistai;16;13;29
626;05.06.2018;2018;06;14;Tiistai;8;10;18
626;05.06.2018;2018;06;15;Tiistai;12;24;36
626;05.06.2018;2018;06;16;Tiistai;34;18;52
626;05.06.2018;2018;06;17;Tiistai;72;34;106
626;05.06.2018;2018;06;18;Tiistai;28;18;46
626;05.06.2018;2018;06;19;Tiistai;24;25;49
626;05.06.2018;2018;06;20;Tiistai;20;9;29
626;05.06.2018;2018;06;21;Tiistai;10;2;12
626;05.06.2018;2018;06;22;Tiistai;5;8;13
626;05.06.2018;2018;06;23;Tiistai;1;2;3
626;06.06.2018;2018;06;00;Keskiviikko;0;1;1
626;06.06.2018;2018;06;01;Keskiviikko;0;1;1
626;06.06.2018;2018;06;02;Keskiviikko;2;1;3
626;06.06.2018;2018;06;03;Keskiviikko;0;0;0
626;06.06.2018;2018;06;04;Keskiviikko;0;0;0
626;06.06.2018;2018;06;05;Keskiviikko;1;3;4
626;06.06.2018;2018;06;06;Keskiviikko;9;6;15
626;06.06.2018;2018;06;07;Keskiviikko;13;51;64
626;06.06.2018;2018;06;08;Keskiviikko;30;70;100
626;06.06.2018;2018;06;09;Keskiviikko;21;44;65
626;06.06.2018;2018;06;10;Keskiviikko;6;14;20
626;06.06.2018;2018;06;11;Keskiviikko;12;20;32
626;06.06.2018;2018;06;12;Keskiviikko;14;20;34
626;06.06.2018;2018;06;13;Keskiviikko;14;10;24
626;06.06.2018;2018;06;14;Keskiviikko;16;10;26
626;06.06.2018;2018;06;15;Keskiviikko;18;10;28
626;06.06.2018;2018;06;16;Keskiviikko;47;26;73
626;06.06.2018;2018;06;17;Keskiviikko;81;44;125
626;06.06.2018;2018;06;18;Keskiviikko;32;24;56
626;06.06.2018;2018;06;19;Keskiviikko;21;11;32
626;06.06.2018;2018;06;20;Keskiviikko;22;15;37
626;06.06.2018;2018;06;21;Keskiviikko;22;11;33
626;06.06.2018;2018;06;22;Keskiviikko;5;4;9
626;06.06.2018;2018;06;23;Keskiviikko;1;5;6
626;07.06.2018;2018;06;00;Torstai;3;1;4
626;07.06.2018;2018;06;01;Torstai;0;1;1
626;07.06.2018;2018;06;02;Torstai;0;1;1
626;07.06.2018;2018;06;03;Torstai;0;0;0
626;07.06.2018;2018;06;04;Torstai;0;0;0
626;07.06.2018;2018;06;05;Torstai;0;4;4
626;07.06.2018;2018;06;06;Torstai;5;7;12
626;07.06.2018;2018;06;07;Torstai;9;18;27
626;07.06.2018;2018;06;08;Torstai;15;36;51
626;07.06.2018;2018;06;09;Torstai;11;14;25
626;07.06.2018;2018;06;10;Torstai;3;5;8
626;07.06.2018;2018;06;11;Torstai;5;2;7
626;07.06.2018;2018;06;12;Torstai;5;1;6
626;07.06.2018;2018;06;13;Torstai;5;7;12
626;07.06.2018;2018;06;14;Torstai;8;5;13
626;07.06.2018;2018;06;15;Torstai;12;11;23
626;07.06.2018;2018;06;16;Torstai;25;14;39
626;07.06.2018;2018;06;17;Torstai;33;26;59
626;07.06.2018;2018;06;18;Torstai;21;24;45
626;07.06.2018;2018;06;19;Torstai;15;12;27
626;07.06.2018;2018;06;20;Torstai;14;11;25
626;07.06.2018;2018;06;21;Torstai;14;9;23
626;07.06.2018;2018;06;22;Torstai;7;4;11
626;07.06.2018;2018;06;23;Torstai;6;5;11
626;08.06.2018;2018;06;00;Perjantai;0;2;2
626;08.06.2018;2018;06;01;Perjantai;1;0;1
626;08.06.2018;2018;06;02;Perjantai;1;0;1
626;08.06.2018;2018;06;03;Perjantai;1;0;1
626;08.06.2018;2018;06;04;Perjantai;0;0;0
626;08.06.2018;2018;06;05;Perjantai;0;2;2
626;08.06.2018;2018;06;06;Perjantai;7;11;18
626;08.06.2018;2018;06;07;Perjantai;9;34;43
626;08.06.2018;2018;06;08;Perjantai;23;66;89
626;08.06.2018;2018;06;09;Perjantai;29;40;69
626;08.06.2018;2018;06;10;Perjantai;15;22;37
626;08.06.2018;2018;06;11;Perjantai;13;18;31
626;08.06.2018;2018;06;12;Perjantai;12;15;27
626;08.06.2018;2018;06;13;Perjantai;15;16;31
626;08.06.2018;2018;06;14;Perjantai;22;22;44
626;08.06.2018;2018;06;15;Perjantai;32;22;54
626;08.06.2018;2018;06;16;Perjantai;54;40;94
626;08.06.2018;2018;06;17;Perjantai;58;41;99
626;08.06.2018;2018;06;18;Perjantai;25;24;49
626;08.06.2018;2018;06;19;Perjantai;26;15;41
626;08.06.2018;2018;06;20;Perjantai;17;9;26
626;08.06.2018;2018;06;21;Perjantai;9;16;25
626;08.06.2018;2018;06;22;Perjantai;13;10;23
626;08.06.2018;2018;06;23;Perjantai;4;5;9
626;09.06.2018;2018;06;00;Lauantai;6;4;10
626;09.06.2018;2018;06;01;Lauantai;4;3;7
626;09.06.2018;2018;06;02;Lauantai;4;0;4
626;09.06.2018;2018;06;03;Lauantai;0;0;0
626;09.06.2018;2018;06;04;Lauantai;3;1;4
626;09.06.2018;2018;06;05;Lauantai;2;0;2
626;09.06.2018;2018;06;06;Lauantai;11;0;11
626;09.06.2018;2018;06;07;Lauantai;6;0;6
626;09.06.2018;2018;06;08;Lauantai;12;0;12
626;09.06.2018;2018;06;09;Lauantai;24;0;24
626;09.06.2018;2018;06;10;Lauantai;43;0;43
626;09.06.2018;2018;06;11;Lauantai;69;0;69
626;09.06.2018;2018;06;12;Lauantai;76;0;76
626;09.06.2018;2018;06;13;Lauantai;92;0;92
626;09.06.2018;2018;06;14;Lauantai;85;0;85
626;09.06.2018;2018;06;15;Lauantai;91;0;91
626;09.06.2018;2018;06;16;Lauantai;89;0;89
626;09.06.2018;2018;06;17;Lauantai;58;0;58
626;09.06.2018;2018;06;18;Lauantai;51;0;51
626;09.06.2018;2018;06;19;Lauantai;46;0;46
626;09.06.2018;2018;06;20;Lauantai;41;0;41
626;09.06.2018;2018;06;21;Lauantai;21;0;21
626;09.06.2018;2018;06;22;Lauantai;30;0;30
626;09.06.2018;2018;06;23;Lauantai;29;0;29
626;10.06.2018;2018;06;00;Sunnuntai;11;0;11
626;10.06.2018;2018;06;01;Sunnuntai;16;0;16
626;10.06.2018;2018;06;02;Sunnuntai;13;0;13
626;10.06.2018;2018;06;03;Sunnuntai;14;0;14
626;10.06.2018;2018;06;04;Sunnuntai;10;0;10
626;10.06.2018;2018;06;05;Sunnuntai;6;0;6
626;10.06.2018;2018;06;06;Sunnuntai;5;0;5
626;10.06.2018;2018;06;07;Sunnuntai;8;0;8
626;10.06.2018;2018;06;08;Sunnuntai;10;0;10
626;10.06.2018;2018;06;09;Sunnuntai;14;0;14
626;10.06.2018;2018;06;10;Sunnuntai;24;0;24
626;10.06.2018;2018;06;11;Sunnuntai;34;0;34
626;10.06.2018;2018;06;12;Sunnuntai;44;0;44
626;10.06.2018;2018;06;13;Sunnuntai;63;0;63
626;10.06.2018;2018;06;14;Sunnuntai;55;0;55
626;10.06.2018;2018;06;15;Sunnuntai;50;0;50
626;10.06.2018;2018;06;16;Sunnuntai;70;0;70
626;10.06.2018;2018;06;17;Sunnuntai;61;0;61
626;10.06.2018;2018;06;18;Sunnuntai;48;0;48
626;10.06.2018;2018;06;19;Sunnuntai;45;0;45
626;10.06.2018;2018;06;20;Sunnuntai;35;0;35
626;10.06.2018;2018;06;21;Sunnuntai;24;0;24
626;10.06.2018;2018;06;22;Sunnuntai;18;0;18
626;10.06.2018;2018;06;23;Sunnuntai;10;0;10
626;11.06.2018;2018;06;00;Maanantai;2;3;5
626;11.06.2018;2018;06;01;Maanantai;1;0;1
626;11.06.2018;2018;06;02;Maanantai;1;0;1
626;11.06.2018;2018;06;03;Maanantai;1;1;2
626;11.06.2018;2018;06;04;Maanantai;0;1;1
626;11.06.2018;2018;06;05;Maanantai;1;0;1
626;11.06.2018;2018;06;06;Maanantai;9;7;16
626;11.06.2018;2018;06;07;Maanantai;14;52;66
626;11.06.2018;2018;06;08;Maanantai;26;88;114
626;11.06.2018;2018;06;09;Maanantai;23;54;77
626;11.06.2018;2018;06;10;Maanantai;9;26;35
626;11.06.2018;2018;06;11;Maanantai;8;24;32
626;11.06.2018;2018;06;12;Maanantai;16;21;37
626;11.06.2018;2018;06;13;Maanantai;24;38;62
626;11.06.2018;2018;06;14;Maanantai;26;20;46
626;11.06.2018;2018;06;15;Maanantai;29;30;59
626;11.06.2018;2018;06;16;Maanantai;72;40;112
626;11.06.2018;2018;06;17;Maanantai;105;51;156
626;11.06.2018;2018;06;18;Maanantai;65;46;111
626;11.06.2018;2018;06;19;Maanantai;50;26;76
626;11.06.2018;2018;06;20;Maanantai;31;23;54
626;11.06.2018;2018;06;21;Maanantai;21;17;38
626;11.06.2018;2018;06;22;Maanantai;19;18;37
626;11.06.2018;2018;06;23;Maanantai;10;4;14
626;12.06.2018;2018;06;00;Tiistai;2;3;5
626;12.06.2018;2018;06;01;Tiistai;1;0;1
626;12.06.2018;2018;06;02;Tiistai;1;0;1
626;12.06.2018;2018;06;03;Tiistai;1;1;2
626;12.06.2018;2018;06;04;Tiistai;0;1;1
626;12.06.2018;2018;06;05;Tiistai;1;0;1
626;12.06.2018;2018;06;06;Tiistai;9;7;16
626;12.06.2018;2018;06;07;Tiistai;14;52;66
626;12.06.2018;2018;06;08;Tiistai;26;88;114
626;12.06.2018;2018;06;09;Tiistai;23;54;77
626;12.06.2018;2018;06;10;Tiistai;9;26;35
626;12.06.2018;2018;06;11;Tiistai;8;24;32
626;12.06.2018;2018;06;12;Tiistai;16;21;37
626;12.06.2018;2018;06;13;Tiistai;13;26;39
626;12.06.2018;2018;06;14;Tiistai;23;23;46
626;12.06.2018;2018;06;15;Tiistai;34;20;54
626;12.06.2018;2018;06;16;Tiistai;50;36;86
626;12.06.2018;2018;06;17;Tiistai;83;59;142
626;12.06.2018;2018;06;18;Tiistai;50;40;90
626;12.06.2018;2018;06;19;Tiistai;41;19;60
626;12.06.2018;2018;06;20;Tiistai;37;18;55
626;12.06.2018;2018;06;21;Tiistai;24;19;43
626;12.06.2018;2018;06;22;Tiistai;20;12;32
626;12.06.2018;2018;06;23;Tiistai;8;10;18
626;13.06.2018;2018;06;00;Keskiviikko;1;2;3
626;13.06.2018;2018;06;01;Keskiviikko;2;0;2
626;13.06.2018;2018;06;02;Keskiviikko;0;0;0
626;13.06.2018;2018;06;03;Keskiviikko;0;0;0
626;13.06.2018;2018;06;04;Keskiviikko;1;1;2
626;13.06.2018;2018;06;05;Keskiviikko;2;2;4
626;13.06.2018;2018;06;06;Keskiviikko;10;9;19
626;13.06.2018;2018;06;07;Keskiviikko;13;46;59
626;13.06.2018;2018;06;08;Keskiviikko;28;81;109
626;13.06.2018;2018;06;09;Keskiviikko;28;50;78
626;13.06.2018;2018;06;10;Keskiviikko;17;23;40
626;13.06.2018;2018;06;11;Keskiviikko;11;19;30
626;13.06.2018;2018;06;12;Keskiviikko;14;22;36
626;13.06.2018;2018;06;13;Keskiviikko;19;23;42
626;13.06.2018;2018;06;14;Keskiviikko;27;21;48
626;13.06.2018;2018;06;15;Keskiviikko;30;29;59
626;13.06.2018;2018;06;16;Keskiviikko;65;32;97
626;13.06.2018;2018;06;17;Keskiviikko;72;48;120
626;13.06.2018;2018;06;18;Keskiviikko;44;41;85
626;13.06.2018;2018;06;19;Keskiviikko;36;28;64
626;13.06.2018;2018;06;20;Keskiviikko;27;24;51
626;13.06.2018;2018;06;21;Keskiviikko;21;14;35
626;13.06.2018;2018;06;22;Keskiviikko;18;14;32
626;13.06.2018;2018;06;23;Keskiviikko;7;6;13
626;14.06.2018;2018;06;00;Torstai;3;3;6
626;14.06.2018;2018;06;01;Torstai;0;0;0
626;14.06.2018;2018;06;02;Torstai;1;1;2
626;14.06.2018;2018;06;03;Torstai;0;0;0
626;14.06.2018;2018;06;04;Torstai;1;2;3
626;14.06.2018;2018;06;05;Torstai;1;1;2
626;14.06.2018;2018;06;06;Torstai;9;11;20
626;14.06.2018;2018;06;07;Torstai;8;44;52
626;14.06.2018;2018;06;08;Torstai;35;94;129
626;14.06.2018;2018;06;09;Torstai;25;43;68
626;14.06.2018;2018;06;10;Torstai;12;27;39
626;14.06.2018;2018;06;11;Torstai;21;29;50
626;14.06.2018;2018;06;12;Torstai;23;39;62
626;14.06.2018;2018;06;13;Torstai;26;30;56
626;14.06.2018;2018;06;14;Torstai;33;42;75
626;14.06.2018;2018;06;15;Torstai;33;36;69
626;14.06.2018;2018;06;16;Torstai;54;39;93
626;14.06.2018;2018;06;17;Torstai;109;57;166
626;14.06.2018;2018;06;18;Torstai;61;46;107
626;14.06.2018;2018;06;19;Torstai;37;28;65
626;14.06.2018;2018;06;20;Torstai;27;21;48
626;14.06.2018;2018;06;21;Torstai;27;17;44
626;14.06.2018;2018;06;22;Torstai;20;16;36
626;14.06.2018;2018;06;23;Torstai;9;4;13
626;15.06.2018;2018;06;00;Perjantai;5;5;10
626;15.06.2018;2018;06;01;Perjantai;2;4;6
626;15.06.2018;2018;06;02;Perjantai;2;4;6
626;15.06.2018;2018;06;03;Perjantai;3;1;4
626;15.06.2018;2018;06;04;Perjantai;1;1;2
626;15.06.2018;2018;06;05;Perjantai;1;2;3
626;15.06.2018;2018;06;06;Perjantai;12;12;24
626;15.06.2018;2018;06;07;Perjantai;12;41;53
626;15.06.2018;2018;06;08;Perjantai;17;67;84
626;15.06.2018;2018;06;09;Perjantai;24;52;76
626;15.06.2018;2018;06;10;Perjantai;11;25;36
626;15.06.2018;2018;06;11;Perjantai;6;23;29
626;15.06.2018;2018;06;12;Perjantai;20;28;48
626;15.06.2018;2018;06;13;Perjantai;16;26;42
626;15.06.2018;2018;06;14;Perjantai;25;28;53
626;15.06.2018;2018;06;15;Perjantai;31;31;62
626;15.06.2018;2018;06;16;Perjantai;60;40;100
626;15.06.2018;2018;06;17;Perjantai;81;45;126
626;15.06.2018;2018;06;18;Perjantai;29;39;68
626;15.06.2018;2018;06;19;Perjantai;39;24;63
626;15.06.2018;2018;06;20;Perjantai;20;15;35
626;15.06.2018;2018;06;21;Perjantai;19;19;38
626;15.06.2018;2018;06;22;Perjantai;16;15;31
626;15.06.2018;2018;06;23;Perjantai;12;5;17
626;16.06.2018;2018;06;00;Lauantai;6;2;8
626;16.06.2018;2018;06;01;Lauantai;5;2;7
626;16.06.2018;2018;06;02;Lauantai;4;1;5
626;16.06.2018;2018;06;03;Lauantai;4;0;4
626;16.06.2018;2018;06;04;Lauantai;3;2;5
626;16.06.2018;2018;06;05;Lauantai;5;1;6
626;16.06.2018;2018;06;06;Lauantai;5;1;6
626;16.06.2018;2018;06;07;Lauantai;2;6;8
626;16.06.2018;2018;06;08;Lauantai;4;9;13
626;16.06.2018;2018;06;09;Lauantai;12;11;23
626;16.06.2018;2018;06;10;Lauantai;19;27;46
626;16.06.2018;2018;06;11;Lauantai;30;34;64
626;16.06.2018;2018;06;12;Lauantai;34;37;71
626;16.06.2018;2018;06;13;Lauantai;34;54;88
626;16.06.2018;2018;06;14;Lauantai;31;38;69
626;16.06.2018;2018;06;15;Lauantai;40;49;89
626;16.06.2018;2018;06;16;Lauantai;42;35;77
626;16.06.2018;2018;06;17;Lauantai;45;29;74
626;16.06.2018;2018;06;18;Lauantai;35;43;78
626;16.06.2018;2018;06;19;Lauantai;29;36;65
626;16.06.2018;2018;06;20;Lauantai;23;26;49
626;16.06.2018;2018;06;21;Lauantai;12;16;28
626;16.06.2018;2018;06;22;Lauantai;15;15;30
626;16.06.2018;2018;06;23;Lauantai;11;7;18
626;17.06.2018;2018;06;00;Sunnuntai;12;2;14
626;17.06.2018;2018;06;01;Sunnuntai;10;2;12
626;17.06.2018;2018;06;02;Sunnuntai;10;2;12
626;17.06.2018;2018;06;03;Sunnuntai;4;0;4
626;17.06.2018;2018;06;04;Sunnuntai;6;0;6
626;17.06.2018;2018;06;05;Sunnuntai;7;1;8
626;17.06.2018;2018;06;06;Sunnuntai;5;2;7
626;17.06.2018;2018;06;07;Sunnuntai;2;9;11
626;17.06.2018;2018;06;08;Sunnuntai;4;6;10
626;17.06.2018;2018;06;09;Sunnuntai;4;10;14
626;17.06.2018;2018;06;10;Sunnuntai;14;18;32
626;17.06.2018;2018;06;11;Sunnuntai;24;30;54
626;17.06.2018;2018;06;12;Sunnuntai;18;43;61
626;17.06.2018;2018;06;13;Sunnuntai;43;81;124
626;17.06.2018;2018;06;14;Sunnuntai;39;58;97
626;17.06.2018;2018;06;15;Sunnuntai;58;58;116
626;17.06.2018;2018;06;16;Sunnuntai;56;42;98
626;17.06.2018;2018;06;17;Sunnuntai;49;40;89
626;17.06.2018;2018;06;18;Sunnuntai;30;29;59
626;17.06.2018;2018;06;19;Sunnuntai;24;40;64
626;17.06.2018;2018;06;20;Sunnuntai;22;24;46
626;17.06.2018;2018;06;21;Sunnuntai;14;14;28
626;17.06.2018;2018;06;22;Sunnuntai;14;14;28
626;17.06.2018;2018;06;23;Sunnuntai;4;3;7
626;18.06.2018;2018;06;00;Maanantai;3;4;7
626;18.06.2018;2018;06;01;Maanantai;0;1;1
626;18.06.2018;2018;06;02;Maanantai;1;1;2
626;18.06.2018;2018;06;03;Maanantai;0;1;1
626;18.06.2018;2018;06;04;Maanantai;1;2;3
626;18.06.2018;2018;06;05;Maanantai;1;2;3
626;18.06.2018;2018;06;06;Maanantai;10;10;20
626;18.06.2018;2018;06;07;Maanantai;8;41;49
626;18.06.2018;2018;06;08;Maanantai;21;69;90
626;18.06.2018;2018;06;09;Maanantai;24;43;67
626;18.06.2018;2018;06;10;Maanantai;9;19;28
626;18.06.2018;2018;06;11;Maanantai;15;16;31
626;18.06.2018;2018;06;12;Maanantai;6;10;16
626;18.06.2018;2018;06;13;Maanantai;12;11;23
626;18.06.2018;2018;06;14;Maanantai;16;15;31
626;18.06.2018;2018;06;15;Maanantai;30;22;52
626;18.06.2018;2018;06;16;Maanantai;47;33;80
626;18.06.2018;2018;06;17;Maanantai;49;36;85
626;18.06.2018;2018;06;18;Maanantai;42;21;63
626;18.06.2018;2018;06;19;Maanantai;34;20;54
626;18.06.2018;2018;06;20;Maanantai;18;20;38
626;18.06.2018;2018;06;21;Maanantai;18;13;31
626;18.06.2018;2018;06;22;Maanantai;4;10;14
626;18.06.2018;2018;06;23;Maanantai;3;4;7
626;19.06.2018;2018;06;00;Tiistai;5;5;10
626;19.06.2018;2018;06;01;Tiistai;3;1;4
626;19.06.2018;2018;06;02;Tiistai;1;1;2
626;19.06.2018;2018;06;03;Tiistai;1;2;3
626;19.06.2018;2018;06;04;Tiistai;0;1;1
626;19.06.2018;2018;06;05;Tiistai;2;3;5
626;19.06.2018;2018;06;06;Tiistai;6;11;17
626;19.06.2018;2018;06;07;Tiistai;9;37;46
626;19.06.2018;2018;06;08;Tiistai;17;56;73
626;19.06.2018;2018;06;09;Tiistai;21;35;56
626;19.06.2018;2018;06;10;Tiistai;11;22;33
626;19.06.2018;2018;06;11;Tiistai;16;19;35
626;19.06.2018;2018;06;12;Tiistai;15;14;29
626;19.06.2018;2018;06;13;Tiistai;6;13;19
626;19.06.2018;2018;06;14;Tiistai;12;6;18
626;19.06.2018;2018;06;15;Tiistai;22;15;37
626;19.06.2018;2018;06;16;Tiistai;25;15;40
626;19.06.2018;2018;06;17;Tiistai;37;21;58
626;19.06.2018;2018;06;18;Tiistai;22;14;36
626;19.06.2018;2018;06;19;Tiistai;13;20;33
626;19.06.2018;2018;06;20;Tiistai;14;7;21
626;19.06.2018;2018;06;21;Tiistai;11;7;18
626;19.06.2018;2018;06;22;Tiistai;5;5;10
626;19.06.2018;2018;06;23;Tiistai;0;2;2
626;20.06.2018;2018;06;00;Keskiviikko;0;1;1
626;20.06.2018;2018;06;01;Keskiviikko;1;2;3
626;20.06.2018;2018;06;02;Keskiviikko;0;0;0
626;20.06.2018;2018;06;03;Keskiviikko;0;0;0
626;20.06.2018;2018;06;04;Keskiviikko;1;3;4
626;20.06.2018;2018;06;05;Keskiviikko;2;2;4
626;20.06.2018;2018;06;06;Keskiviikko;9;13;22
626;20.06.2018;2018;06;07;Keskiviikko;11;37;48
626;20.06.2018;2018;06;08;Keskiviikko;26;54;80
626;20.06.2018;2018;06;09;Keskiviikko;18;29;47
626;20.06.2018;2018;06;10;Keskiviikko;7;21;28
626;20.06.2018;2018;06;11;Keskiviikko;11;20;31
626;20.06.2018;2018;06;12;Keskiviikko;14;18;32
626;20.06.2018;2018;06;13;Keskiviikko;14;21;35
626;20.06.2018;2018;06;14;Keskiviikko;17;20;37
626;20.06.2018;2018;06;15;Keskiviikko;29;30;59
626;20.06.2018;2018;06;16;Keskiviikko;44;32;76
626;20.06.2018;2018;06;17;Keskiviikko;61;35;96
626;20.06.2018;2018;06;18;Keskiviikko;41;35;76
626;20.06.2018;2018;06;19;Keskiviikko;28;29;57
626;20.06.2018;2018;06;20;Keskiviikko;24;17;41
626;20.06.2018;2018;06;21;Keskiviikko;14;10;24
626;20.06.2018;2018;06;22;Keskiviikko;15;10;25
626;20.06.2018;2018;06;23;Keskiviikko;10;8;18
626;21.06.2018;2018;06;00;Torstai;6;1;7
626;21.06.2018;2018;06;01;Torstai;1;3;4
626;21.06.2018;2018;06;02;Torstai;0;2;2
626;21.06.2018;2018;06;03;Torstai;2;0;2
626;21.06.2018;2018;06;04;Torstai;1;1;2
626;21.06.2018;2018;06;05;Torstai;2;4;6
626;21.06.2018;2018;06;06;Torstai;8;8;16
626;21.06.2018;2018;06;07;Torstai;8;38;46
626;21.06.2018;2018;06;08;Torstai;14;51;65
626;21.06.2018;2018;06;09;Torstai;27;42;69
626;21.06.2018;2018;06;10;Torstai;14;22;36
626;21.06.2018;2018;06;11;Torstai;20;20;40
626;21.06.2018;2018;06;12;Torstai;28;23;51
626;21.06.2018;2018;06;13;Torstai;26;31;57
626;21.06.2018;2018;06;14;Torstai;40;28;68
626;21.06.2018;2018;06;15;Torstai;48;37;85
626;21.06.2018;2018;06;16;Torstai;53;36;89
626;21.06.2018;2018;06;17;Torstai;44;44;88
626;21.06.2018;2018;06;18;Torstai;18;23;41
626;21.06.2018;2018;06;19;Torstai;27;27;54
626;21.06.2018;2018;06;20;Torstai;19;16;35
626;21.06.2018;2018;06;21;Torstai;16;17;33
626;21.06.2018;2018;06;22;Torstai;5;11;16
626;21.06.2018;2018;06;23;Torstai;3;5;8
626;22.06.2018;2018;06;00;Perjantai;5;8;13
626;22.06.2018;2018;06;01;Perjantai;4;0;4
626;22.06.2018;2018;06;02;Perjantai;0;2;2
626;22.06.2018;2018;06;03;Perjantai;2;1;3
626;22.06.2018;2018;06;04;Perjantai;1;1;2
626;22.06.2018;2018;06;05;Perjantai;2;2;4
626;22.06.2018;2018;06;06;Perjantai;2;0;2
626;22.06.2018;2018;06;07;Perjantai;1;2;3
626;22.06.2018;2018;06;08;Perjantai;0;1;1
626;22.06.2018;2018;06;09;Perjantai;5;3;8
626;22.06.2018;2018;06;10;Perjantai;1;0;1
626;22.06.2018;2018;06;11;Perjantai;2;2;4
626;22.06.2018;2018;06;12;Perjantai;3;0;3
626;22.06.2018;2018;06;13;Perjantai;3;2;5
626;22.06.2018;2018;06;14;Perjantai;6;4;10
626;22.06.2018;2018;06;15;Perjantai;3;2;5
626;22.06.2018;2018;06;16;Perjantai;3;2;5
626;22.06.2018;2018;06;17;Perjantai;3;7;10
626;22.06.2018;2018;06;18;Perjantai;3;2;5
626;22.06.2018;2018;06;19;Perjantai;2;1;3
626;22.06.2018;2018;06;20;Perjantai;4;5;9
626;22.06.2018;2018;06;21;Perjantai;7;2;9
626;22.06.2018;2018;06;22;Perjantai;1;4;5
626;22.06.2018;2018;06;23;Perjantai;2;1;3
626;23.06.2018;2018;06;00;Lauantai;2;4;6
626;23.06.2018;2018;06;01;Lauantai;4;3;7
626;23.06.2018;2018;06;02;Lauantai;3;2;5
626;23.06.2018;2018;06;03;Lauantai;0;0;0
626;23.06.2018;2018;06;04;Lauantai;0;0;0
626;23.06.2018;2018;06;05;Lauantai;2;1;3
626;23.06.2018;2018;06;06;Lauantai;2;1;3
626;23.06.2018;2018;06;07;Lauantai;4;0;4
626;23.06.2018;2018;06;08;Lauantai;1;4;5
626;23.06.2018;2018;06;09;Lauantai;1;2;3
626;23.06.2018;2018;06;10;Lauantai;6;3;9
626;23.06.2018;2018;06;11;Lauantai;3;3;6
626;23.06.2018;2018;06;12;Lauantai;5;3;8
626;23.06.2018;2018;06;13;Lauantai;3;4;7
626;23.06.2018;2018;06;14;Lauantai;4;7;11
626;23.06.2018;2018;06;15;Lauantai;7;7;14
626;23.06.2018;2018;06;16;Lauantai;9;7;16
626;23.06.2018;2018;06;17;Lauantai;12;11;23
626;23.06.2018;2018;06;18;Lauantai;9;6;15
626;23.06.2018;2018;06;19;Lauantai;9;8;17
626;23.06.2018;2018;06;20;Lauantai;7;14;21
626;23.06.2018;2018;06;21;Lauantai;3;10;13
626;23.06.2018;2018;06;22;Lauantai;6;4;10
626;23.06.2018;2018;06;23;Lauantai;3;6;9
626;24.06.2018;2018;06;00;Sunnuntai;0;0;0
626;24.06.2018;2018;06;01;Sunnuntai;4;1;5
626;24.06.2018;2018;06;02;Sunnuntai;2;3;5
626;24.06.2018;2018;06;03;Sunnuntai;1;1;2
626;24.06.2018;2018;06;04;Sunnuntai;2;1;3
626;24.06.2018;2018;06;05;Sunnuntai;1;0;1
626;24.06.2018;2018;06;06;Sunnuntai;2;0;2
626;24.06.2018;2018;06;07;Sunnuntai;0;3;3
626;24.06.2018;2018;06;08;Sunnuntai;3;6;9
626;24.06.2018;2018;06;09;Sunnuntai;6;6;12
626;24.06.2018;2018;06;10;Sunnuntai;12;21;33
626;24.06.2018;2018;06;11;Sunnuntai;17;17;34
626;24.06.2018;2018;06;12;Sunnuntai;21;32;53
626;24.06.2018;2018;06;13;Sunnuntai;31;32;63
626;24.06.2018;2018;06;14;Sunnuntai;37;41;78
626;24.06.2018;2018;06;15;Sunnuntai;55;54;109
626;24.06.2018;2018;06;16;Sunnuntai;26;20;46
626;24.06.2018;2018;06;17;Sunnuntai;15;43;58
626;24.06.2018;2018;06;18;Sunnuntai;37;37;74
626;24.06.2018;2018;06;19;Sunnuntai;27;31;58
626;24.06.2018;2018;06;20;Sunnuntai;19;20;39
626;24.06.2018;2018;06;21;Sunnuntai;9;13;22
626;24.06.2018;2018;06;22;Sunnuntai;11;9;20
626;24.06.2018;2018;06;23;Sunnuntai;6;7;13
626;25.06.2018;2018;06;00;Maanantai;3;1;4
626;25.06.2018;2018;06;01;Maanantai;1;1;2
626;25.06.2018;2018;06;02;Maanantai;1;1;2
626;25.06.2018;2018;06;03;Maanantai;2;3;5
626;25.06.2018;2018;06;04;Maanantai;0;1;1
626;25.06.2018;2018;06;05;Maanantai;0;3;3
626;25.06.2018;2018;06;06;Maanantai;8;8;16
626;25.06.2018;2018;06;07;Maanantai;12;51;63
626;25.06.2018;2018;06;08;Maanantai;29;82;111
626;25.06.2018;2018;06;09;Maanantai;33;54;87
626;25.06.2018;2018;06;10;Maanantai;10;39;49
626;25.06.2018;2018;06;11;Maanantai;18;36;54
626;25.06.2018;2018;06;12;Maanantai;38;46;84
626;25.06.2018;2018;06;13;Maanantai;43;40;83
626;25.06.2018;2018;06;14;Maanantai;36;37;73
626;25.06.2018;2018;06;15;Maanantai;49;48;97
626;25.06.2018;2018;06;16;Maanantai;98;60;158
626;25.06.2018;2018;06;17;Maanantai;103;53;156
626;25.06.2018;2018;06;18;Maanantai;51;51;102
626;25.06.2018;2018;06;19;Maanantai;48;43;91
626;25.06.2018;2018;06;20;Maanantai;37;33;70
626;25.06.2018;2018;06;21;Maanantai;25;25;50
626;25.06.2018;2018;06;22;Maanantai;22;20;42
626;25.06.2018;2018;06;23;Maanantai;9;5;14
626;26.06.2018;2018;06;00;Tiistai;0;4;4
626;26.06.2018;2018;06;01;Tiistai;2;2;4
626;26.06.2018;2018;06;02;Tiistai;3;0;3
626;26.06.2018;2018;06;03;Tiistai;0;0;0
626;26.06.2018;2018;06;04;Tiistai;1;2;3
626;26.06.2018;2018;06;05;Tiistai;0;2;2
626;26.06.2018;2018;06;06;Tiistai;9;9;18
626;26.06.2018;2018;06;07;Tiistai;25;51;76
626;26.06.2018;2018;06;08;Tiistai;33;94;127
626;26.06.2018;2018;06;09;Tiistai;23;60;83
626;26.06.2018;2018;06;10;Tiistai;16;30;46
626;26.06.2018;2018;06;11;Tiistai;15;25;40
626;26.06.2018;2018;06;12;Tiistai;24;41;65
626;26.06.2018;2018;06;13;Tiistai;23;32;55
626;26.06.2018;2018;06;14;Tiistai;38;34;72
626;26.06.2018;2018;06;15;Tiistai;36;35;71
626;26.06.2018;2018;06;16;Tiistai;60;49;109
626;26.06.2018;2018;06;17;Tiistai;91;56;147
626;26.06.2018;2018;06;18;Tiistai;39;38;77
626;26.06.2018;2018;06;19;Tiistai;48;45;93
626;26.06.2018;2018;06;20;Tiistai;30;34;64
626;26.06.2018;2018;06;21;Tiistai;24;18;42
626;26.06.2018;2018;06;22;Tiistai;21;9;30
626;26.06.2018;2018;06;23;Tiistai;7;8;15
626;27.06.2018;2018;06;00;Keskiviikko;2;3;5
626;27.06.2018;2018;06;01;Keskiviikko;1;1;2
626;27.06.2018;2018;06;02;Keskiviikko;2;0;2
626;27.06.2018;2018;06;03;Keskiviikko;1;1;2
626;27.06.2018;2018;06;04;Keskiviikko;1;3;4
626;27.06.2018;2018;06;05;Keskiviikko;0;5;5
626;27.06.2018;2018;06;06;Keskiviikko;10;10;20
626;27.06.2018;2018;06;07;Keskiviikko;15;55;70
626;27.06.2018;2018;06;08;Keskiviikko;36;91;127
626;27.06.2018;2018;06;09;Keskiviikko;20;53;73
626;27.06.2018;2018;06;10;Keskiviikko;11;33;44
626;27.06.2018;2018;06;11;Keskiviikko;9;21;30
626;27.06.2018;2018;06;12;Keskiviikko;18;26;44
626;27.06.2018;2018;06;13;Keskiviikko;32;30;62
626;27.06.2018;2018;06;14;Keskiviikko;33;22;55
626;27.06.2018;2018;06;15;Keskiviikko;33;33;66
626;27.06.2018;2018;06;16;Keskiviikko;62;42;104
626;27.06.2018;2018;06;17;Keskiviikko;82;47;129
626;27.06.2018;2018;06;18;Keskiviikko;53;45;98
626;27.06.2018;2018;06;19;Keskiviikko;28;30;58
626;27.06.2018;2018;06;20;Keskiviikko;25;15;40
626;27.06.2018;2018;06;21;Keskiviikko;13;15;28
626;27.06.2018;2018;06;22;Keskiviikko;19;20;39
626;27.06.2018;2018;06;23;Keskiviikko;10;7;17
626;28.06.2018;2018;06;00;Torstai;1;1;2
626;28.06.2018;2018;06;01;Torstai;0;0;0
626;28.06.2018;2018;06;02;Torstai;0;1;1
626;28.06.2018;2018;06;03;Torstai;2;0;2
626;28.06.2018;2018;06;04;Torstai;3;1;4
626;28.06.2018;2018;06;05;Torstai;1;5;6
626;28.06.2018;2018;06;06;Torstai;6;6;12
626;28.06.2018;2018;06;07;Torstai;12;21;33
626;28.06.2018;2018;06;08;Torstai;12;46;58
626;28.06.2018;2018;06;09;Torstai;10;13;23
626;28.06.2018;2018;06;10;Torstai;2;3;5
626;28.06.2018;2018;06;11;Torstai;2;6;8
626;28.06.2018;2018;06;12;Torstai;3;3;6
626;28.06.2018;2018;06;13;Torstai;4;8;12
626;28.06.2018;2018;06;14;Torstai;5;3;8
626;28.06.2018;2018;06;15;Torstai;13;7;20
626;28.06.2018;2018;06;16;Torstai;8;12;20
626;28.06.2018;2018;06;17;Torstai;19;17;36
626;28.06.2018;2018;06;18;Torstai;21;11;32
626;28.06.2018;2018;06;19;Torstai;9;4;13
626;28.06.2018;2018;06;20;Torstai;4;3;7
626;28.06.2018;2018;06;21;Torstai;2;5;7
626;28.06.2018;2018;06;22;Torstai;4;1;5
626;28.06.2018;2018;06;23;Torstai;1;2;3
626;29.06.2018;2018;06;00;Perjantai;3;3;6
626;29.06.2018;2018;06;01;Perjantai;0;1;1
626;29.06.2018;2018;06;02;Perjantai;1;0;1
626;29.06.2018;2018;06;03;Perjantai;0;0;0
626;29.06.2018;2018;06;04;Perjantai;0;2;2
626;29.06.2018;2018;06;05;Perjantai;1;3;4
626;29.06.2018;2018;06;06;Perjantai;8;8;16
626;29.06.2018;2018;06;07;Perjantai;13;31;44
626;29.06.2018;2018;06;08;Perjantai;13;37;50
626;29.06.2018;2018;06;09;Perjantai;19;34;53
626;29.06.2018;2018;06;10;Perjantai;11;12;23
626;29.06.2018;2018;06;11;Perjantai;14;12;26
626;29.06.2018;2018;06;12;Perjantai;16;12;28
626;29.06.2018;2018;06;13;Perjantai;13;18;31
626;29.06.2018;2018;06;14;Perjantai;30;17;47
626;29.06.2018;2018;06;15;Perjantai;32;20;52
626;29.06.2018;2018;06;16;Perjantai;29;34;63
626;29.06.2018;2018;06;17;Perjantai;45;23;68
626;29.06.2018;2018;06;18;Perjantai;30;24;54
626;29.06.2018;2018;06;19;Perjantai;22;11;33
626;29.06.2018;2018;06;20;Perjantai;16;18;34
626;29.06.2018;2018;06;21;Perjantai;7;11;18
626;29.06.2018;2018;06;22;Perjantai;8;11;19
626;29.06.2018;2018;06;23;Perjantai;8;4;12
626;30.06.2018;2018;06;00;Lauantai;6;4;10
626;30.06.2018;2018;06;01;Lauantai;0;2;2
626;30.06.2018;2018;06;02;Lauantai;2;0;2
626;30.06.2018;2018;06;03;Lauantai;3;4;7
626;30.06.2018;2018;06;04;Lauantai;1;3;4
626;30.06.2018;2018;06;05;Lauantai;1;2;3
626;30.06.2018;2018;06;06;Lauantai;2;3;5
626;30.06.2018;2018;06;07;Lauantai;1;3;4
626;30.06.2018;2018;06;08;Lauantai;2;6;8
626;30.06.2018;2018;06;09;Lauantai;6;7;13
626;30.06.2018;2018;06;10;Lauantai;6;14;20
626;30.06.2018;2018;06;11;Lauantai;19;17;36
626;30.06.2018;2018;06;12;Lauantai;27;27;54
626;30.06.2018;2018;06;13;Lauantai;24;18;42
626;30.06.2018;2018;06;14;Lauantai;21;33;54
626;30.06.2018;2018;06;15;Lauantai;28;19;47
626;30.06.2018;2018;06;16;Lauantai;21;23;44
626;30.06.2018;2018;06;17;Lauantai;25;23;48
626;30.06.2018;2018;06;18;Lauantai;20;17;37
626;30.06.2018;2018;06;19;Lauantai;13;15;28
626;30.06.2018;2018;06;20;Lauantai;8;12;20
626;30.06.2018;2018;06;21;Lauantai;15;16;31
626;30.06.2018;2018;06;22;Lauantai;9;9;18
626;30.06.2018;2018;06;23;Lauantai;5;5;10
626;01.07.2018;2018;07;00;Sunnuntai;4;4;8
626;01.07.2018;2018;07;01;Sunnuntai;3;5;8
626;01.07.2018;2018;07;02;Sunnuntai;3;4;7
626;01.07.2018;2018;07;03;Sunnuntai;2;3;5
626;01.07.2018;2018;07;04;Sunnuntai;3;1;4
626;01.07.2018;2018;07;05;Sunnuntai;1;1;2
626;01.07.2018;2018;07;06;Sunnuntai;0;1;1
626;01.07.2018;2018;07;07;Sunnuntai;3;1;4
626;01.07.2018;2018;07;08;Sunnuntai;2;3;5
626;01.07.2018;2018;07;09;Sunnuntai;5;6;11
626;01.07.2018;2018;07;10;Sunnuntai;12;22;34
626;01.07.2018;2018;07;11;Sunnuntai;15;24;39
626;01.07.2018;2018;07;12;Sunnuntai;38;51;89
626;01.07.2018;2018;07;13;Sunnuntai;23;31;54
626;01.07.2018;2018;07;14;Sunnuntai;44;57;101
626;01.07.2018;2018;07;15;Sunnuntai;43;48;91
626;01.07.2018;2018;07;16;Sunnuntai;37;32;69
626;01.07.2018;2018;07;17;Sunnuntai;29;35;64
626;01.07.2018;2018;07;18;Sunnuntai;31;32;63
626;01.07.2018;2018;07;19;Sunnuntai;23;22;45
626;01.07.2018;2018;07;20;Sunnuntai;21;21;42
626;01.07.2018;2018;07;21;Sunnuntai;25;22;47
626;01.07.2018;2018;07;22;Sunnuntai;12;7;19
626;01.07.2018;2018;07;23;Sunnuntai;8;4;12
626;02.07.2018;2018;07;00;Maanantai;5;4;9
626;02.07.2018;2018;07;01;Maanantai;2;0;2
626;02.07.2018;2018;07;02;Maanantai;2;0;2
626;02.07.2018;2018;07;03;Maanantai;2;2;4
626;02.07.2018;2018;07;04;Maanantai;0;1;1
626;02.07.2018;2018;07;05;Maanantai;0;4;4
626;02.07.2018;2018;07;06;Maanantai;8;6;14
626;02.07.2018;2018;07;07;Maanantai;16;35;51
626;02.07.2018;2018;07;08;Maanantai;19;75;94
626;02.07.2018;2018;07;09;Maanantai;23;50;73
626;02.07.2018;2018;07;10;Maanantai;19;38;57
626;02.07.2018;2018;07;11;Maanantai;12;24;36
626;02.07.2018;2018;07;12;Maanantai;23;35;58
626;02.07.2018;2018;07;13;Maanantai;40;46;86
626;02.07.2018;2018;07;14;Maanantai;34;45;79
626;02.07.2018;2018;07;15;Maanantai;34;44;78
626;02.07.2018;2018;07;16;Maanantai;66;44;110
626;02.07.2018;2018;07;17;Maanantai;88;57;145
626;02.07.2018;2018;07;18;Maanantai;47;55;102
626;02.07.2018;2018;07;19;Maanantai;45;38;83
626;02.07.2018;2018;07;20;Maanantai;35;35;70
626;02.07.2018;2018;07;21;Maanantai;39;19;58
626;02.07.2018;2018;07;22;Maanantai;15;13;28
626;02.07.2018;2018;07;23;Maanantai;13;8;21
626;03.07.2018;2018;07;00;Tiistai;5;3;8
626;03.07.2018;2018;07;01;Tiistai;2;0;2
626;03.07.2018;2018;07;02;Tiistai;3;1;4
626;03.07.2018;2018;07;03;Tiistai;0;1;1
626;03.07.2018;2018;07;04;Tiistai;0;1;1
626;03.07.2018;2018;07;05;Tiistai;0;3;3
626;03.07.2018;2018;07;06;Tiistai;7;12;19
626;03.07.2018;2018;07;07;Tiistai;16;45;61
626;03.07.2018;2018;07;08;Tiistai;20;63;83
626;03.07.2018;2018;07;09;Tiistai;25;49;74
626;03.07.2018;2018;07;10;Tiistai;15;31;46
626;03.07.2018;2018;07;11;Tiistai;17;37;54
626;03.07.2018;2018;07;12;Tiistai;29;25;54
626;03.07.2018;2018;07;13;Tiistai;29;34;63
626;03.07.2018;2018;07;14;Tiistai;30;28;58
626;03.07.2018;2018;07;15;Tiistai;47;44;91
626;03.07.2018;2018;07;16;Tiistai;73;46;119
626;03.07.2018;2018;07;17;Tiistai;72;47;119
626;03.07.2018;2018;07;18;Tiistai;48;31;79
626;03.07.2018;2018;07;19;Tiistai;34;41;75
626;03.07.2018;2018;07;20;Tiistai;29;27;56
626;03.07.2018;2018;07;21;Tiistai;21;23;44
626;03.07.2018;2018;07;22;Tiistai;11;10;21
626;03.07.2018;2018;07;23;Tiistai;5;5;10
626;04.07.2018;2018;07;00;Keskiviikko;2;2;4
626;04.07.2018;2018;07;01;Keskiviikko;0;1;1
626;04.07.2018;2018;07;02;Keskiviikko;0;0;0
626;04.07.2018;2018;07;03;Keskiviikko;0;0;0
626;04.07.2018;2018;07;04;Keskiviikko;0;0;0
626;04.07.2018;2018;07;05;Keskiviikko;0;0;0
626;04.07.2018;2018;07;06;Keskiviikko;0;0;0
626;04.07.2018;2018;07;07;Keskiviikko;0;0;0
626;04.07.2018;2018;07;08;Keskiviikko;0;0;0
626;04.07.2018;2018;07;09;Keskiviikko;26;51;77
626;04.07.2018;2018;07;10;Keskiviikko;3;4;7
626;04.07.2018;2018;07;11;Keskiviikko;9;4;13
626;04.07.2018;2018;07;12;Keskiviikko;1;3;4
626;04.07.2018;2018;07;13;Keskiviikko;5;1;6
626;04.07.2018;2018;07;14;Keskiviikko;4;4;8
626;04.07.2018;2018;07;15;Keskiviikko;7;10;17
626;04.07.2018;2018;07;16;Keskiviikko;24;19;43
626;04.07.2018;2018;07;17;Keskiviikko;20;16;36
626;04.07.2018;2018;07;18;Keskiviikko;29;25;54
626;04.07.2018;2018;07;19;Keskiviikko;27;21;48
626;04.07.2018;2018;07;20;Keskiviikko;18;19;37
626;04.07.2018;2018;07;21;Keskiviikko;16;22;38
626;04.07.2018;2018;07;22;Keskiviikko;15;18;33
626;04.07.2018;2018;07;23;Keskiviikko;6;5;11
626;05.07.2018;2018;07;00;Torstai;1;3;4
626;05.07.2018;2018;07;01;Torstai;2;1;3
626;05.07.2018;2018;07;02;Torstai;3;0;3
626;05.07.2018;2018;07;03;Torstai;0;1;1
626;05.07.2018;2018;07;04;Torstai;0;0;0
626;05.07.2018;2018;07;05;Torstai;0;6;6
626;05.07.2018;2018;07;06;Torstai;4;9;13
626;05.07.2018;2018;07;07;Torstai;10;44;54
626;05.07.2018;2018;07;08;Torstai;19;57;76
626;05.07.2018;2018;07;09;Torstai;23;45;68
626;05.07.2018;2018;07;10;Torstai;13;30;43
626;05.07.2018;2018;07;11;Torstai;17;30;47
626;05.07.2018;2018;07;12;Torstai;40;55;95
626;05.07.2018;2018;07;13;Torstai;29;34;63
626;05.07.2018;2018;07;14;Torstai;27;40;67
626;05.07.2018;2018;07;15;Torstai;42;30;72
626;05.07.2018;2018;07;16;Torstai;62;23;85
626;05.07.2018;2018;07;17;Torstai;58;42;100
626;05.07.2018;2018;07;18;Torstai;47;37;84
626;05.07.2018;2018;07;19;Torstai;29;17;46
626;05.07.2018;2018;07;20;Torstai;19;12;31
626;05.07.2018;2018;07;21;Torstai;14;9;23
626;05.07.2018;2018;07;22;Torstai;8;8;16
626;05.07.2018;2018;07;23;Torstai;5;3;8
626;06.07.2018;2018;07;00;Perjantai;1;3;4
626;06.07.2018;2018;07;01;Perjantai;0;0;0
626;06.07.2018;2018;07;02;Perjantai;1;1;2
626;06.07.2018;2018;07;03;Perjantai;0;0;0
626;06.07.2018;2018;07;04;Perjantai;0;1;1
626;06.07.2018;2018;07;05;Perjantai;2;4;6
626;06.07.2018;2018;07;06;Perjantai;9;8;17
626;06.07.2018;2018;07;07;Perjantai;6;34;40
626;06.07.2018;2018;07;08;Perjantai;20;60;80
626;06.07.2018;2018;07;09;Perjantai;17;29;46
626;06.07.2018;2018;07;10;Perjantai;9;26;35
626;06.07.2018;2018;07;11;Perjantai;15;20;35
626;06.07.2018;2018;07;12;Perjantai;13;25;38
626;06.07.2018;2018;07;13;Perjantai;25;30;55
626;06.07.2018;2018;07;14;Perjantai;34;31;65
626;06.07.2018;2018;07;15;Perjantai;42;45;87
626;06.07.2018;2018;07;16;Perjantai;71;41;112
626;06.07.2018;2018;07;17;Perjantai;63;48;111
626;06.07.2018;2018;07;18;Perjantai;34;45;79
626;06.07.2018;2018;07;19;Perjantai;36;22;58
626;06.07.2018;2018;07;20;Perjantai;23;16;39
626;06.07.2018;2018;07;21;Perjantai;23;31;54
626;06.07.2018;2018;07;22;Perjantai;14;18;32
626;06.07.2018;2018;07;23;Perjantai;13;9;22
626;07.07.2018;2018;07;00;Lauantai;8;8;16
626;07.07.2018;2018;07;01;Lauantai;13;7;20
626;07.07.2018;2018;07;02;Lauantai;5;2;7
626;07.07.2018;2018;07;03;Lauantai;11;1;12
626;07.07.2018;2018;07;04;Lauantai;3;3;6
626;07.07.2018;2018;07;05;Lauantai;4;0;4
626;07.07.2018;2018;07;06;Lauantai;3;7;10
626;07.07.2018;2018;07;07;Lauantai;2;0;2
626;07.07.2018;2018;07;08;Lauantai;4;7;11
626;07.07.2018;2018;07;09;Lauantai;10;14;24
626;07.07.2018;2018;07;10;Lauantai;17;18;35
626;07.07.2018;2018;07;11;Lauantai;13;34;47
626;07.07.2018;2018;07;12;Lauantai;40;42;82
626;07.07.2018;2018;07;13;Lauantai;37;41;78
626;07.07.2018;2018;07;14;Lauantai;43;46;89
626;07.07.2018;2018;07;15;Lauantai;37;51;88
626;07.07.2018;2018;07;16;Lauantai;36;41;77
626;07.07.2018;2018;07;17;Lauantai;34;37;71
626;07.07.2018;2018;07;18;Lauantai;37;30;67
626;07.07.2018;2018;07;19;Lauantai;23;23;46
626;07.07.2018;2018;07;20;Lauantai;25;22;47
626;07.07.2018;2018;07;21;Lauantai;15;16;31
626;07.07.2018;2018;07;22;Lauantai;9;14;23
626;07.07.2018;2018;07;23;Lauantai;9;4;13
626;08.07.2018;2018;07;00;Sunnuntai;4;4;8
626;08.07.2018;2018;07;01;Sunnuntai;17;2;19
626;08.07.2018;2018;07;02;Sunnuntai;4;2;6
626;08.07.2018;2018;07;03;Sunnuntai;4;1;5
626;08.07.2018;2018;07;04;Sunnuntai;6;1;7
626;08.07.2018;2018;07;05;Sunnuntai;4;1;5
626;08.07.2018;2018;07;06;Sunnuntai;2;2;4
626;08.07.2018;2018;07;07;Sunnuntai;4;3;7
626;08.07.2018;2018;07;08;Sunnuntai;2;2;4
626;08.07.2018;2018;07;09;Sunnuntai;3;5;8
626;08.07.2018;2018;07;10;Sunnuntai;12;10;22
626;08.07.2018;2018;07;11;Sunnuntai;17;27;44
626;08.07.2018;2018;07;12;Sunnuntai;26;30;56
626;08.07.2018;2018;07;13;Sunnuntai;29;30;59
626;08.07.2018;2018;07;14;Sunnuntai;48;56;104
626;08.07.2018;2018;07;15;Sunnuntai;29;47;76
626;08.07.2018;2018;07;16;Sunnuntai;35;35;70
626;08.07.2018;2018;07;17;Sunnuntai;55;47;102
626;08.07.2018;2018;07;18;Sunnuntai;30;36;66
626;08.07.2018;2018;07;19;Sunnuntai;34;46;80
626;08.07.2018;2018;07;20;Sunnuntai;24;18;42
626;08.07.2018;2018;07;21;Sunnuntai;20;19;39
626;08.07.2018;2018;07;22;Sunnuntai;9;15;24
626;08.07.2018;2018;07;23;Sunnuntai;11;8;19
626;09.07.2018;2018;07;00;Maanantai;6;4;10
626;09.07.2018;2018;07;01;Maanantai;1;6;7
626;09.07.2018;2018;07;02;Maanantai;0;2;2
626;09.07.2018;2018;07;03;Maanantai;0;2;2
626;09.07.2018;2018;07;04;Maanantai;0;1;1
626;09.07.2018;2018;07;05;Maanantai;0;2;2
626;09.07.2018;2018;07;06;Maanantai;6;11;17
626;09.07.2018;2018;07;07;Maanantai;9;41;50
626;09.07.2018;2018;07;08;Maanantai;20;74;94
626;09.07.2018;2018;07;09;Maanantai;21;55;76
626;09.07.2018;2018;07;10;Maanantai;6;31;37
626;09.07.2018;2018;07;11;Maanantai;17;28;45
626;09.07.2018;2018;07;12;Maanantai;36;38;74
626;09.07.2018;2018;07;13;Maanantai;32;54;86
626;09.07.2018;2018;07;14;Maanantai;57;52;109
626;09.07.2018;2018;07;15;Maanantai;60;50;110
626;09.07.2018;2018;07;16;Maanantai;75;57;132
626;09.07.2018;2018;07;17;Maanantai;87;55;142
626;09.07.2018;2018;07;18;Maanantai;65;50;115
626;09.07.2018;2018;07;19;Maanantai;47;44;91
626;09.07.2018;2018;07;20;Maanantai;44;25;69
626;09.07.2018;2018;07;21;Maanantai;25;24;49
626;09.07.2018;2018;07;22;Maanantai;37;28;65
626;09.07.2018;2018;07;23;Maanantai;12;10;22
626;10.07.2018;2018;07;00;Tiistai;3;4;7
626;10.07.2018;2018;07;01;Tiistai;2;3;5
626;10.07.2018;2018;07;02;Tiistai;0;0;0
626;10.07.2018;2018;07;03;Tiistai;1;2;3
626;10.07.2018;2018;07;04;Tiistai;1;1;2
626;10.07.2018;2018;07;05;Tiistai;2;3;5
626;10.07.2018;2018;07;06;Tiistai;9;16;25
626;10.07.2018;2018;07;07;Tiistai;17;53;70
626;10.07.2018;2018;07;08;Tiistai;27;85;112
626;10.07.2018;2018;07;09;Tiistai;28;55;83
626;10.07.2018;2018;07;10;Tiistai;15;42;57
626;10.07.2018;2018;07;11;Tiistai;37;46;83
626;10.07.2018;2018;07;12;Tiistai;61;57;118
626;10.07.2018;2018;07;13;Tiistai;40;51;91
626;10.07.2018;2018;07;14;Tiistai;51;46;97
626;10.07.2018;2018;07;15;Tiistai;64;64;128
626;10.07.2018;2018;07;16;Tiistai;85;62;147
626;10.07.2018;2018;07;17;Tiistai;98;76;174
626;10.07.2018;2018;07;18;Tiistai;64;52;116
626;10.07.2018;2018;07;19;Tiistai;52;47;99
626;10.07.2018;2018;07;20;Tiistai;44;39;83
626;10.07.2018;2018;07;21;Tiistai;46;28;74
626;10.07.2018;2018;07;22;Tiistai;32;16;48
626;10.07.2018;2018;07;23;Tiistai;10;9;19
626;11.07.2018;2018;07;00;Keskiviikko;6;7;13
626;11.07.2018;2018;07;01;Keskiviikko;5;6;11
626;11.07.2018;2018;07;02;Keskiviikko;2;2;4
626;11.07.2018;2018;07;03;Keskiviikko;0;0;0
626;11.07.2018;2018;07;04;Keskiviikko;2;2;4
626;11.07.2018;2018;07;05;Keskiviikko;0;2;2
626;11.07.2018;2018;07;06;Keskiviikko;11;11;22
626;11.07.2018;2018;07;07;Keskiviikko;15;49;64
626;11.07.2018;2018;07;08;Keskiviikko;18;83;101
626;11.07.2018;2018;07;09;Keskiviikko;17;43;60
626;11.07.2018;2018;07;10;Keskiviikko;10;39;49
626;11.07.2018;2018;07;11;Keskiviikko;20;34;54
626;11.07.2018;2018;07;12;Keskiviikko;39;39;78
626;11.07.2018;2018;07;13;Keskiviikko;60;56;116
626;11.07.2018;2018;07;14;Keskiviikko;52;54;106
626;11.07.2018;2018;07;15;Keskiviikko;48;54;102
626;11.07.2018;2018;07;16;Keskiviikko;85;64;149
626;11.07.2018;2018;07;17;Keskiviikko;97;59;156
626;11.07.2018;2018;07;18;Keskiviikko;53;62;115
626;11.07.2018;2018;07;19;Keskiviikko;40;41;81
626;11.07.2018;2018;07;20;Keskiviikko;44;36;80
626;11.07.2018;2018;07;21;Keskiviikko;36;27;63
626;11.07.2018;2018;07;22;Keskiviikko;32;15;47
626;11.07.2018;2018;07;23;Keskiviikko;12;6;18
626;12.07.2018;2018;07;00;Torstai;7;2;9
626;12.07.2018;2018;07;01;Torstai;5;4;9
626;12.07.2018;2018;07;02;Torstai;1;0;1
626;12.07.2018;2018;07;03;Torstai;2;0;2
626;12.07.2018;2018;07;04;Torstai;1;4;5
626;12.07.2018;2018;07;05;Torstai;2;3;5
626;12.07.2018;2018;07;06;Torstai;8;6;14
626;12.07.2018;2018;07;07;Torstai;19;42;61
626;12.07.2018;2018;07;08;Torstai;25;66;91
626;12.07.2018;2018;07;09;Torstai;21;50;71
626;12.07.2018;2018;07;10;Torstai;16;46;62
626;12.07.2018;2018;07;11;Torstai;15;39;54
626;12.07.2018;2018;07;12;Torstai;40;47;87
626;12.07.2018;2018;07;13;Torstai;27;42;69
626;12.07.2018;2018;07;14;Torstai;44;45;89
626;12.07.2018;2018;07;15;Torstai;45;57;102
626;12.07.2018;2018;07;16;Torstai;65;52;117
626;12.07.2018;2018;07;17;Torstai;93;72;165
626;12.07.2018;2018;07;18;Torstai;53;58;111
626;12.07.2018;2018;07;19;Torstai;40;40;80
626;12.07.2018;2018;07;20;Torstai;25;25;50
626;12.07.2018;2018;07;21;Torstai;39;18;57
626;12.07.2018;2018;07;22;Torstai;23;27;50
626;12.07.2018;2018;07;23;Torstai;27;9;36
626;13.07.2018;2018;07;00;Perjantai;15;3;18
626;13.07.2018;2018;07;01;Perjantai;9;2;11
626;13.07.2018;2018;07;02;Perjantai;9;1;10
626;13.07.2018;2018;07;03;Perjantai;2;0;2
626;13.07.2018;2018;07;04;Perjantai;0;0;0
626;13.07.2018;2018;07;05;Perjantai;3;6;9
626;13.07.2018;2018;07;06;Perjantai;9;9;18
626;13.07.2018;2018;07;07;Perjantai;11;31;42
626;13.07.2018;2018;07;08;Perjantai;26;57;83
626;13.07.2018;2018;07;09;Perjantai;17;36;53
626;13.07.2018;2018;07;10;Perjantai;22;35;57
626;13.07.2018;2018;07;11;Perjantai;24;38;62
626;13.07.2018;2018;07;12;Perjantai;26;39;65
626;13.07.2018;2018;07;13;Perjantai;27;40;67
626;13.07.2018;2018;07;14;Perjantai;54;38;92
626;13.07.2018;2018;07;15;Perjantai;47;59;106
626;13.07.2018;2018;07;16;Perjantai;63;70;133
626;13.07.2018;2018;07;17;Perjantai;57;57;114
626;13.07.2018;2018;07;18;Perjantai;46;59;105
626;13.07.2018;2018;07;19;Perjantai;27;37;64
626;13.07.2018;2018;07;20;Perjantai;34;29;63
626;13.07.2018;2018;07;21;Perjantai;25;22;47
626;13.07.2018;2018;07;22;Perjantai;24;34;58
626;13.07.2018;2018;07;23;Perjantai;21;8;29
626;14.07.2018;2018;07;00;Lauantai;21;11;32
626;14.07.2018;2018;07;01;Lauantai;27;4;31
626;14.07.2018;2018;07;02;Lauantai;17;3;20
626;14.07.2018;2018;07;03;Lauantai;12;2;14
626;14.07.2018;2018;07;04;Lauantai;7;3;10
626;14.07.2018;2018;07;05;Lauantai;11;2;13
626;14.07.2018;2018;07;06;Lauantai;2;5;7
626;14.07.2018;2018;07;07;Lauantai;5;2;7
626;14.07.2018;2018;07;08;Lauantai;2;2;4
626;14.07.2018;2018;07;09;Lauantai;3;5;8
626;14.07.2018;2018;07;10;Lauantai;5;17;22
626;14.07.2018;2018;07;11;Lauantai;16;23;39
626;14.07.2018;2018;07;12;Lauantai;18;22;40
626;14.07.2018;2018;07;13;Lauantai;26;25;51
626;14.07.2018;2018;07;14;Lauantai;31;45;76
626;14.07.2018;2018;07;15;Lauantai;25;32;57
626;14.07.2018;2018;07;16;Lauantai;22;36;58
626;14.07.2018;2018;07;17;Lauantai;28;30;58
626;14.07.2018;2018;07;18;Lauantai;19;29;48
626;14.07.2018;2018;07;19;Lauantai;15;35;50
626;14.07.2018;2018;07;20;Lauantai;23;34;57
626;14.07.2018;2018;07;21;Lauantai;26;29;55
626;14.07.2018;2018;07;22;Lauantai;26;26;52
626;14.07.2018;2018;07;23;Lauantai;17;17;34
626;15.07.2018;2018;07;00;Sunnuntai;17;6;23
626;15.07.2018;2018;07;01;Sunnuntai;28;3;31
626;15.07.2018;2018;07;02;Sunnuntai;8;2;10
626;15.07.2018;2018;07;03;Sunnuntai;13;1;14
626;15.07.2018;2018;07;04;Sunnuntai;10;3;13
626;15.07.2018;2018;07;05;Sunnuntai;5;0;5
626;15.07.2018;2018;07;06;Sunnuntai;8;3;11
626;15.07.2018;2018;07;07;Sunnuntai;4;1;5
626;15.07.2018;2018;07;08;Sunnuntai;4;6;10
626;15.07.2018;2018;07;09;Sunnuntai;8;9;17
626;15.07.2018;2018;07;10;Sunnuntai;17;17;34
626;15.07.2018;2018;07;11;Sunnuntai;20;34;54
626;15.07.2018;2018;07;12;Sunnuntai;30;47;77
626;15.07.2018;2018;07;13;Sunnuntai;33;47;80
626;15.07.2018;2018;07;14;Sunnuntai;34;40;74
626;15.07.2018;2018;07;15;Sunnuntai;48;59;107
626;15.07.2018;2018;07;16;Sunnuntai;39;45;84
626;15.07.2018;2018;07;17;Sunnuntai;50;39;89
626;15.07.2018;2018;07;18;Sunnuntai;34;40;74
626;15.07.2018;2018;07;19;Sunnuntai;43;30;73
626;15.07.2018;2018;07;20;Sunnuntai;15;13;28
626;15.07.2018;2018;07;21;Sunnuntai;20;17;37
626;15.07.2018;2018;07;22;Sunnuntai;16;20;36
626;15.07.2018;2018;07;23;Sunnuntai;7;9;16
626;16.07.2018;2018;07;00;Maanantai;10;6;16
626;16.07.2018;2018;07;01;Maanantai;2;2;4
626;16.07.2018;2018;07;02;Maanantai;0;2;2
626;16.07.2018;2018;07;03;Maanantai;1;1;2
626;16.07.2018;2018;07;04;Maanantai;2;1;3
626;16.07.2018;2018;07;05;Maanantai;0;1;1
626;16.07.2018;2018;07;06;Maanantai;17;17;34
626;16.07.2018;2018;07;07;Maanantai;10;49;59
626;16.07.2018;2018;07;08;Maanantai;31;73;104
626;16.07.2018;2018;07;09;Maanantai;14;38;52
626;16.07.2018;2018;07;10;Maanantai;13;36;49
626;16.07.2018;2018;07;11;Maanantai;27;24;51
626;16.07.2018;2018;07;12;Maanantai;35;52;87
626;16.07.2018;2018;07;13;Maanantai;24;63;87
626;16.07.2018;2018;07;14;Maanantai;51;59;110
626;16.07.2018;2018;07;15;Maanantai;69;41;110
626;16.07.2018;2018;07;16;Maanantai;67;53;120
626;16.07.2018;2018;07;17;Maanantai;95;61;156
626;16.07.2018;2018;07;18;Maanantai;62;59;121
626;16.07.2018;2018;07;19;Maanantai;48;41;89
626;16.07.2018;2018;07;20;Maanantai;43;37;80
626;16.07.2018;2018;07;21;Maanantai;37;32;69
626;16.07.2018;2018;07;22;Maanantai;27;15;42
626;16.07.2018;2018;07;23;Maanantai;20;13;33
626;17.07.2018;2018;07;00;Tiistai;11;8;19
626;17.07.2018;2018;07;01;Tiistai;3;2;5
626;17.07.2018;2018;07;02;Tiistai;2;2;4
626;17.07.2018;2018;07;03;Tiistai;3;2;5
626;17.07.2018;2018;07;04;Tiistai;1;1;2
626;17.07.2018;2018;07;05;Tiistai;1;5;6
626;17.07.2018;2018;07;06;Tiistai;9;16;25
626;17.07.2018;2018;07;07;Tiistai;12;49;61
626;17.07.2018;2018;07;08;Tiistai;32;70;102
626;17.07.2018;2018;07;09;Tiistai;28;50;78
626;17.07.2018;2018;07;10;Tiistai;25;43;68
626;17.07.2018;2018;07;11;Tiistai;23;41;64
626;17.07.2018;2018;07;12;Tiistai;28;37;65
626;17.07.2018;2018;07;13;Tiistai;30;41;71
626;17.07.2018;2018;07;14;Tiistai;29;33;62
626;17.07.2018;2018;07;15;Tiistai;63;36;99
626;17.07.2018;2018;07;16;Tiistai;56;45;101
626;17.07.2018;2018;07;17;Tiistai;82;70;152
626;17.07.2018;2018;07;18;Tiistai;61;47;108
626;17.07.2018;2018;07;19;Tiistai;33;36;69
626;17.07.2018;2018;07;20;Tiistai;41;39;80
626;17.07.2018;2018;07;21;Tiistai;30;25;55
626;17.07.2018;2018;07;22;Tiistai;24;28;52
626;17.07.2018;2018;07;23;Tiistai;19;13;32
626;18.07.2018;2018;07;00;Keskiviikko;13;6;19
626;18.07.2018;2018;07;01;Keskiviikko;6;3;9
626;18.07.2018;2018;07;02;Keskiviikko;0;2;2
626;18.07.2018;2018;07;03;Keskiviikko;5;2;7
626;18.07.2018;2018;07;04;Keskiviikko;2;1;3
626;18.07.2018;2018;07;05;Keskiviikko;3;4;7
626;18.07.2018;2018;07;06;Keskiviikko;7;18;25
626;18.07.2018;2018;07;07;Keskiviikko;10;43;53
626;18.07.2018;2018;07;08;Keskiviikko;23;58;81
626;18.07.2018;2018;07;09;Keskiviikko;20;44;64
626;18.07.2018;2018;07;10;Keskiviikko;16;41;57
626;18.07.2018;2018;07;11;Keskiviikko;21;40;61
626;18.07.2018;2018;07;12;Keskiviikko;31;42;73
626;18.07.2018;2018;07;13;Keskiviikko;28;34;62
626;18.07.2018;2018;07;14;Keskiviikko;28;32;60
626;18.07.2018;2018;07;15;Keskiviikko;39;32;71
626;18.07.2018;2018;07;16;Keskiviikko;68;46;114
626;18.07.2018;2018;07;17;Keskiviikko;78;56;134
626;18.07.2018;2018;07;18;Keskiviikko;61;29;90
626;18.07.2018;2018;07;19;Keskiviikko;26;27;53
626;18.07.2018;2018;07;20;Keskiviikko;25;13;38
626;18.07.2018;2018;07;21;Keskiviikko;31;32;63
626;18.07.2018;2018;07;22;Keskiviikko;27;27;54
626;18.07.2018;2018;07;23;Keskiviikko;15;12;27
626;19.07.2018;2018;07;00;Torstai;11;5;16
626;19.07.2018;2018;07;01;Torstai;2;3;5
626;19.07.2018;2018;07;02;Torstai;6;1;7
626;19.07.2018;2018;07;03;Torstai;4;0;4
626;19.07.2018;2018;07;04;Torstai;1;4;5
626;19.07.2018;2018;07;05;Torstai;3;3;6
626;19.07.2018;2018;07;06;Torstai;8;17;25
626;19.07.2018;2018;07;07;Torstai;8;39;47
626;19.07.2018;2018;07;08;Torstai;20;57;77
626;19.07.2018;2018;07;09;Torstai;32;54;86
626;19.07.2018;2018;07;10;Torstai;19;25;44
626;19.07.2018;2018;07;11;Torstai;23;25;48
626;19.07.2018;2018;07;12;Torstai;26;36;62
626;19.07.2018;2018;07;13;Torstai;27;36;63
626;19.07.2018;2018;07;14;Torstai;31;39;70
626;19.07.2018;2018;07;15;Torstai;42;36;78
626;19.07.2018;2018;07;16;Torstai;53;48;101
626;19.07.2018;2018;07;17;Torstai;75;51;126
626;19.07.2018;2018;07;18;Torstai;62;44;106
626;19.07.2018;2018;07;19;Torstai;26;34;60
626;19.07.2018;2018;07;20;Torstai;37;32;69
626;19.07.2018;2018;07;21;Torstai;27;30;57
626;19.07.2018;2018;07;22;Torstai;28;24;52
626;19.07.2018;2018;07;23;Torstai;19;11;30
626;20.07.2018;2018;07;00;Perjantai;12;11;23
626;20.07.2018;2018;07;01;Perjantai;8;4;12
626;20.07.2018;2018;07;02;Perjantai;5;3;8
626;20.07.2018;2018;07;03;Perjantai;3;2;5
626;20.07.2018;2018;07;04;Perjantai;5;1;6
626;20.07.2018;2018;07;05;Perjantai;4;1;5
626;20.07.2018;2018;07;06;Perjantai;10;16;26
626;20.07.2018;2018;07;07;Perjantai;13;37;50
626;20.07.2018;2018;07;08;Perjantai;17;45;62
626;20.07.2018;2018;07;09;Perjantai;21;38;59
626;20.07.2018;2018;07;10;Perjantai;17;29;46
626;20.07.2018;2018;07;11;Perjantai;13;24;37
626;20.07.2018;2018;07;12;Perjantai;25;23;48
626;20.07.2018;2018;07;13;Perjantai;32;38;70
626;20.07.2018;2018;07;14;Perjantai;39;39;78
626;20.07.2018;2018;07;15;Perjantai;40;29;69
626;20.07.2018;2018;07;16;Perjantai;59;51;110
626;20.07.2018;2018;07;17;Perjantai;52;52;104
626;20.07.2018;2018;07;18;Perjantai;40;37;77
626;20.07.2018;2018;07;19;Perjantai;37;19;56
626;20.07.2018;2018;07;20;Perjantai;26;22;48
626;20.07.2018;2018;07;21;Perjantai;27;36;63
626;20.07.2018;2018;07;22;Perjantai;24;20;44
626;20.07.2018;2018;07;23;Perjantai;18;9;27
626;21.07.2018;2018;07;00;Lauantai;12;9;21
626;21.07.2018;2018;07;01;Lauantai;7;5;12
626;21.07.2018;2018;07;02;Lauantai;12;2;14
626;21.07.2018;2018;07;03;Lauantai;9;0;9
626;21.07.2018;2018;07;04;Lauantai;11;1;12
626;21.07.2018;2018;07;05;Lauantai;3;0;3
626;21.07.2018;2018;07;06;Lauantai;6;4;10
626;21.07.2018;2018;07;07;Lauantai;5;5;10
626;21.07.2018;2018;07;08;Lauantai;5;6;11
626;21.07.2018;2018;07;09;Lauantai;6;11;17
626;21.07.2018;2018;07;10;Lauantai;7;14;21
626;21.07.2018;2018;07;11;Lauantai;14;13;27
626;21.07.2018;2018;07;12;Lauantai;13;23;36
626;21.07.2018;2018;07;13;Lauantai;18;12;30
626;21.07.2018;2018;07;14;Lauantai;18;9;27
626;21.07.2018;2018;07;15;Lauantai;20;31;51
626;21.07.2018;2018;07;16;Lauantai;18;19;37
626;21.07.2018;2018;07;17;Lauantai;18;14;32
626;21.07.2018;2018;07;18;Lauantai;16;21;37
626;21.07.2018;2018;07;19;Lauantai;18;18;36
626;21.07.2018;2018;07;20;Lauantai;11;17;28
626;21.07.2018;2018;07;21;Lauantai;11;17;28
626;21.07.2018;2018;07;22;Lauantai;8;12;20
626;21.07.2018;2018;07;23;Lauantai;4;14;18
626;22.07.2018;2018;07;00;Sunnuntai;4;2;6
626;22.07.2018;2018;07;01;Sunnuntai;7;3;10
626;22.07.2018;2018;07;02;Sunnuntai;5;2;7
626;22.07.2018;2018;07;03;Sunnuntai;3;3;6
626;22.07.2018;2018;07;04;Sunnuntai;6;0;6
626;22.07.2018;2018;07;05;Sunnuntai;2;0;2
626;22.07.2018;2018;07;06;Sunnuntai;9;1;10
626;22.07.2018;2018;07;07;Sunnuntai;4;3;7
626;22.07.2018;2018;07;08;Sunnuntai;2;4;6
626;22.07.2018;2018;07;09;Sunnuntai;8;4;12
626;22.07.2018;2018;07;10;Sunnuntai;8;11;19
626;22.07.2018;2018;07;11;Sunnuntai;12;16;28
626;22.07.2018;2018;07;12;Sunnuntai;14;31;45
626;22.07.2018;2018;07;13;Sunnuntai;34;49;83
626;22.07.2018;2018;07;14;Sunnuntai;50;31;81
626;22.07.2018;2018;07;15;Sunnuntai;33;32;65
626;22.07.2018;2018;07;16;Sunnuntai;27;33;60
626;22.07.2018;2018;07;17;Sunnuntai;16;13;29
626;22.07.2018;2018;07;18;Sunnuntai;17;7;24
626;22.07.2018;2018;07;19;Sunnuntai;22;21;43
626;22.07.2018;2018;07;20;Sunnuntai;10;9;19
626;22.07.2018;2018;07;21;Sunnuntai;11;10;21
626;22.07.2018;2018;07;22;Sunnuntai;6;6;12
626;22.07.2018;2018;07;23;Sunnuntai;6;3;9
626;23.07.2018;2018;07;00;Maanantai;3;2;5
626;23.07.2018;2018;07;01;Maanantai;1;0;1
626;23.07.2018;2018;07;02;Maanantai;0;0;0
626;23.07.2018;2018;07;03;Maanantai;0;2;2
626;23.07.2018;2018;07;04;Maanantai;0;1;1
626;23.07.2018;2018;07;05;Maanantai;1;4;5
626;23.07.2018;2018;07;06;Maanantai;6;8;14
626;23.07.2018;2018;07;07;Maanantai;13;33;46
626;23.07.2018;2018;07;08;Maanantai;16;63;79
626;23.07.2018;2018;07;09;Maanantai;21;40;61
626;23.07.2018;2018;07;10;Maanantai;12;29;41
626;23.07.2018;2018;07;11;Maanantai;17;13;30
626;23.07.2018;2018;07;12;Maanantai;30;26;56
626;23.07.2018;2018;07;13;Maanantai;23;21;44
626;23.07.2018;2018;07;14;Maanantai;35;38;73
626;23.07.2018;2018;07;15;Maanantai;44;45;89
626;23.07.2018;2018;07;16;Maanantai;60;44;104
626;23.07.2018;2018;07;17;Maanantai;101;61;162
626;23.07.2018;2018;07;18;Maanantai;60;63;123
626;23.07.2018;2018;07;19;Maanantai;40;46;86
626;23.07.2018;2018;07;20;Maanantai;49;43;92
626;23.07.2018;2018;07;21;Maanantai;45;42;87
626;23.07.2018;2018;07;22;Maanantai;30;22;52
626;23.07.2018;2018;07;23;Maanantai;18;11;29
626;24.07.2018;2018;07;00;Tiistai;2;5;7
626;24.07.2018;2018;07;01;Tiistai;2;3;5
626;24.07.2018;2018;07;02;Tiistai;5;2;7
626;24.07.2018;2018;07;03;Tiistai;4;2;6
626;24.07.2018;2018;07;04;Tiistai;1;0;1
626;24.07.2018;2018;07;05;Tiistai;3;3;6
626;24.07.2018;2018;07;06;Tiistai;8;10;18
626;24.07.2018;2018;07;07;Tiistai;16;48;64
626;24.07.2018;2018;07;08;Tiistai;24;73;97
626;24.07.2018;2018;07;09;Tiistai;21;37;58
626;24.07.2018;2018;07;10;Tiistai;14;30;44
626;24.07.2018;2018;07;11;Tiistai;22;23;45
626;24.07.2018;2018;07;12;Tiistai;18;39;57
626;24.07.2018;2018;07;13;Tiistai;31;42;73
626;24.07.2018;2018;07;14;Tiistai;50;33;83
626;24.07.2018;2018;07;15;Tiistai;50;48;98
626;24.07.2018;2018;07;16;Tiistai;67;43;110
626;24.07.2018;2018;07;17;Tiistai;91;64;155
626;24.07.2018;2018;07;18;Tiistai;49;51;100
626;24.07.2018;2018;07;19;Tiistai;54;28;82
626;24.07.2018;2018;07;20;Tiistai;34;29;63
626;24.07.2018;2018;07;21;Tiistai;40;26;66
626;24.07.2018;2018;07;22;Tiistai;30;23;53
626;24.07.2018;2018;07;23;Tiistai;10;18;28
626;25.07.2018;2018;07;00;Keskiviikko;8;4;12
626;25.07.2018;2018;07;01;Keskiviikko;1;2;3
626;25.07.2018;2018;07;02;Keskiviikko;5;2;7
626;25.07.2018;2018;07;03;Keskiviikko;0;3;3
626;25.07.2018;2018;07;04;Keskiviikko;2;4;6
626;25.07.2018;2018;07;05;Keskiviikko;2;2;4
626;25.07.2018;2018;07;06;Keskiviikko;7;15;22
626;25.07.2018;2018;07;07;Keskiviikko;15;38;53
626;25.07.2018;2018;07;08;Keskiviikko;25;76;101
626;25.07.2018;2018;07;09;Keskiviikko;18;52;70
626;25.07.2018;2018;07;10;Keskiviikko;16;26;42
626;25.07.2018;2018;07;11;Keskiviikko;18;42;60
626;25.07.2018;2018;07;12;Keskiviikko;26;36;62
626;25.07.2018;2018;07;13;Keskiviikko;27;44;71
626;25.07.2018;2018;07;14;Keskiviikko;41;37;78
626;25.07.2018;2018;07;15;Keskiviikko;38;31;69
626;25.07.2018;2018;07;16;Keskiviikko;71;34;105
626;25.07.2018;2018;07;17;Keskiviikko;101;65;166
626;25.07.2018;2018;07;18;Keskiviikko;52;40;92
626;25.07.2018;2018;07;19;Keskiviikko;58;35;93
626;25.07.2018;2018;07;20;Keskiviikko;33;38;71
626;25.07.2018;2018;07;21;Keskiviikko;23;25;48
626;25.07.2018;2018;07;22;Keskiviikko;23;31;54
626;25.07.2018;2018;07;23;Keskiviikko;16;13;29
626;26.07.2018;2018;07;00;Torstai;13;2;15
626;26.07.2018;2018;07;01;Torstai;17;5;22
626;26.07.2018;2018;07;02;Torstai;5;1;6
626;26.07.2018;2018;07;03;Torstai;3;1;4
626;26.07.2018;2018;07;04;Torstai;4;0;4
626;26.07.2018;2018;07;05;Torstai;1;2;3
626;26.07.2018;2018;07;06;Torstai;13;9;22
626;26.07.2018;2018;07;07;Torstai;8;29;37
626;26.07.2018;2018;07;08;Torstai;18;63;81
626;26.07.2018;2018;07;09;Torstai;25;51;76
626;26.07.2018;2018;07;10;Torstai;12;25;37
626;26.07.2018;2018;07;11;Torstai;13;36;49
626;26.07.2018;2018;07;12;Torstai;32;30;62
626;26.07.2018;2018;07;13;Torstai;33;38;71
626;26.07.2018;2018;07;14;Torstai;32;30;62
626;26.07.2018;2018;07;15;Torstai;44;33;77
626;26.07.2018;2018;07;16;Torstai;76;39;115
626;26.07.2018;2018;07;17;Torstai;75;46;121
626;26.07.2018;2018;07;18;Torstai;47;38;85
626;26.07.2018;2018;07;19;Torstai;39;42;81
626;26.07.2018;2018;07;20;Torstai;18;23;41
626;26.07.2018;2018;07;21;Torstai;20;15;35
626;26.07.2018;2018;07;22;Torstai;15;16;31
626;26.07.2018;2018;07;23;Torstai;11;6;17
626;27.07.2018;2018;07;00;Perjantai;11;6;17
626;27.07.2018;2018;07;01;Perjantai;6;4;10
626;27.07.2018;2018;07;02;Perjantai;4;2;6
626;27.07.2018;2018;07;03;Perjantai;2;2;4
626;27.07.2018;2018;07;04;Perjantai;0;1;1
626;27.07.2018;2018;07;05;Perjantai;1;1;2
626;27.07.2018;2018;07;06;Perjantai;7;7;14
626;27.07.2018;2018;07;07;Perjantai;11;27;38
626;27.07.2018;2018;07;08;Perjantai;21;56;77
626;27.07.2018;2018;07;09;Perjantai;23;30;53
626;27.07.2018;2018;07;10;Perjantai;11;34;45
626;27.07.2018;2018;07;11;Perjantai;20;28;48
626;27.07.2018;2018;07;12;Perjantai;26;56;82
626;27.07.2018;2018;07;13;Perjantai;38;47;85
626;27.07.2018;2018;07;14;Perjantai;46;43;89
626;27.07.2018;2018;07;15;Perjantai;54;77;131
626;27.07.2018;2018;07;16;Perjantai;73;70;143
626;27.07.2018;2018;07;17;Perjantai;66;70;136
626;27.07.2018;2018;07;18;Perjantai;41;56;97
626;27.07.2018;2018;07;19;Perjantai;31;36;67
626;27.07.2018;2018;07;20;Perjantai;28;38;66
626;27.07.2018;2018;07;21;Perjantai;39;26;65
626;27.07.2018;2018;07;22;Perjantai;28;18;46
626;27.07.2018;2018;07;23;Perjantai;22;10;32
626;28.07.2018;2018;07;00;Lauantai;23;8;31
626;28.07.2018;2018;07;01;Lauantai;42;6;48
626;28.07.2018;2018;07;02;Lauantai;45;9;54
626;28.07.2018;2018;07;03;Lauantai;23;2;25
626;28.07.2018;2018;07;04;Lauantai;13;0;13
626;28.07.2018;2018;07;05;Lauantai;13;7;20
626;28.07.2018;2018;07;06;Lauantai;8;1;9
626;28.07.2018;2018;07;07;Lauantai;4;3;7
626;28.07.2018;2018;07;08;Lauantai;4;3;7
626;28.07.2018;2018;07;09;Lauantai;9;6;15
626;28.07.2018;2018;07;10;Lauantai;9;17;26
626;28.07.2018;2018;07;11;Lauantai;13;27;40
626;28.07.2018;2018;07;12;Lauantai;24;28;52
626;28.07.2018;2018;07;13;Lauantai;28;65;93
626;28.07.2018;2018;07;14;Lauantai;34;59;93
626;28.07.2018;2018;07;15;Lauantai;33;68;101
626;28.07.2018;2018;07;16;Lauantai;34;50;84
626;28.07.2018;2018;07;17;Lauantai;40;41;81
626;28.07.2018;2018;07;18;Lauantai;43;55;98
626;28.07.2018;2018;07;19;Lauantai;27;34;61
626;28.07.2018;2018;07;20;Lauantai;23;26;49
626;28.07.2018;2018;07;21;Lauantai;28;19;47
626;28.07.2018;2018;07;22;Lauantai;20;29;49
626;28.07.2018;2018;07;23;Lauantai;19;15;34
626;29.07.2018;2018;07;00;Sunnuntai;24;5;29
626;29.07.2018;2018;07;01;Sunnuntai;28;8;36
626;29.07.2018;2018;07;02;Sunnuntai;59;9;68
626;29.07.2018;2018;07;03;Sunnuntai;43;7;50
626;29.07.2018;2018;07;04;Sunnuntai;19;0;19
626;29.07.2018;2018;07;05;Sunnuntai;10;0;10
626;29.07.2018;2018;07;06;Sunnuntai;7;1;8
626;29.07.2018;2018;07;07;Sunnuntai;5;5;10
626;29.07.2018;2018;07;08;Sunnuntai;2;4;6
626;29.07.2018;2018;07;09;Sunnuntai;9;8;17
626;29.07.2018;2018;07;10;Sunnuntai;15;22;37
626;29.07.2018;2018;07;11;Sunnuntai;33;24;57
626;29.07.2018;2018;07;12;Sunnuntai;16;38;54
626;29.07.2018;2018;07;13;Sunnuntai;30;53;83
626;29.07.2018;2018;07;14;Sunnuntai;46;39;85
626;29.07.2018;2018;07;15;Sunnuntai;38;35;73
626;29.07.2018;2018;07;16;Sunnuntai;27;35;62
626;29.07.2018;2018;07;17;Sunnuntai;36;40;76
626;29.07.2018;2018;07;18;Sunnuntai;29;42;71
626;29.07.2018;2018;07;19;Sunnuntai;44;30;74
626;29.07.2018;2018;07;20;Sunnuntai;29;25;54
626;29.07.2018;2018;07;21;Sunnuntai;16;20;36
626;29.07.2018;2018;07;22;Sunnuntai;25;15;40
626;29.07.2018;2018;07;23;Sunnuntai;10;9;19
626;30.07.2018;2018;07;00;Maanantai;4;1;5
626;30.07.2018;2018;07;01;Maanantai;5;1;6
626;30.07.2018;2018;07;02;Maanantai;1;1;2
626;30.07.2018;2018;07;03;Maanantai;2;2;4
626;30.07.2018;2018;07;04;Maanantai;0;0;0
626;30.07.2018;2018;07;05;Maanantai;0;3;3
626;30.07.2018;2018;07;06;Maanantai;9;10;19
626;30.07.2018;2018;07;07;Maanantai;15;47;62
626;30.07.2018;2018;07;08;Maanantai;26;80;106
626;30.07.2018;2018;07;09;Maanantai;21;51;72
626;30.07.2018;2018;07;10;Maanantai;14;29;43
626;30.07.2018;2018;07;11;Maanantai;10;39;49
626;30.07.2018;2018;07;12;Maanantai;20;36;56
626;30.07.2018;2018;07;13;Maanantai;22;29;51
626;30.07.2018;2018;07;14;Maanantai;49;51;100
626;30.07.2018;2018;07;15;Maanantai;44;41;85
626;30.07.2018;2018;07;16;Maanantai;65;31;96
626;30.07.2018;2018;07;17;Maanantai;99;62;161
626;30.07.2018;2018;07;18;Maanantai;46;43;89
626;30.07.2018;2018;07;19;Maanantai;47;23;70
626;30.07.2018;2018;07;20;Maanantai;34;28;62
626;30.07.2018;2018;07;21;Maanantai;33;24;57
626;30.07.2018;2018;07;22;Maanantai;33;24;57
626;30.07.2018;2018;07;23;Maanantai;13;10;23
626;31.07.2018;2018;07;00;Tiistai;2;4;6
626;31.07.2018;2018;07;01;Tiistai;7;4;11
626;31.07.2018;2018;07;02;Tiistai;1;0;1
626;31.07.2018;2018;07;03;Tiistai;1;0;1
626;31.07.2018;2018;07;04;Tiistai;3;0;3
626;31.07.2018;2018;07;05;Tiistai;5;4;9
626;31.07.2018;2018;07;06;Tiistai;9;12;21
626;31.07.2018;2018;07;07;Tiistai;14;47;61
626;31.07.2018;2018;07;08;Tiistai;30;91;121
626;31.07.2018;2018;07;09;Tiistai;16;59;75
626;31.07.2018;2018;07;10;Tiistai;13;24;37
626;31.07.2018;2018;07;11;Tiistai;17;24;41
626;31.07.2018;2018;07;12;Tiistai;31;31;62
626;31.07.2018;2018;07;13;Tiistai;21;34;55
626;31.07.2018;2018;07;14;Tiistai;31;35;66
626;31.07.2018;2018;07;15;Tiistai;48;43;91
626;31.07.2018;2018;07;16;Tiistai;81;48;129
626;31.07.2018;2018;07;17;Tiistai;84;36;120
626;31.07.2018;2018;07;18;Tiistai;51;29;80
626;31.07.2018;2018;07;19;Tiistai;53;41;94
626;31.07.2018;2018;07;20;Tiistai;30;29;59
626;31.07.2018;2018;07;21;Tiistai;23;24;47
626;31.07.2018;2018;07;22;Tiistai;27;18;45
626;31.07.2018;2018;07;23;Tiistai;16;10;26
626;01.08.2018;2018;08;00;Keskiviikko;8;2;10
626;01.08.2018;2018;08;01;Keskiviikko;2;2;4
626;01.08.2018;2018;08;02;Keskiviikko;2;0;2
626;01.08.2018;2018;08;03;Keskiviikko;1;0;1
626;01.08.2018;2018;08;04;Keskiviikko;0;0;0
626;01.08.2018;2018;08;05;Keskiviikko;1;1;2
626;01.08.2018;2018;08;06;Keskiviikko;7;12;19
626;01.08.2018;2018;08;07;Keskiviikko;10;37;47
626;01.08.2018;2018;08;08;Keskiviikko;14;73;87
626;01.08.2018;2018;08;09;Keskiviikko;24;30;54
626;01.08.2018;2018;08;10;Keskiviikko;11;19;30
626;01.08.2018;2018;08;11;Keskiviikko;16;24;40
626;01.08.2018;2018;08;12;Keskiviikko;18;33;51
626;01.08.2018;2018;08;13;Keskiviikko;29;31;60
626;01.08.2018;2018;08;14;Keskiviikko;26;25;51
626;01.08.2018;2018;08;15;Keskiviikko;32;31;63
626;01.08.2018;2018;08;16;Keskiviikko;57;46;103
626;01.08.2018;2018;08;17;Keskiviikko;72;40;112
626;01.08.2018;2018;08;18;Keskiviikko;44;19;63
626;01.08.2018;2018;08;19;Keskiviikko;24;20;44
626;01.08.2018;2018;08;20;Keskiviikko;26;17;43
626;01.08.2018;2018;08;21;Keskiviikko;19;22;41
626;01.08.2018;2018;08;22;Keskiviikko;25;29;54
626;01.08.2018;2018;08;23;Keskiviikko;8;8;16
626;02.08.2018;2018;08;00;Torstai;15;7;22
626;02.08.2018;2018;08;01;Torstai;22;1;23
626;02.08.2018;2018;08;02;Torstai;6;0;6
626;02.08.2018;2018;08;03;Torstai;4;0;4
626;02.08.2018;2018;08;04;Torstai;4;0;4
626;02.08.2018;2018;08;05;Torstai;3;0;3
626;02.08.2018;2018;08;06;Torstai;22;0;22
626;02.08.2018;2018;08;07;Torstai;37;0;37
626;02.08.2018;2018;08;08;Torstai;81;0;81
626;02.08.2018;2018;08;09;Torstai;76;0;76
626;02.08.2018;2018;08;10;Torstai;37;0;37
626;02.08.2018;2018;08;11;Torstai;49;0;49
626;02.08.2018;2018;08;12;Torstai;62;0;62
626;02.08.2018;2018;08;13;Torstai;71;0;71
626;02.08.2018;2018;08;14;Torstai;62;0;62
626;02.08.2018;2018;08;15;Torstai;77;0;77
626;02.08.2018;2018;08;16;Torstai;115;0;115
626;02.08.2018;2018;08;17;Torstai;121;0;121
626;02.08.2018;2018;08;18;Torstai;85;0;85
626;02.08.2018;2018;08;19;Torstai;81;0;81
626;02.08.2018;2018;08;20;Torstai;41;0;41
626;02.08.2018;2018;08;21;Torstai;35;0;35
626;02.08.2018;2018;08;22;Torstai;31;0;31
626;02.08.2018;2018;08;23;Torstai;17;0;17
626;03.08.2018;2018;08;00;Perjantai;17;0;17
626;03.08.2018;2018;08;01;Perjantai;10;0;10
626;03.08.2018;2018;08;02;Perjantai;6;0;6
626;03.08.2018;2018;08;03;Perjantai;4;0;4
626;03.08.2018;2018;08;04;Perjantai;1;0;1
626;03.08.2018;2018;08;05;Perjantai;2;0;2
626;03.08.2018;2018;08;06;Perjantai;14;0;14
626;03.08.2018;2018;08;07;Perjantai;38;0;38
626;03.08.2018;2018;08;08;Perjantai;77;0;77
626;03.08.2018;2018;08;09;Perjantai;53;0;53
626;03.08.2018;2018;08;10;Perjantai;45;0;45
626;03.08.2018;2018;08;11;Perjantai;48;0;48
626;03.08.2018;2018;08;12;Perjantai;82;0;82
626;03.08.2018;2018;08;13;Perjantai;85;0;85
626;03.08.2018;2018;08;14;Perjantai;89;0;89
626;03.08.2018;2018;08;15;Perjantai;131;0;131
626;03.08.2018;2018;08;16;Perjantai;143;0;143
626;03.08.2018;2018;08;17;Perjantai;136;0;136
626;03.08.2018;2018;08;18;Perjantai;97;0;97
626;03.08.2018;2018;08;19;Perjantai;67;0;67
626;03.08.2018;2018;08;20;Perjantai;66;0;66
626;03.08.2018;2018;08;21;Perjantai;65;0;65
626;03.08.2018;2018;08;22;Perjantai;46;0;46
626;03.08.2018;2018;08;23;Perjantai;32;0;32
626;04.08.2018;2018;08;00;Lauantai;31;0;31
626;04.08.2018;2018;08;01;Lauantai;48;0;48
626;04.08.2018;2018;08;02;Lauantai;54;0;54
626;04.08.2018;2018;08;03;Lauantai;25;0;25
626;04.08.2018;2018;08;04;Lauantai;13;0;13
626;04.08.2018;2018;08;05;Lauantai;20;0;20
626;04.08.2018;2018;08;06;Lauantai;9;0;9
626;04.08.2018;2018;08;07;Lauantai;7;0;7
626;04.08.2018;2018;08;08;Lauantai;7;0;7
626;04.08.2018;2018;08;09;Lauantai;15;0;15
626;04.08.2018;2018;08;10;Lauantai;26;0;26
626;04.08.2018;2018;08;11;Lauantai;40;0;40
626;04.08.2018;2018;08;12;Lauantai;52;0;52
626;04.08.2018;2018;08;13;Lauantai;93;0;93
626;04.08.2018;2018;08;14;Lauantai;93;0;93
626;04.08.2018;2018;08;15;Lauantai;101;0;101
626;04.08.2018;2018;08;16;Lauantai;84;0;84
626;04.08.2018;2018;08;17;Lauantai;81;0;81
626;04.08.2018;2018;08;18;Lauantai;98;0;98
626;04.08.2018;2018;08;19;Lauantai;61;0;61
626;04.08.2018;2018;08;20;Lauantai;49;0;49
626;04.08.2018;2018;08;21;Lauantai;47;0;47
626;04.08.2018;2018;08;22;Lauantai;49;0;49
626;04.08.2018;2018;08;23;Lauantai;34;0;34
626;05.08.2018;2018;08;00;Sunnuntai;29;0;29
626;05.08.2018;2018;08;01;Sunnuntai;36;0;36
626;05.08.2018;2018;08;02;Sunnuntai;68;0;68
626;05.08.2018;2018;08;03;Sunnuntai;50;0;50
626;05.08.2018;2018;08;04;Sunnuntai;19;0;19
626;05.08.2018;2018;08;05;Sunnuntai;10;0;10
626;05.08.2018;2018;08;06;Sunnuntai;8;0;8
626;05.08.2018;2018;08;07;Sunnuntai;10;0;10
626;05.08.2018;2018;08;08;Sunnuntai;6;0;6
626;05.08.2018;2018;08;09;Sunnuntai;17;0;17
626;05.08.2018;2018;08;10;Sunnuntai;37;0;37
626;05.08.2018;2018;08;11;Sunnuntai;57;0;57
626;05.08.2018;2018;08;12;Sunnuntai;54;0;54
626;05.08.2018;2018;08;13;Sunnuntai;83;0;83
626;05.08.2018;2018;08;14;Sunnuntai;85;0;85
626;05.08.2018;2018;08;15;Sunnuntai;73;0;73
626;05.08.2018;2018;08;16;Sunnuntai;62;0;62
626;05.08.2018;2018;08;17;Sunnuntai;76;0;76
626;05.08.2018;2018;08;18;Sunnuntai;71;0;71
626;05.08.2018;2018;08;19;Sunnuntai;74;0;74
626;05.08.2018;2018;08;20;Sunnuntai;54;0;54
626;05.08.2018;2018;08;21;Sunnuntai;36;0;36
626;05.08.2018;2018;08;22;Sunnuntai;40;0;40
626;05.08.2018;2018;08;23;Sunnuntai;19;0;19
626;06.08.2018;2018;08;00;Maanantai;3;1;4
626;06.08.2018;2018;08;01;Maanantai;1;3;4
626;06.08.2018;2018;08;02;Maanantai;0;0;0
626;06.08.2018;2018;08;03;Maanantai;1;0;1
626;06.08.2018;2018;08;04;Maanantai;0;1;1
626;06.08.2018;2018;08;05;Maanantai;1;4;5
626;06.08.2018;2018;08;06;Maanantai;7;6;13
626;06.08.2018;2018;08;07;Maanantai;13;33;46
626;06.08.2018;2018;08;08;Maanantai;23;53;76
626;06.08.2018;2018;08;09;Maanantai;20;44;64
626;06.08.2018;2018;08;10;Maanantai;5;13;18
626;06.08.2018;2018;08;11;Maanantai;5;10;15
626;06.08.2018;2018;08;12;Maanantai;10;7;17
626;06.08.2018;2018;08;13;Maanantai;9;11;20
626;06.08.2018;2018;08;14;Maanantai;11;1;12
626;06.08.2018;2018;08;15;Maanantai;12;10;22
626;06.08.2018;2018;08;16;Maanantai;43;18;61
626;06.08.2018;2018;08;17;Maanantai;50;31;81
626;06.08.2018;2018;08;18;Maanantai;39;25;64
626;06.08.2018;2018;08;19;Maanantai;24;19;43
626;06.08.2018;2018;08;20;Maanantai;26;23;49
626;06.08.2018;2018;08;21;Maanantai;18;19;37
626;06.08.2018;2018;08;22;Maanantai;17;9;26
626;06.08.2018;2018;08;23;Maanantai;4;5;9
626;07.08.2018;2018;08;00;Tiistai;2;5;7
626;07.08.2018;2018;08;01;Tiistai;4;3;7
626;07.08.2018;2018;08;02;Tiistai;0;1;1
626;07.08.2018;2018;08;03;Tiistai;1;0;1
626;07.08.2018;2018;08;04;Tiistai;0;1;1
626;07.08.2018;2018;08;05;Tiistai;1;6;7
626;07.08.2018;2018;08;06;Tiistai;6;18;24
626;07.08.2018;2018;08;07;Tiistai;13;54;67
626;07.08.2018;2018;08;08;Tiistai;35;97;132
626;07.08.2018;2018;08;09;Tiistai;28;59;87
626;07.08.2018;2018;08;10;Tiistai;14;29;43
626;07.08.2018;2018;08;11;Tiistai;16;28;44
626;07.08.2018;2018;08;12;Tiistai;25;33;58
626;07.08.2018;2018;08;13;Tiistai;20;29;49
626;07.08.2018;2018;08;14;Tiistai;28;36;64
626;07.08.2018;2018;08;15;Tiistai;38;30;68
626;07.08.2018;2018;08;16;Tiistai;73;52;125
626;07.08.2018;2018;08;17;Tiistai;115;57;172
626;07.08.2018;2018;08;18;Tiistai;61;42;103
626;07.08.2018;2018;08;19;Tiistai;55;39;94
626;07.08.2018;2018;08;20;Tiistai;38;28;66
626;07.08.2018;2018;08;21;Tiistai;22;20;42
626;07.08.2018;2018;08;22;Tiistai;24;23;47
626;07.08.2018;2018;08;23;Tiistai;12;12;24
626;08.08.2018;2018;08;00;Keskiviikko;5;2;7
626;08.08.2018;2018;08;01;Keskiviikko;7;4;11
626;08.08.2018;2018;08;02;Keskiviikko;0;1;1
626;08.08.2018;2018;08;03;Keskiviikko;0;0;0
626;08.08.2018;2018;08;04;Keskiviikko;1;1;2
626;08.08.2018;2018;08;05;Keskiviikko;1;8;9
626;08.08.2018;2018;08;06;Keskiviikko;8;9;17
626;08.08.2018;2018;08;07;Keskiviikko;18;63;81
626;08.08.2018;2018;08;08;Keskiviikko;40;92;132
626;08.08.2018;2018;08;09;Keskiviikko;33;67;100
626;08.08.2018;2018;08;10;Keskiviikko;17;35;52
626;08.08.2018;2018;08;11;Keskiviikko;17;33;50
626;08.08.2018;2018;08;12;Keskiviikko;27;26;53
626;08.08.2018;2018;08;13;Keskiviikko;24;33;57
626;08.08.2018;2018;08;14;Keskiviikko;30;35;65
626;08.08.2018;2018;08;15;Keskiviikko;46;46;92
626;08.08.2018;2018;08;16;Keskiviikko;83;50;133
626;08.08.2018;2018;08;17;Keskiviikko;103;72;175
626;08.08.2018;2018;08;18;Keskiviikko;67;51;118
626;08.08.2018;2018;08;19;Keskiviikko;46;36;82
626;08.08.2018;2018;08;20;Keskiviikko;43;21;64
626;08.08.2018;2018;08;21;Keskiviikko;36;24;60
626;08.08.2018;2018;08;22;Keskiviikko;28;13;41
626;08.08.2018;2018;08;23;Keskiviikko;7;6;13
626;09.08.2018;2018;08;00;Torstai;3;1;4
626;09.08.2018;2018;08;01;Torstai;0;2;2
626;09.08.2018;2018;08;02;Torstai;2;1;3
626;09.08.2018;2018;08;03;Torstai;1;0;1
626;09.08.2018;2018;08;04;Torstai;1;2;3
626;09.08.2018;2018;08;05;Torstai;1;6;7
626;09.08.2018;2018;08;06;Torstai;6;10;16
626;09.08.2018;2018;08;07;Torstai;14;39;53
626;09.08.2018;2018;08;08;Torstai;22;68;90
626;09.08.2018;2018;08;09;Torstai;23;44;67
626;09.08.2018;2018;08;10;Torstai;8;33;41
626;09.08.2018;2018;08;11;Torstai;16;23;39
626;09.08.2018;2018;08;12;Torstai;15;22;37
626;09.08.2018;2018;08;13;Torstai;26;20;46
626;09.08.2018;2018;08;14;Torstai;35;34;69
626;09.08.2018;2018;08;15;Torstai;21;24;45
626;09.08.2018;2018;08;16;Torstai;70;54;124
626;09.08.2018;2018;08;17;Torstai;78;45;123
626;09.08.2018;2018;08;18;Torstai;35;40;75
626;09.08.2018;2018;08;19;Torstai;27;22;49
626;09.08.2018;2018;08;20;Torstai;33;28;61
626;09.08.2018;2018;08;21;Torstai;34;20;54
626;09.08.2018;2018;08;22;Torstai;16;11;27
626;09.08.2018;2018;08;23;Torstai;7;8;15
626;10.08.2018;2018;08;00;Perjantai;7;2;9
626;10.08.2018;2018;08;01;Perjantai;0;2;2
626;10.08.2018;2018;08;02;Perjantai;1;2;3
626;10.08.2018;2018;08;03;Perjantai;2;0;2
626;10.08.2018;2018;08;04;Perjantai;0;0;0
626;10.08.2018;2018;08;05;Perjantai;1;2;3
626;10.08.2018;2018;08;06;Perjantai;10;17;27
626;10.08.2018;2018;08;07;Perjantai;15;44;59
626;10.08.2018;2018;08;08;Perjantai;29;79;108
626;10.08.2018;2018;08;09;Perjantai;30;66;96
626;10.08.2018;2018;08;10;Perjantai;18;35;53
626;10.08.2018;2018;08;11;Perjantai;22;29;51
626;10.08.2018;2018;08;12;Perjantai;19;22;41
626;10.08.2018;2018;08;13;Perjantai;44;43;87
626;10.08.2018;2018;08;14;Perjantai;48;40;88
626;10.08.2018;2018;08;15;Perjantai;41;52;93
626;10.08.2018;2018;08;16;Perjantai;80;50;130
626;10.08.2018;2018;08;17;Perjantai;76;57;133
626;10.08.2018;2018;08;18;Perjantai;42;46;88
626;10.08.2018;2018;08;19;Perjantai;34;34;68
626;10.08.2018;2018;08;20;Perjantai;27;12;39
626;10.08.2018;2018;08;21;Perjantai;18;12;30
626;10.08.2018;2018;08;22;Perjantai;9;6;15
626;10.08.2018;2018;08;23;Perjantai;2;0;2
626;11.08.2018;2018;08;00;Lauantai;4;2;6
626;11.08.2018;2018;08;01;Lauantai;8;2;10
626;11.08.2018;2018;08;02;Lauantai;4;2;6
626;11.08.2018;2018;08;03;Lauantai;4;1;5
626;11.08.2018;2018;08;04;Lauantai;0;0;0
626;11.08.2018;2018;08;05;Lauantai;3;4;7
626;11.08.2018;2018;08;06;Lauantai;2;3;5
626;11.08.2018;2018;08;07;Lauantai;2;1;3
626;11.08.2018;2018;08;08;Lauantai;3;1;4
626;11.08.2018;2018;08;09;Lauantai;2;11;13
626;11.08.2018;2018;08;10;Lauantai;11;22;33
626;11.08.2018;2018;08;11;Lauantai;24;31;55
626;11.08.2018;2018;08;12;Lauantai;34;39;73
626;11.08.2018;2018;08;13;Lauantai;26;37;63
626;11.08.2018;2018;08;14;Lauantai;27;27;54
626;11.08.2018;2018;08;15;Lauantai;26;15;41
626;11.08.2018;2018;08;16;Lauantai;21;32;53
626;11.08.2018;2018;08;17;Lauantai;23;27;50
626;11.08.2018;2018;08;18;Lauantai;23;18;41
626;11.08.2018;2018;08;19;Lauantai;17;18;35
626;11.08.2018;2018;08;20;Lauantai;9;14;23
626;11.08.2018;2018;08;21;Lauantai;9;10;19
626;11.08.2018;2018;08;22;Lauantai;9;7;16
626;11.08.2018;2018;08;23;Lauantai;9;4;13
626;12.08.2018;2018;08;00;Sunnuntai;2;8;10
626;12.08.2018;2018;08;01;Sunnuntai;4;4;8
626;12.08.2018;2018;08;02;Sunnuntai;0;5;5
626;12.08.2018;2018;08;03;Sunnuntai;4;3;7
626;12.08.2018;2018;08;04;Sunnuntai;3;2;5
626;12.08.2018;2018;08;05;Sunnuntai;3;1;4
626;12.08.2018;2018;08;06;Sunnuntai;5;2;7
626;12.08.2018;2018;08;07;Sunnuntai;0;4;4
626;12.08.2018;2018;08;08;Sunnuntai;4;4;8
626;12.08.2018;2018;08;09;Sunnuntai;3;6;9
626;12.08.2018;2018;08;10;Sunnuntai;14;17;31
626;12.08.2018;2018;08;11;Sunnuntai;22;22;44
626;12.08.2018;2018;08;12;Sunnuntai;29;36;65
626;12.08.2018;2018;08;13;Sunnuntai;20;28;48
626;12.08.2018;2018;08;14;Sunnuntai;34;45;79
626;12.08.2018;2018;08;15;Sunnuntai;33;32;65
626;12.08.2018;2018;08;16;Sunnuntai;38;38;76
626;12.08.2018;2018;08;17;Sunnuntai;38;30;68
626;12.08.2018;2018;08;18;Sunnuntai;33;25;58
626;12.08.2018;2018;08;19;Sunnuntai;20;33;53
626;12.08.2018;2018;08;20;Sunnuntai;25;26;51
626;12.08.2018;2018;08;21;Sunnuntai;16;16;32
626;12.08.2018;2018;08;22;Sunnuntai;12;4;16
626;12.08.2018;2018;08;23;Sunnuntai;4;3;7
626;13.08.2018;2018;08;00;Maanantai;3;1;4
626;13.08.2018;2018;08;01;Maanantai;1;3;4
626;13.08.2018;2018;08;02;Maanantai;0;0;0
626;13.08.2018;2018;08;03;Maanantai;1;0;1
626;13.08.2018;2018;08;04;Maanantai;0;1;1
626;13.08.2018;2018;08;05;Maanantai;1;4;5
626;13.08.2018;2018;08;06;Maanantai;7;6;13
626;13.08.2018;2018;08;07;Maanantai;13;33;46
626;13.08.2018;2018;08;08;Maanantai;23;53;76
626;13.08.2018;2018;08;09;Maanantai;20;44;64
626;13.08.2018;2018;08;10;Maanantai;8;19;27
626;13.08.2018;2018;08;11;Maanantai;12;12;24
626;13.08.2018;2018;08;12;Maanantai;15;14;29
626;13.08.2018;2018;08;13;Maanantai;16;16;32
626;13.08.2018;2018;08;14;Maanantai;20;17;37
626;13.08.2018;2018;08;15;Maanantai;27;24;51
626;13.08.2018;2018;08;16;Maanantai;41;24;65
626;13.08.2018;2018;08;17;Maanantai;40;31;71
626;13.08.2018;2018;08;18;Maanantai;28;31;59
626;13.08.2018;2018;08;19;Maanantai;28;19;47
626;13.08.2018;2018;08;20;Maanantai;27;10;37
626;13.08.2018;2018;08;21;Maanantai;21;24;45
626;13.08.2018;2018;08;22;Maanantai;12;8;20
626;13.08.2018;2018;08;23;Maanantai;1;4;5
626;14.08.2018;2018;08;00;Tiistai;3;0;3
626;14.08.2018;2018;08;01;Tiistai;2;1;3
626;14.08.2018;2018;08;02;Tiistai;0;0;0
626;14.08.2018;2018;08;03;Tiistai;0;0;0
626;14.08.2018;2018;08;04;Tiistai;0;0;0
626;14.08.2018;2018;08;05;Tiistai;1;3;4
626;14.08.2018;2018;08;06;Tiistai;8;12;20
626;14.08.2018;2018;08;07;Tiistai;22;56;78
626;14.08.2018;2018;08;08;Tiistai;37;94;131
626;14.08.2018;2018;08;09;Tiistai;27;82;109
626;14.08.2018;2018;08;10;Tiistai;23;48;71
626;14.08.2018;2018;08;11;Tiistai;23;28;51
626;14.08.2018;2018;08;12;Tiistai;22;17;39
626;14.08.2018;2018;08;13;Tiistai;24;27;51
626;14.08.2018;2018;08;14;Tiistai;30;42;72
626;14.08.2018;2018;08;15;Tiistai;41;41;82
626;14.08.2018;2018;08;16;Tiistai;75;45;120
626;14.08.2018;2018;08;17;Tiistai;103;40;143
626;14.08.2018;2018;08;18;Tiistai;55;34;89
626;14.08.2018;2018;08;19;Tiistai;42;34;76
626;14.08.2018;2018;08;20;Tiistai;24;23;47
626;14.08.2018;2018;08;21;Tiistai;26;21;47
626;14.08.2018;2018;08;22;Tiistai;23;6;29
626;14.08.2018;2018;08;23;Tiistai;15;5;20
626;15.08.2018;2018;08;00;Keskiviikko;6;1;7
626;15.08.2018;2018;08;01;Keskiviikko;0;1;1
626;15.08.2018;2018;08;02;Keskiviikko;0;0;0
626;15.08.2018;2018;08;03;Keskiviikko;0;1;1
626;15.08.2018;2018;08;04;Keskiviikko;1;0;1
626;15.08.2018;2018;08;05;Keskiviikko;0;2;2
626;15.08.2018;2018;08;06;Keskiviikko;7;9;16
626;15.08.2018;2018;08;07;Keskiviikko;16;50;66
626;15.08.2018;2018;08;08;Keskiviikko;31;99;130
626;15.08.2018;2018;08;09;Keskiviikko;22;42;64
626;15.08.2018;2018;08;10;Keskiviikko;15;28;43
626;15.08.2018;2018;08;11;Keskiviikko;17;23;40
626;15.08.2018;2018;08;12;Keskiviikko;16;25;41
626;15.08.2018;2018;08;13;Keskiviikko;14;17;31
626;15.08.2018;2018;08;14;Keskiviikko;21;16;37
626;15.08.2018;2018;08;15;Keskiviikko;39;36;75
626;15.08.2018;2018;08;16;Keskiviikko;66;54;120
626;15.08.2018;2018;08;17;Keskiviikko;89;44;133
626;15.08.2018;2018;08;18;Keskiviikko;60;40;100
626;15.08.2018;2018;08;19;Keskiviikko;31;27;58
626;15.08.2018;2018;08;20;Keskiviikko;28;23;51
626;15.08.2018;2018;08;21;Keskiviikko;19;16;35
626;15.08.2018;2018;08;22;Keskiviikko;13;7;20
626;15.08.2018;2018;08;23;Keskiviikko;4;3;7
626;16.08.2018;2018;08;00;Torstai;3;3;6
626;16.08.2018;2018;08;01;Torstai;1;0;1
626;16.08.2018;2018;08;02;Torstai;1;0;1
626;16.08.2018;2018;08;03;Torstai;0;0;0
626;16.08.2018;2018;08;04;Torstai;0;0;0
626;16.08.2018;2018;08;05;Torstai;2;5;7
626;16.08.2018;2018;08;06;Torstai;9;11;20
626;16.08.2018;2018;08;07;Torstai;13;41;54
626;16.08.2018;2018;08;08;Torstai;28;94;122
626;16.08.2018;2018;08;09;Torstai;21;60;81
626;16.08.2018;2018;08;10;Torstai;16;40;56
626;16.08.2018;2018;08;11;Torstai;7;23;30
626;16.08.2018;2018;08;12;Torstai;16;19;35
626;16.08.2018;2018;08;13;Torstai;20;28;48
626;16.08.2018;2018;08;14;Torstai;35;32;67
626;16.08.2018;2018;08;15;Torstai;34;34;68
626;16.08.2018;2018;08;16;Torstai;63;53;116
626;16.08.2018;2018;08;17;Torstai;95;53;148
626;16.08.2018;2018;08;18;Torstai;59;39;98
626;16.08.2018;2018;08;19;Torstai;29;28;57
626;16.08.2018;2018;08;20;Torstai;33;21;54
626;16.08.2018;2018;08;21;Torstai;35;22;57
626;16.08.2018;2018;08;22;Torstai;20;5;25
626;16.08.2018;2018;08;23;Torstai;15;8;23
626;17.08.2018;2018;08;00;Perjantai;7;3;10
626;17.08.2018;2018;08;01;Perjantai;5;2;7
626;17.08.2018;2018;08;02;Perjantai;0;1;1
626;17.08.2018;2018;08;03;Perjantai;2;0;2
626;17.08.2018;2018;08;04;Perjantai;0;0;0
626;17.08.2018;2018;08;05;Perjantai;0;2;2
626;17.08.2018;2018;08;06;Perjantai;8;8;16
626;17.08.2018;2018;08;07;Perjantai;8;33;41
626;17.08.2018;2018;08;08;Perjantai;28;74;102
626;17.08.2018;2018;08;09;Perjantai;19;51;70
626;17.08.2018;2018;08;10;Perjantai;10;27;37
626;17.08.2018;2018;08;11;Perjantai;14;12;26
626;17.08.2018;2018;08;12;Perjantai;16;13;29
626;17.08.2018;2018;08;13;Perjantai;13;18;31
626;17.08.2018;2018;08;14;Perjantai;23;13;36
626;17.08.2018;2018;08;15;Perjantai;34;30;64
626;17.08.2018;2018;08;16;Perjantai;56;44;100
626;17.08.2018;2018;08;17;Perjantai;66;47;113
626;17.08.2018;2018;08;18;Perjantai;33;42;75
626;17.08.2018;2018;08;19;Perjantai;42;23;65
626;17.08.2018;2018;08;20;Perjantai;22;13;35
626;17.08.2018;2018;08;21;Perjantai;19;10;29
626;17.08.2018;2018;08;22;Perjantai;6;4;10
626;17.08.2018;2018;08;23;Perjantai;3;4;7
626;18.08.2018;2018;08;00;Lauantai;3;1;4
626;18.08.2018;2018;08;01;Lauantai;2;2;4
626;18.08.2018;2018;08;02;Lauantai;1;0;1
626;18.08.2018;2018;08;03;Lauantai;0;0;0
626;18.08.2018;2018;08;04;Lauantai;1;0;1
626;18.08.2018;2018;08;05;Lauantai;1;3;4
626;18.08.2018;2018;08;06;Lauantai;1;3;4
626;18.08.2018;2018;08;07;Lauantai;2;1;3
626;18.08.2018;2018;08;08;Lauantai;3;7;10
626;18.08.2018;2018;08;09;Lauantai;3;5;8
626;18.08.2018;2018;08;10;Lauantai;10;21;31
626;18.08.2018;2018;08;11;Lauantai;14;14;28
626;18.08.2018;2018;08;12;Lauantai;19;22;41
626;18.08.2018;2018;08;13;Lauantai;24;24;48
626;18.08.2018;2018;08;14;Lauantai;25;27;52
626;18.08.2018;2018;08;15;Lauantai;35;39;74
626;18.08.2018;2018;08;16;Lauantai;37;31;68
626;18.08.2018;2018;08;17;Lauantai;22;36;58
626;18.08.2018;2018;08;18;Lauantai;23;29;52
626;18.08.2018;2018;08;19;Lauantai;18;21;39
626;18.08.2018;2018;08;20;Lauantai;17;18;35
626;18.08.2018;2018;08;21;Lauantai;13;15;28
626;18.08.2018;2018;08;22;Lauantai;11;10;21
626;18.08.2018;2018;08;23;Lauantai;7;2;9
626;19.08.2018;2018;08;00;Sunnuntai;13;4;17
626;19.08.2018;2018;08;01;Sunnuntai;11;2;13
626;19.08.2018;2018;08;02;Sunnuntai;5;0;5
626;19.08.2018;2018;08;03;Sunnuntai;0;0;0
626;19.08.2018;2018;08;04;Sunnuntai;3;2;5
626;19.08.2018;2018;08;05;Sunnuntai;2;0;2
626;19.08.2018;2018;08;06;Sunnuntai;1;3;4
626;19.08.2018;2018;08;07;Sunnuntai;1;0;1
626;19.08.2018;2018;08;08;Sunnuntai;5;2;7
626;19.08.2018;2018;08;09;Sunnuntai;5;3;8
626;19.08.2018;2018;08;10;Sunnuntai;10;7;17
626;19.08.2018;2018;08;11;Sunnuntai;11;13;24
626;19.08.2018;2018;08;12;Sunnuntai;16;25;41
626;19.08.2018;2018;08;13;Sunnuntai;24;27;51
626;19.08.2018;2018;08;14;Sunnuntai;13;16;29
626;19.08.2018;2018;08;15;Sunnuntai;20;20;40
626;19.08.2018;2018;08;16;Sunnuntai;22;25;47
626;19.08.2018;2018;08;17;Sunnuntai;15;30;45
626;19.08.2018;2018;08;18;Sunnuntai;23;18;41
626;19.08.2018;2018;08;19;Sunnuntai;10;19;29
626;19.08.2018;2018;08;20;Sunnuntai;15;13;28
626;19.08.2018;2018;08;21;Sunnuntai;11;9;20
626;19.08.2018;2018;08;22;Sunnuntai;4;3;7
626;19.08.2018;2018;08;23;Sunnuntai;5;9;14
626;27.08.2018;2018;08;00;Maanantai;0;1;1
626;27.08.2018;2018;08;01;Maanantai;2;1;3
626;27.08.2018;2018;08;02;Maanantai;0;0;0
626;27.08.2018;2018;08;03;Maanantai;0;0;0
626;27.08.2018;2018;08;04;Maanantai;0;0;0
626;27.08.2018;2018;08;05;Maanantai;0;5;5
626;27.08.2018;2018;08;06;Maanantai;5;8;13
626;27.08.2018;2018;08;07;Maanantai;12;46;58
626;27.08.2018;2018;08;08;Maanantai;21;72;93
626;27.08.2018;2018;08;09;Maanantai;16;40;56
626;27.08.2018;2018;08;10;Maanantai;10;10;20
626;27.08.2018;2018;08;11;Maanantai;4;13;17
626;27.08.2018;2018;08;12;Maanantai;10;10;20
626;27.08.2018;2018;08;13;Maanantai;11;13;24
626;27.08.2018;2018;08;14;Maanantai;10;20;30
626;27.08.2018;2018;08;15;Maanantai;18;13;31
626;27.08.2018;2018;08;16;Maanantai;47;23;70
626;27.08.2018;2018;08;17;Maanantai;63;28;91
626;27.08.2018;2018;08;18;Maanantai;41;33;74
626;27.08.2018;2018;08;19;Maanantai;25;20;45
626;27.08.2018;2018;08;20;Maanantai;10;12;22
626;27.08.2018;2018;08;21;Maanantai;20;12;32
626;27.08.2018;2018;08;22;Maanantai;10;2;12
626;27.08.2018;2018;08;23;Maanantai;7;2;9
626;28.08.2018;2018;08;00;Tiistai;2;1;3
626;28.08.2018;2018;08;01;Tiistai;0;1;1
626;28.08.2018;2018;08;02;Tiistai;0;0;0
626;28.08.2018;2018;08;03;Tiistai;0;1;1
626;28.08.2018;2018;08;04;Tiistai;0;0;0
626;28.08.2018;2018;08;05;Tiistai;0;1;1
626;28.08.2018;2018;08;06;Tiistai;4;15;19
626;28.08.2018;2018;08;07;Tiistai;14;58;72
626;28.08.2018;2018;08;08;Tiistai;27;83;110
626;28.08.2018;2018;08;09;Tiistai;18;44;62
626;28.08.2018;2018;08;10;Tiistai;11;22;33
626;28.08.2018;2018;08;11;Tiistai;8;22;30
626;28.08.2018;2018;08;12;Tiistai;15;14;29
626;28.08.2018;2018;08;13;Tiistai;19;14;33
626;28.08.2018;2018;08;14;Tiistai;16;19;35
626;28.08.2018;2018;08;15;Tiistai;30;21;51
626;28.08.2018;2018;08;16;Tiistai;65;32;97
626;28.08.2018;2018;08;17;Tiistai;78;36;114
626;28.08.2018;2018;08;18;Tiistai;47;20;67
626;28.08.2018;2018;08;19;Tiistai;41;23;64
626;28.08.2018;2018;08;20;Tiistai;20;18;38
626;28.08.2018;2018;08;21;Tiistai;18;12;30
626;28.08.2018;2018;08;22;Tiistai;10;14;24
626;28.08.2018;2018;08;23;Tiistai;6;7;13
626;29.08.2018;2018;08;00;Keskiviikko;2;0;2
626;29.08.2018;2018;08;01;Keskiviikko;2;3;5
626;29.08.2018;2018;08;02;Keskiviikko;1;0;1
626;29.08.2018;2018;08;03;Keskiviikko;0;1;1
626;29.08.2018;2018;08;04;Keskiviikko;0;1;1
626;29.08.2018;2018;08;05;Keskiviikko;0;3;3
626;29.08.2018;2018;08;06;Keskiviikko;5;10;15
626;29.08.2018;2018;08;07;Keskiviikko;13;55;68
626;29.08.2018;2018;08;08;Keskiviikko;29;80;109
626;29.08.2018;2018;08;09;Keskiviikko;15;42;57
626;29.08.2018;2018;08;10;Keskiviikko;4;7;11
626;29.08.2018;2018;08;11;Keskiviikko;24;29;53
626;29.08.2018;2018;08;12;Keskiviikko;13;17;30
626;29.08.2018;2018;08;13;Keskiviikko;24;15;39
626;29.08.2018;2018;08;14;Keskiviikko;23;29;52
626;29.08.2018;2018;08;15;Keskiviikko;31;42;73
626;29.08.2018;2018;08;16;Keskiviikko;72;44;116
626;29.08.2018;2018;08;17;Keskiviikko;95;60;155
626;29.08.2018;2018;08;18;Keskiviikko;48;36;84
626;29.08.2018;2018;08;19;Keskiviikko;32;29;61
626;29.08.2018;2018;08;20;Keskiviikko;27;21;48
626;29.08.2018;2018;08;21;Keskiviikko;35;17;52
626;29.08.2018;2018;08;22;Keskiviikko;6;8;14
626;29.08.2018;2018;08;23;Keskiviikko;11;5;16
626;30.08.2018;2018;08;00;Torstai;1;3;4
626;30.08.2018;2018;08;01;Torstai;2;3;5
626;30.08.2018;2018;08;02;Torstai;0;0;0
626;30.08.2018;2018;08;03;Torstai;1;0;1
626;30.08.2018;2018;08;04;Torstai;1;0;1
626;30.08.2018;2018;08;05;Torstai;0;2;2
626;30.08.2018;2018;08;06;Torstai;4;10;14
626;30.08.2018;2018;08;07;Torstai;13;41;54
626;30.08.2018;2018;08;08;Torstai;25;82;107
626;30.08.2018;2018;08;09;Torstai;12;49;61
626;30.08.2018;2018;08;10;Torstai;6;19;25
626;30.08.2018;2018;08;11;Torstai;10;25;35
626;30.08.2018;2018;08;12;Torstai;16;24;40
626;30.08.2018;2018;08;13;Torstai;19;11;30
626;30.08.2018;2018;08;14;Torstai;25;30;55
626;30.08.2018;2018;08;15;Torstai;32;25;57
626;30.08.2018;2018;08;16;Torstai;68;26;94
626;30.08.2018;2018;08;17;Torstai;67;28;95
626;30.08.2018;2018;08;18;Torstai;41;27;68
626;30.08.2018;2018;08;19;Torstai;21;17;38
626;30.08.2018;2018;08;20;Torstai;17;10;27
626;30.08.2018;2018;08;21;Torstai;22;12;34
626;30.08.2018;2018;08;22;Torstai;7;6;13
626;30.08.2018;2018;08;23;Torstai;5;6;11
626;31.08.2018;2018;08;00;Perjantai;1;3;4
626;31.08.2018;2018;08;01;Perjantai;2;0;2
626;31.08.2018;2018;08;02;Perjantai;1;0;1
626;31.08.2018;2018;08;03;Perjantai;2;1;3
626;31.08.2018;2018;08;04;Perjantai;1;0;1
626;31.08.2018;2018;08;05;Perjantai;1;0;1
626;31.08.2018;2018;08;06;Perjantai;4;10;14
626;31.08.2018;2018;08;07;Perjantai;11;35;46
626;31.08.2018;2018;08;08;Perjantai;18;62;80
626;31.08.2018;2018;08;09;Perjantai;15;38;53
626;31.08.2018;2018;08;10;Perjantai;9;18;27
626;31.08.2018;2018;08;11;Perjantai;9;18;27
626;31.08.2018;2018;08;12;Perjantai;18;12;30
626;31.08.2018;2018;08;13;Perjantai;15;25;40
626;31.08.2018;2018;08;14;Perjantai;24;22;46
626;31.08.2018;2018;08;15;Perjantai;25;13;38
626;31.08.2018;2018;08;16;Perjantai;41;22;63
626;31.08.2018;2018;08;17;Perjantai;60;27;87
626;31.08.2018;2018;08;18;Perjantai;25;24;49
626;31.08.2018;2018;08;19;Perjantai;31;25;56
626;31.08.2018;2018;08;20;Perjantai;24;14;38
626;31.08.2018;2018;08;21;Perjantai;8;8;16
626;31.08.2018;2018;08;22;Perjantai;11;9;20
626;31.08.2018;2018;08;23;Perjantai;1;2;3
626;01.09.2018;2018;09;00;Lauantai;7;0;7
626;01.09.2018;2018;09;01;Lauantai;3;0;3
626;01.09.2018;2018;09;02;Lauantai;4;0;4
626;01.09.2018;2018;09;03;Lauantai;1;0;1
626;01.09.2018;2018;09;04;Lauantai;2;0;2
626;01.09.2018;2018;09;05;Lauantai;0;0;0
626;01.09.2018;2018;09;06;Lauantai;6;1;7
626;01.09.2018;2018;09;07;Lauantai;3;1;4
626;01.09.2018;2018;09;08;Lauantai;0;0;0
626;01.09.2018;2018;09;09;Lauantai;9;4;13
626;01.09.2018;2018;09;10;Lauantai;7;10;17
626;01.09.2018;2018;09;11;Lauantai;5;9;14
626;01.09.2018;2018;09;12;Lauantai;26;37;63
626;01.09.2018;2018;09;13;Lauantai;28;44;72
626;01.09.2018;2018;09;14;Lauantai;30;34;64
626;01.09.2018;2018;09;15;Lauantai;17;23;40
626;01.09.2018;2018;09;16;Lauantai;28;30;58
626;01.09.2018;2018;09;17;Lauantai;19;25;44
626;01.09.2018;2018;09;18;Lauantai;13;23;36
626;01.09.2018;2018;09;19;Lauantai;14;14;28
626;01.09.2018;2018;09;20;Lauantai;15;11;26
626;01.09.2018;2018;09;21;Lauantai;8;2;10
626;01.09.2018;2018;09;22;Lauantai;12;5;17
626;01.09.2018;2018;09;23;Lauantai;4;10;14
626;02.09.2018;2018;09;00;Sunnuntai;6;1;7
626;02.09.2018;2018;09;01;Sunnuntai;1;0;1
626;02.09.2018;2018;09;02;Sunnuntai;4;1;5
626;02.09.2018;2018;09;03;Sunnuntai;4;0;4
626;02.09.2018;2018;09;04;Sunnuntai;3;0;3
626;02.09.2018;2018;09;05;Sunnuntai;1;1;2
626;02.09.2018;2018;09;06;Sunnuntai;2;3;5
626;02.09.2018;2018;09;07;Sunnuntai;1;0;1
626;02.09.2018;2018;09;08;Sunnuntai;3;1;4
626;02.09.2018;2018;09;09;Sunnuntai;7;2;9
626;02.09.2018;2018;09;10;Sunnuntai;4;11;15
626;02.09.2018;2018;09;11;Sunnuntai;11;13;24
626;02.09.2018;2018;09;12;Sunnuntai;12;19;31
626;02.09.2018;2018;09;13;Sunnuntai;24;27;51
626;02.09.2018;2018;09;14;Sunnuntai;22;19;41
626;02.09.2018;2018;09;15;Sunnuntai;29;26;55
626;02.09.2018;2018;09;16;Sunnuntai;24;25;49
626;02.09.2018;2018;09;17;Sunnuntai;23;37;60
626;02.09.2018;2018;09;18;Sunnuntai;20;10;30
626;02.09.2018;2018;09;19;Sunnuntai;27;17;44
626;02.09.2018;2018;09;20;Sunnuntai;11;16;27
626;02.09.2018;2018;09;21;Sunnuntai;9;11;20
626;02.09.2018;2018;09;22;Sunnuntai;1;4;5
626;02.09.2018;2018;09;23;Sunnuntai;0;0;0
626;03.09.2018;2018;09;00;Maanantai;1;0;1
626;03.09.2018;2018;09;01;Maanantai;1;2;3
626;03.09.2018;2018;09;02;Maanantai;0;1;1
626;03.09.2018;2018;09;03;Maanantai;0;0;0
626;03.09.2018;2018;09;04;Maanantai;0;0;0
626;03.09.2018;2018;09;05;Maanantai;1;1;2
626;03.09.2018;2018;09;06;Maanantai;6;12;18
626;03.09.2018;2018;09;07;Maanantai;21;59;80
626;03.09.2018;2018;09;08;Maanantai;31;106;137
626;03.09.2018;2018;09;09;Maanantai;18;61;79
626;03.09.2018;2018;09;10;Maanantai;8;21;29
626;03.09.2018;2018;09;11;Maanantai;13;21;34
626;03.09.2018;2018;09;12;Maanantai;14;20;34
626;03.09.2018;2018;09;13;Maanantai;18;16;34
626;03.09.2018;2018;09;14;Maanantai;27;28;55
626;03.09.2018;2018;09;15;Maanantai;21;30;51
626;03.09.2018;2018;09;16;Maanantai;66;39;105
626;03.09.2018;2018;09;17;Maanantai;85;50;135
626;03.09.2018;2018;09;18;Maanantai;51;43;94
626;03.09.2018;2018;09;19;Maanantai;36;24;60
626;03.09.2018;2018;09;20;Maanantai;44;22;66
626;03.09.2018;2018;09;21;Maanantai;15;13;28
626;03.09.2018;2018;09;22;Maanantai;16;12;28
626;03.09.2018;2018;09;23;Maanantai;5;2;7
626;04.09.2018;2018;09;00;Tiistai;1;0;1
626;04.09.2018;2018;09;01;Tiistai;1;2;3
626;04.09.2018;2018;09;02;Tiistai;0;1;1
626;04.09.2018;2018;09;03;Tiistai;0;0;0
626;04.09.2018;2018;09;04;Tiistai;0;0;0
626;04.09.2018;2018;09;05;Tiistai;1;1;2
626;04.09.2018;2018;09;06;Tiistai;6;12;18
626;04.09.2018;2018;09;07;Tiistai;21;59;80
626;04.09.2018;2018;09;08;Tiistai;31;106;137
626;04.09.2018;2018;09;09;Tiistai;18;61;79
626;04.09.2018;2018;09;10;Tiistai;8;21;29
626;04.09.2018;2018;09;11;Tiistai;13;29;42
626;04.09.2018;2018;09;12;Tiistai;17;26;43
626;04.09.2018;2018;09;13;Tiistai;24;21;45
626;04.09.2018;2018;09;14;Tiistai;28;32;60
626;04.09.2018;2018;09;15;Tiistai;37;37;74
626;04.09.2018;2018;09;16;Tiistai;67;40;107
626;04.09.2018;2018;09;17;Tiistai;84;56;140
626;04.09.2018;2018;09;18;Tiistai;53;46;99
626;04.09.2018;2018;09;19;Tiistai;38;17;55
626;04.09.2018;2018;09;20;Tiistai;23;18;41
626;04.09.2018;2018;09;21;Tiistai;27;27;54
626;04.09.2018;2018;09;22;Tiistai;12;9;21
626;04.09.2018;2018;09;23;Tiistai;0;1;1
626;05.09.2018;2018;09;00;Keskiviikko;1;0;1
626;05.09.2018;2018;09;01;Keskiviikko;0;4;4
626;05.09.2018;2018;09;02;Keskiviikko;1;0;1
626;05.09.2018;2018;09;03;Keskiviikko;1;0;1
626;05.09.2018;2018;09;04;Keskiviikko;1;0;1
626;05.09.2018;2018;09;05;Keskiviikko;1;1;2
626;05.09.2018;2018;09;06;Keskiviikko;6;20;26
626;05.09.2018;2018;09;07;Keskiviikko;15;41;56
626;05.09.2018;2018;09;08;Keskiviikko;19;86;105
626;05.09.2018;2018;09;09;Keskiviikko;17;45;62
626;05.09.2018;2018;09;10;Keskiviikko;12;15;27
626;05.09.2018;2018;09;11;Keskiviikko;5;13;18
626;05.09.2018;2018;09;12;Keskiviikko;15;22;37
626;05.09.2018;2018;09;13;Keskiviikko;14;7;21
626;05.09.2018;2018;09;14;Keskiviikko;22;15;37
626;05.09.2018;2018;09;15;Keskiviikko;32;35;67
626;05.09.2018;2018;09;16;Keskiviikko;69;42;111
626;05.09.2018;2018;09;17;Keskiviikko;81;45;126
626;05.09.2018;2018;09;18;Keskiviikko;31;25;56
626;05.09.2018;2018;09;19;Keskiviikko;21;15;36
626;05.09.2018;2018;09;20;Keskiviikko;26;13;39
626;05.09.2018;2018;09;21;Keskiviikko;18;16;34
626;05.09.2018;2018;09;22;Keskiviikko;7;1;8
626;05.09.2018;2018;09;23;Keskiviikko;2;4;6
626;06.09.2018;2018;09;00;Torstai;1;6;7
626;06.09.2018;2018;09;01;Torstai;2;1;3
626;06.09.2018;2018;09;02;Torstai;0;1;1
626;06.09.2018;2018;09;03;Torstai;0;0;0
626;06.09.2018;2018;09;04;Torstai;0;1;1
626;06.09.2018;2018;09;05;Torstai;1;1;2
626;06.09.2018;2018;09;06;Torstai;8;12;20
626;06.09.2018;2018;09;07;Torstai;13;38;51
626;06.09.2018;2018;09;08;Torstai;19;81;100
626;06.09.2018;2018;09;09;Torstai;14;35;49
626;06.09.2018;2018;09;10;Torstai;16;21;37
626;06.09.2018;2018;09;11;Torstai;11;17;28
626;06.09.2018;2018;09;12;Torstai;21;17;38
626;06.09.2018;2018;09;13;Torstai;18;14;32
626;06.09.2018;2018;09;14;Torstai;28;18;46
626;06.09.2018;2018;09;15;Torstai;23;36;59
626;06.09.2018;2018;09;16;Torstai;67;28;95
626;06.09.2018;2018;09;17;Torstai;68;38;106
626;06.09.2018;2018;09;18;Torstai;31;38;69
626;06.09.2018;2018;09;19;Torstai;29;20;49
626;06.09.2018;2018;09;20;Torstai;19;20;39
626;06.09.2018;2018;09;21;Torstai;10;8;18
626;06.09.2018;2018;09;22;Torstai;7;3;10
626;06.09.2018;2018;09;23;Torstai;4;3;7
626;07.09.2018;2018;09;00;Perjantai;0;0;0
626;07.09.2018;2018;09;01;Perjantai;2;1;3
626;07.09.2018;2018;09;02;Perjantai;1;0;1
626;07.09.2018;2018;09;03;Perjantai;0;0;0
626;07.09.2018;2018;09;04;Perjantai;1;1;2
626;07.09.2018;2018;09;05;Perjantai;2;0;2
626;07.09.2018;2018;09;06;Perjantai;9;15;24
626;07.09.2018;2018;09;07;Perjantai;12;32;44
626;07.09.2018;2018;09;08;Perjantai;23;54;77
626;07.09.2018;2018;09;09;Perjantai;9;39;48
626;07.09.2018;2018;09;10;Perjantai;6;17;23
626;07.09.2018;2018;09;11;Perjantai;11;16;27
626;07.09.2018;2018;09;12;Perjantai;19;20;39
626;07.09.2018;2018;09;13;Perjantai;13;26;39
626;07.09.2018;2018;09;14;Perjantai;23;18;41
626;07.09.2018;2018;09;15;Perjantai;31;31;62
626;07.09.2018;2018;09;16;Perjantai;51;26;77
626;07.09.2018;2018;09;17;Perjantai;49;35;84
626;07.09.2018;2018;09;18;Perjantai;26;20;46
626;07.09.2018;2018;09;19;Perjantai;22;18;40
626;07.09.2018;2018;09;20;Perjantai;14;12;26
626;07.09.2018;2018;09;21;Perjantai;22;20;42
626;07.09.2018;2018;09;22;Perjantai;11;10;21
626;07.09.2018;2018;09;23;Perjantai;6;4;10
626;08.09.2018;2018;09;00;Lauantai;1;4;5
626;08.09.2018;2018;09;01;Lauantai;1;2;3
626;08.09.2018;2018;09;02;Lauantai;4;0;4
626;08.09.2018;2018;09;03;Lauantai;1;0;1
626;08.09.2018;2018;09;04;Lauantai;1;0;1
626;08.09.2018;2018;09;05;Lauantai;3;1;4
626;08.09.2018;2018;09;06;Lauantai;3;1;4
626;08.09.2018;2018;09;07;Lauantai;4;2;6
626;08.09.2018;2018;09;08;Lauantai;3;2;5
626;08.09.2018;2018;09;09;Lauantai;8;12;20
626;08.09.2018;2018;09;10;Lauantai;7;12;19
626;08.09.2018;2018;09;11;Lauantai;21;15;36
626;08.09.2018;2018;09;12;Lauantai;23;33;56
626;08.09.2018;2018;09;13;Lauantai;32;36;68
626;08.09.2018;2018;09;14;Lauantai;35;35;70
626;08.09.2018;2018;09;15;Lauantai;26;27;53
626;08.09.2018;2018;09;16;Lauantai;26;24;50
626;08.09.2018;2018;09;17;Lauantai;23;20;43
626;08.09.2018;2018;09;18;Lauantai;14;23;37
626;08.09.2018;2018;09;19;Lauantai;16;16;32
626;08.09.2018;2018;09;20;Lauantai;22;13;35
626;08.09.2018;2018;09;21;Lauantai;5;8;13
626;08.09.2018;2018;09;22;Lauantai;13;7;20
626;08.09.2018;2018;09;23;Lauantai;8;4;12
626;09.09.2018;2018;09;00;Sunnuntai;2;1;3
626;09.09.2018;2018;09;01;Sunnuntai;5;1;6
626;09.09.2018;2018;09;02;Sunnuntai;2;0;2
626;09.09.2018;2018;09;03;Sunnuntai;3;1;4
626;09.09.2018;2018;09;04;Sunnuntai;0;1;1
626;09.09.2018;2018;09;05;Sunnuntai;1;0;1
626;09.09.2018;2018;09;06;Sunnuntai;1;3;4
626;09.09.2018;2018;09;07;Sunnuntai;1;3;4
626;09.09.2018;2018;09;08;Sunnuntai;2;3;5
626;09.09.2018;2018;09;09;Sunnuntai;7;6;13
626;09.09.2018;2018;09;10;Sunnuntai;8;12;20
626;09.09.2018;2018;09;11;Sunnuntai;16;17;33
626;09.09.2018;2018;09;12;Sunnuntai;26;29;55
626;09.09.2018;2018;09;13;Sunnuntai;25;40;65
626;09.09.2018;2018;09;14;Sunnuntai;31;28;59
626;09.09.2018;2018;09;15;Sunnuntai;26;27;53
626;09.09.2018;2018;09;16;Sunnuntai;25;24;49
626;09.09.2018;2018;09;17;Sunnuntai;25;25;50
626;09.09.2018;2018;09;18;Sunnuntai;20;26;46
626;09.09.2018;2018;09;19;Sunnuntai;12;20;32
626;09.09.2018;2018;09;20;Sunnuntai;10;22;32
626;09.09.2018;2018;09;21;Sunnuntai;12;9;21
626;09.09.2018;2018;09;22;Sunnuntai;2;5;7
626;09.09.2018;2018;09;23;Sunnuntai;2;1;3
626;10.09.2018;2018;09;00;Maanantai;2;1;3
626;10.09.2018;2018;09;01;Maanantai;0;0;0
626;10.09.2018;2018;09;02;Maanantai;0;0;0
626;10.09.2018;2018;09;03;Maanantai;1;0;1
626;10.09.2018;2018;09;04;Maanantai;0;0;0
626;10.09.2018;2018;09;05;Maanantai;0;2;2
626;10.09.2018;2018;09;06;Maanantai;6;10;16
626;10.09.2018;2018;09;07;Maanantai;12;48;60
626;10.09.2018;2018;09;08;Maanantai;24;87;111
626;10.09.2018;2018;09;09;Maanantai;13;30;43
626;10.09.2018;2018;09;10;Maanantai;19;35;54
626;10.09.2018;2018;09;11;Maanantai;10;16;26
626;10.09.2018;2018;09;12;Maanantai;12;20;32
626;10.09.2018;2018;09;13;Maanantai;17;19;36
626;10.09.2018;2018;09;14;Maanantai;21;13;34
626;10.09.2018;2018;09;15;Maanantai;28;23;51
626;10.09.2018;2018;09;16;Maanantai;47;31;78
626;10.09.2018;2018;09;17;Maanantai;81;41;122
626;10.09.2018;2018;09;18;Maanantai;49;27;76
626;10.09.2018;2018;09;19;Maanantai;28;16;44
626;10.09.2018;2018;09;20;Maanantai;17;14;31
626;10.09.2018;2018;09;21;Maanantai;17;8;25
626;10.09.2018;2018;09;22;Maanantai;9;3;12
626;10.09.2018;2018;09;23;Maanantai;5;3;8
626;11.09.2018;2018;09;00;Tiistai;2;2;4
626;11.09.2018;2018;09;01;Tiistai;0;0;0
626;11.09.2018;2018;09;02;Tiistai;0;0;0
626;11.09.2018;2018;09;03;Tiistai;0;1;1
626;11.09.2018;2018;09;04;Tiistai;0;0;0
626;11.09.2018;2018;09;05;Tiistai;1;1;2
626;11.09.2018;2018;09;06;Tiistai;7;9;16
626;11.09.2018;2018;09;07;Tiistai;14;38;52
626;11.09.2018;2018;09;08;Tiistai;18;55;73
626;11.09.2018;2018;09;09;Tiistai;13;42;55
626;11.09.2018;2018;09;10;Tiistai;8;22;30
626;11.09.2018;2018;09;11;Tiistai;2;8;10
626;11.09.2018;2018;09;12;Tiistai;8;11;19
626;11.09.2018;2018;09;13;Tiistai;13;19;32
626;11.09.2018;2018;09;14;Tiistai;41;51;92
626;11.09.2018;2018;09;15;Tiistai;22;20;42
626;11.09.2018;2018;09;16;Tiistai;42;25;67
626;11.09.2018;2018;09;17;Tiistai;79;35;114
626;11.09.2018;2018;09;18;Tiistai;24;10;34
626;11.09.2018;2018;09;19;Tiistai;8;8;16
626;11.09.2018;2018;09;20;Tiistai;3;3;6
626;11.09.2018;2018;09;21;Tiistai;10;4;14
626;11.09.2018;2018;09;22;Tiistai;7;2;9
626;11.09.2018;2018;09;23;Tiistai;0;2;2
626;12.09.2018;2018;09;00;Keskiviikko;2;1;3
626;12.09.2018;2018;09;01;Keskiviikko;0;0;0
626;12.09.2018;2018;09;02;Keskiviikko;0;0;0
626;12.09.2018;2018;09;03;Keskiviikko;0;0;0
626;12.09.2018;2018;09;04;Keskiviikko;0;0;0
626;12.09.2018;2018;09;05;Keskiviikko;1;3;4
626;12.09.2018;2018;09;06;Keskiviikko;6;4;10
626;12.09.2018;2018;09;07;Keskiviikko;10;15;25
626;12.09.2018;2018;09;08;Keskiviikko;14;36;50
626;12.09.2018;2018;09;09;Keskiviikko;13;18;31
626;12.09.2018;2018;09;10;Keskiviikko;1;14;15
626;12.09.2018;2018;09;11;Keskiviikko;7;9;16
626;12.09.2018;2018;09;12;Keskiviikko;4;6;10
626;12.09.2018;2018;09;13;Keskiviikko;3;7;10
626;12.09.2018;2018;09;14;Keskiviikko;8;6;14
626;12.09.2018;2018;09;15;Keskiviikko;8;17;25
626;12.09.2018;2018;09;16;Keskiviikko;28;14;42
626;12.09.2018;2018;09;17;Keskiviikko;29;15;44
626;12.09.2018;2018;09;18;Keskiviikko;12;6;18
626;12.09.2018;2018;09;19;Keskiviikko;7;5;12
626;12.09.2018;2018;09;20;Keskiviikko;8;8;16
626;12.09.2018;2018;09;21;Keskiviikko;11;7;18
626;12.09.2018;2018;09;22;Keskiviikko;4;4;8
626;12.09.2018;2018;09;23;Keskiviikko;3;3;6
626;13.09.2018;2018;09;00;Torstai;2;2;4
626;13.09.2018;2018;09;01;Torstai;2;0;2
626;13.09.2018;2018;09;02;Torstai;0;0;0
626;13.09.2018;2018;09;03;Torstai;0;0;0
626;13.09.2018;2018;09;04;Torstai;0;1;1
626;13.09.2018;2018;09;05;Torstai;1;3;4
626;13.09.2018;2018;09;06;Torstai;9;10;19
626;13.09.2018;2018;09;07;Torstai;10;26;36
626;13.09.2018;2018;09;08;Torstai;22;60;82
626;13.09.2018;2018;09;09;Torstai;17;33;50
626;13.09.2018;2018;09;10;Torstai;14;16;30
626;13.09.2018;2018;09;11;Torstai;12;18;30
626;13.09.2018;2018;09;12;Torstai;10;18;28
626;13.09.2018;2018;09;13;Torstai;9;10;19
626;13.09.2018;2018;09;14;Torstai;21;21;42
626;13.09.2018;2018;09;15;Torstai;21;31;52
626;13.09.2018;2018;09;16;Torstai;58;24;82
626;13.09.2018;2018;09;17;Torstai;46;39;85
626;13.09.2018;2018;09;18;Torstai;36;25;61
626;13.09.2018;2018;09;19;Torstai;20;17;37
626;13.09.2018;2018;09;20;Torstai;14;8;22
626;13.09.2018;2018;09;21;Torstai;20;16;36
626;13.09.2018;2018;09;22;Torstai;10;2;12
626;13.09.2018;2018;09;23;Torstai;4;3;7
626;14.09.2018;2018;09;00;Perjantai;2;0;2
626;14.09.2018;2018;09;01;Perjantai;0;0;0
626;14.09.2018;2018;09;02;Perjantai;1;0;1
626;14.09.2018;2018;09;03;Perjantai;0;0;0
626;14.09.2018;2018;09;04;Perjantai;0;1;1
626;14.09.2018;2018;09;05;Perjantai;2;0;2
626;14.09.2018;2018;09;06;Perjantai;8;11;19
626;14.09.2018;2018;09;07;Perjantai;13;29;42
626;14.09.2018;2018;09;08;Perjantai;21;59;80
626;14.09.2018;2018;09;09;Perjantai;14;36;50
626;14.09.2018;2018;09;10;Perjantai;7;14;21
626;14.09.2018;2018;09;11;Perjantai;13;12;25
626;14.09.2018;2018;09;12;Perjantai;10;21;31
626;14.09.2018;2018;09;13;Perjantai;17;22;39
626;14.09.2018;2018;09;14;Perjantai;15;24;39
626;14.09.2018;2018;09;15;Perjantai;35;25;60
626;14.09.2018;2018;09;16;Perjantai;48;24;72
626;14.09.2018;2018;09;17;Perjantai;52;15;67
626;14.09.2018;2018;09;18;Perjantai;15;11;26
626;14.09.2018;2018;09;19;Perjantai;6;6;12
626;14.09.2018;2018;09;20;Perjantai;9;4;13
626;14.09.2018;2018;09;21;Perjantai;8;5;13
626;14.09.2018;2018;09;22;Perjantai;7;4;11
626;14.09.2018;2018;09;23;Perjantai;1;1;2
626;15.09.2018;2018;09;00;Lauantai;2;4;6
626;15.09.2018;2018;09;01;Lauantai;6;2;8
626;15.09.2018;2018;09;02;Lauantai;2;0;2
626;15.09.2018;2018;09;03;Lauantai;2;1;3
626;15.09.2018;2018;09;04;Lauantai;2;0;2
626;15.09.2018;2018;09;05;Lauantai;1;0;1
626;15.09.2018;2018;09;06;Lauantai;1;1;2
626;15.09.2018;2018;09;07;Lauantai;0;2;2
626;15.09.2018;2018;09;08;Lauantai;0;5;5
626;15.09.2018;2018;09;09;Lauantai;3;7;10
626;15.09.2018;2018;09;10;Lauantai;12;11;23
626;15.09.2018;2018;09;11;Lauantai;9;6;15
626;15.09.2018;2018;09;12;Lauantai;9;14;23
626;15.09.2018;2018;09;13;Lauantai;10;17;27
626;15.09.2018;2018;09;14;Lauantai;2;5;7
626;15.09.2018;2018;09;15;Lauantai;2;9;11
626;15.09.2018;2018;09;16;Lauantai;12;0;12
626;15.09.2018;2018;09;17;Lauantai;3;6;9
626;15.09.2018;2018;09;18;Lauantai;6;7;13
626;15.09.2018;2018;09;19;Lauantai;7;8;15
626;15.09.2018;2018;09;20;Lauantai;3;6;9
626;15.09.2018;2018;09;21;Lauantai;16;4;20
626;15.09.2018;2018;09;22;Lauantai;2;2;4
626;15.09.2018;2018;09;23;Lauantai;1;1;2
626;16.09.2018;2018;09;00;Sunnuntai;2;2;4
626;16.09.2018;2018;09;01;Sunnuntai;0;0;0
626;16.09.2018;2018;09;02;Sunnuntai;0;0;0
626;16.09.2018;2018;09;03;Sunnuntai;1;0;1
626;16.09.2018;2018;09;04;Sunnuntai;1;0;1
626;16.09.2018;2018;09;05;Sunnuntai;0;1;1
626;16.09.2018;2018;09;06;Sunnuntai;1;1;2
626;16.09.2018;2018;09;07;Sunnuntai;2;4;6
626;16.09.2018;2018;09;08;Sunnuntai;1;1;2
626;16.09.2018;2018;09;09;Sunnuntai;1;2;3
626;16.09.2018;2018;09;10;Sunnuntai;7;12;19
626;16.09.2018;2018;09;11;Sunnuntai;8;13;21
626;16.09.2018;2018;09;12;Sunnuntai;18;19;37
626;16.09.2018;2018;09;13;Sunnuntai;15;26;41
626;16.09.2018;2018;09;14;Sunnuntai;16;17;33
626;16.09.2018;2018;09;15;Sunnuntai;18;18;36
626;16.09.2018;2018;09;16;Sunnuntai;15;13;28
626;16.09.2018;2018;09;17;Sunnuntai;8;8;16
626;16.09.2018;2018;09;18;Sunnuntai;11;12;23
626;16.09.2018;2018;09;19;Sunnuntai;7;4;11
626;16.09.2018;2018;09;20;Sunnuntai;5;5;10
626;16.09.2018;2018;09;21;Sunnuntai;8;7;15
626;16.09.2018;2018;09;22;Sunnuntai;5;3;8
626;16.09.2018;2018;09;23;Sunnuntai;3;0;3
626;17.09.2018;2018;09;00;Maanantai;0;0;0
626;17.09.2018;2018;09;01;Maanantai;0;0;0
626;17.09.2018;2018;09;02;Maanantai;0;0;0
626;17.09.2018;2018;09;03;Maanantai;0;0;0
626;17.09.2018;2018;09;04;Maanantai;0;1;1
626;17.09.2018;2018;09;05;Maanantai;0;1;1
626;17.09.2018;2018;09;06;Maanantai;3;10;13
626;17.09.2018;2018;09;07;Maanantai;13;32;45
626;17.09.2018;2018;09;08;Maanantai;15;55;70
626;17.09.2018;2018;09;09;Maanantai;21;47;68
626;17.09.2018;2018;09;10;Maanantai;10;28;38
626;17.09.2018;2018;09;11;Maanantai;8;23;31
626;17.09.2018;2018;09;12;Maanantai;25;19;44
626;17.09.2018;2018;09;13;Maanantai;17;15;32
626;17.09.2018;2018;09;14;Maanantai;15;23;38
626;17.09.2018;2018;09;15;Maanantai;27;21;48
626;17.09.2018;2018;09;16;Maanantai;46;37;83
626;17.09.2018;2018;09;17;Maanantai;52;38;90
626;17.09.2018;2018;09;18;Maanantai;35;22;57
626;17.09.2018;2018;09;19;Maanantai;23;9;32
626;17.09.2018;2018;09;20;Maanantai;13;12;25
626;17.09.2018;2018;09;21;Maanantai;11;10;21
626;17.09.2018;2018;09;22;Maanantai;6;2;8
626;17.09.2018;2018;09;23;Maanantai;5;2;7
626;18.09.2018;2018;09;00;Tiistai;0;0;0
626;18.09.2018;2018;09;01;Tiistai;0;0;0
626;18.09.2018;2018;09;02;Tiistai;0;1;1
626;18.09.2018;2018;09;03;Tiistai;0;0;0
626;18.09.2018;2018;09;04;Tiistai;0;1;1
626;18.09.2018;2018;09;05;Tiistai;0;0;0
626;18.09.2018;2018;09;06;Tiistai;6;12;18
626;18.09.2018;2018;09;07;Tiistai;11;39;50
626;18.09.2018;2018;09;08;Tiistai;31;69;100
626;18.09.2018;2018;09;09;Tiistai;8;47;55
626;18.09.2018;2018;09;10;Tiistai;10;23;33
626;18.09.2018;2018;09;11;Tiistai;7;23;30
626;18.09.2018;2018;09;12;Tiistai;13;11;24
626;18.09.2018;2018;09;13;Tiistai;18;13;31
626;18.09.2018;2018;09;14;Tiistai;29;19;48
626;18.09.2018;2018;09;15;Tiistai;20;16;36
626;18.09.2018;2018;09;16;Tiistai;52;33;85
626;18.09.2018;2018;09;17;Tiistai;69;33;102
626;18.09.2018;2018;09;18;Tiistai;39;22;61
626;18.09.2018;2018;09;19;Tiistai;21;18;39
626;18.09.2018;2018;09;20;Tiistai;27;21;48
626;18.09.2018;2018;09;21;Tiistai;12;19;31
626;18.09.2018;2018;09;22;Tiistai;11;6;17
626;18.09.2018;2018;09;23;Tiistai;5;6;11
626;19.09.2018;2018;09;00;Keskiviikko;4;1;5
626;19.09.2018;2018;09;01;Keskiviikko;2;0;2
626;19.09.2018;2018;09;02;Keskiviikko;0;0;0
626;19.09.2018;2018;09;03;Keskiviikko;0;0;0
626;19.09.2018;2018;09;04;Keskiviikko;0;1;1
626;19.09.2018;2018;09;05;Keskiviikko;0;4;4
626;19.09.2018;2018;09;06;Keskiviikko;5;10;15
626;19.09.2018;2018;09;07;Keskiviikko;13;36;49
626;19.09.2018;2018;09;08;Keskiviikko;14;51;65
626;19.09.2018;2018;09;09;Keskiviikko;17;33;50
626;19.09.2018;2018;09;10;Keskiviikko;5;26;31
626;19.09.2018;2018;09;11;Keskiviikko;1;7;8
626;19.09.2018;2018;09;12;Keskiviikko;13;11;24
626;19.09.2018;2018;09;13;Keskiviikko;10;10;20
626;19.09.2018;2018;09;14;Keskiviikko;14;3;17
626;19.09.2018;2018;09;15;Keskiviikko;17;15;32
626;19.09.2018;2018;09;16;Keskiviikko;27;17;44
626;19.09.2018;2018;09;17;Keskiviikko;38;23;61
626;19.09.2018;2018;09;18;Keskiviikko;19;5;24
626;19.09.2018;2018;09;19;Keskiviikko;11;7;18
626;19.09.2018;2018;09;20;Keskiviikko;9;5;14
626;19.09.2018;2018;09;21;Keskiviikko;9;7;16
626;19.09.2018;2018;09;22;Keskiviikko;4;6;10
626;19.09.2018;2018;09;23;Keskiviikko;3;1;4
626;20.09.2018;2018;09;00;Torstai;0;1;1
626;20.09.2018;2018;09;01;Torstai;2;1;3
626;20.09.2018;2018;09;02;Torstai;1;0;1
626;20.09.2018;2018;09;03;Torstai;0;0;0
626;20.09.2018;2018;09;04;Torstai;0;0;0
626;20.09.2018;2018;09;05;Torstai;0;3;3
626;20.09.2018;2018;09;06;Torstai;6;9;15
626;20.09.2018;2018;09;07;Torstai;12;36;48
626;20.09.2018;2018;09;08;Torstai;21;58;79
626;20.09.2018;2018;09;09;Torstai;17;38;55
626;20.09.2018;2018;09;10;Torstai;6;27;33
626;20.09.2018;2018;09;11;Torstai;9;18;27
626;20.09.2018;2018;09;12;Torstai;9;8;17
626;20.09.2018;2018;09;13;Torstai;12;9;21
626;20.09.2018;2018;09;14;Torstai;9;12;21
626;20.09.2018;2018;09;15;Torstai;19;24;43
626;20.09.2018;2018;09;16;Torstai;38;18;56
626;20.09.2018;2018;09;17;Torstai;46;24;70
626;20.09.2018;2018;09;18;Torstai;30;22;52
626;20.09.2018;2018;09;19;Torstai;21;12;33
626;20.09.2018;2018;09;20;Torstai;11;10;21
626;20.09.2018;2018;09;21;Torstai;13;3;16
626;20.09.2018;2018;09;22;Torstai;3;4;7
626;20.09.2018;2018;09;23;Torstai;1;5;6
626;21.09.2018;2018;09;00;Perjantai;3;1;4
626;21.09.2018;2018;09;01;Perjantai;1;2;3
626;21.09.2018;2018;09;02;Perjantai;0;0;0
626;21.09.2018;2018;09;03;Perjantai;0;0;0
626;21.09.2018;2018;09;04;Perjantai;0;0;0
626;21.09.2018;2018;09;05;Perjantai;2;0;2
626;21.09.2018;2018;09;06;Perjantai;2;8;10
626;21.09.2018;2018;09;07;Perjantai;9;26;35
626;21.09.2018;2018;09;08;Perjantai;16;45;61
626;21.09.2018;2018;09;09;Perjantai;14;34;48
626;21.09.2018;2018;09;10;Perjantai;8;19;27
626;21.09.2018;2018;09;11;Perjantai;6;15;21
626;21.09.2018;2018;09;12;Perjantai;6;14;20
626;21.09.2018;2018;09;13;Perjantai;18;11;29
626;21.09.2018;2018;09;14;Perjantai;20;21;41
626;21.09.2018;2018;09;15;Perjantai;27;24;51
626;21.09.2018;2018;09;16;Perjantai;44;28;72
626;21.09.2018;2018;09;17;Perjantai;50;20;70
626;21.09.2018;2018;09;18;Perjantai;27;24;51
626;21.09.2018;2018;09;19;Perjantai;10;10;20
626;21.09.2018;2018;09;20;Perjantai;7;7;14
626;21.09.2018;2018;09;21;Perjantai;8;6;14
626;21.09.2018;2018;09;22;Perjantai;5;5;10
626;21.09.2018;2018;09;23;Perjantai;3;1;4
626;22.09.2018;2018;09;00;Lauantai;0;3;3
626;22.09.2018;2018;09;01;Lauantai;3;1;4
626;22.09.2018;2018;09;02;Lauantai;0;2;2
626;22.09.2018;2018;09;03;Lauantai;2;0;2
626;22.09.2018;2018;09;04;Lauantai;0;0;0
626;22.09.2018;2018;09;05;Lauantai;1;2;3
626;22.09.2018;2018;09;06;Lauantai;2;0;2
626;22.09.2018;2018;09;07;Lauantai;0;1;1
626;22.09.2018;2018;09;08;Lauantai;0;0;0
626;22.09.2018;2018;09;09;Lauantai;1;4;5
626;22.09.2018;2018;09;10;Lauantai;3;2;5
626;22.09.2018;2018;09;11;Lauantai;0;3;3
626;22.09.2018;2018;09;12;Lauantai;5;2;7
626;22.09.2018;2018;09;13;Lauantai;3;6;9
626;22.09.2018;2018;09;14;Lauantai;6;7;13
626;22.09.2018;2018;09;15;Lauantai;16;14;30
626;22.09.2018;2018;09;16;Lauantai;9;12;21
626;22.09.2018;2018;09;17;Lauantai;8;13;21
626;22.09.2018;2018;09;18;Lauantai;13;4;17
626;22.09.2018;2018;09;19;Lauantai;8;9;17
626;22.09.2018;2018;09;20;Lauantai;7;9;16
626;22.09.2018;2018;09;21;Lauantai;3;2;5
626;22.09.2018;2018;09;22;Lauantai;3;5;8
626;22.09.2018;2018;09;23;Lauantai;1;3;4
626;23.09.2018;2018;09;00;Sunnuntai;1;2;3
626;23.09.2018;2018;09;01;Sunnuntai;2;1;3
626;23.09.2018;2018;09;02;Sunnuntai;1;1;2
626;23.09.2018;2018;09;03;Sunnuntai;0;0;0
626;23.09.2018;2018;09;04;Sunnuntai;2;0;2
626;23.09.2018;2018;09;05;Sunnuntai;2;0;2
626;23.09.2018;2018;09;06;Sunnuntai;0;1;1
626;23.09.2018;2018;09;07;Sunnuntai;0;1;1
626;23.09.2018;2018;09;08;Sunnuntai;0;3;3
626;23.09.2018;2018;09;09;Sunnuntai;1;1;2
626;23.09.2018;2018;09;10;Sunnuntai;6;6;12
626;23.09.2018;2018;09;11;Sunnuntai;2;7;9
626;23.09.2018;2018;09;12;Sunnuntai;15;17;32
626;23.09.2018;2018;09;13;Sunnuntai;11;17;28
626;23.09.2018;2018;09;14;Sunnuntai;21;11;32
626;23.09.2018;2018;09;15;Sunnuntai;9;19;28
626;23.09.2018;2018;09;16;Sunnuntai;9;19;28
626;23.09.2018;2018;09;17;Sunnuntai;16;16;32
626;23.09.2018;2018;09;18;Sunnuntai;7;12;19
626;23.09.2018;2018;09;19;Sunnuntai;10;13;23
626;23.09.2018;2018;09;20;Sunnuntai;7;12;19
626;23.09.2018;2018;09;21;Sunnuntai;3;6;9
626;23.09.2018;2018;09;22;Sunnuntai;4;0;4
626;23.09.2018;2018;09;23;Sunnuntai;2;2;4
626;24.09.2018;2018;09;00;Maanantai;2;1;3
626;24.09.2018;2018;09;01;Maanantai;3;0;3
626;24.09.2018;2018;09;02;Maanantai;0;0;0
626;24.09.2018;2018;09;03;Maanantai;0;0;0
626;24.09.2018;2018;09;04;Maanantai;0;0;0
626;24.09.2018;2018;09;05;Maanantai;1;2;3
626;24.09.2018;2018;09;06;Maanantai;5;7;12
626;24.09.2018;2018;09;07;Maanantai;11;33;44
626;24.09.2018;2018;09;08;Maanantai;17;53;70
626;24.09.2018;2018;09;09;Maanantai;21;34;55
626;24.09.2018;2018;09;10;Maanantai;3;23;26
626;24.09.2018;2018;09;11;Maanantai;6;8;14
626;24.09.2018;2018;09;12;Maanantai;12;13;25
626;24.09.2018;2018;09;13;Maanantai;8;7;15
626;24.09.2018;2018;09;14;Maanantai;16;14;30
626;24.09.2018;2018;09;15;Maanantai;22;17;39
626;24.09.2018;2018;09;16;Maanantai;45;29;74
626;24.09.2018;2018;09;17;Maanantai;51;25;76
626;24.09.2018;2018;09;18;Maanantai;24;17;41
626;24.09.2018;2018;09;19;Maanantai;21;10;31
626;24.09.2018;2018;09;20;Maanantai;14;9;23
626;24.09.2018;2018;09;21;Maanantai;7;3;10
626;24.09.2018;2018;09;22;Maanantai;4;4;8
626;24.09.2018;2018;09;23;Maanantai;4;3;7
626;25.09.2018;2018;09;00;Tiistai;1;1;2
626;25.09.2018;2018;09;01;Tiistai;1;1;2
626;25.09.2018;2018;09;02;Tiistai;0;0;0
626;25.09.2018;2018;09;03;Tiistai;0;0;0
626;25.09.2018;2018;09;04;Tiistai;0;1;1
626;25.09.2018;2018;09;05;Tiistai;0;0;0
626;25.09.2018;2018;09;06;Tiistai;8;13;21
626;25.09.2018;2018;09;07;Tiistai;9;41;50
626;25.09.2018;2018;09;08;Tiistai;21;57;78
626;25.09.2018;2018;09;09;Tiistai;8;35;43
626;25.09.2018;2018;09;10;Tiistai;10;26;36
626;25.09.2018;2018;09;11;Tiistai;14;17;31
626;25.09.2018;2018;09;12;Tiistai;8;18;26
626;25.09.2018;2018;09;13;Tiistai;21;10;31
626;25.09.2018;2018;09;14;Tiistai;20;13;33
626;25.09.2018;2018;09;15;Tiistai;16;23;39
626;25.09.2018;2018;09;16;Tiistai;37;31;68
626;25.09.2018;2018;09;17;Tiistai;52;29;81
626;25.09.2018;2018;09;18;Tiistai;35;14;49
626;25.09.2018;2018;09;19;Tiistai;13;15;28
626;25.09.2018;2018;09;20;Tiistai;11;8;19
626;25.09.2018;2018;09;21;Tiistai;17;1;18
626;25.09.2018;2018;09;22;Tiistai;8;6;14
626;25.09.2018;2018;09;23;Tiistai;4;3;7
626;26.09.2018;2018;09;00;Keskiviikko;3;0;3
626;26.09.2018;2018;09;01;Keskiviikko;1;0;1
626;26.09.2018;2018;09;02;Keskiviikko;0;0;0
626;26.09.2018;2018;09;03;Keskiviikko;0;0;0
626;26.09.2018;2018;09;04;Keskiviikko;0;0;0
626;26.09.2018;2018;09;05;Keskiviikko;1;3;4
626;26.09.2018;2018;09;06;Keskiviikko;4;9;13
626;26.09.2018;2018;09;07;Keskiviikko;11;23;34
626;26.09.2018;2018;09;08;Keskiviikko;20;36;56
626;26.09.2018;2018;09;09;Keskiviikko;9;15;24
626;26.09.2018;2018;09;10;Keskiviikko;3;15;18
626;26.09.2018;2018;09;11;Keskiviikko;2;4;6
626;26.09.2018;2018;09;12;Keskiviikko;6;3;9
626;26.09.2018;2018;09;13;Keskiviikko;5;7;12
626;26.09.2018;2018;09;14;Keskiviikko;5;6;11
626;26.09.2018;2018;09;15;Keskiviikko;11;11;22
626;26.09.2018;2018;09;16;Keskiviikko;24;9;33
626;26.09.2018;2018;09;17;Keskiviikko;20;11;31
626;26.09.2018;2018;09;18;Keskiviikko;14;11;25
626;26.09.2018;2018;09;19;Keskiviikko;12;3;15
626;26.09.2018;2018;09;20;Keskiviikko;5;6;11
626;26.09.2018;2018;09;21;Keskiviikko;6;0;6
626;26.09.2018;2018;09;22;Keskiviikko;5;3;8
626;26.09.2018;2018;09;23;Keskiviikko;1;2;3
626;27.09.2018;2018;09;00;Torstai;2;2;4
626;27.09.2018;2018;09;01;Torstai;0;0;0
626;27.09.2018;2018;09;02;Torstai;0;0;0
626;27.09.2018;2018;09;03;Torstai;0;0;0
626;27.09.2018;2018;09;04;Torstai;1;0;1
626;27.09.2018;2018;09;05;Torstai;1;2;3
626;27.09.2018;2018;09;06;Torstai;6;11;17
626;27.09.2018;2018;09;07;Torstai;8;15;23
626;27.09.2018;2018;09;08;Torstai;15;26;41
626;27.09.2018;2018;09;09;Torstai;8;13;21
626;27.09.2018;2018;09;10;Torstai;2;6;8
626;27.09.2018;2018;09;11;Torstai;3;4;7
626;27.09.2018;2018;09;12;Torstai;5;7;12
626;27.09.2018;2018;09;13;Torstai;4;7;11
626;27.09.2018;2018;09;14;Torstai;9;12;21
626;27.09.2018;2018;09;15;Torstai;8;8;16
626;27.09.2018;2018;09;16;Torstai;14;11;25
626;27.09.2018;2018;09;17;Torstai;19;7;26
626;27.09.2018;2018;09;18;Torstai;17;15;32
626;27.09.2018;2018;09;19;Torstai;13;7;20
626;27.09.2018;2018;09;20;Torstai;8;9;17
626;27.09.2018;2018;09;21;Torstai;6;7;13
626;27.09.2018;2018;09;22;Torstai;7;7;14
626;27.09.2018;2018;09;23;Torstai;2;2;4
626;28.09.2018;2018;09;00;Perjantai;2;0;2
626;28.09.2018;2018;09;01;Perjantai;1;0;1
626;28.09.2018;2018;09;02;Perjantai;2;0;2
626;28.09.2018;2018;09;03;Perjantai;1;1;2
626;28.09.2018;2018;09;04;Perjantai;2;1;3
626;28.09.2018;2018;09;05;Perjantai;1;1;2
626;28.09.2018;2018;09;06;Perjantai;2;16;18
626;28.09.2018;2018;09;07;Perjantai;10;29;39
626;28.09.2018;2018;09;08;Perjantai;13;53;66
626;28.09.2018;2018;09;09;Perjantai;10;24;34
626;28.09.2018;2018;09;10;Perjantai;11;17;28
626;28.09.2018;2018;09;11;Perjantai;7;7;14
626;28.09.2018;2018;09;12;Perjantai;5;5;10
626;28.09.2018;2018;09;13;Perjantai;7;12;19
626;28.09.2018;2018;09;14;Perjantai;17;14;31
626;28.09.2018;2018;09;15;Perjantai;21;17;38
626;28.09.2018;2018;09;16;Perjantai;29;18;47
626;28.09.2018;2018;09;17;Perjantai;39;16;55
626;28.09.2018;2018;09;18;Perjantai;26;16;42
626;28.09.2018;2018;09;19;Perjantai;20;9;29
626;28.09.2018;2018;09;20;Perjantai;9;7;16
626;28.09.2018;2018;09;21;Perjantai;8;1;9
626;28.09.2018;2018;09;22;Perjantai;8;2;10
626;28.09.2018;2018;09;23;Perjantai;3;2;5
626;29.09.2018;2018;09;00;Lauantai;0;2;2
626;29.09.2018;2018;09;01;Lauantai;2;0;2
626;29.09.2018;2018;09;02;Lauantai;2;1;3
626;29.09.2018;2018;09;03;Lauantai;0;1;1
626;29.09.2018;2018;09;04;Lauantai;0;1;1
626;29.09.2018;2018;09;05;Lauantai;4;0;4
626;29.09.2018;2018;09;06;Lauantai;0;3;3
626;29.09.2018;2018;09;07;Lauantai;1;3;4
626;29.09.2018;2018;09;08;Lauantai;0;2;2
626;29.09.2018;2018;09;09;Lauantai;3;6;9
626;29.09.2018;2018;09;10;Lauantai;7;13;20
626;29.09.2018;2018;09;11;Lauantai;7;6;13
626;29.09.2018;2018;09;12;Lauantai;11;9;20
626;29.09.2018;2018;09;13;Lauantai;13;10;23
626;29.09.2018;2018;09;14;Lauantai;7;12;19
626;29.09.2018;2018;09;15;Lauantai;15;12;27
626;29.09.2018;2018;09;16;Lauantai;13;12;25
626;29.09.2018;2018;09;17;Lauantai;21;12;33
626;29.09.2018;2018;09;18;Lauantai;8;9;17
626;29.09.2018;2018;09;19;Lauantai;5;9;14
626;29.09.2018;2018;09;20;Lauantai;10;6;16
626;29.09.2018;2018;09;21;Lauantai;12;2;14
626;29.09.2018;2018;09;22;Lauantai;5;6;11
626;29.09.2018;2018;09;23;Lauantai;4;2;6
626;30.09.2018;2018;09;00;Sunnuntai;2;0;2
626;30.09.2018;2018;09;01;Sunnuntai;1;0;1
626;30.09.2018;2018;09;02;Sunnuntai;1;1;2
626;30.09.2018;2018;09;03;Sunnuntai;2;0;2
626;30.09.2018;2018;09;04;Sunnuntai;2;3;5
626;30.09.2018;2018;09;05;Sunnuntai;0;0;0
626;30.09.2018;2018;09;06;Sunnuntai;1;3;4
626;30.09.2018;2018;09;07;Sunnuntai;3;3;6
626;30.09.2018;2018;09;08;Sunnuntai;0;1;1
626;30.09.2018;2018;09;09;Sunnuntai;3;1;4
626;30.09.2018;2018;09;10;Sunnuntai;6;5;11
626;30.09.2018;2018;09;11;Sunnuntai;2;6;8
626;30.09.2018;2018;09;12;Sunnuntai;4;8;12
626;30.09.2018;2018;09;13;Sunnuntai;6;8;14
626;30.09.2018;2018;09;14;Sunnuntai;10;10;20
626;30.09.2018;2018;09;15;Sunnuntai;12;13;25
626;30.09.2018;2018;09;16;Sunnuntai;10;11;21
626;30.09.2018;2018;09;17;Sunnuntai;8;8;16
626;30.09.2018;2018;09;18;Sunnuntai;9;6;15
626;30.09.2018;2018;09;19;Sunnuntai;18;16;34
626;30.09.2018;2018;09;20;Sunnuntai;7;8;15
626;30.09.2018;2018;09;21;Sunnuntai;2;4;6
626;30.09.2018;2018;09;22;Sunnuntai;2;2;4
626;30.09.2018;2018;09;23;Sunnuntai;4;0;4