MittausID;Pvm;Vuosi;Kuukausi;Tunti;Viikonpäivä;PP_1;PP_2;PP_YHT;JK_1;JK_2;JK_YHT
109;23.06.2014;2014;06;00;Maanantai;0;0;0;1;1;2
109;23.06.2014;2014;06;01;Maanantai;0;0;0;0;0;0
109;23.06.2014;2014;06;02;Maanantai;0;0;0;0;1;1
109;23.06.2014;2014;06;03;Maanantai;0;0;0;0;0;0
109;23.06.2014;2014;06;04;Maanantai;0;0;0;0;0;0
109;23.06.2014;2014;06;05;Maanantai;0;0;0;2;1;3
109;23.06.2014;2014;06;06;Maanantai;0;0;0;2;0;2
109;23.06.2014;2014;06;07;Maanantai;0;0;0;2;2;4
109;23.06.2014;2014;06;08;Maanantai;0;0;0;1;3;4
109;23.06.2014;2014;06;09;Maanantai;0;0;0;3;6;9
109;23.06.2014;2014;06;10;Maanantai;3;1;4;6;4;10
109;23.06.2014;2014;06;11;Maanantai;16;17;33;5;9;14
109;23.06.2014;2014;06;12;Maanantai;14;25;39;5;4;9
109;23.06.2014;2014;06;13;Maanantai;21;16;37;2;5;7
109;23.06.2014;2014;06;14;Maanantai;30;23;53;4;6;10
109;23.06.2014;2014;06;15;Maanantai;53;40;93;7;3;10
109;23.06.2014;2014;06;16;Maanantai;70;36;106;3;5;8
109;23.06.2014;2014;06;17;Maanantai;28;26;54;7;7;14
109;23.06.2014;2014;06;18;Maanantai;11;17;28;8;13;21
109;23.06.2014;2014;06;19;Maanantai;8;14;22;5;7;12
109;23.06.2014;2014;06;20;Maanantai;14;6;20;1;3;4
109;23.06.2014;2014;06;21;Maanantai;13;6;19;5;2;7
109;23.06.2014;2014;06;22;Maanantai;4;10;14;1;1;2
109;23.06.2014;2014;06;23;Maanantai;2;4;6;0;0;0
109;24.06.2014;2014;06;00;Tiistai;0;0;0;10;3;13
109;24.06.2014;2014;06;01;Tiistai;0;0;0;0;0;0
109;24.06.2014;2014;06;02;Tiistai;3;1;4;0;0;0
109;24.06.2014;2014;06;03;Tiistai;0;0;0;0;1;1
109;24.06.2014;2014;06;04;Tiistai;1;0;1;0;0;0
109;24.06.2014;2014;06;05;Tiistai;7;9;16;2;2;4
109;24.06.2014;2014;06;06;Tiistai;13;37;50;1;2;3
109;24.06.2014;2014;06;07;Tiistai;38;74;112;2;4;6
109;24.06.2014;2014;06;08;Tiistai;14;46;60;3;5;8
109;24.06.2014;2014;06;09;Tiistai;8;19;27;2;1;3
109;24.06.2014;2014;06;10;Tiistai;5;15;20;5;4;9
109;24.06.2014;2014;06;11;Tiistai;11;6;17;0;2;2
109;24.06.2014;2014;06;12;Tiistai;4;28;32;1;5;6
109;24.06.2014;2014;06;13;Tiistai;32;15;47;2;1;3
109;24.06.2014;2014;06;14;Tiistai;22;30;52;3;5;8
109;24.06.2014;2014;06;15;Tiistai;44;40;84;1;3;4
109;24.06.2014;2014;06;16;Tiistai;55;62;117;5;7;12
109;24.06.2014;2014;06;17;Tiistai;41;31;72;3;6;9
109;24.06.2014;2014;06;18;Tiistai;28;17;45;7;3;10
109;24.06.2014;2014;06;19;Tiistai;15;15;30;6;9;15
109;24.06.2014;2014;06;20;Tiistai;12;12;24;4;5;9
109;24.06.2014;2014;06;21;Tiistai;14;11;25;6;3;9
109;24.06.2014;2014;06;22;Tiistai;3;22;25;4;1;5
109;24.06.2014;2014;06;23;Tiistai;1;1;2;0;0;0
109;25.06.2014;2014;06;00;Keskiviikko;6;2;8;0;0;0
109;25.06.2014;2014;06;01;Keskiviikko;1;0;1;0;0;0
109;25.06.2014;2014;06;02;Keskiviikko;4;4;8;0;0;0
109;25.06.2014;2014;06;03;Keskiviikko;0;2;2;0;0;0
109;25.06.2014;2014;06;04;Keskiviikko;4;0;4;0;0;0
109;25.06.2014;2014;06;05;Keskiviikko;9;9;18;2;1;3
109;25.06.2014;2014;06;06;Keskiviikko;13;53;66;0;1;1
109;25.06.2014;2014;06;07;Keskiviikko;31;72;103;3;3;6
109;25.06.2014;2014;06;08;Keskiviikko;21;52;73;1;4;5
109;25.06.2014;2014;06;09;Keskiviikko;7;20;27;1;5;6
109;25.06.2014;2014;06;10;Keskiviikko;11;14;25;8;5;13
109;25.06.2014;2014;06;11;Keskiviikko;11;17;28;0;2;2
109;25.06.2014;2014;06;12;Keskiviikko;17;17;34;2;1;3
109;25.06.2014;2014;06;13;Keskiviikko;28;29;57;4;4;8
109;25.06.2014;2014;06;14;Keskiviikko;31;21;52;0;4;4
109;25.06.2014;2014;06;15;Keskiviikko;49;31;80;5;7;12
109;25.06.2014;2014;06;16;Keskiviikko;67;54;121;8;4;12
109;25.06.2014;2014;06;17;Keskiviikko;30;43;73;3;4;7
109;25.06.2014;2014;06;18;Keskiviikko;24;29;53;4;3;7
109;25.06.2014;2014;06;19;Keskiviikko;13;15;28;8;3;11
109;25.06.2014;2014;06;20;Keskiviikko;16;18;34;7;6;13
109;25.06.2014;2014;06;21;Keskiviikko;15;10;25;2;2;4
109;25.06.2014;2014;06;22;Keskiviikko;4;16;20;1;3;4
109;25.06.2014;2014;06;23;Keskiviikko;3;2;5;1;0;1
109;26.06.2014;2014;06;00;Torstai;4;2;6;0;0;0
109;26.06.2014;2014;06;01;Torstai;0;1;1;1;0;1
109;26.06.2014;2014;06;02;Torstai;0;0;0;0;0;0
109;26.06.2014;2014;06;03;Torstai;0;1;1;0;1;1
109;26.06.2014;2014;06;04;Torstai;1;0;1;0;0;0
109;26.06.2014;2014;06;05;Torstai;14;7;21;2;1;3
109;26.06.2014;2014;06;06;Torstai;12;42;54;2;1;3
109;26.06.2014;2014;06;07;Torstai;40;54;94;7;7;14
109;26.06.2014;2014;06;08;Torstai;19;45;64;3;6;9
109;26.06.2014;2014;06;09;Torstai;9;16;25;4;4;8
109;26.06.2014;2014;06;10;Torstai;8;21;29;3;2;5
109;26.06.2014;2014;06;11;Torstai;4;12;16;2;4;6
109;26.06.2014;2014;06;12;Torstai;14;11;25;3;4;7
109;26.06.2014;2014;06;13;Torstai;18;17;35;2;4;6
109;26.06.2014;2014;06;14;Torstai;14;27;41;7;6;13
109;26.06.2014;2014;06;15;Torstai;42;37;79;2;0;2
109;26.06.2014;2014;06;16;Torstai;51;61;112;4;7;11
109;26.06.2014;2014;06;17;Torstai;32;25;57;6;4;10
109;26.06.2014;2014;06;18;Torstai;21;20;41;4;5;9
109;26.06.2014;2014;06;19;Torstai;16;19;35;8;7;15
109;26.06.2014;2014;06;20;Torstai;6;12;18;4;3;7
109;26.06.2014;2014;06;21;Torstai;5;8;13;1;2;3
109;26.06.2014;2014;06;22;Torstai;6;16;22;4;3;7
109;26.06.2014;2014;06;23;Torstai;2;2;4;2;4;6
109;27.06.2014;2014;06;00;Perjantai;3;3;6;2;0;2
109;27.06.2014;2014;06;01;Perjantai;1;4;5;1;0;1
109;27.06.2014;2014;06;02;Perjantai;0;1;1;0;0;0
109;27.06.2014;2014;06;03;Perjantai;2;0;2;0;0;0
109;27.06.2014;2014;06;04;Perjantai;3;1;4;0;0;0
109;27.06.2014;2014;06;05;Perjantai;9;7;16;0;1;1
109;27.06.2014;2014;06;06;Perjantai;11;32;43;1;0;1
109;27.06.2014;2014;06;07;Perjantai;26;50;76;3;5;8
109;27.06.2014;2014;06;08;Perjantai;17;48;65;1;2;3
109;27.06.2014;2014;06;09;Perjantai;16;16;32;6;5;11
109;27.06.2014;2014;06;10;Perjantai;4;18;22;4;3;7
109;27.06.2014;2014;06;11;Perjantai;9;16;25;4;7;11
109;27.06.2014;2014;06;12;Perjantai;9;26;35;3;1;4
109;27.06.2014;2014;06;13;Perjantai;19;19;38;2;2;4
109;27.06.2014;2014;06;14;Perjantai;26;31;57;4;7;11
109;27.06.2014;2014;06;15;Perjantai;46;50;96;9;4;13
109;27.06.2014;2014;06;16;Perjantai;30;31;61;3;3;6
109;27.06.2014;2014;06;17;Perjantai;21;20;41;3;4;7
109;27.06.2014;2014;06;18;Perjantai;24;18;42;4;4;8
109;27.06.2014;2014;06;19;Perjantai;16;16;32;5;2;7
109;27.06.2014;2014;06;20;Perjantai;10;21;31;4;3;7
109;27.06.2014;2014;06;21;Perjantai;9;15;24;2;7;9
109;27.06.2014;2014;06;22;Perjantai;4;18;22;1;2;3
109;27.06.2014;2014;06;23;Perjantai;0;22;22;1;3;4
109;28.06.2014;2014;06;00;Lauantai;1;8;9;0;1;1
109;28.06.2014;2014;06;01;Lauantai;2;3;5;0;0;0
109;28.06.2014;2014;06;02;Lauantai;0;0;0;1;1;2
109;28.06.2014;2014;06;03;Lauantai;0;0;0;1;0;1
109;28.06.2014;2014;06;04;Lauantai;1;4;5;1;0;1
109;28.06.2014;2014;06;05;Lauantai;3;1;4;0;0;0
109;28.06.2014;2014;06;06;Lauantai;3;4;7;2;2;4
109;28.06.2014;2014;06;07;Lauantai;3;1;4;1;2;3
109;28.06.2014;2014;06;08;Lauantai;4;3;7;4;1;5
109;28.06.2014;2014;06;09;Lauantai;10;11;21;2;5;7
109;28.06.2014;2014;06;10;Lauantai;4;14;18;3;4;7
109;28.06.2014;2014;06;11;Lauantai;10;18;28;1;3;4
109;28.06.2014;2014;06;12;Lauantai;11;20;31;8;1;9
109;28.06.2014;2014;06;13;Lauantai;13;18;31;3;8;11
109;28.06.2014;2014;06;14;Lauantai;12;16;28;3;5;8
109;28.06.2014;2014;06;15;Lauantai;14;11;25;1;4;5
109;28.06.2014;2014;06;16;Lauantai;10;7;17;6;7;13
109;28.06.2014;2014;06;17;Lauantai;6;17;23;2;4;6
109;28.06.2014;2014;06;18;Lauantai;11;17;28;7;5;12
109;28.06.2014;2014;06;19;Lauantai;5;9;14;0;2;2
109;28.06.2014;2014;06;20;Lauantai;9;16;25;2;2;4
109;28.06.2014;2014;06;21;Lauantai;10;7;17;2;3;5
109;28.06.2014;2014;06;22;Lauantai;8;20;28;2;2;4
109;28.06.2014;2014;06;23;Lauantai;1;6;7;0;2;2
109;29.06.2014;2014;06;00;Sunnuntai;0;2;2;2;0;2
109;29.06.2014;2014;06;01;Sunnuntai;1;7;8;0;1;1
109;29.06.2014;2014;06;02;Sunnuntai;5;0;5;0;0;0
109;29.06.2014;2014;06;03;Sunnuntai;4;0;4;2;1;3
109;29.06.2014;2014;06;04;Sunnuntai;3;0;3;0;0;0
109;29.06.2014;2014;06;05;Sunnuntai;2;0;2;1;0;1
109;29.06.2014;2014;06;06;Sunnuntai;2;2;4;2;4;6
109;29.06.2014;2014;06;07;Sunnuntai;6;1;7;2;1;3
109;29.06.2014;2014;06;08;Sunnuntai;2;7;9;2;7;9
109;29.06.2014;2014;06;09;Sunnuntai;5;9;14;8;1;9
109;29.06.2014;2014;06;10;Sunnuntai;5;5;10;6;3;9
109;29.06.2014;2014;06;11;Sunnuntai;7;10;17;3;4;7
109;29.06.2014;2014;06;12;Sunnuntai;12;17;29;1;3;4
109;29.06.2014;2014;06;13;Sunnuntai;15;19;34;2;3;5
109;29.06.2014;2014;06;14;Sunnuntai;14;14;28;5;7;12
109;29.06.2014;2014;06;15;Sunnuntai;14;20;34;5;3;8
109;29.06.2014;2014;06;16;Sunnuntai;11;22;33;1;4;5
109;29.06.2014;2014;06;17;Sunnuntai;17;12;29;6;1;7
109;29.06.2014;2014;06;18;Sunnuntai;22;26;48;4;7;11
109;29.06.2014;2014;06;19;Sunnuntai;9;10;19;4;2;6
109;29.06.2014;2014;06;20;Sunnuntai;13;16;29;8;3;11
109;29.06.2014;2014;06;21;Sunnuntai;17;10;27;0;5;5
109;29.06.2014;2014;06;22;Sunnuntai;2;8;10;3;1;4
109;29.06.2014;2014;06;23;Sunnuntai;6;7;13;0;0;0
109;30.06.2014;2014;06;00;Maanantai;1;2;3;1;1;2
109;30.06.2014;2014;06;01;Maanantai;0;0;0;0;0;0
109;30.06.2014;2014;06;02;Maanantai;0;0;0;0;1;1
109;30.06.2014;2014;06;03;Maanantai;1;5;6;0;0;0
109;30.06.2014;2014;06;04;Maanantai;5;1;6;0;0;0
109;30.06.2014;2014;06;05;Maanantai;15;4;19;2;1;3
109;30.06.2014;2014;06;06;Maanantai;18;25;43;2;0;2
109;30.06.2014;2014;06;07;Maanantai;41;53;94;2;2;4
109;30.06.2014;2014;06;08;Maanantai;12;43;55;1;3;4
109;30.06.2014;2014;06;09;Maanantai;5;18;23;3;6;9
109;30.06.2014;2014;06;10;Maanantai;11;18;29;6;4;10
109;30.06.2014;2014;06;11;Maanantai;13;34;47;5;9;14
109;30.06.2014;2014;06;12;Maanantai;20;13;33;5;4;9
109;30.06.2014;2014;06;13;Maanantai;15;25;40;2;5;7
109;30.06.2014;2014;06;14;Maanantai;18;16;34;4;6;10
109;30.06.2014;2014;06;15;Maanantai;50;30;80;7;3;10
109;30.06.2014;2014;06;16;Maanantai;59;40;99;3;5;8
109;30.06.2014;2014;06;17;Maanantai;24;17;41;7;7;14
109;30.06.2014;2014;06;18;Maanantai;17;21;38;8;13;21
109;30.06.2014;2014;06;19;Maanantai;12;19;31;5;7;12
109;30.06.2014;2014;06;20;Maanantai;9;15;24;1;3;4
109;30.06.2014;2014;06;21;Maanantai;8;12;20;5;2;7
109;30.06.2014;2014;06;22;Maanantai;8;11;19;1;1;2
109;30.06.2014;2014;06;23;Maanantai;5;4;9;0;0;0
109;01.07.2014;2014;07;00;Tiistai;1;3;4;0;0;0
109;01.07.2014;2014;07;01;Tiistai;1;6;7;2;1;3
109;01.07.2014;2014;07;02;Tiistai;0;2;2;0;0;0
109;01.07.2014;2014;07;03;Tiistai;0;0;0;0;0;0
109;01.07.2014;2014;07;04;Tiistai;3;1;4;0;1;1
109;01.07.2014;2014;07;05;Tiistai;10;8;18;1;1;2
109;01.07.2014;2014;07;06;Tiistai;22;31;53;1;2;3
109;01.07.2014;2014;07;07;Tiistai;33;61;94;3;5;8
109;01.07.2014;2014;07;08;Tiistai;13;39;52;6;3;9
109;01.07.2014;2014;07;09;Tiistai;16;25;41;4;5;9
109;01.07.2014;2014;07;10;Tiistai;11;22;33;5;7;12
109;01.07.2014;2014;07;11;Tiistai;15;23;38;3;6;9
109;01.07.2014;2014;07;12;Tiistai;16;16;32;4;3;7
109;01.07.2014;2014;07;13;Tiistai;17;27;44;4;3;7
109;01.07.2014;2014;07;14;Tiistai;25;26;51;3;4;7
109;01.07.2014;2014;07;15;Tiistai;54;37;91;2;5;7
109;01.07.2014;2014;07;16;Tiistai;62;61;123;5;6;11
109;01.07.2014;2014;07;17;Tiistai;31;36;67;6;14;20
109;01.07.2014;2014;07;18;Tiistai;25;21;46;7;10;17
109;01.07.2014;2014;07;19;Tiistai;20;23;43;2;7;9
109;01.07.2014;2014;07;20;Tiistai;23;21;44;7;3;10
109;01.07.2014;2014;07;21;Tiistai;23;10;33;4;6;10
109;01.07.2014;2014;07;22;Tiistai;10;14;24;2;3;5
109;01.07.2014;2014;07;23;Tiistai;2;1;3;2;1;3
109;02.07.2014;2014;07;00;Keskiviikko;2;6;8;2;1;3
109;02.07.2014;2014;07;01;Keskiviikko;1;1;2;0;0;0
109;02.07.2014;2014;07;02;Keskiviikko;1;2;3;0;1;1
109;02.07.2014;2014;07;03;Keskiviikko;0;1;1;0;0;0
109;02.07.2014;2014;07;04;Keskiviikko;3;1;4;1;0;1
109;02.07.2014;2014;07;05;Keskiviikko;9;4;13;2;0;2
109;02.07.2014;2014;07;06;Keskiviikko;14;24;38;0;4;4
109;02.07.2014;2014;07;07;Keskiviikko;34;43;77;6;3;9
109;02.07.2014;2014;07;08;Keskiviikko;11;26;37;2;1;3
109;02.07.2014;2014;07;09;Keskiviikko;6;5;11;4;0;4
109;02.07.2014;2014;07;10;Keskiviikko;4;4;8;2;2;4
109;02.07.2014;2014;07;11;Keskiviikko;3;5;8;2;2;4
109;02.07.2014;2014;07;12;Keskiviikko;3;7;10;3;0;3
109;02.07.2014;2014;07;13;Keskiviikko;8;9;17;0;2;2
109;02.07.2014;2014;07;14;Keskiviikko;12;11;23;0;3;3
109;02.07.2014;2014;07;15;Keskiviikko;17;18;35;0;2;2
109;02.07.2014;2014;07;16;Keskiviikko;31;21;52;5;0;5
109;02.07.2014;2014;07;17;Keskiviikko;12;9;21;3;2;5
109;02.07.2014;2014;07;18;Keskiviikko;9;0;9;1;1;2
109;02.07.2014;2014;07;19;Keskiviikko;6;8;14;3;1;4
109;02.07.2014;2014;07;20;Keskiviikko;2;4;6;2;1;3
109;02.07.2014;2014;07;21;Keskiviikko;4;7;11;2;2;4
109;02.07.2014;2014;07;22;Keskiviikko;4;3;7;1;1;2
109;02.07.2014;2014;07;23;Keskiviikko;3;1;4;0;2;2
109;03.07.2014;2014;07;00;Torstai;0;0;0;1;0;1
109;03.07.2014;2014;07;01;Torstai;0;0;0;0;0;0
109;03.07.2014;2014;07;02;Torstai;0;1;1;0;0;0
109;03.07.2014;2014;07;03;Torstai;0;0;0;0;0;0
109;03.07.2014;2014;07;04;Torstai;1;1;2;3;0;3
109;03.07.2014;2014;07;05;Torstai;10;5;15;0;0;0
109;03.07.2014;2014;07;06;Torstai;15;26;41;1;1;2
109;03.07.2014;2014;07;07;Torstai;25;44;69;2;3;5
109;03.07.2014;2014;07;08;Torstai;12;24;36;4;0;4
109;03.07.2014;2014;07;09;Torstai;9;18;27;4;3;7
109;03.07.2014;2014;07;10;Torstai;4;14;18;1;3;4
109;03.07.2014;2014;07;11;Torstai;7;8;15;3;2;5
109;03.07.2014;2014;07;12;Torstai;7;13;20;0;5;5
109;03.07.2014;2014;07;13;Torstai;10;8;18;2;0;2
109;03.07.2014;2014;07;14;Torstai;16;22;38;3;3;6
109;03.07.2014;2014;07;15;Torstai;17;30;47;5;4;9
109;03.07.2014;2014;07;16;Torstai;41;26;67;2;3;5
109;03.07.2014;2014;07;17;Torstai;18;23;41;5;8;13
109;03.07.2014;2014;07;18;Torstai;25;10;35;11;3;14
109;03.07.2014;2014;07;19;Torstai;8;15;23;2;2;4
109;03.07.2014;2014;07;20;Torstai;10;9;19;6;7;13
109;03.07.2014;2014;07;21;Torstai;9;11;20;2;1;3
109;03.07.2014;2014;07;22;Torstai;5;4;9;1;0;1
109;03.07.2014;2014;07;23;Torstai;5;2;7;0;1;1
109;04.07.2014;2014;07;00;Perjantai;2;3;5;0;1;1
109;04.07.2014;2014;07;01;Perjantai;0;0;0;2;1;3
109;04.07.2014;2014;07;02;Perjantai;3;2;5;2;0;2
109;04.07.2014;2014;07;03;Perjantai;0;1;1;0;0;0
109;04.07.2014;2014;07;04;Perjantai;1;0;1;0;0;0
109;04.07.2014;2014;07;05;Perjantai;11;8;19;1;2;3
109;04.07.2014;2014;07;06;Perjantai;15;28;43;2;1;3
109;04.07.2014;2014;07;07;Perjantai;21;48;69;4;0;4
109;04.07.2014;2014;07;08;Perjantai;11;30;41;5;0;5
109;04.07.2014;2014;07;09;Perjantai;6;15;21;2;10;12
109;04.07.2014;2014;07;10;Perjantai;7;26;33;5;3;8
109;04.07.2014;2014;07;11;Perjantai;17;14;31;0;6;6
109;04.07.2014;2014;07;12;Perjantai;13;22;35;3;4;7
109;04.07.2014;2014;07;13;Perjantai;12;25;37;0;4;4
109;04.07.2014;2014;07;14;Perjantai;27;34;61;2;7;9
109;04.07.2014;2014;07;15;Perjantai;39;33;72;3;2;5
109;04.07.2014;2014;07;16;Perjantai;34;34;68;3;4;7
109;04.07.2014;2014;07;17;Perjantai;11;8;19;4;3;7
109;04.07.2014;2014;07;18;Perjantai;9;9;18;4;2;6
109;04.07.2014;2014;07;19;Perjantai;6;10;16;2;1;3
109;04.07.2014;2014;07;20;Perjantai;7;2;9;0;3;3
109;04.07.2014;2014;07;21;Perjantai;11;7;18;4;3;7
109;04.07.2014;2014;07;22;Perjantai;7;5;12;2;1;3
109;04.07.2014;2014;07;23;Perjantai;6;5;11;3;0;3
109;05.07.2014;2014;07;00;Lauantai;0;3;3;0;0;0
109;05.07.2014;2014;07;01;Lauantai;2;0;2;0;1;1
109;05.07.2014;2014;07;02;Lauantai;5;0;5;0;0;0
109;05.07.2014;2014;07;03;Lauantai;4;0;4;4;0;4
109;05.07.2014;2014;07;04;Lauantai;2;1;3;0;0;0
109;05.07.2014;2014;07;05;Lauantai;1;2;3;2;1;3
109;05.07.2014;2014;07;06;Lauantai;1;5;6;1;2;3
109;05.07.2014;2014;07;07;Lauantai;5;4;9;1;3;4
109;05.07.2014;2014;07;08;Lauantai;2;4;6;3;4;7
109;05.07.2014;2014;07;09;Lauantai;4;7;11;3;10;13
109;05.07.2014;2014;07;10;Lauantai;8;14;22;1;3;4
109;05.07.2014;2014;07;11;Lauantai;13;17;30;4;3;7
109;05.07.2014;2014;07;12;Lauantai;12;19;31;2;1;3
109;05.07.2014;2014;07;13;Lauantai;12;26;38;3;3;6
109;05.07.2014;2014;07;14;Lauantai;17;17;34;2;5;7
109;05.07.2014;2014;07;15;Lauantai;17;16;33;4;4;8
109;05.07.2014;2014;07;16;Lauantai;16;19;35;2;6;8
109;05.07.2014;2014;07;17;Lauantai;13;22;35;3;9;12
109;05.07.2014;2014;07;18;Lauantai;9;19;28;7;8;15
109;05.07.2014;2014;07;19;Lauantai;8;18;26;3;6;9
109;05.07.2014;2014;07;20;Lauantai;11;11;22;1;2;3
109;05.07.2014;2014;07;21;Lauantai;14;10;24;2;3;5
109;05.07.2014;2014;07;22;Lauantai;6;8;14;0;1;1
109;05.07.2014;2014;07;23;Lauantai;1;4;5;0;2;2
109;06.07.2014;2014;07;00;Sunnuntai;6;4;10;1;0;1
109;06.07.2014;2014;07;01;Sunnuntai;10;3;13;0;0;0
109;06.07.2014;2014;07;02;Sunnuntai;2;1;3;0;2;2
109;06.07.2014;2014;07;03;Sunnuntai;2;0;2;0;0;0
109;06.07.2014;2014;07;04;Sunnuntai;13;4;17;0;0;0
109;06.07.2014;2014;07;05;Sunnuntai;3;2;5;0;1;1
109;06.07.2014;2014;07;06;Sunnuntai;3;5;8;0;0;0
109;06.07.2014;2014;07;07;Sunnuntai;1;5;6;2;5;7
109;06.07.2014;2014;07;08;Sunnuntai;2;6;8;6;4;10
109;06.07.2014;2014;07;09;Sunnuntai;8;8;16;3;11;14
109;06.07.2014;2014;07;10;Sunnuntai;12;10;22;2;6;8
109;06.07.2014;2014;07;11;Sunnuntai;15;24;39;6;10;16
109;06.07.2014;2014;07;12;Sunnuntai;24;34;58;4;9;13
109;06.07.2014;2014;07;13;Sunnuntai;19;24;43;7;3;10
109;06.07.2014;2014;07;14;Sunnuntai;24;33;57;3;5;8
109;06.07.2014;2014;07;15;Sunnuntai;20;29;49;0;6;6
109;06.07.2014;2014;07;16;Sunnuntai;22;25;47;7;9;16
109;06.07.2014;2014;07;17;Sunnuntai;19;17;36;5;3;8
109;06.07.2014;2014;07;18;Sunnuntai;11;27;38;1;4;5
109;06.07.2014;2014;07;19;Sunnuntai;24;23;47;2;7;9
109;06.07.2014;2014;07;20;Sunnuntai;17;17;34;6;4;10
109;06.07.2014;2014;07;21;Sunnuntai;13;13;26;4;2;6
109;06.07.2014;2014;07;22;Sunnuntai;8;1;9;5;1;6
109;06.07.2014;2014;07;23;Sunnuntai;5;3;8;0;1;1
109;07.07.2014;2014;07;00;Maanantai;2;3;5;1;1;2
109;07.07.2014;2014;07;01;Maanantai;0;7;7;0;0;0
109;07.07.2014;2014;07;02;Maanantai;2;0;2;0;0;0
109;07.07.2014;2014;07;03;Maanantai;0;1;1;0;0;0
109;07.07.2014;2014;07;04;Maanantai;1;2;3;0;0;0
109;07.07.2014;2014;07;05;Maanantai;9;4;13;1;1;2
109;07.07.2014;2014;07;06;Maanantai;12;32;44;2;3;5
109;07.07.2014;2014;07;07;Maanantai;36;53;89;7;4;11
109;07.07.2014;2014;07;08;Maanantai;11;35;46;3;3;6
109;07.07.2014;2014;07;09;Maanantai;10;20;30;5;4;9
109;07.07.2014;2014;07;10;Maanantai;9;22;31;6;2;8
109;07.07.2014;2014;07;11;Maanantai;20;24;44;2;3;5
109;07.07.2014;2014;07;12;Maanantai;19;20;39;1;3;4
109;07.07.2014;2014;07;13;Maanantai;23;28;51;5;5;10
109;07.07.2014;2014;07;14;Maanantai;40;31;71;2;3;5
109;07.07.2014;2014;07;15;Maanantai;48;35;83;5;5;10
109;07.07.2014;2014;07;16;Maanantai;60;60;120;2;10;12
109;07.07.2014;2014;07;17;Maanantai;29;33;62;3;7;10
109;07.07.2014;2014;07;18;Maanantai;25;26;51;4;4;8
109;07.07.2014;2014;07;19;Maanantai;21;27;48;6;4;10
109;07.07.2014;2014;07;20;Maanantai;20;25;45;6;7;13
109;07.07.2014;2014;07;21;Maanantai;18;18;36;2;8;10
109;07.07.2014;2014;07;22;Maanantai;10;17;27;5;4;9
109;07.07.2014;2014;07;23;Maanantai;10;3;13;1;1;2
109;08.07.2014;2014;07;00;Tiistai;9;5;14;2;0;2
109;08.07.2014;2014;07;01;Tiistai;0;1;1;2;0;2
109;08.07.2014;2014;07;02;Tiistai;4;4;8;0;0;0
109;08.07.2014;2014;07;03;Tiistai;1;0;1;1;0;1
109;08.07.2014;2014;07;04;Tiistai;1;1;2;1;0;1
109;08.07.2014;2014;07;05;Tiistai;11;6;17;0;1;1
109;08.07.2014;2014;07;06;Tiistai;15;31;46;5;2;7
109;08.07.2014;2014;07;07;Tiistai;40;56;96;6;1;7
109;08.07.2014;2014;07;08;Tiistai;13;39;52;3;3;6
109;08.07.2014;2014;07;09;Tiistai;13;22;35;6;12;18
109;08.07.2014;2014;07;10;Tiistai;15;25;40;2;4;6
109;08.07.2014;2014;07;11;Tiistai;6;13;19;3;5;8
109;08.07.2014;2014;07;12;Tiistai;19;42;61;1;2;3
109;08.07.2014;2014;07;13;Tiistai;27;21;48;0;2;2
109;08.07.2014;2014;07;14;Tiistai;34;28;62;2;3;5
109;08.07.2014;2014;07;15;Tiistai;58;54;112;4;7;11
109;08.07.2014;2014;07;16;Tiistai;51;48;99;2;3;5
109;08.07.2014;2014;07;17;Tiistai;42;30;72;4;5;9
109;08.07.2014;2014;07;18;Tiistai;22;28;50;4;4;8
109;08.07.2014;2014;07;19;Tiistai;25;49;74;1;4;5
109;08.07.2014;2014;07;20;Tiistai;20;18;38;2;0;2
109;08.07.2014;2014;07;21;Tiistai;10;8;18;7;5;12
109;08.07.2014;2014;07;22;Tiistai;8;15;23;3;1;4
109;08.07.2014;2014;07;23;Tiistai;3;9;12;3;2;5
109;09.07.2014;2014;07;00;Keskiviikko;2;1;3;1;1;2
109;09.07.2014;2014;07;01;Keskiviikko;1;7;8;1;0;1
109;09.07.2014;2014;07;02;Keskiviikko;2;3;5;0;0;0
109;09.07.2014;2014;07;03;Keskiviikko;3;0;3;0;0;0
109;09.07.2014;2014;07;04;Keskiviikko;1;1;2;0;0;0
109;09.07.2014;2014;07;05;Keskiviikko;7;7;14;1;2;3
109;09.07.2014;2014;07;06;Keskiviikko;17;28;45;0;2;2
109;09.07.2014;2014;07;07;Keskiviikko;41;53;94;3;4;7
109;09.07.2014;2014;07;08;Keskiviikko;11;28;39;3;7;10
109;09.07.2014;2014;07;09;Keskiviikko;12;35;47;2;4;6
109;09.07.2014;2014;07;10;Keskiviikko;7;19;26;4;1;5
109;09.07.2014;2014;07;11;Keskiviikko;12;27;39;3;4;7
109;09.07.2014;2014;07;12;Keskiviikko;15;10;25;1;3;4
109;09.07.2014;2014;07;13;Keskiviikko;33;33;66;3;3;6
109;09.07.2014;2014;07;14;Keskiviikko;27;30;57;0;7;7
109;09.07.2014;2014;07;15;Keskiviikko;57;53;110;3;6;9
109;09.07.2014;2014;07;16;Keskiviikko;43;45;88;4;2;6
109;09.07.2014;2014;07;17;Keskiviikko;28;29;57;5;3;8
109;09.07.2014;2014;07;18;Keskiviikko;22;28;50;3;4;7
109;09.07.2014;2014;07;19;Keskiviikko;17;27;44;7;7;14
109;09.07.2014;2014;07;20;Keskiviikko;15;17;32;4;4;8
109;09.07.2014;2014;07;21;Keskiviikko;14;12;26;7;3;10
109;09.07.2014;2014;07;22;Keskiviikko;11;19;30;1;4;5
109;09.07.2014;2014;07;23;Keskiviikko;3;9;12;2;0;2
109;10.07.2014;2014;07;00;Torstai;5;2;7;0;0;0
109;10.07.2014;2014;07;01;Torstai;3;5;8;0;0;0
109;10.07.2014;2014;07;02;Torstai;2;2;4;1;0;1
109;10.07.2014;2014;07;03;Torstai;0;0;0;0;0;0
109;10.07.2014;2014;07;04;Torstai;2;0;2;0;1;1
109;10.07.2014;2014;07;05;Torstai;12;7;19;2;1;3
109;10.07.2014;2014;07;06;Torstai;11;22;33;2;2;4
109;10.07.2014;2014;07;07;Torstai;35;51;86;2;2;4
109;10.07.2014;2014;07;08;Torstai;14;26;40;1;1;2
109;10.07.2014;2014;07;09;Torstai;8;18;26;6;6;12
109;10.07.2014;2014;07;10;Torstai;8;17;25;4;3;7
109;10.07.2014;2014;07;11;Torstai;12;24;36;1;2;3
109;10.07.2014;2014;07;12;Torstai;21;20;41;3;3;6
109;10.07.2014;2014;07;13;Torstai;29;19;48;2;3;5
109;10.07.2014;2014;07;14;Torstai;20;20;40;1;5;6
109;10.07.2014;2014;07;15;Torstai;54;37;91;5;4;9
109;10.07.2014;2014;07;16;Torstai;40;39;79;4;7;11
109;10.07.2014;2014;07;17;Torstai;22;32;54;3;2;5
109;10.07.2014;2014;07;18;Torstai;20;18;38;3;5;8
109;10.07.2014;2014;07;19;Torstai;23;32;55;2;4;6
109;10.07.2014;2014;07;20;Torstai;18;14;32;6;3;9
109;10.07.2014;2014;07;21;Torstai;16;19;35;3;5;8
109;10.07.2014;2014;07;22;Torstai;2;14;16;6;1;7
109;10.07.2014;2014;07;23;Torstai;6;2;8;1;1;2
109;11.07.2014;2014;07;00;Perjantai;7;6;13;2;0;2
109;11.07.2014;2014;07;01;Perjantai;1;4;5;0;2;2
109;11.07.2014;2014;07;02;Perjantai;4;3;7;2;0;2
109;11.07.2014;2014;07;03;Perjantai;4;0;4;1;0;1
109;11.07.2014;2014;07;04;Perjantai;2;1;3;0;0;0
109;11.07.2014;2014;07;05;Perjantai;11;7;18;1;2;3
109;11.07.2014;2014;07;06;Perjantai;10;27;37;3;2;5
109;11.07.2014;2014;07;07;Perjantai;34;40;74;3;5;8
109;11.07.2014;2014;07;08;Perjantai;16;28;44;1;2;3
109;11.07.2014;2014;07;09;Perjantai;11;25;36;3;4;7
109;11.07.2014;2014;07;10;Perjantai;6;20;26;5;3;8
109;11.07.2014;2014;07;11;Perjantai;14;16;30;1;5;6
109;11.07.2014;2014;07;12;Perjantai;14;26;40;3;2;5
109;11.07.2014;2014;07;13;Perjantai;30;27;57;0;5;5
109;11.07.2014;2014;07;14;Perjantai;34;36;70;2;8;10
109;11.07.2014;2014;07;15;Perjantai;44;36;80;9;1;10
109;11.07.2014;2014;07;16;Perjantai;39;34;73;1;1;2
109;11.07.2014;2014;07;17;Perjantai;20;30;50;5;1;6
109;11.07.2014;2014;07;18;Perjantai;14;31;45;2;5;7
109;11.07.2014;2014;07;19;Perjantai;12;30;42;5;7;12
109;11.07.2014;2014;07;20;Perjantai;10;18;28;3;1;4
109;11.07.2014;2014;07;21;Perjantai;10;17;27;1;1;2
109;11.07.2014;2014;07;22;Perjantai;10;15;25;2;2;4
109;11.07.2014;2014;07;23;Perjantai;4;11;15;0;2;2
109;12.07.2014;2014;07;00;Lauantai;12;5;17;0;0;0
109;12.07.2014;2014;07;01;Lauantai;9;1;10;0;0;0
109;12.07.2014;2014;07;02;Lauantai;2;1;3;0;0;0
109;12.07.2014;2014;07;03;Lauantai;4;1;5;0;0;0
109;12.07.2014;2014;07;04;Lauantai;6;4;10;0;0;0
109;12.07.2014;2014;07;05;Lauantai;5;3;8;2;1;3
109;12.07.2014;2014;07;06;Lauantai;1;7;8;0;2;2
109;12.07.2014;2014;07;07;Lauantai;5;4;9;2;2;4
109;12.07.2014;2014;07;08;Lauantai;2;7;9;2;2;4
109;12.07.2014;2014;07;09;Lauantai;2;11;13;2;4;6
109;12.07.2014;2014;07;10;Lauantai;4;15;19;3;4;7
109;12.07.2014;2014;07;11;Lauantai;16;15;31;5;9;14
109;12.07.2014;2014;07;12;Lauantai;9;30;39;1;4;5
109;12.07.2014;2014;07;13;Lauantai;17;28;45;4;10;14
109;12.07.2014;2014;07;14;Lauantai;15;15;30;6;4;10
109;12.07.2014;2014;07;15;Lauantai;19;23;42;3;4;7
109;12.07.2014;2014;07;16;Lauantai;22;19;41;5;3;8
109;12.07.2014;2014;07;17;Lauantai;15;26;41;2;4;6
109;12.07.2014;2014;07;18;Lauantai;22;22;44;2;0;2
109;12.07.2014;2014;07;19;Lauantai;10;16;26;7;3;10
109;12.07.2014;2014;07;20;Lauantai;14;13;27;2;3;5
109;12.07.2014;2014;07;21;Lauantai;14;9;23;0;0;0
109;12.07.2014;2014;07;22;Lauantai;9;6;15;2;2;4
109;12.07.2014;2014;07;23;Lauantai;2;1;3;2;0;2
109;13.07.2014;2014;07;00;Sunnuntai;15;1;16;1;0;1
109;13.07.2014;2014;07;01;Sunnuntai;3;2;5;0;0;0
109;13.07.2014;2014;07;02;Sunnuntai;2;0;2;1;0;1
109;13.07.2014;2014;07;03;Sunnuntai;6;0;6;0;0;0
109;13.07.2014;2014;07;04;Sunnuntai;0;1;1;1;2;3
109;13.07.2014;2014;07;05;Sunnuntai;1;2;3;0;0;0
109;13.07.2014;2014;07;06;Sunnuntai;1;5;6;0;0;0
109;13.07.2014;2014;07;07;Sunnuntai;6;6;12;3;2;5
109;13.07.2014;2014;07;08;Sunnuntai;3;7;10;1;1;2
109;13.07.2014;2014;07;09;Sunnuntai;3;9;12;3;7;10
109;13.07.2014;2014;07;10;Sunnuntai;3;12;15;2;4;6
109;13.07.2014;2014;07;11;Sunnuntai;13;24;37;4;9;13
109;13.07.2014;2014;07;12;Sunnuntai;12;23;35;1;6;7
109;13.07.2014;2014;07;13;Sunnuntai;19;36;55;0;5;5
109;13.07.2014;2014;07;14;Sunnuntai;17;18;35;9;4;13
109;13.07.2014;2014;07;15;Sunnuntai;26;25;51;1;3;4
109;13.07.2014;2014;07;16;Sunnuntai;26;34;60;6;2;8
109;13.07.2014;2014;07;17;Sunnuntai;20;25;45;4;3;7
109;13.07.2014;2014;07;18;Sunnuntai;22;21;43;1;5;6
109;13.07.2014;2014;07;19;Sunnuntai;27;34;61;4;4;8
109;13.07.2014;2014;07;20;Sunnuntai;13;23;36;5;5;10
109;13.07.2014;2014;07;21;Sunnuntai;12;18;30;6;4;10
109;13.07.2014;2014;07;22;Sunnuntai;4;3;7;0;0;0
109;13.07.2014;2014;07;23;Sunnuntai;5;4;9;1;2;3
109;14.07.2014;2014;07;00;Maanantai;2;3;5;1;1;2
109;14.07.2014;2014;07;01;Maanantai;2;7;9;2;1;3
109;14.07.2014;2014;07;02;Maanantai;0;1;1;0;0;0
109;14.07.2014;2014;07;03;Maanantai;0;0;0;0;0;0
109;14.07.2014;2014;07;04;Maanantai;2;1;3;1;1;2
109;14.07.2014;2014;07;05;Maanantai;14;4;18;4;0;4
109;14.07.2014;2014;07;06;Maanantai;15;23;38;1;1;2
109;14.07.2014;2014;07;07;Maanantai;36;49;85;1;5;6
109;14.07.2014;2014;07;08;Maanantai;6;30;36;2;1;3
109;14.07.2014;2014;07;09;Maanantai;10;20;30;0;4;4
109;14.07.2014;2014;07;10;Maanantai;11;14;25;6;3;9
109;14.07.2014;2014;07;11;Maanantai;7;22;29;2;1;3
109;14.07.2014;2014;07;12;Maanantai;13;26;39;2;3;5
109;14.07.2014;2014;07;13;Maanantai;20;28;48;1;5;6
109;14.07.2014;2014;07;14;Maanantai;29;37;66;1;2;3
109;14.07.2014;2014;07;15;Maanantai;46;32;78;2;3;5
109;14.07.2014;2014;07;16;Maanantai;43;41;84;5;3;8
109;14.07.2014;2014;07;17;Maanantai;40;24;64;2;3;5
109;14.07.2014;2014;07;18;Maanantai;16;23;39;5;1;6
109;14.07.2014;2014;07;19;Maanantai;13;7;20;1;0;1
109;14.07.2014;2014;07;20;Maanantai;22;9;31;4;3;7
109;14.07.2014;2014;07;21;Maanantai;10;6;16;4;8;12
109;14.07.2014;2014;07;22;Maanantai;4;8;12;1;1;2
109;14.07.2014;2014;07;23;Maanantai;1;9;10;0;3;3
109;15.07.2014;2014;07;00;Tiistai;0;5;5;0;1;1
109;15.07.2014;2014;07;01;Tiistai;1;1;2;1;0;1
109;15.07.2014;2014;07;02;Tiistai;1;2;3;0;0;0
109;15.07.2014;2014;07;03;Tiistai;0;4;4;1;0;1
109;15.07.2014;2014;07;04;Tiistai;4;2;6;2;0;2
109;15.07.2014;2014;07;05;Tiistai;15;5;20;0;1;1
109;15.07.2014;2014;07;06;Tiistai;13;29;42;1;2;3
109;15.07.2014;2014;07;07;Tiistai;28;48;76;3;2;5
109;15.07.2014;2014;07;08;Tiistai;14;24;38;3;0;3
109;15.07.2014;2014;07;09;Tiistai;7;21;28;4;5;9
109;15.07.2014;2014;07;10;Tiistai;7;17;24;8;2;10
109;15.07.2014;2014;07;11;Tiistai;3;13;16;3;3;6
109;15.07.2014;2014;07;12;Tiistai;11;16;27;2;2;4
109;15.07.2014;2014;07;13;Tiistai;13;20;33;3;3;6
109;15.07.2014;2014;07;14;Tiistai;17;41;58;4;2;6
109;15.07.2014;2014;07;15;Tiistai;43;41;84;2;6;8
109;15.07.2014;2014;07;16;Tiistai;40;43;83;0;2;2
109;15.07.2014;2014;07;17;Tiistai;33;30;63;3;3;6
109;15.07.2014;2014;07;18;Tiistai;20;25;45;2;4;6
109;15.07.2014;2014;07;19;Tiistai;29;29;58;5;3;8
109;15.07.2014;2014;07;20;Tiistai;20;11;31;4;2;6
109;15.07.2014;2014;07;21;Tiistai;7;8;15;0;9;9
109;15.07.2014;2014;07;22;Tiistai;1;13;14;0;0;0
109;15.07.2014;2014;07;23;Tiistai;11;10;21;1;1;2
109;16.07.2014;2014;07;00;Keskiviikko;0;2;2;0;1;1
109;16.07.2014;2014;07;01;Keskiviikko;0;0;0;2;0;2
109;16.07.2014;2014;07;02;Keskiviikko;1;2;3;0;0;0
109;16.07.2014;2014;07;03;Keskiviikko;0;0;0;0;0;0
109;16.07.2014;2014;07;04;Keskiviikko;4;1;5;0;0;0
109;16.07.2014;2014;07;05;Keskiviikko;17;6;23;2;0;2
109;16.07.2014;2014;07;06;Keskiviikko;15;19;34;0;3;3
109;16.07.2014;2014;07;07;Keskiviikko;33;45;78;5;0;5
109;16.07.2014;2014;07;08;Keskiviikko;12;23;35;3;6;9
109;16.07.2014;2014;07;09;Keskiviikko;7;19;26;5;4;9
109;16.07.2014;2014;07;10;Keskiviikko;10;17;27;1;4;5
109;16.07.2014;2014;07;11;Keskiviikko;14;23;37;1;6;7
109;16.07.2014;2014;07;12;Keskiviikko;17;25;42;4;3;7
109;16.07.2014;2014;07;13;Keskiviikko;14;23;37;2;6;8
109;16.07.2014;2014;07;14;Keskiviikko;25;39;64;0;1;1
109;16.07.2014;2014;07;15;Keskiviikko;29;33;62;4;2;6
109;16.07.2014;2014;07;16;Keskiviikko;40;29;69;0;5;5
109;16.07.2014;2014;07;17;Keskiviikko;19;17;36;3;6;9
109;16.07.2014;2014;07;18;Keskiviikko;18;34;52;5;9;14
109;16.07.2014;2014;07;19;Keskiviikko;9;12;21;7;10;17
109;16.07.2014;2014;07;20;Keskiviikko;9;18;27;5;2;7
109;16.07.2014;2014;07;21;Keskiviikko;13;20;33;5;2;7
109;16.07.2014;2014;07;22;Keskiviikko;12;9;21;2;3;5
109;16.07.2014;2014;07;23;Keskiviikko;4;3;7;1;3;4
109;17.07.2014;2014;07;00;Torstai;3;3;6;0;0;0
109;17.07.2014;2014;07;01;Torstai;2;1;3;0;0;0
109;17.07.2014;2014;07;02;Torstai;1;2;3;0;0;0
109;17.07.2014;2014;07;03;Torstai;2;0;2;0;0;0
109;17.07.2014;2014;07;04;Torstai;3;1;4;0;0;0
109;17.07.2014;2014;07;05;Torstai;15;7;22;1;1;2
109;17.07.2014;2014;07;06;Torstai;13;29;42;0;0;0
109;17.07.2014;2014;07;07;Torstai;29;42;71;4;0;4
109;17.07.2014;2014;07;08;Torstai;7;26;33;2;2;4
109;17.07.2014;2014;07;09;Torstai;8;18;26;3;3;6
109;17.07.2014;2014;07;10;Torstai;11;5;16;5;5;10
109;17.07.2014;2014;07;11;Torstai;14;13;27;1;7;8
109;17.07.2014;2014;07;12;Torstai;13;20;33;1;1;2
109;17.07.2014;2014;07;13;Torstai;13;19;32;2;6;8
109;17.07.2014;2014;07;14;Torstai;17;21;38;3;1;4
109;17.07.2014;2014;07;15;Torstai;27;40;67;7;2;9
109;17.07.2014;2014;07;16;Torstai;42;36;78;1;6;7
109;17.07.2014;2014;07;17;Torstai;28;19;47;2;6;8
109;17.07.2014;2014;07;18;Torstai;11;32;43;4;6;10
109;17.07.2014;2014;07;19;Torstai;18;26;44;6;3;9
109;17.07.2014;2014;07;20;Torstai;15;16;31;1;5;6
109;17.07.2014;2014;07;21;Torstai;14;11;25;3;2;5
109;17.07.2014;2014;07;22;Torstai;8;11;19;0;0;0
109;17.07.2014;2014;07;23;Torstai;1;3;4;1;0;1
109;18.07.2014;2014;07;00;Perjantai;3;1;4;0;0;0
109;18.07.2014;2014;07;01;Perjantai;1;0;1;0;1;1
109;18.07.2014;2014;07;02;Perjantai;1;2;3;0;3;3
109;18.07.2014;2014;07;03;Perjantai;0;2;2;0;0;0
109;18.07.2014;2014;07;04;Perjantai;1;1;2;1;0;1
109;18.07.2014;2014;07;05;Perjantai;13;6;19;0;1;1
109;18.07.2014;2014;07;06;Perjantai;13;18;31;2;4;6
109;18.07.2014;2014;07;07;Perjantai;25;31;56;2;2;4
109;18.07.2014;2014;07;08;Perjantai;7;22;29;4;4;8
109;18.07.2014;2014;07;09;Perjantai;7;19;26;3;2;5
109;18.07.2014;2014;07;10;Perjantai;7;13;20;2;4;6
109;18.07.2014;2014;07;11;Perjantai;8;12;20;2;1;3
109;18.07.2014;2014;07;12;Perjantai;17;13;30;4;1;5
109;18.07.2014;2014;07;13;Perjantai;14;19;33;3;1;4
109;18.07.2014;2014;07;14;Perjantai;23;13;36;2;0;2
109;18.07.2014;2014;07;15;Perjantai;17;18;35;1;5;6
109;18.07.2014;2014;07;16;Perjantai;18;23;41;3;3;6
109;18.07.2014;2014;07;17;Perjantai;25;26;51;5;3;8
109;18.07.2014;2014;07;18;Perjantai;15;32;47;1;2;3
109;18.07.2014;2014;07;19;Perjantai;11;24;35;3;2;5
109;18.07.2014;2014;07;20;Perjantai;9;22;31;4;4;8
109;18.07.2014;2014;07;21;Perjantai;17;16;33;2;4;6
109;18.07.2014;2014;07;22;Perjantai;3;12;15;1;2;3
109;18.07.2014;2014;07;23;Perjantai;3;3;6;1;2;3
109;19.07.2014;2014;07;00;Lauantai;0;5;5;0;1;1
109;19.07.2014;2014;07;01;Lauantai;5;1;6;3;1;4
109;19.07.2014;2014;07;02;Lauantai;0;5;5;0;1;1
109;19.07.2014;2014;07;03;Lauantai;13;2;15;1;0;1
109;19.07.2014;2014;07;04;Lauantai;9;0;9;0;0;0
109;19.07.2014;2014;07;05;Lauantai;0;2;2;1;0;1
109;19.07.2014;2014;07;06;Lauantai;3;6;9;0;3;3
109;19.07.2014;2014;07;07;Lauantai;1;4;5;1;1;2
109;19.07.2014;2014;07;08;Lauantai;7;8;15;4;2;6
109;19.07.2014;2014;07;09;Lauantai;7;14;21;4;6;10
109;19.07.2014;2014;07;10;Lauantai;7;7;14;5;4;9
109;19.07.2014;2014;07;11;Lauantai;8;26;34;1;2;3
109;19.07.2014;2014;07;12;Lauantai;14;24;38;1;1;2
109;19.07.2014;2014;07;13;Lauantai;14;16;30;2;5;7
109;19.07.2014;2014;07;14;Lauantai;10;7;17;1;2;3
109;19.07.2014;2014;07;15;Lauantai;17;10;27;1;4;5
109;19.07.2014;2014;07;16;Lauantai;16;6;22;5;5;10
109;19.07.2014;2014;07;17;Lauantai;5;3;8;2;1;3
109;19.07.2014;2014;07;18;Lauantai;8;13;21;2;3;5
109;19.07.2014;2014;07;19;Lauantai;5;9;14;4;3;7
109;19.07.2014;2014;07;20;Lauantai;2;16;18;3;0;3
109;19.07.2014;2014;07;21;Lauantai;12;5;17;1;3;4
109;19.07.2014;2014;07;22;Lauantai;4;9;13;1;0;1
109;19.07.2014;2014;07;23;Lauantai;3;2;5;2;1;3
109;20.07.2014;2014;07;00;Sunnuntai;5;1;6;0;0;0
109;20.07.2014;2014;07;01;Sunnuntai;6;2;8;1;0;1
109;20.07.2014;2014;07;02;Sunnuntai;2;0;2;0;0;0
109;20.07.2014;2014;07;03;Sunnuntai;6;0;6;0;0;0
109;20.07.2014;2014;07;04;Sunnuntai;1;0;1;1;0;1
109;20.07.2014;2014;07;05;Sunnuntai;2;1;3;0;0;0
109;20.07.2014;2014;07;06;Sunnuntai;5;4;9;1;2;3
109;20.07.2014;2014;07;07;Sunnuntai;2;3;5;2;1;3
109;20.07.2014;2014;07;08;Sunnuntai;3;5;8;2;4;6
109;20.07.2014;2014;07;09;Sunnuntai;5;11;16;7;4;11
109;20.07.2014;2014;07;10;Sunnuntai;6;13;19;3;4;7
109;20.07.2014;2014;07;11;Sunnuntai;16;23;39;3;8;11
109;20.07.2014;2014;07;12;Sunnuntai;18;20;38;2;1;3
109;20.07.2014;2014;07;13;Sunnuntai;8;15;23;3;2;5
109;20.07.2014;2014;07;14;Sunnuntai;16;28;44;0;7;7
109;20.07.2014;2014;07;15;Sunnuntai;18;14;32;3;4;7
109;20.07.2014;2014;07;16;Sunnuntai;24;30;54;5;4;9
109;20.07.2014;2014;07;17;Sunnuntai;17;16;33;3;2;5
109;20.07.2014;2014;07;18;Sunnuntai;15;31;46;2;4;6
109;20.07.2014;2014;07;19;Sunnuntai;12;12;24;6;3;9
109;20.07.2014;2014;07;20;Sunnuntai;17;17;34;6;9;15
109;20.07.2014;2014;07;21;Sunnuntai;18;9;27;3;4;7
109;20.07.2014;2014;07;22;Sunnuntai;6;3;9;1;1;2
109;20.07.2014;2014;07;23;Sunnuntai;2;1;3;2;2;4
109;21.07.2014;2014;07;00;Maanantai;6;0;6;0;0;0
109;21.07.2014;2014;07;01;Maanantai;1;3;4;2;0;2
109;21.07.2014;2014;07;02;Maanantai;1;0;1;0;1;1
109;21.07.2014;2014;07;03;Maanantai;0;0;0;0;0;0
109;21.07.2014;2014;07;04;Maanantai;2;0;2;0;0;0
109;21.07.2014;2014;07;05;Maanantai;10;8;18;1;1;2
109;21.07.2014;2014;07;06;Maanantai;13;31;44;1;2;3
109;21.07.2014;2014;07;07;Maanantai;30;49;79;2;1;3
109;21.07.2014;2014;07;08;Maanantai;8;29;37;1;4;5
109;21.07.2014;2014;07;09;Maanantai;5;23;28;5;7;12
109;21.07.2014;2014;07;10;Maanantai;3;20;23;3;3;6
109;21.07.2014;2014;07;11;Maanantai;9;38;47;2;1;3
109;21.07.2014;2014;07;12;Maanantai;10;18;28;3;2;5
109;21.07.2014;2014;07;13;Maanantai;23;31;54;4;1;5
109;21.07.2014;2014;07;14;Maanantai;34;30;64;0;2;2
109;21.07.2014;2014;07;15;Maanantai;42;38;80;3;2;5
109;21.07.2014;2014;07;16;Maanantai;47;47;94;3;3;6
109;21.07.2014;2014;07;17;Maanantai;34;30;64;5;3;8
109;21.07.2014;2014;07;18;Maanantai;20;16;36;4;3;7
109;21.07.2014;2014;07;19;Maanantai;26;36;62;7;5;12
109;21.07.2014;2014;07;20;Maanantai;16;21;37;3;3;6
109;21.07.2014;2014;07;21;Maanantai;17;14;31;6;5;11
109;21.07.2014;2014;07;22;Maanantai;9;17;26;4;4;8
109;21.07.2014;2014;07;23;Maanantai;3;10;13;1;0;1
109;22.07.2014;2014;07;00;Tiistai;3;1;4;0;0;0
109;22.07.2014;2014;07;01;Tiistai;2;3;5;0;1;1
109;22.07.2014;2014;07;02;Tiistai;2;0;2;0;0;0
109;22.07.2014;2014;07;03;Tiistai;3;0;3;0;0;0
109;22.07.2014;2014;07;04;Tiistai;3;2;5;0;0;0
109;22.07.2014;2014;07;05;Tiistai;10;4;14;1;1;2
109;22.07.2014;2014;07;06;Tiistai;14;35;49;1;3;4
109;22.07.2014;2014;07;07;Tiistai;29;57;86;3;1;4
109;22.07.2014;2014;07;08;Tiistai;7;26;33;3;3;6
109;22.07.2014;2014;07;09;Tiistai;8;25;33;6;2;8
109;22.07.2014;2014;07;10;Tiistai;6;19;25;2;7;9
109;22.07.2014;2014;07;11;Tiistai;15;22;37;2;1;3
109;22.07.2014;2014;07;12;Tiistai;14;22;36;2;4;6
109;22.07.2014;2014;07;13;Tiistai;22;28;50;3;2;5
109;22.07.2014;2014;07;14;Tiistai;19;32;51;0;2;2
109;22.07.2014;2014;07;15;Tiistai;51;37;88;1;1;2
109;22.07.2014;2014;07;16;Tiistai;48;44;92;0;7;7
109;22.07.2014;2014;07;17;Tiistai;31;30;61;3;1;4
109;22.07.2014;2014;07;18;Tiistai;26;23;49;5;4;9
109;22.07.2014;2014;07;19;Tiistai;14;25;39;5;5;10
109;22.07.2014;2014;07;20;Tiistai;15;22;37;3;2;5
109;22.07.2014;2014;07;21;Tiistai;29;19;48;5;4;9
109;22.07.2014;2014;07;22;Tiistai;3;8;11;6;5;11
109;22.07.2014;2014;07;23;Tiistai;2;4;6;0;3;3
109;23.07.2014;2014;07;00;Keskiviikko;1;1;2;0;0;0
109;23.07.2014;2014;07;01;Keskiviikko;0;0;0;0;0;0
109;23.07.2014;2014;07;02;Keskiviikko;4;0;4;0;0;0
109;23.07.2014;2014;07;03;Keskiviikko;2;0;2;0;0;0
109;23.07.2014;2014;07;04;Keskiviikko;5;1;6;0;0;0
109;23.07.2014;2014;07;05;Keskiviikko;17;8;25;1;3;4
109;23.07.2014;2014;07;06;Keskiviikko;11;33;44;2;1;3
109;23.07.2014;2014;07;07;Keskiviikko;26;47;73;4;3;7
109;23.07.2014;2014;07;08;Keskiviikko;11;22;33;3;5;8
109;23.07.2014;2014;07;09;Keskiviikko;11;25;36;3;3;6
109;23.07.2014;2014;07;10;Keskiviikko;13;18;31;3;2;5
109;23.07.2014;2014;07;11;Keskiviikko;14;34;48;2;4;6
109;23.07.2014;2014;07;12;Keskiviikko;11;28;39;3;3;6
109;23.07.2014;2014;07;13;Keskiviikko;25;22;47;2;2;4
109;23.07.2014;2014;07;14;Keskiviikko;31;30;61;2;6;8
109;23.07.2014;2014;07;15;Keskiviikko;51;38;89;3;6;9
109;23.07.2014;2014;07;16;Keskiviikko;38;45;83;0;3;3
109;23.07.2014;2014;07;17;Keskiviikko;19;34;53;3;9;12
109;23.07.2014;2014;07;18;Keskiviikko;19;19;38;4;0;4
109;23.07.2014;2014;07;19;Keskiviikko;11;28;39;0;5;5
109;23.07.2014;2014;07;20;Keskiviikko;23;21;44;1;6;7
109;23.07.2014;2014;07;21;Keskiviikko;15;19;34;3;4;7
109;23.07.2014;2014;07;22;Keskiviikko;8;13;21;3;3;6
109;23.07.2014;2014;07;23;Keskiviikko;5;6;11;0;1;1
109;24.07.2014;2014;07;00;Torstai;7;2;9;0;2;2
109;24.07.2014;2014;07;01;Torstai;1;6;7;1;1;2
109;24.07.2014;2014;07;02;Torstai;5;1;6;0;0;0
109;24.07.2014;2014;07;03;Torstai;1;0;1;0;1;1
109;24.07.2014;2014;07;04;Torstai;2;0;2;0;0;0
109;24.07.2014;2014;07;05;Torstai;18;5;23;1;2;3
109;24.07.2014;2014;07;06;Torstai;14;34;48;1;4;5
109;24.07.2014;2014;07;07;Torstai;28;37;65;6;2;8
109;24.07.2014;2014;07;08;Torstai;7;26;33;1;4;5
109;24.07.2014;2014;07;09;Torstai;7;19;26;5;3;8
109;24.07.2014;2014;07;10;Torstai;2;24;26;4;4;8
109;24.07.2014;2014;07;11;Torstai;10;16;26;2;3;5
109;24.07.2014;2014;07;12;Torstai;16;18;34;2;7;9
109;24.07.2014;2014;07;13;Torstai;18;24;42;2;3;5
109;24.07.2014;2014;07;14;Torstai;22;23;45;3;2;5
109;24.07.2014;2014;07;15;Torstai;36;52;88;3;8;11
109;24.07.2014;2014;07;16;Torstai;46;36;82;3;2;5
109;24.07.2014;2014;07;17;Torstai;24;22;46;2;4;6
109;24.07.2014;2014;07;18;Torstai;26;24;50;1;0;1
109;24.07.2014;2014;07;19;Torstai;14;26;40;3;4;7
109;24.07.2014;2014;07;20;Torstai;9;18;27;4;3;7
109;24.07.2014;2014;07;21;Torstai;26;15;41;4;7;11
109;24.07.2014;2014;07;22;Torstai;13;13;26;2;2;4
109;24.07.2014;2014;07;23;Torstai;1;0;1;2;0;2
109;25.07.2014;2014;07;00;Perjantai;5;1;6;0;0;0
109;25.07.2014;2014;07;01;Perjantai;2;2;4;0;1;1
109;25.07.2014;2014;07;02;Perjantai;1;1;2;1;0;1
109;25.07.2014;2014;07;03;Perjantai;1;2;3;1;0;1
109;25.07.2014;2014;07;04;Perjantai;4;0;4;0;0;0
109;25.07.2014;2014;07;05;Perjantai;13;6;19;1;1;2
109;25.07.2014;2014;07;06;Perjantai;13;28;41;3;1;4
109;25.07.2014;2014;07;07;Perjantai;25;39;64;2;0;2
109;25.07.2014;2014;07;08;Perjantai;7;22;29;3;3;6
109;25.07.2014;2014;07;09;Perjantai;6;27;33;4;0;4
109;25.07.2014;2014;07;10;Perjantai;5;18;23;0;2;2
109;25.07.2014;2014;07;11;Perjantai;13;27;40;3;2;5
109;25.07.2014;2014;07;12;Perjantai;17;23;40;2;5;7
109;25.07.2014;2014;07;13;Perjantai;25;35;60;1;2;3
109;25.07.2014;2014;07;14;Perjantai;23;33;56;1;3;4
109;25.07.2014;2014;07;15;Perjantai;38;69;107;2;3;5
109;25.07.2014;2014;07;16;Perjantai;31;41;72;1;3;4
109;25.07.2014;2014;07;17;Perjantai;22;34;56;4;5;9
109;25.07.2014;2014;07;18;Perjantai;24;44;68;0;5;5
109;25.07.2014;2014;07;19;Perjantai;12;32;44;0;2;2
109;25.07.2014;2014;07;20;Perjantai;15;30;45;2;4;6
109;25.07.2014;2014;07;21;Perjantai;13;18;31;3;6;9
109;25.07.2014;2014;07;22;Perjantai;7;10;17;0;0;0
109;25.07.2014;2014;07;23;Perjantai;12;4;16;2;1;3
109;26.07.2014;2014;07;00;Lauantai;22;1;23;1;2;3
109;26.07.2014;2014;07;01;Lauantai;22;5;27;3;1;4
109;26.07.2014;2014;07;02;Lauantai;25;2;27;1;0;1
109;26.07.2014;2014;07;03;Lauantai;5;2;7;1;0;1
109;26.07.2014;2014;07;04;Lauantai;8;3;11;1;0;1
109;26.07.2014;2014;07;05;Lauantai;5;2;7;1;1;2
109;26.07.2014;2014;07;06;Lauantai;2;10;12;1;0;1
109;26.07.2014;2014;07;07;Lauantai;4;5;9;2;2;4
109;26.07.2014;2014;07;08;Lauantai;1;6;7;2;1;3
109;26.07.2014;2014;07;09;Lauantai;8;16;24;1;2;3
109;26.07.2014;2014;07;10;Lauantai;7;16;23;3;1;4
109;26.07.2014;2014;07;11;Lauantai;10;43;53;5;8;13
109;26.07.2014;2014;07;12;Lauantai;19;30;49;2;3;5
109;26.07.2014;2014;07;13;Lauantai;15;31;46;1;3;4
109;26.07.2014;2014;07;14;Lauantai;20;22;42;2;5;7
109;26.07.2014;2014;07;15;Lauantai;12;26;38;3;1;4
109;26.07.2014;2014;07;16;Lauantai;22;24;46;4;2;6
109;26.07.2014;2014;07;17;Lauantai;12;26;38;0;2;2
109;26.07.2014;2014;07;18;Lauantai;12;21;33;3;2;5
109;26.07.2014;2014;07;19;Lauantai;13;23;36;2;2;4
109;26.07.2014;2014;07;20;Lauantai;11;17;28;4;1;5
109;26.07.2014;2014;07;21;Lauantai;8;18;26;7;5;12
109;26.07.2014;2014;07;22;Lauantai;5;9;14;1;3;4
109;26.07.2014;2014;07;23;Lauantai;13;8;21;2;2;4
109;27.07.2014;2014;07;00;Sunnuntai;17;6;23;1;2;3
109;27.07.2014;2014;07;01;Sunnuntai;21;1;22;0;1;1
109;27.07.2014;2014;07;02;Sunnuntai;14;0;14;1;0;1
109;27.07.2014;2014;07;03;Sunnuntai;7;0;7;3;0;3
109;27.07.2014;2014;07;04;Sunnuntai;5;0;5;0;0;0
109;27.07.2014;2014;07;05;Sunnuntai;10;2;12;1;1;2
109;27.07.2014;2014;07;06;Sunnuntai;2;6;8;0;0;0
109;27.07.2014;2014;07;07;Sunnuntai;9;4;13;1;2;3
109;27.07.2014;2014;07;08;Sunnuntai;5;9;14;2;2;4
109;27.07.2014;2014;07;09;Sunnuntai;4;10;14;3;0;3
109;27.07.2014;2014;07;10;Sunnuntai;4;11;15;3;4;7
109;27.07.2014;2014;07;11;Sunnuntai;7;10;17;3;6;9
109;27.07.2014;2014;07;12;Sunnuntai;5;31;36;0;2;2
109;27.07.2014;2014;07;13;Sunnuntai;15;22;37;1;3;4
109;27.07.2014;2014;07;14;Sunnuntai;9;15;24;1;6;7
109;27.07.2014;2014;07;15;Sunnuntai;16;9;25;2;2;4
109;27.07.2014;2014;07;16;Sunnuntai;16;8;24;5;3;8
109;27.07.2014;2014;07;17;Sunnuntai;19;13;32;2;5;7
109;27.07.2014;2014;07;18;Sunnuntai;18;36;54;1;3;4
109;27.07.2014;2014;07;19;Sunnuntai;4;15;19;5;2;7
109;27.07.2014;2014;07;20;Sunnuntai;14;30;44;2;4;6
109;27.07.2014;2014;07;21;Sunnuntai;17;14;31;4;4;8
109;27.07.2014;2014;07;22;Sunnuntai;5;4;9;7;1;8
109;27.07.2014;2014;07;23;Sunnuntai;10;4;14;3;3;6
109;28.07.2014;2014;07;00;Maanantai;0;1;1;1;0;1
109;28.07.2014;2014;07;01;Maanantai;0;0;0;0;0;0
109;28.07.2014;2014;07;02;Maanantai;0;0;0;0;0;0
109;28.07.2014;2014;07;03;Maanantai;0;1;1;0;0;0
109;28.07.2014;2014;07;04;Maanantai;1;1;2;1;0;1
109;28.07.2014;2014;07;05;Maanantai;13;10;23;1;2;3
109;28.07.2014;2014;07;06;Maanantai;14;27;41;2;4;6
109;28.07.2014;2014;07;07;Maanantai;25;50;75;3;4;7
109;28.07.2014;2014;07;08;Maanantai;7;34;41;2;6;8
109;28.07.2014;2014;07;09;Maanantai;7;4;11;1;0;1
109;28.07.2014;2014;07;10;Maanantai;3;4;7;1;1;2
109;28.07.2014;2014;07;11;Maanantai;6;9;15;1;2;3
109;28.07.2014;2014;07;12;Maanantai;7;4;11;0;3;3
109;28.07.2014;2014;07;13;Maanantai;14;28;42;4;3;7
109;28.07.2014;2014;07;14;Maanantai;20;16;36;2;2;4
109;28.07.2014;2014;07;15;Maanantai;29;27;56;1;4;5
109;28.07.2014;2014;07;16;Maanantai;40;18;58;4;4;8
109;28.07.2014;2014;07;17;Maanantai;18;18;36;4;5;9
109;28.07.2014;2014;07;18;Maanantai;9;21;30;4;4;8
109;28.07.2014;2014;07;19;Maanantai;9;27;36;8;6;14
109;28.07.2014;2014;07;20;Maanantai;11;12;23;4;3;7
109;28.07.2014;2014;07;21;Maanantai;14;10;24;2;4;6
109;28.07.2014;2014;07;22;Maanantai;5;14;19;3;0;3
109;28.07.2014;2014;07;23;Maanantai;1;4;5;0;2;2
109;29.07.2014;2014;07;00;Tiistai;0;1;1;2;0;2
109;29.07.2014;2014;07;01;Tiistai;3;1;4;0;0;0
109;29.07.2014;2014;07;02;Tiistai;1;0;1;0;0;0
109;29.07.2014;2014;07;03;Tiistai;0;0;0;0;0;0
109;29.07.2014;2014;07;04;Tiistai;2;0;2;1;0;1
109;29.07.2014;2014;07;05;Tiistai;11;7;18;1;1;2
109;29.07.2014;2014;07;06;Tiistai;11;26;37;1;3;4
109;29.07.2014;2014;07;07;Tiistai;26;61;87;2;1;3
109;29.07.2014;2014;07;08;Tiistai;10;27;37;4;3;7
109;29.07.2014;2014;07;09;Tiistai;11;22;33;2;1;3
109;29.07.2014;2014;07;10;Tiistai;12;21;33;3;3;6
109;29.07.2014;2014;07;11;Tiistai;11;15;26;2;3;5
109;29.07.2014;2014;07;12;Tiistai;15;30;45;2;3;5
109;29.07.2014;2014;07;13;Tiistai;21;23;44;2;0;2
109;29.07.2014;2014;07;14;Tiistai;25;19;44;1;2;3
109;29.07.2014;2014;07;15;Tiistai;38;43;81;1;0;1
109;29.07.2014;2014;07;16;Tiistai;47;42;89;2;5;7
109;29.07.2014;2014;07;17;Tiistai;25;40;65;2;6;8
109;29.07.2014;2014;07;18;Tiistai;15;31;46;8;6;14
109;29.07.2014;2014;07;19;Tiistai;20;25;45;5;7;12
109;29.07.2014;2014;07;20;Tiistai;11;16;27;6;5;11
109;29.07.2014;2014;07;21;Tiistai;20;22;42;3;2;5
109;29.07.2014;2014;07;22;Tiistai;11;11;22;4;0;4
109;29.07.2014;2014;07;23;Tiistai;2;3;5;2;2;4
109;30.07.2014;2014;07;00;Keskiviikko;2;7;9;0;0;0
109;30.07.2014;2014;07;01;Keskiviikko;1;1;2;3;0;3
109;30.07.2014;2014;07;02;Keskiviikko;0;1;1;0;0;0
109;30.07.2014;2014;07;03;Keskiviikko;2;1;3;0;0;0
109;30.07.2014;2014;07;04;Keskiviikko;1;0;1;0;0;0
109;30.07.2014;2014;07;05;Keskiviikko;10;3;13;2;1;3
109;30.07.2014;2014;07;06;Keskiviikko;14;32;46;3;3;6
109;30.07.2014;2014;07;07;Keskiviikko;23;59;82;2;1;3
109;30.07.2014;2014;07;08;Keskiviikko;11;30;41;1;2;3
109;30.07.2014;2014;07;09;Keskiviikko;16;26;42;0;8;8
109;30.07.2014;2014;07;10;Keskiviikko;11;21;32;1;3;4
109;30.07.2014;2014;07;11;Keskiviikko;14;15;29;3;7;10
109;30.07.2014;2014;07;12;Keskiviikko;16;29;45;0;6;6
109;30.07.2014;2014;07;13;Keskiviikko;16;23;39;4;2;6
109;30.07.2014;2014;07;14;Keskiviikko;23;31;54;3;5;8
109;30.07.2014;2014;07;15;Keskiviikko;48;32;80;3;1;4
109;30.07.2014;2014;07;16;Keskiviikko;50;48;98;11;5;16
109;30.07.2014;2014;07;17;Keskiviikko;27;32;59;3;3;6
109;30.07.2014;2014;07;18;Keskiviikko;31;31;62;5;1;6
109;30.07.2014;2014;07;19;Keskiviikko;13;36;49;1;5;6
109;30.07.2014;2014;07;20;Keskiviikko;11;25;36;10;4;14
109;30.07.2014;2014;07;21;Keskiviikko;28;11;39;4;4;8
109;30.07.2014;2014;07;22;Keskiviikko;17;14;31;2;3;5
109;30.07.2014;2014;07;23;Keskiviikko;4;5;9;0;1;1
109;31.07.2014;2014;07;00;Torstai;2;2;4;0;0;0
109;31.07.2014;2014;07;01;Torstai;4;0;4;1;0;1
109;31.07.2014;2014;07;02;Torstai;1;3;4;0;1;1
109;31.07.2014;2014;07;03;Torstai;1;0;1;1;0;1
109;31.07.2014;2014;07;04;Torstai;4;1;5;0;0;0
109;31.07.2014;2014;07;05;Torstai;11;2;13;1;0;1
109;31.07.2014;2014;07;06;Torstai;8;18;26;0;4;4
109;31.07.2014;2014;07;07;Torstai;21;43;64;2;2;4
109;31.07.2014;2014;07;08;Torstai;12;21;33;1;3;4
109;31.07.2014;2014;07;09;Torstai;11;14;25;1;4;5
109;31.07.2014;2014;07;10;Torstai;4;9;13;2;1;3
109;31.07.2014;2014;07;11;Torstai;7;14;21;0;0;0
109;31.07.2014;2014;07;12;Torstai;10;15;25;0;0;0
109;31.07.2014;2014;07;13;Torstai;11;4;15;2;0;2
109;31.07.2014;2014;07;14;Torstai;8;5;13;0;0;0
109;31.07.2014;2014;07;15;Torstai;21;5;26;0;2;2
109;31.07.2014;2014;07;16;Torstai;19;18;37;2;0;2
109;31.07.2014;2014;07;17;Torstai;10;4;14;1;2;3
109;31.07.2014;2014;07;18;Torstai;7;1;8;3;0;3
109;31.07.2014;2014;07;19;Torstai;2;9;11;3;1;4
109;31.07.2014;2014;07;20;Torstai;9;13;22;3;3;6
109;31.07.2014;2014;07;21;Torstai;8;7;15;5;6;11
109;31.07.2014;2014;07;22;Torstai;11;17;28;3;3;6
109;31.07.2014;2014;07;23;Torstai;1;1;2;0;1;1
109;01.08.2014;2014;08;00;Perjantai;2;2;4;0;0;0
109;01.08.2014;2014;08;01;Perjantai;0;1;1;0;0;0
109;01.08.2014;2014;08;02;Perjantai;3;2;5;1;0;1
109;01.08.2014;2014;08;03;Perjantai;1;0;1;0;0;0
109;01.08.2014;2014;08;04;Perjantai;3;2;5;1;0;1
109;01.08.2014;2014;08;05;Perjantai;5;7;12;1;1;2
109;01.08.2014;2014;08;06;Perjantai;12;23;35;2;4;6
109;01.08.2014;2014;08;07;Perjantai;34;51;85;2;2;4
109;01.08.2014;2014;08;08;Perjantai;28;13;41;1;1;2
109;01.08.2014;2014;08;09;Perjantai;17;18;35;0;0;0
109;01.08.2014;2014;08;10;Perjantai;17;17;34;1;4;5
109;01.08.2014;2014;08;11;Perjantai;14;18;32;7;8;15
109;01.08.2014;2014;08;12;Perjantai;13;35;48;2;4;6
109;01.08.2014;2014;08;13;Perjantai;30;23;53;3;5;8
109;01.08.2014;2014;08;14;Perjantai;30;41;71;5;6;11
109;01.08.2014;2014;08;15;Perjantai;42;45;87;6;4;10
109;01.08.2014;2014;08;16;Perjantai;36;40;76;0;2;2
109;01.08.2014;2014;08;17;Perjantai;21;29;50;4;2;6
109;01.08.2014;2014;08;18;Perjantai;24;28;52;10;5;15
109;01.08.2014;2014;08;19;Perjantai;10;16;26;2;2;4
109;01.08.2014;2014;08;20;Perjantai;17;23;40;3;2;5
109;01.08.2014;2014;08;21;Perjantai;15;20;35;2;1;3
109;01.08.2014;2014;08;22;Perjantai;18;13;31;3;1;4
109;01.08.2014;2014;08;23;Perjantai;8;5;13;1;1;2
109;02.08.2014;2014;08;00;Lauantai;7;3;10;0;0;0
109;02.08.2014;2014;08;01;Lauantai;7;0;7;1;1;2
109;02.08.2014;2014;08;02;Lauantai;6;0;6;0;1;1
109;02.08.2014;2014;08;03;Lauantai;1;0;1;2;0;2
109;02.08.2014;2014;08;04;Lauantai;0;0;0;0;0;0
109;02.08.2014;2014;08;05;Lauantai;2;2;4;1;0;1
109;02.08.2014;2014;08;06;Lauantai;2;5;7;0;3;3
109;02.08.2014;2014;08;07;Lauantai;2;5;7;1;0;1
109;02.08.2014;2014;08;08;Lauantai;2;3;5;2;3;5
109;02.08.2014;2014;08;09;Lauantai;9;9;18;5;2;7
109;02.08.2014;2014;08;10;Lauantai;9;16;25;4;5;9
109;02.08.2014;2014;08;11;Lauantai;17;22;39;3;3;6
109;02.08.2014;2014;08;12;Lauantai;9;20;29;1;5;6
109;02.08.2014;2014;08;13;Lauantai;20;20;40;2;1;3
109;02.08.2014;2014;08;14;Lauantai;11;21;32;2;5;7
109;02.08.2014;2014;08;15;Lauantai;16;22;38;3;4;7
109;02.08.2014;2014;08;16;Lauantai;19;17;36;2;6;8
109;02.08.2014;2014;08;17;Lauantai;20;25;45;6;3;9
109;02.08.2014;2014;08;18;Lauantai;11;17;28;2;3;5
109;02.08.2014;2014;08;19;Lauantai;11;19;30;2;0;2
109;02.08.2014;2014;08;20;Lauantai;11;10;21;5;2;7
109;02.08.2014;2014;08;21;Lauantai;15;24;39;0;0;0
109;02.08.2014;2014;08;22;Lauantai;6;10;16;1;0;1
109;02.08.2014;2014;08;23;Lauantai;3;5;8;0;0;0
109;03.08.2014;2014;08;00;Sunnuntai;13;12;25;0;1;1
109;03.08.2014;2014;08;01;Sunnuntai;4;0;4;0;0;0
109;03.08.2014;2014;08;02;Sunnuntai;8;3;11;0;0;0
109;03.08.2014;2014;08;03;Sunnuntai;5;1;6;1;0;1
109;03.08.2014;2014;08;04;Sunnuntai;6;1;7;2;0;2
109;03.08.2014;2014;08;05;Sunnuntai;2;0;2;0;0;0
109;03.08.2014;2014;08;06;Sunnuntai;3;8;11;0;0;0
109;03.08.2014;2014;08;07;Sunnuntai;4;2;6;2;5;7
109;03.08.2014;2014;08;08;Sunnuntai;4;5;9;3;5;8
109;03.08.2014;2014;08;09;Sunnuntai;7;9;16;2;1;3
109;03.08.2014;2014;08;10;Sunnuntai;8;10;18;3;3;6
109;03.08.2014;2014;08;11;Sunnuntai;10;14;24;3;8;11
109;03.08.2014;2014;08;12;Sunnuntai;25;29;54;1;1;2
109;03.08.2014;2014;08;13;Sunnuntai;16;19;35;2;2;4
109;03.08.2014;2014;08;14;Sunnuntai;6;39;45;2;4;6
109;03.08.2014;2014;08;15;Sunnuntai;24;22;46;2;1;3
109;03.08.2014;2014;08;16;Sunnuntai;17;36;53;7;4;11
109;03.08.2014;2014;08;17;Sunnuntai;20;18;38;4;2;6
109;03.08.2014;2014;08;18;Sunnuntai;20;22;42;4;3;7
109;03.08.2014;2014;08;19;Sunnuntai;24;30;54;9;6;15
109;03.08.2014;2014;08;20;Sunnuntai;16;24;40;4;2;6
109;03.08.2014;2014;08;21;Sunnuntai;24;16;40;4;6;10
109;03.08.2014;2014;08;22;Sunnuntai;7;9;16;2;0;2
109;03.08.2014;2014;08;23;Sunnuntai;4;7;11;0;0;0
109;04.08.2014;2014;08;00;Maanantai;2;3;5;2;0;2
109;04.08.2014;2014;08;01;Maanantai;0;0;0;0;0;0
109;04.08.2014;2014;08;02;Maanantai;0;0;0;0;0;0
109;04.08.2014;2014;08;03;Maanantai;0;0;0;0;0;0
109;04.08.2014;2014;08;04;Maanantai;2;0;2;0;0;0
109;04.08.2014;2014;08;05;Maanantai;11;5;16;2;1;3
109;04.08.2014;2014;08;06;Maanantai;17;26;43;0;3;3
109;04.08.2014;2014;08;07;Maanantai;41;85;126;3;6;9
109;04.08.2014;2014;08;08;Maanantai;21;49;70;3;5;8
109;04.08.2014;2014;08;09;Maanantai;6;27;33;2;0;2
109;04.08.2014;2014;08;10;Maanantai;11;14;25;3;3;6
109;04.08.2014;2014;08;11;Maanantai;11;21;32;2;2;4
109;04.08.2014;2014;08;12;Maanantai;11;17;28;3;6;9
109;04.08.2014;2014;08;13;Maanantai;21;24;45;4;0;4
109;04.08.2014;2014;08;14;Maanantai;24;38;62;6;1;7
109;04.08.2014;2014;08;15;Maanantai;67;51;118;3;3;6
109;04.08.2014;2014;08;16;Maanantai;80;58;138;7;3;10
109;04.08.2014;2014;08;17;Maanantai;47;26;73;3;4;7
109;04.08.2014;2014;08;18;Maanantai;24;25;49;1;2;3
109;04.08.2014;2014;08;19;Maanantai;24;19;43;3;1;4
109;04.08.2014;2014;08;20;Maanantai;13;28;41;7;7;14
109;04.08.2014;2014;08;21;Maanantai;19;15;34;6;5;11
109;04.08.2014;2014;08;22;Maanantai;13;17;30;0;2;2
109;04.08.2014;2014;08;23;Maanantai;4;1;5;2;0;2
109;05.08.2014;2014;08;00;Tiistai;3;0;3;0;2;2
109;05.08.2014;2014;08;01;Tiistai;1;14;15;1;0;1
109;05.08.2014;2014;08;02;Tiistai;1;0;1;0;0;0
109;05.08.2014;2014;08;03;Tiistai;0;0;0;0;0;0
109;05.08.2014;2014;08;04;Tiistai;2;0;2;0;1;1
109;05.08.2014;2014;08;05;Tiistai;12;6;18;0;2;2
109;05.08.2014;2014;08;06;Tiistai;12;38;50;2;3;5
109;05.08.2014;2014;08;07;Tiistai;40;108;148;3;6;9
109;05.08.2014;2014;08;08;Tiistai;23;60;83;4;2;6
109;05.08.2014;2014;08;09;Tiistai;13;31;44;2;2;4
109;05.08.2014;2014;08;10;Tiistai;9;24;33;2;4;6
109;05.08.2014;2014;08;11;Tiistai;10;27;37;3;4;7
109;05.08.2014;2014;08;12;Tiistai;18;28;46;5;2;7
109;05.08.2014;2014;08;13;Tiistai;28;32;60;1;2;3
109;05.08.2014;2014;08;14;Tiistai;31;32;63;2;2;4
109;05.08.2014;2014;08;15;Tiistai;66;47;113;4;1;5
109;05.08.2014;2014;08;16;Tiistai;101;63;164;4;5;9
109;05.08.2014;2014;08;17;Tiistai;43;35;78;3;2;5
109;05.08.2014;2014;08;18;Tiistai;34;30;64;1;6;7
109;05.08.2014;2014;08;19;Tiistai;27;33;60;5;6;11
109;05.08.2014;2014;08;20;Tiistai;21;30;51;1;6;7
109;05.08.2014;2014;08;21;Tiistai;36;18;54;5;1;6
109;05.08.2014;2014;08;22;Tiistai;4;18;22;3;1;4
109;05.08.2014;2014;08;23;Tiistai;4;8;12;0;1;1
109;06.08.2014;2014;08;00;Keskiviikko;5;4;9;0;0;0
109;06.08.2014;2014;08;01;Keskiviikko;4;0;4;0;0;0
109;06.08.2014;2014;08;02;Keskiviikko;2;1;3;0;0;0
109;06.08.2014;2014;08;03;Keskiviikko;0;0;0;0;0;0
109;06.08.2014;2014;08;04;Keskiviikko;1;1;2;2;0;2
109;06.08.2014;2014;08;05;Keskiviikko;13;4;17;0;0;0
109;06.08.2014;2014;08;06;Keskiviikko;17;37;54;0;1;1
109;06.08.2014;2014;08;07;Keskiviikko;42;89;131;4;5;9
109;06.08.2014;2014;08;08;Keskiviikko;32;73;105;3;3;6
109;06.08.2014;2014;08;09;Keskiviikko;13;40;53;1;4;5
109;06.08.2014;2014;08;10;Keskiviikko;13;23;36;2;3;5
109;06.08.2014;2014;08;11;Keskiviikko;8;24;32;3;0;3
109;06.08.2014;2014;08;12;Keskiviikko;22;32;54;3;2;5
109;06.08.2014;2014;08;13;Keskiviikko;32;28;60;3;3;6
109;06.08.2014;2014;08;14;Keskiviikko;40;31;71;1;4;5
109;06.08.2014;2014;08;15;Keskiviikko;72;39;111;6;4;10
109;06.08.2014;2014;08;16;Keskiviikko;85;58;143;3;3;6
109;06.08.2014;2014;08;17;Keskiviikko;44;42;86;8;2;10
109;06.08.2014;2014;08;18;Keskiviikko;53;41;94;4;2;6
109;06.08.2014;2014;08;19;Keskiviikko;19;25;44;2;3;5
109;06.08.2014;2014;08;20;Keskiviikko;11;17;28;2;4;6
109;06.08.2014;2014;08;21;Keskiviikko;28;34;62;3;4;7
109;06.08.2014;2014;08;22;Keskiviikko;27;29;56;6;1;7
109;06.08.2014;2014;08;23;Keskiviikko;2;5;7;1;0;1
109;07.08.2014;2014;08;00;Torstai;4;3;7;0;1;1
109;07.08.2014;2014;08;01;Torstai;5;2;7;1;0;1
109;07.08.2014;2014;08;02;Torstai;0;1;1;0;0;0
109;07.08.2014;2014;08;03;Torstai;2;0;2;0;2;2
109;07.08.2014;2014;08;04;Torstai;2;1;3;1;0;1
109;07.08.2014;2014;08;05;Torstai;11;5;16;1;1;2
109;07.08.2014;2014;08;06;Torstai;22;36;58;2;2;4
109;07.08.2014;2014;08;07;Torstai;37;93;130;3;3;6
109;07.08.2014;2014;08;08;Torstai;23;68;91;5;5;10
109;07.08.2014;2014;08;09;Torstai;16;57;73;3;1;4
109;07.08.2014;2014;08;10;Torstai;11;23;34;3;1;4
109;07.08.2014;2014;08;11;Torstai;14;22;36;0;2;2
109;07.08.2014;2014;08;12;Torstai;28;24;52;4;0;4
109;07.08.2014;2014;08;13;Torstai;25;22;47;4;2;6
109;07.08.2014;2014;08;14;Torstai;36;33;69;2;1;3
109;07.08.2014;2014;08;15;Torstai;65;47;112;2;8;10
109;07.08.2014;2014;08;16;Torstai;97;45;142;8;3;11
109;07.08.2014;2014;08;17;Torstai;29;38;67;6;2;8
109;07.08.2014;2014;08;18;Torstai;36;26;62;1;3;4
109;07.08.2014;2014;08;19;Torstai;21;17;38;3;4;7
109;07.08.2014;2014;08;20;Torstai;24;18;42;3;2;5
109;07.08.2014;2014;08;21;Torstai;25;15;40;5;2;7
109;07.08.2014;2014;08;22;Torstai;10;15;25;2;0;2
109;07.08.2014;2014;08;23;Torstai;7;4;11;2;1;3
109;08.08.2014;2014;08;00;Perjantai;2;0;2;0;0;0
109;08.08.2014;2014;08;01;Perjantai;2;1;3;0;1;1
109;08.08.2014;2014;08;02;Perjantai;0;4;4;0;0;0
109;08.08.2014;2014;08;03;Perjantai;0;0;0;0;0;0
109;08.08.2014;2014;08;04;Perjantai;2;2;4;4;0;4
109;08.08.2014;2014;08;05;Perjantai;7;5;12;0;2;2
109;08.08.2014;2014;08;06;Perjantai;12;25;37;0;1;1
109;08.08.2014;2014;08;07;Perjantai;33;78;111;2;4;6
109;08.08.2014;2014;08;08;Perjantai;21;63;84;6;3;9
109;08.08.2014;2014;08;09;Perjantai;16;25;41;3;3;6
109;08.08.2014;2014;08;10;Perjantai;5;24;29;1;1;2
109;08.08.2014;2014;08;11;Perjantai;9;18;27;2;1;3
109;08.08.2014;2014;08;12;Perjantai;25;23;48;6;4;10
109;08.08.2014;2014;08;13;Perjantai;28;15;43;2;2;4
109;08.08.2014;2014;08;14;Perjantai;41;26;67;6;5;11
109;08.08.2014;2014;08;15;Perjantai;56;44;100;4;3;7
109;08.08.2014;2014;08;16;Perjantai;48;35;83;6;3;9
109;08.08.2014;2014;08;17;Perjantai;22;27;49;5;1;6
109;08.08.2014;2014;08;18;Perjantai;14;28;42;1;5;6
109;08.08.2014;2014;08;19;Perjantai;17;25;42;3;4;7
109;08.08.2014;2014;08;20;Perjantai;22;14;36;2;4;6
109;08.08.2014;2014;08;21;Perjantai;6;22;28;4;7;11
109;08.08.2014;2014;08;22;Perjantai;11;14;25;5;2;7
109;08.08.2014;2014;08;23;Perjantai;10;5;15;2;2;4
109;09.08.2014;2014;08;00;Lauantai;2;1;3;0;0;0
109;09.08.2014;2014;08;01;Lauantai;6;3;9;0;0;0
109;09.08.2014;2014;08;02;Lauantai;6;0;6;0;0;0
109;09.08.2014;2014;08;03;Lauantai;10;1;11;0;1;1
109;09.08.2014;2014;08;04;Lauantai;0;2;2;1;0;1
109;09.08.2014;2014;08;05;Lauantai;1;3;4;2;0;2
109;09.08.2014;2014;08;06;Lauantai;2;6;8;0;0;0
109;09.08.2014;2014;08;07;Lauantai;1;3;4;3;1;4
109;09.08.2014;2014;08;08;Lauantai;5;2;7;6;5;11
109;09.08.2014;2014;08;09;Lauantai;13;2;15;3;7;10
109;09.08.2014;2014;08;10;Lauantai;9;12;21;5;6;11
109;09.08.2014;2014;08;11;Lauantai;7;14;21;4;1;5
109;09.08.2014;2014;08;12;Lauantai;17;18;35;2;4;6
109;09.08.2014;2014;08;13;Lauantai;12;33;45;4;3;7
109;09.08.2014;2014;08;14;Lauantai;13;19;32;1;2;3
109;09.08.2014;2014;08;15;Lauantai;23;14;37;2;2;4
109;09.08.2014;2014;08;16;Lauantai;6;8;14;3;3;6
109;09.08.2014;2014;08;17;Lauantai;6;2;8;2;1;3
109;09.08.2014;2014;08;18;Lauantai;10;12;22;4;1;5
109;09.08.2014;2014;08;19;Lauantai;5;5;10;1;4;5
109;09.08.2014;2014;08;20;Lauantai;2;5;7;1;1;2
109;09.08.2014;2014;08;21;Lauantai;3;2;5;2;1;3
109;09.08.2014;2014;08;22;Lauantai;0;5;5;2;0;2
109;09.08.2014;2014;08;23;Lauantai;9;1;10;0;0;0
109;10.08.2014;2014;08;00;Sunnuntai;6;0;6;1;2;3
109;10.08.2014;2014;08;01;Sunnuntai;1;1;2;0;0;0
109;10.08.2014;2014;08;02;Sunnuntai;3;1;4;0;1;1
109;10.08.2014;2014;08;03;Sunnuntai;0;1;1;1;0;1
109;10.08.2014;2014;08;04;Sunnuntai;0;0;0;0;0;0
109;10.08.2014;2014;08;05;Sunnuntai;1;0;1;1;0;1
109;10.08.2014;2014;08;06;Sunnuntai;2;1;3;0;0;0
109;10.08.2014;2014;08;07;Sunnuntai;0;4;4;1;5;6
109;10.08.2014;2014;08;08;Sunnuntai;1;5;6;0;0;0
109;10.08.2014;2014;08;09;Sunnuntai;1;6;7;2;4;6
109;10.08.2014;2014;08;10;Sunnuntai;0;7;7;4;2;6
109;10.08.2014;2014;08;11;Sunnuntai;11;11;22;6;7;13
109;10.08.2014;2014;08;12;Sunnuntai;9;17;26;2;10;12
109;10.08.2014;2014;08;13;Sunnuntai;15;17;32;4;5;9
109;10.08.2014;2014;08;14;Sunnuntai;18;21;39;2;6;8
109;10.08.2014;2014;08;15;Sunnuntai;21;22;43;5;3;8
109;10.08.2014;2014;08;16;Sunnuntai;19;32;51;2;3;5
109;10.08.2014;2014;08;17;Sunnuntai;20;24;44;3;5;8
109;10.08.2014;2014;08;18;Sunnuntai;21;19;40;2;5;7
109;10.08.2014;2014;08;19;Sunnuntai;22;26;48;6;5;11
109;10.08.2014;2014;08;20;Sunnuntai;14;10;24;1;5;6
109;10.08.2014;2014;08;21;Sunnuntai;14;8;22;7;4;11
109;10.08.2014;2014;08;22;Sunnuntai;8;5;13;1;3;4
109;10.08.2014;2014;08;23;Sunnuntai;1;1;2;1;0;1
109;11.08.2014;2014;08;00;Maanantai;0;0;0;1;0;1
109;11.08.2014;2014;08;01;Maanantai;1;0;1;2;0;2
109;11.08.2014;2014;08;02;Maanantai;0;0;0;0;0;0
109;11.08.2014;2014;08;03;Maanantai;0;0;0;0;0;0
109;11.08.2014;2014;08;04;Maanantai;3;0;3;1;1;2
109;11.08.2014;2014;08;05;Maanantai;14;7;21;1;2;3
109;11.08.2014;2014;08;06;Maanantai;18;41;59;2;1;3
109;11.08.2014;2014;08;07;Maanantai;46;125;171;4;5;9
109;11.08.2014;2014;08;08;Maanantai;31;90;121;4;6;10
109;11.08.2014;2014;08;09;Maanantai;14;42;56;6;2;8
109;11.08.2014;2014;08;10;Maanantai;10;24;34;1;2;3
109;11.08.2014;2014;08;11;Maanantai;9;22;31;4;1;5
109;11.08.2014;2014;08;12;Maanantai;17;19;36;2;5;7
109;11.08.2014;2014;08;13;Maanantai;19;31;50;13;11;24
109;11.08.2014;2014;08;14;Maanantai;33;29;62;4;5;9
109;11.08.2014;2014;08;15;Maanantai;82;35;117;7;7;14
109;11.08.2014;2014;08;16;Maanantai;130;70;200;10;6;16
109;11.08.2014;2014;08;17;Maanantai;50;46;96;5;5;10
109;11.08.2014;2014;08;18;Maanantai;30;41;71;4;8;12
109;11.08.2014;2014;08;19;Maanantai;25;24;49;7;7;14
109;11.08.2014;2014;08;20;Maanantai;22;17;39;2;6;8
109;11.08.2014;2014;08;21;Maanantai;24;10;34;4;3;7
109;11.08.2014;2014;08;22;Maanantai;3;17;20;3;1;4
109;11.08.2014;2014;08;23;Maanantai;4;3;7;2;0;2
109;12.08.2014;2014;08;00;Tiistai;0;0;0;0;1;1
109;12.08.2014;2014;08;01;Tiistai;3;0;3;0;0;0
109;12.08.2014;2014;08;02;Tiistai;0;0;0;0;0;0
109;12.08.2014;2014;08;03;Tiistai;0;0;0;0;0;0
109;12.08.2014;2014;08;04;Tiistai;0;2;2;0;0;0
109;12.08.2014;2014;08;05;Tiistai;16;3;19;1;2;3
109;12.08.2014;2014;08;06;Tiistai;14;44;58;3;2;5
109;12.08.2014;2014;08;07;Tiistai;33;99;132;3;4;7
109;12.08.2014;2014;08;08;Tiistai;26;80;106;0;2;2
109;12.08.2014;2014;08;09;Tiistai;7;33;40;5;3;8
109;12.08.2014;2014;08;10;Tiistai;7;3;10;0;2;2
109;12.08.2014;2014;08;11;Tiistai;8;5;13;2;0;2
109;12.08.2014;2014;08;12;Tiistai;3;5;8;1;3;4
109;12.08.2014;2014;08;13;Tiistai;10;9;19;2;1;3
109;12.08.2014;2014;08;14;Tiistai;32;27;59;1;5;6
109;12.08.2014;2014;08;15;Tiistai;60;29;89;4;3;7
109;12.08.2014;2014;08;16;Tiistai;83;42;125;4;8;12
109;12.08.2014;2014;08;17;Tiistai;28;25;53;6;3;9
109;12.08.2014;2014;08;18;Tiistai;25;23;48;4;8;12
109;12.08.2014;2014;08;19;Tiistai;24;16;40;6;6;12
109;12.08.2014;2014;08;20;Tiistai;22;15;37;1;10;11
109;12.08.2014;2014;08;21;Tiistai;20;21;41;5;4;9
109;12.08.2014;2014;08;22;Tiistai;4;13;17;2;0;2
109;12.08.2014;2014;08;23;Tiistai;2;3;5;1;1;2
109;13.08.2014;2014;08;00;Keskiviikko;3;1;4;0;0;0
109;13.08.2014;2014;08;01;Keskiviikko;0;0;0;0;0;0
109;13.08.2014;2014;08;02;Keskiviikko;0;0;0;1;1;2
109;13.08.2014;2014;08;03;Keskiviikko;0;0;0;0;0;0
109;13.08.2014;2014;08;04;Keskiviikko;3;0;3;0;0;0
109;13.08.2014;2014;08;05;Keskiviikko;12;5;17;2;1;3
109;13.08.2014;2014;08;06;Keskiviikko;20;53;73;3;0;3
109;13.08.2014;2014;08;07;Keskiviikko;40;113;153;4;4;8
109;13.08.2014;2014;08;08;Keskiviikko;19;84;103;2;5;7
109;13.08.2014;2014;08;09;Keskiviikko;15;32;47;4;2;6
109;13.08.2014;2014;08;10;Keskiviikko;6;19;25;3;3;6
109;13.08.2014;2014;08;11;Keskiviikko;10;21;31;2;2;4
109;13.08.2014;2014;08;12;Keskiviikko;19;28;47;1;6;7
109;13.08.2014;2014;08;13;Keskiviikko;21;16;37;5;4;9
109;13.08.2014;2014;08;14;Keskiviikko;36;22;58;3;6;9
109;13.08.2014;2014;08;15;Keskiviikko;67;37;104;5;2;7
109;13.08.2014;2014;08;16;Keskiviikko;91;52;143;4;7;11
109;13.08.2014;2014;08;17;Keskiviikko;56;30;86;5;4;9
109;13.08.2014;2014;08;18;Keskiviikko;31;24;55;3;8;11
109;13.08.2014;2014;08;19;Keskiviikko;17;23;40;5;12;17
109;13.08.2014;2014;08;20;Keskiviikko;17;21;38;5;2;7
109;13.08.2014;2014;08;21;Keskiviikko;18;10;28;2;3;5
109;13.08.2014;2014;08;22;Keskiviikko;5;13;18;2;3;5
109;13.08.2014;2014;08;23;Keskiviikko;3;1;4;0;0;0
109;14.08.2014;2014;08;00;Torstai;3;1;4;0;1;1
109;14.08.2014;2014;08;01;Torstai;0;0;0;1;0;1
109;14.08.2014;2014;08;02;Torstai;0;0;0;0;0;0
109;14.08.2014;2014;08;03;Torstai;0;0;0;0;0;0
109;14.08.2014;2014;08;04;Torstai;2;1;3;1;0;1
109;14.08.2014;2014;08;05;Torstai;4;13;17;0;1;1
109;14.08.2014;2014;08;06;Torstai;16;50;66;3;2;5
109;14.08.2014;2014;08;07;Torstai;36;112;148;3;5;8
109;14.08.2014;2014;08;08;Torstai;19;80;99;3;3;6
109;14.08.2014;2014;08;09;Torstai;12;37;49;2;3;5
109;14.08.2014;2014;08;10;Torstai;10;11;21;3;3;6
109;14.08.2014;2014;08;11;Torstai;4;22;26;3;4;7
109;14.08.2014;2014;08;12;Torstai;11;12;23;2;5;7
109;14.08.2014;2014;08;13;Torstai;23;19;42;3;2;5
109;14.08.2014;2014;08;14;Torstai;21;24;45;0;2;2
109;14.08.2014;2014;08;15;Torstai;74;54;128;14;4;18
109;14.08.2014;2014;08;16;Torstai;79;61;140;7;6;13
109;14.08.2014;2014;08;17;Torstai;29;19;48;3;3;6
109;14.08.2014;2014;08;18;Torstai;29;23;52;3;6;9
109;14.08.2014;2014;08;19;Torstai;12;12;24;3;6;9
109;14.08.2014;2014;08;20;Torstai;17;15;32;7;6;13
109;14.08.2014;2014;08;21;Torstai;13;14;27;2;3;5
109;14.08.2014;2014;08;22;Torstai;7;7;14;0;1;1
109;14.08.2014;2014;08;23;Torstai;0;0;0;1;0;1
109;15.08.2014;2014;08;00;Perjantai;4;0;4;0;0;0
109;15.08.2014;2014;08;01;Perjantai;0;0;0;1;0;1
109;15.08.2014;2014;08;02;Perjantai;0;0;0;0;0;0
109;15.08.2014;2014;08;03;Perjantai;0;0;0;0;0;0
109;15.08.2014;2014;08;04;Perjantai;3;1;4;0;0;0
109;15.08.2014;2014;08;05;Perjantai;15;6;21;1;1;2
109;15.08.2014;2014;08;06;Perjantai;8;38;46;1;1;2
109;15.08.2014;2014;08;07;Perjantai;41;95;136;2;2;4
109;15.08.2014;2014;08;08;Perjantai;17;47;64;4;0;4
109;15.08.2014;2014;08;09;Perjantai;7;25;32;2;1;3
109;15.08.2014;2014;08;10;Perjantai;10;10;20;3;2;5
109;15.08.2014;2014;08;11;Perjantai;12;21;33;1;3;4
109;15.08.2014;2014;08;12;Perjantai;14;23;37;3;5;8
109;15.08.2014;2014;08;13;Perjantai;26;24;50;3;3;6
109;15.08.2014;2014;08;14;Perjantai;50;28;78;1;4;5
109;15.08.2014;2014;08;15;Perjantai;66;32;98;4;6;10
109;15.08.2014;2014;08;16;Perjantai;41;45;86;4;2;6
109;15.08.2014;2014;08;17;Perjantai;27;29;56;4;5;9
109;15.08.2014;2014;08;18;Perjantai;15;32;47;4;3;7
109;15.08.2014;2014;08;19;Perjantai;15;14;29;3;5;8
109;15.08.2014;2014;08;20;Perjantai;8;19;27;4;1;5
109;15.08.2014;2014;08;21;Perjantai;14;24;38;5;2;7
109;15.08.2014;2014;08;22;Perjantai;9;9;18;2;2;4
109;15.08.2014;2014;08;23;Perjantai;6;3;9;0;0;0
109;16.08.2014;2014;08;00;Lauantai;1;3;4;2;0;2
109;16.08.2014;2014;08;01;Lauantai;3;0;3;0;0;0
109;16.08.2014;2014;08;02;Lauantai;3;0;3;0;0;0
109;16.08.2014;2014;08;03;Lauantai;2;1;3;0;0;0
109;16.08.2014;2014;08;04;Lauantai;1;1;2;1;0;1
109;16.08.2014;2014;08;05;Lauantai;1;2;3;0;0;0
109;16.08.2014;2014;08;06;Lauantai;2;7;9;0;2;2
109;16.08.2014;2014;08;07;Lauantai;4;2;6;1;0;1
109;16.08.2014;2014;08;08;Lauantai;2;4;6;2;3;5
109;16.08.2014;2014;08;09;Lauantai;4;8;12;3;5;8
109;16.08.2014;2014;08;10;Lauantai;9;23;32;3;1;4
109;16.08.2014;2014;08;11;Lauantai;6;20;26;4;0;4
109;16.08.2014;2014;08;12;Lauantai;11;21;32;4;5;9
109;16.08.2014;2014;08;13;Lauantai;13;18;31;0;3;3
109;16.08.2014;2014;08;14;Lauantai;32;27;59;4;3;7
109;16.08.2014;2014;08;15;Lauantai;12;15;27;5;5;10
109;16.08.2014;2014;08;16;Lauantai;19;14;33;3;6;9
109;16.08.2014;2014;08;17;Lauantai;15;8;23;2;1;3
109;16.08.2014;2014;08;18;Lauantai;19;18;37;6;2;8
109;16.08.2014;2014;08;19;Lauantai;11;12;23;1;3;4
109;16.08.2014;2014;08;20;Lauantai;14;18;32;2;2;4
109;16.08.2014;2014;08;21;Lauantai;18;11;29;4;3;7
109;16.08.2014;2014;08;22;Lauantai;12;7;19;2;1;3
109;16.08.2014;2014;08;23;Lauantai;3;2;5;1;1;2
109;17.08.2014;2014;08;00;Sunnuntai;3;2;5;1;0;1
109;17.08.2014;2014;08;01;Sunnuntai;5;1;6;1;1;2
109;17.08.2014;2014;08;02;Sunnuntai;1;1;2;0;0;0
109;17.08.2014;2014;08;03;Sunnuntai;7;0;7;0;0;0
109;17.08.2014;2014;08;04;Sunnuntai;2;0;2;1;0;1
109;17.08.2014;2014;08;05;Sunnuntai;0;1;1;0;0;0
109;17.08.2014;2014;08;06;Sunnuntai;0;5;5;1;1;2
109;17.08.2014;2014;08;07;Sunnuntai;2;0;2;1;1;2
109;17.08.2014;2014;08;08;Sunnuntai;0;0;0;2;2;4
109;17.08.2014;2014;08;09;Sunnuntai;4;4;8;5;4;9
109;17.08.2014;2014;08;10;Sunnuntai;6;8;14;8;9;17
109;17.08.2014;2014;08;11;Sunnuntai;9;11;20;4;4;8
109;17.08.2014;2014;08;12;Sunnuntai;13;16;29;1;4;5
109;17.08.2014;2014;08;13;Sunnuntai;8;23;31;6;7;13
109;17.08.2014;2014;08;14;Sunnuntai;15;5;20;1;2;3
109;17.08.2014;2014;08;15;Sunnuntai;17;21;38;1;4;5
109;17.08.2014;2014;08;16;Sunnuntai;15;13;28;3;7;10
109;17.08.2014;2014;08;17;Sunnuntai;21;16;37;6;8;14
109;17.08.2014;2014;08;18;Sunnuntai;11;11;22;3;5;8
109;17.08.2014;2014;08;19;Sunnuntai;13;20;33;5;13;18
109;17.08.2014;2014;08;20;Sunnuntai;17;22;39;5;4;9
109;17.08.2014;2014;08;21;Sunnuntai;11;8;19;3;6;9
109;17.08.2014;2014;08;22;Sunnuntai;4;2;6;2;0;2
109;17.08.2014;2014;08;23;Sunnuntai;2;2;4;0;0;0
109;18.08.2014;2014;08;00;Maanantai;0;2;2;2;0;2
109;18.08.2014;2014;08;01;Maanantai;1;1;2;0;0;0
109;18.08.2014;2014;08;02;Maanantai;0;0;0;0;0;0
109;18.08.2014;2014;08;03;Maanantai;0;0;0;0;0;0
109;18.08.2014;2014;08;04;Maanantai;1;0;1;0;0;0
109;18.08.2014;2014;08;05;Maanantai;3;6;9;2;1;3
109;18.08.2014;2014;08;06;Maanantai;21;41;62;1;0;1
109;18.08.2014;2014;08;07;Maanantai;46;108;154;3;8;11
109;18.08.2014;2014;08;08;Maanantai;30;65;95;2;1;3
109;18.08.2014;2014;08;09;Maanantai;11;42;53;1;2;3
109;18.08.2014;2014;08;10;Maanantai;10;11;21;5;4;9
109;18.08.2014;2014;08;11;Maanantai;13;22;35;4;1;5
109;18.08.2014;2014;08;12;Maanantai;14;16;30;2;5;7
109;18.08.2014;2014;08;13;Maanantai;19;14;33;6;6;12
109;18.08.2014;2014;08;14;Maanantai;26;29;55;11;9;20
109;18.08.2014;2014;08;15;Maanantai;57;44;101;5;6;11
109;18.08.2014;2014;08;16;Maanantai;105;50;155;10;4;14
109;18.08.2014;2014;08;17;Maanantai;23;14;37;2;3;5
109;18.08.2014;2014;08;18;Maanantai;10;10;20;2;1;3
109;18.08.2014;2014;08;19;Maanantai;9;8;17;3;1;4
109;18.08.2014;2014;08;20;Maanantai;8;6;14;4;6;10
109;18.08.2014;2014;08;21;Maanantai;2;4;6;2;3;5
109;18.08.2014;2014;08;22;Maanantai;5;10;15;4;2;6
109;18.08.2014;2014;08;23;Maanantai;1;1;2;0;1;1
109;19.08.2014;2014;08;00;Tiistai;2;1;3;0;0;0
109;19.08.2014;2014;08;01;Tiistai;0;0;0;0;0;0
109;19.08.2014;2014;08;02;Tiistai;0;0;0;2;0;2
109;19.08.2014;2014;08;03;Tiistai;0;0;0;0;0;0
109;19.08.2014;2014;08;04;Tiistai;1;0;1;0;0;0
109;19.08.2014;2014;08;05;Tiistai;5;6;11;2;1;3
109;19.08.2014;2014;08;06;Tiistai;11;39;50;1;1;2
109;19.08.2014;2014;08;07;Tiistai;38;93;131;5;9;14
109;19.08.2014;2014;08;08;Tiistai;20;70;90;3;3;6
109;19.08.2014;2014;08;09;Tiistai;11;25;36;5;5;10
109;19.08.2014;2014;08;10;Tiistai;6;8;14;4;4;8
109;19.08.2014;2014;08;11;Tiistai;6;6;12;4;6;10
109;19.08.2014;2014;08;12;Tiistai;7;16;23;2;3;5
109;19.08.2014;2014;08;13;Tiistai;26;12;38;2;4;6
109;19.08.2014;2014;08;14;Tiistai;29;14;43;5;2;7
109;19.08.2014;2014;08;15;Tiistai;60;35;95;7;3;10
109;19.08.2014;2014;08;16;Tiistai;81;56;137;8;1;9
109;19.08.2014;2014;08;17;Tiistai;36;31;67;5;7;12
109;19.08.2014;2014;08;18;Tiistai;27;36;63;1;2;3
109;19.08.2014;2014;08;19;Tiistai;13;11;24;5;10;15
109;19.08.2014;2014;08;20;Tiistai;21;10;31;4;2;6
109;19.08.2014;2014;08;21;Tiistai;12;12;24;6;1;7
109;19.08.2014;2014;08;22;Tiistai;3;10;13;2;0;2
109;19.08.2014;2014;08;23;Tiistai;0;1;1;2;0;2
109;20.08.2014;2014;08;00;Keskiviikko;0;0;0;0;2;2
109;20.08.2014;2014;08;01;Keskiviikko;0;0;0;2;0;2
109;20.08.2014;2014;08;02;Keskiviikko;0;0;0;0;0;0
109;20.08.2014;2014;08;03;Keskiviikko;0;0;0;1;0;1
109;20.08.2014;2014;08;04;Keskiviikko;1;1;2;0;0;0
109;20.08.2014;2014;08;05;Keskiviikko;6;5;11;2;2;4
109;20.08.2014;2014;08;06;Keskiviikko;20;38;58;0;1;1
109;20.08.2014;2014;08;07;Keskiviikko;41;99;140;5;6;11
109;20.08.2014;2014;08;08;Keskiviikko;24;79;103;4;3;7
109;20.08.2014;2014;08;09;Keskiviikko;8;29;37;1;3;4
109;20.08.2014;2014;08;10;Keskiviikko;9;14;23;2;4;6
109;20.08.2014;2014;08;11;Keskiviikko;4;21;25;2;4;6
109;20.08.2014;2014;08;12;Keskiviikko;19;20;39;4;2;6
109;20.08.2014;2014;08;13;Keskiviikko;24;15;39;4;0;4
109;20.08.2014;2014;08;14;Keskiviikko;32;18;50;0;3;3
109;20.08.2014;2014;08;15;Keskiviikko;63;40;103;3;8;11
109;20.08.2014;2014;08;16;Keskiviikko;94;45;139;4;5;9
109;20.08.2014;2014;08;17;Keskiviikko;35;31;66;2;5;7
109;20.08.2014;2014;08;18;Keskiviikko;22;24;46;4;6;10
109;20.08.2014;2014;08;19;Keskiviikko;14;12;26;4;7;11
109;20.08.2014;2014;08;20;Keskiviikko;18;7;25;4;2;6
109;20.08.2014;2014;08;21;Keskiviikko;18;15;33;4;4;8
109;20.08.2014;2014;08;22;Keskiviikko;4;12;16;1;0;1
109;20.08.2014;2014;08;23;Keskiviikko;1;2;3;0;0;0
109;21.08.2014;2014;08;00;Torstai;0;0;0;0;1;1
109;21.08.2014;2014;08;01;Torstai;0;0;0;0;1;1
109;21.08.2014;2014;08;02;Torstai;0;0;0;0;0;0
109;21.08.2014;2014;08;03;Torstai;0;1;1;1;0;1
109;21.08.2014;2014;08;04;Torstai;2;1;3;0;0;0
109;21.08.2014;2014;08;05;Torstai;9;3;12;2;1;3
109;21.08.2014;2014;08;06;Torstai;16;33;49;0;3;3
109;21.08.2014;2014;08;07;Torstai;33;78;111;5;4;9
109;21.08.2014;2014;08;08;Torstai;23;64;87;3;3;6
109;21.08.2014;2014;08;09;Torstai;10;20;30;3;5;8
109;21.08.2014;2014;08;10;Torstai;5;12;17;1;4;5
109;21.08.2014;2014;08;11;Torstai;8;16;24;3;3;6
109;21.08.2014;2014;08;12;Torstai;11;20;31;1;2;3
109;21.08.2014;2014;08;13;Torstai;15;18;33;0;2;2
109;21.08.2014;2014;08;14;Torstai;26;28;54;3;3;6
109;21.08.2014;2014;08;15;Torstai;47;42;89;4;7;11
109;21.08.2014;2014;08;16;Torstai;63;46;109;5;2;7
109;21.08.2014;2014;08;17;Torstai;27;18;45;2;3;5
109;21.08.2014;2014;08;18;Torstai;13;15;28;6;4;10
109;21.08.2014;2014;08;19;Torstai;16;14;30;4;9;13
109;21.08.2014;2014;08;20;Torstai;14;11;25;2;2;4
109;21.08.2014;2014;08;21;Torstai;21;7;28;5;2;7
109;21.08.2014;2014;08;22;Torstai;2;12;14;3;2;5
109;21.08.2014;2014;08;23;Torstai;3;1;4;1;3;4
109;22.08.2014;2014;08;00;Perjantai;3;0;3;0;1;1
109;22.08.2014;2014;08;01;Perjantai;0;0;0;0;0;0
109;22.08.2014;2014;08;02;Perjantai;1;0;1;1;0;1
109;22.08.2014;2014;08;03;Perjantai;0;0;0;0;0;0
109;22.08.2014;2014;08;04;Perjantai;2;0;2;1;0;1
109;22.08.2014;2014;08;05;Perjantai;7;3;10;2;0;2
109;22.08.2014;2014;08;06;Perjantai;12;35;47;0;1;1
109;22.08.2014;2014;08;07;Perjantai;25;74;99;1;4;5
109;22.08.2014;2014;08;08;Perjantai;20;57;77;2;1;3
109;22.08.2014;2014;08;09;Perjantai;9;35;44;3;4;7
109;22.08.2014;2014;08;10;Perjantai;7;8;15;6;1;7
109;22.08.2014;2014;08;11;Perjantai;10;13;23;2;6;8
109;22.08.2014;2014;08;12;Perjantai;13;13;26;1;3;4
109;22.08.2014;2014;08;13;Perjantai;17;15;32;1;5;6
109;22.08.2014;2014;08;14;Perjantai;48;19;67;1;3;4
109;22.08.2014;2014;08;15;Perjantai;60;26;86;7;2;9
109;22.08.2014;2014;08;16;Perjantai;47;25;72;2;6;8
109;22.08.2014;2014;08;17;Perjantai;26;19;45;3;2;5
109;22.08.2014;2014;08;18;Perjantai;18;20;38;3;5;8
109;22.08.2014;2014;08;19;Perjantai;21;14;35;4;5;9
109;22.08.2014;2014;08;20;Perjantai;8;4;12;4;6;10
109;22.08.2014;2014;08;21;Perjantai;14;12;26;1;1;2
109;22.08.2014;2014;08;22;Perjantai;6;7;13;0;3;3
109;22.08.2014;2014;08;23;Perjantai;1;9;10;0;1;1
109;23.08.2014;2014;08;00;Lauantai;1;1;2;0;0;0
109;23.08.2014;2014;08;01;Lauantai;4;9;13;0;0;0
109;23.08.2014;2014;08;02;Lauantai;0;0;0;0;0;0
109;23.08.2014;2014;08;03;Lauantai;2;1;3;2;0;2
109;23.08.2014;2014;08;04;Lauantai;0;0;0;0;0;0
109;23.08.2014;2014;08;05;Lauantai;2;0;2;2;0;2
109;23.08.2014;2014;08;06;Lauantai;0;3;3;0;1;1
109;23.08.2014;2014;08;07;Lauantai;0;6;6;1;2;3
109;23.08.2014;2014;08;08;Lauantai;1;6;7;3;3;6
109;23.08.2014;2014;08;09;Lauantai;4;10;14;5;3;8
109;23.08.2014;2014;08;10;Lauantai;8;7;15;3;3;6
109;23.08.2014;2014;08;11;Lauantai;8;8;16;4;4;8
109;23.08.2014;2014;08;12;Lauantai;14;16;30;4;1;5
109;23.08.2014;2014;08;13;Lauantai;13;10;23;3;4;7
109;23.08.2014;2014;08;14;Lauantai;13;13;26;5;5;10
109;23.08.2014;2014;08;15;Lauantai;19;23;42;2;2;4
109;23.08.2014;2014;08;16;Lauantai;16;5;21;5;1;6
109;23.08.2014;2014;08;17;Lauantai;4;13;17;2;0;2
109;23.08.2014;2014;08;18;Lauantai;12;13;25;4;1;5
109;23.08.2014;2014;08;19;Lauantai;5;4;9;3;5;8
109;23.08.2014;2014;08;20;Lauantai;11;12;23;3;3;6
109;23.08.2014;2014;08;21;Lauantai;12;4;16;1;0;1
109;23.08.2014;2014;08;22;Lauantai;0;6;6;0;3;3
109;23.08.2014;2014;08;23;Lauantai;2;4;6;1;1;2
109;24.08.2014;2014;08;00;Sunnuntai;4;8;12;1;0;1
109;24.08.2014;2014;08;01;Sunnuntai;3;0;3;1;1;2
109;24.08.2014;2014;08;02;Sunnuntai;1;1;2;0;0;0
109;24.08.2014;2014;08;03;Sunnuntai;3;3;6;1;0;1
109;24.08.2014;2014;08;04;Sunnuntai;4;2;6;10;7;17
109;24.08.2014;2014;08;05;Sunnuntai;1;0;1;1;0;1
109;24.08.2014;2014;08;06;Sunnuntai;0;5;5;0;1;1
109;24.08.2014;2014;08;07;Sunnuntai;2;1;3;1;2;3
109;24.08.2014;2014;08;08;Sunnuntai;1;0;1;1;1;2
109;24.08.2014;2014;08;09;Sunnuntai;3;5;8;2;2;4
109;24.08.2014;2014;08;10;Sunnuntai;6;7;13;3;2;5
109;24.08.2014;2014;08;11;Sunnuntai;0;10;10;7;5;12
109;24.08.2014;2014;08;12;Sunnuntai;15;20;35;1;7;8
109;24.08.2014;2014;08;13;Sunnuntai;14;13;27;4;6;10
109;24.08.2014;2014;08;14;Sunnuntai;16;12;28;2;6;8
109;24.08.2014;2014;08;15;Sunnuntai;7;2;9;3;3;6
109;24.08.2014;2014;08;16;Sunnuntai;6;17;23;2;1;3
109;24.08.2014;2014;08;17;Sunnuntai;15;8;23;2;7;9
109;24.08.2014;2014;08;18;Sunnuntai;7;12;19;7;6;13
109;24.08.2014;2014;08;19;Sunnuntai;7;9;16;8;7;15
109;24.08.2014;2014;08;20;Sunnuntai;6;6;12;4;2;6
109;24.08.2014;2014;08;21;Sunnuntai;11;6;17;3;3;6
109;24.08.2014;2014;08;22;Sunnuntai;4;1;5;3;0;3
109;24.08.2014;2014;08;23;Sunnuntai;0;0;0;0;0;0
109;25.08.2014;2014;08;00;Maanantai;1;3;4;0;0;0
109;25.08.2014;2014;08;01;Maanantai;0;1;1;0;0;0
109;25.08.2014;2014;08;02;Maanantai;1;0;1;2;0;2
109;25.08.2014;2014;08;03;Maanantai;0;0;0;0;0;0
109;25.08.2014;2014;08;04;Maanantai;0;0;0;1;1;2
109;25.08.2014;2014;08;05;Maanantai;10;6;16;0;1;1
109;25.08.2014;2014;08;06;Maanantai;13;32;45;0;1;1
109;25.08.2014;2014;08;07;Maanantai;40;107;147;4;6;10
109;25.08.2014;2014;08;08;Maanantai;21;65;86;3;2;5
109;25.08.2014;2014;08;09;Maanantai;12;33;45;6;3;9
109;25.08.2014;2014;08;10;Maanantai;9;18;27;1;2;3
109;25.08.2014;2014;08;11;Maanantai;6;10;16;4;5;9
109;25.08.2014;2014;08;12;Maanantai;19;20;39;1;6;7
109;25.08.2014;2014;08;13;Maanantai;21;20;41;5;2;7
109;25.08.2014;2014;08;14;Maanantai;41;20;61;1;3;4
109;25.08.2014;2014;08;15;Maanantai;60;43;103;8;8;16
109;25.08.2014;2014;08;16;Maanantai;107;55;162;6;5;11
109;25.08.2014;2014;08;17;Maanantai;26;35;61;10;3;13
109;25.08.2014;2014;08;18;Maanantai;30;15;45;6;5;11
109;25.08.2014;2014;08;19;Maanantai;13;13;26;4;6;10
109;25.08.2014;2014;08;20;Maanantai;13;12;25;2;0;2
109;25.08.2014;2014;08;21;Maanantai;9;7;16;3;2;5
109;25.08.2014;2014;08;22;Maanantai;4;10;14;2;0;2
109;25.08.2014;2014;08;23;Maanantai;1;1;2;0;2;2
109;26.08.2014;2014;08;00;Tiistai;0;0;0;0;0;0
109;26.08.2014;2014;08;01;Tiistai;0;0;0;0;0;0
109;26.08.2014;2014;08;02;Tiistai;0;1;1;2;0;2
109;26.08.2014;2014;08;03;Tiistai;0;0;0;0;0;0
109;26.08.2014;2014;08;04;Tiistai;1;1;2;0;0;0
109;26.08.2014;2014;08;05;Tiistai;7;7;14;2;0;2
109;26.08.2014;2014;08;06;Tiistai;14;34;48;0;4;4
109;26.08.2014;2014;08;07;Tiistai;27;91;118;2;6;8
109;26.08.2014;2014;08;08;Tiistai;13;60;73;5;3;8
109;26.08.2014;2014;08;09;Tiistai;7;22;29;4;4;8
109;26.08.2014;2014;08;10;Tiistai;7;10;17;3;4;7
109;26.08.2014;2014;08;11;Tiistai;12;15;27;2;7;9
109;26.08.2014;2014;08;12;Tiistai;6;19;25;0;2;2
109;26.08.2014;2014;08;13;Tiistai;23;14;37;2;1;3
109;26.08.2014;2014;08;14;Tiistai;28;29;57;0;2;2
109;26.08.2014;2014;08;15;Tiistai;44;42;86;1;4;5
109;26.08.2014;2014;08;16;Tiistai;64;52;116;6;6;12
109;26.08.2014;2014;08;17;Tiistai;31;34;65;5;5;10
109;26.08.2014;2014;08;18;Tiistai;22;26;48;5;1;6
109;26.08.2014;2014;08;19;Tiistai;10;6;16;6;7;13
109;26.08.2014;2014;08;20;Tiistai;13;8;21;5;4;9
109;26.08.2014;2014;08;21;Tiistai;6;5;11;5;5;10
109;26.08.2014;2014;08;22;Tiistai;3;8;11;1;1;2
109;26.08.2014;2014;08;23;Tiistai;1;1;2;0;1;1
109;27.08.2014;2014;08;00;Keskiviikko;1;0;1;0;0;0
109;27.08.2014;2014;08;01;Keskiviikko;0;2;2;0;0;0
109;27.08.2014;2014;08;02;Keskiviikko;0;0;0;0;0;0
109;27.08.2014;2014;08;03;Keskiviikko;0;0;0;0;0;0
109;27.08.2014;2014;08;04;Keskiviikko;1;1;2;0;0;0
109;27.08.2014;2014;08;05;Keskiviikko;9;4;13;0;0;0
109;27.08.2014;2014;08;06;Keskiviikko;12;29;41;2;1;3
109;27.08.2014;2014;08;07;Keskiviikko;26;82;108;5;8;13
109;27.08.2014;2014;08;08;Keskiviikko;17;49;66;4;3;7
109;27.08.2014;2014;08;09;Keskiviikko;10;15;25;1;3;4
109;27.08.2014;2014;08;10;Keskiviikko;2;8;10;0;1;1
109;27.08.2014;2014;08;11;Keskiviikko;8;8;16;3;2;5
109;27.08.2014;2014;08;12;Keskiviikko;2;11;13;4;2;6
109;27.08.2014;2014;08;13;Keskiviikko;16;14;30;1;4;5
109;27.08.2014;2014;08;14;Keskiviikko;26;16;42;0;1;1
109;27.08.2014;2014;08;15;Keskiviikko;47;35;82;5;8;13
109;27.08.2014;2014;08;16;Keskiviikko;60;33;93;6;2;8
109;27.08.2014;2014;08;17;Keskiviikko;24;16;40;1;4;5
109;27.08.2014;2014;08;18;Keskiviikko;16;16;32;4;4;8
109;27.08.2014;2014;08;19;Keskiviikko;13;13;26;3;7;10
109;27.08.2014;2014;08;20;Keskiviikko;14;8;22;5;5;10
109;27.08.2014;2014;08;21;Keskiviikko;6;8;14;8;1;9
109;27.08.2014;2014;08;22;Keskiviikko;2;6;8;0;1;1
109;27.08.2014;2014;08;23;Keskiviikko;1;1;2;0;0;0
109;28.08.2014;2014;08;00;Torstai;0;0;0;0;0;0
109;28.08.2014;2014;08;01;Torstai;0;0;0;0;0;0
109;28.08.2014;2014;08;02;Torstai;1;0;1;2;0;2
109;28.08.2014;2014;08;03;Torstai;1;0;1;0;0;0
109;28.08.2014;2014;08;04;Torstai;0;1;1;0;0;0
109;28.08.2014;2014;08;05;Torstai;6;3;9;2;0;2
109;28.08.2014;2014;08;06;Torstai;16;28;44;0;4;4
109;28.08.2014;2014;08;07;Torstai;31;78;109;5;8;13
109;28.08.2014;2014;08;08;Torstai;19;63;82;3;1;4
109;28.08.2014;2014;08;09;Torstai;9;24;33;1;2;3
109;28.08.2014;2014;08;10;Torstai;9;16;25;1;0;1
109;28.08.2014;2014;08;11;Torstai;14;14;28;2;5;7
109;28.08.2014;2014;08;12;Torstai;8;6;14;5;5;10
109;28.08.2014;2014;08;13;Torstai;12;20;32;0;2;2
109;28.08.2014;2014;08;14;Torstai;30;20;50;2;2;4
109;28.08.2014;2014;08;15;Torstai;46;23;69;8;7;15
109;28.08.2014;2014;08;16;Torstai;62;45;107;4;4;8
109;28.08.2014;2014;08;17;Torstai;17;23;40;3;3;6
109;28.08.2014;2014;08;18;Torstai;19;27;46;2;6;8
109;28.08.2014;2014;08;19;Torstai;22;15;37;6;4;10
109;28.08.2014;2014;08;20;Torstai;20;6;26;1;9;10
109;28.08.2014;2014;08;21;Torstai;17;10;27;1;2;3
109;28.08.2014;2014;08;22;Torstai;6;9;15;2;2;4
109;28.08.2014;2014;08;23;Torstai;3;4;7;0;0;0
109;29.08.2014;2014;08;00;Perjantai;0;1;1;0;0;0
109;29.08.2014;2014;08;01;Perjantai;0;1;1;0;0;0
109;29.08.2014;2014;08;02;Perjantai;0;0;0;1;0;1
109;29.08.2014;2014;08;03;Perjantai;1;0;1;0;0;0
109;29.08.2014;2014;08;04;Perjantai;0;0;0;0;0;0
109;29.08.2014;2014;08;05;Perjantai;7;3;10;1;1;2
109;29.08.2014;2014;08;06;Perjantai;13;34;47;0;3;3
109;29.08.2014;2014;08;07;Perjantai;32;75;107;3;1;4
109;29.08.2014;2014;08;08;Perjantai;15;61;76;2;4;6
109;29.08.2014;2014;08;09;Perjantai;10;21;31;1;3;4
109;29.08.2014;2014;08;10;Perjantai;10;16;26;3;3;6
109;29.08.2014;2014;08;11;Perjantai;9;16;25;2;4;6
109;29.08.2014;2014;08;12;Perjantai;13;22;35;5;3;8
109;29.08.2014;2014;08;13;Perjantai;23;16;39;0;3;3
109;29.08.2014;2014;08;14;Perjantai;44;19;63;2;3;5
109;29.08.2014;2014;08;15;Perjantai;50;30;80;4;3;7
109;29.08.2014;2014;08;16;Perjantai;54;41;95;4;3;7
109;29.08.2014;2014;08;17;Perjantai;19;13;32;3;6;9
109;29.08.2014;2014;08;18;Perjantai;7;14;21;4;2;6
109;29.08.2014;2014;08;19;Perjantai;17;20;37;3;4;7
109;29.08.2014;2014;08;20;Perjantai;9;12;21;3;6;9
109;29.08.2014;2014;08;21;Perjantai;8;4;12;4;2;6
109;29.08.2014;2014;08;22;Perjantai;13;9;22;2;2;4
109;29.08.2014;2014;08;23;Perjantai;8;3;11;1;0;1
109;30.08.2014;2014;08;00;Lauantai;0;5;5;1;0;1
109;30.08.2014;2014;08;01;Lauantai;3;0;3;0;0;0
109;30.08.2014;2014;08;02;Lauantai;4;1;5;0;0;0
109;30.08.2014;2014;08;03;Lauantai;5;0;5;0;0;0
109;30.08.2014;2014;08;04;Lauantai;2;0;2;0;0;0
109;30.08.2014;2014;08;05;Lauantai;0;1;1;1;1;2
109;30.08.2014;2014;08;06;Lauantai;0;3;3;0;1;1
109;30.08.2014;2014;08;07;Lauantai;3;4;7;1;4;5
109;30.08.2014;2014;08;08;Lauantai;3;2;5;4;5;9
109;30.08.2014;2014;08;09;Lauantai;9;14;23;5;1;6
109;30.08.2014;2014;08;10;Lauantai;4;12;16;3;3;6
109;30.08.2014;2014;08;11;Lauantai;10;5;15;0;5;5
109;30.08.2014;2014;08;12;Lauantai;15;11;26;3;5;8
109;30.08.2014;2014;08;13;Lauantai;11;9;20;0;5;5
109;30.08.2014;2014;08;14;Lauantai;16;9;25;3;4;7
109;30.08.2014;2014;08;15;Lauantai;12;19;31;4;1;5
109;30.08.2014;2014;08;16;Lauantai;13;9;22;0;2;2
109;30.08.2014;2014;08;17;Lauantai;15;12;27;4;1;5
109;30.08.2014;2014;08;18;Lauantai;12;13;25;2;3;5
109;30.08.2014;2014;08;19;Lauantai;9;15;24;1;4;5
109;30.08.2014;2014;08;20;Lauantai;15;11;26;2;5;7
109;30.08.2014;2014;08;21;Lauantai;11;4;15;1;1;2
109;30.08.2014;2014;08;22;Lauantai;6;5;11;1;2;3
109;30.08.2014;2014;08;23;Lauantai;3;3;6;1;1;2
109;31.08.2014;2014;08;00;Sunnuntai;5;6;11;3;1;4
109;31.08.2014;2014;08;01;Sunnuntai;4;4;8;0;1;1
109;31.08.2014;2014;08;02;Sunnuntai;0;0;0;0;0;0
109;31.08.2014;2014;08;03;Sunnuntai;3;2;5;0;0;0
109;31.08.2014;2014;08;04;Sunnuntai;0;0;0;1;0;1
109;31.08.2014;2014;08;05;Sunnuntai;1;0;1;1;0;1
109;31.08.2014;2014;08;06;Sunnuntai;0;6;6;0;2;2
109;31.08.2014;2014;08;07;Sunnuntai;3;1;4;3;2;5
109;31.08.2014;2014;08;08;Sunnuntai;0;2;2;3;4;7
109;31.08.2014;2014;08;09;Sunnuntai;3;4;7;1;4;5
109;31.08.2014;2014;08;10;Sunnuntai;3;9;12;5;8;13
109;31.08.2014;2014;08;11;Sunnuntai;16;8;24;6;3;9
109;31.08.2014;2014;08;12;Sunnuntai;10;15;25;4;2;6
109;31.08.2014;2014;08;13;Sunnuntai;8;9;17;2;3;5
109;31.08.2014;2014;08;14;Sunnuntai;10;7;17;6;5;11
109;31.08.2014;2014;08;15;Sunnuntai;13;20;33;4;6;10
109;31.08.2014;2014;08;16;Sunnuntai;12;15;27;3;3;6
109;31.08.2014;2014;08;17;Sunnuntai;8;21;29;0;7;7
109;31.08.2014;2014;08;18;Sunnuntai;16;13;29;4;5;9
109;31.08.2014;2014;08;19;Sunnuntai;20;9;29;12;8;20
109;31.08.2014;2014;08;20;Sunnuntai;7;10;17;4;6;10
109;31.08.2014;2014;08;21;Sunnuntai;14;5;19;4;2;6
109;31.08.2014;2014;08;22;Sunnuntai;2;2;4;0;0;0
109;31.08.2014;2014;08;23;Sunnuntai;2;1;3;0;0;0
109;01.09.2014;2014;09;00;Maanantai;0;1;1;0;0;0
109;01.09.2014;2014;09;01;Maanantai;2;0;2;2;0;2
109;01.09.2014;2014;09;02;Maanantai;0;0;0;0;0;0
109;01.09.2014;2014;09;03;Maanantai;0;0;0;0;0;0
109;01.09.2014;2014;09;04;Maanantai;2;0;2;0;1;1
109;01.09.2014;2014;09;05;Maanantai;7;5;12;2;1;3
109;01.09.2014;2014;09;06;Maanantai;15;27;42;1;1;2
109;01.09.2014;2014;09;07;Maanantai;34;87;121;1;6;7
109;01.09.2014;2014;09;08;Maanantai;25;69;94;5;4;9
109;01.09.2014;2014;09;09;Maanantai;17;45;62;2;1;3
109;01.09.2014;2014;09;10;Maanantai;7;16;23;4;4;8
109;01.09.2014;2014;09;11;Maanantai;13;13;26;5;6;11
109;01.09.2014;2014;09;12;Maanantai;19;25;44;0;4;4
109;01.09.2014;2014;09;13;Maanantai;14;21;35;2;5;7
109;01.09.2014;2014;09;14;Maanantai;35;15;50;0;2;2
109;01.09.2014;2014;09;15;Maanantai;48;28;76;1;4;5
109;01.09.2014;2014;09;16;Maanantai;99;40;139;5;10;15
109;01.09.2014;2014;09;17;Maanantai;41;26;67;8;8;16
109;01.09.2014;2014;09;18;Maanantai;27;16;43;5;6;11
109;01.09.2014;2014;09;19;Maanantai;21;10;31;6;7;13
109;01.09.2014;2014;09;20;Maanantai;8;15;23;3;6;9
109;01.09.2014;2014;09;21;Maanantai;13;9;22;3;4;7
109;01.09.2014;2014;09;22;Maanantai;1;6;7;2;2;4
109;01.09.2014;2014;09;23;Maanantai;1;2;3;0;0;0
109;02.09.2014;2014;09;00;Tiistai;0;1;1;0;2;2
109;02.09.2014;2014;09;01;Tiistai;0;0;0;1;0;1
109;02.09.2014;2014;09;02;Tiistai;0;0;0;0;0;0
109;02.09.2014;2014;09;03;Tiistai;0;0;0;0;0;0
109;02.09.2014;2014;09;04;Tiistai;0;2;2;0;1;1
109;02.09.2014;2014;09;05;Tiistai;10;5;15;2;1;3
109;02.09.2014;2014;09;06;Tiistai;9;31;40;1;1;2
109;02.09.2014;2014;09;07;Tiistai;36;100;136;2;5;7
109;02.09.2014;2014;09;08;Tiistai;31;61;92;4;3;7
109;02.09.2014;2014;09;09;Tiistai;11;28;39;0;0;0
109;02.09.2014;2014;09;10;Tiistai;8;9;17;9;6;15
109;02.09.2014;2014;09;11;Tiistai;20;13;33;1;4;5
109;02.09.2014;2014;09;12;Tiistai;13;14;27;3;4;7
109;02.09.2014;2014;09;13;Tiistai;20;16;36;1;3;4
109;02.09.2014;2014;09;14;Tiistai;29;27;56;1;9;10
109;02.09.2014;2014;09;15;Tiistai;57;45;102;2;4;6
109;02.09.2014;2014;09;16;Tiistai;74;54;128;2;9;11
109;02.09.2014;2014;09;17;Tiistai;33;33;66;3;2;5
109;02.09.2014;2014;09;18;Tiistai;22;17;39;2;3;5
109;02.09.2014;2014;09;19;Tiistai;21;14;35;3;4;7
109;02.09.2014;2014;09;20;Tiistai;21;9;30;4;4;8
109;02.09.2014;2014;09;21;Tiistai;11;6;17;4;4;8
109;02.09.2014;2014;09;22;Tiistai;2;7;9;1;1;2
109;02.09.2014;2014;09;23;Tiistai;1;1;2;1;0;1
109;03.09.2014;2014;09;00;Keskiviikko;3;0;3;1;0;1
109;03.09.2014;2014;09;01;Keskiviikko;0;1;1;0;0;0
109;03.09.2014;2014;09;02;Keskiviikko;0;0;0;0;0;0
109;03.09.2014;2014;09;03;Keskiviikko;1;0;1;0;0;0
109;03.09.2014;2014;09;04;Keskiviikko;1;1;2;0;0;0
109;03.09.2014;2014;09;05;Keskiviikko;9;2;11;1;3;4
109;03.09.2014;2014;09;06;Keskiviikko;16;30;46;0;1;1
109;03.09.2014;2014;09;07;Keskiviikko;33;98;131;3;7;10
109;03.09.2014;2014;09;08;Keskiviikko;29;68;97;2;0;2
109;03.09.2014;2014;09;09;Keskiviikko;11;35;46;1;1;2
109;03.09.2014;2014;09;10;Keskiviikko;11;19;30;2;3;5
109;03.09.2014;2014;09;11;Keskiviikko;19;19;38;0;2;2
109;03.09.2014;2014;09;12;Keskiviikko;11;14;25;2;6;8
109;03.09.2014;2014;09;13;Keskiviikko;29;23;52;3;1;4
109;03.09.2014;2014;09;14;Keskiviikko;33;22;55;3;3;6
109;03.09.2014;2014;09;15;Keskiviikko;40;37;77;6;6;12
109;03.09.2014;2014;09;16;Keskiviikko;61;66;127;8;6;14
109;03.09.2014;2014;09;17;Keskiviikko;36;37;73;1;6;7
109;03.09.2014;2014;09;18;Keskiviikko;19;43;62;6;3;9
109;03.09.2014;2014;09;19;Keskiviikko;19;17;36;4;7;11
109;03.09.2014;2014;09;20;Keskiviikko;20;8;28;9;5;14
109;03.09.2014;2014;09;21;Keskiviikko;18;9;27;4;1;5
109;03.09.2014;2014;09;22;Keskiviikko;7;7;14;1;1;2
109;03.09.2014;2014;09;23;Keskiviikko;6;1;7;1;1;2
109;04.09.2014;2014;09;00;Torstai;2;1;3;0;0;0
109;04.09.2014;2014;09;01;Torstai;0;0;0;1;0;1
109;04.09.2014;2014;09;02;Torstai;0;0;0;0;0;0
109;04.09.2014;2014;09;03;Torstai;0;0;0;0;1;1
109;04.09.2014;2014;09;04;Torstai;0;1;1;0;0;0
109;04.09.2014;2014;09;05;Torstai;11;3;14;1;2;3
109;04.09.2014;2014;09;06;Torstai;15;30;45;2;2;4
109;04.09.2014;2014;09;07;Torstai;36;93;129;4;5;9
109;04.09.2014;2014;09;08;Torstai;27;64;91;5;4;9
109;04.09.2014;2014;09;09;Torstai;6;31;37;2;3;5
109;04.09.2014;2014;09;10;Torstai;9;13;22;6;5;11
109;04.09.2014;2014;09;11;Torstai;10;21;31;3;8;11
109;04.09.2014;2014;09;12;Torstai;18;27;45;5;1;6
109;04.09.2014;2014;09;13;Torstai;18;18;36;3;1;4
109;04.09.2014;2014;09;14;Torstai;28;25;53;0;2;2
109;04.09.2014;2014;09;15;Torstai;46;38;84;4;4;8
109;04.09.2014;2014;09;16;Torstai;81;65;146;5;3;8
109;04.09.2014;2014;09;17;Torstai;31;27;58;0;5;5
109;04.09.2014;2014;09;18;Torstai;26;24;50;5;7;12
109;04.09.2014;2014;09;19;Torstai;15;12;27;5;5;10
109;04.09.2014;2014;09;20;Torstai;17;21;38;5;7;12
109;04.09.2014;2014;09;21;Torstai;8;12;20;3;3;6
109;04.09.2014;2014;09;22;Torstai;4;6;10;2;1;3
109;04.09.2014;2014;09;23;Torstai;0;2;2;0;1;1
109;05.09.2014;2014;09;00;Perjantai;0;2;2;0;0;0
109;05.09.2014;2014;09;01;Perjantai;0;0;0;1;1;2
109;05.09.2014;2014;09;02;Perjantai;2;0;2;0;0;0
109;05.09.2014;2014;09;03;Perjantai;0;0;0;0;0;0
109;05.09.2014;2014;09;04;Perjantai;2;1;3;0;0;0
109;05.09.2014;2014;09;05;Perjantai;6;2;8;1;0;1
109;05.09.2014;2014;09;06;Perjantai;11;35;46;1;2;3
109;05.09.2014;2014;09;07;Perjantai;28;89;117;2;6;8
109;05.09.2014;2014;09;08;Perjantai;31;56;87;8;4;12
109;05.09.2014;2014;09;09;Perjantai;9;26;35;3;3;6
109;05.09.2014;2014;09;10;Perjantai;9;18;27;1;4;5
109;05.09.2014;2014;09;11;Perjantai;11;10;21;1;2;3
109;05.09.2014;2014;09;12;Perjantai;16;16;32;2;6;8
109;05.09.2014;2014;09;13;Perjantai;23;20;43;3;3;6
109;05.09.2014;2014;09;14;Perjantai;50;25;75;5;1;6
109;05.09.2014;2014;09;15;Perjantai;52;37;89;2;6;8
109;05.09.2014;2014;09;16;Perjantai;62;36;98;3;8;11
109;05.09.2014;2014;09;17;Perjantai;27;26;53;3;0;3
109;05.09.2014;2014;09;18;Perjantai;26;32;58;2;2;4
109;05.09.2014;2014;09;19;Perjantai;8;9;17;8;6;14
109;05.09.2014;2014;09;20;Perjantai;17;9;26;3;2;5
109;05.09.2014;2014;09;21;Perjantai;11;13;24;2;3;5
109;05.09.2014;2014;09;22;Perjantai;3;2;5;2;0;2
109;05.09.2014;2014;09;23;Perjantai;5;3;8;0;0;0
109;06.09.2014;2014;09;00;Lauantai;3;2;5;0;1;1
109;06.09.2014;2014;09;01;Lauantai;2;0;2;0;0;0
109;06.09.2014;2014;09;02;Lauantai;2;1;3;0;0;0
109;06.09.2014;2014;09;03;Lauantai;4;0;4;0;0;0
109;06.09.2014;2014;09;04;Lauantai;8;2;10;0;0;0
109;06.09.2014;2014;09;05;Lauantai;1;4;5;0;1;1
109;06.09.2014;2014;09;06;Lauantai;1;7;8;0;1;1
109;06.09.2014;2014;09;07;Lauantai;3;4;7;2;3;5
109;06.09.2014;2014;09;08;Lauantai;2;3;5;3;2;5
109;06.09.2014;2014;09;09;Lauantai;8;10;18;2;2;4
109;06.09.2014;2014;09;10;Lauantai;4;6;10;2;5;7
109;06.09.2014;2014;09;11;Lauantai;9;16;25;4;5;9
109;06.09.2014;2014;09;12;Lauantai;9;8;17;0;0;0
109;06.09.2014;2014;09;13;Lauantai;18;17;35;6;4;10
109;06.09.2014;2014;09;14;Lauantai;6;10;16;1;3;4
109;06.09.2014;2014;09;15;Lauantai;17;16;33;1;1;2
109;06.09.2014;2014;09;16;Lauantai;9;8;17;3;4;7
109;06.09.2014;2014;09;17;Lauantai;10;14;24;2;2;4
109;06.09.2014;2014;09;18;Lauantai;18;12;30;2;7;9
109;06.09.2014;2014;09;19;Lauantai;9;14;23;4;9;13
109;06.09.2014;2014;09;20;Lauantai;10;18;28;5;3;8
109;06.09.2014;2014;09;21;Lauantai;6;12;18;2;2;4
109;06.09.2014;2014;09;22;Lauantai;9;2;11;4;1;5
109;06.09.2014;2014;09;23;Lauantai;4;2;6;2;0;2
109;07.09.2014;2014;09;00;Sunnuntai;2;6;8;0;1;1
109;07.09.2014;2014;09;01;Sunnuntai;0;1;1;0;0;0
109;07.09.2014;2014;09;02;Sunnuntai;4;1;5;0;0;0
109;07.09.2014;2014;09;03;Sunnuntai;4;0;4;0;0;0
109;07.09.2014;2014;09;04;Sunnuntai;0;1;1;1;0;1
109;07.09.2014;2014;09;05;Sunnuntai;0;2;2;0;1;1
109;07.09.2014;2014;09;06;Sunnuntai;0;5;5;0;0;0
109;07.09.2014;2014;09;07;Sunnuntai;1;3;4;1;2;3
109;07.09.2014;2014;09;08;Sunnuntai;0;6;6;5;2;7
109;07.09.2014;2014;09;09;Sunnuntai;2;2;4;4;2;6
109;07.09.2014;2014;09;10;Sunnuntai;5;3;8;5;1;6
109;07.09.2014;2014;09;11;Sunnuntai;4;12;16;8;5;13
109;07.09.2014;2014;09;12;Sunnuntai;13;19;32;7;5;12
109;07.09.2014;2014;09;13;Sunnuntai;18;10;28;4;4;8
109;07.09.2014;2014;09;14;Sunnuntai;13;16;29;0;4;4
109;07.09.2014;2014;09;15;Sunnuntai;13;7;20;3;3;6
109;07.09.2014;2014;09;16;Sunnuntai;8;22;30;6;7;13
109;07.09.2014;2014;09;17;Sunnuntai;8;15;23;4;4;8
109;07.09.2014;2014;09;18;Sunnuntai;17;25;42;2;13;15
109;07.09.2014;2014;09;19;Sunnuntai;13;10;23;2;9;11
109;07.09.2014;2014;09;20;Sunnuntai;12;9;21;4;2;6
109;07.09.2014;2014;09;21;Sunnuntai;20;3;23;6;0;6
109;07.09.2014;2014;09;22;Sunnuntai;5;3;8;1;0;1
109;07.09.2014;2014;09;23;Sunnuntai;1;2;3;1;1;2
109;08.09.2014;2014;09;00;Maanantai;1;0;1;0;1;1
109;08.09.2014;2014;09;01;Maanantai;0;0;0;0;2;2
109;08.09.2014;2014;09;02;Maanantai;0;0;0;0;1;1
109;08.09.2014;2014;09;03;Maanantai;0;0;0;0;0;0
109;08.09.2014;2014;09;04;Maanantai;0;0;0;0;0;0
109;08.09.2014;2014;09;05;Maanantai;5;4;9;1;0;1
109;08.09.2014;2014;09;06;Maanantai;13;29;42;3;1;4
109;08.09.2014;2014;09;07;Maanantai;40;98;138;2;5;7
109;08.09.2014;2014;09;08;Maanantai;27;65;92;5;5;10
109;08.09.2014;2014;09;09;Maanantai;10;48;58;1;3;4
109;08.09.2014;2014;09;10;Maanantai;7;20;27;4;10;14
109;08.09.2014;2014;09;11;Maanantai;7;21;28;1;3;4
109;08.09.2014;2014;09;12;Maanantai;12;23;35;3;4;7
109;08.09.2014;2014;09;13;Maanantai;20;20;40;2;1;3
109;08.09.2014;2014;09;14;Maanantai;39;16;55;1;3;4
109;08.09.2014;2014;09;15;Maanantai;51;31;82;6;6;12
109;08.09.2014;2014;09;16;Maanantai;103;61;164;3;9;12
109;08.09.2014;2014;09;17;Maanantai;37;40;77;6;0;6
109;08.09.2014;2014;09;18;Maanantai;12;19;31;3;6;9
109;08.09.2014;2014;09;19;Maanantai;20;25;45;7;5;12
109;08.09.2014;2014;09;20;Maanantai;11;14;25;1;5;6
109;08.09.2014;2014;09;21;Maanantai;12;6;18;5;1;6
109;08.09.2014;2014;09;22;Maanantai;3;7;10;2;0;2
109;08.09.2014;2014;09;23;Maanantai;2;1;3;1;1;2
109;09.09.2014;2014;09;00;Tiistai;0;1;1;0;0;0
109;09.09.2014;2014;09;01;Tiistai;0;0;0;1;0;1
109;09.09.2014;2014;09;02;Tiistai;0;0;0;1;1;2
109;09.09.2014;2014;09;03;Tiistai;0;0;0;0;0;0
109;09.09.2014;2014;09;04;Tiistai;1;1;2;0;0;0
109;09.09.2014;2014;09;05;Tiistai;6;4;10;2;1;3
109;09.09.2014;2014;09;06;Tiistai;10;30;40;1;1;2
109;09.09.2014;2014;09;07;Tiistai;49;111;160;4;8;12
109;09.09.2014;2014;09;08;Tiistai;18;74;92;3;4;7
109;09.09.2014;2014;09;09;Tiistai;16;42;58;0;4;4
109;09.09.2014;2014;09;10;Tiistai;9;15;24;1;7;8
109;09.09.2014;2014;09;11;Tiistai;12;16;28;3;1;4
109;09.09.2014;2014;09;12;Tiistai;17;19;36;2;4;6
109;09.09.2014;2014;09;13;Tiistai;19;19;38;1;3;4
109;09.09.2014;2014;09;14;Tiistai;23;24;47;3;3;6
109;09.09.2014;2014;09;15;Tiistai;68;37;105;6;7;13
109;09.09.2014;2014;09;16;Tiistai;83;59;142;6;4;10
109;09.09.2014;2014;09;17;Tiistai;36;26;62;4;4;8
109;09.09.2014;2014;09;18;Tiistai;24;41;65;1;5;6
109;09.09.2014;2014;09;19;Tiistai;17;13;30;7;5;12
109;09.09.2014;2014;09;20;Tiistai;20;16;36;5;2;7
109;09.09.2014;2014;09;21;Tiistai;18;10;28;3;6;9
109;09.09.2014;2014;09;22;Tiistai;3;11;14;1;2;3
109;09.09.2014;2014;09;23;Tiistai;1;5;6;0;0;0
109;10.09.2014;2014;09;00;Keskiviikko;0;0;0;1;1;2
109;10.09.2014;2014;09;01;Keskiviikko;0;1;1;0;0;0
109;10.09.2014;2014;09;02;Keskiviikko;0;0;0;0;0;0
109;10.09.2014;2014;09;03;Keskiviikko;1;2;3;0;0;0
109;10.09.2014;2014;09;04;Keskiviikko;1;1;2;0;1;1
109;10.09.2014;2014;09;05;Keskiviikko;6;2;8;2;1;3
109;10.09.2014;2014;09;06;Keskiviikko;11;39;50;4;1;5
109;10.09.2014;2014;09;07;Keskiviikko;37;109;146;4;7;11
109;10.09.2014;2014;09;08;Keskiviikko;28;72;100;3;2;5
109;10.09.2014;2014;09;09;Keskiviikko;12;28;40;1;3;4
109;10.09.2014;2014;09;10;Keskiviikko;10;18;28;1;3;4
109;10.09.2014;2014;09;11;Keskiviikko;9;15;24;2;3;5
109;10.09.2014;2014;09;12;Keskiviikko;10;21;31;2;1;3
109;10.09.2014;2014;09;13;Keskiviikko;30;14;44;2;3;5
109;10.09.2014;2014;09;14;Keskiviikko;39;15;54;6;2;8
109;10.09.2014;2014;09;15;Keskiviikko;49;43;92;4;4;8
109;10.09.2014;2014;09;16;Keskiviikko;96;56;152;5;6;11
109;10.09.2014;2014;09;17;Keskiviikko;42;37;79;2;7;9
109;10.09.2014;2014;09;18;Keskiviikko;22;23;45;6;3;9
109;10.09.2014;2014;09;19;Keskiviikko;14;19;33;5;4;9
109;10.09.2014;2014;09;20;Keskiviikko;15;11;26;4;6;10
109;10.09.2014;2014;09;21;Keskiviikko;10;11;21;0;4;4
109;10.09.2014;2014;09;22;Keskiviikko;3;6;9;2;2;4
109;10.09.2014;2014;09;23;Keskiviikko;4;3;7;0;1;1
109;11.09.2014;2014;09;00;Torstai;2;0;2;0;1;1
109;11.09.2014;2014;09;01;Torstai;0;0;0;2;0;2
109;11.09.2014;2014;09;02;Torstai;0;0;0;0;0;0
109;11.09.2014;2014;09;03;Torstai;0;1;1;0;0;0
109;11.09.2014;2014;09;04;Torstai;2;1;3;0;1;1
109;11.09.2014;2014;09;05;Torstai;10;5;15;1;1;2
109;11.09.2014;2014;09;06;Torstai;14;31;45;3;2;5
109;11.09.2014;2014;09;07;Torstai;32;98;130;4;2;6
109;11.09.2014;2014;09;08;Torstai;21;66;87;3;3;6
109;11.09.2014;2014;09;09;Torstai;10;21;31;4;7;11
109;11.09.2014;2014;09;10;Torstai;12;15;27;3;2;5
109;11.09.2014;2014;09;11;Torstai;12;18;30;3;3;6
109;11.09.2014;2014;09;12;Torstai;15;13;28;3;0;3
109;11.09.2014;2014;09;13;Torstai;21;13;34;1;2;3
109;11.09.2014;2014;09;14;Torstai;39;30;69;0;2;2
109;11.09.2014;2014;09;15;Torstai;45;32;77;5;4;9
109;11.09.2014;2014;09;16;Torstai;87;64;151;4;8;12
109;11.09.2014;2014;09;17;Torstai;34;35;69;5;4;9
109;11.09.2014;2014;09;18;Torstai;18;21;39;5;4;9
109;11.09.2014;2014;09;19;Torstai;18;17;35;6;4;10
109;11.09.2014;2014;09;20;Torstai;18;11;29;3;11;14
109;11.09.2014;2014;09;21;Torstai;13;11;24;2;3;5
109;11.09.2014;2014;09;22;Torstai;2;4;6;0;0;0
109;11.09.2014;2014;09;23;Torstai;0;4;4;1;0;1
109;12.09.2014;2014;09;00;Perjantai;1;0;1;0;0;0
109;12.09.2014;2014;09;01;Perjantai;2;0;2;1;0;1
109;12.09.2014;2014;09;02;Perjantai;0;0;0;0;0;0
109;12.09.2014;2014;09;03;Perjantai;0;1;1;1;2;3
109;12.09.2014;2014;09;04;Perjantai;1;1;2;1;0;1
109;12.09.2014;2014;09;05;Perjantai;9;4;13;0;2;2
109;12.09.2014;2014;09;06;Perjantai;15;24;39;1;1;2
109;12.09.2014;2014;09;07;Perjantai;35;75;110;4;3;7
109;12.09.2014;2014;09;08;Perjantai;25;51;76;2;4;6
109;12.09.2014;2014;09;09;Perjantai;10;19;29;0;3;3
109;12.09.2014;2014;09;10;Perjantai;7;17;24;1;1;2
109;12.09.2014;2014;09;11;Perjantai;13;16;29;2;3;5
109;12.09.2014;2014;09;12;Perjantai;9;20;29;5;2;7
109;12.09.2014;2014;09;13;Perjantai;19;16;35;4;2;6
109;12.09.2014;2014;09;14;Perjantai;37;26;63;2;5;7
109;12.09.2014;2014;09;15;Perjantai;47;33;80;5;4;9
109;12.09.2014;2014;09;16;Perjantai;42;46;88;5;1;6
109;12.09.2014;2014;09;17;Perjantai;21;31;52;2;1;3
109;12.09.2014;2014;09;18;Perjantai;13;27;40;1;3;4
109;12.09.2014;2014;09;19;Perjantai;12;14;26;5;4;9
109;12.09.2014;2014;09;20;Perjantai;12;10;22;3;1;4
109;12.09.2014;2014;09;21;Perjantai;8;16;24;3;4;7
109;12.09.2014;2014;09;22;Perjantai;4;5;9;0;1;1
109;12.09.2014;2014;09;23;Perjantai;4;3;7;1;0;1
109;13.09.2014;2014;09;00;Lauantai;0;2;2;0;0;0
109;13.09.2014;2014;09;01;Lauantai;0;2;2;0;0;0
109;13.09.2014;2014;09;02;Lauantai;0;0;0;0;0;0
109;13.09.2014;2014;09;03;Lauantai;2;0;2;0;0;0
109;13.09.2014;2014;09;04;Lauantai;1;0;1;0;0;0
109;13.09.2014;2014;09;05;Lauantai;3;0;3;0;1;1
109;13.09.2014;2014;09;06;Lauantai;0;6;6;0;1;1
109;13.09.2014;2014;09;07;Lauantai;3;3;6;2;3;5
109;13.09.2014;2014;09;08;Lauantai;0;4;4;2;2;4
109;13.09.2014;2014;09;09;Lauantai;6;8;14;4;5;9
109;13.09.2014;2014;09;10;Lauantai;3;7;10;6;3;9
109;13.09.2014;2014;09;11;Lauantai;7;8;15;3;4;7
109;13.09.2014;2014;09;12;Lauantai;14;19;33;1;2;3
109;13.09.2014;2014;09;13;Lauantai;9;13;22;1;3;4
109;13.09.2014;2014;09;14;Lauantai;14;24;38;3;1;4
109;13.09.2014;2014;09;15;Lauantai;12;24;36;7;1;8
109;13.09.2014;2014;09;16;Lauantai;27;24;51;5;3;8
109;13.09.2014;2014;09;17;Lauantai;17;14;31;3;4;7
109;13.09.2014;2014;09;18;Lauantai;11;21;32;5;4;9
109;13.09.2014;2014;09;19;Lauantai;9;12;21;3;2;5
109;13.09.2014;2014;09;20;Lauantai;11;3;14;1;3;4
109;13.09.2014;2014;09;21;Lauantai;2;9;11;2;3;5
109;13.09.2014;2014;09;22;Lauantai;6;7;13;1;1;2
109;13.09.2014;2014;09;23;Lauantai;5;0;5;1;0;1
109;14.09.2014;2014;09;00;Sunnuntai;2;10;12;0;0;0
109;14.09.2014;2014;09;01;Sunnuntai;0;0;0;0;0;0
109;14.09.2014;2014;09;02;Sunnuntai;3;0;3;1;0;1
109;14.09.2014;2014;09;03;Sunnuntai;1;0;1;0;0;0
109;14.09.2014;2014;09;04;Sunnuntai;1;2;3;0;0;0
109;14.09.2014;2014;09;05;Sunnuntai;0;0;0;2;2;4
109;14.09.2014;2014;09;06;Sunnuntai;1;1;2;0;0;0
109;14.09.2014;2014;09;07;Sunnuntai;6;1;7;2;2;4
109;14.09.2014;2014;09;08;Sunnuntai;0;1;1;2;2;4
109;14.09.2014;2014;09;09;Sunnuntai;2;11;13;2;2;4
109;14.09.2014;2014;09;10;Sunnuntai;2;8;10;5;4;9
109;14.09.2014;2014;09;11;Sunnuntai;10;5;15;1;5;6
109;14.09.2014;2014;09;12;Sunnuntai;11;18;29;4;4;8
109;14.09.2014;2014;09;13;Sunnuntai;6;10;16;0;4;4
109;14.09.2014;2014;09;14;Sunnuntai;8;14;22;3;3;6
109;14.09.2014;2014;09;15;Sunnuntai;11;18;29;4;5;9
109;14.09.2014;2014;09;16;Sunnuntai;14;23;37;9;4;13
109;14.09.2014;2014;09;17;Sunnuntai;9;9;18;1;2;3
109;14.09.2014;2014;09;18;Sunnuntai;7;21;28;5;5;10
109;14.09.2014;2014;09;19;Sunnuntai;18;17;35;8;4;12
109;14.09.2014;2014;09;20;Sunnuntai;4;2;6;5;4;9
109;14.09.2014;2014;09;21;Sunnuntai;6;3;9;3;1;4
109;14.09.2014;2014;09;22;Sunnuntai;2;1;3;2;3;5
109;14.09.2014;2014;09;23;Sunnuntai;1;0;1;0;0;0
109;15.09.2014;2014;09;00;Maanantai;0;0;0;0;0;0
109;15.09.2014;2014;09;01;Maanantai;0;0;0;0;0;0
109;15.09.2014;2014;09;02;Maanantai;0;0;0;2;0;2
109;15.09.2014;2014;09;03;Maanantai;0;3;3;0;0;0
109;15.09.2014;2014;09;04;Maanantai;0;0;0;0;0;0
109;15.09.2014;2014;09;05;Maanantai;5;4;9;2;1;3
109;15.09.2014;2014;09;06;Maanantai;16;37;53;2;1;3
109;15.09.2014;2014;09;07;Maanantai;33;93;126;5;3;8
109;15.09.2014;2014;09;08;Maanantai;42;64;106;3;1;4
109;15.09.2014;2014;09;09;Maanantai;7;35;42;1;0;1
109;15.09.2014;2014;09;10;Maanantai;9;13;22;3;0;3
109;15.09.2014;2014;09;11;Maanantai;6;21;27;3;4;7
109;15.09.2014;2014;09;12;Maanantai;17;18;35;2;2;4
109;15.09.2014;2014;09;13;Maanantai;17;21;38;2;4;6
109;15.09.2014;2014;09;14;Maanantai;39;21;60;1;2;3
109;15.09.2014;2014;09;15;Maanantai;63;41;104;5;2;7
109;15.09.2014;2014;09;16;Maanantai;79;47;126;4;3;7
109;15.09.2014;2014;09;17;Maanantai;36;32;68;6;3;9
109;15.09.2014;2014;09;18;Maanantai;21;14;35;2;8;10
109;15.09.2014;2014;09;19;Maanantai;14;22;36;3;2;5
109;15.09.2014;2014;09;20;Maanantai;17;9;26;9;4;13
109;15.09.2014;2014;09;21;Maanantai;5;9;14;1;4;5
109;15.09.2014;2014;09;22;Maanantai;5;9;14;0;0;0
109;15.09.2014;2014;09;23;Maanantai;1;1;2;0;0;0
109;16.09.2014;2014;09;00;Tiistai;0;1;1;2;1;3
109;16.09.2014;2014;09;01;Tiistai;0;0;0;2;0;2
109;16.09.2014;2014;09;02;Tiistai;0;0;0;0;0;0
109;16.09.2014;2014;09;03;Tiistai;0;0;0;0;0;0
109;16.09.2014;2014;09;04;Tiistai;1;0;1;0;0;0
109;16.09.2014;2014;09;05;Tiistai;5;6;11;2;1;3
109;16.09.2014;2014;09;06;Tiistai;12;31;43;0;0;0
109;16.09.2014;2014;09;07;Tiistai;42;106;148;2;6;8
109;16.09.2014;2014;09;08;Tiistai;24;68;92;1;2;3
109;16.09.2014;2014;09;09;Tiistai;21;31;52;1;3;4
109;16.09.2014;2014;09;10;Tiistai;14;15;29;3;3;6
109;16.09.2014;2014;09;11;Tiistai;5;15;20;3;9;12
109;16.09.2014;2014;09;12;Tiistai;12;14;26;3;1;4
109;16.09.2014;2014;09;13;Tiistai;27;21;48;0;3;3
109;16.09.2014;2014;09;14;Tiistai;41;17;58;3;5;8
109;16.09.2014;2014;09;15;Tiistai;53;36;89;3;2;5
109;16.09.2014;2014;09;16;Tiistai;91;46;137;5;3;8
109;16.09.2014;2014;09;17;Tiistai;38;32;70;2;2;4
109;16.09.2014;2014;09;18;Tiistai;23;25;48;5;5;10
109;16.09.2014;2014;09;19;Tiistai;13;18;31;7;9;16
109;16.09.2014;2014;09;20;Tiistai;21;9;30;4;6;10
109;16.09.2014;2014;09;21;Tiistai;9;3;12;3;2;5
109;16.09.2014;2014;09;22;Tiistai;3;10;13;1;0;1
109;16.09.2014;2014;09;23;Tiistai;0;1;1;0;0;0
109;17.09.2014;2014;09;00;Keskiviikko;0;2;2;0;0;0
109;17.09.2014;2014;09;01;Keskiviikko;0;0;0;0;0;0
109;17.09.2014;2014;09;02;Keskiviikko;0;0;0;0;0;0
109;17.09.2014;2014;09;03;Keskiviikko;0;0;0;0;0;0
109;17.09.2014;2014;09;04;Keskiviikko;1;0;1;0;1;1
109;17.09.2014;2014;09;05;Keskiviikko;3;7;10;2;1;3
109;17.09.2014;2014;09;06;Keskiviikko;14;29;43;0;0;0
109;17.09.2014;2014;09;07;Keskiviikko;41;86;127;6;1;7
109;17.09.2014;2014;09;08;Keskiviikko;30;88;118;3;4;7
109;17.09.2014;2014;09;09;Keskiviikko;12;23;35;1;4;5
109;17.09.2014;2014;09;10;Keskiviikko;10;25;35;1;1;2
109;17.09.2014;2014;09;11;Keskiviikko;8;16;24;2;5;7
109;17.09.2014;2014;09;12;Keskiviikko;10;9;19;0;1;1
109;17.09.2014;2014;09;13;Keskiviikko;25;17;42;6;1;7
109;17.09.2014;2014;09;14;Keskiviikko;39;20;59;1;1;2
109;17.09.2014;2014;09;15;Keskiviikko;39;35;74;4;3;7
109;17.09.2014;2014;09;16;Keskiviikko;88;54;142;3;1;4
109;17.09.2014;2014;09;17;Keskiviikko;34;33;67;3;6;9
109;17.09.2014;2014;09;18;Keskiviikko;23;24;47;2;3;5
109;17.09.2014;2014;09;19;Keskiviikko;12;22;34;5;4;9
109;17.09.2014;2014;09;20;Keskiviikko;8;12;20;2;2;4
109;17.09.2014;2014;09;21;Keskiviikko;21;6;27;2;2;4
109;17.09.2014;2014;09;22;Keskiviikko;4;10;14;1;1;2
109;17.09.2014;2014;09;23;Keskiviikko;3;4;7;0;0;0
109;18.09.2014;2014;09;00;Torstai;0;0;0;0;0;0
109;18.09.2014;2014;09;01;Torstai;0;0;0;0;0;0
109;18.09.2014;2014;09;02;Torstai;1;1;2;1;0;1
109;18.09.2014;2014;09;03;Torstai;1;0;1;0;1;1
109;18.09.2014;2014;09;04;Torstai;0;0;0;1;0;1
109;18.09.2014;2014;09;05;Torstai;7;6;13;3;1;4
109;18.09.2014;2014;09;06;Torstai;10;30;40;0;1;1
109;18.09.2014;2014;09;07;Torstai;34;84;118;3;4;7
109;18.09.2014;2014;09;08;Torstai;27;72;99;2;1;3
109;18.09.2014;2014;09;09;Torstai;10;23;33;1;2;3
109;18.09.2014;2014;09;10;Torstai;8;15;23;6;8;14
109;18.09.2014;2014;09;11;Torstai;7;16;23;1;2;3
109;18.09.2014;2014;09;12;Torstai;14;15;29;2;5;7
109;18.09.2014;2014;09;13;Torstai;21;15;36;0;2;2
109;18.09.2014;2014;09;14;Torstai;19;27;46;0;3;3
109;18.09.2014;2014;09;15;Torstai;44;33;77;1;4;5
109;18.09.2014;2014;09;16;Torstai;62;60;122;5;3;8
109;18.09.2014;2014;09;17;Torstai;38;26;64;4;9;13
109;18.09.2014;2014;09;18;Torstai;16;15;31;6;5;11
109;18.09.2014;2014;09;19;Torstai;8;15;23;5;6;11
109;18.09.2014;2014;09;20;Torstai;12;7;19;6;4;10
109;18.09.2014;2014;09;21;Torstai;9;4;13;2;2;4
109;18.09.2014;2014;09;22;Torstai;6;7;13;2;0;2
109;18.09.2014;2014;09;23;Torstai;0;4;4;0;1;1
109;19.09.2014;2014;09;00;Perjantai;0;1;1;2;0;2
109;19.09.2014;2014;09;01;Perjantai;1;0;1;2;0;2
109;19.09.2014;2014;09;02;Perjantai;0;0;0;0;0;0
109;19.09.2014;2014;09;03;Perjantai;1;1;2;0;0;0
109;19.09.2014;2014;09;04;Perjantai;0;0;0;1;0;1
109;19.09.2014;2014;09;05;Perjantai;5;3;8;0;1;1
109;19.09.2014;2014;09;06;Perjantai;11;25;36;0;0;0
109;19.09.2014;2014;09;07;Perjantai;35;62;97;5;6;11
109;19.09.2014;2014;09;08;Perjantai;27;57;84;4;4;8
109;19.09.2014;2014;09;09;Perjantai;9;25;34;1;0;1
109;19.09.2014;2014;09;10;Perjantai;6;15;21;4;2;6
109;19.09.2014;2014;09;11;Perjantai;16;21;37;4;3;7
109;19.09.2014;2014;09;12;Perjantai;14;33;47;1;4;5
109;19.09.2014;2014;09;13;Perjantai;19;18;37;1;5;6
109;19.09.2014;2014;09;14;Perjantai;32;21;53;3;4;7
109;19.09.2014;2014;09;15;Perjantai;49;27;76;2;2;4
109;19.09.2014;2014;09;16;Perjantai;46;37;83;3;3;6
109;19.09.2014;2014;09;17;Perjantai;17;19;36;2;1;3
109;19.09.2014;2014;09;18;Perjantai;17;16;33;2;3;5
109;19.09.2014;2014;09;19;Perjantai;17;15;32;1;4;5
109;19.09.2014;2014;09;20;Perjantai;7;4;11;2;4;6
109;19.09.2014;2014;09;21;Perjantai;8;14;22;0;3;3
109;19.09.2014;2014;09;22;Perjantai;2;5;7;5;3;8
109;19.09.2014;2014;09;23;Perjantai;1;9;10;2;1;3
109;20.09.2014;2014;09;00;Lauantai;1;0;1;0;0;0
109;20.09.2014;2014;09;01;Lauantai;3;0;3;0;0;0
109;20.09.2014;2014;09;02;Lauantai;4;0;4;0;0;0
109;20.09.2014;2014;09;03;Lauantai;1;0;1;0;0;0
109;20.09.2014;2014;09;04;Lauantai;3;2;5;0;0;0
109;20.09.2014;2014;09;05;Lauantai;1;0;1;1;0;1
109;20.09.2014;2014;09;06;Lauantai;3;6;9;0;0;0
109;20.09.2014;2014;09;07;Lauantai;2;4;6;1;2;3
109;20.09.2014;2014;09;08;Lauantai;0;4;4;0;2;2
109;20.09.2014;2014;09;09;Lauantai;3;11;14;1;4;5
109;20.09.2014;2014;09;10;Lauantai;8;7;15;2;2;4
109;20.09.2014;2014;09;11;Lauantai;10;6;16;2;3;5
109;20.09.2014;2014;09;12;Lauantai;8;15;23;1;5;6
109;20.09.2014;2014;09;13;Lauantai;11;20;31;3;3;6
109;20.09.2014;2014;09;14;Lauantai;15;14;29;2;5;7
109;20.09.2014;2014;09;15;Lauantai;11;21;32;5;7;12
109;20.09.2014;2014;09;16;Lauantai;18;13;31;4;3;7
109;20.09.2014;2014;09;17;Lauantai;13;14;27;7;9;16
109;20.09.2014;2014;09;18;Lauantai;10;21;31;7;10;17
109;20.09.2014;2014;09;19;Lauantai;3;14;17;2;4;6
109;20.09.2014;2014;09;20;Lauantai;5;11;16;2;3;5
109;20.09.2014;2014;09;21;Lauantai;10;11;21;0;0;0
109;20.09.2014;2014;09;22;Lauantai;0;4;4;1;0;1
109;20.09.2014;2014;09;23;Lauantai;4;4;8;0;1;1
109;21.09.2014;2014;09;00;Sunnuntai;0;2;2;0;0;0
109;21.09.2014;2014;09;01;Sunnuntai;0;0;0;0;0;0
109;21.09.2014;2014;09;02;Sunnuntai;2;0;2;0;0;0
109;21.09.2014;2014;09;03;Sunnuntai;1;0;1;0;0;0
109;21.09.2014;2014;09;04;Sunnuntai;1;0;1;0;0;0
109;21.09.2014;2014;09;05;Sunnuntai;2;1;3;3;0;3
109;21.09.2014;2014;09;06;Sunnuntai;1;5;6;0;2;2
109;21.09.2014;2014;09;07;Sunnuntai;1;2;3;1;0;1
109;21.09.2014;2014;09;08;Sunnuntai;2;2;4;3;1;4
109;21.09.2014;2014;09;09;Sunnuntai;2;6;8;0;1;1
109;21.09.2014;2014;09;10;Sunnuntai;5;5;10;4;2;6
109;21.09.2014;2014;09;11;Sunnuntai;3;2;5;4;1;5
109;21.09.2014;2014;09;12;Sunnuntai;6;24;30;1;4;5
109;21.09.2014;2014;09;13;Sunnuntai;11;7;18;1;4;5
109;21.09.2014;2014;09;14;Sunnuntai;11;12;23;0;4;4
109;21.09.2014;2014;09;15;Sunnuntai;8;19;27;3;7;10
109;21.09.2014;2014;09;16;Sunnuntai;12;20;32;2;2;4
109;21.09.2014;2014;09;17;Sunnuntai;9;9;18;4;1;5
109;21.09.2014;2014;09;18;Sunnuntai;10;15;25;5;4;9
109;21.09.2014;2014;09;19;Sunnuntai;8;6;14;2;4;6
109;21.09.2014;2014;09;20;Sunnuntai;7;7;14;2;5;7
109;21.09.2014;2014;09;21;Sunnuntai;9;6;15;1;1;2
109;21.09.2014;2014;09;22;Sunnuntai;2;3;5;0;0;0
109;21.09.2014;2014;09;23;Sunnuntai;2;2;4;0;1;1
109;22.09.2014;2014;09;00;Maanantai;0;1;1;0;0;0
109;22.09.2014;2014;09;01;Maanantai;0;1;1;2;0;2
109;22.09.2014;2014;09;02;Maanantai;0;0;0;0;0;0
109;22.09.2014;2014;09;03;Maanantai;0;0;0;0;0;0
109;22.09.2014;2014;09;04;Maanantai;0;1;1;0;0;0
109;22.09.2014;2014;09;05;Maanantai;9;2;11;1;0;1
109;22.09.2014;2014;09;06;Maanantai;15;32;47;1;2;3
109;22.09.2014;2014;09;07;Maanantai;31;79;110;5;7;12
109;22.09.2014;2014;09;08;Maanantai;32;78;110;3;6;9
109;22.09.2014;2014;09;09;Maanantai;9;32;41;3;0;3
109;22.09.2014;2014;09;10;Maanantai;7;16;23;4;1;5
109;22.09.2014;2014;09;11;Maanantai;12;13;25;0;3;3
109;22.09.2014;2014;09;12;Maanantai;13;17;30;1;4;5
109;22.09.2014;2014;09;13;Maanantai;21;14;35;3;0;3
109;22.09.2014;2014;09;14;Maanantai;28;17;45;3;1;4
109;22.09.2014;2014;09;15;Maanantai;57;32;89;2;1;3
109;22.09.2014;2014;09;16;Maanantai;66;59;125;5;2;7
109;22.09.2014;2014;09;17;Maanantai;27;31;58;2;2;4
109;22.09.2014;2014;09;18;Maanantai;14;26;40;3;6;9
109;22.09.2014;2014;09;19;Maanantai;15;15;30;3;6;9
109;22.09.2014;2014;09;20;Maanantai;6;15;21;3;6;9
109;22.09.2014;2014;09;21;Maanantai;11;10;21;2;3;5
109;22.09.2014;2014;09;22;Maanantai;4;4;8;2;1;3
109;22.09.2014;2014;09;23;Maanantai;2;2;4;0;2;2
109;23.09.2014;2014;09;00;Tiistai;1;0;1;0;0;0
109;23.09.2014;2014;09;01;Tiistai;0;0;0;2;0;2
109;23.09.2014;2014;09;02;Tiistai;0;0;0;0;0;0
109;23.09.2014;2014;09;03;Tiistai;0;0;0;0;0;0
109;23.09.2014;2014;09;04;Tiistai;2;0;2;0;0;0
109;23.09.2014;2014;09;05;Tiistai;4;8;12;1;1;2
109;23.09.2014;2014;09;06;Tiistai;13;36;49;1;1;2
109;23.09.2014;2014;09;07;Tiistai;41;79;120;3;3;6
109;23.09.2014;2014;09;08;Tiistai;25;66;91;5;0;5
109;23.09.2014;2014;09;09;Tiistai;8;21;29;4;1;5
109;23.09.2014;2014;09;10;Tiistai;12;10;22;6;4;10
109;23.09.2014;2014;09;11;Tiistai;10;13;23;4;1;5
109;23.09.2014;2014;09;12;Tiistai;11;17;28;0;4;4
109;23.09.2014;2014;09;13;Tiistai;13;21;34;0;4;4
109;23.09.2014;2014;09;14;Tiistai;22;28;50;0;2;2
109;23.09.2014;2014;09;15;Tiistai;36;27;63;2;3;5
109;23.09.2014;2014;09;16;Tiistai;65;59;124;11;8;19
109;23.09.2014;2014;09;17;Tiistai;26;29;55;4;4;8
109;23.09.2014;2014;09;18;Tiistai;14;26;40;4;4;8
109;23.09.2014;2014;09;19;Tiistai;9;13;22;9;1;10
109;23.09.2014;2014;09;20;Tiistai;7;13;20;3;0;3
109;23.09.2014;2014;09;21;Tiistai;7;8;15;2;4;6
109;23.09.2014;2014;09;22;Tiistai;1;6;7;1;0;1
109;23.09.2014;2014;09;23;Tiistai;1;2;3;0;1;1
109;24.09.2014;2014;09;00;Keskiviikko;0;0;0;0;0;0
109;24.09.2014;2014;09;01;Keskiviikko;0;0;0;0;0;0
109;24.09.2014;2014;09;02;Keskiviikko;0;0;0;0;0;0
109;24.09.2014;2014;09;03;Keskiviikko;0;0;0;2;0;2
109;24.09.2014;2014;09;04;Keskiviikko;0;1;1;0;0;0
109;24.09.2014;2014;09;05;Keskiviikko;7;5;12;1;1;2
109;24.09.2014;2014;09;06;Keskiviikko;12;19;31;0;0;0
109;24.09.2014;2014;09;07;Keskiviikko;25;59;84;1;7;8
109;24.09.2014;2014;09;08;Keskiviikko;23;63;86;3;3;6
109;24.09.2014;2014;09;09;Keskiviikko;9;10;19;3;4;7
109;24.09.2014;2014;09;10;Keskiviikko;12;11;23;1;1;2
109;24.09.2014;2014;09;11;Keskiviikko;4;14;18;3;3;6
109;24.09.2014;2014;09;12;Keskiviikko;4;10;14;3;3;6
109;24.09.2014;2014;09;13;Keskiviikko;8;11;19;2;1;3
109;24.09.2014;2014;09;14;Keskiviikko;19;19;38;2;4;6
109;24.09.2014;2014;09;15;Keskiviikko;26;38;64;0;5;5
109;24.09.2014;2014;09;16;Keskiviikko;47;50;97;5;3;8
109;24.09.2014;2014;09;17;Keskiviikko;25;27;52;3;5;8
109;24.09.2014;2014;09;18;Keskiviikko;10;14;24;0;1;1
109;24.09.2014;2014;09;19;Keskiviikko;9;10;19;4;1;5
109;24.09.2014;2014;09;20;Keskiviikko;9;7;16;2;2;4
109;24.09.2014;2014;09;21;Keskiviikko;3;5;8;0;0;0
109;24.09.2014;2014;09;22;Keskiviikko;6;2;8;1;0;1
109;24.09.2014;2014;09;23;Keskiviikko;3;1;4;0;1;1
109;25.09.2014;2014;09;00;Torstai;0;1;1;0;0;0
109;25.09.2014;2014;09;01;Torstai;1;0;1;1;1;2
109;25.09.2014;2014;09;02;Torstai;0;0;0;0;0;0
109;25.09.2014;2014;09;03;Torstai;0;0;0;0;0;0
109;25.09.2014;2014;09;04;Torstai;1;0;1;1;0;1
109;25.09.2014;2014;09;05;Torstai;7;2;9;1;0;1
109;25.09.2014;2014;09;06;Torstai;10;30;40;1;2;3
109;25.09.2014;2014;09;07;Torstai;34;58;92;4;5;9
109;25.09.2014;2014;09;08;Torstai;20;52;72;4;2;6
109;25.09.2014;2014;09;09;Torstai;4;17;21;2;2;4
109;25.09.2014;2014;09;10;Torstai;9;15;24;2;1;3
109;25.09.2014;2014;09;11;Torstai;8;14;22;7;3;10
109;25.09.2014;2014;09;12;Torstai;12;17;29;1;4;5
109;25.09.2014;2014;09;13;Torstai;14;13;27;2;4;6
109;25.09.2014;2014;09;14;Torstai;13;23;36;1;4;5
109;25.09.2014;2014;09;15;Torstai;39;26;65;5;3;8
109;25.09.2014;2014;09;16;Torstai;56;35;91;5;4;9
109;25.09.2014;2014;09;17;Torstai;13;31;44;4;5;9
109;25.09.2014;2014;09;18;Torstai;10;22;32;4;4;8
109;25.09.2014;2014;09;19;Torstai;15;10;25;2;9;11
109;25.09.2014;2014;09;20;Torstai;9;12;21;5;7;12
109;25.09.2014;2014;09;21;Torstai;9;15;24;3;1;4
109;25.09.2014;2014;09;22;Torstai;4;8;12;0;0;0
109;25.09.2014;2014;09;23;Torstai;1;3;4;2;0;2
109;26.09.2014;2014;09;00;Perjantai;0;0;0;2;0;2
109;26.09.2014;2014;09;01;Perjantai;0;1;1;0;1;1
109;26.09.2014;2014;09;02;Perjantai;0;0;0;1;0;1
109;26.09.2014;2014;09;03;Perjantai;0;0;0;0;0;0
109;26.09.2014;2014;09;04;Perjantai;0;0;0;0;0;0
109;26.09.2014;2014;09;05;Perjantai;4;3;7;1;0;1
109;26.09.2014;2014;09;06;Perjantai;13;24;37;0;3;3
109;26.09.2014;2014;09;07;Perjantai;27;54;81;3;4;7
109;26.09.2014;2014;09;08;Perjantai;18;50;68;5;4;9
109;26.09.2014;2014;09;09;Perjantai;12;16;28;3;0;3
109;26.09.2014;2014;09;10;Perjantai;4;9;13;4;1;5
109;26.09.2014;2014;09;11;Perjantai;4;16;20;1;4;5
109;26.09.2014;2014;09;12;Perjantai;10;15;25;4;2;6
109;26.09.2014;2014;09;13;Perjantai;26;9;35;0;1;1
109;26.09.2014;2014;09;14;Perjantai;26;22;48;3;5;8
109;26.09.2014;2014;09;15;Perjantai;40;30;70;4;3;7
109;26.09.2014;2014;09;16;Perjantai;46;35;81;5;2;7
109;26.09.2014;2014;09;17;Perjantai;15;25;40;0;4;4
109;26.09.2014;2014;09;18;Perjantai;15;12;27;2;3;5
109;26.09.2014;2014;09;19;Perjantai;6;3;9;5;2;7
109;26.09.2014;2014;09;20;Perjantai;3;1;4;2;3;5
109;26.09.2014;2014;09;21;Perjantai;5;4;9;2;1;3
109;26.09.2014;2014;09;22;Perjantai;7;2;9;2;1;3
109;26.09.2014;2014;09;23;Perjantai;0;2;2;1;1;2
109;27.09.2014;2014;09;00;Lauantai;0;1;1;0;0;0
109;27.09.2014;2014;09;01;Lauantai;0;1;1;0;0;0
109;27.09.2014;2014;09;02;Lauantai;2;0;2;0;0;0
109;27.09.2014;2014;09;03;Lauantai;0;0;0;0;0;0
109;27.09.2014;2014;09;04;Lauantai;4;1;5;0;0;0
109;27.09.2014;2014;09;05;Lauantai;1;1;2;1;0;1
109;27.09.2014;2014;09;06;Lauantai;0;4;4;0;0;0
109;27.09.2014;2014;09;07;Lauantai;2;3;5;1;1;2
109;27.09.2014;2014;09;08;Lauantai;2;6;8;2;3;5
109;27.09.2014;2014;09;09;Lauantai;6;8;14;6;1;7
109;27.09.2014;2014;09;10;Lauantai;2;8;10;3;6;9
109;27.09.2014;2014;09;11;Lauantai;4;8;12;1;3;4
109;27.09.2014;2014;09;12;Lauantai;10;15;25;1;1;2
109;27.09.2014;2014;09;13;Lauantai;10;6;16;1;3;4
109;27.09.2014;2014;09;14;Lauantai;6;7;13;4;2;6
109;27.09.2014;2014;09;15;Lauantai;4;6;10;2;5;7
109;27.09.2014;2014;09;16;Lauantai;6;2;8;2;7;9
109;27.09.2014;2014;09;17;Lauantai;4;4;8;3;5;8
109;27.09.2014;2014;09;18;Lauantai;4;5;9;2;3;5
109;27.09.2014;2014;09;19;Lauantai;3;17;20;0;5;5
109;27.09.2014;2014;09;20;Lauantai;5;1;6;1;4;5
109;27.09.2014;2014;09;21;Lauantai;5;5;10;3;0;3
109;27.09.2014;2014;09;22;Lauantai;8;3;11;1;0;1
109;27.09.2014;2014;09;23;Lauantai;2;4;6;0;0;0
109;28.09.2014;2014;09;00;Sunnuntai;1;0;1;0;1;1
109;28.09.2014;2014;09;01;Sunnuntai;0;0;0;0;0;0
109;28.09.2014;2014;09;02;Sunnuntai;1;0;1;0;2;2
109;28.09.2014;2014;09;03;Sunnuntai;2;0;2;1;0;1
109;28.09.2014;2014;09;04;Sunnuntai;0;0;0;0;0;0
109;28.09.2014;2014;09;05;Sunnuntai;0;1;1;1;0;1
109;28.09.2014;2014;09;06;Sunnuntai;0;4;4;0;1;1
109;28.09.2014;2014;09;07;Sunnuntai;2;2;4;4;1;5
109;28.09.2014;2014;09;08;Sunnuntai;0;2;2;1;0;1
109;28.09.2014;2014;09;09;Sunnuntai;2;10;12;7;3;10
109;28.09.2014;2014;09;10;Sunnuntai;5;8;13;6;8;14
109;28.09.2014;2014;09;11;Sunnuntai;13;9;22;5;3;8
109;28.09.2014;2014;09;12;Sunnuntai;8;10;18;5;5;10
109;28.09.2014;2014;09;13;Sunnuntai;10;14;24;0;8;8
109;28.09.2014;2014;09;14;Sunnuntai;15;5;20;7;8;15
109;28.09.2014;2014;09;15;Sunnuntai;6;14;20;3;7;10
109;28.09.2014;2014;09;16;Sunnuntai;11;10;21;1;2;3
109;28.09.2014;2014;09;17;Sunnuntai;11;15;26;2;7;9
109;28.09.2014;2014;09;18;Sunnuntai;10;11;21;11;7;18
109;28.09.2014;2014;09;19;Sunnuntai;4;6;10;3;4;7
109;28.09.2014;2014;09;20;Sunnuntai;7;3;10;4;3;7
109;28.09.2014;2014;09;21;Sunnuntai;5;3;8;1;1;2
109;28.09.2014;2014;09;22;Sunnuntai;2;2;4;0;1;1
109;28.09.2014;2014;09;23;Sunnuntai;0;1;1;0;0;0
109;29.09.2014;2014;09;00;Maanantai;0;0;0;0;2;2
109;29.09.2014;2014;09;01;Maanantai;0;0;0;0;0;0
109;29.09.2014;2014;09;02;Maanantai;1;0;1;1;0;1
109;29.09.2014;2014;09;03;Maanantai;0;0;0;0;0;0
109;29.09.2014;2014;09;04;Maanantai;1;1;2;0;0;0
109;29.09.2014;2014;09;05;Maanantai;2;3;5;3;0;3
109;29.09.2014;2014;09;06;Maanantai;8;36;44;2;1;3
109;29.09.2014;2014;09;07;Maanantai;42;81;123;1;8;9
109;29.09.2014;2014;09;08;Maanantai;22;77;99;3;0;3
109;29.09.2014;2014;09;09;Maanantai;10;27;37;3;4;7
109;29.09.2014;2014;09;10;Maanantai;17;10;27;6;1;7
109;29.09.2014;2014;09;11;Maanantai;9;17;26;0;2;2
109;29.09.2014;2014;09;12;Maanantai;7;20;27;1;6;7
109;29.09.2014;2014;09;13;Maanantai;19;22;41;2;7;9
109;29.09.2014;2014;09;14;Maanantai;20;20;40;1;1;2
109;29.09.2014;2014;09;15;Maanantai;43;34;77;2;4;6
109;29.09.2014;2014;09;16;Maanantai;67;57;124;6;1;7
109;29.09.2014;2014;09;17;Maanantai;27;33;60;3;6;9
109;29.09.2014;2014;09;18;Maanantai;23;19;42;2;5;7
109;29.09.2014;2014;09;19;Maanantai;18;15;33;3;1;4
109;29.09.2014;2014;09;20;Maanantai;7;13;20;5;13;18
109;29.09.2014;2014;09;21;Maanantai;9;11;20;3;2;5
109;29.09.2014;2014;09;22;Maanantai;2;10;12;1;1;2
109;29.09.2014;2014;09;23;Maanantai;0;2;2;0;1;1
109;30.09.2014;2014;09;00;Tiistai;1;2;3;0;1;1
109;30.09.2014;2014;09;01;Tiistai;0;0;0;0;0;0
109;30.09.2014;2014;09;02;Tiistai;1;0;1;2;1;3
109;30.09.2014;2014;09;03;Tiistai;0;0;0;0;0;0
109;30.09.2014;2014;09;04;Tiistai;0;1;1;0;0;0
109;30.09.2014;2014;09;05;Tiistai;1;3;4;2;2;4
109;30.09.2014;2014;09;06;Tiistai;18;26;44;0;0;0
109;30.09.2014;2014;09;07;Tiistai;35;95;130;2;6;8
109;30.09.2014;2014;09;08;Tiistai;17;66;83;2;4;6
109;30.09.2014;2014;09;09;Tiistai;11;26;37;0;2;2
109;30.09.2014;2014;09;10;Tiistai;8;10;18;2;3;5
109;30.09.2014;2014;09;11;Tiistai;13;10;23;2;6;8
109;30.09.2014;2014;09;12;Tiistai;15;8;23;2;5;7
109;30.09.2014;2014;09;13;Tiistai;15;9;24;1;2;3
109;30.09.2014;2014;09;14;Tiistai;24;23;47;5;2;7
109;30.09.2014;2014;09;15;Tiistai;41;42;83;4;6;10
109;30.09.2014;2014;09;16;Tiistai;61;47;108;3;1;4
109;30.09.2014;2014;09;17;Tiistai;39;42;81;4;8;12
109;30.09.2014;2014;09;18;Tiistai;18;24;42;5;7;12
109;30.09.2014;2014;09;19;Tiistai;10;16;26;8;6;14
109;30.09.2014;2014;09;20;Tiistai;19;13;32;8;5;13
109;30.09.2014;2014;09;21;Tiistai;7;5;12;0;3;3
109;30.09.2014;2014;09;22;Tiistai;3;7;10;1;0;1
109;30.09.2014;2014;09;23;Tiistai;1;1;2;0;0;0
109;01.10.2014;2014;10;00;Keskiviikko;0;0;0;0;0;0
109;01.10.2014;2014;10;01;Keskiviikko;0;0;0;0;0;0
109;01.10.2014;2014;10;02;Keskiviikko;1;1;2;0;0;0
109;01.10.2014;2014;10;03;Keskiviikko;0;0;0;0;0;0
109;01.10.2014;2014;10;04;Keskiviikko;2;3;5;0;0;0
109;01.10.2014;2014;10;05;Keskiviikko;2;2;4;2;0;2
109;01.10.2014;2014;10;06;Keskiviikko;16;31;47;1;1;2
109;01.10.2014;2014;10;07;Keskiviikko;34;88;122;5;3;8
109;01.10.2014;2014;10;08;Keskiviikko;30;73;103;4;3;7
109;01.10.2014;2014;10;09;Keskiviikko;8;29;37;3;0;3
109;01.10.2014;2014;10;10;Keskiviikko;11;10;21;3;4;7
109;01.10.2014;2014;10;11;Keskiviikko;13;10;23;4;6;10
109;01.10.2014;2014;10;12;Keskiviikko;11;24;35;3;1;4
109;01.10.2014;2014;10;13;Keskiviikko;21;19;40;4;6;10
109;01.10.2014;2014;10;14;Keskiviikko;28;15;43;5;4;9
109;01.10.2014;2014;10;15;Keskiviikko;50;36;86;5;1;6
109;01.10.2014;2014;10;16;Keskiviikko;66;61;127;1;7;8
109;01.10.2014;2014;10;17;Keskiviikko;25;28;53;4;4;8
109;01.10.2014;2014;10;18;Keskiviikko;22;28;50;4;3;7
109;01.10.2014;2014;10;19;Keskiviikko;11;23;34;6;6;12
109;01.10.2014;2014;10;20;Keskiviikko;10;5;15;6;1;7
109;01.10.2014;2014;10;21;Keskiviikko;11;5;16;2;3;5
109;01.10.2014;2014;10;22;Keskiviikko;3;8;11;1;0;1
109;01.10.2014;2014;10;23;Keskiviikko;1;2;3;0;0;0
109;02.10.2014;2014;10;00;Torstai;1;1;2;1;0;1
109;02.10.2014;2014;10;01;Torstai;0;0;0;2;2;4
109;02.10.2014;2014;10;02;Torstai;1;0;1;0;0;0
109;02.10.2014;2014;10;03;Torstai;0;3;3;0;0;0
109;02.10.2014;2014;10;04;Torstai;5;2;7;0;0;0
109;02.10.2014;2014;10;05;Torstai;7;4;11;1;0;1
109;02.10.2014;2014;10;06;Torstai;13;22;35;0;3;3
109;02.10.2014;2014;10;07;Torstai;34;64;98;2;3;5
109;02.10.2014;2014;10;08;Torstai;22;62;84;3;4;7
109;02.10.2014;2014;10;09;Torstai;9;26;35;2;3;5
109;02.10.2014;2014;10;10;Torstai;7;14;21;1;4;5
109;02.10.2014;2014;10;11;Torstai;7;8;15;2;4;6
109;02.10.2014;2014;10;12;Torstai;8;8;16;3;2;5
109;02.10.2014;2014;10;13;Torstai;13;11;24;2;0;2
109;02.10.2014;2014;10;14;Torstai;15;18;33;0;2;2
109;02.10.2014;2014;10;15;Torstai;31;26;57;2;3;5
109;02.10.2014;2014;10;16;Torstai;59;42;101;1;5;6
109;02.10.2014;2014;10;17;Torstai;32;31;63;2;4;6
109;02.10.2014;2014;10;18;Torstai;17;18;35;3;13;16
109;02.10.2014;2014;10;19;Torstai;14;14;28;5;7;12
109;02.10.2014;2014;10;20;Torstai;11;7;18;3;3;6
109;02.10.2014;2014;10;21;Torstai;12;10;22;1;3;4
109;02.10.2014;2014;10;22;Torstai;4;8;12;1;3;4
109;02.10.2014;2014;10;23;Torstai;1;1;2;0;0;0
109;03.10.2014;2014;10;00;Perjantai;0;1;1;0;0;0
109;03.10.2014;2014;10;01;Perjantai;0;0;0;2;0;2
109;03.10.2014;2014;10;02;Perjantai;0;1;1;1;0;1
109;03.10.2014;2014;10;03;Perjantai;0;0;0;0;0;0
109;03.10.2014;2014;10;04;Perjantai;2;0;2;0;0;0
109;03.10.2014;2014;10;05;Perjantai;2;4;6;1;0;1
109;03.10.2014;2014;10;06;Perjantai;16;20;36;1;0;1
109;03.10.2014;2014;10;07;Perjantai;23;60;83;4;2;6
109;03.10.2014;2014;10;08;Perjantai;29;49;78;3;2;5
109;03.10.2014;2014;10;09;Perjantai;9;23;32;2;5;7
109;03.10.2014;2014;10;10;Perjantai;7;12;19;0;0;0
109;03.10.2014;2014;10;11;Perjantai;12;15;27;2;2;4
109;03.10.2014;2014;10;12;Perjantai;15;23;38;1;4;5
109;03.10.2014;2014;10;13;Perjantai;20;17;37;3;6;9
109;03.10.2014;2014;10;14;Perjantai;33;23;56;3;2;5
109;03.10.2014;2014;10;15;Perjantai;38;32;70;0;2;2
109;03.10.2014;2014;10;16;Perjantai;33;36;69;4;4;8
109;03.10.2014;2014;10;17;Perjantai;18;25;43;1;5;6
109;03.10.2014;2014;10;18;Perjantai;19;13;32;1;4;5
109;03.10.2014;2014;10;19;Perjantai;4;9;13;4;5;9
109;03.10.2014;2014;10;20;Perjantai;15;4;19;3;4;7
109;03.10.2014;2014;10;21;Perjantai;8;10;18;4;0;4
109;03.10.2014;2014;10;22;Perjantai;6;8;14;0;0;0
109;03.10.2014;2014;10;23;Perjantai;0;4;4;1;0;1
109;04.10.2014;2014;10;00;Lauantai;1;1;2;1;0;1
109;04.10.2014;2014;10;01;Lauantai;3;1;4;2;0;2
109;04.10.2014;2014;10;02;Lauantai;3;1;4;0;0;0
109;04.10.2014;2014;10;03;Lauantai;0;0;0;0;0;0
109;04.10.2014;2014;10;04;Lauantai;1;0;1;0;0;0
109;04.10.2014;2014;10;05;Lauantai;2;2;4;1;0;1
109;04.10.2014;2014;10;06;Lauantai;1;3;4;0;1;1
109;04.10.2014;2014;10;07;Lauantai;3;4;7;2;2;4
109;04.10.2014;2014;10;08;Lauantai;5;2;7;1;0;1
109;04.10.2014;2014;10;09;Lauantai;2;8;10;6;7;13
109;04.10.2014;2014;10;10;Lauantai;3;12;15;6;5;11
109;04.10.2014;2014;10;11;Lauantai;9;13;22;3;5;8
109;04.10.2014;2014;10;12;Lauantai;8;9;17;5;5;10
109;04.10.2014;2014;10;13;Lauantai;17;14;31;3;6;9
109;04.10.2014;2014;10;14;Lauantai;11;16;27;9;0;9
109;04.10.2014;2014;10;15;Lauantai;11;9;20;4;5;9
109;04.10.2014;2014;10;16;Lauantai;16;12;28;1;2;3
109;04.10.2014;2014;10;17;Lauantai;7;12;19;4;4;8
109;04.10.2014;2014;10;18;Lauantai;5;19;24;1;4;5
109;04.10.2014;2014;10;19;Lauantai;6;8;14;2;6;8
109;04.10.2014;2014;10;20;Lauantai;5;8;13;3;2;5
109;04.10.2014;2014;10;21;Lauantai;2;10;12;3;3;6
109;04.10.2014;2014;10;22;Lauantai;7;7;14;5;2;7
109;04.10.2014;2014;10;23;Lauantai;5;0;5;0;1;1
109;05.10.2014;2014;10;00;Sunnuntai;5;2;7;1;1;2
109;05.10.2014;2014;10;01;Sunnuntai;0;0;0;0;0;0
109;05.10.2014;2014;10;02;Sunnuntai;1;2;3;0;0;0
109;05.10.2014;2014;10;03;Sunnuntai;1;0;1;0;0;0
109;05.10.2014;2014;10;04;Sunnuntai;2;0;2;0;0;0
109;05.10.2014;2014;10;05;Sunnuntai;0;1;1;1;1;2
109;05.10.2014;2014;10;06;Sunnuntai;1;2;3;0;0;0
109;05.10.2014;2014;10;07;Sunnuntai;2;4;6;1;3;4
109;05.10.2014;2014;10;08;Sunnuntai;2;3;5;1;1;2
109;05.10.2014;2014;10;09;Sunnuntai;1;13;14;5;7;12
109;05.10.2014;2014;10;10;Sunnuntai;4;7;11;3;0;3
109;05.10.2014;2014;10;11;Sunnuntai;11;10;21;4;7;11
109;05.10.2014;2014;10;12;Sunnuntai;7;9;16;4;6;10
109;05.10.2014;2014;10;13;Sunnuntai;14;16;30;4;2;6
109;05.10.2014;2014;10;14;Sunnuntai;12;10;22;4;3;7
109;05.10.2014;2014;10;15;Sunnuntai;12;5;17;3;5;8
109;05.10.2014;2014;10;16;Sunnuntai;16;14;30;4;5;9
109;05.10.2014;2014;10;17;Sunnuntai;8;15;23;4;13;17
109;05.10.2014;2014;10;18;Sunnuntai;7;18;25;7;5;12
109;05.10.2014;2014;10;19;Sunnuntai;5;12;17;2;8;10
109;05.10.2014;2014;10;20;Sunnuntai;5;3;8;3;3;6
109;05.10.2014;2014;10;21;Sunnuntai;6;5;11;1;2;3
109;05.10.2014;2014;10;22;Sunnuntai;3;1;4;3;1;4
109;05.10.2014;2014;10;23;Sunnuntai;2;0;2;0;1;1
109;06.10.2014;2014;10;00;Maanantai;0;0;0;1;0;1
109;06.10.2014;2014;10;01;Maanantai;0;0;0;0;0;0
109;06.10.2014;2014;10;02;Maanantai;0;0;0;0;0;0
109;06.10.2014;2014;10;03;Maanantai;0;0;0;0;0;0
109;06.10.2014;2014;10;04;Maanantai;1;1;2;0;0;0
109;06.10.2014;2014;10;05;Maanantai;3;6;9;3;0;3
109;06.10.2014;2014;10;06;Maanantai;14;32;46;1;1;2
109;06.10.2014;2014;10;07;Maanantai;35;75;110;4;2;6
109;06.10.2014;2014;10;08;Maanantai;28;66;94;4;3;7
109;06.10.2014;2014;10;09;Maanantai;10;23;33;1;1;2
109;06.10.2014;2014;10;10;Maanantai;11;20;31;0;4;4
109;06.10.2014;2014;10;11;Maanantai;2;14;16;2;3;5
109;06.10.2014;2014;10;12;Maanantai;13;15;28;2;2;4
109;06.10.2014;2014;10;13;Maanantai;10;16;26;1;3;4
109;06.10.2014;2014;10;14;Maanantai;30;17;47;4;1;5
109;06.10.2014;2014;10;15;Maanantai;34;29;63;7;4;11
109;06.10.2014;2014;10;16;Maanantai;71;49;120;7;4;11
109;06.10.2014;2014;10;17;Maanantai;27;37;64;4;3;7
109;06.10.2014;2014;10;18;Maanantai;18;15;33;6;5;11
109;06.10.2014;2014;10;19;Maanantai;18;11;29;5;12;17
109;06.10.2014;2014;10;20;Maanantai;8;7;15;2;4;6
109;06.10.2014;2014;10;21;Maanantai;5;9;14;0;3;3
109;06.10.2014;2014;10;22;Maanantai;2;8;10;2;0;2
109;06.10.2014;2014;10;23;Maanantai;2;1;3;1;0;1
109;07.10.2014;2014;10;00;Tiistai;2;0;2;0;1;1
109;07.10.2014;2014;10;01;Tiistai;0;0;0;2;0;2
109;07.10.2014;2014;10;02;Tiistai;0;0;0;0;0;0
109;07.10.2014;2014;10;03;Tiistai;0;0;0;0;0;0
109;07.10.2014;2014;10;04;Tiistai;2;2;4;0;0;0
109;07.10.2014;2014;10;05;Tiistai;3;6;9;3;0;3
109;07.10.2014;2014;10;06;Tiistai;12;37;49;2;2;4
109;07.10.2014;2014;10;07;Tiistai;32;84;116;5;3;8
109;07.10.2014;2014;10;08;Tiistai;22;80;102;5;1;6
109;07.10.2014;2014;10;09;Tiistai;8;22;30;5;1;6
109;07.10.2014;2014;10;10;Tiistai;8;11;19;3;3;6
109;07.10.2014;2014;10;11;Tiistai;8;12;20;2;4;6
109;07.10.2014;2014;10;12;Tiistai;21;15;36;1;6;7
109;07.10.2014;2014;10;13;Tiistai;22;12;34;1;5;6
109;07.10.2014;2014;10;14;Tiistai;28;22;50;5;7;12
109;07.10.2014;2014;10;15;Tiistai;53;39;92;0;5;5
109;07.10.2014;2014;10;16;Tiistai;67;55;122;8;4;12
109;07.10.2014;2014;10;17;Tiistai;30;28;58;5;8;13
109;07.10.2014;2014;10;18;Tiistai;27;15;42;5;6;11
109;07.10.2014;2014;10;19;Tiistai;13;16;29;3;10;13
109;07.10.2014;2014;10;20;Tiistai;10;11;21;5;3;8
109;07.10.2014;2014;10;21;Tiistai;9;6;15;2;1;3
109;07.10.2014;2014;10;22;Tiistai;6;9;15;2;1;3
109;07.10.2014;2014;10;23;Tiistai;1;1;2;0;0;0
109;08.10.2014;2014;10;00;Keskiviikko;0;0;0;0;0;0
109;08.10.2014;2014;10;01;Keskiviikko;0;0;0;0;0;0
109;08.10.2014;2014;10;02;Keskiviikko;0;1;1;0;0;0
109;08.10.2014;2014;10;03;Keskiviikko;1;0;1;0;0;0
109;08.10.2014;2014;10;04;Keskiviikko;0;0;0;0;0;0
109;08.10.2014;2014;10;05;Keskiviikko;5;7;12;1;0;1
109;08.10.2014;2014;10;06;Keskiviikko;12;38;50;2;2;4
109;08.10.2014;2014;10;07;Keskiviikko;27;76;103;4;6;10
109;08.10.2014;2014;10;08;Keskiviikko;24;55;79;2;7;9
109;08.10.2014;2014;10;09;Keskiviikko;12;19;31;5;4;9
109;08.10.2014;2014;10;10;Keskiviikko;4;15;19;4;3;7
109;08.10.2014;2014;10;11;Keskiviikko;10;21;31;2;4;6
109;08.10.2014;2014;10;12;Keskiviikko;13;13;26;0;2;2
109;08.10.2014;2014;10;13;Keskiviikko;25;11;36;2;2;4
109;08.10.2014;2014;10;14;Keskiviikko;19;19;38;3;3;6
109;08.10.2014;2014;10;15;Keskiviikko;42;22;64;5;2;7
109;08.10.2014;2014;10;16;Keskiviikko;48;56;104;10;20;30
109;08.10.2014;2014;10;17;Keskiviikko;30;25;55;7;9;16
109;08.10.2014;2014;10;18;Keskiviikko;15;15;30;8;11;19
109;08.10.2014;2014;10;19;Keskiviikko;10;13;23;6;7;13
109;08.10.2014;2014;10;20;Keskiviikko;10;10;20;3;3;6
109;08.10.2014;2014;10;21;Keskiviikko;10;5;15;2;0;2
109;08.10.2014;2014;10;22;Keskiviikko;2;3;5;0;1;1
109;08.10.2014;2014;10;23;Keskiviikko;2;2;4;0;0;0
109;09.10.2014;2014;10;00;Torstai;0;0;0;0;1;1
109;09.10.2014;2014;10;01;Torstai;0;0;0;1;0;1
109;09.10.2014;2014;10;02;Torstai;0;0;0;0;0;0
109;09.10.2014;2014;10;03;Torstai;1;0;1;0;0;0
109;09.10.2014;2014;10;04;Torstai;0;1;1;0;0;0
109;09.10.2014;2014;10;05;Torstai;3;9;12;1;0;1
109;09.10.2014;2014;10;06;Torstai;8;16;24;1;2;3
109;09.10.2014;2014;10;07;Torstai;23;69;92;6;6;12
109;09.10.2014;2014;10;08;Torstai;14;48;62;4;2;6
109;09.10.2014;2014;10;09;Torstai;12;18;30;0;3;3
109;09.10.2014;2014;10;10;Torstai;7;5;12;3;3;6
109;09.10.2014;2014;10;11;Torstai;6;10;16;0;0;0
109;09.10.2014;2014;10;12;Torstai;5;10;15;1;10;11
109;09.10.2014;2014;10;13;Torstai;12;4;16;1;1;2
109;09.10.2014;2014;10;14;Torstai;15;16;31;4;4;8
109;09.10.2014;2014;10;15;Torstai;25;22;47;1;3;4
109;09.10.2014;2014;10;16;Torstai;42;28;70;5;5;10
109;09.10.2014;2014;10;17;Torstai;25;23;48;1;6;7
109;09.10.2014;2014;10;18;Torstai;12;13;25;6;1;7
109;09.10.2014;2014;10;19;Torstai;7;4;11;3;2;5
109;09.10.2014;2014;10;20;Torstai;8;8;16;0;1;1
109;09.10.2014;2014;10;21;Torstai;6;3;9;1;0;1
109;09.10.2014;2014;10;22;Torstai;3;3;6;0;0;0
109;09.10.2014;2014;10;23;Torstai;2;1;3;1;0;1
109;10.10.2014;2014;10;00;Perjantai;0;0;0;0;0;0
109;10.10.2014;2014;10;01;Perjantai;0;0;0;1;1;2
109;10.10.2014;2014;10;02;Perjantai;0;0;0;0;1;1
109;10.10.2014;2014;10;03;Perjantai;0;0;0;0;0;0
109;10.10.2014;2014;10;04;Perjantai;1;0;1;0;0;0
109;10.10.2014;2014;10;05;Perjantai;5;4;9;3;0;3
109;10.10.2014;2014;10;06;Perjantai;11;14;25;2;1;3
109;10.10.2014;2014;10;07;Perjantai;22;38;60;3;2;5
109;10.10.2014;2014;10;08;Perjantai;14;23;37;3;2;5
109;10.10.2014;2014;10;09;Perjantai;12;13;25;0;0;0
109;10.10.2014;2014;10;10;Perjantai;2;3;5;1;0;1
109;10.10.2014;2014;10;11;Perjantai;8;8;16;1;0;1
109;10.10.2014;2014;10;12;Perjantai;8;3;11;4;2;6
109;10.10.2014;2014;10;13;Perjantai;8;5;13;2;3;5
109;10.10.2014;2014;10;14;Perjantai;12;9;21;8;6;14
109;10.10.2014;2014;10;15;Perjantai;26;16;42;3;2;5
109;10.10.2014;2014;10;16;Perjantai;26;14;40;0;4;4
109;10.10.2014;2014;10;17;Perjantai;18;8;26;2;2;4
109;10.10.2014;2014;10;18;Perjantai;7;9;16;2;5;7
109;10.10.2014;2014;10;19;Perjantai;3;6;9;1;8;9
109;10.10.2014;2014;10;20;Perjantai;7;2;9;1;0;1
109;10.10.2014;2014;10;21;Perjantai;11;3;14;1;0;1
109;10.10.2014;2014;10;22;Perjantai;2;1;3;1;1;2
109;10.10.2014;2014;10;23;Perjantai;0;1;1;1;0;1
109;11.10.2014;2014;10;00;Lauantai;1;2;3;1;0;1
109;11.10.2014;2014;10;01;Lauantai;2;2;4;2;0;2
109;11.10.2014;2014;10;02;Lauantai;1;0;1;0;0;0
109;11.10.2014;2014;10;03;Lauantai;3;0;3;0;0;0
109;11.10.2014;2014;10;04;Lauantai;0;1;1;1;0;1
109;11.10.2014;2014;10;05;Lauantai;0;0;0;1;0;1
109;11.10.2014;2014;10;06;Lauantai;0;5;5;0;1;1
109;11.10.2014;2014;10;07;Lauantai;2;0;2;2;0;2
109;11.10.2014;2014;10;08;Lauantai;3;8;11;1;0;1
109;11.10.2014;2014;10;09;Lauantai;2;7;9;2;5;7
109;11.10.2014;2014;10;10;Lauantai;1;6;7;7;4;11
109;11.10.2014;2014;10;11;Lauantai;4;12;16;3;4;7
109;11.10.2014;2014;10;12;Lauantai;7;10;17;2;1;3
109;11.10.2014;2014;10;13;Lauantai;2;9;11;2;2;4
109;11.10.2014;2014;10;14;Lauantai;6;19;25;2;2;4
109;11.10.2014;2014;10;15;Lauantai;13;9;22;1;3;4
109;11.10.2014;2014;10;16;Lauantai;11;4;15;8;0;8
109;11.10.2014;2014;10;17;Lauantai;7;3;10;7;3;10
109;11.10.2014;2014;10;18;Lauantai;6;5;11;5;3;8
109;11.10.2014;2014;10;19;Lauantai;5;8;13;0;5;5
109;11.10.2014;2014;10;20;Lauantai;1;2;3;5;0;5
109;11.10.2014;2014;10;21;Lauantai;6;8;14;0;3;3
109;11.10.2014;2014;10;22;Lauantai;1;1;2;1;1;2
109;11.10.2014;2014;10;23;Lauantai;1;0;1;0;1;1
109;12.10.2014;2014;10;00;Sunnuntai;0;3;3;0;0;0
109;12.10.2014;2014;10;01;Sunnuntai;1;0;1;0;0;0
109;12.10.2014;2014;10;02;Sunnuntai;2;0;2;0;0;0
109;12.10.2014;2014;10;03;Sunnuntai;0;0;0;1;1;2
109;12.10.2014;2014;10;04;Sunnuntai;0;1;1;0;0;0
109;12.10.2014;2014;10;05;Sunnuntai;1;0;1;0;0;0
109;12.10.2014;2014;10;06;Sunnuntai;0;3;3;1;0;1
109;12.10.2014;2014;10;07;Sunnuntai;1;4;5;1;4;5
109;12.10.2014;2014;10;08;Sunnuntai;1;1;2;0;2;2
109;12.10.2014;2014;10;09;Sunnuntai;4;2;6;2;4;6
109;12.10.2014;2014;10;10;Sunnuntai;5;6;11;3;4;7
109;12.10.2014;2014;10;11;Sunnuntai;4;7;11;6;5;11
109;12.10.2014;2014;10;12;Sunnuntai;11;15;26;3;2;5
109;12.10.2014;2014;10;13;Sunnuntai;11;14;25;5;6;11
109;12.10.2014;2014;10;14;Sunnuntai;4;8;12;4;5;9
109;12.10.2014;2014;10;15;Sunnuntai;10;12;22;4;4;8
109;12.10.2014;2014;10;16;Sunnuntai;8;11;19;2;3;5
109;12.10.2014;2014;10;17;Sunnuntai;4;12;16;5;6;11
109;12.10.2014;2014;10;18;Sunnuntai;4;3;7;7;8;15
109;12.10.2014;2014;10;19;Sunnuntai;9;6;15;3;4;7
109;12.10.2014;2014;10;20;Sunnuntai;3;6;9;4;4;8
109;12.10.2014;2014;10;21;Sunnuntai;5;3;8;2;4;6
109;12.10.2014;2014;10;22;Sunnuntai;3;1;4;1;0;1
109;12.10.2014;2014;10;23;Sunnuntai;0;1;1;0;1;1
109;13.10.2014;2014;10;00;Maanantai;2;0;2;0;2;2
109;13.10.2014;2014;10;01;Maanantai;0;0;0;0;0;0
109;13.10.2014;2014;10;02;Maanantai;0;0;0;0;0;0
109;13.10.2014;2014;10;03;Maanantai;1;0;1;0;0;0
109;13.10.2014;2014;10;04;Maanantai;1;0;1;0;0;0
109;13.10.2014;2014;10;05;Maanantai;3;3;6;2;0;2
109;13.10.2014;2014;10;06;Maanantai;7;32;39;1;1;2
109;13.10.2014;2014;10;07;Maanantai;30;53;83;2;5;7
109;13.10.2014;2014;10;08;Maanantai;23;70;93;2;7;9
109;13.10.2014;2014;10;09;Maanantai;10;23;33;1;1;2
109;13.10.2014;2014;10;10;Maanantai;6;18;24;3;2;5
109;13.10.2014;2014;10;11;Maanantai;8;9;17;2;2;4
109;13.10.2014;2014;10;12;Maanantai;11;15;26;1;7;8
109;13.10.2014;2014;10;13;Maanantai;19;21;40;3;3;6
109;13.10.2014;2014;10;14;Maanantai;21;12;33;3;3;6
109;13.10.2014;2014;10;15;Maanantai;43;30;73;6;4;10
109;13.10.2014;2014;10;16;Maanantai;61;34;95;6;4;10
109;13.10.2014;2014;10;17;Maanantai;22;25;47;4;4;8
109;13.10.2014;2014;10;18;Maanantai;8;16;24;3;1;4
109;13.10.2014;2014;10;19;Maanantai;11;7;18;2;3;5
109;13.10.2014;2014;10;20;Maanantai;10;3;13;4;3;7
109;13.10.2014;2014;10;21;Maanantai;8;7;15;1;2;3
109;13.10.2014;2014;10;22;Maanantai;1;4;5;4;3;7
109;13.10.2014;2014;10;23;Maanantai;0;3;3;0;0;0
109;14.10.2014;2014;10;00;Tiistai;0;2;2;3;2;5
109;14.10.2014;2014;10;01;Tiistai;0;0;0;0;0;0
109;14.10.2014;2014;10;02;Tiistai;0;0;0;1;0;1
109;14.10.2014;2014;10;03;Tiistai;0;0;0;0;0;0
109;14.10.2014;2014;10;04;Tiistai;0;2;2;1;0;1
109;14.10.2014;2014;10;05;Tiistai;2;5;7;0;1;1
109;14.10.2014;2014;10;06;Tiistai;15;23;38;0;2;2
109;14.10.2014;2014;10;07;Tiistai;29;66;95;3;1;4
109;14.10.2014;2014;10;08;Tiistai;24;61;85;4;3;7
109;14.10.2014;2014;10;09;Tiistai;5;17;22;5;3;8
109;14.10.2014;2014;10;10;Tiistai;7;12;19;3;1;4
109;14.10.2014;2014;10;11;Tiistai;7;12;19;0;1;1
109;14.10.2014;2014;10;12;Tiistai;9;17;26;2;3;5
109;14.10.2014;2014;10;13;Tiistai;14;13;27;8;3;11
109;14.10.2014;2014;10;14;Tiistai;31;10;41;3;1;4
109;14.10.2014;2014;10;15;Tiistai;38;40;78;6;3;9
109;14.10.2014;2014;10;16;Tiistai;52;61;113;7;7;14
109;14.10.2014;2014;10;17;Tiistai;30;21;51;3;4;7
109;14.10.2014;2014;10;18;Tiistai;20;26;46;5;3;8
109;14.10.2014;2014;10;19;Tiistai;11;6;17;4;7;11
109;14.10.2014;2014;10;20;Tiistai;11;6;17;3;6;9
109;14.10.2014;2014;10;21;Tiistai;7;10;17;2;4;6
109;14.10.2014;2014;10;22;Tiistai;2;5;7;1;1;2
109;14.10.2014;2014;10;23;Tiistai;1;1;2;0;0;0
109;15.10.2014;2014;10;00;Keskiviikko;0;0;0;0;0;0
109;15.10.2014;2014;10;01;Keskiviikko;1;0;1;0;0;0
109;15.10.2014;2014;10;02;Keskiviikko;0;0;0;0;0;0
109;15.10.2014;2014;10;03;Keskiviikko;0;0;0;0;0;0
109;15.10.2014;2014;10;04;Keskiviikko;0;1;1;0;0;0
109;15.10.2014;2014;10;05;Keskiviikko;3;3;6;1;0;1
109;15.10.2014;2014;10;06;Keskiviikko;9;24;33;3;3;6
109;15.10.2014;2014;10;07;Keskiviikko;33;58;91;5;3;8
109;15.10.2014;2014;10;08;Keskiviikko;23;51;74;2;3;5
109;15.10.2014;2014;10;09;Keskiviikko;8;25;33;2;0;2
109;15.10.2014;2014;10;10;Keskiviikko;4;9;13;1;2;3
109;15.10.2014;2014;10;11;Keskiviikko;9;8;17;1;0;1
109;15.10.2014;2014;10;12;Keskiviikko;11;17;28;4;3;7
109;15.10.2014;2014;10;13;Keskiviikko;21;11;32;1;3;4
109;15.10.2014;2014;10;14;Keskiviikko;30;11;41;1;3;4
109;15.10.2014;2014;10;15;Keskiviikko;32;29;61;2;3;5
109;15.10.2014;2014;10;16;Keskiviikko;58;43;101;9;6;15
109;15.10.2014;2014;10;17;Keskiviikko;31;21;52;4;9;13
109;15.10.2014;2014;10;18;Keskiviikko;23;18;41;2;5;7
109;15.10.2014;2014;10;19;Keskiviikko;9;11;20;3;6;9
109;15.10.2014;2014;10;20;Keskiviikko;6;8;14;2;7;9
109;15.10.2014;2014;10;21;Keskiviikko;9;8;17;4;2;6
109;15.10.2014;2014;10;22;Keskiviikko;3;7;10;1;0;1
109;15.10.2014;2014;10;23;Keskiviikko;0;1;1;0;0;0
109;16.10.2014;2014;10;00;Torstai;0;1;1;0;0;0
109;16.10.2014;2014;10;01;Torstai;1;1;2;0;0;0
109;16.10.2014;2014;10;02;Torstai;0;0;0;0;0;0
109;16.10.2014;2014;10;03;Torstai;0;0;0;0;0;0
109;16.10.2014;2014;10;04;Torstai;2;3;5;0;0;0
109;16.10.2014;2014;10;05;Torstai;1;4;5;2;0;2
109;16.10.2014;2014;10;06;Torstai;9;18;27;1;1;2
109;16.10.2014;2014;10;07;Torstai;39;53;92;4;4;8
109;16.10.2014;2014;10;08;Torstai;17;47;64;2;0;2
109;16.10.2014;2014;10;09;Torstai;12;24;36;1;4;5
109;16.10.2014;2014;10;10;Torstai;12;16;28;3;4;7
109;16.10.2014;2014;10;11;Torstai;7;16;23;3;0;3
109;16.10.2014;2014;10;12;Torstai;9;17;26;2;5;7
109;16.10.2014;2014;10;13;Torstai;14;11;25;2;2;4
109;16.10.2014;2014;10;14;Torstai;17;14;31;3;1;4
109;16.10.2014;2014;10;15;Torstai;44;27;71;3;3;6
109;16.10.2014;2014;10;16;Torstai;56;41;97;2;4;6
109;16.10.2014;2014;10;17;Torstai;27;16;43;2;3;5
109;16.10.2014;2014;10;18;Torstai;8;18;26;6;2;8
109;16.10.2014;2014;10;19;Torstai;10;11;21;7;8;15
109;16.10.2014;2014;10;20;Torstai;15;4;19;3;2;5
109;16.10.2014;2014;10;21;Torstai;13;2;15;2;1;3
109;16.10.2014;2014;10;22;Torstai;2;8;10;1;4;5
109;16.10.2014;2014;10;23;Torstai;0;1;1;0;0;0
109;17.10.2014;2014;10;00;Perjantai;0;1;1;1;0;1
109;17.10.2014;2014;10;01;Perjantai;0;0;0;1;0;1
109;17.10.2014;2014;10;02;Perjantai;0;0;0;0;0;0
109;17.10.2014;2014;10;03;Perjantai;0;0;0;0;0;0
109;17.10.2014;2014;10;04;Perjantai;0;1;1;0;0;0
109;17.10.2014;2014;10;05;Perjantai;4;4;8;0;0;0
109;17.10.2014;2014;10;06;Perjantai;11;20;31;1;1;2
109;17.10.2014;2014;10;07;Perjantai;21;65;86;4;6;10
109;17.10.2014;2014;10;08;Perjantai;15;38;53;3;2;5
109;17.10.2014;2014;10;09;Perjantai;6;14;20;2;3;5
109;17.10.2014;2014;10;10;Perjantai;10;14;24;3;6;9
109;17.10.2014;2014;10;11;Perjantai;9;14;23;0;1;1
109;17.10.2014;2014;10;12;Perjantai;6;12;18;2;2;4
109;17.10.2014;2014;10;13;Perjantai;24;15;39;2;2;4
109;17.10.2014;2014;10;14;Perjantai;38;11;49;3;4;7
109;17.10.2014;2014;10;15;Perjantai;34;30;64;2;4;6
109;17.10.2014;2014;10;16;Perjantai;25;27;52;4;6;10
109;17.10.2014;2014;10;17;Perjantai;20;16;36;5;8;13
109;17.10.2014;2014;10;18;Perjantai;11;10;21;7;3;10
109;17.10.2014;2014;10;19;Perjantai;0;6;6;5;3;8
109;17.10.2014;2014;10;20;Perjantai;3;0;3;1;1;2
109;17.10.2014;2014;10;21;Perjantai;2;7;9;1;2;3
109;17.10.2014;2014;10;22;Perjantai;0;5;5;1;1;2
109;17.10.2014;2014;10;23;Perjantai;3;4;7;0;1;1
109;18.10.2014;2014;10;00;Lauantai;1;2;3;0;0;0
109;18.10.2014;2014;10;01;Lauantai;1;0;1;0;0;0
109;18.10.2014;2014;10;02;Lauantai;4;1;5;0;1;1
109;18.10.2014;2014;10;03;Lauantai;1;0;1;0;0;0
109;18.10.2014;2014;10;04;Lauantai;1;0;1;1;0;1
109;18.10.2014;2014;10;05;Lauantai;0;0;0;0;0;0
109;18.10.2014;2014;10;06;Lauantai;0;4;4;1;1;2
109;18.10.2014;2014;10;07;Lauantai;0;4;4;2;1;3
109;18.10.2014;2014;10;08;Lauantai;6;4;10;3;1;4
109;18.10.2014;2014;10;09;Lauantai;0;7;7;4;1;5
109;18.10.2014;2014;10;10;Lauantai;5;6;11;5;1;6
109;18.10.2014;2014;10;11;Lauantai;5;6;11;3;6;9
109;18.10.2014;2014;10;12;Lauantai;5;4;9;1;5;6
109;18.10.2014;2014;10;13;Lauantai;4;9;13;5;7;12
109;18.10.2014;2014;10;14;Lauantai;5;8;13;8;4;12
109;18.10.2014;2014;10;15;Lauantai;7;5;12;1;2;3
109;18.10.2014;2014;10;16;Lauantai;7;6;13;2;5;7
109;18.10.2014;2014;10;17;Lauantai;5;7;12;3;8;11
109;18.10.2014;2014;10;18;Lauantai;7;2;9;3;1;4
109;18.10.2014;2014;10;19;Lauantai;3;3;6;2;5;7
109;18.10.2014;2014;10;20;Lauantai;3;3;6;6;2;8
109;18.10.2014;2014;10;21;Lauantai;8;3;11;1;2;3
109;18.10.2014;2014;10;22;Lauantai;4;2;6;1;2;3
109;18.10.2014;2014;10;23;Lauantai;3;1;4;1;1;2
109;19.10.2014;2014;10;00;Sunnuntai;2;1;3;1;1;2
109;19.10.2014;2014;10;01;Sunnuntai;0;0;0;0;0;0
109;19.10.2014;2014;10;02;Sunnuntai;0;1;1;0;1;1
109;19.10.2014;2014;10;03;Sunnuntai;0;1;1;0;0;0
109;19.10.2014;2014;10;04;Sunnuntai;0;1;1;0;0;0
109;19.10.2014;2014;10;05;Sunnuntai;0;0;0;1;0;1
109;19.10.2014;2014;10;06;Sunnuntai;0;1;1;0;0;0
109;19.10.2014;2014;10;07;Sunnuntai;0;1;1;3;4;7
109;19.10.2014;2014;10;08;Sunnuntai;1;0;1;1;3;4
109;19.10.2014;2014;10;09;Sunnuntai;1;1;2;3;3;6
109;19.10.2014;2014;10;10;Sunnuntai;1;3;4;2;3;5
109;19.10.2014;2014;10;11;Sunnuntai;2;3;5;3;2;5
109;19.10.2014;2014;10;12;Sunnuntai;2;6;8;3;5;8
109;19.10.2014;2014;10;13;Sunnuntai;4;6;10;1;3;4
109;19.10.2014;2014;10;14;Sunnuntai;6;1;7;3;4;7
109;19.10.2014;2014;10;15;Sunnuntai;7;1;8;3;4;7
109;19.10.2014;2014;10;16;Sunnuntai;2;5;7;3;2;5
109;19.10.2014;2014;10;17;Sunnuntai;2;3;5;3;4;7
109;19.10.2014;2014;10;18;Sunnuntai;3;3;6;2;5;7
109;19.10.2014;2014;10;19;Sunnuntai;3;0;3;5;5;10
109;19.10.2014;2014;10;20;Sunnuntai;2;1;3;7;3;10
109;19.10.2014;2014;10;21;Sunnuntai;2;0;2;1;2;3
109;19.10.2014;2014;10;22;Sunnuntai;1;1;2;1;0;1
109;19.10.2014;2014;10;23;Sunnuntai;2;2;4;0;1;1
109;20.10.2014;2014;10;00;Maanantai;0;0;0;0;0;0
109;20.10.2014;2014;10;01;Maanantai;0;0;0;1;0;1
109;20.10.2014;2014;10;02;Maanantai;1;1;2;1;1;2
109;20.10.2014;2014;10;03;Maanantai;0;0;0;0;0;0
109;20.10.2014;2014;10;04;Maanantai;1;0;1;0;0;0
109;20.10.2014;2014;10;05;Maanantai;2;4;6;1;0;1
109;20.10.2014;2014;10;06;Maanantai;12;19;31;1;1;2
109;20.10.2014;2014;10;07;Maanantai;25;35;60;2;6;8
109;20.10.2014;2014;10;08;Maanantai;12;34;46;5;1;6
109;20.10.2014;2014;10;09;Maanantai;5;13;18;1;5;6
109;20.10.2014;2014;10;10;Maanantai;6;9;15;1;4;5
109;20.10.2014;2014;10;11;Maanantai;9;10;19;2;3;5
109;20.10.2014;2014;10;12;Maanantai;2;18;20;2;4;6
109;20.10.2014;2014;10;13;Maanantai;9;14;23;0;3;3
109;20.10.2014;2014;10;14;Maanantai;12;18;30;5;0;5
109;20.10.2014;2014;10;15;Maanantai;23;21;44;3;2;5
109;20.10.2014;2014;10;16;Maanantai;30;44;74;4;7;11
109;20.10.2014;2014;10;17;Maanantai;16;14;30;5;3;8
109;20.10.2014;2014;10;18;Maanantai;16;9;25;4;3;7
109;20.10.2014;2014;10;19;Maanantai;9;4;13;1;11;12
109;20.10.2014;2014;10;20;Maanantai;4;2;6;3;3;6
109;20.10.2014;2014;10;21;Maanantai;1;0;1;1;2;3
109;20.10.2014;2014;10;22;Maanantai;2;7;9;2;2;4
109;20.10.2014;2014;10;23;Maanantai;0;2;2;0;0;0
109;21.10.2014;2014;10;00;Tiistai;2;0;2;1;0;1
109;21.10.2014;2014;10;01;Tiistai;0;0;0;0;1;1
109;21.10.2014;2014;10;02;Tiistai;1;2;3;0;0;0
109;21.10.2014;2014;10;03;Tiistai;0;0;0;0;0;0
109;21.10.2014;2014;10;04;Tiistai;1;1;2;0;0;0
109;21.10.2014;2014;10;05;Tiistai;1;5;6;2;1;3
109;21.10.2014;2014;10;06;Tiistai;6;22;28;1;2;3
109;21.10.2014;2014;10;07;Tiistai;24;43;67;3;8;11
109;21.10.2014;2014;10;08;Tiistai;13;34;47;3;0;3
109;21.10.2014;2014;10;09;Tiistai;2;12;14;0;1;1
109;21.10.2014;2014;10;10;Tiistai;4;8;12;1;5;6
109;21.10.2014;2014;10;11;Tiistai;6;14;20;2;4;6
109;21.10.2014;2014;10;12;Tiistai;3;13;16;2;3;5
109;21.10.2014;2014;10;13;Tiistai;5;18;23;2;3;5
109;21.10.2014;2014;10;14;Tiistai;7;19;26;2;3;5
109;21.10.2014;2014;10;15;Tiistai;30;32;62;2;4;6
109;21.10.2014;2014;10;16;Tiistai;24;39;63;7;4;11
109;21.10.2014;2014;10;17;Tiistai;11;16;27;4;4;8
109;21.10.2014;2014;10;18;Tiistai;22;15;37;3;9;12
109;21.10.2014;2014;10;19;Tiistai;9;9;18;4;7;11
109;21.10.2014;2014;10;20;Tiistai;4;6;10;0;2;2
109;21.10.2014;2014;10;21;Tiistai;3;3;6;0;2;2
109;21.10.2014;2014;10;22;Tiistai;6;5;11;1;4;5
109;21.10.2014;2014;10;23;Tiistai;2;1;3;0;0;0
109;22.10.2014;2014;10;00;Keskiviikko;0;0;0;0;0;0
109;22.10.2014;2014;10;01;Keskiviikko;1;1;2;0;2;2
109;22.10.2014;2014;10;02;Keskiviikko;0;0;0;2;0;2
109;22.10.2014;2014;10;03;Keskiviikko;0;1;1;0;0;0
109;22.10.2014;2014;10;04;Keskiviikko;1;0;1;0;0;0
109;22.10.2014;2014;10;05;Keskiviikko;6;3;9;2;0;2
109;22.10.2014;2014;10;06;Keskiviikko;8;27;35;1;1;2
109;22.10.2014;2014;10;07;Keskiviikko;20;42;62;4;1;5
109;22.10.2014;2014;10;08;Keskiviikko;20;27;47;0;4;4
109;22.10.2014;2014;10;09;Keskiviikko;3;16;19;3;2;5
109;22.10.2014;2014;10;10;Keskiviikko;2;15;17;2;2;4
109;22.10.2014;2014;10;11;Keskiviikko;7;8;15;2;5;7
109;22.10.2014;2014;10;12;Keskiviikko;5;10;15;1;0;1
109;22.10.2014;2014;10;13;Keskiviikko;5;10;15;3;6;9
109;22.10.2014;2014;10;14;Keskiviikko;19;18;37;3;3;6
109;22.10.2014;2014;10;15;Keskiviikko;25;21;46;5;4;9
109;22.10.2014;2014;10;16;Keskiviikko;35;39;74;2;2;4
109;22.10.2014;2014;10;17;Keskiviikko;22;16;38;4;2;6
109;22.10.2014;2014;10;18;Keskiviikko;13;11;24;5;4;9
109;22.10.2014;2014;10;19;Keskiviikko;5;9;14;4;3;7
109;22.10.2014;2014;10;20;Keskiviikko;5;7;12;1;8;9
109;22.10.2014;2014;10;21;Keskiviikko;6;1;7;3;0;3
109;22.10.2014;2014;10;22;Keskiviikko;0;1;1;1;2;3
109;22.10.2014;2014;10;23;Keskiviikko;0;3;3;0;1;1
109;23.10.2014;2014;10;00;Torstai;0;1;1;0;1;1
109;23.10.2014;2014;10;01;Torstai;1;0;1;1;0;1
109;23.10.2014;2014;10;02;Torstai;0;0;0;0;0;0
109;23.10.2014;2014;10;03;Torstai;0;1;1;0;0;0
109;23.10.2014;2014;10;04;Torstai;1;0;1;0;0;0
109;23.10.2014;2014;10;05;Torstai;4;3;7;2;1;3
109;23.10.2014;2014;10;06;Torstai;8;19;27;1;1;2
109;23.10.2014;2014;10;07;Torstai;21;42;63;3;0;3
109;23.10.2014;2014;10;08;Torstai;17;15;32;2;3;5
109;23.10.2014;2014;10;09;Torstai;4;7;11;2;2;4
109;23.10.2014;2014;10;10;Torstai;0;11;11;6;2;8
109;23.10.2014;2014;10;11;Torstai;5;11;16;2;2;4
109;23.10.2014;2014;10;12;Torstai;4;9;13;1;3;4
109;23.10.2014;2014;10;13;Torstai;11;11;22;2;6;8
109;23.10.2014;2014;10;14;Torstai;12;21;33;2;5;7
109;23.10.2014;2014;10;15;Torstai;21;21;42;8;4;12
109;23.10.2014;2014;10;16;Torstai;30;35;65;6;5;11
109;23.10.2014;2014;10;17;Torstai;11;17;28;2;4;6
109;23.10.2014;2014;10;18;Torstai;17;9;26;4;5;9
109;23.10.2014;2014;10;19;Torstai;6;8;14;2;6;8
109;23.10.2014;2014;10;20;Torstai;5;2;7;0;1;1
109;23.10.2014;2014;10;21;Torstai;6;5;11;5;2;7
109;23.10.2014;2014;10;22;Torstai;2;7;9;1;3;4
109;23.10.2014;2014;10;23;Torstai;0;1;1;0;0;0
109;24.10.2014;2014;10;00;Perjantai;0;0;0;1;0;1
109;24.10.2014;2014;10;01;Perjantai;0;0;0;0;0;0
109;24.10.2014;2014;10;02;Perjantai;1;0;1;0;0;0
109;24.10.2014;2014;10;03;Perjantai;0;0;0;0;0;0
109;24.10.2014;2014;10;04;Perjantai;1;0;1;0;0;0
109;24.10.2014;2014;10;05;Perjantai;3;5;8;1;0;1
109;24.10.2014;2014;10;06;Perjantai;6;14;20;2;1;3
109;24.10.2014;2014;10;07;Perjantai;31;15;46;6;0;6
109;24.10.2014;2014;10;08;Perjantai;19;5;24;1;0;1
109;24.10.2014;2014;10;09;Perjantai;5;4;9;0;0;0
109;24.10.2014;2014;10;10;Perjantai;7;3;10;0;0;0
109;24.10.2014;2014;10;11;Perjantai;4;2;6;0;0;0
109;24.10.2014;2014;10;12;Perjantai;5;3;8;0;0;0
109;24.10.2014;2014;10;13;Perjantai;9;7;16;0;0;0
109;24.10.2014;2014;10;14;Perjantai;7;6;13;0;0;0
109;24.10.2014;2014;10;15;Perjantai;21;18;39;0;0;0
109;24.10.2014;2014;10;16;Perjantai;19;18;37;0;0;0
109;24.10.2014;2014;10;17;Perjantai;8;8;16;0;0;0
109;24.10.2014;2014;10;18;Perjantai;5;2;7;0;0;0
109;24.10.2014;2014;10;19;Perjantai;2;0;2;0;0;0
109;24.10.2014;2014;10;20;Perjantai;3;3;6;0;0;0
109;24.10.2014;2014;10;21;Perjantai;0;0;0;0;0;0
109;24.10.2014;2014;10;22;Perjantai;1;0;1;2;0;2
109;24.10.2014;2014;10;23;Perjantai;1;0;1;0;0;0
109;25.10.2014;2014;10;00;Lauantai;1;0;1;0;0;0
109;25.10.2014;2014;10;01;Lauantai;3;0;3;0;0;0
109;25.10.2014;2014;10;02;Lauantai;0;0;0;0;0;0
109;25.10.2014;2014;10;03;Lauantai;0;0;0;0;0;0
109;25.10.2014;2014;10;04;Lauantai;1;0;1;0;0;0
109;25.10.2014;2014;10;05;Lauantai;1;0;1;0;0;0
109;25.10.2014;2014;10;06;Lauantai;1;0;1;3;1;4
109;25.10.2014;2014;10;07;Lauantai;2;0;2;1;1;2
109;25.10.2014;2014;10;08;Lauantai;2;0;2;2;1;3
109;25.10.2014;2014;10;09;Lauantai;1;1;2;2;6;8
109;25.10.2014;2014;10;10;Lauantai;1;3;4;2;0;2
109;25.10.2014;2014;10;11;Lauantai;1;1;2;2;1;3
109;25.10.2014;2014;10;12;Lauantai;1;1;2;4;2;6
109;25.10.2014;2014;10;13;Lauantai;0;1;1;2;0;2
109;25.10.2014;2014;10;14;Lauantai;2;0;2;5;2;7
109;25.10.2014;2014;10;15;Lauantai;5;2;7;2;3;5
109;25.10.2014;2014;10;16;Lauantai;4;1;5;2;2;4
109;25.10.2014;2014;10;17;Lauantai;0;2;2;4;1;5
109;25.10.2014;2014;10;18;Lauantai;5;0;5;2;0;2
109;25.10.2014;2014;10;19;Lauantai;3;1;4;1;1;2
109;25.10.2014;2014;10;20;Lauantai;2;1;3;2;0;2
109;25.10.2014;2014;10;21;Lauantai;2;1;3;3;3;6
109;25.10.2014;2014;10;22;Lauantai;3;1;4;0;1;1
109;25.10.2014;2014;10;23;Lauantai;2;0;2;1;0;1
109;26.10.2014;2014;10;00;Sunnuntai;0;0;0;1;0;1
109;26.10.2014;2014;10;01;Sunnuntai;0;1;1;0;0;0
109;26.10.2014;2014;10;02;Sunnuntai;2;0;2;0;1;1
109;26.10.2014;2014;10;03;Sunnuntai;0;0;0;0;0;0
109;26.10.2014;2014;10;04;Sunnuntai;1;3;4;0;0;0
109;26.10.2014;2014;10;05;Sunnuntai;2;1;3;0;0;0
109;26.10.2014;2014;10;06;Sunnuntai;0;0;0;2;0;2
109;26.10.2014;2014;10;07;Sunnuntai;1;1;2;2;3;5
109;26.10.2014;2014;10;08;Sunnuntai;1;2;3;2;5;7
109;26.10.2014;2014;10;09;Sunnuntai;1;0;1;2;4;6
109;26.10.2014;2014;10;10;Sunnuntai;2;1;3;3;1;4
109;26.10.2014;2014;10;11;Sunnuntai;2;3;5;4;2;6
109;26.10.2014;2014;10;12;Sunnuntai;6;9;15;3;8;11
109;26.10.2014;2014;10;13;Sunnuntai;4;7;11;3;7;10
109;26.10.2014;2014;10;14;Sunnuntai;6;6;12;3;10;13
109;26.10.2014;2014;10;15;Sunnuntai;3;4;7;8;2;10
109;26.10.2014;2014;10;16;Sunnuntai;4;3;7;4;3;7
109;26.10.2014;2014;10;17;Sunnuntai;2;3;5;4;8;12
109;26.10.2014;2014;10;18;Sunnuntai;7;3;10;4;5;9
109;26.10.2014;2014;10;19;Sunnuntai;2;4;6;5;5;10
109;26.10.2014;2014;10;20;Sunnuntai;0;3;3;3;2;5
109;26.10.2014;2014;10;21;Sunnuntai;10;5;15;2;2;4
109;26.10.2014;2014;10;22;Sunnuntai;1;0;1;0;0;0
109;26.10.2014;2014;10;23;Sunnuntai;0;0;0;0;0;0
109;27.10.2014;2014;10;00;Maanantai;0;1;1;0;0;0
109;27.10.2014;2014;10;01;Maanantai;0;0;0;0;0;0
109;27.10.2014;2014;10;02;Maanantai;0;0;0;0;0;0
109;27.10.2014;2014;10;03;Maanantai;0;0;0;0;0;0
109;27.10.2014;2014;10;04;Maanantai;0;0;0;0;0;0
109;27.10.2014;2014;10;05;Maanantai;3;1;4;2;0;2
109;27.10.2014;2014;10;06;Maanantai;10;27;37;3;3;6
109;27.10.2014;2014;10;07;Maanantai;27;64;91;6;3;9
109;27.10.2014;2014;10;08;Maanantai;21;42;63;4;3;7
109;27.10.2014;2014;10;09;Maanantai;10;19;29;5;5;10
109;27.10.2014;2014;10;10;Maanantai;6;5;11;1;2;3
109;27.10.2014;2014;10;11;Maanantai;8;11;19;3;5;8
109;27.10.2014;2014;10;12;Maanantai;7;13;20;3;3;6
109;27.10.2014;2014;10;13;Maanantai;8;7;15;2;7;9
109;27.10.2014;2014;10;14;Maanantai;17;15;32;4;3;7
109;27.10.2014;2014;10;15;Maanantai;35;27;62;11;5;16
109;27.10.2014;2014;10;16;Maanantai;54;48;102;6;4;10
109;27.10.2014;2014;10;17;Maanantai;23;16;39;8;4;12
109;27.10.2014;2014;10;18;Maanantai;13;12;25;6;7;13
109;27.10.2014;2014;10;19;Maanantai;8;17;25;2;8;10
109;27.10.2014;2014;10;20;Maanantai;7;3;10;6;4;10
109;27.10.2014;2014;10;21;Maanantai;8;5;13;3;3;6
109;27.10.2014;2014;10;22;Maanantai;1;6;7;1;0;1
109;27.10.2014;2014;10;23;Maanantai;3;1;4;0;0;0
109;28.10.2014;2014;10;00;Tiistai;0;3;3;2;0;2
109;28.10.2014;2014;10;01;Tiistai;0;0;0;1;0;1
109;28.10.2014;2014;10;02;Tiistai;0;0;0;0;0;0
109;28.10.2014;2014;10;03;Tiistai;0;0;0;0;1;1
109;28.10.2014;2014;10;04;Tiistai;0;0;0;0;0;0
109;28.10.2014;2014;10;05;Tiistai;4;5;9;1;1;2
109;28.10.2014;2014;10;06;Tiistai;14;26;40;2;3;5
109;28.10.2014;2014;10;07;Tiistai;34;77;111;4;3;7
109;28.10.2014;2014;10;08;Tiistai;17;53;70;1;0;1
109;28.10.2014;2014;10;09;Tiistai;12;19;31;2;2;4
109;28.10.2014;2014;10;10;Tiistai;10;7;17;2;2;4
109;28.10.2014;2014;10;11;Tiistai;10;11;21;1;5;6
109;28.10.2014;2014;10;12;Tiistai;12;11;23;1;2;3
109;28.10.2014;2014;10;13;Tiistai;16;14;30;1;1;2
109;28.10.2014;2014;10;14;Tiistai;25;27;52;4;4;8
109;28.10.2014;2014;10;15;Tiistai;40;28;68;4;6;10
109;28.10.2014;2014;10;16;Tiistai;56;30;86;3;3;6
109;28.10.2014;2014;10;17;Tiistai;37;18;55;3;8;11
109;28.10.2014;2014;10;18;Tiistai;23;5;28;7;7;14
109;28.10.2014;2014;10;19;Tiistai;15;8;23;4;5;9
109;28.10.2014;2014;10;20;Tiistai;15;3;18;1;2;3
109;28.10.2014;2014;10;21;Tiistai;8;0;8;1;2;3
109;28.10.2014;2014;10;22;Tiistai;7;3;10;2;0;2
109;28.10.2014;2014;10;23;Tiistai;1;0;1;1;1;2
109;29.10.2014;2014;10;00;Keskiviikko;1;0;1;1;0;1
109;29.10.2014;2014;10;01;Keskiviikko;0;0;0;0;0;0
109;29.10.2014;2014;10;02;Keskiviikko;1;0;1;0;0;0
109;29.10.2014;2014;10;03;Keskiviikko;0;0;0;0;0;0
109;29.10.2014;2014;10;04;Keskiviikko;1;0;1;0;0;0
109;29.10.2014;2014;10;05;Keskiviikko;3;0;3;1;0;1
109;29.10.2014;2014;10;06;Keskiviikko;33;6;39;4;0;4
109;29.10.2014;2014;10;07;Keskiviikko;59;14;73;5;0;5
109;29.10.2014;2014;10;08;Keskiviikko;33;19;52;3;3;6
109;29.10.2014;2014;10;09;Keskiviikko;9;7;16;1;1;2
109;29.10.2014;2014;10;10;Keskiviikko;6;4;10;2;3;5
109;29.10.2014;2014;10;11;Keskiviikko;11;10;21;0;1;1
109;29.10.2014;2014;10;12;Keskiviikko;8;16;24;1;5;6
109;29.10.2014;2014;10;13;Keskiviikko;15;4;19;5;4;9
109;29.10.2014;2014;10;14;Keskiviikko;16;15;31;4;2;6
109;29.10.2014;2014;10;15;Keskiviikko;29;18;47;8;8;16
109;29.10.2014;2014;10;16;Keskiviikko;49;25;74;10;10;20
109;29.10.2014;2014;10;17;Keskiviikko;27;20;47;7;7;14
109;29.10.2014;2014;10;18;Keskiviikko;12;19;31;7;6;13
109;29.10.2014;2014;10;19;Keskiviikko;6;5;11;5;8;13
109;29.10.2014;2014;10;20;Keskiviikko;6;2;8;6;3;9
109;29.10.2014;2014;10;21;Keskiviikko;8;7;15;2;3;5
109;29.10.2014;2014;10;22;Keskiviikko;0;4;4;1;0;1
109;29.10.2014;2014;10;23;Keskiviikko;1;1;2;0;0;0
109;30.10.2014;2014;10;00;Torstai;0;0;0;2;0;2
109;30.10.2014;2014;10;01;Torstai;1;0;1;0;0;0
109;30.10.2014;2014;10;02;Torstai;0;0;0;0;0;0
109;30.10.2014;2014;10;03;Torstai;0;0;0;1;0;1
109;30.10.2014;2014;10;04;Torstai;1;0;1;0;0;0
109;30.10.2014;2014;10;05;Torstai;3;6;9;0;2;2
109;30.10.2014;2014;10;06;Torstai;12;26;38;3;0;3
109;30.10.2014;2014;10;07;Torstai;28;66;94;8;3;11
109;30.10.2014;2014;10;08;Torstai;18;63;81;0;3;3
109;30.10.2014;2014;10;09;Torstai;5;16;21;1;1;2
109;30.10.2014;2014;10;10;Torstai;6;17;23;4;3;7
109;30.10.2014;2014;10;11;Torstai;6;14;20;3;4;7
109;30.10.2014;2014;10;12;Torstai;4;13;17;0;1;1
109;30.10.2014;2014;10;13;Torstai;7;15;22;2;5;7
109;30.10.2014;2014;10;14;Torstai;16;24;40;6;5;11
109;30.10.2014;2014;10;15;Torstai;36;32;68;6;5;11
109;30.10.2014;2014;10;16;Torstai;64;44;108;6;6;12
109;30.10.2014;2014;10;17;Torstai;27;24;51;3;2;5
109;30.10.2014;2014;10;18;Torstai;8;13;21;3;8;11
109;30.10.2014;2014;10;19;Torstai;6;12;18;2;5;7
109;30.10.2014;2014;10;20;Torstai;10;7;17;6;7;13
109;30.10.2014;2014;10;21;Torstai;3;5;8;1;3;4
109;30.10.2014;2014;10;22;Torstai;5;7;12;1;1;2
109;30.10.2014;2014;10;23;Torstai;0;2;2;0;1;1
109;31.10.2014;2014;10;00;Perjantai;1;0;1;0;0;0
109;31.10.2014;2014;10;01;Perjantai;0;0;0;2;0;2
109;31.10.2014;2014;10;02;Perjantai;0;0;0;0;0;0
109;31.10.2014;2014;10;03;Perjantai;0;0;0;0;0;0
109;31.10.2014;2014;10;04;Perjantai;2;0;2;0;0;0
109;31.10.2014;2014;10;05;Perjantai;2;3;5;1;0;1
109;31.10.2014;2014;10;06;Perjantai;7;26;33;3;2;5
109;31.10.2014;2014;10;07;Perjantai;25;50;75;5;3;8
109;31.10.2014;2014;10;08;Perjantai;16;45;61;3;5;8
109;31.10.2014;2014;10;09;Perjantai;5;19;24;0;3;3
109;31.10.2014;2014;10;10;Perjantai;6;14;20;3;1;4
109;31.10.2014;2014;10;11;Perjantai;8;22;30;3;2;5
109;31.10.2014;2014;10;12;Perjantai;15;9;24;2;2;4
109;31.10.2014;2014;10;13;Perjantai;16;17;33;1;6;7
109;31.10.2014;2014;10;14;Perjantai;22;16;38;6;5;11
109;31.10.2014;2014;10;15;Perjantai;32;30;62;2;4;6
109;31.10.2014;2014;10;16;Perjantai;26;28;54;6;2;8
109;31.10.2014;2014;10;17;Perjantai;15;13;28;3;3;6
109;31.10.2014;2014;10;18;Perjantai;7;3;10;3;3;6
109;31.10.2014;2014;10;19;Perjantai;4;5;9;2;1;3
109;31.10.2014;2014;10;20;Perjantai;6;3;9;1;2;3
109;31.10.2014;2014;10;21;Perjantai;3;5;8;1;2;3
109;31.10.2014;2014;10;22;Perjantai;0;5;5;1;1;2
109;31.10.2014;2014;10;23;Perjantai;1;2;3;0;0;0
109;01.11.2014;2014;11;00;Lauantai;0;0;0;0;0;0
109;01.11.2014;2014;11;01;Lauantai;2;1;3;1;0;1
109;01.11.2014;2014;11;02;Lauantai;3;0;3;0;0;0
109;01.11.2014;2014;11;03;Lauantai;0;0;0;1;0;1
109;01.11.2014;2014;11;04;Lauantai;2;0;2;0;0;0
109;01.11.2014;2014;11;05;Lauantai;1;0;1;0;0;0
109;01.11.2014;2014;11;06;Lauantai;0;7;7;0;0;0
109;01.11.2014;2014;11;07;Lauantai;0;2;2;2;0;2
109;01.11.2014;2014;11;08;Lauantai;1;2;3;0;2;2
109;01.11.2014;2014;11;09;Lauantai;5;5;10;1;5;6
109;01.11.2014;2014;11;10;Lauantai;3;4;7;3;7;10
109;01.11.2014;2014;11;11;Lauantai;3;9;12;11;6;17
109;01.11.2014;2014;11;12;Lauantai;12;6;18;4;11;15
109;01.11.2014;2014;11;13;Lauantai;8;6;14;5;9;14
109;01.11.2014;2014;11;14;Lauantai;5;5;10;6;3;9
109;01.11.2014;2014;11;15;Lauantai;13;13;26;4;7;11
109;01.11.2014;2014;11;16;Lauantai;4;1;5;4;6;10
109;01.11.2014;2014;11;17;Lauantai;2;8;10;2;6;8
109;01.11.2014;2014;11;18;Lauantai;2;1;3;3;2;5
109;01.11.2014;2014;11;19;Lauantai;2;5;7;2;2;4
109;01.11.2014;2014;11;20;Lauantai;0;2;2;3;1;4
109;01.11.2014;2014;11;21;Lauantai;4;2;6;1;0;1
109;01.11.2014;2014;11;22;Lauantai;0;0;0;1;2;3
109;01.11.2014;2014;11;23;Lauantai;2;0;2;1;0;1
109;02.11.2014;2014;11;00;Sunnuntai;0;1;1;0;0;0
109;02.11.2014;2014;11;01;Sunnuntai;0;0;0;0;1;1
109;02.11.2014;2014;11;02;Sunnuntai;0;0;0;0;0;0
109;02.11.2014;2014;11;03;Sunnuntai;3;2;5;0;0;0
109;02.11.2014;2014;11;04;Sunnuntai;1;0;1;0;0;0
109;02.11.2014;2014;11;05;Sunnuntai;1;0;1;0;0;0
109;02.11.2014;2014;11;06;Sunnuntai;0;0;0;0;0;0
109;02.11.2014;2014;11;07;Sunnuntai;1;0;1;0;0;0
109;02.11.2014;2014;11;08;Sunnuntai;2;0;2;0;0;0
109;02.11.2014;2014;11;09;Sunnuntai;0;0;0;0;0;0
109;02.11.2014;2014;11;10;Sunnuntai;2;1;3;0;0;0
109;02.11.2014;2014;11;11;Sunnuntai;1;0;1;0;0;0
109;02.11.2014;2014;11;12;Sunnuntai;5;3;8;0;0;0
109;02.11.2014;2014;11;13;Sunnuntai;6;3;9;0;0;0
109;02.11.2014;2014;11;14;Sunnuntai;3;2;5;2;0;2
109;02.11.2014;2014;11;15;Sunnuntai;9;2;11;3;5;8
109;02.11.2014;2014;11;16;Sunnuntai;2;4;6;5;6;11
109;02.11.2014;2014;11;17;Sunnuntai;1;5;6;2;3;5
109;02.11.2014;2014;11;18;Sunnuntai;2;3;5;3;6;9
109;02.11.2014;2014;11;19;Sunnuntai;5;3;8;5;4;9
109;02.11.2014;2014;11;20;Sunnuntai;2;1;3;3;2;5
109;02.11.2014;2014;11;21;Sunnuntai;5;3;8;0;0;0
109;02.11.2014;2014;11;22;Sunnuntai;0;2;2;1;1;2
109;02.11.2014;2014;11;23;Sunnuntai;0;0;0;0;0;0
109;03.11.2014;2014;11;00;Maanantai;0;0;0;1;0;1
109;03.11.2014;2014;11;01;Maanantai;0;0;0;1;0;1
109;03.11.2014;2014;11;02;Maanantai;0;0;0;0;0;0
109;03.11.2014;2014;11;03;Maanantai;2;0;2;0;0;0
109;03.11.2014;2014;11;04;Maanantai;0;0;0;0;0;0
109;03.11.2014;2014;11;05;Maanantai;9;2;11;0;0;0
109;03.11.2014;2014;11;06;Maanantai;20;7;27;0;0;0
109;03.11.2014;2014;11;07;Maanantai;44;31;75;4;3;7
109;03.11.2014;2014;11;08;Maanantai;22;26;48;2;0;2
109;03.11.2014;2014;11;09;Maanantai;11;11;22;0;0;0
109;03.11.2014;2014;11;10;Maanantai;7;5;12;0;1;1
109;03.11.2014;2014;11;11;Maanantai;7;4;11;1;2;3
109;03.11.2014;2014;11;12;Maanantai;6;2;8;1;0;1
109;03.11.2014;2014;11;13;Maanantai;7;6;13;0;1;1
109;03.11.2014;2014;11;14;Maanantai;16;9;25;0;4;4
109;03.11.2014;2014;11;15;Maanantai;30;17;47;5;1;6
109;03.11.2014;2014;11;16;Maanantai;45;20;65;1;6;7
109;03.11.2014;2014;11;17;Maanantai;25;13;38;3;3;6
109;03.11.2014;2014;11;18;Maanantai;8;4;12;3;4;7
109;03.11.2014;2014;11;19;Maanantai;16;5;21;5;4;9
109;03.11.2014;2014;11;20;Maanantai;7;2;9;1;1;2
109;03.11.2014;2014;11;21;Maanantai;6;3;9;2;2;4
109;03.11.2014;2014;11;22;Maanantai;4;3;7;0;0;0
109;03.11.2014;2014;11;23;Maanantai;1;0;1;0;0;0
109;04.11.2014;2014;11;00;Tiistai;0;1;1;1;0;1
109;04.11.2014;2014;11;01;Tiistai;0;0;0;1;0;1
109;04.11.2014;2014;11;02;Tiistai;1;0;1;0;0;0
109;04.11.2014;2014;11;03;Tiistai;1;0;1;0;0;0
109;04.11.2014;2014;11;04;Tiistai;1;1;2;0;0;0
109;04.11.2014;2014;11;05;Tiistai;2;5;7;4;1;5
109;04.11.2014;2014;11;06;Tiistai;20;15;35;2;3;5
109;04.11.2014;2014;11;07;Tiistai;38;48;86;5;4;9
109;04.11.2014;2014;11;08;Tiistai;23;47;70;6;1;7
109;04.11.2014;2014;11;09;Tiistai;11;14;25;4;10;14
109;04.11.2014;2014;11;10;Tiistai;4;10;14;5;1;6
109;04.11.2014;2014;11;11;Tiistai;10;14;24;0;1;1
109;04.11.2014;2014;11;12;Tiistai;13;14;27;2;2;4
109;04.11.2014;2014;11;13;Tiistai;16;11;27;0;1;1
109;04.11.2014;2014;11;14;Tiistai;18;19;37;1;3;4
109;04.11.2014;2014;11;15;Tiistai;30;30;60;5;7;12
109;04.11.2014;2014;11;16;Tiistai;52;37;89;6;10;16
109;04.11.2014;2014;11;17;Tiistai;27;25;52;3;7;10
109;04.11.2014;2014;11;18;Tiistai;19;18;37;9;4;13
109;04.11.2014;2014;11;19;Tiistai;7;5;12;5;5;10
109;04.11.2014;2014;11;20;Tiistai;12;5;17;6;2;8
109;04.11.2014;2014;11;21;Tiistai;13;2;15;0;2;2
109;04.11.2014;2014;11;22;Tiistai;1;3;4;2;2;4
109;04.11.2014;2014;11;23;Tiistai;0;1;1;0;1;1
109;05.11.2014;2014;11;00;Keskiviikko;0;0;0;0;0;0
109;05.11.2014;2014;11;01;Keskiviikko;0;2;2;0;0;0
109;05.11.2014;2014;11;02;Keskiviikko;1;0;1;0;0;0
109;05.11.2014;2014;11;03;Keskiviikko;0;0;0;0;0;0
109;05.11.2014;2014;11;04;Keskiviikko;0;4;4;0;0;0
109;05.11.2014;2014;11;05;Keskiviikko;2;2;4;0;0;0
109;05.11.2014;2014;11;06;Keskiviikko;8;22;30;0;1;1
109;05.11.2014;2014;11;07;Keskiviikko;33;44;77;9;6;15
109;05.11.2014;2014;11;08;Keskiviikko;18;38;56;3;2;5
109;05.11.2014;2014;11;09;Keskiviikko;9;16;25;1;3;4
109;05.11.2014;2014;11;10;Keskiviikko;7;5;12;4;1;5
109;05.11.2014;2014;11;11;Keskiviikko;7;8;15;3;3;6
109;05.11.2014;2014;11;12;Keskiviikko;6;7;13;3;1;4
109;05.11.2014;2014;11;13;Keskiviikko;11;7;18;2;4;6
109;05.11.2014;2014;11;14;Keskiviikko;23;13;36;2;3;5
109;05.11.2014;2014;11;15;Keskiviikko;29;15;44;2;5;7
109;05.11.2014;2014;11;16;Keskiviikko;46;26;72;7;6;13
109;05.11.2014;2014;11;17;Keskiviikko;24;13;37;5;9;14
109;05.11.2014;2014;11;18;Keskiviikko;9;8;17;4;8;12
109;05.11.2014;2014;11;19;Keskiviikko;10;6;16;5;4;9
109;05.11.2014;2014;11;20;Keskiviikko;9;3;12;0;1;1
109;05.11.2014;2014;11;21;Keskiviikko;3;5;8;0;0;0
109;05.11.2014;2014;11;22;Keskiviikko;4;2;6;3;3;6
109;05.11.2014;2014;11;23;Keskiviikko;4;2;6;0;1;1
109;06.11.2014;2014;11;00;Torstai;0;0;0;0;0;0
109;06.11.2014;2014;11;01;Torstai;1;0;1;0;0;0
109;06.11.2014;2014;11;02;Torstai;0;0;0;0;0;0
109;06.11.2014;2014;11;03;Torstai;0;1;1;0;0;0
109;06.11.2014;2014;11;04;Torstai;0;0;0;0;0;0
109;06.11.2014;2014;11;05;Torstai;3;3;6;1;0;1
109;06.11.2014;2014;11;06;Torstai;10;16;26;1;1;2
109;06.11.2014;2014;11;07;Torstai;23;35;58;3;4;7
109;06.11.2014;2014;11;08;Torstai;18;51;69;1;2;3
109;06.11.2014;2014;11;09;Torstai;9;12;21;4;5;9
109;06.11.2014;2014;11;10;Torstai;4;10;14;8;3;11
109;06.11.2014;2014;11;11;Torstai;8;10;18;0;5;5
109;06.11.2014;2014;11;12;Torstai;4;7;11;3;3;6
109;06.11.2014;2014;11;13;Torstai;12;6;18;4;3;7
109;06.11.2014;2014;11;14;Torstai;24;18;42;2;4;6
109;06.11.2014;2014;11;15;Torstai;29;24;53;4;4;8
109;06.11.2014;2014;11;16;Torstai;46;31;77;3;7;10
109;06.11.2014;2014;11;17;Torstai;17;11;28;2;2;4
109;06.11.2014;2014;11;18;Torstai;8;10;18;2;8;10
109;06.11.2014;2014;11;19;Torstai;2;5;7;1;2;3
109;06.11.2014;2014;11;20;Torstai;4;0;4;0;1;1
109;06.11.2014;2014;11;21;Torstai;2;7;9;1;1;2
109;06.11.2014;2014;11;22;Torstai;3;5;8;2;1;3
109;06.11.2014;2014;11;23;Torstai;0;1;1;1;0;1
109;07.11.2014;2014;11;00;Perjantai;1;0;1;1;0;1
109;07.11.2014;2014;11;01;Perjantai;2;0;2;0;0;0
109;07.11.2014;2014;11;02;Perjantai;0;0;0;0;0;0
109;07.11.2014;2014;11;03;Perjantai;2;1;3;0;0;0
109;07.11.2014;2014;11;04;Perjantai;0;1;1;0;0;0
109;07.11.2014;2014;11;05;Perjantai;2;3;5;1;0;1
109;07.11.2014;2014;11;06;Perjantai;10;18;28;1;0;1
109;07.11.2014;2014;11;07;Perjantai;19;36;55;6;5;11
109;07.11.2014;2014;11;08;Perjantai;18;27;45;1;4;5
109;07.11.2014;2014;11;09;Perjantai;6;21;27;12;3;15
109;07.11.2014;2014;11;10;Perjantai;6;4;10;3;1;4
109;07.11.2014;2014;11;11;Perjantai;11;7;18;3;6;9
109;07.11.2014;2014;11;12;Perjantai;6;13;19;1;2;3
109;07.11.2014;2014;11;13;Perjantai;15;8;23;2;5;7
109;07.11.2014;2014;11;14;Perjantai;29;9;38;4;2;6
109;07.11.2014;2014;11;15;Perjantai;37;21;58;3;3;6
109;07.11.2014;2014;11;16;Perjantai;24;23;47;4;8;12
109;07.11.2014;2014;11;17;Perjantai;10;12;22;4;5;9
109;07.11.2014;2014;11;18;Perjantai;7;9;16;3;5;8
109;07.11.2014;2014;11;19;Perjantai;7;1;8;1;2;3
109;07.11.2014;2014;11;20;Perjantai;1;3;4;1;1;2
109;07.11.2014;2014;11;21;Perjantai;2;3;5;4;1;5
109;07.11.2014;2014;11;22;Perjantai;2;4;6;1;4;5
109;07.11.2014;2014;11;23;Perjantai;2;3;5;0;0;0
109;08.11.2014;2014;11;00;Lauantai;0;5;5;1;1;2
109;08.11.2014;2014;11;01;Lauantai;1;4;5;0;0;0
109;08.11.2014;2014;11;02;Lauantai;5;0;5;0;0;0
109;08.11.2014;2014;11;03;Lauantai;0;0;0;0;0;0
109;08.11.2014;2014;11;04;Lauantai;0;0;0;0;0;0
109;08.11.2014;2014;11;05;Lauantai;0;2;2;0;0;0
109;08.11.2014;2014;11;06;Lauantai;1;4;5;3;1;4
109;08.11.2014;2014;11;07;Lauantai;2;2;4;2;2;4
109;08.11.2014;2014;11;08;Lauantai;2;0;2;3;4;7
109;08.11.2014;2014;11;09;Lauantai;4;4;8;1;2;3
109;08.11.2014;2014;11;10;Lauantai;4;2;6;5;3;8
109;08.11.2014;2014;11;11;Lauantai;6;4;10;6;1;7
109;08.11.2014;2014;11;12;Lauantai;6;4;10;3;6;9
109;08.11.2014;2014;11;13;Lauantai;3;7;10;4;2;6
109;08.11.2014;2014;11;14;Lauantai;3;7;10;4;3;7
109;08.11.2014;2014;11;15;Lauantai;8;4;12;2;4;6
109;08.11.2014;2014;11;16;Lauantai;6;6;12;5;2;7
109;08.11.2014;2014;11;17;Lauantai;4;5;9;3;8;11
109;08.11.2014;2014;11;18;Lauantai;3;6;9;5;5;10
109;08.11.2014;2014;11;19;Lauantai;3;3;6;3;7;10
109;08.11.2014;2014;11;20;Lauantai;3;1;4;2;2;4
109;08.11.2014;2014;11;21;Lauantai;2;0;2;0;1;1
109;08.11.2014;2014;11;22;Lauantai;1;1;2;3;0;3
109;08.11.2014;2014;11;23;Lauantai;2;0;2;0;0;0
109;09.11.2014;2014;11;00;Sunnuntai;0;2;2;0;1;1
109;09.11.2014;2014;11;01;Sunnuntai;0;0;0;0;0;0
109;09.11.2014;2014;11;02;Sunnuntai;0;0;0;1;1;2
109;09.11.2014;2014;11;03;Sunnuntai;0;0;0;0;0;0
109;09.11.2014;2014;11;04;Sunnuntai;3;1;4;0;2;2
109;09.11.2014;2014;11;05;Sunnuntai;0;0;0;0;0;0
109;09.11.2014;2014;11;06;Sunnuntai;1;4;5;1;0;1
109;09.11.2014;2014;11;07;Sunnuntai;5;0;5;1;1;2
109;09.11.2014;2014;11;08;Sunnuntai;1;1;2;3;4;7
109;09.11.2014;2014;11;09;Sunnuntai;5;2;7;4;2;6
109;09.11.2014;2014;11;10;Sunnuntai;7;3;10;7;5;12
109;09.11.2014;2014;11;11;Sunnuntai;2;0;2;8;2;10
109;09.11.2014;2014;11;12;Sunnuntai;9;2;11;3;4;7
109;09.11.2014;2014;11;13;Sunnuntai;3;3;6;4;3;7
109;09.11.2014;2014;11;14;Sunnuntai;7;2;9;2;2;4
109;09.11.2014;2014;11;15;Sunnuntai;5;5;10;5;3;8
109;09.11.2014;2014;11;16;Sunnuntai;5;8;13;2;5;7
109;09.11.2014;2014;11;17;Sunnuntai;3;3;6;2;0;2
109;09.11.2014;2014;11;18;Sunnuntai;4;0;4;6;1;7
109;09.11.2014;2014;11;19;Sunnuntai;5;1;6;1;4;5
109;09.11.2014;2014;11;20;Sunnuntai;3;1;4;2;1;3
109;09.11.2014;2014;11;21;Sunnuntai;1;1;2;0;3;3
109;09.11.2014;2014;11;22;Sunnuntai;0;0;0;1;0;1
109;09.11.2014;2014;11;23;Sunnuntai;0;0;0;0;0;0
109;10.11.2014;2014;11;00;Maanantai;2;0;2;1;0;1
109;10.11.2014;2014;11;01;Maanantai;0;0;0;0;0;0
109;10.11.2014;2014;11;02;Maanantai;0;0;0;0;0;0
109;10.11.2014;2014;11;03;Maanantai;0;0;0;0;0;0
109;10.11.2014;2014;11;04;Maanantai;0;0;0;0;0;0
109;10.11.2014;2014;11;05;Maanantai;4;1;5;0;0;0
109;10.11.2014;2014;11;06;Maanantai;13;15;28;0;1;1
109;10.11.2014;2014;11;07;Maanantai;42;39;81;6;5;11
109;10.11.2014;2014;11;08;Maanantai;26;35;61;5;2;7
109;10.11.2014;2014;11;09;Maanantai;12;14;26;1;1;2
109;10.11.2014;2014;11;10;Maanantai;6;12;18;3;5;8
109;10.11.2014;2014;11;11;Maanantai;9;8;17;0;3;3
109;10.11.2014;2014;11;12;Maanantai;17;9;26;4;5;9
109;10.11.2014;2014;11;13;Maanantai;13;11;24;1;3;4
109;10.11.2014;2014;11;14;Maanantai;18;11;29;6;3;9
109;10.11.2014;2014;11;15;Maanantai;28;24;52;2;9;11
109;10.11.2014;2014;11;16;Maanantai;63;32;95;9;3;12
109;10.11.2014;2014;11;17;Maanantai;17;14;31;1;4;5
109;10.11.2014;2014;11;18;Maanantai;17;11;28;5;8;13
109;10.11.2014;2014;11;19;Maanantai;10;4;14;7;10;17
109;10.11.2014;2014;11;20;Maanantai;6;7;13;7;5;12
109;10.11.2014;2014;11;21;Maanantai;6;3;9;2;1;3
109;10.11.2014;2014;11;22;Maanantai;5;3;8;2;1;3
109;10.11.2014;2014;11;23;Maanantai;0;2;2;0;1;1
109;11.11.2014;2014;11;00;Tiistai;0;1;1;0;0;0
109;11.11.2014;2014;11;01;Tiistai;0;0;0;0;0;0
109;11.11.2014;2014;11;02;Tiistai;0;0;0;0;0;0
109;11.11.2014;2014;11;03;Tiistai;1;0;1;0;0;0
109;11.11.2014;2014;11;04;Tiistai;1;0;1;0;0;0
109;11.11.2014;2014;11;05;Tiistai;2;0;2;2;0;2
109;11.11.2014;2014;11;06;Tiistai;10;12;22;1;3;4
109;11.11.2014;2014;11;07;Tiistai;41;30;71;2;4;6
109;11.11.2014;2014;11;08;Tiistai;28;24;52;2;2;4
109;11.11.2014;2014;11;09;Tiistai;18;1;19;3;2;5
109;11.11.2014;2014;11;10;Tiistai;13;3;16;2;1;3
109;11.11.2014;2014;11;11;Tiistai;3;1;4;2;0;2
109;11.11.2014;2014;11;12;Tiistai;2;7;9;2;1;3
109;11.11.2014;2014;11;13;Tiistai;8;1;9;1;1;2
109;11.11.2014;2014;11;14;Tiistai;16;4;20;2;1;3
109;11.11.2014;2014;11;15;Tiistai;29;9;38;1;4;5
109;11.11.2014;2014;11;16;Tiistai;43;25;68;6;7;13
109;11.11.2014;2014;11;17;Tiistai;24;12;36;10;6;16
109;11.11.2014;2014;11;18;Tiistai;14;7;21;7;7;14
109;11.11.2014;2014;11;19;Tiistai;9;3;12;6;2;8
109;11.11.2014;2014;11;20;Tiistai;9;3;12;7;3;10
109;11.11.2014;2014;11;21;Tiistai;3;1;4;1;2;3
109;11.11.2014;2014;11;22;Tiistai;4;3;7;1;0;1
109;11.11.2014;2014;11;23;Tiistai;0;0;0;1;1;2
109;12.11.2014;2014;11;00;Keskiviikko;0;0;0;0;0;0
109;12.11.2014;2014;11;01;Keskiviikko;0;1;1;0;0;0
109;12.11.2014;2014;11;02;Keskiviikko;0;0;0;0;0;0
109;12.11.2014;2014;11;03;Keskiviikko;0;2;2;0;0;0
109;12.11.2014;2014;11;04;Keskiviikko;0;1;1;0;0;0
109;12.11.2014;2014;11;05;Keskiviikko;1;2;3;1;1;2
109;12.11.2014;2014;11;06;Keskiviikko;10;13;23;3;1;4
109;12.11.2014;2014;11;07;Keskiviikko;32;47;79;5;10;15
109;12.11.2014;2014;11;08;Keskiviikko;36;35;71;5;4;9
109;12.11.2014;2014;11;09;Keskiviikko;6;14;20;5;4;9
109;12.11.2014;2014;11;10;Keskiviikko;11;16;27;2;2;4
109;12.11.2014;2014;11;11;Keskiviikko;8;7;15;6;8;14
109;12.11.2014;2014;11;12;Keskiviikko;7;14;21;5;4;9
109;12.11.2014;2014;11;13;Keskiviikko;19;15;34;5;4;9
109;12.11.2014;2014;11;14;Keskiviikko;26;10;36;3;2;5
109;12.11.2014;2014;11;15;Keskiviikko;33;27;60;2;5;7
109;12.11.2014;2014;11;16;Keskiviikko;52;27;79;7;9;16
109;12.11.2014;2014;11;17;Keskiviikko;23;19;42;4;5;9
109;12.11.2014;2014;11;18;Keskiviikko;13;9;22;5;11;16
109;12.11.2014;2014;11;19;Keskiviikko;14;2;16;3;6;9
109;12.11.2014;2014;11;20;Keskiviikko;10;6;16;1;3;4
109;12.11.2014;2014;11;21;Keskiviikko;4;3;7;2;1;3
109;12.11.2014;2014;11;22;Keskiviikko;2;2;4;0;1;1
109;12.11.2014;2014;11;23;Keskiviikko;0;1;1;1;0;1
109;13.11.2014;2014;11;00;Torstai;1;0;1;0;0;0
109;13.11.2014;2014;11;01;Torstai;0;0;0;1;0;1
109;13.11.2014;2014;11;02;Torstai;1;0;1;0;0;0
109;13.11.2014;2014;11;03;Torstai;0;0;0;0;0;0
109;13.11.2014;2014;11;04;Torstai;2;1;3;0;0;0
109;13.11.2014;2014;11;05;Torstai;0;2;2;1;1;2
109;13.11.2014;2014;11;06;Torstai;7;18;25;3;2;5
109;13.11.2014;2014;11;07;Torstai;24;56;80;9;8;17
109;13.11.2014;2014;11;08;Torstai;19;47;66;3;2;5
109;13.11.2014;2014;11;09;Torstai;8;16;24;2;2;4
109;13.11.2014;2014;11;10;Torstai;8;15;23;2;3;5
109;13.11.2014;2014;11;11;Torstai;14;17;31;7;4;11
109;13.11.2014;2014;11;12;Torstai;6;11;17;3;4;7
109;13.11.2014;2014;11;13;Torstai;7;8;15;1;1;2
109;13.11.2014;2014;11;14;Torstai;22;11;33;3;3;6
109;13.11.2014;2014;11;15;Torstai;32;23;55;7;4;11
109;13.11.2014;2014;11;16;Torstai;58;25;83;5;11;16
109;13.11.2014;2014;11;17;Torstai;15;29;44;2;2;4
109;13.11.2014;2014;11;18;Torstai;16;16;32;4;5;9
109;13.11.2014;2014;11;19;Torstai;7;7;14;4;5;9
109;13.11.2014;2014;11;20;Torstai;7;5;12;3;3;6
109;13.11.2014;2014;11;21;Torstai;7;6;13;3;1;4
109;13.11.2014;2014;11;22;Torstai;4;4;8;1;2;3
109;13.11.2014;2014;11;23;Torstai;0;0;0;0;1;1
109;14.11.2014;2014;11;00;Perjantai;0;0;0;0;0;0
109;14.11.2014;2014;11;01;Perjantai;0;0;0;0;0;0
109;14.11.2014;2014;11;02;Perjantai;0;0;0;0;0;0
109;14.11.2014;2014;11;03;Perjantai;2;2;4;0;0;0
109;14.11.2014;2014;11;04;Perjantai;1;1;2;0;0;0
109;14.11.2014;2014;11;05;Perjantai;1;3;4;1;0;1
109;14.11.2014;2014;11;06;Perjantai;8;22;30;3;1;4
109;14.11.2014;2014;11;07;Perjantai;16;54;70;4;9;13
109;14.11.2014;2014;11;08;Perjantai;12;37;49;4;5;9
109;14.11.2014;2014;11;09;Perjantai;7;25;32;3;4;7
109;14.11.2014;2014;11;10;Perjantai;3;10;13;3;1;4
109;14.11.2014;2014;11;11;Perjantai;11;11;22;3;1;4
109;14.11.2014;2014;11;12;Perjantai;11;12;23;3;4;7
109;14.11.2014;2014;11;13;Perjantai;15;10;25;5;2;7
109;14.11.2014;2014;11;14;Perjantai;27;20;47;6;5;11
109;14.11.2014;2014;11;15;Perjantai;37;22;59;2;2;4
109;14.11.2014;2014;11;16;Perjantai;37;19;56;2;8;10
109;14.11.2014;2014;11;17;Perjantai;12;13;25;5;5;10
109;14.11.2014;2014;11;18;Perjantai;9;8;17;3;1;4
109;14.11.2014;2014;11;19;Perjantai;4;9;13;5;1;6
109;14.11.2014;2014;11;20;Perjantai;2;1;3;3;2;5
109;14.11.2014;2014;11;21;Perjantai;3;1;4;2;2;4
109;14.11.2014;2014;11;22;Perjantai;1;2;3;1;2;3
109;14.11.2014;2014;11;23;Perjantai;2;0;2;1;0;1
109;15.11.2014;2014;11;00;Lauantai;0;1;1;0;1;1
109;15.11.2014;2014;11;01;Lauantai;0;0;0;0;0;0
109;15.11.2014;2014;11;02;Lauantai;2;0;2;0;0;0
109;15.11.2014;2014;11;03;Lauantai;0;0;0;0;0;0
109;15.11.2014;2014;11;04;Lauantai;0;0;0;0;0;0
109;15.11.2014;2014;11;05;Lauantai;0;1;1;0;0;0
109;15.11.2014;2014;11;06;Lauantai;2;3;5;0;0;0
109;15.11.2014;2014;11;07;Lauantai;0;4;4;2;1;3
109;15.11.2014;2014;11;08;Lauantai;1;3;4;3;2;5
109;15.11.2014;2014;11;09;Lauantai;4;6;10;3;3;6
109;15.11.2014;2014;11;10;Lauantai;1;5;6;3;7;10
109;15.11.2014;2014;11;11;Lauantai;7;6;13;4;3;7
109;15.11.2014;2014;11;12;Lauantai;3;11;14;5;2;7
109;15.11.2014;2014;11;13;Lauantai;1;6;7;7;3;10
109;15.11.2014;2014;11;14;Lauantai;5;8;13;5;6;11
109;15.11.2014;2014;11;15;Lauantai;11;3;14;7;1;8
109;15.11.2014;2014;11;16;Lauantai;11;9;20;4;6;10
109;15.11.2014;2014;11;17;Lauantai;3;2;5;1;3;4
109;15.11.2014;2014;11;18;Lauantai;2;3;5;2;2;4
109;15.11.2014;2014;11;19;Lauantai;2;2;4;5;2;7
109;15.11.2014;2014;11;20;Lauantai;4;8;12;2;2;4
109;15.11.2014;2014;11;21;Lauantai;3;2;5;1;3;4
109;15.11.2014;2014;11;22;Lauantai;4;0;4;1;2;3
109;15.11.2014;2014;11;23;Lauantai;0;2;2;0;0;0
109;16.11.2014;2014;11;00;Sunnuntai;2;1;3;0;1;1
109;16.11.2014;2014;11;01;Sunnuntai;1;0;1;1;0;1
109;16.11.2014;2014;11;02;Sunnuntai;0;0;0;0;0;0
109;16.11.2014;2014;11;03;Sunnuntai;0;0;0;0;0;0
109;16.11.2014;2014;11;04;Sunnuntai;0;0;0;0;0;0
109;16.11.2014;2014;11;05;Sunnuntai;0;1;1;1;0;1
109;16.11.2014;2014;11;06;Sunnuntai;2;2;4;2;0;2
109;16.11.2014;2014;11;07;Sunnuntai;1;1;2;1;1;2
109;16.11.2014;2014;11;08;Sunnuntai;3;1;4;0;3;3
109;16.11.2014;2014;11;09;Sunnuntai;0;2;2;0;1;1
109;16.11.2014;2014;11;10;Sunnuntai;4;2;6;6;4;10
109;16.11.2014;2014;11;11;Sunnuntai;2;4;6;3;7;10
109;16.11.2014;2014;11;12;Sunnuntai;1;3;4;2;3;5
109;16.11.2014;2014;11;13;Sunnuntai;2;2;4;4;8;12
109;16.11.2014;2014;11;14;Sunnuntai;3;2;5;3;3;6
109;16.11.2014;2014;11;15;Sunnuntai;6;11;17;2;6;8
109;16.11.2014;2014;11;16;Sunnuntai;3;5;8;2;3;5
109;16.11.2014;2014;11;17;Sunnuntai;6;3;9;5;4;9
109;16.11.2014;2014;11;18;Sunnuntai;2;3;5;3;5;8
109;16.11.2014;2014;11;19;Sunnuntai;2;4;6;5;8;13
109;16.11.2014;2014;11;20;Sunnuntai;3;6;9;4;2;6
109;16.11.2014;2014;11;21;Sunnuntai;5;4;9;2;0;2
109;16.11.2014;2014;11;22;Sunnuntai;1;1;2;1;0;1
109;16.11.2014;2014;11;23;Sunnuntai;1;0;1;0;0;0
109;17.11.2014;2014;11;00;Maanantai;0;0;0;2;0;2
109;17.11.2014;2014;11;01;Maanantai;0;0;0;1;0;1
109;17.11.2014;2014;11;02;Maanantai;1;0;1;0;0;0
109;17.11.2014;2014;11;03;Maanantai;0;0;0;0;0;0
109;17.11.2014;2014;11;04;Maanantai;0;1;1;0;0;0
109;17.11.2014;2014;11;05;Maanantai;2;3;5;0;1;1
109;17.11.2014;2014;11;06;Maanantai;11;14;25;2;1;3
109;17.11.2014;2014;11;07;Maanantai;31;44;75;5;7;12
109;17.11.2014;2014;11;08;Maanantai;27;34;61;3;5;8
109;17.11.2014;2014;11;09;Maanantai;9;21;30;0;3;3
109;17.11.2014;2014;11;10;Maanantai;10;11;21;1;1;2
109;17.11.2014;2014;11;11;Maanantai;5;11;16;7;6;13
109;17.11.2014;2014;11;12;Maanantai;7;10;17;2;1;3
109;17.11.2014;2014;11;13;Maanantai;6;10;16;1;1;2
109;17.11.2014;2014;11;14;Maanantai;17;11;28;3;5;8
109;17.11.2014;2014;11;15;Maanantai;29;18;47;3;5;8
109;17.11.2014;2014;11;16;Maanantai;52;33;85;8;3;11
109;17.11.2014;2014;11;17;Maanantai;22;20;42;7;9;16
109;17.11.2014;2014;11;18;Maanantai;10;6;16;4;8;12
109;17.11.2014;2014;11;19;Maanantai;11;13;24;2;6;8
109;17.11.2014;2014;11;20;Maanantai;7;6;13;8;3;11
109;17.11.2014;2014;11;21;Maanantai;5;7;12;1;3;4
109;17.11.2014;2014;11;22;Maanantai;7;3;10;1;2;3
109;17.11.2014;2014;11;23;Maanantai;1;0;1;0;0;0
109;18.11.2014;2014;11;00;Tiistai;1;1;2;1;1;2
109;18.11.2014;2014;11;01;Tiistai;0;0;0;1;1;2
109;18.11.2014;2014;11;02;Tiistai;0;0;0;0;0;0
109;18.11.2014;2014;11;03;Tiistai;0;0;0;0;1;1
109;18.11.2014;2014;11;04;Tiistai;1;0;1;0;0;0
109;18.11.2014;2014;11;05;Tiistai;2;2;4;4;0;4
109;18.11.2014;2014;11;06;Tiistai;13;27;40;3;3;6
109;18.11.2014;2014;11;07;Tiistai;29;49;78;6;5;11
109;18.11.2014;2014;11;08;Tiistai;25;52;77;3;4;7
109;18.11.2014;2014;11;09;Tiistai;13;12;25;1;6;7
109;18.11.2014;2014;11;10;Tiistai;7;5;12;3;1;4
109;18.11.2014;2014;11;11;Tiistai;8;7;15;1;1;2
109;18.11.2014;2014;11;12;Tiistai;5;10;15;2;4;6
109;18.11.2014;2014;11;13;Tiistai;7;10;17;2;6;8
109;18.11.2014;2014;11;14;Tiistai;27;12;39;5;1;6
109;18.11.2014;2014;11;15;Tiistai;44;23;67;5;3;8
109;18.11.2014;2014;11;16;Tiistai;55;38;93;3;2;5
109;18.11.2014;2014;11;17;Tiistai;21;22;43;3;3;6
109;18.11.2014;2014;11;18;Tiistai;16;5;21;7;8;15
109;18.11.2014;2014;11;19;Tiistai;12;8;20;8;11;19
109;18.11.2014;2014;11;20;Tiistai;7;16;23;8;5;13
109;18.11.2014;2014;11;21;Tiistai;9;2;11;5;3;8
109;18.11.2014;2014;11;22;Tiistai;2;5;7;1;1;2
109;18.11.2014;2014;11;23;Tiistai;3;0;3;0;0;0
109;19.11.2014;2014;11;00;Keskiviikko;1;0;1;1;0;1
109;19.11.2014;2014;11;01;Keskiviikko;0;0;0;0;0;0
109;19.11.2014;2014;11;02;Keskiviikko;0;0;0;0;0;0
109;19.11.2014;2014;11;03;Keskiviikko;0;0;0;0;0;0
109;19.11.2014;2014;11;04;Keskiviikko;1;0;1;0;0;0
109;19.11.2014;2014;11;05;Keskiviikko;3;2;5;2;0;2
109;19.11.2014;2014;11;06;Keskiviikko;9;24;33;2;1;3
109;19.11.2014;2014;11;07;Keskiviikko;39;48;87;5;11;16
109;19.11.2014;2014;11;08;Keskiviikko;25;43;68;4;3;7
109;19.11.2014;2014;11;09;Keskiviikko;9;14;23;4;9;13
109;19.11.2014;2014;11;10;Keskiviikko;10;9;19;2;5;7
109;19.11.2014;2014;11;11;Keskiviikko;5;10;15;2;6;8
109;19.11.2014;2014;11;12;Keskiviikko;5;8;13;6;3;9
109;19.11.2014;2014;11;13;Keskiviikko;10;15;25;0;5;5
109;19.11.2014;2014;11;14;Keskiviikko;19;8;27;4;3;7
109;19.11.2014;2014;11;15;Keskiviikko;46;17;63;2;7;9
109;19.11.2014;2014;11;16;Keskiviikko;51;21;72;6;14;20
109;19.11.2014;2014;11;17;Keskiviikko;27;9;36;5;7;12
109;19.11.2014;2014;11;18;Keskiviikko;16;14;30;7;3;10
109;19.11.2014;2014;11;19;Keskiviikko;13;4;17;3;10;13
109;19.11.2014;2014;11;20;Keskiviikko;7;6;13;6;3;9
109;19.11.2014;2014;11;21;Keskiviikko;4;4;8;1;5;6
109;19.11.2014;2014;11;22;Keskiviikko;5;6;11;1;1;2
109;19.11.2014;2014;11;23;Keskiviikko;2;0;2;0;0;0
109;20.11.2014;2014;11;00;Torstai;0;0;0;0;0;0
109;20.11.2014;2014;11;01;Torstai;1;0;1;2;0;2
109;20.11.2014;2014;11;02;Torstai;1;1;2;3;0;3
109;20.11.2014;2014;11;03;Torstai;0;1;1;0;1;1
109;20.11.2014;2014;11;04;Torstai;1;0;1;0;0;0
109;20.11.2014;2014;11;05;Torstai;2;1;3;0;1;1
109;20.11.2014;2014;11;06;Torstai;12;20;32;3;0;3
109;20.11.2014;2014;11;07;Torstai;28;48;76;7;6;13
109;20.11.2014;2014;11;08;Torstai;19;49;68;2;4;6
109;20.11.2014;2014;11;09;Torstai;11;15;26;6;3;9
109;20.11.2014;2014;11;10;Torstai;6;11;17;4;3;7
109;20.11.2014;2014;11;11;Torstai;6;9;15;4;6;10
109;20.11.2014;2014;11;12;Torstai;10;10;20;2;4;6
109;20.11.2014;2014;11;13;Torstai;9;8;17;1;0;1
109;20.11.2014;2014;11;14;Torstai;23;11;34;0;5;5
109;20.11.2014;2014;11;15;Torstai;24;14;38;6;1;7
109;20.11.2014;2014;11;16;Torstai;52;26;78;8;5;13
109;20.11.2014;2014;11;17;Torstai;19;15;34;7;3;10
109;20.11.2014;2014;11;18;Torstai;15;9;24;3;3;6
109;20.11.2014;2014;11;19;Torstai;10;4;14;6;7;13
109;20.11.2014;2014;11;20;Torstai;9;7;16;6;3;9
109;20.11.2014;2014;11;21;Torstai;8;6;14;5;3;8
109;20.11.2014;2014;11;22;Torstai;4;3;7;1;0;1
109;20.11.2014;2014;11;23;Torstai;2;1;3;1;0;1
109;21.11.2014;2014;11;00;Perjantai;1;0;1;0;0;0
109;21.11.2014;2014;11;01;Perjantai;3;0;3;0;0;0
109;21.11.2014;2014;11;02;Perjantai;0;0;0;0;0;0
109;21.11.2014;2014;11;03;Perjantai;1;0;1;0;0;0
109;21.11.2014;2014;11;04;Perjantai;2;0;2;0;0;0
109;21.11.2014;2014;11;05;Perjantai;6;0;6;1;0;1
109;21.11.2014;2014;11;06;Perjantai;25;5;30;2;0;2
109;21.11.2014;2014;11;07;Perjantai;65;1;66;8;1;9
109;21.11.2014;2014;11;08;Perjantai;53;1;54;6;0;6
109;21.11.2014;2014;11;09;Perjantai;24;0;24;7;0;7
109;21.11.2014;2014;11;10;Perjantai;12;0;12;6;0;6
109;21.11.2014;2014;11;11;Perjantai;15;1;16;5;1;6
109;21.11.2014;2014;11;12;Perjantai;19;2;21;5;0;5
109;21.11.2014;2014;11;13;Perjantai;24;2;26;7;0;7
109;21.11.2014;2014;11;14;Perjantai;40;5;45;6;1;7
109;21.11.2014;2014;11;15;Perjantai;52;3;55;6;3;9
109;21.11.2014;2014;11;16;Perjantai;44;5;49;6;3;9
109;21.11.2014;2014;11;17;Perjantai;24;11;35;2;2;4
109;21.11.2014;2014;11;18;Perjantai;15;8;23;8;1;9
109;21.11.2014;2014;11;19;Perjantai;8;5;13;6;5;11
109;21.11.2014;2014;11;20;Perjantai;4;0;4;2;1;3
109;21.11.2014;2014;11;21;Perjantai;2;2;4;4;2;6
109;21.11.2014;2014;11;22;Perjantai;6;2;8;1;1;2
109;21.11.2014;2014;11;23;Perjantai;1;3;4;3;1;4
109;22.11.2014;2014;11;00;Lauantai;0;2;2;0;0;0
109;22.11.2014;2014;11;01;Lauantai;2;0;2;0;0;0
109;22.11.2014;2014;11;02;Lauantai;2;0;2;0;0;0
109;22.11.2014;2014;11;03;Lauantai;1;1;2;0;0;0
109;22.11.2014;2014;11;04;Lauantai;0;0;0;0;0;0
109;22.11.2014;2014;11;05;Lauantai;2;0;2;3;0;3
109;22.11.2014;2014;11;06;Lauantai;1;6;7;1;1;2
109;22.11.2014;2014;11;07;Lauantai;2;2;4;4;0;4
109;22.11.2014;2014;11;08;Lauantai;3;1;4;2;1;3
109;22.11.2014;2014;11;09;Lauantai;4;1;5;2;1;3
109;22.11.2014;2014;11;10;Lauantai;4;3;7;4;4;8
109;22.11.2014;2014;11;11;Lauantai;4;2;6;8;4;12
109;22.11.2014;2014;11;12;Lauantai;7;4;11;3;0;3
109;22.11.2014;2014;11;13;Lauantai;11;6;17;2;4;6
109;22.11.2014;2014;11;14;Lauantai;8;4;12;1;1;2
109;22.11.2014;2014;11;15;Lauantai;7;4;11;2;7;9
109;22.11.2014;2014;11;16;Lauantai;9;2;11;4;2;6
109;22.11.2014;2014;11;17;Lauantai;0;5;5;5;3;8
109;22.11.2014;2014;11;18;Lauantai;6;9;15;1;6;7
109;22.11.2014;2014;11;19;Lauantai;1;5;6;3;4;7
109;22.11.2014;2014;11;20;Lauantai;3;3;6;3;2;5
109;22.11.2014;2014;11;21;Lauantai;5;6;11;1;4;5
109;22.11.2014;2014;11;22;Lauantai;0;1;1;1;1;2
109;22.11.2014;2014;11;23;Lauantai;3;2;5;0;1;1
109;23.11.2014;2014;11;00;Sunnuntai;1;1;2;3;0;3
109;23.11.2014;2014;11;01;Sunnuntai;2;0;2;0;0;0
109;23.11.2014;2014;11;02;Sunnuntai;0;0;0;0;0;0
109;23.11.2014;2014;11;03;Sunnuntai;1;0;1;0;0;0
109;23.11.2014;2014;11;04;Sunnuntai;8;0;8;0;0;0
109;23.11.2014;2014;11;05;Sunnuntai;1;0;1;0;0;0
109;23.11.2014;2014;11;06;Sunnuntai;1;4;5;0;1;1
109;23.11.2014;2014;11;07;Sunnuntai;1;1;2;2;3;5
109;23.11.2014;2014;11;08;Sunnuntai;0;1;1;2;2;4
109;23.11.2014;2014;11;09;Sunnuntai;1;5;6;3;5;8
109;23.11.2014;2014;11;10;Sunnuntai;6;4;10;2;4;6
109;23.11.2014;2014;11;11;Sunnuntai;6;6;12;3;9;12
109;23.11.2014;2014;11;12;Sunnuntai;6;12;18;0;4;4
109;23.11.2014;2014;11;13;Sunnuntai;4;7;11;4;3;7
109;23.11.2014;2014;11;14;Sunnuntai;6;10;16;2;6;8
109;23.11.2014;2014;11;15;Sunnuntai;4;3;7;3;7;10
109;23.11.2014;2014;11;16;Sunnuntai;4;3;7;6;5;11
109;23.11.2014;2014;11;17;Sunnuntai;3;8;11;4;8;12
109;23.11.2014;2014;11;18;Sunnuntai;2;10;12;4;10;14
109;23.11.2014;2014;11;19;Sunnuntai;6;6;12;5;11;16
109;23.11.2014;2014;11;20;Sunnuntai;3;2;5;5;1;6
109;23.11.2014;2014;11;21;Sunnuntai;5;1;6;2;1;3
109;23.11.2014;2014;11;22;Sunnuntai;1;0;1;1;0;1
109;23.11.2014;2014;11;23;Sunnuntai;1;0;1;0;0;0
109;24.11.2014;2014;11;00;Maanantai;0;0;0;0;0;0
109;24.11.2014;2014;11;01;Maanantai;0;0;0;0;0;0
109;24.11.2014;2014;11;02;Maanantai;0;0;0;1;0;1
109;24.11.2014;2014;11;03;Maanantai;0;0;0;0;0;0
109;24.11.2014;2014;11;04;Maanantai;0;1;1;0;0;0
109;24.11.2014;2014;11;05;Maanantai;0;2;2;0;1;1
109;24.11.2014;2014;11;06;Maanantai;11;19;30;2;2;4
109;24.11.2014;2014;11;07;Maanantai;23;38;61;3;7;10
109;24.11.2014;2014;11;08;Maanantai;26;38;64;6;1;7
109;24.11.2014;2014;11;09;Maanantai;6;15;21;0;3;3
109;24.11.2014;2014;11;10;Maanantai;5;10;15;5;4;9
109;24.11.2014;2014;11;11;Maanantai;5;9;14;4;6;10
109;24.11.2014;2014;11;12;Maanantai;9;13;22;2;2;4
109;24.11.2014;2014;11;13;Maanantai;11;8;19;4;4;8
109;24.11.2014;2014;11;14;Maanantai;23;11;34;2;6;8
109;24.11.2014;2014;11;15;Maanantai;29;11;40;6;4;10
109;24.11.2014;2014;11;16;Maanantai;58;32;90;9;6;15
109;24.11.2014;2014;11;17;Maanantai;33;13;46;2;5;7
109;24.11.2014;2014;11;18;Maanantai;7;4;11;1;3;4
109;24.11.2014;2014;11;19;Maanantai;6;3;9;7;7;14
109;24.11.2014;2014;11;20;Maanantai;3;7;10;0;5;5
109;24.11.2014;2014;11;21;Maanantai;6;0;6;1;0;1
109;24.11.2014;2014;11;22;Maanantai;4;5;9;2;1;3
109;24.11.2014;2014;11;23;Maanantai;1;0;1;1;1;2
109;25.11.2014;2014;11;00;Tiistai;0;0;0;0;0;0
109;25.11.2014;2014;11;01;Tiistai;0;0;0;1;0;1
109;25.11.2014;2014;11;02;Tiistai;1;0;1;0;0;0
109;25.11.2014;2014;11;03;Tiistai;0;0;0;0;1;1
109;25.11.2014;2014;11;04;Tiistai;0;1;1;0;0;0
109;25.11.2014;2014;11;05;Tiistai;0;2;2;0;0;0
109;25.11.2014;2014;11;06;Tiistai;8;17;25;0;1;1
109;25.11.2014;2014;11;07;Tiistai;23;42;65;6;3;9
109;25.11.2014;2014;11;08;Tiistai;20;56;76;6;2;8
109;25.11.2014;2014;11;09;Tiistai;7;14;21;1;6;7
109;25.11.2014;2014;11;10;Tiistai;12;4;16;0;5;5
109;25.11.2014;2014;11;11;Tiistai;7;5;12;2;5;7
109;25.11.2014;2014;11;12;Tiistai;8;11;19;3;2;5
109;25.11.2014;2014;11;13;Tiistai;10;9;19;2;2;4
109;25.11.2014;2014;11;14;Tiistai;19;10;29;8;1;9
109;25.11.2014;2014;11;15;Tiistai;38;15;53;2;6;8
109;25.11.2014;2014;11;16;Tiistai;45;21;66;6;7;13
109;25.11.2014;2014;11;17;Tiistai;24;21;45;5;3;8
109;25.11.2014;2014;11;18;Tiistai;18;10;28;4;8;12
109;25.11.2014;2014;11;19;Tiistai;13;8;21;1;6;7
109;25.11.2014;2014;11;20;Tiistai;10;4;14;4;4;8
109;25.11.2014;2014;11;21;Tiistai;9;0;9;4;1;5
109;25.11.2014;2014;11;22;Tiistai;2;3;5;4;2;6
109;25.11.2014;2014;11;23;Tiistai;1;0;1;0;0;0
109;26.11.2014;2014;11;00;Keskiviikko;0;0;0;0;1;1
109;26.11.2014;2014;11;01;Keskiviikko;0;0;0;1;0;1
109;26.11.2014;2014;11;02;Keskiviikko;0;0;0;1;1;2
109;26.11.2014;2014;11;03;Keskiviikko;1;0;1;0;0;0
109;26.11.2014;2014;11;04;Keskiviikko;1;0;1;0;0;0
109;26.11.2014;2014;11;05;Keskiviikko;2;2;4;1;1;2
109;26.11.2014;2014;11;06;Keskiviikko;14;15;29;1;1;2
109;26.11.2014;2014;11;07;Keskiviikko;43;36;79;7;3;10
109;26.11.2014;2014;11;08;Keskiviikko;30;29;59;2;7;9
109;26.11.2014;2014;11;09;Keskiviikko;11;10;21;1;3;4
109;26.11.2014;2014;11;10;Keskiviikko;5;9;14;3;2;5
109;26.11.2014;2014;11;11;Keskiviikko;16;8;24;2;4;6
109;26.11.2014;2014;11;12;Keskiviikko;11;5;16;1;3;4
109;26.11.2014;2014;11;13;Keskiviikko;12;4;16;4;3;7
109;26.11.2014;2014;11;14;Keskiviikko;22;12;34;5;4;9
109;26.11.2014;2014;11;15;Keskiviikko;28;6;34;2;3;5
109;26.11.2014;2014;11;16;Keskiviikko;46;28;74;5;4;9
109;26.11.2014;2014;11;17;Keskiviikko;29;10;39;6;9;15
109;26.11.2014;2014;11;18;Keskiviikko;16;9;25;7;5;12
109;26.11.2014;2014;11;19;Keskiviikko;4;10;14;2;4;6
109;26.11.2014;2014;11;20;Keskiviikko;9;3;12;9;5;14
109;26.11.2014;2014;11;21;Keskiviikko;8;1;9;1;3;4
109;26.11.2014;2014;11;22;Keskiviikko;4;2;6;1;0;1
109;26.11.2014;2014;11;23;Keskiviikko;2;1;3;0;0;0
109;27.11.2014;2014;11;00;Torstai;0;1;1;1;0;1
109;27.11.2014;2014;11;01;Torstai;0;0;0;2;0;2
109;27.11.2014;2014;11;02;Torstai;0;0;0;0;1;1
109;27.11.2014;2014;11;03;Torstai;0;0;0;0;1;1
109;27.11.2014;2014;11;04;Torstai;1;0;1;0;0;0
109;27.11.2014;2014;11;05;Torstai;3;3;6;3;1;4
109;27.11.2014;2014;11;06;Torstai;20;13;33;3;2;5
109;27.11.2014;2014;11;07;Torstai;32;29;61;10;8;18
109;27.11.2014;2014;11;08;Torstai;27;32;59;6;3;9
109;27.11.2014;2014;11;09;Torstai;9;11;20;7;3;10
109;27.11.2014;2014;11;10;Torstai;13;11;24;3;6;9
109;27.11.2014;2014;11;11;Torstai;4;9;13;3;1;4
109;27.11.2014;2014;11;12;Torstai;8;6;14;1;3;4
109;27.11.2014;2014;11;13;Torstai;17;2;19;3;4;7
109;27.11.2014;2014;11;14;Torstai;17;9;26;4;3;7
109;27.11.2014;2014;11;15;Torstai;35;16;51;7;4;11
109;27.11.2014;2014;11;16;Torstai;52;25;77;4;4;8
109;27.11.2014;2014;11;17;Torstai;20;13;33;4;7;11
109;27.11.2014;2014;11;18;Torstai;8;10;18;5;6;11
109;27.11.2014;2014;11;19;Torstai;12;4;16;6;2;8
109;27.11.2014;2014;11;20;Torstai;8;5;13;1;1;2
109;27.11.2014;2014;11;21;Torstai;7;4;11;2;5;7
109;27.11.2014;2014;11;22;Torstai;2;6;8;3;0;3
109;27.11.2014;2014;11;23;Torstai;0;4;4;1;1;2
109;28.11.2014;2014;11;00;Perjantai;3;0;3;1;0;1
109;28.11.2014;2014;11;01;Perjantai;0;0;0;1;0;1
109;28.11.2014;2014;11;02;Perjantai;2;0;2;0;2;2
109;28.11.2014;2014;11;03;Perjantai;0;0;0;0;0;0
109;28.11.2014;2014;11;04;Perjantai;3;0;3;0;0;0
109;28.11.2014;2014;11;05;Perjantai;1;2;3;2;0;2
109;28.11.2014;2014;11;06;Perjantai;13;13;26;3;0;3
109;28.11.2014;2014;11;07;Perjantai;33;25;58;8;5;13
109;28.11.2014;2014;11;08;Perjantai;23;27;50;4;3;7
109;28.11.2014;2014;11;09;Perjantai;15;15;30;1;4;5
109;28.11.2014;2014;11;10;Perjantai;6;7;13;2;0;2
109;28.11.2014;2014;11;11;Perjantai;12;6;18;7;1;8
109;28.11.2014;2014;11;12;Perjantai;13;6;19;1;2;3
109;28.11.2014;2014;11;13;Perjantai;20;6;26;5;4;9
109;28.11.2014;2014;11;14;Perjantai;26;3;29;2;3;5
109;28.11.2014;2014;11;15;Perjantai;38;10;48;9;6;15
109;28.11.2014;2014;11;16;Perjantai;38;15;53;6;3;9
109;28.11.2014;2014;11;17;Perjantai;25;5;30;7;8;15
109;28.11.2014;2014;11;18;Perjantai;11;4;15;5;2;7
109;28.11.2014;2014;11;19;Perjantai;8;3;11;6;4;10
109;28.11.2014;2014;11;20;Perjantai;1;13;14;1;3;4
109;28.11.2014;2014;11;21;Perjantai;4;1;5;5;1;6
109;28.11.2014;2014;11;22;Perjantai;3;4;7;1;1;2
109;28.11.2014;2014;11;23;Perjantai;1;2;3;0;0;0
109;29.11.2014;2014;11;00;Lauantai;0;3;3;1;1;2
109;29.11.2014;2014;11;01;Lauantai;3;1;4;0;0;0
109;29.11.2014;2014;11;02;Lauantai;3;0;3;0;0;0
109;29.11.2014;2014;11;03;Lauantai;1;1;2;0;0;0
109;29.11.2014;2014;11;04;Lauantai;1;0;1;1;0;1
109;29.11.2014;2014;11;05;Lauantai;0;0;0;1;0;1
109;29.11.2014;2014;11;06;Lauantai;1;1;2;1;1;2
109;29.11.2014;2014;11;07;Lauantai;6;0;6;2;2;4
109;29.11.2014;2014;11;08;Lauantai;0;0;0;1;0;1
109;29.11.2014;2014;11;09;Lauantai;3;4;7;3;3;6
109;29.11.2014;2014;11;10;Lauantai;7;7;14;6;2;8
109;29.11.2014;2014;11;11;Lauantai;3;3;6;6;2;8
109;29.11.2014;2014;11;12;Lauantai;12;5;17;3;3;6
109;29.11.2014;2014;11;13;Lauantai;12;3;15;3;6;9
109;29.11.2014;2014;11;14;Lauantai;4;9;13;6;2;8
109;29.11.2014;2014;11;15;Lauantai;8;3;11;1;2;3
109;29.11.2014;2014;11;16;Lauantai;6;6;12;4;5;9
109;29.11.2014;2014;11;17;Lauantai;9;10;19;2;3;5
109;29.11.2014;2014;11;18;Lauantai;3;1;4;3;3;6
109;29.11.2014;2014;11;19;Lauantai;3;8;11;5;1;6
109;29.11.2014;2014;11;20;Lauantai;3;5;8;3;3;6
109;29.11.2014;2014;11;21;Lauantai;6;0;6;2;1;3
109;29.11.2014;2014;11;22;Lauantai;6;2;8;1;1;2
109;29.11.2014;2014;11;23;Lauantai;7;1;8;1;0;1
109;30.11.2014;2014;11;00;Sunnuntai;1;0;1;1;0;1
109;30.11.2014;2014;11;01;Sunnuntai;0;5;5;1;0;1
109;30.11.2014;2014;11;02;Sunnuntai;1;0;1;0;0;0
109;30.11.2014;2014;11;03;Sunnuntai;0;0;0;0;0;0
109;30.11.2014;2014;11;04;Sunnuntai;1;0;1;0;0;0
109;30.11.2014;2014;11;05;Sunnuntai;1;1;2;0;0;0
109;30.11.2014;2014;11;06;Sunnuntai;2;3;5;2;0;2
109;30.11.2014;2014;11;07;Sunnuntai;3;0;3;1;2;3
109;30.11.2014;2014;11;08;Sunnuntai;1;0;1;4;1;5
109;30.11.2014;2014;11;09;Sunnuntai;4;1;5;3;3;6
109;30.11.2014;2014;11;10;Sunnuntai;1;5;6;7;5;12
109;30.11.2014;2014;11;11;Sunnuntai;5;4;9;3;5;8
109;30.11.2014;2014;11;12;Sunnuntai;3;2;5;6;3;9
109;30.11.2014;2014;11;13;Sunnuntai;4;6;10;6;3;9
109;30.11.2014;2014;11;14;Sunnuntai;5;3;8;9;4;13
109;30.11.2014;2014;11;15;Sunnuntai;9;8;17;7;5;12
109;30.11.2014;2014;11;16;Sunnuntai;3;7;10;3;5;8
109;30.11.2014;2014;11;17;Sunnuntai;2;11;13;6;6;12
109;30.11.2014;2014;11;18;Sunnuntai;5;9;14;4;5;9
109;30.11.2014;2014;11;19;Sunnuntai;4;4;8;4;4;8
109;30.11.2014;2014;11;20;Sunnuntai;4;2;6;1;4;5
109;30.11.2014;2014;11;21;Sunnuntai;6;1;7;3;2;5
109;30.11.2014;2014;11;22;Sunnuntai;2;1;3;2;1;3
109;30.11.2014;2014;11;23;Sunnuntai;2;0;2;0;0;0
109;01.12.2014;2014;12;00;Maanantai;0;0;0;0;0;0
109;01.12.2014;2014;12;01;Maanantai;0;0;0;0;0;0
109;01.12.2014;2014;12;02;Maanantai;0;0;0;1;0;1
109;01.12.2014;2014;12;03;Maanantai;0;0;0;0;0;0
109;01.12.2014;2014;12;04;Maanantai;0;1;1;0;0;0
109;01.12.2014;2014;12;05;Maanantai;0;2;2;0;1;1
109;01.12.2014;2014;12;06;Maanantai;11;19;30;2;2;4
109;01.12.2014;2014;12;07;Maanantai;23;38;61;3;7;10
109;01.12.2014;2014;12;08;Maanantai;26;38;64;6;1;7
109;01.12.2014;2014;12;09;Maanantai;6;15;21;0;3;3
109;01.12.2014;2014;12;10;Maanantai;5;10;15;5;4;9
109;01.12.2014;2014;12;11;Maanantai;5;9;14;4;6;10
109;01.12.2014;2014;12;12;Maanantai;9;13;22;2;2;4
109;01.12.2014;2014;12;13;Maanantai;11;8;19;4;4;8
109;01.12.2014;2014;12;14;Maanantai;23;11;34;2;6;8
109;01.12.2014;2014;12;15;Maanantai;29;11;40;6;4;10
109;01.12.2014;2014;12;16;Maanantai;58;32;90;9;6;15
109;01.12.2014;2014;12;17;Maanantai;33;13;46;2;5;7
109;01.12.2014;2014;12;18;Maanantai;7;4;11;1;3;4
109;01.12.2014;2014;12;19;Maanantai;6;3;9;7;7;14
109;01.12.2014;2014;12;20;Maanantai;3;7;10;0;5;5
109;01.12.2014;2014;12;21;Maanantai;6;0;6;1;0;1
109;01.12.2014;2014;12;22;Maanantai;4;5;9;2;1;3
109;01.12.2014;2014;12;23;Maanantai;1;0;1;1;1;2
109;02.12.2014;2014;12;00;Tiistai;2;0;2;0;0;0
109;02.12.2014;2014;12;01;Tiistai;0;0;0;0;0;0
109;02.12.2014;2014;12;02;Tiistai;1;0;1;0;0;0
109;02.12.2014;2014;12;03;Tiistai;0;0;0;0;0;0
109;02.12.2014;2014;12;04;Tiistai;0;0;0;0;0;0
109;02.12.2014;2014;12;05;Tiistai;4;2;6;0;0;0
109;02.12.2014;2014;12;06;Tiistai;13;12;25;5;3;8
109;02.12.2014;2014;12;07;Tiistai;32;31;63;10;10;20
109;02.12.2014;2014;12;08;Tiistai;32;30;62;11;8;19
109;02.12.2014;2014;12;09;Tiistai;12;9;21;4;3;7
109;02.12.2014;2014;12;10;Tiistai;13;10;23;5;2;7
109;02.12.2014;2014;12;11;Tiistai;11;8;19;4;1;5
109;02.12.2014;2014;12;12;Tiistai;7;5;12;3;1;4
109;02.12.2014;2014;12;13;Tiistai;11;11;22;4;3;7
109;02.12.2014;2014;12;14;Tiistai;23;11;34;3;2;5
109;02.12.2014;2014;12;15;Tiistai;29;11;40;6;4;10
109;02.12.2014;2014;12;16;Tiistai;50;30;80;9;6;15
109;02.12.2014;2014;12;17;Tiistai;30;12;42;2;5;7
109;02.12.2014;2014;12;18;Tiistai;7;4;11;1;3;4
109;02.12.2014;2014;12;19;Tiistai;6;3;9;7;7;14
109;02.12.2014;2014;12;20;Tiistai;3;7;10;0;5;5
109;02.12.2014;2014;12;21;Tiistai;6;0;6;1;0;1
109;02.12.2014;2014;12;22;Tiistai;4;5;9;2;1;3
109;02.12.2014;2014;12;23;Tiistai;1;0;1;1;1;2
109;03.12.2014;2014;12;00;Keskiviikko;2;0;2;0;0;0
109;03.12.2014;2014;12;01;Keskiviikko;2;1;3;1;0;1
109;03.12.2014;2014;12;02;Keskiviikko;0;0;0;0;0;0
109;03.12.2014;2014;12;03;Keskiviikko;1;0;1;1;0;1
109;03.12.2014;2014;12;04;Keskiviikko;2;0;2;0;0;0
109;03.12.2014;2014;12;05;Keskiviikko;5;3;8;2;1;3
109;03.12.2014;2014;12;06;Keskiviikko;13;12;25;6;4;10
109;03.12.2014;2014;12;07;Keskiviikko;26;24;50;9;8;17
109;03.12.2014;2014;12;08;Keskiviikko;27;25;52;9;9;18
109;03.12.2014;2014;12;09;Keskiviikko;9;8;17;4;1;5
109;03.12.2014;2014;12;10;Keskiviikko;14;10;24;5;3;8
109;03.12.2014;2014;12;11;Keskiviikko;7;6;13;4;1;5
109;03.12.2014;2014;12;12;Keskiviikko;10;10;20;5;2;7
109;03.12.2014;2014;12;13;Keskiviikko;11;10;21;5;2;7
109;03.12.2014;2014;12;14;Keskiviikko;16;14;30;5;5;10
109;03.12.2014;2014;12;15;Keskiviikko;19;19;38;8;6;14
109;03.12.2014;2014;12;16;Keskiviikko;32;30;62;12;10;22
109;03.12.2014;2014;12;17;Keskiviikko;13;11;24;6;3;9
109;03.12.2014;2014;12;18;Keskiviikko;8;7;15;4;2;6
109;03.12.2014;2014;12;19;Keskiviikko;6;5;11;4;1;5
109;03.12.2014;2014;12;20;Keskiviikko;4;2;6;3;0;3
109;03.12.2014;2014;12;21;Keskiviikko;6;3;9;3;0;3
109;03.12.2014;2014;12;22;Keskiviikko;4;1;5;2;0;2
109;03.12.2014;2014;12;23;Keskiviikko;1;1;2;1;0;1
109;04.12.2014;2014;12;00;Torstai;1;0;1;0;0;0
109;04.12.2014;2014;12;01;Torstai;1;0;1;0;0;0
109;04.12.2014;2014;12;02;Torstai;0;0;0;0;0;0
109;04.12.2014;2014;12;03;Torstai;1;0;1;0;0;0
109;04.12.2014;2014;12;04;Torstai;1;0;1;1;0;1
109;04.12.2014;2014;12;05;Torstai;4;1;5;1;0;1
109;04.12.2014;2014;12;06;Torstai;12;11;23;6;3;9
109;04.12.2014;2014;12;07;Torstai;24;21;45;10;8;18
109;04.12.2014;2014;12;08;Torstai;24;21;45;9;8;17
109;04.12.2014;2014;12;09;Torstai;9;6;15;4;3;7
109;04.12.2014;2014;12;10;Torstai;7;5;12;4;0;4
109;04.12.2014;2014;12;11;Torstai;9;7;16;3;3;6
109;04.12.2014;2014;12;12;Torstai;11;9;20;5;4;9
109;04.12.2014;2014;12;13;Torstai;12;10;22;5;4;9
109;04.12.2014;2014;12;14;Torstai;16;14;30;6;5;11
109;04.12.2014;2014;12;15;Torstai;21;19;40;7;7;14
109;04.12.2014;2014;12;16;Torstai;31;27;58;11;11;22
109;04.12.2014;2014;12;17;Torstai;19;17;36;7;6;13
109;04.12.2014;2014;12;18;Torstai;10;8;18;5;2;7
109;04.12.2014;2014;12;19;Torstai;7;5;12;4;2;6
109;04.12.2014;2014;12;20;Torstai;8;6;14;4;1;5
109;04.12.2014;2014;12;21;Torstai;6;2;8;4;0;4
109;04.12.2014;2014;12;22;Torstai;3;2;5;2;0;2
109;04.12.2014;2014;12;23;Torstai;2;0;2;0;0;0
109;05.12.2014;2014;12;00;Perjantai;0;0;0;0;0;0
109;05.12.2014;2014;12;01;Perjantai;0;0;0;0;0;0
109;05.12.2014;2014;12;02;Perjantai;0;0;0;0;0;0
109;05.12.2014;2014;12;03;Perjantai;1;0;1;0;0;0
109;05.12.2014;2014;12;04;Perjantai;2;0;2;1;0;1
109;05.12.2014;2014;12;05;Perjantai;3;1;4;2;0;2
109;05.12.2014;2014;12;06;Perjantai;9;5;14;4;2;6
109;05.12.2014;2014;12;07;Perjantai;23;21;44;10;7;17
109;05.12.2014;2014;12;08;Perjantai;20;16;36;7;6;13
109;05.12.2014;2014;12;09;Perjantai;11;9;20;4;3;7
109;05.12.2014;2014;12;10;Perjantai;7;6;13;4;1;5
109;05.12.2014;2014;12;11;Perjantai;5;4;9;4;1;5
109;05.12.2014;2014;12;12;Perjantai;12;11;23;6;2;8
109;05.12.2014;2014;12;13;Perjantai;6;5;11;4;1;5
109;05.12.2014;2014;12;14;Perjantai;17;14;31;6;4;10
109;05.12.2014;2014;12;15;Perjantai;17;14;31;6;5;11
109;05.12.2014;2014;12;16;Perjantai;18;15;33;8;6;14
109;05.12.2014;2014;12;17;Perjantai;10;8;18;5;2;7
109;05.12.2014;2014;12;18;Perjantai;9;7;16;4;3;7
109;05.12.2014;2014;12;19;Perjantai;8;5;13;4;1;5
109;05.12.2014;2014;12;20;Perjantai;5;4;9;3;0;3
109;05.12.2014;2014;12;21;Perjantai;6;4;10;3;1;4
109;05.12.2014;2014;12;22;Perjantai;4;2;6;3;0;3
109;05.12.2014;2014;12;23;Perjantai;3;0;3;1;0;1
109;06.12.2014;2014;12;00;Lauantai;3;0;3;2;0;2
109;06.12.2014;2014;12;01;Lauantai;0;0;0;0;0;0
109;06.12.2014;2014;12;02;Lauantai;0;0;0;0;0;0
109;06.12.2014;2014;12;03;Lauantai;0;0;0;0;0;0
109;06.12.2014;2014;12;04;Lauantai;1;0;1;1;0;1
109;06.12.2014;2014;12;05;Lauantai;1;0;1;0;0;0
109;06.12.2014;2014;12;06;Lauantai;3;0;3;0;0;0
109;06.12.2014;2014;12;07;Lauantai;2;0;2;2;0;2
109;06.12.2014;2014;12;08;Lauantai;4;0;4;1;0;1
109;06.12.2014;2014;12;09;Lauantai;4;1;5;4;0;4
109;06.12.2014;2014;12;10;Lauantai;6;4;10;5;3;8
109;06.12.2014;2014;12;11;Lauantai;6;4;10;4;4;8
109;06.12.2014;2014;12;12;Lauantai;5;4;9;5;2;7
109;06.12.2014;2014;12;13;Lauantai;5;2;7;3;2;5
109;06.12.2014;2014;12;14;Lauantai;4;2;6;3;1;4
109;06.12.2014;2014;12;15;Lauantai;7;4;11;5;4;9
109;06.12.2014;2014;12;16;Lauantai;6;5;11;6;4;10
109;06.12.2014;2014;12;17;Lauantai;5;4;9;5;3;8
109;06.12.2014;2014;12;18;Lauantai;5;4;9;4;3;7
109;06.12.2014;2014;12;19;Lauantai;3;2;5;2;1;3
109;06.12.2014;2014;12;20;Lauantai;3;2;5;3;0;3
109;06.12.2014;2014;12;21;Lauantai;5;3;8;3;2;5
109;06.12.2014;2014;12;22;Lauantai;4;1;5;2;1;3
109;06.12.2014;2014;12;23;Lauantai;0;0;0;0;0;0
109;07.12.2014;2014;12;00;Sunnuntai;1;0;1;1;0;1
109;07.12.2014;2014;12;01;Sunnuntai;2;1;3;1;0;1
109;07.12.2014;2014;12;02;Sunnuntai;1;0;1;0;0;0
109;07.12.2014;2014;12;03;Sunnuntai;1;0;1;0;0;0
109;07.12.2014;2014;12;04;Sunnuntai;1;1;2;1;0;1
109;07.12.2014;2014;12;05;Sunnuntai;3;0;3;0;0;0
109;07.12.2014;2014;12;06;Sunnuntai;1;0;1;0;0;0
109;07.12.2014;2014;12;07;Sunnuntai;3;0;3;1;0;1
109;07.12.2014;2014;12;08;Sunnuntai;2;0;2;0;0;0
109;07.12.2014;2014;12;09;Sunnuntai;5;3;8;5;2;7
109;07.12.2014;2014;12;10;Sunnuntai;5;4;9;4;2;6
109;07.12.2014;2014;12;11;Sunnuntai;5;3;8;5;2;7
109;07.12.2014;2014;12;12;Sunnuntai;7;6;13;7;4;11
109;07.12.2014;2014;12;13;Sunnuntai;7;5;12;6;3;9
109;07.12.2014;2014;12;14;Sunnuntai;5;4;9;4;2;6
109;07.12.2014;2014;12;15;Sunnuntai;6;3;9;5;2;7
109;07.12.2014;2014;12;16;Sunnuntai;4;3;7;4;3;7
109;07.12.2014;2014;12;17;Sunnuntai;7;5;12;5;4;9
109;07.12.2014;2014;12;18;Sunnuntai;6;4;10;6;4;10
109;07.12.2014;2014;12;19;Sunnuntai;4;3;7;4;3;7
109;07.12.2014;2014;12;20;Sunnuntai;4;2;6;3;2;5
109;07.12.2014;2014;12;21;Sunnuntai;4;2;6;4;1;5
109;07.12.2014;2014;12;22;Sunnuntai;4;0;4;2;0;2
109;07.12.2014;2014;12;23;Sunnuntai;1;0;1;0;0;0
109;08.12.2014;2014;12;00;Maanantai;0;0;0;0;0;0
109;08.12.2014;2014;12;01;Maanantai;0;2;2;0;0;0
109;08.12.2014;2014;12;02;Maanantai;1;0;1;0;0;0
109;08.12.2014;2014;12;03;Maanantai;0;0;0;0;0;0
109;08.12.2014;2014;12;04;Maanantai;1;0;1;0;0;0
109;08.12.2014;2014;12;05;Maanantai;2;2;4;0;2;2
109;08.12.2014;2014;12;06;Maanantai;12;10;22;7;3;10
109;08.12.2014;2014;12;07;Maanantai;21;23;44;9;10;19
109;08.12.2014;2014;12;08;Maanantai;20;19;39;10;7;17
109;08.12.2014;2014;12;09;Maanantai;8;8;16;2;4;6
109;08.12.2014;2014;12;10;Maanantai;12;9;21;6;3;9
109;08.12.2014;2014;12;11;Maanantai;5;5;10;1;3;4
109;08.12.2014;2014;12;12;Maanantai;9;8;17;4;4;8
109;08.12.2014;2014;12;13;Maanantai;6;7;13;2;3;5
109;08.12.2014;2014;12;14;Maanantai;14;13;27;7;5;12
109;08.12.2014;2014;12;15;Maanantai;14;16;30;5;8;13
109;08.12.2014;2014;12;16;Maanantai;33;30;63;13;12;25
109;08.12.2014;2014;12;17;Maanantai;11;13;24;4;6;10
109;08.12.2014;2014;12;18;Maanantai;16;13;29;8;5;13
109;08.12.2014;2014;12;19;Maanantai;11;11;22;3;5;8
109;08.12.2014;2014;12;20;Maanantai;8;6;14;4;2;6
109;08.12.2014;2014;12;21;Maanantai;3;4;7;0;3;3
109;08.12.2014;2014;12;22;Maanantai;4;1;5;3;0;3
109;08.12.2014;2014;12;23;Maanantai;1;5;6;0;3;3
109;09.12.2014;2014;12;00;Tiistai;2;0;2;0;0;0
109;09.12.2014;2014;12;01;Tiistai;0;1;1;0;1;1
109;09.12.2014;2014;12;02;Tiistai;0;0;0;0;0;0
109;09.12.2014;2014;12;03;Tiistai;0;1;1;0;0;0
109;09.12.2014;2014;12;04;Tiistai;0;0;0;0;0;0
109;09.12.2014;2014;12;05;Tiistai;1;3;4;0;2;2
109;09.12.2014;2014;12;06;Tiistai;13;12;25;6;4;10
109;09.12.2014;2014;12;07;Tiistai;30;32;62;12;14;26
109;09.12.2014;2014;12;08;Tiistai;24;22;46;11;8;19
109;09.12.2014;2014;12;09;Tiistai;11;13;24;4;5;9
109;09.12.2014;2014;12;10;Tiistai;8;6;14;4;0;4
109;09.12.2014;2014;12;11;Tiistai;8;9;17;2;5;7
109;09.12.2014;2014;12;12;Tiistai;8;8;16;5;3;8
109;09.12.2014;2014;12;13;Tiistai;10;10;20;4;5;9
109;09.12.2014;2014;12;14;Tiistai;10;9;19;5;3;8
109;09.12.2014;2014;12;15;Tiistai;18;21;39;6;9;15
109;09.12.2014;2014;12;16;Tiistai;36;35;71;16;14;30
109;09.12.2014;2014;12;17;Tiistai;13;13;26;6;7;13
109;09.12.2014;2014;12;18;Tiistai;17;16;33;8;5;13
109;09.12.2014;2014;12;19;Tiistai;6;7;13;2;4;6
109;09.12.2014;2014;12;20;Tiistai;6;4;10;4;1;5
109;09.12.2014;2014;12;21;Tiistai;4;7;11;1;4;5
109;09.12.2014;2014;12;22;Tiistai;7;5;12;4;2;6
109;09.12.2014;2014;12;23;Tiistai;0;3;3;0;1;1
109;10.12.2014;2014;12;00;Keskiviikko;2;0;2;0;0;0
109;10.12.2014;2014;12;01;Keskiviikko;0;1;1;0;0;0
109;10.12.2014;2014;12;02;Keskiviikko;0;0;0;0;0;0
109;10.12.2014;2014;12;03;Keskiviikko;0;1;1;0;1;1
109;10.12.2014;2014;12;04;Keskiviikko;0;0;0;0;0;0
109;10.12.2014;2014;12;05;Keskiviikko;3;6;9;0;3;3
109;10.12.2014;2014;12;06;Keskiviikko;14;11;25;6;5;11
109;10.12.2014;2014;12;07;Keskiviikko;27;28;55;10;13;23
109;10.12.2014;2014;12;08;Keskiviikko;33;32;65;15;14;29
109;10.12.2014;2014;12;09;Keskiviikko;11;13;24;3;7;10
109;10.12.2014;2014;12;10;Keskiviikko;8;6;14;4;0;4
109;10.12.2014;2014;12;11;Keskiviikko;8;10;18;2;5;7
109;10.12.2014;2014;12;12;Keskiviikko;10;9;19;6;3;9
109;10.12.2014;2014;12;13;Keskiviikko;7;9;16;2;4;6
109;10.12.2014;2014;12;14;Keskiviikko;13;12;25;7;4;11
109;10.12.2014;2014;12;15;Keskiviikko;18;21;39;8;10;18
109;10.12.2014;2014;12;16;Keskiviikko;26;25;51;12;9;21
109;10.12.2014;2014;12;17;Keskiviikko;15;15;30;5;7;12
109;10.12.2014;2014;12;18;Keskiviikko;12;8;20;6;3;9
109;10.12.2014;2014;12;19;Keskiviikko;7;9;16;2;4;6
109;10.12.2014;2014;12;20;Keskiviikko;5;3;8;3;0;3
109;10.12.2014;2014;12;21;Keskiviikko;4;7;11;2;3;5
109;10.12.2014;2014;12;22;Keskiviikko;5;3;8;3;0;3
109;10.12.2014;2014;12;23;Keskiviikko;0;2;2;0;1;1
109;11.12.2014;2014;12;00;Torstai;3;0;3;2;0;2
109;11.12.2014;2014;12;01;Torstai;0;2;2;0;1;1
109;11.12.2014;2014;12;02;Torstai;1;0;1;0;0;0
109;11.12.2014;2014;12;03;Torstai;0;0;0;0;0;0
109;11.12.2014;2014;12;04;Torstai;0;0;0;0;0;0
109;11.12.2014;2014;12;05;Torstai;1;3;4;0;3;3
109;11.12.2014;2014;12;06;Torstai;14;12;26;6;4;10
109;11.12.2014;2014;12;07;Torstai;21;24;45;9;10;19
109;11.12.2014;2014;12;08;Torstai;24;21;45;11;8;19
109;11.12.2014;2014;12;09;Torstai;10;11;21;4;5;9
109;11.12.2014;2014;12;10;Torstai;6;6;12;4;2;6
109;11.12.2014;2014;12;11;Torstai;10;10;20;3;5;8
109;11.12.2014;2014;12;12;Torstai;8;7;15;3;2;5
109;11.12.2014;2014;12;13;Torstai;6;8;14;1;5;6
109;11.12.2014;2014;12;14;Torstai;9;9;18;4;3;7
109;11.12.2014;2014;12;15;Torstai;17;21;38;7;9;16
109;11.12.2014;2014;12;16;Torstai;26;24;50;11;9;20
109;11.12.2014;2014;12;17;Torstai;14;17;31;5;8;13
109;11.12.2014;2014;12;18;Torstai;14;12;26;7;4;11
109;11.12.2014;2014;12;19;Torstai;5;7;12;1;3;4
109;11.12.2014;2014;12;20;Torstai;8;8;16;4;1;5
109;11.12.2014;2014;12;21;Torstai;2;5;7;0;1;1
109;11.12.2014;2014;12;22;Torstai;6;3;9;3;1;4
109;11.12.2014;2014;12;23;Torstai;1;3;4;0;1;1
109;12.12.2014;2014;12;00;Perjantai;3;1;4;2;0;2
109;12.12.2014;2014;12;01;Perjantai;0;1;1;0;1;1
109;12.12.2014;2014;12;02;Perjantai;0;0;0;0;0;0
109;12.12.2014;2014;12;03;Perjantai;0;0;0;0;0;0
109;12.12.2014;2014;12;04;Perjantai;2;0;2;0;0;0
109;12.12.2014;2014;12;05;Perjantai;0;4;4;0;3;3
109;12.12.2014;2014;12;06;Perjantai;9;7;16;4;2;6
109;12.12.2014;2014;12;07;Perjantai;23;26;49;9;12;21
109;12.12.2014;2014;12;08;Perjantai;21;19;40;9;8;17
109;12.12.2014;2014;12;09;Perjantai;7;9;16;2;4;6
109;12.12.2014;2014;12;10;Perjantai;7;5;12;4;0;4
109;12.12.2014;2014;12;11;Perjantai;10;11;21;3;5;8
109;12.12.2014;2014;12;12;Perjantai;8;6;14;4;2;6
109;12.12.2014;2014;12;13;Perjantai;10;12;22;4;6;10
109;12.12.2014;2014;12;14;Perjantai;13;12;25;6;4;10
109;12.12.2014;2014;12;15;Perjantai;17;20;37;6;8;14
109;12.12.2014;2014;12;16;Perjantai;16;13;29;7;5;12
109;12.12.2014;2014;12;17;Perjantai;15;17;32;5;7;12
109;12.12.2014;2014;12;18;Perjantai;7;5;12;3;2;5
109;12.12.2014;2014;12;19;Perjantai;4;5;9;0;4;4
109;12.12.2014;2014;12;20;Perjantai;6;5;11;4;1;5
109;12.12.2014;2014;12;21;Perjantai;4;6;10;1;3;4
109;12.12.2014;2014;12;22;Perjantai;7;4;11;3;0;3
109;12.12.2014;2014;12;23;Perjantai;0;2;2;0;0;0
109;13.12.2014;2014;12;00;Lauantai;3;1;4;1;1;2
109;13.12.2014;2014;12;01;Lauantai;0;1;1;0;1;1
109;13.12.2014;2014;12;02;Lauantai;1;0;1;0;0;0
109;13.12.2014;2014;12;03;Lauantai;0;2;2;0;0;0
109;13.12.2014;2014;12;04;Lauantai;2;0;2;0;0;0
109;13.12.2014;2014;12;05;Lauantai;1;3;4;0;1;1
109;13.12.2014;2014;12;06;Lauantai;3;1;4;2;0;2
109;13.12.2014;2014;12;07;Lauantai;1;2;3;0;2;2
109;13.12.2014;2014;12;08;Lauantai;4;1;5;3;1;4
109;13.12.2014;2014;12;09;Lauantai;3;4;7;0;3;3
109;13.12.2014;2014;12;10;Lauantai;5;4;9;4;3;7
109;13.12.2014;2014;12;11;Lauantai;3;6;9;3;4;7
109;13.12.2014;2014;12;12;Lauantai;7;5;12;7;4;11
109;13.12.2014;2014;12;13;Lauantai;4;7;11;4;6;10
109;13.12.2014;2014;12;14;Lauantai;6;5;11;5;4;9
109;13.12.2014;2014;12;15;Lauantai;3;6;9;2;6;8
109;13.12.2014;2014;12;16;Lauantai;7;4;11;5;3;8
109;13.12.2014;2014;12;17;Lauantai;2;5;7;1;5;6
109;13.12.2014;2014;12;18;Lauantai;7;4;11;7;3;10
109;13.12.2014;2014;12;19;Lauantai;0;4;4;0;2;2
109;13.12.2014;2014;12;20;Lauantai;4;1;5;4;0;4
109;13.12.2014;2014;12;21;Lauantai;3;3;6;3;3;6
109;13.12.2014;2014;12;22;Lauantai;5;3;8;3;3;6
109;13.12.2014;2014;12;23;Lauantai;1;4;5;1;3;4
109;14.12.2014;2014;12;00;Sunnuntai;3;0;3;1;0;1
109;14.12.2014;2014;12;01;Sunnuntai;0;1;1;0;1;1
109;14.12.2014;2014;12;02;Sunnuntai;2;0;2;0;0;0
109;14.12.2014;2014;12;03;Sunnuntai;1;1;2;1;1;2
109;14.12.2014;2014;12;04;Sunnuntai;2;0;2;0;0;0
109;14.12.2014;2014;12;05;Sunnuntai;0;2;2;0;2;2
109;14.12.2014;2014;12;06;Sunnuntai;5;1;6;4;1;5
109;14.12.2014;2014;12;07;Sunnuntai;0;4;4;0;1;1
109;14.12.2014;2014;12;08;Sunnuntai;3;1;4;1;0;1
109;14.12.2014;2014;12;09;Sunnuntai;1;4;5;1;3;4
109;14.12.2014;2014;12;10;Sunnuntai;3;2;5;3;2;5
109;14.12.2014;2014;12;11;Sunnuntai;5;7;12;4;6;10
109;14.12.2014;2014;12;12;Sunnuntai;6;6;12;6;4;10
109;14.12.2014;2014;12;13;Sunnuntai;5;9;14;5;5;10
109;14.12.2014;2014;12;14;Sunnuntai;5;4;9;4;4;8
109;14.12.2014;2014;12;15;Sunnuntai;4;7;11;4;5;9
109;14.12.2014;2014;12;16;Sunnuntai;7;6;13;7;4;11
109;14.12.2014;2014;12;17;Sunnuntai;2;4;6;1;3;4
109;14.12.2014;2014;12;18;Sunnuntai;6;5;11;5;4;9
109;14.12.2014;2014;12;19;Sunnuntai;5;6;11;2;5;7
109;14.12.2014;2014;12;20;Sunnuntai;4;4;8;4;3;7
109;14.12.2014;2014;12;21;Sunnuntai;2;4;6;2;3;5
109;14.12.2014;2014;12;22;Sunnuntai;4;1;5;2;1;3
109;14.12.2014;2014;12;23;Sunnuntai;0;1;1;0;0;0
109;15.12.2014;2014;12;00;Maanantai;1;0;1;0;0;0
109;15.12.2014;2014;12;01;Maanantai;0;1;1;0;1;1
109;15.12.2014;2014;12;02;Maanantai;0;0;0;0;0;0
109;15.12.2014;2014;12;03;Maanantai;0;1;1;0;0;0
109;15.12.2014;2014;12;04;Maanantai;2;0;2;0;0;0
109;15.12.2014;2014;12;05;Maanantai;3;6;9;0;4;4
109;15.12.2014;2014;12;06;Maanantai;10;7;17;6;2;8
109;15.12.2014;2014;12;07;Maanantai;28;30;58;11;12;23
109;15.12.2014;2014;12;08;Maanantai;21;20;41;9;7;16
109;15.12.2014;2014;12;09;Maanantai;9;9;18;1;5;6
109;15.12.2014;2014;12;10;Maanantai;6;6;12;4;2;6
109;15.12.2014;2014;12;11;Maanantai;6;8;14;3;4;7
109;15.12.2014;2014;12;12;Maanantai;9;8;17;4;1;5
109;15.12.2014;2014;12;13;Maanantai;7;8;15;1;4;5
109;15.12.2014;2014;12;14;Maanantai;12;10;22;5;3;8
109;15.12.2014;2014;12;15;Maanantai;13;14;27;4;7;11
109;15.12.2014;2014;12;16;Maanantai;27;24;51;11;9;20
109;15.12.2014;2014;12;17;Maanantai;13;16;29;5;8;13
109;15.12.2014;2014;12;18;Maanantai;9;9;18;4;4;8
109;15.12.2014;2014;12;19;Maanantai;3;6;9;0;4;4
109;15.12.2014;2014;12;20;Maanantai;9;7;16;5;2;7
109;15.12.2014;2014;12;21;Maanantai;2;5;7;0;4;4
109;15.12.2014;2014;12;22;Maanantai;6;5;11;4;0;4
109;15.12.2014;2014;12;23;Maanantai;0;4;4;0;2;2
109;16.12.2014;2014;12;00;Tiistai;1;0;1;0;0;0
109;16.12.2014;2014;12;01;Tiistai;1;2;3;0;1;1
109;16.12.2014;2014;12;02;Tiistai;1;0;1;0;0;0
109;16.12.2014;2014;12;03;Tiistai;0;0;0;0;0;0
109;16.12.2014;2014;12;04;Tiistai;1;0;1;0;0;0
109;16.12.2014;2014;12;05;Tiistai;3;5;8;0;3;3
109;16.12.2014;2014;12;06;Tiistai;15;13;28;7;4;11
109;16.12.2014;2014;12;07;Tiistai;27;28;55;10;13;23
109;16.12.2014;2014;12;08;Tiistai;25;24;49;12;9;21
109;16.12.2014;2014;12;09;Tiistai;9;11;20;3;5;8
109;16.12.2014;2014;12;10;Tiistai;4;2;6;4;0;4
109;16.12.2014;2014;12;11;Tiistai;6;8;14;1;5;6
109;16.12.2014;2014;12;12;Tiistai;11;9;20;5;4;9
109;16.12.2014;2014;12;13;Tiistai;6;8;14;1;4;5
109;16.12.2014;2014;12;14;Tiistai;7;6;13;4;2;6
109;16.12.2014;2014;12;15;Tiistai;16;18;34;6;9;15
109;16.12.2014;2014;12;16;Tiistai;30;27;57;13;12;25
109;16.12.2014;2014;12;17;Tiistai;16;18;34;7;8;15
109;16.12.2014;2014;12;18;Tiistai;13;11;24;6;4;10
109;16.12.2014;2014;12;19;Tiistai;8;10;18;2;4;6
109;16.12.2014;2014;12;20;Tiistai;7;6;13;4;2;6
109;16.12.2014;2014;12;21;Tiistai;5;6;11;1;4;5
109;16.12.2014;2014;12;22;Tiistai;5;4;9;3;0;3
109;16.12.2014;2014;12;23;Tiistai;1;2;3;0;2;2
109;17.12.2014;2014;12;00;Keskiviikko;1;0;1;0;0;0
109;17.12.2014;2014;12;01;Keskiviikko;0;0;0;0;0;0
109;17.12.2014;2014;12;02;Keskiviikko;1;0;1;0;0;0
109;17.12.2014;2014;12;03;Keskiviikko;0;0;0;0;0;0
109;17.12.2014;2014;12;04;Keskiviikko;3;0;3;0;0;0
109;17.12.2014;2014;12;05;Keskiviikko;3;5;8;1;4;5
109;17.12.2014;2014;12;06;Keskiviikko;12;11;23;7;4;11
109;17.12.2014;2014;12;07;Keskiviikko;24;27;51;10;11;21
109;17.12.2014;2014;12;08;Keskiviikko;19;17;36;9;6;15
109;17.12.2014;2014;12;09;Keskiviikko;8;10;18;2;4;6
109;17.12.2014;2014;12;10;Keskiviikko;7;5;12;5;1;6
109;17.12.2014;2014;12;11;Keskiviikko;8;9;17;2;5;7
109;17.12.2014;2014;12;12;Keskiviikko;8;8;16;5;3;8
109;17.12.2014;2014;12;13;Keskiviikko;9;10;19;3;5;8
109;17.12.2014;2014;12;14;Keskiviikko;12;12;24;7;4;11
109;17.12.2014;2014;12;15;Keskiviikko;16;20;36;7;9;16
109;17.12.2014;2014;12;16;Keskiviikko;24;23;47;11;10;21
109;17.12.2014;2014;12;17;Keskiviikko;15;17;32;7;7;14
109;17.12.2014;2014;12;18;Keskiviikko;12;10;22;5;4;9
109;17.12.2014;2014;12;19;Keskiviikko;7;8;15;2;4;6
109;17.12.2014;2014;12;20;Keskiviikko;7;5;12;3;1;4
109;17.12.2014;2014;12;21;Keskiviikko;6;8;14;2;3;5
109;17.12.2014;2014;12;22;Keskiviikko;3;1;4;3;0;3
109;17.12.2014;2014;12;23;Keskiviikko;0;3;3;0;1;1
109;18.12.2014;2014;12;00;Torstai;3;0;3;0;0;0
109;18.12.2014;2014;12;01;Torstai;0;0;0;0;0;0
109;18.12.2014;2014;12;02;Torstai;1;0;1;0;0;0
109;18.12.2014;2014;12;03;Torstai;0;0;0;0;0;0
109;18.12.2014;2014;12;04;Torstai;1;0;1;0;0;0
109;18.12.2014;2014;12;05;Torstai;0;4;4;0;2;2
109;18.12.2014;2014;12;06;Torstai;13;12;25;6;4;10
109;18.12.2014;2014;12;07;Torstai;22;24;46;8;11;19
109;18.12.2014;2014;12;08;Torstai;23;20;43;11;9;20
109;18.12.2014;2014;12;09;Torstai;8;11;19;3;4;7
109;18.12.2014;2014;12;10;Torstai;8;4;12;3;1;4
109;18.12.2014;2014;12;11;Torstai;5;5;10;0;4;4
109;18.12.2014;2014;12;12;Torstai;8;6;14;4;2;6
109;18.12.2014;2014;12;13;Torstai;9;9;18;2;5;7
109;18.12.2014;2014;12;14;Torstai;11;10;21;6;3;9
109;18.12.2014;2014;12;15;Torstai;18;19;37;6;9;15
109;18.12.2014;2014;12;16;Torstai;32;29;61;13;12;25
109;18.12.2014;2014;12;17;Torstai;11;13;24;4;7;11
109;18.12.2014;2014;12;18;Torstai;12;10;22;7;3;10
109;18.12.2014;2014;12;19;Torstai;9;10;19;2;5;7
109;18.12.2014;2014;12;20;Torstai;7;6;13;4;0;4
109;18.12.2014;2014;12;21;Torstai;3;5;8;0;4;4
109;18.12.2014;2014;12;22;Torstai;4;4;8;3;0;3
109;18.12.2014;2014;12;23;Torstai;0;3;3;0;0;0
109;19.12.2014;2014;12;00;Perjantai;1;0;1;0;0;0
109;19.12.2014;2014;12;01;Perjantai;1;1;2;0;1;1
109;19.12.2014;2014;12;02;Perjantai;1;0;1;0;0;0
109;19.12.2014;2014;12;03;Perjantai;0;3;3;0;0;0
109;19.12.2014;2014;12;04;Perjantai;2;0;2;1;0;1
109;19.12.2014;2014;12;05;Perjantai;1;5;6;0;4;4
109;19.12.2014;2014;12;06;Perjantai;11;9;20;5;3;8
109;19.12.2014;2014;12;07;Perjantai;19;23;42;8;10;18
109;19.12.2014;2014;12;08;Perjantai;16;14;30;7;5;12
109;19.12.2014;2014;12;09;Perjantai;12;12;24;5;6;11
109;19.12.2014;2014;12;10;Perjantai;7;4;11;3;1;4
109;19.12.2014;2014;12;11;Perjantai;3;5;8;1;3;4
109;19.12.2014;2014;12;12;Perjantai;7;5;12;4;1;5
109;19.12.2014;2014;12;13;Perjantai;11;12;23;4;5;9
109;19.12.2014;2014;12;14;Perjantai;11;10;21;5;2;7
109;19.12.2014;2014;12;15;Perjantai;19;20;39;7;9;16
109;19.12.2014;2014;12;16;Perjantai;20;19;39;9;7;16
109;19.12.2014;2014;12;17;Perjantai;9;10;19;3;6;9
109;19.12.2014;2014;12;18;Perjantai;9;8;17;5;2;7
109;19.12.2014;2014;12;19;Perjantai;1;4;5;0;3;3
109;19.12.2014;2014;12;20;Perjantai;7;5;12;3;1;4
109;19.12.2014;2014;12;21;Perjantai;3;5;8;0;4;4
109;19.12.2014;2014;12;22;Perjantai;2;1;3;1;0;1
109;19.12.2014;2014;12;23;Perjantai;0;2;2;0;1;1
109;20.12.2014;2014;12;00;Lauantai;4;0;4;1;0;1
109;20.12.2014;2014;12;01;Lauantai;0;0;0;0;0;0
109;20.12.2014;2014;12;02;Lauantai;0;0;0;0;0;0
109;20.12.2014;2014;12;03;Lauantai;0;2;2;0;0;0
109;20.12.2014;2014;12;04;Lauantai;0;0;0;0;0;0
109;20.12.2014;2014;12;05;Lauantai;0;2;2;0;0;0
109;20.12.2014;2014;12;06;Lauantai;3;1;4;1;0;1
109;20.12.2014;2014;12;07;Lauantai;1;3;4;0;2;2
109;20.12.2014;2014;12;08;Lauantai;4;1;5;1;1;2
109;20.12.2014;2014;12;09;Lauantai;0;4;4;0;2;2
109;20.12.2014;2014;12;10;Lauantai;3;0;3;0;0;0
109;20.12.2014;2014;12;11;Lauantai;0;1;1;0;1;1
109;20.12.2014;2014;12;12;Lauantai;4;2;6;3;1;4
109;20.12.2014;2014;12;13;Lauantai;3;7;10;3;4;7
109;20.12.2014;2014;12;14;Lauantai;5;3;8;4;2;6
109;20.12.2014;2014;12;15;Lauantai;3;5;8;2;4;6
109;20.12.2014;2014;12;16;Lauantai;6;3;9;5;3;8
109;20.12.2014;2014;12;17;Lauantai;1;4;5;0;3;3
109;20.12.2014;2014;12;18;Lauantai;6;2;8;3;2;5
109;20.12.2014;2014;12;19;Lauantai;1;2;3;1;2;3
109;20.12.2014;2014;12;20;Lauantai;3;1;4;2;0;2
109;20.12.2014;2014;12;21;Lauantai;2;5;7;1;3;4
109;20.12.2014;2014;12;22;Lauantai;3;0;3;2;0;2
109;20.12.2014;2014;12;23;Lauantai;1;4;5;0;3;3
109;21.12.2014;2014;12;00;Sunnuntai;2;1;3;1;0;1
109;21.12.2014;2014;12;01;Sunnuntai;0;1;1;0;0;0
109;21.12.2014;2014;12;02;Sunnuntai;1;0;1;0;0;0
109;21.12.2014;2014;12;03;Sunnuntai;0;0;0;0;0;0
109;21.12.2014;2014;12;04;Sunnuntai;3;0;3;0;0;0
109;21.12.2014;2014;12;05;Sunnuntai;0;1;1;0;0;0
109;21.12.2014;2014;12;06;Sunnuntai;2;1;3;1;0;1
109;21.12.2014;2014;12;07;Sunnuntai;1;3;4;1;2;3
109;21.12.2014;2014;12;08;Sunnuntai;2;0;2;2;0;2
109;21.12.2014;2014;12;09;Sunnuntai;3;5;8;1;4;5
109;21.12.2014;2014;12;10;Sunnuntai;4;2;6;4;1;5
109;21.12.2014;2014;12;11;Sunnuntai;3;5;8;1;5;6
109;21.12.2014;2014;12;12;Sunnuntai;6;2;8;4;2;6
109;21.12.2014;2014;12;13;Sunnuntai;3;5;8;3;5;8
109;21.12.2014;2014;12;14;Sunnuntai;4;4;8;4;3;7
109;21.12.2014;2014;12;15;Sunnuntai;2;4;6;0;3;3
109;21.12.2014;2014;12;16;Sunnuntai;6;4;10;4;2;6
109;21.12.2014;2014;12;17;Sunnuntai;3;5;8;2;5;7
109;21.12.2014;2014;12;18;Sunnuntai;5;5;10;5;2;7
109;21.12.2014;2014;12;19;Sunnuntai;4;6;10;3;5;8
109;21.12.2014;2014;12;20;Sunnuntai;5;2;7;3;2;5
109;21.12.2014;2014;12;21;Sunnuntai;2;5;7;1;3;4
109;21.12.2014;2014;12;22;Sunnuntai;4;0;4;1;0;1
109;21.12.2014;2014;12;23;Sunnuntai;1;2;3;0;1;1
109;22.12.2014;2014;12;00;Maanantai;0;0;0;0;0;0
109;22.12.2014;2014;12;01;Maanantai;0;1;1;0;0;0
109;22.12.2014;2014;12;02;Maanantai;0;0;0;0;0;0
109;22.12.2014;2014;12;03;Maanantai;0;0;0;0;0;0
109;22.12.2014;2014;12;04;Maanantai;1;0;1;0;0;0
109;22.12.2014;2014;12;05;Maanantai;1;4;5;0;2;2
109;22.12.2014;2014;12;06;Maanantai;7;5;12;4;2;6
109;22.12.2014;2014;12;07;Maanantai;12;14;26;5;6;11
109;22.12.2014;2014;12;08;Maanantai;9;8;17;5;3;8
109;22.12.2014;2014;12;09;Maanantai;8;9;17;2;5;7
109;22.12.2014;2014;12;10;Maanantai;8;5;13;4;1;5
109;22.12.2014;2014;12;11;Maanantai;3;5;8;0;4;4
109;22.12.2014;2014;12;12;Maanantai;7;6;13;4;2;6
109;22.12.2014;2014;12;13;Maanantai;5;7;12;0;4;4
109;22.12.2014;2014;12;14;Maanantai;5;4;9;4;1;5
109;22.12.2014;2014;12;15;Maanantai;11;13;24;4;6;10
109;22.12.2014;2014;12;16;Maanantai;14;12;26;6;5;11
109;22.12.2014;2014;12;17;Maanantai;7;10;17;3;4;7
109;22.12.2014;2014;12;18;Maanantai;8;6;14;4;1;5
109;22.12.2014;2014;12;19;Maanantai;3;6;9;0;3;3
109;22.12.2014;2014;12;20;Maanantai;5;2;7;3;0;3
109;22.12.2014;2014;12;21;Maanantai;3;6;9;1;2;3
109;22.12.2014;2014;12;22;Maanantai;4;2;6;4;0;4
109;22.12.2014;2014;12;23;Maanantai;0;2;2;0;0;0
109;23.12.2014;2014;12;00;Tiistai;0;0;0;0;0;0
109;23.12.2014;2014;12;01;Tiistai;0;0;0;0;0;0
109;23.12.2014;2014;12;02;Tiistai;0;0;0;0;0;0
109;23.12.2014;2014;12;03;Tiistai;0;0;0;0;0;0
109;23.12.2014;2014;12;04;Tiistai;2;0;2;0;0;0
109;23.12.2014;2014;12;05;Tiistai;2;3;5;1;1;2
109;23.12.2014;2014;12;06;Tiistai;6;4;10;4;1;5
109;23.12.2014;2014;12;07;Tiistai;8;10;18;2;4;6
109;23.12.2014;2014;12;08;Tiistai;8;6;14;3;1;4
109;23.12.2014;2014;12;09;Tiistai;6;6;12;1;5;6
109;23.12.2014;2014;12;10;Tiistai;4;3;7;3;0;3
109;23.12.2014;2014;12;11;Tiistai;4;7;11;0;4;4
109;23.12.2014;2014;12;12;Tiistai;7;5;12;3;0;3
109;23.12.2014;2014;12;13;Tiistai;7;8;15;2;4;6
109;23.12.2014;2014;12;14;Tiistai;9;7;16;5;1;6
109;23.12.2014;2014;12;15;Tiistai;11;11;22;5;6;11
109;23.12.2014;2014;12;16;Tiistai;7;5;12;4;2;6
109;23.12.2014;2014;12;17;Tiistai;3;5;8;0;4;4
109;23.12.2014;2014;12;18;Tiistai;6;4;10;3;1;4
109;23.12.2014;2014;12;19;Tiistai;2;5;7;0;3;3
109;23.12.2014;2014;12;20;Tiistai;2;0;2;2;0;2
109;23.12.2014;2014;12;21;Tiistai;0;3;3;0;1;1
109;23.12.2014;2014;12;22;Tiistai;2;0;2;1;0;1
109;23.12.2014;2014;12;23;Tiistai;0;2;2;0;0;0
109;24.12.2014;2014;12;00;Keskiviikko;1;0;1;0;0;0
109;24.12.2014;2014;12;01;Keskiviikko;0;0;0;0;0;0
109;24.12.2014;2014;12;02;Keskiviikko;0;0;0;0;0;0
109;24.12.2014;2014;12;03;Keskiviikko;0;0;0;0;0;0
109;24.12.2014;2014;12;04;Keskiviikko;0;0;0;0;0;0
109;24.12.2014;2014;12;05;Keskiviikko;0;0;0;0;0;0
109;24.12.2014;2014;12;06;Keskiviikko;4;0;4;1;0;1
109;24.12.2014;2014;12;07;Keskiviikko;0;2;2;0;1;1
109;24.12.2014;2014;12;08;Keskiviikko;3;0;3;0;0;0
109;24.12.2014;2014;12;09;Keskiviikko;2;4;6;0;2;2
109;24.12.2014;2014;12;10;Keskiviikko;3;0;3;1;0;1
109;24.12.2014;2014;12;11;Keskiviikko;0;4;4;0;3;3
109;24.12.2014;2014;12;12;Keskiviikko;6;5;11;4;2;6
109;24.12.2014;2014;12;13;Keskiviikko;4;6;10;0;4;4
109;24.12.2014;2014;12;14;Keskiviikko;4;0;4;2;0;2
109;24.12.2014;2014;12;15;Keskiviikko;1;2;3;0;1;1
109;24.12.2014;2014;12;16;Keskiviikko;3;0;3;0;0;0
109;24.12.2014;2014;12;17;Keskiviikko;0;1;1;0;0;0
109;24.12.2014;2014;12;18;Keskiviikko;1;0;1;0;0;0
109;24.12.2014;2014;12;19;Keskiviikko;0;4;4;0;1;1
109;24.12.2014;2014;12;20;Keskiviikko;4;1;5;2;0;2
109;24.12.2014;2014;12;21;Keskiviikko;1;2;3;0;1;1
109;24.12.2014;2014;12;22;Keskiviikko;2;0;2;1;0;1
109;24.12.2014;2014;12;23;Keskiviikko;0;2;2;0;0;0
109;25.12.2014;2014;12;00;Torstai;0;0;0;0;0;0
109;25.12.2014;2014;12;01;Torstai;0;0;0;0;0;0
109;25.12.2014;2014;12;02;Torstai;0;0;0;0;0;0
109;25.12.2014;2014;12;03;Torstai;0;0;0;0;0;0
109;25.12.2014;2014;12;04;Torstai;1;0;1;0;0;0
109;25.12.2014;2014;12;05;Torstai;0;0;0;0;0;0
109;25.12.2014;2014;12;06;Torstai;3;0;3;1;0;1
109;25.12.2014;2014;12;07;Torstai;1;1;2;0;1;1
109;25.12.2014;2014;12;08;Torstai;2;0;2;0;0;0
109;25.12.2014;2014;12;09;Torstai;0;3;3;0;0;0
109;25.12.2014;2014;12;10;Torstai;2;1;3;2;0;2
109;25.12.2014;2014;12;11;Torstai;3;4;7;0;3;3
109;25.12.2014;2014;12;12;Torstai;5;2;7;2;0;2
109;25.12.2014;2014;12;13;Torstai;7;9;16;1;5;6
109;25.12.2014;2014;12;14;Torstai;8;6;14;5;2;7
109;25.12.2014;2014;12;15;Torstai;4;7;11;1;4;5
109;25.12.2014;2014;12;16;Torstai;5;3;8;3;0;3
109;25.12.2014;2014;12;17;Torstai;3;5;8;0;3;3
109;25.12.2014;2014;12;18;Torstai;3;1;4;2;0;2
109;25.12.2014;2014;12;19;Torstai;3;5;8;0;2;2
109;25.12.2014;2014;12;20;Torstai;3;3;6;2;1;3
109;25.12.2014;2014;12;21;Torstai;0;2;2;0;1;1
109;25.12.2014;2014;12;22;Torstai;3;0;3;2;0;2
109;25.12.2014;2014;12;23;Torstai;0;3;3;0;0;0
109;26.12.2014;2014;12;00;Perjantai;1;0;1;1;0;1
109;26.12.2014;2014;12;01;Perjantai;0;0;0;0;0;0
109;26.12.2014;2014;12;02;Perjantai;0;0;0;0;0;0
109;26.12.2014;2014;12;03;Perjantai;0;0;0;0;0;0
109;26.12.2014;2014;12;04;Perjantai;0;0;0;0;0;0
109;26.12.2014;2014;12;05;Perjantai;0;2;2;0;0;0
109;26.12.2014;2014;12;06;Perjantai;3;1;4;2;0;2
109;26.12.2014;2014;12;07;Perjantai;0;3;3;0;1;1
109;26.12.2014;2014;12;08;Perjantai;2;0;2;1;0;1
109;26.12.2014;2014;12;09;Perjantai;0;3;3;0;3;3
109;26.12.2014;2014;12;10;Perjantai;5;1;6;3;0;3
109;26.12.2014;2014;12;11;Perjantai;2;3;5;0;3;3
109;26.12.2014;2014;12;12;Perjantai;8;4;12;4;1;5
109;26.12.2014;2014;12;13;Perjantai;4;7;11;0;4;4
109;26.12.2014;2014;12;14;Perjantai;4;1;5;3;0;3
109;26.12.2014;2014;12;15;Perjantai;3;5;8;1;3;4
109;26.12.2014;2014;12;16;Perjantai;4;1;5;3;0;3
109;26.12.2014;2014;12;17;Perjantai;6;7;13;2;5;7
109;26.12.2014;2014;12;18;Perjantai;4;1;5;3;0;3
109;26.12.2014;2014;12;19;Perjantai;1;3;4;0;2;2
109;26.12.2014;2014;12;20;Perjantai;4;0;4;1;0;1
109;26.12.2014;2014;12;21;Perjantai;1;3;4;0;2;2
109;26.12.2014;2014;12;22;Perjantai;4;0;4;2;0;2
109;26.12.2014;2014;12;23;Perjantai;1;4;5;0;1;1
109;27.12.2014;2014;12;00;Lauantai;2;0;2;1;0;1
109;27.12.2014;2014;12;01;Lauantai;0;0;0;0;0;0
109;27.12.2014;2014;12;02;Lauantai;0;0;0;0;0;0
109;27.12.2014;2014;12;03;Lauantai;0;1;1;0;0;0
109;27.12.2014;2014;12;04;Lauantai;1;0;1;0;0;0
109;27.12.2014;2014;12;05;Lauantai;0;0;0;0;0;0
109;27.12.2014;2014;12;06;Lauantai;2;0;2;0;0;0
109;27.12.2014;2014;12;07;Lauantai;0;3;3;0;3;3
109;27.12.2014;2014;12;08;Lauantai;2;1;3;1;0;1
109;27.12.2014;2014;12;09;Lauantai;1;3;4;1;2;3
109;27.12.2014;2014;12;10;Lauantai;5;2;7;4;1;5
109;27.12.2014;2014;12;11;Lauantai;4;7;11;4;5;9
109;27.12.2014;2014;12;12;Lauantai;6;3;9;5;2;7
109;27.12.2014;2014;12;13;Lauantai;2;5;7;2;4;6
109;27.12.2014;2014;12;14;Lauantai;6;2;8;3;2;5
109;27.12.2014;2014;12;15;Lauantai;4;5;9;2;5;7
109;27.12.2014;2014;12;16;Lauantai;6;3;9;5;2;7
109;27.12.2014;2014;12;17;Lauantai;1;4;5;1;3;4
109;27.12.2014;2014;12;18;Lauantai;5;2;7;3;1;4
109;27.12.2014;2014;12;19;Lauantai;1;3;4;0;2;2
109;27.12.2014;2014;12;20;Lauantai;4;1;5;2;0;2
109;27.12.2014;2014;12;21;Lauantai;1;4;5;1;1;2
109;27.12.2014;2014;12;22;Lauantai;2;0;2;0;0;0
109;27.12.2014;2014;12;23;Lauantai;0;1;1;0;1;1
109;28.12.2014;2014;12;00;Sunnuntai;2;0;2;0;0;0
109;28.12.2014;2014;12;01;Sunnuntai;0;0;0;0;0;0
109;28.12.2014;2014;12;02;Sunnuntai;0;0;0;0;0;0
109;28.12.2014;2014;12;03;Sunnuntai;0;0;0;0;0;0
109;28.12.2014;2014;12;04;Sunnuntai;1;0;1;0;0;0
109;28.12.2014;2014;12;05;Sunnuntai;0;1;1;0;0;0
109;28.12.2014;2014;12;06;Sunnuntai;2;0;2;0;0;0
109;28.12.2014;2014;12;07;Sunnuntai;1;1;2;0;1;1
109;28.12.2014;2014;12;08;Sunnuntai;2;1;3;1;0;1
109;28.12.2014;2014;12;09;Sunnuntai;1;3;4;1;2;3
109;28.12.2014;2014;12;10;Sunnuntai;2;0;2;0;0;0
109;28.12.2014;2014;12;11;Sunnuntai;1;3;4;1;3;4
109;28.12.2014;2014;12;12;Sunnuntai;4;2;6;4;1;5
109;28.12.2014;2014;12;13;Sunnuntai;0;3;3;0;2;2
109;28.12.2014;2014;12;14;Sunnuntai;4;1;5;3;1;4
109;28.12.2014;2014;12;15;Sunnuntai;3;5;8;2;5;7
109;28.12.2014;2014;12;16;Sunnuntai;4;1;5;4;1;5
109;28.12.2014;2014;12;17;Sunnuntai;3;4;7;2;4;6
109;28.12.2014;2014;12;18;Sunnuntai;4;3;7;3;2;5
109;28.12.2014;2014;12;19;Sunnuntai;3;3;6;1;3;4
109;28.12.2014;2014;12;20;Sunnuntai;3;0;3;1;0;1
109;28.12.2014;2014;12;21;Sunnuntai;3;4;7;2;3;5
109;28.12.2014;2014;12;22;Sunnuntai;2;0;2;0;0;0
109;28.12.2014;2014;12;23;Sunnuntai;0;3;3;0;2;2
109;29.12.2014;2014;12;00;Maanantai;1;0;1;0;0;0
109;29.12.2014;2014;12;01;Maanantai;0;1;1;0;0;0
109;29.12.2014;2014;12;02;Maanantai;0;0;0;0;0;0
109;29.12.2014;2014;12;03;Maanantai;0;1;1;0;0;0
109;29.12.2014;2014;12;04;Maanantai;0;0;0;0;0;0
109;29.12.2014;2014;12;05;Maanantai;0;4;4;0;0;0
109;29.12.2014;2014;12;06;Maanantai;7;5;12;2;2;4
109;29.12.2014;2014;12;07;Maanantai;16;17;33;5;8;13
109;29.12.2014;2014;12;08;Maanantai;13;11;24;6;4;10
109;29.12.2014;2014;12;09;Maanantai;0;4;4;0;3;3
109;29.12.2014;2014;12;10;Maanantai;4;2;6;3;0;3
109;29.12.2014;2014;12;11;Maanantai;2;5;7;0;3;3
109;29.12.2014;2014;12;12;Maanantai;4;2;6;3;0;3
109;29.12.2014;2014;12;13;Maanantai;4;4;8;1;2;3
109;29.12.2014;2014;12;14;Maanantai;7;7;14;3;1;4
109;29.12.2014;2014;12;15;Maanantai;11;11;22;3;2;5
109;29.12.2014;2014;12;16;Maanantai;9;9;18;6;5;11
109;29.12.2014;2014;12;17;Maanantai;4;4;8;3;2;5
109;29.12.2014;2014;12;18;Maanantai;2;2;4;2;1;3
109;29.12.2014;2014;12;19;Maanantai;1;0;1;1;5;6
109;29.12.2014;2014;12;20;Maanantai;0;2;2;2;1;3
109;29.12.2014;2014;12;21;Maanantai;2;0;2;0;0;0
109;29.12.2014;2014;12;22;Maanantai;0;0;0;0;0;0
109;29.12.2014;2014;12;23;Maanantai;0;0;0;0;0;0
109;30.12.2014;2014;12;00;Tiistai;1;0;1;0;0;0
109;30.12.2014;2014;12;01;Tiistai;0;0;0;0;0;0
109;30.12.2014;2014;12;02;Tiistai;0;0;0;0;0;0
109;30.12.2014;2014;12;03;Tiistai;0;0;0;0;0;0
109;30.12.2014;2014;12;04;Tiistai;0;0;0;0;0;0
109;30.12.2014;2014;12;05;Tiistai;0;0;0;0;0;0
109;30.12.2014;2014;12;06;Tiistai;4;0;4;1;0;1
109;30.12.2014;2014;12;07;Tiistai;0;2;2;0;1;1
109;30.12.2014;2014;12;08;Tiistai;3;0;3;0;0;0
109;30.12.2014;2014;12;09;Tiistai;2;4;6;0;2;2
109;30.12.2014;2014;12;10;Tiistai;3;0;3;1;0;1
109;30.12.2014;2014;12;11;Tiistai;0;4;4;0;3;3
109;30.12.2014;2014;12;12;Tiistai;6;5;11;4;2;6
109;30.12.2014;2014;12;13;Tiistai;4;6;10;0;4;4
109;30.12.2014;2014;12;14;Tiistai;4;0;4;2;0;2
109;30.12.2014;2014;12;15;Tiistai;1;2;3;0;1;1
109;30.12.2014;2014;12;16;Tiistai;3;0;3;0;0;0
109;30.12.2014;2014;12;17;Tiistai;0;1;1;0;0;0
109;30.12.2014;2014;12;18;Tiistai;1;0;1;0;0;0
109;30.12.2014;2014;12;19;Tiistai;0;4;4;0;1;1
109;30.12.2014;2014;12;20;Tiistai;4;1;5;2;0;2
109;30.12.2014;2014;12;21;Tiistai;1;2;3;0;1;1
109;30.12.2014;2014;12;22;Tiistai;2;0;2;1;0;1
109;30.12.2014;2014;12;23;Tiistai;0;2;2;0;0;0
109;31.12.2014;2014;12;00;Keskiviikko;0;0;0;0;0;0
109;31.12.2014;2014;12;01;Keskiviikko;0;0;0;0;0;0
109;31.12.2014;2014;12;02;Keskiviikko;0;0;0;0;0;0
109;31.12.2014;2014;12;03;Keskiviikko;0;0;0;0;0;0
109;31.12.2014;2014;12;04;Keskiviikko;1;0;1;0;0;0
109;31.12.2014;2014;12;05;Keskiviikko;0;0;0;0;0;0
109;31.12.2014;2014;12;06;Keskiviikko;3;0;3;1;0;1
109;31.12.2014;2014;12;07;Keskiviikko;1;1;2;0;1;1
109;31.12.2014;2014;12;08;Keskiviikko;2;0;2;0;0;0
109;31.12.2014;2014;12;09;Keskiviikko;0;3;3;0;0;0
109;31.12.2014;2014;12;10;Keskiviikko;2;1;3;2;0;2
109;31.12.2014;2014;12;11;Keskiviikko;3;4;7;0;3;3
109;31.12.2014;2014;12;12;Keskiviikko;5;2;7;2;0;2
109;31.12.2014;2014;12;13;Keskiviikko;7;9;16;1;5;6
109;31.12.2014;2014;12;14;Keskiviikko;8;6;14;5;2;7
109;31.12.2014;2014;12;15;Keskiviikko;4;7;11;1;4;5
109;31.12.2014;2014;12;16;Keskiviikko;5;3;8;3;0;3
109;31.12.2014;2014;12;17;Keskiviikko;3;5;8;0;3;3
109;31.12.2014;2014;12;18;Keskiviikko;3;1;4;2;0;2
109;31.12.2014;2014;12;19;Keskiviikko;3;5;8;0;2;2
109;31.12.2014;2014;12;20;Keskiviikko;3;3;6;2;1;3
109;31.12.2014;2014;12;21;Keskiviikko;0;2;2;0;1;1
109;31.12.2014;2014;12;22;Keskiviikko;3;0;3;2;0;2
109;31.12.2014;2014;12;23;Keskiviikko;0;3;3;0;0;0
109;01.01.2015;2015;01;00;Torstai;0;0;0;0;0;0
109;01.01.2015;2015;01;01;Torstai;0;0;0;0;0;0
109;01.01.2015;2015;01;02;Torstai;0;0;0;0;0;0
109;01.01.2015;2015;01;03;Torstai;0;0;0;0;0;0
109;01.01.2015;2015;01;04;Torstai;3;0;3;2;0;2
109;01.01.2015;2015;01;05;Torstai;0;1;1;0;1;1
109;01.01.2015;2015;01;06;Torstai;3;0;3;1;0;1
109;01.01.2015;2015;01;07;Torstai;1;3;4;0;3;3
109;01.01.2015;2015;01;08;Torstai;2;0;2;1;0;1
109;01.01.2015;2015;01;09;Torstai;3;5;8;0;3;3
109;01.01.2015;2015;01;10;Torstai;6;3;9;2;0;2
109;01.01.2015;2015;01;11;Torstai;4;7;11;1;4;5
109;01.01.2015;2015;01;12;Torstai;10;10;20;4;3;7
109;01.01.2015;2015;01;13;Torstai;5;7;12;0;4;4
109;01.01.2015;2015;01;14;Torstai;7;5;12;4;1;5
109;01.01.2015;2015;01;15;Torstai;6;7;13;2;4;6
109;01.01.2015;2015;01;16;Torstai;7;5;12;4;1;5
109;01.01.2015;2015;01;17;Torstai;9;9;18;2;4;6
109;01.01.2015;2015;01;18;Torstai;7;5;12;3;1;4
109;01.01.2015;2015;01;19;Torstai;5;6;11;1;3;4
109;01.01.2015;2015;01;20;Torstai;5;3;8;3;0;3
109;01.01.2015;2015;01;21;Torstai;1;4;5;0;1;1
109;01.01.2015;2015;01;22;Torstai;2;1;3;2;0;2
109;01.01.2015;2015;01;23;Torstai;0;0;0;0;0;0
109;02.01.2015;2015;01;00;Perjantai;1;0;1;0;0;0
109;02.01.2015;2015;01;01;Perjantai;0;0;0;0;0;0
109;02.01.2015;2015;01;02;Perjantai;0;0;0;0;0;0
109;02.01.2015;2015;01;03;Perjantai;0;0;0;0;0;0
109;02.01.2015;2015;01;04;Perjantai;2;0;2;0;0;0
109;02.01.2015;2015;01;05;Perjantai;0;4;4;0;0;0
109;02.01.2015;2015;01;06;Perjantai;6;5;11;4;1;5
109;02.01.2015;2015;01;07;Perjantai;11;11;22;3;6;9
109;02.01.2015;2015;01;08;Perjantai;7;6;13;4;0;4
109;02.01.2015;2015;01;09;Perjantai;1;3;4;0;2;2
109;02.01.2015;2015;01;10;Perjantai;9;8;17;4;2;6
109;02.01.2015;2015;01;11;Perjantai;2;5;7;0;4;4
109;02.01.2015;2015;01;12;Perjantai;8;4;12;3;1;4
109;02.01.2015;2015;01;13;Perjantai;8;10;18;1;5;6
109;02.01.2015;2015;01;14;Perjantai;11;10;21;5;3;8
109;02.01.2015;2015;01;15;Perjantai;7;8;15;2;4;6
109;02.01.2015;2015;01;16;Perjantai;11;10;21;5;3;8
109;02.01.2015;2015;01;17;Perjantai;8;10;18;2;5;7
109;02.01.2015;2015;01;18;Perjantai;5;3;8;4;1;5
109;02.01.2015;2015;01;19;Perjantai;2;3;5;0;2;2
109;02.01.2015;2015;01;20;Perjantai;4;2;6;3;0;3
109;02.01.2015;2015;01;21;Perjantai;2;5;7;0;2;2
109;02.01.2015;2015;01;22;Perjantai;2;2;4;2;0;2
109;02.01.2015;2015;01;23;Perjantai;0;4;4;0;2;2
109;03.01.2015;2015;01;00;Lauantai;1;0;1;0;0;0
109;03.01.2015;2015;01;01;Lauantai;0;0;0;0;0;0
109;03.01.2015;2015;01;02;Lauantai;0;0;0;0;0;0
109;03.01.2015;2015;01;03;Lauantai;0;0;0;0;0;0
109;03.01.2015;2015;01;04;Lauantai;1;0;1;0;0;0
109;03.01.2015;2015;01;05;Lauantai;0;2;2;0;0;0
109;03.01.2015;2015;01;06;Lauantai;1;0;1;0;0;0
109;03.01.2015;2015;01;07;Lauantai;2;4;6;1;3;4
109;03.01.2015;2015;01;08;Lauantai;4;2;6;3;1;4
109;03.01.2015;2015;01;09;Lauantai;2;4;6;1;3;4
109;03.01.2015;2015;01;10;Lauantai;5;4;9;5;2;7
109;03.01.2015;2015;01;11;Lauantai;3;4;7;0;3;3
109;03.01.2015;2015;01;12;Lauantai;7;5;12;6;4;10
109;03.01.2015;2015;01;13;Lauantai;1;4;5;0;4;4
109;03.01.2015;2015;01;14;Lauantai;6;2;8;3;2;5
109;03.01.2015;2015;01;15;Lauantai;2;5;7;1;3;4
109;03.01.2015;2015;01;16;Lauantai;6;4;10;4;3;7
109;03.01.2015;2015;01;17;Lauantai;0;3;3;0;1;1
109;03.01.2015;2015;01;18;Lauantai;6;4;10;4;2;6
109;03.01.2015;2015;01;19;Lauantai;1;4;5;0;2;2
109;03.01.2015;2015;01;20;Lauantai;4;1;5;3;0;3
109;03.01.2015;2015;01;21;Lauantai;2;4;6;0;3;3
109;03.01.2015;2015;01;22;Lauantai;1;0;1;1;0;1
109;03.01.2015;2015;01;23;Lauantai;0;2;2;0;1;1
109;04.01.2015;2015;01;00;Sunnuntai;1;0;1;0;0;0
109;04.01.2015;2015;01;01;Sunnuntai;0;1;1;0;0;0
109;04.01.2015;2015;01;02;Sunnuntai;0;0;0;0;0;0
109;04.01.2015;2015;01;03;Sunnuntai;0;2;2;0;1;1
109;04.01.2015;2015;01;04;Sunnuntai;2;2;4;2;1;3
109;04.01.2015;2015;01;05;Sunnuntai;0;2;2;0;0;0
109;04.01.2015;2015;01;06;Sunnuntai;4;1;5;1;1;2
109;04.01.2015;2015;01;07;Sunnuntai;0;2;2;0;2;2
109;04.01.2015;2015;01;08;Sunnuntai;2;1;3;2;0;2
109;04.01.2015;2015;01;09;Sunnuntai;0;4;4;0;2;2
109;04.01.2015;2015;01;10;Sunnuntai;4;0;4;2;0;2
109;04.01.2015;2015;01;11;Sunnuntai;3;5;8;1;3;4
109;04.01.2015;2015;01;12;Sunnuntai;6;4;10;5;4;9
109;04.01.2015;2015;01;13;Sunnuntai;3;7;10;3;3;6
109;04.01.2015;2015;01;14;Sunnuntai;6;5;11;5;3;8
109;04.01.2015;2015;01;15;Sunnuntai;4;4;8;0;4;4
109;04.01.2015;2015;01;16;Sunnuntai;5;4;9;4;3;7
109;04.01.2015;2015;01;17;Sunnuntai;4;6;10;3;6;9
109;04.01.2015;2015;01;18;Sunnuntai;5;2;7;2;2;4
109;04.01.2015;2015;01;19;Sunnuntai;2;4;6;1;3;4
109;04.01.2015;2015;01;20;Sunnuntai;4;0;4;1;0;1
109;04.01.2015;2015;01;21;Sunnuntai;2;6;8;2;4;6
109;04.01.2015;2015;01;22;Sunnuntai;2;1;3;1;0;1
109;04.01.2015;2015;01;23;Sunnuntai;0;2;2;0;0;0
109;05.01.2015;2015;01;00;Maanantai;1;0;1;0;0;0
109;05.01.2015;2015;01;01;Maanantai;0;0;0;0;0;0
109;05.01.2015;2015;01;02;Maanantai;0;0;0;0;0;0
109;05.01.2015;2015;01;03;Maanantai;0;0;0;0;0;0
109;05.01.2015;2015;01;04;Maanantai;0;0;0;0;0;0
109;05.01.2015;2015;01;05;Maanantai;1;4;5;0;1;1
109;05.01.2015;2015;01;06;Maanantai;7;4;11;3;1;4
109;05.01.2015;2015;01;07;Maanantai;11;13;24;5;6;11
109;05.01.2015;2015;01;08;Maanantai;8;8;16;5;2;7
109;05.01.2015;2015;01;09;Maanantai;0;2;2;0;2;2
109;05.01.2015;2015;01;10;Maanantai;5;3;8;3;0;3
109;05.01.2015;2015;01;11;Maanantai;4;6;10;0;4;4
109;05.01.2015;2015;01;12;Maanantai;5;3;8;4;1;5
109;05.01.2015;2015;01;13;Maanantai;6;8;14;0;4;4
109;05.01.2015;2015;01;14;Maanantai;6;4;10;2;2;4
109;05.01.2015;2015;01;15;Maanantai;9;10;19;3;5;8
109;05.01.2015;2015;01;16;Maanantai;12;11;23;5;4;9
109;05.01.2015;2015;01;17;Maanantai;9;10;19;2;5;7
109;05.01.2015;2015;01;18;Maanantai;5;2;7;3;0;3
109;05.01.2015;2015;01;19;Maanantai;2;5;7;0;3;3
109;05.01.2015;2015;01;20;Maanantai;5;2;7;3;0;3
109;05.01.2015;2015;01;21;Maanantai;0;3;3;0;1;1
109;05.01.2015;2015;01;22;Maanantai;4;2;6;3;0;3
109;05.01.2015;2015;01;23;Maanantai;1;2;3;0;2;2
109;06.01.2015;2015;01;00;Tiistai;1;0;1;0;0;0
109;06.01.2015;2015;01;01;Tiistai;0;1;1;0;0;0
109;06.01.2015;2015;01;02;Tiistai;1;0;1;1;0;1
109;06.01.2015;2015;01;03;Tiistai;0;0;0;0;0;0
109;06.01.2015;2015;01;04;Tiistai;1;0;1;0;0;0
109;06.01.2015;2015;01;05;Tiistai;0;0;0;0;0;0
109;06.01.2015;2015;01;06;Tiistai;1;0;1;1;0;1
109;06.01.2015;2015;01;07;Tiistai;0;3;3;0;1;1
109;06.01.2015;2015;01;08;Tiistai;3;0;3;2;0;2
109;06.01.2015;2015;01;09;Tiistai;1;3;4;0;1;1
109;06.01.2015;2015;01;10;Tiistai;4;1;5;2;0;2
109;06.01.2015;2015;01;11;Tiistai;4;6;10;0;3;3
109;06.01.2015;2015;01;12;Tiistai;5;4;9;4;1;5
109;06.01.2015;2015;01;13;Tiistai;3;5;8;0;4;4
109;06.01.2015;2015;01;14;Tiistai;4;2;6;2;0;2
109;06.01.2015;2015;01;15;Tiistai;4;6;10;0;4;4
109;06.01.2015;2015;01;16;Tiistai;7;5;12;4;1;5
109;06.01.2015;2015;01;17;Tiistai;3;7;10;1;4;5
109;06.01.2015;2015;01;18;Tiistai;5;3;8;3;0;3
109;06.01.2015;2015;01;19;Tiistai;3;5;8;0;3;3
109;06.01.2015;2015;01;20;Tiistai;6;2;8;2;1;3
109;06.01.2015;2015;01;21;Tiistai;0;3;3;0;2;2
109;06.01.2015;2015;01;22;Tiistai;2;0;2;1;0;1
109;06.01.2015;2015;01;23;Tiistai;0;2;2;0;0;0
109;07.01.2015;2015;01;00;Keskiviikko;1;0;1;0;0;0
109;07.01.2015;2015;01;01;Keskiviikko;0;0;0;0;0;0
109;07.01.2015;2015;01;02;Keskiviikko;0;0;0;0;0;0
109;07.01.2015;2015;01;03;Keskiviikko;0;0;0;0;0;0
109;07.01.2015;2015;01;04;Keskiviikko;1;0;1;0;0;0
109;07.01.2015;2015;01;05;Keskiviikko;1;4;5;0;2;2
109;07.01.2015;2015;01;06;Keskiviikko;9;7;16;5;2;7
109;07.01.2015;2015;01;07;Keskiviikko;20;23;43;9;10;19
109;07.01.2015;2015;01;08;Keskiviikko;7;6;13;4;1;5
109;07.01.2015;2015;01;09;Keskiviikko;0;2;2;0;2;2
109;07.01.2015;2015;01;10;Keskiviikko;5;3;8;3;0;3
109;07.01.2015;2015;01;11;Keskiviikko;4;6;10;0;4;4
109;07.01.2015;2015;01;12;Keskiviikko;5;3;8;4;1;5
109;07.01.2015;2015;01;13;Keskiviikko;6;8;14;0;4;4
109;07.01.2015;2015;01;14;Keskiviikko;6;4;10;2;2;4
109;07.01.2015;2015;01;15;Keskiviikko;9;10;19;3;5;8
109;07.01.2015;2015;01;16;Keskiviikko;12;11;23;5;4;9
109;07.01.2015;2015;01;17;Keskiviikko;9;10;19;2;5;7
109;07.01.2015;2015;01;18;Keskiviikko;5;2;7;3;0;3
109;07.01.2015;2015;01;19;Keskiviikko;2;5;7;0;3;3
109;07.01.2015;2015;01;20;Keskiviikko;5;2;7;3;0;3
109;07.01.2015;2015;01;21;Keskiviikko;0;3;3;0;1;1
109;07.01.2015;2015;01;22;Keskiviikko;4;2;6;3;0;3
109;07.01.2015;2015;01;23;Keskiviikko;1;2;3;0;2;2
109;08.01.2015;2015;01;00;Torstai;1;0;1;0;0;0
109;08.01.2015;2015;01;01;Torstai;0;0;0;0;0;0
109;08.01.2015;2015;01;02;Torstai;0;0;0;0;0;0
109;08.01.2015;2015;01;03;Torstai;0;0;0;0;0;0
109;08.01.2015;2015;01;04;Torstai;0;0;0;0;0;0
109;08.01.2015;2015;01;05;Torstai;1;4;5;0;1;1
109;08.01.2015;2015;01;06;Torstai;7;4;11;3;1;4
109;08.01.2015;2015;01;07;Torstai;11;13;24;5;6;11
109;08.01.2015;2015;01;08;Torstai;8;8;16;5;2;7
109;08.01.2015;2015;01;09;Torstai;0;2;2;0;2;2
109;08.01.2015;2015;01;10;Torstai;5;3;8;3;0;3
109;08.01.2015;2015;01;11;Torstai;4;6;10;0;4;4
109;08.01.2015;2015;01;12;Torstai;5;3;8;4;1;5
109;08.01.2015;2015;01;13;Torstai;6;8;14;0;4;4
109;08.01.2015;2015;01;14;Torstai;6;4;10;2;2;4
109;08.01.2015;2015;01;15;Torstai;9;10;19;3;5;8
109;08.01.2015;2015;01;16;Torstai;12;11;23;5;4;9
109;08.01.2015;2015;01;17;Torstai;9;10;19;2;5;7
109;08.01.2015;2015;01;18;Torstai;5;2;7;3;0;3
109;08.01.2015;2015;01;19;Torstai;2;5;7;0;3;3
109;08.01.2015;2015;01;20;Torstai;5;2;7;3;0;3
109;08.01.2015;2015;01;21;Torstai;0;3;3;0;1;1
109;08.01.2015;2015;01;22;Torstai;4;2;6;3;0;3
109;08.01.2015;2015;01;23;Torstai;1;2;3;0;2;2
109;09.01.2015;2015;01;00;Perjantai;1;0;1;0;0;0
109;09.01.2015;2015;01;01;Perjantai;0;0;0;0;0;0
109;09.01.2015;2015;01;02;Perjantai;0;0;0;0;0;0
109;09.01.2015;2015;01;03;Perjantai;0;0;0;0;0;0
109;09.01.2015;2015;01;04;Perjantai;1;0;1;0;0;0
109;09.01.2015;2015;01;05;Perjantai;1;4;5;0;2;2
109;09.01.2015;2015;01;06;Perjantai;9;7;16;5;2;7
109;09.01.2015;2015;01;07;Perjantai;20;23;43;9;10;19
109;09.01.2015;2015;01;08;Perjantai;7;6;13;4;1;5
109;09.01.2015;2015;01;09;Perjantai;0;2;2;0;2;2
109;09.01.2015;2015;01;10;Perjantai;5;3;8;3;0;3
109;09.01.2015;2015;01;11;Perjantai;4;6;10;0;4;4
109;09.01.2015;2015;01;12;Perjantai;5;3;8;4;1;5
109;09.01.2015;2015;01;13;Perjantai;6;8;14;0;4;4
109;09.01.2015;2015;01;14;Perjantai;6;4;10;2;2;4
109;09.01.2015;2015;01;15;Perjantai;9;10;19;3;5;8
109;09.01.2015;2015;01;16;Perjantai;12;11;23;5;4;9
109;09.01.2015;2015;01;17;Perjantai;9;10;19;2;5;7
109;09.01.2015;2015;01;18;Perjantai;5;2;7;3;0;3
109;09.01.2015;2015;01;19;Perjantai;2;5;7;0;3;3
109;09.01.2015;2015;01;20;Perjantai;5;2;7;3;0;3
109;09.01.2015;2015;01;21;Perjantai;0;3;3;0;1;1
109;09.01.2015;2015;01;22;Perjantai;4;2;6;3;0;3
109;09.01.2015;2015;01;23;Perjantai;1;2;3;0;2;2
109;10.01.2015;2015;01;00;Lauantai;1;0;1;0;0;0
109;10.01.2015;2015;01;01;Lauantai;0;0;0;0;0;0
109;10.01.2015;2015;01;02;Lauantai;0;0;0;0;0;0
109;10.01.2015;2015;01;03;Lauantai;0;0;0;0;0;0
109;10.01.2015;2015;01;04;Lauantai;1;0;1;0;0;0
109;10.01.2015;2015;01;05;Lauantai;0;2;2;0;0;0
109;10.01.2015;2015;01;06;Lauantai;1;0;1;0;0;0
109;10.01.2015;2015;01;07;Lauantai;2;4;6;1;3;4
109;10.01.2015;2015;01;08;Lauantai;4;2;6;3;1;4
109;10.01.2015;2015;01;09;Lauantai;2;4;6;1;3;4
109;10.01.2015;2015;01;10;Lauantai;5;4;9;5;2;7
109;10.01.2015;2015;01;11;Lauantai;3;4;7;0;3;3
109;10.01.2015;2015;01;12;Lauantai;7;5;12;6;4;10
109;10.01.2015;2015;01;13;Lauantai;1;4;5;0;4;4
109;10.01.2015;2015;01;14;Lauantai;6;2;8;3;2;5
109;10.01.2015;2015;01;15;Lauantai;2;5;7;1;3;4
109;10.01.2015;2015;01;16;Lauantai;6;4;10;4;3;7
109;10.01.2015;2015;01;17;Lauantai;0;3;3;0;1;1
109;10.01.2015;2015;01;18;Lauantai;6;4;10;4;2;6
109;10.01.2015;2015;01;19;Lauantai;1;4;5;0;2;2
109;10.01.2015;2015;01;20;Lauantai;4;1;5;3;0;3
109;10.01.2015;2015;01;21;Lauantai;2;4;6;0;3;3
109;10.01.2015;2015;01;22;Lauantai;1;0;1;1;0;1
109;10.01.2015;2015;01;23;Lauantai;0;2;2;0;1;1
109;11.01.2015;2015;01;00;Sunnuntai;1;0;1;0;0;0
109;11.01.2015;2015;01;01;Sunnuntai;0;1;1;0;0;0
109;11.01.2015;2015;01;02;Sunnuntai;0;0;0;0;0;0
109;11.01.2015;2015;01;03;Sunnuntai;0;2;2;0;1;1
109;11.01.2015;2015;01;04;Sunnuntai;2;2;4;2;1;3
109;11.01.2015;2015;01;05;Sunnuntai;0;2;2;0;0;0
109;11.01.2015;2015;01;06;Sunnuntai;4;1;5;1;1;2
109;11.01.2015;2015;01;07;Sunnuntai;0;2;2;0;2;2
109;11.01.2015;2015;01;08;Sunnuntai;2;1;3;2;0;2
109;11.01.2015;2015;01;09;Sunnuntai;0;4;4;0;2;2
109;11.01.2015;2015;01;10;Sunnuntai;4;0;4;2;0;2
109;11.01.2015;2015;01;11;Sunnuntai;3;5;8;1;3;4
109;11.01.2015;2015;01;12;Sunnuntai;6;4;10;5;4;9
109;11.01.2015;2015;01;13;Sunnuntai;3;7;10;3;3;6
109;11.01.2015;2015;01;14;Sunnuntai;6;5;11;5;3;8
109;11.01.2015;2015;01;15;Sunnuntai;4;4;8;0;4;4
109;11.01.2015;2015;01;16;Sunnuntai;5;4;9;4;3;7
109;11.01.2015;2015;01;17;Sunnuntai;4;6;10;3;6;9
109;11.01.2015;2015;01;18;Sunnuntai;5;2;7;2;2;4
109;11.01.2015;2015;01;19;Sunnuntai;2;4;6;1;3;4
109;11.01.2015;2015;01;20;Sunnuntai;4;0;4;1;0;1
109;11.01.2015;2015;01;21;Sunnuntai;2;6;8;2;4;6
109;11.01.2015;2015;01;22;Sunnuntai;2;1;3;1;0;1
109;11.01.2015;2015;01;23;Sunnuntai;0;2;2;0;0;0
109;12.01.2015;2015;01;00;Maanantai;1;0;1;0;0;0
109;12.01.2015;2015;01;01;Maanantai;0;0;0;0;0;0
109;12.01.2015;2015;01;02;Maanantai;0;0;0;0;0;0
109;12.01.2015;2015;01;03;Maanantai;0;0;0;0;0;0
109;12.01.2015;2015;01;04;Maanantai;0;0;0;0;0;0
109;12.01.2015;2015;01;05;Maanantai;1;4;5;0;1;1
109;12.01.2015;2015;01;06;Maanantai;7;4;11;3;1;4
109;12.01.2015;2015;01;07;Maanantai;11;13;24;5;6;11
109;12.01.2015;2015;01;08;Maanantai;8;8;16;5;2;7
109;12.01.2015;2015;01;09;Maanantai;0;2;2;0;2;2
109;12.01.2015;2015;01;10;Maanantai;5;3;8;3;0;3
109;12.01.2015;2015;01;11;Maanantai;4;6;10;0;4;4
109;12.01.2015;2015;01;12;Maanantai;5;3;8;4;1;5
109;12.01.2015;2015;01;13;Maanantai;6;8;14;0;4;4
109;12.01.2015;2015;01;14;Maanantai;6;4;10;2;2;4
109;12.01.2015;2015;01;15;Maanantai;9;10;19;3;5;8
109;12.01.2015;2015;01;16;Maanantai;12;11;23;5;4;9
109;12.01.2015;2015;01;17;Maanantai;9;10;19;2;5;7
109;12.01.2015;2015;01;18;Maanantai;5;2;7;3;0;3
109;12.01.2015;2015;01;19;Maanantai;2;5;7;0;3;3
109;12.01.2015;2015;01;20;Maanantai;5;2;7;3;0;3
109;12.01.2015;2015;01;21;Maanantai;0;3;3;0;1;1
109;12.01.2015;2015;01;22;Maanantai;4;2;6;3;0;3
109;12.01.2015;2015;01;23;Maanantai;1;2;3;0;2;2
109;13.01.2015;2015;01;00;Tiistai;1;0;1;0;0;0
109;13.01.2015;2015;01;01;Tiistai;0;0;0;0;0;0
109;13.01.2015;2015;01;02;Tiistai;0;0;0;0;0;0
109;13.01.2015;2015;01;03;Tiistai;0;0;0;0;0;0
109;13.01.2015;2015;01;04;Tiistai;0;0;0;0;0;0
109;13.01.2015;2015;01;05;Tiistai;1;4;5;0;1;1
109;13.01.2015;2015;01;06;Tiistai;7;4;11;3;1;4
109;13.01.2015;2015;01;07;Tiistai;11;13;24;5;6;11
109;13.01.2015;2015;01;08;Tiistai;8;8;16;5;2;7
109;13.01.2015;2015;01;09;Tiistai;0;2;2;0;2;2
109;13.01.2015;2015;01;10;Tiistai;5;3;8;3;0;3
109;13.01.2015;2015;01;11;Tiistai;4;6;10;0;4;4
109;13.01.2015;2015;01;12;Tiistai;5;3;8;4;1;5
109;13.01.2015;2015;01;13;Tiistai;6;8;14;0;4;4
109;13.01.2015;2015;01;14;Tiistai;6;4;10;2;2;4
109;13.01.2015;2015;01;15;Tiistai;9;10;19;3;5;8
109;13.01.2015;2015;01;16;Tiistai;12;11;23;5;4;9
109;13.01.2015;2015;01;17;Tiistai;9;10;19;2;5;7
109;13.01.2015;2015;01;18;Tiistai;5;2;7;3;0;3
109;13.01.2015;2015;01;19;Tiistai;2;5;7;0;3;3
109;13.01.2015;2015;01;20;Tiistai;5;2;7;3;0;3
109;13.01.2015;2015;01;21;Tiistai;0;3;3;0;1;1
109;13.01.2015;2015;01;22;Tiistai;4;2;6;3;0;3
109;13.01.2015;2015;01;23;Tiistai;1;2;3;0;2;2
109;14.01.2015;2015;01;00;Keskiviikko;1;0;1;0;0;0
109;14.01.2015;2015;01;01;Keskiviikko;0;0;0;0;0;0
109;14.01.2015;2015;01;02;Keskiviikko;0;0;0;0;0;0
109;14.01.2015;2015;01;03;Keskiviikko;0;0;0;0;0;0
109;14.01.2015;2015;01;04;Keskiviikko;1;0;1;0;0;0
109;14.01.2015;2015;01;05;Keskiviikko;1;4;5;0;2;2
109;14.01.2015;2015;01;06;Keskiviikko;9;7;16;5;2;7
109;14.01.2015;2015;01;07;Keskiviikko;20;23;43;9;10;19
109;14.01.2015;2015;01;08;Keskiviikko;7;6;13;4;1;5
109;14.01.2015;2015;01;09;Keskiviikko;0;2;2;0;2;2
109;14.01.2015;2015;01;10;Keskiviikko;5;3;8;3;0;3
109;14.01.2015;2015;01;11;Keskiviikko;4;6;10;0;4;4
109;14.01.2015;2015;01;12;Keskiviikko;5;3;8;4;1;5
109;14.01.2015;2015;01;13;Keskiviikko;6;8;14;0;4;4
109;14.01.2015;2015;01;14;Keskiviikko;6;4;10;2;2;4
109;14.01.2015;2015;01;15;Keskiviikko;9;10;19;3;5;8
109;14.01.2015;2015;01;16;Keskiviikko;12;11;23;5;4;9
109;14.01.2015;2015;01;17;Keskiviikko;9;10;19;2;5;7
109;14.01.2015;2015;01;18;Keskiviikko;5;2;7;3;0;3
109;14.01.2015;2015;01;19;Keskiviikko;2;5;7;0;3;3
109;14.01.2015;2015;01;20;Keskiviikko;5;2;7;3;0;3
109;14.01.2015;2015;01;21;Keskiviikko;0;3;3;0;1;1
109;14.01.2015;2015;01;22;Keskiviikko;4;2;6;3;0;3
109;14.01.2015;2015;01;23;Keskiviikko;1;2;3;0;2;2
109;15.01.2015;2015;01;00;Torstai;1;0;1;0;0;0
109;15.01.2015;2015;01;01;Torstai;0;0;0;0;0;0
109;15.01.2015;2015;01;02;Torstai;0;0;0;0;0;0
109;15.01.2015;2015;01;03;Torstai;0;0;0;0;0;0
109;15.01.2015;2015;01;04;Torstai;0;0;0;0;0;0
109;15.01.2015;2015;01;05;Torstai;1;4;5;0;1;1
109;15.01.2015;2015;01;06;Torstai;7;4;11;3;1;4
109;15.01.2015;2015;01;07;Torstai;11;13;24;5;6;11
109;15.01.2015;2015;01;08;Torstai;8;8;16;5;2;7
109;15.01.2015;2015;01;09;Torstai;0;2;2;0;2;2
109;15.01.2015;2015;01;10;Torstai;5;3;8;3;0;3
109;15.01.2015;2015;01;11;Torstai;4;6;10;0;4;4
109;15.01.2015;2015;01;12;Torstai;5;3;8;4;1;5
109;15.01.2015;2015;01;13;Torstai;6;8;14;0;4;4
109;15.01.2015;2015;01;14;Torstai;6;4;10;2;2;4
109;15.01.2015;2015;01;15;Torstai;9;10;19;3;5;8
109;15.01.2015;2015;01;16;Torstai;12;11;23;5;4;9
109;15.01.2015;2015;01;17;Torstai;9;10;19;2;5;7
109;15.01.2015;2015;01;18;Torstai;5;2;7;3;0;3
109;15.01.2015;2015;01;19;Torstai;2;5;7;0;3;3
109;15.01.2015;2015;01;20;Torstai;5;2;7;3;0;3
109;15.01.2015;2015;01;21;Torstai;0;3;3;0;1;1
109;15.01.2015;2015;01;22;Torstai;4;2;6;3;0;3
109;15.01.2015;2015;01;23;Torstai;1;2;3;0;2;2
109;16.01.2015;2015;01;00;Perjantai;1;0;1;0;0;0
109;16.01.2015;2015;01;01;Perjantai;0;0;0;0;0;0
109;16.01.2015;2015;01;02;Perjantai;0;0;0;0;0;0
109;16.01.2015;2015;01;03;Perjantai;0;0;0;0;0;0
109;16.01.2015;2015;01;04;Perjantai;1;0;1;0;0;0
109;16.01.2015;2015;01;05;Perjantai;1;4;5;0;2;2
109;16.01.2015;2015;01;06;Perjantai;9;7;16;5;2;7
109;16.01.2015;2015;01;07;Perjantai;20;23;43;9;10;19
109;16.01.2015;2015;01;08;Perjantai;7;6;13;4;1;5
109;16.01.2015;2015;01;09;Perjantai;0;2;2;0;2;2
109;16.01.2015;2015;01;10;Perjantai;5;3;8;3;0;3
109;16.01.2015;2015;01;11;Perjantai;4;6;10;0;4;4
109;16.01.2015;2015;01;12;Perjantai;5;3;8;4;1;5
109;16.01.2015;2015;01;13;Perjantai;6;8;14;0;4;4
109;16.01.2015;2015;01;14;Perjantai;6;4;10;2;2;4
109;16.01.2015;2015;01;15;Perjantai;9;10;19;3;5;8
109;16.01.2015;2015;01;16;Perjantai;12;11;23;5;4;9
109;16.01.2015;2015;01;17;Perjantai;9;10;19;2;5;7
109;16.01.2015;2015;01;18;Perjantai;5;2;7;3;0;3
109;16.01.2015;2015;01;19;Perjantai;2;5;7;0;3;3
109;16.01.2015;2015;01;20;Perjantai;5;2;7;3;0;3
109;16.01.2015;2015;01;21;Perjantai;0;3;3;0;1;1
109;16.01.2015;2015;01;22;Perjantai;4;2;6;3;0;3
109;16.01.2015;2015;01;23;Perjantai;1;2;3;0;2;2
109;17.01.2015;2015;01;00;Lauantai;1;0;1;0;0;0
109;17.01.2015;2015;01;01;Lauantai;0;0;0;0;0;0
109;17.01.2015;2015;01;02;Lauantai;0;0;0;0;0;0
109;17.01.2015;2015;01;03;Lauantai;0;0;0;0;0;0
109;17.01.2015;2015;01;04;Lauantai;1;0;1;0;0;0
109;17.01.2015;2015;01;05;Lauantai;0;2;2;0;0;0
109;17.01.2015;2015;01;06;Lauantai;1;0;1;0;0;0
109;17.01.2015;2015;01;07;Lauantai;2;4;6;1;3;4
109;17.01.2015;2015;01;08;Lauantai;4;2;6;3;1;4
109;17.01.2015;2015;01;09;Lauantai;2;4;6;1;3;4
109;17.01.2015;2015;01;10;Lauantai;5;4;9;5;2;7
109;17.01.2015;2015;01;11;Lauantai;3;4;7;0;3;3
109;17.01.2015;2015;01;12;Lauantai;7;5;12;6;4;10
109;17.01.2015;2015;01;13;Lauantai;1;4;5;0;4;4
109;17.01.2015;2015;01;14;Lauantai;6;2;8;3;2;5
109;17.01.2015;2015;01;15;Lauantai;2;5;7;1;3;4
109;17.01.2015;2015;01;16;Lauantai;6;4;10;4;3;7
109;17.01.2015;2015;01;17;Lauantai;0;3;3;0;1;1
109;17.01.2015;2015;01;18;Lauantai;6;4;10;4;2;6
109;17.01.2015;2015;01;19;Lauantai;1;4;5;0;2;2
109;17.01.2015;2015;01;20;Lauantai;4;1;5;3;0;3
109;17.01.2015;2015;01;21;Lauantai;2;4;6;0;3;3
109;17.01.2015;2015;01;22;Lauantai;1;0;1;1;0;1
109;17.01.2015;2015;01;23;Lauantai;0;2;2;0;1;1
109;18.01.2015;2015;01;00;Sunnuntai;4;2;6;2;2;4
109;18.01.2015;2015;01;01;Sunnuntai;0;0;0;0;0;0
109;18.01.2015;2015;01;02;Sunnuntai;0;0;0;0;0;0
109;18.01.2015;2015;01;03;Sunnuntai;0;1;1;0;0;0
109;18.01.2015;2015;01;04;Sunnuntai;1;0;1;0;0;0
109;18.01.2015;2015;01;05;Sunnuntai;0;3;3;0;0;0
109;18.01.2015;2015;01;06;Sunnuntai;4;1;5;1;0;1
109;18.01.2015;2015;01;07;Sunnuntai;0;1;1;0;1;1
109;18.01.2015;2015;01;08;Sunnuntai;4;1;5;1;0;1
109;18.01.2015;2015;01;09;Sunnuntai;2;4;6;1;3;4
109;18.01.2015;2015;01;10;Sunnuntai;5;4;9;4;2;6
109;18.01.2015;2015;01;11;Sunnuntai;4;7;11;3;5;8
109;18.01.2015;2015;01;12;Sunnuntai;6;4;10;5;2;7
109;18.01.2015;2015;01;13;Sunnuntai;3;6;9;3;3;6
109;18.01.2015;2015;01;14;Sunnuntai;7;4;11;5;4;9
109;18.01.2015;2015;01;15;Sunnuntai;5;6;11;3;5;8
109;18.01.2015;2015;01;16;Sunnuntai;5;4;9;5;2;7
109;18.01.2015;2015;01;17;Sunnuntai;4;5;9;2;4;6
109;18.01.2015;2015;01;18;Sunnuntai;3;2;5;3;2;5
109;18.01.2015;2015;01;19;Sunnuntai;4;7;11;3;5;8
109;18.01.2015;2015;01;20;Sunnuntai;3;2;5;2;1;3
109;18.01.2015;2015;01;21;Sunnuntai;1;5;6;1;2;3
109;18.01.2015;2015;01;22;Sunnuntai;1;0;1;1;0;1
109;18.01.2015;2015;01;23;Sunnuntai;0;0;0;0;0;0
109;19.01.2015;2015;01;00;Maanantai;0;0;0;0;0;0
109;19.01.2015;2015;01;01;Maanantai;0;1;1;0;0;0
109;19.01.2015;2015;01;02;Maanantai;0;0;0;0;0;0
109;19.01.2015;2015;01;03;Maanantai;0;0;0;0;0;0
109;19.01.2015;2015;01;04;Maanantai;0;0;0;0;0;0
109;19.01.2015;2015;01;05;Maanantai;1;3;4;0;3;3
109;19.01.2015;2015;01;06;Maanantai;10;8;18;5;4;9
109;19.01.2015;2015;01;07;Maanantai;24;27;51;10;13;23
109;19.01.2015;2015;01;08;Maanantai;25;23;48;12;9;21
109;19.01.2015;2015;01;09;Maanantai;7;8;15;1;4;5
109;19.01.2015;2015;01;10;Maanantai;9;7;16;4;1;5
109;19.01.2015;2015;01;11;Maanantai;6;7;13;0;4;4
109;19.01.2015;2015;01;12;Maanantai;8;8;16;5;2;7
109;19.01.2015;2015;01;13;Maanantai;6;8;14;1;4;5
109;19.01.2015;2015;01;14;Maanantai;28;27;55;12;11;23
109;19.01.2015;2015;01;15;Maanantai;13;14;27;5;7;12
109;19.01.2015;2015;01;16;Maanantai;30;27;57;13;11;24
109;19.01.2015;2015;01;17;Maanantai;15;15;30;6;6;12
109;19.01.2015;2015;01;18;Maanantai;8;7;15;4;1;5
109;19.01.2015;2015;01;19;Maanantai;7;8;15;2;4;6
109;19.01.2015;2015;01;20;Maanantai;7;6;13;4;1;5
109;19.01.2015;2015;01;21;Maanantai;4;4;8;0;3;3
109;19.01.2015;2015;01;22;Maanantai;4;2;6;1;1;2
109;19.01.2015;2015;01;23;Maanantai;0;3;3;0;1;1
109;20.01.2015;2015;01;00;Tiistai;1;0;1;1;0;1
109;20.01.2015;2015;01;01;Tiistai;0;1;1;0;0;0
109;20.01.2015;2015;01;02;Tiistai;1;0;1;0;0;0
109;20.01.2015;2015;01;03;Tiistai;0;0;0;0;0;0
109;20.01.2015;2015;01;04;Tiistai;0;0;0;0;0;0
109;20.01.2015;2015;01;05;Tiistai;1;2;3;0;1;1
109;20.01.2015;2015;01;06;Tiistai;10;8;18;6;3;9
109;20.01.2015;2015;01;07;Tiistai;22;23;45;8;10;18
109;20.01.2015;2015;01;08;Tiistai;17;16;33;8;5;13
109;20.01.2015;2015;01;09;Tiistai;3;6;9;0;4;4
109;20.01.2015;2015;01;10;Tiistai;6;3;9;3;0;3
109;20.01.2015;2015;01;11;Tiistai;4;7;11;1;3;4
109;20.01.2015;2015;01;12;Tiistai;6;3;9;3;0;3
109;20.01.2015;2015;01;13;Tiistai;5;7;12;0;4;4
109;20.01.2015;2015;01;14;Tiistai;10;8;18;4;2;6
109;20.01.2015;2015;01;15;Tiistai;10;10;20;4;5;9
109;20.01.2015;2015;01;16;Tiistai;19;19;38;9;7;16
109;20.01.2015;2015;01;17;Tiistai;14;14;28;6;7;13
109;20.01.2015;2015;01;18;Tiistai;7;5;12;4;1;5
109;20.01.2015;2015;01;19;Tiistai;3;4;7;0;4;4
109;20.01.2015;2015;01;20;Tiistai;4;1;5;2;0;2
109;20.01.2015;2015;01;21;Tiistai;1;3;4;0;2;2
109;20.01.2015;2015;01;22;Tiistai;5;2;7;2;1;3
109;20.01.2015;2015;01;23;Tiistai;0;2;2;0;1;1
109;21.01.2015;2015;01;00;Keskiviikko;0;0;0;0;0;0
109;21.01.2015;2015;01;01;Keskiviikko;0;2;2;0;0;0
109;21.01.2015;2015;01;02;Keskiviikko;0;0;0;0;0;0
109;21.01.2015;2015;01;03;Keskiviikko;0;1;1;0;0;0
109;21.01.2015;2015;01;04;Keskiviikko;1;0;1;0;0;0
109;21.01.2015;2015;01;05;Keskiviikko;1;3;4;0;1;1
109;21.01.2015;2015;01;06;Keskiviikko;12;10;22;6;3;9
109;21.01.2015;2015;01;07;Keskiviikko;22;24;46;10;10;20
109;21.01.2015;2015;01;08;Keskiviikko;20;19;39;9;7;16
109;21.01.2015;2015;01;09;Keskiviikko;5;7;12;0;4;4
109;21.01.2015;2015;01;10;Keskiviikko;9;8;17;4;1;5
109;21.01.2015;2015;01;11;Keskiviikko;5;8;13;2;2;4
109;21.01.2015;2015;01;12;Keskiviikko;7;5;12;4;1;5
109;21.01.2015;2015;01;13;Keskiviikko;10;11;21;4;5;9
109;21.01.2015;2015;01;14;Keskiviikko;9;9;18;5;3;8
109;21.01.2015;2015;01;15;Keskiviikko;16;16;32;5;8;13
109;21.01.2015;2015;01;16;Keskiviikko;29;26;55;13;11;24
109;21.01.2015;2015;01;17;Keskiviikko;14;15;29;5;7;12
109;21.01.2015;2015;01;18;Keskiviikko;10;8;18;5;3;8
109;21.01.2015;2015;01;19;Keskiviikko;7;7;14;3;4;7
109;21.01.2015;2015;01;20;Keskiviikko;5;3;8;3;0;3
109;21.01.2015;2015;01;21;Keskiviikko;3;4;7;0;3;3
109;21.01.2015;2015;01;22;Keskiviikko;4;2;6;4;0;4
109;21.01.2015;2015;01;23;Keskiviikko;1;1;2;0;1;1
109;22.01.2015;2015;01;00;Torstai;2;0;2;1;0;1
109;22.01.2015;2015;01;01;Torstai;0;0;0;0;0;0
109;22.01.2015;2015;01;02;Torstai;0;0;0;0;0;0
109;22.01.2015;2015;01;03;Torstai;0;1;1;0;0;0
109;22.01.2015;2015;01;04;Torstai;1;0;1;0;0;0
109;22.01.2015;2015;01;05;Torstai;1;3;4;0;2;2
109;22.01.2015;2015;01;06;Torstai;10;10;20;5;3;8
109;22.01.2015;2015;01;07;Torstai;21;22;43;7;11;18
109;22.01.2015;2015;01;08;Torstai;20;18;38;8;6;14
109;22.01.2015;2015;01;09;Torstai;6;7;13;1;3;4
109;22.01.2015;2015;01;10;Torstai;4;2;6;3;0;3
109;22.01.2015;2015;01;11;Torstai;4;7;11;2;3;5
109;22.01.2015;2015;01;12;Torstai;8;7;15;4;1;5
109;22.01.2015;2015;01;13;Torstai;3;7;10;0;4;4
109;22.01.2015;2015;01;14;Torstai;9;8;17;4;4;8
109;22.01.2015;2015;01;15;Torstai;14;15;29;4;7;11
109;22.01.2015;2015;01;16;Torstai;22;20;42;11;8;19
109;22.01.2015;2015;01;17;Torstai;14;16;30;6;7;13
109;22.01.2015;2015;01;18;Torstai;7;7;14;4;1;5
109;22.01.2015;2015;01;19;Torstai;2;4;6;1;3;4
109;22.01.2015;2015;01;20;Torstai;6;4;10;3;1;4
109;22.01.2015;2015;01;21;Torstai;1;3;4;0;1;1
109;22.01.2015;2015;01;22;Torstai;6;3;9;3;1;4
109;22.01.2015;2015;01;23;Torstai;0;2;2;0;0;0
109;23.01.2015;2015;01;00;Perjantai;0;0;0;0;0;0
109;23.01.2015;2015;01;01;Perjantai;0;0;0;0;0;0
109;23.01.2015;2015;01;02;Perjantai;1;0;1;0;0;0
109;23.01.2015;2015;01;03;Perjantai;0;0;0;0;0;0
109;23.01.2015;2015;01;04;Perjantai;1;0;1;0;0;0
109;23.01.2015;2015;01;05;Perjantai;1;1;2;0;1;1
109;23.01.2015;2015;01;06;Perjantai;10;7;17;5;3;8
109;23.01.2015;2015;01;07;Perjantai;18;19;37;6;9;15
109;23.01.2015;2015;01;08;Perjantai;13;11;24;6;4;10
109;23.01.2015;2015;01;09;Perjantai;3;6;9;1;4;5
109;23.01.2015;2015;01;10;Perjantai;4;4;8;4;0;4
109;23.01.2015;2015;01;11;Perjantai;4;6;10;1;4;5
109;23.01.2015;2015;01;12;Perjantai;7;5;12;4;0;4
109;23.01.2015;2015;01;13;Perjantai;6;7;13;1;4;5
109;23.01.2015;2015;01;14;Perjantai;11;7;18;5;2;7
109;23.01.2015;2015;01;15;Perjantai;12;13;25;5;5;10
109;23.01.2015;2015;01;16;Perjantai;15;14;29;8;5;13
109;23.01.2015;2015;01;17;Perjantai;7;10;17;3;5;8
109;23.01.2015;2015;01;18;Perjantai;7;4;11;4;0;4
109;23.01.2015;2015;01;19;Perjantai;4;5;9;1;3;4
109;23.01.2015;2015;01;20;Perjantai;3;2;5;2;0;2
109;23.01.2015;2015;01;21;Perjantai;1;3;4;0;1;1
109;23.01.2015;2015;01;22;Perjantai;3;0;3;2;0;2
109;23.01.2015;2015;01;23;Perjantai;0;3;3;0;2;2
109;24.01.2015;2015;01;00;Lauantai;3;0;3;0;0;0
109;24.01.2015;2015;01;01;Lauantai;0;1;1;0;0;0
109;24.01.2015;2015;01;02;Lauantai;1;0;1;0;0;0
109;24.01.2015;2015;01;03;Lauantai;0;0;0;0;0;0
109;24.01.2015;2015;01;04;Lauantai;1;0;1;0;0;0
109;24.01.2015;2015;01;05;Lauantai;0;1;1;0;0;0
109;24.01.2015;2015;01;06;Lauantai;3;0;3;1;0;1
109;24.01.2015;2015;01;07;Lauantai;1;4;5;1;2;3
109;24.01.2015;2015;01;08;Lauantai;4;0;4;4;0;4
109;24.01.2015;2015;01;09;Lauantai;2;3;5;0;3;3
109;24.01.2015;2015;01;10;Lauantai;4;1;5;3;1;4
109;24.01.2015;2015;01;11;Lauantai;4;5;9;3;5;8
109;24.01.2015;2015;01;12;Lauantai;6;3;9;4;2;6
109;24.01.2015;2015;01;13;Lauantai;4;5;9;3;4;7
109;24.01.2015;2015;01;14;Lauantai;7;5;12;6;4;10
109;24.01.2015;2015;01;15;Lauantai;4;6;10;2;5;7
109;24.01.2015;2015;01;16;Lauantai;5;4;9;4;4;8
109;24.01.2015;2015;01;17;Lauantai;3;6;9;2;6;8
109;24.01.2015;2015;01;18;Lauantai;5;2;7;5;2;7
109;24.01.2015;2015;01;19;Lauantai;2;2;4;0;2;2
109;24.01.2015;2015;01;20;Lauantai;3;1;4;3;0;3
109;24.01.2015;2015;01;21;Lauantai;2;4;6;2;3;5
109;24.01.2015;2015;01;22;Lauantai;5;2;7;3;1;4
109;24.01.2015;2015;01;23;Lauantai;0;1;1;0;0;0
109;25.01.2015;2015;01;00;Sunnuntai;4;2;6;2;2;4
109;25.01.2015;2015;01;01;Sunnuntai;0;0;0;0;0;0
109;25.01.2015;2015;01;02;Sunnuntai;0;0;0;0;0;0
109;25.01.2015;2015;01;03;Sunnuntai;0;1;1;0;0;0
109;25.01.2015;2015;01;04;Sunnuntai;1;0;1;0;0;0
109;25.01.2015;2015;01;05;Sunnuntai;0;3;3;0;0;0
109;25.01.2015;2015;01;06;Sunnuntai;4;1;5;1;0;1
109;25.01.2015;2015;01;07;Sunnuntai;0;1;1;0;1;1
109;25.01.2015;2015;01;08;Sunnuntai;4;1;5;1;0;1
109;25.01.2015;2015;01;09;Sunnuntai;2;4;6;1;3;4
109;25.01.2015;2015;01;10;Sunnuntai;5;4;9;4;2;6
109;25.01.2015;2015;01;11;Sunnuntai;4;7;11;3;5;8
109;25.01.2015;2015;01;12;Sunnuntai;6;4;10;5;2;7
109;25.01.2015;2015;01;13;Sunnuntai;3;6;9;3;3;6
109;25.01.2015;2015;01;14;Sunnuntai;7;4;11;5;4;9
109;25.01.2015;2015;01;15;Sunnuntai;5;6;11;3;5;8
109;25.01.2015;2015;01;16;Sunnuntai;5;4;9;5;2;7
109;25.01.2015;2015;01;17;Sunnuntai;4;5;9;2;4;6
109;25.01.2015;2015;01;18;Sunnuntai;3;2;5;3;2;5
109;25.01.2015;2015;01;19;Sunnuntai;4;7;11;3;5;8
109;25.01.2015;2015;01;20;Sunnuntai;3;2;5;2;1;3
109;25.01.2015;2015;01;21;Sunnuntai;1;5;6;1;2;3
109;25.01.2015;2015;01;22;Sunnuntai;1;0;1;1;0;1
109;25.01.2015;2015;01;23;Sunnuntai;0;0;0;0;0;0
109;26.01.2015;2015;01;00;Maanantai;1;0;1;0;0;0
109;26.01.2015;2015;01;01;Maanantai;0;0;0;0;0;0
109;26.01.2015;2015;01;02;Maanantai;0;0;0;0;0;0
109;26.01.2015;2015;01;03;Maanantai;0;0;0;0;0;0
109;26.01.2015;2015;01;04;Maanantai;0;0;0;0;0;0
109;26.01.2015;2015;01;05;Maanantai;1;3;4;0;2;2
109;26.01.2015;2015;01;06;Maanantai;6;3;9;3;1;4
109;26.01.2015;2015;01;07;Maanantai;17;18;35;6;8;14
109;26.01.2015;2015;01;08;Maanantai;20;18;38;8;8;16
109;26.01.2015;2015;01;09;Maanantai;4;6;10;1;4;5
109;26.01.2015;2015;01;10;Maanantai;6;5;11;3;1;4
109;26.01.2015;2015;01;11;Maanantai;5;6;11;0;4;4
109;26.01.2015;2015;01;12;Maanantai;8;6;14;4;2;6
109;26.01.2015;2015;01;13;Maanantai;6;8;14;1;4;5
109;26.01.2015;2015;01;14;Maanantai;12;10;22;5;4;9
109;26.01.2015;2015;01;15;Maanantai;11;14;25;4;6;10
109;26.01.2015;2015;01;16;Maanantai;27;25;52;12;9;21
109;26.01.2015;2015;01;17;Maanantai;15;15;30;6;6;12
109;26.01.2015;2015;01;18;Maanantai;8;7;15;4;1;5
109;26.01.2015;2015;01;19;Maanantai;7;8;15;2;4;6
109;26.01.2015;2015;01;20;Maanantai;7;6;13;4;1;5
109;26.01.2015;2015;01;21;Maanantai;4;4;8;0;3;3
109;26.01.2015;2015;01;22;Maanantai;4;2;6;1;1;2
109;26.01.2015;2015;01;23;Maanantai;0;3;3;0;1;1
109;27.01.2015;2015;01;00;Tiistai;1;0;1;1;0;1
109;27.01.2015;2015;01;01;Tiistai;0;1;1;0;0;0
109;27.01.2015;2015;01;02;Tiistai;1;0;1;0;0;0
109;27.01.2015;2015;01;03;Tiistai;0;0;0;0;0;0
109;27.01.2015;2015;01;04;Tiistai;0;0;0;0;0;0
109;27.01.2015;2015;01;05;Tiistai;1;2;3;0;1;1
109;27.01.2015;2015;01;06;Tiistai;10;8;18;6;3;9
109;27.01.2015;2015;01;07;Tiistai;22;23;45;8;10;18
109;27.01.2015;2015;01;08;Tiistai;17;16;33;8;5;13
109;27.01.2015;2015;01;09;Tiistai;3;6;9;0;4;4
109;27.01.2015;2015;01;10;Tiistai;6;3;9;3;0;3
109;27.01.2015;2015;01;11;Tiistai;4;7;11;1;3;4
109;27.01.2015;2015;01;12;Tiistai;6;3;9;3;0;3
109;27.01.2015;2015;01;13;Tiistai;5;7;12;0;4;4
109;27.01.2015;2015;01;14;Tiistai;10;8;18;4;2;6
109;27.01.2015;2015;01;15;Tiistai;10;10;20;4;5;9
109;27.01.2015;2015;01;16;Tiistai;19;19;38;9;7;16
109;27.01.2015;2015;01;17;Tiistai;14;14;28;6;7;13
109;27.01.2015;2015;01;18;Tiistai;7;5;12;4;1;5
109;27.01.2015;2015;01;19;Tiistai;3;4;7;0;4;4
109;27.01.2015;2015;01;20;Tiistai;4;1;5;2;0;2
109;27.01.2015;2015;01;21;Tiistai;1;3;4;0;2;2
109;27.01.2015;2015;01;22;Tiistai;5;2;7;2;1;3
109;27.01.2015;2015;01;23;Tiistai;0;2;2;0;1;1
109;28.01.2015;2015;01;00;Keskiviikko;0;0;0;0;0;0
109;28.01.2015;2015;01;01;Keskiviikko;0;2;2;0;0;0
109;28.01.2015;2015;01;02;Keskiviikko;0;0;0;0;0;0
109;28.01.2015;2015;01;03;Keskiviikko;0;1;1;0;0;0
109;28.01.2015;2015;01;04;Keskiviikko;1;0;1;0;0;0
109;28.01.2015;2015;01;05;Keskiviikko;1;3;4;0;1;1
109;28.01.2015;2015;01;06;Keskiviikko;12;10;22;6;3;9
109;28.01.2015;2015;01;07;Keskiviikko;22;24;46;10;10;20
109;28.01.2015;2015;01;08;Keskiviikko;20;19;39;9;7;16
109;28.01.2015;2015;01;09;Keskiviikko;5;7;12;0;4;4
109;28.01.2015;2015;01;10;Keskiviikko;9;8;17;4;1;5
109;28.01.2015;2015;01;11;Keskiviikko;5;8;13;2;2;4
109;28.01.2015;2015;01;12;Keskiviikko;7;5;12;4;1;5
109;28.01.2015;2015;01;13;Keskiviikko;10;11;21;4;5;9
109;28.01.2015;2015;01;14;Keskiviikko;9;9;18;5;3;8
109;28.01.2015;2015;01;15;Keskiviikko;16;16;32;5;8;13
109;28.01.2015;2015;01;16;Keskiviikko;29;26;55;13;11;24
109;28.01.2015;2015;01;17;Keskiviikko;14;15;29;5;7;12
109;28.01.2015;2015;01;18;Keskiviikko;10;8;18;5;3;8
109;28.01.2015;2015;01;19;Keskiviikko;7;7;14;3;4;7
109;28.01.2015;2015;01;20;Keskiviikko;5;3;8;3;0;3
109;28.01.2015;2015;01;21;Keskiviikko;3;4;7;0;3;3
109;28.01.2015;2015;01;22;Keskiviikko;4;2;6;4;0;4
109;28.01.2015;2015;01;23;Keskiviikko;1;1;2;0;1;1
109;29.01.2015;2015;01;00;Torstai;2;0;2;1;0;1
109;29.01.2015;2015;01;01;Torstai;0;0;0;0;0;0
109;29.01.2015;2015;01;02;Torstai;0;0;0;0;0;0
109;29.01.2015;2015;01;03;Torstai;0;1;1;0;0;0
109;29.01.2015;2015;01;04;Torstai;1;0;1;0;0;0
109;29.01.2015;2015;01;05;Torstai;1;3;4;0;2;2
109;29.01.2015;2015;01;06;Torstai;10;10;20;5;3;8
109;29.01.2015;2015;01;07;Torstai;21;22;43;7;11;18
109;29.01.2015;2015;01;08;Torstai;20;18;38;8;6;14
109;29.01.2015;2015;01;09;Torstai;6;7;13;1;3;4
109;29.01.2015;2015;01;10;Torstai;4;2;6;3;0;3
109;29.01.2015;2015;01;11;Torstai;4;7;11;2;3;5
109;29.01.2015;2015;01;12;Torstai;3;2;5;1;0;1
109;29.01.2015;2015;01;13;Torstai;3;6;9;0;3;3
109;29.01.2015;2015;01;14;Torstai;6;5;11;4;1;5
109;29.01.2015;2015;01;15;Torstai;13;14;27;5;6;11
109;29.01.2015;2015;01;16;Torstai;20;19;39;9;7;16
109;29.01.2015;2015;01;17;Torstai;13;13;26;5;5;10
109;29.01.2015;2015;01;18;Torstai;8;6;14;5;2;7
109;29.01.2015;2015;01;19;Torstai;3;5;8;0;4;4
109;29.01.2015;2015;01;20;Torstai;5;4;9;4;1;5
109;29.01.2015;2015;01;21;Torstai;1;3;4;0;1;1
109;29.01.2015;2015;01;22;Torstai;3;1;4;1;0;1
109;29.01.2015;2015;01;23;Torstai;0;0;0;0;0;0
109;30.01.2015;2015;01;00;Perjantai;0;0;0;0;0;0
109;30.01.2015;2015;01;01;Perjantai;0;0;0;0;0;0
109;30.01.2015;2015;01;02;Perjantai;1;0;1;0;0;0
109;30.01.2015;2015;01;03;Perjantai;0;0;0;0;0;0
109;30.01.2015;2015;01;04;Perjantai;1;0;1;0;0;0
109;30.01.2015;2015;01;05;Perjantai;1;1;2;0;1;1
109;30.01.2015;2015;01;06;Perjantai;10;7;17;5;3;8
109;30.01.2015;2015;01;07;Perjantai;18;19;37;6;9;15
109;30.01.2015;2015;01;08;Perjantai;13;11;24;6;4;10
109;30.01.2015;2015;01;09;Perjantai;3;6;9;1;4;5
109;30.01.2015;2015;01;10;Perjantai;4;4;8;4;0;4
109;30.01.2015;2015;01;11;Perjantai;4;6;10;1;4;5
109;30.01.2015;2015;01;12;Perjantai;7;5;12;4;0;4
109;30.01.2015;2015;01;13;Perjantai;6;7;13;1;4;5
109;30.01.2015;2015;01;14;Perjantai;11;7;18;5;2;7
109;30.01.2015;2015;01;15;Perjantai;12;13;25;5;5;10
109;30.01.2015;2015;01;16;Perjantai;15;14;29;8;5;13
109;30.01.2015;2015;01;17;Perjantai;7;10;17;3;5;8
109;30.01.2015;2015;01;18;Perjantai;7;4;11;4;0;4
109;30.01.2015;2015;01;19;Perjantai;4;5;9;1;3;4
109;30.01.2015;2015;01;20;Perjantai;3;2;5;2;0;2
109;30.01.2015;2015;01;21;Perjantai;1;3;4;0;1;1
109;30.01.2015;2015;01;22;Perjantai;3;0;3;2;0;2
109;30.01.2015;2015;01;23;Perjantai;0;3;3;0;2;2
109;31.01.2015;2015;01;00;Lauantai;3;0;3;0;0;0
109;31.01.2015;2015;01;01;Lauantai;0;1;1;0;0;0
109;31.01.2015;2015;01;02;Lauantai;1;0;1;0;0;0
109;31.01.2015;2015;01;03;Lauantai;0;0;0;0;0;0
109;31.01.2015;2015;01;04;Lauantai;1;0;1;0;0;0
109;31.01.2015;2015;01;05;Lauantai;0;1;1;0;0;0
109;31.01.2015;2015;01;06;Lauantai;3;0;3;1;0;1
109;31.01.2015;2015;01;07;Lauantai;1;4;5;1;2;3
109;31.01.2015;2015;01;08;Lauantai;4;0;4;4;0;4
109;31.01.2015;2015;01;09;Lauantai;2;3;5;0;3;3
109;31.01.2015;2015;01;10;Lauantai;4;1;5;3;1;4
109;31.01.2015;2015;01;11;Lauantai;4;5;9;3;5;8
109;31.01.2015;2015;01;12;Lauantai;6;3;9;4;2;6
109;31.01.2015;2015;01;13;Lauantai;4;5;9;3;4;7
109;31.01.2015;2015;01;14;Lauantai;7;5;12;6;4;10
109;31.01.2015;2015;01;15;Lauantai;4;6;10;2;5;7
109;31.01.2015;2015;01;16;Lauantai;5;4;9;4;4;8
109;31.01.2015;2015;01;17;Lauantai;3;6;9;2;6;8
109;31.01.2015;2015;01;18;Lauantai;5;2;7;5;2;7
109;31.01.2015;2015;01;19;Lauantai;2;2;4;0;2;2
109;31.01.2015;2015;01;20;Lauantai;3;1;4;3;0;3
109;31.01.2015;2015;01;21;Lauantai;2;4;6;2;3;5
109;31.01.2015;2015;01;22;Lauantai;5;2;7;3;1;4
109;31.01.2015;2015;01;23;Lauantai;0;1;1;0;0;0
109;01.02.2015;2015;02;00;Sunnuntai;4;2;6;2;2;4
109;01.02.2015;2015;02;01;Sunnuntai;0;0;0;0;0;0
109;01.02.2015;2015;02;02;Sunnuntai;0;0;0;0;0;0
109;01.02.2015;2015;02;03;Sunnuntai;0;1;1;0;0;0
109;01.02.2015;2015;02;04;Sunnuntai;1;0;1;0;0;0
109;01.02.2015;2015;02;05;Sunnuntai;0;3;3;0;0;0
109;01.02.2015;2015;02;06;Sunnuntai;4;1;5;1;0;1
109;01.02.2015;2015;02;07;Sunnuntai;0;1;1;0;1;1
109;01.02.2015;2015;02;08;Sunnuntai;4;1;5;1;0;1
109;01.02.2015;2015;02;09;Sunnuntai;2;4;6;1;3;4
109;01.02.2015;2015;02;10;Sunnuntai;5;4;9;4;2;6
109;01.02.2015;2015;02;11;Sunnuntai;4;7;11;3;5;8
109;01.02.2015;2015;02;12;Sunnuntai;6;4;10;5;2;7
109;01.02.2015;2015;02;13;Sunnuntai;3;6;9;3;3;6
109;01.02.2015;2015;02;14;Sunnuntai;7;4;11;5;4;9
109;01.02.2015;2015;02;15;Sunnuntai;5;6;11;3;5;8
109;01.02.2015;2015;02;16;Sunnuntai;5;4;9;5;2;7
109;01.02.2015;2015;02;17;Sunnuntai;4;5;9;2;4;6
109;01.02.2015;2015;02;18;Sunnuntai;3;2;5;3;2;5
109;01.02.2015;2015;02;19;Sunnuntai;4;7;11;3;5;8
109;01.02.2015;2015;02;20;Sunnuntai;3;2;5;2;1;3
109;01.02.2015;2015;02;21;Sunnuntai;1;5;6;1;2;3
109;01.02.2015;2015;02;22;Sunnuntai;1;0;1;1;0;1
109;01.02.2015;2015;02;23;Sunnuntai;0;0;0;0;0;0
109;02.02.2015;2015;02;00;Maanantai;1;0;1;0;0;0
109;02.02.2015;2015;02;01;Maanantai;0;0;0;0;0;0
109;02.02.2015;2015;02;02;Maanantai;0;0;0;0;0;0
109;02.02.2015;2015;02;03;Maanantai;0;0;0;0;0;0
109;02.02.2015;2015;02;04;Maanantai;0;0;0;0;0;0
109;02.02.2015;2015;02;05;Maanantai;1;3;4;0;2;2
109;02.02.2015;2015;02;06;Maanantai;6;3;9;3;1;4
109;02.02.2015;2015;02;07;Maanantai;17;18;35;6;8;14
109;02.02.2015;2015;02;08;Maanantai;20;18;38;8;8;16
109;02.02.2015;2015;02;09;Maanantai;4;6;10;1;4;5
109;02.02.2015;2015;02;10;Maanantai;6;5;11;3;1;4
109;02.02.2015;2015;02;11;Maanantai;5;6;11;0;4;4
109;02.02.2015;2015;02;12;Maanantai;8;6;14;4;2;6
109;02.02.2015;2015;02;13;Maanantai;6;8;14;1;4;5
109;02.02.2015;2015;02;14;Maanantai;12;10;22;5;4;9
109;02.02.2015;2015;02;15;Maanantai;11;14;25;4;6;10
109;02.02.2015;2015;02;16;Maanantai;27;25;52;12;9;21
109;02.02.2015;2015;02;17;Maanantai;15;15;30;6;6;12
109;02.02.2015;2015;02;18;Maanantai;8;7;15;4;1;5
109;02.02.2015;2015;02;19;Maanantai;7;8;15;2;4;6
109;02.02.2015;2015;02;20;Maanantai;7;6;13;4;1;5
109;02.02.2015;2015;02;21;Maanantai;4;4;8;0;3;3
109;02.02.2015;2015;02;22;Maanantai;4;2;6;1;1;2
109;02.02.2015;2015;02;23;Maanantai;0;3;3;0;1;1
109;03.02.2015;2015;02;00;Tiistai;1;0;1;1;0;1
109;03.02.2015;2015;02;01;Tiistai;0;1;1;0;0;0
109;03.02.2015;2015;02;02;Tiistai;1;0;1;0;0;0
109;03.02.2015;2015;02;03;Tiistai;0;0;0;0;0;0
109;03.02.2015;2015;02;04;Tiistai;0;0;0;0;0;0
109;03.02.2015;2015;02;05;Tiistai;1;2;3;0;1;1
109;03.02.2015;2015;02;06;Tiistai;10;8;18;6;3;9
109;03.02.2015;2015;02;07;Tiistai;22;23;45;8;10;18
109;03.02.2015;2015;02;08;Tiistai;17;16;33;8;5;13
109;03.02.2015;2015;02;09;Tiistai;3;6;9;0;4;4
109;03.02.2015;2015;02;10;Tiistai;6;3;9;3;0;3
109;03.02.2015;2015;02;11;Tiistai;4;7;11;1;3;4
109;03.02.2015;2015;02;12;Tiistai;6;3;9;3;0;3
109;03.02.2015;2015;02;13;Tiistai;5;7;12;0;4;4
109;03.02.2015;2015;02;14;Tiistai;10;8;18;4;2;6
109;03.02.2015;2015;02;15;Tiistai;10;10;20;4;5;9
109;03.02.2015;2015;02;16;Tiistai;19;19;38;9;7;16
109;03.02.2015;2015;02;17;Tiistai;14;14;28;6;7;13
109;03.02.2015;2015;02;18;Tiistai;7;5;12;4;1;5
109;03.02.2015;2015;02;19;Tiistai;3;4;7;0;4;4
109;03.02.2015;2015;02;20;Tiistai;4;1;5;2;0;2
109;03.02.2015;2015;02;21;Tiistai;1;3;4;0;2;2
109;03.02.2015;2015;02;22;Tiistai;5;2;7;2;1;3
109;03.02.2015;2015;02;23;Tiistai;0;2;2;0;1;1
109;04.02.2015;2015;02;00;Keskiviikko;1;0;1;1;0;1
109;04.02.2015;2015;02;01;Keskiviikko;0;1;1;0;0;0
109;04.02.2015;2015;02;02;Keskiviikko;1;0;1;0;0;0
109;04.02.2015;2015;02;03;Keskiviikko;0;0;0;0;0;0
109;04.02.2015;2015;02;04;Keskiviikko;0;0;0;0;0;0
109;04.02.2015;2015;02;05;Keskiviikko;1;2;3;0;1;1
109;04.02.2015;2015;02;06;Keskiviikko;10;8;18;6;3;9
109;04.02.2015;2015;02;07;Keskiviikko;22;23;45;8;10;18
109;04.02.2015;2015;02;08;Keskiviikko;17;16;33;8;5;13
109;04.02.2015;2015;02;09;Keskiviikko;3;6;9;0;4;4
109;04.02.2015;2015;02;10;Keskiviikko;2;0;2;1;0;1
109;04.02.2015;2015;02;11;Keskiviikko;3;5;8;0;4;4
109;04.02.2015;2015;02;12;Keskiviikko;2;0;2;2;0;2
109;04.02.2015;2015;02;13;Keskiviikko;3;5;8;0;4;4
109;04.02.2015;2015;02;14;Keskiviikko;8;6;14;4;1;5
109;04.02.2015;2015;02;15;Keskiviikko;9;11;20;3;6;9
109;04.02.2015;2015;02;16;Keskiviikko;22;21;43;10;9;19
109;04.02.2015;2015;02;17;Keskiviikko;14;14;28;5;7;12
109;04.02.2015;2015;02;18;Keskiviikko;10;8;18;5;1;6
109;04.02.2015;2015;02;19;Keskiviikko;6;6;12;1;4;5
109;04.02.2015;2015;02;20;Keskiviikko;4;2;6;3;0;3
109;04.02.2015;2015;02;21;Keskiviikko;4;6;10;1;4;5
109;04.02.2015;2015;02;22;Keskiviikko;3;1;4;1;0;1
109;04.02.2015;2015;02;23;Keskiviikko;0;2;2;0;1;1
109;05.02.2015;2015;02;00;Torstai;1;0;1;1;0;1
109;05.02.2015;2015;02;01;Torstai;0;0;0;0;0;0
109;05.02.2015;2015;02;02;Torstai;0;0;0;0;0;0
109;05.02.2015;2015;02;03;Torstai;0;0;0;0;0;0
109;05.02.2015;2015;02;04;Torstai;1;0;1;0;0;0
109;05.02.2015;2015;02;05;Torstai;0;3;3;0;2;2
109;05.02.2015;2015;02;06;Torstai;13;11;24;6;3;9
109;05.02.2015;2015;02;07;Torstai;27;29;56;11;14;25
109;05.02.2015;2015;02;08;Torstai;17;15;32;8;6;14
109;05.02.2015;2015;02;09;Torstai;10;10;20;3;6;9
109;05.02.2015;2015;02;10;Torstai;6;5;11;4;0;4
109;05.02.2015;2015;02;11;Torstai;9;9;18;2;5;7
109;05.02.2015;2015;02;12;Torstai;6;5;11;4;1;5
109;05.02.2015;2015;02;13;Torstai;7;7;14;2;4;6
109;05.02.2015;2015;02;14;Torstai;11;9;20;5;3;8
109;05.02.2015;2015;02;15;Torstai;17;18;35;6;9;15
109;05.02.2015;2015;02;16;Torstai;29;26;55;13;10;23
109;05.02.2015;2015;02;17;Torstai;12;14;26;4;7;11
109;05.02.2015;2015;02;18;Torstai;9;7;16;4;2;6
109;05.02.2015;2015;02;19;Torstai;8;9;17;2;4;6
109;05.02.2015;2015;02;20;Torstai;7;5;12;4;1;5
109;05.02.2015;2015;02;21;Torstai;4;5;9;1;3;4
109;05.02.2015;2015;02;22;Torstai;1;0;1;1;0;1
109;05.02.2015;2015;02;23;Torstai;0;1;1;0;0;0
109;06.02.2015;2015;02;00;Perjantai;0;0;0;0;0;0
109;06.02.2015;2015;02;01;Perjantai;0;1;1;0;0;0
109;06.02.2015;2015;02;02;Perjantai;0;0;0;0;0;0
109;06.02.2015;2015;02;03;Perjantai;0;0;0;0;0;0
109;06.02.2015;2015;02;04;Perjantai;1;0;1;1;0;1
109;06.02.2015;2015;02;05;Perjantai;1;3;4;0;1;1
109;06.02.2015;2015;02;06;Perjantai;6;5;11;5;1;6
109;06.02.2015;2015;02;07;Perjantai;21;23;44;9;11;20
109;06.02.2015;2015;02;08;Perjantai;19;17;36;8;7;15
109;06.02.2015;2015;02;09;Perjantai;7;9;16;3;4;7
109;06.02.2015;2015;02;10;Perjantai;6;6;12;4;0;4
109;06.02.2015;2015;02;11;Perjantai;3;5;8;1;4;5
109;06.02.2015;2015;02;12;Perjantai;9;8;17;5;2;7
109;06.02.2015;2015;02;13;Perjantai;9;12;21;4;4;8
109;06.02.2015;2015;02;14;Perjantai;13;12;25;7;4;11
109;06.02.2015;2015;02;15;Perjantai;17;18;35;6;9;15
109;06.02.2015;2015;02;16;Perjantai;20;17;37;10;6;16
109;06.02.2015;2015;02;17;Perjantai;8;10;18;3;4;7
109;06.02.2015;2015;02;18;Perjantai;6;4;10;4;1;5
109;06.02.2015;2015;02;19;Perjantai;4;5;9;0;3;3
109;06.02.2015;2015;02;20;Perjantai;6;4;10;4;0;4
109;06.02.2015;2015;02;21;Perjantai;0;3;3;0;0;0
109;06.02.2015;2015;02;22;Perjantai;5;2;7;3;0;3
109;06.02.2015;2015;02;23;Perjantai;0;1;1;0;0;0
109;07.02.2015;2015;02;00;Lauantai;2;0;2;0;0;0
109;07.02.2015;2015;02;01;Lauantai;0;0;0;0;0;0
109;07.02.2015;2015;02;02;Lauantai;0;0;0;0;0;0
109;07.02.2015;2015;02;03;Lauantai;0;2;2;0;0;0
109;07.02.2015;2015;02;04;Lauantai;1;0;1;0;0;0
109;07.02.2015;2015;02;05;Lauantai;0;2;2;0;0;0
109;07.02.2015;2015;02;06;Lauantai;1;0;1;1;0;1
109;07.02.2015;2015;02;07;Lauantai;3;3;6;0;3;3
109;07.02.2015;2015;02;08;Lauantai;3;2;5;3;2;5
109;07.02.2015;2015;02;09;Lauantai;3;5;8;1;3;4
109;07.02.2015;2015;02;10;Lauantai;4;3;7;4;2;6
109;07.02.2015;2015;02;11;Lauantai;3;7;10;3;4;7
109;07.02.2015;2015;02;12;Lauantai;6;4;10;5;2;7
109;07.02.2015;2015;02;13;Lauantai;4;7;11;3;5;8
109;07.02.2015;2015;02;14;Lauantai;6;5;11;6;2;8
109;07.02.2015;2015;02;15;Lauantai;3;6;9;2;4;6
109;07.02.2015;2015;02;16;Lauantai;4;2;6;3;0;3
109;07.02.2015;2015;02;17;Lauantai;2;4;6;1;3;4
109;07.02.2015;2015;02;18;Lauantai;5;5;10;5;4;9
109;07.02.2015;2015;02;19;Lauantai;2;4;6;0;4;4
109;07.02.2015;2015;02;20;Lauantai;2;1;3;2;1;3
109;07.02.2015;2015;02;21;Lauantai;2;4;6;1;3;4
109;07.02.2015;2015;02;22;Lauantai;3;2;5;2;1;3
109;07.02.2015;2015;02;23;Lauantai;0;0;0;0;0;0
109;08.02.2015;2015;02;00;Sunnuntai;2;0;2;1;0;1
109;08.02.2015;2015;02;01;Sunnuntai;0;0;0;0;0;0
109;08.02.2015;2015;02;02;Sunnuntai;0;0;0;0;0;0
109;08.02.2015;2015;02;03;Sunnuntai;0;2;2;0;0;0
109;08.02.2015;2015;02;04;Sunnuntai;2;0;2;1;0;1
109;08.02.2015;2015;02;05;Sunnuntai;0;1;1;0;0;0
109;08.02.2015;2015;02;06;Sunnuntai;1;0;1;1;0;1
109;08.02.2015;2015;02;07;Sunnuntai;1;3;4;1;2;3
109;08.02.2015;2015;02;08;Sunnuntai;2;1;3;2;1;3
109;08.02.2015;2015;02;09;Sunnuntai;4;6;10;2;5;7
109;08.02.2015;2015;02;10;Sunnuntai;3;2;5;2;1;3
109;08.02.2015;2015;02;11;Sunnuntai;1;4;5;0;3;3
109;08.02.2015;2015;02;12;Sunnuntai;6;2;8;5;2;7
109;08.02.2015;2015;02;13;Sunnuntai;7;9;16;6;7;13
109;08.02.2015;2015;02;14;Sunnuntai;6;4;10;5;4;9
109;08.02.2015;2015;02;15;Sunnuntai;4;6;10;4;5;9
109;08.02.2015;2015;02;16;Sunnuntai;7;3;10;6;3;9
109;08.02.2015;2015;02;17;Sunnuntai;3;7;10;3;3;6
109;08.02.2015;2015;02;18;Sunnuntai;4;3;7;3;2;5
109;08.02.2015;2015;02;19;Sunnuntai;1;3;4;1;2;3
109;08.02.2015;2015;02;20;Sunnuntai;4;1;5;3;0;3
109;08.02.2015;2015;02;21;Sunnuntai;2;4;6;1;3;4
109;08.02.2015;2015;02;22;Sunnuntai;3;0;3;0;0;0
109;08.02.2015;2015;02;23;Sunnuntai;0;0;0;0;0;0
109;09.02.2015;2015;02;00;Maanantai;0;0;0;0;0;0
109;09.02.2015;2015;02;01;Maanantai;0;1;1;0;1;1
109;09.02.2015;2015;02;02;Maanantai;0;0;0;0;0;0
109;09.02.2015;2015;02;03;Maanantai;0;0;0;0;0;0
109;09.02.2015;2015;02;04;Maanantai;1;0;1;0;0;0
109;09.02.2015;2015;02;05;Maanantai;0;4;4;0;2;2
109;09.02.2015;2015;02;06;Maanantai;9;8;17;4;1;5
109;09.02.2015;2015;02;07;Maanantai;27;29;56;11;13;24
109;09.02.2015;2015;02;08;Maanantai;18;18;36;9;6;15
109;09.02.2015;2015;02;09;Maanantai;6;8;14;1;4;5
109;09.02.2015;2015;02;10;Maanantai;7;5;12;3;1;4
109;09.02.2015;2015;02;11;Maanantai;8;8;16;1;4;5
109;09.02.2015;2015;02;12;Maanantai;8;7;15;4;1;5
109;09.02.2015;2015;02;13;Maanantai;5;7;12;1;3;4
109;09.02.2015;2015;02;14;Maanantai;11;9;20;6;4;10
109;09.02.2015;2015;02;15;Maanantai;17;19;36;7;9;16
109;09.02.2015;2015;02;16;Maanantai;32;29;61;14;12;26
109;09.02.2015;2015;02;17;Maanantai;20;22;42;7;10;17
109;09.02.2015;2015;02;18;Maanantai;11;11;22;5;3;8
109;09.02.2015;2015;02;19;Maanantai;9;10;19;3;4;7
109;09.02.2015;2015;02;20;Maanantai;8;8;16;5;2;7
109;09.02.2015;2015;02;21;Maanantai;4;6;10;0;4;4
109;09.02.2015;2015;02;22;Maanantai;9;5;14;4;1;5
109;09.02.2015;2015;02;23;Maanantai;1;1;2;0;1;1
109;10.02.2015;2015;02;00;Tiistai;1;1;2;1;0;1
109;10.02.2015;2015;02;01;Tiistai;0;0;0;0;0;0
109;10.02.2015;2015;02;02;Tiistai;0;0;0;0;0;0
109;10.02.2015;2015;02;03;Tiistai;0;1;1;0;0;0
109;10.02.2015;2015;02;04;Tiistai;2;0;2;0;0;0
109;10.02.2015;2015;02;05;Tiistai;3;4;7;0;4;4
109;10.02.2015;2015;02;06;Tiistai;12;10;22;7;3;10
109;10.02.2015;2015;02;07;Tiistai;26;27;53;10;12;22
109;10.02.2015;2015;02;08;Tiistai;26;23;49;12;9;21
109;10.02.2015;2015;02;09;Tiistai;7;9;16;1;4;5
109;10.02.2015;2015;02;10;Tiistai;10;7;17;4;3;7
109;10.02.2015;2015;02;11;Tiistai;10;10;20;3;6;9
109;10.02.2015;2015;02;12;Tiistai;7;6;13;4;1;5
109;10.02.2015;2015;02;13;Tiistai;7;7;14;1;4;5
109;10.02.2015;2015;02;14;Tiistai;11;10;21;5;3;8
109;10.02.2015;2015;02;15;Tiistai;18;18;36;6;9;15
109;10.02.2015;2015;02;16;Tiistai;32;30;62;15;13;28
109;10.02.2015;2015;02;17;Tiistai;16;17;33;7;7;14
109;10.02.2015;2015;02;18;Tiistai;11;9;20;6;3;9
109;10.02.2015;2015;02;19;Tiistai;4;6;10;1;3;4
109;10.02.2015;2015;02;20;Tiistai;5;3;8;3;0;3
109;10.02.2015;2015;02;21;Tiistai;2;5;7;0;4;4
109;10.02.2015;2015;02;22;Tiistai;5;4;9;4;0;4
109;10.02.2015;2015;02;23;Tiistai;0;1;1;0;1;1
109;11.02.2015;2015;02;00;Keskiviikko;0;0;0;0;0;0
109;11.02.2015;2015;02;01;Keskiviikko;0;0;0;0;0;0
109;11.02.2015;2015;02;02;Keskiviikko;0;0;0;0;0;0
109;11.02.2015;2015;02;03;Keskiviikko;2;2;4;0;1;1
109;11.02.2015;2015;02;04;Keskiviikko;1;0;1;0;0;0
109;11.02.2015;2015;02;05;Keskiviikko;0;4;4;0;2;2
109;11.02.2015;2015;02;06;Keskiviikko;10;9;19;5;2;7
109;11.02.2015;2015;02;07;Keskiviikko;15;19;34;6;8;14
109;11.02.2015;2015;02;08;Keskiviikko;25;24;49;10;9;19
109;11.02.2015;2015;02;09;Keskiviikko;4;6;10;1;4;5
109;11.02.2015;2015;02;10;Keskiviikko;4;0;4;2;0;2
109;11.02.2015;2015;02;11;Keskiviikko;7;8;15;2;4;6
109;11.02.2015;2015;02;12;Keskiviikko;5;5;10;4;1;5
109;11.02.2015;2015;02;13;Keskiviikko;6;7;13;0;4;4
109;11.02.2015;2015;02;14;Keskiviikko;9;7;16;4;2;6
109;11.02.2015;2015;02;15;Keskiviikko;9;13;22;3;6;9
109;11.02.2015;2015;02;16;Keskiviikko;22;20;42;10;8;18
109;11.02.2015;2015;02;17;Keskiviikko;14;16;30;6;8;14
109;11.02.2015;2015;02;18;Keskiviikko;5;3;8;3;1;4
109;11.02.2015;2015;02;19;Keskiviikko;6;6;12;1;4;5
109;11.02.2015;2015;02;20;Keskiviikko;5;3;8;3;1;4
109;11.02.2015;2015;02;21;Keskiviikko;0;2;2;0;1;1
109;11.02.2015;2015;02;22;Keskiviikko;3;0;3;0;0;0
109;11.02.2015;2015;02;23;Keskiviikko;0;0;0;0;0;0
109;12.02.2015;2015;02;00;Torstai;3;0;3;0;0;0
109;12.02.2015;2015;02;01;Torstai;0;1;1;0;1;1
109;12.02.2015;2015;02;02;Torstai;4;2;6;2;0;2
109;12.02.2015;2015;02;03;Torstai;0;1;1;0;0;0
109;12.02.2015;2015;02;04;Torstai;0;0;0;0;0;0
109;12.02.2015;2015;02;05;Torstai;2;3;5;0;2;2
109;12.02.2015;2015;02;06;Torstai;8;5;13;4;2;6
109;12.02.2015;2015;02;07;Torstai;15;16;31;5;7;12
109;12.02.2015;2015;02;08;Torstai;15;14;29;7;5;12
109;12.02.2015;2015;02;09;Torstai;3;5;8;1;4;5
109;12.02.2015;2015;02;10;Torstai;5;2;7;2;0;2
109;12.02.2015;2015;02;11;Torstai;2;5;7;0;4;4
109;12.02.2015;2015;02;12;Torstai;9;6;15;4;1;5
109;12.02.2015;2015;02;13;Torstai;5;6;11;1;3;4
109;12.02.2015;2015;02;14;Torstai;6;3;9;3;0;3
109;12.02.2015;2015;02;15;Torstai;14;16;30;6;7;13
109;12.02.2015;2015;02;16;Torstai;20;16;36;8;8;16
109;12.02.2015;2015;02;17;Torstai;10;11;21;4;4;8
109;12.02.2015;2015;02;18;Torstai;9;8;17;4;3;7
109;12.02.2015;2015;02;19;Torstai;4;7;11;1;4;5
109;12.02.2015;2015;02;20;Torstai;4;2;6;2;0;2
109;12.02.2015;2015;02;21;Torstai;7;9;16;2;4;6
109;12.02.2015;2015;02;22;Torstai;5;2;7;2;1;3
109;12.02.2015;2015;02;23;Torstai;0;1;1;0;1;1
109;13.02.2015;2015;02;00;Perjantai;1;0;1;1;0;1
109;13.02.2015;2015;02;01;Perjantai;0;1;1;0;0;0
109;13.02.2015;2015;02;02;Perjantai;0;0;0;0;0;0
109;13.02.2015;2015;02;03;Perjantai;0;0;0;0;0;0
109;13.02.2015;2015;02;04;Perjantai;1;0;1;0;0;0
109;13.02.2015;2015;02;05;Perjantai;1;3;4;0;1;1
109;13.02.2015;2015;02;06;Perjantai;8;7;15;4;3;7
109;13.02.2015;2015;02;07;Perjantai;17;18;35;6;9;15
109;13.02.2015;2015;02;08;Perjantai;17;16;33;8;5;13
109;13.02.2015;2015;02;09;Perjantai;6;6;12;1;4;5
109;13.02.2015;2015;02;10;Perjantai;6;2;8;4;0;4
109;13.02.2015;2015;02;11;Perjantai;7;7;14;2;4;6
109;13.02.2015;2015;02;12;Perjantai;8;4;12;4;0;4
109;13.02.2015;2015;02;13;Perjantai;10;11;21;4;4;8
109;13.02.2015;2015;02;14;Perjantai;10;8;18;5;2;7
109;13.02.2015;2015;02;15;Perjantai;13;14;27;5;6;11
109;13.02.2015;2015;02;16;Perjantai;19;16;35;8;7;15
109;13.02.2015;2015;02;17;Perjantai;10;11;21;4;5;9
109;13.02.2015;2015;02;18;Perjantai;6;3;9;3;1;4
109;13.02.2015;2015;02;19;Perjantai;2;5;7;0;4;4
109;13.02.2015;2015;02;20;Perjantai;4;2;6;2;0;2
109;13.02.2015;2015;02;21;Perjantai;3;7;10;0;4;4
109;13.02.2015;2015;02;22;Perjantai;4;2;6;1;1;2
109;13.02.2015;2015;02;23;Perjantai;0;2;2;0;1;1
109;14.02.2015;2015;02;00;Lauantai;2;0;2;0;0;0
109;14.02.2015;2015;02;01;Lauantai;0;2;2;0;2;2
109;14.02.2015;2015;02;02;Lauantai;0;0;0;0;0;0
109;14.02.2015;2015;02;03;Lauantai;0;0;0;0;0;0
109;14.02.2015;2015;02;04;Lauantai;1;0;1;0;0;0
109;14.02.2015;2015;02;05;Lauantai;0;1;1;0;1;1
109;14.02.2015;2015;02;06;Lauantai;0;0;0;0;0;0
109;14.02.2015;2015;02;07;Lauantai;0;3;3;0;1;1
109;14.02.2015;2015;02;08;Lauantai;3;1;4;2;0;2
109;14.02.2015;2015;02;09;Lauantai;1;4;5;1;3;4
109;14.02.2015;2015;02;10;Lauantai;3;2;5;2;0;2
109;14.02.2015;2015;02;11;Lauantai;3;5;8;1;4;5
109;14.02.2015;2015;02;12;Lauantai;5;5;10;5;3;8
109;14.02.2015;2015;02;13;Lauantai;4;6;10;2;5;7
109;14.02.2015;2015;02;14;Lauantai;6;3;9;5;3;8
109;14.02.2015;2015;02;15;Lauantai;0;3;3;0;2;2
109;14.02.2015;2015;02;16;Lauantai;4;2;6;3;1;4
109;14.02.2015;2015;02;17;Lauantai;2;4;6;2;4;6
109;14.02.2015;2015;02;18;Lauantai;6;4;10;4;3;7
109;14.02.2015;2015;02;19;Lauantai;2;4;6;1;2;3
109;14.02.2015;2015;02;20;Lauantai;6;3;9;4;2;6
109;14.02.2015;2015;02;21;Lauantai;2;4;6;0;4;4
109;14.02.2015;2015;02;22;Lauantai;3;0;3;1;0;1
109;14.02.2015;2015;02;23;Lauantai;0;2;2;0;1;1
109;15.02.2015;2015;02;00;Sunnuntai;2;1;3;1;0;1
109;15.02.2015;2015;02;01;Sunnuntai;0;0;0;0;0;0
109;15.02.2015;2015;02;02;Sunnuntai;0;0;0;0;0;0
109;15.02.2015;2015;02;03;Sunnuntai;0;1;1;0;0;0
109;15.02.2015;2015;02;04;Sunnuntai;4;0;4;1;0;1
109;15.02.2015;2015;02;05;Sunnuntai;0;1;1;0;0;0
109;15.02.2015;2015;02;06;Sunnuntai;3;0;3;0;0;0
109;15.02.2015;2015;02;07;Sunnuntai;1;3;4;1;1;2
109;15.02.2015;2015;02;08;Sunnuntai;2;0;2;0;0;0
109;15.02.2015;2015;02;09;Sunnuntai;1;4;5;1;2;3
109;15.02.2015;2015;02;10;Sunnuntai;3;1;4;2;0;2
109;15.02.2015;2015;02;11;Sunnuntai;2;4;6;1;3;4
109;15.02.2015;2015;02;12;Sunnuntai;5;3;8;5;3;8
109;15.02.2015;2015;02;13;Sunnuntai;3;5;8;2;4;6
109;15.02.2015;2015;02;14;Sunnuntai;4;1;5;2;0;2
109;15.02.2015;2015;02;15;Sunnuntai;3;6;9;2;6;8
109;15.02.2015;2015;02;16;Sunnuntai;7;6;13;6;5;11
109;15.02.2015;2015;02;17;Sunnuntai;4;5;9;3;4;7
109;15.02.2015;2015;02;18;Sunnuntai;4;3;7;4;2;6
109;15.02.2015;2015;02;19;Sunnuntai;3;7;10;3;3;6
109;15.02.2015;2015;02;20;Sunnuntai;5;3;8;5;1;6
109;15.02.2015;2015;02;21;Sunnuntai;2;4;6;1;2;3
109;15.02.2015;2015;02;22;Sunnuntai;3;0;3;1;0;1
109;15.02.2015;2015;02;23;Sunnuntai;0;1;1;0;0;0
109;16.02.2015;2015;02;00;Maanantai;1;0;1;0;0;0
109;16.02.2015;2015;02;01;Maanantai;0;0;0;0;0;0
109;16.02.2015;2015;02;02;Maanantai;0;0;0;0;0;0
109;16.02.2015;2015;02;03;Maanantai;0;0;0;0;0;0
109;16.02.2015;2015;02;04;Maanantai;0;0;0;0;0;0
109;16.02.2015;2015;02;05;Maanantai;1;3;4;0;2;2
109;16.02.2015;2015;02;06;Maanantai;8;6;14;4;1;5
109;16.02.2015;2015;02;07;Maanantai;23;26;49;9;11;20
109;16.02.2015;2015;02;08;Maanantai;24;22;46;10;9;19
109;16.02.2015;2015;02;09;Maanantai;5;7;12;1;4;5
109;16.02.2015;2015;02;10;Maanantai;5;4;9;3;1;4
109;16.02.2015;2015;02;11;Maanantai;6;8;14;1;4;5
109;16.02.2015;2015;02;12;Maanantai;8;7;15;5;2;7
109;16.02.2015;2015;02;13;Maanantai;10;11;21;4;4;8
109;16.02.2015;2015;02;14;Maanantai;10;8;18;4;2;6
109;16.02.2015;2015;02;15;Maanantai;12;14;26;4;6;10
109;16.02.2015;2015;02;16;Maanantai;33;31;64;14;12;26
109;16.02.2015;2015;02;17;Maanantai;12;15;27;5;6;11
109;16.02.2015;2015;02;18;Maanantai;10;9;19;5;3;8
109;16.02.2015;2015;02;19;Maanantai;5;9;14;1;4;5
109;16.02.2015;2015;02;20;Maanantai;6;4;10;3;1;4
109;16.02.2015;2015;02;21;Maanantai;1;4;5;0;3;3
109;16.02.2015;2015;02;22;Maanantai;4;2;6;2;0;2
109;16.02.2015;2015;02;23;Maanantai;0;3;3;0;1;1
109;17.02.2015;2015;02;00;Tiistai;2;0;2;1;0;1
109;17.02.2015;2015;02;01;Tiistai;0;0;0;0;0;0
109;17.02.2015;2015;02;02;Tiistai;0;0;0;0;0;0
109;17.02.2015;2015;02;03;Tiistai;0;0;0;0;0;0
109;17.02.2015;2015;02;04;Tiistai;0;0;0;0;0;0
109;17.02.2015;2015;02;05;Tiistai;2;4;6;0;2;2
109;17.02.2015;2015;02;06;Tiistai;13;12;25;6;3;9
109;17.02.2015;2015;02;07;Tiistai;25;26;51;9;12;21
109;17.02.2015;2015;02;08;Tiistai;24;21;45;11;8;19
109;17.02.2015;2015;02;09;Tiistai;8;9;17;1;5;6
109;17.02.2015;2015;02;10;Tiistai;8;6;14;3;2;5
109;17.02.2015;2015;02;11;Tiistai;5;8;13;1;4;5
109;17.02.2015;2015;02;12;Tiistai;9;8;17;5;2;7
109;17.02.2015;2015;02;13;Tiistai;10;12;22;3;5;8
109;17.02.2015;2015;02;14;Tiistai;8;6;14;4;3;7
109;17.02.2015;2015;02;15;Tiistai;17;18;35;7;8;15
109;17.02.2015;2015;02;16;Tiistai;35;32;67;15;12;27
109;17.02.2015;2015;02;17;Tiistai;18;20;38;7;9;16
109;17.02.2015;2015;02;18;Tiistai;8;7;15;5;2;7
109;17.02.2015;2015;02;19;Tiistai;8;8;16;0;4;4
109;17.02.2015;2015;02;20;Tiistai;3;1;4;2;0;2
109;17.02.2015;2015;02;21;Tiistai;3;4;7;1;3;4
109;17.02.2015;2015;02;22;Tiistai;3;1;4;1;0;1
109;17.02.2015;2015;02;23;Tiistai;0;1;1;0;0;0
109;18.02.2015;2015;02;00;Keskiviikko;2;0;2;0;0;0
109;18.02.2015;2015;02;01;Keskiviikko;1;1;2;0;1;1
109;18.02.2015;2015;02;02;Keskiviikko;1;0;1;0;0;0
109;18.02.2015;2015;02;03;Keskiviikko;0;1;1;0;0;0
109;18.02.2015;2015;02;04;Keskiviikko;0;0;0;0;0;0
109;18.02.2015;2015;02;05;Keskiviikko;2;4;6;0;2;2
109;18.02.2015;2015;02;06;Keskiviikko;13;11;24;6;4;10
109;18.02.2015;2015;02;07;Keskiviikko;27;28;55;11;13;24
109;18.02.2015;2015;02;08;Keskiviikko;21;20;41;10;8;18
109;18.02.2015;2015;02;09;Keskiviikko;9;11;20;3;5;8
109;18.02.2015;2015;02;10;Keskiviikko;7;6;13;4;1;5
109;18.02.2015;2015;02;11;Keskiviikko;9;11;20;4;4;8
109;18.02.2015;2015;02;12;Keskiviikko;10;7;17;4;2;6
109;18.02.2015;2015;02;13;Keskiviikko;10;13;23;4;6;10
109;18.02.2015;2015;02;14;Keskiviikko;12;10;22;4;4;8
109;18.02.2015;2015;02;15;Keskiviikko;17;18;35;7;8;15
109;18.02.2015;2015;02;16;Keskiviikko;32;28;60;14;11;25
109;18.02.2015;2015;02;17;Keskiviikko;17;18;35;6;9;15
109;18.02.2015;2015;02;18;Keskiviikko;9;8;17;5;2;7
109;18.02.2015;2015;02;19;Keskiviikko;9;11;20;3;5;8
109;18.02.2015;2015;02;20;Keskiviikko;6;5;11;4;1;5
109;18.02.2015;2015;02;21;Keskiviikko;5;7;12;0;3;3
109;18.02.2015;2015;02;22;Keskiviikko;6;2;8;2;0;2
109;18.02.2015;2015;02;23;Keskiviikko;0;1;1;0;1;1
109;19.02.2015;2015;02;00;Torstai;1;0;1;1;0;1
109;19.02.2015;2015;02;01;Torstai;0;0;0;0;0;0
109;19.02.2015;2015;02;02;Torstai;0;0;0;0;0;0
109;19.02.2015;2015;02;03;Torstai;0;2;2;0;0;0
109;19.02.2015;2015;02;04;Torstai;3;0;3;1;0;1
109;19.02.2015;2015;02;05;Torstai;1;2;3;0;1;1
109;19.02.2015;2015;02;06;Torstai;12;9;21;6;3;9
109;19.02.2015;2015;02;07;Torstai;24;27;51;10;10;20
109;19.02.2015;2015;02;08;Torstai;24;21;45;11;9;20
109;19.02.2015;2015;02;09;Torstai;8;8;16;3;5;8
109;19.02.2015;2015;02;10;Torstai;7;5;12;4;1;5
109;19.02.2015;2015;02;11;Torstai;7;11;18;3;4;7
109;19.02.2015;2015;02;12;Torstai;7;6;13;4;1;5
109;19.02.2015;2015;02;13;Torstai;5;8;13;1;5;6
109;19.02.2015;2015;02;14;Torstai;8;7;15;4;2;6
109;19.02.2015;2015;02;15;Torstai;18;19;37;7;9;16
109;19.02.2015;2015;02;16;Torstai;28;25;53;13;9;22
109;19.02.2015;2015;02;17;Torstai;11;11;22;4;5;9
109;19.02.2015;2015;02;18;Torstai;7;6;13;4;0;4
109;19.02.2015;2015;02;19;Torstai;4;6;10;1;4;5
109;19.02.2015;2015;02;20;Torstai;3;2;5;1;0;1
109;19.02.2015;2015;02;21;Torstai;3;5;8;1;3;4
109;19.02.2015;2015;02;22;Torstai;4;2;6;2;0;2
109;19.02.2015;2015;02;23;Torstai;0;0;0;0;0;0
109;20.02.2015;2015;02;00;Perjantai;1;0;1;0;0;0
109;20.02.2015;2015;02;01;Perjantai;1;2;3;0;1;1
109;20.02.2015;2015;02;02;Perjantai;2;0;2;0;0;0
109;20.02.2015;2015;02;03;Perjantai;0;0;0;0;0;0
109;20.02.2015;2015;02;04;Perjantai;2;0;2;1;0;1
109;20.02.2015;2015;02;05;Perjantai;0;3;3;0;0;0
109;20.02.2015;2015;02;06;Perjantai;6;6;12;4;0;4
109;20.02.2015;2015;02;07;Perjantai;18;21;39;7;8;15
109;20.02.2015;2015;02;08;Perjantai;18;16;34;8;6;14
109;20.02.2015;2015;02;09;Perjantai;4;5;9;1;3;4
109;20.02.2015;2015;02;10;Perjantai;3;1;4;2;0;2
109;20.02.2015;2015;02;11;Perjantai;3;6;9;1;2;3
109;20.02.2015;2015;02;12;Perjantai;6;3;9;4;0;4
109;20.02.2015;2015;02;13;Perjantai;9;9;18;2;5;7
109;20.02.2015;2015;02;14;Perjantai;11;10;21;6;4;10
109;20.02.2015;2015;02;15;Perjantai;15;16;31;5;7;12
109;20.02.2015;2015;02;16;Perjantai;19;17;36;8;6;14
109;20.02.2015;2015;02;17;Perjantai;11;11;22;3;7;10
109;20.02.2015;2015;02;18;Perjantai;5;3;8;4;0;4
109;20.02.2015;2015;02;19;Perjantai;3;5;8;0;3;3
109;20.02.2015;2015;02;20;Perjantai;5;4;9;3;1;4
109;20.02.2015;2015;02;21;Perjantai;1;5;6;0;3;3
109;20.02.2015;2015;02;22;Perjantai;4;1;5;1;0;1
109;20.02.2015;2015;02;23;Perjantai;0;4;4;0;3;3
109;21.02.2015;2015;02;00;Lauantai;2;0;2;0;0;0
109;21.02.2015;2015;02;01;Lauantai;0;0;0;0;0;0
109;21.02.2015;2015;02;02;Lauantai;2;0;2;2;0;2
109;21.02.2015;2015;02;03;Lauantai;0;2;2;0;0;0
109;21.02.2015;2015;02;04;Lauantai;1;0;1;0;0;0
109;21.02.2015;2015;02;05;Lauantai;0;2;2;0;0;0
109;21.02.2015;2015;02;06;Lauantai;3;1;4;2;0;2
109;21.02.2015;2015;02;07;Lauantai;0;3;3;0;1;1
109;21.02.2015;2015;02;08;Lauantai;6;4;10;4;3;7
109;21.02.2015;2015;02;09;Lauantai;3;5;8;1;4;5
109;21.02.2015;2015;02;10;Lauantai;4;3;7;3;2;5
109;21.02.2015;2015;02;11;Lauantai;4;5;9;3;5;8
109;21.02.2015;2015;02;12;Lauantai;7;6;13;7;6;13
109;21.02.2015;2015;02;13;Lauantai;4;5;9;3;5;8
109;21.02.2015;2015;02;14;Lauantai;6;3;9;6;2;8
109;21.02.2015;2015;02;15;Lauantai;4;7;11;4;5;9
109;21.02.2015;2015;02;16;Lauantai;6;4;10;5;3;8
109;21.02.2015;2015;02;17;Lauantai;5;7;12;4;5;9
109;21.02.2015;2015;02;18;Lauantai;5;2;7;4;2;6
109;21.02.2015;2015;02;19;Lauantai;2;4;6;1;3;4
109;21.02.2015;2015;02;20;Lauantai;5;2;7;3;2;5
109;21.02.2015;2015;02;21;Lauantai;3;6;9;2;4;6
109;21.02.2015;2015;02;22;Lauantai;3;0;3;2;0;2
109;21.02.2015;2015;02;23;Lauantai;1;2;3;0;1;1
109;22.02.2015;2015;02;00;Sunnuntai;0;0;0;0;0;0
109;22.02.2015;2015;02;01;Sunnuntai;0;1;1;0;0;0
109;22.02.2015;2015;02;02;Sunnuntai;1;0;1;0;0;0
109;22.02.2015;2015;02;03;Sunnuntai;0;0;0;0;0;0
109;22.02.2015;2015;02;04;Sunnuntai;1;0;1;0;0;0
109;22.02.2015;2015;02;05;Sunnuntai;0;0;0;0;0;0
109;22.02.2015;2015;02;06;Sunnuntai;2;1;3;1;0;1
109;22.02.2015;2015;02;07;Sunnuntai;1;4;5;0;1;1
109;22.02.2015;2015;02;08;Sunnuntai;3;1;4;1;1;2
109;22.02.2015;2015;02;09;Sunnuntai;1;4;5;1;4;5
109;22.02.2015;2015;02;10;Sunnuntai;6;4;10;4;2;6
109;22.02.2015;2015;02;11;Sunnuntai;4;6;10;4;5;9
109;22.02.2015;2015;02;12;Sunnuntai;6;5;11;6;3;9
109;22.02.2015;2015;02;13;Sunnuntai;5;8;13;4;5;9
109;22.02.2015;2015;02;14;Sunnuntai;8;4;12;4;4;8
109;22.02.2015;2015;02;15;Sunnuntai;4;6;10;3;6;9
109;22.02.2015;2015;02;16;Sunnuntai;7;4;11;5;3;8
109;22.02.2015;2015;02;17;Sunnuntai;3;7;10;3;4;7
109;22.02.2015;2015;02;18;Sunnuntai;6;5;11;5;3;8
109;22.02.2015;2015;02;19;Sunnuntai;2;5;7;1;3;4
109;22.02.2015;2015;02;20;Sunnuntai;4;2;6;3;2;5
109;22.02.2015;2015;02;21;Sunnuntai;2;5;7;2;2;4
109;22.02.2015;2015;02;22;Sunnuntai;2;1;3;1;0;1
109;22.02.2015;2015;02;23;Sunnuntai;0;2;2;0;1;1
109;23.02.2015;2015;02;00;Maanantai;0;0;0;1;0;1
109;23.02.2015;2015;02;01;Maanantai;0;0;0;0;0;0
109;23.02.2015;2015;02;02;Maanantai;0;1;1;0;0;0
109;23.02.2015;2015;02;03;Maanantai;0;0;0;0;0;0
109;23.02.2015;2015;02;04;Maanantai;0;0;0;0;0;0
109;23.02.2015;2015;02;05;Maanantai;4;1;5;0;0;0
109;23.02.2015;2015;02;06;Maanantai;6;15;21;1;3;4
109;23.02.2015;2015;02;07;Maanantai;15;40;55;5;10;15
109;23.02.2015;2015;02;08;Maanantai;12;44;56;4;4;8
109;23.02.2015;2015;02;09;Maanantai;4;8;12;1;2;3
109;23.02.2015;2015;02;10;Maanantai;4;8;12;2;2;4
109;23.02.2015;2015;02;11;Maanantai;6;10;16;5;4;9
109;23.02.2015;2015;02;12;Maanantai;4;12;16;5;4;9
109;23.02.2015;2015;02;13;Maanantai;4;8;12;5;6;11
109;23.02.2015;2015;02;14;Maanantai;13;14;27;2;6;8
109;23.02.2015;2015;02;15;Maanantai;15;18;33;4;7;11
109;23.02.2015;2015;02;16;Maanantai;25;38;63;8;7;15
109;23.02.2015;2015;02;17;Maanantai;17;26;43;6;7;13
109;23.02.2015;2015;02;18;Maanantai;6;6;12;2;6;8
109;23.02.2015;2015;02;19;Maanantai;4;6;10;3;8;11
109;23.02.2015;2015;02;20;Maanantai;3;5;8;4;8;12
109;23.02.2015;2015;02;21;Maanantai;4;2;6;1;3;4
109;23.02.2015;2015;02;22;Maanantai;1;8;9;0;0;0
109;23.02.2015;2015;02;23;Maanantai;0;1;1;1;0;1
109;24.02.2015;2015;02;00;Tiistai;1;0;1;2;0;2
109;24.02.2015;2015;02;01;Tiistai;0;0;0;0;0;0
109;24.02.2015;2015;02;02;Tiistai;0;0;0;0;0;0
109;24.02.2015;2015;02;03;Tiistai;0;0;0;1;0;1
109;24.02.2015;2015;02;04;Tiistai;0;0;0;0;0;0
109;24.02.2015;2015;02;05;Tiistai;3;4;7;0;2;2
109;24.02.2015;2015;02;06;Tiistai;0;15;15;1;5;6
109;24.02.2015;2015;02;07;Tiistai;4;51;55;3;13;16
109;24.02.2015;2015;02;08;Tiistai;13;42;55;3;5;8
109;24.02.2015;2015;02;09;Tiistai;7;1;8;5;0;5
109;24.02.2015;2015;02;10;Tiistai;12;0;12;8;0;8
109;24.02.2015;2015;02;11;Tiistai;10;1;11;6;1;7
109;24.02.2015;2015;02;12;Tiistai;1;7;8;0;3;3
109;24.02.2015;2015;02;13;Tiistai;4;11;15;2;5;7
109;24.02.2015;2015;02;14;Tiistai;10;9;19;1;8;9
109;24.02.2015;2015;02;15;Tiistai;15;17;32;1;4;5
109;24.02.2015;2015;02;16;Tiistai;24;38;62;9;13;22
109;24.02.2015;2015;02;17;Tiistai;13;20;33;7;7;14
109;24.02.2015;2015;02;18;Tiistai;9;7;16;4;6;10
109;24.02.2015;2015;02;19;Tiistai;3;5;8;7;6;13
109;24.02.2015;2015;02;20;Tiistai;3;3;6;3;1;4
109;24.02.2015;2015;02;21;Tiistai;4;10;14;0;2;2
109;24.02.2015;2015;02;22;Tiistai;2;5;7;1;2;3
109;24.02.2015;2015;02;23;Tiistai;1;2;3;0;1;1
109;25.02.2015;2015;02;00;Keskiviikko;0;0;0;1;2;3
109;25.02.2015;2015;02;01;Keskiviikko;0;1;1;0;0;0
109;25.02.2015;2015;02;02;Keskiviikko;1;0;1;0;0;0
109;25.02.2015;2015;02;03;Keskiviikko;0;1;1;0;0;0
109;25.02.2015;2015;02;04;Keskiviikko;0;1;1;0;0;0
109;25.02.2015;2015;02;05;Keskiviikko;2;8;10;1;3;4
109;25.02.2015;2015;02;06;Keskiviikko;5;12;17;5;2;7
109;25.02.2015;2015;02;07;Keskiviikko;17;47;64;4;4;8
109;25.02.2015;2015;02;08;Keskiviikko;9;57;66;4;6;10
109;25.02.2015;2015;02;09;Keskiviikko;3;11;14;4;3;7
109;25.02.2015;2015;02;10;Keskiviikko;1;6;7;1;8;9
109;25.02.2015;2015;02;11;Keskiviikko;3;7;10;5;5;10
109;25.02.2015;2015;02;12;Keskiviikko;4;15;19;3;8;11
109;25.02.2015;2015;02;13;Keskiviikko;5;6;11;6;4;10
109;25.02.2015;2015;02;14;Keskiviikko;8;13;21;7;7;14
109;25.02.2015;2015;02;15;Keskiviikko;11;21;32;0;9;9
109;25.02.2015;2015;02;16;Keskiviikko;31;31;62;10;5;15
109;25.02.2015;2015;02;17;Keskiviikko;20;27;47;3;5;8
109;25.02.2015;2015;02;18;Keskiviikko;11;14;25;2;6;8
109;25.02.2015;2015;02;19;Keskiviikko;4;2;6;7;5;12
109;25.02.2015;2015;02;20;Keskiviikko;7;5;12;2;3;5
109;25.02.2015;2015;02;21;Keskiviikko;6;2;8;6;1;7
109;25.02.2015;2015;02;22;Keskiviikko;0;5;5;0;2;2
109;25.02.2015;2015;02;23;Keskiviikko;1;1;2;1;0;1
109;26.02.2015;2015;02;00;Torstai;0;1;1;2;1;3
109;26.02.2015;2015;02;01;Torstai;0;0;0;0;0;0
109;26.02.2015;2015;02;02;Torstai;0;0;0;0;0;0
109;26.02.2015;2015;02;03;Torstai;2;1;3;1;1;2
109;26.02.2015;2015;02;04;Torstai;0;4;4;0;1;1
109;26.02.2015;2015;02;05;Torstai;5;2;7;1;2;3
109;26.02.2015;2015;02;06;Torstai;2;10;12;3;3;6
109;26.02.2015;2015;02;07;Torstai;22;41;63;3;7;10
109;26.02.2015;2015;02;08;Torstai;5;30;35;5;6;11
109;26.02.2015;2015;02;09;Torstai;5;13;18;5;4;9
109;26.02.2015;2015;02;10;Torstai;3;12;15;2;3;5
109;26.02.2015;2015;02;11;Torstai;5;8;13;2;2;4
109;26.02.2015;2015;02;12;Torstai;8;14;22;7;6;13
109;26.02.2015;2015;02;13;Torstai;7;13;20;3;0;3
109;26.02.2015;2015;02;14;Torstai;5;8;13;2;4;6
109;26.02.2015;2015;02;15;Torstai;19;19;38;2;10;12
109;26.02.2015;2015;02;16;Torstai;26;29;55;5;7;12
109;26.02.2015;2015;02;17;Torstai;17;24;41;4;3;7
109;26.02.2015;2015;02;18;Torstai;10;3;13;3;4;7
109;26.02.2015;2015;02;19;Torstai;4;2;6;4;6;10
109;26.02.2015;2015;02;20;Torstai;4;2;6;1;7;8
109;26.02.2015;2015;02;21;Torstai;4;3;7;2;5;7
109;26.02.2015;2015;02;22;Torstai;0;3;3;4;4;8
109;26.02.2015;2015;02;23;Torstai;0;0;0;0;0;0
109;27.02.2015;2015;02;00;Perjantai;0;0;0;0;0;0
109;27.02.2015;2015;02;01;Perjantai;0;0;0;1;1;2
109;27.02.2015;2015;02;02;Perjantai;0;0;0;0;0;0
109;27.02.2015;2015;02;03;Perjantai;0;0;0;0;0;0
109;27.02.2015;2015;02;04;Perjantai;0;2;2;0;0;0
109;27.02.2015;2015;02;05;Perjantai;2;2;4;2;0;2
109;27.02.2015;2015;02;06;Perjantai;5;17;22;7;3;10
109;27.02.2015;2015;02;07;Perjantai;13;29;42;9;6;15
109;27.02.2015;2015;02;08;Perjantai;14;33;47;4;1;5
109;27.02.2015;2015;02;09;Perjantai;3;9;12;3;4;7
109;27.02.2015;2015;02;10;Perjantai;7;11;18;2;2;4
109;27.02.2015;2015;02;11;Perjantai;10;10;20;2;7;9
109;27.02.2015;2015;02;12;Perjantai;4;8;12;4;5;9
109;27.02.2015;2015;02;13;Perjantai;6;11;17;4;3;7
109;27.02.2015;2015;02;14;Perjantai;11;18;29;2;11;13
109;27.02.2015;2015;02;15;Perjantai;18;14;32;7;8;15
109;27.02.2015;2015;02;16;Perjantai;17;25;42;5;4;9
109;27.02.2015;2015;02;17;Perjantai;13;13;26;1;4;5
109;27.02.2015;2015;02;18;Perjantai;5;5;10;4;7;11
109;27.02.2015;2015;02;19;Perjantai;1;2;3;3;2;5
109;27.02.2015;2015;02;20;Perjantai;3;5;8;2;1;3
109;27.02.2015;2015;02;21;Perjantai;4;4;8;0;1;1
109;27.02.2015;2015;02;22;Perjantai;0;1;1;4;3;7
109;27.02.2015;2015;02;23;Perjantai;2;1;3;2;0;2
109;28.02.2015;2015;02;00;Lauantai;0;3;3;1;3;4
109;28.02.2015;2015;02;01;Lauantai;0;0;0;0;0;0
109;28.02.2015;2015;02;02;Lauantai;2;0;2;1;0;1
109;28.02.2015;2015;02;03;Lauantai;0;0;0;0;0;0
109;28.02.2015;2015;02;04;Lauantai;3;1;4;0;0;0
109;28.02.2015;2015;02;05;Lauantai;0;0;0;0;0;0
109;28.02.2015;2015;02;06;Lauantai;1;5;6;0;2;2
109;28.02.2015;2015;02;07;Lauantai;0;2;2;2;2;4
109;28.02.2015;2015;02;08;Lauantai;2;2;4;4;1;5
109;28.02.2015;2015;02;09;Lauantai;2;3;5;5;8;13
109;28.02.2015;2015;02;10;Lauantai;0;6;6;4;5;9
109;28.02.2015;2015;02;11;Lauantai;5;7;12;4;6;10
109;28.02.2015;2015;02;12;Lauantai;0;8;8;6;5;11
109;28.02.2015;2015;02;13;Lauantai;1;10;11;7;3;10
109;28.02.2015;2015;02;14;Lauantai;2;2;4;1;5;6
109;28.02.2015;2015;02;15;Lauantai;4;2;6;0;2;2
109;28.02.2015;2015;02;16;Lauantai;4;4;8;5;2;7
109;28.02.2015;2015;02;17;Lauantai;2;3;5;6;7;13
109;28.02.2015;2015;02;18;Lauantai;3;4;7;5;5;10
109;28.02.2015;2015;02;19;Lauantai;1;1;2;1;6;7
109;28.02.2015;2015;02;20;Lauantai;1;4;5;3;3;6
109;28.02.2015;2015;02;21;Lauantai;3;3;6;2;1;3
109;28.02.2015;2015;02;22;Lauantai;1;0;1;1;4;5
109;28.02.2015;2015;02;23;Lauantai;0;0;0;0;0;0
109;01.03.2015;2015;03;00;Sunnuntai;0;1;1;1;0;1
109;01.03.2015;2015;03;01;Sunnuntai;0;0;0;1;1;2
109;01.03.2015;2015;03;02;Sunnuntai;0;0;0;0;0;0
109;01.03.2015;2015;03;03;Sunnuntai;1;1;2;0;0;0
109;01.03.2015;2015;03;04;Sunnuntai;0;2;2;0;0;0
109;01.03.2015;2015;03;05;Sunnuntai;0;0;0;1;0;1
109;01.03.2015;2015;03;06;Sunnuntai;0;3;3;0;1;1
109;01.03.2015;2015;03;07;Sunnuntai;1;1;2;1;1;2
109;01.03.2015;2015;03;08;Sunnuntai;1;0;1;3;6;9
109;01.03.2015;2015;03;09;Sunnuntai;3;4;7;5;5;10
109;01.03.2015;2015;03;10;Sunnuntai;3;2;5;8;6;14
109;01.03.2015;2015;03;11;Sunnuntai;3;7;10;2;14;16
109;01.03.2015;2015;03;12;Sunnuntai;3;7;10;6;4;10
109;01.03.2015;2015;03;13;Sunnuntai;5;4;9;3;11;14
109;01.03.2015;2015;03;14;Sunnuntai;0;3;3;5;4;9
109;01.03.2015;2015;03;15;Sunnuntai;7;4;11;4;7;11
109;01.03.2015;2015;03;16;Sunnuntai;3;5;8;3;3;6
109;01.03.2015;2015;03;17;Sunnuntai;5;2;7;5;9;14
109;01.03.2015;2015;03;18;Sunnuntai;4;8;12;3;9;12
109;01.03.2015;2015;03;19;Sunnuntai;0;4;4;1;6;7
109;01.03.2015;2015;03;20;Sunnuntai;3;7;10;2;4;6
109;01.03.2015;2015;03;21;Sunnuntai;5;4;9;3;5;8
109;01.03.2015;2015;03;22;Sunnuntai;0;0;0;2;1;3
109;01.03.2015;2015;03;23;Sunnuntai;0;0;0;0;0;0
109;02.03.2015;2015;03;00;Maanantai;0;2;2;0;1;1
109;02.03.2015;2015;03;01;Maanantai;0;0;0;0;0;0
109;02.03.2015;2015;03;02;Maanantai;0;0;0;0;0;0
109;02.03.2015;2015;03;03;Maanantai;0;0;0;0;0;0
109;02.03.2015;2015;03;04;Maanantai;0;0;0;0;0;0
109;02.03.2015;2015;03;05;Maanantai;1;1;2;2;0;2
109;02.03.2015;2015;03;06;Maanantai;4;17;21;5;6;11
109;02.03.2015;2015;03;07;Maanantai;17;24;41;6;5;11
109;02.03.2015;2015;03;08;Maanantai;5;27;32;4;3;7
109;02.03.2015;2015;03;09;Maanantai;6;7;13;5;3;8
109;02.03.2015;2015;03;10;Maanantai;3;4;7;0;4;4
109;02.03.2015;2015;03;11;Maanantai;5;12;17;2;2;4
109;02.03.2015;2015;03;12;Maanantai;3;7;10;6;4;10
109;02.03.2015;2015;03;13;Maanantai;4;8;12;4;4;8
109;02.03.2015;2015;03;14;Maanantai;11;11;22;2;3;5
109;02.03.2015;2015;03;15;Maanantai;11;14;25;4;4;8
109;02.03.2015;2015;03;16;Maanantai;21;33;54;6;3;9
109;02.03.2015;2015;03;17;Maanantai;12;8;20;2;6;8
109;02.03.2015;2015;03;18;Maanantai;8;11;19;5;8;13
109;02.03.2015;2015;03;19;Maanantai;6;4;10;4;8;12
109;02.03.2015;2015;03;20;Maanantai;3;7;10;2;4;6
109;02.03.2015;2015;03;21;Maanantai;1;1;2;0;3;3
109;02.03.2015;2015;03;22;Maanantai;1;11;12;2;1;3
109;02.03.2015;2015;03;23;Maanantai;0;1;1;0;0;0
109;03.03.2015;2015;03;00;Tiistai;1;0;1;0;1;1
109;03.03.2015;2015;03;01;Tiistai;0;1;1;3;0;3
109;03.03.2015;2015;03;02;Tiistai;1;0;1;0;0;0
109;03.03.2015;2015;03;03;Tiistai;0;0;0;0;1;1
109;03.03.2015;2015;03;04;Tiistai;0;0;0;0;0;0
109;03.03.2015;2015;03;05;Tiistai;2;5;7;1;1;2
109;03.03.2015;2015;03;06;Tiistai;4;16;20;3;3;6
109;03.03.2015;2015;03;07;Tiistai;14;28;42;4;6;10
109;03.03.2015;2015;03;08;Tiistai;11;30;41;1;3;4
109;03.03.2015;2015;03;09;Tiistai;3;8;11;5;2;7
109;03.03.2015;2015;03;10;Tiistai;2;10;12;2;6;8
109;03.03.2015;2015;03;11;Tiistai;5;6;11;1;6;7
109;03.03.2015;2015;03;12;Tiistai;7;8;15;3;4;7
109;03.03.2015;2015;03;13;Tiistai;2;7;9;3;2;5
109;03.03.2015;2015;03;14;Tiistai;9;6;15;2;2;4
109;03.03.2015;2015;03;15;Tiistai;14;14;28;6;8;14
109;03.03.2015;2015;03;16;Tiistai;19;26;45;4;7;11
109;03.03.2015;2015;03;17;Tiistai;12;18;30;8;9;17
109;03.03.2015;2015;03;18;Tiistai;4;10;14;2;10;12
109;03.03.2015;2015;03;19;Tiistai;2;4;6;2;2;4
109;03.03.2015;2015;03;20;Tiistai;6;3;9;2;8;10
109;03.03.2015;2015;03;21;Tiistai;2;1;3;2;4;6
109;03.03.2015;2015;03;22;Tiistai;1;9;10;1;0;1
109;03.03.2015;2015;03;23;Tiistai;0;1;1;1;0;1
109;04.03.2015;2015;03;00;Keskiviikko;0;0;0;1;1;2
109;04.03.2015;2015;03;01;Keskiviikko;0;0;0;1;0;1
109;04.03.2015;2015;03;02;Keskiviikko;0;0;0;0;0;0
109;04.03.2015;2015;03;03;Keskiviikko;0;0;0;0;0;0
109;04.03.2015;2015;03;04;Keskiviikko;0;1;1;0;0;0
109;04.03.2015;2015;03;05;Keskiviikko;0;1;1;0;1;1
109;04.03.2015;2015;03;06;Keskiviikko;7;11;18;3;1;4
109;04.03.2015;2015;03;07;Keskiviikko;8;32;40;1;6;7
109;04.03.2015;2015;03;08;Keskiviikko;10;14;24;1;2;3
109;04.03.2015;2015;03;09;Keskiviikko;4;11;15;3;3;6
109;04.03.2015;2015;03;10;Keskiviikko;3;5;8;2;6;8
109;04.03.2015;2015;03;11;Keskiviikko;2;6;8;4;8;12
109;04.03.2015;2015;03;12;Keskiviikko;2;12;14;3;4;7
109;04.03.2015;2015;03;13;Keskiviikko;0;6;6;1;5;6
109;04.03.2015;2015;03;14;Keskiviikko;7;11;18;3;3;6
109;04.03.2015;2015;03;15;Keskiviikko;8;21;29;1;5;6
109;04.03.2015;2015;03;16;Keskiviikko;12;29;41;3;4;7
109;04.03.2015;2015;03;17;Keskiviikko;11;14;25;3;6;9
109;04.03.2015;2015;03;18;Keskiviikko;1;11;12;3;3;6
109;04.03.2015;2015;03;19;Keskiviikko;2;3;5;2;5;7
109;04.03.2015;2015;03;20;Keskiviikko;4;6;10;3;4;7
109;04.03.2015;2015;03;21;Keskiviikko;4;5;9;2;4;6
109;04.03.2015;2015;03;22;Keskiviikko;0;5;5;1;3;4
109;04.03.2015;2015;03;23;Keskiviikko;0;0;0;0;0;0
109;05.03.2015;2015;03;00;Torstai;0;0;0;1;3;4
109;05.03.2015;2015;03;01;Torstai;0;0;0;0;0;0
109;05.03.2015;2015;03;02;Torstai;0;0;0;0;0;0
109;05.03.2015;2015;03;03;Torstai;0;0;0;0;0;0
109;05.03.2015;2015;03;04;Torstai;0;0;0;0;0;0
109;05.03.2015;2015;03;05;Torstai;0;4;4;2;1;3
109;05.03.2015;2015;03;06;Torstai;3;18;21;3;1;4
109;05.03.2015;2015;03;07;Torstai;10;30;40;2;8;10
109;05.03.2015;2015;03;08;Torstai;9;24;33;1;5;6
109;05.03.2015;2015;03;09;Torstai;1;5;6;1;6;7
109;05.03.2015;2015;03;10;Torstai;0;8;8;6;9;15
109;05.03.2015;2015;03;11;Torstai;1;7;8;3;4;7
109;05.03.2015;2015;03;12;Torstai;1;11;12;2;4;6
109;05.03.2015;2015;03;13;Torstai;7;9;16;3;9;12
109;05.03.2015;2015;03;14;Torstai;4;11;15;4;2;6
109;05.03.2015;2015;03;15;Torstai;11;23;34;2;8;10
109;05.03.2015;2015;03;16;Torstai;15;28;43;1;7;8
109;05.03.2015;2015;03;17;Torstai;13;19;32;5;6;11
109;05.03.2015;2015;03;18;Torstai;6;11;17;3;6;9
109;05.03.2015;2015;03;19;Torstai;5;9;14;5;3;8
109;05.03.2015;2015;03;20;Torstai;5;2;7;4;6;10
109;05.03.2015;2015;03;21;Torstai;10;5;15;4;2;6
109;05.03.2015;2015;03;22;Torstai;1;7;8;2;0;2
109;05.03.2015;2015;03;23;Torstai;0;0;0;2;1;3
109;06.03.2015;2015;03;00;Perjantai;1;0;1;1;2;3
109;06.03.2015;2015;03;01;Perjantai;0;0;0;0;0;0
109;06.03.2015;2015;03;02;Perjantai;1;0;1;0;0;0
109;06.03.2015;2015;03;03;Perjantai;0;0;0;0;0;0
109;06.03.2015;2015;03;04;Perjantai;0;0;0;1;0;1
109;06.03.2015;2015;03;05;Perjantai;1;2;3;0;0;0
109;06.03.2015;2015;03;06;Perjantai;7;9;16;4;1;5
109;06.03.2015;2015;03;07;Perjantai;13;21;34;2;3;5
109;06.03.2015;2015;03;08;Perjantai;2;25;27;1;7;8
109;06.03.2015;2015;03;09;Perjantai;6;3;9;2;2;4
109;06.03.2015;2015;03;10;Perjantai;10;0;10;6;0;6
109;06.03.2015;2015;03;11;Perjantai;3;5;8;3;3;6
109;06.03.2015;2015;03;12;Perjantai;1;16;17;3;4;7
109;06.03.2015;2015;03;13;Perjantai;5;4;9;2;2;4
109;06.03.2015;2015;03;14;Perjantai;3;12;15;2;9;11
109;06.03.2015;2015;03;15;Perjantai;11;23;34;6;7;13
109;06.03.2015;2015;03;16;Perjantai;14;24;38;11;10;21
109;06.03.2015;2015;03;17;Perjantai;9;14;23;5;4;9
109;06.03.2015;2015;03;18;Perjantai;5;5;10;1;8;9
109;06.03.2015;2015;03;19;Perjantai;6;7;13;4;6;10
109;06.03.2015;2015;03;20;Perjantai;5;0;5;4;3;7
109;06.03.2015;2015;03;21;Perjantai;3;2;5;2;3;5
109;06.03.2015;2015;03;22;Perjantai;2;1;3;2;5;7
109;06.03.2015;2015;03;23;Perjantai;0;1;1;1;4;5
109;07.03.2015;2015;03;00;Lauantai;1;3;4;1;1;2
109;07.03.2015;2015;03;01;Lauantai;1;2;3;0;0;0
109;07.03.2015;2015;03;02;Lauantai;0;0;0;0;0;0
109;07.03.2015;2015;03;03;Lauantai;0;0;0;0;0;0
109;07.03.2015;2015;03;04;Lauantai;2;1;3;0;0;0
109;07.03.2015;2015;03;05;Lauantai;0;1;1;0;0;0
109;07.03.2015;2015;03;06;Lauantai;0;4;4;1;1;2
109;07.03.2015;2015;03;07;Lauantai;0;1;1;0;2;2
109;07.03.2015;2015;03;08;Lauantai;1;0;1;2;4;6
109;07.03.2015;2015;03;09;Lauantai;2;3;5;8;5;13
109;07.03.2015;2015;03;10;Lauantai;2;3;5;4;8;12
109;07.03.2015;2015;03;11;Lauantai;0;8;8;3;5;8
109;07.03.2015;2015;03;12;Lauantai;1;3;4;2;8;10
109;07.03.2015;2015;03;13;Lauantai;2;5;7;1;4;5
109;07.03.2015;2015;03;14;Lauantai;1;7;8;1;3;4
109;07.03.2015;2015;03;15;Lauantai;4;3;7;1;7;8
109;07.03.2015;2015;03;16;Lauantai;2;4;6;1;2;3
109;07.03.2015;2015;03;17;Lauantai;4;1;5;1;5;6
109;07.03.2015;2015;03;18;Lauantai;1;8;9;0;1;1
109;07.03.2015;2015;03;19;Lauantai;0;5;5;1;0;1
109;07.03.2015;2015;03;20;Lauantai;3;3;6;1;3;4
109;07.03.2015;2015;03;21;Lauantai;6;1;7;1;2;3
109;07.03.2015;2015;03;22;Lauantai;2;3;5;1;1;2
109;07.03.2015;2015;03;23;Lauantai;2;1;3;1;0;1
109;08.03.2015;2015;03;00;Sunnuntai;0;5;5;0;0;0
109;08.03.2015;2015;03;01;Sunnuntai;0;0;0;1;0;1
109;08.03.2015;2015;03;02;Sunnuntai;0;0;0;1;0;1
109;08.03.2015;2015;03;03;Sunnuntai;1;0;1;0;0;0
109;08.03.2015;2015;03;04;Sunnuntai;3;0;3;0;0;0
109;08.03.2015;2015;03;05;Sunnuntai;0;0;0;2;0;2
109;08.03.2015;2015;03;06;Sunnuntai;0;3;3;1;0;1
109;08.03.2015;2015;03;07;Sunnuntai;0;0;0;1;3;4
109;08.03.2015;2015;03;08;Sunnuntai;1;3;4;3;2;5
109;08.03.2015;2015;03;09;Sunnuntai;1;3;4;4;6;10
109;08.03.2015;2015;03;10;Sunnuntai;1;4;5;3;10;13
109;08.03.2015;2015;03;11;Sunnuntai;0;0;0;3;8;11
109;08.03.2015;2015;03;12;Sunnuntai;3;10;13;2;10;12
109;08.03.2015;2015;03;13;Sunnuntai;6;8;14;2;8;10
109;08.03.2015;2015;03;14;Sunnuntai;7;11;18;7;17;24
109;08.03.2015;2015;03;15;Sunnuntai;3;5;8;5;8;13
109;08.03.2015;2015;03;16;Sunnuntai;4;0;4;6;9;15
109;08.03.2015;2015;03;17;Sunnuntai;5;3;8;7;6;13
109;08.03.2015;2015;03;18;Sunnuntai;8;8;16;6;13;19
109;08.03.2015;2015;03;19;Sunnuntai;6;3;9;7;8;15
109;08.03.2015;2015;03;20;Sunnuntai;2;3;5;3;4;7
109;08.03.2015;2015;03;21;Sunnuntai;1;1;2;0;5;5
109;08.03.2015;2015;03;22;Sunnuntai;4;1;5;0;1;1
109;08.03.2015;2015;03;23;Sunnuntai;0;0;0;1;1;2
109;09.03.2015;2015;03;00;Maanantai;0;0;0;0;0;0
109;09.03.2015;2015;03;01;Maanantai;0;0;0;0;0;0
109;09.03.2015;2015;03;02;Maanantai;0;0;0;1;0;1
109;09.03.2015;2015;03;03;Maanantai;0;0;0;0;0;0
109;09.03.2015;2015;03;04;Maanantai;0;3;3;0;0;0
109;09.03.2015;2015;03;05;Maanantai;3;1;4;2;0;2
109;09.03.2015;2015;03;06;Maanantai;3;23;26;7;4;11
109;09.03.2015;2015;03;07;Maanantai;26;57;83;2;6;8
109;09.03.2015;2015;03;08;Maanantai;19;51;70;4;1;5
109;09.03.2015;2015;03;09;Maanantai;7;13;20;4;3;7
109;09.03.2015;2015;03;10;Maanantai;8;7;15;0;0;0
109;09.03.2015;2015;03;11;Maanantai;2;9;11;0;3;3
109;09.03.2015;2015;03;12;Maanantai;6;12;18;2;8;10
109;09.03.2015;2015;03;13;Maanantai;11;12;23;5;8;13
109;09.03.2015;2015;03;14;Maanantai;21;8;29;4;5;9
109;09.03.2015;2015;03;15;Maanantai;14;18;32;3;6;9
109;09.03.2015;2015;03;16;Maanantai;27;41;68;5;13;18
109;09.03.2015;2015;03;17;Maanantai;20;21;41;2;4;6
109;09.03.2015;2015;03;18;Maanantai;11;7;18;9;6;15
109;09.03.2015;2015;03;19;Maanantai;11;11;22;4;10;14
109;09.03.2015;2015;03;20;Maanantai;4;5;9;2;4;6
109;09.03.2015;2015;03;21;Maanantai;9;4;13;1;3;4
109;09.03.2015;2015;03;22;Maanantai;2;6;8;1;0;1
109;09.03.2015;2015;03;23;Maanantai;0;4;4;0;0;0
109;10.03.2015;2015;03;00;Tiistai;1;0;1;1;1;2
109;10.03.2015;2015;03;01;Tiistai;0;0;0;0;0;0
109;10.03.2015;2015;03;02;Tiistai;0;0;0;0;0;0
109;10.03.2015;2015;03;03;Tiistai;0;0;0;0;0;0
109;10.03.2015;2015;03;04;Tiistai;0;0;0;0;0;0
109;10.03.2015;2015;03;05;Tiistai;3;3;6;1;0;1
109;10.03.2015;2015;03;06;Tiistai;3;27;30;3;5;8
109;10.03.2015;2015;03;07;Tiistai;18;62;80;2;6;8
109;10.03.2015;2015;03;08;Tiistai;12;49;61;5;8;13
109;10.03.2015;2015;03;09;Tiistai;8;8;16;2;7;9
109;10.03.2015;2015;03;10;Tiistai;6;12;18;1;10;11
109;10.03.2015;2015;03;11;Tiistai;3;8;11;5;5;10
109;10.03.2015;2015;03;12;Tiistai;10;9;19;3;5;8
109;10.03.2015;2015;03;13;Tiistai;4;7;11;2;3;5
109;10.03.2015;2015;03;14;Tiistai;13;9;22;2;9;11
109;10.03.2015;2015;03;15;Tiistai;19;23;42;7;5;12
109;10.03.2015;2015;03;16;Tiistai;28;39;67;3;7;10
109;10.03.2015;2015;03;17;Tiistai;7;23;30;6;6;12
109;10.03.2015;2015;03;18;Tiistai;10;14;24;1;4;5
109;10.03.2015;2015;03;19;Tiistai;5;8;13;1;5;6
109;10.03.2015;2015;03;20;Tiistai;3;4;7;1;3;4
109;10.03.2015;2015;03;21;Tiistai;3;7;10;2;1;3
109;10.03.2015;2015;03;22;Tiistai;3;1;4;0;0;0
109;10.03.2015;2015;03;23;Tiistai;0;1;1;1;1;2
109;11.03.2015;2015;03;00;Keskiviikko;0;0;0;0;0;0
109;11.03.2015;2015;03;01;Keskiviikko;0;0;0;0;0;0
109;11.03.2015;2015;03;02;Keskiviikko;0;2;2;0;0;0
109;11.03.2015;2015;03;03;Keskiviikko;1;0;1;0;0;0
109;11.03.2015;2015;03;04;Keskiviikko;0;1;1;0;0;0
109;11.03.2015;2015;03;05;Keskiviikko;0;4;4;0;2;2
109;11.03.2015;2015;03;06;Keskiviikko;2;19;21;3;4;7
109;11.03.2015;2015;03;07;Keskiviikko;16;65;81;3;12;15
109;11.03.2015;2015;03;08;Keskiviikko;10;47;57;0;5;5
109;11.03.2015;2015;03;09;Keskiviikko;0;16;16;3;6;9
109;11.03.2015;2015;03;10;Keskiviikko;1;10;11;4;5;9
109;11.03.2015;2015;03;11;Keskiviikko;4;9;13;4;8;12
109;11.03.2015;2015;03;12;Keskiviikko;6;11;17;3;8;11
109;11.03.2015;2015;03;13;Keskiviikko;4;8;12;5;5;10
109;11.03.2015;2015;03;14;Keskiviikko;4;23;27;2;6;8
109;11.03.2015;2015;03;15;Keskiviikko;14;31;45;3;6;9
109;11.03.2015;2015;03;16;Keskiviikko;17;59;76;2;12;14
109;11.03.2015;2015;03;17;Keskiviikko;13;31;44;4;5;9
109;11.03.2015;2015;03;18;Keskiviikko;3;10;13;3;7;10
109;11.03.2015;2015;03;19;Keskiviikko;4;13;17;1;8;9
109;11.03.2015;2015;03;20;Keskiviikko;1;8;9;2;5;7
109;11.03.2015;2015;03;21;Keskiviikko;0;12;12;1;3;4
109;11.03.2015;2015;03;22;Keskiviikko;0;3;3;1;4;5
109;11.03.2015;2015;03;23;Keskiviikko;0;1;1;2;1;3
109;12.03.2015;2015;03;00;Torstai;0;0;0;0;1;1
109;12.03.2015;2015;03;01;Torstai;0;1;1;0;0;0
109;12.03.2015;2015;03;02;Torstai;0;0;0;0;1;1
109;12.03.2015;2015;03;03;Torstai;0;1;1;0;0;0
109;12.03.2015;2015;03;04;Torstai;2;0;2;0;0;0
109;12.03.2015;2015;03;05;Torstai;2;2;4;0;0;0
109;12.03.2015;2015;03;06;Torstai;5;16;21;2;5;7
109;12.03.2015;2015;03;07;Torstai;13;58;71;0;11;11
109;12.03.2015;2015;03;08;Torstai;4;48;52;0;5;5
109;12.03.2015;2015;03;09;Torstai;0;18;18;1;4;5
109;12.03.2015;2015;03;10;Torstai;4;9;13;3;11;14
109;12.03.2015;2015;03;11;Torstai;2;9;11;2;6;8
109;12.03.2015;2015;03;12;Torstai;3;9;12;8;10;18
109;12.03.2015;2015;03;13;Torstai;12;8;20;6;5;11
109;12.03.2015;2015;03;14;Torstai;17;13;30;6;7;13
109;12.03.2015;2015;03;15;Torstai;25;19;44;7;6;13
109;12.03.2015;2015;03;16;Torstai;39;29;68;7;4;11
109;12.03.2015;2015;03;17;Torstai;16;13;29;2;6;8
109;12.03.2015;2015;03;18;Torstai;12;11;23;4;8;12
109;12.03.2015;2015;03;19;Torstai;5;10;15;5;6;11
109;12.03.2015;2015;03;20;Torstai;5;12;17;1;5;6
109;12.03.2015;2015;03;21;Torstai;10;3;13;0;2;2
109;12.03.2015;2015;03;22;Torstai;0;5;5;2;1;3
109;12.03.2015;2015;03;23;Torstai;0;1;1;0;0;0
109;13.03.2015;2015;03;00;Perjantai;0;0;0;0;0;0
109;13.03.2015;2015;03;01;Perjantai;2;0;2;0;2;2
109;13.03.2015;2015;03;02;Perjantai;2;0;2;1;1;2
109;13.03.2015;2015;03;03;Perjantai;0;0;0;0;0;0
109;13.03.2015;2015;03;04;Perjantai;2;4;6;1;2;3
109;13.03.2015;2015;03;05;Perjantai;3;1;4;0;0;0
109;13.03.2015;2015;03;06;Perjantai;3;13;16;5;2;7
109;13.03.2015;2015;03;07;Perjantai;15;47;62;6;8;14
109;13.03.2015;2015;03;08;Perjantai;9;37;46;2;2;4
109;13.03.2015;2015;03;09;Perjantai;3;14;17;4;6;10
109;13.03.2015;2015;03;10;Perjantai;7;11;18;5;6;11
109;13.03.2015;2015;03;11;Perjantai;1;12;13;2;7;9
109;13.03.2015;2015;03;12;Perjantai;8;7;15;0;4;4
109;13.03.2015;2015;03;13;Perjantai;6;8;14;1;5;6
109;13.03.2015;2015;03;14;Perjantai;12;12;24;2;4;6
109;13.03.2015;2015;03;15;Perjantai;27;19;46;6;6;12
109;13.03.2015;2015;03;16;Perjantai;26;25;51;3;6;9
109;13.03.2015;2015;03;17;Perjantai;21;6;27;7;3;10
109;13.03.2015;2015;03;18;Perjantai;3;7;10;2;5;7
109;13.03.2015;2015;03;19;Perjantai;5;3;8;4;0;4
109;13.03.2015;2015;03;20;Perjantai;4;2;6;0;3;3
109;13.03.2015;2015;03;21;Perjantai;5;11;16;1;7;8
109;13.03.2015;2015;03;22;Perjantai;1;3;4;0;3;3
109;13.03.2015;2015;03;23;Perjantai;1;4;5;0;1;1
109;14.03.2015;2015;03;00;Lauantai;1;4;5;0;0;0
109;14.03.2015;2015;03;01;Lauantai;2;3;5;0;0;0
109;14.03.2015;2015;03;02;Lauantai;0;0;0;0;0;0
109;14.03.2015;2015;03;03;Lauantai;1;0;1;0;0;0
109;14.03.2015;2015;03;04;Lauantai;0;0;0;0;0;0
109;14.03.2015;2015;03;05;Lauantai;1;0;1;1;0;1
109;14.03.2015;2015;03;06;Lauantai;0;3;3;1;3;4
109;14.03.2015;2015;03;07;Lauantai;2;2;4;2;1;3
109;14.03.2015;2015;03;08;Lauantai;4;2;6;6;5;11
109;14.03.2015;2015;03;09;Lauantai;1;3;4;3;8;11
109;14.03.2015;2015;03;10;Lauantai;5;3;8;4;6;10
109;14.03.2015;2015;03;11;Lauantai;5;9;14;3;5;8
109;14.03.2015;2015;03;12;Lauantai;5;7;12;6;6;12
109;14.03.2015;2015;03;13;Lauantai;7;9;16;2;5;7
109;14.03.2015;2015;03;14;Lauantai;3;10;13;1;3;4
109;14.03.2015;2015;03;15;Lauantai;11;2;13;2;4;6
109;14.03.2015;2015;03;16;Lauantai;4;5;9;3;6;9
109;14.03.2015;2015;03;17;Lauantai;5;5;10;7;5;12
109;14.03.2015;2015;03;18;Lauantai;4;5;9;3;9;12
109;14.03.2015;2015;03;19;Lauantai;2;3;5;1;3;4
109;14.03.2015;2015;03;20;Lauantai;2;6;8;2;3;5
109;14.03.2015;2015;03;21;Lauantai;4;2;6;1;0;1
109;14.03.2015;2015;03;22;Lauantai;3;5;8;1;3;4
109;14.03.2015;2015;03;23;Lauantai;1;1;2;2;0;2
109;15.03.2015;2015;03;00;Sunnuntai;1;0;1;0;0;0
109;15.03.2015;2015;03;01;Sunnuntai;0;0;0;0;0;0
109;15.03.2015;2015;03;02;Sunnuntai;3;0;3;0;0;0
109;15.03.2015;2015;03;03;Sunnuntai;1;0;1;0;0;0
109;15.03.2015;2015;03;04;Sunnuntai;0;1;1;0;0;0
109;15.03.2015;2015;03;05;Sunnuntai;0;0;0;0;1;1
109;15.03.2015;2015;03;06;Sunnuntai;0;5;5;0;0;0
109;15.03.2015;2015;03;07;Sunnuntai;2;3;5;1;5;6
109;15.03.2015;2015;03;08;Sunnuntai;0;1;1;2;4;6
109;15.03.2015;2015;03;09;Sunnuntai;4;6;10;3;5;8
109;15.03.2015;2015;03;10;Sunnuntai;1;3;4;6;5;11
109;15.03.2015;2015;03;11;Sunnuntai;6;6;12;6;14;20
109;15.03.2015;2015;03;12;Sunnuntai;2;6;8;5;4;9
109;15.03.2015;2015;03;13;Sunnuntai;3;4;7;4;8;12
109;15.03.2015;2015;03;14;Sunnuntai;8;4;12;7;8;15
109;15.03.2015;2015;03;15;Sunnuntai;9;7;16;2;12;14
109;15.03.2015;2015;03;16;Sunnuntai;6;11;17;9;10;19
109;15.03.2015;2015;03;17;Sunnuntai;6;13;19;5;5;10
109;15.03.2015;2015;03;18;Sunnuntai;3;4;7;6;9;15
109;15.03.2015;2015;03;19;Sunnuntai;1;3;4;2;4;6
109;15.03.2015;2015;03;20;Sunnuntai;3;3;6;4;2;6
109;15.03.2015;2015;03;21;Sunnuntai;7;1;8;0;2;2
109;15.03.2015;2015;03;22;Sunnuntai;4;0;4;1;0;1
109;15.03.2015;2015;03;23;Sunnuntai;0;0;0;0;0;0
109;16.03.2015;2015;03;00;Maanantai;0;0;0;1;2;3
109;16.03.2015;2015;03;01;Maanantai;0;1;1;1;0;1
109;16.03.2015;2015;03;02;Maanantai;0;0;0;2;0;2
109;16.03.2015;2015;03;03;Maanantai;0;0;0;0;0;0
109;16.03.2015;2015;03;04;Maanantai;1;0;1;0;0;0
109;16.03.2015;2015;03;05;Maanantai;0;1;1;1;0;1
109;16.03.2015;2015;03;06;Maanantai;8;19;27;4;3;7
109;16.03.2015;2015;03;07;Maanantai;21;57;78;4;11;15
109;16.03.2015;2015;03;08;Maanantai;16;55;71;0;3;3
109;16.03.2015;2015;03;09;Maanantai;2;11;13;2;2;4
109;16.03.2015;2015;03;10;Maanantai;2;9;11;2;3;5
109;16.03.2015;2015;03;11;Maanantai;9;11;20;4;12;16
109;16.03.2015;2015;03;12;Maanantai;10;24;34;6;8;14
109;16.03.2015;2015;03;13;Maanantai;18;8;26;3;6;9
109;16.03.2015;2015;03;14;Maanantai;20;12;32;2;10;12
109;16.03.2015;2015;03;15;Maanantai;37;16;53;4;5;9
109;16.03.2015;2015;03;16;Maanantai;41;39;80;7;3;10
109;16.03.2015;2015;03;17;Maanantai;29;21;50;4;9;13
109;16.03.2015;2015;03;18;Maanantai;14;16;30;1;11;12
109;16.03.2015;2015;03;19;Maanantai;13;8;21;4;6;10
109;16.03.2015;2015;03;20;Maanantai;10;5;15;2;4;6
109;16.03.2015;2015;03;21;Maanantai;4;3;7;1;2;3
109;16.03.2015;2015;03;22;Maanantai;4;11;15;0;1;1
109;16.03.2015;2015;03;23;Maanantai;1;2;3;2;1;3
109;17.03.2015;2015;03;00;Tiistai;1;2;3;0;0;0
109;17.03.2015;2015;03;01;Tiistai;0;0;0;0;0;0
109;17.03.2015;2015;03;02;Tiistai;0;0;0;0;0;0
109;17.03.2015;2015;03;03;Tiistai;0;0;0;0;0;0
109;17.03.2015;2015;03;04;Tiistai;0;2;2;0;0;0
109;17.03.2015;2015;03;05;Tiistai;0;2;2;0;0;0
109;17.03.2015;2015;03;06;Tiistai;10;26;36;4;4;8
109;17.03.2015;2015;03;07;Tiistai;25;53;78;0;7;7
109;17.03.2015;2015;03;08;Tiistai;20;47;67;1;5;6
109;17.03.2015;2015;03;09;Tiistai;9;13;22;4;11;15
109;17.03.2015;2015;03;10;Tiistai;4;9;13;4;6;10
109;17.03.2015;2015;03;11;Tiistai;6;10;16;3;7;10
109;17.03.2015;2015;03;12;Tiistai;4;11;15;5;1;6
109;17.03.2015;2015;03;13;Tiistai;14;10;24;5;5;10
109;17.03.2015;2015;03;14;Tiistai;13;14;27;3;8;11
109;17.03.2015;2015;03;15;Tiistai;42;26;68;6;7;13
109;17.03.2015;2015;03;16;Tiistai;47;36;83;6;5;11
109;17.03.2015;2015;03;17;Tiistai;14;23;37;7;4;11
109;17.03.2015;2015;03;18;Tiistai;11;11;22;4;5;9
109;17.03.2015;2015;03;19;Tiistai;13;5;18;3;11;14
109;17.03.2015;2015;03;20;Tiistai;8;6;14;5;3;8
109;17.03.2015;2015;03;21;Tiistai;11;0;11;4;4;8
109;17.03.2015;2015;03;22;Tiistai;2;5;7;1;2;3
109;17.03.2015;2015;03;23;Tiistai;1;2;3;0;0;0
109;18.03.2015;2015;03;00;Keskiviikko;0;0;0;1;1;2
109;18.03.2015;2015;03;01;Keskiviikko;0;0;0;0;0;0
109;18.03.2015;2015;03;02;Keskiviikko;0;2;2;0;0;0
109;18.03.2015;2015;03;03;Keskiviikko;0;1;1;0;0;0
109;18.03.2015;2015;03;04;Keskiviikko;0;0;0;0;0;0
109;18.03.2015;2015;03;05;Keskiviikko;0;1;1;2;1;3
109;18.03.2015;2015;03;06;Keskiviikko;7;19;26;3;4;7
109;18.03.2015;2015;03;07;Keskiviikko;28;52;80;0;10;10
109;18.03.2015;2015;03;08;Keskiviikko;18;46;64;1;7;8
109;18.03.2015;2015;03;09;Keskiviikko;5;18;23;4;4;8
109;18.03.2015;2015;03;10;Keskiviikko;2;12;14;4;5;9
109;18.03.2015;2015;03;11;Keskiviikko;11;14;25;5;3;8
109;18.03.2015;2015;03;12;Keskiviikko;6;16;22;1;1;2
109;18.03.2015;2015;03;13;Keskiviikko;10;11;21;1;5;6
109;18.03.2015;2015;03;14;Keskiviikko;20;12;32;1;6;7
109;18.03.2015;2015;03;15;Keskiviikko;33;27;60;4;7;11
109;18.03.2015;2015;03;16;Keskiviikko;42;36;78;5;7;12
109;18.03.2015;2015;03;17;Keskiviikko;26;28;54;3;6;9
109;18.03.2015;2015;03;18;Keskiviikko;12;10;22;1;7;8
109;18.03.2015;2015;03;19;Keskiviikko;12;14;26;3;5;8
109;18.03.2015;2015;03;20;Keskiviikko;5;4;9;3;4;7
109;18.03.2015;2015;03;21;Keskiviikko;2;2;4;1;4;5
109;18.03.2015;2015;03;22;Keskiviikko;4;4;8;0;1;1
109;18.03.2015;2015;03;23;Keskiviikko;1;0;1;0;0;0
109;19.03.2015;2015;03;00;Torstai;1;0;1;0;0;0
109;19.03.2015;2015;03;01;Torstai;0;0;0;0;0;0
109;19.03.2015;2015;03;02;Torstai;0;0;0;0;0;0
109;19.03.2015;2015;03;03;Torstai;0;2;2;0;0;0
109;19.03.2015;2015;03;04;Torstai;0;2;2;0;0;0
109;19.03.2015;2015;03;05;Torstai;0;2;2;5;0;5
109;19.03.2015;2015;03;06;Torstai;10;22;32;3;3;6
109;19.03.2015;2015;03;07;Torstai;27;45;72;2;5;7
109;19.03.2015;2015;03;08;Torstai;18;50;68;3;8;11
109;19.03.2015;2015;03;09;Torstai;11;20;31;8;9;17
109;19.03.2015;2015;03;10;Torstai;4;10;14;3;6;9
109;19.03.2015;2015;03;11;Torstai;8;7;15;2;3;5
109;19.03.2015;2015;03;12;Torstai;3;9;12;1;2;3
109;19.03.2015;2015;03;13;Torstai;8;12;20;2;3;5
109;19.03.2015;2015;03;14;Torstai;7;7;14;3;0;3
109;19.03.2015;2015;03;15;Torstai;26;13;39;4;3;7
109;19.03.2015;2015;03;16;Torstai;48;33;81;5;6;11
109;19.03.2015;2015;03;17;Torstai;26;26;52;8;4;12
109;19.03.2015;2015;03;18;Torstai;14;15;29;2;4;6
109;19.03.2015;2015;03;19;Torstai;9;13;22;5;5;10
109;19.03.2015;2015;03;20;Torstai;5;2;7;4;2;6
109;19.03.2015;2015;03;21;Torstai;3;2;5;2;2;4
109;19.03.2015;2015;03;22;Torstai;7;8;15;1;0;1
109;19.03.2015;2015;03;23;Torstai;2;5;7;0;1;1
109;20.03.2015;2015;03;00;Perjantai;3;0;3;0;0;0
109;20.03.2015;2015;03;01;Perjantai;0;0;0;0;1;1
109;20.03.2015;2015;03;02;Perjantai;1;3;4;1;0;1
109;20.03.2015;2015;03;03;Perjantai;0;0;0;0;0;0
109;20.03.2015;2015;03;04;Perjantai;0;1;1;0;0;0
109;20.03.2015;2015;03;05;Perjantai;4;6;10;0;0;0
109;20.03.2015;2015;03;06;Perjantai;4;16;20;4;1;5
109;20.03.2015;2015;03;07;Perjantai;26;37;63;3;7;10
109;20.03.2015;2015;03;08;Perjantai;14;47;61;2;6;8
109;20.03.2015;2015;03;09;Perjantai;5;23;28;3;3;6
109;20.03.2015;2015;03;10;Perjantai;2;5;7;1;3;4
109;20.03.2015;2015;03;11;Perjantai;7;7;14;2;6;8
109;20.03.2015;2015;03;12;Perjantai;10;8;18;0;3;3
109;20.03.2015;2015;03;13;Perjantai;10;7;17;2;2;4
109;20.03.2015;2015;03;14;Perjantai;7;11;18;2;6;8
109;20.03.2015;2015;03;15;Perjantai;23;22;45;7;7;14
109;20.03.2015;2015;03;16;Perjantai;26;28;54;3;6;9
109;20.03.2015;2015;03;17;Perjantai;14;19;33;3;2;5
109;20.03.2015;2015;03;18;Perjantai;7;16;23;2;5;7
109;20.03.2015;2015;03;19;Perjantai;6;8;14;0;3;3
109;20.03.2015;2015;03;20;Perjantai;1;1;2;6;1;7
109;20.03.2015;2015;03;21;Perjantai;5;1;6;1;4;5
109;20.03.2015;2015;03;22;Perjantai;1;4;5;0;0;0
109;20.03.2015;2015;03;23;Perjantai;1;2;3;1;0;1
109;21.03.2015;2015;03;00;Lauantai;0;5;5;0;0;0
109;21.03.2015;2015;03;01;Lauantai;3;0;3;0;0;0
109;21.03.2015;2015;03;02;Lauantai;1;0;1;0;0;0
109;21.03.2015;2015;03;03;Lauantai;0;0;0;1;0;1
109;21.03.2015;2015;03;04;Lauantai;3;0;3;0;0;0
109;21.03.2015;2015;03;05;Lauantai;0;2;2;0;1;1
109;21.03.2015;2015;03;06;Lauantai;0;1;1;1;1;2
109;21.03.2015;2015;03;07;Lauantai;2;0;2;1;3;4
109;21.03.2015;2015;03;08;Lauantai;2;2;4;2;3;5
109;21.03.2015;2015;03;09;Lauantai;4;6;10;2;4;6
109;21.03.2015;2015;03;10;Lauantai;2;10;12;1;7;8
109;21.03.2015;2015;03;11;Lauantai;2;10;12;3;4;7
109;21.03.2015;2015;03;12;Lauantai;1;10;11;3;8;11
109;21.03.2015;2015;03;13;Lauantai;5;4;9;5;7;12
109;21.03.2015;2015;03;14;Lauantai;6;6;12;7;3;10
109;21.03.2015;2015;03;15;Lauantai;2;6;8;0;9;9
109;21.03.2015;2015;03;16;Lauantai;7;9;16;1;3;4
109;21.03.2015;2015;03;17;Lauantai;4;5;9;4;5;9
109;21.03.2015;2015;03;18;Lauantai;1;9;10;2;3;5
109;21.03.2015;2015;03;19;Lauantai;1;6;7;3;8;11
109;21.03.2015;2015;03;20;Lauantai;0;2;2;0;2;2
109;21.03.2015;2015;03;21;Lauantai;7;3;10;1;1;2
109;21.03.2015;2015;03;22;Lauantai;4;1;5;0;0;0
109;21.03.2015;2015;03;23;Lauantai;4;0;4;0;0;0
109;22.03.2015;2015;03;00;Sunnuntai;0;1;1;0;0;0
109;22.03.2015;2015;03;01;Sunnuntai;0;2;2;0;0;0
109;22.03.2015;2015;03;02;Sunnuntai;1;1;2;0;0;0
109;22.03.2015;2015;03;03;Sunnuntai;2;0;2;0;0;0
109;22.03.2015;2015;03;04;Sunnuntai;5;0;5;1;1;2
109;22.03.2015;2015;03;05;Sunnuntai;0;1;1;2;1;3
109;22.03.2015;2015;03;06;Sunnuntai;0;0;0;0;2;2
109;22.03.2015;2015;03;07;Sunnuntai;2;1;3;1;2;3
109;22.03.2015;2015;03;08;Sunnuntai;0;4;4;4;5;9
109;22.03.2015;2015;03;09;Sunnuntai;1;0;1;4;7;11
109;22.03.2015;2015;03;10;Sunnuntai;4;3;7;3;5;8
109;22.03.2015;2015;03;11;Sunnuntai;2;3;5;4;7;11
109;22.03.2015;2015;03;12;Sunnuntai;2;3;5;8;5;13
109;22.03.2015;2015;03;13;Sunnuntai;3;5;8;7;7;14
109;22.03.2015;2015;03;14;Sunnuntai;5;5;10;3;10;13
109;22.03.2015;2015;03;15;Sunnuntai;2;1;3;0;5;5
109;22.03.2015;2015;03;16;Sunnuntai;3;6;9;2;6;8
109;22.03.2015;2015;03;17;Sunnuntai;3;2;5;1;6;7
109;22.03.2015;2015;03;18;Sunnuntai;4;0;4;7;0;7
109;22.03.2015;2015;03;19;Sunnuntai;2;0;2;7;0;7
109;22.03.2015;2015;03;20;Sunnuntai;0;2;2;9;0;9
109;22.03.2015;2015;03;21;Sunnuntai;4;0;4;5;0;5
109;22.03.2015;2015;03;22;Sunnuntai;4;0;4;1;0;1
109;22.03.2015;2015;03;23;Sunnuntai;0;0;0;0;0;0
109;23.03.2015;2015;03;00;Maanantai;1;0;1;1;0;1
109;23.03.2015;2015;03;01;Maanantai;0;0;0;1;0;1
109;23.03.2015;2015;03;02;Maanantai;0;0;0;0;0;0
109;23.03.2015;2015;03;03;Maanantai;0;0;0;0;0;0
109;23.03.2015;2015;03;04;Maanantai;0;0;0;0;0;0
109;23.03.2015;2015;03;05;Maanantai;2;2;4;0;1;1
109;23.03.2015;2015;03;06;Maanantai;14;9;23;3;2;5
109;23.03.2015;2015;03;07;Maanantai;28;33;61;6;6;12
109;23.03.2015;2015;03;08;Maanantai;19;40;59;2;4;6
109;23.03.2015;2015;03;09;Maanantai;3;11;14;3;2;5
109;23.03.2015;2015;03;10;Maanantai;6;8;14;4;1;5
109;23.03.2015;2015;03;11;Maanantai;1;12;13;1;4;5
109;23.03.2015;2015;03;12;Maanantai;6;10;16;2;2;4
109;23.03.2015;2015;03;13;Maanantai;10;6;16;3;4;7
109;23.03.2015;2015;03;14;Maanantai;11;10;21;5;4;9
109;23.03.2015;2015;03;15;Maanantai;27;26;53;4;7;11
109;23.03.2015;2015;03;16;Maanantai;29;48;77;6;5;11
109;23.03.2015;2015;03;17;Maanantai;24;13;37;7;5;12
109;23.03.2015;2015;03;18;Maanantai;9;9;18;3;8;11
109;23.03.2015;2015;03;19;Maanantai;11;10;21;5;6;11
109;23.03.2015;2015;03;20;Maanantai;4;3;7;3;3;6
109;23.03.2015;2015;03;21;Maanantai;2;7;9;3;6;9
109;23.03.2015;2015;03;22;Maanantai;0;9;9;0;0;0
109;23.03.2015;2015;03;23;Maanantai;1;1;2;0;0;0
109;24.03.2015;2015;03;00;Tiistai;2;0;2;1;1;2
109;24.03.2015;2015;03;01;Tiistai;0;0;0;0;0;0
109;24.03.2015;2015;03;02;Tiistai;0;0;0;1;0;1
109;24.03.2015;2015;03;03;Tiistai;0;0;0;0;0;0
109;24.03.2015;2015;03;04;Tiistai;0;0;0;0;0;0
109;24.03.2015;2015;03;05;Tiistai;0;4;4;0;2;2
109;24.03.2015;2015;03;06;Tiistai;2;16;18;8;7;15
109;24.03.2015;2015;03;07;Tiistai;13;58;71;2;11;13
109;24.03.2015;2015;03;08;Tiistai;8;37;45;0;6;6
109;24.03.2015;2015;03;09;Tiistai;5;10;15;0;4;4
109;24.03.2015;2015;03;10;Tiistai;2;15;17;3;4;7
109;24.03.2015;2015;03;11;Tiistai;0;0;0;0;4;4
109;24.03.2015;2015;03;12;Tiistai;5;6;11;5;6;11
109;24.03.2015;2015;03;13;Tiistai;3;2;5;4;6;10
109;24.03.2015;2015;03;14;Tiistai;8;7;15;2;1;3
109;24.03.2015;2015;03;15;Tiistai;13;19;32;0;8;8
109;24.03.2015;2015;03;16;Tiistai;10;33;43;0;10;10
109;24.03.2015;2015;03;17;Tiistai;7;26;33;0;6;6
109;24.03.2015;2015;03;18;Tiistai;5;6;11;2;7;9
109;24.03.2015;2015;03;19;Tiistai;0;8;8;0;5;5
109;24.03.2015;2015;03;20;Tiistai;2;6;8;0;4;4
109;24.03.2015;2015;03;21;Tiistai;3;6;9;0;2;2
109;24.03.2015;2015;03;22;Tiistai;1;3;4;0;1;1
109;24.03.2015;2015;03;23;Tiistai;0;1;1;0;1;1
109;25.03.2015;2015;03;00;Keskiviikko;0;0;0;0;0;0
109;25.03.2015;2015;03;01;Keskiviikko;0;0;0;0;0;0
109;25.03.2015;2015;03;02;Keskiviikko;0;0;0;0;0;0
109;25.03.2015;2015;03;03;Keskiviikko;1;0;1;0;0;0
109;25.03.2015;2015;03;04;Keskiviikko;0;2;2;0;0;0
109;25.03.2015;2015;03;05;Keskiviikko;0;4;4;2;0;2
109;25.03.2015;2015;03;06;Keskiviikko;4;16;20;1;3;4
109;25.03.2015;2015;03;07;Keskiviikko;17;29;46;1;16;17
109;25.03.2015;2015;03;08;Keskiviikko;11;45;56;4;6;10
109;25.03.2015;2015;03;09;Keskiviikko;7;14;21;2;6;8
109;25.03.2015;2015;03;10;Keskiviikko;5;8;13;2;1;3
109;25.03.2015;2015;03;11;Keskiviikko;6;6;12;2;5;7
109;25.03.2015;2015;03;12;Keskiviikko;5;6;11;3;3;6
109;25.03.2015;2015;03;13;Keskiviikko;11;4;15;1;7;8
109;25.03.2015;2015;03;14;Keskiviikko;19;8;27;5;3;8
109;25.03.2015;2015;03;15;Keskiviikko;14;17;31;7;6;13
109;25.03.2015;2015;03;16;Keskiviikko;20;38;58;8;11;19
109;25.03.2015;2015;03;17;Keskiviikko;13;28;41;4;10;14
109;25.03.2015;2015;03;18;Keskiviikko;9;15;24;2;7;9
109;25.03.2015;2015;03;19;Keskiviikko;4;6;10;0;6;6
109;25.03.2015;2015;03;20;Keskiviikko;3;1;4;3;2;5
109;25.03.2015;2015;03;21;Keskiviikko;5;6;11;3;4;7
109;25.03.2015;2015;03;22;Keskiviikko;2;4;6;1;0;1
109;25.03.2015;2015;03;23;Keskiviikko;0;2;2;0;0;0
109;26.03.2015;2015;03;00;Torstai;0;0;0;0;0;0
109;26.03.2015;2015;03;01;Torstai;1;0;1;1;1;2
109;26.03.2015;2015;03;02;Torstai;0;0;0;0;0;0
109;26.03.2015;2015;03;03;Torstai;0;0;0;0;0;0
109;26.03.2015;2015;03;04;Torstai;0;1;1;0;0;0
109;26.03.2015;2015;03;05;Torstai;0;3;3;0;0;0
109;26.03.2015;2015;03;06;Torstai;1;23;24;2;4;6
109;26.03.2015;2015;03;07;Torstai;20;39;59;3;7;10
109;26.03.2015;2015;03;08;Torstai;15;46;61;2;3;5
109;26.03.2015;2015;03;09;Torstai;5;7;12;5;5;10
109;26.03.2015;2015;03;10;Torstai;3;7;10;1;4;5
109;26.03.2015;2015;03;11;Torstai;5;11;16;2;8;10
109;26.03.2015;2015;03;12;Torstai;8;8;16;4;11;15
109;26.03.2015;2015;03;13;Torstai;8;8;16;2;5;7
109;26.03.2015;2015;03;14;Torstai;17;12;29;5;4;9
109;26.03.2015;2015;03;15;Torstai;19;20;39;6;13;19
109;26.03.2015;2015;03;16;Torstai;28;32;60;7;0;7
109;26.03.2015;2015;03;17;Torstai;14;22;36;3;13;16
109;26.03.2015;2015;03;18;Torstai;4;12;16;4;10;14
109;26.03.2015;2015;03;19;Torstai;2;7;9;5;8;13
109;26.03.2015;2015;03;20;Torstai;4;5;9;0;0;0
109;26.03.2015;2015;03;21;Torstai;3;8;11;1;2;3
109;26.03.2015;2015;03;22;Torstai;1;6;7;0;3;3
109;26.03.2015;2015;03;23;Torstai;1;1;2;0;0;0
109;27.03.2015;2015;03;00;Perjantai;3;0;3;0;0;0
109;27.03.2015;2015;03;01;Perjantai;0;0;0;0;0;0
109;27.03.2015;2015;03;02;Perjantai;1;0;1;0;0;0
109;27.03.2015;2015;03;03;Perjantai;0;0;0;0;0;0
109;27.03.2015;2015;03;04;Perjantai;0;3;3;1;0;1
109;27.03.2015;2015;03;05;Perjantai;0;4;4;0;1;1
109;27.03.2015;2015;03;06;Perjantai;1;16;17;3;4;7
109;27.03.2015;2015;03;07;Perjantai;15;43;58;7;9;16
109;27.03.2015;2015;03;08;Perjantai;11;38;49;1;2;3
109;27.03.2015;2015;03;09;Perjantai;3;7;10;2;2;4
109;27.03.2015;2015;03;10;Perjantai;2;5;7;2;9;11
109;27.03.2015;2015;03;11;Perjantai;1;10;11;3;3;6
109;27.03.2015;2015;03;12;Perjantai;10;7;17;2;2;4
109;27.03.2015;2015;03;13;Perjantai;13;3;16;8;9;17
109;27.03.2015;2015;03;14;Perjantai;17;20;37;5;5;10
109;27.03.2015;2015;03;15;Perjantai;19;22;41;5;10;15
109;27.03.2015;2015;03;16;Perjantai;17;31;48;5;4;9
109;27.03.2015;2015;03;17;Perjantai;8;20;28;4;6;10
109;27.03.2015;2015;03;18;Perjantai;10;13;23;4;9;13
109;27.03.2015;2015;03;19;Perjantai;6;7;13;2;6;8
109;27.03.2015;2015;03;20;Perjantai;1;13;14;1;3;4
109;27.03.2015;2015;03;21;Perjantai;2;2;4;2;3;5
109;27.03.2015;2015;03;22;Perjantai;1;5;6;1;1;2
109;27.03.2015;2015;03;23;Perjantai;0;2;2;0;1;1
109;28.03.2015;2015;03;00;Lauantai;2;0;2;0;0;0
109;28.03.2015;2015;03;01;Lauantai;2;0;2;0;0;0
109;28.03.2015;2015;03;02;Lauantai;1;0;1;0;0;0
109;28.03.2015;2015;03;03;Lauantai;1;1;2;0;0;0
109;28.03.2015;2015;03;04;Lauantai;0;0;0;1;0;1
109;28.03.2015;2015;03;05;Lauantai;3;0;3;1;1;2
109;28.03.2015;2015;03;06;Lauantai;1;5;6;5;4;9
109;28.03.2015;2015;03;07;Lauantai;1;2;3;1;0;1
109;28.03.2015;2015;03;08;Lauantai;0;3;3;1;3;4
109;28.03.2015;2015;03;09;Lauantai;2;2;4;1;4;5
109;28.03.2015;2015;03;10;Lauantai;0;4;4;2;7;9
109;28.03.2015;2015;03;11;Lauantai;2;2;4;2;5;7
109;28.03.2015;2015;03;12;Lauantai;0;6;6;0;2;2
109;28.03.2015;2015;03;13;Lauantai;1;3;4;1;2;3
109;28.03.2015;2015;03;14;Lauantai;2;2;4;0;2;2
109;28.03.2015;2015;03;15;Lauantai;3;10;13;1;3;4
109;28.03.2015;2015;03;16;Lauantai;2;1;3;1;7;8
109;28.03.2015;2015;03;17;Lauantai;3;2;5;1;3;4
109;28.03.2015;2015;03;18;Lauantai;1;7;8;1;2;3
109;28.03.2015;2015;03;19;Lauantai;1;5;6;3;4;7
109;28.03.2015;2015;03;20;Lauantai;2;3;5;6;4;10
109;28.03.2015;2015;03;21;Lauantai;1;6;7;1;2;3
109;28.03.2015;2015;03;22;Lauantai;0;2;2;0;0;0
109;28.03.2015;2015;03;23;Lauantai;0;1;1;1;1;2
109;29.03.2015;2015;03;00;Sunnuntai;0;3;3;1;1;2
109;29.03.2015;2015;03;01;Sunnuntai;0;0;0;0;0;0
109;29.03.2015;2015;03;02;Sunnuntai;0;0;0;0;0;0
109;29.03.2015;2015;03;03;Sunnuntai;1;1;2;0;0;0
109;29.03.2015;2015;03;04;Sunnuntai;1;0;1;0;0;0
109;29.03.2015;2015;03;05;Sunnuntai;0;2;2;0;1;1
109;29.03.2015;2015;03;06;Sunnuntai;1;3;4;3;0;3
109;29.03.2015;2015;03;07;Sunnuntai;2;0;2;0;3;3
109;29.03.2015;2015;03;08;Sunnuntai;0;0;0;1;1;2
109;29.03.2015;2015;03;09;Sunnuntai;0;1;1;3;4;7
109;29.03.2015;2015;03;10;Sunnuntai;0;2;2;3;6;9
109;29.03.2015;2015;03;11;Sunnuntai;0;2;2;2;8;10
109;29.03.2015;2015;03;12;Sunnuntai;1;8;9;3;17;20
109;29.03.2015;2015;03;13;Sunnuntai;6;8;14;1;9;10
109;29.03.2015;2015;03;14;Sunnuntai;2;5;7;1;10;11
109;29.03.2015;2015;03;15;Sunnuntai;5;7;12;4;7;11
109;29.03.2015;2015;03;16;Sunnuntai;6;5;11;2;3;5
109;29.03.2015;2015;03;17;Sunnuntai;4;9;13;7;9;16
109;29.03.2015;2015;03;18;Sunnuntai;3;3;6;5;6;11
109;29.03.2015;2015;03;19;Sunnuntai;3;3;6;8;10;18
109;29.03.2015;2015;03;20;Sunnuntai;5;5;10;0;4;4
109;29.03.2015;2015;03;21;Sunnuntai;4;7;11;2;5;7
109;29.03.2015;2015;03;22;Sunnuntai;1;0;1;1;5;6
109;29.03.2015;2015;03;23;Sunnuntai;0;0;0;0;2;2
109;30.03.2015;2015;03;00;Maanantai;0;0;0;2;2;4
109;30.03.2015;2015;03;01;Maanantai;0;0;0;1;0;1
109;30.03.2015;2015;03;02;Maanantai;0;1;1;0;0;0
109;30.03.2015;2015;03;03;Maanantai;0;0;0;0;0;0
109;30.03.2015;2015;03;04;Maanantai;0;1;1;0;0;0
109;30.03.2015;2015;03;05;Maanantai;3;2;5;0;2;2
109;30.03.2015;2015;03;06;Maanantai;1;12;13;1;0;1
109;30.03.2015;2015;03;07;Maanantai;6;40;46;1;10;11
109;30.03.2015;2015;03;08;Maanantai;4;40;44;1;11;12
109;30.03.2015;2015;03;09;Maanantai;0;11;11;1;4;5
109;30.03.2015;2015;03;10;Maanantai;5;4;9;0;3;3
109;30.03.2015;2015;03;11;Maanantai;2;11;13;3;7;10
109;30.03.2015;2015;03;12;Maanantai;5;11;16;1;2;3
109;30.03.2015;2015;03;13;Maanantai;5;6;11;1;3;4
109;30.03.2015;2015;03;14;Maanantai;11;13;24;4;6;10
109;30.03.2015;2015;03;15;Maanantai;14;13;27;3;10;13
109;30.03.2015;2015;03;16;Maanantai;24;26;50;8;6;14
109;30.03.2015;2015;03;17;Maanantai;14;17;31;2;9;11
109;30.03.2015;2015;03;18;Maanantai;7;12;19;3;6;9
109;30.03.2015;2015;03;19;Maanantai;3;7;10;6;2;8
109;30.03.2015;2015;03;20;Maanantai;3;7;10;1;8;9
109;30.03.2015;2015;03;21;Maanantai;0;3;3;1;2;3
109;30.03.2015;2015;03;22;Maanantai;0;3;3;0;1;1
109;30.03.2015;2015;03;23;Maanantai;0;2;2;0;1;1
109;31.03.2015;2015;03;00;Tiistai;1;0;1;1;0;1
109;31.03.2015;2015;03;01;Tiistai;0;0;0;0;0;0
109;31.03.2015;2015;03;02;Tiistai;0;0;0;1;0;1
109;31.03.2015;2015;03;03;Tiistai;0;0;0;0;0;0
109;31.03.2015;2015;03;04;Tiistai;0;0;0;0;0;0
109;31.03.2015;2015;03;05;Tiistai;2;1;3;0;0;0
109;31.03.2015;2015;03;06;Tiistai;10;8;18;0;0;0
109;31.03.2015;2015;03;07;Tiistai;26;25;51;0;0;0
109;31.03.2015;2015;03;08;Tiistai;23;22;45;0;0;0
109;31.03.2015;2015;03;09;Tiistai;6;4;10;0;0;0
109;31.03.2015;2015;03;10;Tiistai;9;6;15;0;0;0
109;31.03.2015;2015;03;11;Tiistai;6;2;8;2;1;3
109;31.03.2015;2015;03;12;Tiistai;2;7;9;1;9;10
109;31.03.2015;2015;03;13;Tiistai;7;10;17;3;3;6
109;31.03.2015;2015;03;14;Tiistai;6;9;15;2;7;9
109;31.03.2015;2015;03;15;Tiistai;15;20;35;4;10;14
109;31.03.2015;2015;03;16;Tiistai;28;21;49;4;11;15
109;31.03.2015;2015;03;17;Tiistai;16;15;31;2;5;7
109;31.03.2015;2015;03;18;Tiistai;7;10;17;3;7;10
109;31.03.2015;2015;03;19;Tiistai;5;5;10;6;5;11
109;31.03.2015;2015;03;20;Tiistai;4;11;15;1;6;7
109;31.03.2015;2015;03;21;Tiistai;6;3;9;2;3;5
109;31.03.2015;2015;03;22;Tiistai;0;10;10;0;1;1
109;31.03.2015;2015;03;23;Tiistai;0;1;1;0;0;0
109;01.04.2015;2015;04;00;Keskiviikko;0;0;0;0;0;0
109;01.04.2015;2015;04;01;Keskiviikko;1;0;1;2;0;2
109;01.04.2015;2015;04;02;Keskiviikko;0;0;0;0;0;0
109;01.04.2015;2015;04;03;Keskiviikko;0;1;1;0;0;0
109;01.04.2015;2015;04;04;Keskiviikko;0;0;0;0;0;0
109;01.04.2015;2015;04;05;Keskiviikko;5;2;7;1;0;1
109;01.04.2015;2015;04;06;Keskiviikko;1;10;11;5;2;7
109;01.04.2015;2015;04;07;Keskiviikko;16;46;62;2;7;9
109;01.04.2015;2015;04;08;Keskiviikko;13;37;50;2;5;7
109;01.04.2015;2015;04;09;Keskiviikko;6;17;23;2;6;8
109;01.04.2015;2015;04;10;Keskiviikko;4;10;14;2;7;9
109;01.04.2015;2015;04;11;Keskiviikko;7;16;23;3;7;10
109;01.04.2015;2015;04;12;Keskiviikko;8;8;16;4;6;10
109;01.04.2015;2015;04;13;Keskiviikko;13;7;20;3;7;10
109;01.04.2015;2015;04;14;Keskiviikko;13;14;27;4;4;8
109;01.04.2015;2015;04;15;Keskiviikko;19;20;39;2;10;12
109;01.04.2015;2015;04;16;Keskiviikko;39;31;70;6;7;13
109;01.04.2015;2015;04;17;Keskiviikko;16;23;39;5;9;14
109;01.04.2015;2015;04;18;Keskiviikko;8;12;20;1;15;16
109;01.04.2015;2015;04;19;Keskiviikko;4;7;11;7;6;13
109;01.04.2015;2015;04;20;Keskiviikko;5;1;6;3;6;9
109;01.04.2015;2015;04;21;Keskiviikko;8;4;12;1;2;3
109;01.04.2015;2015;04;22;Keskiviikko;1;7;8;1;1;2
109;01.04.2015;2015;04;23;Keskiviikko;3;4;7;1;3;4
109;02.04.2015;2015;04;00;Torstai;1;0;1;0;0;0
109;02.04.2015;2015;04;01;Torstai;0;0;0;0;0;0
109;02.04.2015;2015;04;02;Torstai;1;0;1;0;0;0
109;02.04.2015;2015;04;03;Torstai;0;1;1;0;0;0
109;02.04.2015;2015;04;04;Torstai;1;0;1;0;0;0
109;02.04.2015;2015;04;05;Torstai;4;2;6;0;1;1
109;02.04.2015;2015;04;06;Torstai;3;17;20;3;2;5
109;02.04.2015;2015;04;07;Torstai;13;38;51;2;6;8
109;02.04.2015;2015;04;08;Torstai;6;42;48;4;8;12
109;02.04.2015;2015;04;09;Torstai;7;13;20;2;3;5
109;02.04.2015;2015;04;10;Torstai;5;11;16;1;3;4
109;02.04.2015;2015;04;11;Torstai;6;20;26;4;7;11
109;02.04.2015;2015;04;12;Torstai;9;9;18;2;10;12
109;02.04.2015;2015;04;13;Torstai;15;21;36;4;10;14
109;02.04.2015;2015;04;14;Torstai;20;16;36;2;7;9
109;02.04.2015;2015;04;15;Torstai;12;29;41;6;6;12
109;02.04.2015;2015;04;16;Torstai;19;28;47;2;5;7
109;02.04.2015;2015;04;17;Torstai;8;21;29;4;4;8
109;02.04.2015;2015;04;18;Torstai;8;10;18;3;4;7
109;02.04.2015;2015;04;19;Torstai;2;5;7;4;7;11
109;02.04.2015;2015;04;20;Torstai;8;4;12;4;3;7
109;02.04.2015;2015;04;21;Torstai;4;7;11;0;5;5
109;02.04.2015;2015;04;22;Torstai;0;3;3;1;3;4
109;02.04.2015;2015;04;23;Torstai;1;1;2;0;0;0
109;03.04.2015;2015;04;00;Perjantai;0;1;1;1;3;4
109;03.04.2015;2015;04;01;Perjantai;2;1;3;0;1;1
109;03.04.2015;2015;04;02;Perjantai;2;0;2;0;1;1
109;03.04.2015;2015;04;03;Perjantai;1;0;1;0;0;0
109;03.04.2015;2015;04;04;Perjantai;0;1;1;0;0;0
109;03.04.2015;2015;04;05;Perjantai;0;0;0;1;0;1
109;03.04.2015;2015;04;06;Perjantai;0;2;2;2;2;4
109;03.04.2015;2015;04;07;Perjantai;2;1;3;0;6;6
109;03.04.2015;2015;04;08;Perjantai;1;2;3;1;2;3
109;03.04.2015;2015;04;09;Perjantai;2;3;5;3;5;8
109;03.04.2015;2015;04;10;Perjantai;2;3;5;2;7;9
109;03.04.2015;2015;04;11;Perjantai;4;4;8;4;13;17
109;03.04.2015;2015;04;12;Perjantai;3;9;12;2;8;10
109;03.04.2015;2015;04;13;Perjantai;3;5;8;4;11;15
109;03.04.2015;2015;04;14;Perjantai;0;4;4;2;15;17
109;03.04.2015;2015;04;15;Perjantai;8;10;18;5;8;13
109;03.04.2015;2015;04;16;Perjantai;5;9;14;4;8;12
109;03.04.2015;2015;04;17;Perjantai;9;8;17;6;6;12
109;03.04.2015;2015;04;18;Perjantai;3;5;8;2;7;9
109;03.04.2015;2015;04;19;Perjantai;4;6;10;3;2;5
109;03.04.2015;2015;04;20;Perjantai;3;3;6;3;4;7
109;03.04.2015;2015;04;21;Perjantai;1;2;3;2;3;5
109;03.04.2015;2015;04;22;Perjantai;1;0;1;0;2;2
109;03.04.2015;2015;04;23;Perjantai;0;0;0;1;1;2
109;04.04.2015;2015;04;00;Lauantai;1;2;3;1;0;1
109;04.04.2015;2015;04;01;Lauantai;0;0;0;0;1;1
109;04.04.2015;2015;04;02;Lauantai;0;0;0;2;0;2
109;04.04.2015;2015;04;03;Lauantai;1;0;1;0;0;0
109;04.04.2015;2015;04;04;Lauantai;2;0;2;0;0;0
109;04.04.2015;2015;04;05;Lauantai;0;0;0;0;0;0
109;04.04.2015;2015;04;06;Lauantai;0;4;4;1;1;2
109;04.04.2015;2015;04;07;Lauantai;1;1;2;1;1;2
109;04.04.2015;2015;04;08;Lauantai;2;2;4;1;7;8
109;04.04.2015;2015;04;09;Lauantai;1;6;7;3;4;7
109;04.04.2015;2015;04;10;Lauantai;0;3;3;4;2;6
109;04.04.2015;2015;04;11;Lauantai;2;11;13;1;3;4
109;04.04.2015;2015;04;12;Lauantai;5;8;13;2;3;5
109;04.04.2015;2015;04;13;Lauantai;5;13;18;1;6;7
109;04.04.2015;2015;04;14;Lauantai;2;13;15;8;4;12
109;04.04.2015;2015;04;15;Lauantai;5;5;10;3;6;9
109;04.04.2015;2015;04;16;Lauantai;4;8;12;0;5;5
109;04.04.2015;2015;04;17;Lauantai;6;15;21;3;9;12
109;04.04.2015;2015;04;18;Lauantai;4;3;7;2;4;6
109;04.04.2015;2015;04;19;Lauantai;7;6;13;2;9;11
109;04.04.2015;2015;04;20;Lauantai;1;6;7;3;2;5
109;04.04.2015;2015;04;21;Lauantai;6;4;10;2;1;3
109;04.04.2015;2015;04;22;Lauantai;0;5;5;0;0;0
109;04.04.2015;2015;04;23;Lauantai;1;2;3;1;1;2
109;05.04.2015;2015;04;00;Sunnuntai;2;1;3;1;0;1
109;05.04.2015;2015;04;01;Sunnuntai;1;1;2;0;0;0
109;05.04.2015;2015;04;02;Sunnuntai;0;0;0;0;0;0
109;05.04.2015;2015;04;03;Sunnuntai;2;1;3;0;0;0
109;05.04.2015;2015;04;04;Sunnuntai;0;0;0;0;0;0
109;05.04.2015;2015;04;05;Sunnuntai;0;0;0;0;0;0
109;05.04.2015;2015;04;06;Sunnuntai;0;4;4;0;2;2
109;05.04.2015;2015;04;07;Sunnuntai;1;1;2;1;4;5
109;05.04.2015;2015;04;08;Sunnuntai;0;0;0;2;9;11
109;05.04.2015;2015;04;09;Sunnuntai;0;3;3;3;6;9
109;05.04.2015;2015;04;10;Sunnuntai;5;4;9;2;4;6
109;05.04.2015;2015;04;11;Sunnuntai;2;14;16;6;17;23
109;05.04.2015;2015;04;12;Sunnuntai;6;5;11;5;10;15
109;05.04.2015;2015;04;13;Sunnuntai;7;16;23;6;12;18
109;05.04.2015;2015;04;14;Sunnuntai;5;7;12;1;7;8
109;05.04.2015;2015;04;15;Sunnuntai;3;11;14;5;7;12
109;05.04.2015;2015;04;16;Sunnuntai;6;13;19;5;8;13
109;05.04.2015;2015;04;17;Sunnuntai;4;16;20;2;8;10
109;05.04.2015;2015;04;18;Sunnuntai;4;12;16;1;7;8
109;05.04.2015;2015;04;19;Sunnuntai;5;13;18;2;6;8
109;05.04.2015;2015;04;20;Sunnuntai;3;2;5;3;5;8
109;05.04.2015;2015;04;21;Sunnuntai;4;4;8;3;3;6
109;05.04.2015;2015;04;22;Sunnuntai;0;1;1;2;1;3
109;05.04.2015;2015;04;23;Sunnuntai;0;0;0;1;0;1
109;06.04.2015;2015;04;00;Maanantai;0;2;2;1;0;1
109;06.04.2015;2015;04;01;Maanantai;0;0;0;0;1;1
109;06.04.2015;2015;04;02;Maanantai;0;0;0;0;0;0
109;06.04.2015;2015;04;03;Maanantai;2;0;2;0;0;0
109;06.04.2015;2015;04;04;Maanantai;1;0;1;0;0;0
109;06.04.2015;2015;04;05;Maanantai;1;1;2;0;0;0
109;06.04.2015;2015;04;06;Maanantai;0;3;3;0;0;0
109;06.04.2015;2015;04;07;Maanantai;0;6;6;3;3;6
109;06.04.2015;2015;04;08;Maanantai;0;4;4;1;7;8
109;06.04.2015;2015;04;09;Maanantai;0;3;3;3;8;11
109;06.04.2015;2015;04;10;Maanantai;6;6;12;3;5;8
109;06.04.2015;2015;04;11;Maanantai;5;9;14;5;8;13
109;06.04.2015;2015;04;12;Maanantai;2;8;10;3;4;7
109;06.04.2015;2015;04;13;Maanantai;3;7;10;3;12;15
109;06.04.2015;2015;04;14;Maanantai;5;9;14;4;6;10
109;06.04.2015;2015;04;15;Maanantai;2;6;8;5;3;8
109;06.04.2015;2015;04;16;Maanantai;12;2;14;2;7;9
109;06.04.2015;2015;04;17;Maanantai;4;11;15;2;5;7
109;06.04.2015;2015;04;18;Maanantai;6;8;14;4;3;7
109;06.04.2015;2015;04;19;Maanantai;2;0;2;1;6;7
109;06.04.2015;2015;04;20;Maanantai;3;2;5;6;5;11
109;06.04.2015;2015;04;21;Maanantai;7;5;12;0;1;1
109;06.04.2015;2015;04;22;Maanantai;1;1;2;1;1;2
109;06.04.2015;2015;04;23;Maanantai;1;0;1;0;0;0
109;07.04.2015;2015;04;00;Tiistai;0;0;0;0;0;0
109;07.04.2015;2015;04;01;Tiistai;0;0;0;1;0;1
109;07.04.2015;2015;04;02;Tiistai;0;0;0;0;0;0
109;07.04.2015;2015;04;03;Tiistai;0;2;2;0;0;0
109;07.04.2015;2015;04;04;Tiistai;1;1;2;0;0;0
109;07.04.2015;2015;04;05;Tiistai;4;5;9;4;3;7
109;07.04.2015;2015;04;06;Tiistai;6;19;25;2;1;3
109;07.04.2015;2015;04;07;Tiistai;16;56;72;4;13;17
109;07.04.2015;2015;04;08;Tiistai;12;58;70;5;4;9
109;07.04.2015;2015;04;09;Tiistai;4;12;16;6;5;11
109;07.04.2015;2015;04;10;Tiistai;5;9;14;2;5;7
109;07.04.2015;2015;04;11;Tiistai;6;13;19;3;3;6
109;07.04.2015;2015;04;12;Tiistai;4;16;20;1;2;3
109;07.04.2015;2015;04;13;Tiistai;5;8;13;2;4;6
109;07.04.2015;2015;04;14;Tiistai;9;18;27;3;3;6
109;07.04.2015;2015;04;15;Tiistai;16;25;41;2;6;8
109;07.04.2015;2015;04;16;Tiistai;44;42;86;7;9;16
109;07.04.2015;2015;04;17;Tiistai;19;18;37;5;7;12
109;07.04.2015;2015;04;18;Tiistai;11;23;34;2;9;11
109;07.04.2015;2015;04;19;Tiistai;9;15;24;4;9;13
109;07.04.2015;2015;04;20;Tiistai;8;13;21;2;6;8
109;07.04.2015;2015;04;21;Tiistai;9;3;12;1;3;4
109;07.04.2015;2015;04;22;Tiistai;2;4;6;2;5;7
109;07.04.2015;2015;04;23;Tiistai;1;1;2;0;0;0
109;08.04.2015;2015;04;00;Keskiviikko;0;0;0;0;0;0
109;08.04.2015;2015;04;01;Keskiviikko;0;0;0;1;0;1
109;08.04.2015;2015;04;02;Keskiviikko;0;0;0;0;0;0
109;08.04.2015;2015;04;03;Keskiviikko;0;0;0;0;0;0
109;08.04.2015;2015;04;04;Keskiviikko;0;0;0;0;2;2
109;08.04.2015;2015;04;05;Keskiviikko;3;3;6;2;0;2
109;08.04.2015;2015;04;06;Keskiviikko;7;16;23;2;1;3
109;08.04.2015;2015;04;07;Keskiviikko;17;53;70;1;9;10
109;08.04.2015;2015;04;08;Keskiviikko;12;53;65;1;4;5
109;08.04.2015;2015;04;09;Keskiviikko;7;21;28;6;5;11
109;08.04.2015;2015;04;10;Keskiviikko;3;15;18;0;5;5
109;08.04.2015;2015;04;11;Keskiviikko;6;12;18;4;3;7
109;08.04.2015;2015;04;12;Keskiviikko;7;11;18;0;1;1
109;08.04.2015;2015;04;13;Keskiviikko;7;15;22;4;5;9
109;08.04.2015;2015;04;14;Keskiviikko;15;13;28;0;4;4
109;08.04.2015;2015;04;15;Keskiviikko;23;20;43;3;5;8
109;08.04.2015;2015;04;16;Keskiviikko;37;59;96;6;10;16
109;08.04.2015;2015;04;17;Keskiviikko;12;23;35;2;8;10
109;08.04.2015;2015;04;18;Keskiviikko;9;13;22;1;5;6
109;08.04.2015;2015;04;19;Keskiviikko;3;6;9;3;5;8
109;08.04.2015;2015;04;20;Keskiviikko;5;10;15;1;5;6
109;08.04.2015;2015;04;21;Keskiviikko;3;6;9;1;5;6
109;08.04.2015;2015;04;22;Keskiviikko;2;6;8;1;1;2
109;08.04.2015;2015;04;23;Keskiviikko;0;0;0;0;0;0
109;09.04.2015;2015;04;00;Torstai;0;0;0;0;0;0
109;09.04.2015;2015;04;01;Torstai;0;0;0;0;0;0
109;09.04.2015;2015;04;02;Torstai;0;0;0;0;0;0
109;09.04.2015;2015;04;03;Torstai;0;0;0;0;0;0
109;09.04.2015;2015;04;04;Torstai;1;1;2;0;0;0
109;09.04.2015;2015;04;05;Torstai;7;3;10;2;0;2
109;09.04.2015;2015;04;06;Torstai;5;21;26;2;2;4
109;09.04.2015;2015;04;07;Torstai;18;59;77;3;8;11
109;09.04.2015;2015;04;08;Torstai;10;49;59;2;3;5
109;09.04.2015;2015;04;09;Torstai;3;25;28;3;6;9
109;09.04.2015;2015;04;10;Torstai;7;10;17;1;5;6
109;09.04.2015;2015;04;11;Torstai;3;14;17;3;11;14
109;09.04.2015;2015;04;12;Torstai;5;13;18;2;3;5
109;09.04.2015;2015;04;13;Torstai;7;11;18;2;5;7
109;09.04.2015;2015;04;14;Torstai;15;20;35;1;6;7
109;09.04.2015;2015;04;15;Torstai;19;36;55;3;5;8
109;09.04.2015;2015;04;16;Torstai;25;38;63;3;10;13
109;09.04.2015;2015;04;17;Torstai;9;38;47;4;12;16
109;09.04.2015;2015;04;18;Torstai;7;10;17;1;8;9
109;09.04.2015;2015;04;19;Torstai;7;12;19;5;10;15
109;09.04.2015;2015;04;20;Torstai;5;9;14;3;8;11
109;09.04.2015;2015;04;21;Torstai;8;2;10;1;7;8
109;09.04.2015;2015;04;22;Torstai;3;5;8;0;0;0
109;09.04.2015;2015;04;23;Torstai;0;2;2;0;1;1
109;10.04.2015;2015;04;00;Perjantai;0;0;0;0;2;2
109;10.04.2015;2015;04;01;Perjantai;0;0;0;1;1;2
109;10.04.2015;2015;04;02;Perjantai;0;3;3;0;0;0
109;10.04.2015;2015;04;03;Perjantai;0;0;0;0;0;0
109;10.04.2015;2015;04;04;Perjantai;0;3;3;0;1;1
109;10.04.2015;2015;04;05;Perjantai;8;2;10;2;0;2
109;10.04.2015;2015;04;06;Perjantai;3;16;19;2;5;7
109;10.04.2015;2015;04;07;Perjantai;19;52;71;3;4;7
109;10.04.2015;2015;04;08;Perjantai;14;39;53;1;5;6
109;10.04.2015;2015;04;09;Perjantai;3;23;26;2;7;9
109;10.04.2015;2015;04;10;Perjantai;3;11;14;3;4;7
109;10.04.2015;2015;04;11;Perjantai;6;9;15;1;1;2
109;10.04.2015;2015;04;12;Perjantai;8;16;24;4;5;9
109;10.04.2015;2015;04;13;Perjantai;12;9;21;2;2;4
109;10.04.2015;2015;04;14;Perjantai;20;6;26;1;2;3
109;10.04.2015;2015;04;15;Perjantai;21;27;48;1;5;6
109;10.04.2015;2015;04;16;Perjantai;23;19;42;5;4;9
109;10.04.2015;2015;04;17;Perjantai;8;20;28;4;3;7
109;10.04.2015;2015;04;18;Perjantai;2;14;16;3;4;7
109;10.04.2015;2015;04;19;Perjantai;6;14;20;1;5;6
109;10.04.2015;2015;04;20;Perjantai;1;8;9;7;3;10
109;10.04.2015;2015;04;21;Perjantai;3;6;9;1;7;8
109;10.04.2015;2015;04;22;Perjantai;2;6;8;0;2;2
109;10.04.2015;2015;04;23;Perjantai;0;2;2;0;0;0
109;11.04.2015;2015;04;00;Lauantai;2;2;4;0;0;0
109;11.04.2015;2015;04;01;Lauantai;1;0;1;0;0;0
109;11.04.2015;2015;04;02;Lauantai;3;2;5;0;0;0
109;11.04.2015;2015;04;03;Lauantai;0;0;0;0;0;0
109;11.04.2015;2015;04;04;Lauantai;1;0;1;0;0;0
109;11.04.2015;2015;04;05;Lauantai;1;2;3;0;0;0
109;11.04.2015;2015;04;06;Lauantai;1;6;7;0;2;2
109;11.04.2015;2015;04;07;Lauantai;1;2;3;1;0;1
109;11.04.2015;2015;04;08;Lauantai;2;6;8;1;9;10
109;11.04.2015;2015;04;09;Lauantai;3;7;10;2;5;7
109;11.04.2015;2015;04;10;Lauantai;2;11;13;2;6;8
109;11.04.2015;2015;04;11;Lauantai;4;14;18;1;9;10
109;11.04.2015;2015;04;12;Lauantai;5;13;18;3;16;19
109;11.04.2015;2015;04;13;Lauantai;8;28;36;0;8;8
109;11.04.2015;2015;04;14;Lauantai;5;18;23;6;5;11
109;11.04.2015;2015;04;15;Lauantai;16;14;30;2;13;15
109;11.04.2015;2015;04;16;Lauantai;22;12;34;3;12;15
109;11.04.2015;2015;04;17;Lauantai;18;9;27;4;5;9
109;11.04.2015;2015;04;18;Lauantai;9;6;15;4;7;11
109;11.04.2015;2015;04;19;Lauantai;2;15;17;4;8;12
109;11.04.2015;2015;04;20;Lauantai;3;19;22;5;2;7
109;11.04.2015;2015;04;21;Lauantai;2;10;12;2;3;5
109;11.04.2015;2015;04;22;Lauantai;0;2;2;0;1;1
109;11.04.2015;2015;04;23;Lauantai;4;2;6;0;1;1
109;12.04.2015;2015;04;00;Sunnuntai;0;1;1;2;0;2
109;12.04.2015;2015;04;01;Sunnuntai;0;0;0;0;0;0
109;12.04.2015;2015;04;02;Sunnuntai;3;1;4;0;1;1
109;12.04.2015;2015;04;03;Sunnuntai;1;1;2;0;0;0
109;12.04.2015;2015;04;04;Sunnuntai;1;1;2;0;0;0
109;12.04.2015;2015;04;05;Sunnuntai;0;1;1;0;0;0
109;12.04.2015;2015;04;06;Sunnuntai;0;4;4;1;1;2
109;12.04.2015;2015;04;07;Sunnuntai;1;5;6;2;5;7
109;12.04.2015;2015;04;08;Sunnuntai;2;3;5;0;11;11
109;12.04.2015;2015;04;09;Sunnuntai;3;9;12;4;4;8
109;12.04.2015;2015;04;10;Sunnuntai;2;15;17;2;5;7
109;12.04.2015;2015;04;11;Sunnuntai;10;29;39;10;12;22
109;12.04.2015;2015;04;12;Sunnuntai;7;28;35;6;11;17
109;12.04.2015;2015;04;13;Sunnuntai;19;45;64;9;14;23
109;12.04.2015;2015;04;14;Sunnuntai;15;15;30;3;9;12
109;12.04.2015;2015;04;15;Sunnuntai;5;11;16;6;16;22
109;12.04.2015;2015;04;16;Sunnuntai;6;23;29;5;4;9
109;12.04.2015;2015;04;17;Sunnuntai;7;15;22;7;11;18
109;12.04.2015;2015;04;18;Sunnuntai;3;20;23;3;14;17
109;12.04.2015;2015;04;19;Sunnuntai;9;25;34;9;11;20
109;12.04.2015;2015;04;20;Sunnuntai;2;13;15;3;6;9
109;12.04.2015;2015;04;21;Sunnuntai;2;9;11;3;6;9
109;12.04.2015;2015;04;22;Sunnuntai;2;0;2;0;1;1
109;12.04.2015;2015;04;23;Sunnuntai;1;0;1;0;2;2
109;13.04.2015;2015;04;00;Maanantai;0;0;0;1;1;2
109;13.04.2015;2015;04;01;Maanantai;0;0;0;0;1;1
109;13.04.2015;2015;04;02;Maanantai;0;1;1;0;0;0
109;13.04.2015;2015;04;03;Maanantai;0;0;0;0;0;0
109;13.04.2015;2015;04;04;Maanantai;0;0;0;0;0;0
109;13.04.2015;2015;04;05;Maanantai;2;4;6;1;0;1
109;13.04.2015;2015;04;06;Maanantai;7;21;28;2;3;5
109;13.04.2015;2015;04;07;Maanantai;19;75;94;3;8;11
109;13.04.2015;2015;04;08;Maanantai;13;66;79;2;5;7
109;13.04.2015;2015;04;09;Maanantai;3;24;27;4;6;10
109;13.04.2015;2015;04;10;Maanantai;4;14;18;0;1;1
109;13.04.2015;2015;04;11;Maanantai;5;11;16;1;5;6
109;13.04.2015;2015;04;12;Maanantai;6;13;19;4;4;8
109;13.04.2015;2015;04;13;Maanantai;9;14;23;1;4;5
109;13.04.2015;2015;04;14;Maanantai;10;19;29;5;2;7
109;13.04.2015;2015;04;15;Maanantai;23;37;60;3;5;8
109;13.04.2015;2015;04;16;Maanantai;37;49;86;8;8;16
109;13.04.2015;2015;04;17;Maanantai;19;32;51;2;5;7
109;13.04.2015;2015;04;18;Maanantai;12;15;27;2;10;12
109;13.04.2015;2015;04;19;Maanantai;7;15;22;3;5;8
109;13.04.2015;2015;04;20;Maanantai;4;6;10;3;2;5
109;13.04.2015;2015;04;21;Maanantai;3;11;14;0;4;4
109;13.04.2015;2015;04;22;Maanantai;2;9;11;0;1;1
109;13.04.2015;2015;04;23;Maanantai;0;2;2;0;1;1
109;14.04.2015;2015;04;00;Tiistai;1;1;2;0;0;0
109;14.04.2015;2015;04;01;Tiistai;1;0;1;2;0;2
109;14.04.2015;2015;04;02;Tiistai;0;0;0;0;0;0
109;14.04.2015;2015;04;03;Tiistai;1;1;2;0;0;0
109;14.04.2015;2015;04;04;Tiistai;0;1;1;0;0;0
109;14.04.2015;2015;04;05;Tiistai;4;5;9;0;1;1
109;14.04.2015;2015;04;06;Tiistai;4;31;35;1;3;4
109;14.04.2015;2015;04;07;Tiistai;20;82;102;3;8;11
109;14.04.2015;2015;04;08;Tiistai;15;71;86;3;6;9
109;14.04.2015;2015;04;09;Tiistai;5;19;24;0;5;5
109;14.04.2015;2015;04;10;Tiistai;3;11;14;0;4;4
109;14.04.2015;2015;04;11;Tiistai;6;15;21;3;7;10
109;14.04.2015;2015;04;12;Tiistai;8;23;31;0;4;4
109;14.04.2015;2015;04;13;Tiistai;11;14;25;4;5;9
109;14.04.2015;2015;04;14;Tiistai;12;18;30;2;2;4
109;14.04.2015;2015;04;15;Tiistai;17;39;56;3;4;7
109;14.04.2015;2015;04;16;Tiistai;34;70;104;4;8;12
109;14.04.2015;2015;04;17;Tiistai;17;39;56;4;10;14
109;14.04.2015;2015;04;18;Tiistai;16;25;41;5;10;15
109;14.04.2015;2015;04;19;Tiistai;9;13;22;9;4;13
109;14.04.2015;2015;04;20;Tiistai;3;22;25;3;2;5
109;14.04.2015;2015;04;21;Tiistai;4;12;16;3;7;10
109;14.04.2015;2015;04;22;Tiistai;2;9;11;3;1;4
109;14.04.2015;2015;04;23;Tiistai;1;2;3;0;2;2
109;15.04.2015;2015;04;00;Keskiviikko;0;2;2;0;1;1
109;15.04.2015;2015;04;01;Keskiviikko;0;2;2;0;0;0
109;15.04.2015;2015;04;02;Keskiviikko;0;0;0;0;0;0
109;15.04.2015;2015;04;03;Keskiviikko;0;0;0;0;0;0
109;15.04.2015;2015;04;04;Keskiviikko;0;1;1;0;0;0
109;15.04.2015;2015;04;05;Keskiviikko;3;5;8;0;1;1
109;15.04.2015;2015;04;06;Keskiviikko;6;21;27;3;4;7
109;15.04.2015;2015;04;07;Keskiviikko;20;87;107;2;10;12
109;15.04.2015;2015;04;08;Keskiviikko;19;57;76;0;5;5
109;15.04.2015;2015;04;09;Keskiviikko;0;20;20;1;4;5
109;15.04.2015;2015;04;10;Keskiviikko;5;15;20;1;2;3
109;15.04.2015;2015;04;11;Keskiviikko;7;12;19;3;6;9
109;15.04.2015;2015;04;12;Keskiviikko;7;13;20;3;2;5
109;15.04.2015;2015;04;13;Keskiviikko;9;8;17;0;3;3
109;15.04.2015;2015;04;14;Keskiviikko;7;21;28;4;4;8
109;15.04.2015;2015;04;15;Keskiviikko;26;41;67;2;6;8
109;15.04.2015;2015;04;16;Keskiviikko;41;53;94;2;11;13
109;15.04.2015;2015;04;17;Keskiviikko;18;27;45;3;8;11
109;15.04.2015;2015;04;18;Keskiviikko;7;22;29;2;8;10
109;15.04.2015;2015;04;19;Keskiviikko;4;10;14;3;5;8
109;15.04.2015;2015;04;20;Keskiviikko;6;11;17;2;3;5
109;15.04.2015;2015;04;21;Keskiviikko;5;14;19;2;4;6
109;15.04.2015;2015;04;22;Keskiviikko;2;8;10;0;2;2
109;15.04.2015;2015;04;23;Keskiviikko;0;1;1;0;2;2
109;16.04.2015;2015;04;00;Torstai;1;0;1;1;0;1
109;16.04.2015;2015;04;01;Torstai;1;0;1;1;0;1
109;16.04.2015;2015;04;02;Torstai;0;0;0;0;0;0
109;16.04.2015;2015;04;03;Torstai;0;0;0;0;0;0
109;16.04.2015;2015;04;04;Torstai;0;2;2;0;0;0
109;16.04.2015;2015;04;05;Torstai;4;5;9;1;0;1
109;16.04.2015;2015;04;06;Torstai;6;17;23;3;3;6
109;16.04.2015;2015;04;07;Torstai;23;76;99;3;4;7
109;16.04.2015;2015;04;08;Torstai;10;67;77;3;3;6
109;16.04.2015;2015;04;09;Torstai;4;24;28;1;2;3
109;16.04.2015;2015;04;10;Torstai;8;8;16;3;4;7
109;16.04.2015;2015;04;11;Torstai;1;11;12;2;6;8
109;16.04.2015;2015;04;12;Torstai;6;19;25;1;5;6
109;16.04.2015;2015;04;13;Torstai;9;12;21;0;4;4
109;16.04.2015;2015;04;14;Torstai;12;19;31;4;1;5
109;16.04.2015;2015;04;15;Torstai;10;37;47;2;4;6
109;16.04.2015;2015;04;16;Torstai;25;67;92;3;8;11
109;16.04.2015;2015;04;17;Torstai;18;46;64;2;8;10
109;16.04.2015;2015;04;18;Torstai;10;18;28;3;7;10
109;16.04.2015;2015;04;19;Torstai;7;13;20;5;13;18
109;16.04.2015;2015;04;20;Torstai;10;12;22;3;4;7
109;16.04.2015;2015;04;21;Torstai;5;8;13;1;6;7
109;16.04.2015;2015;04;22;Torstai;3;7;10;1;2;3
109;16.04.2015;2015;04;23;Torstai;0;0;0;0;1;1
109;17.04.2015;2015;04;00;Perjantai;0;0;0;0;2;2
109;17.04.2015;2015;04;01;Perjantai;0;0;0;1;0;1
109;17.04.2015;2015;04;02;Perjantai;0;0;0;0;0;0
109;17.04.2015;2015;04;03;Perjantai;0;0;0;0;0;0
109;17.04.2015;2015;04;04;Perjantai;0;1;1;0;0;0
109;17.04.2015;2015;04;05;Perjantai;1;4;5;1;0;1
109;17.04.2015;2015;04;06;Perjantai;3;30;33;1;3;4
109;17.04.2015;2015;04;07;Perjantai;18;61;79;2;10;12
109;17.04.2015;2015;04;08;Perjantai;13;53;66;1;2;3
109;17.04.2015;2015;04;09;Perjantai;5;28;33;3;3;6
109;17.04.2015;2015;04;10;Perjantai;4;9;13;3;6;9
109;17.04.2015;2015;04;11;Perjantai;4;15;19;4;3;7
109;17.04.2015;2015;04;12;Perjantai;10;18;28;1;6;7
109;17.04.2015;2015;04;13;Perjantai;12;19;31;2;2;4
109;17.04.2015;2015;04;14;Perjantai;23;20;43;1;5;6
109;17.04.2015;2015;04;15;Perjantai;33;38;71;5;12;17
109;17.04.2015;2015;04;16;Perjantai;21;49;70;2;10;12
109;17.04.2015;2015;04;17;Perjantai;14;21;35;4;8;12
109;17.04.2015;2015;04;18;Perjantai;9;10;19;2;3;5
109;17.04.2015;2015;04;19;Perjantai;3;6;9;6;6;12
109;17.04.2015;2015;04;20;Perjantai;3;11;14;1;1;2
109;17.04.2015;2015;04;21;Perjantai;3;6;9;0;0;0
109;17.04.2015;2015;04;22;Perjantai;5;6;11;1;1;2
109;17.04.2015;2015;04;23;Perjantai;0;0;0;1;0;1
109;18.04.2015;2015;04;00;Lauantai;2;1;3;1;0;1
109;18.04.2015;2015;04;01;Lauantai;1;0;1;0;0;0
109;18.04.2015;2015;04;02;Lauantai;0;0;0;0;0;0
109;18.04.2015;2015;04;03;Lauantai;0;0;0;0;0;0
109;18.04.2015;2015;04;04;Lauantai;1;0;1;0;0;0
109;18.04.2015;2015;04;05;Lauantai;0;2;2;2;1;3
109;18.04.2015;2015;04;06;Lauantai;3;3;6;2;2;4
109;18.04.2015;2015;04;07;Lauantai;2;6;8;0;3;3
109;18.04.2015;2015;04;08;Lauantai;2;2;4;1;4;5
109;18.04.2015;2015;04;09;Lauantai;3;9;12;3;7;10
109;18.04.2015;2015;04;10;Lauantai;2;8;10;2;3;5
109;18.04.2015;2015;04;11;Lauantai;4;14;18;5;3;8
109;18.04.2015;2015;04;12;Lauantai;3;15;18;4;7;11
109;18.04.2015;2015;04;13;Lauantai;10;26;36;3;10;13
109;18.04.2015;2015;04;14;Lauantai;12;15;27;2;7;9
109;18.04.2015;2015;04;15;Lauantai;9;27;36;0;7;7
109;18.04.2015;2015;04;16;Lauantai;12;17;29;0;3;3
109;18.04.2015;2015;04;17;Lauantai;3;12;15;6;4;10
109;18.04.2015;2015;04;18;Lauantai;6;17;23;2;4;6
109;18.04.2015;2015;04;19;Lauantai;5;15;20;7;4;11
109;18.04.2015;2015;04;20;Lauantai;8;15;23;3;1;4
109;18.04.2015;2015;04;21;Lauantai;4;11;15;5;3;8
109;18.04.2015;2015;04;22;Lauantai;0;6;6;1;7;8
109;18.04.2015;2015;04;23;Lauantai;2;1;3;0;1;1
109;19.04.2015;2015;04;00;Sunnuntai;2;1;3;0;0;0
109;19.04.2015;2015;04;01;Sunnuntai;0;2;2;0;0;0
109;19.04.2015;2015;04;02;Sunnuntai;0;2;2;0;1;1
109;19.04.2015;2015;04;03;Sunnuntai;1;0;1;1;0;1
109;19.04.2015;2015;04;04;Sunnuntai;1;0;1;0;0;0
109;19.04.2015;2015;04;05;Sunnuntai;0;3;3;0;1;1
109;19.04.2015;2015;04;06;Sunnuntai;3;2;5;0;1;1
109;19.04.2015;2015;04;07;Sunnuntai;4;3;7;2;4;6
109;19.04.2015;2015;04;08;Sunnuntai;0;2;2;1;7;8
109;19.04.2015;2015;04;09;Sunnuntai;4;12;16;4;3;7
109;19.04.2015;2015;04;10;Sunnuntai;0;10;10;3;8;11
109;19.04.2015;2015;04;11;Sunnuntai;2;9;11;2;10;12
109;19.04.2015;2015;04;12;Sunnuntai;10;22;32;3;2;5
109;19.04.2015;2015;04;13;Sunnuntai;10;17;27;4;5;9
109;19.04.2015;2015;04;14;Sunnuntai;7;11;18;3;18;21
109;19.04.2015;2015;04;15;Sunnuntai;8;11;19;3;10;13
109;19.04.2015;2015;04;16;Sunnuntai;6;20;26;2;6;8
109;19.04.2015;2015;04;17;Sunnuntai;3;23;26;3;7;10
109;19.04.2015;2015;04;18;Sunnuntai;10;10;20;3;5;8
109;19.04.2015;2015;04;19;Sunnuntai;5;5;10;1;6;7
109;19.04.2015;2015;04;20;Sunnuntai;4;11;15;0;6;6
109;19.04.2015;2015;04;21;Sunnuntai;1;6;7;2;2;4
109;19.04.2015;2015;04;22;Sunnuntai;1;2;3;0;5;5
109;19.04.2015;2015;04;23;Sunnuntai;1;0;1;0;1;1
109;20.04.2015;2015;04;00;Maanantai;0;1;1;0;0;0
109;20.04.2015;2015;04;01;Maanantai;0;0;0;0;2;2
109;20.04.2015;2015;04;02;Maanantai;0;0;0;0;0;0
109;20.04.2015;2015;04;03;Maanantai;0;0;0;0;0;0
109;20.04.2015;2015;04;04;Maanantai;0;2;2;0;0;0
109;20.04.2015;2015;04;05;Maanantai;3;5;8;0;0;0
109;20.04.2015;2015;04;06;Maanantai;4;31;35;2;3;5
109;20.04.2015;2015;04;07;Maanantai;18;87;105;1;7;8
109;20.04.2015;2015;04;08;Maanantai;16;90;106;1;5;6
109;20.04.2015;2015;04;09;Maanantai;6;29;35;1;3;4
109;20.04.2015;2015;04;10;Maanantai;6;20;26;5;6;11
109;20.04.2015;2015;04;11;Maanantai;4;15;19;0;5;5
109;20.04.2015;2015;04;12;Maanantai;10;17;27;1;4;5
109;20.04.2015;2015;04;13;Maanantai;12;8;20;5;6;11
109;20.04.2015;2015;04;14;Maanantai;12;32;44;4;1;5
109;20.04.2015;2015;04;15;Maanantai;25;52;77;3;10;13
109;20.04.2015;2015;04;16;Maanantai;45;70;115;5;7;12
109;20.04.2015;2015;04;17;Maanantai;32;49;81;5;11;16
109;20.04.2015;2015;04;18;Maanantai;15;27;42;0;10;10
109;20.04.2015;2015;04;19;Maanantai;4;13;17;4;11;15
109;20.04.2015;2015;04;20;Maanantai;8;11;19;2;8;10
109;20.04.2015;2015;04;21;Maanantai;9;8;17;4;3;7
109;20.04.2015;2015;04;22;Maanantai;2;10;12;4;4;8
109;20.04.2015;2015;04;23;Maanantai;2;1;3;0;1;1
109;21.04.2015;2015;04;00;Tiistai;1;2;3;1;0;1
109;21.04.2015;2015;04;01;Tiistai;0;0;0;1;0;1
109;21.04.2015;2015;04;02;Tiistai;0;0;0;0;0;0
109;21.04.2015;2015;04;03;Tiistai;0;0;0;0;0;0
109;21.04.2015;2015;04;04;Tiistai;0;2;2;0;0;0
109;21.04.2015;2015;04;05;Tiistai;3;6;9;0;0;0
109;21.04.2015;2015;04;06;Tiistai;5;33;38;4;6;10
109;21.04.2015;2015;04;07;Tiistai;34;91;125;3;10;13
109;21.04.2015;2015;04;08;Tiistai;13;77;90;2;5;7
109;21.04.2015;2015;04;09;Tiistai;7;14;21;2;4;6
109;21.04.2015;2015;04;10;Tiistai;6;14;20;2;10;12
109;21.04.2015;2015;04;11;Tiistai;3;20;23;0;5;5
109;21.04.2015;2015;04;12;Tiistai;8;21;29;2;5;7
109;21.04.2015;2015;04;13;Tiistai;7;26;33;4;7;11
109;21.04.2015;2015;04;14;Tiistai;11;32;43;2;4;6
109;21.04.2015;2015;04;15;Tiistai;24;39;63;8;5;13
109;21.04.2015;2015;04;16;Tiistai;42;79;121;3;9;12
109;21.04.2015;2015;04;17;Tiistai;23;33;56;7;6;13
109;21.04.2015;2015;04;18;Tiistai;9;30;39;2;14;16
109;21.04.2015;2015;04;19;Tiistai;12;15;27;5;15;20
109;21.04.2015;2015;04;20;Tiistai;4;15;19;1;7;8
109;21.04.2015;2015;04;21;Tiistai;6;14;20;1;6;7
109;21.04.2015;2015;04;22;Tiistai;5;5;10;2;1;3
109;21.04.2015;2015;04;23;Tiistai;0;3;3;0;0;0
109;22.04.2015;2015;04;00;Keskiviikko;0;1;1;0;0;0
109;22.04.2015;2015;04;01;Keskiviikko;0;0;0;1;0;1
109;22.04.2015;2015;04;02;Keskiviikko;0;0;0;0;0;0
109;22.04.2015;2015;04;03;Keskiviikko;1;0;1;0;0;0
109;22.04.2015;2015;04;04;Keskiviikko;0;0;0;0;0;0
109;22.04.2015;2015;04;05;Keskiviikko;4;3;7;1;4;5
109;22.04.2015;2015;04;06;Keskiviikko;3;24;27;1;3;4
109;22.04.2015;2015;04;07;Keskiviikko;25;96;121;3;8;11
109;22.04.2015;2015;04;08;Keskiviikko;16;71;87;2;3;5
109;22.04.2015;2015;04;09;Keskiviikko;7;25;32;1;6;7
109;22.04.2015;2015;04;10;Keskiviikko;5;15;20;4;7;11
109;22.04.2015;2015;04;11;Keskiviikko;8;15;23;3;5;8
109;22.04.2015;2015;04;12;Keskiviikko;2;18;20;1;3;4
109;22.04.2015;2015;04;13;Keskiviikko;17;10;27;0;4;4
109;22.04.2015;2015;04;14;Keskiviikko;24;13;37;12;7;19
109;22.04.2015;2015;04;15;Keskiviikko;41;41;82;19;38;57
109;22.04.2015;2015;04;16;Keskiviikko;46;71;117;2;3;5
109;22.04.2015;2015;04;17;Keskiviikko;20;40;60;3;10;13
109;22.04.2015;2015;04;18;Keskiviikko;16;33;49;3;11;14
109;22.04.2015;2015;04;19;Keskiviikko;6;21;27;2;8;10
109;22.04.2015;2015;04;20;Keskiviikko;6;9;15;3;6;9
109;22.04.2015;2015;04;21;Keskiviikko;4;14;18;2;5;7
109;22.04.2015;2015;04;22;Keskiviikko;7;7;14;1;2;3
109;22.04.2015;2015;04;23;Keskiviikko;1;5;6;0;0;0
109;23.04.2015;2015;04;00;Torstai;0;0;0;1;0;1
109;23.04.2015;2015;04;01;Torstai;1;1;2;0;0;0
109;23.04.2015;2015;04;02;Torstai;0;0;0;0;0;0
109;23.04.2015;2015;04;03;Torstai;0;3;3;0;1;1
109;23.04.2015;2015;04;04;Torstai;0;1;1;0;0;0
109;23.04.2015;2015;04;05;Torstai;2;3;5;0;0;0
109;23.04.2015;2015;04;06;Torstai;8;25;33;1;5;6
109;23.04.2015;2015;04;07;Torstai;19;84;103;2;8;10
109;23.04.2015;2015;04;08;Torstai;18;63;81;1;7;8
109;23.04.2015;2015;04;09;Torstai;3;19;22;1;0;1
109;23.04.2015;2015;04;10;Torstai;2;19;21;0;4;4
109;23.04.2015;2015;04;11;Torstai;5;20;25;2;2;4
109;23.04.2015;2015;04;12;Torstai;13;14;27;1;4;5
109;23.04.2015;2015;04;13;Torstai;13;17;30;0;2;2
109;23.04.2015;2015;04;14;Torstai;4;23;27;6;3;9
109;23.04.2015;2015;04;15;Torstai;26;46;72;2;0;2
109;23.04.2015;2015;04;16;Torstai;42;64;106;7;5;12
109;23.04.2015;2015;04;17;Torstai;23;34;57;5;6;11
109;23.04.2015;2015;04;18;Torstai;12;23;35;3;9;12
109;23.04.2015;2015;04;19;Torstai;2;15;17;3;3;6
109;23.04.2015;2015;04;20;Torstai;9;19;28;0;6;6
109;23.04.2015;2015;04;21;Torstai;11;13;24;2;2;4
109;23.04.2015;2015;04;22;Torstai;5;6;11;2;2;4
109;23.04.2015;2015;04;23;Torstai;1;4;5;0;2;2
109;24.04.2015;2015;04;00;Perjantai;1;3;4;1;1;2
109;24.04.2015;2015;04;01;Perjantai;1;0;1;1;0;1
109;24.04.2015;2015;04;02;Perjantai;0;0;0;0;0;0
109;24.04.2015;2015;04;03;Perjantai;0;0;0;0;0;0
109;24.04.2015;2015;04;04;Perjantai;4;2;6;0;0;0
109;24.04.2015;2015;04;05;Perjantai;5;6;11;0;0;0
109;24.04.2015;2015;04;06;Perjantai;3;25;28;0;2;2
109;24.04.2015;2015;04;07;Perjantai;18;75;93;2;5;7
109;24.04.2015;2015;04;08;Perjantai;18;68;86;4;5;9
109;24.04.2015;2015;04;09;Perjantai;4;29;33;1;1;2
109;24.04.2015;2015;04;10;Perjantai;9;14;23;1;0;1
109;24.04.2015;2015;04;11;Perjantai;3;23;26;0;4;4
109;24.04.2015;2015;04;12;Perjantai;9;24;33;4;1;5
109;24.04.2015;2015;04;13;Perjantai;14;24;38;3;5;8
109;24.04.2015;2015;04;14;Perjantai;10;39;49;1;7;8
109;24.04.2015;2015;04;15;Perjantai;19;45;64;3;4;7
109;24.04.2015;2015;04;16;Perjantai;25;53;78;5;9;14
109;24.04.2015;2015;04;17;Perjantai;16;33;49;4;4;8
109;24.04.2015;2015;04;18;Perjantai;9;14;23;2;2;4
109;24.04.2015;2015;04;19;Perjantai;3;17;20;3;0;3
109;24.04.2015;2015;04;20;Perjantai;2;7;9;3;3;6
109;24.04.2015;2015;04;21;Perjantai;8;18;26;1;1;2
109;24.04.2015;2015;04;22;Perjantai;5;8;13;1;1;2
109;24.04.2015;2015;04;23;Perjantai;3;4;7;1;0;1
109;25.04.2015;2015;04;00;Lauantai;1;4;5;0;0;0
109;25.04.2015;2015;04;01;Lauantai;1;0;1;1;0;1
109;25.04.2015;2015;04;02;Lauantai;1;2;3;0;0;0
109;25.04.2015;2015;04;03;Lauantai;1;1;2;0;0;0
109;25.04.2015;2015;04;04;Lauantai;1;4;5;0;0;0
109;25.04.2015;2015;04;05;Lauantai;0;4;4;0;0;0
109;25.04.2015;2015;04;06;Lauantai;2;4;6;0;2;2
109;25.04.2015;2015;04;07;Lauantai;1;4;5;2;0;2
109;25.04.2015;2015;04;08;Lauantai;3;7;10;0;6;6
109;25.04.2015;2015;04;09;Lauantai;4;15;19;4;4;8
109;25.04.2015;2015;04;10;Lauantai;2;16;18;4;6;10
109;25.04.2015;2015;04;11;Lauantai;6;11;17;1;2;3
109;25.04.2015;2015;04;12;Lauantai;3;25;28;1;2;3
109;25.04.2015;2015;04;13;Lauantai;6;15;21;1;1;2
109;25.04.2015;2015;04;14;Lauantai;5;20;25;6;6;12
109;25.04.2015;2015;04;15;Lauantai;6;19;25;3;10;13
109;25.04.2015;2015;04;16;Lauantai;16;14;30;5;4;9
109;25.04.2015;2015;04;17;Lauantai;5;13;18;1;5;6
109;25.04.2015;2015;04;18;Lauantai;3;12;15;2;3;5
109;25.04.2015;2015;04;19;Lauantai;3;8;11;2;6;8
109;25.04.2015;2015;04;20;Lauantai;8;12;20;5;4;9
109;25.04.2015;2015;04;21;Lauantai;3;9;12;1;1;2
109;25.04.2015;2015;04;22;Lauantai;3;9;12;3;1;4
109;25.04.2015;2015;04;23;Lauantai;6;3;9;1;2;3
109;26.04.2015;2015;04;00;Sunnuntai;4;1;5;0;0;0
109;26.04.2015;2015;04;01;Sunnuntai;2;1;3;0;0;0
109;26.04.2015;2015;04;02;Sunnuntai;2;0;2;1;0;1
109;26.04.2015;2015;04;03;Sunnuntai;3;1;4;0;0;0
109;26.04.2015;2015;04;04;Sunnuntai;3;2;5;0;1;1
109;26.04.2015;2015;04;05;Sunnuntai;0;2;2;2;2;4
109;26.04.2015;2015;04;06;Sunnuntai;0;3;3;0;1;1
109;26.04.2015;2015;04;07;Sunnuntai;0;4;4;0;3;3
109;26.04.2015;2015;04;08;Sunnuntai;2;3;5;5;11;16
109;26.04.2015;2015;04;09;Sunnuntai;3;6;9;2;6;8
109;26.04.2015;2015;04;10;Sunnuntai;7;11;18;2;9;11
109;26.04.2015;2015;04;11;Sunnuntai;10;19;29;4;11;15
109;26.04.2015;2015;04;12;Sunnuntai;15;25;40;2;4;6
109;26.04.2015;2015;04;13;Sunnuntai;7;20;27;4;5;9
109;26.04.2015;2015;04;14;Sunnuntai;9;19;28;2;11;13
109;26.04.2015;2015;04;15;Sunnuntai;9;34;43;2;12;14
109;26.04.2015;2015;04;16;Sunnuntai;8;20;28;4;3;7
109;26.04.2015;2015;04;17;Sunnuntai;7;19;26;4;8;12
109;26.04.2015;2015;04;18;Sunnuntai;3;26;29;4;13;17
109;26.04.2015;2015;04;19;Sunnuntai;4;14;18;2;8;10
109;26.04.2015;2015;04;20;Sunnuntai;5;18;23;1;2;3
109;26.04.2015;2015;04;21;Sunnuntai;3;6;9;3;7;10
109;26.04.2015;2015;04;22;Sunnuntai;0;2;2;3;2;5
109;26.04.2015;2015;04;23;Sunnuntai;0;4;4;0;0;0
109;27.04.2015;2015;04;00;Maanantai;1;0;1;2;1;3
109;27.04.2015;2015;04;01;Maanantai;0;0;0;0;0;0
109;27.04.2015;2015;04;02;Maanantai;0;0;0;0;0;0
109;27.04.2015;2015;04;03;Maanantai;0;1;1;0;1;1
109;27.04.2015;2015;04;04;Maanantai;0;3;3;0;0;0
109;27.04.2015;2015;04;05;Maanantai;1;7;8;2;1;3
109;27.04.2015;2015;04;06;Maanantai;8;25;33;2;1;3
109;27.04.2015;2015;04;07;Maanantai;12;66;78;2;3;5
109;27.04.2015;2015;04;08;Maanantai;9;63;72;4;1;5
109;27.04.2015;2015;04;09;Maanantai;4;113;117;4;5;9
109;27.04.2015;2015;04;10;Maanantai;2;12;14;1;3;4
109;27.04.2015;2015;04;11;Maanantai;5;12;17;0;3;3
109;27.04.2015;2015;04;12;Maanantai;28;63;91;8;3;11
109;27.04.2015;2015;04;13;Maanantai;12;17;29;0;0;0
109;27.04.2015;2015;04;14;Maanantai;7;23;30;3;7;10
109;27.04.2015;2015;04;15;Maanantai;23;22;45;2;5;7
109;27.04.2015;2015;04;16;Maanantai;23;74;97;4;5;9
109;27.04.2015;2015;04;17;Maanantai;18;26;44;2;7;9
109;27.04.2015;2015;04;18;Maanantai;9;32;41;0;14;14
109;27.04.2015;2015;04;19;Maanantai;8;16;24;5;6;11
109;27.04.2015;2015;04;20;Maanantai;6;24;30;2;5;7
109;27.04.2015;2015;04;21;Maanantai;7;6;13;0;2;2
109;27.04.2015;2015;04;22;Maanantai;2;9;11;2;0;2
109;27.04.2015;2015;04;23;Maanantai;1;1;2;0;0;0
109;28.04.2015;2015;04;00;Tiistai;1;0;1;0;2;2
109;28.04.2015;2015;04;01;Tiistai;0;1;1;0;1;1
109;28.04.2015;2015;04;02;Tiistai;0;0;0;0;1;1
109;28.04.2015;2015;04;03;Tiistai;0;0;0;0;0;0
109;28.04.2015;2015;04;04;Tiistai;0;1;1;0;0;0
109;28.04.2015;2015;04;05;Tiistai;3;5;8;1;1;2
109;28.04.2015;2015;04;06;Tiistai;11;32;43;2;3;5
109;28.04.2015;2015;04;07;Tiistai;28;107;135;3;3;6
109;28.04.2015;2015;04;08;Tiistai;18;71;89;3;3;6
109;28.04.2015;2015;04;09;Tiistai;11;29;40;0;0;0
109;28.04.2015;2015;04;10;Tiistai;7;21;28;5;3;8
109;28.04.2015;2015;04;11;Tiistai;6;20;26;2;3;5
109;28.04.2015;2015;04;12;Tiistai;6;19;25;3;2;5
109;28.04.2015;2015;04;13;Tiistai;15;23;38;3;2;5
109;28.04.2015;2015;04;14;Tiistai;15;39;54;1;4;5
109;28.04.2015;2015;04;15;Tiistai;36;51;87;0;4;4
109;28.04.2015;2015;04;16;Tiistai;51;80;131;2;8;10
109;28.04.2015;2015;04;17;Tiistai;23;29;52;4;7;11
109;28.04.2015;2015;04;18;Tiistai;11;23;34;2;8;10
109;28.04.2015;2015;04;19;Tiistai;10;25;35;4;9;13
109;28.04.2015;2015;04;20;Tiistai;4;22;26;3;6;9
109;28.04.2015;2015;04;21;Tiistai;8;8;16;3;2;5
109;28.04.2015;2015;04;22;Tiistai;5;12;17;1;3;4
109;28.04.2015;2015;04;23;Tiistai;1;2;3;1;1;2
109;29.04.2015;2015;04;00;Keskiviikko;1;1;2;0;0;0
109;29.04.2015;2015;04;01;Keskiviikko;0;0;0;1;0;1
109;29.04.2015;2015;04;02;Keskiviikko;0;2;2;0;0;0
109;29.04.2015;2015;04;03;Keskiviikko;0;2;2;0;0;0
109;29.04.2015;2015;04;04;Keskiviikko;2;0;2;0;0;0
109;29.04.2015;2015;04;05;Keskiviikko;6;8;14;0;2;2
109;29.04.2015;2015;04;06;Keskiviikko;7;28;35;1;0;1
109;29.04.2015;2015;04;07;Keskiviikko;25;94;119;4;3;7
109;29.04.2015;2015;04;08;Keskiviikko;8;83;91;2;5;7
109;29.04.2015;2015;04;09;Keskiviikko;4;20;24;0;3;3
109;29.04.2015;2015;04;10;Keskiviikko;2;6;8;3;3;6
109;29.04.2015;2015;04;11;Keskiviikko;6;22;28;4;3;7
109;29.04.2015;2015;04;12;Keskiviikko;3;18;21;3;5;8
109;29.04.2015;2015;04;13;Keskiviikko;12;23;35;4;4;8
109;29.04.2015;2015;04;14;Keskiviikko;16;27;43;2;4;6
109;29.04.2015;2015;04;15;Keskiviikko;15;46;61;2;6;8
109;29.04.2015;2015;04;16;Keskiviikko;33;100;133;2;5;7
109;29.04.2015;2015;04;17;Keskiviikko;20;36;56;3;6;9
109;29.04.2015;2015;04;18;Keskiviikko;7;22;29;4;10;14
109;29.04.2015;2015;04;19;Keskiviikko;14;19;33;2;11;13
109;29.04.2015;2015;04;20;Keskiviikko;10;15;25;4;5;9
109;29.04.2015;2015;04;21;Keskiviikko;6;8;14;1;4;5
109;29.04.2015;2015;04;22;Keskiviikko;2;6;8;0;0;0
109;29.04.2015;2015;04;23;Keskiviikko;1;4;5;2;0;2
109;30.04.2015;2015;04;00;Torstai;0;0;0;0;0;0
109;30.04.2015;2015;04;01;Torstai;0;0;0;0;1;1
109;30.04.2015;2015;04;02;Torstai;0;0;0;0;0;0
109;30.04.2015;2015;04;03;Torstai;0;1;1;0;0;0
109;30.04.2015;2015;04;04;Torstai;1;1;2;1;0;1
109;30.04.2015;2015;04;05;Torstai;2;2;4;0;2;2
109;30.04.2015;2015;04;06;Torstai;8;19;27;2;2;4
109;30.04.2015;2015;04;07;Torstai;16;65;81;3;6;9
109;30.04.2015;2015;04;08;Torstai;9;59;68;0;4;4
109;30.04.2015;2015;04;09;Torstai;5;26;31;1;1;2
109;30.04.2015;2015;04;10;Torstai;3;11;14;0;2;2
109;30.04.2015;2015;04;11;Torstai;1;14;15;3;6;9
109;30.04.2015;2015;04;12;Torstai;11;12;23;5;4;9
109;30.04.2015;2015;04;13;Torstai;20;33;53;4;7;11
109;30.04.2015;2015;04;14;Torstai;22;36;58;3;2;5
109;30.04.2015;2015;04;15;Torstai;21;44;65;2;3;5
109;30.04.2015;2015;04;16;Torstai;31;39;70;2;4;6
109;30.04.2015;2015;04;17;Torstai;12;9;21;3;5;8
109;30.04.2015;2015;04;18;Torstai;8;19;27;1;2;3
109;30.04.2015;2015;04;19;Torstai;12;10;22;4;6;10
109;30.04.2015;2015;04;20;Torstai;1;16;17;1;2;3
109;30.04.2015;2015;04;21;Torstai;11;7;18;1;4;5
109;30.04.2015;2015;04;22;Torstai;1;11;12;0;1;1
109;30.04.2015;2015;04;23;Torstai;2;8;10;3;1;4
109;01.05.2015;2015;05;00;Perjantai;2;6;8;0;0;0
109;01.05.2015;2015;05;01;Perjantai;1;3;4;0;0;0
109;01.05.2015;2015;05;02;Perjantai;3;2;5;0;0;0
109;01.05.2015;2015;05;03;Perjantai;6;3;9;1;1;2
109;01.05.2015;2015;05;04;Perjantai;3;1;4;0;0;0
109;01.05.2015;2015;05;05;Perjantai;4;2;6;0;1;1
109;01.05.2015;2015;05;06;Perjantai;1;3;4;0;1;1
109;01.05.2015;2015;05;07;Perjantai;0;2;2;1;3;4
109;01.05.2015;2015;05;08;Perjantai;0;2;2;0;8;8
109;01.05.2015;2015;05;09;Perjantai;3;5;8;4;5;9
109;01.05.2015;2015;05;10;Perjantai;6;8;14;4;2;6
109;01.05.2015;2015;05;11;Perjantai;2;23;25;2;8;10
109;01.05.2015;2015;05;12;Perjantai;3;32;35;4;5;9
109;01.05.2015;2015;05;13;Perjantai;8;22;30;3;4;7
109;01.05.2015;2015;05;14;Perjantai;8;15;23;1;5;6
109;01.05.2015;2015;05;15;Perjantai;9;11;20;3;4;7
109;01.05.2015;2015;05;16;Perjantai;6;8;14;0;2;2
109;01.05.2015;2015;05;17;Perjantai;1;7;8;3;6;9
109;01.05.2015;2015;05;18;Perjantai;7;4;11;0;3;3
109;01.05.2015;2015;05;19;Perjantai;3;2;5;2;2;4
109;01.05.2015;2015;05;20;Perjantai;3;4;7;2;4;6
109;01.05.2015;2015;05;21;Perjantai;7;2;9;2;2;4
109;01.05.2015;2015;05;22;Perjantai;3;2;5;1;1;2
109;01.05.2015;2015;05;23;Perjantai;1;2;3;0;1;1
109;02.05.2015;2015;05;00;Lauantai;0;1;1;0;1;1
109;02.05.2015;2015;05;01;Lauantai;0;1;1;0;0;0
109;02.05.2015;2015;05;02;Lauantai;2;1;3;0;0;0
109;02.05.2015;2015;05;03;Lauantai;0;0;0;0;1;1
109;02.05.2015;2015;05;04;Lauantai;0;0;0;0;0;0
109;02.05.2015;2015;05;05;Lauantai;1;0;1;0;1;1
109;02.05.2015;2015;05;06;Lauantai;0;4;4;0;1;1
109;02.05.2015;2015;05;07;Lauantai;0;6;6;0;2;2
109;02.05.2015;2015;05;08;Lauantai;2;11;13;1;7;8
109;02.05.2015;2015;05;09;Lauantai;6;9;15;2;1;3
109;02.05.2015;2015;05;10;Lauantai;3;20;23;3;11;14
109;02.05.2015;2015;05;11;Lauantai;3;23;26;1;2;3
109;02.05.2015;2015;05;12;Lauantai;6;23;29;3;4;7
109;02.05.2015;2015;05;13;Lauantai;4;20;24;3;5;8
109;02.05.2015;2015;05;14;Lauantai;5;25;30;2;4;6
109;02.05.2015;2015;05;15;Lauantai;7;19;26;1;5;6
109;02.05.2015;2015;05;16;Lauantai;9;17;26;0;6;6
109;02.05.2015;2015;05;17;Lauantai;6;18;24;1;10;11
109;02.05.2015;2015;05;18;Lauantai;5;16;21;5;4;9
109;02.05.2015;2015;05;19;Lauantai;10;12;22;2;6;8
109;02.05.2015;2015;05;20;Lauantai;8;3;11;3;0;3
109;02.05.2015;2015;05;21;Lauantai;2;10;12;1;5;6
109;02.05.2015;2015;05;22;Lauantai;2;5;7;0;2;2
109;02.05.2015;2015;05;23;Lauantai;1;0;1;0;0;0
109;03.05.2015;2015;05;00;Sunnuntai;2;4;6;0;2;2
109;03.05.2015;2015;05;01;Sunnuntai;0;0;0;0;0;0
109;03.05.2015;2015;05;02;Sunnuntai;0;0;0;0;0;0
109;03.05.2015;2015;05;03;Sunnuntai;0;0;0;0;0;0
109;03.05.2015;2015;05;04;Sunnuntai;1;0;1;0;0;0
109;03.05.2015;2015;05;05;Sunnuntai;0;0;0;0;1;1
109;03.05.2015;2015;05;06;Sunnuntai;0;1;1;1;0;1
109;03.05.2015;2015;05;07;Sunnuntai;1;3;4;2;2;4
109;03.05.2015;2015;05;08;Sunnuntai;1;1;2;0;4;4
109;03.05.2015;2015;05;09;Sunnuntai;2;5;7;1;0;1
109;03.05.2015;2015;05;10;Sunnuntai;0;4;4;0;4;4
109;03.05.2015;2015;05;11;Sunnuntai;0;3;3;1;5;6
109;03.05.2015;2015;05;12;Sunnuntai;1;11;12;3;7;10
109;03.05.2015;2015;05;13;Sunnuntai;3;8;11;3;9;12
109;03.05.2015;2015;05;14;Sunnuntai;5;6;11;3;7;10
109;03.05.2015;2015;05;15;Sunnuntai;5;19;24;4;11;15
109;03.05.2015;2015;05;16;Sunnuntai;2;14;16;0;4;4
109;03.05.2015;2015;05;17;Sunnuntai;2;24;26;0;11;11
109;03.05.2015;2015;05;18;Sunnuntai;1;6;7;1;3;4
109;03.05.2015;2015;05;19;Sunnuntai;3;11;14;2;6;8
109;03.05.2015;2015;05;20;Sunnuntai;2;7;9;3;5;8
109;03.05.2015;2015;05;21;Sunnuntai;0;4;4;1;8;9
109;03.05.2015;2015;05;22;Sunnuntai;0;0;0;0;2;2
109;03.05.2015;2015;05;23;Sunnuntai;1;0;1;1;1;2
109;04.05.2015;2015;05;00;Maanantai;0;0;0;0;0;0
109;04.05.2015;2015;05;01;Maanantai;0;0;0;0;0;0
109;04.05.2015;2015;05;02;Maanantai;0;1;1;0;0;0
109;04.05.2015;2015;05;03;Maanantai;0;0;0;0;0;0
109;04.05.2015;2015;05;04;Maanantai;1;0;1;0;0;0
109;04.05.2015;2015;05;05;Maanantai;8;4;12;0;2;2
109;04.05.2015;2015;05;06;Maanantai;10;29;39;1;4;5
109;04.05.2015;2015;05;07;Maanantai;22;91;113;4;10;14
109;04.05.2015;2015;05;08;Maanantai;19;85;104;5;5;10
109;04.05.2015;2015;05;09;Maanantai;6;26;32;4;5;9
109;04.05.2015;2015;05;10;Maanantai;4;15;19;2;6;8
109;04.05.2015;2015;05;11;Maanantai;17;19;36;0;5;5
109;04.05.2015;2015;05;12;Maanantai;9;18;27;3;5;8
109;04.05.2015;2015;05;13;Maanantai;7;26;33;2;1;3
109;04.05.2015;2015;05;14;Maanantai;12;18;30;3;1;4
109;04.05.2015;2015;05;15;Maanantai;41;53;94;4;3;7
109;04.05.2015;2015;05;16;Maanantai;55;65;120;6;9;15
109;04.05.2015;2015;05;17;Maanantai;25;34;59;3;7;10
109;04.05.2015;2015;05;18;Maanantai;15;22;37;2;13;15
109;04.05.2015;2015;05;19;Maanantai;8;28;36;7;11;18
109;04.05.2015;2015;05;20;Maanantai;6;19;25;4;9;13
109;04.05.2015;2015;05;21;Maanantai;7;14;21;1;6;7
109;04.05.2015;2015;05;22;Maanantai;3;6;9;0;3;3
109;04.05.2015;2015;05;23;Maanantai;1;6;7;1;0;1
109;05.05.2015;2015;05;00;Tiistai;0;1;1;1;0;1
109;05.05.2015;2015;05;01;Tiistai;0;0;0;0;1;1
109;05.05.2015;2015;05;02;Tiistai;0;0;0;0;0;0
109;05.05.2015;2015;05;03;Tiistai;0;0;0;0;0;0
109;05.05.2015;2015;05;04;Tiistai;1;4;5;0;0;0
109;05.05.2015;2015;05;05;Tiistai;7;8;15;0;1;1
109;05.05.2015;2015;05;06;Tiistai;16;38;54;1;2;3
109;05.05.2015;2015;05;07;Tiistai;28;92;120;0;3;3
109;05.05.2015;2015;05;08;Tiistai;16;82;98;1;3;4
109;05.05.2015;2015;05;09;Tiistai;3;33;36;2;3;5
109;05.05.2015;2015;05;10;Tiistai;6;15;21;1;6;7
109;05.05.2015;2015;05;11;Tiistai;9;20;29;1;6;7
109;05.05.2015;2015;05;12;Tiistai;8;23;31;1;3;4
109;05.05.2015;2015;05;13;Tiistai;8;24;32;3;1;4
109;05.05.2015;2015;05;14;Tiistai;12;21;33;3;4;7
109;05.05.2015;2015;05;15;Tiistai;21;57;78;10;6;16
109;05.05.2015;2015;05;16;Tiistai;42;90;132;0;7;7
109;05.05.2015;2015;05;17;Tiistai;14;50;64;5;10;15
109;05.05.2015;2015;05;18;Tiistai;13;34;47;6;9;15
109;05.05.2015;2015;05;19;Tiistai;10;20;30;3;8;11
109;05.05.2015;2015;05;20;Tiistai;10;35;45;4;6;10
109;05.05.2015;2015;05;21;Tiistai;6;21;27;1;6;7
109;05.05.2015;2015;05;22;Tiistai;2;7;9;1;1;2
109;05.05.2015;2015;05;23;Tiistai;1;2;3;1;0;1
109;06.05.2015;2015;05;00;Keskiviikko;0;0;0;2;0;2
109;06.05.2015;2015;05;01;Keskiviikko;0;1;1;0;0;0
109;06.05.2015;2015;05;02;Keskiviikko;1;0;1;0;0;0
109;06.05.2015;2015;05;03;Keskiviikko;0;1;1;0;0;0
109;06.05.2015;2015;05;04;Keskiviikko;1;2;3;0;0;0
109;06.05.2015;2015;05;05;Keskiviikko;2;11;13;0;0;0
109;06.05.2015;2015;05;06;Keskiviikko;12;32;44;0;2;2
109;06.05.2015;2015;05;07;Keskiviikko;28;123;151;3;6;9
109;06.05.2015;2015;05;08;Keskiviikko;10;88;98;2;2;4
109;06.05.2015;2015;05;09;Keskiviikko;5;19;24;2;3;5
109;06.05.2015;2015;05;10;Keskiviikko;5;13;18;1;4;5
109;06.05.2015;2015;05;11;Keskiviikko;8;22;30;5;9;14
109;06.05.2015;2015;05;12;Keskiviikko;8;22;30;3;3;6
109;06.05.2015;2015;05;13;Keskiviikko;10;29;39;1;10;11
109;06.05.2015;2015;05;14;Keskiviikko;8;38;46;2;2;4
109;06.05.2015;2015;05;15;Keskiviikko;13;50;63;3;10;13
109;06.05.2015;2015;05;16;Keskiviikko;32;120;152;2;9;11
109;06.05.2015;2015;05;17;Keskiviikko;13;49;62;3;8;11
109;06.05.2015;2015;05;18;Keskiviikko;7;28;35;2;2;4
109;06.05.2015;2015;05;19;Keskiviikko;4;25;29;3;11;14
109;06.05.2015;2015;05;20;Keskiviikko;8;9;17;4;4;8
109;06.05.2015;2015;05;21;Keskiviikko;6;6;12;3;9;12
109;06.05.2015;2015;05;22;Keskiviikko;2;8;10;1;0;1
109;06.05.2015;2015;05;23;Keskiviikko;2;2;4;0;0;0
109;07.05.2015;2015;05;00;Torstai;0;0;0;2;1;3
109;07.05.2015;2015;05;01;Torstai;0;0;0;0;0;0
109;07.05.2015;2015;05;02;Torstai;0;0;0;0;1;1
109;07.05.2015;2015;05;03;Torstai;0;4;4;0;0;0
109;07.05.2015;2015;05;04;Torstai;1;3;4;0;0;0
109;07.05.2015;2015;05;05;Torstai;0;8;8;3;1;4
109;07.05.2015;2015;05;06;Torstai;6;34;40;3;4;7
109;07.05.2015;2015;05;07;Torstai;22;100;122;2;2;4
109;07.05.2015;2015;05;08;Torstai;15;83;98;2;6;8
109;07.05.2015;2015;05;09;Torstai;6;153;159;0;5;5
109;07.05.2015;2015;05;10;Torstai;3;21;24;2;4;6
109;07.05.2015;2015;05;11;Torstai;4;18;22;0;9;9
109;07.05.2015;2015;05;12;Torstai;62;79;141;2;5;7
109;07.05.2015;2015;05;13;Torstai;6;23;29;1;4;5
109;07.05.2015;2015;05;14;Torstai;10;28;38;3;3;6
109;07.05.2015;2015;05;15;Torstai;19;71;90;2;8;10
109;07.05.2015;2015;05;16;Torstai;26;94;120;2;6;8
109;07.05.2015;2015;05;17;Torstai;20;45;65;3;7;10
109;07.05.2015;2015;05;18;Torstai;13;25;38;0;10;10
109;07.05.2015;2015;05;19;Torstai;12;32;44;3;8;11
109;07.05.2015;2015;05;20;Torstai;10;14;24;3;13;16
109;07.05.2015;2015;05;21;Torstai;5;20;25;1;5;6
109;07.05.2015;2015;05;22;Torstai;4;10;14;2;4;6
109;07.05.2015;2015;05;23;Torstai;0;4;4;1;0;1
109;08.05.2015;2015;05;00;Perjantai;0;2;2;0;1;1
109;08.05.2015;2015;05;01;Perjantai;1;2;3;0;0;0
109;08.05.2015;2015;05;02;Perjantai;2;0;2;0;0;0
109;08.05.2015;2015;05;03;Perjantai;0;1;1;0;0;0
109;08.05.2015;2015;05;04;Perjantai;0;0;0;0;0;0
109;08.05.2015;2015;05;05;Perjantai;3;3;6;1;1;2
109;08.05.2015;2015;05;06;Perjantai;7;33;40;2;2;4
109;08.05.2015;2015;05;07;Perjantai;18;88;106;4;4;8
109;08.05.2015;2015;05;08;Perjantai;13;64;77;2;3;5
109;08.05.2015;2015;05;09;Perjantai;0;24;24;2;3;5
109;08.05.2015;2015;05;10;Perjantai;1;8;9;0;1;1
109;08.05.2015;2015;05;11;Perjantai;5;18;23;1;6;7
109;08.05.2015;2015;05;12;Perjantai;2;13;15;1;4;5
109;08.05.2015;2015;05;13;Perjantai;6;23;29;1;5;6
109;08.05.2015;2015;05;14;Perjantai;11;34;45;1;4;5
109;08.05.2015;2015;05;15;Perjantai;22;67;89;2;3;5
109;08.05.2015;2015;05;16;Perjantai;31;56;87;3;10;13
109;08.05.2015;2015;05;17;Perjantai;15;30;45;2;4;6
109;08.05.2015;2015;05;18;Perjantai;6;15;21;2;7;9
109;08.05.2015;2015;05;19;Perjantai;8;35;43;2;5;7
109;08.05.2015;2015;05;20;Perjantai;2;14;16;4;7;11
109;08.05.2015;2015;05;21;Perjantai;2;7;9;2;3;5
109;08.05.2015;2015;05;22;Perjantai;1;3;4;0;1;1
109;08.05.2015;2015;05;23;Perjantai;0;3;3;1;1;2
109;09.05.2015;2015;05;00;Lauantai;0;2;2;1;0;1
109;09.05.2015;2015;05;01;Lauantai;5;0;5;0;0;0
109;09.05.2015;2015;05;02;Lauantai;1;0;1;0;0;0
109;09.05.2015;2015;05;03;Lauantai;0;4;4;0;0;0
109;09.05.2015;2015;05;04;Lauantai;0;2;2;0;0;0
109;09.05.2015;2015;05;05;Lauantai;1;1;2;0;0;0
109;09.05.2015;2015;05;06;Lauantai;2;3;5;0;2;2
109;09.05.2015;2015;05;07;Lauantai;3;6;9;1;1;2
109;09.05.2015;2015;05;08;Lauantai;4;4;8;3;7;10
109;09.05.2015;2015;05;09;Lauantai;4;6;10;2;4;6
109;09.05.2015;2015;05;10;Lauantai;5;12;17;3;5;8
109;09.05.2015;2015;05;11;Lauantai;4;11;15;6;4;10
109;09.05.2015;2015;05;12;Lauantai;0;19;19;1;2;3
109;09.05.2015;2015;05;13;Lauantai;2;8;10;1;3;4
109;09.05.2015;2015;05;14;Lauantai;3;14;17;2;1;3
109;09.05.2015;2015;05;15;Lauantai;4;16;20;2;7;9
109;09.05.2015;2015;05;16;Lauantai;7;15;22;4;7;11
109;09.05.2015;2015;05;17;Lauantai;4;8;12;0;2;2
109;09.05.2015;2015;05;18;Lauantai;1;5;6;1;3;4
109;09.05.2015;2015;05;19;Lauantai;0;5;5;1;7;8
109;09.05.2015;2015;05;20;Lauantai;5;8;13;1;4;5
109;09.05.2015;2015;05;21;Lauantai;2;6;8;2;6;8
109;09.05.2015;2015;05;22;Lauantai;0;0;0;0;0;0
109;09.05.2015;2015;05;23;Lauantai;1;0;1;1;2;3
109;10.05.2015;2015;05;00;Sunnuntai;4;0;4;0;0;0
109;10.05.2015;2015;05;01;Sunnuntai;0;0;0;1;0;1
109;10.05.2015;2015;05;02;Sunnuntai;0;3;3;0;0;0
109;10.05.2015;2015;05;03;Sunnuntai;0;0;0;1;0;1
109;10.05.2015;2015;05;04;Sunnuntai;1;3;4;0;0;0
109;10.05.2015;2015;05;05;Sunnuntai;1;5;6;0;0;0
109;10.05.2015;2015;05;06;Sunnuntai;2;5;7;0;0;0
109;10.05.2015;2015;05;07;Sunnuntai;3;3;6;0;7;7
109;10.05.2015;2015;05;08;Sunnuntai;2;8;10;0;5;5
109;10.05.2015;2015;05;09;Sunnuntai;4;13;17;1;3;4
109;10.05.2015;2015;05;10;Sunnuntai;4;22;26;1;8;9
109;10.05.2015;2015;05;11;Sunnuntai;5;25;30;3;10;13
109;10.05.2015;2015;05;12;Sunnuntai;5;11;16;4;7;11
109;10.05.2015;2015;05;13;Sunnuntai;10;23;33;7;6;13
109;10.05.2015;2015;05;14;Sunnuntai;6;26;32;5;8;13
109;10.05.2015;2015;05;15;Sunnuntai;2;21;23;5;5;10
109;10.05.2015;2015;05;16;Sunnuntai;7;21;28;1;7;8
109;10.05.2015;2015;05;17;Sunnuntai;9;20;29;2;8;10
109;10.05.2015;2015;05;18;Sunnuntai;10;18;28;2;5;7
109;10.05.2015;2015;05;19;Sunnuntai;5;22;27;7;14;21
109;10.05.2015;2015;05;20;Sunnuntai;2;23;25;2;5;7
109;10.05.2015;2015;05;21;Sunnuntai;7;12;19;1;5;6
109;10.05.2015;2015;05;22;Sunnuntai;0;5;5;1;0;1
109;10.05.2015;2015;05;23;Sunnuntai;0;1;1;0;2;2
109;11.05.2015;2015;05;00;Maanantai;0;0;0;0;3;3
109;11.05.2015;2015;05;01;Maanantai;0;0;0;0;0;0
109;11.05.2015;2015;05;02;Maanantai;0;1;1;0;0;0
109;11.05.2015;2015;05;03;Maanantai;0;1;1;0;0;0
109;11.05.2015;2015;05;04;Maanantai;0;1;1;0;0;0
109;11.05.2015;2015;05;05;Maanantai;3;6;9;0;0;0
109;11.05.2015;2015;05;06;Maanantai;8;33;41;1;1;2
109;11.05.2015;2015;05;07;Maanantai;21;90;111;0;8;8
109;11.05.2015;2015;05;08;Maanantai;16;82;98;1;4;5
109;11.05.2015;2015;05;09;Maanantai;6;26;32;0;6;6
109;11.05.2015;2015;05;10;Maanantai;4;17;21;0;6;6
109;11.05.2015;2015;05;11;Maanantai;3;17;20;1;5;6
109;11.05.2015;2015;05;12;Maanantai;10;15;25;2;3;5
109;11.05.2015;2015;05;13;Maanantai;10;28;38;4;7;11
109;11.05.2015;2015;05;14;Maanantai;13;38;51;3;3;6
109;11.05.2015;2015;05;15;Maanantai;36;54;90;4;7;11
109;11.05.2015;2015;05;16;Maanantai;41;77;118;4;6;10
109;11.05.2015;2015;05;17;Maanantai;10;32;42;4;5;9
109;11.05.2015;2015;05;18;Maanantai;6;34;40;0;10;10
109;11.05.2015;2015;05;19;Maanantai;6;21;27;1;7;8
109;11.05.2015;2015;05;20;Maanantai;9;33;42;2;11;13
109;11.05.2015;2015;05;21;Maanantai;8;21;29;3;6;9
109;11.05.2015;2015;05;22;Maanantai;1;17;18;0;2;2
109;11.05.2015;2015;05;23;Maanantai;0;1;1;0;1;1
109;12.05.2015;2015;05;00;Tiistai;0;1;1;0;0;0
109;12.05.2015;2015;05;01;Tiistai;0;0;0;0;0;0
109;12.05.2015;2015;05;02;Tiistai;0;0;0;0;0;0
109;12.05.2015;2015;05;03;Tiistai;0;0;0;0;0;0
109;12.05.2015;2015;05;04;Tiistai;0;1;1;0;0;0
109;12.05.2015;2015;05;05;Tiistai;1;7;8;0;2;2
109;12.05.2015;2015;05;06;Tiistai;6;27;33;2;3;5
109;12.05.2015;2015;05;07;Tiistai;16;80;96;1;3;4
109;12.05.2015;2015;05;08;Tiistai;3;62;65;2;12;14
109;12.05.2015;2015;05;09;Tiistai;2;19;21;1;5;6
109;12.05.2015;2015;05;10;Tiistai;1;10;11;0;0;0
109;12.05.2015;2015;05;11;Tiistai;3;11;14;2;3;5
109;12.05.2015;2015;05;12;Tiistai;0;13;13;3;4;7
109;12.05.2015;2015;05;13;Tiistai;10;8;18;2;3;5
109;12.05.2015;2015;05;14;Tiistai;12;10;22;3;4;7
109;12.05.2015;2015;05;15;Tiistai;25;24;49;5;5;10
109;12.05.2015;2015;05;16;Tiistai;44;42;86;4;4;8
109;12.05.2015;2015;05;17;Tiistai;18;16;34;3;5;8
109;12.05.2015;2015;05;18;Tiistai;13;11;24;2;3;5
109;12.05.2015;2015;05;19;Tiistai;13;9;22;1;1;2
109;12.05.2015;2015;05;20;Tiistai;9;8;17;2;2;4
109;12.05.2015;2015;05;21;Tiistai;5;4;9;1;0;1
109;12.05.2015;2015;05;22;Tiistai;3;1;4;0;0;0
109;12.05.2015;2015;05;23;Tiistai;0;0;0;0;0;0
109;13.05.2015;2015;05;00;Keskiviikko;3;0;3;0;0;0
109;13.05.2015;2015;05;01;Keskiviikko;1;0;1;0;0;0
109;13.05.2015;2015;05;02;Keskiviikko;1;0;1;0;0;0
109;13.05.2015;2015;05;03;Keskiviikko;1;0;1;0;0;0
109;13.05.2015;2015;05;04;Keskiviikko;1;1;2;0;0;0
109;13.05.2015;2015;05;05;Keskiviikko;9;7;16;0;0;0
109;13.05.2015;2015;05;06;Keskiviikko;20;19;39;0;0;0
109;13.05.2015;2015;05;07;Keskiviikko;43;63;106;2;4;6
109;13.05.2015;2015;05;08;Keskiviikko;2;77;79;0;5;5
109;13.05.2015;2015;05;09;Keskiviikko;2;32;34;0;5;5
109;13.05.2015;2015;05;10;Keskiviikko;0;17;17;3;5;8
109;13.05.2015;2015;05;11;Keskiviikko;1;13;14;0;3;3
109;13.05.2015;2015;05;12;Keskiviikko;5;12;17;1;2;3
109;13.05.2015;2015;05;13;Keskiviikko;2;12;14;0;4;4
109;13.05.2015;2015;05;14;Keskiviikko;2;29;31;1;4;5
109;13.05.2015;2015;05;15;Keskiviikko;8;49;57;0;3;3
109;13.05.2015;2015;05;16;Keskiviikko;8;63;71;0;2;2
109;13.05.2015;2015;05;17;Keskiviikko;4;25;29;0;5;5
109;13.05.2015;2015;05;18;Keskiviikko;4;13;17;1;3;4
109;13.05.2015;2015;05;19;Keskiviikko;6;12;18;0;3;3
109;13.05.2015;2015;05;20;Keskiviikko;1;5;6;1;4;5
109;13.05.2015;2015;05;21;Keskiviikko;3;10;13;0;2;2
109;13.05.2015;2015;05;22;Keskiviikko;0;5;5;0;0;0
109;13.05.2015;2015;05;23;Keskiviikko;0;3;3;3;3;6
109;14.05.2015;2015;05;00;Torstai;0;6;6;0;0;0
109;14.05.2015;2015;05;01;Torstai;0;2;2;0;0;0
109;14.05.2015;2015;05;02;Torstai;0;1;1;0;0;0
109;14.05.2015;2015;05;03;Torstai;0;0;0;0;0;0
109;14.05.2015;2015;05;04;Torstai;3;0;3;0;1;1
109;14.05.2015;2015;05;05;Torstai;0;1;1;0;0;0
109;14.05.2015;2015;05;06;Torstai;2;7;9;1;1;2
109;14.05.2015;2015;05;07;Torstai;2;4;6;0;5;5
109;14.05.2015;2015;05;08;Torstai;0;8;8;0;5;5
109;14.05.2015;2015;05;09;Torstai;0;8;8;2;12;14
109;14.05.2015;2015;05;10;Torstai;1;7;8;1;2;3
109;14.05.2015;2015;05;11;Torstai;2;5;7;0;2;2
109;14.05.2015;2015;05;12;Torstai;3;23;26;2;4;6
109;14.05.2015;2015;05;13;Torstai;2;15;17;2;6;8
109;14.05.2015;2015;05;14;Torstai;1;24;25;2;11;13
109;14.05.2015;2015;05;15;Torstai;4;26;30;2;9;11
109;14.05.2015;2015;05;16;Torstai;0;14;14;2;4;6
109;14.05.2015;2015;05;17;Torstai;6;7;13;1;11;12
109;14.05.2015;2015;05;18;Torstai;5;10;15;0;9;9
109;14.05.2015;2015;05;19;Torstai;2;13;15;2;3;5
109;14.05.2015;2015;05;20;Torstai;8;7;15;2;1;3
109;14.05.2015;2015;05;21;Torstai;1;6;7;0;3;3
109;14.05.2015;2015;05;22;Torstai;1;2;3;0;1;1
109;14.05.2015;2015;05;23;Torstai;1;0;1;1;0;1
109;15.05.2015;2015;05;00;Perjantai;1;1;2;0;0;0
109;15.05.2015;2015;05;01;Perjantai;0;0;0;0;0;0
109;15.05.2015;2015;05;02;Perjantai;0;0;0;0;0;0
109;15.05.2015;2015;05;03;Perjantai;0;0;0;0;1;1
109;15.05.2015;2015;05;04;Perjantai;0;0;0;0;0;0
109;15.05.2015;2015;05;05;Perjantai;5;2;7;2;1;3
109;15.05.2015;2015;05;06;Perjantai;4;16;20;0;0;0
109;15.05.2015;2015;05;07;Perjantai;7;38;45;1;6;7
109;15.05.2015;2015;05;08;Perjantai;6;34;40;0;5;5
109;15.05.2015;2015;05;09;Perjantai;4;13;17;1;3;4
109;15.05.2015;2015;05;10;Perjantai;3;10;13;0;1;1
109;15.05.2015;2015;05;11;Perjantai;1;13;14;2;2;4
109;15.05.2015;2015;05;12;Perjantai;6;23;29;1;2;3
109;15.05.2015;2015;05;13;Perjantai;6;13;19;0;4;4
109;15.05.2015;2015;05;14;Perjantai;3;22;25;0;1;1
109;15.05.2015;2015;05;15;Perjantai;11;31;42;3;2;5
109;15.05.2015;2015;05;16;Perjantai;8;28;36;3;2;5
109;15.05.2015;2015;05;17;Perjantai;11;15;26;1;5;6
109;15.05.2015;2015;05;18;Perjantai;4;8;12;2;4;6
109;15.05.2015;2015;05;19;Perjantai;4;8;12;3;7;10
109;15.05.2015;2015;05;20;Perjantai;0;5;5;0;6;6
109;15.05.2015;2015;05;21;Perjantai;2;11;13;2;5;7
109;15.05.2015;2015;05;22;Perjantai;5;10;15;2;3;5
109;15.05.2015;2015;05;23;Perjantai;1;3;4;0;3;3
109;16.05.2015;2015;05;00;Lauantai;0;4;4;0;0;0
109;16.05.2015;2015;05;01;Lauantai;2;1;3;0;2;2
109;16.05.2015;2015;05;02;Lauantai;0;0;0;0;0;0
109;16.05.2015;2015;05;03;Lauantai;2;3;5;1;0;1
109;16.05.2015;2015;05;04;Lauantai;2;4;6;0;0;0
109;16.05.2015;2015;05;05;Lauantai;0;1;1;0;1;1
109;16.05.2015;2015;05;06;Lauantai;1;12;13;3;6;9
109;16.05.2015;2015;05;07;Lauantai;0;6;6;0;3;3
109;16.05.2015;2015;05;08;Lauantai;1;7;8;0;4;4
109;16.05.2015;2015;05;09;Lauantai;3;12;15;1;9;10
109;16.05.2015;2015;05;10;Lauantai;5;12;17;3;9;12
109;16.05.2015;2015;05;11;Lauantai;2;16;18;2;5;7
109;16.05.2015;2015;05;12;Lauantai;3;34;37;2;6;8
109;16.05.2015;2015;05;13;Lauantai;5;21;26;2;5;7
109;16.05.2015;2015;05;14;Lauantai;8;20;28;0;7;7
109;16.05.2015;2015;05;15;Lauantai;3;22;25;1;2;3
109;16.05.2015;2015;05;16;Lauantai;6;24;30;1;7;8
109;16.05.2015;2015;05;17;Lauantai;3;13;16;1;6;7
109;16.05.2015;2015;05;18;Lauantai;5;30;35;4;5;9
109;16.05.2015;2015;05;19;Lauantai;2;21;23;0;7;7
109;16.05.2015;2015;05;20;Lauantai;2;17;19;0;5;5
109;16.05.2015;2015;05;21;Lauantai;3;14;17;2;5;7
109;16.05.2015;2015;05;22;Lauantai;2;6;8;0;1;1
109;16.05.2015;2015;05;23;Lauantai;6;8;14;0;0;0
109;17.05.2015;2015;05;00;Sunnuntai;0;7;7;1;0;1
109;17.05.2015;2015;05;01;Sunnuntai;0;5;5;0;0;0
109;17.05.2015;2015;05;02;Sunnuntai;0;2;2;0;0;0
109;17.05.2015;2015;05;03;Sunnuntai;4;2;6;0;0;0
109;17.05.2015;2015;05;04;Sunnuntai;1;0;1;2;0;2
109;17.05.2015;2015;05;05;Sunnuntai;2;2;4;0;0;0
109;17.05.2015;2015;05;06;Sunnuntai;1;3;4;2;7;9
109;17.05.2015;2015;05;07;Sunnuntai;2;6;8;0;3;3
109;17.05.2015;2015;05;08;Sunnuntai;2;5;7;0;5;5
109;17.05.2015;2015;05;09;Sunnuntai;4;11;15;2;7;9
109;17.05.2015;2015;05;10;Sunnuntai;5;13;18;2;8;10
109;17.05.2015;2015;05;11;Sunnuntai;0;19;19;1;9;10
109;17.05.2015;2015;05;12;Sunnuntai;5;22;27;2;5;7
109;17.05.2015;2015;05;13;Sunnuntai;4;19;23;1;10;11
109;17.05.2015;2015;05;14;Sunnuntai;5;25;30;5;7;12
109;17.05.2015;2015;05;15;Sunnuntai;7;25;32;0;5;5
109;17.05.2015;2015;05;16;Sunnuntai;10;21;31;0;6;6
109;17.05.2015;2015;05;17;Sunnuntai;6;15;21;1;8;9
109;17.05.2015;2015;05;18;Sunnuntai;9;24;33;2;7;9
109;17.05.2015;2015;05;19;Sunnuntai;8;17;25;4;7;11
109;17.05.2015;2015;05;20;Sunnuntai;8;21;29;1;8;9
109;17.05.2015;2015;05;21;Sunnuntai;3;13;16;3;4;7
109;17.05.2015;2015;05;22;Sunnuntai;1;4;5;0;2;2
109;17.05.2015;2015;05;23;Sunnuntai;1;0;1;0;0;0
109;18.05.2015;2015;05;00;Maanantai;0;0;0;0;0;0
109;18.05.2015;2015;05;01;Maanantai;0;0;0;0;0;0
109;18.05.2015;2015;05;02;Maanantai;0;0;0;0;0;0
109;18.05.2015;2015;05;03;Maanantai;0;0;0;0;0;0
109;18.05.2015;2015;05;04;Maanantai;0;1;1;0;0;0
109;18.05.2015;2015;05;05;Maanantai;2;11;13;2;1;3
109;18.05.2015;2015;05;06;Maanantai;11;40;51;1;2;3
109;18.05.2015;2015;05;07;Maanantai;27;141;168;1;6;7
109;18.05.2015;2015;05;08;Maanantai;14;79;93;0;7;7
109;18.05.2015;2015;05;09;Maanantai;10;41;51;7;9;16
109;18.05.2015;2015;05;10;Maanantai;18;21;39;3;21;24
109;18.05.2015;2015;05;11;Maanantai;2;19;21;0;2;2
109;18.05.2015;2015;05;12;Maanantai;4;26;30;1;4;5
109;18.05.2015;2015;05;13;Maanantai;10;28;38;2;3;5
109;18.05.2015;2015;05;14;Maanantai;18;42;60;1;5;6
109;18.05.2015;2015;05;15;Maanantai;28;83;111;1;5;6
109;18.05.2015;2015;05;16;Maanantai;34;114;148;0;7;7
109;18.05.2015;2015;05;17;Maanantai;15;49;64;1;5;6
109;18.05.2015;2015;05;18;Maanantai;8;26;34;1;8;9
109;18.05.2015;2015;05;19;Maanantai;6;26;32;2;14;16
109;18.05.2015;2015;05;20;Maanantai;3;16;19;2;12;14
109;18.05.2015;2015;05;21;Maanantai;5;7;12;1;5;6
109;18.05.2015;2015;05;22;Maanantai;1;10;11;0;0;0
109;18.05.2015;2015;05;23;Maanantai;1;2;3;0;0;0
109;19.05.2015;2015;05;00;Tiistai;0;0;0;1;0;1
109;19.05.2015;2015;05;01;Tiistai;0;0;0;0;1;1
109;19.05.2015;2015;05;02;Tiistai;0;0;0;0;0;0
109;19.05.2015;2015;05;03;Tiistai;0;0;0;0;0;0
109;19.05.2015;2015;05;04;Tiistai;1;0;1;0;0;0
109;19.05.2015;2015;05;05;Tiistai;3;6;9;0;2;2
109;19.05.2015;2015;05;06;Tiistai;11;35;46;2;2;4
109;19.05.2015;2015;05;07;Tiistai;15;101;116;0;5;5
109;19.05.2015;2015;05;08;Tiistai;9;77;86;0;6;6
109;19.05.2015;2015;05;09;Tiistai;5;25;30;1;1;2
109;19.05.2015;2015;05;10;Tiistai;0;12;12;2;1;3
109;19.05.2015;2015;05;11;Tiistai;5;22;27;1;8;9
109;19.05.2015;2015;05;12;Tiistai;5;22;27;2;3;5
109;19.05.2015;2015;05;13;Tiistai;7;14;21;0;4;4
109;19.05.2015;2015;05;14;Tiistai;8;32;40;1;5;6
109;19.05.2015;2015;05;15;Tiistai;15;60;75;2;5;7
109;19.05.2015;2015;05;16;Tiistai;35;85;120;2;4;6
109;19.05.2015;2015;05;17;Tiistai;14;36;50;4;8;12
109;19.05.2015;2015;05;18;Tiistai;10;22;32;4;4;8
109;19.05.2015;2015;05;19;Tiistai;6;20;26;2;6;8
109;19.05.2015;2015;05;20;Tiistai;4;14;18;3;9;12
109;19.05.2015;2015;05;21;Tiistai;4;9;13;1;2;3
109;19.05.2015;2015;05;22;Tiistai;2;6;8;0;1;1
109;19.05.2015;2015;05;23;Tiistai;1;3;4;0;1;1
109;20.05.2015;2015;05;00;Keskiviikko;0;0;0;0;0;0
109;20.05.2015;2015;05;01;Keskiviikko;4;0;4;1;1;2
109;20.05.2015;2015;05;02;Keskiviikko;1;0;1;0;0;0
109;20.05.2015;2015;05;03;Keskiviikko;0;0;0;0;0;0
109;20.05.2015;2015;05;04;Keskiviikko;1;2;3;0;0;0
109;20.05.2015;2015;05;05;Keskiviikko;1;9;10;0;1;1
109;20.05.2015;2015;05;06;Keskiviikko;7;33;40;0;2;2
109;20.05.2015;2015;05;07;Keskiviikko;22;103;125;2;3;5
109;20.05.2015;2015;05;08;Keskiviikko;11;80;91;1;3;4
109;20.05.2015;2015;05;09;Keskiviikko;5;25;30;2;5;7
109;20.05.2015;2015;05;10;Keskiviikko;3;15;18;1;1;2
109;20.05.2015;2015;05;11;Keskiviikko;7;24;31;1;3;4
109;20.05.2015;2015;05;12;Keskiviikko;4;20;24;0;1;1
109;20.05.2015;2015;05;13;Keskiviikko;3;11;14;0;2;2
109;20.05.2015;2015;05;14;Keskiviikko;7;28;35;0;4;4
109;20.05.2015;2015;05;15;Keskiviikko;16;44;60;2;3;5
109;20.05.2015;2015;05;16;Keskiviikko;41;61;102;1;6;7
109;20.05.2015;2015;05;17;Keskiviikko;10;49;59;0;7;7
109;20.05.2015;2015;05;18;Keskiviikko;14;18;32;4;5;9
109;20.05.2015;2015;05;19;Keskiviikko;6;17;23;5;10;15
109;20.05.2015;2015;05;20;Keskiviikko;5;8;13;2;3;5
109;20.05.2015;2015;05;21;Keskiviikko;6;6;12;2;9;11
109;20.05.2015;2015;05;22;Keskiviikko;3;7;10;2;2;4
109;20.05.2015;2015;05;23;Keskiviikko;0;3;3;0;0;0
109;21.05.2015;2015;05;00;Torstai;0;0;0;1;1;2
109;21.05.2015;2015;05;01;Torstai;0;0;0;0;0;0
109;21.05.2015;2015;05;02;Torstai;0;0;0;0;2;2
109;21.05.2015;2015;05;03;Torstai;0;0;0;0;1;1
109;21.05.2015;2015;05;04;Torstai;1;2;3;0;0;0
109;21.05.2015;2015;05;05;Torstai;2;8;10;0;0;0
109;21.05.2015;2015;05;06;Torstai;16;42;58;2;1;3
109;21.05.2015;2015;05;07;Torstai;23;125;148;2;4;6
109;21.05.2015;2015;05;08;Torstai;6;84;90;2;3;5
109;21.05.2015;2015;05;09;Torstai;6;31;37;0;4;4
109;21.05.2015;2015;05;10;Torstai;2;18;20;0;6;6
109;21.05.2015;2015;05;11;Torstai;4;25;29;1;4;5
109;21.05.2015;2015;05;12;Torstai;6;19;25;2;8;10
109;21.05.2015;2015;05;13;Torstai;4;35;39;0;3;3
109;21.05.2015;2015;05;14;Torstai;16;31;47;0;4;4
109;21.05.2015;2015;05;15;Torstai;31;66;97;3;6;9
109;21.05.2015;2015;05;16;Torstai;37;104;141;0;9;9
109;21.05.2015;2015;05;17;Torstai;25;53;78;2;5;7
109;21.05.2015;2015;05;18;Torstai;11;17;28;3;6;9
109;21.05.2015;2015;05;19;Torstai;12;26;38;0;12;12
109;21.05.2015;2015;05;20;Torstai;8;21;29;1;3;4
109;21.05.2015;2015;05;21;Torstai;10;19;29;2;8;10
109;21.05.2015;2015;05;22;Torstai;6;6;12;0;0;0
109;21.05.2015;2015;05;23;Torstai;3;2;5;0;0;0
109;22.05.2015;2015;05;00;Perjantai;3;0;3;0;0;0
109;22.05.2015;2015;05;01;Perjantai;2;0;2;0;0;0
109;22.05.2015;2015;05;02;Perjantai;0;0;0;0;0;0
109;22.05.2015;2015;05;03;Perjantai;0;0;0;0;1;1
109;22.05.2015;2015;05;04;Perjantai;2;1;3;0;0;0
109;22.05.2015;2015;05;05;Perjantai;10;7;17;2;1;3
109;22.05.2015;2015;05;06;Perjantai;27;25;52;0;0;0
109;22.05.2015;2015;05;07;Perjantai;69;67;136;1;6;7
109;22.05.2015;2015;05;08;Perjantai;47;45;92;0;5;5
109;22.05.2015;2015;05;09;Perjantai;16;13;29;1;3;4
109;22.05.2015;2015;05;10;Perjantai;17;15;32;0;1;1
109;22.05.2015;2015;05;11;Perjantai;15;14;29;2;2;4
109;22.05.2015;2015;05;12;Perjantai;24;23;47;1;2;3
109;22.05.2015;2015;05;13;Perjantai;12;10;22;0;4;4
109;22.05.2015;2015;05;14;Perjantai;25;22;47;0;1;1
109;22.05.2015;2015;05;15;Perjantai;50;47;97;3;2;5
109;22.05.2015;2015;05;16;Perjantai;44;44;88;3;2;5
109;22.05.2015;2015;05;17;Perjantai;31;28;59;1;5;6
109;22.05.2015;2015;05;18;Perjantai;18;14;32;2;4;6
109;22.05.2015;2015;05;19;Perjantai;18;17;35;3;7;10
109;22.05.2015;2015;05;20;Perjantai;19;16;35;0;6;6
109;22.05.2015;2015;05;21;Perjantai;20;17;37;2;5;7
109;22.05.2015;2015;05;22;Perjantai;13;11;24;2;3;5
109;22.05.2015;2015;05;23;Perjantai;7;5;12;0;3;3
109;23.05.2015;2015;05;00;Lauantai;2;0;2;0;0;0
109;23.05.2015;2015;05;01;Lauantai;6;4;10;0;2;2
109;23.05.2015;2015;05;02;Lauantai;4;0;4;0;0;0
109;23.05.2015;2015;05;03;Lauantai;2;3;5;1;0;1
109;23.05.2015;2015;05;04;Lauantai;5;0;5;0;0;0
109;23.05.2015;2015;05;05;Lauantai;0;2;2;0;1;1
109;23.05.2015;2015;05;06;Lauantai;0;6;6;3;6;9
109;23.05.2015;2015;05;07;Lauantai;2;3;5;0;3;3
109;23.05.2015;2015;05;08;Lauantai;0;2;2;0;4;4
109;23.05.2015;2015;05;09;Lauantai;2;4;6;1;9;10
109;23.05.2015;2015;05;10;Lauantai;1;10;11;3;9;12
109;23.05.2015;2015;05;11;Lauantai;0;8;8;2;5;7
109;23.05.2015;2015;05;12;Lauantai;0;3;3;2;6;8
109;23.05.2015;2015;05;13;Lauantai;1;3;4;5;4;9
109;23.05.2015;2015;05;14;Lauantai;6;4;10;0;7;7
109;23.05.2015;2015;05;15;Lauantai;9;6;15;1;2;3
109;23.05.2015;2015;05;16;Lauantai;6;2;8;1;7;8
109;23.05.2015;2015;05;17;Lauantai;3;2;5;1;6;7
109;23.05.2015;2015;05;18;Lauantai;4;2;6;4;5;9
109;23.05.2015;2015;05;19;Lauantai;5;3;8;0;7;7
109;23.05.2015;2015;05;20;Lauantai;6;5;11;0;5;5
109;23.05.2015;2015;05;21;Lauantai;6;4;10;2;5;7
109;23.05.2015;2015;05;22;Lauantai;4;3;7;0;1;1
109;23.05.2015;2015;05;23;Lauantai;3;0;3;0;0;0
109;24.05.2015;2015;05;00;Sunnuntai;3;2;5;0;0;0
109;24.05.2015;2015;05;01;Sunnuntai;1;1;2;0;0;0
109;24.05.2015;2015;05;02;Sunnuntai;2;1;3;0;0;0
109;24.05.2015;2015;05;03;Sunnuntai;1;0;1;0;0;0
109;24.05.2015;2015;05;04;Sunnuntai;4;2;6;0;0;0
109;24.05.2015;2015;05;05;Sunnuntai;2;0;2;0;0;0
109;24.05.2015;2015;05;06;Sunnuntai;4;3;7;0;0;0
109;24.05.2015;2015;05;07;Sunnuntai;4;2;6;0;0;0
109;24.05.2015;2015;05;08;Sunnuntai;3;2;5;0;0;0
109;24.05.2015;2015;05;09;Sunnuntai;8;6;14;0;0;0
109;24.05.2015;2015;05;10;Sunnuntai;13;9;22;0;0;0
109;24.05.2015;2015;05;11;Sunnuntai;10;10;20;9;7;16
109;24.05.2015;2015;05;12;Sunnuntai;14;13;27;2;5;7
109;24.05.2015;2015;05;13;Sunnuntai;5;39;44;2;6;8
109;24.05.2015;2015;05;14;Sunnuntai;4;31;35;0;9;9
109;24.05.2015;2015;05;15;Sunnuntai;15;23;38;5;4;9
109;24.05.2015;2015;05;16;Sunnuntai;12;18;30;2;4;6
109;24.05.2015;2015;05;17;Sunnuntai;3;17;20;2;8;10
109;24.05.2015;2015;05;18;Sunnuntai;7;28;35;1;5;6
109;24.05.2015;2015;05;19;Sunnuntai;4;25;29;1;12;13
109;24.05.2015;2015;05;20;Sunnuntai;3;19;22;2;10;12
109;24.05.2015;2015;05;21;Sunnuntai;6;14;20;0;4;4
109;24.05.2015;2015;05;22;Sunnuntai;0;2;2;0;1;1
109;24.05.2015;2015;05;23;Sunnuntai;2;2;4;2;1;3
109;25.05.2015;2015;05;00;Maanantai;0;0;0;0;1;1
109;25.05.2015;2015;05;01;Maanantai;0;0;0;0;0;0
109;25.05.2015;2015;05;02;Maanantai;0;0;0;1;0;1
109;25.05.2015;2015;05;03;Maanantai;0;0;0;0;0;0
109;25.05.2015;2015;05;04;Maanantai;0;3;3;0;0;0
109;25.05.2015;2015;05;05;Maanantai;9;9;18;0;1;1
109;25.05.2015;2015;05;06;Maanantai;8;40;48;1;2;3
109;25.05.2015;2015;05;07;Maanantai;25;118;143;2;7;9
109;25.05.2015;2015;05;08;Maanantai;19;97;116;0;9;9
109;25.05.2015;2015;05;09;Maanantai;8;28;36;1;9;10
109;25.05.2015;2015;05;10;Maanantai;7;23;30;1;6;7
109;25.05.2015;2015;05;11;Maanantai;7;21;28;1;4;5
109;25.05.2015;2015;05;12;Maanantai;7;26;33;0;6;6
109;25.05.2015;2015;05;13;Maanantai;15;39;54;4;5;9
109;25.05.2015;2015;05;14;Maanantai;11;51;62;0;6;6
109;25.05.2015;2015;05;15;Maanantai;22;80;102;0;11;11
109;25.05.2015;2015;05;16;Maanantai;31;123;154;1;7;8
109;25.05.2015;2015;05;17;Maanantai;11;48;59;4;8;12
109;25.05.2015;2015;05;18;Maanantai;10;29;39;1;4;5
109;25.05.2015;2015;05;19;Maanantai;12;32;44;1;9;10
109;25.05.2015;2015;05;20;Maanantai;9;23;32;1;10;11
109;25.05.2015;2015;05;21;Maanantai;6;12;18;1;3;4
109;25.05.2015;2015;05;22;Maanantai;1;13;14;0;3;3
109;25.05.2015;2015;05;23;Maanantai;0;5;5;0;1;1
109;26.05.2015;2015;05;00;Tiistai;0;1;1;1;0;1
109;26.05.2015;2015;05;01;Tiistai;0;0;0;0;0;0
109;26.05.2015;2015;05;02;Tiistai;0;0;0;0;1;1
109;26.05.2015;2015;05;03;Tiistai;0;0;0;0;1;1
109;26.05.2015;2015;05;04;Tiistai;0;3;3;0;0;0
109;26.05.2015;2015;05;05;Tiistai;4;13;17;1;0;1
109;26.05.2015;2015;05;06;Tiistai;6;37;43;0;3;3
109;26.05.2015;2015;05;07;Tiistai;8;102;110;1;5;6
109;26.05.2015;2015;05;08;Tiistai;8;79;87;2;3;5
109;26.05.2015;2015;05;09;Tiistai;6;20;26;1;1;2
109;26.05.2015;2015;05;10;Tiistai;2;18;20;1;4;5
109;26.05.2015;2015;05;11;Tiistai;12;26;38;0;9;9
109;26.05.2015;2015;05;12;Tiistai;1;31;32;5;3;8
109;26.05.2015;2015;05;13;Tiistai;13;29;42;2;4;6
109;26.05.2015;2015;05;14;Tiistai;14;31;45;2;5;7
109;26.05.2015;2015;05;15;Tiistai;15;69;84;5;4;9
109;26.05.2015;2015;05;16;Tiistai;39;91;130;0;7;7
109;26.05.2015;2015;05;17;Tiistai;14;57;71;2;6;8
109;26.05.2015;2015;05;18;Tiistai;9;39;48;2;10;12
109;26.05.2015;2015;05;19;Tiistai;3;29;32;3;7;10
109;26.05.2015;2015;05;20;Tiistai;6;26;32;4;16;20
109;26.05.2015;2015;05;21;Tiistai;6;10;16;1;2;3
109;26.05.2015;2015;05;22;Tiistai;6;8;14;2;1;3
109;26.05.2015;2015;05;23;Tiistai;1;2;3;0;0;0
109;27.05.2015;2015;05;00;Keskiviikko;1;1;2;0;0;0
109;27.05.2015;2015;05;01;Keskiviikko;0;0;0;0;0;0
109;27.05.2015;2015;05;02;Keskiviikko;0;0;0;0;0;0
109;27.05.2015;2015;05;03;Keskiviikko;2;0;2;0;0;0
109;27.05.2015;2015;05;04;Keskiviikko;0;3;3;0;1;1
109;27.05.2015;2015;05;05;Keskiviikko;5;11;16;0;0;0
109;27.05.2015;2015;05;06;Keskiviikko;5;39;44;0;1;1
109;27.05.2015;2015;05;07;Keskiviikko;17;83;100;1;8;9
109;27.05.2015;2015;05;08;Keskiviikko;7;81;88;1;10;11
109;27.05.2015;2015;05;09;Keskiviikko;7;22;29;2;4;6
109;27.05.2015;2015;05;10;Keskiviikko;3;17;20;1;2;3
109;27.05.2015;2015;05;11;Keskiviikko;5;24;29;1;4;5
109;27.05.2015;2015;05;12;Keskiviikko;4;9;13;1;2;3
109;27.05.2015;2015;05;13;Keskiviikko;7;25;32;0;1;1
109;27.05.2015;2015;05;14;Keskiviikko;10;18;28;0;1;1
109;27.05.2015;2015;05;15;Keskiviikko;7;64;71;2;6;8
109;27.05.2015;2015;05;16;Keskiviikko;19;90;109;1;10;11
109;27.05.2015;2015;05;17;Keskiviikko;12;49;61;3;8;11
109;27.05.2015;2015;05;18;Keskiviikko;12;29;41;1;6;7
109;27.05.2015;2015;05;19;Keskiviikko;8;20;28;4;6;10
109;27.05.2015;2015;05;20;Keskiviikko;6;24;30;3;12;15
109;27.05.2015;2015;05;21;Keskiviikko;3;15;18;0;9;9
109;27.05.2015;2015;05;22;Keskiviikko;2;12;14;0;0;0
109;27.05.2015;2015;05;23;Keskiviikko;0;3;3;1;0;1
109;28.05.2015;2015;05;00;Torstai;1;2;3;1;0;1
109;28.05.2015;2015;05;01;Torstai;0;0;0;2;2;4
109;28.05.2015;2015;05;02;Torstai;1;2;3;0;0;0
109;28.05.2015;2015;05;03;Torstai;0;1;1;0;0;0
109;28.05.2015;2015;05;04;Torstai;0;2;2;0;0;0
109;28.05.2015;2015;05;05;Torstai;4;12;16;0;0;0
109;28.05.2015;2015;05;06;Torstai;9;37;46;1;4;5
109;28.05.2015;2015;05;07;Torstai;23;119;142;2;5;7
109;28.05.2015;2015;05;08;Torstai;9;79;88;2;2;4
109;28.05.2015;2015;05;09;Torstai;3;32;35;1;5;6
109;28.05.2015;2015;05;10;Torstai;5;16;21;2;8;10
109;28.05.2015;2015;05;11;Torstai;5;19;24;3;2;5
109;28.05.2015;2015;05;12;Torstai;22;43;65;1;2;3
109;28.05.2015;2015;05;13;Torstai;18;36;54;1;4;5
109;28.05.2015;2015;05;14;Torstai;20;46;66;3;5;8
109;28.05.2015;2015;05;15;Torstai;18;65;83;1;3;4
109;28.05.2015;2015;05;16;Torstai;37;84;121;2;4;6
109;28.05.2015;2015;05;17;Torstai;31;42;73;6;4;10
109;28.05.2015;2015;05;18;Torstai;5;37;42;4;7;11
109;28.05.2015;2015;05;19;Torstai;11;37;48;3;7;10
109;28.05.2015;2015;05;20;Torstai;12;19;31;4;9;13
109;28.05.2015;2015;05;21;Torstai;6;17;23;0;7;7
109;28.05.2015;2015;05;22;Torstai;5;12;17;1;1;2
109;28.05.2015;2015;05;23;Torstai;0;2;2;1;0;1
109;29.05.2015;2015;05;00;Perjantai;1;4;5;0;4;4
109;29.05.2015;2015;05;01;Perjantai;0;2;2;0;1;1
109;29.05.2015;2015;05;02;Perjantai;0;0;0;0;1;1
109;29.05.2015;2015;05;03;Perjantai;0;1;1;0;0;0
109;29.05.2015;2015;05;04;Perjantai;1;2;3;0;0;0
109;29.05.2015;2015;05;05;Perjantai;10;6;16;0;1;1
109;29.05.2015;2015;05;06;Perjantai;5;31;36;2;1;3
109;29.05.2015;2015;05;07;Perjantai;20;96;116;4;6;10
109;29.05.2015;2015;05;08;Perjantai;19;80;99;1;6;7
109;29.05.2015;2015;05;09;Perjantai;5;31;36;1;0;1
109;29.05.2015;2015;05;10;Perjantai;5;27;32;0;5;5
109;29.05.2015;2015;05;11;Perjantai;8;34;42;2;6;8
109;29.05.2015;2015;05;12;Perjantai;14;33;47;4;3;7
109;29.05.2015;2015;05;13;Perjantai;19;41;60;0;4;4
109;29.05.2015;2015;05;14;Perjantai;22;41;63;3;4;7
109;29.05.2015;2015;05;15;Perjantai;18;80;98;1;5;6
109;29.05.2015;2015;05;16;Perjantai;28;72;100;1;6;7
109;29.05.2015;2015;05;17;Perjantai;11;40;51;1;2;3
109;29.05.2015;2015;05;18;Perjantai;11;17;28;2;14;16
109;29.05.2015;2015;05;19;Perjantai;7;20;27;0;6;6
109;29.05.2015;2015;05;20;Perjantai;3;13;16;0;6;6
109;29.05.2015;2015;05;21;Perjantai;2;5;7;0;1;1
109;29.05.2015;2015;05;22;Perjantai;2;5;7;4;1;5
109;29.05.2015;2015;05;23;Perjantai;2;2;4;0;0;0
109;30.05.2015;2015;05;00;Lauantai;1;1;2;0;0;0
109;30.05.2015;2015;05;01;Lauantai;2;1;3;1;0;1
109;30.05.2015;2015;05;02;Lauantai;1;0;1;0;0;0
109;30.05.2015;2015;05;03;Lauantai;1;1;2;0;0;0
109;30.05.2015;2015;05;04;Lauantai;5;1;6;0;0;0
109;30.05.2015;2015;05;05;Lauantai;1;3;4;1;1;2
109;30.05.2015;2015;05;06;Lauantai;1;7;8;0;1;1
109;30.05.2015;2015;05;07;Lauantai;1;10;11;2;3;5
109;30.05.2015;2015;05;08;Lauantai;1;10;11;2;7;9
109;30.05.2015;2015;05;09;Lauantai;2;8;10;1;3;4
109;30.05.2015;2015;05;10;Lauantai;3;26;29;1;4;5
109;30.05.2015;2015;05;11;Lauantai;3;30;33;2;6;8
109;30.05.2015;2015;05;12;Lauantai;8;27;35;1;5;6
109;30.05.2015;2015;05;13;Lauantai;4;23;27;3;5;8
109;30.05.2015;2015;05;14;Lauantai;7;28;35;1;9;10
109;30.05.2015;2015;05;15;Lauantai;10;23;33;2;4;6
109;30.05.2015;2015;05;16;Lauantai;8;25;33;4;5;9
109;30.05.2015;2015;05;17;Lauantai;11;16;27;2;3;5
109;30.05.2015;2015;05;18;Lauantai;5;22;27;1;5;6
109;30.05.2015;2015;05;19;Lauantai;5;23;28;2;2;4
109;30.05.2015;2015;05;20;Lauantai;4;23;27;0;2;2
109;30.05.2015;2015;05;21;Lauantai;6;9;15;1;2;3
109;30.05.2015;2015;05;22;Lauantai;17;21;38;3;0;3
109;30.05.2015;2015;05;23;Lauantai;0;4;4;0;3;3
109;31.05.2015;2015;05;00;Sunnuntai;5;5;10;1;0;1
109;31.05.2015;2015;05;01;Sunnuntai;8;5;13;0;1;1
109;31.05.2015;2015;05;02;Sunnuntai;5;3;8;0;0;0
109;31.05.2015;2015;05;03;Sunnuntai;2;2;4;1;1;2
109;31.05.2015;2015;05;04;Sunnuntai;7;0;7;0;1;1
109;31.05.2015;2015;05;05;Sunnuntai;2;1;3;0;1;1
109;31.05.2015;2015;05;06;Sunnuntai;0;3;3;0;1;1
109;31.05.2015;2015;05;07;Sunnuntai;2;4;6;1;2;3
109;31.05.2015;2015;05;08;Sunnuntai;3;4;7;3;5;8
109;31.05.2015;2015;05;09;Sunnuntai;4;10;14;2;3;5
109;31.05.2015;2015;05;10;Sunnuntai;2;16;18;5;11;16
109;31.05.2015;2015;05;11;Sunnuntai;2;14;16;2;5;7
109;31.05.2015;2015;05;12;Sunnuntai;7;14;21;2;3;5
109;31.05.2015;2015;05;13;Sunnuntai;3;9;12;2;6;8
109;31.05.2015;2015;05;14;Sunnuntai;3;10;13;0;6;6
109;31.05.2015;2015;05;15;Sunnuntai;6;14;20;0;5;5
109;31.05.2015;2015;05;16;Sunnuntai;5;10;15;3;3;6
109;31.05.2015;2015;05;17;Sunnuntai;3;13;16;0;8;8
109;31.05.2015;2015;05;18;Sunnuntai;1;14;15;2;6;8
109;31.05.2015;2015;05;19;Sunnuntai;2;12;14;0;9;9
109;31.05.2015;2015;05;20;Sunnuntai;2;2;4;2;5;7
109;31.05.2015;2015;05;21;Sunnuntai;3;6;9;1;5;6
109;31.05.2015;2015;05;22;Sunnuntai;2;6;8;0;2;2
109;31.05.2015;2015;05;23;Sunnuntai;1;0;1;1;0;1
109;01.06.2015;2015;06;00;Maanantai;0;0;0;0;2;2
109;01.06.2015;2015;06;01;Maanantai;1;2;3;0;0;0
109;01.06.2015;2015;06;02;Maanantai;0;3;3;0;0;0
109;01.06.2015;2015;06;03;Maanantai;0;0;0;0;0;0
109;01.06.2015;2015;06;04;Maanantai;1;1;2;0;0;0
109;01.06.2015;2015;06;05;Maanantai;8;6;14;0;1;1
109;01.06.2015;2015;06;06;Maanantai;13;39;52;1;1;2
109;01.06.2015;2015;06;07;Maanantai;20;103;123;2;6;8
109;01.06.2015;2015;06;08;Maanantai;11;79;90;0;8;8
109;01.06.2015;2015;06;09;Maanantai;1;31;32;0;1;1
109;01.06.2015;2015;06;10;Maanantai;2;9;11;0;1;1
109;01.06.2015;2015;06;11;Maanantai;7;22;29;2;2;4
109;01.06.2015;2015;06;12;Maanantai;8;20;28;2;7;9
109;01.06.2015;2015;06;13;Maanantai;8;17;25;0;3;3
109;01.06.2015;2015;06;14;Maanantai;7;31;38;2;1;3
109;01.06.2015;2015;06;15;Maanantai;24;76;100;2;3;5
109;01.06.2015;2015;06;16;Maanantai;29;102;131;0;8;8
109;01.06.2015;2015;06;17;Maanantai;9;32;41;3;2;5
109;01.06.2015;2015;06;18;Maanantai;7;15;22;1;1;2
109;01.06.2015;2015;06;19;Maanantai;8;8;16;1;7;8
109;01.06.2015;2015;06;20;Maanantai;1;15;16;0;5;5
109;01.06.2015;2015;06;21;Maanantai;7;6;13;1;7;8
109;01.06.2015;2015;06;22;Maanantai;6;14;20;2;1;3
109;01.06.2015;2015;06;23;Maanantai;2;3;5;0;2;2
109;02.06.2015;2015;06;00;Tiistai;0;1;1;0;1;1
109;02.06.2015;2015;06;01;Tiistai;0;4;4;0;2;2
109;02.06.2015;2015;06;02;Tiistai;0;0;0;0;0;0
109;02.06.2015;2015;06;03;Tiistai;0;0;0;1;0;1
109;02.06.2015;2015;06;04;Tiistai;1;2;3;0;0;0
109;02.06.2015;2015;06;05;Tiistai;7;6;13;2;1;3
109;02.06.2015;2015;06;06;Tiistai;11;37;48;1;1;2
109;02.06.2015;2015;06;07;Tiistai;29;106;135;3;5;8
109;02.06.2015;2015;06;08;Tiistai;17;78;95;2;3;5
109;02.06.2015;2015;06;09;Tiistai;8;28;36;3;2;5
109;02.06.2015;2015;06;10;Tiistai;5;23;28;4;3;7
109;02.06.2015;2015;06;11;Tiistai;7;22;29;2;3;5
109;02.06.2015;2015;06;12;Tiistai;11;32;43;1;1;2
109;02.06.2015;2015;06;13;Tiistai;5;32;37;0;4;4
109;02.06.2015;2015;06;14;Tiistai;11;27;38;4;4;8
109;02.06.2015;2015;06;15;Tiistai;47;48;95;4;4;8
109;02.06.2015;2015;06;16;Tiistai;72;88;160;2;2;4
109;02.06.2015;2015;06;17;Tiistai;30;61;91;2;7;9
109;02.06.2015;2015;06;18;Tiistai;13;37;50;4;13;17
109;02.06.2015;2015;06;19;Tiistai;13;28;41;5;5;10
109;02.06.2015;2015;06;20;Tiistai;9;18;27;2;7;9
109;02.06.2015;2015;06;21;Tiistai;14;13;27;5;2;7
109;02.06.2015;2015;06;22;Tiistai;3;15;18;2;2;4
109;02.06.2015;2015;06;23;Tiistai;2;6;8;2;0;2
109;03.06.2015;2015;06;00;Keskiviikko;3;4;7;0;0;0
109;03.06.2015;2015;06;01;Keskiviikko;0;3;3;1;1;2
109;03.06.2015;2015;06;02;Keskiviikko;0;0;0;0;0;0
109;03.06.2015;2015;06;03;Keskiviikko;1;1;2;0;0;0
109;03.06.2015;2015;06;04;Keskiviikko;1;3;4;0;0;0
109;03.06.2015;2015;06;05;Keskiviikko;6;3;9;0;0;0
109;03.06.2015;2015;06;06;Keskiviikko;7;24;31;1;1;2
109;03.06.2015;2015;06;07;Keskiviikko;19;67;86;1;4;5
109;03.06.2015;2015;06;08;Keskiviikko;7;41;48;1;2;3
109;03.06.2015;2015;06;09;Keskiviikko;2;14;16;0;2;2
109;03.06.2015;2015;06;10;Keskiviikko;1;6;7;3;2;5
109;03.06.2015;2015;06;11;Keskiviikko;2;10;12;0;0;0
109;03.06.2015;2015;06;12;Keskiviikko;1;10;11;1;2;3
109;03.06.2015;2015;06;13;Keskiviikko;5;18;23;1;7;8
109;03.06.2015;2015;06;14;Keskiviikko;3;17;20;2;0;2
109;03.06.2015;2015;06;15;Keskiviikko;19;27;46;2;1;3
109;03.06.2015;2015;06;16;Keskiviikko;24;58;82;1;6;7
109;03.06.2015;2015;06;17;Keskiviikko;14;24;38;5;3;8
109;03.06.2015;2015;06;18;Keskiviikko;12;10;22;4;6;10
109;03.06.2015;2015;06;19;Keskiviikko;8;16;24;4;4;8
109;03.06.2015;2015;06;20;Keskiviikko;8;14;22;1;6;7
109;03.06.2015;2015;06;21;Keskiviikko;4;15;19;1;7;8
109;03.06.2015;2015;06;22;Keskiviikko;3;9;12;1;0;1
109;03.06.2015;2015;06;23;Keskiviikko;0;3;3;1;2;3
109;04.06.2015;2015;06;00;Torstai;1;4;5;0;0;0
109;04.06.2015;2015;06;01;Torstai;0;1;1;0;0;0
109;04.06.2015;2015;06;02;Torstai;0;1;1;0;0;0
109;04.06.2015;2015;06;03;Torstai;0;0;0;0;0;0
109;04.06.2015;2015;06;04;Torstai;1;4;5;0;0;0
109;04.06.2015;2015;06;05;Torstai;2;7;9;0;0;0
109;04.06.2015;2015;06;06;Torstai;10;34;44;3;2;5
109;04.06.2015;2015;06;07;Torstai;15;95;110;2;3;5
109;04.06.2015;2015;06;08;Torstai;14;77;91;3;2;5
109;04.06.2015;2015;06;09;Torstai;7;28;35;2;6;8
109;04.06.2015;2015;06;10;Torstai;3;19;22;1;9;10
109;04.06.2015;2015;06;11;Torstai;3;43;46;1;6;7
109;04.06.2015;2015;06;12;Torstai;7;61;68;1;6;7
109;04.06.2015;2015;06;13;Torstai;13;35;48;0;2;2
109;04.06.2015;2015;06;14;Torstai;12;59;71;0;5;5
109;04.06.2015;2015;06;15;Torstai;43;55;98;4;5;9
109;04.06.2015;2015;06;16;Torstai;43;102;145;3;5;8
109;04.06.2015;2015;06;17;Torstai;29;46;75;3;4;7
109;04.06.2015;2015;06;18;Torstai;11;30;41;3;9;12
109;04.06.2015;2015;06;19;Torstai;16;29;45;6;4;10
109;04.06.2015;2015;06;20;Torstai;11;17;28;5;7;12
109;04.06.2015;2015;06;21;Torstai;11;15;26;3;7;10
109;04.06.2015;2015;06;22;Torstai;5;12;17;0;1;1
109;04.06.2015;2015;06;23;Torstai;5;7;12;0;1;1
109;05.06.2015;2015;06;00;Perjantai;0;1;1;2;0;2
109;05.06.2015;2015;06;01;Perjantai;0;0;0;0;0;0
109;05.06.2015;2015;06;02;Perjantai;0;1;1;0;0;0
109;05.06.2015;2015;06;03;Perjantai;0;1;1;0;0;0
109;05.06.2015;2015;06;04;Perjantai;1;2;3;0;0;0
109;05.06.2015;2015;06;05;Perjantai;7;8;15;1;0;1
109;05.06.2015;2015;06;06;Perjantai;7;37;44;2;5;7
109;05.06.2015;2015;06;07;Perjantai;32;89;121;3;6;9
109;05.06.2015;2015;06;08;Perjantai;21;61;82;2;3;5
109;05.06.2015;2015;06;09;Perjantai;7;29;36;2;4;6
109;05.06.2015;2015;06;10;Perjantai;5;19;24;2;4;6
109;05.06.2015;2015;06;11;Perjantai;7;20;27;1;2;3
109;05.06.2015;2015;06;12;Perjantai;8;13;21;4;1;5
109;05.06.2015;2015;06;13;Perjantai;27;31;58;4;0;4
109;05.06.2015;2015;06;14;Perjantai;26;44;70;4;4;8
109;05.06.2015;2015;06;15;Perjantai;39;54;93;6;5;11
109;05.06.2015;2015;06;16;Perjantai;41;55;96;5;2;7
109;05.06.2015;2015;06;17;Perjantai;23;27;50;4;4;8
109;05.06.2015;2015;06;18;Perjantai;15;15;30;5;8;13
109;05.06.2015;2015;06;19;Perjantai;6;16;22;4;6;10
109;05.06.2015;2015;06;20;Perjantai;8;19;27;1;3;4
109;05.06.2015;2015;06;21;Perjantai;4;18;22;1;3;4
109;05.06.2015;2015;06;22;Perjantai;8;10;18;1;0;1
109;05.06.2015;2015;06;23;Perjantai;4;9;13;1;0;1
109;06.06.2015;2015;06;00;Lauantai;2;3;5;0;0;0
109;06.06.2015;2015;06;01;Lauantai;0;3;3;0;1;1
109;06.06.2015;2015;06;02;Lauantai;8;2;10;0;0;0
109;06.06.2015;2015;06;03;Lauantai;2;0;2;0;0;0
109;06.06.2015;2015;06;04;Lauantai;0;1;1;0;0;0
109;06.06.2015;2015;06;05;Lauantai;2;1;3;0;1;1
109;06.06.2015;2015;06;06;Lauantai;1;6;7;0;3;3
109;06.06.2015;2015;06;07;Lauantai;2;1;3;2;2;4
109;06.06.2015;2015;06;08;Lauantai;1;9;10;4;7;11
109;06.06.2015;2015;06;09;Lauantai;5;7;12;2;3;5
109;06.06.2015;2015;06;10;Lauantai;5;15;20;2;1;3
109;06.06.2015;2015;06;11;Lauantai;7;19;26;1;7;8
109;06.06.2015;2015;06;12;Lauantai;7;31;38;0;6;6
109;06.06.2015;2015;06;13;Lauantai;9;17;26;0;8;8
109;06.06.2015;2015;06;14;Lauantai;10;20;30;2;5;7
109;06.06.2015;2015;06;15;Lauantai;6;26;32;2;0;2
109;06.06.2015;2015;06;16;Lauantai;11;15;26;2;3;5
109;06.06.2015;2015;06;17;Lauantai;16;14;30;1;0;1
109;06.06.2015;2015;06;18;Lauantai;8;10;18;0;0;0
109;06.06.2015;2015;06;19;Lauantai;1;15;16;1;0;1
109;06.06.2015;2015;06;20;Lauantai;1;4;5;0;1;1
109;06.06.2015;2015;06;21;Lauantai;2;5;7;0;1;1
109;06.06.2015;2015;06;22;Lauantai;3;2;5;1;1;2
109;06.06.2015;2015;06;23;Lauantai;0;3;3;1;0;1
109;07.06.2015;2015;06;00;Sunnuntai;0;4;4;1;0;1
109;07.06.2015;2015;06;01;Sunnuntai;0;0;0;0;0;0
109;07.06.2015;2015;06;02;Sunnuntai;0;0;0;0;0;0
109;07.06.2015;2015;06;03;Sunnuntai;1;0;1;0;0;0
109;07.06.2015;2015;06;04;Sunnuntai;1;2;3;0;0;0
109;07.06.2015;2015;06;05;Sunnuntai;0;1;1;0;0;0
109;07.06.2015;2015;06;06;Sunnuntai;0;0;0;0;0;0
109;07.06.2015;2015;06;07;Sunnuntai;0;3;3;1;1;2
109;07.06.2015;2015;06;08;Sunnuntai;1;4;5;1;1;2
109;07.06.2015;2015;06;09;Sunnuntai;0;1;1;1;5;6
109;07.06.2015;2015;06;10;Sunnuntai;0;2;2;1;2;3
109;07.06.2015;2015;06;11;Sunnuntai;0;5;5;1;3;4
109;07.06.2015;2015;06;12;Sunnuntai;0;4;4;2;2;4
109;07.06.2015;2015;06;13;Sunnuntai;0;0;0;0;5;5
109;07.06.2015;2015;06;14;Sunnuntai;0;1;1;0;3;3
109;07.06.2015;2015;06;15;Sunnuntai;0;5;5;0;1;1
109;07.06.2015;2015;06;16;Sunnuntai;2;6;8;0;3;3
109;07.06.2015;2015;06;17;Sunnuntai;0;4;4;1;4;5
109;07.06.2015;2015;06;18;Sunnuntai;1;0;1;2;2;4
109;07.06.2015;2015;06;19;Sunnuntai;1;1;2;2;0;2
109;07.06.2015;2015;06;20;Sunnuntai;0;3;3;2;3;5
109;07.06.2015;2015;06;21;Sunnuntai;3;2;5;1;1;2
109;07.06.2015;2015;06;22;Sunnuntai;0;3;3;1;0;1
109;07.06.2015;2015;06;23;Sunnuntai;0;1;1;1;3;4
109;08.06.2015;2015;06;00;Maanantai;0;0;0;1;1;2
109;08.06.2015;2015;06;01;Maanantai;0;0;0;1;0;1
109;08.06.2015;2015;06;02;Maanantai;0;0;0;0;0;0
109;08.06.2015;2015;06;03;Maanantai;0;0;0;0;0;0
109;08.06.2015;2015;06;04;Maanantai;0;4;4;0;0;0
109;08.06.2015;2015;06;05;Maanantai;3;9;12;0;2;2
109;08.06.2015;2015;06;06;Maanantai;4;41;45;1;2;3
109;08.06.2015;2015;06;07;Maanantai;14;103;117;5;3;8
109;08.06.2015;2015;06;08;Maanantai;5;63;68;0;6;6
109;08.06.2015;2015;06;09;Maanantai;1;29;30;6;7;13
109;08.06.2015;2015;06;10;Maanantai;4;20;24;4;5;9
109;08.06.2015;2015;06;11;Maanantai;4;21;25;1;6;7
109;08.06.2015;2015;06;12;Maanantai;3;34;37;0;6;6
109;08.06.2015;2015;06;13;Maanantai;12;28;40;2;5;7
109;08.06.2015;2015;06;14;Maanantai;14;32;46;2;3;5
109;08.06.2015;2015;06;15;Maanantai;24;59;83;2;5;7
109;08.06.2015;2015;06;16;Maanantai;27;93;120;4;3;7
109;08.06.2015;2015;06;17;Maanantai;29;53;82;4;5;9
109;08.06.2015;2015;06;18;Maanantai;13;29;42;1;8;9
109;08.06.2015;2015;06;19;Maanantai;4;21;25;3;7;10
109;08.06.2015;2015;06;20;Maanantai;8;24;32;8;9;17
109;08.06.2015;2015;06;21;Maanantai;11;17;28;1;5;6
109;08.06.2015;2015;06;22;Maanantai;0;14;14;1;1;2
109;08.06.2015;2015;06;23;Maanantai;2;4;6;0;1;1
109;09.06.2015;2015;06;00;Tiistai;3;3;6;0;0;0
109;09.06.2015;2015;06;01;Tiistai;2;0;2;0;0;0
109;09.06.2015;2015;06;02;Tiistai;1;0;1;0;0;0
109;09.06.2015;2015;06;03;Tiistai;0;0;0;0;0;0
109;09.06.2015;2015;06;04;Tiistai;1;1;2;0;0;0
109;09.06.2015;2015;06;05;Tiistai;6;6;12;0;0;0
109;09.06.2015;2015;06;06;Tiistai;8;60;68;0;3;3
109;09.06.2015;2015;06;07;Tiistai;32;96;128;3;3;6
109;09.06.2015;2015;06;08;Tiistai;17;76;93;0;3;3
109;09.06.2015;2015;06;09;Tiistai;7;27;34;3;9;12
109;09.06.2015;2015;06;10;Tiistai;6;12;18;2;4;6
109;09.06.2015;2015;06;11;Tiistai;7;19;26;1;4;5
109;09.06.2015;2015;06;12;Tiistai;12;23;35;2;4;6
109;09.06.2015;2015;06;13;Tiistai;9;24;33;1;0;1
109;09.06.2015;2015;06;14;Tiistai;24;23;47;1;3;4
109;09.06.2015;2015;06;15;Tiistai;53;37;90;4;6;10
109;09.06.2015;2015;06;16;Tiistai;76;89;165;4;5;9
109;09.06.2015;2015;06;17;Tiistai;41;51;92;4;3;7
109;09.06.2015;2015;06;18;Tiistai;15;18;33;4;8;12
109;09.06.2015;2015;06;19;Tiistai;15;19;34;7;6;13
109;09.06.2015;2015;06;20;Tiistai;13;17;30;5;3;8
109;09.06.2015;2015;06;21;Tiistai;11;12;23;5;1;6
109;09.06.2015;2015;06;22;Tiistai;2;16;18;1;1;2
109;09.06.2015;2015;06;23;Tiistai;0;10;10;0;0;0
109;10.06.2015;2015;06;00;Keskiviikko;0;8;8;0;2;2
109;10.06.2015;2015;06;01;Keskiviikko;1;6;7;1;0;1
109;10.06.2015;2015;06;02;Keskiviikko;1;1;2;1;0;1
109;10.06.2015;2015;06;03;Keskiviikko;0;0;0;0;1;1
109;10.06.2015;2015;06;04;Keskiviikko;0;3;3;0;0;0
109;10.06.2015;2015;06;05;Keskiviikko;4;4;8;1;1;2
109;10.06.2015;2015;06;06;Keskiviikko;8;43;51;3;3;6
109;10.06.2015;2015;06;07;Keskiviikko;24;91;115;3;4;7
109;10.06.2015;2015;06;08;Keskiviikko;7;49;56;2;1;3
109;10.06.2015;2015;06;09;Keskiviikko;7;12;19;0;0;0
109;10.06.2015;2015;06;10;Keskiviikko;7;12;19;1;1;2
109;10.06.2015;2015;06;11;Keskiviikko;2;5;7;3;1;4
109;10.06.2015;2015;06;12;Keskiviikko;4;17;21;2;2;4
109;10.06.2015;2015;06;13;Keskiviikko;10;17;27;3;4;7
109;10.06.2015;2015;06;14;Keskiviikko;13;23;36;2;3;5
109;10.06.2015;2015;06;15;Keskiviikko;30;45;75;4;4;8
109;10.06.2015;2015;06;16;Keskiviikko;65;63;128;1;3;4
109;10.06.2015;2015;06;17;Keskiviikko;20;30;50;2;5;7
109;10.06.2015;2015;06;18;Keskiviikko;9;33;42;6;13;19
109;10.06.2015;2015;06;19;Keskiviikko;7;22;29;3;5;8
109;10.06.2015;2015;06;20;Keskiviikko;8;20;28;1;7;8
109;10.06.2015;2015;06;21;Keskiviikko;9;13;22;1;3;4
109;10.06.2015;2015;06;22;Keskiviikko;0;15;15;1;1;2
109;10.06.2015;2015;06;23;Keskiviikko;2;2;4;3;1;4
109;11.06.2015;2015;06;00;Torstai;2;3;5;0;0;0
109;11.06.2015;2015;06;01;Torstai;1;3;4;0;1;1
109;11.06.2015;2015;06;02;Torstai;0;0;0;0;0;0
109;11.06.2015;2015;06;03;Torstai;0;1;1;0;0;0
109;11.06.2015;2015;06;04;Torstai;1;3;4;0;1;1
109;11.06.2015;2015;06;05;Torstai;3;8;11;0;2;2
109;11.06.2015;2015;06;06;Torstai;8;36;44;2;2;4
109;11.06.2015;2015;06;07;Torstai;27;90;117;4;3;7
109;11.06.2015;2015;06;08;Torstai;14;71;85;0;5;5
109;11.06.2015;2015;06;09;Torstai;13;18;31;1;8;9
109;11.06.2015;2015;06;10;Torstai;5;18;23;2;5;7
109;11.06.2015;2015;06;11;Torstai;13;11;24;2;8;10
109;11.06.2015;2015;06;12;Torstai;3;17;20;3;0;3
109;11.06.2015;2015;06;13;Torstai;12;20;32;1;5;6
109;11.06.2015;2015;06;14;Torstai;12;28;40;3;6;9
109;11.06.2015;2015;06;15;Torstai;38;44;82;2;3;5
109;11.06.2015;2015;06;16;Torstai;65;68;133;3;8;11
109;11.06.2015;2015;06;17;Torstai;33;37;70;6;3;9
109;11.06.2015;2015;06;18;Torstai;16;29;45;4;4;8
109;11.06.2015;2015;06;19;Torstai;7;24;31;2;7;9
109;11.06.2015;2015;06;20;Torstai;6;21;27;7;6;13
109;11.06.2015;2015;06;21;Torstai;8;8;16;3;3;6
109;11.06.2015;2015;06;22;Torstai;6;16;22;3;3;6
109;11.06.2015;2015;06;23;Torstai;1;5;6;0;1;1
109;12.06.2015;2015;06;00;Perjantai;1;2;3;0;0;0
109;12.06.2015;2015;06;01;Perjantai;0;1;1;0;0;0
109;12.06.2015;2015;06;02;Perjantai;1;1;2;0;0;0
109;12.06.2015;2015;06;03;Perjantai;0;2;2;0;0;0
109;12.06.2015;2015;06;04;Perjantai;1;2;3;0;0;0
109;12.06.2015;2015;06;05;Perjantai;10;9;19;1;3;4
109;12.06.2015;2015;06;06;Perjantai;9;38;47;1;1;2
109;12.06.2015;2015;06;07;Perjantai;25;71;96;3;5;8
109;12.06.2015;2015;06;08;Perjantai;16;52;68;1;3;4
109;12.06.2015;2015;06;09;Perjantai;7;21;28;4;1;5
109;12.06.2015;2015;06;10;Perjantai;7;19;26;3;1;4
109;12.06.2015;2015;06;11;Perjantai;7;19;26;1;5;6
109;12.06.2015;2015;06;12;Perjantai;12;30;42;0;1;1
109;12.06.2015;2015;06;13;Perjantai;24;26;50;3;1;4
109;12.06.2015;2015;06;14;Perjantai;26;51;77;2;4;6
109;12.06.2015;2015;06;15;Perjantai;37;42;79;5;7;12
109;12.06.2015;2015;06;16;Perjantai;38;65;103;4;4;8
109;12.06.2015;2015;06;17;Perjantai;26;24;50;1;8;9
109;12.06.2015;2015;06;18;Perjantai;7;20;27;4;3;7
109;12.06.2015;2015;06;19;Perjantai;6;16;22;5;5;10
109;12.06.2015;2015;06;20;Perjantai;11;9;20;4;8;12
109;12.06.2015;2015;06;21;Perjantai;5;21;26;3;2;5
109;12.06.2015;2015;06;22;Perjantai;7;14;21;2;1;3
109;12.06.2015;2015;06;23;Perjantai;3;18;21;2;1;3
109;13.06.2015;2015;06;00;Lauantai;2;1;3;0;0;0
109;13.06.2015;2015;06;01;Lauantai;0;1;1;0;0;0
109;13.06.2015;2015;06;02;Lauantai;1;2;3;0;0;0
109;13.06.2015;2015;06;03;Lauantai;5;3;8;0;0;0
109;13.06.2015;2015;06;04;Lauantai;2;0;2;0;0;0
109;13.06.2015;2015;06;05;Lauantai;2;3;5;0;3;3
109;13.06.2015;2015;06;06;Lauantai;1;5;6;0;0;0
109;13.06.2015;2015;06;07;Lauantai;2;5;7;2;1;3
109;13.06.2015;2015;06;08;Lauantai;1;6;7;1;3;4
109;13.06.2015;2015;06;09;Lauantai;5;10;15;1;3;4
109;13.06.2015;2015;06;10;Lauantai;7;11;18;1;3;4
109;13.06.2015;2015;06;11;Lauantai;4;11;15;0;1;1
109;13.06.2015;2015;06;12;Lauantai;5;12;17;6;5;11
109;13.06.2015;2015;06;13;Lauantai;6;23;29;1;2;3
109;13.06.2015;2015;06;14;Lauantai;3;18;21;2;5;7
109;13.06.2015;2015;06;15;Lauantai;12;22;34;3;8;11
109;13.06.2015;2015;06;16;Lauantai;7;10;17;3;2;5
109;13.06.2015;2015;06;17;Lauantai;7;13;20;2;4;6
109;13.06.2015;2015;06;18;Lauantai;9;20;29;3;3;6
109;13.06.2015;2015;06;19;Lauantai;8;11;19;4;4;8
109;13.06.2015;2015;06;20;Lauantai;7;14;21;2;3;5
109;13.06.2015;2015;06;21;Lauantai;8;8;16;2;6;8
109;13.06.2015;2015;06;22;Lauantai;3;6;9;1;1;2
109;13.06.2015;2015;06;23;Lauantai;2;1;3;0;1;1
109;14.06.2015;2015;06;00;Sunnuntai;0;0;0;1;0;1
109;14.06.2015;2015;06;01;Sunnuntai;3;0;3;0;0;0
109;14.06.2015;2015;06;02;Sunnuntai;0;3;3;0;0;0
109;14.06.2015;2015;06;03;Sunnuntai;3;0;3;0;0;0
109;14.06.2015;2015;06;04;Sunnuntai;1;2;3;0;0;0
109;14.06.2015;2015;06;05;Sunnuntai;0;3;3;1;1;2
109;14.06.2015;2015;06;06;Sunnuntai;0;2;2;0;0;0
109;14.06.2015;2015;06;07;Sunnuntai;2;1;3;3;1;4
109;14.06.2015;2015;06;08;Sunnuntai;2;4;6;0;3;3
109;14.06.2015;2015;06;09;Sunnuntai;4;11;15;2;5;7
109;14.06.2015;2015;06;10;Sunnuntai;7;12;19;2;3;5
109;14.06.2015;2015;06;11;Sunnuntai;5;21;26;3;3;6
109;14.06.2015;2015;06;12;Sunnuntai;11;32;43;3;8;11
109;14.06.2015;2015;06;13;Sunnuntai;17;22;39;4;5;9
109;14.06.2015;2015;06;14;Sunnuntai;18;21;39;4;1;5
109;14.06.2015;2015;06;15;Sunnuntai;20;20;40;3;4;7
109;14.06.2015;2015;06;16;Sunnuntai;15;27;42;9;9;18
109;14.06.2015;2015;06;17;Sunnuntai;14;18;32;5;2;7
109;14.06.2015;2015;06;18;Sunnuntai;5;27;32;4;5;9
109;14.06.2015;2015;06;19;Sunnuntai;2;10;12;2;5;7
109;14.06.2015;2015;06;20;Sunnuntai;3;14;17;1;3;4
109;14.06.2015;2015;06;21;Sunnuntai;8;19;27;4;1;5
109;14.06.2015;2015;06;22;Sunnuntai;11;7;18;2;2;4
109;14.06.2015;2015;06;23;Sunnuntai;1;4;5;0;1;1
109;15.06.2015;2015;06;00;Maanantai;0;2;2;1;2;3
109;15.06.2015;2015;06;01;Maanantai;3;0;3;0;0;0
109;15.06.2015;2015;06;02;Maanantai;0;1;1;0;0;0
109;15.06.2015;2015;06;03;Maanantai;0;0;0;0;0;0
109;15.06.2015;2015;06;04;Maanantai;1;0;1;0;0;0
109;15.06.2015;2015;06;05;Maanantai;4;11;15;0;0;0
109;15.06.2015;2015;06;06;Maanantai;4;25;29;1;1;2
109;15.06.2015;2015;06;07;Maanantai;12;49;61;0;3;3
109;15.06.2015;2015;06;08;Maanantai;1;28;29;2;2;4
109;15.06.2015;2015;06;09;Maanantai;4;11;15;1;1;2
109;15.06.2015;2015;06;10;Maanantai;1;22;23;1;2;3
109;15.06.2015;2015;06;11;Maanantai;1;8;9;0;1;1
109;15.06.2015;2015;06;12;Maanantai;1;17;18;0;0;0
109;15.06.2015;2015;06;13;Maanantai;0;6;6;0;2;2
109;15.06.2015;2015;06;14;Maanantai;1;12;13;3;0;3
109;15.06.2015;2015;06;15;Maanantai;5;40;45;1;6;7
109;15.06.2015;2015;06;16;Maanantai;11;52;63;1;3;4
109;15.06.2015;2015;06;17;Maanantai;10;28;38;2;2;4
109;15.06.2015;2015;06;18;Maanantai;5;9;14;0;2;2
109;15.06.2015;2015;06;19;Maanantai;4;3;7;1;1;2
109;15.06.2015;2015;06;20;Maanantai;2;8;10;0;3;3
109;15.06.2015;2015;06;21;Maanantai;2;4;6;3;2;5
109;15.06.2015;2015;06;22;Maanantai;1;5;6;0;3;3
109;15.06.2015;2015;06;23;Maanantai;0;3;3;1;0;1
109;16.06.2015;2015;06;00;Tiistai;1;3;4;0;1;1
109;16.06.2015;2015;06;01;Tiistai;0;0;0;0;0;0
109;16.06.2015;2015;06;02;Tiistai;0;0;0;0;0;0
109;16.06.2015;2015;06;03;Tiistai;1;1;2;1;0;1
109;16.06.2015;2015;06;04;Tiistai;1;2;3;0;0;0
109;16.06.2015;2015;06;05;Tiistai;8;5;13;1;1;2
109;16.06.2015;2015;06;06;Tiistai;12;21;33;2;0;2
109;16.06.2015;2015;06;07;Tiistai;39;31;70;2;1;3
109;16.06.2015;2015;06;08;Tiistai;18;33;51;3;2;5
109;16.06.2015;2015;06;09;Tiistai;10;16;26;1;3;4
109;16.06.2015;2015;06;10;Tiistai;28;6;34;2;0;2
109;16.06.2015;2015;06;11;Tiistai;6;8;14;3;4;7
109;16.06.2015;2015;06;12;Tiistai;44;10;54;11;3;14
109;16.06.2015;2015;06;13;Tiistai;13;9;22;3;2;5
109;16.06.2015;2015;06;14;Tiistai;1;14;15;1;3;4
109;16.06.2015;2015;06;15;Tiistai;7;44;51;1;3;4
109;16.06.2015;2015;06;16;Tiistai;29;45;74;1;4;5
109;16.06.2015;2015;06;17;Tiistai;23;30;53;3;7;10
109;16.06.2015;2015;06;18;Tiistai;11;19;30;3;6;9
109;16.06.2015;2015;06;19;Tiistai;2;20;22;0;9;9
109;16.06.2015;2015;06;20;Tiistai;4;6;10;4;8;12
109;16.06.2015;2015;06;21;Tiistai;16;4;20;2;6;8
109;16.06.2015;2015;06;22;Tiistai;7;6;13;1;2;3
109;16.06.2015;2015;06;23;Tiistai;3;5;8;1;1;2
109;17.06.2015;2015;06;00;Keskiviikko;0;3;3;1;1;2
109;17.06.2015;2015;06;01;Keskiviikko;0;0;0;0;0;0
109;17.06.2015;2015;06;02;Keskiviikko;0;0;0;0;0;0
109;17.06.2015;2015;06;03;Keskiviikko;0;0;0;0;0;0
109;17.06.2015;2015;06;04;Keskiviikko;0;3;3;0;0;0
109;17.06.2015;2015;06;05;Keskiviikko;10;7;17;1;1;2
109;17.06.2015;2015;06;06;Keskiviikko;20;31;51;1;3;4
109;17.06.2015;2015;06;07;Keskiviikko;42;62;104;2;4;6
109;17.06.2015;2015;06;08;Keskiviikko;29;51;80;0;4;4
109;17.06.2015;2015;06;09;Keskiviikko;15;21;36;0;4;4
109;17.06.2015;2015;06;10;Keskiviikko;4;12;16;1;2;3
109;17.06.2015;2015;06;11;Keskiviikko;12;18;30;1;7;8
109;17.06.2015;2015;06;12;Keskiviikko;9;26;35;1;2;3
109;17.06.2015;2015;06;13;Keskiviikko;20;15;35;1;2;3
109;17.06.2015;2015;06;14;Keskiviikko;33;16;49;4;3;7
109;17.06.2015;2015;06;15;Keskiviikko;29;46;75;4;4;8
109;17.06.2015;2015;06;16;Keskiviikko;18;110;128;3;15;18
109;17.06.2015;2015;06;17;Keskiviikko;24;50;74;0;7;7
109;17.06.2015;2015;06;18;Keskiviikko;13;33;46;2;3;5
109;17.06.2015;2015;06;19;Keskiviikko;8;24;32;4;8;12
109;17.06.2015;2015;06;20;Keskiviikko;9;22;31;3;8;11
109;17.06.2015;2015;06;21;Keskiviikko;16;5;21;2;1;3
109;17.06.2015;2015;06;22;Keskiviikko;9;13;22;2;1;3
109;17.06.2015;2015;06;23;Keskiviikko;0;7;7;0;2;2
109;18.06.2015;2015;06;00;Torstai;3;1;4;0;0;0
109;18.06.2015;2015;06;01;Torstai;0;3;3;0;0;0
109;18.06.2015;2015;06;02;Torstai;0;0;0;0;0;0
109;18.06.2015;2015;06;03;Torstai;0;1;1;0;0;0
109;18.06.2015;2015;06;04;Torstai;1;1;2;0;0;0
109;18.06.2015;2015;06;05;Torstai;8;9;17;1;1;2
109;18.06.2015;2015;06;06;Torstai;4;44;48;0;4;4
109;18.06.2015;2015;06;07;Torstai;34;95;129;2;2;4
109;18.06.2015;2015;06;08;Torstai;16;59;75;0;7;7
109;18.06.2015;2015;06;09;Torstai;6;22;28;0;1;1
109;18.06.2015;2015;06;10;Torstai;7;11;18;2;2;4
109;18.06.2015;2015;06;11;Torstai;15;12;27;1;1;2
109;18.06.2015;2015;06;12;Torstai;22;16;38;5;2;7
109;18.06.2015;2015;06;13;Torstai;16;40;56;1;2;3
109;18.06.2015;2015;06;14;Torstai;23;52;75;1;2;3
109;18.06.2015;2015;06;15;Torstai;21;68;89;1;2;3
109;18.06.2015;2015;06;16;Torstai;1;83;84;2;10;12
109;18.06.2015;2015;06;17;Torstai;7;29;36;0;3;3
109;18.06.2015;2015;06;18;Torstai;4;30;34;1;3;4
109;18.06.2015;2015;06;19;Torstai;18;10;28;3;1;4
109;18.06.2015;2015;06;20;Torstai;8;4;12;2;0;2
109;18.06.2015;2015;06;21;Torstai;5;17;22;2;3;5
109;18.06.2015;2015;06;22;Torstai;3;8;11;0;0;0
109;18.06.2015;2015;06;23;Torstai;1;5;6;0;1;1
109;19.06.2015;2015;06;00;Perjantai;7;3;10;0;0;0
109;19.06.2015;2015;06;01;Perjantai;1;3;4;1;0;1
109;19.06.2015;2015;06;02;Perjantai;0;1;1;0;1;1
109;19.06.2015;2015;06;03;Perjantai;1;0;1;0;0;0
109;19.06.2015;2015;06;04;Perjantai;0;0;0;0;0;0
109;19.06.2015;2015;06;05;Perjantai;2;2;4;0;0;0
109;19.06.2015;2015;06;06;Perjantai;2;6;8;1;0;1
109;19.06.2015;2015;06;07;Perjantai;1;12;13;1;3;4
109;19.06.2015;2015;06;08;Perjantai;3;5;8;0;4;4
109;19.06.2015;2015;06;09;Perjantai;4;27;31;2;9;11
109;19.06.2015;2015;06;10;Perjantai;9;14;23;0;4;4
109;19.06.2015;2015;06;11;Perjantai;21;19;40;0;2;2
109;19.06.2015;2015;06;12;Perjantai;11;15;26;0;4;4
109;19.06.2015;2015;06;13;Perjantai;9;16;25;1;9;10
109;19.06.2015;2015;06;14;Perjantai;0;21;21;0;6;6
109;19.06.2015;2015;06;15;Perjantai;13;25;38;2;7;9
109;19.06.2015;2015;06;16;Perjantai;4;16;20;1;4;5
109;19.06.2015;2015;06;17;Perjantai;10;20;30;1;1;2
109;19.06.2015;2015;06;18;Perjantai;0;22;22;0;2;2
109;19.06.2015;2015;06;19;Perjantai;2;19;21;3;4;7
109;19.06.2015;2015;06;20;Perjantai;1;10;11;1;2;3
109;19.06.2015;2015;06;21;Perjantai;8;11;19;1;3;4
109;19.06.2015;2015;06;22;Perjantai;1;11;12;0;0;0
109;19.06.2015;2015;06;23;Perjantai;2;6;8;0;0;0
109;20.06.2015;2015;06;00;Lauantai;2;6;8;0;1;1
109;20.06.2015;2015;06;01;Lauantai;3;3;6;0;0;0
109;20.06.2015;2015;06;02;Lauantai;4;1;5;1;2;3
109;20.06.2015;2015;06;03;Lauantai;1;4;5;0;0;0
109;20.06.2015;2015;06;04;Lauantai;4;0;4;0;0;0
109;20.06.2015;2015;06;05;Lauantai;2;1;3;2;0;2
109;20.06.2015;2015;06;06;Lauantai;1;5;6;1;0;1
109;20.06.2015;2015;06;07;Lauantai;3;0;3;1;4;5
109;20.06.2015;2015;06;08;Lauantai;0;7;7;1;2;3
109;20.06.2015;2015;06;09;Lauantai;5;4;9;2;0;2
109;20.06.2015;2015;06;10;Lauantai;17;3;20;3;4;7
109;20.06.2015;2015;06;11;Lauantai;7;9;16;4;3;7
109;20.06.2015;2015;06;12;Lauantai;5;32;37;1;6;7
109;20.06.2015;2015;06;13;Lauantai;15;12;27;5;6;11
109;20.06.2015;2015;06;14;Lauantai;13;23;36;0;2;2
109;20.06.2015;2015;06;15;Lauantai;14;32;46;1;6;7
109;20.06.2015;2015;06;16;Lauantai;11;29;40;0;4;4
109;20.06.2015;2015;06;17;Lauantai;9;27;36;0;3;3
109;20.06.2015;2015;06;18;Lauantai;13;13;26;3;6;9
109;20.06.2015;2015;06;19;Lauantai;6;31;37;0;3;3
109;20.06.2015;2015;06;20;Lauantai;16;13;29;3;1;4
109;20.06.2015;2015;06;21;Lauantai;12;6;18;2;3;5
109;20.06.2015;2015;06;22;Lauantai;2;6;8;0;2;2
109;20.06.2015;2015;06;23;Lauantai;3;8;11;0;0;0
109;21.06.2015;2015;06;00;Sunnuntai;1;4;5;0;2;2
109;21.06.2015;2015;06;01;Sunnuntai;0;3;3;0;0;0
109;21.06.2015;2015;06;02;Sunnuntai;1;0;1;1;1;2
109;21.06.2015;2015;06;03;Sunnuntai;3;1;4;0;0;0
109;21.06.2015;2015;06;04;Sunnuntai;0;4;4;2;0;2
109;21.06.2015;2015;06;05;Sunnuntai;1;1;2;0;1;1
109;21.06.2015;2015;06;06;Sunnuntai;6;2;8;0;1;1
109;21.06.2015;2015;06;07;Sunnuntai;4;2;6;1;0;1
109;21.06.2015;2015;06;08;Sunnuntai;1;4;5;4;3;7
109;21.06.2015;2015;06;09;Sunnuntai;2;1;3;4;3;7
109;21.06.2015;2015;06;10;Sunnuntai;3;1;4;3;1;4
109;21.06.2015;2015;06;11;Sunnuntai;4;0;4;1;2;3
109;21.06.2015;2015;06;12;Sunnuntai;13;2;15;5;1;6
109;21.06.2015;2015;06;13;Sunnuntai;5;18;23;2;3;5
109;21.06.2015;2015;06;14;Sunnuntai;14;16;30;1;6;7
109;21.06.2015;2015;06;15;Sunnuntai;10;9;19;5;4;9
109;21.06.2015;2015;06;16;Sunnuntai;14;26;40;3;10;13
109;21.06.2015;2015;06;17;Sunnuntai;17;20;37;1;8;9
109;21.06.2015;2015;06;18;Sunnuntai;3;28;31;0;12;12
109;21.06.2015;2015;06;19;Sunnuntai;4;26;30;1;4;5
109;21.06.2015;2015;06;20;Sunnuntai;10;7;17;2;4;6
109;21.06.2015;2015;06;21;Sunnuntai;5;3;8;9;2;11
109;21.06.2015;2015;06;22;Sunnuntai;1;4;5;1;3;4
109;21.06.2015;2015;06;23;Sunnuntai;0;2;2;0;0;0
109;22.06.2015;2015;06;00;Maanantai;0;3;3;3;1;4
109;22.06.2015;2015;06;01;Maanantai;1;0;1;0;0;0
109;22.06.2015;2015;06;02;Maanantai;0;1;1;1;0;1
109;22.06.2015;2015;06;03;Maanantai;0;1;1;0;0;0
109;22.06.2015;2015;06;04;Maanantai;1;2;3;0;0;0
109;22.06.2015;2015;06;05;Maanantai;10;8;18;1;0;1
109;22.06.2015;2015;06;06;Maanantai;10;56;66;1;4;5
109;22.06.2015;2015;06;07;Maanantai;27;111;138;1;4;5
109;22.06.2015;2015;06;08;Maanantai;11;49;60;0;4;4
109;22.06.2015;2015;06;09;Maanantai;15;27;42;0;7;7
109;22.06.2015;2015;06;10;Maanantai;5;19;24;1;5;6
109;22.06.2015;2015;06;11;Maanantai;17;25;42;1;6;7
109;22.06.2015;2015;06;12;Maanantai;11;30;41;5;5;10
109;22.06.2015;2015;06;13;Maanantai;20;31;51;4;3;7
109;22.06.2015;2015;06;14;Maanantai;17;58;75;2;5;7
109;22.06.2015;2015;06;15;Maanantai;32;76;108;2;5;7
109;22.06.2015;2015;06;16;Maanantai;10;123;133;2;12;14
109;22.06.2015;2015;06;17;Maanantai;8;63;71;1;12;13
109;22.06.2015;2015;06;18;Maanantai;31;32;63;5;7;12
109;22.06.2015;2015;06;19;Maanantai;42;5;47;8;5;13
109;22.06.2015;2015;06;20;Maanantai;11;29;40;2;5;7
109;22.06.2015;2015;06;21;Maanantai;4;13;17;1;3;4
109;22.06.2015;2015;06;22;Maanantai;5;12;17;2;2;4
109;22.06.2015;2015;06;23;Maanantai;3;4;7;0;1;1
109;23.06.2015;2015;06;00;Tiistai;0;0;0;0;2;2
109;23.06.2015;2015;06;01;Tiistai;0;1;1;0;0;0
109;23.06.2015;2015;06;02;Tiistai;0;0;0;0;0;0
109;23.06.2015;2015;06;03;Tiistai;0;2;2;0;0;0
109;23.06.2015;2015;06;04;Tiistai;0;1;1;0;0;0
109;23.06.2015;2015;06;05;Tiistai;4;12;16;0;2;2
109;23.06.2015;2015;06;06;Tiistai;7;30;37;0;3;3
109;23.06.2015;2015;06;07;Tiistai;15;75;90;1;4;5
109;23.06.2015;2015;06;08;Tiistai;7;40;47;2;4;6
109;23.06.2015;2015;06;09;Tiistai;6;16;22;0;2;2
109;23.06.2015;2015;06;10;Tiistai;2;11;13;0;5;5
109;23.06.2015;2015;06;11;Tiistai;4;5;9;0;1;1
109;23.06.2015;2015;06;12;Tiistai;2;2;4;1;3;4
109;23.06.2015;2015;06;13;Tiistai;6;2;8;0;0;0
109;23.06.2015;2015;06;14;Tiistai;11;17;28;1;3;4
109;23.06.2015;2015;06;15;Tiistai;27;29;56;0;4;4
109;23.06.2015;2015;06;16;Tiistai;26;52;78;1;6;7
109;23.06.2015;2015;06;17;Tiistai;9;15;24;3;2;5
109;23.06.2015;2015;06;18;Tiistai;7;4;11;5;3;8
109;23.06.2015;2015;06;19;Tiistai;5;6;11;1;5;6
109;23.06.2015;2015;06;20;Tiistai;8;4;12;6;8;14
109;23.06.2015;2015;06;21;Tiistai;5;3;8;1;1;2
109;23.06.2015;2015;06;22;Tiistai;1;4;5;1;0;1
109;23.06.2015;2015;06;23;Tiistai;2;1;3;0;1;1
109;24.06.2015;2015;06;00;Keskiviikko;0;0;0;0;2;2
109;24.06.2015;2015;06;01;Keskiviikko;0;0;0;0;0;0
109;24.06.2015;2015;06;02;Keskiviikko;0;1;1;0;0;0
109;24.06.2015;2015;06;03;Keskiviikko;0;0;0;0;1;1
109;24.06.2015;2015;06;04;Keskiviikko;1;2;3;0;0;0
109;24.06.2015;2015;06;05;Keskiviikko;6;5;11;1;2;3
109;24.06.2015;2015;06;06;Keskiviikko;17;24;41;1;3;4
109;24.06.2015;2015;06;07;Keskiviikko;31;72;103;1;5;6
109;24.06.2015;2015;06;08;Keskiviikko;19;40;59;1;3;4
109;24.06.2015;2015;06;09;Keskiviikko;8;22;30;4;4;8
109;24.06.2015;2015;06;10;Keskiviikko;9;8;17;1;8;9
109;24.06.2015;2015;06;11;Keskiviikko;13;16;29;1;8;9
109;24.06.2015;2015;06;12;Keskiviikko;9;12;21;1;2;3
109;24.06.2015;2015;06;13;Keskiviikko;9;10;19;3;1;4
109;24.06.2015;2015;06;14;Keskiviikko;17;9;26;2;1;3
109;24.06.2015;2015;06;15;Keskiviikko;43;20;63;7;2;9
109;24.06.2015;2015;06;16;Keskiviikko;51;30;81;3;6;9
109;24.06.2015;2015;06;17;Keskiviikko;28;16;44;2;3;5
109;24.06.2015;2015;06;18;Keskiviikko;10;9;19;5;5;10
109;24.06.2015;2015;06;19;Keskiviikko;6;9;15;5;7;12
109;24.06.2015;2015;06;20;Keskiviikko;7;5;12;2;4;6
109;24.06.2015;2015;06;21;Keskiviikko;8;10;18;4;1;5
109;24.06.2015;2015;06;22;Keskiviikko;1;4;5;1;4;5
109;24.06.2015;2015;06;23;Keskiviikko;0;1;1;1;2;3
109;25.06.2015;2015;06;00;Torstai;1;2;3;1;0;1
109;25.06.2015;2015;06;01;Torstai;2;0;2;0;0;0
109;25.06.2015;2015;06;02;Torstai;0;1;1;0;0;0
109;25.06.2015;2015;06;03;Torstai;0;2;2;0;0;0
109;25.06.2015;2015;06;04;Torstai;3;0;3;0;0;0
109;25.06.2015;2015;06;05;Torstai;9;6;15;1;1;2
109;25.06.2015;2015;06;06;Torstai;18;18;36;2;2;4
109;25.06.2015;2015;06;07;Torstai;43;33;76;1;5;6
109;25.06.2015;2015;06;08;Torstai;17;12;29;1;2;3
109;25.06.2015;2015;06;09;Torstai;6;6;12;3;0;3
109;25.06.2015;2015;06;10;Torstai;7;4;11;3;0;3
109;25.06.2015;2015;06;11;Torstai;13;3;16;1;0;1
109;25.06.2015;2015;06;12;Torstai;4;2;6;1;2;3
109;25.06.2015;2015;06;13;Torstai;16;4;20;3;0;3
109;25.06.2015;2015;06;14;Torstai;24;2;26;1;1;2
109;25.06.2015;2015;06;15;Torstai;39;5;44;4;1;5
109;25.06.2015;2015;06;16;Torstai;47;10;57;7;4;11
109;25.06.2015;2015;06;17;Torstai;26;4;30;6;4;10
109;25.06.2015;2015;06;18;Torstai;19;11;30;9;8;17
109;25.06.2015;2015;06;19;Torstai;8;5;13;3;4;7
109;25.06.2015;2015;06;20;Torstai;8;2;10;7;2;9
109;25.06.2015;2015;06;21;Torstai;4;2;6;3;4;7
109;25.06.2015;2015;06;22;Torstai;4;0;4;3;2;5
109;25.06.2015;2015;06;23;Torstai;5;0;5;0;1;1
109;26.06.2015;2015;06;00;Perjantai;1;2;3;2;0;2
109;26.06.2015;2015;06;01;Perjantai;0;0;0;0;0;0
109;26.06.2015;2015;06;02;Perjantai;1;3;4;0;0;0
109;26.06.2015;2015;06;03;Perjantai;1;0;1;0;0;0
109;26.06.2015;2015;06;04;Perjantai;3;1;4;0;0;0
109;26.06.2015;2015;06;05;Perjantai;15;9;24;2;1;3
109;26.06.2015;2015;06;06;Perjantai;12;23;35;2;0;2
109;26.06.2015;2015;06;07;Perjantai;31;63;94;1;5;6
109;26.06.2015;2015;06;08;Perjantai;18;33;51;3;2;5
109;26.06.2015;2015;06;09;Perjantai;9;11;20;1;7;8
109;26.06.2015;2015;06;10;Perjantai;3;13;16;1;5;6
109;26.06.2015;2015;06;11;Perjantai;10;19;29;0;3;3
109;26.06.2015;2015;06;12;Perjantai;6;11;17;3;2;5
109;26.06.2015;2015;06;13;Perjantai;20;20;40;0;2;2
109;26.06.2015;2015;06;14;Perjantai;24;16;40;4;4;8
109;26.06.2015;2015;06;15;Perjantai;26;38;64;6;8;14
109;26.06.2015;2015;06;16;Perjantai;46;47;93;2;4;6
109;26.06.2015;2015;06;17;Perjantai;21;22;43;4;4;8
109;26.06.2015;2015;06;18;Perjantai;8;26;34;3;9;12
109;26.06.2015;2015;06;19;Perjantai;11;15;26;2;2;4
109;26.06.2015;2015;06;20;Perjantai;22;14;36;4;3;7
109;26.06.2015;2015;06;21;Perjantai;6;14;20;4;2;6
109;26.06.2015;2015;06;22;Perjantai;1;10;11;1;0;1
109;26.06.2015;2015;06;23;Perjantai;1;9;10;1;0;1
109;27.06.2015;2015;06;00;Lauantai;6;9;15;0;0;0
109;27.06.2015;2015;06;01;Lauantai;1;2;3;0;0;0
109;27.06.2015;2015;06;02;Lauantai;2;1;3;1;0;1
109;27.06.2015;2015;06;03;Lauantai;0;1;1;0;0;0
109;27.06.2015;2015;06;04;Lauantai;3;0;3;0;0;0
109;27.06.2015;2015;06;05;Lauantai;0;0;0;1;1;2
109;27.06.2015;2015;06;06;Lauantai;0;8;8;0;0;0
109;27.06.2015;2015;06;07;Lauantai;2;1;3;1;3;4
109;27.06.2015;2015;06;08;Lauantai;3;4;7;4;1;5
109;27.06.2015;2015;06;09;Lauantai;3;11;14;3;4;7
109;27.06.2015;2015;06;10;Lauantai;8;17;25;3;4;7
109;27.06.2015;2015;06;11;Lauantai;3;18;21;2;2;4
109;27.06.2015;2015;06;12;Lauantai;12;15;27;2;2;4
109;27.06.2015;2015;06;13;Lauantai;12;13;25;1;3;4
109;27.06.2015;2015;06;14;Lauantai;10;17;27;1;1;2
109;27.06.2015;2015;06;15;Lauantai;16;17;33;2;10;12
109;27.06.2015;2015;06;16;Lauantai;10;19;29;2;7;9
109;27.06.2015;2015;06;17;Lauantai;8;16;24;1;6;7
109;27.06.2015;2015;06;18;Lauantai;9;4;13;0;1;1
109;27.06.2015;2015;06;19;Lauantai;5;14;19;3;6;9
109;27.06.2015;2015;06;20;Lauantai;2;13;15;1;6;7
109;27.06.2015;2015;06;21;Lauantai;10;10;20;3;3;6
109;27.06.2015;2015;06;22;Lauantai;0;6;6;1;4;5
109;27.06.2015;2015;06;23;Lauantai;3;7;10;1;0;1
109;28.06.2015;2015;06;00;Sunnuntai;0;3;3;1;1;2
109;28.06.2015;2015;06;01;Sunnuntai;2;6;8;0;1;1
109;28.06.2015;2015;06;02;Sunnuntai;2;3;5;0;0;0
109;28.06.2015;2015;06;03;Sunnuntai;2;3;5;1;2;3
109;28.06.2015;2015;06;04;Sunnuntai;2;5;7;0;0;0
109;28.06.2015;2015;06;05;Sunnuntai;0;1;1;0;1;1
109;28.06.2015;2015;06;06;Sunnuntai;3;9;12;0;1;1
109;28.06.2015;2015;06;07;Sunnuntai;1;2;3;1;3;4
109;28.06.2015;2015;06;08;Sunnuntai;3;9;12;0;3;3
109;28.06.2015;2015;06;09;Sunnuntai;7;12;19;1;4;5
109;28.06.2015;2015;06;10;Sunnuntai;5;18;23;4;8;12
109;28.06.2015;2015;06;11;Sunnuntai;9;18;27;6;11;17
109;28.06.2015;2015;06;12;Sunnuntai;14;28;42;0;3;3
109;28.06.2015;2015;06;13;Sunnuntai;8;27;35;0;4;4
109;28.06.2015;2015;06;14;Sunnuntai;15;30;45;2;6;8
109;28.06.2015;2015;06;15;Sunnuntai;11;29;40;0;2;2
109;28.06.2015;2015;06;16;Sunnuntai;6;32;38;1;10;11
109;28.06.2015;2015;06;17;Sunnuntai;10;28;38;2;11;13
109;28.06.2015;2015;06;18;Sunnuntai;14;22;36;1;7;8
109;28.06.2015;2015;06;19;Sunnuntai;14;22;36;1;7;8
109;28.06.2015;2015;06;20;Sunnuntai;11;13;24;4;4;8
109;28.06.2015;2015;06;21;Sunnuntai;12;14;26;1;5;6
109;28.06.2015;2015;06;22;Sunnuntai;3;9;12;2;6;8
109;28.06.2015;2015;06;23;Sunnuntai;0;1;1;1;2;3
109;29.06.2015;2015;06;00;Maanantai;4;0;4;0;0;0
109;29.06.2015;2015;06;01;Maanantai;0;0;0;1;0;1
109;29.06.2015;2015;06;02;Maanantai;0;1;1;0;0;0
109;29.06.2015;2015;06;03;Maanantai;0;0;0;0;0;0
109;29.06.2015;2015;06;04;Maanantai;3;2;5;1;1;2
109;29.06.2015;2015;06;05;Maanantai;13;8;21;3;2;5
109;29.06.2015;2015;06;06;Maanantai;13;33;46;1;2;3
109;29.06.2015;2015;06;07;Maanantai;37;103;140;0;6;6
109;29.06.2015;2015;06;08;Maanantai;12;55;67;4;9;13
109;29.06.2015;2015;06;09;Maanantai;14;23;37;1;6;7
109;29.06.2015;2015;06;10;Maanantai;2;13;15;0;5;5
109;29.06.2015;2015;06;11;Maanantai;10;34;44;0;3;3
109;29.06.2015;2015;06;12;Maanantai;11;37;48;0;3;3
109;29.06.2015;2015;06;13;Maanantai;13;29;42;2;13;15
109;29.06.2015;2015;06;14;Maanantai;13;50;63;2;6;8
109;29.06.2015;2015;06;15;Maanantai;39;69;108;2;11;13
109;29.06.2015;2015;06;16;Maanantai;38;98;136;4;11;15
109;29.06.2015;2015;06;17;Maanantai;21;50;71;3;8;11
109;29.06.2015;2015;06;18;Maanantai;17;35;52;0;8;8
109;29.06.2015;2015;06;19;Maanantai;19;35;54;3;10;13
109;29.06.2015;2015;06;20;Maanantai;11;12;23;2;5;7
109;29.06.2015;2015;06;21;Maanantai;5;5;10;1;3;4
109;29.06.2015;2015;06;22;Maanantai;0;9;9;0;4;4
109;29.06.2015;2015;06;23;Maanantai;3;4;7;1;0;1
109;30.06.2015;2015;06;00;Tiistai;0;5;5;0;1;1
109;30.06.2015;2015;06;01;Tiistai;0;0;0;1;1;2
109;30.06.2015;2015;06;02;Tiistai;1;0;1;0;0;0
109;30.06.2015;2015;06;03;Tiistai;0;1;1;0;0;0
109;30.06.2015;2015;06;04;Tiistai;0;2;2;0;0;0
109;30.06.2015;2015;06;05;Tiistai;9;10;19;1;2;3
109;30.06.2015;2015;06;06;Tiistai;10;18;28;2;1;3
109;30.06.2015;2015;06;07;Tiistai;30;82;112;3;6;9
109;30.06.2015;2015;06;08;Tiistai;17;48;65;1;2;3
109;30.06.2015;2015;06;09;Tiistai;5;23;28;1;4;5
109;30.06.2015;2015;06;10;Tiistai;9;10;19;1;3;4
109;30.06.2015;2015;06;11;Tiistai;7;23;30;0;5;5
109;30.06.2015;2015;06;12;Tiistai;6;19;25;4;5;9
109;30.06.2015;2015;06;13;Tiistai;15;16;31;0;2;2
109;30.06.2015;2015;06;14;Tiistai;8;43;51;1;5;6
109;30.06.2015;2015;06;15;Tiistai;35;47;82;0;6;6
109;30.06.2015;2015;06;16;Tiistai;34;57;91;0;4;4
109;30.06.2015;2015;06;17;Tiistai;23;26;49;5;2;7
109;30.06.2015;2015;06;18;Tiistai;12;26;38;2;7;9
109;30.06.2015;2015;06;19;Tiistai;17;24;41;5;7;12
109;30.06.2015;2015;06;20;Tiistai;7;11;18;3;5;8
109;30.06.2015;2015;06;21;Tiistai;10;14;24;1;4;5
109;30.06.2015;2015;06;22;Tiistai;1;9;10;0;4;4
109;30.06.2015;2015;06;23;Tiistai;5;11;16;1;1;2
109;01.07.2015;2015;07;00;Keskiviikko;1;0;1;2;1;3
109;01.07.2015;2015;07;01;Keskiviikko;0;0;0;0;1;1
109;01.07.2015;2015;07;02;Keskiviikko;1;0;1;0;0;0
109;01.07.2015;2015;07;03;Keskiviikko;0;0;0;1;0;1
109;01.07.2015;2015;07;04;Keskiviikko;2;0;2;0;0;0
109;01.07.2015;2015;07;05;Keskiviikko;10;6;16;2;1;3
109;01.07.2015;2015;07;06;Keskiviikko;10;46;56;0;3;3
109;01.07.2015;2015;07;07;Keskiviikko;34;97;131;1;6;7
109;01.07.2015;2015;07;08;Keskiviikko;18;54;72;0;6;6
109;01.07.2015;2015;07;09;Keskiviikko;10;35;45;0;2;2
109;01.07.2015;2015;07;10;Keskiviikko;3;18;21;2;9;11
109;01.07.2015;2015;07;11;Keskiviikko;13;32;45;1;9;10
109;01.07.2015;2015;07;12;Keskiviikko;12;31;43;1;4;5
109;01.07.2015;2015;07;13;Keskiviikko;20;56;76;4;4;8
109;01.07.2015;2015;07;14;Keskiviikko;8;55;63;0;8;8
109;01.07.2015;2015;07;15;Keskiviikko;31;97;128;0;8;8
109;01.07.2015;2015;07;16;Keskiviikko;49;72;121;6;6;12
109;01.07.2015;2015;07;17;Keskiviikko;22;74;96;1;5;6
109;01.07.2015;2015;07;18;Keskiviikko;16;42;58;3;10;13
109;01.07.2015;2015;07;19;Keskiviikko;15;36;51;0;13;13
109;01.07.2015;2015;07;20;Keskiviikko;14;26;40;2;2;4
109;01.07.2015;2015;07;21;Keskiviikko;8;21;29;3;7;10
109;01.07.2015;2015;07;22;Keskiviikko;12;22;34;0;3;3
109;01.07.2015;2015;07;23;Keskiviikko;3;2;5;1;0;1
109;02.07.2015;2015;07;00;Torstai;1;3;4;0;0;0
109;02.07.2015;2015;07;01;Torstai;4;2;6;0;0;0
109;02.07.2015;2015;07;02;Torstai;0;1;1;0;0;0
109;02.07.2015;2015;07;03;Torstai;0;0;0;1;0;1
109;02.07.2015;2015;07;04;Torstai;1;4;5;0;1;1
109;02.07.2015;2015;07;05;Torstai;10;12;22;1;1;2
109;02.07.2015;2015;07;06;Torstai;2;41;43;1;4;5
109;02.07.2015;2015;07;07;Torstai;30;92;122;5;4;9
109;02.07.2015;2015;07;08;Torstai;13;59;72;2;8;10
109;02.07.2015;2015;07;09;Torstai;11;20;31;2;10;12
109;02.07.2015;2015;07;10;Torstai;4;20;24;1;4;5
109;02.07.2015;2015;07;11;Torstai;5;22;27;0;2;2
109;02.07.2015;2015;07;12;Torstai;3;24;27;4;8;12
109;02.07.2015;2015;07;13;Torstai;11;24;35;1;6;7
109;02.07.2015;2015;07;14;Torstai;15;37;52;1;12;13
109;02.07.2015;2015;07;15;Torstai;40;60;100;3;8;11
109;02.07.2015;2015;07;16;Torstai;35;73;108;5;12;17
109;02.07.2015;2015;07;17;Torstai;29;37;66;2;4;6
109;02.07.2015;2015;07;18;Torstai;9;19;28;3;1;4
109;02.07.2015;2015;07;19;Torstai;4;7;11;0;4;4
109;02.07.2015;2015;07;20;Torstai;4;10;14;1;4;5
109;02.07.2015;2015;07;21;Torstai;8;7;15;1;1;2
109;02.07.2015;2015;07;22;Torstai;3;11;14;1;1;2
109;02.07.2015;2015;07;23;Torstai;1;6;7;1;1;2
109;03.07.2015;2015;07;00;Perjantai;1;0;1;1;1;2
109;03.07.2015;2015;07;01;Perjantai;1;1;2;0;0;0
109;03.07.2015;2015;07;02;Perjantai;0;1;1;0;0;0
109;03.07.2015;2015;07;03;Perjantai;0;0;0;0;0;0
109;03.07.2015;2015;07;04;Perjantai;1;3;4;0;0;0
109;03.07.2015;2015;07;05;Perjantai;11;12;23;1;0;1
109;03.07.2015;2015;07;06;Perjantai;8;29;37;1;1;2
109;03.07.2015;2015;07;07;Perjantai;10;64;74;3;8;11
109;03.07.2015;2015;07;08;Perjantai;12;35;47;1;4;5
109;03.07.2015;2015;07;09;Perjantai;5;23;28;0;3;3
109;03.07.2015;2015;07;10;Perjantai;8;25;33;3;8;11
109;03.07.2015;2015;07;11;Perjantai;8;29;37;23;59;82
109;03.07.2015;2015;07;12;Perjantai;27;15;42;48;28;76
109;03.07.2015;2015;07;13;Perjantai;31;32;63;2;5;7
109;03.07.2015;2015;07;14;Perjantai;41;44;85;10;4;14
109;03.07.2015;2015;07;15;Perjantai;42;42;84;5;6;11
109;03.07.2015;2015;07;16;Perjantai;25;36;61;1;6;7
109;03.07.2015;2015;07;17;Perjantai;36;35;71;6;2;8
109;03.07.2015;2015;07;18;Perjantai;15;25;40;2;8;10
109;03.07.2015;2015;07;19;Perjantai;10;19;29;3;1;4
109;03.07.2015;2015;07;20;Perjantai;6;7;13;2;3;5
109;03.07.2015;2015;07;21;Perjantai;5;8;13;6;2;8
109;03.07.2015;2015;07;22;Perjantai;4;1;5;1;1;2
109;03.07.2015;2015;07;23;Perjantai;2;2;4;0;0;0
109;04.07.2015;2015;07;00;Lauantai;3;4;7;0;1;1
109;04.07.2015;2015;07;01;Lauantai;1;1;2;1;0;1
109;04.07.2015;2015;07;02;Lauantai;0;2;2;0;0;0
109;04.07.2015;2015;07;03;Lauantai;1;1;2;0;0;0
109;04.07.2015;2015;07;04;Lauantai;0;4;4;0;0;0
109;04.07.2015;2015;07;05;Lauantai;2;1;3;1;0;1
109;04.07.2015;2015;07;06;Lauantai;6;0;6;1;0;1
109;04.07.2015;2015;07;07;Lauantai;4;2;6;4;2;6
109;04.07.2015;2015;07;08;Lauantai;2;1;3;5;2;7
109;04.07.2015;2015;07;09;Lauantai;3;4;7;0;3;3
109;04.07.2015;2015;07;10;Lauantai;4;1;5;2;3;5
109;04.07.2015;2015;07;11;Lauantai;11;7;18;8;1;9
109;04.07.2015;2015;07;12;Lauantai;9;5;14;0;1;1
109;04.07.2015;2015;07;13;Lauantai;5;5;10;1;0;1
109;04.07.2015;2015;07;14;Lauantai;14;7;21;4;4;8
109;04.07.2015;2015;07;15;Lauantai;23;9;32;5;1;6
109;04.07.2015;2015;07;16;Lauantai;15;12;27;5;4;9
109;04.07.2015;2015;07;17;Lauantai;12;11;23;3;4;7
109;04.07.2015;2015;07;18;Lauantai;10;10;20;1;5;6
109;04.07.2015;2015;07;19;Lauantai;11;5;16;7;10;17
109;04.07.2015;2015;07;20;Lauantai;5;6;11;7;2;9
109;04.07.2015;2015;07;21;Lauantai;14;5;19;5;5;10
109;04.07.2015;2015;07;22;Lauantai;2;4;6;3;1;4
109;04.07.2015;2015;07;23;Lauantai;2;0;2;0;0;0
109;05.07.2015;2015;07;00;Sunnuntai;5;1;6;1;0;1
109;05.07.2015;2015;07;01;Sunnuntai;1;4;5;0;0;0
109;05.07.2015;2015;07;02;Sunnuntai;2;3;5;0;0;0
109;05.07.2015;2015;07;03;Sunnuntai;0;5;5;2;0;2
109;05.07.2015;2015;07;04;Sunnuntai;2;1;3;0;1;1
109;05.07.2015;2015;07;05;Sunnuntai;1;5;6;0;1;1
109;05.07.2015;2015;07;06;Sunnuntai;5;1;6;0;1;1
109;05.07.2015;2015;07;07;Sunnuntai;3;3;6;4;1;5
109;05.07.2015;2015;07;08;Sunnuntai;3;3;6;2;1;3
109;05.07.2015;2015;07;09;Sunnuntai;8;9;17;3;3;6
109;05.07.2015;2015;07;10;Sunnuntai;14;7;21;10;4;14
109;05.07.2015;2015;07;11;Sunnuntai;18;6;24;9;3;12
109;05.07.2015;2015;07;12;Sunnuntai;15;23;38;8;3;11
109;05.07.2015;2015;07;13;Sunnuntai;17;14;31;3;4;7
109;05.07.2015;2015;07;14;Sunnuntai;22;21;43;5;0;5
109;05.07.2015;2015;07;15;Sunnuntai;22;12;34;5;1;6
109;05.07.2015;2015;07;16;Sunnuntai;19;19;38;3;4;7
109;05.07.2015;2015;07;17;Sunnuntai;18;14;32;4;1;5
109;05.07.2015;2015;07;18;Sunnuntai;20;12;32;9;3;12
109;05.07.2015;2015;07;19;Sunnuntai;15;8;23;8;6;14
109;05.07.2015;2015;07;20;Sunnuntai;9;10;19;8;7;15
109;05.07.2015;2015;07;21;Sunnuntai;8;16;24;5;5;10
109;05.07.2015;2015;07;22;Sunnuntai;4;5;9;3;0;3
109;05.07.2015;2015;07;23;Sunnuntai;0;3;3;1;2;3
109;06.07.2015;2015;07;00;Maanantai;0;3;3;0;1;1
109;06.07.2015;2015;07;01;Maanantai;0;2;2;2;1;3
109;06.07.2015;2015;07;02;Maanantai;4;0;4;0;0;0
109;06.07.2015;2015;07;03;Maanantai;0;0;0;0;0;0
109;06.07.2015;2015;07;04;Maanantai;0;4;4;0;0;0
109;06.07.2015;2015;07;05;Maanantai;4;16;20;1;2;3
109;06.07.2015;2015;07;06;Maanantai;41;14;55;1;0;1
109;06.07.2015;2015;07;07;Maanantai;50;44;94;4;3;7
109;06.07.2015;2015;07;08;Maanantai;34;22;56;4;1;5
109;06.07.2015;2015;07;09;Maanantai;13;9;22;5;4;9
109;06.07.2015;2015;07;10;Maanantai;18;10;28;3;2;5
109;06.07.2015;2015;07;11;Maanantai;26;22;48;4;2;6
109;06.07.2015;2015;07;12;Maanantai;21;10;31;1;2;3
109;06.07.2015;2015;07;13;Maanantai;18;12;30;2;0;2
109;06.07.2015;2015;07;14;Maanantai;30;15;45;10;2;12
109;06.07.2015;2015;07;15;Maanantai;40;56;96;6;2;8
109;06.07.2015;2015;07;16;Maanantai;53;53;106;10;10;20
109;06.07.2015;2015;07;17;Maanantai;29;40;69;5;6;11
109;06.07.2015;2015;07;18;Maanantai;30;19;49;6;9;15
109;06.07.2015;2015;07;19;Maanantai;24;23;47;7;3;10
109;06.07.2015;2015;07;20;Maanantai;6;35;41;7;4;11
109;06.07.2015;2015;07;21;Maanantai;15;15;30;5;1;6
109;06.07.2015;2015;07;22;Maanantai;11;10;21;0;3;3
109;06.07.2015;2015;07;23;Maanantai;7;8;15;0;2;2
109;07.07.2015;2015;07;00;Tiistai;4;4;8;0;1;1
109;07.07.2015;2015;07;01;Tiistai;0;0;0;1;0;1
109;07.07.2015;2015;07;02;Tiistai;3;4;7;0;0;0
109;07.07.2015;2015;07;03;Tiistai;0;0;0;1;0;1
109;07.07.2015;2015;07;04;Tiistai;2;2;4;0;1;1
109;07.07.2015;2015;07;05;Tiistai;5;14;19;1;1;2
109;07.07.2015;2015;07;06;Tiistai;42;14;56;3;1;4
109;07.07.2015;2015;07;07;Tiistai;65;37;102;3;3;6
109;07.07.2015;2015;07;08;Tiistai;25;20;45;6;4;10
109;07.07.2015;2015;07;09;Tiistai;21;4;25;9;0;9
109;07.07.2015;2015;07;10;Tiistai;14;11;25;1;3;4
109;07.07.2015;2015;07;11;Tiistai;25;13;38;6;4;10
109;07.07.2015;2015;07;12;Tiistai;17;20;37;3;3;6
109;07.07.2015;2015;07;13;Tiistai;21;12;33;2;1;3
109;07.07.2015;2015;07;14;Tiistai;17;20;37;1;2;3
109;07.07.2015;2015;07;15;Tiistai;36;46;82;6;4;10
109;07.07.2015;2015;07;16;Tiistai;45;50;95;7;5;12
109;07.07.2015;2015;07;17;Tiistai;21;31;52;8;2;10
109;07.07.2015;2015;07;18;Tiistai;16;17;33;5;6;11
109;07.07.2015;2015;07;19;Tiistai;21;19;40;6;4;10
109;07.07.2015;2015;07;20;Tiistai;6;22;28;8;4;12
109;07.07.2015;2015;07;21;Tiistai;17;21;38;0;6;6
109;07.07.2015;2015;07;22;Tiistai;6;5;11;1;0;1
109;07.07.2015;2015;07;23;Tiistai;0;5;5;0;0;0
109;08.07.2015;2015;07;00;Keskiviikko;0;0;0;0;0;0
109;08.07.2015;2015;07;01;Keskiviikko;1;0;1;0;0;0
109;08.07.2015;2015;07;02;Keskiviikko;0;0;0;0;0;0
109;08.07.2015;2015;07;03;Keskiviikko;2;1;3;0;0;0
109;08.07.2015;2015;07;04;Keskiviikko;1;3;4;0;0;0
109;08.07.2015;2015;07;05;Keskiviikko;4;18;22;1;0;1
109;08.07.2015;2015;07;06;Keskiviikko;37;12;49;0;3;3
109;08.07.2015;2015;07;07;Keskiviikko;47;41;88;3;2;5
109;08.07.2015;2015;07;08;Keskiviikko;20;20;40;4;1;5
109;08.07.2015;2015;07;09;Keskiviikko;13;7;20;4;3;7
109;08.07.2015;2015;07;10;Keskiviikko;13;7;20;3;2;5
109;08.07.2015;2015;07;11;Keskiviikko;15;18;33;5;3;8
109;08.07.2015;2015;07;12;Keskiviikko;21;15;36;5;5;10
109;08.07.2015;2015;07;13;Keskiviikko;22;14;36;0;3;3
109;08.07.2015;2015;07;14;Keskiviikko;25;14;39;2;1;3
109;08.07.2015;2015;07;15;Keskiviikko;42;45;87;7;1;8
109;08.07.2015;2015;07;16;Keskiviikko;53;47;100;9;2;11
109;08.07.2015;2015;07;17;Keskiviikko;18;19;37;4;7;11
109;08.07.2015;2015;07;18;Keskiviikko;25;26;51;6;4;10
109;08.07.2015;2015;07;19;Keskiviikko;20;19;39;8;2;10
109;08.07.2015;2015;07;20;Keskiviikko;10;13;23;5;8;13
109;08.07.2015;2015;07;21;Keskiviikko;12;16;28;2;6;8
109;08.07.2015;2015;07;22;Keskiviikko;12;3;15;0;0;0
109;08.07.2015;2015;07;23;Keskiviikko;2;4;6;3;0;3
109;09.07.2015;2015;07;00;Torstai;2;5;7;0;1;1
109;09.07.2015;2015;07;01;Torstai;1;2;3;0;1;1
109;09.07.2015;2015;07;02;Torstai;0;3;3;0;0;0
109;09.07.2015;2015;07;03;Torstai;2;1;3;0;0;0
109;09.07.2015;2015;07;04;Torstai;1;4;5;0;0;0
109;09.07.2015;2015;07;05;Torstai;5;11;16;0;1;1
109;09.07.2015;2015;07;06;Torstai;26;8;34;0;0;0
109;09.07.2015;2015;07;07;Torstai;25;30;55;2;2;4
109;09.07.2015;2015;07;08;Torstai;19;9;28;1;4;5
109;09.07.2015;2015;07;09;Torstai;6;6;12;3;2;5
109;09.07.2015;2015;07;10;Torstai;8;5;13;2;1;3
109;09.07.2015;2015;07;11;Torstai;7;5;12;2;3;5
109;09.07.2015;2015;07;12;Torstai;9;11;20;0;0;0
109;09.07.2015;2015;07;13;Torstai;10;6;16;1;1;2
109;09.07.2015;2015;07;14;Torstai;7;9;16;2;2;4
109;09.07.2015;2015;07;15;Torstai;22;26;48;6;0;6
109;09.07.2015;2015;07;16;Torstai;31;20;51;1;2;3
109;09.07.2015;2015;07;17;Torstai;11;12;23;5;4;9
109;09.07.2015;2015;07;18;Torstai;9;7;16;3;3;6
109;09.07.2015;2015;07;19;Torstai;11;5;16;5;3;8
109;09.07.2015;2015;07;20;Torstai;5;6;11;2;3;5
109;09.07.2015;2015;07;21;Torstai;6;10;16;4;3;7
109;09.07.2015;2015;07;22;Torstai;6;6;12;0;0;0
109;09.07.2015;2015;07;23;Torstai;2;1;3;0;0;0
109;10.07.2015;2015;07;00;Perjantai;1;2;3;3;2;5
109;10.07.2015;2015;07;01;Perjantai;0;1;1;0;0;0
109;10.07.2015;2015;07;02;Perjantai;0;0;0;1;0;1
109;10.07.2015;2015;07;03;Perjantai;1;0;1;0;0;0
109;10.07.2015;2015;07;04;Perjantai;0;2;2;0;0;0
109;10.07.2015;2015;07;05;Perjantai;2;9;11;1;2;3
109;10.07.2015;2015;07;06;Perjantai;29;8;37;1;2;3
109;10.07.2015;2015;07;07;Perjantai;31;19;50;3;2;5
109;10.07.2015;2015;07;08;Perjantai;12;11;23;3;1;4
109;10.07.2015;2015;07;09;Perjantai;7;10;17;4;2;6
109;10.07.2015;2015;07;10;Perjantai;16;5;21;6;3;9
109;10.07.2015;2015;07;11;Perjantai;28;12;40;6;1;7
109;10.07.2015;2015;07;12;Perjantai;14;8;22;5;2;7
109;10.07.2015;2015;07;13;Perjantai;17;22;39;6;3;9
109;10.07.2015;2015;07;14;Perjantai;25;21;46;6;3;9
109;10.07.2015;2015;07;15;Perjantai;40;42;82;9;5;14
109;10.07.2015;2015;07;16;Perjantai;29;29;58;9;3;12
109;10.07.2015;2015;07;17;Perjantai;26;23;49;4;3;7
109;10.07.2015;2015;07;18;Perjantai;15;32;47;3;5;8
109;10.07.2015;2015;07;19;Perjantai;24;12;36;5;1;6
109;10.07.2015;2015;07;20;Perjantai;11;15;26;6;3;9
109;10.07.2015;2015;07;21;Perjantai;15;13;28;5;2;7
109;10.07.2015;2015;07;22;Perjantai;11;1;12;2;7;9
109;10.07.2015;2015;07;23;Perjantai;24;6;30;1;0;1
109;11.07.2015;2015;07;00;Lauantai;6;5;11;0;1;1
109;11.07.2015;2015;07;01;Lauantai;2;3;5;1;0;1
109;11.07.2015;2015;07;02;Lauantai;1;1;2;4;2;6
109;11.07.2015;2015;07;03;Lauantai;0;0;0;0;1;1
109;11.07.2015;2015;07;04;Lauantai;1;3;4;0;2;2
109;11.07.2015;2015;07;05;Lauantai;1;1;2;0;2;2
109;11.07.2015;2015;07;06;Lauantai;8;0;8;0;0;0
109;11.07.2015;2015;07;07;Lauantai;6;6;12;3;6;9
109;11.07.2015;2015;07;08;Lauantai;4;6;10;7;0;7
109;11.07.2015;2015;07;09;Lauantai;6;3;9;1;5;6
109;11.07.2015;2015;07;10;Lauantai;11;6;17;3;3;6
109;11.07.2015;2015;07;11;Lauantai;6;8;14;2;1;3
109;11.07.2015;2015;07;12;Lauantai;18;8;26;3;1;4
109;11.07.2015;2015;07;13;Lauantai;19;20;39;2;2;4
109;11.07.2015;2015;07;14;Lauantai;20;13;33;7;3;10
109;11.07.2015;2015;07;15;Lauantai;22;28;50;9;7;16
109;11.07.2015;2015;07;16;Lauantai;9;12;21;8;4;12
109;11.07.2015;2015;07;17;Lauantai;6;14;20;3;2;5
109;11.07.2015;2015;07;18;Lauantai;29;16;45;5;5;10
109;11.07.2015;2015;07;19;Lauantai;10;13;23;2;1;3
109;11.07.2015;2015;07;20;Lauantai;13;5;18;2;4;6
109;11.07.2015;2015;07;21;Lauantai;1;10;11;2;5;7
109;11.07.2015;2015;07;22;Lauantai;5;7;12;0;2;2
109;11.07.2015;2015;07;23;Lauantai;0;4;4;0;1;1
109;12.07.2015;2015;07;00;Sunnuntai;2;7;9;0;1;1
109;12.07.2015;2015;07;01;Sunnuntai;7;2;9;0;0;0
109;12.07.2015;2015;07;02;Sunnuntai;2;1;3;0;0;0
109;12.07.2015;2015;07;03;Sunnuntai;1;2;3;0;1;1
109;12.07.2015;2015;07;04;Sunnuntai;2;7;9;0;1;1
109;12.07.2015;2015;07;05;Sunnuntai;0;3;3;0;0;0
109;12.07.2015;2015;07;06;Sunnuntai;5;0;5;0;0;0
109;12.07.2015;2015;07;07;Sunnuntai;1;2;3;1;4;5
109;12.07.2015;2015;07;08;Sunnuntai;5;3;8;5;2;7
109;12.07.2015;2015;07;09;Sunnuntai;3;4;7;4;1;5
109;12.07.2015;2015;07;10;Sunnuntai;8;5;13;2;8;10
109;12.07.2015;2015;07;11;Sunnuntai;15;15;30;7;4;11
109;12.07.2015;2015;07;12;Sunnuntai;20;21;41;5;8;13
109;12.07.2015;2015;07;13;Sunnuntai;21;16;37;5;1;6
109;12.07.2015;2015;07;14;Sunnuntai;19;18;37;7;3;10
109;12.07.2015;2015;07;15;Sunnuntai;19;18;37;1;7;8
109;12.07.2015;2015;07;16;Sunnuntai;3;23;26;4;5;9
109;12.07.2015;2015;07;17;Sunnuntai;19;22;41;5;3;8
109;12.07.2015;2015;07;18;Sunnuntai;21;12;33;5;1;6
109;12.07.2015;2015;07;19;Sunnuntai;14;8;22;4;4;8
109;12.07.2015;2015;07;20;Sunnuntai;11;6;17;6;5;11
109;12.07.2015;2015;07;21;Sunnuntai;7;12;19;7;1;8
109;12.07.2015;2015;07;22;Sunnuntai;7;4;11;1;0;1
109;12.07.2015;2015;07;23;Sunnuntai;2;1;3;0;0;0
109;13.07.2015;2015;07;00;Maanantai;0;1;1;0;0;0
109;13.07.2015;2015;07;01;Maanantai;2;0;2;0;0;0
109;13.07.2015;2015;07;02;Maanantai;0;1;1;0;0;0
109;13.07.2015;2015;07;03;Maanantai;0;1;1;0;0;0
109;13.07.2015;2015;07;04;Maanantai;2;0;2;0;0;0
109;13.07.2015;2015;07;05;Maanantai;18;5;23;4;1;5
109;13.07.2015;2015;07;06;Maanantai;17;30;47;3;6;9
109;13.07.2015;2015;07;07;Maanantai;38;40;78;9;5;14
109;13.07.2015;2015;07;08;Maanantai;13;19;32;1;4;5
109;13.07.2015;2015;07;09;Maanantai;10;15;25;4;1;5
109;13.07.2015;2015;07;10;Maanantai;9;18;27;1;4;5
109;13.07.2015;2015;07;11;Maanantai;18;19;37;4;2;6
109;13.07.2015;2015;07;12;Maanantai;13;25;38;2;4;6
109;13.07.2015;2015;07;13;Maanantai;22;23;45;4;3;7
109;13.07.2015;2015;07;14;Maanantai;27;30;57;4;7;11
109;13.07.2015;2015;07;15;Maanantai;42;43;85;8;6;14
109;13.07.2015;2015;07;16;Maanantai;43;45;88;6;9;15
109;13.07.2015;2015;07;17;Maanantai;26;29;55;7;4;11
109;13.07.2015;2015;07;18;Maanantai;25;28;53;3;6;9
109;13.07.2015;2015;07;19;Maanantai;14;17;31;4;1;5
109;13.07.2015;2015;07;20;Maanantai;14;16;30;0;4;4
109;13.07.2015;2015;07;21;Maanantai;15;17;32;4;1;5
109;13.07.2015;2015;07;22;Maanantai;6;9;15;1;2;3
109;13.07.2015;2015;07;23;Maanantai;1;4;5;0;0;0
109;14.07.2015;2015;07;00;Tiistai;3;3;6;0;1;1
109;14.07.2015;2015;07;01;Tiistai;1;2;3;0;0;0
109;14.07.2015;2015;07;02;Tiistai;0;3;3;0;0;0
109;14.07.2015;2015;07;03;Tiistai;0;1;1;0;0;0
109;14.07.2015;2015;07;04;Tiistai;0;1;1;0;0;0
109;14.07.2015;2015;07;05;Tiistai;7;11;18;3;1;4
109;14.07.2015;2015;07;06;Tiistai;25;25;50;3;5;8
109;14.07.2015;2015;07;07;Tiistai;40;43;83;9;6;15
109;14.07.2015;2015;07;08;Tiistai;16;16;32;1;4;5
109;14.07.2015;2015;07;09;Tiistai;14;15;29;4;1;5
109;14.07.2015;2015;07;10;Tiistai;13;16;29;2;4;6
109;14.07.2015;2015;07;11;Tiistai;15;16;31;4;2;6
109;14.07.2015;2015;07;12;Tiistai;15;17;32;2;4;6
109;14.07.2015;2015;07;13;Tiistai;18;22;40;4;3;7
109;14.07.2015;2015;07;14;Tiistai;23;24;47;3;4;7
109;14.07.2015;2015;07;15;Tiistai;40;42;82;7;7;14
109;14.07.2015;2015;07;16;Tiistai;45;46;91;6;9;15
109;14.07.2015;2015;07;17;Tiistai;34;37;71;7;5;12
109;14.07.2015;2015;07;18;Tiistai;19;22;41;2;4;6
109;14.07.2015;2015;07;19;Tiistai;15;18;33;4;2;6
109;14.07.2015;2015;07;20;Tiistai;12;14;26;0;4;4
109;14.07.2015;2015;07;21;Tiistai;14;14;28;3;1;4
109;14.07.2015;2015;07;22;Tiistai;8;9;17;0;2;2
109;14.07.2015;2015;07;23;Tiistai;4;5;9;1;0;1
109;15.07.2015;2015;07;00;Keskiviikko;0;2;2;0;0;0
109;15.07.2015;2015;07;01;Keskiviikko;2;2;4;0;0;0
109;15.07.2015;2015;07;02;Keskiviikko;1;3;4;0;0;0
109;15.07.2015;2015;07;03;Keskiviikko;0;2;2;0;0;0
109;15.07.2015;2015;07;04;Keskiviikko;0;3;3;0;0;0
109;15.07.2015;2015;07;05;Keskiviikko;5;8;13;3;0;3
109;15.07.2015;2015;07;06;Keskiviikko;19;22;41;3;4;7
109;15.07.2015;2015;07;07;Keskiviikko;43;44;87;9;6;15
109;15.07.2015;2015;07;08;Keskiviikko;15;17;32;2;4;6
109;15.07.2015;2015;07;09;Keskiviikko;11;14;25;4;1;5
109;15.07.2015;2015;07;10;Keskiviikko;15;17;32;1;4;5
109;15.07.2015;2015;07;11;Keskiviikko;14;16;30;4;2;6
109;15.07.2015;2015;07;12;Keskiviikko;17;18;35;1;5;6
109;15.07.2015;2015;07;13;Keskiviikko;21;21;42;4;3;7
109;15.07.2015;2015;07;14;Keskiviikko;23;26;49;3;6;9
109;15.07.2015;2015;07;15;Keskiviikko;35;36;71;8;4;12
109;15.07.2015;2015;07;16;Keskiviikko;41;42;83;5;8;13
109;15.07.2015;2015;07;17;Keskiviikko;32;36;68;7;5;12
109;15.07.2015;2015;07;18;Keskiviikko;23;25;48;3;5;8
109;15.07.2015;2015;07;19;Keskiviikko;16;18;34;4;2;6
109;15.07.2015;2015;07;20;Keskiviikko;11;15;26;1;4;5
109;15.07.2015;2015;07;21;Keskiviikko;12;16;28;3;2;5
109;15.07.2015;2015;07;22;Keskiviikko;3;7;10;0;2;2
109;15.07.2015;2015;07;23;Keskiviikko;5;7;12;2;0;2
109;16.07.2015;2015;07;00;Torstai;0;1;1;0;0;0
109;16.07.2015;2015;07;01;Torstai;0;1;1;0;0;0
109;16.07.2015;2015;07;02;Torstai;0;1;1;0;0;0
109;16.07.2015;2015;07;03;Torstai;0;1;1;0;0;0
109;16.07.2015;2015;07;04;Torstai;0;1;1;0;0;0
109;16.07.2015;2015;07;05;Torstai;8;9;17;3;0;3
109;16.07.2015;2015;07;06;Torstai;14;17;31;2;4;6
109;16.07.2015;2015;07;07;Torstai;33;36;69;7;5;12
109;16.07.2015;2015;07;08;Torstai;11;14;25;1;3;4
109;16.07.2015;2015;07;09;Torstai;6;7;13;2;0;2
109;16.07.2015;2015;07;10;Torstai;7;8;15;0;3;3
109;16.07.2015;2015;07;11;Torstai;9;12;21;3;1;4
109;16.07.2015;2015;07;12;Torstai;16;17;33;2;4;6
109;16.07.2015;2015;07;13;Torstai;13;15;28;4;2;6
109;16.07.2015;2015;07;14;Torstai;16;18;34;2;4;6
109;16.07.2015;2015;07;15;Torstai;35;36;71;7;4;11
109;16.07.2015;2015;07;16;Torstai;34;35;69;6;6;12
109;16.07.2015;2015;07;17;Torstai;24;26;50;5;3;8
109;16.07.2015;2015;07;18;Torstai;20;23;43;4;5;9
109;16.07.2015;2015;07;19;Torstai;12;14;26;3;1;4
109;16.07.2015;2015;07;20;Torstai;11;13;24;1;4;5
109;16.07.2015;2015;07;21;Torstai;15;17;32;4;2;6
109;16.07.2015;2015;07;22;Torstai;3;5;8;0;1;1
109;16.07.2015;2015;07;23;Torstai;3;4;7;1;0;1
109;17.07.2015;2015;07;00;Perjantai;2;4;6;0;1;1
109;17.07.2015;2015;07;01;Perjantai;0;2;2;0;0;0
109;17.07.2015;2015;07;02;Perjantai;0;1;1;0;0;0
109;17.07.2015;2015;07;03;Perjantai;0;0;0;0;0;0
109;17.07.2015;2015;07;04;Perjantai;2;3;5;0;0;0
109;17.07.2015;2015;07;05;Perjantai;8;10;18;2;1;3
109;17.07.2015;2015;07;06;Perjantai;23;25;48;3;5;8
109;17.07.2015;2015;07;07;Perjantai;31;34;65;7;4;11
109;17.07.2015;2015;07;08;Perjantai;13;14;27;1;4;5
109;17.07.2015;2015;07;09;Perjantai;11;14;25;4;0;4
109;17.07.2015;2015;07;10;Perjantai;14;16;30;1;4;5
109;17.07.2015;2015;07;11;Perjantai;17;19;36;4;1;5
109;17.07.2015;2015;07;12;Perjantai;14;17;31;3;4;7
109;17.07.2015;2015;07;13;Perjantai;32;34;66;8;4;12
109;17.07.2015;2015;07;14;Perjantai;28;31;59;4;6;10
109;17.07.2015;2015;07;15;Perjantai;40;42;82;9;5;14
109;17.07.2015;2015;07;16;Perjantai;36;37;73;5;8;13
109;17.07.2015;2015;07;17;Perjantai;22;24;46;5;2;7
109;17.07.2015;2015;07;18;Perjantai;20;23;43;3;4;7
109;17.07.2015;2015;07;19;Perjantai;15;17;32;5;1;6
109;17.07.2015;2015;07;20;Perjantai;18;21;39;3;4;7
109;17.07.2015;2015;07;21;Perjantai;13;16;29;4;1;5
109;17.07.2015;2015;07;22;Perjantai;9;12;21;1;3;4
109;17.07.2015;2015;07;23;Perjantai;3;4;7;1;0;1
109;18.07.2015;2015;07;00;Lauantai;3;6;9;0;2;2
109;18.07.2015;2015;07;01;Lauantai;2;5;7;1;0;1
109;18.07.2015;2015;07;02;Lauantai;1;1;2;0;0;0
109;18.07.2015;2015;07;03;Lauantai;3;7;10;3;0;3
109;18.07.2015;2015;07;04;Lauantai;2;4;6;0;1;1
109;18.07.2015;2015;07;05;Lauantai;1;2;3;0;0;0
109;18.07.2015;2015;07;06;Lauantai;4;6;10;0;2;2
109;18.07.2015;2015;07;07;Lauantai;4;6;10;2;0;2
109;18.07.2015;2015;07;08;Lauantai;5;8;13;0;2;2
109;18.07.2015;2015;07;09;Lauantai;7;9;16;3;0;3
109;18.07.2015;2015;07;10;Lauantai;15;16;31;1;4;5
109;18.07.2015;2015;07;11;Lauantai;15;17;32;4;1;5
109;18.07.2015;2015;07;12;Lauantai;17;20;37;2;4;6
109;18.07.2015;2015;07;13;Lauantai;19;20;39;4;3;7
109;18.07.2015;2015;07;14;Lauantai;23;25;48;3;5;8
109;18.07.2015;2015;07;15;Lauantai;31;33;64;6;4;10
109;18.07.2015;2015;07;16;Lauantai;19;20;39;2;5;7
109;18.07.2015;2015;07;17;Lauantai;15;17;32;5;2;7
109;18.07.2015;2015;07;18;Lauantai;27;29;56;5;5;10
109;18.07.2015;2015;07;19;Lauantai;17;19;36;4;3;7
109;18.07.2015;2015;07;20;Lauantai;13;15;28;1;4;5
109;18.07.2015;2015;07;21;Lauantai;7;7;14;1;0;1
109;18.07.2015;2015;07;22;Lauantai;1;3;4;0;1;1
109;18.07.2015;2015;07;23;Lauantai;1;3;4;1;0;1
109;19.07.2015;2015;07;00;Sunnuntai;3;5;8;0;2;2
109;19.07.2015;2015;07;01;Sunnuntai;0;2;2;0;0;0
109;19.07.2015;2015;07;02;Sunnuntai;2;3;5;0;1;1
109;19.07.2015;2015;07;03;Sunnuntai;0;3;3;0;0;0
109;19.07.2015;2015;07;04;Sunnuntai;0;2;2;0;0;0
109;19.07.2015;2015;07;05;Sunnuntai;0;1;1;0;0;0
109;19.07.2015;2015;07;06;Sunnuntai;1;3;4;0;0;0
109;19.07.2015;2015;07;07;Sunnuntai;5;6;11;2;0;2
109;19.07.2015;2015;07;08;Sunnuntai;2;2;4;0;0;0
109;19.07.2015;2015;07;09;Sunnuntai;1;3;4;0;0;0
109;19.07.2015;2015;07;10;Sunnuntai;3;5;8;0;1;1
109;19.07.2015;2015;07;11;Sunnuntai;4;5;9;2;0;2
109;19.07.2015;2015;07;12;Sunnuntai;7;8;15;0;2;2
109;19.07.2015;2015;07;13;Sunnuntai;9;10;19;3;0;3
109;19.07.2015;2015;07;14;Sunnuntai;8;9;17;0;4;4
109;19.07.2015;2015;07;15;Sunnuntai;6;10;16;4;0;4
109;19.07.2015;2015;07;16;Sunnuntai;3;5;8;0;1;1
109;19.07.2015;2015;07;17;Sunnuntai;7;9;16;2;1;3
109;19.07.2015;2015;07;18;Sunnuntai;8;12;20;1;3;4
109;19.07.2015;2015;07;19;Sunnuntai;17;19;36;4;3;7
109;19.07.2015;2015;07;20;Sunnuntai;13;15;28;0;4;4
109;19.07.2015;2015;07;21;Sunnuntai;4;6;10;3;0;3
109;19.07.2015;2015;07;22;Sunnuntai;4;6;10;0;2;2
109;19.07.2015;2015;07;23;Sunnuntai;0;1;1;0;0;0
109;20.07.2015;2015;07;00;Maanantai;0;0;0;0;0;0
109;20.07.2015;2015;07;01;Maanantai;0;1;1;0;0;0
109;20.07.2015;2015;07;02;Maanantai;0;2;2;0;0;0
109;20.07.2015;2015;07;03;Maanantai;0;0;0;0;0;0
109;20.07.2015;2015;07;04;Maanantai;3;3;6;0;1;1
109;20.07.2015;2015;07;05;Maanantai;9;11;20;4;0;4
109;20.07.2015;2015;07;06;Maanantai;19;21;40;2;5;7
109;20.07.2015;2015;07;07;Maanantai;44;44;88;9;5;14
109;20.07.2015;2015;07;08;Maanantai;17;19;36;2;4;6
109;20.07.2015;2015;07;09;Maanantai;12;15;27;4;1;5
109;20.07.2015;2015;07;10;Maanantai;15;16;31;2;4;6
109;20.07.2015;2015;07;11;Maanantai;17;19;36;4;3;7
109;20.07.2015;2015;07;12;Maanantai;19;21;40;3;4;7
109;20.07.2015;2015;07;13;Maanantai;28;30;58;6;4;10
109;20.07.2015;2015;07;14;Maanantai;25;27;52;4;5;9
109;20.07.2015;2015;07;15;Maanantai;41;44;85;9;6;15
109;20.07.2015;2015;07;16;Maanantai;56;59;115;9;11;20
109;20.07.2015;2015;07;17;Maanantai;31;32;63;7;4;11
109;20.07.2015;2015;07;18;Maanantai;18;20;38;2;5;7
109;20.07.2015;2015;07;19;Maanantai;22;24;46;4;3;7
109;20.07.2015;2015;07;20;Maanantai;19;20;39;2;4;6
109;20.07.2015;2015;07;21;Maanantai;12;15;27;4;0;4
109;20.07.2015;2015;07;22;Maanantai;9;11;20;1;3;4
109;20.07.2015;2015;07;23;Maanantai;3;4;7;1;0;1
109;21.07.2015;2015;07;00;Tiistai;0;0;0;0;0;0
109;21.07.2015;2015;07;01;Tiistai;1;3;4;0;0;0
109;21.07.2015;2015;07;02;Tiistai;0;0;0;0;0;0
109;21.07.2015;2015;07;03;Tiistai;1;1;2;0;0;0
109;21.07.2015;2015;07;04;Tiistai;1;2;3;0;0;0
109;21.07.2015;2015;07;05;Tiistai;8;9;17;3;0;3
109;21.07.2015;2015;07;06;Tiistai;23;24;47;2;6;8
109;21.07.2015;2015;07;07;Tiistai;40;41;81;8;6;14
109;21.07.2015;2015;07;08;Tiistai;12;14;26;1;4;5
109;21.07.2015;2015;07;09;Tiistai;9;12;21;3;1;4
109;21.07.2015;2015;07;10;Tiistai;11;14;25;1;4;5
109;21.07.2015;2015;07;11;Tiistai;6;9;15;4;0;4
109;21.07.2015;2015;07;12;Tiistai;19;22;41;3;4;7
109;21.07.2015;2015;07;13;Tiistai;20;23;43;4;3;7
109;21.07.2015;2015;07;14;Tiistai;21;21;42;3;4;7
109;21.07.2015;2015;07;15;Tiistai;38;40;78;8;6;14
109;21.07.2015;2015;07;16;Tiistai;37;40;77;6;8;14
109;21.07.2015;2015;07;17;Tiistai;26;27;53;5;3;8
109;21.07.2015;2015;07;18;Tiistai;18;21;39;3;5;8
109;21.07.2015;2015;07;19;Tiistai;17;19;36;4;2;6
109;21.07.2015;2015;07;20;Tiistai;9;13;22;1;3;4
109;21.07.2015;2015;07;21;Tiistai;16;18;34;4;2;6
109;21.07.2015;2015;07;22;Tiistai;5;7;12;0;2;2
109;21.07.2015;2015;07;23;Tiistai;2;3;5;1;0;1
109;22.07.2015;2015;07;00;Keskiviikko;2;4;6;0;1;1
109;22.07.2015;2015;07;01;Keskiviikko;0;0;0;0;0;0
109;22.07.2015;2015;07;02;Keskiviikko;1;2;3;0;0;0
109;22.07.2015;2015;07;03;Keskiviikko;0;1;1;0;0;0
109;22.07.2015;2015;07;04;Keskiviikko;1;2;3;0;0;0
109;22.07.2015;2015;07;05;Keskiviikko;10;12;22;3;1;4
109;22.07.2015;2015;07;06;Keskiviikko;19;22;41;3;5;8
109;22.07.2015;2015;07;07;Keskiviikko;38;40;78;8;5;13
109;22.07.2015;2015;07;08;Keskiviikko;24;25;49;3;5;8
109;22.07.2015;2015;07;09;Keskiviikko;13;14;27;4;0;4
109;22.07.2015;2015;07;10;Keskiviikko;17;18;35;2;4;6
109;22.07.2015;2015;07;11;Keskiviikko;17;18;35;5;1;6
109;22.07.2015;2015;07;12;Keskiviikko;19;21;40;2;5;7
109;22.07.2015;2015;07;13;Keskiviikko;22;22;44;4;3;7
109;22.07.2015;2015;07;14;Keskiviikko;31;34;65;4;8;12
109;22.07.2015;2015;07;15;Keskiviikko;48;51;99;10;7;17
109;22.07.2015;2015;07;16;Keskiviikko;43;45;88;6;9;15
109;22.07.2015;2015;07;17;Keskiviikko;32;35;67;8;5;13
109;22.07.2015;2015;07;18;Keskiviikko;21;22;43;2;5;7
109;22.07.2015;2015;07;19;Keskiviikko;21;24;45;4;3;7
109;22.07.2015;2015;07;20;Keskiviikko;16;18;34;2;4;6
109;22.07.2015;2015;07;21;Keskiviikko;14;15;29;4;0;4
109;22.07.2015;2015;07;22;Keskiviikko;10;13;23;0;3;3
109;22.07.2015;2015;07;23;Keskiviikko;5;5;10;2;0;2
109;23.07.2015;2015;07;00;Torstai;1;3;4;0;0;0
109;23.07.2015;2015;07;01;Torstai;1;3;4;1;0;1
109;23.07.2015;2015;07;02;Torstai;1;3;4;0;1;1
109;23.07.2015;2015;07;03;Torstai;0;3;3;0;0;0
109;23.07.2015;2015;07;04;Torstai;1;2;3;0;0;0
109;23.07.2015;2015;07;05;Torstai;14;15;29;5;1;6
109;23.07.2015;2015;07;06;Torstai;22;24;46;2;6;8
109;23.07.2015;2015;07;07;Torstai;35;36;71;7;4;11
109;23.07.2015;2015;07;08;Torstai;19;21;40;2;5;7
109;23.07.2015;2015;07;09;Torstai;10;11;21;3;0;3
109;23.07.2015;2015;07;10;Torstai;16;18;34;3;4;7
109;23.07.2015;2015;07;11;Torstai;23;26;49;5;4;9
109;23.07.2015;2015;07;12;Torstai;23;24;47;4;5;9
109;23.07.2015;2015;07;13;Torstai;28;29;57;6;4;10
109;23.07.2015;2015;07;14;Torstai;26;27;53;4;5;9
109;23.07.2015;2015;07;15;Torstai;39;41;80;8;5;13
109;23.07.2015;2015;07;16;Torstai;46;48;94;7;9;16
109;23.07.2015;2015;07;17;Torstai;23;25;48;6;3;9
109;23.07.2015;2015;07;18;Torstai;8;11;19;0;4;4
109;23.07.2015;2015;07;19;Torstai;8;9;17;2;1;3
109;23.07.2015;2015;07;20;Torstai;10;14;24;2;3;5
109;23.07.2015;2015;07;21;Torstai;11;12;23;3;1;4
109;23.07.2015;2015;07;22;Torstai;5;7;12;0;2;2
109;23.07.2015;2015;07;23;Torstai;2;4;6;0;0;0
109;24.07.2015;2015;07;00;Perjantai;0;0;0;0;0;0
109;24.07.2015;2015;07;01;Perjantai;0;0;0;0;0;0
109;24.07.2015;2015;07;02;Perjantai;0;0;0;0;0;0
109;24.07.2015;2015;07;03;Perjantai;0;1;1;0;0;0
109;24.07.2015;2015;07;04;Perjantai;1;4;5;0;0;0
109;24.07.2015;2015;07;05;Perjantai;7;10;17;4;0;4
109;24.07.2015;2015;07;06;Perjantai;14;16;30;2;3;5
109;24.07.2015;2015;07;07;Perjantai;18;19;37;5;2;7
109;24.07.2015;2015;07;08;Perjantai;10;11;21;0;3;3
109;24.07.2015;2015;07;09;Perjantai;9;11;20;4;0;4
109;24.07.2015;2015;07;10;Perjantai;8;12;20;0;3;3
109;24.07.2015;2015;07;11;Perjantai;5;9;14;4;0;4
109;24.07.2015;2015;07;12;Perjantai;6;8;14;1;2;3
109;24.07.2015;2015;07;13;Perjantai;10;13;23;4;1;5
109;24.07.2015;2015;07;14;Perjantai;14;17;31;1;4;5
109;24.07.2015;2015;07;15;Perjantai;30;31;61;7;4;11
109;24.07.2015;2015;07;16;Perjantai;27;30;57;4;6;10
109;24.07.2015;2015;07;17;Perjantai;19;20;39;4;3;7
109;24.07.2015;2015;07;18;Perjantai;10;13;23;1;4;5
109;24.07.2015;2015;07;19;Perjantai;13;14;27;4;1;5
109;24.07.2015;2015;07;20;Perjantai;14;16;30;1;4;5
109;24.07.2015;2015;07;21;Perjantai;18;22;40;5;2;7
109;24.07.2015;2015;07;22;Perjantai;6;8;14;1;2;3
109;24.07.2015;2015;07;23;Perjantai;6;7;13;2;0;2
109;25.07.2015;2015;07;00;Lauantai;4;6;10;0;2;2
109;25.07.2015;2015;07;01;Lauantai;10;12;22;3;1;4
109;25.07.2015;2015;07;02;Lauantai;2;3;5;0;0;0
109;25.07.2015;2015;07;03;Lauantai;2;2;4;0;0;0
109;25.07.2015;2015;07;04;Lauantai;2;3;5;0;1;1
109;25.07.2015;2015;07;05;Lauantai;1;2;3;0;0;0
109;25.07.2015;2015;07;06;Lauantai;2;3;5;0;1;1
109;25.07.2015;2015;07;07;Lauantai;2;4;6;1;0;1
109;25.07.2015;2015;07;08;Lauantai;4;5;9;0;2;2
109;25.07.2015;2015;07;09;Lauantai;4;4;8;0;0;0
109;25.07.2015;2015;07;10;Lauantai;5;8;13;0;3;3
109;25.07.2015;2015;07;11;Lauantai;7;7;14;2;0;2
109;25.07.2015;2015;07;12;Lauantai;16;18;34;2;4;6
109;25.07.2015;2015;07;13;Lauantai;22;25;47;5;3;8
109;25.07.2015;2015;07;14;Lauantai;24;26;50;4;4;8
109;25.07.2015;2015;07;15;Lauantai;23;24;47;5;3;8
109;25.07.2015;2015;07;16;Lauantai;16;17;33;2;4;6
109;25.07.2015;2015;07;17;Lauantai;13;16;29;4;1;5
109;25.07.2015;2015;07;18;Lauantai;11;13;24;1;3;4
109;25.07.2015;2015;07;19;Lauantai;12;16;28;4;2;6
109;25.07.2015;2015;07;20;Lauantai;14;17;31;1;4;5
109;25.07.2015;2015;07;21;Lauantai;15;16;31;3;2;5
109;25.07.2015;2015;07;22;Lauantai;8;10;18;0;4;4
109;25.07.2015;2015;07;23;Lauantai;6;8;14;1;1;2
109;26.07.2015;2015;07;00;Sunnuntai;12;13;25;1;4;5
109;26.07.2015;2015;07;01;Sunnuntai;11;14;25;4;1;5
109;26.07.2015;2015;07;02;Sunnuntai;2;5;7;0;1;1
109;26.07.2015;2015;07;03;Sunnuntai;2;4;6;0;0;0
109;26.07.2015;2015;07;04;Sunnuntai;2;4;6;0;1;1
109;26.07.2015;2015;07;05;Sunnuntai;3;4;7;1;0;1
109;26.07.2015;2015;07;06;Sunnuntai;1;4;5;0;1;1
109;26.07.2015;2015;07;07;Sunnuntai;2;4;6;1;0;1
109;26.07.2015;2015;07;08;Sunnuntai;5;8;13;0;2;2
109;26.07.2015;2015;07;09;Sunnuntai;3;4;7;1;0;1
109;26.07.2015;2015;07;10;Sunnuntai;12;14;26;1;4;5
109;26.07.2015;2015;07;11;Sunnuntai;7;10;17;4;0;4
109;26.07.2015;2015;07;12;Sunnuntai;12;14;26;1;4;5
109;26.07.2015;2015;07;13;Sunnuntai;12;14;26;4;1;5
109;26.07.2015;2015;07;14;Sunnuntai;10;12;22;0;4;4
109;26.07.2015;2015;07;15;Sunnuntai;8;11;19;3;0;3
109;26.07.2015;2015;07;16;Sunnuntai;6;9;15;0;4;4
109;26.07.2015;2015;07;17;Sunnuntai;8;10;18;3;0;3
109;26.07.2015;2015;07;18;Sunnuntai;10;13;23;1;4;5
109;26.07.2015;2015;07;19;Sunnuntai;12;13;25;4;1;5
109;26.07.2015;2015;07;20;Sunnuntai;12;13;25;1;3;4
109;26.07.2015;2015;07;21;Sunnuntai;5;6;11;2;0;2
109;26.07.2015;2015;07;22;Sunnuntai;1;4;5;0;0;0
109;26.07.2015;2015;07;23;Sunnuntai;0;0;0;0;0;0
109;27.07.2015;2015;07;00;Maanantai;0;0;0;0;0;0
109;27.07.2015;2015;07;01;Maanantai;0;1;1;0;0;0
109;27.07.2015;2015;07;02;Maanantai;0;0;0;0;0;0
109;27.07.2015;2015;07;03;Maanantai;0;0;0;0;0;0
109;27.07.2015;2015;07;04;Maanantai;2;2;4;0;0;0
109;27.07.2015;2015;07;05;Maanantai;8;9;17;2;0;2
109;27.07.2015;2015;07;06;Maanantai;16;18;34;2;4;6
109;27.07.2015;2015;07;07;Maanantai;27;30;57;5;4;9
109;27.07.2015;2015;07;08;Maanantai;15;17;32;1;4;5
109;27.07.2015;2015;07;09;Maanantai;8;9;17;3;0;3
109;27.07.2015;2015;07;10;Maanantai;4;7;11;0;3;3
109;27.07.2015;2015;07;11;Maanantai;13;16;29;4;1;5
109;27.07.2015;2015;07;12;Maanantai;19;20;39;3;4;7
109;27.07.2015;2015;07;13;Maanantai;19;20;39;4;3;7
109;27.07.2015;2015;07;14;Maanantai;17;20;37;4;4;8
109;27.07.2015;2015;07;15;Maanantai;31;33;64;7;4;11
109;27.07.2015;2015;07;16;Maanantai;32;35;67;5;7;12
109;27.07.2015;2015;07;17;Maanantai;23;24;47;5;4;9
109;27.07.2015;2015;07;18;Maanantai;17;20;37;3;4;7
109;27.07.2015;2015;07;19;Maanantai;14;17;31;4;2;6
109;27.07.2015;2015;07;20;Maanantai;10;11;21;0;4;4
109;27.07.2015;2015;07;21;Maanantai;11;14;25;4;0;4
109;27.07.2015;2015;07;22;Maanantai;6;9;15;0;3;3
109;27.07.2015;2015;07;23;Maanantai;4;5;9;2;0;2
109;28.07.2015;2015;07;00;Tiistai;2;3;5;0;0;0
109;28.07.2015;2015;07;01;Tiistai;0;0;0;0;0;0
109;28.07.2015;2015;07;02;Tiistai;1;1;2;0;0;0
109;28.07.2015;2015;07;03;Tiistai;0;0;0;0;0;0
109;28.07.2015;2015;07;04;Tiistai;1;1;2;0;0;0
109;28.07.2015;2015;07;05;Tiistai;14;16;30;4;2;6
109;28.07.2015;2015;07;06;Tiistai;25;27;52;3;5;8
109;28.07.2015;2015;07;07;Tiistai;40;43;83;8;6;14
109;28.07.2015;2015;07;08;Tiistai;23;24;47;3;5;8
109;28.07.2015;2015;07;09;Tiistai;13;15;28;4;1;5
109;28.07.2015;2015;07;10;Tiistai;9;10;19;0;2;2
109;28.07.2015;2015;07;11;Tiistai;14;15;29;4;1;5
109;28.07.2015;2015;07;12;Tiistai;19;19;38;2;4;6
109;28.07.2015;2015;07;13;Tiistai;17;19;36;4;2;6
109;28.07.2015;2015;07;14;Tiistai;30;33;63;5;6;11
109;28.07.2015;2015;07;15;Tiistai;44;45;89;9;7;16
109;28.07.2015;2015;07;16;Tiistai;48;51;99;8;9;17
109;28.07.2015;2015;07;17;Tiistai;30;32;62;7;4;11
109;28.07.2015;2015;07;18;Tiistai;16;20;36;3;4;7
109;28.07.2015;2015;07;19;Tiistai;20;22;42;5;3;8
109;28.07.2015;2015;07;20;Tiistai;15;17;32;2;4;6
109;28.07.2015;2015;07;21;Tiistai;13;17;30;4;2;6
109;28.07.2015;2015;07;22;Tiistai;8;9;17;1;2;3
109;28.07.2015;2015;07;23;Tiistai;5;6;11;2;0;2
109;29.07.2015;2015;07;00;Keskiviikko;0;0;0;0;0;0
109;29.07.2015;2015;07;01;Keskiviikko;1;1;2;0;0;0
109;29.07.2015;2015;07;02;Keskiviikko;0;1;1;0;0;0
109;29.07.2015;2015;07;03;Keskiviikko;0;1;1;0;0;0
109;29.07.2015;2015;07;04;Keskiviikko;0;1;1;0;0;0
109;29.07.2015;2015;07;05;Keskiviikko;13;15;28;3;2;5
109;29.07.2015;2015;07;06;Keskiviikko;26;28;54;5;5;10
109;29.07.2015;2015;07;07;Keskiviikko;44;46;90;8;7;15
109;29.07.2015;2015;07;08;Keskiviikko;22;25;47;3;5;8
109;29.07.2015;2015;07;09;Keskiviikko;10;13;23;3;2;5
109;29.07.2015;2015;07;10;Keskiviikko;10;12;22;1;4;5
109;29.07.2015;2015;07;11;Keskiviikko;18;21;39;4;3;7
109;29.07.2015;2015;07;12;Keskiviikko;18;20;38;1;5;6
109;29.07.2015;2015;07;13;Keskiviikko;23;24;47;5;4;9
109;29.07.2015;2015;07;14;Keskiviikko;21;22;43;3;4;7
109;29.07.2015;2015;07;15;Keskiviikko;42;46;88;10;6;16
109;29.07.2015;2015;07;16;Keskiviikko;49;52;101;8;9;17
109;29.07.2015;2015;07;17;Keskiviikko;21;23;44;6;3;9
109;29.07.2015;2015;07;18;Keskiviikko;7;8;15;1;1;2
109;29.07.2015;2015;07;19;Keskiviikko;9;9;18;2;0;2
109;29.07.2015;2015;07;20;Keskiviikko;6;7;13;0;3;3
109;29.07.2015;2015;07;21;Keskiviikko;9;10;19;3;0;3
109;29.07.2015;2015;07;22;Keskiviikko;2;5;7;0;1;1
109;29.07.2015;2015;07;23;Keskiviikko;2;3;5;0;0;0
109;30.07.2015;2015;07;00;Torstai;0;1;1;0;0;0
109;30.07.2015;2015;07;01;Torstai;0;2;2;0;0;0
109;30.07.2015;2015;07;02;Torstai;0;0;0;0;0;0
109;30.07.2015;2015;07;03;Torstai;0;0;0;0;0;0
109;30.07.2015;2015;07;04;Torstai;0;1;1;0;0;0
109;30.07.2015;2015;07;05;Torstai;11;11;22;3;1;4
109;30.07.2015;2015;07;06;Torstai;20;22;42;2;5;7
109;30.07.2015;2015;07;07;Torstai;31;34;65;6;5;11
109;30.07.2015;2015;07;08;Torstai;21;22;43;3;4;7
109;30.07.2015;2015;07;09;Torstai;8;11;19;3;0;3
109;30.07.2015;2015;07;10;Torstai;10;11;21;0;3;3
109;30.07.2015;2015;07;11;Torstai;14;16;30;4;2;6
109;30.07.2015;2015;07;12;Torstai;9;13;22;1;4;5
109;30.07.2015;2015;07;13;Torstai;24;25;49;6;3;9
109;30.07.2015;2015;07;14;Torstai;30;33;63;5;6;11
109;30.07.2015;2015;07;15;Torstai;42;45;87;8;6;14
109;30.07.2015;2015;07;16;Torstai;46;47;93;7;9;16
109;30.07.2015;2015;07;17;Torstai;31;35;66;7;4;11
109;30.07.2015;2015;07;18;Torstai;29;31;60;5;5;10
109;30.07.2015;2015;07;19;Torstai;19;20;39;5;2;7
109;30.07.2015;2015;07;20;Torstai;19;19;38;2;4;6
109;30.07.2015;2015;07;21;Torstai;17;18;35;4;2;6
109;30.07.2015;2015;07;22;Torstai;4;5;9;0;1;1
109;30.07.2015;2015;07;23;Torstai;2;4;6;1;0;1
109;31.07.2015;2015;07;00;Perjantai;1;4;5;0;1;1
109;31.07.2015;2015;07;01;Perjantai;0;1;1;0;0;0
109;31.07.2015;2015;07;02;Perjantai;2;2;4;0;0;0
109;31.07.2015;2015;07;03;Perjantai;0;0;0;0;0;0
109;31.07.2015;2015;07;04;Perjantai;0;2;2;0;0;0
109;31.07.2015;2015;07;05;Perjantai;10;13;23;3;1;4
109;31.07.2015;2015;07;06;Perjantai;20;21;41;2;5;7
109;31.07.2015;2015;07;07;Perjantai;36;40;76;8;5;13
109;31.07.2015;2015;07;08;Perjantai;18;20;38;3;4;7
109;31.07.2015;2015;07;09;Perjantai;11;13;24;4;1;5
109;31.07.2015;2015;07;10;Perjantai;10;14;24;1;3;4
109;31.07.2015;2015;07;11;Perjantai;15;18;33;4;1;5
109;31.07.2015;2015;07;12;Perjantai;15;18;33;2;4;6
109;31.07.2015;2015;07;13;Perjantai;17;18;35;4;1;5
109;31.07.2015;2015;07;14;Perjantai;18;20;38;2;5;7
109;31.07.2015;2015;07;15;Perjantai;27;29;56;5;4;9
109;31.07.2015;2015;07;16;Perjantai;30;32;62;5;6;11
109;31.07.2015;2015;07;17;Perjantai;21;24;45;5;3;8
109;31.07.2015;2015;07;18;Perjantai;22;23;45;3;4;7
109;31.07.2015;2015;07;19;Perjantai;19;22;41;4;3;7
109;31.07.2015;2015;07;20;Perjantai;16;18;34;2;5;7
109;31.07.2015;2015;07;21;Perjantai;10;11;21;3;0;3
109;31.07.2015;2015;07;22;Perjantai;5;7;12;0;2;2
109;31.07.2015;2015;07;23;Perjantai;3;5;8;1;0;1
109;01.08.2015;2015;08;00;Lauantai;3;4;7;0;2;2
109;01.08.2015;2015;08;01;Lauantai;0;1;1;0;0;0
109;01.08.2015;2015;08;02;Lauantai;0;1;1;0;0;0
109;01.08.2015;2015;08;03;Lauantai;0;0;0;0;0;0
109;01.08.2015;2015;08;04;Lauantai;0;0;0;0;0;0
109;01.08.2015;2015;08;05;Lauantai;1;3;4;1;0;1
109;01.08.2015;2015;08;06;Lauantai;2;5;7;0;1;1
109;01.08.2015;2015;08;07;Lauantai;2;4;6;0;0;0
109;01.08.2015;2015;08;08;Lauantai;5;7;12;0;3;3
109;01.08.2015;2015;08;09;Lauantai;2;5;7;1;0;1
109;01.08.2015;2015;08;10;Lauantai;5;6;11;0;2;2
109;01.08.2015;2015;08;11;Lauantai;1;5;6;1;0;1
109;01.08.2015;2015;08;12;Lauantai;4;5;9;0;1;1
109;01.08.2015;2015;08;13;Lauantai;9;10;19;3;0;3
109;01.08.2015;2015;08;14;Lauantai;6;7;13;0;3;3
109;01.08.2015;2015;08;15;Lauantai;4;8;12;3;0;3
109;01.08.2015;2015;08;16;Lauantai;6;7;13;0;2;2
109;01.08.2015;2015;08;17;Lauantai;4;5;9;1;0;1
109;01.08.2015;2015;08;18;Lauantai;6;9;15;0;3;3
109;01.08.2015;2015;08;19;Lauantai;5;8;13;4;0;4
109;01.08.2015;2015;08;20;Lauantai;3;6;9;0;2;2
109;01.08.2015;2015;08;21;Lauantai;7;8;15;3;0;3
109;01.08.2015;2015;08;22;Lauantai;2;5;7;0;1;1
109;01.08.2015;2015;08;23;Lauantai;1;1;2;0;0;0
109;02.08.2015;2015;08;00;Sunnuntai;3;5;8;0;1;1
109;02.08.2015;2015;08;01;Sunnuntai;0;3;3;0;0;0
109;02.08.2015;2015;08;02;Sunnuntai;1;3;4;0;0;0
109;02.08.2015;2015;08;03;Sunnuntai;0;1;1;0;0;0
109;02.08.2015;2015;08;04;Sunnuntai;2;3;5;0;1;1
109;02.08.2015;2015;08;05;Sunnuntai;0;1;1;0;0;0
109;02.08.2015;2015;08;06;Sunnuntai;3;5;8;0;1;1
109;02.08.2015;2015;08;07;Sunnuntai;1;4;5;1;0;1
109;02.08.2015;2015;08;08;Sunnuntai;1;2;3;0;0;0
109;02.08.2015;2015;08;09;Sunnuntai;2;3;5;0;0;0
109;02.08.2015;2015;08;10;Sunnuntai;6;8;14;0;3;3
109;02.08.2015;2015;08;11;Sunnuntai;9;10;19;3;0;3
109;02.08.2015;2015;08;12;Sunnuntai;12;15;27;1;4;5
109;02.08.2015;2015;08;13;Sunnuntai;14;18;32;5;2;7
109;02.08.2015;2015;08;14;Sunnuntai;15;17;32;2;4;6
109;02.08.2015;2015;08;15;Sunnuntai;15;16;31;4;2;6
109;02.08.2015;2015;08;16;Sunnuntai;10;12;22;1;3;4
109;02.08.2015;2015;08;17;Sunnuntai;6;9;15;4;0;4
109;02.08.2015;2015;08;18;Sunnuntai;11;14;25;0;4;4
109;02.08.2015;2015;08;19;Sunnuntai;7;10;17;3;0;3
109;02.08.2015;2015;08;20;Sunnuntai;5;8;13;0;3;3
109;02.08.2015;2015;08;21;Sunnuntai;6;7;13;3;0;3
109;02.08.2015;2015;08;22;Sunnuntai;1;3;4;0;0;0
109;02.08.2015;2015;08;23;Sunnuntai;0;2;2;0;0;0
109;03.08.2015;2015;08;00;Maanantai;0;1;1;0;0;0
109;03.08.2015;2015;08;01;Maanantai;0;0;0;0;0;0
109;03.08.2015;2015;08;02;Maanantai;0;0;0;0;0;0
109;03.08.2015;2015;08;03;Maanantai;0;0;0;0;0;0
109;03.08.2015;2015;08;04;Maanantai;0;2;2;0;0;0
109;03.08.2015;2015;08;05;Maanantai;7;10;17;3;1;4
109;03.08.2015;2015;08;06;Maanantai;19;22;41;3;4;7
109;03.08.2015;2015;08;07;Maanantai;45;46;91;8;7;15
109;03.08.2015;2015;08;08;Maanantai;28;29;57;3;7;10
109;03.08.2015;2015;08;09;Maanantai;7;9;16;3;0;3
109;03.08.2015;2015;08;10;Maanantai;10;11;21;1;3;4
109;03.08.2015;2015;08;11;Maanantai;15;15;30;4;1;5
109;03.08.2015;2015;08;12;Maanantai;18;19;37;2;4;6
109;03.08.2015;2015;08;13;Maanantai;15;19;34;4;2;6
109;03.08.2015;2015;08;14;Maanantai;32;35;67;5;7;12
109;03.08.2015;2015;08;15;Maanantai;54;55;109;11;8;19
109;03.08.2015;2015;08;16;Maanantai;52;54;106;8;10;18
109;03.08.2015;2015;08;17;Maanantai;29;31;60;7;4;11
109;03.08.2015;2015;08;18;Maanantai;24;26;50;3;5;8
109;03.08.2015;2015;08;19;Maanantai;21;24;45;5;3;8
109;03.08.2015;2015;08;20;Maanantai;11;13;24;0;4;4
109;03.08.2015;2015;08;21;Maanantai;17;19;36;5;2;7
109;03.08.2015;2015;08;22;Maanantai;6;9;15;0;2;2
109;03.08.2015;2015;08;23;Maanantai;8;8;16;2;0;2
109;04.08.2015;2015;08;00;Tiistai;1;2;3;0;1;1
109;04.08.2015;2015;08;01;Tiistai;0;0;0;0;0;0
109;04.08.2015;2015;08;02;Tiistai;0;1;1;0;0;0
109;04.08.2015;2015;08;03;Tiistai;1;1;2;0;0;0
109;04.08.2015;2015;08;04;Tiistai;1;1;2;0;0;0
109;04.08.2015;2015;08;05;Tiistai;9;10;19;3;0;3
109;04.08.2015;2015;08;06;Tiistai;15;16;31;1;4;5
109;04.08.2015;2015;08;07;Tiistai;13;14;27;4;1;5
109;04.08.2015;2015;08;08;Tiistai;17;18;35;2;4;6
109;04.08.2015;2015;08;09;Tiistai;26;26;52;5;3;8
109;04.08.2015;2015;08;10;Tiistai;29;32;61;4;7;11
109;04.08.2015;2015;08;11;Tiistai;36;39;75;7;6;13
109;04.08.2015;2015;08;12;Tiistai;70;71;141;11;12;23
109;04.08.2015;2015;08;13;Tiistai;44;47;91;8;8;16
109;04.08.2015;2015;08;14;Tiistai;28;29;57;4;6;10
109;04.08.2015;2015;08;15;Tiistai;25;27;52;5;4;9
109;04.08.2015;2015;08;16;Tiistai;15;18;33;2;4;6
109;04.08.2015;2015;08;17;Tiistai;15;18;33;4;2;6
109;04.08.2015;2015;08;18;Tiistai;16;17;33;2;4;6
109;04.08.2015;2015;08;19;Tiistai;3;6;9;2;0;2
109;04.08.2015;2015;08;20;Tiistai;0;2;2;0;0;0
109;04.08.2015;2015;08;21;Tiistai;0;1;1;0;0;0
109;04.08.2015;2015;08;22;Tiistai;0;2;2;0;0;0
109;04.08.2015;2015;08;23;Tiistai;0;0;0;0;0;0
109;05.08.2015;2015;08;00;Keskiviikko;0;0;0;0;0;0
109;05.08.2015;2015;08;01;Keskiviikko;7;5;12;2;0;2
109;05.08.2015;2015;08;02;Keskiviikko;4;0;4;0;1;1
109;05.08.2015;2015;08;03;Keskiviikko;4;2;6;0;0;0
109;05.08.2015;2015;08;04;Keskiviikko;1;3;4;0;0;0
109;05.08.2015;2015;08;05;Keskiviikko;9;12;21;3;1;4
109;05.08.2015;2015;08;06;Keskiviikko;22;24;46;4;5;9
109;05.08.2015;2015;08;07;Keskiviikko;65;67;132;13;10;23
109;05.08.2015;2015;08;08;Keskiviikko;42;43;85;6;8;14
109;05.08.2015;2015;08;09;Keskiviikko;16;19;35;4;2;6
109;05.08.2015;2015;08;10;Keskiviikko;11;12;23;1;4;5
109;05.08.2015;2015;08;11;Keskiviikko;21;22;43;4;4;8
109;05.08.2015;2015;08;12;Keskiviikko;30;31;61;4;6;10
109;05.08.2015;2015;08;13;Keskiviikko;32;34;66;7;4;11
109;05.08.2015;2015;08;14;Keskiviikko;32;35;67;5;6;11
109;05.08.2015;2015;08;15;Keskiviikko;55;56;111;10;9;19
109;05.08.2015;2015;08;16;Keskiviikko;63;66;129;10;12;22
109;05.08.2015;2015;08;17;Keskiviikko;42;43;85;8;7;15
109;05.08.2015;2015;08;18;Keskiviikko;32;33;65;5;7;12
109;05.08.2015;2015;08;19;Keskiviikko;20;24;44;5;3;8
109;05.08.2015;2015;08;20;Keskiviikko;17;18;35;2;5;7
109;05.08.2015;2015;08;21;Keskiviikko;17;19;36;4;2;6
109;05.08.2015;2015;08;22;Keskiviikko;9;11;20;1;3;4
109;05.08.2015;2015;08;23;Keskiviikko;2;4;6;0;0;0
109;06.08.2015;2015;08;00;Torstai;1;2;3;0;0;0
109;06.08.2015;2015;08;01;Torstai;0;0;0;0;0;0
109;06.08.2015;2015;08;02;Torstai;0;1;1;0;0;0
109;06.08.2015;2015;08;03;Torstai;0;1;1;0;0;0
109;06.08.2015;2015;08;04;Torstai;0;1;1;0;0;0
109;06.08.2015;2015;08;05;Torstai;9;9;18;2;1;3
109;06.08.2015;2015;08;06;Torstai;22;25;47;3;6;9
109;06.08.2015;2015;08;07;Torstai;55;56;111;11;8;19
109;06.08.2015;2015;08;08;Torstai;35;37;72;6;7;13
109;06.08.2015;2015;08;09;Torstai;13;14;27;3;1;4
109;06.08.2015;2015;08;10;Torstai;6;7;13;0;2;2
109;06.08.2015;2015;08;11;Torstai;8;11;19;4;0;4
109;06.08.2015;2015;08;12;Torstai;11;14;25;1;4;5
109;06.08.2015;2015;08;13;Torstai;13;14;27;4;1;5
109;06.08.2015;2015;08;14;Torstai;20;22;42;3;4;7
109;06.08.2015;2015;08;15;Torstai;36;39;75;7;6;13
109;06.08.2015;2015;08;16;Torstai;49;53;102;7;10;17
109;06.08.2015;2015;08;17;Torstai;18;19;37;4;3;7
109;06.08.2015;2015;08;18;Torstai;10;12;22;1;3;4
109;06.08.2015;2015;08;19;Torstai;10;11;21;4;0;4
109;06.08.2015;2015;08;20;Torstai;6;7;13;0;3;3
109;06.08.2015;2015;08;21;Torstai;4;7;11;2;0;2
109;06.08.2015;2015;08;22;Torstai;7;9;16;0;2;2
109;06.08.2015;2015;08;23;Torstai;0;1;1;0;0;0
109;07.08.2015;2015;08;00;Perjantai;0;1;1;0;0;0
109;07.08.2015;2015;08;01;Perjantai;0;0;0;0;0;0
109;07.08.2015;2015;08;02;Perjantai;0;0;0;0;0;0
109;07.08.2015;2015;08;03;Perjantai;0;1;1;0;0;0
109;07.08.2015;2015;08;04;Perjantai;0;0;0;0;0;0
109;07.08.2015;2015;08;05;Perjantai;8;9;17;2;1;3
109;07.08.2015;2015;08;06;Perjantai;21;22;43;3;4;7
109;07.08.2015;2015;08;07;Perjantai;39;39;78;8;6;14
109;07.08.2015;2015;08;08;Perjantai;28;29;57;4;5;9
109;07.08.2015;2015;08;09;Perjantai;11;12;23;4;0;4
109;07.08.2015;2015;08;10;Perjantai;8;10;18;0;4;4
109;07.08.2015;2015;08;11;Perjantai;8;10;18;3;0;3
109;07.08.2015;2015;08;12;Perjantai;7;11;18;0;4;4
109;07.08.2015;2015;08;13;Perjantai;21;22;43;4;3;7
109;07.08.2015;2015;08;14;Perjantai;25;27;52;4;5;9
109;07.08.2015;2015;08;15;Perjantai;31;34;65;7;4;11
109;07.08.2015;2015;08;16;Perjantai;40;41;81;6;8;14
109;07.08.2015;2015;08;17;Perjantai;21;21;42;5;2;7
109;07.08.2015;2015;08;18;Perjantai;15;18;33;2;4;6
109;07.08.2015;2015;08;19;Perjantai;16;18;34;4;2;6
109;07.08.2015;2015;08;20;Perjantai;18;20;38;2;4;6
109;07.08.2015;2015;08;21;Perjantai;11;14;25;4;0;4
109;07.08.2015;2015;08;22;Perjantai;5;7;12;0;2;2
109;07.08.2015;2015;08;23;Perjantai;3;6;9;2;0;2
109;08.08.2015;2015;08;00;Lauantai;3;6;9;0;2;2
109;08.08.2015;2015;08;01;Lauantai;1;2;3;0;0;0
109;08.08.2015;2015;08;02;Lauantai;0;1;1;0;0;0
109;08.08.2015;2015;08;03;Lauantai;1;1;2;0;0;0
109;08.08.2015;2015;08;04;Lauantai;2;3;5;0;0;0
109;08.08.2015;2015;08;05;Lauantai;1;3;4;0;0;0
109;08.08.2015;2015;08;06;Lauantai;1;3;4;0;1;1
109;08.08.2015;2015;08;07;Lauantai;2;4;6;0;0;0
109;08.08.2015;2015;08;08;Lauantai;3;5;8;0;1;1
109;08.08.2015;2015;08;09;Lauantai;5;9;14;3;0;3
109;08.08.2015;2015;08;10;Lauantai;4;7;11;0;2;2
109;08.08.2015;2015;08;11;Lauantai;13;15;28;4;0;4
109;08.08.2015;2015;08;12;Lauantai;9;13;22;2;3;5
109;08.08.2015;2015;08;13;Lauantai;7;9;16;2;1;3
109;08.08.2015;2015;08;14;Lauantai;8;12;20;0;4;4
109;08.08.2015;2015;08;15;Lauantai;12;14;26;4;0;4
109;08.08.2015;2015;08;16;Lauantai;9;12;21;0;4;4
109;08.08.2015;2015;08;17;Lauantai;6;10;16;4;0;4
109;08.08.2015;2015;08;18;Lauantai;7;11;18;0;4;4
109;08.08.2015;2015;08;19;Lauantai;13;16;29;4;1;5
109;08.08.2015;2015;08;20;Lauantai;12;15;27;0;4;4
109;08.08.2015;2015;08;21;Lauantai;12;13;25;3;1;4
109;08.08.2015;2015;08;22;Lauantai;2;3;5;0;1;1
109;08.08.2015;2015;08;23;Lauantai;2;5;7;2;0;2
109;09.08.2015;2015;08;00;Sunnuntai;1;2;3;0;0;0
109;09.08.2015;2015;08;01;Sunnuntai;4;6;10;2;0;2
109;09.08.2015;2015;08;02;Sunnuntai;0;1;1;0;0;0
109;09.08.2015;2015;08;03;Sunnuntai;1;2;3;0;0;0
109;09.08.2015;2015;08;04;Sunnuntai;2;3;5;0;1;1
109;09.08.2015;2015;08;05;Sunnuntai;1;2;3;0;0;0
109;09.08.2015;2015;08;06;Sunnuntai;1;1;2;0;0;0
109;09.08.2015;2015;08;07;Sunnuntai;3;3;6;1;0;1
109;09.08.2015;2015;08;08;Sunnuntai;3;3;6;0;1;1
109;09.08.2015;2015;08;09;Sunnuntai;5;6;11;2;0;2
109;09.08.2015;2015;08;10;Sunnuntai;8;10;18;1;3;4
109;09.08.2015;2015;08;11;Sunnuntai;13;14;27;4;1;5
109;09.08.2015;2015;08;12;Sunnuntai;17;20;37;2;4;6
109;09.08.2015;2015;08;13;Sunnuntai;15;16;31;4;1;5
109;09.08.2015;2015;08;14;Sunnuntai;17;17;34;1;4;5
109;09.08.2015;2015;08;15;Sunnuntai;16;18;34;4;2;6
109;09.08.2015;2015;08;16;Sunnuntai;19;22;41;3;4;7
109;09.08.2015;2015;08;17;Sunnuntai;17;19;36;4;2;6
109;09.08.2015;2015;08;18;Sunnuntai;23;24;47;2;5;7
109;09.08.2015;2015;08;19;Sunnuntai;17;18;35;4;1;5
109;09.08.2015;2015;08;20;Sunnuntai;7;11;18;0;4;4
109;09.08.2015;2015;08;21;Sunnuntai;8;9;17;2;1;3
109;09.08.2015;2015;08;22;Sunnuntai;4;5;9;0;1;1
109;09.08.2015;2015;08;23;Sunnuntai;0;3;3;0;0;0
109;10.08.2015;2015;08;00;Maanantai;3;1;4;0;0;0
109;10.08.2015;2015;08;01;Maanantai;0;0;0;0;0;0
109;10.08.2015;2015;08;02;Maanantai;1;0;1;0;0;0
109;10.08.2015;2015;08;03;Maanantai;0;0;0;0;0;0
109;10.08.2015;2015;08;04;Maanantai;1;1;2;0;0;0
109;10.08.2015;2015;08;05;Maanantai;9;7;16;2;0;2
109;10.08.2015;2015;08;06;Maanantai;24;24;48;1;4;5
109;10.08.2015;2015;08;07;Maanantai;69;68;137;5;4;9
109;10.08.2015;2015;08;08;Maanantai;40;40;80;2;1;3
109;10.08.2015;2015;08;09;Maanantai;24;22;46;1;1;2
109;10.08.2015;2015;08;10;Maanantai;16;13;29;4;7;11
109;10.08.2015;2015;08;11;Maanantai;23;21;44;3;2;5
109;10.08.2015;2015;08;12;Maanantai;22;20;42;2;2;4
109;10.08.2015;2015;08;13;Maanantai;34;31;65;2;1;3
109;10.08.2015;2015;08;14;Maanantai;34;31;65;3;3;6
109;10.08.2015;2015;08;15;Maanantai;67;63;130;3;5;8
109;10.08.2015;2015;08;16;Maanantai;80;77;157;7;7;14
109;10.08.2015;2015;08;17;Maanantai;50;48;98;6;6;12
109;10.08.2015;2015;08;18;Maanantai;23;22;45;8;4;12
109;10.08.2015;2015;08;19;Maanantai;32;28;60;6;3;9
109;10.08.2015;2015;08;20;Maanantai;18;14;32;9;5;14
109;10.08.2015;2015;08;21;Maanantai;14;12;26;2;1;3
109;10.08.2015;2015;08;22;Maanantai;14;12;26;3;0;3
109;10.08.2015;2015;08;23;Maanantai;4;1;5;0;0;0
109;11.08.2015;2015;08;00;Tiistai;2;1;3;0;0;0
109;11.08.2015;2015;08;01;Tiistai;0;0;0;0;0;0
109;11.08.2015;2015;08;02;Tiistai;1;0;1;0;0;0
109;11.08.2015;2015;08;03;Tiistai;1;1;2;0;0;0
109;11.08.2015;2015;08;04;Tiistai;2;1;3;0;0;0
109;11.08.2015;2015;08;05;Tiistai;9;7;16;1;1;2
109;11.08.2015;2015;08;06;Tiistai;33;33;66;2;2;4
109;11.08.2015;2015;08;07;Tiistai;86;84;170;3;3;6
109;11.08.2015;2015;08;08;Tiistai;60;53;113;4;5;9
109;11.08.2015;2015;08;09;Tiistai;29;26;55;5;4;9
109;11.08.2015;2015;08;10;Tiistai;12;10;22;2;1;3
109;11.08.2015;2015;08;11;Tiistai;27;9;36;6;1;7
109;11.08.2015;2015;08;12;Tiistai;40;26;66;4;1;5
109;11.08.2015;2015;08;13;Tiistai;26;35;61;4;3;7
109;11.08.2015;2015;08;14;Tiistai;34;42;76;0;0;0
109;11.08.2015;2015;08;15;Tiistai;45;84;129;5;6;11
109;11.08.2015;2015;08;16;Tiistai;68;91;159;3;5;8
109;11.08.2015;2015;08;17;Tiistai;29;48;77;3;4;7
109;11.08.2015;2015;08;18;Tiistai;20;29;49;7;4;11
109;11.08.2015;2015;08;19;Tiistai;16;12;28;3;7;10
109;11.08.2015;2015;08;20;Tiistai;11;14;25;6;2;8
109;11.08.2015;2015;08;21;Tiistai;6;18;24;7;4;11
109;11.08.2015;2015;08;22;Tiistai;11;6;17;1;1;2
109;11.08.2015;2015;08;23;Tiistai;8;2;10;0;1;1
109;12.08.2015;2015;08;00;Keskiviikko;2;1;3;0;0;0
109;12.08.2015;2015;08;01;Keskiviikko;0;3;3;0;0;0
109;12.08.2015;2015;08;02;Keskiviikko;1;0;1;0;0;0
109;12.08.2015;2015;08;03;Keskiviikko;1;1;2;0;0;0
109;12.08.2015;2015;08;04;Keskiviikko;0;2;2;0;0;0
109;12.08.2015;2015;08;05;Keskiviikko;2;9;11;2;0;2
109;12.08.2015;2015;08;06;Keskiviikko;39;15;54;1;4;5
109;12.08.2015;2015;08;07;Keskiviikko;97;37;134;5;4;9
109;12.08.2015;2015;08;08;Keskiviikko;67;34;101;2;1;3
109;12.08.2015;2015;08;09;Keskiviikko;43;12;55;1;1;2
109;12.08.2015;2015;08;10;Keskiviikko;10;12;22;4;7;11
109;12.08.2015;2015;08;11;Keskiviikko;23;10;33;3;2;5
109;12.08.2015;2015;08;12;Keskiviikko;24;21;45;2;2;4
109;12.08.2015;2015;08;13;Keskiviikko;12;32;44;2;1;3
109;12.08.2015;2015;08;14;Keskiviikko;21;31;52;3;3;6
109;12.08.2015;2015;08;15;Keskiviikko;39;59;98;3;5;8
109;12.08.2015;2015;08;16;Keskiviikko;48;97;145;7;7;14
109;12.08.2015;2015;08;17;Keskiviikko;50;40;90;6;6;12
109;12.08.2015;2015;08;18;Keskiviikko;29;26;55;8;4;12
109;12.08.2015;2015;08;19;Keskiviikko;31;18;49;6;3;9
109;12.08.2015;2015;08;20;Keskiviikko;17;19;36;9;5;14
109;12.08.2015;2015;08;21;Keskiviikko;10;18;28;2;1;3
109;12.08.2015;2015;08;22;Keskiviikko;8;8;16;3;0;3
109;12.08.2015;2015;08;23;Keskiviikko;2;1;3;0;0;0
109;13.08.2015;2015;08;00;Torstai;1;0;1;2;0;2
109;13.08.2015;2015;08;01;Torstai;1;1;2;0;0;0
109;13.08.2015;2015;08;02;Torstai;2;1;3;0;0;0
109;13.08.2015;2015;08;03;Torstai;1;0;1;0;1;1
109;13.08.2015;2015;08;04;Torstai;1;0;1;0;0;0
109;13.08.2015;2015;08;05;Torstai;4;13;17;0;0;0
109;13.08.2015;2015;08;06;Torstai;47;15;62;1;1;2
109;13.08.2015;2015;08;07;Torstai;128;39;167;5;4;9
109;13.08.2015;2015;08;08;Torstai;88;38;126;2;2;4
109;13.08.2015;2015;08;09;Torstai;21;13;34;4;2;6
109;13.08.2015;2015;08;10;Torstai;16;9;25;3;4;7
109;13.08.2015;2015;08;11;Torstai;11;16;27;0;3;3
109;13.08.2015;2015;08;12;Torstai;28;20;48;3;3;6
109;13.08.2015;2015;08;13;Torstai;16;29;45;1;3;4
109;13.08.2015;2015;08;14;Torstai;33;36;69;0;2;2
109;13.08.2015;2015;08;15;Torstai;46;73;119;7;6;13
109;13.08.2015;2015;08;16;Torstai;67;112;179;7;7;14
109;13.08.2015;2015;08;17;Torstai;34;44;78;4;0;4
109;13.08.2015;2015;08;18;Torstai;16;23;39;2;3;5
109;13.08.2015;2015;08;19;Torstai;14;16;30;7;5;12
109;13.08.2015;2015;08;20;Torstai;11;19;30;9;7;16
109;13.08.2015;2015;08;21;Torstai;4;5;9;2;3;5
109;13.08.2015;2015;08;22;Torstai;9;4;13;4;2;6
109;13.08.2015;2015;08;23;Torstai;2;3;5;1;1;2
109;14.08.2015;2015;08;00;Perjantai;0;1;1;0;1;1
109;14.08.2015;2015;08;01;Perjantai;1;2;3;0;0;0
109;14.08.2015;2015;08;02;Perjantai;1;0;1;0;0;0
109;14.08.2015;2015;08;03;Perjantai;0;0;0;0;1;1
109;14.08.2015;2015;08;04;Perjantai;1;1;2;0;0;0
109;14.08.2015;2015;08;05;Perjantai;2;11;13;1;0;1
109;14.08.2015;2015;08;06;Perjantai;32;14;46;1;1;2
109;14.08.2015;2015;08;07;Perjantai;86;44;130;8;3;11
109;14.08.2015;2015;08;08;Perjantai;82;28;110;2;3;5
109;14.08.2015;2015;08;09;Perjantai;26;11;37;1;1;2
109;14.08.2015;2015;08;10;Perjantai;13;7;20;1;1;2
109;14.08.2015;2015;08;11;Perjantai;11;12;23;1;1;2
109;14.08.2015;2015;08;12;Perjantai;17;15;32;3;1;4
109;14.08.2015;2015;08;13;Perjantai;21;31;52;3;1;4
109;14.08.2015;2015;08;14;Perjantai;28;51;79;4;3;7
109;14.08.2015;2015;08;15;Perjantai;43;63;106;5;5;10
109;14.08.2015;2015;08;16;Perjantai;39;59;98;9;6;15
109;14.08.2015;2015;08;17;Perjantai;34;30;64;11;5;16
109;14.08.2015;2015;08;18;Perjantai;33;19;52;4;2;6
109;14.08.2015;2015;08;19;Perjantai;18;14;32;10;1;11
109;14.08.2015;2015;08;20;Perjantai;10;9;19;3;6;9
109;14.08.2015;2015;08;21;Perjantai;17;11;28;3;2;5
109;14.08.2015;2015;08;22;Perjantai;12;7;19;1;1;2
109;14.08.2015;2015;08;23;Perjantai;2;4;6;3;0;3
109;15.08.2015;2015;08;00;Lauantai;4;4;8;1;3;4
109;15.08.2015;2015;08;01;Lauantai;1;3;4;0;0;0
109;15.08.2015;2015;08;02;Lauantai;0;5;5;0;1;1
109;15.08.2015;2015;08;03;Lauantai;0;5;5;0;0;0
109;15.08.2015;2015;08;04;Lauantai;0;1;1;0;1;1
109;15.08.2015;2015;08;05;Lauantai;1;4;5;0;0;0
109;15.08.2015;2015;08;06;Lauantai;4;0;4;0;1;1
109;15.08.2015;2015;08;07;Lauantai;2;3;5;4;2;6
109;15.08.2015;2015;08;08;Lauantai;5;5;10;2;4;6
109;15.08.2015;2015;08;09;Lauantai;10;10;20;2;2;4
109;15.08.2015;2015;08;10;Lauantai;12;11;23;4;4;8
109;15.08.2015;2015;08;11;Lauantai;15;11;26;2;2;4
109;15.08.2015;2015;08;12;Lauantai;22;23;45;7;1;8
109;15.08.2015;2015;08;13;Lauantai;19;11;30;4;1;5
109;15.08.2015;2015;08;14;Lauantai;22;17;39;4;3;7
109;15.08.2015;2015;08;15;Lauantai;28;25;53;6;0;6
109;15.08.2015;2015;08;16;Lauantai;15;21;36;5;1;6
109;15.08.2015;2015;08;17;Lauantai;20;15;35;4;2;6
109;15.08.2015;2015;08;18;Lauantai;26;16;42;2;2;4
109;15.08.2015;2015;08;19;Lauantai;19;11;30;9;1;10
109;15.08.2015;2015;08;20;Lauantai;16;14;30;1;1;2
109;15.08.2015;2015;08;21;Lauantai;3;11;14;3;2;5
109;15.08.2015;2015;08;22;Lauantai;4;7;11;3;2;5
109;15.08.2015;2015;08;23;Lauantai;0;3;3;0;2;2
109;16.08.2015;2015;08;00;Sunnuntai;7;2;9;1;1;2
109;16.08.2015;2015;08;01;Sunnuntai;0;2;2;0;0;0
109;16.08.2015;2015;08;02;Sunnuntai;2;2;4;0;0;0
109;16.08.2015;2015;08;03;Sunnuntai;1;0;1;0;0;0
109;16.08.2015;2015;08;04;Sunnuntai;2;3;5;0;0;0
109;16.08.2015;2015;08;05;Sunnuntai;0;1;1;0;2;2
109;16.08.2015;2015;08;06;Sunnuntai;5;1;6;0;0;0
109;16.08.2015;2015;08;07;Sunnuntai;2;3;5;2;1;3
109;16.08.2015;2015;08;08;Sunnuntai;2;2;4;1;4;5
109;16.08.2015;2015;08;09;Sunnuntai;7;6;13;4;5;9
109;16.08.2015;2015;08;10;Sunnuntai;13;3;16;8;3;11
109;16.08.2015;2015;08;11;Sunnuntai;20;12;32;6;4;10
109;16.08.2015;2015;08;12;Sunnuntai;34;12;46;5;3;8
109;16.08.2015;2015;08;13;Sunnuntai;27;12;39;2;2;4
109;16.08.2015;2015;08;14;Sunnuntai;20;14;34;5;3;8
109;16.08.2015;2015;08;15;Sunnuntai;29;14;43;9;1;10
109;16.08.2015;2015;08;16;Sunnuntai;24;16;40;3;5;8
109;16.08.2015;2015;08;17;Sunnuntai;32;11;43;7;3;10
109;16.08.2015;2015;08;18;Sunnuntai;12;21;33;3;4;7
109;16.08.2015;2015;08;19;Sunnuntai;28;18;46;11;4;15
109;16.08.2015;2015;08;20;Sunnuntai;8;18;26;5;5;10
109;16.08.2015;2015;08;21;Sunnuntai;7;14;21;2;3;5
109;16.08.2015;2015;08;22;Sunnuntai;2;4;6;2;0;2
109;16.08.2015;2015;08;23;Sunnuntai;0;1;1;0;2;2
109;17.08.2015;2015;08;00;Maanantai;0;0;0;0;0;0
109;17.08.2015;2015;08;01;Maanantai;0;1;1;0;0;0
109;17.08.2015;2015;08;02;Maanantai;0;0;0;0;0;0
109;17.08.2015;2015;08;03;Maanantai;0;0;0;0;0;0
109;17.08.2015;2015;08;04;Maanantai;0;4;4;0;0;0
109;17.08.2015;2015;08;05;Maanantai;5;17;22;0;0;0
109;17.08.2015;2015;08;06;Maanantai;43;9;52;3;3;6
109;17.08.2015;2015;08;07;Maanantai;122;60;182;1;3;4
109;17.08.2015;2015;08;08;Maanantai;107;29;136;5;3;8
109;17.08.2015;2015;08;09;Maanantai;30;15;45;4;4;8
109;17.08.2015;2015;08;10;Maanantai;19;9;28;3;0;3
109;17.08.2015;2015;08;11;Maanantai;28;15;43;5;2;7
109;17.08.2015;2015;08;12;Maanantai;22;23;45;0;2;2
109;17.08.2015;2015;08;13;Maanantai;29;25;54;5;2;7
109;17.08.2015;2015;08;14;Maanantai;26;28;54;2;2;4
109;17.08.2015;2015;08;15;Maanantai;50;99;149;3;4;7
109;17.08.2015;2015;08;16;Maanantai;72;116;188;10;4;14
109;17.08.2015;2015;08;17;Maanantai;39;51;90;3;5;8
109;17.08.2015;2015;08;18;Maanantai;20;30;50;4;1;5
109;17.08.2015;2015;08;19;Maanantai;22;29;51;8;4;12
109;17.08.2015;2015;08;20;Maanantai;14;22;36;7;3;10
109;17.08.2015;2015;08;21;Maanantai;2;13;15;1;6;7
109;17.08.2015;2015;08;22;Maanantai;13;5;18;2;1;3
109;17.08.2015;2015;08;23;Maanantai;6;2;8;0;0;0
109;18.08.2015;2015;08;00;Tiistai;1;0;1;0;0;0
109;18.08.2015;2015;08;01;Tiistai;0;0;0;0;1;1
109;18.08.2015;2015;08;02;Tiistai;0;1;1;1;0;1
109;18.08.2015;2015;08;03;Tiistai;0;0;0;0;0;0
109;18.08.2015;2015;08;04;Tiistai;2;0;2;0;0;0
109;18.08.2015;2015;08;05;Tiistai;7;17;24;0;0;0
109;18.08.2015;2015;08;06;Tiistai;37;16;53;0;3;3
109;18.08.2015;2015;08;07;Tiistai;131;58;189;3;3;6
109;18.08.2015;2015;08;08;Tiistai;87;27;114;4;0;4
109;18.08.2015;2015;08;09;Tiistai;35;10;45;5;0;5
109;18.08.2015;2015;08;10;Tiistai;10;17;27;3;3;6
109;18.08.2015;2015;08;11;Tiistai;21;18;39;5;2;7
109;18.08.2015;2015;08;12;Tiistai;14;15;29;3;3;6
109;18.08.2015;2015;08;13;Tiistai;21;23;44;4;5;9
109;18.08.2015;2015;08;14;Tiistai;35;48;83;2;0;2
109;18.08.2015;2015;08;15;Tiistai;47;87;134;8;4;12
109;18.08.2015;2015;08;16;Tiistai;69;114;183;3;5;8
109;18.08.2015;2015;08;17;Tiistai;51;51;102;10;3;13
109;18.08.2015;2015;08;18;Tiistai;31;23;54;7;4;11
109;18.08.2015;2015;08;19;Tiistai;24;29;53;6;4;10
109;18.08.2015;2015;08;20;Tiistai;21;21;42;8;4;12
109;18.08.2015;2015;08;21;Tiistai;12;18;30;3;3;6
109;18.08.2015;2015;08;22;Tiistai;9;9;18;0;0;0
109;18.08.2015;2015;08;23;Tiistai;5;2;7;0;0;0
109;19.08.2015;2015;08;00;Keskiviikko;0;1;1;0;1;1
109;19.08.2015;2015;08;01;Keskiviikko;0;1;1;0;0;0
109;19.08.2015;2015;08;02;Keskiviikko;0;0;0;0;1;1
109;19.08.2015;2015;08;03;Keskiviikko;1;0;1;0;0;0
109;19.08.2015;2015;08;04;Keskiviikko;1;1;2;0;0;0
109;19.08.2015;2015;08;05;Keskiviikko;1;16;17;1;1;2
109;19.08.2015;2015;08;06;Keskiviikko;39;18;57;2;1;3
109;19.08.2015;2015;08;07;Keskiviikko;119;52;171;2;2;4
109;19.08.2015;2015;08;08;Keskiviikko;74;25;99;4;1;5
109;19.08.2015;2015;08;09;Keskiviikko;38;11;49;2;2;4
109;19.08.2015;2015;08;10;Keskiviikko;25;4;29;5;2;7
109;19.08.2015;2015;08;11;Keskiviikko;24;18;42;7;4;11
109;19.08.2015;2015;08;12;Keskiviikko;21;17;38;5;3;8
109;19.08.2015;2015;08;13;Keskiviikko;27;25;52;3;4;7
109;19.08.2015;2015;08;14;Keskiviikko;26;45;71;2;4;6
109;19.08.2015;2015;08;15;Keskiviikko;47;74;121;7;2;9
109;19.08.2015;2015;08;16;Keskiviikko;65;105;170;11;7;18
109;19.08.2015;2015;08;17;Keskiviikko;38;56;94;5;5;10
109;19.08.2015;2015;08;18;Keskiviikko;36;30;66;1;5;6
109;19.08.2015;2015;08;19;Keskiviikko;25;26;51;7;2;9
109;19.08.2015;2015;08;20;Keskiviikko;15;28;43;5;6;11
109;19.08.2015;2015;08;21;Keskiviikko;13;23;36;3;1;4
109;19.08.2015;2015;08;22;Keskiviikko;7;5;12;2;0;2
109;19.08.2015;2015;08;23;Keskiviikko;1;0;1;1;0;1
109;20.08.2015;2015;08;00;Torstai;0;1;1;0;0;0
109;20.08.2015;2015;08;01;Torstai;0;5;5;0;1;1
109;20.08.2015;2015;08;02;Torstai;0;1;1;0;0;0
109;20.08.2015;2015;08;03;Torstai;0;1;1;0;0;0
109;20.08.2015;2015;08;04;Torstai;2;0;2;1;0;1
109;20.08.2015;2015;08;05;Torstai;4;14;18;1;0;1
109;20.08.2015;2015;08;06;Torstai;40;11;51;4;1;5
109;20.08.2015;2015;08;07;Torstai;102;60;162;6;2;8
109;20.08.2015;2015;08;08;Torstai;86;34;120;1;2;3
109;20.08.2015;2015;08;09;Torstai;34;14;48;6;7;13
109;20.08.2015;2015;08;10;Torstai;18;9;27;0;2;2
109;20.08.2015;2015;08;11;Torstai;20;11;31;3;3;6
109;20.08.2015;2015;08;12;Torstai;17;22;39;3;4;7
109;20.08.2015;2015;08;13;Torstai;13;18;31;1;4;5
109;20.08.2015;2015;08;14;Torstai;34;51;85;5;2;7
109;20.08.2015;2015;08;15;Torstai;37;93;130;8;5;13
109;20.08.2015;2015;08;16;Torstai;80;106;186;6;8;14
109;20.08.2015;2015;08;17;Torstai;46;46;92;7;4;11
109;20.08.2015;2015;08;18;Torstai;35;31;66;9;8;17
109;20.08.2015;2015;08;19;Torstai;17;30;47;5;2;7
109;20.08.2015;2015;08;20;Torstai;13;19;32;13;3;16
109;20.08.2015;2015;08;21;Torstai;10;19;29;5;4;9
109;20.08.2015;2015;08;22;Torstai;9;7;16;1;1;2
109;20.08.2015;2015;08;23;Torstai;4;3;7;2;0;2
109;21.08.2015;2015;08;00;Perjantai;0;7;7;1;2;3
109;21.08.2015;2015;08;01;Perjantai;0;1;1;0;0;0
109;21.08.2015;2015;08;02;Perjantai;0;2;2;0;0;0
109;21.08.2015;2015;08;03;Perjantai;0;0;0;0;0;0
109;21.08.2015;2015;08;04;Perjantai;1;2;3;0;0;0
109;21.08.2015;2015;08;05;Perjantai;5;12;17;0;1;1
109;21.08.2015;2015;08;06;Perjantai;39;12;51;3;2;5
109;21.08.2015;2015;08;07;Perjantai;77;46;123;2;5;7
109;21.08.2015;2015;08;08;Perjantai;69;25;94;4;2;6
109;21.08.2015;2015;08;09;Perjantai;32;12;44;4;4;8
109;21.08.2015;2015;08;10;Perjantai;8;9;17;1;2;3
109;21.08.2015;2015;08;11;Perjantai;9;15;24;3;4;7
109;21.08.2015;2015;08;12;Perjantai;21;17;38;1;1;2
109;21.08.2015;2015;08;13;Perjantai;19;26;45;4;2;6
109;21.08.2015;2015;08;14;Perjantai;35;69;104;9;4;13
109;21.08.2015;2015;08;15;Perjantai;36;66;102;2;2;4
109;21.08.2015;2015;08;16;Perjantai;47;64;111;3;2;5
109;21.08.2015;2015;08;17;Perjantai;37;25;62;3;1;4
109;21.08.2015;2015;08;18;Perjantai;20;13;33;4;3;7
109;21.08.2015;2015;08;19;Perjantai;20;11;31;4;4;8
109;21.08.2015;2015;08;20;Perjantai;18;12;30;5;1;6
109;21.08.2015;2015;08;21;Perjantai;12;9;21;4;6;10
109;21.08.2015;2015;08;22;Perjantai;12;5;17;2;0;2
109;21.08.2015;2015;08;23;Perjantai;4;4;8;2;2;4
109;22.08.2015;2015;08;00;Lauantai;2;7;9;2;1;3
109;22.08.2015;2015;08;01;Lauantai;0;7;7;1;1;2
109;22.08.2015;2015;08;02;Lauantai;0;5;5;0;1;1
109;22.08.2015;2015;08;03;Lauantai;0;10;10;0;0;0
109;22.08.2015;2015;08;04;Lauantai;1;1;2;0;0;0
109;22.08.2015;2015;08;05;Lauantai;2;2;4;0;0;0
109;22.08.2015;2015;08;06;Lauantai;2;1;3;1;1;2
109;22.08.2015;2015;08;07;Lauantai;1;3;4;3;1;4
109;22.08.2015;2015;08;08;Lauantai;8;0;8;1;1;2
109;22.08.2015;2015;08;09;Lauantai;11;2;13;0;2;2
109;22.08.2015;2015;08;10;Lauantai;4;12;16;6;3;9
109;22.08.2015;2015;08;11;Lauantai;18;9;27;5;2;7
109;22.08.2015;2015;08;12;Lauantai;20;15;35;16;9;25
109;22.08.2015;2015;08;13;Lauantai;25;23;48;6;6;12
109;22.08.2015;2015;08;14;Lauantai;41;18;59;5;2;7
109;22.08.2015;2015;08;15;Lauantai;15;25;40;1;3;4
109;22.08.2015;2015;08;16;Lauantai;14;17;31;4;6;10
109;22.08.2015;2015;08;17;Lauantai;20;16;36;3;4;7
109;22.08.2015;2015;08;18;Lauantai;24;12;36;7;4;11
109;22.08.2015;2015;08;19;Lauantai;11;13;24;4;2;6
109;22.08.2015;2015;08;20;Lauantai;22;18;40;8;2;10
109;22.08.2015;2015;08;21;Lauantai;13;10;23;2;1;3
109;22.08.2015;2015;08;22;Lauantai;1;11;12;2;0;2
109;22.08.2015;2015;08;23;Lauantai;2;2;4;1;0;1
109;23.08.2015;2015;08;00;Sunnuntai;1;1;2;0;0;0
109;23.08.2015;2015;08;01;Sunnuntai;1;1;2;0;0;0
109;23.08.2015;2015;08;02;Sunnuntai;1;2;3;0;0;0
109;23.08.2015;2015;08;03;Sunnuntai;2;7;9;0;1;1
109;23.08.2015;2015;08;04;Sunnuntai;0;2;2;0;0;0
109;23.08.2015;2015;08;05;Sunnuntai;1;0;1;0;1;1
109;23.08.2015;2015;08;06;Sunnuntai;4;1;5;0;0;0
109;23.08.2015;2015;08;07;Sunnuntai;1;3;4;5;1;6
109;23.08.2015;2015;08;08;Sunnuntai;4;1;5;2;2;4
109;23.08.2015;2015;08;09;Sunnuntai;8;5;13;5;8;13
109;23.08.2015;2015;08;10;Sunnuntai;12;4;16;4;2;6
109;23.08.2015;2015;08;11;Sunnuntai;27;11;38;5;5;10
109;23.08.2015;2015;08;12;Sunnuntai;28;12;40;1;1;2
109;23.08.2015;2015;08;13;Sunnuntai;21;7;28;4;1;5
109;23.08.2015;2015;08;14;Sunnuntai;20;18;38;2;2;4
109;23.08.2015;2015;08;15;Sunnuntai;33;20;53;6;4;10
109;23.08.2015;2015;08;16;Sunnuntai;15;14;29;3;2;5
109;23.08.2015;2015;08;17;Sunnuntai;34;11;45;0;2;2
109;23.08.2015;2015;08;18;Sunnuntai;14;15;29;10;4;14
109;23.08.2015;2015;08;19;Sunnuntai;15;22;37;7;7;14
109;23.08.2015;2015;08;20;Sunnuntai;16;17;33;4;8;12
109;23.08.2015;2015;08;21;Sunnuntai;8;12;20;5;3;8
109;23.08.2015;2015;08;22;Sunnuntai;3;5;8;4;0;4
109;23.08.2015;2015;08;23;Sunnuntai;1;0;1;1;2;3
109;24.08.2015;2015;08;00;Maanantai;0;0;0;0;0;0
109;24.08.2015;2015;08;01;Maanantai;0;0;0;0;0;0
109;24.08.2015;2015;08;02;Maanantai;0;0;0;0;0;0
109;24.08.2015;2015;08;03;Maanantai;0;0;0;0;0;0
109;24.08.2015;2015;08;04;Maanantai;0;1;1;0;1;1
109;24.08.2015;2015;08;05;Maanantai;3;7;10;1;0;1
109;24.08.2015;2015;08;06;Maanantai;41;15;56;4;3;7
109;24.08.2015;2015;08;07;Maanantai;130;52;182;4;3;7
109;24.08.2015;2015;08;08;Maanantai;94;31;125;2;1;3
109;24.08.2015;2015;08;09;Maanantai;30;9;39;4;4;8
109;24.08.2015;2015;08;10;Maanantai;15;7;22;1;2;3
109;24.08.2015;2015;08;11;Maanantai;15;16;31;4;0;4
109;24.08.2015;2015;08;12;Maanantai;30;18;48;4;2;6
109;24.08.2015;2015;08;13;Maanantai;17;21;38;1;4;5
109;24.08.2015;2015;08;14;Maanantai;19;40;59;6;1;7
109;24.08.2015;2015;08;15;Maanantai;35;82;117;5;4;9
109;24.08.2015;2015;08;16;Maanantai;61;114;175;4;8;12
109;24.08.2015;2015;08;17;Maanantai;44;53;97;5;4;9
109;24.08.2015;2015;08;18;Maanantai;27;28;55;5;6;11
109;24.08.2015;2015;08;19;Maanantai;31;28;59;6;5;11
109;24.08.2015;2015;08;20;Maanantai;21;16;37;9;8;17
109;24.08.2015;2015;08;21;Maanantai;6;13;19;6;2;8
109;24.08.2015;2015;08;22;Maanantai;10;10;20;1;0;1
109;24.08.2015;2015;08;23;Maanantai;2;0;2;0;0;0
109;25.08.2015;2015;08;00;Tiistai;1;0;1;1;2;3
109;25.08.2015;2015;08;01;Tiistai;0;0;0;0;1;1
109;25.08.2015;2015;08;02;Tiistai;0;0;0;0;0;0
109;25.08.2015;2015;08;03;Tiistai;2;0;2;0;0;0
109;25.08.2015;2015;08;04;Tiistai;1;0;1;0;0;0
109;25.08.2015;2015;08;05;Tiistai;2;8;10;0;0;0
109;25.08.2015;2015;08;06;Tiistai;50;15;65;3;2;5
109;25.08.2015;2015;08;07;Tiistai;129;55;184;3;4;7
109;25.08.2015;2015;08;08;Tiistai;96;30;126;5;2;7
109;25.08.2015;2015;08;09;Tiistai;30;16;46;6;3;9
109;25.08.2015;2015;08;10;Tiistai;24;16;40;4;3;7
109;25.08.2015;2015;08;11;Tiistai;23;15;38;5;1;6
109;25.08.2015;2015;08;12;Tiistai;22;21;43;3;1;4
109;25.08.2015;2015;08;13;Tiistai;16;25;41;0;3;3
109;25.08.2015;2015;08;14;Tiistai;32;33;65;3;2;5
109;25.08.2015;2015;08;15;Tiistai;40;106;146;7;8;15
109;25.08.2015;2015;08;16;Tiistai;53;133;186;6;2;8
109;25.08.2015;2015;08;17;Tiistai;57;47;104;7;5;12
109;25.08.2015;2015;08;18;Tiistai;20;31;51;7;7;14
109;25.08.2015;2015;08;19;Tiistai;27;41;68;6;7;13
109;25.08.2015;2015;08;20;Tiistai;17;22;39;6;10;16
109;25.08.2015;2015;08;21;Tiistai;10;21;31;2;1;3
109;25.08.2015;2015;08;22;Tiistai;3;4;7;2;0;2
109;25.08.2015;2015;08;23;Tiistai;1;0;1;0;1;1
109;26.08.2015;2015;08;00;Keskiviikko;1;2;3;0;0;0
109;26.08.2015;2015;08;01;Keskiviikko;0;0;0;0;0;0
109;26.08.2015;2015;08;02;Keskiviikko;1;0;1;1;0;1
109;26.08.2015;2015;08;03;Keskiviikko;1;0;1;0;0;0
109;26.08.2015;2015;08;04;Keskiviikko;0;2;2;0;0;0
109;26.08.2015;2015;08;05;Keskiviikko;4;8;12;0;1;1
109;26.08.2015;2015;08;06;Keskiviikko;44;15;59;5;2;7
109;26.08.2015;2015;08;07;Keskiviikko;123;51;174;4;2;6
109;26.08.2015;2015;08;08;Keskiviikko;80;30;110;4;1;5
109;26.08.2015;2015;08;09;Keskiviikko;36;23;59;11;2;13
109;26.08.2015;2015;08;10;Keskiviikko;33;14;47;4;1;5
109;26.08.2015;2015;08;11;Keskiviikko;21;21;42;4;2;6
109;26.08.2015;2015;08;12;Keskiviikko;23;20;43;1;3;4
109;26.08.2015;2015;08;13;Keskiviikko;21;24;45;4;3;7
109;26.08.2015;2015;08;14;Keskiviikko;19;42;61;0;4;4
109;26.08.2015;2015;08;15;Keskiviikko;35;75;110;3;4;7
109;26.08.2015;2015;08;16;Keskiviikko;51;107;158;5;1;6
109;26.08.2015;2015;08;17;Keskiviikko;51;46;97;3;3;6
109;26.08.2015;2015;08;18;Keskiviikko;21;31;52;6;1;7
109;26.08.2015;2015;08;19;Keskiviikko;18;32;50;6;4;10
109;26.08.2015;2015;08;20;Keskiviikko;16;20;36;3;5;8
109;26.08.2015;2015;08;21;Keskiviikko;7;18;25;5;5;10
109;26.08.2015;2015;08;22;Keskiviikko;7;12;19;4;0;4
109;26.08.2015;2015;08;23;Keskiviikko;1;3;4;0;0;0
109;27.08.2015;2015;08;00;Torstai;2;2;4;1;0;1
109;27.08.2015;2015;08;01;Torstai;0;1;1;0;2;2
109;27.08.2015;2015;08;02;Torstai;0;1;1;0;0;0
109;27.08.2015;2015;08;03;Torstai;0;0;0;0;0;0
109;27.08.2015;2015;08;04;Torstai;0;1;1;0;0;0
109;27.08.2015;2015;08;05;Torstai;1;8;9;1;1;2
109;27.08.2015;2015;08;06;Torstai;33;12;45;5;1;6
109;27.08.2015;2015;08;07;Torstai;87;35;122;5;3;8
109;27.08.2015;2015;08;08;Torstai;90;27;117;5;5;10
109;27.08.2015;2015;08;09;Torstai;24;13;37;6;3;9
109;27.08.2015;2015;08;10;Torstai;13;13;26;3;3;6
109;27.08.2015;2015;08;11;Torstai;18;8;26;2;2;4
109;27.08.2015;2015;08;12;Torstai;19;11;30;5;3;8
109;27.08.2015;2015;08;13;Torstai;20;19;39;3;2;5
109;27.08.2015;2015;08;14;Torstai;16;31;47;4;1;5
109;27.08.2015;2015;08;15;Torstai;18;76;94;3;3;6
109;27.08.2015;2015;08;16;Torstai;53;89;142;8;4;12
109;27.08.2015;2015;08;17;Torstai;23;37;60;3;2;5
109;27.08.2015;2015;08;18;Torstai;15;10;25;7;3;10
109;27.08.2015;2015;08;19;Torstai;12;22;34;4;5;9
109;27.08.2015;2015;08;20;Torstai;8;15;23;5;2;7
109;27.08.2015;2015;08;21;Torstai;7;18;25;5;2;7
109;27.08.2015;2015;08;22;Torstai;4;4;8;2;0;2
109;27.08.2015;2015;08;23;Torstai;1;4;5;1;1;2
109;28.08.2015;2015;08;00;Perjantai;0;1;1;0;0;0
109;28.08.2015;2015;08;01;Perjantai;1;0;1;0;0;0
109;28.08.2015;2015;08;02;Perjantai;1;1;2;0;0;0
109;28.08.2015;2015;08;03;Perjantai;1;1;2;0;0;0
109;28.08.2015;2015;08;04;Perjantai;1;1;2;0;0;0
109;28.08.2015;2015;08;05;Perjantai;5;10;15;0;1;1
109;28.08.2015;2015;08;06;Perjantai;20;16;36;1;3;4
109;28.08.2015;2015;08;07;Perjantai;52;27;79;3;2;5
109;28.08.2015;2015;08;08;Perjantai;42;11;53;2;1;3
109;28.08.2015;2015;08;09;Perjantai;14;13;27;2;4;6
109;28.08.2015;2015;08;10;Perjantai;9;3;12;2;2;4
109;28.08.2015;2015;08;11;Perjantai;12;4;16;4;0;4
109;28.08.2015;2015;08;12;Perjantai;7;11;18;3;1;4
109;28.08.2015;2015;08;13;Perjantai;13;14;27;0;0;0
109;28.08.2015;2015;08;14;Perjantai;17;25;42;0;0;0
109;28.08.2015;2015;08;15;Perjantai;16;31;47;3;3;6
109;28.08.2015;2015;08;16;Perjantai;20;34;54;1;2;3
109;28.08.2015;2015;08;17;Perjantai;12;17;29;2;2;4
109;28.08.2015;2015;08;18;Perjantai;11;6;17;3;0;3
109;28.08.2015;2015;08;19;Perjantai;2;1;3;2;3;5
109;28.08.2015;2015;08;20;Perjantai;3;4;7;4;1;5
109;28.08.2015;2015;08;21;Perjantai;5;3;8;2;3;5
109;28.08.2015;2015;08;22;Perjantai;5;2;7;1;0;1
109;28.08.2015;2015;08;23;Perjantai;2;2;4;2;0;2
109;29.08.2015;2015;08;00;Lauantai;4;1;5;0;0;0
109;29.08.2015;2015;08;01;Lauantai;0;1;1;0;0;0
109;29.08.2015;2015;08;02;Lauantai;0;2;2;0;0;0
109;29.08.2015;2015;08;03;Lauantai;0;2;2;0;0;0
109;29.08.2015;2015;08;04;Lauantai;0;0;0;0;0;0
109;29.08.2015;2015;08;05;Lauantai;0;2;2;0;0;0
109;29.08.2015;2015;08;06;Lauantai;3;2;5;0;1;1
109;29.08.2015;2015;08;07;Lauantai;6;3;9;3;2;5
109;29.08.2015;2015;08;08;Lauantai;7;6;13;1;1;2
109;29.08.2015;2015;08;09;Lauantai;8;8;16;2;1;3
109;29.08.2015;2015;08;10;Lauantai;22;7;29;3;1;4
109;29.08.2015;2015;08;11;Lauantai;21;2;23;3;1;4
109;29.08.2015;2015;08;12;Lauantai;23;6;29;6;1;7
109;29.08.2015;2015;08;13;Lauantai;23;14;37;3;3;6
109;29.08.2015;2015;08;14;Lauantai;26;13;39;1;9;10
109;29.08.2015;2015;08;15;Lauantai;24;24;48;9;4;13
109;29.08.2015;2015;08;16;Lauantai;14;15;29;7;6;13
109;29.08.2015;2015;08;17;Lauantai;18;6;24;3;3;6
109;29.08.2015;2015;08;18;Lauantai;17;22;39;8;0;8
109;29.08.2015;2015;08;19;Lauantai;13;11;24;4;7;11
109;29.08.2015;2015;08;20;Lauantai;7;15;22;3;1;4
109;29.08.2015;2015;08;21;Lauantai;8;10;18;0;0;0
109;29.08.2015;2015;08;22;Lauantai;4;6;10;2;1;3
109;29.08.2015;2015;08;23;Lauantai;0;4;4;1;0;1
109;30.08.2015;2015;08;00;Sunnuntai;5;3;8;1;3;4
109;30.08.2015;2015;08;01;Sunnuntai;0;1;1;0;0;0
109;30.08.2015;2015;08;02;Sunnuntai;0;1;1;0;1;1
109;30.08.2015;2015;08;03;Sunnuntai;1;1;2;1;0;1
109;30.08.2015;2015;08;04;Sunnuntai;1;3;4;0;0;0
109;30.08.2015;2015;08;05;Sunnuntai;0;0;0;0;0;0
109;30.08.2015;2015;08;06;Sunnuntai;5;2;7;0;1;1
109;30.08.2015;2015;08;07;Sunnuntai;3;5;8;4;1;5
109;30.08.2015;2015;08;08;Sunnuntai;3;3;6;3;0;3
109;30.08.2015;2015;08;09;Sunnuntai;2;9;11;1;3;4
109;30.08.2015;2015;08;10;Sunnuntai;12;8;20;5;6;11
109;30.08.2015;2015;08;11;Sunnuntai;23;11;34;9;3;12
109;30.08.2015;2015;08;12;Sunnuntai;12;10;22;13;4;17
109;30.08.2015;2015;08;13;Sunnuntai;20;14;34;12;7;19
109;30.08.2015;2015;08;14;Sunnuntai;15;22;37;8;6;14
109;30.08.2015;2015;08;15;Sunnuntai;11;17;28;4;3;7
109;30.08.2015;2015;08;16;Sunnuntai;24;18;42;3;4;7
109;30.08.2015;2015;08;17;Sunnuntai;14;10;24;6;3;9
109;30.08.2015;2015;08;18;Sunnuntai;17;12;29;1;4;5
109;30.08.2015;2015;08;19;Sunnuntai;16;9;25;14;5;19
109;30.08.2015;2015;08;20;Sunnuntai;8;22;30;6;5;11
109;30.08.2015;2015;08;21;Sunnuntai;5;7;12;3;2;5
109;30.08.2015;2015;08;22;Sunnuntai;2;2;4;2;0;2
109;30.08.2015;2015;08;23;Sunnuntai;6;0;6;1;3;4
109;31.08.2015;2015;08;00;Maanantai;0;4;4;0;0;0
109;31.08.2015;2015;08;01;Maanantai;0;0;0;0;2;2
109;31.08.2015;2015;08;02;Maanantai;0;1;1;0;0;0
109;31.08.2015;2015;08;03;Maanantai;0;0;0;0;0;0
109;31.08.2015;2015;08;04;Maanantai;1;2;3;0;0;0
109;31.08.2015;2015;08;05;Maanantai;6;7;13;1;2;3
109;31.08.2015;2015;08;06;Maanantai;32;10;42;5;4;9
109;31.08.2015;2015;08;07;Maanantai;119;40;159;10;3;13
109;31.08.2015;2015;08;08;Maanantai;86;26;112;4;3;7
109;31.08.2015;2015;08;09;Maanantai;34;11;45;8;5;13
109;31.08.2015;2015;08;10;Maanantai;16;9;25;3;1;4
109;31.08.2015;2015;08;11;Maanantai;26;14;40;2;2;4
109;31.08.2015;2015;08;12;Maanantai;19;17;36;8;3;11
109;31.08.2015;2015;08;13;Maanantai;22;20;42;3;1;4
109;31.08.2015;2015;08;14;Maanantai;17;53;70;3;1;4
109;31.08.2015;2015;08;15;Maanantai;36;71;107;4;6;10
109;31.08.2015;2015;08;16;Maanantai;56;115;171;8;3;11
109;31.08.2015;2015;08;17;Maanantai;38;54;92;2;1;3
109;31.08.2015;2015;08;18;Maanantai;16;25;41;5;4;9
109;31.08.2015;2015;08;19;Maanantai;18;20;38;6;4;10
109;31.08.2015;2015;08;20;Maanantai;10;14;24;5;8;13
109;31.08.2015;2015;08;21;Maanantai;8;12;20;3;2;5
109;31.08.2015;2015;08;22;Maanantai;12;10;22;1;2;3
109;31.08.2015;2015;08;23;Maanantai;3;1;4;0;1;1
109;01.09.2015;2015;09;00;Tiistai;1;3;4;0;0;0
109;01.09.2015;2015;09;01;Tiistai;0;0;0;0;0;0
109;01.09.2015;2015;09;02;Tiistai;0;1;1;0;1;1
109;01.09.2015;2015;09;03;Tiistai;0;0;0;0;0;0
109;01.09.2015;2015;09;04;Tiistai;0;1;1;0;0;0
109;01.09.2015;2015;09;05;Tiistai;2;9;11;0;1;1
109;01.09.2015;2015;09;06;Tiistai;42;18;60;3;1;4
109;01.09.2015;2015;09;07;Tiistai;103;34;137;1;3;4
109;01.09.2015;2015;09;08;Tiistai;75;30;105;3;4;7
109;01.09.2015;2015;09;09;Tiistai;39;17;56;5;3;8
109;01.09.2015;2015;09;10;Tiistai;20;8;28;1;2;3
109;01.09.2015;2015;09;11;Tiistai;15;18;33;3;2;5
109;01.09.2015;2015;09;12;Tiistai;17;21;38;0;1;1
109;01.09.2015;2015;09;13;Tiistai;20;25;45;3;4;7
109;01.09.2015;2015;09;14;Tiistai;30;24;54;4;3;7
109;01.09.2015;2015;09;15;Tiistai;31;72;103;6;3;9
109;01.09.2015;2015;09;16;Tiistai;54;124;178;7;4;11
109;01.09.2015;2015;09;17;Tiistai;35;41;76;5;7;12
109;01.09.2015;2015;09;18;Tiistai;21;32;53;6;10;16
109;01.09.2015;2015;09;19;Tiistai;17;21;38;8;5;13
109;01.09.2015;2015;09;20;Tiistai;16;20;36;6;5;11
109;01.09.2015;2015;09;21;Tiistai;5;9;14;2;4;6
109;01.09.2015;2015;09;22;Tiistai;5;5;10;1;0;1
109;01.09.2015;2015;09;23;Tiistai;3;4;7;0;0;0
109;02.09.2015;2015;09;00;Keskiviikko;0;1;1;0;1;1
109;02.09.2015;2015;09;01;Keskiviikko;0;0;0;0;1;1
109;02.09.2015;2015;09;02;Keskiviikko;0;1;1;0;0;0
109;02.09.2015;2015;09;03;Keskiviikko;0;0;0;0;0;0
109;02.09.2015;2015;09;04;Keskiviikko;0;1;1;0;0;0
109;02.09.2015;2015;09;05;Keskiviikko;5;9;14;1;1;2
109;02.09.2015;2015;09;06;Keskiviikko;40;18;58;6;3;9
109;02.09.2015;2015;09;07;Keskiviikko;131;38;169;4;5;9
109;02.09.2015;2015;09;08;Keskiviikko;81;21;102;5;1;6
109;02.09.2015;2015;09;09;Keskiviikko;32;17;49;1;2;3
109;02.09.2015;2015;09;10;Keskiviikko;19;5;24;4;0;4
109;02.09.2015;2015;09;11;Keskiviikko;14;17;31;1;2;3
109;02.09.2015;2015;09;12;Keskiviikko;20;20;40;7;5;12
109;02.09.2015;2015;09;13;Keskiviikko;15;16;31;4;6;10
109;02.09.2015;2015;09;14;Keskiviikko;25;34;59;4;1;5
109;02.09.2015;2015;09;15;Keskiviikko;33;81;114;6;3;9
109;02.09.2015;2015;09;16;Keskiviikko;56;118;174;8;4;12
109;02.09.2015;2015;09;17;Keskiviikko;41;38;79;3;2;5
109;02.09.2015;2015;09;18;Keskiviikko;24;22;46;3;4;7
109;02.09.2015;2015;09;19;Keskiviikko;23;23;46;10;5;15
109;02.09.2015;2015;09;20;Keskiviikko;12;20;32;4;3;7
109;02.09.2015;2015;09;21;Keskiviikko;2;17;19;4;0;4
109;02.09.2015;2015;09;22;Keskiviikko;9;4;13;0;1;1
109;02.09.2015;2015;09;23;Keskiviikko;2;3;5;0;0;0
109;03.09.2015;2015;09;00;Torstai;0;0;0;2;0;2
109;03.09.2015;2015;09;01;Torstai;0;0;0;0;0;0
109;03.09.2015;2015;09;02;Torstai;0;0;0;0;0;0
109;03.09.2015;2015;09;03;Torstai;0;0;0;0;0;0
109;03.09.2015;2015;09;04;Torstai;0;1;1;0;0;0
109;03.09.2015;2015;09;05;Torstai;1;10;11;1;0;1
109;03.09.2015;2015;09;06;Torstai;40;12;52;4;1;5
109;03.09.2015;2015;09;07;Torstai;107;39;146;4;5;9
109;03.09.2015;2015;09;08;Torstai;87;28;115;9;5;14
109;03.09.2015;2015;09;09;Torstai;24;16;40;5;3;8
109;03.09.2015;2015;09;10;Torstai;12;10;22;6;12;18
109;03.09.2015;2015;09;11;Torstai;16;18;34;4;2;6
109;03.09.2015;2015;09;12;Torstai;16;17;33;6;5;11
109;03.09.2015;2015;09;13;Torstai;13;24;37;5;4;9
109;03.09.2015;2015;09;14;Torstai;22;46;68;1;3;4
109;03.09.2015;2015;09;15;Torstai;26;65;91;3;7;10
109;03.09.2015;2015;09;16;Torstai;60;108;168;10;6;16
109;03.09.2015;2015;09;17;Torstai;29;36;65;8;2;10
109;03.09.2015;2015;09;18;Torstai;6;26;32;9;2;11
109;03.09.2015;2015;09;19;Torstai;23;22;45;5;5;10
109;03.09.2015;2015;09;20;Torstai;10;6;16;4;4;8
109;03.09.2015;2015;09;21;Torstai;3;12;15;2;6;8
109;03.09.2015;2015;09;22;Torstai;9;0;9;1;0;1
109;03.09.2015;2015;09;23;Torstai;3;1;4;1;2;3
109;04.09.2015;2015;09;00;Perjantai;0;1;1;1;2;3
109;04.09.2015;2015;09;01;Perjantai;0;0;0;0;1;1
109;04.09.2015;2015;09;02;Perjantai;0;0;0;0;0;0
109;04.09.2015;2015;09;03;Perjantai;0;0;0;0;0;0
109;04.09.2015;2015;09;04;Perjantai;0;0;0;0;0;0
109;04.09.2015;2015;09;05;Perjantai;4;8;12;1;2;3
109;04.09.2015;2015;09;06;Perjantai;36;13;49;5;1;6
109;04.09.2015;2015;09;07;Perjantai;70;30;100;6;3;9
109;04.09.2015;2015;09;08;Perjantai;72;22;94;4;0;4
109;04.09.2015;2015;09;09;Perjantai;23;17;40;3;1;4
109;04.09.2015;2015;09;10;Perjantai;12;11;23;1;3;4
109;04.09.2015;2015;09;11;Perjantai;16;12;28;4;3;7
109;04.09.2015;2015;09;12;Perjantai;22;14;36;1;2;3
109;04.09.2015;2015;09;13;Perjantai;24;29;53;4;2;6
109;04.09.2015;2015;09;14;Perjantai;15;68;83;5;2;7
109;04.09.2015;2015;09;15;Perjantai;30;59;89;5;2;7
109;04.09.2015;2015;09;16;Perjantai;26;51;77;3;5;8
109;04.09.2015;2015;09;17;Perjantai;26;33;59;3;0;3
109;04.09.2015;2015;09;18;Perjantai;19;11;30;5;2;7
109;04.09.2015;2015;09;19;Perjantai;14;8;22;3;2;5
109;04.09.2015;2015;09;20;Perjantai;11;10;21;4;2;6
109;04.09.2015;2015;09;21;Perjantai;4;7;11;3;2;5
109;04.09.2015;2015;09;22;Perjantai;4;4;8;1;2;3
109;04.09.2015;2015;09;23;Perjantai;2;3;5;1;1;2
109;05.09.2015;2015;09;00;Lauantai;2;1;3;0;0;0
109;05.09.2015;2015;09;01;Lauantai;1;5;6;0;1;1
109;05.09.2015;2015;09;02;Lauantai;0;6;6;0;1;1
109;05.09.2015;2015;09;03;Lauantai;0;4;4;0;0;0
109;05.09.2015;2015;09;04;Lauantai;0;3;3;2;1;3
109;05.09.2015;2015;09;05;Lauantai;0;1;1;0;2;2
109;05.09.2015;2015;09;06;Lauantai;6;1;7;0;0;0
109;05.09.2015;2015;09;07;Lauantai;5;2;7;2;1;3
109;05.09.2015;2015;09;08;Lauantai;16;2;18;4;0;4
109;05.09.2015;2015;09;09;Lauantai;8;4;12;4;2;6
109;05.09.2015;2015;09;10;Lauantai;6;10;16;3;3;6
109;05.09.2015;2015;09;11;Lauantai;10;8;18;2;3;5
109;05.09.2015;2015;09;12;Lauantai;14;14;28;10;2;12
109;05.09.2015;2015;09;13;Lauantai;18;6;24;5;5;10
109;05.09.2015;2015;09;14;Lauantai;15;13;28;3;2;5
109;05.09.2015;2015;09;15;Lauantai;11;19;30;4;2;6
109;05.09.2015;2015;09;16;Lauantai;14;14;28;5;3;8
109;05.09.2015;2015;09;17;Lauantai;9;15;24;2;2;4
109;05.09.2015;2015;09;18;Lauantai;16;9;25;6;4;10
109;05.09.2015;2015;09;19;Lauantai;6;8;14;2;1;3
109;05.09.2015;2015;09;20;Lauantai;4;4;8;5;2;7
109;05.09.2015;2015;09;21;Lauantai;5;13;18;3;6;9
109;05.09.2015;2015;09;22;Lauantai;2;1;3;2;1;3
109;05.09.2015;2015;09;23;Lauantai;5;1;6;1;3;4
109;06.09.2015;2015;09;00;Sunnuntai;2;0;2;0;0;0
109;06.09.2015;2015;09;01;Sunnuntai;1;0;1;0;0;0
109;06.09.2015;2015;09;02;Sunnuntai;0;1;1;0;0;0
109;06.09.2015;2015;09;03;Sunnuntai;0;4;4;0;0;0
109;06.09.2015;2015;09;04;Sunnuntai;0;1;1;0;0;0
109;06.09.2015;2015;09;05;Sunnuntai;1;1;2;0;1;1
109;06.09.2015;2015;09;06;Sunnuntai;4;1;5;0;0;0
109;06.09.2015;2015;09;07;Sunnuntai;0;3;3;2;2;4
109;06.09.2015;2015;09;08;Sunnuntai;2;3;5;3;0;3
109;06.09.2015;2015;09;09;Sunnuntai;4;6;10;2;2;4
109;06.09.2015;2015;09;10;Sunnuntai;6;2;8;5;3;8
109;06.09.2015;2015;09;11;Sunnuntai;6;3;9;2;2;4
109;06.09.2015;2015;09;12;Sunnuntai;7;4;11;4;2;6
109;06.09.2015;2015;09;13;Sunnuntai;12;3;15;3;7;10
109;06.09.2015;2015;09;14;Sunnuntai;11;7;18;5;1;6
109;06.09.2015;2015;09;15;Sunnuntai;16;5;21;4;5;9
109;06.09.2015;2015;09;16;Sunnuntai;9;12;21;8;2;10
109;06.09.2015;2015;09;17;Sunnuntai;9;8;17;7;4;11
109;06.09.2015;2015;09;18;Sunnuntai;9;5;14;4;7;11
109;06.09.2015;2015;09;19;Sunnuntai;9;7;16;3;1;4
109;06.09.2015;2015;09;20;Sunnuntai;5;13;18;1;3;4
109;06.09.2015;2015;09;21;Sunnuntai;3;7;10;4;2;6
109;06.09.2015;2015;09;22;Sunnuntai;1;2;3;0;1;1
109;06.09.2015;2015;09;23;Sunnuntai;1;0;1;2;0;2
109;07.09.2015;2015;09;00;Maanantai;0;1;1;0;0;0
109;07.09.2015;2015;09;01;Maanantai;0;0;0;0;1;1
109;07.09.2015;2015;09;02;Maanantai;0;1;1;0;0;0
109;07.09.2015;2015;09;03;Maanantai;0;0;0;0;0;0
109;07.09.2015;2015;09;04;Maanantai;0;2;2;1;0;1
109;07.09.2015;2015;09;05;Maanantai;8;13;21;0;0;0
109;07.09.2015;2015;09;06;Maanantai;37;10;47;4;2;6
109;07.09.2015;2015;09;07;Maanantai;79;48;127;5;5;10
109;07.09.2015;2015;09;08;Maanantai;64;20;84;4;0;4
109;07.09.2015;2015;09;09;Maanantai;35;10;45;1;1;2
109;07.09.2015;2015;09;10;Maanantai;10;8;18;0;0;0
109;07.09.2015;2015;09;11;Maanantai;19;10;29;2;0;2
109;07.09.2015;2015;09;12;Maanantai;14;9;23;4;5;9
109;07.09.2015;2015;09;13;Maanantai;22;17;39;2;3;5
109;07.09.2015;2015;09;14;Maanantai;18;31;49;2;4;6
109;07.09.2015;2015;09;15;Maanantai;23;58;81;4;6;10
109;07.09.2015;2015;09;16;Maanantai;45;98;143;3;3;6
109;07.09.2015;2015;09;17;Maanantai;22;27;49;4;2;6
109;07.09.2015;2015;09;18;Maanantai;17;34;51;6;6;12
109;07.09.2015;2015;09;19;Maanantai;21;18;39;8;5;13
109;07.09.2015;2015;09;20;Maanantai;13;19;32;5;7;12
109;07.09.2015;2015;09;21;Maanantai;7;15;22;1;3;4
109;07.09.2015;2015;09;22;Maanantai;10;5;15;2;2;4
109;07.09.2015;2015;09;23;Maanantai;3;2;5;0;0;0
109;08.09.2015;2015;09;00;Tiistai;1;1;2;0;0;0
109;08.09.2015;2015;09;01;Tiistai;4;1;5;0;1;1
109;08.09.2015;2015;09;02;Tiistai;0;0;0;0;1;1
109;08.09.2015;2015;09;03;Tiistai;0;0;0;0;0;0
109;08.09.2015;2015;09;04;Tiistai;0;1;1;0;0;0
109;08.09.2015;2015;09;05;Tiistai;3;12;15;0;1;1
109;08.09.2015;2015;09;06;Tiistai;43;12;55;6;2;8
109;08.09.2015;2015;09;07;Tiistai;110;54;164;4;5;9
109;08.09.2015;2015;09;08;Tiistai;70;22;92;2;2;4
109;08.09.2015;2015;09;09;Tiistai;39;11;50;4;2;6
109;08.09.2015;2015;09;10;Tiistai;11;3;14;2;4;6
109;08.09.2015;2015;09;11;Tiistai;17;13;30;2;1;3
109;08.09.2015;2015;09;12;Tiistai;19;19;38;4;0;4
109;08.09.2015;2015;09;13;Tiistai;21;22;43;1;3;4
109;08.09.2015;2015;09;14;Tiistai;25;27;52;3;3;6
109;08.09.2015;2015;09;15;Tiistai;27;72;99;9;6;15
109;08.09.2015;2015;09;16;Tiistai;46;115;161;5;7;12
109;08.09.2015;2015;09;17;Tiistai;29;61;90;5;2;7
109;08.09.2015;2015;09;18;Tiistai;15;23;38;8;4;12
109;08.09.2015;2015;09;19;Tiistai;24;19;43;7;5;12
109;08.09.2015;2015;09;20;Tiistai;13;11;24;4;3;7
109;08.09.2015;2015;09;21;Tiistai;6;9;15;2;4;6
109;08.09.2015;2015;09;22;Tiistai;7;4;11;3;1;4
109;08.09.2015;2015;09;23;Tiistai;2;0;2;2;2;4
109;09.09.2015;2015;09;00;Keskiviikko;1;0;1;0;0;0
109;09.09.2015;2015;09;01;Keskiviikko;2;0;2;0;0;0
109;09.09.2015;2015;09;02;Keskiviikko;0;1;1;0;0;0
109;09.09.2015;2015;09;03;Keskiviikko;1;0;1;0;0;0
109;09.09.2015;2015;09;04;Keskiviikko;0;0;0;0;0;0
109;09.09.2015;2015;09;05;Keskiviikko;2;11;13;1;0;1
109;09.09.2015;2015;09;06;Keskiviikko;43;11;54;5;2;7
109;09.09.2015;2015;09;07;Keskiviikko;112;43;155;5;3;8
109;09.09.2015;2015;09;08;Keskiviikko;84;23;107;5;3;8
109;09.09.2015;2015;09;09;Keskiviikko;35;15;50;7;3;10
109;09.09.2015;2015;09;10;Keskiviikko;16;11;27;1;1;2
109;09.09.2015;2015;09;11;Keskiviikko;20;14;34;1;2;3
109;09.09.2015;2015;09;12;Keskiviikko;18;12;30;3;4;7
109;09.09.2015;2015;09;13;Keskiviikko;17;20;37;1;2;3
109;09.09.2015;2015;09;14;Keskiviikko;20;36;56;6;1;7
109;09.09.2015;2015;09;15;Keskiviikko;36;79;115;6;3;9
109;09.09.2015;2015;09;16;Keskiviikko;63;86;149;4;6;10
109;09.09.2015;2015;09;17;Keskiviikko;29;44;73;4;4;8
109;09.09.2015;2015;09;18;Keskiviikko;25;22;47;6;4;10
109;09.09.2015;2015;09;19;Keskiviikko;18;31;49;9;2;11
109;09.09.2015;2015;09;20;Keskiviikko;15;16;31;6;7;13
109;09.09.2015;2015;09;21;Keskiviikko;3;20;23;1;2;3
109;09.09.2015;2015;09;22;Keskiviikko;6;4;10;1;2;3
109;09.09.2015;2015;09;23;Keskiviikko;3;1;4;1;0;1
109;10.09.2015;2015;09;00;Torstai;4;3;7;0;0;0
109;10.09.2015;2015;09;01;Torstai;0;2;2;0;0;0
109;10.09.2015;2015;09;02;Torstai;0;4;4;0;0;0
109;10.09.2015;2015;09;03;Torstai;0;1;1;0;0;0
109;10.09.2015;2015;09;04;Torstai;2;1;3;1;0;1
109;10.09.2015;2015;09;05;Torstai;1;8;9;1;0;1
109;10.09.2015;2015;09;06;Torstai;39;14;53;3;3;6
109;10.09.2015;2015;09;07;Torstai;93;29;122;6;4;10
109;10.09.2015;2015;09;08;Torstai;95;31;126;4;6;10
109;10.09.2015;2015;09;09;Torstai;27;9;36;6;2;8
109;10.09.2015;2015;09;10;Torstai;17;10;27;1;2;3
109;10.09.2015;2015;09;11;Torstai;24;26;50;2;2;4
109;10.09.2015;2015;09;12;Torstai;24;15;39;5;2;7
109;10.09.2015;2015;09;13;Torstai;14;35;49;4;5;9
109;10.09.2015;2015;09;14;Torstai;26;44;70;2;5;7
109;10.09.2015;2015;09;15;Torstai;35;57;92;7;6;13
109;10.09.2015;2015;09;16;Torstai;60;94;154;7;4;11
109;10.09.2015;2015;09;17;Torstai;30;42;72;0;1;1
109;10.09.2015;2015;09;18;Torstai;26;24;50;9;2;11
109;10.09.2015;2015;09;19;Torstai;14;23;37;8;6;14
109;10.09.2015;2015;09;20;Torstai;12;14;26;5;4;9
109;10.09.2015;2015;09;21;Torstai;6;16;22;4;1;5
109;10.09.2015;2015;09;22;Torstai;6;1;7;0;1;1
109;10.09.2015;2015;09;23;Torstai;1;3;4;0;1;1
109;11.09.2015;2015;09;00;Perjantai;2;0;2;0;0;0
109;11.09.2015;2015;09;01;Perjantai;0;1;1;0;1;1
109;11.09.2015;2015;09;02;Perjantai;0;2;2;0;0;0
109;11.09.2015;2015;09;03;Perjantai;0;0;0;0;0;0
109;11.09.2015;2015;09;04;Perjantai;2;2;4;1;0;1
109;11.09.2015;2015;09;05;Perjantai;3;10;13;2;0;2
109;11.09.2015;2015;09;06;Perjantai;30;9;39;3;2;5
109;11.09.2015;2015;09;07;Perjantai;77;26;103;7;7;14
109;11.09.2015;2015;09;08;Perjantai;73;30;103;3;0;3
109;11.09.2015;2015;09;09;Perjantai;28;15;43;5;3;8
109;11.09.2015;2015;09;10;Perjantai;13;10;23;1;1;2
109;11.09.2015;2015;09;11;Perjantai;20;12;32;7;0;7
109;11.09.2015;2015;09;12;Perjantai;26;14;40;8;2;10
109;11.09.2015;2015;09;13;Perjantai;20;31;51;3;8;11
109;11.09.2015;2015;09;14;Perjantai;23;63;86;1;2;3
109;11.09.2015;2015;09;15;Perjantai;24;56;80;4;6;10
109;11.09.2015;2015;09;16;Perjantai;36;67;103;7;4;11
109;11.09.2015;2015;09;17;Perjantai;23;32;55;8;4;12
109;11.09.2015;2015;09;18;Perjantai;17;17;34;12;7;19
109;11.09.2015;2015;09;19;Perjantai;6;14;20;6;2;8
109;11.09.2015;2015;09;20;Perjantai;15;4;19;1;2;3
109;11.09.2015;2015;09;21;Perjantai;8;12;20;2;2;4
109;11.09.2015;2015;09;22;Perjantai;8;4;12;0;1;1
109;11.09.2015;2015;09;23;Perjantai;1;2;3;0;1;1
109;12.09.2015;2015;09;00;Lauantai;2;3;5;1;2;3
109;12.09.2015;2015;09;01;Lauantai;2;2;4;1;0;1
109;12.09.2015;2015;09;02;Lauantai;0;3;3;0;0;0
109;12.09.2015;2015;09;03;Lauantai;0;1;1;0;0;0
109;12.09.2015;2015;09;04;Lauantai;2;0;2;0;0;0
109;12.09.2015;2015;09;05;Lauantai;3;1;4;0;1;1
109;12.09.2015;2015;09;06;Lauantai;7;1;8;1;0;1
109;12.09.2015;2015;09;07;Lauantai;3;3;6;1;4;5
109;12.09.2015;2015;09;08;Lauantai;4;2;6;2;1;3
109;12.09.2015;2015;09;09;Lauantai;14;7;21;4;2;6
109;12.09.2015;2015;09;10;Lauantai;15;7;22;4;1;5
109;12.09.2015;2015;09;11;Lauantai;14;16;30;4;6;10
109;12.09.2015;2015;09;12;Lauantai;22;17;39;4;3;7
109;12.09.2015;2015;09;13;Lauantai;23;17;40;0;3;3
109;12.09.2015;2015;09;14;Lauantai;27;21;48;6;4;10
109;12.09.2015;2015;09;15;Lauantai;18;24;42;3;8;11
109;12.09.2015;2015;09;16;Lauantai;11;20;31;7;3;10
109;12.09.2015;2015;09;17;Lauantai;18;8;26;4;3;7
109;12.09.2015;2015;09;18;Lauantai;21;21;42;8;4;12
109;12.09.2015;2015;09;19;Lauantai;9;13;22;3;4;7
109;12.09.2015;2015;09;20;Lauantai;13;15;28;2;1;3
109;12.09.2015;2015;09;21;Lauantai;4;9;13;0;2;2
109;12.09.2015;2015;09;22;Lauantai;4;5;9;2;2;4
109;12.09.2015;2015;09;23;Lauantai;1;2;3;1;0;1
109;13.09.2015;2015;09;00;Sunnuntai;2;0;2;0;0;0
109;13.09.2015;2015;09;01;Sunnuntai;0;2;2;1;0;1
109;13.09.2015;2015;09;02;Sunnuntai;0;3;3;3;2;5
109;13.09.2015;2015;09;03;Sunnuntai;0;2;2;1;1;2
109;13.09.2015;2015;09;04;Sunnuntai;0;0;0;1;0;1
109;13.09.2015;2015;09;05;Sunnuntai;0;0;0;0;1;1
109;13.09.2015;2015;09;06;Sunnuntai;3;2;5;2;0;2
109;13.09.2015;2015;09;07;Sunnuntai;1;4;5;1;2;3
109;13.09.2015;2015;09;08;Sunnuntai;5;2;7;2;2;4
109;13.09.2015;2015;09;09;Sunnuntai;8;2;10;8;1;9
109;13.09.2015;2015;09;10;Sunnuntai;6;4;10;3;4;7
109;13.09.2015;2015;09;11;Sunnuntai;18;16;34;6;4;10
109;13.09.2015;2015;09;12;Sunnuntai;20;15;35;5;5;10
109;13.09.2015;2015;09;13;Sunnuntai;15;20;35;3;3;6
109;13.09.2015;2015;09;14;Sunnuntai;23;14;37;4;5;9
109;13.09.2015;2015;09;15;Sunnuntai;22;17;39;2;4;6
109;13.09.2015;2015;09;16;Sunnuntai;20;8;28;9;5;14
109;13.09.2015;2015;09;17;Sunnuntai;26;18;44;7;6;13
109;13.09.2015;2015;09;18;Sunnuntai;25;14;39;17;3;20
109;13.09.2015;2015;09;19;Sunnuntai;13;13;26;7;0;7
109;13.09.2015;2015;09;20;Sunnuntai;11;17;28;3;3;6
109;13.09.2015;2015;09;21;Sunnuntai;8;10;18;1;1;2
109;13.09.2015;2015;09;22;Sunnuntai;3;4;7;4;1;5
109;13.09.2015;2015;09;23;Sunnuntai;1;0;1;0;0;0
109;14.09.2015;2015;09;00;Maanantai;0;0;0;0;0;0
109;14.09.2015;2015;09;01;Maanantai;0;1;1;0;0;0
109;14.09.2015;2015;09;02;Maanantai;0;0;0;3;4;7
109;14.09.2015;2015;09;03;Maanantai;0;0;0;0;0;0
109;14.09.2015;2015;09;04;Maanantai;0;1;1;0;0;0
109;14.09.2015;2015;09;05;Maanantai;1;4;5;1;1;2
109;14.09.2015;2015;09;06;Maanantai;47;17;64;6;2;8
109;14.09.2015;2015;09;07;Maanantai;92;45;137;8;4;12
109;14.09.2015;2015;09;08;Maanantai;86;29;115;0;1;1
109;14.09.2015;2015;09;09;Maanantai;37;17;54;5;1;6
109;14.09.2015;2015;09;10;Maanantai;12;6;18;9;2;11
109;14.09.2015;2015;09;11;Maanantai;21;12;33;4;3;7
109;14.09.2015;2015;09;12;Maanantai;18;19;37;1;4;5
109;14.09.2015;2015;09;13;Maanantai;20;23;43;4;6;10
109;14.09.2015;2015;09;14;Maanantai;26;40;66;5;4;9
109;14.09.2015;2015;09;15;Maanantai;31;82;113;8;2;10
109;14.09.2015;2015;09;16;Maanantai;70;115;185;5;4;9
109;14.09.2015;2015;09;17;Maanantai;38;48;86;5;2;7
109;14.09.2015;2015;09;18;Maanantai;17;23;40;10;5;15
109;14.09.2015;2015;09;19;Maanantai;29;19;48;10;3;13
109;14.09.2015;2015;09;20;Maanantai;12;20;32;3;3;6
109;14.09.2015;2015;09;21;Maanantai;2;7;9;1;1;2
109;14.09.2015;2015;09;22;Maanantai;6;4;10;2;0;2
109;14.09.2015;2015;09;23;Maanantai;1;1;2;0;1;1
109;15.09.2015;2015;09;00;Tiistai;0;0;0;1;0;1
109;15.09.2015;2015;09;01;Tiistai;1;0;1;0;2;2
109;15.09.2015;2015;09;02;Tiistai;0;0;0;0;0;0
109;15.09.2015;2015;09;03;Tiistai;0;0;0;0;0;0
109;15.09.2015;2015;09;04;Tiistai;0;1;1;3;0;3
109;15.09.2015;2015;09;05;Tiistai;1;8;9;0;0;0
109;15.09.2015;2015;09;06;Tiistai;41;15;56;5;3;8
109;15.09.2015;2015;09;07;Tiistai;105;46;151;5;3;8
109;15.09.2015;2015;09;08;Tiistai;90;26;116;4;5;9
109;15.09.2015;2015;09;09;Tiistai;40;17;57;5;5;10
109;15.09.2015;2015;09;10;Tiistai;23;13;36;5;4;9
109;15.09.2015;2015;09;11;Tiistai;24;16;40;1;2;3
109;15.09.2015;2015;09;12;Tiistai;20;18;38;1;1;2
109;15.09.2015;2015;09;13;Tiistai;14;30;44;2;2;4
109;15.09.2015;2015;09;14;Tiistai;26;38;64;3;3;6
109;15.09.2015;2015;09;15;Tiistai;37;77;114;3;4;7
109;15.09.2015;2015;09;16;Tiistai;56;111;167;8;6;14
109;15.09.2015;2015;09;17;Tiistai;28;48;76;6;4;10
109;15.09.2015;2015;09;18;Tiistai;24;31;55;11;5;16
109;15.09.2015;2015;09;19;Tiistai;26;24;50;9;8;17
109;15.09.2015;2015;09;20;Tiistai;11;14;25;8;5;13
109;15.09.2015;2015;09;21;Tiistai;3;10;13;5;4;9
109;15.09.2015;2015;09;22;Tiistai;13;5;18;1;0;1
109;15.09.2015;2015;09;23;Tiistai;1;2;3;0;2;2
109;16.09.2015;2015;09;00;Keskiviikko;0;2;2;1;1;2
109;16.09.2015;2015;09;01;Keskiviikko;0;0;0;0;0;0
109;16.09.2015;2015;09;02;Keskiviikko;0;0;0;0;0;0
109;16.09.2015;2015;09;03;Keskiviikko;0;0;0;0;0;0
109;16.09.2015;2015;09;04;Keskiviikko;0;1;1;0;0;0
109;16.09.2015;2015;09;05;Keskiviikko;1;8;9;2;0;2
109;16.09.2015;2015;09;06;Keskiviikko;30;13;43;2;8;10
109;16.09.2015;2015;09;07;Keskiviikko;95;32;127;3;6;9
109;16.09.2015;2015;09;08;Keskiviikko;75;22;97;3;1;4
109;16.09.2015;2015;09;09;Keskiviikko;21;14;35;2;2;4
109;16.09.2015;2015;09;10;Keskiviikko;8;5;13;3;0;3
109;16.09.2015;2015;09;11;Keskiviikko;15;14;29;1;3;4
109;16.09.2015;2015;09;12;Keskiviikko;13;8;21;3;0;3
109;16.09.2015;2015;09;13;Keskiviikko;15;19;34;2;2;4
109;16.09.2015;2015;09;14;Keskiviikko;13;29;42;0;5;5
109;16.09.2015;2015;09;15;Keskiviikko;36;53;89;12;9;21
109;16.09.2015;2015;09;16;Keskiviikko;35;85;120;7;3;10
109;16.09.2015;2015;09;17;Keskiviikko;20;30;50;3;5;8
109;16.09.2015;2015;09;18;Keskiviikko;16;20;36;6;3;9
109;16.09.2015;2015;09;19;Keskiviikko;7;21;28;6;7;13
109;16.09.2015;2015;09;20;Keskiviikko;5;21;26;12;2;14
109;16.09.2015;2015;09;21;Keskiviikko;9;9;18;0;4;4
109;16.09.2015;2015;09;22;Keskiviikko;7;3;10;1;1;2
109;16.09.2015;2015;09;23;Keskiviikko;2;1;3;0;0;0
109;17.09.2015;2015;09;00;Torstai;1;0;1;2;0;2
109;17.09.2015;2015;09;01;Torstai;0;0;0;0;0;0
109;17.09.2015;2015;09;02;Torstai;0;1;1;0;0;0
109;17.09.2015;2015;09;03;Torstai;0;0;0;0;0;0
109;17.09.2015;2015;09;04;Torstai;0;2;2;0;0;0
109;17.09.2015;2015;09;05;Torstai;0;8;8;1;0;1
109;17.09.2015;2015;09;06;Torstai;42;12;54;3;5;8
109;17.09.2015;2015;09;07;Torstai;87;31;118;5;3;8
109;17.09.2015;2015;09;08;Torstai;70;23;93;2;3;5
109;17.09.2015;2015;09;09;Torstai;31;9;40;6;3;9
109;17.09.2015;2015;09;10;Torstai;13;9;22;3;1;4
109;17.09.2015;2015;09;11;Torstai;18;15;33;4;2;6
109;17.09.2015;2015;09;12;Torstai;8;18;26;2;0;2
109;17.09.2015;2015;09;13;Torstai;11;21;32;3;4;7
109;17.09.2015;2015;09;14;Torstai;18;44;62;3;1;4
109;17.09.2015;2015;09;15;Torstai;33;64;97;7;10;17
109;17.09.2015;2015;09;16;Torstai;42;102;144;6;7;13
109;17.09.2015;2015;09;17;Torstai;23;37;60;11;0;11
109;17.09.2015;2015;09;18;Torstai;18;30;48;10;3;13
109;17.09.2015;2015;09;19;Torstai;6;16;22;1;2;3
109;17.09.2015;2015;09;20;Torstai;7;11;18;1;1;2
109;17.09.2015;2015;09;21;Torstai;4;14;18;2;2;4
109;17.09.2015;2015;09;22;Torstai;7;5;12;1;0;1
109;17.09.2015;2015;09;23;Torstai;1;1;2;0;0;0
109;18.09.2015;2015;09;00;Perjantai;0;0;0;0;1;1
109;18.09.2015;2015;09;01;Perjantai;0;1;1;0;0;0
109;18.09.2015;2015;09;02;Perjantai;0;1;1;0;0;0
109;18.09.2015;2015;09;03;Perjantai;0;0;0;3;0;3
109;18.09.2015;2015;09;04;Perjantai;1;1;2;0;0;0
109;18.09.2015;2015;09;05;Perjantai;4;4;8;0;0;0
109;18.09.2015;2015;09;06;Perjantai;25;7;32;3;2;5
109;18.09.2015;2015;09;07;Perjantai;49;21;70;3;3;6
109;18.09.2015;2015;09;08;Perjantai;49;11;60;4;0;4
109;18.09.2015;2015;09;09;Perjantai;13;6;19;2;0;2
109;18.09.2015;2015;09;10;Perjantai;7;1;8;1;0;1
109;18.09.2015;2015;09;11;Perjantai;12;8;20;0;0;0
109;18.09.2015;2015;09;12;Perjantai;12;9;21;1;0;1
109;18.09.2015;2015;09;13;Perjantai;10;12;22;1;0;1
109;18.09.2015;2015;09;14;Perjantai;14;17;31;2;0;2
109;18.09.2015;2015;09;15;Perjantai;17;22;39;0;0;0
109;18.09.2015;2015;09;16;Perjantai;20;35;55;4;4;8
109;18.09.2015;2015;09;17;Perjantai;6;12;18;3;0;3
109;18.09.2015;2015;09;18;Perjantai;7;4;11;3;1;4
109;18.09.2015;2015;09;19;Perjantai;6;5;11;3;1;4
109;18.09.2015;2015;09;20;Perjantai;5;3;8;3;2;5
109;18.09.2015;2015;09;21;Perjantai;5;11;16;1;1;2
109;18.09.2015;2015;09;22;Perjantai;4;2;6;0;3;3
109;18.09.2015;2015;09;23;Perjantai;1;0;1;1;0;1
109;19.09.2015;2015;09;00;Lauantai;2;4;6;0;2;2
109;19.09.2015;2015;09;01;Lauantai;0;0;0;0;0;0
109;19.09.2015;2015;09;02;Lauantai;0;1;1;0;0;0
109;19.09.2015;2015;09;03;Lauantai;0;0;0;0;0;0
109;19.09.2015;2015;09;04;Lauantai;0;0;0;0;0;0
109;19.09.2015;2015;09;05;Lauantai;0;0;0;0;0;0
109;19.09.2015;2015;09;06;Lauantai;3;0;3;1;0;1
109;19.09.2015;2015;09;07;Lauantai;3;4;7;2;1;3
109;19.09.2015;2015;09;08;Lauantai;8;2;10;0;3;3
109;19.09.2015;2015;09;09;Lauantai;10;5;15;4;3;7
109;19.09.2015;2015;09;10;Lauantai;7;5;12;5;4;9
109;19.09.2015;2015;09;11;Lauantai;1;5;6;1;3;4
109;19.09.2015;2015;09;12;Lauantai;10;13;23;5;6;11
109;19.09.2015;2015;09;13;Lauantai;13;12;25;6;4;10
109;19.09.2015;2015;09;14;Lauantai;9;13;22;3;5;8
109;19.09.2015;2015;09;15;Lauantai;18;12;30;6;8;14
109;19.09.2015;2015;09;16;Lauantai;6;12;18;8;4;12
109;19.09.2015;2015;09;17;Lauantai;9;4;13;8;2;10
109;19.09.2015;2015;09;18;Lauantai;9;13;22;8;3;11
109;19.09.2015;2015;09;19;Lauantai;9;12;21;5;2;7
109;19.09.2015;2015;09;20;Lauantai;7;7;14;5;4;9
109;19.09.2015;2015;09;21;Lauantai;2;8;10;2;1;3
109;19.09.2015;2015;09;22;Lauantai;2;0;2;1;2;3
109;19.09.2015;2015;09;23;Lauantai;0;8;8;0;0;0
109;20.09.2015;2015;09;00;Sunnuntai;1;3;4;0;0;0
109;20.09.2015;2015;09;01;Sunnuntai;0;1;1;0;0;0
109;20.09.2015;2015;09;02;Sunnuntai;1;1;2;0;0;0
109;20.09.2015;2015;09;03;Sunnuntai;0;2;2;0;0;0
109;20.09.2015;2015;09;04;Sunnuntai;0;3;3;0;0;0
109;20.09.2015;2015;09;05;Sunnuntai;0;0;0;0;0;0
109;20.09.2015;2015;09;06;Sunnuntai;2;0;2;0;0;0
109;20.09.2015;2015;09;07;Sunnuntai;1;1;2;4;3;7
109;20.09.2015;2015;09;08;Sunnuntai;1;2;3;6;1;7
109;20.09.2015;2015;09;09;Sunnuntai;9;2;11;5;10;15
109;20.09.2015;2015;09;10;Sunnuntai;9;9;18;3;1;4
109;20.09.2015;2015;09;11;Sunnuntai;15;7;22;3;4;7
109;20.09.2015;2015;09;12;Sunnuntai;19;9;28;11;7;18
109;20.09.2015;2015;09;13;Sunnuntai;15;12;27;5;3;8
109;20.09.2015;2015;09;14;Sunnuntai;7;10;17;4;3;7
109;20.09.2015;2015;09;15;Sunnuntai;18;14;32;9;6;15
109;20.09.2015;2015;09;16;Sunnuntai;11;15;26;7;4;11
109;20.09.2015;2015;09;17;Sunnuntai;3;5;8;0;0;0
109;20.09.2015;2015;09;18;Sunnuntai;8;13;21;3;3;6
109;20.09.2015;2015;09;19;Sunnuntai;7;7;14;7;5;12
109;20.09.2015;2015;09;20;Sunnuntai;4;7;11;12;19;31
109;20.09.2015;2015;09;21;Sunnuntai;2;5;7;0;1;1
109;20.09.2015;2015;09;22;Sunnuntai;0;1;1;1;0;1
109;20.09.2015;2015;09;23;Sunnuntai;0;1;1;2;0;2
109;21.09.2015;2015;09;00;Maanantai;0;0;0;0;1;1
109;21.09.2015;2015;09;01;Maanantai;2;0;2;0;1;1
109;21.09.2015;2015;09;02;Maanantai;0;0;0;0;0;0
109;21.09.2015;2015;09;03;Maanantai;1;0;1;0;0;0
109;21.09.2015;2015;09;04;Maanantai;2;1;3;0;0;0
109;21.09.2015;2015;09;05;Maanantai;2;10;12;1;1;2
109;21.09.2015;2015;09;06;Maanantai;43;12;55;5;4;9
109;21.09.2015;2015;09;07;Maanantai;91;43;134;9;4;13
109;21.09.2015;2015;09;08;Maanantai;84;25;109;2;0;2
109;21.09.2015;2015;09;09;Maanantai;29;11;40;4;5;9
109;21.09.2015;2015;09;10;Maanantai;14;12;26;6;2;8
109;21.09.2015;2015;09;11;Maanantai;20;16;36;0;2;2
109;21.09.2015;2015;09;12;Maanantai;15;16;31;2;1;3
109;21.09.2015;2015;09;13;Maanantai;17;21;38;0;3;3
109;21.09.2015;2015;09;14;Maanantai;22;34;56;5;3;8
109;21.09.2015;2015;09;15;Maanantai;30;76;106;6;2;8
109;21.09.2015;2015;09;16;Maanantai;61;106;167;5;5;10
109;21.09.2015;2015;09;17;Maanantai;15;39;54;4;5;9
109;21.09.2015;2015;09;18;Maanantai;24;21;45;10;5;15
109;21.09.2015;2015;09;19;Maanantai;15;17;32;14;4;18
109;21.09.2015;2015;09;20;Maanantai;7;19;26;7;5;12
109;21.09.2015;2015;09;21;Maanantai;5;9;14;1;1;2
109;21.09.2015;2015;09;22;Maanantai;3;4;7;0;0;0
109;21.09.2015;2015;09;23;Maanantai;2;2;4;1;0;1
109;22.09.2015;2015;09;00;Tiistai;4;2;6;0;1;1
109;22.09.2015;2015;09;01;Tiistai;0;0;0;0;1;1
109;22.09.2015;2015;09;02;Tiistai;3;0;3;0;0;0
109;22.09.2015;2015;09;03;Tiistai;0;0;0;0;0;0
109;22.09.2015;2015;09;04;Tiistai;1;1;2;0;0;0
109;22.09.2015;2015;09;05;Tiistai;2;9;11;0;1;1
109;22.09.2015;2015;09;06;Tiistai;38;12;50;5;1;6
109;22.09.2015;2015;09;07;Tiistai;74;33;107;1;4;5
109;22.09.2015;2015;09;08;Tiistai;65;12;77;1;0;1
109;22.09.2015;2015;09;09;Tiistai;25;13;38;1;2;3
109;22.09.2015;2015;09;10;Tiistai;7;13;20;1;2;3
109;22.09.2015;2015;09;11;Tiistai;7;8;15;3;2;5
109;22.09.2015;2015;09;12;Tiistai;14;9;23;1;2;3
109;22.09.2015;2015;09;13;Tiistai;16;19;35;3;4;7
109;22.09.2015;2015;09;14;Tiistai;21;17;38;1;1;2
109;22.09.2015;2015;09;15;Tiistai;25;54;79;5;2;7
109;22.09.2015;2015;09;16;Tiistai;44;65;109;5;2;7
109;22.09.2015;2015;09;17;Tiistai;21;18;39;4;4;8
109;22.09.2015;2015;09;18;Tiistai;10;15;25;1;0;1
109;22.09.2015;2015;09;19;Tiistai;5;12;17;5;1;6
109;22.09.2015;2015;09;20;Tiistai;4;6;10;2;4;6
109;22.09.2015;2015;09;21;Tiistai;2;8;10;2;1;3
109;22.09.2015;2015;09;22;Tiistai;5;3;8;4;0;4
109;22.09.2015;2015;09;23;Tiistai;3;0;3;1;0;1
109;23.09.2015;2015;09;00;Keskiviikko;2;1;3;1;0;1
109;23.09.2015;2015;09;01;Keskiviikko;0;0;0;0;0;0
109;23.09.2015;2015;09;02;Keskiviikko;0;0;0;0;1;1
109;23.09.2015;2015;09;03;Keskiviikko;0;0;0;0;0;0
109;23.09.2015;2015;09;04;Keskiviikko;2;1;3;0;0;0
109;23.09.2015;2015;09;05;Keskiviikko;2;6;8;1;1;2
109;23.09.2015;2015;09;06;Keskiviikko;29;13;42;4;2;6
109;23.09.2015;2015;09;07;Keskiviikko;82;32;114;3;6;9
109;23.09.2015;2015;09;08;Keskiviikko;67;21;88;3;3;6
109;23.09.2015;2015;09;09;Keskiviikko;34;8;42;3;4;7
109;23.09.2015;2015;09;10;Keskiviikko;10;10;20;2;4;6
109;23.09.2015;2015;09;11;Keskiviikko;19;14;33;3;3;6
109;23.09.2015;2015;09;12;Keskiviikko;15;9;24;4;3;7
109;23.09.2015;2015;09;13;Keskiviikko;14;16;30;3;4;7
109;23.09.2015;2015;09;14;Keskiviikko;13;29;42;2;2;4
109;23.09.2015;2015;09;15;Keskiviikko;24;54;78;6;3;9
109;23.09.2015;2015;09;16;Keskiviikko;36;71;107;3;5;8
109;23.09.2015;2015;09;17;Keskiviikko;21;23;44;5;6;11
109;23.09.2015;2015;09;18;Keskiviikko;10;18;28;11;6;17
109;23.09.2015;2015;09;19;Keskiviikko;9;19;28;8;6;14
109;23.09.2015;2015;09;20;Keskiviikko;8;9;17;4;0;4
109;23.09.2015;2015;09;21;Keskiviikko;3;12;15;1;5;6
109;23.09.2015;2015;09;22;Keskiviikko;3;2;5;0;1;1
109;23.09.2015;2015;09;23;Keskiviikko;1;2;3;0;1;1
109;24.09.2015;2015;09;00;Torstai;2;1;3;0;0;0
109;24.09.2015;2015;09;01;Torstai;0;0;0;0;0;0
109;24.09.2015;2015;09;02;Torstai;0;0;0;0;0;0
109;24.09.2015;2015;09;03;Torstai;0;0;0;0;0;0
109;24.09.2015;2015;09;04;Torstai;1;1;2;0;0;0
109;24.09.2015;2015;09;05;Torstai;0;7;7;1;1;2
109;24.09.2015;2015;09;06;Torstai;35;14;49;4;1;5
109;24.09.2015;2015;09;07;Torstai;83;38;121;5;4;9
109;24.09.2015;2015;09;08;Torstai;77;23;100;4;1;5
109;24.09.2015;2015;09;09;Torstai;17;12;29;6;1;7
109;24.09.2015;2015;09;10;Torstai;7;10;17;3;3;6
109;24.09.2015;2015;09;11;Torstai;14;13;27;0;3;3
109;24.09.2015;2015;09;12;Torstai;20;21;41;2;2;4
109;24.09.2015;2015;09;13;Torstai;11;23;34;2;4;6
109;24.09.2015;2015;09;14;Torstai;24;32;56;9;3;12
109;24.09.2015;2015;09;15;Torstai;30;55;85;4;6;10
109;24.09.2015;2015;09;16;Torstai;50;70;120;4;9;13
109;24.09.2015;2015;09;17;Torstai;23;33;56;9;1;10
109;24.09.2015;2015;09;18;Torstai;17;17;34;4;7;11
109;24.09.2015;2015;09;19;Torstai;11;20;31;5;4;9
109;24.09.2015;2015;09;20;Torstai;6;10;16;5;5;10
109;24.09.2015;2015;09;21;Torstai;0;16;16;3;3;6
109;24.09.2015;2015;09;22;Torstai;8;5;13;0;1;1
109;24.09.2015;2015;09;23;Torstai;1;2;3;0;0;0
109;25.09.2015;2015;09;00;Perjantai;0;0;0;0;0;0
109;25.09.2015;2015;09;01;Perjantai;0;0;0;0;1;1
109;25.09.2015;2015;09;02;Perjantai;1;0;1;0;1;1
109;25.09.2015;2015;09;03;Perjantai;0;3;3;0;0;0
109;25.09.2015;2015;09;04;Perjantai;1;2;3;0;0;0
109;25.09.2015;2015;09;05;Perjantai;3;5;8;0;3;3
109;25.09.2015;2015;09;06;Perjantai;27;15;42;4;2;6
109;25.09.2015;2015;09;07;Perjantai;62;31;93;5;4;9
109;25.09.2015;2015;09;08;Perjantai;63;22;85;2;0;2
109;25.09.2015;2015;09;09;Perjantai;16;8;24;1;1;2
109;25.09.2015;2015;09;10;Perjantai;8;14;22;3;4;7
109;25.09.2015;2015;09;11;Perjantai;14;11;25;6;2;8
109;25.09.2015;2015;09;12;Perjantai;12;11;23;5;1;6
109;25.09.2015;2015;09;13;Perjantai;18;28;46;3;2;5
109;25.09.2015;2015;09;14;Perjantai;24;40;64;4;2;6
109;25.09.2015;2015;09;15;Perjantai;26;50;76;5;3;8
109;25.09.2015;2015;09;16;Perjantai;30;37;67;2;6;8
109;25.09.2015;2015;09;17;Perjantai;19;25;44;5;4;9
109;25.09.2015;2015;09;18;Perjantai;6;13;19;6;2;8
109;25.09.2015;2015;09;19;Perjantai;17;12;29;1;2;3
109;25.09.2015;2015;09;20;Perjantai;12;3;15;6;2;8
109;25.09.2015;2015;09;21;Perjantai;6;12;18;1;2;3
109;25.09.2015;2015;09;22;Perjantai;10;5;15;1;2;3
109;25.09.2015;2015;09;23;Perjantai;4;1;5;0;0;0
109;26.09.2015;2015;09;00;Lauantai;2;2;4;0;0;0
109;26.09.2015;2015;09;01;Lauantai;2;1;3;2;0;2
109;26.09.2015;2015;09;02;Lauantai;0;1;1;0;0;0
109;26.09.2015;2015;09;03;Lauantai;1;2;3;0;1;1
109;26.09.2015;2015;09;04;Lauantai;3;1;4;0;0;0
109;26.09.2015;2015;09;05;Lauantai;1;4;5;0;2;2
109;26.09.2015;2015;09;06;Lauantai;6;2;8;1;0;1
109;26.09.2015;2015;09;07;Lauantai;3;2;5;2;2;4
109;26.09.2015;2015;09;08;Lauantai;8;1;9;1;4;5
109;26.09.2015;2015;09;09;Lauantai;8;7;15;6;5;11
109;26.09.2015;2015;09;10;Lauantai;9;3;12;2;3;5
109;26.09.2015;2015;09;11;Lauantai;9;14;23;3;2;5
109;26.09.2015;2015;09;12;Lauantai;13;13;26;5;2;7
109;26.09.2015;2015;09;13;Lauantai;17;7;24;7;4;11
109;26.09.2015;2015;09;14;Lauantai;18;14;32;7;5;12
109;26.09.2015;2015;09;15;Lauantai;7;12;19;2;3;5
109;26.09.2015;2015;09;16;Lauantai;8;17;25;7;1;8
109;26.09.2015;2015;09;17;Lauantai;18;11;29;4;6;10
109;26.09.2015;2015;09;18;Lauantai;11;12;23;13;3;16
109;26.09.2015;2015;09;19;Lauantai;15;7;22;4;2;6
109;26.09.2015;2015;09;20;Lauantai;10;12;22;5;4;9
109;26.09.2015;2015;09;21;Lauantai;6;8;14;3;2;5
109;26.09.2015;2015;09;22;Lauantai;3;4;7;0;0;0
109;26.09.2015;2015;09;23;Lauantai;1;3;4;1;0;1
109;27.09.2015;2015;09;00;Sunnuntai;1;1;2;1;1;2
109;27.09.2015;2015;09;01;Sunnuntai;0;1;1;0;0;0
109;27.09.2015;2015;09;02;Sunnuntai;0;6;6;0;0;0
109;27.09.2015;2015;09;03;Sunnuntai;0;1;1;0;1;1
109;27.09.2015;2015;09;04;Sunnuntai;2;1;3;0;1;1
109;27.09.2015;2015;09;05;Sunnuntai;1;2;3;0;0;0
109;27.09.2015;2015;09;06;Sunnuntai;6;1;7;0;0;0
109;27.09.2015;2015;09;07;Sunnuntai;2;4;6;4;1;5
109;27.09.2015;2015;09;08;Sunnuntai;3;0;3;1;3;4
109;27.09.2015;2015;09;09;Sunnuntai;3;3;6;3;7;10
109;27.09.2015;2015;09;10;Sunnuntai;5;2;7;6;1;7
109;27.09.2015;2015;09;11;Sunnuntai;15;5;20;9;3;12
109;27.09.2015;2015;09;12;Sunnuntai;14;4;18;7;5;12
109;27.09.2015;2015;09;13;Sunnuntai;12;10;22;3;2;5
109;27.09.2015;2015;09;14;Sunnuntai;12;11;23;2;3;5
109;27.09.2015;2015;09;15;Sunnuntai;10;10;20;9;4;13
109;27.09.2015;2015;09;16;Sunnuntai;10;11;21;5;5;10
109;27.09.2015;2015;09;17;Sunnuntai;8;7;15;6;6;12
109;27.09.2015;2015;09;18;Sunnuntai;8;16;24;8;6;14
109;27.09.2015;2015;09;19;Sunnuntai;5;9;14;8;3;11
109;27.09.2015;2015;09;20;Sunnuntai;7;8;15;2;2;4
109;27.09.2015;2015;09;21;Sunnuntai;3;6;9;2;2;4
109;27.09.2015;2015;09;22;Sunnuntai;1;3;4;0;1;1
109;27.09.2015;2015;09;23;Sunnuntai;0;0;0;0;0;0
109;28.09.2015;2015;09;00;Maanantai;0;0;0;2;0;2
109;28.09.2015;2015;09;01;Maanantai;0;0;0;0;1;1
109;28.09.2015;2015;09;02;Maanantai;1;0;1;0;1;1
109;28.09.2015;2015;09;03;Maanantai;0;1;1;0;0;0
109;28.09.2015;2015;09;04;Maanantai;1;1;2;0;0;0
109;28.09.2015;2015;09;05;Maanantai;0;8;8;2;0;2
109;28.09.2015;2015;09;06;Maanantai;33;11;44;6;3;9
109;28.09.2015;2015;09;07;Maanantai;86;45;131;7;6;13
109;28.09.2015;2015;09;08;Maanantai;83;20;103;4;1;5
109;28.09.2015;2015;09;09;Maanantai;26;15;41;3;3;6
109;28.09.2015;2015;09;10;Maanantai;11;5;16;7;0;7
109;28.09.2015;2015;09;11;Maanantai;23;9;32;3;2;5
109;28.09.2015;2015;09;12;Maanantai;9;24;33;3;2;5
109;28.09.2015;2015;09;13;Maanantai;16;21;37;1;4;5
109;28.09.2015;2015;09;14;Maanantai;24;35;59;2;6;8
109;28.09.2015;2015;09;15;Maanantai;31;64;95;6;6;12
109;28.09.2015;2015;09;16;Maanantai;53;87;140;4;6;10
109;28.09.2015;2015;09;17;Maanantai;26;38;64;9;5;14
109;28.09.2015;2015;09;18;Maanantai;15;24;39;9;6;15
109;28.09.2015;2015;09;19;Maanantai;11;11;22;4;4;8
109;28.09.2015;2015;09;20;Maanantai;8;13;21;8;5;13
109;28.09.2015;2015;09;21;Maanantai;7;6;13;4;2;6
109;28.09.2015;2015;09;22;Maanantai;8;1;9;3;2;5
109;28.09.2015;2015;09;23;Maanantai;2;0;2;0;0;0
109;29.09.2015;2015;09;00;Tiistai;1;1;2;0;0;0
109;29.09.2015;2015;09;01;Tiistai;0;0;0;0;1;1
109;29.09.2015;2015;09;02;Tiistai;0;1;1;0;0;0
109;29.09.2015;2015;09;03;Tiistai;0;0;0;0;0;0
109;29.09.2015;2015;09;04;Tiistai;0;0;0;0;0;0
109;29.09.2015;2015;09;05;Tiistai;0;9;9;2;1;3
109;29.09.2015;2015;09;06;Tiistai;39;11;50;3;3;6
109;29.09.2015;2015;09;07;Tiistai;78;40;118;2;4;6
109;29.09.2015;2015;09;08;Tiistai;93;23;116;3;2;5
109;29.09.2015;2015;09;09;Tiistai;18;15;33;6;4;10
109;29.09.2015;2015;09;10;Tiistai;14;10;24;3;2;5
109;29.09.2015;2015;09;11;Tiistai;13;16;29;4;3;7
109;29.09.2015;2015;09;12;Tiistai;22;11;33;4;1;5
109;29.09.2015;2015;09;13;Tiistai;14;24;38;6;7;13
109;29.09.2015;2015;09;14;Tiistai;17;29;46;5;3;8
109;29.09.2015;2015;09;15;Tiistai;35;64;99;6;4;10
109;29.09.2015;2015;09;16;Tiistai;46;91;137;4;3;7
109;29.09.2015;2015;09;17;Tiistai;23;37;60;8;2;10
109;29.09.2015;2015;09;18;Tiistai;17;20;37;9;5;14
109;29.09.2015;2015;09;19;Tiistai;11;13;24;6;8;14
109;29.09.2015;2015;09;20;Tiistai;14;13;27;5;3;8
109;29.09.2015;2015;09;21;Tiistai;4;15;19;4;5;9
109;29.09.2015;2015;09;22;Tiistai;5;3;8;2;1;3
109;29.09.2015;2015;09;23;Tiistai;4;4;8;0;0;0
109;30.09.2015;2015;09;00;Keskiviikko;0;2;2;2;0;2
109;30.09.2015;2015;09;01;Keskiviikko;0;0;0;0;1;1
109;30.09.2015;2015;09;02;Keskiviikko;0;1;1;0;1;1
109;30.09.2015;2015;09;03;Keskiviikko;2;0;2;0;0;0
109;30.09.2015;2015;09;04;Keskiviikko;0;1;1;0;0;0
109;30.09.2015;2015;09;05;Keskiviikko;0;9;9;0;2;2
109;30.09.2015;2015;09;06;Keskiviikko;34;12;46;3;2;5
109;30.09.2015;2015;09;07;Keskiviikko;85;41;126;5;1;6
109;30.09.2015;2015;09;08;Keskiviikko;78;24;102;4;5;9
109;30.09.2015;2015;09;09;Keskiviikko;26;10;36;6;2;8
109;30.09.2015;2015;09;10;Keskiviikko;5;8;13;4;2;6
109;30.09.2015;2015;09;11;Keskiviikko;17;16;33;3;2;5
109;30.09.2015;2015;09;12;Keskiviikko;21;8;29;2;2;4
109;30.09.2015;2015;09;13;Keskiviikko;17;25;42;2;5;7
109;30.09.2015;2015;09;14;Keskiviikko;21;27;48;2;5;7
109;30.09.2015;2015;09;15;Keskiviikko;35;67;102;4;4;8
109;30.09.2015;2015;09;16;Keskiviikko;49;92;141;7;6;13
109;30.09.2015;2015;09;17;Keskiviikko;26;34;60;6;2;8
109;30.09.2015;2015;09;18;Keskiviikko;15;26;41;8;5;13
109;30.09.2015;2015;09;19;Keskiviikko;9;27;36;5;6;11
109;30.09.2015;2015;09;20;Keskiviikko;14;10;24;6;5;11
109;30.09.2015;2015;09;21;Keskiviikko;6;13;19;2;0;2
109;30.09.2015;2015;09;22;Keskiviikko;8;6;14;2;2;4
109;30.09.2015;2015;09;23;Keskiviikko;1;2;3;0;0;0
109;01.10.2015;2015;10;00;Torstai;1;2;3;2;0;2
109;01.10.2015;2015;10;01;Torstai;1;0;1;0;0;0
109;01.10.2015;2015;10;02;Torstai;0;0;0;0;0;0
109;01.10.2015;2015;10;03;Torstai;0;1;1;0;0;0
109;01.10.2015;2015;10;04;Torstai;1;0;1;0;0;0
109;01.10.2015;2015;10;05;Torstai;2;5;7;3;3;6
109;01.10.2015;2015;10;06;Torstai;30;11;41;4;1;5
109;01.10.2015;2015;10;07;Torstai;75;34;109;5;3;8
109;01.10.2015;2015;10;08;Torstai;85;21;106;3;2;5
109;01.10.2015;2015;10;09;Torstai;22;11;33;3;3;6
109;01.10.2015;2015;10;10;Torstai;14;8;22;7;3;10
109;01.10.2015;2015;10;11;Torstai;21;10;31;5;3;8
109;01.10.2015;2015;10;12;Torstai;15;16;31;5;12;17
109;01.10.2015;2015;10;13;Torstai;16;21;37;3;1;4
109;01.10.2015;2015;10;14;Torstai;20;29;49;0;1;1
109;01.10.2015;2015;10;15;Torstai;31;61;92;6;6;12
109;01.10.2015;2015;10;16;Torstai;44;76;120;12;3;15
109;01.10.2015;2015;10;17;Torstai;26;35;61;3;3;6
109;01.10.2015;2015;10;18;Torstai;23;19;42;9;4;13
109;01.10.2015;2015;10;19;Torstai;7;11;18;5;3;8
109;01.10.2015;2015;10;20;Torstai;7;15;22;1;5;6
109;01.10.2015;2015;10;21;Torstai;3;14;17;3;2;5
109;01.10.2015;2015;10;22;Torstai;7;6;13;2;0;2
109;01.10.2015;2015;10;23;Torstai;0;0;0;3;0;3
109;02.10.2015;2015;10;00;Perjantai;2;0;2;0;0;0
109;02.10.2015;2015;10;01;Perjantai;0;2;2;0;1;1
109;02.10.2015;2015;10;02;Perjantai;1;0;1;0;0;0
109;02.10.2015;2015;10;03;Perjantai;0;0;0;0;0;0
109;02.10.2015;2015;10;04;Perjantai;0;0;0;0;0;0
109;02.10.2015;2015;10;05;Perjantai;1;7;8;1;1;2
109;02.10.2015;2015;10;06;Perjantai;16;12;28;1;2;3
109;02.10.2015;2015;10;07;Perjantai;28;21;49;2;3;5
109;02.10.2015;2015;10;08;Perjantai;33;12;45;5;1;6
109;02.10.2015;2015;10;09;Perjantai;15;8;23;0;2;2
109;02.10.2015;2015;10;10;Perjantai;10;5;15;2;0;2
109;02.10.2015;2015;10;11;Perjantai;11;6;17;4;1;5
109;02.10.2015;2015;10;12;Perjantai;7;7;14;2;1;3
109;02.10.2015;2015;10;13;Perjantai;14;16;30;4;3;7
109;02.10.2015;2015;10;14;Perjantai;10;19;29;8;2;10
109;02.10.2015;2015;10;15;Perjantai;20;31;51;5;3;8
109;02.10.2015;2015;10;16;Perjantai;12;23;35;1;3;4
109;02.10.2015;2015;10;17;Perjantai;9;8;17;3;4;7
109;02.10.2015;2015;10;18;Perjantai;4;7;11;2;2;4
109;02.10.2015;2015;10;19;Perjantai;4;11;15;0;2;2
109;02.10.2015;2015;10;20;Perjantai;3;3;6;2;2;4
109;02.10.2015;2015;10;21;Perjantai;3;7;10;2;3;5
109;02.10.2015;2015;10;22;Perjantai;3;3;6;2;1;3
109;02.10.2015;2015;10;23;Perjantai;1;3;4;0;0;0
109;03.10.2015;2015;10;00;Lauantai;3;1;4;0;3;3
109;03.10.2015;2015;10;01;Lauantai;2;0;2;0;1;1
109;03.10.2015;2015;10;02;Lauantai;0;2;2;0;2;2
109;03.10.2015;2015;10;03;Lauantai;0;0;0;0;1;1
109;03.10.2015;2015;10;04;Lauantai;1;2;3;0;0;0
109;03.10.2015;2015;10;05;Lauantai;0;1;1;0;1;1
109;03.10.2015;2015;10;06;Lauantai;4;0;4;1;0;1
109;03.10.2015;2015;10;07;Lauantai;1;2;3;4;2;6
109;03.10.2015;2015;10;08;Lauantai;6;2;8;4;2;6
109;03.10.2015;2015;10;09;Lauantai;6;1;7;4;3;7
109;03.10.2015;2015;10;10;Lauantai;9;6;15;7;5;12
109;03.10.2015;2015;10;11;Lauantai;7;13;20;4;2;6
109;03.10.2015;2015;10;12;Lauantai;14;15;29;5;1;6
109;03.10.2015;2015;10;13;Lauantai;9;6;15;3;5;8
109;03.10.2015;2015;10;14;Lauantai;14;13;27;3;4;7
109;03.10.2015;2015;10;15;Lauantai;12;7;19;9;3;12
109;03.10.2015;2015;10;16;Lauantai;14;13;27;5;4;9
109;03.10.2015;2015;10;17;Lauantai;14;14;28;6;6;12
109;03.10.2015;2015;10;18;Lauantai;11;7;18;5;3;8
109;03.10.2015;2015;10;19;Lauantai;9;5;14;2;2;4
109;03.10.2015;2015;10;20;Lauantai;8;4;12;2;3;5
109;03.10.2015;2015;10;21;Lauantai;1;3;4;1;3;4
109;03.10.2015;2015;10;22;Lauantai;3;7;10;2;0;2
109;03.10.2015;2015;10;23;Lauantai;1;6;7;0;2;2
109;04.10.2015;2015;10;00;Sunnuntai;1;3;4;0;1;1
109;04.10.2015;2015;10;01;Sunnuntai;3;1;4;0;0;0
109;04.10.2015;2015;10;02;Sunnuntai;0;1;1;0;1;1
109;04.10.2015;2015;10;03;Sunnuntai;1;0;1;0;0;0
109;04.10.2015;2015;10;04;Sunnuntai;0;1;1;0;0;0
109;04.10.2015;2015;10;05;Sunnuntai;0;0;0;0;1;1
109;04.10.2015;2015;10;06;Sunnuntai;1;0;1;0;0;0
109;04.10.2015;2015;10;07;Sunnuntai;1;2;3;3;2;5
109;04.10.2015;2015;10;08;Sunnuntai;5;2;7;2;3;5
109;04.10.2015;2015;10;09;Sunnuntai;5;3;8;5;2;7
109;04.10.2015;2015;10;10;Sunnuntai;3;4;7;10;9;19
109;04.10.2015;2015;10;11;Sunnuntai;5;4;9;3;2;5
109;04.10.2015;2015;10;12;Sunnuntai;16;8;24;5;5;10
109;04.10.2015;2015;10;13;Sunnuntai;4;10;14;7;5;12
109;04.10.2015;2015;10;14;Sunnuntai;18;6;24;3;4;7
109;04.10.2015;2015;10;15;Sunnuntai;16;5;21;3;8;11
109;04.10.2015;2015;10;16;Sunnuntai;8;12;20;2;5;7
109;04.10.2015;2015;10;17;Sunnuntai;18;3;21;3;2;5
109;04.10.2015;2015;10;18;Sunnuntai;4;10;14;7;3;10
109;04.10.2015;2015;10;19;Sunnuntai;7;4;11;5;1;6
109;04.10.2015;2015;10;20;Sunnuntai;4;5;9;3;2;5
109;04.10.2015;2015;10;21;Sunnuntai;0;9;9;0;1;1
109;04.10.2015;2015;10;22;Sunnuntai;3;1;4;3;0;3
109;04.10.2015;2015;10;23;Sunnuntai;0;1;1;0;0;0
109;05.10.2015;2015;10;00;Maanantai;0;1;1;0;0;0
109;05.10.2015;2015;10;01;Maanantai;1;2;3;0;0;0
109;05.10.2015;2015;10;02;Maanantai;0;1;1;0;0;0
109;05.10.2015;2015;10;03;Maanantai;0;0;0;0;0;0
109;05.10.2015;2015;10;04;Maanantai;1;2;3;0;0;0
109;05.10.2015;2015;10;05;Maanantai;2;5;7;2;2;4
109;05.10.2015;2015;10;06;Maanantai;32;11;43;4;2;6
109;05.10.2015;2015;10;07;Maanantai;68;39;107;6;2;8
109;05.10.2015;2015;10;08;Maanantai;78;25;103;9;1;10
109;05.10.2015;2015;10;09;Maanantai;25;5;30;5;6;11
109;05.10.2015;2015;10;10;Maanantai;16;8;24;5;2;7
109;05.10.2015;2015;10;11;Maanantai;14;25;39;4;1;5
109;05.10.2015;2015;10;12;Maanantai;19;12;31;2;5;7
109;05.10.2015;2015;10;13;Maanantai;11;18;29;1;2;3
109;05.10.2015;2015;10;14;Maanantai;10;18;28;3;3;6
109;05.10.2015;2015;10;15;Maanantai;24;65;89;2;4;6
109;05.10.2015;2015;10;16;Maanantai;53;84;137;4;5;9
109;05.10.2015;2015;10;17;Maanantai;22;28;50;4;2;6
109;05.10.2015;2015;10;18;Maanantai;13;18;31;7;10;17
109;05.10.2015;2015;10;19;Maanantai;7;6;13;5;7;12
109;05.10.2015;2015;10;20;Maanantai;10;12;22;2;6;8
109;05.10.2015;2015;10;21;Maanantai;0;8;8;4;3;7
109;05.10.2015;2015;10;22;Maanantai;6;7;13;1;0;1
109;05.10.2015;2015;10;23;Maanantai;3;0;3;0;0;0
109;06.10.2015;2015;10;00;Tiistai;3;1;4;0;1;1
109;06.10.2015;2015;10;01;Tiistai;2;0;2;0;0;0
109;06.10.2015;2015;10;02;Tiistai;0;0;0;0;0;0
109;06.10.2015;2015;10;03;Tiistai;0;0;0;0;0;0
109;06.10.2015;2015;10;04;Tiistai;2;0;2;0;0;0
109;06.10.2015;2015;10;05;Tiistai;2;6;8;2;2;4
109;06.10.2015;2015;10;06;Tiistai;32;12;44;4;1;5
109;06.10.2015;2015;10;07;Tiistai;69;46;115;8;9;17
109;06.10.2015;2015;10;08;Tiistai;76;30;106;1;0;1
109;06.10.2015;2015;10;09;Tiistai;20;6;26;1;4;5
109;06.10.2015;2015;10;10;Tiistai;11;11;22;4;2;6
109;06.10.2015;2015;10;11;Tiistai;12;9;21;5;1;6
109;06.10.2015;2015;10;12;Tiistai;18;6;24;1;2;3
109;06.10.2015;2015;10;13;Tiistai;18;21;39;4;3;7
109;06.10.2015;2015;10;14;Tiistai;12;26;38;4;4;8
109;06.10.2015;2015;10;15;Tiistai;30;58;88;7;2;9
109;06.10.2015;2015;10;16;Tiistai;44;80;124;7;3;10
109;06.10.2015;2015;10;17;Tiistai;19;34;53;3;1;4
109;06.10.2015;2015;10;18;Tiistai;16;18;34;6;7;13
109;06.10.2015;2015;10;19;Tiistai;12;17;29;5;3;8
109;06.10.2015;2015;10;20;Tiistai;7;14;21;5;3;8
109;06.10.2015;2015;10;21;Tiistai;1;13;14;3;1;4
109;06.10.2015;2015;10;22;Tiistai;4;4;8;0;0;0
109;06.10.2015;2015;10;23;Tiistai;3;0;3;0;0;0
109;07.10.2015;2015;10;00;Keskiviikko;2;2;4;0;0;0
109;07.10.2015;2015;10;01;Keskiviikko;0;1;1;0;1;1
109;07.10.2015;2015;10;02;Keskiviikko;0;0;0;0;0;0
109;07.10.2015;2015;10;03;Keskiviikko;0;0;0;0;0;0
109;07.10.2015;2015;10;04;Keskiviikko;2;0;2;0;1;1
109;07.10.2015;2015;10;05;Keskiviikko;3;9;12;3;2;5
109;07.10.2015;2015;10;06;Keskiviikko;28;12;40;1;3;4
109;07.10.2015;2015;10;07;Keskiviikko;68;30;98;7;5;12
109;07.10.2015;2015;10;08;Keskiviikko;66;21;87;1;1;2
109;07.10.2015;2015;10;09;Keskiviikko;19;8;27;3;2;5
109;07.10.2015;2015;10;10;Keskiviikko;16;10;26;2;0;2
109;07.10.2015;2015;10;11;Keskiviikko;12;15;27;6;1;7
109;07.10.2015;2015;10;12;Keskiviikko;21;9;30;6;1;7
109;07.10.2015;2015;10;13;Keskiviikko;17;21;38;3;5;8
109;07.10.2015;2015;10;14;Keskiviikko;10;33;43;4;3;7
109;07.10.2015;2015;10;15;Keskiviikko;27;52;79;6;6;12
109;07.10.2015;2015;10;16;Keskiviikko;46;69;115;4;4;8
109;07.10.2015;2015;10;17;Keskiviikko;21;35;56;7;5;12
109;07.10.2015;2015;10;18;Keskiviikko;21;24;45;4;3;7
109;07.10.2015;2015;10;19;Keskiviikko;7;14;21;4;1;5
109;07.10.2015;2015;10;20;Keskiviikko;4;11;15;7;6;13
109;07.10.2015;2015;10;21;Keskiviikko;4;12;16;1;0;1
109;07.10.2015;2015;10;22;Keskiviikko;6;5;11;2;4;6
109;07.10.2015;2015;10;23;Keskiviikko;6;0;6;0;0;0
109;08.10.2015;2015;10;00;Torstai;2;0;2;0;1;1
109;08.10.2015;2015;10;01;Torstai;0;1;1;0;0;0
109;08.10.2015;2015;10;02;Torstai;1;0;1;0;0;0
109;08.10.2015;2015;10;03;Torstai;0;0;0;0;0;0
109;08.10.2015;2015;10;04;Torstai;1;0;1;0;0;0
109;08.10.2015;2015;10;05;Torstai;1;9;10;1;2;3
109;08.10.2015;2015;10;06;Torstai;30;10;40;3;4;7
109;08.10.2015;2015;10;07;Torstai;66;32;98;5;5;10
109;08.10.2015;2015;10;08;Torstai;79;23;102;6;1;7
109;08.10.2015;2015;10;09;Torstai;11;11;22;3;1;4
109;08.10.2015;2015;10;10;Torstai;10;12;22;4;1;5
109;08.10.2015;2015;10;11;Torstai;19;9;28;0;2;2
109;08.10.2015;2015;10;12;Torstai;14;16;30;2;2;4
109;08.10.2015;2015;10;13;Torstai;5;23;28;3;5;8
109;08.10.2015;2015;10;14;Torstai;17;26;43;2;4;6
109;08.10.2015;2015;10;15;Torstai;23;51;74;7;3;10
109;08.10.2015;2015;10;16;Torstai;48;75;123;12;5;17
109;08.10.2015;2015;10;17;Torstai;25;28;53;1;2;3
109;08.10.2015;2015;10;18;Torstai;15;16;31;5;6;11
109;08.10.2015;2015;10;19;Torstai;10;13;23;3;3;6
109;08.10.2015;2015;10;20;Torstai;7;17;24;4;1;5
109;08.10.2015;2015;10;21;Torstai;4;15;19;4;4;8
109;08.10.2015;2015;10;22;Torstai;4;2;6;1;0;1
109;08.10.2015;2015;10;23;Torstai;1;0;1;0;0;0
109;09.10.2015;2015;10;00;Perjantai;1;0;1;1;0;1
109;09.10.2015;2015;10;01;Perjantai;1;0;1;0;0;0
109;09.10.2015;2015;10;02;Perjantai;1;0;1;0;0;0
109;09.10.2015;2015;10;03;Perjantai;0;0;0;0;0;0
109;09.10.2015;2015;10;04;Perjantai;1;0;1;0;0;0
109;09.10.2015;2015;10;05;Perjantai;1;11;12;0;0;0
109;09.10.2015;2015;10;06;Perjantai;36;10;46;1;3;4
109;09.10.2015;2015;10;07;Perjantai;58;25;83;4;6;10
109;09.10.2015;2015;10;08;Perjantai;47;22;69;3;1;4
109;09.10.2015;2015;10;09;Perjantai;26;7;33;2;2;4
109;09.10.2015;2015;10;10;Perjantai;11;2;13;4;4;8
109;09.10.2015;2015;10;11;Perjantai;12;11;23;4;2;6
109;09.10.2015;2015;10;12;Perjantai;14;11;25;5;8;13
109;09.10.2015;2015;10;13;Perjantai;17;22;39;3;2;5
109;09.10.2015;2015;10;14;Perjantai;14;33;47;14;4;18
109;09.10.2015;2015;10;15;Perjantai;23;41;64;3;4;7
109;09.10.2015;2015;10;16;Perjantai;26;45;71;4;2;6
109;09.10.2015;2015;10;17;Perjantai;22;16;38;3;2;5
109;09.10.2015;2015;10;18;Perjantai;8;12;20;6;1;7
109;09.10.2015;2015;10;19;Perjantai;10;11;21;5;3;8
109;09.10.2015;2015;10;20;Perjantai;4;5;9;2;1;3
109;09.10.2015;2015;10;21;Perjantai;2;7;9;4;0;4
109;09.10.2015;2015;10;22;Perjantai;5;5;10;3;1;4
109;09.10.2015;2015;10;23;Perjantai;3;0;3;0;3;3
109;10.10.2015;2015;10;00;Lauantai;2;2;4;0;1;1
109;10.10.2015;2015;10;01;Lauantai;0;2;2;0;0;0
109;10.10.2015;2015;10;02;Lauantai;1;0;1;0;0;0
109;10.10.2015;2015;10;03;Lauantai;0;0;0;0;0;0
109;10.10.2015;2015;10;04;Lauantai;1;1;2;0;0;0
109;10.10.2015;2015;10;05;Lauantai;0;0;0;0;0;0
109;10.10.2015;2015;10;06;Lauantai;3;5;8;0;0;0
109;10.10.2015;2015;10;07;Lauantai;4;0;4;2;2;4
109;10.10.2015;2015;10;08;Lauantai;4;1;5;5;1;6
109;10.10.2015;2015;10;09;Lauantai;8;3;11;2;2;4
109;10.10.2015;2015;10;10;Lauantai;7;6;13;1;4;5
109;10.10.2015;2015;10;11;Lauantai;9;9;18;3;2;5
109;10.10.2015;2015;10;12;Lauantai;5;10;15;2;0;2
109;10.10.2015;2015;10;13;Lauantai;5;5;10;2;1;3
109;10.10.2015;2015;10;14;Lauantai;13;9;22;3;3;6
109;10.10.2015;2015;10;15;Lauantai;8;9;17;3;3;6
109;10.10.2015;2015;10;16;Lauantai;15;14;29;3;4;7
109;10.10.2015;2015;10;17;Lauantai;7;12;19;2;5;7
109;10.10.2015;2015;10;18;Lauantai;8;8;16;7;3;10
109;10.10.2015;2015;10;19;Lauantai;11;5;16;5;6;11
109;10.10.2015;2015;10;20;Lauantai;1;2;3;5;2;7
109;10.10.2015;2015;10;21;Lauantai;2;4;6;2;2;4
109;10.10.2015;2015;10;22;Lauantai;1;0;1;1;0;1
109;10.10.2015;2015;10;23;Lauantai;3;1;4;0;1;1
109;11.10.2015;2015;10;00;Sunnuntai;1;3;4;0;0;0
109;11.10.2015;2015;10;01;Sunnuntai;2;0;2;0;0;0
109;11.10.2015;2015;10;02;Sunnuntai;0;4;4;1;0;1
109;11.10.2015;2015;10;03;Sunnuntai;0;5;5;0;0;0
109;11.10.2015;2015;10;04;Sunnuntai;1;0;1;0;0;0
109;11.10.2015;2015;10;05;Sunnuntai;0;3;3;0;0;0
109;11.10.2015;2015;10;06;Sunnuntai;4;0;4;0;0;0
109;11.10.2015;2015;10;07;Sunnuntai;2;1;3;0;2;2
109;11.10.2015;2015;10;08;Sunnuntai;2;0;2;5;3;8
109;11.10.2015;2015;10;09;Sunnuntai;0;1;1;3;3;6
109;11.10.2015;2015;10;10;Sunnuntai;4;5;9;7;3;10
109;11.10.2015;2015;10;11;Sunnuntai;9;10;19;6;5;11
109;11.10.2015;2015;10;12;Sunnuntai;17;10;27;3;4;7
109;11.10.2015;2015;10;13;Sunnuntai;15;11;26;8;4;12
109;11.10.2015;2015;10;14;Sunnuntai;18;13;31;6;7;13
109;11.10.2015;2015;10;15;Sunnuntai;14;6;20;7;1;8
109;11.10.2015;2015;10;16;Sunnuntai;9;12;21;6;3;9
109;11.10.2015;2015;10;17;Sunnuntai;6;10;16;8;7;15
109;11.10.2015;2015;10;18;Sunnuntai;10;7;17;5;3;8
109;11.10.2015;2015;10;19;Sunnuntai;5;2;7;4;2;6
109;11.10.2015;2015;10;20;Sunnuntai;0;12;12;2;6;8
109;11.10.2015;2015;10;21;Sunnuntai;4;7;11;2;4;6
109;11.10.2015;2015;10;22;Sunnuntai;1;1;2;1;0;1
109;11.10.2015;2015;10;23;Sunnuntai;3;2;5;2;0;2
109;12.10.2015;2015;10;00;Maanantai;0;0;0;1;1;2
109;12.10.2015;2015;10;01;Maanantai;0;0;0;0;1;1
109;12.10.2015;2015;10;02;Maanantai;0;0;0;0;0;0
109;12.10.2015;2015;10;03;Maanantai;0;0;0;0;1;1
109;12.10.2015;2015;10;04;Maanantai;0;0;0;0;0;0
109;12.10.2015;2015;10;05;Maanantai;2;8;10;1;1;2
109;12.10.2015;2015;10;06;Maanantai;35;10;45;1;2;3
109;12.10.2015;2015;10;07;Maanantai;81;34;115;10;4;14
109;12.10.2015;2015;10;08;Maanantai;76;25;101;6;0;6
109;12.10.2015;2015;10;09;Maanantai;14;7;21;2;1;3
109;12.10.2015;2015;10;10;Maanantai;20;10;30;5;3;8
109;12.10.2015;2015;10;11;Maanantai;28;9;37;0;4;4
109;12.10.2015;2015;10;12;Maanantai;15;11;26;8;3;11
109;12.10.2015;2015;10;13;Maanantai;7;19;26;5;5;10
109;12.10.2015;2015;10;14;Maanantai;25;37;62;2;7;9
109;12.10.2015;2015;10;15;Maanantai;22;69;91;9;5;14
109;12.10.2015;2015;10;16;Maanantai;37;94;131;6;5;11
109;12.10.2015;2015;10;17;Maanantai;26;32;58;2;2;4
109;12.10.2015;2015;10;18;Maanantai;21;20;41;9;3;12
109;12.10.2015;2015;10;19;Maanantai;18;13;31;10;11;21
109;12.10.2015;2015;10;20;Maanantai;3;11;14;4;2;6
109;12.10.2015;2015;10;21;Maanantai;3;12;15;3;2;5
109;12.10.2015;2015;10;22;Maanantai;6;3;9;2;0;2
109;12.10.2015;2015;10;23;Maanantai;1;1;2;0;0;0
109;13.10.2015;2015;10;00;Tiistai;1;2;3;1;1;2
109;13.10.2015;2015;10;01;Tiistai;0;0;0;0;1;1
109;13.10.2015;2015;10;02;Tiistai;0;0;0;0;0;0
109;13.10.2015;2015;10;03;Tiistai;0;0;0;0;0;0
109;13.10.2015;2015;10;04;Tiistai;0;0;0;0;0;0
109;13.10.2015;2015;10;05;Tiistai;1;6;7;3;1;4
109;13.10.2015;2015;10;06;Tiistai;43;13;56;5;5;10
109;13.10.2015;2015;10;07;Tiistai;78;41;119;6;4;10
109;13.10.2015;2015;10;08;Tiistai;65;28;93;5;2;7
109;13.10.2015;2015;10;09;Tiistai;23;12;35;4;3;7
109;13.10.2015;2015;10;10;Tiistai;10;11;21;5;4;9
109;13.10.2015;2015;10;11;Tiistai;17;14;31;1;4;5
109;13.10.2015;2015;10;12;Tiistai;18;8;26;3;1;4
109;13.10.2015;2015;10;13;Tiistai;15;19;34;6;4;10
109;13.10.2015;2015;10;14;Tiistai;18;37;55;6;4;10
109;13.10.2015;2015;10;15;Tiistai;23;56;79;7;5;12
109;13.10.2015;2015;10;16;Tiistai;45;89;134;8;4;12
109;13.10.2015;2015;10;17;Tiistai;26;39;65;6;4;10
109;13.10.2015;2015;10;18;Tiistai;13;20;33;13;14;27
109;13.10.2015;2015;10;19;Tiistai;14;12;26;5;5;10
109;13.10.2015;2015;10;20;Tiistai;7;7;14;3;6;9
109;13.10.2015;2015;10;21;Tiistai;1;9;10;5;3;8
109;13.10.2015;2015;10;22;Tiistai;11;5;16;1;0;1
109;13.10.2015;2015;10;23;Tiistai;0;1;1;0;0;0
109;14.10.2015;2015;10;00;Keskiviikko;1;1;2;0;1;1
109;14.10.2015;2015;10;01;Keskiviikko;0;0;0;0;0;0
109;14.10.2015;2015;10;02;Keskiviikko;0;1;1;0;0;0
109;14.10.2015;2015;10;03;Keskiviikko;0;0;0;0;0;0
109;14.10.2015;2015;10;04;Keskiviikko;0;0;0;0;0;0
109;14.10.2015;2015;10;05;Keskiviikko;1;7;8;1;2;3
109;14.10.2015;2015;10;06;Keskiviikko;26;10;36;5;2;7
109;14.10.2015;2015;10;07;Keskiviikko;69;40;109;8;4;12
109;14.10.2015;2015;10;08;Keskiviikko;64;20;84;2;1;3
109;14.10.2015;2015;10;09;Keskiviikko;15;6;21;3;0;3
109;14.10.2015;2015;10;10;Keskiviikko;15;6;21;0;2;2
109;14.10.2015;2015;10;11;Keskiviikko;18;10;28;2;1;3
109;14.10.2015;2015;10;12;Keskiviikko;12;13;25;0;2;2
109;14.10.2015;2015;10;13;Keskiviikko;17;15;32;3;4;7
109;14.10.2015;2015;10;14;Keskiviikko;14;26;40;4;3;7
109;14.10.2015;2015;10;15;Keskiviikko;28;44;72;9;8;17
109;14.10.2015;2015;10;16;Keskiviikko;43;86;129;5;7;12
109;14.10.2015;2015;10;17;Keskiviikko;21;25;46;5;4;9
109;14.10.2015;2015;10;18;Keskiviikko;17;18;35;7;3;10
109;14.10.2015;2015;10;19;Keskiviikko;13;11;24;7;2;9
109;14.10.2015;2015;10;20;Keskiviikko;8;16;24;2;1;3
109;14.10.2015;2015;10;21;Keskiviikko;4;9;13;1;3;4
109;14.10.2015;2015;10;22;Keskiviikko;6;6;12;4;0;4
109;14.10.2015;2015;10;23;Keskiviikko;0;3;3;0;0;0
109;15.10.2015;2015;10;00;Torstai;1;0;1;0;1;1
109;15.10.2015;2015;10;01;Torstai;0;0;0;0;0;0
109;15.10.2015;2015;10;02;Torstai;0;1;1;0;0;0
109;15.10.2015;2015;10;03;Torstai;0;0;0;0;0;0
109;15.10.2015;2015;10;04;Torstai;0;2;2;0;0;0
109;15.10.2015;2015;10;05;Torstai;0;5;5;1;2;3
109;15.10.2015;2015;10;06;Torstai;27;12;39;6;2;8
109;15.10.2015;2015;10;07;Torstai;85;25;110;6;3;9
109;15.10.2015;2015;10;08;Torstai;67;26;93;9;2;11
109;15.10.2015;2015;10;09;Torstai;18;13;31;1;4;5
109;15.10.2015;2015;10;10;Torstai;8;7;15;2;1;3
109;15.10.2015;2015;10;11;Torstai;14;11;25;2;1;3
109;15.10.2015;2015;10;12;Torstai;22;10;32;1;1;2
109;15.10.2015;2015;10;13;Torstai;11;20;31;3;2;5
109;15.10.2015;2015;10;14;Torstai;18;25;43;2;4;6
109;15.10.2015;2015;10;15;Torstai;19;50;69;4;2;6
109;15.10.2015;2015;10;16;Torstai;35;75;110;9;3;12
109;15.10.2015;2015;10;17;Torstai;32;29;61;4;3;7
109;15.10.2015;2015;10;18;Torstai;12;21;33;1;5;6
109;15.10.2015;2015;10;19;Torstai;5;11;16;9;8;17
109;15.10.2015;2015;10;20;Torstai;7;15;22;1;2;3
109;15.10.2015;2015;10;21;Torstai;3;13;16;4;2;6
109;15.10.2015;2015;10;22;Torstai;10;4;14;1;1;2
109;15.10.2015;2015;10;23;Torstai;0;0;0;1;0;1
109;16.10.2015;2015;10;00;Perjantai;1;0;1;0;0;0
109;16.10.2015;2015;10;01;Perjantai;0;0;0;0;1;1
109;16.10.2015;2015;10;02;Perjantai;0;0;0;0;0;0
109;16.10.2015;2015;10;03;Perjantai;0;0;0;0;0;0
109;16.10.2015;2015;10;04;Perjantai;1;1;2;0;0;0
109;16.10.2015;2015;10;05;Perjantai;2;6;8;0;1;1
109;16.10.2015;2015;10;06;Perjantai;31;11;42;2;2;4
109;16.10.2015;2015;10;07;Perjantai;61;31;92;3;4;7
109;16.10.2015;2015;10;08;Perjantai;54;25;79;2;3;5
109;16.10.2015;2015;10;09;Perjantai;24;15;39;1;3;4
109;16.10.2015;2015;10;10;Perjantai;23;6;29;3;2;5
109;16.10.2015;2015;10;11;Perjantai;21;17;38;7;3;10
109;16.10.2015;2015;10;12;Perjantai;12;10;22;7;7;14
109;16.10.2015;2015;10;13;Perjantai;13;24;37;3;2;5
109;16.10.2015;2015;10;14;Perjantai;20;44;64;1;6;7
109;16.10.2015;2015;10;15;Perjantai;32;44;76;4;1;5
109;16.10.2015;2015;10;16;Perjantai;31;39;70;7;5;12
109;16.10.2015;2015;10;17;Perjantai;22;21;43;3;4;7
109;16.10.2015;2015;10;18;Perjantai;8;8;16;8;1;9
109;16.10.2015;2015;10;19;Perjantai;5;14;19;0;3;3
109;16.10.2015;2015;10;20;Perjantai;1;9;10;9;1;10
109;16.10.2015;2015;10;21;Perjantai;4;10;14;1;1;2
109;16.10.2015;2015;10;22;Perjantai;7;2;9;1;1;2
109;16.10.2015;2015;10;23;Perjantai;0;2;2;1;1;2
109;17.10.2015;2015;10;00;Lauantai;5;0;5;0;0;0
109;17.10.2015;2015;10;01;Lauantai;1;7;8;0;0;0
109;17.10.2015;2015;10;02;Lauantai;1;1;2;0;0;0
109;17.10.2015;2015;10;03;Lauantai;0;0;0;0;0;0
109;17.10.2015;2015;10;04;Lauantai;0;1;1;0;0;0
109;17.10.2015;2015;10;05;Lauantai;0;0;0;0;0;0
109;17.10.2015;2015;10;06;Lauantai;5;0;5;0;1;1
109;17.10.2015;2015;10;07;Lauantai;5;3;8;2;1;3
109;17.10.2015;2015;10;08;Lauantai;2;5;7;5;2;7
109;17.10.2015;2015;10;09;Lauantai;9;1;10;3;5;8
109;17.10.2015;2015;10;10;Lauantai;8;4;12;7;4;11
109;17.10.2015;2015;10;11;Lauantai;7;7;14;1;3;4
109;17.10.2015;2015;10;12;Lauantai;17;14;31;3;4;7
109;17.10.2015;2015;10;13;Lauantai;9;10;19;4;3;7
109;17.10.2015;2015;10;14;Lauantai;12;10;22;4;6;10
109;17.10.2015;2015;10;15;Lauantai;13;12;25;7;2;9
109;17.10.2015;2015;10;16;Lauantai;13;15;28;4;5;9
109;17.10.2015;2015;10;17;Lauantai;15;8;23;5;3;8
109;17.10.2015;2015;10;18;Lauantai;11;5;16;0;3;3
109;17.10.2015;2015;10;19;Lauantai;3;6;9;2;1;3
109;17.10.2015;2015;10;20;Lauantai;4;8;12;5;2;7
109;17.10.2015;2015;10;21;Lauantai;1;4;5;0;0;0
109;17.10.2015;2015;10;22;Lauantai;4;3;7;1;1;2
109;17.10.2015;2015;10;23;Lauantai;0;3;3;0;0;0
109;18.10.2015;2015;10;00;Sunnuntai;0;0;0;0;1;1
109;18.10.2015;2015;10;01;Sunnuntai;3;4;7;0;0;0
109;18.10.2015;2015;10;02;Sunnuntai;3;5;8;0;1;1
109;18.10.2015;2015;10;03;Sunnuntai;0;0;0;0;0;0
109;18.10.2015;2015;10;04;Sunnuntai;0;0;0;0;0;0
109;18.10.2015;2015;10;05;Sunnuntai;1;2;3;0;0;0
109;18.10.2015;2015;10;06;Sunnuntai;4;0;4;1;1;2
109;18.10.2015;2015;10;07;Sunnuntai;1;3;4;1;3;4
109;18.10.2015;2015;10;08;Sunnuntai;2;2;4;5;1;6
109;18.10.2015;2015;10;09;Sunnuntai;2;3;5;1;1;2
109;18.10.2015;2015;10;10;Sunnuntai;5;7;12;4;4;8
109;18.10.2015;2015;10;11;Sunnuntai;12;3;15;9;1;10
109;18.10.2015;2015;10;12;Sunnuntai;7;4;11;2;3;5
109;18.10.2015;2015;10;13;Sunnuntai;12;4;16;6;4;10
109;18.10.2015;2015;10;14;Sunnuntai;10;11;21;7;5;12
109;18.10.2015;2015;10;15;Sunnuntai;7;9;16;5;5;10
109;18.10.2015;2015;10;16;Sunnuntai;10;9;19;7;5;12
109;18.10.2015;2015;10;17;Sunnuntai;9;8;17;11;4;15
109;18.10.2015;2015;10;18;Sunnuntai;12;4;16;4;3;7
109;18.10.2015;2015;10;19;Sunnuntai;7;4;11;3;3;6
109;18.10.2015;2015;10;20;Sunnuntai;4;6;10;2;4;6
109;18.10.2015;2015;10;21;Sunnuntai;5;2;7;1;1;2
109;18.10.2015;2015;10;22;Sunnuntai;1;9;10;0;0;0
109;18.10.2015;2015;10;23;Sunnuntai;0;1;1;0;1;1
109;19.10.2015;2015;10;00;Maanantai;0;0;0;1;0;1
109;19.10.2015;2015;10;01;Maanantai;0;2;2;1;0;1
109;19.10.2015;2015;10;02;Maanantai;0;1;1;0;0;0
109;19.10.2015;2015;10;03;Maanantai;0;1;1;0;1;1
109;19.10.2015;2015;10;04;Maanantai;0;2;2;0;0;0
109;19.10.2015;2015;10;05;Maanantai;2;10;12;0;1;1
109;19.10.2015;2015;10;06;Maanantai;20;8;28;2;2;4
109;19.10.2015;2015;10;07;Maanantai;57;30;87;6;4;10
109;19.10.2015;2015;10;08;Maanantai;53;16;69;5;0;5
109;19.10.2015;2015;10;09;Maanantai;14;10;24;4;3;7
109;19.10.2015;2015;10;10;Maanantai;11;10;21;7;2;9
109;19.10.2015;2015;10;11;Maanantai;14;7;21;1;4;5
109;19.10.2015;2015;10;12;Maanantai;26;11;37;6;4;10
109;19.10.2015;2015;10;13;Maanantai;9;10;19;6;8;14
109;19.10.2015;2015;10;14;Maanantai;17;24;41;4;5;9
109;19.10.2015;2015;10;15;Maanantai;24;40;64;7;5;12
109;19.10.2015;2015;10;16;Maanantai;44;64;108;5;5;10
109;19.10.2015;2015;10;17;Maanantai;30;32;62;3;2;5
109;19.10.2015;2015;10;18;Maanantai;22;11;33;5;10;15
109;19.10.2015;2015;10;19;Maanantai;7;7;14;6;5;11
109;19.10.2015;2015;10;20;Maanantai;5;5;10;3;2;5
109;19.10.2015;2015;10;21;Maanantai;0;13;13;3;0;3
109;19.10.2015;2015;10;22;Maanantai;4;3;7;1;0;1
109;19.10.2015;2015;10;23;Maanantai;3;2;5;0;0;0
109;20.10.2015;2015;10;00;Tiistai;0;0;0;0;0;0
109;20.10.2015;2015;10;01;Tiistai;2;0;2;0;1;1
109;20.10.2015;2015;10;02;Tiistai;0;0;0;0;1;1
109;20.10.2015;2015;10;03;Tiistai;0;0;0;0;0;0
109;20.10.2015;2015;10;04;Tiistai;1;2;3;0;0;0
109;20.10.2015;2015;10;05;Tiistai;1;7;8;1;1;2
109;20.10.2015;2015;10;06;Tiistai;22;10;32;0;2;2
109;20.10.2015;2015;10;07;Tiistai;47;27;74;3;5;8
109;20.10.2015;2015;10;08;Tiistai;44;23;67;6;3;9
109;20.10.2015;2015;10;09;Tiistai;10;9;19;4;3;7
109;20.10.2015;2015;10;10;Tiistai;9;7;16;4;1;5
109;20.10.2015;2015;10;11;Tiistai;6;10;16;3;2;5
109;20.10.2015;2015;10;12;Tiistai;10;9;19;4;4;8
109;20.10.2015;2015;10;13;Tiistai;18;12;30;0;1;1
109;20.10.2015;2015;10;14;Tiistai;8;12;20;3;2;5
109;20.10.2015;2015;10;15;Tiistai;25;33;58;1;5;6
109;20.10.2015;2015;10;16;Tiistai;40;56;96;2;3;5
109;20.10.2015;2015;10;17;Tiistai;27;23;50;4;3;7
109;20.10.2015;2015;10;18;Tiistai;6;17;23;2;2;4
109;20.10.2015;2015;10;19;Tiistai;3;3;6;4;3;7
109;20.10.2015;2015;10;20;Tiistai;8;10;18;4;1;5
109;20.10.2015;2015;10;21;Tiistai;3;7;10;3;4;7
109;20.10.2015;2015;10;22;Tiistai;4;5;9;0;0;0
109;20.10.2015;2015;10;23;Tiistai;0;2;2;0;0;0
109;21.10.2015;2015;10;00;Keskiviikko;2;1;3;0;1;1
109;21.10.2015;2015;10;01;Keskiviikko;0;0;0;0;0;0
109;21.10.2015;2015;10;02;Keskiviikko;0;0;0;0;1;1
109;21.10.2015;2015;10;03;Keskiviikko;0;0;0;0;0;0
109;21.10.2015;2015;10;04;Keskiviikko;1;2;3;0;0;0
109;21.10.2015;2015;10;05;Keskiviikko;0;10;10;1;2;3
109;21.10.2015;2015;10;06;Keskiviikko;22;4;26;3;3;6
109;21.10.2015;2015;10;07;Keskiviikko;49;23;72;3;6;9
109;21.10.2015;2015;10;08;Keskiviikko;32;16;48;3;2;5
109;21.10.2015;2015;10;09;Keskiviikko;11;7;18;8;2;10
109;21.10.2015;2015;10;10;Keskiviikko;12;6;18;3;3;6
109;21.10.2015;2015;10;11;Keskiviikko;14;6;20;6;0;6
109;21.10.2015;2015;10;12;Keskiviikko;12;8;20;2;2;4
109;21.10.2015;2015;10;13;Keskiviikko;9;15;24;6;4;10
109;21.10.2015;2015;10;14;Keskiviikko;12;9;21;0;3;3
109;21.10.2015;2015;10;15;Keskiviikko;19;29;48;4;3;7
109;21.10.2015;2015;10;16;Keskiviikko;24;47;71;0;3;3
109;21.10.2015;2015;10;17;Keskiviikko;18;20;38;5;4;9
109;21.10.2015;2015;10;18;Keskiviikko;3;12;15;3;5;8
109;21.10.2015;2015;10;19;Keskiviikko;5;3;8;7;4;11
109;21.10.2015;2015;10;20;Keskiviikko;8;4;12;2;2;4
109;21.10.2015;2015;10;21;Keskiviikko;1;3;4;1;1;2
109;21.10.2015;2015;10;22;Keskiviikko;5;2;7;3;0;3
109;21.10.2015;2015;10;23;Keskiviikko;1;0;1;1;0;1
109;22.10.2015;2015;10;00;Torstai;2;0;2;1;0;1
109;22.10.2015;2015;10;01;Torstai;0;0;0;0;1;1
109;22.10.2015;2015;10;02;Torstai;1;0;1;1;0;1
109;22.10.2015;2015;10;03;Torstai;0;1;1;0;0;0
109;22.10.2015;2015;10;04;Torstai;1;0;1;0;0;0
109;22.10.2015;2015;10;05;Torstai;0;8;8;0;1;1
109;22.10.2015;2015;10;06;Torstai;21;8;29;2;2;4
109;22.10.2015;2015;10;07;Torstai;28;19;47;1;3;4
109;22.10.2015;2015;10;08;Torstai;30;23;53;2;1;3
109;22.10.2015;2015;10;09;Torstai;18;11;29;5;3;8
109;22.10.2015;2015;10;10;Torstai;9;5;14;2;2;4
109;22.10.2015;2015;10;11;Torstai;8;8;16;1;2;3
109;22.10.2015;2015;10;12;Torstai;9;4;13;1;1;2
109;22.10.2015;2015;10;13;Torstai;9;13;22;5;3;8
109;22.10.2015;2015;10;14;Torstai;20;14;34;4;5;9
109;22.10.2015;2015;10;15;Torstai;15;37;52;5;3;8
109;22.10.2015;2015;10;16;Torstai;23;33;56;8;5;13
109;22.10.2015;2015;10;17;Torstai;15;38;53;8;2;10
109;22.10.2015;2015;10;18;Torstai;11;15;26;5;5;10
109;22.10.2015;2015;10;19;Torstai;6;5;11;5;0;5
109;22.10.2015;2015;10;20;Torstai;9;3;12;3;5;8
109;22.10.2015;2015;10;21;Torstai;2;2;4;3;3;6
109;22.10.2015;2015;10;22;Torstai;5;2;7;0;0;0
109;22.10.2015;2015;10;23;Torstai;1;0;1;1;0;1
109;23.10.2015;2015;10;00;Perjantai;1;0;1;0;0;0
109;23.10.2015;2015;10;01;Perjantai;0;6;6;0;1;1
109;23.10.2015;2015;10;02;Perjantai;0;0;0;1;0;1
109;23.10.2015;2015;10;03;Perjantai;0;0;0;0;0;0
109;23.10.2015;2015;10;04;Perjantai;1;0;1;0;1;1
109;23.10.2015;2015;10;05;Perjantai;3;7;10;0;1;1
109;23.10.2015;2015;10;06;Perjantai;19;5;24;2;4;6
109;23.10.2015;2015;10;07;Perjantai;31;25;56;2;3;5
109;23.10.2015;2015;10;08;Perjantai;19;14;33;1;0;1
109;23.10.2015;2015;10;09;Perjantai;8;5;13;4;1;5
109;23.10.2015;2015;10;10;Perjantai;7;4;11;5;2;7
109;23.10.2015;2015;10;11;Perjantai;6;8;14;1;6;7
109;23.10.2015;2015;10;12;Perjantai;4;3;7;4;4;8
109;23.10.2015;2015;10;13;Perjantai;5;10;15;3;1;4
109;23.10.2015;2015;10;14;Perjantai;22;21;43;3;0;3
109;23.10.2015;2015;10;15;Perjantai;21;26;47;6;1;7
109;23.10.2015;2015;10;16;Perjantai;21;25;46;1;2;3
109;23.10.2015;2015;10;17;Perjantai;11;14;25;3;2;5
109;23.10.2015;2015;10;18;Perjantai;7;8;15;5;2;7
109;23.10.2015;2015;10;19;Perjantai;6;3;9;4;2;6
109;23.10.2015;2015;10;20;Perjantai;3;1;4;1;4;5
109;23.10.2015;2015;10;21;Perjantai;3;4;7;2;2;4
109;23.10.2015;2015;10;22;Perjantai;4;1;5;1;0;1
109;23.10.2015;2015;10;23;Perjantai;2;3;5;1;0;1
109;24.10.2015;2015;10;00;Lauantai;0;1;1;0;0;0
109;24.10.2015;2015;10;01;Lauantai;0;0;0;0;0;0
109;24.10.2015;2015;10;02;Lauantai;0;1;1;0;0;0
109;24.10.2015;2015;10;03;Lauantai;1;1;2;0;0;0
109;24.10.2015;2015;10;04;Lauantai;0;1;1;0;0;0
109;24.10.2015;2015;10;05;Lauantai;1;1;2;0;0;0
109;24.10.2015;2015;10;06;Lauantai;8;1;9;0;1;1
109;24.10.2015;2015;10;07;Lauantai;0;1;1;1;1;2
109;24.10.2015;2015;10;08;Lauantai;0;3;3;1;1;2
109;24.10.2015;2015;10;09;Lauantai;5;2;7;3;3;6
109;24.10.2015;2015;10;10;Lauantai;6;2;8;8;3;11
109;24.10.2015;2015;10;11;Lauantai;11;8;19;8;5;13
109;24.10.2015;2015;10;12;Lauantai;14;8;22;3;5;8
109;24.10.2015;2015;10;13;Lauantai;10;12;22;6;4;10
109;24.10.2015;2015;10;14;Lauantai;7;8;15;3;2;5
109;24.10.2015;2015;10;15;Lauantai;6;7;13;9;4;13
109;24.10.2015;2015;10;16;Lauantai;9;7;16;3;3;6
109;24.10.2015;2015;10;17;Lauantai;4;6;10;6;3;9
109;24.10.2015;2015;10;18;Lauantai;9;7;16;3;5;8
109;24.10.2015;2015;10;19;Lauantai;9;4;13;3;1;4
109;24.10.2015;2015;10;20;Lauantai;1;2;3;2;1;3
109;24.10.2015;2015;10;21;Lauantai;0;7;7;2;4;6
109;24.10.2015;2015;10;22;Lauantai;3;1;4;2;2;4
109;24.10.2015;2015;10;23;Lauantai;0;0;0;2;0;2
109;25.10.2015;2015;10;00;Sunnuntai;0;0;0;0;2;2
109;25.10.2015;2015;10;01;Sunnuntai;0;1;1;0;0;0
109;25.10.2015;2015;10;02;Sunnuntai;0;2;2;0;1;1
109;25.10.2015;2015;10;03;Sunnuntai;0;3;3;0;1;1
109;25.10.2015;2015;10;04;Sunnuntai;0;2;2;0;0;0
109;25.10.2015;2015;10;05;Sunnuntai;1;0;1;0;1;1
109;25.10.2015;2015;10;06;Sunnuntai;4;1;5;1;0;1
109;25.10.2015;2015;10;07;Sunnuntai;0;2;2;2;3;5
109;25.10.2015;2015;10;08;Sunnuntai;3;3;6;8;4;12
109;25.10.2015;2015;10;09;Sunnuntai;6;2;8;2;6;8
109;25.10.2015;2015;10;10;Sunnuntai;2;2;4;6;6;12
109;25.10.2015;2015;10;11;Sunnuntai;5;3;8;2;3;5
109;25.10.2015;2015;10;12;Sunnuntai;5;8;13;1;1;2
109;25.10.2015;2015;10;13;Sunnuntai;9;2;11;2;2;4
109;25.10.2015;2015;10;14;Sunnuntai;5;7;12;2;3;5
109;25.10.2015;2015;10;15;Sunnuntai;3;4;7;2;2;4
109;25.10.2015;2015;10;16;Sunnuntai;6;5;11;3;5;8
109;25.10.2015;2015;10;17;Sunnuntai;5;2;7;2;3;5
109;25.10.2015;2015;10;18;Sunnuntai;4;1;5;4;1;5
109;25.10.2015;2015;10;19;Sunnuntai;5;9;14;3;4;7
109;25.10.2015;2015;10;20;Sunnuntai;2;2;4;6;1;7
109;25.10.2015;2015;10;21;Sunnuntai;4;4;8;1;1;2
109;25.10.2015;2015;10;22;Sunnuntai;1;2;3;0;1;1
109;25.10.2015;2015;10;23;Sunnuntai;0;0;0;0;1;1
109;26.10.2015;2015;10;00;Maanantai;0;1;1;0;1;1
109;26.10.2015;2015;10;01;Maanantai;0;1;1;0;0;0
109;26.10.2015;2015;10;02;Maanantai;0;0;0;0;0;0
109;26.10.2015;2015;10;03;Maanantai;0;0;0;0;0;0
109;26.10.2015;2015;10;04;Maanantai;0;1;1;0;0;0
109;26.10.2015;2015;10;05;Maanantai;0;7;7;2;1;3
109;26.10.2015;2015;10;06;Maanantai;38;9;47;3;2;5
109;26.10.2015;2015;10;07;Maanantai;69;42;111;3;2;5
109;26.10.2015;2015;10;08;Maanantai;58;21;79;4;2;6
109;26.10.2015;2015;10;09;Maanantai;22;12;34;0;1;1
109;26.10.2015;2015;10;10;Maanantai;14;8;22;1;2;3
109;26.10.2015;2015;10;11;Maanantai;18;15;33;7;4;11
109;26.10.2015;2015;10;12;Maanantai;14;10;24;4;4;8
109;26.10.2015;2015;10;13;Maanantai;18;19;37;0;2;2
109;26.10.2015;2015;10;14;Maanantai;25;27;52;7;1;8
109;26.10.2015;2015;10;15;Maanantai;27;54;81;5;2;7
109;26.10.2015;2015;10;16;Maanantai;47;83;130;7;5;12
109;26.10.2015;2015;10;17;Maanantai;27;36;63;4;1;5
109;26.10.2015;2015;10;18;Maanantai;9;17;26;9;6;15
109;26.10.2015;2015;10;19;Maanantai;6;16;22;4;4;8
109;26.10.2015;2015;10;20;Maanantai;5;17;22;4;2;6
109;26.10.2015;2015;10;21;Maanantai;2;8;10;2;6;8
109;26.10.2015;2015;10;22;Maanantai;8;7;15;0;0;0
109;26.10.2015;2015;10;23;Maanantai;1;1;2;0;0;0
109;27.10.2015;2015;10;00;Tiistai;1;0;1;1;1;2
109;27.10.2015;2015;10;01;Tiistai;1;0;1;0;0;0
109;27.10.2015;2015;10;02;Tiistai;0;0;0;1;0;1
109;27.10.2015;2015;10;03;Tiistai;0;0;0;0;0;0
109;27.10.2015;2015;10;04;Tiistai;0;0;0;0;0;0
109;27.10.2015;2015;10;05;Tiistai;2;5;7;2;2;4
109;27.10.2015;2015;10;06;Tiistai;36;8;44;3;2;5
109;27.10.2015;2015;10;07;Tiistai;67;40;107;3;0;3
109;27.10.2015;2015;10;08;Tiistai;57;19;76;1;0;1
109;27.10.2015;2015;10;09;Tiistai;19;7;26;1;1;2
109;27.10.2015;2015;10;10;Tiistai;5;11;16;13;12;25
109;27.10.2015;2015;10;11;Tiistai;15;14;29;1;1;2
109;27.10.2015;2015;10;12;Tiistai;14;8;22;5;2;7
109;27.10.2015;2015;10;13;Tiistai;17;15;32;2;5;7
109;27.10.2015;2015;10;14;Tiistai;11;20;31;4;1;5
109;27.10.2015;2015;10;15;Tiistai;22;46;68;7;3;10
109;27.10.2015;2015;10;16;Tiistai;42;55;97;5;4;9
109;27.10.2015;2015;10;17;Tiistai;11;40;51;2;8;10
109;27.10.2015;2015;10;18;Tiistai;7;11;18;9;3;12
109;27.10.2015;2015;10;19;Tiistai;10;12;22;10;0;10
109;27.10.2015;2015;10;20;Tiistai;6;5;11;3;4;7
109;27.10.2015;2015;10;21;Tiistai;4;10;14;2;2;4
109;27.10.2015;2015;10;22;Tiistai;11;2;13;3;0;3
109;27.10.2015;2015;10;23;Tiistai;4;1;5;1;0;1
109;28.10.2015;2015;10;00;Keskiviikko;0;0;0;0;2;2
109;28.10.2015;2015;10;01;Keskiviikko;0;0;0;0;0;0
109;28.10.2015;2015;10;02;Keskiviikko;1;0;1;0;0;0
109;28.10.2015;2015;10;03;Keskiviikko;0;0;0;0;0;0
109;28.10.2015;2015;10;04;Keskiviikko;1;2;3;0;0;0
109;28.10.2015;2015;10;05;Keskiviikko;2;8;10;1;1;2
109;28.10.2015;2015;10;06;Keskiviikko;34;7;41;4;2;6
109;28.10.2015;2015;10;07;Keskiviikko;63;37;100;4;5;9
109;28.10.2015;2015;10;08;Keskiviikko;56;16;72;3;0;3
109;28.10.2015;2015;10;09;Keskiviikko;22;10;32;3;1;4
109;28.10.2015;2015;10;10;Keskiviikko;8;7;15;4;7;11
109;28.10.2015;2015;10;11;Keskiviikko;14;4;18;4;2;6
109;28.10.2015;2015;10;12;Keskiviikko;18;7;25;7;0;7
109;28.10.2015;2015;10;13;Keskiviikko;14;13;27;3;1;4
109;28.10.2015;2015;10;14;Keskiviikko;13;30;43;2;3;5
109;28.10.2015;2015;10;15;Keskiviikko;18;51;69;10;4;14
109;28.10.2015;2015;10;16;Keskiviikko;35;76;111;5;6;11
109;28.10.2015;2015;10;17;Keskiviikko;20;27;47;2;5;7
109;28.10.2015;2015;10;18;Keskiviikko;16;17;33;5;9;14
109;28.10.2015;2015;10;19;Keskiviikko;10;16;26;7;4;11
109;28.10.2015;2015;10;20;Keskiviikko;10;9;19;3;4;7
109;28.10.2015;2015;10;21;Keskiviikko;7;9;16;1;1;2
109;28.10.2015;2015;10;22;Keskiviikko;4;2;6;0;0;0
109;28.10.2015;2015;10;23;Keskiviikko;2;5;7;1;0;1
109;29.10.2015;2015;10;00;Torstai;1;0;1;3;1;4
109;29.10.2015;2015;10;01;Torstai;0;1;1;0;0;0
109;29.10.2015;2015;10;02;Torstai;0;0;0;0;0;0
109;29.10.2015;2015;10;03;Torstai;0;0;0;0;0;0
109;29.10.2015;2015;10;04;Torstai;1;2;3;0;0;0
109;29.10.2015;2015;10;05;Torstai;2;8;10;0;1;1
109;29.10.2015;2015;10;06;Torstai;32;7;39;4;4;8
109;29.10.2015;2015;10;07;Torstai;67;30;97;4;6;10
109;29.10.2015;2015;10;08;Torstai;70;21;91;2;1;3
109;29.10.2015;2015;10;09;Torstai;22;10;32;2;1;3
109;29.10.2015;2015;10;10;Torstai;9;4;13;6;1;7
109;29.10.2015;2015;10;11;Torstai;11;6;17;6;2;8
109;29.10.2015;2015;10;12;Torstai;17;12;29;3;2;5
109;29.10.2015;2015;10;13;Torstai;18;13;31;1;0;1
109;29.10.2015;2015;10;14;Torstai;16;18;34;2;2;4
109;29.10.2015;2015;10;15;Torstai;17;54;71;8;5;13
109;29.10.2015;2015;10;16;Torstai;40;56;96;4;6;10
109;29.10.2015;2015;10;17;Torstai;15;25;40;4;3;7
109;29.10.2015;2015;10;18;Torstai;9;19;28;3;5;8
109;29.10.2015;2015;10;19;Torstai;11;6;17;3;4;7
109;29.10.2015;2015;10;20;Torstai;5;7;12;2;3;5
109;29.10.2015;2015;10;21;Torstai;1;5;6;2;1;3
109;29.10.2015;2015;10;22;Torstai;5;3;8;1;0;1
109;29.10.2015;2015;10;23;Torstai;2;4;6;2;0;2
109;30.10.2015;2015;10;00;Perjantai;1;0;1;1;0;1
109;30.10.2015;2015;10;01;Perjantai;2;1;3;0;0;0
109;30.10.2015;2015;10;02;Perjantai;0;1;1;0;0;0
109;30.10.2015;2015;10;03;Perjantai;0;1;1;0;0;0
109;30.10.2015;2015;10;04;Perjantai;1;0;1;0;0;0
109;30.10.2015;2015;10;05;Perjantai;3;5;8;1;2;3
109;30.10.2015;2015;10;06;Perjantai;28;8;36;2;1;3
109;30.10.2015;2015;10;07;Perjantai;51;28;79;3;4;7
109;30.10.2015;2015;10;08;Perjantai;41;13;54;1;3;4
109;30.10.2015;2015;10;09;Perjantai;23;8;31;3;1;4
109;30.10.2015;2015;10;10;Perjantai;10;6;16;3;0;3
109;30.10.2015;2015;10;11;Perjantai;9;13;22;4;7;11
109;30.10.2015;2015;10;12;Perjantai;5;12;17;3;1;4
109;30.10.2015;2015;10;13;Perjantai;13;19;32;2;1;3
109;30.10.2015;2015;10;14;Perjantai;19;31;50;3;2;5
109;30.10.2015;2015;10;15;Perjantai;24;42;66;6;5;11
109;30.10.2015;2015;10;16;Perjantai;23;27;50;6;4;10
109;30.10.2015;2015;10;17;Perjantai;20;14;34;3;7;10
109;30.10.2015;2015;10;18;Perjantai;6;13;19;2;5;7
109;30.10.2015;2015;10;19;Perjantai;3;2;5;2;2;4
109;30.10.2015;2015;10;20;Perjantai;8;8;16;0;1;1
109;30.10.2015;2015;10;21;Perjantai;0;4;4;1;1;2
109;30.10.2015;2015;10;22;Perjantai;5;4;9;0;0;0
109;30.10.2015;2015;10;23;Perjantai;2;1;3;2;0;2
109;31.10.2015;2015;10;00;Lauantai;2;2;4;1;0;1
109;31.10.2015;2015;10;01;Lauantai;0;1;1;1;0;1
109;31.10.2015;2015;10;02;Lauantai;0;4;4;0;0;0
109;31.10.2015;2015;10;03;Lauantai;0;0;0;0;0;0
109;31.10.2015;2015;10;04;Lauantai;0;0;0;0;0;0
109;31.10.2015;2015;10;05;Lauantai;1;1;2;0;1;1
109;31.10.2015;2015;10;06;Lauantai;3;1;4;1;0;1
109;31.10.2015;2015;10;07;Lauantai;2;1;3;2;3;5
109;31.10.2015;2015;10;08;Lauantai;2;0;2;6;3;9
109;31.10.2015;2015;10;09;Lauantai;6;4;10;3;5;8
109;31.10.2015;2015;10;10;Lauantai;5;1;6;2;3;5
109;31.10.2015;2015;10;11;Lauantai;6;9;15;4;2;6
109;31.10.2015;2015;10;12;Lauantai;10;9;19;3;6;9
109;31.10.2015;2015;10;13;Lauantai;6;8;14;10;6;16
109;31.10.2015;2015;10;14;Lauantai;15;7;22;4;6;10
109;31.10.2015;2015;10;15;Lauantai;5;9;14;7;6;13
109;31.10.2015;2015;10;16;Lauantai;15;14;29;6;4;10
109;31.10.2015;2015;10;17;Lauantai;8;11;19;7;1;8
109;31.10.2015;2015;10;18;Lauantai;4;9;13;3;3;6
109;31.10.2015;2015;10;19;Lauantai;3;12;15;0;1;1
109;31.10.2015;2015;10;20;Lauantai;5;5;10;1;4;5
109;31.10.2015;2015;10;21;Lauantai;1;6;7;1;3;4
109;31.10.2015;2015;10;22;Lauantai;1;1;2;0;1;1
109;31.10.2015;2015;10;23;Lauantai;1;2;3;0;2;2
109;01.11.2015;2015;11;00;Sunnuntai;1;1;2;3;0;3
109;01.11.2015;2015;11;01;Sunnuntai;0;0;0;0;0;0
109;01.11.2015;2015;11;02;Sunnuntai;1;0;1;0;1;1
109;01.11.2015;2015;11;03;Sunnuntai;0;0;0;0;0;0
109;01.11.2015;2015;11;04;Sunnuntai;0;0;0;0;0;0
109;01.11.2015;2015;11;05;Sunnuntai;0;0;0;0;1;1
109;01.11.2015;2015;11;06;Sunnuntai;1;0;1;1;0;1
109;01.11.2015;2015;11;07;Sunnuntai;2;1;3;1;2;3
109;01.11.2015;2015;11;08;Sunnuntai;4;1;5;0;2;2
109;01.11.2015;2015;11;09;Sunnuntai;5;3;8;8;2;10
109;01.11.2015;2015;11;10;Sunnuntai;5;4;9;4;7;11
109;01.11.2015;2015;11;11;Sunnuntai;9;6;15;8;7;15
109;01.11.2015;2015;11;12;Sunnuntai;12;8;20;3;3;6
109;01.11.2015;2015;11;13;Sunnuntai;15;14;29;8;8;16
109;01.11.2015;2015;11;14;Sunnuntai;8;4;12;8;7;15
109;01.11.2015;2015;11;15;Sunnuntai;7;9;16;6;8;14
109;01.11.2015;2015;11;16;Sunnuntai;8;10;18;5;4;9
109;01.11.2015;2015;11;17;Sunnuntai;9;4;13;7;6;13
109;01.11.2015;2015;11;18;Sunnuntai;5;3;8;2;0;2
109;01.11.2015;2015;11;19;Sunnuntai;4;5;9;8;3;11
109;01.11.2015;2015;11;20;Sunnuntai;2;3;5;6;1;7
109;01.11.2015;2015;11;21;Sunnuntai;0;5;5;1;0;1
109;01.11.2015;2015;11;22;Sunnuntai;1;1;2;0;3;3
109;01.11.2015;2015;11;23;Sunnuntai;0;0;0;0;0;0
109;02.11.2015;2015;11;00;Maanantai;0;1;1;1;0;1
109;02.11.2015;2015;11;01;Maanantai;0;0;0;0;1;1
109;02.11.2015;2015;11;02;Maanantai;0;0;0;0;0;0
109;02.11.2015;2015;11;03;Maanantai;0;0;0;0;1;1
109;02.11.2015;2015;11;04;Maanantai;0;0;0;0;0;0
109;02.11.2015;2015;11;05;Maanantai;2;8;10;1;1;2
109;02.11.2015;2015;11;06;Maanantai;30;11;41;4;4;8
109;02.11.2015;2015;11;07;Maanantai;60;33;93;3;3;6
109;02.11.2015;2015;11;08;Maanantai;64;16;80;5;1;6
109;02.11.2015;2015;11;09;Maanantai;19;10;29;3;5;8
109;02.11.2015;2015;11;10;Maanantai;17;1;18;5;5;10
109;02.11.2015;2015;11;11;Maanantai;15;12;27;4;0;4
109;02.11.2015;2015;11;12;Maanantai;12;10;22;3;0;3
109;02.11.2015;2015;11;13;Maanantai;12;10;22;0;3;3
109;02.11.2015;2015;11;14;Maanantai;23;21;44;3;5;8
109;02.11.2015;2015;11;15;Maanantai;36;34;70;5;4;9
109;02.11.2015;2015;11;16;Maanantai;48;45;93;4;4;8
109;02.11.2015;2015;11;17;Maanantai;24;22;46;3;6;9
109;02.11.2015;2015;11;18;Maanantai;15;13;28;5;2;7
109;02.11.2015;2015;11;19;Maanantai;14;13;27;11;5;16
109;02.11.2015;2015;11;20;Maanantai;11;10;21;5;1;6
109;02.11.2015;2015;11;21;Maanantai;6;4;10;1;2;3
109;02.11.2015;2015;11;22;Maanantai;5;3;8;2;0;2
109;02.11.2015;2015;11;23;Maanantai;1;0;1;0;0;0
109;03.11.2015;2015;11;00;Tiistai;1;0;1;1;1;2
109;03.11.2015;2015;11;01;Tiistai;3;0;3;1;2;3
109;03.11.2015;2015;11;02;Tiistai;1;0;1;0;0;0
109;03.11.2015;2015;11;03;Tiistai;1;0;1;0;0;0
109;03.11.2015;2015;11;04;Tiistai;0;0;0;0;0;0
109;03.11.2015;2015;11;05;Tiistai;5;3;8;0;0;0
109;03.11.2015;2015;11;06;Tiistai;26;25;51;0;0;0
109;03.11.2015;2015;11;07;Tiistai;48;47;95;2;2;4
109;03.11.2015;2015;11;08;Tiistai;44;42;86;3;3;6
109;03.11.2015;2015;11;09;Tiistai;20;17;37;5;2;7
109;03.11.2015;2015;11;10;Tiistai;15;12;27;5;1;6
109;03.11.2015;2015;11;11;Tiistai;10;9;19;4;0;4
109;03.11.2015;2015;11;12;Tiistai;19;16;35;3;0;3
109;03.11.2015;2015;11;13;Tiistai;17;16;33;0;3;3
109;03.11.2015;2015;11;14;Tiistai;22;22;44;3;5;8
109;03.11.2015;2015;11;15;Tiistai;42;41;83;5;4;9
109;03.11.2015;2015;11;16;Tiistai;56;56;112;3;1;4
109;03.11.2015;2015;11;17;Tiistai;22;27;49;6;4;10
109;03.11.2015;2015;11;18;Tiistai;16;23;39;3;5;8
109;03.11.2015;2015;11;19;Tiistai;10;16;26;13;5;18
109;03.11.2015;2015;11;20;Tiistai;4;6;10;5;5;10
109;03.11.2015;2015;11;21;Tiistai;3;14;17;2;4;6
109;03.11.2015;2015;11;22;Tiistai;8;3;11;0;1;1
109;03.11.2015;2015;11;23;Tiistai;1;1;2;0;0;0
109;04.11.2015;2015;11;00;Keskiviikko;4;1;5;1;1;2
109;04.11.2015;2015;11;01;Keskiviikko;1;0;1;1;2;3
109;04.11.2015;2015;11;02;Keskiviikko;0;1;1;0;0;0
109;04.11.2015;2015;11;03;Keskiviikko;1;2;3;0;0;0
109;04.11.2015;2015;11;04;Keskiviikko;0;1;1;0;0;0
109;04.11.2015;2015;11;05;Keskiviikko;2;8;10;2;2;4
109;04.11.2015;2015;11;06;Keskiviikko;39;6;45;3;3;6
109;04.11.2015;2015;11;07;Keskiviikko;70;36;106;3;3;6
109;04.11.2015;2015;11;08;Keskiviikko;66;20;86;5;2;7
109;04.11.2015;2015;11;09;Keskiviikko;21;7;28;5;1;6
109;04.11.2015;2015;11;10;Keskiviikko;13;7;20;5;4;9
109;04.11.2015;2015;11;11;Keskiviikko;14;15;29;4;0;4
109;04.11.2015;2015;11;12;Keskiviikko;18;12;30;3;0;3
109;04.11.2015;2015;11;13;Keskiviikko;13;27;40;0;3;3
109;04.11.2015;2015;11;14;Keskiviikko;24;29;53;3;5;8
109;04.11.2015;2015;11;15;Keskiviikko;28;48;76;5;4;9
109;04.11.2015;2015;11;16;Keskiviikko;32;83;115;4;4;8
109;04.11.2015;2015;11;17;Keskiviikko;21;25;46;3;6;9
109;04.11.2015;2015;11;18;Keskiviikko;14;16;30;5;2;7
109;04.11.2015;2015;11;19;Keskiviikko;10;12;22;11;5;16
109;04.11.2015;2015;11;20;Keskiviikko;4;10;14;5;1;6
109;04.11.2015;2015;11;21;Keskiviikko;2;12;14;1;2;3
109;04.11.2015;2015;11;22;Keskiviikko;5;1;6;2;0;2
109;04.11.2015;2015;11;23;Keskiviikko;4;3;7;0;0;0
109;05.11.2015;2015;11;00;Torstai;2;1;3;0;0;0
109;05.11.2015;2015;11;01;Torstai;0;0;0;0;0;0
109;05.11.2015;2015;11;02;Torstai;0;1;1;1;0;1
109;05.11.2015;2015;11;03;Torstai;0;0;0;0;0;0
109;05.11.2015;2015;11;04;Torstai;1;0;1;0;1;1
109;05.11.2015;2015;11;05;Torstai;3;9;12;1;1;2
109;05.11.2015;2015;11;06;Torstai;31;9;40;2;2;4
109;05.11.2015;2015;11;07;Torstai;61;29;90;6;7;13
109;05.11.2015;2015;11;08;Torstai;64;19;83;4;0;4
109;05.11.2015;2015;11;09;Torstai;16;8;24;4;4;8
109;05.11.2015;2015;11;10;Torstai;10;8;18;3;2;5
109;05.11.2015;2015;11;11;Torstai;17;5;22;4;1;5
109;05.11.2015;2015;11;12;Torstai;12;11;23;2;1;3
109;05.11.2015;2015;11;13;Torstai;15;21;36;2;2;4
109;05.11.2015;2015;11;14;Torstai;10;27;37;2;2;4
109;05.11.2015;2015;11;15;Torstai;21;45;66;8;6;14
109;05.11.2015;2015;11;16;Torstai;31;63;94;5;2;7
109;05.11.2015;2015;11;17;Torstai;18;22;40;1;2;3
109;05.11.2015;2015;11;18;Torstai;8;20;28;2;4;6
109;05.11.2015;2015;11;19;Torstai;10;11;21;4;2;6
109;05.11.2015;2015;11;20;Torstai;5;14;19;2;3;5
109;05.11.2015;2015;11;21;Torstai;4;8;12;1;2;3
109;05.11.2015;2015;11;22;Torstai;6;1;7;0;0;0
109;05.11.2015;2015;11;23;Torstai;2;0;2;1;0;1
109;06.11.2015;2015;11;00;Perjantai;0;0;0;1;0;1
109;06.11.2015;2015;11;01;Perjantai;0;2;2;0;2;2
109;06.11.2015;2015;11;02;Perjantai;0;0;0;0;1;1
109;06.11.2015;2015;11;03;Perjantai;1;0;1;0;0;0
109;06.11.2015;2015;11;04;Perjantai;0;0;0;0;0;0
109;06.11.2015;2015;11;05;Perjantai;4;9;13;1;0;1
109;06.11.2015;2015;11;06;Perjantai;21;9;30;1;1;2
109;06.11.2015;2015;11;07;Perjantai;55;21;76;4;4;8
109;06.11.2015;2015;11;08;Perjantai;45;16;61;7;2;9
109;06.11.2015;2015;11;09;Perjantai;21;9;30;3;1;4
109;06.11.2015;2015;11;10;Perjantai;12;3;15;8;5;13
109;06.11.2015;2015;11;11;Perjantai;10;13;23;4;2;6
109;06.11.2015;2015;11;12;Perjantai;17;16;33;1;1;2
109;06.11.2015;2015;11;13;Perjantai;12;21;33;4;4;8
109;06.11.2015;2015;11;14;Perjantai;14;35;49;1;3;4
109;06.11.2015;2015;11;15;Perjantai;21;36;57;7;8;15
109;06.11.2015;2015;11;16;Perjantai;20;34;54;1;3;4
109;06.11.2015;2015;11;17;Perjantai;16;9;25;5;2;7
109;06.11.2015;2015;11;18;Perjantai;7;8;15;4;5;9
109;06.11.2015;2015;11;19;Perjantai;4;1;5;4;3;7
109;06.11.2015;2015;11;20;Perjantai;5;2;7;0;1;1
109;06.11.2015;2015;11;21;Perjantai;0;7;7;1;5;6
109;06.11.2015;2015;11;22;Perjantai;5;4;9;1;0;1
109;06.11.2015;2015;11;23;Perjantai;0;4;4;3;0;3
109;07.11.2015;2015;11;00;Lauantai;5;0;5;0;0;0
109;07.11.2015;2015;11;01;Lauantai;0;0;0;0;0;0
109;07.11.2015;2015;11;02;Lauantai;0;2;2;0;0;0
109;07.11.2015;2015;11;03;Lauantai;0;0;0;0;0;0
109;07.11.2015;2015;11;04;Lauantai;0;0;0;0;0;0
109;07.11.2015;2015;11;05;Lauantai;1;1;2;0;0;0
109;07.11.2015;2015;11;06;Lauantai;6;0;6;1;0;1
109;07.11.2015;2015;11;07;Lauantai;5;2;7;3;0;3
109;07.11.2015;2015;11;08;Lauantai;1;3;4;1;0;1
109;07.11.2015;2015;11;09;Lauantai;5;2;7;2;0;2
109;07.11.2015;2015;11;10;Lauantai;3;3;6;1;1;2
109;07.11.2015;2015;11;11;Lauantai;2;5;7;4;3;7
109;07.11.2015;2015;11;12;Lauantai;5;1;6;6;2;8
109;07.11.2015;2015;11;13;Lauantai;7;4;11;3;2;5
109;07.11.2015;2015;11;14;Lauantai;16;8;24;3;3;6
109;07.11.2015;2015;11;15;Lauantai;7;9;16;2;3;5
109;07.11.2015;2015;11;16;Lauantai;0;6;6;2;2;4
109;07.11.2015;2015;11;17;Lauantai;8;4;12;3;1;4
109;07.11.2015;2015;11;18;Lauantai;8;3;11;2;2;4
109;07.11.2015;2015;11;19;Lauantai;3;2;5;4;3;7
109;07.11.2015;2015;11;20;Lauantai;2;2;4;2;2;4
109;07.11.2015;2015;11;21;Lauantai;1;2;3;2;3;5
109;07.11.2015;2015;11;22;Lauantai;1;1;2;1;0;1
109;07.11.2015;2015;11;23;Lauantai;1;4;5;0;0;0
109;08.11.2015;2015;11;00;Sunnuntai;1;2;3;1;1;2
109;08.11.2015;2015;11;01;Sunnuntai;0;0;0;1;0;1
109;08.11.2015;2015;11;02;Sunnuntai;0;4;4;0;0;0
109;08.11.2015;2015;11;03;Sunnuntai;0;0;0;0;0;0
109;08.11.2015;2015;11;04;Sunnuntai;1;0;1;0;1;1
109;08.11.2015;2015;11;05;Sunnuntai;0;2;2;0;0;0
109;08.11.2015;2015;11;06;Sunnuntai;2;1;3;0;1;1
109;08.11.2015;2015;11;07;Sunnuntai;0;0;0;3;3;6
109;08.11.2015;2015;11;08;Sunnuntai;3;0;3;1;0;1
109;08.11.2015;2015;11;09;Sunnuntai;3;2;5;6;2;8
109;08.11.2015;2015;11;10;Sunnuntai;12;5;17;7;3;10
109;08.11.2015;2015;11;11;Sunnuntai;2;7;9;10;4;14
109;08.11.2015;2015;11;12;Sunnuntai;6;8;14;6;9;15
109;08.11.2015;2015;11;13;Sunnuntai;6;3;9;4;4;8
109;08.11.2015;2015;11;14;Sunnuntai;8;8;16;8;7;15
109;08.11.2015;2015;11;15;Sunnuntai;6;3;9;14;9;23
109;08.11.2015;2015;11;16;Sunnuntai;9;4;13;2;5;7
109;08.11.2015;2015;11;17;Sunnuntai;4;4;8;4;5;9
109;08.11.2015;2015;11;18;Sunnuntai;6;4;10;5;2;7
109;08.11.2015;2015;11;19;Sunnuntai;5;2;7;2;0;2
109;08.11.2015;2015;11;20;Sunnuntai;0;3;3;9;4;13
109;08.11.2015;2015;11;21;Sunnuntai;1;6;7;1;4;5
109;08.11.2015;2015;11;22;Sunnuntai;0;2;2;2;0;2
109;08.11.2015;2015;11;23;Sunnuntai;1;1;2;0;0;0
109;09.11.2015;2015;11;00;Maanantai;1;0;1;1;0;1
109;09.11.2015;2015;11;01;Maanantai;0;0;0;0;2;2
109;09.11.2015;2015;11;02;Maanantai;0;0;0;1;0;1
109;09.11.2015;2015;11;03;Maanantai;0;0;0;0;0;0
109;09.11.2015;2015;11;04;Maanantai;0;2;2;0;0;0
109;09.11.2015;2015;11;05;Maanantai;1;8;9;2;0;2
109;09.11.2015;2015;11;06;Maanantai;35;4;39;5;3;8
109;09.11.2015;2015;11;07;Maanantai;54;33;87;9;4;13
109;09.11.2015;2015;11;08;Maanantai;60;18;78;2;3;5
109;09.11.2015;2015;11;09;Maanantai;19;6;25;3;1;4
109;09.11.2015;2015;11;10;Maanantai;16;8;24;3;1;4
109;09.11.2015;2015;11;11;Maanantai;8;8;16;2;4;6
109;09.11.2015;2015;11;12;Maanantai;16;11;27;4;3;7
109;09.11.2015;2015;11;13;Maanantai;8;12;20;2;1;3
109;09.11.2015;2015;11;14;Maanantai;20;27;47;3;0;3
109;09.11.2015;2015;11;15;Maanantai;19;50;69;5;3;8
109;09.11.2015;2015;11;16;Maanantai;36;63;99;7;5;12
109;09.11.2015;2015;11;17;Maanantai;18;24;42;4;7;11
109;09.11.2015;2015;11;18;Maanantai;14;15;29;13;3;16
109;09.11.2015;2015;11;19;Maanantai;10;15;25;9;3;12
109;09.11.2015;2015;11;20;Maanantai;5;8;13;4;7;11
109;09.11.2015;2015;11;21;Maanantai;6;9;15;2;0;2
109;09.11.2015;2015;11;22;Maanantai;6;3;9;0;0;0
109;09.11.2015;2015;11;23;Maanantai;2;0;2;0;0;0
109;10.11.2015;2015;11;00;Tiistai;1;2;3;1;0;1
109;10.11.2015;2015;11;01;Tiistai;0;0;0;0;0;0
109;10.11.2015;2015;11;02;Tiistai;0;0;0;0;0;0
109;10.11.2015;2015;11;03;Tiistai;0;0;0;0;0;0
109;10.11.2015;2015;11;04;Tiistai;1;0;1;0;0;0
109;10.11.2015;2015;11;05;Tiistai;2;6;8;0;0;0
109;10.11.2015;2015;11;06;Tiistai;23;4;27;3;2;5
109;10.11.2015;2015;11;07;Tiistai;47;24;71;4;1;5
109;10.11.2015;2015;11;08;Tiistai;40;9;49;0;2;2
109;10.11.2015;2015;11;09;Tiistai;14;5;19;2;2;4
109;10.11.2015;2015;11;10;Tiistai;8;8;16;0;0;0
109;10.11.2015;2015;11;11;Tiistai;12;1;13;0;1;1
109;10.11.2015;2015;11;12;Tiistai;11;6;17;1;0;1
109;10.11.2015;2015;11;13;Tiistai;6;6;12;3;0;3
109;10.11.2015;2015;11;14;Tiistai;12;5;17;2;1;3
109;10.11.2015;2015;11;15;Tiistai;24;27;51;4;1;5
109;10.11.2015;2015;11;16;Tiistai;28;34;62;4;2;6
109;10.11.2015;2015;11;17;Tiistai;16;16;32;2;3;5
109;10.11.2015;2015;11;18;Tiistai;8;18;26;5;1;6
109;10.11.2015;2015;11;19;Tiistai;13;5;18;3;1;4
109;10.11.2015;2015;11;20;Tiistai;5;4;9;6;5;11
109;10.11.2015;2015;11;21;Tiistai;2;17;19;2;3;5
109;10.11.2015;2015;11;22;Tiistai;9;3;12;1;1;2
109;10.11.2015;2015;11;23;Tiistai;0;0;0;0;0;0
109;11.11.2015;2015;11;00;Keskiviikko;1;2;3;0;0;0
109;11.11.2015;2015;11;01;Keskiviikko;1;0;1;0;0;0
109;11.11.2015;2015;11;02;Keskiviikko;0;0;0;0;1;1
109;11.11.2015;2015;11;03;Keskiviikko;0;0;0;0;0;0
109;11.11.2015;2015;11;04;Keskiviikko;0;0;0;0;0;0
109;11.11.2015;2015;11;05;Keskiviikko;3;7;10;0;0;0
109;11.11.2015;2015;11;06;Keskiviikko;29;9;38;6;2;8
109;11.11.2015;2015;11;07;Keskiviikko;43;19;62;5;1;6
109;11.11.2015;2015;11;08;Keskiviikko;47;21;68;3;0;3
109;11.11.2015;2015;11;09;Keskiviikko;13;4;17;6;6;12
109;11.11.2015;2015;11;10;Keskiviikko;15;9;24;2;3;5
109;11.11.2015;2015;11;11;Keskiviikko;10;10;20;3;2;5
109;11.11.2015;2015;11;12;Keskiviikko;19;8;27;3;2;5
109;11.11.2015;2015;11;13;Keskiviikko;9;13;22;0;2;2
109;11.11.2015;2015;11;14;Keskiviikko;19;22;41;0;3;3
109;11.11.2015;2015;11;15;Keskiviikko;22;40;62;8;2;10
109;11.11.2015;2015;11;16;Keskiviikko;31;52;83;3;5;8
109;11.11.2015;2015;11;17;Keskiviikko;19;29;48;5;6;11
109;11.11.2015;2015;11;18;Keskiviikko;11;15;26;7;7;14
109;11.11.2015;2015;11;19;Keskiviikko;7;16;23;8;3;11
109;11.11.2015;2015;11;20;Keskiviikko;3;10;13;2;3;5
109;11.11.2015;2015;11;21;Keskiviikko;5;12;17;1;5;6
109;11.11.2015;2015;11;22;Keskiviikko;5;3;8;2;1;3
109;11.11.2015;2015;11;23;Keskiviikko;3;2;5;1;2;3
109;12.11.2015;2015;11;00;Torstai;2;1;3;1;1;2
109;12.11.2015;2015;11;01;Torstai;0;0;0;0;0;0
109;12.11.2015;2015;11;02;Torstai;0;2;2;0;0;0
109;12.11.2015;2015;11;03;Torstai;0;0;0;0;0;0
109;12.11.2015;2015;11;04;Torstai;0;0;0;0;0;0
109;12.11.2015;2015;11;05;Torstai;3;7;10;2;0;2
109;12.11.2015;2015;11;06;Torstai;30;10;40;6;2;8
109;12.11.2015;2015;11;07;Torstai;51;25;76;2;8;10
109;12.11.2015;2015;11;08;Torstai;46;17;63;3;1;4
109;12.11.2015;2015;11;09;Torstai;19;6;25;1;0;1
109;12.11.2015;2015;11;10;Torstai;8;9;17;4;1;5
109;12.11.2015;2015;11;11;Torstai;14;4;18;3;1;4
109;12.11.2015;2015;11;12;Torstai;10;14;24;1;2;3
109;12.11.2015;2015;11;13;Torstai;4;12;16;1;2;3
109;12.11.2015;2015;11;14;Torstai;13;19;32;3;3;6
109;12.11.2015;2015;11;15;Torstai;22;58;80;2;3;5
109;12.11.2015;2015;11;16;Torstai;32;44;76;7;1;8
109;12.11.2015;2015;11;17;Torstai;12;22;34;4;5;9
109;12.11.2015;2015;11;18;Torstai;10;11;21;4;1;5
109;12.11.2015;2015;11;19;Torstai;7;4;11;0;0;0
109;12.11.2015;2015;11;20;Torstai;9;6;15;0;0;0
109;12.11.2015;2015;11;21;Torstai;7;5;12;1;0;1
109;12.11.2015;2015;11;22;Torstai;5;2;7;0;0;0
109;12.11.2015;2015;11;23;Torstai;3;2;5;0;0;0
109;13.11.2015;2015;11;00;Perjantai;1;0;1;0;0;0
109;13.11.2015;2015;11;01;Perjantai;0;0;0;0;0;0
109;13.11.2015;2015;11;02;Perjantai;0;0;0;0;0;0
109;13.11.2015;2015;11;03;Perjantai;0;0;0;0;0;0
109;13.11.2015;2015;11;04;Perjantai;1;0;1;0;0;0
109;13.11.2015;2015;11;05;Perjantai;3;3;6;0;0;0
109;13.11.2015;2015;11;06;Perjantai;16;14;30;0;0;0
109;13.11.2015;2015;11;07;Perjantai;56;21;77;4;1;5
109;13.11.2015;2015;11;08;Perjantai;34;10;44;2;1;3
109;13.11.2015;2015;11;09;Perjantai;21;6;27;1;1;2
109;13.11.2015;2015;11;10;Perjantai;13;6;19;1;2;3
109;13.11.2015;2015;11;11;Perjantai;18;4;22;1;2;3
109;13.11.2015;2015;11;12;Perjantai;11;12;23;3;1;4
109;13.11.2015;2015;11;13;Perjantai;19;24;43;4;1;5
109;13.11.2015;2015;11;14;Perjantai;15;32;47;1;3;4
109;13.11.2015;2015;11;15;Perjantai;22;33;55;10;5;15
109;13.11.2015;2015;11;16;Perjantai;17;31;48;5;7;12
109;13.11.2015;2015;11;17;Perjantai;5;19;24;5;1;6
109;13.11.2015;2015;11;18;Perjantai;5;7;12;2;2;4
109;13.11.2015;2015;11;19;Perjantai;6;10;16;4;2;6
109;13.11.2015;2015;11;20;Perjantai;5;0;5;2;3;5
109;13.11.2015;2015;11;21;Perjantai;2;4;6;2;4;6
109;13.11.2015;2015;11;22;Perjantai;5;4;9;0;0;0
109;13.11.2015;2015;11;23;Perjantai;2;2;4;2;2;4
109;14.11.2015;2015;11;00;Lauantai;3;1;4;0;0;0
109;14.11.2015;2015;11;01;Lauantai;0;1;1;0;0;0
109;14.11.2015;2015;11;02;Lauantai;0;0;0;0;0;0
109;14.11.2015;2015;11;03;Lauantai;1;2;3;0;0;0
109;14.11.2015;2015;11;04;Lauantai;0;2;2;0;0;0
109;14.11.2015;2015;11;05;Lauantai;0;0;0;0;0;0
109;14.11.2015;2015;11;06;Lauantai;3;1;4;1;0;1
109;14.11.2015;2015;11;07;Lauantai;2;3;5;1;1;2
109;14.11.2015;2015;11;08;Lauantai;2;5;7;1;4;5
109;14.11.2015;2015;11;09;Lauantai;0;3;3;5;3;8
109;14.11.2015;2015;11;10;Lauantai;0;2;2;3;1;4
109;14.11.2015;2015;11;11;Lauantai;7;4;11;6;4;10
109;14.11.2015;2015;11;12;Lauantai;6;6;12;7;6;13
109;14.11.2015;2015;11;13;Lauantai;1;4;5;0;1;1
109;14.11.2015;2015;11;14;Lauantai;5;1;6;0;2;2
109;14.11.2015;2015;11;15;Lauantai;3;5;8;0;4;4
109;14.11.2015;2015;11;16;Lauantai;9;7;16;6;3;9
109;14.11.2015;2015;11;17;Lauantai;1;3;4;5;3;8
109;14.11.2015;2015;11;18;Lauantai;7;4;11;1;1;2
109;14.11.2015;2015;11;19;Lauantai;7;12;19;5;7;12
109;14.11.2015;2015;11;20;Lauantai;5;4;9;1;2;3
109;14.11.2015;2015;11;21;Lauantai;2;5;7;2;0;2
109;14.11.2015;2015;11;22;Lauantai;0;2;2;1;0;1
109;14.11.2015;2015;11;23;Lauantai;0;2;2;1;0;1
109;15.11.2015;2015;11;00;Sunnuntai;2;1;3;3;0;3
109;15.11.2015;2015;11;01;Sunnuntai;1;1;2;0;0;0
109;15.11.2015;2015;11;02;Sunnuntai;0;2;2;0;0;0
109;15.11.2015;2015;11;03;Sunnuntai;1;4;5;0;0;0
109;15.11.2015;2015;11;04;Sunnuntai;1;2;3;0;0;0
109;15.11.2015;2015;11;05;Sunnuntai;0;0;0;0;0;0
109;15.11.2015;2015;11;06;Sunnuntai;4;0;4;0;1;1
109;15.11.2015;2015;11;07;Sunnuntai;0;1;1;5;2;7
109;15.11.2015;2015;11;08;Sunnuntai;1;1;2;4;1;5
109;15.11.2015;2015;11;09;Sunnuntai;7;1;8;3;3;6
109;15.11.2015;2015;11;10;Sunnuntai;2;2;4;4;8;12
109;15.11.2015;2015;11;11;Sunnuntai;7;5;12;4;3;7
109;15.11.2015;2015;11;12;Sunnuntai;6;6;12;8;4;12
109;15.11.2015;2015;11;13;Sunnuntai;9;2;11;1;3;4
109;15.11.2015;2015;11;14;Sunnuntai;3;6;9;7;7;14
109;15.11.2015;2015;11;15;Sunnuntai;5;6;11;5;2;7
109;15.11.2015;2015;11;16;Sunnuntai;7;5;12;4;8;12
109;15.11.2015;2015;11;17;Sunnuntai;7;8;15;8;1;9
109;15.11.2015;2015;11;18;Sunnuntai;5;5;10;10;4;14
109;15.11.2015;2015;11;19;Sunnuntai;2;4;6;2;0;2
109;15.11.2015;2015;11;20;Sunnuntai;2;2;4;3;1;4
109;15.11.2015;2015;11;21;Sunnuntai;5;6;11;5;1;6
109;15.11.2015;2015;11;22;Sunnuntai;1;0;1;0;0;0
109;15.11.2015;2015;11;23;Sunnuntai;0;0;0;0;0;0
109;16.11.2015;2015;11;00;Maanantai;0;0;0;0;0;0
109;16.11.2015;2015;11;01;Maanantai;0;0;0;0;0;0
109;16.11.2015;2015;11;02;Maanantai;0;0;0;0;0;0
109;16.11.2015;2015;11;03;Maanantai;0;0;0;0;0;0
109;16.11.2015;2015;11;04;Maanantai;1;0;1;0;0;0
109;16.11.2015;2015;11;05;Maanantai;5;3;8;0;0;0
109;16.11.2015;2015;11;06;Maanantai;21;11;32;4;1;5
109;16.11.2015;2015;11;07;Maanantai;49;40;89;0;0;0
109;16.11.2015;2015;11;08;Maanantai;44;41;85;1;0;1
109;16.11.2015;2015;11;09;Maanantai;18;9;27;0;0;0
109;16.11.2015;2015;11;10;Maanantai;17;2;19;1;0;1
109;16.11.2015;2015;11;11;Maanantai;10;8;18;5;1;6
109;16.11.2015;2015;11;12;Maanantai;14;14;28;7;5;12
109;16.11.2015;2015;11;13;Maanantai;14;9;23;2;3;5
109;16.11.2015;2015;11;14;Maanantai;16;24;40;1;3;4
109;16.11.2015;2015;11;15;Maanantai;21;50;71;3;5;8
109;16.11.2015;2015;11;16;Maanantai;36;58;94;6;8;14
109;16.11.2015;2015;11;17;Maanantai;21;30;51;6;3;9
109;16.11.2015;2015;11;18;Maanantai;13;13;26;9;5;14
109;16.11.2015;2015;11;19;Maanantai;6;7;13;7;4;11
109;16.11.2015;2015;11;20;Maanantai;3;5;8;2;9;11
109;16.11.2015;2015;11;21;Maanantai;3;14;17;5;1;6
109;16.11.2015;2015;11;22;Maanantai;8;3;11;0;0;0
109;16.11.2015;2015;11;23;Maanantai;2;1;3;1;0;1
109;17.11.2015;2015;11;00;Tiistai;1;0;1;1;0;1
109;17.11.2015;2015;11;01;Tiistai;1;0;1;0;0;0
109;17.11.2015;2015;11;02;Tiistai;0;0;0;0;0;0
109;17.11.2015;2015;11;03;Tiistai;0;0;0;0;0;0
109;17.11.2015;2015;11;04;Tiistai;0;1;1;0;0;0
109;17.11.2015;2015;11;05;Tiistai;1;6;7;2;0;2
109;17.11.2015;2015;11;06;Tiistai;29;9;38;6;4;10
109;17.11.2015;2015;11;07;Tiistai;69;33;102;3;5;8
109;17.11.2015;2015;11;08;Tiistai;54;16;70;4;2;6
109;17.11.2015;2015;11;09;Tiistai;19;5;24;0;2;2
109;17.11.2015;2015;11;10;Tiistai;8;12;20;6;4;10
109;17.11.2015;2015;11;11;Tiistai;12;9;21;3;2;5
109;17.11.2015;2015;11;12;Tiistai;17;7;24;2;2;4
109;17.11.2015;2015;11;13;Tiistai;8;14;22;5;0;5
109;17.11.2015;2015;11;14;Tiistai;8;26;34;3;0;3
109;17.11.2015;2015;11;15;Tiistai;15;38;53;4;1;5
109;17.11.2015;2015;11;16;Tiistai;29;55;84;2;2;4
109;17.11.2015;2015;11;17;Tiistai;17;24;41;2;4;6
109;17.11.2015;2015;11;18;Tiistai;11;9;20;1;0;1
109;17.11.2015;2015;11;19;Tiistai;7;6;13;0;0;0
109;17.11.2015;2015;11;20;Tiistai;6;5;11;0;0;0
109;17.11.2015;2015;11;21;Tiistai;6;3;9;0;0;0
109;17.11.2015;2015;11;22;Tiistai;8;4;12;0;0;0
109;17.11.2015;2015;11;23;Tiistai;3;0;3;0;0;0
109;18.11.2015;2015;11;00;Keskiviikko;1;3;4;0;0;0
109;18.11.2015;2015;11;01;Keskiviikko;0;0;0;0;1;1
109;18.11.2015;2015;11;02;Keskiviikko;0;0;0;0;0;0
109;18.11.2015;2015;11;03;Keskiviikko;0;0;0;0;0;0
109;18.11.2015;2015;11;04;Keskiviikko;1;0;1;0;0;0
109;18.11.2015;2015;11;05;Keskiviikko;1;8;9;1;0;1
109;18.11.2015;2015;11;06;Keskiviikko;26;8;34;4;5;9
109;18.11.2015;2015;11;07;Keskiviikko;67;19;86;5;3;8
109;18.11.2015;2015;11;08;Keskiviikko;62;15;77;6;3;9
109;18.11.2015;2015;11;09;Keskiviikko;17;8;25;3;0;3
109;18.11.2015;2015;11;10;Keskiviikko;20;6;26;6;2;8
109;18.11.2015;2015;11;11;Keskiviikko;10;14;24;6;3;9
109;18.11.2015;2015;11;12;Keskiviikko;14;11;25;1;2;3
109;18.11.2015;2015;11;13;Keskiviikko;13;21;34;2;4;6
109;18.11.2015;2015;11;14;Keskiviikko;8;21;29;4;3;7
109;18.11.2015;2015;11;15;Keskiviikko;17;47;64;7;2;9
109;18.11.2015;2015;11;16;Keskiviikko;24;57;81;11;2;13
109;18.11.2015;2015;11;17;Keskiviikko;9;26;35;7;2;9
109;18.11.2015;2015;11;18;Keskiviikko;15;14;29;6;1;7
109;18.11.2015;2015;11;19;Keskiviikko;5;7;12;10;5;15
109;18.11.2015;2015;11;20;Keskiviikko;5;12;17;4;6;10
109;18.11.2015;2015;11;21;Keskiviikko;3;11;14;1;1;2
109;18.11.2015;2015;11;22;Keskiviikko;8;3;11;3;1;4
109;18.11.2015;2015;11;23;Keskiviikko;2;3;5;0;2;2
109;19.11.2015;2015;11;00;Torstai;3;1;4;0;0;0
109;19.11.2015;2015;11;01;Torstai;0;0;0;0;0;0
109;19.11.2015;2015;11;02;Torstai;0;0;0;0;0;0
109;19.11.2015;2015;11;03;Torstai;0;0;0;0;0;0
109;19.11.2015;2015;11;04;Torstai;0;1;1;0;0;0
109;19.11.2015;2015;11;05;Torstai;1;6;7;1;0;1
109;19.11.2015;2015;11;06;Torstai;27;9;36;4;3;7
109;19.11.2015;2015;11;07;Torstai;54;20;74;6;5;11
109;19.11.2015;2015;11;08;Torstai;67;19;86;3;1;4
109;19.11.2015;2015;11;09;Torstai;21;7;28;2;2;4
109;19.11.2015;2015;11;10;Torstai;14;10;24;3;4;7
109;19.11.2015;2015;11;11;Torstai;13;14;27;5;2;7
109;19.11.2015;2015;11;12;Torstai;12;10;22;1;1;2
109;19.11.2015;2015;11;13;Torstai;13;19;32;7;4;11
109;19.11.2015;2015;11;14;Torstai;16;14;30;4;2;6
109;19.11.2015;2015;11;15;Torstai;18;47;65;8;4;12
109;19.11.2015;2015;11;16;Torstai;29;46;75;4;4;8
109;19.11.2015;2015;11;17;Torstai;12;27;39;6;3;9
109;19.11.2015;2015;11;18;Torstai;9;15;24;7;2;9
109;19.11.2015;2015;11;19;Torstai;5;12;17;4;2;6
109;19.11.2015;2015;11;20;Torstai;5;7;12;2;2;4
109;19.11.2015;2015;11;21;Torstai;8;12;20;1;3;4
109;19.11.2015;2015;11;22;Torstai;6;3;9;3;0;3
109;19.11.2015;2015;11;23;Torstai;2;2;4;0;0;0
109;20.11.2015;2015;11;00;Perjantai;0;2;2;0;0;0
109;20.11.2015;2015;11;01;Perjantai;0;0;0;0;0;0
109;20.11.2015;2015;11;02;Perjantai;0;0;0;0;0;0
109;20.11.2015;2015;11;03;Perjantai;0;0;0;0;0;0
109;20.11.2015;2015;11;04;Perjantai;1;1;2;0;0;0
109;20.11.2015;2015;11;05;Perjantai;1;4;5;1;2;3
109;20.11.2015;2015;11;06;Perjantai;26;10;36;4;5;9
109;20.11.2015;2015;11;07;Perjantai;38;18;56;7;4;11
109;20.11.2015;2015;11;08;Perjantai;45;13;58;1;1;2
109;20.11.2015;2015;11;09;Perjantai;15;7;22;1;4;5
109;20.11.2015;2015;11;10;Perjantai;16;8;24;2;3;5
109;20.11.2015;2015;11;11;Perjantai;7;16;23;3;1;4
109;20.11.2015;2015;11;12;Perjantai;5;16;21;7;2;9
109;20.11.2015;2015;11;13;Perjantai;14;23;37;6;6;12
109;20.11.2015;2015;11;14;Perjantai;11;17;28;5;4;9
109;20.11.2015;2015;11;15;Perjantai;14;36;50;3;3;6
109;20.11.2015;2015;11;16;Perjantai;20;18;38;6;3;9
109;20.11.2015;2015;11;17;Perjantai;13;12;25;1;4;5
109;20.11.2015;2015;11;18;Perjantai;9;7;16;4;2;6
109;20.11.2015;2015;11;19;Perjantai;5;8;13;4;4;8
109;20.11.2015;2015;11;20;Perjantai;10;5;15;2;1;3
109;20.11.2015;2015;11;21;Perjantai;9;4;13;1;4;5
109;20.11.2015;2015;11;22;Perjantai;2;4;6;0;0;0
109;20.11.2015;2015;11;23;Perjantai;2;2;4;0;1;1
109;21.11.2015;2015;11;00;Lauantai;1;0;1;0;0;0
109;21.11.2015;2015;11;01;Lauantai;0;2;2;0;0;0
109;21.11.2015;2015;11;02;Lauantai;1;1;2;0;0;0
109;21.11.2015;2015;11;03;Lauantai;0;2;2;0;0;0
109;21.11.2015;2015;11;04;Lauantai;0;0;0;0;0;0
109;21.11.2015;2015;11;05;Lauantai;1;0;1;0;0;0
109;21.11.2015;2015;11;06;Lauantai;4;0;4;2;0;2
109;21.11.2015;2015;11;07;Lauantai;4;3;7;0;0;0
109;21.11.2015;2015;11;08;Lauantai;3;3;6;1;0;1
109;21.11.2015;2015;11;09;Lauantai;3;1;4;1;0;1
109;21.11.2015;2015;11;10;Lauantai;2;0;2;2;0;2
109;21.11.2015;2015;11;11;Lauantai;4;1;5;2;2;4
109;21.11.2015;2015;11;12;Lauantai;12;2;14;4;1;5
109;21.11.2015;2015;11;13;Lauantai;8;9;17;3;0;3
109;21.11.2015;2015;11;14;Lauantai;7;1;8;3;1;4
109;21.11.2015;2015;11;15;Lauantai;11;11;22;3;1;4
109;21.11.2015;2015;11;16;Lauantai;6;6;12;2;5;7
109;21.11.2015;2015;11;17;Lauantai;0;1;1;2;1;3
109;21.11.2015;2015;11;18;Lauantai;4;1;5;2;1;3
109;21.11.2015;2015;11;19;Lauantai;9;5;14;3;1;4
109;21.11.2015;2015;11;20;Lauantai;3;2;5;3;3;6
109;21.11.2015;2015;11;21;Lauantai;1;6;7;3;1;4
109;21.11.2015;2015;11;22;Lauantai;3;6;9;1;2;3
109;21.11.2015;2015;11;23;Lauantai;4;4;8;0;0;0
109;22.11.2015;2015;11;00;Sunnuntai;0;3;3;0;0;0
109;22.11.2015;2015;11;01;Sunnuntai;0;0;0;0;0;0
109;22.11.2015;2015;11;02;Sunnuntai;0;3;3;0;0;0
109;22.11.2015;2015;11;03;Sunnuntai;0;3;3;0;0;0
109;22.11.2015;2015;11;04;Sunnuntai;1;0;1;0;1;1
109;22.11.2015;2015;11;05;Sunnuntai;0;0;0;0;0;0
109;22.11.2015;2015;11;06;Sunnuntai;2;0;2;0;0;0
109;22.11.2015;2015;11;07;Sunnuntai;2;5;7;1;2;3
109;22.11.2015;2015;11;08;Sunnuntai;0;0;0;4;0;4
109;22.11.2015;2015;11;09;Sunnuntai;0;1;1;2;3;5
109;22.11.2015;2015;11;10;Sunnuntai;1;6;7;5;2;7
109;22.11.2015;2015;11;11;Sunnuntai;0;2;2;4;2;6
109;22.11.2015;2015;11;12;Sunnuntai;11;2;13;9;2;11
109;22.11.2015;2015;11;13;Sunnuntai;0;3;3;5;4;9
109;22.11.2015;2015;11;14;Sunnuntai;5;6;11;6;4;10
109;22.11.2015;2015;11;15;Sunnuntai;5;7;12;3;1;4
109;22.11.2015;2015;11;16;Sunnuntai;7;1;8;1;4;5
109;22.11.2015;2015;11;17;Sunnuntai;7;6;13;7;2;9
109;22.11.2015;2015;11;18;Sunnuntai;5;7;12;5;0;5
109;22.11.2015;2015;11;19;Sunnuntai;4;3;7;4;2;6
109;22.11.2015;2015;11;20;Sunnuntai;3;5;8;3;4;7
109;22.11.2015;2015;11;21;Sunnuntai;2;10;12;2;1;3
109;22.11.2015;2015;11;22;Sunnuntai;0;3;3;1;1;2
109;22.11.2015;2015;11;23;Sunnuntai;0;0;0;0;1;1
109;23.11.2015;2015;11;00;Maanantai;0;0;0;0;0;0
109;23.11.2015;2015;11;01;Maanantai;0;0;0;0;0;0
109;23.11.2015;2015;11;02;Maanantai;0;0;0;0;0;0
109;23.11.2015;2015;11;03;Maanantai;0;1;1;0;0;0
109;23.11.2015;2015;11;04;Maanantai;0;1;1;0;0;0
109;23.11.2015;2015;11;05;Maanantai;1;7;8;2;0;2
109;23.11.2015;2015;11;06;Maanantai;31;7;38;5;4;9
109;23.11.2015;2015;11;07;Maanantai;56;20;76;6;4;10
109;23.11.2015;2015;11;08;Maanantai;56;21;77;4;1;5
109;23.11.2015;2015;11;09;Maanantai;10;13;23;1;2;3
109;23.11.2015;2015;11;10;Maanantai;11;5;16;8;8;16
109;23.11.2015;2015;11;11;Maanantai;7;6;13;5;6;11
109;23.11.2015;2015;11;12;Maanantai;10;8;18;3;2;5
109;23.11.2015;2015;11;13;Maanantai;6;16;22;2;0;2
109;23.11.2015;2015;11;14;Maanantai;10;17;27;4;5;9
109;23.11.2015;2015;11;15;Maanantai;17;47;64;7;4;11
109;23.11.2015;2015;11;16;Maanantai;34;48;82;3;8;11
109;23.11.2015;2015;11;17;Maanantai;8;35;43;3;2;5
109;23.11.2015;2015;11;18;Maanantai;11;21;32;12;6;18
109;23.11.2015;2015;11;19;Maanantai;6;12;18;6;3;9
109;23.11.2015;2015;11;20;Maanantai;5;7;12;3;4;7
109;23.11.2015;2015;11;21;Maanantai;2;3;5;2;1;3
109;23.11.2015;2015;11;22;Maanantai;8;4;12;2;1;3
109;23.11.2015;2015;11;23;Maanantai;2;0;2;1;3;4
109;24.11.2015;2015;11;00;Tiistai;2;0;2;0;0;0
109;24.11.2015;2015;11;01;Tiistai;0;0;0;0;0;0
109;24.11.2015;2015;11;02;Tiistai;0;0;0;0;0;0
109;24.11.2015;2015;11;03;Tiistai;0;2;2;0;0;0
109;24.11.2015;2015;11;04;Tiistai;1;1;2;0;0;0
109;24.11.2015;2015;11;05;Tiistai;0;6;6;2;0;2
109;24.11.2015;2015;11;06;Tiistai;33;12;45;5;3;8
109;24.11.2015;2015;11;07;Tiistai;56;34;90;6;2;8
109;24.11.2015;2015;11;08;Tiistai;51;22;73;6;2;8
109;24.11.2015;2015;11;09;Tiistai;13;7;20;6;2;8
109;24.11.2015;2015;11;10;Tiistai;6;5;11;10;3;13
109;24.11.2015;2015;11;11;Tiistai;9;17;26;4;6;10
109;24.11.2015;2015;11;12;Tiistai;11;10;21;5;1;6
109;24.11.2015;2015;11;13;Tiistai;16;16;32;2;4;6
109;24.11.2015;2015;11;14;Tiistai;12;22;34;0;8;8
109;24.11.2015;2015;11;15;Tiistai;19;44;63;3;1;4
109;24.11.2015;2015;11;16;Tiistai;40;61;101;2;5;7
109;24.11.2015;2015;11;17;Tiistai;10;21;31;11;2;13
109;24.11.2015;2015;11;18;Tiistai;10;10;20;6;5;11
109;24.11.2015;2015;11;19;Tiistai;4;8;12;10;6;16
109;24.11.2015;2015;11;20;Tiistai;4;5;9;2;3;5
109;24.11.2015;2015;11;21;Tiistai;4;7;11;2;2;4
109;24.11.2015;2015;11;22;Tiistai;9;4;13;1;0;1
109;24.11.2015;2015;11;23;Tiistai;1;0;1;0;1;1
109;25.11.2015;2015;11;00;Keskiviikko;2;1;3;0;0;0
109;25.11.2015;2015;11;01;Keskiviikko;1;0;1;0;0;0
109;25.11.2015;2015;11;02;Keskiviikko;0;0;0;0;0;0
109;25.11.2015;2015;11;03;Keskiviikko;0;2;2;0;0;0
109;25.11.2015;2015;11;04;Keskiviikko;1;0;1;0;0;0
109;25.11.2015;2015;11;05;Keskiviikko;1;4;5;1;0;1
109;25.11.2015;2015;11;06;Keskiviikko;27;11;38;2;3;5
109;25.11.2015;2015;11;07;Keskiviikko;42;24;66;4;5;9
109;25.11.2015;2015;11;08;Keskiviikko;37;11;48;1;0;1
109;25.11.2015;2015;11;09;Keskiviikko;9;2;11;2;4;6
109;25.11.2015;2015;11;10;Keskiviikko;8;6;14;6;3;9
109;25.11.2015;2015;11;11;Keskiviikko;7;3;10;4;2;6
109;25.11.2015;2015;11;12;Keskiviikko;8;6;14;4;3;7
109;25.11.2015;2015;11;13;Keskiviikko;9;20;29;1;4;5
109;25.11.2015;2015;11;14;Keskiviikko;9;23;32;3;4;7
109;25.11.2015;2015;11;15;Keskiviikko;12;42;54;2;3;5
109;25.11.2015;2015;11;16;Keskiviikko;18;52;70;4;3;7
109;25.11.2015;2015;11;17;Keskiviikko;15;24;39;5;2;7
109;25.11.2015;2015;11;18;Keskiviikko;10;12;22;5;4;9
109;25.11.2015;2015;11;19;Keskiviikko;4;5;9;6;2;8
109;25.11.2015;2015;11;20;Keskiviikko;2;7;9;2;3;5
109;25.11.2015;2015;11;21;Keskiviikko;3;7;10;1;4;5
109;25.11.2015;2015;11;22;Keskiviikko;4;8;12;0;0;0
109;25.11.2015;2015;11;23;Keskiviikko;0;0;0;0;0;0
109;26.11.2015;2015;11;00;Torstai;1;0;1;1;1;2
109;26.11.2015;2015;11;01;Torstai;0;0;0;0;0;0
109;26.11.2015;2015;11;02;Torstai;0;0;0;0;0;0
109;26.11.2015;2015;11;03;Torstai;0;0;0;0;0;0
109;26.11.2015;2015;11;04;Torstai;1;0;1;0;0;0
109;26.11.2015;2015;11;05;Torstai;0;5;5;1;0;1
109;26.11.2015;2015;11;06;Torstai;21;10;31;3;2;5
109;26.11.2015;2015;11;07;Torstai;45;19;64;3;4;7
109;26.11.2015;2015;11;08;Torstai;51;14;65;7;3;10
109;26.11.2015;2015;11;09;Torstai;14;5;19;4;2;6
109;26.11.2015;2015;11;10;Torstai;13;6;19;3;2;5
109;26.11.2015;2015;11;11;Torstai;10;11;21;4;1;5
109;26.11.2015;2015;11;12;Torstai;16;9;25;4;4;8
109;26.11.2015;2015;11;13;Torstai;9;12;21;2;3;5
109;26.11.2015;2015;11;14;Torstai;9;17;26;2;3;5
109;26.11.2015;2015;11;15;Torstai;21;37;58;3;4;7
109;26.11.2015;2015;11;16;Torstai;29;48;77;4;3;7
109;26.11.2015;2015;11;17;Torstai;11;29;40;6;2;8
109;26.11.2015;2015;11;18;Torstai;10;16;26;4;3;7
109;26.11.2015;2015;11;19;Torstai;11;9;20;10;4;14
109;26.11.2015;2015;11;20;Torstai;5;9;14;3;2;5
109;26.11.2015;2015;11;21;Torstai;1;5;6;1;2;3
109;26.11.2015;2015;11;22;Torstai;5;0;5;0;1;1
109;26.11.2015;2015;11;23;Torstai;2;1;3;1;1;2
109;27.11.2015;2015;11;00;Perjantai;0;0;0;0;0;0
109;27.11.2015;2015;11;01;Perjantai;0;0;0;0;0;0
109;27.11.2015;2015;11;02;Perjantai;0;1;1;0;0;0
109;27.11.2015;2015;11;03;Perjantai;2;1;3;0;0;0
109;27.11.2015;2015;11;04;Perjantai;1;0;1;0;1;1
109;27.11.2015;2015;11;05;Perjantai;2;5;7;1;0;1
109;27.11.2015;2015;11;06;Perjantai;13;9;22;2;3;5
109;27.11.2015;2015;11;07;Perjantai;31;13;44;5;6;11
109;27.11.2015;2015;11;08;Perjantai;38;16;54;5;1;6
109;27.11.2015;2015;11;09;Perjantai;6;6;12;4;4;8
109;27.11.2015;2015;11;10;Perjantai;11;2;13;5;0;5
109;27.11.2015;2015;11;11;Perjantai;6;7;13;6;1;7
109;27.11.2015;2015;11;12;Perjantai;13;12;25;1;1;2
109;27.11.2015;2015;11;13;Perjantai;8;16;24;10;5;15
109;27.11.2015;2015;11;14;Perjantai;9;15;24;8;2;10
109;27.11.2015;2015;11;15;Perjantai;21;27;48;4;2;6
109;27.11.2015;2015;11;16;Perjantai;17;26;43;5;2;7
109;27.11.2015;2015;11;17;Perjantai;12;12;24;2;3;5
109;27.11.2015;2015;11;18;Perjantai;4;4;8;2;2;4
109;27.11.2015;2015;11;19;Perjantai;4;7;11;3;0;3
109;27.11.2015;2015;11;20;Perjantai;4;4;8;1;4;5
109;27.11.2015;2015;11;21;Perjantai;6;5;11;1;1;2
109;27.11.2015;2015;11;22;Perjantai;4;2;6;2;1;3
109;27.11.2015;2015;11;23;Perjantai;1;1;2;0;1;1
109;28.11.2015;2015;11;00;Lauantai;1;2;3;1;0;1
109;28.11.2015;2015;11;01;Lauantai;0;0;0;0;0;0
109;28.11.2015;2015;11;02;Lauantai;0;0;0;2;0;2
109;28.11.2015;2015;11;03;Lauantai;0;0;0;0;0;0
109;28.11.2015;2015;11;04;Lauantai;0;1;1;0;0;0
109;28.11.2015;2015;11;05;Lauantai;1;1;2;0;0;0
109;28.11.2015;2015;11;06;Lauantai;5;2;7;1;0;1
109;28.11.2015;2015;11;07;Lauantai;2;1;3;3;2;5
109;28.11.2015;2015;11;08;Lauantai;3;0;3;0;0;0
109;28.11.2015;2015;11;09;Lauantai;4;3;7;3;1;4
109;28.11.2015;2015;11;10;Lauantai;7;5;12;2;4;6
109;28.11.2015;2015;11;11;Lauantai;0;3;3;2;3;5
109;28.11.2015;2015;11;12;Lauantai;5;5;10;1;0;1
109;28.11.2015;2015;11;13;Lauantai;7;6;13;2;0;2
109;28.11.2015;2015;11;14;Lauantai;3;7;10;0;2;2
109;28.11.2015;2015;11;15;Lauantai;2;6;8;2;1;3
109;28.11.2015;2015;11;16;Lauantai;5;4;9;3;1;4
109;28.11.2015;2015;11;17;Lauantai;1;3;4;3;3;6
109;28.11.2015;2015;11;18;Lauantai;3;2;5;3;2;5
109;28.11.2015;2015;11;19;Lauantai;5;4;9;1;0;1
109;28.11.2015;2015;11;20;Lauantai;2;1;3;2;0;2
109;28.11.2015;2015;11;21;Lauantai;1;5;6;1;0;1
109;28.11.2015;2015;11;22;Lauantai;2;1;3;0;2;2
109;28.11.2015;2015;11;23;Lauantai;1;2;3;0;1;1
109;29.11.2015;2015;11;00;Sunnuntai;0;2;2;1;0;1
109;29.11.2015;2015;11;01;Sunnuntai;0;1;1;0;0;0
109;29.11.2015;2015;11;02;Sunnuntai;1;0;1;0;1;1
109;29.11.2015;2015;11;03;Sunnuntai;0;1;1;0;1;1
109;29.11.2015;2015;11;04;Sunnuntai;0;1;1;0;0;0
109;29.11.2015;2015;11;05;Sunnuntai;1;0;1;0;0;0
109;29.11.2015;2015;11;06;Sunnuntai;1;1;2;0;1;1
109;29.11.2015;2015;11;07;Sunnuntai;1;3;4;2;1;3
109;29.11.2015;2015;11;08;Sunnuntai;1;1;2;2;1;3
109;29.11.2015;2015;11;09;Sunnuntai;6;4;10;8;7;15
109;29.11.2015;2015;11;10;Sunnuntai;7;2;9;12;7;19
109;29.11.2015;2015;11;11;Sunnuntai;3;8;11;6;8;14
109;29.11.2015;2015;11;12;Sunnuntai;9;8;17;8;1;9
109;29.11.2015;2015;11;13;Sunnuntai;9;5;14;12;1;13
109;29.11.2015;2015;11;14;Sunnuntai;11;6;17;7;6;13
109;29.11.2015;2015;11;15;Sunnuntai;7;4;11;6;6;12
109;29.11.2015;2015;11;16;Sunnuntai;10;2;12;10;2;12
109;29.11.2015;2015;11;17;Sunnuntai;8;6;14;8;7;15
109;29.11.2015;2015;11;18;Sunnuntai;4;9;13;5;2;7
109;29.11.2015;2015;11;19;Sunnuntai;6;6;12;4;3;7
109;29.11.2015;2015;11;20;Sunnuntai;3;1;4;4;4;8
109;29.11.2015;2015;11;21;Sunnuntai;2;9;11;1;1;2
109;29.11.2015;2015;11;22;Sunnuntai;2;3;5;1;1;2
109;29.11.2015;2015;11;23;Sunnuntai;0;1;1;0;0;0
109;30.11.2015;2015;11;00;Maanantai;1;0;1;1;0;1
109;30.11.2015;2015;11;01;Maanantai;0;0;0;0;1;1
109;30.11.2015;2015;11;02;Maanantai;0;0;0;0;1;1
109;30.11.2015;2015;11;03;Maanantai;0;0;0;0;0;0
109;30.11.2015;2015;11;04;Maanantai;0;0;0;0;0;0
109;30.11.2015;2015;11;05;Maanantai;1;4;5;3;2;5
109;30.11.2015;2015;11;06;Maanantai;24;7;31;2;2;4
109;30.11.2015;2015;11;07;Maanantai;48;21;69;6;5;11
109;30.11.2015;2015;11;08;Maanantai;54;11;65;5;2;7
109;30.11.2015;2015;11;09;Maanantai;15;7;22;1;2;3
109;30.11.2015;2015;11;10;Maanantai;8;4;12;1;5;6
109;30.11.2015;2015;11;11;Maanantai;7;5;12;5;1;6
109;30.11.2015;2015;11;12;Maanantai;21;7;28;3;1;4
109;30.11.2015;2015;11;13;Maanantai;12;15;27;2;3;5
109;30.11.2015;2015;11;14;Maanantai;7;20;27;5;5;10
109;30.11.2015;2015;11;15;Maanantai;10;50;60;11;2;13
109;30.11.2015;2015;11;16;Maanantai;34;40;74;3;4;7
109;30.11.2015;2015;11;17;Maanantai;12;29;41;2;1;3
109;30.11.2015;2015;11;18;Maanantai;9;13;22;6;1;7
109;30.11.2015;2015;11;19;Maanantai;6;9;15;7;9;16
109;30.11.2015;2015;11;20;Maanantai;7;6;13;3;3;6
109;30.11.2015;2015;11;21;Maanantai;2;8;10;1;1;2
109;30.11.2015;2015;11;22;Maanantai;6;3;9;2;1;3
109;30.11.2015;2015;11;23;Maanantai;1;0;1;0;0;0
109;01.12.2015;2015;12;00;Tiistai;1;0;1;0;0;0
109;01.12.2015;2015;12;01;Tiistai;1;0;1;0;1;1
109;01.12.2015;2015;12;02;Tiistai;0;0;0;0;0;0
109;01.12.2015;2015;12;03;Tiistai;0;0;0;0;0;0
109;01.12.2015;2015;12;04;Tiistai;1;0;1;0;0;0
109;01.12.2015;2015;12;05;Tiistai;0;4;4;2;0;2
109;01.12.2015;2015;12;06;Tiistai;31;4;35;7;3;10
109;01.12.2015;2015;12;07;Tiistai;56;19;75;6;5;11
109;01.12.2015;2015;12;08;Tiistai;47;12;59;2;0;2
109;01.12.2015;2015;12;09;Tiistai;17;6;23;6;2;8
109;01.12.2015;2015;12;10;Tiistai;8;5;13;3;4;7
109;01.12.2015;2015;12;11;Tiistai;13;7;20;1;1;2
109;01.12.2015;2015;12;12;Tiistai;7;6;13;4;2;6
109;01.12.2015;2015;12;13;Tiistai;10;11;21;2;3;5
109;01.12.2015;2015;12;14;Tiistai;8;18;26;4;4;8
109;01.12.2015;2015;12;15;Tiistai;13;35;48;7;5;12
109;01.12.2015;2015;12;16;Tiistai;23;52;75;3;7;10
109;01.12.2015;2015;12;17;Tiistai;13;17;30;8;4;12
109;01.12.2015;2015;12;18;Tiistai;10;16;26;5;5;10
109;01.12.2015;2015;12;19;Tiistai;2;14;16;7;4;11
109;01.12.2015;2015;12;20;Tiistai;1;10;11;7;0;7
109;01.12.2015;2015;12;21;Tiistai;5;9;14;2;1;3
109;01.12.2015;2015;12;22;Tiistai;4;2;6;0;1;1
109;01.12.2015;2015;12;23;Tiistai;1;2;3;1;0;1
109;02.12.2015;2015;12;00;Keskiviikko;2;0;2;0;0;0
109;02.12.2015;2015;12;01;Keskiviikko;0;0;0;0;0;0
109;02.12.2015;2015;12;02;Keskiviikko;0;1;1;0;0;0
109;02.12.2015;2015;12;03;Keskiviikko;0;0;0;0;0;0
109;02.12.2015;2015;12;04;Keskiviikko;0;0;0;0;0;0
109;02.12.2015;2015;12;05;Keskiviikko;1;3;4;1;0;1
109;02.12.2015;2015;12;06;Keskiviikko;23;7;30;3;2;5
109;02.12.2015;2015;12;07;Keskiviikko;53;22;75;9;5;14
109;02.12.2015;2015;12;08;Keskiviikko;56;16;72;9;5;14
109;02.12.2015;2015;12;09;Keskiviikko;20;8;28;4;1;5
109;02.12.2015;2015;12;10;Keskiviikko;11;4;15;5;4;9
109;02.12.2015;2015;12;11;Keskiviikko;11;11;22;7;6;13
109;02.12.2015;2015;12;12;Keskiviikko;12;2;14;2;4;6
109;02.12.2015;2015;12;13;Keskiviikko;7;10;17;3;3;6
109;02.12.2015;2015;12;14;Keskiviikko;12;14;26;1;0;1
109;02.12.2015;2015;12;15;Keskiviikko;16;28;44;7;3;10
109;02.12.2015;2015;12;16;Keskiviikko;20;63;83;4;4;8
109;02.12.2015;2015;12;17;Keskiviikko;12;18;30;6;0;6
109;02.12.2015;2015;12;18;Keskiviikko;12;10;22;4;2;6
109;02.12.2015;2015;12;19;Keskiviikko;10;10;20;5;1;6
109;02.12.2015;2015;12;20;Keskiviikko;3;7;10;2;1;3
109;02.12.2015;2015;12;21;Keskiviikko;4;7;11;2;1;3
109;02.12.2015;2015;12;22;Keskiviikko;5;3;8;0;0;0
109;02.12.2015;2015;12;23;Keskiviikko;1;1;2;0;0;0
109;03.12.2015;2015;12;00;Torstai;1;0;1;1;1;2
109;03.12.2015;2015;12;01;Torstai;1;0;1;0;0;0
109;03.12.2015;2015;12;02;Torstai;0;0;0;0;0;0
109;03.12.2015;2015;12;03;Torstai;1;0;1;0;0;0
109;03.12.2015;2015;12;04;Torstai;0;0;0;0;0;0
109;03.12.2015;2015;12;05;Torstai;3;2;5;2;0;2
109;03.12.2015;2015;12;06;Torstai;26;9;35;1;1;2
109;03.12.2015;2015;12;07;Torstai;50;11;61;5;1;6
109;03.12.2015;2015;12;08;Torstai;58;18;76;7;3;10
109;03.12.2015;2015;12;09;Torstai;12;10;22;4;2;6
109;03.12.2015;2015;12;10;Torstai;8;4;12;3;2;5
109;03.12.2015;2015;12;11;Torstai;11;7;18;4;1;5
109;03.12.2015;2015;12;12;Torstai;6;5;11;4;4;8
109;03.12.2015;2015;12;13;Torstai;10;10;20;2;3;5
109;03.12.2015;2015;12;14;Torstai;13;10;23;2;3;5
109;03.12.2015;2015;12;15;Torstai;16;34;50;3;4;7
109;03.12.2015;2015;12;16;Torstai;19;57;76;4;3;7
109;03.12.2015;2015;12;17;Torstai;10;20;30;6;2;8
109;03.12.2015;2015;12;18;Torstai;10;8;18;4;3;7
109;03.12.2015;2015;12;19;Torstai;7;5;12;10;4;14
109;03.12.2015;2015;12;20;Torstai;7;4;11;3;2;5
109;03.12.2015;2015;12;21;Torstai;5;2;7;1;2;3
109;03.12.2015;2015;12;22;Torstai;4;2;6;0;1;1
109;03.12.2015;2015;12;23;Torstai;4;1;5;1;1;2
109;04.12.2015;2015;12;00;Perjantai;0;1;1;0;0;0
109;04.12.2015;2015;12;01;Perjantai;1;0;1;0;0;0
109;04.12.2015;2015;12;02;Perjantai;1;0;1;0;0;0
109;04.12.2015;2015;12;03;Perjantai;0;0;0;0;0;0
109;04.12.2015;2015;12;04;Perjantai;2;0;2;0;1;1
109;04.12.2015;2015;12;05;Perjantai;4;2;6;1;0;1
109;04.12.2015;2015;12;06;Perjantai;27;6;33;2;3;5
109;04.12.2015;2015;12;07;Perjantai;37;13;50;5;6;11
109;04.12.2015;2015;12;08;Perjantai;37;14;51;5;1;6
109;04.12.2015;2015;12;09;Perjantai;9;7;16;4;4;8
109;04.12.2015;2015;12;10;Perjantai;8;6;14;5;0;5
109;04.12.2015;2015;12;11;Perjantai;9;8;17;6;1;7
109;04.12.2015;2015;12;12;Perjantai;10;9;19;1;1;2
109;04.12.2015;2015;12;13;Perjantai;11;9;20;10;5;15
109;04.12.2015;2015;12;14;Perjantai;19;16;35;8;2;10
109;04.12.2015;2015;12;15;Perjantai;15;33;48;4;2;6
109;04.12.2015;2015;12;16;Perjantai;17;34;51;5;2;7
109;04.12.2015;2015;12;17;Perjantai;10;14;24;2;3;5
109;04.12.2015;2015;12;18;Perjantai;6;3;9;2;2;4
109;04.12.2015;2015;12;19;Perjantai;3;1;4;3;0;3
109;04.12.2015;2015;12;20;Perjantai;5;4;9;1;4;5
109;04.12.2015;2015;12;21;Perjantai;3;1;4;1;1;2
109;04.12.2015;2015;12;22;Perjantai;5;4;9;2;1;3
109;04.12.2015;2015;12;23;Perjantai;2;0;2;0;1;1
109;05.12.2015;2015;12;00;Lauantai;1;1;2;1;0;1
109;05.12.2015;2015;12;01;Lauantai;0;0;0;0;0;0
109;05.12.2015;2015;12;02;Lauantai;0;0;0;2;0;2
109;05.12.2015;2015;12;03;Lauantai;0;0;0;0;0;0
109;05.12.2015;2015;12;04;Lauantai;1;0;1;0;0;0
109;05.12.2015;2015;12;05;Lauantai;1;0;1;0;0;0
109;05.12.2015;2015;12;06;Lauantai;3;1;4;1;0;1
109;05.12.2015;2015;12;07;Lauantai;2;0;2;3;2;5
109;05.12.2015;2015;12;08;Lauantai;1;0;1;0;0;0
109;05.12.2015;2015;12;09;Lauantai;3;2;5;3;1;4
109;05.12.2015;2015;12;10;Lauantai;7;5;12;2;4;6
109;05.12.2015;2015;12;11;Lauantai;4;3;7;2;3;5
109;05.12.2015;2015;12;12;Lauantai;6;4;10;1;0;1
109;05.12.2015;2015;12;13;Lauantai;6;6;12;2;0;2
109;05.12.2015;2015;12;14;Lauantai;6;4;10;0;2;2
109;05.12.2015;2015;12;15;Lauantai;6;4;10;2;1;3
109;05.12.2015;2015;12;16;Lauantai;5;4;9;3;1;4
109;05.12.2015;2015;12;17;Lauantai;4;3;7;3;3;6
109;05.12.2015;2015;12;18;Lauantai;5;0;5;3;2;5
109;05.12.2015;2015;12;19;Lauantai;4;2;6;1;2;3
109;05.12.2015;2015;12;20;Lauantai;2;1;3;1;2;3
109;05.12.2015;2015;12;21;Lauantai;0;2;2;1;2;3
109;05.12.2015;2015;12;22;Lauantai;0;2;2;2;1;3
109;05.12.2015;2015;12;23;Lauantai;4;1;5;0;0;0
109;06.12.2015;2015;12;00;Sunnuntai;1;0;1;0;1;1
109;06.12.2015;2015;12;01;Sunnuntai;0;0;0;0;0;0
109;06.12.2015;2015;12;02;Sunnuntai;0;2;2;0;1;1
109;06.12.2015;2015;12;03;Sunnuntai;0;5;5;0;1;1
109;06.12.2015;2015;12;04;Sunnuntai;0;2;2;0;0;0
109;06.12.2015;2015;12;05;Sunnuntai;0;0;0;1;0;1
109;06.12.2015;2015;12;06;Sunnuntai;2;1;3;0;0;0
109;06.12.2015;2015;12;07;Sunnuntai;1;0;1;4;2;6
109;06.12.2015;2015;12;08;Sunnuntai;1;0;1;4;1;5
109;06.12.2015;2015;12;09;Sunnuntai;5;3;8;4;1;5
109;06.12.2015;2015;12;10;Sunnuntai;0;1;1;8;2;10
109;06.12.2015;2015;12;11;Sunnuntai;4;1;5;8;4;12
109;06.12.2015;2015;12;12;Sunnuntai;0;2;2;6;4;10
109;06.12.2015;2015;12;13;Sunnuntai;2;1;3;3;1;4
109;06.12.2015;2015;12;14;Sunnuntai;11;10;21;7;3;10
109;06.12.2015;2015;12;15;Sunnuntai;4;10;14;6;5;11
109;06.12.2015;2015;12;16;Sunnuntai;4;2;6;11;7;18
109;06.12.2015;2015;12;17;Sunnuntai;2;4;6;4;1;5
109;06.12.2015;2015;12;18;Sunnuntai;3;0;3;1;5;6
109;06.12.2015;2015;12;19;Sunnuntai;2;1;3;5;1;6
109;06.12.2015;2015;12;20;Sunnuntai;2;0;2;1;1;2
109;06.12.2015;2015;12;21;Sunnuntai;1;1;2;3;1;4
109;06.12.2015;2015;12;22;Sunnuntai;1;2;3;1;1;2
109;06.12.2015;2015;12;23;Sunnuntai;0;1;1;0;0;0
109;07.12.2015;2015;12;00;Maanantai;0;2;2;1;0;1
109;07.12.2015;2015;12;01;Maanantai;0;0;0;0;3;3
109;07.12.2015;2015;12;02;Maanantai;0;0;0;0;1;1
109;07.12.2015;2015;12;03;Maanantai;0;0;0;0;0;0
109;07.12.2015;2015;12;04;Maanantai;0;0;0;0;0;0
109;07.12.2015;2015;12;05;Maanantai;0;3;3;2;1;3
109;07.12.2015;2015;12;06;Maanantai;12;5;17;3;2;5
109;07.12.2015;2015;12;07;Maanantai;34;26;60;7;2;9
109;07.12.2015;2015;12;08;Maanantai;30;16;46;5;2;7
109;07.12.2015;2015;12;09;Maanantai;14;11;25;2;3;5
109;07.12.2015;2015;12;10;Maanantai;5;3;8;2;2;4
109;07.12.2015;2015;12;11;Maanantai;7;1;8;1;1;2
109;07.12.2015;2015;12;12;Maanantai;15;2;17;3;1;4
109;07.12.2015;2015;12;13;Maanantai;8;9;17;3;1;4
109;07.12.2015;2015;12;14;Maanantai;9;13;22;7;3;10
109;07.12.2015;2015;12;15;Maanantai;14;29;43;5;3;8
109;07.12.2015;2015;12;16;Maanantai;20;25;45;3;5;8
109;07.12.2015;2015;12;17;Maanantai;14;13;27;4;2;6
109;07.12.2015;2015;12;18;Maanantai;8;7;15;8;6;14
109;07.12.2015;2015;12;19;Maanantai;6;10;16;5;3;8
109;07.12.2015;2015;12;20;Maanantai;5;5;10;1;2;3
109;07.12.2015;2015;12;21;Maanantai;4;4;8;0;0;0
109;07.12.2015;2015;12;22;Maanantai;15;2;17;1;1;2
109;07.12.2015;2015;12;23;Maanantai;0;0;0;0;0;0
109;08.12.2015;2015;12;00;Tiistai;0;0;0;1;0;1
109;08.12.2015;2015;12;01;Tiistai;0;0;0;0;2;2
109;08.12.2015;2015;12;02;Tiistai;0;0;0;0;0;0
109;08.12.2015;2015;12;03;Tiistai;0;0;0;0;0;0
109;08.12.2015;2015;12;04;Tiistai;0;0;0;0;0;0
109;08.12.2015;2015;12;05;Tiistai;2;5;7;3;0;3
109;08.12.2015;2015;12;06;Tiistai;25;6;31;1;1;2
109;08.12.2015;2015;12;07;Tiistai;44;17;61;3;2;5
109;08.12.2015;2015;12;08;Tiistai;32;9;41;3;3;6
109;08.12.2015;2015;12;09;Tiistai;16;7;23;1;0;1
109;08.12.2015;2015;12;10;Tiistai;11;4;15;4;6;10
109;08.12.2015;2015;12;11;Tiistai;3;5;8;3;4;7
109;08.12.2015;2015;12;12;Tiistai;7;7;14;4;1;5
109;08.12.2015;2015;12;13;Tiistai;5;11;16;5;2;7
109;08.12.2015;2015;12;14;Tiistai;14;6;20;1;1;2
109;08.12.2015;2015;12;15;Tiistai;14;29;43;3;3;6
109;08.12.2015;2015;12;16;Tiistai;15;44;59;4;1;5
109;08.12.2015;2015;12;17;Tiistai;14;13;27;3;5;8
109;08.12.2015;2015;12;18;Tiistai;9;15;24;6;3;9
109;08.12.2015;2015;12;19;Tiistai;4;3;7;6;4;10
109;08.12.2015;2015;12;20;Tiistai;3;4;7;3;1;4
109;08.12.2015;2015;12;21;Tiistai;2;11;13;2;3;5
109;08.12.2015;2015;12;22;Tiistai;8;3;11;1;0;1
109;08.12.2015;2015;12;23;Tiistai;0;2;2;0;2;2
109;09.12.2015;2015;12;00;Keskiviikko;2;0;2;0;0;0
109;09.12.2015;2015;12;01;Keskiviikko;0;0;0;0;0;0
109;09.12.2015;2015;12;02;Keskiviikko;1;0;1;0;0;0
109;09.12.2015;2015;12;03;Keskiviikko;1;0;1;0;0;0
109;09.12.2015;2015;12;04;Keskiviikko;0;1;1;0;0;0
109;09.12.2015;2015;12;05;Keskiviikko;2;7;9;1;1;2
109;09.12.2015;2015;12;06;Keskiviikko;24;7;31;2;1;3
109;09.12.2015;2015;12;07;Keskiviikko;35;15;50;8;6;14
109;09.12.2015;2015;12;08;Keskiviikko;32;9;41;3;2;5
109;09.12.2015;2015;12;09;Keskiviikko;9;3;12;2;3;5
109;09.12.2015;2015;12;10;Keskiviikko;4;4;8;0;4;4
109;09.12.2015;2015;12;11;Keskiviikko;5;4;9;6;3;9
109;09.12.2015;2015;12;12;Keskiviikko;8;6;14;4;2;6
109;09.12.2015;2015;12;13;Keskiviikko;4;12;16;2;3;5
109;09.12.2015;2015;12;14;Keskiviikko;6;14;20;3;3;6
109;09.12.2015;2015;12;15;Keskiviikko;10;27;37;4;2;6
109;09.12.2015;2015;12;16;Keskiviikko;17;34;51;6;1;7
109;09.12.2015;2015;12;17;Keskiviikko;7;17;24;3;1;4
109;09.12.2015;2015;12;18;Keskiviikko;9;7;16;2;2;4
109;09.12.2015;2015;12;19;Keskiviikko;1;5;6;7;2;9
109;09.12.2015;2015;12;20;Keskiviikko;5;2;7;0;1;1
109;09.12.2015;2015;12;21;Keskiviikko;4;8;12;0;0;0
109;09.12.2015;2015;12;22;Keskiviikko;9;4;13;1;2;3
109;09.12.2015;2015;12;23;Keskiviikko;4;3;7;3;1;4
109;10.12.2015;2015;12;00;Torstai;2;0;2;0;0;0
109;10.12.2015;2015;12;01;Torstai;0;2;2;0;0;0
109;10.12.2015;2015;12;02;Torstai;0;1;1;0;1;1
109;10.12.2015;2015;12;03;Torstai;0;0;0;0;0;0
109;10.12.2015;2015;12;04;Torstai;0;0;0;0;0;0
109;10.12.2015;2015;12;05;Torstai;2;5;7;2;0;2
109;10.12.2015;2015;12;06;Torstai;18;5;23;2;3;5
109;10.12.2015;2015;12;07;Torstai;39;20;59;7;6;13
109;10.12.2015;2015;12;08;Torstai;26;7;33;3;4;7
109;10.12.2015;2015;12;09;Torstai;13;5;18;3;1;4
109;10.12.2015;2015;12;10;Torstai;4;5;9;5;2;7
109;10.12.2015;2015;12;11;Torstai;6;6;12;2;3;5
109;10.12.2015;2015;12;12;Torstai;9;4;13;9;1;10
109;10.12.2015;2015;12;13;Torstai;7;7;14;2;1;3
109;10.12.2015;2015;12;14;Torstai;2;10;12;3;1;4
109;10.12.2015;2015;12;15;Torstai;13;31;44;4;4;8
109;10.12.2015;2015;12;16;Torstai;17;38;55;7;3;10
109;10.12.2015;2015;12;17;Torstai;9;17;26;2;3;5
109;10.12.2015;2015;12;18;Torstai;5;12;17;5;3;8
109;10.12.2015;2015;12;19;Torstai;8;2;10;3;1;4
109;10.12.2015;2015;12;20;Torstai;2;4;6;2;2;4
109;10.12.2015;2015;12;21;Torstai;1;9;10;2;5;7
109;10.12.2015;2015;12;22;Torstai;10;1;11;1;1;2
109;10.12.2015;2015;12;23;Torstai;3;2;5;0;0;0
109;11.12.2015;2015;12;00;Perjantai;1;0;1;0;0;0
109;11.12.2015;2015;12;01;Perjantai;0;0;0;0;0;0
109;11.12.2015;2015;12;02;Perjantai;0;0;0;0;0;0
109;11.12.2015;2015;12;03;Perjantai;1;0;1;0;0;0
109;11.12.2015;2015;12;04;Perjantai;2;1;3;0;0;0
109;11.12.2015;2015;12;05;Perjantai;1;3;4;0;0;0
109;11.12.2015;2015;12;06;Perjantai;19;5;24;2;2;4
109;11.12.2015;2015;12;07;Perjantai;20;15;35;4;4;8
109;11.12.2015;2015;12;08;Perjantai;20;7;27;4;3;7
109;11.12.2015;2015;12;09;Perjantai;17;4;21;4;6;10
109;11.12.2015;2015;12;10;Perjantai;6;1;7;2;2;4
109;11.12.2015;2015;12;11;Perjantai;3;8;11;3;9;12
109;11.12.2015;2015;12;12;Perjantai;5;9;14;1;1;2
109;11.12.2015;2015;12;13;Perjantai;8;15;23;4;5;9
109;11.12.2015;2015;12;14;Perjantai;8;18;26;1;7;8
109;11.12.2015;2015;12;15;Perjantai;17;20;37;8;3;11
109;11.12.2015;2015;12;16;Perjantai;16;19;35;3;2;5
109;11.12.2015;2015;12;17;Perjantai;7;11;18;6;3;9
109;11.12.2015;2015;12;18;Perjantai;7;7;14;5;7;12
109;11.12.2015;2015;12;19;Perjantai;2;10;12;2;4;6
109;11.12.2015;2015;12;20;Perjantai;3;3;6;0;2;2
109;11.12.2015;2015;12;21;Perjantai;1;7;8;1;1;2
109;11.12.2015;2015;12;22;Perjantai;10;0;10;2;0;2
109;11.12.2015;2015;12;23;Perjantai;1;1;2;1;3;4
109;12.12.2015;2015;12;00;Lauantai;2;1;3;1;1;2
109;12.12.2015;2015;12;01;Lauantai;0;2;2;1;1;2
109;12.12.2015;2015;12;02;Lauantai;0;1;1;0;0;0
109;12.12.2015;2015;12;03;Lauantai;0;1;1;0;0;0
109;12.12.2015;2015;12;04;Lauantai;0;1;1;0;0;0
109;12.12.2015;2015;12;05;Lauantai;4;2;6;0;0;0
109;12.12.2015;2015;12;06;Lauantai;3;1;4;3;1;4
109;12.12.2015;2015;12;07;Lauantai;0;0;0;1;2;3
109;12.12.2015;2015;12;08;Lauantai;0;1;1;0;1;1
109;12.12.2015;2015;12;09;Lauantai;2;2;4;3;4;7
109;12.12.2015;2015;12;10;Lauantai;6;1;7;5;2;7
109;12.12.2015;2015;12;11;Lauantai;2;2;4;3;3;6
109;12.12.2015;2015;12;12;Lauantai;12;5;17;4;1;5
109;12.12.2015;2015;12;13;Lauantai;7;8;15;2;4;6
109;12.12.2015;2015;12;14;Lauantai;5;2;7;3;6;9
109;12.12.2015;2015;12;15;Lauantai;2;8;10;7;3;10
109;12.12.2015;2015;12;16;Lauantai;9;3;12;5;1;6
109;12.12.2015;2015;12;17;Lauantai;6;6;12;7;0;7
109;12.12.2015;2015;12;18;Lauantai;4;6;10;5;0;5
109;12.12.2015;2015;12;19;Lauantai;1;2;3;2;4;6
109;12.12.2015;2015;12;20;Lauantai;4;2;6;3;0;3
109;12.12.2015;2015;12;21;Lauantai;3;7;10;3;2;5
109;12.12.2015;2015;12;22;Lauantai;2;2;4;0;0;0
109;12.12.2015;2015;12;23;Lauantai;1;3;4;1;1;2
109;13.12.2015;2015;12;00;Sunnuntai;2;2;4;1;0;1
109;13.12.2015;2015;12;01;Sunnuntai;1;2;3;0;0;0
109;13.12.2015;2015;12;02;Sunnuntai;0;0;0;0;0;0
109;13.12.2015;2015;12;03;Sunnuntai;0;2;2;0;0;0
109;13.12.2015;2015;12;04;Sunnuntai;0;0;0;0;0;0
109;13.12.2015;2015;12;05;Sunnuntai;0;0;0;0;0;0
109;13.12.2015;2015;12;06;Sunnuntai;2;2;4;0;1;1
109;13.12.2015;2015;12;07;Sunnuntai;1;1;2;2;0;2
109;13.12.2015;2015;12;08;Sunnuntai;1;1;2;3;1;4
109;13.12.2015;2015;12;09;Sunnuntai;0;0;0;6;2;8
109;13.12.2015;2015;12;10;Sunnuntai;4;0;4;3;1;4
109;13.12.2015;2015;12;11;Sunnuntai;3;4;7;7;5;12
109;13.12.2015;2015;12;12;Sunnuntai;4;2;6;5;8;13
109;13.12.2015;2015;12;13;Sunnuntai;4;2;6;4;6;10
109;13.12.2015;2015;12;14;Sunnuntai;7;3;10;2;4;6
109;13.12.2015;2015;12;15;Sunnuntai;3;4;7;5;1;6
109;13.12.2015;2015;12;16;Sunnuntai;6;6;12;3;2;5
109;13.12.2015;2015;12;17;Sunnuntai;2;3;5;3;2;5
109;13.12.2015;2015;12;18;Sunnuntai;4;2;6;4;0;4
109;13.12.2015;2015;12;19;Sunnuntai;6;5;11;2;5;7
109;13.12.2015;2015;12;20;Sunnuntai;3;5;8;4;3;7
109;13.12.2015;2015;12;21;Sunnuntai;1;2;3;1;1;2
109;13.12.2015;2015;12;22;Sunnuntai;0;1;1;0;1;1
109;13.12.2015;2015;12;23;Sunnuntai;0;0;0;0;0;0
109;14.12.2015;2015;12;00;Maanantai;0;0;0;0;1;1
109;14.12.2015;2015;12;01;Maanantai;0;0;0;0;1;1
109;14.12.2015;2015;12;02;Maanantai;0;0;0;0;0;0
109;14.12.2015;2015;12;03;Maanantai;0;0;0;0;0;0
109;14.12.2015;2015;12;04;Maanantai;0;2;2;0;0;0
109;14.12.2015;2015;12;05;Maanantai;0;8;8;1;0;1
109;14.12.2015;2015;12;06;Maanantai;21;5;26;3;1;4
109;14.12.2015;2015;12;07;Maanantai;44;22;66;6;1;7
109;14.12.2015;2015;12;08;Maanantai;37;14;51;5;2;7
109;14.12.2015;2015;12;09;Maanantai;13;1;14;3;2;5
109;14.12.2015;2015;12;10;Maanantai;7;4;11;2;2;4
109;14.12.2015;2015;12;11;Maanantai;6;5;11;2;2;4
109;14.12.2015;2015;12;12;Maanantai;8;2;10;3;1;4
109;14.12.2015;2015;12;13;Maanantai;8;10;18;2;1;3
109;14.12.2015;2015;12;14;Maanantai;11;14;25;2;1;3
109;14.12.2015;2015;12;15;Maanantai;13;37;50;6;1;7
109;14.12.2015;2015;12;16;Maanantai;24;29;53;6;5;11
109;14.12.2015;2015;12;17;Maanantai;11;15;26;5;2;7
109;14.12.2015;2015;12;18;Maanantai;7;14;21;1;8;9
109;14.12.2015;2015;12;19;Maanantai;4;6;10;5;4;9
109;14.12.2015;2015;12;20;Maanantai;4;6;10;4;8;12
109;14.12.2015;2015;12;21;Maanantai;2;5;7;2;1;3
109;14.12.2015;2015;12;22;Maanantai;6;1;7;0;2;2
109;14.12.2015;2015;12;23;Maanantai;1;2;3;1;0;1
109;15.12.2015;2015;12;00;Tiistai;5;0;5;3;0;3
109;15.12.2015;2015;12;01;Tiistai;0;0;0;0;0;0
109;15.12.2015;2015;12;02;Tiistai;0;0;0;0;0;0
109;15.12.2015;2015;12;03;Tiistai;0;1;1;0;0;0
109;15.12.2015;2015;12;04;Tiistai;2;1;3;0;0;0
109;15.12.2015;2015;12;05;Tiistai;2;9;11;2;1;3
109;15.12.2015;2015;12;06;Tiistai;21;4;25;2;3;5
109;15.12.2015;2015;12;07;Tiistai;48;23;71;6;4;10
109;15.12.2015;2015;12;08;Tiistai;40;13;53;1;1;2
109;15.12.2015;2015;12;09;Tiistai;10;6;16;1;0;1
109;15.12.2015;2015;12;10;Tiistai;6;3;9;4;6;10
109;15.12.2015;2015;12;11;Tiistai;8;4;12;3;4;7
109;15.12.2015;2015;12;12;Tiistai;11;10;21;4;1;5
109;15.12.2015;2015;12;13;Tiistai;15;13;28;5;2;7
109;15.12.2015;2015;12;14;Tiistai;14;13;27;1;1;2
109;15.12.2015;2015;12;15;Tiistai;23;21;44;3;3;6
109;15.12.2015;2015;12;16;Tiistai;30;29;59;4;1;5
109;15.12.2015;2015;12;17;Tiistai;18;16;34;3;5;8
109;15.12.2015;2015;12;18;Tiistai;12;10;22;6;3;9
109;15.12.2015;2015;12;19;Tiistai;8;5;13;6;4;10
109;15.12.2015;2015;12;20;Tiistai;4;3;7;3;1;4
109;15.12.2015;2015;12;21;Tiistai;5;4;9;2;3;5
109;15.12.2015;2015;12;22;Tiistai;6;4;10;1;0;1
109;15.12.2015;2015;12;23;Tiistai;1;0;1;0;2;2
109;16.12.2015;2015;12;00;Keskiviikko;4;2;6;0;0;0
109;16.12.2015;2015;12;01;Keskiviikko;2;0;2;0;0;0
109;16.12.2015;2015;12;02;Keskiviikko;0;0;0;0;0;0
109;16.12.2015;2015;12;03;Keskiviikko;0;0;0;0;0;0
109;16.12.2015;2015;12;04;Keskiviikko;1;0;1;0;0;0
109;16.12.2015;2015;12;05;Keskiviikko;8;5;13;1;1;2
109;16.12.2015;2015;12;06;Keskiviikko;14;13;27;2;1;3
109;16.12.2015;2015;12;07;Keskiviikko;34;32;66;8;6;14
109;16.12.2015;2015;12;08;Keskiviikko;18;17;35;3;2;5
109;16.12.2015;2015;12;09;Keskiviikko;10;8;18;2;3;5
109;16.12.2015;2015;12;10;Keskiviikko;9;8;17;0;4;4
109;16.12.2015;2015;12;11;Keskiviikko;7;5;12;6;3;9
109;16.12.2015;2015;12;12;Keskiviikko;10;8;18;4;2;6
109;16.12.2015;2015;12;13;Keskiviikko;11;8;19;2;3;5
109;16.12.2015;2015;12;14;Keskiviikko;13;10;23;3;3;6
109;16.12.2015;2015;12;15;Keskiviikko;19;17;36;4;2;6
109;16.12.2015;2015;12;16;Keskiviikko;26;23;49;6;1;7
109;16.12.2015;2015;12;17;Keskiviikko;15;13;28;3;1;4
109;16.12.2015;2015;12;18;Keskiviikko;9;7;16;2;2;4
109;16.12.2015;2015;12;19;Keskiviikko;4;2;6;7;2;9
109;16.12.2015;2015;12;20;Keskiviikko;7;4;11;0;1;1
109;16.12.2015;2015;12;21;Keskiviikko;7;4;11;0;0;0
109;16.12.2015;2015;12;22;Keskiviikko;4;2;6;1;2;3
109;16.12.2015;2015;12;23;Keskiviikko;0;0;0;3;1;4
109;17.12.2015;2015;12;00;Torstai;4;1;5;0;0;0
109;17.12.2015;2015;12;01;Torstai;1;0;1;0;0;0
109;17.12.2015;2015;12;02;Torstai;1;1;2;0;1;1
109;17.12.2015;2015;12;03;Torstai;0;0;0;0;0;0
109;17.12.2015;2015;12;04;Torstai;1;1;2;0;0;0
109;17.12.2015;2015;12;05;Torstai;5;1;6;2;0;2
109;17.12.2015;2015;12;06;Torstai;11;9;20;2;3;5
109;17.12.2015;2015;12;07;Torstai;30;28;58;7;6;13
109;17.12.2015;2015;12;08;Torstai;26;23;49;3;4;7
109;17.12.2015;2015;12;09;Torstai;10;10;20;3;1;4
109;17.12.2015;2015;12;10;Torstai;8;7;15;5;2;7
109;17.12.2015;2015;12;11;Torstai;6;5;11;2;3;5
109;17.12.2015;2015;12;12;Torstai;11;8;19;9;1;10
109;17.12.2015;2015;12;13;Torstai;9;7;16;2;1;3
109;17.12.2015;2015;12;14;Torstai;12;11;23;3;1;4
109;17.12.2015;2015;12;15;Torstai;21;18;39;4;4;8
109;17.12.2015;2015;12;16;Torstai;25;25;50;7;3;10
109;17.12.2015;2015;12;17;Torstai;13;11;24;2;3;5
109;17.12.2015;2015;12;18;Torstai;8;6;14;5;3;8
109;17.12.2015;2015;12;19;Torstai;6;5;11;3;1;4
109;17.12.2015;2015;12;20;Torstai;6;4;10;2;2;4
109;17.12.2015;2015;12;21;Torstai;4;3;7;2;5;7
109;17.12.2015;2015;12;22;Torstai;6;3;9;1;1;2
109;17.12.2015;2015;12;23;Torstai;4;2;6;0;0;0
109;18.12.2015;2015;12;00;Perjantai;2;1;3;0;0;0
109;18.12.2015;2015;12;01;Perjantai;1;1;2;0;0;0
109;18.12.2015;2015;12;02;Perjantai;0;0;0;0;0;0
109;18.12.2015;2015;12;03;Perjantai;0;0;0;0;0;0
109;18.12.2015;2015;12;04;Perjantai;2;1;3;0;0;0
109;18.12.2015;2015;12;05;Perjantai;7;4;11;0;0;0
109;18.12.2015;2015;12;06;Perjantai;11;8;19;2;2;4
109;18.12.2015;2015;12;07;Perjantai;25;23;48;4;4;8
109;18.12.2015;2015;12;08;Perjantai;21;20;41;4;3;7
109;18.12.2015;2015;12;09;Perjantai;8;6;14;4;6;10
109;18.12.2015;2015;12;10;Perjantai;8;6;14;2;2;4
109;18.12.2015;2015;12;11;Perjantai;7;6;13;3;9;12
109;18.12.2015;2015;12;12;Perjantai;11;9;20;1;1;2
109;18.12.2015;2015;12;13;Perjantai;10;8;18;4;5;9
109;18.12.2015;2015;12;14;Perjantai;18;15;33;1;7;8
109;18.12.2015;2015;12;15;Perjantai;17;16;33;8;3;11
109;18.12.2015;2015;12;16;Perjantai;26;23;49;3;2;5
109;18.12.2015;2015;12;17;Perjantai;14;11;25;6;3;9
109;18.12.2015;2015;12;18;Perjantai;4;1;5;5;7;12
109;18.12.2015;2015;12;19;Perjantai;4;2;6;2;4;6
109;18.12.2015;2015;12;20;Perjantai;2;2;4;0;2;2
109;18.12.2015;2015;12;21;Perjantai;1;0;1;1;1;2
109;18.12.2015;2015;12;22;Perjantai;2;0;2;2;0;2
109;18.12.2015;2015;12;23;Perjantai;3;2;5;1;3;4
109;19.12.2015;2015;12;00;Lauantai;3;0;3;1;1;2
109;19.12.2015;2015;12;01;Lauantai;1;0;1;1;1;2
109;19.12.2015;2015;12;02;Lauantai;0;0;0;0;0;0
109;19.12.2015;2015;12;03;Lauantai;0;0;0;0;0;0
109;19.12.2015;2015;12;04;Lauantai;2;0;2;0;0;0
109;19.12.2015;2015;12;05;Lauantai;4;3;7;0;0;0
109;19.12.2015;2015;12;06;Lauantai;2;1;3;3;1;4
109;19.12.2015;2015;12;07;Lauantai;2;0;2;1;2;3
109;19.12.2015;2015;12;08;Lauantai;4;2;6;0;1;1
109;19.12.2015;2015;12;09;Lauantai;5;4;9;3;4;7
109;19.12.2015;2015;12;10;Lauantai;4;3;7;5;2;7
109;19.12.2015;2015;12;11;Lauantai;4;3;7;3;3;6
109;19.12.2015;2015;12;12;Lauantai;7;5;12;4;1;5
109;19.12.2015;2015;12;13;Lauantai;5;1;6;2;4;6
109;19.12.2015;2015;12;14;Lauantai;8;7;15;3;6;9
109;19.12.2015;2015;12;15;Lauantai;10;7;17;7;3;10
109;19.12.2015;2015;12;16;Lauantai;7;4;11;5;1;6
109;19.12.2015;2015;12;17;Lauantai;4;3;7;7;0;7
109;19.12.2015;2015;12;18;Lauantai;3;3;6;5;0;5
109;19.12.2015;2015;12;19;Lauantai;3;0;3;2;4;6
109;19.12.2015;2015;12;20;Lauantai;3;2;5;3;0;3
109;19.12.2015;2015;12;21;Lauantai;2;1;3;3;2;5
109;19.12.2015;2015;12;22;Lauantai;0;0;0;0;0;0
109;19.12.2015;2015;12;23;Lauantai;2;1;3;1;1;2
109;20.12.2015;2015;12;00;Sunnuntai;0;0;0;0;0;0
109;20.12.2015;2015;12;01;Sunnuntai;1;0;1;0;0;0
109;20.12.2015;2015;12;02;Sunnuntai;0;0;0;0;0;0
109;20.12.2015;2015;12;03;Sunnuntai;1;0;1;0;0;0
109;20.12.2015;2015;12;04;Sunnuntai;3;1;4;0;0;0
109;20.12.2015;2015;12;05;Sunnuntai;1;0;1;0;0;0
109;20.12.2015;2015;12;06;Sunnuntai;1;0;1;1;1;2
109;20.12.2015;2015;12;07;Sunnuntai;2;0;2;1;2;3
109;20.12.2015;2015;12;08;Sunnuntai;2;0;2;1;0;1
109;20.12.2015;2015;12;09;Sunnuntai;0;1;1;1;0;1
109;20.12.2015;2015;12;10;Sunnuntai;2;0;2;0;2;2
109;20.12.2015;2015;12;11;Sunnuntai;2;2;4;5;4;9
109;20.12.2015;2015;12;12;Sunnuntai;3;4;7;4;2;6
109;20.12.2015;2015;12;13;Sunnuntai;5;4;9;4;3;7
109;20.12.2015;2015;12;14;Sunnuntai;4;3;7;5;2;7
109;20.12.2015;2015;12;15;Sunnuntai;4;0;4;5;0;5
109;20.12.2015;2015;12;16;Sunnuntai;1;6;7;4;2;6
109;20.12.2015;2015;12;17;Sunnuntai;0;3;3;3;0;3
109;20.12.2015;2015;12;18;Sunnuntai;2;3;5;2;0;2
109;20.12.2015;2015;12;19;Sunnuntai;0;0;0;1;2;3
109;20.12.2015;2015;12;20;Sunnuntai;2;2;4;1;3;4
109;20.12.2015;2015;12;21;Sunnuntai;0;3;3;2;1;3
109;20.12.2015;2015;12;22;Sunnuntai;0;2;2;2;0;2
109;20.12.2015;2015;12;23;Sunnuntai;0;0;0;0;0;0
109;21.12.2015;2015;12;00;Maanantai;1;0;1;0;0;0
109;21.12.2015;2015;12;01;Maanantai;1;0;1;0;1;1
109;21.12.2015;2015;12;02;Maanantai;0;0;0;0;0;0
109;21.12.2015;2015;12;03;Maanantai;0;0;0;0;0;0
109;21.12.2015;2015;12;04;Maanantai;0;0;0;1;0;1
109;21.12.2015;2015;12;05;Maanantai;1;3;4;1;0;1
109;21.12.2015;2015;12;06;Maanantai;7;4;11;1;1;2
109;21.12.2015;2015;12;07;Maanantai;19;9;28;4;2;6
109;21.12.2015;2015;12;08;Maanantai;23;9;32;2;0;2
109;21.12.2015;2015;12;09;Maanantai;7;3;10;1;1;2
109;21.12.2015;2015;12;10;Maanantai;3;2;5;3;1;4
109;21.12.2015;2015;12;11;Maanantai;2;1;3;4;2;6
109;21.12.2015;2015;12;12;Maanantai;11;3;14;2;2;4
109;21.12.2015;2015;12;13;Maanantai;7;5;12;2;2;4
109;21.12.2015;2015;12;14;Maanantai;9;7;16;4;1;5
109;21.12.2015;2015;12;15;Maanantai;7;9;16;4;2;6
109;21.12.2015;2015;12;16;Maanantai;13;23;36;1;3;4
109;21.12.2015;2015;12;17;Maanantai;3;12;15;5;2;7
109;21.12.2015;2015;12;18;Maanantai;5;7;12;2;1;3
109;21.12.2015;2015;12;19;Maanantai;2;2;4;7;1;8
109;21.12.2015;2015;12;20;Maanantai;2;4;6;5;0;5
109;21.12.2015;2015;12;21;Maanantai;3;4;7;1;0;1
109;21.12.2015;2015;12;22;Maanantai;9;3;12;2;2;4
109;21.12.2015;2015;12;23;Maanantai;1;2;3;0;2;2
109;22.12.2015;2015;12;00;Tiistai;2;1;3;0;0;0
109;22.12.2015;2015;12;01;Tiistai;0;0;0;0;0;0
109;22.12.2015;2015;12;02;Tiistai;0;0;0;0;0;0
109;22.12.2015;2015;12;03;Tiistai;0;1;1;0;0;0
109;22.12.2015;2015;12;04;Tiistai;0;0;0;0;0;0
109;22.12.2015;2015;12;05;Tiistai;1;3;4;1;1;2
109;22.12.2015;2015;12;06;Tiistai;8;3;11;3;1;4
109;22.12.2015;2015;12;07;Tiistai;30;12;42;4;2;6
109;22.12.2015;2015;12;08;Tiistai;18;7;25;2;1;3
109;22.12.2015;2015;12;09;Tiistai;4;1;5;3;4;7
109;22.12.2015;2015;12;10;Tiistai;6;7;13;1;3;4
109;22.12.2015;2015;12;11;Tiistai;3;1;4;2;2;4
109;22.12.2015;2015;12;12;Tiistai;5;1;6;4;2;6
109;22.12.2015;2015;12;13;Tiistai;8;3;11;3;2;5
109;22.12.2015;2015;12;14;Tiistai;6;14;20;2;0;2
109;22.12.2015;2015;12;15;Tiistai;5;15;20;1;4;5
109;22.12.2015;2015;12;16;Tiistai;23;17;40;0;1;1
109;22.12.2015;2015;12;17;Tiistai;4;7;11;3;1;4
109;22.12.2015;2015;12;18;Tiistai;3;7;10;4;3;7
109;22.12.2015;2015;12;19;Tiistai;6;2;8;6;4;10
109;22.12.2015;2015;12;20;Tiistai;0;1;1;3;0;3
109;22.12.2015;2015;12;21;Tiistai;2;4;6;0;1;1
109;22.12.2015;2015;12;22;Tiistai;5;5;10;0;2;2
109;22.12.2015;2015;12;23;Tiistai;1;2;3;1;0;1
109;23.12.2015;2015;12;00;Keskiviikko;2;0;2;0;0;0
109;23.12.2015;2015;12;01;Keskiviikko;0;0;0;0;0;0
109;23.12.2015;2015;12;02;Keskiviikko;0;0;0;0;0;0
109;23.12.2015;2015;12;03;Keskiviikko;0;0;0;0;0;0
109;23.12.2015;2015;12;04;Keskiviikko;1;0;1;0;1;1
109;23.12.2015;2015;12;05;Keskiviikko;1;3;4;3;0;3
109;23.12.2015;2015;12;06;Keskiviikko;6;4;10;1;3;4
109;23.12.2015;2015;12;07;Keskiviikko;21;9;30;1;7;8
109;23.12.2015;2015;12;08;Keskiviikko;14;3;17;5;1;6
109;23.12.2015;2015;12;09;Keskiviikko;8;2;10;4;2;6
109;23.12.2015;2015;12;10;Keskiviikko;5;1;6;3;1;4
109;23.12.2015;2015;12;11;Keskiviikko;4;3;7;5;3;8
109;23.12.2015;2015;12;12;Keskiviikko;8;2;10;4;2;6
109;23.12.2015;2015;12;13;Keskiviikko;6;7;13;4;1;5
109;23.12.2015;2015;12;14;Keskiviikko;17;15;32;1;4;5
109;23.12.2015;2015;12;15;Keskiviikko;6;14;20;6;5;11
109;23.12.2015;2015;12;16;Keskiviikko;5;5;10;2;0;2
109;23.12.2015;2015;12;17;Keskiviikko;1;5;6;1;3;4
109;23.12.2015;2015;12;18;Keskiviikko;2;5;7;2;1;3
109;23.12.2015;2015;12;19;Keskiviikko;2;2;4;5;2;7
109;23.12.2015;2015;12;20;Keskiviikko;2;0;2;2;2;4
109;23.12.2015;2015;12;21;Keskiviikko;0;0;0;0;0;0
109;23.12.2015;2015;12;22;Keskiviikko;2;2;4;0;0;0
109;23.12.2015;2015;12;23;Keskiviikko;1;0;1;0;0;0
109;24.12.2015;2015;12;00;Torstai;1;1;2;0;0;0
109;24.12.2015;2015;12;01;Torstai;0;0;0;0;0;0
109;24.12.2015;2015;12;02;Torstai;1;0;1;0;0;0
109;24.12.2015;2015;12;03;Torstai;0;0;0;0;0;0
109;24.12.2015;2015;12;04;Torstai;1;0;1;0;0;0
109;24.12.2015;2015;12;05;Torstai;0;0;0;1;1;2
109;24.12.2015;2015;12;06;Torstai;2;2;4;0;0;0
109;24.12.2015;2015;12;07;Torstai;3;2;5;3;3;6
109;24.12.2015;2015;12;08;Torstai;1;1;2;4;0;4
109;24.12.2015;2015;12;09;Torstai;2;0;2;0;0;0
109;24.12.2015;2015;12;10;Torstai;3;2;5;4;3;7
109;24.12.2015;2015;12;11;Torstai;3;1;4;3;2;5
109;24.12.2015;2015;12;12;Torstai;4;1;5;5;5;10
109;24.12.2015;2015;12;13;Torstai;3;2;5;4;5;9
109;24.12.2015;2015;12;14;Torstai;2;1;3;4;3;7
109;24.12.2015;2015;12;15;Torstai;3;2;5;7;5;12
109;24.12.2015;2015;12;16;Torstai;1;0;1;9;2;11
109;24.12.2015;2015;12;17;Torstai;1;0;1;3;4;7
109;24.12.2015;2015;12;18;Torstai;0;0;0;2;1;3
109;24.12.2015;2015;12;19;Torstai;3;1;4;1;1;2
109;24.12.2015;2015;12;20;Torstai;3;1;4;1;4;5
109;24.12.2015;2015;12;21;Torstai;2;0;2;1;0;1
109;24.12.2015;2015;12;22;Torstai;1;0;1;0;0;0
109;24.12.2015;2015;12;23;Torstai;0;0;0;0;1;1
109;25.12.2015;2015;12;00;Perjantai;5;2;7;0;0;0
109;25.12.2015;2015;12;01;Perjantai;0;0;0;0;0;0
109;25.12.2015;2015;12;02;Perjantai;0;0;0;0;0;0
109;25.12.2015;2015;12;03;Perjantai;0;0;0;0;0;0
109;25.12.2015;2015;12;04;Perjantai;1;0;1;0;0;0
109;25.12.2015;2015;12;05;Perjantai;0;0;0;1;1;2
109;25.12.2015;2015;12;06;Perjantai;4;0;4;0;0;0
109;25.12.2015;2015;12;07;Perjantai;0;1;1;3;3;6
109;25.12.2015;2015;12;08;Perjantai;1;1;2;4;0;4
109;25.12.2015;2015;12;09;Perjantai;0;0;0;0;0;0
109;25.12.2015;2015;12;10;Perjantai;1;1;2;4;3;7
109;25.12.2015;2015;12;11;Perjantai;3;2;5;3;2;5
109;25.12.2015;2015;12;12;Perjantai;2;1;3;5;5;10
109;25.12.2015;2015;12;13;Perjantai;0;0;0;4;5;9
109;25.12.2015;2015;12;14;Perjantai;5;2;7;4;3;7
109;25.12.2015;2015;12;15;Perjantai;3;3;6;7;5;12
109;25.12.2015;2015;12;16;Perjantai;2;1;3;9;2;11
109;25.12.2015;2015;12;17;Perjantai;5;1;6;3;4;7
109;25.12.2015;2015;12;18;Perjantai;1;0;1;2;1;3
109;25.12.2015;2015;12;19;Perjantai;3;3;6;1;1;2
109;25.12.2015;2015;12;20;Perjantai;2;1;3;1;4;5
109;25.12.2015;2015;12;21;Perjantai;1;4;5;1;0;1
109;25.12.2015;2015;12;22;Perjantai;1;0;1;0;0;0
109;25.12.2015;2015;12;23;Perjantai;0;0;0;0;1;1
109;26.12.2015;2015;12;00;Lauantai;0;0;0;0;0;0
109;26.12.2015;2015;12;01;Lauantai;0;0;0;0;2;2
109;26.12.2015;2015;12;02;Lauantai;0;0;0;0;0;0
109;26.12.2015;2015;12;03;Lauantai;0;0;0;0;0;0
109;26.12.2015;2015;12;04;Lauantai;0;0;0;0;1;1
109;26.12.2015;2015;12;05;Lauantai;0;0;0;0;0;0
109;26.12.2015;2015;12;06;Lauantai;0;0;0;1;1;2
109;26.12.2015;2015;12;07;Lauantai;1;0;1;2;1;3
109;26.12.2015;2015;12;08;Lauantai;1;2;3;1;0;1
109;26.12.2015;2015;12;09;Lauantai;1;1;2;2;2;4
109;26.12.2015;2015;12;10;Lauantai;0;0;0;3;0;3
109;26.12.2015;2015;12;11;Lauantai;6;2;8;8;4;12
109;26.12.2015;2015;12;12;Lauantai;3;1;4;6;4;10
109;26.12.2015;2015;12;13;Lauantai;4;2;6;4;4;8
109;26.12.2015;2015;12;14;Lauantai;7;0;7;7;2;9
109;26.12.2015;2015;12;15;Lauantai;2;2;4;3;1;4
109;26.12.2015;2015;12;16;Lauantai;5;9;14;4;2;6
109;26.12.2015;2015;12;17;Lauantai;2;3;5;0;1;1
109;26.12.2015;2015;12;18;Lauantai;1;0;1;1;0;1
109;26.12.2015;2015;12;19;Lauantai;2;0;2;3;5;8
109;26.12.2015;2015;12;20;Lauantai;5;0;5;2;3;5
109;26.12.2015;2015;12;21;Lauantai;4;3;7;3;1;4
109;26.12.2015;2015;12;22;Lauantai;0;2;2;0;0;0
109;26.12.2015;2015;12;23;Lauantai;2;1;3;3;0;3
109;27.12.2015;2015;12;00;Sunnuntai;2;1;3;0;0;0
109;27.12.2015;2015;12;01;Sunnuntai;0;0;0;0;0;0
109;27.12.2015;2015;12;02;Sunnuntai;0;0;0;1;0;1
109;27.12.2015;2015;12;03;Sunnuntai;0;2;2;0;0;0
109;27.12.2015;2015;12;04;Sunnuntai;0;0;0;0;0;0
109;27.12.2015;2015;12;05;Sunnuntai;0;1;1;0;0;0
109;27.12.2015;2015;12;06;Sunnuntai;3;0;3;0;1;1
109;27.12.2015;2015;12;07;Sunnuntai;3;3;6;1;2;3
109;27.12.2015;2015;12;08;Sunnuntai;0;0;0;1;3;4
109;27.12.2015;2015;12;09;Sunnuntai;2;0;2;5;1;6
109;27.12.2015;2015;12;10;Sunnuntai;2;0;2;5;5;10
109;27.12.2015;2015;12;11;Sunnuntai;3;3;6;2;4;6
109;27.12.2015;2015;12;12;Sunnuntai;4;2;6;3;4;7
109;27.12.2015;2015;12;13;Sunnuntai;10;4;14;7;3;10
109;27.12.2015;2015;12;14;Sunnuntai;2;2;4;4;3;7
109;27.12.2015;2015;12;15;Sunnuntai;5;4;9;2;4;6
109;27.12.2015;2015;12;16;Sunnuntai;3;7;10;7;1;8
109;27.12.2015;2015;12;17;Sunnuntai;6;2;8;5;5;10
109;27.12.2015;2015;12;18;Sunnuntai;1;6;7;7;3;10
109;27.12.2015;2015;12;19;Sunnuntai;1;0;1;8;4;12
109;27.12.2015;2015;12;20;Sunnuntai;2;4;6;4;3;7
109;27.12.2015;2015;12;21;Sunnuntai;2;3;5;2;1;3
109;27.12.2015;2015;12;22;Sunnuntai;1;1;2;1;1;2
109;27.12.2015;2015;12;23;Sunnuntai;0;1;1;2;3;5
109;28.12.2015;2015;12;00;Maanantai;0;0;0;0;0;0
109;28.12.2015;2015;12;01;Maanantai;0;0;0;0;1;1
109;28.12.2015;2015;12;02;Maanantai;0;0;0;0;1;1
109;28.12.2015;2015;12;03;Maanantai;0;0;0;0;0;0
109;28.12.2015;2015;12;04;Maanantai;3;0;3;2;0;2
109;28.12.2015;2015;12;05;Maanantai;3;5;8;1;1;2
109;28.12.2015;2015;12;06;Maanantai;20;3;23;4;0;4
109;28.12.2015;2015;12;07;Maanantai;22;11;33;4;3;7
109;28.12.2015;2015;12;08;Maanantai;14;8;22;1;0;1
109;28.12.2015;2015;12;09;Maanantai;5;2;7;1;2;3
109;28.12.2015;2015;12;10;Maanantai;2;6;8;1;2;3
109;28.12.2015;2015;12;11;Maanantai;2;3;5;2;1;3
109;28.12.2015;2015;12;12;Maanantai;6;0;6;2;0;2
109;28.12.2015;2015;12;13;Maanantai;10;2;12;5;2;7
109;28.12.2015;2015;12;14;Maanantai;4;8;12;6;7;13
109;28.12.2015;2015;12;15;Maanantai;6;14;20;3;5;8
109;28.12.2015;2015;12;16;Maanantai;19;19;38;6;3;9
109;28.12.2015;2015;12;17;Maanantai;8;10;18;2;4;6
109;28.12.2015;2015;12;18;Maanantai;4;6;10;1;2;3
109;28.12.2015;2015;12;19;Maanantai;4;2;6;6;2;8
109;28.12.2015;2015;12;20;Maanantai;2;4;6;3;3;6
109;28.12.2015;2015;12;21;Maanantai;1;4;5;3;2;5
109;28.12.2015;2015;12;22;Maanantai;3;0;3;2;1;3
109;28.12.2015;2015;12;23;Maanantai;0;1;1;2;0;2
109;29.12.2015;2015;12;00;Tiistai;2;0;2;1;0;1
109;29.12.2015;2015;12;01;Tiistai;0;1;1;0;0;0
109;29.12.2015;2015;12;02;Tiistai;0;0;0;0;2;2
109;29.12.2015;2015;12;03;Tiistai;0;0;0;0;0;0
109;29.12.2015;2015;12;04;Tiistai;1;2;3;0;0;0
109;29.12.2015;2015;12;05;Tiistai;5;3;8;2;3;5
109;29.12.2015;2015;12;06;Tiistai;13;8;21;2;4;6
109;29.12.2015;2015;12;07;Tiistai;22;8;30;1;1;2
109;29.12.2015;2015;12;08;Tiistai;15;8;23;1;0;1
109;29.12.2015;2015;12;09;Tiistai;4;4;8;3;1;4
109;29.12.2015;2015;12;10;Tiistai;6;3;9;2;2;4
109;29.12.2015;2015;12;11;Tiistai;5;1;6;6;4;10
109;29.12.2015;2015;12;12;Tiistai;2;1;3;8;2;10
109;29.12.2015;2015;12;13;Tiistai;5;3;8;3;2;5
109;29.12.2015;2015;12;14;Tiistai;9;9;18;3;5;8
109;29.12.2015;2015;12;15;Tiistai;13;11;24;4;2;6
109;29.12.2015;2015;12;16;Tiistai;12;17;29;11;10;21
109;29.12.2015;2015;12;17;Tiistai;10;18;28;3;3;6
109;29.12.2015;2015;12;18;Tiistai;3;7;10;4;6;10
109;29.12.2015;2015;12;19;Tiistai;3;4;7;8;2;10
109;29.12.2015;2015;12;20;Tiistai;4;4;8;2;3;5
109;29.12.2015;2015;12;21;Tiistai;2;5;7;2;1;3
109;29.12.2015;2015;12;22;Tiistai;6;2;8;0;3;3
109;29.12.2015;2015;12;23;Tiistai;0;0;0;2;0;2
109;30.12.2015;2015;12;00;Keskiviikko;1;0;1;1;0;1
109;30.12.2015;2015;12;01;Keskiviikko;0;0;0;0;0;0
109;30.12.2015;2015;12;02;Keskiviikko;0;0;0;0;1;1
109;30.12.2015;2015;12;03;Keskiviikko;0;0;0;0;0;0
109;30.12.2015;2015;12;04;Keskiviikko;2;0;2;0;1;1
109;30.12.2015;2015;12;05;Keskiviikko;4;4;8;2;1;3
109;30.12.2015;2015;12;06;Keskiviikko;13;10;23;1;0;1
109;30.12.2015;2015;12;07;Keskiviikko;22;7;29;7;2;9
109;30.12.2015;2015;12;08;Keskiviikko;16;6;22;3;0;3
109;30.12.2015;2015;12;09;Keskiviikko;10;3;13;1;0;1
109;30.12.2015;2015;12;10;Keskiviikko;8;2;10;4;1;5
109;30.12.2015;2015;12;11;Keskiviikko;3;4;7;6;3;9
109;30.12.2015;2015;12;12;Keskiviikko;15;8;23;5;4;9
109;30.12.2015;2015;12;13;Keskiviikko;5;10;15;4;5;9
109;30.12.2015;2015;12;14;Keskiviikko;6;17;23;5;4;9
109;30.12.2015;2015;12;15;Keskiviikko;12;15;27;4;1;5
109;30.12.2015;2015;12;16;Keskiviikko;12;22;34;5;5;10
109;30.12.2015;2015;12;17;Keskiviikko;9;9;18;6;2;8
109;30.12.2015;2015;12;18;Keskiviikko;2;6;8;1;4;5
109;30.12.2015;2015;12;19;Keskiviikko;6;3;9;12;4;16
109;30.12.2015;2015;12;20;Keskiviikko;2;3;5;2;2;4
109;30.12.2015;2015;12;21;Keskiviikko;6;7;13;0;5;5
109;30.12.2015;2015;12;22;Keskiviikko;2;2;4;2;0;2
109;30.12.2015;2015;12;23;Keskiviikko;0;3;3;0;0;0
109;31.12.2015;2015;12;00;Torstai;2;0;2;0;0;0
109;31.12.2015;2015;12;01;Torstai;0;1;1;0;2;2
109;31.12.2015;2015;12;02;Torstai;1;0;1;0;0;0
109;31.12.2015;2015;12;03;Torstai;1;0;1;0;0;0
109;31.12.2015;2015;12;04;Torstai;0;0;0;0;0;0
109;31.12.2015;2015;12;05;Torstai;3;1;4;2;1;3
109;31.12.2015;2015;12;06;Torstai;5;5;10;0;1;1
109;31.12.2015;2015;12;07;Torstai;18;8;26;2;3;5
109;31.12.2015;2015;12;08;Torstai;14;4;18;1;2;3
109;31.12.2015;2015;12;09;Torstai;4;4;8;3;1;4
109;31.12.2015;2015;12;10;Torstai;5;4;9;3;1;4
109;31.12.2015;2015;12;11;Torstai;11;3;14;1;1;2
109;31.12.2015;2015;12;12;Torstai;11;5;16;4;3;7
109;31.12.2015;2015;12;13;Torstai;4;6;10;5;2;7
109;31.12.2015;2015;12;14;Torstai;14;8;22;5;4;9
109;31.12.2015;2015;12;15;Torstai;14;15;29;6;7;13
109;31.12.2015;2015;12;16;Torstai;4;16;20;7;7;14
109;31.12.2015;2015;12;17;Torstai;1;5;6;3;3;6
109;31.12.2015;2015;12;18;Torstai;5;6;11;4;5;9
109;31.12.2015;2015;12;19;Torstai;5;2;7;1;5;6
109;31.12.2015;2015;12;20;Torstai;4;4;8;2;2;4
109;31.12.2015;2015;12;21;Torstai;14;13;27;5;4;9
109;31.12.2015;2015;12;22;Torstai;2;4;6;0;2;2
109;31.12.2015;2015;12;23;Torstai;4;0;4;0;1;1
109;01.01.2016;2016;01;00;Perjantai;0;1;1;6;0;6
109;01.01.2016;2016;01;01;Perjantai;3;1;4;0;0;0
109;01.01.2016;2016;01;02;Perjantai;0;0;0;1;0;1
109;01.01.2016;2016;01;03;Perjantai;1;3;4;0;0;0
109;01.01.2016;2016;01;04;Perjantai;1;0;1;1;1;2
109;01.01.2016;2016;01;05;Perjantai;0;0;0;0;0;0
109;01.01.2016;2016;01;06;Perjantai;4;0;4;0;1;1
109;01.01.2016;2016;01;07;Perjantai;2;2;4;1;1;2
109;01.01.2016;2016;01;08;Perjantai;0;0;0;2;0;2
109;01.01.2016;2016;01;09;Perjantai;0;1;1;3;2;5
109;01.01.2016;2016;01;10;Perjantai;1;4;5;2;3;5
109;01.01.2016;2016;01;11;Perjantai;4;4;8;3;7;10
109;01.01.2016;2016;01;12;Perjantai;6;4;10;11;8;19
109;01.01.2016;2016;01;13;Perjantai;6;2;8;6;3;9
109;01.01.2016;2016;01;14;Perjantai;3;1;4;7;4;11
109;01.01.2016;2016;01;15;Perjantai;4;5;9;6;4;10
109;01.01.2016;2016;01;16;Perjantai;2;4;6;1;5;6
109;01.01.2016;2016;01;17;Perjantai;4;4;8;1;2;3
109;01.01.2016;2016;01;18;Perjantai;1;1;2;9;2;11
109;01.01.2016;2016;01;19;Perjantai;2;5;7;1;7;8
109;01.01.2016;2016;01;20;Perjantai;2;2;4;7;3;10
109;01.01.2016;2016;01;21;Perjantai;2;7;9;0;1;1
109;01.01.2016;2016;01;22;Perjantai;0;1;1;0;1;1
109;01.01.2016;2016;01;23;Perjantai;3;1;4;0;0;0
109;02.01.2016;2016;01;00;Lauantai;0;1;1;0;0;0
109;02.01.2016;2016;01;01;Lauantai;0;0;0;0;0;0
109;02.01.2016;2016;01;02;Lauantai;0;0;0;0;0;0
109;02.01.2016;2016;01;03;Lauantai;0;0;0;0;0;0
109;02.01.2016;2016;01;04;Lauantai;0;0;0;0;0;0
109;02.01.2016;2016;01;05;Lauantai;0;0;0;0;1;1
109;02.01.2016;2016;01;06;Lauantai;3;0;3;1;0;1
109;02.01.2016;2016;01;07;Lauantai;1;0;1;1;2;3
109;02.01.2016;2016;01;08;Lauantai;1;0;1;2;1;3
109;02.01.2016;2016;01;09;Lauantai;0;1;1;1;3;4
109;02.01.2016;2016;01;10;Lauantai;5;0;5;2;4;6
109;02.01.2016;2016;01;11;Lauantai;2;0;2;3;3;6
109;02.01.2016;2016;01;12;Lauantai;2;5;7;5;5;10
109;02.01.2016;2016;01;13;Lauantai;1;2;3;5;4;9
109;02.01.2016;2016;01;14;Lauantai;2;5;7;3;0;3
109;02.01.2016;2016;01;15;Lauantai;3;3;6;5;5;10
109;02.01.2016;2016;01;16;Lauantai;0;4;4;3;2;5
109;02.01.2016;2016;01;17;Lauantai;4;4;8;2;5;7
109;02.01.2016;2016;01;18;Lauantai;2;3;5;2;1;3
109;02.01.2016;2016;01;19;Lauantai;2;2;4;4;2;6
109;02.01.2016;2016;01;20;Lauantai;0;1;1;4;2;6
109;02.01.2016;2016;01;21;Lauantai;3;1;4;0;4;4
109;02.01.2016;2016;01;22;Lauantai;2;0;2;0;0;0
109;02.01.2016;2016;01;23;Lauantai;0;0;0;0;2;2
109;03.01.2016;2016;01;00;Sunnuntai;0;0;0;0;1;1
109;03.01.2016;2016;01;01;Sunnuntai;0;0;0;0;1;1
109;03.01.2016;2016;01;02;Sunnuntai;0;2;2;0;0;0
109;03.01.2016;2016;01;03;Sunnuntai;0;0;0;0;0;0
109;03.01.2016;2016;01;04;Sunnuntai;1;1;2;0;0;0
109;03.01.2016;2016;01;05;Sunnuntai;0;0;0;0;1;1
109;03.01.2016;2016;01;06;Sunnuntai;4;0;4;0;0;0
109;03.01.2016;2016;01;07;Sunnuntai;0;3;3;3;3;6
109;03.01.2016;2016;01;08;Sunnuntai;0;0;0;0;5;5
109;03.01.2016;2016;01;09;Sunnuntai;1;0;1;2;1;3
109;03.01.2016;2016;01;10;Sunnuntai;1;0;1;2;2;4
109;03.01.2016;2016;01;11;Sunnuntai;5;2;7;3;9;12
109;03.01.2016;2016;01;12;Sunnuntai;4;4;8;8;5;13
109;03.01.2016;2016;01;13;Sunnuntai;5;2;7;7;4;11
109;03.01.2016;2016;01;14;Sunnuntai;2;0;2;4;4;8
109;03.01.2016;2016;01;15;Sunnuntai;5;5;10;6;4;10
109;03.01.2016;2016;01;16;Sunnuntai;2;3;5;7;6;13
109;03.01.2016;2016;01;17;Sunnuntai;6;2;8;4;5;9
109;03.01.2016;2016;01;18;Sunnuntai;2;3;5;7;2;9
109;03.01.2016;2016;01;19;Sunnuntai;3;5;8;4;4;8
109;03.01.2016;2016;01;20;Sunnuntai;3;1;4;0;5;5
109;03.01.2016;2016;01;21;Sunnuntai;2;2;4;1;1;2
109;03.01.2016;2016;01;22;Sunnuntai;0;0;0;0;0;0
109;03.01.2016;2016;01;23;Sunnuntai;0;0;0;0;1;1
109;04.01.2016;2016;01;00;Maanantai;0;0;0;0;4;4
109;04.01.2016;2016;01;01;Maanantai;0;0;0;0;0;0
109;04.01.2016;2016;01;02;Maanantai;0;0;0;0;0;0
109;04.01.2016;2016;01;03;Maanantai;0;2;2;0;0;0
109;04.01.2016;2016;01;04;Maanantai;2;0;2;0;0;0
109;04.01.2016;2016;01;05;Maanantai;0;4;4;1;0;1
109;04.01.2016;2016;01;06;Maanantai;12;6;18;4;0;4
109;04.01.2016;2016;01;07;Maanantai;18;14;32;4;3;7
109;04.01.2016;2016;01;08;Maanantai;24;5;29;1;0;1
109;04.01.2016;2016;01;09;Maanantai;10;4;14;2;5;7
109;04.01.2016;2016;01;10;Maanantai;3;1;4;0;1;1
109;04.01.2016;2016;01;11;Maanantai;9;2;11;4;0;4
109;04.01.2016;2016;01;12;Maanantai;7;4;11;3;1;4
109;04.01.2016;2016;01;13;Maanantai;5;7;12;3;3;6
109;04.01.2016;2016;01;14;Maanantai;8;4;12;5;3;8
109;04.01.2016;2016;01;15;Maanantai;13;26;39;6;3;9
109;04.01.2016;2016;01;16;Maanantai;14;21;35;5;2;7
109;04.01.2016;2016;01;17;Maanantai;1;15;16;2;2;4
109;04.01.2016;2016;01;18;Maanantai;3;4;7;3;5;8
109;04.01.2016;2016;01;19;Maanantai;5;5;10;9;6;15
109;04.01.2016;2016;01;20;Maanantai;2;3;5;2;1;3
109;04.01.2016;2016;01;21;Maanantai;0;2;2;1;2;3
109;04.01.2016;2016;01;22;Maanantai;7;1;8;1;1;2
109;04.01.2016;2016;01;23;Maanantai;1;1;2;0;0;0
109;05.01.2016;2016;01;00;Tiistai;1;0;1;0;0;0
109;05.01.2016;2016;01;01;Tiistai;0;0;0;0;0;0
109;05.01.2016;2016;01;02;Tiistai;0;0;0;0;1;1
109;05.01.2016;2016;01;03;Tiistai;1;0;1;0;0;0
109;05.01.2016;2016;01;04;Tiistai;0;0;0;0;0;0
109;05.01.2016;2016;01;05;Tiistai;3;4;7;1;2;3
109;05.01.2016;2016;01;06;Tiistai;10;4;14;5;1;6
109;05.01.2016;2016;01;07;Tiistai;28;19;47;6;3;9
109;05.01.2016;2016;01;08;Tiistai;18;7;25;0;2;2
109;05.01.2016;2016;01;09;Tiistai;5;6;11;5;2;7
109;05.01.2016;2016;01;10;Tiistai;2;6;8;5;6;11
109;05.01.2016;2016;01;11;Tiistai;2;3;5;3;6;9
109;05.01.2016;2016;01;12;Tiistai;2;1;3;4;0;4
109;05.01.2016;2016;01;13;Tiistai;3;6;9;3;3;6
109;05.01.2016;2016;01;14;Tiistai;11;7;18;1;4;5
109;05.01.2016;2016;01;15;Tiistai;12;16;28;5;6;11
109;05.01.2016;2016;01;16;Tiistai;11;18;29;3;6;9
109;05.01.2016;2016;01;17;Tiistai;12;21;33;5;1;6
109;05.01.2016;2016;01;18;Tiistai;6;2;8;4;2;6
109;05.01.2016;2016;01;19;Tiistai;5;0;5;2;4;6
109;05.01.2016;2016;01;20;Tiistai;2;0;2;1;1;2
109;05.01.2016;2016;01;21;Tiistai;0;3;3;0;0;0
109;05.01.2016;2016;01;22;Tiistai;7;2;9;0;3;3
109;05.01.2016;2016;01;23;Tiistai;1;0;1;1;0;1
109;06.01.2016;2016;01;00;Keskiviikko;0;2;2;0;0;0
109;06.01.2016;2016;01;01;Keskiviikko;0;0;0;0;1;1
109;06.01.2016;2016;01;02;Keskiviikko;0;0;0;0;0;0
109;06.01.2016;2016;01;03;Keskiviikko;0;0;0;0;0;0
109;06.01.2016;2016;01;04;Keskiviikko;1;0;1;0;0;0
109;06.01.2016;2016;01;05;Keskiviikko;1;0;1;0;0;0
109;06.01.2016;2016;01;06;Keskiviikko;2;0;2;1;1;2
109;06.01.2016;2016;01;07;Keskiviikko;2;3;5;1;1;2
109;06.01.2016;2016;01;08;Keskiviikko;0;2;2;3;2;5
109;06.01.2016;2016;01;09;Keskiviikko;0;0;0;0;1;1
109;06.01.2016;2016;01;10;Keskiviikko;1;1;2;1;2;3
109;06.01.2016;2016;01;11;Keskiviikko;1;0;1;3;1;4
109;06.01.2016;2016;01;12;Keskiviikko;0;2;2;3;5;8
109;06.01.2016;2016;01;13;Keskiviikko;0;2;2;3;0;3
109;06.01.2016;2016;01;14;Keskiviikko;1;0;1;3;1;4
109;06.01.2016;2016;01;15;Keskiviikko;0;1;1;1;5;6
109;06.01.2016;2016;01;16;Keskiviikko;4;1;5;4;0;4
109;06.01.2016;2016;01;17;Keskiviikko;1;2;3;2;3;5
109;06.01.2016;2016;01;18;Keskiviikko;2;0;2;3;3;6
109;06.01.2016;2016;01;19;Keskiviikko;1;1;2;4;1;5
109;06.01.2016;2016;01;20;Keskiviikko;5;2;7;4;5;9
109;06.01.2016;2016;01;21;Keskiviikko;3;2;5;0;1;1
109;06.01.2016;2016;01;22;Keskiviikko;0;0;0;0;0;0
109;06.01.2016;2016;01;23;Keskiviikko;0;0;0;1;0;1
109;07.01.2016;2016;01;00;Torstai;0;0;0;0;0;0
109;07.01.2016;2016;01;01;Torstai;0;1;1;0;1;1
109;07.01.2016;2016;01;02;Torstai;0;0;0;0;0;0
109;07.01.2016;2016;01;03;Torstai;0;0;0;0;0;0
109;07.01.2016;2016;01;04;Torstai;0;0;0;0;0;0
109;07.01.2016;2016;01;05;Torstai;0;3;3;1;0;1
109;07.01.2016;2016;01;06;Torstai;4;2;6;3;1;4
109;07.01.2016;2016;01;07;Torstai;15;12;27;7;3;10
109;07.01.2016;2016;01;08;Torstai;19;8;27;7;2;9
109;07.01.2016;2016;01;09;Torstai;7;1;8;1;2;3
109;07.01.2016;2016;01;10;Torstai;0;0;0;4;2;6
109;07.01.2016;2016;01;11;Torstai;1;0;1;5;1;6
109;07.01.2016;2016;01;12;Torstai;2;0;2;3;1;4
109;07.01.2016;2016;01;13;Torstai;0;3;3;6;2;8
109;07.01.2016;2016;01;14;Torstai;7;7;14;1;2;3
109;07.01.2016;2016;01;15;Torstai;3;9;12;5;3;8
109;07.01.2016;2016;01;16;Torstai;10;18;28;3;4;7
109;07.01.2016;2016;01;17;Torstai;4;8;12;4;2;6
109;07.01.2016;2016;01;18;Torstai;3;4;7;4;1;5
109;07.01.2016;2016;01;19;Torstai;1;0;1;3;2;5
109;07.01.2016;2016;01;20;Torstai;0;0;0;4;1;5
109;07.01.2016;2016;01;21;Torstai;1;1;2;0;0;0
109;07.01.2016;2016;01;22;Torstai;1;0;1;1;4;5
109;07.01.2016;2016;01;23;Torstai;1;0;1;0;0;0
109;08.01.2016;2016;01;00;Perjantai;0;0;0;0;1;1
109;08.01.2016;2016;01;01;Perjantai;1;0;1;0;2;2
109;08.01.2016;2016;01;02;Perjantai;0;0;0;0;0;0
109;08.01.2016;2016;01;03;Perjantai;0;0;0;0;0;0
109;08.01.2016;2016;01;04;Perjantai;1;1;2;0;0;0
109;08.01.2016;2016;01;05;Perjantai;1;3;4;1;0;1
109;08.01.2016;2016;01;06;Perjantai;3;4;7;3;5;8
109;08.01.2016;2016;01;07;Perjantai;13;10;23;8;5;13
109;08.01.2016;2016;01;08;Perjantai;14;5;19;5;2;7
109;08.01.2016;2016;01;09;Perjantai;9;3;12;0;3;3
109;08.01.2016;2016;01;10;Perjantai;2;1;3;3;1;4
109;08.01.2016;2016;01;11;Perjantai;9;3;12;1;1;2
109;08.01.2016;2016;01;12;Perjantai;10;3;13;2;2;4
109;08.01.2016;2016;01;13;Perjantai;5;6;11;8;3;11
109;08.01.2016;2016;01;14;Perjantai;10;7;17;3;3;6
109;08.01.2016;2016;01;15;Perjantai;6;13;19;8;6;14
109;08.01.2016;2016;01;16;Perjantai;10;12;22;3;6;9
109;08.01.2016;2016;01;17;Perjantai;13;12;25;1;2;3
109;08.01.2016;2016;01;18;Perjantai;5;3;8;1;1;2
109;08.01.2016;2016;01;19;Perjantai;6;4;10;3;2;5
109;08.01.2016;2016;01;20;Perjantai;3;0;3;3;1;4
109;08.01.2016;2016;01;21;Perjantai;2;2;4;1;0;1
109;08.01.2016;2016;01;22;Perjantai;5;4;9;2;1;3
109;08.01.2016;2016;01;23;Perjantai;2;0;2;1;0;1
109;09.01.2016;2016;01;00;Lauantai;2;1;3;0;0;0
109;09.01.2016;2016;01;01;Lauantai;0;0;0;0;0;0
109;09.01.2016;2016;01;02;Lauantai;0;1;1;0;0;0
109;09.01.2016;2016;01;03;Lauantai;0;1;1;1;0;1
109;09.01.2016;2016;01;04;Lauantai;2;0;2;0;0;0
109;09.01.2016;2016;01;05;Lauantai;1;1;2;0;0;0
109;09.01.2016;2016;01;06;Lauantai;3;0;3;1;0;1
109;09.01.2016;2016;01;07;Lauantai;2;1;3;0;1;1
109;09.01.2016;2016;01;08;Lauantai;1;0;1;2;0;2
109;09.01.2016;2016;01;09;Lauantai;7;0;7;2;0;2
109;09.01.2016;2016;01;10;Lauantai;2;1;3;1;1;2
109;09.01.2016;2016;01;11;Lauantai;1;1;2;1;0;1
109;09.01.2016;2016;01;12;Lauantai;0;6;6;6;1;7
109;09.01.2016;2016;01;13;Lauantai;3;3;6;2;0;2
109;09.01.2016;2016;01;14;Lauantai;5;0;5;6;0;6
109;09.01.2016;2016;01;15;Lauantai;3;6;9;2;0;2
109;09.01.2016;2016;01;16;Lauantai;2;4;6;3;2;5
109;09.01.2016;2016;01;17;Lauantai;0;2;2;4;1;5
109;09.01.2016;2016;01;18;Lauantai;7;3;10;2;1;3
109;09.01.2016;2016;01;19;Lauantai;3;0;3;2;2;4
109;09.01.2016;2016;01;20;Lauantai;1;2;3;1;0;1
109;09.01.2016;2016;01;21;Lauantai;3;2;5;1;0;1
109;09.01.2016;2016;01;22;Lauantai;2;1;3;0;0;0
109;09.01.2016;2016;01;23;Lauantai;1;0;1;0;0;0
109;10.01.2016;2016;01;00;Sunnuntai;1;0;1;0;1;1
109;10.01.2016;2016;01;01;Sunnuntai;0;0;0;0;1;1
109;10.01.2016;2016;01;02;Sunnuntai;0;0;0;0;0;0
109;10.01.2016;2016;01;03;Sunnuntai;0;2;2;0;0;0
109;10.01.2016;2016;01;04;Sunnuntai;0;0;0;0;0;0
109;10.01.2016;2016;01;05;Sunnuntai;2;0;2;0;1;1
109;10.01.2016;2016;01;06;Sunnuntai;3;1;4;0;0;0
109;10.01.2016;2016;01;07;Sunnuntai;2;1;3;3;3;6
109;10.01.2016;2016;01;08;Sunnuntai;0;0;0;0;5;5
109;10.01.2016;2016;01;09;Sunnuntai;1;1;2;2;1;3
109;10.01.2016;2016;01;10;Sunnuntai;2;0;2;2;2;4
109;10.01.2016;2016;01;11;Sunnuntai;3;1;4;3;9;12
109;10.01.2016;2016;01;12;Sunnuntai;5;3;8;8;5;13
109;10.01.2016;2016;01;13;Sunnuntai;5;3;8;7;4;11
109;10.01.2016;2016;01;14;Sunnuntai;4;3;7;4;4;8
109;10.01.2016;2016;01;15;Sunnuntai;6;3;9;6;4;10
109;10.01.2016;2016;01;16;Sunnuntai;6;3;9;7;6;13
109;10.01.2016;2016;01;17;Sunnuntai;4;2;6;4;5;9
109;10.01.2016;2016;01;18;Sunnuntai;5;3;8;7;2;9
109;10.01.2016;2016;01;19;Sunnuntai;2;0;2;4;4;8
109;10.01.2016;2016;01;20;Sunnuntai;4;3;7;0;5;5
109;10.01.2016;2016;01;21;Sunnuntai;1;0;1;1;1;2
109;10.01.2016;2016;01;22;Sunnuntai;1;0;1;0;0;0
109;10.01.2016;2016;01;23;Sunnuntai;2;0;2;0;1;1
109;11.01.2016;2016;01;00;Maanantai;0;0;0;0;0;0
109;11.01.2016;2016;01;01;Maanantai;0;0;0;0;0;0
109;11.01.2016;2016;01;02;Maanantai;0;0;0;0;0;0
109;11.01.2016;2016;01;03;Maanantai;0;0;0;0;0;0
109;11.01.2016;2016;01;04;Maanantai;0;0;0;0;0;0
109;11.01.2016;2016;01;05;Maanantai;3;1;4;0;0;0
109;11.01.2016;2016;01;06;Maanantai;11;10;21;0;0;0
109;11.01.2016;2016;01;07;Maanantai;27;24;51;0;0;0
109;11.01.2016;2016;01;08;Maanantai;22;19;41;0;0;0
109;11.01.2016;2016;01;09;Maanantai;8;7;15;0;0;0
109;11.01.2016;2016;01;10;Maanantai;4;2;6;0;0;0
109;11.01.2016;2016;01;11;Maanantai;6;3;9;0;0;0
109;11.01.2016;2016;01;12;Maanantai;6;5;11;0;0;0
109;11.01.2016;2016;01;13;Maanantai;8;7;15;0;0;0
109;11.01.2016;2016;01;14;Maanantai;10;6;16;0;0;0
109;11.01.2016;2016;01;15;Maanantai;16;12;28;0;0;0
109;11.01.2016;2016;01;16;Maanantai;29;28;57;0;0;0
109;11.01.2016;2016;01;17;Maanantai;13;10;23;0;0;0
109;11.01.2016;2016;01;18;Maanantai;7;6;13;0;0;0
109;11.01.2016;2016;01;19;Maanantai;8;5;13;0;0;0
109;11.01.2016;2016;01;20;Maanantai;5;3;8;0;0;0
109;11.01.2016;2016;01;21;Maanantai;7;4;11;0;0;0
109;11.01.2016;2016;01;22;Maanantai;3;1;4;0;0;0
109;11.01.2016;2016;01;23;Maanantai;1;0;1;0;0;0
109;12.01.2016;2016;01;00;Tiistai;1;0;1;0;0;0
109;12.01.2016;2016;01;01;Tiistai;1;0;1;0;0;0
109;12.01.2016;2016;01;02;Tiistai;0;0;0;0;0;0
109;12.01.2016;2016;01;03;Tiistai;0;0;0;0;0;0
109;12.01.2016;2016;01;04;Tiistai;0;0;0;0;0;0
109;12.01.2016;2016;01;05;Tiistai;5;3;8;0;0;0
109;12.01.2016;2016;01;06;Tiistai;13;13;26;0;0;0
109;12.01.2016;2016;01;07;Tiistai;34;33;67;0;0;0
109;12.01.2016;2016;01;08;Tiistai;23;20;43;0;0;0
109;12.01.2016;2016;01;09;Tiistai;12;12;24;0;0;0
109;12.01.2016;2016;01;10;Tiistai;8;5;13;0;0;0
109;12.01.2016;2016;01;11;Tiistai;4;3;7;0;0;0
109;12.01.2016;2016;01;12;Tiistai;6;5;11;0;0;0
109;12.01.2016;2016;01;13;Tiistai;9;8;17;0;0;0
109;12.01.2016;2016;01;14;Tiistai;9;8;17;0;0;0
109;12.01.2016;2016;01;15;Tiistai;15;14;29;0;0;0
109;12.01.2016;2016;01;16;Tiistai;33;31;64;0;0;0
109;12.01.2016;2016;01;17;Tiistai;16;14;30;0;0;0
109;12.01.2016;2016;01;18;Tiistai;5;3;8;0;0;0
109;12.01.2016;2016;01;19;Tiistai;4;3;7;0;0;0
109;12.01.2016;2016;01;20;Tiistai;3;0;3;0;0;0
109;12.01.2016;2016;01;21;Tiistai;6;2;8;0;0;0
109;12.01.2016;2016;01;22;Tiistai;4;3;7;0;0;0
109;12.01.2016;2016;01;23;Tiistai;1;0;1;0;0;0
109;13.01.2016;2016;01;00;Keskiviikko;1;0;1;0;0;0
109;13.01.2016;2016;01;01;Keskiviikko;1;0;1;0;0;0
109;13.01.2016;2016;01;02;Keskiviikko;0;0;0;0;0;0
109;13.01.2016;2016;01;03;Keskiviikko;0;0;0;0;0;0
109;13.01.2016;2016;01;04;Keskiviikko;1;0;1;0;0;0
109;13.01.2016;2016;01;05;Keskiviikko;4;2;6;0;0;0
109;13.01.2016;2016;01;06;Keskiviikko;11;8;19;0;0;0
109;13.01.2016;2016;01;07;Keskiviikko;30;28;58;0;0;0
109;13.01.2016;2016;01;08;Keskiviikko;23;22;45;0;0;0
109;13.01.2016;2016;01;09;Keskiviikko;9;7;16;0;0;0
109;13.01.2016;2016;01;10;Keskiviikko;3;2;5;0;0;0
109;13.01.2016;2016;01;11;Keskiviikko;7;6;13;0;0;0
109;13.01.2016;2016;01;12;Keskiviikko;9;7;16;0;0;0
109;13.01.2016;2016;01;13;Keskiviikko;7;4;11;0;0;0
109;13.01.2016;2016;01;14;Keskiviikko;7;7;14;0;0;0
109;13.01.2016;2016;01;15;Keskiviikko;17;17;34;0;0;0
109;13.01.2016;2016;01;16;Keskiviikko;26;24;50;0;0;0
109;13.01.2016;2016;01;17;Keskiviikko;11;10;21;0;0;0
109;13.01.2016;2016;01;18;Keskiviikko;8;8;16;0;0;0
109;13.01.2016;2016;01;19;Keskiviikko;6;4;10;0;0;0
109;13.01.2016;2016;01;20;Keskiviikko;8;6;14;0;0;0
109;13.01.2016;2016;01;21;Keskiviikko;7;5;12;0;0;0
109;13.01.2016;2016;01;22;Keskiviikko;5;3;8;0;0;0
109;13.01.2016;2016;01;23;Keskiviikko;2;0;2;0;0;0
109;14.01.2016;2016;01;00;Torstai;2;1;3;0;0;0
109;14.01.2016;2016;01;01;Torstai;1;0;1;0;0;0
109;14.01.2016;2016;01;02;Torstai;0;0;0;0;0;0
109;14.01.2016;2016;01;03;Torstai;0;0;0;0;0;0
109;14.01.2016;2016;01;04;Torstai;0;0;0;0;0;0
109;14.01.2016;2016;01;05;Torstai;4;1;5;0;0;0
109;14.01.2016;2016;01;06;Torstai;12;9;21;0;0;0
109;14.01.2016;2016;01;07;Torstai;26;25;51;0;0;0
109;14.01.2016;2016;01;08;Torstai;25;23;48;0;0;0
109;14.01.2016;2016;01;09;Torstai;12;10;22;0;0;0
109;14.01.2016;2016;01;10;Torstai;7;5;12;0;0;0
109;14.01.2016;2016;01;11;Torstai;9;7;16;0;0;0
109;14.01.2016;2016;01;12;Torstai;7;6;13;0;0;0
109;14.01.2016;2016;01;13;Torstai;6;4;10;0;0;0
109;14.01.2016;2016;01;14;Torstai;7;5;12;0;0;0
109;14.01.2016;2016;01;15;Torstai;17;16;33;0;0;0
109;14.01.2016;2016;01;16;Torstai;34;33;67;0;0;0
109;14.01.2016;2016;01;17;Torstai;16;14;30;0;0;0
109;14.01.2016;2016;01;18;Torstai;10;8;18;0;0;0
109;14.01.2016;2016;01;19;Torstai;5;5;10;0;0;0
109;14.01.2016;2016;01;20;Torstai;4;2;6;0;0;0
109;14.01.2016;2016;01;21;Torstai;6;5;11;0;0;0
109;14.01.2016;2016;01;22;Torstai;4;2;6;0;0;0
109;14.01.2016;2016;01;23;Torstai;0;0;0;0;0;0
109;15.01.2016;2016;01;00;Perjantai;0;0;0;0;0;0
109;15.01.2016;2016;01;01;Perjantai;0;0;0;0;0;0
109;15.01.2016;2016;01;02;Perjantai;1;0;1;0;0;0
109;15.01.2016;2016;01;03;Perjantai;0;0;0;0;0;0
109;15.01.2016;2016;01;04;Perjantai;0;0;0;0;0;0
109;15.01.2016;2016;01;05;Perjantai;3;3;6;0;0;0
109;15.01.2016;2016;01;06;Perjantai;11;9;20;0;0;0
109;15.01.2016;2016;01;07;Perjantai;25;22;47;0;0;0
109;15.01.2016;2016;01;08;Perjantai;20;19;39;0;0;0
109;15.01.2016;2016;01;09;Perjantai;6;5;11;0;0;0
109;15.01.2016;2016;01;10;Perjantai;3;1;4;0;0;0
109;15.01.2016;2016;01;11;Perjantai;5;4;9;0;0;0
109;15.01.2016;2016;01;12;Perjantai;10;8;18;0;0;0
109;15.01.2016;2016;01;13;Perjantai;10;8;18;0;0;0
109;15.01.2016;2016;01;14;Perjantai;10;8;18;0;0;0
109;15.01.2016;2016;01;15;Perjantai;19;17;36;0;0;0
109;15.01.2016;2016;01;16;Perjantai;19;17;36;0;0;0
109;15.01.2016;2016;01;17;Perjantai;12;9;21;0;0;0
109;15.01.2016;2016;01;18;Perjantai;7;3;10;0;0;0
109;15.01.2016;2016;01;19;Perjantai;3;1;4;0;0;0
109;15.01.2016;2016;01;20;Perjantai;4;3;7;0;0;0
109;15.01.2016;2016;01;21;Perjantai;1;1;2;0;0;0
109;15.01.2016;2016;01;22;Perjantai;3;2;5;0;0;0
109;15.01.2016;2016;01;23;Perjantai;0;0;0;0;0;0
109;16.01.2016;2016;01;00;Lauantai;0;0;0;0;0;0
109;16.01.2016;2016;01;01;Lauantai;0;0;0;0;0;0
109;16.01.2016;2016;01;02;Lauantai;0;0;0;0;0;0
109;16.01.2016;2016;01;03;Lauantai;1;1;2;0;0;0
109;16.01.2016;2016;01;04;Lauantai;2;0;2;0;0;0
109;16.01.2016;2016;01;05;Lauantai;0;0;0;0;0;0
109;16.01.2016;2016;01;06;Lauantai;3;3;6;0;0;0
109;16.01.2016;2016;01;07;Lauantai;2;0;2;0;0;0
109;16.01.2016;2016;01;08;Lauantai;3;1;4;0;0;0
109;16.01.2016;2016;01;09;Lauantai;3;1;4;0;0;0
109;16.01.2016;2016;01;10;Lauantai;3;1;4;0;0;0
109;16.01.2016;2016;01;11;Lauantai;6;4;10;0;0;0
109;16.01.2016;2016;01;12;Lauantai;5;3;8;0;0;0
109;16.01.2016;2016;01;13;Lauantai;3;3;6;0;0;0
109;16.01.2016;2016;01;14;Lauantai;6;4;10;0;0;0
109;16.01.2016;2016;01;15;Lauantai;5;3;8;0;0;0
109;16.01.2016;2016;01;16;Lauantai;6;3;9;0;0;0
109;16.01.2016;2016;01;17;Lauantai;3;3;6;0;0;0
109;16.01.2016;2016;01;18;Lauantai;2;0;2;0;0;0
109;16.01.2016;2016;01;19;Lauantai;4;2;6;0;0;0
109;16.01.2016;2016;01;20;Lauantai;0;0;0;0;0;0
109;16.01.2016;2016;01;21;Lauantai;5;2;7;0;0;0
109;16.01.2016;2016;01;22;Lauantai;2;0;2;0;0;0
109;16.01.2016;2016;01;23;Lauantai;1;0;1;0;0;0
109;17.01.2016;2016;01;00;Sunnuntai;0;0;0;0;0;0
109;17.01.2016;2016;01;01;Sunnuntai;0;0;0;0;0;0
109;17.01.2016;2016;01;02;Sunnuntai;0;0;0;0;0;0
109;17.01.2016;2016;01;03;Sunnuntai;1;0;1;0;0;0
109;17.01.2016;2016;01;04;Sunnuntai;0;0;0;0;0;0
109;17.01.2016;2016;01;05;Sunnuntai;0;0;0;0;0;0
109;17.01.2016;2016;01;06;Sunnuntai;3;0;3;0;0;0
109;17.01.2016;2016;01;07;Sunnuntai;1;0;1;0;0;0
109;17.01.2016;2016;01;08;Sunnuntai;3;1;4;0;0;0
109;17.01.2016;2016;01;09;Sunnuntai;0;0;0;0;0;0
109;17.01.2016;2016;01;10;Sunnuntai;2;1;3;0;0;0
109;17.01.2016;2016;01;11;Sunnuntai;3;0;3;0;0;0
109;17.01.2016;2016;01;12;Sunnuntai;1;0;1;0;0;0
109;17.01.2016;2016;01;13;Sunnuntai;4;1;5;0;0;0
109;17.01.2016;2016;01;14;Sunnuntai;4;2;6;0;0;0
109;17.01.2016;2016;01;15;Sunnuntai;4;3;7;0;0;0
109;17.01.2016;2016;01;16;Sunnuntai;3;2;5;0;0;0
109;17.01.2016;2016;01;17;Sunnuntai;0;0;0;0;0;0
109;17.01.2016;2016;01;18;Sunnuntai;0;0;0;0;0;0
109;17.01.2016;2016;01;19;Sunnuntai;2;0;2;0;0;0
109;17.01.2016;2016;01;20;Sunnuntai;2;2;4;0;0;0
109;17.01.2016;2016;01;21;Sunnuntai;2;0;2;0;0;0
109;17.01.2016;2016;01;22;Sunnuntai;0;0;0;0;0;0
109;17.01.2016;2016;01;23;Sunnuntai;1;0;1;0;0;0
109;18.01.2016;2016;01;00;Maanantai;0;0;0;0;0;0
109;18.01.2016;2016;01;01;Maanantai;0;0;0;0;0;0
109;18.01.2016;2016;01;02;Maanantai;0;0;0;0;0;0
109;18.01.2016;2016;01;03;Maanantai;1;0;1;0;0;0
109;18.01.2016;2016;01;04;Maanantai;0;0;0;0;0;0
109;18.01.2016;2016;01;05;Maanantai;3;1;4;0;0;0
109;18.01.2016;2016;01;06;Maanantai;7;4;11;0;0;0
109;18.01.2016;2016;01;07;Maanantai;16;13;29;0;0;0
109;18.01.2016;2016;01;08;Maanantai;21;19;40;0;0;0
109;18.01.2016;2016;01;09;Maanantai;7;3;10;0;0;0
109;18.01.2016;2016;01;10;Maanantai;6;3;9;0;0;0
109;18.01.2016;2016;01;11;Maanantai;6;4;10;0;0;0
109;18.01.2016;2016;01;12;Maanantai;6;4;10;0;0;0
109;18.01.2016;2016;01;13;Maanantai;7;3;10;0;0;0
109;18.01.2016;2016;01;14;Maanantai;6;4;10;0;0;0
109;18.01.2016;2016;01;15;Maanantai;15;12;27;0;0;0
109;18.01.2016;2016;01;16;Maanantai;23;20;43;0;0;0
109;18.01.2016;2016;01;17;Maanantai;8;7;15;0;0;0
109;18.01.2016;2016;01;18;Maanantai;7;4;11;0;0;0
109;18.01.2016;2016;01;19;Maanantai;4;2;6;0;0;0
109;18.01.2016;2016;01;20;Maanantai;1;1;2;0;0;0
109;18.01.2016;2016;01;21;Maanantai;4;1;5;0;0;0
109;18.01.2016;2016;01;22;Maanantai;4;2;6;0;0;0
109;18.01.2016;2016;01;23;Maanantai;0;0;0;0;0;0
109;19.01.2016;2016;01;00;Tiistai;0;0;0;0;0;0
109;19.01.2016;2016;01;01;Tiistai;0;0;0;0;0;0
109;19.01.2016;2016;01;02;Tiistai;0;0;0;0;0;0
109;19.01.2016;2016;01;03;Tiistai;1;0;1;0;0;0
109;19.01.2016;2016;01;04;Tiistai;0;0;0;0;0;0
109;19.01.2016;2016;01;05;Tiistai;3;1;4;0;0;0
109;19.01.2016;2016;01;06;Tiistai;7;4;11;0;0;0
109;19.01.2016;2016;01;07;Tiistai;15;13;28;0;0;0
109;19.01.2016;2016;01;08;Tiistai;16;13;29;0;0;0
109;19.01.2016;2016;01;09;Tiistai;5;4;9;0;0;0
109;19.01.2016;2016;01;10;Tiistai;3;1;4;0;0;0
109;19.01.2016;2016;01;11;Tiistai;3;1;4;0;0;0
109;19.01.2016;2016;01;12;Tiistai;4;2;6;0;0;0
109;19.01.2016;2016;01;13;Tiistai;3;1;4;0;0;0
109;19.01.2016;2016;01;14;Tiistai;7;5;12;0;0;0
109;19.01.2016;2016;01;15;Tiistai;11;9;20;0;0;0
109;19.01.2016;2016;01;16;Tiistai;16;14;30;0;0;0
109;19.01.2016;2016;01;17;Tiistai;12;9;21;0;0;0
109;19.01.2016;2016;01;18;Tiistai;7;4;11;0;0;0
109;19.01.2016;2016;01;19;Tiistai;4;2;6;0;0;0
109;19.01.2016;2016;01;20;Tiistai;1;0;1;0;0;0
109;19.01.2016;2016;01;21;Tiistai;3;1;4;0;0;0
109;19.01.2016;2016;01;22;Tiistai;4;2;6;0;0;0
109;19.01.2016;2016;01;23;Tiistai;0;0;0;0;0;0
109;20.01.2016;2016;01;00;Keskiviikko;0;0;0;0;0;0
109;20.01.2016;2016;01;01;Keskiviikko;0;0;0;0;0;0
109;20.01.2016;2016;01;02;Keskiviikko;0;0;0;0;0;0
109;20.01.2016;2016;01;03;Keskiviikko;2;0;2;0;0;0
109;20.01.2016;2016;01;04;Keskiviikko;1;0;1;0;0;0
109;20.01.2016;2016;01;05;Keskiviikko;1;1;2;0;0;0
109;20.01.2016;2016;01;06;Keskiviikko;7;5;12;0;0;0
109;20.01.2016;2016;01;07;Keskiviikko;17;15;32;0;0;0
109;20.01.2016;2016;01;08;Keskiviikko;17;14;31;0;0;0
109;20.01.2016;2016;01;09;Keskiviikko;5;3;8;0;0;0
109;20.01.2016;2016;01;10;Keskiviikko;3;3;6;0;0;0
109;20.01.2016;2016;01;11;Keskiviikko;3;1;4;0;0;0
109;20.01.2016;2016;01;12;Keskiviikko;4;1;5;0;0;0
109;20.01.2016;2016;01;13;Keskiviikko;5;2;7;0;0;0
109;20.01.2016;2016;01;14;Keskiviikko;8;5;13;0;0;0
109;20.01.2016;2016;01;15;Keskiviikko;14;11;25;0;0;0
109;20.01.2016;2016;01;16;Keskiviikko;18;16;34;0;0;0
109;20.01.2016;2016;01;17;Keskiviikko;13;12;25;0;0;0
109;20.01.2016;2016;01;18;Keskiviikko;6;5;11;0;0;0
109;20.01.2016;2016;01;19;Keskiviikko;6;5;11;0;0;0
109;20.01.2016;2016;01;20;Keskiviikko;4;0;4;0;0;0
109;20.01.2016;2016;01;21;Keskiviikko;7;4;11;0;0;0
109;20.01.2016;2016;01;22;Keskiviikko;5;4;9;0;0;0
109;20.01.2016;2016;01;23;Keskiviikko;0;0;0;0;0;0
109;21.01.2016;2016;01;00;Torstai;0;0;0;0;0;0
109;21.01.2016;2016;01;01;Torstai;0;0;0;0;0;0
109;21.01.2016;2016;01;02;Torstai;0;0;0;0;0;0
109;21.01.2016;2016;01;03;Torstai;0;0;0;0;0;0
109;21.01.2016;2016;01;04;Torstai;0;0;0;0;0;0
109;21.01.2016;2016;01;05;Torstai;2;0;2;0;0;0
109;21.01.2016;2016;01;06;Torstai;7;4;11;0;0;0
109;21.01.2016;2016;01;07;Torstai;16;14;30;0;0;0
109;21.01.2016;2016;01;08;Torstai;10;9;19;0;0;0
109;21.01.2016;2016;01;09;Torstai;5;3;8;0;0;0
109;21.01.2016;2016;01;10;Torstai;3;0;3;0;0;0
109;21.01.2016;2016;01;11;Torstai;4;3;7;0;0;0
109;21.01.2016;2016;01;12;Torstai;3;1;4;0;0;0
109;21.01.2016;2016;01;13;Torstai;3;1;4;0;0;0
109;21.01.2016;2016;01;14;Torstai;4;4;8;0;0;0
109;21.01.2016;2016;01;15;Torstai;8;6;14;0;0;0
109;21.01.2016;2016;01;16;Torstai;14;14;28;0;0;0
109;21.01.2016;2016;01;17;Torstai;7;4;11;0;0;0
109;21.01.2016;2016;01;18;Torstai;5;1;6;0;0;0
109;21.01.2016;2016;01;19;Torstai;3;1;4;0;0;0
109;21.01.2016;2016;01;20;Torstai;0;0;0;0;0;0
109;21.01.2016;2016;01;21;Torstai;2;1;3;0;0;0
109;21.01.2016;2016;01;22;Torstai;4;2;6;0;0;0
109;21.01.2016;2016;01;23;Torstai;0;0;0;0;0;0
109;22.01.2016;2016;01;00;Perjantai;0;0;0;0;0;0
109;22.01.2016;2016;01;01;Perjantai;0;0;0;0;0;0
109;22.01.2016;2016;01;02;Perjantai;1;0;1;0;0;0
109;22.01.2016;2016;01;03;Perjantai;0;0;0;0;0;0
109;22.01.2016;2016;01;04;Perjantai;0;0;0;0;0;0
109;22.01.2016;2016;01;05;Perjantai;1;1;2;0;0;0
109;22.01.2016;2016;01;06;Perjantai;9;8;17;0;0;0
109;22.01.2016;2016;01;07;Perjantai;27;24;51;0;0;0
109;22.01.2016;2016;01;08;Perjantai;16;13;29;0;0;0
109;22.01.2016;2016;01;09;Perjantai;8;4;12;0;0;0
109;22.01.2016;2016;01;10;Perjantai;3;1;4;0;0;0
109;22.01.2016;2016;01;11;Perjantai;9;7;16;0;0;0
109;22.01.2016;2016;01;12;Perjantai;10;8;18;0;0;0
109;22.01.2016;2016;01;13;Perjantai;7;5;12;0;0;0
109;22.01.2016;2016;01;14;Perjantai;9;7;16;0;0;0
109;22.01.2016;2016;01;15;Perjantai;16;15;31;0;0;0
109;22.01.2016;2016;01;16;Perjantai;15;13;28;0;0;0
109;22.01.2016;2016;01;17;Perjantai;11;7;18;0;0;0
109;22.01.2016;2016;01;18;Perjantai;7;4;11;0;0;0
109;22.01.2016;2016;01;19;Perjantai;5;3;8;0;0;0
109;22.01.2016;2016;01;20;Perjantai;5;2;7;0;0;0
109;22.01.2016;2016;01;21;Perjantai;5;3;8;0;0;0
109;22.01.2016;2016;01;22;Perjantai;2;1;3;0;0;0
109;22.01.2016;2016;01;23;Perjantai;4;0;4;0;0;0
109;23.01.2016;2016;01;00;Lauantai;1;0;1;0;0;0
109;23.01.2016;2016;01;01;Lauantai;0;0;0;0;0;0
109;23.01.2016;2016;01;02;Lauantai;1;0;1;0;0;0
109;23.01.2016;2016;01;03;Lauantai;1;0;1;0;0;0
109;23.01.2016;2016;01;04;Lauantai;1;0;1;0;0;0
109;23.01.2016;2016;01;05;Lauantai;1;0;1;0;0;0
109;23.01.2016;2016;01;06;Lauantai;6;2;8;0;0;0
109;23.01.2016;2016;01;07;Lauantai;2;0;2;0;0;0
109;23.01.2016;2016;01;08;Lauantai;4;1;5;0;0;0
109;23.01.2016;2016;01;09;Lauantai;4;2;6;0;0;0
109;23.01.2016;2016;01;10;Lauantai;5;1;6;0;0;0
109;23.01.2016;2016;01;11;Lauantai;4;2;6;0;0;0
109;23.01.2016;2016;01;12;Lauantai;7;5;12;0;0;0
109;23.01.2016;2016;01;13;Lauantai;5;2;7;0;0;0
109;23.01.2016;2016;01;14;Lauantai;5;4;9;0;0;0
109;23.01.2016;2016;01;15;Lauantai;8;4;12;0;0;0
109;23.01.2016;2016;01;16;Lauantai;4;1;5;0;0;0
109;23.01.2016;2016;01;17;Lauantai;2;1;3;0;0;0
109;23.01.2016;2016;01;18;Lauantai;4;2;6;0;0;0
109;23.01.2016;2016;01;19;Lauantai;5;2;7;0;0;0
109;23.01.2016;2016;01;20;Lauantai;2;0;2;0;0;0
109;23.01.2016;2016;01;21;Lauantai;3;1;4;0;0;0
109;23.01.2016;2016;01;22;Lauantai;3;3;6;0;0;0
109;23.01.2016;2016;01;23;Lauantai;1;1;2;0;0;0
109;24.01.2016;2016;01;00;Sunnuntai;0;0;0;0;0;0
109;24.01.2016;2016;01;01;Sunnuntai;1;0;1;0;0;0
109;24.01.2016;2016;01;02;Sunnuntai;1;0;1;0;0;0
109;24.01.2016;2016;01;03;Sunnuntai;1;0;1;0;0;0
109;24.01.2016;2016;01;04;Sunnuntai;1;0;1;0;0;0
109;24.01.2016;2016;01;05;Sunnuntai;0;0;0;0;0;0
109;24.01.2016;2016;01;06;Sunnuntai;2;1;3;0;0;0
109;24.01.2016;2016;01;07;Sunnuntai;3;1;4;0;0;0
109;24.01.2016;2016;01;08;Sunnuntai;1;1;2;0;0;0
109;24.01.2016;2016;01;09;Sunnuntai;2;1;3;0;0;0
109;24.01.2016;2016;01;10;Sunnuntai;2;1;3;0;0;0
109;24.01.2016;2016;01;11;Sunnuntai;7;3;10;0;0;0
109;24.01.2016;2016;01;12;Sunnuntai;4;2;6;0;0;0
109;24.01.2016;2016;01;13;Sunnuntai;3;1;4;0;0;0
109;24.01.2016;2016;01;14;Sunnuntai;3;2;5;0;0;0
109;24.01.2016;2016;01;15;Sunnuntai;9;6;15;0;0;0
109;24.01.2016;2016;01;16;Sunnuntai;3;1;4;0;0;0
109;24.01.2016;2016;01;17;Sunnuntai;3;2;5;0;0;0
109;24.01.2016;2016;01;18;Sunnuntai;1;0;1;0;0;0
109;24.01.2016;2016;01;19;Sunnuntai;3;2;5;0;0;0
109;24.01.2016;2016;01;20;Sunnuntai;3;2;5;0;0;0
109;24.01.2016;2016;01;21;Sunnuntai;4;3;7;0;0;0
109;24.01.2016;2016;01;22;Sunnuntai;0;0;0;0;0;0
109;24.01.2016;2016;01;23;Sunnuntai;0;0;0;0;0;0
109;25.01.2016;2016;01;00;Maanantai;0;0;0;0;0;0
109;25.01.2016;2016;01;01;Maanantai;0;0;0;0;0;0
109;25.01.2016;2016;01;02;Maanantai;0;0;0;0;0;0
109;25.01.2016;2016;01;03;Maanantai;0;0;0;0;0;0
109;25.01.2016;2016;01;04;Maanantai;2;0;2;0;0;0
109;25.01.2016;2016;01;05;Maanantai;2;1;3;0;0;0
109;25.01.2016;2016;01;06;Maanantai;14;12;26;0;0;0
109;25.01.2016;2016;01;07;Maanantai;36;33;69;0;0;0
109;25.01.2016;2016;01;08;Maanantai;39;37;76;0;0;0
109;25.01.2016;2016;01;09;Maanantai;8;7;15;0;0;0
109;25.01.2016;2016;01;10;Maanantai;11;8;19;0;0;0
109;25.01.2016;2016;01;11;Maanantai;10;8;18;0;0;0
109;25.01.2016;2016;01;12;Maanantai;9;7;16;0;0;0
109;25.01.2016;2016;01;13;Maanantai;11;7;18;0;0;0
109;25.01.2016;2016;01;14;Maanantai;9;6;15;0;0;0
109;25.01.2016;2016;01;15;Maanantai;24;23;47;0;0;0
109;25.01.2016;2016;01;16;Maanantai;43;40;83;0;0;0
109;25.01.2016;2016;01;17;Maanantai;16;13;29;0;0;0
109;25.01.2016;2016;01;18;Maanantai;12;10;22;0;0;0
109;25.01.2016;2016;01;19;Maanantai;8;6;14;0;0;0
109;25.01.2016;2016;01;20;Maanantai;6;3;9;0;0;0
109;25.01.2016;2016;01;21;Maanantai;6;3;9;0;0;0
109;25.01.2016;2016;01;22;Maanantai;6;3;9;0;0;0
109;25.01.2016;2016;01;23;Maanantai;4;1;5;0;0;0
109;26.01.2016;2016;01;00;Tiistai;0;0;0;0;0;0
109;26.01.2016;2016;01;01;Tiistai;0;0;0;0;0;0
109;26.01.2016;2016;01;02;Tiistai;0;0;0;0;0;0
109;26.01.2016;2016;01;03;Tiistai;0;0;0;0;0;0
109;26.01.2016;2016;01;04;Tiistai;2;1;3;0;0;0
109;26.01.2016;2016;01;05;Tiistai;1;1;2;0;0;0
109;26.01.2016;2016;01;06;Tiistai;14;13;27;0;0;0
109;26.01.2016;2016;01;07;Tiistai;33;32;65;0;0;0
109;26.01.2016;2016;01;08;Tiistai;21;20;41;0;0;0
109;26.01.2016;2016;01;09;Tiistai;12;10;22;0;0;0
109;26.01.2016;2016;01;10;Tiistai;3;2;5;0;0;0
109;26.01.2016;2016;01;11;Tiistai;4;3;7;0;0;0
109;26.01.2016;2016;01;12;Tiistai;4;1;5;0;0;0
109;26.01.2016;2016;01;13;Tiistai;6;4;10;0;0;0
109;26.01.2016;2016;01;14;Tiistai;12;11;23;0;0;0
109;26.01.2016;2016;01;15;Tiistai;16;16;32;0;0;0
109;26.01.2016;2016;01;16;Tiistai;33;30;63;0;0;0
109;26.01.2016;2016;01;17;Tiistai;17;17;34;0;0;0
109;26.01.2016;2016;01;18;Tiistai;8;6;14;0;0;0
109;26.01.2016;2016;01;19;Tiistai;4;2;6;0;0;0
109;26.01.2016;2016;01;20;Tiistai;4;2;6;0;0;0
109;26.01.2016;2016;01;21;Tiistai;6;4;10;0;0;0
109;26.01.2016;2016;01;22;Tiistai;5;3;8;0;0;0
109;26.01.2016;2016;01;23;Tiistai;1;0;1;0;0;0
109;27.01.2016;2016;01;00;Keskiviikko;1;0;1;0;0;0
109;27.01.2016;2016;01;01;Keskiviikko;1;0;1;0;0;0
109;27.01.2016;2016;01;02;Keskiviikko;2;0;2;0;0;0
109;27.01.2016;2016;01;03;Keskiviikko;0;0;0;0;0;0
109;27.01.2016;2016;01;04;Keskiviikko;1;0;1;0;0;0
109;27.01.2016;2016;01;05;Keskiviikko;3;1;4;0;0;0
109;27.01.2016;2016;01;06;Keskiviikko;14;13;27;0;0;0
109;27.01.2016;2016;01;07;Keskiviikko;38;36;74;0;0;0
109;27.01.2016;2016;01;08;Keskiviikko;27;24;51;0;0;0
109;27.01.2016;2016;01;09;Keskiviikko;13;10;23;0;0;0
109;27.01.2016;2016;01;10;Keskiviikko;6;5;11;0;0;0
109;27.01.2016;2016;01;11;Keskiviikko;7;4;11;0;0;0
109;27.01.2016;2016;01;12;Keskiviikko;7;5;12;0;0;0
109;27.01.2016;2016;01;13;Keskiviikko;11;10;21;0;0;0
109;27.01.2016;2016;01;14;Keskiviikko;9;6;15;0;0;0
109;27.01.2016;2016;01;15;Keskiviikko;21;20;41;0;0;0
109;27.01.2016;2016;01;16;Keskiviikko;39;37;76;0;0;0
109;27.01.2016;2016;01;17;Keskiviikko;15;12;27;0;0;0
109;27.01.2016;2016;01;18;Keskiviikko;9;6;15;0;0;0
109;27.01.2016;2016;01;19;Keskiviikko;9;6;15;0;0;0
109;27.01.2016;2016;01;20;Keskiviikko;6;1;7;0;0;0
109;27.01.2016;2016;01;21;Keskiviikko;3;2;5;0;0;0
109;27.01.2016;2016;01;22;Keskiviikko;6;4;10;0;0;0
109;27.01.2016;2016;01;23;Keskiviikko;0;0;0;0;0;0
109;28.01.2016;2016;01;00;Torstai;1;0;1;0;0;0
109;28.01.2016;2016;01;01;Torstai;1;0;1;0;0;0
109;28.01.2016;2016;01;02;Torstai;0;0;0;0;0;0
109;28.01.2016;2016;01;03;Torstai;0;0;0;0;0;0
109;28.01.2016;2016;01;04;Torstai;2;2;4;0;0;0
109;28.01.2016;2016;01;05;Torstai;1;4;5;0;0;0
109;28.01.2016;2016;01;06;Torstai;12;4;16;0;0;0
109;28.01.2016;2016;01;07;Torstai;36;13;49;0;0;0
109;28.01.2016;2016;01;08;Torstai;50;7;57;0;0;0
109;28.01.2016;2016;01;09;Torstai;12;2;14;0;0;0
109;28.01.2016;2016;01;10;Torstai;12;3;15;0;0;0
109;28.01.2016;2016;01;11;Torstai;14;4;18;0;0;0
109;28.01.2016;2016;01;12;Torstai;15;5;20;0;0;0
109;28.01.2016;2016;01;13;Torstai;11;9;20;0;0;0
109;28.01.2016;2016;01;14;Torstai;18;8;26;0;0;0
109;28.01.2016;2016;01;15;Torstai;26;13;39;0;0;0
109;28.01.2016;2016;01;16;Torstai;29;24;53;0;0;0
109;28.01.2016;2016;01;17;Torstai;15;13;28;0;0;0
109;28.01.2016;2016;01;18;Torstai;12;13;25;0;0;0
109;28.01.2016;2016;01;19;Torstai;4;3;7;0;0;0
109;28.01.2016;2016;01;20;Torstai;8;4;12;0;0;0
109;28.01.2016;2016;01;21;Torstai;5;7;12;0;0;0
109;28.01.2016;2016;01;22;Torstai;8;2;10;0;0;0
109;28.01.2016;2016;01;23;Torstai;3;0;3;0;0;0
109;29.01.2016;2016;01;00;Perjantai;0;0;0;0;0;0
109;29.01.2016;2016;01;01;Perjantai;1;0;1;0;0;0
109;29.01.2016;2016;01;02;Perjantai;0;0;0;0;0;0
109;29.01.2016;2016;01;03;Perjantai;0;0;0;0;0;0
109;29.01.2016;2016;01;04;Perjantai;2;0;2;0;0;0
109;29.01.2016;2016;01;05;Perjantai;4;1;5;0;0;0
109;29.01.2016;2016;01;06;Perjantai;13;4;17;0;0;0
109;29.01.2016;2016;01;07;Perjantai;37;11;48;0;0;0
109;29.01.2016;2016;01;08;Perjantai;44;7;51;0;0;0
109;29.01.2016;2016;01;09;Perjantai;7;5;12;0;0;0
109;29.01.2016;2016;01;10;Perjantai;6;3;9;0;0;0
109;29.01.2016;2016;01;11;Perjantai;12;5;17;0;0;0
109;29.01.2016;2016;01;12;Perjantai;9;2;11;0;0;0
109;29.01.2016;2016;01;13;Perjantai;6;17;23;0;0;0
109;29.01.2016;2016;01;14;Perjantai;17;5;22;0;0;0
109;29.01.2016;2016;01;15;Perjantai;26;14;40;0;0;0
109;29.01.2016;2016;01;16;Perjantai;24;11;35;0;0;0
109;29.01.2016;2016;01;17;Perjantai;15;16;31;0;0;0
109;29.01.2016;2016;01;18;Perjantai;8;5;13;0;0;0
109;29.01.2016;2016;01;19;Perjantai;5;3;8;0;0;0
109;29.01.2016;2016;01;20;Perjantai;4;2;6;0;0;0
109;29.01.2016;2016;01;21;Perjantai;3;2;5;0;0;0
109;29.01.2016;2016;01;22;Perjantai;2;2;4;0;0;0
109;29.01.2016;2016;01;23;Perjantai;1;1;2;0;0;0
109;30.01.2016;2016;01;00;Lauantai;2;0;2;0;0;0
109;30.01.2016;2016;01;01;Lauantai;1;0;1;0;0;0
109;30.01.2016;2016;01;02;Lauantai;1;1;2;0;0;0
109;30.01.2016;2016;01;03;Lauantai;0;0;0;0;0;0
109;30.01.2016;2016;01;04;Lauantai;2;0;2;0;0;0
109;30.01.2016;2016;01;05;Lauantai;3;0;3;0;0;0
109;30.01.2016;2016;01;06;Lauantai;2;2;4;0;0;0
109;30.01.2016;2016;01;07;Lauantai;3;0;3;0;0;0
109;30.01.2016;2016;01;08;Lauantai;6;4;10;0;0;0
109;30.01.2016;2016;01;09;Lauantai;4;1;5;0;0;0
109;30.01.2016;2016;01;10;Lauantai;6;3;9;0;0;0
109;30.01.2016;2016;01;11;Lauantai;1;2;3;0;0;0
109;30.01.2016;2016;01;12;Lauantai;5;7;12;0;0;0
109;30.01.2016;2016;01;13;Lauantai;3;2;5;0;0;0
109;30.01.2016;2016;01;14;Lauantai;4;1;5;0;0;0
109;30.01.2016;2016;01;15;Lauantai;3;2;5;0;0;0
109;30.01.2016;2016;01;16;Lauantai;10;5;15;0;0;0
109;30.01.2016;2016;01;17;Lauantai;1;6;7;0;0;0
109;30.01.2016;2016;01;18;Lauantai;2;2;4;0;0;0
109;30.01.2016;2016;01;19;Lauantai;8;3;11;0;0;0
109;30.01.2016;2016;01;20;Lauantai;4;2;6;0;0;0
109;30.01.2016;2016;01;21;Lauantai;1;6;7;0;0;0
109;30.01.2016;2016;01;22;Lauantai;2;1;3;0;0;0
109;30.01.2016;2016;01;23;Lauantai;1;2;3;0;0;0
109;31.01.2016;2016;01;00;Sunnuntai;0;2;2;0;0;0
109;31.01.2016;2016;01;01;Sunnuntai;0;0;0;0;0;0
109;31.01.2016;2016;01;02;Sunnuntai;0;3;3;0;0;0
109;31.01.2016;2016;01;03;Sunnuntai;0;3;3;0;0;0
109;31.01.2016;2016;01;04;Sunnuntai;2;2;4;0;0;0
109;31.01.2016;2016;01;05;Sunnuntai;0;0;0;0;0;0
109;31.01.2016;2016;01;06;Sunnuntai;4;0;4;0;0;0
109;31.01.2016;2016;01;07;Sunnuntai;2;1;3;0;0;0
109;31.01.2016;2016;01;08;Sunnuntai;5;1;6;0;0;0
109;31.01.2016;2016;01;09;Sunnuntai;1;1;2;0;0;0
109;31.01.2016;2016;01;10;Sunnuntai;4;2;6;0;0;0
109;31.01.2016;2016;01;11;Sunnuntai;2;8;10;0;0;0
109;31.01.2016;2016;01;12;Sunnuntai;4;6;10;0;0;0
109;31.01.2016;2016;01;13;Sunnuntai;8;5;13;0;0;0
109;31.01.2016;2016;01;14;Sunnuntai;13;5;18;0;0;0
109;31.01.2016;2016;01;15;Sunnuntai;5;3;8;0;0;0
109;31.01.2016;2016;01;16;Sunnuntai;3;5;8;0;0;0
109;31.01.2016;2016;01;17;Sunnuntai;3;1;4;0;0;0
109;31.01.2016;2016;01;18;Sunnuntai;3;3;6;0;0;0
109;31.01.2016;2016;01;19;Sunnuntai;3;5;8;0;0;0
109;31.01.2016;2016;01;20;Sunnuntai;2;3;5;0;0;0
109;31.01.2016;2016;01;21;Sunnuntai;2;6;8;0;0;0
109;31.01.2016;2016;01;22;Sunnuntai;3;1;4;0;0;0
109;31.01.2016;2016;01;23;Sunnuntai;1;0;1;0;0;0
109;01.02.2016;2016;02;00;Maanantai;0;0;0;0;0;0
109;01.02.2016;2016;02;01;Maanantai;0;0;0;0;0;0
109;01.02.2016;2016;02;02;Maanantai;0;0;0;0;0;0
109;01.02.2016;2016;02;03;Maanantai;0;0;0;0;0;0
109;01.02.2016;2016;02;04;Maanantai;1;0;1;0;0;0
109;01.02.2016;2016;02;05;Maanantai;0;2;2;0;0;0
109;01.02.2016;2016;02;06;Maanantai;18;3;21;0;0;0
109;01.02.2016;2016;02;07;Maanantai;38;13;51;0;0;0
109;01.02.2016;2016;02;08;Maanantai;49;12;61;0;0;0
109;01.02.2016;2016;02;09;Maanantai;17;3;20;0;0;0
109;01.02.2016;2016;02;10;Maanantai;8;4;12;0;0;0
109;01.02.2016;2016;02;11;Maanantai;11;2;13;0;0;0
109;01.02.2016;2016;02;12;Maanantai;10;4;14;0;0;0
109;01.02.2016;2016;02;13;Maanantai;7;10;17;0;0;0
109;01.02.2016;2016;02;14;Maanantai;11;9;20;0;0;0
109;01.02.2016;2016;02;15;Maanantai;19;20;39;0;0;0
109;01.02.2016;2016;02;16;Maanantai;24;38;62;0;0;0
109;01.02.2016;2016;02;17;Maanantai;14;20;34;0;0;0
109;01.02.2016;2016;02;18;Maanantai;7;15;22;0;0;0
109;01.02.2016;2016;02;19;Maanantai;7;3;10;0;0;0
109;01.02.2016;2016;02;20;Maanantai;4;4;8;0;0;0
109;01.02.2016;2016;02;21;Maanantai;5;7;12;0;0;0
109;01.02.2016;2016;02;22;Maanantai;5;0;5;0;0;0
109;01.02.2016;2016;02;23;Maanantai;1;0;1;0;0;0
109;02.02.2016;2016;02;00;Tiistai;0;0;0;0;0;0
109;02.02.2016;2016;02;01;Tiistai;0;0;0;0;0;0
109;02.02.2016;2016;02;02;Tiistai;0;0;0;0;0;0
109;02.02.2016;2016;02;03;Tiistai;0;0;0;0;0;0
109;02.02.2016;2016;02;04;Tiistai;0;3;3;0;0;0
109;02.02.2016;2016;02;05;Tiistai;3;2;5;0;0;0
109;02.02.2016;2016;02;06;Tiistai;13;13;26;0;0;0
109;02.02.2016;2016;02;07;Tiistai;37;34;71;0;0;0
109;02.02.2016;2016;02;08;Tiistai;27;26;53;0;0;0
109;02.02.2016;2016;02;09;Tiistai;9;9;18;0;0;0
109;02.02.2016;2016;02;10;Tiistai;5;2;7;0;0;0
109;02.02.2016;2016;02;11;Tiistai;13;10;23;0;0;0
109;02.02.2016;2016;02;12;Tiistai;5;3;8;0;0;0
109;02.02.2016;2016;02;13;Tiistai;13;10;23;0;0;0
109;02.02.2016;2016;02;14;Tiistai;12;10;22;0;0;0
109;02.02.2016;2016;02;15;Tiistai;22;20;42;0;0;0
109;02.02.2016;2016;02;16;Tiistai;32;30;62;0;0;0
109;02.02.2016;2016;02;17;Tiistai;21;18;39;0;0;0
109;02.02.2016;2016;02;18;Tiistai;8;6;14;0;0;0
109;02.02.2016;2016;02;19;Tiistai;7;5;12;0;0;0
109;02.02.2016;2016;02;20;Tiistai;4;2;6;0;0;0
109;02.02.2016;2016;02;21;Tiistai;7;6;13;0;0;0
109;02.02.2016;2016;02;22;Tiistai;8;6;14;0;0;0
109;02.02.2016;2016;02;23;Tiistai;0;0;0;0;0;0
109;03.02.2016;2016;02;00;Keskiviikko;0;0;0;0;0;0
109;03.02.2016;2016;02;01;Keskiviikko;0;0;0;0;0;0
109;03.02.2016;2016;02;02;Keskiviikko;0;0;0;0;0;0
109;03.02.2016;2016;02;03;Keskiviikko;0;0;0;0;0;0
109;03.02.2016;2016;02;04;Keskiviikko;2;2;4;0;0;0
109;03.02.2016;2016;02;05;Keskiviikko;3;1;4;0;0;0
109;03.02.2016;2016;02;06;Keskiviikko;16;14;30;0;0;0
109;03.02.2016;2016;02;07;Keskiviikko;31;30;61;0;0;0
109;03.02.2016;2016;02;08;Keskiviikko;23;20;43;0;0;0
109;03.02.2016;2016;02;09;Keskiviikko;9;7;16;0;0;0
109;03.02.2016;2016;02;10;Keskiviikko;8;7;15;0;0;0
109;03.02.2016;2016;02;11;Keskiviikko;8;4;12;0;0;0
109;03.02.2016;2016;02;12;Keskiviikko;8;7;15;0;0;0
109;03.02.2016;2016;02;13;Keskiviikko;12;9;21;0;0;0
109;03.02.2016;2016;02;14;Keskiviikko;13;11;24;0;0;0
109;03.02.2016;2016;02;15;Keskiviikko;26;25;51;0;0;0
109;03.02.2016;2016;02;16;Keskiviikko;31;28;59;0;0;0
109;03.02.2016;2016;02;17;Keskiviikko;19;17;36;0;0;0
109;03.02.2016;2016;02;18;Keskiviikko;11;10;21;0;0;0
109;03.02.2016;2016;02;19;Keskiviikko;8;7;15;0;0;0
109;03.02.2016;2016;02;20;Keskiviikko;6;4;10;0;0;0
109;03.02.2016;2016;02;21;Keskiviikko;6;2;8;0;0;0
109;03.02.2016;2016;02;22;Keskiviikko;7;4;11;0;0;0
109;03.02.2016;2016;02;23;Keskiviikko;1;0;1;0;0;0
109;04.02.2016;2016;02;00;Torstai;0;0;0;0;0;0
109;04.02.2016;2016;02;01;Torstai;0;0;0;0;0;0
109;04.02.2016;2016;02;02;Torstai;0;0;0;0;0;0
109;04.02.2016;2016;02;03;Torstai;1;0;1;0;0;0
109;04.02.2016;2016;02;04;Torstai;0;0;0;0;0;0
109;04.02.2016;2016;02;05;Torstai;3;1;4;0;0;0
109;04.02.2016;2016;02;06;Torstai;15;13;28;0;0;0
109;04.02.2016;2016;02;07;Torstai;30;30;60;0;0;0
109;04.02.2016;2016;02;08;Torstai;28;26;54;0;0;0
109;04.02.2016;2016;02;09;Torstai;10;9;19;0;0;0
109;04.02.2016;2016;02;10;Torstai;4;2;6;0;0;0
109;04.02.2016;2016;02;11;Torstai;9;6;15;0;0;0
109;04.02.2016;2016;02;12;Torstai;7;5;12;0;0;0
109;04.02.2016;2016;02;13;Torstai;10;8;18;0;0;0
109;04.02.2016;2016;02;14;Torstai;10;9;19;0;0;0
109;04.02.2016;2016;02;15;Torstai;24;23;47;0;0;0
109;04.02.2016;2016;02;16;Torstai;23;22;45;0;0;0
109;04.02.2016;2016;02;17;Torstai;21;20;41;0;0;0
109;04.02.2016;2016;02;18;Torstai;7;4;11;0;0;0
109;04.02.2016;2016;02;19;Torstai;5;4;9;0;0;0
109;04.02.2016;2016;02;20;Torstai;2;0;2;0;0;0
109;04.02.2016;2016;02;21;Torstai;6;4;10;0;0;0
109;04.02.2016;2016;02;22;Torstai;5;4;9;0;0;0
109;04.02.2016;2016;02;23;Torstai;0;0;0;0;0;0
109;05.02.2016;2016;02;00;Perjantai;0;0;0;0;0;0
109;05.02.2016;2016;02;01;Perjantai;1;0;1;0;0;0
109;05.02.2016;2016;02;02;Perjantai;0;0;0;0;0;0
109;05.02.2016;2016;02;03;Perjantai;1;0;1;0;0;0
109;05.02.2016;2016;02;04;Perjantai;1;0;1;0;0;0
109;05.02.2016;2016;02;05;Perjantai;4;2;6;0;0;0
109;05.02.2016;2016;02;06;Perjantai;14;11;25;0;0;0
109;05.02.2016;2016;02;07;Perjantai;25;22;47;0;0;0
109;05.02.2016;2016;02;08;Perjantai;27;25;52;0;0;0
109;05.02.2016;2016;02;09;Perjantai;10;7;17;0;0;0
109;05.02.2016;2016;02;10;Perjantai;7;6;13;0;0;0
109;05.02.2016;2016;02;11;Perjantai;6;5;11;0;0;0
109;05.02.2016;2016;02;12;Perjantai;7;4;11;0;0;0
109;05.02.2016;2016;02;13;Perjantai;7;5;12;0;0;0
109;05.02.2016;2016;02;14;Perjantai;16;13;29;0;0;0
109;05.02.2016;2016;02;15;Perjantai;19;16;35;0;0;0
109;05.02.2016;2016;02;16;Perjantai;26;25;51;0;0;0
109;05.02.2016;2016;02;17;Perjantai;11;9;20;0;0;0
109;05.02.2016;2016;02;18;Perjantai;5;4;9;0;0;0
109;05.02.2016;2016;02;19;Perjantai;4;3;7;0;0;0
109;05.02.2016;2016;02;20;Perjantai;3;2;5;0;0;0
109;05.02.2016;2016;02;21;Perjantai;4;3;7;0;0;0
109;05.02.2016;2016;02;22;Perjantai;3;2;5;0;0;0
109;05.02.2016;2016;02;23;Perjantai;0;0;0;0;0;0
109;06.02.2016;2016;02;00;Lauantai;3;2;5;0;0;0
109;06.02.2016;2016;02;01;Lauantai;0;0;0;0;0;0
109;06.02.2016;2016;02;02;Lauantai;0;0;0;0;0;0
109;06.02.2016;2016;02;03;Lauantai;0;0;0;0;0;0
109;06.02.2016;2016;02;04;Lauantai;0;0;0;0;0;0
109;06.02.2016;2016;02;05;Lauantai;2;0;2;0;0;0
109;06.02.2016;2016;02;06;Lauantai;2;0;2;0;0;0
109;06.02.2016;2016;02;07;Lauantai;3;2;5;0;0;0
109;06.02.2016;2016;02;08;Lauantai;3;1;4;0;0;0
109;06.02.2016;2016;02;09;Lauantai;5;2;7;0;0;0
109;06.02.2016;2016;02;10;Lauantai;4;3;7;0;0;0
109;06.02.2016;2016;02;11;Lauantai;7;5;12;0;0;0
109;06.02.2016;2016;02;12;Lauantai;8;6;14;0;0;0
109;06.02.2016;2016;02;13;Lauantai;8;7;15;0;0;0
109;06.02.2016;2016;02;14;Lauantai;6;6;12;0;0;0
109;06.02.2016;2016;02;15;Lauantai;7;4;11;0;0;0
109;06.02.2016;2016;02;16;Lauantai;6;2;8;0;0;0
109;06.02.2016;2016;02;17;Lauantai;5;2;7;0;0;0
109;06.02.2016;2016;02;18;Lauantai;2;0;2;0;0;0
109;06.02.2016;2016;02;19;Lauantai;5;4;9;0;0;0
109;06.02.2016;2016;02;20;Lauantai;5;4;9;0;0;0
109;06.02.2016;2016;02;21;Lauantai;2;0;2;0;0;0
109;06.02.2016;2016;02;22;Lauantai;1;0;1;0;0;0
109;06.02.2016;2016;02;23;Lauantai;1;1;2;0;0;0
109;07.02.2016;2016;02;00;Sunnuntai;0;0;0;0;0;0
109;07.02.2016;2016;02;01;Sunnuntai;0;0;0;0;0;0
109;07.02.2016;2016;02;02;Sunnuntai;0;0;0;0;0;0
109;07.02.2016;2016;02;03;Sunnuntai;0;0;0;0;0;0
109;07.02.2016;2016;02;04;Sunnuntai;1;0;1;0;0;0
109;07.02.2016;2016;02;05;Sunnuntai;0;0;0;0;0;0
109;07.02.2016;2016;02;06;Sunnuntai;2;0;2;0;0;0
109;07.02.2016;2016;02;07;Sunnuntai;3;1;4;0;0;0
109;07.02.2016;2016;02;08;Sunnuntai;2;1;3;0;0;0
109;07.02.2016;2016;02;09;Sunnuntai;1;1;2;0;0;0
109;07.02.2016;2016;02;10;Sunnuntai;3;2;5;0;0;0
109;07.02.2016;2016;02;11;Sunnuntai;5;1;6;0;0;0
109;07.02.2016;2016;02;12;Sunnuntai;6;3;9;0;0;0
109;07.02.2016;2016;02;13;Sunnuntai;5;4;9;0;0;0
109;07.02.2016;2016;02;14;Sunnuntai;5;4;9;0;0;0
109;07.02.2016;2016;02;15;Sunnuntai;5;2;7;0;0;0
109;07.02.2016;2016;02;16;Sunnuntai;6;5;11;0;0;0
109;07.02.2016;2016;02;17;Sunnuntai;4;1;5;0;0;0
109;07.02.2016;2016;02;18;Sunnuntai;2;1;3;0;0;0
109;07.02.2016;2016;02;19;Sunnuntai;2;1;3;0;0;0
109;07.02.2016;2016;02;20;Sunnuntai;1;3;4;0;0;0
109;07.02.2016;2016;02;21;Sunnuntai;2;3;5;0;0;0
109;07.02.2016;2016;02;22;Sunnuntai;2;1;3;0;0;0
109;07.02.2016;2016;02;23;Sunnuntai;0;0;0;0;0;0
109;08.02.2016;2016;02;00;Maanantai;0;0;0;0;0;0
109;08.02.2016;2016;02;01;Maanantai;0;1;1;0;0;0
109;08.02.2016;2016;02;02;Maanantai;0;0;0;0;0;0
109;08.02.2016;2016;02;03;Maanantai;0;0;0;0;0;0
109;08.02.2016;2016;02;04;Maanantai;2;0;2;0;0;0
109;08.02.2016;2016;02;05;Maanantai;0;5;5;0;0;0
109;08.02.2016;2016;02;06;Maanantai;15;3;18;0;0;0
109;08.02.2016;2016;02;07;Maanantai;26;19;45;0;0;0
109;08.02.2016;2016;02;08;Maanantai;29;9;38;0;0;0
109;08.02.2016;2016;02;09;Maanantai;8;3;11;0;0;0
109;08.02.2016;2016;02;10;Maanantai;5;1;6;0;0;0
109;08.02.2016;2016;02;11;Maanantai;5;1;6;0;0;0
109;08.02.2016;2016;02;12;Maanantai;6;4;10;0;0;0
109;08.02.2016;2016;02;13;Maanantai;6;9;15;0;0;0
109;08.02.2016;2016;02;14;Maanantai;5;7;12;0;0;0
109;08.02.2016;2016;02;15;Maanantai;11;29;40;0;0;0
109;08.02.2016;2016;02;16;Maanantai;17;25;42;0;0;0
109;08.02.2016;2016;02;17;Maanantai;5;23;28;0;0;0
109;08.02.2016;2016;02;18;Maanantai;5;9;14;0;0;0
109;08.02.2016;2016;02;19;Maanantai;0;5;5;0;0;0
109;08.02.2016;2016;02;20;Maanantai;2;2;4;0;0;0
109;08.02.2016;2016;02;21;Maanantai;1;4;5;0;0;0
109;08.02.2016;2016;02;22;Maanantai;9;3;12;0;0;0
109;08.02.2016;2016;02;23;Maanantai;1;2;3;0;0;0
109;09.02.2016;2016;02;00;Tiistai;0;0;0;0;0;0
109;09.02.2016;2016;02;01;Tiistai;0;1;1;0;0;0
109;09.02.2016;2016;02;02;Tiistai;0;0;0;0;0;0
109;09.02.2016;2016;02;03;Tiistai;0;0;0;0;0;0
109;09.02.2016;2016;02;04;Tiistai;0;0;0;0;0;0
109;09.02.2016;2016;02;05;Tiistai;4;6;10;0;0;0
109;09.02.2016;2016;02;06;Tiistai;14;1;15;0;0;0
109;09.02.2016;2016;02;07;Tiistai;38;15;53;0;0;0
109;09.02.2016;2016;02;08;Tiistai;28;9;37;0;0;0
109;09.02.2016;2016;02;09;Tiistai;13;5;18;0;0;0
109;09.02.2016;2016;02;10;Tiistai;3;1;4;0;0;0
109;09.02.2016;2016;02;11;Tiistai;7;3;10;0;0;0
109;09.02.2016;2016;02;12;Tiistai;3;8;11;0;0;0
109;09.02.2016;2016;02;13;Tiistai;3;7;10;0;0;0
109;09.02.2016;2016;02;14;Tiistai;9;10;19;0;0;0
109;09.02.2016;2016;02;15;Tiistai;6;25;31;0;0;0
109;09.02.2016;2016;02;16;Tiistai;13;27;40;0;0;0
109;09.02.2016;2016;02;17;Tiistai;16;8;24;0;0;0
109;09.02.2016;2016;02;18;Tiistai;2;8;10;0;0;0
109;09.02.2016;2016;02;19;Tiistai;3;5;8;0;0;0
109;09.02.2016;2016;02;20;Tiistai;2;1;3;0;0;0
109;09.02.2016;2016;02;21;Tiistai;4;7;11;0;0;0
109;09.02.2016;2016;02;22;Tiistai;5;3;8;0;0;0
109;09.02.2016;2016;02;23;Tiistai;0;1;1;0;0;0
109;10.02.2016;2016;02;00;Keskiviikko;1;0;1;0;0;0
109;10.02.2016;2016;02;01;Keskiviikko;0;0;0;0;0;0
109;10.02.2016;2016;02;02;Keskiviikko;0;1;1;0;0;0
109;10.02.2016;2016;02;03;Keskiviikko;0;0;0;0;0;0
109;10.02.2016;2016;02;04;Keskiviikko;0;0;0;0;0;0
109;10.02.2016;2016;02;05;Keskiviikko;4;6;10;0;0;0
109;10.02.2016;2016;02;06;Keskiviikko;16;1;17;0;0;0
109;10.02.2016;2016;02;07;Keskiviikko;41;18;59;0;0;0
109;10.02.2016;2016;02;08;Keskiviikko;37;8;45;0;0;0
109;10.02.2016;2016;02;09;Keskiviikko;9;3;12;0;0;0
109;10.02.2016;2016;02;10;Keskiviikko;5;3;8;0;0;0
109;10.02.2016;2016;02;11;Keskiviikko;3;6;9;0;0;0
109;10.02.2016;2016;02;12;Keskiviikko;10;4;14;0;0;0
109;10.02.2016;2016;02;13;Keskiviikko;2;8;10;0;0;0
109;10.02.2016;2016;02;14;Keskiviikko;14;8;22;0;0;0
109;10.02.2016;2016;02;15;Keskiviikko;13;29;42;0;0;0
109;10.02.2016;2016;02;16;Keskiviikko;21;35;56;0;0;0
109;10.02.2016;2016;02;17;Keskiviikko;9;20;29;0;0;0
109;10.02.2016;2016;02;18;Keskiviikko;7;6;13;0;0;0
109;10.02.2016;2016;02;19;Keskiviikko;5;1;6;0;0;0
109;10.02.2016;2016;02;20;Keskiviikko;1;7;8;0;0;0
109;10.02.2016;2016;02;21;Keskiviikko;1;6;7;0;0;0
109;10.02.2016;2016;02;22;Keskiviikko;9;3;12;0;0;0
109;10.02.2016;2016;02;23;Keskiviikko;1;0;1;0;0;0
109;11.02.2016;2016;02;00;Torstai;0;0;0;0;0;0
109;11.02.2016;2016;02;01;Torstai;1;0;1;0;0;0
109;11.02.2016;2016;02;02;Torstai;0;0;0;0;0;0
109;11.02.2016;2016;02;03;Torstai;0;0;0;0;0;0
109;11.02.2016;2016;02;04;Torstai;0;0;0;0;0;0
109;11.02.2016;2016;02;05;Torstai;1;4;5;0;0;0
109;11.02.2016;2016;02;06;Torstai;14;3;17;0;0;0
109;11.02.2016;2016;02;07;Torstai;34;19;53;0;0;0
109;11.02.2016;2016;02;08;Torstai;32;9;41;0;0;0
109;11.02.2016;2016;02;09;Torstai;9;2;11;0;0;0
109;11.02.2016;2016;02;10;Torstai;10;4;14;0;0;0
109;11.02.2016;2016;02;11;Torstai;5;1;6;0;0;0
109;11.02.2016;2016;02;12;Torstai;15;3;18;0;0;0
109;11.02.2016;2016;02;13;Torstai;9;6;15;0;0;0
109;11.02.2016;2016;02;14;Torstai;8;12;20;0;0;0
109;11.02.2016;2016;02;15;Torstai;19;23;42;0;0;0
109;11.02.2016;2016;02;16;Torstai;25;24;49;0;0;0
109;11.02.2016;2016;02;17;Torstai;7;24;31;0;0;0
109;11.02.2016;2016;02;18;Torstai;2;7;9;0;0;0
109;11.02.2016;2016;02;19;Torstai;4;5;9;0;0;0
109;11.02.2016;2016;02;20;Torstai;0;3;3;0;0;0
109;11.02.2016;2016;02;21;Torstai;1;5;6;0;0;0
109;11.02.2016;2016;02;22;Torstai;8;1;9;0;0;0
109;11.02.2016;2016;02;23;Torstai;1;0;1;0;0;0
109;12.02.2016;2016;02;00;Perjantai;0;0;0;0;0;0
109;12.02.2016;2016;02;01;Perjantai;0;0;0;0;0;0
109;12.02.2016;2016;02;02;Perjantai;0;0;0;0;0;0
109;12.02.2016;2016;02;03;Perjantai;0;0;0;0;0;0
109;12.02.2016;2016;02;04;Perjantai;2;1;3;0;0;0
109;12.02.2016;2016;02;05;Perjantai;1;4;5;0;0;0
109;12.02.2016;2016;02;06;Perjantai;18;7;25;0;0;0
109;12.02.2016;2016;02;07;Perjantai;37;17;54;0;0;0
109;12.02.2016;2016;02;08;Perjantai;18;16;34;0;0;0
109;12.02.2016;2016;02;09;Perjantai;9;6;15;0;0;0
109;12.02.2016;2016;02;10;Perjantai;4;3;7;0;0;0
109;12.02.2016;2016;02;11;Perjantai;6;5;11;0;0;0
109;12.02.2016;2016;02;12;Perjantai;9;6;15;0;0;0
109;12.02.2016;2016;02;13;Perjantai;8;6;14;0;0;0
109;12.02.2016;2016;02;14;Perjantai;12;10;22;0;0;0
109;12.02.2016;2016;02;15;Perjantai;13;13;26;0;0;0
109;12.02.2016;2016;02;16;Perjantai;17;14;31;0;0;0
109;12.02.2016;2016;02;17;Perjantai;7;7;14;0;0;0
109;12.02.2016;2016;02;18;Perjantai;5;4;9;0;0;0
109;12.02.2016;2016;02;19;Perjantai;2;0;2;0;0;0
109;12.02.2016;2016;02;20;Perjantai;3;1;4;0;0;0
109;12.02.2016;2016;02;21;Perjantai;1;1;2;0;0;0
109;12.02.2016;2016;02;22;Perjantai;5;2;7;0;0;0
109;12.02.2016;2016;02;23;Perjantai;0;0;0;0;0;0
109;13.02.2016;2016;02;00;Lauantai;2;1;3;0;0;0
109;13.02.2016;2016;02;01;Lauantai;0;0;0;0;0;0
109;13.02.2016;2016;02;02;Lauantai;0;0;0;0;0;0
109;13.02.2016;2016;02;03;Lauantai;0;0;0;0;0;0
109;13.02.2016;2016;02;04;Lauantai;3;0;3;0;0;0
109;13.02.2016;2016;02;05;Lauantai;0;0;0;0;0;0
109;13.02.2016;2016;02;06;Lauantai;3;1;4;0;0;0
109;13.02.2016;2016;02;07;Lauantai;3;1;4;0;0;0
109;13.02.2016;2016;02;08;Lauantai;4;1;5;0;0;0
109;13.02.2016;2016;02;09;Lauantai;4;3;7;0;0;0
109;13.02.2016;2016;02;10;Lauantai;4;2;6;0;0;0
109;13.02.2016;2016;02;11;Lauantai;4;2;6;0;0;0
109;13.02.2016;2016;02;12;Lauantai;3;2;5;0;0;0
109;13.02.2016;2016;02;13;Lauantai;8;5;13;0;0;0
109;13.02.2016;2016;02;14;Lauantai;5;3;8;0;0;0
109;13.02.2016;2016;02;15;Lauantai;3;2;5;0;0;0
109;13.02.2016;2016;02;16;Lauantai;4;3;7;0;0;0
109;13.02.2016;2016;02;17;Lauantai;5;4;9;0;0;0
109;13.02.2016;2016;02;18;Lauantai;5;3;8;0;0;0
109;13.02.2016;2016;02;19;Lauantai;3;1;4;0;0;0
109;13.02.2016;2016;02;20;Lauantai;2;2;4;0;0;0
109;13.02.2016;2016;02;21;Lauantai;3;0;3;0;0;0
109;13.02.2016;2016;02;22;Lauantai;0;0;0;0;0;0
109;13.02.2016;2016;02;23;Lauantai;2;1;3;0;0;0
109;14.02.2016;2016;02;00;Sunnuntai;1;1;2;0;0;0
109;14.02.2016;2016;02;01;Sunnuntai;0;0;0;0;0;0
109;14.02.2016;2016;02;02;Sunnuntai;1;1;2;0;0;0
109;14.02.2016;2016;02;03;Sunnuntai;0;0;0;0;0;0
109;14.02.2016;2016;02;04;Sunnuntai;0;0;0;0;0;0
109;14.02.2016;2016;02;05;Sunnuntai;1;0;1;0;0;0
109;14.02.2016;2016;02;06;Sunnuntai;4;1;5;0;0;0
109;14.02.2016;2016;02;07;Sunnuntai;0;0;0;0;0;0
109;14.02.2016;2016;02;08;Sunnuntai;3;1;4;0;0;0
109;14.02.2016;2016;02;09;Sunnuntai;2;0;2;0;0;0
109;14.02.2016;2016;02;10;Sunnuntai;3;0;3;0;0;0
109;14.02.2016;2016;02;11;Sunnuntai;1;1;2;0;0;0
109;14.02.2016;2016;02;12;Sunnuntai;2;0;2;0;0;0
109;14.02.2016;2016;02;13;Sunnuntai;4;2;6;0;0;0
109;14.02.2016;2016;02;14;Sunnuntai;8;6;14;0;0;0
109;14.02.2016;2016;02;15;Sunnuntai;6;4;10;0;0;0
109;14.02.2016;2016;02;16;Sunnuntai;4;1;5;0;0;0
109;14.02.2016;2016;02;17;Sunnuntai;2;1;3;0;0;0
109;14.02.2016;2016;02;18;Sunnuntai;4;4;8;0;0;0
109;14.02.2016;2016;02;19;Sunnuntai;2;0;2;0;0;0
109;14.02.2016;2016;02;20;Sunnuntai;6;4;10;0;0;0
109;14.02.2016;2016;02;21;Sunnuntai;3;0;3;0;0;0
109;14.02.2016;2016;02;22;Sunnuntai;0;0;0;0;0;0
109;14.02.2016;2016;02;23;Sunnuntai;1;0;1;0;0;0
109;15.02.2016;2016;02;00;Maanantai;0;0;0;0;0;0
109;15.02.2016;2016;02;01;Maanantai;0;0;0;0;0;0
109;15.02.2016;2016;02;02;Maanantai;0;0;0;0;0;0
109;15.02.2016;2016;02;03;Maanantai;1;1;2;0;0;0
109;15.02.2016;2016;02;04;Maanantai;3;1;4;0;0;0
109;15.02.2016;2016;02;05;Maanantai;4;2;6;0;0;0
109;15.02.2016;2016;02;06;Maanantai;9;5;14;0;0;0
109;15.02.2016;2016;02;07;Maanantai;35;31;66;0;0;0
109;15.02.2016;2016;02;08;Maanantai;34;32;66;0;0;0
109;15.02.2016;2016;02;09;Maanantai;11;10;21;0;0;0
109;15.02.2016;2016;02;10;Maanantai;7;7;14;0;0;0
109;15.02.2016;2016;02;11;Maanantai;6;4;10;0;0;0
109;15.02.2016;2016;02;12;Maanantai;11;9;20;0;0;0
109;15.02.2016;2016;02;13;Maanantai;11;10;21;0;0;0
109;15.02.2016;2016;02;14;Maanantai;10;8;18;0;0;0
109;15.02.2016;2016;02;15;Maanantai;26;24;50;0;0;0
109;15.02.2016;2016;02;16;Maanantai;42;40;82;0;0;0
109;15.02.2016;2016;02;17;Maanantai;14;12;26;0;0;0
109;15.02.2016;2016;02;18;Maanantai;9;6;15;0;0;0
109;15.02.2016;2016;02;19;Maanantai;7;5;12;0;0;0
109;15.02.2016;2016;02;20;Maanantai;7;4;11;0;0;0
109;15.02.2016;2016;02;21;Maanantai;6;2;8;0;0;0
109;15.02.2016;2016;02;22;Maanantai;6;5;11;0;0;0
109;15.02.2016;2016;02;23;Maanantai;2;0;2;0;0;0
109;16.02.2016;2016;02;00;Tiistai;1;0;1;0;0;0
109;16.02.2016;2016;02;01;Tiistai;0;0;0;0;0;0
109;16.02.2016;2016;02;02;Tiistai;0;0;0;0;0;0
109;16.02.2016;2016;02;03;Tiistai;0;0;0;0;0;0
109;16.02.2016;2016;02;04;Tiistai;1;1;2;0;0;0
109;16.02.2016;2016;02;05;Tiistai;3;1;4;0;0;0
109;16.02.2016;2016;02;06;Tiistai;11;11;22;0;0;0
109;16.02.2016;2016;02;07;Tiistai;42;41;83;0;0;0
109;16.02.2016;2016;02;08;Tiistai;26;23;49;0;0;0
109;16.02.2016;2016;02;09;Tiistai;16;14;30;0;0;0
109;16.02.2016;2016;02;10;Tiistai;3;1;4;0;0;0
109;16.02.2016;2016;02;11;Tiistai;8;6;14;0;0;0
109;16.02.2016;2016;02;12;Tiistai;10;8;18;0;0;0
109;16.02.2016;2016;02;13;Tiistai;12;11;23;0;0;0
109;16.02.2016;2016;02;14;Tiistai;9;7;16;0;0;0
109;16.02.2016;2016;02;15;Tiistai;27;26;53;0;0;0
109;16.02.2016;2016;02;16;Tiistai;30;28;58;0;0;0
109;16.02.2016;2016;02;17;Tiistai;22;19;41;0;0;0
109;16.02.2016;2016;02;18;Tiistai;14;12;26;0;0;0
109;16.02.2016;2016;02;19;Tiistai;6;3;9;0;0;0
109;16.02.2016;2016;02;20;Tiistai;4;2;6;0;0;0
109;16.02.2016;2016;02;21;Tiistai;7;3;10;0;0;0
109;16.02.2016;2016;02;22;Tiistai;11;9;20;0;0;0
109;16.02.2016;2016;02;23;Tiistai;0;0;0;0;0;0
109;17.02.2016;2016;02;00;Keskiviikko;1;0;1;0;0;0
109;17.02.2016;2016;02;01;Keskiviikko;0;0;0;0;0;0
109;17.02.2016;2016;02;02;Keskiviikko;1;0;1;0;0;0
109;17.02.2016;2016;02;03;Keskiviikko;0;0;0;0;0;0
109;17.02.2016;2016;02;04;Keskiviikko;2;1;3;0;0;0
109;17.02.2016;2016;02;05;Keskiviikko;3;2;5;0;0;0
109;17.02.2016;2016;02;06;Keskiviikko;16;16;32;0;0;0
109;17.02.2016;2016;02;07;Keskiviikko;40;38;78;0;0;0
109;17.02.2016;2016;02;08;Keskiviikko;26;24;50;0;0;0
109;17.02.2016;2016;02;09;Keskiviikko;10;8;18;0;0;0
109;17.02.2016;2016;02;10;Keskiviikko;6;5;11;0;0;0
109;17.02.2016;2016;02;11;Keskiviikko;10;7;17;0;0;0
109;17.02.2016;2016;02;12;Keskiviikko;11;9;20;0;0;0
109;17.02.2016;2016;02;13;Keskiviikko;11;10;21;0;0;0
109;17.02.2016;2016;02;14;Keskiviikko;12;11;23;0;0;0
109;17.02.2016;2016;02;15;Keskiviikko;26;24;50;0;0;0
109;17.02.2016;2016;02;16;Keskiviikko;37;35;72;0;0;0
109;17.02.2016;2016;02;17;Keskiviikko;22;20;42;0;0;0
109;17.02.2016;2016;02;18;Keskiviikko;12;10;22;0;0;0
109;17.02.2016;2016;02;19;Keskiviikko;5;4;9;0;0;0
109;17.02.2016;2016;02;20;Keskiviikko;4;3;7;0;0;0
109;17.02.2016;2016;02;21;Keskiviikko;7;5;12;0;0;0
109;17.02.2016;2016;02;22;Keskiviikko;6;6;12;0;0;0
109;17.02.2016;2016;02;23;Keskiviikko;1;0;1;0;0;0
109;18.02.2016;2016;02;00;Torstai;2;1;3;0;0;0
109;18.02.2016;2016;02;01;Torstai;0;0;0;0;0;0
109;18.02.2016;2016;02;02;Torstai;1;0;1;0;0;0
109;18.02.2016;2016;02;03;Torstai;0;0;0;0;0;0
109;18.02.2016;2016;02;04;Torstai;3;0;3;0;0;0
109;18.02.2016;2016;02;05;Torstai;2;0;2;0;0;0
109;18.02.2016;2016;02;06;Torstai;13;13;26;0;0;0
109;18.02.2016;2016;02;07;Torstai;40;37;77;0;0;0
109;18.02.2016;2016;02;08;Torstai;36;34;70;0;0;0
109;18.02.2016;2016;02;09;Torstai;13;9;22;0;0;0
109;18.02.2016;2016;02;10;Torstai;10;8;18;0;0;0
109;18.02.2016;2016;02;11;Torstai;7;6;13;0;0;0
109;18.02.2016;2016;02;12;Torstai;13;10;23;0;0;0
109;18.02.2016;2016;02;13;Torstai;16;14;30;0;0;0
109;18.02.2016;2016;02;14;Torstai;13;10;23;0;0;0
109;18.02.2016;2016;02;15;Torstai;29;25;54;0;0;0
109;18.02.2016;2016;02;16;Torstai;40;29;69;0;0;0
109;18.02.2016;2016;02;17;Torstai;22;12;34;0;0;0
109;18.02.2016;2016;02;18;Torstai;8;6;14;0;0;0
109;18.02.2016;2016;02;19;Torstai;5;3;8;0;0;0
109;18.02.2016;2016;02;20;Torstai;5;2;7;0;0;0
109;18.02.2016;2016;02;21;Torstai;4;2;6;0;0;0
109;18.02.2016;2016;02;22;Torstai;3;3;6;0;0;0
109;18.02.2016;2016;02;23;Torstai;1;0;1;0;0;0
109;19.02.2016;2016;02;00;Perjantai;1;0;1;0;0;0
109;19.02.2016;2016;02;01;Perjantai;0;0;0;0;0;0
109;19.02.2016;2016;02;02;Perjantai;1;0;1;0;0;0
109;19.02.2016;2016;02;03;Perjantai;0;0;0;0;0;0
109;19.02.2016;2016;02;04;Perjantai;1;0;1;0;0;0
109;19.02.2016;2016;02;05;Perjantai;3;1;4;0;0;0
109;19.02.2016;2016;02;06;Perjantai;10;10;20;0;0;0
109;19.02.2016;2016;02;07;Perjantai;29;26;55;0;0;0
109;19.02.2016;2016;02;08;Perjantai;23;20;43;0;0;0
109;19.02.2016;2016;02;09;Perjantai;8;7;15;0;0;0
109;19.02.2016;2016;02;10;Perjantai;4;3;7;0;0;0
109;19.02.2016;2016;02;11;Perjantai;11;9;20;0;0;0
109;19.02.2016;2016;02;12;Perjantai;11;9;20;0;0;0
109;19.02.2016;2016;02;13;Perjantai;11;10;21;0;0;0
109;19.02.2016;2016;02;14;Perjantai;15;13;28;0;0;0
109;19.02.2016;2016;02;15;Perjantai;25;22;47;0;0;0
109;19.02.2016;2016;02;16;Perjantai;29;26;55;0;0;0
109;19.02.2016;2016;02;17;Perjantai;11;8;19;0;0;0
109;19.02.2016;2016;02;18;Perjantai;5;3;8;0;0;0
109;19.02.2016;2016;02;19;Perjantai;8;6;14;0;0;0
109;19.02.2016;2016;02;20;Perjantai;7;2;9;0;0;0
109;19.02.2016;2016;02;21;Perjantai;4;3;7;0;0;0
109;19.02.2016;2016;02;22;Perjantai;4;1;5;0;0;0
109;19.02.2016;2016;02;23;Perjantai;3;1;4;0;0;0
109;20.02.2016;2016;02;00;Lauantai;1;1;2;0;0;0
109;20.02.2016;2016;02;01;Lauantai;1;1;2;0;0;0
109;20.02.2016;2016;02;02;Lauantai;0;0;0;0;0;0
109;20.02.2016;2016;02;03;Lauantai;1;0;1;0;0;0
109;20.02.2016;2016;02;04;Lauantai;0;0;0;0;0;0
109;20.02.2016;2016;02;05;Lauantai;3;0;3;0;0;0
109;20.02.2016;2016;02;06;Lauantai;4;1;5;0;0;0
109;20.02.2016;2016;02;07;Lauantai;1;0;1;0;0;0
109;20.02.2016;2016;02;08;Lauantai;5;2;7;0;0;0
109;20.02.2016;2016;02;09;Lauantai;2;1;3;0;0;0
109;20.02.2016;2016;02;10;Lauantai;4;2;6;0;0;0
109;20.02.2016;2016;02;11;Lauantai;4;3;7;0;0;0
109;20.02.2016;2016;02;12;Lauantai;12;6;18;0;0;0
109;20.02.2016;2016;02;13;Lauantai;6;2;8;0;0;0
109;20.02.2016;2016;02;14;Lauantai;12;3;15;0;0;0
109;20.02.2016;2016;02;15;Lauantai;9;4;13;0;0;0
109;20.02.2016;2016;02;16;Lauantai;9;4;13;0;0;0
109;20.02.2016;2016;02;17;Lauantai;5;6;11;0;0;0
109;20.02.2016;2016;02;18;Lauantai;6;2;8;0;0;0
109;20.02.2016;2016;02;19;Lauantai;4;4;8;0;0;0
109;20.02.2016;2016;02;20;Lauantai;4;1;5;0;0;0
109;20.02.2016;2016;02;21;Lauantai;7;4;11;0;0;0
109;20.02.2016;2016;02;22;Lauantai;1;1;2;0;0;0
109;20.02.2016;2016;02;23;Lauantai;2;0;2;0;0;0
109;21.02.2016;2016;02;00;Sunnuntai;0;0;0;0;0;0
109;21.02.2016;2016;02;01;Sunnuntai;1;1;2;0;0;0
109;21.02.2016;2016;02;02;Sunnuntai;0;0;0;0;0;0
109;21.02.2016;2016;02;03;Sunnuntai;1;0;1;0;0;0
109;21.02.2016;2016;02;04;Sunnuntai;0;0;0;0;0;0
109;21.02.2016;2016;02;05;Sunnuntai;0;0;0;0;0;0
109;21.02.2016;2016;02;06;Sunnuntai;2;0;2;0;0;0
109;21.02.2016;2016;02;07;Sunnuntai;3;0;3;0;0;0
109;21.02.2016;2016;02;08;Sunnuntai;0;0;0;0;0;0
109;21.02.2016;2016;02;09;Sunnuntai;0;0;0;0;0;0
109;21.02.2016;2016;02;10;Sunnuntai;2;0;2;0;0;0
109;21.02.2016;2016;02;11;Sunnuntai;2;0;2;0;0;0
109;21.02.2016;2016;02;12;Sunnuntai;4;2;6;0;0;0
109;21.02.2016;2016;02;13;Sunnuntai;2;0;2;0;0;0
109;21.02.2016;2016;02;14;Sunnuntai;4;2;6;0;0;0
109;21.02.2016;2016;02;15;Sunnuntai;5;3;8;0;0;0
109;21.02.2016;2016;02;16;Sunnuntai;7;5;12;0;0;0
109;21.02.2016;2016;02;17;Sunnuntai;4;1;5;0;0;0
109;21.02.2016;2016;02;18;Sunnuntai;2;2;4;0;0;0
109;21.02.2016;2016;02;19;Sunnuntai;4;1;5;0;0;0
109;21.02.2016;2016;02;20;Sunnuntai;6;2;8;0;0;0
109;21.02.2016;2016;02;21;Sunnuntai;4;3;7;0;0;0
109;21.02.2016;2016;02;22;Sunnuntai;2;1;3;0;0;0
109;21.02.2016;2016;02;23;Sunnuntai;0;0;0;0;0;0
109;22.02.2016;2016;02;00;Maanantai;0;0;0;0;0;0
109;22.02.2016;2016;02;01;Maanantai;0;0;0;0;0;0
109;22.02.2016;2016;02;02;Maanantai;0;0;0;0;0;0
109;22.02.2016;2016;02;03;Maanantai;0;0;0;0;0;0
109;22.02.2016;2016;02;04;Maanantai;2;0;2;0;0;0
109;22.02.2016;2016;02;05;Maanantai;4;2;6;0;0;0
109;22.02.2016;2016;02;06;Maanantai;13;12;25;0;0;0
109;22.02.2016;2016;02;07;Maanantai;38;36;74;0;0;0
109;22.02.2016;2016;02;08;Maanantai;27;25;52;0;0;0
109;22.02.2016;2016;02;09;Maanantai;9;5;14;0;0;0
109;22.02.2016;2016;02;10;Maanantai;7;5;12;0;0;0
109;22.02.2016;2016;02;11;Maanantai;4;3;7;0;0;0
109;22.02.2016;2016;02;12;Maanantai;6;4;10;0;0;0
109;22.02.2016;2016;02;13;Maanantai;10;7;17;0;0;0
109;22.02.2016;2016;02;14;Maanantai;11;8;19;0;0;0
109;22.02.2016;2016;02;15;Maanantai;25;22;47;0;0;0
109;22.02.2016;2016;02;16;Maanantai;37;34;71;0;0;0
109;22.02.2016;2016;02;17;Maanantai;16;14;30;0;0;0
109;22.02.2016;2016;02;18;Maanantai;14;11;25;0;0;0
109;22.02.2016;2016;02;19;Maanantai;6;4;10;0;0;0
109;22.02.2016;2016;02;20;Maanantai;5;5;10;0;0;0
109;22.02.2016;2016;02;21;Maanantai;4;2;6;0;0;0
109;22.02.2016;2016;02;22;Maanantai;4;2;6;0;0;0
109;22.02.2016;2016;02;23;Maanantai;1;0;1;0;0;0
109;23.02.2016;2016;02;00;Tiistai;1;1;2;0;0;0
109;23.02.2016;2016;02;01;Tiistai;1;0;1;0;0;0
109;23.02.2016;2016;02;02;Tiistai;0;0;0;0;0;0
109;23.02.2016;2016;02;03;Tiistai;0;0;0;0;0;0
109;23.02.2016;2016;02;04;Tiistai;3;0;3;0;0;0
109;23.02.2016;2016;02;05;Tiistai;4;2;6;0;0;0
109;23.02.2016;2016;02;06;Tiistai;13;10;23;0;0;0
109;23.02.2016;2016;02;07;Tiistai;31;30;61;0;0;0
109;23.02.2016;2016;02;08;Tiistai;27;25;52;0;0;0
109;23.02.2016;2016;02;09;Tiistai;17;14;31;0;0;0
109;23.02.2016;2016;02;10;Tiistai;6;5;11;0;0;0
109;23.02.2016;2016;02;11;Tiistai;8;5;13;0;0;0
109;23.02.2016;2016;02;12;Tiistai;3;2;5;0;0;0
109;23.02.2016;2016;02;13;Tiistai;8;5;13;0;0;0
109;23.02.2016;2016;02;14;Tiistai;10;9;19;0;0;0
109;23.02.2016;2016;02;15;Tiistai;25;22;47;0;0;0
109;23.02.2016;2016;02;16;Tiistai;38;36;74;0;0;0
109;23.02.2016;2016;02;17;Tiistai;21;20;41;0;0;0
109;23.02.2016;2016;02;18;Tiistai;7;6;13;0;0;0
109;23.02.2016;2016;02;19;Tiistai;10;7;17;0;0;0
109;23.02.2016;2016;02;20;Tiistai;8;5;13;0;0;0
109;23.02.2016;2016;02;21;Tiistai;5;3;8;0;0;0
109;23.02.2016;2016;02;22;Tiistai;4;2;6;0;0;0
109;23.02.2016;2016;02;23;Tiistai;2;0;2;0;0;0
109;24.02.2016;2016;02;00;Keskiviikko;2;2;4;0;0;0
109;24.02.2016;2016;02;01;Keskiviikko;0;0;0;0;0;0
109;24.02.2016;2016;02;02;Keskiviikko;1;0;1;0;0;0
109;24.02.2016;2016;02;03;Keskiviikko;0;0;0;0;0;0
109;24.02.2016;2016;02;04;Keskiviikko;1;0;1;0;0;0
109;24.02.2016;2016;02;05;Keskiviikko;5;2;7;0;0;0
109;24.02.2016;2016;02;06;Keskiviikko;13;11;24;0;0;0
109;24.02.2016;2016;02;07;Keskiviikko;41;37;78;0;0;0
109;24.02.2016;2016;02;08;Keskiviikko;32;27;59;0;0;0
109;24.02.2016;2016;02;09;Keskiviikko;14;10;24;0;0;0
109;24.02.2016;2016;02;10;Keskiviikko;5;3;8;0;0;0
109;24.02.2016;2016;02;11;Keskiviikko;7;7;14;0;0;0
109;24.02.2016;2016;02;12;Keskiviikko;13;10;23;0;0;0
109;24.02.2016;2016;02;13;Keskiviikko;14;10;24;0;0;0
109;24.02.2016;2016;02;14;Keskiviikko;17;16;33;0;0;0
109;24.02.2016;2016;02;15;Keskiviikko;22;20;42;0;0;0
109;24.02.2016;2016;02;16;Keskiviikko;41;39;80;0;0;0
109;24.02.2016;2016;02;17;Keskiviikko;16;14;30;0;0;0
109;24.02.2016;2016;02;18;Keskiviikko;9;8;17;0;0;0
109;24.02.2016;2016;02;19;Keskiviikko;6;4;10;0;0;0
109;24.02.2016;2016;02;20;Keskiviikko;4;4;8;0;0;0
109;24.02.2016;2016;02;21;Keskiviikko;7;4;11;0;0;0
109;24.02.2016;2016;02;22;Keskiviikko;6;4;10;0;0;0
109;24.02.2016;2016;02;23;Keskiviikko;2;1;3;0;0;0
109;25.02.2016;2016;02;00;Torstai;0;0;0;0;0;0
109;25.02.2016;2016;02;01;Torstai;0;0;0;0;0;0
109;25.02.2016;2016;02;02;Torstai;1;0;1;0;0;0
109;25.02.2016;2016;02;03;Torstai;0;0;0;0;0;0
109;25.02.2016;2016;02;04;Torstai;0;0;0;0;0;0
109;25.02.2016;2016;02;05;Torstai;6;3;9;0;0;0
109;25.02.2016;2016;02;06;Torstai;8;6;14;0;0;0
109;25.02.2016;2016;02;07;Torstai;30;28;58;0;0;0
109;25.02.2016;2016;02;08;Torstai;24;23;47;0;0;0
109;25.02.2016;2016;02;09;Torstai;9;5;14;0;0;0
109;25.02.2016;2016;02;10;Torstai;5;3;8;0;0;0
109;25.02.2016;2016;02;11;Torstai;6;6;12;0;0;0
109;25.02.2016;2016;02;12;Torstai;11;8;19;0;0;0
109;25.02.2016;2016;02;13;Torstai;7;4;11;0;0;0
109;25.02.2016;2016;02;14;Torstai;10;9;19;0;0;0
109;25.02.2016;2016;02;15;Torstai;28;26;54;0;0;0
109;25.02.2016;2016;02;16;Torstai;40;39;79;0;0;0
109;25.02.2016;2016;02;17;Torstai;15;14;29;0;0;0
109;25.02.2016;2016;02;18;Torstai;9;8;17;0;0;0
109;25.02.2016;2016;02;19;Torstai;7;6;13;0;0;0
109;25.02.2016;2016;02;20;Torstai;7;6;13;0;0;0
109;25.02.2016;2016;02;21;Torstai;2;0;2;0;0;0
109;25.02.2016;2016;02;22;Torstai;3;3;6;0;0;0
109;25.02.2016;2016;02;23;Torstai;1;0;1;0;0;0
109;26.02.2016;2016;02;00;Perjantai;2;0;2;0;0;0
109;26.02.2016;2016;02;01;Perjantai;0;0;0;0;0;0
109;26.02.2016;2016;02;02;Perjantai;0;0;0;0;0;0
109;26.02.2016;2016;02;03;Perjantai;0;0;0;0;0;0
109;26.02.2016;2016;02;04;Perjantai;1;0;1;0;0;0
109;26.02.2016;2016;02;05;Perjantai;4;3;7;0;0;0
109;26.02.2016;2016;02;06;Perjantai;8;6;14;0;0;0
109;26.02.2016;2016;02;07;Perjantai;24;22;46;0;0;0
109;26.02.2016;2016;02;08;Perjantai;17;14;31;0;0;0
109;26.02.2016;2016;02;09;Perjantai;5;4;9;0;0;0
109;26.02.2016;2016;02;10;Perjantai;6;4;10;0;0;0
109;26.02.2016;2016;02;11;Perjantai;5;4;9;0;0;0
109;26.02.2016;2016;02;12;Perjantai;8;7;15;0;0;0
109;26.02.2016;2016;02;13;Perjantai;9;6;15;0;0;0
109;26.02.2016;2016;02;14;Perjantai;13;12;25;0;0;0
109;26.02.2016;2016;02;15;Perjantai;15;14;29;0;0;0
109;26.02.2016;2016;02;16;Perjantai;19;15;34;0;0;0
109;26.02.2016;2016;02;17;Perjantai;13;10;23;0;0;0
109;26.02.2016;2016;02;18;Perjantai;2;0;2;0;0;0
109;26.02.2016;2016;02;19;Perjantai;4;3;7;0;0;0
109;26.02.2016;2016;02;20;Perjantai;3;2;5;0;0;0
109;26.02.2016;2016;02;21;Perjantai;3;3;6;0;0;0
109;26.02.2016;2016;02;22;Perjantai;3;2;5;0;0;0
109;26.02.2016;2016;02;23;Perjantai;1;0;1;0;0;0
109;27.02.2016;2016;02;00;Lauantai;2;0;2;0;0;0
109;27.02.2016;2016;02;01;Lauantai;2;1;3;0;0;0
109;27.02.2016;2016;02;02;Lauantai;0;0;0;0;0;0
109;27.02.2016;2016;02;03;Lauantai;0;0;0;0;0;0
109;27.02.2016;2016;02;04;Lauantai;2;0;2;0;0;0
109;27.02.2016;2016;02;05;Lauantai;1;0;1;0;0;0
109;27.02.2016;2016;02;06;Lauantai;2;1;3;0;0;0
109;27.02.2016;2016;02;07;Lauantai;5;1;6;0;0;0
109;27.02.2016;2016;02;08;Lauantai;4;2;6;0;0;0
109;27.02.2016;2016;02;09;Lauantai;4;2;6;0;0;0
109;27.02.2016;2016;02;10;Lauantai;3;1;4;0;0;0
109;27.02.2016;2016;02;11;Lauantai;3;2;5;0;0;0
109;27.02.2016;2016;02;12;Lauantai;6;4;10;0;0;0
109;27.02.2016;2016;02;13;Lauantai;5;4;9;0;0;0
109;27.02.2016;2016;02;14;Lauantai;8;6;14;0;0;0
109;27.02.2016;2016;02;15;Lauantai;7;6;13;0;0;0
109;27.02.2016;2016;02;16;Lauantai;6;3;9;0;0;0
109;27.02.2016;2016;02;17;Lauantai;3;2;5;0;0;0
109;27.02.2016;2016;02;18;Lauantai;4;2;6;0;0;0
109;27.02.2016;2016;02;19;Lauantai;2;0;2;0;0;0
109;27.02.2016;2016;02;20;Lauantai;2;2;4;0;0;0
109;27.02.2016;2016;02;21;Lauantai;5;2;7;0;0;0
109;27.02.2016;2016;02;22;Lauantai;5;3;8;0;0;0
109;27.02.2016;2016;02;23;Lauantai;1;0;1;0;0;0
109;28.02.2016;2016;02;00;Sunnuntai;3;0;3;0;0;0
109;28.02.2016;2016;02;01;Sunnuntai;1;0;1;0;0;0
109;28.02.2016;2016;02;02;Sunnuntai;0;0;0;0;0;0
109;28.02.2016;2016;02;03;Sunnuntai;0;0;0;0;0;0
109;28.02.2016;2016;02;04;Sunnuntai;2;0;2;0;0;0
109;28.02.2016;2016;02;05;Sunnuntai;0;0;0;0;0;0
109;28.02.2016;2016;02;06;Sunnuntai;2;1;3;0;0;0
109;28.02.2016;2016;02;07;Sunnuntai;1;0;1;0;0;0
109;28.02.2016;2016;02;08;Sunnuntai;2;1;3;0;0;0
109;28.02.2016;2016;02;09;Sunnuntai;3;1;4;0;0;0
109;28.02.2016;2016;02;10;Sunnuntai;2;1;3;0;0;0
109;28.02.2016;2016;02;11;Sunnuntai;5;2;7;0;0;0
109;28.02.2016;2016;02;12;Sunnuntai;6;4;10;0;0;0
109;28.02.2016;2016;02;13;Sunnuntai;8;6;14;0;0;0
109;28.02.2016;2016;02;14;Sunnuntai;6;5;11;0;0;0
109;28.02.2016;2016;02;15;Sunnuntai;8;6;14;0;0;0
109;28.02.2016;2016;02;16;Sunnuntai;6;4;10;0;0;0
109;28.02.2016;2016;02;17;Sunnuntai;3;2;5;0;0;0
109;28.02.2016;2016;02;18;Sunnuntai;6;3;9;0;0;0
109;28.02.2016;2016;02;19;Sunnuntai;3;2;5;0;0;0
109;28.02.2016;2016;02;20;Sunnuntai;1;0;1;0;0;0
109;28.02.2016;2016;02;21;Sunnuntai;4;2;6;0;0;0
109;28.02.2016;2016;02;22;Sunnuntai;2;1;3;0;0;0
109;28.02.2016;2016;02;23;Sunnuntai;0;0;0;0;0;0
109;29.02.2016;2016;02;00;Maanantai;0;0;0;0;0;0
109;29.02.2016;2016;02;01;Maanantai;1;0;1;0;0;0
109;29.02.2016;2016;02;02;Maanantai;0;0;0;0;0;0
109;29.02.2016;2016;02;03;Maanantai;0;0;0;0;0;0
109;29.02.2016;2016;02;04;Maanantai;0;0;0;0;0;0
109;29.02.2016;2016;02;05;Maanantai;1;1;2;4;0;4
109;29.02.2016;2016;02;06;Maanantai;12;9;21;0;3;3
109;29.02.2016;2016;02;07;Maanantai;29;26;55;6;4;10
109;29.02.2016;2016;02;08;Maanantai;30;29;59;2;3;5
109;29.02.2016;2016;02;09;Maanantai;7;7;14;3;4;7
109;29.02.2016;2016;02;10;Maanantai;8;4;12;3;2;5
109;29.02.2016;2016;02;11;Maanantai;8;6;14;2;5;7
109;29.02.2016;2016;02;12;Maanantai;8;7;15;5;2;7
109;29.02.2016;2016;02;13;Maanantai;10;9;19;5;4;9
109;29.02.2016;2016;02;14;Maanantai;14;12;26;5;3;8
109;29.02.2016;2016;02;15;Maanantai;30;28;58;4;9;13
109;29.02.2016;2016;02;16;Maanantai;34;33;67;4;5;9
109;29.02.2016;2016;02;17;Maanantai;17;14;31;7;5;12
109;29.02.2016;2016;02;18;Maanantai;6;6;12;5;5;10
109;29.02.2016;2016;02;19;Maanantai;7;4;11;2;3;5
109;29.02.2016;2016;02;20;Maanantai;7;6;13;1;4;5
109;29.02.2016;2016;02;21;Maanantai;6;4;10;1;1;2
109;29.02.2016;2016;02;22;Maanantai;6;5;11;0;1;1
109;29.02.2016;2016;02;23;Maanantai;1;0;1;1;0;1
109;01.03.2016;2016;03;00;Tiistai;0;0;0;0;0;0
109;01.03.2016;2016;03;01;Tiistai;0;0;0;0;0;0
109;01.03.2016;2016;03;02;Tiistai;0;0;0;0;0;0
109;01.03.2016;2016;03;03;Tiistai;0;0;0;0;0;0
109;01.03.2016;2016;03;04;Tiistai;0;0;0;0;0;0
109;01.03.2016;2016;03;05;Tiistai;3;3;6;2;0;2
109;01.03.2016;2016;03;06;Tiistai;12;9;21;3;3;6
109;01.03.2016;2016;03;07;Tiistai;44;42;86;11;7;18
109;01.03.2016;2016;03;08;Tiistai;34;33;67;3;4;7
109;01.03.2016;2016;03;09;Tiistai;11;9;20;3;1;4
109;01.03.2016;2016;03;10;Tiistai;9;6;15;2;4;6
109;01.03.2016;2016;03;11;Tiistai;14;10;24;4;3;7
109;01.03.2016;2016;03;12;Tiistai;10;4;14;3;5;8
109;01.03.2016;2016;03;13;Tiistai;6;9;15;2;3;5
109;01.03.2016;2016;03;14;Tiistai;17;14;31;7;5;12
109;01.03.2016;2016;03;15;Tiistai;20;29;49;5;9;14
109;01.03.2016;2016;03;16;Tiistai;32;42;74;7;5;12
109;01.03.2016;2016;03;17;Tiistai;14;19;33;13;2;15
109;01.03.2016;2016;03;18;Tiistai;8;12;20;6;1;7
109;01.03.2016;2016;03;19;Tiistai;6;7;13;5;5;10
109;01.03.2016;2016;03;20;Tiistai;3;6;9;4;2;6
109;01.03.2016;2016;03;21;Tiistai;1;11;12;1;5;6
109;01.03.2016;2016;03;22;Tiistai;8;1;9;0;0;0
109;01.03.2016;2016;03;23;Tiistai;4;1;5;0;0;0
109;02.03.2016;2016;03;00;Keskiviikko;1;1;2;0;0;0
109;02.03.2016;2016;03;01;Keskiviikko;0;1;1;0;0;0
109;02.03.2016;2016;03;02;Keskiviikko;0;0;0;0;0;0
109;02.03.2016;2016;03;03;Keskiviikko;0;0;0;0;0;0
109;02.03.2016;2016;03;04;Keskiviikko;0;0;0;0;0;0
109;02.03.2016;2016;03;05;Keskiviikko;3;5;8;4;0;4
109;02.03.2016;2016;03;06;Keskiviikko;18;7;25;0;3;3
109;02.03.2016;2016;03;07;Keskiviikko;66;15;81;6;4;10
109;02.03.2016;2016;03;08;Keskiviikko;40;11;51;2;3;5
109;02.03.2016;2016;03;09;Keskiviikko;10;6;16;3;4;7
109;02.03.2016;2016;03;10;Keskiviikko;16;5;21;3;2;5
109;02.03.2016;2016;03;11;Keskiviikko;8;4;12;2;5;7
109;02.03.2016;2016;03;12;Keskiviikko;15;9;24;5;2;7
109;02.03.2016;2016;03;13;Keskiviikko;5;10;15;5;4;9
109;02.03.2016;2016;03;14;Keskiviikko;23;19;42;5;3;8
109;02.03.2016;2016;03;15;Keskiviikko;29;31;60;4;9;13
109;02.03.2016;2016;03;16;Keskiviikko;28;42;70;4;5;9
109;02.03.2016;2016;03;17;Keskiviikko;21;26;47;7;5;12
109;02.03.2016;2016;03;18;Keskiviikko;6;10;16;5;5;10
109;02.03.2016;2016;03;19;Keskiviikko;4;4;8;2;3;5
109;02.03.2016;2016;03;20;Keskiviikko;1;5;6;1;4;5
109;02.03.2016;2016;03;21;Keskiviikko;5;8;13;1;1;2
109;02.03.2016;2016;03;22;Keskiviikko;9;5;14;0;1;1
109;02.03.2016;2016;03;23;Keskiviikko;2;1;3;1;0;1
109;03.03.2016;2016;03;00;Torstai;0;2;2;0;0;0
109;03.03.2016;2016;03;01;Torstai;1;0;1;0;0;0
109;03.03.2016;2016;03;02;Torstai;1;0;1;0;0;0
109;03.03.2016;2016;03;03;Torstai;0;0;0;0;0;0
109;03.03.2016;2016;03;04;Torstai;0;1;1;0;0;0
109;03.03.2016;2016;03;05;Torstai;1;3;4;2;0;2
109;03.03.2016;2016;03;06;Torstai;17;3;20;3;3;6
109;03.03.2016;2016;03;07;Torstai;61;19;80;11;7;18
109;03.03.2016;2016;03;08;Torstai;51;9;60;3;4;7
109;03.03.2016;2016;03;09;Torstai;13;4;17;3;1;4
109;03.03.2016;2016;03;10;Torstai;7;4;11;2;4;6
109;03.03.2016;2016;03;11;Torstai;6;3;9;4;3;7
109;03.03.2016;2016;03;12;Torstai;13;8;21;3;5;8
109;03.03.2016;2016;03;13;Torstai;14;7;21;2;3;5
109;03.03.2016;2016;03;14;Torstai;16;11;27;4;3;7
109;03.03.2016;2016;03;15;Torstai;7;37;44;5;5;10
109;03.03.2016;2016;03;16;Torstai;28;33;61;9;3;12
109;03.03.2016;2016;03;17;Torstai;14;23;37;5;2;7
109;03.03.2016;2016;03;18;Torstai;9;13;22;3;6;9
109;03.03.2016;2016;03;19;Torstai;7;9;16;8;6;14
109;03.03.2016;2016;03;20;Torstai;4;6;10;2;7;9
109;03.03.2016;2016;03;21;Torstai;4;6;10;0;0;0
109;03.03.2016;2016;03;22;Torstai;8;3;11;1;0;1
109;03.03.2016;2016;03;23;Torstai;3;0;3;1;0;1
109;04.03.2016;2016;03;00;Perjantai;0;1;1;0;0;0
109;04.03.2016;2016;03;01;Perjantai;0;0;0;0;0;0
109;04.03.2016;2016;03;02;Perjantai;0;0;0;0;0;0
109;04.03.2016;2016;03;03;Perjantai;0;0;0;0;0;0
109;04.03.2016;2016;03;04;Perjantai;1;0;1;0;0;0
109;04.03.2016;2016;03;05;Perjantai;0;5;5;1;0;1
109;04.03.2016;2016;03;06;Perjantai;22;3;25;1;2;3
109;04.03.2016;2016;03;07;Perjantai;48;17;65;9;6;15
109;04.03.2016;2016;03;08;Perjantai;41;9;50;3;2;5
109;04.03.2016;2016;03;09;Perjantai;15;3;18;2;4;6
109;04.03.2016;2016;03;10;Perjantai;5;5;10;2;0;2
109;04.03.2016;2016;03;11;Perjantai;9;4;13;6;2;8
109;04.03.2016;2016;03;12;Perjantai;15;6;21;1;2;3
109;04.03.2016;2016;03;13;Perjantai;12;13;25;3;3;6
109;04.03.2016;2016;03;14;Perjantai;13;17;30;5;4;9
109;04.03.2016;2016;03;15;Perjantai;12;37;49;5;2;7
109;04.03.2016;2016;03;16;Perjantai;21;18;39;9;6;15
109;04.03.2016;2016;03;17;Perjantai;9;14;23;6;7;13
109;04.03.2016;2016;03;18;Perjantai;3;5;8;2;0;2
109;04.03.2016;2016;03;19;Perjantai;6;4;10;5;3;8
109;04.03.2016;2016;03;20;Perjantai;2;4;6;2;2;4
109;04.03.2016;2016;03;21;Perjantai;4;3;7;0;0;0
109;04.03.2016;2016;03;22;Perjantai;3;2;5;0;1;1
109;04.03.2016;2016;03;23;Perjantai;1;2;3;1;0;1
109;05.03.2016;2016;03;00;Lauantai;2;0;2;0;0;0
109;05.03.2016;2016;03;01;Lauantai;0;1;1;1;1;2
109;05.03.2016;2016;03;02;Lauantai;0;1;1;0;0;0
109;05.03.2016;2016;03;03;Lauantai;2;0;2;0;1;1
109;05.03.2016;2016;03;04;Lauantai;0;1;1;0;0;0
109;05.03.2016;2016;03;05;Lauantai;0;1;1;0;0;0
109;05.03.2016;2016;03;06;Lauantai;5;1;6;0;0;0
109;05.03.2016;2016;03;07;Lauantai;3;0;3;1;0;1
109;05.03.2016;2016;03;08;Lauantai;5;0;5;1;0;1
109;05.03.2016;2016;03;09;Lauantai;2;3;5;3;1;4
109;05.03.2016;2016;03;10;Lauantai;2;2;4;3;0;3
109;05.03.2016;2016;03;11;Lauantai;4;1;5;3;0;3
109;05.03.2016;2016;03;12;Lauantai;7;2;9;4;0;4
109;05.03.2016;2016;03;13;Lauantai;2;1;3;2;2;4
109;05.03.2016;2016;03;14;Lauantai;7;1;8;5;3;8
109;05.03.2016;2016;03;15;Lauantai;6;8;14;5;3;8
109;05.03.2016;2016;03;16;Lauantai;2;3;5;5;8;13
109;05.03.2016;2016;03;17;Lauantai;2;4;6;5;1;6
109;05.03.2016;2016;03;18;Lauantai;8;1;9;3;3;6
109;05.03.2016;2016;03;19;Lauantai;3;4;7;0;4;4
109;05.03.2016;2016;03;20;Lauantai;1;1;2;4;1;5
109;05.03.2016;2016;03;21;Lauantai;1;3;4;0;0;0
109;05.03.2016;2016;03;22;Lauantai;0;0;0;0;0;0
109;05.03.2016;2016;03;23;Lauantai;2;1;3;1;0;1
109;06.03.2016;2016;03;00;Sunnuntai;0;1;1;0;0;0
109;06.03.2016;2016;03;01;Sunnuntai;1;1;2;0;0;0
109;06.03.2016;2016;03;02;Sunnuntai;0;1;1;0;0;0
109;06.03.2016;2016;03;03;Sunnuntai;0;0;0;1;0;1
109;06.03.2016;2016;03;04;Sunnuntai;0;0;0;0;2;2
109;06.03.2016;2016;03;05;Sunnuntai;0;1;1;0;0;0
109;06.03.2016;2016;03;06;Sunnuntai;5;0;5;1;0;1
109;06.03.2016;2016;03;07;Sunnuntai;4;2;6;3;2;5
109;06.03.2016;2016;03;08;Sunnuntai;1;0;1;1;1;2
109;06.03.2016;2016;03;09;Sunnuntai;5;4;9;4;0;4
109;06.03.2016;2016;03;10;Sunnuntai;7;1;8;8;1;9
109;06.03.2016;2016;03;11;Sunnuntai;5;1;6;6;4;10
109;06.03.2016;2016;03;12;Sunnuntai;13;8;21;6;6;12
109;06.03.2016;2016;03;13;Sunnuntai;4;9;13;6;4;10
109;06.03.2016;2016;03;14;Sunnuntai;8;8;16;9;2;11
109;06.03.2016;2016;03;15;Sunnuntai;2;4;6;4;2;6
109;06.03.2016;2016;03;16;Sunnuntai;6;5;11;8;4;12
109;06.03.2016;2016;03;17;Sunnuntai;0;2;2;3;5;8
109;06.03.2016;2016;03;18;Sunnuntai;6;2;8;4;5;9
109;06.03.2016;2016;03;19;Sunnuntai;7;1;8;8;4;12
109;06.03.2016;2016;03;20;Sunnuntai;5;2;7;3;4;7
109;06.03.2016;2016;03;21;Sunnuntai;5;6;11;1;1;2
109;06.03.2016;2016;03;22;Sunnuntai;1;4;5;1;1;2
109;06.03.2016;2016;03;23;Sunnuntai;1;1;2;1;0;1
109;07.03.2016;2016;03;00;Maanantai;0;0;0;0;0;0
109;07.03.2016;2016;03;01;Maanantai;0;0;0;0;0;0
109;07.03.2016;2016;03;02;Maanantai;0;0;0;0;1;1
109;07.03.2016;2016;03;03;Maanantai;0;0;0;0;0;0
109;07.03.2016;2016;03;04;Maanantai;0;2;2;2;0;2
109;07.03.2016;2016;03;05;Maanantai;4;5;9;3;1;4
109;07.03.2016;2016;03;06;Maanantai;17;5;22;0;2;2
109;07.03.2016;2016;03;07;Maanantai;33;21;54;9;4;13
109;07.03.2016;2016;03;08;Maanantai;24;11;35;4;2;6
109;07.03.2016;2016;03;09;Maanantai;12;2;14;6;2;8
109;07.03.2016;2016;03;10;Maanantai;4;3;7;0;0;0
109;07.03.2016;2016;03;11;Maanantai;17;5;22;4;5;9
109;07.03.2016;2016;03;12;Maanantai;6;5;11;5;0;5
109;07.03.2016;2016;03;13;Maanantai;8;9;17;3;3;6
109;07.03.2016;2016;03;14;Maanantai;16;11;27;5;4;9
109;07.03.2016;2016;03;15;Maanantai;12;24;36;3;6;9
109;07.03.2016;2016;03;16;Maanantai;19;30;49;5;3;8
109;07.03.2016;2016;03;17;Maanantai;7;5;12;1;5;6
109;07.03.2016;2016;03;18;Maanantai;5;8;13;6;6;12
109;07.03.2016;2016;03;19;Maanantai;17;4;21;3;5;8
109;07.03.2016;2016;03;20;Maanantai;1;3;4;6;3;9
109;07.03.2016;2016;03;21;Maanantai;2;3;5;1;0;1
109;07.03.2016;2016;03;22;Maanantai;4;3;7;0;0;0
109;07.03.2016;2016;03;23;Maanantai;2;1;3;0;0;0
109;08.03.2016;2016;03;00;Tiistai;1;0;1;0;0;0
109;08.03.2016;2016;03;01;Tiistai;1;0;1;0;0;0
109;08.03.2016;2016;03;02;Tiistai;1;0;1;0;0;0
109;08.03.2016;2016;03;03;Tiistai;0;0;0;0;0;0
109;08.03.2016;2016;03;04;Tiistai;1;2;3;0;0;0
109;08.03.2016;2016;03;05;Tiistai;1;3;4;3;1;4
109;08.03.2016;2016;03;06;Tiistai;22;6;28;1;1;2
109;08.03.2016;2016;03;07;Tiistai;47;14;61;3;4;7
109;08.03.2016;2016;03;08;Tiistai;28;9;37;3;4;7
109;08.03.2016;2016;03;09;Tiistai;5;6;11;3;5;8
109;08.03.2016;2016;03;10;Tiistai;3;5;8;7;4;11
109;08.03.2016;2016;03;11;Tiistai;6;3;9;4;4;8
109;08.03.2016;2016;03;12;Tiistai;6;7;13;3;2;5
109;08.03.2016;2016;03;13;Tiistai;7;10;17;4;3;7
109;08.03.2016;2016;03;14;Tiistai;6;8;14;5;7;12
109;08.03.2016;2016;03;15;Tiistai;27;22;49;8;6;14
109;08.03.2016;2016;03;16;Tiistai;23;24;47;3;5;8
109;08.03.2016;2016;03;17;Tiistai;16;18;34;4;3;7
109;08.03.2016;2016;03;18;Tiistai;10;15;25;4;4;8
109;08.03.2016;2016;03;19;Tiistai;3;5;8;6;7;13
109;08.03.2016;2016;03;20;Tiistai;6;3;9;8;1;9
109;08.03.2016;2016;03;21;Tiistai;1;1;2;1;0;1
109;08.03.2016;2016;03;22;Tiistai;12;2;14;0;2;2
109;08.03.2016;2016;03;23;Tiistai;3;0;3;0;1;1
109;09.03.2016;2016;03;00;Keskiviikko;1;3;4;0;0;0
109;09.03.2016;2016;03;01;Keskiviikko;2;3;5;0;0;0
109;09.03.2016;2016;03;02;Keskiviikko;0;0;0;0;0;0
109;09.03.2016;2016;03;03;Keskiviikko;0;0;0;0;0;0
109;09.03.2016;2016;03;04;Keskiviikko;2;1;3;0;0;0
109;09.03.2016;2016;03;05;Keskiviikko;1;3;4;2;1;3
109;09.03.2016;2016;03;06;Keskiviikko;26;7;33;0;0;0
109;09.03.2016;2016;03;07;Keskiviikko;42;11;53;8;5;13
109;09.03.2016;2016;03;08;Keskiviikko;22;11;33;3;3;6
109;09.03.2016;2016;03;09;Keskiviikko;6;2;8;6;0;6
109;09.03.2016;2016;03;10;Keskiviikko;17;3;20;2;2;4
109;09.03.2016;2016;03;11;Keskiviikko;4;4;8;7;2;9
109;09.03.2016;2016;03;12;Keskiviikko;10;7;17;4;5;9
109;09.03.2016;2016;03;13;Keskiviikko;4;12;16;2;4;6
109;09.03.2016;2016;03;14;Keskiviikko;10;8;18;6;3;9
109;09.03.2016;2016;03;15;Keskiviikko;15;23;38;4;4;8
109;09.03.2016;2016;03;16;Keskiviikko;23;27;50;3;3;6
109;09.03.2016;2016;03;17;Keskiviikko;10;15;25;8;0;8
109;09.03.2016;2016;03;18;Keskiviikko;1;8;9;8;4;12
109;09.03.2016;2016;03;19;Keskiviikko;5;4;9;7;4;11
109;09.03.2016;2016;03;20;Keskiviikko;2;4;6;5;4;9
109;09.03.2016;2016;03;21;Keskiviikko;4;4;8;2;0;2
109;09.03.2016;2016;03;22;Keskiviikko;5;2;7;1;2;3
109;09.03.2016;2016;03;23;Keskiviikko;4;1;5;0;0;0
109;10.03.2016;2016;03;00;Torstai;0;0;0;0;0;0
109;10.03.2016;2016;03;01;Torstai;0;1;1;0;0;0
109;10.03.2016;2016;03;02;Torstai;0;0;0;0;0;0
109;10.03.2016;2016;03;03;Torstai;0;0;0;0;0;0
109;10.03.2016;2016;03;04;Torstai;2;1;3;0;0;0
109;10.03.2016;2016;03;05;Torstai;0;6;6;3;1;4
109;10.03.2016;2016;03;06;Torstai;15;6;21;4;3;7
109;10.03.2016;2016;03;07;Torstai;30;14;44;7;4;11
109;10.03.2016;2016;03;08;Torstai;20;8;28;0;1;1
109;10.03.2016;2016;03;09;Torstai;8;4;12;4;2;6
109;10.03.2016;2016;03;10;Torstai;5;2;7;1;1;2
109;10.03.2016;2016;03;11;Torstai;6;5;11;5;2;7
109;10.03.2016;2016;03;12;Torstai;4;3;7;0;2;2
109;10.03.2016;2016;03;13;Torstai;9;7;16;7;4;11
109;10.03.2016;2016;03;14;Torstai;16;12;28;5;5;10
109;10.03.2016;2016;03;15;Torstai;15;20;35;4;6;10
109;10.03.2016;2016;03;16;Torstai;14;24;38;4;7;11
109;10.03.2016;2016;03;17;Torstai;8;8;16;4;4;8
109;10.03.2016;2016;03;18;Torstai;10;6;16;4;5;9
109;10.03.2016;2016;03;19;Torstai;1;2;3;0;4;4
109;10.03.2016;2016;03;20;Torstai;2;2;4;6;2;8
109;10.03.2016;2016;03;21;Torstai;2;3;5;4;0;4
109;10.03.2016;2016;03;22;Torstai;5;2;7;0;2;2
109;10.03.2016;2016;03;23;Torstai;1;2;3;2;2;4
109;11.03.2016;2016;03;00;Perjantai;0;1;1;0;0;0
109;11.03.2016;2016;03;01;Perjantai;0;1;1;0;0;0
109;11.03.2016;2016;03;02;Perjantai;1;0;1;0;0;0
109;11.03.2016;2016;03;03;Perjantai;0;0;0;0;0;0
109;11.03.2016;2016;03;04;Perjantai;0;2;2;0;0;0
109;11.03.2016;2016;03;05;Perjantai;2;4;6;1;1;2
109;11.03.2016;2016;03;06;Perjantai;19;5;24;2;4;6
109;11.03.2016;2016;03;07;Perjantai;31;10;41;9;5;14
109;11.03.2016;2016;03;08;Perjantai;25;5;30;2;4;6
109;11.03.2016;2016;03;09;Perjantai;9;5;14;2;2;4
109;11.03.2016;2016;03;10;Perjantai;2;5;7;4;4;8
109;11.03.2016;2016;03;11;Perjantai;5;1;6;4;2;6
109;11.03.2016;2016;03;12;Perjantai;8;4;12;5;1;6
109;11.03.2016;2016;03;13;Perjantai;7;4;11;3;3;6
109;11.03.2016;2016;03;14;Perjantai;10;10;20;5;4;9
109;11.03.2016;2016;03;15;Perjantai;20;19;39;3;6;9
109;11.03.2016;2016;03;16;Perjantai;18;16;34;5;3;8
109;11.03.2016;2016;03;17;Perjantai;12;15;27;1;5;6
109;11.03.2016;2016;03;18;Perjantai;4;2;6;6;6;12
109;11.03.2016;2016;03;19;Perjantai;3;3;6;3;5;8
109;11.03.2016;2016;03;20;Perjantai;2;0;2;4;0;4
109;11.03.2016;2016;03;21;Perjantai;5;4;9;1;0;1
109;11.03.2016;2016;03;22;Perjantai;1;0;1;0;0;0
109;11.03.2016;2016;03;23;Perjantai;2;1;3;2;0;2
109;12.03.2016;2016;03;00;Lauantai;2;2;4;0;0;0
109;12.03.2016;2016;03;01;Lauantai;0;0;0;0;0;0
109;12.03.2016;2016;03;02;Lauantai;0;0;0;0;0;0
109;12.03.2016;2016;03;03;Lauantai;0;0;0;0;0;0
109;12.03.2016;2016;03;04;Lauantai;1;0;1;0;0;0
109;12.03.2016;2016;03;05;Lauantai;1;0;1;0;0;0
109;12.03.2016;2016;03;06;Lauantai;3;0;3;1;1;2
109;12.03.2016;2016;03;07;Lauantai;2;2;4;2;1;3
109;12.03.2016;2016;03;08;Lauantai;2;0;2;1;3;4
109;12.03.2016;2016;03;09;Lauantai;10;3;13;2;3;5
109;12.03.2016;2016;03;10;Lauantai;3;1;4;3;1;4
109;12.03.2016;2016;03;11;Lauantai;2;1;3;3;1;4
109;12.03.2016;2016;03;12;Lauantai;4;6;10;1;1;2
109;12.03.2016;2016;03;13;Lauantai;8;1;9;2;2;4
109;12.03.2016;2016;03;14;Lauantai;4;0;4;1;3;4
109;12.03.2016;2016;03;15;Lauantai;6;4;10;2;0;2
109;12.03.2016;2016;03;16;Lauantai;4;2;6;2;0;2
109;12.03.2016;2016;03;17;Lauantai;3;2;5;1;0;1
109;12.03.2016;2016;03;18;Lauantai;8;0;8;1;1;2
109;12.03.2016;2016;03;19;Lauantai;2;2;4;1;0;1
109;12.03.2016;2016;03;20;Lauantai;2;4;6;1;0;1
109;12.03.2016;2016;03;21;Lauantai;5;3;8;0;1;1
109;12.03.2016;2016;03;22;Lauantai;0;1;1;0;2;2
109;12.03.2016;2016;03;23;Lauantai;4;1;5;1;2;3
109;13.03.2016;2016;03;00;Sunnuntai;0;0;0;1;0;1
109;13.03.2016;2016;03;01;Sunnuntai;0;0;0;0;1;1
109;13.03.2016;2016;03;02;Sunnuntai;0;0;0;0;0;0
109;13.03.2016;2016;03;03;Sunnuntai;0;3;3;0;0;0
109;13.03.2016;2016;03;04;Sunnuntai;1;0;1;0;1;1
109;13.03.2016;2016;03;05;Sunnuntai;1;0;1;0;0;0
109;13.03.2016;2016;03;06;Sunnuntai;2;0;2;1;1;2
109;13.03.2016;2016;03;07;Sunnuntai;5;2;7;1;0;1
109;13.03.2016;2016;03;08;Sunnuntai;0;1;1;0;0;0
109;13.03.2016;2016;03;09;Sunnuntai;3;0;3;0;1;1
109;13.03.2016;2016;03;10;Sunnuntai;4;4;8;5;3;8
109;13.03.2016;2016;03;11;Sunnuntai;2;1;3;2;4;6
109;13.03.2016;2016;03;12;Sunnuntai;8;3;11;3;3;6
109;13.03.2016;2016;03;13;Sunnuntai;8;2;10;2;8;10
109;13.03.2016;2016;03;14;Sunnuntai;10;2;12;3;6;9
109;13.03.2016;2016;03;15;Sunnuntai;5;4;9;6;2;8
109;13.03.2016;2016;03;16;Sunnuntai;2;4;6;6;2;8
109;13.03.2016;2016;03;17;Sunnuntai;7;6;13;6;2;8
109;13.03.2016;2016;03;18;Sunnuntai;3;3;6;3;0;3
109;13.03.2016;2016;03;19;Sunnuntai;4;2;6;0;0;0
109;13.03.2016;2016;03;20;Sunnuntai;3;1;4;0;0;0
109;13.03.2016;2016;03;21;Sunnuntai;5;3;8;0;0;0
109;13.03.2016;2016;03;22;Sunnuntai;1;0;1;0;0;0
109;13.03.2016;2016;03;23;Sunnuntai;2;0;2;0;0;0
109;14.03.2016;2016;03;00;Maanantai;1;1;2;0;0;0
109;14.03.2016;2016;03;01;Maanantai;1;0;1;0;0;0
109;14.03.2016;2016;03;02;Maanantai;0;0;0;0;0;0
109;14.03.2016;2016;03;03;Maanantai;1;0;1;0;0;0
109;14.03.2016;2016;03;04;Maanantai;0;0;0;0;0;0
109;14.03.2016;2016;03;05;Maanantai;2;1;3;0;0;0
109;14.03.2016;2016;03;06;Maanantai;21;17;38;2;2;4
109;14.03.2016;2016;03;07;Maanantai;45;26;71;1;0;1
109;14.03.2016;2016;03;08;Maanantai;38;27;65;1;0;1
109;14.03.2016;2016;03;09;Maanantai;14;8;22;0;0;0
109;14.03.2016;2016;03;10;Maanantai;7;3;10;3;0;3
109;14.03.2016;2016;03;11;Maanantai;11;9;20;5;4;9
109;14.03.2016;2016;03;12;Maanantai;4;8;12;7;4;11
109;14.03.2016;2016;03;13;Maanantai;10;11;21;2;3;5
109;14.03.2016;2016;03;14;Maanantai;14;10;24;8;4;12
109;14.03.2016;2016;03;15;Maanantai;30;36;66;8;10;18
109;14.03.2016;2016;03;16;Maanantai;31;45;76;6;9;15
109;14.03.2016;2016;03;17;Maanantai;8;21;29;2;4;6
109;14.03.2016;2016;03;18;Maanantai;11;19;30;10;4;14
109;14.03.2016;2016;03;19;Maanantai;4;6;10;9;2;11
109;14.03.2016;2016;03;20;Maanantai;4;3;7;2;3;5
109;14.03.2016;2016;03;21;Maanantai;4;5;9;2;0;2
109;14.03.2016;2016;03;22;Maanantai;6;3;9;0;1;1
109;14.03.2016;2016;03;23;Maanantai;2;0;2;0;0;0
109;15.03.2016;2016;03;00;Tiistai;1;0;1;1;0;1
109;15.03.2016;2016;03;01;Tiistai;0;2;2;0;0;0
109;15.03.2016;2016;03;02;Tiistai;0;1;1;0;0;0
109;15.03.2016;2016;03;03;Tiistai;0;0;0;0;0;0
109;15.03.2016;2016;03;04;Tiistai;0;1;1;0;0;0
109;15.03.2016;2016;03;05;Tiistai;4;4;8;3;0;3
109;15.03.2016;2016;03;06;Tiistai;26;7;33;3;4;7
109;15.03.2016;2016;03;07;Tiistai;46;21;67;7;4;11
109;15.03.2016;2016;03;08;Tiistai;42;13;55;3;7;10
109;15.03.2016;2016;03;09;Tiistai;18;9;27;1;1;2
109;15.03.2016;2016;03;10;Tiistai;11;3;14;2;3;5
109;15.03.2016;2016;03;11;Tiistai;11;8;19;5;4;9
109;15.03.2016;2016;03;12;Tiistai;7;8;15;3;5;8
109;15.03.2016;2016;03;13;Tiistai;6;10;16;3;5;8
109;15.03.2016;2016;03;14;Tiistai;8;12;20;13;7;20
109;15.03.2016;2016;03;15;Tiistai;24;35;59;8;3;11
109;15.03.2016;2016;03;16;Tiistai;22;40;62;8;6;14
109;15.03.2016;2016;03;17;Tiistai;18;18;36;6;4;10
109;15.03.2016;2016;03;18;Tiistai;7;12;19;4;3;7
109;15.03.2016;2016;03;19;Tiistai;8;3;11;8;9;17
109;15.03.2016;2016;03;20;Tiistai;1;6;7;4;3;7
109;15.03.2016;2016;03;21;Tiistai;2;5;7;7;5;12
109;15.03.2016;2016;03;22;Tiistai;5;2;7;0;0;0
109;15.03.2016;2016;03;23;Tiistai;0;0;0;1;1;2
109;16.03.2016;2016;03;00;Keskiviikko;1;0;1;0;0;0
109;16.03.2016;2016;03;01;Keskiviikko;0;0;0;0;0;0
109;16.03.2016;2016;03;02;Keskiviikko;0;0;0;0;0;0
109;16.03.2016;2016;03;03;Keskiviikko;0;0;0;0;0;0
109;16.03.2016;2016;03;04;Keskiviikko;0;0;0;0;0;0
109;16.03.2016;2016;03;05;Keskiviikko;1;4;5;2;0;2
109;16.03.2016;2016;03;06;Keskiviikko;20;4;24;2;3;5
109;16.03.2016;2016;03;07;Keskiviikko;42;16;58;11;5;16
109;16.03.2016;2016;03;08;Keskiviikko;31;17;48;2;5;7
109;16.03.2016;2016;03;09;Keskiviikko;10;8;18;5;1;6
109;16.03.2016;2016;03;10;Keskiviikko;7;5;12;5;4;9
109;16.03.2016;2016;03;11;Keskiviikko;7;4;11;3;1;4
109;16.03.2016;2016;03;12;Keskiviikko;12;11;23;5;1;6
109;16.03.2016;2016;03;13;Keskiviikko;5;11;16;4;6;10
109;16.03.2016;2016;03;14;Keskiviikko;8;14;22;6;7;13
109;16.03.2016;2016;03;15;Keskiviikko;18;33;51;6;6;12
109;16.03.2016;2016;03;16;Keskiviikko;29;40;69;10;7;17
109;16.03.2016;2016;03;17;Keskiviikko;15;23;38;8;6;14
109;16.03.2016;2016;03;18;Keskiviikko;12;11;23;3;5;8
109;16.03.2016;2016;03;19;Keskiviikko;6;6;12;4;3;7
109;16.03.2016;2016;03;20;Keskiviikko;1;8;9;2;6;8
109;16.03.2016;2016;03;21;Keskiviikko;5;4;9;0;2;2
109;16.03.2016;2016;03;22;Keskiviikko;5;7;12;0;1;1
109;16.03.2016;2016;03;23;Keskiviikko;1;2;3;0;1;1
109;17.03.2016;2016;03;00;Torstai;1;0;1;0;0;0
109;17.03.2016;2016;03;01;Torstai;0;1;1;0;0;0
109;17.03.2016;2016;03;02;Torstai;2;1;3;0;0;0
109;17.03.2016;2016;03;03;Torstai;0;1;1;0;0;0
109;17.03.2016;2016;03;04;Torstai;0;0;0;0;0;0
109;17.03.2016;2016;03;05;Torstai;2;2;4;4;2;6
109;17.03.2016;2016;03;06;Torstai;23;12;35;3;2;5
109;17.03.2016;2016;03;07;Torstai;51;13;64;7;5;12
109;17.03.2016;2016;03;08;Torstai;34;14;48;4;3;7
109;17.03.2016;2016;03;09;Torstai;11;5;16;3;0;3
109;17.03.2016;2016;03;10;Torstai;7;3;10;4;3;7
109;17.03.2016;2016;03;11;Torstai;12;6;18;3;3;6
109;17.03.2016;2016;03;12;Torstai;7;7;14;2;3;5
109;17.03.2016;2016;03;13;Torstai;5;10;15;2;3;5
109;17.03.2016;2016;03;14;Torstai;9;8;17;1;2;3
109;17.03.2016;2016;03;15;Torstai;15;30;45;4;4;8
109;17.03.2016;2016;03;16;Torstai;31;39;70;1;4;5
109;17.03.2016;2016;03;17;Torstai;15;17;32;7;4;11
109;17.03.2016;2016;03;18;Torstai;6;9;15;5;2;7
109;17.03.2016;2016;03;19;Torstai;1;8;9;3;11;14
109;17.03.2016;2016;03;20;Torstai;1;6;7;1;2;3
109;17.03.2016;2016;03;21;Torstai;2;3;5;2;2;4
109;17.03.2016;2016;03;22;Torstai;11;3;14;0;1;1
109;17.03.2016;2016;03;23;Torstai;1;0;1;0;0;0
109;18.03.2016;2016;03;00;Perjantai;0;0;0;3;1;4
109;18.03.2016;2016;03;01;Perjantai;0;0;0;0;0;0
109;18.03.2016;2016;03;02;Perjantai;0;0;0;0;0;0
109;18.03.2016;2016;03;03;Perjantai;0;0;0;0;0;0
109;18.03.2016;2016;03;04;Perjantai;0;0;0;0;0;0
109;18.03.2016;2016;03;05;Perjantai;1;2;3;3;1;4
109;18.03.2016;2016;03;06;Perjantai;16;7;23;2;3;5
109;18.03.2016;2016;03;07;Perjantai;44;16;60;4;4;8
109;18.03.2016;2016;03;08;Perjantai;40;13;53;2;4;6
109;18.03.2016;2016;03;09;Perjantai;9;5;14;4;2;6
109;18.03.2016;2016;03;10;Perjantai;5;8;13;4;0;4
109;18.03.2016;2016;03;11;Perjantai;12;2;14;4;4;8
109;18.03.2016;2016;03;12;Perjantai;7;8;15;1;4;5
109;18.03.2016;2016;03;13;Perjantai;9;9;18;4;4;8
109;18.03.2016;2016;03;14;Perjantai;11;19;30;6;4;10
109;18.03.2016;2016;03;15;Perjantai;14;24;38;6;4;10
109;18.03.2016;2016;03;16;Perjantai;14;26;40;6;3;9
109;18.03.2016;2016;03;17;Perjantai;7;13;20;6;1;7
109;18.03.2016;2016;03;18;Perjantai;7;3;10;2;2;4
109;18.03.2016;2016;03;19;Perjantai;3;2;5;2;2;4
109;18.03.2016;2016;03;20;Perjantai;5;1;6;6;1;7
109;18.03.2016;2016;03;21;Perjantai;0;5;5;1;1;2
109;18.03.2016;2016;03;22;Perjantai;13;2;15;3;3;6
109;18.03.2016;2016;03;23;Perjantai;0;3;3;1;0;1
109;19.03.2016;2016;03;00;Lauantai;2;0;2;0;1;1
109;19.03.2016;2016;03;01;Lauantai;0;0;0;0;0;0
109;19.03.2016;2016;03;02;Lauantai;0;0;0;0;0;0
109;19.03.2016;2016;03;03;Lauantai;0;2;2;0;0;0
109;19.03.2016;2016;03;04;Lauantai;1;3;4;0;0;0
109;19.03.2016;2016;03;05;Lauantai;0;1;1;0;0;0
109;19.03.2016;2016;03;06;Lauantai;3;0;3;2;0;2
109;19.03.2016;2016;03;07;Lauantai;2;1;3;0;3;3
109;19.03.2016;2016;03;08;Lauantai;1;2;3;2;3;5
109;19.03.2016;2016;03;09;Lauantai;10;4;14;5;2;7
109;19.03.2016;2016;03;10;Lauantai;2;4;6;2;3;5
109;19.03.2016;2016;03;11;Lauantai;7;2;9;3;2;5
109;19.03.2016;2016;03;12;Lauantai;5;9;14;3;10;13
109;19.03.2016;2016;03;13;Lauantai;6;4;10;1;1;2
109;19.03.2016;2016;03;14;Lauantai;4;7;11;4;4;8
109;19.03.2016;2016;03;15;Lauantai;4;7;11;6;1;7
109;19.03.2016;2016;03;16;Lauantai;7;5;12;6;4;10
109;19.03.2016;2016;03;17;Lauantai;1;4;5;4;2;6
109;19.03.2016;2016;03;18;Lauantai;5;5;10;2;0;2
109;19.03.2016;2016;03;19;Lauantai;1;2;3;3;0;3
109;19.03.2016;2016;03;20;Lauantai;3;0;3;1;2;3
109;19.03.2016;2016;03;21;Lauantai;2;1;3;0;0;0
109;19.03.2016;2016;03;22;Lauantai;0;0;0;0;0;0
109;19.03.2016;2016;03;23;Lauantai;0;2;2;1;0;1
109;20.03.2016;2016;03;00;Sunnuntai;2;2;4;0;0;0
109;20.03.2016;2016;03;01;Sunnuntai;0;0;0;0;1;1
109;20.03.2016;2016;03;02;Sunnuntai;0;0;0;0;0;0
109;20.03.2016;2016;03;03;Sunnuntai;0;0;0;0;0;0
109;20.03.2016;2016;03;04;Sunnuntai;1;0;1;0;0;0
109;20.03.2016;2016;03;05;Sunnuntai;0;1;1;0;1;1
109;20.03.2016;2016;03;06;Sunnuntai;2;1;3;0;0;0
109;20.03.2016;2016;03;07;Sunnuntai;0;3;3;1;3;4
109;20.03.2016;2016;03;08;Sunnuntai;1;0;1;2;1;3
109;20.03.2016;2016;03;09;Sunnuntai;1;1;2;2;2;4
109;20.03.2016;2016;03;10;Sunnuntai;5;1;6;10;4;14
109;20.03.2016;2016;03;11;Sunnuntai;7;3;10;6;6;12
109;20.03.2016;2016;03;12;Sunnuntai;6;2;8;2;8;10
109;20.03.2016;2016;03;13;Sunnuntai;5;6;11;6;2;8
109;20.03.2016;2016;03;14;Sunnuntai;8;5;13;7;2;9
109;20.03.2016;2016;03;15;Sunnuntai;4;7;11;9;3;12
109;20.03.2016;2016;03;16;Sunnuntai;5;5;10;6;3;9
109;20.03.2016;2016;03;17;Sunnuntai;8;2;10;5;4;9
109;20.03.2016;2016;03;18;Sunnuntai;5;1;6;6;3;9
109;20.03.2016;2016;03;19;Sunnuntai;2;2;4;2;3;5
109;20.03.2016;2016;03;20;Sunnuntai;1;4;5;5;5;10
109;20.03.2016;2016;03;21;Sunnuntai;3;6;9;1;1;2
109;20.03.2016;2016;03;22;Sunnuntai;2;0;2;1;0;1
109;20.03.2016;2016;03;23;Sunnuntai;1;0;1;0;0;0
109;21.03.2016;2016;03;00;Maanantai;0;1;1;1;0;1
109;21.03.2016;2016;03;01;Maanantai;0;1;1;1;0;1
109;21.03.2016;2016;03;02;Maanantai;0;0;0;0;0;0
109;21.03.2016;2016;03;03;Maanantai;0;0;0;0;0;0
109;21.03.2016;2016;03;04;Maanantai;0;0;0;0;0;0
109;21.03.2016;2016;03;05;Maanantai;2;4;6;3;0;3
109;21.03.2016;2016;03;06;Maanantai;20;2;22;4;1;5
109;21.03.2016;2016;03;07;Maanantai;43;18;61;7;4;11
109;21.03.2016;2016;03;08;Maanantai;44;18;62;2;5;7
109;21.03.2016;2016;03;09;Maanantai;4;6;10;2;4;6
109;21.03.2016;2016;03;10;Maanantai;10;4;14;5;1;6
109;21.03.2016;2016;03;11;Maanantai;9;6;15;2;5;7
109;21.03.2016;2016;03;12;Maanantai;3;4;7;4;1;5
109;21.03.2016;2016;03;13;Maanantai;5;11;16;3;2;5
109;21.03.2016;2016;03;14;Maanantai;8;9;17;7;1;8
109;21.03.2016;2016;03;15;Maanantai;17;33;50;4;9;13
109;21.03.2016;2016;03;16;Maanantai;21;41;62;3;4;7
109;21.03.2016;2016;03;17;Maanantai;19;20;39;5;5;10
109;21.03.2016;2016;03;18;Maanantai;8;8;16;2;7;9
109;21.03.2016;2016;03;19;Maanantai;0;8;8;3;9;12
109;21.03.2016;2016;03;20;Maanantai;1;6;7;0;4;4
109;21.03.2016;2016;03;21;Maanantai;2;3;5;4;1;5
109;21.03.2016;2016;03;22;Maanantai;6;0;6;0;1;1
109;21.03.2016;2016;03;23;Maanantai;0;2;2;0;0;0
109;22.03.2016;2016;03;00;Tiistai;1;0;1;0;0;0
109;22.03.2016;2016;03;01;Tiistai;0;0;0;0;0;0
109;22.03.2016;2016;03;02;Tiistai;0;0;0;0;0;0
109;22.03.2016;2016;03;03;Tiistai;0;0;0;0;0;0
109;22.03.2016;2016;03;04;Tiistai;0;0;0;0;0;0
109;22.03.2016;2016;03;05;Tiistai;1;5;6;2;2;4
109;22.03.2016;2016;03;06;Tiistai;19;7;26;5;4;9
109;22.03.2016;2016;03;07;Tiistai;39;21;60;4;5;9
109;22.03.2016;2016;03;08;Tiistai;36;18;54;3;2;5
109;22.03.2016;2016;03;09;Tiistai;13;7;20;3;0;3
109;22.03.2016;2016;03;10;Tiistai;9;2;11;4;0;4
109;22.03.2016;2016;03;11;Tiistai;5;7;12;2;2;4
109;22.03.2016;2016;03;12;Tiistai;9;3;12;6;2;8
109;22.03.2016;2016;03;13;Tiistai;6;7;13;2;0;2
109;22.03.2016;2016;03;14;Tiistai;11;17;28;8;10;18
109;22.03.2016;2016;03;15;Tiistai;17;28;45;4;6;10
109;22.03.2016;2016;03;16;Tiistai;26;34;60;4;6;10
109;22.03.2016;2016;03;17;Tiistai;15;26;41;7;6;13
109;22.03.2016;2016;03;18;Tiistai;4;9;13;2;1;3
109;22.03.2016;2016;03;19;Tiistai;3;5;8;5;2;7
109;22.03.2016;2016;03;20;Tiistai;4;3;7;3;6;9
109;22.03.2016;2016;03;21;Tiistai;2;8;10;1;2;3
109;22.03.2016;2016;03;22;Tiistai;10;4;14;0;0;0
109;22.03.2016;2016;03;23;Tiistai;0;0;0;0;2;2
109;23.03.2016;2016;03;00;Keskiviikko;1;1;2;0;0;0
109;23.03.2016;2016;03;01;Keskiviikko;0;0;0;0;0;0
109;23.03.2016;2016;03;02;Keskiviikko;0;1;1;0;0;0
109;23.03.2016;2016;03;03;Keskiviikko;0;0;0;0;0;0
109;23.03.2016;2016;03;04;Keskiviikko;0;0;0;0;0;0
109;23.03.2016;2016;03;05;Keskiviikko;1;4;5;1;2;3
109;23.03.2016;2016;03;06;Keskiviikko;20;7;27;3;1;4
109;23.03.2016;2016;03;07;Keskiviikko;41;15;56;3;3;6
109;23.03.2016;2016;03;08;Keskiviikko;40;16;56;1;3;4
109;23.03.2016;2016;03;09;Keskiviikko;10;4;14;3;3;6
109;23.03.2016;2016;03;10;Keskiviikko;7;5;12;1;0;1
109;23.03.2016;2016;03;11;Keskiviikko;7;6;13;2;2;4
109;23.03.2016;2016;03;12;Keskiviikko;8;4;12;6;2;8
109;23.03.2016;2016;03;13;Keskiviikko;12;9;21;2;0;2
109;23.03.2016;2016;03;14;Keskiviikko;12;10;22;8;10;18
109;23.03.2016;2016;03;15;Keskiviikko;21;18;39;4;6;10
109;23.03.2016;2016;03;16;Keskiviikko;28;26;54;4;6;10
109;23.03.2016;2016;03;17;Keskiviikko;22;17;39;7;6;13
109;23.03.2016;2016;03;18;Keskiviikko;6;6;12;6;2;8
109;23.03.2016;2016;03;19;Keskiviikko;5;4;9;4;3;7
109;23.03.2016;2016;03;20;Keskiviikko;5;3;8;1;4;5
109;23.03.2016;2016;03;21;Keskiviikko;7;8;15;0;0;0
109;23.03.2016;2016;03;22;Keskiviikko;6;4;10;0;1;1
109;23.03.2016;2016;03;23;Keskiviikko;1;3;4;0;0;0
109;24.03.2016;2016;03;00;Torstai;0;3;3;2;0;2
109;24.03.2016;2016;03;01;Torstai;0;0;0;0;0;0
109;24.03.2016;2016;03;02;Torstai;0;0;0;0;0;0
109;24.03.2016;2016;03;03;Torstai;1;0;1;0;0;0
109;24.03.2016;2016;03;04;Torstai;1;2;3;0;0;0
109;24.03.2016;2016;03;05;Torstai;3;4;7;1;0;1
109;24.03.2016;2016;03;06;Torstai;15;5;20;1;3;4
109;24.03.2016;2016;03;07;Torstai;48;14;62;3;5;8
109;24.03.2016;2016;03;08;Torstai;33;11;44;4;1;5
109;24.03.2016;2016;03;09;Torstai;7;3;10;3;4;7
109;24.03.2016;2016;03;10;Torstai;14;8;22;7;3;10
109;24.03.2016;2016;03;11;Torstai;10;2;12;3;4;7
109;24.03.2016;2016;03;12;Torstai;7;11;18;4;5;9
109;24.03.2016;2016;03;13;Torstai;10;11;21;0;2;2
109;24.03.2016;2016;03;14;Torstai;15;13;28;8;10;18
109;24.03.2016;2016;03;15;Torstai;21;19;40;4;6;10
109;24.03.2016;2016;03;16;Torstai;17;16;33;4;6;10
109;24.03.2016;2016;03;17;Torstai;8;5;13;7;6;13
109;24.03.2016;2016;03;18;Torstai;6;2;8;2;1;3
109;24.03.2016;2016;03;19;Torstai;3;0;3;5;2;7
109;24.03.2016;2016;03;20;Torstai;5;2;7;3;6;9
109;24.03.2016;2016;03;21;Torstai;2;1;3;1;2;3
109;24.03.2016;2016;03;22;Torstai;1;1;2;0;0;0
109;24.03.2016;2016;03;23;Torstai;1;0;1;1;1;2
109;25.03.2016;2016;03;00;Perjantai;1;0;1;0;0;0
109;25.03.2016;2016;03;01;Perjantai;0;0;0;0;0;0
109;25.03.2016;2016;03;02;Perjantai;0;0;0;0;0;0
109;25.03.2016;2016;03;03;Perjantai;0;0;0;0;0;0
109;25.03.2016;2016;03;04;Perjantai;1;0;1;0;0;0
109;25.03.2016;2016;03;05;Perjantai;0;0;0;0;0;0
109;25.03.2016;2016;03;06;Perjantai;2;1;3;0;0;0
109;25.03.2016;2016;03;07;Perjantai;3;1;4;1;1;2
109;25.03.2016;2016;03;08;Perjantai;0;0;0;3;2;5
109;25.03.2016;2016;03;09;Perjantai;0;0;0;3;0;3
109;25.03.2016;2016;03;10;Perjantai;0;0;0;3;1;4
109;25.03.2016;2016;03;11;Perjantai;0;0;0;3;1;4
109;25.03.2016;2016;03;12;Perjantai;0;0;0;2;2;4
109;25.03.2016;2016;03;13;Perjantai;6;1;7;2;1;3
109;25.03.2016;2016;03;14;Perjantai;3;2;5;4;3;7
109;25.03.2016;2016;03;15;Perjantai;1;7;8;13;9;22
109;25.03.2016;2016;03;16;Perjantai;1;7;8;2;4;6
109;25.03.2016;2016;03;17;Perjantai;2;0;2;6;2;8
109;25.03.2016;2016;03;18;Perjantai;5;2;7;10;5;15
109;25.03.2016;2016;03;19;Perjantai;1;2;3;9;2;11
109;25.03.2016;2016;03;20;Perjantai;0;0;0;3;5;8
109;25.03.2016;2016;03;21;Perjantai;0;1;1;3;1;4
109;25.03.2016;2016;03;22;Perjantai;1;2;3;3;1;4
109;25.03.2016;2016;03;23;Perjantai;0;0;0;0;0;0
109;26.03.2016;2016;03;00;Lauantai;0;1;1;0;0;0
109;26.03.2016;2016;03;01;Lauantai;0;0;0;0;1;1
109;26.03.2016;2016;03;02;Lauantai;0;0;0;0;0;0
109;26.03.2016;2016;03;03;Lauantai;0;1;1;0;0;0
109;26.03.2016;2016;03;04;Lauantai;0;0;0;0;0;0
109;26.03.2016;2016;03;05;Lauantai;0;0;0;0;0;0
109;26.03.2016;2016;03;06;Lauantai;2;0;2;1;2;3
109;26.03.2016;2016;03;07;Lauantai;2;2;4;0;1;1
109;26.03.2016;2016;03;08;Lauantai;1;0;1;2;1;3
109;26.03.2016;2016;03;09;Lauantai;3;2;5;4;4;8
109;26.03.2016;2016;03;10;Lauantai;3;1;4;2;0;2
109;26.03.2016;2016;03;11;Lauantai;1;3;4;3;4;7
109;26.03.2016;2016;03;12;Lauantai;3;4;7;1;1;2
109;26.03.2016;2016;03;13;Lauantai;2;2;4;10;5;15
109;26.03.2016;2016;03;14;Lauantai;4;5;9;3;1;4
109;26.03.2016;2016;03;15;Lauantai;3;3;6;6;6;12
109;26.03.2016;2016;03;16;Lauantai;3;4;7;4;4;8
109;26.03.2016;2016;03;17;Lauantai;4;1;5;1;3;4
109;26.03.2016;2016;03;18;Lauantai;4;4;8;4;2;6
109;26.03.2016;2016;03;19;Lauantai;2;6;8;0;4;4
109;26.03.2016;2016;03;20;Lauantai;2;1;3;0;1;1
109;26.03.2016;2016;03;21;Lauantai;4;1;5;0;3;3
109;26.03.2016;2016;03;22;Lauantai;1;1;2;1;1;2
109;26.03.2016;2016;03;23;Lauantai;0;2;2;0;1;1
109;27.03.2016;2016;03;00;Sunnuntai;0;0;0;0;0;0
109;27.03.2016;2016;03;01;Sunnuntai;1;1;2;0;0;0
109;27.03.2016;2016;03;02;Sunnuntai;0;0;0;0;0;0
109;27.03.2016;2016;03;03;Sunnuntai;0;1;1;0;0;0
109;27.03.2016;2016;03;04;Sunnuntai;1;0;1;1;1;2
109;27.03.2016;2016;03;05;Sunnuntai;0;4;4;0;0;0
109;27.03.2016;2016;03;06;Sunnuntai;1;0;1;0;0;0
109;27.03.2016;2016;03;07;Sunnuntai;1;5;6;0;4;4
109;27.03.2016;2016;03;08;Sunnuntai;0;2;2;3;3;6
109;27.03.2016;2016;03;09;Sunnuntai;2;1;3;0;2;2
109;27.03.2016;2016;03;10;Sunnuntai;1;1;2;6;1;7
109;27.03.2016;2016;03;11;Sunnuntai;4;2;6;0;6;6
109;27.03.2016;2016;03;12;Sunnuntai;8;4;12;7;5;12
109;27.03.2016;2016;03;13;Sunnuntai;3;2;5;6;1;7
109;27.03.2016;2016;03;14;Sunnuntai;9;7;16;10;2;12
109;27.03.2016;2016;03;15;Sunnuntai;9;3;12;4;6;10
109;27.03.2016;2016;03;16;Sunnuntai;3;10;13;4;4;8
109;27.03.2016;2016;03;17;Sunnuntai;5;2;7;4;3;7
109;27.03.2016;2016;03;18;Sunnuntai;7;2;9;6;4;10
109;27.03.2016;2016;03;19;Sunnuntai;1;2;3;3;3;6
109;27.03.2016;2016;03;20;Sunnuntai;3;6;9;5;3;8
109;27.03.2016;2016;03;21;Sunnuntai;1;2;3;2;3;5
109;27.03.2016;2016;03;22;Sunnuntai;0;1;1;2;2;4
109;27.03.2016;2016;03;23;Sunnuntai;1;0;1;0;0;0
109;28.03.2016;2016;03;00;Maanantai;2;1;3;1;0;1
109;28.03.2016;2016;03;01;Maanantai;0;0;0;0;1;1
109;28.03.2016;2016;03;02;Maanantai;0;0;0;0;0;0
109;28.03.2016;2016;03;03;Maanantai;0;2;2;0;0;0
109;28.03.2016;2016;03;04;Maanantai;0;2;2;0;0;0
109;28.03.2016;2016;03;05;Maanantai;0;0;0;0;0;0
109;28.03.2016;2016;03;06;Maanantai;2;0;2;0;1;1
109;28.03.2016;2016;03;07;Maanantai;0;2;2;0;3;3
109;28.03.2016;2016;03;08;Maanantai;4;1;5;1;1;2
109;28.03.2016;2016;03;09;Maanantai;2;1;3;3;2;5
109;28.03.2016;2016;03;10;Maanantai;3;2;5;0;4;4
109;28.03.2016;2016;03;11;Maanantai;2;2;4;6;4;10
109;28.03.2016;2016;03;12;Maanantai;10;3;13;10;8;18
109;28.03.2016;2016;03;13;Maanantai;5;1;6;14;3;17
109;28.03.2016;2016;03;14;Maanantai;12;4;16;10;7;17
109;28.03.2016;2016;03;15;Maanantai;3;8;11;13;6;19
109;28.03.2016;2016;03;16;Maanantai;11;8;19;10;8;18
109;28.03.2016;2016;03;17;Maanantai;6;3;9;5;7;12
109;28.03.2016;2016;03;18;Maanantai;6;3;9;3;4;7
109;28.03.2016;2016;03;19;Maanantai;11;4;15;6;4;10
109;28.03.2016;2016;03;20;Maanantai;2;8;10;3;5;8
109;28.03.2016;2016;03;21;Maanantai;4;4;8;7;2;9
109;28.03.2016;2016;03;22;Maanantai;1;2;3;0;1;1
109;28.03.2016;2016;03;23;Maanantai;0;0;0;1;3;4
109;29.03.2016;2016;03;00;Tiistai;0;0;0;1;0;1
109;29.03.2016;2016;03;01;Tiistai;0;0;0;0;0;0
109;29.03.2016;2016;03;02;Tiistai;0;0;0;0;0;0
109;29.03.2016;2016;03;03;Tiistai;0;0;0;0;0;0
109;29.03.2016;2016;03;04;Tiistai;1;2;3;0;0;0
109;29.03.2016;2016;03;05;Tiistai;1;3;4;2;1;3
109;29.03.2016;2016;03;06;Tiistai;12;4;16;1;3;4
109;29.03.2016;2016;03;07;Tiistai;42;22;64;6;4;10
109;29.03.2016;2016;03;08;Tiistai;52;12;64;3;4;7
109;29.03.2016;2016;03;09;Tiistai;10;10;20;3;6;9
109;29.03.2016;2016;03;10;Tiistai;9;3;12;5;2;7
109;29.03.2016;2016;03;11;Tiistai;10;5;15;3;0;3
109;29.03.2016;2016;03;12;Tiistai;12;7;19;6;3;9
109;29.03.2016;2016;03;13;Tiistai;10;13;23;4;3;7
109;29.03.2016;2016;03;14;Tiistai;11;11;22;6;3;9
109;29.03.2016;2016;03;15;Tiistai;13;35;48;5;4;9
109;29.03.2016;2016;03;16;Tiistai;25;41;66;12;6;18
109;29.03.2016;2016;03;17;Tiistai;25;25;50;4;9;13
109;29.03.2016;2016;03;18;Tiistai;9;14;23;6;4;10
109;29.03.2016;2016;03;19;Tiistai;7;11;18;12;7;19
109;29.03.2016;2016;03;20;Tiistai;6;8;14;3;6;9
109;29.03.2016;2016;03;21;Tiistai;0;11;11;3;3;6
109;29.03.2016;2016;03;22;Tiistai;3;3;6;1;1;2
109;29.03.2016;2016;03;23;Tiistai;0;0;0;0;0;0
109;30.03.2016;2016;03;00;Keskiviikko;1;0;1;0;0;0
109;30.03.2016;2016;03;01;Keskiviikko;0;0;0;0;0;0
109;30.03.2016;2016;03;02;Keskiviikko;0;0;0;0;0;0
109;30.03.2016;2016;03;03;Keskiviikko;0;0;0;0;0;0
109;30.03.2016;2016;03;04;Keskiviikko;1;2;3;0;0;0
109;30.03.2016;2016;03;05;Keskiviikko;0;4;4;3;1;4
109;30.03.2016;2016;03;06;Keskiviikko;14;2;16;2;1;3
109;30.03.2016;2016;03;07;Keskiviikko;57;23;80;4;8;12
109;30.03.2016;2016;03;08;Keskiviikko;42;18;60;1;2;3
109;30.03.2016;2016;03;09;Keskiviikko;13;11;24;4;5;9
109;30.03.2016;2016;03;10;Keskiviikko;10;5;15;4;1;5
109;30.03.2016;2016;03;11;Keskiviikko;10;6;16;8;2;10
109;30.03.2016;2016;03;12;Keskiviikko;7;4;11;5;3;8
109;30.03.2016;2016;03;13;Keskiviikko;7;11;18;2;4;6
109;30.03.2016;2016;03;14;Keskiviikko;14;14;28;4;4;8
109;30.03.2016;2016;03;15;Keskiviikko;15;30;45;5;9;14
109;30.03.2016;2016;03;16;Keskiviikko;36;44;80;6;10;16
109;30.03.2016;2016;03;17;Keskiviikko;19;22;41;3;3;6
109;30.03.2016;2016;03;18;Keskiviikko;9;14;23;10;2;12
109;30.03.2016;2016;03;19;Keskiviikko;6;9;15;8;5;13
109;30.03.2016;2016;03;20;Keskiviikko;8;10;18;8;8;16
109;30.03.2016;2016;03;21;Keskiviikko;5;12;17;0;3;3
109;30.03.2016;2016;03;22;Keskiviikko;5;6;11;0;1;1
109;30.03.2016;2016;03;23;Keskiviikko;0;1;1;0;0;0
109;31.03.2016;2016;03;00;Torstai;0;1;1;6;2;8
109;31.03.2016;2016;03;01;Torstai;0;0;0;0;0;0
109;31.03.2016;2016;03;02;Torstai;0;0;0;0;0;0
109;31.03.2016;2016;03;03;Torstai;0;0;0;0;0;0
109;31.03.2016;2016;03;04;Torstai;2;1;3;0;0;0
109;31.03.2016;2016;03;05;Torstai;2;4;6;2;0;2
109;31.03.2016;2016;03;06;Torstai;19;5;24;2;2;4
109;31.03.2016;2016;03;07;Torstai;46;24;70;6;5;11
109;31.03.2016;2016;03;08;Torstai;44;9;53;2;4;6
109;31.03.2016;2016;03;09;Torstai;11;6;17;3;5;8
109;31.03.2016;2016;03;10;Torstai;5;8;13;5;4;9
109;31.03.2016;2016;03;11;Torstai;10;9;19;10;6;16
109;31.03.2016;2016;03;12;Torstai;9;12;21;4;4;8
109;31.03.2016;2016;03;13;Torstai;7;21;28;6;3;9
109;31.03.2016;2016;03;14;Torstai;15;16;31;1;5;6
109;31.03.2016;2016;03;15;Torstai;8;25;33;6;7;13
109;31.03.2016;2016;03;16;Torstai;24;37;61;3;10;13
109;31.03.2016;2016;03;17;Torstai;20;17;37;9;8;17
109;31.03.2016;2016;03;18;Torstai;8;13;21;6;7;13
109;31.03.2016;2016;03;19;Torstai;6;8;14;5;3;8
109;31.03.2016;2016;03;20;Torstai;4;9;13;3;4;7
109;31.03.2016;2016;03;21;Torstai;2;6;8;8;2;10
109;31.03.2016;2016;03;22;Torstai;5;3;8;0;2;2
109;31.03.2016;2016;03;23;Torstai;0;2;2;0;0;0
109;01.04.2016;2016;04;00;Perjantai;0;0;0;0;2;2
109;01.04.2016;2016;04;01;Perjantai;0;0;0;0;0;0
109;01.04.2016;2016;04;02;Perjantai;0;0;0;0;0;0
109;01.04.2016;2016;04;03;Perjantai;0;0;0;0;0;0
109;01.04.2016;2016;04;04;Perjantai;0;0;0;0;0;0
109;01.04.2016;2016;04;05;Perjantai;3;5;8;2;1;3
109;01.04.2016;2016;04;06;Perjantai;13;3;16;1;2;3
109;01.04.2016;2016;04;07;Perjantai;46;22;68;2;5;7
109;01.04.2016;2016;04;08;Perjantai;47;15;62;5;3;8
109;01.04.2016;2016;04;09;Perjantai;11;9;20;2;3;5
109;01.04.2016;2016;04;10;Perjantai;12;6;18;5;3;8
109;01.04.2016;2016;04;11;Perjantai;11;9;20;4;4;8
109;01.04.2016;2016;04;12;Perjantai;11;11;22;2;4;6
109;01.04.2016;2016;04;13;Perjantai;11;12;23;3;6;9
109;01.04.2016;2016;04;14;Perjantai;12;24;36;4;0;4
109;01.04.2016;2016;04;15;Perjantai;14;38;52;3;7;10
109;01.04.2016;2016;04;16;Perjantai;21;25;46;3;5;8
109;01.04.2016;2016;04;17;Perjantai;18;17;35;5;2;7
109;01.04.2016;2016;04;18;Perjantai;1;8;9;3;4;7
109;01.04.2016;2016;04;19;Perjantai;7;5;12;5;2;7
109;01.04.2016;2016;04;20;Perjantai;8;6;14;2;2;4
109;01.04.2016;2016;04;21;Perjantai;7;5;12;2;1;3
109;01.04.2016;2016;04;22;Perjantai;4;2;6;2;2;4
109;01.04.2016;2016;04;23;Perjantai;0;2;2;0;2;2
109;02.04.2016;2016;04;00;Lauantai;3;0;3;0;0;0
109;02.04.2016;2016;04;01;Lauantai;0;1;1;2;1;3
109;02.04.2016;2016;04;02;Lauantai;0;1;1;0;0;0
109;02.04.2016;2016;04;03;Lauantai;0;0;0;0;0;0
109;02.04.2016;2016;04;04;Lauantai;0;5;5;0;0;0
109;02.04.2016;2016;04;05;Lauantai;3;1;4;0;0;0
109;02.04.2016;2016;04;06;Lauantai;3;0;3;2;4;6
109;02.04.2016;2016;04;07;Lauantai;3;1;4;1;2;3
109;02.04.2016;2016;04;08;Lauantai;2;4;6;2;2;4
109;02.04.2016;2016;04;09;Lauantai;4;1;5;5;1;6
109;02.04.2016;2016;04;10;Lauantai;4;2;6;4;1;5
109;02.04.2016;2016;04;11;Lauantai;7;6;13;2;2;4
109;02.04.2016;2016;04;12;Lauantai;13;2;15;1;2;3
109;02.04.2016;2016;04;13;Lauantai;8;6;14;3;1;4
109;02.04.2016;2016;04;14;Lauantai;12;10;22;5;3;8
109;02.04.2016;2016;04;15;Lauantai;10;12;22;5;2;7
109;02.04.2016;2016;04;16;Lauantai;7;2;9;3;5;8
109;02.04.2016;2016;04;17;Lauantai;12;4;16;2;1;3
109;02.04.2016;2016;04;18;Lauantai;7;10;17;1;4;5
109;02.04.2016;2016;04;19;Lauantai;5;5;10;4;5;9
109;02.04.2016;2016;04;20;Lauantai;4;3;7;3;0;3
109;02.04.2016;2016;04;21;Lauantai;4;5;9;3;3;6
109;02.04.2016;2016;04;22;Lauantai;2;4;6;1;1;2
109;02.04.2016;2016;04;23;Lauantai;4;5;9;0;0;0
109;03.04.2016;2016;04;00;Sunnuntai;0;1;1;0;1;1
109;03.04.2016;2016;04;01;Sunnuntai;1;1;2;0;0;0
109;03.04.2016;2016;04;02;Sunnuntai;2;3;5;0;0;0
109;03.04.2016;2016;04;03;Sunnuntai;0;0;0;0;0;0
109;03.04.2016;2016;04;04;Sunnuntai;1;0;1;0;0;0
109;03.04.2016;2016;04;05;Sunnuntai;1;2;3;0;0;0
109;03.04.2016;2016;04;06;Sunnuntai;5;2;7;0;0;0
109;03.04.2016;2016;04;07;Sunnuntai;1;4;5;3;2;5
109;03.04.2016;2016;04;08;Sunnuntai;0;0;0;1;2;3
109;03.04.2016;2016;04;09;Sunnuntai;1;3;4;7;4;11
109;03.04.2016;2016;04;10;Sunnuntai;8;2;10;9;8;17
109;03.04.2016;2016;04;11;Sunnuntai;12;6;18;5;5;10
109;03.04.2016;2016;04;12;Sunnuntai;13;12;25;11;8;19
109;03.04.2016;2016;04;13;Sunnuntai;16;18;34;5;7;12
109;03.04.2016;2016;04;14;Sunnuntai;13;15;28;5;4;9
109;03.04.2016;2016;04;15;Sunnuntai;14;20;34;6;4;10
109;03.04.2016;2016;04;16;Sunnuntai;14;9;23;7;4;11
109;03.04.2016;2016;04;17;Sunnuntai;10;7;17;9;3;12
109;03.04.2016;2016;04;18;Sunnuntai;7;3;10;8;5;13
109;03.04.2016;2016;04;19;Sunnuntai;4;7;11;2;4;6
109;03.04.2016;2016;04;20;Sunnuntai;10;13;23;3;7;10
109;03.04.2016;2016;04;21;Sunnuntai;2;7;9;2;3;5
109;03.04.2016;2016;04;22;Sunnuntai;2;1;3;0;0;0
109;03.04.2016;2016;04;23;Sunnuntai;1;2;3;0;0;0
109;04.04.2016;2016;04;00;Maanantai;0;0;0;2;1;3
109;04.04.2016;2016;04;01;Maanantai;0;1;1;0;1;1
109;04.04.2016;2016;04;02;Maanantai;0;1;1;0;0;0
109;04.04.2016;2016;04;03;Maanantai;0;0;0;0;0;0
109;04.04.2016;2016;04;04;Maanantai;0;0;0;0;0;0
109;04.04.2016;2016;04;05;Maanantai;2;2;4;1;2;3
109;04.04.2016;2016;04;06;Maanantai;25;5;30;1;4;5
109;04.04.2016;2016;04;07;Maanantai;58;25;83;8;4;12
109;04.04.2016;2016;04;08;Maanantai;54;13;67;6;4;10
109;04.04.2016;2016;04;09;Maanantai;15;7;22;2;3;5
109;04.04.2016;2016;04;10;Maanantai;13;3;16;6;7;13
109;04.04.2016;2016;04;11;Maanantai;12;8;20;8;3;11
109;04.04.2016;2016;04;12;Maanantai;11;17;28;4;3;7
109;04.04.2016;2016;04;13;Maanantai;8;11;19;2;7;9
109;04.04.2016;2016;04;14;Maanantai;13;27;40;1;4;5
109;04.04.2016;2016;04;15;Maanantai;16;43;59;4;1;5
109;04.04.2016;2016;04;16;Maanantai;37;57;94;9;2;11
109;04.04.2016;2016;04;17;Maanantai;18;22;40;5;7;12
109;04.04.2016;2016;04;18;Maanantai;14;28;42;10;3;13
109;04.04.2016;2016;04;19;Maanantai;15;7;22;7;7;14
109;04.04.2016;2016;04;20;Maanantai;4;10;14;5;4;9
109;04.04.2016;2016;04;21;Maanantai;9;12;21;2;2;4
109;04.04.2016;2016;04;22;Maanantai;3;7;10;0;2;2
109;04.04.2016;2016;04;23;Maanantai;0;1;1;0;0;0
109;05.04.2016;2016;04;00;Tiistai;1;1;2;0;0;0
109;05.04.2016;2016;04;01;Tiistai;0;0;0;0;0;0
109;05.04.2016;2016;04;02;Tiistai;0;0;0;1;1;2
109;05.04.2016;2016;04;03;Tiistai;0;0;0;0;0;0
109;05.04.2016;2016;04;04;Tiistai;0;0;0;0;0;0
109;05.04.2016;2016;04;05;Tiistai;1;2;3;0;0;0
109;05.04.2016;2016;04;06;Tiistai;22;13;35;2;3;5
109;05.04.2016;2016;04;07;Tiistai;51;21;72;4;7;11
109;05.04.2016;2016;04;08;Tiistai;46;12;58;2;3;5
109;05.04.2016;2016;04;09;Tiistai;11;9;20;2;4;6
109;05.04.2016;2016;04;10;Tiistai;11;5;16;2;2;4
109;05.04.2016;2016;04;11;Tiistai;4;9;13;5;3;8
109;05.04.2016;2016;04;12;Tiistai;10;6;16;4;1;5
109;05.04.2016;2016;04;13;Tiistai;6;10;16;1;1;2
109;05.04.2016;2016;04;14;Tiistai;9;16;25;6;4;10
109;05.04.2016;2016;04;15;Tiistai;18;26;44;5;4;9
109;05.04.2016;2016;04;16;Tiistai;24;39;63;5;7;12
109;05.04.2016;2016;04;17;Tiistai;17;21;38;4;2;6
109;05.04.2016;2016;04;18;Tiistai;12;19;31;6;9;15
109;05.04.2016;2016;04;19;Tiistai;9;9;18;5;4;9
109;05.04.2016;2016;04;20;Tiistai;3;12;15;4;7;11
109;05.04.2016;2016;04;21;Tiistai;6;8;14;5;0;5
109;05.04.2016;2016;04;22;Tiistai;4;5;9;0;1;1
109;05.04.2016;2016;04;23;Tiistai;1;2;3;0;0;0
109;06.04.2016;2016;04;00;Keskiviikko;0;1;1;1;0;1
109;06.04.2016;2016;04;01;Keskiviikko;0;0;0;0;1;1
109;06.04.2016;2016;04;02;Keskiviikko;0;0;0;0;0;0
109;06.04.2016;2016;04;03;Keskiviikko;0;0;0;0;0;0
109;06.04.2016;2016;04;04;Keskiviikko;0;2;2;0;0;0
109;06.04.2016;2016;04;05;Keskiviikko;2;3;5;0;0;0
109;06.04.2016;2016;04;06;Keskiviikko;19;6;25;2;3;5
109;06.04.2016;2016;04;07;Keskiviikko;49;18;67;3;6;9
109;06.04.2016;2016;04;08;Keskiviikko;41;12;53;3;5;8
109;06.04.2016;2016;04;09;Keskiviikko;14;7;21;3;2;5
109;06.04.2016;2016;04;10;Keskiviikko;7;3;10;2;1;3
109;06.04.2016;2016;04;11;Keskiviikko;8;6;14;6;3;9
109;06.04.2016;2016;04;12;Keskiviikko;16;12;28;5;2;7
109;06.04.2016;2016;04;13;Keskiviikko;7;9;16;0;3;3
109;06.04.2016;2016;04;14;Keskiviikko;11;20;31;6;2;8
109;06.04.2016;2016;04;15;Keskiviikko;7;32;39;2;5;7
109;06.04.2016;2016;04;16;Keskiviikko;35;41;76;4;0;4
109;06.04.2016;2016;04;17;Keskiviikko;16;15;31;4;2;6
109;06.04.2016;2016;04;18;Keskiviikko;7;12;19;1;1;2
109;06.04.2016;2016;04;19;Keskiviikko;1;8;9;6;2;8
109;06.04.2016;2016;04;20;Keskiviikko;3;4;7;3;3;6
109;06.04.2016;2016;04;21;Keskiviikko;3;9;12;2;0;2
109;06.04.2016;2016;04;22;Keskiviikko;3;3;6;0;1;1
109;06.04.2016;2016;04;23;Keskiviikko;1;2;3;1;0;1
109;07.04.2016;2016;04;00;Torstai;1;0;1;0;0;0
109;07.04.2016;2016;04;01;Torstai;0;0;0;0;0;0
109;07.04.2016;2016;04;02;Torstai;0;0;0;0;0;0
109;07.04.2016;2016;04;03;Torstai;0;0;0;0;0;0
109;07.04.2016;2016;04;04;Torstai;2;0;2;1;1;2
109;07.04.2016;2016;04;05;Torstai;1;3;4;2;0;2
109;07.04.2016;2016;04;06;Torstai;19;5;24;5;3;8
109;07.04.2016;2016;04;07;Torstai;42;27;69;5;9;14
109;07.04.2016;2016;04;08;Torstai;42;19;61;1;2;3
109;07.04.2016;2016;04;09;Torstai;20;4;24;1;4;5
109;07.04.2016;2016;04;10;Torstai;9;5;14;5;1;6
109;07.04.2016;2016;04;11;Torstai;11;10;21;4;2;6
109;07.04.2016;2016;04;12;Torstai;15;6;21;4;4;8
109;07.04.2016;2016;04;13;Torstai;11;14;25;5;4;9
109;07.04.2016;2016;04;14;Torstai;12;21;33;4;7;11
109;07.04.2016;2016;04;15;Torstai;10;36;46;5;6;11
109;07.04.2016;2016;04;16;Torstai;32;42;74;4;8;12
109;07.04.2016;2016;04;17;Torstai;13;24;37;7;5;12
109;07.04.2016;2016;04;18;Torstai;11;15;26;5;3;8
109;07.04.2016;2016;04;19;Torstai;9;4;13;11;3;14
109;07.04.2016;2016;04;20;Torstai;4;11;15;6;11;17
109;07.04.2016;2016;04;21;Torstai;1;9;10;3;2;5
109;07.04.2016;2016;04;22;Torstai;6;2;8;1;0;1
109;07.04.2016;2016;04;23;Torstai;0;2;2;1;1;2
109;08.04.2016;2016;04;00;Perjantai;0;1;1;3;0;3
109;08.04.2016;2016;04;01;Perjantai;0;0;0;0;0;0
109;08.04.2016;2016;04;02;Perjantai;0;1;1;0;0;0
109;08.04.2016;2016;04;03;Perjantai;0;0;0;0;0;0
109;08.04.2016;2016;04;04;Perjantai;3;0;3;0;0;0
109;08.04.2016;2016;04;05;Perjantai;2;3;5;1;0;1
109;08.04.2016;2016;04;06;Perjantai;18;8;26;2;2;4
109;08.04.2016;2016;04;07;Perjantai;42;26;68;6;6;12
109;08.04.2016;2016;04;08;Perjantai;45;15;60;4;3;7
109;08.04.2016;2016;04;09;Perjantai;14;8;22;6;2;8
109;08.04.2016;2016;04;10;Perjantai;10;5;15;6;1;7
109;08.04.2016;2016;04;11;Perjantai;14;12;26;0;2;2
109;08.04.2016;2016;04;12;Perjantai;13;12;25;2;1;3
109;08.04.2016;2016;04;13;Perjantai;9;23;32;8;4;12
109;08.04.2016;2016;04;14;Perjantai;15;24;39;8;4;12
109;08.04.2016;2016;04;15;Perjantai;19;31;50;4;5;9
109;08.04.2016;2016;04;16;Perjantai;24;37;61;6;6;12
109;08.04.2016;2016;04;17;Perjantai;14;20;34;7;5;12
109;08.04.2016;2016;04;18;Perjantai;12;9;21;3;10;13
109;08.04.2016;2016;04;19;Perjantai;11;6;17;6;1;7
109;08.04.2016;2016;04;20;Perjantai;4;10;14;4;3;7
109;08.04.2016;2016;04;21;Perjantai;4;13;17;3;2;5
109;08.04.2016;2016;04;22;Perjantai;4;5;9;1;1;2
109;08.04.2016;2016;04;23;Perjantai;2;2;4;0;1;1
109;09.04.2016;2016;04;00;Lauantai;0;3;3;0;0;0
109;09.04.2016;2016;04;01;Lauantai;0;1;1;0;1;1
109;09.04.2016;2016;04;02;Lauantai;0;4;4;0;0;0
109;09.04.2016;2016;04;03;Lauantai;0;1;1;0;0;0
109;09.04.2016;2016;04;04;Lauantai;0;1;1;0;0;0
109;09.04.2016;2016;04;05;Lauantai;4;6;10;0;0;0
109;09.04.2016;2016;04;06;Lauantai;4;0;4;2;0;2
109;09.04.2016;2016;04;07;Lauantai;3;1;4;0;8;8
109;09.04.2016;2016;04;08;Lauantai;8;4;12;5;1;6
109;09.04.2016;2016;04;09;Lauantai;6;5;11;8;6;14
109;09.04.2016;2016;04;10;Lauantai;7;10;17;4;5;9
109;09.04.2016;2016;04;11;Lauantai;10;3;13;8;4;12
109;09.04.2016;2016;04;12;Lauantai;16;7;23;8;2;10
109;09.04.2016;2016;04;13;Lauantai;13;16;29;4;6;10
109;09.04.2016;2016;04;14;Lauantai;15;17;32;9;8;17
109;09.04.2016;2016;04;15;Lauantai;17;13;30;13;8;21
109;09.04.2016;2016;04;16;Lauantai;8;9;17;18;1;19
109;09.04.2016;2016;04;17;Lauantai;7;13;20;5;5;10
109;09.04.2016;2016;04;18;Lauantai;6;6;12;1;5;6
109;09.04.2016;2016;04;19;Lauantai;8;9;17;5;6;11
109;09.04.2016;2016;04;20;Lauantai;9;6;15;2;5;7
109;09.04.2016;2016;04;21;Lauantai;3;8;11;1;3;4
109;09.04.2016;2016;04;22;Lauantai;5;4;9;2;1;3
109;09.04.2016;2016;04;23;Lauantai;3;3;6;1;0;1
109;10.04.2016;2016;04;00;Sunnuntai;5;2;7;1;0;1
109;10.04.2016;2016;04;01;Sunnuntai;0;1;1;0;0;0
109;10.04.2016;2016;04;02;Sunnuntai;0;1;1;0;0;0
109;10.04.2016;2016;04;03;Sunnuntai;0;0;0;0;0;0
109;10.04.2016;2016;04;04;Sunnuntai;0;1;1;0;0;0
109;10.04.2016;2016;04;05;Sunnuntai;1;2;3;0;0;0
109;10.04.2016;2016;04;06;Sunnuntai;6;0;6;1;0;1
109;10.04.2016;2016;04;07;Sunnuntai;0;1;1;3;5;8
109;10.04.2016;2016;04;08;Sunnuntai;2;3;5;4;1;5
109;10.04.2016;2016;04;09;Sunnuntai;4;4;8;2;7;9
109;10.04.2016;2016;04;10;Sunnuntai;3;4;7;7;2;9
109;10.04.2016;2016;04;11;Sunnuntai;17;7;24;8;6;14
109;10.04.2016;2016;04;12;Sunnuntai;12;16;28;8;6;14
109;10.04.2016;2016;04;13;Sunnuntai;16;17;33;4;2;6
109;10.04.2016;2016;04;14;Sunnuntai;14;13;27;4;4;8
109;10.04.2016;2016;04;15;Sunnuntai;16;9;25;10;2;12
109;10.04.2016;2016;04;16;Sunnuntai;21;15;36;6;4;10
109;10.04.2016;2016;04;17;Sunnuntai;16;13;29;3;4;7
109;10.04.2016;2016;04;18;Sunnuntai;13;13;26;8;3;11
109;10.04.2016;2016;04;19;Sunnuntai;6;9;15;2;5;7
109;10.04.2016;2016;04;20;Sunnuntai;9;13;22;3;6;9
109;10.04.2016;2016;04;21;Sunnuntai;1;6;7;2;5;7
109;10.04.2016;2016;04;22;Sunnuntai;1;2;3;0;0;0
109;10.04.2016;2016;04;23;Sunnuntai;0;2;2;1;1;2
109;11.04.2016;2016;04;00;Maanantai;0;1;1;0;0;0
109;11.04.2016;2016;04;01;Maanantai;0;2;2;0;0;0
109;11.04.2016;2016;04;02;Maanantai;0;0;0;0;0;0
109;11.04.2016;2016;04;03;Maanantai;0;0;0;0;0;0
109;11.04.2016;2016;04;04;Maanantai;0;1;1;0;0;0
109;11.04.2016;2016;04;05;Maanantai;1;5;6;0;1;1
109;11.04.2016;2016;04;06;Maanantai;27;11;38;1;3;4
109;11.04.2016;2016;04;07;Maanantai;58;22;80;6;8;14
109;11.04.2016;2016;04;08;Maanantai;64;14;78;2;1;3
109;11.04.2016;2016;04;09;Maanantai;14;7;21;4;9;13
109;11.04.2016;2016;04;10;Maanantai;17;7;24;4;1;5
109;11.04.2016;2016;04;11;Maanantai;18;11;29;4;2;6
109;11.04.2016;2016;04;12;Maanantai;15;9;24;7;2;9
109;11.04.2016;2016;04;13;Maanantai;16;22;38;6;5;11
109;11.04.2016;2016;04;14;Maanantai;22;21;43;5;4;9
109;11.04.2016;2016;04;15;Maanantai;22;46;68;8;3;11
109;11.04.2016;2016;04;16;Maanantai;31;68;99;9;8;17
109;11.04.2016;2016;04;17;Maanantai;24;19;43;4;7;11
109;11.04.2016;2016;04;18;Maanantai;17;19;36;6;4;10
109;11.04.2016;2016;04;19;Maanantai;10;12;22;7;5;12
109;11.04.2016;2016;04;20;Maanantai;7;10;17;5;3;8
109;11.04.2016;2016;04;21;Maanantai;7;7;14;0;5;5
109;11.04.2016;2016;04;22;Maanantai;7;4;11;1;2;3
109;11.04.2016;2016;04;23;Maanantai;2;0;2;0;1;1
109;12.04.2016;2016;04;00;Tiistai;1;1;2;0;0;0
109;12.04.2016;2016;04;01;Tiistai;0;0;0;0;1;1
109;12.04.2016;2016;04;02;Tiistai;0;1;1;0;0;0
109;12.04.2016;2016;04;03;Tiistai;0;0;0;0;0;0
109;12.04.2016;2016;04;04;Tiistai;0;0;0;0;0;0
109;12.04.2016;2016;04;05;Tiistai;1;5;6;1;0;1
109;12.04.2016;2016;04;06;Tiistai;32;11;43;2;3;5
109;12.04.2016;2016;04;07;Tiistai;72;30;102;11;5;16
109;12.04.2016;2016;04;08;Tiistai;47;14;61;2;4;6
109;12.04.2016;2016;04;09;Tiistai;14;7;21;5;1;6
109;12.04.2016;2016;04;10;Tiistai;11;4;15;3;6;9
109;12.04.2016;2016;04;11;Tiistai;26;11;37;6;4;10
109;12.04.2016;2016;04;12;Tiistai;11;13;24;4;1;5
109;12.04.2016;2016;04;13;Tiistai;15;24;39;4;1;5
109;12.04.2016;2016;04;14;Tiistai;7;23;30;6;3;9
109;12.04.2016;2016;04;15;Tiistai;18;43;61;4;3;7
109;12.04.2016;2016;04;16;Tiistai;47;51;98;2;9;11
109;12.04.2016;2016;04;17;Tiistai;26;28;54;4;4;8
109;12.04.2016;2016;04;18;Tiistai;16;21;37;5;3;8
109;12.04.2016;2016;04;19;Tiistai;8;7;15;14;7;21
109;12.04.2016;2016;04;20;Tiistai;8;13;21;5;2;7
109;12.04.2016;2016;04;21;Tiistai;7;11;18;6;3;9
109;12.04.2016;2016;04;22;Tiistai;10;7;17;0;1;1
109;12.04.2016;2016;04;23;Tiistai;0;1;1;0;2;2
109;13.04.2016;2016;04;00;Keskiviikko;0;1;1;0;1;1
109;13.04.2016;2016;04;01;Keskiviikko;1;0;1;0;0;0
109;13.04.2016;2016;04;02;Keskiviikko;0;1;1;0;0;0
109;13.04.2016;2016;04;03;Keskiviikko;0;1;1;0;0;0
109;13.04.2016;2016;04;04;Keskiviikko;0;0;0;0;0;0
109;13.04.2016;2016;04;05;Keskiviikko;1;5;6;0;0;0
109;13.04.2016;2016;04;06;Keskiviikko;28;13;41;2;2;4
109;13.04.2016;2016;04;07;Keskiviikko;67;29;96;6;9;15
109;13.04.2016;2016;04;08;Keskiviikko;56;14;70;6;5;11
109;13.04.2016;2016;04;09;Keskiviikko;12;9;21;4;2;6
109;13.04.2016;2016;04;10;Keskiviikko;20;4;24;6;0;6
109;13.04.2016;2016;04;11;Keskiviikko;8;10;18;2;4;6
109;13.04.2016;2016;04;12;Keskiviikko;12;12;24;4;2;6
109;13.04.2016;2016;04;13;Keskiviikko;13;12;25;4;9;13
109;13.04.2016;2016;04;14;Keskiviikko;15;25;40;3;3;6
109;13.04.2016;2016;04;15;Keskiviikko;18;39;57;9;6;15
109;13.04.2016;2016;04;16;Keskiviikko;35;53;88;4;1;5
109;13.04.2016;2016;04;17;Keskiviikko;14;24;38;4;4;8
109;13.04.2016;2016;04;18;Keskiviikko;13;12;25;3;1;4
109;13.04.2016;2016;04;19;Keskiviikko;9;8;17;10;0;10
109;13.04.2016;2016;04;20;Keskiviikko;5;11;16;1;4;5
109;13.04.2016;2016;04;21;Keskiviikko;2;10;12;4;1;5
109;13.04.2016;2016;04;22;Keskiviikko;7;3;10;1;2;3
109;13.04.2016;2016;04;23;Keskiviikko;1;1;2;0;0;0
109;14.04.2016;2016;04;00;Torstai;1;1;2;2;0;2
109;14.04.2016;2016;04;01;Torstai;0;1;1;0;0;0
109;14.04.2016;2016;04;02;Torstai;1;0;1;1;0;1
109;14.04.2016;2016;04;03;Torstai;0;0;0;0;0;0
109;14.04.2016;2016;04;04;Torstai;0;0;0;0;0;0
109;14.04.2016;2016;04;05;Torstai;2;4;6;1;0;1
109;14.04.2016;2016;04;06;Torstai;13;9;22;1;1;2
109;14.04.2016;2016;04;07;Torstai;60;26;86;5;4;9
109;14.04.2016;2016;04;08;Torstai;60;15;75;3;4;7
109;14.04.2016;2016;04;09;Torstai;14;11;25;4;2;6
109;14.04.2016;2016;04;10;Torstai;11;9;20;6;1;7
109;14.04.2016;2016;04;11;Torstai;13;9;22;2;4;6
109;14.04.2016;2016;04;12;Torstai;15;12;27;1;3;4
109;14.04.2016;2016;04;13;Torstai;11;18;29;3;3;6
109;14.04.2016;2016;04;14;Torstai;21;13;34;2;5;7
109;14.04.2016;2016;04;15;Torstai;23;40;63;1;6;7
109;14.04.2016;2016;04;16;Torstai;37;60;97;6;6;12
109;14.04.2016;2016;04;17;Torstai;21;23;44;7;5;12
109;14.04.2016;2016;04;18;Torstai;22;20;42;5;7;12
109;14.04.2016;2016;04;19;Torstai;13;16;29;6;3;9
109;14.04.2016;2016;04;20;Torstai;5;15;20;5;5;10
109;14.04.2016;2016;04;21;Torstai;4;8;12;5;4;9
109;14.04.2016;2016;04;22;Torstai;8;4;12;0;0;0
109;14.04.2016;2016;04;23;Torstai;0;2;2;1;0;1
109;15.04.2016;2016;04;00;Perjantai;0;2;2;0;0;0
109;15.04.2016;2016;04;01;Perjantai;0;1;1;0;0;0
109;15.04.2016;2016;04;02;Perjantai;0;0;0;0;0;0
109;15.04.2016;2016;04;03;Perjantai;0;0;0;0;0;0
109;15.04.2016;2016;04;04;Perjantai;1;0;1;0;0;0
109;15.04.2016;2016;04;05;Perjantai;2;4;6;1;0;1
109;15.04.2016;2016;04;06;Perjantai;20;8;28;2;3;5
109;15.04.2016;2016;04;07;Perjantai;52;24;76;4;2;6
109;15.04.2016;2016;04;08;Perjantai;37;13;50;2;1;3
109;15.04.2016;2016;04;09;Perjantai;25;4;29;3;2;5
109;15.04.2016;2016;04;10;Perjantai;7;4;11;3;3;6
109;15.04.2016;2016;04;11;Perjantai;14;14;28;8;2;10
109;15.04.2016;2016;04;12;Perjantai;16;16;32;7;6;13
109;15.04.2016;2016;04;13;Perjantai;15;14;29;5;5;10
109;15.04.2016;2016;04;14;Perjantai;25;21;46;6;3;9
109;15.04.2016;2016;04;15;Perjantai;20;36;56;8;5;13
109;15.04.2016;2016;04;16;Perjantai;35;47;82;7;3;10
109;15.04.2016;2016;04;17;Perjantai;24;21;45;5;5;10
109;15.04.2016;2016;04;18;Perjantai;18;14;32;2;4;6
109;15.04.2016;2016;04;19;Perjantai;12;8;20;4;7;11
109;15.04.2016;2016;04;20;Perjantai;9;11;20;6;3;9
109;15.04.2016;2016;04;21;Perjantai;5;12;17;3;3;6
109;15.04.2016;2016;04;22;Perjantai;8;4;12;0;0;0
109;15.04.2016;2016;04;23;Perjantai;0;4;4;1;0;1
109;16.04.2016;2016;04;00;Lauantai;1;2;3;0;1;1
109;16.04.2016;2016;04;01;Lauantai;0;2;2;1;1;2
109;16.04.2016;2016;04;02;Lauantai;0;1;1;0;0;0
109;16.04.2016;2016;04;03;Lauantai;0;0;0;0;0;0
109;16.04.2016;2016;04;04;Lauantai;0;2;2;0;0;0
109;16.04.2016;2016;04;05;Lauantai;0;2;2;0;0;0
109;16.04.2016;2016;04;06;Lauantai;7;0;7;1;1;2
109;16.04.2016;2016;04;07;Lauantai;3;1;4;0;4;4
109;16.04.2016;2016;04;08;Lauantai;4;1;5;7;2;9
109;16.04.2016;2016;04;09;Lauantai;10;0;10;7;3;10
109;16.04.2016;2016;04;10;Lauantai;6;6;12;3;1;4
109;16.04.2016;2016;04;11;Lauantai;14;9;23;2;6;8
109;16.04.2016;2016;04;12;Lauantai;16;3;19;8;0;8
109;16.04.2016;2016;04;13;Lauantai;9;13;22;6;2;8
109;16.04.2016;2016;04;14;Lauantai;15;16;31;9;7;16
109;16.04.2016;2016;04;15;Lauantai;10;9;19;5;5;10
109;16.04.2016;2016;04;16;Lauantai;4;10;14;1;3;4
109;16.04.2016;2016;04;17;Lauantai;8;17;25;7;3;10
109;16.04.2016;2016;04;18;Lauantai;7;13;20;3;3;6
109;16.04.2016;2016;04;19;Lauantai;12;3;15;4;3;7
109;16.04.2016;2016;04;20;Lauantai;4;2;6;8;2;10
109;16.04.2016;2016;04;21;Lauantai;2;6;8;0;3;3
109;16.04.2016;2016;04;22;Lauantai;0;5;5;0;0;0
109;16.04.2016;2016;04;23;Lauantai;0;4;4;3;1;4
109;17.04.2016;2016;04;00;Sunnuntai;0;1;1;0;2;2
109;17.04.2016;2016;04;01;Sunnuntai;0;0;0;0;0;0
109;17.04.2016;2016;04;02;Sunnuntai;0;0;0;0;0;0
109;17.04.2016;2016;04;03;Sunnuntai;0;0;0;0;0;0
109;17.04.2016;2016;04;04;Sunnuntai;0;1;1;0;0;0
109;17.04.2016;2016;04;05;Sunnuntai;3;1;4;0;0;0
109;17.04.2016;2016;04;06;Sunnuntai;4;0;4;0;1;1
109;17.04.2016;2016;04;07;Sunnuntai;1;2;3;2;4;6
109;17.04.2016;2016;04;08;Sunnuntai;1;3;4;1;1;2
109;17.04.2016;2016;04;09;Sunnuntai;1;0;1;1;2;3
109;17.04.2016;2016;04;10;Sunnuntai;4;2;6;5;6;11
109;17.04.2016;2016;04;11;Sunnuntai;10;3;13;3;2;5
109;17.04.2016;2016;04;12;Sunnuntai;11;11;22;6;3;9
109;17.04.2016;2016;04;13;Sunnuntai;11;3;14;2;5;7
109;17.04.2016;2016;04;14;Sunnuntai;11;8;19;6;7;13
109;17.04.2016;2016;04;15;Sunnuntai;8;9;17;7;5;12
109;17.04.2016;2016;04;16;Sunnuntai;15;9;24;3;3;6
109;17.04.2016;2016;04;17;Sunnuntai;2;8;10;9;3;12
109;17.04.2016;2016;04;18;Sunnuntai;10;5;15;11;5;16
109;17.04.2016;2016;04;19;Sunnuntai;5;2;7;4;1;5
109;17.04.2016;2016;04;20;Sunnuntai;2;3;5;4;7;11
109;17.04.2016;2016;04;21;Sunnuntai;4;8;12;4;0;4
109;17.04.2016;2016;04;22;Sunnuntai;3;2;5;0;0;0
109;17.04.2016;2016;04;23;Sunnuntai;0;0;0;0;0;0
109;18.04.2016;2016;04;00;Maanantai;0;0;0;1;0;1
109;18.04.2016;2016;04;01;Maanantai;1;1;2;0;0;0
109;18.04.2016;2016;04;02;Maanantai;0;0;0;0;0;0
109;18.04.2016;2016;04;03;Maanantai;0;0;0;0;0;0
109;18.04.2016;2016;04;04;Maanantai;0;0;0;0;0;0
109;18.04.2016;2016;04;05;Maanantai;1;4;5;2;1;3
109;18.04.2016;2016;04;06;Maanantai;18;6;24;2;4;6
109;18.04.2016;2016;04;07;Maanantai;67;38;105;6;2;8
109;18.04.2016;2016;04;08;Maanantai;57;13;70;5;1;6
109;18.04.2016;2016;04;09;Maanantai;8;9;17;3;2;5
109;18.04.2016;2016;04;10;Maanantai;15;6;21;4;0;4
109;18.04.2016;2016;04;11;Maanantai;17;8;25;6;3;9
109;18.04.2016;2016;04;12;Maanantai;17;12;29;1;4;5
109;18.04.2016;2016;04;13;Maanantai;10;14;24;0;5;5
109;18.04.2016;2016;04;14;Maanantai;22;12;34;5;4;9
109;18.04.2016;2016;04;15;Maanantai;27;44;71;3;4;7
109;18.04.2016;2016;04;16;Maanantai;36;70;106;3;5;8
109;18.04.2016;2016;04;17;Maanantai;15;22;37;12;4;16
109;18.04.2016;2016;04;18;Maanantai;12;13;25;6;6;12
109;18.04.2016;2016;04;19;Maanantai;17;6;23;5;6;11
109;18.04.2016;2016;04;20;Maanantai;5;11;16;7;8;15
109;18.04.2016;2016;04;21;Maanantai;4;17;21;0;2;2
109;18.04.2016;2016;04;22;Maanantai;7;4;11;1;2;3
109;18.04.2016;2016;04;23;Maanantai;2;2;4;1;0;1
109;19.04.2016;2016;04;00;Tiistai;0;1;1;1;1;2
109;19.04.2016;2016;04;01;Tiistai;0;0;0;0;0;0
109;19.04.2016;2016;04;02;Tiistai;0;0;0;0;0;0
109;19.04.2016;2016;04;03;Tiistai;0;0;0;0;0;0
109;19.04.2016;2016;04;04;Tiistai;0;1;1;0;0;0
109;19.04.2016;2016;04;05;Tiistai;0;5;5;0;1;1
109;19.04.2016;2016;04;06;Tiistai;21;8;29;2;4;6
109;19.04.2016;2016;04;07;Tiistai;63;27;90;1;5;6
109;19.04.2016;2016;04;08;Tiistai;58;14;72;3;1;4
109;19.04.2016;2016;04;09;Tiistai;19;7;26;2;1;3
109;19.04.2016;2016;04;10;Tiistai;12;6;18;4;7;11
109;19.04.2016;2016;04;11;Tiistai;9;12;21;8;3;11
109;19.04.2016;2016;04;12;Tiistai;9;5;14;4;2;6
109;19.04.2016;2016;04;13;Tiistai;7;16;23;5;1;6
109;19.04.2016;2016;04;14;Tiistai;13;17;30;7;2;9
109;19.04.2016;2016;04;15;Tiistai;21;44;65;5;5;10
109;19.04.2016;2016;04;16;Tiistai;26;50;76;5;6;11
109;19.04.2016;2016;04;17;Tiistai;11;23;34;5;6;11
109;19.04.2016;2016;04;18;Tiistai;13;13;26;3;6;9
109;19.04.2016;2016;04;19;Tiistai;6;15;21;4;5;9
109;19.04.2016;2016;04;20;Tiistai;3;8;11;6;3;9
109;19.04.2016;2016;04;21;Tiistai;4;8;12;2;3;5
109;19.04.2016;2016;04;22;Tiistai;6;3;9;2;2;4
109;19.04.2016;2016;04;23;Tiistai;0;2;2;0;1;1
109;20.04.2016;2016;04;00;Keskiviikko;0;0;0;0;0;0
109;20.04.2016;2016;04;01;Keskiviikko;0;0;0;0;0;0
109;20.04.2016;2016;04;02;Keskiviikko;0;0;0;0;0;0
109;20.04.2016;2016;04;03;Keskiviikko;0;0;0;0;0;0
109;20.04.2016;2016;04;04;Keskiviikko;2;0;2;0;0;0
109;20.04.2016;2016;04;05;Keskiviikko;1;4;5;1;0;1
109;20.04.2016;2016;04;06;Keskiviikko;28;8;36;3;2;5
109;20.04.2016;2016;04;07;Keskiviikko;56;26;82;4;3;7
109;20.04.2016;2016;04;08;Keskiviikko;43;18;61;5;3;8
109;20.04.2016;2016;04;09;Keskiviikko;16;9;25;2;3;5
109;20.04.2016;2016;04;10;Keskiviikko;14;6;20;2;1;3
109;20.04.2016;2016;04;11;Keskiviikko;13;6;19;4;4;8
109;20.04.2016;2016;04;12;Keskiviikko;16;5;21;3;4;7
109;20.04.2016;2016;04;13;Keskiviikko;8;14;22;3;4;7
109;20.04.2016;2016;04;14;Keskiviikko;17;29;46;5;2;7
109;20.04.2016;2016;04;15;Keskiviikko;18;39;57;4;3;7
109;20.04.2016;2016;04;16;Keskiviikko;23;50;73;5;5;10
109;20.04.2016;2016;04;17;Keskiviikko;26;29;55;6;1;7
109;20.04.2016;2016;04;18;Keskiviikko;12;14;26;12;11;23
109;20.04.2016;2016;04;19;Keskiviikko;6;16;22;0;6;6
109;20.04.2016;2016;04;20;Keskiviikko;5;13;18;6;8;14
109;20.04.2016;2016;04;21;Keskiviikko;3;9;12;3;2;5
109;20.04.2016;2016;04;22;Keskiviikko;4;3;7;2;1;3
109;20.04.2016;2016;04;23;Keskiviikko;0;5;5;0;1;1
109;21.04.2016;2016;04;00;Torstai;0;0;0;1;0;1
109;21.04.2016;2016;04;01;Torstai;0;0;0;0;0;0
109;21.04.2016;2016;04;02;Torstai;0;0;0;0;0;0
109;21.04.2016;2016;04;03;Torstai;0;0;0;0;0;0
109;21.04.2016;2016;04;04;Torstai;0;0;0;0;0;0
109;21.04.2016;2016;04;05;Torstai;1;4;5;2;1;3
109;21.04.2016;2016;04;06;Torstai;24;11;35;2;4;6
109;21.04.2016;2016;04;07;Torstai;67;29;96;6;5;11
109;21.04.2016;2016;04;08;Torstai;56;16;72;4;3;7
109;21.04.2016;2016;04;09;Torstai;13;5;18;2;4;6
109;21.04.2016;2016;04;10;Torstai;5;10;15;9;6;15
109;21.04.2016;2016;04;11;Torstai;10;12;22;4;7;11
109;21.04.2016;2016;04;12;Torstai;20;12;32;6;3;9
109;21.04.2016;2016;04;13;Torstai;5;14;19;3;2;5
109;21.04.2016;2016;04;14;Torstai;25;18;43;2;4;6
109;21.04.2016;2016;04;15;Torstai;25;37;62;5;3;8
109;21.04.2016;2016;04;16;Torstai;36;71;107;7;7;14
109;21.04.2016;2016;04;17;Torstai;19;15;34;7;4;11
109;21.04.2016;2016;04;18;Torstai;16;12;28;5;9;14
109;21.04.2016;2016;04;19;Torstai;3;5;8;7;4;11
109;21.04.2016;2016;04;20;Torstai;5;6;11;5;8;13
109;21.04.2016;2016;04;21;Torstai;7;21;28;3;5;8
109;21.04.2016;2016;04;22;Torstai;4;6;10;2;0;2
109;21.04.2016;2016;04;23;Torstai;0;1;1;0;0;0
109;22.04.2016;2016;04;00;Perjantai;0;2;2;0;0;0
109;22.04.2016;2016;04;01;Perjantai;0;2;2;0;0;0
109;22.04.2016;2016;04;02;Perjantai;0;0;0;0;0;0
109;22.04.2016;2016;04;03;Perjantai;1;0;1;0;0;0
109;22.04.2016;2016;04;04;Perjantai;2;1;3;0;0;0
109;22.04.2016;2016;04;05;Perjantai;2;3;5;2;1;3
109;22.04.2016;2016;04;06;Perjantai;23;10;33;3;1;4
109;22.04.2016;2016;04;07;Perjantai;55;27;82;9;6;15
109;22.04.2016;2016;04;08;Perjantai;52;19;71;4;4;8
109;22.04.2016;2016;04;09;Perjantai;18;6;24;8;5;13
109;22.04.2016;2016;04;10;Perjantai;11;10;21;6;1;7
109;22.04.2016;2016;04;11;Perjantai;17;14;31;32;15;47
109;22.04.2016;2016;04;12;Perjantai;18;16;34;3;4;7
109;22.04.2016;2016;04;13;Perjantai;10;15;25;4;3;7
109;22.04.2016;2016;04;14;Perjantai;14;33;47;4;6;10
109;22.04.2016;2016;04;15;Perjantai;23;48;71;5;4;9
109;22.04.2016;2016;04;16;Perjantai;27;39;66;2;5;7
109;22.04.2016;2016;04;17;Perjantai;17;18;35;9;1;10
109;22.04.2016;2016;04;18;Perjantai;9;11;20;5;2;7
109;22.04.2016;2016;04;19;Perjantai;8;11;19;3;3;6
109;22.04.2016;2016;04;20;Perjantai;8;7;15;8;1;9
109;22.04.2016;2016;04;21;Perjantai;6;8;14;2;2;4
109;22.04.2016;2016;04;22;Perjantai;5;4;9;1;3;4
109;22.04.2016;2016;04;23;Perjantai;2;5;7;0;2;2
109;23.04.2016;2016;04;00;Lauantai;3;2;5;0;0;0
109;23.04.2016;2016;04;01;Lauantai;2;2;4;0;0;0
109;23.04.2016;2016;04;02;Lauantai;0;0;0;0;0;0
109;23.04.2016;2016;04;03;Lauantai;0;1;1;0;0;0
109;23.04.2016;2016;04;04;Lauantai;3;1;4;0;0;0
109;23.04.2016;2016;04;05;Lauantai;1;2;3;0;0;0
109;23.04.2016;2016;04;06;Lauantai;6;1;7;1;1;2
109;23.04.2016;2016;04;07;Lauantai;1;2;3;2;2;4
109;23.04.2016;2016;04;08;Lauantai;2;1;3;4;5;9
109;23.04.2016;2016;04;09;Lauantai;12;5;17;4;8;12
109;23.04.2016;2016;04;10;Lauantai;15;4;19;6;4;10
109;23.04.2016;2016;04;11;Lauantai;18;10;28;3;2;5
109;23.04.2016;2016;04;12;Lauantai;12;6;18;0;3;3
109;23.04.2016;2016;04;13;Lauantai;12;9;21;5;5;10
109;23.04.2016;2016;04;14;Lauantai;6;12;18;6;2;8
109;23.04.2016;2016;04;15;Lauantai;9;12;21;2;0;2
109;23.04.2016;2016;04;16;Lauantai;12;4;16;1;1;2
109;23.04.2016;2016;04;17;Lauantai;7;9;16;3;4;7
109;23.04.2016;2016;04;18;Lauantai;17;9;26;5;3;8
109;23.04.2016;2016;04;19;Lauantai;8;8;16;5;2;7
109;23.04.2016;2016;04;20;Lauantai;6;13;19;5;2;7
109;23.04.2016;2016;04;21;Lauantai;4;12;16;2;4;6
109;23.04.2016;2016;04;22;Lauantai;0;2;2;2;1;3
109;23.04.2016;2016;04;23;Lauantai;1;2;3;0;0;0
109;24.04.2016;2016;04;00;Sunnuntai;2;1;3;0;2;2
109;24.04.2016;2016;04;01;Sunnuntai;0;0;0;1;1;2
109;24.04.2016;2016;04;02;Sunnuntai;0;1;1;0;0;0
109;24.04.2016;2016;04;03;Sunnuntai;0;1;1;0;0;0
109;24.04.2016;2016;04;04;Sunnuntai;2;0;2;0;0;0
109;24.04.2016;2016;04;05;Sunnuntai;1;0;1;0;0;0
109;24.04.2016;2016;04;06;Sunnuntai;2;2;4;0;1;1
109;24.04.2016;2016;04;07;Sunnuntai;1;1;2;1;3;4
109;24.04.2016;2016;04;08;Sunnuntai;2;4;6;8;4;12
109;24.04.2016;2016;04;09;Sunnuntai;7;1;8;3;6;9
109;24.04.2016;2016;04;10;Sunnuntai;4;3;7;6;6;12
109;24.04.2016;2016;04;11;Sunnuntai;24;5;29;10;4;14
109;24.04.2016;2016;04;12;Sunnuntai;13;6;19;1;3;4
109;24.04.2016;2016;04;13;Sunnuntai;11;13;24;9;3;12
109;24.04.2016;2016;04;14;Sunnuntai;9;18;27;5;5;10
109;24.04.2016;2016;04;15;Sunnuntai;15;22;37;5;7;12
109;24.04.2016;2016;04;16;Sunnuntai;11;12;23;6;4;10
109;24.04.2016;2016;04;17;Sunnuntai;16;14;30;7;6;13
109;24.04.2016;2016;04;18;Sunnuntai;11;7;18;6;5;11
109;24.04.2016;2016;04;19;Sunnuntai;7;8;15;6;2;8
109;24.04.2016;2016;04;20;Sunnuntai;4;3;7;5;3;8
109;24.04.2016;2016;04;21;Sunnuntai;2;9;11;1;1;2
109;24.04.2016;2016;04;22;Sunnuntai;1;2;3;0;1;1
109;24.04.2016;2016;04;23;Sunnuntai;0;1;1;0;1;1
109;25.04.2016;2016;04;00;Maanantai;0;1;1;2;0;2
109;25.04.2016;2016;04;01;Maanantai;0;1;1;0;0;0
109;25.04.2016;2016;04;02;Maanantai;0;0;0;0;0;0
109;25.04.2016;2016;04;03;Maanantai;1;0;1;1;0;1
109;25.04.2016;2016;04;04;Maanantai;0;1;1;0;0;0
109;25.04.2016;2016;04;05;Maanantai;3;5;8;1;1;2
109;25.04.2016;2016;04;06;Maanantai;30;7;37;4;3;7
109;25.04.2016;2016;04;07;Maanantai;64;24;88;4;4;8
109;25.04.2016;2016;04;08;Maanantai;68;24;92;6;1;7
109;25.04.2016;2016;04;09;Maanantai;20;11;31;3;4;7
109;25.04.2016;2016;04;10;Maanantai;18;9;27;4;5;9
109;25.04.2016;2016;04;11;Maanantai;19;9;28;3;2;5
109;25.04.2016;2016;04;12;Maanantai;11;10;21;6;3;9
109;25.04.2016;2016;04;13;Maanantai;17;11;28;0;3;3
109;25.04.2016;2016;04;14;Maanantai;13;14;27;1;1;2
109;25.04.2016;2016;04;15;Maanantai;17;43;60;4;1;5
109;25.04.2016;2016;04;16;Maanantai;20;61;81;5;2;7
109;25.04.2016;2016;04;17;Maanantai;15;24;39;1;3;4
109;25.04.2016;2016;04;18;Maanantai;11;17;28;2;2;4
109;25.04.2016;2016;04;19;Maanantai;3;9;12;7;9;16
109;25.04.2016;2016;04;20;Maanantai;6;9;15;4;4;8
109;25.04.2016;2016;04;21;Maanantai;4;12;16;2;3;5
109;25.04.2016;2016;04;22;Maanantai;3;4;7;3;2;5
109;25.04.2016;2016;04;23;Maanantai;1;1;2;0;0;0
109;26.04.2016;2016;04;00;Tiistai;2;1;3;0;0;0
109;26.04.2016;2016;04;01;Tiistai;0;0;0;0;0;0
109;26.04.2016;2016;04;02;Tiistai;0;1;1;0;0;0
109;26.04.2016;2016;04;03;Tiistai;0;0;0;0;0;0
109;26.04.2016;2016;04;04;Tiistai;0;1;1;0;0;0
109;26.04.2016;2016;04;05;Tiistai;1;7;8;0;0;0
109;26.04.2016;2016;04;06;Tiistai;32;12;44;3;3;6
109;26.04.2016;2016;04;07;Tiistai;59;25;84;9;10;19
109;26.04.2016;2016;04;08;Tiistai;57;12;69;2;1;3
109;26.04.2016;2016;04;09;Tiistai;18;10;28;4;3;7
109;26.04.2016;2016;04;10;Tiistai;9;7;16;0;4;4
109;26.04.2016;2016;04;11;Tiistai;13;7;20;3;2;5
109;26.04.2016;2016;04;12;Tiistai;10;6;16;3;1;4
109;26.04.2016;2016;04;13;Tiistai;10;13;23;2;1;3
109;26.04.2016;2016;04;14;Tiistai;14;17;31;5;3;8
109;26.04.2016;2016;04;15;Tiistai;23;59;82;4;3;7
109;26.04.2016;2016;04;16;Tiistai;30;50;80;4;2;6
109;26.04.2016;2016;04;17;Tiistai;20;26;46;3;2;5
109;26.04.2016;2016;04;18;Tiistai;2;12;14;5;5;10
109;26.04.2016;2016;04;19;Tiistai;8;9;17;4;1;5
109;26.04.2016;2016;04;20;Tiistai;13;8;21;7;9;16
109;26.04.2016;2016;04;21;Tiistai;4;13;17;2;3;5
109;26.04.2016;2016;04;22;Tiistai;5;3;8;0;0;0
109;26.04.2016;2016;04;23;Tiistai;0;0;0;0;1;1
109;27.04.2016;2016;04;00;Keskiviikko;0;2;2;0;1;1
109;27.04.2016;2016;04;01;Keskiviikko;0;2;2;0;0;0
109;27.04.2016;2016;04;02;Keskiviikko;0;1;1;0;0;0
109;27.04.2016;2016;04;03;Keskiviikko;0;0;0;0;0;0
109;27.04.2016;2016;04;04;Keskiviikko;1;3;4;0;0;0
109;27.04.2016;2016;04;05;Keskiviikko;1;5;6;2;1;3
109;27.04.2016;2016;04;06;Keskiviikko;23;11;34;4;3;7
109;27.04.2016;2016;04;07;Keskiviikko;74;26;100;8;7;15
109;27.04.2016;2016;04;08;Keskiviikko;55;19;74;3;3;6
109;27.04.2016;2016;04;09;Keskiviikko;23;9;32;6;4;10
109;27.04.2016;2016;04;10;Keskiviikko;15;10;25;4;1;5
109;27.04.2016;2016;04;11;Keskiviikko;16;9;25;3;3;6
109;27.04.2016;2016;04;12;Keskiviikko;11;12;23;3;6;9
109;27.04.2016;2016;04;13;Keskiviikko;11;12;23;6;4;10
109;27.04.2016;2016;04;14;Keskiviikko;17;32;49;3;5;8
109;27.04.2016;2016;04;15;Keskiviikko;23;35;58;3;1;4
109;27.04.2016;2016;04;16;Keskiviikko;27;73;100;5;5;10
109;27.04.2016;2016;04;17;Keskiviikko;17;24;41;6;3;9
109;27.04.2016;2016;04;18;Keskiviikko;8;12;20;4;3;7
109;27.04.2016;2016;04;19;Keskiviikko;5;11;16;8;4;12
109;27.04.2016;2016;04;20;Keskiviikko;6;11;17;5;6;11
109;27.04.2016;2016;04;21;Keskiviikko;2;10;12;2;2;4
109;27.04.2016;2016;04;22;Keskiviikko;3;7;10;0;1;1
109;27.04.2016;2016;04;23;Keskiviikko;0;2;2;1;0;1
109;28.04.2016;2016;04;00;Torstai;0;2;2;0;0;0
109;28.04.2016;2016;04;01;Torstai;0;1;1;0;0;0
109;28.04.2016;2016;04;02;Torstai;0;0;0;0;0;0
109;28.04.2016;2016;04;03;Torstai;0;0;0;0;1;1
109;28.04.2016;2016;04;04;Torstai;1;1;2;0;0;0
109;28.04.2016;2016;04;05;Torstai;5;5;10;1;1;2
109;28.04.2016;2016;04;06;Torstai;28;8;36;3;4;7
109;28.04.2016;2016;04;07;Torstai;62;27;89;9;6;15
109;28.04.2016;2016;04;08;Torstai;64;21;85;3;1;4
109;28.04.2016;2016;04;09;Torstai;14;10;24;2;3;5
109;28.04.2016;2016;04;10;Torstai;9;14;23;3;5;8
109;28.04.2016;2016;04;11;Torstai;18;9;27;6;5;11
109;28.04.2016;2016;04;12;Torstai;17;14;31;3;3;6
109;28.04.2016;2016;04;13;Torstai;13;16;29;5;2;7
109;28.04.2016;2016;04;14;Torstai;15;26;41;6;3;9
109;28.04.2016;2016;04;15;Torstai;22;43;65;4;5;9
109;28.04.2016;2016;04;16;Torstai;31;60;91;13;2;15
109;28.04.2016;2016;04;17;Torstai;27;32;59;13;7;20
109;28.04.2016;2016;04;18;Torstai;22;19;41;6;3;9
109;28.04.2016;2016;04;19;Torstai;9;15;24;5;7;12
109;28.04.2016;2016;04;20;Torstai;8;16;24;8;6;14
109;28.04.2016;2016;04;21;Torstai;6;12;18;5;0;5
109;28.04.2016;2016;04;22;Torstai;9;5;14;0;1;1
109;28.04.2016;2016;04;23;Torstai;0;4;4;0;0;0
109;29.04.2016;2016;04;00;Perjantai;0;0;0;2;0;2
109;29.04.2016;2016;04;01;Perjantai;0;0;0;0;0;0
109;29.04.2016;2016;04;02;Perjantai;0;0;0;0;0;0
109;29.04.2016;2016;04;03;Perjantai;0;0;0;0;0;0
109;29.04.2016;2016;04;04;Perjantai;0;2;2;0;1;1
109;29.04.2016;2016;04;05;Perjantai;1;5;6;3;3;6
109;29.04.2016;2016;04;06;Perjantai;28;7;35;3;2;5
109;29.04.2016;2016;04;07;Perjantai;63;18;81;6;7;13
109;29.04.2016;2016;04;08;Perjantai;52;18;70;8;2;10
109;29.04.2016;2016;04;09;Perjantai;30;8;38;7;5;12
109;29.04.2016;2016;04;10;Perjantai;16;9;25;4;1;5
109;29.04.2016;2016;04;11;Perjantai;11;13;24;8;8;16
109;29.04.2016;2016;04;12;Perjantai;14;11;25;8;4;12
109;29.04.2016;2016;04;13;Perjantai;16;24;40;5;11;16
109;29.04.2016;2016;04;14;Perjantai;21;32;53;4;3;7
109;29.04.2016;2016;04;15;Perjantai;14;49;63;5;4;9
109;29.04.2016;2016;04;16;Perjantai;16;36;52;3;5;8
109;29.04.2016;2016;04;17;Perjantai;11;16;27;9;5;14
109;29.04.2016;2016;04;18;Perjantai;20;7;27;7;2;9
109;29.04.2016;2016;04;19;Perjantai;11;4;15;2;6;8
109;29.04.2016;2016;04;20;Perjantai;7;22;29;8;6;14
109;29.04.2016;2016;04;21;Perjantai;16;14;30;4;8;12
109;29.04.2016;2016;04;22;Perjantai;6;1;7;3;1;4
109;29.04.2016;2016;04;23;Perjantai;6;8;14;2;1;3
109;30.04.2016;2016;04;00;Lauantai;3;1;4;0;0;0
109;30.04.2016;2016;04;01;Lauantai;1;1;2;1;0;1
109;30.04.2016;2016;04;02;Lauantai;0;1;1;0;0;0
109;30.04.2016;2016;04;03;Lauantai;1;4;5;0;0;0
109;30.04.2016;2016;04;04;Lauantai;0;0;0;0;0;0
109;30.04.2016;2016;04;05;Lauantai;2;1;3;0;0;0
109;30.04.2016;2016;04;06;Lauantai;6;3;9;2;2;4
109;30.04.2016;2016;04;07;Lauantai;5;5;10;2;4;6
109;30.04.2016;2016;04;08;Lauantai;5;7;12;6;1;7
109;30.04.2016;2016;04;09;Lauantai;10;2;12;5;11;16
109;30.04.2016;2016;04;10;Lauantai;8;9;17;13;11;24
109;30.04.2016;2016;04;11;Lauantai;12;10;22;6;3;9
109;30.04.2016;2016;04;12;Lauantai;38;11;49;3;4;7
109;30.04.2016;2016;04;13;Lauantai;25;13;38;3;4;7
109;30.04.2016;2016;04;14;Lauantai;17;11;28;4;4;8
109;30.04.2016;2016;04;15;Lauantai;21;10;31;1;4;5
109;30.04.2016;2016;04;16;Lauantai;8;22;30;4;3;7
109;30.04.2016;2016;04;17;Lauantai;24;17;41;1;2;3
109;30.04.2016;2016;04;18;Lauantai;16;21;37;2;2;4
109;30.04.2016;2016;04;19;Lauantai;13;12;25;2;5;7
109;30.04.2016;2016;04;20;Lauantai;3;9;12;2;4;6
109;30.04.2016;2016;04;21;Lauantai;5;11;16;2;3;5
109;30.04.2016;2016;04;22;Lauantai;4;4;8;0;1;1
109;30.04.2016;2016;04;23;Lauantai;0;8;8;3;2;5
109;01.05.2016;2016;05;00;Sunnuntai;2;6;8;0;0;0
109;01.05.2016;2016;05;01;Sunnuntai;2;5;7;0;1;1
109;01.05.2016;2016;05;02;Sunnuntai;2;12;14;0;0;0
109;01.05.2016;2016;05;03;Sunnuntai;4;9;13;1;0;1
109;01.05.2016;2016;05;04;Sunnuntai;2;3;5;2;1;3
109;01.05.2016;2016;05;05;Sunnuntai;0;3;3;0;0;0
109;01.05.2016;2016;05;06;Sunnuntai;8;0;8;1;0;1
109;01.05.2016;2016;05;07;Sunnuntai;5;3;8;3;3;6
109;01.05.2016;2016;05;08;Sunnuntai;5;4;9;4;2;6
109;01.05.2016;2016;05;09;Sunnuntai;9;3;12;6;5;11
109;01.05.2016;2016;05;10;Sunnuntai;19;9;28;6;4;10
109;01.05.2016;2016;05;11;Sunnuntai;32;9;41;7;4;11
109;01.05.2016;2016;05;12;Sunnuntai;37;13;50;8;2;10
109;01.05.2016;2016;05;13;Sunnuntai;52;19;71;9;1;10
109;01.05.2016;2016;05;14;Sunnuntai;37;39;76;4;6;10
109;01.05.2016;2016;05;15;Sunnuntai;25;24;49;0;1;1
109;01.05.2016;2016;05;16;Sunnuntai;20;30;50;4;3;7
109;01.05.2016;2016;05;17;Sunnuntai;15;12;27;8;6;14
109;01.05.2016;2016;05;18;Sunnuntai;19;11;30;5;2;7
109;01.05.2016;2016;05;19;Sunnuntai;22;11;33;5;1;6
109;01.05.2016;2016;05;20;Sunnuntai;6;10;16;3;6;9
109;01.05.2016;2016;05;21;Sunnuntai;1;6;7;2;2;4
109;01.05.2016;2016;05;22;Sunnuntai;3;8;11;1;0;1
109;01.05.2016;2016;05;23;Sunnuntai;1;2;3;0;0;0
109;02.05.2016;2016;05;00;Maanantai;0;0;0;0;1;1
109;02.05.2016;2016;05;01;Maanantai;0;1;1;0;0;0
109;02.05.2016;2016;05;02;Maanantai;0;0;0;0;0;0
109;02.05.2016;2016;05;03;Maanantai;0;0;0;0;0;0
109;02.05.2016;2016;05;04;Maanantai;1;2;3;1;0;1
109;02.05.2016;2016;05;05;Maanantai;5;7;12;2;0;2
109;02.05.2016;2016;05;06;Maanantai;38;10;48;0;1;1
109;02.05.2016;2016;05;07;Maanantai;94;33;127;9;5;14
109;02.05.2016;2016;05;08;Maanantai;74;20;94;6;2;8
109;02.05.2016;2016;05;09;Maanantai;17;8;25;4;1;5
109;02.05.2016;2016;05;10;Maanantai;19;8;27;2;1;3
109;02.05.2016;2016;05;11;Maanantai;14;12;26;2;3;5
109;02.05.2016;2016;05;12;Maanantai;11;10;21;2;1;3
109;02.05.2016;2016;05;13;Maanantai;12;15;27;3;5;8
109;02.05.2016;2016;05;14;Maanantai;15;25;40;1;2;3
109;02.05.2016;2016;05;15;Maanantai;26;64;90;2;4;6
109;02.05.2016;2016;05;16;Maanantai;39;90;129;10;4;14
109;02.05.2016;2016;05;17;Maanantai;29;48;77;3;8;11
109;02.05.2016;2016;05;18;Maanantai;23;20;43;7;5;12
109;02.05.2016;2016;05;19;Maanantai;24;9;33;12;2;14
109;02.05.2016;2016;05;20;Maanantai;12;15;27;5;6;11
109;02.05.2016;2016;05;21;Maanantai;8;9;17;1;1;2
109;02.05.2016;2016;05;22;Maanantai;4;4;8;1;0;1
109;02.05.2016;2016;05;23;Maanantai;5;4;9;1;4;5
109;03.05.2016;2016;05;00;Tiistai;1;0;1;1;0;1
109;03.05.2016;2016;05;01;Tiistai;0;2;2;0;0;0
109;03.05.2016;2016;05;02;Tiistai;0;0;0;0;0;0
109;03.05.2016;2016;05;03;Tiistai;0;0;0;0;0;0
109;03.05.2016;2016;05;04;Tiistai;2;0;2;0;0;0
109;03.05.2016;2016;05;05;Tiistai;3;9;12;1;0;1
109;03.05.2016;2016;05;06;Tiistai;44;16;60;2;5;7
109;03.05.2016;2016;05;07;Tiistai;97;36;133;10;6;16
109;03.05.2016;2016;05;08;Tiistai;77;21;98;5;3;8
109;03.05.2016;2016;05;09;Tiistai;26;5;31;4;3;7
109;03.05.2016;2016;05;10;Tiistai;22;11;33;2;4;6
109;03.05.2016;2016;05;11;Tiistai;17;12;29;6;4;10
109;03.05.2016;2016;05;12;Tiistai;13;18;31;3;2;5
109;03.05.2016;2016;05;13;Tiistai;14;20;34;0;2;2
109;03.05.2016;2016;05;14;Tiistai;18;16;34;3;2;5
109;03.05.2016;2016;05;15;Tiistai;30;68;98;6;6;12
109;03.05.2016;2016;05;16;Tiistai;45;85;130;7;7;14
109;03.05.2016;2016;05;17;Tiistai;39;48;87;8;2;10
109;03.05.2016;2016;05;18;Tiistai;22;25;47;6;6;12
109;03.05.2016;2016;05;19;Tiistai;11;14;25;7;5;12
109;03.05.2016;2016;05;20;Tiistai;14;20;34;4;6;10
109;03.05.2016;2016;05;21;Tiistai;4;19;23;3;5;8
109;03.05.2016;2016;05;22;Tiistai;8;3;11;1;5;6
109;03.05.2016;2016;05;23;Tiistai;2;3;5;2;0;2
109;04.05.2016;2016;05;00;Keskiviikko;2;2;4;1;0;1
109;04.05.2016;2016;05;01;Keskiviikko;0;1;1;0;0;0
109;04.05.2016;2016;05;02;Keskiviikko;1;1;2;0;1;1
109;04.05.2016;2016;05;03;Keskiviikko;0;0;0;0;0;0
109;04.05.2016;2016;05;04;Keskiviikko;0;0;0;0;0;0
109;04.05.2016;2016;05;05;Keskiviikko;2;8;10;2;1;3
109;04.05.2016;2016;05;06;Keskiviikko;41;13;54;9;4;13
109;04.05.2016;2016;05;07;Keskiviikko;101;39;140;4;7;11
109;04.05.2016;2016;05;08;Keskiviikko;72;19;91;3;0;3
109;04.05.2016;2016;05;09;Keskiviikko;27;15;42;6;2;8
109;04.05.2016;2016;05;10;Keskiviikko;20;14;34;4;3;7
109;04.05.2016;2016;05;11;Keskiviikko;24;9;33;2;2;4
109;04.05.2016;2016;05;12;Keskiviikko;30;11;41;2;2;4
109;04.05.2016;2016;05;13;Keskiviikko;26;22;48;1;2;3
109;04.05.2016;2016;05;14;Keskiviikko;24;40;64;3;2;5
109;04.05.2016;2016;05;15;Keskiviikko;24;89;113;2;4;6
109;04.05.2016;2016;05;16;Keskiviikko;56;79;135;2;3;5
109;04.05.2016;2016;05;17;Keskiviikko;22;30;52;4;3;7
109;04.05.2016;2016;05;18;Keskiviikko;28;16;44;7;0;7
109;04.05.2016;2016;05;19;Keskiviikko;15;13;28;7;8;15
109;04.05.2016;2016;05;20;Keskiviikko;18;14;32;5;8;13
109;04.05.2016;2016;05;21;Keskiviikko;13;19;32;3;2;5
109;04.05.2016;2016;05;22;Keskiviikko;2;7;9;1;1;2
109;04.05.2016;2016;05;23;Keskiviikko;0;7;7;0;1;1
109;05.05.2016;2016;05;00;Torstai;3;2;5;0;1;1
109;05.05.2016;2016;05;01;Torstai;1;1;2;0;0;0
109;05.05.2016;2016;05;02;Torstai;0;0;0;0;0;0
109;05.05.2016;2016;05;03;Torstai;0;0;0;0;0;0
109;05.05.2016;2016;05;04;Torstai;0;1;1;0;0;0
109;05.05.2016;2016;05;05;Torstai;3;2;5;0;0;0
109;05.05.2016;2016;05;06;Torstai;7;8;15;2;1;3
109;05.05.2016;2016;05;07;Torstai;6;5;11;1;4;5
109;05.05.2016;2016;05;08;Torstai;7;6;13;4;2;6
109;05.05.2016;2016;05;09;Torstai;9;11;20;6;3;9
109;05.05.2016;2016;05;10;Torstai;11;15;26;5;4;9
109;05.05.2016;2016;05;11;Torstai;17;8;25;5;4;9
109;05.05.2016;2016;05;12;Torstai;17;19;36;2;2;4
109;05.05.2016;2016;05;13;Torstai;32;20;52;5;5;10
109;05.05.2016;2016;05;14;Torstai;25;22;47;4;5;9
109;05.05.2016;2016;05;15;Torstai;36;11;47;2;3;5
109;05.05.2016;2016;05;16;Torstai;25;30;55;3;1;4
109;05.05.2016;2016;05;17;Torstai;18;17;35;4;5;9
109;05.05.2016;2016;05;18;Torstai;22;23;45;12;7;19
109;05.05.2016;2016;05;19;Torstai;12;10;22;5;2;7
109;05.05.2016;2016;05;20;Torstai;14;23;37;6;5;11
109;05.05.2016;2016;05;21;Torstai;9;15;24;0;4;4
109;05.05.2016;2016;05;22;Torstai;2;7;9;0;0;0
109;05.05.2016;2016;05;23;Torstai;4;2;6;0;0;0
109;06.05.2016;2016;05;00;Perjantai;0;2;2;1;0;1
109;06.05.2016;2016;05;01;Perjantai;2;3;5;0;0;0
109;06.05.2016;2016;05;02;Perjantai;0;0;0;0;0;0
109;06.05.2016;2016;05;03;Perjantai;0;0;0;0;0;0
109;06.05.2016;2016;05;04;Perjantai;0;0;0;0;0;0
109;06.05.2016;2016;05;05;Perjantai;2;7;9;2;0;2
109;06.05.2016;2016;05;06;Perjantai;29;13;42;0;1;1
109;06.05.2016;2016;05;07;Perjantai;55;25;80;2;8;10
109;06.05.2016;2016;05;08;Perjantai;32;12;44;8;1;9
109;06.05.2016;2016;05;09;Perjantai;15;11;26;1;2;3
109;06.05.2016;2016;05;10;Perjantai;22;5;27;5;2;7
109;06.05.2016;2016;05;11;Perjantai;19;16;35;2;5;7
109;06.05.2016;2016;05;12;Perjantai;20;20;40;3;5;8
109;06.05.2016;2016;05;13;Perjantai;18;14;32;1;0;1
109;06.05.2016;2016;05;14;Perjantai;21;31;52;2;4;6
109;06.05.2016;2016;05;15;Perjantai;31;44;75;3;1;4
109;06.05.2016;2016;05;16;Perjantai;27;38;65;8;3;11
109;06.05.2016;2016;05;17;Perjantai;26;13;39;8;2;10
109;06.05.2016;2016;05;18;Perjantai;11;16;27;2;6;8
109;06.05.2016;2016;05;19;Perjantai;17;24;41;5;4;9
109;06.05.2016;2016;05;20;Perjantai;6;9;15;4;3;7
109;06.05.2016;2016;05;21;Perjantai;8;13;21;4;1;5
109;06.05.2016;2016;05;22;Perjantai;4;6;10;1;1;2
109;06.05.2016;2016;05;23;Perjantai;4;4;8;3;1;4
109;07.05.2016;2016;05;00;Lauantai;4;3;7;0;3;3
109;07.05.2016;2016;05;01;Lauantai;0;1;1;0;0;0
109;07.05.2016;2016;05;02;Lauantai;1;1;2;0;1;1
109;07.05.2016;2016;05;03;Lauantai;0;1;1;0;0;0
109;07.05.2016;2016;05;04;Lauantai;0;5;5;0;0;0
109;07.05.2016;2016;05;05;Lauantai;0;1;1;0;1;1
109;07.05.2016;2016;05;06;Lauantai;8;2;10;1;0;1
109;07.05.2016;2016;05;07;Lauantai;7;6;13;1;3;4
109;07.05.2016;2016;05;08;Lauantai;3;2;5;3;3;6
109;07.05.2016;2016;05;09;Lauantai;9;6;15;3;2;5
109;07.05.2016;2016;05;10;Lauantai;20;11;31;5;4;9
109;07.05.2016;2016;05;11;Lauantai;18;12;30;3;4;7
109;07.05.2016;2016;05;12;Lauantai;19;12;31;3;0;3
109;07.05.2016;2016;05;13;Lauantai;29;15;44;2;3;5
109;07.05.2016;2016;05;14;Lauantai;22;16;38;4;1;5
109;07.05.2016;2016;05;15;Lauantai;26;13;39;1;2;3
109;07.05.2016;2016;05;16;Lauantai;22;20;42;4;4;8
109;07.05.2016;2016;05;17;Lauantai;14;18;32;3;0;3
109;07.05.2016;2016;05;18;Lauantai;13;19;32;4;5;9
109;07.05.2016;2016;05;19;Lauantai;15;12;27;6;7;13
109;07.05.2016;2016;05;20;Lauantai;11;12;23;4;2;6
109;07.05.2016;2016;05;21;Lauantai;6;12;18;1;1;2
109;07.05.2016;2016;05;22;Lauantai;3;7;10;0;0;0
109;07.05.2016;2016;05;23;Lauantai;5;6;11;3;2;5
109;08.05.2016;2016;05;00;Sunnuntai;3;2;5;0;0;0
109;08.05.2016;2016;05;01;Sunnuntai;1;3;4;1;1;2
109;08.05.2016;2016;05;02;Sunnuntai;0;1;1;0;0;0
109;08.05.2016;2016;05;03;Sunnuntai;1;2;3;0;0;0
109;08.05.2016;2016;05;04;Sunnuntai;1;0;1;0;0;0
109;08.05.2016;2016;05;05;Sunnuntai;1;1;2;0;0;0
109;08.05.2016;2016;05;06;Sunnuntai;7;3;10;0;0;0
109;08.05.2016;2016;05;07;Sunnuntai;1;5;6;4;2;6
109;08.05.2016;2016;05;08;Sunnuntai;3;7;10;4;0;4
109;08.05.2016;2016;05;09;Sunnuntai;7;4;11;4;6;10
109;08.05.2016;2016;05;10;Sunnuntai;9;8;17;4;6;10
109;08.05.2016;2016;05;11;Sunnuntai;24;14;38;12;3;15
109;08.05.2016;2016;05;12;Sunnuntai;27;22;49;4;3;7
109;08.05.2016;2016;05;13;Sunnuntai;21;16;37;8;2;10
109;08.05.2016;2016;05;14;Sunnuntai;16;16;32;3;4;7
109;08.05.2016;2016;05;15;Sunnuntai;26;9;35;5;5;10
109;08.05.2016;2016;05;16;Sunnuntai;12;9;21;6;2;8
109;08.05.2016;2016;05;17;Sunnuntai;13;20;33;4;4;8
109;08.05.2016;2016;05;18;Sunnuntai;7;18;25;2;4;6
109;08.05.2016;2016;05;19;Sunnuntai;22;19;41;4;2;6
109;08.05.2016;2016;05;20;Sunnuntai;14;5;19;10;4;14
109;08.05.2016;2016;05;21;Sunnuntai;13;10;23;3;3;6
109;08.05.2016;2016;05;22;Sunnuntai;2;9;11;0;5;5
109;08.05.2016;2016;05;23;Sunnuntai;0;1;1;1;1;2
109;09.05.2016;2016;05;00;Maanantai;1;0;1;0;0;0
109;09.05.2016;2016;05;01;Maanantai;1;0;1;0;0;0
109;09.05.2016;2016;05;02;Maanantai;0;0;0;0;0;0
109;09.05.2016;2016;05;03;Maanantai;0;0;0;0;0;0
109;09.05.2016;2016;05;04;Maanantai;1;0;1;2;0;2
109;09.05.2016;2016;05;05;Maanantai;5;13;18;2;0;2
109;09.05.2016;2016;05;06;Maanantai;42;12;54;2;1;3
109;09.05.2016;2016;05;07;Maanantai;111;40;151;7;7;14
109;09.05.2016;2016;05;08;Maanantai;88;22;110;3;4;7
109;09.05.2016;2016;05;09;Maanantai;26;11;37;2;1;3
109;09.05.2016;2016;05;10;Maanantai;26;9;35;3;1;4
109;09.05.2016;2016;05;11;Maanantai;19;22;41;1;2;3
109;09.05.2016;2016;05;12;Maanantai;14;14;28;4;0;4
109;09.05.2016;2016;05;13;Maanantai;15;23;38;5;6;11
109;09.05.2016;2016;05;14;Maanantai;21;38;59;4;1;5
109;09.05.2016;2016;05;15;Maanantai;42;77;119;4;3;7
109;09.05.2016;2016;05;16;Maanantai;55;117;172;6;5;11
109;09.05.2016;2016;05;17;Maanantai;34;46;80;3;4;7
109;09.05.2016;2016;05;18;Maanantai;18;26;44;4;2;6
109;09.05.2016;2016;05;19;Maanantai;31;12;43;4;6;10
109;09.05.2016;2016;05;20;Maanantai;6;18;24;4;7;11
109;09.05.2016;2016;05;21;Maanantai;8;10;18;1;3;4
109;09.05.2016;2016;05;22;Maanantai;10;6;16;2;1;3
109;09.05.2016;2016;05;23;Maanantai;2;5;7;0;0;0
109;10.05.2016;2016;05;00;Tiistai;0;3;3;1;0;1
109;10.05.2016;2016;05;01;Tiistai;1;0;1;0;0;0
109;10.05.2016;2016;05;02;Tiistai;0;0;0;0;0;0
109;10.05.2016;2016;05;03;Tiistai;0;0;0;0;0;0
109;10.05.2016;2016;05;04;Tiistai;0;0;0;0;0;0
109;10.05.2016;2016;05;05;Tiistai;2;10;12;1;0;1
109;10.05.2016;2016;05;06;Tiistai;25;12;37;0;3;3
109;10.05.2016;2016;05;07;Tiistai;47;24;71;4;3;7
109;10.05.2016;2016;05;08;Tiistai;40;11;51;1;1;2
109;10.05.2016;2016;05;09;Tiistai;9;7;16;1;1;2
109;10.05.2016;2016;05;10;Tiistai;13;1;14;4;1;5
109;10.05.2016;2016;05;11;Tiistai;6;6;12;1;3;4
109;10.05.2016;2016;05;12;Tiistai;18;5;23;3;3;6
109;10.05.2016;2016;05;13;Tiistai;10;11;21;1;1;2
109;10.05.2016;2016;05;14;Tiistai;16;21;37;4;1;5
109;10.05.2016;2016;05;15;Tiistai;21;33;54;5;0;5
109;10.05.2016;2016;05;16;Tiistai;25;39;64;6;4;10
109;10.05.2016;2016;05;17;Tiistai;19;23;42;3;5;8
109;10.05.2016;2016;05;18;Tiistai;13;23;36;4;4;8
109;10.05.2016;2016;05;19;Tiistai;13;9;22;9;6;15
109;10.05.2016;2016;05;20;Tiistai;7;15;22;8;4;12
109;10.05.2016;2016;05;21;Tiistai;2;15;17;2;1;3
109;10.05.2016;2016;05;22;Tiistai;6;5;11;1;3;4
109;10.05.2016;2016;05;23;Tiistai;0;2;2;0;0;0
109;11.05.2016;2016;05;00;Keskiviikko;1;0;1;0;0;0
109;11.05.2016;2016;05;01;Keskiviikko;0;0;0;0;0;0
109;11.05.2016;2016;05;02;Keskiviikko;0;0;0;0;0;0
109;11.05.2016;2016;05;03;Keskiviikko;0;0;0;0;0;0
109;11.05.2016;2016;05;04;Keskiviikko;1;0;1;0;0;0
109;11.05.2016;2016;05;05;Keskiviikko;3;9;12;1;0;1
109;11.05.2016;2016;05;06;Keskiviikko;35;18;53;1;3;4
109;11.05.2016;2016;05;07;Keskiviikko;99;27;126;4;5;9
109;11.05.2016;2016;05;08;Keskiviikko;80;25;105;2;1;3
109;11.05.2016;2016;05;09;Keskiviikko;41;10;51;7;1;8
109;11.05.2016;2016;05;10;Keskiviikko;11;10;21;5;2;7
109;11.05.2016;2016;05;11;Keskiviikko;14;11;25;1;4;5
109;11.05.2016;2016;05;12;Keskiviikko;21;12;33;0;2;2
109;11.05.2016;2016;05;13;Keskiviikko;17;27;44;2;4;6
109;11.05.2016;2016;05;14;Keskiviikko;25;34;59;9;5;14
109;11.05.2016;2016;05;15;Keskiviikko;23;66;89;5;5;10
109;11.05.2016;2016;05;16;Keskiviikko;49;92;141;7;9;16
109;11.05.2016;2016;05;17;Keskiviikko;23;51;74;4;1;5
109;11.05.2016;2016;05;18;Keskiviikko;23;19;42;4;3;7
109;11.05.2016;2016;05;19;Keskiviikko;19;24;43;4;5;9
109;11.05.2016;2016;05;20;Keskiviikko;9;18;27;4;3;7
109;11.05.2016;2016;05;21;Keskiviikko;6;11;17;0;3;3
109;11.05.2016;2016;05;22;Keskiviikko;6;3;9;1;2;3
109;11.05.2016;2016;05;23;Keskiviikko;5;4;9;0;1;1
109;12.05.2016;2016;05;00;Torstai;1;1;2;0;1;1
109;12.05.2016;2016;05;01;Torstai;0;2;2;0;0;0
109;12.05.2016;2016;05;02;Torstai;0;0;0;0;0;0
109;12.05.2016;2016;05;03;Torstai;0;2;2;0;0;0
109;12.05.2016;2016;05;04;Torstai;0;2;2;0;0;0
109;12.05.2016;2016;05;05;Torstai;3;6;9;1;0;1
109;12.05.2016;2016;05;06;Torstai;33;13;46;3;1;4
109;12.05.2016;2016;05;07;Torstai;95;41;136;10;7;17
109;12.05.2016;2016;05;08;Torstai;79;21;100;4;3;7
109;12.05.2016;2016;05;09;Torstai;22;18;40;3;1;4
109;12.05.2016;2016;05;10;Torstai;16;15;31;3;2;5
109;12.05.2016;2016;05;11;Torstai;20;15;35;9;4;13
109;12.05.2016;2016;05;12;Torstai;21;16;37;3;1;4
109;12.05.2016;2016;05;13;Torstai;14;19;33;2;4;6
109;12.05.2016;2016;05;14;Torstai;24;22;46;4;2;6
109;12.05.2016;2016;05;15;Torstai;43;53;96;5;5;10
109;12.05.2016;2016;05;16;Torstai;42;102;144;5;5;10
109;12.05.2016;2016;05;17;Torstai;27;35;62;2;6;8
109;12.05.2016;2016;05;18;Torstai;35;34;69;14;3;17
109;12.05.2016;2016;05;19;Torstai;21;16;37;6;3;9
109;12.05.2016;2016;05;20;Torstai;14;15;29;3;7;10
109;12.05.2016;2016;05;21;Torstai;14;17;31;1;1;2
109;12.05.2016;2016;05;22;Torstai;8;7;15;3;5;8
109;12.05.2016;2016;05;23;Torstai;3;5;8;1;1;2
109;13.05.2016;2016;05;00;Perjantai;0;0;0;1;0;1
109;13.05.2016;2016;05;01;Perjantai;1;0;1;0;0;0
109;13.05.2016;2016;05;02;Perjantai;0;0;0;0;0;0
109;13.05.2016;2016;05;03;Perjantai;0;1;1;0;0;0
109;13.05.2016;2016;05;04;Perjantai;1;2;3;0;0;0
109;13.05.2016;2016;05;05;Perjantai;2;6;8;1;1;2
109;13.05.2016;2016;05;06;Perjantai;28;12;40;0;2;2
109;13.05.2016;2016;05;07;Perjantai;67;25;92;4;6;10
109;13.05.2016;2016;05;08;Perjantai;65;18;83;4;3;7
109;13.05.2016;2016;05;09;Perjantai;30;7;37;4;0;4
109;13.05.2016;2016;05;10;Perjantai;14;15;29;1;2;3
109;13.05.2016;2016;05;11;Perjantai;22;16;38;7;2;9
109;13.05.2016;2016;05;12;Perjantai;20;15;35;3;2;5
109;13.05.2016;2016;05;13;Perjantai;19;13;32;3;2;5
109;13.05.2016;2016;05;14;Perjantai;22;31;53;3;3;6
109;13.05.2016;2016;05;15;Perjantai;29;58;87;5;5;10
109;13.05.2016;2016;05;16;Perjantai;30;46;76;3;3;6
109;13.05.2016;2016;05;17;Perjantai;15;23;38;2;2;4
109;13.05.2016;2016;05;18;Perjantai;14;16;30;2;4;6
109;13.05.2016;2016;05;19;Perjantai;12;10;22;5;3;8
109;13.05.2016;2016;05;20;Perjantai;7;13;20;4;1;5
109;13.05.2016;2016;05;21;Perjantai;5;8;13;5;2;7
109;13.05.2016;2016;05;22;Perjantai;4;4;8;2;0;2
109;13.05.2016;2016;05;23;Perjantai;3;3;6;0;0;0
109;14.05.2016;2016;05;00;Lauantai;4;2;6;0;1;1
109;14.05.2016;2016;05;01;Lauantai;2;1;3;0;0;0
109;14.05.2016;2016;05;02;Lauantai;0;0;0;0;0;0
109;14.05.2016;2016;05;03;Lauantai;0;0;0;1;0;1
109;14.05.2016;2016;05;04;Lauantai;0;1;1;0;0;0
109;14.05.2016;2016;05;05;Lauantai;2;3;5;0;1;1
109;14.05.2016;2016;05;06;Lauantai;8;3;11;0;0;0
109;14.05.2016;2016;05;07;Lauantai;4;3;7;1;2;3
109;14.05.2016;2016;05;08;Lauantai;7;4;11;2;0;2
109;14.05.2016;2016;05;09;Lauantai;9;4;13;2;1;3
109;14.05.2016;2016;05;10;Lauantai;5;9;14;5;5;10
109;14.05.2016;2016;05;11;Lauantai;13;4;17;6;8;14
109;14.05.2016;2016;05;12;Lauantai;10;8;18;11;5;16
109;14.05.2016;2016;05;13;Lauantai;14;12;26;2;3;5
109;14.05.2016;2016;05;14;Lauantai;13;12;25;1;2;3
109;14.05.2016;2016;05;15;Lauantai;7;8;15;3;5;8
109;14.05.2016;2016;05;16;Lauantai;7;15;22;7;1;8
109;14.05.2016;2016;05;17;Lauantai;11;10;21;3;2;5
109;14.05.2016;2016;05;18;Lauantai;8;12;20;7;1;8
109;14.05.2016;2016;05;19;Lauantai;4;5;9;2;2;4
109;14.05.2016;2016;05;20;Lauantai;7;3;10;5;2;7
109;14.05.2016;2016;05;21;Lauantai;6;3;9;2;3;5
109;14.05.2016;2016;05;22;Lauantai;4;7;11;1;0;1
109;14.05.2016;2016;05;23;Lauantai;2;5;7;0;0;0
109;15.05.2016;2016;05;00;Sunnuntai;0;3;3;0;0;0
109;15.05.2016;2016;05;01;Sunnuntai;1;3;4;1;1;2
109;15.05.2016;2016;05;02;Sunnuntai;0;0;0;0;2;2
109;15.05.2016;2016;05;03;Sunnuntai;0;2;2;0;1;1
109;15.05.2016;2016;05;04;Sunnuntai;0;0;0;0;0;0
109;15.05.2016;2016;05;05;Sunnuntai;1;0;1;0;0;0
109;15.05.2016;2016;05;06;Sunnuntai;2;3;5;0;1;1
109;15.05.2016;2016;05;07;Sunnuntai;0;4;4;2;3;5
109;15.05.2016;2016;05;08;Sunnuntai;8;3;11;5;0;5
109;15.05.2016;2016;05;09;Sunnuntai;11;4;15;3;2;5
109;15.05.2016;2016;05;10;Sunnuntai;11;3;14;4;4;8
109;15.05.2016;2016;05;11;Sunnuntai;6;5;11;4;2;6
109;15.05.2016;2016;05;12;Sunnuntai;15;14;29;7;4;11
109;15.05.2016;2016;05;13;Sunnuntai;13;9;22;6;2;8
109;15.05.2016;2016;05;14;Sunnuntai;7;8;15;5;2;7
109;15.05.2016;2016;05;15;Sunnuntai;9;13;22;4;1;5
109;15.05.2016;2016;05;16;Sunnuntai;7;3;10;6;2;8
109;15.05.2016;2016;05;17;Sunnuntai;5;8;13;5;5;10
109;15.05.2016;2016;05;18;Sunnuntai;13;4;17;3;2;5
109;15.05.2016;2016;05;19;Sunnuntai;11;11;22;5;5;10
109;15.05.2016;2016;05;20;Sunnuntai;3;10;13;7;3;10
109;15.05.2016;2016;05;21;Sunnuntai;2;6;8;1;5;6
109;15.05.2016;2016;05;22;Sunnuntai;1;3;4;1;1;2
109;15.05.2016;2016;05;23;Sunnuntai;0;1;1;1;0;1
109;16.05.2016;2016;05;00;Maanantai;1;0;1;1;0;1
109;16.05.2016;2016;05;01;Maanantai;0;1;1;0;0;0
109;16.05.2016;2016;05;02;Maanantai;0;0;0;1;1;2
109;16.05.2016;2016;05;03;Maanantai;0;0;0;1;0;1
109;16.05.2016;2016;05;04;Maanantai;0;1;1;0;0;0
109;16.05.2016;2016;05;05;Maanantai;5;9;14;0;0;0
109;16.05.2016;2016;05;06;Maanantai;41;17;58;0;4;4
109;16.05.2016;2016;05;07;Maanantai;83;40;123;2;8;10
109;16.05.2016;2016;05;08;Maanantai;88;30;118;4;1;5
109;16.05.2016;2016;05;09;Maanantai;17;13;30;6;3;9
109;16.05.2016;2016;05;10;Maanantai;20;6;26;3;3;6
109;16.05.2016;2016;05;11;Maanantai;21;17;38;6;2;8
109;16.05.2016;2016;05;12;Maanantai;19;9;28;7;5;12
109;16.05.2016;2016;05;13;Maanantai;18;22;40;3;2;5
109;16.05.2016;2016;05;14;Maanantai;28;24;52;4;5;9
109;16.05.2016;2016;05;15;Maanantai;32;71;103;1;4;5
109;16.05.2016;2016;05;16;Maanantai;44;98;142;8;5;13
109;16.05.2016;2016;05;17;Maanantai;37;35;72;9;4;13
109;16.05.2016;2016;05;18;Maanantai;24;26;50;9;4;13
109;16.05.2016;2016;05;19;Maanantai;19;20;39;9;9;18
109;16.05.2016;2016;05;20;Maanantai;10;13;23;6;5;11
109;16.05.2016;2016;05;21;Maanantai;11;23;34;2;5;7
109;16.05.2016;2016;05;22;Maanantai;6;3;9;2;3;5
109;16.05.2016;2016;05;23;Maanantai;0;2;2;1;0;1
109;17.05.2016;2016;05;00;Tiistai;2;0;2;1;0;1
109;17.05.2016;2016;05;01;Tiistai;2;3;5;0;0;0
109;17.05.2016;2016;05;02;Tiistai;0;0;0;0;0;0
109;17.05.2016;2016;05;03;Tiistai;0;0;0;0;1;1
109;17.05.2016;2016;05;04;Tiistai;0;1;1;0;0;0
109;17.05.2016;2016;05;05;Tiistai;1;8;9;2;1;3
109;17.05.2016;2016;05;06;Tiistai;26;17;43;2;2;4
109;17.05.2016;2016;05;07;Tiistai;63;29;92;3;3;6
109;17.05.2016;2016;05;08;Tiistai;60;18;78;3;2;5
109;17.05.2016;2016;05;09;Tiistai;11;6;17;1;1;2
109;17.05.2016;2016;05;10;Tiistai;7;6;13;2;2;4
109;17.05.2016;2016;05;11;Tiistai;9;1;10;2;1;3
109;17.05.2016;2016;05;12;Tiistai;10;3;13;2;2;4
109;17.05.2016;2016;05;13;Tiistai;9;11;20;1;3;4
109;17.05.2016;2016;05;14;Tiistai;15;14;29;1;1;2
109;17.05.2016;2016;05;15;Tiistai;25;40;65;10;4;14
109;17.05.2016;2016;05;16;Tiistai;34;61;95;6;6;12
109;17.05.2016;2016;05;17;Tiistai;19;25;44;0;5;5
109;17.05.2016;2016;05;18;Tiistai;10;14;24;8;4;12
109;17.05.2016;2016;05;19;Tiistai;13;13;26;6;6;12
109;17.05.2016;2016;05;20;Tiistai;12;10;22;5;3;8
109;17.05.2016;2016;05;21;Tiistai;4;8;12;3;2;5
109;17.05.2016;2016;05;22;Tiistai;5;4;9;3;2;5
109;17.05.2016;2016;05;23;Tiistai;2;6;8;1;0;1
109;18.05.2016;2016;05;00;Keskiviikko;0;2;2;0;0;0
109;18.05.2016;2016;05;01;Keskiviikko;0;1;1;0;0;0
109;18.05.2016;2016;05;02;Keskiviikko;0;0;0;0;0;0
109;18.05.2016;2016;05;03;Keskiviikko;0;0;0;0;0;0
109;18.05.2016;2016;05;04;Keskiviikko;2;0;2;0;0;0
109;18.05.2016;2016;05;05;Keskiviikko;1;7;8;2;0;2
109;18.05.2016;2016;05;06;Keskiviikko;40;16;56;1;2;3
109;18.05.2016;2016;05;07;Keskiviikko;101;41;142;6;7;13
109;18.05.2016;2016;05;08;Keskiviikko;79;33;112;5;4;9
109;18.05.2016;2016;05;09;Keskiviikko;40;13;53;3;3;6
109;18.05.2016;2016;05;10;Keskiviikko;18;13;31;6;2;8
109;18.05.2016;2016;05;11;Keskiviikko;22;19;41;4;2;6
109;18.05.2016;2016;05;12;Keskiviikko;19;18;37;8;2;10
109;18.05.2016;2016;05;13;Keskiviikko;5;24;29;0;3;3
109;18.05.2016;2016;05;14;Keskiviikko;19;26;45;3;1;4
109;18.05.2016;2016;05;15;Keskiviikko;30;52;82;7;2;9
109;18.05.2016;2016;05;16;Keskiviikko;29;85;114;2;2;4
109;18.05.2016;2016;05;17;Keskiviikko;25;32;57;1;2;3
109;18.05.2016;2016;05;18;Keskiviikko;17;25;42;3;0;3
109;18.05.2016;2016;05;19;Keskiviikko;5;5;10;2;1;3
109;18.05.2016;2016;05;20;Keskiviikko;6;8;14;3;2;5
109;18.05.2016;2016;05;21;Keskiviikko;5;10;15;1;3;4
109;18.05.2016;2016;05;22;Keskiviikko;3;2;5;1;1;2
109;18.05.2016;2016;05;23;Keskiviikko;1;0;1;1;0;1
109;19.05.2016;2016;05;00;Torstai;0;0;0;1;2;3
109;19.05.2016;2016;05;01;Torstai;0;1;1;0;0;0
109;19.05.2016;2016;05;02;Torstai;0;0;0;0;2;2
109;19.05.2016;2016;05;03;Torstai;0;0;0;0;1;1
109;19.05.2016;2016;05;04;Torstai;1;1;2;0;0;0
109;19.05.2016;2016;05;05;Torstai;1;7;8;1;1;2
109;19.05.2016;2016;05;06;Torstai;23;10;33;1;2;3
109;19.05.2016;2016;05;07;Torstai;61;26;87;2;5;7
109;19.05.2016;2016;05;08;Torstai;49;18;67;7;7;14
109;19.05.2016;2016;05;09;Torstai;16;4;20;9;2;11
109;19.05.2016;2016;05;10;Torstai;5;5;10;0;4;4
109;19.05.2016;2016;05;11;Torstai;14;8;22;3;2;5
109;19.05.2016;2016;05;12;Torstai;15;12;27;4;5;9
109;19.05.2016;2016;05;13;Torstai;7;23;30;1;2;3
109;19.05.2016;2016;05;14;Torstai;13;21;34;1;1;2
109;19.05.2016;2016;05;15;Torstai;25;48;73;6;6;12
109;19.05.2016;2016;05;16;Torstai;35;67;102;7;3;10
109;19.05.2016;2016;05;17;Torstai;15;23;38;1;0;1
109;19.05.2016;2016;05;18;Torstai;14;13;27;7;1;8
109;19.05.2016;2016;05;19;Torstai;9;16;25;5;11;16
109;19.05.2016;2016;05;20;Torstai;6;7;13;5;0;5
109;19.05.2016;2016;05;21;Torstai;6;11;17;3;2;5
109;19.05.2016;2016;05;22;Torstai;1;5;6;1;1;2
109;19.05.2016;2016;05;23;Torstai;2;2;4;2;0;2
109;20.05.2016;2016;05;00;Perjantai;0;0;0;1;1;2
109;20.05.2016;2016;05;01;Perjantai;0;2;2;1;1;2
109;20.05.2016;2016;05;02;Perjantai;0;0;0;0;0;0
109;20.05.2016;2016;05;03;Perjantai;0;1;1;0;0;0
109;20.05.2016;2016;05;04;Perjantai;1;1;2;0;0;0
109;20.05.2016;2016;05;05;Perjantai;1;6;7;2;0;2
109;20.05.2016;2016;05;06;Perjantai;33;16;49;4;6;10
109;20.05.2016;2016;05;07;Perjantai;84;34;118;4;6;10
109;20.05.2016;2016;05;08;Perjantai;63;25;88;6;3;9
109;20.05.2016;2016;05;09;Perjantai;35;8;43;1;3;4
109;20.05.2016;2016;05;10;Perjantai;12;11;23;1;3;4
109;20.05.2016;2016;05;11;Perjantai;20;19;39;5;6;11
109;20.05.2016;2016;05;12;Perjantai;21;11;32;2;3;5
109;20.05.2016;2016;05;13;Perjantai;16;28;44;3;1;4
109;20.05.2016;2016;05;14;Perjantai;25;44;69;6;3;9
109;20.05.2016;2016;05;15;Perjantai;38;70;108;3;2;5
109;20.05.2016;2016;05;16;Perjantai;37;53;90;6;9;15
109;20.05.2016;2016;05;17;Perjantai;26;25;51;2;3;5
109;20.05.2016;2016;05;18;Perjantai;16;17;33;7;1;8
109;20.05.2016;2016;05;19;Perjantai;20;23;43;4;4;8
109;20.05.2016;2016;05;20;Perjantai;18;4;22;7;4;11
109;20.05.2016;2016;05;21;Perjantai;8;12;20;5;1;6
109;20.05.2016;2016;05;22;Perjantai;11;8;19;2;0;2
109;20.05.2016;2016;05;23;Perjantai;1;3;4;0;0;0
109;21.05.2016;2016;05;00;Lauantai;1;4;5;2;3;5
109;21.05.2016;2016;05;01;Lauantai;2;5;7;0;0;0
109;21.05.2016;2016;05;02;Lauantai;4;3;7;0;9;9
109;21.05.2016;2016;05;03;Lauantai;6;9;15;8;2;10
109;21.05.2016;2016;05;04;Lauantai;4;5;9;12;6;18
109;21.05.2016;2016;05;05;Lauantai;2;2;4;0;0;0
109;21.05.2016;2016;05;06;Lauantai;6;7;13;0;0;0
109;21.05.2016;2016;05;07;Lauantai;4;5;9;0;1;1
109;21.05.2016;2016;05;08;Lauantai;16;8;24;4;2;6
109;21.05.2016;2016;05;09;Lauantai;8;10;18;1;4;5
109;21.05.2016;2016;05;10;Lauantai;19;14;33;5;0;5
109;21.05.2016;2016;05;11;Lauantai;21;13;34;6;4;10
109;21.05.2016;2016;05;12;Lauantai;26;10;36;10;1;11
109;21.05.2016;2016;05;13;Lauantai;23;24;47;4;1;5
109;21.05.2016;2016;05;14;Lauantai;25;11;36;2;0;2
109;21.05.2016;2016;05;15;Lauantai;12;39;51;5;2;7
109;21.05.2016;2016;05;16;Lauantai;8;15;23;0;4;4
109;21.05.2016;2016;05;17;Lauantai;9;22;31;3;1;4
109;21.05.2016;2016;05;18;Lauantai;11;9;20;0;1;1
109;21.05.2016;2016;05;19;Lauantai;14;9;23;7;1;8
109;21.05.2016;2016;05;20;Lauantai;13;3;16;5;0;5
109;21.05.2016;2016;05;21;Lauantai;5;7;12;3;2;5
109;21.05.2016;2016;05;22;Lauantai;1;4;5;0;0;0
109;21.05.2016;2016;05;23;Lauantai;3;2;5;0;0;0
109;22.05.2016;2016;05;00;Sunnuntai;1;1;2;1;0;1
109;22.05.2016;2016;05;01;Sunnuntai;0;2;2;0;0;0
109;22.05.2016;2016;05;02;Sunnuntai;0;0;0;1;0;1
109;22.05.2016;2016;05;03;Sunnuntai;1;0;1;0;0;0
109;22.05.2016;2016;05;04;Sunnuntai;0;2;2;0;0;0
109;22.05.2016;2016;05;05;Sunnuntai;0;0;0;0;1;1
109;22.05.2016;2016;05;06;Sunnuntai;9;2;11;0;0;0
109;22.05.2016;2016;05;07;Sunnuntai;3;6;9;1;1;2
109;22.05.2016;2016;05;08;Sunnuntai;4;3;7;2;1;3
109;22.05.2016;2016;05;09;Sunnuntai;8;1;9;1;3;4
109;22.05.2016;2016;05;10;Sunnuntai;8;5;13;2;4;6
109;22.05.2016;2016;05;11;Sunnuntai;9;2;11;9;4;13
109;22.05.2016;2016;05;12;Sunnuntai;12;13;25;4;3;7
109;22.05.2016;2016;05;13;Sunnuntai;21;12;33;5;1;6
109;22.05.2016;2016;05;14;Sunnuntai;18;15;33;12;5;17
109;22.05.2016;2016;05;15;Sunnuntai;39;24;63;8;5;13
109;22.05.2016;2016;05;16;Sunnuntai;25;18;43;4;5;9
109;22.05.2016;2016;05;17;Sunnuntai;16;19;35;10;3;13
109;22.05.2016;2016;05;18;Sunnuntai;28;14;42;11;7;18
109;22.05.2016;2016;05;19;Sunnuntai;13;25;38;11;3;14
109;22.05.2016;2016;05;20;Sunnuntai;13;9;22;4;2;6
109;22.05.2016;2016;05;21;Sunnuntai;7;4;11;3;1;4
109;22.05.2016;2016;05;22;Sunnuntai;3;2;5;2;2;4
109;22.05.2016;2016;05;23;Sunnuntai;4;8;12;0;0;0
109;23.05.2016;2016;05;00;Maanantai;1;1;2;0;0;0
109;23.05.2016;2016;05;01;Maanantai;0;4;4;0;0;0
109;23.05.2016;2016;05;02;Maanantai;0;0;0;0;0;0
109;23.05.2016;2016;05;03;Maanantai;0;1;1;0;0;0
109;23.05.2016;2016;05;04;Maanantai;1;0;1;1;0;1
109;23.05.2016;2016;05;05;Maanantai;1;9;10;1;2;3
109;23.05.2016;2016;05;06;Maanantai;39;19;58;3;1;4
109;23.05.2016;2016;05;07;Maanantai;106;38;144;6;3;9
109;23.05.2016;2016;05;08;Maanantai;94;45;139;7;2;9
109;23.05.2016;2016;05;09;Maanantai;38;6;44;2;6;8
109;23.05.2016;2016;05;10;Maanantai;24;18;42;4;0;4
109;23.05.2016;2016;05;11;Maanantai;22;15;37;5;5;10
109;23.05.2016;2016;05;12;Maanantai;26;25;51;7;3;10
109;23.05.2016;2016;05;13;Maanantai;25;26;51;3;4;7
109;23.05.2016;2016;05;14;Maanantai;25;31;56;4;2;6
109;23.05.2016;2016;05;15;Maanantai;36;76;112;6;9;15
109;23.05.2016;2016;05;16;Maanantai;74;105;179;4;5;9
109;23.05.2016;2016;05;17;Maanantai;47;46;93;4;5;9
109;23.05.2016;2016;05;18;Maanantai;29;43;72;7;8;15
109;23.05.2016;2016;05;19;Maanantai;17;44;61;4;6;10
109;23.05.2016;2016;05;20;Maanantai;21;18;39;7;5;12
109;23.05.2016;2016;05;21;Maanantai;10;13;23;3;2;5
109;23.05.2016;2016;05;22;Maanantai;9;9;18;0;1;1
109;23.05.2016;2016;05;23;Maanantai;0;1;1;0;0;0
109;24.05.2016;2016;05;00;Tiistai;1;0;1;0;0;0
109;24.05.2016;2016;05;01;Tiistai;0;3;3;0;0;0
109;24.05.2016;2016;05;02;Tiistai;0;1;1;0;0;0
109;24.05.2016;2016;05;03;Tiistai;0;0;0;0;0;0
109;24.05.2016;2016;05;04;Tiistai;0;1;1;0;0;0
109;24.05.2016;2016;05;05;Tiistai;3;10;13;2;0;2
109;24.05.2016;2016;05;06;Tiistai;42;16;58;1;2;3
109;24.05.2016;2016;05;07;Tiistai;99;37;136;6;4;10
109;24.05.2016;2016;05;08;Tiistai;83;23;106;6;4;10
109;24.05.2016;2016;05;09;Tiistai;34;16;50;2;5;7
109;24.05.2016;2016;05;10;Tiistai;20;13;33;3;3;6
109;24.05.2016;2016;05;11;Tiistai;20;14;34;0;4;4
109;24.05.2016;2016;05;12;Tiistai;22;21;43;3;2;5
109;24.05.2016;2016;05;13;Tiistai;14;26;40;1;4;5
109;24.05.2016;2016;05;14;Tiistai;25;38;63;5;6;11
109;24.05.2016;2016;05;15;Tiistai;34;65;99;7;6;13
109;24.05.2016;2016;05;16;Tiistai;39;88;127;5;3;8
109;24.05.2016;2016;05;17;Tiistai;16;31;47;1;4;5
109;24.05.2016;2016;05;18;Tiistai;11;13;24;4;5;9
109;24.05.2016;2016;05;19;Tiistai;4;12;16;3;4;7
109;24.05.2016;2016;05;20;Tiistai;6;15;21;7;5;12
109;24.05.2016;2016;05;21;Tiistai;3;14;17;2;2;4
109;24.05.2016;2016;05;22;Tiistai;8;8;16;4;1;5
109;24.05.2016;2016;05;23;Tiistai;2;0;2;0;1;1
109;25.05.2016;2016;05;00;Keskiviikko;2;1;3;0;0;0
109;25.05.2016;2016;05;01;Keskiviikko;0;1;1;0;0;0
109;25.05.2016;2016;05;02;Keskiviikko;0;1;1;0;0;0
109;25.05.2016;2016;05;03;Keskiviikko;0;0;0;0;0;0
109;25.05.2016;2016;05;04;Keskiviikko;1;1;2;0;0;0
109;25.05.2016;2016;05;05;Keskiviikko;2;8;10;0;1;1
109;25.05.2016;2016;05;06;Keskiviikko;35;12;47;0;2;2
109;25.05.2016;2016;05;07;Keskiviikko;67;34;101;8;7;15
109;25.05.2016;2016;05;08;Keskiviikko;66;19;85;5;3;8
109;25.05.2016;2016;05;09;Keskiviikko;20;4;24;1;0;1
109;25.05.2016;2016;05;10;Keskiviikko;11;6;17;1;3;4
109;25.05.2016;2016;05;11;Keskiviikko;12;11;23;3;4;7
109;25.05.2016;2016;05;12;Keskiviikko;15;11;26;2;0;2
109;25.05.2016;2016;05;13;Keskiviikko;8;19;27;0;0;0
109;25.05.2016;2016;05;14;Keskiviikko;18;31;49;0;3;3
109;25.05.2016;2016;05;15;Keskiviikko;23;49;72;3;3;6
109;25.05.2016;2016;05;16;Keskiviikko;33;67;100;5;6;11
109;25.05.2016;2016;05;17;Keskiviikko;22;28;50;5;0;5
109;25.05.2016;2016;05;18;Keskiviikko;13;19;32;3;2;5
109;25.05.2016;2016;05;19;Keskiviikko;6;7;13;10;6;16
109;25.05.2016;2016;05;20;Keskiviikko;13;15;28;5;5;10
109;25.05.2016;2016;05;21;Keskiviikko;6;7;13;4;2;6
109;25.05.2016;2016;05;22;Keskiviikko;7;6;13;1;0;1
109;25.05.2016;2016;05;23;Keskiviikko;0;3;3;1;0;1
109;26.05.2016;2016;05;00;Torstai;0;3;3;0;0;0
109;26.05.2016;2016;05;01;Torstai;1;1;2;0;0;0
109;26.05.2016;2016;05;02;Torstai;0;0;0;1;0;1
109;26.05.2016;2016;05;03;Torstai;0;0;0;0;0;0
109;26.05.2016;2016;05;04;Torstai;0;0;0;0;0;0
109;26.05.2016;2016;05;05;Torstai;4;8;12;2;1;3
109;26.05.2016;2016;05;06;Torstai;44;13;57;2;4;6
109;26.05.2016;2016;05;07;Torstai;93;32;125;1;3;4
109;26.05.2016;2016;05;08;Torstai;78;16;94;6;5;11
109;26.05.2016;2016;05;09;Torstai;26;15;41;4;2;6
109;26.05.2016;2016;05;10;Torstai;16;11;27;6;2;8
109;26.05.2016;2016;05;11;Torstai;18;17;35;9;3;12
109;26.05.2016;2016;05;12;Torstai;21;18;39;3;4;7
109;26.05.2016;2016;05;13;Torstai;20;24;44;2;4;6
109;26.05.2016;2016;05;14;Torstai;25;34;59;6;3;9
109;26.05.2016;2016;05;15;Torstai;29;68;97;7;4;11
109;26.05.2016;2016;05;16;Torstai;33;74;107;5;2;7
109;26.05.2016;2016;05;17;Torstai;28;38;66;4;2;6
109;26.05.2016;2016;05;18;Torstai;13;12;25;10;4;14
109;26.05.2016;2016;05;19;Torstai;13;22;35;8;9;17
109;26.05.2016;2016;05;20;Torstai;12;12;24;4;7;11
109;26.05.2016;2016;05;21;Torstai;11;17;28;3;3;6
109;26.05.2016;2016;05;22;Torstai;4;7;11;1;0;1
109;26.05.2016;2016;05;23;Torstai;3;3;6;0;0;0
109;27.05.2016;2016;05;00;Perjantai;1;1;2;1;0;1
109;27.05.2016;2016;05;01;Perjantai;0;0;0;0;0;0
109;27.05.2016;2016;05;02;Perjantai;0;0;0;0;1;1
109;27.05.2016;2016;05;03;Perjantai;0;1;1;1;0;1
109;27.05.2016;2016;05;04;Perjantai;1;1;2;0;0;0
109;27.05.2016;2016;05;05;Perjantai;1;10;11;2;0;2
109;27.05.2016;2016;05;06;Perjantai;31;23;54;1;1;2
109;27.05.2016;2016;05;07;Perjantai;83;26;109;3;4;7
109;27.05.2016;2016;05;08;Perjantai;72;27;99;6;6;12
109;27.05.2016;2016;05;09;Perjantai;21;13;34;0;2;2
109;27.05.2016;2016;05;10;Perjantai;21;12;33;4;1;5
109;27.05.2016;2016;05;11;Perjantai;24;14;38;5;1;6
109;27.05.2016;2016;05;12;Perjantai;25;19;44;5;4;9
109;27.05.2016;2016;05;13;Perjantai;17;32;49;4;1;5
109;27.05.2016;2016;05;14;Perjantai;32;48;80;4;3;7
109;27.05.2016;2016;05;15;Perjantai;37;65;102;3;3;6
109;27.05.2016;2016;05;16;Perjantai;37;63;100;8;3;11
109;27.05.2016;2016;05;17;Perjantai;28;29;57;2;3;5
109;27.05.2016;2016;05;18;Perjantai;16;22;38;7;3;10
109;27.05.2016;2016;05;19;Perjantai;26;14;40;4;2;6
109;27.05.2016;2016;05;20;Perjantai;18;11;29;5;4;9
109;27.05.2016;2016;05;21;Perjantai;28;20;48;1;5;6
109;27.05.2016;2016;05;22;Perjantai;13;4;17;2;3;5
109;27.05.2016;2016;05;23;Perjantai;3;7;10;0;1;1
109;28.05.2016;2016;05;00;Lauantai;5;7;12;1;1;2
109;28.05.2016;2016;05;01;Lauantai;0;3;3;0;0;0
109;28.05.2016;2016;05;02;Lauantai;0;7;7;2;0;2
109;28.05.2016;2016;05;03;Lauantai;0;2;2;0;1;1
109;28.05.2016;2016;05;04;Lauantai;2;7;9;0;0;0
109;28.05.2016;2016;05;05;Lauantai;3;4;7;0;2;2
109;28.05.2016;2016;05;06;Lauantai;12;4;16;3;0;3
109;28.05.2016;2016;05;07;Lauantai;3;2;5;0;2;2
109;28.05.2016;2016;05;08;Lauantai;8;3;11;4;2;6
109;28.05.2016;2016;05;09;Lauantai;11;11;22;3;5;8
109;28.05.2016;2016;05;10;Lauantai;18;11;29;3;3;6
109;28.05.2016;2016;05;11;Lauantai;33;16;49;3;1;4
109;28.05.2016;2016;05;12;Lauantai;45;10;55;2;1;3
109;28.05.2016;2016;05;13;Lauantai;12;31;43;3;5;8
109;28.05.2016;2016;05;14;Lauantai;27;16;43;7;2;9
109;28.05.2016;2016;05;15;Lauantai;34;25;59;8;8;16
109;28.05.2016;2016;05;16;Lauantai;27;19;46;3;3;6
109;28.05.2016;2016;05;17;Lauantai;27;27;54;2;2;4
109;28.05.2016;2016;05;18;Lauantai;19;18;37;3;3;6
109;28.05.2016;2016;05;19;Lauantai;22;21;43;3;9;12
109;28.05.2016;2016;05;20;Lauantai;14;16;30;4;2;6
109;28.05.2016;2016;05;21;Lauantai;16;22;38;0;1;1
109;28.05.2016;2016;05;22;Lauantai;2;7;9;1;1;2
109;28.05.2016;2016;05;23;Lauantai;8;5;13;0;0;0
109;29.05.2016;2016;05;00;Sunnuntai;7;7;14;2;0;2
109;29.05.2016;2016;05;01;Sunnuntai;4;6;10;0;2;2
109;29.05.2016;2016;05;02;Sunnuntai;0;2;2;0;1;1
109;29.05.2016;2016;05;03;Sunnuntai;1;5;6;0;0;0
109;29.05.2016;2016;05;04;Sunnuntai;0;7;7;0;0;0
109;29.05.2016;2016;05;05;Sunnuntai;0;1;1;1;1;2
109;29.05.2016;2016;05;06;Sunnuntai;8;3;11;3;1;4
109;29.05.2016;2016;05;07;Sunnuntai;1;9;10;3;2;5
109;29.05.2016;2016;05;08;Sunnuntai;9;2;11;3;1;4
109;29.05.2016;2016;05;09;Sunnuntai;14;7;21;6;3;9
109;29.05.2016;2016;05;10;Sunnuntai;15;12;27;4;3;7
109;29.05.2016;2016;05;11;Sunnuntai;39;11;50;6;4;10
109;29.05.2016;2016;05;12;Sunnuntai;49;17;66;4;0;4
109;29.05.2016;2016;05;13;Sunnuntai;33;21;54;8;2;10
109;29.05.2016;2016;05;14;Sunnuntai;35;24;59;7;7;14
109;29.05.2016;2016;05;15;Sunnuntai;48;18;66;7;6;13
109;29.05.2016;2016;05;16;Sunnuntai;24;18;42;4;6;10
109;29.05.2016;2016;05;17;Sunnuntai;41;24;65;5;7;12
109;29.05.2016;2016;05;18;Sunnuntai;26;45;71;5;5;10
109;29.05.2016;2016;05;19;Sunnuntai;20;20;40;8;4;12
109;29.05.2016;2016;05;20;Sunnuntai;14;28;42;6;6;12
109;29.05.2016;2016;05;21;Sunnuntai;6;10;16;3;5;8
109;29.05.2016;2016;05;22;Sunnuntai;2;4;6;0;3;3
109;29.05.2016;2016;05;23;Sunnuntai;1;3;4;0;0;0
109;30.05.2016;2016;05;00;Maanantai;0;1;1;0;1;1
109;30.05.2016;2016;05;01;Maanantai;0;0;0;0;0;0
109;30.05.2016;2016;05;02;Maanantai;0;1;1;0;1;1
109;30.05.2016;2016;05;03;Maanantai;0;0;0;0;0;0
109;30.05.2016;2016;05;04;Maanantai;0;0;0;2;0;2
109;30.05.2016;2016;05;05;Maanantai;4;14;18;1;0;1
109;30.05.2016;2016;05;06;Maanantai;47;18;65;1;2;3
109;30.05.2016;2016;05;07;Maanantai;121;45;166;4;3;7
109;30.05.2016;2016;05;08;Maanantai;96;26;122;6;2;8
109;30.05.2016;2016;05;09;Maanantai;30;10;40;3;2;5
109;30.05.2016;2016;05;10;Maanantai;16;8;24;5;2;7
109;30.05.2016;2016;05;11;Maanantai;21;18;39;3;5;8
109;30.05.2016;2016;05;12;Maanantai;40;13;53;6;0;6
109;30.05.2016;2016;05;13;Maanantai;27;30;57;5;3;8
109;30.05.2016;2016;05;14;Maanantai;36;40;76;8;3;11
109;30.05.2016;2016;05;15;Maanantai;61;73;134;7;5;12
109;30.05.2016;2016;05;16;Maanantai;61;129;190;1;1;2
109;30.05.2016;2016;05;17;Maanantai;48;36;84;8;4;12
109;30.05.2016;2016;05;18;Maanantai;37;33;70;5;1;6
109;30.05.2016;2016;05;19;Maanantai;34;37;71;6;9;15
109;30.05.2016;2016;05;20;Maanantai;20;22;42;5;5;10
109;30.05.2016;2016;05;21;Maanantai;11;30;41;3;2;5
109;30.05.2016;2016;05;22;Maanantai;10;8;18;1;3;4
109;30.05.2016;2016;05;23;Maanantai;1;0;1;0;0;0
109;31.05.2016;2016;05;00;Tiistai;0;3;3;0;1;1
109;31.05.2016;2016;05;01;Tiistai;6;2;8;0;0;0
109;31.05.2016;2016;05;02;Tiistai;2;0;2;1;2;3
109;31.05.2016;2016;05;03;Tiistai;0;4;4;0;0;0
109;31.05.2016;2016;05;04;Tiistai;0;0;0;0;0;0
109;31.05.2016;2016;05;05;Tiistai;4;19;23;1;1;2
109;31.05.2016;2016;05;06;Tiistai;43;18;61;1;1;2
109;31.05.2016;2016;05;07;Tiistai;112;50;162;3;4;7
109;31.05.2016;2016;05;08;Tiistai;92;24;116;6;2;8
109;31.05.2016;2016;05;09;Tiistai;58;18;76;5;1;6
109;31.05.2016;2016;05;10;Tiistai;20;15;35;4;4;8
109;31.05.2016;2016;05;11;Tiistai;24;25;49;7;3;10
109;31.05.2016;2016;05;12;Tiistai;19;20;39;3;1;4
109;31.05.2016;2016;05;13;Tiistai;28;31;59;5;4;9
109;31.05.2016;2016;05;14;Tiistai;40;48;88;6;6;12
109;31.05.2016;2016;05;15;Tiistai;55;76;131;5;4;9
109;31.05.2016;2016;05;16;Tiistai;72;93;165;4;1;5
109;31.05.2016;2016;05;17;Tiistai;40;49;89;4;3;7
109;31.05.2016;2016;05;18;Tiistai;34;36;70;3;5;8
109;31.05.2016;2016;05;19;Tiistai;24;38;62;10;7;17
109;31.05.2016;2016;05;20;Tiistai;8;32;40;6;7;13
109;31.05.2016;2016;05;21;Tiistai;12;27;39;2;7;9
109;31.05.2016;2016;05;22;Tiistai;11;8;19;3;0;3
109;31.05.2016;2016;05;23;Tiistai;1;5;6;0;0;0
109;01.06.2016;2016;06;00;Keskiviikko;1;0;1;0;1;1
109;01.06.2016;2016;06;01;Keskiviikko;1;2;3;0;0;0
109;01.06.2016;2016;06;02;Keskiviikko;0;1;1;0;0;0
109;01.06.2016;2016;06;03;Keskiviikko;0;1;1;0;0;0
109;01.06.2016;2016;06;04;Keskiviikko;0;3;3;0;0;0
109;01.06.2016;2016;06;05;Keskiviikko;2;11;13;5;1;6
109;01.06.2016;2016;06;06;Keskiviikko;42;11;53;3;1;4
109;01.06.2016;2016;06;07;Keskiviikko;110;46;156;4;6;10
109;01.06.2016;2016;06;08;Keskiviikko;87;27;114;7;4;11
109;01.06.2016;2016;06;09;Keskiviikko;28;15;43;4;6;10
109;01.06.2016;2016;06;10;Keskiviikko;11;10;21;4;2;6
109;01.06.2016;2016;06;11;Keskiviikko;13;12;25;4;1;5
109;01.06.2016;2016;06;12;Keskiviikko;18;10;28;1;1;2
109;01.06.2016;2016;06;13;Keskiviikko;28;17;45;14;2;16
109;01.06.2016;2016;06;14;Keskiviikko;23;50;73;3;6;9
109;01.06.2016;2016;06;15;Keskiviikko;29;60;89;7;4;11
109;01.06.2016;2016;06;16;Keskiviikko;54;93;147;4;3;7
109;01.06.2016;2016;06;17;Keskiviikko;40;45;85;4;2;6
109;01.06.2016;2016;06;18;Keskiviikko;36;28;64;9;1;10
109;01.06.2016;2016;06;19;Keskiviikko;31;20;51;6;6;12
109;01.06.2016;2016;06;20;Keskiviikko;17;19;36;8;4;12
109;01.06.2016;2016;06;21;Keskiviikko;15;23;38;3;4;7
109;01.06.2016;2016;06;22;Keskiviikko;6;7;13;0;2;2
109;01.06.2016;2016;06;23;Keskiviikko;1;3;4;0;2;2
109;02.06.2016;2016;06;00;Torstai;1;2;3;1;0;1
109;02.06.2016;2016;06;01;Torstai;0;2;2;0;0;0
109;02.06.2016;2016;06;02;Torstai;3;0;3;2;0;2
109;02.06.2016;2016;06;03;Torstai;0;3;3;0;2;2
109;02.06.2016;2016;06;04;Torstai;1;0;1;1;1;2
109;02.06.2016;2016;06;05;Torstai;2;11;13;0;1;1
109;02.06.2016;2016;06;06;Torstai;48;18;66;5;5;10
109;02.06.2016;2016;06;07;Torstai;110;46;156;3;4;7
109;02.06.2016;2016;06;08;Torstai;83;32;115;1;1;2
109;02.06.2016;2016;06;09;Torstai;26;12;38;4;5;9
109;02.06.2016;2016;06;10;Torstai;9;6;15;10;3;13
109;02.06.2016;2016;06;11;Torstai;18;22;40;4;3;7
109;02.06.2016;2016;06;12;Torstai;27;16;43;4;6;10
109;02.06.2016;2016;06;13;Torstai;31;33;64;5;6;11
109;02.06.2016;2016;06;14;Torstai;35;34;69;8;6;14
109;02.06.2016;2016;06;15;Torstai;44;71;115;5;9;14
109;02.06.2016;2016;06;16;Torstai;63;100;163;4;1;5
109;02.06.2016;2016;06;17;Torstai;32;45;77;11;3;14
109;02.06.2016;2016;06;18;Torstai;27;33;60;3;5;8
109;02.06.2016;2016;06;19;Torstai;19;30;49;6;5;11
109;02.06.2016;2016;06;20;Torstai;22;19;41;5;6;11
109;02.06.2016;2016;06;21;Torstai;11;17;28;1;6;7
109;02.06.2016;2016;06;22;Torstai;6;15;21;1;1;2
109;02.06.2016;2016;06;23;Torstai;1;2;3;0;0;0
109;03.06.2016;2016;06;00;Perjantai;0;3;3;0;0;0
109;03.06.2016;2016;06;01;Perjantai;0;4;4;0;2;2
109;03.06.2016;2016;06;02;Perjantai;1;0;1;0;0;0
109;03.06.2016;2016;06;03;Perjantai;0;0;0;0;0;0
109;03.06.2016;2016;06;04;Perjantai;1;1;2;1;0;1
109;03.06.2016;2016;06;05;Perjantai;2;7;9;1;2;3
109;03.06.2016;2016;06;06;Perjantai;20;16;36;0;2;2
109;03.06.2016;2016;06;07;Perjantai;61;26;87;5;3;8
109;03.06.2016;2016;06;08;Perjantai;66;29;95;2;3;5
109;03.06.2016;2016;06;09;Perjantai;33;8;41;3;4;7
109;03.06.2016;2016;06;10;Perjantai;11;12;23;7;3;10
109;03.06.2016;2016;06;11;Perjantai;23;16;39;1;4;5
109;03.06.2016;2016;06;12;Perjantai;30;24;54;5;1;6
109;03.06.2016;2016;06;13;Perjantai;40;18;58;2;7;9
109;03.06.2016;2016;06;14;Perjantai;17;30;47;2;2;4
109;03.06.2016;2016;06;15;Perjantai;35;55;90;2;3;5
109;03.06.2016;2016;06;16;Perjantai;31;56;87;5;4;9
109;03.06.2016;2016;06;17;Perjantai;34;26;60;4;4;8
109;03.06.2016;2016;06;18;Perjantai;13;23;36;1;2;3
109;03.06.2016;2016;06;19;Perjantai;13;13;26;1;0;1
109;03.06.2016;2016;06;20;Perjantai;13;16;29;7;5;12
109;03.06.2016;2016;06;21;Perjantai;13;14;27;2;4;6
109;03.06.2016;2016;06;22;Perjantai;5;9;14;2;1;3
109;03.06.2016;2016;06;23;Perjantai;4;6;10;1;0;1
109;04.06.2016;2016;06;00;Lauantai;0;2;2;0;0;0
109;04.06.2016;2016;06;01;Lauantai;1;4;5;0;1;1
109;04.06.2016;2016;06;02;Lauantai;0;2;2;0;1;1
109;04.06.2016;2016;06;03;Lauantai;0;3;3;0;1;1
109;04.06.2016;2016;06;04;Lauantai;2;1;3;0;0;0
109;04.06.2016;2016;06;05;Lauantai;2;0;2;0;0;0
109;04.06.2016;2016;06;06;Lauantai;8;3;11;2;1;3
109;04.06.2016;2016;06;07;Lauantai;8;2;10;2;4;6
109;04.06.2016;2016;06;08;Lauantai;13;1;14;6;1;7
109;04.06.2016;2016;06;09;Lauantai;9;13;22;2;3;5
109;04.06.2016;2016;06;10;Lauantai;8;7;15;5;0;5
109;04.06.2016;2016;06;11;Lauantai;7;7;14;4;2;6
109;04.06.2016;2016;06;12;Lauantai;9;8;17;5;2;7
109;04.06.2016;2016;06;13;Lauantai;9;9;18;2;2;4
109;04.06.2016;2016;06;14;Lauantai;4;4;8;1;2;3
109;04.06.2016;2016;06;15;Lauantai;11;16;27;5;1;6
109;04.06.2016;2016;06;16;Lauantai;12;15;27;1;4;5
109;04.06.2016;2016;06;17;Lauantai;15;8;23;3;3;6
109;04.06.2016;2016;06;18;Lauantai;9;11;20;0;1;1
109;04.06.2016;2016;06;19;Lauantai;18;10;28;2;2;4
109;04.06.2016;2016;06;20;Lauantai;8;12;20;3;2;5
109;04.06.2016;2016;06;21;Lauantai;5;6;11;4;3;7
109;04.06.2016;2016;06;22;Lauantai;4;4;8;2;1;3
109;04.06.2016;2016;06;23;Lauantai;4;2;6;2;0;2
109;05.06.2016;2016;06;00;Sunnuntai;0;2;2;1;0;1
109;05.06.2016;2016;06;01;Sunnuntai;0;4;4;2;2;4
109;05.06.2016;2016;06;02;Sunnuntai;0;4;4;0;0;0
109;05.06.2016;2016;06;03;Sunnuntai;1;5;6;1;0;1
109;05.06.2016;2016;06;04;Sunnuntai;1;4;5;0;1;1
109;05.06.2016;2016;06;05;Sunnuntai;2;1;3;0;0;0
109;05.06.2016;2016;06;06;Sunnuntai;3;2;5;0;0;0
109;05.06.2016;2016;06;07;Sunnuntai;1;2;3;2;5;7
109;05.06.2016;2016;06;08;Sunnuntai;2;3;5;2;1;3
109;05.06.2016;2016;06;09;Sunnuntai;6;4;10;3;1;4
109;05.06.2016;2016;06;10;Sunnuntai;6;7;13;4;5;9
109;05.06.2016;2016;06;11;Sunnuntai;13;6;19;7;3;10
109;05.06.2016;2016;06;12;Sunnuntai;19;9;28;5;4;9
109;05.06.2016;2016;06;13;Sunnuntai;21;17;38;4;3;7
109;05.06.2016;2016;06;14;Sunnuntai;6;15;21;2;0;2
109;05.06.2016;2016;06;15;Sunnuntai;17;11;28;3;4;7
109;05.06.2016;2016;06;16;Sunnuntai;13;11;24;2;2;4
109;05.06.2016;2016;06;17;Sunnuntai;14;21;35;7;2;9
109;05.06.2016;2016;06;18;Sunnuntai;15;15;30;2;4;6
109;05.06.2016;2016;06;19;Sunnuntai;13;14;27;6;3;9
109;05.06.2016;2016;06;20;Sunnuntai;9;8;17;6;9;15
109;05.06.2016;2016;06;21;Sunnuntai;10;10;20;1;0;1
109;05.06.2016;2016;06;22;Sunnuntai;3;8;11;0;0;0
109;05.06.2016;2016;06;23;Sunnuntai;2;1;3;0;1;1
109;06.06.2016;2016;06;00;Maanantai;0;0;0;0;0;0
109;06.06.2016;2016;06;01;Maanantai;0;0;0;0;1;1
109;06.06.2016;2016;06;02;Maanantai;0;0;0;0;0;0
109;06.06.2016;2016;06;03;Maanantai;0;0;0;1;0;1
109;06.06.2016;2016;06;04;Maanantai;1;2;3;0;0;0
109;06.06.2016;2016;06;05;Maanantai;0;11;11;4;1;5
109;06.06.2016;2016;06;06;Maanantai;32;15;47;2;1;3
109;06.06.2016;2016;06;07;Maanantai;83;33;116;4;3;7
109;06.06.2016;2016;06;08;Maanantai;63;28;91;3;5;8
109;06.06.2016;2016;06;09;Maanantai;20;14;34;2;6;8
109;06.06.2016;2016;06;10;Maanantai;18;16;34;3;0;3
109;06.06.2016;2016;06;11;Maanantai;23;8;31;2;1;3
109;06.06.2016;2016;06;12;Maanantai;22;14;36;1;0;1
109;06.06.2016;2016;06;13;Maanantai;9;19;28;4;4;8
109;06.06.2016;2016;06;14;Maanantai;20;24;44;3;6;9
109;06.06.2016;2016;06;15;Maanantai;35;45;80;3;1;4
109;06.06.2016;2016;06;16;Maanantai;55;103;158;4;5;9
109;06.06.2016;2016;06;17;Maanantai;42;40;82;7;4;11
109;06.06.2016;2016;06;18;Maanantai;22;31;53;7;5;12
109;06.06.2016;2016;06;19;Maanantai;13;18;31;6;5;11
109;06.06.2016;2016;06;20;Maanantai;14;13;27;9;5;14
109;06.06.2016;2016;06;21;Maanantai;9;14;23;8;3;11
109;06.06.2016;2016;06;22;Maanantai;3;8;11;1;1;2
109;06.06.2016;2016;06;23;Maanantai;5;3;8;1;1;2
109;07.06.2016;2016;06;00;Tiistai;1;1;2;0;1;1
109;07.06.2016;2016;06;01;Tiistai;0;0;0;0;0;0
109;07.06.2016;2016;06;02;Tiistai;0;0;0;0;0;0
109;07.06.2016;2016;06;03;Tiistai;1;1;2;0;0;0
109;07.06.2016;2016;06;04;Tiistai;0;2;2;0;1;1
109;07.06.2016;2016;06;05;Tiistai;4;11;15;1;2;3
109;07.06.2016;2016;06;06;Tiistai;31;20;51;3;2;5
109;07.06.2016;2016;06;07;Tiistai;95;43;138;7;1;8
109;07.06.2016;2016;06;08;Tiistai;64;30;94;3;4;7
109;07.06.2016;2016;06;09;Tiistai;17;14;31;1;3;4
109;07.06.2016;2016;06;10;Tiistai;16;8;24;2;3;5
109;07.06.2016;2016;06;11;Tiistai;12;9;21;5;6;11
109;07.06.2016;2016;06;12;Tiistai;28;21;49;3;5;8
109;07.06.2016;2016;06;13;Tiistai;28;20;48;2;5;7
109;07.06.2016;2016;06;14;Tiistai;20;21;41;1;2;3
109;07.06.2016;2016;06;15;Tiistai;35;65;100;6;2;8
109;07.06.2016;2016;06;16;Tiistai;52;93;145;2;6;8
109;07.06.2016;2016;06;17;Tiistai;30;27;57;9;3;12
109;07.06.2016;2016;06;18;Tiistai;34;33;67;4;3;7
109;07.06.2016;2016;06;19;Tiistai;23;12;35;14;4;18
109;07.06.2016;2016;06;20;Tiistai;10;16;26;8;8;16
109;07.06.2016;2016;06;21;Tiistai;10;13;23;5;1;6
109;07.06.2016;2016;06;22;Tiistai;6;3;9;2;1;3
109;07.06.2016;2016;06;23;Tiistai;2;3;5;1;1;2
109;08.06.2016;2016;06;00;Keskiviikko;4;1;5;0;1;1
109;08.06.2016;2016;06;01;Keskiviikko;0;1;1;0;0;0
109;08.06.2016;2016;06;02;Keskiviikko;1;0;1;0;0;0
109;08.06.2016;2016;06;03;Keskiviikko;0;0;0;0;0;0
109;08.06.2016;2016;06;04;Keskiviikko;0;0;0;0;0;0
109;08.06.2016;2016;06;05;Keskiviikko;3;6;9;0;1;1
109;08.06.2016;2016;06;06;Keskiviikko;13;9;22;4;1;5
109;08.06.2016;2016;06;07;Keskiviikko;39;20;59;2;4;6
109;08.06.2016;2016;06;08;Keskiviikko;31;17;48;4;1;5
109;08.06.2016;2016;06;09;Keskiviikko;16;5;21;2;6;8
109;08.06.2016;2016;06;10;Keskiviikko;11;1;12;3;2;5
109;08.06.2016;2016;06;11;Keskiviikko;9;8;17;2;0;2
109;08.06.2016;2016;06;12;Keskiviikko;5;4;9;0;3;3
109;08.06.2016;2016;06;13;Keskiviikko;8;8;16;2;3;5
109;08.06.2016;2016;06;14;Keskiviikko;7;11;18;1;0;1
109;08.06.2016;2016;06;15;Keskiviikko;18;22;40;2;1;3
109;08.06.2016;2016;06;16;Keskiviikko;19;32;51;1;3;4
109;08.06.2016;2016;06;17;Keskiviikko;8;12;20;2;5;7
109;08.06.2016;2016;06;18;Keskiviikko;6;9;15;0;3;3
109;08.06.2016;2016;06;19;Keskiviikko;6;8;14;3;2;5
109;08.06.2016;2016;06;20;Keskiviikko;3;4;7;4;3;7
109;08.06.2016;2016;06;21;Keskiviikko;2;7;9;3;2;5
109;08.06.2016;2016;06;22;Keskiviikko;4;2;6;0;1;1
109;08.06.2016;2016;06;23;Keskiviikko;0;0;0;0;1;1
109;09.06.2016;2016;06;00;Torstai;2;0;2;0;0;0
109;09.06.2016;2016;06;01;Torstai;1;1;2;0;0;0
109;09.06.2016;2016;06;02;Torstai;0;0;0;0;0;0
109;09.06.2016;2016;06;03;Torstai;0;1;1;0;0;0
109;09.06.2016;2016;06;04;Torstai;0;3;3;0;0;0
109;09.06.2016;2016;06;05;Torstai;1;9;10;1;0;1
109;09.06.2016;2016;06;06;Torstai;20;11;31;7;2;9
109;09.06.2016;2016;06;07;Torstai;47;29;76;5;1;6
109;09.06.2016;2016;06;08;Torstai;34;18;52;2;1;3
109;09.06.2016;2016;06;09;Torstai;11;7;18;3;1;4
109;09.06.2016;2016;06;10;Torstai;9;6;15;3;4;7
109;09.06.2016;2016;06;11;Torstai;7;9;16;7;1;8
109;09.06.2016;2016;06;12;Torstai;19;8;27;8;6;14
109;09.06.2016;2016;06;13;Torstai;13;9;22;2;4;6
109;09.06.2016;2016;06;14;Torstai;10;17;27;2;3;5
109;09.06.2016;2016;06;15;Torstai;23;31;54;3;4;7
109;09.06.2016;2016;06;16;Torstai;41;58;99;7;6;13
109;09.06.2016;2016;06;17;Torstai;22;17;39;2;1;3
109;09.06.2016;2016;06;18;Torstai;18;27;45;4;2;6
109;09.06.2016;2016;06;19;Torstai;14;12;26;5;6;11
109;09.06.2016;2016;06;20;Torstai;12;15;27;5;4;9
109;09.06.2016;2016;06;21;Torstai;9;13;22;2;2;4
109;09.06.2016;2016;06;22;Torstai;6;7;13;0;1;1
109;09.06.2016;2016;06;23;Torstai;2;2;4;0;0;0
109;10.06.2016;2016;06;00;Perjantai;0;0;0;1;1;2
109;10.06.2016;2016;06;01;Perjantai;0;0;0;0;1;1
109;10.06.2016;2016;06;02;Perjantai;0;0;0;0;0;0
109;10.06.2016;2016;06;03;Perjantai;0;0;0;0;0;0
109;10.06.2016;2016;06;04;Perjantai;0;0;0;0;0;0
109;10.06.2016;2016;06;05;Perjantai;1;9;10;1;1;2
109;10.06.2016;2016;06;06;Perjantai;20;11;31;1;2;3
109;10.06.2016;2016;06;07;Perjantai;65;29;94;4;4;8
109;10.06.2016;2016;06;08;Perjantai;43;19;62;1;4;5
109;10.06.2016;2016;06;09;Perjantai;13;9;22;0;1;1
109;10.06.2016;2016;06;10;Perjantai;10;13;23;0;3;3
109;10.06.2016;2016;06;11;Perjantai;21;8;29;3;2;5
109;10.06.2016;2016;06;12;Perjantai;13;9;22;7;2;9
109;10.06.2016;2016;06;13;Perjantai;13;16;29;1;2;3
109;10.06.2016;2016;06;14;Perjantai;24;20;44;4;4;8
109;10.06.2016;2016;06;15;Perjantai;24;34;58;4;3;7
109;10.06.2016;2016;06;16;Perjantai;22;49;71;4;1;5
109;10.06.2016;2016;06;17;Perjantai;13;21;34;5;1;6
109;10.06.2016;2016;06;18;Perjantai;12;15;27;2;6;8
109;10.06.2016;2016;06;19;Perjantai;14;11;25;5;5;10
109;10.06.2016;2016;06;20;Perjantai;13;12;25;7;3;10
109;10.06.2016;2016;06;21;Perjantai;10;9;19;2;4;6
109;10.06.2016;2016;06;22;Perjantai;7;9;16;0;1;1
109;10.06.2016;2016;06;23;Perjantai;2;6;8;6;3;9
109;11.06.2016;2016;06;00;Lauantai;1;0;1;0;0;0
109;11.06.2016;2016;06;01;Lauantai;4;1;5;0;0;0
109;11.06.2016;2016;06;02;Lauantai;2;1;3;0;0;0
109;11.06.2016;2016;06;03;Lauantai;0;4;4;0;1;1
109;11.06.2016;2016;06;04;Lauantai;1;5;6;0;0;0
109;11.06.2016;2016;06;05;Lauantai;0;0;0;0;1;1
109;11.06.2016;2016;06;06;Lauantai;8;2;10;1;0;1
109;11.06.2016;2016;06;07;Lauantai;2;5;7;0;3;3
109;11.06.2016;2016;06;08;Lauantai;7;0;7;2;1;3
109;11.06.2016;2016;06;09;Lauantai;6;5;11;2;4;6
109;11.06.2016;2016;06;10;Lauantai;10;7;17;1;1;2
109;11.06.2016;2016;06;11;Lauantai;9;12;21;3;3;6
109;11.06.2016;2016;06;12;Lauantai;15;9;24;2;1;3
109;11.06.2016;2016;06;13;Lauantai;14;9;23;3;2;5
109;11.06.2016;2016;06;14;Lauantai;10;11;21;4;0;4
109;11.06.2016;2016;06;15;Lauantai;11;8;19;2;4;6
109;11.06.2016;2016;06;16;Lauantai;15;7;22;5;3;8
109;11.06.2016;2016;06;17;Lauantai;15;12;27;4;4;8
109;11.06.2016;2016;06;18;Lauantai;16;11;27;7;3;10
109;11.06.2016;2016;06;19;Lauantai;12;8;20;3;3;6
109;11.06.2016;2016;06;20;Lauantai;15;5;20;7;5;12
109;11.06.2016;2016;06;21;Lauantai;3;9;12;2;3;5
109;11.06.2016;2016;06;22;Lauantai;6;8;14;0;0;0
109;11.06.2016;2016;06;23;Lauantai;1;1;2;3;0;3
109;12.06.2016;2016;06;00;Sunnuntai;1;7;8;0;1;1
109;12.06.2016;2016;06;01;Sunnuntai;1;2;3;0;0;0
109;12.06.2016;2016;06;02;Sunnuntai;6;2;8;0;1;1
109;12.06.2016;2016;06;03;Sunnuntai;0;0;0;0;0;0
109;12.06.2016;2016;06;04;Sunnuntai;0;1;1;0;1;1
109;12.06.2016;2016;06;05;Sunnuntai;0;1;1;0;1;1
109;12.06.2016;2016;06;06;Sunnuntai;3;1;4;0;0;0
109;12.06.2016;2016;06;07;Sunnuntai;0;4;4;1;2;3
109;12.06.2016;2016;06;08;Sunnuntai;6;1;7;1;0;1
109;12.06.2016;2016;06;09;Sunnuntai;11;4;15;5;3;8
109;12.06.2016;2016;06;10;Sunnuntai;13;5;18;3;7;10
109;12.06.2016;2016;06;11;Sunnuntai;17;11;28;8;1;9
109;12.06.2016;2016;06;12;Sunnuntai;28;17;45;2;4;6
109;12.06.2016;2016;06;13;Sunnuntai;19;8;27;2;3;5
109;12.06.2016;2016;06;14;Sunnuntai;12;18;30;3;5;8
109;12.06.2016;2016;06;15;Sunnuntai;28;10;38;7;5;12
109;12.06.2016;2016;06;16;Sunnuntai;12;19;31;5;1;6
109;12.06.2016;2016;06;17;Sunnuntai;24;15;39;5;2;7
109;12.06.2016;2016;06;18;Sunnuntai;13;14;27;3;6;9
109;12.06.2016;2016;06;19;Sunnuntai;12;9;21;4;3;7
109;12.06.2016;2016;06;20;Sunnuntai;11;9;20;12;6;18
109;12.06.2016;2016;06;21;Sunnuntai;7;10;17;2;6;8
109;12.06.2016;2016;06;22;Sunnuntai;3;2;5;1;2;3
109;12.06.2016;2016;06;23;Sunnuntai;3;7;10;0;1;1
109;13.06.2016;2016;06;00;Maanantai;0;4;4;0;1;1
109;13.06.2016;2016;06;01;Maanantai;0;0;0;0;0;0
109;13.06.2016;2016;06;02;Maanantai;0;0;0;0;0;0
109;13.06.2016;2016;06;03;Maanantai;0;0;0;0;0;0
109;13.06.2016;2016;06;04;Maanantai;2;0;2;1;0;1
109;13.06.2016;2016;06;05;Maanantai;1;8;9;4;1;5
109;13.06.2016;2016;06;06;Maanantai;29;17;46;0;1;1
109;13.06.2016;2016;06;07;Maanantai;85;40;125;3;3;6
109;13.06.2016;2016;06;08;Maanantai;78;35;113;5;2;7
109;13.06.2016;2016;06;09;Maanantai;30;9;39;3;3;6
109;13.06.2016;2016;06;10;Maanantai;14;5;19;2;6;8
109;13.06.2016;2016;06;11;Maanantai;7;13;20;3;4;7
109;13.06.2016;2016;06;12;Maanantai;21;14;35;3;2;5
109;13.06.2016;2016;06;13;Maanantai;21;22;43;3;2;5
109;13.06.2016;2016;06;14;Maanantai;19;21;40;4;1;5
109;13.06.2016;2016;06;15;Maanantai;41;59;100;3;5;8
109;13.06.2016;2016;06;16;Maanantai;61;91;152;10;5;15
109;13.06.2016;2016;06;17;Maanantai;30;43;73;3;3;6
109;13.06.2016;2016;06;18;Maanantai;21;29;50;7;4;11
109;13.06.2016;2016;06;19;Maanantai;20;20;40;10;6;16
109;13.06.2016;2016;06;20;Maanantai;12;19;31;6;12;18
109;13.06.2016;2016;06;21;Maanantai;10;16;26;4;7;11
109;13.06.2016;2016;06;22;Maanantai;10;10;20;1;3;4
109;13.06.2016;2016;06;23;Maanantai;3;3;6;1;2;3
109;14.06.2016;2016;06;00;Tiistai;1;0;1;1;0;1
109;14.06.2016;2016;06;01;Tiistai;1;1;2;0;0;0
109;14.06.2016;2016;06;02;Tiistai;1;0;1;0;0;0
109;14.06.2016;2016;06;03;Tiistai;0;0;0;0;0;0
109;14.06.2016;2016;06;04;Tiistai;0;0;0;1;0;1
109;14.06.2016;2016;06;05;Tiistai;3;10;13;3;0;3
109;14.06.2016;2016;06;06;Tiistai;34;15;49;0;1;1
109;14.06.2016;2016;06;07;Tiistai;101;37;138;2;6;8
109;14.06.2016;2016;06;08;Tiistai;71;26;97;3;2;5
109;14.06.2016;2016;06;09;Tiistai;30;14;44;2;4;6
109;14.06.2016;2016;06;10;Tiistai;12;7;19;4;3;7
109;14.06.2016;2016;06;11;Tiistai;11;5;16;4;2;6
109;14.06.2016;2016;06;12;Tiistai;18;13;31;1;3;4
109;14.06.2016;2016;06;13;Tiistai;26;21;47;7;2;9
109;14.06.2016;2016;06;14;Tiistai;24;26;50;2;1;3
109;14.06.2016;2016;06;15;Tiistai;38;67;105;6;3;9
109;14.06.2016;2016;06;16;Tiistai;42;94;136;5;4;9
109;14.06.2016;2016;06;17;Tiistai;44;47;91;9;4;13
109;14.06.2016;2016;06;18;Tiistai;20;30;50;6;7;13
109;14.06.2016;2016;06;19;Tiistai;18;20;38;9;6;15
109;14.06.2016;2016;06;20;Tiistai;17;17;34;5;4;9
109;14.06.2016;2016;06;21;Tiistai;13;17;30;3;8;11
109;14.06.2016;2016;06;22;Tiistai;7;12;19;3;2;5
109;14.06.2016;2016;06;23;Tiistai;2;2;4;0;1;1
109;15.06.2016;2016;06;00;Keskiviikko;0;1;1;1;1;2
109;15.06.2016;2016;06;01;Keskiviikko;1;0;1;0;1;1
109;15.06.2016;2016;06;02;Keskiviikko;1;1;2;0;0;0
109;15.06.2016;2016;06;03;Keskiviikko;0;2;2;0;0;0
109;15.06.2016;2016;06;04;Keskiviikko;0;1;1;1;0;1
109;15.06.2016;2016;06;05;Keskiviikko;4;11;15;2;1;3
109;15.06.2016;2016;06;06;Keskiviikko;28;11;39;3;1;4
109;15.06.2016;2016;06;07;Keskiviikko;100;40;140;3;7;10
109;15.06.2016;2016;06;08;Keskiviikko;59;32;91;2;3;5
109;15.06.2016;2016;06;09;Keskiviikko;36;8;44;5;3;8
109;15.06.2016;2016;06;10;Keskiviikko;20;13;33;6;2;8
109;15.06.2016;2016;06;11;Keskiviikko;22;22;44;7;1;8
109;15.06.2016;2016;06;12;Keskiviikko;39;17;56;4;3;7
109;15.06.2016;2016;06;13;Keskiviikko;16;20;36;17;5;22
109;15.06.2016;2016;06;14;Keskiviikko;16;16;32;2;5;7
109;15.06.2016;2016;06;15;Keskiviikko;39;58;97;5;5;10
109;15.06.2016;2016;06;16;Keskiviikko;48;82;130;8;2;10
109;15.06.2016;2016;06;17;Keskiviikko;42;39;81;3;3;6
109;15.06.2016;2016;06;18;Keskiviikko;22;28;50;6;3;9
109;15.06.2016;2016;06;19;Keskiviikko;19;18;37;6;5;11
109;15.06.2016;2016;06;20;Keskiviikko;18;20;38;9;4;13
109;15.06.2016;2016;06;21;Keskiviikko;12;13;25;8;8;16
109;15.06.2016;2016;06;22;Keskiviikko;12;12;24;1;1;2
109;15.06.2016;2016;06;23;Keskiviikko;2;0;2;0;2;2
109;16.06.2016;2016;06;00;Torstai;1;2;3;0;1;1
109;16.06.2016;2016;06;01;Torstai;0;0;0;0;0;0
109;16.06.2016;2016;06;02;Torstai;1;0;1;0;0;0
109;16.06.2016;2016;06;03;Torstai;1;2;3;1;0;1
109;16.06.2016;2016;06;04;Torstai;0;1;1;0;0;0
109;16.06.2016;2016;06;05;Torstai;4;7;11;0;0;0
109;16.06.2016;2016;06;06;Torstai;24;10;34;13;2;15
109;16.06.2016;2016;06;07;Torstai;73;39;112;3;4;7
109;16.06.2016;2016;06;08;Torstai;51;19;70;3;1;4
109;16.06.2016;2016;06;09;Torstai;18;15;33;3;0;3
109;16.06.2016;2016;06;10;Torstai;16;13;29;3;4;7
109;16.06.2016;2016;06;11;Torstai;17;16;33;5;3;8
109;16.06.2016;2016;06;12;Torstai;16;10;26;1;3;4
109;16.06.2016;2016;06;13;Torstai;8;7;15;2;4;6
109;16.06.2016;2016;06;14;Torstai;17;19;36;1;2;3
109;16.06.2016;2016;06;15;Torstai;30;34;64;1;2;3
109;16.06.2016;2016;06;16;Torstai;37;58;95;1;0;1
109;16.06.2016;2016;06;17;Torstai;16;23;39;1;4;5
109;16.06.2016;2016;06;18;Torstai;8;17;25;3;2;5
109;16.06.2016;2016;06;19;Torstai;10;8;18;2;0;2
109;16.06.2016;2016;06;20;Torstai;11;6;17;6;4;10
109;16.06.2016;2016;06;21;Torstai;4;6;10;1;4;5
109;16.06.2016;2016;06;22;Torstai;4;5;9;0;1;1
109;16.06.2016;2016;06;23;Torstai;0;3;3;3;2;5
109;17.06.2016;2016;06;00;Perjantai;0;0;0;0;0;0
109;17.06.2016;2016;06;01;Perjantai;0;0;0;0;1;1
109;17.06.2016;2016;06;02;Perjantai;1;0;1;0;0;0
109;17.06.2016;2016;06;03;Perjantai;0;1;1;0;0;0
109;17.06.2016;2016;06;04;Perjantai;1;0;1;0;0;0
109;17.06.2016;2016;06;05;Perjantai;4;4;8;1;1;2
109;17.06.2016;2016;06;06;Perjantai;15;8;23;0;1;1
109;17.06.2016;2016;06;07;Perjantai;40;20;60;3;7;10
109;17.06.2016;2016;06;08;Perjantai;32;12;44;2;0;2
109;17.06.2016;2016;06;09;Perjantai;7;8;15;0;0;0
109;17.06.2016;2016;06;10;Perjantai;11;3;14;3;2;5
109;17.06.2016;2016;06;11;Perjantai;9;4;13;2;4;6
109;17.06.2016;2016;06;12;Perjantai;15;2;17;3;2;5
109;17.06.2016;2016;06;13;Perjantai;8;6;14;3;1;4
109;17.06.2016;2016;06;14;Perjantai;10;13;23;2;1;3
109;17.06.2016;2016;06;15;Perjantai;17;22;39;2;0;2
109;17.06.2016;2016;06;16;Perjantai;20;27;47;3;3;6
109;17.06.2016;2016;06;17;Perjantai;15;17;32;2;2;4
109;17.06.2016;2016;06;18;Perjantai;31;8;39;5;3;8
109;17.06.2016;2016;06;19;Perjantai;20;16;36;4;4;8
109;17.06.2016;2016;06;20;Perjantai;9;16;25;4;2;6
109;17.06.2016;2016;06;21;Perjantai;6;7;13;3;0;3
109;17.06.2016;2016;06;22;Perjantai;6;7;13;4;4;8
109;17.06.2016;2016;06;23;Perjantai;4;1;5;0;0;0
109;18.06.2016;2016;06;00;Lauantai;2;3;5;0;2;2
109;18.06.2016;2016;06;01;Lauantai;0;3;3;0;0;0
109;18.06.2016;2016;06;02;Lauantai;0;3;3;0;0;0
109;18.06.2016;2016;06;03;Lauantai;0;1;1;0;1;1
109;18.06.2016;2016;06;04;Lauantai;1;0;1;0;1;1
109;18.06.2016;2016;06;05;Lauantai;1;2;3;2;2;4
109;18.06.2016;2016;06;06;Lauantai;4;1;5;1;2;3
109;18.06.2016;2016;06;07;Lauantai;4;3;7;2;3;5
109;18.06.2016;2016;06;08;Lauantai;6;2;8;5;4;9
109;18.06.2016;2016;06;09;Lauantai;10;5;15;7;3;10
109;18.06.2016;2016;06;10;Lauantai;19;7;26;5;2;7
109;18.06.2016;2016;06;11;Lauantai;5;11;16;3;0;3
109;18.06.2016;2016;06;12;Lauantai;4;8;12;2;0;2
109;18.06.2016;2016;06;13;Lauantai;1;5;6;1;0;1
109;18.06.2016;2016;06;14;Lauantai;11;4;15;5;1;6
109;18.06.2016;2016;06;15;Lauantai;8;8;16;0;3;3
109;18.06.2016;2016;06;16;Lauantai;7;8;15;3;2;5
109;18.06.2016;2016;06;17;Lauantai;6;7;13;3;2;5
109;18.06.2016;2016;06;18;Lauantai;8;4;12;0;0;0
109;18.06.2016;2016;06;19;Lauantai;3;4;7;1;0;1
109;18.06.2016;2016;06;20;Lauantai;4;8;12;5;1;6
109;18.06.2016;2016;06;21;Lauantai;10;6;16;1;2;3
109;18.06.2016;2016;06;22;Lauantai;3;2;5;2;1;3
109;18.06.2016;2016;06;23;Lauantai;1;2;3;0;0;0
109;19.06.2016;2016;06;00;Sunnuntai;0;3;3;1;0;1
109;19.06.2016;2016;06;01;Sunnuntai;0;1;1;0;1;1
109;19.06.2016;2016;06;02;Sunnuntai;0;2;2;0;0;0
109;19.06.2016;2016;06;03;Sunnuntai;0;1;1;0;0;0
109;19.06.2016;2016;06;04;Sunnuntai;0;3;3;0;2;2
109;19.06.2016;2016;06;05;Sunnuntai;1;0;1;1;1;2
109;19.06.2016;2016;06;06;Sunnuntai;2;1;3;0;0;0
109;19.06.2016;2016;06;07;Sunnuntai;1;3;4;2;2;4
109;19.06.2016;2016;06;08;Sunnuntai;2;1;3;4;3;7
109;19.06.2016;2016;06;09;Sunnuntai;3;3;6;3;3;6
109;19.06.2016;2016;06;10;Sunnuntai;10;5;15;8;2;10
109;19.06.2016;2016;06;11;Sunnuntai;13;9;22;7;7;14
109;19.06.2016;2016;06;12;Sunnuntai;26;12;38;4;4;8
109;19.06.2016;2016;06;13;Sunnuntai;22;40;62;2;2;4
109;19.06.2016;2016;06;14;Sunnuntai;19;18;37;2;2;4
109;19.06.2016;2016;06;15;Sunnuntai;14;7;21;5;2;7
109;19.06.2016;2016;06;16;Sunnuntai;17;8;25;2;2;4
109;19.06.2016;2016;06;17;Sunnuntai;5;3;8;0;3;3
109;19.06.2016;2016;06;18;Sunnuntai;8;4;12;1;3;4
109;19.06.2016;2016;06;19;Sunnuntai;3;6;9;10;6;16
109;19.06.2016;2016;06;20;Sunnuntai;10;5;15;7;7;14
109;19.06.2016;2016;06;21;Sunnuntai;5;6;11;2;5;7
109;19.06.2016;2016;06;22;Sunnuntai;0;8;8;1;0;1
109;19.06.2016;2016;06;23;Sunnuntai;1;0;1;2;0;2
109;20.06.2016;2016;06;00;Maanantai;3;3;6;0;0;0
109;20.06.2016;2016;06;01;Maanantai;0;1;1;0;0;0
109;20.06.2016;2016;06;02;Maanantai;0;0;0;0;0;0
109;20.06.2016;2016;06;03;Maanantai;0;0;0;0;0;0
109;20.06.2016;2016;06;04;Maanantai;2;0;2;0;1;1
109;20.06.2016;2016;06;05;Maanantai;2;11;13;3;1;4
109;20.06.2016;2016;06;06;Maanantai;36;14;50;2;2;4
109;20.06.2016;2016;06;07;Maanantai;87;38;125;2;7;9
109;20.06.2016;2016;06;08;Maanantai;59;27;86;4;3;7
109;20.06.2016;2016;06;09;Maanantai;27;7;34;4;5;9
109;20.06.2016;2016;06;10;Maanantai;12;18;30;0;1;1
109;20.06.2016;2016;06;11;Maanantai;25;12;37;4;2;6
109;20.06.2016;2016;06;12;Maanantai;16;9;25;4;4;8
109;20.06.2016;2016;06;13;Maanantai;18;25;43;2;0;2
109;20.06.2016;2016;06;14;Maanantai;23;21;44;2;2;4
109;20.06.2016;2016;06;15;Maanantai;33;42;75;8;6;14
109;20.06.2016;2016;06;16;Maanantai;49;74;123;6;4;10
109;20.06.2016;2016;06;17;Maanantai;42;50;92;12;9;21
109;20.06.2016;2016;06;18;Maanantai;37;21;58;7;6;13
109;20.06.2016;2016;06;19;Maanantai;12;27;39;6;6;12
109;20.06.2016;2016;06;20;Maanantai;9;20;29;8;7;15
109;20.06.2016;2016;06;21;Maanantai;10;18;28;4;3;7
109;20.06.2016;2016;06;22;Maanantai;6;5;11;1;0;1
109;20.06.2016;2016;06;23;Maanantai;0;4;4;2;1;3
109;21.06.2016;2016;06;00;Tiistai;3;2;5;0;0;0
109;21.06.2016;2016;06;01;Tiistai;2;2;4;0;1;1
109;21.06.2016;2016;06;02;Tiistai;2;2;4;0;0;0
109;21.06.2016;2016;06;03;Tiistai;0;0;0;0;0;0
109;21.06.2016;2016;06;04;Tiistai;0;1;1;0;2;2
109;21.06.2016;2016;06;05;Tiistai;2;16;18;3;1;4
109;21.06.2016;2016;06;06;Tiistai;36;12;48;0;0;0
109;21.06.2016;2016;06;07;Tiistai;79;46;125;2;2;4
109;21.06.2016;2016;06;08;Tiistai;60;22;82;1;4;5
109;21.06.2016;2016;06;09;Tiistai;21;16;37;4;3;7
109;21.06.2016;2016;06;10;Tiistai;19;14;33;6;3;9
109;21.06.2016;2016;06;11;Tiistai;24;11;35;3;3;6
109;21.06.2016;2016;06;12;Tiistai;18;17;35;2;1;3
109;21.06.2016;2016;06;13;Tiistai;23;17;40;2;3;5
109;21.06.2016;2016;06;14;Tiistai;31;25;56;4;2;6
109;21.06.2016;2016;06;15;Tiistai;42;52;94;6;2;8
109;21.06.2016;2016;06;16;Tiistai;53;75;128;7;7;14
109;21.06.2016;2016;06;17;Tiistai;43;38;81;5;3;8
109;21.06.2016;2016;06;18;Tiistai;21;18;39;7;2;9
109;21.06.2016;2016;06;19;Tiistai;28;27;55;3;4;7
109;21.06.2016;2016;06;20;Tiistai;19;26;45;8;7;15
109;21.06.2016;2016;06;21;Tiistai;9;21;30;4;1;5
109;21.06.2016;2016;06;22;Tiistai;16;14;30;0;2;2
109;21.06.2016;2016;06;23;Tiistai;4;1;5;2;2;4
109;22.06.2016;2016;06;00;Keskiviikko;2;1;3;0;1;1
109;22.06.2016;2016;06;01;Keskiviikko;1;1;2;0;0;0
109;22.06.2016;2016;06;02;Keskiviikko;1;0;1;0;0;0
109;22.06.2016;2016;06;03;Keskiviikko;1;0;1;0;0;0
109;22.06.2016;2016;06;04;Keskiviikko;1;1;2;0;1;1
109;22.06.2016;2016;06;05;Keskiviikko;4;17;21;7;6;13
109;22.06.2016;2016;06;06;Keskiviikko;29;13;42;0;0;0
109;22.06.2016;2016;06;07;Keskiviikko;79;33;112;3;3;6
109;22.06.2016;2016;06;08;Keskiviikko;53;18;71;1;2;3
109;22.06.2016;2016;06;09;Keskiviikko;24;12;36;2;5;7
109;22.06.2016;2016;06;10;Keskiviikko;12;7;19;5;0;5
109;22.06.2016;2016;06;11;Keskiviikko;17;18;35;4;2;6
109;22.06.2016;2016;06;12;Keskiviikko;16;6;22;1;1;2
109;22.06.2016;2016;06;13;Keskiviikko;25;29;54;2;1;3
109;22.06.2016;2016;06;14;Keskiviikko;27;19;46;4;2;6
109;22.06.2016;2016;06;15;Keskiviikko;38;52;90;3;3;6
109;22.06.2016;2016;06;16;Keskiviikko;49;72;121;3;1;4
109;22.06.2016;2016;06;17;Keskiviikko;31;24;55;4;3;7
109;22.06.2016;2016;06;18;Keskiviikko;19;30;49;6;5;11
109;22.06.2016;2016;06;19;Keskiviikko;15;20;35;7;6;13
109;22.06.2016;2016;06;20;Keskiviikko;20;16;36;6;4;10
109;22.06.2016;2016;06;21;Keskiviikko;7;13;20;1;2;3
109;22.06.2016;2016;06;22;Keskiviikko;9;10;19;4;2;6
109;22.06.2016;2016;06;23;Keskiviikko;1;7;8;3;0;3
109;23.06.2016;2016;06;00;Torstai;0;4;4;1;1;2
109;23.06.2016;2016;06;01;Torstai;1;0;1;1;0;1
109;23.06.2016;2016;06;02;Torstai;2;2;4;0;0;0
109;23.06.2016;2016;06;03;Torstai;1;1;2;0;0;0
109;23.06.2016;2016;06;04;Torstai;0;1;1;0;0;0
109;23.06.2016;2016;06;05;Torstai;4;11;15;1;0;1
109;23.06.2016;2016;06;06;Torstai;22;13;35;1;0;1
109;23.06.2016;2016;06;07;Torstai;58;24;82;1;4;5
109;23.06.2016;2016;06;08;Torstai;37;18;55;0;5;5
109;23.06.2016;2016;06;09;Torstai;19;17;36;3;1;4
109;23.06.2016;2016;06;10;Torstai;11;8;19;4;2;6
109;23.06.2016;2016;06;11;Torstai;26;15;41;7;1;8
109;23.06.2016;2016;06;12;Torstai;18;16;34;4;5;9
109;23.06.2016;2016;06;13;Torstai;26;28;54;2;5;7
109;23.06.2016;2016;06;14;Torstai;47;36;83;10;0;10
109;23.06.2016;2016;06;15;Torstai;38;51;89;3;3;6
109;23.06.2016;2016;06;16;Torstai;30;28;58;3;5;8
109;23.06.2016;2016;06;17;Torstai;23;22;45;11;7;18
109;23.06.2016;2016;06;18;Torstai;11;22;33;4;3;7
109;23.06.2016;2016;06;19;Torstai;16;20;36;3;3;6
109;23.06.2016;2016;06;20;Torstai;18;17;35;8;7;15
109;23.06.2016;2016;06;21;Torstai;10;10;20;2;6;8
109;23.06.2016;2016;06;22;Torstai;6;9;15;0;0;0
109;23.06.2016;2016;06;23;Torstai;6;3;9;1;0;1
109;24.06.2016;2016;06;00;Perjantai;6;4;10;1;0;1
109;24.06.2016;2016;06;01;Perjantai;2;1;3;1;0;1
109;24.06.2016;2016;06;02;Perjantai;3;2;5;0;0;0
109;24.06.2016;2016;06;03;Perjantai;0;1;1;0;1;1
109;24.06.2016;2016;06;04;Perjantai;1;0;1;0;0;0
109;24.06.2016;2016;06;05;Perjantai;0;1;1;1;1;2
109;24.06.2016;2016;06;06;Perjantai;3;0;3;1;0;1
109;24.06.2016;2016;06;07;Perjantai;8;2;10;0;1;1
109;24.06.2016;2016;06;08;Perjantai;7;2;9;1;1;2
109;24.06.2016;2016;06;09;Perjantai;14;6;20;3;2;5
109;24.06.2016;2016;06;10;Perjantai;11;12;23;2;4;6
109;24.06.2016;2016;06;11;Perjantai;18;7;25;2;2;4
109;24.06.2016;2016;06;12;Perjantai;18;14;32;5;0;5
109;24.06.2016;2016;06;13;Perjantai;17;10;27;0;3;3
109;24.06.2016;2016;06;14;Perjantai;24;18;42;5;3;8
109;24.06.2016;2016;06;15;Perjantai;15;8;23;3;2;5
109;24.06.2016;2016;06;16;Perjantai;9;23;32;4;4;8
109;24.06.2016;2016;06;17;Perjantai;18;11;29;2;1;3
109;24.06.2016;2016;06;18;Perjantai;24;13;37;0;0;0
109;24.06.2016;2016;06;19;Perjantai;20;11;31;3;1;4
109;24.06.2016;2016;06;20;Perjantai;15;5;20;1;1;2
109;24.06.2016;2016;06;21;Perjantai;23;20;43;6;2;8
109;24.06.2016;2016;06;22;Perjantai;6;17;23;4;1;5
109;24.06.2016;2016;06;23;Perjantai;6;9;15;0;0;0
109;25.06.2016;2016;06;00;Lauantai;3;1;4;1;0;1
109;25.06.2016;2016;06;01;Lauantai;5;6;11;0;0;0
109;25.06.2016;2016;06;02;Lauantai;3;5;8;0;1;1
109;25.06.2016;2016;06;03;Lauantai;2;5;7;0;0;0
109;25.06.2016;2016;06;04;Lauantai;0;10;10;0;1;1
109;25.06.2016;2016;06;05;Lauantai;1;2;3;0;0;0
109;25.06.2016;2016;06;06;Lauantai;1;0;1;0;0;0
109;25.06.2016;2016;06;07;Lauantai;2;5;7;2;2;4
109;25.06.2016;2016;06;08;Lauantai;3;4;7;2;1;3
109;25.06.2016;2016;06;09;Lauantai;5;7;12;2;3;5
109;25.06.2016;2016;06;10;Lauantai;8;5;13;2;0;2
109;25.06.2016;2016;06;11;Lauantai;4;2;6;4;0;4
109;25.06.2016;2016;06;12;Lauantai;0;2;2;0;0;0
109;25.06.2016;2016;06;13;Lauantai;3;0;3;2;0;2
109;25.06.2016;2016;06;14;Lauantai;4;1;5;0;1;1
109;25.06.2016;2016;06;15;Lauantai;5;8;13;2;2;4
109;25.06.2016;2016;06;16;Lauantai;9;7;16;5;1;6
109;25.06.2016;2016;06;17;Lauantai;13;4;17;3;1;4
109;25.06.2016;2016;06;18;Lauantai;5;9;14;2;3;5
109;25.06.2016;2016;06;19;Lauantai;12;11;23;1;2;3
109;25.06.2016;2016;06;20;Lauantai;20;10;30;6;2;8
109;25.06.2016;2016;06;21;Lauantai;14;11;25;1;5;6
109;25.06.2016;2016;06;22;Lauantai;4;8;12;3;2;5
109;25.06.2016;2016;06;23;Lauantai;2;5;7;0;1;1
109;26.06.2016;2016;06;00;Sunnuntai;8;4;12;0;0;0
109;26.06.2016;2016;06;01;Sunnuntai;2;1;3;0;0;0
109;26.06.2016;2016;06;02;Sunnuntai;0;0;0;0;1;1
109;26.06.2016;2016;06;03;Sunnuntai;0;2;2;0;0;0
109;26.06.2016;2016;06;04;Sunnuntai;0;3;3;0;0;0
109;26.06.2016;2016;06;05;Sunnuntai;1;0;1;0;0;0
109;26.06.2016;2016;06;06;Sunnuntai;1;0;1;1;1;2
109;26.06.2016;2016;06;07;Sunnuntai;1;6;7;5;4;9
109;26.06.2016;2016;06;08;Sunnuntai;5;2;7;2;1;3
109;26.06.2016;2016;06;09;Sunnuntai;4;4;8;3;2;5
109;26.06.2016;2016;06;10;Sunnuntai;6;2;8;8;1;9
109;26.06.2016;2016;06;11;Sunnuntai;9;10;19;3;4;7
109;26.06.2016;2016;06;12;Sunnuntai;15;9;24;5;2;7
109;26.06.2016;2016;06;13;Sunnuntai;27;18;45;1;7;8
109;26.06.2016;2016;06;14;Sunnuntai;18;13;31;2;4;6
109;26.06.2016;2016;06;15;Sunnuntai;29;17;46;4;4;8
109;26.06.2016;2016;06;16;Sunnuntai;22;11;33;3;4;7
109;26.06.2016;2016;06;17;Sunnuntai;16;9;25;7;1;8
109;26.06.2016;2016;06;18;Sunnuntai;28;17;45;1;3;4
109;26.06.2016;2016;06;19;Sunnuntai;17;10;27;5;3;8
109;26.06.2016;2016;06;20;Sunnuntai;12;17;29;8;9;17
109;26.06.2016;2016;06;21;Sunnuntai;8;13;21;2;6;8
109;26.06.2016;2016;06;22;Sunnuntai;1;5;6;0;0;0
109;26.06.2016;2016;06;23;Sunnuntai;2;7;9;0;2;2
109;27.06.2016;2016;06;00;Maanantai;1;0;1;0;1;1
109;27.06.2016;2016;06;01;Maanantai;3;1;4;0;1;1
109;27.06.2016;2016;06;02;Maanantai;0;0;0;0;0;0
109;27.06.2016;2016;06;03;Maanantai;2;1;3;0;0;0
109;27.06.2016;2016;06;04;Maanantai;0;1;1;0;1;1
109;27.06.2016;2016;06;05;Maanantai;4;9;13;2;0;2
109;27.06.2016;2016;06;06;Maanantai;23;19;42;5;2;7
109;27.06.2016;2016;06;07;Maanantai;74;34;108;2;4;6
109;27.06.2016;2016;06;08;Maanantai;46;25;71;4;2;6
109;27.06.2016;2016;06;09;Maanantai;22;18;40;1;4;5
109;27.06.2016;2016;06;10;Maanantai;22;10;32;4;3;7
109;27.06.2016;2016;06;11;Maanantai;30;9;39;3;0;3
109;27.06.2016;2016;06;12;Maanantai;28;17;45;7;5;12
109;27.06.2016;2016;06;13;Maanantai;33;21;54;10;3;13
109;27.06.2016;2016;06;14;Maanantai;26;28;54;5;1;6
109;27.06.2016;2016;06;15;Maanantai;39;51;90;3;6;9
109;27.06.2016;2016;06;16;Maanantai;56;72;128;4;2;6
109;27.06.2016;2016;06;17;Maanantai;27;48;75;4;4;8
109;27.06.2016;2016;06;18;Maanantai;25;17;42;5;2;7
109;27.06.2016;2016;06;19;Maanantai;18;23;41;4;3;7
109;27.06.2016;2016;06;20;Maanantai;6;17;23;12;7;19
109;27.06.2016;2016;06;21;Maanantai;7;11;18;3;4;7
109;27.06.2016;2016;06;22;Maanantai;5;7;12;2;1;3
109;27.06.2016;2016;06;23;Maanantai;2;4;6;2;2;4
109;28.06.2016;2016;06;00;Tiistai;0;3;3;0;0;0
109;28.06.2016;2016;06;01;Tiistai;0;1;1;0;1;1
109;28.06.2016;2016;06;02;Tiistai;0;0;0;0;0;0
109;28.06.2016;2016;06;03;Tiistai;0;0;0;1;0;1
109;28.06.2016;2016;06;04;Tiistai;2;1;3;0;0;0
109;28.06.2016;2016;06;05;Tiistai;3;8;11;1;0;1
109;28.06.2016;2016;06;06;Tiistai;14;10;24;3;0;3
109;28.06.2016;2016;06;07;Tiistai;31;25;56;0;4;4
109;28.06.2016;2016;06;08;Tiistai;31;13;44;2;1;3
109;28.06.2016;2016;06;09;Tiistai;9;10;19;3;2;5
109;28.06.2016;2016;06;10;Tiistai;10;2;12;0;3;3
109;28.06.2016;2016;06;11;Tiistai;10;6;16;2;0;2
109;28.06.2016;2016;06;12;Tiistai;9;9;18;6;0;6
109;28.06.2016;2016;06;13;Tiistai;23;9;32;3;1;4
109;28.06.2016;2016;06;14;Tiistai;28;11;39;4;3;7
109;28.06.2016;2016;06;15;Tiistai;25;37;62;6;6;12
109;28.06.2016;2016;06;16;Tiistai;28;35;63;2;3;5
109;28.06.2016;2016;06;17;Tiistai;29;31;60;4;7;11
109;28.06.2016;2016;06;18;Tiistai;21;20;41;13;6;19
109;28.06.2016;2016;06;19;Tiistai;35;13;48;11;8;19
109;28.06.2016;2016;06;20;Tiistai;17;21;38;2;7;9
109;28.06.2016;2016;06;21;Tiistai;14;8;22;6;5;11
109;28.06.2016;2016;06;22;Tiistai;6;8;14;2;3;5
109;28.06.2016;2016;06;23;Tiistai;1;9;10;2;2;4
109;29.06.2016;2016;06;00;Keskiviikko;4;14;18;0;2;2
109;29.06.2016;2016;06;01;Keskiviikko;0;1;1;0;1;1
109;29.06.2016;2016;06;02;Keskiviikko;2;0;2;0;0;0
109;29.06.2016;2016;06;03;Keskiviikko;0;0;0;0;0;0
109;29.06.2016;2016;06;04;Keskiviikko;0;1;1;0;0;0
109;29.06.2016;2016;06;05;Keskiviikko;2;10;12;4;0;4
109;29.06.2016;2016;06;06;Keskiviikko;25;10;35;2;0;2
109;29.06.2016;2016;06;07;Keskiviikko;60;42;102;1;3;4
109;29.06.2016;2016;06;08;Keskiviikko;48;25;73;0;2;2
109;29.06.2016;2016;06;09;Keskiviikko;29;14;43;4;3;7
109;29.06.2016;2016;06;10;Keskiviikko;20;12;32;6;4;10
109;29.06.2016;2016;06;11;Keskiviikko;10;12;22;10;2;12
109;29.06.2016;2016;06;12;Keskiviikko;24;20;44;4;0;4
109;29.06.2016;2016;06;13;Keskiviikko;23;9;32;1;2;3
109;29.06.2016;2016;06;14;Keskiviikko;34;20;54;1;0;1
109;29.06.2016;2016;06;15;Keskiviikko;31;58;89;4;7;11
109;29.06.2016;2016;06;16;Keskiviikko;42;57;99;2;4;6
109;29.06.2016;2016;06;17;Keskiviikko;17;25;42;5;0;5
109;29.06.2016;2016;06;18;Keskiviikko;24;23;47;5;3;8
109;29.06.2016;2016;06;19;Keskiviikko;20;10;30;8;5;13
109;29.06.2016;2016;06;20;Keskiviikko;18;12;30;7;0;7
109;29.06.2016;2016;06;21;Keskiviikko;10;10;20;4;4;8
109;29.06.2016;2016;06;22;Keskiviikko;5;11;16;3;1;4
109;29.06.2016;2016;06;23;Keskiviikko;1;2;3;2;2;4
109;30.06.2016;2016;06;00;Torstai;2;2;4;1;0;1
109;30.06.2016;2016;06;01;Torstai;1;3;4;1;1;2
109;30.06.2016;2016;06;02;Torstai;0;0;0;0;0;0
109;30.06.2016;2016;06;03;Torstai;0;0;0;0;0;0
109;30.06.2016;2016;06;04;Torstai;1;4;5;0;0;0
109;30.06.2016;2016;06;05;Torstai;0;10;10;1;0;1
109;30.06.2016;2016;06;06;Torstai;22;11;33;2;1;3
109;30.06.2016;2016;06;07;Torstai;50;29;79;4;1;5
109;30.06.2016;2016;06;08;Torstai;39;26;65;2;5;7
109;30.06.2016;2016;06;09;Torstai;22;15;37;4;2;6
109;30.06.2016;2016;06;10;Torstai;21;13;34;3;3;6
109;30.06.2016;2016;06;11;Torstai;19;16;35;10;0;10
109;30.06.2016;2016;06;12;Torstai;27;14;41;2;2;4
109;30.06.2016;2016;06;13;Torstai;28;19;47;4;2;6
109;30.06.2016;2016;06;14;Torstai;25;16;41;6;2;8
109;30.06.2016;2016;06;15;Torstai;39;61;100;3;4;7
109;30.06.2016;2016;06;16;Torstai;31;25;56;3;1;4
109;30.06.2016;2016;06;17;Torstai;16;18;34;2;1;3
109;30.06.2016;2016;06;18;Torstai;12;11;23;2;2;4
109;30.06.2016;2016;06;19;Torstai;9;18;27;4;3;7
109;30.06.2016;2016;06;20;Torstai;16;17;33;8;5;13
109;30.06.2016;2016;06;21;Torstai;8;10;18;5;5;10
109;30.06.2016;2016;06;22;Torstai;5;7;12;2;4;6
109;30.06.2016;2016;06;23;Torstai;4;3;7;0;0;0
109;01.07.2016;2016;07;00;Perjantai;1;2;3;0;0;0
109;01.07.2016;2016;07;01;Perjantai;1;2;3;0;1;1
109;01.07.2016;2016;07;02;Perjantai;0;0;0;1;1;2
109;01.07.2016;2016;07;03;Perjantai;0;0;0;0;0;0
109;01.07.2016;2016;07;04;Perjantai;0;1;1;1;0;1
109;01.07.2016;2016;07;05;Perjantai;0;7;7;1;1;2
109;01.07.2016;2016;07;06;Perjantai;24;9;33;2;0;2
109;01.07.2016;2016;07;07;Perjantai;37;25;62;0;1;1
109;01.07.2016;2016;07;08;Perjantai;28;14;42;4;0;4
109;01.07.2016;2016;07;09;Perjantai;23;10;33;0;3;3
109;01.07.2016;2016;07;10;Perjantai;12;6;18;8;2;10
109;01.07.2016;2016;07;11;Perjantai;12;10;22;12;4;16
109;01.07.2016;2016;07;12;Perjantai;21;14;35;1;1;2
109;01.07.2016;2016;07;13;Perjantai;23;15;38;2;2;4
109;01.07.2016;2016;07;14;Perjantai;12;14;26;4;1;5
109;01.07.2016;2016;07;15;Perjantai;22;36;58;2;1;3
109;01.07.2016;2016;07;16;Perjantai;25;31;56;3;2;5
109;01.07.2016;2016;07;17;Perjantai;14;17;31;0;4;4
109;01.07.2016;2016;07;18;Perjantai;12;12;24;2;3;5
109;01.07.2016;2016;07;19;Perjantai;20;10;30;2;7;9
109;01.07.2016;2016;07;20;Perjantai;12;8;20;4;1;5
109;01.07.2016;2016;07;21;Perjantai;5;7;12;2;6;8
109;01.07.2016;2016;07;22;Perjantai;8;4;12;2;0;2
109;01.07.2016;2016;07;23;Perjantai;2;2;4;0;1;1
109;02.07.2016;2016;07;00;Lauantai;5;1;6;1;1;2
109;02.07.2016;2016;07;01;Lauantai;4;5;9;0;0;0
109;02.07.2016;2016;07;02;Lauantai;1;4;5;0;1;1
109;02.07.2016;2016;07;03;Lauantai;0;3;3;1;0;1
109;02.07.2016;2016;07;04;Lauantai;1;6;7;0;0;0
109;02.07.2016;2016;07;05;Lauantai;0;2;2;0;0;0
109;02.07.2016;2016;07;06;Lauantai;6;5;11;3;1;4
109;02.07.2016;2016;07;07;Lauantai;0;3;3;1;0;1
109;02.07.2016;2016;07;08;Lauantai;4;3;7;2;1;3
109;02.07.2016;2016;07;09;Lauantai;8;11;19;3;5;8
109;02.07.2016;2016;07;10;Lauantai;14;5;19;3;1;4
109;02.07.2016;2016;07;11;Lauantai;20;9;29;9;5;14
109;02.07.2016;2016;07;12;Lauantai;20;10;30;3;2;5
109;02.07.2016;2016;07;13;Lauantai;25;18;43;2;3;5
109;02.07.2016;2016;07;14;Lauantai;26;19;45;0;4;4
109;02.07.2016;2016;07;15;Lauantai;20;13;33;3;5;8
109;02.07.2016;2016;07;16;Lauantai;15;10;25;3;1;4
109;02.07.2016;2016;07;17;Lauantai;9;16;25;1;2;3
109;02.07.2016;2016;07;18;Lauantai;10;6;16;7;3;10
109;02.07.2016;2016;07;19;Lauantai;14;15;29;4;2;6
109;02.07.2016;2016;07;20;Lauantai;16;5;21;7;4;11
109;02.07.2016;2016;07;21;Lauantai;12;18;30;3;3;6
109;02.07.2016;2016;07;22;Lauantai;8;2;10;1;0;1
109;02.07.2016;2016;07;23;Lauantai;6;5;11;5;1;6
109;03.07.2016;2016;07;00;Sunnuntai;1;2;3;1;0;1
109;03.07.2016;2016;07;01;Sunnuntai;3;6;9;3;0;3
109;03.07.2016;2016;07;02;Sunnuntai;2;3;5;1;1;2
109;03.07.2016;2016;07;03;Sunnuntai;1;4;5;0;0;0
109;03.07.2016;2016;07;04;Sunnuntai;0;7;7;1;0;1
109;03.07.2016;2016;07;05;Sunnuntai;0;2;2;0;2;2
109;03.07.2016;2016;07;06;Sunnuntai;3;4;7;2;0;2
109;03.07.2016;2016;07;07;Sunnuntai;0;1;1;1;2;3
109;03.07.2016;2016;07;08;Sunnuntai;2;1;3;1;2;3
109;03.07.2016;2016;07;09;Sunnuntai;4;3;7;6;6;12
109;03.07.2016;2016;07;10;Sunnuntai;7;1;8;1;2;3
109;03.07.2016;2016;07;11;Sunnuntai;3;3;6;1;1;2
109;03.07.2016;2016;07;12;Sunnuntai;3;2;5;0;2;2
109;03.07.2016;2016;07;13;Sunnuntai;5;2;7;3;2;5
109;03.07.2016;2016;07;14;Sunnuntai;5;5;10;2;4;6
109;03.07.2016;2016;07;15;Sunnuntai;18;11;29;8;5;13
109;03.07.2016;2016;07;16;Sunnuntai;15;21;36;12;5;17
109;03.07.2016;2016;07;17;Sunnuntai;23;9;32;5;5;10
109;03.07.2016;2016;07;18;Sunnuntai;12;20;32;7;3;10
109;03.07.2016;2016;07;19;Sunnuntai;18;15;33;7;8;15
109;03.07.2016;2016;07;20;Sunnuntai;11;13;24;3;3;6
109;03.07.2016;2016;07;21;Sunnuntai;8;5;13;3;2;5
109;03.07.2016;2016;07;22;Sunnuntai;4;3;7;2;1;3
109;03.07.2016;2016;07;23;Sunnuntai;1;4;5;0;1;1
109;04.07.2016;2016;07;00;Maanantai;0;1;1;1;0;1
109;04.07.2016;2016;07;01;Maanantai;1;0;1;0;0;0
109;04.07.2016;2016;07;02;Maanantai;0;1;1;0;1;1
109;04.07.2016;2016;07;03;Maanantai;0;0;0;1;1;2
109;04.07.2016;2016;07;04;Maanantai;1;1;2;0;0;0
109;04.07.2016;2016;07;05;Maanantai;1;5;6;3;0;3
109;04.07.2016;2016;07;06;Maanantai;18;13;31;2;1;3
109;04.07.2016;2016;07;07;Maanantai;33;22;55;2;4;6
109;04.07.2016;2016;07;08;Maanantai;29;11;40;3;4;7
109;04.07.2016;2016;07;09;Maanantai;11;6;17;6;2;8
109;04.07.2016;2016;07;10;Maanantai;9;5;14;5;4;9
109;04.07.2016;2016;07;11;Maanantai;10;5;15;3;1;4
109;04.07.2016;2016;07;12;Maanantai;9;6;15;2;2;4
109;04.07.2016;2016;07;13;Maanantai;7;7;14;3;0;3
109;04.07.2016;2016;07;14;Maanantai;14;15;29;1;1;2
109;04.07.2016;2016;07;15;Maanantai;27;23;50;3;4;7
109;04.07.2016;2016;07;16;Maanantai;29;35;64;4;6;10
109;04.07.2016;2016;07;17;Maanantai;16;24;40;4;5;9
109;04.07.2016;2016;07;18;Maanantai;12;13;25;11;2;13
109;04.07.2016;2016;07;19;Maanantai;11;8;19;7;11;18
109;04.07.2016;2016;07;20;Maanantai;9;12;21;6;5;11
109;04.07.2016;2016;07;21;Maanantai;3;7;10;2;1;3
109;04.07.2016;2016;07;22;Maanantai;5;2;7;0;0;0
109;04.07.2016;2016;07;23;Maanantai;1;1;2;0;1;1
109;05.07.2016;2016;07;00;Tiistai;0;0;0;0;0;0
109;05.07.2016;2016;07;01;Tiistai;0;1;1;0;1;1
109;05.07.2016;2016;07;02;Tiistai;1;0;1;0;0;0
109;05.07.2016;2016;07;03;Tiistai;0;0;0;0;0;0
109;05.07.2016;2016;07;04;Tiistai;1;1;2;0;0;0
109;05.07.2016;2016;07;05;Tiistai;2;6;8;1;0;1
109;05.07.2016;2016;07;06;Tiistai;21;8;29;3;2;5
109;05.07.2016;2016;07;07;Tiistai;26;24;50;2;2;4
109;05.07.2016;2016;07;08;Tiistai;23;12;35;1;3;4
109;05.07.2016;2016;07;09;Tiistai;11;4;15;4;4;8
109;05.07.2016;2016;07;10;Tiistai;8;6;14;2;1;3
109;05.07.2016;2016;07;11;Tiistai;12;9;21;1;0;1
109;05.07.2016;2016;07;12;Tiistai;20;11;31;4;1;5
109;05.07.2016;2016;07;13;Tiistai;12;15;27;5;4;9
109;05.07.2016;2016;07;14;Tiistai;19;14;33;7;0;7
109;05.07.2016;2016;07;15;Tiistai;29;29;58;2;4;6
109;05.07.2016;2016;07;16;Tiistai;27;37;64;3;1;4
109;05.07.2016;2016;07;17;Tiistai;11;13;24;0;1;1
109;05.07.2016;2016;07;18;Tiistai;5;2;7;2;1;3
109;05.07.2016;2016;07;19;Tiistai;12;17;29;6;4;10
109;05.07.2016;2016;07;20;Tiistai;8;11;19;7;4;11
109;05.07.2016;2016;07;21;Tiistai;5;7;12;2;1;3
109;05.07.2016;2016;07;22;Tiistai;11;5;16;0;1;1
109;05.07.2016;2016;07;23;Tiistai;1;2;3;1;2;3
109;06.07.2016;2016;07;00;Keskiviikko;0;3;3;1;2;3
109;06.07.2016;2016;07;01;Keskiviikko;0;1;1;0;0;0
109;06.07.2016;2016;07;02;Keskiviikko;1;0;1;0;1;1
109;06.07.2016;2016;07;03;Keskiviikko;0;0;0;0;0;0
109;06.07.2016;2016;07;04;Keskiviikko;0;0;0;0;0;0
109;06.07.2016;2016;07;05;Keskiviikko;1;7;8;1;0;1
109;06.07.2016;2016;07;06;Keskiviikko;18;7;25;1;0;1
109;06.07.2016;2016;07;07;Keskiviikko;20;15;35;1;3;4
109;06.07.2016;2016;07;08;Keskiviikko;20;5;25;1;2;3
109;06.07.2016;2016;07;09;Keskiviikko;8;1;9;0;3;3
109;06.07.2016;2016;07;10;Keskiviikko;4;4;8;1;1;2
109;06.07.2016;2016;07;11;Keskiviikko;15;9;24;3;3;6
109;06.07.2016;2016;07;12;Keskiviikko;13;3;16;10;5;15
109;06.07.2016;2016;07;13;Keskiviikko;30;17;47;5;0;5
109;06.07.2016;2016;07;14;Keskiviikko;10;21;31;6;2;8
109;06.07.2016;2016;07;15;Keskiviikko;14;24;38;2;2;4
109;06.07.2016;2016;07;16;Keskiviikko;32;32;64;7;3;10
109;06.07.2016;2016;07;17;Keskiviikko;35;16;51;7;5;12
109;06.07.2016;2016;07;18;Keskiviikko;12;7;19;2;1;3
109;06.07.2016;2016;07;19;Keskiviikko;5;15;20;2;1;3
109;06.07.2016;2016;07;20;Keskiviikko;8;16;24;5;3;8
109;06.07.2016;2016;07;21;Keskiviikko;10;6;16;4;3;7
109;06.07.2016;2016;07;22;Keskiviikko;5;11;16;1;2;3
109;06.07.2016;2016;07;23;Keskiviikko;2;3;5;0;4;4
109;07.07.2016;2016;07;00;Torstai;3;2;5;2;0;2
109;07.07.2016;2016;07;01;Torstai;0;2;2;0;0;0
109;07.07.2016;2016;07;02;Torstai;1;0;1;0;0;0
109;07.07.2016;2016;07;03;Torstai;0;0;0;0;0;0
109;07.07.2016;2016;07;04;Torstai;1;0;1;0;0;0
109;07.07.2016;2016;07;05;Torstai;7;9;16;1;1;2
109;07.07.2016;2016;07;06;Torstai;32;7;39;1;2;3
109;07.07.2016;2016;07;07;Torstai;34;26;60;2;3;5
109;07.07.2016;2016;07;08;Torstai;27;9;36;4;0;4
109;07.07.2016;2016;07;09;Torstai;9;12;21;4;1;5
109;07.07.2016;2016;07;10;Torstai;7;5;12;1;5;6
109;07.07.2016;2016;07;11;Torstai;9;5;14;1;1;2
109;07.07.2016;2016;07;12;Torstai;10;4;14;0;0;0
109;07.07.2016;2016;07;13;Torstai;20;5;25;1;4;5
109;07.07.2016;2016;07;14;Torstai;17;10;27;4;2;6
109;07.07.2016;2016;07;15;Torstai;30;35;65;5;2;7
109;07.07.2016;2016;07;16;Torstai;29;36;65;10;8;18
109;07.07.2016;2016;07;17;Torstai;12;18;30;2;2;4
109;07.07.2016;2016;07;18;Torstai;14;16;30;2;9;11
109;07.07.2016;2016;07;19;Torstai;8;8;16;5;2;7
109;07.07.2016;2016;07;20;Torstai;6;11;17;7;7;14
109;07.07.2016;2016;07;21;Torstai;3;8;11;7;3;10
109;07.07.2016;2016;07;22;Torstai;7;8;15;3;1;4
109;07.07.2016;2016;07;23;Torstai;4;1;5;1;0;1
109;08.07.2016;2016;07;00;Perjantai;0;2;2;0;0;0
109;08.07.2016;2016;07;01;Perjantai;0;3;3;0;1;1
109;08.07.2016;2016;07;02;Perjantai;1;3;4;3;0;3
109;08.07.2016;2016;07;03;Perjantai;0;0;0;2;1;3
109;08.07.2016;2016;07;04;Perjantai;0;0;0;0;1;1
109;08.07.2016;2016;07;05;Perjantai;4;6;10;1;1;2
109;08.07.2016;2016;07;06;Perjantai;25;11;36;1;3;4
109;08.07.2016;2016;07;07;Perjantai;27;18;45;2;5;7
109;08.07.2016;2016;07;08;Perjantai;23;16;39;3;4;7
109;08.07.2016;2016;07;09;Perjantai;15;4;19;2;2;4
109;08.07.2016;2016;07;10;Perjantai;18;6;24;4;2;6
109;08.07.2016;2016;07;11;Perjantai;29;6;35;6;4;10
109;08.07.2016;2016;07;12;Perjantai;28;13;41;3;2;5
109;08.07.2016;2016;07;13;Perjantai;29;32;61;3;4;7
109;08.07.2016;2016;07;14;Perjantai;21;22;43;7;5;12
109;08.07.2016;2016;07;15;Perjantai;35;33;68;9;3;12
109;08.07.2016;2016;07;16;Perjantai;33;34;67;4;8;12
109;08.07.2016;2016;07;17;Perjantai;25;36;61;5;4;9
109;08.07.2016;2016;07;18;Perjantai;20;15;35;3;2;5
109;08.07.2016;2016;07;19;Perjantai;18;29;47;1;3;4
109;08.07.2016;2016;07;20;Perjantai;17;10;27;3;4;7
109;08.07.2016;2016;07;21;Perjantai;15;13;28;3;1;4
109;08.07.2016;2016;07;22;Perjantai;16;17;33;5;3;8
109;08.07.2016;2016;07;23;Perjantai;6;6;12;1;1;2
109;09.07.2016;2016;07;00;Lauantai;7;3;10;1;1;2
109;09.07.2016;2016;07;01;Lauantai;0;10;10;0;0;0
109;09.07.2016;2016;07;02;Lauantai;1;2;3;0;0;0
109;09.07.2016;2016;07;03;Lauantai;0;1;1;0;0;0
109;09.07.2016;2016;07;04;Lauantai;0;5;5;2;3;5
109;09.07.2016;2016;07;05;Lauantai;1;6;7;0;1;1
109;09.07.2016;2016;07;06;Lauantai;9;1;10;2;0;2
109;09.07.2016;2016;07;07;Lauantai;4;3;7;1;2;3
109;09.07.2016;2016;07;08;Lauantai;4;2;6;2;1;3
109;09.07.2016;2016;07;09;Lauantai;7;4;11;3;4;7
109;09.07.2016;2016;07;10;Lauantai;9;2;11;3;4;7
109;09.07.2016;2016;07;11;Lauantai;7;6;13;5;1;6
109;09.07.2016;2016;07;12;Lauantai;16;7;23;4;4;8
109;09.07.2016;2016;07;13;Lauantai;18;12;30;3;2;5
109;09.07.2016;2016;07;14;Lauantai;8;15;23;4;4;8
109;09.07.2016;2016;07;15;Lauantai;15;17;32;8;6;14
109;09.07.2016;2016;07;16;Lauantai;32;20;52;11;4;15
109;09.07.2016;2016;07;17;Lauantai;10;14;24;6;3;9
109;09.07.2016;2016;07;18;Lauantai;26;10;36;10;0;10
109;09.07.2016;2016;07;19;Lauantai;19;12;31;7;0;7
109;09.07.2016;2016;07;20;Lauantai;13;16;29;6;9;15
109;09.07.2016;2016;07;21;Lauantai;9;7;16;3;0;3
109;09.07.2016;2016;07;22;Lauantai;7;7;14;1;0;1
109;09.07.2016;2016;07;23;Lauantai;10;5;15;4;0;4
109;10.07.2016;2016;07;00;Sunnuntai;5;8;13;0;0;0
109;10.07.2016;2016;07;01;Sunnuntai;7;2;9;0;0;0
109;10.07.2016;2016;07;02;Sunnuntai;4;1;5;0;0;0
109;10.07.2016;2016;07;03;Sunnuntai;0;4;4;0;0;0
109;10.07.2016;2016;07;04;Sunnuntai;2;3;5;0;0;0
109;10.07.2016;2016;07;05;Sunnuntai;1;3;4;0;1;1
109;10.07.2016;2016;07;06;Sunnuntai;5;1;6;1;0;1
109;10.07.2016;2016;07;07;Sunnuntai;1;2;3;1;1;2
109;10.07.2016;2016;07;08;Sunnuntai;5;1;6;3;1;4
109;10.07.2016;2016;07;09;Sunnuntai;4;4;8;1;5;6
109;10.07.2016;2016;07;10;Sunnuntai;10;9;19;2;5;7
109;10.07.2016;2016;07;11;Sunnuntai;15;6;21;4;3;7
109;10.07.2016;2016;07;12;Sunnuntai;29;18;47;5;5;10
109;10.07.2016;2016;07;13;Sunnuntai;20;22;42;8;6;14
109;10.07.2016;2016;07;14;Sunnuntai;26;14;40;12;3;15
109;10.07.2016;2016;07;15;Sunnuntai;22;24;46;12;5;17
109;10.07.2016;2016;07;16;Sunnuntai;17;24;41;8;2;10
109;10.07.2016;2016;07;17;Sunnuntai;28;5;33;6;3;9
109;10.07.2016;2016;07;18;Sunnuntai;15;16;31;7;8;15
109;10.07.2016;2016;07;19;Sunnuntai;15;12;27;4;4;8
109;10.07.2016;2016;07;20;Sunnuntai;16;8;24;8;8;16
109;10.07.2016;2016;07;21;Sunnuntai;14;25;39;3;4;7
109;10.07.2016;2016;07;22;Sunnuntai;4;5;9;0;2;2
109;10.07.2016;2016;07;23;Sunnuntai;3;3;6;0;2;2
109;11.07.2016;2016;07;00;Maanantai;0;1;1;0;0;0
109;11.07.2016;2016;07;01;Maanantai;0;2;2;0;1;1
109;11.07.2016;2016;07;02;Maanantai;0;2;2;0;0;0
109;11.07.2016;2016;07;03;Maanantai;0;0;0;0;0;0
109;11.07.2016;2016;07;04;Maanantai;0;0;0;0;0;0
109;11.07.2016;2016;07;05;Maanantai;3;9;12;3;3;6
109;11.07.2016;2016;07;06;Maanantai;25;11;36;3;0;3
109;11.07.2016;2016;07;07;Maanantai;41;31;72;3;3;6
109;11.07.2016;2016;07;08;Maanantai;33;13;46;2;4;6
109;11.07.2016;2016;07;09;Maanantai;25;6;31;6;4;10
109;11.07.2016;2016;07;10;Maanantai;24;15;39;4;2;6
109;11.07.2016;2016;07;11;Maanantai;19;16;35;13;1;14
109;11.07.2016;2016;07;12;Maanantai;42;11;53;7;3;10
109;11.07.2016;2016;07;13;Maanantai;26;20;46;4;2;6
109;11.07.2016;2016;07;14;Maanantai;37;22;59;8;5;13
109;11.07.2016;2016;07;15;Maanantai;44;43;87;5;4;9
109;11.07.2016;2016;07;16;Maanantai;57;53;110;4;6;10
109;11.07.2016;2016;07;17;Maanantai;34;28;62;3;3;6
109;11.07.2016;2016;07;18;Maanantai;31;34;65;5;4;9
109;11.07.2016;2016;07;19;Maanantai;18;29;47;7;8;15
109;11.07.2016;2016;07;20;Maanantai;23;25;48;9;7;16
109;11.07.2016;2016;07;21;Maanantai;21;28;49;7;5;12
109;11.07.2016;2016;07;22;Maanantai;10;14;24;1;0;1
109;11.07.2016;2016;07;23;Maanantai;6;11;17;0;0;0
109;12.07.2016;2016;07;00;Tiistai;2;1;3;2;1;3
109;12.07.2016;2016;07;01;Tiistai;0;1;1;0;0;0
109;12.07.2016;2016;07;02;Tiistai;1;0;1;0;0;0
109;12.07.2016;2016;07;03;Tiistai;0;0;0;0;0;0
109;12.07.2016;2016;07;04;Tiistai;0;0;0;1;1;2
109;12.07.2016;2016;07;05;Tiistai;2;12;14;1;1;2
109;12.07.2016;2016;07;06;Tiistai;28;11;39;3;2;5
109;12.07.2016;2016;07;07;Tiistai;49;40;89;3;3;6
109;12.07.2016;2016;07;08;Tiistai;29;11;40;1;3;4
109;12.07.2016;2016;07;09;Tiistai;18;9;27;4;3;7
109;12.07.2016;2016;07;10;Tiistai;30;9;39;1;3;4
109;12.07.2016;2016;07;11;Tiistai;21;17;38;6;4;10
109;12.07.2016;2016;07;12;Tiistai;29;12;41;0;2;2
109;12.07.2016;2016;07;13;Tiistai;32;24;56;4;1;5
109;12.07.2016;2016;07;14;Tiistai;32;15;47;5;2;7
109;12.07.2016;2016;07;15;Tiistai;43;45;88;5;4;9
109;12.07.2016;2016;07;16;Tiistai;46;62;108;4;3;7
109;12.07.2016;2016;07;17;Tiistai;17;24;41;5;5;10
109;12.07.2016;2016;07;18;Tiistai;33;20;53;12;3;15
109;12.07.2016;2016;07;19;Tiistai;19;14;33;8;8;16
109;12.07.2016;2016;07;20;Tiistai;25;19;44;10;5;15
109;12.07.2016;2016;07;21;Tiistai;17;23;40;4;11;15
109;12.07.2016;2016;07;22;Tiistai;18;9;27;0;1;1
109;12.07.2016;2016;07;23;Tiistai;3;4;7;3;1;4
109;13.07.2016;2016;07;00;Keskiviikko;1;1;2;0;0;0
109;13.07.2016;2016;07;01;Keskiviikko;2;1;3;0;2;2
109;13.07.2016;2016;07;02;Keskiviikko;0;1;1;0;0;0
109;13.07.2016;2016;07;03;Keskiviikko;0;1;1;0;1;1
109;13.07.2016;2016;07;04;Keskiviikko;0;0;0;0;0;0
109;13.07.2016;2016;07;05;Keskiviikko;1;9;10;1;0;1
109;13.07.2016;2016;07;06;Keskiviikko;28;13;41;4;3;7
109;13.07.2016;2016;07;07;Keskiviikko;47;26;73;4;4;8
109;13.07.2016;2016;07;08;Keskiviikko;31;14;45;2;3;5
109;13.07.2016;2016;07;09;Keskiviikko;14;10;24;2;4;6
109;13.07.2016;2016;07;10;Keskiviikko;10;1;11;4;0;4
109;13.07.2016;2016;07;11;Keskiviikko;25;5;30;9;5;14
109;13.07.2016;2016;07;12;Keskiviikko;19;6;25;4;3;7
109;13.07.2016;2016;07;13;Keskiviikko;30;16;46;2;2;4
109;13.07.2016;2016;07;14;Keskiviikko;39;23;62;3;0;3
109;13.07.2016;2016;07;15;Keskiviikko;39;47;86;8;5;13
109;13.07.2016;2016;07;16;Keskiviikko;46;50;96;8;3;11
109;13.07.2016;2016;07;17;Keskiviikko;25;25;50;4;4;8
109;13.07.2016;2016;07;18;Keskiviikko;33;28;61;12;5;17
109;13.07.2016;2016;07;19;Keskiviikko;26;20;46;3;4;7
109;13.07.2016;2016;07;20;Keskiviikko;34;23;57;4;2;6
109;13.07.2016;2016;07;21;Keskiviikko;16;27;43;1;3;4
109;13.07.2016;2016;07;22;Keskiviikko;15;8;23;5;1;6
109;13.07.2016;2016;07;23;Keskiviikko;4;9;13;0;1;1
109;14.07.2016;2016;07;00;Torstai;2;9;11;0;0;0
109;14.07.2016;2016;07;01;Torstai;1;5;6;2;1;3
109;14.07.2016;2016;07;02;Torstai;1;2;3;0;0;0
109;14.07.2016;2016;07;03;Torstai;0;4;4;0;0;0
109;14.07.2016;2016;07;04;Torstai;1;2;3;0;0;0
109;14.07.2016;2016;07;05;Torstai;3;16;19;1;1;2
109;14.07.2016;2016;07;06;Torstai;22;10;32;5;2;7
109;14.07.2016;2016;07;07;Torstai;42;26;68;2;2;4
109;14.07.2016;2016;07;08;Torstai;38;17;55;2;2;4
109;14.07.2016;2016;07;09;Torstai;12;8;20;2;3;5
109;14.07.2016;2016;07;10;Torstai;23;18;41;1;3;4
109;14.07.2016;2016;07;11;Torstai;16;7;23;2;1;3
109;14.07.2016;2016;07;12;Torstai;37;18;55;7;4;11
109;14.07.2016;2016;07;13;Torstai;22;25;47;3;3;6
109;14.07.2016;2016;07;14;Torstai;35;23;58;3;1;4
109;14.07.2016;2016;07;15;Torstai;39;45;84;6;7;13
109;14.07.2016;2016;07;16;Torstai;53;45;98;6;1;7
109;14.07.2016;2016;07;17;Torstai;37;23;60;2;2;4
109;14.07.2016;2016;07;18;Torstai;37;32;69;2;5;7
109;14.07.2016;2016;07;19;Torstai;19;22;41;4;3;7
109;14.07.2016;2016;07;20;Torstai;23;12;35;5;1;6
109;14.07.2016;2016;07;21;Torstai;13;27;40;5;2;7
109;14.07.2016;2016;07;22;Torstai;7;10;17;2;0;2
109;14.07.2016;2016;07;23;Torstai;8;9;17;0;1;1
109;15.07.2016;2016;07;00;Perjantai;5;10;15;0;2;2
109;15.07.2016;2016;07;01;Perjantai;0;5;5;2;0;2
109;15.07.2016;2016;07;02;Perjantai;1;3;4;1;0;1
109;15.07.2016;2016;07;03;Perjantai;0;1;1;0;0;0
109;15.07.2016;2016;07;04;Perjantai;0;1;1;0;0;0
109;15.07.2016;2016;07;05;Perjantai;2;10;12;1;1;2
109;15.07.2016;2016;07;06;Perjantai;18;15;33;1;4;5
109;15.07.2016;2016;07;07;Perjantai;33;24;57;3;2;5
109;15.07.2016;2016;07;08;Perjantai;26;5;31;1;1;2
109;15.07.2016;2016;07;09;Perjantai;16;10;26;5;4;9
109;15.07.2016;2016;07;10;Perjantai;13;5;18;4;3;7
109;15.07.2016;2016;07;11;Perjantai;8;9;17;4;3;7
109;15.07.2016;2016;07;12;Perjantai;19;20;39;6;3;9
109;15.07.2016;2016;07;13;Perjantai;31;17;48;4;6;10
109;15.07.2016;2016;07;14;Perjantai;23;28;51;6;1;7
109;15.07.2016;2016;07;15;Perjantai;22;22;44;5;2;7
109;15.07.2016;2016;07;16;Perjantai;25;23;48;4;3;7
109;15.07.2016;2016;07;17;Perjantai;21;15;36;4;2;6
109;15.07.2016;2016;07;18;Perjantai;17;9;26;3;1;4
109;15.07.2016;2016;07;19;Perjantai;18;14;32;3;3;6
109;15.07.2016;2016;07;20;Perjantai;16;15;31;8;6;14
109;15.07.2016;2016;07;21;Perjantai;14;18;32;4;3;7
109;15.07.2016;2016;07;22;Perjantai;13;3;16;2;1;3
109;15.07.2016;2016;07;23;Perjantai;3;7;10;0;1;1
109;16.07.2016;2016;07;00;Lauantai;2;3;5;1;0;1
109;16.07.2016;2016;07;01;Lauantai;1;4;5;2;1;3
109;16.07.2016;2016;07;02;Lauantai;5;2;7;0;0;0
109;16.07.2016;2016;07;03;Lauantai;0;3;3;0;0;0
109;16.07.2016;2016;07;04;Lauantai;0;5;5;0;0;0
109;16.07.2016;2016;07;05;Lauantai;2;0;2;1;0;1
109;16.07.2016;2016;07;06;Lauantai;4;2;6;2;2;4
109;16.07.2016;2016;07;07;Lauantai;2;1;3;0;1;1
109;16.07.2016;2016;07;08;Lauantai;4;2;6;1;1;2
109;16.07.2016;2016;07;09;Lauantai;11;1;12;3;2;5
109;16.07.2016;2016;07;10;Lauantai;6;7;13;3;2;5
109;16.07.2016;2016;07;11;Lauantai;5;1;6;11;2;13
109;16.07.2016;2016;07;12;Lauantai;2;3;5;4;2;6
109;16.07.2016;2016;07;13;Lauantai;5;8;13;1;4;5
109;16.07.2016;2016;07;14;Lauantai;3;2;5;3;2;5
109;16.07.2016;2016;07;15;Lauantai;3;6;9;1;4;5
109;16.07.2016;2016;07;16;Lauantai;13;9;22;2;3;5
109;16.07.2016;2016;07;17;Lauantai;6;5;11;4;3;7
109;16.07.2016;2016;07;18;Lauantai;20;9;29;7;9;16
109;16.07.2016;2016;07;19;Lauantai;11;4;15;7;6;13
109;16.07.2016;2016;07;20;Lauantai;17;13;30;3;6;9
109;16.07.2016;2016;07;21;Lauantai;6;8;14;5;2;7
109;16.07.2016;2016;07;22;Lauantai;12;7;19;3;2;5
109;16.07.2016;2016;07;23;Lauantai;8;2;10;2;1;3
109;17.07.2016;2016;07;00;Sunnuntai;4;8;12;1;0;1
109;17.07.2016;2016;07;01;Sunnuntai;1;3;4;1;2;3
109;17.07.2016;2016;07;02;Sunnuntai;1;6;7;2;0;2
109;17.07.2016;2016;07;03;Sunnuntai;0;1;1;0;0;0
109;17.07.2016;2016;07;04;Sunnuntai;0;2;2;0;0;0
109;17.07.2016;2016;07;05;Sunnuntai;1;1;2;0;0;0
109;17.07.2016;2016;07;06;Sunnuntai;3;0;3;3;0;3
109;17.07.2016;2016;07;07;Sunnuntai;3;2;5;3;3;6
109;17.07.2016;2016;07;08;Sunnuntai;5;7;12;1;2;3
109;17.07.2016;2016;07;09;Sunnuntai;5;3;8;1;3;4
109;17.07.2016;2016;07;10;Sunnuntai;11;5;16;1;3;4
109;17.07.2016;2016;07;11;Sunnuntai;12;7;19;4;3;7
109;17.07.2016;2016;07;12;Sunnuntai;14;6;20;4;2;6
109;17.07.2016;2016;07;13;Sunnuntai;6;9;15;5;9;14
109;17.07.2016;2016;07;14;Sunnuntai;8;7;15;1;3;4
109;17.07.2016;2016;07;15;Sunnuntai;17;12;29;3;2;5
109;17.07.2016;2016;07;16;Sunnuntai;3;5;8;1;1;2
109;17.07.2016;2016;07;17;Sunnuntai;10;5;15;2;2;4
109;17.07.2016;2016;07;18;Sunnuntai;11;8;19;5;4;9
109;17.07.2016;2016;07;19;Sunnuntai;17;10;27;4;5;9
109;17.07.2016;2016;07;20;Sunnuntai;17;16;33;4;7;11
109;17.07.2016;2016;07;21;Sunnuntai;11;10;21;4;4;8
109;17.07.2016;2016;07;22;Sunnuntai;1;6;7;2;0;2
109;17.07.2016;2016;07;23;Sunnuntai;0;4;4;1;2;3
109;18.07.2016;2016;07;00;Maanantai;0;0;0;0;0;0
109;18.07.2016;2016;07;01;Maanantai;2;1;3;0;0;0
109;18.07.2016;2016;07;02;Maanantai;0;0;0;0;2;2
109;18.07.2016;2016;07;03;Maanantai;0;0;0;0;2;2
109;18.07.2016;2016;07;04;Maanantai;1;0;1;0;0;0
109;18.07.2016;2016;07;05;Maanantai;1;11;12;0;1;1
109;18.07.2016;2016;07;06;Maanantai;29;13;42;3;1;4
109;18.07.2016;2016;07;07;Maanantai;34;24;58;3;1;4
109;18.07.2016;2016;07;08;Maanantai;35;7;42;3;4;7
109;18.07.2016;2016;07;09;Maanantai;20;9;29;4;3;7
109;18.07.2016;2016;07;10;Maanantai;11;5;16;1;1;2
109;18.07.2016;2016;07;11;Maanantai;15;6;21;2;0;2
109;18.07.2016;2016;07;12;Maanantai;14;15;29;5;0;5
109;18.07.2016;2016;07;13;Maanantai;29;27;56;4;1;5
109;18.07.2016;2016;07;14;Maanantai;34;24;58;6;5;11
109;18.07.2016;2016;07;15;Maanantai;33;42;75;4;4;8
109;18.07.2016;2016;07;16;Maanantai;39;52;91;6;6;12
109;18.07.2016;2016;07;17;Maanantai;21;29;50;8;2;10
109;18.07.2016;2016;07;18;Maanantai;27;23;50;9;5;14
109;18.07.2016;2016;07;19;Maanantai;33;34;67;8;5;13
109;18.07.2016;2016;07;20;Maanantai;16;12;28;3;4;7
109;18.07.2016;2016;07;21;Maanantai;11;19;30;2;3;5
109;18.07.2016;2016;07;22;Maanantai;6;13;19;3;2;5
109;18.07.2016;2016;07;23;Maanantai;6;4;10;1;0;1
109;19.07.2016;2016;07;00;Tiistai;3;1;4;0;0;0
109;19.07.2016;2016;07;01;Tiistai;0;3;3;0;1;1
109;19.07.2016;2016;07;02;Tiistai;0;2;2;0;0;0
109;19.07.2016;2016;07;03;Tiistai;0;0;0;0;0;0
109;19.07.2016;2016;07;04;Tiistai;1;3;4;0;0;0
109;19.07.2016;2016;07;05;Tiistai;3;12;15;0;1;1
109;19.07.2016;2016;07;06;Tiistai;27;7;34;2;3;5
109;19.07.2016;2016;07;07;Tiistai;46;31;77;3;2;5
109;19.07.2016;2016;07;08;Tiistai;26;9;35;4;2;6
109;19.07.2016;2016;07;09;Tiistai;21;7;28;2;5;7
109;19.07.2016;2016;07;10;Tiistai;20;10;30;3;0;3
109;19.07.2016;2016;07;11;Tiistai;20;6;26;5;2;7
109;19.07.2016;2016;07;12;Tiistai;34;15;49;0;5;5
109;19.07.2016;2016;07;13;Tiistai;24;29;53;4;3;7
109;19.07.2016;2016;07;14;Tiistai;32;17;49;7;1;8
109;19.07.2016;2016;07;15;Tiistai;35;47;82;5;5;10
109;19.07.2016;2016;07;16;Tiistai;48;42;90;6;6;12
109;19.07.2016;2016;07;17;Tiistai;35;27;62;6;3;9
109;19.07.2016;2016;07;18;Tiistai;20;32;52;5;3;8
109;19.07.2016;2016;07;19;Tiistai;20;27;47;8;3;11
109;19.07.2016;2016;07;20;Tiistai;23;25;48;6;4;10
109;19.07.2016;2016;07;21;Tiistai;13;21;34;11;6;17
109;19.07.2016;2016;07;22;Tiistai;12;26;38;3;3;6
109;19.07.2016;2016;07;23;Tiistai;9;1;10;0;1;1
109;20.07.2016;2016;07;00;Keskiviikko;2;1;3;1;0;1
109;20.07.2016;2016;07;01;Keskiviikko;0;4;4;0;2;2
109;20.07.2016;2016;07;02;Keskiviikko;0;2;2;0;0;0
109;20.07.2016;2016;07;03;Keskiviikko;0;0;0;0;0;0
109;20.07.2016;2016;07;04;Keskiviikko;1;1;2;0;0;0
109;20.07.2016;2016;07;05;Keskiviikko;2;10;12;0;2;2
109;20.07.2016;2016;07;06;Keskiviikko;24;9;33;2;0;2
109;20.07.2016;2016;07;07;Keskiviikko;46;26;72;4;2;6
109;20.07.2016;2016;07;08;Keskiviikko;29;17;46;1;2;3
109;20.07.2016;2016;07;09;Keskiviikko;17;5;22;3;4;7
109;20.07.2016;2016;07;10;Keskiviikko;26;5;31;2;4;6
109;20.07.2016;2016;07;11;Keskiviikko;14;9;23;5;2;7
109;20.07.2016;2016;07;12;Keskiviikko;33;18;51;3;2;5
109;20.07.2016;2016;07;13;Keskiviikko;38;18;56;4;5;9
109;20.07.2016;2016;07;14;Keskiviikko;36;27;63;7;6;13
109;20.07.2016;2016;07;15;Keskiviikko;23;44;67;4;0;4
109;20.07.2016;2016;07;16;Keskiviikko;48;50;98;6;5;11
109;20.07.2016;2016;07;17;Keskiviikko;26;16;42;10;8;18
109;20.07.2016;2016;07;18;Keskiviikko;38;24;62;4;4;8
109;20.07.2016;2016;07;19;Keskiviikko;26;33;59;11;3;14
109;20.07.2016;2016;07;20;Keskiviikko;26;28;54;1;6;7
109;20.07.2016;2016;07;21;Keskiviikko;15;22;37;3;5;8
109;20.07.2016;2016;07;22;Keskiviikko;9;14;23;1;1;2
109;20.07.2016;2016;07;23;Keskiviikko;5;8;13;1;1;2
109;21.07.2016;2016;07;00;Torstai;1;5;6;0;0;0
109;21.07.2016;2016;07;01;Torstai;3;6;9;0;1;1
109;21.07.2016;2016;07;02;Torstai;0;3;3;0;0;0
109;21.07.2016;2016;07;03;Torstai;0;0;0;0;0;0
109;21.07.2016;2016;07;04;Torstai;1;4;5;0;0;0
109;21.07.2016;2016;07;05;Torstai;0;12;12;1;0;1
109;21.07.2016;2016;07;06;Torstai;25;7;32;2;3;5
109;21.07.2016;2016;07;07;Torstai;42;24;66;2;1;3
109;21.07.2016;2016;07;08;Torstai;27;13;40;1;1;2
109;21.07.2016;2016;07;09;Torstai;25;5;30;1;4;5
109;21.07.2016;2016;07;10;Torstai;20;7;27;5;4;9
109;21.07.2016;2016;07;11;Torstai;23;11;34;6;3;9
109;21.07.2016;2016;07;12;Torstai;19;18;37;4;1;5
109;21.07.2016;2016;07;13;Torstai;35;21;56;3;4;7
109;21.07.2016;2016;07;14;Torstai;29;27;56;4;0;4
109;21.07.2016;2016;07;15;Torstai;40;40;80;5;4;9
109;21.07.2016;2016;07;16;Torstai;58;51;109;5;4;9
109;21.07.2016;2016;07;17;Torstai;35;25;60;6;3;9
109;21.07.2016;2016;07;18;Torstai;51;22;73;6;2;8
109;21.07.2016;2016;07;19;Torstai;23;16;39;6;1;7
109;21.07.2016;2016;07;20;Torstai;8;30;38;11;1;12
109;21.07.2016;2016;07;21;Torstai;15;29;44;8;5;13
109;21.07.2016;2016;07;22;Torstai;13;10;23;3;1;4
109;21.07.2016;2016;07;23;Torstai;7;3;10;1;1;2
109;22.07.2016;2016;07;00;Perjantai;1;3;4;1;0;1
109;22.07.2016;2016;07;01;Perjantai;1;3;4;0;2;2
109;22.07.2016;2016;07;02;Perjantai;0;3;3;0;0;0
109;22.07.2016;2016;07;03;Perjantai;0;0;0;0;1;1
109;22.07.2016;2016;07;04;Perjantai;0;1;1;0;0;0
109;22.07.2016;2016;07;05;Perjantai;0;9;9;1;1;2
109;22.07.2016;2016;07;06;Perjantai;18;8;26;3;3;6
109;22.07.2016;2016;07;07;Perjantai;43;24;67;3;0;3
109;22.07.2016;2016;07;08;Perjantai;28;15;43;0;4;4
109;22.07.2016;2016;07;09;Perjantai;25;12;37;3;3;6
109;22.07.2016;2016;07;10;Perjantai;22;8;30;1;2;3
109;22.07.2016;2016;07;11;Perjantai;33;24;57;6;1;7
109;22.07.2016;2016;07;12;Perjantai;26;19;45;2;3;5
109;22.07.2016;2016;07;13;Perjantai;34;20;54;6;4;10
109;22.07.2016;2016;07;14;Perjantai;27;16;43;5;1;6
109;22.07.2016;2016;07;15;Perjantai;44;46;90;8;2;10
109;22.07.2016;2016;07;16;Perjantai;33;24;57;1;2;3
109;22.07.2016;2016;07;17;Perjantai;37;25;62;4;1;5
109;22.07.2016;2016;07;18;Perjantai;30;19;49;4;5;9
109;22.07.2016;2016;07;19;Perjantai;31;20;51;7;3;10
109;22.07.2016;2016;07;20;Perjantai;20;26;46;7;2;9
109;22.07.2016;2016;07;21;Perjantai;7;22;29;0;2;2
109;22.07.2016;2016;07;22;Perjantai;19;5;24;2;0;2
109;22.07.2016;2016;07;23;Perjantai;6;16;22;3;1;4
109;23.07.2016;2016;07;00;Lauantai;0;7;7;1;0;1
109;23.07.2016;2016;07;01;Lauantai;4;6;10;1;0;1
109;23.07.2016;2016;07;02;Lauantai;0;2;2;0;0;0
109;23.07.2016;2016;07;03;Lauantai;1;2;3;2;0;2
109;23.07.2016;2016;07;04;Lauantai;3;6;9;0;1;1
109;23.07.2016;2016;07;05;Lauantai;1;1;2;0;0;0
109;23.07.2016;2016;07;06;Lauantai;6;2;8;2;2;4
109;23.07.2016;2016;07;07;Lauantai;0;4;4;2;2;4
109;23.07.2016;2016;07;08;Lauantai;4;6;10;1;0;1
109;23.07.2016;2016;07;09;Lauantai;11;3;14;2;3;5
109;23.07.2016;2016;07;10;Lauantai;24;7;31;4;2;6
109;23.07.2016;2016;07;11;Lauantai;19;10;29;5;3;8
109;23.07.2016;2016;07;12;Lauantai;25;10;35;4;3;7
109;23.07.2016;2016;07;13;Lauantai;29;20;49;3;1;4
109;23.07.2016;2016;07;14;Lauantai;28;24;52;8;1;9
109;23.07.2016;2016;07;15;Lauantai;24;19;43;3;1;4
109;23.07.2016;2016;07;16;Lauantai;27;20;47;5;1;6
109;23.07.2016;2016;07;17;Lauantai;28;6;34;3;5;8
109;23.07.2016;2016;07;18;Lauantai;20;19;39;3;1;4
109;23.07.2016;2016;07;19;Lauantai;20;14;34;2;4;6
109;23.07.2016;2016;07;20;Lauantai;9;26;35;6;7;13
109;23.07.2016;2016;07;21;Lauantai;7;32;39;0;4;4
109;23.07.2016;2016;07;22;Lauantai;7;9;16;4;2;6
109;23.07.2016;2016;07;23;Lauantai;1;3;4;1;0;1
109;24.07.2016;2016;07;00;Sunnuntai;4;10;14;2;4;6
109;24.07.2016;2016;07;01;Sunnuntai;6;5;11;0;0;0
109;24.07.2016;2016;07;02;Sunnuntai;1;6;7;1;0;1
109;24.07.2016;2016;07;03;Sunnuntai;0;2;2;0;0;0
109;24.07.2016;2016;07;04;Sunnuntai;2;3;5;0;0;0
109;24.07.2016;2016;07;05;Sunnuntai;0;1;1;0;1;1
109;24.07.2016;2016;07;06;Sunnuntai;5;4;9;0;0;0
109;24.07.2016;2016;07;07;Sunnuntai;4;4;8;0;0;0
109;24.07.2016;2016;07;08;Sunnuntai;9;4;13;4;5;9
109;24.07.2016;2016;07;09;Sunnuntai;8;7;15;5;9;14
109;24.07.2016;2016;07;10;Sunnuntai;16;6;22;10;0;10
109;24.07.2016;2016;07;11;Sunnuntai;20;6;26;1;3;4
109;24.07.2016;2016;07;12;Sunnuntai;42;19;61;2;4;6
109;24.07.2016;2016;07;13;Sunnuntai;30;10;40;6;1;7
109;24.07.2016;2016;07;14;Sunnuntai;36;14;50;3;0;3
109;24.07.2016;2016;07;15;Sunnuntai;30;24;54;7;5;12
109;24.07.2016;2016;07;16;Sunnuntai;23;24;47;3;3;6
109;24.07.2016;2016;07;17;Sunnuntai;26;21;47;3;2;5
109;24.07.2016;2016;07;18;Sunnuntai;37;28;65;3;5;8
109;24.07.2016;2016;07;19;Sunnuntai;28;25;53;3;4;7
109;24.07.2016;2016;07;20;Sunnuntai;19;11;30;5;6;11
109;24.07.2016;2016;07;21;Sunnuntai;7;22;29;2;3;5
109;24.07.2016;2016;07;22;Sunnuntai;5;12;17;2;5;7
109;24.07.2016;2016;07;23;Sunnuntai;4;3;7;2;0;2
109;25.07.2016;2016;07;00;Maanantai;1;2;3;0;0;0
109;25.07.2016;2016;07;01;Maanantai;1;1;2;0;1;1
109;25.07.2016;2016;07;02;Maanantai;0;4;4;0;0;0
109;25.07.2016;2016;07;03;Maanantai;0;0;0;0;0;0
109;25.07.2016;2016;07;04;Maanantai;1;0;1;0;0;0
109;25.07.2016;2016;07;05;Maanantai;4;11;15;2;4;6
109;25.07.2016;2016;07;06;Maanantai;23;13;36;3;2;5
109;25.07.2016;2016;07;07;Maanantai;45;27;72;1;0;1
109;25.07.2016;2016;07;08;Maanantai;33;13;46;5;1;6
109;25.07.2016;2016;07;09;Maanantai;18;6;24;2;1;3
109;25.07.2016;2016;07;10;Maanantai;21;11;32;4;3;7
109;25.07.2016;2016;07;11;Maanantai;20;13;33;5;3;8
109;25.07.2016;2016;07;12;Maanantai;30;26;56;0;1;1
109;25.07.2016;2016;07;13;Maanantai;44;25;69;5;5;10
109;25.07.2016;2016;07;14;Maanantai;29;26;55;6;5;11
109;25.07.2016;2016;07;15;Maanantai;47;49;96;7;5;12
109;25.07.2016;2016;07;16;Maanantai;51;54;105;3;6;9
109;25.07.2016;2016;07;17;Maanantai;32;28;60;3;2;5
109;25.07.2016;2016;07;18;Maanantai;37;29;66;1;3;4
109;25.07.2016;2016;07;19;Maanantai;26;17;43;4;4;8
109;25.07.2016;2016;07;20;Maanantai;14;22;36;5;9;14
109;25.07.2016;2016;07;21;Maanantai;10;30;40;4;3;7
109;25.07.2016;2016;07;22;Maanantai;13;10;23;2;2;4
109;25.07.2016;2016;07;23;Maanantai;5;10;15;1;0;1
109;26.07.2016;2016;07;00;Tiistai;0;3;3;3;1;4
109;26.07.2016;2016;07;01;Tiistai;0;2;2;0;1;1
109;26.07.2016;2016;07;02;Tiistai;0;0;0;0;0;0
109;26.07.2016;2016;07;03;Tiistai;3;2;5;1;0;1
109;26.07.2016;2016;07;04;Tiistai;0;0;0;0;1;1
109;26.07.2016;2016;07;05;Tiistai;3;11;14;2;1;3
109;26.07.2016;2016;07;06;Tiistai;27;13;40;5;2;7
109;26.07.2016;2016;07;07;Tiistai;56;31;87;4;4;8
109;26.07.2016;2016;07;08;Tiistai;32;10;42;4;0;4
109;26.07.2016;2016;07;09;Tiistai;24;14;38;6;2;8
109;26.07.2016;2016;07;10;Tiistai;23;12;35;1;7;8
109;26.07.2016;2016;07;11;Tiistai;25;11;36;5;2;7
109;26.07.2016;2016;07;12;Tiistai;41;27;68;8;7;15
109;26.07.2016;2016;07;13;Tiistai;32;20;52;2;3;5
109;26.07.2016;2016;07;14;Tiistai;36;25;61;8;6;14
109;26.07.2016;2016;07;15;Tiistai;41;49;90;4;6;10
109;26.07.2016;2016;07;16;Tiistai;51;68;119;6;2;8
109;26.07.2016;2016;07;17;Tiistai;48;32;80;10;4;14
109;26.07.2016;2016;07;18;Tiistai;27;28;55;3;3;6
109;26.07.2016;2016;07;19;Tiistai;33;35;68;4;3;7
109;26.07.2016;2016;07;20;Tiistai;30;20;50;5;7;12
109;26.07.2016;2016;07;21;Tiistai;16;38;54;6;5;11
109;26.07.2016;2016;07;22;Tiistai;6;12;18;2;1;3
109;26.07.2016;2016;07;23;Tiistai;3;8;11;0;2;2
109;27.07.2016;2016;07;00;Keskiviikko;1;6;7;0;0;0
109;27.07.2016;2016;07;01;Keskiviikko;0;1;1;0;1;1
109;27.07.2016;2016;07;02;Keskiviikko;0;4;4;0;0;0
109;27.07.2016;2016;07;03;Keskiviikko;0;1;1;0;0;0
109;27.07.2016;2016;07;04;Keskiviikko;1;0;1;2;0;2
109;27.07.2016;2016;07;05;Keskiviikko;5;8;13;1;1;2
109;27.07.2016;2016;07;06;Keskiviikko;31;7;38;3;1;4
109;27.07.2016;2016;07;07;Keskiviikko;40;28;68;1;3;4
109;27.07.2016;2016;07;08;Keskiviikko;24;13;37;2;0;2
109;27.07.2016;2016;07;09;Keskiviikko;3;2;5;0;0;0
109;27.07.2016;2016;07;10;Keskiviikko;7;4;11;1;1;2
109;27.07.2016;2016;07;11;Keskiviikko;16;5;21;3;4;7
109;27.07.2016;2016;07;12;Keskiviikko;14;8;22;5;1;6
109;27.07.2016;2016;07;13;Keskiviikko;25;29;54;4;2;6
109;27.07.2016;2016;07;14;Keskiviikko;24;16;40;3;5;8
109;27.07.2016;2016;07;15;Keskiviikko;34;37;71;7;1;8
109;27.07.2016;2016;07;16;Keskiviikko;38;40;78;3;3;6
109;27.07.2016;2016;07;17;Keskiviikko;27;20;47;5;4;9
109;27.07.2016;2016;07;18;Keskiviikko;28;20;48;3;6;9
109;27.07.2016;2016;07;19;Keskiviikko;27;16;43;8;3;11
109;27.07.2016;2016;07;20;Keskiviikko;19;22;41;11;5;16
109;27.07.2016;2016;07;21;Keskiviikko;4;21;25;0;4;4
109;27.07.2016;2016;07;22;Keskiviikko;12;14;26;0;0;0
109;27.07.2016;2016;07;23;Keskiviikko;4;14;18;0;0;0
109;28.07.2016;2016;07;00;Torstai;4;5;9;0;1;1
109;28.07.2016;2016;07;01;Torstai;0;2;2;0;0;0
109;28.07.2016;2016;07;02;Torstai;1;3;4;0;1;1
109;28.07.2016;2016;07;03;Torstai;1;2;3;0;0;0
109;28.07.2016;2016;07;04;Torstai;1;2;3;0;0;0
109;28.07.2016;2016;07;05;Torstai;4;4;8;1;2;3
109;28.07.2016;2016;07;06;Torstai;28;11;39;1;3;4
109;28.07.2016;2016;07;07;Torstai;47;23;70;4;7;11
109;28.07.2016;2016;07;08;Torstai;38;15;53;3;1;4
109;28.07.2016;2016;07;09;Torstai;21;8;29;3;3;6
109;28.07.2016;2016;07;10;Torstai;21;17;38;9;7;16
109;28.07.2016;2016;07;11;Torstai;16;17;33;5;5;10
109;28.07.2016;2016;07;12;Torstai;28;14;42;4;2;6
109;28.07.2016;2016;07;13;Torstai;29;23;52;4;2;6
109;28.07.2016;2016;07;14;Torstai;27;22;49;7;4;11
109;28.07.2016;2016;07;15;Torstai;36;47;83;8;10;18
109;28.07.2016;2016;07;16;Torstai;46;58;104;4;2;6
109;28.07.2016;2016;07;17;Torstai;35;27;62;3;5;8
109;28.07.2016;2016;07;18;Torstai;19;20;39;5;1;6
109;28.07.2016;2016;07;19;Torstai;14;16;30;1;2;3
109;28.07.2016;2016;07;20;Torstai;14;22;36;1;2;3
109;28.07.2016;2016;07;21;Torstai;14;24;38;6;4;10
109;28.07.2016;2016;07;22;Torstai;15;13;28;0;1;1
109;28.07.2016;2016;07;23;Torstai;14;12;26;1;0;1
109;29.07.2016;2016;07;00;Perjantai;0;3;3;1;0;1
109;29.07.2016;2016;07;01;Perjantai;0;1;1;0;0;0
109;29.07.2016;2016;07;02;Perjantai;0;0;0;0;0;0
109;29.07.2016;2016;07;03;Perjantai;0;0;0;0;0;0
109;29.07.2016;2016;07;04;Perjantai;0;0;0;0;0;0
109;29.07.2016;2016;07;05;Perjantai;3;8;11;1;1;2
109;29.07.2016;2016;07;06;Perjantai;22;6;28;3;2;5
109;29.07.2016;2016;07;07;Perjantai;45;20;65;7;3;10
109;29.07.2016;2016;07;08;Perjantai;30;9;39;2;0;2
109;29.07.2016;2016;07;09;Perjantai;15;10;25;4;0;4
109;29.07.2016;2016;07;10;Perjantai;21;6;27;2;0;2
109;29.07.2016;2016;07;11;Perjantai;21;20;41;1;3;4
109;29.07.2016;2016;07;12;Perjantai;38;11;49;10;6;16
109;29.07.2016;2016;07;13;Perjantai;25;13;38;3;3;6
109;29.07.2016;2016;07;14;Perjantai;28;25;53;3;1;4
109;29.07.2016;2016;07;15;Perjantai;37;35;72;2;2;4
109;29.07.2016;2016;07;16;Perjantai;62;31;93;8;3;11
109;29.07.2016;2016;07;17;Perjantai;24;14;38;2;2;4
109;29.07.2016;2016;07;18;Perjantai;44;14;58;8;1;9
109;29.07.2016;2016;07;19;Perjantai;47;11;58;1;2;3
109;29.07.2016;2016;07;20;Perjantai;21;17;38;6;2;8
109;29.07.2016;2016;07;21;Perjantai;18;14;32;2;1;3
109;29.07.2016;2016;07;22;Perjantai;9;14;23;0;1;1
109;29.07.2016;2016;07;23;Perjantai;3;17;20;0;0;0
109;30.07.2016;2016;07;00;Lauantai;5;16;21;1;5;6
109;30.07.2016;2016;07;01;Lauantai;0;38;38;1;1;2
109;30.07.2016;2016;07;02;Lauantai;0;19;19;0;1;1
109;30.07.2016;2016;07;03;Lauantai;0;19;19;3;7;10
109;30.07.2016;2016;07;04;Lauantai;0;2;2;0;0;0
109;30.07.2016;2016;07;05;Lauantai;1;4;5;1;0;1
109;30.07.2016;2016;07;06;Lauantai;6;2;8;0;1;1
109;30.07.2016;2016;07;07;Lauantai;4;3;7;1;3;4
109;30.07.2016;2016;07;08;Lauantai;8;2;10;2;2;4
109;30.07.2016;2016;07;09;Lauantai;12;4;16;2;6;8
109;30.07.2016;2016;07;10;Lauantai;18;6;24;4;1;5
109;30.07.2016;2016;07;11;Lauantai;15;19;34;8;2;10
109;30.07.2016;2016;07;12;Lauantai;52;13;65;4;4;8
109;30.07.2016;2016;07;13;Lauantai;33;16;49;3;4;7
109;30.07.2016;2016;07;14;Lauantai;58;17;75;6;5;11
109;30.07.2016;2016;07;15;Lauantai;16;16;32;1;1;2
109;30.07.2016;2016;07;16;Lauantai;8;10;18;0;5;5
109;30.07.2016;2016;07;17;Lauantai;13;17;30;3;3;6
109;30.07.2016;2016;07;18;Lauantai;18;7;25;4;3;7
109;30.07.2016;2016;07;19;Lauantai;19;15;34;4;2;6
109;30.07.2016;2016;07;20;Lauantai;37;13;50;3;1;4
109;30.07.2016;2016;07;21;Lauantai;19;15;34;5;3;8
109;30.07.2016;2016;07;22;Lauantai;9;8;17;0;2;2
109;30.07.2016;2016;07;23;Lauantai;11;9;20;0;0;0
109;31.07.2016;2016;07;00;Sunnuntai;4;9;13;2;0;2
109;31.07.2016;2016;07;01;Sunnuntai;1;27;28;0;1;1
109;31.07.2016;2016;07;02;Sunnuntai;5;15;20;2;1;3
109;31.07.2016;2016;07;03;Sunnuntai;0;5;5;0;0;0
109;31.07.2016;2016;07;04;Sunnuntai;1;4;5;0;3;3
109;31.07.2016;2016;07;05;Sunnuntai;1;7;8;0;1;1
109;31.07.2016;2016;07;06;Sunnuntai;4;2;6;1;0;1
109;31.07.2016;2016;07;07;Sunnuntai;3;5;8;2;1;3
109;31.07.2016;2016;07;08;Sunnuntai;3;4;7;2;3;5
109;31.07.2016;2016;07;09;Sunnuntai;7;10;17;2;6;8
109;31.07.2016;2016;07;10;Sunnuntai;7;2;9;3;2;5
109;31.07.2016;2016;07;11;Sunnuntai;14;2;16;7;2;9
109;31.07.2016;2016;07;12;Sunnuntai;7;2;9;3;3;6
109;31.07.2016;2016;07;13;Sunnuntai;5;9;14;3;1;4
109;31.07.2016;2016;07;14;Sunnuntai;11;5;16;7;3;10
109;31.07.2016;2016;07;15;Sunnuntai;15;11;26;2;3;5
109;31.07.2016;2016;07;16;Sunnuntai;16;7;23;6;4;10
109;31.07.2016;2016;07;17;Sunnuntai;10;6;16;10;7;17
109;31.07.2016;2016;07;18;Sunnuntai;14;7;21;3;0;3
109;31.07.2016;2016;07;19;Sunnuntai;3;6;9;3;4;7
109;31.07.2016;2016;07;20;Sunnuntai;4;4;8;5;6;11
109;31.07.2016;2016;07;21;Sunnuntai;5;10;15;3;5;8
109;31.07.2016;2016;07;22;Sunnuntai;1;4;5;1;3;4
109;31.07.2016;2016;07;23;Sunnuntai;4;1;5;0;0;0
109;01.08.2016;2016;08;00;Maanantai;1;4;5;0;0;0
109;01.08.2016;2016;08;01;Maanantai;0;0;0;0;1;1
109;01.08.2016;2016;08;02;Maanantai;1;0;1;0;0;0
109;01.08.2016;2016;08;03;Maanantai;0;0;0;0;0;0
109;01.08.2016;2016;08;04;Maanantai;0;0;0;0;0;0
109;01.08.2016;2016;08;05;Maanantai;4;7;11;1;1;2
109;01.08.2016;2016;08;06;Maanantai;35;11;46;1;2;3
109;01.08.2016;2016;08;07;Maanantai;62;21;83;1;2;3
109;01.08.2016;2016;08;08;Maanantai;42;15;57;3;3;6
109;01.08.2016;2016;08;09;Maanantai;23;10;33;4;1;5
109;01.08.2016;2016;08;10;Maanantai;15;15;30;3;4;7
109;01.08.2016;2016;08;11;Maanantai;8;10;18;2;4;6
109;01.08.2016;2016;08;12;Maanantai;16;7;23;2;4;6
109;01.08.2016;2016;08;13;Maanantai;20;26;46;5;6;11
109;01.08.2016;2016;08;14;Maanantai;30;20;50;4;2;6
109;01.08.2016;2016;08;15;Maanantai;39;45;84;8;5;13
109;01.08.2016;2016;08;16;Maanantai;52;73;125;6;4;10
109;01.08.2016;2016;08;17;Maanantai;34;36;70;5;7;12
109;01.08.2016;2016;08;18;Maanantai;21;28;49;8;2;10
109;01.08.2016;2016;08;19;Maanantai;15;17;32;4;4;8
109;01.08.2016;2016;08;20;Maanantai;18;24;42;6;7;13
109;01.08.2016;2016;08;21;Maanantai;13;10;23;2;5;7
109;01.08.2016;2016;08;22;Maanantai;15;6;21;3;0;3
109;01.08.2016;2016;08;23;Maanantai;5;10;15;2;0;2
109;02.08.2016;2016;08;00;Tiistai;1;1;2;1;1;2
109;02.08.2016;2016;08;01;Tiistai;0;1;1;0;0;0
109;02.08.2016;2016;08;02;Tiistai;1;1;2;0;0;0
109;02.08.2016;2016;08;03;Tiistai;0;0;0;0;0;0
109;02.08.2016;2016;08;04;Tiistai;1;0;1;0;0;0
109;02.08.2016;2016;08;05;Tiistai;2;6;8;1;1;2
109;02.08.2016;2016;08;06;Tiistai;24;14;38;2;2;4
109;02.08.2016;2016;08;07;Tiistai;57;32;89;2;3;5
109;02.08.2016;2016;08;08;Tiistai;46;15;61;0;4;4
109;02.08.2016;2016;08;09;Tiistai;15;5;20;0;2;2
109;02.08.2016;2016;08;10;Tiistai;4;8;12;3;3;6
109;02.08.2016;2016;08;11;Tiistai;19;5;24;3;2;5
109;02.08.2016;2016;08;12;Tiistai;13;12;25;4;1;5
109;02.08.2016;2016;08;13;Tiistai;17;13;30;2;3;5
109;02.08.2016;2016;08;14;Tiistai;9;9;18;0;3;3
109;02.08.2016;2016;08;15;Tiistai;24;31;55;1;1;2
109;02.08.2016;2016;08;16;Tiistai;28;44;72;2;1;3
109;02.08.2016;2016;08;17;Tiistai;18;27;45;3;3;6
109;02.08.2016;2016;08;18;Tiistai;15;5;20;5;2;7
109;02.08.2016;2016;08;19;Tiistai;27;20;47;4;5;9
109;02.08.2016;2016;08;20;Tiistai;9;16;25;3;9;12
109;02.08.2016;2016;08;21;Tiistai;5;16;21;4;10;14
109;02.08.2016;2016;08;22;Tiistai;7;6;13;3;1;4
109;02.08.2016;2016;08;23;Tiistai;2;5;7;1;3;4
109;03.08.2016;2016;08;00;Keskiviikko;0;4;4;0;0;0
109;03.08.2016;2016;08;01;Keskiviikko;1;0;1;0;1;1
109;03.08.2016;2016;08;02;Keskiviikko;0;3;3;0;0;0
109;03.08.2016;2016;08;03;Keskiviikko;1;0;1;0;0;0
109;03.08.2016;2016;08;04;Keskiviikko;0;0;0;1;0;1
109;03.08.2016;2016;08;05;Keskiviikko;2;5;7;2;1;3
109;03.08.2016;2016;08;06;Keskiviikko;25;12;37;2;2;4
109;03.08.2016;2016;08;07;Keskiviikko;58;26;84;5;3;8
109;03.08.2016;2016;08;08;Keskiviikko;33;14;47;4;1;5
109;03.08.2016;2016;08;09;Keskiviikko;28;8;36;4;2;6
109;03.08.2016;2016;08;10;Keskiviikko;16;12;28;2;4;6
109;03.08.2016;2016;08;11;Keskiviikko;13;10;23;5;1;6
109;03.08.2016;2016;08;12;Keskiviikko;14;11;25;3;1;4
109;03.08.2016;2016;08;13;Keskiviikko;16;17;33;1;3;4
109;03.08.2016;2016;08;14;Keskiviikko;17;18;35;1;0;1
109;03.08.2016;2016;08;15;Keskiviikko;16;43;59;1;1;2
109;03.08.2016;2016;08;16;Keskiviikko;37;63;100;7;3;10
109;03.08.2016;2016;08;17;Keskiviikko;12;21;33;0;4;4
109;03.08.2016;2016;08;18;Keskiviikko;17;16;33;4;6;10
109;03.08.2016;2016;08;19;Keskiviikko;18;24;42;15;8;23
109;03.08.2016;2016;08;20;Keskiviikko;15;11;26;6;3;9
109;03.08.2016;2016;08;21;Keskiviikko;13;20;33;4;5;9
109;03.08.2016;2016;08;22;Keskiviikko;7;3;10;2;0;2
109;03.08.2016;2016;08;23;Keskiviikko;3;3;6;1;1;2
109;04.08.2016;2016;08;00;Torstai;1;0;1;0;0;0
109;04.08.2016;2016;08;01;Torstai;1;1;2;0;0;0
109;04.08.2016;2016;08;02;Torstai;0;0;0;0;0;0
109;04.08.2016;2016;08;03;Torstai;0;0;0;0;1;1
109;04.08.2016;2016;08;04;Torstai;2;0;2;0;1;1
109;04.08.2016;2016;08;05;Torstai;2;8;10;2;1;3
109;04.08.2016;2016;08;06;Torstai;23;10;33;1;3;4
109;04.08.2016;2016;08;07;Torstai;69;31;100;2;3;5
109;04.08.2016;2016;08;08;Torstai;52;20;72;2;5;7
109;04.08.2016;2016;08;09;Torstai;18;12;30;0;3;3
109;04.08.2016;2016;08;10;Torstai;22;11;33;6;3;9
109;04.08.2016;2016;08;11;Torstai;23;11;34;3;4;7
109;04.08.2016;2016;08;12;Torstai;26;17;43;6;3;9
109;04.08.2016;2016;08;13;Torstai;39;27;66;0;1;1
109;04.08.2016;2016;08;14;Torstai;17;19;36;1;3;4
109;04.08.2016;2016;08;15;Torstai;53;52;105;1;7;8
109;04.08.2016;2016;08;16;Torstai;37;78;115;3;2;5
109;04.08.2016;2016;08;17;Torstai;19;36;55;6;4;10
109;04.08.2016;2016;08;18;Torstai;15;15;30;5;4;9
109;04.08.2016;2016;08;19;Torstai;7;13;20;5;5;10
109;04.08.2016;2016;08;20;Torstai;17;14;31;5;5;10
109;04.08.2016;2016;08;21;Torstai;4;13;17;4;4;8
109;04.08.2016;2016;08;22;Torstai;9;6;15;1;1;2
109;04.08.2016;2016;08;23;Torstai;2;1;3;1;0;1
109;05.08.2016;2016;08;00;Perjantai;0;5;5;0;0;0
109;05.08.2016;2016;08;01;Perjantai;1;0;1;0;1;1
109;05.08.2016;2016;08;02;Perjantai;0;0;0;0;0;0
109;05.08.2016;2016;08;03;Perjantai;0;0;0;0;0;0
109;05.08.2016;2016;08;04;Perjantai;2;0;2;0;0;0
109;05.08.2016;2016;08;05;Perjantai;2;8;10;1;0;1
109;05.08.2016;2016;08;06;Perjantai;26;14;40;1;2;3
109;05.08.2016;2016;08;07;Perjantai;49;19;68;5;4;9
109;05.08.2016;2016;08;08;Perjantai;30;13;43;3;2;5
109;05.08.2016;2016;08;09;Perjantai;21;8;29;1;1;2
109;05.08.2016;2016;08;10;Perjantai;8;10;18;2;2;4
109;05.08.2016;2016;08;11;Perjantai;11;8;19;3;4;7
109;05.08.2016;2016;08;12;Perjantai;20;17;37;4;4;8
109;05.08.2016;2016;08;13;Perjantai;16;18;34;1;1;2
109;05.08.2016;2016;08;14;Perjantai;29;23;52;2;3;5
109;05.08.2016;2016;08;15;Perjantai;29;42;71;8;5;13
109;05.08.2016;2016;08;16;Perjantai;34;50;84;7;3;10
109;05.08.2016;2016;08;17;Perjantai;20;22;42;5;4;9
109;05.08.2016;2016;08;18;Perjantai;15;17;32;5;4;9
109;05.08.2016;2016;08;19;Perjantai;15;13;28;6;2;8
109;05.08.2016;2016;08;20;Perjantai;14;22;36;8;3;11
109;05.08.2016;2016;08;21;Perjantai;12;15;27;3;2;5
109;05.08.2016;2016;08;22;Perjantai;4;5;9;0;2;2
109;05.08.2016;2016;08;23;Perjantai;5;4;9;0;0;0
109;06.08.2016;2016;08;00;Lauantai;2;6;8;0;0;0
109;06.08.2016;2016;08;01;Lauantai;0;1;1;0;0;0
109;06.08.2016;2016;08;02;Lauantai;1;2;3;0;0;0
109;06.08.2016;2016;08;03;Lauantai;1;2;3;0;0;0
109;06.08.2016;2016;08;04;Lauantai;0;7;7;0;0;0
109;06.08.2016;2016;08;05;Lauantai;1;3;4;0;1;1
109;06.08.2016;2016;08;06;Lauantai;9;1;10;1;0;1
109;06.08.2016;2016;08;07;Lauantai;4;6;10;4;5;9
109;06.08.2016;2016;08;08;Lauantai;5;1;6;3;3;6
109;06.08.2016;2016;08;09;Lauantai;11;5;16;2;3;5
109;06.08.2016;2016;08;10;Lauantai;10;9;19;2;1;3
109;06.08.2016;2016;08;11;Lauantai;17;9;26;4;1;5
109;06.08.2016;2016;08;12;Lauantai;27;13;40;5;2;7
109;06.08.2016;2016;08;13;Lauantai;19;16;35;1;5;6
109;06.08.2016;2016;08;14;Lauantai;25;15;40;5;3;8
109;06.08.2016;2016;08;15;Lauantai;17;21;38;5;4;9
109;06.08.2016;2016;08;16;Lauantai;17;20;37;2;1;3
109;06.08.2016;2016;08;17;Lauantai;18;11;29;4;1;5
109;06.08.2016;2016;08;18;Lauantai;37;20;57;7;4;11
109;06.08.2016;2016;08;19;Lauantai;17;9;26;2;2;4
109;06.08.2016;2016;08;20;Lauantai;12;21;33;5;4;9
109;06.08.2016;2016;08;21;Lauantai;10;18;28;2;1;3
109;06.08.2016;2016;08;22;Lauantai;3;7;10;1;2;3
109;06.08.2016;2016;08;23;Lauantai;4;12;16;3;0;3
109;07.08.2016;2016;08;00;Sunnuntai;7;3;10;1;0;1
109;07.08.2016;2016;08;01;Sunnuntai;5;6;11;4;1;5
109;07.08.2016;2016;08;02;Sunnuntai;5;5;10;0;0;0
109;07.08.2016;2016;08;03;Sunnuntai;0;2;2;0;0;0
109;07.08.2016;2016;08;04;Sunnuntai;2;3;5;0;0;0
109;07.08.2016;2016;08;05;Sunnuntai;3;4;7;0;1;1
109;07.08.2016;2016;08;06;Sunnuntai;6;0;6;0;0;0
109;07.08.2016;2016;08;07;Sunnuntai;1;8;9;1;0;1
109;07.08.2016;2016;08;08;Sunnuntai;1;2;3;2;1;3
109;07.08.2016;2016;08;09;Sunnuntai;3;6;9;1;4;5
109;07.08.2016;2016;08;10;Sunnuntai;20;6;26;4;4;8
109;07.08.2016;2016;08;11;Sunnuntai;11;9;20;5;1;6
109;07.08.2016;2016;08;12;Sunnuntai;13;7;20;5;3;8
109;07.08.2016;2016;08;13;Sunnuntai;5;4;9;4;3;7
109;07.08.2016;2016;08;14;Sunnuntai;8;12;20;1;2;3
109;07.08.2016;2016;08;15;Sunnuntai;26;10;36;4;3;7
109;07.08.2016;2016;08;16;Sunnuntai;25;8;33;6;2;8
109;07.08.2016;2016;08;17;Sunnuntai;18;25;43;3;2;5
109;07.08.2016;2016;08;18;Sunnuntai;23;13;36;4;2;6
109;07.08.2016;2016;08;19;Sunnuntai;23;27;50;9;4;13
109;07.08.2016;2016;08;20;Sunnuntai;10;21;31;5;6;11
109;07.08.2016;2016;08;21;Sunnuntai;12;19;31;2;1;3
109;07.08.2016;2016;08;22;Sunnuntai;10;4;14;6;4;10
109;07.08.2016;2016;08;23;Sunnuntai;4;5;9;3;0;3
109;29.08.2016;2016;08;00;Maanantai;1;0;1;0;0;0
109;29.08.2016;2016;08;01;Maanantai;0;0;0;0;0;0
109;29.08.2016;2016;08;02;Maanantai;0;0;0;0;0;0
109;29.08.2016;2016;08;03;Maanantai;0;0;0;0;0;0
109;29.08.2016;2016;08;04;Maanantai;0;0;0;0;0;0
109;29.08.2016;2016;08;05;Maanantai;0;0;0;0;0;0
109;29.08.2016;2016;08;06;Maanantai;9;7;16;2;0;2
109;29.08.2016;2016;08;07;Maanantai;29;31;60;2;5;7
109;29.08.2016;2016;08;08;Maanantai;41;39;80;5;3;8
109;29.08.2016;2016;08;09;Maanantai;32;34;66;3;3;6
109;29.08.2016;2016;08;10;Maanantai;0;0;0;0;0;0
109;29.08.2016;2016;08;11;Maanantai;9;11;20;0;2;2
109;29.08.2016;2016;08;12;Maanantai;3;1;4;0;0;0
109;29.08.2016;2016;08;13;Maanantai;27;30;57;2;4;6
109;29.08.2016;2016;08;14;Maanantai;4;3;7;0;0;0
109;29.08.2016;2016;08;15;Maanantai;26;29;55;2;3;5
109;29.08.2016;2016;08;16;Maanantai;8;5;13;1;0;1
109;29.08.2016;2016;08;17;Maanantai;2;3;5;0;0;0
109;29.08.2016;2016;08;18;Maanantai;2;1;3;0;0;0
109;29.08.2016;2016;08;19;Maanantai;1;3;4;0;0;0
109;29.08.2016;2016;08;20;Maanantai;3;1;4;0;0;0
109;29.08.2016;2016;08;21;Maanantai;0;1;1;0;0;0
109;29.08.2016;2016;08;22;Maanantai;2;1;3;0;0;0
109;29.08.2016;2016;08;23;Maanantai;0;0;0;0;0;0
109;30.08.2016;2016;08;00;Tiistai;1;0;1;0;0;0
109;30.08.2016;2016;08;01;Tiistai;0;0;0;0;0;0
109;30.08.2016;2016;08;02;Tiistai;0;0;0;0;0;0
109;30.08.2016;2016;08;03;Tiistai;0;1;1;0;0;0
109;30.08.2016;2016;08;04;Tiistai;1;0;1;0;0;0
109;30.08.2016;2016;08;05;Tiistai;0;0;0;0;0;0
109;30.08.2016;2016;08;06;Tiistai;1;0;1;0;0;0
109;30.08.2016;2016;08;07;Tiistai;4;5;9;0;0;0
109;30.08.2016;2016;08;08;Tiistai;3;3;6;0;0;0
109;30.08.2016;2016;08;09;Tiistai;5;5;10;0;1;1
109;30.08.2016;2016;08;10;Tiistai;9;8;17;1;0;1
109;30.08.2016;2016;08;11;Tiistai;14;16;30;0;4;4
109;30.08.2016;2016;08;12;Tiistai;14;11;25;2;0;2
109;30.08.2016;2016;08;13;Tiistai;14;14;28;0;4;4
109;30.08.2016;2016;08;14;Tiistai;17;15;32;3;0;3
109;30.08.2016;2016;08;15;Tiistai;27;28;55;2;4;6
109;30.08.2016;2016;08;16;Tiistai;42;38;80;4;3;7
109;30.08.2016;2016;08;17;Tiistai;20;23;43;1;3;4
109;30.08.2016;2016;08;18;Tiistai;18;15;33;4;0;4
109;30.08.2016;2016;08;19;Tiistai;10;13;23;0;1;1
109;30.08.2016;2016;08;20;Tiistai;14;11;25;3;0;3
109;30.08.2016;2016;08;21;Tiistai;5;9;14;0;1;1
109;30.08.2016;2016;08;22;Tiistai;4;1;5;0;0;0
109;30.08.2016;2016;08;23;Tiistai;0;1;1;0;0;0
109;31.08.2016;2016;08;00;Keskiviikko;0;0;0;0;0;0
109;31.08.2016;2016;08;01;Keskiviikko;0;1;1;0;0;0
109;31.08.2016;2016;08;02;Keskiviikko;0;0;0;0;0;0
109;31.08.2016;2016;08;03;Keskiviikko;0;1;1;0;0;0
109;31.08.2016;2016;08;04;Keskiviikko;0;0;0;0;0;0
109;31.08.2016;2016;08;05;Keskiviikko;3;6;9;0;0;0
109;31.08.2016;2016;08;06;Keskiviikko;20;19;39;3;0;3
109;31.08.2016;2016;08;07;Keskiviikko;63;64;127;5;7;12
109;31.08.2016;2016;08;08;Keskiviikko;24;22;46;4;1;5
109;31.08.2016;2016;08;09;Keskiviikko;15;16;31;1;3;4
109;31.08.2016;2016;08;10;Keskiviikko;10;9;19;2;0;2
109;31.08.2016;2016;08;11;Keskiviikko;14;15;29;0;3;3
109;31.08.2016;2016;08;12;Keskiviikko;15;13;28;3;0;3
109;31.08.2016;2016;08;13;Keskiviikko;13;17;30;0;4;4
109;31.08.2016;2016;08;14;Keskiviikko;25;23;48;4;0;4
109;31.08.2016;2016;08;15;Keskiviikko;44;45;89;3;6;9
109;31.08.2016;2016;08;16;Keskiviikko;63;61;124;6;6;12
109;31.08.2016;2016;08;17;Keskiviikko;24;25;49;2;3;5
109;31.08.2016;2016;08;18;Keskiviikko;20;19;39;3;0;3
109;31.08.2016;2016;08;19;Keskiviikko;17;19;36;0;2;2
109;31.08.2016;2016;08;20;Keskiviikko;16;13;29;4;0;4
109;31.08.2016;2016;08;21;Keskiviikko;9;10;19;0;3;3
109;31.08.2016;2016;08;22;Keskiviikko;6;4;10;0;0;0
109;31.08.2016;2016;08;23;Keskiviikko;1;4;5;0;0;0
109;01.09.2016;2016;09;00;Torstai;0;0;0;0;0;0
109;01.09.2016;2016;09;01;Torstai;0;0;0;0;0;0
109;01.09.2016;2016;09;02;Torstai;1;0;1;0;0;0
109;01.09.2016;2016;09;03;Torstai;0;0;0;0;0;0
109;01.09.2016;2016;09;04;Torstai;2;0;2;0;0;0
109;01.09.2016;2016;09;05;Torstai;5;9;14;0;1;1
109;01.09.2016;2016;09;06;Torstai;18;15;33;2;0;2
109;01.09.2016;2016;09;07;Torstai;45;47;92;3;6;9
109;01.09.2016;2016;09;08;Torstai;21;21;42;4;0;4
109;01.09.2016;2016;09;09;Torstai;7;10;17;0;1;1
109;01.09.2016;2016;09;10;Torstai;12;9;21;2;0;2
109;01.09.2016;2016;09;11;Torstai;11;14;25;0;2;2
109;01.09.2016;2016;09;12;Torstai;13;10;23;2;0;2
109;01.09.2016;2016;09;13;Torstai;9;11;20;0;2;2
109;01.09.2016;2016;09;14;Torstai;18;16;34;3;0;3
109;01.09.2016;2016;09;15;Torstai;30;32;62;3;4;7
109;01.09.2016;2016;09;16;Torstai;50;48;98;6;3;9
109;01.09.2016;2016;09;17;Torstai;20;23;43;1;4;5
109;01.09.2016;2016;09;18;Torstai;17;14;31;4;0;4
109;01.09.2016;2016;09;19;Torstai;15;19;34;0;4;4
109;01.09.2016;2016;09;20;Torstai;18;17;35;4;0;4
109;01.09.2016;2016;09;21;Torstai;8;11;19;0;2;2
109;01.09.2016;2016;09;22;Torstai;9;7;16;2;0;2
109;01.09.2016;2016;09;23;Torstai;0;2;2;0;0;0
109;02.09.2016;2016;09;00;Perjantai;0;0;0;0;0;0
109;02.09.2016;2016;09;01;Perjantai;0;1;1;0;0;0
109;02.09.2016;2016;09;02;Perjantai;0;0;0;0;0;0
109;02.09.2016;2016;09;03;Perjantai;0;0;0;0;0;0
109;02.09.2016;2016;09;04;Perjantai;2;0;2;0;0;0
109;02.09.2016;2016;09;05;Perjantai;6;8;14;0;0;0
109;02.09.2016;2016;09;06;Perjantai;19;15;34;3;1;4
109;02.09.2016;2016;09;07;Perjantai;58;61;119;5;6;11
109;02.09.2016;2016;09;08;Perjantai;32;30;62;4;3;7
109;02.09.2016;2016;09;09;Perjantai;15;18;33;0;2;2
109;02.09.2016;2016;09;10;Perjantai;11;7;18;1;0;1
109;02.09.2016;2016;09;11;Perjantai;7;11;18;0;2;2
109;02.09.2016;2016;09;12;Perjantai;18;16;34;2;0;2
109;02.09.2016;2016;09;13;Perjantai;21;23;44;0;4;4
109;02.09.2016;2016;09;14;Perjantai;32;29;61;4;2;6
109;02.09.2016;2016;09;15;Perjantai;41;43;84;4;4;8
109;02.09.2016;2016;09;16;Perjantai;36;35;71;4;3;7
109;02.09.2016;2016;09;17;Perjantai;20;22;42;1;4;5
109;02.09.2016;2016;09;18;Perjantai;21;19;40;4;0;4
109;02.09.2016;2016;09;19;Perjantai;11;13;24;0;3;3
109;02.09.2016;2016;09;20;Perjantai;11;9;20;3;0;3
109;02.09.2016;2016;09;21;Perjantai;6;9;15;0;1;1
109;02.09.2016;2016;09;22;Perjantai;7;5;12;0;0;0
109;02.09.2016;2016;09;23;Perjantai;2;3;5;0;0;0
109;03.09.2016;2016;09;00;Lauantai;3;1;4;1;0;1
109;03.09.2016;2016;09;01;Lauantai;0;1;1;0;0;0
109;03.09.2016;2016;09;02;Lauantai;1;0;1;0;0;0
109;03.09.2016;2016;09;03;Lauantai;1;2;3;1;1;2
109;03.09.2016;2016;09;04;Lauantai;0;0;0;0;0;0
109;03.09.2016;2016;09;05;Lauantai;0;3;3;0;1;1
109;03.09.2016;2016;09;06;Lauantai;3;0;3;2;0;2
109;03.09.2016;2016;09;07;Lauantai;1;4;5;1;1;2
109;03.09.2016;2016;09;08;Lauantai;6;5;11;6;2;8
109;03.09.2016;2016;09;09;Lauantai;5;8;13;4;6;10
109;03.09.2016;2016;09;10;Lauantai;6;5;11;5;4;9
109;03.09.2016;2016;09;11;Lauantai;6;9;15;5;6;11
109;03.09.2016;2016;09;12;Lauantai;11;10;21;11;10;21
109;03.09.2016;2016;09;13;Lauantai;9;11;20;8;10;18
109;03.09.2016;2016;09;14;Lauantai;12;8;20;11;8;19
109;03.09.2016;2016;09;15;Lauantai;6;10;16;6;9;15
109;03.09.2016;2016;09;16;Lauantai;9;8;17;9;6;15
109;03.09.2016;2016;09;17;Lauantai;8;8;16;4;8;12
109;03.09.2016;2016;09;18;Lauantai;10;6;16;9;6;15
109;03.09.2016;2016;09;19;Lauantai;9;10;19;8;9;17
109;03.09.2016;2016;09;20;Lauantai;7;4;11;6;4;10
109;03.09.2016;2016;09;21;Lauantai;4;5;9;2;5;7
109;03.09.2016;2016;09;22;Lauantai;3;1;4;2;0;2
109;03.09.2016;2016;09;23;Lauantai;1;3;4;0;1;1
109;04.09.2016;2016;09;00;Sunnuntai;1;0;1;0;0;0
109;04.09.2016;2016;09;01;Sunnuntai;0;2;2;0;0;0
109;04.09.2016;2016;09;02;Sunnuntai;2;0;2;0;0;0
109;04.09.2016;2016;09;03;Sunnuntai;0;2;2;0;0;0
109;04.09.2016;2016;09;04;Sunnuntai;1;0;1;1;0;1
109;04.09.2016;2016;09;05;Sunnuntai;0;2;2;0;2;2
109;04.09.2016;2016;09;06;Sunnuntai;4;1;5;3;1;4
109;04.09.2016;2016;09;07;Sunnuntai;1;5;6;1;1;2
109;04.09.2016;2016;09;08;Sunnuntai;5;1;6;3;1;4
109;04.09.2016;2016;09;09;Sunnuntai;4;7;11;4;5;9
109;04.09.2016;2016;09;10;Sunnuntai;9;6;15;7;5;12
109;04.09.2016;2016;09;11;Sunnuntai;10;12;22;9;10;19
109;04.09.2016;2016;09;12;Sunnuntai;15;13;28;15;12;27
109;04.09.2016;2016;09;13;Sunnuntai;10;13;23;9;12;21
109;04.09.2016;2016;09;14;Sunnuntai;10;9;19;9;8;17
109;04.09.2016;2016;09;15;Sunnuntai;9;10;19;7;10;17
109;04.09.2016;2016;09;16;Sunnuntai;9;8;17;9;6;15
109;04.09.2016;2016;09;17;Sunnuntai;9;11;20;9;9;18
109;04.09.2016;2016;09;18;Sunnuntai;9;9;18;9;8;17
109;04.09.2016;2016;09;19;Sunnuntai;12;15;27;12;14;26
109;04.09.2016;2016;09;20;Sunnuntai;9;8;17;8;5;13
109;04.09.2016;2016;09;21;Sunnuntai;6;7;13;5;7;12
109;04.09.2016;2016;09;22;Sunnuntai;3;0;3;0;0;0
109;04.09.2016;2016;09;23;Sunnuntai;0;0;0;0;0;0
109;05.09.2016;2016;09;00;Maanantai;1;1;2;0;0;0
109;05.09.2016;2016;09;01;Maanantai;1;2;3;0;0;0
109;05.09.2016;2016;09;02;Maanantai;1;0;1;0;0;0
109;05.09.2016;2016;09;03;Maanantai;0;0;0;0;0;0
109;05.09.2016;2016;09;04;Maanantai;2;0;2;0;0;0
109;05.09.2016;2016;09;05;Maanantai;5;7;12;0;0;0
109;05.09.2016;2016;09;06;Maanantai;25;21;46;4;1;5
109;05.09.2016;2016;09;07;Maanantai;68;70;138;7;7;14
109;05.09.2016;2016;09;08;Maanantai;42;38;80;5;4;9
109;05.09.2016;2016;09;09;Maanantai;17;18;35;0;4;4
109;05.09.2016;2016;09;10;Maanantai;14;12;26;3;0;3
109;05.09.2016;2016;09;11;Maanantai;14;16;30;0;3;3
109;05.09.2016;2016;09;12;Maanantai;13;9;22;2;0;2
109;05.09.2016;2016;09;13;Maanantai;28;30;58;2;3;5
109;05.09.2016;2016;09;14;Maanantai;40;37;77;4;3;7
109;05.09.2016;2016;09;15;Maanantai;58;60;118;5;7;12
109;05.09.2016;2016;09;16;Maanantai;68;67;135;8;5;13
109;05.09.2016;2016;09;17;Maanantai;25;28;53;1;5;6
109;05.09.2016;2016;09;18;Maanantai;33;30;63;4;2;6
109;05.09.2016;2016;09;19;Maanantai;19;20;39;1;4;5
109;05.09.2016;2016;09;20;Maanantai;16;13;29;4;0;4
109;05.09.2016;2016;09;21;Maanantai;9;10;19;0;2;2
109;05.09.2016;2016;09;22;Maanantai;6;4;10;0;0;0
109;05.09.2016;2016;09;23;Maanantai;0;1;1;0;0;0
109;06.09.2016;2016;09;00;Tiistai;3;1;4;0;0;0
109;06.09.2016;2016;09;01;Tiistai;0;0;0;0;0;0
109;06.09.2016;2016;09;02;Tiistai;0;0;0;0;0;0
109;06.09.2016;2016;09;03;Tiistai;0;0;0;0;0;0
109;06.09.2016;2016;09;04;Tiistai;3;1;4;0;0;0
109;06.09.2016;2016;09;05;Tiistai;6;7;13;0;0;0
109;06.09.2016;2016;09;06;Tiistai;25;22;47;3;2;5
109;06.09.2016;2016;09;07;Tiistai;71;72;143;6;8;14
109;06.09.2016;2016;09;08;Tiistai;36;34;70;4;3;7
109;06.09.2016;2016;09;09;Tiistai;20;23;43;0;3;3
109;06.09.2016;2016;09;10;Tiistai;13;11;24;3;0;3
109;06.09.2016;2016;09;11;Tiistai;20;23;43;1;4;5
109;06.09.2016;2016;09;12;Tiistai;18;15;33;4;0;4
109;06.09.2016;2016;09;13;Tiistai;26;28;54;1;4;5
109;06.09.2016;2016;09;14;Tiistai;18;15;33;4;0;4
109;06.09.2016;2016;09;15;Tiistai;49;51;100;4;5;9
109;06.09.2016;2016;09;16;Tiistai;52;51;103;6;4;10
109;06.09.2016;2016;09;17;Tiistai;29;31;60;3;4;7
109;06.09.2016;2016;09;18;Tiistai;24;23;47;4;0;4
109;06.09.2016;2016;09;19;Tiistai;16;18;34;0;4;4
109;06.09.2016;2016;09;20;Tiistai;15;12;27;3;0;3
109;06.09.2016;2016;09;21;Tiistai;8;9;17;0;1;1
109;06.09.2016;2016;09;22;Tiistai;4;2;6;1;0;1
109;06.09.2016;2016;09;23;Tiistai;1;3;4;0;0;0
109;07.09.2016;2016;09;00;Keskiviikko;2;0;2;0;0;0
109;07.09.2016;2016;09;01;Keskiviikko;0;1;1;0;0;0
109;07.09.2016;2016;09;02;Keskiviikko;1;0;1;0;0;0
109;07.09.2016;2016;09;03;Keskiviikko;0;0;0;0;0;0
109;07.09.2016;2016;09;04;Keskiviikko;2;0;2;0;0;0
109;07.09.2016;2016;09;05;Keskiviikko;5;5;10;0;0;0
109;07.09.2016;2016;09;06;Keskiviikko;27;26;53;4;2;6
109;07.09.2016;2016;09;07;Keskiviikko;57;59;116;5;7;12
109;07.09.2016;2016;09;08;Keskiviikko;32;31;63;5;1;6
109;07.09.2016;2016;09;09;Keskiviikko;15;17;32;0;3;3
109;07.09.2016;2016;09;10;Keskiviikko;26;23;49;4;2;6
109;07.09.2016;2016;09;11;Keskiviikko;18;20;38;0;4;4
109;07.09.2016;2016;09;12;Keskiviikko;20;19;39;4;0;4
109;07.09.2016;2016;09;13;Keskiviikko;18;21;39;0;3;3
109;07.09.2016;2016;09;14;Keskiviikko;31;28;59;4;2;6
109;07.09.2016;2016;09;15;Keskiviikko;46;49;95;4;5;9
109;07.09.2016;2016;09;16;Keskiviikko;61;58;119;6;6;12
109;07.09.2016;2016;09;17;Keskiviikko;28;30;58;2;4;6
109;07.09.2016;2016;09;18;Keskiviikko;23;21;44;4;0;4
109;07.09.2016;2016;09;19;Keskiviikko;19;21;40;0;4;4
109;07.09.2016;2016;09;20;Keskiviikko;12;10;22;3;0;3
109;07.09.2016;2016;09;21;Keskiviikko;11;14;25;0;1;1
109;07.09.2016;2016;09;22;Keskiviikko;7;4;11;0;0;0
109;07.09.2016;2016;09;23;Keskiviikko;0;1;1;0;0;0
109;08.09.2016;2016;09;00;Torstai;2;1;3;0;0;0
109;08.09.2016;2016;09;01;Torstai;0;1;1;0;0;0
109;08.09.2016;2016;09;02;Torstai;0;0;0;0;0;0
109;08.09.2016;2016;09;03;Torstai;0;2;2;0;0;0
109;08.09.2016;2016;09;04;Torstai;2;0;2;0;0;0
109;08.09.2016;2016;09;05;Torstai;2;5;7;0;0;0
109;08.09.2016;2016;09;06;Torstai;24;20;44;4;1;5
109;08.09.2016;2016;09;07;Torstai;62;64;126;5;7;12
109;08.09.2016;2016;09;08;Torstai;33;31;64;5;3;8
109;08.09.2016;2016;09;09;Torstai;20;22;42;0;3;3
109;08.09.2016;2016;09;10;Torstai;15;13;28;4;0;4
109;08.09.2016;2016;09;11;Torstai;19;20;39;0;4;4
109;08.09.2016;2016;09;12;Torstai;21;19;40;4;0;4
109;08.09.2016;2016;09;13;Torstai;20;22;42;1;4;5
109;08.09.2016;2016;09;14;Torstai;21;17;38;4;0;4
109;08.09.2016;2016;09;15;Torstai;45;48;93;4;5;9
109;08.09.2016;2016;09;16;Torstai;58;57;115;6;6;12
109;08.09.2016;2016;09;17;Torstai;29;32;61;3;4;7
109;08.09.2016;2016;09;18;Torstai;23;20;43;4;0;4
109;08.09.2016;2016;09;19;Torstai;18;20;38;0;4;4
109;08.09.2016;2016;09;20;Torstai;16;13;29;2;0;2
109;08.09.2016;2016;09;21;Torstai;8;9;17;0;1;1
109;08.09.2016;2016;09;22;Torstai;3;1;4;0;0;0
109;08.09.2016;2016;09;23;Torstai;0;2;2;0;0;0
109;09.09.2016;2016;09;00;Perjantai;1;0;1;0;0;0
109;09.09.2016;2016;09;01;Perjantai;0;1;1;0;0;0
109;09.09.2016;2016;09;02;Perjantai;0;0;0;0;0;0
109;09.09.2016;2016;09;03;Perjantai;0;0;0;0;0;0
109;09.09.2016;2016;09;04;Perjantai;0;0;0;0;0;0
109;09.09.2016;2016;09;05;Perjantai;5;6;11;0;0;0
109;09.09.2016;2016;09;06;Perjantai;21;18;39;4;0;4
109;09.09.2016;2016;09;07;Perjantai;54;57;111;4;7;11
109;09.09.2016;2016;09;08;Perjantai;33;29;62;4;3;7
109;09.09.2016;2016;09;09;Perjantai;16;19;35;0;3;3
109;09.09.2016;2016;09;10;Perjantai;13;11;24;4;0;4
109;09.09.2016;2016;09;11;Perjantai;13;15;28;0;4;4
109;09.09.2016;2016;09;12;Perjantai;17;15;32;3;0;3
109;09.09.2016;2016;09;13;Perjantai;25;28;53;1;4;5
109;09.09.2016;2016;09;14;Perjantai;28;27;55;4;1;5
109;09.09.2016;2016;09;15;Perjantai;36;40;76;3;4;7
109;09.09.2016;2016;09;16;Perjantai;33;31;64;4;2;6
109;09.09.2016;2016;09;17;Perjantai;16;18;34;0;4;4
109;09.09.2016;2016;09;18;Perjantai;20;19;39;4;0;4
109;09.09.2016;2016;09;19;Perjantai;10;11;21;0;2;2
109;09.09.2016;2016;09;20;Perjantai;11;9;20;3;0;3
109;09.09.2016;2016;09;21;Perjantai;6;9;15;0;1;1
109;09.09.2016;2016;09;22;Perjantai;4;1;5;0;0;0
109;09.09.2016;2016;09;23;Perjantai;4;6;10;0;0;0
109;10.09.2016;2016;09;00;Lauantai;2;0;2;1;0;1
109;10.09.2016;2016;09;01;Lauantai;0;1;1;0;0;0
109;10.09.2016;2016;09;02;Lauantai;3;0;3;0;0;0
109;10.09.2016;2016;09;03;Lauantai;0;0;0;0;0;0
109;10.09.2016;2016;09;04;Lauantai;1;0;1;0;0;0
109;10.09.2016;2016;09;05;Lauantai;0;0;0;0;0;0
109;10.09.2016;2016;09;06;Lauantai;3;2;5;2;2;4
109;10.09.2016;2016;09;07;Lauantai;3;4;7;1;3;4
109;10.09.2016;2016;09;08;Lauantai;4;2;6;2;2;4
109;10.09.2016;2016;09;09;Lauantai;5;8;13;4;7;11
109;10.09.2016;2016;09;10;Lauantai;6;3;9;6;2;8
109;10.09.2016;2016;09;11;Lauantai;7;9;16;5;8;13
109;10.09.2016;2016;09;12;Lauantai;9;7;16;7;6;13
109;10.09.2016;2016;09;13;Lauantai;9;10;19;8;9;17
109;10.09.2016;2016;09;14;Lauantai;6;5;11;5;5;10
109;10.09.2016;2016;09;15;Lauantai;9;11;20;9;10;19
109;10.09.2016;2016;09;16;Lauantai;10;8;18;8;8;16
109;10.09.2016;2016;09;17;Lauantai;9;11;20;8;11;19
109;10.09.2016;2016;09;18;Lauantai;8;6;14;6;6;12
109;10.09.2016;2016;09;19;Lauantai;7;10;17;6;9;15
109;10.09.2016;2016;09;20;Lauantai;4;2;6;3;2;5
109;10.09.2016;2016;09;21;Lauantai;1;3;4;1;2;3
109;10.09.2016;2016;09;22;Lauantai;3;0;3;0;0;0
109;10.09.2016;2016;09;23;Lauantai;0;3;3;0;2;2
109;11.09.2016;2016;09;00;Sunnuntai;2;0;2;0;0;0
109;11.09.2016;2016;09;01;Sunnuntai;0;3;3;0;1;1
109;11.09.2016;2016;09;02;Sunnuntai;4;1;5;2;0;2
109;11.09.2016;2016;09;03;Sunnuntai;0;1;1;0;0;0
109;11.09.2016;2016;09;04;Sunnuntai;1;0;1;0;0;0
109;11.09.2016;2016;09;05;Sunnuntai;0;2;2;0;0;0
109;11.09.2016;2016;09;06;Sunnuntai;3;2;5;3;0;3
109;11.09.2016;2016;09;07;Sunnuntai;2;3;5;1;2;3
109;11.09.2016;2016;09;08;Sunnuntai;4;1;5;2;0;2
109;11.09.2016;2016;09;09;Sunnuntai;5;7;12;5;6;11
109;11.09.2016;2016;09;10;Sunnuntai;8;6;14;7;5;12
109;11.09.2016;2016;09;11;Sunnuntai;5;6;11;4;6;10
109;11.09.2016;2016;09;12;Sunnuntai;9;7;16;7;7;14
109;11.09.2016;2016;09;13;Sunnuntai;10;12;22;9;11;20
109;11.09.2016;2016;09;14;Sunnuntai;10;8;18;8;7;15
109;11.09.2016;2016;09;15;Sunnuntai;5;8;13;4;7;11
109;11.09.2016;2016;09;16;Sunnuntai;11;9;20;10;8;18
109;11.09.2016;2016;09;17;Sunnuntai;8;11;19;8;8;16
109;11.09.2016;2016;09;18;Sunnuntai;13;9;22;11;9;20
109;11.09.2016;2016;09;19;Sunnuntai;6;8;14;5;7;12
109;11.09.2016;2016;09;20;Sunnuntai;5;4;9;4;3;7
109;11.09.2016;2016;09;21;Sunnuntai;3;5;8;3;4;7
109;11.09.2016;2016;09;22;Sunnuntai;1;1;2;1;0;1
109;11.09.2016;2016;09;23;Sunnuntai;0;1;1;0;0;0
109;12.09.2016;2016;09;00;Maanantai;1;0;1;0;0;0
109;12.09.2016;2016;09;01;Maanantai;0;1;1;0;0;0
109;12.09.2016;2016;09;02;Maanantai;0;0;0;0;0;0
109;12.09.2016;2016;09;03;Maanantai;0;0;0;0;0;0
109;12.09.2016;2016;09;04;Maanantai;1;0;1;0;0;0
109;12.09.2016;2016;09;05;Maanantai;4;7;11;0;0;0
109;12.09.2016;2016;09;06;Maanantai;18;17;35;3;0;3
109;12.09.2016;2016;09;07;Maanantai;57;60;117;5;7;12
109;12.09.2016;2016;09;08;Maanantai;32;28;60;4;1;5
109;12.09.2016;2016;09;09;Maanantai;26;29;55;1;3;4
109;12.09.2016;2016;09;10;Maanantai;11;10;21;3;0;3
109;12.09.2016;2016;09;11;Maanantai;11;12;23;0;3;3
109;12.09.2016;2016;09;12;Maanantai;16;14;30;3;0;3
109;12.09.2016;2016;09;13;Maanantai;19;21;40;0;4;4
109;12.09.2016;2016;09;14;Maanantai;26;26;52;4;1;5
109;12.09.2016;2016;09;15;Maanantai;43;45;88;4;6;10
109;12.09.2016;2016;09;16;Maanantai;58;56;114;6;5;11
109;12.09.2016;2016;09;17;Maanantai;23;27;50;1;4;5
109;12.09.2016;2016;09;18;Maanantai;18;16;34;4;0;4
109;12.09.2016;2016;09;19;Maanantai;15;17;32;0;3;3
109;12.09.2016;2016;09;20;Maanantai;17;15;32;4;0;4
109;12.09.2016;2016;09;21;Maanantai;8;9;17;0;2;2
109;12.09.2016;2016;09;22;Maanantai;4;3;7;0;0;0
109;12.09.2016;2016;09;23;Maanantai;2;2;4;0;0;0
109;13.09.2016;2016;09;00;Tiistai;1;0;1;0;0;0
109;13.09.2016;2016;09;01;Tiistai;0;1;1;0;0;0
109;13.09.2016;2016;09;02;Tiistai;0;0;0;0;0;0
109;13.09.2016;2016;09;03;Tiistai;0;0;0;0;0;0
109;13.09.2016;2016;09;04;Tiistai;2;0;2;0;0;0
109;13.09.2016;2016;09;05;Tiistai;6;7;13;0;0;0
109;13.09.2016;2016;09;06;Tiistai;28;25;53;4;3;7
109;13.09.2016;2016;09;07;Tiistai;70;72;142;6;9;15
109;13.09.2016;2016;09;08;Tiistai;36;33;69;5;2;7
109;13.09.2016;2016;09;09;Tiistai;16;18;34;0;4;4
109;13.09.2016;2016;09;10;Tiistai;18;17;35;4;0;4
109;13.09.2016;2016;09;11;Tiistai;22;25;47;0;4;4
109;13.09.2016;2016;09;12;Tiistai;14;12;26;3;0;3
109;13.09.2016;2016;09;13;Tiistai;19;21;40;0;4;4
109;13.09.2016;2016;09;14;Tiistai;29;27;56;4;0;4
109;13.09.2016;2016;09;15;Tiistai;54;56;110;4;7;11
109;13.09.2016;2016;09;16;Tiistai;55;54;109;6;5;11
109;13.09.2016;2016;09;17;Tiistai;23;26;49;0;4;4
109;13.09.2016;2016;09;18;Tiistai;28;25;53;4;0;4
109;13.09.2016;2016;09;19;Tiistai;17;18;35;0;4;4
109;13.09.2016;2016;09;20;Tiistai;18;16;34;3;0;3
109;13.09.2016;2016;09;21;Tiistai;11;13;24;0;3;3
109;13.09.2016;2016;09;22;Tiistai;6;2;8;0;0;0
109;13.09.2016;2016;09;23;Tiistai;1;2;3;0;0;0
109;14.09.2016;2016;09;00;Keskiviikko;1;0;1;0;0;0
109;14.09.2016;2016;09;01;Keskiviikko;0;0;0;0;0;0
109;14.09.2016;2016;09;02;Keskiviikko;0;0;0;0;0;0
109;14.09.2016;2016;09;03;Keskiviikko;0;1;1;0;0;0
109;14.09.2016;2016;09;04;Keskiviikko;0;0;0;0;0;0
109;14.09.2016;2016;09;05;Keskiviikko;5;8;13;0;1;1
109;14.09.2016;2016;09;06;Keskiviikko;28;25;53;3;2;5
109;14.09.2016;2016;09;07;Keskiviikko;71;74;145;7;8;15
109;14.09.2016;2016;09;08;Keskiviikko;31;28;59;5;1;6
109;14.09.2016;2016;09;09;Keskiviikko;27;28;55;1;4;5
109;14.09.2016;2016;09;10;Keskiviikko;16;16;32;4;0;4
109;14.09.2016;2016;09;11;Keskiviikko;20;22;42;0;3;3
109;14.09.2016;2016;09;12;Keskiviikko;20;18;38;4;1;5
109;14.09.2016;2016;09;13;Keskiviikko;23;26;49;1;4;5
109;14.09.2016;2016;09;14;Keskiviikko;36;35;71;4;4;8
109;14.09.2016;2016;09;15;Keskiviikko;44;46;90;4;5;9
109;14.09.2016;2016;09;16;Keskiviikko;66;64;130;7;6;13
109;14.09.2016;2016;09;17;Keskiviikko;23;26;49;1;4;5
109;14.09.2016;2016;09;18;Keskiviikko;28;25;53;4;1;5
109;14.09.2016;2016;09;19;Keskiviikko;19;22;41;0;4;4
109;14.09.2016;2016;09;20;Keskiviikko;14;12;26;2;0;2
109;14.09.2016;2016;09;21;Keskiviikko;8;10;18;0;2;2
109;14.09.2016;2016;09;22;Keskiviikko;3;3;6;0;0;0
109;14.09.2016;2016;09;23;Keskiviikko;0;3;3;0;0;0
109;15.09.2016;2016;09;00;Torstai;1;0;1;0;0;0
109;15.09.2016;2016;09;01;Torstai;0;0;0;0;0;0
109;15.09.2016;2016;09;02;Torstai;0;0;0;0;0;0
109;15.09.2016;2016;09;03;Torstai;0;1;1;0;0;0
109;15.09.2016;2016;09;04;Torstai;1;0;1;0;0;0
109;15.09.2016;2016;09;05;Torstai;3;5;8;0;0;0
109;15.09.2016;2016;09;06;Torstai;31;29;60;4;2;6
109;15.09.2016;2016;09;07;Torstai;62;63;125;5;7;12
109;15.09.2016;2016;09;08;Torstai;32;30;62;4;2;6
109;15.09.2016;2016;09;09;Torstai;21;23;44;0;4;4
109;15.09.2016;2016;09;10;Torstai;25;23;48;5;1;6
109;15.09.2016;2016;09;11;Torstai;14;17;31;0;3;3
109;15.09.2016;2016;09;12;Torstai;15;13;28;4;0;4
109;15.09.2016;2016;09;13;Torstai;25;27;52;2;4;6
109;15.09.2016;2016;09;14;Torstai;34;32;66;4;2;6
109;15.09.2016;2016;09;15;Torstai;46;50;96;4;5;9
109;15.09.2016;2016;09;16;Torstai;60;57;117;6;5;11
109;15.09.2016;2016;09;17;Torstai;27;30;57;2;4;6
109;15.09.2016;2016;09;18;Torstai;20;19;39;4;0;4
109;15.09.2016;2016;09;19;Torstai;15;17;32;0;4;4
109;15.09.2016;2016;09;20;Torstai;15;12;27;2;0;2
109;15.09.2016;2016;09;21;Torstai;11;13;24;0;3;3
109;15.09.2016;2016;09;22;Torstai;1;1;2;0;0;0
109;15.09.2016;2016;09;23;Torstai;1;3;4;0;0;0
109;16.09.2016;2016;09;00;Perjantai;1;0;1;0;0;0
109;16.09.2016;2016;09;01;Perjantai;0;0;0;0;0;0
109;16.09.2016;2016;09;02;Perjantai;0;0;0;0;0;0
109;16.09.2016;2016;09;03;Perjantai;0;0;0;0;0;0
109;16.09.2016;2016;09;04;Perjantai;2;0;2;0;0;0
109;16.09.2016;2016;09;05;Perjantai;4;7;11;0;1;1
109;16.09.2016;2016;09;06;Perjantai;23;22;45;4;0;4
109;16.09.2016;2016;09;07;Perjantai;63;66;129;5;7;12
109;16.09.2016;2016;09;08;Perjantai;38;35;73;5;2;7
109;16.09.2016;2016;09;09;Perjantai;13;14;27;0;3;3
109;16.09.2016;2016;09;10;Perjantai;14;10;24;3;0;3
109;16.09.2016;2016;09;11;Perjantai;16;18;34;0;4;4
109;16.09.2016;2016;09;12;Perjantai;15;13;28;4;0;4
109;16.09.2016;2016;09;13;Perjantai;25;26;51;1;4;5
109;16.09.2016;2016;09;14;Perjantai;41;38;79;4;4;8
109;16.09.2016;2016;09;15;Perjantai;42;45;87;4;5;9
109;16.09.2016;2016;09;16;Perjantai;34;32;66;4;2;6
109;16.09.2016;2016;09;17;Perjantai;16;17;33;0;4;4
109;16.09.2016;2016;09;18;Perjantai;19;16;35;3;0;3
109;16.09.2016;2016;09;19;Perjantai;12;16;28;0;4;4
109;16.09.2016;2016;09;20;Perjantai;12;10;22;3;0;3
109;16.09.2016;2016;09;21;Perjantai;8;10;18;0;1;1
109;16.09.2016;2016;09;22;Perjantai;6;4;10;1;0;1
109;16.09.2016;2016;09;23;Perjantai;2;2;4;0;0;0
109;17.09.2016;2016;09;00;Lauantai;1;0;1;0;0;0
109;17.09.2016;2016;09;01;Lauantai;1;2;3;0;2;2
109;17.09.2016;2016;09;02;Lauantai;1;1;2;1;0;1
109;17.09.2016;2016;09;03;Lauantai;1;3;4;0;2;2
109;17.09.2016;2016;09;04;Lauantai;3;0;3;2;0;2
109;17.09.2016;2016;09;05;Lauantai;1;2;3;0;1;1
109;17.09.2016;2016;09;06;Lauantai;4;2;6;2;0;2
109;17.09.2016;2016;09;07;Lauantai;3;5;8;1;3;4
109;17.09.2016;2016;09;08;Lauantai;2;0;2;0;0;0
109;17.09.2016;2016;09;09;Lauantai;4;5;9;3;4;7
109;17.09.2016;2016;09;10;Lauantai;7;5;12;7;4;11
109;17.09.2016;2016;09;11;Lauantai;5;7;12;4;6;10
109;17.09.2016;2016;09;12;Lauantai;7;5;12;6;4;10
109;17.09.2016;2016;09;13;Lauantai;7;8;15;6;7;13
109;17.09.2016;2016;09;14;Lauantai;7;3;10;6;3;9
109;17.09.2016;2016;09;15;Lauantai;9;12;21;9;10;19
109;17.09.2016;2016;09;16;Lauantai;9;7;16;9;6;15
109;17.09.2016;2016;09;17;Lauantai;8;10;18;7;9;16
109;17.09.2016;2016;09;18;Lauantai;8;6;14;7;6;13
109;17.09.2016;2016;09;19;Lauantai;8;10;18;7;8;15
109;17.09.2016;2016;09;20;Lauantai;6;5;11;5;3;8
109;17.09.2016;2016;09;21;Lauantai;3;5;8;3;3;6
109;17.09.2016;2016;09;22;Lauantai;3;2;5;3;2;5
109;17.09.2016;2016;09;23;Lauantai;0;3;3;0;2;2
109;18.09.2016;2016;09;00;Sunnuntai;1;0;1;0;0;0
109;18.09.2016;2016;09;01;Sunnuntai;0;0;0;0;0;0
109;18.09.2016;2016;09;02;Sunnuntai;2;0;2;0;0;0
109;18.09.2016;2016;09;03;Sunnuntai;0;3;3;0;1;1
109;18.09.2016;2016;09;04;Sunnuntai;4;0;4;1;0;1
109;18.09.2016;2016;09;05;Sunnuntai;0;1;1;0;0;0
109;18.09.2016;2016;09;06;Sunnuntai;3;2;5;3;0;3
109;18.09.2016;2016;09;07;Sunnuntai;0;3;3;0;2;2
109;18.09.2016;2016;09;08;Sunnuntai;3;1;4;2;1;3
109;18.09.2016;2016;09;09;Sunnuntai;2;5;7;2;2;4
109;18.09.2016;2016;09;10;Sunnuntai;8;5;13;6;4;10
109;18.09.2016;2016;09;11;Sunnuntai;9;12;21;9;9;18
109;18.09.2016;2016;09;12;Sunnuntai;9;8;17;9;5;14
109;18.09.2016;2016;09;13;Sunnuntai;9;11;20;7;10;17
109;18.09.2016;2016;09;14;Sunnuntai;10;9;19;10;8;18
109;18.09.2016;2016;09;15;Sunnuntai;10;14;24;10;13;23
109;18.09.2016;2016;09;16;Sunnuntai;10;8;18;10;6;16
109;18.09.2016;2016;09;17;Sunnuntai;9;11;20;7;9;16
109;18.09.2016;2016;09;18;Sunnuntai;11;10;21;11;8;19
109;18.09.2016;2016;09;19;Sunnuntai;9;13;22;9;10;19
109;18.09.2016;2016;09;20;Sunnuntai;7;6;13;7;4;11
109;18.09.2016;2016;09;21;Sunnuntai;4;6;10;4;5;9
109;18.09.2016;2016;09;22;Sunnuntai;2;0;2;1;0;1
109;18.09.2016;2016;09;23;Sunnuntai;0;1;1;0;0;0
109;19.09.2016;2016;09;00;Maanantai;1;1;2;0;0;0
109;19.09.2016;2016;09;01;Maanantai;0;0;0;0;0;0
109;19.09.2016;2016;09;02;Maanantai;0;0;0;0;0;0
109;19.09.2016;2016;09;03;Maanantai;0;0;0;0;0;0
109;19.09.2016;2016;09;04;Maanantai;2;1;3;0;0;0
109;19.09.2016;2016;09;05;Maanantai;5;7;12;0;0;0
109;19.09.2016;2016;09;06;Maanantai;29;26;55;4;1;5
109;19.09.2016;2016;09;07;Maanantai;70;73;143;6;9;15
109;19.09.2016;2016;09;08;Maanantai;35;33;68;4;2;6
109;19.09.2016;2016;09;09;Maanantai;16;19;35;0;4;4
109;19.09.2016;2016;09;10;Maanantai;18;16;34;4;0;4
109;19.09.2016;2016;09;11;Maanantai;22;24;46;0;4;4
109;19.09.2016;2016;09;12;Maanantai;22;20;42;4;0;4
109;19.09.2016;2016;09;13;Maanantai;18;21;39;0;4;4
109;19.09.2016;2016;09;14;Maanantai;32;30;62;4;2;6
109;19.09.2016;2016;09;15;Maanantai;52;56;108;5;5;10
109;19.09.2016;2016;09;16;Maanantai;63;62;125;8;5;13
109;19.09.2016;2016;09;17;Maanantai;26;28;54;1;4;5
109;19.09.2016;2016;09;18;Maanantai;22;21;43;4;0;4
109;19.09.2016;2016;09;19;Maanantai;11;13;24;0;3;3
109;19.09.2016;2016;09;20;Maanantai;15;13;28;3;0;3
109;19.09.2016;2016;09;21;Maanantai;12;15;27;0;3;3
109;19.09.2016;2016;09;22;Maanantai;2;2;4;0;0;0
109;19.09.2016;2016;09;23;Maanantai;0;0;0;0;0;0
109;20.09.2016;2016;09;00;Tiistai;1;1;2;0;0;0
109;20.09.2016;2016;09;01;Tiistai;0;1;1;0;0;0
109;20.09.2016;2016;09;02;Tiistai;0;0;0;0;0;0
109;20.09.2016;2016;09;03;Tiistai;0;1;1;0;0;0
109;20.09.2016;2016;09;04;Tiistai;0;0;0;0;0;0
109;20.09.2016;2016;09;05;Tiistai;5;7;12;0;1;1
109;20.09.2016;2016;09;06;Tiistai;31;29;60;4;2;6
109;20.09.2016;2016;09;07;Tiistai;75;77;152;5;9;14
109;20.09.2016;2016;09;08;Tiistai;37;34;71;5;2;7
109;20.09.2016;2016;09;09;Tiistai;15;18;33;0;3;3
109;20.09.2016;2016;09;10;Tiistai;15;12;27;3;0;3
109;20.09.2016;2016;09;11;Tiistai;16;18;34;0;4;4
109;20.09.2016;2016;09;12;Tiistai;18;17;35;4;0;4
109;20.09.2016;2016;09;13;Tiistai;20;23;43;1;4;5
109;20.09.2016;2016;09;14;Tiistai;30;29;59;4;1;5
109;20.09.2016;2016;09;15;Tiistai;48;51;99;4;6;10
109;20.09.2016;2016;09;16;Tiistai;65;63;128;7;6;13
109;20.09.2016;2016;09;17;Tiistai;27;29;56;2;4;6
109;20.09.2016;2016;09;18;Tiistai;26;22;48;4;1;5
109;20.09.2016;2016;09;19;Tiistai;15;17;32;0;4;4
109;20.09.2016;2016;09;20;Tiistai;13;11;24;2;0;2
109;20.09.2016;2016;09;21;Tiistai;12;13;25;0;2;2
109;20.09.2016;2016;09;22;Tiistai;6;4;10;1;0;1
109;20.09.2016;2016;09;23;Tiistai;0;2;2;0;0;0
109;21.09.2016;2016;09;00;Keskiviikko;1;0;1;0;0;0
109;21.09.2016;2016;09;01;Keskiviikko;1;1;2;0;0;0
109;21.09.2016;2016;09;02;Keskiviikko;0;0;0;0;0;0
109;21.09.2016;2016;09;03;Keskiviikko;0;0;0;0;0;0
109;21.09.2016;2016;09;04;Keskiviikko;0;0;0;0;0;0
109;21.09.2016;2016;09;05;Keskiviikko;5;6;11;0;0;0
109;21.09.2016;2016;09;06;Keskiviikko;24;22;46;4;1;5
109;21.09.2016;2016;09;07;Keskiviikko;71;74;145;7;8;15
109;21.09.2016;2016;09;08;Keskiviikko;40;36;76;5;3;8
109;21.09.2016;2016;09;09;Keskiviikko;13;16;29;0;4;4
109;21.09.2016;2016;09;10;Keskiviikko;14;11;25;3;0;3
109;21.09.2016;2016;09;11;Keskiviikko;14;17;31;0;4;4
109;21.09.2016;2016;09;12;Keskiviikko;17;14;31;4;0;4
109;21.09.2016;2016;09;13;Keskiviikko;19;20;39;0;4;4
109;21.09.2016;2016;09;14;Keskiviikko;30;27;57;4;1;5
109;21.09.2016;2016;09;15;Keskiviikko;50;53;103;4;7;11
109;21.09.2016;2016;09;16;Keskiviikko;68;66;134;7;7;14
109;21.09.2016;2016;09;17;Keskiviikko;30;33;63;2;4;6
109;21.09.2016;2016;09;18;Keskiviikko;28;26;54;4;1;5
109;21.09.2016;2016;09;19;Keskiviikko;20;21;41;0;4;4
109;21.09.2016;2016;09;20;Keskiviikko;12;11;23;3;0;3
109;21.09.2016;2016;09;21;Keskiviikko;11;14;25;0;2;2
109;21.09.2016;2016;09;22;Keskiviikko;6;4;10;1;0;1
109;21.09.2016;2016;09;23;Keskiviikko;1;2;3;0;0;0
109;22.09.2016;2016;09;00;Torstai;2;0;2;0;0;0
109;22.09.2016;2016;09;01;Torstai;0;1;1;0;0;0
109;22.09.2016;2016;09;02;Torstai;0;0;0;0;0;0
109;22.09.2016;2016;09;03;Torstai;0;1;1;0;0;0
109;22.09.2016;2016;09;04;Torstai;1;0;1;0;0;0
109;22.09.2016;2016;09;05;Torstai;5;7;12;0;1;1
109;22.09.2016;2016;09;06;Torstai;22;22;44;3;1;4
109;22.09.2016;2016;09;07;Torstai;68;71;139;6;7;13
109;22.09.2016;2016;09;08;Torstai;34;31;65;4;2;6
109;22.09.2016;2016;09;09;Torstai;14;16;30;0;2;2
109;22.09.2016;2016;09;10;Torstai;17;14;31;4;0;4
109;22.09.2016;2016;09;11;Torstai;18;21;39;1;4;5
109;22.09.2016;2016;09;12;Torstai;18;16;34;4;0;4
109;22.09.2016;2016;09;13;Torstai;21;24;45;0;4;4
109;22.09.2016;2016;09;14;Torstai;28;27;55;4;2;6
109;22.09.2016;2016;09;15;Torstai;42;44;86;3;5;8
109;22.09.2016;2016;09;16;Torstai;55;54;109;7;4;11
109;22.09.2016;2016;09;17;Torstai;28;31;59;1;4;5
109;22.09.2016;2016;09;18;Torstai;18;16;34;4;0;4
109;22.09.2016;2016;09;19;Torstai;15;17;32;0;4;4
109;22.09.2016;2016;09;20;Torstai;14;11;25;3;0;3
109;22.09.2016;2016;09;21;Torstai;10;13;23;0;3;3
109;22.09.2016;2016;09;22;Torstai;10;7;17;2;0;2
109;22.09.2016;2016;09;23;Torstai;0;1;1;0;0;0
109;23.09.2016;2016;09;00;Perjantai;0;0;0;0;0;0
109;23.09.2016;2016;09;01;Perjantai;0;0;0;0;0;0
109;23.09.2016;2016;09;02;Perjantai;1;0;1;0;0;0
109;23.09.2016;2016;09;03;Perjantai;0;1;1;0;0;0
109;23.09.2016;2016;09;04;Perjantai;3;0;3;0;0;0
109;23.09.2016;2016;09;05;Perjantai;6;8;14;0;1;1
109;23.09.2016;2016;09;06;Perjantai;18;15;33;4;1;5
109;23.09.2016;2016;09;07;Perjantai;56;59;115;5;7;12
109;23.09.2016;2016;09;08;Perjantai;36;35;71;4;2;6
109;23.09.2016;2016;09;09;Perjantai;16;18;34;0;4;4
109;23.09.2016;2016;09;10;Perjantai;16;13;29;3;0;3
109;23.09.2016;2016;09;11;Perjantai;20;20;40;0;4;4
109;23.09.2016;2016;09;12;Perjantai;23;20;43;4;0;4
109;23.09.2016;2016;09;13;Perjantai;16;18;34;0;4;4
109;23.09.2016;2016;09;14;Perjantai;37;34;71;4;4;8
109;23.09.2016;2016;09;15;Perjantai;35;38;73;3;5;8
109;23.09.2016;2016;09;16;Perjantai;35;34;69;4;3;7
109;23.09.2016;2016;09;17;Perjantai;19;21;40;1;4;5
109;23.09.2016;2016;09;18;Perjantai;14;12;26;3;0;3
109;23.09.2016;2016;09;19;Perjantai;10;12;22;0;1;1
109;23.09.2016;2016;09;20;Perjantai;10;7;17;1;0;1
109;23.09.2016;2016;09;21;Perjantai;7;10;17;0;0;0
109;23.09.2016;2016;09;22;Perjantai;6;4;10;0;0;0
109;23.09.2016;2016;09;23;Perjantai;1;3;4;0;0;0
109;24.09.2016;2016;09;00;Lauantai;3;0;3;3;0;3
109;24.09.2016;2016;09;01;Lauantai;1;2;3;0;2;2
109;24.09.2016;2016;09;02;Lauantai;2;0;2;0;0;0
109;24.09.2016;2016;09;03;Lauantai;0;2;2;0;0;0
109;24.09.2016;2016;09;04;Lauantai;1;0;1;0;0;0
109;24.09.2016;2016;09;05;Lauantai;0;3;3;0;0;0
109;24.09.2016;2016;09;06;Lauantai;3;1;4;3;0;3
109;24.09.2016;2016;09;07;Lauantai;1;4;5;1;3;4
109;24.09.2016;2016;09;08;Lauantai;3;0;3;1;0;1
109;24.09.2016;2016;09;09;Lauantai;3;5;8;2;4;6
109;24.09.2016;2016;09;10;Lauantai;8;5;13;7;5;12
109;24.09.2016;2016;09;11;Lauantai;6;7;13;5;6;11
109;24.09.2016;2016;09;12;Lauantai;7;3;10;6;3;9
109;24.09.2016;2016;09;13;Lauantai;9;9;18;7;9;16
109;24.09.2016;2016;09;14;Lauantai;10;6;16;8;6;14
109;24.09.2016;2016;09;15;Lauantai;8;8;16;6;8;14
109;24.09.2016;2016;09;16;Lauantai;9;7;16;9;6;15
109;24.09.2016;2016;09;17;Lauantai;5;6;11;3;6;9
109;24.09.2016;2016;09;18;Lauantai;8;4;12;7;4;11
109;24.09.2016;2016;09;19;Lauantai;5;7;12;4;5;9
109;24.09.2016;2016;09;20;Lauantai;5;4;9;4;1;5
109;24.09.2016;2016;09;21;Lauantai;5;6;11;3;6;9
109;24.09.2016;2016;09;22;Lauantai;2;0;2;0;0;0
109;24.09.2016;2016;09;23;Lauantai;1;2;3;1;1;2
109;25.09.2016;2016;09;00;Sunnuntai;2;0;2;1;0;1
109;25.09.2016;2016;09;01;Sunnuntai;0;3;3;0;1;1
109;25.09.2016;2016;09;02;Sunnuntai;1;0;1;1;0;1
109;25.09.2016;2016;09;03;Sunnuntai;0;2;2;0;2;2
109;25.09.2016;2016;09;04;Sunnuntai;1;0;1;0;0;0
109;25.09.2016;2016;09;05;Sunnuntai;0;0;0;0;0;0
109;25.09.2016;2016;09;06;Sunnuntai;2;0;2;1;0;1
109;25.09.2016;2016;09;07;Sunnuntai;0;3;3;0;1;1
109;25.09.2016;2016;09;08;Sunnuntai;3;2;5;3;1;4
109;25.09.2016;2016;09;09;Sunnuntai;6;8;14;4;6;10
109;25.09.2016;2016;09;10;Sunnuntai;6;3;9;4;3;7
109;25.09.2016;2016;09;11;Sunnuntai;10;10;20;7;10;17
109;25.09.2016;2016;09;12;Sunnuntai;9;8;17;8;6;14
109;25.09.2016;2016;09;13;Sunnuntai;11;13;24;9;12;21
109;25.09.2016;2016;09;14;Sunnuntai;10;7;17;8;6;14
109;25.09.2016;2016;09;15;Sunnuntai;6;8;14;6;7;13
109;25.09.2016;2016;09;16;Sunnuntai;16;13;29;14;12;26
109;25.09.2016;2016;09;17;Sunnuntai;6;10;16;6;10;16
109;25.09.2016;2016;09;18;Sunnuntai;12;9;21;11;8;19
109;25.09.2016;2016;09;19;Sunnuntai;6;10;16;6;9;15
109;25.09.2016;2016;09;20;Sunnuntai;9;6;15;9;6;15
109;25.09.2016;2016;09;21;Sunnuntai;2;5;7;2;2;4
109;25.09.2016;2016;09;22;Sunnuntai;4;0;4;1;0;1
109;25.09.2016;2016;09;23;Sunnuntai;0;0;0;0;0;0
109;26.09.2016;2016;09;00;Maanantai;0;0;0;0;0;0
109;26.09.2016;2016;09;01;Maanantai;0;0;0;0;0;0
109;26.09.2016;2016;09;02;Maanantai;0;0;0;0;0;0
109;26.09.2016;2016;09;03;Maanantai;0;0;0;0;0;0
109;26.09.2016;2016;09;04;Maanantai;2;0;2;0;0;0
109;26.09.2016;2016;09;05;Maanantai;4;7;11;0;0;0
109;26.09.2016;2016;09;06;Maanantai;28;25;53;3;2;5
109;26.09.2016;2016;09;07;Maanantai;68;71;139;6;8;14
109;26.09.2016;2016;09;08;Maanantai;39;38;77;6;2;8
109;26.09.2016;2016;09;09;Maanantai;20;21;41;0;4;4
109;26.09.2016;2016;09;10;Maanantai;15;12;27;4;0;4
109;26.09.2016;2016;09;11;Maanantai;19;23;42;0;4;4
109;26.09.2016;2016;09;12;Maanantai;18;17;35;4;0;4
109;26.09.2016;2016;09;13;Maanantai;16;17;33;0;4;4
109;26.09.2016;2016;09;14;Maanantai;15;12;27;3;0;3
109;26.09.2016;2016;09;15;Maanantai;60;61;121;5;7;12
109;26.09.2016;2016;09;16;Maanantai;60;58;118;7;5;12
109;26.09.2016;2016;09;17;Maanantai;34;36;70;4;4;8
109;26.09.2016;2016;09;18;Maanantai;29;28;57;4;2;6
109;26.09.2016;2016;09;19;Maanantai;16;18;34;0;3;3
109;26.09.2016;2016;09;20;Maanantai;16;14;30;4;0;4
109;26.09.2016;2016;09;21;Maanantai;7;8;15;0;1;1
109;26.09.2016;2016;09;22;Maanantai;8;5;13;0;0;0
109;26.09.2016;2016;09;23;Maanantai;0;1;1;0;0;0
109;27.09.2016;2016;09;00;Tiistai;1;0;1;0;0;0
109;27.09.2016;2016;09;01;Tiistai;0;0;0;0;0;0
109;27.09.2016;2016;09;02;Tiistai;1;0;1;0;0;0
109;27.09.2016;2016;09;03;Tiistai;0;1;1;0;0;0
109;27.09.2016;2016;09;04;Tiistai;1;1;2;0;0;0
109;27.09.2016;2016;09;05;Tiistai;5;6;11;0;0;0
109;27.09.2016;2016;09;06;Tiistai;22;21;43;4;1;5
109;27.09.2016;2016;09;07;Tiistai;64;67;131;5;7;12
109;27.09.2016;2016;09;08;Tiistai;37;34;71;4;2;6
109;27.09.2016;2016;09;09;Tiistai;19;21;40;0;4;4
109;27.09.2016;2016;09;10;Tiistai;13;11;24;4;0;4
109;27.09.2016;2016;09;11;Tiistai;16;18;34;0;3;3
109;27.09.2016;2016;09;12;Tiistai;26;22;48;4;0;4
109;27.09.2016;2016;09;13;Tiistai;21;23;44;0;4;4
109;27.09.2016;2016;09;14;Tiistai;21;19;40;3;0;3
109;27.09.2016;2016;09;15;Tiistai;45;46;91;3;5;8
109;27.09.2016;2016;09;16;Tiistai;50;50;100;5;5;10
109;27.09.2016;2016;09;17;Tiistai;30;32;62;2;4;6
109;27.09.2016;2016;09;18;Tiistai;24;23;47;3;1;4
109;27.09.2016;2016;09;19;Tiistai;16;16;32;0;4;4
109;27.09.2016;2016;09;20;Tiistai;15;13;28;3;0;3
109;27.09.2016;2016;09;21;Tiistai;9;12;21;0;1;1
109;27.09.2016;2016;09;22;Tiistai;4;2;6;0;0;0
109;27.09.2016;2016;09;23;Tiistai;1;2;3;0;0;0
109;28.09.2016;2016;09;00;Keskiviikko;1;0;1;0;0;0
109;28.09.2016;2016;09;01;Keskiviikko;0;0;0;0;0;0
109;28.09.2016;2016;09;02;Keskiviikko;1;0;1;0;0;0
109;28.09.2016;2016;09;03;Keskiviikko;0;1;1;0;0;0
109;28.09.2016;2016;09;04;Keskiviikko;3;0;3;0;0;0
109;28.09.2016;2016;09;05;Keskiviikko;3;6;9;0;0;0
109;28.09.2016;2016;09;06;Keskiviikko;23;20;43;4;0;4
109;28.09.2016;2016;09;07;Keskiviikko;59;61;120;5;6;11
109;28.09.2016;2016;09;08;Keskiviikko;30;30;60;4;1;5
109;28.09.2016;2016;09;09;Keskiviikko;20;21;41;0;4;4
109;28.09.2016;2016;09;10;Keskiviikko;14;10;24;3;0;3
109;28.09.2016;2016;09;11;Keskiviikko;17;19;36;0;4;4
109;28.09.2016;2016;09;12;Keskiviikko;12;10;22;3;0;3
109;28.09.2016;2016;09;13;Keskiviikko;14;17;31;0;4;4
109;28.09.2016;2016;09;14;Keskiviikko;22;21;43;4;1;5
109;28.09.2016;2016;09;15;Keskiviikko;40;42;82;3;5;8
109;28.09.2016;2016;09;16;Keskiviikko;36;35;71;4;3;7
109;28.09.2016;2016;09;17;Keskiviikko;16;18;34;0;4;4
109;28.09.2016;2016;09;18;Keskiviikko;11;10;21;1;0;1
109;28.09.2016;2016;09;19;Keskiviikko;8;10;18;0;1;1
109;28.09.2016;2016;09;20;Keskiviikko;13;10;23;3;0;3
109;28.09.2016;2016;09;21;Keskiviikko;6;9;15;0;2;2
109;28.09.2016;2016;09;22;Keskiviikko;6;4;10;1;0;1
109;28.09.2016;2016;09;23;Keskiviikko;0;1;1;0;0;0
109;29.09.2016;2016;09;00;Torstai;3;1;4;0;0;0
109;29.09.2016;2016;09;01;Torstai;0;1;1;0;0;0
109;29.09.2016;2016;09;02;Torstai;1;0;1;0;0;0
109;29.09.2016;2016;09;03;Torstai;0;1;1;0;0;0
109;29.09.2016;2016;09;04;Torstai;2;0;2;0;0;0
109;29.09.2016;2016;09;05;Torstai;5;8;13;0;0;0
109;29.09.2016;2016;09;06;Torstai;23;19;42;4;1;5
109;29.09.2016;2016;09;07;Torstai;57;61;118;5;7;12
109;29.09.2016;2016;09;08;Torstai;35;32;67;5;2;7
109;29.09.2016;2016;09;09;Torstai;17;20;37;0;3;3
109;29.09.2016;2016;09;10;Torstai;10;7;17;1;0;1
109;29.09.2016;2016;09;11;Torstai;19;19;38;0;4;4
109;29.09.2016;2016;09;12;Torstai;14;12;26;4;0;4
109;29.09.2016;2016;09;13;Torstai;21;23;44;1;4;5
109;29.09.2016;2016;09;14;Torstai;20;19;39;4;1;5
109;29.09.2016;2016;09;15;Torstai;40;43;83;4;4;8
109;29.09.2016;2016;09;16;Torstai;60;60;120;6;5;11
109;29.09.2016;2016;09;17;Torstai;28;32;60;1;5;6
109;29.09.2016;2016;09;18;Torstai;17;14;31;3;0;3
109;29.09.2016;2016;09;19;Torstai;6;9;15;0;2;2
109;29.09.2016;2016;09;20;Torstai;13;12;25;3;0;3
109;29.09.2016;2016;09;21;Torstai;4;6;10;0;1;1
109;29.09.2016;2016;09;22;Torstai;3;1;4;0;0;0
109;29.09.2016;2016;09;23;Torstai;1;1;2;0;0;0
109;30.09.2016;2016;09;00;Perjantai;2;0;2;0;0;0
109;30.09.2016;2016;09;01;Perjantai;0;0;0;0;0;0
109;30.09.2016;2016;09;02;Perjantai;2;1;3;0;0;0
109;30.09.2016;2016;09;03;Perjantai;0;0;0;0;0;0
109;30.09.2016;2016;09;04;Perjantai;2;0;2;0;0;0
109;30.09.2016;2016;09;05;Perjantai;4;6;10;0;0;0
109;30.09.2016;2016;09;06;Perjantai;20;19;39;4;0;4
109;30.09.2016;2016;09;07;Perjantai;44;47;91;3;6;9
109;30.09.2016;2016;09;08;Perjantai;31;29;60;4;1;5
109;30.09.2016;2016;09;09;Perjantai;12;14;26;0;4;4
109;30.09.2016;2016;09;10;Perjantai;7;5;12;2;0;2
109;30.09.2016;2016;09;11;Perjantai;13;14;27;0;3;3
109;30.09.2016;2016;09;12;Perjantai;18;16;34;4;0;4
109;30.09.2016;2016;09;13;Perjantai;16;20;36;0;3;3
109;30.09.2016;2016;09;14;Perjantai;28;25;53;4;2;6
109;30.09.2016;2016;09;15;Perjantai;31;32;63;3;4;7
109;30.09.2016;2016;09;16;Perjantai;33;31;64;4;3;7
109;30.09.2016;2016;09;17;Perjantai;13;17;30;0;4;4
109;30.09.2016;2016;09;18;Perjantai;12;11;23;3;0;3
109;30.09.2016;2016;09;19;Perjantai;12;12;24;0;3;3
109;30.09.2016;2016;09;20;Perjantai;6;5;11;1;0;1
109;30.09.2016;2016;09;21;Perjantai;6;9;15;0;1;1
109;30.09.2016;2016;09;22;Perjantai;6;3;9;0;0;0
109;30.09.2016;2016;09;23;Perjantai;1;2;3;0;0;0
109;01.10.2016;2016;10;00;Lauantai;1;0;1;0;0;0
109;01.10.2016;2016;10;01;Lauantai;0;2;2;0;1;1
109;01.10.2016;2016;10;02;Lauantai;0;0;0;0;0;0
109;01.10.2016;2016;10;03;Lauantai;0;1;1;0;0;0
109;01.10.2016;2016;10;04;Lauantai;2;0;2;0;0;0
109;01.10.2016;2016;10;05;Lauantai;0;1;1;0;1;1
109;01.10.2016;2016;10;06;Lauantai;5;2;7;3;2;5
109;01.10.2016;2016;10;07;Lauantai;1;4;5;0;2;2
109;01.10.2016;2016;10;08;Lauantai;6;3;9;4;2;6
109;01.10.2016;2016;10;09;Lauantai;6;8;14;5;7;12
109;01.10.2016;2016;10;10;Lauantai;6;5;11;5;5;10
109;01.10.2016;2016;10;11;Lauantai;6;7;13;4;7;11
109;01.10.2016;2016;10;12;Lauantai;8;8;16;8;6;14
109;01.10.2016;2016;10;13;Lauantai;7;8;15;6;8;14
109;01.10.2016;2016;10;14;Lauantai;7;6;13;6;4;10
109;01.10.2016;2016;10;15;Lauantai;8;10;18;8;9;17
109;01.10.2016;2016;10;16;Lauantai;9;6;15;7;5;12
109;01.10.2016;2016;10;17;Lauantai;8;9;17;5;9;14
109;01.10.2016;2016;10;18;Lauantai;9;6;15;7;6;13
109;01.10.2016;2016;10;19;Lauantai;5;7;12;5;6;11
109;01.10.2016;2016;10;20;Lauantai;4;2;6;3;1;4
109;01.10.2016;2016;10;21;Lauantai;3;4;7;3;4;7
109;01.10.2016;2016;10;22;Lauantai;3;0;3;1;0;1
109;01.10.2016;2016;10;23;Lauantai;0;2;2;0;0;0
109;02.10.2016;2016;10;00;Sunnuntai;1;0;1;1;0;1
109;02.10.2016;2016;10;01;Sunnuntai;0;0;0;0;0;0
109;02.10.2016;2016;10;02;Sunnuntai;1;0;1;0;0;0
109;02.10.2016;2016;10;03;Sunnuntai;0;1;1;0;0;0
109;02.10.2016;2016;10;04;Sunnuntai;2;0;2;0;0;0
109;02.10.2016;2016;10;05;Sunnuntai;0;2;2;0;1;1
109;02.10.2016;2016;10;06;Sunnuntai;4;3;7;3;1;4
109;02.10.2016;2016;10;07;Sunnuntai;2;5;7;1;4;5
109;02.10.2016;2016;10;08;Sunnuntai;6;4;10;4;3;7
109;02.10.2016;2016;10;09;Sunnuntai;3;6;9;3;4;7
109;02.10.2016;2016;10;10;Sunnuntai;9;5;14;7;5;12
109;02.10.2016;2016;10;11;Sunnuntai;4;6;10;4;6;10
109;02.10.2016;2016;10;12;Sunnuntai;14;11;25;12;10;22
109;02.10.2016;2016;10;13;Sunnuntai;8;10;18;7;10;17
109;02.10.2016;2016;10;14;Sunnuntai;10;9;19;10;8;18
109;02.10.2016;2016;10;15;Sunnuntai;7;9;16;6;7;13
109;02.10.2016;2016;10;16;Sunnuntai;10;6;16;8;6;14
109;02.10.2016;2016;10;17;Sunnuntai;6;8;14;6;7;13
109;02.10.2016;2016;10;18;Sunnuntai;11;9;20;9;7;16
109;02.10.2016;2016;10;19;Sunnuntai;5;7;12;4;5;9
109;02.10.2016;2016;10;20;Sunnuntai;7;5;12;6;5;11
109;02.10.2016;2016;10;21;Sunnuntai;3;4;7;3;4;7
109;02.10.2016;2016;10;22;Sunnuntai;3;0;3;1;0;1
109;02.10.2016;2016;10;23;Sunnuntai;0;2;2;0;1;1
109;03.10.2016;2016;10;00;Maanantai;1;0;1;0;0;0
109;03.10.2016;2016;10;01;Maanantai;0;1;1;0;0;0
109;03.10.2016;2016;10;02;Maanantai;0;0;0;0;0;0
109;03.10.2016;2016;10;03;Maanantai;0;0;0;0;0;0
109;03.10.2016;2016;10;04;Maanantai;3;1;4;0;0;0
109;03.10.2016;2016;10;05;Maanantai;5;5;10;0;0;0
109;03.10.2016;2016;10;06;Maanantai;23;22;45;3;1;4
109;03.10.2016;2016;10;07;Maanantai;66;69;135;6;8;14
109;03.10.2016;2016;10;08;Maanantai;39;39;78;5;3;8
109;03.10.2016;2016;10;09;Maanantai;19;21;40;1;4;5
109;03.10.2016;2016;10;10;Maanantai;14;12;26;4;0;4
109;03.10.2016;2016;10;11;Maanantai;15;16;31;0;4;4
109;03.10.2016;2016;10;12;Maanantai;27;27;54;4;1;5
109;03.10.2016;2016;10;13;Maanantai;22;24;46;1;4;5
109;03.10.2016;2016;10;14;Maanantai;31;28;59;4;2;6
109;03.10.2016;2016;10;15;Maanantai;53;56;109;5;7;12
109;03.10.2016;2016;10;16;Maanantai;51;48;99;6;3;9
109;03.10.2016;2016;10;17;Maanantai;30;32;62;2;4;6
109;03.10.2016;2016;10;18;Maanantai;19;18;37;4;0;4
109;03.10.2016;2016;10;19;Maanantai;14;15;29;0;4;4
109;03.10.2016;2016;10;20;Maanantai;15;12;27;3;0;3
109;03.10.2016;2016;10;21;Maanantai;7;11;18;0;1;1
109;03.10.2016;2016;10;22;Maanantai;7;5;12;0;0;0
109;03.10.2016;2016;10;23;Maanantai;0;0;0;0;0;0
109;04.10.2016;2016;10;00;Tiistai;2;1;3;0;0;0
109;04.10.2016;2016;10;01;Tiistai;0;0;0;0;0;0
109;04.10.2016;2016;10;02;Tiistai;0;0;0;0;0;0
109;04.10.2016;2016;10;03;Tiistai;0;1;1;0;0;0
109;04.10.2016;2016;10;04;Tiistai;1;0;1;0;0;0
109;04.10.2016;2016;10;05;Tiistai;5;7;12;0;0;0
109;04.10.2016;2016;10;06;Tiistai;23;20;43;4;0;4
109;04.10.2016;2016;10;07;Tiistai;73;76;149;6;8;14
109;04.10.2016;2016;10;08;Tiistai;33;30;63;5;1;6
109;04.10.2016;2016;10;09;Tiistai;15;18;33;0;4;4
109;04.10.2016;2016;10;10;Tiistai;13;11;24;2;0;2
109;04.10.2016;2016;10;11;Tiistai;15;18;33;0;4;4
109;04.10.2016;2016;10;12;Tiistai;22;19;41;4;0;4
109;04.10.2016;2016;10;13;Tiistai;18;22;40;0;4;4
109;04.10.2016;2016;10;14;Tiistai;28;24;52;4;2;6
109;04.10.2016;2016;10;15;Tiistai;50;51;101;4;7;11
109;04.10.2016;2016;10;16;Tiistai;60;59;119;8;4;12
109;04.10.2016;2016;10;17;Tiistai;23;26;49;1;4;5
109;04.10.2016;2016;10;18;Tiistai;20;17;37;4;0;4
109;04.10.2016;2016;10;19;Tiistai;19;21;40;0;4;4
109;04.10.2016;2016;10;20;Tiistai;12;10;22;3;0;3
109;04.10.2016;2016;10;21;Tiistai;9;11;20;0;2;2
109;04.10.2016;2016;10;22;Tiistai;5;4;9;0;0;0
109;04.10.2016;2016;10;23;Tiistai;0;1;1;0;0;0
109;05.10.2016;2016;10;00;Keskiviikko;0;0;0;0;0;0
109;05.10.2016;2016;10;01;Keskiviikko;0;0;0;0;0;0
109;05.10.2016;2016;10;02;Keskiviikko;0;0;0;0;0;0
109;05.10.2016;2016;10;03;Keskiviikko;0;0;0;0;0;0
109;05.10.2016;2016;10;04;Keskiviikko;1;0;1;0;0;0
109;05.10.2016;2016;10;05;Keskiviikko;4;6;10;0;0;0
109;05.10.2016;2016;10;06;Keskiviikko;24;21;45;3;2;5
109;05.10.2016;2016;10;07;Keskiviikko;65;68;133;6;6;12
109;05.10.2016;2016;10;08;Keskiviikko;38;36;74;5;2;7
109;05.10.2016;2016;10;09;Keskiviikko;18;20;38;0;4;4
109;05.10.2016;2016;10;10;Keskiviikko;17;13;30;3;0;3
109;05.10.2016;2016;10;11;Keskiviikko;14;16;30;0;3;3
109;05.10.2016;2016;10;12;Keskiviikko;19;15;34;3;0;3
109;05.10.2016;2016;10;13;Keskiviikko;21;24;45;1;4;5
109;05.10.2016;2016;10;14;Keskiviikko;26;23;49;4;0;4
109;05.10.2016;2016;10;15;Keskiviikko;41;43;84;4;4;8
109;05.10.2016;2016;10;16;Keskiviikko;62;61;123;7;5;12
109;05.10.2016;2016;10;17;Keskiviikko;30;33;63;2;4;6
109;05.10.2016;2016;10;18;Keskiviikko;29;26;55;4;2;6
109;05.10.2016;2016;10;19;Keskiviikko;15;17;32;0;4;4
109;05.10.2016;2016;10;20;Keskiviikko;10;8;18;0;0;0
109;05.10.2016;2016;10;21;Keskiviikko;9;13;22;0;2;2
109;05.10.2016;2016;10;22;Keskiviikko;4;3;7;0;0;0
109;05.10.2016;2016;10;23;Keskiviikko;0;1;1;0;0;0
109;06.10.2016;2016;10;00;Torstai;3;0;3;0;0;0
109;06.10.2016;2016;10;01;Torstai;0;0;0;0;0;0
109;06.10.2016;2016;10;02;Torstai;0;0;0;0;0;0
109;06.10.2016;2016;10;03;Torstai;0;0;0;0;0;0
109;06.10.2016;2016;10;04;Torstai;1;0;1;0;0;0
109;06.10.2016;2016;10;05;Torstai;5;6;11;0;0;0
109;06.10.2016;2016;10;06;Torstai;22;21;43;3;1;4
109;06.10.2016;2016;10;07;Torstai;67;67;134;5;8;13
109;06.10.2016;2016;10;08;Torstai;33;32;65;4;2;6
109;06.10.2016;2016;10;09;Torstai;16;20;36;1;3;4
109;06.10.2016;2016;10;10;Torstai;11;9;20;2;0;2
109;06.10.2016;2016;10;11;Torstai;13;15;28;0;4;4
109;06.10.2016;2016;10;12;Torstai;18;15;33;4;0;4
109;06.10.2016;2016;10;13;Torstai;19;20;39;0;4;4
109;06.10.2016;2016;10;14;Torstai;20;19;39;4;0;4
109;06.10.2016;2016;10;15;Torstai;41;44;85;4;5;9
109;06.10.2016;2016;10;16;Torstai;54;51;105;6;4;10
109;06.10.2016;2016;10;17;Torstai;23;24;47;0;4;4
109;06.10.2016;2016;10;18;Torstai;17;16;33;4;0;4
109;06.10.2016;2016;10;19;Torstai;10;12;22;0;2;2
109;06.10.2016;2016;10;20;Torstai;13;10;23;1;0;1
109;06.10.2016;2016;10;21;Torstai;12;15;27;0;2;2
109;06.10.2016;2016;10;22;Torstai;2;1;3;0;0;0
109;06.10.2016;2016;10;23;Torstai;0;3;3;0;0;0
109;07.10.2016;2016;10;00;Perjantai;0;0;0;0;0;0
109;07.10.2016;2016;10;01;Perjantai;1;1;2;0;0;0
109;07.10.2016;2016;10;02;Perjantai;1;0;1;0;0;0
109;07.10.2016;2016;10;03;Perjantai;0;0;0;0;0;0
109;07.10.2016;2016;10;04;Perjantai;1;0;1;0;0;0
109;07.10.2016;2016;10;05;Perjantai;6;8;14;0;0;0
109;07.10.2016;2016;10;06;Perjantai;15;14;29;3;0;3
109;07.10.2016;2016;10;07;Perjantai;48;51;99;4;6;10
109;07.10.2016;2016;10;08;Perjantai;30;27;57;4;2;6
109;07.10.2016;2016;10;09;Perjantai;18;21;39;0;4;4
109;07.10.2016;2016;10;10;Perjantai;14;13;27;3;0;3
109;07.10.2016;2016;10;11;Perjantai;20;20;40;1;4;5
109;07.10.2016;2016;10;12;Perjantai;18;16;34;3;0;3
109;07.10.2016;2016;10;13;Perjantai;22;25;47;1;4;5
109;07.10.2016;2016;10;14;Perjantai;33;31;64;4;3;7
109;07.10.2016;2016;10;15;Perjantai;42;44;86;4;4;8
109;07.10.2016;2016;10;16;Perjantai;34;33;67;4;2;6
109;07.10.2016;2016;10;17;Perjantai;24;24;48;0;4;4
109;07.10.2016;2016;10;18;Perjantai;14;13;27;3;0;3
109;07.10.2016;2016;10;19;Perjantai;11;14;25;0;3;3
109;07.10.2016;2016;10;20;Perjantai;7;6;13;0;0;0
109;07.10.2016;2016;10;21;Perjantai;8;9;17;0;1;1
109;07.10.2016;2016;10;22;Perjantai;5;2;7;0;0;0
109;07.10.2016;2016;10;23;Perjantai;1;2;3;0;0;0
109;08.10.2016;2016;10;00;Lauantai;2;0;2;1;0;1
109;08.10.2016;2016;10;01;Lauantai;0;1;1;0;0;0
109;08.10.2016;2016;10;02;Lauantai;1;0;1;1;0;1
109;08.10.2016;2016;10;03;Lauantai;0;2;2;0;2;2
109;08.10.2016;2016;10;04;Lauantai;3;0;3;1;0;1
109;08.10.2016;2016;10;05;Lauantai;0;2;2;0;0;0
109;08.10.2016;2016;10;06;Lauantai;3;0;3;3;0;3
109;08.10.2016;2016;10;07;Lauantai;3;5;8;1;4;5
109;08.10.2016;2016;10;08;Lauantai;4;3;7;4;0;4
109;08.10.2016;2016;10;09;Lauantai;3;4;7;3;4;7
109;08.10.2016;2016;10;10;Lauantai;8;6;14;8;4;12
109;08.10.2016;2016;10;11;Lauantai;8;11;19;7;9;16
109;08.10.2016;2016;10;12;Lauantai;6;5;11;6;4;10
109;08.10.2016;2016;10;13;Lauantai;8;9;17;7;8;15
109;08.10.2016;2016;10;14;Lauantai;6;4;10;5;3;8
109;08.10.2016;2016;10;15;Lauantai;9;10;19;6;10;16
109;08.10.2016;2016;10;16;Lauantai;9;7;16;8;7;15
109;08.10.2016;2016;10;17;Lauantai;6;7;13;4;7;11
109;08.10.2016;2016;10;18;Lauantai;8;5;13;6;5;11
109;08.10.2016;2016;10;19;Lauantai;5;5;10;2;5;7
109;08.10.2016;2016;10;20;Lauantai;4;2;6;4;1;5
109;08.10.2016;2016;10;21;Lauantai;2;5;7;2;2;4
109;08.10.2016;2016;10;22;Lauantai;4;1;5;3;0;3
109;08.10.2016;2016;10;23;Lauantai;1;3;4;1;1;2
109;09.10.2016;2016;10;00;Sunnuntai;2;0;2;1;0;1
109;09.10.2016;2016;10;01;Sunnuntai;0;2;2;0;0;0
109;09.10.2016;2016;10;02;Sunnuntai;1;1;2;1;1;2
109;09.10.2016;2016;10;03;Sunnuntai;1;2;3;0;1;1
109;09.10.2016;2016;10;04;Sunnuntai;2;0;2;0;0;0
109;09.10.2016;2016;10;05;Sunnuntai;1;2;3;0;1;1
109;09.10.2016;2016;10;06;Sunnuntai;2;0;2;0;0;0
109;09.10.2016;2016;10;07;Sunnuntai;1;3;4;1;3;4
109;09.10.2016;2016;10;08;Sunnuntai;4;0;4;3;0;3
109;09.10.2016;2016;10;09;Sunnuntai;1;4;5;0;1;1
109;09.10.2016;2016;10;10;Sunnuntai;8;6;14;7;6;13
109;09.10.2016;2016;10;11;Sunnuntai;7;8;15;6;7;13
109;09.10.2016;2016;10;12;Sunnuntai;8;6;14;8;6;14
109;09.10.2016;2016;10;13;Sunnuntai;7;9;16;6;7;13
109;09.10.2016;2016;10;14;Sunnuntai;6;4;10;5;4;9
109;09.10.2016;2016;10;15;Sunnuntai;8;11;19;7;10;17
109;09.10.2016;2016;10;16;Sunnuntai;10;8;18;8;7;15
109;09.10.2016;2016;10;17;Sunnuntai;9;11;20;8;10;18
109;09.10.2016;2016;10;18;Sunnuntai;10;9;19;9;6;15
109;09.10.2016;2016;10;19;Sunnuntai;3;6;9;3;4;7
109;09.10.2016;2016;10;20;Sunnuntai;8;5;13;7;5;12
109;09.10.2016;2016;10;21;Sunnuntai;5;8;13;5;6;11
109;09.10.2016;2016;10;22;Sunnuntai;3;0;3;2;0;2
109;09.10.2016;2016;10;23;Sunnuntai;0;0;0;0;0;0
109;10.10.2016;2016;10;00;Maanantai;0;0;0;0;0;0
109;10.10.2016;2016;10;01;Maanantai;1;1;2;0;0;0
109;10.10.2016;2016;10;02;Maanantai;0;0;0;0;0;0
109;10.10.2016;2016;10;03;Maanantai;0;0;0;0;0;0
109;10.10.2016;2016;10;04;Maanantai;1;0;1;0;0;0
109;10.10.2016;2016;10;05;Maanantai;5;7;12;0;0;0
109;10.10.2016;2016;10;06;Maanantai;24;20;44;3;1;4
109;10.10.2016;2016;10;07;Maanantai;61;64;125;5;7;12
109;10.10.2016;2016;10;08;Maanantai;35;32;67;4;2;6
109;10.10.2016;2016;10;09;Maanantai;18;20;38;0;4;4
109;10.10.2016;2016;10;10;Maanantai;15;11;26;3;0;3
109;10.10.2016;2016;10;11;Maanantai;13;16;29;0;3;3
109;10.10.2016;2016;10;12;Maanantai;18;16;34;4;0;4
109;10.10.2016;2016;10;13;Maanantai;20;21;41;0;4;4
109;10.10.2016;2016;10;14;Maanantai;25;23;48;4;1;5
109;10.10.2016;2016;10;15;Maanantai;51;55;106;4;6;10
109;10.10.2016;2016;10;16;Maanantai;51;50;101;7;4;11
109;10.10.2016;2016;10;17;Maanantai;30;32;62;1;4;5
109;10.10.2016;2016;10;18;Maanantai;22;19;41;4;0;4
109;10.10.2016;2016;10;19;Maanantai;14;17;31;0;2;2
109;10.10.2016;2016;10;20;Maanantai;11;7;18;0;0;0
109;10.10.2016;2016;10;21;Maanantai;10;12;22;0;3;3
109;10.10.2016;2016;10;22;Maanantai;5;3;8;0;0;0
109;10.10.2016;2016;10;23;Maanantai;1;2;3;0;0;0
109;11.10.2016;2016;10;00;Tiistai;1;0;1;0;0;0
109;11.10.2016;2016;10;01;Tiistai;0;0;0;0;0;0
109;11.10.2016;2016;10;02;Tiistai;1;0;1;0;0;0
109;11.10.2016;2016;10;03;Tiistai;0;0;0;0;0;0
109;11.10.2016;2016;10;04;Tiistai;1;0;1;0;0;0
109;11.10.2016;2016;10;05;Tiistai;2;6;8;0;0;0
109;11.10.2016;2016;10;06;Tiistai;26;25;51;3;1;4
109;11.10.2016;2016;10;07;Tiistai;58;58;116;5;7;12
109;11.10.2016;2016;10;08;Tiistai;38;37;75;5;2;7
109;11.10.2016;2016;10;09;Tiistai;17;19;36;0;4;4
109;11.10.2016;2016;10;10;Tiistai;15;11;26;4;0;4
109;11.10.2016;2016;10;11;Tiistai;18;19;37;0;4;4
109;11.10.2016;2016;10;12;Tiistai;17;14;31;3;0;3
109;11.10.2016;2016;10;13;Tiistai;13;16;29;0;4;4
109;11.10.2016;2016;10;14;Tiistai;21;19;40;4;1;5
109;11.10.2016;2016;10;15;Tiistai;48;49;97;4;6;10
109;11.10.2016;2016;10;16;Tiistai;53;49;102;5;5;10
109;11.10.2016;2016;10;17;Tiistai;30;32;62;3;4;7
109;11.10.2016;2016;10;18;Tiistai;24;23;47;4;0;4
109;11.10.2016;2016;10;19;Tiistai;14;16;30;0;4;4
109;11.10.2016;2016;10;20;Tiistai;14;11;25;3;0;3
109;11.10.2016;2016;10;21;Tiistai;9;11;20;0;1;1
109;11.10.2016;2016;10;22;Tiistai;6;4;10;0;0;0
109;11.10.2016;2016;10;23;Tiistai;0;2;2;0;0;0
109;12.10.2016;2016;10;00;Keskiviikko;1;0;1;0;0;0
109;12.10.2016;2016;10;01;Keskiviikko;0;1;1;0;0;0
109;12.10.2016;2016;10;02;Keskiviikko;2;0;2;0;0;0
109;12.10.2016;2016;10;03;Keskiviikko;0;0;0;0;0;0
109;12.10.2016;2016;10;04;Keskiviikko;1;0;1;0;0;0
109;12.10.2016;2016;10;05;Keskiviikko;3;6;9;0;0;0
109;12.10.2016;2016;10;06;Keskiviikko;24;22;46;4;0;4
109;12.10.2016;2016;10;07;Keskiviikko;62;63;125;6;7;13
109;12.10.2016;2016;10;08;Keskiviikko;37;34;71;4;3;7
109;12.10.2016;2016;10;09;Keskiviikko;18;21;39;0;4;4
109;12.10.2016;2016;10;10;Keskiviikko;16;12;28;2;0;2
109;12.10.2016;2016;10;11;Keskiviikko;14;15;29;0;4;4
109;12.10.2016;2016;10;12;Keskiviikko;11;8;19;1;0;1
109;12.10.2016;2016;10;13;Keskiviikko;16;18;34;0;4;4
109;12.10.2016;2016;10;14;Keskiviikko;26;23;49;3;1;4
109;12.10.2016;2016;10;15;Keskiviikko;46;49;95;4;5;9
109;12.10.2016;2016;10;16;Keskiviikko;50;48;98;6;4;10
109;12.10.2016;2016;10;17;Keskiviikko;20;22;42;0;4;4
109;12.10.2016;2016;10;18;Keskiviikko;22;21;43;4;0;4
109;12.10.2016;2016;10;19;Keskiviikko;11;13;24;0;4;4
109;12.10.2016;2016;10;20;Keskiviikko;22;18;40;4;1;5
109;12.10.2016;2016;10;21;Keskiviikko;168;170;338;15;19;34
109;12.10.2016;2016;10;22;Keskiviikko;13;12;25;1;1;2
109;12.10.2016;2016;10;23;Keskiviikko;0;1;1;0;0;0
109;13.10.2016;2016;10;00;Torstai;2;0;2;0;0;0
109;13.10.2016;2016;10;01;Torstai;0;0;0;0;0;0
109;13.10.2016;2016;10;02;Torstai;0;0;0;0;0;0
109;13.10.2016;2016;10;03;Torstai;0;0;0;0;0;0
109;13.10.2016;2016;10;04;Torstai;1;0;1;0;0;0
109;13.10.2016;2016;10;05;Torstai;4;7;11;0;0;0
109;13.10.2016;2016;10;06;Torstai;24;21;45;4;0;4
109;13.10.2016;2016;10;07;Torstai;61;63;124;5;7;12
109;13.10.2016;2016;10;08;Torstai;34;32;66;4;2;6
109;13.10.2016;2016;10;09;Torstai;16;18;34;1;4;5
109;13.10.2016;2016;10;10;Torstai;14;13;27;4;0;4
109;13.10.2016;2016;10;11;Torstai;17;19;36;0;4;4
109;13.10.2016;2016;10;12;Torstai;16;12;28;4;0;4
109;13.10.2016;2016;10;13;Torstai;14;16;30;0;4;4
109;13.10.2016;2016;10;14;Torstai;25;24;49;4;1;5
109;13.10.2016;2016;10;15;Torstai;47;48;95;4;6;10
109;13.10.2016;2016;10;16;Torstai;58;56;114;6;5;11
109;13.10.2016;2016;10;17;Torstai;20;23;43;0;4;4
109;13.10.2016;2016;10;18;Torstai;23;22;45;4;1;5
109;13.10.2016;2016;10;19;Torstai;14;17;31;0;3;3
109;13.10.2016;2016;10;20;Torstai;11;8;19;2;0;2
109;13.10.2016;2016;10;21;Torstai;9;11;20;0;2;2
109;13.10.2016;2016;10;22;Torstai;4;0;4;0;0;0
109;13.10.2016;2016;10;23;Torstai;2;4;6;0;0;0
109;14.10.2016;2016;10;00;Perjantai;1;1;2;0;0;0
109;14.10.2016;2016;10;01;Perjantai;0;0;0;0;0;0
109;14.10.2016;2016;10;02;Perjantai;0;0;0;0;0;0
109;14.10.2016;2016;10;03;Perjantai;0;0;0;0;0;0
109;14.10.2016;2016;10;04;Perjantai;0;0;0;0;0;0
109;14.10.2016;2016;10;05;Perjantai;6;8;14;0;0;0
109;14.10.2016;2016;10;06;Perjantai;20;16;36;3;0;3
109;14.10.2016;2016;10;07;Perjantai;52;54;106;4;6;10
109;14.10.2016;2016;10;08;Perjantai;31;28;59;4;2;6
109;14.10.2016;2016;10;09;Perjantai;17;19;36;0;4;4
109;14.10.2016;2016;10;10;Perjantai;17;14;31;4;0;4
109;14.10.2016;2016;10;11;Perjantai;17;19;36;0;4;4
109;14.10.2016;2016;10;12;Perjantai;23;21;44;4;1;5
109;14.10.2016;2016;10;13;Perjantai;19;22;41;0;4;4
109;14.10.2016;2016;10;14;Perjantai;23;20;43;4;0;4
109;14.10.2016;2016;10;15;Perjantai;41;41;82;4;4;8
109;14.10.2016;2016;10;16;Perjantai;41;39;80;5;3;8
109;14.10.2016;2016;10;17;Perjantai;20;20;40;0;4;4
109;14.10.2016;2016;10;18;Perjantai;13;10;23;3;0;3
109;14.10.2016;2016;10;19;Perjantai;6;10;16;0;2;2
109;14.10.2016;2016;10;20;Perjantai;12;10;22;3;0;3
109;14.10.2016;2016;10;21;Perjantai;6;9;15;0;1;1
109;14.10.2016;2016;10;22;Perjantai;5;2;7;0;0;0
109;14.10.2016;2016;10;23;Perjantai;3;5;8;0;0;0
109;15.10.2016;2016;10;00;Lauantai;2;0;2;1;0;1
109;15.10.2016;2016;10;01;Lauantai;0;3;3;0;0;0
109;15.10.2016;2016;10;02;Lauantai;3;0;3;0;0;0
109;15.10.2016;2016;10;03;Lauantai;0;0;0;0;0;0
109;15.10.2016;2016;10;04;Lauantai;1;0;1;0;0;0
109;15.10.2016;2016;10;05;Lauantai;0;3;3;0;2;2
109;15.10.2016;2016;10;06;Lauantai;3;2;5;2;1;3
109;15.10.2016;2016;10;07;Lauantai;1;2;3;0;2;2
109;15.10.2016;2016;10;08;Lauantai;3;1;4;2;0;2
109;15.10.2016;2016;10;09;Lauantai;4;5;9;1;5;6
109;15.10.2016;2016;10;10;Lauantai;6;4;10;4;4;8
109;15.10.2016;2016;10;11;Lauantai;7;8;15;6;8;14
109;15.10.2016;2016;10;12;Lauantai;11;8;19;9;7;16
109;15.10.2016;2016;10;13;Lauantai;3;4;7;2;4;6
109;15.10.2016;2016;10;14;Lauantai;12;9;21;11;8;19
109;15.10.2016;2016;10;15;Lauantai;5;8;13;5;7;12
109;15.10.2016;2016;10;16;Lauantai;8;7;15;8;5;13
109;15.10.2016;2016;10;17;Lauantai;6;9;15;5;8;13
109;15.10.2016;2016;10;18;Lauantai;7;4;11;6;3;9
109;15.10.2016;2016;10;19;Lauantai;3;6;9;3;5;8
109;15.10.2016;2016;10;20;Lauantai;3;2;5;2;0;2
109;15.10.2016;2016;10;21;Lauantai;2;5;7;2;4;6
109;15.10.2016;2016;10;22;Lauantai;4;1;5;4;1;5
109;15.10.2016;2016;10;23;Lauantai;0;2;2;0;1;1
109;16.10.2016;2016;10;00;Sunnuntai;1;0;1;0;0;0
109;16.10.2016;2016;10;01;Sunnuntai;0;0;0;0;0;0
109;16.10.2016;2016;10;02;Sunnuntai;1;0;1;0;0;0
109;16.10.2016;2016;10;03;Sunnuntai;0;1;1;0;0;0
109;16.10.2016;2016;10;04;Sunnuntai;3;0;3;1;0;1
109;16.10.2016;2016;10;05;Sunnuntai;0;4;4;0;1;1
109;16.10.2016;2016;10;06;Sunnuntai;3;1;4;2;0;2
109;16.10.2016;2016;10;07;Sunnuntai;1;3;4;1;2;3
109;16.10.2016;2016;10;08;Sunnuntai;4;1;5;3;0;3
109;16.10.2016;2016;10;09;Sunnuntai;3;4;7;1;3;4
109;16.10.2016;2016;10;10;Sunnuntai;5;3;8;4;2;6
109;16.10.2016;2016;10;11;Sunnuntai;5;7;12;5;6;11
109;16.10.2016;2016;10;12;Sunnuntai;7;6;13;6;4;10
109;16.10.2016;2016;10;13;Sunnuntai;5;7;12;3;5;8
109;16.10.2016;2016;10;14;Sunnuntai;7;4;11;4;4;8
109;16.10.2016;2016;10;15;Sunnuntai;9;10;19;7;10;17
109;16.10.2016;2016;10;16;Sunnuntai;10;7;17;8;6;14
109;16.10.2016;2016;10;17;Sunnuntai;6;7;13;4;7;11
109;16.10.2016;2016;10;18;Sunnuntai;7;6;13;6;3;9
109;16.10.2016;2016;10;19;Sunnuntai;5;5;10;5;5;10
109;16.10.2016;2016;10;20;Sunnuntai;5;5;10;5;2;7
109;16.10.2016;2016;10;21;Sunnuntai;3;6;9;3;4;7
109;16.10.2016;2016;10;22;Sunnuntai;4;0;4;3;0;3
109;16.10.2016;2016;10;23;Sunnuntai;0;2;2;0;0;0
109;17.10.2016;2016;10;00;Maanantai;1;0;1;1;0;1
109;17.10.2016;2016;10;01;Maanantai;0;0;0;0;0;0
109;17.10.2016;2016;10;02;Maanantai;0;0;0;0;0;0
109;17.10.2016;2016;10;03;Maanantai;0;0;0;0;0;0
109;17.10.2016;2016;10;04;Maanantai;2;0;2;1;0;1
109;17.10.2016;2016;10;05;Maanantai;5;4;9;1;1;2
109;17.10.2016;2016;10;06;Maanantai;26;16;42;4;3;7
109;17.10.2016;2016;10;07;Maanantai;80;34;114;6;6;12
109;17.10.2016;2016;10;08;Maanantai;60;11;71;3;2;5
109;17.10.2016;2016;10;09;Maanantai;25;10;35;1;4;5
109;17.10.2016;2016;10;10;Maanantai;9;5;14;6;0;6
109;17.10.2016;2016;10;11;Maanantai;20;13;33;4;5;9
109;17.10.2016;2016;10;12;Maanantai;13;16;29;3;3;6
109;17.10.2016;2016;10;13;Maanantai;10;19;29;1;3;4
109;17.10.2016;2016;10;14;Maanantai;16;21;37;2;2;4
109;17.10.2016;2016;10;15;Maanantai;34;60;94;8;2;10
109;17.10.2016;2016;10;16;Maanantai;41;69;110;5;5;10
109;17.10.2016;2016;10;17;Maanantai;12;31;43;7;6;13
109;17.10.2016;2016;10;18;Maanantai;15;22;37;5;5;10
109;17.10.2016;2016;10;19;Maanantai;7;11;18;7;4;11
109;17.10.2016;2016;10;20;Maanantai;10;11;21;3;3;6
109;17.10.2016;2016;10;21;Maanantai;8;11;19;1;4;5
109;17.10.2016;2016;10;22;Maanantai;7;2;9;4;2;6
109;17.10.2016;2016;10;23;Maanantai;0;1;1;0;0;0
109;18.10.2016;2016;10;00;Tiistai;1;0;1;1;0;1
109;18.10.2016;2016;10;01;Tiistai;0;0;0;0;0;0
109;18.10.2016;2016;10;02;Tiistai;0;0;0;0;0;0
109;18.10.2016;2016;10;03;Tiistai;0;0;0;0;0;0
109;18.10.2016;2016;10;04;Tiistai;0;1;1;0;0;0
109;18.10.2016;2016;10;05;Tiistai;2;6;8;2;0;2
109;18.10.2016;2016;10;06;Tiistai;27;18;45;4;3;7
109;18.10.2016;2016;10;07;Tiistai;89;34;123;7;4;11
109;18.10.2016;2016;10;08;Tiistai;46;13;59;3;2;5
109;18.10.2016;2016;10;09;Tiistai;25;10;35;6;3;9
109;18.10.2016;2016;10;10;Tiistai;9;9;18;3;9;12
109;18.10.2016;2016;10;11;Tiistai;22;13;35;2;5;7
109;18.10.2016;2016;10;12;Tiistai;13;16;29;3;3;6
109;18.10.2016;2016;10;13;Tiistai;12;16;28;5;2;7
109;18.10.2016;2016;10;14;Tiistai;17;19;36;5;3;8
109;18.10.2016;2016;10;15;Tiistai;24;71;95;10;9;19
109;18.10.2016;2016;10;16;Tiistai;45;69;114;6;2;8
109;18.10.2016;2016;10;17;Tiistai;38;33;71;8;5;13
109;18.10.2016;2016;10;18;Tiistai;11;15;26;5;5;10
109;18.10.2016;2016;10;19;Tiistai;16;8;24;11;3;14
109;18.10.2016;2016;10;20;Tiistai;10;14;24;3;7;10
109;18.10.2016;2016;10;21;Tiistai;5;12;17;1;3;4
109;18.10.2016;2016;10;22;Tiistai;2;5;7;3;1;4
109;18.10.2016;2016;10;23;Tiistai;1;3;4;0;0;0
109;19.10.2016;2016;10;00;Keskiviikko;0;0;0;1;0;1
109;19.10.2016;2016;10;01;Keskiviikko;0;0;0;0;0;0
109;19.10.2016;2016;10;02;Keskiviikko;0;0;0;0;0;0
109;19.10.2016;2016;10;03;Keskiviikko;1;0;1;0;0;0
109;19.10.2016;2016;10;04;Keskiviikko;0;0;0;1;0;1
109;19.10.2016;2016;10;05;Keskiviikko;4;5;9;0;0;0
109;19.10.2016;2016;10;06;Keskiviikko;31;15;46;1;2;3
109;19.10.2016;2016;10;07;Keskiviikko;89;33;122;6;1;7
109;19.10.2016;2016;10;08;Keskiviikko;61;12;73;6;5;11
109;19.10.2016;2016;10;09;Keskiviikko;23;11;34;4;6;10
109;19.10.2016;2016;10;10;Keskiviikko;13;15;28;2;8;10
109;19.10.2016;2016;10;11;Keskiviikko;13;14;27;3;4;7
109;19.10.2016;2016;10;12;Keskiviikko;15;13;28;2;1;3
109;19.10.2016;2016;10;13;Keskiviikko;13;21;34;4;6;10
109;19.10.2016;2016;10;14;Keskiviikko;20;20;40;3;3;6
109;19.10.2016;2016;10;15;Keskiviikko;27;57;84;5;5;10
109;19.10.2016;2016;10;16;Keskiviikko;33;81;114;6;5;11
109;19.10.2016;2016;10;17;Keskiviikko;22;27;49;3;4;7
109;19.10.2016;2016;10;18;Keskiviikko;14;18;32;5;4;9
109;19.10.2016;2016;10;19;Keskiviikko;4;10;14;8;6;14
109;19.10.2016;2016;10;20;Keskiviikko;4;8;12;0;3;3
109;19.10.2016;2016;10;21;Keskiviikko;6;6;12;2;3;5
109;19.10.2016;2016;10;22;Keskiviikko;5;4;9;2;1;3
109;19.10.2016;2016;10;23;Keskiviikko;2;0;2;2;1;3
109;20.10.2016;2016;10;00;Torstai;1;0;1;0;0;0
109;20.10.2016;2016;10;01;Torstai;1;0;1;0;1;1
109;20.10.2016;2016;10;02;Torstai;0;0;0;0;0;0
109;20.10.2016;2016;10;03;Torstai;0;0;0;0;0;0
109;20.10.2016;2016;10;04;Torstai;0;0;0;1;0;1
109;20.10.2016;2016;10;05;Torstai;4;6;10;1;1;2
109;20.10.2016;2016;10;06;Torstai;32;17;49;0;1;1
109;20.10.2016;2016;10;07;Torstai;86;29;115;16;9;25
109;20.10.2016;2016;10;08;Torstai;40;16;56;18;2;20
109;20.10.2016;2016;10;09;Torstai;24;5;29;3;5;8
109;20.10.2016;2016;10;10;Torstai;14;7;21;4;5;9
109;20.10.2016;2016;10;11;Torstai;16;16;32;5;3;8
109;20.10.2016;2016;10;12;Torstai;17;10;27;4;3;7
109;20.10.2016;2016;10;13;Torstai;15;18;33;6;8;14
109;20.10.2016;2016;10;14;Torstai;16;18;34;4;11;15
109;20.10.2016;2016;10;15;Torstai;23;52;75;5;6;11
109;20.10.2016;2016;10;16;Torstai;34;84;118;6;3;9
109;20.10.2016;2016;10;17;Torstai;14;30;44;6;4;10
109;20.10.2016;2016;10;18;Torstai;17;17;34;9;12;21
109;20.10.2016;2016;10;19;Torstai;5;6;11;7;4;11
109;20.10.2016;2016;10;20;Torstai;5;3;8;1;4;5
109;20.10.2016;2016;10;21;Torstai;6;14;20;4;1;5
109;20.10.2016;2016;10;22;Torstai;5;3;8;2;1;3
109;20.10.2016;2016;10;23;Torstai;1;3;4;0;0;0
109;21.10.2016;2016;10;00;Perjantai;0;1;1;0;0;0
109;21.10.2016;2016;10;01;Perjantai;0;0;0;0;1;1
109;21.10.2016;2016;10;02;Perjantai;0;1;1;0;0;0
109;21.10.2016;2016;10;03;Perjantai;0;0;0;0;0;0
109;21.10.2016;2016;10;04;Perjantai;1;6;7;0;0;0
109;21.10.2016;2016;10;05;Perjantai;2;6;8;0;0;0
109;21.10.2016;2016;10;06;Perjantai;19;13;32;1;1;2
109;21.10.2016;2016;10;07;Perjantai;78;27;105;5;3;8
109;21.10.2016;2016;10;08;Perjantai;49;10;59;2;1;3
109;21.10.2016;2016;10;09;Perjantai;19;13;32;1;2;3
109;21.10.2016;2016;10;10;Perjantai;12;9;21;9;3;12
109;21.10.2016;2016;10;11;Perjantai;8;12;20;4;1;5
109;21.10.2016;2016;10;12;Perjantai;18;15;33;1;6;7
109;21.10.2016;2016;10;13;Perjantai;13;31;44;5;3;8
109;21.10.2016;2016;10;14;Perjantai;17;25;42;0;3;3
109;21.10.2016;2016;10;15;Perjantai;28;53;81;5;6;11
109;21.10.2016;2016;10;16;Perjantai;20;34;54;6;2;8
109;21.10.2016;2016;10;17;Perjantai;15;26;41;8;4;12
109;21.10.2016;2016;10;18;Perjantai;13;10;23;0;1;1
109;21.10.2016;2016;10;19;Perjantai;10;9;19;4;3;7
109;21.10.2016;2016;10;20;Perjantai;10;2;12;5;1;6
109;21.10.2016;2016;10;21;Perjantai;3;5;8;2;4;6
109;21.10.2016;2016;10;22;Perjantai;4;1;5;2;0;2
109;21.10.2016;2016;10;23;Perjantai;6;2;8;2;1;3
109;22.10.2016;2016;10;00;Lauantai;1;1;2;0;0;0
109;22.10.2016;2016;10;01;Lauantai;0;2;2;0;0;0
109;22.10.2016;2016;10;02;Lauantai;0;1;1;0;0;0
109;22.10.2016;2016;10;03;Lauantai;0;2;2;0;0;0
109;22.10.2016;2016;10;04;Lauantai;1;2;3;1;0;1
109;22.10.2016;2016;10;05;Lauantai;1;1;2;0;0;0
109;22.10.2016;2016;10;06;Lauantai;4;2;6;3;1;4
109;22.10.2016;2016;10;07;Lauantai;4;5;9;0;2;2
109;22.10.2016;2016;10;08;Lauantai;0;6;6;2;3;5
109;22.10.2016;2016;10;09;Lauantai;6;4;10;3;4;7
109;22.10.2016;2016;10;10;Lauantai;7;7;14;1;4;5
109;22.10.2016;2016;10;11;Lauantai;19;8;27;3;3;6
109;22.10.2016;2016;10;12;Lauantai;11;15;26;5;3;8
109;22.10.2016;2016;10;13;Lauantai;13;10;23;9;4;13
109;22.10.2016;2016;10;14;Lauantai;8;6;14;5;6;11
109;22.10.2016;2016;10;15;Lauantai;11;5;16;3;0;3
109;22.10.2016;2016;10;16;Lauantai;13;13;26;5;6;11
109;22.10.2016;2016;10;17;Lauantai;7;7;14;6;4;10
109;22.10.2016;2016;10;18;Lauantai;4;5;9;4;9;13
109;22.10.2016;2016;10;19;Lauantai;9;2;11;2;5;7
109;22.10.2016;2016;10;20;Lauantai;2;4;6;1;0;1
109;22.10.2016;2016;10;21;Lauantai;2;3;5;3;2;5
109;22.10.2016;2016;10;22;Lauantai;1;2;3;1;1;2
109;22.10.2016;2016;10;23;Lauantai;0;2;2;0;2;2
109;23.10.2016;2016;10;00;Sunnuntai;0;1;1;0;0;0
109;23.10.2016;2016;10;01;Sunnuntai;1;4;5;0;0;0
109;23.10.2016;2016;10;02;Sunnuntai;0;0;0;0;0;0
109;23.10.2016;2016;10;03;Sunnuntai;0;0;0;0;0;0
109;23.10.2016;2016;10;04;Sunnuntai;0;1;1;0;1;1
109;23.10.2016;2016;10;05;Sunnuntai;0;1;1;0;0;0
109;23.10.2016;2016;10;06;Sunnuntai;4;3;7;1;2;3
109;23.10.2016;2016;10;07;Sunnuntai;1;2;3;1;0;1
109;23.10.2016;2016;10;08;Sunnuntai;1;2;3;1;0;1
109;23.10.2016;2016;10;09;Sunnuntai;1;2;3;3;3;6
109;23.10.2016;2016;10;10;Sunnuntai;1;1;2;7;2;9
109;23.10.2016;2016;10;11;Sunnuntai;5;3;8;6;3;9
109;23.10.2016;2016;10;12;Sunnuntai;6;4;10;3;7;10
109;23.10.2016;2016;10;13;Sunnuntai;9;7;16;0;0;0
109;23.10.2016;2016;10;14;Sunnuntai;8;7;15;0;0;0
109;23.10.2016;2016;10;15;Sunnuntai;7;5;12;0;0;0
109;23.10.2016;2016;10;16;Sunnuntai;7;7;14;0;0;0
109;23.10.2016;2016;10;17;Sunnuntai;6;7;13;4;4;8
109;23.10.2016;2016;10;18;Sunnuntai;6;6;12;6;5;11
109;23.10.2016;2016;10;19;Sunnuntai;7;3;10;7;0;7
109;23.10.2016;2016;10;20;Sunnuntai;3;2;5;2;2;4
109;23.10.2016;2016;10;21;Sunnuntai;1;8;9;0;3;3
109;23.10.2016;2016;10;22;Sunnuntai;2;1;3;2;1;3
109;23.10.2016;2016;10;23;Sunnuntai;0;0;0;0;1;1
109;24.10.2016;2016;10;00;Maanantai;0;0;0;0;0;0
109;24.10.2016;2016;10;01;Maanantai;0;2;2;0;0;0
109;24.10.2016;2016;10;02;Maanantai;0;0;0;0;0;0
109;24.10.2016;2016;10;03;Maanantai;1;0;1;0;0;0
109;24.10.2016;2016;10;04;Maanantai;0;0;0;1;0;1
109;24.10.2016;2016;10;05;Maanantai;3;5;8;1;1;2
109;24.10.2016;2016;10;06;Maanantai;18;11;29;2;1;3
109;24.10.2016;2016;10;07;Maanantai;53;31;84;5;3;8
109;24.10.2016;2016;10;08;Maanantai;39;7;46;1;3;4
109;24.10.2016;2016;10;09;Maanantai;16;12;28;3;3;6
109;24.10.2016;2016;10;10;Maanantai;10;6;16;3;4;7
109;24.10.2016;2016;10;11;Maanantai;9;11;20;2;2;4
109;24.10.2016;2016;10;12;Maanantai;15;7;22;1;2;3
109;24.10.2016;2016;10;13;Maanantai;12;12;24;2;4;6
109;24.10.2016;2016;10;14;Maanantai;17;14;31;4;6;10
109;24.10.2016;2016;10;15;Maanantai;27;35;62;9;4;13
109;24.10.2016;2016;10;16;Maanantai;36;50;86;9;5;14
109;24.10.2016;2016;10;17;Maanantai;9;23;32;6;6;12
109;24.10.2016;2016;10;18;Maanantai;9;12;21;4;2;6
109;24.10.2016;2016;10;19;Maanantai;6;6;12;1;2;3
109;24.10.2016;2016;10;20;Maanantai;6;4;10;9;8;17
109;24.10.2016;2016;10;21;Maanantai;2;12;14;1;1;2
109;24.10.2016;2016;10;22;Maanantai;5;2;7;2;1;3
109;24.10.2016;2016;10;23;Maanantai;0;2;2;0;0;0
109;25.10.2016;2016;10;00;Tiistai;0;0;0;0;0;0
109;25.10.2016;2016;10;01;Tiistai;0;0;0;0;0;0
109;25.10.2016;2016;10;02;Tiistai;0;0;0;0;0;0
109;25.10.2016;2016;10;03;Tiistai;0;0;0;0;0;0
109;25.10.2016;2016;10;04;Tiistai;0;0;0;0;0;0
109;25.10.2016;2016;10;05;Tiistai;2;7;9;0;0;0
109;25.10.2016;2016;10;06;Tiistai;25;11;36;0;2;2
109;25.10.2016;2016;10;07;Tiistai;56;31;87;9;2;11
109;25.10.2016;2016;10;08;Tiistai;25;13;38;0;2;2
109;25.10.2016;2016;10;09;Tiistai;11;8;19;2;2;4
109;25.10.2016;2016;10;10;Tiistai;15;3;18;4;5;9
109;25.10.2016;2016;10;11;Tiistai;11;7;18;2;2;4
109;25.10.2016;2016;10;12;Tiistai;24;6;30;8;2;10
109;25.10.2016;2016;10;13;Tiistai;15;17;32;3;7;10
109;25.10.2016;2016;10;14;Tiistai;15;18;33;3;7;10
109;25.10.2016;2016;10;15;Tiistai;28;41;69;8;7;15
109;25.10.2016;2016;10;16;Tiistai;23;48;71;10;3;13
109;25.10.2016;2016;10;17;Tiistai;8;19;27;12;3;15
109;25.10.2016;2016;10;18;Tiistai;6;16;22;12;5;17
109;25.10.2016;2016;10;19;Tiistai;2;9;11;4;2;6
109;25.10.2016;2016;10;20;Tiistai;1;10;11;7;1;8
109;25.10.2016;2016;10;21;Tiistai;2;3;5;3;1;4
109;25.10.2016;2016;10;22;Tiistai;2;3;5;1;1;2
109;25.10.2016;2016;10;23;Tiistai;0;0;0;0;0;0
109;26.10.2016;2016;10;00;Keskiviikko;0;0;0;0;0;0
109;26.10.2016;2016;10;01;Keskiviikko;0;0;0;0;0;0
109;26.10.2016;2016;10;02;Keskiviikko;0;0;0;0;0;0
109;26.10.2016;2016;10;03;Keskiviikko;0;0;0;0;0;0
109;26.10.2016;2016;10;04;Keskiviikko;1;0;1;1;0;1
109;26.10.2016;2016;10;05;Keskiviikko;8;0;8;1;0;1
109;26.10.2016;2016;10;06;Keskiviikko;30;1;31;1;0;1
109;26.10.2016;2016;10;07;Keskiviikko;63;6;69;4;0;4
109;26.10.2016;2016;10;08;Keskiviikko;27;2;29;3;1;4
109;26.10.2016;2016;10;09;Keskiviikko;6;2;8;4;0;4
109;26.10.2016;2016;10;10;Keskiviikko;7;4;11;9;0;9
109;26.10.2016;2016;10;11;Keskiviikko;20;8;28;4;0;4
109;26.10.2016;2016;10;12;Keskiviikko;19;4;23;6;1;7
109;26.10.2016;2016;10;13;Keskiviikko;16;0;16;12;0;12
109;26.10.2016;2016;10;14;Keskiviikko;32;0;32;5;2;7
109;26.10.2016;2016;10;15;Keskiviikko;44;1;45;7;0;7
109;26.10.2016;2016;10;16;Keskiviikko;51;3;54;5;1;6
109;26.10.2016;2016;10;17;Keskiviikko;31;2;33;7;0;7
109;26.10.2016;2016;10;18;Keskiviikko;13;1;14;7;2;9
109;26.10.2016;2016;10;19;Keskiviikko;9;3;12;14;0;14
109;26.10.2016;2016;10;20;Keskiviikko;7;1;8;3;0;3
109;26.10.2016;2016;10;21;Keskiviikko;6;0;6;4;0;4
109;26.10.2016;2016;10;22;Keskiviikko;7;1;8;4;0;4
109;26.10.2016;2016;10;23;Keskiviikko;0;1;1;2;0;2
109;27.10.2016;2016;10;00;Torstai;1;0;1;0;0;0
109;27.10.2016;2016;10;01;Torstai;0;0;0;0;0;0
109;27.10.2016;2016;10;02;Torstai;0;0;0;0;0;0
109;27.10.2016;2016;10;03;Torstai;0;0;0;0;0;0
109;27.10.2016;2016;10;04;Torstai;2;0;2;0;0;0
109;27.10.2016;2016;10;05;Torstai;7;0;7;2;1;3
109;27.10.2016;2016;10;06;Torstai;26;0;26;3;0;3
109;27.10.2016;2016;10;07;Torstai;59;1;60;8;0;8
109;27.10.2016;2016;10;08;Torstai;26;0;26;8;0;8
109;27.10.2016;2016;10;09;Torstai;12;0;12;5;2;7
109;27.10.2016;2016;10;10;Torstai;10;2;12;6;1;7
109;27.10.2016;2016;10;11;Torstai;10;1;11;10;2;12
109;27.10.2016;2016;10;12;Torstai;16;0;16;3;0;3
109;27.10.2016;2016;10;13;Torstai;16;4;20;5;1;6
109;27.10.2016;2016;10;14;Torstai;17;4;21;12;0;12
109;27.10.2016;2016;10;15;Torstai;46;0;46;13;1;14
109;27.10.2016;2016;10;16;Torstai;46;0;46;7;0;7
109;27.10.2016;2016;10;17;Torstai;33;0;33;6;0;6
109;27.10.2016;2016;10;18;Torstai;14;1;15;8;0;8
109;27.10.2016;2016;10;19;Torstai;9;2;11;15;0;15
109;27.10.2016;2016;10;20;Torstai;8;0;8;6;0;6
109;27.10.2016;2016;10;21;Torstai;9;0;9;4;0;4
109;27.10.2016;2016;10;22;Torstai;3;0;3;3;0;3
109;27.10.2016;2016;10;23;Torstai;0;0;0;0;0;0
109;28.10.2016;2016;10;00;Perjantai;1;0;1;1;0;1
109;28.10.2016;2016;10;01;Perjantai;0;0;0;0;0;0
109;28.10.2016;2016;10;02;Perjantai;0;0;0;0;0;0
109;28.10.2016;2016;10;03;Perjantai;0;0;0;0;0;0
109;28.10.2016;2016;10;04;Perjantai;2;0;2;0;0;0
109;28.10.2016;2016;10;05;Perjantai;12;0;12;0;0;0
109;28.10.2016;2016;10;06;Perjantai;30;0;30;4;0;4
109;28.10.2016;2016;10;07;Perjantai;49;0;49;5;0;5
109;28.10.2016;2016;10;08;Perjantai;24;0;24;2;0;2
109;28.10.2016;2016;10;09;Perjantai;9;0;9;2;0;2
109;28.10.2016;2016;10;10;Perjantai;16;0;16;9;0;9
109;28.10.2016;2016;10;11;Perjantai;19;0;19;9;0;9
109;28.10.2016;2016;10;12;Perjantai;16;0;16;5;0;5
109;28.10.2016;2016;10;13;Perjantai;18;0;18;7;0;7
109;28.10.2016;2016;10;14;Perjantai;41;0;41;11;0;11
109;28.10.2016;2016;10;15;Perjantai;47;0;47;4;0;4
109;28.10.2016;2016;10;16;Perjantai;47;0;47;6;0;6
109;28.10.2016;2016;10;17;Perjantai;35;0;35;7;0;7
109;28.10.2016;2016;10;18;Perjantai;26;0;26;5;0;5
109;28.10.2016;2016;10;19;Perjantai;13;0;13;10;0;10
109;28.10.2016;2016;10;20;Perjantai;9;0;9;3;0;3
109;28.10.2016;2016;10;21;Perjantai;9;0;9;2;0;2
109;28.10.2016;2016;10;22;Perjantai;5;0;5;2;0;2
109;28.10.2016;2016;10;23;Perjantai;0;0;0;1;0;1
109;29.10.2016;2016;10;00;Lauantai;3;0;3;0;0;0
109;29.10.2016;2016;10;01;Lauantai;3;0;3;0;0;0
109;29.10.2016;2016;10;02;Lauantai;1;0;1;1;0;1
109;29.10.2016;2016;10;03;Lauantai;8;0;8;0;0;0
109;29.10.2016;2016;10;04;Lauantai;5;0;5;0;0;0
109;29.10.2016;2016;10;05;Lauantai;2;0;2;3;0;3
109;29.10.2016;2016;10;06;Lauantai;10;0;10;1;0;1
109;29.10.2016;2016;10;07;Lauantai;4;0;4;4;0;4
109;29.10.2016;2016;10;08;Lauantai;4;0;4;5;0;5
109;29.10.2016;2016;10;09;Lauantai;7;0;7;6;0;6
109;29.10.2016;2016;10;10;Lauantai;7;1;8;22;7;29
109;29.10.2016;2016;10;11;Lauantai;7;5;12;0;1;1
109;29.10.2016;2016;10;12;Lauantai;15;8;23;4;5;9
109;29.10.2016;2016;10;13;Lauantai;6;8;14;7;4;11
109;29.10.2016;2016;10;14;Lauantai;17;7;24;1;5;6
109;29.10.2016;2016;10;15;Lauantai;6;18;24;7;4;11
109;29.10.2016;2016;10;16;Lauantai;6;9;15;4;3;7
109;29.10.2016;2016;10;17;Lauantai;3;8;11;9;1;10
109;29.10.2016;2016;10;18;Lauantai;7;3;10;2;0;2
109;29.10.2016;2016;10;19;Lauantai;0;6;6;3;4;7
109;29.10.2016;2016;10;20;Lauantai;0;3;3;2;1;3
109;29.10.2016;2016;10;21;Lauantai;8;6;14;2;2;4
109;29.10.2016;2016;10;22;Lauantai;1;2;3;1;0;1
109;29.10.2016;2016;10;23;Lauantai;3;0;3;1;0;1
109;30.10.2016;2016;10;00;Sunnuntai;0;0;0;0;0;0
109;30.10.2016;2016;10;01;Sunnuntai;2;1;3;1;0;1
109;30.10.2016;2016;10;02;Sunnuntai;0;2;2;0;0;0
109;30.10.2016;2016;10;03;Sunnuntai;0;2;2;0;2;2
109;30.10.2016;2016;10;04;Sunnuntai;2;0;2;0;0;0
109;30.10.2016;2016;10;05;Sunnuntai;0;1;1;0;0;0
109;30.10.2016;2016;10;06;Sunnuntai;3;2;5;3;1;4
109;30.10.2016;2016;10;07;Sunnuntai;1;1;2;3;0;3
109;30.10.2016;2016;10;08;Sunnuntai;7;1;8;1;0;1
109;30.10.2016;2016;10;09;Sunnuntai;11;0;11;6;5;11
109;30.10.2016;2016;10;10;Sunnuntai;7;6;13;8;5;13
109;30.10.2016;2016;10;11;Sunnuntai;3;6;9;3;5;8
109;30.10.2016;2016;10;12;Sunnuntai;14;8;22;1;3;4
109;30.10.2016;2016;10;13;Sunnuntai;5;4;9;3;4;7
109;30.10.2016;2016;10;14;Sunnuntai;10;2;12;4;4;8
109;30.10.2016;2016;10;15;Sunnuntai;9;12;21;7;5;12
109;30.10.2016;2016;10;16;Sunnuntai;12;11;23;4;6;10
109;30.10.2016;2016;10;17;Sunnuntai;3;1;4;5;1;6
109;30.10.2016;2016;10;18;Sunnuntai;6;10;16;3;5;8
109;30.10.2016;2016;10;19;Sunnuntai;5;4;9;4;4;8
109;30.10.2016;2016;10;20;Sunnuntai;2;3;5;2;3;5
109;30.10.2016;2016;10;21;Sunnuntai;3;7;10;2;1;3
109;30.10.2016;2016;10;22;Sunnuntai;2;2;4;0;1;1
109;30.10.2016;2016;10;23;Sunnuntai;0;0;0;0;0;0
109;31.10.2016;2016;10;00;Maanantai;0;1;1;1;0;1
109;31.10.2016;2016;10;01;Maanantai;0;0;0;1;0;1
109;31.10.2016;2016;10;02;Maanantai;0;0;0;0;0;0
109;31.10.2016;2016;10;03;Maanantai;2;0;2;0;0;0
109;31.10.2016;2016;10;04;Maanantai;1;0;1;1;0;1
109;31.10.2016;2016;10;05;Maanantai;3;5;8;3;0;3
109;31.10.2016;2016;10;06;Maanantai;25;17;42;1;0;1
109;31.10.2016;2016;10;07;Maanantai;82;27;109;6;8;14
109;31.10.2016;2016;10;08;Maanantai;42;12;54;6;3;9
109;31.10.2016;2016;10;09;Maanantai;19;7;26;2;2;4
109;31.10.2016;2016;10;10;Maanantai;17;5;22;4;3;7
109;31.10.2016;2016;10;11;Maanantai;18;14;32;4;3;7
109;31.10.2016;2016;10;12;Maanantai;15;9;24;7;3;10
109;31.10.2016;2016;10;13;Maanantai;10;15;25;6;3;9
109;31.10.2016;2016;10;14;Maanantai;7;23;30;4;10;14
109;31.10.2016;2016;10;15;Maanantai;24;46;70;7;3;10
109;31.10.2016;2016;10;16;Maanantai;25;78;103;7;1;8
109;31.10.2016;2016;10;17;Maanantai;16;20;36;4;3;7
109;31.10.2016;2016;10;18;Maanantai;13;16;29;5;6;11
109;31.10.2016;2016;10;19;Maanantai;2;12;14;6;6;12
109;31.10.2016;2016;10;20;Maanantai;7;10;17;3;5;8
109;31.10.2016;2016;10;21;Maanantai;4;12;16;3;3;6
109;31.10.2016;2016;10;22;Maanantai;5;2;7;5;6;11
109;31.10.2016;2016;10;23;Maanantai;0;0;0;0;0;0
109;01.11.2016;2016;11;00;Tiistai;0;0;0;0;0;0
109;01.11.2016;2016;11;01;Tiistai;0;0;0;0;1;1
109;01.11.2016;2016;11;02;Tiistai;0;0;0;0;0;0
109;01.11.2016;2016;11;03;Tiistai;1;0;1;0;0;0
109;01.11.2016;2016;11;04;Tiistai;2;0;2;1;1;2
109;01.11.2016;2016;11;05;Tiistai;1;8;9;0;0;0
109;01.11.2016;2016;11;06;Tiistai;27;20;47;2;1;3
109;01.11.2016;2016;11;07;Tiistai;81;27;108;5;5;10
109;01.11.2016;2016;11;08;Tiistai;36;15;51;6;2;8
109;01.11.2016;2016;11;09;Tiistai;20;11;31;4;3;7
109;01.11.2016;2016;11;10;Tiistai;9;10;19;3;4;7
109;01.11.2016;2016;11;11;Tiistai;18;9;27;2;1;3
109;01.11.2016;2016;11;12;Tiistai;12;13;25;1;1;2
109;01.11.2016;2016;11;13;Tiistai;12;12;24;3;2;5
109;01.11.2016;2016;11;14;Tiistai;8;21;29;4;3;7
109;01.11.2016;2016;11;15;Tiistai;25;43;68;3;4;7
109;01.11.2016;2016;11;16;Tiistai;17;64;81;2;3;5
109;01.11.2016;2016;11;17;Tiistai;15;19;34;8;2;10
109;01.11.2016;2016;11;18;Tiistai;5;7;12;3;1;4
109;01.11.2016;2016;11;19;Tiistai;3;6;9;3;3;6
109;01.11.2016;2016;11;20;Tiistai;8;5;13;2;5;7
109;01.11.2016;2016;11;21;Tiistai;2;10;12;4;5;9
109;01.11.2016;2016;11;22;Tiistai;2;3;5;0;0;0
109;01.11.2016;2016;11;23;Tiistai;0;0;0;0;0;0
109;02.11.2016;2016;11;00;Keskiviikko;0;0;0;1;0;1
109;02.11.2016;2016;11;01;Keskiviikko;0;0;0;0;1;1
109;02.11.2016;2016;11;02;Keskiviikko;0;0;0;0;0;0
109;02.11.2016;2016;11;03;Keskiviikko;1;0;1;0;0;0
109;02.11.2016;2016;11;04;Keskiviikko;0;0;0;0;0;0
109;02.11.2016;2016;11;05;Keskiviikko;3;6;9;2;0;2
109;02.11.2016;2016;11;06;Keskiviikko;21;14;35;2;0;2
109;02.11.2016;2016;11;07;Keskiviikko;66;23;89;4;2;6
109;02.11.2016;2016;11;08;Keskiviikko;34;11;45;4;2;6
109;02.11.2016;2016;11;09;Keskiviikko;21;6;27;2;2;4
109;02.11.2016;2016;11;10;Keskiviikko;13;5;18;4;3;7
109;02.11.2016;2016;11;11;Keskiviikko;8;13;21;6;4;10
109;02.11.2016;2016;11;12;Keskiviikko;19;6;25;2;3;5
109;02.11.2016;2016;11;13;Keskiviikko;14;13;27;5;2;7
109;02.11.2016;2016;11;14;Keskiviikko;8;18;26;5;2;7
109;02.11.2016;2016;11;15;Keskiviikko;26;37;63;5;5;10
109;02.11.2016;2016;11;16;Keskiviikko;21;53;74;7;5;12
109;02.11.2016;2016;11;17;Keskiviikko;16;24;40;5;3;8
109;02.11.2016;2016;11;18;Keskiviikko;7;12;19;4;3;7
109;02.11.2016;2016;11;19;Keskiviikko;5;3;8;4;4;8
109;02.11.2016;2016;11;20;Keskiviikko;2;8;10;4;3;7
109;02.11.2016;2016;11;21;Keskiviikko;9;14;23;2;3;5
109;02.11.2016;2016;11;22;Keskiviikko;3;5;8;2;1;3
109;02.11.2016;2016;11;23;Keskiviikko;0;1;1;1;1;2
109;03.11.2016;2016;11;00;Torstai;0;2;2;1;0;1
109;03.11.2016;2016;11;01;Torstai;0;1;1;0;0;0
109;03.11.2016;2016;11;02;Torstai;1;0;1;0;0;0
109;03.11.2016;2016;11;03;Torstai;1;0;1;0;0;0
109;03.11.2016;2016;11;04;Torstai;1;0;1;0;0;0
109;03.11.2016;2016;11;05;Torstai;4;7;11;2;2;4
109;03.11.2016;2016;11;06;Torstai;19;15;34;2;3;5
109;03.11.2016;2016;11;07;Torstai;68;24;92;4;4;8
109;03.11.2016;2016;11;08;Torstai;40;11;51;5;2;7
109;03.11.2016;2016;11;09;Torstai;14;8;22;3;6;9
109;03.11.2016;2016;11;10;Torstai;16;6;22;1;4;5
109;03.11.2016;2016;11;11;Torstai;11;5;16;2;5;7
109;03.11.2016;2016;11;12;Torstai;8;10;18;3;2;5
109;03.11.2016;2016;11;13;Torstai;17;10;27;3;6;9
109;03.11.2016;2016;11;14;Torstai;14;26;40;9;0;9
109;03.11.2016;2016;11;15;Torstai;27;36;63;7;2;9
109;03.11.2016;2016;11;16;Torstai;16;57;73;5;5;10
109;03.11.2016;2016;11;17;Torstai;9;21;30;4;3;7
109;03.11.2016;2016;11;18;Torstai;6;11;17;3;4;7
109;03.11.2016;2016;11;19;Torstai;6;12;18;6;4;10
109;03.11.2016;2016;11;20;Torstai;3;2;5;5;1;6
109;03.11.2016;2016;11;21;Torstai;3;16;19;0;2;2
109;03.11.2016;2016;11;22;Torstai;3;0;3;2;2;4
109;03.11.2016;2016;11;23;Torstai;0;0;0;0;0;0
109;04.11.2016;2016;11;00;Perjantai;0;0;0;0;0;0
109;04.11.2016;2016;11;01;Perjantai;0;0;0;0;0;0
109;04.11.2016;2016;11;02;Perjantai;1;0;1;0;0;0
109;04.11.2016;2016;11;03;Perjantai;1;0;1;0;0;0
109;04.11.2016;2016;11;04;Perjantai;0;1;1;0;0;0
109;04.11.2016;2016;11;05;Perjantai;2;6;8;2;3;5
109;04.11.2016;2016;11;06;Perjantai;14;19;33;3;2;5
109;04.11.2016;2016;11;07;Perjantai;66;23;89;4;3;7
109;04.11.2016;2016;11;08;Perjantai;42;10;52;5;2;7
109;04.11.2016;2016;11;09;Perjantai;14;10;24;4;2;6
109;04.11.2016;2016;11;10;Perjantai;3;11;14;2;5;7
109;04.11.2016;2016;11;11;Perjantai;19;12;31;2;1;3
109;04.11.2016;2016;11;12;Perjantai;11;8;19;3;5;8
109;04.11.2016;2016;11;13;Perjantai;11;19;30;5;4;9
109;04.11.2016;2016;11;14;Perjantai;17;27;44;1;5;6
109;04.11.2016;2016;11;15;Perjantai;23;29;52;3;4;7
109;04.11.2016;2016;11;16;Perjantai;11;35;46;0;3;3
109;04.11.2016;2016;11;17;Perjantai;8;14;22;4;3;7
109;04.11.2016;2016;11;18;Perjantai;6;8;14;2;4;6
109;04.11.2016;2016;11;19;Perjantai;5;0;5;2;3;5
109;04.11.2016;2016;11;20;Perjantai;5;7;12;0;1;1
109;04.11.2016;2016;11;21;Perjantai;3;6;9;2;2;4
109;04.11.2016;2016;11;22;Perjantai;3;2;5;0;0;0
109;04.11.2016;2016;11;23;Perjantai;1;1;2;2;0;2
109;05.11.2016;2016;11;00;Lauantai;2;0;2;0;0;0
109;05.11.2016;2016;11;01;Lauantai;0;0;0;0;0;0
109;05.11.2016;2016;11;02;Lauantai;0;0;0;0;0;0
109;05.11.2016;2016;11;03;Lauantai;0;0;0;0;0;0
109;05.11.2016;2016;11;04;Lauantai;0;0;0;0;0;0
109;05.11.2016;2016;11;05;Lauantai;1;0;1;0;0;0
109;05.11.2016;2016;11;06;Lauantai;6;1;7;1;1;2
109;05.11.2016;2016;11;07;Lauantai;2;1;3;2;0;2
109;05.11.2016;2016;11;08;Lauantai;2;1;3;1;0;1
109;05.11.2016;2016;11;09;Lauantai;7;2;9;0;0;0
109;05.11.2016;2016;11;10;Lauantai;3;2;5;9;7;16
109;05.11.2016;2016;11;11;Lauantai;8;7;15;1;7;8
109;05.11.2016;2016;11;12;Lauantai;7;8;15;1;3;4
109;05.11.2016;2016;11;13;Lauantai;5;6;11;6;3;9
109;05.11.2016;2016;11;14;Lauantai;8;8;16;6;3;9
109;05.11.2016;2016;11;15;Lauantai;6;5;11;3;1;4
109;05.11.2016;2016;11;16;Lauantai;5;5;10;4;3;7
109;05.11.2016;2016;11;17;Lauantai;3;4;7;3;9;12
109;05.11.2016;2016;11;18;Lauantai;2;3;5;4;1;5
109;05.11.2016;2016;11;19;Lauantai;1;4;5;1;1;2
109;05.11.2016;2016;11;20;Lauantai;4;1;5;3;1;4
109;05.11.2016;2016;11;21;Lauantai;2;2;4;3;4;7
109;05.11.2016;2016;11;22;Lauantai;2;0;2;0;1;1
109;05.11.2016;2016;11;23;Lauantai;3;1;4;2;0;2
109;06.11.2016;2016;11;00;Sunnuntai;0;1;1;0;0;0
109;06.11.2016;2016;11;01;Sunnuntai;1;0;1;1;0;1
109;06.11.2016;2016;11;02;Sunnuntai;0;0;0;0;0;0
109;06.11.2016;2016;11;03;Sunnuntai;0;0;0;0;0;0
109;06.11.2016;2016;11;04;Sunnuntai;1;0;1;0;0;0
109;06.11.2016;2016;11;05;Sunnuntai;1;0;1;0;0;0
109;06.11.2016;2016;11;06;Sunnuntai;2;0;2;1;0;1
109;06.11.2016;2016;11;07;Sunnuntai;1;2;3;0;1;1
109;06.11.2016;2016;11;08;Sunnuntai;1;0;1;2;0;2
109;06.11.2016;2016;11;09;Sunnuntai;6;2;8;3;3;6
109;06.11.2016;2016;11;10;Sunnuntai;2;9;11;5;6;11
109;06.11.2016;2016;11;11;Sunnuntai;7;3;10;10;2;12
109;06.11.2016;2016;11;12;Sunnuntai;5;0;5;7;2;9
109;06.11.2016;2016;11;13;Sunnuntai;4;7;11;5;2;7
109;06.11.2016;2016;11;14;Sunnuntai;4;2;6;6;3;9
109;06.11.2016;2016;11;15;Sunnuntai;3;9;12;5;4;9
109;06.11.2016;2016;11;16;Sunnuntai;9;5;14;3;2;5
109;06.11.2016;2016;11;17;Sunnuntai;1;5;6;3;3;6
109;06.11.2016;2016;11;18;Sunnuntai;1;6;7;1;2;3
109;06.11.2016;2016;11;19;Sunnuntai;1;0;1;4;0;4
109;06.11.2016;2016;11;20;Sunnuntai;2;2;4;6;2;8
109;06.11.2016;2016;11;21;Sunnuntai;6;3;9;3;5;8
109;06.11.2016;2016;11;22;Sunnuntai;3;1;4;3;0;3
109;06.11.2016;2016;11;23;Sunnuntai;0;0;0;0;0;0
109;07.11.2016;2016;11;00;Maanantai;0;0;0;0;2;2
109;07.11.2016;2016;11;01;Maanantai;0;0;0;0;0;0
109;07.11.2016;2016;11;02;Maanantai;0;0;0;0;0;0
109;07.11.2016;2016;11;03;Maanantai;0;0;0;0;0;0
109;07.11.2016;2016;11;04;Maanantai;2;1;3;1;0;1
109;07.11.2016;2016;11;05;Maanantai;4;2;6;0;1;1
109;07.11.2016;2016;11;06;Maanantai;20;7;27;2;2;4
109;07.11.2016;2016;11;07;Maanantai;62;22;84;10;5;15
109;07.11.2016;2016;11;08;Maanantai;44;14;58;6;3;9
109;07.11.2016;2016;11;09;Maanantai;19;7;26;4;1;5
109;07.11.2016;2016;11;10;Maanantai;8;8;16;4;3;7
109;07.11.2016;2016;11;11;Maanantai;8;9;17;6;4;10
109;07.11.2016;2016;11;12;Maanantai;15;5;20;3;3;6
109;07.11.2016;2016;11;13;Maanantai;6;14;20;3;1;4
109;07.11.2016;2016;11;14;Maanantai;12;18;30;4;4;8
109;07.11.2016;2016;11;15;Maanantai;25;45;70;7;3;10
109;07.11.2016;2016;11;16;Maanantai;23;56;79;5;5;10
109;07.11.2016;2016;11;17;Maanantai;10;24;34;4;4;8
109;07.11.2016;2016;11;18;Maanantai;4;9;13;6;0;6
109;07.11.2016;2016;11;19;Maanantai;5;6;11;0;3;3
109;07.11.2016;2016;11;20;Maanantai;9;4;13;1;3;4
109;07.11.2016;2016;11;21;Maanantai;7;8;15;2;3;5
109;07.11.2016;2016;11;22;Maanantai;3;2;5;3;1;4
109;07.11.2016;2016;11;23;Maanantai;0;1;1;0;1;1
109;08.11.2016;2016;11;00;Tiistai;1;0;1;0;0;0
109;08.11.2016;2016;11;01;Tiistai;0;0;0;0;0;0
109;08.11.2016;2016;11;02;Tiistai;0;0;0;0;0;0
109;08.11.2016;2016;11;03;Tiistai;1;0;1;0;0;0
109;08.11.2016;2016;11;04;Tiistai;1;0;1;1;0;1
109;08.11.2016;2016;11;05;Tiistai;4;3;7;1;0;1
109;08.11.2016;2016;11;06;Tiistai;25;12;37;1;1;2
109;08.11.2016;2016;11;07;Tiistai;74;30;104;13;4;17
109;08.11.2016;2016;11;08;Tiistai;41;7;48;4;2;6
109;08.11.2016;2016;11;09;Tiistai;14;9;23;0;2;2
109;08.11.2016;2016;11;10;Tiistai;5;2;7;3;5;8
109;08.11.2016;2016;11;11;Tiistai;7;5;12;4;1;5
109;08.11.2016;2016;11;12;Tiistai;14;9;23;3;4;7
109;08.11.2016;2016;11;13;Tiistai;11;18;29;5;1;6
109;08.11.2016;2016;11;14;Tiistai;5;9;14;1;2;3
109;08.11.2016;2016;11;15;Tiistai;17;43;60;5;6;11
109;08.11.2016;2016;11;16;Tiistai;25;51;76;5;6;11
109;08.11.2016;2016;11;17;Tiistai;11;12;23;4;2;6
109;08.11.2016;2016;11;18;Tiistai;6;16;22;6;4;10
109;08.11.2016;2016;11;19;Tiistai;4;6;10;6;9;15
109;08.11.2016;2016;11;20;Tiistai;1;5;6;7;3;10
109;08.11.2016;2016;11;21;Tiistai;7;7;14;2;1;3
109;08.11.2016;2016;11;22;Tiistai;2;1;3;1;0;1
109;08.11.2016;2016;11;23;Tiistai;1;1;2;2;0;2
109;09.11.2016;2016;11;00;Keskiviikko;0;0;0;0;0;0
109;09.11.2016;2016;11;01;Keskiviikko;0;0;0;0;0;0
109;09.11.2016;2016;11;02;Keskiviikko;0;0;0;0;0;0
109;09.11.2016;2016;11;03;Keskiviikko;1;0;1;0;0;0
109;09.11.2016;2016;11;04;Keskiviikko;1;0;1;1;0;1
109;09.11.2016;2016;11;05;Keskiviikko;4;4;8;0;0;0
109;09.11.2016;2016;11;06;Keskiviikko;23;11;34;3;3;6
109;09.11.2016;2016;11;07;Keskiviikko;65;32;97;13;8;21
109;09.11.2016;2016;11;08;Keskiviikko;37;10;47;3;4;7
109;09.11.2016;2016;11;09;Keskiviikko;15;5;20;2;2;4
109;09.11.2016;2016;11;10;Keskiviikko;11;5;16;1;4;5
109;09.11.2016;2016;11;11;Keskiviikko;14;5;19;7;6;13
109;09.11.2016;2016;11;12;Keskiviikko;15;10;25;6;2;8
109;09.11.2016;2016;11;13;Keskiviikko;7;14;21;3;3;6
109;09.11.2016;2016;11;14;Keskiviikko;14;18;32;10;4;14
109;09.11.2016;2016;11;15;Keskiviikko;19;44;63;7;5;12
109;09.11.2016;2016;11;16;Keskiviikko;23;49;72;4;4;8
109;09.11.2016;2016;11;17;Keskiviikko;16;25;41;4;6;10
109;09.11.2016;2016;11;18;Keskiviikko;4;18;22;8;3;11
109;09.11.2016;2016;11;19;Keskiviikko;3;4;7;2;4;6
109;09.11.2016;2016;11;20;Keskiviikko;8;7;15;3;2;5
109;09.11.2016;2016;11;21;Keskiviikko;4;9;13;1;0;1
109;09.11.2016;2016;11;22;Keskiviikko;5;2;7;4;2;6
109;09.11.2016;2016;11;23;Keskiviikko;0;0;0;1;1;2
109;10.11.2016;2016;11;00;Torstai;0;0;0;0;0;0
109;10.11.2016;2016;11;01;Torstai;0;1;1;0;0;0
109;10.11.2016;2016;11;02;Torstai;0;0;0;0;0;0
109;10.11.2016;2016;11;03;Torstai;0;0;0;0;0;0
109;10.11.2016;2016;11;04;Torstai;1;0;1;1;0;1
109;10.11.2016;2016;11;05;Torstai;3;3;6;0;0;0
109;10.11.2016;2016;11;06;Torstai;18;14;32;2;2;4
109;10.11.2016;2016;11;07;Torstai;59;23;82;9;3;12
109;10.11.2016;2016;11;08;Torstai;47;12;59;2;2;4
109;10.11.2016;2016;11;09;Torstai;23;6;29;1;0;1
109;10.11.2016;2016;11;10;Torstai;6;7;13;2;7;9
109;10.11.2016;2016;11;11;Torstai;10;5;15;6;6;12
109;10.11.2016;2016;11;12;Torstai;12;2;14;1;3;4
109;10.11.2016;2016;11;13;Torstai;6;13;19;3;5;8
109;10.11.2016;2016;11;14;Torstai;15;16;31;3;5;8
109;10.11.2016;2016;11;15;Torstai;16;62;78;6;7;13
109;10.11.2016;2016;11;16;Torstai;28;38;66;7;5;12
109;10.11.2016;2016;11;17;Torstai;6;13;19;4;6;10
109;10.11.2016;2016;11;18;Torstai;3;6;9;5;2;7
109;10.11.2016;2016;11;19;Torstai;5;11;16;6;0;6
109;10.11.2016;2016;11;20;Torstai;5;6;11;2;3;5
109;10.11.2016;2016;11;21;Torstai;5;15;20;3;2;5
109;10.11.2016;2016;11;22;Torstai;1;1;2;2;0;2
109;10.11.2016;2016;11;23;Torstai;1;0;1;0;0;0
109;11.11.2016;2016;11;00;Perjantai;0;0;0;1;0;1
109;11.11.2016;2016;11;01;Perjantai;0;0;0;0;0;0
109;11.11.2016;2016;11;02;Perjantai;0;0;0;0;0;0
109;11.11.2016;2016;11;03;Perjantai;0;0;0;0;0;0
109;11.11.2016;2016;11;04;Perjantai;0;0;0;0;0;0
109;11.11.2016;2016;11;05;Perjantai;6;3;9;1;0;1
109;11.11.2016;2016;11;06;Perjantai;19;17;36;0;0;0
109;11.11.2016;2016;11;07;Perjantai;34;34;68;0;0;0
109;11.11.2016;2016;11;08;Perjantai;24;22;46;0;0;0
109;11.11.2016;2016;11;09;Perjantai;13;10;23;0;0;0
109;11.11.2016;2016;11;10;Perjantai;8;6;14;0;0;0
109;11.11.2016;2016;11;11;Perjantai;8;13;21;2;1;3
109;11.11.2016;2016;11;12;Perjantai;15;6;21;3;3;6
109;11.11.2016;2016;11;13;Perjantai;5;18;23;4;6;10
109;11.11.2016;2016;11;14;Perjantai;14;20;34;4;5;9
109;11.11.2016;2016;11;15;Perjantai;12;37;49;8;5;13
109;11.11.2016;2016;11;16;Perjantai;16;27;43;1;5;6
109;11.11.2016;2016;11;17;Perjantai;13;20;33;1;0;1
109;11.11.2016;2016;11;18;Perjantai;2;6;8;3;3;6
109;11.11.2016;2016;11;19;Perjantai;4;7;11;6;2;8
109;11.11.2016;2016;11;20;Perjantai;8;2;10;6;2;8
109;11.11.2016;2016;11;21;Perjantai;1;2;3;2;0;2
109;11.11.2016;2016;11;22;Perjantai;4;3;7;1;2;3
109;11.11.2016;2016;11;23;Perjantai;1;1;2;2;0;2
109;12.11.2016;2016;11;00;Lauantai;2;1;3;1;0;1
109;12.11.2016;2016;11;01;Lauantai;0;0;0;0;0;0
109;12.11.2016;2016;11;02;Lauantai;0;3;3;0;0;0
109;12.11.2016;2016;11;03;Lauantai;0;1;1;0;0;0
109;12.11.2016;2016;11;04;Lauantai;0;2;2;0;0;0
109;12.11.2016;2016;11;05;Lauantai;0;0;0;1;0;1
109;12.11.2016;2016;11;06;Lauantai;2;1;3;3;1;4
109;12.11.2016;2016;11;07;Lauantai;3;3;6;1;0;1
109;12.11.2016;2016;11;08;Lauantai;2;2;4;2;0;2
109;12.11.2016;2016;11;09;Lauantai;6;6;12;1;7;8
109;12.11.2016;2016;11;10;Lauantai;3;0;3;6;4;10
109;12.11.2016;2016;11;11;Lauantai;8;8;16;6;3;9
109;12.11.2016;2016;11;12;Lauantai;7;4;11;4;6;10
109;12.11.2016;2016;11;13;Lauantai;2;6;8;6;3;9
109;12.11.2016;2016;11;14;Lauantai;1;6;7;3;4;7
109;12.11.2016;2016;11;15;Lauantai;3;7;10;3;2;5
109;12.11.2016;2016;11;16;Lauantai;7;1;8;5;3;8
109;12.11.2016;2016;11;17;Lauantai;6;3;9;6;2;8
109;12.11.2016;2016;11;18;Lauantai;6;1;7;5;2;7
109;12.11.2016;2016;11;19;Lauantai;4;0;4;6;1;7
109;12.11.2016;2016;11;20;Lauantai;5;3;8;2;1;3
109;12.11.2016;2016;11;21;Lauantai;1;6;7;3;2;5
109;12.11.2016;2016;11;22;Lauantai;0;2;2;1;2;3
109;12.11.2016;2016;11;23;Lauantai;1;1;2;1;2;3
109;13.11.2016;2016;11;00;Sunnuntai;0;1;1;0;0;0
109;13.11.2016;2016;11;01;Sunnuntai;1;1;2;0;1;1
109;13.11.2016;2016;11;02;Sunnuntai;1;1;2;0;0;0
109;13.11.2016;2016;11;03;Sunnuntai;1;0;1;0;0;0
109;13.11.2016;2016;11;04;Sunnuntai;0;1;1;0;0;0
109;13.11.2016;2016;11;05;Sunnuntai;0;1;1;0;0;0
109;13.11.2016;2016;11;06;Sunnuntai;2;0;2;1;0;1
109;13.11.2016;2016;11;07;Sunnuntai;1;4;5;2;0;2
109;13.11.2016;2016;11;08;Sunnuntai;1;1;2;3;5;8
109;13.11.2016;2016;11;09;Sunnuntai;2;1;3;6;7;13
109;13.11.2016;2016;11;10;Sunnuntai;2;3;5;5;8;13
109;13.11.2016;2016;11;11;Sunnuntai;9;4;13;8;4;12
109;13.11.2016;2016;11;12;Sunnuntai;3;6;9;8;3;11
109;13.11.2016;2016;11;13;Sunnuntai;5;10;15;4;4;8
109;13.11.2016;2016;11;14;Sunnuntai;8;3;11;5;1;6
109;13.11.2016;2016;11;15;Sunnuntai;9;4;13;5;2;7
109;13.11.2016;2016;11;16;Sunnuntai;5;7;12;5;6;11
109;13.11.2016;2016;11;17;Sunnuntai;3;0;3;2;2;4
109;13.11.2016;2016;11;18;Sunnuntai;4;6;10;9;7;16
109;13.11.2016;2016;11;19;Sunnuntai;3;4;7;2;2;4
109;13.11.2016;2016;11;20;Sunnuntai;3;3;6;3;2;5
109;13.11.2016;2016;11;21;Sunnuntai;1;5;6;3;1;4
109;13.11.2016;2016;11;22;Sunnuntai;0;0;0;5;1;6
109;13.11.2016;2016;11;23;Sunnuntai;0;1;1;0;0;0
109;14.11.2016;2016;11;00;Maanantai;0;0;0;0;1;1
109;14.11.2016;2016;11;01;Maanantai;0;0;0;0;0;0
109;14.11.2016;2016;11;02;Maanantai;0;0;0;0;0;0
109;14.11.2016;2016;11;03;Maanantai;0;1;1;0;0;0
109;14.11.2016;2016;11;04;Maanantai;0;0;0;0;0;0
109;14.11.2016;2016;11;05;Maanantai;2;6;8;3;1;4
109;14.11.2016;2016;11;06;Maanantai;20;12;32;2;2;4
109;14.11.2016;2016;11;07;Maanantai;74;21;95;8;4;12
109;14.11.2016;2016;11;08;Maanantai;32;9;41;3;3;6
109;14.11.2016;2016;11;09;Maanantai;17;3;20;3;0;3
109;14.11.2016;2016;11;10;Maanantai;8;6;14;5;3;8
109;14.11.2016;2016;11;11;Maanantai;15;5;20;5;1;6
109;14.11.2016;2016;11;12;Maanantai;10;6;16;0;4;4
109;14.11.2016;2016;11;13;Maanantai;9;9;18;3;1;4
109;14.11.2016;2016;11;14;Maanantai;10;24;34;5;0;5
109;14.11.2016;2016;11;15;Maanantai;16;35;51;4;6;10
109;14.11.2016;2016;11;16;Maanantai;20;57;77;9;4;13
109;14.11.2016;2016;11;17;Maanantai;14;26;40;5;3;8
109;14.11.2016;2016;11;18;Maanantai;3;8;11;10;1;11
109;14.11.2016;2016;11;19;Maanantai;3;6;9;5;4;9
109;14.11.2016;2016;11;20;Maanantai;2;4;6;4;3;7
109;14.11.2016;2016;11;21;Maanantai;4;3;7;5;2;7
109;14.11.2016;2016;11;22;Maanantai;3;1;4;2;2;4
109;14.11.2016;2016;11;23;Maanantai;1;0;1;0;0;0
109;15.11.2016;2016;11;00;Tiistai;0;0;0;1;0;1
109;15.11.2016;2016;11;01;Tiistai;0;0;0;0;0;0
109;15.11.2016;2016;11;02;Tiistai;0;0;0;0;0;0
109;15.11.2016;2016;11;03;Tiistai;0;0;0;0;0;0
109;15.11.2016;2016;11;04;Tiistai;0;0;0;1;0;1
109;15.11.2016;2016;11;05;Tiistai;2;8;10;1;1;2
109;15.11.2016;2016;11;06;Tiistai;24;13;37;2;1;3
109;15.11.2016;2016;11;07;Tiistai;67;22;89;10;5;15
109;15.11.2016;2016;11;08;Tiistai;49;7;56;2;2;4
109;15.11.2016;2016;11;09;Tiistai;10;8;18;3;1;4
109;15.11.2016;2016;11;10;Tiistai;5;5;10;1;8;9
109;15.11.2016;2016;11;11;Tiistai;10;8;18;4;3;7
109;15.11.2016;2016;11;12;Tiistai;23;8;31;0;2;2
109;15.11.2016;2016;11;13;Tiistai;7;11;18;5;4;9
109;15.11.2016;2016;11;14;Tiistai;11;10;21;2;3;5
109;15.11.2016;2016;11;15;Tiistai;11;41;52;6;5;11
109;15.11.2016;2016;11;16;Tiistai;20;48;68;8;4;12
109;15.11.2016;2016;11;17;Tiistai;10;27;37;6;4;10
109;15.11.2016;2016;11;18;Tiistai;4;11;15;5;0;5
109;15.11.2016;2016;11;19;Tiistai;4;5;9;2;5;7
109;15.11.2016;2016;11;20;Tiistai;5;9;14;6;3;9
109;15.11.2016;2016;11;21;Tiistai;3;5;8;3;1;4
109;15.11.2016;2016;11;22;Tiistai;0;3;3;0;2;2
109;15.11.2016;2016;11;23;Tiistai;0;1;1;1;0;1
109;16.11.2016;2016;11;00;Keskiviikko;0;1;1;1;0;1
109;16.11.2016;2016;11;01;Keskiviikko;0;0;0;0;0;0
109;16.11.2016;2016;11;02;Keskiviikko;2;0;2;0;0;0
109;16.11.2016;2016;11;03;Keskiviikko;0;0;0;0;0;0
109;16.11.2016;2016;11;04;Keskiviikko;0;0;0;1;0;1
109;16.11.2016;2016;11;05;Keskiviikko;6;3;9;1;1;2
109;16.11.2016;2016;11;06;Keskiviikko;15;15;30;2;1;3
109;16.11.2016;2016;11;07;Keskiviikko;30;32;62;9;5;14
109;16.11.2016;2016;11;08;Keskiviikko;20;19;39;2;2;4
109;16.11.2016;2016;11;09;Keskiviikko;8;7;15;2;1;3
109;16.11.2016;2016;11;10;Keskiviikko;11;7;18;1;2;3
109;16.11.2016;2016;11;11;Keskiviikko;10;6;16;2;3;5
109;16.11.2016;2016;11;12;Keskiviikko;11;6;17;0;2;2
109;16.11.2016;2016;11;13;Keskiviikko;8;8;16;4;2;6
109;16.11.2016;2016;11;14;Keskiviikko;16;12;28;2;3;5
109;16.11.2016;2016;11;15;Keskiviikko;25;24;49;6;5;11
109;16.11.2016;2016;11;16;Keskiviikko;40;40;80;5;4;9
109;16.11.2016;2016;11;17;Keskiviikko;13;9;22;3;4;7
109;16.11.2016;2016;11;18;Keskiviikko;5;6;11;3;0;3
109;16.11.2016;2016;11;19;Keskiviikko;4;3;7;2;2;4
109;16.11.2016;2016;11;20;Keskiviikko;4;4;8;2;1;3
109;16.11.2016;2016;11;21;Keskiviikko;9;9;18;1;1;2
109;16.11.2016;2016;11;22;Keskiviikko;3;2;5;0;1;1
109;16.11.2016;2016;11;23;Keskiviikko;5;1;6;1;0;1
109;17.11.2016;2016;11;00;Torstai;0;0;0;0;1;1
109;17.11.2016;2016;11;01;Torstai;1;1;2;0;0;0
109;17.11.2016;2016;11;02;Torstai;0;0;0;0;0;0
109;17.11.2016;2016;11;03;Torstai;1;0;1;0;0;0
109;17.11.2016;2016;11;04;Torstai;1;2;3;0;0;0
109;17.11.2016;2016;11;05;Torstai;2;8;10;0;0;0
109;17.11.2016;2016;11;06;Torstai;18;11;29;3;3;6
109;17.11.2016;2016;11;07;Torstai;60;23;83;13;6;19
109;17.11.2016;2016;11;08;Torstai;41;12;53;4;3;7
109;17.11.2016;2016;11;09;Torstai;14;2;16;5;3;8
109;17.11.2016;2016;11;10;Torstai;10;6;16;2;9;11
109;17.11.2016;2016;11;11;Torstai;14;8;22;2;7;9
109;17.11.2016;2016;11;12;Torstai;12;7;19;5;2;7
109;17.11.2016;2016;11;13;Torstai;8;8;16;3;2;5
109;17.11.2016;2016;11;14;Torstai;18;19;37;7;4;11
109;17.11.2016;2016;11;15;Torstai;19;46;65;4;5;9
109;17.11.2016;2016;11;16;Torstai;18;53;71;8;1;9
109;17.11.2016;2016;11;17;Torstai;8;13;21;5;3;8
109;17.11.2016;2016;11;18;Torstai;6;11;17;5;9;14
109;17.11.2016;2016;11;19;Torstai;1;7;8;8;4;12
109;17.11.2016;2016;11;20;Torstai;2;7;9;2;3;5
109;17.11.2016;2016;11;21;Torstai;5;14;19;1;3;4
109;17.11.2016;2016;11;22;Torstai;4;3;7;2;2;4
109;17.11.2016;2016;11;23;Torstai;1;0;1;0;0;0
109;18.11.2016;2016;11;00;Perjantai;1;0;1;0;0;0
109;18.11.2016;2016;11;01;Perjantai;0;0;0;0;0;0
109;18.11.2016;2016;11;02;Perjantai;0;0;0;0;0;0
109;18.11.2016;2016;11;03;Perjantai;1;0;1;0;0;0
109;18.11.2016;2016;11;04;Perjantai;0;1;1;0;0;0
109;18.11.2016;2016;11;05;Perjantai;2;6;8;1;1;2
109;18.11.2016;2016;11;06;Perjantai;13;8;21;2;3;5
109;18.11.2016;2016;11;07;Perjantai;43;15;58;5;8;13
109;18.11.2016;2016;11;08;Perjantai;31;7;38;3;2;5
109;18.11.2016;2016;11;09;Perjantai;17;3;20;6;2;8
109;18.11.2016;2016;11;10;Perjantai;9;9;18;2;2;4
109;18.11.2016;2016;11;11;Perjantai;12;8;20;4;0;4
109;18.11.2016;2016;11;12;Perjantai;16;11;27;1;2;3
109;18.11.2016;2016;11;13;Perjantai;15;17;32;4;5;9
109;18.11.2016;2016;11;14;Perjantai;13;22;35;11;4;15
109;18.11.2016;2016;11;15;Perjantai;13;35;48;4;2;6
109;18.11.2016;2016;11;16;Perjantai;11;31;42;4;4;8
109;18.11.2016;2016;11;17;Perjantai;8;13;21;5;1;6
109;18.11.2016;2016;11;18;Perjantai;3;4;7;4;2;6
109;18.11.2016;2016;11;19;Perjantai;6;8;14;5;6;11
109;18.11.2016;2016;11;20;Perjantai;5;5;10;2;2;4
109;18.11.2016;2016;11;21;Perjantai;3;10;13;1;0;1
109;18.11.2016;2016;11;22;Perjantai;3;1;4;0;1;1
109;18.11.2016;2016;11;23;Perjantai;3;2;5;0;0;0
109;19.11.2016;2016;11;00;Lauantai;1;0;1;0;0;0
109;19.11.2016;2016;11;01;Lauantai;1;0;1;0;0;0
109;19.11.2016;2016;11;02;Lauantai;0;1;1;0;0;0
109;19.11.2016;2016;11;03;Lauantai;1;1;2;0;0;0
109;19.11.2016;2016;11;04;Lauantai;0;0;0;0;0;0
109;19.11.2016;2016;11;05;Lauantai;7;1;8;0;0;0
109;19.11.2016;2016;11;06;Lauantai;2;0;2;1;0;1
109;19.11.2016;2016;11;07;Lauantai;3;0;3;3;1;4
109;19.11.2016;2016;11;08;Lauantai;0;2;2;2;1;3
109;19.11.2016;2016;11;09;Lauantai;3;2;5;2;1;3
109;19.11.2016;2016;11;10;Lauantai;5;1;6;5;4;9
109;19.11.2016;2016;11;11;Lauantai;1;3;4;7;4;11
109;19.11.2016;2016;11;12;Lauantai;4;3;7;2;3;5
109;19.11.2016;2016;11;13;Lauantai;8;2;10;7;3;10
109;19.11.2016;2016;11;14;Lauantai;1;5;6;2;0;2
109;19.11.2016;2016;11;15;Lauantai;5;13;18;1;0;1
109;19.11.2016;2016;11;16;Lauantai;5;7;12;0;6;6
109;19.11.2016;2016;11;17;Lauantai;5;1;6;2;1;3
109;19.11.2016;2016;11;18;Lauantai;1;4;5;1;1;2
109;19.11.2016;2016;11;19;Lauantai;0;0;0;1;1;2
109;19.11.2016;2016;11;20;Lauantai;3;0;3;2;0;2
109;19.11.2016;2016;11;21;Lauantai;1;1;2;1;3;4
109;19.11.2016;2016;11;22;Lauantai;0;4;4;1;3;4
109;19.11.2016;2016;11;23;Lauantai;0;1;1;2;0;2
109;20.11.2016;2016;11;00;Sunnuntai;0;0;0;1;0;1
109;20.11.2016;2016;11;01;Sunnuntai;0;0;0;0;0;0
109;20.11.2016;2016;11;02;Sunnuntai;0;3;3;0;0;0
109;20.11.2016;2016;11;03;Sunnuntai;0;0;0;0;0;0
109;20.11.2016;2016;11;04;Sunnuntai;1;2;3;0;0;0
109;20.11.2016;2016;11;05;Sunnuntai;2;0;2;0;0;0
109;20.11.2016;2016;11;06;Sunnuntai;3;0;3;1;0;1
109;20.11.2016;2016;11;07;Sunnuntai;3;2;5;1;1;2
109;20.11.2016;2016;11;08;Sunnuntai;3;0;3;5;4;9
109;20.11.2016;2016;11;09;Sunnuntai;3;2;5;6;3;9
109;20.11.2016;2016;11;10;Sunnuntai;7;2;9;6;6;12
109;20.11.2016;2016;11;11;Sunnuntai;2;6;8;4;2;6
109;20.11.2016;2016;11;12;Sunnuntai;12;7;19;9;5;14
109;20.11.2016;2016;11;13;Sunnuntai;10;13;23;1;7;8
109;20.11.2016;2016;11;14;Sunnuntai;10;5;15;7;0;7
109;20.11.2016;2016;11;15;Sunnuntai;4;3;7;6;5;11
109;20.11.2016;2016;11;16;Sunnuntai;7;8;15;7;1;8
109;20.11.2016;2016;11;17;Sunnuntai;5;3;8;10;3;13
109;20.11.2016;2016;11;18;Sunnuntai;3;6;9;5;5;10
109;20.11.2016;2016;11;19;Sunnuntai;1;4;5;4;2;6
109;20.11.2016;2016;11;20;Sunnuntai;4;5;9;1;2;3
109;20.11.2016;2016;11;21;Sunnuntai;1;7;8;0;2;2
109;20.11.2016;2016;11;22;Sunnuntai;0;0;0;1;3;4
109;20.11.2016;2016;11;23;Sunnuntai;3;0;3;1;0;1
109;21.11.2016;2016;11;00;Maanantai;0;0;0;2;1;3
109;21.11.2016;2016;11;01;Maanantai;0;0;0;0;0;0
109;21.11.2016;2016;11;02;Maanantai;0;0;0;0;0;0
109;21.11.2016;2016;11;03;Maanantai;0;0;0;0;0;0
109;21.11.2016;2016;11;04;Maanantai;0;0;0;0;0;0
109;21.11.2016;2016;11;05;Maanantai;3;6;9;2;0;2
109;21.11.2016;2016;11;06;Maanantai;23;12;35;2;1;3
109;21.11.2016;2016;11;07;Maanantai;62;24;86;6;8;14
109;21.11.2016;2016;11;08;Maanantai;44;10;54;5;2;7
109;21.11.2016;2016;11;09;Maanantai;17;4;21;4;3;7
109;21.11.2016;2016;11;10;Maanantai;9;4;13;2;4;6
109;21.11.2016;2016;11;11;Maanantai;11;9;20;6;4;10
109;21.11.2016;2016;11;12;Maanantai;12;10;22;5;1;6
109;21.11.2016;2016;11;13;Maanantai;14;18;32;5;4;9
109;21.11.2016;2016;11;14;Maanantai;14;18;32;5;6;11
109;21.11.2016;2016;11;15;Maanantai;15;40;55;4;4;8
109;21.11.2016;2016;11;16;Maanantai;22;54;76;6;2;8
109;21.11.2016;2016;11;17;Maanantai;14;15;29;3;1;4
109;21.11.2016;2016;11;18;Maanantai;10;10;20;1;1;2
109;21.11.2016;2016;11;19;Maanantai;5;5;10;7;4;11
109;21.11.2016;2016;11;20;Maanantai;5;3;8;6;1;7
109;21.11.2016;2016;11;21;Maanantai;4;3;7;1;0;1
109;21.11.2016;2016;11;22;Maanantai;5;5;10;1;1;2
109;21.11.2016;2016;11;23;Maanantai;0;0;0;0;0;0
109;22.11.2016;2016;11;00;Tiistai;0;0;0;1;0;1
109;22.11.2016;2016;11;01;Tiistai;1;0;1;0;0;0
109;22.11.2016;2016;11;02;Tiistai;0;0;0;0;0;0
109;22.11.2016;2016;11;03;Tiistai;0;0;0;1;0;1
109;22.11.2016;2016;11;04;Tiistai;0;2;2;0;0;0
109;22.11.2016;2016;11;05;Tiistai;1;8;9;2;0;2
109;22.11.2016;2016;11;06;Tiistai;28;13;41;2;0;2
109;22.11.2016;2016;11;07;Tiistai;65;30;95;9;5;14
109;22.11.2016;2016;11;08;Tiistai;46;12;58;1;2;3
109;22.11.2016;2016;11;09;Tiistai;9;4;13;4;5;9
109;22.11.2016;2016;11;10;Tiistai;12;7;19;2;4;6
109;22.11.2016;2016;11;11;Tiistai;15;9;24;7;4;11
109;22.11.2016;2016;11;12;Tiistai;13;16;29;2;6;8
109;22.11.2016;2016;11;13;Tiistai;7;11;18;0;4;4
109;22.11.2016;2016;11;14;Tiistai;13;24;37;6;8;14
109;22.11.2016;2016;11;15;Tiistai;13;40;53;4;4;8
109;22.11.2016;2016;11;16;Tiistai;25;42;67;9;3;12
109;22.11.2016;2016;11;17;Tiistai;11;22;33;6;4;10
109;22.11.2016;2016;11;18;Tiistai;8;9;17;4;2;6
109;22.11.2016;2016;11;19;Tiistai;5;6;11;3;5;8
109;22.11.2016;2016;11;20;Tiistai;1;9;10;7;1;8
109;22.11.2016;2016;11;21;Tiistai;6;9;15;2;0;2
109;22.11.2016;2016;11;22;Tiistai;5;1;6;0;0;0
109;22.11.2016;2016;11;23;Tiistai;0;0;0;0;0;0
109;23.11.2016;2016;11;00;Keskiviikko;0;1;1;0;0;0
109;23.11.2016;2016;11;01;Keskiviikko;0;0;0;0;0;0
109;23.11.2016;2016;11;02;Keskiviikko;0;1;1;0;0;0
109;23.11.2016;2016;11;03;Keskiviikko;1;0;1;0;0;0
109;23.11.2016;2016;11;04;Keskiviikko;0;0;0;1;0;1
109;23.11.2016;2016;11;05;Keskiviikko;3;5;8;0;0;0
109;23.11.2016;2016;11;06;Keskiviikko;18;13;31;1;0;1
109;23.11.2016;2016;11;07;Keskiviikko;55;25;80;4;2;6
109;23.11.2016;2016;11;08;Keskiviikko;40;9;49;2;1;3
109;23.11.2016;2016;11;09;Keskiviikko;12;3;15;3;1;4
109;23.11.2016;2016;11;10;Keskiviikko;8;8;16;0;4;4
109;23.11.2016;2016;11;11;Keskiviikko;12;7;19;1;2;3
109;23.11.2016;2016;11;12;Keskiviikko;11;9;20;3;0;3
109;23.11.2016;2016;11;13;Keskiviikko;7;14;21;1;2;3
109;23.11.2016;2016;11;14;Keskiviikko;15;16;31;6;0;6
109;23.11.2016;2016;11;15;Keskiviikko;18;32;50;2;2;4
109;23.11.2016;2016;11;16;Keskiviikko;22;40;62;9;2;11
109;23.11.2016;2016;11;17;Keskiviikko;15;19;34;2;0;2
109;23.11.2016;2016;11;18;Keskiviikko;7;10;17;4;2;6
109;23.11.2016;2016;11;19;Keskiviikko;7;3;10;4;1;5
109;23.11.2016;2016;11;20;Keskiviikko;3;10;13;2;1;3
109;23.11.2016;2016;11;21;Keskiviikko;5;11;16;1;1;2
109;23.11.2016;2016;11;22;Keskiviikko;4;2;6;1;1;2
109;23.11.2016;2016;11;23;Keskiviikko;0;0;0;2;0;2
109;24.11.2016;2016;11;00;Torstai;0;0;0;1;0;1
109;24.11.2016;2016;11;01;Torstai;0;0;0;0;0;0
109;24.11.2016;2016;11;02;Torstai;0;0;0;0;0;0
109;24.11.2016;2016;11;03;Torstai;0;0;0;0;0;0
109;24.11.2016;2016;11;04;Torstai;0;1;1;1;0;1
109;24.11.2016;2016;11;05;Torstai;3;5;8;0;1;1
109;24.11.2016;2016;11;06;Torstai;22;12;34;1;0;1
109;24.11.2016;2016;11;07;Torstai;64;19;83;11;3;14
109;24.11.2016;2016;11;08;Torstai;36;6;42;5;1;6
109;24.11.2016;2016;11;09;Torstai;19;8;27;1;0;1
109;24.11.2016;2016;11;10;Torstai;9;1;10;3;2;5
109;24.11.2016;2016;11;11;Torstai;12;5;17;3;3;6
109;24.11.2016;2016;11;12;Torstai;14;5;19;7;3;10
109;24.11.2016;2016;11;13;Torstai;12;20;32;1;3;4
109;24.11.2016;2016;11;14;Torstai;12;21;33;3;2;5
109;24.11.2016;2016;11;15;Torstai;18;30;48;7;4;11
109;24.11.2016;2016;11;16;Torstai;19;38;57;7;5;12
109;24.11.2016;2016;11;17;Torstai;9;16;25;3;4;7
109;24.11.2016;2016;11;18;Torstai;2;7;9;2;1;3
109;24.11.2016;2016;11;19;Torstai;3;5;8;6;1;7
109;24.11.2016;2016;11;20;Torstai;4;11;15;4;4;8
109;24.11.2016;2016;11;21;Torstai;2;8;10;1;0;1
109;24.11.2016;2016;11;22;Torstai;4;4;8;1;2;3
109;24.11.2016;2016;11;23;Torstai;0;1;1;1;2;3
109;25.11.2016;2016;11;00;Perjantai;0;0;0;0;0;0
109;25.11.2016;2016;11;01;Perjantai;0;1;1;0;0;0
109;25.11.2016;2016;11;02;Perjantai;0;0;0;0;0;0
109;25.11.2016;2016;11;03;Perjantai;0;0;0;0;0;0
109;25.11.2016;2016;11;04;Perjantai;0;0;0;1;1;2
109;25.11.2016;2016;11;05;Perjantai;1;5;6;0;0;0
109;25.11.2016;2016;11;06;Perjantai;14;10;24;0;0;0
109;25.11.2016;2016;11;07;Perjantai;56;25;81;7;6;13
109;25.11.2016;2016;11;08;Perjantai;38;7;45;0;1;1
109;25.11.2016;2016;11;09;Perjantai;11;7;18;3;0;3
109;25.11.2016;2016;11;10;Perjantai;7;2;9;5;2;7
109;25.11.2016;2016;11;11;Perjantai;10;9;19;3;2;5
109;25.11.2016;2016;11;12;Perjantai;19;9;28;1;3;4
109;25.11.2016;2016;11;13;Perjantai;7;9;16;2;4;6
109;25.11.2016;2016;11;14;Perjantai;17;19;36;4;1;5
109;25.11.2016;2016;11;15;Perjantai;16;32;48;5;2;7
109;25.11.2016;2016;11;16;Perjantai;21;24;45;4;4;8
109;25.11.2016;2016;11;17;Perjantai;5;10;15;1;2;3
109;25.11.2016;2016;11;18;Perjantai;3;6;9;5;1;6
109;25.11.2016;2016;11;19;Perjantai;1;3;4;3;1;4
109;25.11.2016;2016;11;20;Perjantai;4;4;8;1;1;2
109;25.11.2016;2016;11;21;Perjantai;3;11;14;0;3;3
109;25.11.2016;2016;11;22;Perjantai;4;5;9;1;0;1
109;25.11.2016;2016;11;23;Perjantai;1;0;1;0;0;0
109;26.11.2016;2016;11;00;Lauantai;2;1;3;0;0;0
109;26.11.2016;2016;11;01;Lauantai;0;0;0;0;0;0
109;26.11.2016;2016;11;02;Lauantai;2;0;2;0;0;0
109;26.11.2016;2016;11;03;Lauantai;0;0;0;0;0;0
109;26.11.2016;2016;11;04;Lauantai;1;0;1;0;0;0
109;26.11.2016;2016;11;05;Lauantai;1;0;1;0;0;0
109;26.11.2016;2016;11;06;Lauantai;3;2;5;1;0;1
109;26.11.2016;2016;11;07;Lauantai;2;1;3;3;1;4
109;26.11.2016;2016;11;08;Lauantai;3;0;3;2;1;3
109;26.11.2016;2016;11;09;Lauantai;4;4;8;2;1;3
109;26.11.2016;2016;11;10;Lauantai;3;3;6;5;4;9
109;26.11.2016;2016;11;11;Lauantai;3;0;3;7;4;11
109;26.11.2016;2016;11;12;Lauantai;6;4;10;2;3;5
109;26.11.2016;2016;11;13;Lauantai;6;3;9;7;3;10
109;26.11.2016;2016;11;14;Lauantai;5;1;6;2;0;2
109;26.11.2016;2016;11;15;Lauantai;7;4;11;1;0;1
109;26.11.2016;2016;11;16;Lauantai;3;2;5;0;6;6
109;26.11.2016;2016;11;17;Lauantai;4;2;6;2;1;3
109;26.11.2016;2016;11;18;Lauantai;5;1;6;1;1;2
109;26.11.2016;2016;11;19;Lauantai;2;1;3;1;1;2
109;26.11.2016;2016;11;20;Lauantai;5;2;7;2;0;2
109;26.11.2016;2016;11;21;Lauantai;3;3;6;1;3;4
109;26.11.2016;2016;11;22;Lauantai;4;2;6;1;3;4
109;26.11.2016;2016;11;23;Lauantai;1;0;1;2;0;2
109;27.11.2016;2016;11;00;Sunnuntai;0;0;0;1;0;1
109;27.11.2016;2016;11;01;Sunnuntai;1;0;1;0;0;0
109;27.11.2016;2016;11;02;Sunnuntai;0;0;0;0;0;0
109;27.11.2016;2016;11;03;Sunnuntai;0;0;0;0;0;0
109;27.11.2016;2016;11;04;Sunnuntai;3;1;4;0;0;0
109;27.11.2016;2016;11;05;Sunnuntai;2;1;3;0;0;0
109;27.11.2016;2016;11;06;Sunnuntai;2;0;2;1;0;1
109;27.11.2016;2016;11;07;Sunnuntai;3;1;4;1;1;2
109;27.11.2016;2016;11;08;Sunnuntai;3;2;5;5;4;9
109;27.11.2016;2016;11;09;Sunnuntai;5;4;9;6;3;9
109;27.11.2016;2016;11;10;Sunnuntai;4;2;6;6;6;12
109;27.11.2016;2016;11;11;Sunnuntai;7;3;10;4;2;6
109;27.11.2016;2016;11;12;Sunnuntai;5;2;7;9;5;14
109;27.11.2016;2016;11;13;Sunnuntai;7;5;12;1;7;8
109;27.11.2016;2016;11;14;Sunnuntai;6;5;11;7;0;7
109;27.11.2016;2016;11;15;Sunnuntai;5;3;8;6;5;11
109;27.11.2016;2016;11;16;Sunnuntai;5;3;8;7;1;8
109;27.11.2016;2016;11;17;Sunnuntai;4;2;6;10;3;13
109;27.11.2016;2016;11;18;Sunnuntai;7;4;11;5;5;10
109;27.11.2016;2016;11;19;Sunnuntai;3;1;4;4;2;6
109;27.11.2016;2016;11;20;Sunnuntai;3;0;3;1;2;3
109;27.11.2016;2016;11;21;Sunnuntai;5;2;7;0;2;2
109;27.11.2016;2016;11;22;Sunnuntai;0;0;0;1;3;4
109;27.11.2016;2016;11;23;Sunnuntai;0;0;0;1;0;1
109;28.11.2016;2016;11;00;Maanantai;1;0;1;0;0;0
109;28.11.2016;2016;11;01;Maanantai;0;0;0;0;0;0
109;28.11.2016;2016;11;02;Maanantai;1;0;1;0;0;0
109;28.11.2016;2016;11;03;Maanantai;1;0;1;0;0;0
109;28.11.2016;2016;11;04;Maanantai;0;0;0;0;0;0
109;28.11.2016;2016;11;05;Maanantai;5;3;8;0;0;0
109;28.11.2016;2016;11;06;Maanantai;17;15;32;0;0;0
109;28.11.2016;2016;11;07;Maanantai;40;39;79;2;2;4
109;28.11.2016;2016;11;08;Maanantai;21;19;40;1;1;2
109;28.11.2016;2016;11;09;Maanantai;15;11;26;1;1;2
109;28.11.2016;2016;11;10;Maanantai;5;4;9;4;4;8
109;28.11.2016;2016;11;11;Maanantai;11;9;20;2;2;4
109;28.11.2016;2016;11;12;Maanantai;13;10;23;0;0;0
109;28.11.2016;2016;11;13;Maanantai;15;11;26;2;2;4
109;28.11.2016;2016;11;14;Maanantai;14;13;27;0;0;0
109;28.11.2016;2016;11;15;Maanantai;25;24;49;2;2;4
109;28.11.2016;2016;11;16;Maanantai;32;31;63;2;2;4
109;28.11.2016;2016;11;17;Maanantai;14;13;27;0;0;0
109;28.11.2016;2016;11;18;Maanantai;10;10;20;2;2;4
109;28.11.2016;2016;11;19;Maanantai;6;4;10;1;1;2
109;28.11.2016;2016;11;20;Maanantai;4;3;7;1;1;2
109;28.11.2016;2016;11;21;Maanantai;6;4;10;1;1;2
109;28.11.2016;2016;11;22;Maanantai;4;2;6;1;1;2
109;28.11.2016;2016;11;23;Maanantai;0;0;0;0;0;0
109;29.11.2016;2016;11;00;Tiistai;0;0;0;0;0;0
109;29.11.2016;2016;11;01;Tiistai;0;0;0;0;0;0
109;29.11.2016;2016;11;02;Tiistai;0;0;0;0;0;0
109;29.11.2016;2016;11;03;Tiistai;0;0;0;0;0;0
109;29.11.2016;2016;11;04;Tiistai;1;0;1;1;0;1
109;29.11.2016;2016;11;05;Tiistai;4;2;6;0;0;0
109;29.11.2016;2016;11;06;Tiistai;15;12;27;0;0;0
109;29.11.2016;2016;11;07;Tiistai;44;43;87;2;0;2
109;29.11.2016;2016;11;08;Tiistai;31;27;58;0;0;0
109;29.11.2016;2016;11;09;Tiistai;9;8;17;0;1;1
109;29.11.2016;2016;11;10;Tiistai;8;6;14;0;0;0
109;29.11.2016;2016;11;11;Tiistai;10;2;12;4;0;4
109;29.11.2016;2016;11;12;Tiistai;11;7;18;0;1;1
109;29.11.2016;2016;11;13;Tiistai;7;14;21;4;0;4
109;29.11.2016;2016;11;14;Tiistai;14;13;27;9;0;9
109;29.11.2016;2016;11;15;Tiistai;32;23;55;3;1;4
109;29.11.2016;2016;11;16;Tiistai;38;35;73;6;1;7
109;29.11.2016;2016;11;17;Tiistai;16;16;32;3;2;5
109;29.11.2016;2016;11;18;Tiistai;12;8;20;3;0;3
109;29.11.2016;2016;11;19;Tiistai;10;7;17;4;3;7
109;29.11.2016;2016;11;20;Tiistai;4;2;6;2;2;4
109;29.11.2016;2016;11;21;Tiistai;5;3;8;3;4;7
109;29.11.2016;2016;11;22;Tiistai;4;3;7;0;0;0
109;29.11.2016;2016;11;23;Tiistai;2;1;3;0;0;0
109;30.11.2016;2016;11;00;Keskiviikko;1;1;2;0;0;0
109;30.11.2016;2016;11;01;Keskiviikko;0;0;0;0;0;0
109;30.11.2016;2016;11;02;Keskiviikko;1;0;1;0;0;0
109;30.11.2016;2016;11;03;Keskiviikko;0;0;0;0;0;0
109;30.11.2016;2016;11;04;Keskiviikko;2;2;4;1;0;1
109;30.11.2016;2016;11;05;Keskiviikko;3;2;5;0;0;0
109;30.11.2016;2016;11;06;Keskiviikko;17;12;29;0;0;0
109;30.11.2016;2016;11;07;Keskiviikko;59;25;84;2;0;2
109;30.11.2016;2016;11;08;Keskiviikko;33;12;45;0;0;0
109;30.11.2016;2016;11;09;Keskiviikko;12;2;14;0;1;1
109;30.11.2016;2016;11;10;Keskiviikko;7;2;9;0;0;0
109;30.11.2016;2016;11;11;Keskiviikko;13;12;25;4;0;4
109;30.11.2016;2016;11;12;Keskiviikko;12;7;19;0;1;1
109;30.11.2016;2016;11;13;Keskiviikko;8;14;22;4;0;4
109;30.11.2016;2016;11;14;Keskiviikko;19;17;36;9;0;9
109;30.11.2016;2016;11;15;Keskiviikko;16;29;45;3;1;4
109;30.11.2016;2016;11;16;Keskiviikko;27;47;74;6;1;7
109;30.11.2016;2016;11;17;Keskiviikko;15;21;36;3;2;5
109;30.11.2016;2016;11;18;Keskiviikko;10;5;15;3;0;3
109;30.11.2016;2016;11;19;Keskiviikko;6;4;10;4;3;7
109;30.11.2016;2016;11;20;Keskiviikko;8;6;14;2;2;4
109;30.11.2016;2016;11;21;Keskiviikko;3;3;6;3;4;7
109;30.11.2016;2016;11;22;Keskiviikko;5;0;5;0;0;0
109;30.11.2016;2016;11;23;Keskiviikko;1;2;3;0;0;0
109;01.12.2016;2016;12;00;Torstai;0;0;0;0;1;1
109;01.12.2016;2016;12;01;Torstai;0;1;1;0;0;0
109;01.12.2016;2016;12;02;Torstai;0;0;0;0;0;0
109;01.12.2016;2016;12;03;Torstai;0;0;0;0;0;0
109;01.12.2016;2016;12;04;Torstai;0;1;1;0;0;0
109;01.12.2016;2016;12;05;Torstai;5;3;8;0;0;0
109;01.12.2016;2016;12;06;Torstai;19;12;31;3;2;5
109;01.12.2016;2016;12;07;Torstai;71;16;87;3;3;6
109;01.12.2016;2016;12;08;Torstai;26;9;35;2;0;2
109;01.12.2016;2016;12;09;Torstai;23;2;25;3;0;3
109;01.12.2016;2016;12;10;Torstai;11;3;14;0;1;1
109;01.12.2016;2016;12;11;Torstai;16;4;20;1;1;2
109;01.12.2016;2016;12;12;Torstai;14;6;20;0;0;0
109;01.12.2016;2016;12;13;Torstai;2;7;9;1;0;1
109;01.12.2016;2016;12;14;Torstai;18;14;32;2;0;2
109;01.12.2016;2016;12;15;Torstai;22;22;44;4;0;4
109;01.12.2016;2016;12;16;Torstai;28;34;62;2;0;2
109;01.12.2016;2016;12;17;Torstai;18;14;32;5;1;6
109;01.12.2016;2016;12;18;Torstai;12;8;20;1;1;2
109;01.12.2016;2016;12;19;Torstai;2;7;9;4;1;5
109;01.12.2016;2016;12;20;Torstai;5;4;9;3;3;6
109;01.12.2016;2016;12;21;Torstai;5;6;11;2;0;2
109;01.12.2016;2016;12;22;Torstai;7;1;8;0;0;0
109;01.12.2016;2016;12;23;Torstai;1;0;1;0;0;0
109;02.12.2016;2016;12;00;Perjantai;1;0;1;0;0;0
109;02.12.2016;2016;12;01;Perjantai;0;0;0;0;0;0
109;02.12.2016;2016;12;02;Perjantai;0;1;1;0;1;1
109;02.12.2016;2016;12;03;Perjantai;0;0;0;1;0;1
109;02.12.2016;2016;12;04;Perjantai;0;1;1;0;0;0
109;02.12.2016;2016;12;05;Perjantai;4;3;7;3;0;3
109;02.12.2016;2016;12;06;Perjantai;20;12;32;3;0;3
109;02.12.2016;2016;12;07;Perjantai;57;16;73;7;1;8
109;02.12.2016;2016;12;08;Perjantai;23;8;31;0;2;2
109;02.12.2016;2016;12;09;Perjantai;15;5;20;0;1;1
109;02.12.2016;2016;12;10;Perjantai;7;7;14;3;2;5
109;02.12.2016;2016;12;11;Perjantai;9;3;12;3;1;4
109;02.12.2016;2016;12;12;Perjantai;16;5;21;2;0;2
109;02.12.2016;2016;12;13;Perjantai;15;6;21;2;0;2
109;02.12.2016;2016;12;14;Perjantai;19;16;35;1;1;2
109;02.12.2016;2016;12;15;Perjantai;26;18;44;1;0;1
109;02.12.2016;2016;12;16;Perjantai;29;24;53;1;1;2
109;02.12.2016;2016;12;17;Perjantai;10;7;17;2;1;3
109;02.12.2016;2016;12;18;Perjantai;6;3;9;4;0;4
109;02.12.2016;2016;12;19;Perjantai;5;1;6;0;1;1
109;02.12.2016;2016;12;20;Perjantai;1;0;1;0;0;0
109;02.12.2016;2016;12;21;Perjantai;3;3;6;1;0;1
109;02.12.2016;2016;12;22;Perjantai;6;1;7;1;0;1
109;02.12.2016;2016;12;23;Perjantai;0;1;1;0;0;0
109;03.12.2016;2016;12;00;Lauantai;1;0;1;0;0;0
109;03.12.2016;2016;12;01;Lauantai;0;0;0;0;0;0
109;03.12.2016;2016;12;02;Lauantai;0;1;1;0;0;0
109;03.12.2016;2016;12;03;Lauantai;2;0;2;1;0;1
109;03.12.2016;2016;12;04;Lauantai;0;0;0;0;0;0
109;03.12.2016;2016;12;05;Lauantai;1;1;2;0;0;0
109;03.12.2016;2016;12;06;Lauantai;4;0;4;0;1;1
109;03.12.2016;2016;12;07;Lauantai;2;0;2;0;0;0
109;03.12.2016;2016;12;08;Lauantai;0;1;1;1;1;2
109;03.12.2016;2016;12;09;Lauantai;5;1;6;0;0;0
109;03.12.2016;2016;12;10;Lauantai;6;4;10;0;0;0
109;03.12.2016;2016;12;11;Lauantai;0;1;1;1;1;2
109;03.12.2016;2016;12;12;Lauantai;2;1;3;6;1;7
109;03.12.2016;2016;12;13;Lauantai;5;4;9;1;0;1
109;03.12.2016;2016;12;14;Lauantai;7;1;8;3;1;4
109;03.12.2016;2016;12;15;Lauantai;6;2;8;2;0;2
109;03.12.2016;2016;12;16;Lauantai;2;1;3;2;0;2
109;03.12.2016;2016;12;17;Lauantai;2;5;7;1;0;1
109;03.12.2016;2016;12;18;Lauantai;1;1;2;4;1;5
109;03.12.2016;2016;12;19;Lauantai;2;2;4;2;0;2
109;03.12.2016;2016;12;20;Lauantai;1;0;1;1;0;1
109;03.12.2016;2016;12;21;Lauantai;1;3;4;3;1;4
109;03.12.2016;2016;12;22;Lauantai;0;0;0;1;0;1
109;03.12.2016;2016;12;23;Lauantai;0;0;0;0;0;0
109;04.12.2016;2016;12;00;Sunnuntai;0;0;0;0;0;0
109;04.12.2016;2016;12;01;Sunnuntai;0;0;0;0;0;0
109;04.12.2016;2016;12;02;Sunnuntai;0;1;1;0;0;0
109;04.12.2016;2016;12;03;Sunnuntai;0;2;2;0;0;0
109;04.12.2016;2016;12;04;Sunnuntai;2;0;2;0;0;0
109;04.12.2016;2016;12;05;Sunnuntai;0;0;0;0;0;0
109;04.12.2016;2016;12;06;Sunnuntai;1;0;1;1;0;1
109;04.12.2016;2016;12;07;Sunnuntai;1;0;1;0;0;0
109;04.12.2016;2016;12;08;Sunnuntai;0;0;0;0;1;1
109;04.12.2016;2016;12;09;Sunnuntai;1;1;2;0;1;1
109;04.12.2016;2016;12;10;Sunnuntai;6;2;8;2;1;3
109;04.12.2016;2016;12;11;Sunnuntai;5;2;7;4;1;5
109;04.12.2016;2016;12;12;Sunnuntai;4;1;5;1;0;1
109;04.12.2016;2016;12;13;Sunnuntai;5;4;9;2;0;2
109;04.12.2016;2016;12;14;Sunnuntai;4;4;8;0;0;0
109;04.12.2016;2016;12;15;Sunnuntai;3;3;6;0;0;0
109;04.12.2016;2016;12;16;Sunnuntai;7;4;11;0;0;0
109;04.12.2016;2016;12;17;Sunnuntai;2;2;4;0;0;0
109;04.12.2016;2016;12;18;Sunnuntai;2;0;2;0;0;0
109;04.12.2016;2016;12;19;Sunnuntai;2;2;4;0;0;0
109;04.12.2016;2016;12;20;Sunnuntai;1;0;1;0;0;0
109;04.12.2016;2016;12;21;Sunnuntai;4;1;5;0;0;0
109;04.12.2016;2016;12;22;Sunnuntai;0;0;0;0;0;0
109;04.12.2016;2016;12;23;Sunnuntai;0;0;0;0;0;0
109;05.12.2016;2016;12;00;Maanantai;0;0;0;0;0;0
109;05.12.2016;2016;12;01;Maanantai;1;0;1;0;0;0
109;05.12.2016;2016;12;02;Maanantai;1;0;1;0;0;0
109;05.12.2016;2016;12;03;Maanantai;0;0;0;0;0;0
109;05.12.2016;2016;12;04;Maanantai;0;0;0;0;0;0
109;05.12.2016;2016;12;05;Maanantai;4;1;5;0;0;0
109;05.12.2016;2016;12;06;Maanantai;11;9;20;0;0;0
109;05.12.2016;2016;12;07;Maanantai;19;17;36;2;2;4
109;05.12.2016;2016;12;08;Maanantai;11;8;19;1;1;2
109;05.12.2016;2016;12;09;Maanantai;7;5;12;1;1;2
109;05.12.2016;2016;12;10;Maanantai;6;4;10;4;4;8
109;05.12.2016;2016;12;11;Maanantai;5;3;8;2;2;4
109;05.12.2016;2016;12;12;Maanantai;7;5;12;0;0;0
109;05.12.2016;2016;12;13;Maanantai;7;4;11;2;2;4
109;05.12.2016;2016;12;14;Maanantai;11;9;20;0;0;0
109;05.12.2016;2016;12;15;Maanantai;18;15;33;2;2;4
109;05.12.2016;2016;12;16;Maanantai;16;14;30;2;2;4
109;05.12.2016;2016;12;17;Maanantai;8;7;15;0;0;0
109;05.12.2016;2016;12;18;Maanantai;4;3;7;2;2;4
109;05.12.2016;2016;12;19;Maanantai;4;1;5;1;1;2
109;05.12.2016;2016;12;20;Maanantai;3;2;5;1;1;2
109;05.12.2016;2016;12;21;Maanantai;4;3;7;1;1;2
109;05.12.2016;2016;12;22;Maanantai;2;2;4;1;1;2
109;05.12.2016;2016;12;23;Maanantai;2;0;2;0;0;0
109;06.12.2016;2016;12;00;Tiistai;3;2;5;0;0;0
109;06.12.2016;2016;12;01;Tiistai;0;0;0;0;0;0
109;06.12.2016;2016;12;02;Tiistai;0;0;0;0;0;0
109;06.12.2016;2016;12;03;Tiistai;0;0;0;0;0;0
109;06.12.2016;2016;12;04;Tiistai;1;1;2;0;0;0
109;06.12.2016;2016;12;05;Tiistai;1;0;1;0;0;0
109;06.12.2016;2016;12;06;Tiistai;2;2;4;0;0;0
109;06.12.2016;2016;12;07;Tiistai;2;2;4;0;0;0
109;06.12.2016;2016;12;08;Tiistai;0;0;0;0;0;0
109;06.12.2016;2016;12;09;Tiistai;4;1;5;1;1;2
109;06.12.2016;2016;12;10;Tiistai;1;0;1;0;0;0
109;06.12.2016;2016;12;11;Tiistai;1;1;2;0;0;0
109;06.12.2016;2016;12;12;Tiistai;3;1;4;1;1;2
109;06.12.2016;2016;12;13;Tiistai;5;3;8;0;0;0
109;06.12.2016;2016;12;14;Tiistai;6;3;9;0;0;0
109;06.12.2016;2016;12;15;Tiistai;3;1;4;1;1;2
109;06.12.2016;2016;12;16;Tiistai;2;0;2;1;1;2
109;06.12.2016;2016;12;17;Tiistai;1;0;1;2;2;4
109;06.12.2016;2016;12;18;Tiistai;1;0;1;0;0;0
109;06.12.2016;2016;12;19;Tiistai;1;0;1;3;3;6
109;06.12.2016;2016;12;20;Tiistai;4;3;7;2;2;4
109;06.12.2016;2016;12;21;Tiistai;4;1;5;4;4;8
109;06.12.2016;2016;12;22;Tiistai;0;0;0;0;0;0
109;06.12.2016;2016;12;23;Tiistai;1;0;1;0;0;0
109;07.12.2016;2016;12;00;Keskiviikko;0;0;0;0;0;0
109;07.12.2016;2016;12;01;Keskiviikko;1;0;1;0;0;0
109;07.12.2016;2016;12;02;Keskiviikko;0;0;0;0;0;0
109;07.12.2016;2016;12;03;Keskiviikko;0;0;0;0;0;0
109;07.12.2016;2016;12;04;Keskiviikko;3;0;3;0;0;0
109;07.12.2016;2016;12;05;Keskiviikko;5;3;8;0;0;0
109;07.12.2016;2016;12;06;Keskiviikko;14;13;27;0;0;0
109;07.12.2016;2016;12;07;Keskiviikko;48;26;74;5;0;5
109;07.12.2016;2016;12;08;Keskiviikko;47;0;47;7;0;7
109;07.12.2016;2016;12;09;Keskiviikko;18;0;18;1;0;1
109;07.12.2016;2016;12;10;Keskiviikko;21;1;22;3;0;3
109;07.12.2016;2016;12;11;Keskiviikko;12;8;20;3;0;3
109;07.12.2016;2016;12;12;Keskiviikko;12;6;18;1;0;1
109;07.12.2016;2016;12;13;Keskiviikko;9;16;25;2;2;4
109;07.12.2016;2016;12;14;Keskiviikko;4;27;31;5;2;7
109;07.12.2016;2016;12;15;Keskiviikko;15;35;50;5;9;14
109;07.12.2016;2016;12;16;Keskiviikko;24;46;70;5;4;9
109;07.12.2016;2016;12;17;Keskiviikko;5;20;25;6;3;9
109;07.12.2016;2016;12;18;Keskiviikko;6;20;26;2;2;4
109;07.12.2016;2016;12;19;Keskiviikko;7;5;12;9;7;16
109;07.12.2016;2016;12;20;Keskiviikko;4;7;11;6;1;7
109;07.12.2016;2016;12;21;Keskiviikko;8;8;16;2;2;4
109;07.12.2016;2016;12;22;Keskiviikko;7;5;12;1;1;2
109;07.12.2016;2016;12;23;Keskiviikko;0;0;0;0;0;0
109;08.12.2016;2016;12;00;Torstai;0;0;0;2;0;2
109;08.12.2016;2016;12;01;Torstai;0;0;0;0;0;0
109;08.12.2016;2016;12;02;Torstai;0;0;0;0;0;0
109;08.12.2016;2016;12;03;Torstai;1;0;1;0;0;0
109;08.12.2016;2016;12;04;Torstai;0;1;1;1;1;2
109;08.12.2016;2016;12;05;Torstai;3;4;7;0;0;0
109;08.12.2016;2016;12;06;Torstai;15;16;31;1;0;1
109;08.12.2016;2016;12;07;Torstai;67;22;89;8;4;12
109;08.12.2016;2016;12;08;Torstai;43;8;51;3;4;7
109;08.12.2016;2016;12;09;Torstai;18;10;28;3;0;3
109;08.12.2016;2016;12;10;Torstai;9;1;10;1;2;3
109;08.12.2016;2016;12;11;Torstai;9;8;17;1;1;2
109;08.12.2016;2016;12;12;Torstai;10;9;19;4;3;7
109;08.12.2016;2016;12;13;Torstai;4;9;13;3;2;5
109;08.12.2016;2016;12;14;Torstai;8;20;28;4;3;7
109;08.12.2016;2016;12;15;Torstai;15;36;51;6;5;11
109;08.12.2016;2016;12;16;Torstai;17;48;65;5;3;8
109;08.12.2016;2016;12;17;Torstai;8;20;28;4;3;7
109;08.12.2016;2016;12;18;Torstai;5;13;18;1;3;4
109;08.12.2016;2016;12;19;Torstai;1;8;9;8;3;11
109;08.12.2016;2016;12;20;Torstai;6;6;12;2;4;6
109;08.12.2016;2016;12;21;Torstai;5;3;8;1;3;4
109;08.12.2016;2016;12;22;Torstai;5;2;7;1;1;2
109;08.12.2016;2016;12;23;Torstai;0;1;1;1;1;2
109;09.12.2016;2016;12;00;Perjantai;0;0;0;3;0;3
109;09.12.2016;2016;12;01;Perjantai;1;0;1;0;0;0
109;09.12.2016;2016;12;02;Perjantai;0;0;0;0;0;0
109;09.12.2016;2016;12;03;Perjantai;0;0;0;0;0;0
109;09.12.2016;2016;12;04;Perjantai;0;1;1;0;0;0
109;09.12.2016;2016;12;05;Perjantai;4;6;10;1;1;2
109;09.12.2016;2016;12;06;Perjantai;14;13;27;1;3;4
109;09.12.2016;2016;12;07;Perjantai;53;17;70;6;2;8
109;09.12.2016;2016;12;08;Perjantai;34;9;43;2;3;5
109;09.12.2016;2016;12;09;Perjantai;20;8;28;1;1;2
109;09.12.2016;2016;12;10;Perjantai;4;5;9;5;5;10
109;09.12.2016;2016;12;11;Perjantai;13;8;21;1;1;2
109;09.12.2016;2016;12;12;Perjantai;6;7;13;2;5;7
109;09.12.2016;2016;12;13;Perjantai;5;23;28;7;3;10
109;09.12.2016;2016;12;14;Perjantai;22;17;39;1;5;6
109;09.12.2016;2016;12;15;Perjantai;8;27;35;5;6;11
109;09.12.2016;2016;12;16;Perjantai;17;34;51;4;2;6
109;09.12.2016;2016;12;17;Perjantai;2;17;19;1;1;2
109;09.12.2016;2016;12;18;Perjantai;3;4;7;5;1;6
109;09.12.2016;2016;12;19;Perjantai;3;5;8;0;1;1
109;09.12.2016;2016;12;20;Perjantai;3;3;6;1;3;4
109;09.12.2016;2016;12;21;Perjantai;3;5;8;1;1;2
109;09.12.2016;2016;12;22;Perjantai;3;2;5;2;1;3
109;09.12.2016;2016;12;23;Perjantai;1;1;2;0;0;0
109;10.12.2016;2016;12;00;Lauantai;0;0;0;1;0;1
109;10.12.2016;2016;12;01;Lauantai;0;0;0;0;0;0
109;10.12.2016;2016;12;02;Lauantai;0;1;1;0;0;0
109;10.12.2016;2016;12;03;Lauantai;1;1;2;0;0;0
109;10.12.2016;2016;12;04;Lauantai;0;1;1;0;0;0
109;10.12.2016;2016;12;05;Lauantai;2;2;4;0;1;1
109;10.12.2016;2016;12;06;Lauantai;3;1;4;0;0;0
109;10.12.2016;2016;12;07;Lauantai;2;0;2;2;0;2
109;10.12.2016;2016;12;08;Lauantai;0;0;0;2;0;2
109;10.12.2016;2016;12;09;Lauantai;4;1;5;1;2;3
109;10.12.2016;2016;12;10;Lauantai;4;2;6;3;2;5
109;10.12.2016;2016;12;11;Lauantai;5;7;12;5;3;8
109;10.12.2016;2016;12;12;Lauantai;7;1;8;3;3;6
109;10.12.2016;2016;12;13;Lauantai;6;2;8;5;1;6
109;10.12.2016;2016;12;14;Lauantai;7;7;14;5;4;9
109;10.12.2016;2016;12;15;Lauantai;5;6;11;3;2;5
109;10.12.2016;2016;12;16;Lauantai;4;3;7;2;2;4
109;10.12.2016;2016;12;17;Lauantai;2;7;9;0;1;1
109;10.12.2016;2016;12;18;Lauantai;8;2;10;1;5;6
109;10.12.2016;2016;12;19;Lauantai;2;2;4;3;3;6
109;10.12.2016;2016;12;20;Lauantai;3;4;7;3;7;10
109;10.12.2016;2016;12;21;Lauantai;3;6;9;0;1;1
109;10.12.2016;2016;12;22;Lauantai;1;0;1;2;0;2
109;10.12.2016;2016;12;23;Lauantai;0;0;0;1;0;1
109;11.12.2016;2016;12;00;Sunnuntai;4;0;4;0;0;0
109;11.12.2016;2016;12;01;Sunnuntai;0;0;0;0;0;0
109;11.12.2016;2016;12;02;Sunnuntai;0;0;0;0;0;0
109;11.12.2016;2016;12;03;Sunnuntai;0;1;1;1;0;1
109;11.12.2016;2016;12;04;Sunnuntai;0;3;3;0;0;0
109;11.12.2016;2016;12;05;Sunnuntai;1;0;1;0;0;0
109;11.12.2016;2016;12;06;Sunnuntai;2;1;3;1;0;1
109;11.12.2016;2016;12;07;Sunnuntai;0;4;4;2;0;2
109;11.12.2016;2016;12;08;Sunnuntai;2;0;2;0;1;1
109;11.12.2016;2016;12;09;Sunnuntai;0;0;0;1;3;4
109;11.12.2016;2016;12;10;Sunnuntai;0;4;4;3;4;7
109;11.12.2016;2016;12;11;Sunnuntai;6;3;9;4;2;6
109;11.12.2016;2016;12;12;Sunnuntai;6;1;7;5;5;10
109;11.12.2016;2016;12;13;Sunnuntai;1;2;3;9;4;13
109;11.12.2016;2016;12;14;Sunnuntai;2;4;6;2;5;7
109;11.12.2016;2016;12;15;Sunnuntai;1;2;3;2;0;2
109;11.12.2016;2016;12;16;Sunnuntai;3;3;6;3;4;7
109;11.12.2016;2016;12;17;Sunnuntai;9;3;12;3;0;3
109;11.12.2016;2016;12;18;Sunnuntai;2;6;8;2;3;5
109;11.12.2016;2016;12;19;Sunnuntai;1;0;1;7;1;8
109;11.12.2016;2016;12;20;Sunnuntai;2;2;4;3;1;4
109;11.12.2016;2016;12;21;Sunnuntai;2;5;7;2;3;5
109;11.12.2016;2016;12;22;Sunnuntai;2;0;2;1;0;1
109;11.12.2016;2016;12;23;Sunnuntai;0;1;1;1;0;1
109;12.12.2016;2016;12;00;Maanantai;1;0;1;0;0;0
109;12.12.2016;2016;12;01;Maanantai;0;1;1;0;1;1
109;12.12.2016;2016;12;02;Maanantai;0;0;0;0;0;0
109;12.12.2016;2016;12;03;Maanantai;0;1;1;0;0;0
109;12.12.2016;2016;12;04;Maanantai;0;2;2;2;1;3
109;12.12.2016;2016;12;05;Maanantai;2;5;7;0;0;0
109;12.12.2016;2016;12;06;Maanantai;12;9;21;1;0;1
109;12.12.2016;2016;12;07;Maanantai;58;17;75;7;4;11
109;12.12.2016;2016;12;08;Maanantai;40;10;50;5;3;8
109;12.12.2016;2016;12;09;Maanantai;6;3;9;3;2;5
109;12.12.2016;2016;12;10;Maanantai;6;3;9;1;6;7
109;12.12.2016;2016;12;11;Maanantai;11;6;17;0;1;1
109;12.12.2016;2016;12;12;Maanantai;4;3;7;2;0;2
109;12.12.2016;2016;12;13;Maanantai;8;6;14;2;2;4
109;12.12.2016;2016;12;14;Maanantai;6;18;24;8;5;13
109;12.12.2016;2016;12;15;Maanantai;14;32;46;5;5;10
109;12.12.2016;2016;12;16;Maanantai;14;38;52;4;4;8
109;12.12.2016;2016;12;17;Maanantai;8;18;26;4;2;6
109;12.12.2016;2016;12;18;Maanantai;6;7;13;3;1;4
109;12.12.2016;2016;12;19;Maanantai;3;5;8;2;3;5
109;12.12.2016;2016;12;20;Maanantai;3;3;6;2;2;4
109;12.12.2016;2016;12;21;Maanantai;2;5;7;1;0;1
109;12.12.2016;2016;12;22;Maanantai;6;1;7;0;0;0
109;12.12.2016;2016;12;23;Maanantai;0;0;0;0;1;1
109;13.12.2016;2016;12;00;Tiistai;2;0;2;0;0;0
109;13.12.2016;2016;12;01;Tiistai;0;1;1;0;0;0
109;13.12.2016;2016;12;02;Tiistai;0;0;0;0;0;0
109;13.12.2016;2016;12;03;Tiistai;2;0;2;0;0;0
109;13.12.2016;2016;12;04;Tiistai;0;0;0;0;0;0
109;13.12.2016;2016;12;05;Tiistai;0;6;6;0;0;0
109;13.12.2016;2016;12;06;Tiistai;23;11;34;1;1;2
109;13.12.2016;2016;12;07;Tiistai;59;22;81;7;3;10
109;13.12.2016;2016;12;08;Tiistai;32;9;41;3;3;6
109;13.12.2016;2016;12;09;Tiistai;8;4;12;2;1;3
109;13.12.2016;2016;12;10;Tiistai;7;4;11;2;2;4
109;13.12.2016;2016;12;11;Tiistai;8;8;16;2;2;4
109;13.12.2016;2016;12;12;Tiistai;11;5;16;3;2;5
109;13.12.2016;2016;12;13;Tiistai;7;12;19;4;3;7
109;13.12.2016;2016;12;14;Tiistai;13;12;25;3;3;6
109;13.12.2016;2016;12;15;Tiistai;14;33;47;6;1;7
109;13.12.2016;2016;12;16;Tiistai;25;52;77;5;6;11
109;13.12.2016;2016;12;17;Tiistai;9;21;30;3;2;5
109;13.12.2016;2016;12;18;Tiistai;6;6;12;6;4;10
109;13.12.2016;2016;12;19;Tiistai;5;7;12;5;1;6
109;13.12.2016;2016;12;20;Tiistai;4;5;9;2;3;5
109;13.12.2016;2016;12;21;Tiistai;3;10;13;3;0;3
109;13.12.2016;2016;12;22;Tiistai;6;1;7;1;0;1
109;13.12.2016;2016;12;23;Tiistai;0;4;4;0;0;0
109;14.12.2016;2016;12;00;Keskiviikko;2;0;2;0;0;0
109;14.12.2016;2016;12;01;Keskiviikko;0;0;0;0;0;0
109;14.12.2016;2016;12;02;Keskiviikko;0;0;0;1;0;1
109;14.12.2016;2016;12;03;Keskiviikko;0;0;0;0;0;0
109;14.12.2016;2016;12;04;Keskiviikko;0;1;1;1;0;1
109;14.12.2016;2016;12;05;Keskiviikko;2;5;7;0;0;0
109;14.12.2016;2016;12;06;Keskiviikko;22;12;34;1;0;1
109;14.12.2016;2016;12;07;Keskiviikko;62;21;83;8;1;9
109;14.12.2016;2016;12;08;Keskiviikko;35;11;46;5;3;8
109;14.12.2016;2016;12;09;Keskiviikko;12;5;17;1;1;2
109;14.12.2016;2016;12;10;Keskiviikko;9;2;11;4;1;5
109;14.12.2016;2016;12;11;Keskiviikko;9;7;16;8;2;10
109;14.12.2016;2016;12;12;Keskiviikko;10;9;19;1;0;1
109;14.12.2016;2016;12;13;Keskiviikko;4;10;14;1;4;5
109;14.12.2016;2016;12;14;Keskiviikko;8;23;31;6;2;8
109;14.12.2016;2016;12;15;Keskiviikko;18;34;52;6;4;10
109;14.12.2016;2016;12;16;Keskiviikko;28;56;84;6;4;10
109;14.12.2016;2016;12;17;Keskiviikko;8;28;36;6;1;7
109;14.12.2016;2016;12;18;Keskiviikko;8;6;14;8;3;11
109;14.12.2016;2016;12;19;Keskiviikko;8;5;13;4;2;6
109;14.12.2016;2016;12;20;Keskiviikko;6;7;13;1;3;4
109;14.12.2016;2016;12;21;Keskiviikko;4;8;12;1;1;2
109;14.12.2016;2016;12;22;Keskiviikko;3;2;5;0;1;1
109;14.12.2016;2016;12;23;Keskiviikko;0;2;2;1;1;2
109;15.12.2016;2016;12;00;Torstai;2;0;2;0;0;0
109;15.12.2016;2016;12;01;Torstai;0;0;0;0;0;0
109;15.12.2016;2016;12;02;Torstai;0;0;0;0;0;0
109;15.12.2016;2016;12;03;Torstai;0;0;0;0;0;0
109;15.12.2016;2016;12;04;Torstai;0;0;0;1;0;1
109;15.12.2016;2016;12;05;Torstai;2;3;5;1;1;2
109;15.12.2016;2016;12;06;Torstai;23;8;31;2;0;2
109;15.12.2016;2016;12;07;Torstai;69;22;91;7;6;13
109;15.12.2016;2016;12;08;Torstai;38;6;44;2;4;6
109;15.12.2016;2016;12;09;Torstai;9;5;14;3;1;4
109;15.12.2016;2016;12;10;Torstai;10;2;12;7;2;9
109;15.12.2016;2016;12;11;Torstai;10;3;13;3;3;6
109;15.12.2016;2016;12;12;Torstai;15;3;18;4;4;8
109;15.12.2016;2016;12;13;Torstai;7;15;22;6;2;8
109;15.12.2016;2016;12;14;Torstai;8;18;26;2;1;3
109;15.12.2016;2016;12;15;Torstai;24;33;57;3;3;6
109;15.12.2016;2016;12;16;Torstai;21;53;74;4;1;5
109;15.12.2016;2016;12;17;Torstai;7;21;28;2;3;5
109;15.12.2016;2016;12;18;Torstai;6;8;14;7;3;10
109;15.12.2016;2016;12;19;Torstai;4;3;7;6;3;9
109;15.12.2016;2016;12;20;Torstai;2;8;10;4;2;6
109;15.12.2016;2016;12;21;Torstai;5;5;10;3;3;6
109;15.12.2016;2016;12;22;Torstai;6;1;7;0;0;0
109;15.12.2016;2016;12;23;Torstai;0;2;2;0;0;0
109;16.12.2016;2016;12;00;Perjantai;2;0;2;0;0;0
109;16.12.2016;2016;12;01;Perjantai;0;0;0;0;0;0
109;16.12.2016;2016;12;02;Perjantai;0;0;0;0;0;0
109;16.12.2016;2016;12;03;Perjantai;0;0;0;0;0;0
109;16.12.2016;2016;12;04;Perjantai;1;0;1;0;0;0
109;16.12.2016;2016;12;05;Perjantai;5;2;7;0;0;0
109;16.12.2016;2016;12;06;Perjantai;21;13;34;1;0;1
109;16.12.2016;2016;12;07;Perjantai;45;27;72;1;1;2
109;16.12.2016;2016;12;08;Perjantai;33;14;47;0;1;1
109;16.12.2016;2016;12;09;Perjantai;14;7;21;0;0;0
109;16.12.2016;2016;12;10;Perjantai;6;5;11;2;0;2
109;16.12.2016;2016;12;11;Perjantai;9;4;13;1;0;1
109;16.12.2016;2016;12;12;Perjantai;13;9;22;0;0;0
109;16.12.2016;2016;12;13;Perjantai;15;9;24;2;0;2
109;16.12.2016;2016;12;14;Perjantai;20;18;38;1;0;1
109;16.12.2016;2016;12;15;Perjantai;23;22;45;3;0;3
109;16.12.2016;2016;12;16;Perjantai;30;26;56;1;0;1
109;16.12.2016;2016;12;17;Perjantai;12;14;26;2;0;2
109;16.12.2016;2016;12;18;Perjantai;7;1;8;0;0;0
109;16.12.2016;2016;12;19;Perjantai;10;4;14;4;0;4
109;16.12.2016;2016;12;20;Perjantai;10;3;13;1;0;1
109;16.12.2016;2016;12;21;Perjantai;9;2;11;0;0;0
109;16.12.2016;2016;12;22;Perjantai;4;2;6;0;0;0
109;16.12.2016;2016;12;23;Perjantai;3;1;4;0;0;0
109;17.12.2016;2016;12;00;Lauantai;2;1;3;0;0;0
109;17.12.2016;2016;12;01;Lauantai;2;1;3;1;0;1
109;17.12.2016;2016;12;02;Lauantai;1;0;1;0;0;0
109;17.12.2016;2016;12;03;Lauantai;1;0;1;0;0;0
109;17.12.2016;2016;12;04;Lauantai;2;1;3;0;0;0
109;17.12.2016;2016;12;05;Lauantai;1;0;1;0;0;0
109;17.12.2016;2016;12;06;Lauantai;3;2;5;0;0;0
109;17.12.2016;2016;12;07;Lauantai;2;0;2;0;0;0
109;17.12.2016;2016;12;08;Lauantai;1;1;2;0;1;1
109;17.12.2016;2016;12;09;Lauantai;4;2;6;1;0;1
109;17.12.2016;2016;12;10;Lauantai;4;1;5;1;0;1
109;17.12.2016;2016;12;11;Lauantai;6;3;9;0;0;0
109;17.12.2016;2016;12;12;Lauantai;11;6;17;1;0;1
109;17.12.2016;2016;12;13;Lauantai;6;4;10;2;0;2
109;17.12.2016;2016;12;14;Lauantai;5;2;7;0;0;0
109;17.12.2016;2016;12;15;Lauantai;5;3;8;3;1;4
109;17.12.2016;2016;12;16;Lauantai;3;5;8;2;0;2
109;17.12.2016;2016;12;17;Lauantai;3;8;11;3;3;6
109;17.12.2016;2016;12;18;Lauantai;6;1;7;0;0;0
109;17.12.2016;2016;12;19;Lauantai;1;4;5;3;0;3
109;17.12.2016;2016;12;20;Lauantai;7;1;8;2;2;4
109;17.12.2016;2016;12;21;Lauantai;3;3;6;1;1;2
109;17.12.2016;2016;12;22;Lauantai;1;1;2;1;1;2
109;17.12.2016;2016;12;23;Lauantai;1;0;1;1;0;1
109;18.12.2016;2016;12;00;Sunnuntai;2;1;3;0;0;0
109;18.12.2016;2016;12;01;Sunnuntai;0;0;0;0;0;0
109;18.12.2016;2016;12;02;Sunnuntai;0;3;3;0;0;0
109;18.12.2016;2016;12;03;Sunnuntai;1;0;1;0;0;0
109;18.12.2016;2016;12;04;Sunnuntai;0;0;0;1;0;1
109;18.12.2016;2016;12;05;Sunnuntai;0;1;1;0;0;0
109;18.12.2016;2016;12;06;Sunnuntai;3;2;5;1;0;1
109;18.12.2016;2016;12;07;Sunnuntai;1;1;2;1;1;2
109;18.12.2016;2016;12;08;Sunnuntai;1;0;1;1;0;1
109;18.12.2016;2016;12;09;Sunnuntai;3;0;3;0;0;0
109;18.12.2016;2016;12;10;Sunnuntai;4;3;7;6;3;9
109;18.12.2016;2016;12;11;Sunnuntai;4;3;7;1;0;1
109;18.12.2016;2016;12;12;Sunnuntai;10;1;11;5;3;8
109;18.12.2016;2016;12;13;Sunnuntai;5;6;11;4;2;6
109;18.12.2016;2016;12;14;Sunnuntai;3;1;4;3;1;4
109;18.12.2016;2016;12;15;Sunnuntai;6;5;11;5;0;5
109;18.12.2016;2016;12;16;Sunnuntai;6;8;14;3;2;5
109;18.12.2016;2016;12;17;Sunnuntai;4;6;10;5;0;5
109;18.12.2016;2016;12;18;Sunnuntai;2;3;5;3;1;4
109;18.12.2016;2016;12;19;Sunnuntai;4;5;9;1;3;4
109;18.12.2016;2016;12;20;Sunnuntai;1;4;5;5;0;5
109;18.12.2016;2016;12;21;Sunnuntai;2;3;5;1;0;1
109;18.12.2016;2016;12;22;Sunnuntai;0;1;1;0;0;0
109;18.12.2016;2016;12;23;Sunnuntai;0;1;1;0;0;0
109;19.12.2016;2016;12;00;Maanantai;0;1;1;0;0;0
109;19.12.2016;2016;12;01;Maanantai;0;0;0;0;0;0
109;19.12.2016;2016;12;02;Maanantai;0;0;0;0;0;0
109;19.12.2016;2016;12;03;Maanantai;0;0;0;0;0;0
109;19.12.2016;2016;12;04;Maanantai;0;0;0;0;0;0
109;19.12.2016;2016;12;05;Maanantai;2;3;5;2;0;2
109;19.12.2016;2016;12;06;Maanantai;19;11;30;2;1;3
109;19.12.2016;2016;12;07;Maanantai;63;16;79;7;2;9
109;19.12.2016;2016;12;08;Maanantai;27;6;33;1;2;3
109;19.12.2016;2016;12;09;Maanantai;13;5;18;2;0;2
109;19.12.2016;2016;12;10;Maanantai;17;3;20;4;0;4
109;19.12.2016;2016;12;11;Maanantai;10;6;16;3;1;4
109;19.12.2016;2016;12;12;Maanantai;14;6;20;1;2;3
109;19.12.2016;2016;12;13;Maanantai;9;15;24;8;1;9
109;19.12.2016;2016;12;14;Maanantai;10;13;23;6;2;8
109;19.12.2016;2016;12;15;Maanantai;21;20;41;6;2;8
109;19.12.2016;2016;12;16;Maanantai;28;50;78;6;0;6
109;19.12.2016;2016;12;17;Maanantai;16;15;31;1;2;3
109;19.12.2016;2016;12;18;Maanantai;7;9;16;6;1;7
109;19.12.2016;2016;12;19;Maanantai;5;5;10;4;0;4
109;19.12.2016;2016;12;20;Maanantai;4;5;9;3;1;4
109;19.12.2016;2016;12;21;Maanantai;5;3;8;3;1;4
109;19.12.2016;2016;12;22;Maanantai;2;0;2;1;0;1
109;19.12.2016;2016;12;23;Maanantai;0;0;0;0;0;0
109;20.12.2016;2016;12;00;Tiistai;3;0;3;0;0;0
109;20.12.2016;2016;12;01;Tiistai;0;0;0;0;0;0
109;20.12.2016;2016;12;02;Tiistai;0;0;0;0;0;0
109;20.12.2016;2016;12;03;Tiistai;0;0;0;0;0;0
109;20.12.2016;2016;12;04;Tiistai;2;1;3;3;0;3
109;20.12.2016;2016;12;05;Tiistai;1;4;5;1;1;2
109;20.12.2016;2016;12;06;Tiistai;16;7;23;3;3;6
109;20.12.2016;2016;12;07;Tiistai;36;12;48;4;2;6
109;20.12.2016;2016;12;08;Tiistai;24;5;29;2;0;2
109;20.12.2016;2016;12;09;Tiistai;10;0;10;2;1;3
109;20.12.2016;2016;12;10;Tiistai;5;0;5;1;3;4
109;20.12.2016;2016;12;11;Tiistai;11;5;16;2;0;2
109;20.12.2016;2016;12;12;Tiistai;12;1;13;1;2;3
109;20.12.2016;2016;12;13;Tiistai;4;5;9;3;0;3
109;20.12.2016;2016;12;14;Tiistai;3;11;14;1;2;3
109;20.12.2016;2016;12;15;Tiistai;11;15;26;3;1;4
109;20.12.2016;2016;12;16;Tiistai;14;31;45;6;0;6
109;20.12.2016;2016;12;17;Tiistai;6;11;17;4;0;4
109;20.12.2016;2016;12;18;Tiistai;3;4;7;3;1;4
109;20.12.2016;2016;12;19;Tiistai;4;1;5;5;4;9
109;20.12.2016;2016;12;20;Tiistai;5;4;9;6;2;8
109;20.12.2016;2016;12;21;Tiistai;1;3;4;1;0;1
109;20.12.2016;2016;12;22;Tiistai;10;12;22;7;3;10
109;20.12.2016;2016;12;23;Tiistai;2;0;2;5;1;6
109;21.12.2016;2016;12;00;Keskiviikko;0;0;0;0;0;0
109;21.12.2016;2016;12;01;Keskiviikko;0;0;0;0;0;0
109;21.12.2016;2016;12;02;Keskiviikko;0;0;0;0;0;0
109;21.12.2016;2016;12;03;Keskiviikko;0;0;0;0;0;0
109;21.12.2016;2016;12;04;Keskiviikko;0;0;0;0;0;0
109;21.12.2016;2016;12;05;Keskiviikko;2;5;7;0;0;0
109;21.12.2016;2016;12;06;Keskiviikko;13;10;23;3;2;5
109;21.12.2016;2016;12;07;Keskiviikko;41;17;58;5;5;10
109;21.12.2016;2016;12;08;Keskiviikko;29;5;34;2;3;5
109;21.12.2016;2016;12;09;Keskiviikko;8;5;13;0;1;1
109;21.12.2016;2016;12;10;Keskiviikko;3;4;7;2;4;6
109;21.12.2016;2016;12;11;Keskiviikko;8;5;13;1;1;2
109;21.12.2016;2016;12;12;Keskiviikko;9;8;17;2;0;2
109;21.12.2016;2016;12;13;Keskiviikko;5;4;9;5;4;9
109;21.12.2016;2016;12;14;Keskiviikko;11;15;26;4;6;10
109;21.12.2016;2016;12;15;Keskiviikko;13;14;27;3;4;7
109;21.12.2016;2016;12;16;Keskiviikko;14;34;48;5;1;6
109;21.12.2016;2016;12;17;Keskiviikko;9;15;24;1;4;5
109;21.12.2016;2016;12;18;Keskiviikko;6;7;13;8;2;10
109;21.12.2016;2016;12;19;Keskiviikko;8;4;12;4;3;7
109;21.12.2016;2016;12;20;Keskiviikko;6;4;10;7;2;9
109;21.12.2016;2016;12;21;Keskiviikko;5;7;12;4;6;10
109;21.12.2016;2016;12;22;Keskiviikko;3;1;4;0;0;0
109;21.12.2016;2016;12;23;Keskiviikko;1;1;2;1;1;2
109;22.12.2016;2016;12;00;Torstai;0;2;2;0;2;2
109;22.12.2016;2016;12;01;Torstai;0;0;0;0;0;0
109;22.12.2016;2016;12;02;Torstai;1;0;1;0;0;0
109;22.12.2016;2016;12;03;Torstai;0;1;1;0;0;0
109;22.12.2016;2016;12;04;Torstai;1;0;1;0;0;0
109;22.12.2016;2016;12;05;Torstai;3;3;6;1;2;3
109;22.12.2016;2016;12;06;Torstai;11;9;20;4;2;6
109;22.12.2016;2016;12;07;Torstai;21;13;34;4;5;9
109;22.12.2016;2016;12;08;Torstai;27;6;33;2;2;4
109;22.12.2016;2016;12;09;Torstai;5;1;6;2;3;5
109;22.12.2016;2016;12;10;Torstai;6;6;12;1;3;4
109;22.12.2016;2016;12;11;Torstai;4;4;8;3;0;3
109;22.12.2016;2016;12;12;Torstai;15;6;21;5;4;9
109;22.12.2016;2016;12;13;Torstai;8;8;16;3;2;5
109;22.12.2016;2016;12;14;Torstai;6;15;21;2;2;4
109;22.12.2016;2016;12;15;Torstai;13;14;27;6;3;9
109;22.12.2016;2016;12;16;Torstai;14;17;31;1;2;3
109;22.12.2016;2016;12;17;Torstai;4;13;17;7;6;13
109;22.12.2016;2016;12;18;Torstai;3;4;7;4;2;6
109;22.12.2016;2016;12;19;Torstai;2;4;6;3;0;3
109;22.12.2016;2016;12;20;Torstai;7;1;8;4;4;8
109;22.12.2016;2016;12;21;Torstai;4;3;7;2;1;3
109;22.12.2016;2016;12;22;Torstai;0;1;1;0;0;0
109;22.12.2016;2016;12;23;Torstai;0;0;0;0;0;0
109;23.12.2016;2016;12;00;Perjantai;0;1;1;0;0;0
109;23.12.2016;2016;12;01;Perjantai;0;0;0;0;0;0
109;23.12.2016;2016;12;02;Perjantai;0;0;0;0;1;1
109;23.12.2016;2016;12;03;Perjantai;1;0;1;0;0;0
109;23.12.2016;2016;12;04;Perjantai;0;1;1;0;0;0
109;23.12.2016;2016;12;05;Perjantai;1;4;5;1;0;1
109;23.12.2016;2016;12;06;Perjantai;2;4;6;1;1;2
109;23.12.2016;2016;12;07;Perjantai;17;9;26;4;2;6
109;23.12.2016;2016;12;08;Perjantai;11;2;13;1;1;2
109;23.12.2016;2016;12;09;Perjantai;5;1;6;1;4;5
109;23.12.2016;2016;12;10;Perjantai;4;1;5;1;3;4
109;23.12.2016;2016;12;11;Perjantai;8;4;12;4;3;7
109;23.12.2016;2016;12;12;Perjantai;7;4;11;4;2;6
109;23.12.2016;2016;12;13;Perjantai;11;8;19;5;1;6
109;23.12.2016;2016;12;14;Perjantai;11;8;19;6;3;9
109;23.12.2016;2016;12;15;Perjantai;7;11;18;4;1;5
109;23.12.2016;2016;12;16;Perjantai;5;15;20;2;2;4
109;23.12.2016;2016;12;17;Perjantai;1;2;3;3;2;5
109;23.12.2016;2016;12;18;Perjantai;1;5;6;3;3;6
109;23.12.2016;2016;12;19;Perjantai;1;0;1;4;3;7
109;23.12.2016;2016;12;20;Perjantai;3;1;4;3;6;9
109;23.12.2016;2016;12;21;Perjantai;6;5;11;5;1;6
109;23.12.2016;2016;12;22;Perjantai;0;0;0;2;0;2
109;23.12.2016;2016;12;23;Perjantai;0;1;1;1;0;1
109;24.12.2016;2016;12;00;Lauantai;0;0;0;0;0;0
109;24.12.2016;2016;12;01;Lauantai;0;0;0;0;0;0
109;24.12.2016;2016;12;02;Lauantai;0;0;0;0;0;0
109;24.12.2016;2016;12;03;Lauantai;0;0;0;0;0;0
109;24.12.2016;2016;12;04;Lauantai;0;0;0;1;0;1
109;24.12.2016;2016;12;05;Lauantai;0;1;1;0;0;0
109;24.12.2016;2016;12;06;Lauantai;1;2;3;2;0;2
109;24.12.2016;2016;12;07;Lauantai;2;1;3;3;4;7
109;24.12.2016;2016;12;08;Lauantai;1;1;2;1;1;2
109;24.12.2016;2016;12;09;Lauantai;2;3;5;2;3;5
109;24.12.2016;2016;12;10;Lauantai;7;4;11;8;2;10
109;24.12.2016;2016;12;11;Lauantai;5;2;7;5;4;9
109;24.12.2016;2016;12;12;Lauantai;3;0;3;0;0;0
109;24.12.2016;2016;12;13;Lauantai;1;0;1;0;0;0
109;24.12.2016;2016;12;14;Lauantai;2;1;3;0;0;0
109;24.12.2016;2016;12;15;Lauantai;0;0;0;0;0;0
109;24.12.2016;2016;12;16;Lauantai;3;2;5;0;0;0
109;24.12.2016;2016;12;17;Lauantai;1;0;1;0;0;0
109;24.12.2016;2016;12;18;Lauantai;1;0;1;0;0;0
109;24.12.2016;2016;12;19;Lauantai;1;0;1;0;0;0
109;24.12.2016;2016;12;20;Lauantai;2;1;3;0;0;0
109;24.12.2016;2016;12;21;Lauantai;1;0;1;0;0;0
109;24.12.2016;2016;12;22;Lauantai;1;0;1;0;0;0
109;24.12.2016;2016;12;23;Lauantai;1;0;1;0;0;0
109;25.12.2016;2016;12;00;Sunnuntai;0;0;0;0;0;0
109;25.12.2016;2016;12;01;Sunnuntai;0;0;0;0;0;0
109;25.12.2016;2016;12;02;Sunnuntai;0;0;0;0;0;0
109;25.12.2016;2016;12;03;Sunnuntai;0;0;0;0;0;0
109;25.12.2016;2016;12;04;Sunnuntai;0;0;0;0;0;0
109;25.12.2016;2016;12;05;Sunnuntai;1;0;1;0;0;0
109;25.12.2016;2016;12;06;Sunnuntai;0;0;0;0;0;0
109;25.12.2016;2016;12;07;Sunnuntai;4;1;5;1;1;2
109;25.12.2016;2016;12;08;Sunnuntai;1;0;1;0;0;0
109;25.12.2016;2016;12;09;Sunnuntai;2;0;2;0;0;0
109;25.12.2016;2016;12;10;Sunnuntai;0;0;0;0;0;0
109;25.12.2016;2016;12;11;Sunnuntai;2;0;2;0;0;0
109;25.12.2016;2016;12;12;Sunnuntai;2;2;4;2;2;4
109;25.12.2016;2016;12;13;Sunnuntai;5;3;8;3;3;6
109;25.12.2016;2016;12;14;Sunnuntai;2;2;4;2;2;4
109;25.12.2016;2016;12;15;Sunnuntai;3;2;5;2;2;4
109;25.12.2016;2016;12;16;Sunnuntai;5;3;8;3;3;6
109;25.12.2016;2016;12;17;Sunnuntai;6;2;8;2;2;4
109;25.12.2016;2016;12;18;Sunnuntai;1;0;1;0;0;0
109;25.12.2016;2016;12;19;Sunnuntai;0;0;0;0;0;0
109;25.12.2016;2016;12;20;Sunnuntai;1;0;1;0;0;0
109;25.12.2016;2016;12;21;Sunnuntai;3;2;5;2;2;4
109;25.12.2016;2016;12;22;Sunnuntai;0;0;0;0;0;0
109;25.12.2016;2016;12;23;Sunnuntai;0;0;0;0;0;0
109;26.12.2016;2016;12;00;Maanantai;2;0;2;0;0;0
109;26.12.2016;2016;12;01;Maanantai;0;0;0;0;0;0
109;26.12.2016;2016;12;02;Maanantai;0;0;0;0;0;0
109;26.12.2016;2016;12;03;Maanantai;1;0;1;0;0;0
109;26.12.2016;2016;12;04;Maanantai;0;0;0;0;0;0
109;26.12.2016;2016;12;05;Maanantai;1;0;1;0;0;0
109;26.12.2016;2016;12;06;Maanantai;1;0;1;0;0;0
109;26.12.2016;2016;12;07;Maanantai;0;0;0;0;0;0
109;26.12.2016;2016;12;08;Maanantai;2;0;2;0;0;0
109;26.12.2016;2016;12;09;Maanantai;1;0;1;1;1;2
109;26.12.2016;2016;12;10;Maanantai;2;1;3;1;1;2
109;26.12.2016;2016;12;11;Maanantai;3;3;6;1;1;2
109;26.12.2016;2016;12;12;Maanantai;5;3;8;1;1;2
109;26.12.2016;2016;12;13;Maanantai;2;2;4;1;1;2
109;26.12.2016;2016;12;14;Maanantai;4;3;7;1;1;2
109;26.12.2016;2016;12;15;Maanantai;6;3;9;1;1;2
109;26.12.2016;2016;12;16;Maanantai;4;1;5;1;1;2
109;26.12.2016;2016;12;17;Maanantai;3;1;4;1;1;2
109;26.12.2016;2016;12;18;Maanantai;2;2;4;1;1;2
109;26.12.2016;2016;12;19;Maanantai;3;1;4;1;1;2
109;26.12.2016;2016;12;20;Maanantai;4;1;5;0;0;0
109;26.12.2016;2016;12;21;Maanantai;3;1;4;0;0;0
109;26.12.2016;2016;12;22;Maanantai;0;0;0;0;0;0
109;26.12.2016;2016;12;23;Maanantai;0;0;0;0;0;0
109;27.12.2016;2016;12;00;Tiistai;0;0;0;0;0;0
109;27.12.2016;2016;12;01;Tiistai;1;0;1;0;0;0
109;27.12.2016;2016;12;02;Tiistai;0;0;0;0;0;0
109;27.12.2016;2016;12;03;Tiistai;0;0;0;0;0;0
109;27.12.2016;2016;12;04;Tiistai;2;0;2;0;0;0
109;27.12.2016;2016;12;05;Tiistai;1;0;1;0;0;0
109;27.12.2016;2016;12;06;Tiistai;7;4;11;1;1;2
109;27.12.2016;2016;12;07;Tiistai;10;8;18;1;1;2
109;27.12.2016;2016;12;08;Tiistai;10;7;17;1;1;2
109;27.12.2016;2016;12;09;Tiistai;4;3;7;1;1;2
109;27.12.2016;2016;12;10;Tiistai;4;2;6;0;0;0
109;27.12.2016;2016;12;11;Tiistai;2;1;3;0;0;0
109;27.12.2016;2016;12;12;Tiistai;5;2;7;2;2;4
109;27.12.2016;2016;12;13;Tiistai;5;3;8;0;0;0
109;27.12.2016;2016;12;14;Tiistai;7;5;12;2;2;4
109;27.12.2016;2016;12;15;Tiistai;11;9;20;1;1;2
109;27.12.2016;2016;12;16;Tiistai;12;11;23;2;2;4
109;27.12.2016;2016;12;17;Tiistai;7;3;10;2;2;4
109;27.12.2016;2016;12;18;Tiistai;5;4;9;1;1;2
109;27.12.2016;2016;12;19;Tiistai;4;3;7;1;1;2
109;27.12.2016;2016;12;20;Tiistai;2;2;4;3;3;6
109;27.12.2016;2016;12;21;Tiistai;4;2;6;0;0;0
109;27.12.2016;2016;12;22;Tiistai;1;1;2;0;0;0
109;27.12.2016;2016;12;23;Tiistai;3;1;4;0;0;0
109;28.12.2016;2016;12;00;Keskiviikko;0;0;0;0;0;0
109;28.12.2016;2016;12;01;Keskiviikko;0;0;0;0;0;0
109;28.12.2016;2016;12;02;Keskiviikko;0;0;0;0;0;0
109;28.12.2016;2016;12;03;Keskiviikko;1;1;2;0;0;0
109;28.12.2016;2016;12;04;Keskiviikko;2;1;3;0;0;0
109;28.12.2016;2016;12;05;Keskiviikko;2;0;2;1;1;2
109;28.12.2016;2016;12;06;Keskiviikko;9;5;14;0;0;0
109;28.12.2016;2016;12;07;Keskiviikko;17;15;32;1;1;2
109;28.12.2016;2016;12;08;Keskiviikko;11;9;20;1;1;2
109;28.12.2016;2016;12;09;Keskiviikko;4;1;5;1;1;2
109;28.12.2016;2016;12;10;Keskiviikko;5;3;8;2;2;4
109;28.12.2016;2016;12;11;Keskiviikko;6;4;10;4;4;8
109;28.12.2016;2016;12;12;Keskiviikko;6;4;10;1;1;2
109;28.12.2016;2016;12;13;Keskiviikko;9;7;16;2;2;4
109;28.12.2016;2016;12;14;Keskiviikko;8;7;15;5;5;10
109;28.12.2016;2016;12;15;Keskiviikko;11;10;21;3;3;6
109;28.12.2016;2016;12;16;Keskiviikko;19;17;36;2;2;4
109;28.12.2016;2016;12;17;Keskiviikko;11;9;20;1;1;2
109;28.12.2016;2016;12;18;Keskiviikko;7;6;13;1;1;2
109;28.12.2016;2016;12;19;Keskiviikko;4;1;5;7;7;14
109;28.12.2016;2016;12;20;Keskiviikko;4;3;7;1;1;2
109;28.12.2016;2016;12;21;Keskiviikko;7;6;13;1;1;2
109;28.12.2016;2016;12;22;Keskiviikko;2;1;3;0;0;0
109;28.12.2016;2016;12;23;Keskiviikko;1;1;2;1;1;2
109;29.12.2016;2016;12;00;Torstai;1;0;1;0;0;0
109;29.12.2016;2016;12;01;Torstai;0;0;0;0;0;0
109;29.12.2016;2016;12;02;Torstai;0;0;0;0;0;0
109;29.12.2016;2016;12;03;Torstai;0;0;0;0;0;0
109;29.12.2016;2016;12;04;Torstai;0;0;0;0;0;0
109;29.12.2016;2016;12;05;Torstai;2;0;2;1;0;1
109;29.12.2016;2016;12;06;Torstai;7;6;13;0;1;1
109;29.12.2016;2016;12;07;Torstai;22;11;33;1;1;2
109;29.12.2016;2016;12;08;Torstai;11;12;23;1;1;2
109;29.12.2016;2016;12;09;Torstai;7;2;9;1;1;2
109;29.12.2016;2016;12;10;Torstai;9;4;13;2;0;2
109;29.12.2016;2016;12;11;Torstai;6;3;9;4;0;4
109;29.12.2016;2016;12;12;Torstai;11;4;15;1;2;3
109;29.12.2016;2016;12;13;Torstai;10;10;20;2;0;2
109;29.12.2016;2016;12;14;Torstai;7;6;13;5;2;7
109;29.12.2016;2016;12;15;Torstai;16;13;29;3;1;4
109;29.12.2016;2016;12;16;Torstai;13;18;31;2;2;4
109;29.12.2016;2016;12;17;Torstai;10;5;15;1;2;3
109;29.12.2016;2016;12;18;Torstai;5;5;10;1;1;2
109;29.12.2016;2016;12;19;Torstai;3;5;8;7;1;8
109;29.12.2016;2016;12;20;Torstai;6;4;10;1;3;4
109;29.12.2016;2016;12;21;Torstai;5;4;9;1;0;1
109;29.12.2016;2016;12;22;Torstai;2;3;5;0;0;0
109;29.12.2016;2016;12;23;Torstai;2;1;3;1;0;1
109;30.12.2016;2016;12;00;Perjantai;2;0;2;0;0;0
109;30.12.2016;2016;12;01;Perjantai;1;0;1;0;1;1
109;30.12.2016;2016;12;02;Perjantai;0;0;0;0;0;0
109;30.12.2016;2016;12;03;Perjantai;1;0;1;0;0;0
109;30.12.2016;2016;12;04;Perjantai;1;0;1;0;0;0
109;30.12.2016;2016;12;05;Perjantai;4;0;4;0;0;0
109;30.12.2016;2016;12;06;Perjantai;6;6;12;1;0;1
109;30.12.2016;2016;12;07;Perjantai;16;13;29;0;1;1
109;30.12.2016;2016;12;08;Perjantai;9;8;17;0;0;0
109;30.12.2016;2016;12;09;Perjantai;3;1;4;0;0;0
109;30.12.2016;2016;12;10;Perjantai;6;3;9;1;0;1
109;30.12.2016;2016;12;11;Perjantai;6;2;8;0;0;0
109;30.12.2016;2016;12;12;Perjantai;6;4;10;2;1;3
109;30.12.2016;2016;12;13;Perjantai;3;4;7;4;2;6
109;30.12.2016;2016;12;14;Perjantai;9;12;21;0;0;0
109;30.12.2016;2016;12;15;Perjantai;5;5;10;10;5;15
109;30.12.2016;2016;12;16;Perjantai;15;15;30;3;0;3
109;30.12.2016;2016;12;17;Perjantai;5;7;12;1;2;3
109;30.12.2016;2016;12;18;Perjantai;2;2;4;0;3;3
109;30.12.2016;2016;12;19;Perjantai;3;1;4;2;7;9
109;30.12.2016;2016;12;20;Perjantai;1;2;3;4;3;7
109;30.12.2016;2016;12;21;Perjantai;3;4;7;0;1;1
109;30.12.2016;2016;12;22;Perjantai;1;0;1;1;1;2
109;30.12.2016;2016;12;23;Perjantai;1;0;1;1;0;1
109;31.12.2016;2016;12;00;Lauantai;4;1;5;0;1;1
109;31.12.2016;2016;12;01;Lauantai;0;0;0;2;0;2
109;31.12.2016;2016;12;02;Lauantai;0;0;0;0;0;0
109;31.12.2016;2016;12;03;Lauantai;0;1;1;0;0;0
109;31.12.2016;2016;12;04;Lauantai;0;2;2;0;0;0
109;31.12.2016;2016;12;05;Lauantai;1;0;1;1;0;1
109;31.12.2016;2016;12;06;Lauantai;0;0;0;0;0;0
109;31.12.2016;2016;12;07;Lauantai;1;2;3;0;0;0
109;31.12.2016;2016;12;08;Lauantai;1;0;1;4;1;5
109;31.12.2016;2016;12;09;Lauantai;2;0;2;1;0;1
109;31.12.2016;2016;12;10;Lauantai;3;5;8;3;0;3
109;31.12.2016;2016;12;11;Lauantai;1;2;3;3;3;6
109;31.12.2016;2016;12;12;Lauantai;2;2;4;3;1;4
109;31.12.2016;2016;12;13;Lauantai;4;1;5;4;0;4
109;31.12.2016;2016;12;14;Lauantai;1;4;5;7;5;12
109;31.12.2016;2016;12;15;Lauantai;0;1;1;3;5;8
109;31.12.2016;2016;12;16;Lauantai;4;0;4;6;4;10
109;31.12.2016;2016;12;17;Lauantai;3;1;4;1;3;4
109;31.12.2016;2016;12;18;Lauantai;1;1;2;1;3;4
109;31.12.2016;2016;12;19;Lauantai;4;1;5;2;2;4
109;31.12.2016;2016;12;20;Lauantai;2;1;3;3;1;4
109;31.12.2016;2016;12;21;Lauantai;2;1;3;3;1;4
109;31.12.2016;2016;12;22;Lauantai;2;0;2;3;0;3
109;31.12.2016;2016;12;23;Lauantai;0;4;4;1;1;2
109;01.01.2017;2017;01;00;Sunnuntai;0;0;0;5;0;5
109;01.01.2017;2017;01;01;Sunnuntai;0;0;0;1;1;2
109;01.01.2017;2017;01;02;Sunnuntai;0;0;0;1;0;1
109;01.01.2017;2017;01;03;Sunnuntai;2;0;2;0;0;0
109;01.01.2017;2017;01;04;Sunnuntai;0;1;1;0;0;0
109;01.01.2017;2017;01;05;Sunnuntai;0;2;2;0;0;0
109;01.01.2017;2017;01;06;Sunnuntai;1;0;1;0;1;1
109;01.01.2017;2017;01;07;Sunnuntai;0;0;0;2;0;2
109;01.01.2017;2017;01;08;Sunnuntai;0;0;0;0;0;0
109;01.01.2017;2017;01;09;Sunnuntai;2;1;3;2;2;4
109;01.01.2017;2017;01;10;Sunnuntai;3;0;3;9;5;14
109;01.01.2017;2017;01;11;Sunnuntai;5;1;6;4;2;6
109;01.01.2017;2017;01;12;Sunnuntai;2;1;3;5;1;6
109;01.01.2017;2017;01;13;Sunnuntai;2;4;6;4;5;9
109;01.01.2017;2017;01;14;Sunnuntai;1;3;4;5;6;11
109;01.01.2017;2017;01;15;Sunnuntai;4;4;8;7;5;12
109;01.01.2017;2017;01;16;Sunnuntai;1;3;4;10;2;12
109;01.01.2017;2017;01;17;Sunnuntai;6;0;6;3;2;5
109;01.01.2017;2017;01;18;Sunnuntai;2;1;3;3;0;3
109;01.01.2017;2017;01;19;Sunnuntai;0;2;2;2;4;6
109;01.01.2017;2017;01;20;Sunnuntai;6;0;6;6;3;9
109;01.01.2017;2017;01;21;Sunnuntai;3;4;7;1;1;2
109;01.01.2017;2017;01;22;Sunnuntai;0;1;1;0;0;0
109;01.01.2017;2017;01;23;Sunnuntai;0;1;1;1;0;1
109;02.01.2017;2017;01;00;Maanantai;0;0;0;0;1;1
109;02.01.2017;2017;01;01;Maanantai;0;0;0;0;0;0
109;02.01.2017;2017;01;02;Maanantai;0;0;0;0;0;0
109;02.01.2017;2017;01;03;Maanantai;1;0;1;0;0;0
109;02.01.2017;2017;01;04;Maanantai;0;0;0;2;0;2
109;02.01.2017;2017;01;05;Maanantai;0;7;7;1;1;2
109;02.01.2017;2017;01;06;Maanantai;12;10;22;4;2;6
109;02.01.2017;2017;01;07;Maanantai;35;17;52;10;3;13
109;02.01.2017;2017;01;08;Maanantai;17;6;23;3;0;3
109;02.01.2017;2017;01;09;Maanantai;5;2;7;3;1;4
109;02.01.2017;2017;01;10;Maanantai;5;2;7;4;4;8
109;02.01.2017;2017;01;11;Maanantai;9;7;16;10;2;12
109;02.01.2017;2017;01;12;Maanantai;7;6;13;4;3;7
109;02.01.2017;2017;01;13;Maanantai;9;9;18;2;0;2
109;02.01.2017;2017;01;14;Maanantai;11;8;19;5;4;9
109;02.01.2017;2017;01;15;Maanantai;15;21;36;10;4;14
109;02.01.2017;2017;01;16;Maanantai;14;33;47;5;6;11
109;02.01.2017;2017;01;17;Maanantai;10;18;28;4;3;7
109;02.01.2017;2017;01;18;Maanantai;0;4;4;8;3;11
109;02.01.2017;2017;01;19;Maanantai;1;4;5;4;9;13
109;02.01.2017;2017;01;20;Maanantai;3;1;4;3;3;6
109;02.01.2017;2017;01;21;Maanantai;3;3;6;1;5;6
109;02.01.2017;2017;01;22;Maanantai;4;1;5;2;1;3
109;02.01.2017;2017;01;23;Maanantai;1;1;2;0;0;0
109;03.01.2017;2017;01;00;Tiistai;0;0;0;2;0;2
109;03.01.2017;2017;01;01;Tiistai;0;0;0;0;1;1
109;03.01.2017;2017;01;02;Tiistai;0;0;0;0;0;0
109;03.01.2017;2017;01;03;Tiistai;0;0;0;0;0;0
109;03.01.2017;2017;01;04;Tiistai;0;0;0;0;0;0
109;03.01.2017;2017;01;05;Tiistai;1;4;5;1;1;2
109;03.01.2017;2017;01;06;Tiistai;11;9;20;2;3;5
109;03.01.2017;2017;01;07;Tiistai;31;22;53;1;0;1
109;03.01.2017;2017;01;08;Tiistai;13;12;25;0;0;0
109;03.01.2017;2017;01;09;Tiistai;5;1;6;1;0;1
109;03.01.2017;2017;01;10;Tiistai;4;2;6;0;0;0
109;03.01.2017;2017;01;11;Tiistai;6;2;8;0;0;0
109;03.01.2017;2017;01;12;Tiistai;8;3;11;0;0;0
109;03.01.2017;2017;01;13;Tiistai;4;0;4;2;0;2
109;03.01.2017;2017;01;14;Tiistai;7;8;15;1;0;1
109;03.01.2017;2017;01;15;Tiistai;15;14;29;5;0;5
109;03.01.2017;2017;01;16;Tiistai;18;32;50;4;2;6
109;03.01.2017;2017;01;17;Tiistai;15;15;30;2;2;4
109;03.01.2017;2017;01;18;Tiistai;4;6;10;6;1;7
109;03.01.2017;2017;01;19;Tiistai;4;3;7;1;1;2
109;03.01.2017;2017;01;20;Tiistai;2;4;6;2;2;4
109;03.01.2017;2017;01;21;Tiistai;2;5;7;0;1;1
109;03.01.2017;2017;01;22;Tiistai;2;1;3;0;0;0
109;03.01.2017;2017;01;23;Tiistai;0;1;1;1;1;2
109;04.01.2017;2017;01;00;Keskiviikko;0;0;0;0;0;0
109;04.01.2017;2017;01;01;Keskiviikko;0;0;0;0;0;0
109;04.01.2017;2017;01;02;Keskiviikko;0;0;0;0;0;0
109;04.01.2017;2017;01;03;Keskiviikko;0;0;0;0;0;0
109;04.01.2017;2017;01;04;Keskiviikko;1;0;1;1;0;1
109;04.01.2017;2017;01;05;Keskiviikko;0;3;3;1;1;2
109;04.01.2017;2017;01;06;Keskiviikko;4;7;11;2;0;2
109;04.01.2017;2017;01;07;Keskiviikko;26;15;41;1;2;3
109;04.01.2017;2017;01;08;Keskiviikko;12;4;16;4;2;6
109;04.01.2017;2017;01;09;Keskiviikko;4;2;6;0;0;0
109;04.01.2017;2017;01;10;Keskiviikko;1;1;2;3;2;5
109;04.01.2017;2017;01;11;Keskiviikko;3;1;4;8;1;9
109;04.01.2017;2017;01;12;Keskiviikko;1;2;3;1;0;1
109;04.01.2017;2017;01;13;Keskiviikko;1;3;4;2;0;2
109;04.01.2017;2017;01;14;Keskiviikko;4;3;7;1;1;2
109;04.01.2017;2017;01;15;Keskiviikko;9;8;17;3;1;4
109;04.01.2017;2017;01;16;Keskiviikko;13;12;25;3;6;9
109;04.01.2017;2017;01;17;Keskiviikko;2;8;10;6;1;7
109;04.01.2017;2017;01;18;Keskiviikko;3;3;6;1;0;1
109;04.01.2017;2017;01;19;Keskiviikko;0;1;1;2;2;4
109;04.01.2017;2017;01;20;Keskiviikko;2;2;4;4;0;4
109;04.01.2017;2017;01;21;Keskiviikko;3;3;6;1;3;4
109;04.01.2017;2017;01;22;Keskiviikko;0;0;0;2;0;2
109;04.01.2017;2017;01;23;Keskiviikko;0;0;0;0;1;1
109;05.01.2017;2017;01;00;Torstai;0;0;0;0;1;1
109;05.01.2017;2017;01;01;Torstai;0;0;0;0;0;0
109;05.01.2017;2017;01;02;Torstai;0;0;0;0;0;0
109;05.01.2017;2017;01;03;Torstai;0;0;0;0;0;0
109;05.01.2017;2017;01;04;Torstai;0;0;0;1;0;1
109;05.01.2017;2017;01;05;Torstai;0;2;2;1;2;3
109;05.01.2017;2017;01;06;Torstai;1;4;5;4;2;6
109;05.01.2017;2017;01;07;Torstai;14;11;25;4;4;8
109;05.01.2017;2017;01;08;Torstai;11;3;14;2;1;3
109;05.01.2017;2017;01;09;Torstai;5;0;5;0;0;0
109;05.01.2017;2017;01;10;Torstai;0;0;0;2;0;2
109;05.01.2017;2017;01;11;Torstai;3;3;6;1;0;1
109;05.01.2017;2017;01;12;Torstai;1;3;4;7;1;8
109;05.01.2017;2017;01;13;Torstai;1;0;1;2;0;2
109;05.01.2017;2017;01;14;Torstai;3;1;4;5;1;6
109;05.01.2017;2017;01;15;Torstai;7;6;13;5;2;7
109;05.01.2017;2017;01;16;Torstai;6;7;13;2;0;2
109;05.01.2017;2017;01;17;Torstai;5;8;13;2;1;3
109;05.01.2017;2017;01;18;Torstai;4;0;4;1;1;2
109;05.01.2017;2017;01;19;Torstai;2;2;4;3;4;7
109;05.01.2017;2017;01;20;Torstai;1;2;3;3;1;4
109;05.01.2017;2017;01;21;Torstai;2;0;2;1;1;2
109;05.01.2017;2017;01;22;Torstai;1;0;1;0;0;0
109;05.01.2017;2017;01;23;Torstai;0;0;0;0;0;0
109;06.01.2017;2017;01;00;Perjantai;0;0;0;1;0;1
109;06.01.2017;2017;01;01;Perjantai;0;0;0;0;0;0
109;06.01.2017;2017;01;02;Perjantai;0;0;0;0;0;0
109;06.01.2017;2017;01;03;Perjantai;0;0;0;0;0;0
109;06.01.2017;2017;01;04;Perjantai;1;1;2;0;0;0
109;06.01.2017;2017;01;05;Perjantai;0;1;1;0;0;0
109;06.01.2017;2017;01;06;Perjantai;2;2;4;2;0;2
109;06.01.2017;2017;01;07;Perjantai;0;1;1;1;1;2
109;06.01.2017;2017;01;08;Perjantai;0;0;0;0;0;0
109;06.01.2017;2017;01;09;Perjantai;2;0;2;0;1;1
109;06.01.2017;2017;01;10;Perjantai;1;0;1;4;2;6
109;06.01.2017;2017;01;11;Perjantai;5;1;6;1;0;1
109;06.01.2017;2017;01;12;Perjantai;3;2;5;2;1;3
109;06.01.2017;2017;01;13;Perjantai;2;1;3;1;1;2
109;06.01.2017;2017;01;14;Perjantai;3;0;3;0;0;0
109;06.01.2017;2017;01;15;Perjantai;6;4;10;3;2;5
109;06.01.2017;2017;01;16;Perjantai;3;2;5;1;1;2
109;06.01.2017;2017;01;17;Perjantai;3;2;5;4;0;4
109;06.01.2017;2017;01;18;Perjantai;1;2;3;2;3;5
109;06.01.2017;2017;01;19;Perjantai;1;1;2;1;2;3
109;06.01.2017;2017;01;20;Perjantai;6;3;9;2;0;2
109;06.01.2017;2017;01;21;Perjantai;2;2;4;0;0;0
109;06.01.2017;2017;01;22;Perjantai;0;2;2;0;0;0
109;06.01.2017;2017;01;23;Perjantai;1;1;2;0;0;0
109;07.01.2017;2017;01;00;Lauantai;0;0;0;1;0;1
109;07.01.2017;2017;01;01;Lauantai;0;1;1;0;0;0
109;07.01.2017;2017;01;02;Lauantai;0;1;1;0;0;0
109;07.01.2017;2017;01;03;Lauantai;1;1;2;0;0;0
109;07.01.2017;2017;01;04;Lauantai;1;0;1;0;0;0
109;07.01.2017;2017;01;05;Lauantai;0;0;0;0;0;0
109;07.01.2017;2017;01;06;Lauantai;3;1;4;2;0;2
109;07.01.2017;2017;01;07;Lauantai;1;0;1;1;1;2
109;07.01.2017;2017;01;08;Lauantai;2;0;2;0;0;0
109;07.01.2017;2017;01;09;Lauantai;3;0;3;0;1;1
109;07.01.2017;2017;01;10;Lauantai;3;1;4;4;2;6
109;07.01.2017;2017;01;11;Lauantai;5;2;7;1;0;1
109;07.01.2017;2017;01;12;Lauantai;6;5;11;2;1;3
109;07.01.2017;2017;01;13;Lauantai;5;4;9;1;1;2
109;07.01.2017;2017;01;14;Lauantai;4;3;7;0;0;0
109;07.01.2017;2017;01;15;Lauantai;6;5;11;3;2;5
109;07.01.2017;2017;01;16;Lauantai;5;3;8;1;1;2
109;07.01.2017;2017;01;17;Lauantai;4;4;8;4;0;4
109;07.01.2017;2017;01;18;Lauantai;6;5;11;2;3;5
109;07.01.2017;2017;01;19;Lauantai;2;1;3;1;2;3
109;07.01.2017;2017;01;20;Lauantai;5;4;9;2;0;2
109;07.01.2017;2017;01;21;Lauantai;4;3;7;0;0;0
109;07.01.2017;2017;01;22;Lauantai;2;1;3;0;0;0
109;07.01.2017;2017;01;23;Lauantai;2;1;3;0;0;0
109;08.01.2017;2017;01;00;Sunnuntai;2;0;2;0;0;0
109;08.01.2017;2017;01;01;Sunnuntai;1;0;1;0;0;0
109;08.01.2017;2017;01;02;Sunnuntai;0;0;0;0;0;0
109;08.01.2017;2017;01;03;Sunnuntai;1;0;1;0;0;0
109;08.01.2017;2017;01;04;Sunnuntai;1;0;1;0;0;0
109;08.01.2017;2017;01;05;Sunnuntai;2;1;3;0;0;0
109;08.01.2017;2017;01;06;Sunnuntai;3;1;4;0;0;0
109;08.01.2017;2017;01;07;Sunnuntai;3;1;4;1;1;2
109;08.01.2017;2017;01;08;Sunnuntai;2;0;2;0;0;0
109;08.01.2017;2017;01;09;Sunnuntai;5;2;7;1;1;2
109;08.01.2017;2017;01;10;Sunnuntai;3;1;4;2;2;4
109;08.01.2017;2017;01;11;Sunnuntai;4;2;6;0;0;0
109;08.01.2017;2017;01;12;Sunnuntai;5;3;8;1;1;2
109;08.01.2017;2017;01;13;Sunnuntai;7;4;11;1;1;2
109;08.01.2017;2017;01;14;Sunnuntai;3;1;4;0;0;0
109;08.01.2017;2017;01;15;Sunnuntai;4;2;6;2;2;4
109;08.01.2017;2017;01;16;Sunnuntai;5;2;7;1;1;2
109;08.01.2017;2017;01;17;Sunnuntai;2;0;2;0;0;0
109;08.01.2017;2017;01;18;Sunnuntai;5;2;7;3;3;6
109;08.01.2017;2017;01;19;Sunnuntai;4;0;4;2;2;4
109;08.01.2017;2017;01;20;Sunnuntai;4;2;6;0;0;0
109;08.01.2017;2017;01;21;Sunnuntai;4;1;5;0;0;0
109;08.01.2017;2017;01;22;Sunnuntai;0;0;0;0;0;0
109;08.01.2017;2017;01;23;Sunnuntai;0;0;0;0;0;0
109;09.01.2017;2017;01;00;Maanantai;0;0;0;1;0;1
109;09.01.2017;2017;01;01;Maanantai;0;0;0;0;0;0
109;09.01.2017;2017;01;02;Maanantai;0;0;0;0;0;0
109;09.01.2017;2017;01;03;Maanantai;0;0;0;0;0;0
109;09.01.2017;2017;01;04;Maanantai;1;0;1;0;0;0
109;09.01.2017;2017;01;05;Maanantai;1;4;5;1;0;1
109;09.01.2017;2017;01;06;Maanantai;18;16;34;3;0;3
109;09.01.2017;2017;01;07;Maanantai;71;27;98;5;4;9
109;09.01.2017;2017;01;08;Maanantai;33;9;42;6;4;10
109;09.01.2017;2017;01;09;Maanantai;21;6;27;2;1;3
109;09.01.2017;2017;01;10;Maanantai;7;1;8;2;1;3
109;09.01.2017;2017;01;11;Maanantai;9;4;13;1;0;1
109;09.01.2017;2017;01;12;Maanantai;12;8;20;2;4;6
109;09.01.2017;2017;01;13;Maanantai;3;7;10;5;5;10
109;09.01.2017;2017;01;14;Maanantai;7;10;17;2;6;8
109;09.01.2017;2017;01;15;Maanantai;19;25;44;12;6;18
109;09.01.2017;2017;01;16;Maanantai;24;56;80;7;4;11
109;09.01.2017;2017;01;17;Maanantai;11;23;34;5;2;7
109;09.01.2017;2017;01;18;Maanantai;6;15;21;3;1;4
109;09.01.2017;2017;01;19;Maanantai;7;2;9;5;7;12
109;09.01.2017;2017;01;20;Maanantai;4;5;9;4;4;8
109;09.01.2017;2017;01;21;Maanantai;2;9;11;3;1;4
109;09.01.2017;2017;01;22;Maanantai;4;1;5;2;0;2
109;09.01.2017;2017;01;23;Maanantai;0;0;0;0;2;2
109;10.01.2017;2017;01;00;Tiistai;0;0;0;3;0;3
109;10.01.2017;2017;01;01;Tiistai;0;0;0;2;0;2
109;10.01.2017;2017;01;02;Tiistai;0;0;0;0;0;0
109;10.01.2017;2017;01;03;Tiistai;0;0;0;0;0;0
109;10.01.2017;2017;01;04;Tiistai;2;0;2;0;0;0
109;10.01.2017;2017;01;05;Tiistai;4;1;5;0;0;0
109;10.01.2017;2017;01;06;Tiistai;14;12;26;1;0;1
109;10.01.2017;2017;01;07;Tiistai;45;44;89;3;2;5
109;10.01.2017;2017;01;08;Tiistai;16;15;31;9;3;12
109;10.01.2017;2017;01;09;Tiistai;10;7;17;2;4;6
109;10.01.2017;2017;01;10;Tiistai;9;7;16;4;0;4
109;10.01.2017;2017;01;11;Tiistai;8;3;11;6;5;11
109;10.01.2017;2017;01;12;Tiistai;13;2;15;4;3;7
109;10.01.2017;2017;01;13;Tiistai;3;9;12;8;3;11
109;10.01.2017;2017;01;14;Tiistai;10;10;20;6;10;16
109;10.01.2017;2017;01;15;Tiistai;23;35;58;4;2;6
109;10.01.2017;2017;01;16;Tiistai;17;54;71;9;5;14
109;10.01.2017;2017;01;17;Tiistai;10;21;31;3;9;12
109;10.01.2017;2017;01;18;Tiistai;4;11;15;9;3;12
109;10.01.2017;2017;01;19;Tiistai;5;4;9;4;8;12
109;10.01.2017;2017;01;20;Tiistai;2;5;7;3;3;6
109;10.01.2017;2017;01;21;Tiistai;4;7;11;3;4;7
109;10.01.2017;2017;01;22;Tiistai;1;0;1;0;0;0
109;10.01.2017;2017;01;23;Tiistai;0;1;1;1;2;3
109;11.01.2017;2017;01;00;Keskiviikko;0;1;1;0;0;0
109;11.01.2017;2017;01;01;Keskiviikko;0;0;0;0;0;0
109;11.01.2017;2017;01;02;Keskiviikko;0;0;0;0;0;0
109;11.01.2017;2017;01;03;Keskiviikko;0;0;0;0;0;0
109;11.01.2017;2017;01;04;Keskiviikko;0;2;2;0;0;0
109;11.01.2017;2017;01;05;Keskiviikko;1;5;6;1;0;1
109;11.01.2017;2017;01;06;Keskiviikko;13;9;22;3;2;5
109;11.01.2017;2017;01;07;Keskiviikko;62;23;85;9;3;12
109;11.01.2017;2017;01;08;Keskiviikko;32;7;39;2;4;6
109;11.01.2017;2017;01;09;Keskiviikko;14;7;21;4;0;4
109;11.01.2017;2017;01;10;Keskiviikko;5;3;8;6;5;11
109;11.01.2017;2017;01;11;Keskiviikko;8;6;14;3;5;8
109;11.01.2017;2017;01;12;Keskiviikko;13;7;20;4;0;4
109;11.01.2017;2017;01;13;Keskiviikko;6;4;10;2;6;8
109;11.01.2017;2017;01;14;Keskiviikko;7;15;22;6;3;9
109;11.01.2017;2017;01;15;Keskiviikko;20;29;49;3;3;6
109;11.01.2017;2017;01;16;Keskiviikko;13;49;62;5;8;13
109;11.01.2017;2017;01;17;Keskiviikko;9;13;22;6;2;8
109;11.01.2017;2017;01;18;Keskiviikko;9;5;14;9;2;11
109;11.01.2017;2017;01;19;Keskiviikko;1;2;3;5;8;13
109;11.01.2017;2017;01;20;Keskiviikko;3;6;9;4;3;7
109;11.01.2017;2017;01;21;Keskiviikko;2;4;6;2;2;4
109;11.01.2017;2017;01;22;Keskiviikko;0;1;1;0;1;1
109;11.01.2017;2017;01;23;Keskiviikko;0;0;0;0;1;1
109;12.01.2017;2017;01;00;Torstai;0;0;0;0;0;0
109;12.01.2017;2017;01;01;Torstai;0;0;0;0;0;0
109;12.01.2017;2017;01;02;Torstai;1;0;1;0;0;0
109;12.01.2017;2017;01;03;Torstai;0;0;0;0;0;0
109;12.01.2017;2017;01;04;Torstai;1;0;1;0;1;1
109;12.01.2017;2017;01;05;Torstai;1;6;7;0;1;1
109;12.01.2017;2017;01;06;Torstai;10;13;23;6;1;7
109;12.01.2017;2017;01;07;Torstai;64;16;80;4;2;6
109;12.01.2017;2017;01;08;Torstai;31;7;38;6;2;8
109;12.01.2017;2017;01;09;Torstai;12;5;17;2;1;3
109;12.01.2017;2017;01;10;Torstai;8;6;14;0;0;0
109;12.01.2017;2017;01;11;Torstai;7;5;12;0;0;0
109;12.01.2017;2017;01;12;Torstai;7;4;11;0;0;0
109;12.01.2017;2017;01;13;Torstai;2;1;3;3;1;4
109;12.01.2017;2017;01;14;Torstai;6;5;11;4;6;10
109;12.01.2017;2017;01;15;Torstai;18;33;51;5;2;7
109;12.01.2017;2017;01;16;Torstai;14;47;61;3;1;4
109;12.01.2017;2017;01;17;Torstai;4;17;21;3;5;8
109;12.01.2017;2017;01;18;Torstai;1;11;12;3;4;7
109;12.01.2017;2017;01;19;Torstai;4;6;10;4;4;8
109;12.01.2017;2017;01;20;Torstai;2;7;9;7;5;12
109;12.01.2017;2017;01;21;Torstai;2;6;8;1;1;2
109;12.01.2017;2017;01;22;Torstai;2;2;4;1;1;2
109;12.01.2017;2017;01;23;Torstai;0;0;0;1;1;2
109;13.01.2017;2017;01;00;Perjantai;0;0;0;1;0;1
109;13.01.2017;2017;01;01;Perjantai;0;0;0;0;0;0
109;13.01.2017;2017;01;02;Perjantai;0;0;0;0;0;0
109;13.01.2017;2017;01;03;Perjantai;0;0;0;0;1;1
109;13.01.2017;2017;01;04;Perjantai;0;0;0;0;0;0
109;13.01.2017;2017;01;05;Perjantai;0;6;6;0;1;1
109;13.01.2017;2017;01;06;Perjantai;10;15;25;2;0;2
109;13.01.2017;2017;01;07;Perjantai;54;18;72;6;3;9
109;13.01.2017;2017;01;08;Perjantai;34;5;39;3;4;7
109;13.01.2017;2017;01;09;Perjantai;10;3;13;1;2;3
109;13.01.2017;2017;01;10;Perjantai;7;3;10;5;1;6
109;13.01.2017;2017;01;11;Perjantai;8;8;16;3;2;5
109;13.01.2017;2017;01;12;Perjantai;12;7;19;5;0;5
109;13.01.2017;2017;01;13;Perjantai;5;10;15;3;4;7
109;13.01.2017;2017;01;14;Perjantai;11;16;27;2;6;8
109;13.01.2017;2017;01;15;Perjantai;13;30;43;5;4;9
109;13.01.2017;2017;01;16;Perjantai;14;34;48;5;6;11
109;13.01.2017;2017;01;17;Perjantai;7;16;23;1;5;6
109;13.01.2017;2017;01;18;Perjantai;4;5;9;4;3;7
109;13.01.2017;2017;01;19;Perjantai;2;4;6;4;4;8
109;13.01.2017;2017;01;20;Perjantai;1;7;8;2;1;3
109;13.01.2017;2017;01;21;Perjantai;2;3;5;2;1;3
109;13.01.2017;2017;01;22;Perjantai;0;2;2;3;4;7
109;13.01.2017;2017;01;23;Perjantai;0;0;0;3;1;4
109;14.01.2017;2017;01;00;Lauantai;0;0;0;1;0;1
109;14.01.2017;2017;01;01;Lauantai;0;0;0;0;0;0
109;14.01.2017;2017;01;02;Lauantai;0;0;0;0;0;0
109;14.01.2017;2017;01;03;Lauantai;0;0;0;0;0;0
109;14.01.2017;2017;01;04;Lauantai;0;0;0;0;0;0
109;14.01.2017;2017;01;05;Lauantai;0;1;1;0;0;0
109;14.01.2017;2017;01;06;Lauantai;2;1;3;2;0;2
109;14.01.2017;2017;01;07;Lauantai;3;1;4;1;1;2
109;14.01.2017;2017;01;08;Lauantai;0;0;0;0;0;0
109;14.01.2017;2017;01;09;Lauantai;1;1;2;0;1;1
109;14.01.2017;2017;01;10;Lauantai;4;3;7;4;2;6
109;14.01.2017;2017;01;11;Lauantai;4;1;5;1;0;1
109;14.01.2017;2017;01;12;Lauantai;4;4;8;2;1;3
109;14.01.2017;2017;01;13;Lauantai;3;2;5;1;1;2
109;14.01.2017;2017;01;14;Lauantai;7;6;13;0;0;0
109;14.01.2017;2017;01;15;Lauantai;4;1;5;3;2;5
109;14.01.2017;2017;01;16;Lauantai;5;2;7;1;1;2
109;14.01.2017;2017;01;17;Lauantai;3;2;5;4;0;4
109;14.01.2017;2017;01;18;Lauantai;4;3;7;2;3;5
109;14.01.2017;2017;01;19;Lauantai;3;3;6;1;2;3
109;14.01.2017;2017;01;20;Lauantai;4;2;6;2;0;2
109;14.01.2017;2017;01;21;Lauantai;3;1;4;0;0;0
109;14.01.2017;2017;01;22;Lauantai;2;0;2;0;0;0
109;14.01.2017;2017;01;23;Lauantai;1;0;1;0;0;0
109;15.01.2017;2017;01;00;Sunnuntai;0;0;0;0;0;0
109;15.01.2017;2017;01;01;Sunnuntai;0;0;0;0;0;0
109;15.01.2017;2017;01;02;Sunnuntai;0;0;0;0;0;0
109;15.01.2017;2017;01;03;Sunnuntai;0;0;0;0;0;0
109;15.01.2017;2017;01;04;Sunnuntai;0;0;0;0;0;0
109;15.01.2017;2017;01;05;Sunnuntai;2;0;2;0;0;0
109;15.01.2017;2017;01;06;Sunnuntai;5;3;8;0;0;0
109;15.01.2017;2017;01;07;Sunnuntai;0;0;0;1;1;2
109;15.01.2017;2017;01;08;Sunnuntai;1;0;1;0;0;0
109;15.01.2017;2017;01;09;Sunnuntai;1;0;1;1;1;2
109;15.01.2017;2017;01;10;Sunnuntai;3;0;3;2;2;4
109;15.01.2017;2017;01;11;Sunnuntai;8;5;13;0;0;0
109;15.01.2017;2017;01;12;Sunnuntai;6;5;11;1;1;2
109;15.01.2017;2017;01;13;Sunnuntai;6;2;8;1;1;2
109;15.01.2017;2017;01;14;Sunnuntai;5;4;9;0;0;0
109;15.01.2017;2017;01;15;Sunnuntai;4;2;6;2;2;4
109;15.01.2017;2017;01;16;Sunnuntai;5;3;8;1;1;2
109;15.01.2017;2017;01;17;Sunnuntai;1;0;1;0;0;0
109;15.01.2017;2017;01;18;Sunnuntai;5;4;9;3;3;6
109;15.01.2017;2017;01;19;Sunnuntai;3;0;3;2;2;4
109;15.01.2017;2017;01;20;Sunnuntai;3;2;5;0;0;0
109;15.01.2017;2017;01;21;Sunnuntai;3;2;5;0;0;0
109;15.01.2017;2017;01;22;Sunnuntai;1;0;1;0;0;0
109;15.01.2017;2017;01;23;Sunnuntai;1;0;1;0;0;0
109;16.01.2017;2017;01;00;Maanantai;0;0;0;1;0;1
109;16.01.2017;2017;01;01;Maanantai;0;0;0;0;0;0
109;16.01.2017;2017;01;02;Maanantai;0;0;0;0;0;0
109;16.01.2017;2017;01;03;Maanantai;0;0;0;0;0;0
109;16.01.2017;2017;01;04;Maanantai;3;0;3;0;0;0
109;16.01.2017;2017;01;05;Maanantai;2;1;3;1;0;1
109;16.01.2017;2017;01;06;Maanantai;15;13;28;3;0;3
109;16.01.2017;2017;01;07;Maanantai;43;40;83;5;4;9
109;16.01.2017;2017;01;08;Maanantai;27;24;51;6;4;10
109;16.01.2017;2017;01;09;Maanantai;11;10;21;2;1;3
109;16.01.2017;2017;01;10;Maanantai;6;4;10;2;1;3
109;16.01.2017;2017;01;11;Maanantai;10;8;18;1;0;1
109;16.01.2017;2017;01;12;Maanantai;10;8;18;2;4;6
109;16.01.2017;2017;01;13;Maanantai;7;4;11;5;5;10
109;16.01.2017;2017;01;14;Maanantai;11;10;21;2;6;8
109;16.01.2017;2017;01;15;Maanantai;27;25;52;12;6;18
109;16.01.2017;2017;01;16;Maanantai;40;40;80;7;4;11
109;16.01.2017;2017;01;17;Maanantai;17;14;31;5;2;7
109;16.01.2017;2017;01;18;Maanantai;7;5;12;3;1;4
109;16.01.2017;2017;01;19;Maanantai;5;3;8;5;7;12
109;16.01.2017;2017;01;20;Maanantai;4;3;7;4;4;8
109;16.01.2017;2017;01;21;Maanantai;3;1;4;3;1;4
109;16.01.2017;2017;01;22;Maanantai;5;3;8;2;0;2
109;16.01.2017;2017;01;23;Maanantai;0;0;0;0;2;2
109;17.01.2017;2017;01;00;Tiistai;1;0;1;0;0;0
109;17.01.2017;2017;01;01;Tiistai;0;0;0;0;0;0
109;17.01.2017;2017;01;02;Tiistai;0;0;0;0;0;0
109;17.01.2017;2017;01;03;Tiistai;1;0;1;0;0;0
109;17.01.2017;2017;01;04;Tiistai;0;0;0;0;0;0
109;17.01.2017;2017;01;05;Tiistai;2;0;2;0;0;0
109;17.01.2017;2017;01;06;Tiistai;21;19;40;3;0;3
109;17.01.2017;2017;01;07;Tiistai;49;39;88;4;5;9
109;17.01.2017;2017;01;08;Tiistai;33;10;43;2;2;4
109;17.01.2017;2017;01;09;Tiistai;12;10;22;4;2;6
109;17.01.2017;2017;01;10;Tiistai;6;4;10;6;1;7
109;17.01.2017;2017;01;11;Tiistai;11;2;13;3;5;8
109;17.01.2017;2017;01;12;Tiistai;13;6;19;6;2;8
109;17.01.2017;2017;01;13;Tiistai;7;5;12;2;4;6
109;17.01.2017;2017;01;14;Tiistai;5;15;20;3;5;8
109;17.01.2017;2017;01;15;Tiistai;19;40;59;4;5;9
109;17.01.2017;2017;01;16;Tiistai;24;44;68;6;6;12
109;17.01.2017;2017;01;17;Tiistai;12;16;28;9;4;13
109;17.01.2017;2017;01;18;Tiistai;3;6;9;6;2;8
109;17.01.2017;2017;01;19;Tiistai;3;14;17;4;4;8
109;17.01.2017;2017;01;20;Tiistai;5;10;15;4;4;8
109;17.01.2017;2017;01;21;Tiistai;5;5;10;0;4;4
109;17.01.2017;2017;01;22;Tiistai;7;3;10;0;0;0
109;17.01.2017;2017;01;23;Tiistai;1;1;2;0;0;0
109;18.01.2017;2017;01;00;Keskiviikko;0;0;0;0;0;0
109;18.01.2017;2017;01;01;Keskiviikko;1;0;1;0;0;0
109;18.01.2017;2017;01;02;Keskiviikko;0;0;0;0;0;0
109;18.01.2017;2017;01;03;Keskiviikko;0;0;0;0;0;0
109;18.01.2017;2017;01;04;Keskiviikko;0;0;0;0;0;0
109;18.01.2017;2017;01;05;Keskiviikko;1;2;3;0;0;0
109;18.01.2017;2017;01;06;Keskiviikko;25;17;42;4;1;5
109;18.01.2017;2017;01;07;Keskiviikko;58;27;85;10;2;12
109;18.01.2017;2017;01;08;Keskiviikko;37;14;51;3;6;9
109;18.01.2017;2017;01;09;Keskiviikko;13;6;19;3;1;4
109;18.01.2017;2017;01;10;Keskiviikko;13;1;14;5;1;6
109;18.01.2017;2017;01;11;Keskiviikko;7;8;15;3;7;10
109;18.01.2017;2017;01;12;Keskiviikko;15;3;18;3;3;6
109;18.01.2017;2017;01;13;Keskiviikko;11;10;21;4;5;9
109;18.01.2017;2017;01;14;Keskiviikko;13;12;25;3;2;5
109;18.01.2017;2017;01;15;Keskiviikko;30;22;52;1;0;1
109;18.01.2017;2017;01;16;Keskiviikko;41;40;81;4;1;5
109;18.01.2017;2017;01;17;Keskiviikko;13;16;29;2;1;3
109;18.01.2017;2017;01;18;Keskiviikko;5;6;11;6;6;12
109;18.01.2017;2017;01;19;Keskiviikko;0;5;5;1;6;7
109;18.01.2017;2017;01;20;Keskiviikko;6;4;10;8;4;12
109;18.01.2017;2017;01;21;Keskiviikko;6;6;12;1;3;4
109;18.01.2017;2017;01;22;Keskiviikko;3;0;3;1;0;1
109;18.01.2017;2017;01;23;Keskiviikko;2;1;3;0;0;0
109;19.01.2017;2017;01;00;Torstai;1;0;1;1;0;1
109;19.01.2017;2017;01;01;Torstai;0;0;0;0;0;0
109;19.01.2017;2017;01;02;Torstai;0;0;0;0;0;0
109;19.01.2017;2017;01;03;Torstai;0;0;0;0;0;0
109;19.01.2017;2017;01;04;Torstai;1;1;2;0;0;0
109;19.01.2017;2017;01;05;Torstai;2;2;4;0;0;0
109;19.01.2017;2017;01;06;Torstai;10;13;23;5;1;6
109;19.01.2017;2017;01;07;Torstai;51;20;71;8;4;12
109;19.01.2017;2017;01;08;Torstai;32;12;44;4;3;7
109;19.01.2017;2017;01;09;Torstai;10;3;13;2;5;7
109;19.01.2017;2017;01;10;Torstai;7;3;10;1;2;3
109;19.01.2017;2017;01;11;Torstai;5;3;8;3;2;5
109;19.01.2017;2017;01;12;Torstai;10;6;16;2;1;3
109;19.01.2017;2017;01;13;Torstai;6;11;17;1;2;3
109;19.01.2017;2017;01;14;Torstai;7;10;17;8;6;14
109;19.01.2017;2017;01;15;Torstai;19;21;40;4;6;10
109;19.01.2017;2017;01;16;Torstai;18;37;55;3;2;5
109;19.01.2017;2017;01;17;Torstai;8;13;21;4;2;6
109;19.01.2017;2017;01;18;Torstai;1;15;16;6;5;11
109;19.01.2017;2017;01;19;Torstai;1;2;3;2;1;3
109;19.01.2017;2017;01;20;Torstai;3;2;5;3;2;5
109;19.01.2017;2017;01;21;Torstai;1;6;7;2;2;4
109;19.01.2017;2017;01;22;Torstai;2;1;3;1;0;1
109;19.01.2017;2017;01;23;Torstai;0;0;0;0;0;0
109;20.01.2017;2017;01;00;Perjantai;0;0;0;0;0;0
109;20.01.2017;2017;01;01;Perjantai;1;0;1;3;0;3
109;20.01.2017;2017;01;02;Perjantai;0;1;1;0;0;0
109;20.01.2017;2017;01;03;Perjantai;0;0;0;0;0;0
109;20.01.2017;2017;01;04;Perjantai;1;1;2;0;0;0
109;20.01.2017;2017;01;05;Perjantai;0;0;0;0;1;1
109;20.01.2017;2017;01;06;Perjantai;9;8;17;3;0;3
109;20.01.2017;2017;01;07;Perjantai;42;14;56;4;2;6
109;20.01.2017;2017;01;08;Perjantai;29;7;36;1;1;2
109;20.01.2017;2017;01;09;Perjantai;13;6;19;4;2;6
109;20.01.2017;2017;01;10;Perjantai;5;4;9;3;2;5
109;20.01.2017;2017;01;11;Perjantai;5;8;13;4;3;7
109;20.01.2017;2017;01;12;Perjantai;11;9;20;2;2;4
109;20.01.2017;2017;01;13;Perjantai;5;16;21;5;6;11
109;20.01.2017;2017;01;14;Perjantai;11;17;28;7;5;12
109;20.01.2017;2017;01;15;Perjantai;13;23;36;9;5;14
109;20.01.2017;2017;01;16;Perjantai;19;30;49;3;3;6
109;20.01.2017;2017;01;17;Perjantai;4;12;16;3;2;5
109;20.01.2017;2017;01;18;Perjantai;4;7;11;4;2;6
109;20.01.2017;2017;01;19;Perjantai;1;1;2;2;7;9
109;20.01.2017;2017;01;20;Perjantai;8;7;15;5;0;5
109;20.01.2017;2017;01;21;Perjantai;2;8;10;1;0;1
109;20.01.2017;2017;01;22;Perjantai;0;1;1;0;2;2
109;20.01.2017;2017;01;23;Perjantai;2;1;3;1;1;2
109;21.01.2017;2017;01;00;Lauantai;1;0;1;0;1;1
109;21.01.2017;2017;01;01;Lauantai;0;0;0;0;0;0
109;21.01.2017;2017;01;02;Lauantai;0;1;1;1;0;1
109;21.01.2017;2017;01;03;Lauantai;0;1;1;0;0;0
109;21.01.2017;2017;01;04;Lauantai;0;1;1;0;0;0
109;21.01.2017;2017;01;05;Lauantai;0;2;2;0;0;0
109;21.01.2017;2017;01;06;Lauantai;0;1;1;0;0;0
109;21.01.2017;2017;01;07;Lauantai;2;1;3;6;3;9
109;21.01.2017;2017;01;08;Lauantai;1;2;3;4;2;6
109;21.01.2017;2017;01;09;Lauantai;4;3;7;5;1;6
109;21.01.2017;2017;01;10;Lauantai;3;3;6;2;4;6
109;21.01.2017;2017;01;11;Lauantai;7;0;7;6;4;10
109;21.01.2017;2017;01;12;Lauantai;2;4;6;7;3;10
109;21.01.2017;2017;01;13;Lauantai;1;3;4;10;6;16
109;21.01.2017;2017;01;14;Lauantai;5;6;11;9;5;14
109;21.01.2017;2017;01;15;Lauantai;4;3;7;5;7;12
109;21.01.2017;2017;01;16;Lauantai;4;2;6;4;2;6
109;21.01.2017;2017;01;17;Lauantai;2;2;4;2;4;6
109;21.01.2017;2017;01;18;Lauantai;1;3;4;4;5;9
109;21.01.2017;2017;01;19;Lauantai;2;1;3;5;0;5
109;21.01.2017;2017;01;20;Lauantai;3;1;4;0;5;5
109;21.01.2017;2017;01;21;Lauantai;2;0;2;4;0;4
109;21.01.2017;2017;01;22;Lauantai;0;2;2;0;1;1
109;21.01.2017;2017;01;23;Lauantai;0;1;1;0;0;0
109;22.01.2017;2017;01;00;Sunnuntai;0;0;0;0;0;0
109;22.01.2017;2017;01;01;Sunnuntai;1;1;2;0;0;0
109;22.01.2017;2017;01;02;Sunnuntai;0;0;0;0;0;0
109;22.01.2017;2017;01;03;Sunnuntai;1;0;1;0;0;0
109;22.01.2017;2017;01;04;Sunnuntai;0;2;2;0;0;0
109;22.01.2017;2017;01;05;Sunnuntai;0;2;2;0;0;0
109;22.01.2017;2017;01;06;Sunnuntai;2;0;2;0;1;1
109;22.01.2017;2017;01;07;Sunnuntai;1;3;4;2;1;3
109;22.01.2017;2017;01;08;Sunnuntai;3;1;4;0;0;0
109;22.01.2017;2017;01;09;Sunnuntai;1;1;2;3;2;5
109;22.01.2017;2017;01;10;Sunnuntai;5;1;6;5;4;9
109;22.01.2017;2017;01;11;Sunnuntai;5;5;10;12;0;12
109;22.01.2017;2017;01;12;Sunnuntai;3;0;3;6;5;11
109;22.01.2017;2017;01;13;Sunnuntai;7;7;14;7;5;12
109;22.01.2017;2017;01;14;Sunnuntai;3;1;4;3;4;7
109;22.01.2017;2017;01;15;Sunnuntai;7;4;11;8;2;10
109;22.01.2017;2017;01;16;Sunnuntai;6;2;8;8;4;12
109;22.01.2017;2017;01;17;Sunnuntai;2;2;4;3;1;4
109;22.01.2017;2017;01;18;Sunnuntai;7;0;7;9;7;16
109;22.01.2017;2017;01;19;Sunnuntai;2;2;4;3;4;7
109;22.01.2017;2017;01;20;Sunnuntai;2;3;5;0;0;0
109;22.01.2017;2017;01;21;Sunnuntai;2;3;5;1;1;2
109;22.01.2017;2017;01;22;Sunnuntai;3;0;3;0;0;0
109;22.01.2017;2017;01;23;Sunnuntai;0;0;0;0;0;0
109;23.01.2017;2017;01;00;Maanantai;1;0;1;1;0;1
109;23.01.2017;2017;01;01;Maanantai;0;0;0;0;0;0
109;23.01.2017;2017;01;02;Maanantai;0;0;0;0;0;0
109;23.01.2017;2017;01;03;Maanantai;0;0;0;0;0;0
109;23.01.2017;2017;01;04;Maanantai;0;0;0;0;0;0
109;23.01.2017;2017;01;05;Maanantai;6;3;9;1;0;1
109;23.01.2017;2017;01;06;Maanantai;17;15;32;3;0;3
109;23.01.2017;2017;01;07;Maanantai;46;45;91;5;4;9
109;23.01.2017;2017;01;08;Maanantai;21;19;40;6;4;10
109;23.01.2017;2017;01;09;Maanantai;8;6;14;2;1;3
109;23.01.2017;2017;01;10;Maanantai;7;6;13;2;1;3
109;23.01.2017;2017;01;11;Maanantai;11;8;19;1;0;1
109;23.01.2017;2017;01;12;Maanantai;9;5;14;2;4;6
109;23.01.2017;2017;01;13;Maanantai;13;11;24;5;5;10
109;23.01.2017;2017;01;14;Maanantai;9;8;17;2;6;8
109;23.01.2017;2017;01;15;Maanantai;26;21;47;12;6;18
109;23.01.2017;2017;01;16;Maanantai;37;31;68;7;4;11
109;23.01.2017;2017;01;17;Maanantai;16;13;29;5;2;7
109;23.01.2017;2017;01;18;Maanantai;10;6;16;3;1;4
109;23.01.2017;2017;01;19;Maanantai;7;4;11;5;7;12
109;23.01.2017;2017;01;20;Maanantai;4;2;6;4;4;8
109;23.01.2017;2017;01;21;Maanantai;7;4;11;3;1;4
109;23.01.2017;2017;01;22;Maanantai;2;1;3;2;0;2
109;23.01.2017;2017;01;23;Maanantai;0;0;0;0;2;2
109;24.01.2017;2017;01;00;Tiistai;0;0;0;0;0;0
109;24.01.2017;2017;01;01;Tiistai;0;0;0;0;0;0
109;24.01.2017;2017;01;02;Tiistai;1;0;1;0;0;0
109;24.01.2017;2017;01;03;Tiistai;0;0;0;0;0;0
109;24.01.2017;2017;01;04;Tiistai;2;0;2;0;0;0
109;24.01.2017;2017;01;05;Tiistai;7;2;9;0;0;0
109;24.01.2017;2017;01;06;Tiistai;15;11;26;3;0;3
109;24.01.2017;2017;01;07;Tiistai;47;33;80;4;5;9
109;24.01.2017;2017;01;08;Tiistai;22;15;37;2;2;4
109;24.01.2017;2017;01;09;Tiistai;7;3;10;4;2;6
109;24.01.2017;2017;01;10;Tiistai;7;1;8;6;1;7
109;24.01.2017;2017;01;11;Tiistai;10;4;14;3;5;8
109;24.01.2017;2017;01;12;Tiistai;5;5;10;6;2;8
109;24.01.2017;2017;01;13;Tiistai;9;5;14;2;4;6
109;24.01.2017;2017;01;14;Tiistai;12;10;22;3;5;8
109;24.01.2017;2017;01;15;Tiistai;22;17;39;4;5;9
109;24.01.2017;2017;01;16;Tiistai;30;24;54;6;6;12
109;24.01.2017;2017;01;17;Tiistai;16;13;29;9;4;13
109;24.01.2017;2017;01;18;Tiistai;7;4;11;6;2;8
109;24.01.2017;2017;01;19;Tiistai;3;1;4;4;4;8
109;24.01.2017;2017;01;20;Tiistai;6;3;9;4;4;8
109;24.01.2017;2017;01;21;Tiistai;1;1;2;0;4;4
109;24.01.2017;2017;01;22;Tiistai;3;1;4;0;0;0
109;24.01.2017;2017;01;23;Tiistai;1;0;1;0;0;0
109;25.01.2017;2017;01;00;Keskiviikko;0;0;0;0;0;0
109;25.01.2017;2017;01;01;Keskiviikko;0;0;0;0;0;0
109;25.01.2017;2017;01;02;Keskiviikko;0;0;0;0;0;0
109;25.01.2017;2017;01;03;Keskiviikko;0;0;0;0;0;0
109;25.01.2017;2017;01;04;Keskiviikko;1;0;1;0;0;0
109;25.01.2017;2017;01;05;Keskiviikko;3;2;5;0;0;0
109;25.01.2017;2017;01;06;Keskiviikko;13;11;24;4;1;5
109;25.01.2017;2017;01;07;Keskiviikko;41;37;78;10;2;12
109;25.01.2017;2017;01;08;Keskiviikko;23;18;41;3;6;9
109;25.01.2017;2017;01;09;Keskiviikko;8;5;13;3;1;4
109;25.01.2017;2017;01;10;Keskiviikko;6;3;9;5;1;6
109;25.01.2017;2017;01;11;Keskiviikko;7;4;11;3;7;10
109;25.01.2017;2017;01;12;Keskiviikko;9;8;17;3;3;6
109;25.01.2017;2017;01;13;Keskiviikko;4;6;10;4;5;9
109;25.01.2017;2017;01;14;Keskiviikko;11;9;20;3;2;5
109;25.01.2017;2017;01;15;Keskiviikko;21;18;39;1;0;1
109;25.01.2017;2017;01;16;Keskiviikko;34;33;67;4;1;5
109;25.01.2017;2017;01;17;Keskiviikko;16;14;30;2;1;3
109;25.01.2017;2017;01;18;Keskiviikko;7;5;12;6;6;12
109;25.01.2017;2017;01;19;Keskiviikko;3;2;5;1;6;7
109;25.01.2017;2017;01;20;Keskiviikko;6;3;9;8;4;12
109;25.01.2017;2017;01;21;Keskiviikko;3;3;6;1;3;4
109;25.01.2017;2017;01;22;Keskiviikko;2;0;2;1;0;1
109;25.01.2017;2017;01;23;Keskiviikko;0;0;0;0;0;0
109;26.01.2017;2017;01;00;Torstai;0;0;0;0;0;0
109;26.01.2017;2017;01;01;Torstai;0;0;0;0;1;1
109;26.01.2017;2017;01;02;Torstai;1;0;1;0;0;0
109;26.01.2017;2017;01;03;Torstai;0;0;0;0;0;0
109;26.01.2017;2017;01;04;Torstai;2;0;2;0;0;0
109;26.01.2017;2017;01;05;Torstai;0;3;3;0;0;0
109;26.01.2017;2017;01;06;Torstai;19;14;33;2;1;3
109;26.01.2017;2017;01;07;Torstai;50;19;69;7;3;10
109;26.01.2017;2017;01;08;Torstai;31;6;37;1;3;4
109;26.01.2017;2017;01;09;Torstai;9;9;18;2;4;6
109;26.01.2017;2017;01;10;Torstai;7;1;8;5;3;8
109;26.01.2017;2017;01;11;Torstai;5;6;11;3;4;7
109;26.01.2017;2017;01;12;Torstai;11;13;24;1;3;4
109;26.01.2017;2017;01;13;Torstai;7;16;23;4;2;6
109;26.01.2017;2017;01;14;Torstai;7;11;18;8;4;12
109;26.01.2017;2017;01;15;Torstai;18;28;46;6;5;11
109;26.01.2017;2017;01;16;Torstai;24;41;65;3;4;7
109;26.01.2017;2017;01;17;Torstai;5;18;23;3;5;8
109;26.01.2017;2017;01;18;Torstai;6;8;14;4;3;7
109;26.01.2017;2017;01;19;Torstai;1;5;6;3;4;7
109;26.01.2017;2017;01;20;Torstai;6;1;7;3;3;6
109;26.01.2017;2017;01;21;Torstai;2;6;8;0;3;3
109;26.01.2017;2017;01;22;Torstai;3;1;4;0;2;2
109;26.01.2017;2017;01;23;Torstai;0;0;0;1;0;1
109;27.01.2017;2017;01;00;Perjantai;0;0;0;0;0;0
109;27.01.2017;2017;01;01;Perjantai;0;0;0;0;0;0
109;27.01.2017;2017;01;02;Perjantai;1;0;1;0;0;0
109;27.01.2017;2017;01;03;Perjantai;0;0;0;0;0;0
109;27.01.2017;2017;01;04;Perjantai;1;0;1;0;0;0
109;27.01.2017;2017;01;05;Perjantai;1;3;4;1;1;2
109;27.01.2017;2017;01;06;Perjantai;19;14;33;4;2;6
109;27.01.2017;2017;01;07;Perjantai;57;14;71;6;2;8
109;27.01.2017;2017;01;08;Perjantai;32;9;41;2;3;5
109;27.01.2017;2017;01;09;Perjantai;9;4;13;1;4;5
109;27.01.2017;2017;01;10;Perjantai;5;4;9;5;4;9
109;27.01.2017;2017;01;11;Perjantai;8;2;10;4;2;6
109;27.01.2017;2017;01;12;Perjantai;12;10;22;5;3;8
109;27.01.2017;2017;01;13;Perjantai;8;14;22;5;1;6
109;27.01.2017;2017;01;14;Perjantai;8;21;29;5;1;6
109;27.01.2017;2017;01;15;Perjantai;15;33;48;5;4;9
109;27.01.2017;2017;01;16;Perjantai;16;35;51;3;3;6
109;27.01.2017;2017;01;17;Perjantai;7;12;19;5;5;10
109;27.01.2017;2017;01;18;Perjantai;3;10;13;3;1;4
109;27.01.2017;2017;01;19;Perjantai;4;4;8;2;4;6
109;27.01.2017;2017;01;20;Perjantai;4;2;6;4;2;6
109;27.01.2017;2017;01;21;Perjantai;8;6;14;1;1;2
109;27.01.2017;2017;01;22;Perjantai;1;1;2;0;0;0
109;27.01.2017;2017;01;23;Perjantai;1;3;4;1;1;2
109;28.01.2017;2017;01;00;Lauantai;0;0;0;0;1;1
109;28.01.2017;2017;01;01;Lauantai;3;0;3;0;0;0
109;28.01.2017;2017;01;02;Lauantai;0;0;0;0;0;0
109;28.01.2017;2017;01;03;Lauantai;0;2;2;1;0;1
109;28.01.2017;2017;01;04;Lauantai;0;0;0;0;0;0
109;28.01.2017;2017;01;05;Lauantai;1;0;1;0;0;0
109;28.01.2017;2017;01;06;Lauantai;2;0;2;2;1;3
109;28.01.2017;2017;01;07;Lauantai;1;2;3;2;0;2
109;28.01.2017;2017;01;08;Lauantai;2;2;4;0;2;2
109;28.01.2017;2017;01;09;Lauantai;2;0;2;2;1;3
109;28.01.2017;2017;01;10;Lauantai;5;1;6;1;1;2
109;28.01.2017;2017;01;11;Lauantai;5;0;5;1;0;1
109;28.01.2017;2017;01;12;Lauantai;8;3;11;4;0;4
109;28.01.2017;2017;01;13;Lauantai;7;7;14;4;1;5
109;28.01.2017;2017;01;14;Lauantai;5;2;7;2;3;5
109;28.01.2017;2017;01;15;Lauantai;3;2;5;3;3;6
109;28.01.2017;2017;01;16;Lauantai;5;2;7;2;2;4
109;28.01.2017;2017;01;17;Lauantai;5;8;13;4;0;4
109;28.01.2017;2017;01;18;Lauantai;8;2;10;3;4;7
109;28.01.2017;2017;01;19;Lauantai;2;2;4;4;2;6
109;28.01.2017;2017;01;20;Lauantai;3;1;4;3;1;4
109;28.01.2017;2017;01;21;Lauantai;2;7;9;0;0;0
109;28.01.2017;2017;01;22;Lauantai;0;1;1;0;0;0
109;28.01.2017;2017;01;23;Lauantai;0;2;2;1;0;1
109;29.01.2017;2017;01;00;Sunnuntai;1;1;2;0;0;0
109;29.01.2017;2017;01;01;Sunnuntai;1;0;1;1;1;2
109;29.01.2017;2017;01;02;Sunnuntai;0;0;0;0;0;0
109;29.01.2017;2017;01;03;Sunnuntai;0;3;3;1;0;1
109;29.01.2017;2017;01;04;Sunnuntai;0;2;2;0;0;0
109;29.01.2017;2017;01;05;Sunnuntai;0;1;1;0;0;0
109;29.01.2017;2017;01;06;Sunnuntai;3;0;3;1;0;1
109;29.01.2017;2017;01;07;Sunnuntai;0;2;2;6;1;7
109;29.01.2017;2017;01;08;Sunnuntai;0;1;1;2;2;4
109;29.01.2017;2017;01;09;Sunnuntai;5;2;7;1;4;5
109;29.01.2017;2017;01;10;Sunnuntai;1;3;4;8;4;12
109;29.01.2017;2017;01;11;Sunnuntai;4;3;7;9;2;11
109;29.01.2017;2017;01;12;Sunnuntai;8;7;15;6;5;11
109;29.01.2017;2017;01;13;Sunnuntai;7;2;9;9;5;14
109;29.01.2017;2017;01;14;Sunnuntai;5;5;10;8;5;13
109;29.01.2017;2017;01;15;Sunnuntai;7;5;12;3;1;4
109;29.01.2017;2017;01;16;Sunnuntai;9;4;13;3;3;6
109;29.01.2017;2017;01;17;Sunnuntai;4;4;8;5;6;11
109;29.01.2017;2017;01;18;Sunnuntai;2;5;7;4;3;7
109;29.01.2017;2017;01;19;Sunnuntai;5;4;9;4;8;12
109;29.01.2017;2017;01;20;Sunnuntai;3;2;5;2;1;3
109;29.01.2017;2017;01;21;Sunnuntai;3;1;4;2;5;7
109;29.01.2017;2017;01;22;Sunnuntai;0;0;0;0;0;0
109;29.01.2017;2017;01;23;Sunnuntai;0;0;0;0;0;0
109;30.01.2017;2017;01;00;Maanantai;0;0;0;0;0;0
109;30.01.2017;2017;01;01;Maanantai;0;0;0;0;0;0
109;30.01.2017;2017;01;02;Maanantai;0;1;1;0;0;0
109;30.01.2017;2017;01;03;Maanantai;0;0;0;0;0;0
109;30.01.2017;2017;01;04;Maanantai;2;0;2;0;0;0
109;30.01.2017;2017;01;05;Maanantai;1;2;3;1;3;4
109;30.01.2017;2017;01;06;Maanantai;15;15;30;2;0;2
109;30.01.2017;2017;01;07;Maanantai;71;17;88;7;4;11
109;30.01.2017;2017;01;08;Maanantai;24;13;37;3;2;5
109;30.01.2017;2017;01;09;Maanantai;13;2;15;6;3;9
109;30.01.2017;2017;01;10;Maanantai;1;2;3;2;3;5
109;30.01.2017;2017;01;11;Maanantai;5;5;10;4;0;4
109;30.01.2017;2017;01;12;Maanantai;14;9;23;2;2;4
109;30.01.2017;2017;01;13;Maanantai;13;12;25;5;4;9
109;30.01.2017;2017;01;14;Maanantai;8;15;23;8;4;12
109;30.01.2017;2017;01;15;Maanantai;15;35;50;12;9;21
109;30.01.2017;2017;01;16;Maanantai;26;50;76;2;2;4
109;30.01.2017;2017;01;17;Maanantai;8;32;40;3;2;5
109;30.01.2017;2017;01;18;Maanantai;4;12;16;11;6;17
109;30.01.2017;2017;01;19;Maanantai;5;1;6;2;8;10
109;30.01.2017;2017;01;20;Maanantai;4;4;8;3;4;7
109;30.01.2017;2017;01;21;Maanantai;2;3;5;7;3;10
109;30.01.2017;2017;01;22;Maanantai;2;2;4;2;0;2
109;30.01.2017;2017;01;23;Maanantai;1;1;2;1;0;1
109;31.01.2017;2017;01;00;Tiistai;0;0;0;0;0;0
109;31.01.2017;2017;01;01;Tiistai;0;0;0;0;0;0
109;31.01.2017;2017;01;02;Tiistai;0;0;0;0;0;0
109;31.01.2017;2017;01;03;Tiistai;0;0;0;0;0;0
109;31.01.2017;2017;01;04;Tiistai;1;1;2;0;0;0
109;31.01.2017;2017;01;05;Tiistai;3;2;5;1;1;2
109;31.01.2017;2017;01;06;Tiistai;23;16;39;2;1;3
109;31.01.2017;2017;01;07;Tiistai;57;18;75;5;8;13
109;31.01.2017;2017;01;08;Tiistai;31;9;40;4;5;9
109;31.01.2017;2017;01;09;Tiistai;10;6;16;7;4;11
109;31.01.2017;2017;01;10;Tiistai;8;1;9;4;3;7
109;31.01.2017;2017;01;11;Tiistai;10;6;16;10;6;16
109;31.01.2017;2017;01;12;Tiistai;13;5;18;3;3;6
109;31.01.2017;2017;01;13;Tiistai;11;15;26;4;8;12
109;31.01.2017;2017;01;14;Tiistai;8;10;18;4;7;11
109;31.01.2017;2017;01;15;Tiistai;12;33;45;6;2;8
109;31.01.2017;2017;01;16;Tiistai;29;41;70;10;9;19
109;31.01.2017;2017;01;17;Tiistai;9;18;27;1;2;3
109;31.01.2017;2017;01;18;Tiistai;1;12;13;6;4;10
109;31.01.2017;2017;01;19;Tiistai;1;5;6;1;7;8
109;31.01.2017;2017;01;20;Tiistai;3;7;10;3;2;5
109;31.01.2017;2017;01;21;Tiistai;2;4;6;1;3;4
109;31.01.2017;2017;01;22;Tiistai;3;4;7;0;0;0
109;31.01.2017;2017;01;23;Tiistai;0;0;0;1;0;1
109;01.02.2017;2017;02;00;Keskiviikko;0;0;0;0;0;0
109;01.02.2017;2017;02;01;Keskiviikko;0;0;0;0;0;0
109;01.02.2017;2017;02;02;Keskiviikko;0;0;0;0;0;0
109;01.02.2017;2017;02;03;Keskiviikko;1;0;1;0;0;0
109;01.02.2017;2017;02;04;Keskiviikko;0;0;0;0;0;0
109;01.02.2017;2017;02;05;Keskiviikko;2;5;7;0;1;1
109;01.02.2017;2017;02;06;Keskiviikko;20;12;32;1;1;2
109;01.02.2017;2017;02;07;Keskiviikko;53;20;73;3;1;4
109;01.02.2017;2017;02;08;Keskiviikko;35;6;41;7;2;9
109;01.02.2017;2017;02;09;Keskiviikko;6;8;14;3;4;7
109;01.02.2017;2017;02;10;Keskiviikko;6;1;7;1;5;6
109;01.02.2017;2017;02;11;Keskiviikko;4;9;13;7;1;8
109;01.02.2017;2017;02;12;Keskiviikko;10;9;19;1;1;2
109;01.02.2017;2017;02;13;Keskiviikko;8;6;14;4;2;6
109;01.02.2017;2017;02;14;Keskiviikko;13;19;32;2;3;5
109;01.02.2017;2017;02;15;Keskiviikko;18;24;42;8;3;11
109;01.02.2017;2017;02;16;Keskiviikko;19;45;64;9;6;15
109;01.02.2017;2017;02;17;Keskiviikko;9;21;30;2;8;10
109;01.02.2017;2017;02;18;Keskiviikko;5;14;19;5;4;9
109;01.02.2017;2017;02;19;Keskiviikko;3;2;5;6;5;11
109;01.02.2017;2017;02;20;Keskiviikko;5;7;12;2;1;3
109;01.02.2017;2017;02;21;Keskiviikko;4;1;5;2;2;4
109;01.02.2017;2017;02;22;Keskiviikko;2;1;3;1;0;1
109;01.02.2017;2017;02;23;Keskiviikko;1;1;2;2;0;2
109;02.02.2017;2017;02;00;Torstai;0;0;0;0;0;0
109;02.02.2017;2017;02;01;Torstai;0;0;0;0;1;1
109;02.02.2017;2017;02;02;Torstai;1;0;1;0;0;0
109;02.02.2017;2017;02;03;Torstai;0;0;0;0;0;0
109;02.02.2017;2017;02;04;Torstai;1;0;1;1;1;2
109;02.02.2017;2017;02;05;Torstai;3;4;7;0;2;2
109;02.02.2017;2017;02;06;Torstai;12;11;23;2;2;4
109;02.02.2017;2017;02;07;Torstai;52;18;70;6;2;8
109;02.02.2017;2017;02;08;Torstai;36;11;47;4;2;6
109;02.02.2017;2017;02;09;Torstai;11;4;15;4;2;6
109;02.02.2017;2017;02;10;Torstai;6;3;9;5;3;8
109;02.02.2017;2017;02;11;Torstai;5;4;9;3;4;7
109;02.02.2017;2017;02;12;Torstai;7;6;13;1;3;4
109;02.02.2017;2017;02;13;Torstai;12;9;21;4;2;6
109;02.02.2017;2017;02;14;Torstai;14;11;25;8;4;12
109;02.02.2017;2017;02;15;Torstai;25;21;46;6;5;11
109;02.02.2017;2017;02;16;Torstai;31;29;60;3;4;7
109;02.02.2017;2017;02;17;Torstai;13;11;24;3;5;8
109;02.02.2017;2017;02;18;Torstai;4;2;6;4;3;7
109;02.02.2017;2017;02;19;Torstai;2;2;4;3;4;7
109;02.02.2017;2017;02;20;Torstai;7;3;10;3;3;6
109;02.02.2017;2017;02;21;Torstai;5;2;7;0;3;3
109;02.02.2017;2017;02;22;Torstai;1;0;1;0;2;2
109;02.02.2017;2017;02;23;Torstai;1;0;1;1;0;1
109;03.02.2017;2017;02;00;Perjantai;0;0;0;0;0;0
109;03.02.2017;2017;02;01;Perjantai;0;0;0;0;0;0
109;03.02.2017;2017;02;02;Perjantai;0;0;0;0;0;0
109;03.02.2017;2017;02;03;Perjantai;0;0;0;0;0;0
109;03.02.2017;2017;02;04;Perjantai;0;0;0;0;0;0
109;03.02.2017;2017;02;05;Perjantai;3;0;3;1;1;2
109;03.02.2017;2017;02;06;Perjantai;10;6;16;4;2;6
109;03.02.2017;2017;02;07;Perjantai;24;22;46;6;2;8
109;03.02.2017;2017;02;08;Perjantai;20;19;39;2;3;5
109;03.02.2017;2017;02;09;Perjantai;8;7;15;1;4;5
109;03.02.2017;2017;02;10;Perjantai;5;3;8;5;4;9
109;03.02.2017;2017;02;11;Perjantai;8;8;16;4;2;6
109;03.02.2017;2017;02;12;Perjantai;8;6;14;5;3;8
109;03.02.2017;2017;02;13;Perjantai;10;9;19;5;1;6
109;03.02.2017;2017;02;14;Perjantai;14;12;26;5;1;6
109;03.02.2017;2017;02;15;Perjantai;17;13;30;5;4;9
109;03.02.2017;2017;02;16;Perjantai;24;22;46;3;3;6
109;03.02.2017;2017;02;17;Perjantai;11;9;20;5;5;10
109;03.02.2017;2017;02;18;Perjantai;5;3;8;3;1;4
109;03.02.2017;2017;02;19;Perjantai;6;2;8;2;4;6
109;03.02.2017;2017;02;20;Perjantai;6;3;9;4;2;6
109;03.02.2017;2017;02;21;Perjantai;3;2;5;1;1;2
109;03.02.2017;2017;02;22;Perjantai;3;2;5;0;0;0
109;03.02.2017;2017;02;23;Perjantai;0;0;0;1;1;2
109;04.02.2017;2017;02;00;Lauantai;1;0;1;0;1;1
109;04.02.2017;2017;02;01;Lauantai;0;0;0;0;0;0
109;04.02.2017;2017;02;02;Lauantai;0;0;0;0;0;0
109;04.02.2017;2017;02;03;Lauantai;0;0;0;1;0;1
109;04.02.2017;2017;02;04;Lauantai;0;0;0;0;0;0
109;04.02.2017;2017;02;05;Lauantai;0;0;0;0;0;0
109;04.02.2017;2017;02;06;Lauantai;4;2;6;2;1;3
109;04.02.2017;2017;02;07;Lauantai;4;1;5;2;0;2
109;04.02.2017;2017;02;08;Lauantai;1;0;1;0;2;2
109;04.02.2017;2017;02;09;Lauantai;3;2;5;2;1;3
109;04.02.2017;2017;02;10;Lauantai;5;3;8;1;1;2
109;04.02.2017;2017;02;11;Lauantai;6;4;10;1;0;1
109;04.02.2017;2017;02;12;Lauantai;4;1;5;4;0;4
109;04.02.2017;2017;02;13;Lauantai;6;3;9;4;1;5
109;04.02.2017;2017;02;14;Lauantai;6;3;9;2;3;5
109;04.02.2017;2017;02;15;Lauantai;6;4;10;3;3;6
109;04.02.2017;2017;02;16;Lauantai;5;3;8;2;2;4
109;04.02.2017;2017;02;17;Lauantai;3;3;6;4;0;4
109;04.02.2017;2017;02;18;Lauantai;4;1;5;3;4;7
109;04.02.2017;2017;02;19;Lauantai;4;1;5;4;2;6
109;04.02.2017;2017;02;20;Lauantai;1;1;2;3;1;4
109;04.02.2017;2017;02;21;Lauantai;2;1;3;0;0;0
109;04.02.2017;2017;02;22;Lauantai;0;0;0;0;0;0
109;04.02.2017;2017;02;23;Lauantai;2;0;2;1;0;1
109;05.02.2017;2017;02;00;Sunnuntai;2;1;3;0;0;0
109;05.02.2017;2017;02;01;Sunnuntai;0;0;0;1;1;2
109;05.02.2017;2017;02;02;Sunnuntai;0;0;0;0;0;0
109;05.02.2017;2017;02;03;Sunnuntai;0;0;0;1;0;1
109;05.02.2017;2017;02;04;Sunnuntai;2;0;2;0;0;0
109;05.02.2017;2017;02;05;Sunnuntai;2;1;3;0;0;0
109;05.02.2017;2017;02;06;Sunnuntai;1;1;2;1;0;1
109;05.02.2017;2017;02;07;Sunnuntai;3;1;4;6;1;7
109;05.02.2017;2017;02;08;Sunnuntai;2;0;2;2;2;4
109;05.02.2017;2017;02;09;Sunnuntai;2;1;3;1;4;5
109;05.02.2017;2017;02;10;Sunnuntai;2;1;3;8;4;12
109;05.02.2017;2017;02;11;Sunnuntai;3;3;6;9;2;11
109;05.02.2017;2017;02;12;Sunnuntai;4;1;5;6;5;11
109;05.02.2017;2017;02;13;Sunnuntai;5;4;9;9;5;14
109;05.02.2017;2017;02;14;Sunnuntai;5;3;8;8;5;13
109;05.02.2017;2017;02;15;Sunnuntai;6;3;9;3;1;4
109;05.02.2017;2017;02;16;Sunnuntai;6;3;9;3;3;6
109;05.02.2017;2017;02;17;Sunnuntai;3;2;5;5;6;11
109;05.02.2017;2017;02;18;Sunnuntai;4;3;7;4;3;7
109;05.02.2017;2017;02;19;Sunnuntai;4;0;4;4;8;12
109;05.02.2017;2017;02;20;Sunnuntai;5;3;8;2;1;3
109;05.02.2017;2017;02;21;Sunnuntai;3;2;5;2;5;7
109;05.02.2017;2017;02;22;Sunnuntai;1;0;1;0;0;0
109;05.02.2017;2017;02;23;Sunnuntai;0;0;0;0;0;0
109;06.02.2017;2017;02;00;Maanantai;2;0;2;0;0;0
109;06.02.2017;2017;02;01;Maanantai;0;0;0;0;0;0
109;06.02.2017;2017;02;02;Maanantai;0;0;0;0;0;0
109;06.02.2017;2017;02;03;Maanantai;1;0;1;0;0;0
109;06.02.2017;2017;02;04;Maanantai;0;0;0;0;0;0
109;06.02.2017;2017;02;05;Maanantai;4;3;7;1;3;4
109;06.02.2017;2017;02;06;Maanantai;15;15;30;2;0;2
109;06.02.2017;2017;02;07;Maanantai;37;35;72;7;4;11
109;06.02.2017;2017;02;08;Maanantai;27;24;51;3;2;5
109;06.02.2017;2017;02;09;Maanantai;8;6;14;6;3;9
109;06.02.2017;2017;02;10;Maanantai;6;5;11;2;3;5
109;06.02.2017;2017;02;11;Maanantai;7;5;12;4;0;4
109;06.02.2017;2017;02;12;Maanantai;7;5;12;2;2;4
109;06.02.2017;2017;02;13;Maanantai;9;8;17;5;4;9
109;06.02.2017;2017;02;14;Maanantai;9;8;17;8;4;12
109;06.02.2017;2017;02;15;Maanantai;31;30;61;12;9;21
109;06.02.2017;2017;02;16;Maanantai;35;34;69;2;2;4
109;06.02.2017;2017;02;17;Maanantai;17;13;30;3;2;5
109;06.02.2017;2017;02;18;Maanantai;8;4;12;11;6;17
109;06.02.2017;2017;02;19;Maanantai;4;4;8;2;8;10
109;06.02.2017;2017;02;20;Maanantai;6;5;11;3;4;7
109;06.02.2017;2017;02;21;Maanantai;6;3;9;7;3;10
109;06.02.2017;2017;02;22;Maanantai;4;4;8;2;0;2
109;06.02.2017;2017;02;23;Maanantai;0;0;0;1;0;1
109;07.02.2017;2017;02;00;Tiistai;0;0;0;0;0;0
109;07.02.2017;2017;02;01;Tiistai;0;0;0;0;0;0
109;07.02.2017;2017;02;02;Tiistai;0;0;0;0;0;0
109;07.02.2017;2017;02;03;Tiistai;0;0;0;0;0;0
109;07.02.2017;2017;02;04;Tiistai;2;0;2;0;0;0
109;07.02.2017;2017;02;05;Tiistai;4;3;7;1;1;2
109;07.02.2017;2017;02;06;Tiistai;16;14;30;2;1;3
109;07.02.2017;2017;02;07;Tiistai;45;32;77;5;8;13
109;07.02.2017;2017;02;08;Tiistai;21;18;39;4;5;9
109;07.02.2017;2017;02;09;Tiistai;8;4;12;7;4;11
109;07.02.2017;2017;02;10;Tiistai;5;4;9;4;3;7
109;07.02.2017;2017;02;11;Tiistai;7;6;13;10;6;16
109;07.02.2017;2017;02;12;Tiistai;8;5;13;3;3;6
109;07.02.2017;2017;02;13;Tiistai;10;4;14;4;8;12
109;07.02.2017;2017;02;14;Tiistai;13;10;23;4;7;11
109;07.02.2017;2017;02;15;Tiistai;28;24;52;6;2;8
109;07.02.2017;2017;02;16;Tiistai;41;29;70;10;9;19
109;07.02.2017;2017;02;17;Tiistai;17;13;30;1;2;3
109;07.02.2017;2017;02;18;Tiistai;10;5;15;6;4;10
109;07.02.2017;2017;02;19;Tiistai;8;2;10;1;7;8
109;07.02.2017;2017;02;20;Tiistai;7;4;11;3;2;5
109;07.02.2017;2017;02;21;Tiistai;7;3;10;1;3;4
109;07.02.2017;2017;02;22;Tiistai;5;2;7;0;0;0
109;07.02.2017;2017;02;23;Tiistai;2;2;4;1;0;1
109;08.02.2017;2017;02;00;Keskiviikko;0;0;0;0;0;0
109;08.02.2017;2017;02;01;Keskiviikko;0;0;0;0;0;0
109;08.02.2017;2017;02;02;Keskiviikko;1;0;1;0;0;0
109;08.02.2017;2017;02;03;Keskiviikko;0;0;0;0;0;0
109;08.02.2017;2017;02;04;Keskiviikko;0;0;0;0;0;0
109;08.02.2017;2017;02;05;Keskiviikko;3;1;4;0;1;1
109;08.02.2017;2017;02;06;Keskiviikko;18;8;26;1;1;2
109;08.02.2017;2017;02;07;Keskiviikko;38;23;61;3;1;4
109;08.02.2017;2017;02;08;Keskiviikko;19;13;32;7;2;9
109;08.02.2017;2017;02;09;Keskiviikko;8;4;12;3;4;7
109;08.02.2017;2017;02;10;Keskiviikko;4;2;6;1;5;6
109;08.02.2017;2017;02;11;Keskiviikko;5;1;6;7;1;8
109;08.02.2017;2017;02;12;Keskiviikko;10;4;14;1;1;2
109;08.02.2017;2017;02;13;Keskiviikko;8;0;8;4;2;6
109;08.02.2017;2017;02;14;Keskiviikko;10;5;15;2;3;5
109;08.02.2017;2017;02;15;Keskiviikko;24;15;39;8;3;11
109;08.02.2017;2017;02;16;Keskiviikko;26;23;49;9;6;15
109;08.02.2017;2017;02;17;Keskiviikko;15;11;26;2;8;10
109;08.02.2017;2017;02;18;Keskiviikko;7;5;12;5;4;9
109;08.02.2017;2017;02;19;Keskiviikko;3;1;4;6;5;11
109;08.02.2017;2017;02;20;Keskiviikko;3;2;5;2;1;3
109;08.02.2017;2017;02;21;Keskiviikko;5;3;8;2;2;4
109;08.02.2017;2017;02;22;Keskiviikko;3;3;6;1;0;1
109;08.02.2017;2017;02;23;Keskiviikko;1;0;1;2;0;2
109;09.02.2017;2017;02;00;Torstai;0;0;0;0;0;0
109;09.02.2017;2017;02;01;Torstai;0;0;0;0;1;1
109;09.02.2017;2017;02;02;Torstai;0;0;0;0;0;0
109;09.02.2017;2017;02;03;Torstai;0;0;0;0;0;0
109;09.02.2017;2017;02;04;Torstai;0;0;0;1;1;2
109;09.02.2017;2017;02;05;Torstai;3;1;4;0;2;2
109;09.02.2017;2017;02;06;Torstai;8;6;14;2;2;4
109;09.02.2017;2017;02;07;Torstai;24;20;44;6;2;8
109;09.02.2017;2017;02;08;Torstai;15;12;27;4;2;6
109;09.02.2017;2017;02;09;Torstai;7;4;11;4;2;6
109;09.02.2017;2017;02;10;Torstai;6;4;10;5;3;8
109;09.02.2017;2017;02;11;Torstai;6;3;9;3;4;7
109;09.02.2017;2017;02;12;Torstai;4;4;8;1;3;4
109;09.02.2017;2017;02;13;Torstai;4;1;5;4;2;6
109;09.02.2017;2017;02;14;Torstai;9;6;15;8;4;12
109;09.02.2017;2017;02;15;Torstai;17;14;31;6;5;11
109;09.02.2017;2017;02;16;Torstai;29;26;55;3;4;7
109;09.02.2017;2017;02;17;Torstai;15;12;27;3;5;8
109;09.02.2017;2017;02;18;Torstai;9;8;17;4;3;7
109;09.02.2017;2017;02;19;Torstai;5;2;7;3;4;7
109;09.02.2017;2017;02;20;Torstai;3;1;4;3;3;6
109;09.02.2017;2017;02;21;Torstai;4;1;5;0;3;3
109;09.02.2017;2017;02;22;Torstai;2;2;4;0;2;2
109;09.02.2017;2017;02;23;Torstai;0;0;0;1;0;1
109;10.02.2017;2017;02;00;Perjantai;0;0;0;0;0;0
109;10.02.2017;2017;02;01;Perjantai;0;0;0;0;0;0
109;10.02.2017;2017;02;02;Perjantai;0;0;0;0;0;0
109;10.02.2017;2017;02;03;Perjantai;1;0;1;0;0;0
109;10.02.2017;2017;02;04;Perjantai;2;1;3;1;0;1
109;10.02.2017;2017;02;05;Perjantai;3;2;5;0;1;1
109;10.02.2017;2017;02;06;Perjantai;12;11;23;2;1;3
109;10.02.2017;2017;02;07;Perjantai;34;31;65;3;3;6
109;10.02.2017;2017;02;08;Perjantai;17;16;33;5;2;7
109;10.02.2017;2017;02;09;Perjantai;7;3;10;4;3;7
109;10.02.2017;2017;02;10;Perjantai;4;3;7;3;3;6
109;10.02.2017;2017;02;11;Perjantai;18;8;26;4;4;8
109;10.02.2017;2017;02;12;Perjantai;8;5;13;5;4;9
109;10.02.2017;2017;02;13;Perjantai;8;10;18;3;6;9
109;10.02.2017;2017;02;14;Perjantai;11;18;29;3;2;5
109;10.02.2017;2017;02;15;Perjantai;10;31;41;6;4;10
109;10.02.2017;2017;02;16;Perjantai;10;35;45;7;5;12
109;10.02.2017;2017;02;17;Perjantai;6;16;22;7;2;9
109;10.02.2017;2017;02;18;Perjantai;7;6;13;9;2;11
109;10.02.2017;2017;02;19;Perjantai;3;1;4;5;3;8
109;10.02.2017;2017;02;20;Perjantai;4;3;7;4;1;5
109;10.02.2017;2017;02;21;Perjantai;4;5;9;1;4;5
109;10.02.2017;2017;02;22;Perjantai;5;1;6;3;1;4
109;10.02.2017;2017;02;23;Perjantai;0;0;0;1;0;1
109;11.02.2017;2017;02;00;Lauantai;1;0;1;0;0;0
109;11.02.2017;2017;02;01;Lauantai;1;0;1;0;0;0
109;11.02.2017;2017;02;02;Lauantai;0;2;2;1;0;1
109;11.02.2017;2017;02;03;Lauantai;1;0;1;0;0;0
109;11.02.2017;2017;02;04;Lauantai;1;1;2;0;0;0
109;11.02.2017;2017;02;05;Lauantai;1;0;1;0;1;1
109;11.02.2017;2017;02;06;Lauantai;1;2;3;1;0;1
109;11.02.2017;2017;02;07;Lauantai;2;3;5;3;0;3
109;11.02.2017;2017;02;08;Lauantai;4;0;4;0;3;3
109;11.02.2017;2017;02;09;Lauantai;3;1;4;4;5;9
109;11.02.2017;2017;02;10;Lauantai;5;4;9;5;2;7
109;11.02.2017;2017;02;11;Lauantai;7;7;14;5;10;15
109;11.02.2017;2017;02;12;Lauantai;5;12;17;4;2;6
109;11.02.2017;2017;02;13;Lauantai;1;4;5;3;7;10
109;11.02.2017;2017;02;14;Lauantai;4;2;6;0;0;0
109;11.02.2017;2017;02;15;Lauantai;6;10;16;3;4;7
109;11.02.2017;2017;02;16;Lauantai;3;2;5;7;6;13
109;11.02.2017;2017;02;17;Lauantai;0;9;9;5;4;9
109;11.02.2017;2017;02;18;Lauantai;12;2;14;1;2;3
109;11.02.2017;2017;02;19;Lauantai;0;2;2;1;6;7
109;11.02.2017;2017;02;20;Lauantai;6;2;8;1;2;3
109;11.02.2017;2017;02;21;Lauantai;1;5;6;1;2;3
109;11.02.2017;2017;02;22;Lauantai;0;0;0;2;0;2
109;11.02.2017;2017;02;23;Lauantai;0;1;1;2;0;2
109;12.02.2017;2017;02;00;Sunnuntai;0;0;0;0;1;1
109;12.02.2017;2017;02;01;Sunnuntai;0;3;3;0;0;0
109;12.02.2017;2017;02;02;Sunnuntai;1;1;2;0;0;0
109;12.02.2017;2017;02;03;Sunnuntai;0;0;0;0;0;0
109;12.02.2017;2017;02;04;Sunnuntai;0;0;0;0;0;0
109;12.02.2017;2017;02;05;Sunnuntai;1;0;1;0;0;0
109;12.02.2017;2017;02;06;Sunnuntai;0;2;2;1;0;1
109;12.02.2017;2017;02;07;Sunnuntai;0;1;1;3;0;3
109;12.02.2017;2017;02;08;Sunnuntai;3;0;3;5;6;11
109;12.02.2017;2017;02;09;Sunnuntai;1;1;2;6;7;13
109;12.02.2017;2017;02;10;Sunnuntai;1;1;2;3;7;10
109;12.02.2017;2017;02;11;Sunnuntai;2;1;3;7;4;11
109;12.02.2017;2017;02;12;Sunnuntai;6;6;12;9;5;14
109;12.02.2017;2017;02;13;Sunnuntai;10;3;13;4;5;9
109;12.02.2017;2017;02;14;Sunnuntai;5;3;8;7;6;13
109;12.02.2017;2017;02;15;Sunnuntai;2;4;6;7;0;7
109;12.02.2017;2017;02;16;Sunnuntai;8;3;11;5;5;10
109;12.02.2017;2017;02;17;Sunnuntai;1;3;4;4;0;4
109;12.02.2017;2017;02;18;Sunnuntai;4;5;9;4;5;9
109;12.02.2017;2017;02;19;Sunnuntai;1;1;2;8;2;10
109;12.02.2017;2017;02;20;Sunnuntai;3;6;9;1;0;1
109;12.02.2017;2017;02;21;Sunnuntai;1;2;3;1;1;2
109;12.02.2017;2017;02;22;Sunnuntai;0;1;1;2;0;2
109;12.02.2017;2017;02;23;Sunnuntai;0;0;0;1;0;1
109;13.02.2017;2017;02;00;Maanantai;0;0;0;0;0;0
109;13.02.2017;2017;02;01;Maanantai;0;0;0;0;0;0
109;13.02.2017;2017;02;02;Maanantai;0;0;0;0;0;0
109;13.02.2017;2017;02;03;Maanantai;0;0;0;0;0;0
109;13.02.2017;2017;02;04;Maanantai;1;0;1;0;0;0
109;13.02.2017;2017;02;05;Maanantai;1;3;4;0;0;0
109;13.02.2017;2017;02;06;Maanantai;19;13;32;4;2;6
109;13.02.2017;2017;02;07;Maanantai;57;24;81;9;8;17
109;13.02.2017;2017;02;08;Maanantai;32;13;45;4;5;9
109;13.02.2017;2017;02;09;Maanantai;15;5;20;4;4;8
109;13.02.2017;2017;02;10;Maanantai;12;4;16;4;1;5
109;13.02.2017;2017;02;11;Maanantai;10;4;14;6;3;9
109;13.02.2017;2017;02;12;Maanantai;13;8;21;3;3;6
109;13.02.2017;2017;02;13;Maanantai;10;4;14;4;3;7
109;13.02.2017;2017;02;14;Maanantai;8;23;31;5;4;9
109;13.02.2017;2017;02;15;Maanantai;18;29;47;11;7;18
109;13.02.2017;2017;02;16;Maanantai;19;45;64;5;3;8
109;13.02.2017;2017;02;17;Maanantai;12;18;30;6;3;9
109;13.02.2017;2017;02;18;Maanantai;1;13;14;3;5;8
109;13.02.2017;2017;02;19;Maanantai;2;2;4;5;7;12
109;13.02.2017;2017;02;20;Maanantai;4;4;8;3;4;7
109;13.02.2017;2017;02;21;Maanantai;2;4;6;2;0;2
109;13.02.2017;2017;02;22;Maanantai;4;3;7;0;0;0
109;13.02.2017;2017;02;23;Maanantai;0;0;0;2;1;3
109;14.02.2017;2017;02;00;Tiistai;0;0;0;0;0;0
109;14.02.2017;2017;02;01;Tiistai;0;0;0;0;0;0
109;14.02.2017;2017;02;02;Tiistai;0;0;0;0;0;0
109;14.02.2017;2017;02;03;Tiistai;0;0;0;0;0;0
109;14.02.2017;2017;02;04;Tiistai;0;0;0;0;0;0
109;14.02.2017;2017;02;05;Tiistai;0;3;3;1;1;2
109;14.02.2017;2017;02;06;Tiistai;21;12;33;4;2;6
109;14.02.2017;2017;02;07;Tiistai;62;28;90;12;8;20
109;14.02.2017;2017;02;08;Tiistai;35;3;38;1;7;8
109;14.02.2017;2017;02;09;Tiistai;10;4;14;4;2;6
109;14.02.2017;2017;02;10;Tiistai;6;10;16;0;5;5
109;14.02.2017;2017;02;11;Tiistai;11;2;13;2;4;6
109;14.02.2017;2017;02;12;Tiistai;9;6;15;1;1;2
109;14.02.2017;2017;02;13;Tiistai;8;11;19;4;5;9
109;14.02.2017;2017;02;14;Tiistai;8;6;14;4;7;11
109;14.02.2017;2017;02;15;Tiistai;11;26;37;3;2;5
109;14.02.2017;2017;02;16;Tiistai;20;48;68;7;5;12
109;14.02.2017;2017;02;17;Tiistai;11;11;22;11;7;18
109;14.02.2017;2017;02;18;Tiistai;3;10;13;12;3;15
109;14.02.2017;2017;02;19;Tiistai;3;3;6;5;6;11
109;14.02.2017;2017;02;20;Tiistai;4;8;12;4;5;9
109;14.02.2017;2017;02;21;Tiistai;2;4;6;0;1;1
109;14.02.2017;2017;02;22;Tiistai;2;2;4;1;1;2
109;14.02.2017;2017;02;23;Tiistai;0;1;1;2;2;4
109;15.02.2017;2017;02;00;Keskiviikko;0;0;0;0;0;0
109;15.02.2017;2017;02;01;Keskiviikko;0;0;0;0;0;0
109;15.02.2017;2017;02;02;Keskiviikko;0;0;0;0;0;0
109;15.02.2017;2017;02;03;Keskiviikko;0;0;0;0;0;0
109;15.02.2017;2017;02;04;Keskiviikko;1;1;2;0;0;0
109;15.02.2017;2017;02;05;Keskiviikko;0;6;6;0;0;0
109;15.02.2017;2017;02;06;Keskiviikko;20;13;33;1;1;2
109;15.02.2017;2017;02;07;Keskiviikko;55;27;82;8;6;14
109;15.02.2017;2017;02;08;Keskiviikko;30;6;36;0;2;2
109;15.02.2017;2017;02;09;Keskiviikko;12;4;16;6;4;10
109;15.02.2017;2017;02;10;Keskiviikko;10;4;14;2;0;2
109;15.02.2017;2017;02;11;Keskiviikko;10;7;17;8;3;11
109;15.02.2017;2017;02;12;Keskiviikko;11;7;18;0;5;5
109;15.02.2017;2017;02;13;Keskiviikko;3;8;11;5;3;8
109;15.02.2017;2017;02;14;Keskiviikko;13;11;24;11;3;14
109;15.02.2017;2017;02;15;Keskiviikko;14;28;42;11;6;17
109;15.02.2017;2017;02;16;Keskiviikko;22;45;67;3;5;8
109;15.02.2017;2017;02;17;Keskiviikko;10;13;23;6;2;8
109;15.02.2017;2017;02;18;Keskiviikko;1;7;8;9;4;13
109;15.02.2017;2017;02;19;Keskiviikko;2;8;10;6;3;9
109;15.02.2017;2017;02;20;Keskiviikko;4;6;10;5;2;7
109;15.02.2017;2017;02;21;Keskiviikko;5;7;12;4;0;4
109;15.02.2017;2017;02;22;Keskiviikko;3;4;7;0;1;1
109;15.02.2017;2017;02;23;Keskiviikko;2;1;3;1;2;3
109;16.02.2017;2017;02;00;Torstai;1;0;1;0;0;0
109;16.02.2017;2017;02;01;Torstai;0;0;0;0;0;0
109;16.02.2017;2017;02;02;Torstai;0;0;0;0;0;0
109;16.02.2017;2017;02;03;Torstai;1;0;1;0;0;0
109;16.02.2017;2017;02;04;Torstai;3;0;3;0;0;0
109;16.02.2017;2017;02;05;Torstai;1;1;2;3;1;4
109;16.02.2017;2017;02;06;Torstai;20;15;35;2;2;4
109;16.02.2017;2017;02;07;Torstai;59;21;80;7;4;11
109;16.02.2017;2017;02;08;Torstai;20;7;27;8;4;12
109;16.02.2017;2017;02;09;Torstai;12;4;16;3;1;4
109;16.02.2017;2017;02;10;Torstai;9;3;12;3;6;9
109;16.02.2017;2017;02;11;Torstai;7;6;13;5;1;6
109;16.02.2017;2017;02;12;Torstai;16;12;28;0;1;1
109;16.02.2017;2017;02;13;Torstai;6;9;15;4;4;8
109;16.02.2017;2017;02;14;Torstai;10;21;31;5;6;11
109;16.02.2017;2017;02;15;Torstai;14;39;53;9;2;11
109;16.02.2017;2017;02;16;Torstai;16;41;57;2;7;9
109;16.02.2017;2017;02;17;Torstai;6;18;24;6;5;11
109;16.02.2017;2017;02;18;Torstai;5;13;18;3;5;8
109;16.02.2017;2017;02;19;Torstai;3;11;14;7;4;11
109;16.02.2017;2017;02;20;Torstai;8;3;11;3;1;4
109;16.02.2017;2017;02;21;Torstai;2;6;8;4;3;7
109;16.02.2017;2017;02;22;Torstai;1;1;2;0;1;1
109;16.02.2017;2017;02;23;Torstai;0;0;0;1;0;1
109;17.02.2017;2017;02;00;Perjantai;1;0;1;0;0;0
109;17.02.2017;2017;02;01;Perjantai;0;0;0;0;0;0
109;17.02.2017;2017;02;02;Perjantai;0;0;0;0;0;0
109;17.02.2017;2017;02;03;Perjantai;0;1;1;0;0;0
109;17.02.2017;2017;02;04;Perjantai;1;0;1;0;0;0
109;17.02.2017;2017;02;05;Perjantai;1;0;1;0;1;1
109;17.02.2017;2017;02;06;Perjantai;17;11;28;3;0;3
109;17.02.2017;2017;02;07;Perjantai;55;16;71;6;6;12
109;17.02.2017;2017;02;08;Perjantai;32;9;41;1;3;4
109;17.02.2017;2017;02;09;Perjantai;10;4;14;4;1;5
109;17.02.2017;2017;02;10;Perjantai;8;4;12;7;5;12
109;17.02.2017;2017;02;11;Perjantai;8;11;19;6;2;8
109;17.02.2017;2017;02;12;Perjantai;12;8;20;2;6;8
109;17.02.2017;2017;02;13;Perjantai;6;5;11;2;5;7
109;17.02.2017;2017;02;14;Perjantai;11;14;25;1;2;3
109;17.02.2017;2017;02;15;Perjantai;14;39;53;5;4;9
109;17.02.2017;2017;02;16;Perjantai;13;31;44;2;4;6
109;17.02.2017;2017;02;17;Perjantai;8;13;21;4;4;8
109;17.02.2017;2017;02;18;Perjantai;6;3;9;5;2;7
109;17.02.2017;2017;02;19;Perjantai;6;7;13;5;6;11
109;17.02.2017;2017;02;20;Perjantai;2;5;7;2;2;4
109;17.02.2017;2017;02;21;Perjantai;2;3;5;2;0;2
109;17.02.2017;2017;02;22;Perjantai;0;3;3;0;0;0
109;17.02.2017;2017;02;23;Perjantai;1;2;3;2;0;2
109;18.02.2017;2017;02;00;Lauantai;1;1;2;1;0;1
109;18.02.2017;2017;02;01;Lauantai;0;1;1;0;0;0
109;18.02.2017;2017;02;02;Lauantai;2;2;4;0;0;0
109;18.02.2017;2017;02;03;Lauantai;0;0;0;0;0;0
109;18.02.2017;2017;02;04;Lauantai;1;0;1;0;0;0
109;18.02.2017;2017;02;05;Lauantai;1;1;2;0;0;0
109;18.02.2017;2017;02;06;Lauantai;4;2;6;3;1;4
109;18.02.2017;2017;02;07;Lauantai;3;1;4;2;1;3
109;18.02.2017;2017;02;08;Lauantai;1;0;1;3;2;5
109;18.02.2017;2017;02;09;Lauantai;2;2;4;1;3;4
109;18.02.2017;2017;02;10;Lauantai;3;5;8;3;7;10
109;18.02.2017;2017;02;11;Lauantai;6;5;11;7;5;12
109;18.02.2017;2017;02;12;Lauantai;5;4;9;3;6;9
109;18.02.2017;2017;02;13;Lauantai;6;7;13;5;5;10
109;18.02.2017;2017;02;14;Lauantai;7;6;13;9;3;12
109;18.02.2017;2017;02;15;Lauantai;2;3;5;6;1;7
109;18.02.2017;2017;02;16;Lauantai;5;2;7;0;2;2
109;18.02.2017;2017;02;17;Lauantai;1;3;4;3;5;8
109;18.02.2017;2017;02;18;Lauantai;5;2;7;5;5;10
109;18.02.2017;2017;02;19;Lauantai;2;1;3;3;4;7
109;18.02.2017;2017;02;20;Lauantai;2;4;6;8;1;9
109;18.02.2017;2017;02;21;Lauantai;0;2;2;2;0;2
109;18.02.2017;2017;02;22;Lauantai;0;1;1;1;0;1
109;18.02.2017;2017;02;23;Lauantai;0;0;0;0;0;0
109;19.02.2017;2017;02;00;Sunnuntai;0;0;0;1;0;1
109;19.02.2017;2017;02;01;Sunnuntai;0;1;1;0;0;0
109;19.02.2017;2017;02;02;Sunnuntai;0;0;0;0;0;0
109;19.02.2017;2017;02;03;Sunnuntai;0;0;0;0;0;0
109;19.02.2017;2017;02;04;Sunnuntai;0;0;0;0;1;1
109;19.02.2017;2017;02;05;Sunnuntai;1;0;1;0;0;0
109;19.02.2017;2017;02;06;Sunnuntai;3;1;4;2;1;3
109;19.02.2017;2017;02;07;Sunnuntai;2;3;5;2;0;2
109;19.02.2017;2017;02;08;Sunnuntai;2;1;3;0;0;0
109;19.02.2017;2017;02;09;Sunnuntai;1;3;4;6;3;9
109;19.02.2017;2017;02;10;Sunnuntai;2;1;3;3;5;8
109;19.02.2017;2017;02;11;Sunnuntai;2;2;4;5;3;8
109;19.02.2017;2017;02;12;Sunnuntai;7;2;9;8;2;10
109;19.02.2017;2017;02;13;Sunnuntai;4;0;4;5;4;9
109;19.02.2017;2017;02;14;Sunnuntai;8;2;10;6;6;12
109;19.02.2017;2017;02;15;Sunnuntai;4;8;12;7;4;11
109;19.02.2017;2017;02;16;Sunnuntai;2;2;4;7;2;9
109;19.02.2017;2017;02;17;Sunnuntai;2;3;5;3;1;4
109;19.02.2017;2017;02;18;Sunnuntai;3;3;6;8;1;9
109;19.02.2017;2017;02;19;Sunnuntai;2;2;4;2;6;8
109;19.02.2017;2017;02;20;Sunnuntai;5;2;7;2;0;2
109;19.02.2017;2017;02;21;Sunnuntai;0;2;2;1;1;2
109;19.02.2017;2017;02;22;Sunnuntai;0;0;0;0;0;0
109;19.02.2017;2017;02;23;Sunnuntai;2;0;2;0;0;0
109;20.02.2017;2017;02;00;Maanantai;0;0;0;0;0;0
109;20.02.2017;2017;02;01;Maanantai;0;0;0;0;0;0
109;20.02.2017;2017;02;02;Maanantai;0;0;0;0;0;0
109;20.02.2017;2017;02;03;Maanantai;0;1;1;1;0;1
109;20.02.2017;2017;02;04;Maanantai;2;0;2;0;0;0
109;20.02.2017;2017;02;05;Maanantai;3;0;3;1;0;1
109;20.02.2017;2017;02;06;Maanantai;14;8;22;0;0;0
109;20.02.2017;2017;02;07;Maanantai;47;22;69;3;0;3
109;20.02.2017;2017;02;08;Maanantai;32;16;48;1;0;1
109;20.02.2017;2017;02;09;Maanantai;12;6;18;2;0;2
109;20.02.2017;2017;02;10;Maanantai;10;3;13;0;0;0
109;20.02.2017;2017;02;11;Maanantai;13;3;16;2;0;2
109;20.02.2017;2017;02;12;Maanantai;8;3;11;5;0;5
109;20.02.2017;2017;02;13;Maanantai;8;6;14;3;1;4
109;20.02.2017;2017;02;14;Maanantai;15;11;26;5;0;5
109;20.02.2017;2017;02;15;Maanantai;14;20;34;6;0;6
109;20.02.2017;2017;02;16;Maanantai;29;40;69;3;0;3
109;20.02.2017;2017;02;17;Maanantai;11;15;26;2;0;2
109;20.02.2017;2017;02;18;Maanantai;4;3;7;6;0;6
109;20.02.2017;2017;02;19;Maanantai;5;4;9;2;2;4
109;20.02.2017;2017;02;20;Maanantai;6;1;7;2;5;7
109;20.02.2017;2017;02;21;Maanantai;6;6;12;1;1;2
109;20.02.2017;2017;02;22;Maanantai;0;3;3;0;1;1
109;20.02.2017;2017;02;23;Maanantai;1;3;4;0;0;0
109;21.02.2017;2017;02;00;Tiistai;0;0;0;0;0;0
109;21.02.2017;2017;02;01;Tiistai;0;0;0;0;0;0
109;21.02.2017;2017;02;02;Tiistai;0;0;0;1;1;2
109;21.02.2017;2017;02;03;Tiistai;1;0;1;0;0;0
109;21.02.2017;2017;02;04;Tiistai;0;0;0;0;0;0
109;21.02.2017;2017;02;05;Tiistai;1;6;7;1;0;1
109;21.02.2017;2017;02;06;Tiistai;22;9;31;0;0;0
109;21.02.2017;2017;02;07;Tiistai;55;24;79;7;0;7
109;21.02.2017;2017;02;08;Tiistai;24;12;36;2;2;4
109;21.02.2017;2017;02;09;Tiistai;15;5;20;4;0;4
109;21.02.2017;2017;02;10;Tiistai;5;5;10;3;0;3
109;21.02.2017;2017;02;11;Tiistai;8;4;12;7;1;8
109;21.02.2017;2017;02;12;Tiistai;10;8;18;9;6;15
109;21.02.2017;2017;02;13;Tiistai;5;7;12;6;5;11
109;21.02.2017;2017;02;14;Tiistai;15;12;27;5;4;9
109;21.02.2017;2017;02;15;Tiistai;18;30;48;7;3;10
109;21.02.2017;2017;02;16;Tiistai;28;47;75;1;4;5
109;21.02.2017;2017;02;17;Tiistai;11;16;27;1;1;2
109;21.02.2017;2017;02;18;Tiistai;4;7;11;11;1;12
109;21.02.2017;2017;02;19;Tiistai;4;4;8;1;6;7
109;21.02.2017;2017;02;20;Tiistai;4;2;6;7;1;8
109;21.02.2017;2017;02;21;Tiistai;0;3;3;1;1;2
109;21.02.2017;2017;02;22;Tiistai;0;1;1;0;0;0
109;21.02.2017;2017;02;23;Tiistai;1;0;1;0;0;0
109;22.02.2017;2017;02;00;Keskiviikko;0;0;0;0;0;0
109;22.02.2017;2017;02;01;Keskiviikko;0;0;0;0;0;0
109;22.02.2017;2017;02;02;Keskiviikko;0;0;0;0;0;0
109;22.02.2017;2017;02;03;Keskiviikko;0;0;0;0;1;1
109;22.02.2017;2017;02;04;Keskiviikko;0;0;0;0;0;0
109;22.02.2017;2017;02;05;Keskiviikko;1;3;4;1;1;2
109;22.02.2017;2017;02;06;Keskiviikko;13;13;26;1;0;1
109;22.02.2017;2017;02;07;Keskiviikko;57;16;73;6;4;10
109;22.02.2017;2017;02;08;Keskiviikko;23;6;29;2;2;4
109;22.02.2017;2017;02;09;Keskiviikko;10;8;18;3;1;4
109;22.02.2017;2017;02;10;Keskiviikko;8;1;9;4;2;6
109;22.02.2017;2017;02;11;Keskiviikko;5;3;8;6;1;7
109;22.02.2017;2017;02;12;Keskiviikko;6;7;13;3;2;5
109;22.02.2017;2017;02;13;Keskiviikko;6;6;12;4;4;8
109;22.02.2017;2017;02;14;Keskiviikko;10;12;22;3;3;6
109;22.02.2017;2017;02;15;Keskiviikko;13;31;44;3;2;5
109;22.02.2017;2017;02;16;Keskiviikko;14;40;54;9;2;11
109;22.02.2017;2017;02;17;Keskiviikko;8;25;33;4;0;4
109;22.02.2017;2017;02;18;Keskiviikko;3;8;11;10;4;14
109;22.02.2017;2017;02;19;Keskiviikko;2;2;4;2;9;11
109;22.02.2017;2017;02;20;Keskiviikko;1;8;9;2;3;5
109;22.02.2017;2017;02;21;Keskiviikko;3;3;6;2;3;5
109;22.02.2017;2017;02;22;Keskiviikko;0;1;1;1;0;1
109;22.02.2017;2017;02;23;Keskiviikko;2;0;2;0;0;0
109;23.02.2017;2017;02;00;Torstai;0;0;0;0;0;0
109;23.02.2017;2017;02;01;Torstai;0;0;0;0;0;0
109;23.02.2017;2017;02;02;Torstai;0;0;0;0;0;0
109;23.02.2017;2017;02;03;Torstai;0;0;0;0;0;0
109;23.02.2017;2017;02;04;Torstai;0;0;0;0;0;0
109;23.02.2017;2017;02;05;Torstai;2;4;6;1;0;1
109;23.02.2017;2017;02;06;Torstai;20;12;32;3;0;3
109;23.02.2017;2017;02;07;Torstai;51;20;71;7;0;7
109;23.02.2017;2017;02;08;Torstai;16;11;27;0;0;0
109;23.02.2017;2017;02;09;Torstai;8;5;13;0;0;0
109;23.02.2017;2017;02;10;Torstai;4;2;6;0;0;0
109;23.02.2017;2017;02;11;Torstai;7;5;12;0;0;0
109;23.02.2017;2017;02;12;Torstai;5;4;9;0;0;0
109;23.02.2017;2017;02;13;Torstai;5;6;11;4;4;8
109;23.02.2017;2017;02;14;Torstai;6;11;17;4;5;9
109;23.02.2017;2017;02;15;Torstai;15;23;38;4;4;8
109;23.02.2017;2017;02;16;Torstai;17;51;68;9;2;11
109;23.02.2017;2017;02;17;Torstai;5;11;16;1;5;6
109;23.02.2017;2017;02;18;Torstai;3;4;7;0;1;1
109;23.02.2017;2017;02;19;Torstai;4;3;7;6;3;9
109;23.02.2017;2017;02;20;Torstai;1;2;3;6;4;10
109;23.02.2017;2017;02;21;Torstai;3;7;10;3;2;5
109;23.02.2017;2017;02;22;Torstai;1;2;3;0;1;1
109;23.02.2017;2017;02;23;Torstai;0;0;0;0;0;0
109;24.02.2017;2017;02;00;Perjantai;0;0;0;2;1;3
109;24.02.2017;2017;02;01;Perjantai;2;0;2;0;0;0
109;24.02.2017;2017;02;02;Perjantai;5;3;8;6;0;6
109;24.02.2017;2017;02;03;Perjantai;0;0;0;0;0;0
109;24.02.2017;2017;02;04;Perjantai;0;0;0;0;0;0
109;24.02.2017;2017;02;05;Perjantai;2;4;6;0;0;0
109;24.02.2017;2017;02;06;Perjantai;17;9;26;1;0;1
109;24.02.2017;2017;02;07;Perjantai;48;18;66;5;2;7
109;24.02.2017;2017;02;08;Perjantai;27;8;35;3;1;4
109;24.02.2017;2017;02;09;Perjantai;8;2;10;3;0;3
109;24.02.2017;2017;02;10;Perjantai;1;2;3;2;1;3
109;24.02.2017;2017;02;11;Perjantai;8;9;17;3;1;4
109;24.02.2017;2017;02;12;Perjantai;12;4;16;1;0;1
109;24.02.2017;2017;02;13;Perjantai;3;6;9;1;1;2
109;24.02.2017;2017;02;14;Perjantai;13;19;32;5;1;6
109;24.02.2017;2017;02;15;Perjantai;13;35;48;2;2;4
109;24.02.2017;2017;02;16;Perjantai;10;25;35;4;0;4
109;24.02.2017;2017;02;17;Perjantai;6;13;19;3;2;5
109;24.02.2017;2017;02;18;Perjantai;6;2;8;1;0;1
109;24.02.2017;2017;02;19;Perjantai;5;4;9;3;2;5
109;24.02.2017;2017;02;20;Perjantai;6;4;10;1;2;3
109;24.02.2017;2017;02;21;Perjantai;1;5;6;4;1;5
109;24.02.2017;2017;02;22;Perjantai;0;3;3;0;0;0
109;24.02.2017;2017;02;23;Perjantai;0;0;0;1;0;1
109;25.02.2017;2017;02;00;Lauantai;1;2;3;0;0;0
109;25.02.2017;2017;02;01;Lauantai;1;0;1;0;0;0
109;25.02.2017;2017;02;02;Lauantai;0;0;0;0;0;0
109;25.02.2017;2017;02;03;Lauantai;0;0;0;0;0;0
109;25.02.2017;2017;02;04;Lauantai;2;1;3;0;0;0
109;25.02.2017;2017;02;05;Lauantai;0;1;1;0;0;0
109;25.02.2017;2017;02;06;Lauantai;3;1;4;1;0;1
109;25.02.2017;2017;02;07;Lauantai;1;2;3;5;1;6
109;25.02.2017;2017;02;08;Lauantai;3;2;5;3;1;4
109;25.02.2017;2017;02;09;Lauantai;1;3;4;2;1;3
109;25.02.2017;2017;02;10;Lauantai;2;1;3;10;4;14
109;25.02.2017;2017;02;11;Lauantai;6;2;8;2;5;7
109;25.02.2017;2017;02;12;Lauantai;7;3;10;3;1;4
109;25.02.2017;2017;02;13;Lauantai;1;4;5;3;6;9
109;25.02.2017;2017;02;14;Lauantai;5;7;12;6;8;14
109;25.02.2017;2017;02;15;Lauantai;2;5;7;7;1;8
109;25.02.2017;2017;02;16;Lauantai;9;6;15;6;9;15
109;25.02.2017;2017;02;17;Lauantai;2;4;6;2;1;3
109;25.02.2017;2017;02;18;Lauantai;5;0;5;2;3;5
109;25.02.2017;2017;02;19;Lauantai;6;3;9;3;1;4
109;25.02.2017;2017;02;20;Lauantai;3;5;8;1;1;2
109;25.02.2017;2017;02;21;Lauantai;1;4;5;0;3;3
109;25.02.2017;2017;02;22;Lauantai;1;0;1;0;0;0
109;25.02.2017;2017;02;23;Lauantai;0;1;1;0;0;0
109;26.02.2017;2017;02;00;Sunnuntai;0;0;0;1;0;1
109;26.02.2017;2017;02;01;Sunnuntai;0;1;1;0;0;0
109;26.02.2017;2017;02;02;Sunnuntai;0;0;0;0;1;1
109;26.02.2017;2017;02;03;Sunnuntai;1;1;2;0;1;1
109;26.02.2017;2017;02;04;Sunnuntai;2;0;2;0;0;0
109;26.02.2017;2017;02;05;Sunnuntai;0;0;0;0;0;0
109;26.02.2017;2017;02;06;Sunnuntai;2;1;3;0;0;0
109;26.02.2017;2017;02;07;Sunnuntai;1;4;5;1;0;1
109;26.02.2017;2017;02;08;Sunnuntai;4;0;4;3;2;5
109;26.02.2017;2017;02;09;Sunnuntai;3;1;4;2;4;6
109;26.02.2017;2017;02;10;Sunnuntai;1;4;5;9;2;11
109;26.02.2017;2017;02;11;Sunnuntai;5;7;12;3;7;10
109;26.02.2017;2017;02;12;Sunnuntai;6;3;9;4;5;9
109;26.02.2017;2017;02;13;Sunnuntai;2;2;4;11;3;14
109;26.02.2017;2017;02;14;Sunnuntai;5;5;10;10;4;14
109;26.02.2017;2017;02;15;Sunnuntai;2;7;9;6;4;10
109;26.02.2017;2017;02;16;Sunnuntai;4;4;8;8;7;15
109;26.02.2017;2017;02;17;Sunnuntai;2;2;4;8;2;10
109;26.02.2017;2017;02;18;Sunnuntai;5;1;6;5;3;8
109;26.02.2017;2017;02;19;Sunnuntai;0;7;7;8;3;11
109;26.02.2017;2017;02;20;Sunnuntai;5;2;7;2;7;9
109;26.02.2017;2017;02;21;Sunnuntai;0;4;4;0;0;0
109;26.02.2017;2017;02;22;Sunnuntai;1;4;5;0;1;1
109;26.02.2017;2017;02;23;Sunnuntai;0;0;0;1;0;1
109;27.02.2017;2017;02;00;Maanantai;0;0;0;0;2;2
109;27.02.2017;2017;02;01;Maanantai;0;0;0;0;0;0
109;27.02.2017;2017;02;02;Maanantai;0;0;0;0;0;0
109;27.02.2017;2017;02;03;Maanantai;0;0;0;0;0;0
109;27.02.2017;2017;02;04;Maanantai;0;0;0;0;0;0
109;27.02.2017;2017;02;05;Maanantai;5;2;7;3;0;3
109;27.02.2017;2017;02;06;Maanantai;12;11;23;1;2;3
109;27.02.2017;2017;02;07;Maanantai;34;15;49;4;4;8
109;27.02.2017;2017;02;08;Maanantai;21;7;28;1;4;5
109;27.02.2017;2017;02;09;Maanantai;7;1;8;2;5;7
109;27.02.2017;2017;02;10;Maanantai;3;2;5;5;1;6
109;27.02.2017;2017;02;11;Maanantai;9;8;17;3;3;6
109;27.02.2017;2017;02;12;Maanantai;14;4;18;5;6;11
109;27.02.2017;2017;02;13;Maanantai;3;12;15;7;5;12
109;27.02.2017;2017;02;14;Maanantai;7;15;22;6;2;8
109;27.02.2017;2017;02;15;Maanantai;20;27;47;5;7;12
109;27.02.2017;2017;02;16;Maanantai;25;34;59;4;4;8
109;27.02.2017;2017;02;17;Maanantai;6;16;22;5;3;8
109;27.02.2017;2017;02;18;Maanantai;2;8;10;0;6;6
109;27.02.2017;2017;02;19;Maanantai;4;4;8;5;6;11
109;27.02.2017;2017;02;20;Maanantai;3;6;9;4;6;10
109;27.02.2017;2017;02;21;Maanantai;3;6;9;2;2;4
109;27.02.2017;2017;02;22;Maanantai;9;2;11;0;0;0
109;27.02.2017;2017;02;23;Maanantai;0;0;0;1;0;1
109;28.02.2017;2017;02;00;Tiistai;0;0;0;0;0;0
109;28.02.2017;2017;02;01;Tiistai;1;0;1;0;0;0
109;28.02.2017;2017;02;02;Tiistai;1;0;1;0;0;0
109;28.02.2017;2017;02;03;Tiistai;0;0;0;0;0;0
109;28.02.2017;2017;02;04;Tiistai;1;0;1;0;0;0
109;28.02.2017;2017;02;05;Tiistai;4;1;5;0;0;0
109;28.02.2017;2017;02;06;Tiistai;16;14;30;0;0;0
109;28.02.2017;2017;02;07;Tiistai;46;35;81;0;0;0
109;28.02.2017;2017;02;08;Tiistai;22;12;34;0;0;0
109;28.02.2017;2017;02;09;Tiistai;12;5;17;2;0;2
109;28.02.2017;2017;02;10;Tiistai;8;7;15;2;0;2
109;28.02.2017;2017;02;11;Tiistai;8;2;10;2;0;2
109;28.02.2017;2017;02;12;Tiistai;12;7;19;5;2;7
109;28.02.2017;2017;02;13;Tiistai;5;6;11;4;4;8
109;28.02.2017;2017;02;14;Tiistai;3;11;14;3;5;8
109;28.02.2017;2017;02;15;Tiistai;13;35;48;5;6;11
109;28.02.2017;2017;02;16;Tiistai;26;49;75;7;5;12
109;28.02.2017;2017;02;17;Tiistai;9;9;18;6;2;8
109;28.02.2017;2017;02;18;Tiistai;8;5;13;9;7;16
109;28.02.2017;2017;02;19;Tiistai;1;2;3;6;7;13
109;28.02.2017;2017;02;20;Tiistai;8;10;18;1;1;2
109;28.02.2017;2017;02;21;Tiistai;1;9;10;4;3;7
109;28.02.2017;2017;02;22;Tiistai;2;1;3;0;1;1
109;28.02.2017;2017;02;23;Tiistai;0;2;2;0;0;0
109;01.03.2017;2017;03;00;Keskiviikko;2;1;3;0;0;0
109;01.03.2017;2017;03;01;Keskiviikko;0;0;0;2;0;2
109;01.03.2017;2017;03;02;Keskiviikko;0;0;0;0;0;0
109;01.03.2017;2017;03;03;Keskiviikko;0;0;0;0;0;0
109;01.03.2017;2017;03;04;Keskiviikko;1;0;1;0;0;0
109;01.03.2017;2017;03;05;Keskiviikko;1;3;4;1;0;1
109;01.03.2017;2017;03;06;Keskiviikko;14;12;26;2;0;2
109;01.03.2017;2017;03;07;Keskiviikko;49;20;69;7;5;12
109;01.03.2017;2017;03;08;Keskiviikko;24;9;33;1;1;2
109;01.03.2017;2017;03;09;Keskiviikko;7;4;11;2;3;5
109;01.03.2017;2017;03;10;Keskiviikko;9;1;10;0;2;2
109;01.03.2017;2017;03;11;Keskiviikko;8;5;13;7;2;9
109;01.03.2017;2017;03;12;Keskiviikko;3;11;14;1;1;2
109;01.03.2017;2017;03;13;Keskiviikko;6;11;17;3;2;5
109;01.03.2017;2017;03;14;Keskiviikko;3;7;10;1;1;2
109;01.03.2017;2017;03;15;Keskiviikko;12;23;35;2;2;4
109;01.03.2017;2017;03;16;Keskiviikko;17;33;50;8;9;17
109;01.03.2017;2017;03;17;Keskiviikko;11;13;24;3;4;7
109;01.03.2017;2017;03;18;Keskiviikko;6;6;12;4;0;4
109;01.03.2017;2017;03;19;Keskiviikko;4;4;8;5;6;11
109;01.03.2017;2017;03;20;Keskiviikko;4;6;10;4;4;8
109;01.03.2017;2017;03;21;Keskiviikko;3;2;5;0;3;3
109;01.03.2017;2017;03;22;Keskiviikko;3;2;5;2;0;2
109;01.03.2017;2017;03;23;Keskiviikko;1;0;1;0;0;0
109;02.03.2017;2017;03;00;Torstai;0;0;0;0;0;0
109;02.03.2017;2017;03;01;Torstai;0;0;0;0;0;0
109;02.03.2017;2017;03;02;Torstai;0;0;0;0;0;0
109;02.03.2017;2017;03;03;Torstai;0;0;0;0;0;0
109;02.03.2017;2017;03;04;Torstai;0;1;1;0;0;0
109;02.03.2017;2017;03;05;Torstai;0;2;2;0;0;0
109;02.03.2017;2017;03;06;Torstai;12;11;23;3;2;5
109;02.03.2017;2017;03;07;Torstai;43;21;64;3;0;3
109;02.03.2017;2017;03;08;Torstai;25;12;37;1;0;1
109;02.03.2017;2017;03;09;Torstai;12;9;21;0;0;0
109;02.03.2017;2017;03;10;Torstai;2;4;6;1;0;1
109;02.03.2017;2017;03;11;Torstai;11;4;15;11;5;16
109;02.03.2017;2017;03;12;Torstai;6;7;13;0;8;8
109;02.03.2017;2017;03;13;Torstai;8;7;15;7;1;8
109;02.03.2017;2017;03;14;Torstai;6;13;19;6;2;8
109;02.03.2017;2017;03;15;Torstai;17;23;40;3;4;7
109;02.03.2017;2017;03;16;Torstai;23;48;71;3;9;12
109;02.03.2017;2017;03;17;Torstai;9;20;29;4;2;6
109;02.03.2017;2017;03;18;Torstai;1;11;12;7;1;8
109;02.03.2017;2017;03;19;Torstai;3;6;9;6;4;10
109;02.03.2017;2017;03;20;Torstai;4;5;9;5;1;6
109;02.03.2017;2017;03;21;Torstai;1;4;5;3;3;6
109;02.03.2017;2017;03;22;Torstai;6;2;8;0;3;3
109;02.03.2017;2017;03;23;Torstai;0;0;0;0;0;0
109;03.03.2017;2017;03;00;Perjantai;1;0;1;0;0;0
109;03.03.2017;2017;03;01;Perjantai;0;1;1;0;0;0
109;03.03.2017;2017;03;02;Perjantai;0;0;0;0;0;0
109;03.03.2017;2017;03;03;Perjantai;2;0;2;3;0;3
109;03.03.2017;2017;03;04;Perjantai;1;0;1;0;0;0
109;03.03.2017;2017;03;05;Perjantai;2;2;4;0;0;0
109;03.03.2017;2017;03;06;Perjantai;12;12;24;1;0;1
109;03.03.2017;2017;03;07;Perjantai;31;18;49;7;5;12
109;03.03.2017;2017;03;08;Perjantai;25;8;33;3;4;7
109;03.03.2017;2017;03;09;Perjantai;11;3;14;2;9;11
109;03.03.2017;2017;03;10;Perjantai;9;5;14;5;6;11
109;03.03.2017;2017;03;11;Perjantai;9;5;14;5;3;8
109;03.03.2017;2017;03;12;Perjantai;10;8;18;5;0;5
109;03.03.2017;2017;03;13;Perjantai;8;10;18;2;4;6
109;03.03.2017;2017;03;14;Perjantai;5;18;23;4;4;8
109;03.03.2017;2017;03;15;Perjantai;12;18;30;3;1;4
109;03.03.2017;2017;03;16;Perjantai;10;30;40;14;5;19
109;03.03.2017;2017;03;17;Perjantai;13;16;29;1;3;4
109;03.03.2017;2017;03;18;Perjantai;2;5;7;2;2;4
109;03.03.2017;2017;03;19;Perjantai;2;4;6;2;3;5
109;03.03.2017;2017;03;20;Perjantai;3;1;4;1;1;2
109;03.03.2017;2017;03;21;Perjantai;1;2;3;3;1;4
109;03.03.2017;2017;03;22;Perjantai;0;1;1;1;2;3
109;03.03.2017;2017;03;23;Perjantai;1;0;1;1;1;2
109;04.03.2017;2017;03;00;Lauantai;0;0;0;1;1;2
109;04.03.2017;2017;03;01;Lauantai;0;0;0;0;0;0
109;04.03.2017;2017;03;02;Lauantai;1;0;1;0;0;0
109;04.03.2017;2017;03;03;Lauantai;0;1;1;0;1;1
109;04.03.2017;2017;03;04;Lauantai;0;0;0;0;0;0
109;04.03.2017;2017;03;05;Lauantai;2;3;5;0;0;0
109;04.03.2017;2017;03;06;Lauantai;1;0;1;2;0;2
109;04.03.2017;2017;03;07;Lauantai;3;1;4;0;1;1
109;04.03.2017;2017;03;08;Lauantai;1;2;3;2;4;6
109;04.03.2017;2017;03;09;Lauantai;2;0;2;4;6;10
109;04.03.2017;2017;03;10;Lauantai;5;2;7;6;1;7
109;04.03.2017;2017;03;11;Lauantai;4;4;8;4;6;10
109;04.03.2017;2017;03;12;Lauantai;6;13;19;14;3;17
109;04.03.2017;2017;03;13;Lauantai;5;4;9;1;3;4
109;04.03.2017;2017;03;14;Lauantai;3;4;7;5;1;6
109;04.03.2017;2017;03;15;Lauantai;4;2;6;5;4;9
109;04.03.2017;2017;03;16;Lauantai;5;6;11;6;6;12
109;04.03.2017;2017;03;17;Lauantai;3;2;5;4;3;7
109;04.03.2017;2017;03;18;Lauantai;2;1;3;4;3;7
109;04.03.2017;2017;03;19;Lauantai;3;0;3;5;4;9
109;04.03.2017;2017;03;20;Lauantai;1;2;3;5;1;6
109;04.03.2017;2017;03;21;Lauantai;0;2;2;1;1;2
109;04.03.2017;2017;03;22;Lauantai;0;2;2;0;0;0
109;04.03.2017;2017;03;23;Lauantai;0;2;2;1;0;1
109;05.03.2017;2017;03;00;Sunnuntai;0;1;1;2;0;2
109;05.03.2017;2017;03;01;Sunnuntai;2;0;2;0;0;0
109;05.03.2017;2017;03;02;Sunnuntai;0;0;0;0;0;0
109;05.03.2017;2017;03;03;Sunnuntai;0;0;0;0;0;0
109;05.03.2017;2017;03;04;Sunnuntai;0;1;1;0;0;0
109;05.03.2017;2017;03;05;Sunnuntai;2;1;3;0;0;0
109;05.03.2017;2017;03;06;Sunnuntai;1;0;1;0;0;0
109;05.03.2017;2017;03;07;Sunnuntai;1;1;2;3;1;4
109;05.03.2017;2017;03;08;Sunnuntai;4;0;4;0;0;0
109;05.03.2017;2017;03;09;Sunnuntai;0;0;0;1;2;3
109;05.03.2017;2017;03;10;Sunnuntai;1;6;7;6;2;8
109;05.03.2017;2017;03;11;Sunnuntai;2;2;4;8;7;15
109;05.03.2017;2017;03;12;Sunnuntai;5;7;12;10;2;12
109;05.03.2017;2017;03;13;Sunnuntai;9;3;12;6;5;11
109;05.03.2017;2017;03;14;Sunnuntai;4;2;6;3;9;12
109;05.03.2017;2017;03;15;Sunnuntai;10;4;14;6;5;11
109;05.03.2017;2017;03;16;Sunnuntai;2;7;9;7;2;9
109;05.03.2017;2017;03;17;Sunnuntai;2;6;8;2;1;3
109;05.03.2017;2017;03;18;Sunnuntai;5;3;8;2;5;7
109;05.03.2017;2017;03;19;Sunnuntai;4;1;5;5;3;8
109;05.03.2017;2017;03;20;Sunnuntai;0;2;2;4;1;5
109;05.03.2017;2017;03;21;Sunnuntai;1;3;4;4;0;4
109;05.03.2017;2017;03;22;Sunnuntai;0;3;3;1;0;1
109;05.03.2017;2017;03;23;Sunnuntai;1;0;1;0;0;0
109;06.03.2017;2017;03;00;Maanantai;2;0;2;2;1;3
109;06.03.2017;2017;03;01;Maanantai;0;0;0;1;1;2
109;06.03.2017;2017;03;02;Maanantai;0;0;0;0;0;0
109;06.03.2017;2017;03;03;Maanantai;0;0;0;0;0;0
109;06.03.2017;2017;03;04;Maanantai;0;2;2;0;0;0
109;06.03.2017;2017;03;05;Maanantai;0;3;3;0;0;0
109;06.03.2017;2017;03;06;Maanantai;14;10;24;3;0;3
109;06.03.2017;2017;03;07;Maanantai;24;19;43;5;1;6
109;06.03.2017;2017;03;08;Maanantai;14;6;20;2;4;6
109;06.03.2017;2017;03;09;Maanantai;7;1;8;1;2;3
109;06.03.2017;2017;03;10;Maanantai;3;1;4;2;1;3
109;06.03.2017;2017;03;11;Maanantai;11;1;12;4;3;7
109;06.03.2017;2017;03;12;Maanantai;10;7;17;8;8;16
109;06.03.2017;2017;03;13;Maanantai;14;6;20;3;6;9
109;06.03.2017;2017;03;14;Maanantai;9;9;18;7;1;8
109;06.03.2017;2017;03;15;Maanantai;18;21;39;5;4;9
109;06.03.2017;2017;03;16;Maanantai;7;21;28;3;8;11
109;06.03.2017;2017;03;17;Maanantai;13;11;24;3;0;3
109;06.03.2017;2017;03;18;Maanantai;2;9;11;5;3;8
109;06.03.2017;2017;03;19;Maanantai;3;4;7;3;7;10
109;06.03.2017;2017;03;20;Maanantai;2;2;4;7;3;10
109;06.03.2017;2017;03;21;Maanantai;1;6;7;2;0;2
109;06.03.2017;2017;03;22;Maanantai;1;1;2;0;1;1
109;06.03.2017;2017;03;23;Maanantai;1;0;1;0;1;1
109;07.03.2017;2017;03;00;Tiistai;1;0;1;0;0;0
109;07.03.2017;2017;03;01;Tiistai;0;0;0;0;0;0
109;07.03.2017;2017;03;02;Tiistai;0;0;0;0;0;0
109;07.03.2017;2017;03;03;Tiistai;1;0;1;0;0;0
109;07.03.2017;2017;03;04;Tiistai;2;0;2;0;0;0
109;07.03.2017;2017;03;05;Tiistai;1;2;3;1;1;2
109;07.03.2017;2017;03;06;Tiistai;17;13;30;2;1;3
109;07.03.2017;2017;03;07;Tiistai;27;15;42;7;3;10
109;07.03.2017;2017;03;08;Tiistai;18;7;25;0;2;2
109;07.03.2017;2017;03;09;Tiistai;2;3;5;7;2;9
109;07.03.2017;2017;03;10;Tiistai;7;1;8;4;2;6
109;07.03.2017;2017;03;11;Tiistai;6;2;8;7;3;10
109;07.03.2017;2017;03;12;Tiistai;9;5;14;3;7;10
109;07.03.2017;2017;03;13;Tiistai;7;8;15;9;3;12
109;07.03.2017;2017;03;14;Tiistai;7;9;16;9;6;15
109;07.03.2017;2017;03;15;Tiistai;11;24;35;8;8;16
109;07.03.2017;2017;03;16;Tiistai;19;28;47;8;3;11
109;07.03.2017;2017;03;17;Tiistai;4;18;22;2;2;4
109;07.03.2017;2017;03;18;Tiistai;2;6;8;3;6;9
109;07.03.2017;2017;03;19;Tiistai;3;3;6;4;3;7
109;07.03.2017;2017;03;20;Tiistai;3;3;6;7;2;9
109;07.03.2017;2017;03;21;Tiistai;4;3;7;3;1;4
109;07.03.2017;2017;03;22;Tiistai;1;0;1;1;1;2
109;07.03.2017;2017;03;23;Tiistai;4;2;6;0;0;0
109;08.03.2017;2017;03;00;Keskiviikko;1;0;1;0;0;0
109;08.03.2017;2017;03;01;Keskiviikko;0;0;0;0;0;0
109;08.03.2017;2017;03;02;Keskiviikko;0;0;0;0;0;0
109;08.03.2017;2017;03;03;Keskiviikko;0;0;0;0;0;0
109;08.03.2017;2017;03;04;Keskiviikko;1;0;1;1;0;1
109;08.03.2017;2017;03;05;Keskiviikko;2;3;5;2;1;3
109;08.03.2017;2017;03;06;Keskiviikko;12;11;23;1;0;1
109;08.03.2017;2017;03;07;Keskiviikko;30;19;49;8;1;9
109;08.03.2017;2017;03;08;Keskiviikko;11;5;16;8;1;9
109;08.03.2017;2017;03;09;Keskiviikko;7;6;13;4;4;8
109;08.03.2017;2017;03;10;Keskiviikko;7;1;8;6;3;9
109;08.03.2017;2017;03;11;Keskiviikko;4;3;7;4;5;9
109;08.03.2017;2017;03;12;Keskiviikko;9;7;16;6;3;9
109;08.03.2017;2017;03;13;Keskiviikko;10;7;17;2;2;4
109;08.03.2017;2017;03;14;Keskiviikko;5;7;12;8;0;8
109;08.03.2017;2017;03;15;Keskiviikko;12;25;37;6;4;10
109;08.03.2017;2017;03;16;Keskiviikko;10;16;26;11;6;17
109;08.03.2017;2017;03;17;Keskiviikko;8;11;19;4;1;5
109;08.03.2017;2017;03;18;Keskiviikko;2;10;12;2;0;2
109;08.03.2017;2017;03;19;Keskiviikko;2;5;7;1;2;3
109;08.03.2017;2017;03;20;Keskiviikko;3;5;8;2;2;4
109;08.03.2017;2017;03;21;Keskiviikko;3;2;5;0;1;1
109;08.03.2017;2017;03;22;Keskiviikko;2;2;4;0;1;1
109;08.03.2017;2017;03;23;Keskiviikko;1;0;1;0;0;0
109;09.03.2017;2017;03;00;Torstai;0;0;0;0;0;0
109;09.03.2017;2017;03;01;Torstai;1;0;1;0;0;0
109;09.03.2017;2017;03;02;Torstai;0;0;0;0;0;0
109;09.03.2017;2017;03;03;Torstai;0;0;0;0;0;0
109;09.03.2017;2017;03;04;Torstai;1;0;1;1;1;2
109;09.03.2017;2017;03;05;Torstai;1;0;1;2;2;4
109;09.03.2017;2017;03;06;Torstai;12;9;21;1;1;2
109;09.03.2017;2017;03;07;Torstai;18;17;35;8;8;16
109;09.03.2017;2017;03;08;Torstai;13;9;22;8;8;16
109;09.03.2017;2017;03;09;Torstai;5;2;7;4;4;8
109;09.03.2017;2017;03;10;Torstai;6;5;11;6;6;12
109;09.03.2017;2017;03;11;Torstai;8;6;14;4;4;8
109;09.03.2017;2017;03;12;Torstai;8;5;13;6;6;12
109;09.03.2017;2017;03;13;Torstai;4;3;7;2;2;4
109;09.03.2017;2017;03;14;Torstai;6;3;9;8;8;16
109;09.03.2017;2017;03;15;Torstai;13;12;25;6;6;12
109;09.03.2017;2017;03;16;Torstai;18;16;34;11;11;22
109;09.03.2017;2017;03;17;Torstai;9;7;16;4;4;8
109;09.03.2017;2017;03;18;Torstai;7;4;11;2;2;4
109;09.03.2017;2017;03;19;Torstai;3;2;5;1;1;2
109;09.03.2017;2017;03;20;Torstai;4;4;8;2;2;4
109;09.03.2017;2017;03;21;Torstai;5;2;7;0;0;0
109;09.03.2017;2017;03;22;Torstai;2;2;4;0;0;0
109;09.03.2017;2017;03;23;Torstai;1;0;1;0;0;0
109;10.03.2017;2017;03;00;Perjantai;1;0;1;1;0;1
109;10.03.2017;2017;03;01;Perjantai;1;0;1;0;0;0
109;10.03.2017;2017;03;02;Perjantai;0;0;0;0;0;0
109;10.03.2017;2017;03;03;Perjantai;0;0;0;0;0;0
109;10.03.2017;2017;03;04;Perjantai;0;3;3;0;1;1
109;10.03.2017;2017;03;05;Perjantai;4;3;7;2;0;2
109;10.03.2017;2017;03;06;Perjantai;10;10;20;1;1;2
109;10.03.2017;2017;03;07;Perjantai;18;14;32;5;3;8
109;10.03.2017;2017;03;08;Perjantai;12;5;17;1;6;7
109;10.03.2017;2017;03;09;Perjantai;2;3;5;3;3;6
109;10.03.2017;2017;03;10;Perjantai;4;3;7;3;3;6
109;10.03.2017;2017;03;11;Perjantai;6;5;11;4;3;7
109;10.03.2017;2017;03;12;Perjantai;7;1;8;4;3;7
109;10.03.2017;2017;03;13;Perjantai;11;8;19;5;6;11
109;10.03.2017;2017;03;14;Perjantai;8;11;19;6;4;10
109;10.03.2017;2017;03;15;Perjantai;13;10;23;6;11;17
109;10.03.2017;2017;03;16;Perjantai;14;18;32;5;2;7
109;10.03.2017;2017;03;17;Perjantai;3;15;18;7;6;13
109;10.03.2017;2017;03;18;Perjantai;3;5;8;6;1;7
109;10.03.2017;2017;03;19;Perjantai;6;1;7;3;1;4
109;10.03.2017;2017;03;20;Perjantai;3;4;7;2;2;4
109;10.03.2017;2017;03;21;Perjantai;3;2;5;2;0;2
109;10.03.2017;2017;03;22;Perjantai;1;2;3;0;0;0
109;10.03.2017;2017;03;23;Perjantai;2;2;4;0;0;0
109;11.03.2017;2017;03;00;Lauantai;0;0;0;0;0;0
109;11.03.2017;2017;03;01;Lauantai;0;0;0;0;0;0
109;11.03.2017;2017;03;02;Lauantai;0;0;0;0;1;1
109;11.03.2017;2017;03;03;Lauantai;1;0;1;0;0;0
109;11.03.2017;2017;03;04;Lauantai;0;0;0;0;0;0
109;11.03.2017;2017;03;05;Lauantai;1;0;1;0;0;0
109;11.03.2017;2017;03;06;Lauantai;6;1;7;0;1;1
109;11.03.2017;2017;03;07;Lauantai;1;2;3;0;1;1
109;11.03.2017;2017;03;08;Lauantai;1;2;3;3;1;4
109;11.03.2017;2017;03;09;Lauantai;1;1;2;4;2;6
109;11.03.2017;2017;03;10;Lauantai;2;1;3;10;2;12
109;11.03.2017;2017;03;11;Lauantai;5;4;9;5;0;5
109;11.03.2017;2017;03;12;Lauantai;3;3;6;3;7;10
109;11.03.2017;2017;03;13;Lauantai;3;4;7;5;7;12
109;11.03.2017;2017;03;14;Lauantai;4;3;7;6;2;8
109;11.03.2017;2017;03;15;Lauantai;3;10;13;5;4;9
109;11.03.2017;2017;03;16;Lauantai;6;7;13;5;1;6
109;11.03.2017;2017;03;17;Lauantai;8;6;14;9;3;12
109;11.03.2017;2017;03;18;Lauantai;3;5;8;4;4;8
109;11.03.2017;2017;03;19;Lauantai;2;3;5;0;3;3
109;11.03.2017;2017;03;20;Lauantai;2;1;3;3;4;7
109;11.03.2017;2017;03;21;Lauantai;0;5;5;1;4;5
109;11.03.2017;2017;03;22;Lauantai;2;0;2;3;0;3
109;11.03.2017;2017;03;23;Lauantai;2;0;2;2;1;3
109;12.03.2017;2017;03;00;Sunnuntai;0;0;0;0;0;0
109;12.03.2017;2017;03;01;Sunnuntai;0;2;2;0;1;1
109;12.03.2017;2017;03;02;Sunnuntai;2;0;2;0;1;1
109;12.03.2017;2017;03;03;Sunnuntai;0;0;0;0;0;0
109;12.03.2017;2017;03;04;Sunnuntai;0;0;0;0;0;0
109;12.03.2017;2017;03;05;Sunnuntai;0;1;1;0;0;0
109;12.03.2017;2017;03;06;Sunnuntai;2;1;3;2;0;2
109;12.03.2017;2017;03;07;Sunnuntai;1;4;5;0;0;0
109;12.03.2017;2017;03;08;Sunnuntai;2;0;2;1;3;4
109;12.03.2017;2017;03;09;Sunnuntai;2;4;6;9;2;11
109;12.03.2017;2017;03;10;Sunnuntai;3;3;6;3;6;9
109;12.03.2017;2017;03;11;Sunnuntai;3;1;4;9;5;14
109;12.03.2017;2017;03;12;Sunnuntai;8;2;10;5;3;8
109;12.03.2017;2017;03;13;Sunnuntai;2;2;4;7;8;15
109;12.03.2017;2017;03;14;Sunnuntai;4;2;6;8;6;14
109;12.03.2017;2017;03;15;Sunnuntai;3;7;10;3;3;6
109;12.03.2017;2017;03;16;Sunnuntai;4;4;8;6;4;10
109;12.03.2017;2017;03;17;Sunnuntai;6;2;8;4;5;9
109;12.03.2017;2017;03;18;Sunnuntai;3;1;4;4;3;7
109;12.03.2017;2017;03;19;Sunnuntai;6;2;8;11;3;14
109;12.03.2017;2017;03;20;Sunnuntai;2;1;3;5;3;8
109;12.03.2017;2017;03;21;Sunnuntai;0;5;5;2;3;5
109;12.03.2017;2017;03;22;Sunnuntai;0;0;0;0;2;2
109;12.03.2017;2017;03;23;Sunnuntai;0;0;0;0;0;0
109;13.03.2017;2017;03;00;Maanantai;0;0;0;0;1;1
109;13.03.2017;2017;03;01;Maanantai;0;0;0;0;0;0
109;13.03.2017;2017;03;02;Maanantai;0;0;0;0;0;0
109;13.03.2017;2017;03;03;Maanantai;0;0;0;0;0;0
109;13.03.2017;2017;03;04;Maanantai;0;0;0;0;0;0
109;13.03.2017;2017;03;05;Maanantai;2;2;4;2;2;4
109;13.03.2017;2017;03;06;Maanantai;17;11;28;1;0;1
109;13.03.2017;2017;03;07;Maanantai;49;26;75;9;9;18
109;13.03.2017;2017;03;08;Maanantai;38;12;50;4;3;7
109;13.03.2017;2017;03;09;Maanantai;11;4;15;4;7;11
109;13.03.2017;2017;03;10;Maanantai;6;2;8;4;1;5
109;13.03.2017;2017;03;11;Maanantai;12;4;16;5;2;7
109;13.03.2017;2017;03;12;Maanantai;10;5;15;4;2;6
109;13.03.2017;2017;03;13;Maanantai;8;10;18;8;8;16
109;13.03.2017;2017;03;14;Maanantai;9;18;27;7;4;11
109;13.03.2017;2017;03;15;Maanantai;14;38;52;8;5;13
109;13.03.2017;2017;03;16;Maanantai;19;46;65;12;4;16
109;13.03.2017;2017;03;17;Maanantai;11;22;33;8;2;10
109;13.03.2017;2017;03;18;Maanantai;4;12;16;6;1;7
109;13.03.2017;2017;03;19;Maanantai;1;8;9;11;7;18
109;13.03.2017;2017;03;20;Maanantai;1;3;4;2;3;5
109;13.03.2017;2017;03;21;Maanantai;0;9;9;6;2;8
109;13.03.2017;2017;03;22;Maanantai;5;0;5;1;2;3
109;13.03.2017;2017;03;23;Maanantai;1;1;2;0;0;0
109;14.03.2017;2017;03;00;Tiistai;0;0;0;0;1;1
109;14.03.2017;2017;03;01;Tiistai;0;0;0;1;1;2
109;14.03.2017;2017;03;02;Tiistai;1;0;1;0;0;0
109;14.03.2017;2017;03;03;Tiistai;0;0;0;0;0;0
109;14.03.2017;2017;03;04;Tiistai;0;0;0;0;0;0
109;14.03.2017;2017;03;05;Tiistai;3;3;6;0;0;0
109;14.03.2017;2017;03;06;Tiistai;14;9;23;1;1;2
109;14.03.2017;2017;03;07;Tiistai;48;30;78;8;5;13
109;14.03.2017;2017;03;08;Tiistai;25;10;35;5;3;8
109;14.03.2017;2017;03;09;Tiistai;7;8;15;3;7;10
109;14.03.2017;2017;03;10;Tiistai;8;0;8;6;6;12
109;14.03.2017;2017;03;11;Tiistai;6;7;13;4;2;6
109;14.03.2017;2017;03;12;Tiistai;8;6;14;3;3;6
109;14.03.2017;2017;03;13;Tiistai;6;3;9;4;6;10
109;14.03.2017;2017;03;14;Tiistai;3;7;10;6;8;14
109;14.03.2017;2017;03;15;Tiistai;22;30;52;6;1;7
109;14.03.2017;2017;03;16;Tiistai;22;51;73;2;1;3
109;14.03.2017;2017;03;17;Tiistai;7;17;24;5;4;9
109;14.03.2017;2017;03;18;Tiistai;5;10;15;8;4;12
109;14.03.2017;2017;03;19;Tiistai;5;4;9;9;5;14
109;14.03.2017;2017;03;20;Tiistai;3;8;11;4;1;5
109;14.03.2017;2017;03;21;Tiistai;7;5;12;2;2;4
109;14.03.2017;2017;03;22;Tiistai;1;2;3;0;0;0
109;14.03.2017;2017;03;23;Tiistai;2;2;4;0;0;0
109;15.03.2017;2017;03;00;Keskiviikko;2;0;2;0;0;0
109;15.03.2017;2017;03;01;Keskiviikko;0;0;0;0;0;0
109;15.03.2017;2017;03;02;Keskiviikko;0;0;0;0;0;0
109;15.03.2017;2017;03;03;Keskiviikko;0;1;1;0;0;0
109;15.03.2017;2017;03;04;Keskiviikko;1;0;1;0;0;0
109;15.03.2017;2017;03;05;Keskiviikko;1;2;3;0;0;0
109;15.03.2017;2017;03;06;Keskiviikko;8;14;22;2;1;3
109;15.03.2017;2017;03;07;Keskiviikko;61;22;83;9;2;11
109;15.03.2017;2017;03;08;Keskiviikko;17;10;27;5;2;7
109;15.03.2017;2017;03;09;Keskiviikko;7;10;17;4;2;6
109;15.03.2017;2017;03;10;Keskiviikko;7;1;8;5;4;9
109;15.03.2017;2017;03;11;Keskiviikko;6;5;11;3;3;6
109;15.03.2017;2017;03;12;Keskiviikko;6;3;9;4;2;6
109;15.03.2017;2017;03;13;Keskiviikko;7;7;14;4;3;7
109;15.03.2017;2017;03;14;Keskiviikko;6;9;15;5;2;7
109;15.03.2017;2017;03;15;Keskiviikko;16;24;40;4;2;6
109;15.03.2017;2017;03;16;Keskiviikko;18;35;53;11;3;14
109;15.03.2017;2017;03;17;Keskiviikko;2;16;18;5;4;9
109;15.03.2017;2017;03;18;Keskiviikko;6;7;13;7;0;7
109;15.03.2017;2017;03;19;Keskiviikko;5;4;9;6;5;11
109;15.03.2017;2017;03;20;Keskiviikko;2;2;4;3;2;5
109;15.03.2017;2017;03;21;Keskiviikko;7;2;9;2;1;3
109;15.03.2017;2017;03;22;Keskiviikko;1;0;1;0;0;0
109;15.03.2017;2017;03;23;Keskiviikko;1;0;1;1;1;2
109;16.03.2017;2017;03;00;Torstai;0;0;0;0;1;1
109;16.03.2017;2017;03;01;Torstai;0;0;0;1;0;1
109;16.03.2017;2017;03;02;Torstai;0;0;0;0;0;0
109;16.03.2017;2017;03;03;Torstai;1;0;1;1;0;1
109;16.03.2017;2017;03;04;Torstai;0;0;0;0;0;0
109;16.03.2017;2017;03;05;Torstai;3;1;4;0;0;0
109;16.03.2017;2017;03;06;Torstai;13;12;25;4;0;4
109;16.03.2017;2017;03;07;Torstai;42;16;58;18;5;23
109;16.03.2017;2017;03;08;Torstai;20;9;29;10;2;12
109;16.03.2017;2017;03;09;Torstai;5;2;7;9;2;11
109;16.03.2017;2017;03;10;Torstai;2;1;3;1;3;4
109;16.03.2017;2017;03;11;Torstai;3;4;7;2;4;6
109;16.03.2017;2017;03;12;Torstai;4;3;7;5;4;9
109;16.03.2017;2017;03;13;Torstai;2;5;7;4;6;10
109;16.03.2017;2017;03;14;Torstai;6;9;15;6;3;9
109;16.03.2017;2017;03;15;Torstai;12;21;33;6;5;11
109;16.03.2017;2017;03;16;Torstai;15;31;46;6;6;12
109;16.03.2017;2017;03;17;Torstai;2;16;18;6;3;9
109;16.03.2017;2017;03;18;Torstai;3;10;13;9;3;12
109;16.03.2017;2017;03;19;Torstai;2;1;3;7;1;8
109;16.03.2017;2017;03;20;Torstai;1;3;4;1;0;1
109;16.03.2017;2017;03;21;Torstai;2;6;8;1;2;3
109;16.03.2017;2017;03;22;Torstai;2;1;3;1;0;1
109;16.03.2017;2017;03;23;Torstai;1;0;1;1;0;1
109;17.03.2017;2017;03;00;Perjantai;1;0;1;0;0;0
109;17.03.2017;2017;03;01;Perjantai;1;0;1;0;1;1
109;17.03.2017;2017;03;02;Perjantai;0;0;0;0;0;0
109;17.03.2017;2017;03;03;Perjantai;0;0;0;0;0;0
109;17.03.2017;2017;03;04;Perjantai;1;0;1;0;0;0
109;17.03.2017;2017;03;05;Perjantai;2;0;2;0;0;0
109;17.03.2017;2017;03;06;Perjantai;7;6;13;0;0;0
109;17.03.2017;2017;03;07;Perjantai;18;15;33;0;0;0
109;17.03.2017;2017;03;08;Perjantai;13;11;24;0;0;0
109;17.03.2017;2017;03;09;Perjantai;6;3;9;0;0;0
109;17.03.2017;2017;03;10;Perjantai;5;1;6;1;1;2
109;17.03.2017;2017;03;11;Perjantai;5;7;12;4;1;5
109;17.03.2017;2017;03;12;Perjantai;7;1;8;4;1;5
109;17.03.2017;2017;03;13;Perjantai;6;10;16;5;3;8
109;17.03.2017;2017;03;14;Perjantai;8;5;13;4;2;6
109;17.03.2017;2017;03;15;Perjantai;8;18;26;2;3;5
109;17.03.2017;2017;03;16;Perjantai;10;13;23;2;3;5
109;17.03.2017;2017;03;17;Perjantai;6;12;18;3;2;5
109;17.03.2017;2017;03;18;Perjantai;2;3;5;2;2;4
109;17.03.2017;2017;03;19;Perjantai;1;4;5;2;2;4
109;17.03.2017;2017;03;20;Perjantai;1;0;1;0;0;0
109;17.03.2017;2017;03;21;Perjantai;3;3;6;1;2;3
109;17.03.2017;2017;03;22;Perjantai;0;1;1;2;0;2
109;17.03.2017;2017;03;23;Perjantai;0;0;0;0;0;0
109;18.03.2017;2017;03;00;Lauantai;1;0;1;1;0;1
109;18.03.2017;2017;03;01;Lauantai;1;1;2;2;2;4
109;18.03.2017;2017;03;02;Lauantai;0;0;0;0;0;0
109;18.03.2017;2017;03;03;Lauantai;0;0;0;1;0;1
109;18.03.2017;2017;03;04;Lauantai;1;0;1;1;0;1
109;18.03.2017;2017;03;05;Lauantai;0;0;0;1;0;1
109;18.03.2017;2017;03;06;Lauantai;2;1;3;3;1;4
109;18.03.2017;2017;03;07;Lauantai;1;2;3;6;0;6
109;18.03.2017;2017;03;08;Lauantai;2;1;3;4;3;7
109;18.03.2017;2017;03;09;Lauantai;3;0;3;4;9;13
109;18.03.2017;2017;03;10;Lauantai;4;2;6;6;4;10
109;18.03.2017;2017;03;11;Lauantai;5;4;9;4;5;9
109;18.03.2017;2017;03;12;Lauantai;3;4;7;7;6;13
109;18.03.2017;2017;03;13;Lauantai;4;3;7;1;4;5
109;18.03.2017;2017;03;14;Lauantai;2;3;5;3;3;6
109;18.03.2017;2017;03;15;Lauantai;3;1;4;11;2;13
109;18.03.2017;2017;03;16;Lauantai;3;8;11;4;6;10
109;18.03.2017;2017;03;17;Lauantai;4;5;9;4;5;9
109;18.03.2017;2017;03;18;Lauantai;4;2;6;5;4;9
109;18.03.2017;2017;03;19;Lauantai;2;3;5;4;3;7
109;18.03.2017;2017;03;20;Lauantai;6;4;10;2;2;4
109;18.03.2017;2017;03;21;Lauantai;0;3;3;2;1;3
109;18.03.2017;2017;03;22;Lauantai;1;1;2;1;0;1
109;18.03.2017;2017;03;23;Lauantai;2;1;3;0;1;1
109;19.03.2017;2017;03;00;Sunnuntai;4;1;5;0;0;0
109;19.03.2017;2017;03;01;Sunnuntai;0;0;0;0;0;0
109;19.03.2017;2017;03;02;Sunnuntai;1;2;3;0;2;2
109;19.03.2017;2017;03;03;Sunnuntai;0;0;0;0;0;0
109;19.03.2017;2017;03;04;Sunnuntai;1;1;2;0;0;0
109;19.03.2017;2017;03;05;Sunnuntai;0;0;0;0;0;0
109;19.03.2017;2017;03;06;Sunnuntai;3;1;4;0;0;0
109;19.03.2017;2017;03;07;Sunnuntai;1;1;2;2;0;2
109;19.03.2017;2017;03;08;Sunnuntai;1;0;1;2;1;3
109;19.03.2017;2017;03;09;Sunnuntai;1;4;5;7;6;13
109;19.03.2017;2017;03;10;Sunnuntai;3;0;3;4;6;10
109;19.03.2017;2017;03;11;Sunnuntai;7;1;8;5;1;6
109;19.03.2017;2017;03;12;Sunnuntai;13;1;14;9;7;16
109;19.03.2017;2017;03;13;Sunnuntai;3;1;4;5;1;6
109;19.03.2017;2017;03;14;Sunnuntai;2;2;4;7;6;13
109;19.03.2017;2017;03;15;Sunnuntai;2;6;8;8;7;15
109;19.03.2017;2017;03;16;Sunnuntai;3;7;10;9;0;9
109;19.03.2017;2017;03;17;Sunnuntai;4;2;6;4;5;9
109;19.03.2017;2017;03;18;Sunnuntai;3;4;7;3;5;8
109;19.03.2017;2017;03;19;Sunnuntai;0;3;3;4;7;11
109;19.03.2017;2017;03;20;Sunnuntai;4;4;8;0;2;2
109;19.03.2017;2017;03;21;Sunnuntai;1;2;3;3;0;3
109;19.03.2017;2017;03;22;Sunnuntai;0;0;0;1;0;1
109;19.03.2017;2017;03;23;Sunnuntai;0;0;0;1;1;2
109;20.03.2017;2017;03;00;Maanantai;0;0;0;0;0;0
109;20.03.2017;2017;03;01;Maanantai;0;0;0;0;0;0
109;20.03.2017;2017;03;02;Maanantai;1;0;1;0;1;1
109;20.03.2017;2017;03;03;Maanantai;0;0;0;0;0;0
109;20.03.2017;2017;03;04;Maanantai;0;0;0;0;0;0
109;20.03.2017;2017;03;05;Maanantai;1;4;5;0;0;0
109;20.03.2017;2017;03;06;Maanantai;13;9;22;2;1;3
109;20.03.2017;2017;03;07;Maanantai;39;23;62;5;4;9
109;20.03.2017;2017;03;08;Maanantai;23;4;27;7;2;9
109;20.03.2017;2017;03;09;Maanantai;13;3;16;4;2;6
109;20.03.2017;2017;03;10;Maanantai;9;1;10;7;3;10
109;20.03.2017;2017;03;11;Maanantai;9;5;14;5;5;10
109;20.03.2017;2017;03;12;Maanantai;7;4;11;2;2;4
109;20.03.2017;2017;03;13;Maanantai;6;5;11;3;3;6
109;20.03.2017;2017;03;14;Maanantai;6;10;16;4;5;9
109;20.03.2017;2017;03;15;Maanantai;10;25;35;12;4;16
109;20.03.2017;2017;03;16;Maanantai;19;30;49;8;8;16
109;20.03.2017;2017;03;17;Maanantai;14;18;32;6;6;12
109;20.03.2017;2017;03;18;Maanantai;4;9;13;8;6;14
109;20.03.2017;2017;03;19;Maanantai;1;2;3;4;5;9
109;20.03.2017;2017;03;20;Maanantai;4;5;9;5;4;9
109;20.03.2017;2017;03;21;Maanantai;3;6;9;2;2;4
109;20.03.2017;2017;03;22;Maanantai;5;4;9;0;0;0
109;20.03.2017;2017;03;23;Maanantai;1;0;1;3;0;3
109;21.03.2017;2017;03;00;Tiistai;1;0;1;1;0;1
109;21.03.2017;2017;03;01;Tiistai;1;0;1;0;1;1
109;21.03.2017;2017;03;02;Tiistai;0;0;0;0;0;0
109;21.03.2017;2017;03;03;Tiistai;0;0;0;0;0;0
109;21.03.2017;2017;03;04;Tiistai;0;0;0;0;0;0
109;21.03.2017;2017;03;05;Tiistai;1;2;3;1;0;1
109;21.03.2017;2017;03;06;Tiistai;17;13;30;8;2;10
109;21.03.2017;2017;03;07;Tiistai;49;24;73;10;4;14
109;21.03.2017;2017;03;08;Tiistai;24;7;31;10;3;13
109;21.03.2017;2017;03;09;Tiistai;14;6;20;4;6;10
109;21.03.2017;2017;03;10;Tiistai;6;3;9;1;2;3
109;21.03.2017;2017;03;11;Tiistai;7;4;11;2;2;4
109;21.03.2017;2017;03;12;Tiistai;5;9;14;1;3;4
109;21.03.2017;2017;03;13;Tiistai;5;4;9;3;1;4
109;21.03.2017;2017;03;14;Tiistai;9;13;22;8;4;12
109;21.03.2017;2017;03;15;Tiistai;12;31;43;6;3;9
109;21.03.2017;2017;03;16;Tiistai;26;56;82;5;6;11
109;21.03.2017;2017;03;17;Tiistai;12;22;34;4;2;6
109;21.03.2017;2017;03;18;Tiistai;2;8;10;5;4;9
109;21.03.2017;2017;03;19;Tiistai;4;5;9;10;3;13
109;21.03.2017;2017;03;20;Tiistai;5;6;11;1;5;6
109;21.03.2017;2017;03;21;Tiistai;2;5;7;2;0;2
109;21.03.2017;2017;03;22;Tiistai;4;1;5;2;0;2
109;21.03.2017;2017;03;23;Tiistai;0;0;0;1;0;1
109;22.03.2017;2017;03;00;Keskiviikko;0;0;0;0;0;0
109;22.03.2017;2017;03;01;Keskiviikko;2;0;2;0;0;0
109;22.03.2017;2017;03;02;Keskiviikko;0;0;0;0;1;1
109;22.03.2017;2017;03;03;Keskiviikko;0;0;0;0;0;0
109;22.03.2017;2017;03;04;Keskiviikko;0;0;0;0;0;0
109;22.03.2017;2017;03;05;Keskiviikko;1;0;1;2;0;2
109;22.03.2017;2017;03;06;Keskiviikko;17;12;29;5;1;6
109;22.03.2017;2017;03;07;Keskiviikko;40;20;60;5;3;8
109;22.03.2017;2017;03;08;Keskiviikko;29;7;36;4;5;9
109;22.03.2017;2017;03;09;Keskiviikko;4;4;8;2;1;3
109;22.03.2017;2017;03;10;Keskiviikko;8;1;9;1;6;7
109;22.03.2017;2017;03;11;Keskiviikko;4;5;9;5;9;14
109;22.03.2017;2017;03;12;Keskiviikko;9;4;13;7;2;9
109;22.03.2017;2017;03;13;Keskiviikko;8;9;17;5;6;11
109;22.03.2017;2017;03;14;Keskiviikko;8;13;21;11;6;17
109;22.03.2017;2017;03;15;Keskiviikko;8;22;30;11;2;13
109;22.03.2017;2017;03;16;Keskiviikko;17;40;57;7;6;13
109;22.03.2017;2017;03;17;Keskiviikko;11;20;31;8;2;10
109;22.03.2017;2017;03;18;Keskiviikko;6;9;15;8;4;12
109;22.03.2017;2017;03;19;Keskiviikko;4;7;11;3;4;7
109;22.03.2017;2017;03;20;Keskiviikko;4;8;12;2;4;6
109;22.03.2017;2017;03;21;Keskiviikko;1;8;9;2;2;4
109;22.03.2017;2017;03;22;Keskiviikko;2;3;5;0;1;1
109;22.03.2017;2017;03;23;Keskiviikko;3;0;3;0;1;1
109;23.03.2017;2017;03;00;Torstai;0;0;0;0;0;0
109;23.03.2017;2017;03;01;Torstai;0;1;1;1;0;1
109;23.03.2017;2017;03;02;Torstai;0;0;0;0;0;0
109;23.03.2017;2017;03;03;Torstai;0;0;0;0;0;0
109;23.03.2017;2017;03;04;Torstai;0;0;0;0;0;0
109;23.03.2017;2017;03;05;Torstai;0;3;3;0;0;0
109;23.03.2017;2017;03;06;Torstai;15;12;27;7;1;8
109;23.03.2017;2017;03;07;Torstai;43;17;60;12;6;18
109;23.03.2017;2017;03;08;Torstai;20;11;31;7;3;10
109;23.03.2017;2017;03;09;Torstai;15;5;20;7;1;8
109;23.03.2017;2017;03;10;Torstai;6;1;7;5;6;11
109;23.03.2017;2017;03;11;Torstai;3;3;6;3;4;7
109;23.03.2017;2017;03;12;Torstai;4;6;10;2;4;6
109;23.03.2017;2017;03;13;Torstai;5;9;14;3;2;5
109;23.03.2017;2017;03;14;Torstai;4;15;19;11;3;14
109;23.03.2017;2017;03;15;Torstai;11;25;36;4;3;7
109;23.03.2017;2017;03;16;Torstai;16;40;56;16;5;21
109;23.03.2017;2017;03;17;Torstai;6;8;14;6;3;9
109;23.03.2017;2017;03;18;Torstai;5;13;18;7;2;9
109;23.03.2017;2017;03;19;Torstai;2;6;8;7;6;13
109;23.03.2017;2017;03;20;Torstai;2;2;4;3;2;5
109;23.03.2017;2017;03;21;Torstai;1;1;2;0;0;0
109;23.03.2017;2017;03;22;Torstai;3;1;4;0;0;0
109;23.03.2017;2017;03;23;Torstai;0;0;0;1;0;1
109;24.03.2017;2017;03;00;Perjantai;0;0;0;0;0;0
109;24.03.2017;2017;03;01;Perjantai;0;0;0;0;0;0
109;24.03.2017;2017;03;02;Perjantai;0;0;0;0;0;0
109;24.03.2017;2017;03;03;Perjantai;0;0;0;0;1;1
109;24.03.2017;2017;03;04;Perjantai;0;1;1;0;0;0
109;24.03.2017;2017;03;05;Perjantai;1;3;4;1;0;1
109;24.03.2017;2017;03;06;Perjantai;18;9;27;1;1;2
109;24.03.2017;2017;03;07;Perjantai;40;16;56;5;7;12
109;24.03.2017;2017;03;08;Perjantai;19;5;24;3;3;6
109;24.03.2017;2017;03;09;Perjantai;5;2;7;5;0;5
109;24.03.2017;2017;03;10;Perjantai;5;1;6;4;4;8
109;24.03.2017;2017;03;11;Perjantai;6;4;10;1;6;7
109;24.03.2017;2017;03;12;Perjantai;7;2;9;3;2;5
109;24.03.2017;2017;03;13;Perjantai;7;11;18;2;6;8
109;24.03.2017;2017;03;14;Perjantai;7;12;19;2;3;5
109;24.03.2017;2017;03;15;Perjantai;15;29;44;4;3;7
109;24.03.2017;2017;03;16;Perjantai;8;22;30;4;5;9
109;24.03.2017;2017;03;17;Perjantai;5;7;12;3;3;6
109;24.03.2017;2017;03;18;Perjantai;1;4;5;2;0;2
109;24.03.2017;2017;03;19;Perjantai;3;4;7;8;2;10
109;24.03.2017;2017;03;20;Perjantai;5;2;7;1;2;3
109;24.03.2017;2017;03;21;Perjantai;8;3;11;1;0;1
109;24.03.2017;2017;03;22;Perjantai;0;1;1;1;0;1
109;24.03.2017;2017;03;23;Perjantai;0;1;1;0;1;1
109;25.03.2017;2017;03;00;Lauantai;0;0;0;0;1;1
109;25.03.2017;2017;03;01;Lauantai;0;0;0;0;0;0
109;25.03.2017;2017;03;02;Lauantai;1;2;3;0;0;0
109;25.03.2017;2017;03;03;Lauantai;0;0;0;1;0;1
109;25.03.2017;2017;03;04;Lauantai;0;0;0;0;0;0
109;25.03.2017;2017;03;05;Lauantai;1;2;3;0;0;0
109;25.03.2017;2017;03;06;Lauantai;2;0;2;3;0;3
109;25.03.2017;2017;03;07;Lauantai;1;1;2;0;1;1
109;25.03.2017;2017;03;08;Lauantai;2;2;4;3;0;3
109;25.03.2017;2017;03;09;Lauantai;4;1;5;2;1;3
109;25.03.2017;2017;03;10;Lauantai;4;4;8;3;5;8
109;25.03.2017;2017;03;11;Lauantai;4;3;7;11;5;16
109;25.03.2017;2017;03;12;Lauantai;3;5;8;6;3;9
109;25.03.2017;2017;03;13;Lauantai;6;0;6;2;5;7
109;25.03.2017;2017;03;14;Lauantai;2;2;4;3;4;7
109;25.03.2017;2017;03;15;Lauantai;3;4;7;10;3;13
109;25.03.2017;2017;03;16;Lauantai;3;8;11;8;3;11
109;25.03.2017;2017;03;17;Lauantai;2;4;6;6;5;11
109;25.03.2017;2017;03;18;Lauantai;7;5;12;4;4;8
109;25.03.2017;2017;03;19;Lauantai;6;7;13;6;1;7
109;25.03.2017;2017;03;20;Lauantai;2;0;2;2;3;5
109;25.03.2017;2017;03;21;Lauantai;2;3;5;2;1;3
109;25.03.2017;2017;03;22;Lauantai;0;1;1;1;0;1
109;25.03.2017;2017;03;23;Lauantai;3;4;7;0;0;0
109;26.03.2017;2017;03;00;Sunnuntai;1;0;1;0;0;0
109;26.03.2017;2017;03;01;Sunnuntai;0;0;0;0;1;1
109;26.03.2017;2017;03;02;Sunnuntai;0;0;0;0;0;0
109;26.03.2017;2017;03;03;Sunnuntai;1;0;1;0;0;0
109;26.03.2017;2017;03;04;Sunnuntai;0;0;0;0;0;0
109;26.03.2017;2017;03;05;Sunnuntai;1;2;3;1;0;1
109;26.03.2017;2017;03;06;Sunnuntai;3;0;3;0;1;1
109;26.03.2017;2017;03;07;Sunnuntai;0;1;1;1;2;3
109;26.03.2017;2017;03;08;Sunnuntai;1;0;1;0;0;0
109;26.03.2017;2017;03;09;Sunnuntai;1;0;1;5;0;5
109;26.03.2017;2017;03;10;Sunnuntai;0;1;1;9;8;17
109;26.03.2017;2017;03;11;Sunnuntai;4;2;6;5;1;6
109;26.03.2017;2017;03;12;Sunnuntai;7;2;9;3;3;6
109;26.03.2017;2017;03;13;Sunnuntai;6;3;9;11;6;17
109;26.03.2017;2017;03;14;Sunnuntai;1;2;3;9;2;11
109;26.03.2017;2017;03;15;Sunnuntai;5;4;9;6;3;9
109;26.03.2017;2017;03;16;Sunnuntai;5;7;12;5;2;7
109;26.03.2017;2017;03;17;Sunnuntai;3;0;3;7;3;10
109;26.03.2017;2017;03;18;Sunnuntai;2;6;8;4;5;9
109;26.03.2017;2017;03;19;Sunnuntai;2;2;4;11;2;13
109;26.03.2017;2017;03;20;Sunnuntai;1;3;4;6;5;11
109;26.03.2017;2017;03;21;Sunnuntai;0;3;3;1;1;2
109;26.03.2017;2017;03;22;Sunnuntai;0;0;0;1;2;3
109;26.03.2017;2017;03;23;Sunnuntai;0;0;0;0;0;0
109;27.03.2017;2017;03;00;Maanantai;0;0;0;0;0;0
109;27.03.2017;2017;03;01;Maanantai;0;0;0;0;0;0
109;27.03.2017;2017;03;02;Maanantai;0;0;0;0;0;0
109;27.03.2017;2017;03;03;Maanantai;0;0;0;0;0;0
109;27.03.2017;2017;03;04;Maanantai;2;1;3;0;0;0
109;27.03.2017;2017;03;05;Maanantai;1;3;4;2;0;2
109;27.03.2017;2017;03;06;Maanantai;8;12;20;13;5;18
109;27.03.2017;2017;03;07;Maanantai;36;21;57;17;5;22
109;27.03.2017;2017;03;08;Maanantai;27;9;36;11;5;16
109;27.03.2017;2017;03;09;Maanantai;13;3;16;9;4;13
109;27.03.2017;2017;03;10;Maanantai;3;1;4;5;2;7
109;27.03.2017;2017;03;11;Maanantai;17;9;26;11;10;21
109;27.03.2017;2017;03;12;Maanantai;8;6;14;3;2;5
109;27.03.2017;2017;03;13;Maanantai;7;8;15;1;6;7
109;27.03.2017;2017;03;14;Maanantai;8;7;15;6;2;8
109;27.03.2017;2017;03;15;Maanantai;12;25;37;10;5;15
109;27.03.2017;2017;03;16;Maanantai;13;25;38;5;3;8
109;27.03.2017;2017;03;17;Maanantai;6;14;20;6;5;11
109;27.03.2017;2017;03;18;Maanantai;7;13;20;5;3;8
109;27.03.2017;2017;03;19;Maanantai;5;7;12;8;3;11
109;27.03.2017;2017;03;20;Maanantai;1;8;9;5;3;8
109;27.03.2017;2017;03;21;Maanantai;1;6;7;2;2;4
109;27.03.2017;2017;03;22;Maanantai;3;1;4;0;1;1
109;27.03.2017;2017;03;23;Maanantai;0;0;0;0;2;2
109;28.03.2017;2017;03;00;Tiistai;2;2;4;8;1;9
109;28.03.2017;2017;03;01;Tiistai;0;0;0;0;0;0
109;28.03.2017;2017;03;02;Tiistai;0;0;0;0;1;1
109;28.03.2017;2017;03;03;Tiistai;1;0;1;0;0;0
109;28.03.2017;2017;03;04;Tiistai;1;0;1;0;0;0
109;28.03.2017;2017;03;05;Tiistai;0;2;2;2;0;2
109;28.03.2017;2017;03;06;Tiistai;19;15;34;2;1;3
109;28.03.2017;2017;03;07;Tiistai;37;19;56;4;5;9
109;28.03.2017;2017;03;08;Tiistai;23;8;31;5;2;7
109;28.03.2017;2017;03;09;Tiistai;11;6;17;2;4;6
109;28.03.2017;2017;03;10;Tiistai;5;1;6;5;4;9
109;28.03.2017;2017;03;11;Tiistai;11;7;18;8;4;12
109;28.03.2017;2017;03;12;Tiistai;7;8;15;9;4;13
109;28.03.2017;2017;03;13;Tiistai;4;3;7;4;3;7
109;28.03.2017;2017;03;14;Tiistai;2;14;16;6;6;12
109;28.03.2017;2017;03;15;Tiistai;11;21;32;2;6;8
109;28.03.2017;2017;03;16;Tiistai;23;40;63;12;3;15
109;28.03.2017;2017;03;17;Tiistai;15;9;24;5;7;12
109;28.03.2017;2017;03;18;Tiistai;7;13;20;8;1;9
109;28.03.2017;2017;03;19;Tiistai;3;4;7;11;4;15
109;28.03.2017;2017;03;20;Tiistai;4;8;12;9;1;10
109;28.03.2017;2017;03;21;Tiistai;3;6;9;5;2;7
109;28.03.2017;2017;03;22;Tiistai;1;1;2;0;0;0
109;28.03.2017;2017;03;23;Tiistai;1;0;1;0;0;0
109;29.03.2017;2017;03;00;Keskiviikko;0;5;5;0;0;0
109;29.03.2017;2017;03;01;Keskiviikko;1;0;1;0;1;1
109;29.03.2017;2017;03;02;Keskiviikko;0;0;0;1;1;2
109;29.03.2017;2017;03;03;Keskiviikko;0;0;0;0;0;0
109;29.03.2017;2017;03;04;Keskiviikko;0;0;0;0;0;0
109;29.03.2017;2017;03;05;Keskiviikko;1;2;3;2;1;3
109;29.03.2017;2017;03;06;Keskiviikko;15;13;28;7;0;7
109;29.03.2017;2017;03;07;Keskiviikko;29;18;47;17;2;19
109;29.03.2017;2017;03;08;Keskiviikko;18;4;22;13;6;19
109;29.03.2017;2017;03;09;Keskiviikko;4;7;11;6;5;11
109;29.03.2017;2017;03;10;Keskiviikko;5;2;7;4;6;10
109;29.03.2017;2017;03;11;Keskiviikko;6;4;10;4;0;4
109;29.03.2017;2017;03;12;Keskiviikko;3;5;8;6;6;12
109;29.03.2017;2017;03;13;Keskiviikko;6;9;15;7;2;9
109;29.03.2017;2017;03;14;Keskiviikko;3;10;13;11;4;15
109;29.03.2017;2017;03;15;Keskiviikko;7;24;31;9;5;14
109;29.03.2017;2017;03;16;Keskiviikko;13;36;49;10;6;16
109;29.03.2017;2017;03;17;Keskiviikko;14;14;28;2;5;7
109;29.03.2017;2017;03;18;Keskiviikko;8;13;21;9;5;14
109;29.03.2017;2017;03;19;Keskiviikko;3;4;7;10;4;14
109;29.03.2017;2017;03;20;Keskiviikko;5;8;13;4;2;6
109;29.03.2017;2017;03;21;Keskiviikko;2;10;12;1;1;2
109;29.03.2017;2017;03;22;Keskiviikko;1;3;4;1;0;1
109;29.03.2017;2017;03;23;Keskiviikko;0;0;0;1;1;2
109;30.03.2017;2017;03;00;Torstai;0;0;0;0;0;0
109;30.03.2017;2017;03;01;Torstai;0;0;0;0;0;0
109;30.03.2017;2017;03;02;Torstai;0;0;0;0;1;1
109;30.03.2017;2017;03;03;Torstai;0;0;0;0;1;1
109;30.03.2017;2017;03;04;Torstai;0;0;0;0;0;0
109;30.03.2017;2017;03;05;Torstai;1;1;2;0;0;0
109;30.03.2017;2017;03;06;Torstai;11;15;26;2;0;2
109;30.03.2017;2017;03;07;Torstai;28;16;44;11;5;16
109;30.03.2017;2017;03;08;Torstai;18;9;27;9;3;12
109;30.03.2017;2017;03;09;Torstai;9;0;9;4;2;6
109;30.03.2017;2017;03;10;Torstai;7;0;7;3;1;4
109;30.03.2017;2017;03;11;Torstai;1;3;4;5;2;7
109;30.03.2017;2017;03;12;Torstai;6;6;12;6;3;9
109;30.03.2017;2017;03;13;Torstai;5;8;13;7;3;10
109;30.03.2017;2017;03;14;Torstai;2;6;8;4;1;5
109;30.03.2017;2017;03;15;Torstai;11;28;39;11;7;18
109;30.03.2017;2017;03;16;Torstai;19;26;45;7;3;10
109;30.03.2017;2017;03;17;Torstai;5;17;22;12;5;17
109;30.03.2017;2017;03;18;Torstai;3;3;6;12;8;20
109;30.03.2017;2017;03;19;Torstai;4;3;7;9;0;9
109;30.03.2017;2017;03;20;Torstai;2;4;6;6;5;11
109;30.03.2017;2017;03;21;Torstai;4;8;12;1;3;4
109;30.03.2017;2017;03;22;Torstai;2;3;5;0;1;1
109;30.03.2017;2017;03;23;Torstai;0;1;1;0;0;0
109;31.03.2017;2017;03;00;Perjantai;0;0;0;0;0;0
109;31.03.2017;2017;03;01;Perjantai;2;0;2;1;1;2
109;31.03.2017;2017;03;02;Perjantai;0;0;0;0;0;0
109;31.03.2017;2017;03;03;Perjantai;0;0;0;0;0;0
109;31.03.2017;2017;03;04;Perjantai;0;1;1;0;0;0
109;31.03.2017;2017;03;05;Perjantai;3;1;4;2;0;2
109;31.03.2017;2017;03;06;Perjantai;18;11;29;4;2;6
109;31.03.2017;2017;03;07;Perjantai;28;17;45;8;2;10
109;31.03.2017;2017;03;08;Perjantai;23;8;31;3;3;6
109;31.03.2017;2017;03;09;Perjantai;12;1;13;3;2;5
109;31.03.2017;2017;03;10;Perjantai;6;1;7;4;3;7
109;31.03.2017;2017;03;11;Perjantai;7;8;15;3;7;10
109;31.03.2017;2017;03;12;Perjantai;7;6;13;13;6;19
109;31.03.2017;2017;03;13;Perjantai;5;11;16;4;9;13
109;31.03.2017;2017;03;14;Perjantai;9;19;28;8;9;17
109;31.03.2017;2017;03;15;Perjantai;11;26;37;4;2;6
109;31.03.2017;2017;03;16;Perjantai;11;20;31;6;6;12
109;31.03.2017;2017;03;17;Perjantai;6;10;16;5;5;10
109;31.03.2017;2017;03;18;Perjantai;3;7;10;3;3;6
109;31.03.2017;2017;03;19;Perjantai;3;3;6;2;4;6
109;31.03.2017;2017;03;20;Perjantai;4;4;8;7;2;9
109;31.03.2017;2017;03;21;Perjantai;2;3;5;2;2;4
109;31.03.2017;2017;03;22;Perjantai;1;1;2;0;1;1
109;31.03.2017;2017;03;23;Perjantai;1;1;2;0;0;0
109;01.04.2017;2017;04;00;Lauantai;3;0;3;0;1;1
109;01.04.2017;2017;04;01;Lauantai;0;2;2;0;0;0
109;01.04.2017;2017;04;02;Lauantai;1;1;2;1;0;1
109;01.04.2017;2017;04;03;Lauantai;1;1;2;0;0;0
109;01.04.2017;2017;04;04;Lauantai;0;0;0;0;0;0
109;01.04.2017;2017;04;05;Lauantai;1;2;3;0;1;1
109;01.04.2017;2017;04;06;Lauantai;6;1;7;0;2;2
109;01.04.2017;2017;04;07;Lauantai;1;3;4;3;1;4
109;01.04.2017;2017;04;08;Lauantai;3;0;3;2;2;4
109;01.04.2017;2017;04;09;Lauantai;2;0;2;6;2;8
109;01.04.2017;2017;04;10;Lauantai;3;2;5;4;5;9
109;01.04.2017;2017;04;11;Lauantai;4;5;9;5;3;8
109;01.04.2017;2017;04;12;Lauantai;1;9;10;3;1;4
109;01.04.2017;2017;04;13;Lauantai;1;5;6;5;3;8
109;01.04.2017;2017;04;14;Lauantai;6;5;11;3;4;7
109;01.04.2017;2017;04;15;Lauantai;1;4;5;1;1;2
109;01.04.2017;2017;04;16;Lauantai;1;5;6;3;3;6
109;01.04.2017;2017;04;17;Lauantai;2;3;5;3;2;5
109;01.04.2017;2017;04;18;Lauantai;1;3;4;4;1;5
109;01.04.2017;2017;04;19;Lauantai;0;0;0;7;1;8
109;01.04.2017;2017;04;20;Lauantai;3;2;5;1;2;3
109;01.04.2017;2017;04;21;Lauantai;1;0;1;3;0;3
109;01.04.2017;2017;04;22;Lauantai;2;1;3;3;2;5
109;01.04.2017;2017;04;23;Lauantai;0;0;0;3;1;4
109;02.04.2017;2017;04;00;Sunnuntai;0;0;0;0;1;1
109;02.04.2017;2017;04;01;Sunnuntai;2;1;3;3;0;3
109;02.04.2017;2017;04;02;Sunnuntai;1;0;1;0;0;0
109;02.04.2017;2017;04;03;Sunnuntai;0;2;2;0;1;1
109;02.04.2017;2017;04;04;Sunnuntai;1;0;1;0;0;0
109;02.04.2017;2017;04;05;Sunnuntai;0;0;0;1;0;1
109;02.04.2017;2017;04;06;Sunnuntai;3;0;3;4;0;4
109;02.04.2017;2017;04;07;Sunnuntai;2;2;4;0;1;1
109;02.04.2017;2017;04;08;Sunnuntai;2;0;2;4;1;5
109;02.04.2017;2017;04;09;Sunnuntai;2;2;4;6;2;8
109;02.04.2017;2017;04;10;Sunnuntai;5;3;8;7;5;12
109;02.04.2017;2017;04;11;Sunnuntai;3;2;5;11;6;17
109;02.04.2017;2017;04;12;Sunnuntai;2;4;6;7;1;8
109;02.04.2017;2017;04;13;Sunnuntai;7;5;12;10;7;17
109;02.04.2017;2017;04;14;Sunnuntai;1;2;3;9;8;17
109;02.04.2017;2017;04;15;Sunnuntai;6;8;14;9;2;11
109;02.04.2017;2017;04;16;Sunnuntai;2;3;5;9;5;14
109;02.04.2017;2017;04;17;Sunnuntai;4;0;4;8;8;16
109;02.04.2017;2017;04;18;Sunnuntai;5;7;12;7;5;12
109;02.04.2017;2017;04;19;Sunnuntai;1;4;5;8;3;11
109;02.04.2017;2017;04;20;Sunnuntai;1;2;3;6;2;8
109;02.04.2017;2017;04;21;Sunnuntai;3;0;3;4;1;5
109;02.04.2017;2017;04;22;Sunnuntai;1;0;1;0;0;0
109;02.04.2017;2017;04;23;Sunnuntai;0;0;0;0;0;0
109;03.04.2017;2017;04;00;Maanantai;1;0;1;1;0;1
109;03.04.2017;2017;04;01;Maanantai;0;0;0;0;0;0
109;03.04.2017;2017;04;02;Maanantai;0;0;0;0;0;0
109;03.04.2017;2017;04;03;Maanantai;0;0;0;0;0;0
109;03.04.2017;2017;04;04;Maanantai;0;0;0;0;0;0
109;03.04.2017;2017;04;05;Maanantai;3;0;3;0;0;0
109;03.04.2017;2017;04;06;Maanantai;21;13;34;7;2;9
109;03.04.2017;2017;04;07;Maanantai;45;20;65;15;4;19
109;03.04.2017;2017;04;08;Maanantai;29;12;41;5;3;8
109;03.04.2017;2017;04;09;Maanantai;10;2;12;8;2;10
109;03.04.2017;2017;04;10;Maanantai;8;1;9;11;4;15
109;03.04.2017;2017;04;11;Maanantai;2;6;8;9;5;14
109;03.04.2017;2017;04;12;Maanantai;5;9;14;4;2;6
109;03.04.2017;2017;04;13;Maanantai;3;7;10;5;7;12
109;03.04.2017;2017;04;14;Maanantai;8;16;24;7;4;11
109;03.04.2017;2017;04;15;Maanantai;10;31;41;15;6;21
109;03.04.2017;2017;04;16;Maanantai;14;40;54;17;10;27
109;03.04.2017;2017;04;17;Maanantai;7;21;28;11;1;12
109;03.04.2017;2017;04;18;Maanantai;7;8;15;6;9;15
109;03.04.2017;2017;04;19;Maanantai;4;7;11;6;7;13
109;03.04.2017;2017;04;20;Maanantai;1;6;7;4;1;5
109;03.04.2017;2017;04;21;Maanantai;2;8;10;3;2;5
109;03.04.2017;2017;04;22;Maanantai;2;0;2;0;1;1
109;03.04.2017;2017;04;23;Maanantai;1;0;1;2;0;2
109;04.04.2017;2017;04;00;Tiistai;0;0;0;0;0;0
109;04.04.2017;2017;04;01;Tiistai;0;0;0;0;2;2
109;04.04.2017;2017;04;02;Tiistai;0;0;0;0;1;1
109;04.04.2017;2017;04;03;Tiistai;0;0;0;0;0;0
109;04.04.2017;2017;04;04;Tiistai;0;1;1;0;1;1
109;04.04.2017;2017;04;05;Tiistai;1;2;3;0;0;0
109;04.04.2017;2017;04;06;Tiistai;15;16;31;11;0;11
109;04.04.2017;2017;04;07;Tiistai;34;24;58;19;7;26
109;04.04.2017;2017;04;08;Tiistai;17;11;28;10;0;10
109;04.04.2017;2017;04;09;Tiistai;10;3;13;5;4;9
109;04.04.2017;2017;04;10;Tiistai;3;0;3;5;6;11
109;04.04.2017;2017;04;11;Tiistai;6;2;8;12;4;16
109;04.04.2017;2017;04;12;Tiistai;5;6;11;7;0;7
109;04.04.2017;2017;04;13;Tiistai;5;12;17;4;6;10
109;04.04.2017;2017;04;14;Tiistai;8;9;17;3;6;9
109;04.04.2017;2017;04;15;Tiistai;13;35;48;13;6;19
109;04.04.2017;2017;04;16;Tiistai;23;41;64;8;6;14
109;04.04.2017;2017;04;17;Tiistai;10;15;25;5;5;10
109;04.04.2017;2017;04;18;Tiistai;9;17;26;5;8;13
109;04.04.2017;2017;04;19;Tiistai;7;10;17;7;2;9
109;04.04.2017;2017;04;20;Tiistai;3;3;6;9;3;12
109;04.04.2017;2017;04;21;Tiistai;1;8;9;5;3;8
109;04.04.2017;2017;04;22;Tiistai;2;3;5;1;3;4
109;04.04.2017;2017;04;23;Tiistai;0;0;0;0;2;2
109;05.04.2017;2017;04;00;Keskiviikko;1;0;1;1;0;1
109;05.04.2017;2017;04;01;Keskiviikko;0;0;0;0;0;0
109;05.04.2017;2017;04;02;Keskiviikko;0;0;0;0;0;0
109;05.04.2017;2017;04;03;Keskiviikko;0;0;0;1;0;1
109;05.04.2017;2017;04;04;Keskiviikko;0;0;0;0;0;0
109;05.04.2017;2017;04;05;Keskiviikko;3;2;5;0;0;0
109;05.04.2017;2017;04;06;Keskiviikko;23;6;29;4;2;6
109;05.04.2017;2017;04;07;Keskiviikko;44;17;61;5;2;7
109;05.04.2017;2017;04;08;Keskiviikko;29;11;40;4;3;7
109;05.04.2017;2017;04;09;Keskiviikko;9;7;16;5;3;8
109;05.04.2017;2017;04;10;Keskiviikko;3;3;6;2;4;6
109;05.04.2017;2017;04;11;Keskiviikko;9;6;15;5;2;7
109;05.04.2017;2017;04;12;Keskiviikko;14;11;25;7;3;10
109;05.04.2017;2017;04;13;Keskiviikko;16;10;26;5;3;8
109;05.04.2017;2017;04;14;Keskiviikko;10;19;29;9;4;13
109;05.04.2017;2017;04;15;Keskiviikko;19;31;50;4;1;5
109;05.04.2017;2017;04;16;Keskiviikko;24;40;64;12;6;18
109;05.04.2017;2017;04;17;Keskiviikko;18;18;36;5;6;11
109;05.04.2017;2017;04;18;Keskiviikko;6;13;19;8;2;10
109;05.04.2017;2017;04;19;Keskiviikko;3;9;12;2;4;6
109;05.04.2017;2017;04;20;Keskiviikko;3;8;11;12;4;16
109;05.04.2017;2017;04;21;Keskiviikko;2;4;6;2;3;5
109;05.04.2017;2017;04;22;Keskiviikko;2;5;7;3;2;5
109;05.04.2017;2017;04;23;Keskiviikko;0;0;0;1;0;1
109;06.04.2017;2017;04;00;Torstai;0;1;1;0;3;3
109;06.04.2017;2017;04;01;Torstai;0;0;0;0;0;0
109;06.04.2017;2017;04;02;Torstai;0;0;0;0;0;0
109;06.04.2017;2017;04;03;Torstai;0;0;0;0;0;0
109;06.04.2017;2017;04;04;Torstai;1;0;1;0;0;0
109;06.04.2017;2017;04;05;Torstai;4;1;5;0;1;1
109;06.04.2017;2017;04;06;Torstai;18;13;31;2;1;3
109;06.04.2017;2017;04;07;Torstai;49;20;69;7;5;12
109;06.04.2017;2017;04;08;Torstai;35;8;43;4;2;6
109;06.04.2017;2017;04;09;Torstai;9;7;16;4;1;5
109;06.04.2017;2017;04;10;Torstai;9;5;14;4;2;6
109;06.04.2017;2017;04;11;Torstai;12;11;23;5;4;9
109;06.04.2017;2017;04;12;Torstai;10;8;18;3;3;6
109;06.04.2017;2017;04;13;Torstai;11;11;22;6;4;10
109;06.04.2017;2017;04;14;Torstai;8;16;24;6;3;9
109;06.04.2017;2017;04;15;Torstai;22;42;64;3;2;5
109;06.04.2017;2017;04;16;Torstai;24;40;64;11;5;16
109;06.04.2017;2017;04;17;Torstai;9;24;33;5;2;7
109;06.04.2017;2017;04;18;Torstai;15;16;31;7;4;11
109;06.04.2017;2017;04;19;Torstai;2;8;10;14;0;14
109;06.04.2017;2017;04;20;Torstai;4;9;13;8;4;12
109;06.04.2017;2017;04;21;Torstai;0;4;4;2;3;5
109;06.04.2017;2017;04;22;Torstai;2;2;4;3;0;3
109;06.04.2017;2017;04;23;Torstai;2;1;3;2;0;2
109;07.04.2017;2017;04;00;Perjantai;0;0;0;1;1;2
109;07.04.2017;2017;04;01;Perjantai;0;0;0;0;0;0
109;07.04.2017;2017;04;02;Perjantai;0;0;0;1;1;2
109;07.04.2017;2017;04;03;Perjantai;0;0;0;0;0;0
109;07.04.2017;2017;04;04;Perjantai;2;0;2;0;0;0
109;07.04.2017;2017;04;05;Perjantai;2;3;5;0;0;0
109;07.04.2017;2017;04;06;Perjantai;16;13;29;2;2;4
109;07.04.2017;2017;04;07;Perjantai;46;18;64;4;4;8
109;07.04.2017;2017;04;08;Perjantai;32;8;40;3;1;4
109;07.04.2017;2017;04;09;Perjantai;13;5;18;3;2;5
109;07.04.2017;2017;04;10;Perjantai;11;6;17;2;1;3
109;07.04.2017;2017;04;11;Perjantai;7;5;12;6;2;8
109;07.04.2017;2017;04;12;Perjantai;11;9;20;7;6;13
109;07.04.2017;2017;04;13;Perjantai;6;18;24;5;5;10
109;07.04.2017;2017;04;14;Perjantai;12;23;35;6;1;7
109;07.04.2017;2017;04;15;Perjantai;18;38;56;6;2;8
109;07.04.2017;2017;04;16;Perjantai;20;28;48;7;5;12
109;07.04.2017;2017;04;17;Perjantai;9;21;30;9;6;15
109;07.04.2017;2017;04;18;Perjantai;6;7;13;7;3;10
109;07.04.2017;2017;04;19;Perjantai;2;6;8;5;1;6
109;07.04.2017;2017;04;20;Perjantai;1;3;4;7;1;8
109;07.04.2017;2017;04;21;Perjantai;5;8;13;1;2;3
109;07.04.2017;2017;04;22;Perjantai;2;4;6;1;1;2
109;07.04.2017;2017;04;23;Perjantai;1;1;2;1;0;1
109;08.04.2017;2017;04;00;Lauantai;2;1;3;0;0;0
109;08.04.2017;2017;04;01;Lauantai;2;0;2;0;0;0
109;08.04.2017;2017;04;02;Lauantai;0;1;1;0;2;2
109;08.04.2017;2017;04;03;Lauantai;0;0;0;0;0;0
109;08.04.2017;2017;04;04;Lauantai;1;1;2;0;0;0
109;08.04.2017;2017;04;05;Lauantai;1;1;2;1;1;2
109;08.04.2017;2017;04;06;Lauantai;3;0;3;1;1;2
109;08.04.2017;2017;04;07;Lauantai;3;0;3;5;0;5
109;08.04.2017;2017;04;08;Lauantai;5;2;7;3;0;3
109;08.04.2017;2017;04;09;Lauantai;5;1;6;3;1;4
109;08.04.2017;2017;04;10;Lauantai;2;2;4;6;6;12
109;08.04.2017;2017;04;11;Lauantai;9;5;14;4;5;9
109;08.04.2017;2017;04;12;Lauantai;4;3;7;4;3;7
109;08.04.2017;2017;04;13;Lauantai;1;9;10;11;6;17
109;08.04.2017;2017;04;14;Lauantai;7;5;12;6;3;9
109;08.04.2017;2017;04;15;Lauantai;7;4;11;8;1;9
109;08.04.2017;2017;04;16;Lauantai;2;6;8;7;4;11
109;08.04.2017;2017;04;17;Lauantai;7;3;10;12;3;15
109;08.04.2017;2017;04;18;Lauantai;8;11;19;8;9;17
109;08.04.2017;2017;04;19;Lauantai;3;0;3;10;7;17
109;08.04.2017;2017;04;20;Lauantai;3;3;6;5;5;10
109;08.04.2017;2017;04;21;Lauantai;2;9;11;4;3;7
109;08.04.2017;2017;04;22;Lauantai;1;0;1;0;1;1
109;08.04.2017;2017;04;23;Lauantai;0;0;0;0;0;0
109;09.04.2017;2017;04;00;Sunnuntai;0;0;0;0;0;0
109;09.04.2017;2017;04;01;Sunnuntai;1;1;2;0;0;0
109;09.04.2017;2017;04;02;Sunnuntai;1;0;1;0;0;0
109;09.04.2017;2017;04;03;Sunnuntai;1;0;1;0;0;0
109;09.04.2017;2017;04;04;Sunnuntai;1;0;1;1;0;1
109;09.04.2017;2017;04;05;Sunnuntai;0;2;2;0;0;0
109;09.04.2017;2017;04;06;Sunnuntai;3;0;3;3;3;6
109;09.04.2017;2017;04;07;Sunnuntai;0;1;1;3;1;4
109;09.04.2017;2017;04;08;Sunnuntai;3;1;4;11;4;15
109;09.04.2017;2017;04;09;Sunnuntai;4;2;6;4;7;11
109;09.04.2017;2017;04;10;Sunnuntai;6;3;9;6;4;10
109;09.04.2017;2017;04;11;Sunnuntai;3;5;8;8;2;10
109;09.04.2017;2017;04;12;Sunnuntai;9;6;15;10;3;13
109;09.04.2017;2017;04;13;Sunnuntai;0;6;6;4;4;8
109;09.04.2017;2017;04;14;Sunnuntai;8;4;12;3;3;6
109;09.04.2017;2017;04;15;Sunnuntai;3;6;9;6;8;14
109;09.04.2017;2017;04;16;Sunnuntai;6;6;12;11;4;15
109;09.04.2017;2017;04;17;Sunnuntai;6;5;11;13;3;16
109;09.04.2017;2017;04;18;Sunnuntai;7;2;9;10;4;14
109;09.04.2017;2017;04;19;Sunnuntai;4;1;5;4;7;11
109;09.04.2017;2017;04;20;Sunnuntai;4;6;10;6;3;9
109;09.04.2017;2017;04;21;Sunnuntai;0;6;6;2;2;4
109;09.04.2017;2017;04;22;Sunnuntai;1;1;2;1;1;2
109;09.04.2017;2017;04;23;Sunnuntai;0;0;0;1;0;1
109;10.04.2017;2017;04;00;Maanantai;1;1;2;0;0;0
109;10.04.2017;2017;04;01;Maanantai;0;0;0;0;0;0
109;10.04.2017;2017;04;02;Maanantai;0;0;0;0;0;0
109;10.04.2017;2017;04;03;Maanantai;0;0;0;0;0;0
109;10.04.2017;2017;04;04;Maanantai;0;0;0;0;0;0
109;10.04.2017;2017;04;05;Maanantai;4;0;4;0;0;0
109;10.04.2017;2017;04;06;Maanantai;18;13;31;4;1;5
109;10.04.2017;2017;04;07;Maanantai;54;19;73;7;4;11
109;10.04.2017;2017;04;08;Maanantai;25;6;31;3;5;8
109;10.04.2017;2017;04;09;Maanantai;11;4;15;3;4;7
109;10.04.2017;2017;04;10;Maanantai;6;4;10;4;2;6
109;10.04.2017;2017;04;11;Maanantai;7;3;10;7;4;11
109;10.04.2017;2017;04;12;Maanantai;7;3;10;3;1;4
109;10.04.2017;2017;04;13;Maanantai;3;4;7;5;5;10
109;10.04.2017;2017;04;14;Maanantai;3;12;15;2;7;9
109;10.04.2017;2017;04;15;Maanantai;14;34;48;8;3;11
109;10.04.2017;2017;04;16;Maanantai;16;33;49;4;5;9
109;10.04.2017;2017;04;17;Maanantai;2;22;24;1;1;2
109;10.04.2017;2017;04;18;Maanantai;2;9;11;9;5;14
109;10.04.2017;2017;04;19;Maanantai;2;5;7;8;4;12
109;10.04.2017;2017;04;20;Maanantai;5;3;8;2;6;8
109;10.04.2017;2017;04;21;Maanantai;1;6;7;3;4;7
109;10.04.2017;2017;04;22;Maanantai;3;0;3;0;1;1
109;10.04.2017;2017;04;23;Maanantai;0;0;0;1;0;1
109;11.04.2017;2017;04;00;Tiistai;0;0;0;1;0;1
109;11.04.2017;2017;04;01;Tiistai;0;0;0;0;0;0
109;11.04.2017;2017;04;02;Tiistai;0;1;1;0;0;0
109;11.04.2017;2017;04;03;Tiistai;0;0;0;0;0;0
109;11.04.2017;2017;04;04;Tiistai;0;1;1;0;0;0
109;11.04.2017;2017;04;05;Tiistai;0;0;0;0;0;0
109;11.04.2017;2017;04;06;Tiistai;18;14;32;2;1;3
109;11.04.2017;2017;04;07;Tiistai;43;13;56;3;2;5
109;11.04.2017;2017;04;08;Tiistai;24;4;28;2;2;4
109;11.04.2017;2017;04;09;Tiistai;7;3;10;1;3;4
109;11.04.2017;2017;04;10;Tiistai;4;3;7;4;2;6
109;11.04.2017;2017;04;11;Tiistai;5;3;8;2;1;3
109;11.04.2017;2017;04;12;Tiistai;6;4;10;3;4;7
109;11.04.2017;2017;04;13;Tiistai;4;6;10;4;6;10
109;11.04.2017;2017;04;14;Tiistai;4;14;18;8;2;10
109;11.04.2017;2017;04;15;Tiistai;13;33;46;4;5;9
109;11.04.2017;2017;04;16;Tiistai;13;57;70;7;5;12
109;11.04.2017;2017;04;17;Tiistai;10;19;29;9;2;11
109;11.04.2017;2017;04;18;Tiistai;2;9;11;11;4;15
109;11.04.2017;2017;04;19;Tiistai;4;9;13;13;7;20
109;11.04.2017;2017;04;20;Tiistai;6;10;16;1;4;5
109;11.04.2017;2017;04;21;Tiistai;5;4;9;1;4;5
109;11.04.2017;2017;04;22;Tiistai;2;0;2;0;0;0
109;11.04.2017;2017;04;23;Tiistai;0;0;0;1;0;1
109;12.04.2017;2017;04;00;Keskiviikko;1;0;1;0;0;0
109;12.04.2017;2017;04;01;Keskiviikko;2;0;2;0;1;1
109;12.04.2017;2017;04;02;Keskiviikko;0;0;0;0;0;0
109;12.04.2017;2017;04;03;Keskiviikko;0;0;0;0;0;0
109;12.04.2017;2017;04;04;Keskiviikko;1;0;1;0;0;0
109;12.04.2017;2017;04;05;Keskiviikko;0;1;1;2;0;2
109;12.04.2017;2017;04;06;Keskiviikko;18;13;31;4;1;5
109;12.04.2017;2017;04;07;Keskiviikko;56;27;83;3;2;5
109;12.04.2017;2017;04;08;Keskiviikko;26;11;37;3;4;7
109;12.04.2017;2017;04;09;Keskiviikko;13;4;17;2;3;5
109;12.04.2017;2017;04;10;Keskiviikko;6;8;14;2;3;5
109;12.04.2017;2017;04;11;Keskiviikko;9;7;16;6;4;10
109;12.04.2017;2017;04;12;Keskiviikko;10;9;19;11;2;13
109;12.04.2017;2017;04;13;Keskiviikko;8;12;20;1;6;7
109;12.04.2017;2017;04;14;Keskiviikko;3;16;19;2;2;4
109;12.04.2017;2017;04;15;Keskiviikko;17;30;47;9;3;12
109;12.04.2017;2017;04;16;Keskiviikko;18;42;60;9;2;11
109;12.04.2017;2017;04;17;Keskiviikko;16;17;33;4;3;7
109;12.04.2017;2017;04;18;Keskiviikko;4;10;14;4;5;9
109;12.04.2017;2017;04;19;Keskiviikko;2;7;9;9;3;12
109;12.04.2017;2017;04;20;Keskiviikko;7;8;15;6;3;9
109;12.04.2017;2017;04;21;Keskiviikko;10;5;15;5;4;9
109;12.04.2017;2017;04;22;Keskiviikko;1;2;3;0;0;0
109;12.04.2017;2017;04;23;Keskiviikko;1;0;1;0;0;0
109;13.04.2017;2017;04;00;Torstai;2;0;2;0;2;2
109;13.04.2017;2017;04;01;Torstai;0;0;0;0;1;1
109;13.04.2017;2017;04;02;Torstai;0;0;0;0;0;0
109;13.04.2017;2017;04;03;Torstai;2;0;2;0;0;0
109;13.04.2017;2017;04;04;Torstai;1;3;4;0;0;0
109;13.04.2017;2017;04;05;Torstai;2;0;2;0;0;0
109;13.04.2017;2017;04;06;Torstai;19;9;28;3;1;4
109;13.04.2017;2017;04;07;Torstai;45;13;58;7;2;9
109;13.04.2017;2017;04;08;Torstai;19;6;25;1;2;3
109;13.04.2017;2017;04;09;Torstai;15;4;19;4;5;9
109;13.04.2017;2017;04;10;Torstai;8;5;13;5;0;5
109;13.04.2017;2017;04;11;Torstai;10;5;15;4;3;7
109;13.04.2017;2017;04;12;Torstai;10;6;16;3;3;6
109;13.04.2017;2017;04;13;Torstai;12;11;23;6;2;8
109;13.04.2017;2017;04;14;Torstai;19;23;42;6;3;9
109;13.04.2017;2017;04;15;Torstai;10;31;41;9;7;16
109;13.04.2017;2017;04;16;Torstai;14;25;39;5;2;7
109;13.04.2017;2017;04;17;Torstai;12;12;24;11;2;13
109;13.04.2017;2017;04;18;Torstai;12;1;13;9;3;12
109;13.04.2017;2017;04;19;Torstai;1;5;6;7;4;11
109;13.04.2017;2017;04;20;Torstai;4;8;12;2;4;6
109;13.04.2017;2017;04;21;Torstai;3;7;10;9;3;12
109;13.04.2017;2017;04;22;Torstai;0;3;3;0;1;1
109;13.04.2017;2017;04;23;Torstai;1;2;3;0;0;0
109;14.04.2017;2017;04;00;Perjantai;1;1;2;0;1;1
109;14.04.2017;2017;04;01;Perjantai;0;0;0;1;0;1
109;14.04.2017;2017;04;02;Perjantai;0;0;0;0;0;0
109;14.04.2017;2017;04;03;Perjantai;0;1;1;0;0;0
109;14.04.2017;2017;04;04;Perjantai;0;0;0;0;0;0
109;14.04.2017;2017;04;05;Perjantai;1;0;1;0;0;0
109;14.04.2017;2017;04;06;Perjantai;2;1;3;0;0;0
109;14.04.2017;2017;04;07;Perjantai;0;1;1;3;2;5
109;14.04.2017;2017;04;08;Perjantai;2;1;3;2;1;3
109;14.04.2017;2017;04;09;Perjantai;1;1;2;6;2;8
109;14.04.2017;2017;04;10;Perjantai;0;1;1;8;1;9
109;14.04.2017;2017;04;11;Perjantai;2;4;6;5;8;13
109;14.04.2017;2017;04;12;Perjantai;4;5;9;7;2;9
109;14.04.2017;2017;04;13;Perjantai;2;2;4;5;2;7
109;14.04.2017;2017;04;14;Perjantai;3;1;4;3;2;5
109;14.04.2017;2017;04;15;Perjantai;4;3;7;3;2;5
109;14.04.2017;2017;04;16;Perjantai;4;2;6;4;5;9
109;14.04.2017;2017;04;17;Perjantai;5;5;10;4;2;6
109;14.04.2017;2017;04;18;Perjantai;1;7;8;3;2;5
109;14.04.2017;2017;04;19;Perjantai;1;1;2;4;3;7
109;14.04.2017;2017;04;20;Perjantai;4;4;8;5;3;8
109;14.04.2017;2017;04;21;Perjantai;2;0;2;1;3;4
109;14.04.2017;2017;04;22;Perjantai;1;3;4;1;1;2
109;14.04.2017;2017;04;23;Perjantai;0;0;0;3;0;3
109;15.04.2017;2017;04;00;Lauantai;1;1;2;0;0;0
109;15.04.2017;2017;04;01;Lauantai;1;0;1;0;1;1
109;15.04.2017;2017;04;02;Lauantai;1;1;2;0;0;0
109;15.04.2017;2017;04;03;Lauantai;0;0;0;0;0;0
109;15.04.2017;2017;04;04;Lauantai;0;1;1;0;0;0
109;15.04.2017;2017;04;05;Lauantai;1;2;3;0;0;0
109;15.04.2017;2017;04;06;Lauantai;2;1;3;1;0;1
109;15.04.2017;2017;04;07;Lauantai;2;1;3;2;3;5
109;15.04.2017;2017;04;08;Lauantai;3;0;3;0;1;1
109;15.04.2017;2017;04;09;Lauantai;2;0;2;2;1;3
109;15.04.2017;2017;04;10;Lauantai;1;1;2;1;3;4
109;15.04.2017;2017;04;11;Lauantai;4;2;6;9;2;11
109;15.04.2017;2017;04;12;Lauantai;5;4;9;2;4;6
109;15.04.2017;2017;04;13;Lauantai;5;0;5;4;3;7
109;15.04.2017;2017;04;14;Lauantai;5;4;9;9;3;12
109;15.04.2017;2017;04;15;Lauantai;7;4;11;2;5;7
109;15.04.2017;2017;04;16;Lauantai;1;5;6;3;2;5
109;15.04.2017;2017;04;17;Lauantai;3;8;11;2;2;4
109;15.04.2017;2017;04;18;Lauantai;2;8;10;7;1;8
109;15.04.2017;2017;04;19;Lauantai;4;1;5;4;4;8
109;15.04.2017;2017;04;20;Lauantai;1;3;4;2;2;4
109;15.04.2017;2017;04;21;Lauantai;1;8;9;2;1;3
109;15.04.2017;2017;04;22;Lauantai;6;1;7;0;1;1
109;15.04.2017;2017;04;23;Lauantai;1;1;2;2;0;2
109;16.04.2017;2017;04;00;Sunnuntai;0;2;2;0;1;1
109;16.04.2017;2017;04;01;Sunnuntai;0;0;0;0;0;0
109;16.04.2017;2017;04;02;Sunnuntai;0;1;1;0;0;0
109;16.04.2017;2017;04;03;Sunnuntai;0;0;0;0;0;0
109;16.04.2017;2017;04;04;Sunnuntai;1;1;2;0;0;0
109;16.04.2017;2017;04;05;Sunnuntai;0;1;1;0;3;3
109;16.04.2017;2017;04;06;Sunnuntai;3;0;3;2;0;2
109;16.04.2017;2017;04;07;Sunnuntai;1;2;3;0;3;3
109;16.04.2017;2017;04;08;Sunnuntai;3;1;4;3;2;5
109;16.04.2017;2017;04;09;Sunnuntai;1;1;2;7;4;11
109;16.04.2017;2017;04;10;Sunnuntai;1;1;2;7;3;10
109;16.04.2017;2017;04;11;Sunnuntai;6;6;12;4;3;7
109;16.04.2017;2017;04;12;Sunnuntai;9;4;13;11;5;16
109;16.04.2017;2017;04;13;Sunnuntai;5;8;13;8;2;10
109;16.04.2017;2017;04;14;Sunnuntai;5;5;10;7;1;8
109;16.04.2017;2017;04;15;Sunnuntai;7;8;15;6;5;11
109;16.04.2017;2017;04;16;Sunnuntai;5;3;8;5;3;8
109;16.04.2017;2017;04;17;Sunnuntai;6;5;11;3;2;5
109;16.04.2017;2017;04;18;Sunnuntai;6;1;7;6;8;14
109;16.04.2017;2017;04;19;Sunnuntai;4;6;10;5;0;5
109;16.04.2017;2017;04;20;Sunnuntai;1;5;6;3;3;6
109;16.04.2017;2017;04;21;Sunnuntai;1;2;3;1;0;1
109;16.04.2017;2017;04;22;Sunnuntai;2;3;5;1;1;2
109;16.04.2017;2017;04;23;Sunnuntai;0;2;2;2;1;3
109;17.04.2017;2017;04;00;Maanantai;0;0;0;0;0;0
109;17.04.2017;2017;04;01;Maanantai;1;0;1;0;0;0
109;17.04.2017;2017;04;02;Maanantai;0;0;0;0;0;0
109;17.04.2017;2017;04;03;Maanantai;0;0;0;1;1;2
109;17.04.2017;2017;04;04;Maanantai;1;0;1;0;1;1
109;17.04.2017;2017;04;05;Maanantai;0;0;0;0;1;1
109;17.04.2017;2017;04;06;Maanantai;8;2;10;0;0;0
109;17.04.2017;2017;04;07;Maanantai;1;0;1;3;0;3
109;17.04.2017;2017;04;08;Maanantai;3;0;3;4;4;8
109;17.04.2017;2017;04;09;Maanantai;1;1;2;3;1;4
109;17.04.2017;2017;04;10;Maanantai;5;1;6;10;7;17
109;17.04.2017;2017;04;11;Maanantai;12;4;16;11;8;19
109;17.04.2017;2017;04;12;Maanantai;11;8;19;8;3;11
109;17.04.2017;2017;04;13;Maanantai;11;8;19;6;8;14
109;17.04.2017;2017;04;14;Maanantai;9;13;22;7;5;12
109;17.04.2017;2017;04;15;Maanantai;13;8;21;5;10;15
109;17.04.2017;2017;04;16;Maanantai;10;11;21;13;4;17
109;17.04.2017;2017;04;17;Maanantai;7;5;12;4;5;9
109;17.04.2017;2017;04;18;Maanantai;3;7;10;8;2;10
109;17.04.2017;2017;04;19;Maanantai;5;7;12;7;3;10
109;17.04.2017;2017;04;20;Maanantai;2;5;7;6;2;8
109;17.04.2017;2017;04;21;Maanantai;2;4;6;2;0;2
109;17.04.2017;2017;04;22;Maanantai;1;1;2;1;1;2
109;17.04.2017;2017;04;23;Maanantai;1;0;1;0;0;0
109;18.04.2017;2017;04;00;Tiistai;0;2;2;0;0;0
109;18.04.2017;2017;04;01;Tiistai;0;0;0;0;1;1
109;18.04.2017;2017;04;02;Tiistai;0;0;0;0;0;0
109;18.04.2017;2017;04;03;Tiistai;0;0;0;0;0;0
109;18.04.2017;2017;04;04;Tiistai;0;0;0;0;0;0
109;18.04.2017;2017;04;05;Tiistai;6;1;7;0;1;1
109;18.04.2017;2017;04;06;Tiistai;19;17;36;3;2;5
109;18.04.2017;2017;04;07;Tiistai;58;23;81;5;5;10
109;18.04.2017;2017;04;08;Tiistai;31;7;38;2;2;4
109;18.04.2017;2017;04;09;Tiistai;15;9;24;7;5;12
109;18.04.2017;2017;04;10;Tiistai;4;2;6;5;1;6
109;18.04.2017;2017;04;11;Tiistai;6;7;13;3;3;6
109;18.04.2017;2017;04;12;Tiistai;14;4;18;7;5;12
109;18.04.2017;2017;04;13;Tiistai;1;9;10;4;3;7
109;18.04.2017;2017;04;14;Tiistai;11;10;21;7;4;11
109;18.04.2017;2017;04;15;Tiistai;26;51;77;7;4;11
109;18.04.2017;2017;04;16;Tiistai;32;62;94;3;3;6
109;18.04.2017;2017;04;17;Tiistai;9;16;25;8;2;10
109;18.04.2017;2017;04;18;Tiistai;13;10;23;8;3;11
109;18.04.2017;2017;04;19;Tiistai;5;9;14;10;9;19
109;18.04.2017;2017;04;20;Tiistai;3;10;13;10;3;13
109;18.04.2017;2017;04;21;Tiistai;5;10;15;5;5;10
109;18.04.2017;2017;04;22;Tiistai;3;2;5;0;0;0
109;18.04.2017;2017;04;23;Tiistai;2;0;2;0;2;2
109;19.04.2017;2017;04;00;Keskiviikko;2;0;2;1;0;1
109;19.04.2017;2017;04;01;Keskiviikko;0;0;0;0;0;0
109;19.04.2017;2017;04;02;Keskiviikko;0;0;0;0;0;0
109;19.04.2017;2017;04;03;Keskiviikko;0;0;0;0;0;0
109;19.04.2017;2017;04;04;Keskiviikko;1;0;1;0;0;0
109;19.04.2017;2017;04;05;Keskiviikko;1;2;3;2;0;2
109;19.04.2017;2017;04;06;Keskiviikko;20;11;31;3;4;7
109;19.04.2017;2017;04;07;Keskiviikko;58;27;85;8;7;15
109;19.04.2017;2017;04;08;Keskiviikko;32;9;41;7;4;11
109;19.04.2017;2017;04;09;Keskiviikko;11;2;13;3;8;11
109;19.04.2017;2017;04;10;Keskiviikko;10;3;13;2;3;5
109;19.04.2017;2017;04;11;Keskiviikko;19;2;21;5;4;9
109;19.04.2017;2017;04;12;Keskiviikko;9;7;16;7;5;12
109;19.04.2017;2017;04;13;Keskiviikko;9;9;18;6;2;8
109;19.04.2017;2017;04;14;Keskiviikko;10;32;42;4;2;6
109;19.04.2017;2017;04;15;Keskiviikko;10;50;60;3;0;3
109;19.04.2017;2017;04;16;Keskiviikko;25;52;77;7;3;10
109;19.04.2017;2017;04;17;Keskiviikko;16;16;32;4;1;5
109;19.04.2017;2017;04;18;Keskiviikko;7;15;22;12;7;19
109;19.04.2017;2017;04;19;Keskiviikko;15;10;25;18;4;22
109;19.04.2017;2017;04;20;Keskiviikko;4;4;8;10;10;20
109;19.04.2017;2017;04;21;Keskiviikko;6;13;19;2;3;5
109;19.04.2017;2017;04;22;Keskiviikko;2;2;4;1;0;1
109;19.04.2017;2017;04;23;Keskiviikko;1;0;1;0;0;0
109;20.04.2017;2017;04;00;Torstai;0;0;0;0;0;0
109;20.04.2017;2017;04;01;Torstai;0;0;0;0;0;0
109;20.04.2017;2017;04;02;Torstai;0;0;0;0;0;0
109;20.04.2017;2017;04;03;Torstai;0;0;0;0;0;0
109;20.04.2017;2017;04;04;Torstai;0;0;0;0;0;0
109;20.04.2017;2017;04;05;Torstai;1;3;4;2;1;3
109;20.04.2017;2017;04;06;Torstai;12;19;31;4;0;4
109;20.04.2017;2017;04;07;Torstai;59;23;82;3;7;10
109;20.04.2017;2017;04;08;Torstai;29;12;41;9;3;12
109;20.04.2017;2017;04;09;Torstai;14;4;18;5;3;8
109;20.04.2017;2017;04;10;Torstai;8;2;10;4;6;10
109;20.04.2017;2017;04;11;Torstai;8;6;14;2;3;5
109;20.04.2017;2017;04;12;Torstai;8;7;15;1;2;3
109;20.04.2017;2017;04;13;Torstai;6;16;22;4;5;9
109;20.04.2017;2017;04;14;Torstai;6;18;24;5;0;5
109;20.04.2017;2017;04;15;Torstai;20;31;51;4;3;7
109;20.04.2017;2017;04;16;Torstai;21;36;57;6;3;9
109;20.04.2017;2017;04;17;Torstai;3;22;25;1;4;5
109;20.04.2017;2017;04;18;Torstai;6;13;19;2;2;4
109;20.04.2017;2017;04;19;Torstai;4;4;8;3;5;8
109;20.04.2017;2017;04;20;Torstai;1;3;4;4;4;8
109;20.04.2017;2017;04;21;Torstai;2;8;10;3;3;6
109;20.04.2017;2017;04;22;Torstai;1;1;2;0;0;0
109;20.04.2017;2017;04;23;Torstai;2;0;2;0;0;0
109;21.04.2017;2017;04;00;Perjantai;0;0;0;1;0;1
109;21.04.2017;2017;04;01;Perjantai;0;0;0;2;1;3
109;21.04.2017;2017;04;02;Perjantai;0;1;1;0;0;0
109;21.04.2017;2017;04;03;Perjantai;0;0;0;0;0;0
109;21.04.2017;2017;04;04;Perjantai;0;1;1;0;0;0
109;21.04.2017;2017;04;05;Perjantai;2;2;4;1;0;1
109;21.04.2017;2017;04;06;Perjantai;12;10;22;5;1;6
109;21.04.2017;2017;04;07;Perjantai;58;21;79;4;6;10
109;21.04.2017;2017;04;08;Perjantai;25;9;34;2;5;7
109;21.04.2017;2017;04;09;Perjantai;17;1;18;6;6;12
109;21.04.2017;2017;04;10;Perjantai;6;8;14;5;3;8
109;21.04.2017;2017;04;11;Perjantai;13;5;18;3;4;7
109;21.04.2017;2017;04;12;Perjantai;14;10;24;5;2;7
109;21.04.2017;2017;04;13;Perjantai;11;17;28;10;4;14
109;21.04.2017;2017;04;14;Perjantai;9;22;31;6;6;12
109;21.04.2017;2017;04;15;Perjantai;27;29;56;4;2;6
109;21.04.2017;2017;04;16;Perjantai;15;35;50;4;4;8
109;21.04.2017;2017;04;17;Perjantai;11;14;25;3;0;3
109;21.04.2017;2017;04;18;Perjantai;8;6;14;9;3;12
109;21.04.2017;2017;04;19;Perjantai;8;5;13;4;1;5
109;21.04.2017;2017;04;20;Perjantai;2;5;7;5;2;7
109;21.04.2017;2017;04;21;Perjantai;2;6;8;4;4;8
109;21.04.2017;2017;04;22;Perjantai;5;2;7;1;1;2
109;21.04.2017;2017;04;23;Perjantai;1;1;2;1;1;2
109;22.04.2017;2017;04;00;Lauantai;1;0;1;0;0;0
109;22.04.2017;2017;04;01;Lauantai;0;0;0;0;1;1
109;22.04.2017;2017;04;02;Lauantai;0;3;3;0;0;0
109;22.04.2017;2017;04;03;Lauantai;1;0;1;0;0;0
109;22.04.2017;2017;04;04;Lauantai;0;1;1;1;0;1
109;22.04.2017;2017;04;05;Lauantai;0;1;1;1;0;1
109;22.04.2017;2017;04;06;Lauantai;0;6;6;2;1;3
109;22.04.2017;2017;04;07;Lauantai;1;3;4;4;1;5
109;22.04.2017;2017;04;08;Lauantai;4;1;5;2;4;6
109;22.04.2017;2017;04;09;Lauantai;6;3;9;8;2;10
109;22.04.2017;2017;04;10;Lauantai;5;6;11;8;4;12
109;22.04.2017;2017;04;11;Lauantai;12;7;19;8;4;12
109;22.04.2017;2017;04;12;Lauantai;15;7;22;8;5;13
109;22.04.2017;2017;04;13;Lauantai;12;16;28;15;9;24
109;22.04.2017;2017;04;14;Lauantai;9;12;21;5;2;7
109;22.04.2017;2017;04;15;Lauantai;10;16;26;2;2;4
109;22.04.2017;2017;04;16;Lauantai;4;7;11;7;3;10
109;22.04.2017;2017;04;17;Lauantai;13;5;18;6;3;9
109;22.04.2017;2017;04;18;Lauantai;2;8;10;3;3;6
109;22.04.2017;2017;04;19;Lauantai;2;5;7;6;3;9
109;22.04.2017;2017;04;20;Lauantai;5;4;9;3;2;5
109;22.04.2017;2017;04;21;Lauantai;1;8;9;1;1;2
109;22.04.2017;2017;04;22;Lauantai;1;1;2;0;0;0
109;22.04.2017;2017;04;23;Lauantai;0;1;1;1;0;1
109;23.04.2017;2017;04;00;Sunnuntai;0;0;0;1;0;1
109;23.04.2017;2017;04;01;Sunnuntai;2;0;2;0;0;0
109;23.04.2017;2017;04;02;Sunnuntai;1;0;1;0;0;0
109;23.04.2017;2017;04;03;Sunnuntai;1;0;1;0;0;0
109;23.04.2017;2017;04;04;Sunnuntai;0;1;1;0;0;0
109;23.04.2017;2017;04;05;Sunnuntai;0;0;0;0;0;0
109;23.04.2017;2017;04;06;Sunnuntai;1;3;4;0;1;1
109;23.04.2017;2017;04;07;Sunnuntai;2;2;4;2;0;2
109;23.04.2017;2017;04;08;Sunnuntai;2;0;2;8;3;11
109;23.04.2017;2017;04;09;Sunnuntai;4;6;10;12;7;19
109;23.04.2017;2017;04;10;Sunnuntai;5;4;9;5;3;8
109;23.04.2017;2017;04;11;Sunnuntai;10;4;14;3;4;7
109;23.04.2017;2017;04;12;Sunnuntai;12;8;20;10;3;13
109;23.04.2017;2017;04;13;Sunnuntai;8;6;14;4;2;6
109;23.04.2017;2017;04;14;Sunnuntai;11;4;15;9;5;14
109;23.04.2017;2017;04;15;Sunnuntai;11;10;21;5;3;8
109;23.04.2017;2017;04;16;Sunnuntai;5;9;14;7;4;11
109;23.04.2017;2017;04;17;Sunnuntai;2;7;9;4;5;9
109;23.04.2017;2017;04;18;Sunnuntai;7;9;16;10;6;16
109;23.04.2017;2017;04;19;Sunnuntai;4;4;8;10;1;11
109;23.04.2017;2017;04;20;Sunnuntai;4;4;8;2;5;7
109;23.04.2017;2017;04;21;Sunnuntai;3;9;12;4;3;7
109;23.04.2017;2017;04;22;Sunnuntai;2;2;4;0;0;0
109;23.04.2017;2017;04;23;Sunnuntai;2;0;2;0;1;1
109;24.04.2017;2017;04;00;Maanantai;0;1;1;0;0;0
109;24.04.2017;2017;04;01;Maanantai;0;0;0;2;2;4
109;24.04.2017;2017;04;02;Maanantai;0;0;0;0;0;0
109;24.04.2017;2017;04;03;Maanantai;0;0;0;0;0;0
109;24.04.2017;2017;04;04;Maanantai;0;1;1;0;0;0
109;24.04.2017;2017;04;05;Maanantai;3;3;6;2;0;2
109;24.04.2017;2017;04;06;Maanantai;24;19;43;6;2;8
109;24.04.2017;2017;04;07;Maanantai;68;21;89;7;10;17
109;24.04.2017;2017;04;08;Maanantai;33;13;46;3;4;7
109;24.04.2017;2017;04;09;Maanantai;22;9;31;1;2;3
109;24.04.2017;2017;04;10;Maanantai;11;5;16;5;7;12
109;24.04.2017;2017;04;11;Maanantai;12;13;25;2;8;10
109;24.04.2017;2017;04;12;Maanantai;12;7;19;2;2;4
109;24.04.2017;2017;04;13;Maanantai;11;18;29;3;8;11
109;24.04.2017;2017;04;14;Maanantai;14;29;43;1;4;5
109;24.04.2017;2017;04;15;Maanantai;26;41;67;5;3;8
109;24.04.2017;2017;04;16;Maanantai;21;57;78;11;8;19
109;24.04.2017;2017;04;17;Maanantai;15;20;35;7;3;10
109;24.04.2017;2017;04;18;Maanantai;16;8;24;2;3;5
109;24.04.2017;2017;04;19;Maanantai;9;8;17;15;7;22
109;24.04.2017;2017;04;20;Maanantai;5;6;11;6;4;10
109;24.04.2017;2017;04;21;Maanantai;2;7;9;7;1;8
109;24.04.2017;2017;04;22;Maanantai;2;1;3;0;1;1
109;24.04.2017;2017;04;23;Maanantai;0;0;0;0;0;0
109;25.04.2017;2017;04;00;Tiistai;1;0;1;1;0;1
109;25.04.2017;2017;04;01;Tiistai;0;0;0;0;0;0
109;25.04.2017;2017;04;02;Tiistai;0;0;0;0;0;0
109;25.04.2017;2017;04;03;Tiistai;0;0;0;0;0;0
109;25.04.2017;2017;04;04;Tiistai;0;0;0;0;0;0
109;25.04.2017;2017;04;05;Tiistai;4;4;8;1;0;1
109;25.04.2017;2017;04;06;Tiistai;28;21;49;7;1;8
109;25.04.2017;2017;04;07;Tiistai;87;37;124;7;5;12
109;25.04.2017;2017;04;08;Tiistai;40;4;44;7;4;11
109;25.04.2017;2017;04;09;Tiistai;13;6;19;2;5;7
109;25.04.2017;2017;04;10;Tiistai;11;5;16;4;1;5
109;25.04.2017;2017;04;11;Tiistai;17;14;31;7;9;16
109;25.04.2017;2017;04;12;Tiistai;10;10;20;7;3;10
109;25.04.2017;2017;04;13;Tiistai;22;11;33;5;3;8
109;25.04.2017;2017;04;14;Tiistai;11;16;27;4;3;7
109;25.04.2017;2017;04;15;Tiistai;23;60;83;5;3;8
109;25.04.2017;2017;04;16;Tiistai;33;76;109;14;9;23
109;25.04.2017;2017;04;17;Tiistai;17;19;36;10;3;13
109;25.04.2017;2017;04;18;Tiistai;9;19;28;2;4;6
109;25.04.2017;2017;04;19;Tiistai;6;18;24;12;14;26
109;25.04.2017;2017;04;20;Tiistai;6;10;16;4;3;7
109;25.04.2017;2017;04;21;Tiistai;1;11;12;1;3;4
109;25.04.2017;2017;04;22;Tiistai;3;3;6;2;2;4
109;25.04.2017;2017;04;23;Tiistai;1;1;2;0;1;1
109;26.04.2017;2017;04;00;Keskiviikko;1;0;1;0;0;0
109;26.04.2017;2017;04;01;Keskiviikko;0;0;0;0;0;0
109;26.04.2017;2017;04;02;Keskiviikko;0;0;0;0;0;0
109;26.04.2017;2017;04;03;Keskiviikko;0;0;0;0;0;0
109;26.04.2017;2017;04;04;Keskiviikko;0;1;1;0;0;0
109;26.04.2017;2017;04;05;Keskiviikko;3;4;7;2;2;4
109;26.04.2017;2017;04;06;Keskiviikko;26;14;40;3;2;5
109;26.04.2017;2017;04;07;Keskiviikko;53;20;73;7;5;12
109;26.04.2017;2017;04;08;Keskiviikko;25;7;32;8;2;10
109;26.04.2017;2017;04;09;Keskiviikko;16;12;28;2;3;5
109;26.04.2017;2017;04;10;Keskiviikko;3;3;6;0;1;1
109;26.04.2017;2017;04;11;Keskiviikko;9;2;11;5;3;8
109;26.04.2017;2017;04;12;Keskiviikko;8;4;12;1;2;3
109;26.04.2017;2017;04;13;Keskiviikko;5;7;12;3;1;4
109;26.04.2017;2017;04;14;Keskiviikko;4;10;14;3;3;6
109;26.04.2017;2017;04;15;Keskiviikko;12;37;49;5;4;9
109;26.04.2017;2017;04;16;Keskiviikko;20;43;63;7;5;12
109;26.04.2017;2017;04;17;Keskiviikko;8;18;26;1;3;4
109;26.04.2017;2017;04;18;Keskiviikko;3;14;17;7;2;9
109;26.04.2017;2017;04;19;Keskiviikko;4;4;8;3;2;5
109;26.04.2017;2017;04;20;Keskiviikko;6;3;9;4;3;7
109;26.04.2017;2017;04;21;Keskiviikko;3;7;10;0;2;2
109;26.04.2017;2017;04;22;Keskiviikko;0;2;2;1;0;1
109;26.04.2017;2017;04;23;Keskiviikko;1;1;2;0;0;0
109;27.04.2017;2017;04;00;Torstai;0;0;0;0;0;0
109;27.04.2017;2017;04;01;Torstai;0;0;0;0;0;0
109;27.04.2017;2017;04;02;Torstai;0;0;0;0;0;0
109;27.04.2017;2017;04;03;Torstai;1;0;1;0;0;0
109;27.04.2017;2017;04;04;Torstai;1;0;1;0;0;0
109;27.04.2017;2017;04;05;Torstai;3;2;5;1;0;1
109;27.04.2017;2017;04;06;Torstai;20;16;36;2;1;3
109;27.04.2017;2017;04;07;Torstai;40;20;60;6;9;15
109;27.04.2017;2017;04;08;Torstai;25;4;29;2;0;2
109;27.04.2017;2017;04;09;Torstai;17;4;21;5;1;6
109;27.04.2017;2017;04;10;Torstai;7;4;11;3;4;7
109;27.04.2017;2017;04;11;Torstai;12;7;19;6;4;10
109;27.04.2017;2017;04;12;Torstai;5;6;11;3;1;4
109;27.04.2017;2017;04;13;Torstai;8;11;19;3;3;6
109;27.04.2017;2017;04;14;Torstai;6;17;23;2;3;5
109;27.04.2017;2017;04;15;Torstai;18;31;49;5;2;7
109;27.04.2017;2017;04;16;Torstai;19;44;63;7;3;10
109;27.04.2017;2017;04;17;Torstai;11;22;33;3;6;9
109;27.04.2017;2017;04;18;Torstai;9;10;19;4;6;10
109;27.04.2017;2017;04;19;Torstai;3;5;8;10;2;12
109;27.04.2017;2017;04;20;Torstai;4;8;12;4;3;7
109;27.04.2017;2017;04;21;Torstai;2;7;9;5;4;9
109;27.04.2017;2017;04;22;Torstai;0;1;1;0;1;1
109;27.04.2017;2017;04;23;Torstai;0;0;0;0;1;1
109;28.04.2017;2017;04;00;Perjantai;0;0;0;0;0;0
109;28.04.2017;2017;04;01;Perjantai;2;0;2;0;1;1
109;28.04.2017;2017;04;02;Perjantai;0;1;1;0;0;0
109;28.04.2017;2017;04;03;Perjantai;0;0;0;0;0;0
109;28.04.2017;2017;04;04;Perjantai;0;0;0;0;0;0
109;28.04.2017;2017;04;05;Perjantai;0;4;4;1;0;1
109;28.04.2017;2017;04;06;Perjantai;23;14;37;3;1;4
109;28.04.2017;2017;04;07;Perjantai;59;28;87;4;3;7
109;28.04.2017;2017;04;08;Perjantai;32;8;40;2;2;4
109;28.04.2017;2017;04;09;Perjantai;14;4;18;7;3;10
109;28.04.2017;2017;04;10;Perjantai;5;7;12;2;4;6
109;28.04.2017;2017;04;11;Perjantai;15;9;24;5;3;8
109;28.04.2017;2017;04;12;Perjantai;12;10;22;5;3;8
109;28.04.2017;2017;04;13;Perjantai;16;11;27;4;4;8
109;28.04.2017;2017;04;14;Perjantai;17;31;48;6;7;13
109;28.04.2017;2017;04;15;Perjantai;28;43;71;5;5;10
109;28.04.2017;2017;04;16;Perjantai;23;38;61;4;3;7
109;28.04.2017;2017;04;17;Perjantai;10;16;26;6;9;15
109;28.04.2017;2017;04;18;Perjantai;14;10;24;5;4;9
109;28.04.2017;2017;04;19;Perjantai;5;8;13;4;1;5
109;28.04.2017;2017;04;20;Perjantai;8;4;12;4;2;6
109;28.04.2017;2017;04;21;Perjantai;3;8;11;3;2;5
109;28.04.2017;2017;04;22;Perjantai;2;6;8;2;0;2
109;28.04.2017;2017;04;23;Perjantai;3;3;6;1;0;1
109;29.04.2017;2017;04;00;Lauantai;1;0;1;0;0;0
109;29.04.2017;2017;04;01;Lauantai;3;1;4;1;2;3
109;29.04.2017;2017;04;02;Lauantai;1;3;4;0;0;0
109;29.04.2017;2017;04;03;Lauantai;1;1;2;0;0;0
109;29.04.2017;2017;04;04;Lauantai;1;0;1;0;0;0
109;29.04.2017;2017;04;05;Lauantai;0;0;0;0;0;0
109;29.04.2017;2017;04;06;Lauantai;2;1;3;0;1;1
109;29.04.2017;2017;04;07;Lauantai;3;2;5;0;1;1
109;29.04.2017;2017;04;08;Lauantai;3;4;7;8;3;11
109;29.04.2017;2017;04;09;Lauantai;4;6;10;8;5;13
109;29.04.2017;2017;04;10;Lauantai;12;7;19;6;5;11
109;29.04.2017;2017;04;11;Lauantai;10;13;23;6;2;8
109;29.04.2017;2017;04;12;Lauantai;18;10;28;3;6;9
109;29.04.2017;2017;04;13;Lauantai;11;10;21;5;3;8
109;29.04.2017;2017;04;14;Lauantai;11;14;25;5;3;8
109;29.04.2017;2017;04;15;Lauantai;11;19;30;5;6;11
109;29.04.2017;2017;04;16;Lauantai;9;16;25;2;4;6
109;29.04.2017;2017;04;17;Lauantai;18;6;24;4;2;6
109;29.04.2017;2017;04;18;Lauantai;12;9;21;2;3;5
109;29.04.2017;2017;04;19;Lauantai;8;9;17;8;2;10
109;29.04.2017;2017;04;20;Lauantai;2;8;10;4;4;8
109;29.04.2017;2017;04;21;Lauantai;6;10;16;0;1;1
109;29.04.2017;2017;04;22;Lauantai;2;7;9;0;2;2
109;29.04.2017;2017;04;23;Lauantai;0;2;2;1;0;1
109;30.04.2017;2017;04;00;Sunnuntai;4;1;5;2;1;3
109;30.04.2017;2017;04;01;Sunnuntai;3;3;6;0;3;3
109;30.04.2017;2017;04;02;Sunnuntai;0;1;1;0;1;1
109;30.04.2017;2017;04;03;Sunnuntai;0;0;0;0;0;0
109;30.04.2017;2017;04;04;Sunnuntai;0;1;1;0;0;0
109;30.04.2017;2017;04;05;Sunnuntai;0;0;0;1;0;1
109;30.04.2017;2017;04;06;Sunnuntai;4;2;6;0;1;1
109;30.04.2017;2017;04;07;Sunnuntai;1;3;4;0;2;2
109;30.04.2017;2017;04;08;Sunnuntai;1;2;3;5;4;9
109;30.04.2017;2017;04;09;Sunnuntai;2;4;6;1;0;1
109;30.04.2017;2017;04;10;Sunnuntai;4;3;7;3;1;4
109;30.04.2017;2017;04;11;Sunnuntai;4;3;7;3;2;5
109;30.04.2017;2017;04;12;Sunnuntai;8;4;12;4;1;5
109;30.04.2017;2017;04;13;Sunnuntai;4;3;7;6;2;8
109;30.04.2017;2017;04;14;Sunnuntai;4;2;6;4;2;6
109;30.04.2017;2017;04;15;Sunnuntai;9;4;13;4;3;7
109;30.04.2017;2017;04;16;Sunnuntai;6;7;13;5;2;7
109;30.04.2017;2017;04;17;Sunnuntai;4;6;10;2;3;5
109;30.04.2017;2017;04;18;Sunnuntai;2;2;4;5;0;5
109;30.04.2017;2017;04;19;Sunnuntai;4;1;5;3;2;5
109;30.04.2017;2017;04;20;Sunnuntai;0;2;2;1;2;3
109;30.04.2017;2017;04;21;Sunnuntai;3;2;5;3;4;7
109;30.04.2017;2017;04;22;Sunnuntai;0;1;1;2;0;2
109;30.04.2017;2017;04;23;Sunnuntai;0;0;0;1;0;1
109;01.05.2017;2017;05;00;Maanantai;1;0;1;0;0;0
109;01.05.2017;2017;05;01;Maanantai;0;0;0;1;0;1
109;01.05.2017;2017;05;02;Maanantai;0;2;2;1;0;1
109;01.05.2017;2017;05;03;Maanantai;0;1;1;1;1;2
109;01.05.2017;2017;05;04;Maanantai;0;1;1;0;0;0
109;01.05.2017;2017;05;05;Maanantai;0;0;0;0;0;0
109;01.05.2017;2017;05;06;Maanantai;2;2;4;1;2;3
109;01.05.2017;2017;05;07;Maanantai;1;0;1;2;1;3
109;01.05.2017;2017;05;08;Maanantai;7;2;9;8;2;10
109;01.05.2017;2017;05;09;Maanantai;8;2;10;1;6;7
109;01.05.2017;2017;05;10;Maanantai;16;8;24;5;5;10
109;01.05.2017;2017;05;11;Maanantai;25;2;27;11;3;14
109;01.05.2017;2017;05;12;Maanantai;22;7;29;9;4;13
109;01.05.2017;2017;05;13;Maanantai;8;22;30;9;6;15
109;01.05.2017;2017;05;14;Maanantai;12;11;23;7;7;14
109;01.05.2017;2017;05;15;Maanantai;7;11;18;6;5;11
109;01.05.2017;2017;05;16;Maanantai;8;8;16;4;3;7
109;01.05.2017;2017;05;17;Maanantai;11;8;19;4;0;4
109;01.05.2017;2017;05;18;Maanantai;10;4;14;6;4;10
109;01.05.2017;2017;05;19;Maanantai;3;4;7;9;4;13
109;01.05.2017;2017;05;20;Maanantai;8;5;13;7;5;12
109;01.05.2017;2017;05;21;Maanantai;4;6;10;1;0;1
109;01.05.2017;2017;05;22;Maanantai;3;0;3;0;0;0
109;01.05.2017;2017;05;23;Maanantai;1;0;1;0;0;0
109;02.05.2017;2017;05;00;Tiistai;0;4;4;0;2;2
109;02.05.2017;2017;05;01;Tiistai;1;0;1;1;0;1
109;02.05.2017;2017;05;02;Tiistai;0;0;0;0;0;0
109;02.05.2017;2017;05;03;Tiistai;0;0;0;0;0;0
109;02.05.2017;2017;05;04;Tiistai;0;3;3;0;0;0
109;02.05.2017;2017;05;05;Tiistai;7;4;11;0;0;0
109;02.05.2017;2017;05;06;Tiistai;28;28;56;6;2;8
109;02.05.2017;2017;05;07;Tiistai;92;31;123;4;3;7
109;02.05.2017;2017;05;08;Tiistai;46;13;59;1;4;5
109;02.05.2017;2017;05;09;Tiistai;21;6;27;1;5;6
109;02.05.2017;2017;05;10;Tiistai;16;4;20;4;4;8
109;02.05.2017;2017;05;11;Tiistai;15;15;30;4;3;7
109;02.05.2017;2017;05;12;Tiistai;19;11;30;6;6;12
109;02.05.2017;2017;05;13;Tiistai;19;10;29;4;5;9
109;02.05.2017;2017;05;14;Tiistai;15;27;42;5;7;12
109;02.05.2017;2017;05;15;Tiistai;28;43;71;13;6;19
109;02.05.2017;2017;05;16;Tiistai;43;71;114;12;7;19
109;02.05.2017;2017;05;17;Tiistai;15;35;50;10;8;18
109;02.05.2017;2017;05;18;Tiistai;12;12;24;8;4;12
109;02.05.2017;2017;05;19;Tiistai;16;8;24;17;5;22
109;02.05.2017;2017;05;20;Tiistai;4;13;17;4;5;9
109;02.05.2017;2017;05;21;Tiistai;7;8;15;3;7;10
109;02.05.2017;2017;05;22;Tiistai;6;3;9;2;0;2
109;02.05.2017;2017;05;23;Tiistai;0;1;1;1;1;2
109;03.05.2017;2017;05;00;Keskiviikko;1;0;1;0;1;1
109;03.05.2017;2017;05;01;Keskiviikko;1;0;1;0;1;1
109;03.05.2017;2017;05;02;Keskiviikko;0;1;1;1;0;1
109;03.05.2017;2017;05;03;Keskiviikko;0;1;1;0;0;0
109;03.05.2017;2017;05;04;Keskiviikko;0;1;1;0;1;1
109;03.05.2017;2017;05;05;Keskiviikko;3;4;7;0;1;1
109;03.05.2017;2017;05;06;Keskiviikko;43;22;65;5;0;5
109;03.05.2017;2017;05;07;Keskiviikko;93;30;123;4;5;9
109;03.05.2017;2017;05;08;Keskiviikko;40;15;55;5;5;10
109;03.05.2017;2017;05;09;Keskiviikko;15;14;29;0;5;5
109;03.05.2017;2017;05;10;Keskiviikko;16;4;20;6;4;10
109;03.05.2017;2017;05;11;Keskiviikko;17;13;30;1;2;3
109;03.05.2017;2017;05;12;Keskiviikko;7;9;16;3;5;8
109;03.05.2017;2017;05;13;Keskiviikko;13;17;30;4;6;10
109;03.05.2017;2017;05;14;Keskiviikko;19;27;46;3;2;5
109;03.05.2017;2017;05;15;Keskiviikko;27;57;84;10;6;16
109;03.05.2017;2017;05;16;Keskiviikko;26;68;94;2;3;5
109;03.05.2017;2017;05;17;Keskiviikko;20;24;44;9;3;12
109;03.05.2017;2017;05;18;Keskiviikko;16;19;35;8;7;15
109;03.05.2017;2017;05;19;Keskiviikko;3;8;11;14;8;22
109;03.05.2017;2017;05;20;Keskiviikko;7;11;18;7;7;14
109;03.05.2017;2017;05;21;Keskiviikko;3;11;14;3;3;6
109;03.05.2017;2017;05;22;Keskiviikko;2;4;6;0;1;1
109;03.05.2017;2017;05;23;Keskiviikko;1;0;1;0;0;0
109;04.05.2017;2017;05;00;Torstai;0;2;2;1;1;2
109;04.05.2017;2017;05;01;Torstai;0;1;1;0;0;0
109;04.05.2017;2017;05;02;Torstai;0;1;1;0;1;1
109;04.05.2017;2017;05;03;Torstai;0;0;0;0;0;0
109;04.05.2017;2017;05;04;Torstai;1;0;1;0;0;0
109;04.05.2017;2017;05;05;Torstai;4;5;9;2;1;3
109;04.05.2017;2017;05;06;Torstai;31;19;50;2;1;3
109;04.05.2017;2017;05;07;Torstai;100;31;131;6;6;12
109;04.05.2017;2017;05;08;Torstai;42;11;53;9;5;14
109;04.05.2017;2017;05;09;Torstai;12;7;19;7;5;12
109;04.05.2017;2017;05;10;Torstai;12;8;20;2;4;6
109;04.05.2017;2017;05;11;Torstai;20;13;33;2;1;3
109;04.05.2017;2017;05;12;Torstai;16;7;23;3;3;6
109;04.05.2017;2017;05;13;Torstai;12;17;29;3;5;8
109;04.05.2017;2017;05;14;Torstai;13;18;31;2;5;7
109;04.05.2017;2017;05;15;Torstai;28;56;84;2;2;4
109;04.05.2017;2017;05;16;Torstai;29;69;98;9;11;20
109;04.05.2017;2017;05;17;Torstai;24;38;62;4;4;8
109;04.05.2017;2017;05;18;Torstai;14;15;29;6;9;15
109;04.05.2017;2017;05;19;Torstai;8;7;15;6;6;12
109;04.05.2017;2017;05;20;Torstai;5;7;12;0;4;4
109;04.05.2017;2017;05;21;Torstai;7;15;22;3;6;9
109;04.05.2017;2017;05;22;Torstai;8;0;8;2;0;2
109;04.05.2017;2017;05;23;Torstai;3;0;3;0;1;1
109;05.05.2017;2017;05;00;Perjantai;0;2;2;0;1;1
109;05.05.2017;2017;05;01;Perjantai;2;0;2;0;0;0
109;05.05.2017;2017;05;02;Perjantai;0;0;0;0;0;0
109;05.05.2017;2017;05;03;Perjantai;0;0;0;0;0;0
109;05.05.2017;2017;05;04;Perjantai;0;1;1;0;0;0
109;05.05.2017;2017;05;05;Perjantai;4;4;8;0;0;0
109;05.05.2017;2017;05;06;Perjantai;30;20;50;2;2;4
109;05.05.2017;2017;05;07;Perjantai;85;30;115;4;2;6
109;05.05.2017;2017;05;08;Perjantai;43;15;58;9;1;10
109;05.05.2017;2017;05;09;Perjantai;27;6;33;6;8;14
109;05.05.2017;2017;05;10;Perjantai;15;8;23;4;2;6
109;05.05.2017;2017;05;11;Perjantai;17;14;31;4;3;7
109;05.05.2017;2017;05;12;Perjantai;10;18;28;4;6;10
109;05.05.2017;2017;05;13;Perjantai;21;24;45;1;4;5
109;05.05.2017;2017;05;14;Perjantai;21;39;60;4;5;9
109;05.05.2017;2017;05;15;Perjantai;36;60;96;8;0;8
109;05.05.2017;2017;05;16;Perjantai;35;40;75;3;6;9
109;05.05.2017;2017;05;17;Perjantai;26;21;47;3;3;6
109;05.05.2017;2017;05;18;Perjantai;16;12;28;7;1;8
109;05.05.2017;2017;05;19;Perjantai;14;13;27;5;3;8
109;05.05.2017;2017;05;20;Perjantai;7;9;16;3;4;7
109;05.05.2017;2017;05;21;Perjantai;12;4;16;1;4;5
109;05.05.2017;2017;05;22;Perjantai;1;6;7;2;2;4
109;05.05.2017;2017;05;23;Perjantai;3;3;6;0;0;0
109;06.05.2017;2017;05;00;Lauantai;0;0;0;1;2;3
109;06.05.2017;2017;05;01;Lauantai;1;2;3;0;0;0
109;06.05.2017;2017;05;02;Lauantai;0;1;1;0;0;0
109;06.05.2017;2017;05;03;Lauantai;1;2;3;0;0;0
109;06.05.2017;2017;05;04;Lauantai;0;2;2;1;0;1
109;06.05.2017;2017;05;05;Lauantai;0;3;3;0;0;0
109;06.05.2017;2017;05;06;Lauantai;4;3;7;2;1;3
109;06.05.2017;2017;05;07;Lauantai;4;4;8;1;0;1
109;06.05.2017;2017;05;08;Lauantai;3;4;7;5;0;5
109;06.05.2017;2017;05;09;Lauantai;3;2;5;7;3;10
109;06.05.2017;2017;05;10;Lauantai;13;2;15;3;5;8
109;06.05.2017;2017;05;11;Lauantai;6;9;15;7;16;23
109;06.05.2017;2017;05;12;Lauantai;13;9;22;9;8;17
109;06.05.2017;2017;05;13;Lauantai;9;8;17;2;8;10
109;06.05.2017;2017;05;14;Lauantai;14;4;18;5;5;10
109;06.05.2017;2017;05;15;Lauantai;19;8;27;4;2;6
109;06.05.2017;2017;05;16;Lauantai;9;12;21;4;3;7
109;06.05.2017;2017;05;17;Lauantai;9;9;18;4;5;9
109;06.05.2017;2017;05;18;Lauantai;12;11;23;7;4;11
109;06.05.2017;2017;05;19;Lauantai;5;12;17;4;4;8
109;06.05.2017;2017;05;20;Lauantai;8;10;18;4;2;6
109;06.05.2017;2017;05;21;Lauantai;4;3;7;1;6;7
109;06.05.2017;2017;05;22;Lauantai;2;1;3;3;2;5
109;06.05.2017;2017;05;23;Lauantai;3;1;4;1;0;1
109;07.05.2017;2017;05;00;Sunnuntai;0;2;2;1;0;1
109;07.05.2017;2017;05;01;Sunnuntai;3;0;3;0;1;1
109;07.05.2017;2017;05;02;Sunnuntai;0;0;0;0;0;0
109;07.05.2017;2017;05;03;Sunnuntai;1;3;4;0;0;0
109;07.05.2017;2017;05;04;Sunnuntai;1;1;2;0;0;0
109;07.05.2017;2017;05;05;Sunnuntai;1;3;4;0;0;0
109;07.05.2017;2017;05;06;Sunnuntai;3;1;4;3;3;6
109;07.05.2017;2017;05;07;Sunnuntai;2;3;5;0;0;0
109;07.05.2017;2017;05;08;Sunnuntai;2;0;2;4;3;7
109;07.05.2017;2017;05;09;Sunnuntai;2;8;10;8;7;15
109;07.05.2017;2017;05;10;Sunnuntai;7;6;13;6;7;13
109;07.05.2017;2017;05;11;Sunnuntai;7;9;16;6;10;16
109;07.05.2017;2017;05;12;Sunnuntai;25;7;32;11;7;18
109;07.05.2017;2017;05;13;Sunnuntai;15;9;24;5;3;8
109;07.05.2017;2017;05;14;Sunnuntai;16;11;27;7;3;10
109;07.05.2017;2017;05;15;Sunnuntai;7;15;22;3;1;4
109;07.05.2017;2017;05;16;Sunnuntai;3;16;19;5;1;6
109;07.05.2017;2017;05;17;Sunnuntai;11;8;19;5;2;7
109;07.05.2017;2017;05;18;Sunnuntai;14;12;26;11;5;16
109;07.05.2017;2017;05;19;Sunnuntai;12;0;12;3;4;7
109;07.05.2017;2017;05;20;Sunnuntai;4;15;19;4;2;6
109;07.05.2017;2017;05;21;Sunnuntai;4;4;8;3;4;7
109;07.05.2017;2017;05;22;Sunnuntai;4;2;6;1;3;4
109;07.05.2017;2017;05;23;Sunnuntai;0;0;0;1;0;1
109;08.05.2017;2017;05;00;Maanantai;1;1;2;0;0;0
109;08.05.2017;2017;05;01;Maanantai;0;0;0;0;2;2
109;08.05.2017;2017;05;02;Maanantai;0;1;1;0;1;1
109;08.05.2017;2017;05;03;Maanantai;0;0;0;0;1;1
109;08.05.2017;2017;05;04;Maanantai;0;0;0;0;0;0
109;08.05.2017;2017;05;05;Maanantai;6;6;12;4;2;6
109;08.05.2017;2017;05;06;Maanantai;27;24;51;3;4;7
109;08.05.2017;2017;05;07;Maanantai;88;34;122;8;5;13
109;08.05.2017;2017;05;08;Maanantai;40;16;56;5;3;8
109;08.05.2017;2017;05;09;Maanantai;21;5;26;3;1;4
109;08.05.2017;2017;05;10;Maanantai;18;4;22;3;1;4
109;08.05.2017;2017;05;11;Maanantai;16;12;28;5;1;6
109;08.05.2017;2017;05;12;Maanantai;12;6;18;5;2;7
109;08.05.2017;2017;05;13;Maanantai;11;16;27;4;6;10
109;08.05.2017;2017;05;14;Maanantai;14;22;36;3;0;3
109;08.05.2017;2017;05;15;Maanantai;25;53;78;27;23;50
109;08.05.2017;2017;05;16;Maanantai;39;58;97;6;7;13
109;08.05.2017;2017;05;17;Maanantai;25;29;54;7;8;15
109;08.05.2017;2017;05;18;Maanantai;11;16;27;5;7;12
109;08.05.2017;2017;05;19;Maanantai;9;12;21;12;7;19
109;08.05.2017;2017;05;20;Maanantai;8;6;14;5;9;14
109;08.05.2017;2017;05;21;Maanantai;2;10;12;2;2;4
109;08.05.2017;2017;05;22;Maanantai;2;1;3;7;2;9
109;08.05.2017;2017;05;23;Maanantai;0;0;0;0;3;3
109;09.05.2017;2017;05;00;Tiistai;0;3;3;3;0;3
109;09.05.2017;2017;05;01;Tiistai;0;0;0;0;0;0
109;09.05.2017;2017;05;02;Tiistai;0;0;0;0;0;0
109;09.05.2017;2017;05;03;Tiistai;0;0;0;0;1;1
109;09.05.2017;2017;05;04;Tiistai;0;0;0;0;0;0
109;09.05.2017;2017;05;05;Tiistai;3;5;8;0;1;1
109;09.05.2017;2017;05;06;Tiistai;33;25;58;4;1;5
109;09.05.2017;2017;05;07;Tiistai;87;41;128;7;5;12
109;09.05.2017;2017;05;08;Tiistai;39;14;53;5;3;8
109;09.05.2017;2017;05;09;Tiistai;12;7;19;2;3;5
109;09.05.2017;2017;05;10;Tiistai;18;6;24;3;6;9
109;09.05.2017;2017;05;11;Tiistai;17;8;25;7;3;10
109;09.05.2017;2017;05;12;Tiistai;16;8;24;2;2;4
109;09.05.2017;2017;05;13;Tiistai;11;13;24;5;4;9
109;09.05.2017;2017;05;14;Tiistai;16;17;33;2;4;6
109;09.05.2017;2017;05;15;Tiistai;26;44;70;8;5;13
109;09.05.2017;2017;05;16;Tiistai;37;58;95;5;5;10
109;09.05.2017;2017;05;17;Tiistai;19;21;40;3;8;11
109;09.05.2017;2017;05;18;Tiistai;15;7;22;7;5;12
109;09.05.2017;2017;05;19;Tiistai;10;6;16;11;3;14
109;09.05.2017;2017;05;20;Tiistai;3;10;13;3;2;5
109;09.05.2017;2017;05;21;Tiistai;3;11;14;1;4;5
109;09.05.2017;2017;05;22;Tiistai;4;4;8;4;2;6
109;09.05.2017;2017;05;23;Tiistai;0;1;1;0;0;0
109;10.05.2017;2017;05;00;Keskiviikko;2;0;2;0;0;0
109;10.05.2017;2017;05;01;Keskiviikko;0;0;0;0;1;1
109;10.05.2017;2017;05;02;Keskiviikko;1;2;3;0;0;0
109;10.05.2017;2017;05;03;Keskiviikko;0;0;0;0;0;0
109;10.05.2017;2017;05;04;Keskiviikko;0;0;0;0;0;0
109;10.05.2017;2017;05;05;Keskiviikko;6;7;13;0;1;1
109;10.05.2017;2017;05;06;Keskiviikko;31;19;50;3;0;3
109;10.05.2017;2017;05;07;Keskiviikko;77;33;110;6;6;12
109;10.05.2017;2017;05;08;Keskiviikko;44;26;70;6;4;10
109;10.05.2017;2017;05;09;Keskiviikko;29;8;37;4;5;9
109;10.05.2017;2017;05;10;Keskiviikko;10;6;16;4;2;6
109;10.05.2017;2017;05;11;Keskiviikko;14;11;25;1;3;4
109;10.05.2017;2017;05;12;Keskiviikko;15;9;24;3;2;5
109;10.05.2017;2017;05;13;Keskiviikko;15;19;34;4;4;8
109;10.05.2017;2017;05;14;Keskiviikko;8;24;32;8;3;11
109;10.05.2017;2017;05;15;Keskiviikko;21;50;71;6;6;12
109;10.05.2017;2017;05;16;Keskiviikko;40;61;101;1;4;5
109;10.05.2017;2017;05;17;Keskiviikko;15;19;34;6;4;10
109;10.05.2017;2017;05;18;Keskiviikko;12;14;26;5;5;10
109;10.05.2017;2017;05;19;Keskiviikko;7;5;12;4;5;9
109;10.05.2017;2017;05;20;Keskiviikko;4;13;17;5;5;10
109;10.05.2017;2017;05;21;Keskiviikko;1;15;16;2;3;5
109;10.05.2017;2017;05;22;Keskiviikko;5;2;7;2;0;2
109;10.05.2017;2017;05;23;Keskiviikko;1;2;3;2;2;4
109;11.05.2017;2017;05;00;Torstai;0;2;2;0;0;0
109;11.05.2017;2017;05;01;Torstai;0;0;0;1;0;1
109;11.05.2017;2017;05;02;Torstai;0;0;0;0;0;0
109;11.05.2017;2017;05;03;Torstai;0;0;0;0;0;0
109;11.05.2017;2017;05;04;Torstai;0;1;1;0;0;0
109;11.05.2017;2017;05;05;Torstai;8;4;12;0;0;0
109;11.05.2017;2017;05;06;Torstai;32;22;54;1;0;1
109;11.05.2017;2017;05;07;Torstai;83;31;114;9;4;13
109;11.05.2017;2017;05;08;Torstai;43;14;57;8;6;14
109;11.05.2017;2017;05;09;Torstai;13;1;14;1;4;5
109;11.05.2017;2017;05;10;Torstai;11;3;14;1;3;4
109;11.05.2017;2017;05;11;Torstai;8;7;15;1;2;3
109;11.05.2017;2017;05;12;Torstai;17;6;23;0;1;1
109;11.05.2017;2017;05;13;Torstai;15;19;34;4;4;8
109;11.05.2017;2017;05;14;Torstai;13;22;35;3;3;6
109;11.05.2017;2017;05;15;Torstai;15;58;73;13;5;18
109;11.05.2017;2017;05;16;Torstai;37;53;90;7;3;10
109;11.05.2017;2017;05;17;Torstai;11;28;39;5;3;8
109;11.05.2017;2017;05;18;Torstai;11;14;25;8;2;10
109;11.05.2017;2017;05;19;Torstai;4;4;8;8;3;11
109;11.05.2017;2017;05;20;Torstai;11;12;23;4;6;10
109;11.05.2017;2017;05;21;Torstai;6;9;15;3;4;7
109;11.05.2017;2017;05;22;Torstai;3;3;6;1;0;1
109;11.05.2017;2017;05;23;Torstai;1;1;2;4;1;5
109;12.05.2017;2017;05;00;Perjantai;0;2;2;1;1;2
109;12.05.2017;2017;05;01;Perjantai;0;1;1;0;1;1
109;12.05.2017;2017;05;02;Perjantai;0;0;0;0;0;0
109;12.05.2017;2017;05;03;Perjantai;1;0;1;0;0;0
109;12.05.2017;2017;05;04;Perjantai;0;0;0;0;0;0
109;12.05.2017;2017;05;05;Perjantai;2;2;4;0;0;0
109;12.05.2017;2017;05;06;Perjantai;33;28;61;6;2;8
109;12.05.2017;2017;05;07;Perjantai;80;25;105;7;3;10
109;12.05.2017;2017;05;08;Perjantai;36;18;54;6;3;9
109;12.05.2017;2017;05;09;Perjantai;21;7;28;5;4;9
109;12.05.2017;2017;05;10;Perjantai;14;9;23;6;3;9
109;12.05.2017;2017;05;11;Perjantai;20;12;32;5;2;7
109;12.05.2017;2017;05;12;Perjantai;18;12;30;5;1;6
109;12.05.2017;2017;05;13;Perjantai;16;13;29;3;2;5
109;12.05.2017;2017;05;14;Perjantai;16;20;36;8;5;13
109;12.05.2017;2017;05;15;Perjantai;31;59;90;4;4;8
109;12.05.2017;2017;05;16;Perjantai;18;43;61;3;3;6
109;12.05.2017;2017;05;17;Perjantai;26;17;43;3;1;4
109;12.05.2017;2017;05;18;Perjantai;17;17;34;1;3;4
109;12.05.2017;2017;05;19;Perjantai;13;11;24;4;5;9
109;12.05.2017;2017;05;20;Perjantai;5;8;13;9;1;10
109;12.05.2017;2017;05;21;Perjantai;7;14;21;0;3;3
109;12.05.2017;2017;05;22;Perjantai;3;7;10;0;0;0
109;12.05.2017;2017;05;23;Perjantai;4;1;5;3;3;6
109;13.05.2017;2017;05;00;Lauantai;3;0;3;0;0;0
109;13.05.2017;2017;05;01;Lauantai;2;1;3;0;0;0
109;13.05.2017;2017;05;02;Lauantai;1;1;2;0;0;0
109;13.05.2017;2017;05;03;Lauantai;0;1;1;0;0;0
109;13.05.2017;2017;05;04;Lauantai;1;3;4;0;3;3
109;13.05.2017;2017;05;05;Lauantai;0;1;1;1;2;3
109;13.05.2017;2017;05;06;Lauantai;6;8;14;0;0;0
109;13.05.2017;2017;05;07;Lauantai;6;2;8;4;0;4
109;13.05.2017;2017;05;08;Lauantai;3;3;6;4;0;4
109;13.05.2017;2017;05;09;Lauantai;9;5;14;4;2;6
109;13.05.2017;2017;05;10;Lauantai;14;5;19;4;8;12
109;13.05.2017;2017;05;11;Lauantai;15;10;25;3;7;10
109;13.05.2017;2017;05;12;Lauantai;15;17;32;3;1;4
109;13.05.2017;2017;05;13;Lauantai;16;8;24;6;0;6
109;13.05.2017;2017;05;14;Lauantai;16;12;28;5;2;7
109;13.05.2017;2017;05;15;Lauantai;12;7;19;5;0;5
109;13.05.2017;2017;05;16;Lauantai;14;13;27;3;4;7
109;13.05.2017;2017;05;17;Lauantai;12;6;18;5;2;7
109;13.05.2017;2017;05;18;Lauantai;19;8;27;7;1;8
109;13.05.2017;2017;05;19;Lauantai;12;9;21;9;1;10
109;13.05.2017;2017;05;20;Lauantai;10;13;23;7;3;10
109;13.05.2017;2017;05;21;Lauantai;5;5;10;4;1;5
109;13.05.2017;2017;05;22;Lauantai;3;0;3;0;1;1
109;13.05.2017;2017;05;23;Lauantai;1;2;3;1;0;1
109;14.05.2017;2017;05;00;Sunnuntai;0;0;0;0;1;1
109;14.05.2017;2017;05;01;Sunnuntai;0;0;0;1;0;1
109;14.05.2017;2017;05;02;Sunnuntai;0;1;1;0;0;0
109;14.05.2017;2017;05;03;Sunnuntai;0;0;0;0;0;0
109;14.05.2017;2017;05;04;Sunnuntai;0;2;2;1;0;1
109;14.05.2017;2017;05;05;Sunnuntai;2;1;3;0;0;0
109;14.05.2017;2017;05;06;Sunnuntai;3;5;8;1;2;3
109;14.05.2017;2017;05;07;Sunnuntai;1;3;4;3;0;3
109;14.05.2017;2017;05;08;Sunnuntai;4;2;6;3;2;5
109;14.05.2017;2017;05;09;Sunnuntai;4;1;5;2;3;5
109;14.05.2017;2017;05;10;Sunnuntai;6;1;7;3;4;7
109;14.05.2017;2017;05;11;Sunnuntai;3;3;6;4;1;5
109;14.05.2017;2017;05;12;Sunnuntai;2;5;7;3;1;4
109;14.05.2017;2017;05;13;Sunnuntai;2;2;4;3;0;3
109;14.05.2017;2017;05;14;Sunnuntai;3;3;6;4;0;4
109;14.05.2017;2017;05;15;Sunnuntai;2;0;2;3;1;4
109;14.05.2017;2017;05;16;Sunnuntai;4;7;11;2;1;3
109;14.05.2017;2017;05;17;Sunnuntai;2;5;7;4;2;6
109;14.05.2017;2017;05;18;Sunnuntai;4;3;7;1;5;6
109;14.05.2017;2017;05;19;Sunnuntai;3;5;8;2;5;7
109;14.05.2017;2017;05;20;Sunnuntai;4;2;6;5;2;7
109;14.05.2017;2017;05;21;Sunnuntai;2;1;3;1;1;2
109;14.05.2017;2017;05;22;Sunnuntai;0;1;1;0;2;2
109;14.05.2017;2017;05;23;Sunnuntai;0;2;2;1;1;2
109;15.05.2017;2017;05;00;Maanantai;0;0;0;0;0;0
109;15.05.2017;2017;05;01;Maanantai;2;1;3;0;2;2
109;15.05.2017;2017;05;02;Maanantai;0;0;0;0;1;1
109;15.05.2017;2017;05;03;Maanantai;0;0;0;0;0;0
109;15.05.2017;2017;05;04;Maanantai;1;1;2;0;0;0
109;15.05.2017;2017;05;05;Maanantai;5;2;7;1;0;1
109;15.05.2017;2017;05;06;Maanantai;28;30;58;2;0;2
109;15.05.2017;2017;05;07;Maanantai;83;34;117;4;6;10
109;15.05.2017;2017;05;08;Maanantai;52;10;62;5;3;8
109;15.05.2017;2017;05;09;Maanantai;17;6;23;4;5;9
109;15.05.2017;2017;05;10;Maanantai;15;13;28;5;4;9
109;15.05.2017;2017;05;11;Maanantai;15;9;24;0;3;3
109;15.05.2017;2017;05;12;Maanantai;15;11;26;3;2;5
109;15.05.2017;2017;05;13;Maanantai;13;19;32;4;5;9
109;15.05.2017;2017;05;14;Maanantai;11;20;31;4;4;8
109;15.05.2017;2017;05;15;Maanantai;23;48;71;9;9;18
109;15.05.2017;2017;05;16;Maanantai;47;73;120;4;4;8
109;15.05.2017;2017;05;17;Maanantai;27;12;39;7;4;11
109;15.05.2017;2017;05;18;Maanantai;20;18;38;8;5;13
109;15.05.2017;2017;05;19;Maanantai;15;14;29;14;7;21
109;15.05.2017;2017;05;20;Maanantai;13;7;20;6;7;13
109;15.05.2017;2017;05;21;Maanantai;9;14;23;0;3;3
109;15.05.2017;2017;05;22;Maanantai;6;6;12;2;3;5
109;15.05.2017;2017;05;23;Maanantai;2;0;2;1;1;2
109;16.05.2017;2017;05;00;Tiistai;0;1;1;0;0;0
109;16.05.2017;2017;05;01;Tiistai;0;0;0;0;0;0
109;16.05.2017;2017;05;02;Tiistai;1;1;2;1;0;1
109;16.05.2017;2017;05;03;Tiistai;1;0;1;0;0;0
109;16.05.2017;2017;05;04;Tiistai;3;1;4;0;1;1
109;16.05.2017;2017;05;05;Tiistai;5;6;11;0;0;0
109;16.05.2017;2017;05;06;Tiistai;29;31;60;5;2;7
109;16.05.2017;2017;05;07;Tiistai;109;36;145;6;5;11
109;16.05.2017;2017;05;08;Tiistai;55;14;69;4;3;7
109;16.05.2017;2017;05;09;Tiistai;18;6;24;4;4;8
109;16.05.2017;2017;05;10;Tiistai;11;8;19;4;5;9
109;16.05.2017;2017;05;11;Tiistai;21;14;35;5;5;10
109;16.05.2017;2017;05;12;Tiistai;21;9;30;1;0;1
109;16.05.2017;2017;05;13;Tiistai;18;22;40;4;4;8
109;16.05.2017;2017;05;14;Tiistai;19;22;41;5;7;12
109;16.05.2017;2017;05;15;Tiistai;30;64;94;9;9;18
109;16.05.2017;2017;05;16;Tiistai;46;93;139;5;6;11
109;16.05.2017;2017;05;17;Tiistai;30;23;53;12;2;14
109;16.05.2017;2017;05;18;Tiistai;25;22;47;10;4;14
109;16.05.2017;2017;05;19;Tiistai;19;10;29;8;3;11
109;16.05.2017;2017;05;20;Tiistai;16;21;37;6;3;9
109;16.05.2017;2017;05;21;Tiistai;10;11;21;3;2;5
109;16.05.2017;2017;05;22;Tiistai;2;3;5;2;1;3
109;16.05.2017;2017;05;23;Tiistai;2;1;3;1;2;3
109;17.05.2017;2017;05;00;Keskiviikko;0;0;0;0;0;0
109;17.05.2017;2017;05;01;Keskiviikko;4;0;4;0;1;1
109;17.05.2017;2017;05;02;Keskiviikko;0;0;0;0;0;0
109;17.05.2017;2017;05;03;Keskiviikko;0;0;0;0;0;0
109;17.05.2017;2017;05;04;Keskiviikko;2;1;3;0;0;0
109;17.05.2017;2017;05;05;Keskiviikko;3;2;5;0;0;0
109;17.05.2017;2017;05;06;Keskiviikko;21;19;40;3;2;5
109;17.05.2017;2017;05;07;Keskiviikko;75;42;117;7;11;18
109;17.05.2017;2017;05;08;Keskiviikko;41;10;51;5;4;9
109;17.05.2017;2017;05;09;Keskiviikko;8;5;13;9;3;12
109;17.05.2017;2017;05;10;Keskiviikko;4;3;7;1;3;4
109;17.05.2017;2017;05;11;Keskiviikko;8;6;14;0;1;1
109;17.05.2017;2017;05;12;Keskiviikko;8;4;12;1;2;3
109;17.05.2017;2017;05;13;Keskiviikko;6;12;18;5;5;10
109;17.05.2017;2017;05;14;Keskiviikko;14;25;39;4;3;7
109;17.05.2017;2017;05;15;Keskiviikko;25;33;58;1;2;3
109;17.05.2017;2017;05;16;Keskiviikko;22;44;66;3;2;5
109;17.05.2017;2017;05;17;Keskiviikko;12;19;31;7;2;9
109;17.05.2017;2017;05;18;Keskiviikko;11;10;21;0;2;2
109;17.05.2017;2017;05;19;Keskiviikko;8;8;16;8;5;13
109;17.05.2017;2017;05;20;Keskiviikko;1;11;12;6;4;10
109;17.05.2017;2017;05;21;Keskiviikko;5;6;11;2;0;2
109;17.05.2017;2017;05;22;Keskiviikko;3;1;4;0;1;1
109;17.05.2017;2017;05;23;Keskiviikko;0;0;0;0;0;0
109;18.05.2017;2017;05;00;Torstai;1;0;1;0;0;0
109;18.05.2017;2017;05;01;Torstai;1;0;1;0;0;0
109;18.05.2017;2017;05;02;Torstai;1;0;1;0;0;0
109;18.05.2017;2017;05;03;Torstai;0;1;1;0;0;0
109;18.05.2017;2017;05;04;Torstai;0;0;0;0;0;0
109;18.05.2017;2017;05;05;Torstai;4;8;12;1;1;2
109;18.05.2017;2017;05;06;Torstai;25;20;45;5;2;7
109;18.05.2017;2017;05;07;Torstai;96;33;129;11;6;17
109;18.05.2017;2017;05;08;Torstai;38;15;53;6;5;11
109;18.05.2017;2017;05;09;Torstai;13;4;17;3;2;5
109;18.05.2017;2017;05;10;Torstai;12;7;19;2;2;4
109;18.05.2017;2017;05;11;Torstai;17;4;21;4;5;9
109;18.05.2017;2017;05;12;Torstai;8;8;16;4;4;8
109;18.05.2017;2017;05;13;Torstai;12;12;24;4;3;7
109;18.05.2017;2017;05;14;Torstai;12;17;29;5;1;6
109;18.05.2017;2017;05;15;Torstai;22;48;70;7;6;13
109;18.05.2017;2017;05;16;Torstai;43;73;116;2;6;8
109;18.05.2017;2017;05;17;Torstai;17;21;38;4;2;6
109;18.05.2017;2017;05;18;Torstai;11;19;30;12;3;15
109;18.05.2017;2017;05;19;Torstai;11;18;29;10;8;18
109;18.05.2017;2017;05;20;Torstai;14;9;23;9;6;15
109;18.05.2017;2017;05;21;Torstai;7;11;18;5;1;6
109;18.05.2017;2017;05;22;Torstai;3;4;7;3;1;4
109;18.05.2017;2017;05;23;Torstai;1;1;2;0;0;0
109;19.05.2017;2017;05;00;Perjantai;1;1;2;0;0;0
109;19.05.2017;2017;05;01;Perjantai;0;0;0;1;0;1
109;19.05.2017;2017;05;02;Perjantai;0;0;0;0;0;0
109;19.05.2017;2017;05;03;Perjantai;0;0;0;0;0;0
109;19.05.2017;2017;05;04;Perjantai;0;0;0;0;0;0
109;19.05.2017;2017;05;05;Perjantai;4;3;7;0;1;1
109;19.05.2017;2017;05;06;Perjantai;11;13;24;2;2;4
109;19.05.2017;2017;05;07;Perjantai;41;20;61;1;2;3
109;19.05.2017;2017;05;08;Perjantai;29;7;36;3;5;8
109;19.05.2017;2017;05;09;Perjantai;11;6;17;0;0;0
109;19.05.2017;2017;05;10;Perjantai;4;5;9;0;5;5
109;19.05.2017;2017;05;11;Perjantai;9;6;15;1;2;3
109;19.05.2017;2017;05;12;Perjantai;14;9;23;2;2;4
109;19.05.2017;2017;05;13;Perjantai;28;20;48;6;4;10
109;19.05.2017;2017;05;14;Perjantai;18;24;42;2;5;7
109;19.05.2017;2017;05;15;Perjantai;20;21;41;3;7;10
109;19.05.2017;2017;05;16;Perjantai;21;42;63;0;4;4
109;19.05.2017;2017;05;17;Perjantai;10;16;26;2;3;5
109;19.05.2017;2017;05;18;Perjantai;11;8;19;7;4;11
109;19.05.2017;2017;05;19;Perjantai;10;2;12;5;10;15
109;19.05.2017;2017;05;20;Perjantai;2;5;7;2;5;7
109;19.05.2017;2017;05;21;Perjantai;6;11;17;0;0;0
109;19.05.2017;2017;05;22;Perjantai;2;0;2;3;2;5
109;19.05.2017;2017;05;23;Perjantai;0;4;4;2;0;2
109;20.05.2017;2017;05;00;Lauantai;0;3;3;0;0;0
109;20.05.2017;2017;05;01;Lauantai;0;0;0;1;0;1
109;20.05.2017;2017;05;02;Lauantai;0;1;1;0;1;1
109;20.05.2017;2017;05;03;Lauantai;0;0;0;0;0;0
109;20.05.2017;2017;05;04;Lauantai;1;1;2;0;1;1
109;20.05.2017;2017;05;05;Lauantai;1;2;3;0;0;0
109;20.05.2017;2017;05;06;Lauantai;4;4;8;1;2;3
109;20.05.2017;2017;05;07;Lauantai;2;5;7;2;0;2
109;20.05.2017;2017;05;08;Lauantai;9;1;10;3;3;6
109;20.05.2017;2017;05;09;Lauantai;15;11;26;6;3;9
109;20.05.2017;2017;05;10;Lauantai;16;11;27;6;7;13
109;20.05.2017;2017;05;11;Lauantai;17;11;28;1;1;2
109;20.05.2017;2017;05;12;Lauantai;28;13;41;5;3;8
109;20.05.2017;2017;05;13;Lauantai;30;14;44;4;2;6
109;20.05.2017;2017;05;14;Lauantai;33;22;55;7;4;11
109;20.05.2017;2017;05;15;Lauantai;7;15;22;5;0;5
109;20.05.2017;2017;05;16;Lauantai;15;11;26;5;4;9
109;20.05.2017;2017;05;17;Lauantai;19;12;31;6;3;9
109;20.05.2017;2017;05;18;Lauantai;15;12;27;6;3;9
109;20.05.2017;2017;05;19;Lauantai;14;9;23;7;2;9
109;20.05.2017;2017;05;20;Lauantai;8;10;18;4;2;6
109;20.05.2017;2017;05;21;Lauantai;6;8;14;1;2;3
109;20.05.2017;2017;05;22;Lauantai;4;6;10;1;3;4
109;20.05.2017;2017;05;23;Lauantai;5;4;9;1;2;3
109;21.05.2017;2017;05;00;Sunnuntai;1;0;1;0;0;0
109;21.05.2017;2017;05;01;Sunnuntai;1;0;1;2;0;2
109;21.05.2017;2017;05;02;Sunnuntai;2;1;3;1;1;2
109;21.05.2017;2017;05;03;Sunnuntai;2;2;4;0;0;0
109;21.05.2017;2017;05;04;Sunnuntai;0;2;2;1;1;2
109;21.05.2017;2017;05;05;Sunnuntai;1;1;2;0;0;0
109;21.05.2017;2017;05;06;Sunnuntai;5;2;7;0;2;2
109;21.05.2017;2017;05;07;Sunnuntai;0;4;4;4;1;5
109;21.05.2017;2017;05;08;Sunnuntai;3;2;5;5;2;7
109;21.05.2017;2017;05;09;Sunnuntai;5;4;9;4;6;10
109;21.05.2017;2017;05;10;Sunnuntai;11;7;18;6;2;8
109;21.05.2017;2017;05;11;Sunnuntai;13;13;26;2;5;7
109;21.05.2017;2017;05;12;Sunnuntai;8;6;14;2;9;11
109;21.05.2017;2017;05;13;Sunnuntai;26;15;41;6;7;13
109;21.05.2017;2017;05;14;Sunnuntai;16;9;25;4;4;8
109;21.05.2017;2017;05;15;Sunnuntai;19;20;39;8;4;12
109;21.05.2017;2017;05;16;Sunnuntai;21;8;29;4;8;12
109;21.05.2017;2017;05;17;Sunnuntai;12;8;20;4;3;7
109;21.05.2017;2017;05;18;Sunnuntai;15;14;29;6;2;8
109;21.05.2017;2017;05;19;Sunnuntai;8;13;21;12;5;17
109;21.05.2017;2017;05;20;Sunnuntai;12;7;19;8;1;9
109;21.05.2017;2017;05;21;Sunnuntai;4;3;7;3;2;5
109;21.05.2017;2017;05;22;Sunnuntai;2;0;2;0;1;1
109;21.05.2017;2017;05;23;Sunnuntai;0;1;1;1;1;2
109;22.05.2017;2017;05;00;Maanantai;1;0;1;0;2;2
109;22.05.2017;2017;05;01;Maanantai;0;0;0;0;0;0
109;22.05.2017;2017;05;02;Maanantai;2;0;2;0;0;0
109;22.05.2017;2017;05;03;Maanantai;0;0;0;0;0;0
109;22.05.2017;2017;05;04;Maanantai;0;1;1;0;0;0
109;22.05.2017;2017;05;05;Maanantai;7;8;15;1;0;1
109;22.05.2017;2017;05;06;Maanantai;36;26;62;5;0;5
109;22.05.2017;2017;05;07;Maanantai;105;42;147;7;7;14
109;22.05.2017;2017;05;08;Maanantai;71;27;98;6;5;11
109;22.05.2017;2017;05;09;Maanantai;17;8;25;2;6;8
109;22.05.2017;2017;05;10;Maanantai;23;10;33;3;4;7
109;22.05.2017;2017;05;11;Maanantai;19;17;36;4;1;5
109;22.05.2017;2017;05;12;Maanantai;19;19;38;5;3;8
109;22.05.2017;2017;05;13;Maanantai;18;14;32;2;0;2
109;22.05.2017;2017;05;14;Maanantai;19;25;44;5;8;13
109;22.05.2017;2017;05;15;Maanantai;35;78;113;4;3;7
109;22.05.2017;2017;05;16;Maanantai;59;80;139;7;6;13
109;22.05.2017;2017;05;17;Maanantai;32;29;61;8;5;13
109;22.05.2017;2017;05;18;Maanantai;25;21;46;8;6;14
109;22.05.2017;2017;05;19;Maanantai;17;22;39;12;0;12
109;22.05.2017;2017;05;20;Maanantai;9;18;27;10;4;14
109;22.05.2017;2017;05;21;Maanantai;6;10;16;4;5;9
109;22.05.2017;2017;05;22;Maanantai;3;3;6;2;1;3
109;22.05.2017;2017;05;23;Maanantai;2;1;3;1;1;2
109;23.05.2017;2017;05;00;Tiistai;4;1;5;0;0;0
109;23.05.2017;2017;05;01;Tiistai;0;0;0;0;0;0
109;23.05.2017;2017;05;02;Tiistai;0;0;0;0;0;0
109;23.05.2017;2017;05;03;Tiistai;0;0;0;0;0;0
109;23.05.2017;2017;05;04;Tiistai;1;1;2;0;0;0
109;23.05.2017;2017;05;05;Tiistai;4;10;14;0;0;0
109;23.05.2017;2017;05;06;Tiistai;44;29;73;7;1;8
109;23.05.2017;2017;05;07;Tiistai;119;35;154;6;6;12
109;23.05.2017;2017;05;08;Tiistai;68;20;88;1;2;3
109;23.05.2017;2017;05;09;Tiistai;17;12;29;2;3;5
109;23.05.2017;2017;05;10;Tiistai;23;13;36;3;4;7
109;23.05.2017;2017;05;11;Tiistai;18;17;35;3;4;7
109;23.05.2017;2017;05;12;Tiistai;15;18;33;5;4;9
109;23.05.2017;2017;05;13;Tiistai;13;19;32;7;4;11
109;23.05.2017;2017;05;14;Tiistai;22;21;43;2;2;4
109;23.05.2017;2017;05;15;Tiistai;36;81;117;9;7;16
109;23.05.2017;2017;05;16;Tiistai;52;77;129;6;4;10
109;23.05.2017;2017;05;17;Tiistai;35;28;63;9;2;11
109;23.05.2017;2017;05;18;Tiistai;23;17;40;6;2;8
109;23.05.2017;2017;05;19;Tiistai;20;18;38;5;8;13
109;23.05.2017;2017;05;20;Tiistai;13;8;21;5;3;8
109;23.05.2017;2017;05;21;Tiistai;6;11;17;3;2;5
109;23.05.2017;2017;05;22;Tiistai;5;3;8;0;0;0
109;23.05.2017;2017;05;23;Tiistai;0;0;0;2;3;5
109;24.05.2017;2017;05;00;Keskiviikko;1;1;2;0;0;0
109;24.05.2017;2017;05;01;Keskiviikko;0;1;1;0;0;0
109;24.05.2017;2017;05;02;Keskiviikko;0;0;0;0;1;1
109;24.05.2017;2017;05;03;Keskiviikko;0;1;1;0;0;0
109;24.05.2017;2017;05;04;Keskiviikko;0;1;1;0;0;0
109;24.05.2017;2017;05;05;Keskiviikko;6;6;12;0;0;0
109;24.05.2017;2017;05;06;Keskiviikko;31;24;55;2;0;2
109;24.05.2017;2017;05;07;Keskiviikko;111;37;148;7;7;14
109;24.05.2017;2017;05;08;Keskiviikko;65;23;88;5;3;8
109;24.05.2017;2017;05;09;Keskiviikko;18;11;29;1;0;1
109;24.05.2017;2017;05;10;Keskiviikko;19;10;29;4;5;9
109;24.05.2017;2017;05;11;Keskiviikko;19;6;25;3;4;7
109;24.05.2017;2017;05;12;Keskiviikko;17;19;36;2;3;5
109;24.05.2017;2017;05;13;Keskiviikko;15;21;36;6;5;11
109;24.05.2017;2017;05;14;Keskiviikko;22;25;47;4;1;5
109;24.05.2017;2017;05;15;Keskiviikko;36;65;101;2;6;8
109;24.05.2017;2017;05;16;Keskiviikko;44;69;113;5;9;14
109;24.05.2017;2017;05;17;Keskiviikko;34;26;60;4;1;5
109;24.05.2017;2017;05;18;Keskiviikko;29;18;47;6;5;11
109;24.05.2017;2017;05;19;Keskiviikko;21;15;36;4;6;10
109;24.05.2017;2017;05;20;Keskiviikko;9;12;21;4;1;5
109;24.05.2017;2017;05;21;Keskiviikko;9;9;18;4;1;5
109;24.05.2017;2017;05;22;Keskiviikko;5;7;12;1;1;2
109;24.05.2017;2017;05;23;Keskiviikko;8;5;13;0;0;0
109;25.05.2017;2017;05;00;Torstai;3;7;10;0;0;0
109;25.05.2017;2017;05;01;Torstai;1;1;2;0;0;0
109;25.05.2017;2017;05;02;Torstai;4;1;5;0;1;1
109;25.05.2017;2017;05;03;Torstai;1;0;1;0;0;0
109;25.05.2017;2017;05;04;Torstai;0;0;0;0;0;0
109;25.05.2017;2017;05;05;Torstai;0;1;1;0;0;0
109;25.05.2017;2017;05;06;Torstai;6;7;13;0;1;1
109;25.05.2017;2017;05;07;Torstai;12;9;21;3;1;4
109;25.05.2017;2017;05;08;Torstai;10;7;17;4;2;6
109;25.05.2017;2017;05;09;Torstai;14;5;19;3;3;6
109;25.05.2017;2017;05;10;Torstai;16;11;27;3;3;6
109;25.05.2017;2017;05;11;Torstai;15;13;28;2;1;3
109;25.05.2017;2017;05;12;Torstai;15;13;28;5;1;6
109;25.05.2017;2017;05;13;Torstai;12;6;18;1;3;4
109;25.05.2017;2017;05;14;Torstai;19;8;27;6;4;10
109;25.05.2017;2017;05;15;Torstai;11;14;25;5;4;9
109;25.05.2017;2017;05;16;Torstai;17;18;35;5;4;9
109;25.05.2017;2017;05;17;Torstai;20;22;42;5;1;6
109;25.05.2017;2017;05;18;Torstai;25;12;37;6;4;10
109;25.05.2017;2017;05;19;Torstai;19;9;28;5;3;8
109;25.05.2017;2017;05;20;Torstai;9;7;16;4;3;7
109;25.05.2017;2017;05;21;Torstai;9;11;20;2;2;4
109;25.05.2017;2017;05;22;Torstai;3;9;12;2;0;2
109;25.05.2017;2017;05;23;Torstai;1;1;2;0;0;0
109;26.05.2017;2017;05;00;Perjantai;0;2;2;0;1;1
109;26.05.2017;2017;05;01;Perjantai;2;2;4;0;0;0
109;26.05.2017;2017;05;02;Perjantai;0;0;0;0;0;0
109;26.05.2017;2017;05;03;Perjantai;1;1;2;0;0;0
109;26.05.2017;2017;05;04;Perjantai;1;1;2;0;1;1
109;26.05.2017;2017;05;05;Perjantai;5;4;9;1;1;2
109;26.05.2017;2017;05;06;Perjantai;23;13;36;2;1;3
109;26.05.2017;2017;05;07;Perjantai;59;28;87;5;4;9
109;26.05.2017;2017;05;08;Perjantai;35;10;45;5;1;6
109;26.05.2017;2017;05;09;Perjantai;19;2;21;4;1;5
109;26.05.2017;2017;05;10;Perjantai;9;4;13;0;2;2
109;26.05.2017;2017;05;11;Perjantai;14;10;24;6;0;6
109;26.05.2017;2017;05;12;Perjantai;18;21;39;6;11;17
109;26.05.2017;2017;05;13;Perjantai;12;22;34;4;0;4
109;26.05.2017;2017;05;14;Perjantai;22;52;74;2;5;7
109;26.05.2017;2017;05;15;Perjantai;29;36;65;4;0;4
109;26.05.2017;2017;05;16;Perjantai;22;34;56;6;1;7
109;26.05.2017;2017;05;17;Perjantai;18;19;37;5;7;12
109;26.05.2017;2017;05;18;Perjantai;12;12;24;8;1;9
109;26.05.2017;2017;05;19;Perjantai;17;12;29;5;6;11
109;26.05.2017;2017;05;20;Perjantai;5;6;11;4;3;7
109;26.05.2017;2017;05;21;Perjantai;9;11;20;5;2;7
109;26.05.2017;2017;05;22;Perjantai;2;4;6;0;1;1
109;26.05.2017;2017;05;23;Perjantai;1;2;3;0;0;0
109;27.05.2017;2017;05;00;Lauantai;3;3;6;0;0;0
109;27.05.2017;2017;05;01;Lauantai;0;3;3;0;0;0
109;27.05.2017;2017;05;02;Lauantai;1;0;1;0;0;0
109;27.05.2017;2017;05;03;Lauantai;0;1;1;0;0;0
109;27.05.2017;2017;05;04;Lauantai;2;1;3;0;0;0
109;27.05.2017;2017;05;05;Lauantai;0;1;1;0;0;0
109;27.05.2017;2017;05;06;Lauantai;8;2;10;4;0;4
109;27.05.2017;2017;05;07;Lauantai;1;3;4;7;1;8
109;27.05.2017;2017;05;08;Lauantai;5;0;5;3;1;4
109;27.05.2017;2017;05;09;Lauantai;9;14;23;3;4;7
109;27.05.2017;2017;05;10;Lauantai;11;8;19;2;2;4
109;27.05.2017;2017;05;11;Lauantai;13;19;32;2;6;8
109;27.05.2017;2017;05;12;Lauantai;20;8;28;10;1;11
109;27.05.2017;2017;05;13;Lauantai;21;15;36;5;3;8
109;27.05.2017;2017;05;14;Lauantai;11;13;24;3;3;6
109;27.05.2017;2017;05;15;Lauantai;13;9;22;2;1;3
109;27.05.2017;2017;05;16;Lauantai;4;10;14;2;6;8
109;27.05.2017;2017;05;17;Lauantai;12;4;16;3;1;4
109;27.05.2017;2017;05;18;Lauantai;7;3;10;5;3;8
109;27.05.2017;2017;05;19;Lauantai;6;5;11;3;1;4
109;27.05.2017;2017;05;20;Lauantai;2;5;7;3;4;7
109;27.05.2017;2017;05;21;Lauantai;6;5;11;4;1;5
109;27.05.2017;2017;05;22;Lauantai;3;7;10;2;3;5
109;27.05.2017;2017;05;23;Lauantai;1;1;2;0;0;0
109;28.05.2017;2017;05;00;Sunnuntai;0;0;0;1;0;1
109;28.05.2017;2017;05;01;Sunnuntai;1;0;1;0;0;0
109;28.05.2017;2017;05;02;Sunnuntai;0;2;2;0;0;0
109;28.05.2017;2017;05;03;Sunnuntai;0;0;0;0;0;0
109;28.05.2017;2017;05;04;Sunnuntai;0;1;1;0;1;1
109;28.05.2017;2017;05;05;Sunnuntai;0;3;3;1;0;1
109;28.05.2017;2017;05;06;Sunnuntai;4;2;6;10;4;14
109;28.05.2017;2017;05;07;Sunnuntai;2;1;3;2;5;7
109;28.05.2017;2017;05;08;Sunnuntai;4;2;6;7;5;12
109;28.05.2017;2017;05;09;Sunnuntai;7;1;8;4;3;7
109;28.05.2017;2017;05;10;Sunnuntai;1;3;4;5;2;7
109;28.05.2017;2017;05;11;Sunnuntai;3;2;5;3;2;5
109;28.05.2017;2017;05;12;Sunnuntai;1;3;4;0;3;3
109;28.05.2017;2017;05;13;Sunnuntai;6;2;8;1;4;5
109;28.05.2017;2017;05;14;Sunnuntai;3;6;9;4;3;7
109;28.05.2017;2017;05;15;Sunnuntai;11;7;18;5;2;7
109;28.05.2017;2017;05;16;Sunnuntai;6;6;12;1;2;3
109;28.05.2017;2017;05;17;Sunnuntai;0;2;2;3;1;4
109;28.05.2017;2017;05;18;Sunnuntai;6;6;12;7;5;12
109;28.05.2017;2017;05;19;Sunnuntai;3;2;5;8;5;13
109;28.05.2017;2017;05;20;Sunnuntai;4;2;6;6;2;8
109;28.05.2017;2017;05;21;Sunnuntai;1;5;6;2;1;3
109;28.05.2017;2017;05;22;Sunnuntai;0;1;1;1;2;3
109;28.05.2017;2017;05;23;Sunnuntai;1;0;1;1;0;1
109;29.05.2017;2017;05;00;Maanantai;1;0;1;0;2;2
109;29.05.2017;2017;05;01;Maanantai;0;0;0;0;0;0
109;29.05.2017;2017;05;02;Maanantai;0;0;0;0;0;0
109;29.05.2017;2017;05;03;Maanantai;0;1;1;0;0;0
109;29.05.2017;2017;05;04;Maanantai;2;3;5;0;0;0
109;29.05.2017;2017;05;05;Maanantai;3;7;10;2;1;3
109;29.05.2017;2017;05;06;Maanantai;29;22;51;2;0;2
109;29.05.2017;2017;05;07;Maanantai;86;35;121;5;5;10
109;29.05.2017;2017;05;08;Maanantai;53;17;70;6;6;12
109;29.05.2017;2017;05;09;Maanantai;15;7;22;4;2;6
109;29.05.2017;2017;05;10;Maanantai;12;12;24;5;1;6
109;29.05.2017;2017;05;11;Maanantai;14;12;26;3;3;6
109;29.05.2017;2017;05;12;Maanantai;18;21;39;2;3;5
109;29.05.2017;2017;05;13;Maanantai;12;17;29;3;5;8
109;29.05.2017;2017;05;14;Maanantai;24;26;50;2;5;7
109;29.05.2017;2017;05;15;Maanantai;36;53;89;5;1;6
109;29.05.2017;2017;05;16;Maanantai;46;68;114;9;5;14
109;29.05.2017;2017;05;17;Maanantai;25;28;53;3;4;7
109;29.05.2017;2017;05;18;Maanantai;17;17;34;4;7;11
109;29.05.2017;2017;05;19;Maanantai;12;8;20;10;3;13
109;29.05.2017;2017;05;20;Maanantai;7;11;18;11;4;15
109;29.05.2017;2017;05;21;Maanantai;7;13;20;4;2;6
109;29.05.2017;2017;05;22;Maanantai;1;2;3;1;0;1
109;29.05.2017;2017;05;23;Maanantai;1;3;4;0;2;2
109;30.05.2017;2017;05;00;Tiistai;2;1;3;0;0;0
109;30.05.2017;2017;05;01;Tiistai;1;0;1;0;2;2
109;30.05.2017;2017;05;02;Tiistai;0;0;0;0;0;0
109;30.05.2017;2017;05;03;Tiistai;0;0;0;0;0;0
109;30.05.2017;2017;05;04;Tiistai;0;3;3;0;0;0
109;30.05.2017;2017;05;05;Tiistai;5;6;11;0;0;0
109;30.05.2017;2017;05;06;Tiistai;34;19;53;8;1;9
109;30.05.2017;2017;05;07;Tiistai;112;39;151;3;5;8
109;30.05.2017;2017;05;08;Tiistai;56;32;88;2;2;4
109;30.05.2017;2017;05;09;Tiistai;20;5;25;2;3;5
109;30.05.2017;2017;05;10;Tiistai;18;14;32;3;5;8
109;30.05.2017;2017;05;11;Tiistai;29;15;44;3;5;8
109;30.05.2017;2017;05;12;Tiistai;19;20;39;7;2;9
109;30.05.2017;2017;05;13;Tiistai;20;13;33;2;5;7
109;30.05.2017;2017;05;14;Tiistai;22;30;52;3;4;7
109;30.05.2017;2017;05;15;Tiistai;34;76;110;9;4;13
109;30.05.2017;2017;05;16;Tiistai;47;80;127;3;5;8
109;30.05.2017;2017;05;17;Tiistai;28;27;55;8;1;9
109;30.05.2017;2017;05;18;Tiistai;19;16;35;8;4;12
109;30.05.2017;2017;05;19;Tiistai;22;22;44;5;5;10
109;30.05.2017;2017;05;20;Tiistai;12;13;25;4;9;13
109;30.05.2017;2017;05;21;Tiistai;5;13;18;1;1;2
109;30.05.2017;2017;05;22;Tiistai;3;2;5;1;0;1
109;30.05.2017;2017;05;23;Tiistai;0;0;0;4;2;6
109;31.05.2017;2017;05;00;Keskiviikko;5;1;6;0;1;1
109;31.05.2017;2017;05;01;Keskiviikko;1;1;2;0;0;0
109;31.05.2017;2017;05;02;Keskiviikko;0;0;0;0;0;0
109;31.05.2017;2017;05;03;Keskiviikko;0;2;2;0;0;0
109;31.05.2017;2017;05;04;Keskiviikko;0;3;3;0;0;0
109;31.05.2017;2017;05;05;Keskiviikko;6;6;12;5;2;7
109;31.05.2017;2017;05;06;Keskiviikko;30;23;53;6;1;7
109;31.05.2017;2017;05;07;Keskiviikko;80;32;112;5;5;10
109;31.05.2017;2017;05;08;Keskiviikko;55;16;71;4;6;10
109;31.05.2017;2017;05;09;Keskiviikko;12;3;15;0;0;0
109;31.05.2017;2017;05;10;Keskiviikko;9;4;13;2;1;3
109;31.05.2017;2017;05;11;Keskiviikko;8;10;18;0;5;5
109;31.05.2017;2017;05;12;Keskiviikko;14;11;25;3;2;5
109;31.05.2017;2017;05;13;Keskiviikko;13;15;28;4;5;9
109;31.05.2017;2017;05;14;Keskiviikko;17;26;43;1;2;3
109;31.05.2017;2017;05;15;Keskiviikko;25;44;69;2;6;8
109;31.05.2017;2017;05;16;Keskiviikko;29;59;88;7;7;14
109;31.05.2017;2017;05;17;Keskiviikko;14;22;36;5;3;8
109;31.05.2017;2017;05;18;Keskiviikko;19;19;38;1;2;3
109;31.05.2017;2017;05;19;Keskiviikko;15;5;20;11;3;14
109;31.05.2017;2017;05;20;Keskiviikko;7;11;18;6;1;7
109;31.05.2017;2017;05;21;Keskiviikko;5;19;24;0;1;1
109;31.05.2017;2017;05;22;Keskiviikko;4;2;6;0;2;2
109;31.05.2017;2017;05;23;Keskiviikko;1;0;1;3;2;5
109;01.06.2017;2017;06;00;Torstai;2;0;2;1;0;1
109;01.06.2017;2017;06;01;Torstai;1;0;1;0;0;0
109;01.06.2017;2017;06;02;Torstai;0;1;1;0;0;0
109;01.06.2017;2017;06;03;Torstai;0;0;0;0;0;0
109;01.06.2017;2017;06;04;Torstai;0;2;2;0;0;0
109;01.06.2017;2017;06;05;Torstai;5;7;12;0;0;0
109;01.06.2017;2017;06;06;Torstai;35;22;57;2;1;3
109;01.06.2017;2017;06;07;Torstai;85;40;125;3;3;6
109;01.06.2017;2017;06;08;Torstai;56;22;78;3;2;5
109;01.06.2017;2017;06;09;Torstai;15;7;22;2;4;6
109;01.06.2017;2017;06;10;Torstai;12;13;25;3;5;8
109;01.06.2017;2017;06;11;Torstai;13;12;25;3;1;4
109;01.06.2017;2017;06;12;Torstai;13;16;29;1;1;2
109;01.06.2017;2017;06;13;Torstai;16;12;28;2;2;4
109;01.06.2017;2017;06;14;Torstai;12;22;34;2;2;4
109;01.06.2017;2017;06;15;Torstai;27;48;75;3;2;5
109;01.06.2017;2017;06;16;Torstai;37;60;97;2;5;7
109;01.06.2017;2017;06;17;Torstai;20;28;48;2;4;6
109;01.06.2017;2017;06;18;Torstai;11;14;25;5;6;11
109;01.06.2017;2017;06;19;Torstai;7;14;21;9;4;13
109;01.06.2017;2017;06;20;Torstai;9;11;20;5;5;10
109;01.06.2017;2017;06;21;Torstai;3;10;13;4;3;7
109;01.06.2017;2017;06;22;Torstai;4;1;5;1;0;1
109;01.06.2017;2017;06;23;Torstai;3;0;3;0;1;1
109;02.06.2017;2017;06;00;Perjantai;0;1;1;1;1;2
109;02.06.2017;2017;06;01;Perjantai;0;1;1;0;0;0
109;02.06.2017;2017;06;02;Perjantai;0;0;0;0;0;0
109;02.06.2017;2017;06;03;Perjantai;0;0;0;0;0;0
109;02.06.2017;2017;06;04;Perjantai;1;2;3;0;0;0
109;02.06.2017;2017;06;05;Perjantai;4;4;8;0;1;1
109;02.06.2017;2017;06;06;Perjantai;20;16;36;2;0;2
109;02.06.2017;2017;06;07;Perjantai;38;24;62;5;4;9
109;02.06.2017;2017;06;08;Perjantai;28;18;46;2;1;3
109;02.06.2017;2017;06;09;Perjantai;6;6;12;1;6;7
109;02.06.2017;2017;06;10;Perjantai;9;6;15;4;1;5
109;02.06.2017;2017;06;11;Perjantai;14;5;19;3;2;5
109;02.06.2017;2017;06;12;Perjantai;15;18;33;4;2;6
109;02.06.2017;2017;06;13;Perjantai;8;13;21;3;3;6
109;02.06.2017;2017;06;14;Perjantai;14;13;27;4;1;5
109;02.06.2017;2017;06;15;Perjantai;31;33;64;4;4;8
109;02.06.2017;2017;06;16;Perjantai;19;30;49;3;3;6
109;02.06.2017;2017;06;17;Perjantai;17;22;39;3;4;7
109;02.06.2017;2017;06;18;Perjantai;10;15;25;4;1;5
109;02.06.2017;2017;06;19;Perjantai;13;11;24;6;7;13
109;02.06.2017;2017;06;20;Perjantai;6;3;9;1;4;5
109;02.06.2017;2017;06;21;Perjantai;3;5;8;3;0;3
109;02.06.2017;2017;06;22;Perjantai;2;1;3;0;0;0
109;02.06.2017;2017;06;23;Perjantai;1;3;4;1;1;2
109;03.06.2017;2017;06;00;Lauantai;3;0;3;0;0;0
109;03.06.2017;2017;06;01;Lauantai;0;1;1;0;1;1
109;03.06.2017;2017;06;02;Lauantai;1;0;1;0;0;0
109;03.06.2017;2017;06;03;Lauantai;0;0;0;0;1;1
109;03.06.2017;2017;06;04;Lauantai;1;1;2;0;0;0
109;03.06.2017;2017;06;05;Lauantai;1;1;2;0;0;0
109;03.06.2017;2017;06;06;Lauantai;2;3;5;3;0;3
109;03.06.2017;2017;06;07;Lauantai;1;2;3;4;1;5
109;03.06.2017;2017;06;08;Lauantai;6;8;14;2;2;4
109;03.06.2017;2017;06;09;Lauantai;7;10;17;3;3;6
109;03.06.2017;2017;06;10;Lauantai;4;8;12;3;1;4
109;03.06.2017;2017;06;11;Lauantai;4;4;8;2;2;4
109;03.06.2017;2017;06;12;Lauantai;8;8;16;2;2;4
109;03.06.2017;2017;06;13;Lauantai;10;6;16;2;2;4
109;03.06.2017;2017;06;14;Lauantai;8;9;17;9;3;12
109;03.06.2017;2017;06;15;Lauantai;11;6;17;5;1;6
109;03.06.2017;2017;06;16;Lauantai;8;11;19;4;4;8
109;03.06.2017;2017;06;17;Lauantai;5;9;14;2;2;4
109;03.06.2017;2017;06;18;Lauantai;8;4;12;3;0;3
109;03.06.2017;2017;06;19;Lauantai;3;5;8;4;2;6
109;03.06.2017;2017;06;20;Lauantai;4;3;7;5;3;8
109;03.06.2017;2017;06;21;Lauantai;5;5;10;1;0;1
109;03.06.2017;2017;06;22;Lauantai;3;0;3;2;0;2
109;03.06.2017;2017;06;23;Lauantai;1;2;3;1;0;1
109;04.06.2017;2017;06;00;Sunnuntai;4;0;4;1;1;2
109;04.06.2017;2017;06;01;Sunnuntai;0;5;5;0;1;1
109;04.06.2017;2017;06;02;Sunnuntai;0;6;6;0;0;0
109;04.06.2017;2017;06;03;Sunnuntai;1;1;2;1;1;2
109;04.06.2017;2017;06;04;Sunnuntai;2;0;2;0;3;3
109;04.06.2017;2017;06;05;Sunnuntai;1;2;3;0;1;1
109;04.06.2017;2017;06;06;Sunnuntai;1;1;2;2;1;3
109;04.06.2017;2017;06;07;Sunnuntai;0;4;4;2;2;4
109;04.06.2017;2017;06;08;Sunnuntai;3;1;4;2;3;5
109;04.06.2017;2017;06;09;Sunnuntai;8;5;13;5;3;8
109;04.06.2017;2017;06;10;Sunnuntai;4;5;9;10;4;14
109;04.06.2017;2017;06;11;Sunnuntai;10;6;16;7;3;10
109;04.06.2017;2017;06;12;Sunnuntai;8;7;15;4;2;6
109;04.06.2017;2017;06;13;Sunnuntai;9;10;19;4;3;7
109;04.06.2017;2017;06;14;Sunnuntai;17;9;26;4;3;7
109;04.06.2017;2017;06;15;Sunnuntai;11;9;20;5;1;6
109;04.06.2017;2017;06;16;Sunnuntai;9;9;18;3;6;9
109;04.06.2017;2017;06;17;Sunnuntai;10;7;17;7;4;11
109;04.06.2017;2017;06;18;Sunnuntai;14;5;19;4;6;10
109;04.06.2017;2017;06;19;Sunnuntai;8;10;18;6;3;9
109;04.06.2017;2017;06;20;Sunnuntai;14;14;28;2;4;6
109;04.06.2017;2017;06;21;Sunnuntai;4;5;9;4;3;7
109;04.06.2017;2017;06;22;Sunnuntai;3;4;7;1;1;2
109;04.06.2017;2017;06;23;Sunnuntai;8;1;9;2;1;3
109;05.06.2017;2017;06;00;Maanantai;0;0;0;0;0;0
109;05.06.2017;2017;06;01;Maanantai;1;0;1;0;0;0
109;05.06.2017;2017;06;02;Maanantai;0;0;0;1;0;1
109;05.06.2017;2017;06;03;Maanantai;0;1;1;0;0;0
109;05.06.2017;2017;06;04;Maanantai;1;2;3;1;0;1
109;05.06.2017;2017;06;05;Maanantai;4;5;9;0;2;2
109;05.06.2017;2017;06;06;Maanantai;40;30;70;2;0;2
109;05.06.2017;2017;06;07;Maanantai;88;54;142;7;7;14
109;05.06.2017;2017;06;08;Maanantai;55;26;81;2;0;2
109;05.06.2017;2017;06;09;Maanantai;20;14;34;2;3;5
109;05.06.2017;2017;06;10;Maanantai;20;9;29;2;1;3
109;05.06.2017;2017;06;11;Maanantai;17;11;28;1;5;6
109;05.06.2017;2017;06;12;Maanantai;21;21;42;4;7;11
109;05.06.2017;2017;06;13;Maanantai;18;19;37;4;3;7
109;05.06.2017;2017;06;14;Maanantai;17;25;42;8;6;14
109;05.06.2017;2017;06;15;Maanantai;53;71;124;5;7;12
109;05.06.2017;2017;06;16;Maanantai;60;78;138;8;3;11
109;05.06.2017;2017;06;17;Maanantai;27;39;66;8;3;11
109;05.06.2017;2017;06;18;Maanantai;15;19;34;8;5;13
109;05.06.2017;2017;06;19;Maanantai;12;15;27;7;9;16
109;05.06.2017;2017;06;20;Maanantai;11;18;29;2;3;5
109;05.06.2017;2017;06;21;Maanantai;10;8;18;7;4;11
109;05.06.2017;2017;06;22;Maanantai;7;2;9;0;0;0
109;05.06.2017;2017;06;23;Maanantai;3;2;5;0;1;1
109;06.06.2017;2017;06;00;Tiistai;1;1;2;0;0;0
109;06.06.2017;2017;06;01;Tiistai;0;1;1;0;0;0
109;06.06.2017;2017;06;02;Tiistai;1;2;3;0;0;0
109;06.06.2017;2017;06;03;Tiistai;0;0;0;0;1;1
109;06.06.2017;2017;06;04;Tiistai;2;1;3;1;0;1
109;06.06.2017;2017;06;05;Tiistai;3;3;6;2;0;2
109;06.06.2017;2017;06;06;Tiistai;24;17;41;3;2;5
109;06.06.2017;2017;06;07;Tiistai;58;43;101;5;6;11
109;06.06.2017;2017;06;08;Tiistai;38;11;49;2;1;3
109;06.06.2017;2017;06;09;Tiistai;14;10;24;2;3;5
109;06.06.2017;2017;06;10;Tiistai;9;1;10;1;3;4
109;06.06.2017;2017;06;11;Tiistai;9;11;20;4;2;6
109;06.06.2017;2017;06;12;Tiistai;16;7;23;6;4;10
109;06.06.2017;2017;06;13;Tiistai;20;11;31;3;4;7
109;06.06.2017;2017;06;14;Tiistai;19;21;40;4;2;6
109;06.06.2017;2017;06;15;Tiistai;37;53;90;6;10;16
109;06.06.2017;2017;06;16;Tiistai;45;56;101;7;2;9
109;06.06.2017;2017;06;17;Tiistai;34;22;56;8;4;12
109;06.06.2017;2017;06;18;Tiistai;26;18;44;3;2;5
109;06.06.2017;2017;06;19;Tiistai;21;21;42;12;8;20
109;06.06.2017;2017;06;20;Tiistai;12;24;36;7;1;8
109;06.06.2017;2017;06;21;Tiistai;4;9;13;4;1;5
109;06.06.2017;2017;06;22;Tiistai;10;10;20;0;1;1
109;06.06.2017;2017;06;23;Tiistai;1;3;4;0;0;0
109;07.06.2017;2017;06;00;Keskiviikko;1;1;2;0;0;0
109;07.06.2017;2017;06;01;Keskiviikko;0;0;0;0;1;1
109;07.06.2017;2017;06;02;Keskiviikko;2;0;2;0;1;1
109;07.06.2017;2017;06;03;Keskiviikko;0;0;0;0;0;0
109;07.06.2017;2017;06;04;Keskiviikko;0;1;1;1;0;1
109;07.06.2017;2017;06;05;Keskiviikko;8;5;13;0;0;0
109;07.06.2017;2017;06;06;Keskiviikko;44;29;73;5;1;6
109;07.06.2017;2017;06;07;Keskiviikko;107;39;146;5;5;10
109;07.06.2017;2017;06;08;Keskiviikko;53;21;74;2;3;5
109;07.06.2017;2017;06;09;Keskiviikko;29;10;39;2;1;3
109;07.06.2017;2017;06;10;Keskiviikko;7;15;22;3;3;6
109;07.06.2017;2017;06;11;Keskiviikko;23;18;41;6;10;16
109;07.06.2017;2017;06;12;Keskiviikko;33;20;53;4;3;7
109;07.06.2017;2017;06;13;Keskiviikko;39;21;60;5;3;8
109;07.06.2017;2017;06;14;Keskiviikko;35;25;60;4;5;9
109;07.06.2017;2017;06;15;Keskiviikko;44;64;108;7;10;17
109;07.06.2017;2017;06;16;Keskiviikko;69;82;151;5;1;6
109;07.06.2017;2017;06;17;Keskiviikko;36;25;61;2;1;3
109;07.06.2017;2017;06;18;Keskiviikko;29;17;46;6;7;13
109;07.06.2017;2017;06;19;Keskiviikko;21;20;41;5;2;7
109;07.06.2017;2017;06;20;Keskiviikko;16;23;39;9;3;12
109;07.06.2017;2017;06;21;Keskiviikko;11;20;31;3;1;4
109;07.06.2017;2017;06;22;Keskiviikko;11;12;23;0;4;4
109;07.06.2017;2017;06;23;Keskiviikko;2;0;2;0;2;2
109;08.06.2017;2017;06;00;Torstai;1;4;5;2;1;3
109;08.06.2017;2017;06;01;Torstai;0;0;0;0;0;0
109;08.06.2017;2017;06;02;Torstai;0;0;0;0;0;0
109;08.06.2017;2017;06;03;Torstai;1;2;3;0;0;0
109;08.06.2017;2017;06;04;Torstai;0;2;2;2;0;2
109;08.06.2017;2017;06;05;Torstai;5;7;12;1;0;1
109;08.06.2017;2017;06;06;Torstai;38;23;61;3;2;5
109;08.06.2017;2017;06;07;Torstai;91;38;129;3;4;7
109;08.06.2017;2017;06;08;Torstai;50;15;65;3;4;7
109;08.06.2017;2017;06;09;Torstai;21;8;29;0;4;4
109;08.06.2017;2017;06;10;Torstai;15;7;22;1;2;3
109;08.06.2017;2017;06;11;Torstai;14;15;29;2;2;4
109;08.06.2017;2017;06;12;Torstai;39;15;54;4;2;6
109;08.06.2017;2017;06;13;Torstai;28;25;53;6;3;9
109;08.06.2017;2017;06;14;Torstai;24;29;53;5;6;11
109;08.06.2017;2017;06;15;Torstai;44;65;109;2;6;8
109;08.06.2017;2017;06;16;Torstai;39;80;119;5;3;8
109;08.06.2017;2017;06;17;Torstai;46;31;77;3;0;3
109;08.06.2017;2017;06;18;Torstai;13;13;26;3;2;5
109;08.06.2017;2017;06;19;Torstai;28;15;43;8;1;9
109;08.06.2017;2017;06;20;Torstai;18;19;37;2;3;5
109;08.06.2017;2017;06;21;Torstai;13;20;33;4;0;4
109;08.06.2017;2017;06;22;Torstai;8;7;15;2;1;3
109;08.06.2017;2017;06;23;Torstai;4;6;10;1;0;1
109;09.06.2017;2017;06;00;Perjantai;1;6;7;1;0;1
109;09.06.2017;2017;06;01;Perjantai;1;0;1;0;1;1
109;09.06.2017;2017;06;02;Perjantai;0;0;0;0;0;0
109;09.06.2017;2017;06;03;Perjantai;0;0;0;0;0;0
109;09.06.2017;2017;06;04;Perjantai;1;1;2;1;0;1
109;09.06.2017;2017;06;05;Perjantai;6;7;13;0;1;1
109;09.06.2017;2017;06;06;Perjantai;37;14;51;4;1;5
109;09.06.2017;2017;06;07;Perjantai;79;40;119;7;3;10
109;09.06.2017;2017;06;08;Perjantai;53;19;72;3;2;5
109;09.06.2017;2017;06;09;Perjantai;21;12;33;4;4;8
109;09.06.2017;2017;06;10;Perjantai;18;6;24;2;5;7
109;09.06.2017;2017;06;11;Perjantai;15;12;27;3;1;4
109;09.06.2017;2017;06;12;Perjantai;29;24;53;2;4;6
109;09.06.2017;2017;06;13;Perjantai;19;33;52;5;1;6
109;09.06.2017;2017;06;14;Perjantai;29;39;68;5;3;8
109;09.06.2017;2017;06;15;Perjantai;34;53;87;5;4;9
109;09.06.2017;2017;06;16;Perjantai;43;56;99;4;2;6
109;09.06.2017;2017;06;17;Perjantai;27;26;53;1;1;2
109;09.06.2017;2017;06;18;Perjantai;28;22;50;2;2;4
109;09.06.2017;2017;06;19;Perjantai;20;14;34;7;3;10
109;09.06.2017;2017;06;20;Perjantai;24;9;33;5;2;7
109;09.06.2017;2017;06;21;Perjantai;7;20;27;0;3;3
109;09.06.2017;2017;06;22;Perjantai;5;17;22;1;0;1
109;09.06.2017;2017;06;23;Perjantai;7;5;12;0;0;0
109;10.06.2017;2017;06;00;Lauantai;3;10;13;1;0;1
109;10.06.2017;2017;06;01;Lauantai;1;3;4;0;0;0
109;10.06.2017;2017;06;02;Lauantai;2;5;7;0;1;1
109;10.06.2017;2017;06;03;Lauantai;1;1;2;0;0;0
109;10.06.2017;2017;06;04;Lauantai;0;0;0;0;0;0
109;10.06.2017;2017;06;05;Lauantai;1;1;2;3;1;4
109;10.06.2017;2017;06;06;Lauantai;5;0;5;0;0;0
109;10.06.2017;2017;06;07;Lauantai;5;5;10;2;0;2
109;10.06.2017;2017;06;08;Lauantai;6;5;11;0;5;5
109;10.06.2017;2017;06;09;Lauantai;10;4;14;3;4;7
109;10.06.2017;2017;06;10;Lauantai;17;1;18;5;2;7
109;10.06.2017;2017;06;11;Lauantai;13;9;22;2;0;2
109;10.06.2017;2017;06;12;Lauantai;19;8;27;3;4;7
109;10.06.2017;2017;06;13;Lauantai;17;14;31;1;3;4
109;10.06.2017;2017;06;14;Lauantai;14;16;30;7;3;10
109;10.06.2017;2017;06;15;Lauantai;17;25;42;12;5;17
109;10.06.2017;2017;06;16;Lauantai;22;22;44;4;2;6
109;10.06.2017;2017;06;17;Lauantai;10;9;19;7;5;12
109;10.06.2017;2017;06;18;Lauantai;16;11;27;9;6;15
109;10.06.2017;2017;06;19;Lauantai;7;9;16;5;3;8
109;10.06.2017;2017;06;20;Lauantai;13;18;31;2;7;9
109;10.06.2017;2017;06;21;Lauantai;9;6;15;5;2;7
109;10.06.2017;2017;06;22;Lauantai;8;6;14;2;0;2
109;10.06.2017;2017;06;23;Lauantai;4;7;11;0;1;1
109;11.06.2017;2017;06;00;Sunnuntai;2;2;4;0;0;0
109;11.06.2017;2017;06;01;Sunnuntai;3;1;4;1;1;2
109;11.06.2017;2017;06;02;Sunnuntai;0;0;0;0;0;0
109;11.06.2017;2017;06;03;Sunnuntai;0;2;2;0;0;0
109;11.06.2017;2017;06;04;Sunnuntai;0;0;0;0;0;0
109;11.06.2017;2017;06;05;Sunnuntai;1;2;3;0;0;0
109;11.06.2017;2017;06;06;Sunnuntai;2;4;6;2;0;2
109;11.06.2017;2017;06;07;Sunnuntai;2;4;6;3;0;3
109;11.06.2017;2017;06;08;Sunnuntai;3;2;5;3;4;7
109;11.06.2017;2017;06;09;Sunnuntai;15;6;21;1;2;3
109;11.06.2017;2017;06;10;Sunnuntai;18;4;22;7;2;9
109;11.06.2017;2017;06;11;Sunnuntai;13;14;27;4;3;7
109;11.06.2017;2017;06;12;Sunnuntai;24;15;39;6;2;8
109;11.06.2017;2017;06;13;Sunnuntai;21;9;30;8;4;12
109;11.06.2017;2017;06;14;Sunnuntai;11;14;25;2;4;6
109;11.06.2017;2017;06;15;Sunnuntai;18;10;28;5;2;7
109;11.06.2017;2017;06;16;Sunnuntai;18;12;30;5;7;12
109;11.06.2017;2017;06;17;Sunnuntai;11;14;25;1;2;3
109;11.06.2017;2017;06;18;Sunnuntai;16;16;32;7;10;17
109;11.06.2017;2017;06;19;Sunnuntai;17;16;33;6;4;10
109;11.06.2017;2017;06;20;Sunnuntai;7;12;19;3;3;6
109;11.06.2017;2017;06;21;Sunnuntai;6;4;10;2;2;4
109;11.06.2017;2017;06;22;Sunnuntai;6;5;11;0;1;1
109;11.06.2017;2017;06;23;Sunnuntai;1;1;2;2;3;5
109;12.06.2017;2017;06;00;Maanantai;2;0;2;0;0;0
109;12.06.2017;2017;06;01;Maanantai;1;3;4;0;0;0
109;12.06.2017;2017;06;02;Maanantai;0;0;0;0;0;0
109;12.06.2017;2017;06;03;Maanantai;0;0;0;0;0;0
109;12.06.2017;2017;06;04;Maanantai;2;3;5;2;0;2
109;12.06.2017;2017;06;05;Maanantai;5;3;8;1;0;1
109;12.06.2017;2017;06;06;Maanantai;27;27;54;4;1;5
109;12.06.2017;2017;06;07;Maanantai;112;43;155;4;1;5
109;12.06.2017;2017;06;08;Maanantai;44;14;58;3;2;5
109;12.06.2017;2017;06;09;Maanantai;10;4;14;2;1;3
109;12.06.2017;2017;06;10;Maanantai;6;4;10;1;3;4
109;12.06.2017;2017;06;11;Maanantai;10;8;18;4;0;4
109;12.06.2017;2017;06;12;Maanantai;15;9;24;2;0;2
109;12.06.2017;2017;06;13;Maanantai;18;14;32;1;2;3
109;12.06.2017;2017;06;14;Maanantai;20;17;37;8;3;11
109;12.06.2017;2017;06;15;Maanantai;39;53;92;8;5;13
109;12.06.2017;2017;06;16;Maanantai;54;85;139;2;5;7
109;12.06.2017;2017;06;17;Maanantai;13;41;54;10;2;12
109;12.06.2017;2017;06;18;Maanantai;15;23;38;6;3;9
109;12.06.2017;2017;06;19;Maanantai;16;15;31;10;6;16
109;12.06.2017;2017;06;20;Maanantai;19;14;33;9;5;14
109;12.06.2017;2017;06;21;Maanantai;12;11;23;2;3;5
109;12.06.2017;2017;06;22;Maanantai;4;10;14;1;0;1
109;12.06.2017;2017;06;23;Maanantai;2;2;4;0;1;1
109;13.06.2017;2017;06;00;Tiistai;2;0;2;1;1;2
109;13.06.2017;2017;06;01;Tiistai;1;0;1;0;3;3
109;13.06.2017;2017;06;02;Tiistai;0;1;1;0;2;2
109;13.06.2017;2017;06;03;Tiistai;0;0;0;0;0;0
109;13.06.2017;2017;06;04;Tiistai;0;3;3;1;0;1
109;13.06.2017;2017;06;05;Tiistai;6;6;12;1;1;2
109;13.06.2017;2017;06;06;Tiistai;38;23;61;3;2;5
109;13.06.2017;2017;06;07;Tiistai;104;43;147;6;4;10
109;13.06.2017;2017;06;08;Tiistai;63;23;86;6;4;10
109;13.06.2017;2017;06;09;Tiistai;24;8;32;3;2;5
109;13.06.2017;2017;06;10;Tiistai;26;10;36;6;4;10
109;13.06.2017;2017;06;11;Tiistai;15;24;39;2;4;6
109;13.06.2017;2017;06;12;Tiistai;20;12;32;7;3;10
109;13.06.2017;2017;06;13;Tiistai;23;25;48;3;2;5
109;13.06.2017;2017;06;14;Tiistai;23;18;41;2;3;5
109;13.06.2017;2017;06;15;Tiistai;38;79;117;6;3;9
109;13.06.2017;2017;06;16;Tiistai;59;91;150;8;5;13
109;13.06.2017;2017;06;17;Tiistai;28;40;68;7;3;10
109;13.06.2017;2017;06;18;Tiistai;18;16;34;8;2;10
109;13.06.2017;2017;06;19;Tiistai;19;10;29;6;2;8
109;13.06.2017;2017;06;20;Tiistai;12;21;33;6;4;10
109;13.06.2017;2017;06;21;Tiistai;10;16;26;2;1;3
109;13.06.2017;2017;06;22;Tiistai;7;6;13;1;1;2
109;13.06.2017;2017;06;23;Tiistai;3;4;7;0;0;0
109;14.06.2017;2017;06;00;Keskiviikko;2;3;5;0;1;1
109;14.06.2017;2017;06;01;Keskiviikko;0;0;0;1;1;2
109;14.06.2017;2017;06;02;Keskiviikko;1;1;2;0;0;0
109;14.06.2017;2017;06;03;Keskiviikko;1;0;1;0;0;0
109;14.06.2017;2017;06;04;Keskiviikko;0;2;2;1;1;2
109;14.06.2017;2017;06;05;Keskiviikko;5;6;11;0;0;0
109;14.06.2017;2017;06;06;Keskiviikko;37;27;64;1;2;3
109;14.06.2017;2017;06;07;Keskiviikko;85;48;133;6;3;9
109;14.06.2017;2017;06;08;Keskiviikko;55;23;78;4;1;5
109;14.06.2017;2017;06;09;Keskiviikko;25;4;29;2;2;4
109;14.06.2017;2017;06;10;Keskiviikko;20;13;33;4;4;8
109;14.06.2017;2017;06;11;Keskiviikko;21;13;34;4;2;6
109;14.06.2017;2017;06;12;Keskiviikko;18;22;40;3;4;7
109;14.06.2017;2017;06;13;Keskiviikko;15;18;33;5;3;8
109;14.06.2017;2017;06;14;Keskiviikko;31;30;61;10;0;10
109;14.06.2017;2017;06;15;Keskiviikko;35;62;97;9;1;10
109;14.06.2017;2017;06;16;Keskiviikko;52;82;134;6;4;10
109;14.06.2017;2017;06;17;Keskiviikko;32;24;56;8;4;12
109;14.06.2017;2017;06;18;Keskiviikko;28;33;61;6;4;10
109;14.06.2017;2017;06;19;Keskiviikko;18;18;36;6;5;11
109;14.06.2017;2017;06;20;Keskiviikko;12;16;28;5;5;10
109;14.06.2017;2017;06;21;Keskiviikko;8;22;30;3;1;4
109;14.06.2017;2017;06;22;Keskiviikko;12;7;19;1;1;2
109;14.06.2017;2017;06;23;Keskiviikko;4;3;7;3;5;8
109;15.06.2017;2017;06;00;Torstai;1;0;1;0;1;1
109;15.06.2017;2017;06;01;Torstai;1;4;5;0;0;0
109;15.06.2017;2017;06;02;Torstai;2;0;2;0;0;0
109;15.06.2017;2017;06;03;Torstai;1;1;2;0;0;0
109;15.06.2017;2017;06;04;Torstai;1;3;4;1;2;3
109;15.06.2017;2017;06;05;Torstai;7;5;12;0;0;0
109;15.06.2017;2017;06;06;Torstai;36;27;63;7;0;7
109;15.06.2017;2017;06;07;Torstai;100;40;140;6;2;8
109;15.06.2017;2017;06;08;Torstai;61;22;83;3;5;8
109;15.06.2017;2017;06;09;Torstai;18;14;32;4;1;5
109;15.06.2017;2017;06;10;Torstai;19;13;32;4;3;7
109;15.06.2017;2017;06;11;Torstai;14;13;27;2;1;3
109;15.06.2017;2017;06;12;Torstai;29;23;52;4;6;10
109;15.06.2017;2017;06;13;Torstai;16;27;43;6;2;8
109;15.06.2017;2017;06;14;Torstai;29;24;53;5;5;10
109;15.06.2017;2017;06;15;Torstai;49;83;132;3;2;5
109;15.06.2017;2017;06;16;Torstai;57;93;150;4;5;9
109;15.06.2017;2017;06;17;Torstai;34;34;68;2;5;7
109;15.06.2017;2017;06;18;Torstai;30;14;44;7;4;11
109;15.06.2017;2017;06;19;Torstai;23;14;37;3;4;7
109;15.06.2017;2017;06;20;Torstai;24;30;54;3;2;5
109;15.06.2017;2017;06;21;Torstai;4;27;31;2;2;4
109;15.06.2017;2017;06;22;Torstai;7;6;13;0;1;1
109;15.06.2017;2017;06;23;Torstai;4;2;6;2;2;4
109;16.06.2017;2017;06;00;Perjantai;3;1;4;1;0;1
109;16.06.2017;2017;06;01;Perjantai;1;1;2;0;0;0
109;16.06.2017;2017;06;02;Perjantai;2;3;5;1;0;1
109;16.06.2017;2017;06;03;Perjantai;0;3;3;0;1;1
109;16.06.2017;2017;06;04;Perjantai;2;2;4;1;0;1
109;16.06.2017;2017;06;05;Perjantai;6;5;11;0;0;0
109;16.06.2017;2017;06;06;Perjantai;36;17;53;3;2;5
109;16.06.2017;2017;06;07;Perjantai;80;47;127;5;4;9
109;16.06.2017;2017;06;08;Perjantai;48;25;73;3;2;5
109;16.06.2017;2017;06;09;Perjantai;23;8;31;7;3;10
109;16.06.2017;2017;06;10;Perjantai;15;10;25;6;4;10
109;16.06.2017;2017;06;11;Perjantai;20;16;36;2;2;4
109;16.06.2017;2017;06;12;Perjantai;25;19;44;4;2;6
109;16.06.2017;2017;06;13;Perjantai;32;25;57;4;8;12
109;16.06.2017;2017;06;14;Perjantai;31;30;61;6;1;7
109;16.06.2017;2017;06;15;Perjantai;52;54;106;8;3;11
109;16.06.2017;2017;06;16;Perjantai;39;48;87;4;4;8
109;16.06.2017;2017;06;17;Perjantai;32;33;65;5;8;13
109;16.06.2017;2017;06;18;Perjantai;20;14;34;2;1;3
109;16.06.2017;2017;06;19;Perjantai;19;8;27;1;3;4
109;16.06.2017;2017;06;20;Perjantai;18;16;34;5;1;6
109;16.06.2017;2017;06;21;Perjantai;22;16;38;3;3;6
109;16.06.2017;2017;06;22;Perjantai;8;17;25;0;0;0
109;16.06.2017;2017;06;23;Perjantai;8;8;16;0;0;0
109;17.06.2017;2017;06;00;Lauantai;5;3;8;0;3;3
109;17.06.2017;2017;06;01;Lauantai;2;7;9;0;0;0
109;17.06.2017;2017;06;02;Lauantai;8;7;15;0;1;1
109;17.06.2017;2017;06;03;Lauantai;0;3;3;0;0;0
109;17.06.2017;2017;06;04;Lauantai;0;0;0;0;1;1
109;17.06.2017;2017;06;05;Lauantai;0;3;3;1;0;1
109;17.06.2017;2017;06;06;Lauantai;6;0;6;1;1;2
109;17.06.2017;2017;06;07;Lauantai;3;6;9;3;3;6
109;17.06.2017;2017;06;08;Lauantai;5;4;9;2;1;3
109;17.06.2017;2017;06;09;Lauantai;8;9;17;3;3;6
109;17.06.2017;2017;06;10;Lauantai;21;11;32;2;1;3
109;17.06.2017;2017;06;11;Lauantai;21;9;30;3;0;3
109;17.06.2017;2017;06;12;Lauantai;26;10;36;0;3;3
109;17.06.2017;2017;06;13;Lauantai;28;13;41;9;4;13
109;17.06.2017;2017;06;14;Lauantai;21;18;39;5;3;8
109;17.06.2017;2017;06;15;Lauantai;13;25;38;1;3;4
109;17.06.2017;2017;06;16;Lauantai;19;6;25;4;5;9
109;17.06.2017;2017;06;17;Lauantai;16;12;28;4;1;5
109;17.06.2017;2017;06;18;Lauantai;12;16;28;5;6;11
109;17.06.2017;2017;06;19;Lauantai;6;17;23;4;7;11
109;17.06.2017;2017;06;20;Lauantai;11;13;24;6;1;7
109;17.06.2017;2017;06;21;Lauantai;7;15;22;3;2;5
109;17.06.2017;2017;06;22;Lauantai;10;6;16;0;0;0
109;17.06.2017;2017;06;23;Lauantai;3;1;4;1;0;1
109;18.06.2017;2017;06;00;Sunnuntai;11;6;17;0;0;0
109;18.06.2017;2017;06;01;Sunnuntai;3;6;9;1;0;1
109;18.06.2017;2017;06;02;Sunnuntai;0;9;9;0;0;0
109;18.06.2017;2017;06;03;Sunnuntai;1;6;7;0;0;0
109;18.06.2017;2017;06;04;Sunnuntai;0;0;0;0;0;0
109;18.06.2017;2017;06;05;Sunnuntai;2;3;5;0;2;2
109;18.06.2017;2017;06;06;Sunnuntai;3;2;5;1;0;1
109;18.06.2017;2017;06;07;Sunnuntai;0;7;7;2;1;3
109;18.06.2017;2017;06;08;Sunnuntai;2;1;3;0;2;2
109;18.06.2017;2017;06;09;Sunnuntai;2;0;2;2;0;2
109;18.06.2017;2017;06;10;Sunnuntai;1;2;3;4;0;4
109;18.06.2017;2017;06;11;Sunnuntai;5;1;6;2;0;2
109;18.06.2017;2017;06;12;Sunnuntai;9;11;20;6;2;8
109;18.06.2017;2017;06;13;Sunnuntai;20;12;32;6;5;11
109;18.06.2017;2017;06;14;Sunnuntai;14;13;27;4;4;8
109;18.06.2017;2017;06;15;Sunnuntai;15;12;27;4;2;6
109;18.06.2017;2017;06;16;Sunnuntai;20;11;31;6;7;13
109;18.06.2017;2017;06;17;Sunnuntai;11;8;19;2;4;6
109;18.06.2017;2017;06;18;Sunnuntai;12;7;19;6;4;10
109;18.06.2017;2017;06;19;Sunnuntai;8;8;16;8;9;17
109;18.06.2017;2017;06;20;Sunnuntai;11;6;17;7;1;8
109;18.06.2017;2017;06;21;Sunnuntai;0;13;13;3;3;6
109;18.06.2017;2017;06;22;Sunnuntai;3;4;7;1;1;2
109;18.06.2017;2017;06;23;Sunnuntai;0;1;1;0;1;1
109;19.06.2017;2017;06;00;Maanantai;1;1;2;0;1;1
109;19.06.2017;2017;06;01;Maanantai;2;0;2;0;1;1
109;19.06.2017;2017;06;02;Maanantai;0;0;0;0;1;1
109;19.06.2017;2017;06;03;Maanantai;0;0;0;0;0;0
109;19.06.2017;2017;06;04;Maanantai;0;2;2;1;0;1
109;19.06.2017;2017;06;05;Maanantai;6;3;9;2;2;4
109;19.06.2017;2017;06;06;Maanantai;29;20;49;1;2;3
109;19.06.2017;2017;06;07;Maanantai;87;37;124;6;4;10
109;19.06.2017;2017;06;08;Maanantai;49;18;67;7;3;10
109;19.06.2017;2017;06;09;Maanantai;22;19;41;6;2;8
109;19.06.2017;2017;06;10;Maanantai;22;14;36;2;4;6
109;19.06.2017;2017;06;11;Maanantai;18;17;35;2;1;3
109;19.06.2017;2017;06;12;Maanantai;15;13;28;3;8;11
109;19.06.2017;2017;06;13;Maanantai;23;21;44;6;2;8
109;19.06.2017;2017;06;14;Maanantai;24;21;45;2;5;7
109;19.06.2017;2017;06;15;Maanantai;38;60;98;3;3;6
109;19.06.2017;2017;06;16;Maanantai;51;82;133;6;3;9
109;19.06.2017;2017;06;17;Maanantai;25;37;62;7;3;10
109;19.06.2017;2017;06;18;Maanantai;23;21;44;8;7;15
109;19.06.2017;2017;06;19;Maanantai;22;16;38;11;3;14
109;19.06.2017;2017;06;20;Maanantai;11;15;26;2;3;5
109;19.06.2017;2017;06;21;Maanantai;6;14;20;2;2;4
109;19.06.2017;2017;06;22;Maanantai;8;12;20;2;0;2
109;19.06.2017;2017;06;23;Maanantai;4;3;7;1;1;2
109;20.06.2017;2017;06;00;Tiistai;0;2;2;0;1;1
109;20.06.2017;2017;06;01;Tiistai;0;0;0;0;0;0
109;20.06.2017;2017;06;02;Tiistai;1;2;3;0;0;0
109;20.06.2017;2017;06;03;Tiistai;0;1;1;0;0;0
109;20.06.2017;2017;06;04;Tiistai;0;1;1;1;0;1
109;20.06.2017;2017;06;05;Tiistai;3;4;7;1;0;1
109;20.06.2017;2017;06;06;Tiistai;31;22;53;2;1;3
109;20.06.2017;2017;06;07;Tiistai;76;35;111;6;2;8
109;20.06.2017;2017;06;08;Tiistai;60;22;82;2;2;4
109;20.06.2017;2017;06;09;Tiistai;26;18;44;3;4;7
109;20.06.2017;2017;06;10;Tiistai;25;19;44;4;4;8
109;20.06.2017;2017;06;11;Tiistai;17;11;28;2;2;4
109;20.06.2017;2017;06;12;Tiistai;20;11;31;8;5;13
109;20.06.2017;2017;06;13;Tiistai;24;20;44;6;10;16
109;20.06.2017;2017;06;14;Tiistai;28;32;60;6;0;6
109;20.06.2017;2017;06;15;Tiistai;29;60;89;10;3;13
109;20.06.2017;2017;06;16;Tiistai;43;67;110;2;0;2
109;20.06.2017;2017;06;17;Tiistai;45;37;82;2;7;9
109;20.06.2017;2017;06;18;Tiistai;17;28;45;6;2;8
109;20.06.2017;2017;06;19;Tiistai;13;24;37;3;3;6
109;20.06.2017;2017;06;20;Tiistai;14;19;33;3;2;5
109;20.06.2017;2017;06;21;Tiistai;14;11;25;2;2;4
109;20.06.2017;2017;06;22;Tiistai;2;4;6;0;2;2
109;20.06.2017;2017;06;23;Tiistai;1;3;4;2;0;2
109;21.06.2017;2017;06;00;Keskiviikko;2;2;4;0;2;2
109;21.06.2017;2017;06;01;Keskiviikko;0;0;0;0;0;0
109;21.06.2017;2017;06;02;Keskiviikko;2;1;3;0;1;1
109;21.06.2017;2017;06;03;Keskiviikko;0;0;0;0;0;0
109;21.06.2017;2017;06;04;Keskiviikko;0;0;0;1;1;2
109;21.06.2017;2017;06;05;Keskiviikko;6;5;11;0;1;1
109;21.06.2017;2017;06;06;Keskiviikko;36;27;63;2;1;3
109;21.06.2017;2017;06;07;Keskiviikko;86;39;125;2;1;3
109;21.06.2017;2017;06;08;Keskiviikko;48;14;62;2;2;4
109;21.06.2017;2017;06;09;Keskiviikko;14;14;28;1;3;4
109;21.06.2017;2017;06;10;Keskiviikko;16;9;25;2;0;2
109;21.06.2017;2017;06;11;Keskiviikko;12;13;25;6;2;8
109;21.06.2017;2017;06;12;Keskiviikko;17;16;33;4;3;7
109;21.06.2017;2017;06;13;Keskiviikko;14;18;32;2;2;4
109;21.06.2017;2017;06;14;Keskiviikko;21;17;38;3;1;4
109;21.06.2017;2017;06;15;Keskiviikko;30;46;76;1;3;4
109;21.06.2017;2017;06;16;Keskiviikko;38;69;107;3;2;5
109;21.06.2017;2017;06;17;Keskiviikko;12;27;39;3;2;5
109;21.06.2017;2017;06;18;Keskiviikko;12;20;32;2;3;5
109;21.06.2017;2017;06;19;Keskiviikko;8;10;18;5;2;7
109;21.06.2017;2017;06;20;Keskiviikko;3;11;14;2;6;8
109;21.06.2017;2017;06;21;Keskiviikko;8;16;24;3;2;5
109;21.06.2017;2017;06;22;Keskiviikko;2;1;3;4;2;6
109;21.06.2017;2017;06;23;Keskiviikko;4;3;7;1;0;1
109;22.06.2017;2017;06;00;Torstai;1;0;1;0;0;0
109;22.06.2017;2017;06;01;Torstai;1;0;1;1;1;2
109;22.06.2017;2017;06;02;Torstai;0;0;0;0;0;0
109;22.06.2017;2017;06;03;Torstai;0;1;1;0;0;0
109;22.06.2017;2017;06;04;Torstai;2;0;2;1;0;1
109;22.06.2017;2017;06;05;Torstai;4;7;11;0;0;0
109;22.06.2017;2017;06;06;Torstai;16;21;37;4;3;7
109;22.06.2017;2017;06;07;Torstai;56;21;77;3;3;6
109;22.06.2017;2017;06;08;Torstai;32;9;41;2;2;4
109;22.06.2017;2017;06;09;Torstai;17;4;21;2;3;5
109;22.06.2017;2017;06;10;Torstai;14;4;18;0;4;4
109;22.06.2017;2017;06;11;Torstai;13;6;19;0;3;3
109;22.06.2017;2017;06;12;Torstai;22;14;36;2;0;2
109;22.06.2017;2017;06;13;Torstai;13;15;28;0;2;2
109;22.06.2017;2017;06;14;Torstai;26;33;59;2;4;6
109;22.06.2017;2017;06;15;Torstai;18;34;52;6;1;7
109;22.06.2017;2017;06;16;Torstai;23;31;54;8;2;10
109;22.06.2017;2017;06;17;Torstai;6;20;26;2;4;6
109;22.06.2017;2017;06;18;Torstai;5;4;9;1;2;3
109;22.06.2017;2017;06;19;Torstai;6;10;16;3;1;4
109;22.06.2017;2017;06;20;Torstai;4;5;9;1;3;4
109;22.06.2017;2017;06;21;Torstai;3;14;17;2;0;2
109;22.06.2017;2017;06;22;Torstai;3;2;5;2;1;3
109;22.06.2017;2017;06;23;Torstai;5;6;11;0;0;0
109;23.06.2017;2017;06;00;Perjantai;1;2;3;0;4;4
109;23.06.2017;2017;06;01;Perjantai;0;2;2;0;0;0
109;23.06.2017;2017;06;02;Perjantai;2;0;2;0;0;0
109;23.06.2017;2017;06;03;Perjantai;2;0;2;0;0;0
109;23.06.2017;2017;06;04;Perjantai;0;0;0;1;0;1
109;23.06.2017;2017;06;05;Perjantai;0;1;1;1;1;2
109;23.06.2017;2017;06;06;Perjantai;9;0;9;1;1;2
109;23.06.2017;2017;06;07;Perjantai;1;4;5;0;1;1
109;23.06.2017;2017;06;08;Perjantai;6;0;6;1;2;3
109;23.06.2017;2017;06;09;Perjantai;8;3;11;3;2;5
109;23.06.2017;2017;06;10;Perjantai;6;5;11;3;7;10
109;23.06.2017;2017;06;11;Perjantai;8;6;14;1;1;2
109;23.06.2017;2017;06;12;Perjantai;12;6;18;4;3;7
109;23.06.2017;2017;06;13;Perjantai;21;10;31;0;1;1
109;23.06.2017;2017;06;14;Perjantai;12;9;21;9;5;14
109;23.06.2017;2017;06;15;Perjantai;7;7;14;5;4;9
109;23.06.2017;2017;06;16;Perjantai;7;15;22;2;1;3
109;23.06.2017;2017;06;17;Perjantai;12;11;23;2;3;5
109;23.06.2017;2017;06;18;Perjantai;11;2;13;1;5;6
109;23.06.2017;2017;06;19;Perjantai;6;8;14;4;1;5
109;23.06.2017;2017;06;20;Perjantai;13;6;19;1;0;1
109;23.06.2017;2017;06;21;Perjantai;1;4;5;3;0;3
109;23.06.2017;2017;06;22;Perjantai;10;5;15;0;0;0
109;23.06.2017;2017;06;23;Perjantai;0;1;1;0;0;0
109;24.06.2017;2017;06;00;Lauantai;3;6;9;1;3;4
109;24.06.2017;2017;06;01;Lauantai;0;3;3;1;0;1
109;24.06.2017;2017;06;02;Lauantai;0;0;0;0;0;0
109;24.06.2017;2017;06;03;Lauantai;0;4;4;0;0;0
109;24.06.2017;2017;06;04;Lauantai;0;0;0;0;0;0
109;24.06.2017;2017;06;05;Lauantai;0;2;2;0;0;0
109;24.06.2017;2017;06;06;Lauantai;6;1;7;2;2;4
109;24.06.2017;2017;06;07;Lauantai;0;2;2;1;1;2
109;24.06.2017;2017;06;08;Lauantai;5;1;6;1;2;3
109;24.06.2017;2017;06;09;Lauantai;4;0;4;1;2;3
109;24.06.2017;2017;06;10;Lauantai;7;5;12;5;2;7
109;24.06.2017;2017;06;11;Lauantai;15;10;25;1;2;3
109;24.06.2017;2017;06;12;Lauantai;16;6;22;3;2;5
109;24.06.2017;2017;06;13;Lauantai;8;7;15;6;3;9
109;24.06.2017;2017;06;14;Lauantai;17;14;31;3;3;6
109;24.06.2017;2017;06;15;Lauantai;12;12;24;6;5;11
109;24.06.2017;2017;06;16;Lauantai;16;7;23;1;0;1
109;24.06.2017;2017;06;17;Lauantai;10;10;20;2;2;4
109;24.06.2017;2017;06;18;Lauantai;7;9;16;1;2;3
109;24.06.2017;2017;06;19;Lauantai;9;5;14;3;1;4
109;24.06.2017;2017;06;20;Lauantai;8;9;17;5;1;6
109;24.06.2017;2017;06;21;Lauantai;5;7;12;3;4;7
109;24.06.2017;2017;06;22;Lauantai;12;2;14;2;1;3
109;24.06.2017;2017;06;23;Lauantai;1;4;5;1;1;2
109;25.06.2017;2017;06;00;Sunnuntai;2;0;2;0;0;0
109;25.06.2017;2017;06;01;Sunnuntai;2;0;2;0;2;2
109;25.06.2017;2017;06;02;Sunnuntai;0;0;0;0;0;0
109;25.06.2017;2017;06;03;Sunnuntai;0;3;3;0;0;0
109;25.06.2017;2017;06;04;Sunnuntai;1;0;1;0;0;0
109;25.06.2017;2017;06;05;Sunnuntai;0;0;0;0;1;1
109;25.06.2017;2017;06;06;Sunnuntai;3;2;5;3;3;6
109;25.06.2017;2017;06;07;Sunnuntai;2;0;2;3;0;3
109;25.06.2017;2017;06;08;Sunnuntai;4;4;8;0;1;1
109;25.06.2017;2017;06;09;Sunnuntai;3;3;6;1;2;3
109;25.06.2017;2017;06;10;Sunnuntai;12;5;17;10;5;15
109;25.06.2017;2017;06;11;Sunnuntai;5;4;9;2;2;4
109;25.06.2017;2017;06;12;Sunnuntai;2;4;6;2;2;4
109;25.06.2017;2017;06;13;Sunnuntai;5;4;9;1;2;3
109;25.06.2017;2017;06;14;Sunnuntai;5;2;7;2;0;2
109;25.06.2017;2017;06;15;Sunnuntai;5;4;9;2;0;2
109;25.06.2017;2017;06;16;Sunnuntai;3;3;6;1;0;1
109;25.06.2017;2017;06;17;Sunnuntai;1;3;4;1;0;1
109;25.06.2017;2017;06;18;Sunnuntai;12;9;21;6;0;6
109;25.06.2017;2017;06;19;Sunnuntai;11;4;15;9;4;13
109;25.06.2017;2017;06;20;Sunnuntai;8;7;15;4;5;9
109;25.06.2017;2017;06;21;Sunnuntai;1;3;4;1;0;1
109;25.06.2017;2017;06;22;Sunnuntai;3;2;5;0;0;0
109;25.06.2017;2017;06;23;Sunnuntai;3;1;4;1;0;1
109;26.06.2017;2017;06;00;Maanantai;0;1;1;1;0;1
109;26.06.2017;2017;06;01;Maanantai;0;3;3;0;1;1
109;26.06.2017;2017;06;02;Maanantai;0;0;0;0;0;0
109;26.06.2017;2017;06;03;Maanantai;0;1;1;0;0;0
109;26.06.2017;2017;06;04;Maanantai;1;0;1;1;0;1
109;26.06.2017;2017;06;05;Maanantai;2;3;5;0;0;0
109;26.06.2017;2017;06;06;Maanantai;16;13;29;3;0;3
109;26.06.2017;2017;06;07;Maanantai;49;23;72;3;3;6
109;26.06.2017;2017;06;08;Maanantai;23;10;33;3;3;6
109;26.06.2017;2017;06;09;Maanantai;16;12;28;3;2;5
109;26.06.2017;2017;06;10;Maanantai;10;4;14;2;0;2
109;26.06.2017;2017;06;11;Maanantai;8;9;17;2;1;3
109;26.06.2017;2017;06;12;Maanantai;6;7;13;1;1;2
109;26.06.2017;2017;06;13;Maanantai;14;13;27;2;1;3
109;26.06.2017;2017;06;14;Maanantai;13;13;26;5;3;8
109;26.06.2017;2017;06;15;Maanantai;34;28;62;8;2;10
109;26.06.2017;2017;06;16;Maanantai;27;53;80;6;3;9
109;26.06.2017;2017;06;17;Maanantai;20;25;45;4;5;9
109;26.06.2017;2017;06;18;Maanantai;19;19;38;10;8;18
109;26.06.2017;2017;06;19;Maanantai;12;16;28;6;8;14
109;26.06.2017;2017;06;20;Maanantai;14;12;26;9;7;16
109;26.06.2017;2017;06;21;Maanantai;12;7;19;1;6;7
109;26.06.2017;2017;06;22;Maanantai;7;9;16;2;1;3
109;26.06.2017;2017;06;23;Maanantai;2;3;5;0;0;0
109;27.06.2017;2017;06;00;Tiistai;3;3;6;0;1;1
109;27.06.2017;2017;06;01;Tiistai;0;3;3;1;1;2
109;27.06.2017;2017;06;02;Tiistai;1;0;1;0;1;1
109;27.06.2017;2017;06;03;Tiistai;0;0;0;0;0;0
109;27.06.2017;2017;06;04;Tiistai;0;2;2;1;0;1
109;27.06.2017;2017;06;05;Tiistai;3;7;10;1;1;2
109;27.06.2017;2017;06;06;Tiistai;25;15;40;3;1;4
109;27.06.2017;2017;06;07;Tiistai;68;36;104;5;1;6
109;27.06.2017;2017;06;08;Tiistai;37;21;58;1;4;5
109;27.06.2017;2017;06;09;Tiistai;14;5;19;5;3;8
109;27.06.2017;2017;06;10;Tiistai;23;9;32;5;3;8
109;27.06.2017;2017;06;11;Tiistai;13;12;25;5;4;9
109;27.06.2017;2017;06;12;Tiistai;18;15;33;1;2;3
109;27.06.2017;2017;06;13;Tiistai;22;15;37;0;1;1
109;27.06.2017;2017;06;14;Tiistai;21;18;39;3;7;10
109;27.06.2017;2017;06;15;Tiistai;36;51;87;7;3;10
109;27.06.2017;2017;06;16;Tiistai;37;55;92;1;2;3
109;27.06.2017;2017;06;17;Tiistai;34;24;58;5;5;10
109;27.06.2017;2017;06;18;Tiistai;15;18;33;6;4;10
109;27.06.2017;2017;06;19;Tiistai;14;25;39;6;10;16
109;27.06.2017;2017;06;20;Tiistai;14;12;26;5;6;11
109;27.06.2017;2017;06;21;Tiistai;3;10;13;3;0;3
109;27.06.2017;2017;06;22;Tiistai;5;5;10;0;2;2
109;27.06.2017;2017;06;23;Tiistai;3;2;5;4;1;5
109;28.06.2017;2017;06;00;Keskiviikko;1;1;2;1;0;1
109;28.06.2017;2017;06;01;Keskiviikko;4;1;5;0;1;1
109;28.06.2017;2017;06;02;Keskiviikko;0;0;0;0;0;0
109;28.06.2017;2017;06;03;Keskiviikko;1;0;1;0;0;0
109;28.06.2017;2017;06;04;Keskiviikko;1;1;2;0;0;0
109;28.06.2017;2017;06;05;Keskiviikko;3;8;11;1;0;1
109;28.06.2017;2017;06;06;Keskiviikko;23;22;45;1;2;3
109;28.06.2017;2017;06;07;Keskiviikko;68;31;99;1;3;4
109;28.06.2017;2017;06;08;Keskiviikko;35;18;53;1;4;5
109;28.06.2017;2017;06;09;Keskiviikko;7;7;14;1;5;6
109;28.06.2017;2017;06;10;Keskiviikko;12;3;15;1;5;6
109;28.06.2017;2017;06;11;Keskiviikko;8;8;16;8;0;8
109;28.06.2017;2017;06;12;Keskiviikko;11;8;19;1;1;2
109;28.06.2017;2017;06;13;Keskiviikko;14;15;29;0;0;0
109;28.06.2017;2017;06;14;Keskiviikko;11;12;23;4;3;7
109;28.06.2017;2017;06;15;Keskiviikko;28;33;61;5;0;5
109;28.06.2017;2017;06;16;Keskiviikko;31;63;94;8;5;13
109;28.06.2017;2017;06;17;Keskiviikko;25;30;55;3;5;8
109;28.06.2017;2017;06;18;Keskiviikko;21;25;46;7;2;9
109;28.06.2017;2017;06;19;Keskiviikko;14;20;34;4;4;8
109;28.06.2017;2017;06;20;Keskiviikko;21;20;41;8;7;15
109;28.06.2017;2017;06;21;Keskiviikko;10;8;18;0;1;1
109;28.06.2017;2017;06;22;Keskiviikko;7;4;11;2;0;2
109;28.06.2017;2017;06;23;Keskiviikko;1;0;1;0;0;0
109;29.06.2017;2017;06;00;Torstai;0;3;3;0;1;1
109;29.06.2017;2017;06;01;Torstai;3;1;4;0;0;0
109;29.06.2017;2017;06;02;Torstai;0;0;0;0;0;0
109;29.06.2017;2017;06;03;Torstai;0;0;0;0;0;0
109;29.06.2017;2017;06;04;Torstai;0;0;0;1;1;2
109;29.06.2017;2017;06;05;Torstai;2;10;12;1;1;2
109;29.06.2017;2017;06;06;Torstai;14;16;30;3;1;4
109;29.06.2017;2017;06;07;Torstai;74;35;109;2;1;3
109;29.06.2017;2017;06;08;Torstai;36;21;57;3;1;4
109;29.06.2017;2017;06;09;Torstai;23;8;31;5;6;11
109;29.06.2017;2017;06;10;Torstai;23;10;33;0;1;1
109;29.06.2017;2017;06;11;Torstai;16;16;32;5;2;7
109;29.06.2017;2017;06;12;Torstai;36;14;50;4;2;6
109;29.06.2017;2017;06;13;Torstai;22;22;44;6;0;6
109;29.06.2017;2017;06;14;Torstai;38;26;64;3;3;6
109;29.06.2017;2017;06;15;Torstai;39;51;90;5;2;7
109;29.06.2017;2017;06;16;Torstai;27;55;82;4;4;8
109;29.06.2017;2017;06;17;Torstai;30;28;58;7;5;12
109;29.06.2017;2017;06;18;Torstai;17;24;41;6;5;11
109;29.06.2017;2017;06;19;Torstai;12;17;29;5;1;6
109;29.06.2017;2017;06;20;Torstai;10;10;20;4;9;13
109;29.06.2017;2017;06;21;Torstai;7;18;25;1;0;1
109;29.06.2017;2017;06;22;Torstai;6;8;14;3;2;5
109;29.06.2017;2017;06;23;Torstai;3;0;3;0;0;0
109;30.06.2017;2017;06;00;Perjantai;0;2;2;0;1;1
109;30.06.2017;2017;06;01;Perjantai;1;0;1;1;2;3
109;30.06.2017;2017;06;02;Perjantai;1;0;1;0;0;0
109;30.06.2017;2017;06;03;Perjantai;0;1;1;0;0;0
109;30.06.2017;2017;06;04;Perjantai;0;4;4;1;0;1
109;30.06.2017;2017;06;05;Perjantai;2;5;7;0;4;4
109;30.06.2017;2017;06;06;Perjantai;25;13;38;1;2;3
109;30.06.2017;2017;06;07;Perjantai;71;31;102;3;5;8
109;30.06.2017;2017;06;08;Perjantai;31;18;49;2;6;8
109;30.06.2017;2017;06;09;Perjantai;22;9;31;6;3;9
109;30.06.2017;2017;06;10;Perjantai;24;11;35;5;1;6
109;30.06.2017;2017;06;11;Perjantai;24;5;29;2;6;8
109;30.06.2017;2017;06;12;Perjantai;23;13;36;2;0;2
109;30.06.2017;2017;06;13;Perjantai;20;14;34;6;7;13
109;30.06.2017;2017;06;14;Perjantai;34;27;61;15;1;16
109;30.06.2017;2017;06;15;Perjantai;34;48;82;11;6;17
109;30.06.2017;2017;06;16;Perjantai;32;35;67;4;0;4
109;30.06.2017;2017;06;17;Perjantai;23;29;52;5;1;6
109;30.06.2017;2017;06;18;Perjantai;22;15;37;5;6;11
109;30.06.2017;2017;06;19;Perjantai;22;11;33;4;1;5
109;30.06.2017;2017;06;20;Perjantai;15;13;28;3;2;5
109;30.06.2017;2017;06;21;Perjantai;6;12;18;2;1;3
109;30.06.2017;2017;06;22;Perjantai;5;7;12;3;1;4
109;30.06.2017;2017;06;23;Perjantai;7;6;13;0;0;0
109;01.07.2017;2017;07;00;Lauantai;0;1;1;1;1;2
109;01.07.2017;2017;07;01;Lauantai;0;4;4;1;0;1
109;01.07.2017;2017;07;02;Lauantai;0;3;3;0;0;0
109;01.07.2017;2017;07;03;Lauantai;0;3;3;0;0;0
109;01.07.2017;2017;07;04;Lauantai;0;0;0;0;0;0
109;01.07.2017;2017;07;05;Lauantai;1;1;2;1;0;1
109;01.07.2017;2017;07;06;Lauantai;5;2;7;1;0;1
109;01.07.2017;2017;07;07;Lauantai;0;4;4;2;2;4
109;01.07.2017;2017;07;08;Lauantai;4;3;7;2;4;6
109;01.07.2017;2017;07;09;Lauantai;17;5;22;6;1;7
109;01.07.2017;2017;07;10;Lauantai;28;7;35;5;0;5
109;01.07.2017;2017;07;11;Lauantai;6;9;15;7;4;11
109;01.07.2017;2017;07;12;Lauantai;19;10;29;0;2;2
109;01.07.2017;2017;07;13;Lauantai;20;18;38;2;4;6
109;01.07.2017;2017;07;14;Lauantai;18;21;39;3;3;6
109;01.07.2017;2017;07;15;Lauantai;18;16;34;8;2;10
109;01.07.2017;2017;07;16;Lauantai;21;16;37;0;4;4
109;01.07.2017;2017;07;17;Lauantai;25;12;37;28;7;35
109;01.07.2017;2017;07;18;Lauantai;25;17;42;2;4;6
109;01.07.2017;2017;07;19;Lauantai;18;12;30;3;4;7
109;01.07.2017;2017;07;20;Lauantai;13;9;22;1;3;4
109;01.07.2017;2017;07;21;Lauantai;10;6;16;2;2;4
109;01.07.2017;2017;07;22;Lauantai;11;9;20;3;0;3
109;01.07.2017;2017;07;23;Lauantai;7;8;15;0;0;0
109;02.07.2017;2017;07;00;Sunnuntai;13;3;16;0;1;1
109;02.07.2017;2017;07;01;Sunnuntai;4;5;9;1;0;1
109;02.07.2017;2017;07;02;Sunnuntai;1;1;2;0;0;0
109;02.07.2017;2017;07;03;Sunnuntai;1;6;7;0;0;0
109;02.07.2017;2017;07;04;Sunnuntai;0;3;3;0;0;0
109;02.07.2017;2017;07;05;Sunnuntai;2;4;6;0;0;0
109;02.07.2017;2017;07;06;Sunnuntai;5;2;7;2;0;2
109;02.07.2017;2017;07;07;Sunnuntai;3;4;7;3;1;4
109;02.07.2017;2017;07;08;Sunnuntai;1;4;5;0;4;4
109;02.07.2017;2017;07;09;Sunnuntai;6;2;8;1;3;4
109;02.07.2017;2017;07;10;Sunnuntai;15;6;21;8;8;16
109;02.07.2017;2017;07;11;Sunnuntai;19;10;29;6;5;11
109;02.07.2017;2017;07;12;Sunnuntai;20;14;34;8;2;10
109;02.07.2017;2017;07;13;Sunnuntai;37;15;52;1;1;2
109;02.07.2017;2017;07;14;Sunnuntai;20;13;33;2;0;2
109;02.07.2017;2017;07;15;Sunnuntai;25;14;39;14;6;20
109;02.07.2017;2017;07;16;Sunnuntai;22;8;30;2;5;7
109;02.07.2017;2017;07;17;Sunnuntai;14;14;28;5;1;6
109;02.07.2017;2017;07;18;Sunnuntai;22;10;32;8;1;9
109;02.07.2017;2017;07;19;Sunnuntai;15;7;22;5;3;8
109;02.07.2017;2017;07;20;Sunnuntai;12;9;21;2;0;2
109;02.07.2017;2017;07;21;Sunnuntai;13;12;25;2;0;2
109;02.07.2017;2017;07;22;Sunnuntai;4;2;6;3;0;3
109;02.07.2017;2017;07;23;Sunnuntai;4;2;6;1;2;3
109;03.07.2017;2017;07;00;Maanantai;3;3;6;0;1;1
109;03.07.2017;2017;07;01;Maanantai;0;1;1;1;1;2
109;03.07.2017;2017;07;02;Maanantai;0;0;0;0;0;0
109;03.07.2017;2017;07;03;Maanantai;0;0;0;0;0;0
109;03.07.2017;2017;07;04;Maanantai;0;2;2;1;0;1
109;03.07.2017;2017;07;05;Maanantai;4;9;13;0;0;0
109;03.07.2017;2017;07;06;Maanantai;33;18;51;0;0;0
109;03.07.2017;2017;07;07;Maanantai;52;43;95;5;4;9
109;03.07.2017;2017;07;08;Maanantai;43;26;69;3;4;7
109;03.07.2017;2017;07;09;Maanantai;22;7;29;3;0;3
109;03.07.2017;2017;07;10;Maanantai;35;11;46;2;2;4
109;03.07.2017;2017;07;11;Maanantai;23;9;32;3;1;4
109;03.07.2017;2017;07;12;Maanantai;23;12;35;1;0;1
109;03.07.2017;2017;07;13;Maanantai;28;14;42;6;0;6
109;03.07.2017;2017;07;14;Maanantai;25;13;38;1;6;7
109;03.07.2017;2017;07;15;Maanantai;37;30;67;10;4;14
109;03.07.2017;2017;07;16;Maanantai;43;34;77;4;4;8
109;03.07.2017;2017;07;17;Maanantai;31;23;54;12;1;13
109;03.07.2017;2017;07;18;Maanantai;10;25;35;7;4;11
109;03.07.2017;2017;07;19;Maanantai;22;9;31;7;5;12
109;03.07.2017;2017;07;20;Maanantai;11;15;26;10;7;17
109;03.07.2017;2017;07;21;Maanantai;6;9;15;3;1;4
109;03.07.2017;2017;07;22;Maanantai;4;1;5;6;1;7
109;03.07.2017;2017;07;23;Maanantai;2;0;2;1;0;1
109;04.07.2017;2017;07;00;Tiistai;4;3;7;0;2;2
109;04.07.2017;2017;07;01;Tiistai;0;1;1;1;0;1
109;04.07.2017;2017;07;02;Tiistai;0;1;1;0;0;0
109;04.07.2017;2017;07;03;Tiistai;1;0;1;0;0;0
109;04.07.2017;2017;07;04;Tiistai;0;1;1;1;0;1
109;04.07.2017;2017;07;05;Tiistai;4;8;12;0;2;2
109;04.07.2017;2017;07;06;Tiistai;20;17;37;3;0;3
109;04.07.2017;2017;07;07;Tiistai;40;21;61;3;4;7
109;04.07.2017;2017;07;08;Tiistai;22;13;35;0;3;3
109;04.07.2017;2017;07;09;Tiistai;14;9;23;6;3;9
109;04.07.2017;2017;07;10;Tiistai;17;10;27;8;5;13
109;04.07.2017;2017;07;11;Tiistai;21;6;27;2;2;4
109;04.07.2017;2017;07;12;Tiistai;9;7;16;0;1;1
109;04.07.2017;2017;07;13;Tiistai;12;11;23;1;1;2
109;04.07.2017;2017;07;14;Tiistai;14;8;22;5;0;5
109;04.07.2017;2017;07;15;Tiistai;24;30;54;5;5;10
109;04.07.2017;2017;07;16;Tiistai;29;32;61;3;1;4
109;04.07.2017;2017;07;17;Tiistai;20;17;37;4;1;5
109;04.07.2017;2017;07;18;Tiistai;15;8;23;5;3;8
109;04.07.2017;2017;07;19;Tiistai;13;24;37;7;6;13
109;04.07.2017;2017;07;20;Tiistai;12;9;21;12;2;14
109;04.07.2017;2017;07;21;Tiistai;7;4;11;8;2;10
109;04.07.2017;2017;07;22;Tiistai;5;0;5;3;3;6
109;04.07.2017;2017;07;23;Tiistai;2;2;4;2;1;3
109;05.07.2017;2017;07;00;Keskiviikko;1;2;3;0;0;0
109;05.07.2017;2017;07;01;Keskiviikko;1;1;2;0;0;0
109;05.07.2017;2017;07;02;Keskiviikko;3;0;3;0;0;0
109;05.07.2017;2017;07;03;Keskiviikko;0;0;0;0;0;0
109;05.07.2017;2017;07;04;Keskiviikko;2;0;2;1;0;1
109;05.07.2017;2017;07;05;Keskiviikko;1;8;9;0;0;0
109;05.07.2017;2017;07;06;Keskiviikko;18;19;37;1;1;2
109;05.07.2017;2017;07;07;Keskiviikko;32;22;54;6;5;11
109;05.07.2017;2017;07;08;Keskiviikko;19;13;32;3;4;7
109;05.07.2017;2017;07;09;Keskiviikko;15;7;22;0;4;4
109;05.07.2017;2017;07;10;Keskiviikko;15;4;19;7;2;9
109;05.07.2017;2017;07;11;Keskiviikko;10;4;14;2;2;4
109;05.07.2017;2017;07;12;Keskiviikko;19;9;28;3;2;5
109;05.07.2017;2017;07;13;Keskiviikko;13;10;23;2;3;5
109;05.07.2017;2017;07;14;Keskiviikko;20;9;29;9;2;11
109;05.07.2017;2017;07;15;Keskiviikko;28;31;59;5;3;8
109;05.07.2017;2017;07;16;Keskiviikko;39;32;71;5;3;8
109;05.07.2017;2017;07;17;Keskiviikko;31;21;52;4;3;7
109;05.07.2017;2017;07;18;Keskiviikko;14;14;28;2;3;5
109;05.07.2017;2017;07;19;Keskiviikko;9;11;20;6;5;11
109;05.07.2017;2017;07;20;Keskiviikko;6;9;15;3;3;6
109;05.07.2017;2017;07;21;Keskiviikko;6;5;11;2;1;3
109;05.07.2017;2017;07;22;Keskiviikko;3;2;5;1;1;2
109;05.07.2017;2017;07;23;Keskiviikko;1;6;7;0;0;0
109;06.07.2017;2017;07;00;Torstai;1;0;1;0;0;0
109;06.07.2017;2017;07;01;Torstai;1;0;1;0;0;0
109;06.07.2017;2017;07;02;Torstai;0;0;0;0;0;0
109;06.07.2017;2017;07;03;Torstai;1;0;1;0;0;0
109;06.07.2017;2017;07;04;Torstai;1;0;1;1;1;2
109;06.07.2017;2017;07;05;Torstai;6;6;12;0;0;0
109;06.07.2017;2017;07;06;Torstai;19;16;35;0;2;2
109;06.07.2017;2017;07;07;Torstai;30;18;48;1;3;4
109;06.07.2017;2017;07;08;Torstai;18;5;23;2;2;4
109;06.07.2017;2017;07;09;Torstai;6;6;12;1;3;4
109;06.07.2017;2017;07;10;Torstai;4;2;6;2;2;4
109;06.07.2017;2017;07;11;Torstai;6;4;10;3;1;4
109;06.07.2017;2017;07;12;Torstai;11;4;15;5;1;6
109;06.07.2017;2017;07;13;Torstai;11;9;20;3;6;9
109;06.07.2017;2017;07;14;Torstai;11;11;22;5;3;8
109;06.07.2017;2017;07;15;Torstai;17;18;35;4;4;8
109;06.07.2017;2017;07;16;Torstai;22;20;42;2;5;7
109;06.07.2017;2017;07;17;Torstai;15;9;24;8;2;10
109;06.07.2017;2017;07;18;Torstai;12;9;21;8;5;13
109;06.07.2017;2017;07;19;Torstai;11;9;20;8;3;11
109;06.07.2017;2017;07;20;Torstai;6;6;12;4;3;7
109;06.07.2017;2017;07;21;Torstai;3;5;8;2;4;6
109;06.07.2017;2017;07;22;Torstai;6;2;8;3;0;3
109;06.07.2017;2017;07;23;Torstai;2;3;5;0;0;0
109;07.07.2017;2017;07;00;Perjantai;2;0;2;0;0;0
109;07.07.2017;2017;07;01;Perjantai;0;0;0;0;1;1
109;07.07.2017;2017;07;02;Perjantai;1;0;1;0;0;0
109;07.07.2017;2017;07;03;Perjantai;0;1;1;0;0;0
109;07.07.2017;2017;07;04;Perjantai;1;0;1;0;0;0
109;07.07.2017;2017;07;05;Perjantai;5;5;10;0;0;0
109;07.07.2017;2017;07;06;Perjantai;22;8;30;3;0;3
109;07.07.2017;2017;07;07;Perjantai;45;21;66;1;2;3
109;07.07.2017;2017;07;08;Perjantai;21;9;30;4;2;6
109;07.07.2017;2017;07;09;Perjantai;16;5;21;5;3;8
109;07.07.2017;2017;07;10;Perjantai;21;8;29;6;2;8
109;07.07.2017;2017;07;11;Perjantai;18;12;30;3;3;6
109;07.07.2017;2017;07;12;Perjantai;24;9;33;2;1;3
109;07.07.2017;2017;07;13;Perjantai;20;19;39;1;5;6
109;07.07.2017;2017;07;14;Perjantai;24;14;38;0;1;1
109;07.07.2017;2017;07;15;Perjantai;43;26;69;5;4;9
109;07.07.2017;2017;07;16;Perjantai;20;24;44;4;1;5
109;07.07.2017;2017;07;17;Perjantai;12;14;26;2;2;4
109;07.07.2017;2017;07;18;Perjantai;26;7;33;1;3;4
109;07.07.2017;2017;07;19;Perjantai;19;20;39;8;2;10
109;07.07.2017;2017;07;20;Perjantai;7;14;21;3;3;6
109;07.07.2017;2017;07;21;Perjantai;9;8;17;2;0;2
109;07.07.2017;2017;07;22;Perjantai;10;5;15;3;0;3
109;07.07.2017;2017;07;23;Perjantai;7;2;9;0;0;0
109;08.07.2017;2017;07;00;Lauantai;0;7;7;0;0;0
109;08.07.2017;2017;07;01;Lauantai;6;1;7;1;0;1
109;08.07.2017;2017;07;02;Lauantai;0;2;2;1;0;1
109;08.07.2017;2017;07;03;Lauantai;3;5;8;0;0;0
109;08.07.2017;2017;07;04;Lauantai;1;7;8;0;0;0
109;08.07.2017;2017;07;05;Lauantai;0;0;0;0;0;0
109;08.07.2017;2017;07;06;Lauantai;6;4;10;2;0;2
109;08.07.2017;2017;07;07;Lauantai;6;3;9;1;3;4
109;08.07.2017;2017;07;08;Lauantai;6;2;8;2;2;4
109;08.07.2017;2017;07;09;Lauantai;13;4;17;5;3;8
109;08.07.2017;2017;07;10;Lauantai;24;10;34;6;4;10
109;08.07.2017;2017;07;11;Lauantai;32;6;38;4;1;5
109;08.07.2017;2017;07;12;Lauantai;17;8;25;1;2;3
109;08.07.2017;2017;07;13;Lauantai;24;14;38;5;2;7
109;08.07.2017;2017;07;14;Lauantai;23;8;31;4;3;7
109;08.07.2017;2017;07;15;Lauantai;13;25;38;6;4;10
109;08.07.2017;2017;07;16;Lauantai;18;18;36;8;4;12
109;08.07.2017;2017;07;17;Lauantai;22;15;37;3;4;7
109;08.07.2017;2017;07;18;Lauantai;39;20;59;9;7;16
109;08.07.2017;2017;07;19;Lauantai;15;11;26;7;3;10
109;08.07.2017;2017;07;20;Lauantai;12;8;20;3;3;6
109;08.07.2017;2017;07;21;Lauantai;11;7;18;8;1;9
109;08.07.2017;2017;07;22;Lauantai;8;4;12;1;0;1
109;08.07.2017;2017;07;23;Lauantai;3;4;7;0;0;0
109;09.07.2017;2017;07;00;Sunnuntai;3;10;13;0;1;1
109;09.07.2017;2017;07;01;Sunnuntai;2;5;7;2;1;3
109;09.07.2017;2017;07;02;Sunnuntai;0;0;0;0;1;1
109;09.07.2017;2017;07;03;Sunnuntai;1;3;4;1;1;2
109;09.07.2017;2017;07;04;Sunnuntai;0;1;1;0;0;0
109;09.07.2017;2017;07;05;Sunnuntai;2;0;2;0;0;0
109;09.07.2017;2017;07;06;Sunnuntai;4;1;5;1;0;1
109;09.07.2017;2017;07;07;Sunnuntai;2;1;3;1;1;2
109;09.07.2017;2017;07;08;Sunnuntai;2;3;5;1;1;2
109;09.07.2017;2017;07;09;Sunnuntai;8;2;10;2;2;4
109;09.07.2017;2017;07;10;Sunnuntai;12;7;19;7;5;12
109;09.07.2017;2017;07;11;Sunnuntai;10;4;14;6;3;9
109;09.07.2017;2017;07;12;Sunnuntai;13;8;21;5;4;9
109;09.07.2017;2017;07;13;Sunnuntai;21;5;26;3;2;5
109;09.07.2017;2017;07;14;Sunnuntai;22;16;38;6;4;10
109;09.07.2017;2017;07;15;Sunnuntai;16;19;35;4;1;5
109;09.07.2017;2017;07;16;Sunnuntai;18;7;25;3;1;4
109;09.07.2017;2017;07;17;Sunnuntai;19;19;38;6;5;11
109;09.07.2017;2017;07;18;Sunnuntai;26;13;39;7;3;10
109;09.07.2017;2017;07;19;Sunnuntai;15;13;28;7;1;8
109;09.07.2017;2017;07;20;Sunnuntai;12;10;22;7;6;13
109;09.07.2017;2017;07;21;Sunnuntai;12;13;25;5;3;8
109;09.07.2017;2017;07;22;Sunnuntai;5;4;9;1;0;1
109;09.07.2017;2017;07;23;Sunnuntai;2;3;5;1;0;1
109;10.07.2017;2017;07;00;Maanantai;1;1;2;0;1;1
109;10.07.2017;2017;07;01;Maanantai;0;0;0;2;0;2
109;10.07.2017;2017;07;02;Maanantai;3;1;4;0;0;0
109;10.07.2017;2017;07;03;Maanantai;0;0;0;0;0;0
109;10.07.2017;2017;07;04;Maanantai;3;1;4;0;0;0
109;10.07.2017;2017;07;05;Maanantai;6;8;14;1;0;1
109;10.07.2017;2017;07;06;Maanantai;20;17;37;6;0;6
109;10.07.2017;2017;07;07;Maanantai;43;22;65;3;2;5
109;10.07.2017;2017;07;08;Maanantai;28;14;42;4;5;9
109;10.07.2017;2017;07;09;Maanantai;21;6;27;7;1;8
109;10.07.2017;2017;07;10;Maanantai;20;7;27;2;2;4
109;10.07.2017;2017;07;11;Maanantai;21;12;33;4;2;6
109;10.07.2017;2017;07;12;Maanantai;17;10;27;6;2;8
109;10.07.2017;2017;07;13;Maanantai;28;17;45;3;5;8
109;10.07.2017;2017;07;14;Maanantai;19;16;35;3;7;10
109;10.07.2017;2017;07;15;Maanantai;32;42;74;3;0;3
109;10.07.2017;2017;07;16;Maanantai;38;41;79;3;3;6
109;10.07.2017;2017;07;17;Maanantai;17;19;36;3;5;8
109;10.07.2017;2017;07;18;Maanantai;20;12;32;4;3;7
109;10.07.2017;2017;07;19;Maanantai;12;11;23;3;6;9
109;10.07.2017;2017;07;20;Maanantai;7;13;20;14;8;22
109;10.07.2017;2017;07;21;Maanantai;10;10;20;4;0;4
109;10.07.2017;2017;07;22;Maanantai;1;4;5;1;2;3
109;10.07.2017;2017;07;23;Maanantai;1;4;5;1;1;2
109;11.07.2017;2017;07;00;Tiistai;4;0;4;3;1;4
109;11.07.2017;2017;07;01;Tiistai;0;0;0;1;3;4
109;11.07.2017;2017;07;02;Tiistai;1;0;1;0;0;0
109;11.07.2017;2017;07;03;Tiistai;0;1;1;1;0;1
109;11.07.2017;2017;07;04;Tiistai;0;3;3;1;0;1
109;11.07.2017;2017;07;05;Tiistai;4;9;13;1;0;1
109;11.07.2017;2017;07;06;Tiistai;21;19;40;4;0;4
109;11.07.2017;2017;07;07;Tiistai;38;21;59;1;0;1
109;11.07.2017;2017;07;08;Tiistai;16;13;29;1;2;3
109;11.07.2017;2017;07;09;Tiistai;16;7;23;5;5;10
109;11.07.2017;2017;07;10;Tiistai;21;8;29;4;2;6
109;11.07.2017;2017;07;11;Tiistai;20;7;27;3;4;7
109;11.07.2017;2017;07;12;Tiistai;20;12;32;6;4;10
109;11.07.2017;2017;07;13;Tiistai;21;13;34;4;1;5
109;11.07.2017;2017;07;14;Tiistai;26;20;46;4;4;8
109;11.07.2017;2017;07;15;Tiistai;45;27;72;11;3;14
109;11.07.2017;2017;07;16;Tiistai;35;43;78;7;2;9
109;11.07.2017;2017;07;17;Tiistai;25;24;49;4;1;5
109;11.07.2017;2017;07;18;Tiistai;16;17;33;3;0;3
109;11.07.2017;2017;07;19;Tiistai;17;13;30;5;8;13
109;11.07.2017;2017;07;20;Tiistai;7;15;22;4;7;11
109;11.07.2017;2017;07;21;Tiistai;9;3;12;1;1;2
109;11.07.2017;2017;07;22;Tiistai;1;0;1;1;1;2
109;11.07.2017;2017;07;23;Tiistai;2;2;4;0;0;0
109;12.07.2017;2017;07;00;Keskiviikko;3;0;3;0;1;1
109;12.07.2017;2017;07;01;Keskiviikko;3;0;3;1;0;1
109;12.07.2017;2017;07;02;Keskiviikko;1;0;1;0;0;0
109;12.07.2017;2017;07;03;Keskiviikko;0;0;0;0;0;0
109;12.07.2017;2017;07;04;Keskiviikko;0;0;0;1;0;1
109;12.07.2017;2017;07;05;Keskiviikko;6;7;13;0;1;1
109;12.07.2017;2017;07;06;Keskiviikko;16;8;24;5;0;5
109;12.07.2017;2017;07;07;Keskiviikko;25;20;45;2;5;7
109;12.07.2017;2017;07;08;Keskiviikko;12;8;20;1;1;2
109;12.07.2017;2017;07;09;Keskiviikko;8;11;19;2;4;6
109;12.07.2017;2017;07;10;Keskiviikko;7;6;13;6;2;8
109;12.07.2017;2017;07;11;Keskiviikko;7;7;14;3;1;4
109;12.07.2017;2017;07;12;Keskiviikko;9;7;16;2;2;4
109;12.07.2017;2017;07;13;Keskiviikko;8;14;22;3;2;5
109;12.07.2017;2017;07;14;Keskiviikko;9;7;16;2;2;4
109;12.07.2017;2017;07;15;Keskiviikko;17;12;29;3;0;3
109;12.07.2017;2017;07;16;Keskiviikko;13;19;32;1;0;1
109;12.07.2017;2017;07;17;Keskiviikko;16;6;22;7;1;8
109;12.07.2017;2017;07;18;Keskiviikko;5;5;10;6;5;11
109;12.07.2017;2017;07;19;Keskiviikko;5;4;9;1;0;1
109;12.07.2017;2017;07;20;Keskiviikko;2;1;3;2;1;3
109;12.07.2017;2017;07;21;Keskiviikko;6;3;9;1;2;3
109;12.07.2017;2017;07;22;Keskiviikko;0;0;0;0;0;0
109;12.07.2017;2017;07;23;Keskiviikko;0;1;1;0;0;0
109;13.07.2017;2017;07;00;Torstai;0;0;0;0;0;0
109;13.07.2017;2017;07;01;Torstai;3;0;3;0;0;0
109;13.07.2017;2017;07;02;Torstai;0;1;1;0;0;0
109;13.07.2017;2017;07;03;Torstai;1;0;1;0;0;0
109;13.07.2017;2017;07;04;Torstai;0;3;3;1;0;1
109;13.07.2017;2017;07;05;Torstai;5;8;13;1;0;1
109;13.07.2017;2017;07;06;Torstai;16;12;28;2;1;3
109;13.07.2017;2017;07;07;Torstai;38;17;55;2;2;4
109;13.07.2017;2017;07;08;Torstai;14;6;20;6;7;13
109;13.07.2017;2017;07;09;Torstai;8;9;17;3;2;5
109;13.07.2017;2017;07;10;Torstai;9;3;12;5;1;6
109;13.07.2017;2017;07;11;Torstai;7;8;15;4;4;8
109;13.07.2017;2017;07;12;Torstai;13;9;22;4;4;8
109;13.07.2017;2017;07;13;Torstai;7;9;16;5;4;9
109;13.07.2017;2017;07;14;Torstai;11;18;29;8;3;11
109;13.07.2017;2017;07;15;Torstai;43;26;69;9;7;16
109;13.07.2017;2017;07;16;Torstai;24;19;43;6;2;8
109;13.07.2017;2017;07;17;Torstai;17;12;29;2;0;2
109;13.07.2017;2017;07;18;Torstai;11;3;14;2;3;5
109;13.07.2017;2017;07;19;Torstai;5;12;17;2;2;4
109;13.07.2017;2017;07;20;Torstai;6;4;10;8;4;12
109;13.07.2017;2017;07;21;Torstai;8;9;17;7;7;14
109;13.07.2017;2017;07;22;Torstai;3;2;5;2;1;3
109;13.07.2017;2017;07;23;Torstai;4;6;10;0;0;0
109;14.07.2017;2017;07;00;Perjantai;0;3;3;2;1;3
109;14.07.2017;2017;07;01;Perjantai;3;3;6;0;0;0
109;14.07.2017;2017;07;02;Perjantai;0;1;1;0;0;0
109;14.07.2017;2017;07;03;Perjantai;3;2;5;1;0;1
109;14.07.2017;2017;07;04;Perjantai;0;4;4;1;0;1
109;14.07.2017;2017;07;05;Perjantai;4;6;10;1;1;2
109;14.07.2017;2017;07;06;Perjantai;15;10;25;4;0;4
109;14.07.2017;2017;07;07;Perjantai;25;15;40;2;2;4
109;14.07.2017;2017;07;08;Perjantai;11;4;15;3;2;5
109;14.07.2017;2017;07;09;Perjantai;7;3;10;4;0;4
109;14.07.2017;2017;07;10;Perjantai;3;0;3;1;1;2
109;14.07.2017;2017;07;11;Perjantai;8;1;9;3;3;6
109;14.07.2017;2017;07;12;Perjantai;7;4;11;2;1;3
109;14.07.2017;2017;07;13;Perjantai;9;7;16;2;2;4
109;14.07.2017;2017;07;14;Perjantai;17;12;29;3;3;6
109;14.07.2017;2017;07;15;Perjantai;25;14;39;7;4;11
109;14.07.2017;2017;07;16;Perjantai;12;14;26;7;5;12
109;14.07.2017;2017;07;17;Perjantai;17;4;21;5;3;8
109;14.07.2017;2017;07;18;Perjantai;13;8;21;2;4;6
109;14.07.2017;2017;07;19;Perjantai;19;6;25;6;3;9
109;14.07.2017;2017;07;20;Perjantai;4;8;12;2;5;7
109;14.07.2017;2017;07;21;Perjantai;5;8;13;1;3;4
109;14.07.2017;2017;07;22;Perjantai;3;0;3;2;3;5
109;14.07.2017;2017;07;23;Perjantai;3;4;7;0;0;0
109;15.07.2017;2017;07;00;Lauantai;1;6;7;1;0;1
109;15.07.2017;2017;07;01;Lauantai;1;1;2;0;2;2
109;15.07.2017;2017;07;02;Lauantai;1;1;2;1;0;1
109;15.07.2017;2017;07;03;Lauantai;0;2;2;0;0;0
109;15.07.2017;2017;07;04;Lauantai;1;3;4;0;0;0
109;15.07.2017;2017;07;05;Lauantai;2;1;3;0;0;0
109;15.07.2017;2017;07;06;Lauantai;4;3;7;2;2;4
109;15.07.2017;2017;07;07;Lauantai;3;4;7;1;2;3
109;15.07.2017;2017;07;08;Lauantai;8;5;13;5;1;6
109;15.07.2017;2017;07;09;Lauantai;6;4;10;3;3;6
109;15.07.2017;2017;07;10;Lauantai;16;5;21;5;3;8
109;15.07.2017;2017;07;11;Lauantai;13;6;19;0;3;3
109;15.07.2017;2017;07;12;Lauantai;19;7;26;0;1;1
109;15.07.2017;2017;07;13;Lauantai;21;9;30;3;4;7
109;15.07.2017;2017;07;14;Lauantai;10;11;21;2;6;8
109;15.07.2017;2017;07;15;Lauantai;8;12;20;4;2;6
109;15.07.2017;2017;07;16;Lauantai;18;11;29;4;1;5
109;15.07.2017;2017;07;17;Lauantai;24;9;33;7;4;11
109;15.07.2017;2017;07;18;Lauantai;10;11;21;17;10;27
109;15.07.2017;2017;07;19;Lauantai;18;10;28;6;3;9
109;15.07.2017;2017;07;20;Lauantai;8;9;17;5;3;8
109;15.07.2017;2017;07;21;Lauantai;12;11;23;1;0;1
109;15.07.2017;2017;07;22;Lauantai;4;0;4;4;3;7
109;15.07.2017;2017;07;23;Lauantai;6;4;10;0;2;2
109;16.07.2017;2017;07;00;Sunnuntai;2;6;8;0;1;1
109;16.07.2017;2017;07;01;Sunnuntai;3;0;3;0;0;0
109;16.07.2017;2017;07;02;Sunnuntai;0;2;2;0;0;0
109;16.07.2017;2017;07;03;Sunnuntai;0;2;2;0;0;0
109;16.07.2017;2017;07;04;Sunnuntai;0;3;3;0;0;0
109;16.07.2017;2017;07;05;Sunnuntai;2;5;7;2;1;3
109;16.07.2017;2017;07;06;Sunnuntai;6;3;9;1;0;1
109;16.07.2017;2017;07;07;Sunnuntai;1;5;6;0;2;2
109;16.07.2017;2017;07;08;Sunnuntai;1;1;2;0;2;2
109;16.07.2017;2017;07;09;Sunnuntai;7;1;8;7;2;9
109;16.07.2017;2017;07;10;Sunnuntai;12;9;21;3;2;5
109;16.07.2017;2017;07;11;Sunnuntai;32;13;45;10;6;16
109;16.07.2017;2017;07;12;Sunnuntai;25;13;38;6;3;9
109;16.07.2017;2017;07;13;Sunnuntai;32;14;46;5;2;7
109;16.07.2017;2017;07;14;Sunnuntai;27;16;43;3;3;6
109;16.07.2017;2017;07;15;Sunnuntai;10;20;30;3;4;7
109;16.07.2017;2017;07;16;Sunnuntai;18;17;35;4;3;7
109;16.07.2017;2017;07;17;Sunnuntai;23;14;37;7;3;10
109;16.07.2017;2017;07;18;Sunnuntai;23;11;34;6;4;10
109;16.07.2017;2017;07;19;Sunnuntai;18;12;30;6;1;7
109;16.07.2017;2017;07;20;Sunnuntai;14;9;23;10;3;13
109;16.07.2017;2017;07;21;Sunnuntai;5;14;19;2;3;5
109;16.07.2017;2017;07;22;Sunnuntai;5;5;10;0;2;2
109;16.07.2017;2017;07;23;Sunnuntai;4;1;5;1;2;3
109;17.07.2017;2017;07;00;Maanantai;0;0;0;0;0;0
109;17.07.2017;2017;07;01;Maanantai;1;0;1;0;2;2
109;17.07.2017;2017;07;02;Maanantai;3;1;4;0;0;0
109;17.07.2017;2017;07;03;Maanantai;2;3;5;0;0;0
109;17.07.2017;2017;07;04;Maanantai;1;0;1;1;0;1
109;17.07.2017;2017;07;05;Maanantai;4;7;11;0;0;0
109;17.07.2017;2017;07;06;Maanantai;25;21;46;3;4;7
109;17.07.2017;2017;07;07;Maanantai;34;15;49;1;2;3
109;17.07.2017;2017;07;08;Maanantai;19;10;29;2;6;8
109;17.07.2017;2017;07;09;Maanantai;18;5;23;4;2;6
109;17.07.2017;2017;07;10;Maanantai;13;8;21;7;3;10
109;17.07.2017;2017;07;11;Maanantai;20;10;30;6;2;8
109;17.07.2017;2017;07;12;Maanantai;19;16;35;4;5;9
109;17.07.2017;2017;07;13;Maanantai;21;14;35;6;3;9
109;17.07.2017;2017;07;14;Maanantai;16;17;33;3;2;5
109;17.07.2017;2017;07;15;Maanantai;24;23;47;0;1;1
109;17.07.2017;2017;07;16;Maanantai;23;36;59;4;3;7
109;17.07.2017;2017;07;17;Maanantai;20;21;41;8;1;9
109;17.07.2017;2017;07;18;Maanantai;9;14;23;5;6;11
109;17.07.2017;2017;07;19;Maanantai;22;13;35;7;8;15
109;17.07.2017;2017;07;20;Maanantai;2;11;13;3;5;8
109;17.07.2017;2017;07;21;Maanantai;13;8;21;4;4;8
109;17.07.2017;2017;07;22;Maanantai;2;3;5;4;1;5
109;17.07.2017;2017;07;23;Maanantai;2;3;5;0;0;0
109;18.07.2017;2017;07;00;Tiistai;1;0;1;0;1;1
109;18.07.2017;2017;07;01;Tiistai;1;0;1;0;1;1
109;18.07.2017;2017;07;02;Tiistai;1;1;2;0;0;0
109;18.07.2017;2017;07;03;Tiistai;1;0;1;0;0;0
109;18.07.2017;2017;07;04;Tiistai;0;0;0;1;0;1
109;18.07.2017;2017;07;05;Tiistai;2;4;6;0;1;1
109;18.07.2017;2017;07;06;Tiistai;8;9;17;1;0;1
109;18.07.2017;2017;07;07;Tiistai;12;15;27;4;1;5
109;18.07.2017;2017;07;08;Tiistai;4;6;10;1;1;2
109;18.07.2017;2017;07;09;Tiistai;0;3;3;1;1;2
109;18.07.2017;2017;07;10;Tiistai;5;3;8;7;2;9
109;18.07.2017;2017;07;11;Tiistai;3;3;6;4;1;5
109;18.07.2017;2017;07;12;Tiistai;2;5;7;0;1;1
109;18.07.2017;2017;07;13;Tiistai;12;6;18;1;5;6
109;18.07.2017;2017;07;14;Tiistai;12;8;20;4;2;6
109;18.07.2017;2017;07;15;Tiistai;21;10;31;8;1;9
109;18.07.2017;2017;07;16;Tiistai;17;23;40;7;4;11
109;18.07.2017;2017;07;17;Tiistai;12;10;22;3;5;8
109;18.07.2017;2017;07;18;Tiistai;10;3;13;1;1;2
109;18.07.2017;2017;07;19;Tiistai;4;3;7;5;2;7
109;18.07.2017;2017;07;20;Tiistai;0;2;2;4;4;8
109;18.07.2017;2017;07;21;Tiistai;2;5;7;2;0;2
109;18.07.2017;2017;07;22;Tiistai;4;1;5;1;2;3
109;18.07.2017;2017;07;23;Tiistai;3;3;6;0;1;1
109;19.07.2017;2017;07;00;Keskiviikko;2;0;2;0;2;2
109;19.07.2017;2017;07;01;Keskiviikko;0;0;0;0;0;0
109;19.07.2017;2017;07;02;Keskiviikko;0;0;0;0;0;0
109;19.07.2017;2017;07;03;Keskiviikko;0;0;0;0;0;0
109;19.07.2017;2017;07;04;Keskiviikko;0;0;0;1;0;1
109;19.07.2017;2017;07;05;Keskiviikko;3;6;9;0;0;0
109;19.07.2017;2017;07;06;Keskiviikko;14;10;24;3;0;3
109;19.07.2017;2017;07;07;Keskiviikko;28;18;46;4;2;6
109;19.07.2017;2017;07;08;Keskiviikko;15;9;24;9;6;15
109;19.07.2017;2017;07;09;Keskiviikko;12;8;20;6;4;10
109;19.07.2017;2017;07;10;Keskiviikko;8;4;12;6;1;7
109;19.07.2017;2017;07;11;Keskiviikko;18;6;24;2;5;7
109;19.07.2017;2017;07;12;Keskiviikko;19;7;26;4;5;9
109;19.07.2017;2017;07;13;Keskiviikko;11;11;22;3;1;4
109;19.07.2017;2017;07;14;Keskiviikko;13;12;25;7;4;11
109;19.07.2017;2017;07;15;Keskiviikko;20;19;39;4;2;6
109;19.07.2017;2017;07;16;Keskiviikko;22;25;47;3;2;5
109;19.07.2017;2017;07;17;Keskiviikko;22;13;35;4;5;9
109;19.07.2017;2017;07;18;Keskiviikko;22;7;29;3;5;8
109;19.07.2017;2017;07;19;Keskiviikko;7;7;14;5;5;10
109;19.07.2017;2017;07;20;Keskiviikko;7;17;24;4;3;7
109;19.07.2017;2017;07;21;Keskiviikko;8;12;20;5;1;6
109;19.07.2017;2017;07;22;Keskiviikko;7;9;16;2;1;3
109;19.07.2017;2017;07;23;Keskiviikko;3;4;7;4;3;7
109;20.07.2017;2017;07;00;Torstai;1;0;1;0;1;1
109;20.07.2017;2017;07;01;Torstai;0;1;1;0;0;0
109;20.07.2017;2017;07;02;Torstai;0;0;0;0;1;1
109;20.07.2017;2017;07;03;Torstai;0;0;0;0;0;0
109;20.07.2017;2017;07;04;Torstai;0;2;2;1;0;1
109;20.07.2017;2017;07;05;Torstai;4;8;12;0;0;0
109;20.07.2017;2017;07;06;Torstai;14;13;27;3;0;3
109;20.07.2017;2017;07;07;Torstai;19;17;36;3;3;6
109;20.07.2017;2017;07;08;Torstai;18;10;28;2;2;4
109;20.07.2017;2017;07;09;Torstai;10;4;14;2;4;6
109;20.07.2017;2017;07;10;Torstai;5;6;11;7;2;9
109;20.07.2017;2017;07;11;Torstai;20;9;29;7;2;9
109;20.07.2017;2017;07;12;Torstai;15;8;23;3;2;5
109;20.07.2017;2017;07;13;Torstai;21;19;40;3;3;6
109;20.07.2017;2017;07;14;Torstai;21;15;36;5;4;9
109;20.07.2017;2017;07;15;Torstai;26;18;44;4;2;6
109;20.07.2017;2017;07;16;Torstai;24;24;48;6;0;6
109;20.07.2017;2017;07;17;Torstai;15;18;33;1;2;3
109;20.07.2017;2017;07;18;Torstai;10;18;28;3;5;8
109;20.07.2017;2017;07;19;Torstai;14;12;26;10;9;19
109;20.07.2017;2017;07;20;Torstai;12;5;17;9;1;10
109;20.07.2017;2017;07;21;Torstai;9;6;15;0;0;0
109;20.07.2017;2017;07;22;Torstai;6;0;6;0;1;1
109;20.07.2017;2017;07;23;Torstai;1;1;2;2;1;3
109;21.07.2017;2017;07;00;Perjantai;5;0;5;0;1;1
109;21.07.2017;2017;07;01;Perjantai;0;0;0;3;2;5
109;21.07.2017;2017;07;02;Perjantai;1;0;1;0;0;0
109;21.07.2017;2017;07;03;Perjantai;0;0;0;0;0;0
109;21.07.2017;2017;07;04;Perjantai;0;4;4;1;0;1
109;21.07.2017;2017;07;05;Perjantai;5;4;9;1;1;2
109;21.07.2017;2017;07;06;Perjantai;9;11;20;2;1;3
109;21.07.2017;2017;07;07;Perjantai;20;18;38;3;3;6
109;21.07.2017;2017;07;08;Perjantai;21;6;27;6;0;6
109;21.07.2017;2017;07;09;Perjantai;12;11;23;0;4;4
109;21.07.2017;2017;07;10;Perjantai;14;3;17;4;3;7
109;21.07.2017;2017;07;11;Perjantai;17;6;23;7;6;13
109;21.07.2017;2017;07;12;Perjantai;25;22;47;2;2;4
109;21.07.2017;2017;07;13;Perjantai;24;14;38;2;3;5
109;21.07.2017;2017;07;14;Perjantai;18;22;40;9;4;13
109;21.07.2017;2017;07;15;Perjantai;20;15;35;2;2;4
109;21.07.2017;2017;07;16;Perjantai;9;21;30;5;2;7
109;21.07.2017;2017;07;17;Perjantai;19;17;36;5;5;10
109;21.07.2017;2017;07;18;Perjantai;10;11;21;1;3;4
109;21.07.2017;2017;07;19;Perjantai;11;8;19;5;3;8
109;21.07.2017;2017;07;20;Perjantai;14;8;22;6;4;10
109;21.07.2017;2017;07;21;Perjantai;10;9;19;1;2;3
109;21.07.2017;2017;07;22;Perjantai;12;7;19;1;1;2
109;21.07.2017;2017;07;23;Perjantai;7;6;13;0;0;0
109;22.07.2017;2017;07;00;Lauantai;1;1;2;3;1;4
109;22.07.2017;2017;07;01;Lauantai;1;3;4;0;3;3
109;22.07.2017;2017;07;02;Lauantai;2;2;4;0;1;1
109;22.07.2017;2017;07;03;Lauantai;1;4;5;2;0;2
109;22.07.2017;2017;07;04;Lauantai;0;1;1;0;0;0
109;22.07.2017;2017;07;05;Lauantai;0;0;0;0;1;1
109;22.07.2017;2017;07;06;Lauantai;3;3;6;0;0;0
109;22.07.2017;2017;07;07;Lauantai;2;1;3;1;0;1
109;22.07.2017;2017;07;08;Lauantai;5;0;5;4;1;5
109;22.07.2017;2017;07;09;Lauantai;12;5;17;3;1;4
109;22.07.2017;2017;07;10;Lauantai;17;11;28;5;0;5
109;22.07.2017;2017;07;11;Lauantai;13;6;19;9;1;10
109;22.07.2017;2017;07;12;Lauantai;15;10;25;3;3;6
109;22.07.2017;2017;07;13;Lauantai;17;6;23;4;1;5
109;22.07.2017;2017;07;14;Lauantai;9;15;24;9;3;12
109;22.07.2017;2017;07;15;Lauantai;21;8;29;5;7;12
109;22.07.2017;2017;07;16;Lauantai;16;7;23;3;1;4
109;22.07.2017;2017;07;17;Lauantai;14;16;30;5;4;9
109;22.07.2017;2017;07;18;Lauantai;15;12;27;1;3;4
109;22.07.2017;2017;07;19;Lauantai;12;9;21;1;5;6
109;22.07.2017;2017;07;20;Lauantai;5;5;10;10;1;11
109;22.07.2017;2017;07;21;Lauantai;7;7;14;3;0;3
109;22.07.2017;2017;07;22;Lauantai;6;3;9;0;1;1
109;22.07.2017;2017;07;23;Lauantai;0;0;0;0;0;0
109;23.07.2017;2017;07;00;Sunnuntai;0;0;0;0;1;1
109;23.07.2017;2017;07;01;Sunnuntai;1;0;1;1;1;2
109;23.07.2017;2017;07;02;Sunnuntai;2;1;3;0;0;0
109;23.07.2017;2017;07;03;Sunnuntai;0;3;3;2;0;2
109;23.07.2017;2017;07;04;Sunnuntai;0;2;2;0;0;0
109;23.07.2017;2017;07;05;Sunnuntai;0;1;1;0;0;0
109;23.07.2017;2017;07;06;Sunnuntai;2;4;6;2;1;3
109;23.07.2017;2017;07;07;Sunnuntai;1;3;4;1;2;3
109;23.07.2017;2017;07;08;Sunnuntai;3;3;6;3;2;5
109;23.07.2017;2017;07;09;Sunnuntai;5;3;8;2;3;5
109;23.07.2017;2017;07;10;Sunnuntai;12;6;18;8;3;11
109;23.07.2017;2017;07;11;Sunnuntai;9;11;20;3;3;6
109;23.07.2017;2017;07;12;Sunnuntai;15;3;18;3;2;5
109;23.07.2017;2017;07;13;Sunnuntai;18;10;28;7;1;8
109;23.07.2017;2017;07;14;Sunnuntai;15;6;21;4;2;6
109;23.07.2017;2017;07;15;Sunnuntai;8;9;17;5;2;7
109;23.07.2017;2017;07;16;Sunnuntai;12;5;17;1;3;4
109;23.07.2017;2017;07;17;Sunnuntai;8;12;20;4;2;6
109;23.07.2017;2017;07;18;Sunnuntai;7;3;10;2;2;4
109;23.07.2017;2017;07;19;Sunnuntai;8;1;9;7;5;12
109;23.07.2017;2017;07;20;Sunnuntai;9;6;15;4;1;5
109;23.07.2017;2017;07;21;Sunnuntai;4;10;14;4;1;5
109;23.07.2017;2017;07;22;Sunnuntai;3;4;7;1;0;1
109;23.07.2017;2017;07;23;Sunnuntai;4;1;5;2;1;3
109;24.07.2017;2017;07;00;Maanantai;4;0;4;0;0;0
109;24.07.2017;2017;07;01;Maanantai;0;4;4;0;2;2
109;24.07.2017;2017;07;02;Maanantai;0;0;0;0;0;0
109;24.07.2017;2017;07;03;Maanantai;0;0;0;0;0;0
109;24.07.2017;2017;07;04;Maanantai;0;3;3;1;0;1
109;24.07.2017;2017;07;05;Maanantai;3;6;9;0;0;0
109;24.07.2017;2017;07;06;Maanantai;19;14;33;6;0;6
109;24.07.2017;2017;07;07;Maanantai;29;20;49;3;2;5
109;24.07.2017;2017;07;08;Maanantai;17;5;22;3;4;7
109;24.07.2017;2017;07;09;Maanantai;9;7;16;1;4;5
109;24.07.2017;2017;07;10;Maanantai;12;5;17;9;6;15
109;24.07.2017;2017;07;11;Maanantai;24;18;42;3;4;7
109;24.07.2017;2017;07;12;Maanantai;19;16;35;3;1;4
109;24.07.2017;2017;07;13;Maanantai;22;12;34;2;2;4
109;24.07.2017;2017;07;14;Maanantai;27;17;44;6;5;11
109;24.07.2017;2017;07;15;Maanantai;26;29;55;4;1;5
109;24.07.2017;2017;07;16;Maanantai;36;25;61;8;3;11
109;24.07.2017;2017;07;17;Maanantai;24;25;49;9;5;14
109;24.07.2017;2017;07;18;Maanantai;17;11;28;5;3;8
109;24.07.2017;2017;07;19;Maanantai;20;20;40;9;2;11
109;24.07.2017;2017;07;20;Maanantai;15;22;37;9;9;18
109;24.07.2017;2017;07;21;Maanantai;8;10;18;1;3;4
109;24.07.2017;2017;07;22;Maanantai;8;3;11;3;1;4
109;24.07.2017;2017;07;23;Maanantai;11;0;11;2;1;3
109;25.07.2017;2017;07;00;Tiistai;1;0;1;2;1;3
109;25.07.2017;2017;07;01;Tiistai;2;4;6;0;0;0
109;25.07.2017;2017;07;02;Tiistai;1;0;1;0;0;0
109;25.07.2017;2017;07;03;Tiistai;1;2;3;0;0;0
109;25.07.2017;2017;07;04;Tiistai;1;2;3;0;0;0
109;25.07.2017;2017;07;05;Tiistai;5;9;14;2;1;3
109;25.07.2017;2017;07;06;Tiistai;23;9;32;3;0;3
109;25.07.2017;2017;07;07;Tiistai;33;22;55;2;3;5
109;25.07.2017;2017;07;08;Tiistai;23;7;30;5;5;10
109;25.07.2017;2017;07;09;Tiistai;13;13;26;5;6;11
109;25.07.2017;2017;07;10;Tiistai;20;10;30;5;3;8
109;25.07.2017;2017;07;11;Tiistai;27;9;36;7;1;8
109;25.07.2017;2017;07;12;Tiistai;30;14;44;8;3;11
109;25.07.2017;2017;07;13;Tiistai;23;18;41;3;5;8
109;25.07.2017;2017;07;14;Tiistai;21;20;41;3;3;6
109;25.07.2017;2017;07;15;Tiistai;31;45;76;2;1;3
109;25.07.2017;2017;07;16;Tiistai;40;31;71;3;4;7
109;25.07.2017;2017;07;17;Tiistai;35;22;57;5;2;7
109;25.07.2017;2017;07;18;Tiistai;15;16;31;2;2;4
109;25.07.2017;2017;07;19;Tiistai;22;23;45;2;3;5
109;25.07.2017;2017;07;20;Tiistai;15;7;22;7;2;9
109;25.07.2017;2017;07;21;Tiistai;9;10;19;7;3;10
109;25.07.2017;2017;07;22;Tiistai;9;2;11;1;1;2
109;25.07.2017;2017;07;23;Tiistai;0;0;0;2;0;2
109;26.07.2017;2017;07;00;Keskiviikko;2;6;8;0;2;2
109;26.07.2017;2017;07;01;Keskiviikko;3;2;5;0;1;1
109;26.07.2017;2017;07;02;Keskiviikko;0;0;0;1;0;1
109;26.07.2017;2017;07;03;Keskiviikko;0;0;0;0;0;0
109;26.07.2017;2017;07;04;Keskiviikko;1;3;4;1;0;1
109;26.07.2017;2017;07;05;Keskiviikko;4;8;12;0;1;1
109;26.07.2017;2017;07;06;Keskiviikko;20;15;35;1;0;1
109;26.07.2017;2017;07;07;Keskiviikko;31;17;48;2;1;3
109;26.07.2017;2017;07;08;Keskiviikko;22;9;31;4;6;10
109;26.07.2017;2017;07;09;Keskiviikko;20;11;31;6;4;10
109;26.07.2017;2017;07;10;Keskiviikko;22;8;30;7;1;8
109;26.07.2017;2017;07;11;Keskiviikko;22;9;31;1;1;2
109;26.07.2017;2017;07;12;Keskiviikko;23;11;34;3;3;6
109;26.07.2017;2017;07;13;Keskiviikko;26;15;41;3;6;9
109;26.07.2017;2017;07;14;Keskiviikko;29;17;46;2;3;5
109;26.07.2017;2017;07;15;Keskiviikko;36;32;68;8;2;10
109;26.07.2017;2017;07;16;Keskiviikko;30;30;60;4;0;4
109;26.07.2017;2017;07;17;Keskiviikko;23;23;46;2;1;3
109;26.07.2017;2017;07;18;Keskiviikko;21;21;42;4;2;6
109;26.07.2017;2017;07;19;Keskiviikko;28;16;44;6;1;7
109;26.07.2017;2017;07;20;Keskiviikko;19;15;34;7;4;11
109;26.07.2017;2017;07;21;Keskiviikko;11;15;26;4;2;6
109;26.07.2017;2017;07;22;Keskiviikko;7;9;16;1;2;3
109;26.07.2017;2017;07;23;Keskiviikko;1;6;7;0;0;0
109;27.07.2017;2017;07;00;Torstai;0;4;4;1;2;3
109;27.07.2017;2017;07;01;Torstai;0;0;0;2;2;4
109;27.07.2017;2017;07;02;Torstai;1;3;4;0;0;0
109;27.07.2017;2017;07;03;Torstai;0;0;0;0;0;0
109;27.07.2017;2017;07;04;Torstai;0;3;3;1;0;1
109;27.07.2017;2017;07;05;Torstai;5;10;15;1;1;2
109;27.07.2017;2017;07;06;Torstai;18;14;32;1;0;1
109;27.07.2017;2017;07;07;Torstai;27;19;46;3;3;6
109;27.07.2017;2017;07;08;Torstai;27;9;36;7;5;12
109;27.07.2017;2017;07;09;Torstai;15;8;23;3;1;4
109;27.07.2017;2017;07;10;Torstai;16;4;20;6;5;11
109;27.07.2017;2017;07;11;Torstai;7;15;22;2;2;4
109;27.07.2017;2017;07;12;Torstai;19;11;30;2;1;3
109;27.07.2017;2017;07;13;Torstai;25;15;40;5;4;9
109;27.07.2017;2017;07;14;Torstai;20;32;52;1;6;7
109;27.07.2017;2017;07;15;Torstai;41;24;65;0;2;2
109;27.07.2017;2017;07;16;Torstai;39;27;66;0;2;2
109;27.07.2017;2017;07;17;Torstai;28;18;46;3;2;5
109;27.07.2017;2017;07;18;Torstai;32;12;44;2;2;4
109;27.07.2017;2017;07;19;Torstai;10;18;28;2;2;4
109;27.07.2017;2017;07;20;Torstai;18;12;30;3;3;6
109;27.07.2017;2017;07;21;Torstai;18;14;32;5;5;10
109;27.07.2017;2017;07;22;Torstai;8;7;15;2;1;3
109;27.07.2017;2017;07;23;Torstai;5;2;7;0;1;1
109;28.07.2017;2017;07;00;Perjantai;1;5;6;2;0;2
109;28.07.2017;2017;07;01;Perjantai;1;1;2;0;1;1
109;28.07.2017;2017;07;02;Perjantai;1;1;2;0;0;0
109;28.07.2017;2017;07;03;Perjantai;0;1;1;0;0;0
109;28.07.2017;2017;07;04;Perjantai;0;1;1;0;0;0
109;28.07.2017;2017;07;05;Perjantai;5;9;14;2;0;2
109;28.07.2017;2017;07;06;Perjantai;16;10;26;2;1;3
109;28.07.2017;2017;07;07;Perjantai;27;20;47;2;3;5
109;28.07.2017;2017;07;08;Perjantai;12;4;16;10;1;11
109;28.07.2017;2017;07;09;Perjantai;24;12;36;4;5;9
109;28.07.2017;2017;07;10;Perjantai;26;6;32;5;3;8
109;28.07.2017;2017;07;11;Perjantai;20;7;27;2;5;7
109;28.07.2017;2017;07;12;Perjantai;29;20;49;5;3;8
109;28.07.2017;2017;07;13;Perjantai;22;17;39;1;4;5
109;28.07.2017;2017;07;14;Perjantai;38;25;63;8;6;14
109;28.07.2017;2017;07;15;Perjantai;51;29;80;3;1;4
109;28.07.2017;2017;07;16;Perjantai;42;19;61;2;1;3
109;28.07.2017;2017;07;17;Perjantai;42;13;55;1;1;2
109;28.07.2017;2017;07;18;Perjantai;42;10;52;4;1;5
109;28.07.2017;2017;07;19;Perjantai;25;9;34;7;0;7
109;28.07.2017;2017;07;20;Perjantai;20;13;33;3;3;6
109;28.07.2017;2017;07;21;Perjantai;8;8;16;2;1;3
109;28.07.2017;2017;07;22;Perjantai;1;12;13;0;2;2
109;28.07.2017;2017;07;23;Perjantai;7;11;18;1;1;2
109;29.07.2017;2017;07;00;Lauantai;0;30;30;1;0;1
109;29.07.2017;2017;07;01;Lauantai;5;17;22;3;0;3
109;29.07.2017;2017;07;02;Lauantai;0;15;15;0;1;1
109;29.07.2017;2017;07;03;Lauantai;3;10;13;1;0;1
109;29.07.2017;2017;07;04;Lauantai;0;5;5;0;0;0
109;29.07.2017;2017;07;05;Lauantai;1;0;1;0;0;0
109;29.07.2017;2017;07;06;Lauantai;4;1;5;2;0;2
109;29.07.2017;2017;07;07;Lauantai;9;1;10;4;1;5
109;29.07.2017;2017;07;08;Lauantai;7;3;10;0;3;3
109;29.07.2017;2017;07;09;Lauantai;11;3;14;8;3;11
109;29.07.2017;2017;07;10;Lauantai;6;3;9;6;2;8
109;29.07.2017;2017;07;11;Lauantai;21;9;30;3;3;6
109;29.07.2017;2017;07;12;Lauantai;12;3;15;5;3;8
109;29.07.2017;2017;07;13;Lauantai;10;6;16;5;1;6
109;29.07.2017;2017;07;14;Lauantai;23;6;29;6;8;14
109;29.07.2017;2017;07;15;Lauantai;14;5;19;3;2;5
109;29.07.2017;2017;07;16;Lauantai;11;11;22;3;2;5
109;29.07.2017;2017;07;17;Lauantai;25;13;38;5;3;8
109;29.07.2017;2017;07;18;Lauantai;14;13;27;2;1;3
109;29.07.2017;2017;07;19;Lauantai;15;6;21;3;2;5
109;29.07.2017;2017;07;20;Lauantai;21;10;31;5;3;8
109;29.07.2017;2017;07;21;Lauantai;10;9;19;3;1;4
109;29.07.2017;2017;07;22;Lauantai;7;4;11;0;1;1
109;29.07.2017;2017;07;23;Lauantai;4;7;11;2;0;2
109;30.07.2017;2017;07;00;Sunnuntai;0;14;14;1;0;1
109;30.07.2017;2017;07;01;Sunnuntai;2;29;31;0;0;0
109;30.07.2017;2017;07;02;Sunnuntai;0;8;8;0;0;0
109;30.07.2017;2017;07;03;Sunnuntai;0;3;3;0;0;0
109;30.07.2017;2017;07;04;Sunnuntai;1;5;6;0;0;0
109;30.07.2017;2017;07;05;Sunnuntai;0;2;2;0;0;0
109;30.07.2017;2017;07;06;Sunnuntai;2;1;3;1;1;2
109;30.07.2017;2017;07;07;Sunnuntai;2;1;3;7;1;8
109;30.07.2017;2017;07;08;Sunnuntai;7;2;9;3;2;5
109;30.07.2017;2017;07;09;Sunnuntai;8;2;10;2;4;6
109;30.07.2017;2017;07;10;Sunnuntai;24;12;36;11;3;14
109;30.07.2017;2017;07;11;Sunnuntai;16;11;27;5;3;8
109;30.07.2017;2017;07;12;Sunnuntai;20;13;33;4;1;5
109;30.07.2017;2017;07;13;Sunnuntai;19;9;28;2;5;7
109;30.07.2017;2017;07;14;Sunnuntai;29;22;51;3;1;4
109;30.07.2017;2017;07;15;Sunnuntai;19;13;32;4;3;7
109;30.07.2017;2017;07;16;Sunnuntai;19;16;35;11;2;13
109;30.07.2017;2017;07;17;Sunnuntai;16;8;24;4;1;5
109;30.07.2017;2017;07;18;Sunnuntai;29;12;41;4;1;5
109;30.07.2017;2017;07;19;Sunnuntai;12;12;24;6;1;7
109;30.07.2017;2017;07;20;Sunnuntai;16;9;25;7;5;12
109;30.07.2017;2017;07;21;Sunnuntai;3;10;13;4;4;8
109;30.07.2017;2017;07;22;Sunnuntai;0;2;2;1;2;3
109;30.07.2017;2017;07;23;Sunnuntai;1;2;3;1;0;1
109;31.07.2017;2017;07;00;Maanantai;3;0;3;1;1;2
109;31.07.2017;2017;07;01;Maanantai;0;2;2;0;0;0
109;31.07.2017;2017;07;02;Maanantai;1;0;1;0;0;0
109;31.07.2017;2017;07;03;Maanantai;1;0;1;0;0;0
109;31.07.2017;2017;07;04;Maanantai;0;2;2;2;1;3
109;31.07.2017;2017;07;05;Maanantai;4;6;10;1;1;2
109;31.07.2017;2017;07;06;Maanantai;30;18;48;1;2;3
109;31.07.2017;2017;07;07;Maanantai;41;25;66;1;4;5
109;31.07.2017;2017;07;08;Maanantai;31;8;39;2;1;3
109;31.07.2017;2017;07;09;Maanantai;20;7;27;2;5;7
109;31.07.2017;2017;07;10;Maanantai;22;10;32;3;5;8
109;31.07.2017;2017;07;11;Maanantai;19;9;28;3;3;6
109;31.07.2017;2017;07;12;Maanantai;21;20;41;1;1;2
109;31.07.2017;2017;07;13;Maanantai;26;18;44;5;1;6
109;31.07.2017;2017;07;14;Maanantai;25;19;44;6;9;15
109;31.07.2017;2017;07;15;Maanantai;36;38;74;8;1;9
109;31.07.2017;2017;07;16;Maanantai;35;31;66;8;4;12
109;31.07.2017;2017;07;17;Maanantai;34;24;58;10;8;18
109;31.07.2017;2017;07;18;Maanantai;24;19;43;6;10;16
109;31.07.2017;2017;07;19;Maanantai;20;25;45;8;1;9
109;31.07.2017;2017;07;20;Maanantai;4;11;15;4;4;8
109;31.07.2017;2017;07;21;Maanantai;10;9;19;7;3;10
109;31.07.2017;2017;07;22;Maanantai;4;3;7;2;3;5
109;31.07.2017;2017;07;23;Maanantai;3;5;8;2;1;3
109;01.08.2017;2017;08;00;Tiistai;0;1;1;0;1;1
109;01.08.2017;2017;08;01;Tiistai;0;0;0;3;0;3
109;01.08.2017;2017;08;02;Tiistai;1;0;1;1;0;1
109;01.08.2017;2017;08;03;Tiistai;0;2;2;0;0;0
109;01.08.2017;2017;08;04;Tiistai;0;2;2;1;0;1
109;01.08.2017;2017;08;05;Tiistai;3;1;4;0;0;0
109;01.08.2017;2017;08;06;Tiistai;25;11;36;1;0;1
109;01.08.2017;2017;08;07;Tiistai;42;24;66;3;4;7
109;01.08.2017;2017;08;08;Tiistai;31;12;43;7;1;8
109;01.08.2017;2017;08;09;Tiistai;12;7;19;3;4;7
109;01.08.2017;2017;08;10;Tiistai;15;5;20;4;4;8
109;01.08.2017;2017;08;11;Tiistai;18;10;28;7;3;10
109;01.08.2017;2017;08;12;Tiistai;18;11;29;5;1;6
109;01.08.2017;2017;08;13;Tiistai;25;16;41;3;6;9
109;01.08.2017;2017;08;14;Tiistai;15;23;38;9;3;12
109;01.08.2017;2017;08;15;Tiistai;22;48;70;4;0;4
109;01.08.2017;2017;08;16;Tiistai;37;29;66;3;6;9
109;01.08.2017;2017;08;17;Tiistai;25;21;46;8;5;13
109;01.08.2017;2017;08;18;Tiistai;22;19;41;3;6;9
109;01.08.2017;2017;08;19;Tiistai;17;11;28;8;3;11
109;01.08.2017;2017;08;20;Tiistai;17;14;31;1;1;2
109;01.08.2017;2017;08;21;Tiistai;9;14;23;3;3;6
109;01.08.2017;2017;08;22;Tiistai;5;9;14;5;1;6
109;01.08.2017;2017;08;23;Tiistai;2;2;4;1;1;2
109;02.08.2017;2017;08;00;Keskiviikko;2;0;2;0;0;0
109;02.08.2017;2017;08;01;Keskiviikko;1;0;1;1;0;1
109;02.08.2017;2017;08;02;Keskiviikko;0;0;0;1;0;1
109;02.08.2017;2017;08;03;Keskiviikko;0;0;0;0;0;0
109;02.08.2017;2017;08;04;Keskiviikko;1;1;2;1;0;1
109;02.08.2017;2017;08;05;Keskiviikko;5;3;8;1;1;2
109;02.08.2017;2017;08;06;Keskiviikko;26;10;36;4;0;4
109;02.08.2017;2017;08;07;Keskiviikko;49;33;82;3;2;5
109;02.08.2017;2017;08;08;Keskiviikko;18;12;30;4;2;6
109;02.08.2017;2017;08;09;Keskiviikko;25;6;31;4;4;8
109;02.08.2017;2017;08;10;Keskiviikko;15;6;21;7;0;7
109;02.08.2017;2017;08;11;Keskiviikko;24;8;32;6;3;9
109;02.08.2017;2017;08;12;Keskiviikko;20;12;32;5;0;5
109;02.08.2017;2017;08;13;Keskiviikko;24;21;45;3;7;10
109;02.08.2017;2017;08;14;Keskiviikko;24;23;47;5;2;7
109;02.08.2017;2017;08;15;Keskiviikko;36;38;74;5;6;11
109;02.08.2017;2017;08;16;Keskiviikko;38;40;78;7;2;9
109;02.08.2017;2017;08;17;Keskiviikko;30;22;52;3;5;8
109;02.08.2017;2017;08;18;Keskiviikko;24;31;55;4;5;9
109;02.08.2017;2017;08;19;Keskiviikko;14;15;29;4;4;8
109;02.08.2017;2017;08;20;Keskiviikko;9;11;20;6;7;13
109;02.08.2017;2017;08;21;Keskiviikko;10;20;30;2;1;3
109;02.08.2017;2017;08;22;Keskiviikko;2;3;5;1;0;1
109;02.08.2017;2017;08;23;Keskiviikko;3;8;11;0;0;0
109;03.08.2017;2017;08;00;Torstai;1;2;3;0;0;0
109;03.08.2017;2017;08;01;Torstai;0;1;1;0;0;0
109;03.08.2017;2017;08;02;Torstai;0;0;0;1;0;1
109;03.08.2017;2017;08;03;Torstai;0;0;0;0;0;0
109;03.08.2017;2017;08;04;Torstai;0;1;1;1;1;2
109;03.08.2017;2017;08;05;Torstai;3;5;8;1;0;1
109;03.08.2017;2017;08;06;Torstai;20;12;32;3;0;3
109;03.08.2017;2017;08;07;Torstai;32;27;59;8;3;11
109;03.08.2017;2017;08;08;Torstai;25;10;35;1;3;4
109;03.08.2017;2017;08;09;Torstai;16;4;20;4;1;5
109;03.08.2017;2017;08;10;Torstai;25;8;33;7;5;12
109;03.08.2017;2017;08;11;Torstai;19;7;26;6;2;8
109;03.08.2017;2017;08;12;Torstai;14;14;28;7;6;13
109;03.08.2017;2017;08;13;Torstai;22;15;37;4;3;7
109;03.08.2017;2017;08;14;Torstai;25;15;40;5;2;7
109;03.08.2017;2017;08;15;Torstai;29;30;59;4;2;6
109;03.08.2017;2017;08;16;Torstai;42;32;74;3;1;4
109;03.08.2017;2017;08;17;Torstai;25;23;48;5;3;8
109;03.08.2017;2017;08;18;Torstai;13;28;41;3;5;8
109;03.08.2017;2017;08;19;Torstai;12;10;22;7;5;12
109;03.08.2017;2017;08;20;Torstai;10;6;16;7;2;9
109;03.08.2017;2017;08;21;Torstai;10;12;22;3;2;5
109;03.08.2017;2017;08;22;Torstai;4;6;10;2;2;4
109;03.08.2017;2017;08;23;Torstai;4;2;6;0;0;0
109;04.08.2017;2017;08;00;Perjantai;0;4;4;1;1;2
109;04.08.2017;2017;08;01;Perjantai;1;1;2;1;0;1
109;04.08.2017;2017;08;02;Perjantai;1;2;3;0;1;1
109;04.08.2017;2017;08;03;Perjantai;0;3;3;0;0;0
109;04.08.2017;2017;08;04;Perjantai;3;0;3;1;0;1
109;04.08.2017;2017;08;05;Perjantai;6;7;13;0;1;1
109;04.08.2017;2017;08;06;Perjantai;20;12;32;2;1;3
109;04.08.2017;2017;08;07;Perjantai;32;24;56;3;3;6
109;04.08.2017;2017;08;08;Perjantai;26;7;33;2;1;3
109;04.08.2017;2017;08;09;Perjantai;18;11;29;1;3;4
109;04.08.2017;2017;08;10;Perjantai;10;4;14;5;2;7
109;04.08.2017;2017;08;11;Perjantai;12;10;22;2;3;5
109;04.08.2017;2017;08;12;Perjantai;17;18;35;3;0;3
109;04.08.2017;2017;08;13;Perjantai;20;12;32;3;4;7
109;04.08.2017;2017;08;14;Perjantai;17;16;33;1;2;3
109;04.08.2017;2017;08;15;Perjantai;38;30;68;4;2;6
109;04.08.2017;2017;08;16;Perjantai;38;36;74;5;4;9
109;04.08.2017;2017;08;17;Perjantai;19;21;40;3;3;6
109;04.08.2017;2017;08;18;Perjantai;15;11;26;0;6;6
109;04.08.2017;2017;08;19;Perjantai;12;2;14;3;3;6
109;04.08.2017;2017;08;20;Perjantai;13;12;25;3;0;3
109;04.08.2017;2017;08;21;Perjantai;5;10;15;6;3;9
109;04.08.2017;2017;08;22;Perjantai;10;4;14;4;3;7
109;04.08.2017;2017;08;23;Perjantai;5;1;6;2;1;3
109;05.08.2017;2017;08;00;Lauantai;2;6;8;1;1;2
109;05.08.2017;2017;08;01;Lauantai;4;2;6;1;0;1
109;05.08.2017;2017;08;02;Lauantai;5;3;8;0;0;0
109;05.08.2017;2017;08;03;Lauantai;0;0;0;0;0;0
109;05.08.2017;2017;08;04;Lauantai;0;0;0;0;0;0
109;05.08.2017;2017;08;05;Lauantai;1;1;2;1;1;2
109;05.08.2017;2017;08;06;Lauantai;5;0;5;0;0;0
109;05.08.2017;2017;08;07;Lauantai;0;3;3;1;3;4
109;05.08.2017;2017;08;08;Lauantai;6;2;8;3;1;4
109;05.08.2017;2017;08;09;Lauantai;11;3;14;5;4;9
109;05.08.2017;2017;08;10;Lauantai;5;5;10;4;1;5
109;05.08.2017;2017;08;11;Lauantai;13;10;23;3;0;3
109;05.08.2017;2017;08;12;Lauantai;6;8;14;8;2;10
109;05.08.2017;2017;08;13;Lauantai;7;6;13;1;1;2
109;05.08.2017;2017;08;14;Lauantai;8;4;12;1;4;5
109;05.08.2017;2017;08;15;Lauantai;7;12;19;4;2;6
109;05.08.2017;2017;08;16;Lauantai;13;4;17;5;5;10
109;05.08.2017;2017;08;17;Lauantai;12;7;19;2;0;2
109;05.08.2017;2017;08;18;Lauantai;11;10;21;1;2;3
109;05.08.2017;2017;08;19;Lauantai;5;1;6;5;1;6
109;05.08.2017;2017;08;20;Lauantai;4;6;10;4;1;5
109;05.08.2017;2017;08;21;Lauantai;3;6;9;2;2;4
109;05.08.2017;2017;08;22;Lauantai;2;1;3;5;2;7
109;05.08.2017;2017;08;23;Lauantai;1;2;3;5;2;7
109;06.08.2017;2017;08;00;Sunnuntai;2;0;2;0;1;1
109;06.08.2017;2017;08;01;Sunnuntai;1;0;1;0;0;0
109;06.08.2017;2017;08;02;Sunnuntai;1;1;2;0;0;0
109;06.08.2017;2017;08;03;Sunnuntai;0;0;0;0;0;0
109;06.08.2017;2017;08;04;Sunnuntai;0;1;1;0;0;0
109;06.08.2017;2017;08;05;Sunnuntai;0;0;0;0;0;0
109;06.08.2017;2017;08;06;Sunnuntai;4;1;5;3;0;3
109;06.08.2017;2017;08;07;Sunnuntai;1;2;3;3;1;4
109;06.08.2017;2017;08;08;Sunnuntai;1;4;5;3;2;5
109;06.08.2017;2017;08;09;Sunnuntai;4;4;8;3;4;7
109;06.08.2017;2017;08;10;Sunnuntai;8;5;13;4;1;5
109;06.08.2017;2017;08;11;Sunnuntai;8;10;18;5;3;8
109;06.08.2017;2017;08;12;Sunnuntai;10;7;17;3;3;6
109;06.08.2017;2017;08;13;Sunnuntai;4;9;13;1;2;3
109;06.08.2017;2017;08;14;Sunnuntai;9;5;14;8;2;10
109;06.08.2017;2017;08;15;Sunnuntai;8;7;15;4;4;8
109;06.08.2017;2017;08;16;Sunnuntai;11;4;15;7;5;12
109;06.08.2017;2017;08;17;Sunnuntai;6;9;15;7;4;11
109;06.08.2017;2017;08;18;Sunnuntai;11;5;16;5;7;12
109;06.08.2017;2017;08;19;Sunnuntai;10;13;23;9;5;14
109;06.08.2017;2017;08;20;Sunnuntai;2;4;6;6;3;9
109;06.08.2017;2017;08;21;Sunnuntai;3;7;10;3;2;5
109;06.08.2017;2017;08;22;Sunnuntai;2;1;3;2;1;3
109;06.08.2017;2017;08;23;Sunnuntai;6;4;10;0;1;1
109;07.08.2017;2017;08;00;Maanantai;2;1;3;2;1;3
109;07.08.2017;2017;08;01;Maanantai;0;0;0;1;0;1
109;07.08.2017;2017;08;02;Maanantai;2;0;2;0;1;1
109;07.08.2017;2017;08;03;Maanantai;0;1;1;0;1;1
109;07.08.2017;2017;08;04;Maanantai;2;3;5;1;0;1
109;07.08.2017;2017;08;05;Maanantai;10;7;17;1;0;1
109;07.08.2017;2017;08;06;Maanantai;20;16;36;1;0;1
109;07.08.2017;2017;08;07;Maanantai;53;26;79;7;3;10
109;07.08.2017;2017;08;08;Maanantai;40;16;56;4;1;5
109;07.08.2017;2017;08;09;Maanantai;19;6;25;7;3;10
109;07.08.2017;2017;08;10;Maanantai;16;6;22;6;1;7
109;07.08.2017;2017;08;11;Maanantai;16;7;23;4;1;5
109;07.08.2017;2017;08;12;Maanantai;17;14;31;3;3;6
109;07.08.2017;2017;08;13;Maanantai;20;14;34;31;5;36
109;07.08.2017;2017;08;14;Maanantai;15;19;34;5;6;11
109;07.08.2017;2017;08;15;Maanantai;29;38;67;5;4;9
109;07.08.2017;2017;08;16;Maanantai;44;43;87;5;4;9
109;07.08.2017;2017;08;17;Maanantai;19;32;51;5;1;6
109;07.08.2017;2017;08;18;Maanantai;16;17;33;14;5;19
109;07.08.2017;2017;08;19;Maanantai;16;14;30;10;2;12
109;07.08.2017;2017;08;20;Maanantai;11;9;20;8;7;15
109;07.08.2017;2017;08;21;Maanantai;9;11;20;8;1;9
109;07.08.2017;2017;08;22;Maanantai;4;3;7;3;0;3
109;07.08.2017;2017;08;23;Maanantai;5;3;8;3;1;4
109;08.08.2017;2017;08;00;Tiistai;2;1;3;2;1;3
109;08.08.2017;2017;08;01;Tiistai;3;1;4;0;0;0
109;08.08.2017;2017;08;02;Tiistai;1;0;1;0;0;0
109;08.08.2017;2017;08;03;Tiistai;0;0;0;0;0;0
109;08.08.2017;2017;08;04;Tiistai;0;1;1;1;0;1
109;08.08.2017;2017;08;05;Tiistai;6;3;9;1;1;2
109;08.08.2017;2017;08;06;Tiistai;21;22;43;2;0;2
109;08.08.2017;2017;08;07;Tiistai;55;24;79;4;2;6
109;08.08.2017;2017;08;08;Tiistai;43;15;58;4;3;7
109;08.08.2017;2017;08;09;Tiistai;13;9;22;5;9;14
109;08.08.2017;2017;08;10;Tiistai;16;12;28;2;0;2
109;08.08.2017;2017;08;11;Tiistai;28;13;41;3;3;6
109;08.08.2017;2017;08;12;Tiistai;19;10;29;7;0;7
109;08.08.2017;2017;08;13;Tiistai;19;15;34;3;4;7
109;08.08.2017;2017;08;14;Tiistai;24;13;37;3;9;12
109;08.08.2017;2017;08;15;Tiistai;38;50;88;4;3;7
109;08.08.2017;2017;08;16;Tiistai;35;52;87;5;6;11
109;08.08.2017;2017;08;17;Tiistai;24;32;56;8;8;16
109;08.08.2017;2017;08;18;Tiistai;11;20;31;7;7;14
109;08.08.2017;2017;08;19;Tiistai;11;9;20;3;3;6
109;08.08.2017;2017;08;20;Tiistai;5;7;12;4;1;5
109;08.08.2017;2017;08;21;Tiistai;8;1;9;6;3;9
109;08.08.2017;2017;08;22;Tiistai;4;4;8;2;2;4
109;08.08.2017;2017;08;23;Tiistai;0;0;0;0;2;2
109;09.08.2017;2017;08;00;Keskiviikko;0;0;0;0;0;0
109;09.08.2017;2017;08;01;Keskiviikko;0;0;0;1;0;1
109;09.08.2017;2017;08;02;Keskiviikko;1;0;1;0;0;0
109;09.08.2017;2017;08;03;Keskiviikko;0;0;0;1;2;3
109;09.08.2017;2017;08;04;Keskiviikko;0;1;1;0;0;0
109;09.08.2017;2017;08;05;Keskiviikko;3;3;6;1;0;1
109;09.08.2017;2017;08;06;Keskiviikko;21;16;37;2;0;2
109;09.08.2017;2017;08;07;Keskiviikko;55;26;81;5;3;8
109;09.08.2017;2017;08;08;Keskiviikko;41;13;54;4;3;7
109;09.08.2017;2017;08;09;Keskiviikko;14;5;19;1;3;4
109;09.08.2017;2017;08;10;Keskiviikko;8;4;12;6;3;9
109;09.08.2017;2017;08;11;Keskiviikko;14;9;23;3;2;5
109;09.08.2017;2017;08;12;Keskiviikko;22;13;35;6;4;10
109;09.08.2017;2017;08;13;Keskiviikko;24;21;45;3;4;7
109;09.08.2017;2017;08;14;Keskiviikko;16;23;39;6;3;9
109;09.08.2017;2017;08;15;Keskiviikko;35;44;79;7;10;17
109;09.08.2017;2017;08;16;Keskiviikko;29;40;69;7;0;7
109;09.08.2017;2017;08;17;Keskiviikko;21;24;45;5;6;11
109;09.08.2017;2017;08;18;Keskiviikko;22;23;45;8;6;14
109;09.08.2017;2017;08;19;Keskiviikko;15;10;25;6;8;14
109;09.08.2017;2017;08;20;Keskiviikko;12;14;26;6;6;12
109;09.08.2017;2017;08;21;Keskiviikko;10;6;16;6;1;7
109;09.08.2017;2017;08;22;Keskiviikko;9;9;18;5;3;8
109;09.08.2017;2017;08;23;Keskiviikko;2;1;3;0;0;0
109;10.08.2017;2017;08;00;Torstai;1;2;3;0;0;0
109;10.08.2017;2017;08;01;Torstai;0;1;1;1;1;2
109;10.08.2017;2017;08;02;Torstai;2;0;2;0;0;0
109;10.08.2017;2017;08;03;Torstai;0;1;1;0;0;0
109;10.08.2017;2017;08;04;Torstai;0;1;1;1;0;1
109;10.08.2017;2017;08;05;Torstai;5;5;10;0;0;0
109;10.08.2017;2017;08;06;Torstai;13;17;30;2;1;3
109;10.08.2017;2017;08;07;Torstai;52;19;71;4;5;9
109;10.08.2017;2017;08;08;Torstai;43;7;50;6;3;9
109;10.08.2017;2017;08;09;Torstai;26;4;30;6;4;10
109;10.08.2017;2017;08;10;Torstai;5;9;14;1;1;2
109;10.08.2017;2017;08;11;Torstai;10;8;18;3;1;4
109;10.08.2017;2017;08;12;Torstai;6;8;14;2;0;2
109;10.08.2017;2017;08;13;Torstai;2;11;13;2;2;4
109;10.08.2017;2017;08;14;Torstai;17;18;35;3;2;5
109;10.08.2017;2017;08;15;Torstai;23;18;41;3;3;6
109;10.08.2017;2017;08;16;Torstai;19;37;56;1;4;5
109;10.08.2017;2017;08;17;Torstai;10;10;20;4;2;6
109;10.08.2017;2017;08;18;Torstai;8;9;17;8;5;13
109;10.08.2017;2017;08;19;Torstai;9;5;14;10;11;21
109;10.08.2017;2017;08;20;Torstai;5;3;8;7;6;13
109;10.08.2017;2017;08;21;Torstai;3;2;5;1;4;5
109;10.08.2017;2017;08;22;Torstai;3;2;5;1;0;1
109;10.08.2017;2017;08;23;Torstai;1;1;2;0;0;0
109;11.08.2017;2017;08;00;Perjantai;0;0;0;0;1;1
109;11.08.2017;2017;08;01;Perjantai;0;0;0;0;1;1
109;11.08.2017;2017;08;02;Perjantai;0;1;1;0;0;0
109;11.08.2017;2017;08;03;Perjantai;2;0;2;0;0;0
109;11.08.2017;2017;08;04;Perjantai;0;0;0;0;0;0
109;11.08.2017;2017;08;05;Perjantai;5;3;8;1;0;1
109;11.08.2017;2017;08;06;Perjantai;20;17;37;2;0;2
109;11.08.2017;2017;08;07;Perjantai;55;25;80;2;8;10
109;11.08.2017;2017;08;08;Perjantai;52;13;65;5;5;10
109;11.08.2017;2017;08;09;Perjantai;22;9;31;7;0;7
109;11.08.2017;2017;08;10;Perjantai;19;13;32;4;3;7
109;11.08.2017;2017;08;11;Perjantai;11;19;30;3;3;6
109;11.08.2017;2017;08;12;Perjantai;16;23;39;3;1;4
109;11.08.2017;2017;08;13;Perjantai;16;27;43;4;5;9
109;11.08.2017;2017;08;14;Perjantai;34;39;73;3;3;6
109;11.08.2017;2017;08;15;Perjantai;37;40;77;4;0;4
109;11.08.2017;2017;08;16;Perjantai;26;31;57;10;4;14
109;11.08.2017;2017;08;17;Perjantai;19;17;36;4;5;9
109;11.08.2017;2017;08;18;Perjantai;11;17;28;4;3;7
109;11.08.2017;2017;08;19;Perjantai;16;16;32;4;1;5
109;11.08.2017;2017;08;20;Perjantai;12;8;20;5;1;6
109;11.08.2017;2017;08;21;Perjantai;10;6;16;5;2;7
109;11.08.2017;2017;08;22;Perjantai;6;2;8;2;1;3
109;11.08.2017;2017;08;23;Perjantai;5;3;8;1;1;2
109;12.08.2017;2017;08;00;Lauantai;3;1;4;0;0;0
109;12.08.2017;2017;08;01;Lauantai;1;2;3;1;0;1
109;12.08.2017;2017;08;02;Lauantai;2;2;4;0;0;0
109;12.08.2017;2017;08;03;Lauantai;1;1;2;0;0;0
109;12.08.2017;2017;08;04;Lauantai;0;1;1;0;0;0
109;12.08.2017;2017;08;05;Lauantai;0;0;0;1;0;1
109;12.08.2017;2017;08;06;Lauantai;5;2;7;1;0;1
109;12.08.2017;2017;08;07;Lauantai;3;2;5;1;1;2
109;12.08.2017;2017;08;08;Lauantai;7;2;9;2;0;2
109;12.08.2017;2017;08;09;Lauantai;7;8;15;4;4;8
109;12.08.2017;2017;08;10;Lauantai;10;4;14;14;5;19
109;12.08.2017;2017;08;11;Lauantai;26;10;36;1;4;5
109;12.08.2017;2017;08;12;Lauantai;25;11;36;2;0;2
109;12.08.2017;2017;08;13;Lauantai;23;10;33;4;2;6
109;12.08.2017;2017;08;14;Lauantai;16;18;34;2;2;4
109;12.08.2017;2017;08;15;Lauantai;20;15;35;4;3;7
109;12.08.2017;2017;08;16;Lauantai;25;12;37;2;5;7
109;12.08.2017;2017;08;17;Lauantai;15;17;32;8;6;14
109;12.08.2017;2017;08;18;Lauantai;19;15;34;0;2;2
109;12.08.2017;2017;08;19;Lauantai;10;8;18;5;0;5
109;12.08.2017;2017;08;20;Lauantai;14;5;19;4;2;6
109;12.08.2017;2017;08;21;Lauantai;5;6;11;2;2;4
109;12.08.2017;2017;08;22;Lauantai;4;1;5;2;2;4
109;12.08.2017;2017;08;23;Lauantai;4;3;7;1;0;1
109;13.08.2017;2017;08;00;Sunnuntai;0;1;1;0;1;1
109;13.08.2017;2017;08;01;Sunnuntai;0;3;3;1;0;1
109;13.08.2017;2017;08;02;Sunnuntai;0;2;2;0;2;2
109;13.08.2017;2017;08;03;Sunnuntai;0;5;5;0;0;0
109;13.08.2017;2017;08;04;Sunnuntai;1;0;1;0;0;0
109;13.08.2017;2017;08;05;Sunnuntai;0;0;0;0;0;0
109;13.08.2017;2017;08;06;Sunnuntai;2;0;2;1;0;1
109;13.08.2017;2017;08;07;Sunnuntai;0;2;2;1;2;3
109;13.08.2017;2017;08;08;Sunnuntai;4;0;4;1;1;2
109;13.08.2017;2017;08;09;Sunnuntai;3;3;6;6;1;7
109;13.08.2017;2017;08;10;Sunnuntai;8;2;10;4;2;6
109;13.08.2017;2017;08;11;Sunnuntai;15;9;24;5;4;9
109;13.08.2017;2017;08;12;Sunnuntai;5;7;12;2;1;3
109;13.08.2017;2017;08;13;Sunnuntai;5;8;13;2;3;5
109;13.08.2017;2017;08;14;Sunnuntai;3;5;8;3;2;5
109;13.08.2017;2017;08;15;Sunnuntai;3;7;10;4;2;6
109;13.08.2017;2017;08;16;Sunnuntai;7;6;13;2;4;6
109;13.08.2017;2017;08;17;Sunnuntai;11;5;16;2;2;4
109;13.08.2017;2017;08;18;Sunnuntai;6;7;13;4;2;6
109;13.08.2017;2017;08;19;Sunnuntai;14;9;23;11;6;17
109;13.08.2017;2017;08;20;Sunnuntai;2;4;6;7;9;16
109;13.08.2017;2017;08;21;Sunnuntai;7;7;14;5;0;5
109;13.08.2017;2017;08;22;Sunnuntai;1;0;1;0;0;0
109;13.08.2017;2017;08;23;Sunnuntai;2;1;3;0;0;0
109;14.08.2017;2017;08;00;Maanantai;2;3;5;0;1;1
109;14.08.2017;2017;08;01;Maanantai;0;0;0;0;0;0
109;14.08.2017;2017;08;02;Maanantai;1;0;1;1;0;1
109;14.08.2017;2017;08;03;Maanantai;0;0;0;0;0;0
109;14.08.2017;2017;08;04;Maanantai;1;0;1;1;0;1
109;14.08.2017;2017;08;05;Maanantai;7;4;11;0;0;0
109;14.08.2017;2017;08;06;Maanantai;22;16;38;1;0;1
109;14.08.2017;2017;08;07;Maanantai;85;35;120;2;8;10
109;14.08.2017;2017;08;08;Maanantai;46;10;56;6;2;8
109;14.08.2017;2017;08;09;Maanantai;18;4;22;3;3;6
109;14.08.2017;2017;08;10;Maanantai;16;11;27;2;2;4
109;14.08.2017;2017;08;11;Maanantai;11;6;17;2;2;4
109;14.08.2017;2017;08;12;Maanantai;14;10;24;1;0;1
109;14.08.2017;2017;08;13;Maanantai;17;17;34;3;0;3
109;14.08.2017;2017;08;14;Maanantai;14;35;49;3;4;7
109;14.08.2017;2017;08;15;Maanantai;32;54;86;8;1;9
109;14.08.2017;2017;08;16;Maanantai;29;65;94;1;5;6
109;14.08.2017;2017;08;17;Maanantai;13;26;39;4;4;8
109;14.08.2017;2017;08;18;Maanantai;20;18;38;8;8;16
109;14.08.2017;2017;08;19;Maanantai;15;16;31;7;14;21
109;14.08.2017;2017;08;20;Maanantai;12;13;25;8;5;13
109;14.08.2017;2017;08;21;Maanantai;7;12;19;1;1;2
109;14.08.2017;2017;08;22;Maanantai;7;3;10;0;0;0
109;14.08.2017;2017;08;23;Maanantai;3;0;3;0;2;2
109;15.08.2017;2017;08;00;Tiistai;0;2;2;0;1;1
109;15.08.2017;2017;08;01;Tiistai;1;0;1;3;1;4
109;15.08.2017;2017;08;02;Tiistai;1;0;1;0;0;0
109;15.08.2017;2017;08;03;Tiistai;0;0;0;0;0;0
109;15.08.2017;2017;08;04;Tiistai;0;0;0;0;0;0
109;15.08.2017;2017;08;05;Tiistai;5;4;9;1;0;1
109;15.08.2017;2017;08;06;Tiistai;27;22;49;3;0;3
109;15.08.2017;2017;08;07;Tiistai;92;40;132;6;4;10
109;15.08.2017;2017;08;08;Tiistai;53;16;69;3;3;6
109;15.08.2017;2017;08;09;Tiistai;28;6;34;5;4;9
109;15.08.2017;2017;08;10;Tiistai;9;8;17;1;3;4
109;15.08.2017;2017;08;11;Tiistai;18;10;28;0;4;4
109;15.08.2017;2017;08;12;Tiistai;20;11;31;7;3;10
109;15.08.2017;2017;08;13;Tiistai;12;20;32;6;3;9
109;15.08.2017;2017;08;14;Tiistai;23;23;46;2;2;4
109;15.08.2017;2017;08;15;Tiistai;30;52;82;2;3;5
109;15.08.2017;2017;08;16;Tiistai;29;79;108;3;6;9
109;15.08.2017;2017;08;17;Tiistai;29;34;63;4;3;7
109;15.08.2017;2017;08;18;Tiistai;19;14;33;1;3;4
109;15.08.2017;2017;08;19;Tiistai;22;15;37;3;11;14
109;15.08.2017;2017;08;20;Tiistai;10;10;20;5;2;7
109;15.08.2017;2017;08;21;Tiistai;9;11;20;1;1;2
109;15.08.2017;2017;08;22;Tiistai;11;5;16;2;2;4
109;15.08.2017;2017;08;23;Tiistai;0;3;3;0;0;0
109;16.08.2017;2017;08;00;Keskiviikko;0;1;1;0;1;1
109;16.08.2017;2017;08;01;Keskiviikko;0;1;1;0;2;2
109;16.08.2017;2017;08;02;Keskiviikko;1;0;1;0;0;0
109;16.08.2017;2017;08;03;Keskiviikko;0;0;0;0;0;0
109;16.08.2017;2017;08;04;Keskiviikko;0;0;0;0;0;0
109;16.08.2017;2017;08;05;Keskiviikko;6;5;11;1;0;1
109;16.08.2017;2017;08;06;Keskiviikko;26;14;40;3;0;3
109;16.08.2017;2017;08;07;Keskiviikko;81;40;121;2;11;13
109;16.08.2017;2017;08;08;Keskiviikko;43;20;63;9;3;12
109;16.08.2017;2017;08;09;Keskiviikko;20;3;23;3;4;7
109;16.08.2017;2017;08;10;Keskiviikko;17;8;25;0;3;3
109;16.08.2017;2017;08;11;Keskiviikko;17;12;29;2;3;5
109;16.08.2017;2017;08;12;Keskiviikko;13;13;26;3;2;5
109;16.08.2017;2017;08;13;Keskiviikko;16;18;34;11;7;18
109;16.08.2017;2017;08;14;Keskiviikko;14;26;40;9;2;11
109;16.08.2017;2017;08;15;Keskiviikko;31;49;80;7;3;10
109;16.08.2017;2017;08;16;Keskiviikko;45;54;99;1;2;3
109;16.08.2017;2017;08;17;Keskiviikko;18;25;43;4;6;10
109;16.08.2017;2017;08;18;Keskiviikko;18;18;36;9;4;13
109;16.08.2017;2017;08;19;Keskiviikko;10;16;26;6;8;14
109;16.08.2017;2017;08;20;Keskiviikko;13;14;27;6;4;10
109;16.08.2017;2017;08;21;Keskiviikko;8;13;21;3;3;6
109;16.08.2017;2017;08;22;Keskiviikko;7;4;11;1;1;2
109;16.08.2017;2017;08;23;Keskiviikko;1;0;1;0;0;0
109;17.08.2017;2017;08;00;Torstai;1;2;3;0;1;1
109;17.08.2017;2017;08;01;Torstai;0;0;0;0;0;0
109;17.08.2017;2017;08;02;Torstai;1;0;1;0;0;0
109;17.08.2017;2017;08;03;Torstai;0;0;0;0;0;0
109;17.08.2017;2017;08;04;Torstai;0;0;0;0;0;0
109;17.08.2017;2017;08;05;Torstai;5;8;13;1;1;2
109;17.08.2017;2017;08;06;Torstai;28;16;44;5;1;6
109;17.08.2017;2017;08;07;Torstai;81;39;120;5;3;8
109;17.08.2017;2017;08;08;Torstai;44;19;63;4;5;9
109;17.08.2017;2017;08;09;Torstai;30;7;37;3;4;7
109;17.08.2017;2017;08;10;Torstai;11;11;22;2;2;4
109;17.08.2017;2017;08;11;Torstai;22;16;38;0;2;2
109;17.08.2017;2017;08;12;Torstai;28;15;43;2;3;5
109;17.08.2017;2017;08;13;Torstai;11;28;39;2;4;6
109;17.08.2017;2017;08;14;Torstai;15;20;35;1;1;2
109;17.08.2017;2017;08;15;Torstai;44;54;98;7;5;12
109;17.08.2017;2017;08;16;Torstai;42;77;119;3;1;4
109;17.08.2017;2017;08;17;Torstai;31;23;54;5;4;9
109;17.08.2017;2017;08;18;Torstai;35;16;51;6;4;10
109;17.08.2017;2017;08;19;Torstai;22;24;46;2;8;10
109;17.08.2017;2017;08;20;Torstai;9;23;32;6;5;11
109;17.08.2017;2017;08;21;Torstai;10;14;24;3;5;8
109;17.08.2017;2017;08;22;Torstai;6;5;11;3;1;4
109;17.08.2017;2017;08;23;Torstai;2;3;5;0;0;0
109;18.08.2017;2017;08;00;Perjantai;0;2;2;0;0;0
109;18.08.2017;2017;08;01;Perjantai;0;0;0;2;0;2
109;18.08.2017;2017;08;02;Perjantai;0;3;3;0;1;1
109;18.08.2017;2017;08;03;Perjantai;2;2;4;0;0;0
109;18.08.2017;2017;08;04;Perjantai;0;2;2;0;0;0
109;18.08.2017;2017;08;05;Perjantai;6;2;8;2;1;3
109;18.08.2017;2017;08;06;Perjantai;19;11;30;2;3;5
109;18.08.2017;2017;08;07;Perjantai;64;26;90;6;4;10
109;18.08.2017;2017;08;08;Perjantai;39;18;57;4;4;8
109;18.08.2017;2017;08;09;Perjantai;25;10;35;6;6;12
109;18.08.2017;2017;08;10;Perjantai;20;9;29;2;5;7
109;18.08.2017;2017;08;11;Perjantai;20;10;30;9;1;10
109;18.08.2017;2017;08;12;Perjantai;26;12;38;3;1;4
109;18.08.2017;2017;08;13;Perjantai;20;20;40;3;1;4
109;18.08.2017;2017;08;14;Perjantai;22;31;53;4;3;7
109;18.08.2017;2017;08;15;Perjantai;25;48;73;6;4;10
109;18.08.2017;2017;08;16;Perjantai;28;27;55;4;3;7
109;18.08.2017;2017;08;17;Perjantai;23;22;45;0;3;3
109;18.08.2017;2017;08;18;Perjantai;15;11;26;3;0;3
109;18.08.2017;2017;08;19;Perjantai;12;14;26;2;0;2
109;18.08.2017;2017;08;20;Perjantai;6;7;13;1;2;3
109;18.08.2017;2017;08;21;Perjantai;4;12;16;4;2;6
109;18.08.2017;2017;08;22;Perjantai;7;4;11;0;0;0
109;18.08.2017;2017;08;23;Perjantai;1;6;7;0;0;0
109;19.08.2017;2017;08;00;Lauantai;0;1;1;3;0;3
109;19.08.2017;2017;08;01;Lauantai;1;1;2;0;0;0
109;19.08.2017;2017;08;02;Lauantai;0;2;2;0;0;0
109;19.08.2017;2017;08;03;Lauantai;4;4;8;0;0;0
109;19.08.2017;2017;08;04;Lauantai;0;0;0;0;0;0
109;19.08.2017;2017;08;05;Lauantai;1;0;1;1;0;1
109;19.08.2017;2017;08;06;Lauantai;1;1;2;1;0;1
109;19.08.2017;2017;08;07;Lauantai;3;4;7;1;1;2
109;19.08.2017;2017;08;08;Lauantai;5;3;8;2;2;4
109;19.08.2017;2017;08;09;Lauantai;10;5;15;2;2;4
109;19.08.2017;2017;08;10;Lauantai;10;8;18;4;4;8
109;19.08.2017;2017;08;11;Lauantai;15;6;21;2;4;6
109;19.08.2017;2017;08;12;Lauantai;17;8;25;5;3;8
109;19.08.2017;2017;08;13;Lauantai;16;16;32;8;5;13
109;19.08.2017;2017;08;14;Lauantai;14;13;27;9;5;14
109;19.08.2017;2017;08;15;Lauantai;19;26;45;4;2;6
109;19.08.2017;2017;08;16;Lauantai;20;15;35;2;2;4
109;19.08.2017;2017;08;17;Lauantai;12;11;23;9;2;11
109;19.08.2017;2017;08;18;Lauantai;7;4;11;3;4;7
109;19.08.2017;2017;08;19;Lauantai;1;10;11;5;0;5
109;19.08.2017;2017;08;20;Lauantai;2;2;4;5;0;5
109;19.08.2017;2017;08;21;Lauantai;1;3;4;2;2;4
109;19.08.2017;2017;08;22;Lauantai;2;4;6;1;0;1
109;19.08.2017;2017;08;23;Lauantai;1;1;2;0;0;0
109;20.08.2017;2017;08;00;Sunnuntai;1;1;2;0;0;0
109;20.08.2017;2017;08;01;Sunnuntai;1;0;1;0;1;1
109;20.08.2017;2017;08;02;Sunnuntai;1;0;1;0;1;1
109;20.08.2017;2017;08;03;Sunnuntai;1;0;1;0;0;0
109;20.08.2017;2017;08;04;Sunnuntai;1;0;1;0;0;0
109;20.08.2017;2017;08;05;Sunnuntai;1;1;2;0;0;0
109;20.08.2017;2017;08;06;Sunnuntai;3;1;4;1;1;2
109;20.08.2017;2017;08;07;Sunnuntai;0;4;4;1;0;1
109;20.08.2017;2017;08;08;Sunnuntai;3;0;3;3;2;5
109;20.08.2017;2017;08;09;Sunnuntai;6;1;7;5;3;8
109;20.08.2017;2017;08;10;Sunnuntai;5;4;9;6;7;13
109;20.08.2017;2017;08;11;Sunnuntai;10;7;17;9;3;12
109;20.08.2017;2017;08;12;Sunnuntai;11;7;18;7;0;7
109;20.08.2017;2017;08;13;Sunnuntai;15;4;19;3;1;4
109;20.08.2017;2017;08;14;Sunnuntai;9;1;10;4;3;7
109;20.08.2017;2017;08;15;Sunnuntai;17;8;25;8;2;10
109;20.08.2017;2017;08;16;Sunnuntai;6;5;11;5;2;7
109;20.08.2017;2017;08;17;Sunnuntai;11;14;25;4;4;8
109;20.08.2017;2017;08;18;Sunnuntai;14;15;29;5;4;9
109;20.08.2017;2017;08;19;Sunnuntai;11;8;19;9;3;12
109;20.08.2017;2017;08;20;Sunnuntai;6;5;11;4;3;7
109;20.08.2017;2017;08;21;Sunnuntai;4;6;10;1;3;4
109;20.08.2017;2017;08;22;Sunnuntai;3;0;3;1;0;1
109;20.08.2017;2017;08;23;Sunnuntai;1;0;1;0;0;0
109;21.08.2017;2017;08;00;Maanantai;0;0;0;1;1;2
109;21.08.2017;2017;08;01;Maanantai;0;0;0;0;0;0
109;21.08.2017;2017;08;02;Maanantai;1;0;1;0;0;0
109;21.08.2017;2017;08;03;Maanantai;0;0;0;0;0;0
109;21.08.2017;2017;08;04;Maanantai;0;1;1;1;0;1
109;21.08.2017;2017;08;05;Maanantai;5;4;9;0;0;0
109;21.08.2017;2017;08;06;Maanantai;21;28;49;3;0;3
109;21.08.2017;2017;08;07;Maanantai;94;27;121;5;3;8
109;21.08.2017;2017;08;08;Maanantai;49;26;75;5;5;10
109;21.08.2017;2017;08;09;Maanantai;30;11;41;1;1;2
109;21.08.2017;2017;08;10;Maanantai;18;5;23;0;3;3
109;21.08.2017;2017;08;11;Maanantai;14;13;27;1;3;4
109;21.08.2017;2017;08;12;Maanantai;5;10;15;3;4;7
109;21.08.2017;2017;08;13;Maanantai;16;20;36;3;1;4
109;21.08.2017;2017;08;14;Maanantai;18;29;47;3;4;7
109;21.08.2017;2017;08;15;Maanantai;30;50;80;6;7;13
109;21.08.2017;2017;08;16;Maanantai;42;63;105;6;6;12
109;21.08.2017;2017;08;17;Maanantai;24;23;47;5;4;9
109;21.08.2017;2017;08;18;Maanantai;16;26;42;5;9;14
109;21.08.2017;2017;08;19;Maanantai;14;7;21;4;1;5
109;21.08.2017;2017;08;20;Maanantai;7;9;16;9;2;11
109;21.08.2017;2017;08;21;Maanantai;1;6;7;0;2;2
109;21.08.2017;2017;08;22;Maanantai;3;3;6;4;0;4
109;21.08.2017;2017;08;23;Maanantai;2;1;3;0;0;0
109;22.08.2017;2017;08;00;Tiistai;2;0;2;1;1;2
109;22.08.2017;2017;08;01;Tiistai;2;0;2;1;1;2
109;22.08.2017;2017;08;02;Tiistai;0;1;1;0;0;0
109;22.08.2017;2017;08;03;Tiistai;1;0;1;0;0;0
109;22.08.2017;2017;08;04;Tiistai;0;0;0;0;0;0
109;22.08.2017;2017;08;05;Tiistai;4;2;6;2;3;5
109;22.08.2017;2017;08;06;Tiistai;19;17;36;3;0;3
109;22.08.2017;2017;08;07;Tiistai;80;40;120;4;7;11
109;22.08.2017;2017;08;08;Tiistai;43;20;63;4;3;7
109;22.08.2017;2017;08;09;Tiistai;20;5;25;4;3;7
109;22.08.2017;2017;08;10;Tiistai;11;7;18;3;5;8
109;22.08.2017;2017;08;11;Tiistai;19;9;28;0;0;0
109;22.08.2017;2017;08;12;Tiistai;17;19;36;5;2;7
109;22.08.2017;2017;08;13;Tiistai;9;11;20;2;3;5
109;22.08.2017;2017;08;14;Tiistai;23;19;42;4;4;8
109;22.08.2017;2017;08;15;Tiistai;28;43;71;7;4;11
109;22.08.2017;2017;08;16;Tiistai;39;63;102;4;2;6
109;22.08.2017;2017;08;17;Tiistai;15;27;42;2;8;10
109;22.08.2017;2017;08;18;Tiistai;19;22;41;11;3;14
109;22.08.2017;2017;08;19;Tiistai;13;14;27;9;6;15
109;22.08.2017;2017;08;20;Tiistai;11;14;25;4;3;7
109;22.08.2017;2017;08;21;Tiistai;10;14;24;3;6;9
109;22.08.2017;2017;08;22;Tiistai;4;3;7;1;1;2
109;22.08.2017;2017;08;23;Tiistai;2;0;2;0;0;0
109;23.08.2017;2017;08;00;Keskiviikko;0;0;0;0;0;0
109;23.08.2017;2017;08;01;Keskiviikko;0;0;0;0;1;1
109;23.08.2017;2017;08;02;Keskiviikko;0;1;1;0;0;0
109;23.08.2017;2017;08;03;Keskiviikko;0;0;0;0;0;0
109;23.08.2017;2017;08;04;Keskiviikko;0;0;0;1;0;1
109;23.08.2017;2017;08;05;Keskiviikko;4;2;6;2;0;2
109;23.08.2017;2017;08;06;Keskiviikko;18;15;33;3;2;5
109;23.08.2017;2017;08;07;Keskiviikko;89;33;122;6;7;13
109;23.08.2017;2017;08;08;Keskiviikko;42;16;58;5;1;6
109;23.08.2017;2017;08;09;Keskiviikko;22;7;29;4;3;7
109;23.08.2017;2017;08;10;Keskiviikko;10;6;16;8;1;9
109;23.08.2017;2017;08;11;Keskiviikko;15;4;19;1;1;2
109;23.08.2017;2017;08;12;Keskiviikko;8;9;17;1;4;5
109;23.08.2017;2017;08;13;Keskiviikko;20;14;34;4;4;8
109;23.08.2017;2017;08;14;Keskiviikko;12;22;34;3;4;7
109;23.08.2017;2017;08;15;Keskiviikko;28;37;65;5;2;7
109;23.08.2017;2017;08;16;Keskiviikko;32;64;96;8;5;13
109;23.08.2017;2017;08;17;Keskiviikko;27;29;56;2;5;7
109;23.08.2017;2017;08;18;Keskiviikko;20;15;35;5;1;6
109;23.08.2017;2017;08;19;Keskiviikko;8;12;20;6;4;10
109;23.08.2017;2017;08;20;Keskiviikko;10;13;23;6;2;8
109;23.08.2017;2017;08;21;Keskiviikko;9;10;19;5;6;11
109;23.08.2017;2017;08;22;Keskiviikko;5;8;13;1;1;2
109;23.08.2017;2017;08;23;Keskiviikko;0;2;2;0;0;0
109;24.08.2017;2017;08;00;Torstai;0;0;0;0;1;1
109;24.08.2017;2017;08;01;Torstai;0;0;0;0;1;1
109;24.08.2017;2017;08;02;Torstai;0;0;0;1;0;1
109;24.08.2017;2017;08;03;Torstai;1;0;1;1;1;2
109;24.08.2017;2017;08;04;Torstai;0;0;0;1;0;1
109;24.08.2017;2017;08;05;Torstai;4;4;8;1;1;2
109;24.08.2017;2017;08;06;Torstai;21;17;38;1;0;1
109;24.08.2017;2017;08;07;Torstai;82;38;120;2;5;7
109;24.08.2017;2017;08;08;Torstai;50;18;68;5;3;8
109;24.08.2017;2017;08;09;Torstai;28;6;34;6;0;6
109;24.08.2017;2017;08;10;Torstai;14;6;20;6;1;7
109;24.08.2017;2017;08;11;Torstai;12;12;24;5;0;5
109;24.08.2017;2017;08;12;Torstai;12;15;27;2;3;5
109;24.08.2017;2017;08;13;Torstai;13;15;28;1;4;5
109;24.08.2017;2017;08;14;Torstai;22;20;42;6;0;6
109;24.08.2017;2017;08;15;Torstai;31;43;74;11;5;16
109;24.08.2017;2017;08;16;Torstai;38;53;91;5;3;8
109;24.08.2017;2017;08;17;Torstai;34;28;62;3;4;7
109;24.08.2017;2017;08;18;Torstai;10;21;31;3;5;8
109;24.08.2017;2017;08;19;Torstai;14;16;30;5;1;6
109;24.08.2017;2017;08;20;Torstai;8;9;17;5;10;15
109;24.08.2017;2017;08;21;Torstai;3;8;11;3;3;6
109;24.08.2017;2017;08;22;Torstai;2;5;7;5;2;7
109;24.08.2017;2017;08;23;Torstai;1;0;1;0;0;0
109;25.08.2017;2017;08;00;Perjantai;1;1;2;0;1;1
109;25.08.2017;2017;08;01;Perjantai;1;1;2;1;0;1
109;25.08.2017;2017;08;02;Perjantai;1;0;1;1;1;2
109;25.08.2017;2017;08;03;Perjantai;0;1;1;0;0;0
109;25.08.2017;2017;08;04;Perjantai;1;0;1;1;0;1
109;25.08.2017;2017;08;05;Perjantai;3;5;8;0;0;0
109;25.08.2017;2017;08;06;Perjantai;14;12;26;0;0;0
109;25.08.2017;2017;08;07;Perjantai;56;23;79;3;5;8
109;25.08.2017;2017;08;08;Perjantai;23;11;34;1;2;3
109;25.08.2017;2017;08;09;Perjantai;17;3;20;3;2;5
109;25.08.2017;2017;08;10;Perjantai;9;4;13;3;3;6
109;25.08.2017;2017;08;11;Perjantai;11;5;16;0;3;3
109;25.08.2017;2017;08;12;Perjantai;10;5;15;0;4;4
109;25.08.2017;2017;08;13;Perjantai;12;12;24;2;2;4
109;25.08.2017;2017;08;14;Perjantai;11;28;39;4;1;5
109;25.08.2017;2017;08;15;Perjantai;17;21;38;5;2;7
109;25.08.2017;2017;08;16;Perjantai;19;30;49;5;3;8
109;25.08.2017;2017;08;17;Perjantai;10;15;25;4;3;7
109;25.08.2017;2017;08;18;Perjantai;12;5;17;2;2;4
109;25.08.2017;2017;08;19;Perjantai;1;5;6;6;4;10
109;25.08.2017;2017;08;20;Perjantai;4;3;7;3;0;3
109;25.08.2017;2017;08;21;Perjantai;0;7;7;3;0;3
109;25.08.2017;2017;08;22;Perjantai;1;2;3;2;1;3
109;25.08.2017;2017;08;23;Perjantai;2;3;5;1;0;1
109;26.08.2017;2017;08;00;Lauantai;0;0;0;0;1;1
109;26.08.2017;2017;08;01;Lauantai;4;0;4;1;1;2
109;26.08.2017;2017;08;02;Lauantai;0;0;0;0;0;0
109;26.08.2017;2017;08;03;Lauantai;1;1;2;0;0;0
109;26.08.2017;2017;08;04;Lauantai;0;0;0;0;0;0
109;26.08.2017;2017;08;05;Lauantai;0;1;1;1;0;1
109;26.08.2017;2017;08;06;Lauantai;3;2;5;0;0;0
109;26.08.2017;2017;08;07;Lauantai;2;2;4;0;0;0
109;26.08.2017;2017;08;08;Lauantai;2;1;3;1;1;2
109;26.08.2017;2017;08;09;Lauantai;8;4;12;3;4;7
109;26.08.2017;2017;08;10;Lauantai;17;3;20;4;2;6
109;26.08.2017;2017;08;11;Lauantai;6;5;11;6;4;10
109;26.08.2017;2017;08;12;Lauantai;14;6;20;5;5;10
109;26.08.2017;2017;08;13;Lauantai;16;8;24;4;8;12
109;26.08.2017;2017;08;14;Lauantai;9;10;19;9;5;14
109;26.08.2017;2017;08;15;Lauantai;9;2;11;7;3;10
109;26.08.2017;2017;08;16;Lauantai;11;10;21;4;4;8
109;26.08.2017;2017;08;17;Lauantai;22;13;35;3;2;5
109;26.08.2017;2017;08;18;Lauantai;18;7;25;3;7;10
109;26.08.2017;2017;08;19;Lauantai;7;3;10;4;3;7
109;26.08.2017;2017;08;20;Lauantai;7;12;19;3;6;9
109;26.08.2017;2017;08;21;Lauantai;3;5;8;4;2;6
109;26.08.2017;2017;08;22;Lauantai;3;4;7;2;1;3
109;26.08.2017;2017;08;23;Lauantai;3;5;8;0;0;0
109;27.08.2017;2017;08;00;Sunnuntai;0;11;11;2;0;2
109;27.08.2017;2017;08;01;Sunnuntai;0;3;3;0;1;1
109;27.08.2017;2017;08;02;Sunnuntai;0;0;0;0;0;0
109;27.08.2017;2017;08;03;Sunnuntai;0;0;0;0;0;0
109;27.08.2017;2017;08;04;Sunnuntai;1;1;2;0;0;0
109;27.08.2017;2017;08;05;Sunnuntai;3;0;3;0;0;0
109;27.08.2017;2017;08;06;Sunnuntai;1;0;1;1;0;1
109;27.08.2017;2017;08;07;Sunnuntai;2;2;4;1;1;2
109;27.08.2017;2017;08;08;Sunnuntai;0;1;1;2;2;4
109;27.08.2017;2017;08;09;Sunnuntai;5;5;10;5;1;6
109;27.08.2017;2017;08;10;Sunnuntai;13;3;16;6;2;8
109;27.08.2017;2017;08;11;Sunnuntai;12;7;19;2;0;2
109;27.08.2017;2017;08;12;Sunnuntai;18;10;28;8;2;10
109;27.08.2017;2017;08;13;Sunnuntai;17;11;28;3;4;7
109;27.08.2017;2017;08;14;Sunnuntai;8;6;14;8;1;9
109;27.08.2017;2017;08;15;Sunnuntai;10;10;20;9;1;10
109;27.08.2017;2017;08;16;Sunnuntai;8;10;18;6;1;7
109;27.08.2017;2017;08;17;Sunnuntai;17;9;26;6;2;8
109;27.08.2017;2017;08;18;Sunnuntai;12;6;18;5;2;7
109;27.08.2017;2017;08;19;Sunnuntai;13;6;19;6;2;8
109;27.08.2017;2017;08;20;Sunnuntai;4;3;7;2;2;4
109;27.08.2017;2017;08;21;Sunnuntai;3;9;12;2;1;3
109;27.08.2017;2017;08;22;Sunnuntai;3;0;3;1;0;1
109;27.08.2017;2017;08;23;Sunnuntai;2;2;4;1;0;1
109;28.08.2017;2017;08;00;Maanantai;0;0;0;0;0;0
109;28.08.2017;2017;08;01;Maanantai;0;0;0;0;3;3
109;28.08.2017;2017;08;02;Maanantai;0;0;0;0;0;0
109;28.08.2017;2017;08;03;Maanantai;0;0;0;0;0;0
109;28.08.2017;2017;08;04;Maanantai;0;0;0;0;0;0
109;28.08.2017;2017;08;05;Maanantai;3;1;4;1;0;1
109;28.08.2017;2017;08;06;Maanantai;18;16;34;6;0;6
109;28.08.2017;2017;08;07;Maanantai;78;32;110;4;8;12
109;28.08.2017;2017;08;08;Maanantai;35;17;52;3;2;5
109;28.08.2017;2017;08;09;Maanantai;18;5;23;4;3;7
109;28.08.2017;2017;08;10;Maanantai;10;11;21;3;1;4
109;28.08.2017;2017;08;11;Maanantai;14;9;23;5;2;7
109;28.08.2017;2017;08;12;Maanantai;12;7;19;8;8;16
109;28.08.2017;2017;08;13;Maanantai;24;14;38;5;5;10
109;28.08.2017;2017;08;14;Maanantai;15;23;38;3;2;5
109;28.08.2017;2017;08;15;Maanantai;36;53;89;4;4;8
109;28.08.2017;2017;08;16;Maanantai;31;55;86;8;9;17
109;28.08.2017;2017;08;17;Maanantai;14;26;40;7;6;13
109;28.08.2017;2017;08;18;Maanantai;22;11;33;10;5;15
109;28.08.2017;2017;08;19;Maanantai;12;15;27;1;4;5
109;28.08.2017;2017;08;20;Maanantai;19;13;32;11;9;20
109;28.08.2017;2017;08;21;Maanantai;12;8;20;5;2;7
109;28.08.2017;2017;08;22;Maanantai;3;2;5;0;0;0
109;28.08.2017;2017;08;23;Maanantai;1;0;1;0;0;0
109;29.08.2017;2017;08;00;Tiistai;0;1;1;0;0;0
109;29.08.2017;2017;08;01;Tiistai;0;0;0;0;2;2
109;29.08.2017;2017;08;02;Tiistai;0;0;0;0;0;0
109;29.08.2017;2017;08;03;Tiistai;0;0;0;0;0;0
109;29.08.2017;2017;08;04;Tiistai;0;0;0;1;0;1
109;29.08.2017;2017;08;05;Tiistai;2;2;4;0;0;0
109;29.08.2017;2017;08;06;Tiistai;19;17;36;1;0;1
109;29.08.2017;2017;08;07;Tiistai;72;36;108;4;9;13
109;29.08.2017;2017;08;08;Tiistai;50;17;67;7;2;9
109;29.08.2017;2017;08;09;Tiistai;22;9;31;2;2;4
109;29.08.2017;2017;08;10;Tiistai;17;8;25;3;1;4
109;29.08.2017;2017;08;11;Tiistai;16;16;32;5;3;8
109;29.08.2017;2017;08;12;Tiistai;10;8;18;6;2;8
109;29.08.2017;2017;08;13;Tiistai;13;20;33;5;4;9
109;29.08.2017;2017;08;14;Tiistai;20;23;43;5;3;8
109;29.08.2017;2017;08;15;Tiistai;24;35;59;3;5;8
109;29.08.2017;2017;08;16;Tiistai;26;51;77;5;7;12
109;29.08.2017;2017;08;17;Tiistai;13;23;36;3;1;4
109;29.08.2017;2017;08;18;Tiistai;10;4;14;1;4;5
109;29.08.2017;2017;08;19;Tiistai;4;10;14;3;2;5
109;29.08.2017;2017;08;20;Tiistai;5;6;11;6;5;11
109;29.08.2017;2017;08;21;Tiistai;3;3;6;2;2;4
109;29.08.2017;2017;08;22;Tiistai;4;0;4;3;0;3
109;29.08.2017;2017;08;23;Tiistai;0;1;1;2;3;5
109;30.08.2017;2017;08;00;Keskiviikko;0;1;1;0;0;0
109;30.08.2017;2017;08;01;Keskiviikko;0;2;2;0;0;0
109;30.08.2017;2017;08;02;Keskiviikko;2;0;2;0;0;0
109;30.08.2017;2017;08;03;Keskiviikko;0;0;0;0;0;0
109;30.08.2017;2017;08;04;Keskiviikko;0;1;1;0;0;0
109;30.08.2017;2017;08;05;Keskiviikko;2;0;2;1;0;1
109;30.08.2017;2017;08;06;Keskiviikko;14;10;24;1;0;1
109;30.08.2017;2017;08;07;Keskiviikko;45;21;66;2;1;3
109;30.08.2017;2017;08;08;Keskiviikko;31;7;38;4;2;6
109;30.08.2017;2017;08;09;Keskiviikko;14;3;17;2;0;2
109;30.08.2017;2017;08;10;Keskiviikko;5;3;8;2;0;2
109;30.08.2017;2017;08;11;Keskiviikko;6;2;8;0;0;0
109;30.08.2017;2017;08;12;Keskiviikko;5;5;10;0;2;2
109;30.08.2017;2017;08;13;Keskiviikko;15;9;24;4;0;4
109;30.08.2017;2017;08;14;Keskiviikko;14;11;25;5;2;7
109;30.08.2017;2017;08;15;Keskiviikko;24;22;46;6;1;7
109;30.08.2017;2017;08;16;Keskiviikko;34;41;75;4;2;6
109;30.08.2017;2017;08;17;Keskiviikko;15;22;37;2;3;5
109;30.08.2017;2017;08;18;Keskiviikko;15;10;25;6;1;7
109;30.08.2017;2017;08;19;Keskiviikko;10;5;15;7;4;11
109;30.08.2017;2017;08;20;Keskiviikko;12;6;18;7;3;10
109;30.08.2017;2017;08;21;Keskiviikko;9;7;16;5;3;8
109;30.08.2017;2017;08;22;Keskiviikko;4;3;7;3;2;5
109;30.08.2017;2017;08;23;Keskiviikko;0;0;0;2;0;2
109;31.08.2017;2017;08;00;Torstai;1;0;1;0;1;1
109;31.08.2017;2017;08;01;Torstai;1;0;1;0;0;0
109;31.08.2017;2017;08;02;Torstai;0;2;2;0;0;0
109;31.08.2017;2017;08;03;Torstai;0;0;0;0;0;0
109;31.08.2017;2017;08;04;Torstai;0;0;0;0;1;1
109;31.08.2017;2017;08;05;Torstai;2;2;4;2;0;2
109;31.08.2017;2017;08;06;Torstai;22;18;40;3;1;4
109;31.08.2017;2017;08;07;Torstai;83;34;117;3;6;9
109;31.08.2017;2017;08;08;Torstai;53;18;71;2;1;3
109;31.08.2017;2017;08;09;Torstai;23;10;33;4;6;10
109;31.08.2017;2017;08;10;Torstai;12;9;21;4;5;9
109;31.08.2017;2017;08;11;Torstai;16;12;28;1;1;2
109;31.08.2017;2017;08;12;Torstai;17;17;34;4;2;6
109;31.08.2017;2017;08;13;Torstai;16;26;42;2;4;6
109;31.08.2017;2017;08;14;Torstai;24;19;43;5;6;11
109;31.08.2017;2017;08;15;Torstai;36;44;80;2;3;5
109;31.08.2017;2017;08;16;Torstai;39;61;100;5;5;10
109;31.08.2017;2017;08;17;Torstai;25;22;47;4;8;12
109;31.08.2017;2017;08;18;Torstai;16;18;34;5;2;7
109;31.08.2017;2017;08;19;Torstai;4;13;17;11;1;12
109;31.08.2017;2017;08;20;Torstai;7;9;16;7;3;10
109;31.08.2017;2017;08;21;Torstai;12;3;15;4;3;7
109;31.08.2017;2017;08;22;Torstai;7;1;8;2;3;5
109;31.08.2017;2017;08;23;Torstai;0;3;3;1;3;4
109;01.09.2017;2017;09;00;Perjantai;0;0;0;1;0;1
109;01.09.2017;2017;09;01;Perjantai;0;1;1;0;0;0
109;01.09.2017;2017;09;02;Perjantai;0;0;0;0;0;0
109;01.09.2017;2017;09;03;Perjantai;0;0;0;0;0;0
109;01.09.2017;2017;09;04;Perjantai;0;0;0;0;0;0
109;01.09.2017;2017;09;05;Perjantai;2;4;6;0;0;0
109;01.09.2017;2017;09;06;Perjantai;8;9;17;2;0;2
109;01.09.2017;2017;09;07;Perjantai;26;22;48;0;2;2
109;01.09.2017;2017;09;08;Perjantai;25;7;32;0;1;1
109;01.09.2017;2017;09;09;Perjantai;7;5;12;3;1;4
109;01.09.2017;2017;09;10;Perjantai;1;2;3;4;2;6
109;01.09.2017;2017;09;11;Perjantai;6;4;10;4;0;4
109;01.09.2017;2017;09;12;Perjantai;4;1;5;1;4;5
109;01.09.2017;2017;09;13;Perjantai;5;6;11;2;2;4
109;01.09.2017;2017;09;14;Perjantai;7;15;22;6;3;9
109;01.09.2017;2017;09;15;Perjantai;13;15;28;3;2;5
109;01.09.2017;2017;09;16;Perjantai;17;19;36;1;1;2
109;01.09.2017;2017;09;17;Perjantai;12;7;19;3;4;7
109;01.09.2017;2017;09;18;Perjantai;6;6;12;4;2;6
109;01.09.2017;2017;09;19;Perjantai;4;3;7;4;5;9
109;01.09.2017;2017;09;20;Perjantai;1;5;6;10;2;12
109;01.09.2017;2017;09;21;Perjantai;3;5;8;2;2;4
109;01.09.2017;2017;09;22;Perjantai;2;2;4;1;0;1
109;01.09.2017;2017;09;23;Perjantai;2;0;2;1;1;2
109;02.09.2017;2017;09;00;Lauantai;1;0;1;0;0;0
109;02.09.2017;2017;09;01;Lauantai;1;0;1;0;1;1
109;02.09.2017;2017;09;02;Lauantai;0;1;1;0;0;0
109;02.09.2017;2017;09;03;Lauantai;0;0;0;0;0;0
109;02.09.2017;2017;09;04;Lauantai;0;0;0;0;2;2
109;02.09.2017;2017;09;05;Lauantai;0;0;0;0;0;0
109;02.09.2017;2017;09;06;Lauantai;3;3;6;2;0;2
109;02.09.2017;2017;09;07;Lauantai;4;2;6;0;0;0
109;02.09.2017;2017;09;08;Lauantai;5;4;9;4;2;6
109;02.09.2017;2017;09;09;Lauantai;5;6;11;4;7;11
109;02.09.2017;2017;09;10;Lauantai;8;1;9;4;1;5
109;02.09.2017;2017;09;11;Lauantai;12;10;22;4;3;7
109;02.09.2017;2017;09;12;Lauantai;15;6;21;3;1;4
109;02.09.2017;2017;09;13;Lauantai;10;5;15;2;3;5
109;02.09.2017;2017;09;14;Lauantai;7;19;26;8;1;9
109;02.09.2017;2017;09;15;Lauantai;17;11;28;5;9;14
109;02.09.2017;2017;09;16;Lauantai;9;12;21;7;5;12
109;02.09.2017;2017;09;17;Lauantai;4;3;7;4;5;9
109;02.09.2017;2017;09;18;Lauantai;11;7;18;4;2;6
109;02.09.2017;2017;09;19;Lauantai;13;4;17;4;6;10
109;02.09.2017;2017;09;20;Lauantai;9;7;16;3;2;5
109;02.09.2017;2017;09;21;Lauantai;5;9;14;2;2;4
109;02.09.2017;2017;09;22;Lauantai;4;3;7;1;0;1
109;02.09.2017;2017;09;23;Lauantai;2;2;4;1;0;1
109;03.09.2017;2017;09;00;Sunnuntai;0;2;2;0;0;0
109;03.09.2017;2017;09;01;Sunnuntai;1;5;6;0;2;2
109;03.09.2017;2017;09;02;Sunnuntai;1;6;7;0;0;0
109;03.09.2017;2017;09;03;Sunnuntai;0;3;3;0;1;1
109;03.09.2017;2017;09;04;Sunnuntai;0;0;0;1;0;1
109;03.09.2017;2017;09;05;Sunnuntai;1;0;1;0;1;1
109;03.09.2017;2017;09;06;Sunnuntai;3;1;4;2;1;3
109;03.09.2017;2017;09;07;Sunnuntai;0;2;2;3;2;5
109;03.09.2017;2017;09;08;Sunnuntai;1;2;3;2;2;4
109;03.09.2017;2017;09;09;Sunnuntai;4;4;8;3;1;4
109;03.09.2017;2017;09;10;Sunnuntai;9;2;11;3;3;6
109;03.09.2017;2017;09;11;Sunnuntai;10;8;18;9;2;11
109;03.09.2017;2017;09;12;Sunnuntai;12;10;22;4;2;6
109;03.09.2017;2017;09;13;Sunnuntai;12;3;15;9;8;17
109;03.09.2017;2017;09;14;Sunnuntai;9;12;21;4;3;7
109;03.09.2017;2017;09;15;Sunnuntai;19;15;34;4;3;7
109;03.09.2017;2017;09;16;Sunnuntai;16;18;34;2;6;8
109;03.09.2017;2017;09;17;Sunnuntai;19;8;27;5;4;9
109;03.09.2017;2017;09;18;Sunnuntai;11;10;21;8;5;13
109;03.09.2017;2017;09;19;Sunnuntai;8;20;28;8;3;11
109;03.09.2017;2017;09;20;Sunnuntai;2;4;6;8;2;10
109;03.09.2017;2017;09;21;Sunnuntai;2;7;9;2;1;3
109;03.09.2017;2017;09;22;Sunnuntai;2;1;3;3;2;5
109;03.09.2017;2017;09;23;Sunnuntai;0;0;0;0;1;1
109;04.09.2017;2017;09;00;Maanantai;0;0;0;0;0;0
109;04.09.2017;2017;09;01;Maanantai;0;1;1;0;0;0
109;04.09.2017;2017;09;02;Maanantai;1;0;1;0;0;0
109;04.09.2017;2017;09;03;Maanantai;0;1;1;0;0;0
109;04.09.2017;2017;09;04;Maanantai;0;1;1;0;0;0
109;04.09.2017;2017;09;05;Maanantai;5;2;7;1;0;1
109;04.09.2017;2017;09;06;Maanantai;28;17;45;2;0;2
109;04.09.2017;2017;09;07;Maanantai;89;30;119;3;9;12
109;04.09.2017;2017;09;08;Maanantai;51;18;69;3;3;6
109;04.09.2017;2017;09;09;Maanantai;22;7;29;7;2;9
109;04.09.2017;2017;09;10;Maanantai;13;8;21;4;1;5
109;04.09.2017;2017;09;11;Maanantai;14;11;25;2;1;3
109;04.09.2017;2017;09;12;Maanantai;16;16;32;5;2;7
109;04.09.2017;2017;09;13;Maanantai;21;13;34;6;1;7
109;04.09.2017;2017;09;14;Maanantai;15;35;50;4;0;4
109;04.09.2017;2017;09;15;Maanantai;23;58;81;4;0;4
109;04.09.2017;2017;09;16;Maanantai;50;72;122;4;2;6
109;04.09.2017;2017;09;17;Maanantai;19;31;50;3;4;7
109;04.09.2017;2017;09;18;Maanantai;25;17;42;4;5;9
109;04.09.2017;2017;09;19;Maanantai;8;20;28;7;9;16
109;04.09.2017;2017;09;20;Maanantai;14;17;31;3;2;5
109;04.09.2017;2017;09;21;Maanantai;8;10;18;1;3;4
109;04.09.2017;2017;09;22;Maanantai;10;4;14;4;2;6
109;04.09.2017;2017;09;23;Maanantai;1;0;1;0;0;0
109;05.09.2017;2017;09;00;Tiistai;3;2;5;0;2;2
109;05.09.2017;2017;09;01;Tiistai;1;1;2;0;0;0
109;05.09.2017;2017;09;02;Tiistai;1;0;1;0;0;0
109;05.09.2017;2017;09;03;Tiistai;0;0;0;0;0;0
109;05.09.2017;2017;09;04;Tiistai;0;0;0;0;0;0
109;05.09.2017;2017;09;05;Tiistai;6;5;11;2;0;2
109;05.09.2017;2017;09;06;Tiistai;24;16;40;2;0;2
109;05.09.2017;2017;09;07;Tiistai;86;35;121;2;7;9
109;05.09.2017;2017;09;08;Tiistai;37;21;58;2;5;7
109;05.09.2017;2017;09;09;Tiistai;24;8;32;5;0;5
109;05.09.2017;2017;09;10;Tiistai;11;7;18;4;3;7
109;05.09.2017;2017;09;11;Tiistai;20;19;39;4;9;13
109;05.09.2017;2017;09;12;Tiistai;14;10;24;6;1;7
109;05.09.2017;2017;09;13;Tiistai;18;14;32;1;7;8
109;05.09.2017;2017;09;14;Tiistai;23;34;57;4;2;6
109;05.09.2017;2017;09;15;Tiistai;36;33;69;8;2;10
109;05.09.2017;2017;09;16;Tiistai;28;70;98;3;3;6
109;05.09.2017;2017;09;17;Tiistai;22;16;38;8;3;11
109;05.09.2017;2017;09;18;Tiistai;19;16;35;8;7;15
109;05.09.2017;2017;09;19;Tiistai;11;11;22;6;4;10
109;05.09.2017;2017;09;20;Tiistai;18;11;29;6;6;12
109;05.09.2017;2017;09;21;Tiistai;6;10;16;1;0;1
109;05.09.2017;2017;09;22;Tiistai;3;1;4;2;3;5
109;05.09.2017;2017;09;23;Tiistai;0;0;0;0;0;0
109;06.09.2017;2017;09;00;Keskiviikko;1;1;2;0;0;0
109;06.09.2017;2017;09;01;Keskiviikko;0;0;0;0;1;1
109;06.09.2017;2017;09;02;Keskiviikko;0;0;0;0;0;0
109;06.09.2017;2017;09;03;Keskiviikko;0;0;0;0;0;0
109;06.09.2017;2017;09;04;Keskiviikko;0;2;2;0;0;0
109;06.09.2017;2017;09;05;Keskiviikko;6;2;8;1;0;1
109;06.09.2017;2017;09;06;Keskiviikko;23;17;40;3;0;3
109;06.09.2017;2017;09;07;Keskiviikko;83;28;111;3;6;9
109;06.09.2017;2017;09;08;Keskiviikko;48;17;65;3;5;8
109;06.09.2017;2017;09;09;Keskiviikko;27;10;37;1;3;4
109;06.09.2017;2017;09;10;Keskiviikko;10;5;15;6;4;10
109;06.09.2017;2017;09;11;Keskiviikko;15;13;28;3;5;8
109;06.09.2017;2017;09;12;Keskiviikko;20;13;33;1;4;5
109;06.09.2017;2017;09;13;Keskiviikko;18;23;41;2;4;6
109;06.09.2017;2017;09;14;Keskiviikko;18;29;47;1;8;9
109;06.09.2017;2017;09;15;Keskiviikko;30;42;72;8;3;11
109;06.09.2017;2017;09;16;Keskiviikko;26;61;87;6;0;6
109;06.09.2017;2017;09;17;Keskiviikko;19;23;42;3;2;5
109;06.09.2017;2017;09;18;Keskiviikko;17;21;38;8;14;22
109;06.09.2017;2017;09;19;Keskiviikko;9;14;23;13;7;20
109;06.09.2017;2017;09;20;Keskiviikko;7;9;16;2;5;7
109;06.09.2017;2017;09;21;Keskiviikko;5;8;13;3;2;5
109;06.09.2017;2017;09;22;Keskiviikko;4;6;10;1;0;1
109;06.09.2017;2017;09;23;Keskiviikko;2;0;2;0;1;1
109;07.09.2017;2017;09;00;Torstai;2;1;3;0;1;1
109;07.09.2017;2017;09;01;Torstai;1;1;2;0;0;0
109;07.09.2017;2017;09;02;Torstai;0;3;3;0;0;0
109;07.09.2017;2017;09;03;Torstai;0;0;0;0;0;0
109;07.09.2017;2017;09;04;Torstai;0;1;1;0;0;0
109;07.09.2017;2017;09;05;Torstai;4;3;7;1;0;1
109;07.09.2017;2017;09;06;Torstai;21;17;38;4;0;4
109;07.09.2017;2017;09;07;Torstai;82;29;111;2;5;7
109;07.09.2017;2017;09;08;Torstai;43;18;61;0;3;3
109;07.09.2017;2017;09;09;Torstai;22;11;33;3;3;6
109;07.09.2017;2017;09;10;Torstai;13;4;17;6;3;9
109;07.09.2017;2017;09;11;Torstai;10;14;24;1;4;5
109;07.09.2017;2017;09;12;Torstai;11;7;18;7;3;10
109;07.09.2017;2017;09;13;Torstai;15;21;36;1;2;3
109;07.09.2017;2017;09;14;Torstai;15;22;37;5;4;9
109;07.09.2017;2017;09;15;Torstai;26;36;62;7;2;9
109;07.09.2017;2017;09;16;Torstai;35;59;94;8;3;11
109;07.09.2017;2017;09;17;Torstai;21;26;47;3;2;5
109;07.09.2017;2017;09;18;Torstai;10;13;23;2;3;5
109;07.09.2017;2017;09;19;Torstai;9;10;19;7;6;13
109;07.09.2017;2017;09;20;Torstai;5;9;14;8;4;12
109;07.09.2017;2017;09;21;Torstai;2;7;9;1;0;1
109;07.09.2017;2017;09;22;Torstai;4;2;6;1;0;1
109;07.09.2017;2017;09;23;Torstai;0;0;0;0;0;0
109;08.09.2017;2017;09;00;Perjantai;1;1;2;0;1;1
109;08.09.2017;2017;09;01;Perjantai;0;0;0;0;0;0
109;08.09.2017;2017;09;02;Perjantai;1;1;2;0;0;0
109;08.09.2017;2017;09;03;Perjantai;0;2;2;0;0;0
109;08.09.2017;2017;09;04;Perjantai;0;2;2;0;0;0
109;08.09.2017;2017;09;05;Perjantai;5;0;5;1;0;1
109;08.09.2017;2017;09;06;Perjantai;14;10;24;3;0;3
109;08.09.2017;2017;09;07;Perjantai;37;23;60;2;3;5
109;08.09.2017;2017;09;08;Perjantai;24;10;34;5;1;6
109;08.09.2017;2017;09;09;Perjantai;18;1;19;5;3;8
109;08.09.2017;2017;09;10;Perjantai;11;3;14;3;3;6
109;08.09.2017;2017;09;11;Perjantai;4;12;16;4;1;5
109;08.09.2017;2017;09;12;Perjantai;13;8;21;2;5;7
109;08.09.2017;2017;09;13;Perjantai;14;18;32;3;5;8
109;08.09.2017;2017;09;14;Perjantai;9;25;34;5;2;7
109;08.09.2017;2017;09;15;Perjantai;18;22;40;5;3;8
109;08.09.2017;2017;09;16;Perjantai;21;28;49;3;2;5
109;08.09.2017;2017;09;17;Perjantai;11;10;21;1;4;5
109;08.09.2017;2017;09;18;Perjantai;3;5;8;1;2;3
109;08.09.2017;2017;09;19;Perjantai;1;1;2;8;2;10
109;08.09.2017;2017;09;20;Perjantai;7;3;10;7;4;11
109;08.09.2017;2017;09;21;Perjantai;2;11;13;2;0;2
109;08.09.2017;2017;09;22;Perjantai;6;0;6;3;2;5
109;08.09.2017;2017;09;23;Perjantai;4;0;4;4;2;6
109;09.09.2017;2017;09;00;Lauantai;3;2;5;0;0;0
109;09.09.2017;2017;09;01;Lauantai;1;1;2;0;2;2
109;09.09.2017;2017;09;02;Lauantai;1;1;2;0;0;0
109;09.09.2017;2017;09;03;Lauantai;0;0;0;0;0;0
109;09.09.2017;2017;09;04;Lauantai;1;0;1;0;0;0
109;09.09.2017;2017;09;05;Lauantai;0;1;1;1;0;1
109;09.09.2017;2017;09;06;Lauantai;0;1;1;1;0;1
109;09.09.2017;2017;09;07;Lauantai;4;3;7;2;1;3
109;09.09.2017;2017;09;08;Lauantai;3;5;8;2;2;4
109;09.09.2017;2017;09;09;Lauantai;8;2;10;4;5;9
109;09.09.2017;2017;09;10;Lauantai;8;2;10;4;7;11
109;09.09.2017;2017;09;11;Lauantai;5;7;12;4;2;6
109;09.09.2017;2017;09;12;Lauantai;12;2;14;1;5;6
109;09.09.2017;2017;09;13;Lauantai;3;4;7;4;9;13
109;09.09.2017;2017;09;14;Lauantai;13;5;18;5;1;6
109;09.09.2017;2017;09;15;Lauantai;7;5;12;5;1;6
109;09.09.2017;2017;09;16;Lauantai;7;16;23;2;4;6
109;09.09.2017;2017;09;17;Lauantai;8;9;17;7;3;10
109;09.09.2017;2017;09;18;Lauantai;13;13;26;7;4;11
109;09.09.2017;2017;09;19;Lauantai;9;4;13;2;3;5
109;09.09.2017;2017;09;20;Lauantai;4;5;9;4;0;4
109;09.09.2017;2017;09;21;Lauantai;9;4;13;0;0;0
109;09.09.2017;2017;09;22;Lauantai;3;1;4;2;3;5
109;09.09.2017;2017;09;23;Lauantai;0;3;3;1;0;1
109;10.09.2017;2017;09;00;Sunnuntai;1;1;2;1;0;1
109;10.09.2017;2017;09;01;Sunnuntai;0;0;0;0;0;0
109;10.09.2017;2017;09;02;Sunnuntai;0;0;0;0;0;0
109;10.09.2017;2017;09;03;Sunnuntai;2;0;2;0;0;0
109;10.09.2017;2017;09;04;Sunnuntai;0;0;0;0;0;0
109;10.09.2017;2017;09;05;Sunnuntai;1;1;2;0;1;1
109;10.09.2017;2017;09;06;Sunnuntai;2;1;3;1;0;1
109;10.09.2017;2017;09;07;Sunnuntai;0;4;4;1;1;2
109;10.09.2017;2017;09;08;Sunnuntai;4;1;5;5;0;5
109;10.09.2017;2017;09;09;Sunnuntai;1;2;3;1;1;2
109;10.09.2017;2017;09;10;Sunnuntai;7;1;8;4;1;5
109;10.09.2017;2017;09;11;Sunnuntai;3;0;3;0;1;1
109;10.09.2017;2017;09;12;Sunnuntai;1;2;3;1;1;2
109;10.09.2017;2017;09;13;Sunnuntai;3;0;3;2;1;3
109;10.09.2017;2017;09;14;Sunnuntai;5;1;6;7;2;9
109;10.09.2017;2017;09;15;Sunnuntai;6;2;8;2;0;2
109;10.09.2017;2017;09;16;Sunnuntai;3;1;4;1;0;1
109;10.09.2017;2017;09;17;Sunnuntai;7;2;9;5;0;5
109;10.09.2017;2017;09;18;Sunnuntai;5;0;5;6;1;7
109;10.09.2017;2017;09;19;Sunnuntai;7;3;10;3;2;5
109;10.09.2017;2017;09;20;Sunnuntai;1;0;1;1;0;1
109;10.09.2017;2017;09;21;Sunnuntai;2;2;4;1;0;1
109;10.09.2017;2017;09;22;Sunnuntai;0;0;0;1;0;1
109;10.09.2017;2017;09;23;Sunnuntai;0;0;0;0;0;0
109;11.09.2017;2017;09;00;Maanantai;0;2;2;0;1;1
109;11.09.2017;2017;09;01;Maanantai;1;1;2;1;2;3
109;11.09.2017;2017;09;02;Maanantai;0;0;0;0;0;0
109;11.09.2017;2017;09;03;Maanantai;0;0;0;1;0;1
109;11.09.2017;2017;09;04;Maanantai;0;1;1;0;0;0
109;11.09.2017;2017;09;05;Maanantai;5;0;5;1;0;1
109;11.09.2017;2017;09;06;Maanantai;18;9;27;1;1;2
109;11.09.2017;2017;09;07;Maanantai;77;37;114;3;4;7
109;11.09.2017;2017;09;08;Maanantai;48;13;61;2;4;6
109;11.09.2017;2017;09;09;Maanantai;26;5;31;3;4;7
109;11.09.2017;2017;09;10;Maanantai;23;3;26;3;3;6
109;11.09.2017;2017;09;11;Maanantai;23;12;35;1;2;3
109;11.09.2017;2017;09;12;Maanantai;13;9;22;2;1;3
109;11.09.2017;2017;09;13;Maanantai;9;17;26;3;5;8
109;11.09.2017;2017;09;14;Maanantai;15;28;43;4;5;9
109;11.09.2017;2017;09;15;Maanantai;25;41;66;6;7;13
109;11.09.2017;2017;09;16;Maanantai;36;68;104;10;3;13
109;11.09.2017;2017;09;17;Maanantai;19;18;37;7;5;12
109;11.09.2017;2017;09;18;Maanantai;20;9;29;9;5;14
109;11.09.2017;2017;09;19;Maanantai;14;21;35;5;4;9
109;11.09.2017;2017;09;20;Maanantai;6;12;18;6;2;8
109;11.09.2017;2017;09;21;Maanantai;5;6;11;2;0;2
109;11.09.2017;2017;09;22;Maanantai;9;2;11;2;0;2
109;11.09.2017;2017;09;23;Maanantai;3;1;4;0;0;0
109;12.09.2017;2017;09;00;Tiistai;0;1;1;0;3;3
109;12.09.2017;2017;09;01;Tiistai;0;0;0;0;0;0
109;12.09.2017;2017;09;02;Tiistai;1;1;2;0;0;0
109;12.09.2017;2017;09;03;Tiistai;0;0;0;0;0;0
109;12.09.2017;2017;09;04;Tiistai;0;0;0;0;0;0
109;12.09.2017;2017;09;05;Tiistai;4;4;8;2;1;3
109;12.09.2017;2017;09;06;Tiistai;21;14;35;5;1;6
109;12.09.2017;2017;09;07;Tiistai;74;32;106;5;3;8
109;12.09.2017;2017;09;08;Tiistai;42;16;58;1;4;5
109;12.09.2017;2017;09;09;Tiistai;28;5;33;4;1;5
109;12.09.2017;2017;09;10;Tiistai;13;3;16;2;1;3
109;12.09.2017;2017;09;11;Tiistai;17;10;27;3;5;8
109;12.09.2017;2017;09;12;Tiistai;11;9;20;5;3;8
109;12.09.2017;2017;09;13;Tiistai;13;12;25;3;4;7
109;12.09.2017;2017;09;14;Tiistai;10;21;31;1;3;4
109;12.09.2017;2017;09;15;Tiistai;19;37;56;5;1;6
109;12.09.2017;2017;09;16;Tiistai;33;45;78;4;2;6
109;12.09.2017;2017;09;17;Tiistai;11;22;33;2;2;4
109;12.09.2017;2017;09;18;Tiistai;4;9;13;3;1;4
109;12.09.2017;2017;09;19;Tiistai;2;6;8;5;0;5
109;12.09.2017;2017;09;20;Tiistai;6;7;13;4;2;6
109;12.09.2017;2017;09;21;Tiistai;5;10;15;1;0;1
109;12.09.2017;2017;09;22;Tiistai;5;4;9;1;1;2
109;12.09.2017;2017;09;23;Tiistai;2;0;2;1;0;1
109;13.09.2017;2017;09;00;Keskiviikko;0;0;0;0;1;1
109;13.09.2017;2017;09;01;Keskiviikko;0;1;1;1;0;1
109;13.09.2017;2017;09;02;Keskiviikko;1;0;1;0;0;0
109;13.09.2017;2017;09;03;Keskiviikko;0;0;0;0;0;0
109;13.09.2017;2017;09;04;Keskiviikko;1;3;4;0;0;0
109;13.09.2017;2017;09;05;Keskiviikko;4;3;7;2;0;2
109;13.09.2017;2017;09;06;Keskiviikko;20;16;36;3;2;5
109;13.09.2017;2017;09;07;Keskiviikko;61;21;82;2;3;5
109;13.09.2017;2017;09;08;Keskiviikko;52;15;67;1;5;6
109;13.09.2017;2017;09;09;Keskiviikko;21;9;30;5;0;5
109;13.09.2017;2017;09;10;Keskiviikko;12;7;19;1;3;4
109;13.09.2017;2017;09;11;Keskiviikko;13;6;19;1;3;4
109;13.09.2017;2017;09;12;Keskiviikko;12;12;24;1;5;6
109;13.09.2017;2017;09;13;Keskiviikko;11;14;25;3;3;6
109;13.09.2017;2017;09;14;Keskiviikko;11;20;31;7;4;11
109;13.09.2017;2017;09;15;Keskiviikko;26;30;56;3;5;8
109;13.09.2017;2017;09;16;Keskiviikko;24;55;79;6;1;7
109;13.09.2017;2017;09;17;Keskiviikko;18;23;41;3;6;9
109;13.09.2017;2017;09;18;Keskiviikko;16;13;29;9;7;16
109;13.09.2017;2017;09;19;Keskiviikko;26;18;44;5;2;7
109;13.09.2017;2017;09;20;Keskiviikko;4;8;12;7;2;9
109;13.09.2017;2017;09;21;Keskiviikko;4;6;10;4;1;5
109;13.09.2017;2017;09;22;Keskiviikko;5;5;10;0;0;0
109;13.09.2017;2017;09;23;Keskiviikko;2;0;2;0;1;1
109;14.09.2017;2017;09;00;Torstai;0;0;0;0;1;1
109;14.09.2017;2017;09;01;Torstai;0;0;0;0;0;0
109;14.09.2017;2017;09;02;Torstai;0;0;0;0;0;0
109;14.09.2017;2017;09;03;Torstai;0;0;0;0;0;0
109;14.09.2017;2017;09;04;Torstai;1;0;1;1;0;1
109;14.09.2017;2017;09;05;Torstai;5;4;9;0;0;0
109;14.09.2017;2017;09;06;Torstai;21;16;37;2;1;3
109;14.09.2017;2017;09;07;Torstai;68;31;99;8;1;9
109;14.09.2017;2017;09;08;Torstai;44;21;65;4;4;8
109;14.09.2017;2017;09;09;Torstai;24;8;32;9;2;11
109;14.09.2017;2017;09;10;Torstai;3;7;10;5;3;8
109;14.09.2017;2017;09;11;Torstai;18;27;45;5;2;7
109;14.09.2017;2017;09;12;Torstai;12;11;23;3;0;3
109;14.09.2017;2017;09;13;Torstai;12;15;27;2;2;4
109;14.09.2017;2017;09;14;Torstai;12;21;33;4;4;8
109;14.09.2017;2017;09;15;Torstai;24;41;65;2;1;3
109;14.09.2017;2017;09;16;Torstai;26;61;87;6;2;8
109;14.09.2017;2017;09;17;Torstai;21;25;46;4;4;8
109;14.09.2017;2017;09;18;Torstai;19;4;23;2;3;5
109;14.09.2017;2017;09;19;Torstai;5;9;14;7;5;12
109;14.09.2017;2017;09;20;Torstai;4;8;12;3;0;3
109;14.09.2017;2017;09;21;Torstai;10;5;15;4;1;5
109;14.09.2017;2017;09;22;Torstai;2;2;4;0;0;0
109;14.09.2017;2017;09;23;Torstai;3;0;3;1;2;3
109;15.09.2017;2017;09;00;Perjantai;1;0;1;1;0;1
109;15.09.2017;2017;09;01;Perjantai;0;0;0;0;0;0
109;15.09.2017;2017;09;02;Perjantai;0;3;3;0;0;0
109;15.09.2017;2017;09;03;Perjantai;0;0;0;0;0;0
109;15.09.2017;2017;09;04;Perjantai;1;0;1;0;0;0
109;15.09.2017;2017;09;05;Perjantai;4;5;9;1;0;1
109;15.09.2017;2017;09;06;Perjantai;14;10;24;2;1;3
109;15.09.2017;2017;09;07;Perjantai;41;22;63;3;4;7
109;15.09.2017;2017;09;08;Perjantai;27;12;39;1;3;4
109;15.09.2017;2017;09;09;Perjantai;15;4;19;4;2;6
109;15.09.2017;2017;09;10;Perjantai;17;3;20;5;3;8
109;15.09.2017;2017;09;11;Perjantai;16;11;27;2;3;5
109;15.09.2017;2017;09;12;Perjantai;9;8;17;2;4;6
109;15.09.2017;2017;09;13;Perjantai;12;16;28;0;1;1
109;15.09.2017;2017;09;14;Perjantai;22;25;47;8;3;11
109;15.09.2017;2017;09;15;Perjantai;24;34;58;6;4;10
109;15.09.2017;2017;09;16;Perjantai;16;23;39;0;1;1
109;15.09.2017;2017;09;17;Perjantai;18;16;34;1;3;4
109;15.09.2017;2017;09;18;Perjantai;6;9;15;4;2;6
109;15.09.2017;2017;09;19;Perjantai;4;6;10;3;4;7
109;15.09.2017;2017;09;20;Perjantai;5;3;8;6;4;10
109;15.09.2017;2017;09;21;Perjantai;4;3;7;2;0;2
109;15.09.2017;2017;09;22;Perjantai;5;3;8;1;2;3
109;15.09.2017;2017;09;23;Perjantai;4;3;7;2;1;3
109;16.09.2017;2017;09;00;Lauantai;4;1;5;2;0;2
109;16.09.2017;2017;09;01;Lauantai;1;2;3;0;1;1
109;16.09.2017;2017;09;02;Lauantai;0;1;1;0;0;0
109;16.09.2017;2017;09;03;Lauantai;0;2;2;0;0;0
109;16.09.2017;2017;09;04;Lauantai;0;2;2;0;0;0
109;16.09.2017;2017;09;05;Lauantai;1;0;1;1;0;1
109;16.09.2017;2017;09;06;Lauantai;3;1;4;1;0;1
109;16.09.2017;2017;09;07;Lauantai;3;2;5;3;1;4
109;16.09.2017;2017;09;08;Lauantai;2;2;4;2;0;2
109;16.09.2017;2017;09;09;Lauantai;2;2;4;3;4;7
109;16.09.2017;2017;09;10;Lauantai;3;2;5;3;2;5
109;16.09.2017;2017;09;11;Lauantai;9;2;11;4;6;10
109;16.09.2017;2017;09;12;Lauantai;4;1;5;1;1;2
109;16.09.2017;2017;09;13;Lauantai;8;10;18;3;5;8
109;16.09.2017;2017;09;14;Lauantai;6;8;14;12;2;14
109;16.09.2017;2017;09;15;Lauantai;9;8;17;6;2;8
109;16.09.2017;2017;09;16;Lauantai;13;5;18;2;4;6
109;16.09.2017;2017;09;17;Lauantai;4;12;16;5;3;8
109;16.09.2017;2017;09;18;Lauantai;10;9;19;6;3;9
109;16.09.2017;2017;09;19;Lauantai;6;6;12;7;8;15
109;16.09.2017;2017;09;20;Lauantai;9;2;11;5;4;9
109;16.09.2017;2017;09;21;Lauantai;4;9;13;1;0;1
109;16.09.2017;2017;09;22;Lauantai;4;0;4;1;1;2
109;16.09.2017;2017;09;23;Lauantai;0;3;3;3;2;5
109;17.09.2017;2017;09;00;Sunnuntai;0;0;0;0;0;0
109;17.09.2017;2017;09;01;Sunnuntai;0;0;0;0;0;0
109;17.09.2017;2017;09;02;Sunnuntai;2;2;4;0;0;0
109;17.09.2017;2017;09;03;Sunnuntai;2;4;6;1;0;1
109;17.09.2017;2017;09;04;Sunnuntai;0;1;1;0;0;0
109;17.09.2017;2017;09;05;Sunnuntai;0;1;1;1;1;2
109;17.09.2017;2017;09;06;Sunnuntai;2;0;2;1;0;1
109;17.09.2017;2017;09;07;Sunnuntai;2;1;3;1;1;2
109;17.09.2017;2017;09;08;Sunnuntai;3;1;4;2;1;3
109;17.09.2017;2017;09;09;Sunnuntai;4;3;7;6;7;13
109;17.09.2017;2017;09;10;Sunnuntai;3;3;6;8;8;16
109;17.09.2017;2017;09;11;Sunnuntai;15;5;20;5;1;6
109;17.09.2017;2017;09;12;Sunnuntai;19;3;22;6;2;8
109;17.09.2017;2017;09;13;Sunnuntai;5;8;13;2;4;6
109;17.09.2017;2017;09;14;Sunnuntai;8;9;17;1;5;6
109;17.09.2017;2017;09;15;Sunnuntai;3;12;15;5;2;7
109;17.09.2017;2017;09;16;Sunnuntai;11;10;21;2;3;5
109;17.09.2017;2017;09;17;Sunnuntai;4;8;12;3;4;7
109;17.09.2017;2017;09;18;Sunnuntai;17;5;22;6;7;13
109;17.09.2017;2017;09;19;Sunnuntai;9;5;14;12;2;14
109;17.09.2017;2017;09;20;Sunnuntai;3;5;8;4;7;11
109;17.09.2017;2017;09;21;Sunnuntai;1;2;3;2;0;2
109;17.09.2017;2017;09;22;Sunnuntai;0;0;0;6;2;8
109;17.09.2017;2017;09;23;Sunnuntai;0;1;1;0;0;0
109;18.09.2017;2017;09;00;Maanantai;0;3;3;0;0;0
109;18.09.2017;2017;09;01;Maanantai;0;0;0;0;0;0
109;18.09.2017;2017;09;02;Maanantai;1;0;1;0;0;0
109;18.09.2017;2017;09;03;Maanantai;0;0;0;0;0;0
109;18.09.2017;2017;09;04;Maanantai;0;0;0;1;0;1
109;18.09.2017;2017;09;05;Maanantai;2;2;4;0;0;0
109;18.09.2017;2017;09;06;Maanantai;21;10;31;0;2;2
109;18.09.2017;2017;09;07;Maanantai;55;32;87;4;4;8
109;18.09.2017;2017;09;08;Maanantai;34;15;49;5;3;8
109;18.09.2017;2017;09;09;Maanantai;14;6;20;2;1;3
109;18.09.2017;2017;09;10;Maanantai;10;6;16;7;6;13
109;18.09.2017;2017;09;11;Maanantai;6;4;10;0;7;7
109;18.09.2017;2017;09;12;Maanantai;6;10;16;1;0;1
109;18.09.2017;2017;09;13;Maanantai;13;12;25;6;2;8
109;18.09.2017;2017;09;14;Maanantai;9;23;32;5;5;10
109;18.09.2017;2017;09;15;Maanantai;26;32;58;3;4;7
109;18.09.2017;2017;09;16;Maanantai;36;53;89;2;6;8
109;18.09.2017;2017;09;17;Maanantai;14;25;39;6;4;10
109;18.09.2017;2017;09;18;Maanantai;13;15;28;9;8;17
109;18.09.2017;2017;09;19;Maanantai;8;11;19;5;3;8
109;18.09.2017;2017;09;20;Maanantai;5;3;8;4;8;12
109;18.09.2017;2017;09;21;Maanantai;5;7;12;2;0;2
109;18.09.2017;2017;09;22;Maanantai;3;5;8;3;1;4
109;18.09.2017;2017;09;23;Maanantai;0;0;0;0;1;1
109;19.09.2017;2017;09;00;Tiistai;0;0;0;1;2;3
109;19.09.2017;2017;09;01;Tiistai;0;1;1;0;1;1
109;19.09.2017;2017;09;02;Tiistai;1;0;1;0;0;0
109;19.09.2017;2017;09;03;Tiistai;0;0;0;1;0;1
109;19.09.2017;2017;09;04;Tiistai;0;0;0;1;0;1
109;19.09.2017;2017;09;05;Tiistai;2;5;7;0;0;0
109;19.09.2017;2017;09;06;Tiistai;15;12;27;2;0;2
109;19.09.2017;2017;09;07;Tiistai;59;32;91;4;4;8
109;19.09.2017;2017;09;08;Tiistai;31;13;44;5;3;8
109;19.09.2017;2017;09;09;Tiistai;17;9;26;1;1;2
109;19.09.2017;2017;09;10;Tiistai;8;1;9;1;3;4
109;19.09.2017;2017;09;11;Tiistai;12;5;17;5;2;7
109;19.09.2017;2017;09;12;Tiistai;4;6;10;2;0;2
109;19.09.2017;2017;09;13;Tiistai;10;11;21;6;9;15
109;19.09.2017;2017;09;14;Tiistai;9;14;23;4;6;10
109;19.09.2017;2017;09;15;Tiistai;18;28;46;6;3;9
109;19.09.2017;2017;09;16;Tiistai;29;58;87;5;5;10
109;19.09.2017;2017;09;17;Tiistai;13;24;37;0;7;7
109;19.09.2017;2017;09;18;Tiistai;12;7;19;8;6;14
109;19.09.2017;2017;09;19;Tiistai;8;7;15;10;5;15
109;19.09.2017;2017;09;20;Tiistai;3;7;10;0;4;4
109;19.09.2017;2017;09;21;Tiistai;5;5;10;1;1;2
109;19.09.2017;2017;09;22;Tiistai;4;4;8;3;0;3
109;19.09.2017;2017;09;23;Tiistai;0;2;2;0;1;1
109;20.09.2017;2017;09;00;Keskiviikko;0;0;0;0;0;0
109;20.09.2017;2017;09;01;Keskiviikko;0;0;0;0;0;0
109;20.09.2017;2017;09;02;Keskiviikko;0;0;0;0;0;0
109;20.09.2017;2017;09;03;Keskiviikko;0;0;0;0;0;0
109;20.09.2017;2017;09;04;Keskiviikko;0;1;1;0;0;0
109;20.09.2017;2017;09;05;Keskiviikko;2;3;5;2;1;3
109;20.09.2017;2017;09;06;Keskiviikko;23;10;33;3;2;5
109;20.09.2017;2017;09;07;Keskiviikko;65;30;95;5;6;11
109;20.09.2017;2017;09;08;Keskiviikko;40;18;58;6;3;9
109;20.09.2017;2017;09;09;Keskiviikko;20;11;31;3;1;4
109;20.09.2017;2017;09;10;Keskiviikko;18;8;26;6;5;11
109;20.09.2017;2017;09;11;Keskiviikko;5;6;11;4;3;7
109;20.09.2017;2017;09;12;Keskiviikko;8;10;18;1;3;4
109;20.09.2017;2017;09;13;Keskiviikko;14;15;29;3;1;4
109;20.09.2017;2017;09;14;Keskiviikko;15;27;42;5;5;10
109;20.09.2017;2017;09;15;Keskiviikko;21;25;46;3;3;6
109;20.09.2017;2017;09;16;Keskiviikko;31;57;88;3;5;8
109;20.09.2017;2017;09;17;Keskiviikko;14;23;37;1;3;4
109;20.09.2017;2017;09;18;Keskiviikko;16;11;27;9;4;13
109;20.09.2017;2017;09;19;Keskiviikko;10;15;25;7;3;10
109;20.09.2017;2017;09;20;Keskiviikko;7;7;14;2;2;4
109;20.09.2017;2017;09;21;Keskiviikko;4;4;8;3;4;7
109;20.09.2017;2017;09;22;Keskiviikko;4;1;5;0;1;1
109;20.09.2017;2017;09;23;Keskiviikko;0;0;0;2;1;3
109;21.09.2017;2017;09;00;Torstai;1;2;3;1;4;5
109;21.09.2017;2017;09;01;Torstai;0;0;0;0;0;0
109;21.09.2017;2017;09;02;Torstai;1;0;1;0;0;0
109;21.09.2017;2017;09;03;Torstai;0;0;0;0;0;0
109;21.09.2017;2017;09;04;Torstai;0;1;1;0;0;0
109;21.09.2017;2017;09;05;Torstai;1;2;3;2;0;2
109;21.09.2017;2017;09;06;Torstai;17;18;35;1;0;1
109;21.09.2017;2017;09;07;Torstai;73;37;110;5;3;8
109;21.09.2017;2017;09;08;Torstai;47;21;68;7;2;9
109;21.09.2017;2017;09;09;Torstai;17;12;29;4;2;6
109;21.09.2017;2017;09;10;Torstai;7;6;13;7;3;10
109;21.09.2017;2017;09;11;Torstai;11;14;25;2;5;7
109;21.09.2017;2017;09;12;Torstai;14;12;26;4;1;5
109;21.09.2017;2017;09;13;Torstai;13;13;26;6;4;10
109;21.09.2017;2017;09;14;Torstai;14;25;39;4;6;10
109;21.09.2017;2017;09;15;Torstai;23;24;47;8;3;11
109;21.09.2017;2017;09;16;Torstai;29;66;95;2;7;9
109;21.09.2017;2017;09;17;Torstai;22;29;51;7;8;15
109;21.09.2017;2017;09;18;Torstai;13;13;26;6;4;10
109;21.09.2017;2017;09;19;Torstai;8;12;20;7;7;14
109;21.09.2017;2017;09;20;Torstai;4;5;9;6;5;11
109;21.09.2017;2017;09;21;Torstai;7;5;12;2;1;3
109;21.09.2017;2017;09;22;Torstai;1;4;5;0;0;0
109;21.09.2017;2017;09;23;Torstai;2;0;2;2;2;4
109;22.09.2017;2017;09;00;Perjantai;0;0;0;0;0;0
109;22.09.2017;2017;09;01;Perjantai;0;1;1;0;1;1
109;22.09.2017;2017;09;02;Perjantai;1;0;1;0;0;0
109;22.09.2017;2017;09;03;Perjantai;0;0;0;0;0;0
109;22.09.2017;2017;09;04;Perjantai;0;1;1;0;0;0
109;22.09.2017;2017;09;05;Perjantai;0;7;7;1;0;1
109;22.09.2017;2017;09;06;Perjantai;25;10;35;0;2;2
109;22.09.2017;2017;09;07;Perjantai;61;28;89;5;4;9
109;22.09.2017;2017;09;08;Perjantai;25;23;48;6;5;11
109;22.09.2017;2017;09;09;Perjantai;13;3;16;6;1;7
109;22.09.2017;2017;09;10;Perjantai;13;3;16;6;1;7
109;22.09.2017;2017;09;11;Perjantai;14;17;31;3;2;5
109;22.09.2017;2017;09;12;Perjantai;13;11;24;1;3;4
109;22.09.2017;2017;09;13;Perjantai;18;17;35;3;2;5
109;22.09.2017;2017;09;14;Perjantai;17;25;42;4;4;8
109;22.09.2017;2017;09;15;Perjantai;27;40;67;8;3;11
109;22.09.2017;2017;09;16;Perjantai;30;45;75;8;6;14
109;22.09.2017;2017;09;17;Perjantai;15;9;24;7;3;10
109;22.09.2017;2017;09;18;Perjantai;8;12;20;2;4;6
109;22.09.2017;2017;09;19;Perjantai;10;2;12;6;5;11
109;22.09.2017;2017;09;20;Perjantai;8;6;14;5;3;8
109;22.09.2017;2017;09;21;Perjantai;5;6;11;2;3;5
109;22.09.2017;2017;09;22;Perjantai;3;3;6;2;1;3
109;22.09.2017;2017;09;23;Perjantai;3;2;5;0;0;0
109;23.09.2017;2017;09;00;Lauantai;2;1;3;1;0;1
109;23.09.2017;2017;09;01;Lauantai;0;1;1;0;2;2
109;23.09.2017;2017;09;02;Lauantai;1;2;3;2;0;2
109;23.09.2017;2017;09;03;Lauantai;0;0;0;0;1;1
109;23.09.2017;2017;09;04;Lauantai;1;2;3;0;0;0
109;23.09.2017;2017;09;05;Lauantai;1;1;2;0;0;0
109;23.09.2017;2017;09;06;Lauantai;6;0;6;3;0;3
109;23.09.2017;2017;09;07;Lauantai;5;3;8;0;1;1
109;23.09.2017;2017;09;08;Lauantai;5;6;11;3;0;3
109;23.09.2017;2017;09;09;Lauantai;11;2;13;2;3;5
109;23.09.2017;2017;09;10;Lauantai;7;4;11;4;3;7
109;23.09.2017;2017;09;11;Lauantai;10;10;20;2;1;3
109;23.09.2017;2017;09;12;Lauantai;25;9;34;7;4;11
109;23.09.2017;2017;09;13;Lauantai;11;11;22;1;2;3
109;23.09.2017;2017;09;14;Lauantai;15;4;19;4;7;11
109;23.09.2017;2017;09;15;Lauantai;6;3;9;5;5;10
109;23.09.2017;2017;09;16;Lauantai;10;13;23;2;3;5
109;23.09.2017;2017;09;17;Lauantai;7;18;25;1;3;4
109;23.09.2017;2017;09;18;Lauantai;7;11;18;7;8;15
109;23.09.2017;2017;09;19;Lauantai;13;1;14;8;4;12
109;23.09.2017;2017;09;20;Lauantai;3;4;7;4;3;7
109;23.09.2017;2017;09;21;Lauantai;7;4;11;3;1;4
109;23.09.2017;2017;09;22;Lauantai;2;6;8;1;4;5
109;23.09.2017;2017;09;23;Lauantai;1;0;1;1;0;1
109;24.09.2017;2017;09;00;Sunnuntai;1;2;3;0;0;0
109;24.09.2017;2017;09;01;Sunnuntai;1;0;1;0;1;1
109;24.09.2017;2017;09;02;Sunnuntai;3;0;3;0;0;0
109;24.09.2017;2017;09;03;Sunnuntai;0;0;0;0;1;1
109;24.09.2017;2017;09;04;Sunnuntai;1;1;2;0;0;0
109;24.09.2017;2017;09;05;Sunnuntai;0;0;0;0;0;0
109;24.09.2017;2017;09;06;Sunnuntai;2;0;2;2;0;2
109;24.09.2017;2017;09;07;Sunnuntai;0;2;2;2;1;3
109;24.09.2017;2017;09;08;Sunnuntai;5;1;6;2;2;4
109;24.09.2017;2017;09;09;Sunnuntai;7;2;9;9;1;10
109;24.09.2017;2017;09;10;Sunnuntai;13;3;16;7;1;8
109;24.09.2017;2017;09;11;Sunnuntai;17;8;25;5;4;9
109;24.09.2017;2017;09;12;Sunnuntai;15;11;26;2;4;6
109;24.09.2017;2017;09;13;Sunnuntai;10;11;21;1;6;7
109;24.09.2017;2017;09;14;Sunnuntai;8;11;19;2;2;4
109;24.09.2017;2017;09;15;Sunnuntai;8;5;13;5;1;6
109;24.09.2017;2017;09;16;Sunnuntai;7;18;25;2;3;5
109;24.09.2017;2017;09;17;Sunnuntai;11;7;18;7;2;9
109;24.09.2017;2017;09;18;Sunnuntai;5;6;11;6;4;10
109;24.09.2017;2017;09;19;Sunnuntai;2;6;8;4;8;12
109;24.09.2017;2017;09;20;Sunnuntai;11;4;15;1;3;4
109;24.09.2017;2017;09;21;Sunnuntai;7;7;14;6;1;7
109;24.09.2017;2017;09;22;Sunnuntai;1;0;1;0;0;0
109;24.09.2017;2017;09;23;Sunnuntai;1;1;2;1;1;2
109;25.09.2017;2017;09;00;Maanantai;0;0;0;0;0;0
109;25.09.2017;2017;09;01;Maanantai;0;0;0;1;1;2
109;25.09.2017;2017;09;02;Maanantai;0;0;0;0;0;0
109;25.09.2017;2017;09;03;Maanantai;0;2;2;0;0;0
109;25.09.2017;2017;09;04;Maanantai;0;1;1;1;0;1
109;25.09.2017;2017;09;05;Maanantai;3;2;5;0;0;0
109;25.09.2017;2017;09;06;Maanantai;31;13;44;1;0;1
109;25.09.2017;2017;09;07;Maanantai;62;35;97;3;5;8
109;25.09.2017;2017;09;08;Maanantai;54;15;69;5;4;9
109;25.09.2017;2017;09;09;Maanantai;21;8;29;4;2;6
109;25.09.2017;2017;09;10;Maanantai;12;6;18;6;4;10
109;25.09.2017;2017;09;11;Maanantai;12;5;17;4;1;5
109;25.09.2017;2017;09;12;Maanantai;10;15;25;2;2;4
109;25.09.2017;2017;09;13;Maanantai;12;17;29;5;5;10
109;25.09.2017;2017;09;14;Maanantai;19;22;41;7;0;7
109;25.09.2017;2017;09;15;Maanantai;24;47;71;2;5;7
109;25.09.2017;2017;09;16;Maanantai;41;53;94;7;5;12
109;25.09.2017;2017;09;17;Maanantai;28;24;52;2;5;7
109;25.09.2017;2017;09;18;Maanantai;15;16;31;7;7;14
109;25.09.2017;2017;09;19;Maanantai;13;14;27;10;8;18
109;25.09.2017;2017;09;20;Maanantai;3;6;9;7;5;12
109;25.09.2017;2017;09;21;Maanantai;3;7;10;4;2;6
109;25.09.2017;2017;09;22;Maanantai;5;2;7;1;0;1
109;25.09.2017;2017;09;23;Maanantai;0;2;2;1;1;2
109;26.09.2017;2017;09;00;Tiistai;0;2;2;0;1;1
109;26.09.2017;2017;09;01;Tiistai;0;2;2;0;0;0
109;26.09.2017;2017;09;02;Tiistai;0;0;0;0;0;0
109;26.09.2017;2017;09;03;Tiistai;0;0;0;0;0;0
109;26.09.2017;2017;09;04;Tiistai;0;0;0;0;0;0
109;26.09.2017;2017;09;05;Tiistai;3;3;6;2;1;3
109;26.09.2017;2017;09;06;Tiistai;28;10;38;2;1;3
109;26.09.2017;2017;09;07;Tiistai;61;29;90;2;7;9
109;26.09.2017;2017;09;08;Tiistai;44;18;62;4;5;9
109;26.09.2017;2017;09;09;Tiistai;14;8;22;4;2;6
109;26.09.2017;2017;09;10;Tiistai;17;7;24;7;6;13
109;26.09.2017;2017;09;11;Tiistai;10;10;20;1;3;4
109;26.09.2017;2017;09;12;Tiistai;6;15;21;4;2;6
109;26.09.2017;2017;09;13;Tiistai;4;17;21;1;5;6
109;26.09.2017;2017;09;14;Tiistai;20;22;42;7;2;9
109;26.09.2017;2017;09;15;Tiistai;22;35;57;5;4;9
109;26.09.2017;2017;09;16;Tiistai;38;49;87;1;2;3
109;26.09.2017;2017;09;17;Tiistai;25;29;54;6;6;12
109;26.09.2017;2017;09;18;Tiistai;9;12;21;8;2;10
109;26.09.2017;2017;09;19;Tiistai;9;12;21;12;5;17
109;26.09.2017;2017;09;20;Tiistai;2;4;6;3;3;6
109;26.09.2017;2017;09;21;Tiistai;4;0;4;5;5;10
109;26.09.2017;2017;09;22;Tiistai;4;5;9;1;0;1
109;26.09.2017;2017;09;23;Tiistai;0;2;2;2;0;2
109;27.09.2017;2017;09;00;Keskiviikko;0;0;0;0;1;1
109;27.09.2017;2017;09;01;Keskiviikko;1;0;1;0;0;0
109;27.09.2017;2017;09;02;Keskiviikko;1;2;3;0;0;0
109;27.09.2017;2017;09;03;Keskiviikko;1;0;1;0;0;0
109;27.09.2017;2017;09;04;Keskiviikko;0;1;1;1;0;1
109;27.09.2017;2017;09;05;Keskiviikko;2;3;5;0;0;0
109;27.09.2017;2017;09;06;Keskiviikko;21;6;27;1;1;2
109;27.09.2017;2017;09;07;Keskiviikko;66;30;96;1;5;6
109;27.09.2017;2017;09;08;Keskiviikko;36;17;53;5;3;8
109;27.09.2017;2017;09;09;Keskiviikko;17;8;25;4;1;5
109;27.09.2017;2017;09;10;Keskiviikko;11;5;16;4;3;7
109;27.09.2017;2017;09;11;Keskiviikko;12;5;17;3;3;6
109;27.09.2017;2017;09;12;Keskiviikko;10;7;17;3;6;9
109;27.09.2017;2017;09;13;Keskiviikko;14;17;31;5;2;7
109;27.09.2017;2017;09;14;Keskiviikko;14;24;38;3;4;7
109;27.09.2017;2017;09;15;Keskiviikko;25;29;54;3;3;6
109;27.09.2017;2017;09;16;Keskiviikko;24;47;71;5;5;10
109;27.09.2017;2017;09;17;Keskiviikko;23;28;51;6;3;9
109;27.09.2017;2017;09;18;Keskiviikko;11;14;25;6;4;10
109;27.09.2017;2017;09;19;Keskiviikko;12;10;22;5;9;14
109;27.09.2017;2017;09;20;Keskiviikko;7;10;17;5;3;8
109;27.09.2017;2017;09;21;Keskiviikko;2;9;11;1;0;1
109;27.09.2017;2017;09;22;Keskiviikko;4;2;6;1;1;2
109;27.09.2017;2017;09;23;Keskiviikko;1;0;1;0;0;0
109;28.09.2017;2017;09;00;Torstai;0;0;0;1;1;2
109;28.09.2017;2017;09;01;Torstai;0;0;0;1;2;3
109;28.09.2017;2017;09;02;Torstai;1;0;1;0;0;0
109;28.09.2017;2017;09;03;Torstai;0;1;1;0;0;0
109;28.09.2017;2017;09;04;Torstai;0;1;1;1;0;1
109;28.09.2017;2017;09;05;Torstai;2;1;3;0;0;0
109;28.09.2017;2017;09;06;Torstai;22;11;33;3;1;4
109;28.09.2017;2017;09;07;Torstai;62;21;83;4;6;10
109;28.09.2017;2017;09;08;Torstai;54;12;66;3;2;5
109;28.09.2017;2017;09;09;Torstai;13;6;19;5;1;6
109;28.09.2017;2017;09;10;Torstai;9;9;18;2;11;13
109;28.09.2017;2017;09;11;Torstai;11;9;20;9;2;11
109;28.09.2017;2017;09;12;Torstai;8;7;15;2;2;4
109;28.09.2017;2017;09;13;Torstai;10;19;29;3;1;4
109;28.09.2017;2017;09;14;Torstai;14;15;29;3;6;9
109;28.09.2017;2017;09;15;Torstai;31;33;64;7;1;8
109;28.09.2017;2017;09;16;Torstai;32;59;91;3;3;6
109;28.09.2017;2017;09;17;Torstai;29;28;57;8;6;14
109;28.09.2017;2017;09;18;Torstai;11;9;20;2;5;7
109;28.09.2017;2017;09;19;Torstai;11;11;22;7;4;11
109;28.09.2017;2017;09;20;Torstai;6;6;12;6;5;11
109;28.09.2017;2017;09;21;Torstai;3;5;8;3;3;6
109;28.09.2017;2017;09;22;Torstai;1;3;4;1;0;1
109;28.09.2017;2017;09;23;Torstai;0;0;0;0;1;1
109;29.09.2017;2017;09;00;Perjantai;1;1;2;0;1;1
109;29.09.2017;2017;09;01;Perjantai;0;0;0;0;0;0
109;29.09.2017;2017;09;02;Perjantai;0;0;0;2;1;3
109;29.09.2017;2017;09;03;Perjantai;0;1;1;0;0;0
109;29.09.2017;2017;09;04;Perjantai;0;3;3;0;0;0
109;29.09.2017;2017;09;05;Perjantai;3;3;6;1;0;1
109;29.09.2017;2017;09;06;Perjantai;25;9;34;3;1;4
109;29.09.2017;2017;09;07;Perjantai;47;30;77;3;8;11
109;29.09.2017;2017;09;08;Perjantai;35;16;51;2;2;4
109;29.09.2017;2017;09;09;Perjantai;10;6;16;7;2;9
109;29.09.2017;2017;09;10;Perjantai;13;7;20;3;2;5
109;29.09.2017;2017;09;11;Perjantai;14;10;24;0;5;5
109;29.09.2017;2017;09;12;Perjantai;15;9;24;2;2;4
109;29.09.2017;2017;09;13;Perjantai;28;16;44;3;6;9
109;29.09.2017;2017;09;14;Perjantai;14;31;45;5;4;9
109;29.09.2017;2017;09;15;Perjantai;16;37;53;2;3;5
109;29.09.2017;2017;09;16;Perjantai;28;36;64;3;6;9
109;29.09.2017;2017;09;17;Perjantai;8;13;21;6;3;9
109;29.09.2017;2017;09;18;Perjantai;11;10;21;4;3;7
109;29.09.2017;2017;09;19;Perjantai;4;6;10;6;2;8
109;29.09.2017;2017;09;20;Perjantai;3;2;5;2;3;5
109;29.09.2017;2017;09;21;Perjantai;6;4;10;2;2;4
109;29.09.2017;2017;09;22;Perjantai;6;3;9;4;1;5
109;29.09.2017;2017;09;23;Perjantai;0;0;0;0;2;2
109;30.09.2017;2017;09;00;Lauantai;1;1;2;0;0;0
109;30.09.2017;2017;09;01;Lauantai;5;1;6;0;0;0
109;30.09.2017;2017;09;02;Lauantai;2;2;4;0;0;0
109;30.09.2017;2017;09;03;Lauantai;0;6;6;1;0;1
109;30.09.2017;2017;09;04;Lauantai;0;0;0;0;0;0
109;30.09.2017;2017;09;05;Lauantai;0;1;1;0;1;1
109;30.09.2017;2017;09;06;Lauantai;2;1;3;2;0;2
109;30.09.2017;2017;09;07;Lauantai;1;4;5;0;1;1
109;30.09.2017;2017;09;08;Lauantai;3;1;4;5;3;8
109;30.09.2017;2017;09;09;Lauantai;7;3;10;2;3;5
109;30.09.2017;2017;09;10;Lauantai;7;2;9;1;3;4
109;30.09.2017;2017;09;11;Lauantai;10;4;14;4;1;5
109;30.09.2017;2017;09;12;Lauantai;7;4;11;8;1;9
109;30.09.2017;2017;09;13;Lauantai;4;6;10;3;3;6
109;30.09.2017;2017;09;14;Lauantai;16;9;25;2;5;7
109;30.09.2017;2017;09;15;Lauantai;10;8;18;3;2;5
109;30.09.2017;2017;09;16;Lauantai;8;8;16;2;4;6
109;30.09.2017;2017;09;17;Lauantai;4;3;7;4;0;4
109;30.09.2017;2017;09;18;Lauantai;5;4;9;3;6;9
109;30.09.2017;2017;09;19;Lauantai;6;6;12;4;4;8
109;30.09.2017;2017;09;20;Lauantai;5;6;11;3;3;6
109;30.09.2017;2017;09;21;Lauantai;1;4;5;6;3;9
109;30.09.2017;2017;09;22;Lauantai;0;0;0;4;0;4
109;30.09.2017;2017;09;23;Lauantai;1;1;2;0;0;0
109;01.10.2017;2017;10;00;Sunnuntai;0;0;0;0;0;0
109;01.10.2017;2017;10;01;Sunnuntai;2;2;4;0;0;0
109;01.10.2017;2017;10;02;Sunnuntai;2;1;3;0;0;0
109;01.10.2017;2017;10;03;Sunnuntai;0;0;0;0;1;1
109;01.10.2017;2017;10;04;Sunnuntai;1;2;3;0;0;0
109;01.10.2017;2017;10;05;Sunnuntai;0;1;1;0;0;0
109;01.10.2017;2017;10;06;Sunnuntai;3;0;3;0;0;0
109;01.10.2017;2017;10;07;Sunnuntai;0;4;4;3;1;4
109;01.10.2017;2017;10;08;Sunnuntai;2;1;3;2;1;3
109;01.10.2017;2017;10;09;Sunnuntai;2;3;5;4;1;5
109;01.10.2017;2017;10;10;Sunnuntai;7;2;9;4;5;9
109;01.10.2017;2017;10;11;Sunnuntai;6;3;9;4;6;10
109;01.10.2017;2017;10;12;Sunnuntai;11;6;17;10;3;13
109;01.10.2017;2017;10;13;Sunnuntai;12;9;21;7;4;11
109;01.10.2017;2017;10;14;Sunnuntai;5;4;9;4;2;6
109;01.10.2017;2017;10;15;Sunnuntai;9;4;13;0;1;1
109;01.10.2017;2017;10;16;Sunnuntai;10;8;18;4;6;10
109;01.10.2017;2017;10;17;Sunnuntai;6;2;8;2;2;4
109;01.10.2017;2017;10;18;Sunnuntai;5;6;11;4;6;10
109;01.10.2017;2017;10;19;Sunnuntai;2;5;7;14;4;18
109;01.10.2017;2017;10;20;Sunnuntai;0;3;3;1;3;4
109;01.10.2017;2017;10;21;Sunnuntai;1;2;3;3;0;3
109;01.10.2017;2017;10;22;Sunnuntai;3;3;6;0;0;0
109;01.10.2017;2017;10;23;Sunnuntai;0;0;0;0;0;0
109;02.10.2017;2017;10;00;Maanantai;0;1;1;0;0;0
109;02.10.2017;2017;10;01;Maanantai;0;0;0;0;0;0
109;02.10.2017;2017;10;02;Maanantai;1;1;2;0;0;0
109;02.10.2017;2017;10;03;Maanantai;0;0;0;0;0;0
109;02.10.2017;2017;10;04;Maanantai;0;2;2;1;1;2
109;02.10.2017;2017;10;05;Maanantai;2;3;5;0;0;0
109;02.10.2017;2017;10;06;Maanantai;22;11;33;1;2;3
109;02.10.2017;2017;10;07;Maanantai;73;28;101;1;3;4
109;02.10.2017;2017;10;08;Maanantai;47;16;63;4;1;5
109;02.10.2017;2017;10;09;Maanantai;19;7;26;3;2;5
109;02.10.2017;2017;10;10;Maanantai;10;5;15;5;3;8
109;02.10.2017;2017;10;11;Maanantai;7;7;14;4;3;7
109;02.10.2017;2017;10;12;Maanantai;19;9;28;3;4;7
109;02.10.2017;2017;10;13;Maanantai;11;7;18;2;1;3
109;02.10.2017;2017;10;14;Maanantai;13;18;31;8;7;15
109;02.10.2017;2017;10;15;Maanantai;20;44;64;3;6;9
109;02.10.2017;2017;10;16;Maanantai;32;60;92;3;4;7
109;02.10.2017;2017;10;17;Maanantai;12;22;34;7;4;11
109;02.10.2017;2017;10;18;Maanantai;11;19;30;9;6;15
109;02.10.2017;2017;10;19;Maanantai;5;9;14;6;6;12
109;02.10.2017;2017;10;20;Maanantai;6;8;14;7;4;11
109;02.10.2017;2017;10;21;Maanantai;1;10;11;8;1;9
109;02.10.2017;2017;10;22;Maanantai;3;0;3;2;2;4
109;02.10.2017;2017;10;23;Maanantai;0;1;1;1;1;2
109;03.10.2017;2017;10;00;Tiistai;1;0;1;0;0;0
109;03.10.2017;2017;10;01;Tiistai;0;0;0;0;0;0
109;03.10.2017;2017;10;02;Tiistai;1;0;1;0;0;0
109;03.10.2017;2017;10;03;Tiistai;0;0;0;0;0;0
109;03.10.2017;2017;10;04;Tiistai;0;0;0;0;0;0
109;03.10.2017;2017;10;05;Tiistai;2;2;4;2;0;2
109;03.10.2017;2017;10;06;Tiistai;24;9;33;2;2;4
109;03.10.2017;2017;10;07;Tiistai;62;26;88;7;4;11
109;03.10.2017;2017;10;08;Tiistai;31;16;47;4;3;7
109;03.10.2017;2017;10;09;Tiistai;25;1;26;6;3;9
109;03.10.2017;2017;10;10;Tiistai;12;4;16;4;5;9
109;03.10.2017;2017;10;11;Tiistai;4;7;11;1;7;8
109;03.10.2017;2017;10;12;Tiistai;6;10;16;5;1;6
109;03.10.2017;2017;10;13;Tiistai;8;11;19;7;4;11
109;03.10.2017;2017;10;14;Tiistai;9;16;25;2;5;7
109;03.10.2017;2017;10;15;Tiistai;20;33;53;5;2;7
109;03.10.2017;2017;10;16;Tiistai;32;57;89;2;5;7
109;03.10.2017;2017;10;17;Tiistai;15;26;41;3;2;5
109;03.10.2017;2017;10;18;Tiistai;9;6;15;10;5;15
109;03.10.2017;2017;10;19;Tiistai;5;7;12;4;4;8
109;03.10.2017;2017;10;20;Tiistai;4;9;13;7;1;8
109;03.10.2017;2017;10;21;Tiistai;3;5;8;5;2;7
109;03.10.2017;2017;10;22;Tiistai;2;5;7;3;1;4
109;03.10.2017;2017;10;23;Tiistai;1;0;1;2;0;2
109;04.10.2017;2017;10;00;Keskiviikko;0;0;0;0;1;1
109;04.10.2017;2017;10;01;Keskiviikko;0;1;1;0;0;0
109;04.10.2017;2017;10;02;Keskiviikko;0;0;0;1;0;1
109;04.10.2017;2017;10;03;Keskiviikko;0;0;0;0;0;0
109;04.10.2017;2017;10;04;Keskiviikko;0;1;1;1;0;1
109;04.10.2017;2017;10;05;Keskiviikko;4;3;7;2;1;3
109;04.10.2017;2017;10;06;Keskiviikko;17;7;24;3;0;3
109;04.10.2017;2017;10;07;Keskiviikko;51;20;71;2;5;7
109;04.10.2017;2017;10;08;Keskiviikko;37;10;47;6;6;12
109;04.10.2017;2017;10;09;Keskiviikko;13;5;18;4;1;5
109;04.10.2017;2017;10;10;Keskiviikko;7;4;11;4;2;6
109;04.10.2017;2017;10;11;Keskiviikko;7;6;13;2;3;5
109;04.10.2017;2017;10;12;Keskiviikko;11;6;17;2;1;3
109;04.10.2017;2017;10;13;Keskiviikko;11;6;17;1;2;3
109;04.10.2017;2017;10;14;Keskiviikko;16;23;39;7;3;10
109;04.10.2017;2017;10;15;Keskiviikko;10;23;33;8;5;13
109;04.10.2017;2017;10;16;Keskiviikko;26;41;67;6;2;8
109;04.10.2017;2017;10;17;Keskiviikko;11;24;35;1;3;4
109;04.10.2017;2017;10;18;Keskiviikko;15;16;31;7;1;8
109;04.10.2017;2017;10;19;Keskiviikko;5;12;17;8;7;15
109;04.10.2017;2017;10;20;Keskiviikko;6;8;14;6;6;12
109;04.10.2017;2017;10;21;Keskiviikko;5;9;14;5;2;7
109;04.10.2017;2017;10;22;Keskiviikko;3;4;7;1;3;4
109;04.10.2017;2017;10;23;Keskiviikko;0;0;0;0;0;0
109;05.10.2017;2017;10;00;Torstai;1;0;1;0;0;0
109;05.10.2017;2017;10;01;Torstai;0;0;0;0;0;0
109;05.10.2017;2017;10;02;Torstai;1;0;1;0;0;0
109;05.10.2017;2017;10;03;Torstai;0;0;0;0;0;0
109;05.10.2017;2017;10;04;Torstai;0;1;1;0;0;0
109;05.10.2017;2017;10;05;Torstai;2;2;4;1;0;1
109;05.10.2017;2017;10;06;Torstai;19;10;29;4;1;5
109;05.10.2017;2017;10;07;Torstai;54;25;79;7;4;11
109;05.10.2017;2017;10;08;Torstai;35;14;49;5;4;9
109;05.10.2017;2017;10;09;Torstai;19;2;21;5;3;8
109;05.10.2017;2017;10;10;Torstai;8;8;16;2;3;5
109;05.10.2017;2017;10;11;Torstai;18;7;25;4;2;6
109;05.10.2017;2017;10;12;Torstai;9;11;20;4;3;7
109;05.10.2017;2017;10;13;Torstai;6;8;14;3;5;8
109;05.10.2017;2017;10;14;Torstai;9;16;25;4;1;5
109;05.10.2017;2017;10;15;Torstai;17;24;41;4;3;7
109;05.10.2017;2017;10;16;Torstai;24;42;66;4;2;6
109;05.10.2017;2017;10;17;Torstai;15;21;36;6;4;10
109;05.10.2017;2017;10;18;Torstai;14;11;25;7;3;10
109;05.10.2017;2017;10;19;Torstai;8;9;17;8;7;15
109;05.10.2017;2017;10;20;Torstai;5;0;5;5;1;6
109;05.10.2017;2017;10;21;Torstai;0;3;3;2;1;3
109;05.10.2017;2017;10;22;Torstai;0;4;4;3;1;4
109;05.10.2017;2017;10;23;Torstai;2;3;5;0;0;0
109;06.10.2017;2017;10;00;Perjantai;1;0;1;0;0;0
109;06.10.2017;2017;10;01;Perjantai;2;2;4;1;0;1
109;06.10.2017;2017;10;02;Perjantai;3;0;3;0;0;0
109;06.10.2017;2017;10;03;Perjantai;0;0;0;0;0;0
109;06.10.2017;2017;10;04;Perjantai;0;1;1;1;0;1
109;06.10.2017;2017;10;05;Perjantai;3;3;6;1;1;2
109;06.10.2017;2017;10;06;Perjantai;18;8;26;1;0;1
109;06.10.2017;2017;10;07;Perjantai;45;22;67;4;3;7
109;06.10.2017;2017;10;08;Perjantai;33;13;46;4;5;9
109;06.10.2017;2017;10;09;Perjantai;23;5;28;7;3;10
109;06.10.2017;2017;10;10;Perjantai;10;2;12;8;4;12
109;06.10.2017;2017;10;11;Perjantai;17;5;22;4;1;5
109;06.10.2017;2017;10;12;Perjantai;24;11;35;0;1;1
109;06.10.2017;2017;10;13;Perjantai;10;25;35;3;3;6
109;06.10.2017;2017;10;14;Perjantai;12;30;42;6;0;6
109;06.10.2017;2017;10;15;Perjantai;28;25;53;2;4;6
109;06.10.2017;2017;10;16;Perjantai;19;32;51;6;1;7
109;06.10.2017;2017;10;17;Perjantai;8;14;22;3;3;6
109;06.10.2017;2017;10;18;Perjantai;6;11;17;2;1;3
109;06.10.2017;2017;10;19;Perjantai;4;2;6;3;4;7
109;06.10.2017;2017;10;20;Perjantai;2;3;5;4;1;5
109;06.10.2017;2017;10;21;Perjantai;1;6;7;1;1;2
109;06.10.2017;2017;10;22;Perjantai;3;4;7;3;0;3
109;06.10.2017;2017;10;23;Perjantai;1;0;1;0;0;0
109;07.10.2017;2017;10;00;Lauantai;0;0;0;1;0;1
109;07.10.2017;2017;10;01;Lauantai;0;2;2;0;0;0
109;07.10.2017;2017;10;02;Lauantai;1;0;1;0;0;0
109;07.10.2017;2017;10;03;Lauantai;0;0;0;0;1;1
109;07.10.2017;2017;10;04;Lauantai;0;1;1;1;1;2
109;07.10.2017;2017;10;05;Lauantai;0;0;0;0;0;0
109;07.10.2017;2017;10;06;Lauantai;2;2;4;1;1;2
109;07.10.2017;2017;10;07;Lauantai;4;4;8;0;0;0
109;07.10.2017;2017;10;08;Lauantai;3;0;3;1;3;4
109;07.10.2017;2017;10;09;Lauantai;4;3;7;3;2;5
109;07.10.2017;2017;10;10;Lauantai;12;1;13;8;7;15
109;07.10.2017;2017;10;11;Lauantai;11;3;14;1;1;2
109;07.10.2017;2017;10;12;Lauantai;2;10;12;3;2;5
109;07.10.2017;2017;10;13;Lauantai;9;10;19;4;0;4
109;07.10.2017;2017;10;14;Lauantai;15;12;27;9;1;10
109;07.10.2017;2017;10;15;Lauantai;8;8;16;5;1;6
109;07.10.2017;2017;10;16;Lauantai;6;7;13;5;2;7
109;07.10.2017;2017;10;17;Lauantai;7;2;9;3;2;5
109;07.10.2017;2017;10;18;Lauantai;8;8;16;2;2;4
109;07.10.2017;2017;10;19;Lauantai;11;11;22;5;1;6
109;07.10.2017;2017;10;20;Lauantai;6;2;8;6;2;8
109;07.10.2017;2017;10;21;Lauantai;2;6;8;2;0;2
109;07.10.2017;2017;10;22;Lauantai;3;1;4;1;1;2
109;07.10.2017;2017;10;23;Lauantai;2;1;3;1;0;1
109;08.10.2017;2017;10;00;Sunnuntai;1;0;1;0;0;0
109;08.10.2017;2017;10;01;Sunnuntai;4;4;8;0;0;0
109;08.10.2017;2017;10;02;Sunnuntai;0;3;3;1;0;1
109;08.10.2017;2017;10;03;Sunnuntai;0;0;0;0;0;0
109;08.10.2017;2017;10;04;Sunnuntai;0;0;0;0;1;1
109;08.10.2017;2017;10;05;Sunnuntai;0;2;2;0;1;1
109;08.10.2017;2017;10;06;Sunnuntai;2;1;3;1;0;1
109;08.10.2017;2017;10;07;Sunnuntai;1;0;1;2;2;4
109;08.10.2017;2017;10;08;Sunnuntai;3;1;4;3;0;3
109;08.10.2017;2017;10;09;Sunnuntai;4;1;5;6;2;8
109;08.10.2017;2017;10;10;Sunnuntai;9;3;12;3;4;7
109;08.10.2017;2017;10;11;Sunnuntai;13;8;21;6;3;9
109;08.10.2017;2017;10;12;Sunnuntai;18;6;24;2;3;5
109;08.10.2017;2017;10;13;Sunnuntai;5;6;11;4;0;4
109;08.10.2017;2017;10;14;Sunnuntai;13;3;16;3;0;3
109;08.10.2017;2017;10;15;Sunnuntai;13;9;22;3;6;9
109;08.10.2017;2017;10;16;Sunnuntai;16;6;22;4;5;9
109;08.10.2017;2017;10;17;Sunnuntai;8;8;16;4;1;5
109;08.10.2017;2017;10;18;Sunnuntai;4;6;10;10;5;15
109;08.10.2017;2017;10;19;Sunnuntai;7;3;10;9;2;11
109;08.10.2017;2017;10;20;Sunnuntai;2;6;8;1;3;4
109;08.10.2017;2017;10;21;Sunnuntai;1;2;3;2;4;6
109;08.10.2017;2017;10;22;Sunnuntai;1;2;3;0;0;0
109;08.10.2017;2017;10;23;Sunnuntai;1;0;1;0;0;0
109;09.10.2017;2017;10;00;Maanantai;0;0;0;0;0;0
109;09.10.2017;2017;10;01;Maanantai;0;1;1;0;0;0
109;09.10.2017;2017;10;02;Maanantai;0;0;0;0;0;0
109;09.10.2017;2017;10;03;Maanantai;0;0;0;0;1;1
109;09.10.2017;2017;10;04;Maanantai;0;1;1;1;0;1
109;09.10.2017;2017;10;05;Maanantai;3;0;3;1;0;1
109;09.10.2017;2017;10;06;Maanantai;21;14;35;4;2;6
109;09.10.2017;2017;10;07;Maanantai;52;26;78;6;4;10
109;09.10.2017;2017;10;08;Maanantai;47;19;66;5;6;11
109;09.10.2017;2017;10;09;Maanantai;24;5;29;4;5;9
109;09.10.2017;2017;10;10;Maanantai;13;6;19;7;3;10
109;09.10.2017;2017;10;11;Maanantai;10;8;18;2;2;4
109;09.10.2017;2017;10;12;Maanantai;12;7;19;3;1;4
109;09.10.2017;2017;10;13;Maanantai;12;15;27;2;4;6
109;09.10.2017;2017;10;14;Maanantai;15;21;36;5;2;7
109;09.10.2017;2017;10;15;Maanantai;25;40;65;4;2;6
109;09.10.2017;2017;10;16;Maanantai;34;60;94;6;3;9
109;09.10.2017;2017;10;17;Maanantai;9;24;33;6;3;9
109;09.10.2017;2017;10;18;Maanantai;17;14;31;8;3;11
109;09.10.2017;2017;10;19;Maanantai;4;11;15;8;6;14
109;09.10.2017;2017;10;20;Maanantai;3;2;5;3;0;3
109;09.10.2017;2017;10;21;Maanantai;2;11;13;1;2;3
109;09.10.2017;2017;10;22;Maanantai;8;1;9;6;2;8
109;09.10.2017;2017;10;23;Maanantai;1;3;4;0;1;1
109;10.10.2017;2017;10;00;Tiistai;0;0;0;0;0;0
109;10.10.2017;2017;10;01;Tiistai;0;0;0;0;0;0
109;10.10.2017;2017;10;02;Tiistai;0;1;1;0;0;0
109;10.10.2017;2017;10;03;Tiistai;0;1;1;0;0;0
109;10.10.2017;2017;10;04;Tiistai;0;0;0;1;0;1
109;10.10.2017;2017;10;05;Tiistai;1;1;2;0;0;0
109;10.10.2017;2017;10;06;Tiistai;18;6;24;3;1;4
109;10.10.2017;2017;10;07;Tiistai;47;28;75;5;2;7
109;10.10.2017;2017;10;08;Tiistai;30;12;42;2;2;4
109;10.10.2017;2017;10;09;Tiistai;10;1;11;0;1;1
109;10.10.2017;2017;10;10;Tiistai;6;3;9;7;3;10
109;10.10.2017;2017;10;11;Tiistai;7;8;15;3;1;4
109;10.10.2017;2017;10;12;Tiistai;11;4;15;4;3;7
109;10.10.2017;2017;10;13;Tiistai;1;6;7;2;6;8
109;10.10.2017;2017;10;14;Tiistai;6;10;16;7;2;9
109;10.10.2017;2017;10;15;Tiistai;14;29;43;4;5;9
109;10.10.2017;2017;10;16;Tiistai;29;43;72;8;0;8
109;10.10.2017;2017;10;17;Tiistai;16;21;37;5;4;9
109;10.10.2017;2017;10;18;Tiistai;9;9;18;12;4;16
109;10.10.2017;2017;10;19;Tiistai;2;3;5;9;7;16
109;10.10.2017;2017;10;20;Tiistai;3;8;11;3;4;7
109;10.10.2017;2017;10;21;Tiistai;2;4;6;1;1;2
109;10.10.2017;2017;10;22;Tiistai;2;1;3;0;0;0
109;10.10.2017;2017;10;23;Tiistai;1;1;2;3;1;4
109;11.10.2017;2017;10;00;Keskiviikko;1;0;1;0;0;0
109;11.10.2017;2017;10;01;Keskiviikko;0;0;0;0;2;2
109;11.10.2017;2017;10;02;Keskiviikko;1;0;1;0;0;0
109;11.10.2017;2017;10;03;Keskiviikko;0;0;0;0;0;0
109;11.10.2017;2017;10;04;Keskiviikko;0;0;0;1;0;1
109;11.10.2017;2017;10;05;Keskiviikko;2;2;4;0;0;0
109;11.10.2017;2017;10;06;Keskiviikko;25;10;35;7;0;7
109;11.10.2017;2017;10;07;Keskiviikko;49;30;79;2;2;4
109;11.10.2017;2017;10;08;Keskiviikko;41;17;58;5;2;7
109;11.10.2017;2017;10;09;Keskiviikko;16;5;21;2;4;6
109;11.10.2017;2017;10;10;Keskiviikko;9;7;16;5;4;9
109;11.10.2017;2017;10;11;Keskiviikko;10;13;23;5;3;8
109;11.10.2017;2017;10;12;Keskiviikko;8;12;20;5;5;10
109;11.10.2017;2017;10;13;Keskiviikko;15;15;30;3;3;6
109;11.10.2017;2017;10;14;Keskiviikko;12;15;27;5;3;8
109;11.10.2017;2017;10;15;Keskiviikko;16;28;44;5;6;11
109;11.10.2017;2017;10;16;Keskiviikko;34;50;84;8;3;11
109;11.10.2017;2017;10;17;Keskiviikko;19;23;42;4;2;6
109;11.10.2017;2017;10;18;Keskiviikko;13;13;26;9;6;15
109;11.10.2017;2017;10;19;Keskiviikko;10;6;16;8;5;13
109;11.10.2017;2017;10;20;Keskiviikko;7;9;16;6;3;9
109;11.10.2017;2017;10;21;Keskiviikko;4;5;9;3;3;6
109;11.10.2017;2017;10;22;Keskiviikko;4;1;5;2;0;2
109;11.10.2017;2017;10;23;Keskiviikko;0;0;0;1;0;1
109;12.10.2017;2017;10;00;Torstai;0;0;0;0;0;0
109;12.10.2017;2017;10;01;Torstai;0;1;1;0;0;0
109;12.10.2017;2017;10;02;Torstai;0;0;0;0;0;0
109;12.10.2017;2017;10;03;Torstai;0;1;1;0;2;2
109;12.10.2017;2017;10;04;Torstai;1;0;1;1;0;1
109;12.10.2017;2017;10;05;Torstai;0;0;0;0;0;0
109;12.10.2017;2017;10;06;Torstai;23;10;33;4;1;5
109;12.10.2017;2017;10;07;Torstai;65;29;94;7;5;12
109;12.10.2017;2017;10;08;Torstai;32;13;45;3;5;8
109;12.10.2017;2017;10;09;Torstai;14;2;16;5;2;7
109;12.10.2017;2017;10;10;Torstai;11;4;15;5;6;11
109;12.10.2017;2017;10;11;Torstai;15;12;27;4;1;5
109;12.10.2017;2017;10;12;Torstai;12;5;17;22;18;40
109;12.10.2017;2017;10;13;Torstai;7;13;20;2;5;7
109;12.10.2017;2017;10;14;Torstai;13;20;33;2;1;3
109;12.10.2017;2017;10;15;Torstai;14;29;43;6;7;13
109;12.10.2017;2017;10;16;Torstai;34;56;90;4;6;10
109;12.10.2017;2017;10;17;Torstai;17;27;44;6;6;12
109;12.10.2017;2017;10;18;Torstai;11;10;21;9;2;11
109;12.10.2017;2017;10;19;Torstai;7;8;15;7;2;9
109;12.10.2017;2017;10;20;Torstai;3;5;8;5;1;6
109;12.10.2017;2017;10;21;Torstai;2;4;6;3;0;3
109;12.10.2017;2017;10;22;Torstai;3;2;5;1;0;1
109;12.10.2017;2017;10;23;Torstai;1;1;2;0;1;1
109;13.10.2017;2017;10;00;Perjantai;0;0;0;0;0;0
109;13.10.2017;2017;10;01;Perjantai;0;0;0;2;2;4
109;13.10.2017;2017;10;02;Perjantai;0;0;0;1;0;1
109;13.10.2017;2017;10;03;Perjantai;1;0;1;0;0;0
109;13.10.2017;2017;10;04;Perjantai;0;0;0;1;0;1
109;13.10.2017;2017;10;05;Perjantai;0;0;0;2;1;3
109;13.10.2017;2017;10;06;Perjantai;23;6;29;4;1;5
109;13.10.2017;2017;10;07;Perjantai;43;25;68;3;1;4
109;13.10.2017;2017;10;08;Perjantai;37;20;57;1;4;5
109;13.10.2017;2017;10;09;Perjantai;15;9;24;7;4;11
109;13.10.2017;2017;10;10;Perjantai;12;5;17;5;5;10
109;13.10.2017;2017;10;11;Perjantai;15;10;25;5;2;7
109;13.10.2017;2017;10;12;Perjantai;15;13;28;1;2;3
109;13.10.2017;2017;10;13;Perjantai;11;8;19;5;2;7
109;13.10.2017;2017;10;14;Perjantai;7;25;32;5;0;5
109;13.10.2017;2017;10;15;Perjantai;19;21;40;3;3;6
109;13.10.2017;2017;10;16;Perjantai;30;29;59;5;4;9
109;13.10.2017;2017;10;17;Perjantai;13;10;23;4;5;9
109;13.10.2017;2017;10;18;Perjantai;13;8;21;2;1;3
109;13.10.2017;2017;10;19;Perjantai;5;6;11;5;4;9
109;13.10.2017;2017;10;20;Perjantai;4;7;11;6;1;7
109;13.10.2017;2017;10;21;Perjantai;1;6;7;4;2;6
109;13.10.2017;2017;10;22;Perjantai;2;1;3;2;1;3
109;13.10.2017;2017;10;23;Perjantai;3;4;7;1;0;1
109;14.10.2017;2017;10;00;Lauantai;2;1;3;1;1;2
109;14.10.2017;2017;10;01;Lauantai;3;4;7;0;0;0
109;14.10.2017;2017;10;02;Lauantai;1;2;3;0;1;1
109;14.10.2017;2017;10;03;Lauantai;0;0;0;0;0;0
109;14.10.2017;2017;10;04;Lauantai;0;0;0;0;0;0
109;14.10.2017;2017;10;05;Lauantai;0;0;0;1;1;2
109;14.10.2017;2017;10;06;Lauantai;2;0;2;0;0;0
109;14.10.2017;2017;10;07;Lauantai;2;0;2;0;1;1
109;14.10.2017;2017;10;08;Lauantai;5;4;9;4;2;6
109;14.10.2017;2017;10;09;Lauantai;1;0;1;3;0;3
109;14.10.2017;2017;10;10;Lauantai;10;2;12;4;5;9
109;14.10.2017;2017;10;11;Lauantai;8;4;12;6;3;9
109;14.10.2017;2017;10;12;Lauantai;6;3;9;6;5;11
109;14.10.2017;2017;10;13;Lauantai;14;13;27;6;2;8
109;14.10.2017;2017;10;14;Lauantai;10;7;17;4;4;8
109;14.10.2017;2017;10;15;Lauantai;13;15;28;7;4;11
109;14.10.2017;2017;10;16;Lauantai;3;9;12;4;1;5
109;14.10.2017;2017;10;17;Lauantai;2;4;6;1;0;1
109;14.10.2017;2017;10;18;Lauantai;2;3;5;2;0;2
109;14.10.2017;2017;10;19;Lauantai;7;6;13;1;1;2
109;14.10.2017;2017;10;20;Lauantai;1;2;3;6;2;8
109;14.10.2017;2017;10;21;Lauantai;1;4;5;4;3;7
109;14.10.2017;2017;10;22;Lauantai;1;0;1;5;0;5
109;14.10.2017;2017;10;23;Lauantai;1;0;1;0;0;0
109;15.10.2017;2017;10;00;Sunnuntai;0;1;1;1;0;1
109;15.10.2017;2017;10;01;Sunnuntai;0;0;0;1;0;1
109;15.10.2017;2017;10;02;Sunnuntai;1;0;1;1;2;3
109;15.10.2017;2017;10;03;Sunnuntai;0;0;0;3;0;3
109;15.10.2017;2017;10;04;Sunnuntai;1;1;2;1;1;2
109;15.10.2017;2017;10;05;Sunnuntai;0;1;1;0;1;1
109;15.10.2017;2017;10;06;Sunnuntai;1;0;1;1;0;1
109;15.10.2017;2017;10;07;Sunnuntai;0;1;1;1;2;3
109;15.10.2017;2017;10;08;Sunnuntai;3;0;3;3;0;3
109;15.10.2017;2017;10;09;Sunnuntai;2;0;2;10;3;13
109;15.10.2017;2017;10;10;Sunnuntai;9;2;11;6;5;11
109;15.10.2017;2017;10;11;Sunnuntai;10;6;16;7;4;11
109;15.10.2017;2017;10;12;Sunnuntai;9;6;15;4;1;5
109;15.10.2017;2017;10;13;Sunnuntai;11;3;14;1;2;3
109;15.10.2017;2017;10;14;Sunnuntai;8;9;17;6;5;11
109;15.10.2017;2017;10;15;Sunnuntai;6;14;20;3;3;6
109;15.10.2017;2017;10;16;Sunnuntai;7;5;12;1;1;2
109;15.10.2017;2017;10;17;Sunnuntai;14;8;22;6;8;14
109;15.10.2017;2017;10;18;Sunnuntai;11;2;13;4;0;4
109;15.10.2017;2017;10;19;Sunnuntai;2;4;6;9;3;12
109;15.10.2017;2017;10;20;Sunnuntai;2;2;4;3;4;7
109;15.10.2017;2017;10;21;Sunnuntai;2;5;7;4;4;8
109;15.10.2017;2017;10;22;Sunnuntai;3;1;4;1;0;1
109;15.10.2017;2017;10;23;Sunnuntai;4;0;4;0;0;0
109;16.10.2017;2017;10;00;Maanantai;0;2;2;0;0;0
109;16.10.2017;2017;10;01;Maanantai;0;0;0;0;0;0
109;16.10.2017;2017;10;02;Maanantai;1;0;1;0;0;0
109;16.10.2017;2017;10;03;Maanantai;0;0;0;0;0;0
109;16.10.2017;2017;10;04;Maanantai;0;3;3;1;0;1
109;16.10.2017;2017;10;05;Maanantai;3;2;5;1;0;1
109;16.10.2017;2017;10;06;Maanantai;16;11;27;2;1;3
109;16.10.2017;2017;10;07;Maanantai;56;27;83;6;3;9
109;16.10.2017;2017;10;08;Maanantai;29;12;41;2;3;5
109;16.10.2017;2017;10;09;Maanantai;13;4;17;3;0;3
109;16.10.2017;2017;10;10;Maanantai;3;0;3;1;0;1
109;16.10.2017;2017;10;11;Maanantai;5;6;11;1;2;3
109;16.10.2017;2017;10;12;Maanantai;10;3;13;3;1;4
109;16.10.2017;2017;10;13;Maanantai;9;6;15;1;1;2
109;16.10.2017;2017;10;14;Maanantai;7;17;24;5;1;6
109;16.10.2017;2017;10;15;Maanantai;17;20;37;6;5;11
109;16.10.2017;2017;10;16;Maanantai;27;46;73;6;4;10
109;16.10.2017;2017;10;17;Maanantai;12;19;31;3;4;7
109;16.10.2017;2017;10;18;Maanantai;8;9;17;6;6;12
109;16.10.2017;2017;10;19;Maanantai;6;1;7;4;4;8
109;16.10.2017;2017;10;20;Maanantai;0;0;0;2;2;4
109;16.10.2017;2017;10;21;Maanantai;2;5;7;3;1;4
109;16.10.2017;2017;10;22;Maanantai;4;4;8;1;2;3
109;16.10.2017;2017;10;23;Maanantai;0;1;1;0;1;1
109;17.10.2017;2017;10;00;Tiistai;0;0;0;1;1;2
109;17.10.2017;2017;10;01;Tiistai;0;0;0;0;0;0
109;17.10.2017;2017;10;02;Tiistai;1;0;1;0;1;1
109;17.10.2017;2017;10;03;Tiistai;0;0;0;0;0;0
109;17.10.2017;2017;10;04;Tiistai;0;1;1;1;0;1
109;17.10.2017;2017;10;05;Tiistai;3;3;6;2;0;2
109;17.10.2017;2017;10;06;Tiistai;18;11;29;2;1;3
109;17.10.2017;2017;10;07;Tiistai;58;28;86;6;5;11
109;17.10.2017;2017;10;08;Tiistai;42;11;53;6;3;9
109;17.10.2017;2017;10;09;Tiistai;17;4;21;2;3;5
109;17.10.2017;2017;10;10;Tiistai;17;8;25;4;2;6
109;17.10.2017;2017;10;11;Tiistai;7;12;19;1;3;4
109;17.10.2017;2017;10;12;Tiistai;14;4;18;2;4;6
109;17.10.2017;2017;10;13;Tiistai;16;9;25;2;5;7
109;17.10.2017;2017;10;14;Tiistai;16;18;34;3;3;6
109;17.10.2017;2017;10;15;Tiistai;17;32;49;8;4;12
109;17.10.2017;2017;10;16;Tiistai;28;62;90;5;4;9
109;17.10.2017;2017;10;17;Tiistai;23;17;40;2;4;6
109;17.10.2017;2017;10;18;Tiistai;9;9;18;3;4;7
109;17.10.2017;2017;10;19;Tiistai;5;16;21;6;7;13
109;17.10.2017;2017;10;20;Tiistai;2;6;8;0;2;2
109;17.10.2017;2017;10;21;Tiistai;4;7;11;0;3;3
109;17.10.2017;2017;10;22;Tiistai;4;2;6;0;2;2
109;17.10.2017;2017;10;23;Tiistai;3;1;4;0;0;0
109;18.10.2017;2017;10;00;Keskiviikko;1;0;1;1;1;2
109;18.10.2017;2017;10;01;Keskiviikko;0;0;0;0;0;0
109;18.10.2017;2017;10;02;Keskiviikko;0;0;0;0;0;0
109;18.10.2017;2017;10;03;Keskiviikko;0;1;1;0;0;0
109;18.10.2017;2017;10;04;Keskiviikko;2;5;7;1;0;1
109;18.10.2017;2017;10;05;Keskiviikko;2;2;4;0;0;0
109;18.10.2017;2017;10;06;Keskiviikko;20;9;29;3;1;4
109;18.10.2017;2017;10;07;Keskiviikko;53;20;73;5;2;7
109;18.10.2017;2017;10;08;Keskiviikko;31;14;45;6;2;8
109;18.10.2017;2017;10;09;Keskiviikko;13;4;17;4;4;8
109;18.10.2017;2017;10;10;Keskiviikko;13;5;18;8;6;14
109;18.10.2017;2017;10;11;Keskiviikko;12;3;15;1;4;5
109;18.10.2017;2017;10;12;Keskiviikko;10;5;15;5;4;9
109;18.10.2017;2017;10;13;Keskiviikko;15;10;25;0;1;1
109;18.10.2017;2017;10;14;Keskiviikko;14;14;28;5;4;9
109;18.10.2017;2017;10;15;Keskiviikko;15;21;36;4;4;8
109;18.10.2017;2017;10;16;Keskiviikko;26;56;82;8;2;10
109;18.10.2017;2017;10;17;Keskiviikko;15;21;36;3;3;6
109;18.10.2017;2017;10;18;Keskiviikko;16;13;29;8;1;9
109;18.10.2017;2017;10;19;Keskiviikko;8;6;14;3;4;7
109;18.10.2017;2017;10;20;Keskiviikko;4;6;10;7;7;14
109;18.10.2017;2017;10;21;Keskiviikko;2;7;9;2;2;4
109;18.10.2017;2017;10;22;Keskiviikko;2;3;5;1;1;2
109;18.10.2017;2017;10;23;Keskiviikko;0;0;0;2;1;3
109;19.10.2017;2017;10;00;Torstai;0;1;1;0;0;0
109;19.10.2017;2017;10;01;Torstai;0;0;0;1;1;2
109;19.10.2017;2017;10;02;Torstai;0;0;0;0;0;0
109;19.10.2017;2017;10;03;Torstai;0;2;2;0;0;0
109;19.10.2017;2017;10;04;Torstai;0;2;2;1;1;2
109;19.10.2017;2017;10;05;Torstai;1;1;2;1;1;2
109;19.10.2017;2017;10;06;Torstai;21;10;31;4;2;6
109;19.10.2017;2017;10;07;Torstai;51;19;70;4;3;7
109;19.10.2017;2017;10;08;Torstai;44;11;55;5;5;10
109;19.10.2017;2017;10;09;Torstai;17;1;18;1;4;5
109;19.10.2017;2017;10;10;Torstai;14;10;24;7;3;10
109;19.10.2017;2017;10;11;Torstai;9;6;15;5;3;8
109;19.10.2017;2017;10;12;Torstai;12;6;18;1;5;6
109;19.10.2017;2017;10;13;Torstai;16;12;28;2;4;6
109;19.10.2017;2017;10;14;Torstai;10;13;23;7;5;12
109;19.10.2017;2017;10;15;Torstai;20;33;53;4;4;8
109;19.10.2017;2017;10;16;Torstai;22;46;68;2;1;3
109;19.10.2017;2017;10;17;Torstai;13;24;37;8;2;10
109;19.10.2017;2017;10;18;Torstai;16;14;30;7;2;9
109;19.10.2017;2017;10;19;Torstai;12;11;23;3;6;9
109;19.10.2017;2017;10;20;Torstai;6;6;12;6;3;9
109;19.10.2017;2017;10;21;Torstai;6;9;15;5;3;8
109;19.10.2017;2017;10;22;Torstai;1;3;4;2;0;2
109;19.10.2017;2017;10;23;Torstai;1;2;3;0;1;1
109;20.10.2017;2017;10;00;Perjantai;1;0;1;0;0;0
109;20.10.2017;2017;10;01;Perjantai;1;0;1;0;1;1
109;20.10.2017;2017;10;02;Perjantai;0;0;0;0;0;0
109;20.10.2017;2017;10;03;Perjantai;0;0;0;0;0;0
109;20.10.2017;2017;10;04;Perjantai;0;0;0;1;0;1
109;20.10.2017;2017;10;05;Perjantai;4;3;7;2;2;4
109;20.10.2017;2017;10;06;Perjantai;18;12;30;2;0;2
109;20.10.2017;2017;10;07;Perjantai;41;20;61;4;3;7
109;20.10.2017;2017;10;08;Perjantai;30;12;42;1;2;3
109;20.10.2017;2017;10;09;Perjantai;10;2;12;3;3;6
109;20.10.2017;2017;10;10;Perjantai;8;3;11;4;0;4
109;20.10.2017;2017;10;11;Perjantai;4;9;13;0;0;0
109;20.10.2017;2017;10;12;Perjantai;5;16;21;2;3;5
109;20.10.2017;2017;10;13;Perjantai;10;8;18;3;0;3
109;20.10.2017;2017;10;14;Perjantai;12;20;32;5;6;11
109;20.10.2017;2017;10;15;Perjantai;24;22;46;7;1;8
109;20.10.2017;2017;10;16;Perjantai;24;19;43;3;4;7
109;20.10.2017;2017;10;17;Perjantai;11;12;23;5;4;9
109;20.10.2017;2017;10;18;Perjantai;5;5;10;5;1;6
109;20.10.2017;2017;10;19;Perjantai;1;6;7;7;4;11
109;20.10.2017;2017;10;20;Perjantai;2;2;4;6;2;8
109;20.10.2017;2017;10;21;Perjantai;1;2;3;2;2;4
109;20.10.2017;2017;10;22;Perjantai;3;1;4;3;2;5
109;20.10.2017;2017;10;23;Perjantai;0;0;0;1;0;1
109;21.10.2017;2017;10;00;Lauantai;1;0;1;1;1;2
109;21.10.2017;2017;10;01;Lauantai;0;0;0;0;0;0
109;21.10.2017;2017;10;02;Lauantai;3;1;4;0;2;2
109;21.10.2017;2017;10;03;Lauantai;0;0;0;1;1;2
109;21.10.2017;2017;10;04;Lauantai;0;0;0;0;0;0
109;21.10.2017;2017;10;05;Lauantai;1;1;2;0;0;0
109;21.10.2017;2017;10;06;Lauantai;5;0;5;1;0;1
109;21.10.2017;2017;10;07;Lauantai;1;2;3;1;0;1
109;21.10.2017;2017;10;08;Lauantai;1;5;6;1;1;2
109;21.10.2017;2017;10;09;Lauantai;0;0;0;4;0;4
109;21.10.2017;2017;10;10;Lauantai;4;1;5;7;3;10
109;21.10.2017;2017;10;11;Lauantai;8;4;12;7;5;12
109;21.10.2017;2017;10;12;Lauantai;13;6;19;1;2;3
109;21.10.2017;2017;10;13;Lauantai;7;7;14;4;5;9
109;21.10.2017;2017;10;14;Lauantai;11;1;12;2;3;5
109;21.10.2017;2017;10;15;Lauantai;1;4;5;5;2;7
109;21.10.2017;2017;10;16;Lauantai;8;5;13;2;2;4
109;21.10.2017;2017;10;17;Lauantai;1;6;7;1;4;5
109;21.10.2017;2017;10;18;Lauantai;7;9;16;8;7;15
109;21.10.2017;2017;10;19;Lauantai;6;2;8;1;0;1
109;21.10.2017;2017;10;20;Lauantai;5;3;8;2;1;3
109;21.10.2017;2017;10;21;Lauantai;6;3;9;5;0;5
109;21.10.2017;2017;10;22;Lauantai;1;3;4;4;2;6
109;21.10.2017;2017;10;23;Lauantai;0;0;0;1;0;1
109;22.10.2017;2017;10;00;Sunnuntai;1;0;1;1;1;2
109;22.10.2017;2017;10;01;Sunnuntai;1;0;1;1;0;1
109;22.10.2017;2017;10;02;Sunnuntai;0;0;0;0;0;0
109;22.10.2017;2017;10;03;Sunnuntai;0;0;0;0;1;1
109;22.10.2017;2017;10;04;Sunnuntai;0;0;0;0;0;0
109;22.10.2017;2017;10;05;Sunnuntai;1;1;2;0;0;0
109;22.10.2017;2017;10;06;Sunnuntai;3;1;4;1;0;1
109;22.10.2017;2017;10;07;Sunnuntai;0;3;3;1;3;4
109;22.10.2017;2017;10;08;Sunnuntai;2;0;2;4;1;5
109;22.10.2017;2017;10;09;Sunnuntai;2;1;3;5;0;5
109;22.10.2017;2017;10;10;Sunnuntai;2;1;3;4;1;5
109;22.10.2017;2017;10;11;Sunnuntai;20;6;26;5;2;7
109;22.10.2017;2017;10;12;Sunnuntai;12;9;21;5;3;8
109;22.10.2017;2017;10;13;Sunnuntai;9;5;14;3;6;9
109;22.10.2017;2017;10;14;Sunnuntai;7;5;12;3;4;7
109;22.10.2017;2017;10;15;Sunnuntai;2;10;12;6;2;8
109;22.10.2017;2017;10;16;Sunnuntai;6;3;9;3;1;4
109;22.10.2017;2017;10;17;Sunnuntai;1;5;6;5;7;12
109;22.10.2017;2017;10;18;Sunnuntai;6;7;13;7;7;14
109;22.10.2017;2017;10;19;Sunnuntai;2;4;6;6;4;10
109;22.10.2017;2017;10;20;Sunnuntai;3;2;5;4;1;5
109;22.10.2017;2017;10;21;Sunnuntai;1;3;4;1;0;1
109;22.10.2017;2017;10;22;Sunnuntai;0;1;1;1;0;1
109;22.10.2017;2017;10;23;Sunnuntai;0;0;0;1;1;2
109;23.10.2017;2017;10;00;Maanantai;0;0;0;1;1;2
109;23.10.2017;2017;10;01;Maanantai;0;0;0;0;0;0
109;23.10.2017;2017;10;02;Maanantai;2;0;2;0;0;0
109;23.10.2017;2017;10;03;Maanantai;0;0;0;0;0;0
109;23.10.2017;2017;10;04;Maanantai;1;1;2;1;1;2
109;23.10.2017;2017;10;05;Maanantai;3;2;5;0;0;0
109;23.10.2017;2017;10;06;Maanantai;16;7;23;2;0;2
109;23.10.2017;2017;10;07;Maanantai;26;15;41;5;1;6
109;23.10.2017;2017;10;08;Maanantai;19;10;29;4;0;4
109;23.10.2017;2017;10;09;Maanantai;11;1;12;5;2;7
109;23.10.2017;2017;10;10;Maanantai;6;1;7;3;1;4
109;23.10.2017;2017;10;11;Maanantai;12;4;16;5;5;10
109;23.10.2017;2017;10;12;Maanantai;4;1;5;2;1;3
109;23.10.2017;2017;10;13;Maanantai;11;7;18;6;3;9
109;23.10.2017;2017;10;14;Maanantai;11;10;21;3;3;6
109;23.10.2017;2017;10;15;Maanantai;13;24;37;6;4;10
109;23.10.2017;2017;10;16;Maanantai;16;15;31;5;5;10
109;23.10.2017;2017;10;17;Maanantai;12;17;29;2;4;6
109;23.10.2017;2017;10;18;Maanantai;3;10;13;7;5;12
109;23.10.2017;2017;10;19;Maanantai;7;3;10;5;5;10
109;23.10.2017;2017;10;20;Maanantai;1;1;2;4;1;5
109;23.10.2017;2017;10;21;Maanantai;3;3;6;2;1;3
109;23.10.2017;2017;10;22;Maanantai;5;2;7;1;1;2
109;23.10.2017;2017;10;23;Maanantai;1;0;1;0;3;3
109;24.10.2017;2017;10;00;Tiistai;0;0;0;1;0;1
109;24.10.2017;2017;10;01;Tiistai;0;0;0;1;2;3
109;24.10.2017;2017;10;02;Tiistai;0;0;0;1;0;1
109;24.10.2017;2017;10;03;Tiistai;0;0;0;0;0;0
109;24.10.2017;2017;10;04;Tiistai;1;1;2;1;0;1
109;24.10.2017;2017;10;05;Tiistai;1;2;3;1;1;2
109;24.10.2017;2017;10;06;Tiistai;12;11;23;3;0;3
109;24.10.2017;2017;10;07;Tiistai;22;18;40;4;4;8
109;24.10.2017;2017;10;08;Tiistai;14;8;22;6;1;7
109;24.10.2017;2017;10;09;Tiistai;6;3;9;5;2;7
109;24.10.2017;2017;10;10;Tiistai;4;2;6;8;6;14
109;24.10.2017;2017;10;11;Tiistai;7;5;12;5;2;7
109;24.10.2017;2017;10;12;Tiistai;7;7;14;1;1;2
109;24.10.2017;2017;10;13;Tiistai;5;4;9;0;4;4
109;24.10.2017;2017;10;14;Tiistai;8;7;15;4;5;9
109;24.10.2017;2017;10;15;Tiistai;22;18;40;4;2;6
109;24.10.2017;2017;10;16;Tiistai;19;26;45;4;2;6
109;24.10.2017;2017;10;17;Tiistai;15;10;25;7;6;13
109;24.10.2017;2017;10;18;Tiistai;7;10;17;8;4;12
109;24.10.2017;2017;10;19;Tiistai;5;5;10;5;7;12
109;24.10.2017;2017;10;20;Tiistai;1;5;6;7;7;14
109;24.10.2017;2017;10;21;Tiistai;2;3;5;1;0;1
109;24.10.2017;2017;10;22;Tiistai;3;1;4;1;3;4
109;24.10.2017;2017;10;23;Tiistai;2;0;2;2;1;3
109;25.10.2017;2017;10;00;Keskiviikko;0;0;0;0;0;0
109;25.10.2017;2017;10;01;Keskiviikko;0;0;0;0;0;0
109;25.10.2017;2017;10;02;Keskiviikko;2;0;2;0;0;0
109;25.10.2017;2017;10;03;Keskiviikko;0;0;0;0;0;0
109;25.10.2017;2017;10;04;Keskiviikko;0;1;1;0;0;0
109;25.10.2017;2017;10;05;Keskiviikko;1;4;5;1;0;1
109;25.10.2017;2017;10;06;Keskiviikko;13;10;23;4;2;6
109;25.10.2017;2017;10;07;Keskiviikko;30;16;46;3;3;6
109;25.10.2017;2017;10;08;Keskiviikko;14;6;20;1;0;1
109;25.10.2017;2017;10;09;Keskiviikko;6;1;7;4;4;8
109;25.10.2017;2017;10;10;Keskiviikko;7;3;10;3;3;6
109;25.10.2017;2017;10;11;Keskiviikko;9;6;15;5;4;9
109;25.10.2017;2017;10;12;Keskiviikko;9;11;20;6;1;7
109;25.10.2017;2017;10;13;Keskiviikko;11;5;16;3;2;5
109;25.10.2017;2017;10;14;Keskiviikko;9;2;11;4;3;7
109;25.10.2017;2017;10;15;Keskiviikko;13;23;36;9;5;14
109;25.10.2017;2017;10;16;Keskiviikko;18;25;43;0;2;2
109;25.10.2017;2017;10;17;Keskiviikko;7;9;16;4;2;6
109;25.10.2017;2017;10;18;Keskiviikko;7;6;13;3;1;4
109;25.10.2017;2017;10;19;Keskiviikko;7;1;8;7;2;9
109;25.10.2017;2017;10;20;Keskiviikko;6;5;11;3;1;4
109;25.10.2017;2017;10;21;Keskiviikko;7;5;12;1;1;2
109;25.10.2017;2017;10;22;Keskiviikko;1;3;4;0;1;1
109;25.10.2017;2017;10;23;Keskiviikko;0;0;0;3;1;4
109;26.10.2017;2017;10;00;Torstai;0;0;0;0;0;0
109;26.10.2017;2017;10;01;Torstai;0;0;0;0;0;0
109;26.10.2017;2017;10;02;Torstai;0;0;0;1;0;1
109;26.10.2017;2017;10;03;Torstai;0;0;0;0;0;0
109;26.10.2017;2017;10;04;Torstai;0;1;1;2;0;2
109;26.10.2017;2017;10;05;Torstai;3;2;5;0;0;0
109;26.10.2017;2017;10;06;Torstai;11;6;17;1;2;3
109;26.10.2017;2017;10;07;Torstai;22;16;38;4;3;7
109;26.10.2017;2017;10;08;Torstai;19;8;27;6;0;6
109;26.10.2017;2017;10;09;Torstai;8;3;11;4;2;6
109;26.10.2017;2017;10;10;Torstai;4;5;9;5;5;10
109;26.10.2017;2017;10;11;Torstai;8;6;14;8;2;10
109;26.10.2017;2017;10;12;Torstai;15;8;23;5;3;8
109;26.10.2017;2017;10;13;Torstai;6;3;9;0;4;4
109;26.10.2017;2017;10;14;Torstai;19;10;29;6;4;10
109;26.10.2017;2017;10;15;Torstai;8;17;25;3;2;5
109;26.10.2017;2017;10;16;Torstai;16;19;35;3;6;9
109;26.10.2017;2017;10;17;Torstai;9;14;23;1;4;5
109;26.10.2017;2017;10;18;Torstai;4;5;9;7;1;8
109;26.10.2017;2017;10;19;Torstai;4;4;8;3;5;8
109;26.10.2017;2017;10;20;Torstai;0;2;2;4;4;8
109;26.10.2017;2017;10;21;Torstai;4;4;8;1;1;2
109;26.10.2017;2017;10;22;Torstai;1;3;4;1;5;6
109;26.10.2017;2017;10;23;Torstai;2;0;2;1;1;2
109;27.10.2017;2017;10;00;Perjantai;0;0;0;0;0;0
109;27.10.2017;2017;10;01;Perjantai;0;1;1;1;0;1
109;27.10.2017;2017;10;02;Perjantai;0;0;0;0;0;0
109;27.10.2017;2017;10;03;Perjantai;0;0;0;0;0;0
109;27.10.2017;2017;10;04;Perjantai;0;1;1;1;0;1
109;27.10.2017;2017;10;05;Perjantai;0;5;5;0;0;0
109;27.10.2017;2017;10;06;Perjantai;10;7;17;1;1;2
109;27.10.2017;2017;10;07;Perjantai;23;14;37;2;4;6
109;27.10.2017;2017;10;08;Perjantai;17;7;24;0;0;0
109;27.10.2017;2017;10;09;Perjantai;8;2;10;3;3;6
109;27.10.2017;2017;10;10;Perjantai;11;4;15;6;5;11
109;27.10.2017;2017;10;11;Perjantai;4;5;9;2;3;5
109;27.10.2017;2017;10;12;Perjantai;9;3;12;2;1;3
109;27.10.2017;2017;10;13;Perjantai;9;11;20;4;3;7
109;27.10.2017;2017;10;14;Perjantai;11;10;21;4;2;6
109;27.10.2017;2017;10;15;Perjantai;12;13;25;8;3;11
109;27.10.2017;2017;10;16;Perjantai;11;21;32;0;3;3
109;27.10.2017;2017;10;17;Perjantai;9;8;17;6;3;9
109;27.10.2017;2017;10;18;Perjantai;5;2;7;4;1;5
109;27.10.2017;2017;10;19;Perjantai;3;3;6;3;7;10
109;27.10.2017;2017;10;20;Perjantai;3;2;5;7;4;11
109;27.10.2017;2017;10;21;Perjantai;4;5;9;3;1;4
109;27.10.2017;2017;10;22;Perjantai;0;3;3;0;3;3
109;27.10.2017;2017;10;23;Perjantai;1;1;2;0;2;2
109;28.10.2017;2017;10;00;Lauantai;0;6;6;0;0;0
109;28.10.2017;2017;10;01;Lauantai;0;1;1;1;0;1
109;28.10.2017;2017;10;02;Lauantai;0;0;0;0;0;0
109;28.10.2017;2017;10;03;Lauantai;1;0;1;0;0;0
109;28.10.2017;2017;10;04;Lauantai;0;0;0;0;0;0
109;28.10.2017;2017;10;05;Lauantai;0;3;3;0;1;1
109;28.10.2017;2017;10;06;Lauantai;2;5;7;0;0;0
109;28.10.2017;2017;10;07;Lauantai;1;1;2;1;3;4
109;28.10.2017;2017;10;08;Lauantai;2;0;2;3;1;4
109;28.10.2017;2017;10;09;Lauantai;1;0;1;2;2;4
109;28.10.2017;2017;10;10;Lauantai;2;1;3;3;2;5
109;28.10.2017;2017;10;11;Lauantai;8;2;10;4;0;4
109;28.10.2017;2017;10;12;Lauantai;4;2;6;1;2;3
109;28.10.2017;2017;10;13;Lauantai;5;2;7;2;4;6
109;28.10.2017;2017;10;14;Lauantai;3;1;4;1;1;2
109;28.10.2017;2017;10;15;Lauantai;0;1;1;3;0;3
109;28.10.2017;2017;10;16;Lauantai;7;2;9;6;2;8
109;28.10.2017;2017;10;17;Lauantai;3;4;7;2;0;2
109;28.10.2017;2017;10;18;Lauantai;3;0;3;0;3;3
109;28.10.2017;2017;10;19;Lauantai;1;2;3;3;1;4
109;28.10.2017;2017;10;20;Lauantai;1;0;1;4;0;4
109;28.10.2017;2017;10;21;Lauantai;3;3;6;2;1;3
109;28.10.2017;2017;10;22;Lauantai;0;0;0;0;0;0
109;28.10.2017;2017;10;23;Lauantai;0;0;0;1;1;2
109;29.10.2017;2017;10;00;Sunnuntai;0;0;0;1;0;1
109;29.10.2017;2017;10;01;Sunnuntai;1;0;1;1;1;2
109;29.10.2017;2017;10;02;Sunnuntai;0;0;0;2;0;2
109;29.10.2017;2017;10;03;Sunnuntai;0;1;1;0;1;1
109;29.10.2017;2017;10;04;Sunnuntai;0;0;0;0;0;0
109;29.10.2017;2017;10;05;Sunnuntai;1;0;1;0;0;0
109;29.10.2017;2017;10;06;Sunnuntai;0;0;0;0;0;0
109;29.10.2017;2017;10;07;Sunnuntai;2;1;3;0;0;0
109;29.10.2017;2017;10;08;Sunnuntai;1;1;2;0;0;0
109;29.10.2017;2017;10;09;Sunnuntai;1;1;2;3;5;8
109;29.10.2017;2017;10;10;Sunnuntai;6;1;7;11;2;13
109;29.10.2017;2017;10;11;Sunnuntai;1;1;2;3;5;8
109;29.10.2017;2017;10;12;Sunnuntai;8;1;9;6;1;7
109;29.10.2017;2017;10;13;Sunnuntai;3;4;7;6;2;8
109;29.10.2017;2017;10;14;Sunnuntai;6;1;7;3;1;4
109;29.10.2017;2017;10;15;Sunnuntai;5;1;6;7;4;11
109;29.10.2017;2017;10;16;Sunnuntai;2;4;6;2;2;4
109;29.10.2017;2017;10;17;Sunnuntai;0;1;1;5;1;6
109;29.10.2017;2017;10;18;Sunnuntai;1;3;4;3;1;4
109;29.10.2017;2017;10;19;Sunnuntai;0;4;4;7;4;11
109;29.10.2017;2017;10;20;Sunnuntai;1;2;3;4;1;5
109;29.10.2017;2017;10;21;Sunnuntai;0;2;2;0;0;0
109;29.10.2017;2017;10;22;Sunnuntai;1;0;1;0;0;0
109;29.10.2017;2017;10;23;Sunnuntai;0;0;0;1;1;2
109;30.10.2017;2017;10;00;Maanantai;0;0;0;0;0;0
109;30.10.2017;2017;10;01;Maanantai;0;0;0;0;0;0
109;30.10.2017;2017;10;02;Maanantai;2;0;2;0;0;0
109;30.10.2017;2017;10;03;Maanantai;0;0;0;0;0;0
109;30.10.2017;2017;10;04;Maanantai;0;0;0;1;0;1
109;30.10.2017;2017;10;05;Maanantai;1;1;2;0;0;0
109;30.10.2017;2017;10;06;Maanantai;14;11;25;1;4;5
109;30.10.2017;2017;10;07;Maanantai;41;14;55;6;5;11
109;30.10.2017;2017;10;08;Maanantai;28;9;37;6;5;11
109;30.10.2017;2017;10;09;Maanantai;14;5;19;2;3;5
109;30.10.2017;2017;10;10;Maanantai;8;3;11;3;3;6
109;30.10.2017;2017;10;11;Maanantai;12;3;15;3;4;7
109;30.10.2017;2017;10;12;Maanantai;6;4;10;2;7;9
109;30.10.2017;2017;10;13;Maanantai;8;8;16;2;6;8
109;30.10.2017;2017;10;14;Maanantai;8;14;22;7;2;9
109;30.10.2017;2017;10;15;Maanantai;15;20;35;6;2;8
109;30.10.2017;2017;10;16;Maanantai;19;51;70;5;3;8
109;30.10.2017;2017;10;17;Maanantai;14;15;29;7;4;11
109;30.10.2017;2017;10;18;Maanantai;3;7;10;4;0;4
109;30.10.2017;2017;10;19;Maanantai;1;2;3;5;5;10
109;30.10.2017;2017;10;20;Maanantai;4;11;15;5;5;10
109;30.10.2017;2017;10;21;Maanantai;1;8;9;3;0;3
109;30.10.2017;2017;10;22;Maanantai;4;0;4;1;1;2
109;30.10.2017;2017;10;23;Maanantai;0;4;4;0;1;1
109;31.10.2017;2017;10;00;Tiistai;0;0;0;0;0;0
109;31.10.2017;2017;10;01;Tiistai;0;0;0;0;0;0
109;31.10.2017;2017;10;02;Tiistai;1;0;1;0;0;0
109;31.10.2017;2017;10;03;Tiistai;0;1;1;0;0;0
109;31.10.2017;2017;10;04;Tiistai;0;1;1;2;0;2
109;31.10.2017;2017;10;05;Tiistai;0;2;2;2;0;2
109;31.10.2017;2017;10;06;Tiistai;19;13;32;3;1;4
109;31.10.2017;2017;10;07;Tiistai;42;13;55;6;7;13
109;31.10.2017;2017;10;08;Tiistai;27;11;38;4;4;8
109;31.10.2017;2017;10;09;Tiistai;11;4;15;4;2;6
109;31.10.2017;2017;10;10;Tiistai;6;8;14;4;2;6
109;31.10.2017;2017;10;11;Tiistai;7;3;10;2;0;2
109;31.10.2017;2017;10;12;Tiistai;8;1;9;7;3;10
109;31.10.2017;2017;10;13;Tiistai;4;5;9;3;7;10
109;31.10.2017;2017;10;14;Tiistai;4;9;13;9;6;15
109;31.10.2017;2017;10;15;Tiistai;11;22;33;8;8;16
109;31.10.2017;2017;10;16;Tiistai;31;49;80;3;2;5
109;31.10.2017;2017;10;17;Tiistai;12;20;32;11;5;16
109;31.10.2017;2017;10;18;Tiistai;6;8;14;8;5;13
109;31.10.2017;2017;10;19;Tiistai;4;6;10;7;5;12
109;31.10.2017;2017;10;20;Tiistai;1;5;6;6;1;7
109;31.10.2017;2017;10;21;Tiistai;0;3;3;3;0;3
109;31.10.2017;2017;10;22;Tiistai;2;1;3;0;3;3
109;31.10.2017;2017;10;23;Tiistai;0;0;0;0;1;1
109;01.11.2017;2017;11;00;Keskiviikko;0;0;0;0;0;0
109;01.11.2017;2017;11;01;Keskiviikko;0;2;2;0;0;0
109;01.11.2017;2017;11;02;Keskiviikko;0;0;0;0;0;0
109;01.11.2017;2017;11;03;Keskiviikko;0;0;0;0;0;0
109;01.11.2017;2017;11;04;Keskiviikko;0;0;0;0;0;0
109;01.11.2017;2017;11;05;Keskiviikko;1;2;3;1;0;1
109;01.11.2017;2017;11;06;Keskiviikko;17;14;31;3;3;6
109;01.11.2017;2017;11;07;Keskiviikko;33;22;55;6;6;12
109;01.11.2017;2017;11;08;Keskiviikko;19;11;30;3;0;3
109;01.11.2017;2017;11;09;Keskiviikko;11;0;11;1;6;7
109;01.11.2017;2017;11;10;Keskiviikko;7;2;9;5;0;5
109;01.11.2017;2017;11;11;Keskiviikko;4;7;11;2;4;6
109;01.11.2017;2017;11;12;Keskiviikko;5;2;7;3;3;6
109;01.11.2017;2017;11;13;Keskiviikko;8;9;17;2;4;6
109;01.11.2017;2017;11;14;Keskiviikko;8;4;12;6;2;8
109;01.11.2017;2017;11;15;Keskiviikko;11;19;30;13;11;24
109;01.11.2017;2017;11;16;Keskiviikko;23;35;58;5;5;10
109;01.11.2017;2017;11;17;Keskiviikko;8;13;21;5;3;8
109;01.11.2017;2017;11;18;Keskiviikko;3;6;9;10;2;12
109;01.11.2017;2017;11;19;Keskiviikko;4;5;9;4;4;8
109;01.11.2017;2017;11;20;Keskiviikko;4;8;12;10;4;14
109;01.11.2017;2017;11;21;Keskiviikko;0;6;6;2;3;5
109;01.11.2017;2017;11;22;Keskiviikko;4;0;4;2;1;3
109;01.11.2017;2017;11;23;Keskiviikko;0;1;1;1;0;1
109;02.11.2017;2017;11;00;Torstai;0;0;0;0;0;0
109;02.11.2017;2017;11;01;Torstai;0;0;0;0;0;0
109;02.11.2017;2017;11;02;Torstai;0;0;0;1;0;1
109;02.11.2017;2017;11;03;Torstai;0;0;0;0;0;0
109;02.11.2017;2017;11;04;Torstai;0;1;1;1;0;1
109;02.11.2017;2017;11;05;Torstai;3;2;5;0;0;0
109;02.11.2017;2017;11;06;Torstai;13;7;20;1;1;2
109;02.11.2017;2017;11;07;Torstai;25;19;44;2;2;4
109;02.11.2017;2017;11;08;Torstai;22;10;32;3;0;3
109;02.11.2017;2017;11;09;Torstai;10;3;13;2;1;3
109;02.11.2017;2017;11;10;Torstai;4;6;10;3;3;6
109;02.11.2017;2017;11;11;Torstai;10;7;17;4;1;5
109;02.11.2017;2017;11;12;Torstai;18;10;28;3;2;5
109;02.11.2017;2017;11;13;Torstai;7;3;10;0;2;2
109;02.11.2017;2017;11;14;Torstai;22;12;34;3;2;5
109;02.11.2017;2017;11;15;Torstai;10;20;30;2;1;3
109;02.11.2017;2017;11;16;Torstai;19;22;41;2;3;5
109;02.11.2017;2017;11;17;Torstai;11;16;27;1;2;3
109;02.11.2017;2017;11;18;Torstai;4;6;10;4;1;5
109;02.11.2017;2017;11;19;Torstai;4;4;8;2;3;5
109;02.11.2017;2017;11;20;Torstai;0;2;2;2;2;4
109;02.11.2017;2017;11;21;Torstai;4;4;8;1;1;2
109;02.11.2017;2017;11;22;Torstai;1;3;4;1;3;4
109;02.11.2017;2017;11;23;Torstai;2;0;2;1;1;2
109;03.11.2017;2017;11;00;Perjantai;0;0;0;0;0;0
109;03.11.2017;2017;11;01;Perjantai;0;0;0;0;0;0
109;03.11.2017;2017;11;02;Perjantai;2;1;3;0;0;0
109;03.11.2017;2017;11;03;Perjantai;0;0;0;0;0;0
109;03.11.2017;2017;11;04;Perjantai;1;0;1;0;0;0
109;03.11.2017;2017;11;05;Perjantai;3;2;5;1;0;1
109;03.11.2017;2017;11;06;Perjantai;15;11;26;3;3;6
109;03.11.2017;2017;11;07;Perjantai;18;15;33;6;6;12
109;03.11.2017;2017;11;08;Perjantai;23;20;43;3;0;3
109;03.11.2017;2017;11;09;Perjantai;9;7;16;1;6;7
109;03.11.2017;2017;11;10;Perjantai;5;5;10;5;0;5
109;03.11.2017;2017;11;11;Perjantai;9;4;13;2;4;6
109;03.11.2017;2017;11;12;Perjantai;2;4;6;7;2;9
109;03.11.2017;2017;11;13;Perjantai;5;7;12;1;4;5
109;03.11.2017;2017;11;14;Perjantai;13;22;35;5;2;7
109;03.11.2017;2017;11;15;Perjantai;16;25;41;6;4;10
109;03.11.2017;2017;11;16;Perjantai;20;27;47;5;2;7
109;03.11.2017;2017;11;17;Perjantai;12;15;27;3;0;3
109;03.11.2017;2017;11;18;Perjantai;8;6;14;4;4;8
109;03.11.2017;2017;11;19;Perjantai;3;2;5;3;3;6
109;03.11.2017;2017;11;20;Perjantai;0;2;2;2;0;2
109;03.11.2017;2017;11;21;Perjantai;0;2;2;3;1;4
109;03.11.2017;2017;11;22;Perjantai;4;10;14;3;4;7
109;03.11.2017;2017;11;23;Perjantai;2;4;6;0;0;0
109;04.11.2017;2017;11;00;Lauantai;0;1;1;1;0;1
109;04.11.2017;2017;11;01;Lauantai;1;0;1;0;0;0
109;04.11.2017;2017;11;02;Lauantai;1;0;1;1;2;3
109;04.11.2017;2017;11;03;Lauantai;0;0;0;0;0;0
109;04.11.2017;2017;11;04;Lauantai;0;1;1;0;0;0
109;04.11.2017;2017;11;05;Lauantai;1;0;1;0;1;1
109;04.11.2017;2017;11;06;Lauantai;3;0;3;2;0;2
109;04.11.2017;2017;11;07;Lauantai;0;3;3;1;0;1
109;04.11.2017;2017;11;08;Lauantai;1;1;2;0;1;1
109;04.11.2017;2017;11;09;Lauantai;3;0;3;6;2;8
109;04.11.2017;2017;11;10;Lauantai;2;1;3;2;9;11
109;04.11.2017;2017;11;11;Lauantai;2;2;4;6;5;11
109;04.11.2017;2017;11;12;Lauantai;4;6;10;12;4;16
109;04.11.2017;2017;11;13;Lauantai;3;0;3;1;1;2
109;04.11.2017;2017;11;14;Lauantai;5;7;12;6;1;7
109;04.11.2017;2017;11;15;Lauantai;2;1;3;5;2;7
109;04.11.2017;2017;11;16;Lauantai;10;6;16;4;1;5
109;04.11.2017;2017;11;17;Lauantai;2;3;5;3;2;5
109;04.11.2017;2017;11;18;Lauantai;5;1;6;9;2;11
109;04.11.2017;2017;11;19;Lauantai;2;2;4;3;4;7
109;04.11.2017;2017;11;20;Lauantai;0;1;1;3;3;6
109;04.11.2017;2017;11;21;Lauantai;5;10;15;1;4;5
109;04.11.2017;2017;11;22;Lauantai;2;3;5;0;0;0
109;04.11.2017;2017;11;23;Lauantai;1;6;7;1;0;1
109;05.11.2017;2017;11;00;Sunnuntai;0;1;1;0;0;0
109;05.11.2017;2017;11;01;Sunnuntai;0;0;0;1;0;1
109;05.11.2017;2017;11;02;Sunnuntai;0;1;1;0;0;0
109;05.11.2017;2017;11;03;Sunnuntai;0;0;0;0;0;0
109;05.11.2017;2017;11;04;Sunnuntai;0;0;0;1;2;3
109;05.11.2017;2017;11;05;Sunnuntai;0;0;0;0;0;0
109;05.11.2017;2017;11;06;Sunnuntai;1;0;1;1;0;1
109;05.11.2017;2017;11;07;Sunnuntai;1;3;4;2;2;4
109;05.11.2017;2017;11;08;Sunnuntai;0;1;1;3;1;4
109;05.11.2017;2017;11;09;Sunnuntai;0;1;1;3;2;5
109;05.11.2017;2017;11;10;Sunnuntai;2;0;2;6;8;14
109;05.11.2017;2017;11;11;Sunnuntai;6;1;7;6;5;11
109;05.11.2017;2017;11;12;Sunnuntai;7;4;11;4;4;8
109;05.11.2017;2017;11;13;Sunnuntai;1;3;4;7;4;11
109;05.11.2017;2017;11;14;Sunnuntai;2;4;6;2;1;3
109;05.11.2017;2017;11;15;Sunnuntai;14;5;19;6;1;7
109;05.11.2017;2017;11;16;Sunnuntai;3;9;12;7;0;7
109;05.11.2017;2017;11;17;Sunnuntai;5;5;10;2;1;3
109;05.11.2017;2017;11;18;Sunnuntai;4;1;5;1;3;4
109;05.11.2017;2017;11;19;Sunnuntai;2;2;4;5;3;8
109;05.11.2017;2017;11;20;Sunnuntai;2;2;4;4;1;5
109;05.11.2017;2017;11;21;Sunnuntai;1;7;8;5;0;5
109;05.11.2017;2017;11;22;Sunnuntai;0;4;4;2;0;2
109;05.11.2017;2017;11;23;Sunnuntai;3;0;3;1;0;1
109;06.11.2017;2017;11;00;Maanantai;0;0;0;0;0;0
109;06.11.2017;2017;11;01;Maanantai;0;0;0;0;0;0
109;06.11.2017;2017;11;02;Maanantai;0;0;0;0;0;0
109;06.11.2017;2017;11;03;Maanantai;0;0;0;0;0;0
109;06.11.2017;2017;11;04;Maanantai;0;0;0;0;0;0
109;06.11.2017;2017;11;05;Maanantai;1;0;1;0;0;0
109;06.11.2017;2017;11;06;Maanantai;13;8;21;5;2;7
109;06.11.2017;2017;11;07;Maanantai;35;12;47;3;3;6
109;06.11.2017;2017;11;08;Maanantai;33;8;41;2;3;5
109;06.11.2017;2017;11;09;Maanantai;15;4;19;2;3;5
109;06.11.2017;2017;11;10;Maanantai;9;5;14;6;0;6
109;06.11.2017;2017;11;11;Maanantai;7;6;13;3;5;8
109;06.11.2017;2017;11;12;Maanantai;13;9;22;1;1;2
109;06.11.2017;2017;11;13;Maanantai;9;12;21;1;5;6
109;06.11.2017;2017;11;14;Maanantai;7;7;14;2;2;4
109;06.11.2017;2017;11;15;Maanantai;15;26;41;3;3;6
109;06.11.2017;2017;11;16;Maanantai;15;30;45;6;2;8
109;06.11.2017;2017;11;17;Maanantai;9;20;29;3;3;6
109;06.11.2017;2017;11;18;Maanantai;6;7;13;10;2;12
109;06.11.2017;2017;11;19;Maanantai;4;5;9;2;6;8
109;06.11.2017;2017;11;20;Maanantai;1;3;4;3;3;6
109;06.11.2017;2017;11;21;Maanantai;2;9;11;2;4;6
109;06.11.2017;2017;11;22;Maanantai;1;4;5;2;0;2
109;06.11.2017;2017;11;23;Maanantai;1;1;2;0;0;0
109;07.11.2017;2017;11;00;Tiistai;0;0;0;0;1;1
109;07.11.2017;2017;11;01;Tiistai;0;0;0;0;2;2
109;07.11.2017;2017;11;02;Tiistai;0;0;0;0;0;0
109;07.11.2017;2017;11;03;Tiistai;0;0;0;0;0;0
109;07.11.2017;2017;11;04;Tiistai;0;0;0;0;0;0
109;07.11.2017;2017;11;05;Tiistai;1;3;4;2;0;2
109;07.11.2017;2017;11;06;Tiistai;22;13;35;4;1;5
109;07.11.2017;2017;11;07;Tiistai;40;16;56;6;5;11
109;07.11.2017;2017;11;08;Tiistai;33;11;44;1;2;3
109;07.11.2017;2017;11;09;Tiistai;21;3;24;6;5;11
109;07.11.2017;2017;11;10;Tiistai;8;6;14;3;1;4
109;07.11.2017;2017;11;11;Tiistai;13;7;20;7;3;10
109;07.11.2017;2017;11;12;Tiistai;10;4;14;5;4;9
109;07.11.2017;2017;11;13;Tiistai;8;13;21;1;2;3
109;07.11.2017;2017;11;14;Tiistai;17;9;26;6;4;10
109;07.11.2017;2017;11;15;Tiistai;17;16;33;4;5;9
109;07.11.2017;2017;11;16;Tiistai;28;43;71;7;5;12
109;07.11.2017;2017;11;17;Tiistai;13;21;34;6;3;9
109;07.11.2017;2017;11;18;Tiistai;3;14;17;13;6;19
109;07.11.2017;2017;11;19;Tiistai;1;3;4;3;4;7
109;07.11.2017;2017;11;20;Tiistai;1;9;10;5;7;12
109;07.11.2017;2017;11;21;Tiistai;2;6;8;4;3;7
109;07.11.2017;2017;11;22;Tiistai;1;4;5;1;1;2
109;07.11.2017;2017;11;23;Tiistai;0;1;1;1;1;2
109;08.11.2017;2017;11;00;Keskiviikko;0;0;0;0;0;0
109;08.11.2017;2017;11;01;Keskiviikko;0;0;0;0;0;0
109;08.11.2017;2017;11;02;Keskiviikko;1;1;2;0;0;0
109;08.11.2017;2017;11;03;Keskiviikko;0;0;0;0;0;0
109;08.11.2017;2017;11;04;Keskiviikko;0;0;0;1;0;1
109;08.11.2017;2017;11;05;Keskiviikko;1;0;1;0;0;0
109;08.11.2017;2017;11;06;Keskiviikko;24;11;35;3;0;3
109;08.11.2017;2017;11;07;Keskiviikko;42;16;58;6;0;6
109;08.11.2017;2017;11;08;Keskiviikko;28;9;37;4;1;5
109;08.11.2017;2017;11;09;Keskiviikko;17;4;21;4;6;10
109;08.11.2017;2017;11;10;Keskiviikko;6;2;8;5;4;9
109;08.11.2017;2017;11;11;Keskiviikko;6;6;12;4;2;6
109;08.11.2017;2017;11;12;Keskiviikko;6;5;11;2;1;3
109;08.11.2017;2017;11;13;Keskiviikko;6;6;12;2;2;4
109;08.11.2017;2017;11;14;Keskiviikko;11;19;30;6;2;8
109;08.11.2017;2017;11;15;Keskiviikko;17;31;48;3;2;5
109;08.11.2017;2017;11;16;Keskiviikko;14;38;52;3;4;7
109;08.11.2017;2017;11;17;Keskiviikko;9;15;24;8;1;9
109;08.11.2017;2017;11;18;Keskiviikko;7;9;16;5;2;7
109;08.11.2017;2017;11;19;Keskiviikko;6;3;9;2;5;7
109;08.11.2017;2017;11;20;Keskiviikko;2;5;7;9;0;9
109;08.11.2017;2017;11;21;Keskiviikko;3;4;7;2;1;3
109;08.11.2017;2017;11;22;Keskiviikko;1;1;2;1;0;1
109;08.11.2017;2017;11;23;Keskiviikko;0;0;0;1;2;3
109;09.11.2017;2017;11;00;Torstai;0;0;0;1;0;1
109;09.11.2017;2017;11;01;Torstai;0;0;0;0;0;0
109;09.11.2017;2017;11;02;Torstai;1;0;1;0;0;0
109;09.11.2017;2017;11;03;Torstai;0;0;0;0;1;1
109;09.11.2017;2017;11;04;Torstai;0;0;0;0;0;0
109;09.11.2017;2017;11;05;Torstai;4;0;4;1;0;1
109;09.11.2017;2017;11;06;Torstai;21;10;31;2;1;3
109;09.11.2017;2017;11;07;Torstai;40;14;54;4;4;8
109;09.11.2017;2017;11;08;Torstai;36;11;47;4;2;6
109;09.11.2017;2017;11;09;Torstai;8;4;12;6;3;9
109;09.11.2017;2017;11;10;Torstai;6;2;8;4;1;5
109;09.11.2017;2017;11;11;Torstai;7;8;15;2;4;6
109;09.11.2017;2017;11;12;Torstai;14;5;19;3;3;6
109;09.11.2017;2017;11;13;Torstai;3;11;14;4;2;6
109;09.11.2017;2017;11;14;Torstai;9;11;20;5;2;7
109;09.11.2017;2017;11;15;Torstai;11;28;39;9;5;14
109;09.11.2017;2017;11;16;Torstai;19;32;51;3;1;4
109;09.11.2017;2017;11;17;Torstai;11;14;25;3;1;4
109;09.11.2017;2017;11;18;Torstai;8;11;19;1;3;4
109;09.11.2017;2017;11;19;Torstai;3;7;10;2;2;4
109;09.11.2017;2017;11;20;Torstai;3;5;8;4;0;4
109;09.11.2017;2017;11;21;Torstai;1;2;3;5;3;8
109;09.11.2017;2017;11;22;Torstai;2;2;4;2;1;3
109;09.11.2017;2017;11;23;Torstai;1;0;1;1;0;1
109;10.11.2017;2017;11;00;Perjantai;1;2;3;0;0;0
109;10.11.2017;2017;11;01;Perjantai;1;1;2;0;0;0
109;10.11.2017;2017;11;02;Perjantai;1;0;1;1;0;1
109;10.11.2017;2017;11;03;Perjantai;0;0;0;0;0;0
109;10.11.2017;2017;11;04;Perjantai;0;2;2;0;0;0
109;10.11.2017;2017;11;05;Perjantai;2;3;5;2;2;4
109;10.11.2017;2017;11;06;Perjantai;15;8;23;2;0;2
109;10.11.2017;2017;11;07;Perjantai;26;17;43;1;4;5
109;10.11.2017;2017;11;08;Perjantai;26;12;38;4;3;7
109;10.11.2017;2017;11;09;Perjantai;6;5;11;2;1;3
109;10.11.2017;2017;11;10;Perjantai;12;4;16;7;3;10
109;10.11.2017;2017;11;11;Perjantai;14;6;20;1;2;3
109;10.11.2017;2017;11;12;Perjantai;9;9;18;2;2;4
109;10.11.2017;2017;11;13;Perjantai;11;8;19;3;4;7
109;10.11.2017;2017;11;14;Perjantai;11;16;27;4;2;6
109;10.11.2017;2017;11;15;Perjantai;16;27;43;2;2;4
109;10.11.2017;2017;11;16;Perjantai;26;20;46;0;2;2
109;10.11.2017;2017;11;17;Perjantai;9;13;22;3;2;5
109;10.11.2017;2017;11;18;Perjantai;10;2;12;1;4;5
109;10.11.2017;2017;11;19;Perjantai;3;10;13;3;4;7
109;10.11.2017;2017;11;20;Perjantai;4;0;4;2;3;5
109;10.11.2017;2017;11;21;Perjantai;2;5;7;4;1;5
109;10.11.2017;2017;11;22;Perjantai;3;3;6;1;2;3
109;10.11.2017;2017;11;23;Perjantai;2;3;5;0;0;0
109;11.11.2017;2017;11;00;Lauantai;0;0;0;6;1;7
109;11.11.2017;2017;11;01;Lauantai;0;0;0;0;0;0
109;11.11.2017;2017;11;02;Lauantai;2;0;2;0;1;1
109;11.11.2017;2017;11;03;Lauantai;2;1;3;0;0;0
109;11.11.2017;2017;11;04;Lauantai;0;0;0;0;1;1
109;11.11.2017;2017;11;05;Lauantai;0;1;1;1;0;1
109;11.11.2017;2017;11;06;Lauantai;1;2;3;1;1;2
109;11.11.2017;2017;11;07;Lauantai;3;0;3;2;1;3
109;11.11.2017;2017;11;08;Lauantai;2;3;5;1;0;1
109;11.11.2017;2017;11;09;Lauantai;7;1;8;5;0;5
109;11.11.2017;2017;11;10;Lauantai;6;2;8;2;3;5
109;11.11.2017;2017;11;11;Lauantai;11;1;12;1;1;2
109;11.11.2017;2017;11;12;Lauantai;7;5;12;7;4;11
109;11.11.2017;2017;11;13;Lauantai;9;5;14;8;1;9
109;11.11.2017;2017;11;14;Lauantai;4;6;10;2;5;7
109;11.11.2017;2017;11;15;Lauantai;5;6;11;5;7;12
109;11.11.2017;2017;11;16;Lauantai;2;5;7;2;4;6
109;11.11.2017;2017;11;17;Lauantai;3;4;7;5;2;7
109;11.11.2017;2017;11;18;Lauantai;5;4;9;3;2;5
109;11.11.2017;2017;11;19;Lauantai;1;1;2;8;5;13
109;11.11.2017;2017;11;20;Lauantai;4;0;4;0;4;4
109;11.11.2017;2017;11;21;Lauantai;0;2;2;2;3;5
109;11.11.2017;2017;11;22;Lauantai;5;3;8;1;0;1
109;11.11.2017;2017;11;23;Lauantai;2;0;2;0;0;0
109;12.11.2017;2017;11;00;Sunnuntai;1;0;1;2;3;5
109;12.11.2017;2017;11;01;Sunnuntai;0;1;1;2;1;3
109;12.11.2017;2017;11;02;Sunnuntai;1;1;2;0;0;0
109;12.11.2017;2017;11;03;Sunnuntai;0;1;1;0;0;0
109;12.11.2017;2017;11;04;Sunnuntai;0;0;0;0;0;0
109;12.11.2017;2017;11;05;Sunnuntai;0;1;1;0;0;0
109;12.11.2017;2017;11;06;Sunnuntai;2;2;4;1;2;3
109;12.11.2017;2017;11;07;Sunnuntai;0;2;2;0;1;1
109;12.11.2017;2017;11;08;Sunnuntai;0;0;0;3;1;4
109;12.11.2017;2017;11;09;Sunnuntai;4;4;8;2;3;5
109;12.11.2017;2017;11;10;Sunnuntai;1;4;5;4;2;6
109;12.11.2017;2017;11;11;Sunnuntai;8;3;11;4;2;6
109;12.11.2017;2017;11;12;Sunnuntai;5;1;6;6;3;9
109;12.11.2017;2017;11;13;Sunnuntai;4;3;7;4;3;7
109;12.11.2017;2017;11;14;Sunnuntai;5;4;9;4;4;8
109;12.11.2017;2017;11;15;Sunnuntai;7;5;12;6;7;13
109;12.11.2017;2017;11;16;Sunnuntai;1;3;4;3;4;7
109;12.11.2017;2017;11;17;Sunnuntai;4;4;8;3;2;5
109;12.11.2017;2017;11;18;Sunnuntai;2;1;3;2;3;5
109;12.11.2017;2017;11;19;Sunnuntai;1;2;3;1;5;6
109;12.11.2017;2017;11;20;Sunnuntai;1;1;2;9;3;12
109;12.11.2017;2017;11;21;Sunnuntai;0;6;6;0;0;0
109;12.11.2017;2017;11;22;Sunnuntai;1;1;2;2;0;2
109;12.11.2017;2017;11;23;Sunnuntai;1;0;1;1;0;1
109;13.11.2017;2017;11;00;Maanantai;0;0;0;1;0;1
109;13.11.2017;2017;11;01;Maanantai;2;0;2;0;1;1
109;13.11.2017;2017;11;02;Maanantai;0;0;0;0;0;0
109;13.11.2017;2017;11;03;Maanantai;0;0;0;0;0;0
109;13.11.2017;2017;11;04;Maanantai;1;1;2;1;0;1
109;13.11.2017;2017;11;05;Maanantai;2;3;5;0;0;0
109;13.11.2017;2017;11;06;Maanantai;18;9;27;3;0;3
109;13.11.2017;2017;11;07;Maanantai;41;17;58;4;3;7
109;13.11.2017;2017;11;08;Maanantai;34;11;45;3;2;5
109;13.11.2017;2017;11;09;Maanantai;15;4;19;4;3;7
109;13.11.2017;2017;11;10;Maanantai;10;3;13;3;3;6
109;13.11.2017;2017;11;11;Maanantai;5;6;11;6;3;9
109;13.11.2017;2017;11;12;Maanantai;14;5;19;2;0;2
109;13.11.2017;2017;11;13;Maanantai;9;11;20;2;1;3
109;13.11.2017;2017;11;14;Maanantai;7;15;22;7;4;11
109;13.11.2017;2017;11;15;Maanantai;18;25;43;3;2;5
109;13.11.2017;2017;11;16;Maanantai;19;35;54;5;4;9
109;13.11.2017;2017;11;17;Maanantai;8;23;31;7;4;11
109;13.11.2017;2017;11;18;Maanantai;8;7;15;5;5;10
109;13.11.2017;2017;11;19;Maanantai;3;3;6;7;4;11
109;13.11.2017;2017;11;20;Maanantai;1;7;8;8;7;15
109;13.11.2017;2017;11;21;Maanantai;3;10;13;3;2;5
109;13.11.2017;2017;11;22;Maanantai;2;4;6;1;1;2
109;13.11.2017;2017;11;23;Maanantai;0;2;2;1;1;2
109;14.11.2017;2017;11;00;Tiistai;0;0;0;0;1;1
109;14.11.2017;2017;11;01;Tiistai;0;0;0;0;2;2
109;14.11.2017;2017;11;02;Tiistai;1;0;1;0;0;0
109;14.11.2017;2017;11;03;Tiistai;0;0;0;0;0;0
109;14.11.2017;2017;11;04;Tiistai;0;1;1;0;0;0
109;14.11.2017;2017;11;05;Tiistai;4;2;6;2;0;2
109;14.11.2017;2017;11;06;Tiistai;16;13;29;4;1;5
109;14.11.2017;2017;11;07;Tiistai;31;29;60;6;5;11
109;14.11.2017;2017;11;08;Tiistai;23;21;44;1;2;3
109;14.11.2017;2017;11;09;Tiistai;9;7;16;6;5;11
109;14.11.2017;2017;11;10;Tiistai;5;4;9;3;1;4
109;14.11.2017;2017;11;11;Tiistai;9;7;16;7;3;10
109;14.11.2017;2017;11;12;Tiistai;8;6;14;5;4;9
109;14.11.2017;2017;11;13;Tiistai;7;6;13;1;2;3
109;14.11.2017;2017;11;14;Tiistai;13;10;23;6;4;10
109;14.11.2017;2017;11;15;Tiistai;17;13;30;4;5;9
109;14.11.2017;2017;11;16;Tiistai;32;30;62;7;5;12
109;14.11.2017;2017;11;17;Tiistai;14;13;27;6;3;9
109;14.11.2017;2017;11;18;Tiistai;11;8;19;13;6;19
109;14.11.2017;2017;11;19;Tiistai;5;3;8;3;4;7
109;14.11.2017;2017;11;20;Tiistai;5;3;8;5;7;12
109;14.11.2017;2017;11;21;Tiistai;4;2;6;4;3;7
109;14.11.2017;2017;11;22;Tiistai;4;2;6;1;1;2
109;14.11.2017;2017;11;23;Tiistai;0;0;0;1;1;2
109;15.11.2017;2017;11;00;Keskiviikko;0;0;0;0;0;0
109;15.11.2017;2017;11;01;Keskiviikko;0;0;0;0;0;0
109;15.11.2017;2017;11;02;Keskiviikko;1;1;2;0;0;0
109;15.11.2017;2017;11;03;Keskiviikko;0;0;0;0;0;0
109;15.11.2017;2017;11;04;Keskiviikko;0;0;0;1;0;1
109;15.11.2017;2017;11;05;Keskiviikko;1;0;1;0;0;0
109;15.11.2017;2017;11;06;Keskiviikko;23;11;34;3;0;3
109;15.11.2017;2017;11;07;Keskiviikko;41;16;57;6;0;6
109;15.11.2017;2017;11;08;Keskiviikko;27;9;36;4;1;5
109;15.11.2017;2017;11;09;Keskiviikko;16;4;20;4;6;10
109;15.11.2017;2017;11;10;Keskiviikko;6;2;8;5;4;9
109;15.11.2017;2017;11;11;Keskiviikko;6;6;12;4;2;6
109;15.11.2017;2017;11;12;Keskiviikko;6;5;11;2;1;3
109;15.11.2017;2017;11;13;Keskiviikko;6;6;12;2;2;4
109;15.11.2017;2017;11;14;Keskiviikko;11;18;29;6;2;8
109;15.11.2017;2017;11;15;Keskiviikko;16;30;46;3;2;5
109;15.11.2017;2017;11;16;Keskiviikko;14;37;51;3;4;7
109;15.11.2017;2017;11;17;Keskiviikko;9;15;24;9;1;10
109;15.11.2017;2017;11;18;Keskiviikko;7;9;16;5;2;7
109;15.11.2017;2017;11;19;Keskiviikko;6;3;9;2;5;7
109;15.11.2017;2017;11;20;Keskiviikko;2;5;7;11;0;11
109;15.11.2017;2017;11;21;Keskiviikko;3;4;7;2;1;3
109;15.11.2017;2017;11;22;Keskiviikko;1;1;2;1;0;1
109;15.11.2017;2017;11;23;Keskiviikko;0;0;0;1;2;3
109;16.11.2017;2017;11;00;Torstai;0;0;0;1;0;1
109;16.11.2017;2017;11;01;Torstai;0;0;0;0;0;0
109;16.11.2017;2017;11;02;Torstai;1;0;1;0;0;0
109;16.11.2017;2017;11;03;Torstai;0;0;0;0;1;1
109;16.11.2017;2017;11;04;Torstai;0;0;0;0;0;0
109;16.11.2017;2017;11;05;Torstai;4;0;4;1;0;1
109;16.11.2017;2017;11;06;Torstai;20;10;30;2;1;3
109;16.11.2017;2017;11;07;Torstai;37;14;51;4;4;8
109;16.11.2017;2017;11;08;Torstai;33;11;44;4;2;6
109;16.11.2017;2017;11;09;Torstai;8;4;12;6;3;9
109;16.11.2017;2017;11;10;Torstai;6;2;8;4;1;5
109;16.11.2017;2017;11;11;Torstai;7;8;15;2;4;6
109;16.11.2017;2017;11;12;Torstai;14;5;19;3;3;6
109;16.11.2017;2017;11;13;Torstai;3;11;14;4;2;6
109;16.11.2017;2017;11;14;Torstai;9;11;20;5;2;7
109;16.11.2017;2017;11;15;Torstai;11;25;36;9;5;14
109;16.11.2017;2017;11;16;Torstai;18;29;47;3;1;4
109;16.11.2017;2017;11;17;Torstai;11;14;25;3;1;4
109;16.11.2017;2017;11;18;Torstai;8;11;19;1;3;4
109;16.11.2017;2017;11;19;Torstai;3;7;10;2;2;4
109;16.11.2017;2017;11;20;Torstai;3;5;8;4;0;4
109;16.11.2017;2017;11;21;Torstai;1;2;3;5;3;8
109;16.11.2017;2017;11;22;Torstai;2;2;4;2;1;3
109;16.11.2017;2017;11;23;Torstai;1;0;1;1;0;1
109;17.11.2017;2017;11;00;Perjantai;0;0;0;0;0;0
109;17.11.2017;2017;11;01;Perjantai;0;0;0;0;0;0
109;17.11.2017;2017;11;02;Perjantai;1;0;1;1;0;1
109;17.11.2017;2017;11;03;Perjantai;0;0;0;0;0;0
109;17.11.2017;2017;11;04;Perjantai;0;0;0;0;0;0
109;17.11.2017;2017;11;05;Perjantai;1;1;2;2;2;4
109;17.11.2017;2017;11;06;Perjantai;20;4;24;2;0;2
109;17.11.2017;2017;11;07;Perjantai;24;14;38;1;4;5
109;17.11.2017;2017;11;08;Perjantai;19;13;32;4;3;7
109;17.11.2017;2017;11;09;Perjantai;8;5;13;2;1;3
109;17.11.2017;2017;11;10;Perjantai;4;3;7;7;3;10
109;17.11.2017;2017;11;11;Perjantai;8;8;16;1;2;3
109;17.11.2017;2017;11;12;Perjantai;5;4;9;2;2;4
109;17.11.2017;2017;11;13;Perjantai;8;7;15;3;4;7
109;17.11.2017;2017;11;14;Perjantai;10;7;17;4;2;6
109;17.11.2017;2017;11;15;Perjantai;14;13;27;2;2;4
109;17.11.2017;2017;11;16;Perjantai;19;17;36;0;2;2
109;17.11.2017;2017;11;17;Perjantai;9;7;16;3;2;5
109;17.11.2017;2017;11;18;Perjantai;4;1;5;1;4;5
109;17.11.2017;2017;11;19;Perjantai;6;2;8;3;4;7
109;17.11.2017;2017;11;20;Perjantai;3;1;4;2;3;5
109;17.11.2017;2017;11;21;Perjantai;0;2;2;4;1;5
109;17.11.2017;2017;11;22;Perjantai;0;1;1;1;2;3
109;17.11.2017;2017;11;23;Perjantai;1;2;3;0;0;0
109;18.11.2017;2017;11;00;Lauantai;0;0;0;0;0;0
109;18.11.2017;2017;11;01;Lauantai;1;0;1;0;0;0
109;18.11.2017;2017;11;02;Lauantai;1;1;2;0;0;0
109;18.11.2017;2017;11;03;Lauantai;0;0;0;0;0;0
109;18.11.2017;2017;11;04;Lauantai;0;0;0;0;4;4
109;18.11.2017;2017;11;05;Lauantai;0;1;1;1;0;1
109;18.11.2017;2017;11;06;Lauantai;1;0;1;1;0;1
109;18.11.2017;2017;11;07;Lauantai;2;4;6;1;2;3
109;18.11.2017;2017;11;08;Lauantai;0;1;1;5;1;6
109;18.11.2017;2017;11;09;Lauantai;3;2;5;5;2;7
109;18.11.2017;2017;11;10;Lauantai;4;2;6;4;3;7
109;18.11.2017;2017;11;11;Lauantai;4;4;8;1;3;4
109;18.11.2017;2017;11;12;Lauantai;10;2;12;4;5;9
109;18.11.2017;2017;11;13;Lauantai;6;3;9;5;1;6
109;18.11.2017;2017;11;14;Lauantai;5;1;6;5;5;10
109;18.11.2017;2017;11;15;Lauantai;2;4;6;4;5;9
109;18.11.2017;2017;11;16;Lauantai;1;4;5;3;2;5
109;18.11.2017;2017;11;17;Lauantai;1;7;8;3;2;5
109;18.11.2017;2017;11;18;Lauantai;6;4;10;2;0;2
109;18.11.2017;2017;11;19;Lauantai;3;1;4;0;3;3
109;18.11.2017;2017;11;20;Lauantai;4;1;5;7;1;8
109;18.11.2017;2017;11;21;Lauantai;1;1;2;3;1;4
109;18.11.2017;2017;11;22;Lauantai;1;0;1;0;2;2
109;18.11.2017;2017;11;23;Lauantai;0;0;0;0;0;0
109;19.11.2017;2017;11;00;Sunnuntai;1;0;1;1;0;1
109;19.11.2017;2017;11;01;Sunnuntai;0;0;0;0;1;1
109;19.11.2017;2017;11;02;Sunnuntai;0;1;1;0;0;0
109;19.11.2017;2017;11;03;Sunnuntai;0;0;0;0;0;0
109;19.11.2017;2017;11;04;Sunnuntai;0;1;1;0;0;0
109;19.11.2017;2017;11;05;Sunnuntai;0;0;0;0;0;0
109;19.11.2017;2017;11;06;Sunnuntai;0;0;0;0;0;0
109;19.11.2017;2017;11;07;Sunnuntai;1;3;4;2;2;4
109;19.11.2017;2017;11;08;Sunnuntai;2;0;2;3;0;3
109;19.11.2017;2017;11;09;Sunnuntai;1;0;1;6;1;7
109;19.11.2017;2017;11;10;Sunnuntai;0;1;1;5;4;9
109;19.11.2017;2017;11;11;Sunnuntai;2;3;5;5;3;8
109;19.11.2017;2017;11;12;Sunnuntai;5;4;9;4;1;5
109;19.11.2017;2017;11;13;Sunnuntai;4;2;6;1;0;1
109;19.11.2017;2017;11;14;Sunnuntai;3;3;6;2;0;2
109;19.11.2017;2017;11;15;Sunnuntai;9;5;14;2;0;2
109;19.11.2017;2017;11;16;Sunnuntai;3;6;9;2;0;2
109;19.11.2017;2017;11;17;Sunnuntai;5;3;8;0;0;0
109;19.11.2017;2017;11;18;Sunnuntai;3;2;5;0;0;0
109;19.11.2017;2017;11;19;Sunnuntai;2;1;3;0;0;0
109;19.11.2017;2017;11;20;Sunnuntai;1;0;1;0;0;0
109;19.11.2017;2017;11;21;Sunnuntai;3;0;3;0;0;0
109;19.11.2017;2017;11;22;Sunnuntai;0;0;0;0;0;0
109;19.11.2017;2017;11;23;Sunnuntai;1;0;1;0;0;0
109;20.11.2017;2017;11;00;Maanantai;0;0;0;1;0;1
109;20.11.2017;2017;11;01;Maanantai;0;0;0;0;1;1
109;20.11.2017;2017;11;02;Maanantai;0;0;0;0;0;0
109;20.11.2017;2017;11;03;Maanantai;0;0;0;0;0;0
109;20.11.2017;2017;11;04;Maanantai;0;0;0;1;0;1
109;20.11.2017;2017;11;05;Maanantai;2;2;4;0;0;0
109;20.11.2017;2017;11;06;Maanantai;14;11;25;3;0;3
109;20.11.2017;2017;11;07;Maanantai;32;30;62;4;3;7
109;20.11.2017;2017;11;08;Maanantai;21;18;39;3;2;5
109;20.11.2017;2017;11;09;Maanantai;6;4;10;4;3;7
109;20.11.2017;2017;11;10;Maanantai;6;6;12;3;3;6
109;20.11.2017;2017;11;11;Maanantai;8;7;15;6;3;9
109;20.11.2017;2017;11;12;Maanantai;3;2;5;2;0;2
109;20.11.2017;2017;11;13;Maanantai;13;9;22;2;1;3
109;20.11.2017;2017;11;14;Maanantai;14;12;26;7;4;11
109;20.11.2017;2017;11;15;Maanantai;16;15;31;3;2;5
109;20.11.2017;2017;11;16;Maanantai;29;27;56;5;4;9
109;20.11.2017;2017;11;17;Maanantai;17;20;37;7;4;11
109;20.11.2017;2017;11;18;Maanantai;6;6;12;5;5;10
109;20.11.2017;2017;11;19;Maanantai;5;3;8;7;4;11
109;20.11.2017;2017;11;20;Maanantai;3;1;4;8;7;15
109;20.11.2017;2017;11;21;Maanantai;6;3;9;3;2;5
109;20.11.2017;2017;11;22;Maanantai;6;2;8;1;1;2
109;20.11.2017;2017;11;23;Maanantai;1;0;1;1;1;2
109;21.11.2017;2017;11;00;Tiistai;0;0;0;0;1;1
109;21.11.2017;2017;11;01;Tiistai;0;0;0;0;2;2
109;21.11.2017;2017;11;02;Tiistai;0;0;0;0;0;0
109;21.11.2017;2017;11;03;Tiistai;0;0;0;0;0;0
109;21.11.2017;2017;11;04;Tiistai;1;0;1;0;0;0
109;21.11.2017;2017;11;05;Tiistai;3;1;4;2;0;2
109;21.11.2017;2017;11;06;Tiistai;17;14;31;4;1;5
109;21.11.2017;2017;11;07;Tiistai;30;28;58;6;5;11
109;21.11.2017;2017;11;08;Tiistai;20;19;39;1;2;3
109;21.11.2017;2017;11;09;Tiistai;7;6;13;6;5;11
109;21.11.2017;2017;11;10;Tiistai;9;7;16;3;1;4
109;21.11.2017;2017;11;11;Tiistai;4;2;6;7;3;10
109;21.11.2017;2017;11;12;Tiistai;10;9;19;5;4;9
109;21.11.2017;2017;11;13;Tiistai;8;7;15;1;2;3
109;21.11.2017;2017;11;14;Tiistai;9;7;16;6;4;10
109;21.11.2017;2017;11;15;Tiistai;21;13;34;4;5;9
109;21.11.2017;2017;11;16;Tiistai;32;21;53;7;5;12
109;21.11.2017;2017;11;17;Tiistai;24;15;39;6;3;9
109;21.11.2017;2017;11;18;Tiistai;9;5;14;13;6;19
109;21.11.2017;2017;11;19;Tiistai;3;0;3;3;4;7
109;21.11.2017;2017;11;20;Tiistai;7;4;11;5;7;12
109;21.11.2017;2017;11;21;Tiistai;6;4;10;4;3;7
109;21.11.2017;2017;11;22;Tiistai;2;1;3;1;1;2
109;21.11.2017;2017;11;23;Tiistai;0;0;0;1;1;2
109;22.11.2017;2017;11;00;Keskiviikko;0;0;0;0;0;0
109;22.11.2017;2017;11;01;Keskiviikko;0;0;0;0;0;0
109;22.11.2017;2017;11;02;Keskiviikko;1;1;2;0;0;0
109;22.11.2017;2017;11;03;Keskiviikko;0;0;0;0;0;0
109;22.11.2017;2017;11;04;Keskiviikko;0;0;0;1;0;1
109;22.11.2017;2017;11;05;Keskiviikko;1;0;1;0;0;0
109;22.11.2017;2017;11;06;Keskiviikko;23;11;34;3;0;3
109;22.11.2017;2017;11;07;Keskiviikko;41;16;57;6;0;6
109;22.11.2017;2017;11;08;Keskiviikko;27;9;36;4;1;5
109;22.11.2017;2017;11;09;Keskiviikko;16;4;20;4;6;10
109;22.11.2017;2017;11;10;Keskiviikko;6;2;8;5;4;9
109;22.11.2017;2017;11;11;Keskiviikko;6;6;12;4;2;6
109;22.11.2017;2017;11;12;Keskiviikko;6;5;11;2;1;3
109;22.11.2017;2017;11;13;Keskiviikko;6;6;12;2;2;4
109;22.11.2017;2017;11;14;Keskiviikko;11;18;29;6;2;8
109;22.11.2017;2017;11;15;Keskiviikko;16;30;46;3;2;5
109;22.11.2017;2017;11;16;Keskiviikko;14;37;51;3;4;7
109;22.11.2017;2017;11;17;Keskiviikko;9;15;24;9;1;10
109;22.11.2017;2017;11;18;Keskiviikko;7;9;16;5;2;7
109;22.11.2017;2017;11;19;Keskiviikko;6;3;9;2;5;7
109;22.11.2017;2017;11;20;Keskiviikko;2;5;7;11;0;11
109;22.11.2017;2017;11;21;Keskiviikko;3;4;7;2;1;3
109;22.11.2017;2017;11;22;Keskiviikko;1;1;2;1;0;1
109;22.11.2017;2017;11;23;Keskiviikko;0;0;0;1;2;3
109;23.11.2017;2017;11;00;Torstai;0;0;0;1;0;1
109;23.11.2017;2017;11;01;Torstai;0;0;0;0;0;0
109;23.11.2017;2017;11;02;Torstai;1;0;1;0;0;0
109;23.11.2017;2017;11;03;Torstai;0;0;0;1;0;1
109;23.11.2017;2017;11;04;Torstai;0;0;0;0;0;0
109;23.11.2017;2017;11;05;Torstai;4;0;4;1;0;1
109;23.11.2017;2017;11;06;Torstai;30;0;30;3;0;3
109;23.11.2017;2017;11;07;Torstai;51;0;51;8;0;8
109;23.11.2017;2017;11;08;Torstai;44;0;44;6;0;6
109;23.11.2017;2017;11;09;Torstai;12;0;12;9;0;9
109;23.11.2017;2017;11;10;Torstai;8;0;8;5;0;5
109;23.11.2017;2017;11;11;Torstai;15;0;15;6;0;6
109;23.11.2017;2017;11;12;Torstai;19;0;19;6;0;6
109;23.11.2017;2017;11;13;Torstai;14;0;14;6;0;6
109;23.11.2017;2017;11;14;Torstai;20;0;20;7;0;7
109;23.11.2017;2017;11;15;Torstai;36;0;36;14;0;14
109;23.11.2017;2017;11;16;Torstai;47;0;47;4;0;4
109;23.11.2017;2017;11;17;Torstai;25;0;25;4;0;4
109;23.11.2017;2017;11;18;Torstai;19;0;19;4;0;4
109;23.11.2017;2017;11;19;Torstai;10;0;10;4;0;4
109;23.11.2017;2017;11;20;Torstai;8;0;8;4;0;4
109;23.11.2017;2017;11;21;Torstai;3;0;3;8;0;8
109;23.11.2017;2017;11;22;Torstai;4;0;4;3;0;3
109;23.11.2017;2017;11;23;Torstai;1;0;1;1;0;1
109;24.11.2017;2017;11;00;Perjantai;0;0;0;0;0;0
109;24.11.2017;2017;11;01;Perjantai;0;0;0;0;0;0
109;24.11.2017;2017;11;02;Perjantai;0;0;0;1;0;1
109;24.11.2017;2017;11;03;Perjantai;0;0;0;0;0;0
109;24.11.2017;2017;11;04;Perjantai;0;0;0;0;0;0
109;24.11.2017;2017;11;05;Perjantai;3;1;4;2;2;4
109;24.11.2017;2017;11;06;Perjantai;9;8;17;2;0;2
109;24.11.2017;2017;11;07;Perjantai;16;14;30;1;4;5
109;24.11.2017;2017;11;08;Perjantai;13;9;22;4;3;7
109;24.11.2017;2017;11;09;Perjantai;5;2;7;2;1;3
109;24.11.2017;2017;11;10;Perjantai;5;2;7;7;3;10
109;24.11.2017;2017;11;11;Perjantai;7;5;12;1;2;3
109;24.11.2017;2017;11;12;Perjantai;5;4;9;2;2;4
109;24.11.2017;2017;11;13;Perjantai;8;3;11;3;4;7
109;24.11.2017;2017;11;14;Perjantai;6;10;16;2;0;2
109;24.11.2017;2017;11;15;Perjantai;11;9;20;3;4;7
109;24.11.2017;2017;11;16;Perjantai;8;16;24;3;1;4
109;24.11.2017;2017;11;17;Perjantai;3;5;8;2;2;4
109;24.11.2017;2017;11;18;Perjantai;4;6;10;4;2;6
109;24.11.2017;2017;11;19;Perjantai;1;1;2;2;1;3
109;24.11.2017;2017;11;20;Perjantai;1;1;2;2;1;3
109;24.11.2017;2017;11;21;Perjantai;1;6;7;1;1;2
109;24.11.2017;2017;11;22;Perjantai;3;4;7;4;1;5
109;24.11.2017;2017;11;23;Perjantai;0;2;2;1;3;4
109;25.11.2017;2017;11;00;Lauantai;0;0;0;1;0;1
109;25.11.2017;2017;11;01;Lauantai;1;0;1;0;0;0
109;25.11.2017;2017;11;02;Lauantai;1;1;2;0;0;0
109;25.11.2017;2017;11;03;Lauantai;0;0;0;0;0;0
109;25.11.2017;2017;11;04;Lauantai;0;1;1;0;0;0
109;25.11.2017;2017;11;05;Lauantai;1;0;1;0;1;1
109;25.11.2017;2017;11;06;Lauantai;1;0;1;1;0;1
109;25.11.2017;2017;11;07;Lauantai;0;2;2;1;3;4
109;25.11.2017;2017;11;08;Lauantai;2;1;3;1;1;2
109;25.11.2017;2017;11;09;Lauantai;3;3;6;4;1;5
109;25.11.2017;2017;11;10;Lauantai;4;3;7;3;6;9
109;25.11.2017;2017;11;11;Lauantai;3;2;5;4;3;7
109;25.11.2017;2017;11;12;Lauantai;3;0;3;2;3;5
109;25.11.2017;2017;11;13;Lauantai;3;1;4;5;6;11
109;25.11.2017;2017;11;14;Lauantai;1;3;4;3;4;7
109;25.11.2017;2017;11;15;Lauantai;2;3;5;7;2;9
109;25.11.2017;2017;11;16;Lauantai;3;3;6;7;3;10
109;25.11.2017;2017;11;17;Lauantai;3;5;8;5;1;6
109;25.11.2017;2017;11;18;Lauantai;1;0;1;6;3;9
109;25.11.2017;2017;11;19;Lauantai;1;0;1;2;2;4
109;25.11.2017;2017;11;20;Lauantai;1;1;2;2;1;3
109;25.11.2017;2017;11;21;Lauantai;2;5;7;1;3;4
109;25.11.2017;2017;11;22;Lauantai;2;0;2;3;0;3
109;25.11.2017;2017;11;23;Lauantai;1;1;2;0;0;0
109;26.11.2017;2017;11;00;Sunnuntai;1;1;2;2;1;3
109;26.11.2017;2017;11;01;Sunnuntai;0;0;0;0;0;0
109;26.11.2017;2017;11;02;Sunnuntai;2;1;3;1;0;1
109;26.11.2017;2017;11;03;Sunnuntai;0;1;1;0;1;1
109;26.11.2017;2017;11;04;Sunnuntai;0;0;0;0;0;0
109;26.11.2017;2017;11;05;Sunnuntai;0;0;0;0;0;0
109;26.11.2017;2017;11;06;Sunnuntai;2;1;3;1;0;1
109;26.11.2017;2017;11;07;Sunnuntai;1;2;3;0;2;2
109;26.11.2017;2017;11;08;Sunnuntai;1;0;1;1;1;2
109;26.11.2017;2017;11;09;Sunnuntai;2;1;3;7;0;7
109;26.11.2017;2017;11;10;Sunnuntai;4;4;8;4;4;8
109;26.11.2017;2017;11;11;Sunnuntai;2;1;3;8;5;13
109;26.11.2017;2017;11;12;Sunnuntai;1;2;3;6;7;13
109;26.11.2017;2017;11;13;Sunnuntai;6;0;6;5;2;7
109;26.11.2017;2017;11;14;Sunnuntai;6;2;8;5;2;7
109;26.11.2017;2017;11;15;Sunnuntai;4;4;8;4;1;5
109;26.11.2017;2017;11;16;Sunnuntai;1;4;5;5;3;8
109;26.11.2017;2017;11;17;Sunnuntai;3;1;4;3;1;4
109;26.11.2017;2017;11;18;Sunnuntai;1;1;2;3;6;9
109;26.11.2017;2017;11;19;Sunnuntai;0;3;3;6;2;8
109;26.11.2017;2017;11;20;Sunnuntai;3;2;5;4;2;6
109;26.11.2017;2017;11;21;Sunnuntai;1;6;7;1;2;3
109;26.11.2017;2017;11;22;Sunnuntai;0;0;0;0;0;0
109;26.11.2017;2017;11;23;Sunnuntai;1;0;1;1;0;1
109;27.11.2017;2017;11;00;Maanantai;1;0;1;1;4;5
109;27.11.2017;2017;11;01;Maanantai;0;0;0;1;1;2
109;27.11.2017;2017;11;02;Maanantai;1;0;1;0;0;0
109;27.11.2017;2017;11;03;Maanantai;0;0;0;0;0;0
109;27.11.2017;2017;11;04;Maanantai;0;0;0;1;0;1
109;27.11.2017;2017;11;05;Maanantai;2;1;3;1;0;1
109;27.11.2017;2017;11;06;Maanantai;18;14;32;3;1;4
109;27.11.2017;2017;11;07;Maanantai;34;25;59;7;6;13
109;27.11.2017;2017;11;08;Maanantai;18;10;28;3;2;5
109;27.11.2017;2017;11;09;Maanantai;16;3;19;3;3;6
109;27.11.2017;2017;11;10;Maanantai;6;2;8;3;3;6
109;27.11.2017;2017;11;11;Maanantai;8;5;13;4;3;7
109;27.11.2017;2017;11;12;Maanantai;8;6;14;3;2;5
109;27.11.2017;2017;11;13;Maanantai;12;8;20;3;2;5
109;27.11.2017;2017;11;14;Maanantai;6;10;16;6;5;11
109;27.11.2017;2017;11;15;Maanantai;18;26;44;8;5;13
109;27.11.2017;2017;11;16;Maanantai;23;26;49;7;6;13
109;27.11.2017;2017;11;17;Maanantai;5;14;19;7;6;13
109;27.11.2017;2017;11;18;Maanantai;4;4;8;4;3;7
109;27.11.2017;2017;11;19;Maanantai;6;4;10;5;5;10
109;27.11.2017;2017;11;20;Maanantai;3;6;9;3;7;10
109;27.11.2017;2017;11;21;Maanantai;1;8;9;1;1;2
109;27.11.2017;2017;11;22;Maanantai;1;5;6;4;1;5
109;27.11.2017;2017;11;23;Maanantai;0;0;0;0;0;0
109;28.11.2017;2017;11;00;Tiistai;0;0;0;0;2;2
109;28.11.2017;2017;11;01;Tiistai;0;0;0;0;0;0
109;28.11.2017;2017;11;02;Tiistai;1;0;1;0;0;0
109;28.11.2017;2017;11;03;Tiistai;0;0;0;0;0;0
109;28.11.2017;2017;11;04;Tiistai;0;0;0;1;0;1
109;28.11.2017;2017;11;05;Tiistai;0;2;2;3;2;5
109;28.11.2017;2017;11;06;Tiistai;13;7;20;2;1;3
109;28.11.2017;2017;11;07;Tiistai;26;21;47;6;3;9
109;28.11.2017;2017;11;08;Tiistai;30;10;40;5;2;7
109;28.11.2017;2017;11;09;Tiistai;9;5;14;3;2;5
109;28.11.2017;2017;11;10;Tiistai;7;6;13;1;2;3
109;28.11.2017;2017;11;11;Tiistai;8;6;14;1;2;3
109;28.11.2017;2017;11;12;Tiistai;5;6;11;3;1;4
109;28.11.2017;2017;11;13;Tiistai;3;4;7;3;2;5
109;28.11.2017;2017;11;14;Tiistai;7;4;11;3;3;6
109;28.11.2017;2017;11;15;Tiistai;11;20;31;9;6;15
109;28.11.2017;2017;11;16;Tiistai;18;24;42;7;3;10
109;28.11.2017;2017;11;17;Tiistai;10;11;21;3;4;7
109;28.11.2017;2017;11;18;Tiistai;3;11;14;6;2;8
109;28.11.2017;2017;11;19;Tiistai;5;3;8;3;5;8
109;28.11.2017;2017;11;20;Tiistai;2;5;7;7;2;9
109;28.11.2017;2017;11;21;Tiistai;1;8;9;2;0;2
109;28.11.2017;2017;11;22;Tiistai;1;1;2;0;0;0
109;28.11.2017;2017;11;23;Tiistai;0;1;1;0;1;1
109;29.11.2017;2017;11;00;Keskiviikko;1;0;1;0;2;2
109;29.11.2017;2017;11;01;Keskiviikko;0;0;0;0;1;1
109;29.11.2017;2017;11;02;Keskiviikko;0;0;0;0;0;0
109;29.11.2017;2017;11;03;Keskiviikko;0;0;0;0;0;0
109;29.11.2017;2017;11;04;Keskiviikko;0;0;0;1;0;1
109;29.11.2017;2017;11;05;Keskiviikko;2;0;2;0;0;0
109;29.11.2017;2017;11;06;Keskiviikko;11;8;19;3;0;3
109;29.11.2017;2017;11;07;Keskiviikko;26;22;48;6;0;6
109;29.11.2017;2017;11;08;Keskiviikko;18;14;32;5;0;5
109;29.11.2017;2017;11;09;Keskiviikko;8;7;15;10;0;10
109;29.11.2017;2017;11;10;Keskiviikko;5;3;8;9;0;9
109;29.11.2017;2017;11;11;Keskiviikko;4;2;6;6;0;6
109;29.11.2017;2017;11;12;Keskiviikko;6;4;10;3;0;3
109;29.11.2017;2017;11;13;Keskiviikko;6;3;9;4;0;4
109;29.11.2017;2017;11;14;Keskiviikko;9;8;17;8;0;8
109;29.11.2017;2017;11;15;Keskiviikko;14;11;25;5;0;5
109;29.11.2017;2017;11;16;Keskiviikko;23;23;46;7;0;7
109;29.11.2017;2017;11;17;Keskiviikko;14;11;25;10;0;10
109;29.11.2017;2017;11;18;Keskiviikko;9;7;16;7;0;7
109;29.11.2017;2017;11;19;Keskiviikko;6;3;9;7;0;7
109;29.11.2017;2017;11;20;Keskiviikko;3;2;5;11;0;11
109;29.11.2017;2017;11;21;Keskiviikko;7;5;12;3;0;3
109;29.11.2017;2017;11;22;Keskiviikko;2;0;2;1;0;1
109;29.11.2017;2017;11;23;Keskiviikko;0;0;0;3;0;3
109;30.11.2017;2017;11;00;Torstai;0;0;0;0;1;1
109;30.11.2017;2017;11;01;Torstai;0;0;0;0;0;0
109;30.11.2017;2017;11;02;Torstai;0;0;0;0;0;0
109;30.11.2017;2017;11;03;Torstai;0;0;0;0;0;0
109;30.11.2017;2017;11;04;Torstai;0;0;0;1;0;1
109;30.11.2017;2017;11;05;Torstai;3;1;4;1;1;2
109;30.11.2017;2017;11;06;Torstai;13;10;23;2;1;3
109;30.11.2017;2017;11;07;Torstai;27;26;53;1;1;2
109;30.11.2017;2017;11;08;Torstai;21;20;41;5;1;6
109;30.11.2017;2017;11;09;Torstai;11;6;17;1;0;1
109;30.11.2017;2017;11;10;Torstai;5;0;5;4;1;5
109;30.11.2017;2017;11;11;Torstai;7;3;10;3;2;5
109;30.11.2017;2017;11;12;Torstai;6;3;9;7;1;8
109;30.11.2017;2017;11;13;Torstai;5;7;12;3;2;5
109;30.11.2017;2017;11;14;Torstai;9;18;27;7;1;8
109;30.11.2017;2017;11;15;Torstai;14;22;36;4;3;7
109;30.11.2017;2017;11;16;Torstai;24;33;57;5;4;9
109;30.11.2017;2017;11;17;Torstai;5;11;16;7;2;9
109;30.11.2017;2017;11;18;Torstai;12;18;30;6;3;9
109;30.11.2017;2017;11;19;Torstai;1;1;2;2;6;8
109;30.11.2017;2017;11;20;Torstai;2;4;6;5;4;9
109;30.11.2017;2017;11;21;Torstai;4;4;8;4;2;6
109;30.11.2017;2017;11;22;Torstai;3;3;6;3;0;3
109;30.11.2017;2017;11;23;Torstai;0;0;0;0;0;0
109;01.12.2017;2017;12;00;Perjantai;1;0;1;0;1;1
109;01.12.2017;2017;12;01;Perjantai;0;0;0;0;0;0
109;01.12.2017;2017;12;02;Perjantai;1;0;1;0;0;0
109;01.12.2017;2017;12;03;Perjantai;0;0;0;0;0;0
109;01.12.2017;2017;12;04;Perjantai;0;0;0;1;0;1
109;01.12.2017;2017;12;05;Perjantai;2;2;4;1;1;2
109;01.12.2017;2017;12;06;Perjantai;13;12;25;2;1;3
109;01.12.2017;2017;12;07;Perjantai;24;17;41;1;1;2
109;01.12.2017;2017;12;08;Perjantai;17;10;27;5;1;6
109;01.12.2017;2017;12;09;Perjantai;11;7;18;1;0;1
109;01.12.2017;2017;12;10;Perjantai;9;0;9;2;0;2
109;01.12.2017;2017;12;11;Perjantai;11;2;13;2;0;2
109;01.12.2017;2017;12;12;Perjantai;5;6;11;1;1;2
109;01.12.2017;2017;12;13;Perjantai;10;4;14;1;0;1
109;01.12.2017;2017;12;14;Perjantai;15;9;24;7;0;7
109;01.12.2017;2017;12;15;Perjantai;17;10;27;2;0;2
109;01.12.2017;2017;12;16;Perjantai;19;14;33;1;0;1
109;01.12.2017;2017;12;17;Perjantai;12;7;19;2;1;3
109;01.12.2017;2017;12;18;Perjantai;2;2;4;3;1;4
109;01.12.2017;2017;12;19;Perjantai;3;2;5;4;2;6
109;01.12.2017;2017;12;20;Perjantai;3;1;4;1;1;2
109;01.12.2017;2017;12;21;Perjantai;1;1;2;0;1;1
109;01.12.2017;2017;12;22;Perjantai;3;0;3;2;0;2
109;01.12.2017;2017;12;23;Perjantai;2;0;2;2;0;2
109;02.12.2017;2017;12;00;Lauantai;0;0;0;0;0;0
109;02.12.2017;2017;12;01;Lauantai;0;1;1;1;0;1
109;02.12.2017;2017;12;02;Lauantai;2;0;2;0;0;0
109;02.12.2017;2017;12;03;Lauantai;1;0;1;0;0;0
109;02.12.2017;2017;12;04;Lauantai;0;0;0;0;0;0
109;02.12.2017;2017;12;05;Lauantai;0;1;1;1;1;2
109;02.12.2017;2017;12;06;Lauantai;3;0;3;0;0;0
109;02.12.2017;2017;12;07;Lauantai;6;1;7;0;0;0
109;02.12.2017;2017;12;08;Lauantai;4;1;5;1;2;3
109;02.12.2017;2017;12;09;Lauantai;3;1;4;2;1;3
109;02.12.2017;2017;12;10;Lauantai;7;0;7;2;2;4
109;02.12.2017;2017;12;11;Lauantai;4;7;11;2;2;4
109;02.12.2017;2017;12;12;Lauantai;9;3;12;6;2;8
109;02.12.2017;2017;12;13;Lauantai;1;3;4;4;2;6
109;02.12.2017;2017;12;14;Lauantai;3;1;4;5;1;6
109;02.12.2017;2017;12;15;Lauantai;2;2;4;1;0;1
109;02.12.2017;2017;12;16;Lauantai;2;3;5;1;0;1
109;02.12.2017;2017;12;17;Lauantai;2;3;5;0;0;0
109;02.12.2017;2017;12;18;Lauantai;4;0;4;5;0;5
109;02.12.2017;2017;12;19;Lauantai;5;2;7;0;0;0
109;02.12.2017;2017;12;20;Lauantai;1;4;5;1;0;1
109;02.12.2017;2017;12;21;Lauantai;6;2;8;2;0;2
109;02.12.2017;2017;12;22;Lauantai;3;0;3;0;0;0
109;02.12.2017;2017;12;23;Lauantai;2;1;3;0;0;0
109;03.12.2017;2017;12;00;Sunnuntai;1;1;2;0;0;0
109;03.12.2017;2017;12;01;Sunnuntai;1;0;1;0;0;0
109;03.12.2017;2017;12;02;Sunnuntai;0;0;0;0;1;1
109;03.12.2017;2017;12;03;Sunnuntai;0;0;0;0;0;0
109;03.12.2017;2017;12;04;Sunnuntai;0;0;0;0;0;0
109;03.12.2017;2017;12;05;Sunnuntai;0;1;1;0;0;0
109;03.12.2017;2017;12;06;Sunnuntai;3;0;3;1;1;2
109;03.12.2017;2017;12;07;Sunnuntai;1;2;3;1;0;1
109;03.12.2017;2017;12;08;Sunnuntai;1;0;1;2;0;2
109;03.12.2017;2017;12;09;Sunnuntai;3;3;6;4;2;6
109;03.12.2017;2017;12;10;Sunnuntai;2;1;3;2;3;5
109;03.12.2017;2017;12;11;Sunnuntai;2;2;4;8;7;15
109;03.12.2017;2017;12;12;Sunnuntai;2;2;4;1;3;4
109;03.12.2017;2017;12;13;Sunnuntai;2;3;5;5;4;9
109;03.12.2017;2017;12;14;Sunnuntai;7;5;12;5;3;8
109;03.12.2017;2017;12;15;Sunnuntai;4;1;5;5;5;10
109;03.12.2017;2017;12;16;Sunnuntai;1;4;5;4;3;7
109;03.12.2017;2017;12;17;Sunnuntai;6;5;11;7;5;12
109;03.12.2017;2017;12;18;Sunnuntai;1;2;3;2;6;8
109;03.12.2017;2017;12;19;Sunnuntai;2;2;4;5;4;9
109;03.12.2017;2017;12;20;Sunnuntai;1;3;4;6;2;8
109;03.12.2017;2017;12;21;Sunnuntai;3;2;5;1;0;1
109;03.12.2017;2017;12;22;Sunnuntai;0;0;0;0;1;1
109;03.12.2017;2017;12;23;Sunnuntai;0;1;1;0;2;2
109;04.12.2017;2017;12;00;Maanantai;0;0;0;1;1;2
109;04.12.2017;2017;12;01;Maanantai;0;0;0;2;0;2
109;04.12.2017;2017;12;02;Maanantai;0;0;0;0;0;0
109;04.12.2017;2017;12;03;Maanantai;0;0;0;0;0;0
109;04.12.2017;2017;12;04;Maanantai;0;0;0;1;0;1
109;04.12.2017;2017;12;05;Maanantai;2;2;4;0;0;0
109;04.12.2017;2017;12;06;Maanantai;14;15;29;2;1;3
109;04.12.2017;2017;12;07;Maanantai;27;18;45;7;5;12
109;04.12.2017;2017;12;08;Maanantai;19;11;30;5;2;7
109;04.12.2017;2017;12;09;Maanantai;12;6;18;4;0;4
109;04.12.2017;2017;12;10;Maanantai;13;2;15;2;1;3
109;04.12.2017;2017;12;11;Maanantai;4;3;7;4;2;6
109;04.12.2017;2017;12;12;Maanantai;11;4;15;5;1;6
109;04.12.2017;2017;12;13;Maanantai;5;8;13;3;1;4
109;04.12.2017;2017;12;14;Maanantai;5;11;16;3;3;6
109;04.12.2017;2017;12;15;Maanantai;14;19;33;4;1;5
109;04.12.2017;2017;12;16;Maanantai;20;24;44;4;4;8
109;04.12.2017;2017;12;17;Maanantai;16;18;34;2;2;4
109;04.12.2017;2017;12;18;Maanantai;6;12;18;2;1;3
109;04.12.2017;2017;12;19;Maanantai;6;2;8;4;5;9
109;04.12.2017;2017;12;20;Maanantai;2;3;5;5;1;6
109;04.12.2017;2017;12;21;Maanantai;1;7;8;2;0;2
109;04.12.2017;2017;12;22;Maanantai;0;3;3;0;1;1
109;04.12.2017;2017;12;23;Maanantai;1;0;1;1;2;3
109;05.12.2017;2017;12;00;Tiistai;1;0;1;2;0;2
109;05.12.2017;2017;12;01;Tiistai;0;0;0;0;0;0
109;05.12.2017;2017;12;02;Tiistai;0;0;0;0;1;1
109;05.12.2017;2017;12;03;Tiistai;0;0;0;0;1;1
109;05.12.2017;2017;12;04;Tiistai;0;1;1;1;0;1
109;05.12.2017;2017;12;05;Tiistai;2;1;3;3;3;6
109;05.12.2017;2017;12;06;Tiistai;16;9;25;0;2;2
109;05.12.2017;2017;12;07;Tiistai;19;16;35;2;1;3
109;05.12.2017;2017;12;08;Tiistai;22;5;27;3;1;4
109;05.12.2017;2017;12;09;Tiistai;8;5;13;5;1;6
109;05.12.2017;2017;12;10;Tiistai;8;5;13;2;6;8
109;05.12.2017;2017;12;11;Tiistai;5;5;10;8;7;15
109;05.12.2017;2017;12;12;Tiistai;9;12;21;9;5;14
109;05.12.2017;2017;12;13;Tiistai;4;5;9;3;4;7
109;05.12.2017;2017;12;14;Tiistai;16;12;28;10;6;16
109;05.12.2017;2017;12;15;Tiistai;18;22;40;8;6;14
109;05.12.2017;2017;12;16;Tiistai;10;22;32;6;6;12
109;05.12.2017;2017;12;17;Tiistai;9;16;25;1;6;7
109;05.12.2017;2017;12;18;Tiistai;4;4;8;5;1;6
109;05.12.2017;2017;12;19;Tiistai;3;4;7;5;3;8
109;05.12.2017;2017;12;20;Tiistai;2;4;6;3;0;3
109;05.12.2017;2017;12;21;Tiistai;2;5;7;0;1;1
109;05.12.2017;2017;12;22;Tiistai;4;1;5;3;4;7
109;05.12.2017;2017;12;23;Tiistai;2;0;2;2;0;2
109;06.12.2017;2017;12;00;Keskiviikko;0;0;0;1;0;1
109;06.12.2017;2017;12;01;Keskiviikko;1;0;1;0;0;0
109;06.12.2017;2017;12;02;Keskiviikko;1;0;1;1;0;1
109;06.12.2017;2017;12;03;Keskiviikko;0;1;1;0;0;0
109;06.12.2017;2017;12;04;Keskiviikko;0;0;0;2;1;3
109;06.12.2017;2017;12;05;Keskiviikko;0;0;0;0;1;1
109;06.12.2017;2017;12;06;Keskiviikko;2;0;2;3;0;3
109;06.12.2017;2017;12;07;Keskiviikko;0;4;4;1;2;3
109;06.12.2017;2017;12;08;Keskiviikko;0;1;1;1;2;3
109;06.12.2017;2017;12;09;Keskiviikko;3;1;4;5;0;5
109;06.12.2017;2017;12;10;Keskiviikko;4;1;5;6;1;7
109;06.12.2017;2017;12;11;Keskiviikko;4;1;5;5;1;6
109;06.12.2017;2017;12;12;Keskiviikko;3;2;5;2;7;9
109;06.12.2017;2017;12;13;Keskiviikko;4;4;8;4;2;6
109;06.12.2017;2017;12;14;Keskiviikko;7;7;14;6;2;8
109;06.12.2017;2017;12;15;Keskiviikko;3;1;4;0;4;4
109;06.12.2017;2017;12;16;Keskiviikko;2;9;11;3;1;4
109;06.12.2017;2017;12;17;Keskiviikko;6;1;7;4;3;7
109;06.12.2017;2017;12;18;Keskiviikko;1;1;2;6;1;7
109;06.12.2017;2017;12;19;Keskiviikko;0;3;3;2;4;6
109;06.12.2017;2017;12;20;Keskiviikko;1;3;4;1;1;2
109;06.12.2017;2017;12;21;Keskiviikko;1;6;7;0;0;0
109;06.12.2017;2017;12;22;Keskiviikko;1;2;3;0;0;0
109;06.12.2017;2017;12;23;Keskiviikko;0;1;1;0;0;0
109;07.12.2017;2017;12;00;Torstai;2;2;4;1;0;1
109;07.12.2017;2017;12;01;Torstai;0;0;0;0;0;0
109;07.12.2017;2017;12;02;Torstai;1;0;1;0;0;0
109;07.12.2017;2017;12;03;Torstai;0;0;0;0;0;0
109;07.12.2017;2017;12;04;Torstai;0;0;0;1;0;1
109;07.12.2017;2017;12;05;Torstai;1;0;1;2;2;4
109;07.12.2017;2017;12;06;Torstai;12;6;18;1;1;2
109;07.12.2017;2017;12;07;Torstai;36;14;50;6;0;6
109;07.12.2017;2017;12;08;Torstai;23;11;34;1;1;2
109;07.12.2017;2017;12;09;Torstai;12;1;13;4;1;5
109;07.12.2017;2017;12;10;Torstai;9;2;11;2;1;3
109;07.12.2017;2017;12;11;Torstai;18;3;21;2;0;2
109;07.12.2017;2017;12;12;Torstai;8;0;8;3;1;4
109;07.12.2017;2017;12;13;Torstai;11;4;15;0;0;0
109;07.12.2017;2017;12;14;Torstai;6;11;17;4;0;4
109;07.12.2017;2017;12;15;Torstai;13;18;31;4;0;4
109;07.12.2017;2017;12;16;Torstai;15;26;41;2;4;6
109;07.12.2017;2017;12;17;Torstai;10;11;21;5;1;6
109;07.12.2017;2017;12;18;Torstai;6;7;13;4;1;5
109;07.12.2017;2017;12;19;Torstai;4;4;8;3;2;5
109;07.12.2017;2017;12;20;Torstai;4;2;6;0;0;0
109;07.12.2017;2017;12;21;Torstai;0;3;3;5;1;6
109;07.12.2017;2017;12;22;Torstai;2;3;5;0;0;0
109;07.12.2017;2017;12;23;Torstai;3;0;3;0;0;0
109;08.12.2017;2017;12;00;Perjantai;0;0;0;1;0;1
109;08.12.2017;2017;12;01;Perjantai;0;0;0;0;0;0
109;08.12.2017;2017;12;02;Perjantai;1;0;1;0;0;0
109;08.12.2017;2017;12;03;Perjantai;0;0;0;0;0;0
109;08.12.2017;2017;12;04;Perjantai;0;0;0;1;0;1
109;08.12.2017;2017;12;05;Perjantai;2;1;3;2;0;2
109;08.12.2017;2017;12;06;Perjantai;10;7;17;3;0;3
109;08.12.2017;2017;12;07;Perjantai;15;13;28;2;0;2
109;08.12.2017;2017;12;08;Perjantai;10;9;19;6;0;6
109;08.12.2017;2017;12;09;Perjantai;6;3;9;1;0;1
109;08.12.2017;2017;12;10;Perjantai;4;1;5;2;0;2
109;08.12.2017;2017;12;11;Perjantai;7;4;11;2;0;2
109;08.12.2017;2017;12;12;Perjantai;5;5;10;2;0;2
109;08.12.2017;2017;12;13;Perjantai;5;3;8;1;0;1
109;08.12.2017;2017;12;14;Perjantai;8;5;13;7;0;7
109;08.12.2017;2017;12;15;Perjantai;13;12;25;2;0;2
109;08.12.2017;2017;12;16;Perjantai;17;15;32;1;0;1
109;08.12.2017;2017;12;17;Perjantai;5;5;10;3;0;3
109;08.12.2017;2017;12;18;Perjantai;3;0;3;4;0;4
109;08.12.2017;2017;12;19;Perjantai;1;0;1;6;0;6
109;08.12.2017;2017;12;20;Perjantai;3;1;4;2;0;2
109;08.12.2017;2017;12;21;Perjantai;3;1;4;1;0;1
109;08.12.2017;2017;12;22;Perjantai;1;0;1;2;0;2
109;08.12.2017;2017;12;23;Perjantai;2;0;2;2;0;2
109;09.12.2017;2017;12;00;Lauantai;0;0;0;0;1;1
109;09.12.2017;2017;12;01;Lauantai;0;0;0;0;0;0
109;09.12.2017;2017;12;02;Lauantai;2;1;3;0;0;0
109;09.12.2017;2017;12;03;Lauantai;0;0;0;0;0;0
109;09.12.2017;2017;12;04;Lauantai;0;0;0;1;0;1
109;09.12.2017;2017;12;05;Lauantai;0;0;0;1;1;2
109;09.12.2017;2017;12;06;Lauantai;4;1;5;2;1;3
109;09.12.2017;2017;12;07;Lauantai;0;0;0;1;1;2
109;09.12.2017;2017;12;08;Lauantai;1;1;2;5;1;6
109;09.12.2017;2017;12;09;Lauantai;0;1;1;1;0;1
109;09.12.2017;2017;12;10;Lauantai;3;4;7;5;6;11
109;09.12.2017;2017;12;11;Lauantai;3;0;3;6;1;7
109;09.12.2017;2017;12;12;Lauantai;7;5;12;5;6;11
109;09.12.2017;2017;12;13;Lauantai;6;1;7;7;4;11
109;09.12.2017;2017;12;14;Lauantai;3;1;4;6;2;8
109;09.12.2017;2017;12;15;Lauantai;2;0;2;6;1;7
109;09.12.2017;2017;12;16;Lauantai;1;2;3;3;2;5
109;09.12.2017;2017;12;17;Lauantai;1;2;3;4;1;5
109;09.12.2017;2017;12;18;Lauantai;0;1;1;0;3;3
109;09.12.2017;2017;12;19;Lauantai;2;0;2;5;2;7
109;09.12.2017;2017;12;20;Lauantai;0;0;0;4;1;5
109;09.12.2017;2017;12;21;Lauantai;3;8;11;3;1;4
109;09.12.2017;2017;12;22;Lauantai;2;0;2;1;2;3
109;09.12.2017;2017;12;23;Lauantai;1;0;1;0;0;0
109;10.12.2017;2017;12;00;Sunnuntai;0;0;0;3;0;3
109;10.12.2017;2017;12;01;Sunnuntai;3;0;3;0;0;0
109;10.12.2017;2017;12;02;Sunnuntai;2;1;3;0;2;2
109;10.12.2017;2017;12;03;Sunnuntai;0;0;0;1;0;1
109;10.12.2017;2017;12;04;Sunnuntai;0;0;0;0;0;0
109;10.12.2017;2017;12;05;Sunnuntai;0;0;0;0;0;0
109;10.12.2017;2017;12;06;Sunnuntai;1;1;2;1;0;1
109;10.12.2017;2017;12;07;Sunnuntai;1;0;1;0;1;1
109;10.12.2017;2017;12;08;Sunnuntai;3;2;5;0;2;2
109;10.12.2017;2017;12;09;Sunnuntai;3;0;3;3;0;3
109;10.12.2017;2017;12;10;Sunnuntai;3;1;4;4;2;6
109;10.12.2017;2017;12;11;Sunnuntai;9;1;10;6;1;7
109;10.12.2017;2017;12;12;Sunnuntai;3;1;4;7;4;11
109;10.12.2017;2017;12;13;Sunnuntai;4;1;5;3;3;6
109;10.12.2017;2017;12;14;Sunnuntai;5;0;5;8;8;16
109;10.12.2017;2017;12;15;Sunnuntai;3;1;4;7;3;10
109;10.12.2017;2017;12;16;Sunnuntai;2;7;9;2;4;6
109;10.12.2017;2017;12;17;Sunnuntai;3;3;6;4;2;6
109;10.12.2017;2017;12;18;Sunnuntai;3;1;4;4;3;7
109;10.12.2017;2017;12;19;Sunnuntai;0;1;1;8;3;11
109;10.12.2017;2017;12;20;Sunnuntai;1;4;5;1;2;3
109;10.12.2017;2017;12;21;Sunnuntai;4;3;7;0;0;0
109;10.12.2017;2017;12;22;Sunnuntai;0;0;0;0;0;0
109;10.12.2017;2017;12;23;Sunnuntai;1;0;1;0;0;0
109;11.12.2017;2017;12;00;Maanantai;1;0;1;0;0;0
109;11.12.2017;2017;12;01;Maanantai;0;0;0;0;0;0
109;11.12.2017;2017;12;02;Maanantai;1;0;1;0;0;0
109;11.12.2017;2017;12;03;Maanantai;0;0;0;0;0;0
109;11.12.2017;2017;12;04;Maanantai;0;0;0;0;0;0
109;11.12.2017;2017;12;05;Maanantai;2;0;2;0;0;0
109;11.12.2017;2017;12;06;Maanantai;12;9;21;0;0;0
109;11.12.2017;2017;12;07;Maanantai;23;17;40;0;0;0
109;11.12.2017;2017;12;08;Maanantai;19;11;30;2;0;2
109;11.12.2017;2017;12;09;Maanantai;9;4;13;0;0;0
109;11.12.2017;2017;12;10;Maanantai;11;2;13;0;0;0
109;11.12.2017;2017;12;11;Maanantai;6;2;8;3;1;4
109;11.12.2017;2017;12;12;Maanantai;3;1;4;2;0;2
109;11.12.2017;2017;12;13;Maanantai;9;5;14;1;1;2
109;11.12.2017;2017;12;14;Maanantai;8;11;19;2;1;3
109;11.12.2017;2017;12;15;Maanantai;15;15;30;6;2;8
109;11.12.2017;2017;12;16;Maanantai;24;24;48;4;2;6
109;11.12.2017;2017;12;17;Maanantai;7;13;20;5;0;5
109;11.12.2017;2017;12;18;Maanantai;2;7;9;5;2;7
109;11.12.2017;2017;12;19;Maanantai;2;5;7;5;4;9
109;11.12.2017;2017;12;20;Maanantai;2;5;7;8;2;10
109;11.12.2017;2017;12;21;Maanantai;3;5;8;1;1;2
109;11.12.2017;2017;12;22;Maanantai;3;2;5;1;0;1
109;11.12.2017;2017;12;23;Maanantai;0;1;1;1;0;1
109;12.12.2017;2017;12;00;Tiistai;0;0;0;0;0;0
109;12.12.2017;2017;12;01;Tiistai;0;0;0;0;0;0
109;12.12.2017;2017;12;02;Tiistai;1;0;1;1;2;3
109;12.12.2017;2017;12;03;Tiistai;0;0;0;0;0;0
109;12.12.2017;2017;12;04;Tiistai;0;0;0;1;0;1
109;12.12.2017;2017;12;05;Tiistai;1;4;5;1;1;2
109;12.12.2017;2017;12;06;Tiistai;15;12;27;2;3;5
109;12.12.2017;2017;12;07;Tiistai;32;14;46;5;4;9
109;12.12.2017;2017;12;08;Tiistai;21;10;31;4;2;6
109;12.12.2017;2017;12;09;Tiistai;7;4;11;2;0;2
109;12.12.2017;2017;12;10;Tiistai;5;2;7;2;6;8
109;12.12.2017;2017;12;11;Tiistai;4;3;7;2;3;5
109;12.12.2017;2017;12;12;Tiistai;4;7;11;2;2;4
109;12.12.2017;2017;12;13;Tiistai;6;4;10;1;0;1
109;12.12.2017;2017;12;14;Tiistai;8;6;14;7;0;7
109;12.12.2017;2017;12;15;Tiistai;17;14;31;2;0;2
109;12.12.2017;2017;12;16;Tiistai;22;20;42;1;1;2
109;12.12.2017;2017;12;17;Tiistai;11;9;20;2;1;3
109;12.12.2017;2017;12;18;Tiistai;5;2;7;3;2;5
109;12.12.2017;2017;12;19;Tiistai;5;1;6;4;1;5
109;12.12.2017;2017;12;20;Tiistai;3;0;3;1;1;2
109;12.12.2017;2017;12;21;Tiistai;2;1;3;0;1;1
109;12.12.2017;2017;12;22;Tiistai;2;0;2;2;0;2
109;12.12.2017;2017;12;23;Tiistai;2;0;2;2;0;2
109;13.12.2017;2017;12;00;Keskiviikko;1;0;1;1;0;1
109;13.12.2017;2017;12;01;Keskiviikko;0;0;0;0;0;0
109;13.12.2017;2017;12;02;Keskiviikko;0;0;0;1;0;1
109;13.12.2017;2017;12;03;Keskiviikko;0;0;0;0;0;0
109;13.12.2017;2017;12;04;Keskiviikko;0;0;0;3;0;3
109;13.12.2017;2017;12;05;Keskiviikko;2;1;3;1;0;1
109;13.12.2017;2017;12;06;Keskiviikko;15;14;29;3;0;3
109;13.12.2017;2017;12;07;Keskiviikko;22;21;43;3;0;3
109;13.12.2017;2017;12;08;Keskiviikko;14;10;24;3;0;3
109;13.12.2017;2017;12;09;Keskiviikko;6;2;8;5;0;5
109;13.12.2017;2017;12;10;Keskiviikko;4;0;4;7;0;7
109;13.12.2017;2017;12;11;Keskiviikko;5;4;9;6;0;6
109;13.12.2017;2017;12;12;Keskiviikko;4;2;6;9;0;9
109;13.12.2017;2017;12;13;Keskiviikko;5;1;6;6;0;6
109;13.12.2017;2017;12;14;Keskiviikko;8;6;14;8;0;8
109;13.12.2017;2017;12;15;Keskiviikko;9;9;18;4;0;4
109;13.12.2017;2017;12;16;Keskiviikko;17;15;32;4;0;4
109;13.12.2017;2017;12;17;Keskiviikko;15;13;28;7;0;7
109;13.12.2017;2017;12;18;Keskiviikko;5;3;8;7;0;7
109;13.12.2017;2017;12;19;Keskiviikko;4;3;7;6;0;6
109;13.12.2017;2017;12;20;Keskiviikko;3;1;4;2;0;2
109;13.12.2017;2017;12;21;Keskiviikko;6;4;10;0;0;0
109;13.12.2017;2017;12;22;Keskiviikko;2;1;3;0;0;0
109;13.12.2017;2017;12;23;Keskiviikko;2;1;3;0;0;0
109;14.12.2017;2017;12;00;Torstai;1;1;2;0;1;1
109;14.12.2017;2017;12;01;Torstai;0;0;0;0;0;0
109;14.12.2017;2017;12;02;Torstai;1;1;2;0;0;0
109;14.12.2017;2017;12;03;Torstai;0;0;0;0;0;0
109;14.12.2017;2017;12;04;Torstai;0;0;0;1;0;1
109;14.12.2017;2017;12;05;Torstai;3;3;6;1;1;2
109;14.12.2017;2017;12;06;Torstai;7;5;12;2;1;3
109;14.12.2017;2017;12;07;Torstai;29;26;55;1;1;2
109;14.12.2017;2017;12;08;Torstai;13;13;26;5;1;6
109;14.12.2017;2017;12;09;Torstai;8;6;14;2;0;2
109;14.12.2017;2017;12;10;Torstai;3;3;6;2;0;2
109;14.12.2017;2017;12;11;Torstai;6;3;9;1;1;2
109;14.12.2017;2017;12;12;Torstai;7;5;12;1;1;2
109;14.12.2017;2017;12;13;Torstai;7;2;9;7;1;8
109;14.12.2017;2017;12;14;Torstai;8;7;15;3;2;5
109;14.12.2017;2017;12;15;Torstai;12;19;31;3;2;5
109;14.12.2017;2017;12;16;Torstai;21;29;50;3;7;10
109;14.12.2017;2017;12;17;Torstai;6;14;20;6;2;8
109;14.12.2017;2017;12;18;Torstai;9;5;14;3;6;9
109;14.12.2017;2017;12;19;Torstai;0;3;3;5;5;10
109;14.12.2017;2017;12;20;Torstai;5;4;9;5;3;8
109;14.12.2017;2017;12;21;Torstai;0;4;4;1;2;3
109;14.12.2017;2017;12;22;Torstai;1;3;4;2;1;3
109;14.12.2017;2017;12;23;Torstai;1;2;3;4;1;5
109;15.12.2017;2017;12;00;Perjantai;1;0;1;1;1;2
109;15.12.2017;2017;12;01;Perjantai;0;0;0;0;0;0
109;15.12.2017;2017;12;02;Perjantai;0;0;0;0;0;0
109;15.12.2017;2017;12;03;Perjantai;0;0;0;0;0;0
109;15.12.2017;2017;12;04;Perjantai;1;1;2;5;2;7
109;15.12.2017;2017;12;05;Perjantai;1;4;5;1;1;2
109;15.12.2017;2017;12;06;Perjantai;10;7;17;4;1;5
109;15.12.2017;2017;12;07;Perjantai;28;13;41;1;3;4
109;15.12.2017;2017;12;08;Perjantai;19;9;28;4;4;8
109;15.12.2017;2017;12;09;Perjantai;7;8;15;5;1;6
109;15.12.2017;2017;12;10;Perjantai;8;3;11;5;1;6
109;15.12.2017;2017;12;11;Perjantai;10;11;21;6;5;11
109;15.12.2017;2017;12;12;Perjantai;9;3;12;3;4;7
109;15.12.2017;2017;12;13;Perjantai;7;7;14;0;4;4
109;15.12.2017;2017;12;14;Perjantai;4;9;13;4;1;5
109;15.12.2017;2017;12;15;Perjantai;13;19;32;3;4;7
109;15.12.2017;2017;12;16;Perjantai;15;16;31;3;7;10
109;15.12.2017;2017;12;17;Perjantai;9;5;14;1;4;5
109;15.12.2017;2017;12;18;Perjantai;2;3;5;8;1;9
109;15.12.2017;2017;12;19;Perjantai;4;2;6;4;3;7
109;15.12.2017;2017;12;20;Perjantai;5;6;11;7;1;8
109;15.12.2017;2017;12;21;Perjantai;1;2;3;2;4;6
109;15.12.2017;2017;12;22;Perjantai;1;3;4;2;0;2
109;15.12.2017;2017;12;23;Perjantai;0;0;0;1;1;2
109;16.12.2017;2017;12;00;Lauantai;2;1;3;0;0;0
109;16.12.2017;2017;12;01;Lauantai;1;0;1;0;0;0
109;16.12.2017;2017;12;02;Lauantai;1;2;3;0;1;1
109;16.12.2017;2017;12;03;Lauantai;0;2;2;0;0;0
109;16.12.2017;2017;12;04;Lauantai;0;0;0;0;0;0
109;16.12.2017;2017;12;05;Lauantai;0;2;2;2;1;3
109;16.12.2017;2017;12;06;Lauantai;1;1;2;0;0;0
109;16.12.2017;2017;12;07;Lauantai;0;4;4;0;0;0
109;16.12.2017;2017;12;08;Lauantai;3;3;6;3;2;5
109;16.12.2017;2017;12;09;Lauantai;4;0;4;3;0;3
109;16.12.2017;2017;12;10;Lauantai;2;0;2;7;3;10
109;16.12.2017;2017;12;11;Lauantai;3;0;3;2;5;7
109;16.12.2017;2017;12;12;Lauantai;6;2;8;5;1;6
109;16.12.2017;2017;12;13;Lauantai;2;5;7;4;3;7
109;16.12.2017;2017;12;14;Lauantai;3;0;3;3;1;4
109;16.12.2017;2017;12;15;Lauantai;2;0;2;1;1;2
109;16.12.2017;2017;12;16;Lauantai;5;2;7;3;2;5
109;16.12.2017;2017;12;17;Lauantai;3;2;5;1;0;1
109;16.12.2017;2017;12;18;Lauantai;1;1;2;1;0;1
109;16.12.2017;2017;12;19;Lauantai;2;0;2;0;0;0
109;16.12.2017;2017;12;20;Lauantai;1;1;2;0;0;0
109;16.12.2017;2017;12;21;Lauantai;0;0;0;0;0;0
109;16.12.2017;2017;12;22;Lauantai;1;1;2;0;0;0
109;16.12.2017;2017;12;23;Lauantai;2;0;2;1;0;1
109;17.12.2017;2017;12;00;Sunnuntai;1;0;1;0;0;0
109;17.12.2017;2017;12;01;Sunnuntai;0;0;0;0;1;1
109;17.12.2017;2017;12;02;Sunnuntai;0;0;0;0;0;0
109;17.12.2017;2017;12;03;Sunnuntai;0;0;0;0;0;0
109;17.12.2017;2017;12;04;Sunnuntai;0;0;0;0;0;0
109;17.12.2017;2017;12;05;Sunnuntai;2;1;3;0;0;0
109;17.12.2017;2017;12;06;Sunnuntai;0;0;0;0;0;0
109;17.12.2017;2017;12;07;Sunnuntai;3;0;3;1;1;2
109;17.12.2017;2017;12;08;Sunnuntai;4;2;6;0;0;0
109;17.12.2017;2017;12;09;Sunnuntai;4;1;5;2;0;2
109;17.12.2017;2017;12;10;Sunnuntai;2;1;3;2;0;2
109;17.12.2017;2017;12;11;Sunnuntai;6;5;11;4;1;5
109;17.12.2017;2017;12;12;Sunnuntai;6;2;8;2;0;2
109;17.12.2017;2017;12;13;Sunnuntai;9;2;11;3;0;3
109;17.12.2017;2017;12;14;Sunnuntai;3;3;6;3;1;4
109;17.12.2017;2017;12;15;Sunnuntai;5;1;6;2;3;5
109;17.12.2017;2017;12;16;Sunnuntai;5;5;10;6;4;10
109;17.12.2017;2017;12;17;Sunnuntai;4;0;4;3;1;4
109;17.12.2017;2017;12;18;Sunnuntai;1;2;3;7;4;11
109;17.12.2017;2017;12;19;Sunnuntai;7;4;11;8;0;8
109;17.12.2017;2017;12;20;Sunnuntai;1;1;2;0;3;3
109;17.12.2017;2017;12;21;Sunnuntai;1;2;3;0;1;1
109;17.12.2017;2017;12;22;Sunnuntai;3;2;5;5;1;6
109;17.12.2017;2017;12;23;Sunnuntai;0;0;0;1;0;1
109;18.12.2017;2017;12;00;Maanantai;0;0;0;1;1;2
109;18.12.2017;2017;12;01;Maanantai;1;1;2;0;0;0
109;18.12.2017;2017;12;02;Maanantai;0;0;0;0;0;0
109;18.12.2017;2017;12;03;Maanantai;0;0;0;0;1;1
109;18.12.2017;2017;12;04;Maanantai;0;0;0;1;0;1
109;18.12.2017;2017;12;05;Maanantai;0;2;2;3;2;5
109;18.12.2017;2017;12;06;Maanantai;19;5;24;2;1;3
109;18.12.2017;2017;12;07;Maanantai;30;18;48;6;6;12
109;18.12.2017;2017;12;08;Maanantai;17;9;26;1;3;4
109;18.12.2017;2017;12;09;Maanantai;15;3;18;4;2;6
109;18.12.2017;2017;12;10;Maanantai;7;1;8;3;2;5
109;18.12.2017;2017;12;11;Maanantai;5;4;9;4;4;8
109;18.12.2017;2017;12;12;Maanantai;9;1;10;3;3;6
109;18.12.2017;2017;12;13;Maanantai;4;11;15;4;4;8
109;18.12.2017;2017;12;14;Maanantai;7;9;16;4;3;7
109;18.12.2017;2017;12;15;Maanantai;12;17;29;4;9;13
109;18.12.2017;2017;12;16;Maanantai;18;19;37;8;3;11
109;18.12.2017;2017;12;17;Maanantai;8;14;22;7;2;9
109;18.12.2017;2017;12;18;Maanantai;5;9;14;9;5;14
109;18.12.2017;2017;12;19;Maanantai;3;5;8;4;2;6
109;18.12.2017;2017;12;20;Maanantai;1;5;6;1;5;6
109;18.12.2017;2017;12;21;Maanantai;0;3;3;2;2;4
109;18.12.2017;2017;12;22;Maanantai;5;4;9;0;1;1
109;18.12.2017;2017;12;23;Maanantai;0;2;2;2;0;2
109;19.12.2017;2017;12;00;Tiistai;0;0;0;0;0;0
109;19.12.2017;2017;12;01;Tiistai;0;0;0;0;0;0
109;19.12.2017;2017;12;02;Tiistai;1;0;1;0;0;0
109;19.12.2017;2017;12;03;Tiistai;0;0;0;0;0;0
109;19.12.2017;2017;12;04;Tiistai;0;0;0;1;0;1
109;19.12.2017;2017;12;05;Tiistai;2;1;3;2;1;3
109;19.12.2017;2017;12;06;Tiistai;22;9;31;3;2;5
109;19.12.2017;2017;12;07;Tiistai;33;22;55;5;3;8
109;19.12.2017;2017;12;08;Tiistai;20;11;31;4;1;5
109;19.12.2017;2017;12;09;Tiistai;12;4;16;4;3;7
109;19.12.2017;2017;12;10;Tiistai;4;3;7;9;6;15
109;19.12.2017;2017;12;11;Tiistai;6;3;9;5;3;8
109;19.12.2017;2017;12;12;Tiistai;5;4;9;4;4;8
109;19.12.2017;2017;12;13;Tiistai;4;8;12;3;2;5
109;19.12.2017;2017;12;14;Tiistai;13;6;19;5;1;6
109;19.12.2017;2017;12;15;Tiistai;14;20;34;8;4;12
109;19.12.2017;2017;12;16;Tiistai;16;24;40;4;3;7
109;19.12.2017;2017;12;17;Tiistai;12;12;24;7;3;10
109;19.12.2017;2017;12;18;Tiistai;9;7;16;6;5;11
109;19.12.2017;2017;12;19;Tiistai;0;3;3;3;4;7
109;19.12.2017;2017;12;20;Tiistai;0;3;3;7;5;12
109;19.12.2017;2017;12;21;Tiistai;2;7;9;3;1;4
109;19.12.2017;2017;12;22;Tiistai;2;2;4;2;0;2
109;19.12.2017;2017;12;23;Tiistai;0;0;0;1;1;2
109;20.12.2017;2017;12;00;Keskiviikko;0;0;0;1;0;1
109;20.12.2017;2017;12;01;Keskiviikko;0;0;0;0;0;0
109;20.12.2017;2017;12;02;Keskiviikko;0;0;0;0;0;0
109;20.12.2017;2017;12;03;Keskiviikko;0;0;0;0;0;0
109;20.12.2017;2017;12;04;Keskiviikko;0;0;0;1;0;1
109;20.12.2017;2017;12;05;Keskiviikko;0;0;0;2;1;3
109;20.12.2017;2017;12;06;Keskiviikko;15;9;24;1;2;3
109;20.12.2017;2017;12;07;Keskiviikko;24;21;45;6;2;8
109;20.12.2017;2017;12;08;Keskiviikko;13;4;17;3;3;6
109;20.12.2017;2017;12;09;Keskiviikko;11;5;16;3;1;4
109;20.12.2017;2017;12;10;Keskiviikko;0;0;0;2;0;2
109;20.12.2017;2017;12;11;Keskiviikko;5;1;6;1;1;2
109;20.12.2017;2017;12;12;Keskiviikko;4;2;6;1;1;2
109;20.12.2017;2017;12;13;Keskiviikko;3;3;6;1;1;2
109;20.12.2017;2017;12;14;Keskiviikko;8;3;11;5;3;8
109;20.12.2017;2017;12;15;Keskiviikko;6;12;18;5;1;6
109;20.12.2017;2017;12;16;Keskiviikko;19;13;32;3;0;3
109;20.12.2017;2017;12;17;Keskiviikko;11;7;18;0;0;0
109;20.12.2017;2017;12;18;Keskiviikko;7;4;11;0;0;0
109;20.12.2017;2017;12;19;Keskiviikko;2;1;3;0;0;0
109;20.12.2017;2017;12;20;Keskiviikko;3;1;4;0;0;0
109;20.12.2017;2017;12;21;Keskiviikko;2;0;2;0;0;0
109;20.12.2017;2017;12;22;Keskiviikko;3;2;5;0;0;0
109;20.12.2017;2017;12;23;Keskiviikko;0;0;0;0;0;0
109;21.12.2017;2017;12;00;Torstai;1;0;1;0;0;0
109;21.12.2017;2017;12;01;Torstai;0;0;0;0;0;0
109;21.12.2017;2017;12;02;Torstai;2;0;2;0;0;0
109;21.12.2017;2017;12;03;Torstai;0;0;0;0;0;0
109;21.12.2017;2017;12;04;Torstai;0;0;0;0;0;0
109;21.12.2017;2017;12;05;Torstai;0;0;0;0;0;0
109;21.12.2017;2017;12;06;Torstai;9;7;16;0;0;0
109;21.12.2017;2017;12;07;Torstai;19;19;38;0;0;0
109;21.12.2017;2017;12;08;Torstai;10;7;17;0;0;0
109;21.12.2017;2017;12;09;Torstai;7;3;10;1;0;1
109;21.12.2017;2017;12;10;Torstai;4;2;6;2;0;2
109;21.12.2017;2017;12;11;Torstai;4;3;7;0;0;0
109;21.12.2017;2017;12;12;Torstai;5;3;8;0;0;0
109;21.12.2017;2017;12;13;Torstai;11;5;16;0;0;0
109;21.12.2017;2017;12;14;Torstai;9;6;15;1;0;1
109;21.12.2017;2017;12;15;Torstai;13;10;23;0;1;1
109;21.12.2017;2017;12;16;Torstai;16;12;28;1;0;1
109;21.12.2017;2017;12;17;Torstai;13;10;23;3;0;3
109;21.12.2017;2017;12;18;Torstai;6;2;8;1;0;1
109;21.12.2017;2017;12;19;Torstai;5;2;7;1;1;2
109;21.12.2017;2017;12;20;Torstai;3;2;5;1;0;1
109;21.12.2017;2017;12;21;Torstai;7;2;9;0;0;0
109;21.12.2017;2017;12;22;Torstai;3;1;4;2;0;2
109;21.12.2017;2017;12;23;Torstai;0;0;0;0;0;0
109;22.12.2017;2017;12;00;Perjantai;0;0;0;0;0;0
109;22.12.2017;2017;12;01;Perjantai;0;0;0;0;0;0
109;22.12.2017;2017;12;02;Perjantai;0;0;0;0;0;0
109;22.12.2017;2017;12;03;Perjantai;0;0;0;0;0;0
109;22.12.2017;2017;12;04;Perjantai;0;0;0;0;0;0
109;22.12.2017;2017;12;05;Perjantai;2;0;2;0;0;0
109;22.12.2017;2017;12;06;Perjantai;8;6;14;0;0;0
109;22.12.2017;2017;12;07;Perjantai;19;12;31;0;0;0
109;22.12.2017;2017;12;08;Perjantai;10;10;20;1;0;1
109;22.12.2017;2017;12;09;Perjantai;4;3;7;1;0;1
109;22.12.2017;2017;12;10;Perjantai;6;3;9;2;0;2
109;22.12.2017;2017;12;11;Perjantai;6;3;9;1;0;1
109;22.12.2017;2017;12;12;Perjantai;9;4;13;0;0;0
109;22.12.2017;2017;12;13;Perjantai;8;5;13;2;0;2
109;22.12.2017;2017;12;14;Perjantai;12;8;20;2;0;2
109;22.12.2017;2017;12;15;Perjantai;14;9;23;2;0;2
109;22.12.2017;2017;12;16;Perjantai;10;8;18;2;0;2
109;22.12.2017;2017;12;17;Perjantai;6;2;8;2;0;2
109;22.12.2017;2017;12;18;Perjantai;6;2;8;1;0;1
109;22.12.2017;2017;12;19;Perjantai;3;0;3;1;0;1
109;22.12.2017;2017;12;20;Perjantai;4;2;6;0;0;0
109;22.12.2017;2017;12;21;Perjantai;3;0;3;1;0;1
109;22.12.2017;2017;12;22;Perjantai;2;0;2;0;0;0
109;22.12.2017;2017;12;23;Perjantai;3;2;5;1;0;1
109;23.12.2017;2017;12;00;Lauantai;0;0;0;1;0;1
109;23.12.2017;2017;12;01;Lauantai;1;0;1;0;0;0
109;23.12.2017;2017;12;02;Lauantai;0;0;0;0;0;0
109;23.12.2017;2017;12;03;Lauantai;0;0;0;0;0;0
109;23.12.2017;2017;12;04;Lauantai;0;0;0;0;0;0
109;23.12.2017;2017;12;05;Lauantai;0;0;0;0;0;0
109;23.12.2017;2017;12;06;Lauantai;3;1;4;0;0;0
109;23.12.2017;2017;12;07;Lauantai;0;0;0;0;0;0
109;23.12.2017;2017;12;08;Lauantai;1;3;4;0;0;0
109;23.12.2017;2017;12;09;Lauantai;1;0;1;0;0;0
109;23.12.2017;2017;12;10;Lauantai;1;0;1;0;0;0
109;23.12.2017;2017;12;11;Lauantai;3;0;3;0;0;0
109;23.12.2017;2017;12;12;Lauantai;2;1;3;0;0;0
109;23.12.2017;2017;12;13;Lauantai;2;1;3;0;0;0
109;23.12.2017;2017;12;14;Lauantai;1;0;1;0;0;0
109;23.12.2017;2017;12;15;Lauantai;1;0;1;0;0;0
109;23.12.2017;2017;12;16;Lauantai;2;2;4;0;0;0
109;23.12.2017;2017;12;17;Lauantai;2;1;3;0;0;0
109;23.12.2017;2017;12;18;Lauantai;1;0;1;0;0;0
109;23.12.2017;2017;12;19;Lauantai;3;1;4;0;0;0
109;23.12.2017;2017;12;20;Lauantai;0;0;0;0;0;0
109;23.12.2017;2017;12;21;Lauantai;1;0;1;0;0;0
109;23.12.2017;2017;12;22;Lauantai;1;0;1;0;0;0
109;23.12.2017;2017;12;23;Lauantai;0;0;0;0;0;0
109;24.12.2017;2017;12;00;Sunnuntai;0;0;0;0;0;0
109;24.12.2017;2017;12;01;Sunnuntai;0;0;0;0;0;0
109;24.12.2017;2017;12;02;Sunnuntai;0;0;0;0;0;0
109;24.12.2017;2017;12;03;Sunnuntai;1;0;1;0;0;0
109;24.12.2017;2017;12;04;Sunnuntai;0;0;0;0;0;0
109;24.12.2017;2017;12;05;Sunnuntai;0;0;0;0;0;0
109;24.12.2017;2017;12;06;Sunnuntai;0;0;0;0;0;0
109;24.12.2017;2017;12;07;Sunnuntai;1;0;1;0;0;0
109;24.12.2017;2017;12;08;Sunnuntai;1;0;1;0;0;0
109;24.12.2017;2017;12;09;Sunnuntai;0;0;0;0;0;0
109;24.12.2017;2017;12;10;Sunnuntai;2;0;2;0;0;0
109;24.12.2017;2017;12;11;Sunnuntai;2;1;3;0;0;0
109;24.12.2017;2017;12;12;Sunnuntai;0;0;0;0;0;0
109;24.12.2017;2017;12;13;Sunnuntai;2;1;3;0;0;0
109;24.12.2017;2017;12;14;Sunnuntai;0;0;0;0;0;0
109;24.12.2017;2017;12;15;Sunnuntai;0;0;0;0;0;0
109;24.12.2017;2017;12;16;Sunnuntai;2;1;3;0;0;0
109;24.12.2017;2017;12;17;Sunnuntai;2;0;2;0;0;0
109;24.12.2017;2017;12;18;Sunnuntai;1;0;1;0;0;0
109;24.12.2017;2017;12;19;Sunnuntai;1;0;1;0;0;0
109;24.12.2017;2017;12;20;Sunnuntai;2;0;2;0;0;0
109;24.12.2017;2017;12;21;Sunnuntai;1;0;1;0;0;0
109;24.12.2017;2017;12;22;Sunnuntai;1;0;1;0;0;0
109;24.12.2017;2017;12;23;Sunnuntai;1;0;1;0;0;0
109;25.12.2017;2017;12;00;Maanantai;1;0;1;0;0;0
109;25.12.2017;2017;12;01;Maanantai;0;0;0;1;0;1
109;25.12.2017;2017;12;02;Maanantai;0;0;0;0;0;0
109;25.12.2017;2017;12;03;Maanantai;0;0;0;0;0;0
109;25.12.2017;2017;12;04;Maanantai;0;0;0;0;0;0
109;25.12.2017;2017;12;05;Maanantai;0;0;0;0;0;0
109;25.12.2017;2017;12;06;Maanantai;1;0;1;0;0;0
109;25.12.2017;2017;12;07;Maanantai;2;1;3;2;0;2
109;25.12.2017;2017;12;08;Maanantai;1;0;1;0;0;0
109;25.12.2017;2017;12;09;Maanantai;1;0;1;2;0;2
109;25.12.2017;2017;12;10;Maanantai;0;0;0;2;0;2
109;25.12.2017;2017;12;11;Maanantai;2;0;2;5;0;5
109;25.12.2017;2017;12;12;Maanantai;3;2;5;2;0;2
109;25.12.2017;2017;12;13;Maanantai;4;2;6;3;0;3
109;25.12.2017;2017;12;14;Maanantai;4;1;5;4;0;4
109;25.12.2017;2017;12;15;Maanantai;4;2;6;5;0;5
109;25.12.2017;2017;12;16;Maanantai;1;1;2;10;0;10
109;25.12.2017;2017;12;17;Maanantai;1;0;1;4;0;4
109;25.12.2017;2017;12;18;Maanantai;2;1;3;11;0;11
109;25.12.2017;2017;12;19;Maanantai;1;0;1;8;0;8
109;25.12.2017;2017;12;20;Maanantai;0;0;0;3;0;3
109;25.12.2017;2017;12;21;Maanantai;2;0;2;1;0;1
109;25.12.2017;2017;12;22;Maanantai;1;0;1;6;0;6
109;25.12.2017;2017;12;23;Maanantai;0;0;0;1;0;1
109;26.12.2017;2017;12;00;Tiistai;0;0;0;0;0;0
109;26.12.2017;2017;12;01;Tiistai;0;0;0;0;0;0
109;26.12.2017;2017;12;02;Tiistai;0;0;0;1;0;1
109;26.12.2017;2017;12;03;Tiistai;0;0;0;0;0;0
109;26.12.2017;2017;12;04;Tiistai;0;0;0;0;0;0
109;26.12.2017;2017;12;05;Tiistai;0;0;0;3;0;3
109;26.12.2017;2017;12;06;Tiistai;2;0;2;0;0;0
109;26.12.2017;2017;12;07;Tiistai;2;1;3;0;0;0
109;26.12.2017;2017;12;08;Tiistai;3;1;4;5;0;5
109;26.12.2017;2017;12;09;Tiistai;1;0;1;3;0;3
109;26.12.2017;2017;12;10;Tiistai;2;0;2;10;0;10
109;26.12.2017;2017;12;11;Tiistai;1;0;1;7;0;7
109;26.12.2017;2017;12;12;Tiistai;1;1;2;6;0;6
109;26.12.2017;2017;12;13;Tiistai;4;1;5;7;0;7
109;26.12.2017;2017;12;14;Tiistai;3;2;5;4;0;4
109;26.12.2017;2017;12;15;Tiistai;3;0;3;2;0;2
109;26.12.2017;2017;12;16;Tiistai;3;1;4;5;0;5
109;26.12.2017;2017;12;17;Tiistai;3;0;3;1;0;1
109;26.12.2017;2017;12;18;Tiistai;0;0;0;1;0;1
109;26.12.2017;2017;12;19;Tiistai;1;0;1;0;0;0
109;26.12.2017;2017;12;20;Tiistai;1;0;1;0;0;0
109;26.12.2017;2017;12;21;Tiistai;3;0;3;0;0;0
109;26.12.2017;2017;12;22;Tiistai;0;0;0;0;0;0
109;26.12.2017;2017;12;23;Tiistai;1;0;1;1;0;1
109;27.12.2017;2017;12;00;Keskiviikko;0;0;0;1;0;1
109;27.12.2017;2017;12;01;Keskiviikko;0;0;0;0;0;0
109;27.12.2017;2017;12;02;Keskiviikko;0;0;0;1;0;1
109;27.12.2017;2017;12;03;Keskiviikko;0;0;0;0;0;0
109;27.12.2017;2017;12;04;Keskiviikko;0;0;0;3;0;3
109;27.12.2017;2017;12;05;Keskiviikko;2;0;2;1;0;1
109;27.12.2017;2017;12;06;Keskiviikko;5;4;9;3;0;3
109;27.12.2017;2017;12;07;Keskiviikko;10;10;20;3;0;3
109;27.12.2017;2017;12;08;Keskiviikko;7;5;12;3;0;3
109;27.12.2017;2017;12;09;Keskiviikko;3;2;5;5;0;5
109;27.12.2017;2017;12;10;Keskiviikko;2;1;3;7;0;7
109;27.12.2017;2017;12;11;Keskiviikko;5;2;7;6;0;6
109;27.12.2017;2017;12;12;Keskiviikko;5;3;8;9;0;9
109;27.12.2017;2017;12;13;Keskiviikko;5;4;9;6;0;6
109;27.12.2017;2017;12;14;Keskiviikko;3;2;5;8;0;8
109;27.12.2017;2017;12;15;Keskiviikko;6;6;12;4;0;4
109;27.12.2017;2017;12;16;Keskiviikko;14;11;25;4;0;4
109;27.12.2017;2017;12;17;Keskiviikko;7;5;12;7;0;7
109;27.12.2017;2017;12;18;Keskiviikko;4;2;6;7;0;7
109;27.12.2017;2017;12;19;Keskiviikko;3;1;4;6;0;6
109;27.12.2017;2017;12;20;Keskiviikko;1;1;2;2;0;2
109;27.12.2017;2017;12;21;Keskiviikko;4;3;7;0;0;0
109;27.12.2017;2017;12;22;Keskiviikko;3;2;5;0;0;0
109;27.12.2017;2017;12;23;Keskiviikko;0;0;0;0;0;0
109;28.12.2017;2017;12;00;Torstai;0;0;0;1;0;1
109;28.12.2017;2017;12;01;Torstai;1;0;1;0;0;0
109;28.12.2017;2017;12;02;Torstai;0;0;0;1;0;1
109;28.12.2017;2017;12;03;Torstai;0;0;0;0;0;0
109;28.12.2017;2017;12;04;Torstai;0;0;0;3;0;3
109;28.12.2017;2017;12;05;Torstai;2;1;3;1;0;1
109;28.12.2017;2017;12;06;Torstai;7;4;11;3;0;3
109;28.12.2017;2017;12;07;Torstai;10;8;18;3;0;3
109;28.12.2017;2017;12;08;Torstai;7;5;12;3;0;3
109;28.12.2017;2017;12;09;Torstai;4;0;4;5;0;5
109;28.12.2017;2017;12;10;Torstai;3;2;5;7;0;7
109;28.12.2017;2017;12;11;Torstai;4;3;7;6;0;6
109;28.12.2017;2017;12;12;Torstai;5;3;8;9;0;9
109;28.12.2017;2017;12;13;Torstai;6;3;9;6;0;6
109;28.12.2017;2017;12;14;Torstai;6;4;10;8;0;8
109;28.12.2017;2017;12;15;Torstai;9;7;16;4;0;4
109;28.12.2017;2017;12;16;Torstai;14;12;26;4;0;4
109;28.12.2017;2017;12;17;Torstai;5;3;8;7;0;7
109;28.12.2017;2017;12;18;Torstai;2;0;2;7;0;7
109;28.12.2017;2017;12;19;Torstai;2;2;4;6;0;6
109;28.12.2017;2017;12;20;Torstai;3;0;3;2;0;2
109;28.12.2017;2017;12;21;Torstai;4;3;7;0;0;0
109;28.12.2017;2017;12;22;Torstai;2;2;4;0;0;0
109;28.12.2017;2017;12;23;Torstai;1;0;1;0;0;0
109;29.12.2017;2017;12;00;Perjantai;0;0;0;1;0;1
109;29.12.2017;2017;12;01;Perjantai;0;0;0;0;0;0
109;29.12.2017;2017;12;02;Perjantai;1;0;1;0;0;0
109;29.12.2017;2017;12;03;Perjantai;0;0;0;0;0;0
109;29.12.2017;2017;12;04;Perjantai;0;0;0;1;0;1
109;29.12.2017;2017;12;05;Perjantai;1;1;2;3;0;3
109;29.12.2017;2017;12;06;Perjantai;3;2;5;3;0;3
109;29.12.2017;2017;12;07;Perjantai;9;8;17;8;0;8
109;29.12.2017;2017;12;08;Perjantai;5;4;9;6;0;6
109;29.12.2017;2017;12;09;Perjantai;3;0;3;4;0;4
109;29.12.2017;2017;12;10;Perjantai;3;1;4;2;0;2
109;29.12.2017;2017;12;11;Perjantai;1;0;1;2;0;2
109;29.12.2017;2017;12;12;Perjantai;7;5;12;2;0;2
109;29.12.2017;2017;12;13;Perjantai;4;2;6;2;0;2
109;29.12.2017;2017;12;14;Perjantai;5;3;8;8;0;8
109;29.12.2017;2017;12;15;Perjantai;8;8;16;6;0;6
109;29.12.2017;2017;12;16;Perjantai;9;8;17;3;0;3
109;29.12.2017;2017;12;17;Perjantai;5;2;7;5;0;5
109;29.12.2017;2017;12;18;Perjantai;4;1;5;6;1;7
109;29.12.2017;2017;12;19;Perjantai;3;3;6;3;2;5
109;29.12.2017;2017;12;20;Perjantai;1;1;2;6;0;6
109;29.12.2017;2017;12;21;Perjantai;0;2;2;1;0;1
109;29.12.2017;2017;12;22;Perjantai;0;1;1;1;2;3
109;29.12.2017;2017;12;23;Perjantai;2;0;2;1;0;1
109;30.12.2017;2017;12;00;Lauantai;0;0;0;0;0;0
109;30.12.2017;2017;12;01;Lauantai;0;0;0;0;1;1
109;30.12.2017;2017;12;02;Lauantai;2;0;2;1;0;1
109;30.12.2017;2017;12;03;Lauantai;0;1;1;0;1;1
109;30.12.2017;2017;12;04;Lauantai;0;1;1;2;0;2
109;30.12.2017;2017;12;05;Lauantai;0;2;2;0;0;0
109;30.12.2017;2017;12;06;Lauantai;3;1;4;1;1;2
109;30.12.2017;2017;12;07;Lauantai;0;0;0;1;1;2
109;30.12.2017;2017;12;08;Lauantai;1;1;2;0;1;1
109;30.12.2017;2017;12;09;Lauantai;1;1;2;1;0;1
109;30.12.2017;2017;12;10;Lauantai;3;0;3;6;0;6
109;30.12.2017;2017;12;11;Lauantai;2;1;3;1;3;4
109;30.12.2017;2017;12;12;Lauantai;5;1;6;2;1;3
109;30.12.2017;2017;12;13;Lauantai;1;0;1;2;2;4
109;30.12.2017;2017;12;14;Lauantai;2;1;3;2;3;5
109;30.12.2017;2017;12;15;Lauantai;4;0;4;4;1;5
109;30.12.2017;2017;12;16;Lauantai;1;5;6;1;4;5
109;30.12.2017;2017;12;17;Lauantai;0;0;0;2;2;4
109;30.12.2017;2017;12;18;Lauantai;2;0;2;7;3;10
109;30.12.2017;2017;12;19;Lauantai;0;1;1;6;4;10
109;30.12.2017;2017;12;20;Lauantai;1;0;1;5;1;6
109;30.12.2017;2017;12;21;Lauantai;2;4;6;1;4;5
109;30.12.2017;2017;12;22;Lauantai;0;0;0;2;3;5
109;30.12.2017;2017;12;23;Lauantai;1;0;1;0;1;1
109;31.12.2017;2017;12;00;Sunnuntai;0;0;0;0;0;0
109;31.12.2017;2017;12;01;Sunnuntai;0;0;0;0;1;1
109;31.12.2017;2017;12;02;Sunnuntai;0;0;0;2;0;2
109;31.12.2017;2017;12;03;Sunnuntai;0;2;2;0;0;0
109;31.12.2017;2017;12;04;Sunnuntai;0;0;0;0;1;1
109;31.12.2017;2017;12;05;Sunnuntai;0;1;1;0;0;0
109;31.12.2017;2017;12;06;Sunnuntai;4;2;6;1;3;4
109;31.12.2017;2017;12;07;Sunnuntai;0;2;2;0;2;2
109;31.12.2017;2017;12;08;Sunnuntai;0;0;0;2;2;4
109;31.12.2017;2017;12;09;Sunnuntai;1;0;1;5;4;9
109;31.12.2017;2017;12;10;Sunnuntai;3;1;4;9;3;12
109;31.12.2017;2017;12;11;Sunnuntai;5;1;6;2;3;5
109;31.12.2017;2017;12;12;Sunnuntai;4;2;6;7;3;10
109;31.12.2017;2017;12;13;Sunnuntai;3;4;7;7;4;11
109;31.12.2017;2017;12;14;Sunnuntai;3;0;3;7;5;12
109;31.12.2017;2017;12;15;Sunnuntai;3;6;9;1;3;4
109;31.12.2017;2017;12;16;Sunnuntai;2;3;5;1;0;1
109;31.12.2017;2017;12;17;Sunnuntai;1;3;4;2;0;2
109;31.12.2017;2017;12;18;Sunnuntai;1;4;5;3;1;4
109;31.12.2017;2017;12;19;Sunnuntai;3;2;5;5;2;7
109;31.12.2017;2017;12;20;Sunnuntai;2;5;7;0;4;4
109;31.12.2017;2017;12;21;Sunnuntai;1;2;3;3;0;3
109;31.12.2017;2017;12;22;Sunnuntai;1;0;1;0;0;0
109;31.12.2017;2017;12;23;Sunnuntai;0;1;1;1;0;1
109;01.01.2018;2018;01;00;Maanantai;2;1;3;0;0;0
109;01.01.2018;2018;01;01;Maanantai;0;0;0;0;0;0
109;01.01.2018;2018;01;02;Maanantai;0;0;0;0;0;0
109;01.01.2018;2018;01;03;Maanantai;0;1;1;0;1;1
109;01.01.2018;2018;01;04;Maanantai;0;2;2;1;2;3
109;01.01.2018;2018;01;05;Maanantai;0;1;1;1;3;4
109;01.01.2018;2018;01;06;Maanantai;1;0;1;5;2;7
109;01.01.2018;2018;01;07;Maanantai;0;1;1;0;0;0
109;01.01.2018;2018;01;08;Maanantai;0;0;0;3;0;3
109;01.01.2018;2018;01;09;Maanantai;1;1;2;3;2;5
109;01.01.2018;2018;01;10;Maanantai;2;3;5;6;1;7
109;01.01.2018;2018;01;11;Maanantai;1;3;4;7;5;12
109;01.01.2018;2018;01;12;Maanantai;2;1;3;6;6;12
109;01.01.2018;2018;01;13;Maanantai;0;0;0;10;3;13
109;01.01.2018;2018;01;14;Maanantai;2;1;3;3;6;9
109;01.01.2018;2018;01;15;Maanantai;3;0;3;11;4;15
109;01.01.2018;2018;01;16;Maanantai;2;2;4;2;2;4
109;01.01.2018;2018;01;17;Maanantai;1;0;1;8;3;11
109;01.01.2018;2018;01;18;Maanantai;1;0;1;3;4;7
109;01.01.2018;2018;01;19;Maanantai;1;1;2;6;5;11
109;01.01.2018;2018;01;20;Maanantai;0;2;2;3;1;4
109;01.01.2018;2018;01;21;Maanantai;1;2;3;2;1;3
109;01.01.2018;2018;01;22;Maanantai;1;2;3;1;0;1
109;01.01.2018;2018;01;23;Maanantai;1;0;1;0;0;0
109;02.01.2018;2018;01;00;Tiistai;0;0;0;1;1;2
109;02.01.2018;2018;01;01;Tiistai;0;0;0;0;2;2
109;02.01.2018;2018;01;02;Tiistai;0;0;0;0;0;0
109;02.01.2018;2018;01;03;Tiistai;0;0;0;0;0;0
109;02.01.2018;2018;01;04;Tiistai;0;0;0;1;0;1
109;02.01.2018;2018;01;05;Tiistai;0;1;1;0;0;0
109;02.01.2018;2018;01;06;Tiistai;10;6;16;3;1;4
109;02.01.2018;2018;01;07;Tiistai;28;14;42;3;8;11
109;02.01.2018;2018;01;08;Tiistai;14;10;24;5;4;9
109;02.01.2018;2018;01;09;Tiistai;3;5;8;6;2;8
109;02.01.2018;2018;01;10;Tiistai;8;3;11;5;3;8
109;02.01.2018;2018;01;11;Tiistai;10;4;14;1;4;5
109;02.01.2018;2018;01;12;Tiistai;4;1;5;2;5;7
109;02.01.2018;2018;01;13;Tiistai;10;5;15;1;2;3
109;02.01.2018;2018;01;14;Tiistai;6;5;11;5;3;8
109;02.01.2018;2018;01;15;Tiistai;7;19;26;9;5;14
109;02.01.2018;2018;01;16;Tiistai;15;29;44;8;3;11
109;02.01.2018;2018;01;17;Tiistai;7;14;21;3;1;4
109;02.01.2018;2018;01;18;Tiistai;3;4;7;9;3;12
109;02.01.2018;2018;01;19;Tiistai;2;3;5;7;7;14
109;02.01.2018;2018;01;20;Tiistai;2;2;4;5;5;10
109;02.01.2018;2018;01;21;Tiistai;2;4;6;3;2;5
109;02.01.2018;2018;01;22;Tiistai;2;1;3;4;1;5
109;02.01.2018;2018;01;23;Tiistai;2;0;2;1;0;1
109;03.01.2018;2018;01;00;Keskiviikko;0;1;1;0;1;1
109;03.01.2018;2018;01;01;Keskiviikko;0;0;0;0;1;1
109;03.01.2018;2018;01;02;Keskiviikko;1;0;1;1;0;1
109;03.01.2018;2018;01;03;Keskiviikko;0;0;0;0;0;0
109;03.01.2018;2018;01;04;Keskiviikko;1;0;1;0;0;0
109;03.01.2018;2018;01;05;Keskiviikko;3;1;4;0;0;0
109;03.01.2018;2018;01;06;Keskiviikko;8;6;14;0;0;0
109;03.01.2018;2018;01;07;Keskiviikko;21;20;41;0;0;0
109;03.01.2018;2018;01;08;Keskiviikko;18;8;26;2;3;5
109;03.01.2018;2018;01;09;Keskiviikko;7;4;11;0;0;0
109;03.01.2018;2018;01;10;Keskiviikko;2;1;3;3;2;5
109;03.01.2018;2018;01;11;Keskiviikko;5;3;8;2;4;6
109;03.01.2018;2018;01;12;Keskiviikko;3;7;10;2;1;3
109;03.01.2018;2018;01;13;Keskiviikko;6;3;9;3;4;7
109;03.01.2018;2018;01;14;Keskiviikko;9;8;17;5;3;8
109;03.01.2018;2018;01;15;Keskiviikko;14;11;25;6;5;11
109;03.01.2018;2018;01;16;Keskiviikko;27;25;52;2;4;6
109;03.01.2018;2018;01;17;Keskiviikko;6;9;15;4;3;7
109;03.01.2018;2018;01;18;Keskiviikko;2;12;14;5;1;6
109;03.01.2018;2018;01;19;Keskiviikko;4;3;7;4;5;9
109;03.01.2018;2018;01;20;Keskiviikko;0;6;6;6;1;7
109;03.01.2018;2018;01;21;Keskiviikko;3;3;6;2;3;5
109;03.01.2018;2018;01;22;Keskiviikko;4;2;6;1;1;2
109;03.01.2018;2018;01;23;Keskiviikko;3;0;3;1;0;1
109;04.01.2018;2018;01;00;Torstai;0;0;0;1;0;1
109;04.01.2018;2018;01;01;Torstai;1;0;1;0;0;0
109;04.01.2018;2018;01;02;Torstai;0;0;0;1;0;1
109;04.01.2018;2018;01;03;Torstai;0;0;0;0;0;0
109;04.01.2018;2018;01;04;Torstai;0;0;0;3;0;3
109;04.01.2018;2018;01;05;Torstai;3;0;3;1;0;1
109;04.01.2018;2018;01;06;Torstai;11;0;11;3;0;3
109;04.01.2018;2018;01;07;Torstai;18;0;18;3;0;3
109;04.01.2018;2018;01;08;Torstai;12;0;12;3;0;3
109;04.01.2018;2018;01;09;Torstai;4;0;4;5;0;5
109;04.01.2018;2018;01;10;Torstai;5;0;5;7;0;7
109;04.01.2018;2018;01;11;Torstai;7;0;7;6;0;6
109;04.01.2018;2018;01;12;Torstai;8;0;8;9;0;9
109;04.01.2018;2018;01;13;Torstai;9;0;9;6;0;6
109;04.01.2018;2018;01;14;Torstai;10;0;10;8;0;8
109;04.01.2018;2018;01;15;Torstai;16;0;16;4;0;4
109;04.01.2018;2018;01;16;Torstai;26;0;26;4;0;4
109;04.01.2018;2018;01;17;Torstai;8;0;8;7;0;7
109;04.01.2018;2018;01;18;Torstai;2;0;2;7;0;7
109;04.01.2018;2018;01;19;Torstai;4;0;4;6;0;6
109;04.01.2018;2018;01;20;Torstai;3;0;3;2;0;2
109;04.01.2018;2018;01;21;Torstai;7;0;7;0;0;0
109;04.01.2018;2018;01;22;Torstai;4;0;4;0;0;0
109;04.01.2018;2018;01;23;Torstai;1;0;1;0;0;0
109;05.01.2018;2018;01;00;Perjantai;3;0;3;1;0;1
109;05.01.2018;2018;01;01;Perjantai;0;1;1;0;0;0
109;05.01.2018;2018;01;02;Perjantai;0;0;0;0;0;0
109;05.01.2018;2018;01;03;Perjantai;0;0;0;0;0;0
109;05.01.2018;2018;01;04;Perjantai;0;0;0;1;0;1
109;05.01.2018;2018;01;05;Perjantai;1;4;5;3;0;3
109;05.01.2018;2018;01;06;Perjantai;4;6;10;3;1;4
109;05.01.2018;2018;01;07;Perjantai;18;11;29;8;0;8
109;05.01.2018;2018;01;08;Perjantai;13;8;21;6;0;6
109;05.01.2018;2018;01;09;Perjantai;7;4;11;4;0;4
109;05.01.2018;2018;01;10;Perjantai;4;1;5;2;0;2
109;05.01.2018;2018;01;11;Perjantai;3;3;6;2;0;2
109;05.01.2018;2018;01;12;Perjantai;4;1;5;2;0;2
109;05.01.2018;2018;01;13;Perjantai;6;3;9;2;0;2
109;05.01.2018;2018;01;14;Perjantai;6;4;10;8;0;8
109;05.01.2018;2018;01;15;Perjantai;7;4;11;6;0;6
109;05.01.2018;2018;01;16;Perjantai;12;12;24;3;0;3
109;05.01.2018;2018;01;17;Perjantai;6;5;11;5;0;5
109;05.01.2018;2018;01;18;Perjantai;3;1;4;7;0;7
109;05.01.2018;2018;01;19;Perjantai;1;1;2;5;0;5
109;05.01.2018;2018;01;20;Perjantai;0;0;0;6;0;6
109;05.01.2018;2018;01;21;Perjantai;3;3;6;1;0;1
109;05.01.2018;2018;01;22;Perjantai;2;0;2;3;0;3
109;05.01.2018;2018;01;23;Perjantai;1;1;2;1;0;1
109;06.01.2018;2018;01;00;Lauantai;1;0;1;0;0;0
109;06.01.2018;2018;01;01;Lauantai;0;0;0;0;0;0
109;06.01.2018;2018;01;02;Lauantai;1;0;1;0;0;0
109;06.01.2018;2018;01;03;Lauantai;0;0;0;0;0;0
109;06.01.2018;2018;01;04;Lauantai;0;1;1;0;0;0
109;06.01.2018;2018;01;05;Lauantai;0;1;1;0;1;1
109;06.01.2018;2018;01;06;Lauantai;3;1;4;1;0;1
109;06.01.2018;2018;01;07;Lauantai;1;0;1;2;3;5
109;06.01.2018;2018;01;08;Lauantai;0;0;0;3;0;3
109;06.01.2018;2018;01;09;Lauantai;0;3;3;6;2;8
109;06.01.2018;2018;01;10;Lauantai;0;1;1;6;1;7
109;06.01.2018;2018;01;11;Lauantai;2;1;3;3;5;8
109;06.01.2018;2018;01;12;Lauantai;3;2;5;3;1;4
109;06.01.2018;2018;01;13;Lauantai;5;1;6;6;4;10
109;06.01.2018;2018;01;14;Lauantai;2;1;3;5;0;5
109;06.01.2018;2018;01;15;Lauantai;2;4;6;6;1;7
109;06.01.2018;2018;01;16;Lauantai;1;2;3;2;1;3
109;06.01.2018;2018;01;17;Lauantai;1;2;3;1;2;3
109;06.01.2018;2018;01;18;Lauantai;2;1;3;5;2;7
109;06.01.2018;2018;01;19;Lauantai;0;1;1;2;0;2
109;06.01.2018;2018;01;20;Lauantai;2;2;4;2;1;3
109;06.01.2018;2018;01;21;Lauantai;3;2;5;0;3;3
109;06.01.2018;2018;01;22;Lauantai;2;0;2;1;0;1
109;06.01.2018;2018;01;23;Lauantai;0;0;0;2;1;3
109;07.01.2018;2018;01;00;Sunnuntai;1;0;1;0;0;0
109;07.01.2018;2018;01;01;Sunnuntai;0;0;0;1;0;1
109;07.01.2018;2018;01;02;Sunnuntai;0;0;0;0;0;0
109;07.01.2018;2018;01;03;Sunnuntai;0;0;0;0;0;0
109;07.01.2018;2018;01;04;Sunnuntai;0;0;0;0;0;0
109;07.01.2018;2018;01;05;Sunnuntai;0;0;0;3;1;4
109;07.01.2018;2018;01;06;Sunnuntai;2;0;2;1;0;1
109;07.01.2018;2018;01;07;Sunnuntai;0;1;1;0;1;1
109;07.01.2018;2018;01;08;Sunnuntai;0;0;0;4;1;5
109;07.01.2018;2018;01;09;Sunnuntai;1;0;1;2;2;4
109;07.01.2018;2018;01;10;Sunnuntai;1;0;1;4;1;5
109;07.01.2018;2018;01;11;Sunnuntai;2;3;5;5;1;6
109;07.01.2018;2018;01;12;Sunnuntai;2;1;3;9;6;15
109;07.01.2018;2018;01;13;Sunnuntai;5;5;10;4;2;6
109;07.01.2018;2018;01;14;Sunnuntai;2;1;3;6;3;9
109;07.01.2018;2018;01;15;Sunnuntai;8;4;12;4;2;6
109;07.01.2018;2018;01;16;Sunnuntai;1;4;5;6;1;7
109;07.01.2018;2018;01;17;Sunnuntai;4;0;4;6;0;6
109;07.01.2018;2018;01;18;Sunnuntai;2;0;2;6;4;10
109;07.01.2018;2018;01;19;Sunnuntai;0;0;0;4;3;7
109;07.01.2018;2018;01;20;Sunnuntai;2;0;2;2;2;4
109;07.01.2018;2018;01;21;Sunnuntai;0;0;0;2;0;2
109;07.01.2018;2018;01;22;Sunnuntai;0;2;2;2;2;4
109;07.01.2018;2018;01;23;Sunnuntai;0;0;0;1;0;1
109;08.01.2018;2018;01;00;Maanantai;0;0;0;0;0;0
109;08.01.2018;2018;01;01;Maanantai;0;0;0;1;0;1
109;08.01.2018;2018;01;02;Maanantai;0;0;0;1;0;1
109;08.01.2018;2018;01;03;Maanantai;0;0;0;0;0;0
109;08.01.2018;2018;01;04;Maanantai;0;0;0;1;0;1
109;08.01.2018;2018;01;05;Maanantai;0;4;4;2;2;4
109;08.01.2018;2018;01;06;Maanantai;17;12;29;0;1;1
109;08.01.2018;2018;01;07;Maanantai;30;25;55;3;1;4
109;08.01.2018;2018;01;08;Maanantai;19;16;35;2;0;2
109;08.01.2018;2018;01;09;Maanantai;15;6;21;2;1;3
109;08.01.2018;2018;01;10;Maanantai;5;4;9;3;2;5
109;08.01.2018;2018;01;11;Maanantai;5;2;7;7;1;8
109;08.01.2018;2018;01;12;Maanantai;7;4;11;11;10;21
109;08.01.2018;2018;01;13;Maanantai;7;7;14;1;2;3
109;08.01.2018;2018;01;14;Maanantai;7;13;20;2;4;6
109;08.01.2018;2018;01;15;Maanantai;13;20;33;5;3;8
109;08.01.2018;2018;01;16;Maanantai;19;35;54;12;4;16
109;08.01.2018;2018;01;17;Maanantai;10;18;28;4;6;10
109;08.01.2018;2018;01;18;Maanantai;3;8;11;6;3;9
109;08.01.2018;2018;01;19;Maanantai;1;4;5;8;10;18
109;08.01.2018;2018;01;20;Maanantai;1;4;5;3;4;7
109;08.01.2018;2018;01;21;Maanantai;1;6;7;1;0;1
109;08.01.2018;2018;01;22;Maanantai;1;1;2;1;0;1
109;08.01.2018;2018;01;23;Maanantai;0;0;0;1;0;1
109;09.01.2018;2018;01;00;Tiistai;0;0;0;1;0;1
109;09.01.2018;2018;01;01;Tiistai;0;0;0;0;0;0
109;09.01.2018;2018;01;02;Tiistai;0;0;0;1;0;1
109;09.01.2018;2018;01;03;Tiistai;0;0;0;0;0;0
109;09.01.2018;2018;01;04;Tiistai;0;0;0;1;0;1
109;09.01.2018;2018;01;05;Tiistai;1;2;3;0;0;0
109;09.01.2018;2018;01;06;Tiistai;12;8;20;0;1;1
109;09.01.2018;2018;01;07;Tiistai;32;18;50;3;4;7
109;09.01.2018;2018;01;08;Tiistai;19;11;30;2;4;6
109;09.01.2018;2018;01;09;Tiistai;16;4;20;6;1;7
109;09.01.2018;2018;01;10;Tiistai;4;0;4;3;4;7
109;09.01.2018;2018;01;11;Tiistai;4;9;13;3;6;9
109;09.01.2018;2018;01;12;Tiistai;9;3;12;4;2;6
109;09.01.2018;2018;01;13;Tiistai;5;4;9;6;5;11
109;09.01.2018;2018;01;14;Tiistai;6;7;13;1;2;3
109;09.01.2018;2018;01;15;Tiistai;11;19;30;6;4;10
109;09.01.2018;2018;01;16;Tiistai;23;35;58;5;7;12
109;09.01.2018;2018;01;17;Tiistai;7;18;25;6;5;11
109;09.01.2018;2018;01;18;Tiistai;8;9;17;6;1;7
109;09.01.2018;2018;01;19;Tiistai;2;3;5;4;5;9
109;09.01.2018;2018;01;20;Tiistai;1;9;10;4;7;11
109;09.01.2018;2018;01;21;Tiistai;3;5;8;3;2;5
109;09.01.2018;2018;01;22;Tiistai;1;3;4;0;1;1
109;09.01.2018;2018;01;23;Tiistai;1;0;1;1;2;3
109;10.01.2018;2018;01;00;Keskiviikko;0;0;0;0;0;0
109;10.01.2018;2018;01;01;Keskiviikko;0;0;0;0;2;2
109;10.01.2018;2018;01;02;Keskiviikko;0;0;0;0;0;0
109;10.01.2018;2018;01;03;Keskiviikko;0;0;0;0;0;0
109;10.01.2018;2018;01;04;Keskiviikko;0;0;0;0;0;0
109;10.01.2018;2018;01;05;Keskiviikko;1;1;2;1;1;2
109;10.01.2018;2018;01;06;Keskiviikko;14;14;28;4;0;4
109;10.01.2018;2018;01;07;Keskiviikko;28;17;45;2;1;3
109;10.01.2018;2018;01;08;Keskiviikko;24;8;32;3;0;3
109;10.01.2018;2018;01;09;Keskiviikko;13;9;22;0;1;1
109;10.01.2018;2018;01;10;Keskiviikko;8;3;11;7;3;10
109;10.01.2018;2018;01;11;Keskiviikko;6;5;11;5;1;6
109;10.01.2018;2018;01;12;Keskiviikko;5;6;11;4;3;7
109;10.01.2018;2018;01;13;Keskiviikko;9;6;15;0;1;1
109;10.01.2018;2018;01;14;Keskiviikko;8;6;14;5;2;7
109;10.01.2018;2018;01;15;Keskiviikko;9;16;25;2;1;3
109;10.01.2018;2018;01;16;Keskiviikko;20;34;54;6;2;8
109;10.01.2018;2018;01;17;Keskiviikko;11;16;27;8;2;10
109;10.01.2018;2018;01;18;Keskiviikko;2;7;9;10;6;16
109;10.01.2018;2018;01;19;Keskiviikko;4;5;9;6;2;8
109;10.01.2018;2018;01;20;Keskiviikko;3;4;7;4;3;7
109;10.01.2018;2018;01;21;Keskiviikko;3;10;13;3;1;4
109;10.01.2018;2018;01;22;Keskiviikko;1;2;3;1;1;2
109;10.01.2018;2018;01;23;Keskiviikko;0;0;0;0;1;1
109;11.01.2018;2018;01;00;Torstai;0;0;0;0;1;1
109;11.01.2018;2018;01;01;Torstai;1;0;1;1;0;1
109;11.01.2018;2018;01;02;Torstai;0;0;0;0;0;0
109;11.01.2018;2018;01;03;Torstai;0;0;0;0;0;0
109;11.01.2018;2018;01;04;Torstai;0;0;0;1;0;1
109;11.01.2018;2018;01;05;Torstai;0;1;1;0;0;0
109;11.01.2018;2018;01;06;Torstai;16;10;26;3;0;3
109;11.01.2018;2018;01;07;Torstai;39;20;59;5;1;6
109;11.01.2018;2018;01;08;Torstai;26;9;35;5;5;10
109;11.01.2018;2018;01;09;Torstai;10;5;15;6;5;11
109;11.01.2018;2018;01;10;Torstai;5;6;11;4;3;7
109;11.01.2018;2018;01;11;Torstai;5;0;5;4;5;9
109;11.01.2018;2018;01;12;Torstai;8;3;11;2;3;5
109;11.01.2018;2018;01;13;Torstai;2;3;5;4;3;7
109;11.01.2018;2018;01;14;Torstai;10;7;17;6;4;10
109;11.01.2018;2018;01;15;Torstai;13;19;32;4;2;6
109;11.01.2018;2018;01;16;Torstai;18;37;55;4;2;6
109;11.01.2018;2018;01;17;Torstai;10;16;26;6;1;7
109;11.01.2018;2018;01;18;Torstai;2;13;15;6;3;9
109;11.01.2018;2018;01;19;Torstai;1;11;12;7;5;12
109;11.01.2018;2018;01;20;Torstai;2;1;3;4;2;6
109;11.01.2018;2018;01;21;Torstai;1;3;4;1;1;2
109;11.01.2018;2018;01;22;Torstai;3;3;6;3;0;3
109;11.01.2018;2018;01;23;Torstai;0;0;0;3;1;4
109;12.01.2018;2018;01;00;Perjantai;0;1;1;0;1;1
109;12.01.2018;2018;01;01;Perjantai;0;0;0;0;1;1
109;12.01.2018;2018;01;02;Perjantai;1;0;1;1;0;1
109;12.01.2018;2018;01;03;Perjantai;0;0;0;0;0;0
109;12.01.2018;2018;01;04;Perjantai;1;1;2;2;0;2
109;12.01.2018;2018;01;05;Perjantai;0;2;2;2;1;3
109;12.01.2018;2018;01;06;Perjantai;11;9;20;1;0;1
109;12.01.2018;2018;01;07;Perjantai;25;23;48;1;3;4
109;12.01.2018;2018;01;08;Perjantai;15;13;28;2;0;2
109;12.01.2018;2018;01;09;Perjantai;11;7;18;2;0;2
109;12.01.2018;2018;01;10;Perjantai;1;3;4;3;2;5
109;12.01.2018;2018;01;11;Perjantai;7;5;12;5;3;8
109;12.01.2018;2018;01;12;Perjantai;4;5;9;2;2;4
109;12.01.2018;2018;01;13;Perjantai;7;9;16;4;0;4
109;12.01.2018;2018;01;14;Perjantai;9;8;17;3;0;3
109;12.01.2018;2018;01;15;Perjantai;17;28;45;5;1;6
109;12.01.2018;2018;01;16;Perjantai;17;21;38;2;0;2
109;12.01.2018;2018;01;17;Perjantai;10;8;18;4;1;5
109;12.01.2018;2018;01;18;Perjantai;3;8;11;1;4;5
109;12.01.2018;2018;01;19;Perjantai;1;2;3;2;2;4
109;12.01.2018;2018;01;20;Perjantai;3;2;5;4;1;5
109;12.01.2018;2018;01;21;Perjantai;2;1;3;3;1;4
109;12.01.2018;2018;01;22;Perjantai;2;1;3;0;0;0
109;12.01.2018;2018;01;23;Perjantai;1;0;1;1;0;1
109;13.01.2018;2018;01;00;Lauantai;0;0;0;0;0;0
109;13.01.2018;2018;01;01;Lauantai;0;0;0;1;0;1
109;13.01.2018;2018;01;02;Lauantai;0;0;0;1;0;1
109;13.01.2018;2018;01;03;Lauantai;1;1;2;0;0;0
109;13.01.2018;2018;01;04;Lauantai;1;0;1;1;0;1
109;13.01.2018;2018;01;05;Lauantai;0;0;0;1;0;1
109;13.01.2018;2018;01;06;Lauantai;4;0;4;0;0;0
109;13.01.2018;2018;01;07;Lauantai;1;2;3;0;1;1
109;13.01.2018;2018;01;08;Lauantai;0;3;3;1;2;3
109;13.01.2018;2018;01;09;Lauantai;5;2;7;5;1;6
109;13.01.2018;2018;01;10;Lauantai;2;2;4;4;0;4
109;13.01.2018;2018;01;11;Lauantai;7;0;7;3;2;5
109;13.01.2018;2018;01;12;Lauantai;6;4;10;2;0;2
109;13.01.2018;2018;01;13;Lauantai;7;7;14;1;2;3
109;13.01.2018;2018;01;14;Lauantai;7;1;8;4;3;7
109;13.01.2018;2018;01;15;Lauantai;4;6;10;5;5;10
109;13.01.2018;2018;01;16;Lauantai;3;1;4;6;2;8
109;13.01.2018;2018;01;17;Lauantai;3;0;3;2;3;5
109;13.01.2018;2018;01;18;Lauantai;3;3;6;5;2;7
109;13.01.2018;2018;01;19;Lauantai;1;1;2;3;0;3
109;13.01.2018;2018;01;20;Lauantai;3;0;3;4;2;6
109;13.01.2018;2018;01;21;Lauantai;1;0;1;1;0;1
109;13.01.2018;2018;01;22;Lauantai;0;1;1;3;1;4
109;13.01.2018;2018;01;23;Lauantai;2;0;2;1;0;1
109;14.01.2018;2018;01;00;Sunnuntai;0;0;0;1;0;1
109;14.01.2018;2018;01;01;Sunnuntai;0;0;0;0;0;0
109;14.01.2018;2018;01;02;Sunnuntai;0;0;0;0;0;0
109;14.01.2018;2018;01;03;Sunnuntai;0;0;0;0;0;0
109;14.01.2018;2018;01;04;Sunnuntai;0;1;1;0;0;0
109;14.01.2018;2018;01;05;Sunnuntai;1;0;1;0;0;0
109;14.01.2018;2018;01;06;Sunnuntai;6;0;6;1;0;1
109;14.01.2018;2018;01;07;Sunnuntai;0;5;5;2;0;2
109;14.01.2018;2018;01;08;Sunnuntai;0;2;2;0;0;0
109;14.01.2018;2018;01;09;Sunnuntai;3;0;3;3;3;6
109;14.01.2018;2018;01;10;Sunnuntai;1;2;3;5;5;10
109;14.01.2018;2018;01;11;Sunnuntai;1;2;3;3;4;7
109;14.01.2018;2018;01;12;Sunnuntai;3;4;7;6;2;8
109;14.01.2018;2018;01;13;Sunnuntai;3;0;3;6;4;10
109;14.01.2018;2018;01;14;Sunnuntai;5;0;5;9;1;10
109;14.01.2018;2018;01;15;Sunnuntai;4;3;7;2;6;8
109;14.01.2018;2018;01;16;Sunnuntai;5;2;7;5;3;8
109;14.01.2018;2018;01;17;Sunnuntai;2;4;6;4;2;6
109;14.01.2018;2018;01;18;Sunnuntai;1;4;5;7;3;10
109;14.01.2018;2018;01;19;Sunnuntai;4;1;5;7;2;9
109;14.01.2018;2018;01;20;Sunnuntai;1;3;4;6;4;10
109;14.01.2018;2018;01;21;Sunnuntai;1;3;4;6;0;6
109;14.01.2018;2018;01;22;Sunnuntai;0;0;0;1;0;1
109;14.01.2018;2018;01;23;Sunnuntai;0;0;0;0;0;0
109;15.01.2018;2018;01;00;Maanantai;2;3;5;0;0;0
109;15.01.2018;2018;01;01;Maanantai;0;0;0;1;0;1
109;15.01.2018;2018;01;02;Maanantai;0;0;0;2;0;2
109;15.01.2018;2018;01;03;Maanantai;0;2;2;0;0;0
109;15.01.2018;2018;01;04;Maanantai;1;0;1;1;0;1
109;15.01.2018;2018;01;05;Maanantai;2;4;6;0;0;0
109;15.01.2018;2018;01;06;Maanantai;17;8;25;2;2;4
109;15.01.2018;2018;01;07;Maanantai;36;23;59;1;2;3
109;15.01.2018;2018;01;08;Maanantai;19;11;30;1;1;2
109;15.01.2018;2018;01;09;Maanantai;18;4;22;3;4;7
109;15.01.2018;2018;01;10;Maanantai;6;2;8;2;2;4
109;15.01.2018;2018;01;11;Maanantai;11;2;13;0;4;4
109;15.01.2018;2018;01;12;Maanantai;4;3;7;0;3;3
109;15.01.2018;2018;01;13;Maanantai;3;7;10;3;3;6
109;15.01.2018;2018;01;14;Maanantai;12;9;21;2;4;6
109;15.01.2018;2018;01;15;Maanantai;14;29;43;7;2;9
109;15.01.2018;2018;01;16;Maanantai;16;45;61;6;4;10
109;15.01.2018;2018;01;17;Maanantai;12;18;30;6;3;9
109;15.01.2018;2018;01;18;Maanantai;3;9;12;2;3;5
109;15.01.2018;2018;01;19;Maanantai;2;5;7;6;5;11
109;15.01.2018;2018;01;20;Maanantai;0;6;6;0;1;1
109;15.01.2018;2018;01;21;Maanantai;1;7;8;1;0;1
109;15.01.2018;2018;01;22;Maanantai;2;1;3;2;2;4
109;15.01.2018;2018;01;23;Maanantai;1;1;2;1;1;2
109;16.01.2018;2018;01;00;Tiistai;0;0;0;0;0;0
109;16.01.2018;2018;01;01;Tiistai;0;0;0;1;0;1
109;16.01.2018;2018;01;02;Tiistai;0;0;0;0;0;0
109;16.01.2018;2018;01;03;Tiistai;0;0;0;0;0;0
109;16.01.2018;2018;01;04;Tiistai;0;0;0;1;0;1
109;16.01.2018;2018;01;05;Tiistai;0;1;1;1;1;2
109;16.01.2018;2018;01;06;Tiistai;11;10;21;3;1;4
109;16.01.2018;2018;01;07;Tiistai;26;23;49;3;3;6
109;16.01.2018;2018;01;08;Tiistai;19;5;24;0;4;4
109;16.01.2018;2018;01;09;Tiistai;8;3;11;1;2;3
109;16.01.2018;2018;01;10;Tiistai;9;0;9;5;6;11
109;16.01.2018;2018;01;11;Tiistai;12;3;15;4;5;9
109;16.01.2018;2018;01;12;Tiistai;1;3;4;7;4;11
109;16.01.2018;2018;01;13;Tiistai;7;5;12;5;4;9
109;16.01.2018;2018;01;14;Tiistai;3;6;9;2;0;2
109;16.01.2018;2018;01;15;Tiistai;10;14;24;4;2;6
109;16.01.2018;2018;01;16;Tiistai;18;21;39;4;2;6
109;16.01.2018;2018;01;17;Tiistai;11;10;21;12;9;21
109;16.01.2018;2018;01;18;Tiistai;1;6;7;1;5;6
109;16.01.2018;2018;01;19;Tiistai;2;4;6;5;3;8
109;16.01.2018;2018;01;20;Tiistai;2;6;8;4;5;9
109;16.01.2018;2018;01;21;Tiistai;1;3;4;1;0;1
109;16.01.2018;2018;01;22;Tiistai;2;4;6;1;3;4
109;16.01.2018;2018;01;23;Tiistai;2;0;2;0;1;1
109;17.01.2018;2018;01;00;Keskiviikko;0;0;0;0;0;0
109;17.01.2018;2018;01;01;Keskiviikko;0;0;0;0;0;0
109;17.01.2018;2018;01;02;Keskiviikko;0;0;0;0;0;0
109;17.01.2018;2018;01;03;Keskiviikko;0;0;0;0;0;0
109;17.01.2018;2018;01;04;Keskiviikko;0;0;0;1;0;1
109;17.01.2018;2018;01;05;Keskiviikko;1;1;2;2;0;2
109;17.01.2018;2018;01;06;Keskiviikko;13;9;22;3;1;4
109;17.01.2018;2018;01;07;Keskiviikko;30;19;49;2;3;5
109;17.01.2018;2018;01;08;Keskiviikko;20;7;27;1;4;5
109;17.01.2018;2018;01;09;Keskiviikko;9;3;12;1;2;3
109;17.01.2018;2018;01;10;Keskiviikko;4;3;7;6;4;10
109;17.01.2018;2018;01;11;Keskiviikko;6;2;8;2;5;7
109;17.01.2018;2018;01;12;Keskiviikko;3;3;6;2;3;5
109;17.01.2018;2018;01;13;Keskiviikko;7;2;9;4;3;7
109;17.01.2018;2018;01;14;Keskiviikko;7;7;14;2;2;4
109;17.01.2018;2018;01;15;Keskiviikko;9;19;28;6;2;8
109;17.01.2018;2018;01;16;Keskiviikko;14;32;46;5;4;9
109;17.01.2018;2018;01;17;Keskiviikko;9;14;23;7;0;7
109;17.01.2018;2018;01;18;Keskiviikko;3;5;8;7;5;12
109;17.01.2018;2018;01;19;Keskiviikko;2;6;8;5;4;9
109;17.01.2018;2018;01;20;Keskiviikko;4;5;9;2;3;5
109;17.01.2018;2018;01;21;Keskiviikko;3;7;10;4;0;4
109;17.01.2018;2018;01;22;Keskiviikko;1;1;2;2;2;4
109;17.01.2018;2018;01;23;Keskiviikko;0;1;1;0;2;2
109;18.01.2018;2018;01;00;Torstai;0;0;0;1;1;2
109;18.01.2018;2018;01;01;Torstai;0;0;0;1;0;1
109;18.01.2018;2018;01;02;Torstai;0;0;0;0;0;0
109;18.01.2018;2018;01;03;Torstai;0;0;0;0;0;0
109;18.01.2018;2018;01;04;Torstai;0;0;0;1;0;1
109;18.01.2018;2018;01;05;Torstai;0;2;2;0;0;0
109;18.01.2018;2018;01;06;Torstai;11;6;17;3;2;5
109;18.01.2018;2018;01;07;Torstai;27;22;49;6;1;7
109;18.01.2018;2018;01;08;Torstai;17;9;26;10;3;13
109;18.01.2018;2018;01;09;Torstai;17;3;20;11;3;14
109;18.01.2018;2018;01;10;Torstai;3;5;8;7;0;7
109;18.01.2018;2018;01;11;Torstai;8;3;11;9;1;10
109;18.01.2018;2018;01;12;Torstai;12;3;15;5;0;5
109;18.01.2018;2018;01;13;Torstai;9;3;12;7;0;7
109;18.01.2018;2018;01;14;Torstai;5;1;6;10;0;10
109;18.01.2018;2018;01;15;Torstai;14;8;22;6;0;6
109;18.01.2018;2018;01;16;Torstai;29;21;50;6;1;7
109;18.01.2018;2018;01;17;Torstai;19;10;29;7;0;7
109;18.01.2018;2018;01;18;Torstai;5;2;7;9;0;9
109;18.01.2018;2018;01;19;Torstai;6;3;9;12;0;12
109;18.01.2018;2018;01;20;Torstai;5;3;8;6;0;6
109;18.01.2018;2018;01;21;Torstai;3;2;5;2;0;2
109;18.01.2018;2018;01;22;Torstai;3;0;3;3;0;3
109;18.01.2018;2018;01;23;Torstai;2;0;2;4;0;4
109;19.01.2018;2018;01;00;Perjantai;1;0;1;1;0;1
109;19.01.2018;2018;01;01;Perjantai;1;1;2;1;0;1
109;19.01.2018;2018;01;02;Perjantai;0;0;0;1;0;1
109;19.01.2018;2018;01;03;Perjantai;0;0;0;0;0;0
109;19.01.2018;2018;01;04;Perjantai;0;0;0;2;0;2
109;19.01.2018;2018;01;05;Perjantai;4;3;7;3;0;3
109;19.01.2018;2018;01;06;Perjantai;11;5;16;1;0;1
109;19.01.2018;2018;01;07;Perjantai;30;17;47;4;0;4
109;19.01.2018;2018;01;08;Perjantai;18;5;23;2;0;2
109;19.01.2018;2018;01;09;Perjantai;8;1;9;2;0;2
109;19.01.2018;2018;01;10;Perjantai;5;0;5;5;0;5
109;19.01.2018;2018;01;11;Perjantai;7;2;9;8;0;8
109;19.01.2018;2018;01;12;Perjantai;5;4;9;4;0;4
109;19.01.2018;2018;01;13;Perjantai;6;4;10;4;0;4
109;19.01.2018;2018;01;14;Perjantai;8;5;13;3;0;3
109;19.01.2018;2018;01;15;Perjantai;16;11;27;6;0;6
109;19.01.2018;2018;01;16;Perjantai;22;17;39;2;0;2
109;19.01.2018;2018;01;17;Perjantai;13;6;19;5;0;5
109;19.01.2018;2018;01;18;Perjantai;4;0;4;5;0;5
109;19.01.2018;2018;01;19;Perjantai;4;4;8;4;0;4
109;19.01.2018;2018;01;20;Perjantai;6;5;11;5;0;5
109;19.01.2018;2018;01;21;Perjantai;4;3;7;4;0;4
109;19.01.2018;2018;01;22;Perjantai;3;3;6;0;0;0
109;19.01.2018;2018;01;23;Perjantai;1;0;1;1;0;1
109;20.01.2018;2018;01;00;Lauantai;0;0;0;0;0;0
109;20.01.2018;2018;01;01;Lauantai;2;0;2;1;0;1
109;20.01.2018;2018;01;02;Lauantai;0;0;0;1;0;1
109;20.01.2018;2018;01;03;Lauantai;0;0;0;0;0;0
109;20.01.2018;2018;01;04;Lauantai;0;0;0;1;0;1
109;20.01.2018;2018;01;05;Lauantai;0;0;0;1;0;1
109;20.01.2018;2018;01;06;Lauantai;1;1;2;0;0;0
109;20.01.2018;2018;01;07;Lauantai;1;2;3;1;0;1
109;20.01.2018;2018;01;08;Lauantai;3;0;3;3;0;3
109;20.01.2018;2018;01;09;Lauantai;2;0;2;6;0;6
109;20.01.2018;2018;01;10;Lauantai;3;0;3;4;0;4
109;20.01.2018;2018;01;11;Lauantai;6;2;8;5;1;6
109;20.01.2018;2018;01;12;Lauantai;8;6;14;2;0;2
109;20.01.2018;2018;01;13;Lauantai;2;0;2;3;0;3
109;20.01.2018;2018;01;14;Lauantai;6;5;11;7;0;7
109;20.01.2018;2018;01;15;Lauantai;4;2;6;10;0;10
109;20.01.2018;2018;01;16;Lauantai;3;0;3;8;0;8
109;20.01.2018;2018;01;17;Lauantai;2;0;2;5;0;5
109;20.01.2018;2018;01;18;Lauantai;3;0;3;7;0;7
109;20.01.2018;2018;01;19;Lauantai;2;0;2;3;0;3
109;20.01.2018;2018;01;20;Lauantai;2;0;2;6;0;6
109;20.01.2018;2018;01;21;Lauantai;1;1;2;1;0;1
109;20.01.2018;2018;01;22;Lauantai;2;2;4;4;0;4
109;20.01.2018;2018;01;23;Lauantai;1;1;2;1;0;1
109;21.01.2018;2018;01;00;Sunnuntai;1;0;1;1;0;1
109;21.01.2018;2018;01;01;Sunnuntai;1;0;1;0;0;0
109;21.01.2018;2018;01;02;Sunnuntai;0;0;0;0;0;0
109;21.01.2018;2018;01;03;Sunnuntai;0;0;0;0;0;0
109;21.01.2018;2018;01;04;Sunnuntai;1;0;1;0;0;0
109;21.01.2018;2018;01;05;Sunnuntai;0;0;0;0;0;0
109;21.01.2018;2018;01;06;Sunnuntai;2;1;3;1;0;1
109;21.01.2018;2018;01;07;Sunnuntai;1;0;1;2;0;2
109;21.01.2018;2018;01;08;Sunnuntai;0;0;0;0;0;0
109;21.01.2018;2018;01;09;Sunnuntai;2;1;3;6;0;6
109;21.01.2018;2018;01;10;Sunnuntai;3;2;5;10;0;10
109;21.01.2018;2018;01;11;Sunnuntai;2;0;2;7;0;7
109;21.01.2018;2018;01;12;Sunnuntai;9;7;16;8;0;8
109;21.01.2018;2018;01;13;Sunnuntai;3;1;4;10;0;10
109;21.01.2018;2018;01;14;Sunnuntai;7;4;11;10;0;10
109;21.01.2018;2018;01;15;Sunnuntai;3;3;6;8;0;8
109;21.01.2018;2018;01;16;Sunnuntai;4;1;5;8;0;8
109;21.01.2018;2018;01;17;Sunnuntai;4;2;6;6;0;6
109;21.01.2018;2018;01;18;Sunnuntai;3;1;4;10;0;10
109;21.01.2018;2018;01;19;Sunnuntai;3;1;4;9;0;9
109;21.01.2018;2018;01;20;Sunnuntai;3;1;4;10;0;10
109;21.01.2018;2018;01;21;Sunnuntai;2;1;3;6;0;6
109;21.01.2018;2018;01;22;Sunnuntai;0;0;0;1;0;1
109;21.01.2018;2018;01;23;Sunnuntai;1;0;1;0;0;0
109;22.01.2018;2018;01;00;Maanantai;0;0;0;0;0;0
109;22.01.2018;2018;01;01;Maanantai;1;1;2;1;0;1
109;22.01.2018;2018;01;02;Maanantai;0;0;0;2;0;2
109;22.01.2018;2018;01;03;Maanantai;0;0;0;0;0;0
109;22.01.2018;2018;01;04;Maanantai;1;0;1;1;0;1
109;22.01.2018;2018;01;05;Maanantai;2;2;4;0;0;0
109;22.01.2018;2018;01;06;Maanantai;6;4;10;4;0;4
109;22.01.2018;2018;01;07;Maanantai;23;23;46;3;0;3
109;22.01.2018;2018;01;08;Maanantai;14;14;28;2;0;2
109;22.01.2018;2018;01;09;Maanantai;11;9;20;7;0;7
109;22.01.2018;2018;01;10;Maanantai;6;3;9;4;0;4
109;22.01.2018;2018;01;11;Maanantai;3;1;4;4;0;4
109;22.01.2018;2018;01;12;Maanantai;2;2;4;3;0;3
109;22.01.2018;2018;01;13;Maanantai;3;2;5;6;0;6
109;22.01.2018;2018;01;14;Maanantai;7;6;13;6;0;6
109;22.01.2018;2018;01;15;Maanantai;15;12;27;9;0;9
109;22.01.2018;2018;01;16;Maanantai;24;23;47;10;0;10
109;22.01.2018;2018;01;17;Maanantai;9;7;16;9;0;9
109;22.01.2018;2018;01;18;Maanantai;6;4;10;5;0;5
109;22.01.2018;2018;01;19;Maanantai;3;2;5;11;0;11
109;22.01.2018;2018;01;20;Maanantai;6;4;10;1;0;1
109;22.01.2018;2018;01;21;Maanantai;6;5;11;1;0;1
109;22.01.2018;2018;01;22;Maanantai;2;1;3;4;0;4
109;22.01.2018;2018;01;23;Maanantai;1;0;1;2;0;2
109;23.01.2018;2018;01;00;Tiistai;0;0;0;0;0;0
109;23.01.2018;2018;01;01;Tiistai;0;0;0;1;0;1
109;23.01.2018;2018;01;02;Tiistai;0;0;0;0;0;0
109;23.01.2018;2018;01;03;Tiistai;0;0;0;0;0;0
109;23.01.2018;2018;01;04;Tiistai;0;0;0;1;0;1
109;23.01.2018;2018;01;05;Tiistai;3;1;4;2;0;2
109;23.01.2018;2018;01;06;Tiistai;7;6;13;4;0;4
109;23.01.2018;2018;01;07;Tiistai;25;21;46;6;0;6
109;23.01.2018;2018;01;08;Tiistai;11;11;22;4;0;4
109;23.01.2018;2018;01;09;Tiistai;6;4;10;3;0;3
109;23.01.2018;2018;01;10;Tiistai;3;1;4;11;0;11
109;23.01.2018;2018;01;11;Tiistai;4;4;8;9;0;9
109;23.01.2018;2018;01;12;Tiistai;3;2;5;11;0;11
109;23.01.2018;2018;01;13;Tiistai;4;2;6;9;0;9
109;23.01.2018;2018;01;14;Tiistai;6;4;10;2;0;2
109;23.01.2018;2018;01;15;Tiistai;10;9;19;6;0;6
109;23.01.2018;2018;01;16;Tiistai;21;20;41;6;0;6
109;23.01.2018;2018;01;17;Tiistai;10;9;19;21;0;21
109;23.01.2018;2018;01;18;Tiistai;6;2;8;6;0;6
109;23.01.2018;2018;01;19;Tiistai;2;0;2;8;0;8
109;23.01.2018;2018;01;20;Tiistai;3;2;5;9;0;9
109;23.01.2018;2018;01;21;Tiistai;4;2;6;1;0;1
109;23.01.2018;2018;01;22;Tiistai;2;1;3;4;0;4
109;23.01.2018;2018;01;23;Tiistai;1;0;1;1;0;1
109;24.01.2018;2018;01;00;Keskiviikko;0;0;0;0;0;0
109;24.01.2018;2018;01;01;Keskiviikko;0;0;0;0;0;0
109;24.01.2018;2018;01;02;Keskiviikko;0;0;0;0;0;0
109;24.01.2018;2018;01;03;Keskiviikko;0;0;0;0;0;0
109;24.01.2018;2018;01;04;Keskiviikko;0;0;0;1;0;1
109;24.01.2018;2018;01;05;Keskiviikko;2;1;3;2;0;2
109;24.01.2018;2018;01;06;Keskiviikko;10;8;18;4;0;4
109;24.01.2018;2018;01;07;Keskiviikko;25;21;46;5;0;5
109;24.01.2018;2018;01;08;Keskiviikko;22;19;41;5;0;5
109;24.01.2018;2018;01;09;Keskiviikko;5;2;7;3;0;3
109;24.01.2018;2018;01;10;Keskiviikko;5;4;9;10;0;10
109;24.01.2018;2018;01;11;Keskiviikko;6;4;10;7;0;7
109;24.01.2018;2018;01;12;Keskiviikko;4;1;5;5;0;5
109;24.01.2018;2018;01;13;Keskiviikko;6;3;9;7;0;7
109;24.01.2018;2018;01;14;Keskiviikko;5;3;8;4;0;4
109;24.01.2018;2018;01;15;Keskiviikko;9;8;17;8;0;8
109;24.01.2018;2018;01;16;Keskiviikko;30;26;56;9;0;9
109;24.01.2018;2018;01;17;Keskiviikko;11;9;20;7;0;7
109;24.01.2018;2018;01;18;Keskiviikko;10;10;20;12;0;12
109;24.01.2018;2018;01;19;Keskiviikko;3;2;5;9;0;9
109;24.01.2018;2018;01;20;Keskiviikko;6;4;10;5;0;5
109;24.01.2018;2018;01;21;Keskiviikko;3;0;3;4;0;4
109;24.01.2018;2018;01;22;Keskiviikko;2;1;3;4;0;4
109;24.01.2018;2018;01;23;Keskiviikko;1;0;1;2;0;2
109;25.01.2018;2018;01;00;Torstai;0;0;0;0;0;0
109;25.01.2018;2018;01;01;Torstai;1;0;1;0;0;0
109;25.01.2018;2018;01;02;Torstai;0;0;0;0;0;0
109;25.01.2018;2018;01;03;Torstai;0;0;0;0;0;0
109;25.01.2018;2018;01;04;Torstai;0;0;0;0;0;0
109;25.01.2018;2018;01;05;Torstai;2;1;3;0;0;0
109;25.01.2018;2018;01;06;Torstai;5;4;9;0;0;0
109;25.01.2018;2018;01;07;Torstai;17;15;32;0;0;0
109;25.01.2018;2018;01;08;Torstai;17;7;24;3;2;5
109;25.01.2018;2018;01;09;Torstai;6;3;9;3;5;8
109;25.01.2018;2018;01;10;Torstai;5;3;8;2;3;5
109;25.01.2018;2018;01;11;Torstai;2;0;2;8;1;9
109;25.01.2018;2018;01;12;Torstai;5;1;6;4;4;8
109;25.01.2018;2018;01;13;Torstai;2;10;12;2;1;3
109;25.01.2018;2018;01;14;Torstai;5;3;8;8;3;11
109;25.01.2018;2018;01;15;Torstai;7;12;19;3;1;4
109;25.01.2018;2018;01;16;Torstai;12;23;35;3;5;8
109;25.01.2018;2018;01;17;Torstai;5;10;15;5;0;5
109;25.01.2018;2018;01;18;Torstai;4;5;9;3;2;5
109;25.01.2018;2018;01;19;Torstai;3;3;6;3;6;9
109;25.01.2018;2018;01;20;Torstai;2;2;4;3;2;5
109;25.01.2018;2018;01;21;Torstai;1;9;10;4;0;4
109;25.01.2018;2018;01;22;Torstai;1;0;1;0;3;3
109;25.01.2018;2018;01;23;Torstai;1;0;1;0;0;0
109;26.01.2018;2018;01;00;Perjantai;0;0;0;0;2;2
109;26.01.2018;2018;01;01;Perjantai;0;0;0;0;0;0
109;26.01.2018;2018;01;02;Perjantai;0;0;0;0;0;0
109;26.01.2018;2018;01;03;Perjantai;0;1;1;0;0;0
109;26.01.2018;2018;01;04;Perjantai;0;0;0;0;0;0
109;26.01.2018;2018;01;05;Perjantai;0;2;2;0;0;0
109;26.01.2018;2018;01;06;Perjantai;7;5;12;1;3;4
109;26.01.2018;2018;01;07;Perjantai;16;14;30;3;2;5
109;26.01.2018;2018;01;08;Perjantai;12;7;19;0;1;1
109;26.01.2018;2018;01;09;Perjantai;7;3;10;4;1;5
109;26.01.2018;2018;01;10;Perjantai;4;2;6;2;3;5
109;26.01.2018;2018;01;11;Perjantai;3;4;7;5;4;9
109;26.01.2018;2018;01;12;Perjantai;1;6;7;2;3;5
109;26.01.2018;2018;01;13;Perjantai;2;2;4;7;3;10
109;26.01.2018;2018;01;14;Perjantai;11;10;21;3;7;10
109;26.01.2018;2018;01;15;Perjantai;7;23;30;3;1;4
109;26.01.2018;2018;01;16;Perjantai;16;13;29;3;3;6
109;26.01.2018;2018;01;17;Perjantai;6;5;11;8;0;8
109;26.01.2018;2018;01;18;Perjantai;1;4;5;5;4;9
109;26.01.2018;2018;01;19;Perjantai;4;2;6;7;5;12
109;26.01.2018;2018;01;20;Perjantai;2;4;6;3;2;5
109;26.01.2018;2018;01;21;Perjantai;1;3;4;2;2;4
109;26.01.2018;2018;01;22;Perjantai;2;1;3;2;0;2
109;26.01.2018;2018;01;23;Perjantai;3;3;6;0;0;0
109;27.01.2018;2018;01;00;Lauantai;0;5;5;2;0;2
109;27.01.2018;2018;01;01;Lauantai;0;0;0;0;0;0
109;27.01.2018;2018;01;02;Lauantai;0;1;1;0;0;0
109;27.01.2018;2018;01;03;Lauantai;0;0;0;0;0;0
109;27.01.2018;2018;01;04;Lauantai;1;0;1;1;0;1
109;27.01.2018;2018;01;05;Lauantai;0;0;0;0;0;0
109;27.01.2018;2018;01;06;Lauantai;0;1;1;0;1;1
109;27.01.2018;2018;01;07;Lauantai;1;1;2;0;3;3
109;27.01.2018;2018;01;08;Lauantai;3;3;6;0;2;2
109;27.01.2018;2018;01;09;Lauantai;1;1;2;4;4;8
109;27.01.2018;2018;01;10;Lauantai;3;1;4;2;2;4
109;27.01.2018;2018;01;11;Lauantai;0;4;4;4;6;10
109;27.01.2018;2018;01;12;Lauantai;7;3;10;1;1;2
109;27.01.2018;2018;01;13;Lauantai;11;1;12;3;0;3
109;27.01.2018;2018;01;14;Lauantai;1;3;4;8;3;11
109;27.01.2018;2018;01;15;Lauantai;5;2;7;3;4;7
109;27.01.2018;2018;01;16;Lauantai;3;5;8;4;5;9
109;27.01.2018;2018;01;17;Lauantai;3;2;5;6;4;10
109;27.01.2018;2018;01;18;Lauantai;2;2;4;5;2;7
109;27.01.2018;2018;01;19;Lauantai;2;2;4;7;3;10
109;27.01.2018;2018;01;20;Lauantai;2;1;3;0;7;7
109;27.01.2018;2018;01;21;Lauantai;2;1;3;3;1;4
109;27.01.2018;2018;01;22;Lauantai;0;1;1;1;1;2
109;27.01.2018;2018;01;23;Lauantai;0;0;0;3;0;3
109;28.01.2018;2018;01;00;Sunnuntai;0;0;0;0;0;0
109;28.01.2018;2018;01;01;Sunnuntai;0;1;1;1;0;1
109;28.01.2018;2018;01;02;Sunnuntai;0;0;0;2;1;3
109;28.01.2018;2018;01;03;Sunnuntai;0;0;0;1;0;1
109;28.01.2018;2018;01;04;Sunnuntai;0;0;0;0;0;0
109;28.01.2018;2018;01;05;Sunnuntai;0;0;0;0;0;0
109;28.01.2018;2018;01;06;Sunnuntai;0;2;2;1;0;1
109;28.01.2018;2018;01;07;Sunnuntai;0;1;1;0;0;0
109;28.01.2018;2018;01;08;Sunnuntai;0;0;0;1;3;4
109;28.01.2018;2018;01;09;Sunnuntai;3;1;4;5;4;9
109;28.01.2018;2018;01;10;Sunnuntai;3;2;5;5;7;12
109;28.01.2018;2018;01;11;Sunnuntai;4;4;8;7;3;10
109;28.01.2018;2018;01;12;Sunnuntai;5;5;10;3;6;9
109;28.01.2018;2018;01;13;Sunnuntai;5;1;6;4;6;10
109;28.01.2018;2018;01;14;Sunnuntai;5;2;7;4;3;7
109;28.01.2018;2018;01;15;Sunnuntai;8;3;11;4;6;10
109;28.01.2018;2018;01;16;Sunnuntai;2;3;5;4;9;13
109;28.01.2018;2018;01;17;Sunnuntai;1;3;4;5;3;8
109;28.01.2018;2018;01;18;Sunnuntai;3;2;5;1;4;5
109;28.01.2018;2018;01;19;Sunnuntai;5;5;10;6;2;8
109;28.01.2018;2018;01;20;Sunnuntai;3;3;6;3;2;5
109;28.01.2018;2018;01;21;Sunnuntai;3;0;3;2;0;2
109;28.01.2018;2018;01;22;Sunnuntai;0;0;0;0;1;1
109;28.01.2018;2018;01;23;Sunnuntai;0;0;0;0;1;1
109;29.01.2018;2018;01;00;Maanantai;0;0;0;0;0;0
109;29.01.2018;2018;01;01;Maanantai;0;0;0;2;0;2
109;29.01.2018;2018;01;02;Maanantai;0;0;0;0;0;0
109;29.01.2018;2018;01;03;Maanantai;0;0;0;0;0;0
109;29.01.2018;2018;01;04;Maanantai;0;0;0;0;0;0
109;29.01.2018;2018;01;05;Maanantai;0;3;3;1;0;1
109;29.01.2018;2018;01;06;Maanantai;12;4;16;2;1;3
109;29.01.2018;2018;01;07;Maanantai;35;25;60;3;3;6
109;29.01.2018;2018;01;08;Maanantai;19;8;27;3;2;5
109;29.01.2018;2018;01;09;Maanantai;8;9;17;5;2;7
109;29.01.2018;2018;01;10;Maanantai;5;1;6;2;2;4
109;29.01.2018;2018;01;11;Maanantai;4;9;13;6;1;7
109;29.01.2018;2018;01;12;Maanantai;5;3;8;2;2;4
109;29.01.2018;2018;01;13;Maanantai;7;5;12;0;2;2
109;29.01.2018;2018;01;14;Maanantai;7;8;15;2;1;3
109;29.01.2018;2018;01;15;Maanantai;15;22;37;7;1;8
109;29.01.2018;2018;01;16;Maanantai;17;36;53;7;0;7
109;29.01.2018;2018;01;17;Maanantai;17;6;23;1;2;3
109;29.01.2018;2018;01;18;Maanantai;7;4;11;5;0;5
109;29.01.2018;2018;01;19;Maanantai;2;6;8;5;3;8
109;29.01.2018;2018;01;20;Maanantai;0;3;3;3;1;4
109;29.01.2018;2018;01;21;Maanantai;2;10;12;1;0;1
109;29.01.2018;2018;01;22;Maanantai;1;1;2;0;0;0
109;29.01.2018;2018;01;23;Maanantai;1;0;1;0;0;0
109;30.01.2018;2018;01;00;Tiistai;0;0;0;0;0;0
109;30.01.2018;2018;01;01;Tiistai;0;0;0;0;0;0
109;30.01.2018;2018;01;02;Tiistai;0;0;0;0;0;0
109;30.01.2018;2018;01;03;Tiistai;0;2;2;0;0;0
109;30.01.2018;2018;01;04;Tiistai;0;0;0;0;0;0
109;30.01.2018;2018;01;05;Tiistai;1;0;1;0;0;0
109;30.01.2018;2018;01;06;Tiistai;17;5;22;2;1;3
109;30.01.2018;2018;01;07;Tiistai;28;19;47;2;3;5
109;30.01.2018;2018;01;08;Tiistai;26;4;30;5;2;7
109;30.01.2018;2018;01;09;Tiistai;9;2;11;4;1;5
109;30.01.2018;2018;01;10;Tiistai;5;2;7;2;0;2
109;30.01.2018;2018;01;11;Tiistai;5;3;8;3;1;4
109;30.01.2018;2018;01;12;Tiistai;5;1;6;4;1;5
109;30.01.2018;2018;01;13;Tiistai;6;2;8;1;1;2
109;30.01.2018;2018;01;14;Tiistai;6;2;8;1;1;2
109;30.01.2018;2018;01;15;Tiistai;15;15;30;4;0;4
109;30.01.2018;2018;01;16;Tiistai;26;23;49;2;0;2
109;30.01.2018;2018;01;17;Tiistai;13;12;25;1;1;2
109;30.01.2018;2018;01;18;Tiistai;10;6;16;1;0;1
109;30.01.2018;2018;01;19;Tiistai;2;1;3;0;0;0
109;30.01.2018;2018;01;20;Tiistai;4;3;7;0;0;0
109;30.01.2018;2018;01;21;Tiistai;2;0;2;0;0;0
109;30.01.2018;2018;01;22;Tiistai;2;0;2;0;0;0
109;30.01.2018;2018;01;23;Tiistai;1;0;1;0;0;0
109;31.01.2018;2018;01;00;Keskiviikko;0;0;0;0;0;0
109;31.01.2018;2018;01;01;Keskiviikko;0;0;0;0;0;0
109;31.01.2018;2018;01;02;Keskiviikko;0;0;0;0;0;0
109;31.01.2018;2018;01;03;Keskiviikko;0;0;0;0;0;0
109;31.01.2018;2018;01;04;Keskiviikko;1;0;1;1;0;1
109;31.01.2018;2018;01;05;Keskiviikko;2;0;2;2;0;2
109;31.01.2018;2018;01;06;Keskiviikko;11;9;20;4;0;4
109;31.01.2018;2018;01;07;Keskiviikko;26;25;51;5;0;5
109;31.01.2018;2018;01;08;Keskiviikko;16;14;30;5;0;5
109;31.01.2018;2018;01;09;Keskiviikko;5;4;9;3;0;3
109;31.01.2018;2018;01;10;Keskiviikko;6;4;10;10;0;10
109;31.01.2018;2018;01;11;Keskiviikko;6;2;8;7;0;7
109;31.01.2018;2018;01;12;Keskiviikko;7;5;12;5;0;5
109;31.01.2018;2018;01;13;Keskiviikko;6;4;10;7;0;7
109;31.01.2018;2018;01;14;Keskiviikko;12;9;21;4;0;4
109;31.01.2018;2018;01;15;Keskiviikko;18;17;35;8;0;8
109;31.01.2018;2018;01;16;Keskiviikko;21;19;40;9;0;9
109;31.01.2018;2018;01;17;Keskiviikko;12;11;23;7;0;7
109;31.01.2018;2018;01;18;Keskiviikko;6;6;12;12;0;12
109;31.01.2018;2018;01;19;Keskiviikko;3;0;3;9;0;9
109;31.01.2018;2018;01;20;Keskiviikko;3;2;5;5;0;5
109;31.01.2018;2018;01;21;Keskiviikko;6;2;8;4;0;4
109;31.01.2018;2018;01;22;Keskiviikko;1;0;1;4;0;4
109;31.01.2018;2018;01;23;Keskiviikko;0;0;0;2;0;2
109;01.02.2018;2018;02;00;Torstai;0;0;0;0;0;0
109;01.02.2018;2018;02;01;Torstai;1;0;1;0;0;0
109;01.02.2018;2018;02;02;Torstai;1;0;1;0;0;0
109;01.02.2018;2018;02;03;Torstai;0;0;0;0;0;0
109;01.02.2018;2018;02;04;Torstai;1;1;2;0;0;0
109;01.02.2018;2018;02;05;Torstai;2;0;2;0;0;0
109;01.02.2018;2018;02;06;Torstai;8;8;16;0;0;0
109;01.02.2018;2018;02;07;Torstai;22;20;42;0;0;0
109;01.02.2018;2018;02;08;Torstai;19;16;35;5;0;5
109;01.02.2018;2018;02;09;Torstai;6;3;9;8;0;8
109;01.02.2018;2018;02;10;Torstai;5;2;7;5;0;5
109;01.02.2018;2018;02;11;Torstai;4;2;6;9;0;9
109;01.02.2018;2018;02;12;Torstai;4;2;6;8;0;8
109;01.02.2018;2018;02;13;Torstai;5;3;8;3;0;3
109;01.02.2018;2018;02;14;Torstai;4;3;7;11;0;11
109;01.02.2018;2018;02;15;Torstai;10;9;19;4;0;4
109;01.02.2018;2018;02;16;Torstai;22;18;40;8;0;8
109;01.02.2018;2018;02;17;Torstai;12;9;21;5;0;5
109;01.02.2018;2018;02;18;Torstai;6;5;11;5;0;5
109;01.02.2018;2018;02;19;Torstai;2;1;3;9;0;9
109;01.02.2018;2018;02;20;Torstai;2;1;3;5;0;5
109;01.02.2018;2018;02;21;Torstai;2;1;3;4;0;4
109;01.02.2018;2018;02;22;Torstai;3;1;4;3;0;3
109;01.02.2018;2018;02;23;Torstai;0;0;0;0;0;0
109;02.02.2018;2018;02;00;Perjantai;0;0;0;0;0;0
109;02.02.2018;2018;02;01;Perjantai;0;0;0;0;0;0
109;02.02.2018;2018;02;02;Perjantai;0;0;0;0;0;0
109;02.02.2018;2018;02;03;Perjantai;0;0;0;0;0;0
109;02.02.2018;2018;02;04;Perjantai;1;0;1;0;0;0
109;02.02.2018;2018;02;05;Perjantai;2;0;2;0;0;0
109;02.02.2018;2018;02;06;Perjantai;9;6;15;0;0;0
109;02.02.2018;2018;02;07;Perjantai;14;13;27;0;0;0
109;02.02.2018;2018;02;08;Perjantai;14;8;22;5;3;8
109;02.02.2018;2018;02;09;Perjantai;7;5;12;2;1;3
109;02.02.2018;2018;02;10;Perjantai;1;2;3;4;3;7
109;02.02.2018;2018;02;11;Perjantai;5;1;6;2;2;4
109;02.02.2018;2018;02;12;Perjantai;2;0;2;1;1;2
109;02.02.2018;2018;02;13;Perjantai;3;2;5;1;0;1
109;02.02.2018;2018;02;14;Perjantai;6;7;13;2;1;3
109;02.02.2018;2018;02;15;Perjantai;14;8;22;7;3;10
109;02.02.2018;2018;02;16;Perjantai;14;23;37;1;0;1
109;02.02.2018;2018;02;17;Perjantai;2;5;7;3;2;5
109;02.02.2018;2018;02;18;Perjantai;1;6;7;4;4;8
109;02.02.2018;2018;02;19;Perjantai;2;2;4;3;2;5
109;02.02.2018;2018;02;20;Perjantai;0;1;1;4;1;5
109;02.02.2018;2018;02;21;Perjantai;2;1;3;2;1;3
109;02.02.2018;2018;02;22;Perjantai;0;1;1;2;0;2
109;02.02.2018;2018;02;23;Perjantai;0;0;0;0;1;1
109;03.02.2018;2018;02;00;Lauantai;0;0;0;0;0;0
109;03.02.2018;2018;02;01;Lauantai;0;0;0;0;0;0
109;03.02.2018;2018;02;02;Lauantai;0;0;0;1;0;1
109;03.02.2018;2018;02;03;Lauantai;0;0;0;1;1;2
109;03.02.2018;2018;02;04;Lauantai;0;0;0;1;0;1
109;03.02.2018;2018;02;05;Lauantai;1;1;2;0;0;0
109;03.02.2018;2018;02;06;Lauantai;1;0;1;0;0;0
109;03.02.2018;2018;02;07;Lauantai;0;0;0;2;0;2
109;03.02.2018;2018;02;08;Lauantai;0;2;2;1;0;1
109;03.02.2018;2018;02;09;Lauantai;0;0;0;4;1;5
109;03.02.2018;2018;02;10;Lauantai;1;1;2;1;1;2
109;03.02.2018;2018;02;11;Lauantai;1;0;1;1;1;2
109;03.02.2018;2018;02;12;Lauantai;1;1;2;4;3;7
109;03.02.2018;2018;02;13;Lauantai;6;0;6;3;3;6
109;03.02.2018;2018;02;14;Lauantai;1;7;8;2;4;6
109;03.02.2018;2018;02;15;Lauantai;1;1;2;3;1;4
109;03.02.2018;2018;02;16;Lauantai;3;2;5;3;1;4
109;03.02.2018;2018;02;17;Lauantai;1;1;2;3;2;5
109;03.02.2018;2018;02;18;Lauantai;2;2;4;1;1;2
109;03.02.2018;2018;02;19;Lauantai;1;1;2;2;3;5
109;03.02.2018;2018;02;20;Lauantai;2;1;3;2;1;3
109;03.02.2018;2018;02;21;Lauantai;0;0;0;2;2;4
109;03.02.2018;2018;02;22;Lauantai;0;0;0;2;0;2
109;03.02.2018;2018;02;23;Lauantai;0;3;3;0;0;0
109;04.02.2018;2018;02;00;Sunnuntai;0;0;0;1;0;1
109;04.02.2018;2018;02;01;Sunnuntai;0;0;0;0;0;0
109;04.02.2018;2018;02;02;Sunnuntai;0;0;0;0;1;1
109;04.02.2018;2018;02;03;Sunnuntai;0;1;1;0;0;0
109;04.02.2018;2018;02;04;Sunnuntai;0;0;0;0;0;0
109;04.02.2018;2018;02;05;Sunnuntai;0;0;0;0;0;0
109;04.02.2018;2018;02;06;Sunnuntai;2;0;2;1;0;1
109;04.02.2018;2018;02;07;Sunnuntai;2;1;3;0;0;0
109;04.02.2018;2018;02;08;Sunnuntai;0;0;0;0;2;2
109;04.02.2018;2018;02;09;Sunnuntai;0;0;0;2;2;4
109;04.02.2018;2018;02;10;Sunnuntai;0;2;2;2;1;3
109;04.02.2018;2018;02;11;Sunnuntai;0;1;1;0;3;3
109;04.02.2018;2018;02;12;Sunnuntai;1;2;3;5;1;6
109;04.02.2018;2018;02;13;Sunnuntai;1;3;4;2;4;6
109;04.02.2018;2018;02;14;Sunnuntai;2;1;3;4;1;5
109;04.02.2018;2018;02;15;Sunnuntai;3;3;6;3;1;4
109;04.02.2018;2018;02;16;Sunnuntai;2;0;2;5;0;5
109;04.02.2018;2018;02;17;Sunnuntai;2;1;3;4;2;6
109;04.02.2018;2018;02;18;Sunnuntai;2;0;2;3;2;5
109;04.02.2018;2018;02;19;Sunnuntai;1;1;2;2;2;4
109;04.02.2018;2018;02;20;Sunnuntai;1;0;1;4;2;6
109;04.02.2018;2018;02;21;Sunnuntai;0;0;0;3;0;3
109;04.02.2018;2018;02;22;Sunnuntai;1;1;2;0;0;0
109;04.02.2018;2018;02;23;Sunnuntai;0;0;0;0;0;0
109;05.02.2018;2018;02;00;Maanantai;0;0;0;1;1;2
109;05.02.2018;2018;02;01;Maanantai;0;0;0;1;1;2
109;05.02.2018;2018;02;02;Maanantai;0;0;0;0;0;0
109;05.02.2018;2018;02;03;Maanantai;0;0;0;0;0;0
109;05.02.2018;2018;02;04;Maanantai;0;1;1;0;0;0
109;05.02.2018;2018;02;05;Maanantai;0;1;1;0;0;0
109;05.02.2018;2018;02;06;Maanantai;10;4;14;1;3;4
109;05.02.2018;2018;02;07;Maanantai;11;17;28;1;4;5
109;05.02.2018;2018;02;08;Maanantai;19;4;23;2;1;3
109;05.02.2018;2018;02;09;Maanantai;6;3;9;4;2;6
109;05.02.2018;2018;02;10;Maanantai;7;4;11;3;0;3
109;05.02.2018;2018;02;11;Maanantai;2;3;5;3;5;8
109;05.02.2018;2018;02;12;Maanantai;5;2;7;1;3;4
109;05.02.2018;2018;02;13;Maanantai;3;3;6;4;0;4
109;05.02.2018;2018;02;14;Maanantai;4;7;11;1;0;1
109;05.02.2018;2018;02;15;Maanantai;11;8;19;8;2;10
109;05.02.2018;2018;02;16;Maanantai;13;17;30;3;3;6
109;05.02.2018;2018;02;17;Maanantai;9;13;22;5;0;5
109;05.02.2018;2018;02;18;Maanantai;2;4;6;4;1;5
109;05.02.2018;2018;02;19;Maanantai;3;2;5;4;2;6
109;05.02.2018;2018;02;20;Maanantai;5;1;6;3;2;5
109;05.02.2018;2018;02;21;Maanantai;1;4;5;1;1;2
109;05.02.2018;2018;02;22;Maanantai;3;3;6;3;0;3
109;05.02.2018;2018;02;23;Maanantai;0;0;0;0;0;0
109;06.02.2018;2018;02;00;Tiistai;0;0;0;0;0;0
109;06.02.2018;2018;02;01;Tiistai;0;0;0;0;1;1
109;06.02.2018;2018;02;02;Tiistai;0;1;1;0;1;1
109;06.02.2018;2018;02;03;Tiistai;0;0;0;0;0;0
109;06.02.2018;2018;02;04;Tiistai;0;0;0;0;0;0
109;06.02.2018;2018;02;05;Tiistai;1;0;1;0;0;0
109;06.02.2018;2018;02;06;Tiistai;6;4;10;1;0;1
109;06.02.2018;2018;02;07;Tiistai;24;16;40;5;3;8
109;06.02.2018;2018;02;08;Tiistai;14;4;18;2;1;3
109;06.02.2018;2018;02;09;Tiistai;5;1;6;0;1;1
109;06.02.2018;2018;02;10;Tiistai;5;2;7;1;3;4
109;06.02.2018;2018;02;11;Tiistai;6;4;10;2;4;6
109;06.02.2018;2018;02;12;Tiistai;4;3;7;3;1;4
109;06.02.2018;2018;02;13;Tiistai;2;3;5;2;0;2
109;06.02.2018;2018;02;14;Tiistai;3;3;6;2;1;3
109;06.02.2018;2018;02;15;Tiistai;13;11;24;2;2;4
109;06.02.2018;2018;02;16;Tiistai;12;21;33;4;2;6
109;06.02.2018;2018;02;17;Tiistai;15;2;17;2;2;4
109;06.02.2018;2018;02;18;Tiistai;2;2;4;2;2;4
109;06.02.2018;2018;02;19;Tiistai;4;0;4;1;2;3
109;06.02.2018;2018;02;20;Tiistai;6;3;9;0;0;0
109;06.02.2018;2018;02;21;Tiistai;3;2;5;0;0;0
109;06.02.2018;2018;02;22;Tiistai;1;0;1;0;0;0
109;06.02.2018;2018;02;23;Tiistai;0;0;0;0;0;0
109;07.02.2018;2018;02;00;Keskiviikko;1;0;1;0;0;0
109;07.02.2018;2018;02;01;Keskiviikko;0;0;0;0;0;0
109;07.02.2018;2018;02;02;Keskiviikko;0;0;0;0;0;0
109;07.02.2018;2018;02;03;Keskiviikko;0;0;0;0;0;0
109;07.02.2018;2018;02;04;Keskiviikko;0;0;0;1;0;1
109;07.02.2018;2018;02;05;Keskiviikko;2;1;3;2;0;2
109;07.02.2018;2018;02;06;Keskiviikko;9;8;17;4;0;4
109;07.02.2018;2018;02;07;Keskiviikko;24;20;44;5;0;5
109;07.02.2018;2018;02;08;Keskiviikko;13;12;25;5;0;5
109;07.02.2018;2018;02;09;Keskiviikko;7;5;12;3;0;3
109;07.02.2018;2018;02;10;Keskiviikko;4;2;6;10;0;10
109;07.02.2018;2018;02;11;Keskiviikko;4;2;6;7;0;7
109;07.02.2018;2018;02;12;Keskiviikko;7;3;10;5;0;5
109;07.02.2018;2018;02;13;Keskiviikko;6;3;9;7;0;7
109;07.02.2018;2018;02;14;Keskiviikko;11;9;20;4;0;4
109;07.02.2018;2018;02;15;Keskiviikko;11;9;20;8;0;8
109;07.02.2018;2018;02;16;Keskiviikko;29;26;55;9;0;9
109;07.02.2018;2018;02;17;Keskiviikko;7;6;13;7;0;7
109;07.02.2018;2018;02;18;Keskiviikko;10;8;18;12;0;12
109;07.02.2018;2018;02;19;Keskiviikko;6;3;9;9;0;9
109;07.02.2018;2018;02;20;Keskiviikko;4;2;6;5;0;5
109;07.02.2018;2018;02;21;Keskiviikko;6;4;10;4;0;4
109;07.02.2018;2018;02;22;Keskiviikko;1;1;2;4;0;4
109;07.02.2018;2018;02;23;Keskiviikko;2;1;3;2;0;2
109;08.02.2018;2018;02;00;Torstai;1;0;1;0;0;0
109;08.02.2018;2018;02;01;Torstai;0;0;0;0;0;0
109;08.02.2018;2018;02;02;Torstai;0;0;0;0;0;0
109;08.02.2018;2018;02;03;Torstai;0;0;0;0;0;0
109;08.02.2018;2018;02;04;Torstai;0;0;0;0;0;0
109;08.02.2018;2018;02;05;Torstai;2;1;3;0;0;0
109;08.02.2018;2018;02;06;Torstai;9;8;17;0;0;0
109;08.02.2018;2018;02;07;Torstai;27;23;50;0;0;0
109;08.02.2018;2018;02;08;Torstai;14;11;25;5;0;5
109;08.02.2018;2018;02;09;Torstai;7;4;11;8;0;8
109;08.02.2018;2018;02;10;Torstai;6;3;9;5;0;5
109;08.02.2018;2018;02;11;Torstai;3;2;5;9;0;9
109;08.02.2018;2018;02;12;Torstai;4;3;7;8;0;8
109;08.02.2018;2018;02;13;Torstai;5;4;9;3;0;3
109;08.02.2018;2018;02;14;Torstai;6;2;8;11;0;11
109;08.02.2018;2018;02;15;Torstai;12;12;24;4;0;4
109;08.02.2018;2018;02;16;Torstai;22;21;43;8;0;8
109;08.02.2018;2018;02;17;Torstai;9;8;17;5;0;5
109;08.02.2018;2018;02;18;Torstai;5;4;9;5;0;5
109;08.02.2018;2018;02;19;Torstai;4;2;6;9;0;9
109;08.02.2018;2018;02;20;Torstai;5;2;7;5;0;5
109;08.02.2018;2018;02;21;Torstai;1;1;2;4;0;4
109;08.02.2018;2018;02;22;Torstai;3;1;4;3;0;3
109;08.02.2018;2018;02;23;Torstai;0;0;0;0;0;0
109;09.02.2018;2018;02;00;Perjantai;0;0;0;0;0;0
109;09.02.2018;2018;02;01;Perjantai;0;0;0;0;0;0
109;09.02.2018;2018;02;02;Perjantai;0;0;0;0;0;0
109;09.02.2018;2018;02;03;Perjantai;0;0;0;0;0;0
109;09.02.2018;2018;02;04;Perjantai;0;0;0;0;0;0
109;09.02.2018;2018;02;05;Perjantai;3;0;3;0;0;0
109;09.02.2018;2018;02;06;Perjantai;12;9;21;0;0;0
109;09.02.2018;2018;02;07;Perjantai;21;17;38;0;0;0
109;09.02.2018;2018;02;08;Perjantai;14;13;27;8;0;8
109;09.02.2018;2018;02;09;Perjantai;7;4;11;3;0;3
109;09.02.2018;2018;02;10;Perjantai;4;2;6;7;0;7
109;09.02.2018;2018;02;11;Perjantai;7;5;12;4;0;4
109;09.02.2018;2018;02;12;Perjantai;8;5;13;2;0;2
109;09.02.2018;2018;02;13;Perjantai;5;3;8;1;0;1
109;09.02.2018;2018;02;14;Perjantai;8;12;20;6;12;18
109;09.02.2018;2018;02;15;Perjantai;11;16;27;5;5;10
109;09.02.2018;2018;02;16;Perjantai;14;12;26;6;3;9
109;09.02.2018;2018;02;17;Perjantai;6;5;11;6;6;12
109;09.02.2018;2018;02;18;Perjantai;2;4;6;6;2;8
109;09.02.2018;2018;02;19;Perjantai;2;2;4;2;2;4
109;09.02.2018;2018;02;20;Perjantai;4;2;6;1;2;3
109;09.02.2018;2018;02;21;Perjantai;3;2;5;3;3;6
109;09.02.2018;2018;02;22;Perjantai;0;4;4;5;1;6
109;09.02.2018;2018;02;23;Perjantai;1;1;2;0;0;0
109;10.02.2018;2018;02;00;Lauantai;1;0;1;2;0;2
109;10.02.2018;2018;02;01;Lauantai;0;0;0;0;1;1
109;10.02.2018;2018;02;02;Lauantai;0;0;0;0;1;1
109;10.02.2018;2018;02;03;Lauantai;0;0;0;0;0;0
109;10.02.2018;2018;02;04;Lauantai;0;0;0;2;0;2
109;10.02.2018;2018;02;05;Lauantai;0;1;1;1;1;2
109;10.02.2018;2018;02;06;Lauantai;1;0;1;2;0;2
109;10.02.2018;2018;02;07;Lauantai;3;1;4;0;1;1
109;10.02.2018;2018;02;08;Lauantai;0;0;0;2;1;3
109;10.02.2018;2018;02;09;Lauantai;0;3;3;3;3;6
109;10.02.2018;2018;02;10;Lauantai;1;5;6;4;3;7
109;10.02.2018;2018;02;11;Lauantai;1;3;4;6;13;19
109;10.02.2018;2018;02;12;Lauantai;4;0;4;6;5;11
109;10.02.2018;2018;02;13;Lauantai;7;2;9;7;3;10
109;10.02.2018;2018;02;14;Lauantai;2;2;4;10;9;19
109;10.02.2018;2018;02;15;Lauantai;0;4;4;9;2;11
109;10.02.2018;2018;02;16;Lauantai;4;1;5;4;5;9
109;10.02.2018;2018;02;17;Lauantai;2;9;11;6;6;12
109;10.02.2018;2018;02;18;Lauantai;3;4;7;7;4;11
109;10.02.2018;2018;02;19;Lauantai;2;1;3;6;3;9
109;10.02.2018;2018;02;20;Lauantai;4;0;4;3;2;5
109;10.02.2018;2018;02;21;Lauantai;1;3;4;3;2;5
109;10.02.2018;2018;02;22;Lauantai;7;0;7;3;0;3
109;10.02.2018;2018;02;23;Lauantai;0;1;1;3;4;7
109;11.02.2018;2018;02;00;Sunnuntai;0;2;2;0;2;2
109;11.02.2018;2018;02;01;Sunnuntai;1;0;1;0;0;0
109;11.02.2018;2018;02;02;Sunnuntai;0;1;1;3;1;4
109;11.02.2018;2018;02;03;Sunnuntai;0;0;0;0;0;0
109;11.02.2018;2018;02;04;Sunnuntai;0;0;0;0;1;1
109;11.02.2018;2018;02;05;Sunnuntai;0;0;0;2;1;3
109;11.02.2018;2018;02;06;Sunnuntai;1;0;1;4;2;6
109;11.02.2018;2018;02;07;Sunnuntai;0;1;1;0;2;2
109;11.02.2018;2018;02;08;Sunnuntai;0;2;2;2;1;3
109;11.02.2018;2018;02;09;Sunnuntai;0;1;1;1;3;4
109;11.02.2018;2018;02;10;Sunnuntai;3;1;4;4;2;6
109;11.02.2018;2018;02;11;Sunnuntai;2;3;5;2;8;10
109;11.02.2018;2018;02;12;Sunnuntai;4;0;4;5;1;6
109;11.02.2018;2018;02;13;Sunnuntai;2;2;4;5;1;6
109;11.02.2018;2018;02;14;Sunnuntai;2;2;4;7;5;12
109;11.02.2018;2018;02;15;Sunnuntai;5;1;6;8;1;9
109;11.02.2018;2018;02;16;Sunnuntai;1;1;2;4;2;6
109;11.02.2018;2018;02;17;Sunnuntai;2;2;4;6;3;9
109;11.02.2018;2018;02;18;Sunnuntai;4;5;9;4;2;6
109;11.02.2018;2018;02;19;Sunnuntai;1;2;3;3;0;3
109;11.02.2018;2018;02;20;Sunnuntai;0;2;2;5;6;11
109;11.02.2018;2018;02;21;Sunnuntai;0;2;2;1;1;2
109;11.02.2018;2018;02;22;Sunnuntai;1;2;3;3;0;3
109;11.02.2018;2018;02;23;Sunnuntai;0;0;0;0;0;0
109;12.02.2018;2018;02;00;Maanantai;0;0;0;0;0;0
109;12.02.2018;2018;02;01;Maanantai;0;0;0;0;1;1
109;12.02.2018;2018;02;02;Maanantai;0;1;1;1;0;1
109;12.02.2018;2018;02;03;Maanantai;0;0;0;0;0;0
109;12.02.2018;2018;02;04;Maanantai;0;0;0;0;0;0
109;12.02.2018;2018;02;05;Maanantai;1;2;3;1;0;1
109;12.02.2018;2018;02;06;Maanantai;11;6;17;1;1;2
109;12.02.2018;2018;02;07;Maanantai;36;20;56;4;3;7
109;12.02.2018;2018;02;08;Maanantai;30;7;37;5;0;5
109;12.02.2018;2018;02;09;Maanantai;6;8;14;2;2;4
109;12.02.2018;2018;02;10;Maanantai;7;6;13;5;1;6
109;12.02.2018;2018;02;11;Maanantai;5;6;11;1;0;1
109;12.02.2018;2018;02;12;Maanantai;7;4;11;0;0;0
109;12.02.2018;2018;02;13;Maanantai;5;4;9;8;11;19
109;12.02.2018;2018;02;14;Maanantai;11;9;20;0;0;0
109;12.02.2018;2018;02;15;Maanantai;19;14;33;2;1;3
109;12.02.2018;2018;02;16;Maanantai;35;27;62;2;1;3
109;12.02.2018;2018;02;17;Maanantai;10;11;21;4;1;5
109;12.02.2018;2018;02;18;Maanantai;3;5;8;2;0;2
109;12.02.2018;2018;02;19;Maanantai;3;3;6;4;5;9
109;12.02.2018;2018;02;20;Maanantai;2;4;6;4;0;4
109;12.02.2018;2018;02;21;Maanantai;1;6;7;0;1;1
109;12.02.2018;2018;02;22;Maanantai;5;1;6;0;0;0
109;12.02.2018;2018;02;23;Maanantai;0;0;0;0;0;0
109;13.02.2018;2018;02;00;Tiistai;0;0;0;0;0;0
109;13.02.2018;2018;02;01;Tiistai;0;0;0;1;1;2
109;13.02.2018;2018;02;02;Tiistai;0;0;0;1;0;1
109;13.02.2018;2018;02;03;Tiistai;0;0;0;0;0;0
109;13.02.2018;2018;02;04;Tiistai;0;0;0;0;0;0
109;13.02.2018;2018;02;05;Tiistai;1;1;2;0;1;1
109;13.02.2018;2018;02;06;Tiistai;16;8;24;1;2;3
109;13.02.2018;2018;02;07;Tiistai;27;20;47;8;0;8
109;13.02.2018;2018;02;08;Tiistai;21;14;35;3;0;3
109;13.02.2018;2018;02;09;Tiistai;11;8;19;1;0;1
109;13.02.2018;2018;02;10;Tiistai;3;3;6;4;0;4
109;13.02.2018;2018;02;11;Tiistai;8;5;13;6;0;6
109;13.02.2018;2018;02;12;Tiistai;7;3;10;4;0;4
109;13.02.2018;2018;02;13;Tiistai;1;2;3;2;0;2
109;13.02.2018;2018;02;14;Tiistai;10;6;16;3;0;3
109;13.02.2018;2018;02;15;Tiistai;21;11;32;4;0;4
109;13.02.2018;2018;02;16;Tiistai;39;25;64;6;1;7
109;13.02.2018;2018;02;17;Tiistai;17;7;24;4;3;7
109;13.02.2018;2018;02;18;Tiistai;6;1;7;4;1;5
109;13.02.2018;2018;02;19;Tiistai;5;3;8;3;2;5
109;13.02.2018;2018;02;20;Tiistai;1;4;5;0;0;0
109;13.02.2018;2018;02;21;Tiistai;0;2;2;0;3;3
109;13.02.2018;2018;02;22;Tiistai;3;4;7;0;0;0
109;13.02.2018;2018;02;23;Tiistai;0;0;0;0;0;0
109;14.02.2018;2018;02;00;Keskiviikko;1;0;1;0;0;0
109;14.02.2018;2018;02;01;Keskiviikko;0;0;0;0;0;0
109;14.02.2018;2018;02;02;Keskiviikko;0;0;0;0;0;0
109;14.02.2018;2018;02;03;Keskiviikko;0;0;0;0;0;0
109;14.02.2018;2018;02;04;Keskiviikko;0;0;0;1;0;1
109;14.02.2018;2018;02;05;Keskiviikko;3;0;3;2;0;2
109;14.02.2018;2018;02;06;Keskiviikko;17;0;17;4;0;4
109;14.02.2018;2018;02;07;Keskiviikko;44;0;44;5;0;5
109;14.02.2018;2018;02;08;Keskiviikko;25;0;25;5;0;5
109;14.02.2018;2018;02;09;Keskiviikko;12;0;12;3;0;3
109;14.02.2018;2018;02;10;Keskiviikko;6;0;6;10;0;10
109;14.02.2018;2018;02;11;Keskiviikko;6;0;6;7;0;7
109;14.02.2018;2018;02;12;Keskiviikko;10;0;10;5;0;5
109;14.02.2018;2018;02;13;Keskiviikko;9;0;9;7;0;7
109;14.02.2018;2018;02;14;Keskiviikko;20;0;20;4;0;4
109;14.02.2018;2018;02;15;Keskiviikko;20;0;20;8;0;8
109;14.02.2018;2018;02;16;Keskiviikko;55;0;55;9;0;9
109;14.02.2018;2018;02;17;Keskiviikko;13;0;13;7;0;7
109;14.02.2018;2018;02;18;Keskiviikko;18;0;18;12;0;12
109;14.02.2018;2018;02;19;Keskiviikko;9;0;9;9;0;9
109;14.02.2018;2018;02;20;Keskiviikko;6;0;6;5;0;5
109;14.02.2018;2018;02;21;Keskiviikko;10;0;10;4;0;4
109;14.02.2018;2018;02;22;Keskiviikko;2;0;2;4;0;4
109;14.02.2018;2018;02;23;Keskiviikko;3;0;3;2;0;2
109;15.02.2018;2018;02;00;Torstai;1;0;1;0;0;0
109;15.02.2018;2018;02;01;Torstai;0;0;0;0;0;0
109;15.02.2018;2018;02;02;Torstai;0;0;0;0;0;0
109;15.02.2018;2018;02;03;Torstai;0;0;0;0;0;0
109;15.02.2018;2018;02;04;Torstai;0;0;0;0;0;0
109;15.02.2018;2018;02;05;Torstai;3;0;3;0;0;0
109;15.02.2018;2018;02;06;Torstai;17;0;17;0;0;0
109;15.02.2018;2018;02;07;Torstai;50;0;50;0;0;0
109;15.02.2018;2018;02;08;Torstai;25;0;25;5;0;5
109;15.02.2018;2018;02;09;Torstai;11;0;11;8;0;8
109;15.02.2018;2018;02;10;Torstai;9;0;9;5;0;5
109;15.02.2018;2018;02;11;Torstai;5;0;5;9;0;9
109;15.02.2018;2018;02;12;Torstai;7;0;7;8;0;8
109;15.02.2018;2018;02;13;Torstai;9;0;9;3;0;3
109;15.02.2018;2018;02;14;Torstai;8;0;8;11;0;11
109;15.02.2018;2018;02;15;Torstai;24;0;24;4;0;4
109;15.02.2018;2018;02;16;Torstai;43;0;43;8;0;8
109;15.02.2018;2018;02;17;Torstai;17;0;17;5;0;5
109;15.02.2018;2018;02;18;Torstai;9;0;9;5;0;5
109;15.02.2018;2018;02;19;Torstai;6;0;6;9;0;9
109;15.02.2018;2018;02;20;Torstai;7;0;7;5;0;5
109;15.02.2018;2018;02;21;Torstai;2;0;2;4;0;4
109;15.02.2018;2018;02;22;Torstai;4;0;4;3;0;3
109;15.02.2018;2018;02;23;Torstai;0;0;0;0;0;0
109;16.02.2018;2018;02;00;Perjantai;0;0;0;0;0;0
109;16.02.2018;2018;02;01;Perjantai;0;0;0;0;1;1
109;16.02.2018;2018;02;02;Perjantai;0;0;0;0;0;0
109;16.02.2018;2018;02;03;Perjantai;0;0;0;0;0;0
109;16.02.2018;2018;02;04;Perjantai;0;0;0;0;0;0
109;16.02.2018;2018;02;05;Perjantai;0;3;3;1;1;2
109;16.02.2018;2018;02;06;Perjantai;13;7;20;2;0;2
109;16.02.2018;2018;02;07;Perjantai;23;14;37;4;4;8
109;16.02.2018;2018;02;08;Perjantai;12;6;18;5;2;7
109;16.02.2018;2018;02;09;Perjantai;7;4;11;0;3;3
109;16.02.2018;2018;02;10;Perjantai;3;3;6;5;2;7
109;16.02.2018;2018;02;11;Perjantai;7;5;12;6;0;6
109;16.02.2018;2018;02;12;Perjantai;8;1;9;3;2;5
109;16.02.2018;2018;02;13;Perjantai;6;2;8;0;3;3
109;16.02.2018;2018;02;14;Perjantai;8;10;18;2;1;3
109;16.02.2018;2018;02;15;Perjantai;13;19;32;10;0;10
109;16.02.2018;2018;02;16;Perjantai;8;13;21;2;2;4
109;16.02.2018;2018;02;17;Perjantai;5;11;16;4;3;7
109;16.02.2018;2018;02;18;Perjantai;3;4;7;5;3;8
109;16.02.2018;2018;02;19;Perjantai;2;5;7;2;3;5
109;16.02.2018;2018;02;20;Perjantai;3;2;5;5;3;8
109;16.02.2018;2018;02;21;Perjantai;1;2;3;5;1;6
109;16.02.2018;2018;02;22;Perjantai;1;1;2;2;1;3
109;16.02.2018;2018;02;23;Perjantai;0;0;0;0;0;0
109;17.02.2018;2018;02;00;Lauantai;0;0;0;0;0;0
109;17.02.2018;2018;02;01;Lauantai;0;0;0;0;0;0
109;17.02.2018;2018;02;02;Lauantai;0;1;1;0;2;2
109;17.02.2018;2018;02;03;Lauantai;0;0;0;0;0;0
109;17.02.2018;2018;02;04;Lauantai;0;0;0;0;0;0
109;17.02.2018;2018;02;05;Lauantai;0;0;0;0;0;0
109;17.02.2018;2018;02;06;Lauantai;1;0;1;1;0;1
109;17.02.2018;2018;02;07;Lauantai;1;0;1;1;2;3
109;17.02.2018;2018;02;08;Lauantai;2;2;4;6;2;8
109;17.02.2018;2018;02;09;Lauantai;1;1;2;0;2;2
109;17.02.2018;2018;02;10;Lauantai;1;4;5;4;3;7
109;17.02.2018;2018;02;11;Lauantai;1;4;5;5;1;6
109;17.02.2018;2018;02;12;Lauantai;5;1;6;2;2;4
109;17.02.2018;2018;02;13;Lauantai;0;4;4;5;3;8
109;17.02.2018;2018;02;14;Lauantai;2;4;6;11;2;13
109;17.02.2018;2018;02;15;Lauantai;3;3;6;6;5;11
109;17.02.2018;2018;02;16;Lauantai;1;3;4;1;2;3
109;17.02.2018;2018;02;17;Lauantai;0;0;0;2;2;4
109;17.02.2018;2018;02;18;Lauantai;0;2;2;1;3;4
109;17.02.2018;2018;02;19;Lauantai;1;1;2;3;1;4
109;17.02.2018;2018;02;20;Lauantai;4;1;5;6;0;6
109;17.02.2018;2018;02;21;Lauantai;1;2;3;0;0;0
109;17.02.2018;2018;02;22;Lauantai;0;0;0;0;0;0
109;17.02.2018;2018;02;23;Lauantai;0;0;0;0;1;1
109;18.02.2018;2018;02;00;Sunnuntai;0;0;0;0;0;0
109;18.02.2018;2018;02;01;Sunnuntai;0;0;0;1;1;2
109;18.02.2018;2018;02;02;Sunnuntai;0;2;2;0;0;0
109;18.02.2018;2018;02;03;Sunnuntai;0;0;0;0;0;0
109;18.02.2018;2018;02;04;Sunnuntai;0;0;0;0;0;0
109;18.02.2018;2018;02;05;Sunnuntai;0;0;0;1;0;1
109;18.02.2018;2018;02;06;Sunnuntai;1;0;1;0;0;0
109;18.02.2018;2018;02;07;Sunnuntai;0;3;3;0;1;1
109;18.02.2018;2018;02;08;Sunnuntai;1;1;2;1;1;2
109;18.02.2018;2018;02;09;Sunnuntai;0;2;2;2;5;7
109;18.02.2018;2018;02;10;Sunnuntai;1;1;2;3;4;7
109;18.02.2018;2018;02;11;Sunnuntai;5;1;6;6;8;14
109;18.02.2018;2018;02;12;Sunnuntai;1;1;2;7;5;12
109;18.02.2018;2018;02;13;Sunnuntai;2;1;3;3;4;7
109;18.02.2018;2018;02;14;Sunnuntai;1;1;2;4;1;5
109;18.02.2018;2018;02;15;Sunnuntai;5;3;8;5;3;8
109;18.02.2018;2018;02;16;Sunnuntai;1;1;2;3;1;4
109;18.02.2018;2018;02;17;Sunnuntai;5;1;6;7;3;10
109;18.02.2018;2018;02;18;Sunnuntai;1;1;2;1;3;4
109;18.02.2018;2018;02;19;Sunnuntai;0;1;1;4;3;7
109;18.02.2018;2018;02;20;Sunnuntai;2;2;4;6;3;9
109;18.02.2018;2018;02;21;Sunnuntai;1;1;2;2;1;3
109;18.02.2018;2018;02;22;Sunnuntai;0;0;0;0;0;0
109;18.02.2018;2018;02;23;Sunnuntai;0;0;0;0;2;2
109;19.02.2018;2018;02;00;Maanantai;0;1;1;0;0;0
109;19.02.2018;2018;02;01;Maanantai;0;0;0;0;0;0
109;19.02.2018;2018;02;02;Maanantai;0;0;0;0;0;0
109;19.02.2018;2018;02;03;Maanantai;0;0;0;0;0;0
109;19.02.2018;2018;02;04;Maanantai;0;1;1;0;0;0
109;19.02.2018;2018;02;05;Maanantai;1;1;2;3;1;4
109;19.02.2018;2018;02;06;Maanantai;8;3;11;3;1;4
109;19.02.2018;2018;02;07;Maanantai;18;14;32;1;1;2
109;19.02.2018;2018;02;08;Maanantai;17;3;20;4;3;7
109;19.02.2018;2018;02;09;Maanantai;4;5;9;4;2;6
109;19.02.2018;2018;02;10;Maanantai;4;2;6;7;4;11
109;19.02.2018;2018;02;11;Maanantai;1;2;3;6;4;10
109;19.02.2018;2018;02;12;Maanantai;3;5;8;3;2;5
109;19.02.2018;2018;02;13;Maanantai;9;6;15;2;1;3
109;19.02.2018;2018;02;14;Maanantai;4;1;5;5;6;11
109;19.02.2018;2018;02;15;Maanantai;13;12;25;5;2;7
109;19.02.2018;2018;02;16;Maanantai;14;24;38;3;4;7
109;19.02.2018;2018;02;17;Maanantai;7;7;14;9;1;10
109;19.02.2018;2018;02;18;Maanantai;5;3;8;0;4;4
109;19.02.2018;2018;02;19;Maanantai;1;0;1;2;5;7
109;19.02.2018;2018;02;20;Maanantai;3;5;8;6;5;11
109;19.02.2018;2018;02;21;Maanantai;0;4;4;0;1;1
109;19.02.2018;2018;02;22;Maanantai;0;0;0;1;0;1
109;19.02.2018;2018;02;23;Maanantai;0;0;0;0;0;0
109;20.02.2018;2018;02;00;Tiistai;0;0;0;0;0;0
109;20.02.2018;2018;02;01;Tiistai;0;0;0;0;2;2
109;20.02.2018;2018;02;02;Tiistai;0;0;0;0;0;0
109;20.02.2018;2018;02;03;Tiistai;0;0;0;1;1;2
109;20.02.2018;2018;02;04;Tiistai;0;0;0;0;0;0
109;20.02.2018;2018;02;05;Tiistai;0;1;1;1;1;2
109;20.02.2018;2018;02;06;Tiistai;4;2;6;3;2;5
109;20.02.2018;2018;02;07;Tiistai;17;18;35;2;2;4
109;20.02.2018;2018;02;08;Tiistai;9;2;11;4;1;5
109;20.02.2018;2018;02;09;Tiistai;5;1;6;2;1;3
109;20.02.2018;2018;02;10;Tiistai;5;5;10;2;4;6
109;20.02.2018;2018;02;11;Tiistai;2;1;3;3;0;3
109;20.02.2018;2018;02;12;Tiistai;5;2;7;2;1;3
109;20.02.2018;2018;02;13;Tiistai;5;3;8;2;4;6
109;20.02.2018;2018;02;14;Tiistai;4;4;8;5;2;7
109;20.02.2018;2018;02;15;Tiistai;7;10;17;4;2;6
109;20.02.2018;2018;02;16;Tiistai;16;21;37;3;4;7
109;20.02.2018;2018;02;17;Tiistai;5;4;9;5;4;9
109;20.02.2018;2018;02;18;Tiistai;4;4;8;3;0;3
109;20.02.2018;2018;02;19;Tiistai;3;3;6;6;4;10
109;20.02.2018;2018;02;20;Tiistai;2;2;4;5;1;6
109;20.02.2018;2018;02;21;Tiistai;2;5;7;1;3;4
109;20.02.2018;2018;02;22;Tiistai;1;1;2;1;0;1
109;20.02.2018;2018;02;23;Tiistai;0;0;0;2;0;2
109;21.02.2018;2018;02;00;Keskiviikko;0;0;0;0;0;0
109;21.02.2018;2018;02;01;Keskiviikko;0;0;0;2;2;4
109;21.02.2018;2018;02;02;Keskiviikko;0;0;0;0;0;0
109;21.02.2018;2018;02;03;Keskiviikko;0;0;0;0;0;0
109;21.02.2018;2018;02;04;Keskiviikko;0;1;1;0;1;1
109;21.02.2018;2018;02;05;Keskiviikko;0;3;3;1;1;2
109;21.02.2018;2018;02;06;Keskiviikko;10;3;13;3;2;5
109;21.02.2018;2018;02;07;Keskiviikko;21;17;38;3;6;9
109;21.02.2018;2018;02;08;Keskiviikko;10;5;15;2;1;3
109;21.02.2018;2018;02;09;Keskiviikko;10;5;15;9;7;16
109;21.02.2018;2018;02;10;Keskiviikko;4;2;6;6;2;8
109;21.02.2018;2018;02;11;Keskiviikko;5;1;6;1;2;3
109;21.02.2018;2018;02;12;Keskiviikko;6;3;9;1;1;2
109;21.02.2018;2018;02;13;Keskiviikko;2;3;5;1;4;5
109;21.02.2018;2018;02;14;Keskiviikko;5;6;11;5;2;7
109;21.02.2018;2018;02;15;Keskiviikko;7;12;19;4;6;10
109;21.02.2018;2018;02;16;Keskiviikko;13;22;35;3;1;4
109;21.02.2018;2018;02;17;Keskiviikko;7;8;15;5;2;7
109;21.02.2018;2018;02;18;Keskiviikko;2;2;4;3;3;6
109;21.02.2018;2018;02;19;Keskiviikko;3;7;10;5;6;11
109;21.02.2018;2018;02;20;Keskiviikko;5;0;5;4;0;4
109;21.02.2018;2018;02;21;Keskiviikko;4;2;6;3;1;4
109;21.02.2018;2018;02;22;Keskiviikko;0;0;0;1;1;2
109;21.02.2018;2018;02;23;Keskiviikko;0;0;0;0;0;0
109;22.02.2018;2018;02;00;Torstai;0;0;0;0;0;0
109;22.02.2018;2018;02;01;Torstai;0;1;1;0;0;0
109;22.02.2018;2018;02;02;Torstai;0;0;0;0;1;1
109;22.02.2018;2018;02;03;Torstai;0;0;0;0;2;2
109;22.02.2018;2018;02;04;Torstai;0;3;3;0;0;0
109;22.02.2018;2018;02;05;Torstai;0;1;1;1;0;1
109;22.02.2018;2018;02;06;Torstai;6;5;11;2;2;4
109;22.02.2018;2018;02;07;Torstai;25;14;39;2;1;3
109;22.02.2018;2018;02;08;Torstai;17;4;21;4;0;4
109;22.02.2018;2018;02;09;Torstai;4;4;8;3;5;8
109;22.02.2018;2018;02;10;Torstai;3;5;8;3;2;5
109;22.02.2018;2018;02;11;Torstai;4;6;10;5;6;11
109;22.02.2018;2018;02;12;Torstai;4;2;6;1;0;1
109;22.02.2018;2018;02;13;Torstai;2;4;6;3;3;6
109;22.02.2018;2018;02;14;Torstai;4;7;11;3;2;5
109;22.02.2018;2018;02;15;Torstai;9;9;18;4;4;8
109;22.02.2018;2018;02;16;Torstai;13;23;36;5;2;7
109;22.02.2018;2018;02;17;Torstai;7;10;17;4;0;4
109;22.02.2018;2018;02;18;Torstai;4;4;8;2;3;5
109;22.02.2018;2018;02;19;Torstai;2;1;3;6;5;11
109;22.02.2018;2018;02;20;Torstai;2;2;4;1;1;2
109;22.02.2018;2018;02;21;Torstai;3;3;6;4;0;4
109;22.02.2018;2018;02;22;Torstai;1;2;3;1;1;2
109;22.02.2018;2018;02;23;Torstai;0;0;0;0;0;0
109;23.02.2018;2018;02;00;Perjantai;0;0;0;1;2;3
109;23.02.2018;2018;02;01;Perjantai;0;0;0;0;0;0
109;23.02.2018;2018;02;02;Perjantai;0;0;0;0;0;0
109;23.02.2018;2018;02;03;Perjantai;0;1;1;0;0;0
109;23.02.2018;2018;02;04;Perjantai;2;3;5;0;0;0
109;23.02.2018;2018;02;05;Perjantai;1;2;3;1;0;1
109;23.02.2018;2018;02;06;Perjantai;6;3;9;0;2;2
109;23.02.2018;2018;02;07;Perjantai;22;16;38;0;1;1
109;23.02.2018;2018;02;08;Perjantai;8;7;15;4;2;6
109;23.02.2018;2018;02;09;Perjantai;10;4;14;3;1;4
109;23.02.2018;2018;02;10;Perjantai;4;1;5;2;2;4
109;23.02.2018;2018;02;11;Perjantai;5;1;6;8;2;10
109;23.02.2018;2018;02;12;Perjantai;2;1;3;1;3;4
109;23.02.2018;2018;02;13;Perjantai;3;5;8;4;5;9
109;23.02.2018;2018;02;14;Perjantai;9;10;19;3;3;6
109;23.02.2018;2018;02;15;Perjantai;8;10;18;6;3;9
109;23.02.2018;2018;02;16;Perjantai;18;14;32;3;2;5
109;23.02.2018;2018;02;17;Perjantai;4;8;12;4;1;5
109;23.02.2018;2018;02;18;Perjantai;3;4;7;2;3;5
109;23.02.2018;2018;02;19;Perjantai;1;4;5;4;2;6
109;23.02.2018;2018;02;20;Perjantai;2;2;4;4;1;5
109;23.02.2018;2018;02;21;Perjantai;1;2;3;1;1;2
109;23.02.2018;2018;02;22;Perjantai;1;1;2;0;1;1
109;23.02.2018;2018;02;23;Perjantai;2;2;4;0;0;0
109;24.02.2018;2018;02;00;Lauantai;0;0;0;0;0;0
109;24.02.2018;2018;02;01;Lauantai;0;0;0;3;3;6
109;24.02.2018;2018;02;02;Lauantai;0;0;0;0;1;1
109;24.02.2018;2018;02;03;Lauantai;0;0;0;1;0;1
109;24.02.2018;2018;02;04;Lauantai;0;0;0;0;0;0
109;24.02.2018;2018;02;05;Lauantai;1;2;3;0;0;0
109;24.02.2018;2018;02;06;Lauantai;1;0;1;1;0;1
109;24.02.2018;2018;02;07;Lauantai;0;0;0;1;1;2
109;24.02.2018;2018;02;08;Lauantai;0;2;2;4;0;4
109;24.02.2018;2018;02;09;Lauantai;1;0;1;1;1;2
109;24.02.2018;2018;02;10;Lauantai;0;1;1;0;0;0
109;24.02.2018;2018;02;11;Lauantai;1;0;1;4;2;6
109;24.02.2018;2018;02;12;Lauantai;3;2;5;2;1;3
109;24.02.2018;2018;02;13;Lauantai;1;3;4;2;3;5
109;24.02.2018;2018;02;14;Lauantai;3;0;3;9;6;15
109;24.02.2018;2018;02;15;Lauantai;2;5;7;4;0;4
109;24.02.2018;2018;02;16;Lauantai;1;5;6;8;1;9
109;24.02.2018;2018;02;17;Lauantai;0;2;2;3;4;7
109;24.02.2018;2018;02;18;Lauantai;2;1;3;3;3;6
109;24.02.2018;2018;02;19;Lauantai;2;1;3;6;3;9
109;24.02.2018;2018;02;20;Lauantai;1;1;2;2;1;3
109;24.02.2018;2018;02;21;Lauantai;1;0;1;3;0;3
109;24.02.2018;2018;02;22;Lauantai;1;1;2;2;1;3
109;24.02.2018;2018;02;23;Lauantai;0;0;0;2;0;2
109;25.02.2018;2018;02;00;Sunnuntai;0;0;0;0;0;0
109;25.02.2018;2018;02;01;Sunnuntai;0;0;0;0;0;0
109;25.02.2018;2018;02;02;Sunnuntai;0;0;0;3;2;5
109;25.02.2018;2018;02;03;Sunnuntai;0;0;0;0;0;0
109;25.02.2018;2018;02;04;Sunnuntai;0;0;0;0;0;0
109;25.02.2018;2018;02;05;Sunnuntai;0;1;1;0;0;0
109;25.02.2018;2018;02;06;Sunnuntai;3;1;4;0;0;0
109;25.02.2018;2018;02;07;Sunnuntai;0;2;2;3;2;5
109;25.02.2018;2018;02;08;Sunnuntai;0;2;2;3;0;3
109;25.02.2018;2018;02;09;Sunnuntai;0;0;0;1;1;2
109;25.02.2018;2018;02;10;Sunnuntai;6;0;6;4;10;14
109;25.02.2018;2018;02;11;Sunnuntai;3;2;5;1;1;2
109;25.02.2018;2018;02;12;Sunnuntai;7;4;11;4;2;6
109;25.02.2018;2018;02;13;Sunnuntai;2;5;7;1;1;2
109;25.02.2018;2018;02;14;Sunnuntai;1;1;2;5;4;9
109;25.02.2018;2018;02;15;Sunnuntai;7;2;9;9;7;16
109;25.02.2018;2018;02;16;Sunnuntai;1;1;2;5;3;8
109;25.02.2018;2018;02;17;Sunnuntai;1;2;3;4;4;8
109;25.02.2018;2018;02;18;Sunnuntai;1;2;3;9;4;13
109;25.02.2018;2018;02;19;Sunnuntai;2;0;2;2;3;5
109;25.02.2018;2018;02;20;Sunnuntai;2;1;3;0;3;3
109;25.02.2018;2018;02;21;Sunnuntai;0;0;0;0;1;1
109;25.02.2018;2018;02;22;Sunnuntai;0;0;0;1;0;1
109;25.02.2018;2018;02;23;Sunnuntai;0;0;0;0;1;1
109;26.02.2018;2018;02;00;Maanantai;1;0;1;0;0;0
109;26.02.2018;2018;02;01;Maanantai;0;1;1;0;1;1
109;26.02.2018;2018;02;02;Maanantai;0;0;0;0;0;0
109;26.02.2018;2018;02;03;Maanantai;0;0;0;0;0;0
109;26.02.2018;2018;02;04;Maanantai;0;0;0;0;0;0
109;26.02.2018;2018;02;05;Maanantai;3;4;7;1;0;1
109;26.02.2018;2018;02;06;Maanantai;10;6;16;5;1;6
109;26.02.2018;2018;02;07;Maanantai;33;17;50;2;3;5
109;26.02.2018;2018;02;08;Maanantai;19;8;27;3;1;4
109;26.02.2018;2018;02;09;Maanantai;9;11;20;4;3;7
109;26.02.2018;2018;02;10;Maanantai;7;2;9;2;6;8
109;26.02.2018;2018;02;11;Maanantai;5;2;7;1;5;6
109;26.02.2018;2018;02;12;Maanantai;4;2;6;5;3;8
109;26.02.2018;2018;02;13;Maanantai;10;6;16;1;0;1
109;26.02.2018;2018;02;14;Maanantai;3;7;10;1;2;3
109;26.02.2018;2018;02;15;Maanantai;10;16;26;8;3;11
109;26.02.2018;2018;02;16;Maanantai;16;30;46;4;2;6
109;26.02.2018;2018;02;17;Maanantai;7;12;19;2;6;8
109;26.02.2018;2018;02;18;Maanantai;4;5;9;4;7;11
109;26.02.2018;2018;02;19;Maanantai;4;3;7;7;1;8
109;26.02.2018;2018;02;20;Maanantai;0;4;4;3;2;5
109;26.02.2018;2018;02;21;Maanantai;1;2;3;2;1;3
109;26.02.2018;2018;02;22;Maanantai;0;0;0;0;0;0
109;26.02.2018;2018;02;23;Maanantai;0;0;0;0;0;0
109;27.02.2018;2018;02;00;Tiistai;0;0;0;0;0;0
109;27.02.2018;2018;02;01;Tiistai;0;0;0;0;3;3
109;27.02.2018;2018;02;02;Tiistai;0;0;0;0;0;0
109;27.02.2018;2018;02;03;Tiistai;0;0;0;0;0;0
109;27.02.2018;2018;02;04;Tiistai;0;0;0;0;0;0
109;27.02.2018;2018;02;05;Tiistai;0;2;2;1;0;1
109;27.02.2018;2018;02;06;Tiistai;16;6;22;0;3;3
109;27.02.2018;2018;02;07;Tiistai;18;13;31;2;4;6
109;27.02.2018;2018;02;08;Tiistai;8;1;9;4;0;4
109;27.02.2018;2018;02;09;Tiistai;7;2;9;1;3;4
109;27.02.2018;2018;02;10;Tiistai;5;4;9;4;6;10
109;27.02.2018;2018;02;11;Tiistai;2;0;2;3;2;5
109;27.02.2018;2018;02;12;Tiistai;5;0;5;4;3;7
109;27.02.2018;2018;02;13;Tiistai;7;3;10;8;4;12
109;27.02.2018;2018;02;14;Tiistai;4;10;14;6;2;8
109;27.02.2018;2018;02;15;Tiistai;7;17;24;5;5;10
109;27.02.2018;2018;02;16;Tiistai;15;22;37;2;3;5
109;27.02.2018;2018;02;17;Tiistai;10;9;19;4;1;5
109;27.02.2018;2018;02;18;Tiistai;2;5;7;4;2;6
109;27.02.2018;2018;02;19;Tiistai;0;3;3;5;3;8
109;27.02.2018;2018;02;20;Tiistai;2;5;7;5;1;6
109;27.02.2018;2018;02;21;Tiistai;3;2;5;0;0;0
109;27.02.2018;2018;02;22;Tiistai;0;0;0;1;0;1
109;27.02.2018;2018;02;23;Tiistai;1;0;1;1;0;1
109;28.02.2018;2018;02;00;Keskiviikko;0;0;0;0;0;0
109;28.02.2018;2018;02;01;Keskiviikko;0;0;0;0;0;0
109;28.02.2018;2018;02;02;Keskiviikko;0;0;0;0;2;2
109;28.02.2018;2018;02;03;Keskiviikko;0;0;0;0;0;0
109;28.02.2018;2018;02;04;Keskiviikko;0;2;2;0;0;0
109;28.02.2018;2018;02;05;Keskiviikko;0;4;4;0;0;0
109;28.02.2018;2018;02;06;Keskiviikko;10;5;15;4;3;7
109;28.02.2018;2018;02;07;Keskiviikko;17;13;30;2;2;4
109;28.02.2018;2018;02;08;Keskiviikko;7;2;9;3;3;6
109;28.02.2018;2018;02;09;Keskiviikko;6;3;9;1;3;4
109;28.02.2018;2018;02;10;Keskiviikko;2;3;5;7;0;7
109;28.02.2018;2018;02;11;Keskiviikko;5;1;6;1;2;3
109;28.02.2018;2018;02;12;Keskiviikko;1;2;3;4;3;7
109;28.02.2018;2018;02;13;Keskiviikko;3;1;4;5;2;7
109;28.02.2018;2018;02;14;Keskiviikko;8;4;12;2;0;2
109;28.02.2018;2018;02;15;Keskiviikko;10;11;21;4;3;7
109;28.02.2018;2018;02;16;Keskiviikko;15;14;29;5;5;10
109;28.02.2018;2018;02;17;Keskiviikko;4;4;8;0;1;1
109;28.02.2018;2018;02;18;Keskiviikko;2;5;7;3;2;5
109;28.02.2018;2018;02;19;Keskiviikko;6;2;8;2;5;7
109;28.02.2018;2018;02;20;Keskiviikko;1;6;7;3;1;4
109;28.02.2018;2018;02;21;Keskiviikko;2;3;5;2;4;6
109;28.02.2018;2018;02;22;Keskiviikko;2;0;2;3;0;3
109;28.02.2018;2018;02;23;Keskiviikko;0;1;1;0;0;0
109;01.03.2018;2018;03;00;Torstai;0;0;0;0;1;1
109;01.03.2018;2018;03;01;Torstai;0;0;0;0;0;0
109;01.03.2018;2018;03;02;Torstai;0;0;0;0;0;0
109;01.03.2018;2018;03;03;Torstai;0;0;0;0;1;1
109;01.03.2018;2018;03;04;Torstai;0;0;0;1;0;1
109;01.03.2018;2018;03;05;Torstai;0;1;1;0;0;0
109;01.03.2018;2018;03;06;Torstai;7;2;9;1;2;3
109;01.03.2018;2018;03;07;Torstai;22;15;37;2;1;3
109;01.03.2018;2018;03;08;Torstai;15;3;18;4;2;6
109;01.03.2018;2018;03;09;Torstai;3;5;8;5;9;14
109;01.03.2018;2018;03;10;Torstai;2;4;6;2;3;5
109;01.03.2018;2018;03;11;Torstai;6;2;8;0;4;4
109;01.03.2018;2018;03;12;Torstai;5;3;8;1;5;6
109;01.03.2018;2018;03;13;Torstai;5;1;6;4;1;5
109;01.03.2018;2018;03;14;Torstai;5;2;7;7;1;8
109;01.03.2018;2018;03;15;Torstai;8;13;21;6;3;9
109;01.03.2018;2018;03;16;Torstai;16;22;38;2;2;4
109;01.03.2018;2018;03;17;Torstai;5;7;12;4;2;6
109;01.03.2018;2018;03;18;Torstai;7;8;15;6;2;8
109;01.03.2018;2018;03;19;Torstai;1;2;3;4;7;11
109;01.03.2018;2018;03;20;Torstai;3;3;6;3;0;3
109;01.03.2018;2018;03;21;Torstai;2;2;4;0;0;0
109;01.03.2018;2018;03;22;Torstai;3;4;7;2;0;2
109;01.03.2018;2018;03;23;Torstai;0;0;0;0;0;0
109;02.03.2018;2018;03;00;Perjantai;1;0;1;0;1;1
109;02.03.2018;2018;03;01;Perjantai;0;0;0;0;0;0
109;02.03.2018;2018;03;02;Perjantai;0;0;0;0;1;1
109;02.03.2018;2018;03;03;Perjantai;1;0;1;0;0;0
109;02.03.2018;2018;03;04;Perjantai;0;1;1;0;3;3
109;02.03.2018;2018;03;05;Perjantai;1;2;3;0;0;0
109;02.03.2018;2018;03;06;Perjantai;10;7;17;2;1;3
109;02.03.2018;2018;03;07;Perjantai;27;12;39;1;5;6
109;02.03.2018;2018;03;08;Perjantai;7;4;11;5;3;8
109;02.03.2018;2018;03;09;Perjantai;10;3;13;3;1;4
109;02.03.2018;2018;03;10;Perjantai;4;4;8;3;0;3
109;02.03.2018;2018;03;11;Perjantai;9;3;12;6;4;10
109;02.03.2018;2018;03;12;Perjantai;5;6;11;0;4;4
109;02.03.2018;2018;03;13;Perjantai;6;7;13;2;6;8
109;02.03.2018;2018;03;14;Perjantai;8;10;18;4;3;7
109;02.03.2018;2018;03;15;Perjantai;7;20;27;4;5;9
109;02.03.2018;2018;03;16;Perjantai;17;18;35;8;3;11
109;02.03.2018;2018;03;17;Perjantai;5;4;9;4;4;8
109;02.03.2018;2018;03;18;Perjantai;2;2;4;2;6;8
109;02.03.2018;2018;03;19;Perjantai;3;2;5;6;2;8
109;02.03.2018;2018;03;20;Perjantai;1;0;1;1;1;2
109;02.03.2018;2018;03;21;Perjantai;2;0;2;2;2;4
109;02.03.2018;2018;03;22;Perjantai;1;1;2;2;2;4
109;02.03.2018;2018;03;23;Perjantai;0;1;1;1;0;1
109;03.03.2018;2018;03;00;Lauantai;0;0;0;0;0;0
109;03.03.2018;2018;03;01;Lauantai;0;0;0;0;0;0
109;03.03.2018;2018;03;02;Lauantai;0;0;0;0;0;0
109;03.03.2018;2018;03;03;Lauantai;1;1;2;2;2;4
109;03.03.2018;2018;03;04;Lauantai;0;1;1;1;0;1
109;03.03.2018;2018;03;05;Lauantai;0;0;0;0;0;0
109;03.03.2018;2018;03;06;Lauantai;0;0;0;2;1;3
109;03.03.2018;2018;03;07;Lauantai;0;0;0;3;3;6
109;03.03.2018;2018;03;08;Lauantai;1;1;2;0;1;1
109;03.03.2018;2018;03;09;Lauantai;1;1;2;0;0;0
109;03.03.2018;2018;03;10;Lauantai;2;3;5;7;8;15
109;03.03.2018;2018;03;11;Lauantai;4;3;7;5;5;10
109;03.03.2018;2018;03;12;Lauantai;2;2;4;9;2;11
109;03.03.2018;2018;03;13;Lauantai;5;6;11;3;4;7
109;03.03.2018;2018;03;14;Lauantai;2;1;3;4;2;6
109;03.03.2018;2018;03;15;Lauantai;2;1;3;4;2;6
109;03.03.2018;2018;03;16;Lauantai;0;3;3;5;1;6
109;03.03.2018;2018;03;17;Lauantai;1;0;1;3;2;5
109;03.03.2018;2018;03;18;Lauantai;1;0;1;5;2;7
109;03.03.2018;2018;03;19;Lauantai;1;2;3;2;2;4
109;03.03.2018;2018;03;20;Lauantai;0;1;1;4;1;5
109;03.03.2018;2018;03;21;Lauantai;2;3;5;1;0;1
109;03.03.2018;2018;03;22;Lauantai;1;0;1;2;1;3
109;03.03.2018;2018;03;23;Lauantai;1;0;1;0;0;0
109;04.03.2018;2018;03;00;Sunnuntai;0;0;0;1;0;1
109;04.03.2018;2018;03;01;Sunnuntai;1;1;2;0;0;0
109;04.03.2018;2018;03;02;Sunnuntai;0;0;0;0;0;0
109;04.03.2018;2018;03;03;Sunnuntai;1;0;1;1;0;1
109;04.03.2018;2018;03;04;Sunnuntai;0;0;0;0;0;0
109;04.03.2018;2018;03;05;Sunnuntai;0;0;0;0;0;0
109;04.03.2018;2018;03;06;Sunnuntai;0;0;0;0;0;0
109;04.03.2018;2018;03;07;Sunnuntai;0;1;1;2;2;4
109;04.03.2018;2018;03;08;Sunnuntai;1;0;1;4;2;6
109;04.03.2018;2018;03;09;Sunnuntai;0;2;2;3;3;6
109;04.03.2018;2018;03;10;Sunnuntai;1;0;1;5;4;9
109;04.03.2018;2018;03;11;Sunnuntai;2;3;5;4;2;6
109;04.03.2018;2018;03;12;Sunnuntai;3;1;4;5;0;5
109;04.03.2018;2018;03;13;Sunnuntai;1;4;5;2;3;5
109;04.03.2018;2018;03;14;Sunnuntai;6;3;9;6;3;9
109;04.03.2018;2018;03;15;Sunnuntai;6;3;9;7;2;9
109;04.03.2018;2018;03;16;Sunnuntai;1;1;2;6;4;10
109;04.03.2018;2018;03;17;Sunnuntai;2;2;4;4;1;5
109;04.03.2018;2018;03;18;Sunnuntai;1;1;2;5;1;6
109;04.03.2018;2018;03;19;Sunnuntai;0;0;0;5;5;10
109;04.03.2018;2018;03;20;Sunnuntai;1;6;7;3;1;4
109;04.03.2018;2018;03;21;Sunnuntai;3;1;4;5;1;6
109;04.03.2018;2018;03;22;Sunnuntai;2;3;5;1;0;1
109;04.03.2018;2018;03;23;Sunnuntai;1;0;1;0;0;0
109;05.03.2018;2018;03;00;Maanantai;0;0;0;0;0;0
109;05.03.2018;2018;03;01;Maanantai;0;0;0;0;1;1
109;05.03.2018;2018;03;02;Maanantai;0;0;0;0;0;0
109;05.03.2018;2018;03;03;Maanantai;0;0;0;0;0;0
109;05.03.2018;2018;03;04;Maanantai;0;1;1;0;0;0
109;05.03.2018;2018;03;05;Maanantai;1;3;4;1;0;1
109;05.03.2018;2018;03;06;Maanantai;8;5;13;1;3;4
109;05.03.2018;2018;03;07;Maanantai;10;11;21;5;1;6
109;05.03.2018;2018;03;08;Maanantai;6;4;10;1;1;2
109;05.03.2018;2018;03;09;Maanantai;2;3;5;1;2;3
109;05.03.2018;2018;03;10;Maanantai;3;2;5;2;1;3
109;05.03.2018;2018;03;11;Maanantai;5;1;6;3;8;11
109;05.03.2018;2018;03;12;Maanantai;9;0;9;3;2;5
109;05.03.2018;2018;03;13;Maanantai;3;4;7;4;3;7
109;05.03.2018;2018;03;14;Maanantai;3;4;7;7;0;7
109;05.03.2018;2018;03;15;Maanantai;7;9;16;5;4;9
109;05.03.2018;2018;03;16;Maanantai;16;12;28;9;1;10
109;05.03.2018;2018;03;17;Maanantai;6;9;15;4;3;7
109;05.03.2018;2018;03;18;Maanantai;6;2;8;5;2;7
109;05.03.2018;2018;03;19;Maanantai;1;3;4;4;5;9
109;05.03.2018;2018;03;20;Maanantai;0;0;0;3;3;6
109;05.03.2018;2018;03;21;Maanantai;0;3;3;3;1;4
109;05.03.2018;2018;03;22;Maanantai;2;1;3;0;0;0
109;05.03.2018;2018;03;23;Maanantai;0;0;0;2;0;2
109;06.03.2018;2018;03;00;Tiistai;0;0;0;0;0;0
109;06.03.2018;2018;03;01;Tiistai;0;0;0;0;0;0
109;06.03.2018;2018;03;02;Tiistai;0;0;0;1;2;3
109;06.03.2018;2018;03;03;Tiistai;0;0;0;1;0;1
109;06.03.2018;2018;03;04;Tiistai;0;1;1;0;0;0
109;06.03.2018;2018;03;05;Tiistai;3;1;4;0;0;0
109;06.03.2018;2018;03;06;Tiistai;7;5;12;2;3;5
109;06.03.2018;2018;03;07;Tiistai;7;7;14;3;3;6
109;06.03.2018;2018;03;08;Tiistai;10;4;14;4;3;7
109;06.03.2018;2018;03;09;Tiistai;3;6;9;4;4;8
109;06.03.2018;2018;03;10;Tiistai;3;2;5;7;4;11
109;06.03.2018;2018;03;11;Tiistai;4;2;6;5;5;10
109;06.03.2018;2018;03;12;Tiistai;5;4;9;3;0;3
109;06.03.2018;2018;03;13;Tiistai;6;3;9;1;4;5
109;06.03.2018;2018;03;14;Tiistai;4;1;5;5;0;5
109;06.03.2018;2018;03;15;Tiistai;5;9;14;6;3;9
109;06.03.2018;2018;03;16;Tiistai;17;7;24;5;1;6
109;06.03.2018;2018;03;17;Tiistai;5;10;15;1;5;6
109;06.03.2018;2018;03;18;Tiistai;2;4;6;4;4;8
109;06.03.2018;2018;03;19;Tiistai;2;5;7;7;4;11
109;06.03.2018;2018;03;20;Tiistai;0;4;4;8;4;12
109;06.03.2018;2018;03;21;Tiistai;3;3;6;3;2;5
109;06.03.2018;2018;03;22;Tiistai;1;3;4;0;0;0
109;06.03.2018;2018;03;23;Tiistai;0;0;0;0;0;0
109;07.03.2018;2018;03;00;Keskiviikko;0;0;0;0;0;0
109;07.03.2018;2018;03;01;Keskiviikko;0;0;0;0;2;2
109;07.03.2018;2018;03;02;Keskiviikko;0;0;0;0;2;2
109;07.03.2018;2018;03;03;Keskiviikko;0;0;0;0;0;0
109;07.03.2018;2018;03;04;Keskiviikko;0;2;2;0;0;0
109;07.03.2018;2018;03;05;Keskiviikko;0;1;1;0;0;0
109;07.03.2018;2018;03;06;Keskiviikko;9;7;16;2;0;2
109;07.03.2018;2018;03;07;Keskiviikko;14;16;30;5;0;5
109;07.03.2018;2018;03;08;Keskiviikko;5;3;8;2;2;4
109;07.03.2018;2018;03;09;Keskiviikko;2;5;7;0;1;1
109;07.03.2018;2018;03;10;Keskiviikko;1;1;2;3;5;8
109;07.03.2018;2018;03;11;Keskiviikko;1;0;1;2;4;6
109;07.03.2018;2018;03;12;Keskiviikko;6;1;7;2;2;4
109;07.03.2018;2018;03;13;Keskiviikko;5;5;10;3;1;4
109;07.03.2018;2018;03;14;Keskiviikko;10;3;13;3;1;4
109;07.03.2018;2018;03;15;Keskiviikko;9;12;21;3;6;9
109;07.03.2018;2018;03;16;Keskiviikko;11;6;17;5;3;8
109;07.03.2018;2018;03;17;Keskiviikko;10;5;15;8;3;11
109;07.03.2018;2018;03;18;Keskiviikko;0;0;0;7;1;8
109;07.03.2018;2018;03;19;Keskiviikko;3;4;7;8;1;9
109;07.03.2018;2018;03;20;Keskiviikko;0;2;2;4;5;9
109;07.03.2018;2018;03;21;Keskiviikko;2;3;5;4;4;8
109;07.03.2018;2018;03;22;Keskiviikko;1;4;5;0;1;1
109;07.03.2018;2018;03;23;Keskiviikko;1;0;1;0;1;1
109;08.03.2018;2018;03;00;Torstai;0;0;0;0;0;0
109;08.03.2018;2018;03;01;Torstai;0;0;0;0;0;0
109;08.03.2018;2018;03;02;Torstai;0;0;0;0;0;0
109;08.03.2018;2018;03;03;Torstai;0;0;0;0;0;0
109;08.03.2018;2018;03;04;Torstai;0;1;1;0;0;0
109;08.03.2018;2018;03;05;Torstai;0;3;3;0;1;1
109;08.03.2018;2018;03;06;Torstai;7;5;12;1;3;4
109;08.03.2018;2018;03;07;Torstai;14;12;26;4;1;5
109;08.03.2018;2018;03;08;Torstai;6;4;10;1;1;2
109;08.03.2018;2018;03;09;Torstai;5;2;7;1;1;2
109;08.03.2018;2018;03;10;Torstai;2;2;4;3;2;5
109;08.03.2018;2018;03;11;Torstai;7;3;10;7;2;9
109;08.03.2018;2018;03;12;Torstai;3;1;4;3;2;5
109;08.03.2018;2018;03;13;Torstai;3;2;5;1;4;5
109;08.03.2018;2018;03;14;Torstai;4;6;10;6;4;10
109;08.03.2018;2018;03;15;Torstai;6;13;19;4;2;6
109;08.03.2018;2018;03;16;Torstai;10;9;19;4;3;7
109;08.03.2018;2018;03;17;Torstai;11;4;15;6;3;9
109;08.03.2018;2018;03;18;Torstai;4;3;7;2;2;4
109;08.03.2018;2018;03;19;Torstai;4;3;7;3;4;7
109;08.03.2018;2018;03;20;Torstai;1;2;3;2;2;4
109;08.03.2018;2018;03;21;Torstai;1;0;1;6;1;7
109;08.03.2018;2018;03;22;Torstai;0;1;1;1;0;1
109;08.03.2018;2018;03;23;Torstai;0;0;0;0;0;0
109;09.03.2018;2018;03;00;Perjantai;0;1;1;0;1;1
109;09.03.2018;2018;03;01;Perjantai;1;0;1;1;0;1
109;09.03.2018;2018;03;02;Perjantai;0;0;0;0;1;1
109;09.03.2018;2018;03;03;Perjantai;0;0;0;0;1;1
109;09.03.2018;2018;03;04;Perjantai;0;2;2;0;0;0
109;09.03.2018;2018;03;05;Perjantai;0;2;2;1;1;2
109;09.03.2018;2018;03;06;Perjantai;4;9;13;1;0;1
109;09.03.2018;2018;03;07;Perjantai;13;13;26;3;1;4
109;09.03.2018;2018;03;08;Perjantai;8;5;13;1;1;2
109;09.03.2018;2018;03;09;Perjantai;2;5;7;2;4;6
109;09.03.2018;2018;03;10;Perjantai;4;1;5;4;2;6
109;09.03.2018;2018;03;11;Perjantai;6;3;9;7;2;9
109;09.03.2018;2018;03;12;Perjantai;7;3;10;1;4;5
109;09.03.2018;2018;03;13;Perjantai;5;5;10;4;7;11
109;09.03.2018;2018;03;14;Perjantai;8;3;11;5;0;5
109;09.03.2018;2018;03;15;Perjantai;7;7;14;3;4;7
109;09.03.2018;2018;03;16;Perjantai;10;5;15;1;4;5
109;09.03.2018;2018;03;17;Perjantai;11;5;16;3;0;3
109;09.03.2018;2018;03;18;Perjantai;1;1;2;3;2;5
109;09.03.2018;2018;03;19;Perjantai;3;1;4;4;0;4
109;09.03.2018;2018;03;20;Perjantai;1;0;1;0;0;0
109;09.03.2018;2018;03;21;Perjantai;2;0;2;0;0;0
109;09.03.2018;2018;03;22;Perjantai;0;0;0;0;0;0
109;09.03.2018;2018;03;23;Perjantai;0;0;0;0;0;0
109;10.03.2018;2018;03;00;Lauantai;0;0;0;0;0;0
109;10.03.2018;2018;03;01;Lauantai;1;0;1;0;0;0
109;10.03.2018;2018;03;02;Lauantai;0;0;0;0;0;0
109;10.03.2018;2018;03;03;Lauantai;0;0;0;0;0;0
109;10.03.2018;2018;03;04;Lauantai;0;0;0;0;0;0
109;10.03.2018;2018;03;05;Lauantai;0;0;0;0;0;0
109;10.03.2018;2018;03;06;Lauantai;2;0;2;0;0;0
109;10.03.2018;2018;03;07;Lauantai;1;1;2;0;0;0
109;10.03.2018;2018;03;08;Lauantai;1;0;1;0;0;0
109;10.03.2018;2018;03;09;Lauantai;0;0;0;0;0;0
109;10.03.2018;2018;03;10;Lauantai;2;0;2;0;0;0
109;10.03.2018;2018;03;11;Lauantai;5;4;9;0;0;0
109;10.03.2018;2018;03;12;Lauantai;3;0;3;0;0;0
109;10.03.2018;2018;03;13;Lauantai;5;1;6;2;2;4
109;10.03.2018;2018;03;14;Lauantai;5;3;8;2;0;2
109;10.03.2018;2018;03;15;Lauantai;1;3;4;4;8;12
109;10.03.2018;2018;03;16;Lauantai;3;1;4;7;1;8
109;10.03.2018;2018;03;17;Lauantai;1;1;2;3;4;7
109;10.03.2018;2018;03;18;Lauantai;1;0;1;5;0;5
109;10.03.2018;2018;03;19;Lauantai;3;4;7;5;1;6
109;10.03.2018;2018;03;20;Lauantai;2;0;2;1;4;5
109;10.03.2018;2018;03;21;Lauantai;1;0;1;3;2;5
109;10.03.2018;2018;03;22;Lauantai;1;2;3;4;1;5
109;10.03.2018;2018;03;23;Lauantai;2;2;4;0;0;0
109;11.03.2018;2018;03;00;Sunnuntai;0;2;2;0;0;0
109;11.03.2018;2018;03;01;Sunnuntai;0;0;0;0;0;0
109;11.03.2018;2018;03;02;Sunnuntai;0;0;0;0;1;1
109;11.03.2018;2018;03;03;Sunnuntai;0;0;0;0;0;0
109;11.03.2018;2018;03;04;Sunnuntai;0;0;0;0;0;0
109;11.03.2018;2018;03;05;Sunnuntai;0;0;0;0;0;0
109;11.03.2018;2018;03;06;Sunnuntai;1;0;1;0;0;0
109;11.03.2018;2018;03;07;Sunnuntai;2;1;3;0;0;0
109;11.03.2018;2018;03;08;Sunnuntai;0;0;0;0;0;0
109;11.03.2018;2018;03;09;Sunnuntai;0;0;0;0;0;0
109;11.03.2018;2018;03;10;Sunnuntai;3;0;3;0;0;0
109;11.03.2018;2018;03;11;Sunnuntai;2;2;4;1;5;6
109;11.03.2018;2018;03;12;Sunnuntai;4;1;5;6;4;10
109;11.03.2018;2018;03;13;Sunnuntai;0;2;2;5;4;9
109;11.03.2018;2018;03;14;Sunnuntai;1;2;3;9;2;11
109;11.03.2018;2018;03;15;Sunnuntai;3;2;5;4;1;5
109;11.03.2018;2018;03;16;Sunnuntai;2;0;2;8;4;12
109;11.03.2018;2018;03;17;Sunnuntai;0;0;0;0;0;0
109;11.03.2018;2018;03;18;Sunnuntai;0;0;0;5;2;7
109;11.03.2018;2018;03;19;Sunnuntai;3;1;4;7;4;11
109;11.03.2018;2018;03;20;Sunnuntai;0;1;1;3;5;8
109;11.03.2018;2018;03;21;Sunnuntai;0;2;2;3;0;3
109;11.03.2018;2018;03;22;Sunnuntai;2;0;2;1;2;3
109;11.03.2018;2018;03;23;Sunnuntai;0;0;0;0;0;0
109;12.03.2018;2018;03;00;Maanantai;0;0;0;0;0;0
109;12.03.2018;2018;03;01;Maanantai;0;0;0;0;1;1
109;12.03.2018;2018;03;02;Maanantai;0;0;0;0;0;0
109;12.03.2018;2018;03;03;Maanantai;0;0;0;1;0;1
109;12.03.2018;2018;03;04;Maanantai;0;0;0;1;2;3
109;12.03.2018;2018;03;05;Maanantai;0;4;4;1;0;1
109;12.03.2018;2018;03;06;Maanantai;19;8;27;1;1;2
109;12.03.2018;2018;03;07;Maanantai;31;17;48;5;1;6
109;12.03.2018;2018;03;08;Maanantai;20;8;28;3;3;6
109;12.03.2018;2018;03;09;Maanantai;7;0;7;2;4;6
109;12.03.2018;2018;03;10;Maanantai;5;2;7;6;3;9
109;12.03.2018;2018;03;11;Maanantai;4;5;9;7;2;9
109;12.03.2018;2018;03;12;Maanantai;8;4;12;3;5;8
109;12.03.2018;2018;03;13;Maanantai;5;12;17;5;3;8
109;12.03.2018;2018;03;14;Maanantai;6;6;12;1;0;1
109;12.03.2018;2018;03;15;Maanantai;14;19;33;5;2;7
109;12.03.2018;2018;03;16;Maanantai;19;29;48;8;2;10
109;12.03.2018;2018;03;17;Maanantai;8;19;27;5;5;10
109;12.03.2018;2018;03;18;Maanantai;8;8;16;5;2;7
109;12.03.2018;2018;03;19;Maanantai;1;0;1;11;5;16
109;12.03.2018;2018;03;20;Maanantai;1;9;10;2;3;5
109;12.03.2018;2018;03;21;Maanantai;1;4;5;1;2;3
109;12.03.2018;2018;03;22;Maanantai;5;5;10;0;0;0
109;12.03.2018;2018;03;23;Maanantai;0;1;1;1;0;1
109;13.03.2018;2018;03;00;Tiistai;0;0;0;0;0;0
109;13.03.2018;2018;03;01;Tiistai;0;0;0;0;1;1
109;13.03.2018;2018;03;02;Tiistai;0;0;0;1;0;1
109;13.03.2018;2018;03;03;Tiistai;0;0;0;0;0;0
109;13.03.2018;2018;03;04;Tiistai;0;1;1;0;0;0
109;13.03.2018;2018;03;05;Tiistai;0;1;1;0;0;0
109;13.03.2018;2018;03;06;Tiistai;13;14;27;2;2;4
109;13.03.2018;2018;03;07;Tiistai;32;12;44;3;0;3
109;13.03.2018;2018;03;08;Tiistai;18;7;25;3;1;4
109;13.03.2018;2018;03;09;Tiistai;10;3;13;2;0;2
109;13.03.2018;2018;03;10;Tiistai;4;0;4;5;3;8
109;13.03.2018;2018;03;11;Tiistai;6;2;8;6;3;9
109;13.03.2018;2018;03;12;Tiistai;2;0;2;2;4;6
109;13.03.2018;2018;03;13;Tiistai;2;7;9;4;2;6
109;13.03.2018;2018;03;14;Tiistai;5;2;7;1;2;3
109;13.03.2018;2018;03;15;Tiistai;16;17;33;10;6;16
109;13.03.2018;2018;03;16;Tiistai;17;21;38;3;3;6
109;13.03.2018;2018;03;17;Tiistai;11;6;17;2;0;2
109;13.03.2018;2018;03;18;Tiistai;0;7;7;2;3;5
109;13.03.2018;2018;03;19;Tiistai;2;7;9;9;1;10
109;13.03.2018;2018;03;20;Tiistai;4;5;9;3;3;6
109;13.03.2018;2018;03;21;Tiistai;3;3;6;2;1;3
109;13.03.2018;2018;03;22;Tiistai;1;0;1;0;0;0
109;13.03.2018;2018;03;23;Tiistai;0;0;0;0;0;0
109;14.03.2018;2018;03;00;Keskiviikko;0;0;0;1;0;1
109;14.03.2018;2018;03;01;Keskiviikko;0;0;0;1;0;1
109;14.03.2018;2018;03;02;Keskiviikko;0;0;0;0;0;0
109;14.03.2018;2018;03;03;Keskiviikko;0;1;1;0;0;0
109;14.03.2018;2018;03;04;Keskiviikko;1;0;1;1;1;2
109;14.03.2018;2018;03;05;Keskiviikko;0;2;2;2;2;4
109;14.03.2018;2018;03;06;Keskiviikko;10;9;19;3;4;7
109;14.03.2018;2018;03;07;Keskiviikko;32;13;45;4;1;5
109;14.03.2018;2018;03;08;Keskiviikko;14;9;23;5;3;8
109;14.03.2018;2018;03;09;Keskiviikko;2;1;3;5;1;6
109;14.03.2018;2018;03;10;Keskiviikko;5;2;7;3;3;6
109;14.03.2018;2018;03;11;Keskiviikko;1;1;2;2;4;6
109;14.03.2018;2018;03;12;Keskiviikko;4;4;8;1;0;1
109;14.03.2018;2018;03;13;Keskiviikko;3;5;8;2;2;4
109;14.03.2018;2018;03;14;Keskiviikko;8;4;12;4;3;7
109;14.03.2018;2018;03;15;Keskiviikko;13;16;29;5;3;8
109;14.03.2018;2018;03;16;Keskiviikko;14;23;37;3;4;7
109;14.03.2018;2018;03;17;Keskiviikko;7;8;15;7;2;9
109;14.03.2018;2018;03;18;Keskiviikko;3;6;9;3;6;9
109;14.03.2018;2018;03;19;Keskiviikko;4;1;5;5;2;7
109;14.03.2018;2018;03;20;Keskiviikko;2;4;6;5;1;6
109;14.03.2018;2018;03;21;Keskiviikko;2;5;7;2;2;4
109;14.03.2018;2018;03;22;Keskiviikko;0;5;5;0;0;0
109;14.03.2018;2018;03;23;Keskiviikko;0;0;0;1;2;3
109;15.03.2018;2018;03;00;Torstai;1;0;1;0;0;0
109;15.03.2018;2018;03;01;Torstai;0;0;0;1;0;1
109;15.03.2018;2018;03;02;Torstai;0;0;0;0;0;0
109;15.03.2018;2018;03;03;Torstai;0;0;0;0;0;0
109;15.03.2018;2018;03;04;Torstai;0;0;0;0;0;0
109;15.03.2018;2018;03;05;Torstai;2;3;5;0;0;0
109;15.03.2018;2018;03;06;Torstai;15;9;24;3;1;4
109;15.03.2018;2018;03;07;Torstai;31;14;45;3;0;3
109;15.03.2018;2018;03;08;Torstai;15;6;21;4;1;5
109;15.03.2018;2018;03;09;Torstai;8;1;9;5;3;8
109;15.03.2018;2018;03;10;Torstai;3;4;7;5;5;10
109;15.03.2018;2018;03;11;Torstai;8;1;9;3;2;5
109;15.03.2018;2018;03;12;Torstai;4;2;6;2;5;7
109;15.03.2018;2018;03;13;Torstai;2;9;11;6;5;11
109;15.03.2018;2018;03;14;Torstai;6;10;16;8;2;10
109;15.03.2018;2018;03;15;Torstai;5;21;26;3;6;9
109;15.03.2018;2018;03;16;Torstai;17;24;41;8;3;11
109;15.03.2018;2018;03;17;Torstai;4;8;12;4;2;6
109;15.03.2018;2018;03;18;Torstai;2;3;5;7;5;12
109;15.03.2018;2018;03;19;Torstai;2;2;4;4;6;10
109;15.03.2018;2018;03;20;Torstai;1;3;4;4;2;6
109;15.03.2018;2018;03;21;Torstai;4;4;8;3;1;4
109;15.03.2018;2018;03;22;Torstai;0;4;4;1;1;2
109;15.03.2018;2018;03;23;Torstai;1;2;3;0;0;0
109;16.03.2018;2018;03;00;Perjantai;2;0;2;0;1;1
109;16.03.2018;2018;03;01;Perjantai;0;0;0;0;0;0
109;16.03.2018;2018;03;02;Perjantai;0;0;0;0;0;0
109;16.03.2018;2018;03;03;Perjantai;0;0;0;0;0;0
109;16.03.2018;2018;03;04;Perjantai;0;0;0;0;0;0
109;16.03.2018;2018;03;05;Perjantai;1;1;2;0;0;0
109;16.03.2018;2018;03;06;Perjantai;9;11;20;1;2;3
109;16.03.2018;2018;03;07;Perjantai;19;10;29;2;1;3
109;16.03.2018;2018;03;08;Perjantai;11;6;17;3;1;4
109;16.03.2018;2018;03;09;Perjantai;4;4;8;4;3;7
109;16.03.2018;2018;03;10;Perjantai;2;0;2;6;2;8
109;16.03.2018;2018;03;11;Perjantai;7;1;8;3;4;7
109;16.03.2018;2018;03;12;Perjantai;6;3;9;1;4;5
109;16.03.2018;2018;03;13;Perjantai;3;4;7;5;5;10
109;16.03.2018;2018;03;14;Perjantai;8;9;17;7;6;13
109;16.03.2018;2018;03;15;Perjantai;9;23;32;6;3;9
109;16.03.2018;2018;03;16;Perjantai;14;8;22;5;3;8
109;16.03.2018;2018;03;17;Perjantai;5;17;22;5;4;9
109;16.03.2018;2018;03;18;Perjantai;8;3;11;2;4;6
109;16.03.2018;2018;03;19;Perjantai;2;6;8;4;6;10
109;16.03.2018;2018;03;20;Perjantai;3;3;6;0;2;2
109;16.03.2018;2018;03;21;Perjantai;1;4;5;2;0;2
109;16.03.2018;2018;03;22;Perjantai;3;2;5;2;0;2
109;16.03.2018;2018;03;23;Perjantai;0;1;1;1;0;1
109;17.03.2018;2018;03;00;Lauantai;0;0;0;1;0;1
109;17.03.2018;2018;03;01;Lauantai;0;0;0;1;0;1
109;17.03.2018;2018;03;02;Lauantai;0;0;0;0;0;0
109;17.03.2018;2018;03;03;Lauantai;0;0;0;0;0;0
109;17.03.2018;2018;03;04;Lauantai;0;0;0;0;0;0
109;17.03.2018;2018;03;05;Lauantai;0;0;0;0;0;0
109;17.03.2018;2018;03;06;Lauantai;0;1;1;2;0;2
109;17.03.2018;2018;03;07;Lauantai;1;1;2;1;0;1
109;17.03.2018;2018;03;08;Lauantai;1;0;1;3;3;6
109;17.03.2018;2018;03;09;Lauantai;1;1;2;0;1;1
109;17.03.2018;2018;03;10;Lauantai;1;1;2;0;4;4
109;17.03.2018;2018;03;11;Lauantai;5;4;9;4;3;7
109;17.03.2018;2018;03;12;Lauantai;6;6;12;1;1;2
109;17.03.2018;2018;03;13;Lauantai;1;1;2;5;6;11
109;17.03.2018;2018;03;14;Lauantai;1;2;3;4;1;5
109;17.03.2018;2018;03;15;Lauantai;1;0;1;3;3;6
109;17.03.2018;2018;03;16;Lauantai;2;2;4;5;2;7
109;17.03.2018;2018;03;17;Lauantai;1;4;5;6;0;6
109;17.03.2018;2018;03;18;Lauantai;2;0;2;5;0;5
109;17.03.2018;2018;03;19;Lauantai;4;0;4;2;1;3
109;17.03.2018;2018;03;20;Lauantai;1;0;1;2;1;3
109;17.03.2018;2018;03;21;Lauantai;1;5;6;4;2;6
109;17.03.2018;2018;03;22;Lauantai;1;0;1;0;1;1
109;17.03.2018;2018;03;23;Lauantai;0;0;0;0;1;1
109;18.03.2018;2018;03;00;Sunnuntai;0;2;2;0;0;0
109;18.03.2018;2018;03;01;Sunnuntai;0;1;1;0;0;0
109;18.03.2018;2018;03;02;Sunnuntai;1;0;1;0;0;0
109;18.03.2018;2018;03;03;Sunnuntai;0;1;1;1;1;2
109;18.03.2018;2018;03;04;Sunnuntai;0;0;0;0;0;0
109;18.03.2018;2018;03;05;Sunnuntai;0;1;1;0;0;0
109;18.03.2018;2018;03;06;Sunnuntai;1;0;1;0;1;1
109;18.03.2018;2018;03;07;Sunnuntai;0;6;6;2;2;4
109;18.03.2018;2018;03;08;Sunnuntai;0;0;0;2;3;5
109;18.03.2018;2018;03;09;Sunnuntai;1;1;2;1;5;6
109;18.03.2018;2018;03;10;Sunnuntai;3;4;7;8;4;12
109;18.03.2018;2018;03;11;Sunnuntai;4;2;6;6;3;9
109;18.03.2018;2018;03;12;Sunnuntai;3;0;3;7;5;12
109;18.03.2018;2018;03;13;Sunnuntai;3;0;3;4;1;5
109;18.03.2018;2018;03;14;Sunnuntai;2;2;4;3;4;7
109;18.03.2018;2018;03;15;Sunnuntai;3;3;6;2;1;3
109;18.03.2018;2018;03;16;Sunnuntai;3;4;7;2;0;2
109;18.03.2018;2018;03;17;Sunnuntai;5;3;8;2;0;2
109;18.03.2018;2018;03;18;Sunnuntai;1;2;3;6;3;9
109;18.03.2018;2018;03;19;Sunnuntai;4;1;5;5;1;6
109;18.03.2018;2018;03;20;Sunnuntai;1;5;6;1;3;4
109;18.03.2018;2018;03;21;Sunnuntai;1;1;2;1;4;5
109;18.03.2018;2018;03;22;Sunnuntai;0;1;1;2;0;2
109;18.03.2018;2018;03;23;Sunnuntai;0;0;0;0;0;0
109;19.03.2018;2018;03;00;Maanantai;0;1;1;0;0;0
109;19.03.2018;2018;03;01;Maanantai;0;0;0;0;1;1
109;19.03.2018;2018;03;02;Maanantai;0;0;0;0;0;0
109;19.03.2018;2018;03;03;Maanantai;0;0;0;0;0;0
109;19.03.2018;2018;03;04;Maanantai;0;0;0;0;0;0
109;19.03.2018;2018;03;05;Maanantai;0;5;5;0;0;0
109;19.03.2018;2018;03;06;Maanantai;11;7;18;2;1;3
109;19.03.2018;2018;03;07;Maanantai;33;13;46;5;2;7
109;19.03.2018;2018;03;08;Maanantai;22;5;27;7;1;8
109;19.03.2018;2018;03;09;Maanantai;3;4;7;5;3;8
109;19.03.2018;2018;03;10;Maanantai;4;1;5;5;6;11
109;19.03.2018;2018;03;11;Maanantai;3;6;9;4;1;5
109;19.03.2018;2018;03;12;Maanantai;6;2;8;5;5;10
109;19.03.2018;2018;03;13;Maanantai;8;6;14;3;5;8
109;19.03.2018;2018;03;14;Maanantai;7;3;10;8;7;15
109;19.03.2018;2018;03;15;Maanantai;7;22;29;3;2;5
109;19.03.2018;2018;03;16;Maanantai;15;28;43;8;5;13
109;19.03.2018;2018;03;17;Maanantai;9;8;17;2;3;5
109;19.03.2018;2018;03;18;Maanantai;4;3;7;3;3;6
109;19.03.2018;2018;03;19;Maanantai;3;5;8;3;4;7
109;19.03.2018;2018;03;20;Maanantai;2;7;9;2;2;4
109;19.03.2018;2018;03;21;Maanantai;3;5;8;1;2;3
109;19.03.2018;2018;03;22;Maanantai;3;1;4;0;0;0
109;19.03.2018;2018;03;23;Maanantai;0;1;1;0;1;1
109;20.03.2018;2018;03;00;Tiistai;0;0;0;0;0;0
109;20.03.2018;2018;03;01;Tiistai;0;0;0;1;0;1
109;20.03.2018;2018;03;02;Tiistai;0;0;0;0;0;0
109;20.03.2018;2018;03;03;Tiistai;0;0;0;0;0;0
109;20.03.2018;2018;03;04;Tiistai;0;0;0;0;0;0
109;20.03.2018;2018;03;05;Tiistai;1;2;3;1;1;2
109;20.03.2018;2018;03;06;Tiistai;13;8;21;0;0;0
109;20.03.2018;2018;03;07;Tiistai;28;18;46;3;2;5
109;20.03.2018;2018;03;08;Tiistai;15;5;20;5;3;8
109;20.03.2018;2018;03;09;Tiistai;6;0;6;10;3;13
109;20.03.2018;2018;03;10;Tiistai;1;4;5;3;4;7
109;20.03.2018;2018;03;11;Tiistai;2;0;2;3;9;12
109;20.03.2018;2018;03;12;Tiistai;3;3;6;6;8;14
109;20.03.2018;2018;03;13;Tiistai;7;3;10;4;2;6
109;20.03.2018;2018;03;14;Tiistai;8;6;14;5;4;9
109;20.03.2018;2018;03;15;Tiistai;8;23;31;6;5;11
109;20.03.2018;2018;03;16;Tiistai;17;19;36;5;3;8
109;20.03.2018;2018;03;17;Tiistai;5;18;23;7;5;12
109;20.03.2018;2018;03;18;Tiistai;4;6;10;4;2;6
109;20.03.2018;2018;03;19;Tiistai;1;5;6;1;1;2
109;20.03.2018;2018;03;20;Tiistai;3;6;9;0;2;2
109;20.03.2018;2018;03;21;Tiistai;2;2;4;0;0;0
109;20.03.2018;2018;03;22;Tiistai;3;2;5;1;0;1
109;20.03.2018;2018;03;23;Tiistai;0;0;0;1;0;1
109;21.03.2018;2018;03;00;Keskiviikko;0;0;0;1;1;2
109;21.03.2018;2018;03;01;Keskiviikko;0;0;0;1;0;1
109;21.03.2018;2018;03;02;Keskiviikko;0;0;0;0;0;0
109;21.03.2018;2018;03;03;Keskiviikko;0;0;0;0;0;0
109;21.03.2018;2018;03;04;Keskiviikko;0;0;0;2;0;2
109;21.03.2018;2018;03;05;Keskiviikko;2;4;6;4;0;4
109;21.03.2018;2018;03;06;Keskiviikko;8;6;14;7;0;7
109;21.03.2018;2018;03;07;Keskiviikko;19;18;37;5;0;5
109;21.03.2018;2018;03;08;Keskiviikko;11;9;20;8;0;8
109;21.03.2018;2018;03;09;Keskiviikko;3;1;4;6;0;6
109;21.03.2018;2018;03;10;Keskiviikko;2;0;2;6;0;6
109;21.03.2018;2018;03;11;Keskiviikko;5;2;7;6;0;6
109;21.03.2018;2018;03;12;Keskiviikko;6;5;11;1;0;1
109;21.03.2018;2018;03;13;Keskiviikko;5;2;7;4;0;4
109;21.03.2018;2018;03;14;Keskiviikko;9;7;16;7;0;7
109;21.03.2018;2018;03;15;Keskiviikko;11;8;19;8;0;8
109;21.03.2018;2018;03;16;Keskiviikko;22;20;42;7;0;7
109;21.03.2018;2018;03;17;Keskiviikko;9;8;17;9;0;9
109;21.03.2018;2018;03;18;Keskiviikko;6;4;10;9;0;9
109;21.03.2018;2018;03;19;Keskiviikko;4;2;6;7;0;7
109;21.03.2018;2018;03;20;Keskiviikko;6;4;10;6;0;6
109;21.03.2018;2018;03;21;Keskiviikko;7;4;11;4;0;4
109;21.03.2018;2018;03;22;Keskiviikko;2;2;4;0;0;0
109;21.03.2018;2018;03;23;Keskiviikko;0;0;0;3;0;3
109;22.03.2018;2018;03;00;Torstai;0;0;0;0;0;0
109;22.03.2018;2018;03;01;Torstai;0;0;0;1;0;1
109;22.03.2018;2018;03;02;Torstai;0;0;0;0;0;0
109;22.03.2018;2018;03;03;Torstai;0;0;0;0;0;0
109;22.03.2018;2018;03;04;Torstai;1;0;1;0;0;0
109;22.03.2018;2018;03;05;Torstai;3;1;4;0;0;0
109;22.03.2018;2018;03;06;Torstai;12;11;23;4;0;4
109;22.03.2018;2018;03;07;Torstai;21;19;40;3;0;3
109;22.03.2018;2018;03;08;Torstai;13;10;23;5;0;5
109;22.03.2018;2018;03;09;Torstai;3;0;3;8;0;8
109;22.03.2018;2018;03;10;Torstai;4;1;5;10;0;10
109;22.03.2018;2018;03;11;Torstai;3;3;6;5;0;5
109;22.03.2018;2018;03;12;Torstai;3;4;7;2;3;5
109;22.03.2018;2018;03;13;Torstai;5;3;8;5;8;13
109;22.03.2018;2018;03;14;Torstai;4;5;9;5;6;11
109;22.03.2018;2018;03;15;Torstai;12;15;27;3;2;5
109;22.03.2018;2018;03;16;Torstai;12;16;28;8;2;10
109;22.03.2018;2018;03;17;Torstai;7;17;24;7;5;12
109;22.03.2018;2018;03;18;Torstai;4;2;6;4;2;6
109;22.03.2018;2018;03;19;Torstai;3;5;8;7;6;13
109;22.03.2018;2018;03;20;Torstai;2;6;8;5;3;8
109;22.03.2018;2018;03;21;Torstai;3;2;5;2;1;3
109;22.03.2018;2018;03;22;Torstai;1;2;3;0;0;0
109;22.03.2018;2018;03;23;Torstai;2;0;2;0;0;0
109;23.03.2018;2018;03;00;Perjantai;2;1;3;0;0;0
109;23.03.2018;2018;03;01;Perjantai;0;0;0;0;0;0
109;23.03.2018;2018;03;02;Perjantai;0;0;0;0;0;0
109;23.03.2018;2018;03;03;Perjantai;0;0;0;0;2;2
109;23.03.2018;2018;03;04;Perjantai;0;0;0;0;0;0
109;23.03.2018;2018;03;05;Perjantai;0;1;1;0;0;0
109;23.03.2018;2018;03;06;Perjantai;11;5;16;4;1;5
109;23.03.2018;2018;03;07;Perjantai;18;14;32;3;1;4
109;23.03.2018;2018;03;08;Perjantai;16;6;22;5;1;6
109;23.03.2018;2018;03;09;Perjantai;11;1;12;12;11;23
109;23.03.2018;2018;03;10;Perjantai;2;5;7;7;7;14
109;23.03.2018;2018;03;11;Perjantai;5;6;11;0;2;2
109;23.03.2018;2018;03;12;Perjantai;5;3;8;2;2;4
109;23.03.2018;2018;03;13;Perjantai;4;6;10;3;8;11
109;23.03.2018;2018;03;14;Perjantai;9;7;16;3;3;6
109;23.03.2018;2018;03;15;Perjantai;15;16;31;8;1;9
109;23.03.2018;2018;03;16;Perjantai;10;12;22;2;1;3
109;23.03.2018;2018;03;17;Perjantai;3;7;10;4;1;5
109;23.03.2018;2018;03;18;Perjantai;1;1;2;5;2;7
109;23.03.2018;2018;03;19;Perjantai;4;1;5;1;4;5
109;23.03.2018;2018;03;20;Perjantai;4;1;5;2;0;2
109;23.03.2018;2018;03;21;Perjantai;1;2;3;4;0;4
109;23.03.2018;2018;03;22;Perjantai;1;0;1;0;3;3
109;23.03.2018;2018;03;23;Perjantai;0;0;0;0;2;2
109;24.03.2018;2018;03;00;Lauantai;0;0;0;1;0;1
109;24.03.2018;2018;03;01;Lauantai;0;0;0;1;0;1
109;24.03.2018;2018;03;02;Lauantai;0;0;0;0;0;0
109;24.03.2018;2018;03;03;Lauantai;1;0;1;0;2;2
109;24.03.2018;2018;03;04;Lauantai;0;0;0;0;0;0
109;24.03.2018;2018;03;05;Lauantai;1;0;1;0;0;0
109;24.03.2018;2018;03;06;Lauantai;1;1;2;2;1;3
109;24.03.2018;2018;03;07;Lauantai;1;1;2;1;0;1
109;24.03.2018;2018;03;08;Lauantai;0;0;0;6;2;8
109;24.03.2018;2018;03;09;Lauantai;6;1;7;1;1;2
109;24.03.2018;2018;03;10;Lauantai;4;1;5;4;1;5
109;24.03.2018;2018;03;11;Lauantai;6;4;10;7;1;8
109;24.03.2018;2018;03;12;Lauantai;1;6;7;2;0;2
109;24.03.2018;2018;03;13;Lauantai;2;1;3;11;0;11
109;24.03.2018;2018;03;14;Lauantai;4;2;6;5;0;5
109;24.03.2018;2018;03;15;Lauantai;2;0;2;6;0;6
109;24.03.2018;2018;03;16;Lauantai;1;2;3;7;0;7
109;24.03.2018;2018;03;17;Lauantai;1;4;5;6;0;6
109;24.03.2018;2018;03;18;Lauantai;1;0;1;5;0;5
109;24.03.2018;2018;03;19;Lauantai;4;0;4;3;0;3
109;24.03.2018;2018;03;20;Lauantai;4;0;4;3;0;3
109;24.03.2018;2018;03;21;Lauantai;4;5;9;6;0;6
109;24.03.2018;2018;03;22;Lauantai;0;0;0;1;0;1
109;24.03.2018;2018;03;23;Lauantai;1;0;1;1;0;1
109;25.03.2018;2018;03;00;Sunnuntai;1;0;1;0;0;0
109;25.03.2018;2018;03;01;Sunnuntai;0;0;0;0;0;0
109;25.03.2018;2018;03;02;Sunnuntai;0;0;0;0;0;0
109;25.03.2018;2018;03;03;Sunnuntai;0;0;0;0;0;0
109;25.03.2018;2018;03;04;Sunnuntai;0;0;0;0;0;0
109;25.03.2018;2018;03;05;Sunnuntai;0;0;0;0;0;0
109;25.03.2018;2018;03;06;Sunnuntai;3;0;3;0;0;0
109;25.03.2018;2018;03;07;Sunnuntai;1;1;2;0;0;0
109;25.03.2018;2018;03;08;Sunnuntai;0;0;0;0;0;0
109;25.03.2018;2018;03;09;Sunnuntai;0;0;0;0;0;0
109;25.03.2018;2018;03;10;Sunnuntai;2;1;3;0;1;1
109;25.03.2018;2018;03;11;Sunnuntai;3;1;4;0;0;0
109;25.03.2018;2018;03;12;Sunnuntai;0;3;3;0;2;2
109;25.03.2018;2018;03;13;Sunnuntai;1;3;4;6;3;9
109;25.03.2018;2018;03;14;Sunnuntai;2;2;4;2;5;7
109;25.03.2018;2018;03;15;Sunnuntai;3;4;7;14;9;23
109;25.03.2018;2018;03;16;Sunnuntai;5;3;8;8;6;14
109;25.03.2018;2018;03;17;Sunnuntai;1;0;1;6;3;9
109;25.03.2018;2018;03;18;Sunnuntai;2;3;5;6;3;9
109;25.03.2018;2018;03;19;Sunnuntai;4;2;6;3;1;4
109;25.03.2018;2018;03;20;Sunnuntai;1;2;3;6;5;11
109;25.03.2018;2018;03;21;Sunnuntai;1;1;2;8;1;9
109;25.03.2018;2018;03;22;Sunnuntai;0;0;0;0;0;0
109;25.03.2018;2018;03;23;Sunnuntai;0;0;0;1;0;1
109;26.03.2018;2018;03;00;Maanantai;0;0;0;0;1;1
109;26.03.2018;2018;03;01;Maanantai;0;0;0;0;0;0
109;26.03.2018;2018;03;02;Maanantai;0;0;0;0;0;0
109;26.03.2018;2018;03;03;Maanantai;0;0;0;0;0;0
109;26.03.2018;2018;03;04;Maanantai;0;0;0;0;0;0
109;26.03.2018;2018;03;05;Maanantai;1;2;3;1;2;3
109;26.03.2018;2018;03;06;Maanantai;8;3;11;2;1;3
109;26.03.2018;2018;03;07;Maanantai;21;13;34;1;1;2
109;26.03.2018;2018;03;08;Maanantai;25;9;34;3;0;3
109;26.03.2018;2018;03;09;Maanantai;6;0;6;6;0;6
109;26.03.2018;2018;03;10;Maanantai;7;2;9;2;4;6
109;26.03.2018;2018;03;11;Maanantai;6;6;12;0;0;0
109;26.03.2018;2018;03;12;Maanantai;7;8;15;6;2;8
109;26.03.2018;2018;03;13;Maanantai;8;6;14;1;2;3
109;26.03.2018;2018;03;14;Maanantai;7;6;13;11;8;19
109;26.03.2018;2018;03;15;Maanantai;11;19;30;7;4;11
109;26.03.2018;2018;03;16;Maanantai;15;19;34;7;3;10
109;26.03.2018;2018;03;17;Maanantai;7;17;24;5;2;7
109;26.03.2018;2018;03;18;Maanantai;3;9;12;8;2;10
109;26.03.2018;2018;03;19;Maanantai;5;1;6;7;5;12
109;26.03.2018;2018;03;20;Maanantai;2;6;8;6;3;9
109;26.03.2018;2018;03;21;Maanantai;1;4;5;1;1;2
109;26.03.2018;2018;03;22;Maanantai;6;6;12;0;0;0
109;26.03.2018;2018;03;23;Maanantai;0;2;2;0;0;0
109;27.03.2018;2018;03;00;Tiistai;1;0;1;1;0;1
109;27.03.2018;2018;03;01;Tiistai;0;0;0;0;0;0
109;27.03.2018;2018;03;02;Tiistai;0;0;0;0;0;0
109;27.03.2018;2018;03;03;Tiistai;0;0;0;0;1;1
109;27.03.2018;2018;03;04;Tiistai;0;0;0;0;0;0
109;27.03.2018;2018;03;05;Tiistai;1;3;4;0;0;0
109;27.03.2018;2018;03;06;Tiistai;11;5;16;2;2;4
109;27.03.2018;2018;03;07;Tiistai;28;12;40;4;0;4
109;27.03.2018;2018;03;08;Tiistai;18;7;25;7;3;10
109;27.03.2018;2018;03;09;Tiistai;11;2;13;6;1;7
109;27.03.2018;2018;03;10;Tiistai;1;0;1;3;3;6
109;27.03.2018;2018;03;11;Tiistai;9;3;12;1;2;3
109;27.03.2018;2018;03;12;Tiistai;6;3;9;4;5;9
109;27.03.2018;2018;03;13;Tiistai;4;5;9;4;4;8
109;27.03.2018;2018;03;14;Tiistai;9;7;16;7;7;14
109;27.03.2018;2018;03;15;Tiistai;7;9;16;10;5;15
109;27.03.2018;2018;03;16;Tiistai;16;29;45;5;0;5
109;27.03.2018;2018;03;17;Tiistai;8;13;21;5;0;5
109;27.03.2018;2018;03;18;Tiistai;5;5;10;3;4;7
109;27.03.2018;2018;03;19;Tiistai;2;2;4;3;4;7
109;27.03.2018;2018;03;20;Tiistai;3;9;12;1;5;6
109;27.03.2018;2018;03;21;Tiistai;3;4;7;3;1;4
109;27.03.2018;2018;03;22;Tiistai;4;0;4;1;0;1
109;27.03.2018;2018;03;23;Tiistai;0;0;0;0;2;2
109;28.03.2018;2018;03;00;Keskiviikko;0;0;0;0;1;1
109;28.03.2018;2018;03;01;Keskiviikko;0;0;0;0;0;0
109;28.03.2018;2018;03;02;Keskiviikko;0;0;0;1;1;2
109;28.03.2018;2018;03;03;Keskiviikko;0;0;0;1;0;1
109;28.03.2018;2018;03;04;Keskiviikko;0;0;0;0;0;0
109;28.03.2018;2018;03;05;Keskiviikko;2;2;4;0;1;1
109;28.03.2018;2018;03;06;Keskiviikko;9;7;16;4;0;4
109;28.03.2018;2018;03;07;Keskiviikko;23;15;38;2;1;3
109;28.03.2018;2018;03;08;Keskiviikko;20;5;25;5;0;5
109;28.03.2018;2018;03;09;Keskiviikko;10;3;13;11;4;15
109;28.03.2018;2018;03;10;Keskiviikko;5;1;6;6;6;12
109;28.03.2018;2018;03;11;Keskiviikko;2;6;8;2;2;4
109;28.03.2018;2018;03;12;Keskiviikko;4;5;9;2;0;2
109;28.03.2018;2018;03;13;Keskiviikko;10;6;16;2;3;5
109;28.03.2018;2018;03;14;Keskiviikko;7;8;15;3;3;6
109;28.03.2018;2018;03;15;Keskiviikko;9;11;20;3;3;6
109;28.03.2018;2018;03;16;Keskiviikko;17;21;38;8;5;13
109;28.03.2018;2018;03;17;Keskiviikko;7;11;18;2;3;5
109;28.03.2018;2018;03;18;Keskiviikko;7;7;14;3;6;9
109;28.03.2018;2018;03;19;Keskiviikko;3;3;6;7;7;14
109;28.03.2018;2018;03;20;Keskiviikko;3;6;9;5;2;7
109;28.03.2018;2018;03;21;Keskiviikko;3;5;8;1;2;3
109;28.03.2018;2018;03;22;Keskiviikko;4;3;7;4;1;5
109;28.03.2018;2018;03;23;Keskiviikko;0;0;0;0;0;0
109;29.03.2018;2018;03;00;Torstai;0;0;0;1;0;1
109;29.03.2018;2018;03;01;Torstai;0;1;1;0;0;0
109;29.03.2018;2018;03;02;Torstai;0;0;0;0;1;1
109;29.03.2018;2018;03;03;Torstai;0;0;0;1;0;1
109;29.03.2018;2018;03;04;Torstai;0;0;0;0;0;0
109;29.03.2018;2018;03;05;Torstai;1;4;5;0;0;0
109;29.03.2018;2018;03;06;Torstai;11;6;17;0;1;1
109;29.03.2018;2018;03;07;Torstai;25;13;38;4;2;6
109;29.03.2018;2018;03;08;Torstai;17;7;24;9;1;10
109;29.03.2018;2018;03;09;Torstai;6;2;8;5;2;7
109;29.03.2018;2018;03;10;Torstai;2;5;7;3;3;6
109;29.03.2018;2018;03;11;Torstai;6;10;16;3;2;5
109;29.03.2018;2018;03;12;Torstai;7;2;9;1;3;4
109;29.03.2018;2018;03;13;Torstai;11;0;11;6;0;6
109;29.03.2018;2018;03;14;Torstai;23;0;23;11;0;11
109;29.03.2018;2018;03;15;Torstai;19;0;19;10;0;10
109;29.03.2018;2018;03;16;Torstai;22;0;22;12;0;12
109;29.03.2018;2018;03;17;Torstai;18;0;18;8;0;8
109;29.03.2018;2018;03;18;Torstai;9;0;9;5;0;5
109;29.03.2018;2018;03;19;Torstai;4;0;4;3;0;3
109;29.03.2018;2018;03;20;Torstai;9;0;9;3;0;3
109;29.03.2018;2018;03;21;Torstai;7;0;7;2;0;2
109;29.03.2018;2018;03;22;Torstai;2;0;2;1;0;1
109;29.03.2018;2018;03;23;Torstai;3;0;3;1;0;1
109;30.03.2018;2018;03;00;Perjantai;0;0;0;0;0;0
109;30.03.2018;2018;03;01;Perjantai;2;0;2;1;0;1
109;30.03.2018;2018;03;02;Perjantai;2;0;2;0;0;0
109;30.03.2018;2018;03;03;Perjantai;2;0;2;0;0;0
109;30.03.2018;2018;03;04;Perjantai;1;0;1;0;0;0
109;30.03.2018;2018;03;05;Perjantai;0;0;0;0;0;0
109;30.03.2018;2018;03;06;Perjantai;5;0;5;2;0;2
109;30.03.2018;2018;03;07;Perjantai;0;0;0;0;0;0
109;30.03.2018;2018;03;08;Perjantai;4;0;4;2;0;2
109;30.03.2018;2018;03;09;Perjantai;7;0;7;4;0;4
109;30.03.2018;2018;03;10;Perjantai;10;0;10;5;0;5
109;30.03.2018;2018;03;11;Perjantai;11;0;11;6;0;6
109;30.03.2018;2018;03;12;Perjantai;9;0;9;5;0;5
109;30.03.2018;2018;03;13;Perjantai;13;0;13;8;0;8
109;30.03.2018;2018;03;14;Perjantai;7;0;7;4;0;4
109;30.03.2018;2018;03;15;Perjantai;7;0;7;4;0;4
109;30.03.2018;2018;03;16;Perjantai;9;0;9;4;0;4
109;30.03.2018;2018;03;17;Perjantai;4;0;4;2;0;2
109;30.03.2018;2018;03;18;Perjantai;9;0;9;5;0;5
109;30.03.2018;2018;03;19;Perjantai;5;0;5;3;0;3
109;30.03.2018;2018;03;20;Perjantai;4;0;4;2;0;2
109;30.03.2018;2018;03;21;Perjantai;4;0;4;1;0;1
109;30.03.2018;2018;03;22;Perjantai;2;0;2;1;0;1
109;30.03.2018;2018;03;23;Perjantai;0;0;0;0;0;0
109;31.03.2018;2018;03;00;Lauantai;0;0;0;0;0;0
109;31.03.2018;2018;03;01;Lauantai;0;0;0;0;0;0
109;31.03.2018;2018;03;02;Lauantai;0;0;0;0;0;0
109;31.03.2018;2018;03;03;Lauantai;1;0;1;0;0;0
109;31.03.2018;2018;03;04;Lauantai;1;0;1;0;0;0
109;31.03.2018;2018;03;05;Lauantai;1;0;1;0;0;0
109;31.03.2018;2018;03;06;Lauantai;3;0;3;2;0;2
109;31.03.2018;2018;03;07;Lauantai;2;0;2;1;0;1
109;31.03.2018;2018;03;08;Lauantai;3;0;3;1;0;1
109;31.03.2018;2018;03;09;Lauantai;6;0;6;1;0;1
109;31.03.2018;2018;03;10;Lauantai;6;0;6;3;0;3
109;31.03.2018;2018;03;11;Lauantai;6;0;6;5;0;5
109;31.03.2018;2018;03;12;Lauantai;5;0;5;2;0;2
109;31.03.2018;2018;03;13;Lauantai;7;0;7;3;0;3
109;31.03.2018;2018;03;14;Lauantai;8;0;8;4;0;4
109;31.03.2018;2018;03;15;Lauantai;9;0;9;4;0;4
109;31.03.2018;2018;03;16;Lauantai;5;0;5;2;0;2
109;31.03.2018;2018;03;17;Lauantai;8;0;8;6;0;6
109;31.03.2018;2018;03;18;Lauantai;8;0;8;4;0;4
109;31.03.2018;2018;03;19;Lauantai;5;0;5;4;0;4
109;31.03.2018;2018;03;20;Lauantai;5;0;5;3;0;3
109;31.03.2018;2018;03;21;Lauantai;2;0;2;0;0;0
109;31.03.2018;2018;03;22;Lauantai;1;0;1;1;0;1
109;31.03.2018;2018;03;23;Lauantai;3;0;3;0;0;0
109;01.04.2018;2018;04;00;Sunnuntai;0;0;0;0;0;0
109;01.04.2018;2018;04;01;Sunnuntai;2;0;2;1;0;1
109;01.04.2018;2018;04;02;Sunnuntai;2;0;2;1;0;1
109;01.04.2018;2018;04;03;Sunnuntai;1;0;1;1;0;1
109;01.04.2018;2018;04;04;Sunnuntai;0;0;0;0;0;0
109;01.04.2018;2018;04;05;Sunnuntai;0;0;0;0;0;0
109;01.04.2018;2018;04;06;Sunnuntai;3;0;3;1;0;1
109;01.04.2018;2018;04;07;Sunnuntai;3;0;3;1;0;1
109;01.04.2018;2018;04;08;Sunnuntai;3;0;3;1;0;1
109;01.04.2018;2018;04;09;Sunnuntai;1;0;1;0;0;0
109;01.04.2018;2018;04;10;Sunnuntai;8;0;8;4;0;4
109;01.04.2018;2018;04;11;Sunnuntai;13;0;13;7;0;7
109;01.04.2018;2018;04;12;Sunnuntai;8;0;8;4;0;4
109;01.04.2018;2018;04;13;Sunnuntai;10;0;10;6;0;6
109;01.04.2018;2018;04;14;Sunnuntai;5;0;5;3;0;3
109;01.04.2018;2018;04;15;Sunnuntai;13;0;13;7;0;7
109;01.04.2018;2018;04;16;Sunnuntai;10;0;10;4;0;4
109;01.04.2018;2018;04;17;Sunnuntai;10;0;10;5;0;5
109;01.04.2018;2018;04;18;Sunnuntai;8;0;8;4;0;4
109;01.04.2018;2018;04;19;Sunnuntai;7;0;7;2;0;2
109;01.04.2018;2018;04;20;Sunnuntai;6;0;6;2;0;2
109;01.04.2018;2018;04;21;Sunnuntai;4;0;4;1;0;1
109;01.04.2018;2018;04;22;Sunnuntai;3;0;3;2;0;2
109;01.04.2018;2018;04;23;Sunnuntai;1;0;1;1;0;1
109;02.04.2018;2018;04;00;Maanantai;2;0;2;0;0;0
109;02.04.2018;2018;04;01;Maanantai;0;0;0;0;0;0
109;02.04.2018;2018;04;02;Maanantai;0;0;0;0;0;0
109;02.04.2018;2018;04;03;Maanantai;1;0;1;0;0;0
109;02.04.2018;2018;04;04;Maanantai;0;0;0;0;0;0
109;02.04.2018;2018;04;05;Maanantai;2;0;2;1;0;1
109;02.04.2018;2018;04;06;Maanantai;2;0;2;1;0;1
109;02.04.2018;2018;04;07;Maanantai;1;0;1;0;0;0
109;02.04.2018;2018;04;08;Maanantai;3;0;3;2;0;2
109;02.04.2018;2018;04;09;Maanantai;5;0;5;2;0;2
109;02.04.2018;2018;04;10;Maanantai;15;0;15;8;0;8
109;02.04.2018;2018;04;11;Maanantai;11;0;11;5;0;5
109;02.04.2018;2018;04;12;Maanantai;10;0;10;4;0;4
109;02.04.2018;2018;04;13;Maanantai;10;0;10;5;0;5
109;02.04.2018;2018;04;14;Maanantai;7;0;7;3;0;3
109;02.04.2018;2018;04;15;Maanantai;9;0;9;5;0;5
109;02.04.2018;2018;04;16;Maanantai;10;0;10;5;0;5
109;02.04.2018;2018;04;17;Maanantai;8;0;8;4;0;4
109;02.04.2018;2018;04;18;Maanantai;6;0;6;4;0;4
109;02.04.2018;2018;04;19;Maanantai;9;0;9;5;0;5
109;02.04.2018;2018;04;20;Maanantai;7;0;7;3;0;3
109;02.04.2018;2018;04;21;Maanantai;6;0;6;4;0;4
109;02.04.2018;2018;04;22;Maanantai;3;0;3;2;0;2
109;02.04.2018;2018;04;23;Maanantai;1;0;1;0;0;0
109;03.04.2018;2018;04;00;Tiistai;2;0;2;0;0;0
109;03.04.2018;2018;04;01;Tiistai;0;0;0;0;0;0
109;03.04.2018;2018;04;02;Tiistai;0;0;0;0;0;0
109;03.04.2018;2018;04;03;Tiistai;0;0;0;0;0;0
109;03.04.2018;2018;04;04;Tiistai;1;0;1;0;0;0
109;03.04.2018;2018;04;05;Tiistai;3;0;3;1;0;1
109;03.04.2018;2018;04;06;Tiistai;19;0;19;8;0;8
109;03.04.2018;2018;04;07;Tiistai;26;0;26;11;0;11
109;03.04.2018;2018;04;08;Tiistai;20;0;20;11;0;11
109;03.04.2018;2018;04;09;Tiistai;30;0;30;14;0;14
109;03.04.2018;2018;04;10;Tiistai;9;0;9;4;0;4
109;03.04.2018;2018;04;11;Tiistai;10;0;10;6;0;6
109;03.04.2018;2018;04;12;Tiistai;12;0;12;6;0;6
109;03.04.2018;2018;04;13;Tiistai;10;0;10;5;0;5
109;03.04.2018;2018;04;14;Tiistai;16;0;16;7;0;7
109;03.04.2018;2018;04;15;Tiistai;22;0;22;9;0;9
109;03.04.2018;2018;04;16;Tiistai;25;0;25;10;0;10
109;03.04.2018;2018;04;17;Tiistai;18;0;18;8;0;8
109;03.04.2018;2018;04;18;Tiistai;18;0;18;8;0;8
109;03.04.2018;2018;04;19;Tiistai;6;0;6;3;0;3
109;03.04.2018;2018;04;20;Tiistai;10;0;10;5;0;5
109;03.04.2018;2018;04;21;Tiistai;5;0;5;2;0;2
109;03.04.2018;2018;04;22;Tiistai;1;0;1;1;0;1
109;03.04.2018;2018;04;23;Tiistai;2;0;2;0;0;0
109;04.04.2018;2018;04;00;Keskiviikko;3;0;3;2;0;2
109;04.04.2018;2018;04;01;Keskiviikko;1;0;1;0;0;0
109;04.04.2018;2018;04;02;Keskiviikko;1;0;1;0;0;0
109;04.04.2018;2018;04;03;Keskiviikko;0;0;0;0;0;0
109;04.04.2018;2018;04;04;Keskiviikko;1;0;1;0;0;0
109;04.04.2018;2018;04;05;Keskiviikko;5;0;5;3;0;3
109;04.04.2018;2018;04;06;Keskiviikko;20;0;20;9;0;9
109;04.04.2018;2018;04;07;Keskiviikko;29;0;29;14;0;14
109;04.04.2018;2018;04;08;Keskiviikko;21;0;21;10;0;10
109;04.04.2018;2018;04;09;Keskiviikko;6;0;6;3;0;3
109;04.04.2018;2018;04;10;Keskiviikko;22;0;22;10;0;10
109;04.04.2018;2018;04;11;Keskiviikko;12;0;12;7;0;7
109;04.04.2018;2018;04;12;Keskiviikko;20;0;20;9;0;9
109;04.04.2018;2018;04;13;Keskiviikko;13;0;13;6;0;6
109;04.04.2018;2018;04;14;Keskiviikko;19;0;19;9;0;9
109;04.04.2018;2018;04;15;Keskiviikko;22;0;22;9;0;9
109;04.04.2018;2018;04;16;Keskiviikko;35;0;35;16;0;16
109;04.04.2018;2018;04;17;Keskiviikko;13;0;13;7;0;7
109;04.04.2018;2018;04;18;Keskiviikko;13;0;13;6;0;6
109;04.04.2018;2018;04;19;Keskiviikko;18;0;18;8;0;8
109;04.04.2018;2018;04;20;Keskiviikko;11;0;11;4;0;4
109;04.04.2018;2018;04;21;Keskiviikko;6;0;6;3;0;3
109;04.04.2018;2018;04;22;Keskiviikko;5;0;5;2;0;2
109;04.04.2018;2018;04;23;Keskiviikko;3;0;3;0;0;0
109;05.04.2018;2018;04;00;Torstai;0;0;0;0;0;0
109;05.04.2018;2018;04;01;Torstai;0;0;0;0;0;0
109;05.04.2018;2018;04;02;Torstai;0;0;0;0;0;0
109;05.04.2018;2018;04;03;Torstai;0;0;0;0;0;0
109;05.04.2018;2018;04;04;Torstai;0;0;0;0;0;0
109;05.04.2018;2018;04;05;Torstai;3;0;3;2;0;2
109;05.04.2018;2018;04;06;Torstai;19;0;19;10;0;10
109;05.04.2018;2018;04;07;Torstai;27;0;27;14;0;14
109;05.04.2018;2018;04;08;Torstai;22;0;22;11;0;11
109;05.04.2018;2018;04;09;Torstai;9;0;9;4;0;4
109;05.04.2018;2018;04;10;Torstai;13;0;13;5;0;5
109;05.04.2018;2018;04;11;Torstai;15;0;15;7;0;7
109;05.04.2018;2018;04;12;Torstai;11;0;11;5;0;5
109;05.04.2018;2018;04;13;Torstai;11;0;11;7;0;7
109;05.04.2018;2018;04;14;Torstai;13;0;13;7;0;7
109;05.04.2018;2018;04;15;Torstai;16;0;16;8;0;8
109;05.04.2018;2018;04;16;Torstai;25;0;25;13;0;13
109;05.04.2018;2018;04;17;Torstai;11;0;11;5;0;5
109;05.04.2018;2018;04;18;Torstai;20;0;20;9;0;9
109;05.04.2018;2018;04;19;Torstai;11;0;11;6;0;6
109;05.04.2018;2018;04;20;Torstai;11;0;11;5;0;5
109;05.04.2018;2018;04;21;Torstai;8;0;8;4;0;4
109;05.04.2018;2018;04;22;Torstai;3;0;3;2;0;2
109;05.04.2018;2018;04;23;Torstai;3;0;3;0;0;0
109;06.04.2018;2018;04;00;Perjantai;2;0;2;0;0;0
109;06.04.2018;2018;04;01;Perjantai;1;0;1;0;0;0
109;06.04.2018;2018;04;02;Perjantai;0;0;0;0;0;0
109;06.04.2018;2018;04;03;Perjantai;1;0;1;0;0;0
109;06.04.2018;2018;04;04;Perjantai;0;0;0;0;0;0
109;06.04.2018;2018;04;05;Perjantai;1;0;1;1;0;1
109;06.04.2018;2018;04;06;Perjantai;10;0;10;5;0;5
109;06.04.2018;2018;04;07;Perjantai;26;0;26;13;0;13
109;06.04.2018;2018;04;08;Perjantai;9;0;9;5;0;5
109;06.04.2018;2018;04;09;Perjantai;3;0;3;1;0;1
109;06.04.2018;2018;04;10;Perjantai;19;0;19;9;0;9
109;06.04.2018;2018;04;11;Perjantai;4;0;4;2;0;2
109;06.04.2018;2018;04;12;Perjantai;6;0;6;3;0;3
109;06.04.2018;2018;04;13;Perjantai;4;0;4;3;0;3
109;06.04.2018;2018;04;14;Perjantai;12;0;12;8;0;8
109;06.04.2018;2018;04;15;Perjantai;13;0;13;5;0;5
109;06.04.2018;2018;04;16;Perjantai;21;0;21;12;0;12
109;06.04.2018;2018;04;17;Perjantai;9;0;9;5;0;5
109;06.04.2018;2018;04;18;Perjantai;6;0;6;2;0;2
109;06.04.2018;2018;04;19;Perjantai;7;0;7;4;0;4
109;06.04.2018;2018;04;20;Perjantai;8;0;8;4;0;4
109;06.04.2018;2018;04;21;Perjantai;4;0;4;3;0;3
109;06.04.2018;2018;04;22;Perjantai;2;0;2;1;0;1
109;06.04.2018;2018;04;23;Perjantai;1;0;1;0;0;0
109;07.04.2018;2018;04;00;Lauantai;0;0;0;0;0;0
109;07.04.2018;2018;04;01;Lauantai;1;0;1;0;0;0
109;07.04.2018;2018;04;02;Lauantai;1;0;1;0;0;0
109;07.04.2018;2018;04;03;Lauantai;0;0;0;0;0;0
109;07.04.2018;2018;04;04;Lauantai;1;0;1;0;0;0
109;07.04.2018;2018;04;05;Lauantai;0;0;0;0;0;0
109;07.04.2018;2018;04;06;Lauantai;3;0;3;1;0;1
109;07.04.2018;2018;04;07;Lauantai;2;0;2;1;0;1
109;07.04.2018;2018;04;08;Lauantai;7;0;7;6;0;6
109;07.04.2018;2018;04;09;Lauantai;6;0;6;3;0;3
109;07.04.2018;2018;04;10;Lauantai;8;0;8;5;0;5
109;07.04.2018;2018;04;11;Lauantai;8;0;8;6;0;6
109;07.04.2018;2018;04;12;Lauantai;7;0;7;5;0;5
109;07.04.2018;2018;04;13;Lauantai;5;0;5;4;0;4
109;07.04.2018;2018;04;14;Lauantai;5;0;5;3;0;3
109;07.04.2018;2018;04;15;Lauantai;6;0;6;4;0;4
109;07.04.2018;2018;04;16;Lauantai;3;0;3;2;0;2
109;07.04.2018;2018;04;17;Lauantai;4;0;4;3;0;3
109;07.04.2018;2018;04;18;Lauantai;3;0;3;2;0;2
109;07.04.2018;2018;04;19;Lauantai;9;0;9;6;0;6
109;07.04.2018;2018;04;20;Lauantai;9;0;9;7;0;7
109;07.04.2018;2018;04;21;Lauantai;7;0;7;5;0;5
109;07.04.2018;2018;04;22;Lauantai;5;0;5;3;0;3
109;07.04.2018;2018;04;23;Lauantai;1;0;1;0;0;0
109;08.04.2018;2018;04;00;Sunnuntai;1;0;1;1;0;1
109;08.04.2018;2018;04;01;Sunnuntai;2;0;2;0;0;0
109;08.04.2018;2018;04;02;Sunnuntai;2;0;2;1;0;1
109;08.04.2018;2018;04;03;Sunnuntai;1;0;1;0;0;0
109;08.04.2018;2018;04;04;Sunnuntai;0;0;0;0;0;0
109;08.04.2018;2018;04;05;Sunnuntai;1;0;1;0;0;0
109;08.04.2018;2018;04;06;Sunnuntai;2;0;2;0;0;0
109;08.04.2018;2018;04;07;Sunnuntai;2;0;2;2;0;2
109;08.04.2018;2018;04;08;Sunnuntai;4;0;4;1;0;1
109;08.04.2018;2018;04;09;Sunnuntai;7;0;7;6;0;6
109;08.04.2018;2018;04;10;Sunnuntai;3;0;3;1;0;1
109;08.04.2018;2018;04;11;Sunnuntai;8;0;8;6;0;6
109;08.04.2018;2018;04;12;Sunnuntai;8;0;8;6;0;6
109;08.04.2018;2018;04;13;Sunnuntai;7;0;7;5;0;5
109;08.04.2018;2018;04;14;Sunnuntai;9;0;9;6;0;6
109;08.04.2018;2018;04;15;Sunnuntai;5;0;5;4;0;4
109;08.04.2018;2018;04;16;Sunnuntai;10;0;10;7;0;7
109;08.04.2018;2018;04;17;Sunnuntai;4;0;4;2;0;2
109;08.04.2018;2018;04;18;Sunnuntai;17;0;17;14;0;14
109;08.04.2018;2018;04;19;Sunnuntai;8;0;8;5;0;5
109;08.04.2018;2018;04;20;Sunnuntai;5;0;5;2;0;2
109;08.04.2018;2018;04;21;Sunnuntai;3;0;3;1;0;1
109;08.04.2018;2018;04;22;Sunnuntai;0;0;0;0;0;0
109;08.04.2018;2018;04;23;Sunnuntai;1;0;1;0;0;0
109;09.04.2018;2018;04;00;Maanantai;0;0;0;0;1;1
109;09.04.2018;2018;04;01;Maanantai;0;0;0;0;0;0
109;09.04.2018;2018;04;02;Maanantai;0;0;0;0;0;0
109;09.04.2018;2018;04;03;Maanantai;0;0;0;0;0;0
109;09.04.2018;2018;04;04;Maanantai;0;0;0;0;0;0
109;09.04.2018;2018;04;05;Maanantai;1;3;4;0;1;1
109;09.04.2018;2018;04;06;Maanantai;10;8;18;0;0;0
109;09.04.2018;2018;04;07;Maanantai;20;10;30;2;0;2
109;09.04.2018;2018;04;08;Maanantai;15;8;23;4;1;5
109;09.04.2018;2018;04;09;Maanantai;18;17;35;3;3;6
109;09.04.2018;2018;04;10;Maanantai;4;2;6;2;3;5
109;09.04.2018;2018;04;11;Maanantai;6;2;8;2;2;4
109;09.04.2018;2018;04;12;Maanantai;6;2;8;1;1;2
109;09.04.2018;2018;04;13;Maanantai;4;4;8;4;5;9
109;09.04.2018;2018;04;14;Maanantai;11;5;16;8;3;11
109;09.04.2018;2018;04;15;Maanantai;14;15;29;4;4;8
109;09.04.2018;2018;04;16;Maanantai;13;20;33;5;3;8
109;09.04.2018;2018;04;17;Maanantai;4;9;13;4;0;4
109;09.04.2018;2018;04;18;Maanantai;5;2;7;6;0;6
109;09.04.2018;2018;04;19;Maanantai;0;6;6;9;6;15
109;09.04.2018;2018;04;20;Maanantai;3;6;9;7;3;10
109;09.04.2018;2018;04;21;Maanantai;1;5;6;1;2;3
109;09.04.2018;2018;04;22;Maanantai;1;0;1;1;1;2
109;09.04.2018;2018;04;23;Maanantai;0;0;0;0;1;1
109;10.04.2018;2018;04;00;Tiistai;0;0;0;0;0;0
109;10.04.2018;2018;04;01;Tiistai;0;0;0;0;0;0
109;10.04.2018;2018;04;02;Tiistai;0;0;0;1;0;1
109;10.04.2018;2018;04;03;Tiistai;0;0;0;0;0;0
109;10.04.2018;2018;04;04;Tiistai;0;0;0;0;1;1
109;10.04.2018;2018;04;05;Tiistai;1;3;4;0;0;0
109;10.04.2018;2018;04;06;Tiistai;11;8;19;0;0;0
109;10.04.2018;2018;04;07;Tiistai;30;16;46;2;0;2
109;10.04.2018;2018;04;08;Tiistai;21;10;31;4;1;5
109;10.04.2018;2018;04;09;Tiistai;3;2;5;2;4;6
109;10.04.2018;2018;04;10;Tiistai;4;1;5;1;3;4
109;10.04.2018;2018;04;11;Tiistai;6;0;6;3;1;4
109;10.04.2018;2018;04;12;Tiistai;8;1;9;3;1;4
109;10.04.2018;2018;04;13;Tiistai;4;5;9;4;1;5
109;10.04.2018;2018;04;14;Tiistai;9;7;16;6;1;7
109;10.04.2018;2018;04;15;Tiistai;13;18;31;8;3;11
109;10.04.2018;2018;04;16;Tiistai;11;17;28;6;7;13
109;10.04.2018;2018;04;17;Tiistai;4;11;15;8;3;11
109;10.04.2018;2018;04;18;Tiistai;1;9;10;2;3;5
109;10.04.2018;2018;04;19;Tiistai;4;2;6;5;6;11
109;10.04.2018;2018;04;20;Tiistai;2;4;6;4;3;7
109;10.04.2018;2018;04;21;Tiistai;3;3;6;1;0;1
109;10.04.2018;2018;04;22;Tiistai;0;2;2;1;0;1
109;10.04.2018;2018;04;23;Tiistai;0;0;0;1;1;2
109;11.04.2018;2018;04;00;Keskiviikko;0;0;0;1;0;1
109;11.04.2018;2018;04;01;Keskiviikko;0;0;0;0;0;0
109;11.04.2018;2018;04;02;Keskiviikko;0;0;0;0;1;1
109;11.04.2018;2018;04;03;Keskiviikko;0;0;0;0;0;0
109;11.04.2018;2018;04;04;Keskiviikko;0;0;0;0;0;0
109;11.04.2018;2018;04;05;Keskiviikko;1;5;6;0;0;0
109;11.04.2018;2018;04;06;Keskiviikko;11;7;18;5;1;6
109;11.04.2018;2018;04;07;Keskiviikko;25;14;39;0;2;2
109;11.04.2018;2018;04;08;Keskiviikko;26;11;37;3;2;5
109;11.04.2018;2018;04;09;Keskiviikko;8;0;8;3;6;9
109;11.04.2018;2018;04;10;Keskiviikko;1;0;1;5;10;15
109;11.04.2018;2018;04;11;Keskiviikko;4;2;6;5;5;10
109;11.04.2018;2018;04;12;Keskiviikko;7;4;11;1;8;9
109;11.04.2018;2018;04;13;Keskiviikko;7;4;11;3;5;8
109;11.04.2018;2018;04;14;Keskiviikko;9;11;20;11;4;15
109;11.04.2018;2018;04;15;Keskiviikko;13;11;24;2;3;5
109;11.04.2018;2018;04;16;Keskiviikko;18;34;52;10;2;12
109;11.04.2018;2018;04;17;Keskiviikko;7;10;17;7;0;7
109;11.04.2018;2018;04;18;Keskiviikko;5;7;12;4;1;5
109;11.04.2018;2018;04;19;Keskiviikko;2;4;6;8;3;11
109;11.04.2018;2018;04;20;Keskiviikko;2;5;7;1;3;4
109;11.04.2018;2018;04;21;Keskiviikko;6;8;14;4;1;5
109;11.04.2018;2018;04;22;Keskiviikko;0;0;0;0;0;0
109;11.04.2018;2018;04;23;Keskiviikko;0;1;1;0;0;0
109;12.04.2018;2018;04;00;Torstai;0;0;0;0;2;2
109;12.04.2018;2018;04;01;Torstai;0;0;0;0;0;0
109;12.04.2018;2018;04;02;Torstai;0;0;0;0;0;0
109;12.04.2018;2018;04;03;Torstai;0;0;0;0;1;1
109;12.04.2018;2018;04;04;Torstai;0;0;0;2;0;2
109;12.04.2018;2018;04;05;Torstai;0;2;2;0;1;1
109;12.04.2018;2018;04;06;Torstai;10;9;19;3;0;3
109;12.04.2018;2018;04;07;Torstai;28;14;42;0;2;2
109;12.04.2018;2018;04;08;Torstai;30;9;39;4;2;6
109;12.04.2018;2018;04;09;Torstai;4;3;7;3;7;10
109;12.04.2018;2018;04;10;Torstai;2;3;5;3;2;5
109;12.04.2018;2018;04;11;Torstai;5;2;7;2;4;6
109;12.04.2018;2018;04;12;Torstai;8;3;11;2;1;3
109;12.04.2018;2018;04;13;Torstai;4;6;10;1;6;7
109;12.04.2018;2018;04;14;Torstai;5;8;13;8;6;14
109;12.04.2018;2018;04;15;Torstai;22;19;41;2;0;2
109;12.04.2018;2018;04;16;Torstai;11;36;47;6;3;9
109;12.04.2018;2018;04;17;Torstai;6;5;11;7;5;12
109;12.04.2018;2018;04;18;Torstai;8;6;14;7;1;8
109;12.04.2018;2018;04;19;Torstai;1;4;5;3;2;5
109;12.04.2018;2018;04;20;Torstai;1;6;7;6;4;10
109;12.04.2018;2018;04;21;Torstai;3;3;6;2;0;2
109;12.04.2018;2018;04;22;Torstai;2;2;4;1;1;2
109;12.04.2018;2018;04;23;Torstai;1;0;1;0;0;0
109;13.04.2018;2018;04;00;Perjantai;0;0;0;0;0;0
109;13.04.2018;2018;04;01;Perjantai;0;0;0;0;0;0
109;13.04.2018;2018;04;02;Perjantai;0;0;0;0;0;0
109;13.04.2018;2018;04;03;Perjantai;0;0;0;1;1;2
109;13.04.2018;2018;04;04;Perjantai;0;0;0;0;0;0
109;13.04.2018;2018;04;05;Perjantai;4;2;6;0;0;0
109;13.04.2018;2018;04;06;Perjantai;5;7;12;0;1;1
109;13.04.2018;2018;04;07;Perjantai;17;12;29;0;1;1
109;13.04.2018;2018;04;08;Perjantai;17;10;27;2;0;2
109;13.04.2018;2018;04;09;Perjantai;10;1;11;2;1;3
109;13.04.2018;2018;04;10;Perjantai;5;5;10;5;1;6
109;13.04.2018;2018;04;11;Perjantai;7;0;7;9;3;12
109;13.04.2018;2018;04;12;Perjantai;7;2;9;6;4;10
109;13.04.2018;2018;04;13;Perjantai;6;4;10;1;2;3
109;13.04.2018;2018;04;14;Perjantai;9;10;19;2;1;3
109;13.04.2018;2018;04;15;Perjantai;12;11;23;7;5;12
109;13.04.2018;2018;04;16;Perjantai;12;20;32;3;2;5
109;13.04.2018;2018;04;17;Perjantai;8;6;14;6;4;10
109;13.04.2018;2018;04;18;Perjantai;5;0;5;3;4;7
109;13.04.2018;2018;04;19;Perjantai;4;5;9;4;2;6
109;13.04.2018;2018;04;20;Perjantai;0;5;5;4;2;6
109;13.04.2018;2018;04;21;Perjantai;7;5;12;0;1;1
109;13.04.2018;2018;04;22;Perjantai;3;2;5;1;0;1
109;13.04.2018;2018;04;23;Perjantai;0;1;1;0;0;0
109;14.04.2018;2018;04;00;Lauantai;0;0;0;0;0;0
109;14.04.2018;2018;04;01;Lauantai;0;0;0;0;0;0
109;14.04.2018;2018;04;02;Lauantai;0;0;0;0;0;0
109;14.04.2018;2018;04;03;Lauantai;0;0;0;0;0;0
109;14.04.2018;2018;04;04;Lauantai;0;1;1;0;0;0
109;14.04.2018;2018;04;05;Lauantai;0;2;2;3;2;5
109;14.04.2018;2018;04;06;Lauantai;1;2;3;1;0;1
109;14.04.2018;2018;04;07;Lauantai;1;1;2;0;1;1
109;14.04.2018;2018;04;08;Lauantai;4;0;4;1;3;4
109;14.04.2018;2018;04;09;Lauantai;2;3;5;8;1;9
109;14.04.2018;2018;04;10;Lauantai;1;0;1;3;6;9
109;14.04.2018;2018;04;11;Lauantai;6;3;9;6;2;8
109;14.04.2018;2018;04;12;Lauantai;8;1;9;7;6;13
109;14.04.2018;2018;04;13;Lauantai;4;2;6;7;2;9
109;14.04.2018;2018;04;14;Lauantai;5;4;9;1;4;5
109;14.04.2018;2018;04;15;Lauantai;5;3;8;2;1;3
109;14.04.2018;2018;04;16;Lauantai;5;0;5;5;2;7
109;14.04.2018;2018;04;17;Lauantai;5;2;7;2;7;9
109;14.04.2018;2018;04;18;Lauantai;4;2;6;1;2;3
109;14.04.2018;2018;04;19;Lauantai;5;7;12;7;3;10
109;14.04.2018;2018;04;20;Lauantai;2;2;4;3;0;3
109;14.04.2018;2018;04;21;Lauantai;0;4;4;2;1;3
109;14.04.2018;2018;04;22;Lauantai;0;1;1;2;0;2
109;14.04.2018;2018;04;23;Lauantai;1;0;1;0;0;0
109;15.04.2018;2018;04;00;Sunnuntai;0;1;1;0;0;0
109;15.04.2018;2018;04;01;Sunnuntai;0;1;1;0;0;0
109;15.04.2018;2018;04;02;Sunnuntai;0;0;0;0;1;1
109;15.04.2018;2018;04;03;Sunnuntai;0;0;0;1;0;1
109;15.04.2018;2018;04;04;Sunnuntai;1;1;2;0;0;0
109;15.04.2018;2018;04;05;Sunnuntai;0;1;1;0;0;0
109;15.04.2018;2018;04;06;Sunnuntai;2;1;3;2;2;4
109;15.04.2018;2018;04;07;Sunnuntai;1;2;3;1;0;1
109;15.04.2018;2018;04;08;Sunnuntai;0;3;3;5;0;5
109;15.04.2018;2018;04;09;Sunnuntai;3;0;3;4;3;7
109;15.04.2018;2018;04;10;Sunnuntai;4;2;6;4;6;10
109;15.04.2018;2018;04;11;Sunnuntai;9;2;11;9;8;17
109;15.04.2018;2018;04;12;Sunnuntai;7;2;9;11;3;14
109;15.04.2018;2018;04;13;Sunnuntai;1;3;4;4;1;5
109;15.04.2018;2018;04;14;Sunnuntai;4;7;11;13;9;22
109;15.04.2018;2018;04;15;Sunnuntai;13;4;17;7;1;8
109;15.04.2018;2018;04;16;Sunnuntai;7;1;8;7;3;10
109;15.04.2018;2018;04;17;Sunnuntai;6;4;10;5;2;7
109;15.04.2018;2018;04;18;Sunnuntai;10;4;14;6;4;10
109;15.04.2018;2018;04;19;Sunnuntai;5;4;9;6;3;9
109;15.04.2018;2018;04;20;Sunnuntai;5;3;8;2;2;4
109;15.04.2018;2018;04;21;Sunnuntai;1;3;4;0;1;1
109;15.04.2018;2018;04;22;Sunnuntai;2;1;3;0;0;0
109;15.04.2018;2018;04;23;Sunnuntai;0;0;0;0;0;0
109;16.04.2018;2018;04;00;Maanantai;0;0;0;0;0;0
109;16.04.2018;2018;04;01;Maanantai;0;0;0;0;1;1
109;16.04.2018;2018;04;02;Maanantai;0;0;0;0;1;1
109;16.04.2018;2018;04;03;Maanantai;0;1;1;0;0;0
109;16.04.2018;2018;04;04;Maanantai;0;3;3;0;0;0
109;16.04.2018;2018;04;05;Maanantai;1;1;2;0;0;0
109;16.04.2018;2018;04;06;Maanantai;15;13;28;1;1;2
109;16.04.2018;2018;04;07;Maanantai;32;12;44;6;3;9
109;16.04.2018;2018;04;08;Maanantai;24;4;28;5;4;9
109;16.04.2018;2018;04;09;Maanantai;8;5;13;4;3;7
109;16.04.2018;2018;04;10;Maanantai;7;1;8;2;4;6
109;16.04.2018;2018;04;11;Maanantai;12;6;18;3;4;7
109;16.04.2018;2018;04;12;Maanantai;7;1;8;1;5;6
109;16.04.2018;2018;04;13;Maanantai;12;7;19;2;5;7
109;16.04.2018;2018;04;14;Maanantai;6;5;11;5;2;7
109;16.04.2018;2018;04;15;Maanantai;12;22;34;6;4;10
109;16.04.2018;2018;04;16;Maanantai;17;37;54;7;1;8
109;16.04.2018;2018;04;17;Maanantai;12;17;29;3;3;6
109;16.04.2018;2018;04;18;Maanantai;15;9;24;7;4;11
109;16.04.2018;2018;04;19;Maanantai;5;6;11;6;9;15
109;16.04.2018;2018;04;20;Maanantai;2;4;6;3;0;3
109;16.04.2018;2018;04;21;Maanantai;1;3;4;2;0;2
109;16.04.2018;2018;04;22;Maanantai;4;1;5;3;1;4
109;16.04.2018;2018;04;23;Maanantai;0;0;0;0;0;0
109;17.04.2018;2018;04;00;Tiistai;0;0;0;0;1;1
109;17.04.2018;2018;04;01;Tiistai;0;0;0;1;0;1
109;17.04.2018;2018;04;02;Tiistai;0;0;0;0;1;1
109;17.04.2018;2018;04;03;Tiistai;0;0;0;0;0;0
109;17.04.2018;2018;04;04;Tiistai;0;1;1;0;0;0
109;17.04.2018;2018;04;05;Tiistai;0;2;2;0;0;0
109;17.04.2018;2018;04;06;Tiistai;19;10;29;1;2;3
109;17.04.2018;2018;04;07;Tiistai;39;18;57;2;3;5
109;17.04.2018;2018;04;08;Tiistai;24;7;31;4;1;5
109;17.04.2018;2018;04;09;Tiistai;10;3;13;6;5;11
109;17.04.2018;2018;04;10;Tiistai;10;1;11;4;2;6
109;17.04.2018;2018;04;11;Tiistai;7;3;10;1;2;3
109;17.04.2018;2018;04;12;Tiistai;7;5;12;3;2;5
109;17.04.2018;2018;04;13;Tiistai;13;6;19;1;2;3
109;17.04.2018;2018;04;14;Tiistai;7;6;13;3;3;6
109;17.04.2018;2018;04;15;Tiistai;12;20;32;2;6;8
109;17.04.2018;2018;04;16;Tiistai;25;37;62;7;3;10
109;17.04.2018;2018;04;17;Tiistai;17;11;28;1;4;5
109;17.04.2018;2018;04;18;Tiistai;12;10;22;4;6;10
109;17.04.2018;2018;04;19;Tiistai;8;5;13;9;4;13
109;17.04.2018;2018;04;20;Tiistai;2;10;12;6;1;7
109;17.04.2018;2018;04;21;Tiistai;3;7;10;2;3;5
109;17.04.2018;2018;04;22;Tiistai;3;3;6;1;0;1
109;17.04.2018;2018;04;23;Tiistai;1;0;1;0;0;0
109;18.04.2018;2018;04;00;Keskiviikko;0;0;0;0;0;0
109;18.04.2018;2018;04;01;Keskiviikko;0;0;0;1;1;2
109;18.04.2018;2018;04;02;Keskiviikko;0;0;0;0;0;0
109;18.04.2018;2018;04;03;Keskiviikko;0;0;0;1;2;3
109;18.04.2018;2018;04;04;Keskiviikko;0;0;0;0;0;0
109;18.04.2018;2018;04;05;Keskiviikko;2;2;4;0;0;0
109;18.04.2018;2018;04;06;Keskiviikko;17;4;21;1;1;2
109;18.04.2018;2018;04;07;Keskiviikko;43;15;58;2;4;6
109;18.04.2018;2018;04;08;Keskiviikko;30;12;42;2;1;3
109;18.04.2018;2018;04;09;Keskiviikko;8;4;12;2;5;7
109;18.04.2018;2018;04;10;Keskiviikko;6;3;9;3;7;10
109;18.04.2018;2018;04;11;Keskiviikko;5;5;10;4;5;9
109;18.04.2018;2018;04;12;Keskiviikko;6;3;9;1;3;4
109;18.04.2018;2018;04;13;Keskiviikko;9;9;18;7;2;9
109;18.04.2018;2018;04;14;Keskiviikko;9;15;24;4;5;9
109;18.04.2018;2018;04;15;Keskiviikko;19;27;46;7;4;11
109;18.04.2018;2018;04;16;Keskiviikko;16;29;45;7;2;9
109;18.04.2018;2018;04;17;Keskiviikko;17;11;28;3;4;7
109;18.04.2018;2018;04;18;Keskiviikko;12;12;24;7;7;14
109;18.04.2018;2018;04;19;Keskiviikko;12;9;21;3;6;9
109;18.04.2018;2018;04;20;Keskiviikko;8;4;12;8;2;10
109;18.04.2018;2018;04;21;Keskiviikko;3;7;10;5;1;6
109;18.04.2018;2018;04;22;Keskiviikko;2;2;4;2;0;2
109;18.04.2018;2018;04;23;Keskiviikko;1;0;1;0;0;0
109;19.04.2018;2018;04;00;Torstai;0;0;0;1;3;4
109;19.04.2018;2018;04;01;Torstai;0;0;0;0;0;0
109;19.04.2018;2018;04;02;Torstai;0;0;0;0;0;0
109;19.04.2018;2018;04;03;Torstai;1;0;1;1;0;1
109;19.04.2018;2018;04;04;Torstai;0;0;0;0;0;0
109;19.04.2018;2018;04;05;Torstai;1;3;4;0;0;0
109;19.04.2018;2018;04;06;Torstai;12;11;23;1;0;1
109;19.04.2018;2018;04;07;Torstai;43;14;57;1;2;3
109;19.04.2018;2018;04;08;Torstai;27;8;35;5;2;7
109;19.04.2018;2018;04;09;Torstai;6;1;7;4;2;6
109;19.04.2018;2018;04;10;Torstai;6;3;9;1;5;6
109;19.04.2018;2018;04;11;Torstai;11;1;12;4;0;4
109;19.04.2018;2018;04;12;Torstai;12;5;17;7;3;10
109;19.04.2018;2018;04;13;Torstai;5;6;11;2;3;5
109;19.04.2018;2018;04;14;Torstai;14;15;29;3;4;7
109;19.04.2018;2018;04;15;Torstai;10;14;24;3;2;5
109;19.04.2018;2018;04;16;Torstai;20;42;62;6;7;13
109;19.04.2018;2018;04;17;Torstai;15;20;35;5;0;5
109;19.04.2018;2018;04;18;Torstai;7;6;13;4;1;5
109;19.04.2018;2018;04;19;Torstai;9;6;15;4;4;8
109;19.04.2018;2018;04;20;Torstai;5;2;7;4;1;5
109;19.04.2018;2018;04;21;Torstai;3;6;9;1;0;1
109;19.04.2018;2018;04;22;Torstai;4;3;7;1;0;1
109;19.04.2018;2018;04;23;Torstai;1;0;1;0;0;0
109;20.04.2018;2018;04;00;Perjantai;0;0;0;0;2;2
109;20.04.2018;2018;04;01;Perjantai;0;0;0;0;0;0
109;20.04.2018;2018;04;02;Perjantai;0;0;0;1;0;1
109;20.04.2018;2018;04;03;Perjantai;0;0;0;0;1;1
109;20.04.2018;2018;04;04;Perjantai;0;1;1;1;0;1
109;20.04.2018;2018;04;05;Perjantai;1;3;4;0;0;0
109;20.04.2018;2018;04;06;Perjantai;12;8;20;2;3;5
109;20.04.2018;2018;04;07;Perjantai;22;8;30;1;1;2
109;20.04.2018;2018;04;08;Perjantai;13;8;21;3;3;6
109;20.04.2018;2018;04;09;Perjantai;5;1;6;0;2;2
109;20.04.2018;2018;04;10;Perjantai;3;2;5;2;2;4
109;20.04.2018;2018;04;11;Perjantai;2;2;4;3;1;4
109;20.04.2018;2018;04;12;Perjantai;7;4;11;4;2;6
109;20.04.2018;2018;04;13;Perjantai;2;3;5;3;3;6
109;20.04.2018;2018;04;14;Perjantai;13;18;31;8;4;12
109;20.04.2018;2018;04;15;Perjantai;11;15;26;5;5;10
109;20.04.2018;2018;04;16;Perjantai;9;20;29;2;2;4
109;20.04.2018;2018;04;17;Perjantai;5;10;15;1;4;5
109;20.04.2018;2018;04;18;Perjantai;1;3;4;4;4;8
109;20.04.2018;2018;04;19;Perjantai;4;8;12;9;1;10
109;20.04.2018;2018;04;20;Perjantai;1;2;3;10;8;18
109;20.04.2018;2018;04;21;Perjantai;8;1;9;2;1;3
109;20.04.2018;2018;04;22;Perjantai;3;1;4;2;1;3
109;20.04.2018;2018;04;23;Perjantai;1;0;1;1;3;4
109;21.04.2018;2018;04;00;Lauantai;1;0;1;1;1;2
109;21.04.2018;2018;04;01;Lauantai;0;0;0;0;0;0
109;21.04.2018;2018;04;02;Lauantai;1;1;2;1;0;1
109;21.04.2018;2018;04;03;Lauantai;0;0;0;0;0;0
109;21.04.2018;2018;04;04;Lauantai;0;0;0;0;0;0
109;21.04.2018;2018;04;05;Lauantai;0;0;0;0;0;0
109;21.04.2018;2018;04;06;Lauantai;3;0;3;1;2;3
109;21.04.2018;2018;04;07;Lauantai;2;1;3;3;2;5
109;21.04.2018;2018;04;08;Lauantai;2;2;4;1;1;2
109;21.04.2018;2018;04;09;Lauantai;6;1;7;3;6;9
109;21.04.2018;2018;04;10;Lauantai;6;2;8;6;3;9
109;21.04.2018;2018;04;11;Lauantai;3;6;9;8;3;11
109;21.04.2018;2018;04;12;Lauantai;10;5;15;4;0;4
109;21.04.2018;2018;04;13;Lauantai;6;2;8;5;5;10
109;21.04.2018;2018;04;14;Lauantai;3;4;7;4;4;8
109;21.04.2018;2018;04;15;Lauantai;4;12;16;3;2;5
109;21.04.2018;2018;04;16;Lauantai;5;4;9;3;3;6
109;21.04.2018;2018;04;17;Lauantai;7;7;14;4;1;5
109;21.04.2018;2018;04;18;Lauantai;3;2;5;5;1;6
109;21.04.2018;2018;04;19;Lauantai;2;5;7;6;4;10
109;21.04.2018;2018;04;20;Lauantai;7;0;7;4;3;7
109;21.04.2018;2018;04;21;Lauantai;3;1;4;2;2;4
109;21.04.2018;2018;04;22;Lauantai;2;3;5;1;4;5
109;21.04.2018;2018;04;23;Lauantai;2;0;2;0;1;1
109;22.04.2018;2018;04;00;Sunnuntai;0;1;1;0;0;0
109;22.04.2018;2018;04;01;Sunnuntai;0;0;0;0;0;0
109;22.04.2018;2018;04;02;Sunnuntai;0;0;0;0;0;0
109;22.04.2018;2018;04;03;Sunnuntai;0;0;0;0;0;0
109;22.04.2018;2018;04;04;Sunnuntai;0;2;2;0;1;1
109;22.04.2018;2018;04;05;Sunnuntai;2;0;2;1;0;1
109;22.04.2018;2018;04;06;Sunnuntai;1;1;2;0;0;0
109;22.04.2018;2018;04;07;Sunnuntai;0;0;0;1;1;2
109;22.04.2018;2018;04;08;Sunnuntai;2;1;3;5;3;8
109;22.04.2018;2018;04;09;Sunnuntai;4;1;5;4;5;9
109;22.04.2018;2018;04;10;Sunnuntai;5;5;10;6;5;11
109;22.04.2018;2018;04;11;Sunnuntai;9;3;12;5;4;9
109;22.04.2018;2018;04;12;Sunnuntai;13;9;22;13;7;20
109;22.04.2018;2018;04;13;Sunnuntai;9;10;19;7;5;12
109;22.04.2018;2018;04;14;Sunnuntai;14;5;19;7;2;9
109;22.04.2018;2018;04;15;Sunnuntai;10;11;21;6;2;8
109;22.04.2018;2018;04;16;Sunnuntai;7;8;15;8;4;12
109;22.04.2018;2018;04;17;Sunnuntai;8;8;16;8;1;9
109;22.04.2018;2018;04;18;Sunnuntai;4;7;11;7;7;14
109;22.04.2018;2018;04;19;Sunnuntai;5;0;5;4;5;9
109;22.04.2018;2018;04;20;Sunnuntai;6;4;10;6;2;8
109;22.04.2018;2018;04;21;Sunnuntai;2;3;5;1;1;2
109;22.04.2018;2018;04;22;Sunnuntai;0;0;0;4;0;4
109;22.04.2018;2018;04;23;Sunnuntai;0;0;0;0;0;0
109;23.04.2018;2018;04;00;Maanantai;1;0;1;1;1;2
109;23.04.2018;2018;04;01;Maanantai;2;0;2;0;0;0
109;23.04.2018;2018;04;02;Maanantai;0;0;0;1;0;1
109;23.04.2018;2018;04;03;Maanantai;0;0;0;0;1;1
109;23.04.2018;2018;04;04;Maanantai;0;0;0;2;0;2
109;23.04.2018;2018;04;05;Maanantai;2;6;8;0;1;1
109;23.04.2018;2018;04;06;Maanantai;22;12;34;2;0;2
109;23.04.2018;2018;04;07;Maanantai;39;15;54;1;2;3
109;23.04.2018;2018;04;08;Maanantai;30;16;46;6;1;7
109;23.04.2018;2018;04;09;Maanantai;16;1;17;5;6;11
109;23.04.2018;2018;04;10;Maanantai;9;1;10;7;4;11
109;23.04.2018;2018;04;11;Maanantai;13;12;25;33;22;55
109;23.04.2018;2018;04;12;Maanantai;11;13;24;12;4;16
109;23.04.2018;2018;04;13;Maanantai;6;1;7;6;3;9
109;23.04.2018;2018;04;14;Maanantai;16;13;29;5;9;14
109;23.04.2018;2018;04;15;Maanantai;16;30;46;5;7;12
109;23.04.2018;2018;04;16;Maanantai;18;40;58;4;5;9
109;23.04.2018;2018;04;17;Maanantai;17;16;33;6;6;12
109;23.04.2018;2018;04;18;Maanantai;11;15;26;8;3;11
109;23.04.2018;2018;04;19;Maanantai;6;5;11;6;7;13
109;23.04.2018;2018;04;20;Maanantai;4;6;10;9;2;11
109;23.04.2018;2018;04;21;Maanantai;2;7;9;4;2;6
109;23.04.2018;2018;04;22;Maanantai;2;1;3;1;0;1
109;23.04.2018;2018;04;23;Maanantai;0;0;0;0;1;1
109;24.04.2018;2018;04;00;Tiistai;1;2;3;2;2;4
109;24.04.2018;2018;04;01;Tiistai;0;3;3;4;0;4
109;24.04.2018;2018;04;02;Tiistai;0;0;0;1;0;1
109;24.04.2018;2018;04;03;Tiistai;0;0;0;0;0;0
109;24.04.2018;2018;04;04;Tiistai;0;0;0;0;1;1
109;24.04.2018;2018;04;05;Tiistai;3;4;7;0;0;0
109;24.04.2018;2018;04;06;Tiistai;24;10;34;3;0;3
109;24.04.2018;2018;04;07;Tiistai;46;19;65;1;3;4
109;24.04.2018;2018;04;08;Tiistai;27;7;34;6;3;9
109;24.04.2018;2018;04;09;Tiistai;11;2;13;2;4;6
109;24.04.2018;2018;04;10;Tiistai;8;6;14;2;1;3
109;24.04.2018;2018;04;11;Tiistai;11;2;13;6;1;7
109;24.04.2018;2018;04;12;Tiistai;6;3;9;1;2;3
109;24.04.2018;2018;04;13;Tiistai;6;8;14;1;2;3
109;24.04.2018;2018;04;14;Tiistai;7;13;20;2;1;3
109;24.04.2018;2018;04;15;Tiistai;21;23;44;6;5;11
109;24.04.2018;2018;04;16;Tiistai;16;38;54;5;5;10
109;24.04.2018;2018;04;17;Tiistai;11;9;20;5;1;6
109;24.04.2018;2018;04;18;Tiistai;6;6;12;10;4;14
109;24.04.2018;2018;04;19;Tiistai;4;6;10;2;5;7
109;24.04.2018;2018;04;20;Tiistai;2;5;7;4;5;9
109;24.04.2018;2018;04;21;Tiistai;1;2;3;0;2;2
109;24.04.2018;2018;04;22;Tiistai;0;1;1;0;0;0
109;24.04.2018;2018;04;23;Tiistai;1;0;1;1;1;2
109;25.04.2018;2018;04;00;Keskiviikko;0;0;0;0;0;0
109;25.04.2018;2018;04;01;Keskiviikko;0;0;0;0;0;0
109;25.04.2018;2018;04;02;Keskiviikko;1;0;1;0;0;0
109;25.04.2018;2018;04;03;Keskiviikko;0;0;0;0;1;1
109;25.04.2018;2018;04;04;Keskiviikko;0;0;0;0;0;0
109;25.04.2018;2018;04;05;Keskiviikko;2;2;4;0;0;0
109;25.04.2018;2018;04;06;Keskiviikko;17;11;28;3;0;3
109;25.04.2018;2018;04;07;Keskiviikko;40;17;57;3;3;6
109;25.04.2018;2018;04;08;Keskiviikko;24;8;32;2;1;3
109;25.04.2018;2018;04;09;Keskiviikko;9;0;9;2;6;8
109;25.04.2018;2018;04;10;Keskiviikko;6;5;11;4;7;11
109;25.04.2018;2018;04;11;Keskiviikko;7;4;11;4;3;7
109;25.04.2018;2018;04;12;Keskiviikko;12;10;22;2;3;5
109;25.04.2018;2018;04;13;Keskiviikko;9;7;16;1;5;6
109;25.04.2018;2018;04;14;Keskiviikko;21;8;29;5;1;6
109;25.04.2018;2018;04;15;Keskiviikko;17;17;34;1;1;2
109;25.04.2018;2018;04;16;Keskiviikko;11;42;53;6;3;9
109;25.04.2018;2018;04;17;Keskiviikko;16;12;28;3;2;5
109;25.04.2018;2018;04;18;Keskiviikko;11;9;20;4;5;9
109;25.04.2018;2018;04;19;Keskiviikko;5;11;16;8;7;15
109;25.04.2018;2018;04;20;Keskiviikko;4;2;6;7;5;12
109;25.04.2018;2018;04;21;Keskiviikko;5;10;15;4;5;9
109;25.04.2018;2018;04;22;Keskiviikko;0;1;1;1;1;2
109;25.04.2018;2018;04;23;Keskiviikko;0;1;1;1;0;1
109;26.04.2018;2018;04;00;Torstai;0;1;1;0;1;1
109;26.04.2018;2018;04;01;Torstai;0;0;0;0;0;0
109;26.04.2018;2018;04;02;Torstai;0;0;0;1;0;1
109;26.04.2018;2018;04;03;Torstai;0;0;0;0;0;0
109;26.04.2018;2018;04;04;Torstai;0;0;0;0;0;0
109;26.04.2018;2018;04;05;Torstai;1;8;9;0;0;0
109;26.04.2018;2018;04;06;Torstai;14;8;22;3;2;5
109;26.04.2018;2018;04;07;Torstai;47;14;61;3;3;6
109;26.04.2018;2018;04;08;Torstai;29;11;40;7;5;12
109;26.04.2018;2018;04;09;Torstai;12;1;13;1;3;4
109;26.04.2018;2018;04;10;Torstai;5;3;8;3;4;7
109;26.04.2018;2018;04;11;Torstai;8;6;14;6;1;7
109;26.04.2018;2018;04;12;Torstai;8;3;11;6;6;12
109;26.04.2018;2018;04;13;Torstai;9;12;21;3;7;10
109;26.04.2018;2018;04;14;Torstai;11;7;18;4;4;8
109;26.04.2018;2018;04;15;Torstai;16;21;37;8;7;15
109;26.04.2018;2018;04;16;Torstai;18;31;49;7;2;9
109;26.04.2018;2018;04;17;Torstai;9;12;21;6;2;8
109;26.04.2018;2018;04;18;Torstai;8;10;18;9;0;9
109;26.04.2018;2018;04;19;Torstai;7;11;18;12;5;17
109;26.04.2018;2018;04;20;Torstai;6;6;12;5;2;7
109;26.04.2018;2018;04;21;Torstai;4;4;8;0;0;0
109;26.04.2018;2018;04;22;Torstai;5;1;6;1;2;3
109;26.04.2018;2018;04;23;Torstai;1;2;3;1;1;2
109;27.04.2018;2018;04;00;Perjantai;0;5;5;0;0;0
109;27.04.2018;2018;04;01;Perjantai;1;0;1;0;1;1
109;27.04.2018;2018;04;02;Perjantai;0;0;0;0;0;0
109;27.04.2018;2018;04;03;Perjantai;0;0;0;0;0;0
109;27.04.2018;2018;04;04;Perjantai;0;0;0;0;0;0
109;27.04.2018;2018;04;05;Perjantai;3;7;10;0;0;0
109;27.04.2018;2018;04;06;Perjantai;15;5;20;1;0;1
109;27.04.2018;2018;04;07;Perjantai;41;14;55;3;7;10
109;27.04.2018;2018;04;08;Perjantai;21;7;28;3;2;5
109;27.04.2018;2018;04;09;Perjantai;14;4;18;4;4;8
109;27.04.2018;2018;04;10;Perjantai;9;2;11;6;6;12
109;27.04.2018;2018;04;11;Perjantai;6;6;12;3;6;9
109;27.04.2018;2018;04;12;Perjantai;8;8;16;4;0;4
109;27.04.2018;2018;04;13;Perjantai;10;7;17;4;4;8
109;27.04.2018;2018;04;14;Perjantai;18;19;37;4;1;5
109;27.04.2018;2018;04;15;Perjantai;14;26;40;7;3;10
109;27.04.2018;2018;04;16;Perjantai;22;17;39;6;4;10
109;27.04.2018;2018;04;17;Perjantai;9;13;22;2;2;4
109;27.04.2018;2018;04;18;Perjantai;11;10;21;1;3;4
109;27.04.2018;2018;04;19;Perjantai;4;1;5;6;2;8
109;27.04.2018;2018;04;20;Perjantai;6;5;11;0;3;3
109;27.04.2018;2018;04;21;Perjantai;6;6;12;2;2;4
109;27.04.2018;2018;04;22;Perjantai;3;3;6;3;0;3
109;27.04.2018;2018;04;23;Perjantai;1;5;6;0;2;2
109;28.04.2018;2018;04;00;Lauantai;1;0;1;2;1;3
109;28.04.2018;2018;04;01;Lauantai;0;2;2;0;0;0
109;28.04.2018;2018;04;02;Lauantai;0;1;1;1;0;1
109;28.04.2018;2018;04;03;Lauantai;0;0;0;0;0;0
109;28.04.2018;2018;04;04;Lauantai;0;0;0;0;0;0
109;28.04.2018;2018;04;05;Lauantai;0;0;0;0;0;0
109;28.04.2018;2018;04;06;Lauantai;1;2;3;2;0;2
109;28.04.2018;2018;04;07;Lauantai;1;1;2;0;2;2
109;28.04.2018;2018;04;08;Lauantai;2;4;6;2;6;8
109;28.04.2018;2018;04;09;Lauantai;4;6;10;6;4;10
109;28.04.2018;2018;04;10;Lauantai;10;7;17;5;5;10
109;28.04.2018;2018;04;11;Lauantai;4;4;8;4;5;9
109;28.04.2018;2018;04;12;Lauantai;11;4;15;3;6;9
109;28.04.2018;2018;04;13;Lauantai;7;10;17;4;2;6
109;28.04.2018;2018;04;14;Lauantai;5;7;12;4;2;6
109;28.04.2018;2018;04;15;Lauantai;6;5;11;3;0;3
109;28.04.2018;2018;04;16;Lauantai;11;9;20;4;3;7
109;28.04.2018;2018;04;17;Lauantai;9;8;17;5;1;6
109;28.04.2018;2018;04;18;Lauantai;6;3;9;2;2;4
109;28.04.2018;2018;04;19;Lauantai;5;6;11;6;2;8
109;28.04.2018;2018;04;20;Lauantai;7;5;12;4;2;6
109;28.04.2018;2018;04;21;Lauantai;6;2;8;4;1;5
109;28.04.2018;2018;04;22;Lauantai;2;6;8;3;0;3
109;28.04.2018;2018;04;23;Lauantai;1;2;3;1;0;1
109;29.04.2018;2018;04;00;Sunnuntai;5;1;6;0;0;0
109;29.04.2018;2018;04;01;Sunnuntai;2;1;3;0;0;0
109;29.04.2018;2018;04;02;Sunnuntai;1;1;2;0;1;1
109;29.04.2018;2018;04;03;Sunnuntai;0;0;0;0;0;0
109;29.04.2018;2018;04;04;Sunnuntai;1;0;1;0;0;0
109;29.04.2018;2018;04;05;Sunnuntai;0;2;2;2;0;2
109;29.04.2018;2018;04;06;Sunnuntai;5;0;5;3;0;3
109;29.04.2018;2018;04;07;Sunnuntai;0;4;4;2;0;2
109;29.04.2018;2018;04;08;Sunnuntai;0;2;2;3;3;6
109;29.04.2018;2018;04;09;Sunnuntai;4;0;4;3;3;6
109;29.04.2018;2018;04;10;Sunnuntai;13;9;22;5;3;8
109;29.04.2018;2018;04;11;Sunnuntai;3;6;9;6;4;10
109;29.04.2018;2018;04;12;Sunnuntai;12;5;17;7;4;11
109;29.04.2018;2018;04;13;Sunnuntai;12;10;22;3;2;5
109;29.04.2018;2018;04;14;Sunnuntai;7;8;15;8;4;12
109;29.04.2018;2018;04;15;Sunnuntai;15;6;21;9;5;14
109;29.04.2018;2018;04;16;Sunnuntai;7;11;18;8;7;15
109;29.04.2018;2018;04;17;Sunnuntai;10;11;21;3;0;3
109;29.04.2018;2018;04;18;Sunnuntai;7;13;20;4;4;8
109;29.04.2018;2018;04;19;Sunnuntai;7;4;11;3;4;7
109;29.04.2018;2018;04;20;Sunnuntai;2;6;8;4;2;6
109;29.04.2018;2018;04;21;Sunnuntai;0;0;0;4;2;6
109;29.04.2018;2018;04;22;Sunnuntai;1;2;3;5;1;6
109;29.04.2018;2018;04;23;Sunnuntai;5;1;6;0;0;0
109;30.04.2018;2018;04;00;Maanantai;0;0;0;1;0;1
109;30.04.2018;2018;04;01;Maanantai;0;1;1;0;0;0
109;30.04.2018;2018;04;02;Maanantai;1;0;1;1;0;1
109;30.04.2018;2018;04;03;Maanantai;0;0;0;0;0;0
109;30.04.2018;2018;04;04;Maanantai;0;2;2;1;1;2
109;30.04.2018;2018;04;05;Maanantai;0;3;3;1;1;2
109;30.04.2018;2018;04;06;Maanantai;14;6;20;1;2;3
109;30.04.2018;2018;04;07;Maanantai;16;8;24;4;3;7
109;30.04.2018;2018;04;08;Maanantai;15;5;20;4;2;6
109;30.04.2018;2018;04;09;Maanantai;7;4;11;3;4;7
109;30.04.2018;2018;04;10;Maanantai;3;5;8;4;5;9
109;30.04.2018;2018;04;11;Maanantai;10;3;13;7;4;11
109;30.04.2018;2018;04;12;Maanantai;6;3;9;3;4;7
109;30.04.2018;2018;04;13;Maanantai;18;8;26;1;5;6
109;30.04.2018;2018;04;14;Maanantai;20;11;31;3;2;5
109;30.04.2018;2018;04;15;Maanantai;13;12;25;9;1;10
109;30.04.2018;2018;04;16;Maanantai;20;23;43;3;3;6
109;30.04.2018;2018;04;17;Maanantai;9;11;20;3;1;4
109;30.04.2018;2018;04;18;Maanantai;6;7;13;6;3;9
109;30.04.2018;2018;04;19;Maanantai;8;4;12;0;1;1
109;30.04.2018;2018;04;20;Maanantai;4;2;6;3;4;7
109;30.04.2018;2018;04;21;Maanantai;4;3;7;1;0;1
109;30.04.2018;2018;04;22;Maanantai;3;0;3;0;1;1
109;30.04.2018;2018;04;23;Maanantai;0;2;2;0;0;0
109;01.05.2018;2018;05;00;Tiistai;0;1;1;1;0;1
109;01.05.2018;2018;05;01;Tiistai;0;8;8;0;0;0
109;01.05.2018;2018;05;02;Tiistai;1;0;1;0;0;0
109;01.05.2018;2018;05;03;Tiistai;0;1;1;0;1;1
109;01.05.2018;2018;05;04;Tiistai;1;2;3;1;0;1
109;01.05.2018;2018;05;05;Tiistai;0;0;0;0;1;1
109;01.05.2018;2018;05;06;Tiistai;2;0;2;0;0;0
109;01.05.2018;2018;05;07;Tiistai;0;2;2;0;3;3
109;01.05.2018;2018;05;08;Tiistai;2;1;3;7;6;13
109;01.05.2018;2018;05;09;Tiistai;4;4;8;6;6;12
109;01.05.2018;2018;05;10;Tiistai;10;8;18;4;3;7
109;01.05.2018;2018;05;11;Tiistai;18;9;27;4;5;9
109;01.05.2018;2018;05;12;Tiistai;26;9;35;4;2;6
109;01.05.2018;2018;05;13;Tiistai;13;10;23;5;3;8
109;01.05.2018;2018;05;14;Tiistai;17;17;34;6;2;8
109;01.05.2018;2018;05;15;Tiistai;23;7;30;2;1;3
109;01.05.2018;2018;05;16;Tiistai;11;12;23;4;3;7
109;01.05.2018;2018;05;17;Tiistai;13;16;29;4;4;8
109;01.05.2018;2018;05;18;Tiistai;8;14;22;9;4;13
109;01.05.2018;2018;05;19;Tiistai;7;3;10;9;3;12
109;01.05.2018;2018;05;20;Tiistai;3;7;10;4;1;5
109;01.05.2018;2018;05;21;Tiistai;2;5;7;1;4;5
109;01.05.2018;2018;05;22;Tiistai;4;0;4;1;2;3
109;01.05.2018;2018;05;23;Tiistai;2;0;2;0;0;0
109;02.05.2018;2018;05;00;Keskiviikko;0;0;0;0;0;0
109;02.05.2018;2018;05;01;Keskiviikko;0;0;0;1;0;1
109;02.05.2018;2018;05;02;Keskiviikko;0;0;0;0;0;0
109;02.05.2018;2018;05;03;Keskiviikko;0;0;0;0;1;1
109;02.05.2018;2018;05;04;Keskiviikko;0;1;1;1;0;1
109;02.05.2018;2018;05;05;Keskiviikko;2;3;5;0;0;0
109;02.05.2018;2018;05;06;Keskiviikko;11;10;21;1;1;2
109;02.05.2018;2018;05;07;Keskiviikko;39;13;52;3;4;7
109;02.05.2018;2018;05;08;Keskiviikko;28;7;35;8;1;9
109;02.05.2018;2018;05;09;Keskiviikko;12;2;14;5;2;7
109;02.05.2018;2018;05;10;Keskiviikko;8;4;12;2;6;8
109;02.05.2018;2018;05;11;Keskiviikko;4;3;7;4;3;7
109;02.05.2018;2018;05;12;Keskiviikko;8;3;11;4;4;8
109;02.05.2018;2018;05;13;Keskiviikko;7;8;15;2;0;2
109;02.05.2018;2018;05;14;Keskiviikko;13;14;27;3;4;7
109;02.05.2018;2018;05;15;Keskiviikko;14;20;34;5;1;6
109;02.05.2018;2018;05;16;Keskiviikko;20;32;52;7;2;9
109;02.05.2018;2018;05;17;Keskiviikko;8;12;20;6;0;6
109;02.05.2018;2018;05;18;Keskiviikko;9;9;18;5;1;6
109;02.05.2018;2018;05;19;Keskiviikko;4;5;9;8;12;20
109;02.05.2018;2018;05;20;Keskiviikko;5;7;12;4;2;6
109;02.05.2018;2018;05;21;Keskiviikko;3;3;6;2;2;4
109;02.05.2018;2018;05;22;Keskiviikko;3;2;5;0;0;0
109;02.05.2018;2018;05;23;Keskiviikko;0;0;0;0;0;0
109;03.05.2018;2018;05;00;Torstai;1;0;1;0;2;2
109;03.05.2018;2018;05;01;Torstai;0;0;0;0;1;1
109;03.05.2018;2018;05;02;Torstai;0;0;0;1;0;1
109;03.05.2018;2018;05;03;Torstai;0;0;0;1;1;2
109;03.05.2018;2018;05;04;Torstai;0;0;0;0;0;0
109;03.05.2018;2018;05;05;Torstai;1;4;5;0;0;0
109;03.05.2018;2018;05;06;Torstai;27;13;40;0;0;0
109;03.05.2018;2018;05;07;Torstai;37;22;59;5;3;8
109;03.05.2018;2018;05;08;Torstai;34;10;44;9;4;13
109;03.05.2018;2018;05;09;Torstai;19;7;26;1;2;3
109;03.05.2018;2018;05;10;Torstai;11;5;16;2;3;5
109;03.05.2018;2018;05;11;Torstai;17;17;34;5;1;6
109;03.05.2018;2018;05;12;Torstai;13;6;19;3;3;6
109;03.05.2018;2018;05;13;Torstai;9;10;19;4;3;7
109;03.05.2018;2018;05;14;Torstai;13;11;24;3;4;7
109;03.05.2018;2018;05;15;Torstai;23;29;52;8;4;12
109;03.05.2018;2018;05;16;Torstai;23;45;68;8;2;10
109;03.05.2018;2018;05;17;Torstai;17;13;30;4;4;8
109;03.05.2018;2018;05;18;Torstai;12;7;19;6;1;7
109;03.05.2018;2018;05;19;Torstai;12;16;28;3;2;5
109;03.05.2018;2018;05;20;Torstai;7;13;20;1;0;1
109;03.05.2018;2018;05;21;Torstai;1;8;9;2;2;4
109;03.05.2018;2018;05;22;Torstai;3;2;5;1;1;2
109;03.05.2018;2018;05;23;Torstai;1;0;1;0;0;0
109;04.05.2018;2018;05;00;Perjantai;0;1;1;1;2;3
109;04.05.2018;2018;05;01;Perjantai;1;0;1;0;1;1
109;04.05.2018;2018;05;02;Perjantai;0;1;1;1;0;1
109;04.05.2018;2018;05;03;Perjantai;0;1;1;0;0;0
109;04.05.2018;2018;05;04;Perjantai;0;0;0;0;0;0
109;04.05.2018;2018;05;05;Perjantai;3;4;7;1;0;1
109;04.05.2018;2018;05;06;Perjantai;13;12;25;0;0;0
109;04.05.2018;2018;05;07;Perjantai;28;11;39;1;2;3
109;04.05.2018;2018;05;08;Perjantai;20;9;29;4;4;8
109;04.05.2018;2018;05;09;Perjantai;12;1;13;0;0;0
109;04.05.2018;2018;05;10;Perjantai;3;1;4;3;1;4
109;04.05.2018;2018;05;11;Perjantai;4;0;4;1;0;1
109;04.05.2018;2018;05;12;Perjantai;3;4;7;1;1;2
109;04.05.2018;2018;05;13;Perjantai;3;4;7;0;1;1
109;04.05.2018;2018;05;14;Perjantai;9;7;16;1;4;5
109;04.05.2018;2018;05;15;Perjantai;16;14;30;3;2;5
109;04.05.2018;2018;05;16;Perjantai;15;25;40;6;5;11
109;04.05.2018;2018;05;17;Perjantai;6;6;12;3;2;5
109;04.05.2018;2018;05;18;Perjantai;6;5;11;7;2;9
109;04.05.2018;2018;05;19;Perjantai;5;1;6;4;2;6
109;04.05.2018;2018;05;20;Perjantai;1;3;4;3;2;5
109;04.05.2018;2018;05;21;Perjantai;7;1;8;1;1;2
109;04.05.2018;2018;05;22;Perjantai;2;2;4;2;2;4
109;04.05.2018;2018;05;23;Perjantai;0;0;0;1;1;2
109;05.05.2018;2018;05;00;Lauantai;0;2;2;1;3;4
109;05.05.2018;2018;05;01;Lauantai;1;3;4;0;2;2
109;05.05.2018;2018;05;02;Lauantai;0;1;1;0;0;0
109;05.05.2018;2018;05;03;Lauantai;0;0;0;0;1;1
109;05.05.2018;2018;05;04;Lauantai;0;0;0;1;0;1
109;05.05.2018;2018;05;05;Lauantai;0;1;1;0;0;0
109;05.05.2018;2018;05;06;Lauantai;4;1;5;0;0;0
109;05.05.2018;2018;05;07;Lauantai;1;1;2;2;1;3
109;05.05.2018;2018;05;08;Lauantai;1;0;1;4;0;4
109;05.05.2018;2018;05;09;Lauantai;5;1;6;5;5;10
109;05.05.2018;2018;05;10;Lauantai;5;6;11;2;1;3
109;05.05.2018;2018;05;11;Lauantai;8;8;16;6;3;9
109;05.05.2018;2018;05;12;Lauantai;6;10;16;4;2;6
109;05.05.2018;2018;05;13;Lauantai;9;4;13;5;2;7
109;05.05.2018;2018;05;14;Lauantai;10;7;17;4;1;5
109;05.05.2018;2018;05;15;Lauantai;10;6;16;4;1;5
109;05.05.2018;2018;05;16;Lauantai;6;7;13;3;6;9
109;05.05.2018;2018;05;17;Lauantai;8;6;14;5;3;8
109;05.05.2018;2018;05;18;Lauantai;10;4;14;2;5;7
109;05.05.2018;2018;05;19;Lauantai;12;6;18;3;4;7
109;05.05.2018;2018;05;20;Lauantai;5;5;10;5;2;7
109;05.05.2018;2018;05;21;Lauantai;2;12;14;1;1;2
109;05.05.2018;2018;05;22;Lauantai;2;0;2;1;3;4
109;05.05.2018;2018;05;23;Lauantai;0;1;1;1;0;1
109;06.05.2018;2018;05;00;Sunnuntai;0;1;1;0;0;0
109;06.05.2018;2018;05;01;Sunnuntai;0;0;0;0;0;0
109;06.05.2018;2018;05;02;Sunnuntai;0;0;0;0;1;1
109;06.05.2018;2018;05;03;Sunnuntai;0;1;1;0;1;1
109;06.05.2018;2018;05;04;Sunnuntai;0;0;0;1;1;2
109;06.05.2018;2018;05;05;Sunnuntai;1;2;3;0;0;0
109;06.05.2018;2018;05;06;Sunnuntai;1;1;2;1;0;1
109;06.05.2018;2018;05;07;Sunnuntai;1;1;2;2;1;3
109;06.05.2018;2018;05;08;Sunnuntai;2;1;3;4;1;5
109;06.05.2018;2018;05;09;Sunnuntai;6;4;10;6;7;13
109;06.05.2018;2018;05;10;Sunnuntai;11;2;13;3;1;4
109;06.05.2018;2018;05;11;Sunnuntai;21;11;32;2;4;6
109;06.05.2018;2018;05;12;Sunnuntai;13;20;33;4;1;5
109;06.05.2018;2018;05;13;Sunnuntai;16;7;23;2;3;5
109;06.05.2018;2018;05;14;Sunnuntai;8;11;19;2;1;3
109;06.05.2018;2018;05;15;Sunnuntai;10;13;23;6;4;10
109;06.05.2018;2018;05;16;Sunnuntai;8;13;21;5;4;9
109;06.05.2018;2018;05;17;Sunnuntai;9;9;18;2;2;4
109;06.05.2018;2018;05;18;Sunnuntai;28;10;38;3;4;7
109;06.05.2018;2018;05;19;Sunnuntai;11;6;17;3;4;7
109;06.05.2018;2018;05;20;Sunnuntai;1;11;12;5;3;8
109;06.05.2018;2018;05;21;Sunnuntai;1;6;7;4;1;5
109;06.05.2018;2018;05;22;Sunnuntai;1;0;1;0;1;1
109;06.05.2018;2018;05;23;Sunnuntai;2;2;4;0;0;0
109;07.05.2018;2018;05;00;Maanantai;0;1;1;0;2;2
109;07.05.2018;2018;05;01;Maanantai;0;0;0;1;0;1
109;07.05.2018;2018;05;02;Maanantai;0;1;1;0;0;0
109;07.05.2018;2018;05;03;Maanantai;0;0;0;0;0;0
109;07.05.2018;2018;05;04;Maanantai;0;2;2;0;0;0
109;07.05.2018;2018;05;05;Maanantai;4;1;5;0;0;0
109;07.05.2018;2018;05;06;Maanantai;18;16;34;2;2;4
109;07.05.2018;2018;05;07;Maanantai;47;16;63;3;6;9
109;07.05.2018;2018;05;08;Maanantai;33;11;44;4;4;8
109;07.05.2018;2018;05;09;Maanantai;18;2;20;2;2;4
109;07.05.2018;2018;05;10;Maanantai;10;4;14;3;4;7
109;07.05.2018;2018;05;11;Maanantai;15;10;25;4;0;4
109;07.05.2018;2018;05;12;Maanantai;14;6;20;1;4;5
109;07.05.2018;2018;05;13;Maanantai;11;8;19;3;1;4
109;07.05.2018;2018;05;14;Maanantai;7;15;22;3;2;5
109;07.05.2018;2018;05;15;Maanantai;14;34;48;6;3;9
109;07.05.2018;2018;05;16;Maanantai;27;27;54;1;1;2
109;07.05.2018;2018;05;17;Maanantai;12;16;28;3;1;4
109;07.05.2018;2018;05;18;Maanantai;9;6;15;3;3;6
109;07.05.2018;2018;05;19;Maanantai;3;8;11;7;8;15
109;07.05.2018;2018;05;20;Maanantai;8;10;18;2;3;5
109;07.05.2018;2018;05;21;Maanantai;2;8;10;4;3;7
109;07.05.2018;2018;05;22;Maanantai;6;4;10;0;1;1
109;07.05.2018;2018;05;23;Maanantai;0;0;0;0;0;0
109;08.05.2018;2018;05;00;Tiistai;0;0;0;0;0;0
109;08.05.2018;2018;05;01;Tiistai;0;0;0;1;0;1
109;08.05.2018;2018;05;02;Tiistai;0;0;0;0;0;0
109;08.05.2018;2018;05;03;Tiistai;0;0;0;0;1;1
109;08.05.2018;2018;05;04;Tiistai;0;1;1;1;0;1
109;08.05.2018;2018;05;05;Tiistai;2;3;5;0;0;0
109;08.05.2018;2018;05;06;Tiistai;23;17;40;0;0;0
109;08.05.2018;2018;05;07;Tiistai;55;22;77;4;6;10
109;08.05.2018;2018;05;08;Tiistai;33;16;49;2;0;2
109;08.05.2018;2018;05;09;Tiistai;20;5;25;3;1;4
109;08.05.2018;2018;05;10;Tiistai;16;2;18;5;6;11
109;08.05.2018;2018;05;11;Tiistai;8;7;15;2;0;2
109;08.05.2018;2018;05;12;Tiistai;8;10;18;2;0;2
109;08.05.2018;2018;05;13;Tiistai;8;14;22;1;2;3
109;08.05.2018;2018;05;14;Tiistai;11;12;23;2;5;7
109;08.05.2018;2018;05;15;Tiistai;20;34;54;5;4;9
109;08.05.2018;2018;05;16;Tiistai;38;37;75;3;5;8
109;08.05.2018;2018;05;17;Tiistai;25;16;41;6;0;6
109;08.05.2018;2018;05;18;Tiistai;12;13;25;11;6;17
109;08.05.2018;2018;05;19;Tiistai;15;14;29;11;4;15
109;08.05.2018;2018;05;20;Tiistai;13;13;26;5;3;8
109;08.05.2018;2018;05;21;Tiistai;4;11;15;3;1;4
109;08.05.2018;2018;05;22;Tiistai;4;2;6;0;2;2
109;08.05.2018;2018;05;23;Tiistai;2;0;2;0;0;0
109;09.05.2018;2018;05;00;Keskiviikko;2;1;3;0;0;0
109;09.05.2018;2018;05;01;Keskiviikko;3;0;3;0;0;0
109;09.05.2018;2018;05;02;Keskiviikko;0;1;1;0;1;1
109;09.05.2018;2018;05;03;Keskiviikko;0;0;0;0;1;1
109;09.05.2018;2018;05;04;Keskiviikko;4;3;7;6;8;14
109;09.05.2018;2018;05;05;Keskiviikko;2;3;5;1;0;1
109;09.05.2018;2018;05;06;Keskiviikko;23;12;35;1;2;3
109;09.05.2018;2018;05;07;Keskiviikko;55;29;84;5;2;7
109;09.05.2018;2018;05;08;Keskiviikko;35;12;47;0;0;0
109;09.05.2018;2018;05;09;Keskiviikko;16;9;25;2;2;4
109;09.05.2018;2018;05;10;Keskiviikko;8;3;11;2;6;8
109;09.05.2018;2018;05;11;Keskiviikko;8;7;15;3;2;5
109;09.05.2018;2018;05;12;Keskiviikko;4;4;8;0;3;3
109;09.05.2018;2018;05;13;Keskiviikko;12;23;35;0;0;0
109;09.05.2018;2018;05;14;Keskiviikko;19;31;50;2;4;6
109;09.05.2018;2018;05;15;Keskiviikko;25;29;54;4;2;6
109;09.05.2018;2018;05;16;Keskiviikko;31;27;58;4;7;11
109;09.05.2018;2018;05;17;Keskiviikko;29;19;48;2;6;8
109;09.05.2018;2018;05;18;Keskiviikko;25;13;38;4;1;5
109;09.05.2018;2018;05;19;Keskiviikko;15;4;19;9;0;9
109;09.05.2018;2018;05;20;Keskiviikko;10;11;21;3;3;6
109;09.05.2018;2018;05;21;Keskiviikko;9;7;16;2;1;3
109;09.05.2018;2018;05;22;Keskiviikko;7;4;11;4;1;5
109;09.05.2018;2018;05;23;Keskiviikko;1;1;2;0;0;0
109;10.05.2018;2018;05;00;Torstai;0;1;1;0;2;2
109;10.05.2018;2018;05;01;Torstai;1;3;4;0;0;0
109;10.05.2018;2018;05;02;Torstai;0;1;1;0;1;1
109;10.05.2018;2018;05;03;Torstai;0;0;0;2;2;4
109;10.05.2018;2018;05;04;Torstai;1;1;2;0;0;0
109;10.05.2018;2018;05;05;Torstai;1;2;3;0;0;0
109;10.05.2018;2018;05;06;Torstai;4;2;6;1;0;1
109;10.05.2018;2018;05;07;Torstai;0;5;5;0;2;2
109;10.05.2018;2018;05;08;Torstai;9;3;12;3;1;4
109;10.05.2018;2018;05;09;Torstai;5;9;14;2;3;5
109;10.05.2018;2018;05;10;Torstai;13;4;17;5;5;10
109;10.05.2018;2018;05;11;Torstai;19;4;23;7;2;9
109;10.05.2018;2018;05;12;Torstai;29;11;40;7;2;9
109;10.05.2018;2018;05;13;Torstai;26;13;39;4;1;5
109;10.05.2018;2018;05;14;Torstai;14;12;26;1;3;4
109;10.05.2018;2018;05;15;Torstai;16;14;30;4;4;8
109;10.05.2018;2018;05;16;Torstai;26;17;43;7;2;9
109;10.05.2018;2018;05;17;Torstai;9;7;16;5;4;9
109;10.05.2018;2018;05;18;Torstai;21;14;35;5;1;6
109;10.05.2018;2018;05;19;Torstai;19;7;26;5;3;8
109;10.05.2018;2018;05;20;Torstai;13;12;25;0;2;2
109;10.05.2018;2018;05;21;Torstai;7;0;7;3;1;4
109;10.05.2018;2018;05;22;Torstai;6;1;7;0;1;1
109;10.05.2018;2018;05;23;Torstai;1;0;1;0;0;0
109;11.05.2018;2018;05;00;Perjantai;1;0;1;0;1;1
109;11.05.2018;2018;05;01;Perjantai;1;0;1;3;0;3
109;11.05.2018;2018;05;02;Perjantai;0;0;0;0;0;0
109;11.05.2018;2018;05;03;Perjantai;0;0;0;1;1;2
109;11.05.2018;2018;05;04;Perjantai;0;0;0;0;0;0
109;11.05.2018;2018;05;05;Perjantai;6;3;9;1;0;1
109;11.05.2018;2018;05;06;Perjantai;12;8;20;1;1;2
109;11.05.2018;2018;05;07;Perjantai;28;22;50;1;0;1
109;11.05.2018;2018;05;08;Perjantai;19;9;28;4;0;4
109;11.05.2018;2018;05;09;Perjantai;21;4;25;3;2;5
109;11.05.2018;2018;05;10;Perjantai;11;6;17;2;1;3
109;11.05.2018;2018;05;11;Perjantai;23;7;30;3;3;6
109;11.05.2018;2018;05;12;Perjantai;7;10;17;6;6;12
109;11.05.2018;2018;05;13;Perjantai;16;12;28;1;3;4
109;11.05.2018;2018;05;14;Perjantai;13;24;37;4;3;7
109;11.05.2018;2018;05;15;Perjantai;25;32;57;8;1;9
109;11.05.2018;2018;05;16;Perjantai;24;16;40;4;3;7
109;11.05.2018;2018;05;17;Perjantai;19;13;32;2;4;6
109;11.05.2018;2018;05;18;Perjantai;22;8;30;4;1;5
109;11.05.2018;2018;05;19;Perjantai;18;12;30;3;1;4
109;11.05.2018;2018;05;20;Perjantai;15;17;32;2;5;7
109;11.05.2018;2018;05;21;Perjantai;3;3;6;3;1;4
109;11.05.2018;2018;05;22;Perjantai;6;6;12;0;1;1
109;11.05.2018;2018;05;23;Perjantai;2;5;7;0;1;1
109;12.05.2018;2018;05;00;Lauantai;1;2;3;2;1;3
109;12.05.2018;2018;05;01;Lauantai;0;2;2;0;0;0
109;12.05.2018;2018;05;02;Lauantai;1;1;2;0;0;0
109;12.05.2018;2018;05;03;Lauantai;1;2;3;0;0;0
109;12.05.2018;2018;05;04;Lauantai;1;2;3;0;0;0
109;12.05.2018;2018;05;05;Lauantai;1;0;1;0;0;0
109;12.05.2018;2018;05;06;Lauantai;3;2;5;0;1;1
109;12.05.2018;2018;05;07;Lauantai;3;4;7;1;1;2
109;12.05.2018;2018;05;08;Lauantai;2;1;3;2;1;3
109;12.05.2018;2018;05;09;Lauantai;7;3;10;6;6;12
109;12.05.2018;2018;05;10;Lauantai;14;7;21;5;4;9
109;12.05.2018;2018;05;11;Lauantai;17;6;23;7;3;10
109;12.05.2018;2018;05;12;Lauantai;21;12;33;0;3;3
109;12.05.2018;2018;05;13;Lauantai;19;22;41;4;5;9
109;12.05.2018;2018;05;14;Lauantai;20;13;33;6;0;6
109;12.05.2018;2018;05;15;Lauantai;15;17;32;2;1;3
109;12.05.2018;2018;05;16;Lauantai;7;10;17;5;4;9
109;12.05.2018;2018;05;17;Lauantai;16;11;27;2;1;3
109;12.05.2018;2018;05;18;Lauantai;16;4;20;3;1;4
109;12.05.2018;2018;05;19;Lauantai;15;9;24;0;5;5
109;12.05.2018;2018;05;20;Lauantai;10;9;19;6;3;9
109;12.05.2018;2018;05;21;Lauantai;9;4;13;1;2;3
109;12.05.2018;2018;05;22;Lauantai;4;3;7;5;1;6
109;12.05.2018;2018;05;23;Lauantai;10;4;14;1;0;1
109;13.05.2018;2018;05;00;Sunnuntai;2;2;4;0;0;0
109;13.05.2018;2018;05;01;Sunnuntai;0;1;1;1;0;1
109;13.05.2018;2018;05;02;Sunnuntai;1;1;2;1;1;2
109;13.05.2018;2018;05;03;Sunnuntai;0;1;1;0;0;0
109;13.05.2018;2018;05;04;Sunnuntai;1;1;2;0;0;0
109;13.05.2018;2018;05;05;Sunnuntai;0;3;3;0;0;0
109;13.05.2018;2018;05;06;Sunnuntai;2;0;2;0;0;0
109;13.05.2018;2018;05;07;Sunnuntai;2;4;6;1;2;3
109;13.05.2018;2018;05;08;Sunnuntai;2;4;6;3;1;4
109;13.05.2018;2018;05;09;Sunnuntai;2;4;6;7;6;13
109;13.05.2018;2018;05;10;Sunnuntai;9;3;12;7;2;9
109;13.05.2018;2018;05;11;Sunnuntai;27;4;31;7;3;10
109;13.05.2018;2018;05;12;Sunnuntai;17;14;31;1;3;4
109;13.05.2018;2018;05;13;Sunnuntai;34;6;40;5;4;9
109;13.05.2018;2018;05;14;Sunnuntai;12;16;28;1;1;2
109;13.05.2018;2018;05;15;Sunnuntai;17;13;30;4;4;8
109;13.05.2018;2018;05;16;Sunnuntai;22;7;29;3;1;4
109;13.05.2018;2018;05;17;Sunnuntai;16;8;24;1;5;6
109;13.05.2018;2018;05;18;Sunnuntai;22;18;40;2;6;8
109;13.05.2018;2018;05;19;Sunnuntai;12;4;16;7;6;13
109;13.05.2018;2018;05;20;Sunnuntai;13;7;20;7;2;9
109;13.05.2018;2018;05;21;Sunnuntai;6;3;9;2;1;3
109;13.05.2018;2018;05;22;Sunnuntai;6;0;6;1;0;1
109;13.05.2018;2018;05;23;Sunnuntai;0;0;0;0;0;0
109;14.05.2018;2018;05;00;Maanantai;0;0;0;2;1;3
109;14.05.2018;2018;05;01;Maanantai;0;0;0;1;0;1
109;14.05.2018;2018;05;02;Maanantai;0;0;0;0;1;1
109;14.05.2018;2018;05;03;Maanantai;0;0;0;0;1;1
109;14.05.2018;2018;05;04;Maanantai;0;3;3;0;0;0
109;14.05.2018;2018;05;05;Maanantai;10;4;14;1;0;1
109;14.05.2018;2018;05;06;Maanantai;25;18;43;5;3;8
109;14.05.2018;2018;05;07;Maanantai;47;28;75;6;3;9
109;14.05.2018;2018;05;08;Maanantai;41;15;56;4;0;4
109;14.05.2018;2018;05;09;Maanantai;16;10;26;4;1;5
109;14.05.2018;2018;05;10;Maanantai;16;5;21;7;4;11
109;14.05.2018;2018;05;11;Maanantai;12;10;22;1;2;3
109;14.05.2018;2018;05;12;Maanantai;14;12;26;5;2;7
109;14.05.2018;2018;05;13;Maanantai;15;14;29;2;3;5
109;14.05.2018;2018;05;14;Maanantai;20;24;44;2;3;5
109;14.05.2018;2018;05;15;Maanantai;29;34;63;12;6;18
109;14.05.2018;2018;05;16;Maanantai;38;46;84;6;2;8
109;14.05.2018;2018;05;17;Maanantai;28;32;60;2;2;4
109;14.05.2018;2018;05;18;Maanantai;20;20;40;8;3;11
109;14.05.2018;2018;05;19;Maanantai;15;27;42;5;4;9
109;14.05.2018;2018;05;20;Maanantai;14;6;20;6;4;10
109;14.05.2018;2018;05;21;Maanantai;4;7;11;2;3;5
109;14.05.2018;2018;05;22;Maanantai;6;3;9;0;2;2
109;14.05.2018;2018;05;23;Maanantai;2;1;3;1;1;2
109;15.05.2018;2018;05;00;Tiistai;0;0;0;0;0;0
109;15.05.2018;2018;05;01;Tiistai;0;0;0;0;1;1
109;15.05.2018;2018;05;02;Tiistai;0;0;0;0;0;0
109;15.05.2018;2018;05;03;Tiistai;0;0;0;0;0;0
109;15.05.2018;2018;05;04;Tiistai;2;1;3;0;1;1
109;15.05.2018;2018;05;05;Tiistai;4;6;10;3;0;3
109;15.05.2018;2018;05;06;Tiistai;25;14;39;2;0;2
109;15.05.2018;2018;05;07;Tiistai;68;32;100;2;3;5
109;15.05.2018;2018;05;08;Tiistai;47;14;61;4;3;7
109;15.05.2018;2018;05;09;Tiistai;12;4;16;0;5;5
109;15.05.2018;2018;05;10;Tiistai;4;3;7;1;3;4
109;15.05.2018;2018;05;11;Tiistai;19;5;24;3;2;5
109;15.05.2018;2018;05;12;Tiistai;16;7;23;3;0;3
109;15.05.2018;2018;05;13;Tiistai;9;21;30;1;3;4
109;15.05.2018;2018;05;14;Tiistai;23;16;39;4;3;7
109;15.05.2018;2018;05;15;Tiistai;25;29;54;6;1;7
109;15.05.2018;2018;05;16;Tiistai;33;70;103;8;1;9
109;15.05.2018;2018;05;17;Tiistai;33;27;60;5;2;7
109;15.05.2018;2018;05;18;Tiistai;17;19;36;3;4;7
109;15.05.2018;2018;05;19;Tiistai;22;23;45;9;3;12
109;15.05.2018;2018;05;20;Tiistai;17;7;24;10;1;11
109;15.05.2018;2018;05;21;Tiistai;5;15;20;1;2;3
109;15.05.2018;2018;05;22;Tiistai;5;3;8;1;3;4
109;15.05.2018;2018;05;23;Tiistai;2;1;3;0;1;1
109;16.05.2018;2018;05;00;Keskiviikko;2;1;3;0;0;0
109;16.05.2018;2018;05;01;Keskiviikko;3;2;5;2;1;3
109;16.05.2018;2018;05;02;Keskiviikko;0;0;0;0;0;0
109;16.05.2018;2018;05;03;Keskiviikko;0;0;0;2;1;3
109;16.05.2018;2018;05;04;Keskiviikko;1;2;3;2;0;2
109;16.05.2018;2018;05;05;Keskiviikko;7;4;11;1;0;1
109;16.05.2018;2018;05;06;Keskiviikko;24;11;35;3;0;3
109;16.05.2018;2018;05;07;Keskiviikko;66;28;94;1;4;5
109;16.05.2018;2018;05;08;Keskiviikko;49;14;63;5;1;6
109;16.05.2018;2018;05;09;Keskiviikko;14;7;21;3;1;4
109;16.05.2018;2018;05;10;Keskiviikko;18;4;22;4;7;11
109;16.05.2018;2018;05;11;Keskiviikko;14;11;25;4;0;4
109;16.05.2018;2018;05;12;Keskiviikko;13;8;21;2;1;3
109;16.05.2018;2018;05;13;Keskiviikko;11;15;26;1;4;5
109;16.05.2018;2018;05;14;Keskiviikko;17;23;40;2;1;3
109;16.05.2018;2018;05;15;Keskiviikko;31;41;72;8;2;10
109;16.05.2018;2018;05;16;Keskiviikko;39;41;80;11;1;12
109;16.05.2018;2018;05;17;Keskiviikko;23;21;44;0;1;1
109;16.05.2018;2018;05;18;Keskiviikko;33;11;44;6;5;11
109;16.05.2018;2018;05;19;Keskiviikko;18;16;34;5;2;7
109;16.05.2018;2018;05;20;Keskiviikko;22;7;29;3;0;3
109;16.05.2018;2018;05;21;Keskiviikko;13;9;22;3;4;7
109;16.05.2018;2018;05;22;Keskiviikko;6;0;6;2;0;2
109;16.05.2018;2018;05;23;Keskiviikko;2;3;5;1;0;1
109;17.05.2018;2018;05;00;Torstai;2;0;2;0;1;1
109;17.05.2018;2018;05;01;Torstai;1;1;2;0;0;0
109;17.05.2018;2018;05;02;Torstai;0;0;0;0;0;0
109;17.05.2018;2018;05;03;Torstai;0;0;0;0;0;0
109;17.05.2018;2018;05;04;Torstai;0;1;1;0;0;0
109;17.05.2018;2018;05;05;Torstai;4;6;10;2;2;4
109;17.05.2018;2018;05;06;Torstai;18;11;29;2;0;2
109;17.05.2018;2018;05;07;Torstai;61;23;84;1;4;5
109;17.05.2018;2018;05;08;Torstai;38;18;56;6;1;7
109;17.05.2018;2018;05;09;Torstai;16;8;24;1;2;3
109;17.05.2018;2018;05;10;Torstai;19;8;27;4;4;8
109;17.05.2018;2018;05;11;Torstai;10;7;17;3;1;4
109;17.05.2018;2018;05;12;Torstai;6;10;16;2;1;3
109;17.05.2018;2018;05;13;Torstai;15;8;23;0;3;3
109;17.05.2018;2018;05;14;Torstai;16;10;26;2;0;2
109;17.05.2018;2018;05;15;Torstai;31;35;66;5;4;9
109;17.05.2018;2018;05;16;Torstai;31;46;77;6;2;8
109;17.05.2018;2018;05;17;Torstai;23;29;52;7;1;8
109;17.05.2018;2018;05;18;Torstai;13;13;26;7;1;8
109;17.05.2018;2018;05;19;Torstai;12;21;33;7;5;12
109;17.05.2018;2018;05;20;Torstai;4;9;13;4;4;8
109;17.05.2018;2018;05;21;Torstai;5;9;14;2;2;4
109;17.05.2018;2018;05;22;Torstai;3;2;5;2;0;2
109;17.05.2018;2018;05;23;Torstai;3;1;4;0;1;1
109;18.05.2018;2018;05;00;Perjantai;3;2;5;0;1;1
109;18.05.2018;2018;05;01;Perjantai;0;0;0;1;2;3
109;18.05.2018;2018;05;02;Perjantai;0;0;0;0;0;0
109;18.05.2018;2018;05;03;Perjantai;1;0;1;0;1;1
109;18.05.2018;2018;05;04;Perjantai;0;1;1;2;0;2
109;18.05.2018;2018;05;05;Perjantai;3;5;8;2;1;3
109;18.05.2018;2018;05;06;Perjantai;20;9;29;1;0;1
109;18.05.2018;2018;05;07;Perjantai;46;30;76;4;3;7
109;18.05.2018;2018;05;08;Perjantai;37;11;48;4;1;5
109;18.05.2018;2018;05;09;Perjantai;24;7;31;2;3;5
109;18.05.2018;2018;05;10;Perjantai;12;6;18;3;6;9
109;18.05.2018;2018;05;11;Perjantai;12;4;16;2;1;3
109;18.05.2018;2018;05;12;Perjantai;5;5;10;1;1;2
109;18.05.2018;2018;05;13;Perjantai;15;16;31;1;2;3
109;18.05.2018;2018;05;14;Perjantai;17;25;42;1;4;5
109;18.05.2018;2018;05;15;Perjantai;20;39;59;5;2;7
109;18.05.2018;2018;05;16;Perjantai;23;30;53;4;7;11
109;18.05.2018;2018;05;17;Perjantai;17;12;29;3;2;5
109;18.05.2018;2018;05;18;Perjantai;12;9;21;1;1;2
109;18.05.2018;2018;05;19;Perjantai;11;9;20;3;4;7
109;18.05.2018;2018;05;20;Perjantai;8;7;15;1;3;4
109;18.05.2018;2018;05;21;Perjantai;4;7;11;2;2;4
109;18.05.2018;2018;05;22;Perjantai;4;4;8;1;2;3
109;18.05.2018;2018;05;23;Perjantai;2;0;2;0;0;0
109;19.05.2018;2018;05;00;Lauantai;1;1;2;1;0;1
109;19.05.2018;2018;05;01;Lauantai;1;0;1;1;1;2
109;19.05.2018;2018;05;02;Lauantai;1;0;1;0;0;0
109;19.05.2018;2018;05;03;Lauantai;0;0;0;0;0;0
109;19.05.2018;2018;05;04;Lauantai;0;1;1;1;1;2
109;19.05.2018;2018;05;05;Lauantai;3;3;6;0;0;0
109;19.05.2018;2018;05;06;Lauantai;5;1;6;2;0;2
109;19.05.2018;2018;05;07;Lauantai;2;3;5;1;0;1
109;19.05.2018;2018;05;08;Lauantai;3;1;4;1;3;4
109;19.05.2018;2018;05;09;Lauantai;6;2;8;2;1;3
109;19.05.2018;2018;05;10;Lauantai;8;4;12;3;1;4
109;19.05.2018;2018;05;11;Lauantai;14;5;19;5;6;11
109;19.05.2018;2018;05;12;Lauantai;17;6;23;2;2;4
109;19.05.2018;2018;05;13;Lauantai;13;5;18;0;3;3
109;19.05.2018;2018;05;14;Lauantai;17;9;26;2;4;6
109;19.05.2018;2018;05;15;Lauantai;14;7;21;3;3;6
109;19.05.2018;2018;05;16;Lauantai;9;8;17;4;0;4
109;19.05.2018;2018;05;17;Lauantai;8;7;15;4;3;7
109;19.05.2018;2018;05;18;Lauantai;9;4;13;0;0;0
109;19.05.2018;2018;05;19;Lauantai;9;8;17;8;1;9
109;19.05.2018;2018;05;20;Lauantai;9;4;13;2;4;6
109;19.05.2018;2018;05;21;Lauantai;2;4;6;4;2;6
109;19.05.2018;2018;05;22;Lauantai;6;5;11;4;2;6
109;19.05.2018;2018;05;23;Lauantai;1;2;3;2;0;2
109;20.05.2018;2018;05;00;Sunnuntai;0;2;2;1;3;4
109;20.05.2018;2018;05;01;Sunnuntai;1;4;5;0;1;1
109;20.05.2018;2018;05;02;Sunnuntai;0;0;0;0;0;0
109;20.05.2018;2018;05;03;Sunnuntai;1;2;3;0;0;0
109;20.05.2018;2018;05;04;Sunnuntai;0;0;0;0;0;0
109;20.05.2018;2018;05;05;Sunnuntai;2;1;3;0;0;0
109;20.05.2018;2018;05;06;Sunnuntai;4;1;5;0;0;0
109;20.05.2018;2018;05;07;Sunnuntai;0;4;4;5;4;9
109;20.05.2018;2018;05;08;Sunnuntai;1;2;3;8;1;9
109;20.05.2018;2018;05;09;Sunnuntai;4;1;5;3;1;4
109;20.05.2018;2018;05;10;Sunnuntai;6;2;8;3;4;7
109;20.05.2018;2018;05;11;Sunnuntai;15;4;19;2;0;2
109;20.05.2018;2018;05;12;Sunnuntai;8;9;17;2;2;4
109;20.05.2018;2018;05;13;Sunnuntai;17;5;22;3;3;6
109;20.05.2018;2018;05;14;Sunnuntai;12;7;19;3;4;7
109;20.05.2018;2018;05;15;Sunnuntai;9;16;25;7;0;7
109;20.05.2018;2018;05;16;Sunnuntai;9;10;19;10;4;14
109;20.05.2018;2018;05;17;Sunnuntai;10;7;17;8;1;9
109;20.05.2018;2018;05;18;Sunnuntai;12;7;19;5;2;7
109;20.05.2018;2018;05;19;Sunnuntai;9;14;23;5;5;10
109;20.05.2018;2018;05;20;Sunnuntai;4;5;9;2;3;5
109;20.05.2018;2018;05;21;Sunnuntai;7;6;13;4;1;5
109;20.05.2018;2018;05;22;Sunnuntai;3;1;4;0;0;0
109;20.05.2018;2018;05;23;Sunnuntai;0;0;0;0;0;0
109;21.05.2018;2018;05;00;Maanantai;1;0;1;1;0;1
109;21.05.2018;2018;05;01;Maanantai;0;0;0;0;0;0
109;21.05.2018;2018;05;02;Maanantai;0;0;0;0;0;0
109;21.05.2018;2018;05;03;Maanantai;0;0;0;0;0;0
109;21.05.2018;2018;05;04;Maanantai;0;1;1;0;0;0
109;21.05.2018;2018;05;05;Maanantai;5;3;8;2;0;2
109;21.05.2018;2018;05;06;Maanantai;24;19;43;5;0;5
109;21.05.2018;2018;05;07;Maanantai;62;30;92;4;4;8
109;21.05.2018;2018;05;08;Maanantai;45;21;66;8;11;19
109;21.05.2018;2018;05;09;Maanantai;22;11;33;3;4;7
109;21.05.2018;2018;05;10;Maanantai;13;2;15;9;4;13
109;21.05.2018;2018;05;11;Maanantai;14;5;19;1;1;2
109;21.05.2018;2018;05;12;Maanantai;12;9;21;0;5;5
109;21.05.2018;2018;05;13;Maanantai;13;16;29;2;4;6
109;21.05.2018;2018;05;14;Maanantai;16;17;33;1;3;4
109;21.05.2018;2018;05;15;Maanantai;26;35;61;7;1;8
109;21.05.2018;2018;05;16;Maanantai;30;49;79;4;2;6
109;21.05.2018;2018;05;17;Maanantai;22;25;47;3;2;5
109;21.05.2018;2018;05;18;Maanantai;25;10;35;2;2;4
109;21.05.2018;2018;05;19;Maanantai;15;24;39;12;9;21
109;21.05.2018;2018;05;20;Maanantai;8;21;29;4;5;9
109;21.05.2018;2018;05;21;Maanantai;6;3;9;3;0;3
109;21.05.2018;2018;05;22;Maanantai;7;4;11;1;2;3
109;21.05.2018;2018;05;23;Maanantai;2;0;2;1;0;1
109;22.05.2018;2018;05;00;Tiistai;0;0;0;0;1;1
109;22.05.2018;2018;05;01;Tiistai;1;0;1;1;0;1
109;22.05.2018;2018;05;02;Tiistai;0;0;0;0;0;0
109;22.05.2018;2018;05;03;Tiistai;0;0;0;0;0;0
109;22.05.2018;2018;05;04;Tiistai;1;0;1;0;0;0
109;22.05.2018;2018;05;05;Tiistai;3;7;10;2;0;2
109;22.05.2018;2018;05;06;Tiistai;20;11;31;1;3;4
109;22.05.2018;2018;05;07;Tiistai;66;33;99;4;3;7
109;22.05.2018;2018;05;08;Tiistai;48;18;66;5;1;6
109;22.05.2018;2018;05;09;Tiistai;15;5;20;2;4;6
109;22.05.2018;2018;05;10;Tiistai;16;4;20;8;6;14
109;22.05.2018;2018;05;11;Tiistai;14;9;23;4;3;7
109;22.05.2018;2018;05;12;Tiistai;13;8;21;6;2;8
109;22.05.2018;2018;05;13;Tiistai;12;19;31;0;3;3
109;22.05.2018;2018;05;14;Tiistai;21;17;38;2;0;2
109;22.05.2018;2018;05;15;Tiistai;17;34;51;8;6;14
109;22.05.2018;2018;05;16;Tiistai;41;46;87;9;4;13
109;22.05.2018;2018;05;17;Tiistai;26;20;46;1;2;3
109;22.05.2018;2018;05;18;Tiistai;17;14;31;2;3;5
109;22.05.2018;2018;05;19;Tiistai;6;18;24;3;6;9
109;22.05.2018;2018;05;20;Tiistai;9;8;17;1;4;5
109;22.05.2018;2018;05;21;Tiistai;3;4;7;6;2;8
109;22.05.2018;2018;05;22;Tiistai;6;5;11;2;0;2
109;22.05.2018;2018;05;23;Tiistai;0;1;1;0;2;2
109;23.05.2018;2018;05;00;Keskiviikko;0;0;0;2;0;2
109;23.05.2018;2018;05;01;Keskiviikko;1;0;1;0;1;1
109;23.05.2018;2018;05;02;Keskiviikko;0;0;0;0;0;0
109;23.05.2018;2018;05;03;Keskiviikko;0;0;0;0;0;0
109;23.05.2018;2018;05;04;Keskiviikko;1;1;2;0;0;0
109;23.05.2018;2018;05;05;Keskiviikko;1;6;7;4;0;4
109;23.05.2018;2018;05;06;Keskiviikko;21;6;27;4;0;4
109;23.05.2018;2018;05;07;Keskiviikko;52;35;87;0;3;3
109;23.05.2018;2018;05;08;Keskiviikko;47;10;57;6;1;7
109;23.05.2018;2018;05;09;Keskiviikko;12;3;15;3;2;5
109;23.05.2018;2018;05;10;Keskiviikko;9;4;13;5;6;11
109;23.05.2018;2018;05;11;Keskiviikko;9;7;16;2;3;5
109;23.05.2018;2018;05;12;Keskiviikko;10;11;21;6;2;8
109;23.05.2018;2018;05;13;Keskiviikko;10;16;26;2;1;3
109;23.05.2018;2018;05;14;Keskiviikko;17;13;30;5;3;8
109;23.05.2018;2018;05;15;Keskiviikko;16;26;42;5;1;6
109;23.05.2018;2018;05;16;Keskiviikko;41;44;85;6;6;12
109;23.05.2018;2018;05;17;Keskiviikko;22;15;37;4;5;9
109;23.05.2018;2018;05;18;Keskiviikko;9;22;31;6;2;8
109;23.05.2018;2018;05;19;Keskiviikko;10;7;17;8;2;10
109;23.05.2018;2018;05;20;Keskiviikko;2;8;10;4;5;9
109;23.05.2018;2018;05;21;Keskiviikko;11;7;18;1;1;2
109;23.05.2018;2018;05;22;Keskiviikko;8;3;11;2;1;3
109;23.05.2018;2018;05;23;Keskiviikko;1;2;3;0;1;1
109;24.05.2018;2018;05;00;Torstai;1;0;1;0;2;2
109;24.05.2018;2018;05;01;Torstai;1;1;2;0;0;0
109;24.05.2018;2018;05;02;Torstai;0;0;0;1;1;2
109;24.05.2018;2018;05;03;Torstai;0;0;0;0;0;0
109;24.05.2018;2018;05;04;Torstai;0;1;1;0;0;0
109;24.05.2018;2018;05;05;Torstai;2;5;7;1;1;2
109;24.05.2018;2018;05;06;Torstai;20;11;31;0;3;3
109;24.05.2018;2018;05;07;Torstai;43;37;80;2;4;6
109;24.05.2018;2018;05;08;Torstai;58;11;69;8;1;9
109;24.05.2018;2018;05;09;Torstai;13;5;18;3;2;5
109;24.05.2018;2018;05;10;Torstai;10;6;16;5;6;11
109;24.05.2018;2018;05;11;Torstai;16;9;25;3;0;3
109;24.05.2018;2018;05;12;Torstai;17;8;25;7;1;8
109;24.05.2018;2018;05;13;Torstai;13;24;37;2;4;6
109;24.05.2018;2018;05;14;Torstai;23;18;41;4;0;4
109;24.05.2018;2018;05;15;Torstai;21;30;51;2;3;5
109;24.05.2018;2018;05;16;Torstai;30;38;68;4;1;5
109;24.05.2018;2018;05;17;Torstai;14;28;42;6;7;13
109;24.05.2018;2018;05;18;Torstai;14;9;23;5;5;10
109;24.05.2018;2018;05;19;Torstai;7;10;17;5;5;10
109;24.05.2018;2018;05;20;Torstai;8;18;26;4;5;9
109;24.05.2018;2018;05;21;Torstai;4;16;20;3;1;4
109;24.05.2018;2018;05;22;Torstai;3;2;5;2;2;4
109;24.05.2018;2018;05;23;Torstai;0;0;0;1;1;2
109;25.05.2018;2018;05;00;Perjantai;0;0;0;1;1;2
109;25.05.2018;2018;05;01;Perjantai;0;0;0;0;0;0
109;25.05.2018;2018;05;02;Perjantai;1;0;1;0;0;0
109;25.05.2018;2018;05;03;Perjantai;0;0;0;0;0;0
109;25.05.2018;2018;05;04;Perjantai;0;1;1;0;0;0
109;25.05.2018;2018;05;05;Perjantai;5;7;12;1;0;1
109;25.05.2018;2018;05;06;Perjantai;17;12;29;3;3;6
109;25.05.2018;2018;05;07;Perjantai;50;29;79;5;3;8
109;25.05.2018;2018;05;08;Perjantai;40;12;52;3;2;5
109;25.05.2018;2018;05;09;Perjantai;14;4;18;2;4;6
109;25.05.2018;2018;05;10;Perjantai;6;3;9;4;1;5
109;25.05.2018;2018;05;11;Perjantai;12;12;24;2;2;4
109;25.05.2018;2018;05;12;Perjantai;19;13;32;1;4;5
109;25.05.2018;2018;05;13;Perjantai;20;19;39;1;7;8
109;25.05.2018;2018;05;14;Perjantai;28;31;59;9;2;11
109;25.05.2018;2018;05;15;Perjantai;24;38;62;5;2;7
109;25.05.2018;2018;05;16;Perjantai;29;40;69;3;6;9
109;25.05.2018;2018;05;17;Perjantai;12;25;37;4;6;10
109;25.05.2018;2018;05;18;Perjantai;6;8;14;3;2;5
109;25.05.2018;2018;05;19;Perjantai;8;7;15;5;1;6
109;25.05.2018;2018;05;20;Perjantai;7;8;15;3;0;3
109;25.05.2018;2018;05;21;Perjantai;4;9;13;0;2;2
109;25.05.2018;2018;05;22;Perjantai;4;2;6;3;2;5
109;25.05.2018;2018;05;23;Perjantai;7;0;7;1;0;1
109;26.05.2018;2018;05;00;Lauantai;4;4;8;0;1;1
109;26.05.2018;2018;05;01;Lauantai;0;3;3;0;0;0
109;26.05.2018;2018;05;02;Lauantai;3;5;8;0;0;0
109;26.05.2018;2018;05;03;Lauantai;0;4;4;0;1;1
109;26.05.2018;2018;05;04;Lauantai;0;3;3;5;2;7
109;26.05.2018;2018;05;05;Lauantai;1;2;3;0;1;1
109;26.05.2018;2018;05;06;Lauantai;4;0;4;1;0;1
109;26.05.2018;2018;05;07;Lauantai;2;0;2;0;1;1
109;26.05.2018;2018;05;08;Lauantai;4;2;6;1;1;2
109;26.05.2018;2018;05;09;Lauantai;9;3;12;4;2;6
109;26.05.2018;2018;05;10;Lauantai;17;4;21;1;2;3
109;26.05.2018;2018;05;11;Lauantai;13;6;19;3;9;12
109;26.05.2018;2018;05;12;Lauantai;16;2;18;2;4;6
109;26.05.2018;2018;05;13;Lauantai;19;9;28;2;0;2
109;26.05.2018;2018;05;14;Lauantai;15;6;21;3;5;8
109;26.05.2018;2018;05;15;Lauantai;2;12;14;3;2;5
109;26.05.2018;2018;05;16;Lauantai;11;13;24;3;11;14
109;26.05.2018;2018;05;17;Lauantai;24;16;40;9;1;10
109;26.05.2018;2018;05;18;Lauantai;14;14;28;3;5;8
109;26.05.2018;2018;05;19;Lauantai;13;15;28;5;4;9
109;26.05.2018;2018;05;20;Lauantai;4;14;18;6;4;10
109;26.05.2018;2018;05;21;Lauantai;1;5;6;5;3;8
109;26.05.2018;2018;05;22;Lauantai;2;3;5;2;1;3
109;26.05.2018;2018;05;23;Lauantai;4;6;10;0;1;1
109;27.05.2018;2018;05;00;Sunnuntai;6;3;9;1;0;1
109;27.05.2018;2018;05;01;Sunnuntai;2;1;3;1;2;3
109;27.05.2018;2018;05;02;Sunnuntai;0;2;2;2;0;2
109;27.05.2018;2018;05;03;Sunnuntai;2;1;3;0;0;0
109;27.05.2018;2018;05;04;Sunnuntai;1;1;2;0;0;0
109;27.05.2018;2018;05;05;Sunnuntai;0;0;0;0;0;0
109;27.05.2018;2018;05;06;Sunnuntai;4;4;8;0;0;0
109;27.05.2018;2018;05;07;Sunnuntai;0;1;1;3;0;3
109;27.05.2018;2018;05;08;Sunnuntai;2;2;4;2;3;5
109;27.05.2018;2018;05;09;Sunnuntai;9;3;12;6;5;11
109;27.05.2018;2018;05;10;Sunnuntai;4;15;19;3;5;8
109;27.05.2018;2018;05;11;Sunnuntai;9;13;22;1;8;9
109;27.05.2018;2018;05;12;Sunnuntai;16;16;32;7;3;10
109;27.05.2018;2018;05;13;Sunnuntai;12;4;16;13;3;16
109;27.05.2018;2018;05;14;Sunnuntai;16;9;25;3;5;8
109;27.05.2018;2018;05;15;Sunnuntai;14;19;33;6;5;11
109;27.05.2018;2018;05;16;Sunnuntai;9;15;24;2;8;10
109;27.05.2018;2018;05;17;Sunnuntai;6;11;17;2;5;7
109;27.05.2018;2018;05;18;Sunnuntai;12;11;23;4;4;8
109;27.05.2018;2018;05;19;Sunnuntai;9;4;13;5;7;12
109;27.05.2018;2018;05;20;Sunnuntai;11;10;21;0;2;2
109;27.05.2018;2018;05;21;Sunnuntai;4;6;10;8;3;11
109;27.05.2018;2018;05;22;Sunnuntai;3;3;6;3;0;3
109;27.05.2018;2018;05;23;Sunnuntai;3;2;5;2;0;2
109;28.05.2018;2018;05;00;Maanantai;0;2;2;0;0;0
109;28.05.2018;2018;05;01;Maanantai;1;2;3;0;1;1
109;28.05.2018;2018;05;02;Maanantai;2;1;3;3;1;4
109;28.05.2018;2018;05;03;Maanantai;0;0;0;1;0;1
109;28.05.2018;2018;05;04;Maanantai;1;2;3;0;0;0
109;28.05.2018;2018;05;05;Maanantai;2;3;5;1;1;2
109;28.05.2018;2018;05;06;Maanantai;23;24;47;3;2;5
109;28.05.2018;2018;05;07;Maanantai;47;31;78;1;2;3
109;28.05.2018;2018;05;08;Maanantai;42;12;54;3;1;4
109;28.05.2018;2018;05;09;Maanantai;16;6;22;2;7;9
109;28.05.2018;2018;05;10;Maanantai;18;6;24;2;0;2
109;28.05.2018;2018;05;11;Maanantai;11;8;19;3;2;5
109;28.05.2018;2018;05;12;Maanantai;9;15;24;5;1;6
109;28.05.2018;2018;05;13;Maanantai;13;26;39;1;2;3
109;28.05.2018;2018;05;14;Maanantai;13;10;23;6;2;8
109;28.05.2018;2018;05;15;Maanantai;22;29;51;3;2;5
109;28.05.2018;2018;05;16;Maanantai;42;61;103;6;2;8
109;28.05.2018;2018;05;17;Maanantai;17;17;34;2;3;5
109;28.05.2018;2018;05;18;Maanantai;11;17;28;2;2;4
109;28.05.2018;2018;05;19;Maanantai;6;15;21;6;3;9
109;28.05.2018;2018;05;20;Maanantai;7;6;13;6;3;9
109;28.05.2018;2018;05;21;Maanantai;6;4;10;3;1;4
109;28.05.2018;2018;05;22;Maanantai;6;3;9;0;0;0
109;28.05.2018;2018;05;23;Maanantai;0;0;0;0;0;0
109;29.05.2018;2018;05;00;Tiistai;0;0;0;0;0;0
109;29.05.2018;2018;05;01;Tiistai;0;0;0;1;1;2
109;29.05.2018;2018;05;02;Tiistai;1;0;1;0;0;0
109;29.05.2018;2018;05;03;Tiistai;0;0;0;2;1;3
109;29.05.2018;2018;05;04;Tiistai;0;1;1;0;0;0
109;29.05.2018;2018;05;05;Tiistai;3;4;7;2;0;2
109;29.05.2018;2018;05;06;Tiistai;26;11;37;1;3;4
109;29.05.2018;2018;05;07;Tiistai;50;28;78;1;1;2
109;29.05.2018;2018;05;08;Tiistai;39;13;52;5;5;10
109;29.05.2018;2018;05;09;Tiistai;25;8;33;4;0;4
109;29.05.2018;2018;05;10;Tiistai;10;5;15;3;4;7
109;29.05.2018;2018;05;11;Tiistai;11;7;18;0;4;4
109;29.05.2018;2018;05;12;Tiistai;10;9;19;0;4;4
109;29.05.2018;2018;05;13;Tiistai;9;22;31;5;6;11
109;29.05.2018;2018;05;14;Tiistai;14;28;42;2;3;5
109;29.05.2018;2018;05;15;Tiistai;25;49;74;8;1;9
109;29.05.2018;2018;05;16;Tiistai;27;45;72;2;2;4
109;29.05.2018;2018;05;17;Tiistai;28;14;42;5;3;8
109;29.05.2018;2018;05;18;Tiistai;15;12;27;2;5;7
109;29.05.2018;2018;05;19;Tiistai;10;18;28;4;6;10
109;29.05.2018;2018;05;20;Tiistai;2;12;14;5;3;8
109;29.05.2018;2018;05;21;Tiistai;4;5;9;4;2;6
109;29.05.2018;2018;05;22;Tiistai;6;6;12;3;1;4
109;29.05.2018;2018;05;23;Tiistai;0;0;0;0;0;0
109;30.05.2018;2018;05;00;Keskiviikko;0;0;0;0;0;0
109;30.05.2018;2018;05;01;Keskiviikko;1;0;1;2;0;2
109;30.05.2018;2018;05;02;Keskiviikko;2;1;3;0;0;0
109;30.05.2018;2018;05;03;Keskiviikko;0;0;0;0;0;0
109;30.05.2018;2018;05;04;Keskiviikko;0;1;1;1;1;2
109;30.05.2018;2018;05;05;Keskiviikko;3;3;6;1;0;1
109;30.05.2018;2018;05;06;Keskiviikko;22;9;31;8;5;13
109;30.05.2018;2018;05;07;Keskiviikko;49;34;83;6;2;8
109;30.05.2018;2018;05;08;Keskiviikko;43;17;60;6;4;10
109;30.05.2018;2018;05;09;Keskiviikko;8;3;11;7;3;10
109;30.05.2018;2018;05;10;Keskiviikko;7;2;9;3;7;10
109;30.05.2018;2018;05;11;Keskiviikko;7;3;10;2;1;3
109;30.05.2018;2018;05;12;Keskiviikko;10;9;19;4;2;6
109;30.05.2018;2018;05;13;Keskiviikko;8;14;22;1;4;5
109;30.05.2018;2018;05;14;Keskiviikko;15;19;34;3;2;5
109;30.05.2018;2018;05;15;Keskiviikko;24;36;60;1;2;3
109;30.05.2018;2018;05;16;Keskiviikko;40;29;69;11;17;28
109;30.05.2018;2018;05;17;Keskiviikko;18;14;32;4;1;5
109;30.05.2018;2018;05;18;Keskiviikko;9;9;18;3;3;6
109;30.05.2018;2018;05;19;Keskiviikko;7;14;21;7;1;8
109;30.05.2018;2018;05;20;Keskiviikko;9;6;15;2;5;7
109;30.05.2018;2018;05;21;Keskiviikko;6;7;13;3;6;9
109;30.05.2018;2018;05;22;Keskiviikko;4;4;8;2;1;3
109;30.05.2018;2018;05;23;Keskiviikko;1;1;2;0;1;1
109;31.05.2018;2018;05;00;Torstai;0;0;0;0;1;1
109;31.05.2018;2018;05;01;Torstai;0;0;0;0;0;0
109;31.05.2018;2018;05;02;Torstai;2;0;2;0;0;0
109;31.05.2018;2018;05;03;Torstai;2;0;2;0;0;0
109;31.05.2018;2018;05;04;Torstai;0;1;1;0;0;0
109;31.05.2018;2018;05;05;Torstai;3;1;4;1;1;2
109;31.05.2018;2018;05;06;Torstai;19;13;32;1;2;3
109;31.05.2018;2018;05;07;Torstai;45;34;79;3;4;7
109;31.05.2018;2018;05;08;Torstai;39;12;51;9;3;12
109;31.05.2018;2018;05;09;Torstai;17;3;20;5;2;7
109;31.05.2018;2018;05;10;Torstai;11;2;13;5;8;13
109;31.05.2018;2018;05;11;Torstai;4;7;11;2;1;3
109;31.05.2018;2018;05;12;Torstai;8;10;18;5;5;10
109;31.05.2018;2018;05;13;Torstai;17;15;32;4;4;8
109;31.05.2018;2018;05;14;Torstai;19;14;33;3;1;4
109;31.05.2018;2018;05;15;Torstai;20;29;49;4;4;8
109;31.05.2018;2018;05;16;Torstai;31;40;71;3;2;5
109;31.05.2018;2018;05;17;Torstai;23;16;39;5;2;7
109;31.05.2018;2018;05;18;Torstai;9;13;22;6;7;13
109;31.05.2018;2018;05;19;Torstai;8;12;20;2;3;5
109;31.05.2018;2018;05;20;Torstai;5;6;11;1;5;6
109;31.05.2018;2018;05;21;Torstai;4;3;7;4;2;6
109;31.05.2018;2018;05;22;Torstai;4;1;5;0;1;1
109;31.05.2018;2018;05;23;Torstai;1;2;3;2;2;4
109;01.06.2018;2018;06;00;Perjantai;0;0;0;2;0;2
109;01.06.2018;2018;06;01;Perjantai;0;0;0;0;0;0
109;01.06.2018;2018;06;02;Perjantai;1;0;1;0;0;0
109;01.06.2018;2018;06;03;Perjantai;0;0;0;0;0;0
109;01.06.2018;2018;06;04;Perjantai;1;0;1;0;0;0
109;01.06.2018;2018;06;05;Perjantai;12;0;12;1;0;1
109;01.06.2018;2018;06;06;Perjantai;29;0;29;6;0;6
109;01.06.2018;2018;06;07;Perjantai;79;0;79;8;0;8
109;01.06.2018;2018;06;08;Perjantai;52;0;52;5;0;5
109;01.06.2018;2018;06;09;Perjantai;18;0;18;6;0;6
109;01.06.2018;2018;06;10;Perjantai;9;0;9;5;0;5
109;01.06.2018;2018;06;11;Perjantai;24;0;24;4;0;4
109;01.06.2018;2018;06;12;Perjantai;32;0;32;5;0;5
109;01.06.2018;2018;06;13;Perjantai;39;0;39;8;0;8
109;01.06.2018;2018;06;14;Perjantai;59;0;59;11;0;11
109;01.06.2018;2018;06;15;Perjantai;62;0;62;7;0;7
109;01.06.2018;2018;06;16;Perjantai;69;0;69;9;0;9
109;01.06.2018;2018;06;17;Perjantai;37;0;37;10;0;10
109;01.06.2018;2018;06;18;Perjantai;14;0;14;5;0;5
109;01.06.2018;2018;06;19;Perjantai;15;0;15;6;0;6
109;01.06.2018;2018;06;20;Perjantai;15;0;15;3;0;3
109;01.06.2018;2018;06;21;Perjantai;13;0;13;2;0;2
109;01.06.2018;2018;06;22;Perjantai;6;0;6;5;0;5
109;01.06.2018;2018;06;23;Perjantai;7;0;7;1;0;1
109;02.06.2018;2018;06;00;Lauantai;5;5;10;2;0;2
109;02.06.2018;2018;06;01;Lauantai;1;1;2;1;1;2
109;02.06.2018;2018;06;02;Lauantai;0;2;2;0;0;0
109;02.06.2018;2018;06;03;Lauantai;0;1;1;0;1;1
109;02.06.2018;2018;06;04;Lauantai;2;1;3;1;0;1
109;02.06.2018;2018;06;05;Lauantai;2;1;3;0;1;1
109;02.06.2018;2018;06;06;Lauantai;4;5;9;1;1;2
109;02.06.2018;2018;06;07;Lauantai;1;2;3;1;1;2
109;02.06.2018;2018;06;08;Lauantai;7;1;8;2;2;4
109;02.06.2018;2018;06;09;Lauantai;6;5;11;4;1;5
109;02.06.2018;2018;06;10;Lauantai;9;3;12;0;0;0
109;02.06.2018;2018;06;11;Lauantai;7;4;11;4;2;6
109;02.06.2018;2018;06;12;Lauantai;13;6;19;4;2;6
109;02.06.2018;2018;06;13;Lauantai;21;9;30;3;4;7
109;02.06.2018;2018;06;14;Lauantai;7;12;19;5;3;8
109;02.06.2018;2018;06;15;Lauantai;21;21;42;8;4;12
109;02.06.2018;2018;06;16;Lauantai;19;11;30;8;2;10
109;02.06.2018;2018;06;17;Lauantai;10;7;17;2;2;4
109;02.06.2018;2018;06;18;Lauantai;11;12;23;2;2;4
109;02.06.2018;2018;06;19;Lauantai;12;12;24;1;1;2
109;02.06.2018;2018;06;20;Lauantai;9;8;17;3;3;6
109;02.06.2018;2018;06;21;Lauantai;8;7;15;4;2;6
109;02.06.2018;2018;06;22;Lauantai;2;1;3;1;1;2
109;02.06.2018;2018;06;23;Lauantai;2;1;3;1;0;1
109;03.06.2018;2018;06;00;Sunnuntai;8;1;9;1;1;2
109;03.06.2018;2018;06;01;Sunnuntai;2;4;6;1;0;1
109;03.06.2018;2018;06;02;Sunnuntai;0;3;3;3;1;4
109;03.06.2018;2018;06;03;Sunnuntai;0;5;5;0;1;1
109;03.06.2018;2018;06;04;Sunnuntai;2;5;7;0;0;0
109;03.06.2018;2018;06;05;Sunnuntai;2;0;2;0;1;1
109;03.06.2018;2018;06;06;Sunnuntai;5;2;7;0;0;0
109;03.06.2018;2018;06;07;Sunnuntai;0;2;2;0;0;0
109;03.06.2018;2018;06;08;Sunnuntai;3;2;5;3;0;3
109;03.06.2018;2018;06;09;Sunnuntai;9;7;16;2;4;6
109;03.06.2018;2018;06;10;Sunnuntai;9;6;15;2;2;4
109;03.06.2018;2018;06;11;Sunnuntai;6;11;17;5;3;8
109;03.06.2018;2018;06;12;Sunnuntai;13;3;16;6;1;7
109;03.06.2018;2018;06;13;Sunnuntai;12;10;22;9;3;12
109;03.06.2018;2018;06;14;Sunnuntai;15;5;20;2;3;5
109;03.06.2018;2018;06;15;Sunnuntai;12;10;22;6;1;7
109;03.06.2018;2018;06;16;Sunnuntai;11;8;19;2;3;5
109;03.06.2018;2018;06;17;Sunnuntai;12;7;19;6;1;7
109;03.06.2018;2018;06;18;Sunnuntai;8;16;24;4;3;7
109;03.06.2018;2018;06;19;Sunnuntai;4;3;7;5;5;10
109;03.06.2018;2018;06;20;Sunnuntai;7;7;14;2;3;5
109;03.06.2018;2018;06;21;Sunnuntai;1;8;9;6;4;10
109;03.06.2018;2018;06;22;Sunnuntai;1;1;2;0;0;0
109;03.06.2018;2018;06;23;Sunnuntai;0;2;2;1;1;2
109;04.06.2018;2018;06;00;Maanantai;0;0;0;0;0;0
109;04.06.2018;2018;06;01;Maanantai;0;0;0;0;0;0
109;04.06.2018;2018;06;02;Maanantai;0;0;0;0;0;0
109;04.06.2018;2018;06;03;Maanantai;0;1;1;0;0;0
109;04.06.2018;2018;06;04;Maanantai;1;1;2;0;0;0
109;04.06.2018;2018;06;05;Maanantai;4;5;9;1;1;2
109;04.06.2018;2018;06;06;Maanantai;24;12;36;6;1;7
109;04.06.2018;2018;06;07;Maanantai;35;23;58;6;2;8
109;04.06.2018;2018;06;08;Maanantai;22;7;29;5;1;6
109;04.06.2018;2018;06;09;Maanantai;17;4;21;4;2;6
109;04.06.2018;2018;06;10;Maanantai;10;4;14;3;5;8
109;04.06.2018;2018;06;11;Maanantai;7;6;13;3;2;5
109;04.06.2018;2018;06;12;Maanantai;7;5;12;4;2;6
109;04.06.2018;2018;06;13;Maanantai;4;4;8;0;1;1
109;04.06.2018;2018;06;14;Maanantai;11;9;20;7;5;12
109;04.06.2018;2018;06;15;Maanantai;19;16;35;4;4;8
109;04.06.2018;2018;06;16;Maanantai;25;32;57;5;2;7
109;04.06.2018;2018;06;17;Maanantai;10;10;20;3;0;3
109;04.06.2018;2018;06;18;Maanantai;9;9;18;1;1;2
109;04.06.2018;2018;06;19;Maanantai;7;7;14;3;2;5
109;04.06.2018;2018;06;20;Maanantai;1;7;8;4;2;6
109;04.06.2018;2018;06;21;Maanantai;2;11;13;3;3;6
109;04.06.2018;2018;06;22;Maanantai;1;3;4;3;1;4
109;04.06.2018;2018;06;23;Maanantai;0;0;0;0;1;1
109;05.06.2018;2018;06;00;Tiistai;1;0;1;3;1;4
109;05.06.2018;2018;06;01;Tiistai;0;0;0;0;0;0
109;05.06.2018;2018;06;02;Tiistai;0;0;0;0;0;0
109;05.06.2018;2018;06;03;Tiistai;1;0;1;0;0;0
109;05.06.2018;2018;06;04;Tiistai;0;0;0;0;1;1
109;05.06.2018;2018;06;05;Tiistai;4;4;8;1;0;1
109;05.06.2018;2018;06;06;Tiistai;19;10;29;1;3;4
109;05.06.2018;2018;06;07;Tiistai;37;21;58;1;3;4
109;05.06.2018;2018;06;08;Tiistai;17;12;29;6;4;10
109;05.06.2018;2018;06;09;Tiistai;16;3;19;2;2;4
109;05.06.2018;2018;06;10;Tiistai;10;3;13;4;1;5
109;05.06.2018;2018;06;11;Tiistai;10;5;15;4;3;7
109;05.06.2018;2018;06;12;Tiistai;7;9;16;3;3;6
109;05.06.2018;2018;06;13;Tiistai;14;7;21;2;2;4
109;05.06.2018;2018;06;14;Tiistai;8;7;15;6;3;9
109;05.06.2018;2018;06;15;Tiistai;16;18;34;2;1;3
109;05.06.2018;2018;06;16;Tiistai;25;33;58;6;4;10
109;05.06.2018;2018;06;17;Tiistai;11;12;23;8;2;10
109;05.06.2018;2018;06;18;Tiistai;10;12;22;6;3;9
109;05.06.2018;2018;06;19;Tiistai;11;8;19;4;7;11
109;05.06.2018;2018;06;20;Tiistai;7;12;19;4;3;7
109;05.06.2018;2018;06;21;Tiistai;6;14;20;3;1;4
109;05.06.2018;2018;06;22;Tiistai;1;1;2;1;0;1
109;05.06.2018;2018;06;23;Tiistai;0;0;0;0;1;1
109;06.06.2018;2018;06;00;Keskiviikko;0;1;1;0;0;0
109;06.06.2018;2018;06;01;Keskiviikko;2;0;2;0;1;1
109;06.06.2018;2018;06;02;Keskiviikko;0;0;0;0;0;0
109;06.06.2018;2018;06;03;Keskiviikko;0;0;0;0;0;0
109;06.06.2018;2018;06;04;Keskiviikko;1;1;2;0;0;0
109;06.06.2018;2018;06;05;Keskiviikko;3;6;9;3;0;3
109;06.06.2018;2018;06;06;Keskiviikko;26;10;36;3;1;4
109;06.06.2018;2018;06;07;Keskiviikko;38;21;59;5;4;9
109;06.06.2018;2018;06;08;Keskiviikko;24;15;39;3;1;4
109;06.06.2018;2018;06;09;Keskiviikko;12;5;17;1;0;1
109;06.06.2018;2018;06;10;Keskiviikko;9;6;15;4;4;8
109;06.06.2018;2018;06;11;Keskiviikko;10;2;12;4;3;7
109;06.06.2018;2018;06;12;Keskiviikko;4;3;7;6;1;7
109;06.06.2018;2018;06;13;Keskiviikko;10;2;12;2;2;4
109;06.06.2018;2018;06;14;Keskiviikko;13;11;24;7;3;10
109;06.06.2018;2018;06;15;Keskiviikko;16;26;42;4;2;6
109;06.06.2018;2018;06;16;Keskiviikko;32;33;65;7;5;12
109;06.06.2018;2018;06;17;Keskiviikko;22;16;38;5;4;9
109;06.06.2018;2018;06;18;Keskiviikko;11;15;26;7;5;12
109;06.06.2018;2018;06;19;Keskiviikko;11;13;24;7;4;11
109;06.06.2018;2018;06;20;Keskiviikko;6;10;16;6;3;9
109;06.06.2018;2018;06;21;Keskiviikko;4;9;13;2;3;5
109;06.06.2018;2018;06;22;Keskiviikko;4;2;6;0;0;0
109;06.06.2018;2018;06;23;Keskiviikko;0;0;0;0;0;0
109;07.06.2018;2018;06;00;Torstai;3;3;6;0;1;1
109;07.06.2018;2018;06;01;Torstai;0;0;0;0;1;1
109;07.06.2018;2018;06;02;Torstai;0;0;0;0;1;1
109;07.06.2018;2018;06;03;Torstai;0;1;1;0;0;0
109;07.06.2018;2018;06;04;Torstai;1;1;2;0;0;0
109;07.06.2018;2018;06;05;Torstai;2;6;8;1;2;3
109;07.06.2018;2018;06;06;Torstai;16;11;27;1;1;2
109;07.06.2018;2018;06;07;Torstai;26;10;36;1;3;4
109;07.06.2018;2018;06;08;Torstai;19;8;27;2;0;2
109;07.06.2018;2018;06;09;Torstai;8;3;11;3;1;4
109;07.06.2018;2018;06;10;Torstai;3;1;4;2;0;2
109;07.06.2018;2018;06;11;Torstai;2;1;3;4;1;5
109;07.06.2018;2018;06;12;Torstai;3;1;4;2;0;2
109;07.06.2018;2018;06;13;Torstai;3;4;7;1;5;6
109;07.06.2018;2018;06;14;Torstai;11;6;17;3;4;7
109;07.06.2018;2018;06;15;Torstai;17;19;36;8;2;10
109;07.06.2018;2018;06;16;Torstai;26;29;55;4;5;9
109;07.06.2018;2018;06;17;Torstai;17;7;24;4;3;7
109;07.06.2018;2018;06;18;Torstai;8;4;12;6;4;10
109;07.06.2018;2018;06;19;Torstai;4;4;8;6;1;7
109;07.06.2018;2018;06;20;Torstai;3;5;8;5;2;7
109;07.06.2018;2018;06;21;Torstai;5;4;9;1;5;6
109;07.06.2018;2018;06;22;Torstai;3;0;3;4;3;7
109;07.06.2018;2018;06;23;Torstai;0;2;2;1;1;2
109;08.06.2018;2018;06;00;Perjantai;1;0;1;1;1;2
109;08.06.2018;2018;06;01;Perjantai;1;1;2;1;1;2
109;08.06.2018;2018;06;02;Perjantai;0;0;0;0;0;0
109;08.06.2018;2018;06;03;Perjantai;0;0;0;0;0;0
109;08.06.2018;2018;06;04;Perjantai;0;1;1;0;0;0
109;08.06.2018;2018;06;05;Perjantai;1;5;6;1;0;1
109;08.06.2018;2018;06;06;Perjantai;23;8;31;4;1;5
109;08.06.2018;2018;06;07;Perjantai;32;23;55;6;4;10
109;08.06.2018;2018;06;08;Perjantai;24;9;33;5;0;5
109;08.06.2018;2018;06;09;Perjantai;11;7;18;2;5;7
109;08.06.2018;2018;06;10;Perjantai;15;6;21;3;3;6
109;08.06.2018;2018;06;11;Perjantai;16;9;25;2;1;3
109;08.06.2018;2018;06;12;Perjantai;15;3;18;2;2;4
109;08.06.2018;2018;06;13;Perjantai;11;6;17;3;2;5
109;08.06.2018;2018;06;14;Perjantai;23;12;35;3;6;9
109;08.06.2018;2018;06;15;Perjantai;21;27;48;5;4;9
109;08.06.2018;2018;06;16;Perjantai;24;23;47;3;3;6
109;08.06.2018;2018;06;17;Perjantai;6;12;18;5;4;9
109;08.06.2018;2018;06;18;Perjantai;8;9;17;5;6;11
109;08.06.2018;2018;06;19;Perjantai;11;13;24;3;7;10
109;08.06.2018;2018;06;20;Perjantai;7;8;15;3;4;7
109;08.06.2018;2018;06;21;Perjantai;9;5;14;0;1;1
109;08.06.2018;2018;06;22;Perjantai;6;3;9;1;1;2
109;08.06.2018;2018;06;23;Perjantai;2;8;10;0;1;1
109;09.06.2018;2018;06;00;Lauantai;3;7;10;1;0;1
109;09.06.2018;2018;06;01;Lauantai;2;1;3;1;0;1
109;09.06.2018;2018;06;02;Lauantai;0;1;1;0;0;0
109;09.06.2018;2018;06;03;Lauantai;0;1;1;0;1;1
109;09.06.2018;2018;06;04;Lauantai;0;1;1;0;0;0
109;09.06.2018;2018;06;05;Lauantai;1;0;1;0;0;0
109;09.06.2018;2018;06;06;Lauantai;2;0;2;0;1;1
109;09.06.2018;2018;06;07;Lauantai;2;1;3;4;3;7
109;09.06.2018;2018;06;08;Lauantai;1;2;3;1;1;2
109;09.06.2018;2018;06;09;Lauantai;3;2;5;4;5;9
109;09.06.2018;2018;06;10;Lauantai;0;3;3;6;5;11
109;09.06.2018;2018;06;11;Lauantai;6;5;11;3;2;5
109;09.06.2018;2018;06;12;Lauantai;12;8;20;1;1;2
109;09.06.2018;2018;06;13;Lauantai;11;2;13;4;5;9
109;09.06.2018;2018;06;14;Lauantai;7;3;10;3;3;6
109;09.06.2018;2018;06;15;Lauantai;12;3;15;3;3;6
109;09.06.2018;2018;06;16;Lauantai;13;10;23;1;3;4
109;09.06.2018;2018;06;17;Lauantai;5;4;9;2;3;5
109;09.06.2018;2018;06;18;Lauantai;4;2;6;5;2;7
109;09.06.2018;2018;06;19;Lauantai;4;6;10;4;3;7
109;09.06.2018;2018;06;20;Lauantai;3;3;6;2;1;3
109;09.06.2018;2018;06;21;Lauantai;8;5;13;2;2;4
109;09.06.2018;2018;06;22;Lauantai;0;0;0;2;1;3
109;09.06.2018;2018;06;23;Lauantai;3;1;4;1;1;2
109;10.06.2018;2018;06;00;Sunnuntai;2;3;5;0;1;1
109;10.06.2018;2018;06;01;Sunnuntai;1;0;1;0;1;1
109;10.06.2018;2018;06;02;Sunnuntai;0;3;3;1;0;1
109;10.06.2018;2018;06;03;Sunnuntai;0;5;5;0;0;0
109;10.06.2018;2018;06;04;Sunnuntai;0;2;2;0;0;0
109;10.06.2018;2018;06;05;Sunnuntai;2;2;4;0;0;0
109;10.06.2018;2018;06;06;Sunnuntai;2;1;3;0;0;0
109;10.06.2018;2018;06;07;Sunnuntai;1;3;4;0;0;0
109;10.06.2018;2018;06;08;Sunnuntai;2;2;4;0;1;1
109;10.06.2018;2018;06;09;Sunnuntai;0;0;0;5;1;6
109;10.06.2018;2018;06;10;Sunnuntai;4;4;8;4;3;7
109;10.06.2018;2018;06;11;Sunnuntai;6;7;13;6;3;9
109;10.06.2018;2018;06;12;Sunnuntai;15;6;21;9;2;11
109;10.06.2018;2018;06;13;Sunnuntai;10;7;17;7;1;8
109;10.06.2018;2018;06;14;Sunnuntai;5;13;18;2;2;4
109;10.06.2018;2018;06;15;Sunnuntai;8;3;11;6;1;7
109;10.06.2018;2018;06;16;Sunnuntai;12;8;20;2;4;6
109;10.06.2018;2018;06;17;Sunnuntai;14;9;23;3;0;3
109;10.06.2018;2018;06;18;Sunnuntai;14;7;21;3;3;6
109;10.06.2018;2018;06;19;Sunnuntai;7;7;14;4;8;12
109;10.06.2018;2018;06;20;Sunnuntai;11;3;14;7;1;8
109;10.06.2018;2018;06;21;Sunnuntai;4;0;4;0;1;1
109;10.06.2018;2018;06;22;Sunnuntai;4;0;4;2;4;6
109;10.06.2018;2018;06;23;Sunnuntai;3;2;5;1;1;2
109;11.06.2018;2018;06;00;Maanantai;2;2;4;0;1;1
109;11.06.2018;2018;06;01;Maanantai;0;0;0;0;2;2
109;11.06.2018;2018;06;02;Maanantai;3;0;3;3;1;4
109;11.06.2018;2018;06;03;Maanantai;0;0;0;0;0;0
109;11.06.2018;2018;06;04;Maanantai;0;1;1;0;0;0
109;11.06.2018;2018;06;05;Maanantai;1;7;8;0;0;0
109;11.06.2018;2018;06;06;Maanantai;22;12;34;4;1;5
109;11.06.2018;2018;06;07;Maanantai;38;24;62;0;1;1
109;11.06.2018;2018;06;08;Maanantai;28;19;47;2;0;2
109;11.06.2018;2018;06;09;Maanantai;13;3;16;1;3;4
109;11.06.2018;2018;06;10;Maanantai;10;9;19;3;1;4
109;11.06.2018;2018;06;11;Maanantai;14;11;25;2;2;4
109;11.06.2018;2018;06;12;Maanantai;11;10;21;0;2;2
109;11.06.2018;2018;06;13;Maanantai;10;12;22;1;2;3
109;11.06.2018;2018;06;14;Maanantai;15;9;24;4;4;8
109;11.06.2018;2018;06;15;Maanantai;14;21;35;9;5;14
109;11.06.2018;2018;06;16;Maanantai;41;42;83;7;4;11
109;11.06.2018;2018;06;17;Maanantai;22;17;39;5;2;7
109;11.06.2018;2018;06;18;Maanantai;20;18;38;5;7;12
109;11.06.2018;2018;06;19;Maanantai;13;15;28;3;3;6
109;11.06.2018;2018;06;20;Maanantai;9;10;19;7;4;11
109;11.06.2018;2018;06;21;Maanantai;4;7;11;4;2;6
109;11.06.2018;2018;06;22;Maanantai;8;1;9;2;0;2
109;11.06.2018;2018;06;23;Maanantai;2;0;2;1;1;2
109;12.06.2018;2018;06;00;Tiistai;0;1;1;0;1;1
109;12.06.2018;2018;06;01;Tiistai;0;1;1;0;0;0
109;12.06.2018;2018;06;02;Tiistai;1;0;1;0;0;0
109;12.06.2018;2018;06;03;Tiistai;0;0;0;1;0;1
109;12.06.2018;2018;06;04;Tiistai;1;1;2;0;0;0
109;12.06.2018;2018;06;05;Tiistai;2;11;13;2;0;2
109;12.06.2018;2018;06;06;Tiistai;22;13;35;1;1;2
109;12.06.2018;2018;06;07;Tiistai;43;27;70;1;4;5
109;12.06.2018;2018;06;08;Tiistai;28;17;45;4;1;5
109;12.06.2018;2018;06;09;Tiistai;15;7;22;1;3;4
109;12.06.2018;2018;06;10;Tiistai;16;5;21;7;3;10
109;12.06.2018;2018;06;11;Tiistai;17;8;25;5;4;9
109;12.06.2018;2018;06;12;Tiistai;16;10;26;1;1;2
109;12.06.2018;2018;06;13;Tiistai;12;14;26;3;2;5
109;12.06.2018;2018;06;14;Tiistai;16;18;34;3;5;8
109;12.06.2018;2018;06;15;Tiistai;17;24;41;4;5;9
109;12.06.2018;2018;06;16;Tiistai;33;40;73;6;7;13
109;12.06.2018;2018;06;17;Tiistai;25;18;43;5;2;7
109;12.06.2018;2018;06;18;Tiistai;17;17;34;7;2;9
109;12.06.2018;2018;06;19;Tiistai;12;23;35;5;6;11
109;12.06.2018;2018;06;20;Tiistai;8;14;22;2;4;6
109;12.06.2018;2018;06;21;Tiistai;1;6;7;2;1;3
109;12.06.2018;2018;06;22;Tiistai;7;4;11;3;0;3
109;12.06.2018;2018;06;23;Tiistai;4;2;6;1;0;1
109;13.06.2018;2018;06;00;Keskiviikko;0;0;0;2;3;5
109;13.06.2018;2018;06;01;Keskiviikko;0;2;2;0;0;0
109;13.06.2018;2018;06;02;Keskiviikko;2;0;2;1;0;1
109;13.06.2018;2018;06;03;Keskiviikko;0;0;0;0;0;0
109;13.06.2018;2018;06;04;Keskiviikko;0;1;1;0;1;1
109;13.06.2018;2018;06;05;Keskiviikko;1;8;9;1;0;1
109;13.06.2018;2018;06;06;Keskiviikko;21;7;28;3;0;3
109;13.06.2018;2018;06;07;Keskiviikko;41;23;64;2;1;3
109;13.06.2018;2018;06;08;Keskiviikko;21;9;30;7;3;10
109;13.06.2018;2018;06;09;Keskiviikko;6;3;9;1;4;5
109;13.06.2018;2018;06;10;Keskiviikko;10;8;18;5;2;7
109;13.06.2018;2018;06;11;Keskiviikko;5;6;11;2;3;5
109;13.06.2018;2018;06;12;Keskiviikko;12;5;17;0;1;1
109;13.06.2018;2018;06;13;Keskiviikko;9;13;22;2;4;6
109;13.06.2018;2018;06;14;Keskiviikko;25;12;37;3;4;7
109;13.06.2018;2018;06;15;Keskiviikko;27;26;53;2;3;5
109;13.06.2018;2018;06;16;Keskiviikko;27;28;55;6;6;12
109;13.06.2018;2018;06;17;Keskiviikko;18;16;34;5;5;10
109;13.06.2018;2018;06;18;Keskiviikko;7;24;31;6;3;9
109;13.06.2018;2018;06;19;Keskiviikko;12;7;19;4;6;10
109;13.06.2018;2018;06;20;Keskiviikko;9;11;20;4;2;6
109;13.06.2018;2018;06;21;Keskiviikko;3;6;9;1;2;3
109;13.06.2018;2018;06;22;Keskiviikko;9;8;17;0;1;1
109;13.06.2018;2018;06;23;Keskiviikko;2;1;3;1;2;3
109;14.06.2018;2018;06;00;Torstai;0;0;0;0;0;0
109;14.06.2018;2018;06;01;Torstai;0;0;0;1;1;2
109;14.06.2018;2018;06;02;Torstai;0;0;0;0;0;0
109;14.06.2018;2018;06;03;Torstai;1;3;4;0;0;0
109;14.06.2018;2018;06;04;Torstai;0;0;0;0;0;0
109;14.06.2018;2018;06;05;Torstai;2;9;11;1;2;3
109;14.06.2018;2018;06;06;Torstai;29;13;42;0;2;2
109;14.06.2018;2018;06;07;Torstai;39;28;67;0;0;0
109;14.06.2018;2018;06;08;Torstai;26;5;31;9;2;11
109;14.06.2018;2018;06;09;Torstai;12;4;16;9;1;10
109;14.06.2018;2018;06;10;Torstai;16;1;17;1;1;2
109;14.06.2018;2018;06;11;Torstai;15;8;23;5;3;8
109;14.06.2018;2018;06;12;Torstai;13;10;23;2;3;5
109;14.06.2018;2018;06;13;Torstai;12;12;24;3;3;6
109;14.06.2018;2018;06;14;Torstai;16;13;29;3;4;7
109;14.06.2018;2018;06;15;Torstai;26;28;54;5;3;8
109;14.06.2018;2018;06;16;Torstai;33;39;72;3;3;6
109;14.06.2018;2018;06;17;Torstai;16;16;32;5;3;8
109;14.06.2018;2018;06;18;Torstai;12;13;25;6;1;7
109;14.06.2018;2018;06;19;Torstai;6;11;17;4;2;6
109;14.06.2018;2018;06;20;Torstai;12;14;26;1;0;1
109;14.06.2018;2018;06;21;Torstai;3;10;13;1;2;3
109;14.06.2018;2018;06;22;Torstai;5;7;12;3;2;5
109;14.06.2018;2018;06;23;Torstai;3;0;3;1;0;1
109;15.06.2018;2018;06;00;Perjantai;1;0;1;1;2;3
109;15.06.2018;2018;06;01;Perjantai;0;6;6;1;2;3
109;15.06.2018;2018;06;02;Perjantai;4;0;4;0;3;3
109;15.06.2018;2018;06;03;Perjantai;0;0;0;1;0;1
109;15.06.2018;2018;06;04;Perjantai;0;0;0;0;0;0
109;15.06.2018;2018;06;05;Perjantai;5;7;12;0;0;0
109;15.06.2018;2018;06;06;Perjantai;18;11;29;1;2;3
109;15.06.2018;2018;06;07;Perjantai;34;23;57;1;2;3
109;15.06.2018;2018;06;08;Perjantai;25;5;30;2;1;3
109;15.06.2018;2018;06;09;Perjantai;13;7;20;3;5;8
109;15.06.2018;2018;06;10;Perjantai;9;2;11;2;2;4
109;15.06.2018;2018;06;11;Perjantai;13;7;20;1;0;1
109;15.06.2018;2018;06;12;Perjantai;9;5;14;3;1;4
109;15.06.2018;2018;06;13;Perjantai;21;5;26;3;2;5
109;15.06.2018;2018;06;14;Perjantai;12;15;27;2;1;3
109;15.06.2018;2018;06;15;Perjantai;20;30;50;3;4;7
109;15.06.2018;2018;06;16;Perjantai;18;18;36;5;3;8
109;15.06.2018;2018;06;17;Perjantai;11;19;30;2;4;6
109;15.06.2018;2018;06;18;Perjantai;13;17;30;0;2;2
109;15.06.2018;2018;06;19;Perjantai;10;17;27;2;1;3
109;15.06.2018;2018;06;20;Perjantai;2;4;6;3;2;5
109;15.06.2018;2018;06;21;Perjantai;0;10;10;0;1;1
109;15.06.2018;2018;06;22;Perjantai;3;4;7;0;2;2
109;15.06.2018;2018;06;23;Perjantai;2;3;5;5;0;5
109;16.06.2018;2018;06;00;Lauantai;4;5;9;1;0;1
109;16.06.2018;2018;06;01;Lauantai;6;1;7;0;0;0
109;16.06.2018;2018;06;02;Lauantai;1;1;2;0;0;0
109;16.06.2018;2018;06;03;Lauantai;0;2;2;0;1;1
109;16.06.2018;2018;06;04;Lauantai;2;0;2;0;0;0
109;16.06.2018;2018;06;05;Lauantai;1;4;5;0;1;1
109;16.06.2018;2018;06;06;Lauantai;8;1;9;0;0;0
109;16.06.2018;2018;06;07;Lauantai;3;3;6;1;1;2
109;16.06.2018;2018;06;08;Lauantai;5;1;6;2;3;5
109;16.06.2018;2018;06;09;Lauantai;2;5;7;3;0;3
109;16.06.2018;2018;06;10;Lauantai;7;3;10;3;2;5
109;16.06.2018;2018;06;11;Lauantai;9;4;13;3;4;7
109;16.06.2018;2018;06;12;Lauantai;18;6;24;0;0;0
109;16.06.2018;2018;06;13;Lauantai;19;8;27;5;4;9
109;16.06.2018;2018;06;14;Lauantai;23;11;34;2;0;2
109;16.06.2018;2018;06;15;Lauantai;18;10;28;3;1;4
109;16.06.2018;2018;06;16;Lauantai;5;12;17;4;2;6
109;16.06.2018;2018;06;17;Lauantai;10;11;21;1;2;3
109;16.06.2018;2018;06;18;Lauantai;8;5;13;4;4;8
109;16.06.2018;2018;06;19;Lauantai;6;5;11;4;3;7
109;16.06.2018;2018;06;20;Lauantai;9;11;20;1;2;3
109;16.06.2018;2018;06;21;Lauantai;4;9;13;0;4;4
109;16.06.2018;2018;06;22;Lauantai;4;8;12;0;0;0
109;16.06.2018;2018;06;23;Lauantai;1;2;3;2;1;3
109;17.06.2018;2018;06;00;Sunnuntai;2;4;6;1;2;3
109;17.06.2018;2018;06;01;Sunnuntai;2;2;4;0;0;0
109;17.06.2018;2018;06;02;Sunnuntai;1;5;6;0;0;0
109;17.06.2018;2018;06;03;Sunnuntai;0;4;4;0;0;0
109;17.06.2018;2018;06;04;Sunnuntai;0;3;3;0;1;1
109;17.06.2018;2018;06;05;Sunnuntai;0;0;0;1;2;3
109;17.06.2018;2018;06;06;Sunnuntai;6;2;8;0;0;0
109;17.06.2018;2018;06;07;Sunnuntai;0;3;3;0;1;1
109;17.06.2018;2018;06;08;Sunnuntai;2;1;3;3;1;4
109;17.06.2018;2018;06;09;Sunnuntai;10;0;10;4;1;5
109;17.06.2018;2018;06;10;Sunnuntai;15;5;20;2;3;5
109;17.06.2018;2018;06;11;Sunnuntai;12;3;15;4;4;8
109;17.06.2018;2018;06;12;Sunnuntai;15;8;23;2;1;3
109;17.06.2018;2018;06;13;Sunnuntai;13;14;27;6;5;11
109;17.06.2018;2018;06;14;Sunnuntai;18;12;30;8;1;9
109;17.06.2018;2018;06;15;Sunnuntai;8;17;25;4;1;5
109;17.06.2018;2018;06;16;Sunnuntai;8;11;19;0;1;1
109;17.06.2018;2018;06;17;Sunnuntai;18;17;35;5;2;7
109;17.06.2018;2018;06;18;Sunnuntai;11;14;25;6;3;9
109;17.06.2018;2018;06;19;Sunnuntai;11;5;16;4;1;5
109;17.06.2018;2018;06;20;Sunnuntai;5;4;9;4;2;6
109;17.06.2018;2018;06;21;Sunnuntai;3;6;9;6;2;8
109;17.06.2018;2018;06;22;Sunnuntai;5;1;6;0;1;1
109;17.06.2018;2018;06;23;Sunnuntai;0;2;2;1;1;2
109;18.06.2018;2018;06;00;Maanantai;2;0;2;1;1;2
109;18.06.2018;2018;06;01;Maanantai;1;0;1;1;1;2
109;18.06.2018;2018;06;02;Maanantai;0;0;0;0;0;0
109;18.06.2018;2018;06;03;Maanantai;0;0;0;0;0;0
109;18.06.2018;2018;06;04;Maanantai;0;1;1;2;1;3
109;18.06.2018;2018;06;05;Maanantai;2;4;6;3;0;3
109;18.06.2018;2018;06;06;Maanantai;20;9;29;3;0;3
109;18.06.2018;2018;06;07;Maanantai;32;24;56;2;0;2
109;18.06.2018;2018;06;08;Maanantai;27;7;34;4;0;4
109;18.06.2018;2018;06;09;Maanantai;12;1;13;4;3;7
109;18.06.2018;2018;06;10;Maanantai;4;6;10;3;2;5
109;18.06.2018;2018;06;11;Maanantai;7;5;12;3;3;6
109;18.06.2018;2018;06;12;Maanantai;7;3;10;0;3;3
109;18.06.2018;2018;06;13;Maanantai;6;9;15;3;0;3
109;18.06.2018;2018;06;14;Maanantai;20;9;29;2;4;6
109;18.06.2018;2018;06;15;Maanantai;14;23;37;15;5;20
109;18.06.2018;2018;06;16;Maanantai;22;38;60;7;4;11
109;18.06.2018;2018;06;17;Maanantai;9;12;21;2;1;3
109;18.06.2018;2018;06;18;Maanantai;5;5;10;5;2;7
109;18.06.2018;2018;06;19;Maanantai;8;9;17;3;3;6
109;18.06.2018;2018;06;20;Maanantai;4;4;8;4;5;9
109;18.06.2018;2018;06;21;Maanantai;10;7;17;3;3;6
109;18.06.2018;2018;06;22;Maanantai;4;1;5;3;0;3
109;18.06.2018;2018;06;23;Maanantai;2;2;4;1;1;2
109;19.06.2018;2018;06;00;Tiistai;1;0;1;0;0;0
109;19.06.2018;2018;06;01;Tiistai;0;0;0;0;1;1
109;19.06.2018;2018;06;02;Tiistai;2;0;2;1;0;1
109;19.06.2018;2018;06;03;Tiistai;0;3;3;0;1;1
109;19.06.2018;2018;06;04;Tiistai;0;0;0;1;0;1
109;19.06.2018;2018;06;05;Tiistai;2;6;8;2;0;2
109;19.06.2018;2018;06;06;Tiistai;25;8;33;0;2;2
109;19.06.2018;2018;06;07;Tiistai;26;20;46;1;1;2
109;19.06.2018;2018;06;08;Tiistai;28;12;40;4;1;5
109;19.06.2018;2018;06;09;Tiistai;13;0;13;2;4;6
109;19.06.2018;2018;06;10;Tiistai;7;7;14;5;4;9
109;19.06.2018;2018;06;11;Tiistai;6;7;13;5;2;7
109;19.06.2018;2018;06;12;Tiistai;5;4;9;1;0;1
109;19.06.2018;2018;06;13;Tiistai;0;3;3;2;1;3
109;19.06.2018;2018;06;14;Tiistai;9;9;18;2;3;5
109;19.06.2018;2018;06;15;Tiistai;14;17;31;1;0;1
109;19.06.2018;2018;06;16;Tiistai;24;23;47;3;1;4
109;19.06.2018;2018;06;17;Tiistai;3;12;15;3;1;4
109;19.06.2018;2018;06;18;Tiistai;4;4;8;3;4;7
109;19.06.2018;2018;06;19;Tiistai;8;4;12;8;5;13
109;19.06.2018;2018;06;20;Tiistai;2;5;7;4;5;9
109;19.06.2018;2018;06;21;Tiistai;3;7;10;1;2;3
109;19.06.2018;2018;06;22;Tiistai;3;3;6;1;2;3
109;19.06.2018;2018;06;23;Tiistai;0;1;1;0;0;0
109;20.06.2018;2018;06;00;Keskiviikko;0;1;1;0;0;0
109;20.06.2018;2018;06;01;Keskiviikko;0;0;0;0;1;1
109;20.06.2018;2018;06;02;Keskiviikko;4;0;4;0;0;0
109;20.06.2018;2018;06;03;Keskiviikko;0;0;0;0;1;1
109;20.06.2018;2018;06;04;Keskiviikko;0;0;0;0;0;0
109;20.06.2018;2018;06;05;Keskiviikko;2;6;8;1;0;1
109;20.06.2018;2018;06;06;Keskiviikko;19;17;36;1;1;2
109;20.06.2018;2018;06;07;Keskiviikko;37;24;61;1;2;3
109;20.06.2018;2018;06;08;Keskiviikko;19;6;25;5;0;5
109;20.06.2018;2018;06;09;Keskiviikko;12;4;16;4;1;5
109;20.06.2018;2018;06;10;Keskiviikko;5;5;10;4;3;7
109;20.06.2018;2018;06;11;Keskiviikko;14;9;23;12;7;19
109;20.06.2018;2018;06;12;Keskiviikko;6;14;20;1;2;3
109;20.06.2018;2018;06;13;Keskiviikko;7;11;18;1;2;3
109;20.06.2018;2018;06;14;Keskiviikko;20;8;28;3;1;4
109;20.06.2018;2018;06;15;Keskiviikko;20;23;43;9;2;11
109;20.06.2018;2018;06;16;Keskiviikko;29;35;64;10;3;13
109;20.06.2018;2018;06;17;Keskiviikko;18;15;33;0;1;1
109;20.06.2018;2018;06;18;Keskiviikko;10;9;19;5;3;8
109;20.06.2018;2018;06;19;Keskiviikko;10;16;26;0;1;1
109;20.06.2018;2018;06;20;Keskiviikko;7;11;18;6;4;10
109;20.06.2018;2018;06;21;Keskiviikko;7;3;10;4;0;4
109;20.06.2018;2018;06;22;Keskiviikko;2;2;4;0;0;0
109;20.06.2018;2018;06;23;Keskiviikko;1;2;3;0;0;0
109;21.06.2018;2018;06;00;Torstai;0;0;0;0;0;0
109;21.06.2018;2018;06;01;Torstai;0;0;0;0;2;2
109;21.06.2018;2018;06;02;Torstai;0;1;1;0;0;0
109;21.06.2018;2018;06;03;Torstai;0;1;1;0;0;0
109;21.06.2018;2018;06;04;Torstai;0;1;1;0;1;1
109;21.06.2018;2018;06;05;Torstai;1;6;7;0;0;0
109;21.06.2018;2018;06;06;Torstai;22;16;38;2;2;4
109;21.06.2018;2018;06;07;Torstai;27;19;46;3;2;5
109;21.06.2018;2018;06;08;Torstai;26;3;29;3;0;3
109;21.06.2018;2018;06;09;Torstai;13;5;18;3;1;4
109;21.06.2018;2018;06;10;Torstai;6;6;12;5;2;7
109;21.06.2018;2018;06;11;Torstai;10;9;19;3;2;5
109;21.06.2018;2018;06;12;Torstai;17;6;23;1;1;2
109;21.06.2018;2018;06;13;Torstai;15;19;34;3;4;7
109;21.06.2018;2018;06;14;Torstai;19;17;36;2;2;4
109;21.06.2018;2018;06;15;Torstai;27;30;57;2;2;4
109;21.06.2018;2018;06;16;Torstai;20;24;44;4;4;8
109;21.06.2018;2018;06;17;Torstai;6;8;14;4;3;7
109;21.06.2018;2018;06;18;Torstai;10;9;19;10;2;12
109;21.06.2018;2018;06;19;Torstai;12;10;22;3;2;5
109;21.06.2018;2018;06;20;Torstai;12;3;15;3;3;6
109;21.06.2018;2018;06;21;Torstai;4;3;7;3;0;3
109;21.06.2018;2018;06;22;Torstai;6;3;9;1;1;2
109;21.06.2018;2018;06;23;Torstai;4;0;4;1;2;3
109;22.06.2018;2018;06;00;Perjantai;4;1;5;0;1;1
109;22.06.2018;2018;06;01;Perjantai;1;3;4;1;0;1
109;22.06.2018;2018;06;02;Perjantai;1;3;4;0;1;1
109;22.06.2018;2018;06;03;Perjantai;0;2;2;1;0;1
109;22.06.2018;2018;06;04;Perjantai;0;0;0;0;1;1
109;22.06.2018;2018;06;05;Perjantai;0;0;0;0;0;0
109;22.06.2018;2018;06;06;Perjantai;5;0;5;0;0;0
109;22.06.2018;2018;06;07;Perjantai;0;3;3;1;0;1
109;22.06.2018;2018;06;08;Perjantai;1;0;1;2;1;3
109;22.06.2018;2018;06;09;Perjantai;3;1;4;1;0;1
109;22.06.2018;2018;06;10;Perjantai;0;1;1;3;0;3
109;22.06.2018;2018;06;11;Perjantai;2;1;3;2;0;2
109;22.06.2018;2018;06;12;Perjantai;0;0;0;1;0;1
109;22.06.2018;2018;06;13;Perjantai;1;1;2;0;0;0
109;22.06.2018;2018;06;14;Perjantai;1;4;5;3;3;6
109;22.06.2018;2018;06;15;Perjantai;5;2;7;0;2;2
109;22.06.2018;2018;06;16;Perjantai;2;1;3;3;1;4
109;22.06.2018;2018;06;17;Perjantai;4;4;8;3;1;4
109;22.06.2018;2018;06;18;Perjantai;5;4;9;1;3;4
109;22.06.2018;2018;06;19;Perjantai;1;6;7;3;4;7
109;22.06.2018;2018;06;20;Perjantai;2;1;3;2;5;7
109;22.06.2018;2018;06;21;Perjantai;0;1;1;4;1;5
109;22.06.2018;2018;06;22;Perjantai;0;1;1;2;1;3
109;22.06.2018;2018;06;23;Perjantai;5;1;6;0;0;0
109;23.06.2018;2018;06;00;Lauantai;0;0;0;0;1;1
109;23.06.2018;2018;06;01;Lauantai;7;2;9;0;0;0
109;23.06.2018;2018;06;02;Lauantai;0;0;0;0;0;0
109;23.06.2018;2018;06;03;Lauantai;0;0;0;0;0;0
109;23.06.2018;2018;06;04;Lauantai;0;0;0;0;0;0
109;23.06.2018;2018;06;05;Lauantai;1;1;2;0;1;1
109;23.06.2018;2018;06;06;Lauantai;3;0;3;0;0;0
109;23.06.2018;2018;06;07;Lauantai;2;0;2;0;0;0
109;23.06.2018;2018;06;08;Lauantai;0;0;0;0;2;2
109;23.06.2018;2018;06;09;Lauantai;0;0;0;2;0;2
109;23.06.2018;2018;06;10;Lauantai;1;0;1;0;1;1
109;23.06.2018;2018;06;11;Lauantai;1;0;1;2;2;4
109;23.06.2018;2018;06;12;Lauantai;6;1;7;4;1;5
109;23.06.2018;2018;06;13;Lauantai;1;2;3;1;3;4
109;23.06.2018;2018;06;14;Lauantai;2;3;5;5;6;11
109;23.06.2018;2018;06;15;Lauantai;2;4;6;4;2;6
109;23.06.2018;2018;06;16;Lauantai;4;0;4;2;2;4
109;23.06.2018;2018;06;17;Lauantai;5;3;8;4;2;6
109;23.06.2018;2018;06;18;Lauantai;1;2;3;1;2;3
109;23.06.2018;2018;06;19;Lauantai;5;0;5;10;2;12
109;23.06.2018;2018;06;20;Lauantai;0;4;4;3;2;5
109;23.06.2018;2018;06;21;Lauantai;2;2;4;3;2;5
109;23.06.2018;2018;06;22;Lauantai;0;1;1;1;0;1
109;23.06.2018;2018;06;23;Lauantai;2;0;2;2;0;2
109;24.06.2018;2018;06;00;Sunnuntai;0;1;1;0;0;0
109;24.06.2018;2018;06;01;Sunnuntai;1;4;5;1;2;3
109;24.06.2018;2018;06;02;Sunnuntai;0;0;0;0;0;0
109;24.06.2018;2018;06;03;Sunnuntai;0;1;1;0;0;0
109;24.06.2018;2018;06;04;Sunnuntai;0;0;0;0;0;0
109;24.06.2018;2018;06;05;Sunnuntai;1;0;1;0;0;0
109;24.06.2018;2018;06;06;Sunnuntai;4;2;6;0;1;1
109;24.06.2018;2018;06;07;Sunnuntai;2;0;2;0;1;1
109;24.06.2018;2018;06;08;Sunnuntai;0;0;0;5;1;6
109;24.06.2018;2018;06;09;Sunnuntai;4;0;4;5;1;6
109;24.06.2018;2018;06;10;Sunnuntai;7;8;15;4;1;5
109;24.06.2018;2018;06;11;Sunnuntai;14;5;19;8;1;9
109;24.06.2018;2018;06;12;Sunnuntai;14;9;23;2;2;4
109;24.06.2018;2018;06;13;Sunnuntai;9;9;18;2;4;6
109;24.06.2018;2018;06;14;Sunnuntai;6;10;16;12;1;13
109;24.06.2018;2018;06;15;Sunnuntai;12;10;22;7;6;13
109;24.06.2018;2018;06;16;Sunnuntai;11;5;16;4;4;8
109;24.06.2018;2018;06;17;Sunnuntai;10;10;20;3;1;4
109;24.06.2018;2018;06;18;Sunnuntai;5;12;17;3;2;5
109;24.06.2018;2018;06;19;Sunnuntai;12;6;18;3;0;3
109;24.06.2018;2018;06;20;Sunnuntai;10;5;15;0;2;2
109;24.06.2018;2018;06;21;Sunnuntai;4;12;16;2;5;7
109;24.06.2018;2018;06;22;Sunnuntai;0;3;3;0;1;1
109;24.06.2018;2018;06;23;Sunnuntai;0;0;0;1;0;1
109;25.06.2018;2018;06;00;Maanantai;0;0;0;1;1;2
109;25.06.2018;2018;06;01;Maanantai;2;1;3;0;0;0
109;25.06.2018;2018;06;02;Maanantai;1;2;3;0;0;0
109;25.06.2018;2018;06;03;Maanantai;0;0;0;1;0;1
109;25.06.2018;2018;06;04;Maanantai;1;0;1;0;0;0
109;25.06.2018;2018;06;05;Maanantai;2;5;7;2;0;2
109;25.06.2018;2018;06;06;Maanantai;26;12;38;1;4;5
109;25.06.2018;2018;06;07;Maanantai;32;21;53;1;2;3
109;25.06.2018;2018;06;08;Maanantai;28;6;34;6;5;11
109;25.06.2018;2018;06;09;Maanantai;7;2;9;5;3;8
109;25.06.2018;2018;06;10;Maanantai;11;7;18;8;2;10
109;25.06.2018;2018;06;11;Maanantai;15;4;19;2;2;4
109;25.06.2018;2018;06;12;Maanantai;12;8;20;2;2;4
109;25.06.2018;2018;06;13;Maanantai;23;10;33;4;1;5
109;25.06.2018;2018;06;14;Maanantai;16;16;32;7;2;9
109;25.06.2018;2018;06;15;Maanantai;21;23;44;6;5;11
109;25.06.2018;2018;06;16;Maanantai;19;32;51;6;8;14
109;25.06.2018;2018;06;17;Maanantai;12;24;36;4;2;6
109;25.06.2018;2018;06;18;Maanantai;24;14;38;3;3;6
109;25.06.2018;2018;06;19;Maanantai;14;16;30;5;5;10
109;25.06.2018;2018;06;20;Maanantai;7;13;20;3;5;8
109;25.06.2018;2018;06;21;Maanantai;3;10;13;1;0;1
109;25.06.2018;2018;06;22;Maanantai;6;5;11;3;2;5
109;25.06.2018;2018;06;23;Maanantai;0;0;0;0;0;0
109;26.06.2018;2018;06;00;Tiistai;1;0;1;2;0;2
109;26.06.2018;2018;06;01;Tiistai;0;2;2;0;1;1
109;26.06.2018;2018;06;02;Tiistai;0;2;2;0;0;0
109;26.06.2018;2018;06;03;Tiistai;0;1;1;0;0;0
109;26.06.2018;2018;06;04;Tiistai;0;0;0;0;0;0
109;26.06.2018;2018;06;05;Tiistai;4;6;10;2;1;3
109;26.06.2018;2018;06;06;Tiistai;24;13;37;1;1;2
109;26.06.2018;2018;06;07;Tiistai;30;22;52;3;1;4
109;26.06.2018;2018;06;08;Tiistai;27;10;37;6;1;7
109;26.06.2018;2018;06;09;Tiistai;18;8;26;5;3;8
109;26.06.2018;2018;06;10;Tiistai;17;3;20;3;4;7
109;26.06.2018;2018;06;11;Tiistai;7;10;17;5;2;7
109;26.06.2018;2018;06;12;Tiistai;10;11;21;3;2;5
109;26.06.2018;2018;06;13;Tiistai;13;9;22;2;4;6
109;26.06.2018;2018;06;14;Tiistai;24;17;41;3;1;4
109;26.06.2018;2018;06;15;Tiistai;25;22;47;0;4;4
109;26.06.2018;2018;06;16;Tiistai;24;31;55;3;4;7
109;26.06.2018;2018;06;17;Tiistai;14;17;31;4;6;10
109;26.06.2018;2018;06;18;Tiistai;16;11;27;5;4;9
109;26.06.2018;2018;06;19;Tiistai;15;13;28;5;0;5
109;26.06.2018;2018;06;20;Tiistai;10;19;29;1;1;2
109;26.06.2018;2018;06;21;Tiistai;0;10;10;4;2;6
109;26.06.2018;2018;06;22;Tiistai;7;3;10;0;0;0
109;26.06.2018;2018;06;23;Tiistai;2;1;3;2;0;2
109;27.06.2018;2018;06;00;Keskiviikko;0;1;1;1;1;2
109;27.06.2018;2018;06;01;Keskiviikko;0;0;0;1;0;1
109;27.06.2018;2018;06;02;Keskiviikko;0;3;3;0;0;0
109;27.06.2018;2018;06;03;Keskiviikko;0;2;2;0;0;0
109;27.06.2018;2018;06;04;Keskiviikko;0;0;0;0;0;0
109;27.06.2018;2018;06;05;Keskiviikko;2;4;6;3;0;3
109;27.06.2018;2018;06;06;Keskiviikko;18;15;33;3;2;5
109;27.06.2018;2018;06;07;Keskiviikko;34;21;55;2;3;5
109;27.06.2018;2018;06;08;Keskiviikko;23;8;31;5;1;6
109;27.06.2018;2018;06;09;Keskiviikko;10;4;14;5;4;9
109;27.06.2018;2018;06;10;Keskiviikko;14;6;20;4;2;6
109;27.06.2018;2018;06;11;Keskiviikko;13;5;18;1;2;3
109;27.06.2018;2018;06;12;Keskiviikko;11;10;21;4;0;4
109;27.06.2018;2018;06;13;Keskiviikko;6;10;16;0;1;1
109;27.06.2018;2018;06;14;Keskiviikko;15;18;33;2;0;2
109;27.06.2018;2018;06;15;Keskiviikko;19;18;37;5;2;7
109;27.06.2018;2018;06;16;Keskiviikko;34;28;62;10;6;16
109;27.06.2018;2018;06;17;Keskiviikko;17;15;32;4;2;6
109;27.06.2018;2018;06;18;Keskiviikko;10;17;27;5;2;7
109;27.06.2018;2018;06;19;Keskiviikko;12;15;27;6;4;10
109;27.06.2018;2018;06;20;Keskiviikko;11;7;18;7;3;10
109;27.06.2018;2018;06;21;Keskiviikko;5;8;13;2;5;7
109;27.06.2018;2018;06;22;Keskiviikko;5;3;8;1;1;2
109;27.06.2018;2018;06;23;Keskiviikko;2;0;2;1;0;1
109;28.06.2018;2018;06;00;Torstai;0;0;0;1;1;2
109;28.06.2018;2018;06;01;Torstai;0;1;1;0;1;1
109;28.06.2018;2018;06;02;Torstai;0;0;0;0;0;0
109;28.06.2018;2018;06;03;Torstai;0;2;2;0;0;0
109;28.06.2018;2018;06;04;Torstai;0;0;0;0;0;0
109;28.06.2018;2018;06;05;Torstai;2;4;6;0;0;0
109;28.06.2018;2018;06;06;Torstai;15;13;28;3;1;4
109;28.06.2018;2018;06;07;Torstai;23;21;44;1;0;1
109;28.06.2018;2018;06;08;Torstai;18;7;25;0;1;1
109;28.06.2018;2018;06;09;Torstai;7;7;14;1;3;4
109;28.06.2018;2018;06;10;Torstai;1;0;1;2;0;2
109;28.06.2018;2018;06;11;Torstai;3;2;5;0;1;1
109;28.06.2018;2018;06;12;Torstai;4;2;6;0;2;2
109;28.06.2018;2018;06;13;Torstai;5;2;7;2;1;3
109;28.06.2018;2018;06;14;Torstai;9;9;18;1;0;1
109;28.06.2018;2018;06;15;Torstai;11;13;24;6;1;7
109;28.06.2018;2018;06;16;Torstai;16;15;31;4;3;7
109;28.06.2018;2018;06;17;Torstai;7;10;17;4;3;7
109;28.06.2018;2018;06;18;Torstai;6;6;12;1;2;3
109;28.06.2018;2018;06;19;Torstai;2;2;4;5;2;7
109;28.06.2018;2018;06;20;Torstai;2;3;5;2;2;4
109;28.06.2018;2018;06;21;Torstai;3;4;7;1;1;2
109;28.06.2018;2018;06;22;Torstai;3;0;3;1;1;2
109;28.06.2018;2018;06;23;Torstai;2;2;4;2;0;2
109;29.06.2018;2018;06;00;Perjantai;1;2;3;1;0;1
109;29.06.2018;2018;06;01;Perjantai;0;0;0;0;1;1
109;29.06.2018;2018;06;02;Perjantai;2;1;3;1;1;2
109;29.06.2018;2018;06;03;Perjantai;0;1;1;0;0;0
109;29.06.2018;2018;06;04;Perjantai;0;2;2;0;0;0
109;29.06.2018;2018;06;05;Perjantai;2;5;7;0;0;0
109;29.06.2018;2018;06;06;Perjantai;14;8;22;1;3;4
109;29.06.2018;2018;06;07;Perjantai;25;20;45;3;2;5
109;29.06.2018;2018;06;08;Perjantai;13;3;16;3;2;5
109;29.06.2018;2018;06;09;Perjantai;14;4;18;4;1;5
109;29.06.2018;2018;06;10;Perjantai;3;4;7;4;0;4
109;29.06.2018;2018;06;11;Perjantai;8;7;15;1;0;1
109;29.06.2018;2018;06;12;Perjantai;8;5;13;3;4;7
109;29.06.2018;2018;06;13;Perjantai;19;5;24;4;3;7
109;29.06.2018;2018;06;14;Perjantai;14;16;30;1;1;2
109;29.06.2018;2018;06;15;Perjantai;15;22;37;3;6;9
109;29.06.2018;2018;06;16;Perjantai;26;23;49;6;0;6
109;29.06.2018;2018;06;17;Perjantai;3;11;14;5;3;8
109;29.06.2018;2018;06;18;Perjantai;8;9;17;3;2;5
109;29.06.2018;2018;06;19;Perjantai;3;8;11;2;0;2
109;29.06.2018;2018;06;20;Perjantai;7;6;13;1;3;4
109;29.06.2018;2018;06;21;Perjantai;9;6;15;1;1;2
109;29.06.2018;2018;06;22;Perjantai;2;8;10;1;0;1
109;29.06.2018;2018;06;23;Perjantai;3;0;3;1;3;4
109;30.06.2018;2018;06;00;Lauantai;4;1;5;2;3;5
109;30.06.2018;2018;06;01;Lauantai;0;3;3;1;0;1
109;30.06.2018;2018;06;02;Lauantai;1;0;1;1;0;1
109;30.06.2018;2018;06;03;Lauantai;0;2;2;0;0;0
109;30.06.2018;2018;06;04;Lauantai;0;0;0;0;1;1
109;30.06.2018;2018;06;05;Lauantai;1;3;4;3;1;4
109;30.06.2018;2018;06;06;Lauantai;4;3;7;1;1;2
109;30.06.2018;2018;06;07;Lauantai;1;3;4;2;2;4
109;30.06.2018;2018;06;08;Lauantai;2;2;4;4;1;5
109;30.06.2018;2018;06;09;Lauantai;7;2;9;7;3;10
109;30.06.2018;2018;06;10;Lauantai;12;5;17;6;0;6
109;30.06.2018;2018;06;11;Lauantai;3;8;11;4;6;10
109;30.06.2018;2018;06;12;Lauantai;8;6;14;3;1;4
109;30.06.2018;2018;06;13;Lauantai;9;5;14;5;2;7
109;30.06.2018;2018;06;14;Lauantai;11;11;22;3;1;4
109;30.06.2018;2018;06;15;Lauantai;5;4;9;4;3;7
109;30.06.2018;2018;06;16;Lauantai;4;10;14;2;1;3
109;30.06.2018;2018;06;17;Lauantai;9;3;12;2;2;4
109;30.06.2018;2018;06;18;Lauantai;8;10;18;4;3;7
109;30.06.2018;2018;06;19;Lauantai;8;3;11;6;4;10
109;30.06.2018;2018;06;20;Lauantai;14;6;20;4;5;9
109;30.06.2018;2018;06;21;Lauantai;5;1;6;1;4;5
109;30.06.2018;2018;06;22;Lauantai;2;6;8;3;0;3
109;30.06.2018;2018;06;23;Lauantai;5;0;5;2;0;2
109;01.07.2018;2018;07;00;Sunnuntai;0;1;1;1;1;2
109;01.07.2018;2018;07;01;Sunnuntai;1;2;3;0;0;0
109;01.07.2018;2018;07;02;Sunnuntai;0;2;2;1;1;2
109;01.07.2018;2018;07;03;Sunnuntai;0;1;1;1;0;1
109;01.07.2018;2018;07;04;Sunnuntai;1;3;4;0;0;0
109;01.07.2018;2018;07;05;Sunnuntai;0;1;1;0;0;0
109;01.07.2018;2018;07;06;Sunnuntai;5;1;6;0;0;0
109;01.07.2018;2018;07;07;Sunnuntai;0;2;2;1;0;1
109;01.07.2018;2018;07;08;Sunnuntai;5;0;5;3;1;4
109;01.07.2018;2018;07;09;Sunnuntai;9;3;12;3;1;4
109;01.07.2018;2018;07;10;Sunnuntai;7;5;12;3;3;6
109;01.07.2018;2018;07;11;Sunnuntai;12;11;23;3;7;10
109;01.07.2018;2018;07;12;Sunnuntai;15;10;25;6;2;8
109;01.07.2018;2018;07;13;Sunnuntai;11;6;17;6;1;7
109;01.07.2018;2018;07;14;Sunnuntai;9;5;14;3;4;7
109;01.07.2018;2018;07;15;Sunnuntai;15;12;27;12;2;14
109;01.07.2018;2018;07;16;Sunnuntai;15;11;26;4;2;6
109;01.07.2018;2018;07;17;Sunnuntai;10;16;26;3;2;5
109;01.07.2018;2018;07;18;Sunnuntai;13;16;29;0;2;2
109;01.07.2018;2018;07;19;Sunnuntai;12;8;20;2;4;6
109;01.07.2018;2018;07;20;Sunnuntai;9;7;16;4;4;8
109;01.07.2018;2018;07;21;Sunnuntai;11;8;19;4;0;4
109;01.07.2018;2018;07;22;Sunnuntai;1;4;5;3;0;3
109;01.07.2018;2018;07;23;Sunnuntai;1;1;2;0;1;1
109;02.07.2018;2018;07;00;Maanantai;0;1;1;1;0;1
109;02.07.2018;2018;07;01;Maanantai;0;0;0;0;1;1
109;02.07.2018;2018;07;02;Maanantai;0;0;0;1;1;2
109;02.07.2018;2018;07;03;Maanantai;1;1;2;1;0;1
109;02.07.2018;2018;07;04;Maanantai;1;1;2;1;0;1
109;02.07.2018;2018;07;05;Maanantai;1;5;6;2;1;3
109;02.07.2018;2018;07;06;Maanantai;16;14;30;1;2;3
109;02.07.2018;2018;07;07;Maanantai;31;18;49;2;4;6
109;02.07.2018;2018;07;08;Maanantai;21;9;30;1;2;3
109;02.07.2018;2018;07;09;Maanantai;7;5;12;4;1;5
109;02.07.2018;2018;07;10;Maanantai;16;8;24;12;3;15
109;02.07.2018;2018;07;11;Maanantai;9;9;18;1;4;5
109;02.07.2018;2018;07;12;Maanantai;22;10;32;5;1;6
109;02.07.2018;2018;07;13;Maanantai;13;9;22;3;3;6
109;02.07.2018;2018;07;14;Maanantai;24;12;36;6;6;12
109;02.07.2018;2018;07;15;Maanantai;37;32;69;4;2;6
109;02.07.2018;2018;07;16;Maanantai;22;26;48;6;2;8
109;02.07.2018;2018;07;17;Maanantai;23;19;42;3;3;6
109;02.07.2018;2018;07;18;Maanantai;21;24;45;3;2;5
109;02.07.2018;2018;07;19;Maanantai;19;22;41;4;3;7
109;02.07.2018;2018;07;20;Maanantai;15;9;24;3;2;5
109;02.07.2018;2018;07;21;Maanantai;9;12;21;3;0;3
109;02.07.2018;2018;07;22;Maanantai;8;2;10;3;2;5
109;02.07.2018;2018;07;23;Maanantai;0;1;1;0;1;1
109;03.07.2018;2018;07;00;Tiistai;1;1;2;1;2;3
109;03.07.2018;2018;07;01;Tiistai;0;1;1;0;0;0
109;03.07.2018;2018;07;02;Tiistai;0;1;1;0;0;0
109;03.07.2018;2018;07;03;Tiistai;0;0;0;0;0;0
109;03.07.2018;2018;07;04;Tiistai;0;1;1;0;0;0
109;03.07.2018;2018;07;05;Tiistai;4;10;14;2;1;3
109;03.07.2018;2018;07;06;Tiistai;16;13;29;1;3;4
109;03.07.2018;2018;07;07;Tiistai;22;19;41;1;2;3
109;03.07.2018;2018;07;08;Tiistai;24;9;33;1;2;3
109;03.07.2018;2018;07;09;Tiistai;12;7;19;4;3;7
109;03.07.2018;2018;07;10;Tiistai;11;10;21;3;4;7
109;03.07.2018;2018;07;11;Tiistai;13;6;19;5;3;8
109;03.07.2018;2018;07;12;Tiistai;11;5;16;3;2;5
109;03.07.2018;2018;07;13;Tiistai;15;9;24;2;2;4
109;03.07.2018;2018;07;14;Tiistai;26;10;36;4;3;7
109;03.07.2018;2018;07;15;Tiistai;21;32;53;8;4;12
109;03.07.2018;2018;07;16;Tiistai;27;18;45;8;1;9
109;03.07.2018;2018;07;17;Tiistai;16;14;30;3;2;5
109;03.07.2018;2018;07;18;Tiistai;14;13;27;3;3;6
109;03.07.2018;2018;07;19;Tiistai;7;6;13;7;4;11
109;03.07.2018;2018;07;20;Tiistai;4;8;12;5;2;7
109;03.07.2018;2018;07;21;Tiistai;9;7;16;4;0;4
109;03.07.2018;2018;07;22;Tiistai;5;2;7;2;1;3
109;03.07.2018;2018;07;23;Tiistai;0;2;2;0;0;0
109;04.07.2018;2018;07;00;Keskiviikko;1;0;1;0;1;1
109;04.07.2018;2018;07;01;Keskiviikko;1;0;1;0;0;0
109;04.07.2018;2018;07;02;Keskiviikko;0;1;1;0;0;0
109;04.07.2018;2018;07;03;Keskiviikko;0;0;0;0;1;1
109;04.07.2018;2018;07;04;Keskiviikko;0;1;1;0;0;0
109;04.07.2018;2018;07;05;Keskiviikko;2;4;6;0;0;0
109;04.07.2018;2018;07;06;Keskiviikko;7;8;15;1;1;2
109;04.07.2018;2018;07;07;Keskiviikko;17;11;28;3;0;3
109;04.07.2018;2018;07;08;Keskiviikko;9;7;16;2;4;6
109;04.07.2018;2018;07;09;Keskiviikko;8;6;14;3;1;4
109;04.07.2018;2018;07;10;Keskiviikko;4;0;4;1;0;1
109;04.07.2018;2018;07;11;Keskiviikko;6;1;7;2;3;5
109;04.07.2018;2018;07;12;Keskiviikko;1;7;8;0;0;0
109;04.07.2018;2018;07;13;Keskiviikko;6;2;8;0;5;5
109;04.07.2018;2018;07;14;Keskiviikko;10;7;17;3;3;6
109;04.07.2018;2018;07;15;Keskiviikko;13;10;23;2;3;5
109;04.07.2018;2018;07;16;Keskiviikko;18;10;28;7;2;9
109;04.07.2018;2018;07;17;Keskiviikko;17;14;31;3;1;4
109;04.07.2018;2018;07;18;Keskiviikko;10;9;19;3;4;7
109;04.07.2018;2018;07;19;Keskiviikko;13;15;28;4;5;9
109;04.07.2018;2018;07;20;Keskiviikko;11;8;19;4;3;7
109;04.07.2018;2018;07;21;Keskiviikko;6;16;22;8;2;10
109;04.07.2018;2018;07;22;Keskiviikko;5;5;10;5;4;9
109;04.07.2018;2018;07;23;Keskiviikko;5;3;8;3;2;5
109;05.07.2018;2018;07;00;Torstai;4;3;7;0;0;0
109;05.07.2018;2018;07;01;Torstai;1;0;1;0;2;2
109;05.07.2018;2018;07;02;Torstai;0;0;0;0;0;0
109;05.07.2018;2018;07;03;Torstai;0;2;2;0;0;0
109;05.07.2018;2018;07;04;Torstai;0;2;2;1;0;1
109;05.07.2018;2018;07;05;Torstai;1;10;11;0;0;0
109;05.07.2018;2018;07;06;Torstai;17;11;28;2;6;8
109;05.07.2018;2018;07;07;Torstai;19;15;34;4;3;7
109;05.07.2018;2018;07;08;Torstai;20;8;28;6;0;6
109;05.07.2018;2018;07;09;Torstai;5;6;11;5;0;5
109;05.07.2018;2018;07;10;Torstai;17;3;20;6;2;8
109;05.07.2018;2018;07;11;Torstai;9;7;16;6;3;9
109;05.07.2018;2018;07;12;Torstai;12;12;24;4;4;8
109;05.07.2018;2018;07;13;Torstai;12;6;18;4;1;5
109;05.07.2018;2018;07;14;Torstai;17;11;28;6;1;7
109;05.07.2018;2018;07;15;Torstai;22;26;48;5;2;7
109;05.07.2018;2018;07;16;Torstai;25;23;48;2;2;4
109;05.07.2018;2018;07;17;Torstai;13;14;27;11;8;19
109;05.07.2018;2018;07;18;Torstai;6;13;19;1;3;4
109;05.07.2018;2018;07;19;Torstai;5;5;10;4;8;12
109;05.07.2018;2018;07;20;Torstai;7;7;14;2;1;3
109;05.07.2018;2018;07;21;Torstai;1;9;10;4;2;6
109;05.07.2018;2018;07;22;Torstai;0;5;5;2;2;4
109;05.07.2018;2018;07;23;Torstai;5;1;6;1;2;3
109;06.07.2018;2018;07;00;Perjantai;2;0;2;1;1;2
109;06.07.2018;2018;07;01;Perjantai;0;1;1;0;1;1
109;06.07.2018;2018;07;02;Perjantai;0;2;2;0;0;0
109;06.07.2018;2018;07;03;Perjantai;0;0;0;0;0;0
109;06.07.2018;2018;07;04;Perjantai;0;2;2;0;1;1
109;06.07.2018;2018;07;05;Perjantai;4;6;10;1;0;1
109;06.07.2018;2018;07;06;Perjantai;18;13;31;1;1;2
109;06.07.2018;2018;07;07;Perjantai;13;14;27;5;3;8
109;06.07.2018;2018;07;08;Perjantai;14;7;21;3;2;5
109;06.07.2018;2018;07;09;Perjantai;6;2;8;3;1;4
109;06.07.2018;2018;07;10;Perjantai;9;9;18;3;2;5
109;06.07.2018;2018;07;11;Perjantai;7;6;13;1;1;2
109;06.07.2018;2018;07;12;Perjantai;14;6;20;4;0;4
109;06.07.2018;2018;07;13;Perjantai;19;7;26;4;2;6
109;06.07.2018;2018;07;14;Perjantai;30;15;45;7;0;7
109;06.07.2018;2018;07;15;Perjantai;26;13;39;4;6;10
109;06.07.2018;2018;07;16;Perjantai;25;23;48;4;2;6
109;06.07.2018;2018;07;17;Perjantai;17;16;33;3;4;7
109;06.07.2018;2018;07;18;Perjantai;19;20;39;2;3;5
109;06.07.2018;2018;07;19;Perjantai;21;14;35;5;5;10
109;06.07.2018;2018;07;20;Perjantai;12;12;24;7;2;9
109;06.07.2018;2018;07;21;Perjantai;9;5;14;3;1;4
109;06.07.2018;2018;07;22;Perjantai;0;1;1;1;2;3
109;06.07.2018;2018;07;23;Perjantai;0;0;0;1;3;4
109;07.07.2018;2018;07;00;Lauantai;2;3;5;0;0;0
109;07.07.2018;2018;07;01;Lauantai;4;4;8;0;1;1
109;07.07.2018;2018;07;02;Lauantai;0;1;1;0;0;0
109;07.07.2018;2018;07;03;Lauantai;2;0;2;1;0;1
109;07.07.2018;2018;07;04;Lauantai;0;4;4;0;0;0
109;07.07.2018;2018;07;05;Lauantai;0;5;5;0;0;0
109;07.07.2018;2018;07;06;Lauantai;3;0;3;0;3;3
109;07.07.2018;2018;07;07;Lauantai;3;0;3;0;3;3
109;07.07.2018;2018;07;08;Lauantai;3;2;5;1;2;3
109;07.07.2018;2018;07;09;Lauantai;7;1;8;2;1;3
109;07.07.2018;2018;07;10;Lauantai;12;3;15;5;5;10
109;07.07.2018;2018;07;11;Lauantai;12;5;17;3;0;3
109;07.07.2018;2018;07;12;Lauantai;14;11;25;2;1;3
109;07.07.2018;2018;07;13;Lauantai;14;8;22;0;2;2
109;07.07.2018;2018;07;14;Lauantai;12;11;23;4;3;7
109;07.07.2018;2018;07;15;Lauantai;10;6;16;6;5;11
109;07.07.2018;2018;07;16;Lauantai;8;9;17;2;4;6
109;07.07.2018;2018;07;17;Lauantai;5;11;16;2;0;2
109;07.07.2018;2018;07;18;Lauantai;8;19;27;2;2;4
109;07.07.2018;2018;07;19;Lauantai;13;5;18;4;1;5
109;07.07.2018;2018;07;20;Lauantai;3;3;6;2;4;6
109;07.07.2018;2018;07;21;Lauantai;5;9;14;2;1;3
109;07.07.2018;2018;07;22;Lauantai;4;2;6;0;0;0
109;07.07.2018;2018;07;23;Lauantai;4;1;5;2;3;5
109;08.07.2018;2018;07;00;Sunnuntai;2;4;6;1;0;1
109;08.07.2018;2018;07;01;Sunnuntai;1;0;1;2;2;4
109;08.07.2018;2018;07;02;Sunnuntai;1;1;2;0;0;0
109;08.07.2018;2018;07;03;Sunnuntai;0;1;1;1;0;1
109;08.07.2018;2018;07;04;Sunnuntai;0;0;0;0;0;0
109;08.07.2018;2018;07;05;Sunnuntai;0;0;0;0;0;0
109;08.07.2018;2018;07;06;Sunnuntai;3;0;3;1;0;1
109;08.07.2018;2018;07;07;Sunnuntai;0;4;4;0;2;2
109;08.07.2018;2018;07;08;Sunnuntai;3;1;4;0;4;4
109;08.07.2018;2018;07;09;Sunnuntai;4;0;4;6;4;10
109;08.07.2018;2018;07;10;Sunnuntai;12;2;14;3;2;5
109;08.07.2018;2018;07;11;Sunnuntai;9;7;16;3;2;5
109;08.07.2018;2018;07;12;Sunnuntai;8;4;12;2;3;5
109;08.07.2018;2018;07;13;Sunnuntai;13;9;22;1;2;3
109;08.07.2018;2018;07;14;Sunnuntai;20;6;26;5;2;7
109;08.07.2018;2018;07;15;Sunnuntai;9;23;32;4;4;8
109;08.07.2018;2018;07;16;Sunnuntai;11;7;18;3;1;4
109;08.07.2018;2018;07;17;Sunnuntai;18;14;32;2;3;5
109;08.07.2018;2018;07;18;Sunnuntai;10;12;22;1;3;4
109;08.07.2018;2018;07;19;Sunnuntai;9;6;15;3;1;4
109;08.07.2018;2018;07;20;Sunnuntai;16;8;24;2;3;5
109;08.07.2018;2018;07;21;Sunnuntai;15;7;22;2;7;9
109;08.07.2018;2018;07;22;Sunnuntai;4;3;7;0;1;1
109;08.07.2018;2018;07;23;Sunnuntai;0;0;0;5;0;5
109;09.07.2018;2018;07;00;Maanantai;0;0;0;0;1;1
109;09.07.2018;2018;07;01;Maanantai;0;0;0;0;0;0
109;09.07.2018;2018;07;02;Maanantai;1;2;3;1;0;1
109;09.07.2018;2018;07;03;Maanantai;0;0;0;0;0;0
109;09.07.2018;2018;07;04;Maanantai;0;2;2;0;1;1
109;09.07.2018;2018;07;05;Maanantai;2;6;8;1;0;1
109;09.07.2018;2018;07;06;Maanantai;15;10;25;1;2;3
109;09.07.2018;2018;07;07;Maanantai;20;19;39;1;5;6
109;09.07.2018;2018;07;08;Maanantai;20;7;27;6;1;7
109;09.07.2018;2018;07;09;Maanantai;9;6;15;5;4;9
109;09.07.2018;2018;07;10;Maanantai;10;8;18;2;1;3
109;09.07.2018;2018;07;11;Maanantai;12;8;20;2;1;3
109;09.07.2018;2018;07;12;Maanantai;14;5;19;7;1;8
109;09.07.2018;2018;07;13;Maanantai;21;16;37;3;4;7
109;09.07.2018;2018;07;14;Maanantai;18;15;33;7;8;15
109;09.07.2018;2018;07;15;Maanantai;24;23;47;5;5;10
109;09.07.2018;2018;07;16;Maanantai;34;18;52;7;4;11
109;09.07.2018;2018;07;17;Maanantai;24;15;39;5;4;9
109;09.07.2018;2018;07;18;Maanantai;15;11;26;0;4;4
109;09.07.2018;2018;07;19;Maanantai;21;14;35;3;3;6
109;09.07.2018;2018;07;20;Maanantai;5;7;12;4;2;6
109;09.07.2018;2018;07;21;Maanantai;7;13;20;7;1;8
109;09.07.2018;2018;07;22;Maanantai;4;2;6;1;1;2
109;09.07.2018;2018;07;23;Maanantai;5;3;8;0;1;1
109;10.07.2018;2018;07;00;Tiistai;1;0;1;0;1;1
109;10.07.2018;2018;07;01;Tiistai;0;0;0;2;0;2
109;10.07.2018;2018;07;02;Tiistai;0;0;0;0;0;0
109;10.07.2018;2018;07;03;Tiistai;1;1;2;0;1;1
109;10.07.2018;2018;07;04;Tiistai;0;0;0;0;0;0
109;10.07.2018;2018;07;05;Tiistai;3;4;7;1;0;1
109;10.07.2018;2018;07;06;Tiistai;14;8;22;2;1;3
109;10.07.2018;2018;07;07;Tiistai;22;19;41;0;2;2
109;10.07.2018;2018;07;08;Tiistai;16;10;26;3;1;4
109;10.07.2018;2018;07;09;Tiistai;8;4;12;1;1;2
109;10.07.2018;2018;07;10;Tiistai;9;5;14;5;0;5
109;10.07.2018;2018;07;11;Tiistai;11;5;16;4;2;6
109;10.07.2018;2018;07;12;Tiistai;23;4;27;2;1;3
109;10.07.2018;2018;07;13;Tiistai;21;23;44;3;2;5
109;10.07.2018;2018;07;14;Tiistai;22;13;35;6;2;8
109;10.07.2018;2018;07;15;Tiistai;24;21;45;22;11;33
109;10.07.2018;2018;07;16;Tiistai;31;22;53;7;19;26
109;10.07.2018;2018;07;17;Tiistai;26;15;41;4;4;8
109;10.07.2018;2018;07;18;Tiistai;22;27;49;1;2;3
109;10.07.2018;2018;07;19;Tiistai;23;19;42;8;5;13
109;10.07.2018;2018;07;20;Tiistai;13;19;32;5;4;9
109;10.07.2018;2018;07;21;Tiistai;10;5;15;1;0;1
109;10.07.2018;2018;07;22;Tiistai;8;7;15;2;3;5
109;10.07.2018;2018;07;23;Tiistai;2;4;6;1;1;2
109;11.07.2018;2018;07;00;Keskiviikko;2;2;4;1;2;3
109;11.07.2018;2018;07;01;Keskiviikko;0;0;0;0;0;0
109;11.07.2018;2018;07;02;Keskiviikko;1;0;1;0;0;0
109;11.07.2018;2018;07;03;Keskiviikko;0;0;0;0;0;0
109;11.07.2018;2018;07;04;Keskiviikko;0;2;2;0;0;0
109;11.07.2018;2018;07;05;Keskiviikko;3;6;9;2;1;3
109;11.07.2018;2018;07;06;Keskiviikko;17;10;27;1;2;3
109;11.07.2018;2018;07;07;Keskiviikko;25;17;42;0;3;3
109;11.07.2018;2018;07;08;Keskiviikko;18;10;28;1;3;4
109;11.07.2018;2018;07;09;Keskiviikko;21;4;25;3;1;4
109;11.07.2018;2018;07;10;Keskiviikko;27;8;35;9;3;12
109;11.07.2018;2018;07;11;Keskiviikko;14;6;20;2;1;3
109;11.07.2018;2018;07;12;Keskiviikko;18;16;34;4;3;7
109;11.07.2018;2018;07;13;Keskiviikko;17;18;35;1;0;1
109;11.07.2018;2018;07;14;Keskiviikko;13;5;18;3;1;4
109;11.07.2018;2018;07;15;Keskiviikko;23;21;44;4;5;9
109;11.07.2018;2018;07;16;Keskiviikko;26;24;50;2;1;3
109;11.07.2018;2018;07;17;Keskiviikko;22;19;41;1;1;2
109;11.07.2018;2018;07;18;Keskiviikko;20;13;33;0;1;1
109;11.07.2018;2018;07;19;Keskiviikko;22;10;32;7;1;8
109;11.07.2018;2018;07;20;Keskiviikko;6;18;24;4;4;8
109;11.07.2018;2018;07;21;Keskiviikko;12;10;22;2;1;3
109;11.07.2018;2018;07;22;Keskiviikko;5;6;11;2;0;2
109;11.07.2018;2018;07;23;Keskiviikko;1;4;5;1;1;2
109;12.07.2018;2018;07;00;Torstai;1;0;1;0;1;1
109;12.07.2018;2018;07;01;Torstai;1;0;1;0;1;1
109;12.07.2018;2018;07;02;Torstai;1;1;2;1;0;1
109;12.07.2018;2018;07;03;Torstai;0;0;0;0;0;0
109;12.07.2018;2018;07;04;Torstai;1;0;1;0;1;1
109;12.07.2018;2018;07;05;Torstai;2;7;9;3;1;4
109;12.07.2018;2018;07;06;Torstai;10;11;21;1;1;2
109;12.07.2018;2018;07;07;Torstai;21;16;37;1;2;3
109;12.07.2018;2018;07;08;Torstai;20;9;29;1;2;3
109;12.07.2018;2018;07;09;Torstai;11;4;15;3;3;6
109;12.07.2018;2018;07;10;Torstai;13;8;21;6;3;9
109;12.07.2018;2018;07;11;Torstai;9;10;19;2;5;7
109;12.07.2018;2018;07;12;Torstai;21;15;36;4;0;4
109;12.07.2018;2018;07;13;Torstai;22;12;34;3;3;6
109;12.07.2018;2018;07;14;Torstai;19;14;33;1;1;2
109;12.07.2018;2018;07;15;Torstai;30;31;61;11;4;15
109;12.07.2018;2018;07;16;Torstai;21;21;42;4;3;7
109;12.07.2018;2018;07;17;Torstai;29;18;47;3;1;4
109;12.07.2018;2018;07;18;Torstai;16;12;28;4;4;8
109;12.07.2018;2018;07;19;Torstai;25;12;37;4;2;6
109;12.07.2018;2018;07;20;Torstai;16;12;28;2;3;5
109;12.07.2018;2018;07;21;Torstai;16;10;26;5;2;7
109;12.07.2018;2018;07;22;Torstai;10;8;18;2;2;4
109;12.07.2018;2018;07;23;Torstai;1;8;9;2;1;3
109;13.07.2018;2018;07;00;Perjantai;1;6;7;0;0;0
109;13.07.2018;2018;07;01;Perjantai;0;2;2;0;0;0
109;13.07.2018;2018;07;02;Perjantai;1;6;7;0;1;1
109;13.07.2018;2018;07;03;Perjantai;0;0;0;0;0;0
109;13.07.2018;2018;07;04;Perjantai;0;1;1;0;0;0
109;13.07.2018;2018;07;05;Perjantai;1;9;10;0;0;0
109;13.07.2018;2018;07;06;Perjantai;18;8;26;1;1;2
109;13.07.2018;2018;07;07;Perjantai;18;20;38;1;1;2
109;13.07.2018;2018;07;08;Perjantai;16;14;30;2;4;6
109;13.07.2018;2018;07;09;Perjantai;6;7;13;3;1;4
109;13.07.2018;2018;07;10;Perjantai;12;7;19;2;3;5
109;13.07.2018;2018;07;11;Perjantai;7;5;12;0;1;1
109;13.07.2018;2018;07;12;Perjantai;18;10;28;6;2;8
109;13.07.2018;2018;07;13;Perjantai;22;14;36;2;1;3
109;13.07.2018;2018;07;14;Perjantai;30;15;45;4;5;9
109;13.07.2018;2018;07;15;Perjantai;24;17;41;3;1;4
109;13.07.2018;2018;07;16;Perjantai;21;12;33;6;2;8
109;13.07.2018;2018;07;17;Perjantai;22;9;31;3;2;5
109;13.07.2018;2018;07;18;Perjantai;18;8;26;0;3;3
109;13.07.2018;2018;07;19;Perjantai;22;21;43;3;3;6
109;13.07.2018;2018;07;20;Perjantai;17;8;25;5;5;10
109;13.07.2018;2018;07;21;Perjantai;13;7;20;3;5;8
109;13.07.2018;2018;07;22;Perjantai;8;20;28;3;3;6
109;13.07.2018;2018;07;23;Perjantai;3;8;11;0;0;0
109;14.07.2018;2018;07;00;Lauantai;3;7;10;0;0;0
109;14.07.2018;2018;07;01;Lauantai;0;10;10;0;0;0
109;14.07.2018;2018;07;02;Lauantai;3;0;3;0;0;0
109;14.07.2018;2018;07;03;Lauantai;0;0;0;0;0;0
109;14.07.2018;2018;07;04;Lauantai;1;0;1;0;0;0
109;14.07.2018;2018;07;05;Lauantai;2;0;2;0;0;0
109;14.07.2018;2018;07;06;Lauantai;5;1;6;0;0;0
109;14.07.2018;2018;07;07;Lauantai;3;3;6;1;1;2
109;14.07.2018;2018;07;08;Lauantai;4;1;5;4;1;5
109;14.07.2018;2018;07;09;Lauantai;4;4;8;4;3;7
109;14.07.2018;2018;07;10;Lauantai;7;0;7;1;2;3
109;14.07.2018;2018;07;11;Lauantai;10;5;15;1;2;3
109;14.07.2018;2018;07;12;Lauantai;9;7;16;1;1;2
109;14.07.2018;2018;07;13;Lauantai;16;6;22;4;2;6
109;14.07.2018;2018;07;14;Lauantai;17;6;23;7;2;9
109;14.07.2018;2018;07;15;Lauantai;10;9;19;1;3;4
109;14.07.2018;2018;07;16;Lauantai;17;6;23;2;2;4
109;14.07.2018;2018;07;17;Lauantai;11;9;20;0;1;1
109;14.07.2018;2018;07;18;Lauantai;18;8;26;0;2;2
109;14.07.2018;2018;07;19;Lauantai;13;12;25;3;3;6
109;14.07.2018;2018;07;20;Lauantai;16;16;32;5;1;6
109;14.07.2018;2018;07;21;Lauantai;10;9;19;5;2;7
109;14.07.2018;2018;07;22;Lauantai;5;6;11;2;1;3
109;14.07.2018;2018;07;23;Lauantai;3;13;16;2;0;2
109;15.07.2018;2018;07;00;Sunnuntai;1;3;4;0;1;1
109;15.07.2018;2018;07;01;Sunnuntai;2;2;4;0;0;0
109;15.07.2018;2018;07;02;Sunnuntai;0;4;4;1;1;2
109;15.07.2018;2018;07;03;Sunnuntai;0;4;4;1;1;2
109;15.07.2018;2018;07;04;Sunnuntai;0;2;2;0;0;0
109;15.07.2018;2018;07;05;Sunnuntai;0;0;0;0;0;0
109;15.07.2018;2018;07;06;Sunnuntai;6;0;6;0;0;0
109;15.07.2018;2018;07;07;Sunnuntai;1;5;6;0;2;2
109;15.07.2018;2018;07;08;Sunnuntai;2;2;4;2;3;5
109;15.07.2018;2018;07;09;Sunnuntai;9;3;12;3;1;4
109;15.07.2018;2018;07;10;Sunnuntai;8;7;15;2;3;5
109;15.07.2018;2018;07;11;Sunnuntai;20;7;27;3;1;4
109;15.07.2018;2018;07;12;Sunnuntai;14;8;22;1;5;6
109;15.07.2018;2018;07;13;Sunnuntai;12;8;20;3;1;4
109;15.07.2018;2018;07;14;Sunnuntai;22;11;33;7;1;8
109;15.07.2018;2018;07;15;Sunnuntai;15;14;29;2;0;2
109;15.07.2018;2018;07;16;Sunnuntai;7;9;16;0;1;1
109;15.07.2018;2018;07;17;Sunnuntai;11;15;26;2;4;6
109;15.07.2018;2018;07;18;Sunnuntai;8;9;17;0;2;2
109;15.07.2018;2018;07;19;Sunnuntai;6;12;18;2;3;5
109;15.07.2018;2018;07;20;Sunnuntai;13;8;21;1;5;6
109;15.07.2018;2018;07;21;Sunnuntai;8;7;15;2;1;3
109;15.07.2018;2018;07;22;Sunnuntai;2;8;10;3;6;9
109;15.07.2018;2018;07;23;Sunnuntai;1;5;6;4;2;6
109;16.07.2018;2018;07;00;Maanantai;2;0;2;0;2;2
109;16.07.2018;2018;07;01;Maanantai;0;3;3;0;0;0
109;16.07.2018;2018;07;02;Maanantai;0;0;0;0;0;0
109;16.07.2018;2018;07;03;Maanantai;1;0;1;0;0;0
109;16.07.2018;2018;07;04;Maanantai;0;0;0;8;0;8
109;16.07.2018;2018;07;05;Maanantai;3;10;13;3;3;6
109;16.07.2018;2018;07;06;Maanantai;12;8;20;2;2;4
109;16.07.2018;2018;07;07;Maanantai;23;18;41;4;2;6
109;16.07.2018;2018;07;08;Maanantai;16;10;26;3;0;3
109;16.07.2018;2018;07;09;Maanantai;10;1;11;4;0;4
109;16.07.2018;2018;07;10;Maanantai;5;13;18;3;2;5
109;16.07.2018;2018;07;11;Maanantai;16;2;18;0;1;1
109;16.07.2018;2018;07;12;Maanantai;12;11;23;2;3;5
109;16.07.2018;2018;07;13;Maanantai;18;8;26;4;0;4
109;16.07.2018;2018;07;14;Maanantai;18;7;25;4;5;9
109;16.07.2018;2018;07;15;Maanantai;23;18;41;6;3;9
109;16.07.2018;2018;07;16;Maanantai;27;19;46;2;1;3
109;16.07.2018;2018;07;17;Maanantai;17;19;36;2;1;3
109;16.07.2018;2018;07;18;Maanantai;28;11;39;1;2;3
109;16.07.2018;2018;07;19;Maanantai;11;18;29;1;4;5
109;16.07.2018;2018;07;20;Maanantai;6;9;15;4;3;7
109;16.07.2018;2018;07;21;Maanantai;12;8;20;5;4;9
109;16.07.2018;2018;07;22;Maanantai;7;5;12;3;3;6
109;16.07.2018;2018;07;23;Maanantai;2;1;3;0;0;0
109;17.07.2018;2018;07;00;Tiistai;3;1;4;2;0;2
109;17.07.2018;2018;07;01;Tiistai;2;2;4;0;1;1
109;17.07.2018;2018;07;02;Tiistai;0;1;1;0;0;0
109;17.07.2018;2018;07;03;Tiistai;0;0;0;1;1;2
109;17.07.2018;2018;07;04;Tiistai;0;1;1;0;0;0
109;17.07.2018;2018;07;05;Tiistai;4;5;9;1;0;1
109;17.07.2018;2018;07;06;Tiistai;17;9;26;0;1;1
109;17.07.2018;2018;07;07;Tiistai;20;17;37;2;3;5
109;17.07.2018;2018;07;08;Tiistai;23;13;36;3;2;5
109;17.07.2018;2018;07;09;Tiistai;7;1;8;3;2;5
109;17.07.2018;2018;07;10;Tiistai;10;6;16;3;4;7
109;17.07.2018;2018;07;11;Tiistai;16;5;21;3;0;3
109;17.07.2018;2018;07;12;Tiistai;12;5;17;2;2;4
109;17.07.2018;2018;07;13;Tiistai;15;10;25;5;1;6
109;17.07.2018;2018;07;14;Tiistai;24;19;43;1;0;1
109;17.07.2018;2018;07;15;Tiistai;30;17;47;5;2;7
109;17.07.2018;2018;07;16;Tiistai;36;19;55;7;2;9
109;17.07.2018;2018;07;17;Tiistai;13;11;24;4;3;7
109;17.07.2018;2018;07;18;Tiistai;18;14;32;1;3;4
109;17.07.2018;2018;07;19;Tiistai;9;17;26;1;0;1
109;17.07.2018;2018;07;20;Tiistai;12;4;16;0;0;0
109;17.07.2018;2018;07;21;Tiistai;7;9;16;2;0;2
109;17.07.2018;2018;07;22;Tiistai;12;8;20;7;0;7
109;17.07.2018;2018;07;23;Tiistai;3;6;9;0;0;0
109;18.07.2018;2018;07;00;Keskiviikko;2;6;8;1;1;2
109;18.07.2018;2018;07;01;Keskiviikko;0;1;1;1;0;1
109;18.07.2018;2018;07;02;Keskiviikko;1;0;1;0;0;0
109;18.07.2018;2018;07;03;Keskiviikko;0;1;1;0;0;0
109;18.07.2018;2018;07;04;Keskiviikko;0;0;0;0;0;0
109;18.07.2018;2018;07;05;Keskiviikko;3;8;11;0;0;0
109;18.07.2018;2018;07;06;Keskiviikko;23;14;37;1;0;1
109;18.07.2018;2018;07;07;Keskiviikko;21;13;34;3;0;3
109;18.07.2018;2018;07;08;Keskiviikko;14;13;27;1;3;4
109;18.07.2018;2018;07;09;Keskiviikko;9;1;10;2;2;4
109;18.07.2018;2018;07;10;Keskiviikko;15;6;21;4;2;6
109;18.07.2018;2018;07;11;Keskiviikko;13;5;18;6;1;7
109;18.07.2018;2018;07;12;Keskiviikko;13;6;19;3;0;3
109;18.07.2018;2018;07;13;Keskiviikko;9;8;17;3;1;4
109;18.07.2018;2018;07;14;Keskiviikko;27;12;39;1;0;1
109;18.07.2018;2018;07;15;Keskiviikko;36;21;57;5;3;8
109;18.07.2018;2018;07;16;Keskiviikko;23;12;35;1;0;1
109;18.07.2018;2018;07;17;Keskiviikko;10;13;23;0;3;3
109;18.07.2018;2018;07;18;Keskiviikko;15;12;27;1;0;1
109;18.07.2018;2018;07;19;Keskiviikko;7;3;10;1;0;1
109;18.07.2018;2018;07;20;Keskiviikko;14;9;23;0;1;1
109;18.07.2018;2018;07;21;Keskiviikko;10;4;14;5;0;5
109;18.07.2018;2018;07;22;Keskiviikko;8;9;17;2;0;2
109;18.07.2018;2018;07;23;Keskiviikko;1;3;4;1;0;1
109;19.07.2018;2018;07;00;Torstai;3;1;4;0;2;2
109;19.07.2018;2018;07;01;Torstai;0;2;2;2;1;3
109;19.07.2018;2018;07;02;Torstai;0;4;4;0;0;0
109;19.07.2018;2018;07;03;Torstai;0;1;1;0;0;0
109;19.07.2018;2018;07;04;Torstai;0;2;2;0;1;1
109;19.07.2018;2018;07;05;Torstai;1;7;8;1;0;1
109;19.07.2018;2018;07;06;Torstai;17;9;26;1;1;2
109;19.07.2018;2018;07;07;Torstai;20;17;37;0;2;2
109;19.07.2018;2018;07;08;Torstai;24;11;35;4;3;7
109;19.07.2018;2018;07;09;Torstai;4;7;11;1;2;3
109;19.07.2018;2018;07;10;Torstai;12;3;15;5;1;6
109;19.07.2018;2018;07;11;Torstai;14;7;21;1;2;3
109;19.07.2018;2018;07;12;Torstai;10;5;15;3;1;4
109;19.07.2018;2018;07;13;Torstai;14;15;29;2;3;5
109;19.07.2018;2018;07;14;Torstai;25;12;37;6;3;9
109;19.07.2018;2018;07;15;Torstai;20;29;49;2;3;5
109;19.07.2018;2018;07;16;Torstai;23;22;45;3;1;4
109;19.07.2018;2018;07;17;Torstai;11;11;22;0;2;2
109;19.07.2018;2018;07;18;Torstai;10;8;18;0;0;0
109;19.07.2018;2018;07;19;Torstai;9;7;16;13;1;14
109;19.07.2018;2018;07;20;Torstai;12;10;22;1;1;2
109;19.07.2018;2018;07;21;Torstai;14;5;19;5;0;5
109;19.07.2018;2018;07;22;Torstai;4;1;5;2;2;4
109;19.07.2018;2018;07;23;Torstai;1;2;3;0;1;1
109;20.07.2018;2018;07;00;Perjantai;4;1;5;2;2;4
109;20.07.2018;2018;07;01;Perjantai;4;1;5;2;0;2
109;20.07.2018;2018;07;02;Perjantai;0;0;0;0;0;0
109;20.07.2018;2018;07;03;Perjantai;2;1;3;0;0;0
109;20.07.2018;2018;07;04;Perjantai;1;0;1;0;1;1
109;20.07.2018;2018;07;05;Perjantai;2;8;10;0;0;0
109;20.07.2018;2018;07;06;Perjantai;15;12;27;1;1;2
109;20.07.2018;2018;07;07;Perjantai;12;15;27;2;4;6
109;20.07.2018;2018;07;08;Perjantai;13;7;20;4;2;6
109;20.07.2018;2018;07;09;Perjantai;8;3;11;4;0;4
109;20.07.2018;2018;07;10;Perjantai;7;7;14;4;2;6
109;20.07.2018;2018;07;11;Perjantai;10;9;19;1;0;1
109;20.07.2018;2018;07;12;Perjantai;11;10;21;3;2;5
109;20.07.2018;2018;07;13;Perjantai;15;13;28;2;0;2
109;20.07.2018;2018;07;14;Perjantai;13;10;23;1;0;1
109;20.07.2018;2018;07;15;Perjantai;24;20;44;1;2;3
109;20.07.2018;2018;07;16;Perjantai;18;8;26;3;2;5
109;20.07.2018;2018;07;17;Perjantai;10;9;19;0;1;1
109;20.07.2018;2018;07;18;Perjantai;13;8;21;0;1;1
109;20.07.2018;2018;07;19;Perjantai;13;5;18;0;0;0
109;20.07.2018;2018;07;20;Perjantai;16;4;20;2;0;2
109;20.07.2018;2018;07;21;Perjantai;12;8;20;0;0;0
109;20.07.2018;2018;07;22;Perjantai;10;7;17;1;2;3
109;20.07.2018;2018;07;23;Perjantai;11;2;13;1;0;1
109;21.07.2018;2018;07;00;Lauantai;3;4;7;0;0;0
109;21.07.2018;2018;07;01;Lauantai;4;5;9;0;0;0
109;21.07.2018;2018;07;02;Lauantai;0;4;4;0;0;0
109;21.07.2018;2018;07;03;Lauantai;0;4;4;2;1;3
109;21.07.2018;2018;07;04;Lauantai;0;6;6;3;2;5
109;21.07.2018;2018;07;05;Lauantai;1;1;2;3;1;4
109;21.07.2018;2018;07;06;Lauantai;5;4;9;0;0;0
109;21.07.2018;2018;07;07;Lauantai;3;7;10;1;1;2
109;21.07.2018;2018;07;08;Lauantai;6;3;9;1;2;3
109;21.07.2018;2018;07;09;Lauantai;11;1;12;1;1;2
109;21.07.2018;2018;07;10;Lauantai;3;6;9;3;5;8
109;21.07.2018;2018;07;11;Lauantai;8;1;9;2;1;3
109;21.07.2018;2018;07;12;Lauantai;23;2;25;1;2;3
109;21.07.2018;2018;07;13;Lauantai;7;5;12;0;2;2
109;21.07.2018;2018;07;14;Lauantai;3;12;15;3;3;6
109;21.07.2018;2018;07;15;Lauantai;5;1;6;2;3;5
109;21.07.2018;2018;07;16;Lauantai;9;6;15;5;2;7
109;21.07.2018;2018;07;17;Lauantai;6;6;12;1;0;1
109;21.07.2018;2018;07;18;Lauantai;9;5;14;2;1;3
109;21.07.2018;2018;07;19;Lauantai;15;4;19;1;4;5
109;21.07.2018;2018;07;20;Lauantai;6;10;16;1;0;1
109;21.07.2018;2018;07;21;Lauantai;6;4;10;4;3;7
109;21.07.2018;2018;07;22;Lauantai;2;2;4;0;0;0
109;21.07.2018;2018;07;23;Lauantai;2;0;2;0;0;0
109;22.07.2018;2018;07;00;Sunnuntai;1;1;2;0;0;0
109;22.07.2018;2018;07;01;Sunnuntai;0;3;3;0;0;0
109;22.07.2018;2018;07;02;Sunnuntai;2;1;3;1;0;1
109;22.07.2018;2018;07;03;Sunnuntai;0;3;3;0;0;0
109;22.07.2018;2018;07;04;Sunnuntai;0;2;2;0;0;0
109;22.07.2018;2018;07;05;Sunnuntai;2;1;3;1;0;1
109;22.07.2018;2018;07;06;Sunnuntai;2;1;3;0;1;1
109;22.07.2018;2018;07;07;Sunnuntai;0;2;2;1;1;2
109;22.07.2018;2018;07;08;Sunnuntai;0;3;3;2;0;2
109;22.07.2018;2018;07;09;Sunnuntai;2;1;3;2;4;6
109;22.07.2018;2018;07;10;Sunnuntai;2;2;4;3;1;4
109;22.07.2018;2018;07;11;Sunnuntai;8;1;9;5;3;8
109;22.07.2018;2018;07;12;Sunnuntai;10;6;16;0;2;2
109;22.07.2018;2018;07;13;Sunnuntai;2;2;4;0;1;1
109;22.07.2018;2018;07;14;Sunnuntai;3;4;7;3;2;5
109;22.07.2018;2018;07;15;Sunnuntai;8;9;17;4;2;6
109;22.07.2018;2018;07;16;Sunnuntai;5;2;7;2;1;3
109;22.07.2018;2018;07;17;Sunnuntai;3;2;5;1;1;2
109;22.07.2018;2018;07;18;Sunnuntai;10;5;15;1;1;2
109;22.07.2018;2018;07;19;Sunnuntai;0;4;4;1;0;1
109;22.07.2018;2018;07;20;Sunnuntai;5;4;9;3;7;10
109;22.07.2018;2018;07;21;Sunnuntai;6;4;10;11;2;13
109;22.07.2018;2018;07;22;Sunnuntai;2;3;5;0;3;3
109;22.07.2018;2018;07;23;Sunnuntai;3;1;4;2;2;4
109;23.07.2018;2018;07;00;Maanantai;1;0;1;0;2;2
109;23.07.2018;2018;07;01;Maanantai;0;0;0;0;2;2
109;23.07.2018;2018;07;02;Maanantai;0;0;0;0;0;0
109;23.07.2018;2018;07;03;Maanantai;0;0;0;0;0;0
109;23.07.2018;2018;07;04;Maanantai;0;0;0;0;0;0
109;23.07.2018;2018;07;05;Maanantai;0;7;7;1;2;3
109;23.07.2018;2018;07;06;Maanantai;13;3;16;1;0;1
109;23.07.2018;2018;07;07;Maanantai;12;15;27;3;3;6
109;23.07.2018;2018;07;08;Maanantai;14;10;24;3;1;4
109;23.07.2018;2018;07;09;Maanantai;10;4;14;2;1;3
109;23.07.2018;2018;07;10;Maanantai;13;9;22;3;1;4
109;23.07.2018;2018;07;11;Maanantai;6;7;13;2;1;3
109;23.07.2018;2018;07;12;Maanantai;12;7;19;1;1;2
109;23.07.2018;2018;07;13;Maanantai;15;9;24;2;1;3
109;23.07.2018;2018;07;14;Maanantai;21;8;29;0;1;1
109;23.07.2018;2018;07;15;Maanantai;22;16;38;8;4;12
109;23.07.2018;2018;07;16;Maanantai;16;20;36;3;1;4
109;23.07.2018;2018;07;17;Maanantai;10;5;15;2;3;5
109;23.07.2018;2018;07;18;Maanantai;11;14;25;4;1;5
109;23.07.2018;2018;07;19;Maanantai;18;10;28;3;4;7
109;23.07.2018;2018;07;20;Maanantai;10;5;15;2;3;5
109;23.07.2018;2018;07;21;Maanantai;7;17;24;4;3;7
109;23.07.2018;2018;07;22;Maanantai;6;10;16;5;0;5
109;23.07.2018;2018;07;23;Maanantai;12;2;14;1;0;1
109;24.07.2018;2018;07;00;Tiistai;1;1;2;0;0;0
109;24.07.2018;2018;07;01;Tiistai;0;0;0;1;0;1
109;24.07.2018;2018;07;02;Tiistai;1;2;3;0;0;0
109;24.07.2018;2018;07;03;Tiistai;1;1;2;1;0;1
109;24.07.2018;2018;07;04;Tiistai;0;0;0;0;0;0
109;24.07.2018;2018;07;05;Tiistai;3;8;11;0;1;1
109;24.07.2018;2018;07;06;Tiistai;13;8;21;0;2;2
109;24.07.2018;2018;07;07;Tiistai;15;14;29;1;1;2
109;24.07.2018;2018;07;08;Tiistai;20;11;31;4;2;6
109;24.07.2018;2018;07;09;Tiistai;14;9;23;5;0;5
109;24.07.2018;2018;07;10;Tiistai;14;7;21;2;3;5
109;24.07.2018;2018;07;11;Tiistai;12;1;13;3;0;3
109;24.07.2018;2018;07;12;Tiistai;11;10;21;2;0;2
109;24.07.2018;2018;07;13;Tiistai;15;8;23;1;2;3
109;24.07.2018;2018;07;14;Tiistai;21;14;35;2;2;4
109;24.07.2018;2018;07;15;Tiistai;25;24;49;1;1;2
109;24.07.2018;2018;07;16;Tiistai;29;19;48;5;3;8
109;24.07.2018;2018;07;17;Tiistai;18;17;35;2;2;4
109;24.07.2018;2018;07;18;Tiistai;12;7;19;1;0;1
109;24.07.2018;2018;07;19;Tiistai;12;15;27;2;0;2
109;24.07.2018;2018;07;20;Tiistai;15;11;26;5;2;7
109;24.07.2018;2018;07;21;Tiistai;8;13;21;0;0;0
109;24.07.2018;2018;07;22;Tiistai;10;5;15;1;0;1
109;24.07.2018;2018;07;23;Tiistai;4;8;12;2;2;4
109;25.07.2018;2018;07;00;Keskiviikko;0;3;3;0;2;2
109;25.07.2018;2018;07;01;Keskiviikko;0;1;1;1;0;1
109;25.07.2018;2018;07;02;Keskiviikko;0;1;1;0;0;0
109;25.07.2018;2018;07;03;Keskiviikko;1;1;2;1;1;2
109;25.07.2018;2018;07;04;Keskiviikko;0;0;0;2;0;2
109;25.07.2018;2018;07;05;Keskiviikko;0;9;9;0;1;1
109;25.07.2018;2018;07;06;Keskiviikko;14;3;17;0;1;1
109;25.07.2018;2018;07;07;Keskiviikko;16;12;28;2;1;3
109;25.07.2018;2018;07;08;Keskiviikko;15;10;25;3;3;6
109;25.07.2018;2018;07;09;Keskiviikko;7;5;12;5;1;6
109;25.07.2018;2018;07;10;Keskiviikko;11;3;14;3;0;3
109;25.07.2018;2018;07;11;Keskiviikko;6;3;9;0;2;2
109;25.07.2018;2018;07;12;Keskiviikko;11;8;19;0;0;0
109;25.07.2018;2018;07;13;Keskiviikko;13;15;28;2;0;2
109;25.07.2018;2018;07;14;Keskiviikko;13;12;25;1;3;4
109;25.07.2018;2018;07;15;Keskiviikko;26;20;46;5;2;7
109;25.07.2018;2018;07;16;Keskiviikko;31;19;50;3;0;3
109;25.07.2018;2018;07;17;Keskiviikko;17;17;34;1;0;1
109;25.07.2018;2018;07;18;Keskiviikko;12;11;23;5;0;5
109;25.07.2018;2018;07;19;Keskiviikko;19;7;26;1;0;1
109;25.07.2018;2018;07;20;Keskiviikko;15;11;26;2;2;4
109;25.07.2018;2018;07;21;Keskiviikko;12;3;15;0;0;0
109;25.07.2018;2018;07;22;Keskiviikko;17;8;25;2;2;4
109;25.07.2018;2018;07;23;Keskiviikko;4;6;10;1;2;3
109;26.07.2018;2018;07;00;Torstai;1;1;2;0;2;2
109;26.07.2018;2018;07;01;Torstai;0;1;1;0;2;2
109;26.07.2018;2018;07;02;Torstai;3;3;6;0;1;1
109;26.07.2018;2018;07;03;Torstai;1;2;3;0;0;0
109;26.07.2018;2018;07;04;Torstai;2;2;4;0;0;0
109;26.07.2018;2018;07;05;Torstai;1;8;9;0;0;0
109;26.07.2018;2018;07;06;Torstai;13;8;21;3;4;7
109;26.07.2018;2018;07;07;Torstai;19;14;33;0;1;1
109;26.07.2018;2018;07;08;Torstai;21;8;29;1;0;1
109;26.07.2018;2018;07;09;Torstai;8;5;13;5;2;7
109;26.07.2018;2018;07;10;Torstai;3;9;12;3;1;4
109;26.07.2018;2018;07;11;Torstai;7;3;10;1;2;3
109;26.07.2018;2018;07;12;Torstai;8;9;17;1;2;3
109;26.07.2018;2018;07;13;Torstai;10;9;19;4;1;5
109;26.07.2018;2018;07;14;Torstai;14;5;19;3;1;4
109;26.07.2018;2018;07;15;Torstai;12;16;28;2;3;5
109;26.07.2018;2018;07;16;Torstai;25;22;47;3;4;7
109;26.07.2018;2018;07;17;Torstai;27;13;40;2;1;3
109;26.07.2018;2018;07;18;Torstai;18;11;29;2;2;4
109;26.07.2018;2018;07;19;Torstai;15;13;28;1;3;4
109;26.07.2018;2018;07;20;Torstai;13;10;23;1;0;1
109;26.07.2018;2018;07;21;Torstai;6;11;17;5;1;6
109;26.07.2018;2018;07;22;Torstai;12;6;18;3;1;4
109;26.07.2018;2018;07;23;Torstai;3;4;7;1;1;2
109;27.07.2018;2018;07;00;Perjantai;0;3;3;2;2;4
109;27.07.2018;2018;07;01;Perjantai;1;1;2;0;0;0
109;27.07.2018;2018;07;02;Perjantai;3;0;3;0;0;0
109;27.07.2018;2018;07;03;Perjantai;0;0;0;0;0;0
109;27.07.2018;2018;07;04;Perjantai;0;0;0;2;1;3
109;27.07.2018;2018;07;05;Perjantai;1;6;7;2;1;3
109;27.07.2018;2018;07;06;Perjantai;11;6;17;0;2;2
109;27.07.2018;2018;07;07;Perjantai;16;16;32;0;0;0
109;27.07.2018;2018;07;08;Perjantai;15;5;20;1;1;2
109;27.07.2018;2018;07;09;Perjantai;7;4;11;4;2;6
109;27.07.2018;2018;07;10;Perjantai;7;10;17;1;0;1
109;27.07.2018;2018;07;11;Perjantai;9;6;15;5;2;7
109;27.07.2018;2018;07;12;Perjantai;9;11;20;2;4;6
109;27.07.2018;2018;07;13;Perjantai;24;10;34;3;1;4
109;27.07.2018;2018;07;14;Perjantai;26;9;35;4;3;7
109;27.07.2018;2018;07;15;Perjantai;42;19;61;7;5;12
109;27.07.2018;2018;07;16;Perjantai;26;12;38;8;2;10
109;27.07.2018;2018;07;17;Perjantai;24;9;33;1;4;5
109;27.07.2018;2018;07;18;Perjantai;10;7;17;1;1;2
109;27.07.2018;2018;07;19;Perjantai;17;7;24;0;1;1
109;27.07.2018;2018;07;20;Perjantai;17;6;23;3;1;4
109;27.07.2018;2018;07;21;Perjantai;9;3;12;1;1;2
109;27.07.2018;2018;07;22;Perjantai;6;8;14;2;1;3
109;27.07.2018;2018;07;23;Perjantai;2;12;14;2;0;2
109;28.07.2018;2018;07;00;Lauantai;5;14;19;0;1;1
109;28.07.2018;2018;07;01;Lauantai;1;21;22;0;0;0
109;28.07.2018;2018;07;02;Lauantai;1;14;15;0;1;1
109;28.07.2018;2018;07;03;Lauantai;1;3;4;0;0;0
109;28.07.2018;2018;07;04;Lauantai;1;1;2;0;0;0
109;28.07.2018;2018;07;05;Lauantai;2;2;4;0;1;1
109;28.07.2018;2018;07;06;Lauantai;4;0;4;0;1;1
109;28.07.2018;2018;07;07;Lauantai;3;3;6;0;0;0
109;28.07.2018;2018;07;08;Lauantai;4;1;5;3;2;5
109;28.07.2018;2018;07;09;Lauantai;2;2;4;2;1;3
109;28.07.2018;2018;07;10;Lauantai;4;4;8;1;3;4
109;28.07.2018;2018;07;11;Lauantai;9;3;12;5;2;7
109;28.07.2018;2018;07;12;Lauantai;19;4;23;0;1;1
109;28.07.2018;2018;07;13;Lauantai;19;18;37;1;1;2
109;28.07.2018;2018;07;14;Lauantai;26;12;38;7;3;10
109;28.07.2018;2018;07;15;Lauantai;17;12;29;5;2;7
109;28.07.2018;2018;07;16;Lauantai;22;13;35;3;1;4
109;28.07.2018;2018;07;17;Lauantai;16;11;27;2;2;4
109;28.07.2018;2018;07;18;Lauantai;34;9;43;3;0;3
109;28.07.2018;2018;07;19;Lauantai;15;5;20;0;0;0
109;28.07.2018;2018;07;20;Lauantai;11;15;26;4;3;7
109;28.07.2018;2018;07;21;Lauantai;5;15;20;3;2;5
109;28.07.2018;2018;07;22;Lauantai;14;9;23;2;4;6
109;28.07.2018;2018;07;23;Lauantai;0;8;8;0;1;1
109;29.07.2018;2018;07;00;Sunnuntai;1;17;18;0;1;1
109;29.07.2018;2018;07;01;Sunnuntai;1;9;10;0;0;0
109;29.07.2018;2018;07;02;Sunnuntai;1;12;13;0;2;2
109;29.07.2018;2018;07;03;Sunnuntai;0;9;9;1;0;1
109;29.07.2018;2018;07;04;Sunnuntai;0;8;8;0;0;0
109;29.07.2018;2018;07;05;Sunnuntai;0;3;3;0;0;0
109;29.07.2018;2018;07;06;Sunnuntai;5;2;7;0;0;0
109;29.07.2018;2018;07;07;Sunnuntai;2;3;5;1;0;1
109;29.07.2018;2018;07;08;Sunnuntai;5;3;8;4;3;7
109;29.07.2018;2018;07;09;Sunnuntai;3;1;4;4;3;7
109;29.07.2018;2018;07;10;Sunnuntai;10;0;10;3;2;5
109;29.07.2018;2018;07;11;Sunnuntai;5;7;12;2;2;4
109;29.07.2018;2018;07;12;Sunnuntai;10;13;23;4;3;7
109;29.07.2018;2018;07;13;Sunnuntai;15;9;24;2;1;3
109;29.07.2018;2018;07;14;Sunnuntai;15;12;27;1;0;1
109;29.07.2018;2018;07;15;Sunnuntai;11;8;19;2;2;4
109;29.07.2018;2018;07;16;Sunnuntai;7;13;20;1;3;4
109;29.07.2018;2018;07;17;Sunnuntai;9;8;17;0;0;0
109;29.07.2018;2018;07;18;Sunnuntai;5;8;13;1;0;1
109;29.07.2018;2018;07;19;Sunnuntai;14;16;30;2;1;3
109;29.07.2018;2018;07;20;Sunnuntai;11;4;15;3;1;4
109;29.07.2018;2018;07;21;Sunnuntai;10;4;14;0;1;1
109;29.07.2018;2018;07;22;Sunnuntai;9;1;10;4;1;5
109;29.07.2018;2018;07;23;Sunnuntai;4;1;5;2;0;2
109;30.07.2018;2018;07;00;Maanantai;1;1;2;0;0;0
109;30.07.2018;2018;07;01;Maanantai;1;1;2;0;1;1
109;30.07.2018;2018;07;02;Maanantai;0;1;1;0;1;1
109;30.07.2018;2018;07;03;Maanantai;0;0;0;0;0;0
109;30.07.2018;2018;07;04;Maanantai;0;3;3;0;0;0
109;30.07.2018;2018;07;05;Maanantai;2;6;8;0;0;0
109;30.07.2018;2018;07;06;Maanantai;13;7;20;0;2;2
109;30.07.2018;2018;07;07;Maanantai;26;15;41;4;1;5
109;30.07.2018;2018;07;08;Maanantai;15;11;26;0;1;1
109;30.07.2018;2018;07;09;Maanantai;6;6;12;4;2;6
109;30.07.2018;2018;07;10;Maanantai;3;5;8;4;3;7
109;30.07.2018;2018;07;11;Maanantai;13;7;20;3;1;4
109;30.07.2018;2018;07;12;Maanantai;15;12;27;2;1;3
109;30.07.2018;2018;07;13;Maanantai;15;5;20;1;0;1
109;30.07.2018;2018;07;14;Maanantai;12;10;22;2;0;2
109;30.07.2018;2018;07;15;Maanantai;19;25;44;3;2;5
109;30.07.2018;2018;07;16;Maanantai;27;23;50;2;1;3
109;30.07.2018;2018;07;17;Maanantai;17;16;33;0;0;0
109;30.07.2018;2018;07;18;Maanantai;13;14;27;0;0;0
109;30.07.2018;2018;07;19;Maanantai;12;15;27;0;0;0
109;30.07.2018;2018;07;20;Maanantai;15;9;24;0;0;0
109;30.07.2018;2018;07;21;Maanantai;9;4;13;2;0;2
109;30.07.2018;2018;07;22;Maanantai;12;6;18;1;0;1
109;30.07.2018;2018;07;23;Maanantai;2;4;6;0;1;1
109;31.07.2018;2018;07;00;Tiistai;4;2;6;2;0;2
109;31.07.2018;2018;07;01;Tiistai;0;0;0;1;1;2
109;31.07.2018;2018;07;02;Tiistai;0;0;0;0;0;0
109;31.07.2018;2018;07;03;Tiistai;0;0;0;0;0;0
109;31.07.2018;2018;07;04;Tiistai;1;1;2;0;0;0
109;31.07.2018;2018;07;05;Tiistai;0;6;6;1;2;3
109;31.07.2018;2018;07;06;Tiistai;14;7;21;2;1;3
109;31.07.2018;2018;07;07;Tiistai;27;15;42;3;2;5
109;31.07.2018;2018;07;08;Tiistai;18;17;35;4;2;6
109;31.07.2018;2018;07;09;Tiistai;10;4;14;3;2;5
109;31.07.2018;2018;07;10;Tiistai;8;7;15;2;0;2
109;31.07.2018;2018;07;11;Tiistai;15;6;21;2;2;4
109;31.07.2018;2018;07;12;Tiistai;12;8;20;6;1;7
109;31.07.2018;2018;07;13;Tiistai;10;16;26;0;1;1
109;31.07.2018;2018;07;14;Tiistai;20;6;26;4;1;5
109;31.07.2018;2018;07;15;Tiistai;35;25;60;5;0;5
109;31.07.2018;2018;07;16;Tiistai;27;27;54;1;4;5
109;31.07.2018;2018;07;17;Tiistai;20;12;32;0;0;0
109;31.07.2018;2018;07;18;Tiistai;21;10;31;0;0;0
109;31.07.2018;2018;07;19;Tiistai;12;9;21;2;0;2
109;31.07.2018;2018;07;20;Tiistai;15;12;27;1;0;1
109;31.07.2018;2018;07;21;Tiistai;7;3;10;0;0;0
109;31.07.2018;2018;07;22;Tiistai;9;4;13;0;1;1
109;31.07.2018;2018;07;23;Tiistai;1;1;2;1;0;1
109;01.08.2018;2018;08;00;Keskiviikko;1;3;4;0;1;1
109;01.08.2018;2018;08;01;Keskiviikko;0;5;5;0;0;0
109;01.08.2018;2018;08;02;Keskiviikko;1;0;1;0;0;0
109;01.08.2018;2018;08;03;Keskiviikko;0;1;1;0;0;0
109;01.08.2018;2018;08;04;Keskiviikko;1;1;2;0;0;0
109;01.08.2018;2018;08;05;Keskiviikko;0;5;5;0;0;0
109;01.08.2018;2018;08;06;Keskiviikko;12;6;18;1;3;4
109;01.08.2018;2018;08;07;Keskiviikko;30;17;47;3;6;9
109;01.08.2018;2018;08;08;Keskiviikko;19;12;31;2;3;5
109;01.08.2018;2018;08;09;Keskiviikko;11;6;17;3;2;5
109;01.08.2018;2018;08;10;Keskiviikko;10;9;19;1;0;1
109;01.08.2018;2018;08;11;Keskiviikko;8;8;16;1;3;4
109;01.08.2018;2018;08;12;Keskiviikko;4;10;14;3;3;6
109;01.08.2018;2018;08;13;Keskiviikko;6;14;20;1;1;2
109;01.08.2018;2018;08;14;Keskiviikko;11;5;16;1;2;3
109;01.08.2018;2018;08;15;Keskiviikko;27;22;49;1;2;3
109;01.08.2018;2018;08;16;Keskiviikko;17;22;39;3;3;6
109;01.08.2018;2018;08;17;Keskiviikko;14;16;30;1;0;1
109;01.08.2018;2018;08;18;Keskiviikko;7;7;14;0;1;1
109;01.08.2018;2018;08;19;Keskiviikko;18;7;25;2;2;4
109;01.08.2018;2018;08;20;Keskiviikko;15;12;27;4;1;5
109;01.08.2018;2018;08;21;Keskiviikko;4;5;9;2;0;2
109;01.08.2018;2018;08;22;Keskiviikko;10;8;18;1;1;2
109;01.08.2018;2018;08;23;Keskiviikko;5;6;11;1;1;2
109;02.08.2018;2018;08;00;Torstai;1;1;2;0;0;0
109;02.08.2018;2018;08;01;Torstai;0;0;0;0;0;0
109;02.08.2018;2018;08;02;Torstai;1;0;1;1;0;1
109;02.08.2018;2018;08;03;Torstai;0;0;0;0;1;1
109;02.08.2018;2018;08;04;Torstai;0;0;0;0;0;0
109;02.08.2018;2018;08;05;Torstai;2;6;8;0;1;1
109;02.08.2018;2018;08;06;Torstai;14;10;24;2;0;2
109;02.08.2018;2018;08;07;Torstai;26;15;41;4;1;5
109;02.08.2018;2018;08;08;Torstai;15;14;29;4;1;5
109;02.08.2018;2018;08;09;Torstai;6;9;15;0;2;2
109;02.08.2018;2018;08;10;Torstai;16;6;22;2;2;4
109;02.08.2018;2018;08;11;Torstai;13;3;16;1;4;5
109;02.08.2018;2018;08;12;Torstai;19;4;23;0;0;0
109;02.08.2018;2018;08;13;Torstai;12;14;26;1;4;5
109;02.08.2018;2018;08;14;Torstai;19;14;33;3;2;5
109;02.08.2018;2018;08;15;Torstai;16;18;34;1;4;5
109;02.08.2018;2018;08;16;Torstai;29;23;52;1;0;1
109;02.08.2018;2018;08;17;Torstai;16;13;29;1;1;2
109;02.08.2018;2018;08;18;Torstai;17;10;27;3;2;5
109;02.08.2018;2018;08;19;Torstai;8;6;14;2;3;5
109;02.08.2018;2018;08;20;Torstai;7;13;20;3;2;5
109;02.08.2018;2018;08;21;Torstai;15;8;23;3;2;5
109;02.08.2018;2018;08;22;Torstai;7;3;10;2;2;4
109;02.08.2018;2018;08;23;Torstai;2;1;3;0;0;0
109;03.08.2018;2018;08;00;Perjantai;4;0;4;0;0;0
109;03.08.2018;2018;08;01;Perjantai;2;5;7;0;0;0
109;03.08.2018;2018;08;02;Perjantai;0;2;2;0;0;0
109;03.08.2018;2018;08;03;Perjantai;0;1;1;0;0;0
109;03.08.2018;2018;08;04;Perjantai;0;0;0;0;0;0
109;03.08.2018;2018;08;05;Perjantai;3;6;9;0;0;0
109;03.08.2018;2018;08;06;Perjantai;16;7;23;5;1;6
109;03.08.2018;2018;08;07;Perjantai;11;17;28;4;2;6
109;03.08.2018;2018;08;08;Perjantai;11;6;17;4;1;5
109;03.08.2018;2018;08;09;Perjantai;5;1;6;0;4;4
109;03.08.2018;2018;08;10;Perjantai;4;3;7;0;0;0
109;03.08.2018;2018;08;11;Perjantai;6;1;7;0;0;0
109;03.08.2018;2018;08;12;Perjantai;2;2;4;1;4;5
109;03.08.2018;2018;08;13;Perjantai;3;9;12;1;1;2
109;03.08.2018;2018;08;14;Perjantai;11;15;26;4;1;5
109;03.08.2018;2018;08;15;Perjantai;17;9;26;4;5;9
109;03.08.2018;2018;08;16;Perjantai;19;11;30;7;1;8
109;03.08.2018;2018;08;17;Perjantai;6;6;12;2;4;6
109;03.08.2018;2018;08;18;Perjantai;9;7;16;5;3;8
109;03.08.2018;2018;08;19;Perjantai;14;8;22;4;1;5
109;03.08.2018;2018;08;20;Perjantai;12;6;18;2;1;3
109;03.08.2018;2018;08;21;Perjantai;11;3;14;4;3;7
109;03.08.2018;2018;08;22;Perjantai;2;1;3;2;2;4
109;03.08.2018;2018;08;23;Perjantai;2;2;4;2;2;4
109;04.08.2018;2018;08;00;Lauantai;7;1;8;2;3;5
109;04.08.2018;2018;08;01;Lauantai;2;0;2;0;0;0
109;04.08.2018;2018;08;02;Lauantai;0;1;1;0;0;0
109;04.08.2018;2018;08;03;Lauantai;0;3;3;0;0;0
109;04.08.2018;2018;08;04;Lauantai;0;0;0;3;0;3
109;04.08.2018;2018;08;05;Lauantai;1;7;8;1;1;2
109;04.08.2018;2018;08;06;Lauantai;2;1;3;0;1;1
109;04.08.2018;2018;08;07;Lauantai;0;3;3;0;2;2
109;04.08.2018;2018;08;08;Lauantai;1;2;3;1;3;4
109;04.08.2018;2018;08;09;Lauantai;3;0;3;4;1;5
109;04.08.2018;2018;08;10;Lauantai;8;3;11;3;4;7
109;04.08.2018;2018;08;11;Lauantai;13;13;26;3;4;7
109;04.08.2018;2018;08;12;Lauantai;11;7;18;0;2;2
109;04.08.2018;2018;08;13;Lauantai;13;8;21;1;3;4
109;04.08.2018;2018;08;14;Lauantai;20;7;27;4;4;8
109;04.08.2018;2018;08;15;Lauantai;23;8;31;2;5;7
109;04.08.2018;2018;08;16;Lauantai;16;13;29;5;0;5
109;04.08.2018;2018;08;17;Lauantai;7;7;14;5;4;9
109;04.08.2018;2018;08;18;Lauantai;7;19;26;2;5;7
109;04.08.2018;2018;08;19;Lauantai;9;15;24;7;2;9
109;04.08.2018;2018;08;20;Lauantai;9;11;20;4;1;5
109;04.08.2018;2018;08;21;Lauantai;12;5;17;0;2;2
109;04.08.2018;2018;08;22;Lauantai;4;1;5;1;3;4
109;04.08.2018;2018;08;23;Lauantai;7;4;11;2;0;2
109;05.08.2018;2018;08;00;Sunnuntai;2;2;4;0;1;1
109;05.08.2018;2018;08;01;Sunnuntai;0;1;1;0;0;0
109;05.08.2018;2018;08;02;Sunnuntai;2;2;4;1;0;1
109;05.08.2018;2018;08;03;Sunnuntai;0;2;2;0;0;0
109;05.08.2018;2018;08;04;Sunnuntai;0;1;1;0;0;0
109;05.08.2018;2018;08;05;Sunnuntai;1;3;4;1;0;1
109;05.08.2018;2018;08;06;Sunnuntai;4;1;5;1;0;1
109;05.08.2018;2018;08;07;Sunnuntai;0;1;1;3;2;5
109;05.08.2018;2018;08;08;Sunnuntai;0;2;2;4;2;6
109;05.08.2018;2018;08;09;Sunnuntai;7;7;14;1;4;5
109;05.08.2018;2018;08;10;Sunnuntai;8;2;10;9;4;13
109;05.08.2018;2018;08;11;Sunnuntai;6;6;12;2;2;4
109;05.08.2018;2018;08;12;Sunnuntai;10;9;19;3;3;6
109;05.08.2018;2018;08;13;Sunnuntai;6;6;12;1;2;3
109;05.08.2018;2018;08;14;Sunnuntai;9;1;10;2;1;3
109;05.08.2018;2018;08;15;Sunnuntai;7;9;16;3;5;8
109;05.08.2018;2018;08;16;Sunnuntai;8;5;13;3;3;6
109;05.08.2018;2018;08;17;Sunnuntai;9;6;15;7;1;8
109;05.08.2018;2018;08;18;Sunnuntai;13;5;18;6;6;12
109;05.08.2018;2018;08;19;Sunnuntai;13;3;16;4;6;10
109;05.08.2018;2018;08;20;Sunnuntai;4;4;8;7;1;8
109;05.08.2018;2018;08;21;Sunnuntai;5;12;17;5;1;6
109;05.08.2018;2018;08;22;Sunnuntai;3;4;7;2;0;2
109;05.08.2018;2018;08;23;Sunnuntai;3;0;3;1;1;2
109;06.08.2018;2018;08;00;Maanantai;2;0;2;0;1;1
109;06.08.2018;2018;08;01;Maanantai;1;0;1;0;0;0
109;06.08.2018;2018;08;02;Maanantai;1;1;2;0;0;0
109;06.08.2018;2018;08;03;Maanantai;1;1;2;0;0;0
109;06.08.2018;2018;08;04;Maanantai;0;2;2;0;0;0
109;06.08.2018;2018;08;05;Maanantai;0;6;6;2;0;2
109;06.08.2018;2018;08;06;Maanantai;12;7;19;4;1;5
109;06.08.2018;2018;08;07;Maanantai;20;11;31;3;1;4
109;06.08.2018;2018;08;08;Maanantai;12;12;24;3;1;4
109;06.08.2018;2018;08;09;Maanantai;9;3;12;3;1;4
109;06.08.2018;2018;08;10;Maanantai;3;2;5;3;5;8
109;06.08.2018;2018;08;11;Maanantai;11;2;13;0;0;0
109;06.08.2018;2018;08;12;Maanantai;3;2;5;1;0;1
109;06.08.2018;2018;08;13;Maanantai;3;7;10;0;3;3
109;06.08.2018;2018;08;14;Maanantai;9;8;17;2;1;3
109;06.08.2018;2018;08;15;Maanantai;13;16;29;1;7;8
109;06.08.2018;2018;08;16;Maanantai;21;20;41;2;7;9
109;06.08.2018;2018;08;17;Maanantai;6;10;16;3;2;5
109;06.08.2018;2018;08;18;Maanantai;14;5;19;3;2;5
109;06.08.2018;2018;08;19;Maanantai;16;12;28;9;9;18
109;06.08.2018;2018;08;20;Maanantai;10;5;15;6;6;12
109;06.08.2018;2018;08;21;Maanantai;7;3;10;2;4;6
109;06.08.2018;2018;08;22;Maanantai;3;3;6;2;0;2
109;06.08.2018;2018;08;23;Maanantai;3;3;6;0;2;2
109;07.08.2018;2018;08;00;Tiistai;6;0;6;2;0;2
109;07.08.2018;2018;08;01;Tiistai;0;0;0;2;0;2
109;07.08.2018;2018;08;02;Tiistai;0;0;0;0;0;0
109;07.08.2018;2018;08;03;Tiistai;0;0;0;0;0;0
109;07.08.2018;2018;08;04;Tiistai;2;0;2;0;0;0
109;07.08.2018;2018;08;05;Tiistai;6;0;6;3;0;3
109;07.08.2018;2018;08;06;Tiistai;21;0;21;3;0;3
109;07.08.2018;2018;08;07;Tiistai;42;0;42;5;0;5
109;07.08.2018;2018;08;08;Tiistai;35;0;35;6;0;6
109;07.08.2018;2018;08;09;Tiistai;14;0;14;5;0;5
109;07.08.2018;2018;08;10;Tiistai;15;0;15;2;0;2
109;07.08.2018;2018;08;11;Tiistai;21;0;21;4;0;4
109;07.08.2018;2018;08;12;Tiistai;20;0;20;7;0;7
109;07.08.2018;2018;08;13;Tiistai;26;0;26;1;0;1
109;07.08.2018;2018;08;14;Tiistai;26;0;26;5;0;5
109;07.08.2018;2018;08;15;Tiistai;60;0;60;5;0;5
109;07.08.2018;2018;08;16;Tiistai;54;0;54;5;0;5
109;07.08.2018;2018;08;17;Tiistai;32;0;32;0;0;0
109;07.08.2018;2018;08;18;Tiistai;31;0;31;0;0;0
109;07.08.2018;2018;08;19;Tiistai;21;0;21;2;0;2
109;07.08.2018;2018;08;20;Tiistai;27;0;27;1;0;1
109;07.08.2018;2018;08;21;Tiistai;10;0;10;0;0;0
109;07.08.2018;2018;08;22;Tiistai;13;0;13;1;0;1
109;07.08.2018;2018;08;23;Tiistai;2;0;2;1;0;1
109;08.08.2018;2018;08;00;Keskiviikko;0;1;1;1;1;2
109;08.08.2018;2018;08;01;Keskiviikko;1;0;1;0;2;2
109;08.08.2018;2018;08;02;Keskiviikko;1;1;2;0;0;0
109;08.08.2018;2018;08;03;Keskiviikko;0;0;0;0;0;0
109;08.08.2018;2018;08;04;Keskiviikko;0;0;0;0;0;0
109;08.08.2018;2018;08;05;Keskiviikko;3;6;9;2;0;2
109;08.08.2018;2018;08;06;Keskiviikko;16;9;25;3;0;3
109;08.08.2018;2018;08;07;Keskiviikko;32;22;54;2;2;4
109;08.08.2018;2018;08;08;Keskiviikko;25;19;44;5;5;10
109;08.08.2018;2018;08;09;Keskiviikko;13;3;16;7;1;8
109;08.08.2018;2018;08;10;Keskiviikko;5;7;12;0;0;0
109;08.08.2018;2018;08;11;Keskiviikko;8;6;14;4;7;11
109;08.08.2018;2018;08;12;Keskiviikko;16;14;30;2;2;4
109;08.08.2018;2018;08;13;Keskiviikko;9;12;21;3;2;5
109;08.08.2018;2018;08;14;Keskiviikko;10;13;23;0;1;1
109;08.08.2018;2018;08;15;Keskiviikko;28;30;58;6;4;10
109;08.08.2018;2018;08;16;Keskiviikko;36;33;69;0;1;1
109;08.08.2018;2018;08;17;Keskiviikko;20;8;28;2;2;4
109;08.08.2018;2018;08;18;Keskiviikko;14;14;28;2;5;7
109;08.08.2018;2018;08;19;Keskiviikko;15;11;26;6;3;9
109;08.08.2018;2018;08;20;Keskiviikko;8;14;22;1;5;6
109;08.08.2018;2018;08;21;Keskiviikko;13;3;16;5;4;9
109;08.08.2018;2018;08;22;Keskiviikko;6;3;9;3;2;5
109;08.08.2018;2018;08;23;Keskiviikko;2;1;3;0;0;0
109;09.08.2018;2018;08;00;Torstai;0;1;1;1;1;2
109;09.08.2018;2018;08;01;Torstai;0;0;0;0;0;0
109;09.08.2018;2018;08;02;Torstai;0;4;4;0;0;0
109;09.08.2018;2018;08;03;Torstai;0;1;1;0;0;0
109;09.08.2018;2018;08;04;Torstai;3;0;3;0;0;0
109;09.08.2018;2018;08;05;Torstai;2;2;4;3;2;5
109;09.08.2018;2018;08;06;Torstai;13;10;23;4;0;4
109;09.08.2018;2018;08;07;Torstai;30;21;51;4;2;6
109;09.08.2018;2018;08;08;Torstai;21;11;32;3;1;4
109;09.08.2018;2018;08;09;Torstai;14;3;17;5;3;8
109;09.08.2018;2018;08;10;Torstai;4;1;5;1;3;4
109;09.08.2018;2018;08;11;Torstai;4;7;11;3;1;4
109;09.08.2018;2018;08;12;Torstai;3;7;10;2;0;2
109;09.08.2018;2018;08;13;Torstai;12;12;24;2;2;4
109;09.08.2018;2018;08;14;Torstai;16;14;30;2;4;6
109;09.08.2018;2018;08;15;Torstai;14;25;39;2;3;5
109;09.08.2018;2018;08;16;Torstai;19;24;43;7;3;10
109;09.08.2018;2018;08;17;Torstai;14;11;25;1;3;4
109;09.08.2018;2018;08;18;Torstai;13;13;26;6;4;10
109;09.08.2018;2018;08;19;Torstai;9;13;22;3;4;7
109;09.08.2018;2018;08;20;Torstai;8;8;16;3;3;6
109;09.08.2018;2018;08;21;Torstai;7;6;13;2;3;5
109;09.08.2018;2018;08;22;Torstai;2;4;6;2;1;3
109;09.08.2018;2018;08;23;Torstai;4;1;5;1;2;3
109;10.08.2018;2018;08;00;Perjantai;1;2;3;2;0;2
109;10.08.2018;2018;08;01;Perjantai;0;0;0;0;1;1
109;10.08.2018;2018;08;02;Perjantai;0;0;0;0;1;1
109;10.08.2018;2018;08;03;Perjantai;0;0;0;0;0;0
109;10.08.2018;2018;08;04;Perjantai;1;1;2;0;0;0
109;10.08.2018;2018;08;05;Perjantai;2;5;7;0;0;0
109;10.08.2018;2018;08;06;Perjantai;20;9;29;5;0;5
109;10.08.2018;2018;08;07;Perjantai;33;21;54;3;2;5
109;10.08.2018;2018;08;08;Perjantai;28;14;42;0;1;1
109;10.08.2018;2018;08;09;Perjantai;21;5;26;2;5;7
109;10.08.2018;2018;08;10;Perjantai;10;4;14;2;1;3
109;10.08.2018;2018;08;11;Perjantai;6;7;13;8;3;11
109;10.08.2018;2018;08;12;Perjantai;5;9;14;4;2;6
109;10.08.2018;2018;08;13;Perjantai;12;11;23;4;4;8
109;10.08.2018;2018;08;14;Perjantai;13;23;36;4;2;6
109;10.08.2018;2018;08;15;Perjantai;24;32;56;3;2;5
109;10.08.2018;2018;08;16;Perjantai;18;32;50;3;3;6
109;10.08.2018;2018;08;17;Perjantai;14;10;24;6;3;9
109;10.08.2018;2018;08;18;Perjantai;19;4;23;2;1;3
109;10.08.2018;2018;08;19;Perjantai;1;10;11;1;1;2
109;10.08.2018;2018;08;20;Perjantai;3;3;6;4;1;5
109;10.08.2018;2018;08;21;Perjantai;5;2;7;0;0;0
109;10.08.2018;2018;08;22;Perjantai;3;1;4;0;1;1
109;10.08.2018;2018;08;23;Perjantai;1;4;5;2;1;3
109;11.08.2018;2018;08;00;Lauantai;1;1;2;0;0;0
109;11.08.2018;2018;08;01;Lauantai;2;0;2;0;0;0
109;11.08.2018;2018;08;02;Lauantai;0;1;1;2;1;3
109;11.08.2018;2018;08;03;Lauantai;1;0;1;0;1;1
109;11.08.2018;2018;08;04;Lauantai;0;1;1;0;0;0
109;11.08.2018;2018;08;05;Lauantai;2;2;4;0;1;1
109;11.08.2018;2018;08;06;Lauantai;2;0;2;1;0;1
109;11.08.2018;2018;08;07;Lauantai;0;1;1;0;0;0
109;11.08.2018;2018;08;08;Lauantai;4;2;6;0;2;2
109;11.08.2018;2018;08;09;Lauantai;4;5;9;7;2;9
109;11.08.2018;2018;08;10;Lauantai;6;3;9;5;2;7
109;11.08.2018;2018;08;11;Lauantai;11;1;12;10;1;11
109;11.08.2018;2018;08;12;Lauantai;15;1;16;3;1;4
109;11.08.2018;2018;08;13;Lauantai;2;13;15;4;1;5
109;11.08.2018;2018;08;14;Lauantai;11;13;24;4;1;5
109;11.08.2018;2018;08;15;Lauantai;8;13;21;5;0;5
109;11.08.2018;2018;08;16;Lauantai;8;3;11;1;3;4
109;11.08.2018;2018;08;17;Lauantai;6;14;20;1;4;5
109;11.08.2018;2018;08;18;Lauantai;14;7;21;3;0;3
109;11.08.2018;2018;08;19;Lauantai;11;9;20;4;5;9
109;11.08.2018;2018;08;20;Lauantai;2;2;4;2;2;4
109;11.08.2018;2018;08;21;Lauantai;5;3;8;3;3;6
109;11.08.2018;2018;08;22;Lauantai;3;0;3;1;0;1
109;11.08.2018;2018;08;23;Lauantai;5;5;10;0;0;0
109;12.08.2018;2018;08;00;Sunnuntai;4;4;8;0;1;1
109;12.08.2018;2018;08;01;Sunnuntai;4;2;6;0;1;1
109;12.08.2018;2018;08;02;Sunnuntai;2;2;4;0;0;0
109;12.08.2018;2018;08;03;Sunnuntai;1;0;1;0;0;0
109;12.08.2018;2018;08;04;Sunnuntai;1;1;2;0;0;0
109;12.08.2018;2018;08;05;Sunnuntai;0;1;1;0;1;1
109;12.08.2018;2018;08;06;Sunnuntai;3;1;4;0;0;0
109;12.08.2018;2018;08;07;Sunnuntai;0;1;1;1;3;4
109;12.08.2018;2018;08;08;Sunnuntai;2;2;4;1;1;2
109;12.08.2018;2018;08;09;Sunnuntai;5;4;9;1;2;3
109;12.08.2018;2018;08;10;Sunnuntai;11;1;12;0;3;3
109;12.08.2018;2018;08;11;Sunnuntai;5;5;10;2;5;7
109;12.08.2018;2018;08;12;Sunnuntai;7;19;26;3;1;4
109;12.08.2018;2018;08;13;Sunnuntai;21;9;30;4;2;6
109;12.08.2018;2018;08;14;Sunnuntai;8;11;19;5;2;7
109;12.08.2018;2018;08;15;Sunnuntai;12;12;24;26;15;41
109;12.08.2018;2018;08;16;Sunnuntai;13;5;18;3;1;4
109;12.08.2018;2018;08;17;Sunnuntai;12;6;18;2;2;4
109;12.08.2018;2018;08;18;Sunnuntai;8;11;19;2;3;5
109;12.08.2018;2018;08;19;Sunnuntai;10;8;18;6;5;11
109;12.08.2018;2018;08;20;Sunnuntai;5;3;8;2;6;8
109;12.08.2018;2018;08;21;Sunnuntai;1;5;6;2;2;4
109;12.08.2018;2018;08;22;Sunnuntai;0;3;3;2;2;4
109;12.08.2018;2018;08;23;Sunnuntai;4;0;4;6;1;7
109;13.08.2018;2018;08;00;Maanantai;0;0;0;1;2;3
109;13.08.2018;2018;08;01;Maanantai;0;0;0;0;1;1
109;13.08.2018;2018;08;02;Maanantai;0;0;0;1;0;1
109;13.08.2018;2018;08;03;Maanantai;0;1;1;0;0;0
109;13.08.2018;2018;08;04;Maanantai;1;0;1;0;0;0
109;13.08.2018;2018;08;05;Maanantai;5;1;6;2;1;3
109;13.08.2018;2018;08;06;Maanantai;13;7;20;0;0;0
109;13.08.2018;2018;08;07;Maanantai;29;15;44;3;3;6
109;13.08.2018;2018;08;08;Maanantai;22;10;32;4;2;6
109;13.08.2018;2018;08;09;Maanantai;9;5;14;3;1;4
109;13.08.2018;2018;08;10;Maanantai;6;5;11;5;1;6
109;13.08.2018;2018;08;11;Maanantai;5;6;11;2;2;4
109;13.08.2018;2018;08;12;Maanantai;7;11;18;1;2;3
109;13.08.2018;2018;08;13;Maanantai;10;6;16;0;1;1
109;13.08.2018;2018;08;14;Maanantai;12;14;26;4;6;10
109;13.08.2018;2018;08;15;Maanantai;14;26;40;8;1;9
109;13.08.2018;2018;08;16;Maanantai;17;30;47;3;3;6
109;13.08.2018;2018;08;17;Maanantai;12;8;20;1;1;2
109;13.08.2018;2018;08;18;Maanantai;11;12;23;1;1;2
109;13.08.2018;2018;08;19;Maanantai;5;3;8;10;8;18
109;13.08.2018;2018;08;20;Maanantai;5;13;18;4;5;9
109;13.08.2018;2018;08;21;Maanantai;9;11;20;7;3;10
109;13.08.2018;2018;08;22;Maanantai;6;2;8;2;0;2
109;13.08.2018;2018;08;23;Maanantai;1;1;2;0;1;1
109;14.08.2018;2018;08;00;Tiistai;2;0;2;0;1;1
109;14.08.2018;2018;08;01;Tiistai;0;1;1;0;0;0
109;14.08.2018;2018;08;02;Tiistai;0;0;0;0;0;0
109;14.08.2018;2018;08;03;Tiistai;0;1;1;0;0;0
109;14.08.2018;2018;08;04;Tiistai;3;0;3;0;0;0
109;14.08.2018;2018;08;05;Tiistai;2;4;6;3;1;4
109;14.08.2018;2018;08;06;Tiistai;17;11;28;4;0;4
109;14.08.2018;2018;08;07;Tiistai;39;19;58;4;3;7
109;14.08.2018;2018;08;08;Tiistai;31;14;45;2;2;4
109;14.08.2018;2018;08;09;Tiistai;16;5;21;1;4;5
109;14.08.2018;2018;08;10;Tiistai;13;5;18;1;3;4
109;14.08.2018;2018;08;11;Tiistai;5;7;12;2;3;5
109;14.08.2018;2018;08;12;Tiistai;5;9;14;2;1;3
109;14.08.2018;2018;08;13;Tiistai;8;13;21;3;1;4
109;14.08.2018;2018;08;14;Tiistai;18;25;43;1;2;3
109;14.08.2018;2018;08;15;Tiistai;22;27;49;1;5;6
109;14.08.2018;2018;08;16;Tiistai;18;41;59;5;6;11
109;14.08.2018;2018;08;17;Tiistai;14;13;27;4;3;7
109;14.08.2018;2018;08;18;Tiistai;13;15;28;4;2;6
109;14.08.2018;2018;08;19;Tiistai;4;11;15;6;7;13
109;14.08.2018;2018;08;20;Tiistai;14;9;23;5;7;12
109;14.08.2018;2018;08;21;Tiistai;3;11;14;4;3;7
109;14.08.2018;2018;08;22;Tiistai;9;8;17;0;0;0
109;14.08.2018;2018;08;23;Tiistai;4;0;4;1;1;2
109;15.08.2018;2018;08;00;Keskiviikko;0;0;0;0;0;0
109;15.08.2018;2018;08;01;Keskiviikko;0;0;0;0;1;1
109;15.08.2018;2018;08;02;Keskiviikko;0;1;1;1;0;1
109;15.08.2018;2018;08;03;Keskiviikko;0;1;1;0;0;0
109;15.08.2018;2018;08;04;Keskiviikko;1;1;2;0;0;0
109;15.08.2018;2018;08;05;Keskiviikko;3;3;6;3;5;8
109;15.08.2018;2018;08;06;Keskiviikko;15;11;26;0;0;0
109;15.08.2018;2018;08;07;Keskiviikko;34;23;57;7;1;8
109;15.08.2018;2018;08;08;Keskiviikko;32;14;46;7;2;9
109;15.08.2018;2018;08;09;Keskiviikko;12;4;16;4;4;8
109;15.08.2018;2018;08;10;Keskiviikko;5;7;12;3;3;6
109;15.08.2018;2018;08;11;Keskiviikko;4;11;15;3;3;6
109;15.08.2018;2018;08;12;Keskiviikko;7;8;15;3;2;5
109;15.08.2018;2018;08;13;Keskiviikko;5;10;15;2;3;5
109;15.08.2018;2018;08;14;Keskiviikko;19;22;41;5;3;8
109;15.08.2018;2018;08;15;Keskiviikko;26;29;55;5;2;7
109;15.08.2018;2018;08;16;Keskiviikko;23;35;58;1;4;5
109;15.08.2018;2018;08;17;Keskiviikko;23;12;35;0;3;3
109;15.08.2018;2018;08;18;Keskiviikko;9;14;23;3;2;5
109;15.08.2018;2018;08;19;Keskiviikko;11;14;25;5;5;10
109;15.08.2018;2018;08;20;Keskiviikko;11;15;26;8;7;15
109;15.08.2018;2018;08;21;Keskiviikko;5;11;16;0;4;4
109;15.08.2018;2018;08;22;Keskiviikko;5;4;9;3;5;8
109;15.08.2018;2018;08;23;Keskiviikko;2;3;5;0;0;0
109;16.08.2018;2018;08;00;Torstai;0;0;0;0;2;2
109;16.08.2018;2018;08;01;Torstai;0;0;0;0;2;2
109;16.08.2018;2018;08;02;Torstai;0;0;0;0;0;0
109;16.08.2018;2018;08;03;Torstai;0;1;1;0;0;0
109;16.08.2018;2018;08;04;Torstai;1;1;2;0;0;0
109;16.08.2018;2018;08;05;Torstai;2;5;7;2;0;2
109;16.08.2018;2018;08;06;Torstai;20;6;26;3;1;4
109;16.08.2018;2018;08;07;Torstai;30;20;50;1;1;2
109;16.08.2018;2018;08;08;Torstai;38;14;52;3;4;7
109;16.08.2018;2018;08;09;Torstai;9;5;14;2;1;3
109;16.08.2018;2018;08;10;Torstai;10;6;16;3;3;6
109;16.08.2018;2018;08;11;Torstai;9;5;14;8;3;11
109;16.08.2018;2018;08;12;Torstai;7;11;18;2;3;5
109;16.08.2018;2018;08;13;Torstai;7;9;16;3;2;5
109;16.08.2018;2018;08;14;Torstai;18;23;41;6;8;14
109;16.08.2018;2018;08;15;Torstai;19;30;49;4;2;6
109;16.08.2018;2018;08;16;Torstai;23;38;61;2;3;5
109;16.08.2018;2018;08;17;Torstai;13;9;22;5;2;7
109;16.08.2018;2018;08;18;Torstai;22;12;34;7;2;9
109;16.08.2018;2018;08;19;Torstai;15;22;37;5;3;8
109;16.08.2018;2018;08;20;Torstai;13;12;25;4;3;7
109;16.08.2018;2018;08;21;Torstai;7;5;12;1;0;1
109;16.08.2018;2018;08;22;Torstai;8;9;17;4;0;4
109;16.08.2018;2018;08;23;Torstai;2;1;3;0;0;0
109;17.08.2018;2018;08;00;Perjantai;0;3;3;0;0;0
109;17.08.2018;2018;08;01;Perjantai;0;1;1;0;0;0
109;17.08.2018;2018;08;02;Perjantai;0;1;1;0;0;0
109;17.08.2018;2018;08;03;Perjantai;1;1;2;0;0;0
109;17.08.2018;2018;08;04;Perjantai;1;0;1;0;1;1
109;17.08.2018;2018;08;05;Perjantai;5;4;9;2;0;2
109;17.08.2018;2018;08;06;Perjantai;19;8;27;2;1;3
109;17.08.2018;2018;08;07;Perjantai;32;17;49;3;4;7
109;17.08.2018;2018;08;08;Perjantai;19;10;29;5;2;7
109;17.08.2018;2018;08;09;Perjantai;14;3;17;2;3;5
109;17.08.2018;2018;08;10;Perjantai;4;6;10;1;0;1
109;17.08.2018;2018;08;11;Perjantai;6;3;9;5;1;6
109;17.08.2018;2018;08;12;Perjantai;10;5;15;4;1;5
109;17.08.2018;2018;08;13;Perjantai;16;13;29;4;1;5
109;17.08.2018;2018;08;14;Perjantai;11;21;32;3;4;7
109;17.08.2018;2018;08;15;Perjantai;27;31;58;4;3;7
109;17.08.2018;2018;08;16;Perjantai;33;27;60;1;3;4
109;17.08.2018;2018;08;17;Perjantai;10;5;15;3;2;5
109;17.08.2018;2018;08;18;Perjantai;12;14;26;1;3;4
109;17.08.2018;2018;08;19;Perjantai;4;5;9;4;0;4
109;17.08.2018;2018;08;20;Perjantai;6;7;13;0;2;2
109;17.08.2018;2018;08;21;Perjantai;2;5;7;2;2;4
109;17.08.2018;2018;08;22;Perjantai;2;1;3;0;1;1
109;17.08.2018;2018;08;23;Perjantai;1;1;2;1;3;4
109;18.08.2018;2018;08;00;Lauantai;1;1;2;1;0;1
109;18.08.2018;2018;08;01;Lauantai;0;0;0;2;1;3
109;18.08.2018;2018;08;02;Lauantai;0;0;0;0;0;0
109;18.08.2018;2018;08;03;Lauantai;1;0;1;0;0;0
109;18.08.2018;2018;08;04;Lauantai;0;2;2;0;1;1
109;18.08.2018;2018;08;05;Lauantai;2;0;2;0;0;0
109;18.08.2018;2018;08;06;Lauantai;4;1;5;2;1;3
109;18.08.2018;2018;08;07;Lauantai;0;2;2;0;2;2
109;18.08.2018;2018;08;08;Lauantai;2;4;6;3;1;4
109;18.08.2018;2018;08;09;Lauantai;3;5;8;5;3;8
109;18.08.2018;2018;08;10;Lauantai;0;6;6;5;2;7
109;18.08.2018;2018;08;11;Lauantai;11;6;17;4;1;5
109;18.08.2018;2018;08;12;Lauantai;10;8;18;2;4;6
109;18.08.2018;2018;08;13;Lauantai;12;9;21;3;3;6
109;18.08.2018;2018;08;14;Lauantai;13;4;17;6;4;10
109;18.08.2018;2018;08;15;Lauantai;5;8;13;4;4;8
109;18.08.2018;2018;08;16;Lauantai;12;7;19;4;2;6
109;18.08.2018;2018;08;17;Lauantai;13;10;23;1;2;3
109;18.08.2018;2018;08;18;Lauantai;8;8;16;2;4;6
109;18.08.2018;2018;08;19;Lauantai;7;5;12;6;2;8
109;18.08.2018;2018;08;20;Lauantai;18;3;21;0;2;2
109;18.08.2018;2018;08;21;Lauantai;11;4;15;3;1;4
109;18.08.2018;2018;08;22;Lauantai;8;5;13;2;2;4
109;18.08.2018;2018;08;23;Lauantai;2;7;9;1;1;2
109;19.08.2018;2018;08;00;Sunnuntai;2;8;10;0;0;0
109;19.08.2018;2018;08;01;Sunnuntai;0;0;0;0;0;0
109;19.08.2018;2018;08;02;Sunnuntai;0;0;0;0;0;0
109;19.08.2018;2018;08;03;Sunnuntai;0;1;1;1;1;2
109;19.08.2018;2018;08;04;Sunnuntai;0;0;0;0;1;1
109;19.08.2018;2018;08;05;Sunnuntai;2;0;2;0;0;0
109;19.08.2018;2018;08;06;Sunnuntai;4;3;7;0;0;0
109;19.08.2018;2018;08;07;Sunnuntai;0;2;2;2;3;5
109;19.08.2018;2018;08;08;Sunnuntai;0;1;1;0;0;0
109;19.08.2018;2018;08;09;Sunnuntai;5;5;10;5;4;9
109;19.08.2018;2018;08;10;Sunnuntai;6;3;9;5;4;9
109;19.08.2018;2018;08;11;Sunnuntai;9;10;19;0;3;3
109;19.08.2018;2018;08;12;Sunnuntai;9;8;17;5;5;10
109;19.08.2018;2018;08;13;Sunnuntai;7;10;17;2;0;2
109;19.08.2018;2018;08;14;Sunnuntai;11;6;17;3;3;6
109;19.08.2018;2018;08;15;Sunnuntai;13;3;16;4;2;6
109;19.08.2018;2018;08;16;Sunnuntai;13;7;20;4;1;5
109;19.08.2018;2018;08;17;Sunnuntai;8;5;13;1;0;1
109;19.08.2018;2018;08;18;Sunnuntai;8;10;18;2;7;9
109;19.08.2018;2018;08;19;Sunnuntai;4;6;10;8;3;11
109;19.08.2018;2018;08;20;Sunnuntai;9;6;15;1;7;8
109;19.08.2018;2018;08;21;Sunnuntai;8;4;12;8;5;13
109;19.08.2018;2018;08;22;Sunnuntai;2;3;5;0;0;0
109;19.08.2018;2018;08;23;Sunnuntai;0;0;0;1;0;1
109;20.08.2018;2018;08;00;Maanantai;2;1;3;0;2;2
109;20.08.2018;2018;08;01;Maanantai;0;2;2;0;0;0
109;20.08.2018;2018;08;02;Maanantai;0;0;0;0;1;1
109;20.08.2018;2018;08;03;Maanantai;0;0;0;1;0;1
109;20.08.2018;2018;08;04;Maanantai;1;0;1;0;0;0
109;20.08.2018;2018;08;05;Maanantai;3;2;5;2;0;2
109;20.08.2018;2018;08;06;Maanantai;17;13;30;0;1;1
109;20.08.2018;2018;08;07;Maanantai;32;25;57;1;2;3
109;20.08.2018;2018;08;08;Maanantai;37;11;48;4;1;5
109;20.08.2018;2018;08;09;Maanantai;11;5;16;2;4;6
109;20.08.2018;2018;08;10;Maanantai;5;6;11;6;2;8
109;20.08.2018;2018;08;11;Maanantai;8;4;12;1;1;2
109;20.08.2018;2018;08;12;Maanantai;9;5;14;4;0;4
109;20.08.2018;2018;08;13;Maanantai;6;5;11;3;0;3
109;20.08.2018;2018;08;14;Maanantai;8;22;30;7;3;10
109;20.08.2018;2018;08;15;Maanantai;23;21;44;3;2;5
109;20.08.2018;2018;08;16;Maanantai;24;31;55;4;7;11
109;20.08.2018;2018;08;17;Maanantai;8;20;28;2;1;3
109;20.08.2018;2018;08;18;Maanantai;9;6;15;4;2;6
109;20.08.2018;2018;08;19;Maanantai;6;12;18;1;11;12
109;20.08.2018;2018;08;20;Maanantai;7;3;10;5;4;9
109;20.08.2018;2018;08;21;Maanantai;3;7;10;8;2;10
109;20.08.2018;2018;08;22;Maanantai;3;1;4;3;1;4
109;20.08.2018;2018;08;23;Maanantai;2;0;2;1;0;1
109;21.08.2018;2018;08;00;Tiistai;0;0;0;0;0;0
109;21.08.2018;2018;08;01;Tiistai;0;0;0;0;0;0
109;21.08.2018;2018;08;02;Tiistai;0;0;0;0;0;0
109;21.08.2018;2018;08;03;Tiistai;0;1;1;0;0;0
109;21.08.2018;2018;08;04;Tiistai;1;1;2;0;0;0
109;21.08.2018;2018;08;05;Tiistai;2;0;2;2;0;2
109;21.08.2018;2018;08;06;Tiistai;20;9;29;3;1;4
109;21.08.2018;2018;08;07;Tiistai;46;28;74;4;2;6
109;21.08.2018;2018;08;08;Tiistai;33;13;46;1;1;2
109;21.08.2018;2018;08;09;Tiistai;12;8;20;1;5;6
109;21.08.2018;2018;08;10;Tiistai;9;5;14;1;5;6
109;21.08.2018;2018;08;11;Tiistai;4;11;15;3;2;5
109;21.08.2018;2018;08;12;Tiistai;8;2;10;2;1;3
109;21.08.2018;2018;08;13;Tiistai;7;9;16;4;4;8
109;21.08.2018;2018;08;14;Tiistai;7;12;19;2;2;4
109;21.08.2018;2018;08;15;Tiistai;26;28;54;8;4;12
109;21.08.2018;2018;08;16;Tiistai;36;41;77;5;4;9
109;21.08.2018;2018;08;17;Tiistai;15;24;39;3;2;5
109;21.08.2018;2018;08;18;Tiistai;20;15;35;3;4;7
109;21.08.2018;2018;08;19;Tiistai;4;12;16;5;3;8
109;21.08.2018;2018;08;20;Tiistai;7;4;11;2;1;3
109;21.08.2018;2018;08;21;Tiistai;9;2;11;3;3;6
109;21.08.2018;2018;08;22;Tiistai;8;2;10;0;0;0
109;21.08.2018;2018;08;23;Tiistai;0;0;0;1;0;1
109;22.08.2018;2018;08;00;Keskiviikko;0;1;1;0;0;0
109;22.08.2018;2018;08;01;Keskiviikko;1;0;1;0;1;1
109;22.08.2018;2018;08;02;Keskiviikko;0;0;0;0;1;1
109;22.08.2018;2018;08;03;Keskiviikko;0;0;0;0;0;0
109;22.08.2018;2018;08;04;Keskiviikko;0;0;0;0;0;0
109;22.08.2018;2018;08;05;Keskiviikko;6;3;9;2;0;2
109;22.08.2018;2018;08;06;Keskiviikko;17;7;24;4;0;4
109;22.08.2018;2018;08;07;Keskiviikko;37;33;70;11;12;23
109;22.08.2018;2018;08;08;Keskiviikko;40;19;59;10;2;12
109;22.08.2018;2018;08;09;Keskiviikko;19;8;27;1;2;3
109;22.08.2018;2018;08;10;Keskiviikko;7;7;14;7;2;9
109;22.08.2018;2018;08;11;Keskiviikko;9;1;10;1;2;3
109;22.08.2018;2018;08;12;Keskiviikko;13;8;21;1;1;2
109;22.08.2018;2018;08;13;Keskiviikko;11;19;30;1;4;5
109;22.08.2018;2018;08;14;Keskiviikko;16;22;38;2;2;4
109;22.08.2018;2018;08;15;Keskiviikko;17;26;43;3;0;3
109;22.08.2018;2018;08;16;Keskiviikko;36;34;70;3;5;8
109;22.08.2018;2018;08;17;Keskiviikko;9;19;28;2;2;4
109;22.08.2018;2018;08;18;Keskiviikko;12;11;23;4;1;5
109;22.08.2018;2018;08;19;Keskiviikko;6;19;25;5;4;9
109;22.08.2018;2018;08;20;Keskiviikko;3;7;10;3;1;4
109;22.08.2018;2018;08;21;Keskiviikko;4;6;10;2;0;2
109;22.08.2018;2018;08;22;Keskiviikko;6;1;7;0;2;2
109;22.08.2018;2018;08;23;Keskiviikko;0;0;0;1;1;2
109;23.08.2018;2018;08;00;Torstai;0;1;1;1;0;1
109;23.08.2018;2018;08;01;Torstai;1;0;1;1;1;2
109;23.08.2018;2018;08;02;Torstai;0;0;0;0;1;1
109;23.08.2018;2018;08;03;Torstai;0;0;0;1;1;2
109;23.08.2018;2018;08;04;Torstai;0;0;0;0;0;0
109;23.08.2018;2018;08;05;Torstai;2;3;5;1;0;1
109;23.08.2018;2018;08;06;Torstai;15;6;21;4;1;5
109;23.08.2018;2018;08;07;Torstai;18;23;41;5;3;8
109;23.08.2018;2018;08;08;Torstai;26;10;36;2;2;4
109;23.08.2018;2018;08;09;Torstai;13;2;15;1;0;1
109;23.08.2018;2018;08;10;Torstai;5;0;5;1;0;1
109;23.08.2018;2018;08;11;Torstai;4;0;4;2;0;2
109;23.08.2018;2018;08;12;Torstai;3;4;7;1;1;2
109;23.08.2018;2018;08;13;Torstai;4;7;11;2;2;4
109;23.08.2018;2018;08;14;Torstai;8;10;18;2;4;6
109;23.08.2018;2018;08;15;Torstai;21;16;37;4;3;7
109;23.08.2018;2018;08;16;Torstai;18;26;44;2;1;3
109;23.08.2018;2018;08;17;Torstai;18;13;31;6;2;8
109;23.08.2018;2018;08;18;Torstai;11;13;24;8;5;13
109;23.08.2018;2018;08;19;Torstai;12;6;18;4;8;12
109;23.08.2018;2018;08;20;Torstai;3;6;9;1;2;3
109;23.08.2018;2018;08;21;Torstai;9;7;16;3;5;8
109;23.08.2018;2018;08;22;Torstai;10;0;10;2;2;4
109;23.08.2018;2018;08;23;Torstai;0;1;1;0;0;0
109;24.08.2018;2018;08;00;Perjantai;0;1;1;1;1;2
109;24.08.2018;2018;08;01;Perjantai;0;1;1;2;0;2
109;24.08.2018;2018;08;02;Perjantai;1;1;2;0;0;0
109;24.08.2018;2018;08;03;Perjantai;0;0;0;0;0;0
109;24.08.2018;2018;08;04;Perjantai;0;0;0;0;0;0
109;24.08.2018;2018;08;05;Perjantai;2;4;6;2;0;2
109;24.08.2018;2018;08;06;Perjantai;21;8;29;2;2;4
109;24.08.2018;2018;08;07;Perjantai;23;17;40;1;2;3
109;24.08.2018;2018;08;08;Perjantai;18;13;31;5;5;10
109;24.08.2018;2018;08;09;Perjantai;12;6;18;1;1;2
109;24.08.2018;2018;08;10;Perjantai;6;5;11;0;4;4
109;24.08.2018;2018;08;11;Perjantai;2;4;6;0;1;1
109;24.08.2018;2018;08;12;Perjantai;3;6;9;1;0;1
109;24.08.2018;2018;08;13;Perjantai;5;8;13;1;2;3
109;24.08.2018;2018;08;14;Perjantai;10;8;18;3;0;3
109;24.08.2018;2018;08;15;Perjantai;19;18;37;6;1;7
109;24.08.2018;2018;08;16;Perjantai;20;24;44;4;1;5
109;24.08.2018;2018;08;17;Perjantai;16;3;19;4;2;6
109;24.08.2018;2018;08;18;Perjantai;14;5;19;3;0;3
109;24.08.2018;2018;08;19;Perjantai;7;5;12;4;2;6
109;24.08.2018;2018;08;20;Perjantai;6;3;9;3;1;4
109;24.08.2018;2018;08;21;Perjantai;1;3;4;2;0;2
109;24.08.2018;2018;08;22;Perjantai;4;1;5;1;0;1
109;24.08.2018;2018;08;23;Perjantai;1;0;1;1;0;1
109;25.08.2018;2018;08;00;Lauantai;1;0;1;0;0;0
109;25.08.2018;2018;08;01;Lauantai;0;1;1;0;0;0
109;25.08.2018;2018;08;02;Lauantai;1;1;2;0;0;0
109;25.08.2018;2018;08;03;Lauantai;0;0;0;0;0;0
109;25.08.2018;2018;08;04;Lauantai;0;0;0;1;0;1
109;25.08.2018;2018;08;05;Lauantai;0;1;1;1;1;2
109;25.08.2018;2018;08;06;Lauantai;2;2;4;1;0;1
109;25.08.2018;2018;08;07;Lauantai;2;0;2;0;2;2
109;25.08.2018;2018;08;08;Lauantai;1;3;4;0;1;1
109;25.08.2018;2018;08;09;Lauantai;5;3;8;1;1;2
109;25.08.2018;2018;08;10;Lauantai;1;2;3;6;2;8
109;25.08.2018;2018;08;11;Lauantai;7;3;10;0;2;2
109;25.08.2018;2018;08;12;Lauantai;18;4;22;5;0;5
109;25.08.2018;2018;08;13;Lauantai;12;12;24;4;3;7
109;25.08.2018;2018;08;14;Lauantai;9;8;17;2;2;4
109;25.08.2018;2018;08;15;Lauantai;11;11;22;5;1;6
109;25.08.2018;2018;08;16;Lauantai;6;16;22;3;2;5
109;25.08.2018;2018;08;17;Lauantai;3;6;9;5;4;9
109;25.08.2018;2018;08;18;Lauantai;7;5;12;1;1;2
109;25.08.2018;2018;08;19;Lauantai;7;2;9;6;6;12
109;25.08.2018;2018;08;20;Lauantai;2;6;8;0;8;8
109;25.08.2018;2018;08;21;Lauantai;5;8;13;3;2;5
109;25.08.2018;2018;08;22;Lauantai;3;0;3;1;0;1
109;25.08.2018;2018;08;23;Lauantai;0;3;3;0;0;0
109;26.08.2018;2018;08;00;Sunnuntai;0;1;1;1;1;2
109;26.08.2018;2018;08;01;Sunnuntai;1;2;3;0;2;2
109;26.08.2018;2018;08;02;Sunnuntai;0;2;2;0;0;0
109;26.08.2018;2018;08;03;Sunnuntai;0;5;5;3;0;3
109;26.08.2018;2018;08;04;Sunnuntai;1;0;1;0;0;0
109;26.08.2018;2018;08;05;Sunnuntai;0;4;4;0;0;0
109;26.08.2018;2018;08;06;Sunnuntai;3;0;3;0;1;1
109;26.08.2018;2018;08;07;Sunnuntai;0;0;0;2;2;4
109;26.08.2018;2018;08;08;Sunnuntai;1;1;2;1;1;2
109;26.08.2018;2018;08;09;Sunnuntai;0;1;1;0;6;6
109;26.08.2018;2018;08;10;Sunnuntai;8;4;12;5;1;6
109;26.08.2018;2018;08;11;Sunnuntai;18;4;22;5;3;8
109;26.08.2018;2018;08;12;Sunnuntai;12;8;20;3;2;5
109;26.08.2018;2018;08;13;Sunnuntai;22;4;26;5;2;7
109;26.08.2018;2018;08;14;Sunnuntai;3;9;12;2;2;4
109;26.08.2018;2018;08;15;Sunnuntai;7;9;16;9;2;11
109;26.08.2018;2018;08;16;Sunnuntai;7;2;9;0;1;1
109;26.08.2018;2018;08;17;Sunnuntai;12;4;16;3;0;3
109;26.08.2018;2018;08;18;Sunnuntai;5;2;7;8;6;14
109;26.08.2018;2018;08;19;Sunnuntai;6;6;12;4;5;9
109;26.08.2018;2018;08;20;Sunnuntai;8;5;13;4;2;6
109;26.08.2018;2018;08;21;Sunnuntai;1;7;8;1;4;5
109;26.08.2018;2018;08;22;Sunnuntai;0;2;2;1;0;1
109;26.08.2018;2018;08;23;Sunnuntai;1;0;1;2;0;2
109;27.08.2018;2018;08;00;Maanantai;1;0;1;0;0;0
109;27.08.2018;2018;08;01;Maanantai;0;1;1;0;1;1
109;27.08.2018;2018;08;02;Maanantai;0;0;0;0;0;0
109;27.08.2018;2018;08;03;Maanantai;0;0;0;0;0;0
109;27.08.2018;2018;08;04;Maanantai;1;0;1;0;0;0
109;27.08.2018;2018;08;05;Maanantai;2;2;4;2;0;2
109;27.08.2018;2018;08;06;Maanantai;19;8;27;0;1;1
109;27.08.2018;2018;08;07;Maanantai;29;26;55;1;3;4
109;27.08.2018;2018;08;08;Maanantai;29;14;43;12;4;16
109;27.08.2018;2018;08;09;Maanantai;10;3;13;1;2;3
109;27.08.2018;2018;08;10;Maanantai;9;4;13;3;0;3
109;27.08.2018;2018;08;11;Maanantai;10;5;15;3;2;5
109;27.08.2018;2018;08;12;Maanantai;6;7;13;0;0;0
109;27.08.2018;2018;08;13;Maanantai;5;6;11;4;1;5
109;27.08.2018;2018;08;14;Maanantai;7;16;23;4;0;4
109;27.08.2018;2018;08;15;Maanantai;23;23;46;8;4;12
109;27.08.2018;2018;08;16;Maanantai;30;37;67;6;2;8
109;27.08.2018;2018;08;17;Maanantai;22;19;41;4;1;5
109;27.08.2018;2018;08;18;Maanantai;10;11;21;6;5;11
109;27.08.2018;2018;08;19;Maanantai;15;13;28;6;6;12
109;27.08.2018;2018;08;20;Maanantai;12;6;18;6;3;9
109;27.08.2018;2018;08;21;Maanantai;6;9;15;4;1;5
109;27.08.2018;2018;08;22;Maanantai;4;1;5;2;0;2
109;27.08.2018;2018;08;23;Maanantai;1;0;1;0;0;0
109;28.08.2018;2018;08;00;Tiistai;0;0;0;0;2;2
109;28.08.2018;2018;08;01;Tiistai;0;1;1;0;0;0
109;28.08.2018;2018;08;02;Tiistai;0;0;0;0;0;0
109;28.08.2018;2018;08;03;Tiistai;0;1;1;0;0;0
109;28.08.2018;2018;08;04;Tiistai;0;0;0;0;0;0
109;28.08.2018;2018;08;05;Tiistai;5;4;9;2;0;2
109;28.08.2018;2018;08;06;Tiistai;19;9;28;1;0;1
109;28.08.2018;2018;08;07;Tiistai;39;30;69;3;3;6
109;28.08.2018;2018;08;08;Tiistai;27;8;35;1;2;3
109;28.08.2018;2018;08;09;Tiistai;13;4;17;2;6;8
109;28.08.2018;2018;08;10;Tiistai;7;8;15;3;3;6
109;28.08.2018;2018;08;11;Tiistai;10;9;19;5;3;8
109;28.08.2018;2018;08;12;Tiistai;14;10;24;3;0;3
109;28.08.2018;2018;08;13;Tiistai;4;11;15;5;1;6
109;28.08.2018;2018;08;14;Tiistai;15;22;37;1;4;5
109;28.08.2018;2018;08;15;Tiistai;26;23;49;3;4;7
109;28.08.2018;2018;08;16;Tiistai;34;42;76;2;4;6
109;28.08.2018;2018;08;17;Tiistai;17;17;34;7;2;9
109;28.08.2018;2018;08;18;Tiistai;20;16;36;6;8;14
109;28.08.2018;2018;08;19;Tiistai;9;13;22;5;6;11
109;28.08.2018;2018;08;20;Tiistai;8;8;16;11;0;11
109;28.08.2018;2018;08;21;Tiistai;11;6;17;1;2;3
109;28.08.2018;2018;08;22;Tiistai;3;1;4;0;0;0
109;28.08.2018;2018;08;23;Tiistai;0;3;3;3;0;3
109;29.08.2018;2018;08;00;Keskiviikko;1;2;3;0;0;0
109;29.08.2018;2018;08;01;Keskiviikko;0;0;0;0;0;0
109;29.08.2018;2018;08;02;Keskiviikko;0;0;0;0;1;1
109;29.08.2018;2018;08;03;Keskiviikko;2;0;2;0;0;0
109;29.08.2018;2018;08;04;Keskiviikko;1;1;2;0;1;1
109;29.08.2018;2018;08;05;Keskiviikko;3;2;5;2;0;2
109;29.08.2018;2018;08;06;Keskiviikko;20;8;28;3;2;5
109;29.08.2018;2018;08;07;Keskiviikko;31;25;56;7;4;11
109;29.08.2018;2018;08;08;Keskiviikko;32;15;47;4;3;7
109;29.08.2018;2018;08;09;Keskiviikko;17;6;23;3;4;7
109;29.08.2018;2018;08;10;Keskiviikko;11;6;17;5;9;14
109;29.08.2018;2018;08;11;Keskiviikko;9;11;20;3;3;6
109;29.08.2018;2018;08;12;Keskiviikko;12;14;26;4;3;7
109;29.08.2018;2018;08;13;Keskiviikko;12;14;26;2;3;5
109;29.08.2018;2018;08;14;Keskiviikko;15;16;31;4;3;7
109;29.08.2018;2018;08;15;Keskiviikko;22;21;43;1;3;4
109;29.08.2018;2018;08;16;Keskiviikko;30;40;70;8;5;13
109;29.08.2018;2018;08;17;Keskiviikko;26;15;41;2;4;6
109;29.08.2018;2018;08;18;Keskiviikko;21;21;42;4;3;7
109;29.08.2018;2018;08;19;Keskiviikko;16;13;29;7;8;15
109;29.08.2018;2018;08;20;Keskiviikko;21;10;31;9;0;9
109;29.08.2018;2018;08;21;Keskiviikko;9;8;17;1;2;3
109;29.08.2018;2018;08;22;Keskiviikko;3;6;9;2;0;2
109;29.08.2018;2018;08;23;Keskiviikko;0;2;2;0;0;0
109;30.08.2018;2018;08;00;Torstai;0;2;2;2;0;2
109;30.08.2018;2018;08;01;Torstai;1;0;1;0;0;0
109;30.08.2018;2018;08;02;Torstai;0;0;0;0;1;1
109;30.08.2018;2018;08;03;Torstai;0;0;0;0;0;0
109;30.08.2018;2018;08;04;Torstai;2;0;2;0;0;0
109;30.08.2018;2018;08;05;Torstai;3;2;5;2;0;2
109;30.08.2018;2018;08;06;Torstai;22;16;38;0;1;1
109;30.08.2018;2018;08;07;Torstai;36;24;60;4;3;7
109;30.08.2018;2018;08;08;Torstai;29;21;50;11;4;15
109;30.08.2018;2018;08;09;Torstai;10;3;13;2;1;3
109;30.08.2018;2018;08;10;Torstai;4;3;7;1;1;2
109;30.08.2018;2018;08;11;Torstai;10;4;14;2;1;3
109;30.08.2018;2018;08;12;Torstai;14;11;25;3;2;5
109;30.08.2018;2018;08;13;Torstai;9;21;30;3;0;3
109;30.08.2018;2018;08;14;Torstai;13;20;33;4;1;5
109;30.08.2018;2018;08;15;Torstai;25;26;51;3;3;6
109;30.08.2018;2018;08;16;Torstai;23;35;58;7;2;9
109;30.08.2018;2018;08;17;Torstai;9;9;18;6;0;6
109;30.08.2018;2018;08;18;Torstai;17;7;24;11;2;13
109;30.08.2018;2018;08;19;Torstai;5;4;9;3;3;6
109;30.08.2018;2018;08;20;Torstai;10;12;22;4;4;8
109;30.08.2018;2018;08;21;Torstai;11;5;16;1;4;5
109;30.08.2018;2018;08;22;Torstai;6;5;11;6;2;8
109;30.08.2018;2018;08;23;Torstai;3;3;6;0;0;0
109;31.08.2018;2018;08;00;Perjantai;0;0;0;0;0;0
109;31.08.2018;2018;08;01;Perjantai;0;0;0;1;1;2
109;31.08.2018;2018;08;02;Perjantai;0;0;0;0;0;0
109;31.08.2018;2018;08;03;Perjantai;0;0;0;0;0;0
109;31.08.2018;2018;08;04;Perjantai;2;0;2;0;0;0
109;31.08.2018;2018;08;05;Perjantai;4;4;8;3;1;4
109;31.08.2018;2018;08;06;Perjantai;16;11;27;1;1;2
109;31.08.2018;2018;08;07;Perjantai;27;17;44;5;4;9
109;31.08.2018;2018;08;08;Perjantai;19;12;31;1;1;2
109;31.08.2018;2018;08;09;Perjantai;23;6;29;2;3;5
109;31.08.2018;2018;08;10;Perjantai;16;6;22;2;2;4
109;31.08.2018;2018;08;11;Perjantai;7;3;10;3;3;6
109;31.08.2018;2018;08;12;Perjantai;5;13;18;0;1;1
109;31.08.2018;2018;08;13;Perjantai;5;16;21;3;3;6
109;31.08.2018;2018;08;14;Perjantai;20;20;40;0;5;5
109;31.08.2018;2018;08;15;Perjantai;22;32;54;9;4;13
109;31.08.2018;2018;08;16;Perjantai;21;20;41;5;3;8
109;31.08.2018;2018;08;17;Perjantai;11;11;22;3;2;5
109;31.08.2018;2018;08;18;Perjantai;12;12;24;3;2;5
109;31.08.2018;2018;08;19;Perjantai;10;8;18;0;3;3
109;31.08.2018;2018;08;20;Perjantai;9;6;15;1;1;2
109;31.08.2018;2018;08;21;Perjantai;3;5;8;5;2;7
109;31.08.2018;2018;08;22;Perjantai;5;1;6;5;0;5
109;31.08.2018;2018;08;23;Perjantai;2;5;7;0;1;1
109;01.09.2018;2018;09;00;Lauantai;1;5;6;0;0;0
109;01.09.2018;2018;09;01;Lauantai;2;4;6;1;0;1
109;01.09.2018;2018;09;02;Lauantai;0;1;1;0;0;0
109;01.09.2018;2018;09;03;Lauantai;0;0;0;0;0;0
109;01.09.2018;2018;09;04;Lauantai;0;0;0;0;0;0
109;01.09.2018;2018;09;05;Lauantai;1;2;3;0;0;0
109;01.09.2018;2018;09;06;Lauantai;3;2;5;1;1;2
109;01.09.2018;2018;09;07;Lauantai;1;4;5;0;0;0
109;01.09.2018;2018;09;08;Lauantai;3;0;3;4;2;6
109;01.09.2018;2018;09;09;Lauantai;4;5;9;5;3;8
109;01.09.2018;2018;09;10;Lauantai;8;0;8;2;1;3
109;01.09.2018;2018;09;11;Lauantai;11;2;13;6;2;8
109;01.09.2018;2018;09;12;Lauantai;16;8;24;2;3;5
109;01.09.2018;2018;09;13;Lauantai;11;9;20;0;3;3
109;01.09.2018;2018;09;14;Lauantai;13;11;24;2;4;6
109;01.09.2018;2018;09;15;Lauantai;8;5;13;3;3;6
109;01.09.2018;2018;09;16;Lauantai;11;10;21;5;4;9
109;01.09.2018;2018;09;17;Lauantai;6;10;16;3;0;3
109;01.09.2018;2018;09;18;Lauantai;3;6;9;3;1;4
109;01.09.2018;2018;09;19;Lauantai;11;8;19;4;6;10
109;01.09.2018;2018;09;20;Lauantai;5;8;13;0;0;0
109;01.09.2018;2018;09;21;Lauantai;1;8;9;4;1;5
109;01.09.2018;2018;09;22;Lauantai;4;1;5;6;1;7
109;01.09.2018;2018;09;23;Lauantai;0;1;1;2;1;3
109;02.09.2018;2018;09;00;Sunnuntai;1;2;3;0;2;2
109;02.09.2018;2018;09;01;Sunnuntai;2;0;2;1;0;1
109;02.09.2018;2018;09;02;Sunnuntai;0;1;1;2;1;3
109;02.09.2018;2018;09;03;Sunnuntai;2;1;3;0;0;0
109;02.09.2018;2018;09;04;Sunnuntai;1;0;1;0;1;1
109;02.09.2018;2018;09;05;Sunnuntai;0;1;1;0;0;0
109;02.09.2018;2018;09;06;Sunnuntai;5;1;6;0;0;0
109;02.09.2018;2018;09;07;Sunnuntai;0;1;1;2;1;3
109;02.09.2018;2018;09;08;Sunnuntai;4;4;8;4;1;5
109;02.09.2018;2018;09;09;Sunnuntai;5;1;6;2;4;6
109;02.09.2018;2018;09;10;Sunnuntai;4;2;6;3;0;3
109;02.09.2018;2018;09;11;Sunnuntai;5;7;12;2;0;2
109;02.09.2018;2018;09;12;Sunnuntai;17;4;21;6;3;9
109;02.09.2018;2018;09;13;Sunnuntai;9;6;15;4;3;7
109;02.09.2018;2018;09;14;Sunnuntai;13;9;22;5;3;8
109;02.09.2018;2018;09;15;Sunnuntai;8;11;19;3;1;4
109;02.09.2018;2018;09;16;Sunnuntai;3;3;6;5;5;10
109;02.09.2018;2018;09;17;Sunnuntai;13;12;25;4;3;7
109;02.09.2018;2018;09;18;Sunnuntai;10;6;16;1;3;4
109;02.09.2018;2018;09;19;Sunnuntai;8;5;13;4;5;9
109;02.09.2018;2018;09;20;Sunnuntai;5;6;11;5;0;5
109;02.09.2018;2018;09;21;Sunnuntai;5;1;6;0;0;0
109;02.09.2018;2018;09;22;Sunnuntai;1;3;4;1;1;2
109;02.09.2018;2018;09;23;Sunnuntai;1;1;2;0;0;0
109;03.09.2018;2018;09;00;Maanantai;0;1;1;2;0;2
109;03.09.2018;2018;09;01;Maanantai;0;1;1;2;3;5
109;03.09.2018;2018;09;02;Maanantai;0;0;0;0;0;0
109;03.09.2018;2018;09;03;Maanantai;0;0;0;0;0;0
109;03.09.2018;2018;09;04;Maanantai;1;1;2;0;0;0
109;03.09.2018;2018;09;05;Maanantai;3;1;4;2;0;2
109;03.09.2018;2018;09;06;Maanantai;11;10;21;0;0;0
109;03.09.2018;2018;09;07;Maanantai;41;21;62;3;0;3
109;03.09.2018;2018;09;08;Maanantai;34;19;53;6;4;10
109;03.09.2018;2018;09;09;Maanantai;18;9;27;3;5;8
109;03.09.2018;2018;09;10;Maanantai;9;2;11;7;5;12
109;03.09.2018;2018;09;11;Maanantai;10;10;20;1;4;5
109;03.09.2018;2018;09;12;Maanantai;11;3;14;2;0;2
109;03.09.2018;2018;09;13;Maanantai;10;11;21;4;1;5
109;03.09.2018;2018;09;14;Maanantai;10;28;38;6;4;10
109;03.09.2018;2018;09;15;Maanantai;21;38;59;2;2;4
109;03.09.2018;2018;09;16;Maanantai;28;45;73;1;2;3
109;03.09.2018;2018;09;17;Maanantai;19;17;36;5;2;7
109;03.09.2018;2018;09;18;Maanantai;11;15;26;5;4;9
109;03.09.2018;2018;09;19;Maanantai;10;5;15;3;5;8
109;03.09.2018;2018;09;20;Maanantai;4;7;11;3;4;7
109;03.09.2018;2018;09;21;Maanantai;2;6;8;3;2;5
109;03.09.2018;2018;09;22;Maanantai;4;4;8;1;1;2
109;03.09.2018;2018;09;23;Maanantai;0;1;1;2;2;4
109;04.09.2018;2018;09;00;Tiistai;1;0;1;1;0;1
109;04.09.2018;2018;09;01;Tiistai;0;0;0;0;0;0
109;04.09.2018;2018;09;02;Tiistai;0;0;0;1;1;2
109;04.09.2018;2018;09;03;Tiistai;0;0;0;0;0;0
109;04.09.2018;2018;09;04;Tiistai;1;0;1;0;0;0
109;04.09.2018;2018;09;05;Tiistai;1;5;6;3;0;3
109;04.09.2018;2018;09;06;Tiistai;21;6;27;1;2;3
109;04.09.2018;2018;09;07;Tiistai;35;30;65;2;1;3
109;04.09.2018;2018;09;08;Tiistai;36;15;51;3;4;7
109;04.09.2018;2018;09;09;Tiistai;19;14;33;4;3;7
109;04.09.2018;2018;09;10;Tiistai;14;6;20;3;3;6
109;04.09.2018;2018;09;11;Tiistai;10;5;15;3;3;6
109;04.09.2018;2018;09;12;Tiistai;14;10;24;6;6;12
109;04.09.2018;2018;09;13;Tiistai;13;9;22;6;5;11
109;04.09.2018;2018;09;14;Tiistai;24;19;43;6;1;7
109;04.09.2018;2018;09;15;Tiistai;19;28;47;5;1;6
109;04.09.2018;2018;09;16;Tiistai;27;42;69;3;3;6
109;04.09.2018;2018;09;17;Tiistai;16;19;35;3;2;5
109;04.09.2018;2018;09;18;Tiistai;14;15;29;3;3;6
109;04.09.2018;2018;09;19;Tiistai;5;12;17;3;2;5
109;04.09.2018;2018;09;20;Tiistai;7;6;13;3;2;5
109;04.09.2018;2018;09;21;Tiistai;7;8;15;1;0;1
109;04.09.2018;2018;09;22;Tiistai;4;0;4;2;1;3
109;04.09.2018;2018;09;23;Tiistai;1;0;1;1;0;1
109;05.09.2018;2018;09;00;Keskiviikko;1;1;2;0;2;2
109;05.09.2018;2018;09;01;Keskiviikko;1;0;1;0;1;1
109;05.09.2018;2018;09;02;Keskiviikko;0;1;1;0;0;0
109;05.09.2018;2018;09;03;Keskiviikko;0;0;0;0;0;0
109;05.09.2018;2018;09;04;Keskiviikko;1;0;1;0;0;0
109;05.09.2018;2018;09;05;Keskiviikko;1;1;2;2;0;2
109;05.09.2018;2018;09;06;Keskiviikko;17;9;26;2;2;4
109;05.09.2018;2018;09;07;Keskiviikko;40;20;60;9;5;14
109;05.09.2018;2018;09;08;Keskiviikko;47;32;79;5;3;8
109;05.09.2018;2018;09;09;Keskiviikko;16;11;27;3;0;3
109;05.09.2018;2018;09;10;Keskiviikko;5;2;7;1;2;3
109;05.09.2018;2018;09;11;Keskiviikko;17;4;21;3;3;6
109;05.09.2018;2018;09;12;Keskiviikko;7;5;12;4;4;8
109;05.09.2018;2018;09;13;Keskiviikko;9;15;24;1;5;6
109;05.09.2018;2018;09;14;Keskiviikko;7;16;23;4;2;6
109;05.09.2018;2018;09;15;Keskiviikko;16;43;59;6;7;13
109;05.09.2018;2018;09;16;Keskiviikko;27;38;65;2;3;5
109;05.09.2018;2018;09;17;Keskiviikko;24;18;42;7;3;10
109;05.09.2018;2018;09;18;Keskiviikko;10;11;21;5;4;9
109;05.09.2018;2018;09;19;Keskiviikko;10;20;30;4;5;9
109;05.09.2018;2018;09;20;Keskiviikko;8;9;17;3;2;5
109;05.09.2018;2018;09;21;Keskiviikko;6;11;17;4;2;6
109;05.09.2018;2018;09;22;Keskiviikko;3;2;5;1;1;2
109;05.09.2018;2018;09;23;Keskiviikko;3;2;5;1;0;1
109;06.09.2018;2018;09;00;Torstai;2;2;4;0;1;1
109;06.09.2018;2018;09;01;Torstai;0;1;1;0;1;1
109;06.09.2018;2018;09;02;Torstai;1;0;1;1;0;1
109;06.09.2018;2018;09;03;Torstai;0;0;0;0;0;0
109;06.09.2018;2018;09;04;Torstai;1;0;1;0;0;0
109;06.09.2018;2018;09;05;Torstai;1;1;2;3;0;3
109;06.09.2018;2018;09;06;Torstai;10;5;15;2;0;2
109;06.09.2018;2018;09;07;Torstai;30;27;57;2;0;2
109;06.09.2018;2018;09;08;Torstai;40;15;55;4;2;6
109;06.09.2018;2018;09;09;Torstai;15;7;22;3;4;7
109;06.09.2018;2018;09;10;Torstai;13;5;18;0;1;1
109;06.09.2018;2018;09;11;Torstai;6;6;12;1;5;6
109;06.09.2018;2018;09;12;Torstai;8;7;15;1;2;3
109;06.09.2018;2018;09;13;Torstai;8;9;17;3;2;5
109;06.09.2018;2018;09;14;Torstai;9;17;26;3;4;7
109;06.09.2018;2018;09;15;Torstai;19;25;44;5;9;14
109;06.09.2018;2018;09;16;Torstai;30;40;70;5;0;5
109;06.09.2018;2018;09;17;Torstai;21;16;37;6;2;8
109;06.09.2018;2018;09;18;Torstai;17;13;30;12;4;16
109;06.09.2018;2018;09;19;Torstai;15;13;28;2;8;10
109;06.09.2018;2018;09;20;Torstai;9;6;15;1;5;6
109;06.09.2018;2018;09;21;Torstai;4;6;10;2;2;4
109;06.09.2018;2018;09;22;Torstai;2;1;3;3;2;5
109;06.09.2018;2018;09;23;Torstai;0;2;2;1;0;1
109;07.09.2018;2018;09;00;Perjantai;4;3;7;0;1;1
109;07.09.2018;2018;09;01;Perjantai;0;0;0;0;0;0
109;07.09.2018;2018;09;02;Perjantai;2;1;3;1;1;2
109;07.09.2018;2018;09;03;Perjantai;0;0;0;0;0;0
109;07.09.2018;2018;09;04;Perjantai;2;0;2;0;0;0
109;07.09.2018;2018;09;05;Perjantai;2;3;5;2;1;3
109;07.09.2018;2018;09;06;Perjantai;11;7;18;1;0;1
109;07.09.2018;2018;09;07;Perjantai;28;29;57;1;1;2
109;07.09.2018;2018;09;08;Perjantai;18;14;32;1;3;4
109;07.09.2018;2018;09;09;Perjantai;19;9;28;4;1;5
109;07.09.2018;2018;09;10;Perjantai;9;5;14;2;5;7
109;07.09.2018;2018;09;11;Perjantai;11;4;15;4;0;4
109;07.09.2018;2018;09;12;Perjantai;11;12;23;1;2;3
109;07.09.2018;2018;09;13;Perjantai;14;12;26;0;1;1
109;07.09.2018;2018;09;14;Perjantai;15;16;31;3;4;7
109;07.09.2018;2018;09;15;Perjantai;17;26;43;4;2;6
109;07.09.2018;2018;09;16;Perjantai;21;26;47;0;1;1
109;07.09.2018;2018;09;17;Perjantai;16;12;28;6;2;8
109;07.09.2018;2018;09;18;Perjantai;14;4;18;2;4;6
109;07.09.2018;2018;09;19;Perjantai;8;12;20;3;2;5
109;07.09.2018;2018;09;20;Perjantai;3;5;8;2;2;4
109;07.09.2018;2018;09;21;Perjantai;5;6;11;2;2;4
109;07.09.2018;2018;09;22;Perjantai;5;2;7;3;0;3
109;07.09.2018;2018;09;23;Perjantai;6;3;9;0;0;0
109;08.09.2018;2018;09;00;Lauantai;1;4;5;0;2;2
109;08.09.2018;2018;09;01;Lauantai;2;1;3;0;0;0
109;08.09.2018;2018;09;02;Lauantai;1;1;2;0;0;0
109;08.09.2018;2018;09;03;Lauantai;0;1;1;0;0;0
109;08.09.2018;2018;09;04;Lauantai;0;0;0;0;1;1
109;08.09.2018;2018;09;05;Lauantai;1;3;4;1;0;1
109;08.09.2018;2018;09;06;Lauantai;4;1;5;1;1;2
109;08.09.2018;2018;09;07;Lauantai;2;0;2;0;1;1
109;08.09.2018;2018;09;08;Lauantai;1;1;2;2;1;3
109;08.09.2018;2018;09;09;Lauantai;7;2;9;0;4;4
109;08.09.2018;2018;09;10;Lauantai;8;9;17;6;5;11
109;08.09.2018;2018;09;11;Lauantai;5;10;15;4;3;7
109;08.09.2018;2018;09;12;Lauantai;6;7;13;4;1;5
109;08.09.2018;2018;09;13;Lauantai;11;12;23;1;3;4
109;08.09.2018;2018;09;14;Lauantai;9;4;13;5;3;8
109;08.09.2018;2018;09;15;Lauantai;8;7;15;1;1;2
109;08.09.2018;2018;09;16;Lauantai;15;11;26;3;1;4
109;08.09.2018;2018;09;17;Lauantai;2;8;10;1;1;2
109;08.09.2018;2018;09;18;Lauantai;12;15;27;2;1;3
109;08.09.2018;2018;09;19;Lauantai;4;13;17;5;1;6
109;08.09.2018;2018;09;20;Lauantai;5;4;9;1;1;2
109;08.09.2018;2018;09;21;Lauantai;6;3;9;0;0;0
109;08.09.2018;2018;09;22;Lauantai;2;1;3;2;0;2
109;08.09.2018;2018;09;23;Lauantai;6;1;7;2;2;4
109;09.09.2018;2018;09;00;Sunnuntai;2;0;2;1;1;2
109;09.09.2018;2018;09;01;Sunnuntai;0;1;1;0;0;0
109;09.09.2018;2018;09;02;Sunnuntai;4;1;5;0;0;0
109;09.09.2018;2018;09;03;Sunnuntai;2;0;2;2;0;2
109;09.09.2018;2018;09;04;Sunnuntai;1;0;1;0;1;1
109;09.09.2018;2018;09;05;Sunnuntai;1;1;2;0;0;0
109;09.09.2018;2018;09;06;Sunnuntai;3;4;7;0;0;0
109;09.09.2018;2018;09;07;Sunnuntai;0;1;1;1;0;1
109;09.09.2018;2018;09;08;Sunnuntai;1;0;1;1;0;1
109;09.09.2018;2018;09;09;Sunnuntai;4;0;4;0;2;2
109;09.09.2018;2018;09;10;Sunnuntai;3;7;10;3;5;8
109;09.09.2018;2018;09;11;Sunnuntai;2;3;5;1;0;1
109;09.09.2018;2018;09;12;Sunnuntai;13;5;18;3;1;4
109;09.09.2018;2018;09;13;Sunnuntai;10;11;21;4;4;8
109;09.09.2018;2018;09;14;Sunnuntai;19;7;26;5;2;7
109;09.09.2018;2018;09;15;Sunnuntai;12;4;16;1;6;7
109;09.09.2018;2018;09;16;Sunnuntai;8;8;16;4;1;5
109;09.09.2018;2018;09;17;Sunnuntai;9;6;15;5;3;8
109;09.09.2018;2018;09;18;Sunnuntai;9;10;19;6;5;11
109;09.09.2018;2018;09;19;Sunnuntai;12;8;20;6;8;14
109;09.09.2018;2018;09;20;Sunnuntai;3;5;8;2;2;4
109;09.09.2018;2018;09;21;Sunnuntai;2;4;6;2;0;2
109;09.09.2018;2018;09;22;Sunnuntai;1;1;2;2;1;3
109;09.09.2018;2018;09;23;Sunnuntai;6;1;7;0;0;0
109;10.09.2018;2018;09;00;Maanantai;0;0;0;1;1;2
109;10.09.2018;2018;09;01;Maanantai;0;2;2;1;1;2
109;10.09.2018;2018;09;02;Maanantai;0;0;0;0;2;2
109;10.09.2018;2018;09;03;Maanantai;0;0;0;1;0;1
109;10.09.2018;2018;09;04;Maanantai;0;1;1;0;0;0
109;10.09.2018;2018;09;05;Maanantai;5;2;7;2;0;2
109;10.09.2018;2018;09;06;Maanantai;20;7;27;1;0;1
109;10.09.2018;2018;09;07;Maanantai;40;26;66;2;2;4
109;10.09.2018;2018;09;08;Maanantai;35;15;50;0;2;2
109;10.09.2018;2018;09;09;Maanantai;29;5;34;0;2;2
109;10.09.2018;2018;09;10;Maanantai;6;7;13;3;1;4
109;10.09.2018;2018;09;11;Maanantai;12;3;15;0;2;2
109;10.09.2018;2018;09;12;Maanantai;7;4;11;5;3;8
109;10.09.2018;2018;09;13;Maanantai;12;16;28;0;2;2
109;10.09.2018;2018;09;14;Maanantai;19;25;44;6;2;8
109;10.09.2018;2018;09;15;Maanantai;12;45;57;5;1;6
109;10.09.2018;2018;09;16;Maanantai;27;42;69;2;4;6
109;10.09.2018;2018;09;17;Maanantai;24;16;40;3;1;4
109;10.09.2018;2018;09;18;Maanantai;14;11;25;6;4;10
109;10.09.2018;2018;09;19;Maanantai;6;15;21;7;7;14
109;10.09.2018;2018;09;20;Maanantai;11;5;16;3;2;5
109;10.09.2018;2018;09;21;Maanantai;3;5;8;1;1;2
109;10.09.2018;2018;09;22;Maanantai;6;3;9;3;1;4
109;10.09.2018;2018;09;23;Maanantai;1;1;2;1;0;1
109;11.09.2018;2018;09;00;Tiistai;0;1;1;1;2;3
109;11.09.2018;2018;09;01;Tiistai;0;0;0;0;2;2
109;11.09.2018;2018;09;02;Tiistai;1;0;1;0;0;0
109;11.09.2018;2018;09;03;Tiistai;0;0;0;0;0;0
109;11.09.2018;2018;09;04;Tiistai;0;0;0;0;0;0
109;11.09.2018;2018;09;05;Tiistai;3;2;5;2;0;2
109;11.09.2018;2018;09;06;Tiistai;18;7;25;2;0;2
109;11.09.2018;2018;09;07;Tiistai;30;21;51;2;5;7
109;11.09.2018;2018;09;08;Tiistai;37;10;47;2;1;3
109;11.09.2018;2018;09;09;Tiistai;16;7;23;3;2;5
109;11.09.2018;2018;09;10;Tiistai;5;7;12;0;3;3
109;11.09.2018;2018;09;11;Tiistai;7;4;11;3;1;4
109;11.09.2018;2018;09;12;Tiistai;5;7;12;0;1;1
109;11.09.2018;2018;09;13;Tiistai;8;11;19;1;1;2
109;11.09.2018;2018;09;14;Tiistai;10;21;31;5;1;6
109;11.09.2018;2018;09;15;Tiistai;14;28;42;3;3;6
109;11.09.2018;2018;09;16;Tiistai;21;38;59;1;4;5
109;11.09.2018;2018;09;17;Tiistai;10;5;15;2;2;4
109;11.09.2018;2018;09;18;Tiistai;8;6;14;3;0;3
109;11.09.2018;2018;09;19;Tiistai;6;5;11;3;2;5
109;11.09.2018;2018;09;20;Tiistai;0;2;2;9;6;15
109;11.09.2018;2018;09;21;Tiistai;3;3;6;2;1;3
109;11.09.2018;2018;09;22;Tiistai;6;1;7;0;0;0
109;11.09.2018;2018;09;23;Tiistai;1;0;1;1;0;1
109;12.09.2018;2018;09;00;Keskiviikko;0;1;1;0;0;0
109;12.09.2018;2018;09;01;Keskiviikko;0;0;0;0;1;1
109;12.09.2018;2018;09;02;Keskiviikko;0;0;0;0;1;1
109;12.09.2018;2018;09;03;Keskiviikko;0;0;0;0;0;0
109;12.09.2018;2018;09;04;Keskiviikko;0;0;0;0;0;0
109;12.09.2018;2018;09;05;Keskiviikko;3;2;5;1;1;2
109;12.09.2018;2018;09;06;Keskiviikko;11;4;15;0;0;0
109;12.09.2018;2018;09;07;Keskiviikko;25;15;40;3;4;7
109;12.09.2018;2018;09;08;Keskiviikko;20;9;29;3;4;7
109;12.09.2018;2018;09;09;Keskiviikko;11;7;18;2;2;4
109;12.09.2018;2018;09;10;Keskiviikko;5;4;9;1;3;4
109;12.09.2018;2018;09;11;Keskiviikko;4;2;6;0;1;1
109;12.09.2018;2018;09;12;Keskiviikko;12;9;21;0;1;1
109;12.09.2018;2018;09;13;Keskiviikko;9;5;14;2;0;2
109;12.09.2018;2018;09;14;Keskiviikko;15;9;24;0;0;0
109;12.09.2018;2018;09;15;Keskiviikko;18;15;33;4;1;5
109;12.09.2018;2018;09;16;Keskiviikko;19;18;37;3;1;4
109;12.09.2018;2018;09;17;Keskiviikko;17;9;26;4;1;5
109;12.09.2018;2018;09;18;Keskiviikko;3;6;9;2;0;2
109;12.09.2018;2018;09;19;Keskiviikko;11;7;18;3;3;6
109;12.09.2018;2018;09;20;Keskiviikko;7;9;16;2;1;3
109;12.09.2018;2018;09;21;Keskiviikko;5;3;8;2;0;2
109;12.09.2018;2018;09;22;Keskiviikko;6;2;8;1;2;3
109;12.09.2018;2018;09;23;Keskiviikko;1;5;6;1;0;1
109;13.09.2018;2018;09;00;Torstai;1;3;4;0;1;1
109;13.09.2018;2018;09;01;Torstai;0;0;0;0;1;1
109;13.09.2018;2018;09;02;Torstai;0;0;0;0;0;0
109;13.09.2018;2018;09;03;Torstai;0;0;0;0;0;0
109;13.09.2018;2018;09;04;Torstai;0;1;1;0;0;0
109;13.09.2018;2018;09;05;Torstai;2;1;3;3;0;3
109;13.09.2018;2018;09;06;Torstai;10;12;22;1;0;1
109;13.09.2018;2018;09;07;Torstai;30;13;43;0;1;1
109;13.09.2018;2018;09;08;Torstai;44;13;57;3;2;5
109;13.09.2018;2018;09;09;Torstai;14;12;26;0;1;1
109;13.09.2018;2018;09;10;Torstai;4;3;7;1;1;2
109;13.09.2018;2018;09;11;Torstai;7;8;15;1;1;2
109;13.09.2018;2018;09;12;Torstai;11;9;20;3;2;5
109;13.09.2018;2018;09;13;Torstai;5;17;22;2;1;3
109;13.09.2018;2018;09;14;Torstai;13;19;32;1;4;5
109;13.09.2018;2018;09;15;Torstai;13;24;37;1;3;4
109;13.09.2018;2018;09;16;Torstai;19;37;56;4;4;8
109;13.09.2018;2018;09;17;Torstai;21;16;37;4;0;4
109;13.09.2018;2018;09;18;Torstai;16;14;30;5;3;8
109;13.09.2018;2018;09;19;Torstai;14;14;28;2;4;6
109;13.09.2018;2018;09;20;Torstai;8;12;20;1;4;5
109;13.09.2018;2018;09;21;Torstai;6;7;13;5;1;6
109;13.09.2018;2018;09;22;Torstai;4;4;8;1;1;2
109;13.09.2018;2018;09;23;Torstai;0;1;1;2;1;3
109;14.09.2018;2018;09;00;Perjantai;0;0;0;0;1;1
109;14.09.2018;2018;09;01;Perjantai;0;1;1;0;0;0
109;14.09.2018;2018;09;02;Perjantai;0;0;0;0;0;0
109;14.09.2018;2018;09;03;Perjantai;0;0;0;1;1;2
109;14.09.2018;2018;09;04;Perjantai;0;0;0;0;0;0
109;14.09.2018;2018;09;05;Perjantai;2;3;5;1;0;1
109;14.09.2018;2018;09;06;Perjantai;16;5;21;1;0;1
109;14.09.2018;2018;09;07;Perjantai;31;13;44;4;2;6
109;14.09.2018;2018;09;08;Perjantai;25;14;39;4;3;7
109;14.09.2018;2018;09;09;Perjantai;12;3;15;2;1;3
109;14.09.2018;2018;09;10;Perjantai;8;5;13;2;2;4
109;14.09.2018;2018;09;11;Perjantai;9;6;15;2;2;4
109;14.09.2018;2018;09;12;Perjantai;7;7;14;2;1;3
109;14.09.2018;2018;09;13;Perjantai;13;16;29;8;3;11
109;14.09.2018;2018;09;14;Perjantai;12;16;28;4;6;10
109;14.09.2018;2018;09;15;Perjantai;15;27;42;5;3;8
109;14.09.2018;2018;09;16;Perjantai;15;22;37;3;2;5
109;14.09.2018;2018;09;17;Perjantai;5;8;13;3;3;6
109;14.09.2018;2018;09;18;Perjantai;4;10;14;2;1;3
109;14.09.2018;2018;09;19;Perjantai;6;5;11;6;4;10
109;14.09.2018;2018;09;20;Perjantai;4;5;9;2;3;5
109;14.09.2018;2018;09;21;Perjantai;3;4;7;1;1;2
109;14.09.2018;2018;09;22;Perjantai;5;2;7;4;5;9
109;14.09.2018;2018;09;23;Perjantai;1;0;1;1;1;2
109;15.09.2018;2018;09;00;Lauantai;2;1;3;0;0;0
109;15.09.2018;2018;09;01;Lauantai;0;0;0;1;1;2
109;15.09.2018;2018;09;02;Lauantai;0;3;3;0;0;0
109;15.09.2018;2018;09;03;Lauantai;0;0;0;0;0;0
109;15.09.2018;2018;09;04;Lauantai;0;2;2;0;1;1
109;15.09.2018;2018;09;05;Lauantai;1;1;2;0;0;0
109;15.09.2018;2018;09;06;Lauantai;6;1;7;2;1;3
109;15.09.2018;2018;09;07;Lauantai;2;1;3;0;2;2
109;15.09.2018;2018;09;08;Lauantai;3;2;5;3;1;4
109;15.09.2018;2018;09;09;Lauantai;3;4;7;4;1;5
109;15.09.2018;2018;09;10;Lauantai;3;3;6;3;6;9
109;15.09.2018;2018;09;11;Lauantai;3;11;14;8;5;13
109;15.09.2018;2018;09;12;Lauantai;6;7;13;3;3;6
109;15.09.2018;2018;09;13;Lauantai;1;5;6;0;1;1
109;15.09.2018;2018;09;14;Lauantai;5;4;9;1;2;3
109;15.09.2018;2018;09;15;Lauantai;4;6;10;0;2;2
109;15.09.2018;2018;09;16;Lauantai;6;6;12;3;3;6
109;15.09.2018;2018;09;17;Lauantai;14;0;14;0;0;0
109;15.09.2018;2018;09;18;Lauantai;8;3;11;6;2;8
109;15.09.2018;2018;09;19;Lauantai;4;4;8;2;3;5
109;15.09.2018;2018;09;20;Lauantai;1;1;2;2;1;3
109;15.09.2018;2018;09;21;Lauantai;4;1;5;3;1;4
109;15.09.2018;2018;09;22;Lauantai;1;2;3;2;1;3
109;15.09.2018;2018;09;23;Lauantai;1;0;1;0;1;1
109;16.09.2018;2018;09;00;Sunnuntai;0;1;1;1;2;3
109;16.09.2018;2018;09;01;Sunnuntai;0;0;0;0;0;0
109;16.09.2018;2018;09;02;Sunnuntai;0;1;1;0;1;1
109;16.09.2018;2018;09;03;Sunnuntai;0;1;1;0;0;0
109;16.09.2018;2018;09;04;Sunnuntai;0;1;1;1;1;2
109;16.09.2018;2018;09;05;Sunnuntai;1;3;4;0;0;0
109;16.09.2018;2018;09;06;Sunnuntai;4;0;4;0;0;0
109;16.09.2018;2018;09;07;Sunnuntai;0;3;3;0;2;2
109;16.09.2018;2018;09;08;Sunnuntai;1;1;2;3;1;4
109;16.09.2018;2018;09;09;Sunnuntai;4;3;7;4;3;7
109;16.09.2018;2018;09;10;Sunnuntai;10;5;15;5;3;8
109;16.09.2018;2018;09;11;Sunnuntai;5;3;8;6;3;9
109;16.09.2018;2018;09;12;Sunnuntai;9;8;17;4;2;6
109;16.09.2018;2018;09;13;Sunnuntai;4;3;7;2;5;7
109;16.09.2018;2018;09;14;Sunnuntai;12;6;18;3;3;6
109;16.09.2018;2018;09;15;Sunnuntai;10;6;16;11;4;15
109;16.09.2018;2018;09;16;Sunnuntai;5;8;13;4;5;9
109;16.09.2018;2018;09;17;Sunnuntai;10;5;15;4;1;5
109;16.09.2018;2018;09;18;Sunnuntai;11;11;22;5;6;11
109;16.09.2018;2018;09;19;Sunnuntai;10;3;13;3;4;7
109;16.09.2018;2018;09;20;Sunnuntai;3;2;5;0;1;1
109;16.09.2018;2018;09;21;Sunnuntai;0;5;5;1;0;1
109;16.09.2018;2018;09;22;Sunnuntai;0;4;4;3;0;3
109;16.09.2018;2018;09;23;Sunnuntai;2;1;3;1;1;2
109;17.09.2018;2018;09;00;Maanantai;0;0;0;1;1;2
109;17.09.2018;2018;09;01;Maanantai;0;1;1;1;1;2
109;17.09.2018;2018;09;02;Maanantai;0;0;0;0;0;0
109;17.09.2018;2018;09;03;Maanantai;0;1;1;0;0;0
109;17.09.2018;2018;09;04;Maanantai;0;0;0;0;0;0
109;17.09.2018;2018;09;05;Maanantai;1;1;2;2;0;2
109;17.09.2018;2018;09;06;Maanantai;18;7;25;1;0;1
109;17.09.2018;2018;09;07;Maanantai;29;15;44;1;2;3
109;17.09.2018;2018;09;08;Maanantai;35;17;52;2;3;5
109;17.09.2018;2018;09;09;Maanantai;20;9;29;6;5;11
109;17.09.2018;2018;09;10;Maanantai;7;3;10;4;2;6
109;17.09.2018;2018;09;11;Maanantai;5;5;10;6;5;11
109;17.09.2018;2018;09;12;Maanantai;10;6;16;1;1;2
109;17.09.2018;2018;09;13;Maanantai;13;4;17;1;1;2
109;17.09.2018;2018;09;14;Maanantai;9;18;27;1;1;2
109;17.09.2018;2018;09;15;Maanantai;23;27;50;7;8;15
109;17.09.2018;2018;09;16;Maanantai;27;26;53;4;2;6
109;17.09.2018;2018;09;17;Maanantai;19;18;37;1;1;2
109;17.09.2018;2018;09;18;Maanantai;8;9;17;10;4;14
109;17.09.2018;2018;09;19;Maanantai;4;10;14;8;4;12
109;17.09.2018;2018;09;20;Maanantai;5;6;11;3;2;5
109;17.09.2018;2018;09;21;Maanantai;2;6;8;3;2;5
109;17.09.2018;2018;09;22;Maanantai;2;2;4;1;0;1
109;17.09.2018;2018;09;23;Maanantai;0;1;1;1;0;1
109;18.09.2018;2018;09;00;Tiistai;0;0;0;0;0;0
109;18.09.2018;2018;09;01;Tiistai;0;0;0;0;1;1
109;18.09.2018;2018;09;02;Tiistai;0;0;0;0;0;0
109;18.09.2018;2018;09;03;Tiistai;0;0;0;0;0;0
109;18.09.2018;2018;09;04;Tiistai;0;0;0;0;0;0
109;18.09.2018;2018;09;05;Tiistai;1;2;3;2;0;2
109;18.09.2018;2018;09;06;Tiistai;18;8;26;4;2;6
109;18.09.2018;2018;09;07;Tiistai;39;22;61;2;1;3
109;18.09.2018;2018;09;08;Tiistai;41;18;59;5;5;10
109;18.09.2018;2018;09;09;Tiistai;15;7;22;2;7;9
109;18.09.2018;2018;09;10;Tiistai;12;10;22;12;9;21
109;18.09.2018;2018;09;11;Tiistai;7;4;11;4;2;6
109;18.09.2018;2018;09;12;Tiistai;10;9;19;4;3;7
109;18.09.2018;2018;09;13;Tiistai;10;7;17;2;1;3
109;18.09.2018;2018;09;14;Tiistai;11;16;27;8;0;8
109;18.09.2018;2018;09;15;Tiistai;23;27;50;4;1;5
109;18.09.2018;2018;09;16;Tiistai;29;36;65;9;2;11
109;18.09.2018;2018;09;17;Tiistai;17;20;37;3;10;13
109;18.09.2018;2018;09;18;Tiistai;12;8;20;3;3;6
109;18.09.2018;2018;09;19;Tiistai;12;8;20;5;4;9
109;18.09.2018;2018;09;20;Tiistai;12;6;18;7;1;8
109;18.09.2018;2018;09;21;Tiistai;4;7;11;3;0;3
109;18.09.2018;2018;09;22;Tiistai;4;3;7;1;1;2
109;18.09.2018;2018;09;23;Tiistai;0;1;1;0;0;0
109;19.09.2018;2018;09;00;Keskiviikko;0;1;1;0;0;0
109;19.09.2018;2018;09;01;Keskiviikko;0;1;1;0;0;0
109;19.09.2018;2018;09;02;Keskiviikko;0;0;0;0;0;0
109;19.09.2018;2018;09;03;Keskiviikko;0;0;0;0;0;0
109;19.09.2018;2018;09;04;Keskiviikko;0;0;0;0;0;0
109;19.09.2018;2018;09;05;Keskiviikko;2;2;4;2;0;2
109;19.09.2018;2018;09;06;Keskiviikko;14;8;22;0;0;0
109;19.09.2018;2018;09;07;Keskiviikko;37;19;56;1;3;4
109;19.09.2018;2018;09;08;Keskiviikko;26;12;38;4;3;7
109;19.09.2018;2018;09;09;Keskiviikko;14;9;23;1;6;7
109;19.09.2018;2018;09;10;Keskiviikko;3;0;3;2;1;3
109;19.09.2018;2018;09;11;Keskiviikko;10;5;15;2;2;4
109;19.09.2018;2018;09;12;Keskiviikko;7;3;10;6;2;8
109;19.09.2018;2018;09;13;Keskiviikko;6;5;11;4;1;5
109;19.09.2018;2018;09;14;Keskiviikko;5;11;16;2;1;3
109;19.09.2018;2018;09;15;Keskiviikko;13;28;41;7;3;10
109;19.09.2018;2018;09;16;Keskiviikko;22;37;59;5;4;9
109;19.09.2018;2018;09;17;Keskiviikko;24;8;32;3;1;4
109;19.09.2018;2018;09;18;Keskiviikko;13;8;21;3;1;4
109;19.09.2018;2018;09;19;Keskiviikko;6;7;13;2;0;2
109;19.09.2018;2018;09;20;Keskiviikko;7;10;17;2;0;2
109;19.09.2018;2018;09;21;Keskiviikko;1;7;8;2;1;3
109;19.09.2018;2018;09;22;Keskiviikko;3;3;6;0;1;1
109;19.09.2018;2018;09;23;Keskiviikko;0;0;0;0;1;1
109;20.09.2018;2018;09;00;Torstai;0;1;1;0;1;1
109;20.09.2018;2018;09;01;Torstai;0;1;1;0;0;0
109;20.09.2018;2018;09;02;Torstai;0;0;0;0;0;0
109;20.09.2018;2018;09;03;Torstai;0;0;0;2;0;2
109;20.09.2018;2018;09;04;Torstai;1;0;1;0;0;0
109;20.09.2018;2018;09;05;Torstai;2;5;7;2;0;2
109;20.09.2018;2018;09;06;Torstai;14;7;21;2;2;4
109;20.09.2018;2018;09;07;Torstai;40;21;61;1;1;2
109;20.09.2018;2018;09;08;Torstai;29;16;45;4;1;5
109;20.09.2018;2018;09;09;Torstai;13;5;18;1;7;8
109;20.09.2018;2018;09;10;Torstai;7;1;8;6;16;22
109;20.09.2018;2018;09;11;Torstai;7;5;12;2;1;3
109;20.09.2018;2018;09;12;Torstai;9;7;16;2;0;2
109;20.09.2018;2018;09;13;Torstai;2;12;14;12;6;18
109;20.09.2018;2018;09;14;Torstai;8;11;19;2;2;4
109;20.09.2018;2018;09;15;Torstai;12;17;29;3;2;5
109;20.09.2018;2018;09;16;Torstai;21;26;47;5;3;8
109;20.09.2018;2018;09;17;Torstai;23;17;40;4;2;6
109;20.09.2018;2018;09;18;Torstai;19;12;31;3;2;5
109;20.09.2018;2018;09;19;Torstai;7;11;18;3;3;6
109;20.09.2018;2018;09;20;Torstai;5;10;15;5;2;7
109;20.09.2018;2018;09;21;Torstai;5;4;9;0;1;1
109;20.09.2018;2018;09;22;Torstai;3;3;6;0;2;2
109;20.09.2018;2018;09;23;Torstai;0;2;2;0;0;0
109;21.09.2018;2018;09;00;Perjantai;4;6;10;10;6;16
109;21.09.2018;2018;09;01;Perjantai;2;0;2;3;0;3
109;21.09.2018;2018;09;02;Perjantai;1;2;3;0;5;5
109;21.09.2018;2018;09;03;Perjantai;2;1;3;1;2;3
109;21.09.2018;2018;09;04;Perjantai;0;0;0;0;0;0
109;21.09.2018;2018;09;05;Perjantai;3;3;6;3;0;3
109;21.09.2018;2018;09;06;Perjantai;12;3;15;0;1;1
109;21.09.2018;2018;09;07;Perjantai;35;20;55;8;6;14
109;21.09.2018;2018;09;08;Perjantai;27;14;41;7;3;10
109;21.09.2018;2018;09;09;Perjantai;14;10;24;4;2;6
109;21.09.2018;2018;09;10;Perjantai;10;3;13;2;1;3
109;21.09.2018;2018;09;11;Perjantai;14;6;20;4;3;7
109;21.09.2018;2018;09;12;Perjantai;12;9;21;1;1;2
109;21.09.2018;2018;09;13;Perjantai;13;15;28;2;1;3
109;21.09.2018;2018;09;14;Perjantai;11;27;38;5;1;6
109;21.09.2018;2018;09;15;Perjantai;17;21;38;6;7;13
109;21.09.2018;2018;09;16;Perjantai;19;25;44;4;3;7
109;21.09.2018;2018;09;17;Perjantai;4;13;17;3;5;8
109;21.09.2018;2018;09;18;Perjantai;15;8;23;4;1;5
109;21.09.2018;2018;09;19;Perjantai;4;5;9;1;0;1
109;21.09.2018;2018;09;20;Perjantai;4;8;12;1;0;1
109;21.09.2018;2018;09;21;Perjantai;1;2;3;1;3;4
109;21.09.2018;2018;09;22;Perjantai;5;2;7;2;1;3
109;21.09.2018;2018;09;23;Perjantai;2;0;2;0;1;1
109;22.09.2018;2018;09;00;Lauantai;0;0;0;0;1;1
109;22.09.2018;2018;09;01;Lauantai;0;0;0;0;0;0
109;22.09.2018;2018;09;02;Lauantai;6;0;6;0;0;0
109;22.09.2018;2018;09;03;Lauantai;0;0;0;0;0;0
109;22.09.2018;2018;09;04;Lauantai;0;1;1;0;0;0
109;22.09.2018;2018;09;05;Lauantai;0;2;2;0;0;0
109;22.09.2018;2018;09;06;Lauantai;8;0;8;1;0;1
109;22.09.2018;2018;09;07;Lauantai;3;4;7;0;2;2
109;22.09.2018;2018;09;08;Lauantai;1;2;3;0;1;1
109;22.09.2018;2018;09;09;Lauantai;0;2;2;1;1;2
109;22.09.2018;2018;09;10;Lauantai;4;2;6;1;1;2
109;22.09.2018;2018;09;11;Lauantai;2;2;4;2;3;5
109;22.09.2018;2018;09;12;Lauantai;3;3;6;2;2;4
109;22.09.2018;2018;09;13;Lauantai;3;7;10;6;4;10
109;22.09.2018;2018;09;14;Lauantai;11;5;16;4;2;6
109;22.09.2018;2018;09;15;Lauantai;2;6;8;2;4;6
109;22.09.2018;2018;09;16;Lauantai;8;2;10;5;1;6
109;22.09.2018;2018;09;17;Lauantai;3;3;6;4;2;6
109;22.09.2018;2018;09;18;Lauantai;6;3;9;1;3;4
109;22.09.2018;2018;09;19;Lauantai;3;0;3;3;0;3
109;22.09.2018;2018;09;20;Lauantai;2;1;3;4;0;4
109;22.09.2018;2018;09;21;Lauantai;1;6;7;0;0;0
109;22.09.2018;2018;09;22;Lauantai;7;3;10;0;3;3
109;22.09.2018;2018;09;23;Lauantai;1;4;5;1;0;1
109;23.09.2018;2018;09;00;Sunnuntai;1;1;2;1;1;2
109;23.09.2018;2018;09;01;Sunnuntai;5;1;6;1;0;1
109;23.09.2018;2018;09;02;Sunnuntai;2;1;3;0;0;0
109;23.09.2018;2018;09;03;Sunnuntai;1;0;1;0;0;0
109;23.09.2018;2018;09;04;Sunnuntai;0;2;2;1;0;1
109;23.09.2018;2018;09;05;Sunnuntai;0;0;0;0;0;0
109;23.09.2018;2018;09;06;Sunnuntai;6;1;7;0;0;0
109;23.09.2018;2018;09;07;Sunnuntai;1;2;3;1;3;4
109;23.09.2018;2018;09;08;Sunnuntai;2;2;4;5;1;6
109;23.09.2018;2018;09;09;Sunnuntai;6;7;13;2;3;5
109;23.09.2018;2018;09;10;Sunnuntai;2;2;4;5;4;9
109;23.09.2018;2018;09;11;Sunnuntai;6;4;10;2;3;5
109;23.09.2018;2018;09;12;Sunnuntai;8;5;13;4;1;5
109;23.09.2018;2018;09;13;Sunnuntai;5;9;14;6;3;9
109;23.09.2018;2018;09;14;Sunnuntai;8;8;16;3;2;5
109;23.09.2018;2018;09;15;Sunnuntai;10;10;20;7;2;9
109;23.09.2018;2018;09;16;Sunnuntai;11;4;15;4;1;5
109;23.09.2018;2018;09;17;Sunnuntai;4;4;8;7;1;8
109;23.09.2018;2018;09;18;Sunnuntai;9;3;12;4;6;10
109;23.09.2018;2018;09;19;Sunnuntai;8;4;12;3;5;8
109;23.09.2018;2018;09;20;Sunnuntai;6;3;9;3;0;3
109;23.09.2018;2018;09;21;Sunnuntai;2;3;5;0;0;0
109;23.09.2018;2018;09;22;Sunnuntai;2;2;4;0;3;3
109;23.09.2018;2018;09;23;Sunnuntai;1;1;2;0;0;0
109;24.09.2018;2018;09;00;Maanantai;0;0;0;0;0;0
109;24.09.2018;2018;09;01;Maanantai;0;1;1;0;1;1
109;24.09.2018;2018;09;02;Maanantai;1;0;1;0;1;1
109;24.09.2018;2018;09;03;Maanantai;0;0;0;0;0;0
109;24.09.2018;2018;09;04;Maanantai;0;0;0;0;0;0
109;24.09.2018;2018;09;05;Maanantai;3;5;8;2;0;2
109;24.09.2018;2018;09;06;Maanantai;15;4;19;1;2;3
109;24.09.2018;2018;09;07;Maanantai;34;18;52;0;1;1
109;24.09.2018;2018;09;08;Maanantai;32;22;54;1;3;4
109;24.09.2018;2018;09;09;Maanantai;18;9;27;14;14;28
109;24.09.2018;2018;09;10;Maanantai;32;11;43;16;5;21
109;24.09.2018;2018;09;11;Maanantai;14;9;23;6;2;8
109;24.09.2018;2018;09;12;Maanantai;27;19;46;6;4;10
109;24.09.2018;2018;09;13;Maanantai;12;7;19;3;3;6
109;24.09.2018;2018;09;14;Maanantai;12;25;37;10;6;16
109;24.09.2018;2018;09;15;Maanantai;19;19;38;9;2;11
109;24.09.2018;2018;09;16;Maanantai;23;31;54;3;2;5
109;24.09.2018;2018;09;17;Maanantai;22;18;40;2;1;3
109;24.09.2018;2018;09;18;Maanantai;4;10;14;9;6;15
109;24.09.2018;2018;09;19;Maanantai;8;5;13;6;4;10
109;24.09.2018;2018;09;20;Maanantai;0;8;8;1;2;3
109;24.09.2018;2018;09;21;Maanantai;3;5;8;1;2;3
109;24.09.2018;2018;09;22;Maanantai;4;1;5;0;0;0
109;24.09.2018;2018;09;23;Maanantai;1;1;2;2;0;2
109;25.09.2018;2018;09;00;Tiistai;0;0;0;0;0;0
109;25.09.2018;2018;09;01;Tiistai;0;0;0;1;0;1
109;25.09.2018;2018;09;02;Tiistai;0;0;0;0;0;0
109;25.09.2018;2018;09;03;Tiistai;0;0;0;0;0;0
109;25.09.2018;2018;09;04;Tiistai;0;0;0;0;0;0
109;25.09.2018;2018;09;05;Tiistai;3;0;3;2;0;2
109;25.09.2018;2018;09;06;Tiistai;23;0;23;6;0;6
109;25.09.2018;2018;09;07;Tiistai;55;0;55;3;0;3
109;25.09.2018;2018;09;08;Tiistai;53;0;53;10;0;10
109;25.09.2018;2018;09;09;Tiistai;20;0;20;9;0;9
109;25.09.2018;2018;09;10;Tiistai;20;0;20;21;0;21
109;25.09.2018;2018;09;11;Tiistai;10;0;10;6;0;6
109;25.09.2018;2018;09;12;Tiistai;17;0;17;7;0;7
109;25.09.2018;2018;09;13;Tiistai;15;0;15;3;0;3
109;25.09.2018;2018;09;14;Tiistai;24;0;24;8;0;8
109;25.09.2018;2018;09;15;Tiistai;45;0;45;5;0;5
109;25.09.2018;2018;09;16;Tiistai;59;0;59;11;0;11
109;25.09.2018;2018;09;17;Tiistai;33;0;33;13;0;13
109;25.09.2018;2018;09;18;Tiistai;18;0;18;6;0;6
109;25.09.2018;2018;09;19;Tiistai;18;0;18;9;0;9
109;25.09.2018;2018;09;20;Tiistai;16;0;16;8;0;8
109;25.09.2018;2018;09;21;Tiistai;10;0;10;3;0;3
109;25.09.2018;2018;09;22;Tiistai;6;0;6;2;0;2
109;25.09.2018;2018;09;23;Tiistai;1;0;1;0;0;0
109;26.09.2018;2018;09;00;Keskiviikko;1;0;1;1;1;2
109;26.09.2018;2018;09;01;Keskiviikko;1;1;2;0;0;0
109;26.09.2018;2018;09;02;Keskiviikko;1;0;1;0;0;0
109;26.09.2018;2018;09;03;Keskiviikko;0;0;0;0;0;0
109;26.09.2018;2018;09;04;Keskiviikko;0;0;0;0;0;0
109;26.09.2018;2018;09;05;Keskiviikko;2;3;5;1;0;1
109;26.09.2018;2018;09;06;Keskiviikko;14;4;18;2;1;3
109;26.09.2018;2018;09;07;Keskiviikko;29;17;46;7;6;13
109;26.09.2018;2018;09;08;Keskiviikko;20;7;27;0;5;5
109;26.09.2018;2018;09;09;Keskiviikko;6;7;13;1;0;1
109;26.09.2018;2018;09;10;Keskiviikko;7;3;10;1;2;3
109;26.09.2018;2018;09;11;Keskiviikko;3;6;9;0;2;2
109;26.09.2018;2018;09;12;Keskiviikko;0;5;5;3;1;4
109;26.09.2018;2018;09;13;Keskiviikko;4;9;13;0;1;1
109;26.09.2018;2018;09;14;Keskiviikko;7;12;19;5;1;6
109;26.09.2018;2018;09;15;Keskiviikko;15;21;36;1;1;2
109;26.09.2018;2018;09;16;Keskiviikko;18;20;38;11;5;16
109;26.09.2018;2018;09;17;Keskiviikko;11;11;22;4;1;5
109;26.09.2018;2018;09;18;Keskiviikko;7;5;12;3;3;6
109;26.09.2018;2018;09;19;Keskiviikko;6;8;14;6;6;12
109;26.09.2018;2018;09;20;Keskiviikko;6;7;13;4;5;9
109;26.09.2018;2018;09;21;Keskiviikko;3;2;5;1;0;1
109;26.09.2018;2018;09;22;Keskiviikko;4;3;7;0;0;0
109;26.09.2018;2018;09;23;Keskiviikko;0;1;1;1;0;1
109;27.09.2018;2018;09;00;Torstai;0;1;1;0;0;0
109;27.09.2018;2018;09;01;Torstai;0;0;0;0;0;0
109;27.09.2018;2018;09;02;Torstai;2;0;2;0;0;0
109;27.09.2018;2018;09;03;Torstai;0;3;3;0;1;1
109;27.09.2018;2018;09;04;Torstai;2;1;3;0;0;0
109;27.09.2018;2018;09;05;Torstai;1;2;3;1;1;2
109;27.09.2018;2018;09;06;Torstai;11;6;17;0;0;0
109;27.09.2018;2018;09;07;Torstai;26;14;40;0;3;3
109;27.09.2018;2018;09;08;Torstai;12;9;21;2;0;2
109;27.09.2018;2018;09;09;Torstai;10;4;14;3;0;3
109;27.09.2018;2018;09;10;Torstai;12;12;24;0;1;1
109;27.09.2018;2018;09;11;Torstai;8;3;11;4;5;9
109;27.09.2018;2018;09;12;Torstai;5;2;7;9;6;15
109;27.09.2018;2018;09;13;Torstai;6;15;21;7;1;8
109;27.09.2018;2018;09;14;Torstai;14;14;28;12;12;24
109;27.09.2018;2018;09;15;Torstai;13;23;36;0;14;14
109;27.09.2018;2018;09;16;Torstai;16;24;40;4;1;5
109;27.09.2018;2018;09;17;Torstai;11;10;21;2;4;6
109;27.09.2018;2018;09;18;Torstai;3;11;14;3;2;5
109;27.09.2018;2018;09;19;Torstai;2;3;5;5;6;11
109;27.09.2018;2018;09;20;Torstai;8;14;22;4;3;7
109;27.09.2018;2018;09;21;Torstai;4;5;9;1;0;1
109;27.09.2018;2018;09;22;Torstai;7;2;9;0;0;0
109;27.09.2018;2018;09;23;Torstai;1;0;1;0;0;0
109;28.09.2018;2018;09;00;Perjantai;2;3;5;3;4;7
109;28.09.2018;2018;09;01;Perjantai;0;0;0;0;1;1
109;28.09.2018;2018;09;02;Perjantai;0;0;0;0;0;0
109;28.09.2018;2018;09;03;Perjantai;0;0;0;0;0;0
109;28.09.2018;2018;09;04;Perjantai;0;0;0;0;0;0
109;28.09.2018;2018;09;05;Perjantai;2;2;4;3;0;3
109;28.09.2018;2018;09;06;Perjantai;17;3;20;1;1;2
109;28.09.2018;2018;09;07;Perjantai;36;11;47;2;1;3
109;28.09.2018;2018;09;08;Perjantai;22;12;34;3;4;7
109;28.09.2018;2018;09;09;Perjantai;14;4;18;4;5;9
109;28.09.2018;2018;09;10;Perjantai;21;9;30;4;7;11
109;28.09.2018;2018;09;11;Perjantai;5;9;14;3;4;7
109;28.09.2018;2018;09;12;Perjantai;7;5;12;2;2;4
109;28.09.2018;2018;09;13;Perjantai;18;23;41;5;5;10
109;28.09.2018;2018;09;14;Perjantai;17;16;33;6;2;8
109;28.09.2018;2018;09;15;Perjantai;19;20;39;2;4;6
109;28.09.2018;2018;09;16;Perjantai;12;25;37;6;3;9
109;28.09.2018;2018;09;17;Perjantai;11;7;18;8;5;13
109;28.09.2018;2018;09;18;Perjantai;10;6;16;2;4;6
109;28.09.2018;2018;09;19;Perjantai;8;12;20;2;3;5
109;28.09.2018;2018;09;20;Perjantai;9;4;13;1;0;1
109;28.09.2018;2018;09;21;Perjantai;3;2;5;1;2;3
109;28.09.2018;2018;09;22;Perjantai;10;0;10;3;1;4
109;28.09.2018;2018;09;23;Perjantai;1;3;4;1;1;2
109;29.09.2018;2018;09;00;Lauantai;0;0;0;2;2;4
109;29.09.2018;2018;09;01;Lauantai;0;3;3;0;0;0
109;29.09.2018;2018;09;02;Lauantai;0;0;0;0;0;0
109;29.09.2018;2018;09;03;Lauantai;0;3;3;2;0;2
109;29.09.2018;2018;09;04;Lauantai;0;1;1;0;0;0
109;29.09.2018;2018;09;05;Lauantai;1;1;2;0;0;0
109;29.09.2018;2018;09;06;Lauantai;1;2;3;2;1;3
109;29.09.2018;2018;09;07;Lauantai;1;2;3;0;3;3
109;29.09.2018;2018;09;08;Lauantai;1;1;2;1;3;4
109;29.09.2018;2018;09;09;Lauantai;2;1;3;5;1;6
109;29.09.2018;2018;09;10;Lauantai;5;0;5;5;6;11
109;29.09.2018;2018;09;11;Lauantai;4;4;8;0;2;2
109;29.09.2018;2018;09;12;Lauantai;8;7;15;2;2;4
109;29.09.2018;2018;09;13;Lauantai;10;8;18;3;1;4
109;29.09.2018;2018;09;14;Lauantai;6;2;8;2;1;3
109;29.09.2018;2018;09;15;Lauantai;8;10;18;4;2;6
109;29.09.2018;2018;09;16;Lauantai;6;8;14;12;9;21
109;29.09.2018;2018;09;17;Lauantai;6;6;12;5;3;8
109;29.09.2018;2018;09;18;Lauantai;5;5;10;1;2;3
109;29.09.2018;2018;09;19;Lauantai;5;6;11;2;2;4
109;29.09.2018;2018;09;20;Lauantai;6;3;9;2;1;3
109;29.09.2018;2018;09;21;Lauantai;2;2;4;3;3;6
109;29.09.2018;2018;09;22;Lauantai;2;1;3;0;1;1
109;29.09.2018;2018;09;23;Lauantai;3;0;3;1;0;1
109;30.09.2018;2018;09;00;Sunnuntai;2;1;3;1;0;1
109;30.09.2018;2018;09;01;Sunnuntai;1;0;1;0;0;0
109;30.09.2018;2018;09;02;Sunnuntai;1;1;2;0;0;0
109;30.09.2018;2018;09;03;Sunnuntai;0;0;0;0;1;1
109;30.09.2018;2018;09;04;Sunnuntai;0;0;0;0;0;0
109;30.09.2018;2018;09;05;Sunnuntai;1;0;1;0;0;0
109;30.09.2018;2018;09;06;Sunnuntai;3;1;4;0;1;1
109;30.09.2018;2018;09;07;Sunnuntai;1;1;2;1;1;2
109;30.09.2018;2018;09;08;Sunnuntai;1;0;1;5;1;6
109;30.09.2018;2018;09;09;Sunnuntai;3;3;6;1;2;3
109;30.09.2018;2018;09;10;Sunnuntai;6;6;12;1;4;5
109;30.09.2018;2018;09;11;Sunnuntai;6;2;8;1;1;2
109;30.09.2018;2018;09;12;Sunnuntai;11;5;16;3;2;5
109;30.09.2018;2018;09;13;Sunnuntai;11;7;18;4;5;9
109;30.09.2018;2018;09;14;Sunnuntai;11;9;20;5;5;10
109;30.09.2018;2018;09;15;Sunnuntai;6;7;13;8;1;9
109;30.09.2018;2018;09;16;Sunnuntai;11;11;22;7;6;13
109;30.09.2018;2018;09;17;Sunnuntai;12;12;24;4;4;8
109;30.09.2018;2018;09;18;Sunnuntai;7;8;15;5;3;8
109;30.09.2018;2018;09;19;Sunnuntai;1;1;2;3;5;8
109;30.09.2018;2018;09;20;Sunnuntai;6;0;6;0;4;4
109;30.09.2018;2018;09;21;Sunnuntai;3;5;8;3;1;4
109;30.09.2018;2018;09;22;Sunnuntai;1;0;1;0;1;1
109;30.09.2018;2018;09;23;Sunnuntai;0;1;1;1;1;2