MittausID;Pvm;Vuosi;Kuukausi;Tunti;Viikonpäivä;PP_1;PP_2;PP_YHT
625;02.01.2017;2017;01;00;Maanantai;1;1;2
625;02.01.2017;2017;01;01;Maanantai;0;0;0
625;02.01.2017;2017;01;02;Maanantai;0;0;0
625;02.01.2017;2017;01;03;Maanantai;0;0;0
625;02.01.2017;2017;01;04;Maanantai;0;0;0
625;02.01.2017;2017;01;05;Maanantai;0;0;0
625;02.01.2017;2017;01;06;Maanantai;1;1;2
625;02.01.2017;2017;01;07;Maanantai;3;3;6
625;02.01.2017;2017;01;08;Maanantai;9;9;18
625;02.01.2017;2017;01;09;Maanantai;6;6;12
625;02.01.2017;2017;01;10;Maanantai;4;4;8
625;02.01.2017;2017;01;11;Maanantai;3;0;3
625;02.01.2017;2017;01;12;Maanantai;1;2;3
625;02.01.2017;2017;01;13;Maanantai;2;5;7
625;02.01.2017;2017;01;14;Maanantai;4;4;8
625;02.01.2017;2017;01;15;Maanantai;3;4;7
625;02.01.2017;2017;01;16;Maanantai;5;9;14
625;02.01.2017;2017;01;17;Maanantai;7;14;21
625;02.01.2017;2017;01;18;Maanantai;5;6;11
625;02.01.2017;2017;01;19;Maanantai;2;4;6
625;02.01.2017;2017;01;20;Maanantai;4;2;6
625;02.01.2017;2017;01;21;Maanantai;4;1;5
625;02.01.2017;2017;01;22;Maanantai;3;3;6
625;02.01.2017;2017;01;23;Maanantai;1;0;1
625;03.01.2017;2017;01;00;Tiistai;1;0;1
625;03.01.2017;2017;01;01;Tiistai;0;0;0
625;03.01.2017;2017;01;02;Tiistai;0;0;0
625;03.01.2017;2017;01;03;Tiistai;0;0;0
625;03.01.2017;2017;01;04;Tiistai;0;0;0
625;03.01.2017;2017;01;05;Tiistai;0;0;0
625;03.01.2017;2017;01;06;Tiistai;1;1;2
625;03.01.2017;2017;01;07;Tiistai;3;5;8
625;03.01.2017;2017;01;08;Tiistai;10;6;16
625;03.01.2017;2017;01;09;Tiistai;7;5;12
625;03.01.2017;2017;01;10;Tiistai;2;2;4
625;03.01.2017;2017;01;11;Tiistai;2;2;4
625;03.01.2017;2017;01;12;Tiistai;0;5;5
625;03.01.2017;2017;01;13;Tiistai;8;5;13
625;03.01.2017;2017;01;14;Tiistai;2;3;5
625;03.01.2017;2017;01;15;Tiistai;3;6;9
625;03.01.2017;2017;01;16;Tiistai;2;4;6
625;03.01.2017;2017;01;17;Tiistai;5;9;14
625;03.01.2017;2017;01;18;Tiistai;2;4;6
625;03.01.2017;2017;01;19;Tiistai;2;7;9
625;03.01.2017;2017;01;20;Tiistai;0;1;1
625;03.01.2017;2017;01;21;Tiistai;2;0;2
625;03.01.2017;2017;01;22;Tiistai;1;2;3
625;03.01.2017;2017;01;23;Tiistai;2;0;2
625;04.01.2017;2017;01;00;Keskiviikko;0;0;0
625;04.01.2017;2017;01;01;Keskiviikko;0;0;0
625;04.01.2017;2017;01;02;Keskiviikko;0;0;0
625;04.01.2017;2017;01;03;Keskiviikko;0;0;0
625;04.01.2017;2017;01;04;Keskiviikko;0;0;0
625;04.01.2017;2017;01;05;Keskiviikko;0;0;0
625;04.01.2017;2017;01;06;Keskiviikko;0;1;1
625;04.01.2017;2017;01;07;Keskiviikko;0;2;2
625;04.01.2017;2017;01;08;Keskiviikko;7;3;10
625;04.01.2017;2017;01;09;Keskiviikko;6;5;11
625;04.01.2017;2017;01;10;Keskiviikko;0;2;2
625;04.01.2017;2017;01;11;Keskiviikko;0;2;2
625;04.01.2017;2017;01;12;Keskiviikko;1;0;1
625;04.01.2017;2017;01;13;Keskiviikko;2;4;6
625;04.01.2017;2017;01;14;Keskiviikko;1;1;2
625;04.01.2017;2017;01;15;Keskiviikko;1;0;1
625;04.01.2017;2017;01;16;Keskiviikko;2;4;6
625;04.01.2017;2017;01;17;Keskiviikko;4;5;9
625;04.01.2017;2017;01;18;Keskiviikko;1;1;2
625;04.01.2017;2017;01;19;Keskiviikko;1;1;2
625;04.01.2017;2017;01;20;Keskiviikko;1;0;1
625;04.01.2017;2017;01;21;Keskiviikko;0;0;0
625;04.01.2017;2017;01;22;Keskiviikko;1;0;1
625;04.01.2017;2017;01;23;Keskiviikko;1;1;2
625;05.01.2017;2017;01;00;Torstai;0;0;0
625;05.01.2017;2017;01;01;Torstai;0;0;0
625;05.01.2017;2017;01;02;Torstai;0;0;0
625;05.01.2017;2017;01;03;Torstai;0;0;0
625;05.01.2017;2017;01;04;Torstai;1;0;1
625;05.01.2017;2017;01;05;Torstai;0;0;0
625;05.01.2017;2017;01;06;Torstai;0;2;2
625;05.01.2017;2017;01;07;Torstai;1;2;3
625;05.01.2017;2017;01;08;Torstai;2;5;7
625;05.01.2017;2017;01;09;Torstai;3;4;7
625;05.01.2017;2017;01;10;Torstai;1;2;3
625;05.01.2017;2017;01;11;Torstai;0;0;0
625;05.01.2017;2017;01;12;Torstai;2;0;2
625;05.01.2017;2017;01;13;Torstai;0;1;1
625;05.01.2017;2017;01;14;Torstai;0;2;2
625;05.01.2017;2017;01;15;Torstai;0;2;2
625;05.01.2017;2017;01;16;Torstai;2;0;2
625;05.01.2017;2017;01;17;Torstai;2;7;9
625;05.01.2017;2017;01;18;Torstai;2;0;2
625;05.01.2017;2017;01;19;Torstai;2;0;2
625;05.01.2017;2017;01;20;Torstai;0;1;1
625;05.01.2017;2017;01;21;Torstai;1;0;1
625;05.01.2017;2017;01;22;Torstai;0;1;1
625;05.01.2017;2017;01;23;Torstai;1;0;1
625;06.01.2017;2017;01;00;Perjantai;0;0;0
625;06.01.2017;2017;01;01;Perjantai;0;0;0
625;06.01.2017;2017;01;02;Perjantai;0;0;0
625;06.01.2017;2017;01;03;Perjantai;0;0;0
625;06.01.2017;2017;01;04;Perjantai;0;0;0
625;06.01.2017;2017;01;05;Perjantai;0;0;0
625;06.01.2017;2017;01;06;Perjantai;0;0;0
625;06.01.2017;2017;01;07;Perjantai;0;0;0
625;06.01.2017;2017;01;08;Perjantai;1;0;1
625;06.01.2017;2017;01;09;Perjantai;0;0;0
625;06.01.2017;2017;01;10;Perjantai;2;2;4
625;06.01.2017;2017;01;11;Perjantai;0;1;1
625;06.01.2017;2017;01;12;Perjantai;0;0;0
625;06.01.2017;2017;01;13;Perjantai;0;1;1
625;06.01.2017;2017;01;14;Perjantai;3;3;6
625;06.01.2017;2017;01;15;Perjantai;3;4;7
625;06.01.2017;2017;01;16;Perjantai;1;1;2
625;06.01.2017;2017;01;17;Perjantai;0;3;3
625;06.01.2017;2017;01;18;Perjantai;2;1;3
625;06.01.2017;2017;01;19;Perjantai;1;2;3
625;06.01.2017;2017;01;20;Perjantai;0;0;0
625;06.01.2017;2017;01;21;Perjantai;0;1;1
625;06.01.2017;2017;01;22;Perjantai;2;2;4
625;06.01.2017;2017;01;23;Perjantai;1;0;1
625;07.01.2017;2017;01;00;Lauantai;0;0;0
625;07.01.2017;2017;01;01;Lauantai;0;0;0
625;07.01.2017;2017;01;02;Lauantai;0;0;0
625;07.01.2017;2017;01;03;Lauantai;0;0;0
625;07.01.2017;2017;01;04;Lauantai;0;0;0
625;07.01.2017;2017;01;05;Lauantai;0;0;0
625;07.01.2017;2017;01;06;Lauantai;0;0;0
625;07.01.2017;2017;01;07;Lauantai;0;0;0
625;07.01.2017;2017;01;08;Lauantai;0;1;1
625;07.01.2017;2017;01;09;Lauantai;1;0;1
625;07.01.2017;2017;01;10;Lauantai;1;0;1
625;07.01.2017;2017;01;11;Lauantai;1;2;3
625;07.01.2017;2017;01;12;Lauantai;4;5;9
625;07.01.2017;2017;01;13;Lauantai;4;4;8
625;07.01.2017;2017;01;14;Lauantai;0;3;3
625;07.01.2017;2017;01;15;Lauantai;3;2;5
625;07.01.2017;2017;01;16;Lauantai;2;4;6
625;07.01.2017;2017;01;17;Lauantai;0;3;3
625;07.01.2017;2017;01;18;Lauantai;5;3;8
625;07.01.2017;2017;01;19;Lauantai;3;2;5
625;07.01.2017;2017;01;20;Lauantai;0;1;1
625;07.01.2017;2017;01;21;Lauantai;2;0;2
625;07.01.2017;2017;01;22;Lauantai;1;0;1
625;07.01.2017;2017;01;23;Lauantai;1;2;3
625;08.01.2017;2017;01;00;Sunnuntai;0;0;0
625;08.01.2017;2017;01;01;Sunnuntai;0;0;0
625;08.01.2017;2017;01;02;Sunnuntai;0;0;0
625;08.01.2017;2017;01;03;Sunnuntai;0;0;0
625;08.01.2017;2017;01;04;Sunnuntai;0;0;0
625;08.01.2017;2017;01;05;Sunnuntai;0;0;0
625;08.01.2017;2017;01;06;Sunnuntai;0;0;0
625;08.01.2017;2017;01;07;Sunnuntai;0;2;2
625;08.01.2017;2017;01;08;Sunnuntai;1;2;3
625;08.01.2017;2017;01;09;Sunnuntai;3;0;3
625;08.01.2017;2017;01;10;Sunnuntai;3;0;3
625;08.01.2017;2017;01;11;Sunnuntai;3;3;6
625;08.01.2017;2017;01;12;Sunnuntai;0;1;1
625;08.01.2017;2017;01;13;Sunnuntai;3;4;7
625;08.01.2017;2017;01;14;Sunnuntai;5;8;13
625;08.01.2017;2017;01;15;Sunnuntai;2;3;5
625;08.01.2017;2017;01;16;Sunnuntai;4;1;5
625;08.01.2017;2017;01;17;Sunnuntai;5;1;6
625;08.01.2017;2017;01;18;Sunnuntai;2;4;6
625;08.01.2017;2017;01;19;Sunnuntai;1;5;6
625;08.01.2017;2017;01;20;Sunnuntai;0;0;0
625;08.01.2017;2017;01;21;Sunnuntai;1;1;2
625;08.01.2017;2017;01;22;Sunnuntai;0;1;1
625;08.01.2017;2017;01;23;Sunnuntai;0;0;0
625;09.01.2017;2017;01;00;Maanantai;0;0;0
625;09.01.2017;2017;01;01;Maanantai;1;1;2
625;09.01.2017;2017;01;02;Maanantai;0;0;0
625;09.01.2017;2017;01;03;Maanantai;0;0;0
625;09.01.2017;2017;01;04;Maanantai;0;0;0
625;09.01.2017;2017;01;05;Maanantai;1;1;2
625;09.01.2017;2017;01;06;Maanantai;1;2;3
625;09.01.2017;2017;01;07;Maanantai;4;2;6
625;09.01.2017;2017;01;08;Maanantai;52;13;65
625;09.01.2017;2017;01;09;Maanantai;19;15;34
625;09.01.2017;2017;01;10;Maanantai;15;4;19
625;09.01.2017;2017;01;11;Maanantai;6;0;6
625;09.01.2017;2017;01;12;Maanantai;2;2;4
625;09.01.2017;2017;01;13;Maanantai;3;8;11
625;09.01.2017;2017;01;14;Maanantai;1;14;15
625;09.01.2017;2017;01;15;Maanantai;9;27;36
625;09.01.2017;2017;01;16;Maanantai;4;23;27
625;09.01.2017;2017;01;17;Maanantai;17;25;42
625;09.01.2017;2017;01;18;Maanantai;10;14;24
625;09.01.2017;2017;01;19;Maanantai;6;8;14
625;09.01.2017;2017;01;20;Maanantai;3;4;7
625;09.01.2017;2017;01;21;Maanantai;2;6;8
625;09.01.2017;2017;01;22;Maanantai;3;3;6
625;09.01.2017;2017;01;23;Maanantai;2;2;4
625;10.01.2017;2017;01;00;Tiistai;1;1;2
625;10.01.2017;2017;01;01;Tiistai;0;0;0
625;10.01.2017;2017;01;02;Tiistai;0;0;0
625;10.01.2017;2017;01;03;Tiistai;0;0;0
625;10.01.2017;2017;01;04;Tiistai;0;1;1
625;10.01.2017;2017;01;05;Tiistai;0;0;0
625;10.01.2017;2017;01;06;Tiistai;0;2;2
625;10.01.2017;2017;01;07;Tiistai;8;3;11
625;10.01.2017;2017;01;08;Tiistai;41;17;58
625;10.01.2017;2017;01;09;Tiistai;37;12;49
625;10.01.2017;2017;01;10;Tiistai;17;7;24
625;10.01.2017;2017;01;11;Tiistai;16;3;19
625;10.01.2017;2017;01;12;Tiistai;3;8;11
625;10.01.2017;2017;01;13;Tiistai;11;9;20
625;10.01.2017;2017;01;14;Tiistai;8;24;32
625;10.01.2017;2017;01;15;Tiistai;11;23;34
625;10.01.2017;2017;01;16;Tiistai;8;18;26
625;10.01.2017;2017;01;17;Tiistai;12;25;37
625;10.01.2017;2017;01;18;Tiistai;8;15;23
625;10.01.2017;2017;01;19;Tiistai;5;5;10
625;10.01.2017;2017;01;20;Tiistai;6;6;12
625;10.01.2017;2017;01;21;Tiistai;2;3;5
625;10.01.2017;2017;01;22;Tiistai;4;1;5
625;10.01.2017;2017;01;23;Tiistai;2;0;2
625;11.01.2017;2017;01;00;Keskiviikko;1;0;1
625;11.01.2017;2017;01;01;Keskiviikko;0;0;0
625;11.01.2017;2017;01;02;Keskiviikko;0;0;0
625;11.01.2017;2017;01;03;Keskiviikko;0;0;0
625;11.01.2017;2017;01;04;Keskiviikko;0;1;1
625;11.01.2017;2017;01;05;Keskiviikko;1;1;2
625;11.01.2017;2017;01;06;Keskiviikko;2;2;4
625;11.01.2017;2017;01;07;Keskiviikko;6;4;10
625;11.01.2017;2017;01;08;Keskiviikko;41;12;53
625;11.01.2017;2017;01;09;Keskiviikko;24;10;34
625;11.01.2017;2017;01;10;Keskiviikko;15;3;18
625;11.01.2017;2017;01;11;Keskiviikko;7;0;7
625;11.01.2017;2017;01;12;Keskiviikko;5;5;10
625;11.01.2017;2017;01;13;Keskiviikko;1;8;9
625;11.01.2017;2017;01;14;Keskiviikko;7;19;26
625;11.01.2017;2017;01;15;Keskiviikko;4;23;27
625;11.01.2017;2017;01;16;Keskiviikko;10;20;30
625;11.01.2017;2017;01;17;Keskiviikko;10;27;37
625;11.01.2017;2017;01;18;Keskiviikko;4;9;13
625;11.01.2017;2017;01;19;Keskiviikko;5;7;12
625;11.01.2017;2017;01;20;Keskiviikko;4;5;9
625;11.01.2017;2017;01;21;Keskiviikko;6;8;14
625;11.01.2017;2017;01;22;Keskiviikko;3;2;5
625;11.01.2017;2017;01;23;Keskiviikko;1;0;1
625;12.01.2017;2017;01;00;Torstai;2;0;2
625;12.01.2017;2017;01;01;Torstai;0;0;0
625;12.01.2017;2017;01;02;Torstai;0;0;0
625;12.01.2017;2017;01;03;Torstai;0;0;0
625;12.01.2017;2017;01;04;Torstai;1;0;1
625;12.01.2017;2017;01;05;Torstai;0;0;0
625;12.01.2017;2017;01;06;Torstai;1;2;3
625;12.01.2017;2017;01;07;Torstai;6;3;9
625;12.01.2017;2017;01;08;Torstai;22;9;31
625;12.01.2017;2017;01;09;Torstai;28;10;38
625;12.01.2017;2017;01;10;Torstai;19;8;27
625;12.01.2017;2017;01;11;Torstai;5;2;7
625;12.01.2017;2017;01;12;Torstai;6;3;9
625;12.01.2017;2017;01;13;Torstai;4;10;14
625;12.01.2017;2017;01;14;Torstai;9;16;25
625;12.01.2017;2017;01;15;Torstai;6;25;31
625;12.01.2017;2017;01;16;Torstai;5;14;19
625;12.01.2017;2017;01;17;Torstai;9;14;23
625;12.01.2017;2017;01;18;Torstai;11;19;30
625;12.01.2017;2017;01;19;Torstai;6;6;12
625;12.01.2017;2017;01;20;Torstai;1;2;3
625;12.01.2017;2017;01;21;Torstai;2;3;5
625;12.01.2017;2017;01;22;Torstai;5;0;5
625;12.01.2017;2017;01;23;Torstai;3;2;5
625;13.01.2017;2017;01;00;Perjantai;2;0;2
625;13.01.2017;2017;01;01;Perjantai;0;0;0
625;13.01.2017;2017;01;02;Perjantai;0;0;0
625;13.01.2017;2017;01;03;Perjantai;0;0;0
625;13.01.2017;2017;01;04;Perjantai;0;0;0
625;13.01.2017;2017;01;05;Perjantai;1;1;2
625;13.01.2017;2017;01;06;Perjantai;1;0;1
625;13.01.2017;2017;01;07;Perjantai;8;5;13
625;13.01.2017;2017;01;08;Perjantai;46;12;58
625;13.01.2017;2017;01;09;Perjantai;25;11;36
625;13.01.2017;2017;01;10;Perjantai;13;5;18
625;13.01.2017;2017;01;11;Perjantai;5;3;8
625;13.01.2017;2017;01;12;Perjantai;5;7;12
625;13.01.2017;2017;01;13;Perjantai;4;11;15
625;13.01.2017;2017;01;14;Perjantai;10;21;31
625;13.01.2017;2017;01;15;Perjantai;6;18;24
625;13.01.2017;2017;01;16;Perjantai;8;20;28
625;13.01.2017;2017;01;17;Perjantai;4;13;17
625;13.01.2017;2017;01;18;Perjantai;4;7;11
625;13.01.2017;2017;01;19;Perjantai;2;1;3
625;13.01.2017;2017;01;20;Perjantai;2;1;3
625;13.01.2017;2017;01;21;Perjantai;2;2;4
625;13.01.2017;2017;01;22;Perjantai;1;1;2
625;13.01.2017;2017;01;23;Perjantai;4;2;6
625;14.01.2017;2017;01;00;Lauantai;2;0;2
625;14.01.2017;2017;01;01;Lauantai;1;1;2
625;14.01.2017;2017;01;02;Lauantai;1;0;1
625;14.01.2017;2017;01;03;Lauantai;0;0;0
625;14.01.2017;2017;01;04;Lauantai;0;1;1
625;14.01.2017;2017;01;05;Lauantai;0;0;0
625;14.01.2017;2017;01;06;Lauantai;0;0;0
625;14.01.2017;2017;01;07;Lauantai;0;1;1
625;14.01.2017;2017;01;08;Lauantai;1;1;2
625;14.01.2017;2017;01;09;Lauantai;0;0;0
625;14.01.2017;2017;01;10;Lauantai;4;0;4
625;14.01.2017;2017;01;11;Lauantai;3;3;6
625;14.01.2017;2017;01;12;Lauantai;4;3;7
625;14.01.2017;2017;01;13;Lauantai;4;3;7
625;14.01.2017;2017;01;14;Lauantai;0;4;4
625;14.01.2017;2017;01;15;Lauantai;2;3;5
625;14.01.2017;2017;01;16;Lauantai;3;1;4
625;14.01.2017;2017;01;17;Lauantai;2;3;5
625;14.01.2017;2017;01;18;Lauantai;3;5;8
625;14.01.2017;2017;01;19;Lauantai;1;1;2
625;14.01.2017;2017;01;20;Lauantai;0;2;2
625;14.01.2017;2017;01;21;Lauantai;1;0;1
625;14.01.2017;2017;01;22;Lauantai;1;1;2
625;14.01.2017;2017;01;23;Lauantai;4;1;5
625;15.01.2017;2017;01;00;Sunnuntai;0;0;0
625;15.01.2017;2017;01;01;Sunnuntai;1;0;1
625;15.01.2017;2017;01;02;Sunnuntai;0;0;0
625;15.01.2017;2017;01;03;Sunnuntai;2;1;3
625;15.01.2017;2017;01;04;Sunnuntai;0;0;0
625;15.01.2017;2017;01;05;Sunnuntai;0;0;0
625;15.01.2017;2017;01;06;Sunnuntai;0;0;0
625;15.01.2017;2017;01;07;Sunnuntai;0;1;1
625;15.01.2017;2017;01;08;Sunnuntai;0;1;1
625;15.01.2017;2017;01;09;Sunnuntai;0;0;0
625;15.01.2017;2017;01;10;Sunnuntai;0;1;1
625;15.01.2017;2017;01;11;Sunnuntai;3;1;4
625;15.01.2017;2017;01;12;Sunnuntai;0;4;4
625;15.01.2017;2017;01;13;Sunnuntai;1;3;4
625;15.01.2017;2017;01;14;Sunnuntai;3;6;9
625;15.01.2017;2017;01;15;Sunnuntai;8;3;11
625;15.01.2017;2017;01;16;Sunnuntai;3;5;8
625;15.01.2017;2017;01;17;Sunnuntai;1;1;2
625;15.01.2017;2017;01;18;Sunnuntai;2;2;4
625;15.01.2017;2017;01;19;Sunnuntai;0;2;2
625;15.01.2017;2017;01;20;Sunnuntai;1;0;1
625;15.01.2017;2017;01;21;Sunnuntai;1;3;4
625;15.01.2017;2017;01;22;Sunnuntai;1;2;3
625;15.01.2017;2017;01;23;Sunnuntai;0;0;0
625;16.01.2017;2017;01;00;Maanantai;0;0;0
625;16.01.2017;2017;01;01;Maanantai;0;0;0
625;16.01.2017;2017;01;02;Maanantai;0;0;0
625;16.01.2017;2017;01;03;Maanantai;0;0;0
625;16.01.2017;2017;01;04;Maanantai;0;0;0
625;16.01.2017;2017;01;05;Maanantai;1;0;1
625;16.01.2017;2017;01;06;Maanantai;0;1;1
625;16.01.2017;2017;01;07;Maanantai;6;3;9
625;16.01.2017;2017;01;08;Maanantai;29;10;39
625;16.01.2017;2017;01;09;Maanantai;16;8;24
625;16.01.2017;2017;01;10;Maanantai;6;4;10
625;16.01.2017;2017;01;11;Maanantai;6;5;11
625;16.01.2017;2017;01;12;Maanantai;3;3;6
625;16.01.2017;2017;01;13;Maanantai;1;6;7
625;16.01.2017;2017;01;14;Maanantai;1;13;14
625;16.01.2017;2017;01;15;Maanantai;2;16;18
625;16.01.2017;2017;01;16;Maanantai;9;21;30
625;16.01.2017;2017;01;17;Maanantai;9;13;22
625;16.01.2017;2017;01;18;Maanantai;8;7;15
625;16.01.2017;2017;01;19;Maanantai;6;12;18
625;16.01.2017;2017;01;20;Maanantai;0;0;0
625;16.01.2017;2017;01;21;Maanantai;3;5;8
625;16.01.2017;2017;01;22;Maanantai;1;3;4
625;16.01.2017;2017;01;23;Maanantai;0;0;0
625;17.01.2017;2017;01;00;Tiistai;0;0;0
625;17.01.2017;2017;01;01;Tiistai;0;0;0
625;17.01.2017;2017;01;02;Tiistai;0;0;0
625;17.01.2017;2017;01;03;Tiistai;0;0;0
625;17.01.2017;2017;01;04;Tiistai;0;0;0
625;17.01.2017;2017;01;05;Tiistai;0;0;0
625;17.01.2017;2017;01;06;Tiistai;1;1;2
625;17.01.2017;2017;01;07;Tiistai;4;5;9
625;17.01.2017;2017;01;08;Tiistai;22;13;35
625;17.01.2017;2017;01;09;Tiistai;16;10;26
625;17.01.2017;2017;01;10;Tiistai;4;0;4
625;17.01.2017;2017;01;11;Tiistai;10;3;13
625;17.01.2017;2017;01;12;Tiistai;6;7;13
625;17.01.2017;2017;01;13;Tiistai;23;15;38
625;17.01.2017;2017;01;14;Tiistai;5;30;35
625;17.01.2017;2017;01;15;Tiistai;3;20;23
625;17.01.2017;2017;01;16;Tiistai;12;14;26
625;17.01.2017;2017;01;17;Tiistai;16;21;37
625;17.01.2017;2017;01;18;Tiistai;5;6;11
625;17.01.2017;2017;01;19;Tiistai;2;9;11
625;17.01.2017;2017;01;20;Tiistai;1;1;2
625;17.01.2017;2017;01;21;Tiistai;1;2;3
625;17.01.2017;2017;01;22;Tiistai;3;6;9
625;17.01.2017;2017;01;23;Tiistai;1;1;2
625;18.01.2017;2017;01;00;Keskiviikko;0;0;0
625;18.01.2017;2017;01;01;Keskiviikko;0;0;0
625;18.01.2017;2017;01;02;Keskiviikko;0;0;0
625;18.01.2017;2017;01;03;Keskiviikko;0;0;0
625;18.01.2017;2017;01;04;Keskiviikko;0;0;0
625;18.01.2017;2017;01;05;Keskiviikko;1;0;1
625;18.01.2017;2017;01;06;Keskiviikko;0;0;0
625;18.01.2017;2017;01;07;Keskiviikko;8;6;14
625;18.01.2017;2017;01;08;Keskiviikko;22;8;30
625;18.01.2017;2017;01;09;Keskiviikko;12;7;19
625;18.01.2017;2017;01;10;Keskiviikko;8;2;10
625;18.01.2017;2017;01;11;Keskiviikko;5;2;7
625;18.01.2017;2017;01;12;Keskiviikko;5;8;13
625;18.01.2017;2017;01;13;Keskiviikko;8;10;18
625;18.01.2017;2017;01;14;Keskiviikko;5;30;35
625;18.01.2017;2017;01;15;Keskiviikko;3;20;23
625;18.01.2017;2017;01;16;Keskiviikko;12;14;26
625;18.01.2017;2017;01;17;Keskiviikko;16;21;37
625;18.01.2017;2017;01;18;Keskiviikko;5;6;11
625;18.01.2017;2017;01;19;Keskiviikko;2;9;11
625;18.01.2017;2017;01;20;Keskiviikko;1;1;2
625;18.01.2017;2017;01;21;Keskiviikko;1;5;6
625;18.01.2017;2017;01;22;Keskiviikko;4;3;7
625;18.01.2017;2017;01;23;Keskiviikko;2;0;2
625;19.01.2017;2017;01;00;Torstai;0;1;1
625;19.01.2017;2017;01;01;Torstai;0;0;0
625;19.01.2017;2017;01;02;Torstai;0;0;0
625;19.01.2017;2017;01;03;Torstai;0;0;0
625;19.01.2017;2017;01;04;Torstai;0;1;1
625;19.01.2017;2017;01;05;Torstai;0;0;0
625;19.01.2017;2017;01;06;Torstai;1;1;2
625;19.01.2017;2017;01;07;Torstai;5;6;11
625;19.01.2017;2017;01;08;Torstai;23;12;35
625;19.01.2017;2017;01;09;Torstai;18;10;28
625;19.01.2017;2017;01;10;Torstai;8;5;13
625;19.01.2017;2017;01;11;Torstai;1;3;4
625;19.01.2017;2017;01;12;Torstai;3;5;8
625;19.01.2017;2017;01;13;Torstai;2;7;9
625;19.01.2017;2017;01;14;Torstai;4;14;18
625;19.01.2017;2017;01;15;Torstai;4;23;27
625;19.01.2017;2017;01;16;Torstai;8;15;23
625;19.01.2017;2017;01;17;Torstai;8;14;22
625;19.01.2017;2017;01;18;Torstai;12;5;17
625;19.01.2017;2017;01;19;Torstai;2;3;5
625;19.01.2017;2017;01;20;Torstai;3;8;11
625;19.01.2017;2017;01;21;Torstai;1;3;4
625;19.01.2017;2017;01;22;Torstai;3;2;5
625;19.01.2017;2017;01;23;Torstai;1;0;1
625;20.01.2017;2017;01;00;Perjantai;0;0;0
625;20.01.2017;2017;01;01;Perjantai;0;0;0
625;20.01.2017;2017;01;02;Perjantai;0;0;0
625;20.01.2017;2017;01;03;Perjantai;0;0;0
625;20.01.2017;2017;01;04;Perjantai;0;0;0
625;20.01.2017;2017;01;05;Perjantai;1;0;1
625;20.01.2017;2017;01;06;Perjantai;3;2;5
625;20.01.2017;2017;01;07;Perjantai;4;3;7
625;20.01.2017;2017;01;08;Perjantai;27;7;34
625;20.01.2017;2017;01;09;Perjantai;21;6;27
625;20.01.2017;2017;01;10;Perjantai;7;4;11
625;20.01.2017;2017;01;11;Perjantai;2;2;4
625;20.01.2017;2017;01;12;Perjantai;3;5;8
625;20.01.2017;2017;01;13;Perjantai;3;9;12
625;20.01.2017;2017;01;14;Perjantai;9;14;23
625;20.01.2017;2017;01;15;Perjantai;0;12;12
625;20.01.2017;2017;01;16;Perjantai;7;12;19
625;20.01.2017;2017;01;17;Perjantai;5;12;17
625;20.01.2017;2017;01;18;Perjantai;4;4;8
625;20.01.2017;2017;01;19;Perjantai;3;3;6
625;20.01.2017;2017;01;20;Perjantai;3;3;6
625;20.01.2017;2017;01;21;Perjantai;1;1;2
625;20.01.2017;2017;01;22;Perjantai;3;1;4
625;20.01.2017;2017;01;23;Perjantai;1;0;1
625;21.01.2017;2017;01;00;Lauantai;0;0;0
625;21.01.2017;2017;01;01;Lauantai;0;0;0
625;21.01.2017;2017;01;02;Lauantai;0;0;0
625;21.01.2017;2017;01;03;Lauantai;0;1;1
625;21.01.2017;2017;01;04;Lauantai;0;1;1
625;21.01.2017;2017;01;05;Lauantai;1;0;1
625;21.01.2017;2017;01;06;Lauantai;0;0;0
625;21.01.2017;2017;01;07;Lauantai;0;0;0
625;21.01.2017;2017;01;08;Lauantai;1;0;1
625;21.01.2017;2017;01;09;Lauantai;0;1;1
625;21.01.2017;2017;01;10;Lauantai;1;2;3
625;21.01.2017;2017;01;11;Lauantai;1;1;2
625;21.01.2017;2017;01;12;Lauantai;1;3;4
625;21.01.2017;2017;01;13;Lauantai;3;6;9
625;21.01.2017;2017;01;14;Lauantai;0;3;3
625;21.01.2017;2017;01;15;Lauantai;0;5;5
625;21.01.2017;2017;01;16;Lauantai;2;1;3
625;21.01.2017;2017;01;17;Lauantai;2;1;3
625;21.01.2017;2017;01;18;Lauantai;3;1;4
625;21.01.2017;2017;01;19;Lauantai;1;3;4
625;21.01.2017;2017;01;20;Lauantai;0;0;0
625;21.01.2017;2017;01;21;Lauantai;1;1;2
625;21.01.2017;2017;01;22;Lauantai;2;0;2
625;21.01.2017;2017;01;23;Lauantai;0;1;1
625;22.01.2017;2017;01;00;Sunnuntai;0;0;0
625;22.01.2017;2017;01;01;Sunnuntai;1;0;1
625;22.01.2017;2017;01;02;Sunnuntai;0;0;0
625;22.01.2017;2017;01;03;Sunnuntai;1;0;1
625;22.01.2017;2017;01;04;Sunnuntai;0;0;0
625;22.01.2017;2017;01;05;Sunnuntai;0;0;0
625;22.01.2017;2017;01;06;Sunnuntai;0;0;0
625;22.01.2017;2017;01;07;Sunnuntai;0;0;0
625;22.01.2017;2017;01;08;Sunnuntai;1;1;2
625;22.01.2017;2017;01;09;Sunnuntai;0;2;2
625;22.01.2017;2017;01;10;Sunnuntai;2;3;5
625;22.01.2017;2017;01;11;Sunnuntai;2;1;3
625;22.01.2017;2017;01;12;Sunnuntai;2;7;9
625;22.01.2017;2017;01;13;Sunnuntai;3;4;7
625;22.01.2017;2017;01;14;Sunnuntai;2;3;5
625;22.01.2017;2017;01;15;Sunnuntai;5;4;9
625;22.01.2017;2017;01;16;Sunnuntai;4;0;4
625;22.01.2017;2017;01;17;Sunnuntai;0;2;2
625;22.01.2017;2017;01;18;Sunnuntai;2;1;3
625;22.01.2017;2017;01;19;Sunnuntai;1;1;2
625;22.01.2017;2017;01;20;Sunnuntai;1;2;3
625;22.01.2017;2017;01;21;Sunnuntai;2;4;6
625;22.01.2017;2017;01;22;Sunnuntai;2;2;4
625;22.01.2017;2017;01;23;Sunnuntai;1;0;1
625;23.01.2017;2017;01;00;Maanantai;0;1;1
625;23.01.2017;2017;01;01;Maanantai;0;0;0
625;23.01.2017;2017;01;02;Maanantai;0;0;0
625;23.01.2017;2017;01;03;Maanantai;0;0;0
625;23.01.2017;2017;01;04;Maanantai;0;1;1
625;23.01.2017;2017;01;05;Maanantai;1;0;1
625;23.01.2017;2017;01;06;Maanantai;1;0;1
625;23.01.2017;2017;01;07;Maanantai;5;3;8
625;23.01.2017;2017;01;08;Maanantai;30;8;38
625;23.01.2017;2017;01;09;Maanantai;12;12;24
625;23.01.2017;2017;01;10;Maanantai;4;3;7
625;23.01.2017;2017;01;11;Maanantai;2;2;4
625;23.01.2017;2017;01;12;Maanantai;8;5;13
625;23.01.2017;2017;01;13;Maanantai;3;8;11
625;23.01.2017;2017;01;14;Maanantai;10;20;30
625;23.01.2017;2017;01;15;Maanantai;7;18;25
625;23.01.2017;2017;01;16;Maanantai;6;26;32
625;23.01.2017;2017;01;17;Maanantai;10;21;31
625;23.01.2017;2017;01;18;Maanantai;4;8;12
625;23.01.2017;2017;01;19;Maanantai;4;8;12
625;23.01.2017;2017;01;20;Maanantai;1;0;1
625;23.01.2017;2017;01;21;Maanantai;0;3;3
625;23.01.2017;2017;01;22;Maanantai;3;2;5
625;23.01.2017;2017;01;23;Maanantai;2;0;2
625;24.01.2017;2017;01;00;Tiistai;0;0;0
625;24.01.2017;2017;01;01;Tiistai;0;0;0
625;24.01.2017;2017;01;02;Tiistai;0;0;0
625;24.01.2017;2017;01;03;Tiistai;0;0;0
625;24.01.2017;2017;01;04;Tiistai;0;1;1
625;24.01.2017;2017;01;05;Tiistai;0;0;0
625;24.01.2017;2017;01;06;Tiistai;1;2;3
625;24.01.2017;2017;01;07;Tiistai;5;4;9
625;24.01.2017;2017;01;08;Tiistai;24;9;33
625;24.01.2017;2017;01;09;Tiistai;9;8;17
625;24.01.2017;2017;01;10;Tiistai;4;3;7
625;24.01.2017;2017;01;11;Tiistai;9;2;11
625;24.01.2017;2017;01;12;Tiistai;3;6;9
625;24.01.2017;2017;01;13;Tiistai;7;9;16
625;24.01.2017;2017;01;14;Tiistai;2;9;11
625;24.01.2017;2017;01;15;Tiistai;4;29;33
625;24.01.2017;2017;01;16;Tiistai;4;20;24
625;24.01.2017;2017;01;17;Tiistai;6;19;25
625;24.01.2017;2017;01;18;Tiistai;6;7;13
625;24.01.2017;2017;01;19;Tiistai;1;3;4
625;24.01.2017;2017;01;20;Tiistai;2;4;6
625;24.01.2017;2017;01;21;Tiistai;1;2;3
625;24.01.2017;2017;01;22;Tiistai;3;0;3
625;24.01.2017;2017;01;23;Tiistai;2;0;2
625;25.01.2017;2017;01;00;Keskiviikko;1;1;2
625;25.01.2017;2017;01;01;Keskiviikko;0;0;0
625;25.01.2017;2017;01;02;Keskiviikko;0;0;0
625;25.01.2017;2017;01;03;Keskiviikko;0;0;0
625;25.01.2017;2017;01;04;Keskiviikko;0;0;0
625;25.01.2017;2017;01;05;Keskiviikko;1;0;1
625;25.01.2017;2017;01;06;Keskiviikko;1;1;2
625;25.01.2017;2017;01;07;Keskiviikko;5;4;9
625;25.01.2017;2017;01;08;Keskiviikko;19;8;27
625;25.01.2017;2017;01;09;Keskiviikko;13;7;20
625;25.01.2017;2017;01;10;Keskiviikko;13;6;19
625;25.01.2017;2017;01;11;Keskiviikko;7;2;9
625;25.01.2017;2017;01;12;Keskiviikko;5;2;7
625;25.01.2017;2017;01;13;Keskiviikko;3;12;15
625;25.01.2017;2017;01;14;Keskiviikko;2;17;19
625;25.01.2017;2017;01;15;Keskiviikko;3;18;21
625;25.01.2017;2017;01;16;Keskiviikko;4;13;17
625;25.01.2017;2017;01;17;Keskiviikko;6;17;23
625;25.01.2017;2017;01;18;Keskiviikko;2;3;5
625;25.01.2017;2017;01;19;Keskiviikko;4;10;14
625;25.01.2017;2017;01;20;Keskiviikko;2;3;5
625;25.01.2017;2017;01;21;Keskiviikko;3;4;7
625;25.01.2017;2017;01;22;Keskiviikko;3;2;5
625;25.01.2017;2017;01;23;Keskiviikko;1;0;1
625;26.01.2017;2017;01;00;Torstai;2;0;2
625;26.01.2017;2017;01;01;Torstai;1;0;1
625;26.01.2017;2017;01;02;Torstai;0;0;0
625;26.01.2017;2017;01;03;Torstai;1;1;2
625;26.01.2017;2017;01;04;Torstai;0;1;1
625;26.01.2017;2017;01;05;Torstai;2;2;4
625;26.01.2017;2017;01;06;Torstai;1;1;2
625;26.01.2017;2017;01;07;Torstai;4;5;9
625;26.01.2017;2017;01;08;Torstai;13;11;24
625;26.01.2017;2017;01;09;Torstai;18;5;23
625;26.01.2017;2017;01;10;Torstai;14;11;25
625;26.01.2017;2017;01;11;Torstai;2;3;5
625;26.01.2017;2017;01;12;Torstai;4;8;12
625;26.01.2017;2017;01;13;Torstai;4;8;12
625;26.01.2017;2017;01;14;Torstai;3;12;15
625;26.01.2017;2017;01;15;Torstai;5;31;36
625;26.01.2017;2017;01;16;Torstai;3;18;21
625;26.01.2017;2017;01;17;Torstai;13;22;35
625;26.01.2017;2017;01;18;Torstai;2;10;12
625;26.01.2017;2017;01;19;Torstai;4;1;5
625;26.01.2017;2017;01;20;Torstai;1;1;2
625;26.01.2017;2017;01;21;Torstai;4;7;11
625;26.01.2017;2017;01;22;Torstai;0;2;2
625;26.01.2017;2017;01;23;Torstai;1;1;2
625;27.01.2017;2017;01;00;Perjantai;1;0;1
625;27.01.2017;2017;01;01;Perjantai;0;0;0
625;27.01.2017;2017;01;02;Perjantai;1;0;1
625;27.01.2017;2017;01;03;Perjantai;0;0;0
625;27.01.2017;2017;01;04;Perjantai;0;1;1
625;27.01.2017;2017;01;05;Perjantai;1;1;2
625;27.01.2017;2017;01;06;Perjantai;0;2;2
625;27.01.2017;2017;01;07;Perjantai;3;7;10
625;27.01.2017;2017;01;08;Perjantai;33;12;45
625;27.01.2017;2017;01;09;Perjantai;14;10;24
625;27.01.2017;2017;01;10;Perjantai;9;6;15
625;27.01.2017;2017;01;11;Perjantai;3;3;6
625;27.01.2017;2017;01;12;Perjantai;3;12;15
625;27.01.2017;2017;01;13;Perjantai;0;6;6
625;27.01.2017;2017;01;14;Perjantai;4;20;24
625;27.01.2017;2017;01;15;Perjantai;5;21;26
625;27.01.2017;2017;01;16;Perjantai;3;12;15
625;27.01.2017;2017;01;17;Perjantai;11;13;24
625;27.01.2017;2017;01;18;Perjantai;2;8;10
625;27.01.2017;2017;01;19;Perjantai;4;5;9
625;27.01.2017;2017;01;20;Perjantai;1;3;4
625;27.01.2017;2017;01;21;Perjantai;3;2;5
625;27.01.2017;2017;01;22;Perjantai;2;0;2
625;27.01.2017;2017;01;23;Perjantai;0;1;1
625;28.01.2017;2017;01;00;Lauantai;0;0;0
625;28.01.2017;2017;01;01;Lauantai;2;0;2
625;28.01.2017;2017;01;02;Lauantai;0;0;0
625;28.01.2017;2017;01;03;Lauantai;0;1;1
625;28.01.2017;2017;01;04;Lauantai;0;1;1
625;28.01.2017;2017;01;05;Lauantai;1;0;1
625;28.01.2017;2017;01;06;Lauantai;0;0;0
625;28.01.2017;2017;01;07;Lauantai;1;1;2
625;28.01.2017;2017;01;08;Lauantai;0;1;1
625;28.01.2017;2017;01;09;Lauantai;1;1;2
625;28.01.2017;2017;01;10;Lauantai;0;0;0
625;28.01.2017;2017;01;11;Lauantai;1;2;3
625;28.01.2017;2017;01;12;Lauantai;2;2;4
625;28.01.2017;2017;01;13;Lauantai;4;5;9
625;28.01.2017;2017;01;14;Lauantai;0;7;7
625;28.01.2017;2017;01;15;Lauantai;2;7;9
625;28.01.2017;2017;01;16;Lauantai;3;1;4
625;28.01.2017;2017;01;17;Lauantai;2;2;4
625;28.01.2017;2017;01;18;Lauantai;0;5;5
625;28.01.2017;2017;01;19;Lauantai;3;3;6
625;28.01.2017;2017;01;20;Lauantai;1;1;2
625;28.01.2017;2017;01;21;Lauantai;0;1;1
625;28.01.2017;2017;01;22;Lauantai;1;0;1
625;28.01.2017;2017;01;23;Lauantai;0;1;1
625;29.01.2017;2017;01;00;Sunnuntai;0;2;2
625;29.01.2017;2017;01;01;Sunnuntai;2;0;2
625;29.01.2017;2017;01;02;Sunnuntai;3;1;4
625;29.01.2017;2017;01;03;Sunnuntai;0;0;0
625;29.01.2017;2017;01;04;Sunnuntai;0;1;1
625;29.01.2017;2017;01;05;Sunnuntai;0;1;1
625;29.01.2017;2017;01;06;Sunnuntai;0;0;0
625;29.01.2017;2017;01;07;Sunnuntai;1;0;1
625;29.01.2017;2017;01;08;Sunnuntai;0;2;2
625;29.01.2017;2017;01;09;Sunnuntai;1;0;1
625;29.01.2017;2017;01;10;Sunnuntai;1;2;3
625;29.01.2017;2017;01;11;Sunnuntai;2;5;7
625;29.01.2017;2017;01;12;Sunnuntai;2;1;3
625;29.01.2017;2017;01;13;Sunnuntai;2;3;5
625;29.01.2017;2017;01;14;Sunnuntai;1;0;1
625;29.01.2017;2017;01;15;Sunnuntai;1;4;5
625;29.01.2017;2017;01;16;Sunnuntai;1;4;5
625;29.01.2017;2017;01;17;Sunnuntai;1;3;4
625;29.01.2017;2017;01;18;Sunnuntai;2;3;5
625;29.01.2017;2017;01;19;Sunnuntai;1;6;7
625;29.01.2017;2017;01;20;Sunnuntai;1;1;2
625;29.01.2017;2017;01;21;Sunnuntai;3;2;5
625;29.01.2017;2017;01;22;Sunnuntai;1;0;1
625;29.01.2017;2017;01;23;Sunnuntai;0;0;0
625;30.01.2017;2017;01;00;Maanantai;0;0;0
625;30.01.2017;2017;01;01;Maanantai;0;0;0
625;30.01.2017;2017;01;02;Maanantai;0;0;0
625;30.01.2017;2017;01;03;Maanantai;0;0;0
625;30.01.2017;2017;01;04;Maanantai;0;0;0
625;30.01.2017;2017;01;05;Maanantai;0;0;0
625;30.01.2017;2017;01;06;Maanantai;0;2;2
625;30.01.2017;2017;01;07;Maanantai;5;2;7
625;30.01.2017;2017;01;08;Maanantai;23;8;31
625;30.01.2017;2017;01;09;Maanantai;21;10;31
625;30.01.2017;2017;01;10;Maanantai;10;4;14
625;30.01.2017;2017;01;11;Maanantai;4;0;4
625;30.01.2017;2017;01;12;Maanantai;8;2;10
625;30.01.2017;2017;01;13;Maanantai;2;10;12
625;30.01.2017;2017;01;14;Maanantai;5;15;20
625;30.01.2017;2017;01;15;Maanantai;11;25;36
625;30.01.2017;2017;01;16;Maanantai;2;18;20
625;30.01.2017;2017;01;17;Maanantai;8;19;27
625;30.01.2017;2017;01;18;Maanantai;3;12;15
625;30.01.2017;2017;01;19;Maanantai;2;6;8
625;30.01.2017;2017;01;20;Maanantai;2;2;4
625;30.01.2017;2017;01;21;Maanantai;3;6;9
625;30.01.2017;2017;01;22;Maanantai;1;5;6
625;30.01.2017;2017;01;23;Maanantai;1;0;1
625;31.01.2017;2017;01;00;Tiistai;1;0;1
625;31.01.2017;2017;01;01;Tiistai;0;0;0
625;31.01.2017;2017;01;02;Tiistai;0;0;0
625;31.01.2017;2017;01;03;Tiistai;0;0;0
625;31.01.2017;2017;01;04;Tiistai;0;0;0
625;31.01.2017;2017;01;05;Tiistai;0;0;0
625;31.01.2017;2017;01;06;Tiistai;0;2;2
625;31.01.2017;2017;01;07;Tiistai;3;3;6
625;31.01.2017;2017;01;08;Tiistai;21;7;28
625;31.01.2017;2017;01;09;Tiistai;10;13;23
625;31.01.2017;2017;01;10;Tiistai;2;3;5
625;31.01.2017;2017;01;11;Tiistai;6;0;6
625;31.01.2017;2017;01;12;Tiistai;4;5;9
625;31.01.2017;2017;01;13;Tiistai;2;11;13
625;31.01.2017;2017;01;14;Tiistai;4;16;20
625;31.01.2017;2017;01;15;Tiistai;5;22;27
625;31.01.2017;2017;01;16;Tiistai;6;19;25
625;31.01.2017;2017;01;17;Tiistai;11;19;30
625;31.01.2017;2017;01;18;Tiistai;2;10;12
625;31.01.2017;2017;01;19;Tiistai;1;8;9
625;31.01.2017;2017;01;20;Tiistai;4;2;6
625;31.01.2017;2017;01;21;Tiistai;1;5;6
625;31.01.2017;2017;01;22;Tiistai;1;3;4
625;31.01.2017;2017;01;23;Tiistai;0;1;1
625;01.02.2017;2017;02;00;Keskiviikko;1;0;1
625;01.02.2017;2017;02;01;Keskiviikko;0;0;0
625;01.02.2017;2017;02;02;Keskiviikko;0;1;1
625;01.02.2017;2017;02;03;Keskiviikko;0;0;0
625;01.02.2017;2017;02;04;Keskiviikko;0;0;0
625;01.02.2017;2017;02;05;Keskiviikko;0;0;0
625;01.02.2017;2017;02;06;Keskiviikko;0;2;2
625;01.02.2017;2017;02;07;Keskiviikko;3;5;8
625;01.02.2017;2017;02;08;Keskiviikko;19;11;30
625;01.02.2017;2017;02;09;Keskiviikko;9;8;17
625;01.02.2017;2017;02;10;Keskiviikko;6;3;9
625;01.02.2017;2017;02;11;Keskiviikko;2;1;3
625;01.02.2017;2017;02;12;Keskiviikko;2;7;9
625;01.02.2017;2017;02;13;Keskiviikko;2;6;8
625;01.02.2017;2017;02;14;Keskiviikko;6;23;29
625;01.02.2017;2017;02;15;Keskiviikko;6;18;24
625;01.02.2017;2017;02;16;Keskiviikko;6;23;29
625;01.02.2017;2017;02;17;Keskiviikko;4;16;20
625;01.02.2017;2017;02;18;Keskiviikko;2;6;8
625;01.02.2017;2017;02;19;Keskiviikko;2;7;9
625;01.02.2017;2017;02;20;Keskiviikko;1;2;3
625;01.02.2017;2017;02;21;Keskiviikko;1;2;3
625;01.02.2017;2017;02;22;Keskiviikko;2;1;3
625;01.02.2017;2017;02;23;Keskiviikko;0;1;1
625;02.02.2017;2017;02;00;Torstai;0;1;1
625;02.02.2017;2017;02;01;Torstai;0;0;0
625;02.02.2017;2017;02;02;Torstai;0;0;0
625;02.02.2017;2017;02;03;Torstai;0;0;0
625;02.02.2017;2017;02;04;Torstai;0;0;0
625;02.02.2017;2017;02;05;Torstai;1;0;1
625;02.02.2017;2017;02;06;Torstai;1;1;2
625;02.02.2017;2017;02;07;Torstai;4;4;8
625;02.02.2017;2017;02;08;Torstai;14;11;25
625;02.02.2017;2017;02;09;Torstai;13;5;18
625;02.02.2017;2017;02;10;Torstai;3;1;4
625;02.02.2017;2017;02;11;Torstai;3;0;3
625;02.02.2017;2017;02;12;Torstai;2;5;7
625;02.02.2017;2017;02;13;Torstai;0;4;4
625;02.02.2017;2017;02;14;Torstai;6;16;22
625;02.02.2017;2017;02;15;Torstai;3;14;17
625;02.02.2017;2017;02;16;Torstai;4;23;27
625;02.02.2017;2017;02;17;Torstai;4;14;18
625;02.02.2017;2017;02;18;Torstai;7;8;15
625;02.02.2017;2017;02;19;Torstai;2;3;5
625;02.02.2017;2017;02;20;Torstai;1;5;6
625;02.02.2017;2017;02;21;Torstai;0;3;3
625;02.02.2017;2017;02;22;Torstai;1;0;1
625;02.02.2017;2017;02;23;Torstai;0;0;0
625;03.02.2017;2017;02;00;Perjantai;2;0;2
625;03.02.2017;2017;02;01;Perjantai;1;0;1
625;03.02.2017;2017;02;02;Perjantai;0;0;0
625;03.02.2017;2017;02;03;Perjantai;0;0;0
625;03.02.2017;2017;02;04;Perjantai;0;0;0
625;03.02.2017;2017;02;05;Perjantai;0;0;0
625;03.02.2017;2017;02;06;Perjantai;1;0;1
625;03.02.2017;2017;02;07;Perjantai;2;2;4
625;03.02.2017;2017;02;08;Perjantai;17;7;24
625;03.02.2017;2017;02;09;Perjantai;12;8;20
625;03.02.2017;2017;02;10;Perjantai;6;4;10
625;03.02.2017;2017;02;11;Perjantai;3;3;6
625;03.02.2017;2017;02;12;Perjantai;1;10;11
625;03.02.2017;2017;02;13;Perjantai;1;10;11
625;03.02.2017;2017;02;14;Perjantai;3;16;19
625;03.02.2017;2017;02;15;Perjantai;3;16;19
625;03.02.2017;2017;02;16;Perjantai;2;9;11
625;03.02.2017;2017;02;17;Perjantai;2;7;9
625;03.02.2017;2017;02;18;Perjantai;2;2;4
625;03.02.2017;2017;02;19;Perjantai;1;0;1
625;03.02.2017;2017;02;20;Perjantai;0;2;2
625;03.02.2017;2017;02;21;Perjantai;1;1;2
625;03.02.2017;2017;02;22;Perjantai;0;1;1
625;03.02.2017;2017;02;23;Perjantai;0;0;0
625;04.02.2017;2017;02;00;Lauantai;1;0;1
625;04.02.2017;2017;02;01;Lauantai;0;0;0
625;04.02.2017;2017;02;02;Lauantai;0;0;0
625;04.02.2017;2017;02;03;Lauantai;0;0;0
625;04.02.2017;2017;02;04;Lauantai;0;0;0
625;04.02.2017;2017;02;05;Lauantai;0;0;0
625;04.02.2017;2017;02;06;Lauantai;0;1;1
625;04.02.2017;2017;02;07;Lauantai;0;0;0
625;04.02.2017;2017;02;08;Lauantai;0;0;0
625;04.02.2017;2017;02;09;Lauantai;3;0;3
625;04.02.2017;2017;02;10;Lauantai;0;2;2
625;04.02.2017;2017;02;11;Lauantai;1;5;6
625;04.02.2017;2017;02;12;Lauantai;2;0;2
625;04.02.2017;2017;02;13;Lauantai;2;1;3
625;04.02.2017;2017;02;14;Lauantai;3;4;7
625;04.02.2017;2017;02;15;Lauantai;0;1;1
625;04.02.2017;2017;02;16;Lauantai;0;4;4
625;04.02.2017;2017;02;17;Lauantai;1;2;3
625;04.02.2017;2017;02;18;Lauantai;0;2;2
625;04.02.2017;2017;02;19;Lauantai;1;4;5
625;04.02.2017;2017;02;20;Lauantai;1;1;2
625;04.02.2017;2017;02;21;Lauantai;1;2;3
625;04.02.2017;2017;02;22;Lauantai;0;0;0
625;04.02.2017;2017;02;23;Lauantai;0;0;0
625;05.02.2017;2017;02;00;Sunnuntai;1;0;1
625;05.02.2017;2017;02;01;Sunnuntai;0;2;2
625;05.02.2017;2017;02;02;Sunnuntai;1;2;3
625;05.02.2017;2017;02;03;Sunnuntai;0;0;0
625;05.02.2017;2017;02;04;Sunnuntai;0;0;0
625;05.02.2017;2017;02;05;Sunnuntai;0;0;0
625;05.02.2017;2017;02;06;Sunnuntai;0;1;1
625;05.02.2017;2017;02;07;Sunnuntai;0;0;0
625;05.02.2017;2017;02;08;Sunnuntai;1;2;3
625;05.02.2017;2017;02;09;Sunnuntai;0;1;1
625;05.02.2017;2017;02;10;Sunnuntai;2;0;2
625;05.02.2017;2017;02;11;Sunnuntai;1;0;1
625;05.02.2017;2017;02;12;Sunnuntai;2;3;5
625;05.02.2017;2017;02;13;Sunnuntai;3;8;11
625;05.02.2017;2017;02;14;Sunnuntai;1;2;3
625;05.02.2017;2017;02;15;Sunnuntai;0;2;2
625;05.02.2017;2017;02;16;Sunnuntai;0;2;2
625;05.02.2017;2017;02;17;Sunnuntai;1;1;2
625;05.02.2017;2017;02;18;Sunnuntai;0;6;6
625;05.02.2017;2017;02;19;Sunnuntai;2;2;4
625;05.02.2017;2017;02;20;Sunnuntai;0;3;3
625;05.02.2017;2017;02;21;Sunnuntai;0;3;3
625;05.02.2017;2017;02;22;Sunnuntai;0;0;0
625;05.02.2017;2017;02;23;Sunnuntai;0;0;0
625;06.02.2017;2017;02;00;Maanantai;1;0;1
625;06.02.2017;2017;02;01;Maanantai;0;0;0
625;06.02.2017;2017;02;02;Maanantai;1;0;1
625;06.02.2017;2017;02;03;Maanantai;0;0;0
625;06.02.2017;2017;02;04;Maanantai;0;0;0
625;06.02.2017;2017;02;05;Maanantai;0;0;0
625;06.02.2017;2017;02;06;Maanantai;1;2;3
625;06.02.2017;2017;02;07;Maanantai;1;2;3
625;06.02.2017;2017;02;08;Maanantai;17;4;21
625;06.02.2017;2017;02;09;Maanantai;7;11;18
625;06.02.2017;2017;02;10;Maanantai;5;3;8
625;06.02.2017;2017;02;11;Maanantai;4;1;5
625;06.02.2017;2017;02;12;Maanantai;3;0;3
625;06.02.2017;2017;02;13;Maanantai;0;4;4
625;06.02.2017;2017;02;14;Maanantai;2;7;9
625;06.02.2017;2017;02;15;Maanantai;0;0;0
625;06.02.2017;2017;02;16;Maanantai;4;48;52
625;06.02.2017;2017;02;17;Maanantai;6;17;23
625;06.02.2017;2017;02;18;Maanantai;3;9;12
625;06.02.2017;2017;02;19;Maanantai;1;5;6
625;06.02.2017;2017;02;20;Maanantai;0;1;1
625;06.02.2017;2017;02;21;Maanantai;1;3;4
625;06.02.2017;2017;02;22;Maanantai;0;1;1
625;06.02.2017;2017;02;23;Maanantai;2;2;4
625;07.02.2017;2017;02;00;Tiistai;0;0;0
625;07.02.2017;2017;02;01;Tiistai;0;0;0
625;07.02.2017;2017;02;02;Tiistai;0;0;0
625;07.02.2017;2017;02;03;Tiistai;0;0;0
625;07.02.2017;2017;02;04;Tiistai;0;1;1
625;07.02.2017;2017;02;05;Tiistai;1;0;1
625;07.02.2017;2017;02;06;Tiistai;2;1;3
625;07.02.2017;2017;02;07;Tiistai;4;5;9
625;07.02.2017;2017;02;08;Tiistai;7;4;11
625;07.02.2017;2017;02;09;Tiistai;8;11;19
625;07.02.2017;2017;02;10;Tiistai;10;4;14
625;07.02.2017;2017;02;11;Tiistai;9;1;10
625;07.02.2017;2017;02;12;Tiistai;1;1;2
625;07.02.2017;2017;02;13;Tiistai;3;7;10
625;07.02.2017;2017;02;14;Tiistai;4;15;19
625;07.02.2017;2017;02;15;Tiistai;0;11;11
625;07.02.2017;2017;02;16;Tiistai;5;18;23
625;07.02.2017;2017;02;17;Tiistai;7;10;17
625;07.02.2017;2017;02;18;Tiistai;4;7;11
625;07.02.2017;2017;02;19;Tiistai;2;3;5
625;07.02.2017;2017;02;20;Tiistai;1;5;6
625;07.02.2017;2017;02;21;Tiistai;0;2;2
625;07.02.2017;2017;02;22;Tiistai;2;3;5
625;07.02.2017;2017;02;23;Tiistai;1;0;1
625;08.02.2017;2017;02;00;Keskiviikko;0;0;0
625;08.02.2017;2017;02;01;Keskiviikko;0;0;0
625;08.02.2017;2017;02;02;Keskiviikko;0;0;0
625;08.02.2017;2017;02;03;Keskiviikko;0;0;0
625;08.02.2017;2017;02;04;Keskiviikko;0;0;0
625;08.02.2017;2017;02;05;Keskiviikko;1;0;1
625;08.02.2017;2017;02;06;Keskiviikko;1;1;2
625;08.02.2017;2017;02;07;Keskiviikko;2;5;7
625;08.02.2017;2017;02;08;Keskiviikko;17;0;17
625;08.02.2017;2017;02;09;Keskiviikko;10;7;17
625;08.02.2017;2017;02;10;Keskiviikko;5;1;6
625;08.02.2017;2017;02;11;Keskiviikko;1;1;2
625;08.02.2017;2017;02;12;Keskiviikko;1;5;6
625;08.02.2017;2017;02;13;Keskiviikko;5;6;11
625;08.02.2017;2017;02;14;Keskiviikko;3;10;13
625;08.02.2017;2017;02;15;Keskiviikko;6;15;21
625;08.02.2017;2017;02;16;Keskiviikko;2;14;16
625;08.02.2017;2017;02;17;Keskiviikko;5;14;19
625;08.02.2017;2017;02;18;Keskiviikko;5;8;13
625;08.02.2017;2017;02;19;Keskiviikko;0;5;5
625;08.02.2017;2017;02;20;Keskiviikko;2;1;3
625;08.02.2017;2017;02;21;Keskiviikko;2;3;5
625;08.02.2017;2017;02;22;Keskiviikko;0;1;1
625;08.02.2017;2017;02;23;Keskiviikko;1;1;2
625;09.02.2017;2017;02;00;Torstai;1;0;1
625;09.02.2017;2017;02;01;Torstai;0;1;1
625;09.02.2017;2017;02;02;Torstai;0;0;0
625;09.02.2017;2017;02;03;Torstai;0;1;1
625;09.02.2017;2017;02;04;Torstai;0;0;0
625;09.02.2017;2017;02;05;Torstai;1;0;1
625;09.02.2017;2017;02;06;Torstai;2;0;2
625;09.02.2017;2017;02;07;Torstai;2;5;7
625;09.02.2017;2017;02;08;Torstai;8;2;10
625;09.02.2017;2017;02;09;Torstai;10;5;15
625;09.02.2017;2017;02;10;Torstai;5;2;7
625;09.02.2017;2017;02;11;Torstai;3;2;5
625;09.02.2017;2017;02;12;Torstai;6;3;9
625;09.02.2017;2017;02;13;Torstai;3;4;7
625;09.02.2017;2017;02;14;Torstai;5;10;15
625;09.02.2017;2017;02;15;Torstai;2;12;14
625;09.02.2017;2017;02;16;Torstai;6;18;24
625;09.02.2017;2017;02;17;Torstai;8;15;23
625;09.02.2017;2017;02;18;Torstai;2;5;7
625;09.02.2017;2017;02;19;Torstai;1;5;6
625;09.02.2017;2017;02;20;Torstai;2;0;2
625;09.02.2017;2017;02;21;Torstai;0;3;3
625;09.02.2017;2017;02;22;Torstai;1;1;2
625;09.02.2017;2017;02;23;Torstai;0;0;0
625;10.02.2017;2017;02;00;Perjantai;1;0;1
625;10.02.2017;2017;02;01;Perjantai;0;0;0
625;10.02.2017;2017;02;02;Perjantai;0;0;0
625;10.02.2017;2017;02;03;Perjantai;0;0;0
625;10.02.2017;2017;02;04;Perjantai;0;1;1
625;10.02.2017;2017;02;05;Perjantai;0;0;0
625;10.02.2017;2017;02;06;Perjantai;1;1;2
625;10.02.2017;2017;02;07;Perjantai;2;5;7
625;10.02.2017;2017;02;08;Perjantai;22;5;27
625;10.02.2017;2017;02;09;Perjantai;12;5;17
625;10.02.2017;2017;02;10;Perjantai;7;3;10
625;10.02.2017;2017;02;11;Perjantai;7;5;12
625;10.02.2017;2017;02;12;Perjantai;6;6;12
625;10.02.2017;2017;02;13;Perjantai;3;14;17
625;10.02.2017;2017;02;14;Perjantai;7;18;25
625;10.02.2017;2017;02;15;Perjantai;6;19;25
625;10.02.2017;2017;02;16;Perjantai;6;15;21
625;10.02.2017;2017;02;17;Perjantai;6;12;18
625;10.02.2017;2017;02;18;Perjantai;4;6;10
625;10.02.2017;2017;02;19;Perjantai;2;6;8
625;10.02.2017;2017;02;20;Perjantai;1;7;8
625;10.02.2017;2017;02;21;Perjantai;1;1;2
625;10.02.2017;2017;02;22;Perjantai;2;2;4
625;10.02.2017;2017;02;23;Perjantai;2;1;3
625;11.02.2017;2017;02;00;Lauantai;1;0;1
625;11.02.2017;2017;02;01;Lauantai;0;0;0
625;11.02.2017;2017;02;02;Lauantai;1;1;2
625;11.02.2017;2017;02;03;Lauantai;0;0;0
625;11.02.2017;2017;02;04;Lauantai;0;0;0
625;11.02.2017;2017;02;05;Lauantai;0;0;0
625;11.02.2017;2017;02;06;Lauantai;0;0;0
625;11.02.2017;2017;02;07;Lauantai;0;1;1
625;11.02.2017;2017;02;08;Lauantai;0;3;3
625;11.02.2017;2017;02;09;Lauantai;1;1;2
625;11.02.2017;2017;02;10;Lauantai;1;0;1
625;11.02.2017;2017;02;11;Lauantai;1;3;4
625;11.02.2017;2017;02;12;Lauantai;1;1;2
625;11.02.2017;2017;02;13;Lauantai;2;1;3
625;11.02.2017;2017;02;14;Lauantai;3;3;6
625;11.02.2017;2017;02;15;Lauantai;3;3;6
625;11.02.2017;2017;02;16;Lauantai;1;2;3
625;11.02.2017;2017;02;17;Lauantai;2;4;6
625;11.02.2017;2017;02;18;Lauantai;2;3;5
625;11.02.2017;2017;02;19;Lauantai;1;1;2
625;11.02.2017;2017;02;20;Lauantai;3;2;5
625;11.02.2017;2017;02;21;Lauantai;1;4;5
625;11.02.2017;2017;02;22;Lauantai;1;0;1
625;11.02.2017;2017;02;23;Lauantai;1;0;1
625;12.02.2017;2017;02;00;Sunnuntai;1;1;2
625;12.02.2017;2017;02;01;Sunnuntai;0;0;0
625;12.02.2017;2017;02;02;Sunnuntai;0;0;0
625;12.02.2017;2017;02;03;Sunnuntai;0;0;0
625;12.02.2017;2017;02;04;Sunnuntai;0;0;0
625;12.02.2017;2017;02;05;Sunnuntai;0;0;0
625;12.02.2017;2017;02;06;Sunnuntai;0;0;0
625;12.02.2017;2017;02;07;Sunnuntai;0;0;0
625;12.02.2017;2017;02;08;Sunnuntai;0;1;1
625;12.02.2017;2017;02;09;Sunnuntai;0;0;0
625;12.02.2017;2017;02;10;Sunnuntai;0;1;1
625;12.02.2017;2017;02;11;Sunnuntai;1;0;1
625;12.02.2017;2017;02;12;Sunnuntai;1;3;4
625;12.02.2017;2017;02;13;Sunnuntai;7;2;9
625;12.02.2017;2017;02;14;Sunnuntai;5;3;8
625;12.02.2017;2017;02;15;Sunnuntai;2;2;4
625;12.02.2017;2017;02;16;Sunnuntai;5;3;8
625;12.02.2017;2017;02;17;Sunnuntai;0;7;7
625;12.02.2017;2017;02;18;Sunnuntai;0;2;2
625;12.02.2017;2017;02;19;Sunnuntai;0;2;2
625;12.02.2017;2017;02;20;Sunnuntai;1;4;5
625;12.02.2017;2017;02;21;Sunnuntai;1;0;1
625;12.02.2017;2017;02;22;Sunnuntai;0;1;1
625;12.02.2017;2017;02;23;Sunnuntai;0;0;0
625;13.02.2017;2017;02;00;Maanantai;0;0;0
625;13.02.2017;2017;02;01;Maanantai;0;0;0
625;13.02.2017;2017;02;02;Maanantai;0;0;0
625;13.02.2017;2017;02;03;Maanantai;0;0;0
625;13.02.2017;2017;02;04;Maanantai;0;0;0
625;13.02.2017;2017;02;05;Maanantai;0;0;0
625;13.02.2017;2017;02;06;Maanantai;2;1;3
625;13.02.2017;2017;02;07;Maanantai;2;1;3
625;13.02.2017;2017;02;08;Maanantai;22;15;37
625;13.02.2017;2017;02;09;Maanantai;7;5;12
625;13.02.2017;2017;02;10;Maanantai;6;4;10
625;13.02.2017;2017;02;11;Maanantai;2;4;6
625;13.02.2017;2017;02;12;Maanantai;5;2;7
625;13.02.2017;2017;02;13;Maanantai;8;6;14
625;13.02.2017;2017;02;14;Maanantai;4;12;16
625;13.02.2017;2017;02;15;Maanantai;8;23;31
625;13.02.2017;2017;02;16;Maanantai;5;16;21
625;13.02.2017;2017;02;17;Maanantai;7;14;21
625;13.02.2017;2017;02;18;Maanantai;3;14;17
625;13.02.2017;2017;02;19;Maanantai;2;7;9
625;13.02.2017;2017;02;20;Maanantai;1;4;5
625;13.02.2017;2017;02;21;Maanantai;0;3;3
625;13.02.2017;2017;02;22;Maanantai;1;0;1
625;13.02.2017;2017;02;23;Maanantai;0;1;1
625;14.02.2017;2017;02;00;Tiistai;0;2;2
625;14.02.2017;2017;02;01;Tiistai;0;0;0
625;14.02.2017;2017;02;02;Tiistai;0;0;0
625;14.02.2017;2017;02;03;Tiistai;0;0;0
625;14.02.2017;2017;02;04;Tiistai;0;0;0
625;14.02.2017;2017;02;05;Tiistai;1;1;2
625;14.02.2017;2017;02;06;Tiistai;0;1;1
625;14.02.2017;2017;02;07;Tiistai;6;3;9
625;14.02.2017;2017;02;08;Tiistai;15;11;26
625;14.02.2017;2017;02;09;Tiistai;15;11;26
625;14.02.2017;2017;02;10;Tiistai;3;4;7
625;14.02.2017;2017;02;11;Tiistai;5;2;7
625;14.02.2017;2017;02;12;Tiistai;1;6;7
625;14.02.2017;2017;02;13;Tiistai;4;7;11
625;14.02.2017;2017;02;14;Tiistai;5;12;17
625;14.02.2017;2017;02;15;Tiistai;9;20;29
625;14.02.2017;2017;02;16;Tiistai;3;21;24
625;14.02.2017;2017;02;17;Tiistai;5;24;29
625;14.02.2017;2017;02;18;Tiistai;5;5;10
625;14.02.2017;2017;02;19;Tiistai;2;5;7
625;14.02.2017;2017;02;20;Tiistai;2;5;7
625;14.02.2017;2017;02;21;Tiistai;1;0;1
625;14.02.2017;2017;02;22;Tiistai;1;4;5
625;14.02.2017;2017;02;23;Tiistai;0;1;1
625;15.02.2017;2017;02;00;Keskiviikko;0;0;0
625;15.02.2017;2017;02;01;Keskiviikko;0;1;1
625;15.02.2017;2017;02;02;Keskiviikko;0;1;1
625;15.02.2017;2017;02;03;Keskiviikko;0;0;0
625;15.02.2017;2017;02;04;Keskiviikko;0;0;0
625;15.02.2017;2017;02;05;Keskiviikko;0;0;0
625;15.02.2017;2017;02;06;Keskiviikko;1;2;3
625;15.02.2017;2017;02;07;Keskiviikko;2;3;5
625;15.02.2017;2017;02;08;Keskiviikko;19;15;34
625;15.02.2017;2017;02;09;Keskiviikko;13;6;19
625;15.02.2017;2017;02;10;Keskiviikko;9;4;13
625;15.02.2017;2017;02;11;Keskiviikko;3;4;7
625;15.02.2017;2017;02;12;Keskiviikko;6;8;14
625;15.02.2017;2017;02;13;Keskiviikko;2;9;11
625;15.02.2017;2017;02;14;Keskiviikko;1;13;14
625;15.02.2017;2017;02;15;Keskiviikko;8;26;34
625;15.02.2017;2017;02;16;Keskiviikko;4;13;17
625;15.02.2017;2017;02;17;Keskiviikko;7;19;26
625;15.02.2017;2017;02;18;Keskiviikko;5;7;12
625;15.02.2017;2017;02;19;Keskiviikko;5;7;12
625;15.02.2017;2017;02;20;Keskiviikko;3;6;9
625;15.02.2017;2017;02;21;Keskiviikko;3;3;6
625;15.02.2017;2017;02;22;Keskiviikko;1;0;1
625;15.02.2017;2017;02;23;Keskiviikko;2;1;3
625;16.02.2017;2017;02;00;Torstai;1;2;3
625;16.02.2017;2017;02;01;Torstai;0;0;0
625;16.02.2017;2017;02;02;Torstai;0;0;0
625;16.02.2017;2017;02;03;Torstai;0;0;0
625;16.02.2017;2017;02;04;Torstai;0;0;0
625;16.02.2017;2017;02;05;Torstai;0;1;1
625;16.02.2017;2017;02;06;Torstai;2;3;5
625;16.02.2017;2017;02;07;Torstai;3;6;9
625;16.02.2017;2017;02;08;Torstai;17;9;26
625;16.02.2017;2017;02;09;Torstai;14;5;19
625;16.02.2017;2017;02;10;Torstai;6;3;9
625;16.02.2017;2017;02;11;Torstai;3;2;5
625;16.02.2017;2017;02;12;Torstai;6;7;13
625;16.02.2017;2017;02;13;Torstai;4;4;8
625;16.02.2017;2017;02;14;Torstai;3;12;15
625;16.02.2017;2017;02;15;Torstai;2;20;22
625;16.02.2017;2017;02;16;Torstai;5;14;19
625;16.02.2017;2017;02;17;Torstai;7;9;16
625;16.02.2017;2017;02;18;Torstai;3;1;4
625;16.02.2017;2017;02;19;Torstai;3;6;9
625;16.02.2017;2017;02;20;Torstai;2;7;9
625;16.02.2017;2017;02;21;Torstai;1;5;6
625;16.02.2017;2017;02;22;Torstai;2;1;3
625;16.02.2017;2017;02;23;Torstai;1;1;2
625;17.02.2017;2017;02;00;Perjantai;1;1;2
625;17.02.2017;2017;02;01;Perjantai;0;0;0
625;17.02.2017;2017;02;02;Perjantai;1;0;1
625;17.02.2017;2017;02;03;Perjantai;0;0;0
625;17.02.2017;2017;02;04;Perjantai;0;0;0
625;17.02.2017;2017;02;05;Perjantai;0;1;1
625;17.02.2017;2017;02;06;Perjantai;2;2;4
625;17.02.2017;2017;02;07;Perjantai;2;4;6
625;17.02.2017;2017;02;08;Perjantai;21;8;29
625;17.02.2017;2017;02;09;Perjantai;14;6;20
625;17.02.2017;2017;02;10;Perjantai;6;3;9
625;17.02.2017;2017;02;11;Perjantai;1;3;4
625;17.02.2017;2017;02;12;Perjantai;2;6;8
625;17.02.2017;2017;02;13;Perjantai;4;6;10
625;17.02.2017;2017;02;14;Perjantai;6;23;29
625;17.02.2017;2017;02;15;Perjantai;2;14;16
625;17.02.2017;2017;02;16;Perjantai;3;9;12
625;17.02.2017;2017;02;17;Perjantai;4;10;14
625;17.02.2017;2017;02;18;Perjantai;1;3;4
625;17.02.2017;2017;02;19;Perjantai;1;3;4
625;17.02.2017;2017;02;20;Perjantai;0;4;4
625;17.02.2017;2017;02;21;Perjantai;2;0;2
625;17.02.2017;2017;02;22;Perjantai;1;5;6
625;17.02.2017;2017;02;23;Perjantai;0;2;2
625;18.02.2017;2017;02;00;Lauantai;0;1;1
625;18.02.2017;2017;02;01;Lauantai;0;0;0
625;18.02.2017;2017;02;02;Lauantai;0;0;0
625;18.02.2017;2017;02;03;Lauantai;0;0;0
625;18.02.2017;2017;02;04;Lauantai;0;0;0
625;18.02.2017;2017;02;05;Lauantai;0;0;0
625;18.02.2017;2017;02;06;Lauantai;0;1;1
625;18.02.2017;2017;02;07;Lauantai;0;0;0
625;18.02.2017;2017;02;08;Lauantai;0;0;0
625;18.02.2017;2017;02;09;Lauantai;3;0;3
625;18.02.2017;2017;02;10;Lauantai;1;0;1
625;18.02.2017;2017;02;11;Lauantai;2;5;7
625;18.02.2017;2017;02;12;Lauantai;1;6;7
625;18.02.2017;2017;02;13;Lauantai;2;7;9
625;18.02.2017;2017;02;14;Lauantai;4;7;11
625;18.02.2017;2017;02;15;Lauantai;3;3;6
625;18.02.2017;2017;02;16;Lauantai;3;3;6
625;18.02.2017;2017;02;17;Lauantai;2;5;7
625;18.02.2017;2017;02;18;Lauantai;1;0;1
625;18.02.2017;2017;02;19;Lauantai;0;4;4
625;18.02.2017;2017;02;20;Lauantai;2;5;7
625;18.02.2017;2017;02;21;Lauantai;0;0;0
625;18.02.2017;2017;02;22;Lauantai;0;1;1
625;18.02.2017;2017;02;23;Lauantai;2;0;2
625;19.02.2017;2017;02;00;Sunnuntai;0;1;1
625;19.02.2017;2017;02;01;Sunnuntai;0;0;0
625;19.02.2017;2017;02;02;Sunnuntai;0;0;0
625;19.02.2017;2017;02;03;Sunnuntai;0;0;0
625;19.02.2017;2017;02;04;Sunnuntai;0;0;0
625;19.02.2017;2017;02;05;Sunnuntai;0;1;1
625;19.02.2017;2017;02;06;Sunnuntai;0;0;0
625;19.02.2017;2017;02;07;Sunnuntai;1;0;1
625;19.02.2017;2017;02;08;Sunnuntai;0;1;1
625;19.02.2017;2017;02;09;Sunnuntai;0;0;0
625;19.02.2017;2017;02;10;Sunnuntai;0;2;2
625;19.02.2017;2017;02;11;Sunnuntai;0;3;3
625;19.02.2017;2017;02;12;Sunnuntai;5;3;8
625;19.02.2017;2017;02;13;Sunnuntai;2;9;11
625;19.02.2017;2017;02;14;Sunnuntai;3;1;4
625;19.02.2017;2017;02;15;Sunnuntai;1;5;6
625;19.02.2017;2017;02;16;Sunnuntai;1;3;4
625;19.02.2017;2017;02;17;Sunnuntai;1;2;3
625;19.02.2017;2017;02;18;Sunnuntai;3;4;7
625;19.02.2017;2017;02;19;Sunnuntai;1;2;3
625;19.02.2017;2017;02;20;Sunnuntai;0;3;3
625;19.02.2017;2017;02;21;Sunnuntai;1;2;3
625;19.02.2017;2017;02;22;Sunnuntai;0;0;0
625;19.02.2017;2017;02;23;Sunnuntai;0;1;1
625;20.02.2017;2017;02;00;Maanantai;0;1;1
625;20.02.2017;2017;02;01;Maanantai;0;0;0
625;20.02.2017;2017;02;02;Maanantai;0;0;0
625;20.02.2017;2017;02;03;Maanantai;0;0;0
625;20.02.2017;2017;02;04;Maanantai;0;0;0
625;20.02.2017;2017;02;05;Maanantai;1;1;2
625;20.02.2017;2017;02;06;Maanantai;2;1;3
625;20.02.2017;2017;02;07;Maanantai;0;2;2
625;20.02.2017;2017;02;08;Maanantai;15;16;31
625;20.02.2017;2017;02;09;Maanantai;10;5;15
625;20.02.2017;2017;02;10;Maanantai;10;1;11
625;20.02.2017;2017;02;11;Maanantai;7;4;11
625;20.02.2017;2017;02;12;Maanantai;1;6;7
625;20.02.2017;2017;02;13;Maanantai;5;7;12
625;20.02.2017;2017;02;14;Maanantai;3;8;11
625;20.02.2017;2017;02;15;Maanantai;3;18;21
625;20.02.2017;2017;02;16;Maanantai;3;15;18
625;20.02.2017;2017;02;17;Maanantai;5;20;25
625;20.02.2017;2017;02;18;Maanantai;9;3;12
625;20.02.2017;2017;02;19;Maanantai;2;5;7
625;20.02.2017;2017;02;20;Maanantai;3;1;4
625;20.02.2017;2017;02;21;Maanantai;1;2;3
625;20.02.2017;2017;02;22;Maanantai;2;1;3
625;20.02.2017;2017;02;23;Maanantai;1;0;1
625;21.02.2017;2017;02;00;Tiistai;0;0;0
625;21.02.2017;2017;02;01;Tiistai;0;0;0
625;21.02.2017;2017;02;02;Tiistai;0;0;0
625;21.02.2017;2017;02;03;Tiistai;0;0;0
625;21.02.2017;2017;02;04;Tiistai;0;1;1
625;21.02.2017;2017;02;05;Tiistai;1;0;1
625;21.02.2017;2017;02;06;Tiistai;0;0;0
625;21.02.2017;2017;02;07;Tiistai;3;2;5
625;21.02.2017;2017;02;08;Tiistai;20;14;34
625;21.02.2017;2017;02;09;Tiistai;8;8;16
625;21.02.2017;2017;02;10;Tiistai;4;1;5
625;21.02.2017;2017;02;11;Tiistai;7;0;7
625;21.02.2017;2017;02;12;Tiistai;5;6;11
625;21.02.2017;2017;02;13;Tiistai;2;5;7
625;21.02.2017;2017;02;14;Tiistai;1;9;10
625;21.02.2017;2017;02;15;Tiistai;5;22;27
625;21.02.2017;2017;02;16;Tiistai;3;19;22
625;21.02.2017;2017;02;17;Tiistai;2;12;14
625;21.02.2017;2017;02;18;Tiistai;2;7;9
625;21.02.2017;2017;02;19;Tiistai;1;7;8
625;21.02.2017;2017;02;20;Tiistai;0;4;4
625;21.02.2017;2017;02;21;Tiistai;0;3;3
625;21.02.2017;2017;02;22;Tiistai;0;1;1
625;21.02.2017;2017;02;23;Tiistai;2;0;2
625;22.02.2017;2017;02;00;Keskiviikko;0;0;0
625;22.02.2017;2017;02;01;Keskiviikko;0;0;0
625;22.02.2017;2017;02;02;Keskiviikko;0;0;0
625;22.02.2017;2017;02;03;Keskiviikko;0;0;0
625;22.02.2017;2017;02;04;Keskiviikko;0;1;1
625;22.02.2017;2017;02;05;Keskiviikko;1;0;1
625;22.02.2017;2017;02;06;Keskiviikko;0;3;3
625;22.02.2017;2017;02;07;Keskiviikko;1;3;4
625;22.02.2017;2017;02;08;Keskiviikko;12;4;16
625;22.02.2017;2017;02;09;Keskiviikko;12;10;22
625;22.02.2017;2017;02;10;Keskiviikko;17;6;23
625;22.02.2017;2017;02;11;Keskiviikko;4;3;7
625;22.02.2017;2017;02;12;Keskiviikko;4;5;9
625;22.02.2017;2017;02;13;Keskiviikko;7;6;13
625;22.02.2017;2017;02;14;Keskiviikko;4;13;17
625;22.02.2017;2017;02;15;Keskiviikko;5;10;15
625;22.02.2017;2017;02;16;Keskiviikko;1;13;14
625;22.02.2017;2017;02;17;Keskiviikko;7;18;25
625;22.02.2017;2017;02;18;Keskiviikko;5;3;8
625;22.02.2017;2017;02;19;Keskiviikko;0;6;6
625;22.02.2017;2017;02;20;Keskiviikko;5;5;10
625;22.02.2017;2017;02;21;Keskiviikko;0;4;4
625;22.02.2017;2017;02;22;Keskiviikko;2;0;2
625;22.02.2017;2017;02;23;Keskiviikko;0;1;1
625;23.02.2017;2017;02;00;Torstai;0;0;0
625;23.02.2017;2017;02;01;Torstai;0;0;0
625;23.02.2017;2017;02;02;Torstai;0;0;0
625;23.02.2017;2017;02;03;Torstai;0;0;0
625;23.02.2017;2017;02;04;Torstai;0;1;1
625;23.02.2017;2017;02;05;Torstai;1;0;1
625;23.02.2017;2017;02;06;Torstai;1;1;2
625;23.02.2017;2017;02;07;Torstai;2;2;4
625;23.02.2017;2017;02;08;Torstai;13;5;18
625;23.02.2017;2017;02;09;Torstai;12;4;16
625;23.02.2017;2017;02;10;Torstai;6;1;7
625;23.02.2017;2017;02;11;Torstai;6;1;7
625;23.02.2017;2017;02;12;Torstai;5;3;8
625;23.02.2017;2017;02;13;Torstai;1;7;8
625;23.02.2017;2017;02;14;Torstai;6;16;22
625;23.02.2017;2017;02;15;Torstai;2;13;15
625;23.02.2017;2017;02;16;Torstai;6;22;28
625;23.02.2017;2017;02;17;Torstai;7;12;19
625;23.02.2017;2017;02;18;Torstai;3;8;11
625;23.02.2017;2017;02;19;Torstai;5;7;12
625;23.02.2017;2017;02;20;Torstai;2;3;5
625;23.02.2017;2017;02;21;Torstai;1;2;3
625;23.02.2017;2017;02;22;Torstai;3;1;4
625;23.02.2017;2017;02;23;Torstai;4;1;5
625;24.02.2017;2017;02;00;Perjantai;1;0;1
625;24.02.2017;2017;02;01;Perjantai;0;2;2
625;24.02.2017;2017;02;02;Perjantai;0;0;0
625;24.02.2017;2017;02;03;Perjantai;0;0;0
625;24.02.2017;2017;02;04;Perjantai;0;1;1
625;24.02.2017;2017;02;05;Perjantai;1;0;1
625;24.02.2017;2017;02;06;Perjantai;3;5;8
625;24.02.2017;2017;02;07;Perjantai;6;2;8
625;24.02.2017;2017;02;08;Perjantai;22;8;30
625;24.02.2017;2017;02;09;Perjantai;8;6;14
625;24.02.2017;2017;02;10;Perjantai;5;3;8
625;24.02.2017;2017;02;11;Perjantai;3;1;4
625;24.02.2017;2017;02;12;Perjantai;2;5;7
625;24.02.2017;2017;02;13;Perjantai;2;6;8
625;24.02.2017;2017;02;14;Perjantai;7;21;28
625;24.02.2017;2017;02;15;Perjantai;4;16;20
625;24.02.2017;2017;02;16;Perjantai;4;14;18
625;24.02.2017;2017;02;17;Perjantai;8;8;16
625;24.02.2017;2017;02;18;Perjantai;5;9;14
625;24.02.2017;2017;02;19;Perjantai;1;5;6
625;24.02.2017;2017;02;20;Perjantai;1;4;5
625;24.02.2017;2017;02;21;Perjantai;1;3;4
625;24.02.2017;2017;02;22;Perjantai;1;3;4
625;24.02.2017;2017;02;23;Perjantai;0;0;0
625;25.02.2017;2017;02;00;Lauantai;3;1;4
625;25.02.2017;2017;02;01;Lauantai;0;1;1
625;25.02.2017;2017;02;02;Lauantai;0;0;0
625;25.02.2017;2017;02;03;Lauantai;0;0;0
625;25.02.2017;2017;02;04;Lauantai;1;1;2
625;25.02.2017;2017;02;05;Lauantai;0;0;0
625;25.02.2017;2017;02;06;Lauantai;0;1;1
625;25.02.2017;2017;02;07;Lauantai;0;0;0
625;25.02.2017;2017;02;08;Lauantai;0;0;0
625;25.02.2017;2017;02;09;Lauantai;0;0;0
625;25.02.2017;2017;02;10;Lauantai;0;0;0
625;25.02.2017;2017;02;11;Lauantai;1;3;4
625;25.02.2017;2017;02;12;Lauantai;2;0;2
625;25.02.2017;2017;02;13;Lauantai;1;3;4
625;25.02.2017;2017;02;14;Lauantai;3;2;5
625;25.02.2017;2017;02;15;Lauantai;2;4;6
625;25.02.2017;2017;02;16;Lauantai;1;2;3
625;25.02.2017;2017;02;17;Lauantai;4;4;8
625;25.02.2017;2017;02;18;Lauantai;1;3;4
625;25.02.2017;2017;02;19;Lauantai;1;1;2
625;25.02.2017;2017;02;20;Lauantai;0;0;0
625;25.02.2017;2017;02;21;Lauantai;2;4;6
625;25.02.2017;2017;02;22;Lauantai;0;2;2
625;25.02.2017;2017;02;23;Lauantai;2;1;3
625;26.02.2017;2017;02;00;Sunnuntai;0;0;0
625;26.02.2017;2017;02;01;Sunnuntai;0;1;1
625;26.02.2017;2017;02;02;Sunnuntai;0;0;0
625;26.02.2017;2017;02;03;Sunnuntai;1;1;2
625;26.02.2017;2017;02;04;Sunnuntai;0;0;0
625;26.02.2017;2017;02;05;Sunnuntai;0;0;0
625;26.02.2017;2017;02;06;Sunnuntai;0;0;0
625;26.02.2017;2017;02;07;Sunnuntai;0;0;0
625;26.02.2017;2017;02;08;Sunnuntai;0;1;1
625;26.02.2017;2017;02;09;Sunnuntai;0;1;1
625;26.02.2017;2017;02;10;Sunnuntai;1;2;3
625;26.02.2017;2017;02;11;Sunnuntai;1;1;2
625;26.02.2017;2017;02;12;Sunnuntai;4;3;7
625;26.02.2017;2017;02;13;Sunnuntai;1;3;4
625;26.02.2017;2017;02;14;Sunnuntai;3;3;6
625;26.02.2017;2017;02;15;Sunnuntai;1;0;1
625;26.02.2017;2017;02;16;Sunnuntai;2;3;5
625;26.02.2017;2017;02;17;Sunnuntai;2;4;6
625;26.02.2017;2017;02;18;Sunnuntai;1;3;4
625;26.02.2017;2017;02;19;Sunnuntai;3;3;6
625;26.02.2017;2017;02;20;Sunnuntai;0;2;2
625;26.02.2017;2017;02;21;Sunnuntai;2;2;4
625;26.02.2017;2017;02;22;Sunnuntai;1;1;2
625;26.02.2017;2017;02;23;Sunnuntai;0;1;1
625;27.02.2017;2017;02;00;Maanantai;0;0;0
625;27.02.2017;2017;02;01;Maanantai;0;0;0
625;27.02.2017;2017;02;02;Maanantai;0;0;0
625;27.02.2017;2017;02;03;Maanantai;0;0;0
625;27.02.2017;2017;02;04;Maanantai;0;0;0
625;27.02.2017;2017;02;05;Maanantai;1;0;1
625;27.02.2017;2017;02;06;Maanantai;1;3;4
625;27.02.2017;2017;02;07;Maanantai;5;2;7
625;27.02.2017;2017;02;08;Maanantai;14;6;20
625;27.02.2017;2017;02;09;Maanantai;8;3;11
625;27.02.2017;2017;02;10;Maanantai;6;3;9
625;27.02.2017;2017;02;11;Maanantai;6;2;8
625;27.02.2017;2017;02;12;Maanantai;2;1;3
625;27.02.2017;2017;02;13;Maanantai;3;3;6
625;27.02.2017;2017;02;14;Maanantai;3;13;16
625;27.02.2017;2017;02;15;Maanantai;8;23;31
625;27.02.2017;2017;02;16;Maanantai;4;16;20
625;27.02.2017;2017;02;17;Maanantai;4;16;20
625;27.02.2017;2017;02;18;Maanantai;5;4;9
625;27.02.2017;2017;02;19;Maanantai;3;6;9
625;27.02.2017;2017;02;20;Maanantai;0;5;5
625;27.02.2017;2017;02;21;Maanantai;2;4;6
625;27.02.2017;2017;02;22;Maanantai;2;2;4
625;27.02.2017;2017;02;23;Maanantai;0;0;0
625;28.02.2017;2017;02;00;Tiistai;1;1;2
625;28.02.2017;2017;02;01;Tiistai;0;0;0
625;28.02.2017;2017;02;02;Tiistai;0;0;0
625;28.02.2017;2017;02;03;Tiistai;0;0;0
625;28.02.2017;2017;02;04;Tiistai;0;0;0
625;28.02.2017;2017;02;05;Tiistai;0;0;0
625;28.02.2017;2017;02;06;Tiistai;0;2;2
625;28.02.2017;2017;02;07;Tiistai;4;4;8
625;28.02.2017;2017;02;08;Tiistai;23;14;37
625;28.02.2017;2017;02;09;Tiistai;17;14;31
625;28.02.2017;2017;02;10;Tiistai;12;5;17
625;28.02.2017;2017;02;11;Tiistai;4;4;8
625;28.02.2017;2017;02;12;Tiistai;6;5;11
625;28.02.2017;2017;02;13;Tiistai;10;15;25
625;28.02.2017;2017;02;14;Tiistai;5;13;18
625;28.02.2017;2017;02;15;Tiistai;2;16;18
625;28.02.2017;2017;02;16;Tiistai;1;23;24
625;28.02.2017;2017;02;17;Tiistai;11;15;26
625;28.02.2017;2017;02;18;Tiistai;2;11;13
625;28.02.2017;2017;02;19;Tiistai;4;4;8
625;28.02.2017;2017;02;20;Tiistai;1;3;4
625;28.02.2017;2017;02;21;Tiistai;0;4;4
625;28.02.2017;2017;02;22;Tiistai;2;1;3
625;28.02.2017;2017;02;23;Tiistai;0;1;1
625;01.03.2017;2017;03;00;Keskiviikko;0;0;0
625;01.03.2017;2017;03;01;Keskiviikko;0;0;0
625;01.03.2017;2017;03;02;Keskiviikko;0;0;0
625;01.03.2017;2017;03;03;Keskiviikko;0;0;0
625;01.03.2017;2017;03;04;Keskiviikko;0;0;0
625;01.03.2017;2017;03;05;Keskiviikko;1;0;1
625;01.03.2017;2017;03;06;Keskiviikko;1;1;2
625;01.03.2017;2017;03;07;Keskiviikko;4;5;9
625;01.03.2017;2017;03;08;Keskiviikko;20;8;28
625;01.03.2017;2017;03;09;Keskiviikko;10;10;20
625;01.03.2017;2017;03;10;Keskiviikko;6;1;7
625;01.03.2017;2017;03;11;Keskiviikko;2;1;3
625;01.03.2017;2017;03;12;Keskiviikko;3;2;5
625;01.03.2017;2017;03;13;Keskiviikko;3;8;11
625;01.03.2017;2017;03;14;Keskiviikko;4;12;16
625;01.03.2017;2017;03;15;Keskiviikko;5;20;25
625;01.03.2017;2017;03;16;Keskiviikko;2;14;16
625;01.03.2017;2017;03;17;Keskiviikko;4;11;15
625;01.03.2017;2017;03;18;Keskiviikko;8;7;15
625;01.03.2017;2017;03;19;Keskiviikko;3;6;9
625;01.03.2017;2017;03;20;Keskiviikko;4;5;9
625;01.03.2017;2017;03;21;Keskiviikko;3;2;5
625;01.03.2017;2017;03;22;Keskiviikko;1;2;3
625;01.03.2017;2017;03;23;Keskiviikko;1;1;2
625;02.03.2017;2017;03;00;Torstai;0;0;0
625;02.03.2017;2017;03;01;Torstai;1;0;1
625;02.03.2017;2017;03;02;Torstai;0;0;0
625;02.03.2017;2017;03;03;Torstai;0;0;0
625;02.03.2017;2017;03;04;Torstai;0;0;0
625;02.03.2017;2017;03;05;Torstai;1;0;1
625;02.03.2017;2017;03;06;Torstai;0;2;2
625;02.03.2017;2017;03;07;Torstai;5;4;9
625;02.03.2017;2017;03;08;Torstai;14;5;19
625;02.03.2017;2017;03;09;Torstai;15;8;23
625;02.03.2017;2017;03;10;Torstai;10;1;11
625;02.03.2017;2017;03;11;Torstai;1;2;3
625;02.03.2017;2017;03;12;Torstai;5;5;10
625;02.03.2017;2017;03;13;Torstai;4;5;9
625;02.03.2017;2017;03;14;Torstai;3;9;12
625;02.03.2017;2017;03;15;Torstai;6;16;22
625;02.03.2017;2017;03;16;Torstai;2;15;17
625;02.03.2017;2017;03;17;Torstai;6;9;15
625;02.03.2017;2017;03;18;Torstai;4;8;12
625;02.03.2017;2017;03;19;Torstai;2;2;4
625;02.03.2017;2017;03;20;Torstai;2;2;4
625;02.03.2017;2017;03;21;Torstai;0;0;0
625;02.03.2017;2017;03;22;Torstai;1;1;2
625;02.03.2017;2017;03;23;Torstai;0;1;1
625;03.03.2017;2017;03;00;Perjantai;0;1;1
625;03.03.2017;2017;03;01;Perjantai;0;0;0
625;03.03.2017;2017;03;02;Perjantai;0;0;0
625;03.03.2017;2017;03;03;Perjantai;0;0;0
625;03.03.2017;2017;03;04;Perjantai;0;0;0
625;03.03.2017;2017;03;05;Perjantai;1;0;1
625;03.03.2017;2017;03;06;Perjantai;1;4;5
625;03.03.2017;2017;03;07;Perjantai;6;4;10
625;03.03.2017;2017;03;08;Perjantai;16;11;27
625;03.03.2017;2017;03;09;Perjantai;6;10;16
625;03.03.2017;2017;03;10;Perjantai;3;4;7
625;03.03.2017;2017;03;11;Perjantai;0;1;1
625;03.03.2017;2017;03;12;Perjantai;3;7;10
625;03.03.2017;2017;03;13;Perjantai;4;18;22
625;03.03.2017;2017;03;14;Perjantai;4;15;19
625;03.03.2017;2017;03;15;Perjantai;3;11;14
625;03.03.2017;2017;03;16;Perjantai;1;18;19
625;03.03.2017;2017;03;17;Perjantai;4;13;17
625;03.03.2017;2017;03;18;Perjantai;2;7;9
625;03.03.2017;2017;03;19;Perjantai;1;0;1
625;03.03.2017;2017;03;20;Perjantai;0;3;3
625;03.03.2017;2017;03;21;Perjantai;2;1;3
625;03.03.2017;2017;03;22;Perjantai;1;1;2
625;03.03.2017;2017;03;23;Perjantai;0;5;5
625;04.03.2017;2017;03;00;Lauantai;0;0;0
625;04.03.2017;2017;03;01;Lauantai;0;0;0
625;04.03.2017;2017;03;02;Lauantai;0;0;0
625;04.03.2017;2017;03;03;Lauantai;0;0;0
625;04.03.2017;2017;03;04;Lauantai;0;0;0
625;04.03.2017;2017;03;05;Lauantai;0;0;0
625;04.03.2017;2017;03;06;Lauantai;0;1;1
625;04.03.2017;2017;03;07;Lauantai;0;0;0
625;04.03.2017;2017;03;08;Lauantai;0;1;1
625;04.03.2017;2017;03;09;Lauantai;0;1;1
625;04.03.2017;2017;03;10;Lauantai;1;0;1
625;04.03.2017;2017;03;11;Lauantai;1;3;4
625;04.03.2017;2017;03;12;Lauantai;3;4;7
625;04.03.2017;2017;03;13;Lauantai;1;3;4
625;04.03.2017;2017;03;14;Lauantai;2;6;8
625;04.03.2017;2017;03;15;Lauantai;2;1;3
625;04.03.2017;2017;03;16;Lauantai;1;2;3
625;04.03.2017;2017;03;17;Lauantai;1;10;11
625;04.03.2017;2017;03;18;Lauantai;0;4;4
625;04.03.2017;2017;03;19;Lauantai;2;2;4
625;04.03.2017;2017;03;20;Lauantai;1;3;4
625;04.03.2017;2017;03;21;Lauantai;1;0;1
625;04.03.2017;2017;03;22;Lauantai;0;1;1
625;04.03.2017;2017;03;23;Lauantai;0;0;0
625;05.03.2017;2017;03;00;Sunnuntai;1;0;1
625;05.03.2017;2017;03;01;Sunnuntai;1;0;1
625;05.03.2017;2017;03;02;Sunnuntai;0;1;1
625;05.03.2017;2017;03;03;Sunnuntai;0;1;1
625;05.03.2017;2017;03;04;Sunnuntai;0;0;0
625;05.03.2017;2017;03;05;Sunnuntai;0;0;0
625;05.03.2017;2017;03;06;Sunnuntai;0;0;0
625;05.03.2017;2017;03;07;Sunnuntai;0;0;0
625;05.03.2017;2017;03;08;Sunnuntai;2;1;3
625;05.03.2017;2017;03;09;Sunnuntai;0;0;0
625;05.03.2017;2017;03;10;Sunnuntai;0;2;2
625;05.03.2017;2017;03;11;Sunnuntai;1;3;4
625;05.03.2017;2017;03;12;Sunnuntai;3;1;4
625;05.03.2017;2017;03;13;Sunnuntai;0;2;2
625;05.03.2017;2017;03;14;Sunnuntai;1;2;3
625;05.03.2017;2017;03;15;Sunnuntai;0;4;4
625;05.03.2017;2017;03;16;Sunnuntai;4;2;6
625;05.03.2017;2017;03;17;Sunnuntai;5;5;10
625;05.03.2017;2017;03;18;Sunnuntai;2;4;6
625;05.03.2017;2017;03;19;Sunnuntai;4;7;11
625;05.03.2017;2017;03;20;Sunnuntai;0;3;3
625;05.03.2017;2017;03;21;Sunnuntai;2;1;3
625;05.03.2017;2017;03;22;Sunnuntai;0;0;0
625;05.03.2017;2017;03;23;Sunnuntai;0;1;1
625;06.03.2017;2017;03;00;Maanantai;0;0;0
625;06.03.2017;2017;03;01;Maanantai;0;0;0
625;06.03.2017;2017;03;02;Maanantai;0;0;0
625;06.03.2017;2017;03;03;Maanantai;0;0;0
625;06.03.2017;2017;03;04;Maanantai;0;1;1
625;06.03.2017;2017;03;05;Maanantai;0;0;0
625;06.03.2017;2017;03;06;Maanantai;1;2;3
625;06.03.2017;2017;03;07;Maanantai;0;3;3
625;06.03.2017;2017;03;08;Maanantai;2;6;8
625;06.03.2017;2017;03;09;Maanantai;6;1;7
625;06.03.2017;2017;03;10;Maanantai;2;3;5
625;06.03.2017;2017;03;11;Maanantai;2;1;3
625;06.03.2017;2017;03;12;Maanantai;4;2;6
625;06.03.2017;2017;03;13;Maanantai;0;2;2
625;06.03.2017;2017;03;14;Maanantai;2;4;6
625;06.03.2017;2017;03;15;Maanantai;2;9;11
625;06.03.2017;2017;03;16;Maanantai;3;7;10
625;06.03.2017;2017;03;17;Maanantai;2;10;12
625;06.03.2017;2017;03;18;Maanantai;1;9;10
625;06.03.2017;2017;03;19;Maanantai;2;6;8
625;06.03.2017;2017;03;20;Maanantai;2;1;3
625;06.03.2017;2017;03;21;Maanantai;2;0;2
625;06.03.2017;2017;03;22;Maanantai;0;2;2
625;06.03.2017;2017;03;23;Maanantai;1;0;1
625;07.03.2017;2017;03;00;Tiistai;0;0;0
625;07.03.2017;2017;03;01;Tiistai;0;0;0
625;07.03.2017;2017;03;02;Tiistai;0;0;0
625;07.03.2017;2017;03;03;Tiistai;0;0;0
625;07.03.2017;2017;03;04;Tiistai;0;1;1
625;07.03.2017;2017;03;05;Tiistai;0;0;0
625;07.03.2017;2017;03;06;Tiistai;1;2;3
625;07.03.2017;2017;03;07;Tiistai;1;3;4
625;07.03.2017;2017;03;08;Tiistai;6;8;14
625;07.03.2017;2017;03;09;Tiistai;4;3;7
625;07.03.2017;2017;03;10;Tiistai;2;3;5
625;07.03.2017;2017;03;11;Tiistai;0;1;1
625;07.03.2017;2017;03;12;Tiistai;2;3;5
625;07.03.2017;2017;03;13;Tiistai;1;2;3
625;07.03.2017;2017;03;14;Tiistai;5;6;11
625;07.03.2017;2017;03;15;Tiistai;1;3;4
625;07.03.2017;2017;03;16;Tiistai;1;2;3
625;07.03.2017;2017;03;17;Tiistai;1;6;7
625;07.03.2017;2017;03;18;Tiistai;2;9;11
625;07.03.2017;2017;03;19;Tiistai;1;5;6
625;07.03.2017;2017;03;20;Tiistai;1;1;2
625;07.03.2017;2017;03;21;Tiistai;2;1;3
625;07.03.2017;2017;03;22;Tiistai;0;2;2
625;07.03.2017;2017;03;23;Tiistai;1;0;1
625;08.03.2017;2017;03;00;Keskiviikko;1;0;1
625;08.03.2017;2017;03;01;Keskiviikko;0;0;0
625;08.03.2017;2017;03;02;Keskiviikko;0;0;0
625;08.03.2017;2017;03;03;Keskiviikko;0;0;0
625;08.03.2017;2017;03;04;Keskiviikko;0;0;0
625;08.03.2017;2017;03;05;Keskiviikko;0;2;2
625;08.03.2017;2017;03;06;Keskiviikko;1;1;2
625;08.03.2017;2017;03;07;Keskiviikko;2;3;5
625;08.03.2017;2017;03;08;Keskiviikko;3;3;6
625;08.03.2017;2017;03;09;Keskiviikko;3;0;3
625;08.03.2017;2017;03;10;Keskiviikko;1;0;1
625;08.03.2017;2017;03;11;Keskiviikko;0;2;2
625;08.03.2017;2017;03;12;Keskiviikko;3;4;7
625;08.03.2017;2017;03;13;Keskiviikko;3;7;10
625;08.03.2017;2017;03;14;Keskiviikko;3;1;4
625;08.03.2017;2017;03;15;Keskiviikko;4;5;9
625;08.03.2017;2017;03;16;Keskiviikko;3;7;10
625;08.03.2017;2017;03;17;Keskiviikko;1;7;8
625;08.03.2017;2017;03;18;Keskiviikko;1;7;8
625;08.03.2017;2017;03;19;Keskiviikko;3;2;5
625;08.03.2017;2017;03;20;Keskiviikko;3;5;8
625;08.03.2017;2017;03;21;Keskiviikko;3;2;5
625;08.03.2017;2017;03;22;Keskiviikko;0;2;2
625;08.03.2017;2017;03;23;Keskiviikko;1;1;2
625;09.03.2017;2017;03;00;Torstai;0;0;0
625;09.03.2017;2017;03;01;Torstai;0;0;0
625;09.03.2017;2017;03;02;Torstai;0;0;0
625;09.03.2017;2017;03;03;Torstai;0;0;0
625;09.03.2017;2017;03;04;Torstai;0;1;1
625;09.03.2017;2017;03;05;Torstai;0;0;0
625;09.03.2017;2017;03;06;Torstai;2;1;3
625;09.03.2017;2017;03;07;Torstai;1;5;6
625;09.03.2017;2017;03;08;Torstai;6;7;13
625;09.03.2017;2017;03;09;Torstai;2;0;2
625;09.03.2017;2017;03;10;Torstai;1;2;3
625;09.03.2017;2017;03;11;Torstai;2;2;4
625;09.03.2017;2017;03;12;Torstai;4;1;5
625;09.03.2017;2017;03;13;Torstai;4;2;6
625;09.03.2017;2017;03;14;Torstai;2;5;7
625;09.03.2017;2017;03;15;Torstai;2;1;3
625;09.03.2017;2017;03;16;Torstai;1;5;6
625;09.03.2017;2017;03;17;Torstai;2;9;11
625;09.03.2017;2017;03;18;Torstai;0;5;5
625;09.03.2017;2017;03;19;Torstai;1;7;8
625;09.03.2017;2017;03;20;Torstai;0;1;1
625;09.03.2017;2017;03;21;Torstai;1;2;3
625;09.03.2017;2017;03;22;Torstai;0;1;1
625;09.03.2017;2017;03;23;Torstai;2;2;4
625;10.03.2017;2017;03;00;Perjantai;0;1;1
625;10.03.2017;2017;03;01;Perjantai;0;0;0
625;10.03.2017;2017;03;02;Perjantai;0;0;0
625;10.03.2017;2017;03;03;Perjantai;0;0;0
625;10.03.2017;2017;03;04;Perjantai;0;0;0
625;10.03.2017;2017;03;05;Perjantai;0;0;0
625;10.03.2017;2017;03;06;Perjantai;2;1;3
625;10.03.2017;2017;03;07;Perjantai;1;4;5
625;10.03.2017;2017;03;08;Perjantai;5;8;13
625;10.03.2017;2017;03;09;Perjantai;2;7;9
625;10.03.2017;2017;03;10;Perjantai;2;4;6
625;10.03.2017;2017;03;11;Perjantai;5;4;9
625;10.03.2017;2017;03;12;Perjantai;5;4;9
625;10.03.2017;2017;03;13;Perjantai;7;4;11
625;10.03.2017;2017;03;14;Perjantai;1;5;6
625;10.03.2017;2017;03;15;Perjantai;4;8;12
625;10.03.2017;2017;03;16;Perjantai;4;6;10
625;10.03.2017;2017;03;17;Perjantai;5;10;15
625;10.03.2017;2017;03;18;Perjantai;1;5;6
625;10.03.2017;2017;03;19;Perjantai;0;2;2
625;10.03.2017;2017;03;20;Perjantai;2;4;6
625;10.03.2017;2017;03;21;Perjantai;1;4;5
625;10.03.2017;2017;03;22;Perjantai;2;0;2
625;10.03.2017;2017;03;23;Perjantai;0;0;0
625;11.03.2017;2017;03;00;Lauantai;0;0;0
625;11.03.2017;2017;03;01;Lauantai;0;0;0
625;11.03.2017;2017;03;02;Lauantai;0;0;0
625;11.03.2017;2017;03;03;Lauantai;0;0;0
625;11.03.2017;2017;03;04;Lauantai;0;0;0
625;11.03.2017;2017;03;05;Lauantai;0;0;0
625;11.03.2017;2017;03;06;Lauantai;0;0;0
625;11.03.2017;2017;03;07;Lauantai;0;1;1
625;11.03.2017;2017;03;08;Lauantai;0;1;1
625;11.03.2017;2017;03;09;Lauantai;3;1;4
625;11.03.2017;2017;03;10;Lauantai;0;0;0
625;11.03.2017;2017;03;11;Lauantai;0;3;3
625;11.03.2017;2017;03;12;Lauantai;5;5;10
625;11.03.2017;2017;03;13;Lauantai;0;3;3
625;11.03.2017;2017;03;14;Lauantai;1;4;5
625;11.03.2017;2017;03;15;Lauantai;2;1;3
625;11.03.2017;2017;03;16;Lauantai;3;6;9
625;11.03.2017;2017;03;17;Lauantai;2;3;5
625;11.03.2017;2017;03;18;Lauantai;1;1;2
625;11.03.2017;2017;03;19;Lauantai;0;3;3
625;11.03.2017;2017;03;20;Lauantai;0;1;1
625;11.03.2017;2017;03;21;Lauantai;2;1;3
625;11.03.2017;2017;03;22;Lauantai;2;1;3
625;11.03.2017;2017;03;23;Lauantai;0;0;0
625;12.03.2017;2017;03;00;Sunnuntai;0;0;0
625;12.03.2017;2017;03;01;Sunnuntai;0;1;1
625;12.03.2017;2017;03;02;Sunnuntai;0;0;0
625;12.03.2017;2017;03;03;Sunnuntai;0;0;0
625;12.03.2017;2017;03;04;Sunnuntai;0;1;1
625;12.03.2017;2017;03;05;Sunnuntai;0;0;0
625;12.03.2017;2017;03;06;Sunnuntai;0;0;0
625;12.03.2017;2017;03;07;Sunnuntai;0;0;0
625;12.03.2017;2017;03;08;Sunnuntai;0;2;2
625;12.03.2017;2017;03;09;Sunnuntai;0;2;2
625;12.03.2017;2017;03;10;Sunnuntai;0;0;0
625;12.03.2017;2017;03;11;Sunnuntai;1;1;2
625;12.03.2017;2017;03;12;Sunnuntai;6;6;12
625;12.03.2017;2017;03;13;Sunnuntai;5;6;11
625;12.03.2017;2017;03;14;Sunnuntai;2;8;10
625;12.03.2017;2017;03;15;Sunnuntai;4;4;8
625;12.03.2017;2017;03;16;Sunnuntai;4;2;6
625;12.03.2017;2017;03;17;Sunnuntai;4;2;6
625;12.03.2017;2017;03;18;Sunnuntai;5;1;6
625;12.03.2017;2017;03;19;Sunnuntai;1;5;6
625;12.03.2017;2017;03;20;Sunnuntai;1;4;5
625;12.03.2017;2017;03;21;Sunnuntai;2;0;2
625;12.03.2017;2017;03;22;Sunnuntai;0;0;0
625;12.03.2017;2017;03;23;Sunnuntai;0;1;1
625;13.03.2017;2017;03;00;Maanantai;0;0;0
625;13.03.2017;2017;03;01;Maanantai;0;0;0
625;13.03.2017;2017;03;02;Maanantai;0;0;0
625;13.03.2017;2017;03;03;Maanantai;0;0;0
625;13.03.2017;2017;03;04;Maanantai;0;0;0
625;13.03.2017;2017;03;05;Maanantai;1;1;2
625;13.03.2017;2017;03;06;Maanantai;1;4;5
625;13.03.2017;2017;03;07;Maanantai;4;4;8
625;13.03.2017;2017;03;08;Maanantai;27;16;43
625;13.03.2017;2017;03;09;Maanantai;13;7;20
625;13.03.2017;2017;03;10;Maanantai;9;5;14
625;13.03.2017;2017;03;11;Maanantai;4;2;6
625;13.03.2017;2017;03;12;Maanantai;2;5;7
625;13.03.2017;2017;03;13;Maanantai;9;16;25
625;13.03.2017;2017;03;14;Maanantai;5;6;11
625;13.03.2017;2017;03;15;Maanantai;7;30;37
625;13.03.2017;2017;03;16;Maanantai;4;24;28
625;13.03.2017;2017;03;17;Maanantai;4;19;23
625;13.03.2017;2017;03;18;Maanantai;4;11;15
625;13.03.2017;2017;03;19;Maanantai;1;8;9
625;13.03.2017;2017;03;20;Maanantai;1;7;8
625;13.03.2017;2017;03;21;Maanantai;0;5;5
625;13.03.2017;2017;03;22;Maanantai;0;1;1
625;13.03.2017;2017;03;23;Maanantai;0;0;0
625;14.03.2017;2017;03;00;Tiistai;0;0;0
625;14.03.2017;2017;03;01;Tiistai;0;0;0
625;14.03.2017;2017;03;02;Tiistai;0;0;0
625;14.03.2017;2017;03;03;Tiistai;0;0;0
625;14.03.2017;2017;03;04;Tiistai;0;0;0
625;14.03.2017;2017;03;05;Tiistai;3;0;3
625;14.03.2017;2017;03;06;Tiistai;3;3;6
625;14.03.2017;2017;03;07;Tiistai;4;7;11
625;14.03.2017;2017;03;08;Tiistai;14;11;25
625;14.03.2017;2017;03;09;Tiistai;12;8;20
625;14.03.2017;2017;03;10;Tiistai;3;5;8
625;14.03.2017;2017;03;11;Tiistai;10;4;14
625;14.03.2017;2017;03;12;Tiistai;6;3;9
625;14.03.2017;2017;03;13;Tiistai;1;5;6
625;14.03.2017;2017;03;14;Tiistai;2;17;19
625;14.03.2017;2017;03;15;Tiistai;7;19;26
625;14.03.2017;2017;03;16;Tiistai;3;19;22
625;14.03.2017;2017;03;17;Tiistai;6;19;25
625;14.03.2017;2017;03;18;Tiistai;2;15;17
625;14.03.2017;2017;03;19;Tiistai;2;5;7
625;14.03.2017;2017;03;20;Tiistai;1;3;4
625;14.03.2017;2017;03;21;Tiistai;1;5;6
625;14.03.2017;2017;03;22;Tiistai;1;2;3
625;14.03.2017;2017;03;23;Tiistai;0;0;0
625;15.03.2017;2017;03;00;Keskiviikko;0;0;0
625;15.03.2017;2017;03;01;Keskiviikko;0;0;0
625;15.03.2017;2017;03;02;Keskiviikko;0;0;0
625;15.03.2017;2017;03;03;Keskiviikko;0;0;0
625;15.03.2017;2017;03;04;Keskiviikko;0;1;1
625;15.03.2017;2017;03;05;Keskiviikko;0;0;0
625;15.03.2017;2017;03;06;Keskiviikko;2;0;2
625;15.03.2017;2017;03;07;Keskiviikko;7;8;15
625;15.03.2017;2017;03;08;Keskiviikko;13;10;23
625;15.03.2017;2017;03;09;Keskiviikko;14;10;24
625;15.03.2017;2017;03;10;Keskiviikko;11;8;19
625;15.03.2017;2017;03;11;Keskiviikko;9;6;15
625;15.03.2017;2017;03;12;Keskiviikko;3;4;7
625;15.03.2017;2017;03;13;Keskiviikko;10;15;25
625;15.03.2017;2017;03;14;Keskiviikko;6;17;23
625;15.03.2017;2017;03;15;Keskiviikko;9;31;40
625;15.03.2017;2017;03;16;Keskiviikko;14;22;36
625;15.03.2017;2017;03;17;Keskiviikko;11;20;31
625;15.03.2017;2017;03;18;Keskiviikko;4;11;15
625;15.03.2017;2017;03;19;Keskiviikko;6;9;15
625;15.03.2017;2017;03;20;Keskiviikko;3;5;8
625;15.03.2017;2017;03;21;Keskiviikko;4;6;10
625;15.03.2017;2017;03;22;Keskiviikko;0;2;2
625;15.03.2017;2017;03;23;Keskiviikko;1;1;2
625;16.03.2017;2017;03;00;Torstai;3;0;3
625;16.03.2017;2017;03;01;Torstai;0;0;0
625;16.03.2017;2017;03;02;Torstai;0;0;0
625;16.03.2017;2017;03;03;Torstai;1;0;1
625;16.03.2017;2017;03;04;Torstai;0;0;0
625;16.03.2017;2017;03;05;Torstai;0;0;0
625;16.03.2017;2017;03;06;Torstai;2;3;5
625;16.03.2017;2017;03;07;Torstai;10;3;13
625;16.03.2017;2017;03;08;Torstai;27;14;41
625;16.03.2017;2017;03;09;Torstai;21;7;28
625;16.03.2017;2017;03;10;Torstai;20;7;27
625;16.03.2017;2017;03;11;Torstai;7;4;11
625;16.03.2017;2017;03;12;Torstai;5;7;12
625;16.03.2017;2017;03;13;Torstai;3;10;13
625;16.03.2017;2017;03;14;Torstai;11;20;31
625;16.03.2017;2017;03;15;Torstai;5;23;28
625;16.03.2017;2017;03;16;Torstai;10;25;35
625;16.03.2017;2017;03;17;Torstai;11;17;28
625;16.03.2017;2017;03;18;Torstai;9;13;22
625;16.03.2017;2017;03;19;Torstai;4;8;12
625;16.03.2017;2017;03;20;Torstai;5;7;12
625;16.03.2017;2017;03;21;Torstai;4;4;8
625;16.03.2017;2017;03;22;Torstai;1;3;4
625;16.03.2017;2017;03;23;Torstai;1;0;1
625;17.03.2017;2017;03;00;Perjantai;1;0;1
625;17.03.2017;2017;03;01;Perjantai;0;0;0
625;17.03.2017;2017;03;02;Perjantai;0;0;0
625;17.03.2017;2017;03;03;Perjantai;0;0;0
625;17.03.2017;2017;03;04;Perjantai;0;0;0
625;17.03.2017;2017;03;05;Perjantai;1;0;1
625;17.03.2017;2017;03;06;Perjantai;3;1;4
625;17.03.2017;2017;03;07;Perjantai;5;6;11
625;17.03.2017;2017;03;08;Perjantai;21;8;29
625;17.03.2017;2017;03;09;Perjantai;13;4;17
625;17.03.2017;2017;03;10;Perjantai;9;7;16
625;17.03.2017;2017;03;11;Perjantai;3;1;4
625;17.03.2017;2017;03;12;Perjantai;6;4;10
625;17.03.2017;2017;03;13;Perjantai;9;13;22
625;17.03.2017;2017;03;14;Perjantai;7;16;23
625;17.03.2017;2017;03;15;Perjantai;5;19;24
625;17.03.2017;2017;03;16;Perjantai;3;2;5
625;17.03.2017;2017;03;17;Perjantai;3;10;13
625;17.03.2017;2017;03;18;Perjantai;6;3;9
625;17.03.2017;2017;03;19;Perjantai;0;2;2
625;17.03.2017;2017;03;20;Perjantai;1;0;1
625;17.03.2017;2017;03;21;Perjantai;2;1;3
625;17.03.2017;2017;03;22;Perjantai;1;3;4
625;17.03.2017;2017;03;23;Perjantai;3;1;4
625;18.03.2017;2017;03;00;Lauantai;0;0;0
625;18.03.2017;2017;03;01;Lauantai;0;0;0
625;18.03.2017;2017;03;02;Lauantai;0;0;0
625;18.03.2017;2017;03;03;Lauantai;0;0;0
625;18.03.2017;2017;03;04;Lauantai;0;0;0
625;18.03.2017;2017;03;05;Lauantai;0;0;0
625;18.03.2017;2017;03;06;Lauantai;0;0;0
625;18.03.2017;2017;03;07;Lauantai;1;2;3
625;18.03.2017;2017;03;08;Lauantai;0;0;0
625;18.03.2017;2017;03;09;Lauantai;2;0;2
625;18.03.2017;2017;03;10;Lauantai;3;3;6
625;18.03.2017;2017;03;11;Lauantai;6;5;11
625;18.03.2017;2017;03;12;Lauantai;3;0;3
625;18.03.2017;2017;03;13;Lauantai;3;9;12
625;18.03.2017;2017;03;14;Lauantai;2;5;7
625;18.03.2017;2017;03;15;Lauantai;6;2;8
625;18.03.2017;2017;03;16;Lauantai;3;2;5
625;18.03.2017;2017;03;17;Lauantai;4;2;6
625;18.03.2017;2017;03;18;Lauantai;4;3;7
625;18.03.2017;2017;03;19;Lauantai;2;1;3
625;18.03.2017;2017;03;20;Lauantai;2;6;8
625;18.03.2017;2017;03;21;Lauantai;3;1;4
625;18.03.2017;2017;03;22;Lauantai;1;0;1
625;18.03.2017;2017;03;23;Lauantai;1;0;1
625;19.03.2017;2017;03;00;Sunnuntai;1;1;2
625;19.03.2017;2017;03;01;Sunnuntai;1;1;2
625;19.03.2017;2017;03;02;Sunnuntai;1;0;1
625;19.03.2017;2017;03;03;Sunnuntai;0;0;0
625;19.03.2017;2017;03;04;Sunnuntai;0;0;0
625;19.03.2017;2017;03;05;Sunnuntai;0;0;0
625;19.03.2017;2017;03;06;Sunnuntai;0;0;0
625;19.03.2017;2017;03;07;Sunnuntai;0;1;1
625;19.03.2017;2017;03;08;Sunnuntai;0;1;1
625;19.03.2017;2017;03;09;Sunnuntai;4;3;7
625;19.03.2017;2017;03;10;Sunnuntai;3;2;5
625;19.03.2017;2017;03;11;Sunnuntai;3;2;5
625;19.03.2017;2017;03;12;Sunnuntai;3;4;7
625;19.03.2017;2017;03;13;Sunnuntai;4;2;6
625;19.03.2017;2017;03;14;Sunnuntai;7;9;16
625;19.03.2017;2017;03;15;Sunnuntai;5;6;11
625;19.03.2017;2017;03;16;Sunnuntai;4;8;12
625;19.03.2017;2017;03;17;Sunnuntai;3;3;6
625;19.03.2017;2017;03;18;Sunnuntai;4;4;8
625;19.03.2017;2017;03;19;Sunnuntai;0;6;6
625;19.03.2017;2017;03;20;Sunnuntai;4;2;6
625;19.03.2017;2017;03;21;Sunnuntai;5;0;5
625;19.03.2017;2017;03;22;Sunnuntai;2;0;2
625;19.03.2017;2017;03;23;Sunnuntai;4;0;4
625;20.03.2017;2017;03;00;Maanantai;0;0;0
625;20.03.2017;2017;03;01;Maanantai;0;0;0
625;20.03.2017;2017;03;02;Maanantai;0;0;0
625;20.03.2017;2017;03;03;Maanantai;0;0;0
625;20.03.2017;2017;03;04;Maanantai;0;0;0
625;20.03.2017;2017;03;05;Maanantai;0;0;0
625;20.03.2017;2017;03;06;Maanantai;1;3;4
625;20.03.2017;2017;03;07;Maanantai;9;2;11
625;20.03.2017;2017;03;08;Maanantai;23;4;27
625;20.03.2017;2017;03;09;Maanantai;32;13;45
625;20.03.2017;2017;03;10;Maanantai;24;6;30
625;20.03.2017;2017;03;11;Maanantai;7;5;12
625;20.03.2017;2017;03;12;Maanantai;12;8;20
625;20.03.2017;2017;03;13;Maanantai;8;13;21
625;20.03.2017;2017;03;14;Maanantai;4;10;14
625;20.03.2017;2017;03;15;Maanantai;9;16;25
625;20.03.2017;2017;03;16;Maanantai;13;42;55
625;20.03.2017;2017;03;17;Maanantai;11;16;27
625;20.03.2017;2017;03;18;Maanantai;3;11;14
625;20.03.2017;2017;03;19;Maanantai;5;8;13
625;20.03.2017;2017;03;20;Maanantai;4;5;9
625;20.03.2017;2017;03;21;Maanantai;2;4;6
625;20.03.2017;2017;03;22;Maanantai;5;3;8
625;20.03.2017;2017;03;23;Maanantai;2;0;2
625;21.03.2017;2017;03;00;Tiistai;2;0;2
625;21.03.2017;2017;03;01;Tiistai;0;0;0
625;21.03.2017;2017;03;02;Tiistai;0;0;0
625;21.03.2017;2017;03;03;Tiistai;1;0;1
625;21.03.2017;2017;03;04;Tiistai;0;0;0
625;21.03.2017;2017;03;05;Tiistai;0;0;0
625;21.03.2017;2017;03;06;Tiistai;2;1;3
625;21.03.2017;2017;03;07;Tiistai;9;1;10
625;21.03.2017;2017;03;08;Tiistai;23;15;38
625;21.03.2017;2017;03;09;Tiistai;15;12;27
625;21.03.2017;2017;03;10;Tiistai;8;2;10
625;21.03.2017;2017;03;11;Tiistai;5;3;8
625;21.03.2017;2017;03;12;Tiistai;6;6;12
625;21.03.2017;2017;03;13;Tiistai;8;9;17
625;21.03.2017;2017;03;14;Tiistai;7;7;14
625;21.03.2017;2017;03;15;Tiistai;9;30;39
625;21.03.2017;2017;03;16;Tiistai;8;20;28
625;21.03.2017;2017;03;17;Tiistai;16;20;36
625;21.03.2017;2017;03;18;Tiistai;7;14;21
625;21.03.2017;2017;03;19;Tiistai;8;11;19
625;21.03.2017;2017;03;20;Tiistai;2;3;5
625;21.03.2017;2017;03;21;Tiistai;4;4;8
625;21.03.2017;2017;03;22;Tiistai;1;2;3
625;21.03.2017;2017;03;23;Tiistai;2;0;2
625;22.03.2017;2017;03;00;Keskiviikko;0;0;0
625;22.03.2017;2017;03;01;Keskiviikko;0;0;0
625;22.03.2017;2017;03;02;Keskiviikko;0;1;1
625;22.03.2017;2017;03;03;Keskiviikko;0;0;0
625;22.03.2017;2017;03;04;Keskiviikko;0;0;0
625;22.03.2017;2017;03;05;Keskiviikko;1;0;1
625;22.03.2017;2017;03;06;Keskiviikko;2;4;6
625;22.03.2017;2017;03;07;Keskiviikko;6;6;12
625;22.03.2017;2017;03;08;Keskiviikko;31;14;45
625;22.03.2017;2017;03;09;Keskiviikko;15;6;21
625;22.03.2017;2017;03;10;Keskiviikko;11;2;13
625;22.03.2017;2017;03;11;Keskiviikko;11;1;12
625;22.03.2017;2017;03;12;Keskiviikko;8;8;16
625;22.03.2017;2017;03;13;Keskiviikko;5;9;14
625;22.03.2017;2017;03;14;Keskiviikko;5;19;24
625;22.03.2017;2017;03;15;Keskiviikko;11;32;43
625;22.03.2017;2017;03;16;Keskiviikko;10;24;34
625;22.03.2017;2017;03;17;Keskiviikko;6;17;23
625;22.03.2017;2017;03;18;Keskiviikko;5;12;17
625;22.03.2017;2017;03;19;Keskiviikko;5;10;15
625;22.03.2017;2017;03;20;Keskiviikko;4;9;13
625;22.03.2017;2017;03;21;Keskiviikko;1;5;6
625;22.03.2017;2017;03;22;Keskiviikko;1;3;4
625;22.03.2017;2017;03;23;Keskiviikko;2;1;3
625;23.03.2017;2017;03;00;Torstai;0;0;0
625;23.03.2017;2017;03;01;Torstai;0;1;1
625;23.03.2017;2017;03;02;Torstai;0;0;0
625;23.03.2017;2017;03;03;Torstai;0;0;0
625;23.03.2017;2017;03;04;Torstai;0;0;0
625;23.03.2017;2017;03;05;Torstai;1;0;1
625;23.03.2017;2017;03;06;Torstai;3;3;6
625;23.03.2017;2017;03;07;Torstai;8;6;14
625;23.03.2017;2017;03;08;Torstai;26;7;33
625;23.03.2017;2017;03;09;Torstai;22;11;33
625;23.03.2017;2017;03;10;Torstai;21;9;30
625;23.03.2017;2017;03;11;Torstai;6;3;9
625;23.03.2017;2017;03;12;Torstai;9;8;17
625;23.03.2017;2017;03;13;Torstai;3;6;9
625;23.03.2017;2017;03;14;Torstai;11;17;28
625;23.03.2017;2017;03;15;Torstai;6;20;26
625;23.03.2017;2017;03;16;Torstai;8;24;32
625;23.03.2017;2017;03;17;Torstai;6;18;24
625;23.03.2017;2017;03;18;Torstai;8;13;21
625;23.03.2017;2017;03;19;Torstai;8;13;21
625;23.03.2017;2017;03;20;Torstai;5;5;10
625;23.03.2017;2017;03;21;Torstai;2;5;7
625;23.03.2017;2017;03;22;Torstai;4;1;5
625;23.03.2017;2017;03;23;Torstai;7;4;11
625;24.03.2017;2017;03;00;Perjantai;0;0;0
625;24.03.2017;2017;03;01;Perjantai;0;1;1
625;24.03.2017;2017;03;02;Perjantai;0;1;1
625;24.03.2017;2017;03;03;Perjantai;0;0;0
625;24.03.2017;2017;03;04;Perjantai;0;0;0
625;24.03.2017;2017;03;05;Perjantai;1;0;1
625;24.03.2017;2017;03;06;Perjantai;3;4;7
625;24.03.2017;2017;03;07;Perjantai;7;5;12
625;24.03.2017;2017;03;08;Perjantai;27;14;41
625;24.03.2017;2017;03;09;Perjantai;18;9;27
625;24.03.2017;2017;03;10;Perjantai;7;5;12
625;24.03.2017;2017;03;11;Perjantai;8;2;10
625;24.03.2017;2017;03;12;Perjantai;3;9;12
625;24.03.2017;2017;03;13;Perjantai;5;16;21
625;24.03.2017;2017;03;14;Perjantai;8;19;27
625;24.03.2017;2017;03;15;Perjantai;3;23;26
625;24.03.2017;2017;03;16;Perjantai;8;26;34
625;24.03.2017;2017;03;17;Perjantai;7;18;25
625;24.03.2017;2017;03;18;Perjantai;5;8;13
625;24.03.2017;2017;03;19;Perjantai;2;3;5
625;24.03.2017;2017;03;20;Perjantai;4;3;7
625;24.03.2017;2017;03;21;Perjantai;0;3;3
625;24.03.2017;2017;03;22;Perjantai;1;0;1
625;24.03.2017;2017;03;23;Perjantai;1;1;2
625;25.03.2017;2017;03;00;Lauantai;0;1;1
625;25.03.2017;2017;03;01;Lauantai;0;1;1
625;25.03.2017;2017;03;02;Lauantai;1;0;1
625;25.03.2017;2017;03;03;Lauantai;0;0;0
625;25.03.2017;2017;03;04;Lauantai;0;0;0
625;25.03.2017;2017;03;05;Lauantai;0;0;0
625;25.03.2017;2017;03;06;Lauantai;0;2;2
625;25.03.2017;2017;03;07;Lauantai;3;0;3
625;25.03.2017;2017;03;08;Lauantai;0;1;1
625;25.03.2017;2017;03;09;Lauantai;1;1;2
625;25.03.2017;2017;03;10;Lauantai;0;2;2
625;25.03.2017;2017;03;11;Lauantai;2;0;2
625;25.03.2017;2017;03;12;Lauantai;4;8;12
625;25.03.2017;2017;03;13;Lauantai;6;8;14
625;25.03.2017;2017;03;14;Lauantai;3;2;5
625;25.03.2017;2017;03;15;Lauantai;8;5;13
625;25.03.2017;2017;03;16;Lauantai;1;1;2
625;25.03.2017;2017;03;17;Lauantai;5;6;11
625;25.03.2017;2017;03;18;Lauantai;7;4;11
625;25.03.2017;2017;03;19;Lauantai;4;3;7
625;25.03.2017;2017;03;20;Lauantai;2;5;7
625;25.03.2017;2017;03;21;Lauantai;1;4;5
625;25.03.2017;2017;03;22;Lauantai;4;1;5
625;25.03.2017;2017;03;23;Lauantai;2;2;4
625;26.03.2017;2017;03;00;Sunnuntai;0;0;0
625;26.03.2017;2017;03;01;Sunnuntai;0;0;0
625;26.03.2017;2017;03;02;Sunnuntai;1;1;2
625;26.03.2017;2017;03;03;Sunnuntai;0;0;0
625;26.03.2017;2017;03;04;Sunnuntai;1;0;1
625;26.03.2017;2017;03;05;Sunnuntai;0;0;0
625;26.03.2017;2017;03;06;Sunnuntai;0;1;1
625;26.03.2017;2017;03;07;Sunnuntai;0;0;0
625;26.03.2017;2017;03;08;Sunnuntai;1;1;2
625;26.03.2017;2017;03;09;Sunnuntai;1;0;1
625;26.03.2017;2017;03;10;Sunnuntai;0;1;1
625;26.03.2017;2017;03;11;Sunnuntai;0;1;1
625;26.03.2017;2017;03;12;Sunnuntai;2;4;6
625;26.03.2017;2017;03;13;Sunnuntai;3;2;5
625;26.03.2017;2017;03;14;Sunnuntai;9;8;17
625;26.03.2017;2017;03;15;Sunnuntai;1;4;5
625;26.03.2017;2017;03;16;Sunnuntai;0;5;5
625;26.03.2017;2017;03;17;Sunnuntai;6;2;8
625;26.03.2017;2017;03;18;Sunnuntai;3;4;7
625;26.03.2017;2017;03;19;Sunnuntai;4;12;16
625;26.03.2017;2017;03;20;Sunnuntai;1;0;1
625;26.03.2017;2017;03;21;Sunnuntai;3;3;6
625;26.03.2017;2017;03;22;Sunnuntai;1;1;2
625;26.03.2017;2017;03;23;Sunnuntai;0;0;0
625;27.03.2017;2017;03;00;Maanantai;2;0;2
625;27.03.2017;2017;03;01;Maanantai;1;0;1
625;27.03.2017;2017;03;02;Maanantai;0;0;0
625;27.03.2017;2017;03;03;Maanantai;0;0;0
625;27.03.2017;2017;03;04;Maanantai;0;0;0
625;27.03.2017;2017;03;05;Maanantai;2;0;2
625;27.03.2017;2017;03;06;Maanantai;0;2;2
625;27.03.2017;2017;03;07;Maanantai;5;4;9
625;27.03.2017;2017;03;08;Maanantai;18;13;31
625;27.03.2017;2017;03;09;Maanantai;30;15;45
625;27.03.2017;2017;03;10;Maanantai;23;5;28
625;27.03.2017;2017;03;11;Maanantai;12;6;18
625;27.03.2017;2017;03;12;Maanantai;8;10;18
625;27.03.2017;2017;03;13;Maanantai;4;8;12
625;27.03.2017;2017;03;14;Maanantai;7;18;25
625;27.03.2017;2017;03;15;Maanantai;6;21;27
625;27.03.2017;2017;03;16;Maanantai;8;33;41
625;27.03.2017;2017;03;17;Maanantai;11;21;32
625;27.03.2017;2017;03;18;Maanantai;8;15;23
625;27.03.2017;2017;03;19;Maanantai;3;6;9
625;27.03.2017;2017;03;20;Maanantai;4;7;11
625;27.03.2017;2017;03;21;Maanantai;3;5;8
625;27.03.2017;2017;03;22;Maanantai;1;4;5
625;27.03.2017;2017;03;23;Maanantai;4;0;4
625;28.03.2017;2017;03;00;Tiistai;0;0;0
625;28.03.2017;2017;03;01;Tiistai;1;0;1
625;28.03.2017;2017;03;02;Tiistai;0;1;1
625;28.03.2017;2017;03;03;Tiistai;0;0;0
625;28.03.2017;2017;03;04;Tiistai;0;0;0
625;28.03.2017;2017;03;05;Tiistai;0;0;0
625;28.03.2017;2017;03;06;Tiistai;1;1;2
625;28.03.2017;2017;03;07;Tiistai;5;2;7
625;28.03.2017;2017;03;08;Tiistai;32;14;46
625;28.03.2017;2017;03;09;Tiistai;26;10;36
625;28.03.2017;2017;03;10;Tiistai;8;2;10
625;28.03.2017;2017;03;11;Tiistai;10;2;12
625;28.03.2017;2017;03;12;Tiistai;5;4;9
625;28.03.2017;2017;03;13;Tiistai;10;12;22
625;28.03.2017;2017;03;14;Tiistai;8;18;26
625;28.03.2017;2017;03;15;Tiistai;13;24;37
625;28.03.2017;2017;03;16;Tiistai;13;29;42
625;28.03.2017;2017;03;17;Tiistai;14;18;32
625;28.03.2017;2017;03;18;Tiistai;9;14;23
625;28.03.2017;2017;03;19;Tiistai;2;8;10
625;28.03.2017;2017;03;20;Tiistai;6;11;17
625;28.03.2017;2017;03;21;Tiistai;6;3;9
625;28.03.2017;2017;03;22;Tiistai;3;1;4
625;28.03.2017;2017;03;23;Tiistai;5;0;5
625;29.03.2017;2017;03;00;Keskiviikko;0;1;1
625;29.03.2017;2017;03;01;Keskiviikko;0;0;0
625;29.03.2017;2017;03;02;Keskiviikko;0;0;0
625;29.03.2017;2017;03;03;Keskiviikko;0;0;0
625;29.03.2017;2017;03;04;Keskiviikko;0;0;0
625;29.03.2017;2017;03;05;Keskiviikko;0;0;0
625;29.03.2017;2017;03;06;Keskiviikko;1;1;2
625;29.03.2017;2017;03;07;Keskiviikko;3;3;6
625;29.03.2017;2017;03;08;Keskiviikko;27;13;40
625;29.03.2017;2017;03;09;Keskiviikko;22;8;30
625;29.03.2017;2017;03;10;Keskiviikko;11;2;13
625;29.03.2017;2017;03;11;Keskiviikko;4;7;11
625;29.03.2017;2017;03;12;Keskiviikko;10;6;16
625;29.03.2017;2017;03;13;Keskiviikko;6;9;15
625;29.03.2017;2017;03;14;Keskiviikko;4;17;21
625;29.03.2017;2017;03;15;Keskiviikko;3;17;20
625;29.03.2017;2017;03;16;Keskiviikko;6;15;21
625;29.03.2017;2017;03;17;Keskiviikko;13;23;36
625;29.03.2017;2017;03;18;Keskiviikko;12;10;22
625;29.03.2017;2017;03;19;Keskiviikko;2;12;14
625;29.03.2017;2017;03;20;Keskiviikko;2;4;6
625;29.03.2017;2017;03;21;Keskiviikko;6;5;11
625;29.03.2017;2017;03;22;Keskiviikko;8;7;15
625;29.03.2017;2017;03;23;Keskiviikko;4;0;4
625;30.03.2017;2017;03;00;Torstai;1;2;3
625;30.03.2017;2017;03;01;Torstai;0;0;0
625;30.03.2017;2017;03;02;Torstai;1;0;1
625;30.03.2017;2017;03;03;Torstai;0;0;0
625;30.03.2017;2017;03;04;Torstai;0;0;0
625;30.03.2017;2017;03;05;Torstai;1;0;1
625;30.03.2017;2017;03;06;Torstai;1;1;2
625;30.03.2017;2017;03;07;Torstai;9;2;11
625;30.03.2017;2017;03;08;Torstai;27;10;37
625;30.03.2017;2017;03;09;Torstai;30;8;38
625;30.03.2017;2017;03;10;Torstai;14;6;20
625;30.03.2017;2017;03;11;Torstai;7;1;8
625;30.03.2017;2017;03;12;Torstai;8;7;15
625;30.03.2017;2017;03;13;Torstai;5;8;13
625;30.03.2017;2017;03;14;Torstai;11;38;49
625;30.03.2017;2017;03;15;Torstai;6;19;25
625;30.03.2017;2017;03;16;Torstai;11;25;36
625;30.03.2017;2017;03;17;Torstai;7;20;27
625;30.03.2017;2017;03;18;Torstai;7;12;19
625;30.03.2017;2017;03;19;Torstai;1;9;10
625;30.03.2017;2017;03;20;Torstai;5;6;11
625;30.03.2017;2017;03;21;Torstai;3;5;8
625;30.03.2017;2017;03;22;Torstai;0;4;4
625;30.03.2017;2017;03;23;Torstai;1;0;1
625;31.03.2017;2017;03;00;Perjantai;1;0;1
625;31.03.2017;2017;03;01;Perjantai;0;0;0
625;31.03.2017;2017;03;02;Perjantai;0;0;0
625;31.03.2017;2017;03;03;Perjantai;0;0;0
625;31.03.2017;2017;03;04;Perjantai;0;0;0
625;31.03.2017;2017;03;05;Perjantai;1;0;1
625;31.03.2017;2017;03;06;Perjantai;1;0;1
625;31.03.2017;2017;03;07;Perjantai;7;2;9
625;31.03.2017;2017;03;08;Perjantai;37;7;44
625;31.03.2017;2017;03;09;Perjantai;15;12;27
625;31.03.2017;2017;03;10;Perjantai;6;6;12
625;31.03.2017;2017;03;11;Perjantai;9;2;11
625;31.03.2017;2017;03;12;Perjantai;1;8;9
625;31.03.2017;2017;03;13;Perjantai;2;16;18
625;31.03.2017;2017;03;14;Perjantai;5;23;28
625;31.03.2017;2017;03;15;Perjantai;6;17;23
625;31.03.2017;2017;03;16;Perjantai;8;14;22
625;31.03.2017;2017;03;17;Perjantai;9;11;20
625;31.03.2017;2017;03;18;Perjantai;4;5;9
625;31.03.2017;2017;03;19;Perjantai;5;6;11
625;31.03.2017;2017;03;20;Perjantai;4;6;10
625;31.03.2017;2017;03;21;Perjantai;1;3;4
625;31.03.2017;2017;03;22;Perjantai;3;0;3
625;31.03.2017;2017;03;23;Perjantai;4;3;7
625;01.04.2017;2017;04;00;Lauantai;0;0;0
625;01.04.2017;2017;04;01;Lauantai;0;0;0
625;01.04.2017;2017;04;02;Lauantai;1;0;1
625;01.04.2017;2017;04;03;Lauantai;0;1;1
625;01.04.2017;2017;04;04;Lauantai;1;0;1
625;01.04.2017;2017;04;05;Lauantai;0;0;0
625;01.04.2017;2017;04;06;Lauantai;0;0;0
625;01.04.2017;2017;04;07;Lauantai;1;0;1
625;01.04.2017;2017;04;08;Lauantai;1;0;1
625;01.04.2017;2017;04;09;Lauantai;1;0;1
625;01.04.2017;2017;04;10;Lauantai;4;0;4
625;01.04.2017;2017;04;11;Lauantai;5;2;7
625;01.04.2017;2017;04;12;Lauantai;2;2;4
625;01.04.2017;2017;04;13;Lauantai;4;6;10
625;01.04.2017;2017;04;14;Lauantai;7;2;9
625;01.04.2017;2017;04;15;Lauantai;3;4;7
625;01.04.2017;2017;04;16;Lauantai;3;3;6
625;01.04.2017;2017;04;17;Lauantai;1;1;2
625;01.04.2017;2017;04;18;Lauantai;1;2;3
625;01.04.2017;2017;04;19;Lauantai;6;4;10
625;01.04.2017;2017;04;20;Lauantai;3;5;8
625;01.04.2017;2017;04;21;Lauantai;1;4;5
625;01.04.2017;2017;04;22;Lauantai;2;1;3
625;01.04.2017;2017;04;23;Lauantai;0;0;0
625;02.04.2017;2017;04;00;Sunnuntai;1;1;2
625;02.04.2017;2017;04;01;Sunnuntai;0;0;0
625;02.04.2017;2017;04;02;Sunnuntai;1;0;1
625;02.04.2017;2017;04;03;Sunnuntai;0;0;0
625;02.04.2017;2017;04;04;Sunnuntai;0;0;0
625;02.04.2017;2017;04;05;Sunnuntai;0;0;0
625;02.04.2017;2017;04;06;Sunnuntai;1;1;2
625;02.04.2017;2017;04;07;Sunnuntai;0;1;1
625;02.04.2017;2017;04;08;Sunnuntai;0;0;0
625;02.04.2017;2017;04;09;Sunnuntai;1;1;2
625;02.04.2017;2017;04;10;Sunnuntai;2;1;3
625;02.04.2017;2017;04;11;Sunnuntai;4;1;5
625;02.04.2017;2017;04;12;Sunnuntai;2;4;6
625;02.04.2017;2017;04;13;Sunnuntai;2;2;4
625;02.04.2017;2017;04;14;Sunnuntai;6;3;9
625;02.04.2017;2017;04;15;Sunnuntai;4;4;8
625;02.04.2017;2017;04;16;Sunnuntai;6;4;10
625;02.04.2017;2017;04;17;Sunnuntai;1;1;2
625;02.04.2017;2017;04;18;Sunnuntai;2;4;6
625;02.04.2017;2017;04;19;Sunnuntai;4;5;9
625;02.04.2017;2017;04;20;Sunnuntai;6;1;7
625;02.04.2017;2017;04;21;Sunnuntai;1;6;7
625;02.04.2017;2017;04;22;Sunnuntai;2;2;4
625;02.04.2017;2017;04;23;Sunnuntai;3;1;4
625;03.04.2017;2017;04;00;Maanantai;1;0;1
625;03.04.2017;2017;04;01;Maanantai;0;0;0
625;03.04.2017;2017;04;02;Maanantai;0;0;0
625;03.04.2017;2017;04;03;Maanantai;0;0;0
625;03.04.2017;2017;04;04;Maanantai;0;0;0
625;03.04.2017;2017;04;05;Maanantai;1;1;2
625;03.04.2017;2017;04;06;Maanantai;1;2;3
625;03.04.2017;2017;04;07;Maanantai;8;5;13
625;03.04.2017;2017;04;08;Maanantai;30;11;41
625;03.04.2017;2017;04;09;Maanantai;33;12;45
625;03.04.2017;2017;04;10;Maanantai;9;2;11
625;03.04.2017;2017;04;11;Maanantai;20;4;24
625;03.04.2017;2017;04;12;Maanantai;2;6;8
625;03.04.2017;2017;04;13;Maanantai;7;13;20
625;03.04.2017;2017;04;14;Maanantai;7;18;25
625;03.04.2017;2017;04;15;Maanantai;5;13;18
625;03.04.2017;2017;04;16;Maanantai;14;37;51
625;03.04.2017;2017;04;17;Maanantai;18;21;39
625;03.04.2017;2017;04;18;Maanantai;12;18;30
625;03.04.2017;2017;04;19;Maanantai;7;14;21
625;03.04.2017;2017;04;20;Maanantai;3;2;5
625;03.04.2017;2017;04;21;Maanantai;7;3;10
625;03.04.2017;2017;04;22;Maanantai;6;2;8
625;03.04.2017;2017;04;23;Maanantai;1;1;2
625;04.04.2017;2017;04;00;Tiistai;0;0;0
625;04.04.2017;2017;04;01;Tiistai;0;0;0
625;04.04.2017;2017;04;02;Tiistai;0;0;0
625;04.04.2017;2017;04;03;Tiistai;0;0;0
625;04.04.2017;2017;04;04;Tiistai;0;0;0
625;04.04.2017;2017;04;05;Tiistai;0;0;0
625;04.04.2017;2017;04;06;Tiistai;1;1;2
625;04.04.2017;2017;04;07;Tiistai;5;6;11
625;04.04.2017;2017;04;08;Tiistai;32;23;55
625;04.04.2017;2017;04;09;Tiistai;32;9;41
625;04.04.2017;2017;04;10;Tiistai;10;4;14
625;04.04.2017;2017;04;11;Tiistai;8;3;11
625;04.04.2017;2017;04;12;Tiistai;5;10;15
625;04.04.2017;2017;04;13;Tiistai;7;8;15
625;04.04.2017;2017;04;14;Tiistai;9;17;26
625;04.04.2017;2017;04;15;Tiistai;11;28;39
625;04.04.2017;2017;04;16;Tiistai;15;42;57
625;04.04.2017;2017;04;17;Tiistai;15;22;37
625;04.04.2017;2017;04;18;Tiistai;11;13;24
625;04.04.2017;2017;04;19;Tiistai;4;11;15
625;04.04.2017;2017;04;20;Tiistai;3;4;7
625;04.04.2017;2017;04;21;Tiistai;5;6;11
625;04.04.2017;2017;04;22;Tiistai;2;7;9
625;04.04.2017;2017;04;23;Tiistai;1;1;2
625;05.04.2017;2017;04;00;Keskiviikko;0;0;0
625;05.04.2017;2017;04;01;Keskiviikko;1;0;1
625;05.04.2017;2017;04;02;Keskiviikko;0;0;0
625;05.04.2017;2017;04;03;Keskiviikko;0;0;0
625;05.04.2017;2017;04;04;Keskiviikko;0;0;0
625;05.04.2017;2017;04;05;Keskiviikko;1;0;1
625;05.04.2017;2017;04;06;Keskiviikko;1;2;3
625;05.04.2017;2017;04;07;Keskiviikko;9;7;16
625;05.04.2017;2017;04;08;Keskiviikko;40;20;60
625;05.04.2017;2017;04;09;Keskiviikko;29;15;44
625;05.04.2017;2017;04;10;Keskiviikko;13;7;20
625;05.04.2017;2017;04;11;Keskiviikko;10;7;17
625;05.04.2017;2017;04;12;Keskiviikko;6;8;14
625;05.04.2017;2017;04;13;Keskiviikko;16;17;33
625;05.04.2017;2017;04;14;Keskiviikko;6;20;26
625;05.04.2017;2017;04;15;Keskiviikko;8;33;41
625;05.04.2017;2017;04;16;Keskiviikko;10;34;44
625;05.04.2017;2017;04;17;Keskiviikko;20;25;45
625;05.04.2017;2017;04;18;Keskiviikko;15;17;32
625;05.04.2017;2017;04;19;Keskiviikko;3;13;16
625;05.04.2017;2017;04;20;Keskiviikko;4;7;11
625;05.04.2017;2017;04;21;Keskiviikko;9;9;18
625;05.04.2017;2017;04;22;Keskiviikko;5;7;12
625;05.04.2017;2017;04;23;Keskiviikko;3;1;4
625;06.04.2017;2017;04;00;Torstai;1;0;1
625;06.04.2017;2017;04;01;Torstai;1;0;1
625;06.04.2017;2017;04;02;Torstai;0;0;0
625;06.04.2017;2017;04;03;Torstai;0;0;0
625;06.04.2017;2017;04;04;Torstai;0;0;0
625;06.04.2017;2017;04;05;Torstai;1;1;2
625;06.04.2017;2017;04;06;Torstai;2;1;3
625;06.04.2017;2017;04;07;Torstai;11;5;16
625;06.04.2017;2017;04;08;Torstai;39;19;58
625;06.04.2017;2017;04;09;Torstai;23;6;29
625;06.04.2017;2017;04;10;Torstai;12;8;20
625;06.04.2017;2017;04;11;Torstai;9;4;13
625;06.04.2017;2017;04;12;Torstai;9;6;15
625;06.04.2017;2017;04;13;Torstai;8;9;17
625;06.04.2017;2017;04;14;Torstai;8;29;37
625;06.04.2017;2017;04;15;Torstai;21;29;50
625;06.04.2017;2017;04;16;Torstai;10;25;35
625;06.04.2017;2017;04;17;Torstai;17;18;35
625;06.04.2017;2017;04;18;Torstai;10;12;22
625;06.04.2017;2017;04;19;Torstai;10;9;19
625;06.04.2017;2017;04;20;Torstai;5;7;12
625;06.04.2017;2017;04;21;Torstai;4;6;10
625;06.04.2017;2017;04;22;Torstai;3;5;8
625;06.04.2017;2017;04;23;Torstai;2;2;4
625;07.04.2017;2017;04;00;Perjantai;0;1;1
625;07.04.2017;2017;04;01;Perjantai;0;0;0
625;07.04.2017;2017;04;02;Perjantai;0;0;0
625;07.04.2017;2017;04;03;Perjantai;0;0;0
625;07.04.2017;2017;04;04;Perjantai;0;0;0
625;07.04.2017;2017;04;05;Perjantai;1;1;2
625;07.04.2017;2017;04;06;Perjantai;1;2;3
625;07.04.2017;2017;04;07;Perjantai;9;1;10
625;07.04.2017;2017;04;08;Perjantai;59;21;80
625;07.04.2017;2017;04;09;Perjantai;22;6;28
625;07.04.2017;2017;04;10;Perjantai;13;9;22
625;07.04.2017;2017;04;11;Perjantai;7;4;11
625;07.04.2017;2017;04;12;Perjantai;5;13;18
625;07.04.2017;2017;04;13;Perjantai;4;25;29
625;07.04.2017;2017;04;14;Perjantai;10;22;32
625;07.04.2017;2017;04;15;Perjantai;9;20;29
625;07.04.2017;2017;04;16;Perjantai;10;20;30
625;07.04.2017;2017;04;17;Perjantai;6;7;13
625;07.04.2017;2017;04;18;Perjantai;5;11;16
625;07.04.2017;2017;04;19;Perjantai;7;10;17
625;07.04.2017;2017;04;20;Perjantai;4;5;9
625;07.04.2017;2017;04;21;Perjantai;4;3;7
625;07.04.2017;2017;04;22;Perjantai;2;3;5
625;07.04.2017;2017;04;23;Perjantai;2;1;3
625;08.04.2017;2017;04;00;Lauantai;0;2;2
625;08.04.2017;2017;04;01;Lauantai;1;0;1
625;08.04.2017;2017;04;02;Lauantai;0;0;0
625;08.04.2017;2017;04;03;Lauantai;0;1;1
625;08.04.2017;2017;04;04;Lauantai;0;0;0
625;08.04.2017;2017;04;05;Lauantai;0;0;0
625;08.04.2017;2017;04;06;Lauantai;0;0;0
625;08.04.2017;2017;04;07;Lauantai;0;1;1
625;08.04.2017;2017;04;08;Lauantai;1;5;6
625;08.04.2017;2017;04;09;Lauantai;0;0;0
625;08.04.2017;2017;04;10;Lauantai;4;3;7
625;08.04.2017;2017;04;11;Lauantai;9;8;17
625;08.04.2017;2017;04;12;Lauantai;10;8;18
625;08.04.2017;2017;04;13;Lauantai;8;11;19
625;08.04.2017;2017;04;14;Lauantai;6;5;11
625;08.04.2017;2017;04;15;Lauantai;2;5;7
625;08.04.2017;2017;04;16;Lauantai;4;5;9
625;08.04.2017;2017;04;17;Lauantai;6;4;10
625;08.04.2017;2017;04;18;Lauantai;2;5;7
625;08.04.2017;2017;04;19;Lauantai;1;1;2
625;08.04.2017;2017;04;20;Lauantai;6;3;9
625;08.04.2017;2017;04;21;Lauantai;2;7;9
625;08.04.2017;2017;04;22;Lauantai;3;5;8
625;08.04.2017;2017;04;23;Lauantai;3;0;3
625;09.04.2017;2017;04;00;Sunnuntai;0;1;1
625;09.04.2017;2017;04;01;Sunnuntai;1;0;1
625;09.04.2017;2017;04;02;Sunnuntai;0;1;1
625;09.04.2017;2017;04;03;Sunnuntai;0;0;0
625;09.04.2017;2017;04;04;Sunnuntai;0;0;0
625;09.04.2017;2017;04;05;Sunnuntai;0;0;0
625;09.04.2017;2017;04;06;Sunnuntai;0;0;0
625;09.04.2017;2017;04;07;Sunnuntai;0;0;0
625;09.04.2017;2017;04;08;Sunnuntai;2;4;6
625;09.04.2017;2017;04;09;Sunnuntai;0;1;1
625;09.04.2017;2017;04;10;Sunnuntai;1;3;4
625;09.04.2017;2017;04;11;Sunnuntai;8;8;16
625;09.04.2017;2017;04;12;Sunnuntai;5;6;11
625;09.04.2017;2017;04;13;Sunnuntai;11;8;19
625;09.04.2017;2017;04;14;Sunnuntai;11;8;19
625;09.04.2017;2017;04;15;Sunnuntai;7;5;12
625;09.04.2017;2017;04;16;Sunnuntai;10;4;14
625;09.04.2017;2017;04;17;Sunnuntai;5;5;10
625;09.04.2017;2017;04;18;Sunnuntai;11;7;18
625;09.04.2017;2017;04;19;Sunnuntai;10;8;18
625;09.04.2017;2017;04;20;Sunnuntai;5;6;11
625;09.04.2017;2017;04;21;Sunnuntai;3;4;7
625;09.04.2017;2017;04;22;Sunnuntai;2;4;6
625;09.04.2017;2017;04;23;Sunnuntai;2;1;3
625;10.04.2017;2017;04;00;Maanantai;1;0;1
625;10.04.2017;2017;04;01;Maanantai;0;1;1
625;10.04.2017;2017;04;02;Maanantai;1;0;1
625;10.04.2017;2017;04;03;Maanantai;0;0;0
625;10.04.2017;2017;04;04;Maanantai;0;0;0
625;10.04.2017;2017;04;05;Maanantai;1;0;1
625;10.04.2017;2017;04;06;Maanantai;1;4;5
625;10.04.2017;2017;04;07;Maanantai;10;5;15
625;10.04.2017;2017;04;08;Maanantai;34;17;51
625;10.04.2017;2017;04;09;Maanantai;30;13;43
625;10.04.2017;2017;04;10;Maanantai;15;9;24
625;10.04.2017;2017;04;11;Maanantai;13;0;13
625;10.04.2017;2017;04;12;Maanantai;4;7;11
625;10.04.2017;2017;04;13;Maanantai;6;11;17
625;10.04.2017;2017;04;14;Maanantai;3;15;18
625;10.04.2017;2017;04;15;Maanantai;13;35;48
625;10.04.2017;2017;04;16;Maanantai;8;34;42
625;10.04.2017;2017;04;17;Maanantai;6;19;25
625;10.04.2017;2017;04;18;Maanantai;7;14;21
625;10.04.2017;2017;04;19;Maanantai;3;4;7
625;10.04.2017;2017;04;20;Maanantai;4;4;8
625;10.04.2017;2017;04;21;Maanantai;2;3;5
625;10.04.2017;2017;04;22;Maanantai;2;2;4
625;10.04.2017;2017;04;23;Maanantai;3;0;3
625;11.04.2017;2017;04;00;Tiistai;0;0;0
625;11.04.2017;2017;04;01;Tiistai;0;0;0
625;11.04.2017;2017;04;02;Tiistai;0;0;0
625;11.04.2017;2017;04;03;Tiistai;0;0;0
625;11.04.2017;2017;04;04;Tiistai;0;0;0
625;11.04.2017;2017;04;05;Tiistai;1;0;1
625;11.04.2017;2017;04;06;Tiistai;2;3;5
625;11.04.2017;2017;04;07;Tiistai;7;7;14
625;11.04.2017;2017;04;08;Tiistai;32;15;47
625;11.04.2017;2017;04;09;Tiistai;25;5;30
625;11.04.2017;2017;04;10;Tiistai;10;4;14
625;11.04.2017;2017;04;11;Tiistai;15;2;17
625;11.04.2017;2017;04;12;Tiistai;10;2;12
625;11.04.2017;2017;04;13;Tiistai;6;12;18
625;11.04.2017;2017;04;14;Tiistai;4;12;16
625;11.04.2017;2017;04;15;Tiistai;6;22;28
625;11.04.2017;2017;04;16;Tiistai;16;25;41
625;11.04.2017;2017;04;17;Tiistai;15;14;29
625;11.04.2017;2017;04;18;Tiistai;5;8;13
625;11.04.2017;2017;04;19;Tiistai;8;8;16
625;11.04.2017;2017;04;20;Tiistai;6;12;18
625;11.04.2017;2017;04;21;Tiistai;4;5;9
625;11.04.2017;2017;04;22;Tiistai;1;1;2
625;11.04.2017;2017;04;23;Tiistai;0;1;1
625;12.04.2017;2017;04;00;Keskiviikko;0;1;1
625;12.04.2017;2017;04;01;Keskiviikko;0;0;0
625;12.04.2017;2017;04;02;Keskiviikko;0;0;0
625;12.04.2017;2017;04;03;Keskiviikko;0;0;0
625;12.04.2017;2017;04;04;Keskiviikko;0;0;0
625;12.04.2017;2017;04;05;Keskiviikko;1;0;1
625;12.04.2017;2017;04;06;Keskiviikko;1;2;3
625;12.04.2017;2017;04;07;Keskiviikko;6;6;12
625;12.04.2017;2017;04;08;Keskiviikko;51;18;69
625;12.04.2017;2017;04;09;Keskiviikko;22;6;28
625;12.04.2017;2017;04;10;Keskiviikko;14;5;19
625;12.04.2017;2017;04;11;Keskiviikko;7;6;13
625;12.04.2017;2017;04;12;Keskiviikko;5;7;12
625;12.04.2017;2017;04;13;Keskiviikko;4;15;19
625;12.04.2017;2017;04;14;Keskiviikko;4;19;23
625;12.04.2017;2017;04;15;Keskiviikko;14;20;34
625;12.04.2017;2017;04;16;Keskiviikko;11;26;37
625;12.04.2017;2017;04;17;Keskiviikko;9;18;27
625;12.04.2017;2017;04;18;Keskiviikko;11;12;23
625;12.04.2017;2017;04;19;Keskiviikko;6;10;16
625;12.04.2017;2017;04;20;Keskiviikko;5;4;9
625;12.04.2017;2017;04;21;Keskiviikko;6;8;14
625;12.04.2017;2017;04;22;Keskiviikko;0;4;4
625;12.04.2017;2017;04;23;Keskiviikko;3;2;5
625;13.04.2017;2017;04;00;Torstai;0;1;1
625;13.04.2017;2017;04;01;Torstai;0;0;0
625;13.04.2017;2017;04;02;Torstai;0;0;0
625;13.04.2017;2017;04;03;Torstai;0;0;0
625;13.04.2017;2017;04;04;Torstai;0;0;0
625;13.04.2017;2017;04;05;Torstai;1;0;1
625;13.04.2017;2017;04;06;Torstai;1;2;3
625;13.04.2017;2017;04;07;Torstai;8;6;14
625;13.04.2017;2017;04;08;Torstai;43;14;57
625;13.04.2017;2017;04;09;Torstai;22;5;27
625;13.04.2017;2017;04;10;Torstai;10;2;12
625;13.04.2017;2017;04;11;Torstai;6;6;12
625;13.04.2017;2017;04;12;Torstai;6;16;22
625;13.04.2017;2017;04;13;Torstai;4;14;18
625;13.04.2017;2017;04;14;Torstai;8;16;24
625;13.04.2017;2017;04;15;Torstai;7;20;27
625;13.04.2017;2017;04;16;Torstai;27;21;48
625;13.04.2017;2017;04;17;Torstai;8;12;20
625;13.04.2017;2017;04;18;Torstai;2;8;10
625;13.04.2017;2017;04;19;Torstai;11;5;16
625;13.04.2017;2017;04;20;Torstai;3;6;9
625;13.04.2017;2017;04;21;Torstai;5;1;6
625;13.04.2017;2017;04;22;Torstai;2;4;6
625;13.04.2017;2017;04;23;Torstai;2;0;2
625;14.04.2017;2017;04;00;Perjantai;0;0;0
625;14.04.2017;2017;04;01;Perjantai;0;1;1
625;14.04.2017;2017;04;02;Perjantai;0;0;0
625;14.04.2017;2017;04;03;Perjantai;0;0;0
625;14.04.2017;2017;04;04;Perjantai;0;0;0
625;14.04.2017;2017;04;05;Perjantai;0;0;0
625;14.04.2017;2017;04;06;Perjantai;0;0;0
625;14.04.2017;2017;04;07;Perjantai;0;1;1
625;14.04.2017;2017;04;08;Perjantai;0;0;0
625;14.04.2017;2017;04;09;Perjantai;1;1;2
625;14.04.2017;2017;04;10;Perjantai;2;3;5
625;14.04.2017;2017;04;11;Perjantai;2;5;7
625;14.04.2017;2017;04;12;Perjantai;2;3;5
625;14.04.2017;2017;04;13;Perjantai;8;8;16
625;14.04.2017;2017;04;14;Perjantai;6;12;18
625;14.04.2017;2017;04;15;Perjantai;6;4;10
625;14.04.2017;2017;04;16;Perjantai;5;5;10
625;14.04.2017;2017;04;17;Perjantai;3;5;8
625;14.04.2017;2017;04;18;Perjantai;4;3;7
625;14.04.2017;2017;04;19;Perjantai;5;7;12
625;14.04.2017;2017;04;20;Perjantai;3;1;4
625;14.04.2017;2017;04;21;Perjantai;5;3;8
625;14.04.2017;2017;04;22;Perjantai;1;0;1
625;14.04.2017;2017;04;23;Perjantai;1;0;1
625;15.04.2017;2017;04;00;Lauantai;1;1;2
625;15.04.2017;2017;04;01;Lauantai;0;0;0
625;15.04.2017;2017;04;02;Lauantai;2;0;2
625;15.04.2017;2017;04;03;Lauantai;0;0;0
625;15.04.2017;2017;04;04;Lauantai;0;0;0
625;15.04.2017;2017;04;05;Lauantai;0;0;0
625;15.04.2017;2017;04;06;Lauantai;0;0;0
625;15.04.2017;2017;04;07;Lauantai;2;1;3
625;15.04.2017;2017;04;08;Lauantai;3;1;4
625;15.04.2017;2017;04;09;Lauantai;0;1;1
625;15.04.2017;2017;04;10;Lauantai;1;0;1
625;15.04.2017;2017;04;11;Lauantai;5;1;6
625;15.04.2017;2017;04;12;Lauantai;2;4;6
625;15.04.2017;2017;04;13;Lauantai;2;5;7
625;15.04.2017;2017;04;14;Lauantai;5;3;8
625;15.04.2017;2017;04;15;Lauantai;5;5;10
625;15.04.2017;2017;04;16;Lauantai;5;2;7
625;15.04.2017;2017;04;17;Lauantai;0;1;1
625;15.04.2017;2017;04;18;Lauantai;6;3;9
625;15.04.2017;2017;04;19;Lauantai;2;5;7
625;15.04.2017;2017;04;20;Lauantai;5;4;9
625;15.04.2017;2017;04;21;Lauantai;2;3;5
625;15.04.2017;2017;04;22;Lauantai;0;3;3
625;15.04.2017;2017;04;23;Lauantai;5;1;6
625;16.04.2017;2017;04;00;Sunnuntai;0;0;0
625;16.04.2017;2017;04;01;Sunnuntai;0;1;1
625;16.04.2017;2017;04;02;Sunnuntai;0;2;2
625;16.04.2017;2017;04;03;Sunnuntai;0;0;0
625;16.04.2017;2017;04;04;Sunnuntai;1;2;3
625;16.04.2017;2017;04;05;Sunnuntai;0;0;0
625;16.04.2017;2017;04;06;Sunnuntai;1;0;1
625;16.04.2017;2017;04;07;Sunnuntai;0;1;1
625;16.04.2017;2017;04;08;Sunnuntai;0;2;2
625;16.04.2017;2017;04;09;Sunnuntai;1;0;1
625;16.04.2017;2017;04;10;Sunnuntai;5;4;9
625;16.04.2017;2017;04;11;Sunnuntai;0;2;2
625;16.04.2017;2017;04;12;Sunnuntai;0;1;1
625;16.04.2017;2017;04;13;Sunnuntai;1;6;7
625;16.04.2017;2017;04;14;Sunnuntai;10;5;15
625;16.04.2017;2017;04;15;Sunnuntai;11;10;21
625;16.04.2017;2017;04;16;Sunnuntai;7;3;10
625;16.04.2017;2017;04;17;Sunnuntai;8;5;13
625;16.04.2017;2017;04;18;Sunnuntai;4;6;10
625;16.04.2017;2017;04;19;Sunnuntai;4;9;13
625;16.04.2017;2017;04;20;Sunnuntai;5;4;9
625;16.04.2017;2017;04;21;Sunnuntai;3;3;6
625;16.04.2017;2017;04;22;Sunnuntai;2;0;2
625;16.04.2017;2017;04;23;Sunnuntai;2;1;3
625;17.04.2017;2017;04;00;Maanantai;0;1;1
625;17.04.2017;2017;04;01;Maanantai;1;0;1
625;17.04.2017;2017;04;02;Maanantai;0;0;0
625;17.04.2017;2017;04;03;Maanantai;0;0;0
625;17.04.2017;2017;04;04;Maanantai;0;0;0
625;17.04.2017;2017;04;05;Maanantai;0;0;0
625;17.04.2017;2017;04;06;Maanantai;0;0;0
625;17.04.2017;2017;04;07;Maanantai;0;0;0
625;17.04.2017;2017;04;08;Maanantai;0;1;1
625;17.04.2017;2017;04;09;Maanantai;0;0;0
625;17.04.2017;2017;04;10;Maanantai;3;1;4
625;17.04.2017;2017;04;11;Maanantai;3;5;8
625;17.04.2017;2017;04;12;Maanantai;7;5;12
625;17.04.2017;2017;04;13;Maanantai;9;13;22
625;17.04.2017;2017;04;14;Maanantai;14;8;22
625;17.04.2017;2017;04;15;Maanantai;5;8;13
625;17.04.2017;2017;04;16;Maanantai;12;17;29
625;17.04.2017;2017;04;17;Maanantai;10;10;20
625;17.04.2017;2017;04;18;Maanantai;10;8;18
625;17.04.2017;2017;04;19;Maanantai;3;8;11
625;17.04.2017;2017;04;20;Maanantai;10;4;14
625;17.04.2017;2017;04;21;Maanantai;4;3;7
625;17.04.2017;2017;04;22;Maanantai;2;3;5
625;17.04.2017;2017;04;23;Maanantai;1;0;1
625;18.04.2017;2017;04;00;Tiistai;0;0;0
625;18.04.2017;2017;04;01;Tiistai;0;0;0
625;18.04.2017;2017;04;02;Tiistai;0;0;0
625;18.04.2017;2017;04;03;Tiistai;0;0;0
625;18.04.2017;2017;04;04;Tiistai;0;0;0
625;18.04.2017;2017;04;05;Tiistai;0;1;1
625;18.04.2017;2017;04;06;Tiistai;0;4;4
625;18.04.2017;2017;04;07;Tiistai;11;6;17
625;18.04.2017;2017;04;08;Tiistai;46;28;74
625;18.04.2017;2017;04;09;Tiistai;30;16;46
625;18.04.2017;2017;04;10;Tiistai;19;10;29
625;18.04.2017;2017;04;11;Tiistai;11;4;15
625;18.04.2017;2017;04;12;Tiistai;7;7;14
625;18.04.2017;2017;04;13;Tiistai;10;14;24
625;18.04.2017;2017;04;14;Tiistai;10;19;29
625;18.04.2017;2017;04;15;Tiistai;10;28;38
625;18.04.2017;2017;04;16;Tiistai;17;33;50
625;18.04.2017;2017;04;17;Tiistai;21;31;52
625;18.04.2017;2017;04;18;Tiistai;17;22;39
625;18.04.2017;2017;04;19;Tiistai;9;10;19
625;18.04.2017;2017;04;20;Tiistai;7;11;18
625;18.04.2017;2017;04;21;Tiistai;2;9;11
625;18.04.2017;2017;04;22;Tiistai;4;2;6
625;18.04.2017;2017;04;23;Tiistai;4;2;6
625;19.04.2017;2017;04;00;Keskiviikko;2;0;2
625;19.04.2017;2017;04;01;Keskiviikko;0;0;0
625;19.04.2017;2017;04;02;Keskiviikko;0;0;0
625;19.04.2017;2017;04;03;Keskiviikko;0;0;0
625;19.04.2017;2017;04;04;Keskiviikko;0;0;0
625;19.04.2017;2017;04;05;Keskiviikko;0;1;1
625;19.04.2017;2017;04;06;Keskiviikko;1;3;4
625;19.04.2017;2017;04;07;Keskiviikko;9;3;12
625;19.04.2017;2017;04;08;Keskiviikko;56;28;84
625;19.04.2017;2017;04;09;Keskiviikko;27;12;39
625;19.04.2017;2017;04;10;Keskiviikko;19;8;27
625;19.04.2017;2017;04;11;Keskiviikko;11;4;15
625;19.04.2017;2017;04;12;Keskiviikko;8;9;17
625;19.04.2017;2017;04;13;Keskiviikko;10;17;27
625;19.04.2017;2017;04;14;Keskiviikko;10;20;30
625;19.04.2017;2017;04;15;Keskiviikko;16;33;49
625;19.04.2017;2017;04;16;Keskiviikko;7;15;22
625;19.04.2017;2017;04;17;Keskiviikko;24;33;57
625;19.04.2017;2017;04;18;Keskiviikko;19;14;33
625;19.04.2017;2017;04;19;Keskiviikko;11;24;35
625;19.04.2017;2017;04;20;Keskiviikko;14;14;28
625;19.04.2017;2017;04;21;Keskiviikko;7;19;26
625;19.04.2017;2017;04;22;Keskiviikko;1;2;3
625;19.04.2017;2017;04;23;Keskiviikko;4;0;4
625;20.04.2017;2017;04;00;Torstai;0;0;0
625;20.04.2017;2017;04;01;Torstai;0;1;1
625;20.04.2017;2017;04;02;Torstai;0;0;0
625;20.04.2017;2017;04;03;Torstai;0;0;0
625;20.04.2017;2017;04;04;Torstai;0;1;1
625;20.04.2017;2017;04;05;Torstai;0;1;1
625;20.04.2017;2017;04;06;Torstai;0;1;1
625;20.04.2017;2017;04;07;Torstai;9;2;11
625;20.04.2017;2017;04;08;Torstai;53;26;79
625;20.04.2017;2017;04;09;Torstai;29;14;43
625;20.04.2017;2017;04;10;Torstai;9;9;18
625;20.04.2017;2017;04;11;Torstai;4;7;11
625;20.04.2017;2017;04;12;Torstai;12;14;26
625;20.04.2017;2017;04;13;Torstai;8;8;16
625;20.04.2017;2017;04;14;Torstai;11;30;41
625;20.04.2017;2017;04;15;Torstai;10;28;38
625;20.04.2017;2017;04;16;Torstai;8;18;26
625;20.04.2017;2017;04;17;Torstai;16;13;29
625;20.04.2017;2017;04;18;Torstai;7;5;12
625;20.04.2017;2017;04;19;Torstai;2;6;8
625;20.04.2017;2017;04;20;Torstai;2;5;7
625;20.04.2017;2017;04;21;Torstai;2;3;5
625;20.04.2017;2017;04;22;Torstai;5;3;8
625;20.04.2017;2017;04;23;Torstai;1;0;1
625;21.04.2017;2017;04;00;Perjantai;0;1;1
625;21.04.2017;2017;04;01;Perjantai;0;0;0
625;21.04.2017;2017;04;02;Perjantai;0;0;0
625;21.04.2017;2017;04;03;Perjantai;1;0;1
625;21.04.2017;2017;04;04;Perjantai;0;0;0
625;21.04.2017;2017;04;05;Perjantai;0;0;0
625;21.04.2017;2017;04;06;Perjantai;2;3;5
625;21.04.2017;2017;04;07;Perjantai;6;1;7
625;21.04.2017;2017;04;08;Perjantai;58;24;82
625;21.04.2017;2017;04;09;Perjantai;27;12;39
625;21.04.2017;2017;04;10;Perjantai;9;6;15
625;21.04.2017;2017;04;11;Perjantai;11;6;17
625;21.04.2017;2017;04;12;Perjantai;8;16;24
625;21.04.2017;2017;04;13;Perjantai;9;19;28
625;21.04.2017;2017;04;14;Perjantai;14;30;44
625;21.04.2017;2017;04;15;Perjantai;13;17;30
625;21.04.2017;2017;04;16;Perjantai;15;24;39
625;21.04.2017;2017;04;17;Perjantai;13;19;32
625;21.04.2017;2017;04;18;Perjantai;16;12;28
625;21.04.2017;2017;04;19;Perjantai;8;12;20
625;21.04.2017;2017;04;20;Perjantai;6;5;11
625;21.04.2017;2017;04;21;Perjantai;5;5;10
625;21.04.2017;2017;04;22;Perjantai;4;7;11
625;21.04.2017;2017;04;23;Perjantai;1;1;2
625;22.04.2017;2017;04;00;Lauantai;1;2;3
625;22.04.2017;2017;04;01;Lauantai;0;1;1
625;22.04.2017;2017;04;02;Lauantai;2;0;2
625;22.04.2017;2017;04;03;Lauantai;0;0;0
625;22.04.2017;2017;04;04;Lauantai;0;0;0
625;22.04.2017;2017;04;05;Lauantai;0;0;0
625;22.04.2017;2017;04;06;Lauantai;0;0;0
625;22.04.2017;2017;04;07;Lauantai;3;1;4
625;22.04.2017;2017;04;08;Lauantai;0;1;1
625;22.04.2017;2017;04;09;Lauantai;2;0;2
625;22.04.2017;2017;04;10;Lauantai;3;0;3
625;22.04.2017;2017;04;11;Lauantai;6;3;9
625;22.04.2017;2017;04;12;Lauantai;6;5;11
625;22.04.2017;2017;04;13;Lauantai;14;12;26
625;22.04.2017;2017;04;14;Lauantai;9;11;20
625;22.04.2017;2017;04;15;Lauantai;7;3;10
625;22.04.2017;2017;04;16;Lauantai;10;10;20
625;22.04.2017;2017;04;17;Lauantai;5;10;15
625;22.04.2017;2017;04;18;Lauantai;5;6;11
625;22.04.2017;2017;04;19;Lauantai;3;15;18
625;22.04.2017;2017;04;20;Lauantai;5;5;10
625;22.04.2017;2017;04;21;Lauantai;6;7;13
625;22.04.2017;2017;04;22;Lauantai;2;2;4
625;22.04.2017;2017;04;23;Lauantai;1;1;2
625;23.04.2017;2017;04;00;Sunnuntai;1;4;5
625;23.04.2017;2017;04;01;Sunnuntai;1;1;2
625;23.04.2017;2017;04;02;Sunnuntai;1;0;1
625;23.04.2017;2017;04;03;Sunnuntai;2;1;3
625;23.04.2017;2017;04;04;Sunnuntai;1;1;2
625;23.04.2017;2017;04;05;Sunnuntai;0;0;0
625;23.04.2017;2017;04;06;Sunnuntai;0;0;0
625;23.04.2017;2017;04;07;Sunnuntai;0;2;2
625;23.04.2017;2017;04;08;Sunnuntai;0;1;1
625;23.04.2017;2017;04;09;Sunnuntai;1;1;2
625;23.04.2017;2017;04;10;Sunnuntai;2;1;3
625;23.04.2017;2017;04;11;Sunnuntai;4;9;13
625;23.04.2017;2017;04;12;Sunnuntai;6;6;12
625;23.04.2017;2017;04;13;Sunnuntai;13;7;20
625;23.04.2017;2017;04;14;Sunnuntai;17;9;26
625;23.04.2017;2017;04;15;Sunnuntai;6;6;12
625;23.04.2017;2017;04;16;Sunnuntai;16;11;27
625;23.04.2017;2017;04;17;Sunnuntai;10;11;21
625;23.04.2017;2017;04;18;Sunnuntai;3;3;6
625;23.04.2017;2017;04;19;Sunnuntai;4;7;11
625;23.04.2017;2017;04;20;Sunnuntai;7;6;13
625;23.04.2017;2017;04;21;Sunnuntai;0;3;3
625;23.04.2017;2017;04;22;Sunnuntai;1;1;2
625;23.04.2017;2017;04;23;Sunnuntai;0;2;2
625;24.04.2017;2017;04;00;Maanantai;1;0;1
625;24.04.2017;2017;04;01;Maanantai;0;0;0
625;24.04.2017;2017;04;02;Maanantai;0;0;0
625;24.04.2017;2017;04;03;Maanantai;0;0;0
625;24.04.2017;2017;04;04;Maanantai;0;0;0
625;24.04.2017;2017;04;05;Maanantai;1;0;1
625;24.04.2017;2017;04;06;Maanantai;2;4;6
625;24.04.2017;2017;04;07;Maanantai;12;6;18
625;24.04.2017;2017;04;08;Maanantai;46;23;69
625;24.04.2017;2017;04;09;Maanantai;30;13;43
625;24.04.2017;2017;04;10;Maanantai;19;4;23
625;24.04.2017;2017;04;11;Maanantai;13;6;19
625;24.04.2017;2017;04;12;Maanantai;9;12;21
625;24.04.2017;2017;04;13;Maanantai;11;24;35
625;24.04.2017;2017;04;14;Maanantai;5;19;24
625;24.04.2017;2017;04;15;Maanantai;13;32;45
625;24.04.2017;2017;04;16;Maanantai;20;36;56
625;24.04.2017;2017;04;17;Maanantai;24;25;49
625;24.04.2017;2017;04;18;Maanantai;15;16;31
625;24.04.2017;2017;04;19;Maanantai;5;16;21
625;24.04.2017;2017;04;20;Maanantai;9;8;17
625;24.04.2017;2017;04;21;Maanantai;3;5;8
625;24.04.2017;2017;04;22;Maanantai;5;3;8
625;24.04.2017;2017;04;23;Maanantai;3;1;4
625;25.04.2017;2017;04;00;Tiistai;1;3;4
625;25.04.2017;2017;04;01;Tiistai;0;0;0
625;25.04.2017;2017;04;02;Tiistai;1;0;1
625;25.04.2017;2017;04;03;Tiistai;0;0;0
625;25.04.2017;2017;04;04;Tiistai;0;0;0
625;25.04.2017;2017;04;05;Tiistai;1;0;1
625;25.04.2017;2017;04;06;Tiistai;4;2;6
625;25.04.2017;2017;04;07;Tiistai;15;11;26
625;25.04.2017;2017;04;08;Tiistai;56;32;88
625;25.04.2017;2017;04;09;Tiistai;41;22;63
625;25.04.2017;2017;04;10;Tiistai;16;6;22
625;25.04.2017;2017;04;11;Tiistai;22;5;27
625;25.04.2017;2017;04;12;Tiistai;11;8;19
625;25.04.2017;2017;04;13;Tiistai;11;15;26
625;25.04.2017;2017;04;14;Tiistai;15;30;45
625;25.04.2017;2017;04;15;Tiistai;11;28;39
625;25.04.2017;2017;04;16;Tiistai;26;45;71
625;25.04.2017;2017;04;17;Tiistai;25;34;59
625;25.04.2017;2017;04;18;Tiistai;14;21;35
625;25.04.2017;2017;04;19;Tiistai;12;6;18
625;25.04.2017;2017;04;20;Tiistai;14;18;32
625;25.04.2017;2017;04;21;Tiistai;8;10;18
625;25.04.2017;2017;04;22;Tiistai;9;4;13
625;25.04.2017;2017;04;23;Tiistai;5;2;7
625;26.04.2017;2017;04;00;Keskiviikko;0;0;0
625;26.04.2017;2017;04;01;Keskiviikko;2;0;2
625;26.04.2017;2017;04;02;Keskiviikko;0;0;0
625;26.04.2017;2017;04;03;Keskiviikko;0;0;0
625;26.04.2017;2017;04;04;Keskiviikko;0;0;0
625;26.04.2017;2017;04;05;Keskiviikko;1;0;1
625;26.04.2017;2017;04;06;Keskiviikko;1;1;2
625;26.04.2017;2017;04;07;Keskiviikko;9;7;16
625;26.04.2017;2017;04;08;Keskiviikko;47;13;60
625;26.04.2017;2017;04;09;Keskiviikko;34;19;53
625;26.04.2017;2017;04;10;Keskiviikko;14;4;18
625;26.04.2017;2017;04;11;Keskiviikko;10;3;13
625;26.04.2017;2017;04;12;Keskiviikko;1;4;5
625;26.04.2017;2017;04;13;Keskiviikko;5;8;13
625;26.04.2017;2017;04;14;Keskiviikko;5;19;24
625;26.04.2017;2017;04;15;Keskiviikko;6;19;25
625;26.04.2017;2017;04;16;Keskiviikko;10;31;41
625;26.04.2017;2017;04;17;Keskiviikko;16;22;38
625;26.04.2017;2017;04;18;Keskiviikko;7;10;17
625;26.04.2017;2017;04;19;Keskiviikko;4;4;8
625;26.04.2017;2017;04;20;Keskiviikko;5;0;5
625;26.04.2017;2017;04;21;Keskiviikko;4;2;6
625;26.04.2017;2017;04;22;Keskiviikko;2;3;5
625;26.04.2017;2017;04;23;Keskiviikko;2;0;2
625;27.04.2017;2017;04;00;Torstai;0;0;0
625;27.04.2017;2017;04;01;Torstai;1;0;1
625;27.04.2017;2017;04;02;Torstai;0;0;0
625;27.04.2017;2017;04;03;Torstai;0;0;0
625;27.04.2017;2017;04;04;Torstai;0;0;0
625;27.04.2017;2017;04;05;Torstai;1;0;1
625;27.04.2017;2017;04;06;Torstai;1;0;1
625;27.04.2017;2017;04;07;Torstai;8;6;14
625;27.04.2017;2017;04;08;Torstai;12;8;20
625;27.04.2017;2017;04;09;Torstai;41;11;52
625;27.04.2017;2017;04;10;Torstai;31;8;39
625;27.04.2017;2017;04;11;Torstai;6;1;7
625;27.04.2017;2017;04;12;Torstai;10;7;17
625;27.04.2017;2017;04;13;Torstai;10;5;15
625;27.04.2017;2017;04;14;Torstai;6;9;15
625;27.04.2017;2017;04;15;Torstai;16;48;64
625;27.04.2017;2017;04;16;Torstai;12;24;36
625;27.04.2017;2017;04;17;Torstai;17;17;34
625;27.04.2017;2017;04;18;Torstai;10;16;26
625;27.04.2017;2017;04;19;Torstai;16;16;32
625;27.04.2017;2017;04;20;Torstai;6;6;12
625;27.04.2017;2017;04;21;Torstai;11;11;22
625;27.04.2017;2017;04;22;Torstai;4;6;10
625;27.04.2017;2017;04;23;Torstai;4;1;5
625;28.04.2017;2017;04;00;Perjantai;0;1;1
625;28.04.2017;2017;04;01;Perjantai;1;2;3
625;28.04.2017;2017;04;02;Perjantai;1;0;1
625;28.04.2017;2017;04;03;Perjantai;0;0;0
625;28.04.2017;2017;04;04;Perjantai;1;0;1
625;28.04.2017;2017;04;05;Perjantai;1;2;3
625;28.04.2017;2017;04;06;Perjantai;1;2;3
625;28.04.2017;2017;04;07;Perjantai;16;5;21
625;28.04.2017;2017;04;08;Perjantai;48;24;72
625;28.04.2017;2017;04;09;Perjantai;34;8;42
625;28.04.2017;2017;04;10;Perjantai;8;5;13
625;28.04.2017;2017;04;11;Perjantai;17;4;21
625;28.04.2017;2017;04;12;Perjantai;3;21;24
625;28.04.2017;2017;04;13;Perjantai;9;25;34
625;28.04.2017;2017;04;14;Perjantai;14;33;47
625;28.04.2017;2017;04;15;Perjantai;10;19;29
625;28.04.2017;2017;04;16;Perjantai;16;16;32
625;28.04.2017;2017;04;17;Perjantai;20;20;40
625;28.04.2017;2017;04;18;Perjantai;15;16;31
625;28.04.2017;2017;04;19;Perjantai;16;9;25
625;28.04.2017;2017;04;20;Perjantai;6;6;12
625;28.04.2017;2017;04;21;Perjantai;4;5;9
625;28.04.2017;2017;04;22;Perjantai;2;2;4
625;28.04.2017;2017;04;23;Perjantai;2;2;4
625;29.04.2017;2017;04;00;Lauantai;1;2;3
625;29.04.2017;2017;04;01;Lauantai;0;1;1
625;29.04.2017;2017;04;02;Lauantai;2;0;2
625;29.04.2017;2017;04;03;Lauantai;0;0;0
625;29.04.2017;2017;04;04;Lauantai;0;0;0
625;29.04.2017;2017;04;05;Lauantai;0;0;0
625;29.04.2017;2017;04;06;Lauantai;0;0;0
625;29.04.2017;2017;04;07;Lauantai;3;1;4
625;29.04.2017;2017;04;08;Lauantai;0;1;1
625;29.04.2017;2017;04;09;Lauantai;2;0;2
625;29.04.2017;2017;04;10;Lauantai;3;0;3
625;29.04.2017;2017;04;11;Lauantai;6;3;9
625;29.04.2017;2017;04;12;Lauantai;6;5;11
625;29.04.2017;2017;04;13;Lauantai;14;12;26
625;29.04.2017;2017;04;14;Lauantai;9;11;20
625;29.04.2017;2017;04;15;Lauantai;7;3;10
625;29.04.2017;2017;04;16;Lauantai;10;10;20
625;29.04.2017;2017;04;17;Lauantai;5;10;15
625;29.04.2017;2017;04;18;Lauantai;5;6;11
625;29.04.2017;2017;04;19;Lauantai;3;15;18
625;29.04.2017;2017;04;20;Lauantai;5;5;10
625;29.04.2017;2017;04;21;Lauantai;6;7;13
625;29.04.2017;2017;04;22;Lauantai;2;2;4
625;29.04.2017;2017;04;23;Lauantai;1;1;2
625;30.04.2017;2017;04;00;Sunnuntai;1;4;5
625;30.04.2017;2017;04;01;Sunnuntai;1;1;2
625;30.04.2017;2017;04;02;Sunnuntai;1;0;1
625;30.04.2017;2017;04;03;Sunnuntai;2;1;3
625;30.04.2017;2017;04;04;Sunnuntai;1;1;2
625;30.04.2017;2017;04;05;Sunnuntai;0;0;0
625;30.04.2017;2017;04;06;Sunnuntai;0;0;0
625;30.04.2017;2017;04;07;Sunnuntai;0;2;2
625;30.04.2017;2017;04;08;Sunnuntai;0;1;1
625;30.04.2017;2017;04;09;Sunnuntai;1;1;2
625;30.04.2017;2017;04;10;Sunnuntai;2;1;3
625;30.04.2017;2017;04;11;Sunnuntai;4;9;13
625;30.04.2017;2017;04;12;Sunnuntai;6;6;12
625;30.04.2017;2017;04;13;Sunnuntai;13;7;20
625;30.04.2017;2017;04;14;Sunnuntai;17;9;26
625;30.04.2017;2017;04;15;Sunnuntai;6;6;12
625;30.04.2017;2017;04;16;Sunnuntai;16;11;27
625;30.04.2017;2017;04;17;Sunnuntai;10;11;21
625;30.04.2017;2017;04;18;Sunnuntai;3;3;6
625;30.04.2017;2017;04;19;Sunnuntai;4;7;11
625;30.04.2017;2017;04;20;Sunnuntai;7;6;13
625;30.04.2017;2017;04;21;Sunnuntai;0;3;3
625;30.04.2017;2017;04;22;Sunnuntai;1;1;2
625;30.04.2017;2017;04;23;Sunnuntai;0;2;2
625;01.05.2017;2017;05;00;Maanantai;1;4;5
625;01.05.2017;2017;05;01;Maanantai;1;1;2
625;01.05.2017;2017;05;02;Maanantai;1;0;1
625;01.05.2017;2017;05;03;Maanantai;2;1;3
625;01.05.2017;2017;05;04;Maanantai;1;1;2
625;01.05.2017;2017;05;05;Maanantai;0;0;0
625;01.05.2017;2017;05;06;Maanantai;0;0;0
625;01.05.2017;2017;05;07;Maanantai;0;2;2
625;01.05.2017;2017;05;08;Maanantai;0;1;1
625;01.05.2017;2017;05;09;Maanantai;1;1;2
625;01.05.2017;2017;05;10;Maanantai;2;1;3
625;01.05.2017;2017;05;11;Maanantai;4;9;13
625;01.05.2017;2017;05;12;Maanantai;6;6;12
625;01.05.2017;2017;05;13;Maanantai;13;7;20
625;01.05.2017;2017;05;14;Maanantai;17;9;26
625;01.05.2017;2017;05;15;Maanantai;6;6;12
625;01.05.2017;2017;05;16;Maanantai;16;11;27
625;01.05.2017;2017;05;17;Maanantai;10;11;21
625;01.05.2017;2017;05;18;Maanantai;3;3;6
625;01.05.2017;2017;05;19;Maanantai;4;7;11
625;01.05.2017;2017;05;20;Maanantai;7;6;13
625;01.05.2017;2017;05;21;Maanantai;0;3;3
625;01.05.2017;2017;05;22;Maanantai;1;1;2
625;01.05.2017;2017;05;23;Maanantai;0;2;2
625;02.05.2017;2017;05;00;Tiistai;1;3;4
625;02.05.2017;2017;05;01;Tiistai;0;0;0
625;02.05.2017;2017;05;02;Tiistai;1;0;1
625;02.05.2017;2017;05;03;Tiistai;0;0;0
625;02.05.2017;2017;05;04;Tiistai;0;0;0
625;02.05.2017;2017;05;05;Tiistai;1;0;1
625;02.05.2017;2017;05;06;Tiistai;4;2;6
625;02.05.2017;2017;05;07;Tiistai;15;11;26
625;02.05.2017;2017;05;08;Tiistai;56;32;88
625;02.05.2017;2017;05;09;Tiistai;41;22;63
625;02.05.2017;2017;05;10;Tiistai;16;6;22
625;02.05.2017;2017;05;11;Tiistai;22;5;27
625;02.05.2017;2017;05;12;Tiistai;11;8;19
625;02.05.2017;2017;05;13;Tiistai;11;15;26
625;02.05.2017;2017;05;14;Tiistai;15;30;45
625;02.05.2017;2017;05;15;Tiistai;11;28;39
625;02.05.2017;2017;05;16;Tiistai;26;45;71
625;02.05.2017;2017;05;17;Tiistai;25;34;59
625;02.05.2017;2017;05;18;Tiistai;14;21;35
625;02.05.2017;2017;05;19;Tiistai;12;6;18
625;02.05.2017;2017;05;20;Tiistai;14;18;32
625;02.05.2017;2017;05;21;Tiistai;8;10;18
625;02.05.2017;2017;05;22;Tiistai;9;4;13
625;02.05.2017;2017;05;23;Tiistai;5;2;7
625;03.05.2017;2017;05;00;Keskiviikko;0;0;0
625;03.05.2017;2017;05;01;Keskiviikko;2;0;2
625;03.05.2017;2017;05;02;Keskiviikko;0;0;0
625;03.05.2017;2017;05;03;Keskiviikko;0;0;0
625;03.05.2017;2017;05;04;Keskiviikko;0;0;0
625;03.05.2017;2017;05;05;Keskiviikko;1;0;1
625;03.05.2017;2017;05;06;Keskiviikko;1;1;2
625;03.05.2017;2017;05;07;Keskiviikko;9;7;16
625;03.05.2017;2017;05;08;Keskiviikko;47;13;60
625;03.05.2017;2017;05;09;Keskiviikko;34;19;53
625;03.05.2017;2017;05;10;Keskiviikko;14;4;18
625;03.05.2017;2017;05;11;Keskiviikko;10;3;13
625;03.05.2017;2017;05;12;Keskiviikko;1;4;5
625;03.05.2017;2017;05;13;Keskiviikko;5;8;13
625;03.05.2017;2017;05;14;Keskiviikko;5;19;24
625;03.05.2017;2017;05;15;Keskiviikko;6;19;25
625;03.05.2017;2017;05;16;Keskiviikko;10;31;41
625;03.05.2017;2017;05;17;Keskiviikko;16;22;38
625;03.05.2017;2017;05;18;Keskiviikko;7;10;17
625;03.05.2017;2017;05;19;Keskiviikko;4;4;8
625;03.05.2017;2017;05;20;Keskiviikko;5;0;5
625;03.05.2017;2017;05;21;Keskiviikko;4;2;6
625;03.05.2017;2017;05;22;Keskiviikko;2;3;5
625;03.05.2017;2017;05;23;Keskiviikko;2;0;2
625;04.05.2017;2017;05;00;Torstai;3;0;3
625;04.05.2017;2017;05;01;Torstai;1;2;3
625;04.05.2017;2017;05;02;Torstai;1;0;1
625;04.05.2017;2017;05;03;Torstai;1;1;2
625;04.05.2017;2017;05;04;Torstai;0;0;0
625;04.05.2017;2017;05;05;Torstai;1;0;1
625;04.05.2017;2017;05;06;Torstai;1;2;3
625;04.05.2017;2017;05;07;Torstai;16;8;24
625;04.05.2017;2017;05;08;Torstai;63;27;90
625;04.05.2017;2017;05;09;Torstai;26;17;43
625;04.05.2017;2017;05;10;Torstai;12;13;25
625;04.05.2017;2017;05;11;Torstai;16;13;29
625;04.05.2017;2017;05;12;Torstai;10;12;22
625;04.05.2017;2017;05;13;Torstai;17;15;32
625;04.05.2017;2017;05;14;Torstai;10;25;35
625;04.05.2017;2017;05;15;Torstai;14;25;39
625;04.05.2017;2017;05;16;Torstai;19;32;51
625;04.05.2017;2017;05;17;Torstai;32;34;66
625;04.05.2017;2017;05;18;Torstai;12;21;33
625;04.05.2017;2017;05;19;Torstai;16;19;35
625;04.05.2017;2017;05;20;Torstai;11;9;20
625;04.05.2017;2017;05;21;Torstai;13;19;32
625;04.05.2017;2017;05;22;Torstai;8;7;15
625;04.05.2017;2017;05;23;Torstai;4;3;7
625;05.05.2017;2017;05;00;Perjantai;3;0;3
625;05.05.2017;2017;05;01;Perjantai;1;2;3
625;05.05.2017;2017;05;02;Perjantai;1;0;1
625;05.05.2017;2017;05;03;Perjantai;1;1;2
625;05.05.2017;2017;05;04;Perjantai;0;0;0
625;05.05.2017;2017;05;05;Perjantai;1;0;1
625;05.05.2017;2017;05;06;Perjantai;1;2;3
625;05.05.2017;2017;05;07;Perjantai;16;8;24
625;05.05.2017;2017;05;08;Perjantai;63;27;90
625;05.05.2017;2017;05;09;Perjantai;26;17;43
625;05.05.2017;2017;05;10;Perjantai;12;13;25
625;05.05.2017;2017;05;11;Perjantai;8;4;12
625;05.05.2017;2017;05;12;Perjantai;18;25;43
625;05.05.2017;2017;05;13;Perjantai;11;22;33
625;05.05.2017;2017;05;14;Perjantai;14;43;57
625;05.05.2017;2017;05;15;Perjantai;16;27;43
625;05.05.2017;2017;05;16;Perjantai;21;34;55
625;05.05.2017;2017;05;17;Perjantai;19;32;51
625;05.05.2017;2017;05;18;Perjantai;27;19;46
625;05.05.2017;2017;05;19;Perjantai;20;18;38
625;05.05.2017;2017;05;20;Perjantai;8;9;17
625;05.05.2017;2017;05;21;Perjantai;12;11;23
625;05.05.2017;2017;05;22;Perjantai;7;1;8
625;05.05.2017;2017;05;23;Perjantai;6;1;7
625;06.05.2017;2017;05;00;Lauantai;2;4;6
625;06.05.2017;2017;05;01;Lauantai;0;0;0
625;06.05.2017;2017;05;02;Lauantai;0;0;0
625;06.05.2017;2017;05;03;Lauantai;1;0;1
625;06.05.2017;2017;05;04;Lauantai;0;0;0
625;06.05.2017;2017;05;05;Lauantai;1;0;1
625;06.05.2017;2017;05;06;Lauantai;0;1;1
625;06.05.2017;2017;05;07;Lauantai;1;1;2
625;06.05.2017;2017;05;08;Lauantai;3;4;7
625;06.05.2017;2017;05;09;Lauantai;3;1;4
625;06.05.2017;2017;05;10;Lauantai;8;5;13
625;06.05.2017;2017;05;11;Lauantai;8;9;17
625;06.05.2017;2017;05;12;Lauantai;9;7;16
625;06.05.2017;2017;05;13;Lauantai;13;11;24
625;06.05.2017;2017;05;14;Lauantai;7;12;19
625;06.05.2017;2017;05;15;Lauantai;5;8;13
625;06.05.2017;2017;05;16;Lauantai;6;8;14
625;06.05.2017;2017;05;17;Lauantai;6;8;14
625;06.05.2017;2017;05;18;Lauantai;8;5;13
625;06.05.2017;2017;05;19;Lauantai;6;8;14
625;06.05.2017;2017;05;20;Lauantai;7;2;9
625;06.05.2017;2017;05;21;Lauantai;5;6;11
625;06.05.2017;2017;05;22;Lauantai;3;1;4
625;06.05.2017;2017;05;23;Lauantai;3;3;6
625;07.05.2017;2017;05;00;Sunnuntai;0;0;0
625;07.05.2017;2017;05;01;Sunnuntai;1;0;1
625;07.05.2017;2017;05;02;Sunnuntai;2;0;2
625;07.05.2017;2017;05;03;Sunnuntai;1;0;1
625;07.05.2017;2017;05;04;Sunnuntai;0;0;0
625;07.05.2017;2017;05;05;Sunnuntai;1;1;2
625;07.05.2017;2017;05;06;Sunnuntai;0;0;0
625;07.05.2017;2017;05;07;Sunnuntai;0;2;2
625;07.05.2017;2017;05;08;Sunnuntai;0;4;4
625;07.05.2017;2017;05;09;Sunnuntai;2;0;2
625;07.05.2017;2017;05;10;Sunnuntai;8;4;12
625;07.05.2017;2017;05;11;Sunnuntai;8;7;15
625;07.05.2017;2017;05;12;Sunnuntai;9;5;14
625;07.05.2017;2017;05;13;Sunnuntai;6;7;13
625;07.05.2017;2017;05;14;Sunnuntai;11;11;22
625;07.05.2017;2017;05;15;Sunnuntai;8;10;18
625;07.05.2017;2017;05;16;Sunnuntai;11;8;19
625;07.05.2017;2017;05;17;Sunnuntai;8;9;17
625;07.05.2017;2017;05;18;Sunnuntai;9;11;20
625;07.05.2017;2017;05;19;Sunnuntai;8;16;24
625;07.05.2017;2017;05;20;Sunnuntai;5;2;7
625;07.05.2017;2017;05;21;Sunnuntai;8;5;13
625;07.05.2017;2017;05;22;Sunnuntai;7;3;10
625;07.05.2017;2017;05;23;Sunnuntai;1;4;5
625;08.05.2017;2017;05;00;Maanantai;0;0;0
625;08.05.2017;2017;05;01;Maanantai;1;0;1
625;08.05.2017;2017;05;02;Maanantai;0;0;0
625;08.05.2017;2017;05;03;Maanantai;1;0;1
625;08.05.2017;2017;05;04;Maanantai;0;0;0
625;08.05.2017;2017;05;05;Maanantai;2;0;2
625;08.05.2017;2017;05;06;Maanantai;4;2;6
625;08.05.2017;2017;05;07;Maanantai;14;4;18
625;08.05.2017;2017;05;08;Maanantai;39;25;64
625;08.05.2017;2017;05;09;Maanantai;31;16;47
625;08.05.2017;2017;05;10;Maanantai;19;7;26
625;08.05.2017;2017;05;11;Maanantai;10;6;16
625;08.05.2017;2017;05;12;Maanantai;7;10;17
625;08.05.2017;2017;05;13;Maanantai;13;15;28
625;08.05.2017;2017;05;14;Maanantai;8;19;27
625;08.05.2017;2017;05;15;Maanantai;11;27;38
625;08.05.2017;2017;05;16;Maanantai;18;37;55
625;08.05.2017;2017;05;17;Maanantai;18;24;42
625;08.05.2017;2017;05;18;Maanantai;19;12;31
625;08.05.2017;2017;05;19;Maanantai;16;17;33
625;08.05.2017;2017;05;20;Maanantai;9;13;22
625;08.05.2017;2017;05;21;Maanantai;7;9;16
625;08.05.2017;2017;05;22;Maanantai;5;3;8
625;08.05.2017;2017;05;23;Maanantai;4;2;6
625;09.05.2017;2017;05;00;Tiistai;2;0;2
625;09.05.2017;2017;05;01;Tiistai;1;0;1
625;09.05.2017;2017;05;02;Tiistai;0;1;1
625;09.05.2017;2017;05;03;Tiistai;0;0;0
625;09.05.2017;2017;05;04;Tiistai;0;0;0
625;09.05.2017;2017;05;05;Tiistai;0;0;0
625;09.05.2017;2017;05;06;Tiistai;1;3;4
625;09.05.2017;2017;05;07;Tiistai;15;11;26
625;09.05.2017;2017;05;08;Tiistai;66;25;91
625;09.05.2017;2017;05;09;Tiistai;33;18;51
625;09.05.2017;2017;05;10;Tiistai;13;10;23
625;09.05.2017;2017;05;11;Tiistai;16;10;26
625;09.05.2017;2017;05;12;Tiistai;11;13;24
625;09.05.2017;2017;05;13;Tiistai;9;12;21
625;09.05.2017;2017;05;14;Tiistai;10;30;40
625;09.05.2017;2017;05;15;Tiistai;13;36;49
625;09.05.2017;2017;05;16;Tiistai;20;32;52
625;09.05.2017;2017;05;17;Tiistai;30;33;63
625;09.05.2017;2017;05;18;Tiistai;15;15;30
625;09.05.2017;2017;05;19;Tiistai;4;13;17
625;09.05.2017;2017;05;20;Tiistai;12;8;20
625;09.05.2017;2017;05;21;Tiistai;8;12;20
625;09.05.2017;2017;05;22;Tiistai;2;5;7
625;09.05.2017;2017;05;23;Tiistai;6;3;9
625;10.05.2017;2017;05;00;Keskiviikko;1;1;2
625;10.05.2017;2017;05;01;Keskiviikko;0;0;0
625;10.05.2017;2017;05;02;Keskiviikko;0;0;0
625;10.05.2017;2017;05;03;Keskiviikko;0;0;0
625;10.05.2017;2017;05;04;Keskiviikko;0;0;0
625;10.05.2017;2017;05;05;Keskiviikko;1;0;1
625;10.05.2017;2017;05;06;Keskiviikko;2;2;4
625;10.05.2017;2017;05;07;Keskiviikko;15;10;25
625;10.05.2017;2017;05;08;Keskiviikko;45;24;69
625;10.05.2017;2017;05;09;Keskiviikko;25;13;38
625;10.05.2017;2017;05;10;Keskiviikko;16;11;27
625;10.05.2017;2017;05;11;Keskiviikko;15;6;21
625;10.05.2017;2017;05;12;Keskiviikko;12;7;19
625;10.05.2017;2017;05;13;Keskiviikko;12;26;38
625;10.05.2017;2017;05;14;Keskiviikko;8;31;39
625;10.05.2017;2017;05;15;Keskiviikko;14;35;49
625;10.05.2017;2017;05;16;Keskiviikko;18;31;49
625;10.05.2017;2017;05;17;Keskiviikko;23;23;46
625;10.05.2017;2017;05;18;Keskiviikko;21;19;40
625;10.05.2017;2017;05;19;Keskiviikko;13;18;31
625;10.05.2017;2017;05;20;Keskiviikko;4;11;15
625;10.05.2017;2017;05;21;Keskiviikko;5;9;14
625;10.05.2017;2017;05;22;Keskiviikko;3;1;4
625;10.05.2017;2017;05;23;Keskiviikko;4;0;4
625;11.05.2017;2017;05;00;Torstai;1;0;1
625;11.05.2017;2017;05;01;Torstai;3;1;4
625;11.05.2017;2017;05;02;Torstai;1;0;1
625;11.05.2017;2017;05;03;Torstai;0;0;0
625;11.05.2017;2017;05;04;Torstai;0;0;0
625;11.05.2017;2017;05;05;Torstai;1;0;1
625;11.05.2017;2017;05;06;Torstai;2;4;6
625;11.05.2017;2017;05;07;Torstai;10;8;18
625;11.05.2017;2017;05;08;Torstai;48;24;72
625;11.05.2017;2017;05;09;Torstai;17;11;28
625;11.05.2017;2017;05;10;Torstai;21;8;29
625;11.05.2017;2017;05;11;Torstai;10;10;20
625;11.05.2017;2017;05;12;Torstai;9;12;21
625;11.05.2017;2017;05;13;Torstai;9;15;24
625;11.05.2017;2017;05;14;Torstai;4;28;32
625;11.05.2017;2017;05;15;Torstai;10;19;29
625;11.05.2017;2017;05;16;Torstai;16;28;44
625;11.05.2017;2017;05;17;Torstai;27;30;57
625;11.05.2017;2017;05;18;Torstai;22;24;46
625;11.05.2017;2017;05;19;Torstai;6;9;15
625;11.05.2017;2017;05;20;Torstai;11;18;29
625;11.05.2017;2017;05;21;Torstai;12;16;28
625;11.05.2017;2017;05;22;Torstai;7;3;10
625;11.05.2017;2017;05;23;Torstai;3;2;5
625;12.05.2017;2017;05;00;Perjantai;1;1;2
625;12.05.2017;2017;05;01;Perjantai;0;1;1
625;12.05.2017;2017;05;02;Perjantai;0;1;1
625;12.05.2017;2017;05;03;Perjantai;0;0;0
625;12.05.2017;2017;05;04;Perjantai;1;0;1
625;12.05.2017;2017;05;05;Perjantai;1;0;1
625;12.05.2017;2017;05;06;Perjantai;0;2;2
625;12.05.2017;2017;05;07;Perjantai;8;8;16
625;12.05.2017;2017;05;08;Perjantai;61;29;90
625;12.05.2017;2017;05;09;Perjantai;28;24;52
625;12.05.2017;2017;05;10;Perjantai;6;7;13
625;12.05.2017;2017;05;11;Perjantai;13;10;23
625;12.05.2017;2017;05;12;Perjantai;10;19;29
625;12.05.2017;2017;05;13;Perjantai;12;21;33
625;12.05.2017;2017;05;14;Perjantai;10;29;39
625;12.05.2017;2017;05;15;Perjantai;31;34;65
625;12.05.2017;2017;05;16;Perjantai;16;21;37
625;12.05.2017;2017;05;17;Perjantai;21;34;55
625;12.05.2017;2017;05;18;Perjantai;12;10;22
625;12.05.2017;2017;05;19;Perjantai;5;9;14
625;12.05.2017;2017;05;20;Perjantai;7;12;19
625;12.05.2017;2017;05;21;Perjantai;3;5;8
625;12.05.2017;2017;05;22;Perjantai;2;4;6
625;12.05.2017;2017;05;23;Perjantai;3;3;6
625;13.05.2017;2017;05;00;Lauantai;1;2;3
625;13.05.2017;2017;05;01;Lauantai;2;2;4
625;13.05.2017;2017;05;02;Lauantai;1;1;2
625;13.05.2017;2017;05;03;Lauantai;2;1;3
625;13.05.2017;2017;05;04;Lauantai;1;1;2
625;13.05.2017;2017;05;05;Lauantai;1;0;1
625;13.05.2017;2017;05;06;Lauantai;0;0;0
625;13.05.2017;2017;05;07;Lauantai;0;1;1
625;13.05.2017;2017;05;08;Lauantai;1;3;4
625;13.05.2017;2017;05;09;Lauantai;1;2;3
625;13.05.2017;2017;05;10;Lauantai;5;2;7
625;13.05.2017;2017;05;11;Lauantai;6;9;15
625;13.05.2017;2017;05;12;Lauantai;12;10;22
625;13.05.2017;2017;05;13;Lauantai;16;11;27
625;13.05.2017;2017;05;14;Lauantai;12;15;27
625;13.05.2017;2017;05;15;Lauantai;11;14;25
625;13.05.2017;2017;05;16;Lauantai;9;8;17
625;13.05.2017;2017;05;17;Lauantai;11;13;24
625;13.05.2017;2017;05;18;Lauantai;6;13;19
625;13.05.2017;2017;05;19;Lauantai;8;8;16
625;13.05.2017;2017;05;20;Lauantai;6;5;11
625;13.05.2017;2017;05;21;Lauantai;6;10;16
625;13.05.2017;2017;05;22;Lauantai;5;5;10
625;13.05.2017;2017;05;23;Lauantai;2;0;2
625;14.05.2017;2017;05;00;Sunnuntai;4;3;7
625;14.05.2017;2017;05;01;Sunnuntai;0;1;1
625;14.05.2017;2017;05;02;Sunnuntai;0;0;0
625;14.05.2017;2017;05;03;Sunnuntai;1;0;1
625;14.05.2017;2017;05;04;Sunnuntai;0;0;0
625;14.05.2017;2017;05;05;Sunnuntai;1;0;1
625;14.05.2017;2017;05;06;Sunnuntai;0;0;0
625;14.05.2017;2017;05;07;Sunnuntai;1;0;1
625;14.05.2017;2017;05;08;Sunnuntai;0;2;2
625;14.05.2017;2017;05;09;Sunnuntai;1;1;2
625;14.05.2017;2017;05;10;Sunnuntai;1;3;4
625;14.05.2017;2017;05;11;Sunnuntai;1;2;3
625;14.05.2017;2017;05;12;Sunnuntai;1;3;4
625;14.05.2017;2017;05;13;Sunnuntai;6;3;9
625;14.05.2017;2017;05;14;Sunnuntai;4;3;7
625;14.05.2017;2017;05;15;Sunnuntai;2;3;5
625;14.05.2017;2017;05;16;Sunnuntai;1;1;2
625;14.05.2017;2017;05;17;Sunnuntai;6;3;9
625;14.05.2017;2017;05;18;Sunnuntai;0;3;3
625;14.05.2017;2017;05;19;Sunnuntai;3;4;7
625;14.05.2017;2017;05;20;Sunnuntai;2;1;3
625;14.05.2017;2017;05;21;Sunnuntai;0;1;1
625;14.05.2017;2017;05;22;Sunnuntai;1;0;1
625;14.05.2017;2017;05;23;Sunnuntai;0;0;0
625;15.05.2017;2017;05;00;Maanantai;1;0;1
625;15.05.2017;2017;05;01;Maanantai;0;1;1
625;15.05.2017;2017;05;02;Maanantai;0;1;1
625;15.05.2017;2017;05;03;Maanantai;0;0;0
625;15.05.2017;2017;05;04;Maanantai;1;0;1
625;15.05.2017;2017;05;05;Maanantai;0;1;1
625;15.05.2017;2017;05;06;Maanantai;1;3;4
625;15.05.2017;2017;05;07;Maanantai;7;8;15
625;15.05.2017;2017;05;08;Maanantai;55;27;82
625;15.05.2017;2017;05;09;Maanantai;21;17;38
625;15.05.2017;2017;05;10;Maanantai;21;7;28
625;15.05.2017;2017;05;11;Maanantai;15;8;23
625;15.05.2017;2017;05;12;Maanantai;10;9;19
625;15.05.2017;2017;05;13;Maanantai;20;25;45
625;15.05.2017;2017;05;14;Maanantai;11;21;32
625;15.05.2017;2017;05;15;Maanantai;11;21;32
625;15.05.2017;2017;05;16;Maanantai;20;38;58
625;15.05.2017;2017;05;17;Maanantai;25;31;56
625;15.05.2017;2017;05;18;Maanantai;8;18;26
625;15.05.2017;2017;05;19;Maanantai;9;17;26
625;15.05.2017;2017;05;20;Maanantai;10;12;22
625;15.05.2017;2017;05;21;Maanantai;4;5;9
625;15.05.2017;2017;05;22;Maanantai;7;1;8
625;15.05.2017;2017;05;23;Maanantai;0;2;2
625;16.05.2017;2017;05;00;Tiistai;1;1;2
625;16.05.2017;2017;05;01;Tiistai;0;0;0
625;16.05.2017;2017;05;02;Tiistai;0;0;0
625;16.05.2017;2017;05;03;Tiistai;0;0;0
625;16.05.2017;2017;05;04;Tiistai;1;1;2
625;16.05.2017;2017;05;05;Tiistai;0;1;1
625;16.05.2017;2017;05;06;Tiistai;0;4;4
625;16.05.2017;2017;05;07;Tiistai;11;9;20
625;16.05.2017;2017;05;08;Tiistai;63;28;91
625;16.05.2017;2017;05;09;Tiistai;28;17;45
625;16.05.2017;2017;05;10;Tiistai;13;8;21
625;16.05.2017;2017;05;11;Tiistai;17;10;27
625;16.05.2017;2017;05;12;Tiistai;9;9;18
625;16.05.2017;2017;05;13;Tiistai;18;38;56
625;16.05.2017;2017;05;14;Tiistai;8;13;21
625;16.05.2017;2017;05;15;Tiistai;16;18;34
625;16.05.2017;2017;05;16;Tiistai;20;40;60
625;16.05.2017;2017;05;17;Tiistai;42;40;82
625;16.05.2017;2017;05;18;Tiistai;22;23;45
625;16.05.2017;2017;05;19;Tiistai;23;18;41
625;16.05.2017;2017;05;20;Tiistai;11;16;27
625;16.05.2017;2017;05;21;Tiistai;9;11;20
625;16.05.2017;2017;05;22;Tiistai;7;6;13
625;16.05.2017;2017;05;23;Tiistai;5;4;9
625;17.05.2017;2017;05;00;Keskiviikko;1;3;4
625;17.05.2017;2017;05;01;Keskiviikko;1;2;3
625;17.05.2017;2017;05;02;Keskiviikko;0;1;1
625;17.05.2017;2017;05;03;Keskiviikko;0;1;1
625;17.05.2017;2017;05;04;Keskiviikko;0;0;0
625;17.05.2017;2017;05;05;Keskiviikko;2;1;3
625;17.05.2017;2017;05;06;Keskiviikko;0;3;3
625;17.05.2017;2017;05;07;Keskiviikko;9;7;16
625;17.05.2017;2017;05;08;Keskiviikko;52;17;69
625;17.05.2017;2017;05;09;Keskiviikko;14;15;29
625;17.05.2017;2017;05;10;Keskiviikko;17;4;21
625;17.05.2017;2017;05;11;Keskiviikko;3;3;6
625;17.05.2017;2017;05;12;Keskiviikko;6;11;17
625;17.05.2017;2017;05;13;Keskiviikko;9;20;29
625;17.05.2017;2017;05;14;Keskiviikko;12;29;41
625;17.05.2017;2017;05;15;Keskiviikko;10;19;29
625;17.05.2017;2017;05;16;Keskiviikko;11;9;20
625;17.05.2017;2017;05;17;Keskiviikko;11;19;30
625;17.05.2017;2017;05;18;Keskiviikko;10;11;21
625;17.05.2017;2017;05;19;Keskiviikko;6;9;15
625;17.05.2017;2017;05;20;Keskiviikko;5;5;10
625;17.05.2017;2017;05;21;Keskiviikko;3;5;8
625;17.05.2017;2017;05;22;Keskiviikko;4;3;7
625;17.05.2017;2017;05;23;Keskiviikko;1;0;1
625;18.05.2017;2017;05;00;Torstai;0;0;0
625;18.05.2017;2017;05;01;Torstai;0;0;0
625;18.05.2017;2017;05;02;Torstai;0;0;0
625;18.05.2017;2017;05;03;Torstai;0;0;0
625;18.05.2017;2017;05;04;Torstai;1;0;1
625;18.05.2017;2017;05;05;Torstai;0;0;0
625;18.05.2017;2017;05;06;Torstai;1;2;3
625;18.05.2017;2017;05;07;Torstai;12;7;19
625;18.05.2017;2017;05;08;Torstai;46;28;74
625;18.05.2017;2017;05;09;Torstai;24;19;43
625;18.05.2017;2017;05;10;Torstai;24;8;32
625;18.05.2017;2017;05;11;Torstai;7;3;10
625;18.05.2017;2017;05;12;Torstai;6;16;22
625;18.05.2017;2017;05;13;Torstai;10;8;18
625;18.05.2017;2017;05;14;Torstai;14;30;44
625;18.05.2017;2017;05;15;Torstai;20;44;64
625;18.05.2017;2017;05;16;Torstai;17;26;43
625;18.05.2017;2017;05;17;Torstai;22;36;58
625;18.05.2017;2017;05;18;Torstai;16;12;28
625;18.05.2017;2017;05;19;Torstai;9;11;20
625;18.05.2017;2017;05;20;Torstai;8;6;14
625;18.05.2017;2017;05;21;Torstai;14;8;22
625;18.05.2017;2017;05;22;Torstai;5;3;8
625;18.05.2017;2017;05;23;Torstai;2;2;4
625;19.05.2017;2017;05;00;Perjantai;2;0;2
625;19.05.2017;2017;05;01;Perjantai;0;0;0
625;19.05.2017;2017;05;02;Perjantai;0;0;0
625;19.05.2017;2017;05;03;Perjantai;0;0;0
625;19.05.2017;2017;05;04;Perjantai;0;0;0
625;19.05.2017;2017;05;05;Perjantai;0;1;1
625;19.05.2017;2017;05;06;Perjantai;0;2;2
625;19.05.2017;2017;05;07;Perjantai;5;5;10
625;19.05.2017;2017;05;08;Perjantai;30;8;38
625;19.05.2017;2017;05;09;Perjantai;9;8;17
625;19.05.2017;2017;05;10;Perjantai;6;6;12
625;19.05.2017;2017;05;11;Perjantai;3;6;9
625;19.05.2017;2017;05;12;Perjantai;5;10;15
625;19.05.2017;2017;05;13;Perjantai;4;5;9
625;19.05.2017;2017;05;14;Perjantai;5;24;29
625;19.05.2017;2017;05;15;Perjantai;7;16;23
625;19.05.2017;2017;05;16;Perjantai;5;15;20
625;19.05.2017;2017;05;17;Perjantai;9;11;20
625;19.05.2017;2017;05;18;Perjantai;7;9;16
625;19.05.2017;2017;05;19;Perjantai;8;8;16
625;19.05.2017;2017;05;20;Perjantai;3;4;7
625;19.05.2017;2017;05;21;Perjantai;2;2;4
625;19.05.2017;2017;05;22;Perjantai;2;2;4
625;19.05.2017;2017;05;23;Perjantai;0;3;3
625;20.05.2017;2017;05;00;Lauantai;1;0;1
625;20.05.2017;2017;05;01;Lauantai;0;0;0
625;20.05.2017;2017;05;02;Lauantai;0;0;0
625;20.05.2017;2017;05;03;Lauantai;0;0;0
625;20.05.2017;2017;05;04;Lauantai;0;0;0
625;20.05.2017;2017;05;05;Lauantai;0;0;0
625;20.05.2017;2017;05;06;Lauantai;0;2;2
625;20.05.2017;2017;05;07;Lauantai;1;2;3
625;20.05.2017;2017;05;08;Lauantai;2;1;3
625;20.05.2017;2017;05;09;Lauantai;2;0;2
625;20.05.2017;2017;05;10;Lauantai;6;3;9
625;20.05.2017;2017;05;11;Lauantai;7;9;16
625;20.05.2017;2017;05;12;Lauantai;4;13;17
625;20.05.2017;2017;05;13;Lauantai;11;14;25
625;20.05.2017;2017;05;14;Lauantai;19;19;38
625;20.05.2017;2017;05;15;Lauantai;10;10;20
625;20.05.2017;2017;05;16;Lauantai;18;11;29
625;20.05.2017;2017;05;17;Lauantai;8;10;18
625;20.05.2017;2017;05;18;Lauantai;10;14;24
625;20.05.2017;2017;05;19;Lauantai;11;6;17
625;20.05.2017;2017;05;20;Lauantai;9;11;20
625;20.05.2017;2017;05;21;Lauantai;7;4;11
625;20.05.2017;2017;05;22;Lauantai;2;0;2
625;20.05.2017;2017;05;23;Lauantai;3;3;6
625;21.05.2017;2017;05;00;Sunnuntai;2;3;5
625;21.05.2017;2017;05;01;Sunnuntai;0;1;1
625;21.05.2017;2017;05;02;Sunnuntai;2;1;3
625;21.05.2017;2017;05;03;Sunnuntai;0;1;1
625;21.05.2017;2017;05;04;Sunnuntai;1;0;1
625;21.05.2017;2017;05;05;Sunnuntai;2;2;4
625;21.05.2017;2017;05;06;Sunnuntai;0;0;0
625;21.05.2017;2017;05;07;Sunnuntai;1;1;2
625;21.05.2017;2017;05;08;Sunnuntai;0;4;4
625;21.05.2017;2017;05;09;Sunnuntai;1;3;4
625;21.05.2017;2017;05;10;Sunnuntai;2;4;6
625;21.05.2017;2017;05;11;Sunnuntai;3;4;7
625;21.05.2017;2017;05;12;Sunnuntai;9;9;18
625;21.05.2017;2017;05;13;Sunnuntai;11;12;23
625;21.05.2017;2017;05;14;Sunnuntai;11;11;22
625;21.05.2017;2017;05;15;Sunnuntai;17;25;42
625;21.05.2017;2017;05;16;Sunnuntai;17;21;38
625;21.05.2017;2017;05;17;Sunnuntai;14;18;32
625;21.05.2017;2017;05;18;Sunnuntai;11;20;31
625;21.05.2017;2017;05;19;Sunnuntai;11;15;26
625;21.05.2017;2017;05;20;Sunnuntai;11;16;27
625;21.05.2017;2017;05;21;Sunnuntai;10;7;17
625;21.05.2017;2017;05;22;Sunnuntai;5;3;8
625;21.05.2017;2017;05;23;Sunnuntai;3;2;5
625;22.05.2017;2017;05;00;Maanantai;2;3;5
625;22.05.2017;2017;05;01;Maanantai;1;1;2
625;22.05.2017;2017;05;02;Maanantai;0;0;0
625;22.05.2017;2017;05;03;Maanantai;0;0;0
625;22.05.2017;2017;05;04;Maanantai;0;0;0
625;22.05.2017;2017;05;05;Maanantai;1;0;1
625;22.05.2017;2017;05;06;Maanantai;3;2;5
625;22.05.2017;2017;05;07;Maanantai;16;8;24
625;22.05.2017;2017;05;08;Maanantai;69;25;94
625;22.05.2017;2017;05;09;Maanantai;25;10;35
625;22.05.2017;2017;05;10;Maanantai;27;5;32
625;22.05.2017;2017;05;11;Maanantai;14;8;22
625;22.05.2017;2017;05;12;Maanantai;9;13;22
625;22.05.2017;2017;05;13;Maanantai;19;16;35
625;22.05.2017;2017;05;14;Maanantai;15;37;52
625;22.05.2017;2017;05;15;Maanantai;26;29;55
625;22.05.2017;2017;05;16;Maanantai;16;41;57
625;22.05.2017;2017;05;17;Maanantai;18;37;55
625;22.05.2017;2017;05;18;Maanantai;16;24;40
625;22.05.2017;2017;05;19;Maanantai;11;19;30
625;22.05.2017;2017;05;20;Maanantai;8;20;28
625;22.05.2017;2017;05;21;Maanantai;8;13;21
625;22.05.2017;2017;05;22;Maanantai;5;2;7
625;22.05.2017;2017;05;23;Maanantai;3;2;5
625;23.05.2017;2017;05;00;Tiistai;3;1;4
625;23.05.2017;2017;05;01;Tiistai;0;1;1
625;23.05.2017;2017;05;02;Tiistai;0;0;0
625;23.05.2017;2017;05;03;Tiistai;0;0;0
625;23.05.2017;2017;05;04;Tiistai;0;0;0
625;23.05.2017;2017;05;05;Tiistai;2;0;2
625;23.05.2017;2017;05;06;Tiistai;1;5;6
625;23.05.2017;2017;05;07;Tiistai;20;14;34
625;23.05.2017;2017;05;08;Tiistai;71;28;99
625;23.05.2017;2017;05;09;Tiistai;32;21;53
625;23.05.2017;2017;05;10;Tiistai;20;15;35
625;23.05.2017;2017;05;11;Tiistai;8;4;12
625;23.05.2017;2017;05;12;Tiistai;18;25;43
625;23.05.2017;2017;05;13;Tiistai;11;22;33
625;23.05.2017;2017;05;14;Tiistai;14;43;57
625;23.05.2017;2017;05;15;Tiistai;16;27;43
625;23.05.2017;2017;05;16;Tiistai;21;34;55
625;23.05.2017;2017;05;17;Tiistai;19;32;51
625;23.05.2017;2017;05;18;Tiistai;27;19;46
625;23.05.2017;2017;05;19;Tiistai;20;18;38
625;23.05.2017;2017;05;20;Tiistai;8;9;17
625;23.05.2017;2017;05;21;Tiistai;12;11;23
625;23.05.2017;2017;05;22;Tiistai;7;1;8
625;23.05.2017;2017;05;23;Tiistai;6;1;7
625;24.05.2017;2017;05;00;Keskiviikko;3;0;3
625;24.05.2017;2017;05;01;Keskiviikko;1;2;3
625;24.05.2017;2017;05;02;Keskiviikko;1;0;1
625;24.05.2017;2017;05;03;Keskiviikko;1;1;2
625;24.05.2017;2017;05;04;Keskiviikko;0;0;0
625;24.05.2017;2017;05;05;Keskiviikko;1;0;1
625;24.05.2017;2017;05;06;Keskiviikko;1;2;3
625;24.05.2017;2017;05;07;Keskiviikko;16;8;24
625;24.05.2017;2017;05;08;Keskiviikko;63;27;90
625;24.05.2017;2017;05;09;Keskiviikko;18;17;35
625;24.05.2017;2017;05;10;Keskiviikko;20;9;29
625;24.05.2017;2017;05;11;Keskiviikko;19;10;29
625;24.05.2017;2017;05;12;Keskiviikko;5;7;12
625;24.05.2017;2017;05;13;Keskiviikko;11;30;41
625;24.05.2017;2017;05;14;Keskiviikko;14;18;32
625;24.05.2017;2017;05;15;Keskiviikko;20;26;46
625;24.05.2017;2017;05;16;Keskiviikko;23;54;77
625;24.05.2017;2017;05;17;Keskiviikko;32;45;77
625;24.05.2017;2017;05;18;Keskiviikko;18;22;40
625;24.05.2017;2017;05;19;Keskiviikko;10;18;28
625;24.05.2017;2017;05;20;Keskiviikko;15;20;35
625;24.05.2017;2017;05;21;Keskiviikko;13;8;21
625;24.05.2017;2017;05;22;Keskiviikko;15;14;29
625;24.05.2017;2017;05;23;Keskiviikko;8;1;9
625;25.05.2017;2017;05;00;Torstai;2;3;5
625;25.05.2017;2017;05;01;Torstai;2;1;3
625;25.05.2017;2017;05;02;Torstai;0;0;0
625;25.05.2017;2017;05;03;Torstai;1;0;1
625;25.05.2017;2017;05;04;Torstai;0;0;0
625;25.05.2017;2017;05;05;Torstai;0;0;0
625;25.05.2017;2017;05;06;Torstai;0;0;0
625;25.05.2017;2017;05;07;Torstai;1;3;4
625;25.05.2017;2017;05;08;Torstai;2;4;6
625;25.05.2017;2017;05;09;Torstai;1;4;5
625;25.05.2017;2017;05;10;Torstai;5;8;13
625;25.05.2017;2017;05;11;Torstai;9;9;18
625;25.05.2017;2017;05;12;Torstai;10;7;17
625;25.05.2017;2017;05;13;Torstai;3;13;16
625;25.05.2017;2017;05;14;Torstai;11;9;20
625;25.05.2017;2017;05;15;Torstai;9;15;24
625;25.05.2017;2017;05;16;Torstai;5;4;9
625;25.05.2017;2017;05;17;Torstai;9;17;26
625;25.05.2017;2017;05;18;Torstai;11;13;24
625;25.05.2017;2017;05;19;Torstai;18;17;35
625;25.05.2017;2017;05;20;Torstai;14;14;28
625;25.05.2017;2017;05;21;Torstai;8;8;16
625;25.05.2017;2017;05;22;Torstai;3;2;5
625;25.05.2017;2017;05;23;Torstai;1;5;6
625;26.05.2017;2017;05;00;Perjantai;1;1;2
625;26.05.2017;2017;05;01;Perjantai;0;0;0
625;26.05.2017;2017;05;02;Perjantai;0;0;0
625;26.05.2017;2017;05;03;Perjantai;0;0;0
625;26.05.2017;2017;05;04;Perjantai;0;0;0
625;26.05.2017;2017;05;05;Perjantai;0;0;0
625;26.05.2017;2017;05;06;Perjantai;2;3;5
625;26.05.2017;2017;05;07;Perjantai;8;5;13
625;26.05.2017;2017;05;08;Perjantai;53;23;76
625;26.05.2017;2017;05;09;Perjantai;27;19;46
625;26.05.2017;2017;05;10;Perjantai;8;5;13
625;26.05.2017;2017;05;11;Perjantai;7;7;14
625;26.05.2017;2017;05;12;Perjantai;6;9;15
625;26.05.2017;2017;05;13;Perjantai;15;18;33
625;26.05.2017;2017;05;14;Perjantai;10;32;42
625;26.05.2017;2017;05;15;Perjantai;12;19;31
625;26.05.2017;2017;05;16;Perjantai;13;25;38
625;26.05.2017;2017;05;17;Perjantai;11;19;30
625;26.05.2017;2017;05;18;Perjantai;9;13;22
625;26.05.2017;2017;05;19;Perjantai;5;8;13
625;26.05.2017;2017;05;20;Perjantai;5;2;7
625;26.05.2017;2017;05;21;Perjantai;5;6;11
625;26.05.2017;2017;05;22;Perjantai;3;4;7
625;26.05.2017;2017;05;23;Perjantai;0;2;2
625;27.05.2017;2017;05;00;Lauantai;3;1;4
625;27.05.2017;2017;05;01;Lauantai;3;2;5
625;27.05.2017;2017;05;02;Lauantai;2;0;2
625;27.05.2017;2017;05;03;Lauantai;0;0;0
625;27.05.2017;2017;05;04;Lauantai;0;0;0
625;27.05.2017;2017;05;05;Lauantai;0;0;0
625;27.05.2017;2017;05;06;Lauantai;0;0;0
625;27.05.2017;2017;05;07;Lauantai;0;1;1
625;27.05.2017;2017;05;08;Lauantai;2;2;4
625;27.05.2017;2017;05;09;Lauantai;1;1;2
625;27.05.2017;2017;05;10;Lauantai;7;3;10
625;27.05.2017;2017;05;11;Lauantai;5;4;9
625;27.05.2017;2017;05;12;Lauantai;8;5;13
625;27.05.2017;2017;05;13;Lauantai;9;8;17
625;27.05.2017;2017;05;14;Lauantai;6;5;11
625;27.05.2017;2017;05;15;Lauantai;4;8;12
625;27.05.2017;2017;05;16;Lauantai;8;12;20
625;27.05.2017;2017;05;17;Lauantai;9;7;16
625;27.05.2017;2017;05;18;Lauantai;3;7;10
625;27.05.2017;2017;05;19;Lauantai;5;13;18
625;27.05.2017;2017;05;20;Lauantai;7;10;17
625;27.05.2017;2017;05;21;Lauantai;2;3;5
625;27.05.2017;2017;05;22;Lauantai;1;2;3
625;27.05.2017;2017;05;23;Lauantai;1;1;2
625;28.05.2017;2017;05;00;Sunnuntai;4;1;5
625;28.05.2017;2017;05;01;Sunnuntai;2;1;3
625;28.05.2017;2017;05;02;Sunnuntai;2;1;3
625;28.05.2017;2017;05;03;Sunnuntai;0;2;2
625;28.05.2017;2017;05;04;Sunnuntai;0;1;1
625;28.05.2017;2017;05;05;Sunnuntai;1;0;1
625;28.05.2017;2017;05;06;Sunnuntai;0;0;0
625;28.05.2017;2017;05;07;Sunnuntai;1;1;2
625;28.05.2017;2017;05;08;Sunnuntai;2;1;3
625;28.05.2017;2017;05;09;Sunnuntai;0;0;0
625;28.05.2017;2017;05;10;Sunnuntai;1;1;2
625;28.05.2017;2017;05;11;Sunnuntai;2;2;4
625;28.05.2017;2017;05;12;Sunnuntai;4;1;5
625;28.05.2017;2017;05;13;Sunnuntai;1;3;4
625;28.05.2017;2017;05;14;Sunnuntai;1;0;1
625;28.05.2017;2017;05;15;Sunnuntai;0;4;4
625;28.05.2017;2017;05;16;Sunnuntai;4;6;10
625;28.05.2017;2017;05;17;Sunnuntai;9;2;11
625;28.05.2017;2017;05;18;Sunnuntai;2;3;5
625;28.05.2017;2017;05;19;Sunnuntai;4;4;8
625;28.05.2017;2017;05;20;Sunnuntai;1;2;3
625;28.05.2017;2017;05;21;Sunnuntai;4;3;7
625;28.05.2017;2017;05;22;Sunnuntai;2;3;5
625;28.05.2017;2017;05;23;Sunnuntai;0;0;0
625;29.05.2017;2017;05;00;Maanantai;0;1;1
625;29.05.2017;2017;05;01;Maanantai;2;0;2
625;29.05.2017;2017;05;02;Maanantai;0;0;0
625;29.05.2017;2017;05;03;Maanantai;0;0;0
625;29.05.2017;2017;05;04;Maanantai;0;0;0
625;29.05.2017;2017;05;05;Maanantai;0;1;1
625;29.05.2017;2017;05;06;Maanantai;1;0;1
625;29.05.2017;2017;05;07;Maanantai;15;10;25
625;29.05.2017;2017;05;08;Maanantai;44;21;65
625;29.05.2017;2017;05;09;Maanantai;27;19;46
625;29.05.2017;2017;05;10;Maanantai;22;5;27
625;29.05.2017;2017;05;11;Maanantai;9;4;13
625;29.05.2017;2017;05;12;Maanantai;8;11;19
625;29.05.2017;2017;05;13;Maanantai;13;22;35
625;29.05.2017;2017;05;14;Maanantai;9;27;36
625;29.05.2017;2017;05;15;Maanantai;20;34;54
625;29.05.2017;2017;05;16;Maanantai;17;29;46
625;29.05.2017;2017;05;17;Maanantai;26;33;59
625;29.05.2017;2017;05;18;Maanantai;15;17;32
625;29.05.2017;2017;05;19;Maanantai;11;9;20
625;29.05.2017;2017;05;20;Maanantai;7;10;17
625;29.05.2017;2017;05;21;Maanantai;8;9;17
625;29.05.2017;2017;05;22;Maanantai;5;5;10
625;29.05.2017;2017;05;23;Maanantai;2;1;3
625;30.05.2017;2017;05;00;Tiistai;0;0;0
625;30.05.2017;2017;05;01;Tiistai;2;2;4
625;30.05.2017;2017;05;02;Tiistai;0;0;0
625;30.05.2017;2017;05;03;Tiistai;0;0;0
625;30.05.2017;2017;05;04;Tiistai;0;0;0
625;30.05.2017;2017;05;05;Tiistai;1;1;2
625;30.05.2017;2017;05;06;Tiistai;0;2;2
625;30.05.2017;2017;05;07;Tiistai;9;8;17
625;30.05.2017;2017;05;08;Tiistai;58;30;88
625;30.05.2017;2017;05;09;Tiistai;81;64;145
625;30.05.2017;2017;05;10;Tiistai;30;23;53
625;30.05.2017;2017;05;11;Tiistai;13;3;16
625;30.05.2017;2017;05;12;Tiistai;14;14;28
625;30.05.2017;2017;05;13;Tiistai;19;23;42
625;30.05.2017;2017;05;14;Tiistai;49;74;123
625;30.05.2017;2017;05;15;Tiistai;21;33;54
625;30.05.2017;2017;05;16;Tiistai;23;41;64
625;30.05.2017;2017;05;17;Tiistai;29;47;76
625;30.05.2017;2017;05;18;Tiistai;19;17;36
625;30.05.2017;2017;05;19;Tiistai;9;11;20
625;30.05.2017;2017;05;20;Tiistai;13;16;29
625;30.05.2017;2017;05;21;Tiistai;10;7;17
625;30.05.2017;2017;05;22;Tiistai;7;7;14
625;30.05.2017;2017;05;23;Tiistai;5;1;6
625;31.05.2017;2017;05;00;Keskiviikko;2;0;2
625;31.05.2017;2017;05;01;Keskiviikko;0;0;0
625;31.05.2017;2017;05;02;Keskiviikko;0;1;1
625;31.05.2017;2017;05;03;Keskiviikko;0;1;1
625;31.05.2017;2017;05;04;Keskiviikko;0;0;0
625;31.05.2017;2017;05;05;Keskiviikko;0;0;0
625;31.05.2017;2017;05;06;Keskiviikko;0;1;1
625;31.05.2017;2017;05;07;Keskiviikko;10;3;13
625;31.05.2017;2017;05;08;Keskiviikko;23;22;45
625;31.05.2017;2017;05;09;Keskiviikko;41;17;58
625;31.05.2017;2017;05;10;Keskiviikko;50;19;69
625;31.05.2017;2017;05;11;Keskiviikko;4;4;8
625;31.05.2017;2017;05;12;Keskiviikko;9;9;18
625;31.05.2017;2017;05;13;Keskiviikko;15;50;65
625;31.05.2017;2017;05;14;Keskiviikko;12;10;22
625;31.05.2017;2017;05;15;Keskiviikko;9;16;25
625;31.05.2017;2017;05;16;Keskiviikko;17;20;37
625;31.05.2017;2017;05;17;Keskiviikko;17;33;50
625;31.05.2017;2017;05;18;Keskiviikko;14;21;35
625;31.05.2017;2017;05;19;Keskiviikko;11;13;24
625;31.05.2017;2017;05;20;Keskiviikko;8;11;19
625;31.05.2017;2017;05;21;Keskiviikko;3;12;15
625;31.05.2017;2017;05;22;Keskiviikko;3;4;7
625;31.05.2017;2017;05;23;Keskiviikko;4;7;11
625;01.06.2017;2017;06;00;Torstai;2;0;2
625;01.06.2017;2017;06;01;Torstai;1;0;1
625;01.06.2017;2017;06;02;Torstai;0;0;0
625;01.06.2017;2017;06;03;Torstai;0;0;0
625;01.06.2017;2017;06;04;Torstai;0;0;0
625;01.06.2017;2017;06;05;Torstai;0;0;0
625;01.06.2017;2017;06;06;Torstai;0;3;3
625;01.06.2017;2017;06;07;Torstai;8;11;19
625;01.06.2017;2017;06;08;Torstai;30;13;43
625;01.06.2017;2017;06;09;Torstai;41;19;60
625;01.06.2017;2017;06;10;Torstai;42;12;54
625;01.06.2017;2017;06;11;Torstai;9;6;15
625;01.06.2017;2017;06;12;Torstai;11;14;25
625;01.06.2017;2017;06;13;Torstai;41;65;106
625;01.06.2017;2017;06;14;Torstai;6;12;18
625;01.06.2017;2017;06;15;Torstai;9;12;21
625;01.06.2017;2017;06;16;Torstai;14;12;26
625;01.06.2017;2017;06;17;Torstai;18;30;48
625;01.06.2017;2017;06;18;Torstai;27;19;46
625;01.06.2017;2017;06;19;Torstai;20;18;38
625;01.06.2017;2017;06;20;Torstai;8;9;17
625;01.06.2017;2017;06;21;Torstai;12;11;23
625;01.06.2017;2017;06;22;Torstai;7;1;8
625;01.06.2017;2017;06;23;Torstai;6;1;7
625;02.06.2017;2017;06;00;Perjantai;1;1;2
625;02.06.2017;2017;06;01;Perjantai;0;0;0
625;02.06.2017;2017;06;02;Perjantai;0;0;0
625;02.06.2017;2017;06;03;Perjantai;0;0;0
625;02.06.2017;2017;06;04;Perjantai;0;0;0
625;02.06.2017;2017;06;05;Perjantai;0;0;0
625;02.06.2017;2017;06;06;Perjantai;2;3;5
625;02.06.2017;2017;06;07;Perjantai;8;5;13
625;02.06.2017;2017;06;08;Perjantai;53;23;76
625;02.06.2017;2017;06;09;Perjantai;27;19;46
625;02.06.2017;2017;06;10;Perjantai;8;5;13
625;02.06.2017;2017;06;11;Perjantai;7;7;14
625;02.06.2017;2017;06;12;Perjantai;6;9;15
625;02.06.2017;2017;06;13;Perjantai;15;18;33
625;02.06.2017;2017;06;14;Perjantai;10;32;42
625;02.06.2017;2017;06;15;Perjantai;12;19;31
625;02.06.2017;2017;06;16;Perjantai;13;25;38
625;02.06.2017;2017;06;17;Perjantai;8;11;19
625;02.06.2017;2017;06;18;Perjantai;11;5;16
625;02.06.2017;2017;06;19;Perjantai;4;4;8
625;02.06.2017;2017;06;20;Perjantai;9;10;19
625;02.06.2017;2017;06;21;Perjantai;6;10;16
625;02.06.2017;2017;06;22;Perjantai;2;7;9
625;02.06.2017;2017;06;23;Perjantai;4;3;7
625;03.06.2017;2017;06;00;Lauantai;3;3;6
625;03.06.2017;2017;06;01;Lauantai;1;0;1
625;03.06.2017;2017;06;02;Lauantai;0;1;1
625;03.06.2017;2017;06;03;Lauantai;0;0;0
625;03.06.2017;2017;06;04;Lauantai;1;0;1
625;03.06.2017;2017;06;05;Lauantai;0;0;0
625;03.06.2017;2017;06;06;Lauantai;0;2;2
625;03.06.2017;2017;06;07;Lauantai;0;3;3
625;03.06.2017;2017;06;08;Lauantai;28;7;35
625;03.06.2017;2017;06;09;Lauantai;5;1;6
625;03.06.2017;2017;06;10;Lauantai;4;19;23
625;03.06.2017;2017;06;11;Lauantai;10;4;14
625;03.06.2017;2017;06;12;Lauantai;4;10;14
625;03.06.2017;2017;06;13;Lauantai;4;8;12
625;03.06.2017;2017;06;14;Lauantai;15;12;27
625;03.06.2017;2017;06;15;Lauantai;4;7;11
625;03.06.2017;2017;06;16;Lauantai;4;7;11
625;03.06.2017;2017;06;17;Lauantai;8;12;20
625;03.06.2017;2017;06;18;Lauantai;12;7;19
625;03.06.2017;2017;06;19;Lauantai;6;10;16
625;03.06.2017;2017;06;20;Lauantai;9;7;16
625;03.06.2017;2017;06;21;Lauantai;9;10;19
625;03.06.2017;2017;06;22;Lauantai;5;4;9
625;03.06.2017;2017;06;23;Lauantai;0;2;2
625;04.06.2017;2017;06;00;Sunnuntai;2;1;3
625;04.06.2017;2017;06;01;Sunnuntai;3;0;3
625;04.06.2017;2017;06;02;Sunnuntai;1;5;6
625;04.06.2017;2017;06;03;Sunnuntai;0;1;1
625;04.06.2017;2017;06;04;Sunnuntai;1;1;2
625;04.06.2017;2017;06;05;Sunnuntai;0;0;0
625;04.06.2017;2017;06;06;Sunnuntai;1;0;1
625;04.06.2017;2017;06;07;Sunnuntai;0;0;0
625;04.06.2017;2017;06;08;Sunnuntai;2;5;7
625;04.06.2017;2017;06;09;Sunnuntai;0;2;2
625;04.06.2017;2017;06;10;Sunnuntai;3;3;6
625;04.06.2017;2017;06;11;Sunnuntai;7;5;12
625;04.06.2017;2017;06;12;Sunnuntai;12;16;28
625;04.06.2017;2017;06;13;Sunnuntai;10;10;20
625;04.06.2017;2017;06;14;Sunnuntai;12;12;24
625;04.06.2017;2017;06;15;Sunnuntai;12;15;27
625;04.06.2017;2017;06;16;Sunnuntai;17;10;27
625;04.06.2017;2017;06;17;Sunnuntai;18;21;39
625;04.06.2017;2017;06;18;Sunnuntai;13;8;21
625;04.06.2017;2017;06;19;Sunnuntai;14;13;27
625;04.06.2017;2017;06;20;Sunnuntai;10;10;20
625;04.06.2017;2017;06;21;Sunnuntai;5;10;15
625;04.06.2017;2017;06;22;Sunnuntai;8;5;13
625;04.06.2017;2017;06;23;Sunnuntai;2;3;5
625;05.06.2017;2017;06;00;Maanantai;0;0;0
625;05.06.2017;2017;06;01;Maanantai;1;1;2
625;05.06.2017;2017;06;02;Maanantai;0;0;0
625;05.06.2017;2017;06;03;Maanantai;0;0;0
625;05.06.2017;2017;06;04;Maanantai;1;0;1
625;05.06.2017;2017;06;05;Maanantai;0;0;0
625;05.06.2017;2017;06;06;Maanantai;1;5;6
625;05.06.2017;2017;06;07;Maanantai;17;12;29
625;05.06.2017;2017;06;08;Maanantai;22;26;48
625;05.06.2017;2017;06;09;Maanantai;17;25;42
625;05.06.2017;2017;06;10;Maanantai;9;7;16
625;05.06.2017;2017;06;11;Maanantai;7;5;12
625;05.06.2017;2017;06;12;Maanantai;20;14;34
625;05.06.2017;2017;06;13;Maanantai;13;15;28
625;05.06.2017;2017;06;14;Maanantai;27;28;55
625;05.06.2017;2017;06;15;Maanantai;25;33;58
625;05.06.2017;2017;06;16;Maanantai;25;43;68
625;05.06.2017;2017;06;17;Maanantai;40;39;79
625;05.06.2017;2017;06;18;Maanantai;33;23;56
625;05.06.2017;2017;06;19;Maanantai;12;21;33
625;05.06.2017;2017;06;20;Maanantai;9;13;22
625;05.06.2017;2017;06;21;Maanantai;9;17;26
625;05.06.2017;2017;06;22;Maanantai;7;5;12
625;05.06.2017;2017;06;23;Maanantai;0;4;4
625;06.06.2017;2017;06;00;Tiistai;2;0;2
625;06.06.2017;2017;06;01;Tiistai;1;1;2
625;06.06.2017;2017;06;02;Tiistai;1;1;2
625;06.06.2017;2017;06;03;Tiistai;0;0;0
625;06.06.2017;2017;06;04;Tiistai;0;0;0
625;06.06.2017;2017;06;05;Tiistai;1;0;1
625;06.06.2017;2017;06;06;Tiistai;1;3;4
625;06.06.2017;2017;06;07;Tiistai;12;9;21
625;06.06.2017;2017;06;08;Tiistai;20;19;39
625;06.06.2017;2017;06;09;Tiistai;9;14;23
625;06.06.2017;2017;06;10;Tiistai;7;6;13
625;06.06.2017;2017;06;11;Tiistai;11;7;18
625;06.06.2017;2017;06;12;Tiistai;11;6;17
625;06.06.2017;2017;06;13;Tiistai;8;7;15
625;06.06.2017;2017;06;14;Tiistai;15;19;34
625;06.06.2017;2017;06;15;Tiistai;10;9;19
625;06.06.2017;2017;06;16;Tiistai;12;23;35
625;06.06.2017;2017;06;17;Tiistai;26;41;67
625;06.06.2017;2017;06;18;Tiistai;24;22;46
625;06.06.2017;2017;06;19;Tiistai;28;36;64
625;06.06.2017;2017;06;20;Tiistai;21;23;44
625;06.06.2017;2017;06;21;Tiistai;13;14;27
625;06.06.2017;2017;06;22;Tiistai;12;10;22
625;06.06.2017;2017;06;23;Tiistai;9;7;16
625;07.06.2017;2017;06;00;Keskiviikko;3;0;3
625;07.06.2017;2017;06;01;Keskiviikko;0;1;1
625;07.06.2017;2017;06;02;Keskiviikko;2;2;4
625;07.06.2017;2017;06;03;Keskiviikko;0;0;0
625;07.06.2017;2017;06;04;Keskiviikko;0;1;1
625;07.06.2017;2017;06;05;Keskiviikko;1;0;1
625;07.06.2017;2017;06;06;Keskiviikko;2;8;10
625;07.06.2017;2017;06;07;Keskiviikko;20;23;43
625;07.06.2017;2017;06;08;Keskiviikko;39;31;70
625;07.06.2017;2017;06;09;Keskiviikko;32;29;61
625;07.06.2017;2017;06;10;Keskiviikko;17;16;33
625;07.06.2017;2017;06;11;Keskiviikko;16;9;25
625;07.06.2017;2017;06;12;Keskiviikko;7;18;25
625;07.06.2017;2017;06;13;Keskiviikko;17;18;35
625;07.06.2017;2017;06;14;Keskiviikko;22;26;48
625;07.06.2017;2017;06;15;Keskiviikko;19;27;46
625;07.06.2017;2017;06;16;Keskiviikko;36;50;86
625;07.06.2017;2017;06;17;Keskiviikko;41;49;90
625;07.06.2017;2017;06;18;Keskiviikko;27;36;63
625;07.06.2017;2017;06;19;Keskiviikko;29;35;64
625;07.06.2017;2017;06;20;Keskiviikko;24;20;44
625;07.06.2017;2017;06;21;Keskiviikko;13;20;33
625;07.06.2017;2017;06;22;Keskiviikko;14;18;32
625;07.06.2017;2017;06;23;Keskiviikko;9;7;16
625;08.06.2017;2017;06;00;Torstai;1;3;4
625;08.06.2017;2017;06;01;Torstai;0;0;0
625;08.06.2017;2017;06;02;Torstai;1;2;3
625;08.06.2017;2017;06;03;Torstai;0;0;0
625;08.06.2017;2017;06;04;Torstai;0;1;1
625;08.06.2017;2017;06;05;Torstai;1;0;1
625;08.06.2017;2017;06;06;Torstai;7;7;14
625;08.06.2017;2017;06;07;Torstai;20;14;34
625;08.06.2017;2017;06;08;Torstai;25;24;49
625;08.06.2017;2017;06;09;Torstai;20;20;40
625;08.06.2017;2017;06;10;Torstai;20;9;29
625;08.06.2017;2017;06;11;Torstai;8;16;24
625;08.06.2017;2017;06;12;Torstai;16;14;30
625;08.06.2017;2017;06;13;Torstai;20;19;39
625;08.06.2017;2017;06;14;Torstai;22;27;49
625;08.06.2017;2017;06;15;Torstai;24;32;56
625;08.06.2017;2017;06;16;Torstai;39;41;80
625;08.06.2017;2017;06;17;Torstai;36;44;80
625;08.06.2017;2017;06;18;Torstai;19;27;46
625;08.06.2017;2017;06;19;Torstai;23;29;52
625;08.06.2017;2017;06;20;Torstai;21;31;52
625;08.06.2017;2017;06;21;Torstai;22;19;41
625;08.06.2017;2017;06;22;Torstai;5;7;12
625;08.06.2017;2017;06;23;Torstai;8;5;13
625;09.06.2017;2017;06;00;Perjantai;2;3;5
625;09.06.2017;2017;06;01;Perjantai;1;0;1
625;09.06.2017;2017;06;02;Perjantai;0;0;0
625;09.06.2017;2017;06;03;Perjantai;1;0;1
625;09.06.2017;2017;06;04;Perjantai;2;1;3
625;09.06.2017;2017;06;05;Perjantai;0;0;0
625;09.06.2017;2017;06;06;Perjantai;4;4;8
625;09.06.2017;2017;06;07;Perjantai;17;15;32
625;09.06.2017;2017;06;08;Perjantai;22;25;47
625;09.06.2017;2017;06;09;Perjantai;16;15;31
625;09.06.2017;2017;06;10;Perjantai;14;13;27
625;09.06.2017;2017;06;11;Perjantai;11;11;22
625;09.06.2017;2017;06;12;Perjantai;16;25;41
625;09.06.2017;2017;06;13;Perjantai;15;26;41
625;09.06.2017;2017;06;14;Perjantai;14;23;37
625;09.06.2017;2017;06;15;Perjantai;16;22;38
625;09.06.2017;2017;06;16;Perjantai;28;35;63
625;09.06.2017;2017;06;17;Perjantai;23;30;53
625;09.06.2017;2017;06;18;Perjantai;14;25;39
625;09.06.2017;2017;06;19;Perjantai;29;20;49
625;09.06.2017;2017;06;20;Perjantai;17;11;28
625;09.06.2017;2017;06;21;Perjantai;9;12;21
625;09.06.2017;2017;06;22;Perjantai;12;16;28
625;09.06.2017;2017;06;23;Perjantai;4;3;7
625;10.06.2017;2017;06;00;Lauantai;4;5;9
625;10.06.2017;2017;06;01;Lauantai;1;1;2
625;10.06.2017;2017;06;02;Lauantai;0;0;0
625;10.06.2017;2017;06;03;Lauantai;0;0;0
625;10.06.2017;2017;06;04;Lauantai;1;0;1
625;10.06.2017;2017;06;05;Lauantai;0;0;0
625;10.06.2017;2017;06;06;Lauantai;3;3;6
625;10.06.2017;2017;06;07;Lauantai;2;5;7
625;10.06.2017;2017;06;08;Lauantai;3;1;4
625;10.06.2017;2017;06;09;Lauantai;5;0;5
625;10.06.2017;2017;06;10;Lauantai;5;7;12
625;10.06.2017;2017;06;11;Lauantai;13;7;20
625;10.06.2017;2017;06;12;Lauantai;6;12;18
625;10.06.2017;2017;06;13;Lauantai;11;21;32
625;10.06.2017;2017;06;14;Lauantai;11;20;31
625;10.06.2017;2017;06;15;Lauantai;14;14;28
625;10.06.2017;2017;06;16;Lauantai;16;16;32
625;10.06.2017;2017;06;17;Lauantai;14;22;36
625;10.06.2017;2017;06;18;Lauantai;16;14;30
625;10.06.2017;2017;06;19;Lauantai;12;12;24
625;10.06.2017;2017;06;20;Lauantai;18;11;29
625;10.06.2017;2017;06;21;Lauantai;6;12;18
625;10.06.2017;2017;06;22;Lauantai;1;2;3
625;10.06.2017;2017;06;23;Lauantai;3;5;8
625;11.06.2017;2017;06;00;Sunnuntai;0;3;3
625;11.06.2017;2017;06;01;Sunnuntai;2;1;3
625;11.06.2017;2017;06;02;Sunnuntai;1;3;4
625;11.06.2017;2017;06;03;Sunnuntai;1;0;1
625;11.06.2017;2017;06;04;Sunnuntai;1;0;1
625;11.06.2017;2017;06;05;Sunnuntai;0;0;0
625;11.06.2017;2017;06;06;Sunnuntai;0;1;1
625;11.06.2017;2017;06;07;Sunnuntai;2;2;4
625;11.06.2017;2017;06;08;Sunnuntai;1;1;2
625;11.06.2017;2017;06;09;Sunnuntai;0;2;2
625;11.06.2017;2017;06;10;Sunnuntai;9;9;18
625;11.06.2017;2017;06;11;Sunnuntai;8;8;16
625;11.06.2017;2017;06;12;Sunnuntai;11;7;18
625;11.06.2017;2017;06;13;Sunnuntai;19;14;33
625;11.06.2017;2017;06;14;Sunnuntai;14;23;37
625;11.06.2017;2017;06;15;Sunnuntai;13;21;34
625;11.06.2017;2017;06;16;Sunnuntai;9;17;26
625;11.06.2017;2017;06;17;Sunnuntai;11;10;21
625;11.06.2017;2017;06;18;Sunnuntai;11;10;21
625;11.06.2017;2017;06;19;Sunnuntai;12;9;21
625;11.06.2017;2017;06;20;Sunnuntai;10;11;21
625;11.06.2017;2017;06;21;Sunnuntai;4;8;12
625;11.06.2017;2017;06;22;Sunnuntai;3;10;13
625;11.06.2017;2017;06;23;Sunnuntai;1;0;1
625;12.06.2017;2017;06;00;Maanantai;1;0;1
625;12.06.2017;2017;06;01;Maanantai;4;0;4
625;12.06.2017;2017;06;02;Maanantai;0;1;1
625;12.06.2017;2017;06;03;Maanantai;1;0;1
625;12.06.2017;2017;06;04;Maanantai;0;0;0
625;12.06.2017;2017;06;05;Maanantai;1;0;1
625;12.06.2017;2017;06;06;Maanantai;3;6;9
625;12.06.2017;2017;06;07;Maanantai;20;13;33
625;12.06.2017;2017;06;08;Maanantai;25;17;42
625;12.06.2017;2017;06;09;Maanantai;14;15;29
625;12.06.2017;2017;06;10;Maanantai;5;6;11
625;12.06.2017;2017;06;11;Maanantai;1;5;6
625;12.06.2017;2017;06;12;Maanantai;3;8;11
625;12.06.2017;2017;06;13;Maanantai;11;4;15
625;12.06.2017;2017;06;14;Maanantai;13;13;26
625;12.06.2017;2017;06;15;Maanantai;11;16;27
625;12.06.2017;2017;06;16;Maanantai;24;27;51
625;12.06.2017;2017;06;17;Maanantai;16;30;46
625;12.06.2017;2017;06;18;Maanantai;14;23;37
625;12.06.2017;2017;06;19;Maanantai;12;18;30
625;12.06.2017;2017;06;20;Maanantai;13;11;24
625;12.06.2017;2017;06;21;Maanantai;12;5;17
625;12.06.2017;2017;06;22;Maanantai;6;9;15
625;12.06.2017;2017;06;23;Maanantai;4;4;8
625;13.06.2017;2017;06;00;Tiistai;0;1;1
625;13.06.2017;2017;06;01;Tiistai;1;0;1
625;13.06.2017;2017;06;02;Tiistai;0;0;0
625;13.06.2017;2017;06;03;Tiistai;1;0;1
625;13.06.2017;2017;06;04;Tiistai;0;0;0
625;13.06.2017;2017;06;05;Tiistai;0;0;0
625;13.06.2017;2017;06;06;Tiistai;2;2;4
625;13.06.2017;2017;06;07;Tiistai;15;5;20
625;13.06.2017;2017;06;08;Tiistai;23;23;46
625;13.06.2017;2017;06;09;Tiistai;18;19;37
625;13.06.2017;2017;06;10;Tiistai;7;7;14
625;13.06.2017;2017;06;11;Tiistai;12;9;21
625;13.06.2017;2017;06;12;Tiistai;10;18;28
625;13.06.2017;2017;06;13;Tiistai;13;10;23
625;13.06.2017;2017;06;14;Tiistai;9;14;23
625;13.06.2017;2017;06;15;Tiistai;11;12;23
625;13.06.2017;2017;06;16;Tiistai;26;26;52
625;13.06.2017;2017;06;17;Tiistai;33;37;70
625;13.06.2017;2017;06;18;Tiistai;23;32;55
625;13.06.2017;2017;06;19;Tiistai;11;17;28
625;13.06.2017;2017;06;20;Tiistai;15;22;37
625;13.06.2017;2017;06;21;Tiistai;11;14;25
625;13.06.2017;2017;06;22;Tiistai;2;4;6
625;13.06.2017;2017;06;23;Tiistai;7;1;8
625;14.06.2017;2017;06;00;Keskiviikko;1;3;4
625;14.06.2017;2017;06;01;Keskiviikko;0;0;0
625;14.06.2017;2017;06;02;Keskiviikko;1;2;3
625;14.06.2017;2017;06;03;Keskiviikko;0;0;0
625;14.06.2017;2017;06;04;Keskiviikko;1;1;2
625;14.06.2017;2017;06;05;Keskiviikko;0;0;0
625;14.06.2017;2017;06;06;Keskiviikko;3;6;9
625;14.06.2017;2017;06;07;Keskiviikko;13;9;22
625;14.06.2017;2017;06;08;Keskiviikko;28;20;48
625;14.06.2017;2017;06;09;Keskiviikko;18;15;33
625;14.06.2017;2017;06;10;Keskiviikko;14;6;20
625;14.06.2017;2017;06;11;Keskiviikko;5;11;16
625;14.06.2017;2017;06;12;Keskiviikko;13;17;30
625;14.06.2017;2017;06;13;Keskiviikko;9;14;23
625;14.06.2017;2017;06;14;Keskiviikko;13;20;33
625;14.06.2017;2017;06;15;Keskiviikko;21;23;44
625;14.06.2017;2017;06;16;Keskiviikko;17;26;43
625;14.06.2017;2017;06;17;Keskiviikko;31;35;66
625;14.06.2017;2017;06;18;Keskiviikko;19;19;38
625;14.06.2017;2017;06;19;Keskiviikko;17;14;31
625;14.06.2017;2017;06;20;Keskiviikko;10;11;21
625;14.06.2017;2017;06;21;Keskiviikko;9;13;22
625;14.06.2017;2017;06;22;Keskiviikko;3;7;10
625;14.06.2017;2017;06;23;Keskiviikko;4;1;5
625;15.06.2017;2017;06;00;Torstai;1;2;3
625;15.06.2017;2017;06;01;Torstai;0;0;0
625;15.06.2017;2017;06;02;Torstai;2;1;3
625;15.06.2017;2017;06;03;Torstai;0;0;0
625;15.06.2017;2017;06;04;Torstai;0;0;0
625;15.06.2017;2017;06;05;Torstai;0;0;0
625;15.06.2017;2017;06;06;Torstai;1;2;3
625;15.06.2017;2017;06;07;Torstai;13;12;25
625;15.06.2017;2017;06;08;Torstai;17;13;30
625;15.06.2017;2017;06;09;Torstai;20;16;36
625;15.06.2017;2017;06;10;Torstai;6;11;17
625;15.06.2017;2017;06;11;Torstai;7;10;17
625;15.06.2017;2017;06;12;Torstai;13;7;20
625;15.06.2017;2017;06;13;Torstai;12;18;30
625;15.06.2017;2017;06;14;Torstai;12;15;27
625;15.06.2017;2017;06;15;Torstai;15;31;46
625;15.06.2017;2017;06;16;Torstai;30;40;70
625;15.06.2017;2017;06;17;Torstai;35;36;71
625;15.06.2017;2017;06;18;Torstai;22;31;53
625;15.06.2017;2017;06;19;Torstai;14;23;37
625;15.06.2017;2017;06;20;Torstai;17;22;39
625;15.06.2017;2017;06;21;Torstai;15;12;27
625;15.06.2017;2017;06;22;Torstai;9;8;17
625;15.06.2017;2017;06;23;Torstai;2;4;6
625;16.06.2017;2017;06;00;Perjantai;1;1;2
625;16.06.2017;2017;06;01;Perjantai;1;1;2
625;16.06.2017;2017;06;02;Perjantai;1;0;1
625;16.06.2017;2017;06;03;Perjantai;1;0;1
625;16.06.2017;2017;06;04;Perjantai;2;0;2
625;16.06.2017;2017;06;05;Perjantai;0;0;0
625;16.06.2017;2017;06;06;Perjantai;3;3;6
625;16.06.2017;2017;06;07;Perjantai;14;12;26
625;16.06.2017;2017;06;08;Perjantai;16;19;35
625;16.06.2017;2017;06;09;Perjantai;20;21;41
625;16.06.2017;2017;06;10;Perjantai;9;11;20
625;16.06.2017;2017;06;11;Perjantai;6;9;15
625;16.06.2017;2017;06;12;Perjantai;18;12;30
625;16.06.2017;2017;06;13;Perjantai;8;14;22
625;16.06.2017;2017;06;14;Perjantai;23;18;41
625;16.06.2017;2017;06;15;Perjantai;22;21;43
625;16.06.2017;2017;06;16;Perjantai;12;23;35
625;16.06.2017;2017;06;17;Perjantai;28;35;63
625;16.06.2017;2017;06;18;Perjantai;12;16;28
625;16.06.2017;2017;06;19;Perjantai;13;22;35
625;16.06.2017;2017;06;20;Perjantai;17;4;21
625;16.06.2017;2017;06;21;Perjantai;13;14;27
625;16.06.2017;2017;06;22;Perjantai;6;10;16
625;16.06.2017;2017;06;23;Perjantai;6;5;11
625;17.06.2017;2017;06;00;Lauantai;2;2;4
625;17.06.2017;2017;06;01;Lauantai;3;0;3
625;17.06.2017;2017;06;02;Lauantai;0;1;1
625;17.06.2017;2017;06;03;Lauantai;1;0;1
625;17.06.2017;2017;06;04;Lauantai;1;0;1
625;17.06.2017;2017;06;05;Lauantai;0;1;1
625;17.06.2017;2017;06;06;Lauantai;0;2;2
625;17.06.2017;2017;06;07;Lauantai;1;0;1
625;17.06.2017;2017;06;08;Lauantai;1;1;2
625;17.06.2017;2017;06;09;Lauantai;2;3;5
625;17.06.2017;2017;06;10;Lauantai;8;6;14
625;17.06.2017;2017;06;11;Lauantai;4;10;14
625;17.06.2017;2017;06;12;Lauantai;4;11;15
625;17.06.2017;2017;06;13;Lauantai;7;22;29
625;17.06.2017;2017;06;14;Lauantai;19;19;38
625;17.06.2017;2017;06;15;Lauantai;13;14;27
625;17.06.2017;2017;06;16;Lauantai;8;9;17
625;17.06.2017;2017;06;17;Lauantai;12;19;31
625;17.06.2017;2017;06;18;Lauantai;13;13;26
625;17.06.2017;2017;06;19;Lauantai;7;6;13
625;17.06.2017;2017;06;20;Lauantai;7;9;16
625;17.06.2017;2017;06;21;Lauantai;1;3;4
625;17.06.2017;2017;06;22;Lauantai;2;7;9
625;17.06.2017;2017;06;23;Lauantai;1;0;1
625;18.06.2017;2017;06;00;Sunnuntai;0;1;1
625;18.06.2017;2017;06;01;Sunnuntai;1;0;1
625;18.06.2017;2017;06;02;Sunnuntai;2;3;5
625;18.06.2017;2017;06;03;Sunnuntai;0;2;2
625;18.06.2017;2017;06;04;Sunnuntai;1;1;2
625;18.06.2017;2017;06;05;Sunnuntai;1;0;1
625;18.06.2017;2017;06;06;Sunnuntai;0;0;0
625;18.06.2017;2017;06;07;Sunnuntai;0;2;2
625;18.06.2017;2017;06;08;Sunnuntai;0;0;0
625;18.06.2017;2017;06;09;Sunnuntai;0;1;1
625;18.06.2017;2017;06;10;Sunnuntai;3;2;5
625;18.06.2017;2017;06;11;Sunnuntai;0;1;1
625;18.06.2017;2017;06;12;Sunnuntai;2;3;5
625;18.06.2017;2017;06;13;Sunnuntai;3;7;10
625;18.06.2017;2017;06;14;Sunnuntai;12;7;19
625;18.06.2017;2017;06;15;Sunnuntai;12;14;26
625;18.06.2017;2017;06;16;Sunnuntai;9;14;23
625;18.06.2017;2017;06;17;Sunnuntai;3;7;10
625;18.06.2017;2017;06;18;Sunnuntai;6;5;11
625;18.06.2017;2017;06;19;Sunnuntai;7;9;16
625;18.06.2017;2017;06;20;Sunnuntai;3;7;10
625;18.06.2017;2017;06;21;Sunnuntai;2;5;7
625;18.06.2017;2017;06;22;Sunnuntai;6;6;12
625;18.06.2017;2017;06;23;Sunnuntai;2;6;8
625;19.06.2017;2017;06;00;Maanantai;0;0;0
625;19.06.2017;2017;06;01;Maanantai;2;0;2
625;19.06.2017;2017;06;02;Maanantai;0;0;0
625;19.06.2017;2017;06;03;Maanantai;1;0;1
625;19.06.2017;2017;06;04;Maanantai;0;0;0
625;19.06.2017;2017;06;05;Maanantai;1;0;1
625;19.06.2017;2017;06;06;Maanantai;3;1;4
625;19.06.2017;2017;06;07;Maanantai;16;7;23
625;19.06.2017;2017;06;08;Maanantai;10;13;23
625;19.06.2017;2017;06;09;Maanantai;16;10;26
625;19.06.2017;2017;06;10;Maanantai;11;6;17
625;19.06.2017;2017;06;11;Maanantai;12;6;18
625;19.06.2017;2017;06;12;Maanantai;8;9;17
625;19.06.2017;2017;06;13;Maanantai;7;9;16
625;19.06.2017;2017;06;14;Maanantai;16;19;35
625;19.06.2017;2017;06;15;Maanantai;17;21;38
625;19.06.2017;2017;06;16;Maanantai;15;30;45
625;19.06.2017;2017;06;17;Maanantai;25;29;54
625;19.06.2017;2017;06;18;Maanantai;16;15;31
625;19.06.2017;2017;06;19;Maanantai;12;27;39
625;19.06.2017;2017;06;20;Maanantai;6;13;19
625;19.06.2017;2017;06;21;Maanantai;11;14;25
625;19.06.2017;2017;06;22;Maanantai;3;5;8
625;19.06.2017;2017;06;23;Maanantai;8;4;12
625;20.06.2017;2017;06;00;Tiistai;1;0;1
625;20.06.2017;2017;06;01;Tiistai;0;0;0
625;20.06.2017;2017;06;02;Tiistai;0;0;0
625;20.06.2017;2017;06;03;Tiistai;0;0;0
625;20.06.2017;2017;06;04;Tiistai;0;0;0
625;20.06.2017;2017;06;05;Tiistai;0;0;0
625;20.06.2017;2017;06;06;Tiistai;0;0;0
625;20.06.2017;2017;06;07;Tiistai;0;0;0
625;20.06.2017;2017;06;08;Tiistai;0;0;0
625;20.06.2017;2017;06;09;Tiistai;0;0;0
625;20.06.2017;2017;06;10;Tiistai;0;0;0
625;20.06.2017;2017;06;11;Tiistai;8;6;14
625;20.06.2017;2017;06;12;Tiistai;11;7;18
625;20.06.2017;2017;06;13;Tiistai;8;21;29
625;20.06.2017;2017;06;14;Tiistai;21;16;37
625;20.06.2017;2017;06;15;Tiistai;27;19;46
625;20.06.2017;2017;06;16;Tiistai;29;30;59
625;20.06.2017;2017;06;17;Tiistai;27;32;59
625;20.06.2017;2017;06;18;Tiistai;17;28;45
625;20.06.2017;2017;06;19;Tiistai;23;28;51
625;20.06.2017;2017;06;20;Tiistai;28;27;55
625;20.06.2017;2017;06;21;Tiistai;9;13;22
625;20.06.2017;2017;06;22;Tiistai;6;11;17
625;20.06.2017;2017;06;23;Tiistai;3;8;11
625;21.06.2017;2017;06;00;Keskiviikko;2;2;4
625;21.06.2017;2017;06;01;Keskiviikko;0;1;1
625;21.06.2017;2017;06;02;Keskiviikko;1;0;1
625;21.06.2017;2017;06;03;Keskiviikko;1;1;2
625;21.06.2017;2017;06;04;Keskiviikko;2;0;2
625;21.06.2017;2017;06;05;Keskiviikko;0;0;0
625;21.06.2017;2017;06;06;Keskiviikko;4;6;10
625;21.06.2017;2017;06;07;Keskiviikko;16;6;22
625;21.06.2017;2017;06;08;Keskiviikko;22;20;42
625;21.06.2017;2017;06;09;Keskiviikko;16;14;30
625;21.06.2017;2017;06;10;Keskiviikko;21;13;34
625;21.06.2017;2017;06;11;Keskiviikko;12;7;19
625;21.06.2017;2017;06;12;Keskiviikko;8;12;20
625;21.06.2017;2017;06;13;Keskiviikko;3;10;13
625;21.06.2017;2017;06;14;Keskiviikko;15;8;23
625;21.06.2017;2017;06;15;Keskiviikko;15;16;31
625;21.06.2017;2017;06;16;Keskiviikko;13;20;33
625;21.06.2017;2017;06;17;Keskiviikko;27;26;53
625;21.06.2017;2017;06;18;Keskiviikko;13;18;31
625;21.06.2017;2017;06;19;Keskiviikko;17;17;34
625;21.06.2017;2017;06;20;Keskiviikko;6;10;16
625;21.06.2017;2017;06;21;Keskiviikko;7;8;15
625;21.06.2017;2017;06;22;Keskiviikko;2;8;10
625;21.06.2017;2017;06;23;Keskiviikko;4;5;9
625;22.06.2017;2017;06;00;Torstai;1;3;4
625;22.06.2017;2017;06;01;Torstai;2;2;4
625;22.06.2017;2017;06;02;Torstai;1;0;1
625;22.06.2017;2017;06;03;Torstai;0;0;0
625;22.06.2017;2017;06;04;Torstai;0;0;0
625;22.06.2017;2017;06;05;Torstai;2;0;2
625;22.06.2017;2017;06;06;Torstai;2;6;8
625;22.06.2017;2017;06;07;Torstai;11;6;17
625;22.06.2017;2017;06;08;Torstai;20;16;36
625;22.06.2017;2017;06;09;Torstai;10;9;19
625;22.06.2017;2017;06;10;Torstai;8;5;13
625;22.06.2017;2017;06;11;Torstai;6;2;8
625;22.06.2017;2017;06;12;Torstai;8;4;12
625;22.06.2017;2017;06;13;Torstai;12;18;30
625;22.06.2017;2017;06;14;Torstai;5;4;9
625;22.06.2017;2017;06;15;Torstai;7;14;21
625;22.06.2017;2017;06;16;Torstai;13;19;32
625;22.06.2017;2017;06;17;Torstai;7;9;16
625;22.06.2017;2017;06;18;Torstai;6;10;16
625;22.06.2017;2017;06;19;Torstai;6;5;11
625;22.06.2017;2017;06;20;Torstai;3;8;11
625;22.06.2017;2017;06;21;Torstai;13;8;21
625;22.06.2017;2017;06;22;Torstai;1;3;4
625;22.06.2017;2017;06;23;Torstai;5;3;8
625;23.06.2017;2017;06;00;Perjantai;2;1;3
625;23.06.2017;2017;06;01;Perjantai;2;3;5
625;23.06.2017;2017;06;02;Perjantai;2;1;3
625;23.06.2017;2017;06;03;Perjantai;0;0;0
625;23.06.2017;2017;06;04;Perjantai;0;1;1
625;23.06.2017;2017;06;05;Perjantai;1;0;1
625;23.06.2017;2017;06;06;Perjantai;2;0;2
625;23.06.2017;2017;06;07;Perjantai;3;0;3
625;23.06.2017;2017;06;08;Perjantai;0;4;4
625;23.06.2017;2017;06;09;Perjantai;2;0;2
625;23.06.2017;2017;06;10;Perjantai;3;3;6
625;23.06.2017;2017;06;11;Perjantai;5;8;13
625;23.06.2017;2017;06;12;Perjantai;7;6;13
625;23.06.2017;2017;06;13;Perjantai;3;11;14
625;23.06.2017;2017;06;14;Perjantai;13;19;32
625;23.06.2017;2017;06;15;Perjantai;7;9;16
625;23.06.2017;2017;06;16;Perjantai;8;10;18
625;23.06.2017;2017;06;17;Perjantai;7;12;19
625;23.06.2017;2017;06;18;Perjantai;10;10;20
625;23.06.2017;2017;06;19;Perjantai;5;8;13
625;23.06.2017;2017;06;20;Perjantai;8;5;13
625;23.06.2017;2017;06;21;Perjantai;5;5;10
625;23.06.2017;2017;06;22;Perjantai;3;2;5
625;23.06.2017;2017;06;23;Perjantai;2;5;7
625;24.06.2017;2017;06;00;Lauantai;4;4;8
625;24.06.2017;2017;06;01;Lauantai;3;1;4
625;24.06.2017;2017;06;02;Lauantai;4;1;5
625;24.06.2017;2017;06;03;Lauantai;3;3;6
625;24.06.2017;2017;06;04;Lauantai;1;0;1
625;24.06.2017;2017;06;05;Lauantai;2;2;4
625;24.06.2017;2017;06;06;Lauantai;0;0;0
625;24.06.2017;2017;06;07;Lauantai;2;0;2
625;24.06.2017;2017;06;08;Lauantai;1;4;5
625;24.06.2017;2017;06;09;Lauantai;0;1;1
625;24.06.2017;2017;06;10;Lauantai;2;2;4
625;24.06.2017;2017;06;11;Lauantai;2;4;6
625;24.06.2017;2017;06;12;Lauantai;7;8;15
625;24.06.2017;2017;06;13;Lauantai;7;8;15
625;24.06.2017;2017;06;14;Lauantai;15;16;31
625;24.06.2017;2017;06;15;Lauantai;15;12;27
625;24.06.2017;2017;06;16;Lauantai;7;12;19
625;24.06.2017;2017;06;17;Lauantai;6;3;9
625;24.06.2017;2017;06;18;Lauantai;11;10;21
625;24.06.2017;2017;06;19;Lauantai;15;13;28
625;24.06.2017;2017;06;20;Lauantai;10;8;18
625;24.06.2017;2017;06;21;Lauantai;12;4;16
625;24.06.2017;2017;06;22;Lauantai;2;2;4
625;24.06.2017;2017;06;23;Lauantai;3;1;4
625;25.06.2017;2017;06;00;Sunnuntai;2;0;2
625;25.06.2017;2017;06;01;Sunnuntai;0;0;0
625;25.06.2017;2017;06;02;Sunnuntai;0;2;2
625;25.06.2017;2017;06;03;Sunnuntai;1;0;1
625;25.06.2017;2017;06;04;Sunnuntai;3;2;5
625;25.06.2017;2017;06;05;Sunnuntai;1;0;1
625;25.06.2017;2017;06;06;Sunnuntai;0;0;0
625;25.06.2017;2017;06;07;Sunnuntai;1;0;1
625;25.06.2017;2017;06;08;Sunnuntai;0;3;3
625;25.06.2017;2017;06;09;Sunnuntai;0;6;6
625;25.06.2017;2017;06;10;Sunnuntai;5;4;9
625;25.06.2017;2017;06;11;Sunnuntai;6;6;12
625;25.06.2017;2017;06;12;Sunnuntai;4;8;12
625;25.06.2017;2017;06;13;Sunnuntai;4;8;12
625;25.06.2017;2017;06;14;Sunnuntai;5;8;13
625;25.06.2017;2017;06;15;Sunnuntai;1;4;5
625;25.06.2017;2017;06;16;Sunnuntai;6;5;11
625;25.06.2017;2017;06;17;Sunnuntai;7;5;12
625;25.06.2017;2017;06;18;Sunnuntai;2;4;6
625;25.06.2017;2017;06;19;Sunnuntai;3;8;11
625;25.06.2017;2017;06;20;Sunnuntai;6;8;14
625;25.06.2017;2017;06;21;Sunnuntai;7;2;9
625;25.06.2017;2017;06;22;Sunnuntai;2;1;3
625;25.06.2017;2017;06;23;Sunnuntai;6;1;7
625;26.06.2017;2017;06;00;Maanantai;1;0;1
625;26.06.2017;2017;06;01;Maanantai;0;0;0
625;26.06.2017;2017;06;02;Maanantai;1;1;2
625;26.06.2017;2017;06;03;Maanantai;0;0;0
625;26.06.2017;2017;06;04;Maanantai;1;0;1
625;26.06.2017;2017;06;05;Maanantai;1;0;1
625;26.06.2017;2017;06;06;Maanantai;2;2;4
625;26.06.2017;2017;06;07;Maanantai;7;9;16
625;26.06.2017;2017;06;08;Maanantai;14;14;28
625;26.06.2017;2017;06;09;Maanantai;7;10;17
625;26.06.2017;2017;06;10;Maanantai;2;4;6
625;26.06.2017;2017;06;11;Maanantai;2;3;5
625;26.06.2017;2017;06;12;Maanantai;4;6;10
625;26.06.2017;2017;06;13;Maanantai;3;1;4
625;26.06.2017;2017;06;14;Maanantai;9;16;25
625;26.06.2017;2017;06;15;Maanantai;7;11;18
625;26.06.2017;2017;06;16;Maanantai;10;21;31
625;26.06.2017;2017;06;17;Maanantai;20;22;42
625;26.06.2017;2017;06;18;Maanantai;25;20;45
625;26.06.2017;2017;06;19;Maanantai;17;18;35
625;26.06.2017;2017;06;20;Maanantai;15;19;34
625;26.06.2017;2017;06;21;Maanantai;10;17;27
625;26.06.2017;2017;06;22;Maanantai;7;6;13
625;26.06.2017;2017;06;23;Maanantai;3;3;6
625;27.06.2017;2017;06;00;Tiistai;1;2;3
625;27.06.2017;2017;06;01;Tiistai;1;0;1
625;27.06.2017;2017;06;02;Tiistai;0;1;1
625;27.06.2017;2017;06;03;Tiistai;0;0;0
625;27.06.2017;2017;06;04;Tiistai;1;0;1
625;27.06.2017;2017;06;05;Tiistai;1;0;1
625;27.06.2017;2017;06;06;Tiistai;2;5;7
625;27.06.2017;2017;06;07;Tiistai;12;12;24
625;27.06.2017;2017;06;08;Tiistai;18;23;41
625;27.06.2017;2017;06;09;Tiistai;12;13;25
625;27.06.2017;2017;06;10;Tiistai;22;26;48
625;27.06.2017;2017;06;11;Tiistai;12;14;26
625;27.06.2017;2017;06;12;Tiistai;15;17;32
625;27.06.2017;2017;06;13;Tiistai;9;11;20
625;27.06.2017;2017;06;14;Tiistai;18;14;32
625;27.06.2017;2017;06;15;Tiistai;21;23;44
625;27.06.2017;2017;06;16;Tiistai;21;23;44
625;27.06.2017;2017;06;17;Tiistai;28;27;55
625;27.06.2017;2017;06;18;Tiistai;31;29;60
625;27.06.2017;2017;06;19;Tiistai;21;23;44
625;27.06.2017;2017;06;20;Tiistai;12;23;35
625;27.06.2017;2017;06;21;Tiistai;5;8;13
625;27.06.2017;2017;06;22;Tiistai;7;9;16
625;27.06.2017;2017;06;23;Tiistai;3;5;8
625;28.06.2017;2017;06;00;Keskiviikko;1;3;4
625;28.06.2017;2017;06;01;Keskiviikko;1;0;1
625;28.06.2017;2017;06;02;Keskiviikko;1;1;2
625;28.06.2017;2017;06;03;Keskiviikko;1;0;1
625;28.06.2017;2017;06;04;Keskiviikko;0;0;0
625;28.06.2017;2017;06;05;Keskiviikko;1;1;2
625;28.06.2017;2017;06;06;Keskiviikko;3;9;12
625;28.06.2017;2017;06;07;Keskiviikko;12;7;19
625;28.06.2017;2017;06;08;Keskiviikko;9;18;27
625;28.06.2017;2017;06;09;Keskiviikko;9;14;23
625;28.06.2017;2017;06;10;Keskiviikko;7;6;13
625;28.06.2017;2017;06;11;Keskiviikko;3;6;9
625;28.06.2017;2017;06;12;Keskiviikko;12;8;20
625;28.06.2017;2017;06;13;Keskiviikko;8;10;18
625;28.06.2017;2017;06;14;Keskiviikko;8;11;19
625;28.06.2017;2017;06;15;Keskiviikko;11;19;30
625;28.06.2017;2017;06;16;Keskiviikko;12;11;23
625;28.06.2017;2017;06;17;Keskiviikko;29;16;45
625;28.06.2017;2017;06;18;Keskiviikko;16;13;29
625;28.06.2017;2017;06;19;Keskiviikko;7;17;24
625;28.06.2017;2017;06;20;Keskiviikko;19;14;33
625;28.06.2017;2017;06;21;Keskiviikko;11;17;28
625;28.06.2017;2017;06;22;Keskiviikko;11;6;17
625;28.06.2017;2017;06;23;Keskiviikko;3;4;7
625;29.06.2017;2017;06;00;Torstai;1;1;2
625;29.06.2017;2017;06;01;Torstai;0;0;0
625;29.06.2017;2017;06;02;Torstai;0;1;1
625;29.06.2017;2017;06;03;Torstai;1;0;1
625;29.06.2017;2017;06;04;Torstai;0;0;0
625;29.06.2017;2017;06;05;Torstai;0;0;0
625;29.06.2017;2017;06;06;Torstai;3;4;7
625;29.06.2017;2017;06;07;Torstai;11;13;24
625;29.06.2017;2017;06;08;Torstai;13;22;35
625;29.06.2017;2017;06;09;Torstai;12;10;22
625;29.06.2017;2017;06;10;Torstai;8;8;16
625;29.06.2017;2017;06;11;Torstai;8;8;16
625;29.06.2017;2017;06;12;Torstai;13;13;26
625;29.06.2017;2017;06;13;Torstai;22;17;39
625;29.06.2017;2017;06;14;Torstai;9;11;20
625;29.06.2017;2017;06;15;Torstai;12;17;29
625;29.06.2017;2017;06;16;Torstai;22;31;53
625;29.06.2017;2017;06;17;Torstai;37;28;65
625;29.06.2017;2017;06;18;Torstai;24;28;52
625;29.06.2017;2017;06;19;Torstai;24;26;50
625;29.06.2017;2017;06;20;Torstai;27;20;47
625;29.06.2017;2017;06;21;Torstai;14;15;29
625;29.06.2017;2017;06;22;Torstai;5;10;15
625;29.06.2017;2017;06;23;Torstai;3;6;9
625;30.06.2017;2017;06;00;Perjantai;1;2;3
625;30.06.2017;2017;06;01;Perjantai;3;1;4
625;30.06.2017;2017;06;02;Perjantai;0;0;0
625;30.06.2017;2017;06;03;Perjantai;0;0;0
625;30.06.2017;2017;06;04;Perjantai;1;0;1
625;30.06.2017;2017;06;05;Perjantai;1;0;1
625;30.06.2017;2017;06;06;Perjantai;5;4;9
625;30.06.2017;2017;06;07;Perjantai;14;9;23
625;30.06.2017;2017;06;08;Perjantai;16;25;41
625;30.06.2017;2017;06;09;Perjantai;10;19;29
625;30.06.2017;2017;06;10;Perjantai;5;11;16
625;30.06.2017;2017;06;11;Perjantai;17;14;31
625;30.06.2017;2017;06;12;Perjantai;24;25;49
625;30.06.2017;2017;06;13;Perjantai;19;21;40
625;30.06.2017;2017;06;14;Perjantai;20;9;29
625;30.06.2017;2017;06;15;Perjantai;11;22;33
625;30.06.2017;2017;06;16;Perjantai;26;30;56
625;30.06.2017;2017;06;17;Perjantai;32;33;65
625;30.06.2017;2017;06;18;Perjantai;15;16;31
625;30.06.2017;2017;06;19;Perjantai;18;20;38
625;30.06.2017;2017;06;20;Perjantai;9;10;19
625;30.06.2017;2017;06;21;Perjantai;6;9;15
625;30.06.2017;2017;06;22;Perjantai;7;16;23
625;30.06.2017;2017;06;23;Perjantai;5;6;11
625;01.07.2017;2017;07;00;Lauantai;5;0;5
625;01.07.2017;2017;07;01;Lauantai;4;4;8
625;01.07.2017;2017;07;02;Lauantai;2;0;2
625;01.07.2017;2017;07;03;Lauantai;1;0;1
625;01.07.2017;2017;07;04;Lauantai;2;0;2
625;01.07.2017;2017;07;05;Lauantai;2;2;4
625;01.07.2017;2017;07;06;Lauantai;1;0;1
625;01.07.2017;2017;07;07;Lauantai;0;3;3
625;01.07.2017;2017;07;08;Lauantai;3;0;3
625;01.07.2017;2017;07;09;Lauantai;4;1;5
625;01.07.2017;2017;07;10;Lauantai;7;7;14
625;01.07.2017;2017;07;11;Lauantai;12;7;19
625;01.07.2017;2017;07;12;Lauantai;10;7;17
625;01.07.2017;2017;07;13;Lauantai;17;19;36
625;01.07.2017;2017;07;14;Lauantai;20;16;36
625;01.07.2017;2017;07;15;Lauantai;11;21;32
625;01.07.2017;2017;07;16;Lauantai;15;16;31
625;01.07.2017;2017;07;17;Lauantai;15;27;42
625;01.07.2017;2017;07;18;Lauantai;14;24;38
625;01.07.2017;2017;07;19;Lauantai;22;14;36
625;01.07.2017;2017;07;20;Lauantai;11;14;25
625;01.07.2017;2017;07;21;Lauantai;11;8;19
625;01.07.2017;2017;07;22;Lauantai;16;3;19
625;01.07.2017;2017;07;23;Lauantai;6;4;10
625;02.07.2017;2017;07;00;Sunnuntai;4;4;8
625;02.07.2017;2017;07;01;Sunnuntai;2;4;6
625;02.07.2017;2017;07;02;Sunnuntai;3;1;4
625;02.07.2017;2017;07;03;Sunnuntai;0;1;1
625;02.07.2017;2017;07;04;Sunnuntai;2;1;3
625;02.07.2017;2017;07;05;Sunnuntai;1;0;1
625;02.07.2017;2017;07;06;Sunnuntai;1;0;1
625;02.07.2017;2017;07;07;Sunnuntai;0;2;2
625;02.07.2017;2017;07;08;Sunnuntai;1;4;5
625;02.07.2017;2017;07;09;Sunnuntai;2;2;4
625;02.07.2017;2017;07;10;Sunnuntai;8;7;15
625;02.07.2017;2017;07;11;Sunnuntai;16;17;33
625;02.07.2017;2017;07;12;Sunnuntai;9;12;21
625;02.07.2017;2017;07;13;Sunnuntai;13;19;32
625;02.07.2017;2017;07;14;Sunnuntai;16;20;36
625;02.07.2017;2017;07;15;Sunnuntai;18;26;44
625;02.07.2017;2017;07;16;Sunnuntai;16;33;49
625;02.07.2017;2017;07;17;Sunnuntai;17;16;33
625;02.07.2017;2017;07;18;Sunnuntai;20;27;47
625;02.07.2017;2017;07;19;Sunnuntai;14;21;35
625;02.07.2017;2017;07;20;Sunnuntai;20;18;38
625;02.07.2017;2017;07;21;Sunnuntai;12;16;28
625;02.07.2017;2017;07;22;Sunnuntai;9;11;20
625;02.07.2017;2017;07;23;Sunnuntai;3;4;7
625;03.07.2017;2017;07;00;Maanantai;4;2;6
625;03.07.2017;2017;07;01;Maanantai;1;3;4
625;03.07.2017;2017;07;02;Maanantai;2;1;3
625;03.07.2017;2017;07;03;Maanantai;0;0;0
625;03.07.2017;2017;07;04;Maanantai;1;0;1
625;03.07.2017;2017;07;05;Maanantai;1;1;2
625;03.07.2017;2017;07;06;Maanantai;3;7;10
625;03.07.2017;2017;07;07;Maanantai;13;9;22
625;03.07.2017;2017;07;08;Maanantai;18;21;39
625;03.07.2017;2017;07;09;Maanantai;12;12;24
625;03.07.2017;2017;07;10;Maanantai;6;11;17
625;03.07.2017;2017;07;11;Maanantai;11;7;18
625;03.07.2017;2017;07;12;Maanantai;14;13;27
625;03.07.2017;2017;07;13;Maanantai;13;16;29
625;03.07.2017;2017;07;14;Maanantai;17;19;36
625;03.07.2017;2017;07;15;Maanantai;20;26;46
625;03.07.2017;2017;07;16;Maanantai;21;40;61
625;03.07.2017;2017;07;17;Maanantai;29;26;55
625;03.07.2017;2017;07;18;Maanantai;22;23;45
625;03.07.2017;2017;07;19;Maanantai;26;34;60
625;03.07.2017;2017;07;20;Maanantai;16;20;36
625;03.07.2017;2017;07;21;Maanantai;10;10;20
625;03.07.2017;2017;07;22;Maanantai;5;7;12
625;03.07.2017;2017;07;23;Maanantai;6;5;11
625;04.07.2017;2017;07;00;Tiistai;2;1;3
625;04.07.2017;2017;07;01;Tiistai;4;1;5
625;04.07.2017;2017;07;02;Tiistai;0;1;1
625;04.07.2017;2017;07;03;Tiistai;0;0;0
625;04.07.2017;2017;07;04;Tiistai;0;0;0
625;04.07.2017;2017;07;05;Tiistai;1;1;2
625;04.07.2017;2017;07;06;Tiistai;5;3;8
625;04.07.2017;2017;07;07;Tiistai;13;9;22
625;04.07.2017;2017;07;08;Tiistai;18;15;33
625;04.07.2017;2017;07;09;Tiistai;6;8;14
625;04.07.2017;2017;07;10;Tiistai;7;10;17
625;04.07.2017;2017;07;11;Tiistai;14;6;20
625;04.07.2017;2017;07;12;Tiistai;4;9;13
625;04.07.2017;2017;07;13;Tiistai;9;6;15
625;04.07.2017;2017;07;14;Tiistai;14;10;24
625;04.07.2017;2017;07;15;Tiistai;13;15;28
625;04.07.2017;2017;07;16;Tiistai;14;25;39
625;04.07.2017;2017;07;17;Tiistai;18;21;39
625;04.07.2017;2017;07;18;Tiistai;21;18;39
625;04.07.2017;2017;07;19;Tiistai;12;9;21
625;04.07.2017;2017;07;20;Tiistai;10;16;26
625;04.07.2017;2017;07;21;Tiistai;10;10;20
625;04.07.2017;2017;07;22;Tiistai;5;15;20
625;04.07.2017;2017;07;23;Tiistai;2;4;6
625;05.07.2017;2017;07;00;Keskiviikko;3;0;3
625;05.07.2017;2017;07;01;Keskiviikko;1;1;2
625;05.07.2017;2017;07;02;Keskiviikko;1;1;2
625;05.07.2017;2017;07;03;Keskiviikko;1;0;1
625;05.07.2017;2017;07;04;Keskiviikko;0;0;0
625;05.07.2017;2017;07;05;Keskiviikko;0;0;0
625;05.07.2017;2017;07;06;Keskiviikko;1;5;6
625;05.07.2017;2017;07;07;Keskiviikko;17;9;26
625;05.07.2017;2017;07;08;Keskiviikko;13;14;27
625;05.07.2017;2017;07;09;Keskiviikko;7;6;13
625;05.07.2017;2017;07;10;Keskiviikko;7;6;13
625;05.07.2017;2017;07;11;Keskiviikko;10;7;17
625;05.07.2017;2017;07;12;Keskiviikko;6;8;14
625;05.07.2017;2017;07;13;Keskiviikko;9;7;16
625;05.07.2017;2017;07;14;Keskiviikko;11;14;25
625;05.07.2017;2017;07;15;Keskiviikko;5;5;10
625;05.07.2017;2017;07;16;Keskiviikko;15;21;36
625;05.07.2017;2017;07;17;Keskiviikko;19;20;39
625;05.07.2017;2017;07;18;Keskiviikko;15;24;39
625;05.07.2017;2017;07;19;Keskiviikko;14;11;25
625;05.07.2017;2017;07;20;Keskiviikko;12;12;24
625;05.07.2017;2017;07;21;Keskiviikko;5;5;10
625;05.07.2017;2017;07;22;Keskiviikko;1;2;3
625;05.07.2017;2017;07;23;Keskiviikko;2;2;4
625;06.07.2017;2017;07;00;Torstai;3;1;4
625;06.07.2017;2017;07;01;Torstai;1;0;1
625;06.07.2017;2017;07;02;Torstai;0;0;0
625;06.07.2017;2017;07;03;Torstai;0;0;0
625;06.07.2017;2017;07;04;Torstai;1;0;1
625;06.07.2017;2017;07;05;Torstai;0;0;0
625;06.07.2017;2017;07;06;Torstai;2;4;6
625;06.07.2017;2017;07;07;Torstai;7;5;12
625;06.07.2017;2017;07;08;Torstai;8;7;15
625;06.07.2017;2017;07;09;Torstai;7;6;13
625;06.07.2017;2017;07;10;Torstai;3;1;4
625;06.07.2017;2017;07;11;Torstai;0;4;4
625;06.07.2017;2017;07;12;Torstai;8;5;13
625;06.07.2017;2017;07;13;Torstai;2;3;5
625;06.07.2017;2017;07;14;Torstai;4;3;7
625;06.07.2017;2017;07;15;Torstai;14;4;18
625;06.07.2017;2017;07;16;Torstai;18;13;31
625;06.07.2017;2017;07;17;Torstai;7;16;23
625;06.07.2017;2017;07;18;Torstai;13;14;27
625;06.07.2017;2017;07;19;Torstai;13;10;23
625;06.07.2017;2017;07;20;Torstai;8;7;15
625;06.07.2017;2017;07;21;Torstai;7;4;11
625;06.07.2017;2017;07;22;Torstai;4;6;10
625;06.07.2017;2017;07;23;Torstai;1;4;5
625;07.07.2017;2017;07;00;Perjantai;3;0;3
625;07.07.2017;2017;07;01;Perjantai;2;0;2
625;07.07.2017;2017;07;02;Perjantai;4;0;4
625;07.07.2017;2017;07;03;Perjantai;2;0;2
625;07.07.2017;2017;07;04;Perjantai;0;0;0
625;07.07.2017;2017;07;05;Perjantai;1;1;2
625;07.07.2017;2017;07;06;Perjantai;2;6;8
625;07.07.2017;2017;07;07;Perjantai;10;9;19
625;07.07.2017;2017;07;08;Perjantai;13;16;29
625;07.07.2017;2017;07;09;Perjantai;8;9;17
625;07.07.2017;2017;07;10;Perjantai;11;4;15
625;07.07.2017;2017;07;11;Perjantai;10;7;17
625;07.07.2017;2017;07;12;Perjantai;13;12;25
625;07.07.2017;2017;07;13;Perjantai;15;17;32
625;07.07.2017;2017;07;14;Perjantai;24;28;52
625;07.07.2017;2017;07;15;Perjantai;14;25;39
625;07.07.2017;2017;07;16;Perjantai;20;20;40
625;07.07.2017;2017;07;17;Perjantai;22;27;49
625;07.07.2017;2017;07;18;Perjantai;12;14;26
625;07.07.2017;2017;07;19;Perjantai;9;17;26
625;07.07.2017;2017;07;20;Perjantai;15;12;27
625;07.07.2017;2017;07;21;Perjantai;10;8;18
625;07.07.2017;2017;07;22;Perjantai;6;12;18
625;07.07.2017;2017;07;23;Perjantai;8;9;17
625;08.07.2017;2017;07;00;Lauantai;4;1;5
625;08.07.2017;2017;07;01;Lauantai;3;2;5
625;08.07.2017;2017;07;02;Lauantai;1;1;2
625;08.07.2017;2017;07;03;Lauantai;2;0;2
625;08.07.2017;2017;07;04;Lauantai;0;2;2
625;08.07.2017;2017;07;05;Lauantai;1;2;3
625;08.07.2017;2017;07;06;Lauantai;0;0;0
625;08.07.2017;2017;07;07;Lauantai;3;1;4
625;08.07.2017;2017;07;08;Lauantai;2;3;5
625;08.07.2017;2017;07;09;Lauantai;6;4;10
625;08.07.2017;2017;07;10;Lauantai;4;2;6
625;08.07.2017;2017;07;11;Lauantai;9;16;25
625;08.07.2017;2017;07;12;Lauantai;26;30;56
625;08.07.2017;2017;07;13;Lauantai;16;20;36
625;08.07.2017;2017;07;14;Lauantai;19;15;34
625;08.07.2017;2017;07;15;Lauantai;15;21;36
625;08.07.2017;2017;07;16;Lauantai;8;23;31
625;08.07.2017;2017;07;17;Lauantai;22;26;48
625;08.07.2017;2017;07;18;Lauantai;11;13;24
625;08.07.2017;2017;07;19;Lauantai;8;15;23
625;08.07.2017;2017;07;20;Lauantai;9;12;21
625;08.07.2017;2017;07;21;Lauantai;6;10;16
625;08.07.2017;2017;07;22;Lauantai;8;7;15
625;08.07.2017;2017;07;23;Lauantai;10;3;13
625;09.07.2017;2017;07;00;Sunnuntai;2;2;4
625;09.07.2017;2017;07;01;Sunnuntai;4;5;9
625;09.07.2017;2017;07;02;Sunnuntai;5;3;8
625;09.07.2017;2017;07;03;Sunnuntai;1;1;2
625;09.07.2017;2017;07;04;Sunnuntai;2;0;2
625;09.07.2017;2017;07;05;Sunnuntai;1;0;1
625;09.07.2017;2017;07;06;Sunnuntai;2;0;2
625;09.07.2017;2017;07;07;Sunnuntai;3;1;4
625;09.07.2017;2017;07;08;Sunnuntai;0;6;6
625;09.07.2017;2017;07;09;Sunnuntai;2;6;8
625;09.07.2017;2017;07;10;Sunnuntai;4;9;13
625;09.07.2017;2017;07;11;Sunnuntai;11;10;21
625;09.07.2017;2017;07;12;Sunnuntai;16;10;26
625;09.07.2017;2017;07;13;Sunnuntai;16;28;44
625;09.07.2017;2017;07;14;Sunnuntai;30;29;59
625;09.07.2017;2017;07;15;Sunnuntai;26;33;59
625;09.07.2017;2017;07;16;Sunnuntai;23;20;43
625;09.07.2017;2017;07;17;Sunnuntai;17;13;30
625;09.07.2017;2017;07;18;Sunnuntai;14;24;38
625;09.07.2017;2017;07;19;Sunnuntai;21;18;39
625;09.07.2017;2017;07;20;Sunnuntai;16;21;37
625;09.07.2017;2017;07;21;Sunnuntai;9;11;20
625;09.07.2017;2017;07;22;Sunnuntai;11;10;21
625;09.07.2017;2017;07;23;Sunnuntai;10;7;17
625;10.07.2017;2017;07;00;Maanantai;1;1;2
625;10.07.2017;2017;07;01;Maanantai;2;0;2
625;10.07.2017;2017;07;02;Maanantai;1;0;1
625;10.07.2017;2017;07;03;Maanantai;1;0;1
625;10.07.2017;2017;07;04;Maanantai;0;0;0
625;10.07.2017;2017;07;05;Maanantai;2;1;3
625;10.07.2017;2017;07;06;Maanantai;2;1;3
625;10.07.2017;2017;07;07;Maanantai;11;6;17
625;10.07.2017;2017;07;08;Maanantai;16;23;39
625;10.07.2017;2017;07;09;Maanantai;8;8;16
625;10.07.2017;2017;07;10;Maanantai;5;10;15
625;10.07.2017;2017;07;11;Maanantai;18;8;26
625;10.07.2017;2017;07;12;Maanantai;15;23;38
625;10.07.2017;2017;07;13;Maanantai;23;26;49
625;10.07.2017;2017;07;14;Maanantai;12;20;32
625;10.07.2017;2017;07;15;Maanantai;16;24;40
625;10.07.2017;2017;07;16;Maanantai;24;27;51
625;10.07.2017;2017;07;17;Maanantai;39;24;63
625;10.07.2017;2017;07;18;Maanantai;30;31;61
625;10.07.2017;2017;07;19;Maanantai;14;14;28
625;10.07.2017;2017;07;20;Maanantai;20;24;44
625;10.07.2017;2017;07;21;Maanantai;9;17;26
625;10.07.2017;2017;07;22;Maanantai;11;11;22
625;10.07.2017;2017;07;23;Maanantai;6;3;9
625;11.07.2017;2017;07;00;Tiistai;2;1;3
625;11.07.2017;2017;07;01;Tiistai;0;0;0
625;11.07.2017;2017;07;02;Tiistai;0;0;0
625;11.07.2017;2017;07;03;Tiistai;0;2;2
625;11.07.2017;2017;07;04;Tiistai;0;0;0
625;11.07.2017;2017;07;05;Tiistai;1;1;2
625;11.07.2017;2017;07;06;Tiistai;3;2;5
625;11.07.2017;2017;07;07;Tiistai;17;14;31
625;11.07.2017;2017;07;08;Tiistai;17;11;28
625;11.07.2017;2017;07;09;Tiistai;8;12;20
625;11.07.2017;2017;07;10;Tiistai;13;7;20
625;11.07.2017;2017;07;11;Tiistai;12;19;31
625;11.07.2017;2017;07;12;Tiistai;17;23;40
625;11.07.2017;2017;07;13;Tiistai;20;18;38
625;11.07.2017;2017;07;14;Tiistai;18;21;39
625;11.07.2017;2017;07;15;Tiistai;11;21;32
625;11.07.2017;2017;07;16;Tiistai;14;33;47
625;11.07.2017;2017;07;17;Tiistai;26;34;60
625;11.07.2017;2017;07;18;Tiistai;17;21;38
625;11.07.2017;2017;07;19;Tiistai;19;16;35
625;11.07.2017;2017;07;20;Tiistai;14;14;28
625;11.07.2017;2017;07;21;Tiistai;8;10;18
625;11.07.2017;2017;07;22;Tiistai;3;10;13
625;11.07.2017;2017;07;23;Tiistai;4;2;6
625;12.07.2017;2017;07;00;Keskiviikko;2;0;2
625;12.07.2017;2017;07;01;Keskiviikko;2;0;2
625;12.07.2017;2017;07;02;Keskiviikko;1;1;2
625;12.07.2017;2017;07;03;Keskiviikko;0;0;0
625;12.07.2017;2017;07;04;Keskiviikko;0;0;0
625;12.07.2017;2017;07;05;Keskiviikko;0;1;1
625;12.07.2017;2017;07;06;Keskiviikko;1;0;1
625;12.07.2017;2017;07;07;Keskiviikko;9;5;14
625;12.07.2017;2017;07;08;Keskiviikko;12;11;23
625;12.07.2017;2017;07;09;Keskiviikko;10;9;19
625;12.07.2017;2017;07;10;Keskiviikko;1;1;2
625;12.07.2017;2017;07;11;Keskiviikko;3;4;7
625;12.07.2017;2017;07;12;Keskiviikko;7;8;15
625;12.07.2017;2017;07;13;Keskiviikko;7;3;10
625;12.07.2017;2017;07;14;Keskiviikko;7;12;19
625;12.07.2017;2017;07;15;Keskiviikko;11;10;21
625;12.07.2017;2017;07;16;Keskiviikko;9;12;21
625;12.07.2017;2017;07;17;Keskiviikko;13;9;22
625;12.07.2017;2017;07;18;Keskiviikko;13;11;24
625;12.07.2017;2017;07;19;Keskiviikko;2;6;8
625;12.07.2017;2017;07;20;Keskiviikko;7;4;11
625;12.07.2017;2017;07;21;Keskiviikko;2;5;7
625;12.07.2017;2017;07;22;Keskiviikko;1;6;7
625;12.07.2017;2017;07;23;Keskiviikko;1;3;4
625;13.07.2017;2017;07;00;Torstai;3;0;3
625;13.07.2017;2017;07;01;Torstai;1;0;1
625;13.07.2017;2017;07;02;Torstai;0;0;0
625;13.07.2017;2017;07;03;Torstai;1;1;2
625;13.07.2017;2017;07;04;Torstai;0;0;0
625;13.07.2017;2017;07;05;Torstai;1;0;1
625;13.07.2017;2017;07;06;Torstai;2;1;3
625;13.07.2017;2017;07;07;Torstai;10;7;17
625;13.07.2017;2017;07;08;Torstai;8;12;20
625;13.07.2017;2017;07;09;Torstai;8;7;15
625;13.07.2017;2017;07;10;Torstai;2;5;7
625;13.07.2017;2017;07;11;Torstai;3;6;9
625;13.07.2017;2017;07;12;Torstai;11;13;24
625;13.07.2017;2017;07;13;Torstai;12;14;26
625;13.07.2017;2017;07;14;Torstai;13;21;34
625;13.07.2017;2017;07;15;Torstai;13;19;32
625;13.07.2017;2017;07;16;Torstai;16;21;37
625;13.07.2017;2017;07;17;Torstai;20;15;35
625;13.07.2017;2017;07;18;Torstai;10;7;17
625;13.07.2017;2017;07;19;Torstai;8;12;20
625;13.07.2017;2017;07;20;Torstai;9;4;13
625;13.07.2017;2017;07;21;Torstai;8;5;13
625;13.07.2017;2017;07;22;Torstai;4;7;11
625;13.07.2017;2017;07;23;Torstai;4;3;7
625;14.07.2017;2017;07;00;Perjantai;0;1;1
625;14.07.2017;2017;07;01;Perjantai;2;3;5
625;14.07.2017;2017;07;02;Perjantai;1;1;2
625;14.07.2017;2017;07;03;Perjantai;1;0;1
625;14.07.2017;2017;07;04;Perjantai;0;0;0
625;14.07.2017;2017;07;05;Perjantai;2;1;3
625;14.07.2017;2017;07;06;Perjantai;2;2;4
625;14.07.2017;2017;07;07;Perjantai;10;4;14
625;14.07.2017;2017;07;08;Perjantai;8;9;17
625;14.07.2017;2017;07;09;Perjantai;8;4;12
625;14.07.2017;2017;07;10;Perjantai;4;3;7
625;14.07.2017;2017;07;11;Perjantai;2;3;5
625;14.07.2017;2017;07;12;Perjantai;2;4;6
625;14.07.2017;2017;07;13;Perjantai;3;4;7
625;14.07.2017;2017;07;14;Perjantai;0;0;0
625;14.07.2017;2017;07;15;Perjantai;1;2;3
625;14.07.2017;2017;07;16;Perjantai;10;9;19
625;14.07.2017;2017;07;17;Perjantai;15;18;33
625;14.07.2017;2017;07;18;Perjantai;5;10;15
625;14.07.2017;2017;07;19;Perjantai;16;9;25
625;14.07.2017;2017;07;20;Perjantai;6;12;18
625;14.07.2017;2017;07;21;Perjantai;9;9;18
625;14.07.2017;2017;07;22;Perjantai;3;4;7
625;14.07.2017;2017;07;23;Perjantai;2;4;6
625;15.07.2017;2017;07;00;Lauantai;2;2;4
625;15.07.2017;2017;07;01;Lauantai;3;1;4
625;15.07.2017;2017;07;02;Lauantai;0;1;1
625;15.07.2017;2017;07;03;Lauantai;0;1;1
625;15.07.2017;2017;07;04;Lauantai;2;0;2
625;15.07.2017;2017;07;05;Lauantai;1;0;1
625;15.07.2017;2017;07;06;Lauantai;0;0;0
625;15.07.2017;2017;07;07;Lauantai;1;0;1
625;15.07.2017;2017;07;08;Lauantai;2;2;4
625;15.07.2017;2017;07;09;Lauantai;6;3;9
625;15.07.2017;2017;07;10;Lauantai;3;7;10
625;15.07.2017;2017;07;11;Lauantai;6;8;14
625;15.07.2017;2017;07;12;Lauantai;8;14;22
625;15.07.2017;2017;07;13;Lauantai;6;10;16
625;15.07.2017;2017;07;14;Lauantai;7;15;22
625;15.07.2017;2017;07;15;Lauantai;13;22;35
625;15.07.2017;2017;07;16;Lauantai;12;13;25
625;15.07.2017;2017;07;17;Lauantai;11;14;25
625;15.07.2017;2017;07;18;Lauantai;4;11;15
625;15.07.2017;2017;07;19;Lauantai;4;16;20
625;15.07.2017;2017;07;20;Lauantai;7;9;16
625;15.07.2017;2017;07;21;Lauantai;4;7;11
625;15.07.2017;2017;07;22;Lauantai;6;4;10
625;15.07.2017;2017;07;23;Lauantai;4;5;9
625;16.07.2017;2017;07;00;Sunnuntai;4;2;6
625;16.07.2017;2017;07;01;Sunnuntai;4;2;6
625;16.07.2017;2017;07;02;Sunnuntai;1;1;2
625;16.07.2017;2017;07;03;Sunnuntai;0;1;1
625;16.07.2017;2017;07;04;Sunnuntai;1;1;2
625;16.07.2017;2017;07;05;Sunnuntai;0;0;0
625;16.07.2017;2017;07;06;Sunnuntai;0;1;1
625;16.07.2017;2017;07;07;Sunnuntai;3;1;4
625;16.07.2017;2017;07;08;Sunnuntai;0;2;2
625;16.07.2017;2017;07;09;Sunnuntai;1;1;2
625;16.07.2017;2017;07;10;Sunnuntai;8;9;17
625;16.07.2017;2017;07;11;Sunnuntai;8;8;16
625;16.07.2017;2017;07;12;Sunnuntai;19;26;45
625;16.07.2017;2017;07;13;Sunnuntai;22;37;59
625;16.07.2017;2017;07;14;Sunnuntai;30;41;71
625;16.07.2017;2017;07;15;Sunnuntai;22;29;51
625;16.07.2017;2017;07;16;Sunnuntai;26;20;46
625;16.07.2017;2017;07;17;Sunnuntai;17;25;42
625;16.07.2017;2017;07;18;Sunnuntai;22;23;45
625;16.07.2017;2017;07;19;Sunnuntai;19;20;39
625;16.07.2017;2017;07;20;Sunnuntai;14;19;33
625;16.07.2017;2017;07;21;Sunnuntai;10;7;17
625;16.07.2017;2017;07;22;Sunnuntai;8;10;18
625;16.07.2017;2017;07;23;Sunnuntai;2;8;10
625;17.07.2017;2017;07;00;Maanantai;4;3;7
625;17.07.2017;2017;07;01;Maanantai;1;0;1
625;17.07.2017;2017;07;02;Maanantai;0;0;0
625;17.07.2017;2017;07;03;Maanantai;0;0;0
625;17.07.2017;2017;07;04;Maanantai;0;0;0
625;17.07.2017;2017;07;05;Maanantai;1;0;1
625;17.07.2017;2017;07;06;Maanantai;3;3;6
625;17.07.2017;2017;07;07;Maanantai;8;4;12
625;17.07.2017;2017;07;08;Maanantai;9;17;26
625;17.07.2017;2017;07;09;Maanantai;6;9;15
625;17.07.2017;2017;07;10;Maanantai;9;8;17
625;17.07.2017;2017;07;11;Maanantai;14;8;22
625;17.07.2017;2017;07;12;Maanantai;14;12;26
625;17.07.2017;2017;07;13;Maanantai;10;13;23
625;17.07.2017;2017;07;14;Maanantai;18;19;37
625;17.07.2017;2017;07;15;Maanantai;20;14;34
625;17.07.2017;2017;07;16;Maanantai;12;26;38
625;17.07.2017;2017;07;17;Maanantai;16;23;39
625;17.07.2017;2017;07;18;Maanantai;24;23;47
625;17.07.2017;2017;07;19;Maanantai;10;19;29
625;17.07.2017;2017;07;20;Maanantai;17;10;27
625;17.07.2017;2017;07;21;Maanantai;11;8;19
625;17.07.2017;2017;07;22;Maanantai;5;12;17
625;17.07.2017;2017;07;23;Maanantai;5;2;7
625;18.07.2017;2017;07;00;Tiistai;1;2;3
625;18.07.2017;2017;07;01;Tiistai;0;0;0
625;18.07.2017;2017;07;02;Tiistai;0;0;0
625;18.07.2017;2017;07;03;Tiistai;0;0;0
625;18.07.2017;2017;07;04;Tiistai;0;1;1
625;18.07.2017;2017;07;05;Tiistai;0;0;0
625;18.07.2017;2017;07;06;Tiistai;2;0;2
625;18.07.2017;2017;07;07;Tiistai;6;5;11
625;18.07.2017;2017;07;08;Tiistai;5;7;12
625;18.07.2017;2017;07;09;Tiistai;5;3;8
625;18.07.2017;2017;07;10;Tiistai;3;0;3
625;18.07.2017;2017;07;11;Tiistai;2;2;4
625;18.07.2017;2017;07;12;Tiistai;4;5;9
625;18.07.2017;2017;07;13;Tiistai;9;3;12
625;18.07.2017;2017;07;14;Tiistai;3;8;11
625;18.07.2017;2017;07;15;Tiistai;5;9;14
625;18.07.2017;2017;07;16;Tiistai;6;12;18
625;18.07.2017;2017;07;17;Tiistai;12;10;22
625;18.07.2017;2017;07;18;Tiistai;10;9;19
625;18.07.2017;2017;07;19;Tiistai;3;4;7
625;18.07.2017;2017;07;20;Tiistai;10;4;14
625;18.07.2017;2017;07;21;Tiistai;3;2;5
625;18.07.2017;2017;07;22;Tiistai;2;7;9
625;18.07.2017;2017;07;23;Tiistai;3;2;5
625;19.07.2017;2017;07;00;Keskiviikko;3;1;4
625;19.07.2017;2017;07;01;Keskiviikko;0;0;0
625;19.07.2017;2017;07;02;Keskiviikko;0;1;1
625;19.07.2017;2017;07;03;Keskiviikko;0;0;0
625;19.07.2017;2017;07;04;Keskiviikko;0;0;0
625;19.07.2017;2017;07;05;Keskiviikko;0;1;1
625;19.07.2017;2017;07;06;Keskiviikko;3;0;3
625;19.07.2017;2017;07;07;Keskiviikko;6;9;15
625;19.07.2017;2017;07;08;Keskiviikko;9;7;16
625;19.07.2017;2017;07;09;Keskiviikko;4;1;5
625;19.07.2017;2017;07;10;Keskiviikko;6;4;10
625;19.07.2017;2017;07;11;Keskiviikko;4;7;11
625;19.07.2017;2017;07;12;Keskiviikko;12;10;22
625;19.07.2017;2017;07;13;Keskiviikko;12;13;25
625;19.07.2017;2017;07;14;Keskiviikko;15;16;31
625;19.07.2017;2017;07;15;Keskiviikko;12;7;19
625;19.07.2017;2017;07;16;Keskiviikko;15;17;32
625;19.07.2017;2017;07;17;Keskiviikko;12;22;34
625;19.07.2017;2017;07;18;Keskiviikko;10;14;24
625;19.07.2017;2017;07;19;Keskiviikko;8;20;28
625;19.07.2017;2017;07;20;Keskiviikko;10;12;22
625;19.07.2017;2017;07;21;Keskiviikko;7;8;15
625;19.07.2017;2017;07;22;Keskiviikko;4;5;9
625;19.07.2017;2017;07;23;Keskiviikko;1;0;1
625;20.07.2017;2017;07;00;Torstai;2;0;2
625;20.07.2017;2017;07;01;Torstai;1;1;2
625;20.07.2017;2017;07;02;Torstai;4;3;7
625;20.07.2017;2017;07;03;Torstai;0;0;0
625;20.07.2017;2017;07;04;Torstai;1;0;1
625;20.07.2017;2017;07;05;Torstai;0;1;1
625;20.07.2017;2017;07;06;Torstai;4;1;5
625;20.07.2017;2017;07;07;Torstai;10;5;15
625;20.07.2017;2017;07;08;Torstai;4;8;12
625;20.07.2017;2017;07;09;Torstai;11;9;20
625;20.07.2017;2017;07;10;Torstai;6;7;13
625;20.07.2017;2017;07;11;Torstai;7;3;10
625;20.07.2017;2017;07;12;Torstai;13;16;29
625;20.07.2017;2017;07;13;Torstai;13;11;24
625;20.07.2017;2017;07;14;Torstai;11;6;17
625;20.07.2017;2017;07;15;Torstai;13;10;23
625;20.07.2017;2017;07;16;Torstai;14;16;30
625;20.07.2017;2017;07;17;Torstai;13;28;41
625;20.07.2017;2017;07;18;Torstai;14;15;29
625;20.07.2017;2017;07;19;Torstai;7;14;21
625;20.07.2017;2017;07;20;Torstai;11;21;32
625;20.07.2017;2017;07;21;Torstai;11;4;15
625;20.07.2017;2017;07;22;Torstai;7;9;16
625;20.07.2017;2017;07;23;Torstai;3;1;4
625;21.07.2017;2017;07;00;Perjantai;2;4;6
625;21.07.2017;2017;07;01;Perjantai;0;1;1
625;21.07.2017;2017;07;02;Perjantai;0;1;1
625;21.07.2017;2017;07;03;Perjantai;0;0;0
625;21.07.2017;2017;07;04;Perjantai;0;0;0
625;21.07.2017;2017;07;05;Perjantai;0;1;1
625;21.07.2017;2017;07;06;Perjantai;4;1;5
625;21.07.2017;2017;07;07;Perjantai;10;3;13
625;21.07.2017;2017;07;08;Perjantai;12;11;23
625;21.07.2017;2017;07;09;Perjantai;7;6;13
625;21.07.2017;2017;07;10;Perjantai;7;5;12
625;21.07.2017;2017;07;11;Perjantai;6;7;13
625;21.07.2017;2017;07;12;Perjantai;5;13;18
625;21.07.2017;2017;07;13;Perjantai;17;13;30
625;21.07.2017;2017;07;14;Perjantai;12;11;23
625;21.07.2017;2017;07;15;Perjantai;16;19;35
625;21.07.2017;2017;07;16;Perjantai;11;6;17
625;21.07.2017;2017;07;17;Perjantai;15;23;38
625;21.07.2017;2017;07;18;Perjantai;5;10;15
625;21.07.2017;2017;07;19;Perjantai;8;7;15
625;21.07.2017;2017;07;20;Perjantai;11;8;19
625;21.07.2017;2017;07;21;Perjantai;13;9;22
625;21.07.2017;2017;07;22;Perjantai;4;4;8
625;21.07.2017;2017;07;23;Perjantai;4;3;7
625;22.07.2017;2017;07;00;Lauantai;0;3;3
625;22.07.2017;2017;07;01;Lauantai;3;2;5
625;22.07.2017;2017;07;02;Lauantai;0;1;1
625;22.07.2017;2017;07;03;Lauantai;2;0;2
625;22.07.2017;2017;07;04;Lauantai;0;0;0
625;22.07.2017;2017;07;05;Lauantai;1;1;2
625;22.07.2017;2017;07;06;Lauantai;0;0;0
625;22.07.2017;2017;07;07;Lauantai;2;0;2
625;22.07.2017;2017;07;08;Lauantai;2;1;3
625;22.07.2017;2017;07;09;Lauantai;0;1;1
625;22.07.2017;2017;07;10;Lauantai;5;3;8
625;22.07.2017;2017;07;11;Lauantai;4;3;7
625;22.07.2017;2017;07;12;Lauantai;14;8;22
625;22.07.2017;2017;07;13;Lauantai;10;5;15
625;22.07.2017;2017;07;14;Lauantai;11;8;19
625;22.07.2017;2017;07;15;Lauantai;8;21;29
625;22.07.2017;2017;07;16;Lauantai;9;6;15
625;22.07.2017;2017;07;17;Lauantai;5;9;14
625;22.07.2017;2017;07;18;Lauantai;15;13;28
625;22.07.2017;2017;07;19;Lauantai;4;8;12
625;22.07.2017;2017;07;20;Lauantai;3;9;12
625;22.07.2017;2017;07;21;Lauantai;6;11;17
625;22.07.2017;2017;07;22;Lauantai;4;2;6
625;22.07.2017;2017;07;23;Lauantai;8;11;19
625;23.07.2017;2017;07;00;Sunnuntai;2;2;4
625;23.07.2017;2017;07;01;Sunnuntai;2;2;4
625;23.07.2017;2017;07;02;Sunnuntai;3;1;4
625;23.07.2017;2017;07;03;Sunnuntai;3;1;4
625;23.07.2017;2017;07;04;Sunnuntai;2;0;2
625;23.07.2017;2017;07;05;Sunnuntai;0;1;1
625;23.07.2017;2017;07;06;Sunnuntai;0;0;0
625;23.07.2017;2017;07;07;Sunnuntai;0;1;1
625;23.07.2017;2017;07;08;Sunnuntai;0;2;2
625;23.07.2017;2017;07;09;Sunnuntai;3;3;6
625;23.07.2017;2017;07;10;Sunnuntai;5;5;10
625;23.07.2017;2017;07;11;Sunnuntai;9;3;12
625;23.07.2017;2017;07;12;Sunnuntai;17;12;29
625;23.07.2017;2017;07;13;Sunnuntai;21;15;36
625;23.07.2017;2017;07;14;Sunnuntai;14;13;27
625;23.07.2017;2017;07;15;Sunnuntai;9;16;25
625;23.07.2017;2017;07;16;Sunnuntai;2;4;6
625;23.07.2017;2017;07;17;Sunnuntai;3;2;5
625;23.07.2017;2017;07;18;Sunnuntai;4;2;6
625;23.07.2017;2017;07;19;Sunnuntai;7;7;14
625;23.07.2017;2017;07;20;Sunnuntai;4;3;7
625;23.07.2017;2017;07;21;Sunnuntai;5;5;10
625;23.07.2017;2017;07;22;Sunnuntai;0;3;3
625;23.07.2017;2017;07;23;Sunnuntai;3;4;7
625;24.07.2017;2017;07;00;Maanantai;4;3;7
625;24.07.2017;2017;07;01;Maanantai;1;0;1
625;24.07.2017;2017;07;02;Maanantai;0;0;0
625;24.07.2017;2017;07;03;Maanantai;0;0;0
625;24.07.2017;2017;07;04;Maanantai;0;0;0
625;24.07.2017;2017;07;05;Maanantai;1;0;1
625;24.07.2017;2017;07;06;Maanantai;3;3;6
625;24.07.2017;2017;07;07;Maanantai;8;4;12
625;24.07.2017;2017;07;08;Maanantai;9;17;26
625;24.07.2017;2017;07;09;Maanantai;6;9;15
625;24.07.2017;2017;07;10;Maanantai;9;8;17
625;24.07.2017;2017;07;11;Maanantai;14;8;22
625;24.07.2017;2017;07;12;Maanantai;14;12;26
625;24.07.2017;2017;07;13;Maanantai;10;13;23
625;24.07.2017;2017;07;14;Maanantai;18;19;37
625;24.07.2017;2017;07;15;Maanantai;20;14;34
625;24.07.2017;2017;07;16;Maanantai;12;26;38
625;24.07.2017;2017;07;17;Maanantai;16;23;39
625;24.07.2017;2017;07;18;Maanantai;24;23;47
625;24.07.2017;2017;07;19;Maanantai;10;19;29
625;24.07.2017;2017;07;20;Maanantai;17;10;27
625;24.07.2017;2017;07;21;Maanantai;11;8;19
625;24.07.2017;2017;07;22;Maanantai;5;12;17
625;24.07.2017;2017;07;23;Maanantai;5;2;7
625;25.07.2017;2017;07;00;Tiistai;5;1;6
625;25.07.2017;2017;07;01;Tiistai;2;2;4
625;25.07.2017;2017;07;02;Tiistai;0;0;0
625;25.07.2017;2017;07;03;Tiistai;1;2;3
625;25.07.2017;2017;07;04;Tiistai;0;0;0
625;25.07.2017;2017;07;05;Tiistai;0;0;0
625;25.07.2017;2017;07;06;Tiistai;5;6;11
625;25.07.2017;2017;07;07;Tiistai;20;7;27
625;25.07.2017;2017;07;08;Tiistai;15;17;32
625;25.07.2017;2017;07;09;Tiistai;15;6;21
625;25.07.2017;2017;07;10;Tiistai;9;7;16
625;25.07.2017;2017;07;11;Tiistai;8;10;18
625;25.07.2017;2017;07;12;Tiistai;9;17;26
625;25.07.2017;2017;07;13;Tiistai;13;23;36
625;25.07.2017;2017;07;14;Tiistai;24;23;47
625;25.07.2017;2017;07;15;Tiistai;21;27;48
625;25.07.2017;2017;07;16;Tiistai;26;40;66
625;25.07.2017;2017;07;17;Tiistai;22;33;55
625;25.07.2017;2017;07;18;Tiistai;31;32;63
625;25.07.2017;2017;07;19;Tiistai;30;22;52
625;25.07.2017;2017;07;20;Tiistai;18;20;38
625;25.07.2017;2017;07;21;Tiistai;18;30;48
625;25.07.2017;2017;07;22;Tiistai;15;18;33
625;25.07.2017;2017;07;23;Tiistai;7;5;12
625;26.07.2017;2017;07;00;Keskiviikko;5;1;6
625;26.07.2017;2017;07;01;Keskiviikko;2;2;4
625;26.07.2017;2017;07;02;Keskiviikko;0;0;0
625;26.07.2017;2017;07;03;Keskiviikko;1;2;3
625;26.07.2017;2017;07;04;Keskiviikko;0;0;0
625;26.07.2017;2017;07;05;Keskiviikko;0;0;0
625;26.07.2017;2017;07;06;Keskiviikko;5;6;11
625;26.07.2017;2017;07;07;Keskiviikko;20;7;27
625;26.07.2017;2017;07;08;Keskiviikko;15;17;32
625;26.07.2017;2017;07;09;Keskiviikko;15;6;21
625;26.07.2017;2017;07;10;Keskiviikko;9;7;16
625;26.07.2017;2017;07;11;Keskiviikko;8;7;15
625;26.07.2017;2017;07;12;Keskiviikko;9;17;26
625;26.07.2017;2017;07;13;Keskiviikko;13;23;36
625;26.07.2017;2017;07;14;Keskiviikko;24;23;47
625;26.07.2017;2017;07;15;Keskiviikko;27;36;63
625;26.07.2017;2017;07;16;Keskiviikko;33;34;67
625;26.07.2017;2017;07;17;Keskiviikko;40;54;94
625;26.07.2017;2017;07;18;Keskiviikko;22;30;52
625;26.07.2017;2017;07;19;Keskiviikko;32;19;51
625;26.07.2017;2017;07;20;Keskiviikko;24;27;51
625;26.07.2017;2017;07;21;Keskiviikko;22;22;44
625;26.07.2017;2017;07;22;Keskiviikko;12;21;33
625;26.07.2017;2017;07;23;Keskiviikko;5;8;13
625;27.07.2017;2017;07;00;Torstai;5;1;6
625;27.07.2017;2017;07;01;Torstai;2;2;4
625;27.07.2017;2017;07;02;Torstai;0;0;0
625;27.07.2017;2017;07;03;Torstai;1;2;3
625;27.07.2017;2017;07;04;Torstai;0;0;0
625;27.07.2017;2017;07;05;Torstai;0;0;0
625;27.07.2017;2017;07;06;Torstai;5;6;11
625;27.07.2017;2017;07;07;Torstai;20;7;27
625;27.07.2017;2017;07;08;Torstai;15;17;32
625;27.07.2017;2017;07;09;Torstai;15;6;21
625;27.07.2017;2017;07;10;Torstai;9;7;16
625;27.07.2017;2017;07;11;Torstai;8;10;18
625;27.07.2017;2017;07;12;Torstai;9;17;26
625;27.07.2017;2017;07;13;Torstai;13;23;36
625;27.07.2017;2017;07;14;Torstai;24;23;47
625;27.07.2017;2017;07;15;Torstai;21;27;48
625;27.07.2017;2017;07;16;Torstai;26;40;66
625;27.07.2017;2017;07;17;Torstai;22;33;55
625;27.07.2017;2017;07;18;Torstai;31;32;63
625;27.07.2017;2017;07;19;Torstai;30;22;52
625;27.07.2017;2017;07;20;Torstai;18;20;38
625;27.07.2017;2017;07;21;Torstai;18;30;48
625;27.07.2017;2017;07;22;Torstai;15;18;33
625;27.07.2017;2017;07;23;Torstai;7;5;12
625;28.07.2017;2017;07;00;Perjantai;6;3;9
625;28.07.2017;2017;07;01;Perjantai;2;1;3
625;28.07.2017;2017;07;02;Perjantai;0;0;0
625;28.07.2017;2017;07;03;Perjantai;0;0;0
625;28.07.2017;2017;07;04;Perjantai;1;1;2
625;28.07.2017;2017;07;05;Perjantai;2;0;2
625;28.07.2017;2017;07;06;Perjantai;3;0;3
625;28.07.2017;2017;07;07;Perjantai;13;4;17
625;28.07.2017;2017;07;08;Perjantai;16;12;28
625;28.07.2017;2017;07;09;Perjantai;18;6;24
625;28.07.2017;2017;07;10;Perjantai;6;16;22
625;28.07.2017;2017;07;11;Perjantai;12;21;33
625;28.07.2017;2017;07;12;Perjantai;17;12;29
625;28.07.2017;2017;07;13;Perjantai;37;24;61
625;28.07.2017;2017;07;14;Perjantai;13;31;44
625;28.07.2017;2017;07;15;Perjantai;22;27;49
625;28.07.2017;2017;07;16;Perjantai;15;27;42
625;28.07.2017;2017;07;17;Perjantai;19;28;47
625;28.07.2017;2017;07;18;Perjantai;8;27;35
625;28.07.2017;2017;07;19;Perjantai;13;23;36
625;28.07.2017;2017;07;20;Perjantai;14;19;33
625;28.07.2017;2017;07;21;Perjantai;11;9;20
625;28.07.2017;2017;07;22;Perjantai;13;6;19
625;28.07.2017;2017;07;23;Perjantai;6;1;7
625;29.07.2017;2017;07;00;Lauantai;5;4;9
625;29.07.2017;2017;07;01;Lauantai;5;2;7
625;29.07.2017;2017;07;02;Lauantai;6;3;9
625;29.07.2017;2017;07;03;Lauantai;3;0;3
625;29.07.2017;2017;07;04;Lauantai;5;1;6
625;29.07.2017;2017;07;05;Lauantai;2;0;2
625;29.07.2017;2017;07;06;Lauantai;3;0;3
625;29.07.2017;2017;07;07;Lauantai;3;0;3
625;29.07.2017;2017;07;08;Lauantai;2;3;5
625;29.07.2017;2017;07;09;Lauantai;2;3;5
625;29.07.2017;2017;07;10;Lauantai;8;4;12
625;29.07.2017;2017;07;11;Lauantai;7;5;12
625;29.07.2017;2017;07;12;Lauantai;7;8;15
625;29.07.2017;2017;07;13;Lauantai;11;19;30
625;29.07.2017;2017;07;14;Lauantai;7;10;17
625;29.07.2017;2017;07;15;Lauantai;2;14;16
625;29.07.2017;2017;07;16;Lauantai;12;5;17
625;29.07.2017;2017;07;17;Lauantai;3;10;13
625;29.07.2017;2017;07;18;Lauantai;5;7;12
625;29.07.2017;2017;07;19;Lauantai;9;14;23
625;29.07.2017;2017;07;20;Lauantai;9;11;20
625;29.07.2017;2017;07;21;Lauantai;15;14;29
625;29.07.2017;2017;07;22;Lauantai;7;10;17
625;29.07.2017;2017;07;23;Lauantai;5;5;10
625;30.07.2017;2017;07;00;Sunnuntai;4;0;4
625;30.07.2017;2017;07;01;Sunnuntai;2;3;5
625;30.07.2017;2017;07;02;Sunnuntai;2;1;3
625;30.07.2017;2017;07;03;Sunnuntai;4;2;6
625;30.07.2017;2017;07;04;Sunnuntai;4;4;8
625;30.07.2017;2017;07;05;Sunnuntai;2;1;3
625;30.07.2017;2017;07;06;Sunnuntai;4;0;4
625;30.07.2017;2017;07;07;Sunnuntai;2;1;3
625;30.07.2017;2017;07;08;Sunnuntai;0;3;3
625;30.07.2017;2017;07;09;Sunnuntai;1;5;6
625;30.07.2017;2017;07;10;Sunnuntai;4;8;12
625;30.07.2017;2017;07;11;Sunnuntai;15;10;25
625;30.07.2017;2017;07;12;Sunnuntai;28;24;52
625;30.07.2017;2017;07;13;Sunnuntai;19;28;47
625;30.07.2017;2017;07;14;Sunnuntai;29;35;64
625;30.07.2017;2017;07;15;Sunnuntai;23;24;47
625;30.07.2017;2017;07;16;Sunnuntai;19;47;66
625;30.07.2017;2017;07;17;Sunnuntai;16;26;42
625;30.07.2017;2017;07;18;Sunnuntai;21;24;45
625;30.07.2017;2017;07;19;Sunnuntai;14;18;32
625;30.07.2017;2017;07;20;Sunnuntai;31;27;58
625;30.07.2017;2017;07;21;Sunnuntai;10;15;25
625;30.07.2017;2017;07;22;Sunnuntai;17;11;28
625;30.07.2017;2017;07;23;Sunnuntai;2;12;14
625;31.07.2017;2017;07;00;Maanantai;4;3;7
625;31.07.2017;2017;07;01;Maanantai;0;4;4
625;31.07.2017;2017;07;02;Maanantai;0;0;0
625;31.07.2017;2017;07;03;Maanantai;0;1;1
625;31.07.2017;2017;07;04;Maanantai;0;0;0
625;31.07.2017;2017;07;05;Maanantai;1;2;3
625;31.07.2017;2017;07;06;Maanantai;6;3;9
625;31.07.2017;2017;07;07;Maanantai;18;6;24
625;31.07.2017;2017;07;08;Maanantai;17;21;38
625;31.07.2017;2017;07;09;Maanantai;15;10;25
625;31.07.2017;2017;07;10;Maanantai;6;6;12
625;31.07.2017;2017;07;11;Maanantai;4;4;8
625;31.07.2017;2017;07;12;Maanantai;17;6;23
625;31.07.2017;2017;07;13;Maanantai;13;10;23
625;31.07.2017;2017;07;14;Maanantai;17;33;50
625;31.07.2017;2017;07;15;Maanantai;12;22;34
625;31.07.2017;2017;07;16;Maanantai;23;34;57
625;31.07.2017;2017;07;17;Maanantai;34;36;70
625;31.07.2017;2017;07;18;Maanantai;28;48;76
625;31.07.2017;2017;07;19;Maanantai;16;21;37
625;31.07.2017;2017;07;20;Maanantai;29;20;49
625;31.07.2017;2017;07;21;Maanantai;9;10;19
625;31.07.2017;2017;07;22;Maanantai;5;9;14
625;31.07.2017;2017;07;23;Maanantai;12;6;18
625;01.08.2017;2017;08;00;Tiistai;3;4;7
625;01.08.2017;2017;08;01;Tiistai;0;0;0
625;01.08.2017;2017;08;02;Tiistai;1;1;2
625;01.08.2017;2017;08;03;Tiistai;0;0;0
625;01.08.2017;2017;08;04;Tiistai;1;1;2
625;01.08.2017;2017;08;05;Tiistai;1;0;1
625;01.08.2017;2017;08;06;Tiistai;1;2;3
625;01.08.2017;2017;08;07;Tiistai;16;4;20
625;01.08.2017;2017;08;08;Tiistai;17;15;32
625;01.08.2017;2017;08;09;Tiistai;21;19;40
625;01.08.2017;2017;08;10;Tiistai;7;8;15
625;01.08.2017;2017;08;11;Tiistai;9;7;16
625;01.08.2017;2017;08;12;Tiistai;10;12;22
625;01.08.2017;2017;08;13;Tiistai;19;21;40
625;01.08.2017;2017;08;14;Tiistai;14;22;36
625;01.08.2017;2017;08;15;Tiistai;18;26;44
625;01.08.2017;2017;08;16;Tiistai;29;41;70
625;01.08.2017;2017;08;17;Tiistai;41;47;88
625;01.08.2017;2017;08;18;Tiistai;21;24;45
625;01.08.2017;2017;08;19;Tiistai;23;22;45
625;01.08.2017;2017;08;20;Tiistai;18;26;44
625;01.08.2017;2017;08;21;Tiistai;16;6;22
625;01.08.2017;2017;08;22;Tiistai;11;16;27
625;01.08.2017;2017;08;23;Tiistai;15;12;27
625;02.08.2017;2017;08;00;Keskiviikko;1;2;3
625;02.08.2017;2017;08;01;Keskiviikko;0;0;0
625;02.08.2017;2017;08;02;Keskiviikko;1;0;1
625;02.08.2017;2017;08;03;Keskiviikko;0;0;0
625;02.08.2017;2017;08;04;Keskiviikko;0;2;2
625;02.08.2017;2017;08;05;Keskiviikko;2;0;2
625;02.08.2017;2017;08;06;Keskiviikko;3;3;6
625;02.08.2017;2017;08;07;Keskiviikko;19;7;26
625;02.08.2017;2017;08;08;Keskiviikko;24;32;56
625;02.08.2017;2017;08;09;Keskiviikko;22;15;37
625;02.08.2017;2017;08;10;Keskiviikko;7;13;20
625;02.08.2017;2017;08;11;Keskiviikko;8;10;18
625;02.08.2017;2017;08;12;Keskiviikko;12;12;24
625;02.08.2017;2017;08;13;Keskiviikko;32;33;65
625;02.08.2017;2017;08;14;Keskiviikko;20;21;41
625;02.08.2017;2017;08;15;Keskiviikko;27;27;54
625;02.08.2017;2017;08;16;Keskiviikko;42;45;87
625;02.08.2017;2017;08;17;Keskiviikko;29;43;72
625;02.08.2017;2017;08;18;Keskiviikko;24;34;58
625;02.08.2017;2017;08;19;Keskiviikko;19;23;42
625;02.08.2017;2017;08;20;Keskiviikko;13;14;27
625;02.08.2017;2017;08;21;Keskiviikko;8;14;22
625;02.08.2017;2017;08;22;Keskiviikko;13;13;26
625;02.08.2017;2017;08;23;Keskiviikko;6;5;11
625;03.08.2017;2017;08;00;Torstai;3;3;6
625;03.08.2017;2017;08;01;Torstai;2;1;3
625;03.08.2017;2017;08;02;Torstai;1;1;2
625;03.08.2017;2017;08;03;Torstai;0;0;0
625;03.08.2017;2017;08;04;Torstai;0;0;0
625;03.08.2017;2017;08;05;Torstai;0;1;1
625;03.08.2017;2017;08;06;Torstai;4;4;8
625;03.08.2017;2017;08;07;Torstai;16;3;19
625;03.08.2017;2017;08;08;Torstai;24;27;51
625;03.08.2017;2017;08;09;Torstai;12;15;27
625;03.08.2017;2017;08;10;Torstai;10;10;20
625;03.08.2017;2017;08;11;Torstai;8;8;16
625;03.08.2017;2017;08;12;Torstai;17;13;30
625;03.08.2017;2017;08;13;Torstai;12;16;28
625;03.08.2017;2017;08;14;Torstai;18;16;34
625;03.08.2017;2017;08;15;Torstai;18;27;45
625;03.08.2017;2017;08;16;Torstai;18;28;46
625;03.08.2017;2017;08;17;Torstai;36;42;78
625;03.08.2017;2017;08;18;Torstai;27;26;53
625;03.08.2017;2017;08;19;Torstai;14;15;29
625;03.08.2017;2017;08;20;Torstai;12;23;35
625;03.08.2017;2017;08;21;Torstai;6;17;23
625;03.08.2017;2017;08;22;Torstai;11;12;23
625;03.08.2017;2017;08;23;Torstai;5;4;9
625;04.08.2017;2017;08;00;Perjantai;3;3;6
625;04.08.2017;2017;08;01;Perjantai;3;2;5
625;04.08.2017;2017;08;02;Perjantai;0;0;0
625;04.08.2017;2017;08;03;Perjantai;0;0;0
625;04.08.2017;2017;08;04;Perjantai;1;0;1
625;04.08.2017;2017;08;05;Perjantai;0;0;0
625;04.08.2017;2017;08;06;Perjantai;4;4;8
625;04.08.2017;2017;08;07;Perjantai;16;5;21
625;04.08.2017;2017;08;08;Perjantai;23;18;41
625;04.08.2017;2017;08;09;Perjantai;20;15;35
625;04.08.2017;2017;08;10;Perjantai;16;10;26
625;04.08.2017;2017;08;11;Perjantai;12;14;26
625;04.08.2017;2017;08;12;Perjantai;10;11;21
625;04.08.2017;2017;08;13;Perjantai;14;20;34
625;04.08.2017;2017;08;14;Perjantai;15;19;34
625;04.08.2017;2017;08;15;Perjantai;15;23;38
625;04.08.2017;2017;08;16;Perjantai;18;24;42
625;04.08.2017;2017;08;17;Perjantai;35;25;60
625;04.08.2017;2017;08;18;Perjantai;8;10;18
625;04.08.2017;2017;08;19;Perjantai;17;21;38
625;04.08.2017;2017;08;20;Perjantai;9;15;24
625;04.08.2017;2017;08;21;Perjantai;9;10;19
625;04.08.2017;2017;08;22;Perjantai;6;13;19
625;04.08.2017;2017;08;23;Perjantai;3;9;12
625;05.08.2017;2017;08;00;Lauantai;3;7;10
625;05.08.2017;2017;08;01;Lauantai;6;3;9
625;05.08.2017;2017;08;02;Lauantai;3;1;4
625;05.08.2017;2017;08;03;Lauantai;0;2;2
625;05.08.2017;2017;08;04;Lauantai;2;0;2
625;05.08.2017;2017;08;05;Lauantai;2;0;2
625;05.08.2017;2017;08;06;Lauantai;2;5;7
625;05.08.2017;2017;08;07;Lauantai;5;1;6
625;05.08.2017;2017;08;08;Lauantai;1;4;5
625;05.08.2017;2017;08;09;Lauantai;1;0;1
625;05.08.2017;2017;08;10;Lauantai;2;4;6
625;05.08.2017;2017;08;11;Lauantai;6;4;10
625;05.08.2017;2017;08;12;Lauantai;6;7;13
625;05.08.2017;2017;08;13;Lauantai;12;13;25
625;05.08.2017;2017;08;14;Lauantai;6;12;18
625;05.08.2017;2017;08;15;Lauantai;2;9;11
625;05.08.2017;2017;08;16;Lauantai;7;10;17
625;05.08.2017;2017;08;17;Lauantai;12;9;21
625;05.08.2017;2017;08;18;Lauantai;13;7;20
625;05.08.2017;2017;08;19;Lauantai;9;10;19
625;05.08.2017;2017;08;20;Lauantai;3;5;8
625;05.08.2017;2017;08;21;Lauantai;3;9;12
625;05.08.2017;2017;08;22;Lauantai;2;2;4
625;05.08.2017;2017;08;23;Lauantai;1;3;4
625;06.08.2017;2017;08;00;Sunnuntai;0;3;3
625;06.08.2017;2017;08;01;Sunnuntai;2;1;3
625;06.08.2017;2017;08;02;Sunnuntai;0;1;1
625;06.08.2017;2017;08;03;Sunnuntai;1;2;3
625;06.08.2017;2017;08;04;Sunnuntai;0;0;0
625;06.08.2017;2017;08;05;Sunnuntai;0;0;0
625;06.08.2017;2017;08;06;Sunnuntai;1;2;3
625;06.08.2017;2017;08;07;Sunnuntai;2;4;6
625;06.08.2017;2017;08;08;Sunnuntai;2;5;7
625;06.08.2017;2017;08;09;Sunnuntai;0;0;0
625;06.08.2017;2017;08;10;Sunnuntai;6;2;8
625;06.08.2017;2017;08;11;Sunnuntai;15;15;30
625;06.08.2017;2017;08;12;Sunnuntai;4;9;13
625;06.08.2017;2017;08;13;Sunnuntai;8;9;17
625;06.08.2017;2017;08;14;Sunnuntai;22;11;33
625;06.08.2017;2017;08;15;Sunnuntai;10;8;18
625;06.08.2017;2017;08;16;Sunnuntai;15;19;34
625;06.08.2017;2017;08;17;Sunnuntai;12;8;20
625;06.08.2017;2017;08;18;Sunnuntai;9;15;24
625;06.08.2017;2017;08;19;Sunnuntai;5;6;11
625;06.08.2017;2017;08;20;Sunnuntai;11;11;22
625;06.08.2017;2017;08;21;Sunnuntai;6;11;17
625;06.08.2017;2017;08;22;Sunnuntai;6;4;10
625;06.08.2017;2017;08;23;Sunnuntai;0;2;2
625;07.08.2017;2017;08;00;Maanantai;4;2;6
625;07.08.2017;2017;08;01;Maanantai;0;1;1
625;07.08.2017;2017;08;02;Maanantai;0;0;0
625;07.08.2017;2017;08;03;Maanantai;1;0;1
625;07.08.2017;2017;08;04;Maanantai;0;0;0
625;07.08.2017;2017;08;05;Maanantai;1;0;1
625;07.08.2017;2017;08;06;Maanantai;3;6;9
625;07.08.2017;2017;08;07;Maanantai;17;13;30
625;07.08.2017;2017;08;08;Maanantai;25;20;45
625;07.08.2017;2017;08;09;Maanantai;13;21;34
625;07.08.2017;2017;08;10;Maanantai;14;7;21
625;07.08.2017;2017;08;11;Maanantai;17;11;28
625;07.08.2017;2017;08;12;Maanantai;11;11;22
625;07.08.2017;2017;08;13;Maanantai;19;15;34
625;07.08.2017;2017;08;14;Maanantai;14;18;32
625;07.08.2017;2017;08;15;Maanantai;20;14;34
625;07.08.2017;2017;08;16;Maanantai;20;29;49
625;07.08.2017;2017;08;17;Maanantai;30;40;70
625;07.08.2017;2017;08;18;Maanantai;13;26;39
625;07.08.2017;2017;08;19;Maanantai;24;23;47
625;07.08.2017;2017;08;20;Maanantai;17;21;38
625;07.08.2017;2017;08;21;Maanantai;9;11;20
625;07.08.2017;2017;08;22;Maanantai;7;6;13
625;07.08.2017;2017;08;23;Maanantai;4;5;9
625;08.08.2017;2017;08;00;Tiistai;2;1;3
625;08.08.2017;2017;08;01;Tiistai;1;1;2
625;08.08.2017;2017;08;02;Tiistai;0;0;0
625;08.08.2017;2017;08;03;Tiistai;1;0;1
625;08.08.2017;2017;08;04;Tiistai;0;1;1
625;08.08.2017;2017;08;05;Tiistai;1;1;2
625;08.08.2017;2017;08;06;Tiistai;5;4;9
625;08.08.2017;2017;08;07;Tiistai;19;12;31
625;08.08.2017;2017;08;08;Tiistai;29;28;57
625;08.08.2017;2017;08;09;Tiistai;20;24;44
625;08.08.2017;2017;08;10;Tiistai;11;14;25
625;08.08.2017;2017;08;11;Tiistai;10;9;19
625;08.08.2017;2017;08;12;Tiistai;21;14;35
625;08.08.2017;2017;08;13;Tiistai;16;18;34
625;08.08.2017;2017;08;14;Tiistai;15;20;35
625;08.08.2017;2017;08;15;Tiistai;19;20;39
625;08.08.2017;2017;08;16;Tiistai;24;38;62
625;08.08.2017;2017;08;17;Tiistai;52;44;96
625;08.08.2017;2017;08;18;Tiistai;35;37;72
625;08.08.2017;2017;08;19;Tiistai;21;18;39
625;08.08.2017;2017;08;20;Tiistai;12;19;31
625;08.08.2017;2017;08;21;Tiistai;15;16;31
625;08.08.2017;2017;08;22;Tiistai;8;7;15
625;08.08.2017;2017;08;23;Tiistai;5;3;8
625;09.08.2017;2017;08;00;Keskiviikko;0;0;0
625;09.08.2017;2017;08;01;Keskiviikko;0;1;1
625;09.08.2017;2017;08;02;Keskiviikko;0;1;1
625;09.08.2017;2017;08;03;Keskiviikko;1;0;1
625;09.08.2017;2017;08;04;Keskiviikko;0;0;0
625;09.08.2017;2017;08;05;Keskiviikko;0;1;1
625;09.08.2017;2017;08;06;Keskiviikko;3;2;5
625;09.08.2017;2017;08;07;Keskiviikko;23;14;37
625;09.08.2017;2017;08;08;Keskiviikko;31;27;58
625;09.08.2017;2017;08;09;Keskiviikko;21;20;41
625;09.08.2017;2017;08;10;Keskiviikko;12;11;23
625;09.08.2017;2017;08;11;Keskiviikko;11;6;17
625;09.08.2017;2017;08;12;Keskiviikko;20;24;44
625;09.08.2017;2017;08;13;Keskiviikko;10;19;29
625;09.08.2017;2017;08;14;Keskiviikko;21;22;43
625;09.08.2017;2017;08;15;Keskiviikko;17;27;44
625;09.08.2017;2017;08;16;Keskiviikko;30;37;67
625;09.08.2017;2017;08;17;Keskiviikko;38;47;85
625;09.08.2017;2017;08;18;Keskiviikko;21;23;44
625;09.08.2017;2017;08;19;Keskiviikko;19;29;48
625;09.08.2017;2017;08;20;Keskiviikko;15;23;38
625;09.08.2017;2017;08;21;Keskiviikko;17;14;31
625;09.08.2017;2017;08;22;Keskiviikko;11;16;27
625;09.08.2017;2017;08;23;Keskiviikko;7;2;9
625;10.08.2017;2017;08;00;Torstai;3;0;3
625;10.08.2017;2017;08;01;Torstai;0;0;0
625;10.08.2017;2017;08;02;Torstai;0;0;0
625;10.08.2017;2017;08;03;Torstai;1;0;1
625;10.08.2017;2017;08;04;Torstai;0;0;0
625;10.08.2017;2017;08;05;Torstai;0;1;1
625;10.08.2017;2017;08;06;Torstai;2;1;3
625;10.08.2017;2017;08;07;Torstai;16;10;26
625;10.08.2017;2017;08;08;Torstai;33;23;56
625;10.08.2017;2017;08;09;Torstai;77;36;113
625;10.08.2017;2017;08;10;Torstai;67;27;94
625;10.08.2017;2017;08;11;Torstai;8;11;19
625;10.08.2017;2017;08;12;Torstai;6;10;16
625;10.08.2017;2017;08;13;Torstai;15;41;56
625;10.08.2017;2017;08;14;Torstai;8;26;34
625;10.08.2017;2017;08;15;Torstai;10;36;46
625;10.08.2017;2017;08;16;Torstai;14;27;41
625;10.08.2017;2017;08;17;Torstai;24;31;55
625;10.08.2017;2017;08;18;Torstai;6;18;24
625;10.08.2017;2017;08;19;Torstai;11;15;26
625;10.08.2017;2017;08;20;Torstai;7;7;14
625;10.08.2017;2017;08;21;Torstai;4;5;9
625;10.08.2017;2017;08;22;Torstai;5;7;12
625;10.08.2017;2017;08;23;Torstai;9;0;9
625;11.08.2017;2017;08;00;Perjantai;2;0;2
625;11.08.2017;2017;08;01;Perjantai;1;0;1
625;11.08.2017;2017;08;02;Perjantai;0;0;0
625;11.08.2017;2017;08;03;Perjantai;0;0;0
625;11.08.2017;2017;08;04;Perjantai;0;1;1
625;11.08.2017;2017;08;05;Perjantai;0;0;0
625;11.08.2017;2017;08;06;Perjantai;3;1;4
625;11.08.2017;2017;08;07;Perjantai;18;10;28
625;11.08.2017;2017;08;08;Perjantai;38;26;64
625;11.08.2017;2017;08;09;Perjantai;84;34;118
625;11.08.2017;2017;08;10;Perjantai;47;28;75
625;11.08.2017;2017;08;11;Perjantai;16;18;34
625;11.08.2017;2017;08;12;Perjantai;13;15;28
625;11.08.2017;2017;08;13;Perjantai;25;69;94
625;11.08.2017;2017;08;14;Perjantai;29;25;54
625;11.08.2017;2017;08;15;Perjantai;17;42;59
625;11.08.2017;2017;08;16;Perjantai;28;36;64
625;11.08.2017;2017;08;17;Perjantai;28;46;74
625;11.08.2017;2017;08;18;Perjantai;17;26;43
625;11.08.2017;2017;08;19;Perjantai;19;18;37
625;11.08.2017;2017;08;20;Perjantai;18;18;36
625;11.08.2017;2017;08;21;Perjantai;9;13;22
625;11.08.2017;2017;08;22;Perjantai;4;16;20
625;11.08.2017;2017;08;23;Perjantai;3;6;9
625;12.08.2017;2017;08;00;Lauantai;2;3;5
625;12.08.2017;2017;08;01;Lauantai;4;2;6
625;12.08.2017;2017;08;02;Lauantai;0;1;1
625;12.08.2017;2017;08;03;Lauantai;2;2;4
625;12.08.2017;2017;08;04;Lauantai;3;0;3
625;12.08.2017;2017;08;05;Lauantai;0;1;1
625;12.08.2017;2017;08;06;Lauantai;0;1;1
625;12.08.2017;2017;08;07;Lauantai;1;2;3
625;12.08.2017;2017;08;08;Lauantai;2;3;5
625;12.08.2017;2017;08;09;Lauantai;4;4;8
625;12.08.2017;2017;08;10;Lauantai;5;6;11
625;12.08.2017;2017;08;11;Lauantai;17;8;25
625;12.08.2017;2017;08;12;Lauantai;15;21;36
625;12.08.2017;2017;08;13;Lauantai;18;26;44
625;12.08.2017;2017;08;14;Lauantai;21;27;48
625;12.08.2017;2017;08;15;Lauantai;24;34;58
625;12.08.2017;2017;08;16;Lauantai;10;22;32
625;12.08.2017;2017;08;17;Lauantai;18;19;37
625;12.08.2017;2017;08;18;Lauantai;21;25;46
625;12.08.2017;2017;08;19;Lauantai;12;15;27
625;12.08.2017;2017;08;20;Lauantai;19;13;32
625;12.08.2017;2017;08;21;Lauantai;3;9;12
625;12.08.2017;2017;08;22;Lauantai;5;5;10
625;12.08.2017;2017;08;23;Lauantai;2;4;6
625;13.08.2017;2017;08;00;Sunnuntai;3;5;8
625;13.08.2017;2017;08;01;Sunnuntai;1;2;3
625;13.08.2017;2017;08;02;Sunnuntai;1;1;2
625;13.08.2017;2017;08;03;Sunnuntai;2;0;2
625;13.08.2017;2017;08;04;Sunnuntai;3;0;3
625;13.08.2017;2017;08;05;Sunnuntai;0;0;0
625;13.08.2017;2017;08;06;Sunnuntai;1;0;1
625;13.08.2017;2017;08;07;Sunnuntai;1;1;2
625;13.08.2017;2017;08;08;Sunnuntai;3;1;4
625;13.08.2017;2017;08;09;Sunnuntai;0;3;3
625;13.08.2017;2017;08;10;Sunnuntai;5;2;7
625;13.08.2017;2017;08;11;Sunnuntai;1;5;6
625;13.08.2017;2017;08;12;Sunnuntai;3;4;7
625;13.08.2017;2017;08;13;Sunnuntai;4;4;8
625;13.08.2017;2017;08;14;Sunnuntai;7;4;11
625;13.08.2017;2017;08;15;Sunnuntai;1;9;10
625;13.08.2017;2017;08;16;Sunnuntai;7;3;10
625;13.08.2017;2017;08;17;Sunnuntai;3;2;5
625;13.08.2017;2017;08;18;Sunnuntai;7;9;16
625;13.08.2017;2017;08;19;Sunnuntai;4;8;12
625;13.08.2017;2017;08;20;Sunnuntai;14;7;21
625;13.08.2017;2017;08;21;Sunnuntai;2;9;11
625;13.08.2017;2017;08;22;Sunnuntai;2;6;8
625;13.08.2017;2017;08;23;Sunnuntai;3;1;4
625;14.08.2017;2017;08;00;Maanantai;2;1;3
625;14.08.2017;2017;08;01;Maanantai;0;0;0
625;14.08.2017;2017;08;02;Maanantai;1;0;1
625;14.08.2017;2017;08;03;Maanantai;1;0;1
625;14.08.2017;2017;08;04;Maanantai;1;0;1
625;14.08.2017;2017;08;05;Maanantai;0;1;1
625;14.08.2017;2017;08;06;Maanantai;4;1;5
625;14.08.2017;2017;08;07;Maanantai;17;9;26
625;14.08.2017;2017;08;08;Maanantai;94;48;142
625;14.08.2017;2017;08;09;Maanantai;63;30;93
625;14.08.2017;2017;08;10;Maanantai;32;19;51
625;14.08.2017;2017;08;11;Maanantai;16;15;31
625;14.08.2017;2017;08;12;Maanantai;9;11;20
625;14.08.2017;2017;08;13;Maanantai;17;19;36
625;14.08.2017;2017;08;14;Maanantai;13;38;51
625;14.08.2017;2017;08;15;Maanantai;19;50;69
625;14.08.2017;2017;08;16;Maanantai;37;69;106
625;14.08.2017;2017;08;17;Maanantai;36;62;98
625;14.08.2017;2017;08;18;Maanantai;28;29;57
625;14.08.2017;2017;08;19;Maanantai;18;16;34
625;14.08.2017;2017;08;20;Maanantai;12;18;30
625;14.08.2017;2017;08;21;Maanantai;15;15;30
625;14.08.2017;2017;08;22;Maanantai;8;6;14
625;14.08.2017;2017;08;23;Maanantai;7;6;13
625;15.08.2017;2017;08;00;Tiistai;4;1;5
625;15.08.2017;2017;08;01;Tiistai;0;0;0
625;15.08.2017;2017;08;02;Tiistai;0;0;0
625;15.08.2017;2017;08;03;Tiistai;0;0;0
625;15.08.2017;2017;08;04;Tiistai;1;0;1
625;15.08.2017;2017;08;05;Tiistai;0;1;1
625;15.08.2017;2017;08;06;Tiistai;2;5;7
625;15.08.2017;2017;08;07;Tiistai;20;14;34
625;15.08.2017;2017;08;08;Tiistai;85;42;127
625;15.08.2017;2017;08;09;Tiistai;55;28;83
625;15.08.2017;2017;08;10;Tiistai;25;20;45
625;15.08.2017;2017;08;11;Tiistai;19;7;26
625;15.08.2017;2017;08;12;Tiistai;13;22;35
625;15.08.2017;2017;08;13;Tiistai;12;20;32
625;15.08.2017;2017;08;14;Tiistai;13;37;50
625;15.08.2017;2017;08;15;Tiistai;32;66;98
625;15.08.2017;2017;08;16;Tiistai;36;83;119
625;15.08.2017;2017;08;17;Tiistai;42;64;106
625;15.08.2017;2017;08;18;Tiistai;23;34;57
625;15.08.2017;2017;08;19;Tiistai;14;26;40
625;15.08.2017;2017;08;20;Tiistai;12;16;28
625;15.08.2017;2017;08;21;Tiistai;8;12;20
625;15.08.2017;2017;08;22;Tiistai;6;9;15
625;15.08.2017;2017;08;23;Tiistai;6;3;9
625;16.08.2017;2017;08;00;Keskiviikko;0;1;1
625;16.08.2017;2017;08;01;Keskiviikko;1;1;2
625;16.08.2017;2017;08;02;Keskiviikko;0;0;0
625;16.08.2017;2017;08;03;Keskiviikko;0;0;0
625;16.08.2017;2017;08;04;Keskiviikko;0;0;0
625;16.08.2017;2017;08;05;Keskiviikko;1;1;2
625;16.08.2017;2017;08;06;Keskiviikko;2;3;5
625;16.08.2017;2017;08;07;Keskiviikko;19;7;26
625;16.08.2017;2017;08;08;Keskiviikko;120;67;187
625;16.08.2017;2017;08;09;Keskiviikko;47;29;76
625;16.08.2017;2017;08;10;Keskiviikko;21;12;33
625;16.08.2017;2017;08;11;Keskiviikko;19;20;39
625;16.08.2017;2017;08;12;Keskiviikko;13;12;25
625;16.08.2017;2017;08;13;Keskiviikko;19;37;56
625;16.08.2017;2017;08;14;Keskiviikko;14;50;64
625;16.08.2017;2017;08;15;Keskiviikko;29;56;85
625;16.08.2017;2017;08;16;Keskiviikko;31;46;77
625;16.08.2017;2017;08;17;Keskiviikko;41;62;103
625;16.08.2017;2017;08;18;Keskiviikko;23;25;48
625;16.08.2017;2017;08;19;Keskiviikko;22;21;43
625;16.08.2017;2017;08;20;Keskiviikko;17;26;43
625;16.08.2017;2017;08;21;Keskiviikko;7;19;26
625;16.08.2017;2017;08;22;Keskiviikko;11;11;22
625;16.08.2017;2017;08;23;Keskiviikko;5;4;9
625;17.08.2017;2017;08;00;Torstai;0;1;1
625;17.08.2017;2017;08;01;Torstai;0;0;0
625;17.08.2017;2017;08;02;Torstai;0;0;0
625;17.08.2017;2017;08;03;Torstai;0;0;0
625;17.08.2017;2017;08;04;Torstai;0;0;0
625;17.08.2017;2017;08;05;Torstai;2;2;4
625;17.08.2017;2017;08;06;Torstai;3;1;4
625;17.08.2017;2017;08;07;Torstai;13;8;21
625;17.08.2017;2017;08;08;Torstai;88;40;128
625;17.08.2017;2017;08;09;Torstai;55;29;84
625;17.08.2017;2017;08;10;Torstai;19;13;32
625;17.08.2017;2017;08;11;Torstai;10;8;18
625;17.08.2017;2017;08;12;Torstai;9;15;24
625;17.08.2017;2017;08;13;Torstai;27;27;54
625;17.08.2017;2017;08;14;Torstai;25;44;69
625;17.08.2017;2017;08;15;Torstai;20;59;79
625;17.08.2017;2017;08;16;Torstai;28;61;89
625;17.08.2017;2017;08;17;Torstai;41;48;89
625;17.08.2017;2017;08;18;Torstai;23;30;53
625;17.08.2017;2017;08;19;Torstai;25;32;57
625;17.08.2017;2017;08;20;Torstai;14;23;37
625;17.08.2017;2017;08;21;Torstai;8;12;20
625;17.08.2017;2017;08;22;Torstai;8;10;18
625;17.08.2017;2017;08;23;Torstai;2;2;4
625;18.08.2017;2017;08;00;Perjantai;1;2;3
625;18.08.2017;2017;08;01;Perjantai;1;2;3
625;18.08.2017;2017;08;02;Perjantai;0;1;1
625;18.08.2017;2017;08;03;Perjantai;2;0;2
625;18.08.2017;2017;08;04;Perjantai;0;1;1
625;18.08.2017;2017;08;05;Perjantai;0;0;0
625;18.08.2017;2017;08;06;Perjantai;4;2;6
625;18.08.2017;2017;08;07;Perjantai;13;5;18
625;18.08.2017;2017;08;08;Perjantai;100;49;149
625;18.08.2017;2017;08;09;Perjantai;44;26;70
625;18.08.2017;2017;08;10;Perjantai;18;20;38
625;18.08.2017;2017;08;11;Perjantai;15;11;26
625;18.08.2017;2017;08;12;Perjantai;8;21;29
625;18.08.2017;2017;08;13;Perjantai;16;25;41
625;18.08.2017;2017;08;14;Perjantai;20;54;74
625;18.08.2017;2017;08;15;Perjantai;28;43;71
625;18.08.2017;2017;08;16;Perjantai;25;45;70
625;18.08.2017;2017;08;17;Perjantai;18;39;57
625;18.08.2017;2017;08;18;Perjantai;13;17;30
625;18.08.2017;2017;08;19;Perjantai;4;10;14
625;18.08.2017;2017;08;20;Perjantai;14;12;26
625;18.08.2017;2017;08;21;Perjantai;4;11;15
625;18.08.2017;2017;08;22;Perjantai;4;2;6
625;18.08.2017;2017;08;23;Perjantai;4;1;5
625;19.08.2017;2017;08;00;Lauantai;2;3;5
625;19.08.2017;2017;08;01;Lauantai;0;2;2
625;19.08.2017;2017;08;02;Lauantai;1;1;2
625;19.08.2017;2017;08;03;Lauantai;1;0;1
625;19.08.2017;2017;08;04;Lauantai;0;0;0
625;19.08.2017;2017;08;05;Lauantai;0;0;0
625;19.08.2017;2017;08;06;Lauantai;0;1;1
625;19.08.2017;2017;08;07;Lauantai;1;1;2
625;19.08.2017;2017;08;08;Lauantai;0;3;3
625;19.08.2017;2017;08;09;Lauantai;1;0;1
625;19.08.2017;2017;08;10;Lauantai;2;1;3
625;19.08.2017;2017;08;11;Lauantai;8;7;15
625;19.08.2017;2017;08;12;Lauantai;5;11;16
625;19.08.2017;2017;08;13;Lauantai;9;14;23
625;19.08.2017;2017;08;14;Lauantai;18;20;38
625;19.08.2017;2017;08;15;Lauantai;16;10;26
625;19.08.2017;2017;08;16;Lauantai;12;12;24
625;19.08.2017;2017;08;17;Lauantai;10;10;20
625;19.08.2017;2017;08;18;Lauantai;12;11;23
625;19.08.2017;2017;08;19;Lauantai;7;10;17
625;19.08.2017;2017;08;20;Lauantai;7;8;15
625;19.08.2017;2017;08;21;Lauantai;7;6;13
625;19.08.2017;2017;08;22;Lauantai;6;8;14
625;19.08.2017;2017;08;23;Lauantai;2;1;3
625;20.08.2017;2017;08;00;Sunnuntai;2;1;3
625;20.08.2017;2017;08;01;Sunnuntai;0;3;3
625;20.08.2017;2017;08;02;Sunnuntai;6;5;11
625;20.08.2017;2017;08;03;Sunnuntai;0;0;0
625;20.08.2017;2017;08;04;Sunnuntai;1;1;2
625;20.08.2017;2017;08;05;Sunnuntai;2;0;2
625;20.08.2017;2017;08;06;Sunnuntai;0;1;1
625;20.08.2017;2017;08;07;Sunnuntai;3;0;3
625;20.08.2017;2017;08;08;Sunnuntai;0;5;5
625;20.08.2017;2017;08;09;Sunnuntai;0;4;4
625;20.08.2017;2017;08;10;Sunnuntai;4;4;8
625;20.08.2017;2017;08;11;Sunnuntai;7;7;14
625;20.08.2017;2017;08;12;Sunnuntai;9;9;18
625;20.08.2017;2017;08;13;Sunnuntai;10;14;24
625;20.08.2017;2017;08;14;Sunnuntai;16;12;28
625;20.08.2017;2017;08;15;Sunnuntai;8;13;21
625;20.08.2017;2017;08;16;Sunnuntai;14;11;25
625;20.08.2017;2017;08;17;Sunnuntai;11;18;29
625;20.08.2017;2017;08;18;Sunnuntai;9;11;20
625;20.08.2017;2017;08;19;Sunnuntai;8;14;22
625;20.08.2017;2017;08;20;Sunnuntai;16;14;30
625;20.08.2017;2017;08;21;Sunnuntai;5;6;11
625;20.08.2017;2017;08;22;Sunnuntai;4;7;11
625;20.08.2017;2017;08;23;Sunnuntai;7;4;11
625;21.08.2017;2017;08;00;Maanantai;1;1;2
625;21.08.2017;2017;08;01;Maanantai;0;0;0
625;21.08.2017;2017;08;02;Maanantai;0;0;0
625;21.08.2017;2017;08;03;Maanantai;0;0;0
625;21.08.2017;2017;08;04;Maanantai;0;0;0
625;21.08.2017;2017;08;05;Maanantai;1;0;1
625;21.08.2017;2017;08;06;Maanantai;1;4;5
625;21.08.2017;2017;08;07;Maanantai;16;10;26
625;21.08.2017;2017;08;08;Maanantai;84;41;125
625;21.08.2017;2017;08;09;Maanantai;56;29;85
625;21.08.2017;2017;08;10;Maanantai;33;18;51
625;21.08.2017;2017;08;11;Maanantai;20;6;26
625;21.08.2017;2017;08;12;Maanantai;17;21;38
625;21.08.2017;2017;08;13;Maanantai;9;13;22
625;21.08.2017;2017;08;14;Maanantai;29;42;71
625;21.08.2017;2017;08;15;Maanantai;18;52;70
625;21.08.2017;2017;08;16;Maanantai;32;50;82
625;21.08.2017;2017;08;17;Maanantai;46;55;101
625;21.08.2017;2017;08;18;Maanantai;23;25;48
625;21.08.2017;2017;08;19;Maanantai;18;18;36
625;21.08.2017;2017;08;20;Maanantai;13;12;25
625;21.08.2017;2017;08;21;Maanantai;9;10;19
625;21.08.2017;2017;08;22;Maanantai;5;12;17
625;21.08.2017;2017;08;23;Maanantai;4;6;10
625;22.08.2017;2017;08;00;Tiistai;1;1;2
625;22.08.2017;2017;08;01;Tiistai;0;0;0
625;22.08.2017;2017;08;02;Tiistai;1;1;2
625;22.08.2017;2017;08;03;Tiistai;0;0;0
625;22.08.2017;2017;08;04;Tiistai;0;1;1
625;22.08.2017;2017;08;05;Tiistai;0;0;0
625;22.08.2017;2017;08;06;Tiistai;4;3;7
625;22.08.2017;2017;08;07;Tiistai;15;7;22
625;22.08.2017;2017;08;08;Tiistai;88;53;141
625;22.08.2017;2017;08;09;Tiistai;55;21;76
625;22.08.2017;2017;08;10;Tiistai;35;19;54
625;22.08.2017;2017;08;11;Tiistai;12;10;22
625;22.08.2017;2017;08;12;Tiistai;14;10;24
625;22.08.2017;2017;08;13;Tiistai;17;22;39
625;22.08.2017;2017;08;14;Tiistai;17;27;44
625;22.08.2017;2017;08;15;Tiistai;18;61;79
625;22.08.2017;2017;08;16;Tiistai;33;62;95
625;22.08.2017;2017;08;17;Tiistai;31;46;77
625;22.08.2017;2017;08;18;Tiistai;17;25;42
625;22.08.2017;2017;08;19;Tiistai;8;13;21
625;22.08.2017;2017;08;20;Tiistai;10;6;16
625;22.08.2017;2017;08;21;Tiistai;8;11;19
625;22.08.2017;2017;08;22;Tiistai;6;5;11
625;22.08.2017;2017;08;23;Tiistai;7;2;9
625;23.08.2017;2017;08;00;Keskiviikko;1;0;1
625;23.08.2017;2017;08;01;Keskiviikko;1;1;2
625;23.08.2017;2017;08;02;Keskiviikko;0;1;1
625;23.08.2017;2017;08;03;Keskiviikko;0;0;0
625;23.08.2017;2017;08;04;Keskiviikko;2;3;5
625;23.08.2017;2017;08;05;Keskiviikko;0;0;0
625;23.08.2017;2017;08;06;Keskiviikko;2;3;5
625;23.08.2017;2017;08;07;Keskiviikko;20;11;31
625;23.08.2017;2017;08;08;Keskiviikko;112;41;153
625;23.08.2017;2017;08;09;Keskiviikko;82;72;154
625;23.08.2017;2017;08;10;Keskiviikko;20;16;36
625;23.08.2017;2017;08;11;Keskiviikko;9;7;16
625;23.08.2017;2017;08;12;Keskiviikko;39;33;72
625;23.08.2017;2017;08;13;Keskiviikko;14;32;46
625;23.08.2017;2017;08;14;Keskiviikko;16;35;51
625;23.08.2017;2017;08;15;Keskiviikko;23;59;82
625;23.08.2017;2017;08;16;Keskiviikko;31;43;74
625;23.08.2017;2017;08;17;Keskiviikko;40;58;98
625;23.08.2017;2017;08;18;Keskiviikko;17;32;49
625;23.08.2017;2017;08;19;Keskiviikko;14;17;31
625;23.08.2017;2017;08;20;Keskiviikko;6;10;16
625;23.08.2017;2017;08;21;Keskiviikko;16;15;31
625;23.08.2017;2017;08;22;Keskiviikko;2;5;7
625;23.08.2017;2017;08;23;Keskiviikko;2;1;3
625;24.08.2017;2017;08;00;Torstai;0;1;1
625;24.08.2017;2017;08;01;Torstai;1;1;2
625;24.08.2017;2017;08;02;Torstai;0;0;0
625;24.08.2017;2017;08;03;Torstai;0;0;0
625;24.08.2017;2017;08;04;Torstai;0;0;0
625;24.08.2017;2017;08;05;Torstai;1;1;2
625;24.08.2017;2017;08;06;Torstai;1;4;5
625;24.08.2017;2017;08;07;Torstai;15;11;26
625;24.08.2017;2017;08;08;Torstai;75;44;119
625;24.08.2017;2017;08;09;Torstai;46;21;67
625;24.08.2017;2017;08;10;Torstai;18;10;28
625;24.08.2017;2017;08;11;Torstai;8;4;12
625;24.08.2017;2017;08;12;Torstai;11;4;15
625;24.08.2017;2017;08;13;Torstai;10;26;36
625;24.08.2017;2017;08;14;Torstai;9;30;39
625;24.08.2017;2017;08;15;Torstai;15;50;65
625;24.08.2017;2017;08;16;Torstai;21;47;68
625;24.08.2017;2017;08;17;Torstai;35;47;82
625;24.08.2017;2017;08;18;Torstai;26;19;45
625;24.08.2017;2017;08;19;Torstai;5;22;27
625;24.08.2017;2017;08;20;Torstai;6;16;22
625;24.08.2017;2017;08;21;Torstai;9;6;15
625;24.08.2017;2017;08;22;Torstai;4;9;13
625;24.08.2017;2017;08;23;Torstai;1;2;3
625;25.08.2017;2017;08;00;Perjantai;3;0;3
625;25.08.2017;2017;08;01;Perjantai;0;0;0
625;25.08.2017;2017;08;02;Perjantai;0;2;2
625;25.08.2017;2017;08;03;Perjantai;0;0;0
625;25.08.2017;2017;08;04;Perjantai;0;1;1
625;25.08.2017;2017;08;05;Perjantai;1;2;3
625;25.08.2017;2017;08;06;Perjantai;3;4;7
625;25.08.2017;2017;08;07;Perjantai;10;5;15
625;25.08.2017;2017;08;08;Perjantai;62;23;85
625;25.08.2017;2017;08;09;Perjantai;33;15;48
625;25.08.2017;2017;08;10;Perjantai;13;6;19
625;25.08.2017;2017;08;11;Perjantai;8;4;12
625;25.08.2017;2017;08;12;Perjantai;6;9;15
625;25.08.2017;2017;08;13;Perjantai;5;18;23
625;25.08.2017;2017;08;14;Perjantai;13;33;46
625;25.08.2017;2017;08;15;Perjantai;12;37;49
625;25.08.2017;2017;08;16;Perjantai;23;36;59
625;25.08.2017;2017;08;17;Perjantai;10;27;37
625;25.08.2017;2017;08;18;Perjantai;5;10;15
625;25.08.2017;2017;08;19;Perjantai;9;9;18
625;25.08.2017;2017;08;20;Perjantai;5;6;11
625;25.08.2017;2017;08;21;Perjantai;4;5;9
625;25.08.2017;2017;08;22;Perjantai;8;6;14
625;25.08.2017;2017;08;23;Perjantai;5;3;8
625;26.08.2017;2017;08;00;Lauantai;3;0;3
625;26.08.2017;2017;08;01;Lauantai;2;4;6
625;26.08.2017;2017;08;02;Lauantai;1;3;4
625;26.08.2017;2017;08;03;Lauantai;0;1;1
625;26.08.2017;2017;08;04;Lauantai;0;0;0
625;26.08.2017;2017;08;05;Lauantai;1;0;1
625;26.08.2017;2017;08;06;Lauantai;0;0;0
625;26.08.2017;2017;08;07;Lauantai;2;2;4
625;26.08.2017;2017;08;08;Lauantai;0;1;1
625;26.08.2017;2017;08;09;Lauantai;1;0;1
625;26.08.2017;2017;08;10;Lauantai;4;0;4
625;26.08.2017;2017;08;11;Lauantai;4;3;7
625;26.08.2017;2017;08;12;Lauantai;7;8;15
625;26.08.2017;2017;08;13;Lauantai;2;10;12
625;26.08.2017;2017;08;14;Lauantai;4;7;11
625;26.08.2017;2017;08;15;Lauantai;4;9;13
625;26.08.2017;2017;08;16;Lauantai;14;8;22
625;26.08.2017;2017;08;17;Lauantai;5;9;14
625;26.08.2017;2017;08;18;Lauantai;11;7;18
625;26.08.2017;2017;08;19;Lauantai;5;12;17
625;26.08.2017;2017;08;20;Lauantai;5;4;9
625;26.08.2017;2017;08;21;Lauantai;9;3;12
625;26.08.2017;2017;08;22;Lauantai;12;9;21
625;26.08.2017;2017;08;23;Lauantai;2;2;4
625;27.08.2017;2017;08;00;Sunnuntai;2;3;5
625;27.08.2017;2017;08;01;Sunnuntai;2;2;4
625;27.08.2017;2017;08;02;Sunnuntai;1;0;1
625;27.08.2017;2017;08;03;Sunnuntai;2;1;3
625;27.08.2017;2017;08;04;Sunnuntai;0;1;1
625;27.08.2017;2017;08;05;Sunnuntai;0;2;2
625;27.08.2017;2017;08;06;Sunnuntai;1;1;2
625;27.08.2017;2017;08;07;Sunnuntai;1;1;2
625;27.08.2017;2017;08;08;Sunnuntai;0;1;1
625;27.08.2017;2017;08;09;Sunnuntai;1;3;4
625;27.08.2017;2017;08;10;Sunnuntai;2;1;3
625;27.08.2017;2017;08;11;Sunnuntai;16;18;34
625;27.08.2017;2017;08;12;Sunnuntai;10;9;19
625;27.08.2017;2017;08;13;Sunnuntai;13;10;23
625;27.08.2017;2017;08;14;Sunnuntai;6;12;18
625;27.08.2017;2017;08;15;Sunnuntai;3;13;16
625;27.08.2017;2017;08;16;Sunnuntai;11;5;16
625;27.08.2017;2017;08;17;Sunnuntai;7;18;25
625;27.08.2017;2017;08;18;Sunnuntai;12;13;25
625;27.08.2017;2017;08;19;Sunnuntai;6;9;15
625;27.08.2017;2017;08;20;Sunnuntai;8;9;17
625;27.08.2017;2017;08;21;Sunnuntai;7;5;12
625;27.08.2017;2017;08;22;Sunnuntai;3;5;8
625;27.08.2017;2017;08;23;Sunnuntai;0;1;1
625;28.08.2017;2017;08;00;Maanantai;1;1;2
625;28.08.2017;2017;08;01;Maanantai;1;0;1
625;28.08.2017;2017;08;02;Maanantai;0;0;0
625;28.08.2017;2017;08;03;Maanantai;0;0;0
625;28.08.2017;2017;08;04;Maanantai;0;0;0
625;28.08.2017;2017;08;05;Maanantai;0;0;0
625;28.08.2017;2017;08;06;Maanantai;3;1;4
625;28.08.2017;2017;08;07;Maanantai;9;10;19
625;28.08.2017;2017;08;08;Maanantai;68;27;95
625;28.08.2017;2017;08;09;Maanantai;48;32;80
625;28.08.2017;2017;08;10;Maanantai;29;17;46
625;28.08.2017;2017;08;11;Maanantai;15;9;24
625;28.08.2017;2017;08;12;Maanantai;7;10;17
625;28.08.2017;2017;08;13;Maanantai;18;21;39
625;28.08.2017;2017;08;14;Maanantai;29;54;83
625;28.08.2017;2017;08;15;Maanantai;25;41;66
625;28.08.2017;2017;08;16;Maanantai;30;52;82
625;28.08.2017;2017;08;17;Maanantai;33;55;88
625;28.08.2017;2017;08;18;Maanantai;22;26;48
625;28.08.2017;2017;08;19;Maanantai;21;27;48
625;28.08.2017;2017;08;20;Maanantai;13;20;33
625;28.08.2017;2017;08;21;Maanantai;15;13;28
625;28.08.2017;2017;08;22;Maanantai;8;7;15
625;28.08.2017;2017;08;23;Maanantai;4;4;8
625;29.08.2017;2017;08;00;Tiistai;0;0;0
625;29.08.2017;2017;08;01;Tiistai;2;3;5
625;29.08.2017;2017;08;02;Tiistai;0;0;0
625;29.08.2017;2017;08;03;Tiistai;1;0;1
625;29.08.2017;2017;08;04;Tiistai;0;0;0
625;29.08.2017;2017;08;05;Tiistai;0;1;1
625;29.08.2017;2017;08;06;Tiistai;0;2;2
625;29.08.2017;2017;08;07;Tiistai;9;5;14
625;29.08.2017;2017;08;08;Tiistai;70;37;107
625;29.08.2017;2017;08;09;Tiistai;44;15;59
625;29.08.2017;2017;08;10;Tiistai;25;18;43
625;29.08.2017;2017;08;11;Tiistai;14;7;21
625;29.08.2017;2017;08;12;Tiistai;6;12;18
625;29.08.2017;2017;08;13;Tiistai;22;29;51
625;29.08.2017;2017;08;14;Tiistai;27;49;76
625;29.08.2017;2017;08;15;Tiistai;18;35;53
625;29.08.2017;2017;08;16;Tiistai;19;52;71
625;29.08.2017;2017;08;17;Tiistai;21;24;45
625;29.08.2017;2017;08;18;Tiistai;3;12;15
625;29.08.2017;2017;08;19;Tiistai;11;13;24
625;29.08.2017;2017;08;20;Tiistai;4;10;14
625;29.08.2017;2017;08;21;Tiistai;4;5;9
625;29.08.2017;2017;08;22;Tiistai;6;6;12
625;29.08.2017;2017;08;23;Tiistai;2;3;5
625;30.08.2017;2017;08;00;Keskiviikko;4;2;6
625;30.08.2017;2017;08;01;Keskiviikko;2;0;2
625;30.08.2017;2017;08;02;Keskiviikko;0;0;0
625;30.08.2017;2017;08;03;Keskiviikko;0;0;0
625;30.08.2017;2017;08;04;Keskiviikko;1;0;1
625;30.08.2017;2017;08;05;Keskiviikko;0;0;0
625;30.08.2017;2017;08;06;Keskiviikko;2;0;2
625;30.08.2017;2017;08;07;Keskiviikko;8;6;14
625;30.08.2017;2017;08;08;Keskiviikko;53;18;71
625;30.08.2017;2017;08;09;Keskiviikko;43;18;61
625;30.08.2017;2017;08;10;Keskiviikko;18;9;27
625;30.08.2017;2017;08;11;Keskiviikko;7;5;12
625;30.08.2017;2017;08;12;Keskiviikko;1;6;7
625;30.08.2017;2017;08;13;Keskiviikko;4;11;15
625;30.08.2017;2017;08;14;Keskiviikko;12;29;41
625;30.08.2017;2017;08;15;Keskiviikko;7;36;43
625;30.08.2017;2017;08;16;Keskiviikko;18;34;52
625;30.08.2017;2017;08;17;Keskiviikko;17;39;56
625;30.08.2017;2017;08;18;Keskiviikko;14;14;28
625;30.08.2017;2017;08;19;Keskiviikko;10;15;25
625;30.08.2017;2017;08;20;Keskiviikko;10;14;24
625;30.08.2017;2017;08;21;Keskiviikko;10;10;20
625;30.08.2017;2017;08;22;Keskiviikko;5;2;7
625;30.08.2017;2017;08;23;Keskiviikko;3;2;5
625;31.08.2017;2017;08;00;Torstai;1;0;1
625;31.08.2017;2017;08;01;Torstai;0;0;0
625;31.08.2017;2017;08;02;Torstai;1;0;1
625;31.08.2017;2017;08;03;Torstai;1;0;1
625;31.08.2017;2017;08;04;Torstai;0;0;0
625;31.08.2017;2017;08;05;Torstai;0;0;0
625;31.08.2017;2017;08;06;Torstai;2;4;6
625;31.08.2017;2017;08;07;Torstai;18;7;25
625;31.08.2017;2017;08;08;Torstai;72;31;103
625;31.08.2017;2017;08;09;Torstai;58;27;85
625;31.08.2017;2017;08;10;Torstai;23;12;35
625;31.08.2017;2017;08;11;Torstai;13;10;23
625;31.08.2017;2017;08;12;Torstai;9;10;19
625;31.08.2017;2017;08;13;Torstai;18;26;44
625;31.08.2017;2017;08;14;Torstai;18;45;63
625;31.08.2017;2017;08;15;Torstai;28;49;77
625;31.08.2017;2017;08;16;Torstai;22;56;78
625;31.08.2017;2017;08;17;Torstai;43;53;96
625;31.08.2017;2017;08;18;Torstai;16;16;32
625;31.08.2017;2017;08;19;Torstai;22;24;46
625;31.08.2017;2017;08;20;Torstai;4;14;18
625;31.08.2017;2017;08;21;Torstai;12;11;23
625;31.08.2017;2017;08;22;Torstai;7;10;17
625;31.08.2017;2017;08;23;Torstai;0;5;5
625;01.09.2017;2017;09;00;Perjantai;2;1;3
625;01.09.2017;2017;09;01;Perjantai;4;0;4
625;01.09.2017;2017;09;02;Perjantai;1;0;1
625;01.09.2017;2017;09;03;Perjantai;0;0;0
625;01.09.2017;2017;09;04;Perjantai;0;0;0
625;01.09.2017;2017;09;05;Perjantai;0;0;0
625;01.09.2017;2017;09;06;Perjantai;1;0;1
625;01.09.2017;2017;09;07;Perjantai;9;4;13
625;01.09.2017;2017;09;08;Perjantai;41;18;59
625;01.09.2017;2017;09;09;Perjantai;32;10;42
625;01.09.2017;2017;09;10;Perjantai;24;8;32
625;01.09.2017;2017;09;11;Perjantai;10;4;14
625;01.09.2017;2017;09;12;Perjantai;6;13;19
625;01.09.2017;2017;09;13;Perjantai;12;41;53
625;01.09.2017;2017;09;14;Perjantai;12;16;28
625;01.09.2017;2017;09;15;Perjantai;8;29;37
625;01.09.2017;2017;09;16;Perjantai;6;10;16
625;01.09.2017;2017;09;17;Perjantai;5;15;20
625;01.09.2017;2017;09;18;Perjantai;6;7;13
625;01.09.2017;2017;09;19;Perjantai;7;6;13
625;01.09.2017;2017;09;20;Perjantai;4;1;5
625;01.09.2017;2017;09;21;Perjantai;6;4;10
625;01.09.2017;2017;09;22;Perjantai;2;6;8
625;01.09.2017;2017;09;23;Perjantai;1;6;7
625;02.09.2017;2017;09;00;Lauantai;0;5;5
625;02.09.2017;2017;09;01;Lauantai;1;2;3
625;02.09.2017;2017;09;02;Lauantai;1;1;2
625;02.09.2017;2017;09;03;Lauantai;0;0;0
625;02.09.2017;2017;09;04;Lauantai;0;1;1
625;02.09.2017;2017;09;05;Lauantai;0;1;1
625;02.09.2017;2017;09;06;Lauantai;0;2;2
625;02.09.2017;2017;09;07;Lauantai;1;0;1
625;02.09.2017;2017;09;08;Lauantai;0;0;0
625;02.09.2017;2017;09;09;Lauantai;2;3;5
625;02.09.2017;2017;09;10;Lauantai;6;9;15
625;02.09.2017;2017;09;11;Lauantai;8;2;10
625;02.09.2017;2017;09;12;Lauantai;11;6;17
625;02.09.2017;2017;09;13;Lauantai;8;17;25
625;02.09.2017;2017;09;14;Lauantai;5;14;19
625;02.09.2017;2017;09;15;Lauantai;9;11;20
625;02.09.2017;2017;09;16;Lauantai;11;18;29
625;02.09.2017;2017;09;17;Lauantai;10;9;19
625;02.09.2017;2017;09;18;Lauantai;10;8;18
625;02.09.2017;2017;09;19;Lauantai;10;12;22
625;02.09.2017;2017;09;20;Lauantai;15;14;29
625;02.09.2017;2017;09;21;Lauantai;4;4;8
625;02.09.2017;2017;09;22;Lauantai;2;3;5
625;02.09.2017;2017;09;23;Lauantai;4;4;8
625;03.09.2017;2017;09;00;Sunnuntai;0;1;1
625;03.09.2017;2017;09;01;Sunnuntai;1;2;3
625;03.09.2017;2017;09;02;Sunnuntai;1;0;1
625;03.09.2017;2017;09;03;Sunnuntai;1;0;1
625;03.09.2017;2017;09;04;Sunnuntai;3;0;3
625;03.09.2017;2017;09;05;Sunnuntai;0;1;1
625;03.09.2017;2017;09;06;Sunnuntai;1;1;2
625;03.09.2017;2017;09;07;Sunnuntai;1;1;2
625;03.09.2017;2017;09;08;Sunnuntai;0;3;3
625;03.09.2017;2017;09;09;Sunnuntai;0;1;1
625;03.09.2017;2017;09;10;Sunnuntai;4;6;10
625;03.09.2017;2017;09;11;Sunnuntai;5;6;11
625;03.09.2017;2017;09;12;Sunnuntai;9;9;18
625;03.09.2017;2017;09;13;Sunnuntai;11;16;27
625;03.09.2017;2017;09;14;Sunnuntai;17;12;29
625;03.09.2017;2017;09;15;Sunnuntai;9;21;30
625;03.09.2017;2017;09;16;Sunnuntai;11;13;24
625;03.09.2017;2017;09;17;Sunnuntai;15;11;26
625;03.09.2017;2017;09;18;Sunnuntai;13;17;30
625;03.09.2017;2017;09;19;Sunnuntai;9;14;23
625;03.09.2017;2017;09;20;Sunnuntai;16;12;28
625;03.09.2017;2017;09;21;Sunnuntai;5;10;15
625;03.09.2017;2017;09;22;Sunnuntai;4;4;8
625;03.09.2017;2017;09;23;Sunnuntai;2;6;8
625;04.09.2017;2017;09;00;Maanantai;0;2;2
625;04.09.2017;2017;09;01;Maanantai;1;0;1
625;04.09.2017;2017;09;02;Maanantai;0;0;0
625;04.09.2017;2017;09;03;Maanantai;0;0;0
625;04.09.2017;2017;09;04;Maanantai;0;0;0
625;04.09.2017;2017;09;05;Maanantai;0;1;1
625;04.09.2017;2017;09;06;Maanantai;3;2;5
625;04.09.2017;2017;09;07;Maanantai;18;6;24
625;04.09.2017;2017;09;08;Maanantai;74;39;113
625;04.09.2017;2017;09;09;Maanantai;64;21;85
625;04.09.2017;2017;09;10;Maanantai;40;18;58
625;04.09.2017;2017;09;11;Maanantai;20;15;35
625;04.09.2017;2017;09;12;Maanantai;9;19;28
625;04.09.2017;2017;09;13;Maanantai;15;17;32
625;04.09.2017;2017;09;14;Maanantai;17;34;51
625;04.09.2017;2017;09;15;Maanantai;24;56;80
625;04.09.2017;2017;09;16;Maanantai;27;59;86
625;04.09.2017;2017;09;17;Maanantai;39;66;105
625;04.09.2017;2017;09;18;Maanantai;24;37;61
625;04.09.2017;2017;09;19;Maanantai;17;24;41
625;04.09.2017;2017;09;20;Maanantai;10;19;29
625;04.09.2017;2017;09;21;Maanantai;10;16;26
625;04.09.2017;2017;09;22;Maanantai;7;4;11
625;04.09.2017;2017;09;23;Maanantai;4;2;6
625;05.09.2017;2017;09;00;Tiistai;1;0;1
625;05.09.2017;2017;09;01;Tiistai;0;0;0
625;05.09.2017;2017;09;02;Tiistai;0;0;0
625;05.09.2017;2017;09;03;Tiistai;0;0;0
625;05.09.2017;2017;09;04;Tiistai;0;0;0
625;05.09.2017;2017;09;05;Tiistai;0;1;1
625;05.09.2017;2017;09;06;Tiistai;2;5;7
625;05.09.2017;2017;09;07;Tiistai;7;5;12
625;05.09.2017;2017;09;08;Tiistai;75;45;120
625;05.09.2017;2017;09;09;Tiistai;58;35;93
625;05.09.2017;2017;09;10;Tiistai;45;18;63
625;05.09.2017;2017;09;11;Tiistai;18;10;28
625;05.09.2017;2017;09;12;Tiistai;9;13;22
625;05.09.2017;2017;09;13;Tiistai;21;22;43
625;05.09.2017;2017;09;14;Tiistai;16;35;51
625;05.09.2017;2017;09;15;Tiistai;13;49;62
625;05.09.2017;2017;09;16;Tiistai;37;59;96
625;05.09.2017;2017;09;17;Tiistai;24;52;76
625;05.09.2017;2017;09;18;Tiistai;28;31;59
625;05.09.2017;2017;09;19;Tiistai;18;31;49
625;05.09.2017;2017;09;20;Tiistai;18;15;33
625;05.09.2017;2017;09;21;Tiistai;8;13;21
625;05.09.2017;2017;09;22;Tiistai;7;7;14
625;05.09.2017;2017;09;23;Tiistai;3;5;8
625;06.09.2017;2017;09;00;Keskiviikko;2;1;3
625;06.09.2017;2017;09;01;Keskiviikko;0;0;0
625;06.09.2017;2017;09;02;Keskiviikko;0;0;0
625;06.09.2017;2017;09;03;Keskiviikko;0;1;1
625;06.09.2017;2017;09;04;Keskiviikko;0;0;0
625;06.09.2017;2017;09;05;Keskiviikko;0;2;2
625;06.09.2017;2017;09;06;Keskiviikko;2;3;5
625;06.09.2017;2017;09;07;Keskiviikko;22;10;32
625;06.09.2017;2017;09;08;Keskiviikko;80;46;126
625;06.09.2017;2017;09;09;Keskiviikko;41;24;65
625;06.09.2017;2017;09;10;Keskiviikko;12;20;32
625;06.09.2017;2017;09;11;Keskiviikko;12;8;20
625;06.09.2017;2017;09;12;Keskiviikko;12;18;30
625;06.09.2017;2017;09;13;Keskiviikko;27;53;80
625;06.09.2017;2017;09;14;Keskiviikko;21;32;53
625;06.09.2017;2017;09;15;Keskiviikko;19;45;64
625;06.09.2017;2017;09;16;Keskiviikko;30;41;71
625;06.09.2017;2017;09;17;Keskiviikko;35;53;88
625;06.09.2017;2017;09;18;Keskiviikko;27;35;62
625;06.09.2017;2017;09;19;Keskiviikko;18;32;50
625;06.09.2017;2017;09;20;Keskiviikko;15;32;47
625;06.09.2017;2017;09;21;Keskiviikko;19;15;34
625;06.09.2017;2017;09;22;Keskiviikko;4;9;13
625;06.09.2017;2017;09;23;Keskiviikko;6;4;10
625;07.09.2017;2017;09;00;Torstai;2;0;2
625;07.09.2017;2017;09;01;Torstai;2;0;2
625;07.09.2017;2017;09;02;Torstai;0;0;0
625;07.09.2017;2017;09;03;Torstai;0;0;0
625;07.09.2017;2017;09;04;Torstai;0;0;0
625;07.09.2017;2017;09;05;Torstai;0;2;2
625;07.09.2017;2017;09;06;Torstai;2;3;5
625;07.09.2017;2017;09;07;Torstai;15;8;23
625;07.09.2017;2017;09;08;Torstai;101;49;150
625;07.09.2017;2017;09;09;Torstai;57;38;95
625;07.09.2017;2017;09;10;Torstai;23;18;41
625;07.09.2017;2017;09;11;Torstai;8;5;13
625;07.09.2017;2017;09;12;Torstai;12;10;22
625;07.09.2017;2017;09;13;Torstai;18;35;53
625;07.09.2017;2017;09;14;Torstai;36;50;86
625;07.09.2017;2017;09;15;Torstai;14;44;58
625;07.09.2017;2017;09;16;Torstai;17;57;74
625;07.09.2017;2017;09;17;Torstai;31;47;78
625;07.09.2017;2017;09;18;Torstai;16;15;31
625;07.09.2017;2017;09;19;Torstai;17;23;40
625;07.09.2017;2017;09;20;Torstai;13;11;24
625;07.09.2017;2017;09;21;Torstai;6;5;11
625;07.09.2017;2017;09;22;Torstai;3;6;9
625;07.09.2017;2017;09;23;Torstai;3;3;6
625;08.09.2017;2017;09;00;Perjantai;2;1;3
625;08.09.2017;2017;09;01;Perjantai;0;1;1
625;08.09.2017;2017;09;02;Perjantai;0;0;0
625;08.09.2017;2017;09;03;Perjantai;0;0;0
625;08.09.2017;2017;09;04;Perjantai;0;0;0
625;08.09.2017;2017;09;05;Perjantai;0;1;1
625;08.09.2017;2017;09;06;Perjantai;2;1;3
625;08.09.2017;2017;09;07;Perjantai;7;1;8
625;08.09.2017;2017;09;08;Perjantai;77;38;115
625;08.09.2017;2017;09;09;Perjantai;31;9;40
625;08.09.2017;2017;09;10;Perjantai;9;12;21
625;08.09.2017;2017;09;11;Perjantai;12;5;17
625;08.09.2017;2017;09;12;Perjantai;25;50;75
625;08.09.2017;2017;09;13;Perjantai;6;13;19
625;08.09.2017;2017;09;14;Perjantai;9;10;19
625;08.09.2017;2017;09;15;Perjantai;5;31;36
625;08.09.2017;2017;09;16;Perjantai;9;26;35
625;08.09.2017;2017;09;17;Perjantai;7;20;27
625;08.09.2017;2017;09;18;Perjantai;3;13;16
625;08.09.2017;2017;09;19;Perjantai;6;9;15
625;08.09.2017;2017;09;20;Perjantai;7;3;10
625;08.09.2017;2017;09;21;Perjantai;8;1;9
625;08.09.2017;2017;09;22;Perjantai;2;2;4
625;08.09.2017;2017;09;23;Perjantai;3;1;4
625;09.09.2017;2017;09;00;Lauantai;1;2;3
625;09.09.2017;2017;09;01;Lauantai;1;3;4
625;09.09.2017;2017;09;02;Lauantai;0;0;0
625;09.09.2017;2017;09;03;Lauantai;1;0;1
625;09.09.2017;2017;09;04;Lauantai;0;0;0
625;09.09.2017;2017;09;05;Lauantai;0;0;0
625;09.09.2017;2017;09;06;Lauantai;2;0;2
625;09.09.2017;2017;09;07;Lauantai;0;0;0
625;09.09.2017;2017;09;08;Lauantai;1;2;3
625;09.09.2017;2017;09;09;Lauantai;0;2;2
625;09.09.2017;2017;09;10;Lauantai;6;2;8
625;09.09.2017;2017;09;11;Lauantai;3;6;9
625;09.09.2017;2017;09;12;Lauantai;5;5;10
625;09.09.2017;2017;09;13;Lauantai;7;5;12
625;09.09.2017;2017;09;14;Lauantai;9;5;14
625;09.09.2017;2017;09;15;Lauantai;9;9;18
625;09.09.2017;2017;09;16;Lauantai;8;14;22
625;09.09.2017;2017;09;17;Lauantai;5;6;11
625;09.09.2017;2017;09;18;Lauantai;6;4;10
625;09.09.2017;2017;09;19;Lauantai;6;12;18
625;09.09.2017;2017;09;20;Lauantai;9;6;15
625;09.09.2017;2017;09;21;Lauantai;6;5;11
625;09.09.2017;2017;09;22;Lauantai;4;7;11
625;09.09.2017;2017;09;23;Lauantai;3;4;7
625;10.09.2017;2017;09;00;Sunnuntai;1;3;4
625;10.09.2017;2017;09;01;Sunnuntai;0;1;1
625;10.09.2017;2017;09;02;Sunnuntai;0;1;1
625;10.09.2017;2017;09;03;Sunnuntai;0;0;0
625;10.09.2017;2017;09;04;Sunnuntai;0;0;0
625;10.09.2017;2017;09;05;Sunnuntai;0;0;0
625;10.09.2017;2017;09;06;Sunnuntai;0;1;1
625;10.09.2017;2017;09;07;Sunnuntai;1;0;1
625;10.09.2017;2017;09;08;Sunnuntai;1;0;1
625;10.09.2017;2017;09;09;Sunnuntai;0;0;0
625;10.09.2017;2017;09;10;Sunnuntai;2;1;3
625;10.09.2017;2017;09;11;Sunnuntai;2;1;3
625;10.09.2017;2017;09;12;Sunnuntai;3;2;5
625;10.09.2017;2017;09;13;Sunnuntai;1;1;2
625;10.09.2017;2017;09;14;Sunnuntai;0;5;5
625;10.09.2017;2017;09;15;Sunnuntai;6;5;11
625;10.09.2017;2017;09;16;Sunnuntai;3;3;6
625;10.09.2017;2017;09;17;Sunnuntai;1;2;3
625;10.09.2017;2017;09;18;Sunnuntai;1;4;5
625;10.09.2017;2017;09;19;Sunnuntai;3;3;6
625;10.09.2017;2017;09;20;Sunnuntai;1;1;2
625;10.09.2017;2017;09;21;Sunnuntai;0;1;1
625;10.09.2017;2017;09;22;Sunnuntai;0;1;1
625;10.09.2017;2017;09;23;Sunnuntai;0;0;0
625;11.09.2017;2017;09;00;Maanantai;1;0;1
625;11.09.2017;2017;09;01;Maanantai;1;0;1
625;11.09.2017;2017;09;02;Maanantai;0;0;0
625;11.09.2017;2017;09;03;Maanantai;0;0;0
625;11.09.2017;2017;09;04;Maanantai;0;0;0
625;11.09.2017;2017;09;05;Maanantai;0;0;0
625;11.09.2017;2017;09;06;Maanantai;2;2;4
625;11.09.2017;2017;09;07;Maanantai;13;6;19
625;11.09.2017;2017;09;08;Maanantai;62;23;85
625;11.09.2017;2017;09;09;Maanantai;50;28;78
625;11.09.2017;2017;09;10;Maanantai;39;15;54
625;11.09.2017;2017;09;11;Maanantai;19;3;22
625;11.09.2017;2017;09;12;Maanantai;8;19;27
625;11.09.2017;2017;09;13;Maanantai;16;16;32
625;11.09.2017;2017;09;14;Maanantai;16;29;45
625;11.09.2017;2017;09;15;Maanantai;24;52;76
625;11.09.2017;2017;09;16;Maanantai;26;58;84
625;11.09.2017;2017;09;17;Maanantai;31;67;98
625;11.09.2017;2017;09;18;Maanantai;20;24;44
625;11.09.2017;2017;09;19;Maanantai;11;27;38
625;11.09.2017;2017;09;20;Maanantai;16;25;41
625;11.09.2017;2017;09;21;Maanantai;9;13;22
625;11.09.2017;2017;09;22;Maanantai;2;9;11
625;11.09.2017;2017;09;23;Maanantai;6;1;7
625;12.09.2017;2017;09;00;Tiistai;0;0;0
625;12.09.2017;2017;09;01;Tiistai;3;2;5
625;12.09.2017;2017;09;02;Tiistai;0;0;0
625;12.09.2017;2017;09;03;Tiistai;0;0;0
625;12.09.2017;2017;09;04;Tiistai;0;0;0
625;12.09.2017;2017;09;05;Tiistai;0;1;1
625;12.09.2017;2017;09;06;Tiistai;2;3;5
625;12.09.2017;2017;09;07;Tiistai;11;7;18
625;12.09.2017;2017;09;08;Tiistai;77;40;117
625;12.09.2017;2017;09;09;Tiistai;58;15;73
625;12.09.2017;2017;09;10;Tiistai;33;11;44
625;12.09.2017;2017;09;11;Tiistai;11;3;14
625;12.09.2017;2017;09;12;Tiistai;10;10;20
625;12.09.2017;2017;09;13;Tiistai;7;4;11
625;12.09.2017;2017;09;14;Tiistai;16;34;50
625;12.09.2017;2017;09;15;Tiistai;25;62;87
625;12.09.2017;2017;09;16;Tiistai;16;40;56
625;12.09.2017;2017;09;17;Tiistai;19;37;56
625;12.09.2017;2017;09;18;Tiistai;12;11;23
625;12.09.2017;2017;09;19;Tiistai;3;11;14
625;12.09.2017;2017;09;20;Tiistai;3;6;9
625;12.09.2017;2017;09;21;Tiistai;5;7;12
625;12.09.2017;2017;09;22;Tiistai;5;5;10
625;12.09.2017;2017;09;23;Tiistai;4;2;6
625;13.09.2017;2017;09;00;Keskiviikko;1;1;2
625;13.09.2017;2017;09;01;Keskiviikko;0;0;0
625;13.09.2017;2017;09;02;Keskiviikko;1;0;1
625;13.09.2017;2017;09;03;Keskiviikko;0;1;1
625;13.09.2017;2017;09;04;Keskiviikko;0;0;0
625;13.09.2017;2017;09;05;Keskiviikko;1;2;3
625;13.09.2017;2017;09;06;Keskiviikko;2;0;2
625;13.09.2017;2017;09;07;Keskiviikko;17;7;24
625;13.09.2017;2017;09;08;Keskiviikko;93;44;137
625;13.09.2017;2017;09;09;Keskiviikko;49;27;76
625;13.09.2017;2017;09;10;Keskiviikko;11;15;26
625;13.09.2017;2017;09;11;Keskiviikko;5;1;6
625;13.09.2017;2017;09;12;Keskiviikko;11;8;19
625;13.09.2017;2017;09;13;Keskiviikko;14;29;43
625;13.09.2017;2017;09;14;Keskiviikko;16;35;51
625;13.09.2017;2017;09;15;Keskiviikko;24;51;75
625;13.09.2017;2017;09;16;Keskiviikko;25;48;73
625;13.09.2017;2017;09;17;Keskiviikko;22;40;62
625;13.09.2017;2017;09;18;Keskiviikko;17;20;37
625;13.09.2017;2017;09;19;Keskiviikko;13;18;31
625;13.09.2017;2017;09;20;Keskiviikko;12;17;29
625;13.09.2017;2017;09;21;Keskiviikko;8;9;17
625;13.09.2017;2017;09;22;Keskiviikko;4;5;9
625;13.09.2017;2017;09;23;Keskiviikko;3;2;5
625;14.09.2017;2017;09;00;Torstai;4;3;7
625;14.09.2017;2017;09;01;Torstai;0;0;0
625;14.09.2017;2017;09;02;Torstai;1;0;1
625;14.09.2017;2017;09;03;Torstai;0;0;0
625;14.09.2017;2017;09;04;Torstai;0;0;0
625;14.09.2017;2017;09;05;Torstai;0;1;1
625;14.09.2017;2017;09;06;Torstai;2;3;5
625;14.09.2017;2017;09;07;Torstai;14;2;16
625;14.09.2017;2017;09;08;Torstai;74;27;101
625;14.09.2017;2017;09;09;Torstai;37;14;51
625;14.09.2017;2017;09;10;Torstai;25;14;39
625;14.09.2017;2017;09;11;Torstai;8;6;14
625;14.09.2017;2017;09;12;Torstai;8;7;15
625;14.09.2017;2017;09;13;Torstai;17;30;47
625;14.09.2017;2017;09;14;Torstai;8;32;40
625;14.09.2017;2017;09;15;Torstai;22;40;62
625;14.09.2017;2017;09;16;Torstai;32;62;94
625;14.09.2017;2017;09;17;Torstai;38;46;84
625;14.09.2017;2017;09;18;Torstai;15;27;42
625;14.09.2017;2017;09;19;Torstai;12;15;27
625;14.09.2017;2017;09;20;Torstai;19;18;37
625;14.09.2017;2017;09;21;Torstai;13;8;21
625;14.09.2017;2017;09;22;Torstai;5;9;14
625;14.09.2017;2017;09;23;Torstai;2;1;3
625;15.09.2017;2017;09;00;Perjantai;1;2;3
625;15.09.2017;2017;09;01;Perjantai;0;0;0
625;15.09.2017;2017;09;02;Perjantai;0;0;0
625;15.09.2017;2017;09;03;Perjantai;0;0;0
625;15.09.2017;2017;09;04;Perjantai;0;0;0
625;15.09.2017;2017;09;05;Perjantai;0;0;0
625;15.09.2017;2017;09;06;Perjantai;2;5;7
625;15.09.2017;2017;09;07;Perjantai;11;6;17
625;15.09.2017;2017;09;08;Perjantai;74;36;110
625;15.09.2017;2017;09;09;Perjantai;30;18;48
625;15.09.2017;2017;09;10;Perjantai;9;9;18
625;15.09.2017;2017;09;11;Perjantai;15;4;19
625;15.09.2017;2017;09;12;Perjantai;13;12;25
625;15.09.2017;2017;09;13;Perjantai;8;27;35
625;15.09.2017;2017;09;14;Perjantai;21;51;72
625;15.09.2017;2017;09;15;Perjantai;11;32;43
625;15.09.2017;2017;09;16;Perjantai;16;34;50
625;15.09.2017;2017;09;17;Perjantai;16;26;42
625;15.09.2017;2017;09;18;Perjantai;8;13;21
625;15.09.2017;2017;09;19;Perjantai;3;6;9
625;15.09.2017;2017;09;20;Perjantai;8;9;17
625;15.09.2017;2017;09;21;Perjantai;4;7;11
625;15.09.2017;2017;09;22;Perjantai;3;5;8
625;15.09.2017;2017;09;23;Perjantai;4;7;11
625;16.09.2017;2017;09;00;Lauantai;1;1;2
625;16.09.2017;2017;09;01;Lauantai;1;2;3
625;16.09.2017;2017;09;02;Lauantai;1;0;1
625;16.09.2017;2017;09;03;Lauantai;1;1;2
625;16.09.2017;2017;09;04;Lauantai;0;0;0
625;16.09.2017;2017;09;05;Lauantai;0;0;0
625;16.09.2017;2017;09;06;Lauantai;1;2;3
625;16.09.2017;2017;09;07;Lauantai;2;2;4
625;16.09.2017;2017;09;08;Lauantai;0;0;0
625;16.09.2017;2017;09;09;Lauantai;2;0;2
625;16.09.2017;2017;09;10;Lauantai;2;0;2
625;16.09.2017;2017;09;11;Lauantai;11;7;18
625;16.09.2017;2017;09;12;Lauantai;3;7;10
625;16.09.2017;2017;09;13;Lauantai;8;7;15
625;16.09.2017;2017;09;14;Lauantai;10;9;19
625;16.09.2017;2017;09;15;Lauantai;4;7;11
625;16.09.2017;2017;09;16;Lauantai;11;11;22
625;16.09.2017;2017;09;17;Lauantai;8;4;12
625;16.09.2017;2017;09;18;Lauantai;7;11;18
625;16.09.2017;2017;09;19;Lauantai;6;9;15
625;16.09.2017;2017;09;20;Lauantai;0;4;4
625;16.09.2017;2017;09;21;Lauantai;5;4;9
625;16.09.2017;2017;09;22;Lauantai;5;1;6
625;16.09.2017;2017;09;23;Lauantai;2;4;6
625;17.09.2017;2017;09;00;Sunnuntai;2;3;5
625;17.09.2017;2017;09;01;Sunnuntai;0;1;1
625;17.09.2017;2017;09;02;Sunnuntai;0;0;0
625;17.09.2017;2017;09;03;Sunnuntai;1;1;2
625;17.09.2017;2017;09;04;Sunnuntai;1;0;1
625;17.09.2017;2017;09;05;Sunnuntai;1;0;1
625;17.09.2017;2017;09;06;Sunnuntai;0;0;0
625;17.09.2017;2017;09;07;Sunnuntai;1;0;1
625;17.09.2017;2017;09;08;Sunnuntai;1;3;4
625;17.09.2017;2017;09;09;Sunnuntai;2;1;3
625;17.09.2017;2017;09;10;Sunnuntai;1;2;3
625;17.09.2017;2017;09;11;Sunnuntai;5;5;10
625;17.09.2017;2017;09;12;Sunnuntai;5;10;15
625;17.09.2017;2017;09;13;Sunnuntai;12;7;19
625;17.09.2017;2017;09;14;Sunnuntai;5;13;18
625;17.09.2017;2017;09;15;Sunnuntai;10;11;21
625;17.09.2017;2017;09;16;Sunnuntai;6;13;19
625;17.09.2017;2017;09;17;Sunnuntai;9;6;15
625;17.09.2017;2017;09;18;Sunnuntai;13;4;17
625;17.09.2017;2017;09;19;Sunnuntai;6;8;14
625;17.09.2017;2017;09;20;Sunnuntai;9;8;17
625;17.09.2017;2017;09;21;Sunnuntai;2;3;5
625;17.09.2017;2017;09;22;Sunnuntai;2;3;5
625;17.09.2017;2017;09;23;Sunnuntai;0;2;2
625;18.09.2017;2017;09;00;Maanantai;2;0;2
625;18.09.2017;2017;09;01;Maanantai;0;0;0
625;18.09.2017;2017;09;02;Maanantai;0;0;0
625;18.09.2017;2017;09;03;Maanantai;0;0;0
625;18.09.2017;2017;09;04;Maanantai;1;1;2
625;18.09.2017;2017;09;05;Maanantai;0;2;2
625;18.09.2017;2017;09;06;Maanantai;0;2;2
625;18.09.2017;2017;09;07;Maanantai;17;8;25
625;18.09.2017;2017;09;08;Maanantai;64;25;89
625;18.09.2017;2017;09;09;Maanantai;49;20;69
625;18.09.2017;2017;09;10;Maanantai;19;10;29
625;18.09.2017;2017;09;11;Maanantai;15;5;20
625;18.09.2017;2017;09;12;Maanantai;4;8;12
625;18.09.2017;2017;09;13;Maanantai;10;15;25
625;18.09.2017;2017;09;14;Maanantai;20;32;52
625;18.09.2017;2017;09;15;Maanantai;21;57;78
625;18.09.2017;2017;09;16;Maanantai;25;39;64
625;18.09.2017;2017;09;17;Maanantai;27;51;78
625;18.09.2017;2017;09;18;Maanantai;15;22;37
625;18.09.2017;2017;09;19;Maanantai;12;19;31
625;18.09.2017;2017;09;20;Maanantai;10;15;25
625;18.09.2017;2017;09;21;Maanantai;10;11;21
625;18.09.2017;2017;09;22;Maanantai;7;7;14
625;18.09.2017;2017;09;23;Maanantai;2;0;2
625;19.09.2017;2017;09;00;Tiistai;1;0;1
625;19.09.2017;2017;09;01;Tiistai;0;1;1
625;19.09.2017;2017;09;02;Tiistai;0;0;0
625;19.09.2017;2017;09;03;Tiistai;0;1;1
625;19.09.2017;2017;09;04;Tiistai;0;2;2
625;19.09.2017;2017;09;05;Tiistai;0;3;3
625;19.09.2017;2017;09;06;Tiistai;1;2;3
625;19.09.2017;2017;09;07;Tiistai;11;6;17
625;19.09.2017;2017;09;08;Tiistai;71;40;111
625;19.09.2017;2017;09;09;Tiistai;41;16;57
625;19.09.2017;2017;09;10;Tiistai;30;9;39
625;19.09.2017;2017;09;11;Tiistai;9;11;20
625;19.09.2017;2017;09;12;Tiistai;8;9;17
625;19.09.2017;2017;09;13;Tiistai;8;9;17
625;19.09.2017;2017;09;14;Tiistai;11;31;42
625;19.09.2017;2017;09;15;Tiistai;20;32;52
625;19.09.2017;2017;09;16;Tiistai;27;44;71
625;19.09.2017;2017;09;17;Tiistai;18;47;65
625;19.09.2017;2017;09;18;Tiistai;15;15;30
625;19.09.2017;2017;09;19;Tiistai;12;11;23
625;19.09.2017;2017;09;20;Tiistai;6;7;13
625;19.09.2017;2017;09;21;Tiistai;11;10;21
625;19.09.2017;2017;09;22;Tiistai;5;7;12
625;19.09.2017;2017;09;23;Tiistai;2;0;2
625;20.09.2017;2017;09;00;Keskiviikko;0;0;0
625;20.09.2017;2017;09;01;Keskiviikko;0;0;0
625;20.09.2017;2017;09;02;Keskiviikko;0;0;0
625;20.09.2017;2017;09;03;Keskiviikko;0;0;0
625;20.09.2017;2017;09;04;Keskiviikko;0;0;0
625;20.09.2017;2017;09;05;Keskiviikko;0;3;3
625;20.09.2017;2017;09;06;Keskiviikko;2;1;3
625;20.09.2017;2017;09;07;Keskiviikko;14;7;21
625;20.09.2017;2017;09;08;Keskiviikko;84;35;119
625;20.09.2017;2017;09;09;Keskiviikko;33;19;52
625;20.09.2017;2017;09;10;Keskiviikko;12;7;19
625;20.09.2017;2017;09;11;Keskiviikko;15;5;20
625;20.09.2017;2017;09;12;Keskiviikko;16;12;28
625;20.09.2017;2017;09;13;Keskiviikko;16;26;42
625;20.09.2017;2017;09;14;Keskiviikko;13;27;40
625;20.09.2017;2017;09;15;Keskiviikko;19;49;68
625;20.09.2017;2017;09;16;Keskiviikko;20;38;58
625;20.09.2017;2017;09;17;Keskiviikko;32;48;80
625;20.09.2017;2017;09;18;Keskiviikko;14;16;30
625;20.09.2017;2017;09;19;Keskiviikko;16;19;35
625;20.09.2017;2017;09;20;Keskiviikko;12;17;29
625;20.09.2017;2017;09;21;Keskiviikko;9;6;15
625;20.09.2017;2017;09;22;Keskiviikko;6;10;16
625;20.09.2017;2017;09;23;Keskiviikko;1;4;5
625;21.09.2017;2017;09;00;Torstai;0;0;0
625;21.09.2017;2017;09;01;Torstai;0;0;0
625;21.09.2017;2017;09;02;Torstai;0;0;0
625;21.09.2017;2017;09;03;Torstai;1;0;1
625;21.09.2017;2017;09;04;Torstai;0;0;0
625;21.09.2017;2017;09;05;Torstai;0;1;1
625;21.09.2017;2017;09;06;Torstai;1;3;4
625;21.09.2017;2017;09;07;Torstai;13;6;19
625;21.09.2017;2017;09;08;Torstai;72;36;108
625;21.09.2017;2017;09;09;Torstai;57;22;79
625;21.09.2017;2017;09;10;Torstai;18;8;26
625;21.09.2017;2017;09;11;Torstai;12;8;20
625;21.09.2017;2017;09;12;Torstai;10;15;25
625;21.09.2017;2017;09;13;Torstai;12;26;38
625;21.09.2017;2017;09;14;Torstai;8;34;42
625;21.09.2017;2017;09;15;Torstai;19;47;66
625;21.09.2017;2017;09;16;Torstai;26;46;72
625;21.09.2017;2017;09;17;Torstai;28;43;71
625;21.09.2017;2017;09;18;Torstai;13;12;25
625;21.09.2017;2017;09;19;Torstai;6;8;14
625;21.09.2017;2017;09;20;Torstai;10;17;27
625;21.09.2017;2017;09;21;Torstai;8;3;11
625;21.09.2017;2017;09;22;Torstai;2;6;8
625;21.09.2017;2017;09;23;Torstai;1;2;3
625;22.09.2017;2017;09;00;Perjantai;2;1;3
625;22.09.2017;2017;09;01;Perjantai;2;2;4
625;22.09.2017;2017;09;02;Perjantai;0;0;0
625;22.09.2017;2017;09;03;Perjantai;0;0;0
625;22.09.2017;2017;09;04;Perjantai;0;0;0
625;22.09.2017;2017;09;05;Perjantai;0;0;0
625;22.09.2017;2017;09;06;Perjantai;1;1;2
625;22.09.2017;2017;09;07;Perjantai;12;5;17
625;22.09.2017;2017;09;08;Perjantai;72;39;111
625;22.09.2017;2017;09;09;Perjantai;38;19;57
625;22.09.2017;2017;09;10;Perjantai;18;10;28
625;22.09.2017;2017;09;11;Perjantai;9;8;17
625;22.09.2017;2017;09;12;Perjantai;11;15;26
625;22.09.2017;2017;09;13;Perjantai;12;29;41
625;22.09.2017;2017;09;14;Perjantai;12;53;65
625;22.09.2017;2017;09;15;Perjantai;20;40;60
625;22.09.2017;2017;09;16;Perjantai;24;45;69
625;22.09.2017;2017;09;17;Perjantai;18;26;44
625;22.09.2017;2017;09;18;Perjantai;19;22;41
625;22.09.2017;2017;09;19;Perjantai;7;18;25
625;22.09.2017;2017;09;20;Perjantai;9;12;21
625;22.09.2017;2017;09;21;Perjantai;5;4;9
625;22.09.2017;2017;09;22;Perjantai;2;5;7
625;22.09.2017;2017;09;23;Perjantai;1;1;2
625;23.09.2017;2017;09;00;Lauantai;2;1;3
625;23.09.2017;2017;09;01;Lauantai;1;0;1
625;23.09.2017;2017;09;02;Lauantai;0;1;1
625;23.09.2017;2017;09;03;Lauantai;1;0;1
625;23.09.2017;2017;09;04;Lauantai;0;2;2
625;23.09.2017;2017;09;05;Lauantai;1;1;2
625;23.09.2017;2017;09;06;Lauantai;1;0;1
625;23.09.2017;2017;09;07;Lauantai;1;1;2
625;23.09.2017;2017;09;08;Lauantai;1;2;3
625;23.09.2017;2017;09;09;Lauantai;5;2;7
625;23.09.2017;2017;09;10;Lauantai;9;10;19
625;23.09.2017;2017;09;11;Lauantai;13;9;22
625;23.09.2017;2017;09;12;Lauantai;14;11;25
625;23.09.2017;2017;09;13;Lauantai;15;18;33
625;23.09.2017;2017;09;14;Lauantai;15;23;38
625;23.09.2017;2017;09;15;Lauantai;13;16;29
625;23.09.2017;2017;09;16;Lauantai;8;10;18
625;23.09.2017;2017;09;17;Lauantai;14;18;32
625;23.09.2017;2017;09;18;Lauantai;10;10;20
625;23.09.2017;2017;09;19;Lauantai;5;10;15
625;23.09.2017;2017;09;20;Lauantai;9;11;20
625;23.09.2017;2017;09;21;Lauantai;10;5;15
625;23.09.2017;2017;09;22;Lauantai;6;5;11
625;23.09.2017;2017;09;23;Lauantai;2;2;4
625;24.09.2017;2017;09;00;Sunnuntai;1;3;4
625;24.09.2017;2017;09;01;Sunnuntai;1;2;3
625;24.09.2017;2017;09;02;Sunnuntai;1;1;2
625;24.09.2017;2017;09;03;Sunnuntai;0;0;0
625;24.09.2017;2017;09;04;Sunnuntai;0;0;0
625;24.09.2017;2017;09;05;Sunnuntai;0;2;2
625;24.09.2017;2017;09;06;Sunnuntai;0;0;0
625;24.09.2017;2017;09;07;Sunnuntai;2;2;4
625;24.09.2017;2017;09;08;Sunnuntai;0;2;2
625;24.09.2017;2017;09;09;Sunnuntai;2;0;2
625;24.09.2017;2017;09;10;Sunnuntai;8;2;10
625;24.09.2017;2017;09;11;Sunnuntai;9;7;16
625;24.09.2017;2017;09;12;Sunnuntai;11;8;19
625;24.09.2017;2017;09;13;Sunnuntai;17;17;34
625;24.09.2017;2017;09;14;Sunnuntai;12;15;27
625;24.09.2017;2017;09;15;Sunnuntai;9;20;29
625;24.09.2017;2017;09;16;Sunnuntai;7;20;27
625;24.09.2017;2017;09;17;Sunnuntai;14;11;25
625;24.09.2017;2017;09;18;Sunnuntai;9;8;17
625;24.09.2017;2017;09;19;Sunnuntai;6;9;15
625;24.09.2017;2017;09;20;Sunnuntai;10;6;16
625;24.09.2017;2017;09;21;Sunnuntai;8;9;17
625;24.09.2017;2017;09;22;Sunnuntai;2;2;4
625;24.09.2017;2017;09;23;Sunnuntai;1;2;3
625;25.09.2017;2017;09;00;Maanantai;0;0;0
625;25.09.2017;2017;09;01;Maanantai;1;0;1
625;25.09.2017;2017;09;02;Maanantai;0;0;0
625;25.09.2017;2017;09;03;Maanantai;0;0;0
625;25.09.2017;2017;09;04;Maanantai;0;1;1
625;25.09.2017;2017;09;05;Maanantai;0;0;0
625;25.09.2017;2017;09;06;Maanantai;3;5;8
625;25.09.2017;2017;09;07;Maanantai;25;8;33
625;25.09.2017;2017;09;08;Maanantai;64;27;91
625;25.09.2017;2017;09;09;Maanantai;49;26;75
625;25.09.2017;2017;09;10;Maanantai;19;12;31
625;25.09.2017;2017;09;11;Maanantai;17;8;25
625;25.09.2017;2017;09;12;Maanantai;12;8;20
625;25.09.2017;2017;09;13;Maanantai;17;21;38
625;25.09.2017;2017;09;14;Maanantai;21;41;62
625;25.09.2017;2017;09;15;Maanantai;20;51;71
625;25.09.2017;2017;09;16;Maanantai;15;62;77
625;25.09.2017;2017;09;17;Maanantai;38;54;92
625;25.09.2017;2017;09;18;Maanantai;26;19;45
625;25.09.2017;2017;09;19;Maanantai;10;24;34
625;25.09.2017;2017;09;20;Maanantai;18;16;34
625;25.09.2017;2017;09;21;Maanantai;5;13;18
625;25.09.2017;2017;09;22;Maanantai;9;7;16
625;25.09.2017;2017;09;23;Maanantai;1;1;2
625;26.09.2017;2017;09;00;Tiistai;3;0;3
625;26.09.2017;2017;09;01;Tiistai;0;0;0
625;26.09.2017;2017;09;02;Tiistai;0;0;0
625;26.09.2017;2017;09;03;Tiistai;0;0;0
625;26.09.2017;2017;09;04;Tiistai;0;0;0
625;26.09.2017;2017;09;05;Tiistai;0;0;0
625;26.09.2017;2017;09;06;Tiistai;3;2;5
625;26.09.2017;2017;09;07;Tiistai;18;5;23
625;26.09.2017;2017;09;08;Tiistai;70;39;109
625;26.09.2017;2017;09;09;Tiistai;50;20;70
625;26.09.2017;2017;09;10;Tiistai;34;14;48
625;26.09.2017;2017;09;11;Tiistai;12;8;20
625;26.09.2017;2017;09;12;Tiistai;12;17;29
625;26.09.2017;2017;09;13;Tiistai;12;11;23
625;26.09.2017;2017;09;14;Tiistai;12;29;41
625;26.09.2017;2017;09;15;Tiistai;13;47;60
625;26.09.2017;2017;09;16;Tiistai;21;49;70
625;26.09.2017;2017;09;17;Tiistai;36;54;90
625;26.09.2017;2017;09;18;Tiistai;18;19;37
625;26.09.2017;2017;09;19;Tiistai;15;15;30
625;26.09.2017;2017;09;20;Tiistai;9;13;22
625;26.09.2017;2017;09;21;Tiistai;4;6;10
625;26.09.2017;2017;09;22;Tiistai;1;6;7
625;26.09.2017;2017;09;23;Tiistai;6;2;8
625;27.09.2017;2017;09;00;Keskiviikko;0;0;0
625;27.09.2017;2017;09;01;Keskiviikko;1;0;1
625;27.09.2017;2017;09;02;Keskiviikko;0;0;0
625;27.09.2017;2017;09;03;Keskiviikko;0;0;0
625;27.09.2017;2017;09;04;Keskiviikko;1;0;1
625;27.09.2017;2017;09;05;Keskiviikko;0;0;0
625;27.09.2017;2017;09;06;Keskiviikko;3;2;5
625;27.09.2017;2017;09;07;Keskiviikko;17;6;23
625;27.09.2017;2017;09;08;Keskiviikko;88;44;132
625;27.09.2017;2017;09;09;Keskiviikko;42;17;59
625;27.09.2017;2017;09;10;Keskiviikko;12;9;21
625;27.09.2017;2017;09;11;Keskiviikko;10;14;24
625;27.09.2017;2017;09;12;Keskiviikko;9;13;22
625;27.09.2017;2017;09;13;Keskiviikko;19;30;49
625;27.09.2017;2017;09;14;Keskiviikko;15;41;56
625;27.09.2017;2017;09;15;Keskiviikko;17;50;67
625;27.09.2017;2017;09;16;Keskiviikko;17;42;59
625;27.09.2017;2017;09;17;Keskiviikko;23;39;62
625;27.09.2017;2017;09;18;Keskiviikko;19;12;31
625;27.09.2017;2017;09;19;Keskiviikko;11;16;27
625;27.09.2017;2017;09;20;Keskiviikko;8;18;26
625;27.09.2017;2017;09;21;Keskiviikko;10;6;16
625;27.09.2017;2017;09;22;Keskiviikko;5;6;11
625;27.09.2017;2017;09;23;Keskiviikko;4;4;8
625;28.09.2017;2017;09;00;Torstai;0;0;0
625;28.09.2017;2017;09;01;Torstai;0;0;0
625;28.09.2017;2017;09;02;Torstai;0;0;0
625;28.09.2017;2017;09;03;Torstai;0;0;0
625;28.09.2017;2017;09;04;Torstai;0;1;1
625;28.09.2017;2017;09;05;Torstai;0;0;0
625;28.09.2017;2017;09;06;Torstai;5;5;10
625;28.09.2017;2017;09;07;Torstai;13;9;22
625;28.09.2017;2017;09;08;Torstai;80;33;113
625;28.09.2017;2017;09;09;Torstai;33;21;54
625;28.09.2017;2017;09;10;Torstai;19;11;30
625;28.09.2017;2017;09;11;Torstai;11;5;16
625;28.09.2017;2017;09;12;Torstai;24;13;37
625;28.09.2017;2017;09;13;Torstai;16;31;47
625;28.09.2017;2017;09;14;Torstai;12;35;47
625;28.09.2017;2017;09;15;Torstai;20;51;71
625;28.09.2017;2017;09;16;Torstai;15;22;37
625;28.09.2017;2017;09;17;Torstai;39;48;87
625;28.09.2017;2017;09;18;Torstai;25;13;38
625;28.09.2017;2017;09;19;Torstai;9;10;19
625;28.09.2017;2017;09;20;Torstai;6;9;15
625;28.09.2017;2017;09;21;Torstai;7;14;21
625;28.09.2017;2017;09;22;Torstai;2;2;4
625;28.09.2017;2017;09;23;Torstai;1;4;5
625;29.09.2017;2017;09;00;Perjantai;0;1;1
625;29.09.2017;2017;09;01;Perjantai;0;0;0
625;29.09.2017;2017;09;02;Perjantai;0;0;0
625;29.09.2017;2017;09;03;Perjantai;1;1;2
625;29.09.2017;2017;09;04;Perjantai;0;0;0
625;29.09.2017;2017;09;05;Perjantai;1;0;1
625;29.09.2017;2017;09;06;Perjantai;2;2;4
625;29.09.2017;2017;09;07;Perjantai;8;5;13
625;29.09.2017;2017;09;08;Perjantai;66;25;91
625;29.09.2017;2017;09;09;Perjantai;51;35;86
625;29.09.2017;2017;09;10;Perjantai;11;13;24
625;29.09.2017;2017;09;11;Perjantai;19;15;34
625;29.09.2017;2017;09;12;Perjantai;28;29;57
625;29.09.2017;2017;09;13;Perjantai;13;30;43
625;29.09.2017;2017;09;14;Perjantai;22;51;73
625;29.09.2017;2017;09;15;Perjantai;9;31;40
625;29.09.2017;2017;09;16;Perjantai;17;25;42
625;29.09.2017;2017;09;17;Perjantai;18;22;40
625;29.09.2017;2017;09;18;Perjantai;13;6;19
625;29.09.2017;2017;09;19;Perjantai;7;14;21
625;29.09.2017;2017;09;20;Perjantai;6;5;11
625;29.09.2017;2017;09;21;Perjantai;3;4;7
625;29.09.2017;2017;09;22;Perjantai;4;7;11
625;29.09.2017;2017;09;23;Perjantai;3;2;5
625;30.09.2017;2017;09;00;Lauantai;1;3;4
625;30.09.2017;2017;09;01;Lauantai;0;0;0
625;30.09.2017;2017;09;02;Lauantai;1;1;2
625;30.09.2017;2017;09;03;Lauantai;0;0;0
625;30.09.2017;2017;09;04;Lauantai;0;0;0
625;30.09.2017;2017;09;05;Lauantai;0;1;1
625;30.09.2017;2017;09;06;Lauantai;0;2;2
625;30.09.2017;2017;09;07;Lauantai;1;1;2
625;30.09.2017;2017;09;08;Lauantai;1;3;4
625;30.09.2017;2017;09;09;Lauantai;1;0;1
625;30.09.2017;2017;09;10;Lauantai;4;2;6
625;30.09.2017;2017;09;11;Lauantai;4;6;10
625;30.09.2017;2017;09;12;Lauantai;6;9;15
625;30.09.2017;2017;09;13;Lauantai;6;6;12
625;30.09.2017;2017;09;14;Lauantai;3;4;7
625;30.09.2017;2017;09;15;Lauantai;7;13;20
625;30.09.2017;2017;09;16;Lauantai;7;10;17
625;30.09.2017;2017;09;17;Lauantai;7;10;17
625;30.09.2017;2017;09;18;Lauantai;6;9;15
625;30.09.2017;2017;09;19;Lauantai;9;18;27
625;30.09.2017;2017;09;20;Lauantai;6;9;15
625;30.09.2017;2017;09;21;Lauantai;9;5;14
625;30.09.2017;2017;09;22;Lauantai;5;6;11
625;30.09.2017;2017;09;23;Lauantai;3;0;3
625;01.10.2017;2017;10;00;Sunnuntai;3;2;5
625;01.10.2017;2017;10;01;Sunnuntai;2;2;4
625;01.10.2017;2017;10;02;Sunnuntai;0;0;0
625;01.10.2017;2017;10;03;Sunnuntai;0;2;2
625;01.10.2017;2017;10;04;Sunnuntai;0;0;0
625;01.10.2017;2017;10;05;Sunnuntai;0;0;0
625;01.10.2017;2017;10;06;Sunnuntai;0;0;0
625;01.10.2017;2017;10;07;Sunnuntai;0;2;2
625;01.10.2017;2017;10;08;Sunnuntai;1;1;2
625;01.10.2017;2017;10;09;Sunnuntai;0;1;1
625;01.10.2017;2017;10;10;Sunnuntai;2;6;8
625;01.10.2017;2017;10;11;Sunnuntai;5;6;11
625;01.10.2017;2017;10;12;Sunnuntai;4;7;11
625;01.10.2017;2017;10;13;Sunnuntai;14;20;34
625;01.10.2017;2017;10;14;Sunnuntai;15;7;22
625;01.10.2017;2017;10;15;Sunnuntai;7;9;16
625;01.10.2017;2017;10;16;Sunnuntai;9;8;17
625;01.10.2017;2017;10;17;Sunnuntai;12;7;19
625;01.10.2017;2017;10;18;Sunnuntai;6;21;27
625;01.10.2017;2017;10;19;Sunnuntai;7;12;19
625;01.10.2017;2017;10;20;Sunnuntai;8;3;11
625;01.10.2017;2017;10;21;Sunnuntai;4;3;7
625;01.10.2017;2017;10;22;Sunnuntai;1;3;4
625;01.10.2017;2017;10;23;Sunnuntai;3;1;4
625;02.10.2017;2017;10;00;Maanantai;2;2;4
625;02.10.2017;2017;10;01;Maanantai;0;0;0
625;02.10.2017;2017;10;02;Maanantai;0;0;0
625;02.10.2017;2017;10;03;Maanantai;0;0;0
625;02.10.2017;2017;10;04;Maanantai;0;0;0
625;02.10.2017;2017;10;05;Maanantai;0;2;2
625;02.10.2017;2017;10;06;Maanantai;3;2;5
625;02.10.2017;2017;10;07;Maanantai;13;2;15
625;02.10.2017;2017;10;08;Maanantai;53;33;86
625;02.10.2017;2017;10;09;Maanantai;27;14;41
625;02.10.2017;2017;10;10;Maanantai;24;11;35
625;02.10.2017;2017;10;11;Maanantai;14;3;17
625;02.10.2017;2017;10;12;Maanantai;7;14;21
625;02.10.2017;2017;10;13;Maanantai;16;16;32
625;02.10.2017;2017;10;14;Maanantai;10;26;36
625;02.10.2017;2017;10;15;Maanantai;16;53;69
625;02.10.2017;2017;10;16;Maanantai;16;46;62
625;02.10.2017;2017;10;17;Maanantai;36;43;79
625;02.10.2017;2017;10;18;Maanantai;19;12;31
625;02.10.2017;2017;10;19;Maanantai;12;22;34
625;02.10.2017;2017;10;20;Maanantai;11;20;31
625;02.10.2017;2017;10;21;Maanantai;3;9;12
625;02.10.2017;2017;10;22;Maanantai;5;4;9
625;02.10.2017;2017;10;23;Maanantai;2;4;6
625;03.10.2017;2017;10;00;Tiistai;1;1;2
625;03.10.2017;2017;10;01;Tiistai;0;0;0
625;03.10.2017;2017;10;02;Tiistai;0;0;0
625;03.10.2017;2017;10;03;Tiistai;0;0;0
625;03.10.2017;2017;10;04;Tiistai;0;0;0
625;03.10.2017;2017;10;05;Tiistai;1;2;3
625;03.10.2017;2017;10;06;Tiistai;1;1;2
625;03.10.2017;2017;10;07;Tiistai;14;4;18
625;03.10.2017;2017;10;08;Tiistai;60;32;92
625;03.10.2017;2017;10;09;Tiistai;45;21;66
625;03.10.2017;2017;10;10;Tiistai;14;9;23
625;03.10.2017;2017;10;11;Tiistai;8;5;13
625;03.10.2017;2017;10;12;Tiistai;9;14;23
625;03.10.2017;2017;10;13;Tiistai;5;8;13
625;03.10.2017;2017;10;14;Tiistai;10;32;42
625;03.10.2017;2017;10;15;Tiistai;16;53;69
625;03.10.2017;2017;10;16;Tiistai;18;33;51
625;03.10.2017;2017;10;17;Tiistai;18;40;58
625;03.10.2017;2017;10;18;Tiistai;18;11;29
625;03.10.2017;2017;10;19;Tiistai;7;13;20
625;03.10.2017;2017;10;20;Tiistai;5;10;15
625;03.10.2017;2017;10;21;Tiistai;3;4;7
625;03.10.2017;2017;10;22;Tiistai;1;2;3
625;03.10.2017;2017;10;23;Tiistai;3;3;6
625;04.10.2017;2017;10;00;Keskiviikko;0;0;0
625;04.10.2017;2017;10;01;Keskiviikko;0;0;0
625;04.10.2017;2017;10;02;Keskiviikko;0;0;0
625;04.10.2017;2017;10;03;Keskiviikko;1;0;1
625;04.10.2017;2017;10;04;Keskiviikko;0;0;0
625;04.10.2017;2017;10;05;Keskiviikko;0;0;0
625;04.10.2017;2017;10;06;Keskiviikko;2;2;4
625;04.10.2017;2017;10;07;Keskiviikko;10;9;19
625;04.10.2017;2017;10;08;Keskiviikko;68;26;94
625;04.10.2017;2017;10;09;Keskiviikko;27;20;47
625;04.10.2017;2017;10;10;Keskiviikko;5;7;12
625;04.10.2017;2017;10;11;Keskiviikko;5;7;12
625;04.10.2017;2017;10;12;Keskiviikko;8;14;22
625;04.10.2017;2017;10;13;Keskiviikko;3;16;19
625;04.10.2017;2017;10;14;Keskiviikko;16;20;36
625;04.10.2017;2017;10;15;Keskiviikko;13;37;50
625;04.10.2017;2017;10;16;Keskiviikko;18;34;52
625;04.10.2017;2017;10;17;Keskiviikko;22;31;53
625;04.10.2017;2017;10;18;Keskiviikko;15;23;38
625;04.10.2017;2017;10;19;Keskiviikko;15;15;30
625;04.10.2017;2017;10;20;Keskiviikko;6;14;20
625;04.10.2017;2017;10;21;Keskiviikko;12;8;20
625;04.10.2017;2017;10;22;Keskiviikko;5;4;9
625;04.10.2017;2017;10;23;Keskiviikko;1;2;3
625;05.10.2017;2017;10;00;Torstai;2;0;2
625;05.10.2017;2017;10;01;Torstai;0;0;0
625;05.10.2017;2017;10;02;Torstai;0;0;0
625;05.10.2017;2017;10;03;Torstai;1;0;1
625;05.10.2017;2017;10;04;Torstai;0;0;0
625;05.10.2017;2017;10;05;Torstai;0;1;1
625;05.10.2017;2017;10;06;Torstai;2;1;3
625;05.10.2017;2017;10;07;Torstai;13;8;21
625;05.10.2017;2017;10;08;Torstai;73;31;104
625;05.10.2017;2017;10;09;Torstai;27;9;36
625;05.10.2017;2017;10;10;Torstai;11;4;15
625;05.10.2017;2017;10;11;Torstai;4;4;8
625;05.10.2017;2017;10;12;Torstai;4;11;15
625;05.10.2017;2017;10;13;Torstai;10;16;26
625;05.10.2017;2017;10;14;Torstai;10;21;31
625;05.10.2017;2017;10;15;Torstai;15;47;62
625;05.10.2017;2017;10;16;Torstai;11;18;29
625;05.10.2017;2017;10;17;Torstai;23;30;53
625;05.10.2017;2017;10;18;Torstai;11;14;25
625;05.10.2017;2017;10;19;Torstai;10;10;20
625;05.10.2017;2017;10;20;Torstai;11;15;26
625;05.10.2017;2017;10;21;Torstai;5;6;11
625;05.10.2017;2017;10;22;Torstai;2;6;8
625;05.10.2017;2017;10;23;Torstai;4;1;5
625;06.10.2017;2017;10;00;Perjantai;2;0;2
625;06.10.2017;2017;10;01;Perjantai;0;1;1
625;06.10.2017;2017;10;02;Perjantai;0;1;1
625;06.10.2017;2017;10;03;Perjantai;0;1;1
625;06.10.2017;2017;10;04;Perjantai;0;0;0
625;06.10.2017;2017;10;05;Perjantai;1;0;1
625;06.10.2017;2017;10;06;Perjantai;0;1;1
625;06.10.2017;2017;10;07;Perjantai;18;9;27
625;06.10.2017;2017;10;08;Perjantai;60;31;91
625;06.10.2017;2017;10;09;Perjantai;38;16;54
625;06.10.2017;2017;10;10;Perjantai;12;9;21
625;06.10.2017;2017;10;11;Perjantai;10;15;25
625;06.10.2017;2017;10;12;Perjantai;9;12;21
625;06.10.2017;2017;10;13;Perjantai;11;27;38
625;06.10.2017;2017;10;14;Perjantai;13;43;56
625;06.10.2017;2017;10;15;Perjantai;11;29;40
625;06.10.2017;2017;10;16;Perjantai;19;26;45
625;06.10.2017;2017;10;17;Perjantai;18;25;43
625;06.10.2017;2017;10;18;Perjantai;6;14;20
625;06.10.2017;2017;10;19;Perjantai;7;6;13
625;06.10.2017;2017;10;20;Perjantai;9;5;14
625;06.10.2017;2017;10;21;Perjantai;6;7;13
625;06.10.2017;2017;10;22;Perjantai;2;4;6
625;06.10.2017;2017;10;23;Perjantai;4;2;6
625;07.10.2017;2017;10;00;Lauantai;3;0;3
625;07.10.2017;2017;10;01;Lauantai;1;0;1
625;07.10.2017;2017;10;02;Lauantai;0;0;0
625;07.10.2017;2017;10;03;Lauantai;2;0;2
625;07.10.2017;2017;10;04;Lauantai;1;1;2
625;07.10.2017;2017;10;05;Lauantai;1;0;1
625;07.10.2017;2017;10;06;Lauantai;1;0;1
625;07.10.2017;2017;10;07;Lauantai;1;0;1
625;07.10.2017;2017;10;08;Lauantai;0;4;4
625;07.10.2017;2017;10;09;Lauantai;2;0;2
625;07.10.2017;2017;10;10;Lauantai;0;0;0
625;07.10.2017;2017;10;11;Lauantai;4;2;6
625;07.10.2017;2017;10;12;Lauantai;6;5;11
625;07.10.2017;2017;10;13;Lauantai;8;11;19
625;07.10.2017;2017;10;14;Lauantai;6;6;12
625;07.10.2017;2017;10;15;Lauantai;4;7;11
625;07.10.2017;2017;10;16;Lauantai;1;5;6
625;07.10.2017;2017;10;17;Lauantai;7;5;12
625;07.10.2017;2017;10;18;Lauantai;5;7;12
625;07.10.2017;2017;10;19;Lauantai;2;8;10
625;07.10.2017;2017;10;20;Lauantai;4;2;6
625;07.10.2017;2017;10;21;Lauantai;3;3;6
625;07.10.2017;2017;10;22;Lauantai;1;4;5
625;07.10.2017;2017;10;23;Lauantai;1;1;2
625;08.10.2017;2017;10;00;Sunnuntai;1;5;6
625;08.10.2017;2017;10;01;Sunnuntai;2;2;4
625;08.10.2017;2017;10;02;Sunnuntai;0;0;0
625;08.10.2017;2017;10;03;Sunnuntai;0;0;0
625;08.10.2017;2017;10;04;Sunnuntai;1;0;1
625;08.10.2017;2017;10;05;Sunnuntai;0;0;0
625;08.10.2017;2017;10;06;Sunnuntai;0;0;0
625;08.10.2017;2017;10;07;Sunnuntai;2;1;3
625;08.10.2017;2017;10;08;Sunnuntai;0;3;3
625;08.10.2017;2017;10;09;Sunnuntai;1;0;1
625;08.10.2017;2017;10;10;Sunnuntai;2;5;7
625;08.10.2017;2017;10;11;Sunnuntai;6;6;12
625;08.10.2017;2017;10;12;Sunnuntai;12;7;19
625;08.10.2017;2017;10;13;Sunnuntai;14;15;29
625;08.10.2017;2017;10;14;Sunnuntai;15;21;36
625;08.10.2017;2017;10;15;Sunnuntai;16;27;43
625;08.10.2017;2017;10;16;Sunnuntai;13;21;34
625;08.10.2017;2017;10;17;Sunnuntai;12;7;19
625;08.10.2017;2017;10;18;Sunnuntai;15;25;40
625;08.10.2017;2017;10;19;Sunnuntai;7;8;15
625;08.10.2017;2017;10;20;Sunnuntai;6;8;14
625;08.10.2017;2017;10;21;Sunnuntai;5;1;6
625;08.10.2017;2017;10;22;Sunnuntai;2;2;4
625;08.10.2017;2017;10;23;Sunnuntai;3;0;3
625;09.10.2017;2017;10;00;Maanantai;2;1;3
625;09.10.2017;2017;10;01;Maanantai;0;0;0
625;09.10.2017;2017;10;02;Maanantai;0;1;1
625;09.10.2017;2017;10;03;Maanantai;0;1;1
625;09.10.2017;2017;10;04;Maanantai;0;0;0
625;09.10.2017;2017;10;05;Maanantai;0;0;0
625;09.10.2017;2017;10;06;Maanantai;2;2;4
625;09.10.2017;2017;10;07;Maanantai;11;8;19
625;09.10.2017;2017;10;08;Maanantai;50;15;65
625;09.10.2017;2017;10;09;Maanantai;38;15;53
625;09.10.2017;2017;10;10;Maanantai;27;13;40
625;09.10.2017;2017;10;11;Maanantai;15;7;22
625;09.10.2017;2017;10;12;Maanantai;10;8;18
625;09.10.2017;2017;10;13;Maanantai;6;19;25
625;09.10.2017;2017;10;14;Maanantai;17;25;42
625;09.10.2017;2017;10;15;Maanantai;19;46;65
625;09.10.2017;2017;10;16;Maanantai;17;40;57
625;09.10.2017;2017;10;17;Maanantai;27;36;63
625;09.10.2017;2017;10;18;Maanantai;23;24;47
625;09.10.2017;2017;10;19;Maanantai;17;14;31
625;09.10.2017;2017;10;20;Maanantai;16;22;38
625;09.10.2017;2017;10;21;Maanantai;5;11;16
625;09.10.2017;2017;10;22;Maanantai;8;8;16
625;09.10.2017;2017;10;23;Maanantai;4;4;8
625;10.10.2017;2017;10;00;Tiistai;0;0;0
625;10.10.2017;2017;10;01;Tiistai;0;0;0
625;10.10.2017;2017;10;02;Tiistai;0;0;0
625;10.10.2017;2017;10;03;Tiistai;0;0;0
625;10.10.2017;2017;10;04;Tiistai;1;1;2
625;10.10.2017;2017;10;05;Tiistai;0;1;1
625;10.10.2017;2017;10;06;Tiistai;3;2;5
625;10.10.2017;2017;10;07;Tiistai;9;8;17
625;10.10.2017;2017;10;08;Tiistai;40;17;57
625;10.10.2017;2017;10;09;Tiistai;28;7;35
625;10.10.2017;2017;10;10;Tiistai;16;3;19
625;10.10.2017;2017;10;11;Tiistai;9;6;15
625;10.10.2017;2017;10;12;Tiistai;5;3;8
625;10.10.2017;2017;10;13;Tiistai;5;11;16
625;10.10.2017;2017;10;14;Tiistai;8;18;26
625;10.10.2017;2017;10;15;Tiistai;12;24;36
625;10.10.2017;2017;10;16;Tiistai;10;38;48
625;10.10.2017;2017;10;17;Tiistai;12;26;38
625;10.10.2017;2017;10;18;Tiistai;11;12;23
625;10.10.2017;2017;10;19;Tiistai;8;10;18
625;10.10.2017;2017;10;20;Tiistai;6;6;12
625;10.10.2017;2017;10;21;Tiistai;3;5;8
625;10.10.2017;2017;10;22;Tiistai;5;2;7
625;10.10.2017;2017;10;23;Tiistai;3;2;5
625;11.10.2017;2017;10;00;Keskiviikko;0;1;1
625;11.10.2017;2017;10;01;Keskiviikko;0;0;0
625;11.10.2017;2017;10;02;Keskiviikko;0;0;0
625;11.10.2017;2017;10;03;Keskiviikko;0;0;0
625;11.10.2017;2017;10;04;Keskiviikko;0;1;1
625;11.10.2017;2017;10;05;Keskiviikko;0;0;0
625;11.10.2017;2017;10;06;Keskiviikko;0;4;4
625;11.10.2017;2017;10;07;Keskiviikko;11;4;15
625;11.10.2017;2017;10;08;Keskiviikko;81;30;111
625;11.10.2017;2017;10;09;Keskiviikko;24;18;42
625;11.10.2017;2017;10;10;Keskiviikko;6;10;16
625;11.10.2017;2017;10;11;Keskiviikko;8;10;18
625;11.10.2017;2017;10;12;Keskiviikko;16;11;27
625;11.10.2017;2017;10;13;Keskiviikko;14;33;47
625;11.10.2017;2017;10;14;Keskiviikko;15;21;36
625;11.10.2017;2017;10;15;Keskiviikko;18;54;72
625;11.10.2017;2017;10;16;Keskiviikko;16;43;59
625;11.10.2017;2017;10;17;Keskiviikko;33;40;73
625;11.10.2017;2017;10;18;Keskiviikko;17;24;41
625;11.10.2017;2017;10;19;Keskiviikko;2;5;7
625;11.10.2017;2017;10;20;Keskiviikko;13;12;25
625;11.10.2017;2017;10;21;Keskiviikko;9;10;19
625;11.10.2017;2017;10;22;Keskiviikko;8;3;11
625;11.10.2017;2017;10;23;Keskiviikko;0;0;0
625;12.10.2017;2017;10;00;Torstai;9;6;15
625;12.10.2017;2017;10;01;Torstai;1;1;2
625;12.10.2017;2017;10;02;Torstai;0;1;1
625;12.10.2017;2017;10;03;Torstai;0;0;0
625;12.10.2017;2017;10;04;Torstai;0;0;0
625;12.10.2017;2017;10;05;Torstai;0;0;0
625;12.10.2017;2017;10;06;Torstai;4;5;9
625;12.10.2017;2017;10;07;Torstai;11;6;17
625;12.10.2017;2017;10;08;Torstai;74;31;105
625;12.10.2017;2017;10;09;Torstai;34;16;50
625;12.10.2017;2017;10;10;Torstai;14;11;25
625;12.10.2017;2017;10;11;Torstai;7;6;13
625;12.10.2017;2017;10;12;Torstai;6;12;18
625;12.10.2017;2017;10;13;Torstai;13;22;35
625;12.10.2017;2017;10;14;Torstai;11;27;38
625;12.10.2017;2017;10;15;Torstai;14;53;67
625;12.10.2017;2017;10;16;Torstai;19;47;66
625;12.10.2017;2017;10;17;Torstai;28;44;72
625;12.10.2017;2017;10;18;Torstai;21;15;36
625;12.10.2017;2017;10;19;Torstai;12;8;20
625;12.10.2017;2017;10;20;Torstai;5;12;17
625;12.10.2017;2017;10;21;Torstai;6;11;17
625;12.10.2017;2017;10;22;Torstai;3;4;7
625;12.10.2017;2017;10;23;Torstai;3;1;4
625;13.10.2017;2017;10;00;Perjantai;0;0;0
625;13.10.2017;2017;10;01;Perjantai;0;1;1
625;13.10.2017;2017;10;02;Perjantai;0;0;0
625;13.10.2017;2017;10;03;Perjantai;0;0;0
625;13.10.2017;2017;10;04;Perjantai;0;0;0
625;13.10.2017;2017;10;05;Perjantai;0;0;0
625;13.10.2017;2017;10;06;Perjantai;3;5;8
625;13.10.2017;2017;10;07;Perjantai;10;8;18
625;13.10.2017;2017;10;08;Perjantai;81;35;116
625;13.10.2017;2017;10;09;Perjantai;39;13;52
625;13.10.2017;2017;10;10;Perjantai;12;8;20
625;13.10.2017;2017;10;11;Perjantai;11;8;19
625;13.10.2017;2017;10;12;Perjantai;13;19;32
625;13.10.2017;2017;10;13;Perjantai;12;29;41
625;13.10.2017;2017;10;14;Perjantai;13;37;50
625;13.10.2017;2017;10;15;Perjantai;14;31;45
625;13.10.2017;2017;10;16;Perjantai;31;30;61
625;13.10.2017;2017;10;17;Perjantai;27;23;50
625;13.10.2017;2017;10;18;Perjantai;14;13;27
625;13.10.2017;2017;10;19;Perjantai;7;5;12
625;13.10.2017;2017;10;20;Perjantai;4;5;9
625;13.10.2017;2017;10;21;Perjantai;4;11;15
625;13.10.2017;2017;10;22;Perjantai;9;6;15
625;13.10.2017;2017;10;23;Perjantai;2;4;6
625;14.10.2017;2017;10;00;Lauantai;1;0;1
625;14.10.2017;2017;10;01;Lauantai;1;2;3
625;14.10.2017;2017;10;02;Lauantai;0;0;0
625;14.10.2017;2017;10;03;Lauantai;0;1;1
625;14.10.2017;2017;10;04;Lauantai;0;0;0
625;14.10.2017;2017;10;05;Lauantai;0;0;0
625;14.10.2017;2017;10;06;Lauantai;0;1;1
625;14.10.2017;2017;10;07;Lauantai;0;2;2
625;14.10.2017;2017;10;08;Lauantai;0;1;1
625;14.10.2017;2017;10;09;Lauantai;1;1;2
625;14.10.2017;2017;10;10;Lauantai;2;2;4
625;14.10.2017;2017;10;11;Lauantai;5;1;6
625;14.10.2017;2017;10;12;Lauantai;5;7;12
625;14.10.2017;2017;10;13;Lauantai;7;12;19
625;14.10.2017;2017;10;14;Lauantai;11;10;21
625;14.10.2017;2017;10;15;Lauantai;8;5;13
625;14.10.2017;2017;10;16;Lauantai;7;7;14
625;14.10.2017;2017;10;17;Lauantai;7;8;15
625;14.10.2017;2017;10;18;Lauantai;5;5;10
625;14.10.2017;2017;10;19;Lauantai;3;6;9
625;14.10.2017;2017;10;20;Lauantai;5;6;11
625;14.10.2017;2017;10;21;Lauantai;5;6;11
625;14.10.2017;2017;10;22;Lauantai;3;4;7
625;14.10.2017;2017;10;23;Lauantai;3;3;6
625;15.10.2017;2017;10;00;Sunnuntai;2;0;2
625;15.10.2017;2017;10;01;Sunnuntai;2;1;3
625;15.10.2017;2017;10;02;Sunnuntai;1;0;1
625;15.10.2017;2017;10;03;Sunnuntai;0;0;0
625;15.10.2017;2017;10;04;Sunnuntai;0;0;0
625;15.10.2017;2017;10;05;Sunnuntai;1;0;1
625;15.10.2017;2017;10;06;Sunnuntai;1;0;1
625;15.10.2017;2017;10;07;Sunnuntai;1;1;2
625;15.10.2017;2017;10;08;Sunnuntai;3;3;6
625;15.10.2017;2017;10;09;Sunnuntai;0;3;3
625;15.10.2017;2017;10;10;Sunnuntai;2;1;3
625;15.10.2017;2017;10;11;Sunnuntai;7;3;10
625;15.10.2017;2017;10;12;Sunnuntai;10;11;21
625;15.10.2017;2017;10;13;Sunnuntai;9;6;15
625;15.10.2017;2017;10;14;Sunnuntai;8;15;23
625;15.10.2017;2017;10;15;Sunnuntai;6;11;17
625;15.10.2017;2017;10;16;Sunnuntai;15;13;28
625;15.10.2017;2017;10;17;Sunnuntai;15;13;28
625;15.10.2017;2017;10;18;Sunnuntai;16;14;30
625;15.10.2017;2017;10;19;Sunnuntai;2;11;13
625;15.10.2017;2017;10;20;Sunnuntai;7;10;17
625;15.10.2017;2017;10;21;Sunnuntai;7;6;13
625;15.10.2017;2017;10;22;Sunnuntai;3;2;5
625;15.10.2017;2017;10;23;Sunnuntai;1;2;3
625;16.10.2017;2017;10;00;Maanantai;0;0;0
625;16.10.2017;2017;10;01;Maanantai;0;3;3
625;16.10.2017;2017;10;02;Maanantai;1;0;1
625;16.10.2017;2017;10;03;Maanantai;0;0;0
625;16.10.2017;2017;10;04;Maanantai;0;1;1
625;16.10.2017;2017;10;05;Maanantai;1;0;1
625;16.10.2017;2017;10;06;Maanantai;3;3;6
625;16.10.2017;2017;10;07;Maanantai;12;5;17
625;16.10.2017;2017;10;08;Maanantai;51;25;76
625;16.10.2017;2017;10;09;Maanantai;22;11;33
625;16.10.2017;2017;10;10;Maanantai;18;4;22
625;16.10.2017;2017;10;11;Maanantai;2;4;6
625;16.10.2017;2017;10;12;Maanantai;5;7;12
625;16.10.2017;2017;10;13;Maanantai;10;10;20
625;16.10.2017;2017;10;14;Maanantai;12;33;45
625;16.10.2017;2017;10;15;Maanantai;5;28;33
625;16.10.2017;2017;10;16;Maanantai;13;31;44
625;16.10.2017;2017;10;17;Maanantai;16;26;42
625;16.10.2017;2017;10;18;Maanantai;10;24;34
625;16.10.2017;2017;10;19;Maanantai;7;11;18
625;16.10.2017;2017;10;20;Maanantai;4;6;10
625;16.10.2017;2017;10;21;Maanantai;5;9;14
625;16.10.2017;2017;10;22;Maanantai;5;6;11
625;16.10.2017;2017;10;23;Maanantai;2;3;5
625;17.10.2017;2017;10;00;Tiistai;1;1;2
625;17.10.2017;2017;10;01;Tiistai;0;0;0
625;17.10.2017;2017;10;02;Tiistai;0;0;0
625;17.10.2017;2017;10;03;Tiistai;0;0;0
625;17.10.2017;2017;10;04;Tiistai;0;1;1
625;17.10.2017;2017;10;05;Tiistai;2;1;3
625;17.10.2017;2017;10;06;Tiistai;2;1;3
625;17.10.2017;2017;10;07;Tiistai;13;4;17
625;17.10.2017;2017;10;08;Tiistai;53;26;79
625;17.10.2017;2017;10;09;Tiistai;46;17;63
625;17.10.2017;2017;10;10;Tiistai;22;12;34
625;17.10.2017;2017;10;11;Tiistai;12;10;22
625;17.10.2017;2017;10;12;Tiistai;6;14;20
625;17.10.2017;2017;10;13;Tiistai;12;15;27
625;17.10.2017;2017;10;14;Tiistai;24;42;66
625;17.10.2017;2017;10;15;Tiistai;14;42;56
625;17.10.2017;2017;10;16;Tiistai;28;40;68
625;17.10.2017;2017;10;17;Tiistai;17;37;54
625;17.10.2017;2017;10;18;Tiistai;19;22;41
625;17.10.2017;2017;10;19;Tiistai;8;14;22
625;17.10.2017;2017;10;20;Tiistai;9;10;19
625;17.10.2017;2017;10;21;Tiistai;7;9;16
625;17.10.2017;2017;10;22;Tiistai;5;10;15
625;17.10.2017;2017;10;23;Tiistai;5;4;9
625;18.10.2017;2017;10;00;Keskiviikko;2;0;2
625;18.10.2017;2017;10;01;Keskiviikko;1;0;1
625;18.10.2017;2017;10;02;Keskiviikko;0;0;0
625;18.10.2017;2017;10;03;Keskiviikko;0;0;0
625;18.10.2017;2017;10;04;Keskiviikko;1;0;1
625;18.10.2017;2017;10;05;Keskiviikko;0;0;0
625;18.10.2017;2017;10;06;Keskiviikko;2;0;2
625;18.10.2017;2017;10;07;Keskiviikko;12;10;22
625;18.10.2017;2017;10;08;Keskiviikko;72;24;96
625;18.10.2017;2017;10;09;Keskiviikko;29;14;43
625;18.10.2017;2017;10;10;Keskiviikko;26;12;38
625;18.10.2017;2017;10;11;Keskiviikko;9;10;19
625;18.10.2017;2017;10;12;Keskiviikko;13;18;31
625;18.10.2017;2017;10;13;Keskiviikko;11;17;28
625;18.10.2017;2017;10;14;Keskiviikko;9;24;33
625;18.10.2017;2017;10;15;Keskiviikko;15;39;54
625;18.10.2017;2017;10;16;Keskiviikko;9;33;42
625;18.10.2017;2017;10;17;Keskiviikko;24;40;64
625;18.10.2017;2017;10;18;Keskiviikko;10;18;28
625;18.10.2017;2017;10;19;Keskiviikko;18;10;28
625;18.10.2017;2017;10;20;Keskiviikko;8;9;17
625;18.10.2017;2017;10;21;Keskiviikko;6;7;13
625;18.10.2017;2017;10;22;Keskiviikko;5;3;8
625;18.10.2017;2017;10;23;Keskiviikko;5;3;8
625;19.10.2017;2017;10;00;Torstai;0;1;1
625;19.10.2017;2017;10;01;Torstai;2;0;2
625;19.10.2017;2017;10;02;Torstai;1;0;1
625;19.10.2017;2017;10;03;Torstai;0;0;0
625;19.10.2017;2017;10;04;Torstai;0;0;0
625;19.10.2017;2017;10;05;Torstai;0;2;2
625;19.10.2017;2017;10;06;Torstai;2;1;3
625;19.10.2017;2017;10;07;Torstai;12;6;18
625;19.10.2017;2017;10;08;Torstai;47;29;76
625;19.10.2017;2017;10;09;Torstai;32;23;55
625;19.10.2017;2017;10;10;Torstai;18;11;29
625;19.10.2017;2017;10;11;Torstai;20;8;28
625;19.10.2017;2017;10;12;Torstai;12;8;20
625;19.10.2017;2017;10;13;Torstai;15;25;40
625;19.10.2017;2017;10;14;Torstai;20;36;56
625;19.10.2017;2017;10;15;Torstai;10;30;40
625;19.10.2017;2017;10;16;Torstai;12;27;39
625;19.10.2017;2017;10;17;Torstai;22;44;66
625;19.10.2017;2017;10;18;Torstai;16;17;33
625;19.10.2017;2017;10;19;Torstai;15;13;28
625;19.10.2017;2017;10;20;Torstai;12;9;21
625;19.10.2017;2017;10;21;Torstai;5;4;9
625;19.10.2017;2017;10;22;Torstai;3;4;7
625;19.10.2017;2017;10;23;Torstai;5;7;12
625;20.10.2017;2017;10;00;Perjantai;1;0;1
625;20.10.2017;2017;10;01;Perjantai;0;0;0
625;20.10.2017;2017;10;02;Perjantai;0;0;0
625;20.10.2017;2017;10;03;Perjantai;0;0;0
625;20.10.2017;2017;10;04;Perjantai;0;0;0
625;20.10.2017;2017;10;05;Perjantai;0;1;1
625;20.10.2017;2017;10;06;Perjantai;2;1;3
625;20.10.2017;2017;10;07;Perjantai;9;8;17
625;20.10.2017;2017;10;08;Perjantai;57;24;81
625;20.10.2017;2017;10;09;Perjantai;32;13;45
625;20.10.2017;2017;10;10;Perjantai;9;9;18
625;20.10.2017;2017;10;11;Perjantai;7;10;17
625;20.10.2017;2017;10;12;Perjantai;11;15;26
625;20.10.2017;2017;10;13;Perjantai;8;20;28
625;20.10.2017;2017;10;14;Perjantai;15;31;46
625;20.10.2017;2017;10;15;Perjantai;12;31;43
625;20.10.2017;2017;10;16;Perjantai;17;22;39
625;20.10.2017;2017;10;17;Perjantai;4;20;24
625;20.10.2017;2017;10;18;Perjantai;4;3;7
625;20.10.2017;2017;10;19;Perjantai;6;11;17
625;20.10.2017;2017;10;20;Perjantai;4;2;6
625;20.10.2017;2017;10;21;Perjantai;0;0;0
625;20.10.2017;2017;10;22;Perjantai;1;3;4
625;20.10.2017;2017;10;23;Perjantai;0;1;1
625;21.10.2017;2017;10;00;Lauantai;1;2;3
625;21.10.2017;2017;10;01;Lauantai;1;2;3
625;21.10.2017;2017;10;02;Lauantai;1;1;2
625;21.10.2017;2017;10;03;Lauantai;0;0;0
625;21.10.2017;2017;10;04;Lauantai;1;0;1
625;21.10.2017;2017;10;05;Lauantai;1;0;1
625;21.10.2017;2017;10;06;Lauantai;0;1;1
625;21.10.2017;2017;10;07;Lauantai;0;0;0
625;21.10.2017;2017;10;08;Lauantai;0;2;2
625;21.10.2017;2017;10;09;Lauantai;1;0;1
625;21.10.2017;2017;10;10;Lauantai;5;2;7
625;21.10.2017;2017;10;11;Lauantai;4;1;5
625;21.10.2017;2017;10;12;Lauantai;1;2;3
625;21.10.2017;2017;10;13;Lauantai;8;4;12
625;21.10.2017;2017;10;14;Lauantai;7;7;14
625;21.10.2017;2017;10;15;Lauantai;7;12;19
625;21.10.2017;2017;10;16;Lauantai;6;6;12
625;21.10.2017;2017;10;17;Lauantai;3;3;6
625;21.10.2017;2017;10;18;Lauantai;2;4;6
625;21.10.2017;2017;10;19;Lauantai;3;3;6
625;21.10.2017;2017;10;20;Lauantai;4;6;10
625;21.10.2017;2017;10;21;Lauantai;5;3;8
625;21.10.2017;2017;10;22;Lauantai;2;3;5
625;21.10.2017;2017;10;23;Lauantai;1;1;2
625;22.10.2017;2017;10;00;Sunnuntai;1;0;1
625;22.10.2017;2017;10;01;Sunnuntai;0;0;0
625;22.10.2017;2017;10;02;Sunnuntai;0;0;0
625;22.10.2017;2017;10;03;Sunnuntai;0;0;0
625;22.10.2017;2017;10;04;Sunnuntai;1;0;1
625;22.10.2017;2017;10;05;Sunnuntai;1;0;1
625;22.10.2017;2017;10;06;Sunnuntai;0;1;1
625;22.10.2017;2017;10;07;Sunnuntai;1;0;1
625;22.10.2017;2017;10;08;Sunnuntai;0;0;0
625;22.10.2017;2017;10;09;Sunnuntai;0;1;1
625;22.10.2017;2017;10;10;Sunnuntai;3;5;8
625;22.10.2017;2017;10;11;Sunnuntai;3;4;7
625;22.10.2017;2017;10;12;Sunnuntai;6;10;16
625;22.10.2017;2017;10;13;Sunnuntai;6;5;11
625;22.10.2017;2017;10;14;Sunnuntai;6;6;12
625;22.10.2017;2017;10;15;Sunnuntai;6;6;12
625;22.10.2017;2017;10;16;Sunnuntai;12;10;22
625;22.10.2017;2017;10;17;Sunnuntai;5;11;16
625;22.10.2017;2017;10;18;Sunnuntai;9;8;17
625;22.10.2017;2017;10;19;Sunnuntai;5;6;11
625;22.10.2017;2017;10;20;Sunnuntai;5;2;7
625;22.10.2017;2017;10;21;Sunnuntai;4;2;6
625;22.10.2017;2017;10;22;Sunnuntai;2;4;6
625;22.10.2017;2017;10;23;Sunnuntai;1;1;2
625;23.10.2017;2017;10;00;Maanantai;5;1;6
625;23.10.2017;2017;10;01;Maanantai;0;1;1
625;23.10.2017;2017;10;02;Maanantai;1;0;1
625;23.10.2017;2017;10;03;Maanantai;0;0;0
625;23.10.2017;2017;10;04;Maanantai;0;0;0
625;23.10.2017;2017;10;05;Maanantai;0;1;1
625;23.10.2017;2017;10;06;Maanantai;2;1;3
625;23.10.2017;2017;10;07;Maanantai;9;3;12
625;23.10.2017;2017;10;08;Maanantai;6;9;15
625;23.10.2017;2017;10;09;Maanantai;10;4;14
625;23.10.2017;2017;10;10;Maanantai;5;2;7
625;23.10.2017;2017;10;11;Maanantai;8;3;11
625;23.10.2017;2017;10;12;Maanantai;6;6;12
625;23.10.2017;2017;10;13;Maanantai;7;4;11
625;23.10.2017;2017;10;14;Maanantai;4;4;8
625;23.10.2017;2017;10;15;Maanantai;6;9;15
625;23.10.2017;2017;10;16;Maanantai;15;20;35
625;23.10.2017;2017;10;17;Maanantai;14;12;26
625;23.10.2017;2017;10;18;Maanantai;7;10;17
625;23.10.2017;2017;10;19;Maanantai;5;7;12
625;23.10.2017;2017;10;20;Maanantai;6;9;15
625;23.10.2017;2017;10;21;Maanantai;2;6;8
625;23.10.2017;2017;10;22;Maanantai;3;3;6
625;23.10.2017;2017;10;23;Maanantai;2;1;3
625;24.10.2017;2017;10;00;Tiistai;2;0;2
625;24.10.2017;2017;10;01;Tiistai;1;0;1
625;24.10.2017;2017;10;02;Tiistai;0;0;0
625;24.10.2017;2017;10;03;Tiistai;0;0;0
625;24.10.2017;2017;10;04;Tiistai;0;0;0
625;24.10.2017;2017;10;05;Tiistai;0;0;0
625;24.10.2017;2017;10;06;Tiistai;1;4;5
625;24.10.2017;2017;10;07;Tiistai;7;4;11
625;24.10.2017;2017;10;08;Tiistai;10;11;21
625;24.10.2017;2017;10;09;Tiistai;7;2;9
625;24.10.2017;2017;10;10;Tiistai;5;3;8
625;24.10.2017;2017;10;11;Tiistai;1;1;2
625;24.10.2017;2017;10;12;Tiistai;2;5;7
625;24.10.2017;2017;10;13;Tiistai;4;8;12
625;24.10.2017;2017;10;14;Tiistai;6;1;7
625;24.10.2017;2017;10;15;Tiistai;8;6;14
625;24.10.2017;2017;10;16;Tiistai;6;18;24
625;24.10.2017;2017;10;17;Tiistai;4;10;14
625;24.10.2017;2017;10;18;Tiistai;8;5;13
625;24.10.2017;2017;10;19;Tiistai;5;7;12
625;24.10.2017;2017;10;20;Tiistai;0;1;1
625;24.10.2017;2017;10;21;Tiistai;3;2;5
625;24.10.2017;2017;10;22;Tiistai;0;0;0
625;24.10.2017;2017;10;23;Tiistai;1;2;3
625;25.10.2017;2017;10;00;Keskiviikko;0;0;0
625;25.10.2017;2017;10;01;Keskiviikko;1;0;1
625;25.10.2017;2017;10;02;Keskiviikko;0;0;0
625;25.10.2017;2017;10;03;Keskiviikko;0;0;0
625;25.10.2017;2017;10;04;Keskiviikko;0;0;0
625;25.10.2017;2017;10;05;Keskiviikko;0;0;0
625;25.10.2017;2017;10;06;Keskiviikko;0;3;3
625;25.10.2017;2017;10;07;Keskiviikko;12;9;21
625;25.10.2017;2017;10;08;Keskiviikko;6;10;16
625;25.10.2017;2017;10;09;Keskiviikko;4;8;12
625;25.10.2017;2017;10;10;Keskiviikko;4;5;9
625;25.10.2017;2017;10;11;Keskiviikko;6;7;13
625;25.10.2017;2017;10;12;Keskiviikko;2;9;11
625;25.10.2017;2017;10;13;Keskiviikko;7;8;15
625;25.10.2017;2017;10;14;Keskiviikko;6;3;9
625;25.10.2017;2017;10;15;Keskiviikko;11;9;20
625;25.10.2017;2017;10;16;Keskiviikko;4;9;13
625;25.10.2017;2017;10;17;Keskiviikko;2;2;4
625;25.10.2017;2017;10;18;Keskiviikko;0;0;0
625;25.10.2017;2017;10;19;Keskiviikko;1;3;4
625;25.10.2017;2017;10;20;Keskiviikko;3;8;11
625;25.10.2017;2017;10;21;Keskiviikko;3;0;3
625;25.10.2017;2017;10;22;Keskiviikko;1;5;6
625;25.10.2017;2017;10;23;Keskiviikko;1;2;3
625;26.10.2017;2017;10;00;Torstai;3;1;4
625;26.10.2017;2017;10;01;Torstai;2;1;3
625;26.10.2017;2017;10;02;Torstai;0;1;1
625;26.10.2017;2017;10;03;Torstai;0;0;0
625;26.10.2017;2017;10;04;Torstai;0;0;0
625;26.10.2017;2017;10;05;Torstai;0;0;0
625;26.10.2017;2017;10;06;Torstai;1;1;2
625;26.10.2017;2017;10;07;Torstai;9;1;10
625;26.10.2017;2017;10;08;Torstai;8;11;19
625;26.10.2017;2017;10;09;Torstai;2;4;6
625;26.10.2017;2017;10;10;Torstai;1;3;4
625;26.10.2017;2017;10;11;Torstai;1;1;2
625;26.10.2017;2017;10;12;Torstai;5;2;7
625;26.10.2017;2017;10;13;Torstai;8;7;15
625;26.10.2017;2017;10;14;Torstai;6;9;15
625;26.10.2017;2017;10;15;Torstai;11;9;20
625;26.10.2017;2017;10;16;Torstai;4;2;6
625;26.10.2017;2017;10;17;Torstai;2;2;4
625;26.10.2017;2017;10;18;Torstai;0;0;0
625;26.10.2017;2017;10;19;Torstai;1;3;4
625;26.10.2017;2017;10;20;Torstai;3;8;11
625;26.10.2017;2017;10;21;Torstai;3;0;3
625;26.10.2017;2017;10;22;Torstai;1;5;6
625;26.10.2017;2017;10;23;Torstai;1;2;3
625;27.10.2017;2017;10;00;Perjantai;1;0;1
625;27.10.2017;2017;10;01;Perjantai;0;0;0
625;27.10.2017;2017;10;02;Perjantai;0;0;0
625;27.10.2017;2017;10;03;Perjantai;0;0;0
625;27.10.2017;2017;10;04;Perjantai;0;0;0
625;27.10.2017;2017;10;05;Perjantai;0;1;1
625;27.10.2017;2017;10;06;Perjantai;2;1;3
625;27.10.2017;2017;10;07;Perjantai;9;8;17
625;27.10.2017;2017;10;08;Perjantai;57;24;81
625;27.10.2017;2017;10;09;Perjantai;32;13;45
625;27.10.2017;2017;10;10;Perjantai;9;9;18
625;27.10.2017;2017;10;11;Perjantai;7;10;17
625;27.10.2017;2017;10;12;Perjantai;11;15;26
625;27.10.2017;2017;10;13;Perjantai;8;20;28
625;27.10.2017;2017;10;14;Perjantai;15;31;46
625;27.10.2017;2017;10;15;Perjantai;12;31;43
625;27.10.2017;2017;10;16;Perjantai;17;22;39
625;27.10.2017;2017;10;17;Perjantai;7;8;15
625;27.10.2017;2017;10;18;Perjantai;5;12;17
625;27.10.2017;2017;10;19;Perjantai;3;5;8
625;27.10.2017;2017;10;20;Perjantai;7;8;15
625;27.10.2017;2017;10;21;Perjantai;3;2;5
625;27.10.2017;2017;10;22;Perjantai;3;2;5
625;27.10.2017;2017;10;23;Perjantai;0;1;1
625;28.10.2017;2017;10;00;Lauantai;1;2;3
625;28.10.2017;2017;10;01;Lauantai;0;0;0
625;28.10.2017;2017;10;02;Lauantai;0;0;0
625;28.10.2017;2017;10;03;Lauantai;1;1;2
625;28.10.2017;2017;10;04;Lauantai;0;0;0
625;28.10.2017;2017;10;05;Lauantai;0;0;0
625;28.10.2017;2017;10;06;Lauantai;0;1;1
625;28.10.2017;2017;10;07;Lauantai;0;0;0
625;28.10.2017;2017;10;08;Lauantai;0;1;1
625;28.10.2017;2017;10;09;Lauantai;1;0;1
625;28.10.2017;2017;10;10;Lauantai;1;3;4
625;28.10.2017;2017;10;11;Lauantai;3;2;5
625;28.10.2017;2017;10;12;Lauantai;3;5;8
625;28.10.2017;2017;10;13;Lauantai;2;5;7
625;28.10.2017;2017;10;14;Lauantai;5;2;7
625;28.10.2017;2017;10;15;Lauantai;1;2;3
625;28.10.2017;2017;10;16;Lauantai;3;1;4
625;28.10.2017;2017;10;17;Lauantai;2;4;6
625;28.10.2017;2017;10;18;Lauantai;1;3;4
625;28.10.2017;2017;10;19;Lauantai;2;6;8
625;28.10.2017;2017;10;20;Lauantai;2;2;4
625;28.10.2017;2017;10;21;Lauantai;4;2;6
625;28.10.2017;2017;10;22;Lauantai;0;3;3
625;28.10.2017;2017;10;23;Lauantai;3;1;4
625;29.10.2017;2017;10;00;Sunnuntai;5;2;7
625;29.10.2017;2017;10;01;Sunnuntai;0;0;0
625;29.10.2017;2017;10;02;Sunnuntai;1;1;2
625;29.10.2017;2017;10;03;Sunnuntai;0;0;0
625;29.10.2017;2017;10;04;Sunnuntai;0;0;0
625;29.10.2017;2017;10;05;Sunnuntai;1;0;1
625;29.10.2017;2017;10;06;Sunnuntai;1;0;1
625;29.10.2017;2017;10;07;Sunnuntai;0;0;0
625;29.10.2017;2017;10;08;Sunnuntai;1;2;3
625;29.10.2017;2017;10;09;Sunnuntai;0;0;0
625;29.10.2017;2017;10;10;Sunnuntai;4;2;6
625;29.10.2017;2017;10;11;Sunnuntai;3;2;5
625;29.10.2017;2017;10;12;Sunnuntai;3;4;7
625;29.10.2017;2017;10;13;Sunnuntai;5;3;8
625;29.10.2017;2017;10;14;Sunnuntai;2;6;8
625;29.10.2017;2017;10;15;Sunnuntai;2;5;7
625;29.10.2017;2017;10;16;Sunnuntai;5;1;6
625;29.10.2017;2017;10;17;Sunnuntai;4;4;8
625;29.10.2017;2017;10;18;Sunnuntai;1;2;3
625;29.10.2017;2017;10;19;Sunnuntai;3;5;8
625;29.10.2017;2017;10;20;Sunnuntai;0;2;2
625;29.10.2017;2017;10;21;Sunnuntai;1;1;2
625;29.10.2017;2017;10;22;Sunnuntai;1;1;2
625;29.10.2017;2017;10;23;Sunnuntai;2;3;5
625;30.10.2017;2017;10;00;Maanantai;0;0;0
625;30.10.2017;2017;10;01;Maanantai;0;0;0
625;30.10.2017;2017;10;02;Maanantai;0;0;0
625;30.10.2017;2017;10;03;Maanantai;0;0;0
625;30.10.2017;2017;10;04;Maanantai;1;0;1
625;30.10.2017;2017;10;05;Maanantai;0;1;1
625;30.10.2017;2017;10;06;Maanantai;3;1;4
625;30.10.2017;2017;10;07;Maanantai;15;6;21
625;30.10.2017;2017;10;08;Maanantai;55;19;74
625;30.10.2017;2017;10;09;Maanantai;25;15;40
625;30.10.2017;2017;10;10;Maanantai;4;2;6
625;30.10.2017;2017;10;11;Maanantai;3;0;3
625;30.10.2017;2017;10;12;Maanantai;10;7;17
625;30.10.2017;2017;10;13;Maanantai;10;6;16
625;30.10.2017;2017;10;14;Maanantai;0;0;0
625;30.10.2017;2017;10;15;Maanantai;10;26;36
625;30.10.2017;2017;10;16;Maanantai;10;28;38
625;30.10.2017;2017;10;17;Maanantai;27;35;62
625;30.10.2017;2017;10;18;Maanantai;11;14;25
625;30.10.2017;2017;10;19;Maanantai;7;7;14
625;30.10.2017;2017;10;20;Maanantai;3;7;10
625;30.10.2017;2017;10;21;Maanantai;4;3;7
625;30.10.2017;2017;10;22;Maanantai;4;2;6
625;30.10.2017;2017;10;23;Maanantai;3;5;8
625;31.10.2017;2017;10;00;Tiistai;1;0;1
625;31.10.2017;2017;10;01;Tiistai;1;0;1
625;31.10.2017;2017;10;02;Tiistai;2;1;3
625;31.10.2017;2017;10;03;Tiistai;0;0;0
625;31.10.2017;2017;10;04;Tiistai;0;0;0
625;31.10.2017;2017;10;05;Tiistai;0;1;1
625;31.10.2017;2017;10;06;Tiistai;2;2;4
625;31.10.2017;2017;10;07;Tiistai;9;2;11
625;31.10.2017;2017;10;08;Tiistai;40;14;54
625;31.10.2017;2017;10;09;Tiistai;33;16;49
625;31.10.2017;2017;10;10;Tiistai;22;11;33
625;31.10.2017;2017;10;11;Tiistai;11;5;16
625;31.10.2017;2017;10;12;Tiistai;5;4;9
625;31.10.2017;2017;10;13;Tiistai;6;7;13
625;31.10.2017;2017;10;14;Tiistai;6;26;32
625;31.10.2017;2017;10;15;Tiistai;11;33;44
625;31.10.2017;2017;10;16;Tiistai;15;26;41
625;31.10.2017;2017;10;17;Tiistai;14;16;30
625;31.10.2017;2017;10;18;Tiistai;10;9;19
625;31.10.2017;2017;10;19;Tiistai;3;5;8
625;31.10.2017;2017;10;20;Tiistai;4;3;7
625;31.10.2017;2017;10;21;Tiistai;1;10;11
625;31.10.2017;2017;10;22;Tiistai;2;3;5
625;31.10.2017;2017;10;23;Tiistai;2;2;4
625;01.11.2017;2017;11;00;Keskiviikko;2;1;3
625;01.11.2017;2017;11;01;Keskiviikko;1;0;1
625;01.11.2017;2017;11;02;Keskiviikko;0;0;0
625;01.11.2017;2017;11;03;Keskiviikko;0;0;0
625;01.11.2017;2017;11;04;Keskiviikko;0;0;0
625;01.11.2017;2017;11;05;Keskiviikko;0;1;1
625;01.11.2017;2017;11;06;Keskiviikko;2;1;3
625;01.11.2017;2017;11;07;Keskiviikko;9;6;15
625;01.11.2017;2017;11;08;Keskiviikko;51;15;66
625;01.11.2017;2017;11;09;Keskiviikko;32;18;50
625;01.11.2017;2017;11;10;Keskiviikko;11;10;21
625;01.11.2017;2017;11;11;Keskiviikko;2;1;3
625;01.11.2017;2017;11;12;Keskiviikko;3;11;14
625;01.11.2017;2017;11;13;Keskiviikko;7;11;18
625;01.11.2017;2017;11;14;Keskiviikko;5;15;20
625;01.11.2017;2017;11;15;Keskiviikko;11;43;54
625;01.11.2017;2017;11;16;Keskiviikko;14;20;34
625;01.11.2017;2017;11;17;Keskiviikko;15;11;26
625;01.11.2017;2017;11;18;Keskiviikko;6;8;14
625;01.11.2017;2017;11;19;Keskiviikko;9;7;16
625;01.11.2017;2017;11;20;Keskiviikko;4;5;9
625;01.11.2017;2017;11;21;Keskiviikko;5;5;10
625;01.11.2017;2017;11;22;Keskiviikko;2;1;3
625;01.11.2017;2017;11;23;Keskiviikko;1;0;1
625;02.11.2017;2017;11;00;Torstai;1;0;1
625;02.11.2017;2017;11;01;Torstai;0;0;0
625;02.11.2017;2017;11;02;Torstai;0;0;0
625;02.11.2017;2017;11;03;Torstai;0;0;0
625;02.11.2017;2017;11;04;Torstai;0;0;0
625;02.11.2017;2017;11;05;Torstai;0;1;1
625;02.11.2017;2017;11;06;Torstai;2;4;6
625;02.11.2017;2017;11;07;Torstai;12;5;17
625;02.11.2017;2017;11;08;Torstai;43;13;56
625;02.11.2017;2017;11;09;Torstai;23;13;36
625;02.11.2017;2017;11;10;Torstai;14;8;22
625;02.11.2017;2017;11;11;Torstai;9;3;12
625;02.11.2017;2017;11;12;Torstai;9;5;14
625;02.11.2017;2017;11;13;Torstai;8;14;22
625;02.11.2017;2017;11;14;Torstai;6;15;21
625;02.11.2017;2017;11;15;Torstai;9;27;36
625;02.11.2017;2017;11;16;Torstai;13;19;32
625;02.11.2017;2017;11;17;Torstai;20;24;44
625;02.11.2017;2017;11;18;Torstai;5;11;16
625;02.11.2017;2017;11;19;Torstai;2;8;10
625;02.11.2017;2017;11;20;Torstai;5;4;9
625;02.11.2017;2017;11;21;Torstai;6;5;11
625;02.11.2017;2017;11;22;Torstai;2;3;5
625;02.11.2017;2017;11;23;Torstai;4;5;9
625;03.11.2017;2017;11;00;Perjantai;0;0;0
625;03.11.2017;2017;11;01;Perjantai;0;1;1
625;03.11.2017;2017;11;02;Perjantai;1;1;2
625;03.11.2017;2017;11;03;Perjantai;0;0;0
625;03.11.2017;2017;11;04;Perjantai;0;0;0
625;03.11.2017;2017;11;05;Perjantai;0;0;0
625;03.11.2017;2017;11;06;Perjantai;3;4;7
625;03.11.2017;2017;11;07;Perjantai;7;7;14
625;03.11.2017;2017;11;08;Perjantai;35;17;52
625;03.11.2017;2017;11;09;Perjantai;24;7;31
625;03.11.2017;2017;11;10;Perjantai;11;5;16
625;03.11.2017;2017;11;11;Perjantai;3;3;6
625;03.11.2017;2017;11;12;Perjantai;0;3;3
625;03.11.2017;2017;11;13;Perjantai;0;0;0
625;03.11.2017;2017;11;14;Perjantai;0;0;0
625;03.11.2017;2017;11;15;Perjantai;3;5;8
625;03.11.2017;2017;11;16;Perjantai;14;18;32
625;03.11.2017;2017;11;17;Perjantai;8;18;26
625;03.11.2017;2017;11;18;Perjantai;3;6;9
625;03.11.2017;2017;11;19;Perjantai;6;8;14
625;03.11.2017;2017;11;20;Perjantai;5;2;7
625;03.11.2017;2017;11;21;Perjantai;5;4;9
625;03.11.2017;2017;11;22;Perjantai;2;1;3
625;03.11.2017;2017;11;23;Perjantai;5;5;10
625;04.11.2017;2017;11;00;Lauantai;1;3;4
625;04.11.2017;2017;11;01;Lauantai;0;1;1
625;04.11.2017;2017;11;02;Lauantai;1;0;1
625;04.11.2017;2017;11;03;Lauantai;2;0;2
625;04.11.2017;2017;11;04;Lauantai;0;0;0
625;04.11.2017;2017;11;05;Lauantai;0;0;0
625;04.11.2017;2017;11;06;Lauantai;0;0;0
625;04.11.2017;2017;11;07;Lauantai;1;0;1
625;04.11.2017;2017;11;08;Lauantai;1;2;3
625;04.11.2017;2017;11;09;Lauantai;1;0;1
625;04.11.2017;2017;11;10;Lauantai;3;1;4
625;04.11.2017;2017;11;11;Lauantai;3;6;9
625;04.11.2017;2017;11;12;Lauantai;2;5;7
625;04.11.2017;2017;11;13;Lauantai;1;2;3
625;04.11.2017;2017;11;14;Lauantai;6;3;9
625;04.11.2017;2017;11;15;Lauantai;2;8;10
625;04.11.2017;2017;11;16;Lauantai;4;6;10
625;04.11.2017;2017;11;17;Lauantai;3;5;8
625;04.11.2017;2017;11;18;Lauantai;3;3;6
625;04.11.2017;2017;11;19;Lauantai;2;3;5
625;04.11.2017;2017;11;20;Lauantai;1;3;4
625;04.11.2017;2017;11;21;Lauantai;2;3;5
625;04.11.2017;2017;11;22;Lauantai;3;1;4
625;04.11.2017;2017;11;23;Lauantai;0;1;1
625;05.11.2017;2017;11;00;Sunnuntai;2;1;3
625;05.11.2017;2017;11;01;Sunnuntai;1;1;2
625;05.11.2017;2017;11;02;Sunnuntai;0;0;0
625;05.11.2017;2017;11;03;Sunnuntai;1;0;1
625;05.11.2017;2017;11;04;Sunnuntai;0;0;0
625;05.11.2017;2017;11;05;Sunnuntai;1;1;2
625;05.11.2017;2017;11;06;Sunnuntai;0;1;1
625;05.11.2017;2017;11;07;Sunnuntai;1;1;2
625;05.11.2017;2017;11;08;Sunnuntai;0;1;1
625;05.11.2017;2017;11;09;Sunnuntai;0;0;0
625;05.11.2017;2017;11;10;Sunnuntai;0;5;5
625;05.11.2017;2017;11;11;Sunnuntai;6;3;9
625;05.11.2017;2017;11;12;Sunnuntai;2;4;6
625;05.11.2017;2017;11;13;Sunnuntai;7;6;13
625;05.11.2017;2017;11;14;Sunnuntai;3;7;10
625;05.11.2017;2017;11;15;Sunnuntai;3;3;6
625;05.11.2017;2017;11;16;Sunnuntai;10;7;17
625;05.11.2017;2017;11;17;Sunnuntai;2;2;4
625;05.11.2017;2017;11;18;Sunnuntai;4;2;6
625;05.11.2017;2017;11;19;Sunnuntai;2;2;4
625;05.11.2017;2017;11;20;Sunnuntai;6;3;9
625;05.11.2017;2017;11;21;Sunnuntai;1;3;4
625;05.11.2017;2017;11;22;Sunnuntai;4;1;5
625;05.11.2017;2017;11;23;Sunnuntai;0;1;1
625;06.11.2017;2017;11;00;Maanantai;1;0;1
625;06.11.2017;2017;11;01;Maanantai;0;1;1
625;06.11.2017;2017;11;02;Maanantai;0;0;0
625;06.11.2017;2017;11;03;Maanantai;0;0;0
625;06.11.2017;2017;11;04;Maanantai;0;0;0
625;06.11.2017;2017;11;05;Maanantai;0;0;0
625;06.11.2017;2017;11;06;Maanantai;3;1;4
625;06.11.2017;2017;11;07;Maanantai;6;2;8
625;06.11.2017;2017;11;08;Maanantai;35;16;51
625;06.11.2017;2017;11;09;Maanantai;21;14;35
625;06.11.2017;2017;11;10;Maanantai;14;11;25
625;06.11.2017;2017;11;11;Maanantai;13;4;17
625;06.11.2017;2017;11;12;Maanantai;8;10;18
625;06.11.2017;2017;11;13;Maanantai;4;15;19
625;06.11.2017;2017;11;14;Maanantai;10;30;40
625;06.11.2017;2017;11;15;Maanantai;14;34;48
625;06.11.2017;2017;11;16;Maanantai;12;35;47
625;06.11.2017;2017;11;17;Maanantai;14;31;45
625;06.11.2017;2017;11;18;Maanantai;7;13;20
625;06.11.2017;2017;11;19;Maanantai;9;14;23
625;06.11.2017;2017;11;20;Maanantai;3;4;7
625;06.11.2017;2017;11;21;Maanantai;4;9;13
625;06.11.2017;2017;11;22;Maanantai;4;5;9
625;06.11.2017;2017;11;23;Maanantai;0;3;3
625;07.11.2017;2017;11;00;Tiistai;2;1;3
625;07.11.2017;2017;11;01;Tiistai;4;0;4
625;07.11.2017;2017;11;02;Tiistai;0;0;0
625;07.11.2017;2017;11;03;Tiistai;0;0;0
625;07.11.2017;2017;11;04;Tiistai;0;0;0
625;07.11.2017;2017;11;05;Tiistai;0;1;1
625;07.11.2017;2017;11;06;Tiistai;2;3;5
625;07.11.2017;2017;11;07;Tiistai;12;8;20
625;07.11.2017;2017;11;08;Tiistai;41;12;53
625;07.11.2017;2017;11;09;Tiistai;45;24;69
625;07.11.2017;2017;11;10;Tiistai;23;12;35
625;07.11.2017;2017;11;11;Tiistai;12;2;14
625;07.11.2017;2017;11;12;Tiistai;9;10;19
625;07.11.2017;2017;11;13;Tiistai;12;13;25
625;07.11.2017;2017;11;14;Tiistai;7;23;30
625;07.11.2017;2017;11;15;Tiistai;6;34;40
625;07.11.2017;2017;11;16;Tiistai;8;28;36
625;07.11.2017;2017;11;17;Tiistai;21;25;46
625;07.11.2017;2017;11;18;Tiistai;12;13;25
625;07.11.2017;2017;11;19;Tiistai;5;6;11
625;07.11.2017;2017;11;20;Tiistai;2;8;10
625;07.11.2017;2017;11;21;Tiistai;5;4;9
625;07.11.2017;2017;11;22;Tiistai;4;2;6
625;07.11.2017;2017;11;23;Tiistai;3;1;4
625;08.11.2017;2017;11;00;Keskiviikko;2;0;2
625;08.11.2017;2017;11;01;Keskiviikko;0;0;0
625;08.11.2017;2017;11;02;Keskiviikko;1;1;2
625;08.11.2017;2017;11;03;Keskiviikko;0;0;0
625;08.11.2017;2017;11;04;Keskiviikko;0;0;0
625;08.11.2017;2017;11;05;Keskiviikko;0;0;0
625;08.11.2017;2017;11;06;Keskiviikko;3;2;5
625;08.11.2017;2017;11;07;Keskiviikko;11;7;18
625;08.11.2017;2017;11;08;Keskiviikko;48;23;71
625;08.11.2017;2017;11;09;Keskiviikko;37;12;49
625;08.11.2017;2017;11;10;Keskiviikko;21;19;40
625;08.11.2017;2017;11;11;Keskiviikko;13;5;18
625;08.11.2017;2017;11;12;Keskiviikko;12;19;31
625;08.11.2017;2017;11;13;Keskiviikko;6;14;20
625;08.11.2017;2017;11;14;Keskiviikko;8;23;31
625;08.11.2017;2017;11;15;Keskiviikko;11;40;51
625;08.11.2017;2017;11;16;Keskiviikko;10;28;38
625;08.11.2017;2017;11;17;Keskiviikko;12;21;33
625;08.11.2017;2017;11;18;Keskiviikko;9;15;24
625;08.11.2017;2017;11;19;Keskiviikko;7;7;14
625;08.11.2017;2017;11;20;Keskiviikko;6;6;12
625;08.11.2017;2017;11;21;Keskiviikko;3;4;7
625;08.11.2017;2017;11;22;Keskiviikko;7;1;8
625;08.11.2017;2017;11;23;Keskiviikko;3;2;5
625;09.11.2017;2017;11;00;Torstai;1;0;1
625;09.11.2017;2017;11;01;Torstai;2;1;3
625;09.11.2017;2017;11;02;Torstai;1;0;1
625;09.11.2017;2017;11;03;Torstai;0;0;0
625;09.11.2017;2017;11;04;Torstai;1;0;1
625;09.11.2017;2017;11;05;Torstai;0;0;0
625;09.11.2017;2017;11;06;Torstai;2;3;5
625;09.11.2017;2017;11;07;Torstai;5;9;14
625;09.11.2017;2017;11;08;Torstai;37;20;57
625;09.11.2017;2017;11;09;Torstai;15;12;27
625;09.11.2017;2017;11;10;Torstai;15;7;22
625;09.11.2017;2017;11;11;Torstai;13;3;16
625;09.11.2017;2017;11;12;Torstai;4;12;16
625;09.11.2017;2017;11;13;Torstai;6;8;14
625;09.11.2017;2017;11;14;Torstai;9;25;34
625;09.11.2017;2017;11;15;Torstai;9;31;40
625;09.11.2017;2017;11;16;Torstai;15;28;43
625;09.11.2017;2017;11;17;Torstai;14;33;47
625;09.11.2017;2017;11;18;Torstai;14;10;24
625;09.11.2017;2017;11;19;Torstai;5;5;10
625;09.11.2017;2017;11;20;Torstai;3;9;12
625;09.11.2017;2017;11;21;Torstai;2;1;3
625;09.11.2017;2017;11;22;Torstai;3;6;9
625;09.11.2017;2017;11;23;Torstai;3;1;4
625;10.11.2017;2017;11;00;Perjantai;2;0;2
625;10.11.2017;2017;11;01;Perjantai;1;0;1
625;10.11.2017;2017;11;02;Perjantai;0;0;0
625;10.11.2017;2017;11;03;Perjantai;0;0;0
625;10.11.2017;2017;11;04;Perjantai;0;0;0
625;10.11.2017;2017;11;05;Perjantai;0;0;0
625;10.11.2017;2017;11;06;Perjantai;2;4;6
625;10.11.2017;2017;11;07;Perjantai;4;2;6
625;10.11.2017;2017;11;08;Perjantai;40;26;66
625;10.11.2017;2017;11;09;Perjantai;27;10;37
625;10.11.2017;2017;11;10;Perjantai;23;19;42
625;10.11.2017;2017;11;11;Perjantai;7;4;11
625;10.11.2017;2017;11;12;Perjantai;9;14;23
625;10.11.2017;2017;11;13;Perjantai;10;22;32
625;10.11.2017;2017;11;14;Perjantai;8;29;37
625;10.11.2017;2017;11;15;Perjantai;12;19;31
625;10.11.2017;2017;11;16;Perjantai;11;21;32
625;10.11.2017;2017;11;17;Perjantai;10;11;21
625;10.11.2017;2017;11;18;Perjantai;6;8;14
625;10.11.2017;2017;11;19;Perjantai;2;1;3
625;10.11.2017;2017;11;20;Perjantai;7;5;12
625;10.11.2017;2017;11;21;Perjantai;4;2;6
625;10.11.2017;2017;11;22;Perjantai;2;3;5
625;10.11.2017;2017;11;23;Perjantai;4;3;7
625;11.11.2017;2017;11;00;Lauantai;1;0;1
625;11.11.2017;2017;11;01;Lauantai;1;3;4
625;11.11.2017;2017;11;02;Lauantai;1;2;3
625;11.11.2017;2017;11;03;Lauantai;1;1;2
625;11.11.2017;2017;11;04;Lauantai;1;0;1
625;11.11.2017;2017;11;05;Lauantai;1;1;2
625;11.11.2017;2017;11;06;Lauantai;1;1;2
625;11.11.2017;2017;11;07;Lauantai;0;0;0
625;11.11.2017;2017;11;08;Lauantai;1;0;1
625;11.11.2017;2017;11;09;Lauantai;1;0;1
625;11.11.2017;2017;11;10;Lauantai;5;3;8
625;11.11.2017;2017;11;11;Lauantai;3;4;7
625;11.11.2017;2017;11;12;Lauantai;2;6;8
625;11.11.2017;2017;11;13;Lauantai;8;6;14
625;11.11.2017;2017;11;14;Lauantai;8;12;20
625;11.11.2017;2017;11;15;Lauantai;9;4;13
625;11.11.2017;2017;11;16;Lauantai;4;6;10
625;11.11.2017;2017;11;17;Lauantai;6;7;13
625;11.11.2017;2017;11;18;Lauantai;2;6;8
625;11.11.2017;2017;11;19;Lauantai;2;5;7
625;11.11.2017;2017;11;20;Lauantai;3;0;3
625;11.11.2017;2017;11;21;Lauantai;6;3;9
625;11.11.2017;2017;11;22;Lauantai;1;5;6
625;11.11.2017;2017;11;23;Lauantai;3;0;3
625;12.11.2017;2017;11;00;Sunnuntai;3;0;3
625;12.11.2017;2017;11;01;Sunnuntai;1;0;1
625;12.11.2017;2017;11;02;Sunnuntai;0;2;2
625;12.11.2017;2017;11;03;Sunnuntai;0;2;2
625;12.11.2017;2017;11;04;Sunnuntai;0;0;0
625;12.11.2017;2017;11;05;Sunnuntai;0;0;0
625;12.11.2017;2017;11;06;Sunnuntai;0;0;0
625;12.11.2017;2017;11;07;Sunnuntai;0;1;1
625;12.11.2017;2017;11;08;Sunnuntai;0;2;2
625;12.11.2017;2017;11;09;Sunnuntai;1;0;1
625;12.11.2017;2017;11;10;Sunnuntai;2;2;4
625;12.11.2017;2017;11;11;Sunnuntai;3;2;5
625;12.11.2017;2017;11;12;Sunnuntai;4;4;8
625;12.11.2017;2017;11;13;Sunnuntai;12;6;18
625;12.11.2017;2017;11;14;Sunnuntai;7;6;13
625;12.11.2017;2017;11;15;Sunnuntai;6;7;13
625;12.11.2017;2017;11;16;Sunnuntai;1;8;9
625;12.11.2017;2017;11;17;Sunnuntai;3;6;9
625;12.11.2017;2017;11;18;Sunnuntai;1;2;3
625;12.11.2017;2017;11;19;Sunnuntai;6;8;14
625;12.11.2017;2017;11;20;Sunnuntai;2;6;8
625;12.11.2017;2017;11;21;Sunnuntai;0;0;0
625;12.11.2017;2017;11;22;Sunnuntai;1;3;4
625;12.11.2017;2017;11;23;Sunnuntai;1;4;5
625;13.11.2017;2017;11;00;Maanantai;0;0;0
625;13.11.2017;2017;11;01;Maanantai;1;1;2
625;13.11.2017;2017;11;02;Maanantai;0;0;0
625;13.11.2017;2017;11;03;Maanantai;0;0;0
625;13.11.2017;2017;11;04;Maanantai;0;0;0
625;13.11.2017;2017;11;05;Maanantai;0;1;1
625;13.11.2017;2017;11;06;Maanantai;2;0;2
625;13.11.2017;2017;11;07;Maanantai;7;6;13
625;13.11.2017;2017;11;08;Maanantai;53;15;68
625;13.11.2017;2017;11;09;Maanantai;22;15;37
625;13.11.2017;2017;11;10;Maanantai;16;9;25
625;13.11.2017;2017;11;11;Maanantai;8;2;10
625;13.11.2017;2017;11;12;Maanantai;6;5;11
625;13.11.2017;2017;11;13;Maanantai;4;11;15
625;13.11.2017;2017;11;14;Maanantai;11;29;40
625;13.11.2017;2017;11;15;Maanantai;11;25;36
625;13.11.2017;2017;11;16;Maanantai;8;29;37
625;13.11.2017;2017;11;17;Maanantai;20;27;47
625;13.11.2017;2017;11;18;Maanantai;7;18;25
625;13.11.2017;2017;11;19;Maanantai;8;10;18
625;13.11.2017;2017;11;20;Maanantai;4;11;15
625;13.11.2017;2017;11;21;Maanantai;3;6;9
625;13.11.2017;2017;11;22;Maanantai;7;2;9
625;13.11.2017;2017;11;23;Maanantai;3;2;5
625;14.11.2017;2017;11;00;Tiistai;1;0;1
625;14.11.2017;2017;11;01;Tiistai;1;0;1
625;14.11.2017;2017;11;02;Tiistai;0;0;0
625;14.11.2017;2017;11;03;Tiistai;0;1;1
625;14.11.2017;2017;11;04;Tiistai;0;0;0
625;14.11.2017;2017;11;05;Tiistai;0;0;0
625;14.11.2017;2017;11;06;Tiistai;2;0;2
625;14.11.2017;2017;11;07;Tiistai;14;6;20
625;14.11.2017;2017;11;08;Tiistai;35;15;50
625;14.11.2017;2017;11;09;Tiistai;31;18;49
625;14.11.2017;2017;11;10;Tiistai;18;6;24
625;14.11.2017;2017;11;11;Tiistai;11;10;21
625;14.11.2017;2017;11;12;Tiistai;8;6;14
625;14.11.2017;2017;11;13;Tiistai;5;10;15
625;14.11.2017;2017;11;14;Tiistai;10;23;33
625;14.11.2017;2017;11;15;Tiistai;10;20;30
625;14.11.2017;2017;11;16;Tiistai;17;37;54
625;14.11.2017;2017;11;17;Tiistai;17;31;48
625;14.11.2017;2017;11;18;Tiistai;11;9;20
625;14.11.2017;2017;11;19;Tiistai;5;8;13
625;14.11.2017;2017;11;20;Tiistai;4;6;10
625;14.11.2017;2017;11;21;Tiistai;2;6;8
625;14.11.2017;2017;11;22;Tiistai;4;0;4
625;14.11.2017;2017;11;23;Tiistai;4;2;6
625;15.11.2017;2017;11;00;Keskiviikko;3;1;4
625;15.11.2017;2017;11;01;Keskiviikko;0;0;0
625;15.11.2017;2017;11;02;Keskiviikko;0;1;1
625;15.11.2017;2017;11;03;Keskiviikko;1;0;1
625;15.11.2017;2017;11;04;Keskiviikko;0;1;1
625;15.11.2017;2017;11;05;Keskiviikko;0;0;0
625;15.11.2017;2017;11;06;Keskiviikko;5;2;7
625;15.11.2017;2017;11;07;Keskiviikko;11;7;18
625;15.11.2017;2017;11;08;Keskiviikko;57;19;76
625;15.11.2017;2017;11;09;Keskiviikko;23;17;40
625;15.11.2017;2017;11;10;Keskiviikko;24;17;41
625;15.11.2017;2017;11;11;Keskiviikko;6;12;18
625;15.11.2017;2017;11;12;Keskiviikko;2;7;9
625;15.11.2017;2017;11;13;Keskiviikko;12;13;25
625;15.11.2017;2017;11;14;Keskiviikko;8;17;25
625;15.11.2017;2017;11;15;Keskiviikko;9;33;42
625;15.11.2017;2017;11;16;Keskiviikko;16;28;44
625;15.11.2017;2017;11;17;Keskiviikko;18;21;39
625;15.11.2017;2017;11;18;Keskiviikko;7;11;18
625;15.11.2017;2017;11;19;Keskiviikko;11;9;20
625;15.11.2017;2017;11;20;Keskiviikko;3;3;6
625;15.11.2017;2017;11;21;Keskiviikko;5;5;10
625;15.11.2017;2017;11;22;Keskiviikko;6;3;9
625;15.11.2017;2017;11;23;Keskiviikko;4;0;4
625;16.11.2017;2017;11;00;Torstai;1;0;1
625;16.11.2017;2017;11;01;Torstai;0;0;0
625;16.11.2017;2017;11;02;Torstai;0;0;0
625;16.11.2017;2017;11;03;Torstai;0;0;0
625;16.11.2017;2017;11;04;Torstai;0;0;0
625;16.11.2017;2017;11;05;Torstai;0;1;1
625;16.11.2017;2017;11;06;Torstai;5;1;6
625;16.11.2017;2017;11;07;Torstai;16;8;24
625;16.11.2017;2017;11;08;Torstai;52;18;70
625;16.11.2017;2017;11;09;Torstai;22;13;35
625;16.11.2017;2017;11;10;Torstai;16;12;28
625;16.11.2017;2017;11;11;Torstai;22;6;28
625;16.11.2017;2017;11;12;Torstai;14;6;20
625;16.11.2017;2017;11;13;Torstai;8;8;16
625;16.11.2017;2017;11;14;Torstai;6;21;27
625;16.11.2017;2017;11;15;Torstai;6;21;27
625;16.11.2017;2017;11;16;Torstai;19;30;49
625;16.11.2017;2017;11;17;Torstai;13;25;38
625;16.11.2017;2017;11;18;Torstai;15;12;27
625;16.11.2017;2017;11;19;Torstai;4;4;8
625;16.11.2017;2017;11;20;Torstai;6;9;15
625;16.11.2017;2017;11;21;Torstai;7;6;13
625;16.11.2017;2017;11;22;Torstai;3;1;4
625;16.11.2017;2017;11;23;Torstai;2;2;4
625;17.11.2017;2017;11;00;Perjantai;0;1;1
625;17.11.2017;2017;11;01;Perjantai;0;0;0
625;17.11.2017;2017;11;02;Perjantai;0;1;1
625;17.11.2017;2017;11;03;Perjantai;0;1;1
625;17.11.2017;2017;11;04;Perjantai;0;0;0
625;17.11.2017;2017;11;05;Perjantai;0;1;1
625;17.11.2017;2017;11;06;Perjantai;3;3;6
625;17.11.2017;2017;11;07;Perjantai;10;5;15
625;17.11.2017;2017;11;08;Perjantai;38;13;51
625;17.11.2017;2017;11;09;Perjantai;24;11;35
625;17.11.2017;2017;11;10;Perjantai;11;9;20
625;17.11.2017;2017;11;11;Perjantai;3;5;8
625;17.11.2017;2017;11;12;Perjantai;7;10;17
625;17.11.2017;2017;11;13;Perjantai;9;21;30
625;17.11.2017;2017;11;14;Perjantai;19;28;47
625;17.11.2017;2017;11;15;Perjantai;12;19;31
625;17.11.2017;2017;11;16;Perjantai;5;12;17
625;17.11.2017;2017;11;17;Perjantai;6;16;22
625;17.11.2017;2017;11;18;Perjantai;2;6;8
625;17.11.2017;2017;11;19;Perjantai;1;8;9
625;17.11.2017;2017;11;20;Perjantai;2;2;4
625;17.11.2017;2017;11;21;Perjantai;3;2;5
625;17.11.2017;2017;11;22;Perjantai;3;3;6
625;17.11.2017;2017;11;23;Perjantai;1;0;1
625;18.11.2017;2017;11;00;Lauantai;1;0;1
625;18.11.2017;2017;11;01;Lauantai;1;0;1
625;18.11.2017;2017;11;02;Lauantai;0;0;0
625;18.11.2017;2017;11;03;Lauantai;0;0;0
625;18.11.2017;2017;11;04;Lauantai;1;0;1
625;18.11.2017;2017;11;05;Lauantai;0;0;0
625;18.11.2017;2017;11;06;Lauantai;1;1;2
625;18.11.2017;2017;11;07;Lauantai;1;0;1
625;18.11.2017;2017;11;08;Lauantai;1;1;2
625;18.11.2017;2017;11;09;Lauantai;3;2;5
625;18.11.2017;2017;11;10;Lauantai;0;4;4
625;18.11.2017;2017;11;11;Lauantai;1;1;2
625;18.11.2017;2017;11;12;Lauantai;4;1;5
625;18.11.2017;2017;11;13;Lauantai;2;9;11
625;18.11.2017;2017;11;14;Lauantai;3;7;10
625;18.11.2017;2017;11;15;Lauantai;0;4;4
625;18.11.2017;2017;11;16;Lauantai;6;6;12
625;18.11.2017;2017;11;17;Lauantai;2;3;5
625;18.11.2017;2017;11;18;Lauantai;2;6;8
625;18.11.2017;2017;11;19;Lauantai;2;1;3
625;18.11.2017;2017;11;20;Lauantai;3;5;8
625;18.11.2017;2017;11;21;Lauantai;0;2;2
625;18.11.2017;2017;11;22;Lauantai;0;1;1
625;18.11.2017;2017;11;23;Lauantai;0;1;1
625;19.11.2017;2017;11;00;Sunnuntai;0;1;1
625;19.11.2017;2017;11;01;Sunnuntai;0;1;1
625;19.11.2017;2017;11;02;Sunnuntai;1;1;2
625;19.11.2017;2017;11;03;Sunnuntai;0;0;0
625;19.11.2017;2017;11;04;Sunnuntai;0;0;0
625;19.11.2017;2017;11;05;Sunnuntai;0;0;0
625;19.11.2017;2017;11;06;Sunnuntai;0;0;0
625;19.11.2017;2017;11;07;Sunnuntai;0;0;0
625;19.11.2017;2017;11;08;Sunnuntai;0;2;2
625;19.11.2017;2017;11;09;Sunnuntai;0;0;0
625;19.11.2017;2017;11;10;Sunnuntai;1;0;1
625;19.11.2017;2017;11;11;Sunnuntai;2;3;5
625;19.11.2017;2017;11;12;Sunnuntai;6;6;12
625;19.11.2017;2017;11;13;Sunnuntai;3;3;6
625;19.11.2017;2017;11;14;Sunnuntai;2;2;4
625;19.11.2017;2017;11;15;Sunnuntai;3;3;6
625;19.11.2017;2017;11;16;Sunnuntai;3;3;6
625;19.11.2017;2017;11;17;Sunnuntai;5;3;8
625;19.11.2017;2017;11;18;Sunnuntai;5;4;9
625;19.11.2017;2017;11;19;Sunnuntai;3;1;4
625;19.11.2017;2017;11;20;Sunnuntai;1;1;2
625;19.11.2017;2017;11;21;Sunnuntai;4;6;10
625;19.11.2017;2017;11;22;Sunnuntai;3;1;4
625;19.11.2017;2017;11;23;Sunnuntai;1;2;3
625;20.11.2017;2017;11;00;Maanantai;0;0;0
625;20.11.2017;2017;11;01;Maanantai;0;1;1
625;20.11.2017;2017;11;02;Maanantai;0;0;0
625;20.11.2017;2017;11;03;Maanantai;1;1;2
625;20.11.2017;2017;11;04;Maanantai;1;0;1
625;20.11.2017;2017;11;05;Maanantai;0;1;1
625;20.11.2017;2017;11;06;Maanantai;2;4;6
625;20.11.2017;2017;11;07;Maanantai;12;4;16
625;20.11.2017;2017;11;08;Maanantai;50;14;64
625;20.11.2017;2017;11;09;Maanantai;26;10;36
625;20.11.2017;2017;11;10;Maanantai;10;7;17
625;20.11.2017;2017;11;11;Maanantai;2;2;4
625;20.11.2017;2017;11;12;Maanantai;2;6;8
625;20.11.2017;2017;11;13;Maanantai;6;13;19
625;20.11.2017;2017;11;14;Maanantai;8;16;24
625;20.11.2017;2017;11;15;Maanantai;11;26;37
625;20.11.2017;2017;11;16;Maanantai;8;26;34
625;20.11.2017;2017;11;17;Maanantai;13;25;38
625;20.11.2017;2017;11;18;Maanantai;7;10;17
625;20.11.2017;2017;11;19;Maanantai;2;8;10
625;20.11.2017;2017;11;20;Maanantai;5;3;8
625;20.11.2017;2017;11;21;Maanantai;2;8;10
625;20.11.2017;2017;11;22;Maanantai;6;1;7
625;20.11.2017;2017;11;23;Maanantai;3;3;6
625;21.11.2017;2017;11;00;Tiistai;1;0;1
625;21.11.2017;2017;11;01;Tiistai;0;1;1
625;21.11.2017;2017;11;02;Tiistai;0;0;0
625;21.11.2017;2017;11;03;Tiistai;1;0;1
625;21.11.2017;2017;11;04;Tiistai;0;0;0
625;21.11.2017;2017;11;05;Tiistai;0;0;0
625;21.11.2017;2017;11;06;Tiistai;2;3;5
625;21.11.2017;2017;11;07;Tiistai;13;5;18
625;21.11.2017;2017;11;08;Tiistai;25;17;42
625;21.11.2017;2017;11;09;Tiistai;32;9;41
625;21.11.2017;2017;11;10;Tiistai;17;8;25
625;21.11.2017;2017;11;11;Tiistai;8;4;12
625;21.11.2017;2017;11;12;Tiistai;7;7;14
625;21.11.2017;2017;11;13;Tiistai;5;7;12
625;21.11.2017;2017;11;14;Tiistai;4;16;20
625;21.11.2017;2017;11;15;Tiistai;5;22;27
625;21.11.2017;2017;11;16;Tiistai;6;27;33
625;21.11.2017;2017;11;17;Tiistai;15;23;38
625;21.11.2017;2017;11;18;Tiistai;9;15;24
625;21.11.2017;2017;11;19;Tiistai;6;7;13
625;21.11.2017;2017;11;20;Tiistai;3;5;8
625;21.11.2017;2017;11;21;Tiistai;1;0;1
625;21.11.2017;2017;11;22;Tiistai;2;5;7
625;21.11.2017;2017;11;23;Tiistai;3;0;3
625;22.11.2017;2017;11;00;Keskiviikko;0;0;0
625;22.11.2017;2017;11;01;Keskiviikko;0;0;0
625;22.11.2017;2017;11;02;Keskiviikko;0;0;0
625;22.11.2017;2017;11;03;Keskiviikko;0;0;0
625;22.11.2017;2017;11;04;Keskiviikko;0;0;0
625;22.11.2017;2017;11;05;Keskiviikko;0;0;0
625;22.11.2017;2017;11;06;Keskiviikko;1;4;5
625;22.11.2017;2017;11;07;Keskiviikko;13;1;14
625;22.11.2017;2017;11;08;Keskiviikko;30;14;44
625;22.11.2017;2017;11;09;Keskiviikko;18;7;25
625;22.11.2017;2017;11;10;Keskiviikko;9;7;16
625;22.11.2017;2017;11;11;Keskiviikko;2;2;4
625;22.11.2017;2017;11;12;Keskiviikko;4;8;12
625;22.11.2017;2017;11;13;Keskiviikko;2;8;10
625;22.11.2017;2017;11;14;Keskiviikko;7;9;16
625;22.11.2017;2017;11;15;Keskiviikko;12;41;53
625;22.11.2017;2017;11;16;Keskiviikko;8;22;30
625;22.11.2017;2017;11;17;Keskiviikko;12;19;31
625;22.11.2017;2017;11;18;Keskiviikko;8;11;19
625;22.11.2017;2017;11;19;Keskiviikko;7;8;15
625;22.11.2017;2017;11;20;Keskiviikko;7;5;12
625;22.11.2017;2017;11;21;Keskiviikko;6;7;13
625;22.11.2017;2017;11;22;Keskiviikko;1;1;2
625;22.11.2017;2017;11;23;Keskiviikko;0;1;1
625;23.11.2017;2017;11;00;Torstai;1;0;1
625;23.11.2017;2017;11;01;Torstai;0;0;0
625;23.11.2017;2017;11;02;Torstai;0;0;0
625;23.11.2017;2017;11;03;Torstai;0;0;0
625;23.11.2017;2017;11;04;Torstai;0;0;0
625;23.11.2017;2017;11;05;Torstai;0;0;0
625;23.11.2017;2017;11;06;Torstai;2;4;6
625;23.11.2017;2017;11;07;Torstai;8;7;15
625;23.11.2017;2017;11;08;Torstai;26;11;37
625;23.11.2017;2017;11;09;Torstai;25;8;33
625;23.11.2017;2017;11;10;Torstai;10;9;19
625;23.11.2017;2017;11;11;Torstai;12;2;14
625;23.11.2017;2017;11;12;Torstai;4;4;8
625;23.11.2017;2017;11;13;Torstai;5;12;17
625;23.11.2017;2017;11;14;Torstai;8;18;26
625;23.11.2017;2017;11;15;Torstai;3;22;25
625;23.11.2017;2017;11;16;Torstai;10;17;27
625;23.11.2017;2017;11;17;Torstai;8;18;26
625;23.11.2017;2017;11;18;Torstai;4;6;10
625;23.11.2017;2017;11;19;Torstai;1;2;3
625;23.11.2017;2017;11;20;Torstai;3;4;7
625;23.11.2017;2017;11;21;Torstai;3;3;6
625;23.11.2017;2017;11;22;Torstai;2;2;4
625;23.11.2017;2017;11;23;Torstai;2;1;3
625;24.11.2017;2017;11;00;Perjantai;0;1;1
625;24.11.2017;2017;11;01;Perjantai;0;1;1
625;24.11.2017;2017;11;02;Perjantai;0;0;0
625;24.11.2017;2017;11;03;Perjantai;1;1;2
625;24.11.2017;2017;11;04;Perjantai;0;0;0
625;24.11.2017;2017;11;05;Perjantai;0;0;0
625;24.11.2017;2017;11;06;Perjantai;1;3;4
625;24.11.2017;2017;11;07;Perjantai;11;5;16
625;24.11.2017;2017;11;08;Perjantai;19;13;32
625;24.11.2017;2017;11;09;Perjantai;9;5;14
625;24.11.2017;2017;11;10;Perjantai;9;6;15
625;24.11.2017;2017;11;11;Perjantai;4;6;10
625;24.11.2017;2017;11;12;Perjantai;3;9;12
625;24.11.2017;2017;11;13;Perjantai;7;4;11
625;24.11.2017;2017;11;14;Perjantai;6;15;21
625;24.11.2017;2017;11;15;Perjantai;7;20;27
625;24.11.2017;2017;11;16;Perjantai;4;12;16
625;24.11.2017;2017;11;17;Perjantai;3;7;10
625;24.11.2017;2017;11;18;Perjantai;0;4;4
625;24.11.2017;2017;11;19;Perjantai;5;3;8
625;24.11.2017;2017;11;20;Perjantai;2;1;3
625;24.11.2017;2017;11;21;Perjantai;3;4;7
625;24.11.2017;2017;11;22;Perjantai;2;8;10
625;24.11.2017;2017;11;23;Perjantai;3;1;4
625;25.11.2017;2017;11;00;Lauantai;1;2;3
625;25.11.2017;2017;11;01;Lauantai;1;2;3
625;25.11.2017;2017;11;02;Lauantai;0;0;0
625;25.11.2017;2017;11;03;Lauantai;0;0;0
625;25.11.2017;2017;11;04;Lauantai;1;0;1
625;25.11.2017;2017;11;05;Lauantai;1;0;1
625;25.11.2017;2017;11;06;Lauantai;0;1;1
625;25.11.2017;2017;11;07;Lauantai;1;1;2
625;25.11.2017;2017;11;08;Lauantai;2;1;3
625;25.11.2017;2017;11;09;Lauantai;0;1;1
625;25.11.2017;2017;11;10;Lauantai;6;1;7
625;25.11.2017;2017;11;11;Lauantai;3;0;3
625;25.11.2017;2017;11;12;Lauantai;1;7;8
625;25.11.2017;2017;11;13;Lauantai;3;4;7
625;25.11.2017;2017;11;14;Lauantai;3;4;7
625;25.11.2017;2017;11;15;Lauantai;3;4;7
625;25.11.2017;2017;11;16;Lauantai;4;2;6
625;25.11.2017;2017;11;17;Lauantai;2;4;6
625;25.11.2017;2017;11;18;Lauantai;4;5;9
625;25.11.2017;2017;11;19;Lauantai;1;2;3
625;25.11.2017;2017;11;20;Lauantai;3;4;7
625;25.11.2017;2017;11;21;Lauantai;4;3;7
625;25.11.2017;2017;11;22;Lauantai;1;2;3
625;25.11.2017;2017;11;23;Lauantai;3;0;3
625;26.11.2017;2017;11;00;Sunnuntai;0;0;0
625;26.11.2017;2017;11;01;Sunnuntai;0;2;2
625;26.11.2017;2017;11;02;Sunnuntai;0;0;0
625;26.11.2017;2017;11;03;Sunnuntai;1;0;1
625;26.11.2017;2017;11;04;Sunnuntai;0;0;0
625;26.11.2017;2017;11;05;Sunnuntai;0;0;0
625;26.11.2017;2017;11;06;Sunnuntai;0;0;0
625;26.11.2017;2017;11;07;Sunnuntai;0;0;0
625;26.11.2017;2017;11;08;Sunnuntai;0;2;2
625;26.11.2017;2017;11;09;Sunnuntai;0;1;1
625;26.11.2017;2017;11;10;Sunnuntai;2;0;2
625;26.11.2017;2017;11;11;Sunnuntai;1;4;5
625;26.11.2017;2017;11;12;Sunnuntai;4;5;9
625;26.11.2017;2017;11;13;Sunnuntai;1;1;2
625;26.11.2017;2017;11;14;Sunnuntai;1;2;3
625;26.11.2017;2017;11;15;Sunnuntai;7;8;15
625;26.11.2017;2017;11;16;Sunnuntai;7;1;8
625;26.11.2017;2017;11;17;Sunnuntai;0;5;5
625;26.11.2017;2017;11;18;Sunnuntai;2;8;10
625;26.11.2017;2017;11;19;Sunnuntai;1;3;4
625;26.11.2017;2017;11;20;Sunnuntai;3;6;9
625;26.11.2017;2017;11;21;Sunnuntai;5;2;7
625;26.11.2017;2017;11;22;Sunnuntai;3;0;3
625;26.11.2017;2017;11;23;Sunnuntai;1;2;3
625;27.11.2017;2017;11;00;Maanantai;0;0;0
625;27.11.2017;2017;11;01;Maanantai;0;0;0
625;27.11.2017;2017;11;02;Maanantai;0;0;0
625;27.11.2017;2017;11;03;Maanantai;0;0;0
625;27.11.2017;2017;11;04;Maanantai;0;0;0
625;27.11.2017;2017;11;05;Maanantai;0;2;2
625;27.11.2017;2017;11;06;Maanantai;4;2;6
625;27.11.2017;2017;11;07;Maanantai;12;0;12
625;27.11.2017;2017;11;08;Maanantai;19;10;29
625;27.11.2017;2017;11;09;Maanantai;23;8;31
625;27.11.2017;2017;11;10;Maanantai;17;5;22
625;27.11.2017;2017;11;11;Maanantai;2;2;4
625;27.11.2017;2017;11;12;Maanantai;4;4;8
625;27.11.2017;2017;11;13;Maanantai;5;14;19
625;27.11.2017;2017;11;14;Maanantai;3;18;21
625;27.11.2017;2017;11;15;Maanantai;12;31;43
625;27.11.2017;2017;11;16;Maanantai;8;22;30
625;27.11.2017;2017;11;17;Maanantai;11;24;35
625;27.11.2017;2017;11;18;Maanantai;10;2;12
625;27.11.2017;2017;11;19;Maanantai;5;7;12
625;27.11.2017;2017;11;20;Maanantai;2;4;6
625;27.11.2017;2017;11;21;Maanantai;3;2;5
625;27.11.2017;2017;11;22;Maanantai;3;4;7
625;27.11.2017;2017;11;23;Maanantai;3;2;5
625;28.11.2017;2017;11;00;Tiistai;0;0;0
625;28.11.2017;2017;11;01;Tiistai;0;0;0
625;28.11.2017;2017;11;02;Tiistai;0;1;1
625;28.11.2017;2017;11;03;Tiistai;0;0;0
625;28.11.2017;2017;11;04;Tiistai;0;0;0
625;28.11.2017;2017;11;05;Tiistai;0;0;0
625;28.11.2017;2017;11;06;Tiistai;2;1;3
625;28.11.2017;2017;11;07;Tiistai;11;3;14
625;28.11.2017;2017;11;08;Tiistai;13;8;21
625;28.11.2017;2017;11;09;Tiistai;24;3;27
625;28.11.2017;2017;11;10;Tiistai;27;15;42
625;28.11.2017;2017;11;11;Tiistai;7;7;14
625;28.11.2017;2017;11;12;Tiistai;4;5;9
625;28.11.2017;2017;11;13;Tiistai;9;22;31
625;28.11.2017;2017;11;14;Tiistai;6;10;16
625;28.11.2017;2017;11;15;Tiistai;15;22;37
625;28.11.2017;2017;11;16;Tiistai;13;26;39
625;28.11.2017;2017;11;17;Tiistai;13;17;30
625;28.11.2017;2017;11;18;Tiistai;7;10;17
625;28.11.2017;2017;11;19;Tiistai;4;6;10
625;28.11.2017;2017;11;20;Tiistai;2;10;12
625;28.11.2017;2017;11;21;Tiistai;3;5;8
625;28.11.2017;2017;11;22;Tiistai;5;5;10
625;28.11.2017;2017;11;23;Tiistai;2;3;5
625;29.11.2017;2017;11;00;Keskiviikko;0;0;0
625;29.11.2017;2017;11;01;Keskiviikko;1;1;2
625;29.11.2017;2017;11;02;Keskiviikko;0;0;0
625;29.11.2017;2017;11;03;Keskiviikko;1;0;1
625;29.11.2017;2017;11;04;Keskiviikko;0;0;0
625;29.11.2017;2017;11;05;Keskiviikko;0;0;0
625;29.11.2017;2017;11;06;Keskiviikko;3;1;4
625;29.11.2017;2017;11;07;Keskiviikko;10;2;12
625;29.11.2017;2017;11;08;Keskiviikko;40;18;58
625;29.11.2017;2017;11;09;Keskiviikko;18;13;31
625;29.11.2017;2017;11;10;Keskiviikko;9;5;14
625;29.11.2017;2017;11;11;Keskiviikko;5;1;6
625;29.11.2017;2017;11;12;Keskiviikko;6;5;11
625;29.11.2017;2017;11;13;Keskiviikko;10;26;36
625;29.11.2017;2017;11;14;Keskiviikko;9;9;18
625;29.11.2017;2017;11;15;Keskiviikko;5;16;21
625;29.11.2017;2017;11;16;Keskiviikko;3;11;14
625;29.11.2017;2017;11;17;Keskiviikko;8;19;27
625;29.11.2017;2017;11;18;Keskiviikko;9;8;17
625;29.11.2017;2017;11;19;Keskiviikko;5;7;12
625;29.11.2017;2017;11;20;Keskiviikko;2;4;6
625;29.11.2017;2017;11;21;Keskiviikko;2;5;7
625;29.11.2017;2017;11;22;Keskiviikko;6;3;9
625;29.11.2017;2017;11;23;Keskiviikko;1;1;2
625;30.11.2017;2017;11;00;Torstai;2;0;2
625;30.11.2017;2017;11;01;Torstai;0;1;1
625;30.11.2017;2017;11;02;Torstai;0;1;1
625;30.11.2017;2017;11;03;Torstai;1;0;1
625;30.11.2017;2017;11;04;Torstai;0;0;0
625;30.11.2017;2017;11;05;Torstai;1;1;2
625;30.11.2017;2017;11;06;Torstai;2;2;4
625;30.11.2017;2017;11;07;Torstai;11;4;15
625;30.11.2017;2017;11;08;Torstai;41;10;51
625;30.11.2017;2017;11;09;Torstai;12;14;26
625;30.11.2017;2017;11;10;Torstai;7;4;11
625;30.11.2017;2017;11;11;Torstai;6;3;9
625;30.11.2017;2017;11;12;Torstai;5;5;10
625;30.11.2017;2017;11;13;Torstai;6;19;25
625;30.11.2017;2017;11;14;Torstai;3;6;9
625;30.11.2017;2017;11;15;Torstai;5;16;21
625;30.11.2017;2017;11;16;Torstai;10;28;38
625;30.11.2017;2017;11;17;Torstai;11;18;29
625;30.11.2017;2017;11;18;Torstai;2;8;10
625;30.11.2017;2017;11;19;Torstai;3;4;7
625;30.11.2017;2017;11;20;Torstai;2;5;7
625;30.11.2017;2017;11;21;Torstai;2;2;4
625;30.11.2017;2017;11;22;Torstai;2;3;5
625;30.11.2017;2017;11;23;Torstai;1;2;3
625;01.12.2017;2017;12;00;Perjantai;0;0;0
625;01.12.2017;2017;12;01;Perjantai;0;0;0
625;01.12.2017;2017;12;02;Perjantai;0;0;0
625;01.12.2017;2017;12;03;Perjantai;0;0;0
625;01.12.2017;2017;12;04;Perjantai;0;1;1
625;01.12.2017;2017;12;05;Perjantai;0;0;0
625;01.12.2017;2017;12;06;Perjantai;1;3;4
625;01.12.2017;2017;12;07;Perjantai;13;4;17
625;01.12.2017;2017;12;08;Perjantai;21;15;36
625;01.12.2017;2017;12;09;Perjantai;17;13;30
625;01.12.2017;2017;12;10;Perjantai;8;7;15
625;01.12.2017;2017;12;11;Perjantai;6;1;7
625;01.12.2017;2017;12;12;Perjantai;7;8;15
625;01.12.2017;2017;12;13;Perjantai;4;21;25
625;01.12.2017;2017;12;14;Perjantai;3;11;14
625;01.12.2017;2017;12;15;Perjantai;10;20;30
625;01.12.2017;2017;12;16;Perjantai;5;19;24
625;01.12.2017;2017;12;17;Perjantai;5;17;22
625;01.12.2017;2017;12;18;Perjantai;3;5;8
625;01.12.2017;2017;12;19;Perjantai;5;5;10
625;01.12.2017;2017;12;20;Perjantai;1;1;2
625;01.12.2017;2017;12;21;Perjantai;2;3;5
625;01.12.2017;2017;12;22;Perjantai;2;3;5
625;01.12.2017;2017;12;23;Perjantai;2;2;4
625;02.12.2017;2017;12;00;Lauantai;0;3;3
625;02.12.2017;2017;12;01;Lauantai;0;0;0
625;02.12.2017;2017;12;02;Lauantai;1;0;1
625;02.12.2017;2017;12;03;Lauantai;0;0;0
625;02.12.2017;2017;12;04;Lauantai;0;0;0
625;02.12.2017;2017;12;05;Lauantai;0;0;0
625;02.12.2017;2017;12;06;Lauantai;0;0;0
625;02.12.2017;2017;12;07;Lauantai;1;0;1
625;02.12.2017;2017;12;08;Lauantai;0;2;2
625;02.12.2017;2017;12;09;Lauantai;8;2;10
625;02.12.2017;2017;12;10;Lauantai;3;1;4
625;02.12.2017;2017;12;11;Lauantai;3;6;9
625;02.12.2017;2017;12;12;Lauantai;2;13;15
625;02.12.2017;2017;12;13;Lauantai;3;6;9
625;02.12.2017;2017;12;14;Lauantai;4;7;11
625;02.12.2017;2017;12;15;Lauantai;3;5;8
625;02.12.2017;2017;12;16;Lauantai;2;5;7
625;02.12.2017;2017;12;17;Lauantai;0;3;3
625;02.12.2017;2017;12;18;Lauantai;1;2;3
625;02.12.2017;2017;12;19;Lauantai;1;6;7
625;02.12.2017;2017;12;20;Lauantai;0;1;1
625;02.12.2017;2017;12;21;Lauantai;2;0;2
625;02.12.2017;2017;12;22;Lauantai;3;1;4
625;02.12.2017;2017;12;23;Lauantai;1;2;3
625;03.12.2017;2017;12;00;Sunnuntai;2;2;4
625;03.12.2017;2017;12;01;Sunnuntai;0;2;2
625;03.12.2017;2017;12;02;Sunnuntai;2;1;3
625;03.12.2017;2017;12;03;Sunnuntai;0;0;0
625;03.12.2017;2017;12;04;Sunnuntai;0;0;0
625;03.12.2017;2017;12;05;Sunnuntai;0;0;0
625;03.12.2017;2017;12;06;Sunnuntai;0;0;0
625;03.12.2017;2017;12;07;Sunnuntai;0;1;1
625;03.12.2017;2017;12;08;Sunnuntai;0;1;1
625;03.12.2017;2017;12;09;Sunnuntai;0;1;1
625;03.12.2017;2017;12;10;Sunnuntai;2;2;4
625;03.12.2017;2017;12;11;Sunnuntai;2;2;4
625;03.12.2017;2017;12;12;Sunnuntai;3;5;8
625;03.12.2017;2017;12;13;Sunnuntai;3;6;9
625;03.12.2017;2017;12;14;Sunnuntai;3;3;6
625;03.12.2017;2017;12;15;Sunnuntai;3;4;7
625;03.12.2017;2017;12;16;Sunnuntai;6;6;12
625;03.12.2017;2017;12;17;Sunnuntai;2;4;6
625;03.12.2017;2017;12;18;Sunnuntai;1;2;3
625;03.12.2017;2017;12;19;Sunnuntai;1;4;5
625;03.12.2017;2017;12;20;Sunnuntai;1;3;4
625;03.12.2017;2017;12;21;Sunnuntai;4;0;4
625;03.12.2017;2017;12;22;Sunnuntai;0;0;0
625;03.12.2017;2017;12;23;Sunnuntai;2;1;3
625;04.12.2017;2017;12;00;Maanantai;2;1;3
625;04.12.2017;2017;12;01;Maanantai;0;0;0
625;04.12.2017;2017;12;02;Maanantai;0;0;0
625;04.12.2017;2017;12;03;Maanantai;0;1;1
625;04.12.2017;2017;12;04;Maanantai;0;0;0
625;04.12.2017;2017;12;05;Maanantai;1;0;1
625;04.12.2017;2017;12;06;Maanantai;1;3;4
625;04.12.2017;2017;12;07;Maanantai;10;5;15
625;04.12.2017;2017;12;08;Maanantai;26;10;36
625;04.12.2017;2017;12;09;Maanantai;12;11;23
625;04.12.2017;2017;12;10;Maanantai;11;10;21
625;04.12.2017;2017;12;11;Maanantai;6;3;9
625;04.12.2017;2017;12;12;Maanantai;2;6;8
625;04.12.2017;2017;12;13;Maanantai;2;8;10
625;04.12.2017;2017;12;14;Maanantai;4;15;19
625;04.12.2017;2017;12;15;Maanantai;2;15;17
625;04.12.2017;2017;12;16;Maanantai;3;16;19
625;04.12.2017;2017;12;17;Maanantai;6;18;24
625;04.12.2017;2017;12;18;Maanantai;7;8;15
625;04.12.2017;2017;12;19;Maanantai;3;5;8
625;04.12.2017;2017;12;20;Maanantai;1;7;8
625;04.12.2017;2017;12;21;Maanantai;1;2;3
625;04.12.2017;2017;12;22;Maanantai;1;1;2
625;04.12.2017;2017;12;23;Maanantai;3;3;6
625;05.12.2017;2017;12;00;Tiistai;0;1;1
625;05.12.2017;2017;12;01;Tiistai;0;0;0
625;05.12.2017;2017;12;02;Tiistai;0;0;0
625;05.12.2017;2017;12;03;Tiistai;0;0;0
625;05.12.2017;2017;12;04;Tiistai;0;1;1
625;05.12.2017;2017;12;05;Tiistai;1;0;1
625;05.12.2017;2017;12;06;Tiistai;1;3;4
625;05.12.2017;2017;12;07;Tiistai;7;4;11
625;05.12.2017;2017;12;08;Tiistai;13;13;26
625;05.12.2017;2017;12;09;Tiistai;21;11;32
625;05.12.2017;2017;12;10;Tiistai;13;11;24
625;05.12.2017;2017;12;11;Tiistai;5;4;9
625;05.12.2017;2017;12;12;Tiistai;2;5;7
625;05.12.2017;2017;12;13;Tiistai;5;10;15
625;05.12.2017;2017;12;14;Tiistai;6;11;17
625;05.12.2017;2017;12;15;Tiistai;6;23;29
625;05.12.2017;2017;12;16;Tiistai;8;21;29
625;05.12.2017;2017;12;17;Tiistai;11;12;23
625;05.12.2017;2017;12;18;Tiistai;10;8;18
625;05.12.2017;2017;12;19;Tiistai;4;4;8
625;05.12.2017;2017;12;20;Tiistai;2;5;7
625;05.12.2017;2017;12;21;Tiistai;7;10;17
625;05.12.2017;2017;12;22;Tiistai;1;4;5
625;05.12.2017;2017;12;23;Tiistai;6;3;9
625;06.12.2017;2017;12;00;Keskiviikko;3;1;4
625;06.12.2017;2017;12;01;Keskiviikko;0;0;0
625;06.12.2017;2017;12;02;Keskiviikko;1;0;1
625;06.12.2017;2017;12;03;Keskiviikko;0;0;0
625;06.12.2017;2017;12;04;Keskiviikko;1;0;1
625;06.12.2017;2017;12;05;Keskiviikko;0;0;0
625;06.12.2017;2017;12;06;Keskiviikko;1;3;4
625;06.12.2017;2017;12;07;Keskiviikko;0;0;0
625;06.12.2017;2017;12;08;Keskiviikko;1;2;3
625;06.12.2017;2017;12;09;Keskiviikko;0;1;1
625;06.12.2017;2017;12;10;Keskiviikko;2;3;5
625;06.12.2017;2017;12;11;Keskiviikko;2;4;6
625;06.12.2017;2017;12;12;Keskiviikko;3;4;7
625;06.12.2017;2017;12;13;Keskiviikko;6;5;11
625;06.12.2017;2017;12;14;Keskiviikko;5;3;8
625;06.12.2017;2017;12;15;Keskiviikko;5;4;9
625;06.12.2017;2017;12;16;Keskiviikko;3;5;8
625;06.12.2017;2017;12;17;Keskiviikko;3;0;3
625;06.12.2017;2017;12;18;Keskiviikko;4;4;8
625;06.12.2017;2017;12;19;Keskiviikko;1;1;2
625;06.12.2017;2017;12;20;Keskiviikko;3;3;6
625;06.12.2017;2017;12;21;Keskiviikko;3;4;7
625;06.12.2017;2017;12;22;Keskiviikko;2;0;2
625;06.12.2017;2017;12;23;Keskiviikko;1;3;4
625;07.12.2017;2017;12;00;Torstai;0;0;0
625;07.12.2017;2017;12;01;Torstai;0;0;0
625;07.12.2017;2017;12;02;Torstai;0;0;0
625;07.12.2017;2017;12;03;Torstai;1;0;1
625;07.12.2017;2017;12;04;Torstai;0;1;1
625;07.12.2017;2017;12;05;Torstai;0;0;0
625;07.12.2017;2017;12;06;Torstai;2;1;3
625;07.12.2017;2017;12;07;Torstai;11;3;14
625;07.12.2017;2017;12;08;Torstai;29;15;44
625;07.12.2017;2017;12;09;Torstai;18;14;32
625;07.12.2017;2017;12;10;Torstai;11;3;14
625;07.12.2017;2017;12;11;Torstai;13;3;16
625;07.12.2017;2017;12;12;Torstai;4;6;10
625;07.12.2017;2017;12;13;Torstai;11;10;21
625;07.12.2017;2017;12;14;Torstai;7;17;24
625;07.12.2017;2017;12;15;Torstai;6;17;23
625;07.12.2017;2017;12;16;Torstai;12;23;35
625;07.12.2017;2017;12;17;Torstai;16;19;35
625;07.12.2017;2017;12;18;Torstai;6;10;16
625;07.12.2017;2017;12;19;Torstai;5;3;8
625;07.12.2017;2017;12;20;Torstai;4;7;11
625;07.12.2017;2017;12;21;Torstai;4;6;10
625;07.12.2017;2017;12;22;Torstai;6;6;12
625;07.12.2017;2017;12;23;Torstai;3;2;5
625;08.12.2017;2017;12;00;Perjantai;1;1;2
625;08.12.2017;2017;12;01;Perjantai;1;0;1
625;08.12.2017;2017;12;02;Perjantai;0;0;0
625;08.12.2017;2017;12;03;Perjantai;0;0;0
625;08.12.2017;2017;12;04;Perjantai;0;1;1
625;08.12.2017;2017;12;05;Perjantai;2;0;2
625;08.12.2017;2017;12;06;Perjantai;3;5;8
625;08.12.2017;2017;12;07;Perjantai;10;2;12
625;08.12.2017;2017;12;08;Perjantai;24;14;38
625;08.12.2017;2017;12;09;Perjantai;21;12;33
625;08.12.2017;2017;12;10;Perjantai;8;9;17
625;08.12.2017;2017;12;11;Perjantai;9;4;13
625;08.12.2017;2017;12;12;Perjantai;5;7;12
625;08.12.2017;2017;12;13;Perjantai;11;10;21
625;08.12.2017;2017;12;14;Perjantai;6;14;20
625;08.12.2017;2017;12;15;Perjantai;8;10;18
625;08.12.2017;2017;12;16;Perjantai;9;9;18
625;08.12.2017;2017;12;17;Perjantai;8;11;19
625;08.12.2017;2017;12;18;Perjantai;2;5;7
625;08.12.2017;2017;12;19;Perjantai;4;4;8
625;08.12.2017;2017;12;20;Perjantai;3;5;8
625;08.12.2017;2017;12;21;Perjantai;4;4;8
625;08.12.2017;2017;12;22;Perjantai;2;1;3
625;08.12.2017;2017;12;23;Perjantai;2;2;4
625;09.12.2017;2017;12;00;Lauantai;2;2;4
625;09.12.2017;2017;12;01;Lauantai;0;0;0
625;09.12.2017;2017;12;02;Lauantai;1;0;1
625;09.12.2017;2017;12;03;Lauantai;0;0;0
625;09.12.2017;2017;12;04;Lauantai;0;0;0
625;09.12.2017;2017;12;05;Lauantai;0;0;0
625;09.12.2017;2017;12;06;Lauantai;0;0;0
625;09.12.2017;2017;12;07;Lauantai;2;0;2
625;09.12.2017;2017;12;08;Lauantai;0;1;1
625;09.12.2017;2017;12;09;Lauantai;1;1;2
625;09.12.2017;2017;12;10;Lauantai;3;1;4
625;09.12.2017;2017;12;11;Lauantai;2;8;10
625;09.12.2017;2017;12;12;Lauantai;7;2;9
625;09.12.2017;2017;12;13;Lauantai;5;6;11
625;09.12.2017;2017;12;14;Lauantai;2;5;7
625;09.12.2017;2017;12;15;Lauantai;3;4;7
625;09.12.2017;2017;12;16;Lauantai;1;2;3
625;09.12.2017;2017;12;17;Lauantai;1;2;3
625;09.12.2017;2017;12;18;Lauantai;2;4;6
625;09.12.2017;2017;12;19;Lauantai;0;0;0
625;09.12.2017;2017;12;20;Lauantai;3;4;7
625;09.12.2017;2017;12;21;Lauantai;3;1;4
625;09.12.2017;2017;12;22;Lauantai;2;0;2
625;09.12.2017;2017;12;23;Lauantai;0;2;2
625;10.12.2017;2017;12;00;Sunnuntai;2;0;2
625;10.12.2017;2017;12;01;Sunnuntai;0;1;1
625;10.12.2017;2017;12;02;Sunnuntai;1;0;1
625;10.12.2017;2017;12;03;Sunnuntai;0;0;0
625;10.12.2017;2017;12;04;Sunnuntai;0;0;0
625;10.12.2017;2017;12;05;Sunnuntai;0;0;0
625;10.12.2017;2017;12;06;Sunnuntai;0;0;0
625;10.12.2017;2017;12;07;Sunnuntai;0;0;0
625;10.12.2017;2017;12;08;Sunnuntai;1;3;4
625;10.12.2017;2017;12;09;Sunnuntai;0;0;0
625;10.12.2017;2017;12;10;Sunnuntai;0;1;1
625;10.12.2017;2017;12;11;Sunnuntai;0;2;2
625;10.12.2017;2017;12;12;Sunnuntai;4;4;8
625;10.12.2017;2017;12;13;Sunnuntai;2;3;5
625;10.12.2017;2017;12;14;Sunnuntai;4;1;5
625;10.12.2017;2017;12;15;Sunnuntai;1;1;2
625;10.12.2017;2017;12;16;Sunnuntai;6;4;10
625;10.12.2017;2017;12;17;Sunnuntai;0;1;1
625;10.12.2017;2017;12;18;Sunnuntai;1;2;3
625;10.12.2017;2017;12;19;Sunnuntai;0;2;2
625;10.12.2017;2017;12;20;Sunnuntai;4;1;5
625;10.12.2017;2017;12;21;Sunnuntai;3;2;5
625;10.12.2017;2017;12;22;Sunnuntai;0;1;1
625;10.12.2017;2017;12;23;Sunnuntai;0;0;0
625;11.12.2017;2017;12;00;Maanantai;0;0;0
625;11.12.2017;2017;12;01;Maanantai;1;2;3
625;11.12.2017;2017;12;02;Maanantai;0;1;1
625;11.12.2017;2017;12;03;Maanantai;0;0;0
625;11.12.2017;2017;12;04;Maanantai;0;0;0
625;11.12.2017;2017;12;05;Maanantai;0;0;0
625;11.12.2017;2017;12;06;Maanantai;0;1;1
625;11.12.2017;2017;12;07;Maanantai;8;4;12
625;11.12.2017;2017;12;08;Maanantai;30;14;44
625;11.12.2017;2017;12;09;Maanantai;18;10;28
625;11.12.2017;2017;12;10;Maanantai;10;6;16
625;11.12.2017;2017;12;11;Maanantai;5;2;7
625;11.12.2017;2017;12;12;Maanantai;6;4;10
625;11.12.2017;2017;12;13;Maanantai;9;5;14
625;11.12.2017;2017;12;14;Maanantai;6;17;23
625;11.12.2017;2017;12;15;Maanantai;6;17;23
625;11.12.2017;2017;12;16;Maanantai;8;20;28
625;11.12.2017;2017;12;17;Maanantai;5;15;20
625;11.12.2017;2017;12;18;Maanantai;6;11;17
625;11.12.2017;2017;12;19;Maanantai;3;9;12
625;11.12.2017;2017;12;20;Maanantai;1;1;2
625;11.12.2017;2017;12;21;Maanantai;0;2;2
625;11.12.2017;2017;12;22;Maanantai;0;3;3
625;11.12.2017;2017;12;23;Maanantai;1;3;4
625;12.12.2017;2017;12;00;Tiistai;1;1;2
625;12.12.2017;2017;12;01;Tiistai;0;1;1
625;12.12.2017;2017;12;02;Tiistai;0;0;0
625;12.12.2017;2017;12;03;Tiistai;0;0;0
625;12.12.2017;2017;12;04;Tiistai;0;1;1
625;12.12.2017;2017;12;05;Tiistai;2;0;2
625;12.12.2017;2017;12;06;Tiistai;1;1;2
625;12.12.2017;2017;12;07;Tiistai;6;0;6
625;12.12.2017;2017;12;08;Tiistai;23;4;27
625;12.12.2017;2017;12;09;Tiistai;20;8;28
625;12.12.2017;2017;12;10;Tiistai;14;7;21
625;12.12.2017;2017;12;11;Tiistai;5;8;13
625;12.12.2017;2017;12;12;Tiistai;3;6;9
625;12.12.2017;2017;12;13;Tiistai;9;7;16
625;12.12.2017;2017;12;14;Tiistai;6;20;26
625;12.12.2017;2017;12;15;Tiistai;6;27;33
625;12.12.2017;2017;12;16;Tiistai;8;18;26
625;12.12.2017;2017;12;17;Tiistai;6;9;15
625;12.12.2017;2017;12;18;Tiistai;7;8;15
625;12.12.2017;2017;12;19;Tiistai;7;6;13
625;12.12.2017;2017;12;20;Tiistai;2;4;6
625;12.12.2017;2017;12;21;Tiistai;5;4;9
625;12.12.2017;2017;12;22;Tiistai;3;2;5
625;12.12.2017;2017;12;23;Tiistai;1;3;4
625;13.12.2017;2017;12;00;Keskiviikko;1;0;1
625;13.12.2017;2017;12;01;Keskiviikko;1;2;3
625;13.12.2017;2017;12;02;Keskiviikko;3;1;4
625;13.12.2017;2017;12;03;Keskiviikko;1;0;1
625;13.12.2017;2017;12;04;Keskiviikko;0;2;2
625;13.12.2017;2017;12;05;Keskiviikko;1;0;1
625;13.12.2017;2017;12;06;Keskiviikko;0;0;0
625;13.12.2017;2017;12;07;Keskiviikko;9;3;12
625;13.12.2017;2017;12;08;Keskiviikko;40;18;58
625;13.12.2017;2017;12;09;Keskiviikko;16;10;26
625;13.12.2017;2017;12;10;Keskiviikko;11;11;22
625;13.12.2017;2017;12;11;Keskiviikko;2;0;2
625;13.12.2017;2017;12;12;Keskiviikko;7;5;12
625;13.12.2017;2017;12;13;Keskiviikko;7;7;14
625;13.12.2017;2017;12;14;Keskiviikko;5;8;13
625;13.12.2017;2017;12;15;Keskiviikko;12;21;33
625;13.12.2017;2017;12;16;Keskiviikko;5;18;23
625;13.12.2017;2017;12;17;Keskiviikko;15;19;34
625;13.12.2017;2017;12;18;Keskiviikko;14;8;22
625;13.12.2017;2017;12;19;Keskiviikko;7;5;12
625;13.12.2017;2017;12;20;Keskiviikko;1;5;6
625;13.12.2017;2017;12;21;Keskiviikko;2;7;9
625;13.12.2017;2017;12;22;Keskiviikko;2;3;5
625;13.12.2017;2017;12;23;Keskiviikko;1;2;3
625;14.12.2017;2017;12;00;Torstai;0;0;0
625;14.12.2017;2017;12;01;Torstai;2;0;2
625;14.12.2017;2017;12;02;Torstai;0;1;1
625;14.12.2017;2017;12;03;Torstai;0;0;0
625;14.12.2017;2017;12;04;Torstai;0;1;1
625;14.12.2017;2017;12;05;Torstai;0;0;0
625;14.12.2017;2017;12;06;Torstai;1;3;4
625;14.12.2017;2017;12;07;Torstai;11;4;15
625;14.12.2017;2017;12;08;Torstai;37;10;47
625;14.12.2017;2017;12;09;Torstai;16;12;28
625;14.12.2017;2017;12;10;Torstai;17;8;25
625;14.12.2017;2017;12;11;Torstai;22;10;32
625;14.12.2017;2017;12;12;Torstai;5;3;8
625;14.12.2017;2017;12;13;Torstai;5;10;15
625;14.12.2017;2017;12;14;Torstai;8;20;28
625;14.12.2017;2017;12;15;Torstai;5;17;22
625;14.12.2017;2017;12;16;Torstai;12;17;29
625;14.12.2017;2017;12;17;Torstai;12;17;29
625;14.12.2017;2017;12;18;Torstai;4;3;7
625;14.12.2017;2017;12;19;Torstai;6;7;13
625;14.12.2017;2017;12;20;Torstai;0;3;3
625;14.12.2017;2017;12;21;Torstai;1;2;3
625;14.12.2017;2017;12;22;Torstai;0;4;4
625;14.12.2017;2017;12;23;Torstai;0;1;1
625;15.12.2017;2017;12;00;Perjantai;0;0;0
625;15.12.2017;2017;12;01;Perjantai;0;0;0
625;15.12.2017;2017;12;02;Perjantai;0;0;0
625;15.12.2017;2017;12;03;Perjantai;0;0;0
625;15.12.2017;2017;12;04;Perjantai;0;0;0
625;15.12.2017;2017;12;05;Perjantai;1;0;1
625;15.12.2017;2017;12;06;Perjantai;2;3;5
625;15.12.2017;2017;12;07;Perjantai;2;2;4
625;15.12.2017;2017;12;08;Perjantai;13;11;24
625;15.12.2017;2017;12;09;Perjantai;10;8;18
625;15.12.2017;2017;12;10;Perjantai;8;17;25
625;15.12.2017;2017;12;11;Perjantai;4;2;6
625;15.12.2017;2017;12;12;Perjantai;0;6;6
625;15.12.2017;2017;12;13;Perjantai;3;7;10
625;15.12.2017;2017;12;14;Perjantai;7;22;29
625;15.12.2017;2017;12;15;Perjantai;9;19;28
625;15.12.2017;2017;12;16;Perjantai;7;14;21
625;15.12.2017;2017;12;17;Perjantai;5;9;14
625;15.12.2017;2017;12;18;Perjantai;2;2;4
625;15.12.2017;2017;12;19;Perjantai;2;4;6
625;15.12.2017;2017;12;20;Perjantai;1;3;4
625;15.12.2017;2017;12;21;Perjantai;4;3;7
625;15.12.2017;2017;12;22;Perjantai;3;5;8
625;15.12.2017;2017;12;23;Perjantai;1;4;5
625;16.12.2017;2017;12;00;Lauantai;0;0;0
625;16.12.2017;2017;12;01;Lauantai;0;0;0
625;16.12.2017;2017;12;02;Lauantai;0;0;0
625;16.12.2017;2017;12;03;Lauantai;0;0;0
625;16.12.2017;2017;12;04;Lauantai;0;0;0
625;16.12.2017;2017;12;05;Lauantai;0;0;0
625;16.12.2017;2017;12;06;Lauantai;0;0;0
625;16.12.2017;2017;12;07;Lauantai;2;0;2
625;16.12.2017;2017;12;08;Lauantai;0;1;1
625;16.12.2017;2017;12;09;Lauantai;0;0;0
625;16.12.2017;2017;12;10;Lauantai;2;0;2
625;16.12.2017;2017;12;11;Lauantai;3;1;4
625;16.12.2017;2017;12;12;Lauantai;0;4;4
625;16.12.2017;2017;12;13;Lauantai;2;3;5
625;16.12.2017;2017;12;14;Lauantai;3;1;4
625;16.12.2017;2017;12;15;Lauantai;3;2;5
625;16.12.2017;2017;12;16;Lauantai;1;0;1
625;16.12.2017;2017;12;17;Lauantai;0;2;2
625;16.12.2017;2017;12;18;Lauantai;2;1;3
625;16.12.2017;2017;12;19;Lauantai;2;2;4
625;16.12.2017;2017;12;20;Lauantai;1;1;2
625;16.12.2017;2017;12;21;Lauantai;1;3;4
625;16.12.2017;2017;12;22;Lauantai;3;0;3
625;16.12.2017;2017;12;23;Lauantai;0;0;0
625;17.12.2017;2017;12;00;Sunnuntai;1;1;2
625;17.12.2017;2017;12;01;Sunnuntai;0;1;1
625;17.12.2017;2017;12;02;Sunnuntai;0;0;0
625;17.12.2017;2017;12;03;Sunnuntai;0;1;1
625;17.12.2017;2017;12;04;Sunnuntai;0;0;0
625;17.12.2017;2017;12;05;Sunnuntai;0;0;0
625;17.12.2017;2017;12;06;Sunnuntai;0;0;0
625;17.12.2017;2017;12;07;Sunnuntai;1;0;1
625;17.12.2017;2017;12;08;Sunnuntai;1;1;2
625;17.12.2017;2017;12;09;Sunnuntai;0;0;0
625;17.12.2017;2017;12;10;Sunnuntai;2;3;5
625;17.12.2017;2017;12;11;Sunnuntai;0;2;2
625;17.12.2017;2017;12;12;Sunnuntai;3;3;6
625;17.12.2017;2017;12;13;Sunnuntai;2;2;4
625;17.12.2017;2017;12;14;Sunnuntai;4;3;7
625;17.12.2017;2017;12;15;Sunnuntai;3;5;8
625;17.12.2017;2017;12;16;Sunnuntai;1;2;3
625;17.12.2017;2017;12;17;Sunnuntai;1;3;4
625;17.12.2017;2017;12;18;Sunnuntai;4;4;8
625;17.12.2017;2017;12;19;Sunnuntai;3;3;6
625;17.12.2017;2017;12;20;Sunnuntai;3;1;4
625;17.12.2017;2017;12;21;Sunnuntai;2;2;4
625;17.12.2017;2017;12;22;Sunnuntai;0;1;1
625;17.12.2017;2017;12;23;Sunnuntai;2;2;4
625;18.12.2017;2017;12;00;Maanantai;1;0;1
625;18.12.2017;2017;12;01;Maanantai;0;0;0
625;18.12.2017;2017;12;02;Maanantai;0;0;0
625;18.12.2017;2017;12;03;Maanantai;0;0;0
625;18.12.2017;2017;12;04;Maanantai;0;0;0
625;18.12.2017;2017;12;05;Maanantai;2;0;2
625;18.12.2017;2017;12;06;Maanantai;1;0;1
625;18.12.2017;2017;12;07;Maanantai;10;3;13
625;18.12.2017;2017;12;08;Maanantai;24;14;38
625;18.12.2017;2017;12;09;Maanantai;11;11;22
625;18.12.2017;2017;12;10;Maanantai;17;7;24
625;18.12.2017;2017;12;11;Maanantai;7;6;13
625;18.12.2017;2017;12;12;Maanantai;5;3;8
625;18.12.2017;2017;12;13;Maanantai;6;4;10
625;18.12.2017;2017;12;14;Maanantai;6;22;28
625;18.12.2017;2017;12;15;Maanantai;8;21;29
625;18.12.2017;2017;12;16;Maanantai;5;23;28
625;18.12.2017;2017;12;17;Maanantai;8;17;25
625;18.12.2017;2017;12;18;Maanantai;5;9;14
625;18.12.2017;2017;12;19;Maanantai;4;7;11
625;18.12.2017;2017;12;20;Maanantai;3;3;6
625;18.12.2017;2017;12;21;Maanantai;1;4;5
625;18.12.2017;2017;12;22;Maanantai;3;5;8
625;18.12.2017;2017;12;23;Maanantai;5;1;6
625;19.12.2017;2017;12;00;Tiistai;0;0;0
625;19.12.2017;2017;12;01;Tiistai;0;0;0
625;19.12.2017;2017;12;02;Tiistai;0;0;0
625;19.12.2017;2017;12;03;Tiistai;1;0;1
625;19.12.2017;2017;12;04;Tiistai;1;0;1
625;19.12.2017;2017;12;05;Tiistai;1;0;1
625;19.12.2017;2017;12;06;Tiistai;1;2;3
625;19.12.2017;2017;12;07;Tiistai;6;4;10
625;19.12.2017;2017;12;08;Tiistai;22;18;40
625;19.12.2017;2017;12;09;Tiistai;18;12;30
625;19.12.2017;2017;12;10;Tiistai;13;4;17
625;19.12.2017;2017;12;11;Tiistai;6;1;7
625;19.12.2017;2017;12;12;Tiistai;2;8;10
625;19.12.2017;2017;12;13;Tiistai;4;6;10
625;19.12.2017;2017;12;14;Tiistai;7;20;27
625;19.12.2017;2017;12;15;Tiistai;9;15;24
625;19.12.2017;2017;12;16;Tiistai;10;24;34
625;19.12.2017;2017;12;17;Tiistai;5;16;21
625;19.12.2017;2017;12;18;Tiistai;10;16;26
625;19.12.2017;2017;12;19;Tiistai;6;6;12
625;19.12.2017;2017;12;20;Tiistai;2;7;9
625;19.12.2017;2017;12;21;Tiistai;5;2;7
625;19.12.2017;2017;12;22;Tiistai;3;1;4
625;19.12.2017;2017;12;23;Tiistai;2;0;2
625;20.12.2017;2017;12;00;Keskiviikko;0;0;0
625;20.12.2017;2017;12;01;Keskiviikko;0;0;0
625;20.12.2017;2017;12;02;Keskiviikko;0;1;1
625;20.12.2017;2017;12;03;Keskiviikko;0;0;0
625;20.12.2017;2017;12;04;Keskiviikko;0;0;0
625;20.12.2017;2017;12;05;Keskiviikko;0;0;0
625;20.12.2017;2017;12;06;Keskiviikko;1;1;2
625;20.12.2017;2017;12;07;Keskiviikko;8;5;13
625;20.12.2017;2017;12;08;Keskiviikko;7;11;18
625;20.12.2017;2017;12;09;Keskiviikko;19;11;30
625;20.12.2017;2017;12;10;Keskiviikko;15;6;21
625;20.12.2017;2017;12;11;Keskiviikko;2;3;5
625;20.12.2017;2017;12;12;Keskiviikko;3;3;6
625;20.12.2017;2017;12;13;Keskiviikko;4;17;21
625;20.12.2017;2017;12;14;Keskiviikko;6;9;15
625;20.12.2017;2017;12;15;Keskiviikko;4;16;20
625;20.12.2017;2017;12;16;Keskiviikko;0;1;1
625;20.12.2017;2017;12;17;Keskiviikko;4;8;12
625;20.12.2017;2017;12;18;Keskiviikko;5;4;9
625;20.12.2017;2017;12;19;Keskiviikko;2;1;3
625;20.12.2017;2017;12;20;Keskiviikko;2;3;5
625;20.12.2017;2017;12;21;Keskiviikko;0;3;3
625;20.12.2017;2017;12;22;Keskiviikko;3;1;4
625;20.12.2017;2017;12;23;Keskiviikko;2;1;3
625;21.12.2017;2017;12;00;Torstai;2;0;2
625;21.12.2017;2017;12;01;Torstai;0;0;0
625;21.12.2017;2017;12;02;Torstai;0;0;0
625;21.12.2017;2017;12;03;Torstai;0;1;1
625;21.12.2017;2017;12;04;Torstai;0;0;0
625;21.12.2017;2017;12;05;Torstai;1;0;1
625;21.12.2017;2017;12;06;Torstai;2;3;5
625;21.12.2017;2017;12;07;Torstai;6;2;8
625;21.12.2017;2017;12;08;Torstai;12;9;21
625;21.12.2017;2017;12;09;Torstai;28;14;42
625;21.12.2017;2017;12;10;Torstai;5;13;18
625;21.12.2017;2017;12;11;Torstai;6;9;15
625;21.12.2017;2017;12;12;Torstai;6;13;19
625;21.12.2017;2017;12;13;Torstai;2;5;7
625;21.12.2017;2017;12;14;Torstai;5;16;21
625;21.12.2017;2017;12;15;Torstai;2;11;13
625;21.12.2017;2017;12;16;Torstai;4;3;7
625;21.12.2017;2017;12;17;Torstai;3;8;11
625;21.12.2017;2017;12;18;Torstai;2;4;6
625;21.12.2017;2017;12;19;Torstai;1;2;3
625;21.12.2017;2017;12;20;Torstai;2;4;6
625;21.12.2017;2017;12;21;Torstai;1;0;1
625;21.12.2017;2017;12;22;Torstai;1;0;1
625;21.12.2017;2017;12;23;Torstai;5;4;9
625;22.12.2017;2017;12;00;Perjantai;0;2;2
625;22.12.2017;2017;12;01;Perjantai;0;0;0
625;22.12.2017;2017;12;02;Perjantai;0;0;0
625;22.12.2017;2017;12;03;Perjantai;0;0;0
625;22.12.2017;2017;12;04;Perjantai;1;0;1
625;22.12.2017;2017;12;05;Perjantai;0;1;1
625;22.12.2017;2017;12;06;Perjantai;2;0;2
625;22.12.2017;2017;12;07;Perjantai;1;1;2
625;22.12.2017;2017;12;08;Perjantai;3;7;10
625;22.12.2017;2017;12;09;Perjantai;25;8;33
625;22.12.2017;2017;12;10;Perjantai;6;15;21
625;22.12.2017;2017;12;11;Perjantai;6;21;27
625;22.12.2017;2017;12;12;Perjantai;5;7;12
625;22.12.2017;2017;12;13;Perjantai;2;5;7
625;22.12.2017;2017;12;14;Perjantai;2;3;5
625;22.12.2017;2017;12;15;Perjantai;3;3;6
625;22.12.2017;2017;12;16;Perjantai;6;3;9
625;22.12.2017;2017;12;17;Perjantai;8;5;13
625;22.12.2017;2017;12;18;Perjantai;4;4;8
625;22.12.2017;2017;12;19;Perjantai;3;0;3
625;22.12.2017;2017;12;20;Perjantai;1;1;2
625;22.12.2017;2017;12;21;Perjantai;1;4;5
625;22.12.2017;2017;12;22;Perjantai;3;2;5
625;22.12.2017;2017;12;23;Perjantai;3;2;5
625;23.12.2017;2017;12;00;Lauantai;0;1;1
625;23.12.2017;2017;12;01;Lauantai;0;0;0
625;23.12.2017;2017;12;02;Lauantai;1;0;1
625;23.12.2017;2017;12;03;Lauantai;0;0;0
625;23.12.2017;2017;12;04;Lauantai;0;0;0
625;23.12.2017;2017;12;05;Lauantai;0;0;0
625;23.12.2017;2017;12;06;Lauantai;1;0;1
625;23.12.2017;2017;12;07;Lauantai;1;1;2
625;23.12.2017;2017;12;08;Lauantai;1;0;1
625;23.12.2017;2017;12;09;Lauantai;2;1;3
625;23.12.2017;2017;12;10;Lauantai;1;4;5
625;23.12.2017;2017;12;11;Lauantai;2;2;4
625;23.12.2017;2017;12;12;Lauantai;0;1;1
625;23.12.2017;2017;12;13;Lauantai;1;1;2
625;23.12.2017;2017;12;14;Lauantai;1;2;3
625;23.12.2017;2017;12;15;Lauantai;1;1;2
625;23.12.2017;2017;12;16;Lauantai;0;1;1
625;23.12.2017;2017;12;17;Lauantai;7;2;9
625;23.12.2017;2017;12;18;Lauantai;2;5;7
625;23.12.2017;2017;12;19;Lauantai;0;2;2
625;23.12.2017;2017;12;20;Lauantai;0;2;2
625;23.12.2017;2017;12;21;Lauantai;2;3;5
625;23.12.2017;2017;12;22;Lauantai;1;1;2
625;23.12.2017;2017;12;23;Lauantai;1;0;1
625;24.12.2017;2017;12;00;Sunnuntai;0;1;1
625;24.12.2017;2017;12;01;Sunnuntai;0;0;0
625;24.12.2017;2017;12;02;Sunnuntai;0;0;0
625;24.12.2017;2017;12;03;Sunnuntai;0;0;0
625;24.12.2017;2017;12;04;Sunnuntai;0;0;0
625;24.12.2017;2017;12;05;Sunnuntai;0;0;0
625;24.12.2017;2017;12;06;Sunnuntai;0;0;0
625;24.12.2017;2017;12;07;Sunnuntai;1;1;2
625;24.12.2017;2017;12;08;Sunnuntai;0;2;2
625;24.12.2017;2017;12;09;Sunnuntai;1;0;1
625;24.12.2017;2017;12;10;Sunnuntai;0;2;2
625;24.12.2017;2017;12;11;Sunnuntai;2;0;2
625;24.12.2017;2017;12;12;Sunnuntai;1;1;2
625;24.12.2017;2017;12;13;Sunnuntai;0;2;2
625;24.12.2017;2017;12;14;Sunnuntai;1;0;1
625;24.12.2017;2017;12;15;Sunnuntai;5;7;12
625;24.12.2017;2017;12;16;Sunnuntai;1;0;1
625;24.12.2017;2017;12;17;Sunnuntai;0;0;0
625;24.12.2017;2017;12;18;Sunnuntai;0;1;1
625;24.12.2017;2017;12;19;Sunnuntai;1;1;2
625;24.12.2017;2017;12;20;Sunnuntai;0;1;1
625;24.12.2017;2017;12;21;Sunnuntai;0;1;1
625;24.12.2017;2017;12;22;Sunnuntai;0;1;1
625;24.12.2017;2017;12;23;Sunnuntai;0;0;0
625;25.12.2017;2017;12;00;Maanantai;1;0;1
625;25.12.2017;2017;12;01;Maanantai;0;0;0
625;25.12.2017;2017;12;02;Maanantai;0;0;0
625;25.12.2017;2017;12;03;Maanantai;0;0;0
625;25.12.2017;2017;12;04;Maanantai;0;0;0
625;25.12.2017;2017;12;05;Maanantai;0;0;0
625;25.12.2017;2017;12;06;Maanantai;0;0;0
625;25.12.2017;2017;12;07;Maanantai;0;2;2
625;25.12.2017;2017;12;08;Maanantai;1;2;3
625;25.12.2017;2017;12;09;Maanantai;0;0;0
625;25.12.2017;2017;12;10;Maanantai;0;0;0
625;25.12.2017;2017;12;11;Maanantai;0;1;1
625;25.12.2017;2017;12;12;Maanantai;1;1;2
625;25.12.2017;2017;12;13;Maanantai;2;3;5
625;25.12.2017;2017;12;14;Maanantai;0;1;1
625;25.12.2017;2017;12;15;Maanantai;1;2;3
625;25.12.2017;2017;12;16;Maanantai;4;2;6
625;25.12.2017;2017;12;17;Maanantai;0;2;2
625;25.12.2017;2017;12;18;Maanantai;0;0;0
625;25.12.2017;2017;12;19;Maanantai;1;1;2
625;25.12.2017;2017;12;20;Maanantai;2;1;3
625;25.12.2017;2017;12;21;Maanantai;1;1;2
625;25.12.2017;2017;12;22;Maanantai;1;1;2
625;25.12.2017;2017;12;23;Maanantai;0;1;1
625;26.12.2017;2017;12;00;Tiistai;1;0;1
625;26.12.2017;2017;12;01;Tiistai;0;0;0
625;26.12.2017;2017;12;02;Tiistai;1;0;1
625;26.12.2017;2017;12;03;Tiistai;1;1;2
625;26.12.2017;2017;12;04;Tiistai;0;0;0
625;26.12.2017;2017;12;05;Tiistai;0;0;0
625;26.12.2017;2017;12;06;Tiistai;0;0;0
625;26.12.2017;2017;12;07;Tiistai;2;0;2
625;26.12.2017;2017;12;08;Tiistai;1;2;3
625;26.12.2017;2017;12;09;Tiistai;1;0;1
625;26.12.2017;2017;12;10;Tiistai;0;0;0
625;26.12.2017;2017;12;11;Tiistai;1;2;3
625;26.12.2017;2017;12;12;Tiistai;1;1;2
625;26.12.2017;2017;12;13;Tiistai;3;5;8
625;26.12.2017;2017;12;14;Tiistai;2;2;4
625;26.12.2017;2017;12;15;Tiistai;2;3;5
625;26.12.2017;2017;12;16;Tiistai;1;2;3
625;26.12.2017;2017;12;17;Tiistai;0;1;1
625;26.12.2017;2017;12;18;Tiistai;0;0;0
625;26.12.2017;2017;12;19;Tiistai;1;1;2
625;26.12.2017;2017;12;20;Tiistai;0;2;2
625;26.12.2017;2017;12;21;Tiistai;1;0;1
625;26.12.2017;2017;12;22;Tiistai;0;3;3
625;26.12.2017;2017;12;23;Tiistai;0;0;0
625;27.12.2017;2017;12;00;Keskiviikko;0;2;2
625;27.12.2017;2017;12;01;Keskiviikko;1;0;1
625;27.12.2017;2017;12;02;Keskiviikko;0;0;0
625;27.12.2017;2017;12;03;Keskiviikko;0;1;1
625;27.12.2017;2017;12;04;Keskiviikko;1;0;1
625;27.12.2017;2017;12;05;Keskiviikko;0;1;1
625;27.12.2017;2017;12;06;Keskiviikko;1;1;2
625;27.12.2017;2017;12;07;Keskiviikko;6;2;8
625;27.12.2017;2017;12;08;Keskiviikko;4;8;12
625;27.12.2017;2017;12;09;Keskiviikko;4;2;6
625;27.12.2017;2017;12;10;Keskiviikko;0;3;3
625;27.12.2017;2017;12;11;Keskiviikko;2;3;5
625;27.12.2017;2017;12;12;Keskiviikko;1;2;3
625;27.12.2017;2017;12;13;Keskiviikko;2;2;4
625;27.12.2017;2017;12;14;Keskiviikko;5;1;6
625;27.12.2017;2017;12;15;Keskiviikko;5;4;9
625;27.12.2017;2017;12;16;Keskiviikko;5;1;6
625;27.12.2017;2017;12;17;Keskiviikko;6;7;13
625;27.12.2017;2017;12;18;Keskiviikko;3;4;7
625;27.12.2017;2017;12;19;Keskiviikko;0;3;3
625;27.12.2017;2017;12;20;Keskiviikko;1;1;2
625;27.12.2017;2017;12;21;Keskiviikko;0;2;2
625;27.12.2017;2017;12;22;Keskiviikko;4;0;4
625;27.12.2017;2017;12;23;Keskiviikko;2;1;3
625;28.12.2017;2017;12;00;Torstai;0;1;1
625;28.12.2017;2017;12;01;Torstai;0;0;0
625;28.12.2017;2017;12;02;Torstai;0;0;0
625;28.12.2017;2017;12;03;Torstai;0;0;0
625;28.12.2017;2017;12;04;Torstai;0;0;0
625;28.12.2017;2017;12;05;Torstai;0;1;1
625;28.12.2017;2017;12;06;Torstai;1;1;2
625;28.12.2017;2017;12;07;Torstai;5;3;8
625;28.12.2017;2017;12;08;Torstai;2;2;4
625;28.12.2017;2017;12;09;Torstai;2;2;4
625;28.12.2017;2017;12;10;Torstai;6;4;10
625;28.12.2017;2017;12;11;Torstai;2;0;2
625;28.12.2017;2017;12;12;Torstai;1;1;2
625;28.12.2017;2017;12;13;Torstai;4;7;11
625;28.12.2017;2017;12;14;Torstai;2;8;10
625;28.12.2017;2017;12;15;Torstai;7;3;10
625;28.12.2017;2017;12;16;Torstai;9;8;17
625;28.12.2017;2017;12;17;Torstai;7;5;12
625;28.12.2017;2017;12;18;Torstai;4;3;7
625;28.12.2017;2017;12;19;Torstai;3;5;8
625;28.12.2017;2017;12;20;Torstai;1;1;2
625;28.12.2017;2017;12;21;Torstai;0;1;1
625;28.12.2017;2017;12;22;Torstai;3;0;3
625;28.12.2017;2017;12;23;Torstai;1;2;3
625;29.12.2017;2017;12;00;Perjantai;1;2;3
625;29.12.2017;2017;12;01;Perjantai;1;0;1
625;29.12.2017;2017;12;02;Perjantai;0;0;0
625;29.12.2017;2017;12;03;Perjantai;0;1;1
625;29.12.2017;2017;12;04;Perjantai;0;0;0
625;29.12.2017;2017;12;05;Perjantai;0;0;0
625;29.12.2017;2017;12;06;Perjantai;1;1;2
625;29.12.2017;2017;12;07;Perjantai;0;2;2
625;29.12.2017;2017;12;08;Perjantai;1;6;7
625;29.12.2017;2017;12;09;Perjantai;1;1;2
625;29.12.2017;2017;12;10;Perjantai;4;1;5
625;29.12.2017;2017;12;11;Perjantai;4;4;8
625;29.12.2017;2017;12;12;Perjantai;1;3;4
625;29.12.2017;2017;12;13;Perjantai;3;3;6
625;29.12.2017;2017;12;14;Perjantai;4;6;10
625;29.12.2017;2017;12;15;Perjantai;3;3;6
625;29.12.2017;2017;12;16;Perjantai;1;4;5
625;29.12.2017;2017;12;17;Perjantai;3;2;5
625;29.12.2017;2017;12;18;Perjantai;0;0;0
625;29.12.2017;2017;12;19;Perjantai;3;2;5
625;29.12.2017;2017;12;20;Perjantai;0;3;3
625;29.12.2017;2017;12;21;Perjantai;1;4;5
625;29.12.2017;2017;12;22;Perjantai;0;2;2
625;29.12.2017;2017;12;23;Perjantai;0;1;1
625;30.12.2017;2017;12;00;Lauantai;0;1;1
625;30.12.2017;2017;12;01;Lauantai;0;1;1
625;30.12.2017;2017;12;02;Lauantai;0;0;0
625;30.12.2017;2017;12;03;Lauantai;0;0;0
625;30.12.2017;2017;12;04;Lauantai;0;0;0
625;30.12.2017;2017;12;05;Lauantai;0;1;1
625;30.12.2017;2017;12;06;Lauantai;1;0;1
625;30.12.2017;2017;12;07;Lauantai;0;0;0
625;30.12.2017;2017;12;08;Lauantai;0;0;0
625;30.12.2017;2017;12;09;Lauantai;0;0;0
625;30.12.2017;2017;12;10;Lauantai;0;0;0
625;30.12.2017;2017;12;11;Lauantai;1;0;1
625;30.12.2017;2017;12;12;Lauantai;3;1;4
625;30.12.2017;2017;12;13;Lauantai;2;3;5
625;30.12.2017;2017;12;14;Lauantai;2;3;5
625;30.12.2017;2017;12;15;Lauantai;0;5;5
625;30.12.2017;2017;12;16;Lauantai;4;3;7
625;30.12.2017;2017;12;17;Lauantai;0;2;2
625;30.12.2017;2017;12;18;Lauantai;4;1;5
625;30.12.2017;2017;12;19;Lauantai;2;2;4
625;30.12.2017;2017;12;20;Lauantai;0;2;2
625;30.12.2017;2017;12;21;Lauantai;2;2;4
625;30.12.2017;2017;12;22;Lauantai;0;2;2
625;30.12.2017;2017;12;23;Lauantai;0;0;0
625;31.12.2017;2017;12;00;Sunnuntai;1;0;1
625;31.12.2017;2017;12;01;Sunnuntai;0;1;1
625;31.12.2017;2017;12;02;Sunnuntai;0;0;0
625;31.12.2017;2017;12;03;Sunnuntai;0;0;0
625;31.12.2017;2017;12;04;Sunnuntai;0;0;0
625;31.12.2017;2017;12;05;Sunnuntai;0;0;0
625;31.12.2017;2017;12;06;Sunnuntai;0;0;0
625;31.12.2017;2017;12;07;Sunnuntai;1;0;1
625;31.12.2017;2017;12;08;Sunnuntai;0;2;2
625;31.12.2017;2017;12;09;Sunnuntai;0;0;0
625;31.12.2017;2017;12;10;Sunnuntai;2;0;2
625;31.12.2017;2017;12;11;Sunnuntai;0;2;2
625;31.12.2017;2017;12;12;Sunnuntai;6;1;7
625;31.12.2017;2017;12;13;Sunnuntai;4;2;6
625;31.12.2017;2017;12;14;Sunnuntai;2;2;4
625;31.12.2017;2017;12;15;Sunnuntai;2;3;5
625;31.12.2017;2017;12;16;Sunnuntai;2;3;5
625;31.12.2017;2017;12;17;Sunnuntai;1;0;1
625;31.12.2017;2017;12;18;Sunnuntai;7;4;11
625;31.12.2017;2017;12;19;Sunnuntai;4;1;5
625;31.12.2017;2017;12;20;Sunnuntai;1;2;3
625;31.12.2017;2017;12;21;Sunnuntai;0;0;0
625;31.12.2017;2017;12;22;Sunnuntai;0;3;3
625;31.12.2017;2017;12;23;Sunnuntai;2;0;2
625;01.01.2018;2018;01;00;Maanantai;0;0;0
625;01.01.2018;2018;01;01;Maanantai;0;0;0
625;01.01.2018;2018;01;02;Maanantai;2;1;3
625;01.01.2018;2018;01;03;Maanantai;0;1;1
625;01.01.2018;2018;01;04;Maanantai;2;1;3
625;01.01.2018;2018;01;05;Maanantai;0;1;1
625;01.01.2018;2018;01;06;Maanantai;0;1;1
625;01.01.2018;2018;01;07;Maanantai;2;0;2
625;01.01.2018;2018;01;08;Maanantai;2;1;3
625;01.01.2018;2018;01;09;Maanantai;0;0;0
625;01.01.2018;2018;01;10;Maanantai;0;0;0
625;01.01.2018;2018;01;11;Maanantai;1;1;2
625;01.01.2018;2018;01;12;Maanantai;0;0;0
625;01.01.2018;2018;01;13;Maanantai;3;2;5
625;01.01.2018;2018;01;14;Maanantai;7;5;12
625;01.01.2018;2018;01;15;Maanantai;0;2;2
625;01.01.2018;2018;01;16;Maanantai;4;2;6
625;01.01.2018;2018;01;17;Maanantai;2;4;6
625;01.01.2018;2018;01;18;Maanantai;0;0;0
625;01.01.2018;2018;01;19;Maanantai;2;3;5
625;01.01.2018;2018;01;20;Maanantai;1;3;4
625;01.01.2018;2018;01;21;Maanantai;0;4;4
625;01.01.2018;2018;01;22;Maanantai;1;2;3
625;01.01.2018;2018;01;23;Maanantai;0;2;2
625;02.01.2018;2018;01;00;Tiistai;0;0;0
625;02.01.2018;2018;01;01;Tiistai;0;1;1
625;02.01.2018;2018;01;02;Tiistai;0;0;0
625;02.01.2018;2018;01;03;Tiistai;0;0;0
625;02.01.2018;2018;01;04;Tiistai;0;0;0
625;02.01.2018;2018;01;05;Tiistai;0;0;0
625;02.01.2018;2018;01;06;Tiistai;1;3;4
625;02.01.2018;2018;01;07;Tiistai;9;2;11
625;02.01.2018;2018;01;08;Tiistai;12;7;19
625;02.01.2018;2018;01;09;Tiistai;7;8;15
625;02.01.2018;2018;01;10;Tiistai;7;7;14
625;02.01.2018;2018;01;11;Tiistai;2;4;6
625;02.01.2018;2018;01;12;Tiistai;4;6;10
625;02.01.2018;2018;01;13;Tiistai;5;9;14
625;02.01.2018;2018;01;14;Tiistai;7;11;18
625;02.01.2018;2018;01;15;Tiistai;2;12;14
625;02.01.2018;2018;01;16;Tiistai;6;12;18
625;02.01.2018;2018;01;17;Tiistai;12;14;26
625;02.01.2018;2018;01;18;Tiistai;4;5;9
625;02.01.2018;2018;01;19;Tiistai;5;2;7
625;02.01.2018;2018;01;20;Tiistai;0;2;2
625;02.01.2018;2018;01;21;Tiistai;2;6;8
625;02.01.2018;2018;01;22;Tiistai;1;3;4
625;02.01.2018;2018;01;23;Tiistai;0;2;2
625;03.01.2018;2018;01;00;Keskiviikko;1;1;2
625;03.01.2018;2018;01;01;Keskiviikko;1;0;1
625;03.01.2018;2018;01;02;Keskiviikko;0;0;0
625;03.01.2018;2018;01;03;Keskiviikko;0;0;0
625;03.01.2018;2018;01;04;Keskiviikko;0;0;0
625;03.01.2018;2018;01;05;Keskiviikko;0;0;0
625;03.01.2018;2018;01;06;Keskiviikko;2;1;3
625;03.01.2018;2018;01;07;Keskiviikko;10;3;13
625;03.01.2018;2018;01;08;Keskiviikko;8;16;24
625;03.01.2018;2018;01;09;Keskiviikko;7;14;21
625;03.01.2018;2018;01;10;Keskiviikko;0;4;4
625;03.01.2018;2018;01;11;Keskiviikko;0;2;2
625;03.01.2018;2018;01;12;Keskiviikko;1;6;7
625;03.01.2018;2018;01;13;Keskiviikko;1;6;7
625;03.01.2018;2018;01;14;Keskiviikko;1;9;10
625;03.01.2018;2018;01;15;Keskiviikko;5;7;12
625;03.01.2018;2018;01;16;Keskiviikko;3;5;8
625;03.01.2018;2018;01;17;Keskiviikko;3;6;9
625;03.01.2018;2018;01;18;Keskiviikko;10;5;15
625;03.01.2018;2018;01;19;Keskiviikko;5;6;11
625;03.01.2018;2018;01;20;Keskiviikko;0;3;3
625;03.01.2018;2018;01;21;Keskiviikko;4;2;6
625;03.01.2018;2018;01;22;Keskiviikko;1;4;5
625;03.01.2018;2018;01;23;Keskiviikko;2;1;3
625;04.01.2018;2018;01;00;Torstai;0;1;1
625;04.01.2018;2018;01;01;Torstai;0;0;0
625;04.01.2018;2018;01;02;Torstai;2;1;3
625;04.01.2018;2018;01;03;Torstai;0;0;0
625;04.01.2018;2018;01;04;Torstai;0;0;0
625;04.01.2018;2018;01;05;Torstai;0;0;0
625;04.01.2018;2018;01;06;Torstai;2;2;4
625;04.01.2018;2018;01;07;Torstai;6;5;11
625;04.01.2018;2018;01;08;Torstai;5;10;15
625;04.01.2018;2018;01;09;Torstai;5;6;11
625;04.01.2018;2018;01;10;Torstai;3;8;11
625;04.01.2018;2018;01;11;Torstai;4;9;13
625;04.01.2018;2018;01;12;Torstai;3;11;14
625;04.01.2018;2018;01;13;Torstai;3;8;11
625;04.01.2018;2018;01;14;Torstai;1;3;4
625;04.01.2018;2018;01;15;Torstai;6;4;10
625;04.01.2018;2018;01;16;Torstai;4;5;9
625;04.01.2018;2018;01;17;Torstai;10;13;23
625;04.01.2018;2018;01;18;Torstai;1;9;10
625;04.01.2018;2018;01;19;Torstai;0;3;3
625;04.01.2018;2018;01;20;Torstai;2;2;4
625;04.01.2018;2018;01;21;Torstai;3;2;5
625;04.01.2018;2018;01;22;Torstai;3;6;9
625;04.01.2018;2018;01;23;Torstai;1;1;2
625;05.01.2018;2018;01;00;Perjantai;0;1;1
625;05.01.2018;2018;01;01;Perjantai;0;0;0
625;05.01.2018;2018;01;02;Perjantai;0;0;0
625;05.01.2018;2018;01;03;Perjantai;0;0;0
625;05.01.2018;2018;01;04;Perjantai;0;0;0
625;05.01.2018;2018;01;05;Perjantai;0;0;0
625;05.01.2018;2018;01;06;Perjantai;0;2;2
625;05.01.2018;2018;01;07;Perjantai;7;3;10
625;05.01.2018;2018;01;08;Perjantai;5;5;10
625;05.01.2018;2018;01;09;Perjantai;2;5;7
625;05.01.2018;2018;01;10;Perjantai;0;5;5
625;05.01.2018;2018;01;11;Perjantai;4;3;7
625;05.01.2018;2018;01;12;Perjantai;2;3;5
625;05.01.2018;2018;01;13;Perjantai;3;9;12
625;05.01.2018;2018;01;14;Perjantai;1;2;3
625;05.01.2018;2018;01;15;Perjantai;4;6;10
625;05.01.2018;2018;01;16;Perjantai;5;2;7
625;05.01.2018;2018;01;17;Perjantai;3;6;9
625;05.01.2018;2018;01;18;Perjantai;7;3;10
625;05.01.2018;2018;01;19;Perjantai;3;3;6
625;05.01.2018;2018;01;20;Perjantai;3;2;5
625;05.01.2018;2018;01;21;Perjantai;3;1;4
625;05.01.2018;2018;01;22;Perjantai;1;5;6
625;05.01.2018;2018;01;23;Perjantai;0;0;0
625;06.01.2018;2018;01;00;Lauantai;0;1;1
625;06.01.2018;2018;01;01;Lauantai;3;0;3
625;06.01.2018;2018;01;02;Lauantai;1;0;1
625;06.01.2018;2018;01;03;Lauantai;0;0;0
625;06.01.2018;2018;01;04;Lauantai;1;0;1
625;06.01.2018;2018;01;05;Lauantai;0;0;0
625;06.01.2018;2018;01;06;Lauantai;0;0;0
625;06.01.2018;2018;01;07;Lauantai;1;1;2
625;06.01.2018;2018;01;08;Lauantai;1;4;5
625;06.01.2018;2018;01;09;Lauantai;1;2;3
625;06.01.2018;2018;01;10;Lauantai;3;2;5
625;06.01.2018;2018;01;11;Lauantai;3;2;5
625;06.01.2018;2018;01;12;Lauantai;2;2;4
625;06.01.2018;2018;01;13;Lauantai;2;6;8
625;06.01.2018;2018;01;14;Lauantai;4;3;7
625;06.01.2018;2018;01;15;Lauantai;2;1;3
625;06.01.2018;2018;01;16;Lauantai;2;4;6
625;06.01.2018;2018;01;17;Lauantai;3;1;4
625;06.01.2018;2018;01;18;Lauantai;4;0;4
625;06.01.2018;2018;01;19;Lauantai;1;3;4
625;06.01.2018;2018;01;20;Lauantai;3;4;7
625;06.01.2018;2018;01;21;Lauantai;5;6;11
625;06.01.2018;2018;01;22;Lauantai;4;3;7
625;06.01.2018;2018;01;23;Lauantai;1;0;1
625;07.01.2018;2018;01;00;Sunnuntai;0;0;0
625;07.01.2018;2018;01;01;Sunnuntai;0;2;2
625;07.01.2018;2018;01;02;Sunnuntai;0;0;0
625;07.01.2018;2018;01;03;Sunnuntai;1;1;2
625;07.01.2018;2018;01;04;Sunnuntai;0;0;0
625;07.01.2018;2018;01;05;Sunnuntai;0;0;0
625;07.01.2018;2018;01;06;Sunnuntai;0;0;0
625;07.01.2018;2018;01;07;Sunnuntai;2;2;4
625;07.01.2018;2018;01;08;Sunnuntai;0;3;3
625;07.01.2018;2018;01;09;Sunnuntai;5;4;9
625;07.01.2018;2018;01;10;Sunnuntai;0;0;0
625;07.01.2018;2018;01;11;Sunnuntai;1;1;2
625;07.01.2018;2018;01;12;Sunnuntai;3;2;5
625;07.01.2018;2018;01;13;Sunnuntai;5;9;14
625;07.01.2018;2018;01;14;Sunnuntai;4;9;13
625;07.01.2018;2018;01;15;Sunnuntai;2;5;7
625;07.01.2018;2018;01;16;Sunnuntai;1;4;5
625;07.01.2018;2018;01;17;Sunnuntai;2;2;4
625;07.01.2018;2018;01;18;Sunnuntai;1;1;2
625;07.01.2018;2018;01;19;Sunnuntai;3;3;6
625;07.01.2018;2018;01;20;Sunnuntai;1;1;2
625;07.01.2018;2018;01;21;Sunnuntai;0;1;1
625;07.01.2018;2018;01;22;Sunnuntai;3;0;3
625;07.01.2018;2018;01;23;Sunnuntai;0;0;0
625;08.01.2018;2018;01;00;Maanantai;1;0;1
625;08.01.2018;2018;01;01;Maanantai;0;0;0
625;08.01.2018;2018;01;02;Maanantai;0;0;0
625;08.01.2018;2018;01;03;Maanantai;0;0;0
625;08.01.2018;2018;01;04;Maanantai;0;0;0
625;08.01.2018;2018;01;05;Maanantai;0;1;1
625;08.01.2018;2018;01;06;Maanantai;1;1;2
625;08.01.2018;2018;01;07;Maanantai;12;3;15
625;08.01.2018;2018;01;08;Maanantai;21;18;39
625;08.01.2018;2018;01;09;Maanantai;18;8;26
625;08.01.2018;2018;01;10;Maanantai;15;12;27
625;08.01.2018;2018;01;11;Maanantai;5;5;10
625;08.01.2018;2018;01;12;Maanantai;5;9;14
625;08.01.2018;2018;01;13;Maanantai;3;6;9
625;08.01.2018;2018;01;14;Maanantai;6;9;15
625;08.01.2018;2018;01;15;Maanantai;8;23;31
625;08.01.2018;2018;01;16;Maanantai;7;19;26
625;08.01.2018;2018;01;17;Maanantai;10;23;33
625;08.01.2018;2018;01;18;Maanantai;7;7;14
625;08.01.2018;2018;01;19;Maanantai;6;4;10
625;08.01.2018;2018;01;20;Maanantai;4;5;9
625;08.01.2018;2018;01;21;Maanantai;2;3;5
625;08.01.2018;2018;01;22;Maanantai;1;4;5
625;08.01.2018;2018;01;23;Maanantai;2;1;3
625;09.01.2018;2018;01;00;Tiistai;0;0;0
625;09.01.2018;2018;01;01;Tiistai;0;0;0
625;09.01.2018;2018;01;02;Tiistai;0;0;0
625;09.01.2018;2018;01;03;Tiistai;0;0;0
625;09.01.2018;2018;01;04;Tiistai;0;2;2
625;09.01.2018;2018;01;05;Tiistai;0;1;1
625;09.01.2018;2018;01;06;Tiistai;2;2;4
625;09.01.2018;2018;01;07;Tiistai;11;3;14
625;09.01.2018;2018;01;08;Tiistai;31;13;44
625;09.01.2018;2018;01;09;Tiistai;16;14;30
625;09.01.2018;2018;01;10;Tiistai;15;3;18
625;09.01.2018;2018;01;11;Tiistai;8;4;12
625;09.01.2018;2018;01;12;Tiistai;4;7;11
625;09.01.2018;2018;01;13;Tiistai;7;6;13
625;09.01.2018;2018;01;14;Tiistai;4;15;19
625;09.01.2018;2018;01;15;Tiistai;3;22;25
625;09.01.2018;2018;01;16;Tiistai;8;13;21
625;09.01.2018;2018;01;17;Tiistai;11;23;34
625;09.01.2018;2018;01;18;Tiistai;8;6;14
625;09.01.2018;2018;01;19;Tiistai;2;7;9
625;09.01.2018;2018;01;20;Tiistai;2;3;5
625;09.01.2018;2018;01;21;Tiistai;2;5;7
625;09.01.2018;2018;01;22;Tiistai;2;2;4
625;09.01.2018;2018;01;23;Tiistai;1;1;2
625;10.01.2018;2018;01;00;Keskiviikko;1;1;2
625;10.01.2018;2018;01;01;Keskiviikko;0;0;0
625;10.01.2018;2018;01;02;Keskiviikko;0;0;0
625;10.01.2018;2018;01;03;Keskiviikko;0;0;0
625;10.01.2018;2018;01;04;Keskiviikko;0;2;2
625;10.01.2018;2018;01;05;Keskiviikko;0;1;1
625;10.01.2018;2018;01;06;Keskiviikko;2;3;5
625;10.01.2018;2018;01;07;Keskiviikko;14;4;18
625;10.01.2018;2018;01;08;Keskiviikko;34;23;57
625;10.01.2018;2018;01;09;Keskiviikko;15;11;26
625;10.01.2018;2018;01;10;Keskiviikko;13;6;19
625;10.01.2018;2018;01;11;Keskiviikko;8;5;13
625;10.01.2018;2018;01;12;Keskiviikko;1;3;4
625;10.01.2018;2018;01;13;Keskiviikko;6;6;12
625;10.01.2018;2018;01;14;Keskiviikko;0;13;13
625;10.01.2018;2018;01;15;Keskiviikko;28;45;73
625;10.01.2018;2018;01;16;Keskiviikko;7;15;22
625;10.01.2018;2018;01;17;Keskiviikko;16;25;41
625;10.01.2018;2018;01;18;Keskiviikko;4;7;11
625;10.01.2018;2018;01;19;Keskiviikko;9;7;16
625;10.01.2018;2018;01;20;Keskiviikko;1;5;6
625;10.01.2018;2018;01;21;Keskiviikko;4;7;11
625;10.01.2018;2018;01;22;Keskiviikko;5;1;6
625;10.01.2018;2018;01;23;Keskiviikko;2;1;3
625;11.01.2018;2018;01;00;Torstai;1;1;2
625;11.01.2018;2018;01;01;Torstai;0;0;0
625;11.01.2018;2018;01;02;Torstai;0;1;1
625;11.01.2018;2018;01;03;Torstai;0;0;0
625;11.01.2018;2018;01;04;Torstai;0;2;2
625;11.01.2018;2018;01;05;Torstai;1;0;1
625;11.01.2018;2018;01;06;Torstai;1;2;3
625;11.01.2018;2018;01;07;Torstai;7;3;10
625;11.01.2018;2018;01;08;Torstai;31;17;48
625;11.01.2018;2018;01;09;Torstai;20;21;41
625;11.01.2018;2018;01;10;Torstai;6;5;11
625;11.01.2018;2018;01;11;Torstai;4;3;7
625;11.01.2018;2018;01;12;Torstai;5;6;11
625;11.01.2018;2018;01;13;Torstai;2;6;8
625;11.01.2018;2018;01;14;Torstai;4;6;10
625;11.01.2018;2018;01;15;Torstai;3;21;24
625;11.01.2018;2018;01;16;Torstai;7;19;26
625;11.01.2018;2018;01;17;Torstai;9;17;26
625;11.01.2018;2018;01;18;Torstai;7;10;17
625;11.01.2018;2018;01;19;Torstai;2;4;6
625;11.01.2018;2018;01;20;Torstai;2;3;5
625;11.01.2018;2018;01;21;Torstai;3;4;7
625;11.01.2018;2018;01;22;Torstai;2;3;5
625;11.01.2018;2018;01;23;Torstai;0;0;0
625;12.01.2018;2018;01;00;Perjantai;2;1;3
625;12.01.2018;2018;01;01;Perjantai;0;0;0
625;12.01.2018;2018;01;02;Perjantai;0;0;0
625;12.01.2018;2018;01;03;Perjantai;0;0;0
625;12.01.2018;2018;01;04;Perjantai;0;1;1
625;12.01.2018;2018;01;05;Perjantai;1;2;3
625;12.01.2018;2018;01;06;Perjantai;2;1;3
625;12.01.2018;2018;01;07;Perjantai;4;1;5
625;12.01.2018;2018;01;08;Perjantai;25;13;38
625;12.01.2018;2018;01;09;Perjantai;16;10;26
625;12.01.2018;2018;01;10;Perjantai;7;6;13
625;12.01.2018;2018;01;11;Perjantai;6;3;9
625;12.01.2018;2018;01;12;Perjantai;2;13;15
625;12.01.2018;2018;01;13;Perjantai;3;20;23
625;12.01.2018;2018;01;14;Perjantai;4;16;20
625;12.01.2018;2018;01;15;Perjantai;5;14;19
625;12.01.2018;2018;01;16;Perjantai;2;7;9
625;12.01.2018;2018;01;17;Perjantai;6;14;20
625;12.01.2018;2018;01;18;Perjantai;4;3;7
625;12.01.2018;2018;01;19;Perjantai;1;4;5
625;12.01.2018;2018;01;20;Perjantai;1;3;4
625;12.01.2018;2018;01;21;Perjantai;2;2;4
625;12.01.2018;2018;01;22;Perjantai;0;0;0
625;12.01.2018;2018;01;23;Perjantai;2;2;4
625;13.01.2018;2018;01;00;Lauantai;1;2;3
625;13.01.2018;2018;01;01;Lauantai;0;1;1
625;13.01.2018;2018;01;02;Lauantai;0;0;0
625;13.01.2018;2018;01;03;Lauantai;0;0;0
625;13.01.2018;2018;01;04;Lauantai;0;0;0
625;13.01.2018;2018;01;05;Lauantai;0;1;1
625;13.01.2018;2018;01;06;Lauantai;0;0;0
625;13.01.2018;2018;01;07;Lauantai;0;0;0
625;13.01.2018;2018;01;08;Lauantai;1;2;3
625;13.01.2018;2018;01;09;Lauantai;0;1;1
625;13.01.2018;2018;01;10;Lauantai;3;2;5
625;13.01.2018;2018;01;11;Lauantai;3;4;7
625;13.01.2018;2018;01;12;Lauantai;2;4;6
625;13.01.2018;2018;01;13;Lauantai;5;3;8
625;13.01.2018;2018;01;14;Lauantai;3;4;7
625;13.01.2018;2018;01;15;Lauantai;1;4;5
625;13.01.2018;2018;01;16;Lauantai;3;4;7
625;13.01.2018;2018;01;17;Lauantai;2;3;5
625;13.01.2018;2018;01;18;Lauantai;1;5;6
625;13.01.2018;2018;01;19;Lauantai;3;6;9
625;13.01.2018;2018;01;20;Lauantai;1;0;1
625;13.01.2018;2018;01;21;Lauantai;3;2;5
625;13.01.2018;2018;01;22;Lauantai;0;3;3
625;13.01.2018;2018;01;23;Lauantai;1;0;1
625;14.01.2018;2018;01;00;Sunnuntai;1;2;3
625;14.01.2018;2018;01;01;Sunnuntai;0;0;0
625;14.01.2018;2018;01;02;Sunnuntai;0;0;0
625;14.01.2018;2018;01;03;Sunnuntai;0;0;0
625;14.01.2018;2018;01;04;Sunnuntai;0;0;0
625;14.01.2018;2018;01;05;Sunnuntai;0;0;0
625;14.01.2018;2018;01;06;Sunnuntai;0;0;0
625;14.01.2018;2018;01;07;Sunnuntai;0;0;0
625;14.01.2018;2018;01;08;Sunnuntai;0;2;2
625;14.01.2018;2018;01;09;Sunnuntai;2;1;3
625;14.01.2018;2018;01;10;Sunnuntai;1;3;4
625;14.01.2018;2018;01;11;Sunnuntai;1;2;3
625;14.01.2018;2018;01;12;Sunnuntai;3;2;5
625;14.01.2018;2018;01;13;Sunnuntai;4;7;11
625;14.01.2018;2018;01;14;Sunnuntai;3;3;6
625;14.01.2018;2018;01;15;Sunnuntai;1;4;5
625;14.01.2018;2018;01;16;Sunnuntai;2;3;5
625;14.01.2018;2018;01;17;Sunnuntai;4;4;8
625;14.01.2018;2018;01;18;Sunnuntai;4;3;7
625;14.01.2018;2018;01;19;Sunnuntai;2;2;4
625;14.01.2018;2018;01;20;Sunnuntai;2;2;4
625;14.01.2018;2018;01;21;Sunnuntai;1;2;3
625;14.01.2018;2018;01;22;Sunnuntai;0;4;4
625;14.01.2018;2018;01;23;Sunnuntai;1;3;4
625;15.01.2018;2018;01;00;Maanantai;0;0;0
625;15.01.2018;2018;01;01;Maanantai;0;0;0
625;15.01.2018;2018;01;02;Maanantai;0;0;0
625;15.01.2018;2018;01;03;Maanantai;0;0;0
625;15.01.2018;2018;01;04;Maanantai;0;0;0
625;15.01.2018;2018;01;05;Maanantai;1;0;1
625;15.01.2018;2018;01;06;Maanantai;0;2;2
625;15.01.2018;2018;01;07;Maanantai;8;3;11
625;15.01.2018;2018;01;08;Maanantai;23;12;35
625;15.01.2018;2018;01;09;Maanantai;8;18;26
625;15.01.2018;2018;01;10;Maanantai;17;11;28
625;15.01.2018;2018;01;11;Maanantai;2;3;5
625;15.01.2018;2018;01;12;Maanantai;2;9;11
625;15.01.2018;2018;01;13;Maanantai;1;4;5
625;15.01.2018;2018;01;14;Maanantai;4;14;18
625;15.01.2018;2018;01;15;Maanantai;1;14;15
625;15.01.2018;2018;01;16;Maanantai;5;18;23
625;15.01.2018;2018;01;17;Maanantai;7;19;26
625;15.01.2018;2018;01;18;Maanantai;2;8;10
625;15.01.2018;2018;01;19;Maanantai;6;3;9
625;15.01.2018;2018;01;20;Maanantai;3;6;9
625;15.01.2018;2018;01;21;Maanantai;2;2;4
625;15.01.2018;2018;01;22;Maanantai;1;0;1
625;15.01.2018;2018;01;23;Maanantai;1;2;3
625;16.01.2018;2018;01;00;Tiistai;1;1;2
625;16.01.2018;2018;01;01;Tiistai;0;0;0
625;16.01.2018;2018;01;02;Tiistai;0;0;0
625;16.01.2018;2018;01;03;Tiistai;0;1;1
625;16.01.2018;2018;01;04;Tiistai;0;0;0
625;16.01.2018;2018;01;05;Tiistai;1;0;1
625;16.01.2018;2018;01;06;Tiistai;1;0;1
625;16.01.2018;2018;01;07;Tiistai;6;2;8
625;16.01.2018;2018;01;08;Tiistai;18;10;28
625;16.01.2018;2018;01;09;Tiistai;14;8;22
625;16.01.2018;2018;01;10;Tiistai;9;5;14
625;16.01.2018;2018;01;11;Tiistai;5;3;8
625;16.01.2018;2018;01;12;Tiistai;2;4;6
625;16.01.2018;2018;01;13;Tiistai;3;4;7
625;16.01.2018;2018;01;14;Tiistai;1;9;10
625;16.01.2018;2018;01;15;Tiistai;5;28;33
625;16.01.2018;2018;01;16;Tiistai;4;20;24
625;16.01.2018;2018;01;17;Tiistai;6;11;17
625;16.01.2018;2018;01;18;Tiistai;3;7;10
625;16.01.2018;2018;01;19;Tiistai;1;2;3
625;16.01.2018;2018;01;20;Tiistai;2;1;3
625;16.01.2018;2018;01;21;Tiistai;2;3;5
625;16.01.2018;2018;01;22;Tiistai;1;2;3
625;16.01.2018;2018;01;23;Tiistai;1;1;2
625;17.01.2018;2018;01;00;Keskiviikko;1;0;1
625;17.01.2018;2018;01;01;Keskiviikko;1;0;1
625;17.01.2018;2018;01;02;Keskiviikko;0;0;0
625;17.01.2018;2018;01;03;Keskiviikko;0;1;1
625;17.01.2018;2018;01;04;Keskiviikko;0;0;0
625;17.01.2018;2018;01;05;Keskiviikko;1;0;1
625;17.01.2018;2018;01;06;Keskiviikko;1;2;3
625;17.01.2018;2018;01;07;Keskiviikko;5;2;7
625;17.01.2018;2018;01;08;Keskiviikko;26;18;44
625;17.01.2018;2018;01;09;Keskiviikko;7;8;15
625;17.01.2018;2018;01;10;Keskiviikko;5;6;11
625;17.01.2018;2018;01;11;Keskiviikko;2;2;4
625;17.01.2018;2018;01;12;Keskiviikko;2;4;6
625;17.01.2018;2018;01;13;Keskiviikko;5;5;10
625;17.01.2018;2018;01;14;Keskiviikko;1;25;26
625;17.01.2018;2018;01;15;Keskiviikko;6;14;20
625;17.01.2018;2018;01;16;Keskiviikko;5;18;23
625;17.01.2018;2018;01;17;Keskiviikko;6;18;24
625;17.01.2018;2018;01;18;Keskiviikko;7;6;13
625;17.01.2018;2018;01;19;Keskiviikko;2;4;6
625;17.01.2018;2018;01;20;Keskiviikko;1;5;6
625;17.01.2018;2018;01;21;Keskiviikko;2;4;6
625;17.01.2018;2018;01;22;Keskiviikko;5;0;5
625;17.01.2018;2018;01;23;Keskiviikko;4;0;4
625;18.01.2018;2018;01;00;Torstai;2;1;3
625;18.01.2018;2018;01;01;Torstai;0;0;0
625;18.01.2018;2018;01;02;Torstai;0;0;0
625;18.01.2018;2018;01;03;Torstai;0;0;0
625;18.01.2018;2018;01;04;Torstai;0;1;1
625;18.01.2018;2018;01;05;Torstai;1;0;1
625;18.01.2018;2018;01;06;Torstai;2;2;4
625;18.01.2018;2018;01;07;Torstai;6;1;7
625;18.01.2018;2018;01;08;Torstai;31;8;39
625;18.01.2018;2018;01;09;Torstai;8;8;16
625;18.01.2018;2018;01;10;Torstai;9;8;17
625;18.01.2018;2018;01;11;Torstai;3;5;8
625;18.01.2018;2018;01;12;Torstai;4;12;16
625;18.01.2018;2018;01;13;Torstai;6;6;12
625;18.01.2018;2018;01;14;Torstai;4;8;12
625;18.01.2018;2018;01;15;Torstai;4;30;34
625;18.01.2018;2018;01;16;Torstai;6;21;27
625;18.01.2018;2018;01;17;Torstai;4;14;18
625;18.01.2018;2018;01;18;Torstai;4;11;15
625;18.01.2018;2018;01;19;Torstai;5;3;8
625;18.01.2018;2018;01;20;Torstai;1;5;6
625;18.01.2018;2018;01;21;Torstai;1;2;3
625;18.01.2018;2018;01;22;Torstai;2;3;5
625;18.01.2018;2018;01;23;Torstai;3;2;5
625;19.01.2018;2018;01;00;Perjantai;3;2;5
625;19.01.2018;2018;01;01;Perjantai;1;1;2
625;19.01.2018;2018;01;02;Perjantai;0;0;0
625;19.01.2018;2018;01;03;Perjantai;0;0;0
625;19.01.2018;2018;01;04;Perjantai;0;1;1
625;19.01.2018;2018;01;05;Perjantai;0;0;0
625;19.01.2018;2018;01;06;Perjantai;2;2;4
625;19.01.2018;2018;01;07;Perjantai;13;3;16
625;19.01.2018;2018;01;08;Perjantai;28;10;38
625;19.01.2018;2018;01;09;Perjantai;10;7;17
625;19.01.2018;2018;01;10;Perjantai;16;7;23
625;19.01.2018;2018;01;11;Perjantai;3;1;4
625;19.01.2018;2018;01;12;Perjantai;0;4;4
625;19.01.2018;2018;01;13;Perjantai;3;12;15
625;19.01.2018;2018;01;14;Perjantai;3;12;15
625;19.01.2018;2018;01;15;Perjantai;3;19;22
625;19.01.2018;2018;01;16;Perjantai;5;9;14
625;19.01.2018;2018;01;17;Perjantai;1;13;14
625;19.01.2018;2018;01;18;Perjantai;6;1;7
625;19.01.2018;2018;01;19;Perjantai;1;2;3
625;19.01.2018;2018;01;20;Perjantai;2;3;5
625;19.01.2018;2018;01;21;Perjantai;1;1;2
625;19.01.2018;2018;01;22;Perjantai;0;2;2
625;19.01.2018;2018;01;23;Perjantai;1;0;1
625;20.01.2018;2018;01;00;Lauantai;1;1;2
625;20.01.2018;2018;01;01;Lauantai;0;0;0
625;20.01.2018;2018;01;02;Lauantai;1;0;1
625;20.01.2018;2018;01;03;Lauantai;0;0;0
625;20.01.2018;2018;01;04;Lauantai;0;0;0
625;20.01.2018;2018;01;05;Lauantai;1;0;1
625;20.01.2018;2018;01;06;Lauantai;0;3;3
625;20.01.2018;2018;01;07;Lauantai;0;0;0
625;20.01.2018;2018;01;08;Lauantai;3;1;4
625;20.01.2018;2018;01;09;Lauantai;0;0;0
625;20.01.2018;2018;01;10;Lauantai;1;0;1
625;20.01.2018;2018;01;11;Lauantai;2;2;4
625;20.01.2018;2018;01;12;Lauantai;1;0;1
625;20.01.2018;2018;01;13;Lauantai;2;5;7
625;20.01.2018;2018;01;14;Lauantai;5;5;10
625;20.01.2018;2018;01;15;Lauantai;1;1;2
625;20.01.2018;2018;01;16;Lauantai;0;3;3
625;20.01.2018;2018;01;17;Lauantai;0;1;1
625;20.01.2018;2018;01;18;Lauantai;4;3;7
625;20.01.2018;2018;01;19;Lauantai;3;2;5
625;20.01.2018;2018;01;20;Lauantai;0;0;0
625;20.01.2018;2018;01;21;Lauantai;2;3;5
625;20.01.2018;2018;01;22;Lauantai;1;3;4
625;20.01.2018;2018;01;23;Lauantai;2;0;2
625;21.01.2018;2018;01;00;Sunnuntai;0;1;1
625;21.01.2018;2018;01;01;Sunnuntai;0;0;0
625;21.01.2018;2018;01;02;Sunnuntai;0;0;0
625;21.01.2018;2018;01;03;Sunnuntai;0;0;0
625;21.01.2018;2018;01;04;Sunnuntai;1;0;1
625;21.01.2018;2018;01;05;Sunnuntai;0;0;0
625;21.01.2018;2018;01;06;Sunnuntai;0;0;0
625;21.01.2018;2018;01;07;Sunnuntai;0;0;0
625;21.01.2018;2018;01;08;Sunnuntai;0;2;2
625;21.01.2018;2018;01;09;Sunnuntai;1;1;2
625;21.01.2018;2018;01;10;Sunnuntai;1;0;1
625;21.01.2018;2018;01;11;Sunnuntai;0;1;1
625;21.01.2018;2018;01;12;Sunnuntai;1;3;4
625;21.01.2018;2018;01;13;Sunnuntai;0;4;4
625;21.01.2018;2018;01;14;Sunnuntai;0;1;1
625;21.01.2018;2018;01;15;Sunnuntai;1;1;2
625;21.01.2018;2018;01;16;Sunnuntai;1;1;2
625;21.01.2018;2018;01;17;Sunnuntai;1;1;2
625;21.01.2018;2018;01;18;Sunnuntai;1;1;2
625;21.01.2018;2018;01;19;Sunnuntai;2;4;6
625;21.01.2018;2018;01;20;Sunnuntai;0;5;5
625;21.01.2018;2018;01;21;Sunnuntai;1;1;2
625;21.01.2018;2018;01;22;Sunnuntai;0;2;2
625;21.01.2018;2018;01;23;Sunnuntai;0;1;1
625;22.01.2018;2018;01;00;Maanantai;0;0;0
625;22.01.2018;2018;01;01;Maanantai;0;1;1
625;22.01.2018;2018;01;02;Maanantai;0;0;0
625;22.01.2018;2018;01;03;Maanantai;0;0;0
625;22.01.2018;2018;01;04;Maanantai;0;1;1
625;22.01.2018;2018;01;05;Maanantai;1;0;1
625;22.01.2018;2018;01;06;Maanantai;1;3;4
625;22.01.2018;2018;01;07;Maanantai;6;1;7
625;22.01.2018;2018;01;08;Maanantai;13;7;20
625;22.01.2018;2018;01;09;Maanantai;17;11;28
625;22.01.2018;2018;01;10;Maanantai;7;7;14
625;22.01.2018;2018;01;11;Maanantai;3;2;5
625;22.01.2018;2018;01;12;Maanantai;0;2;2
625;22.01.2018;2018;01;13;Maanantai;2;7;9
625;22.01.2018;2018;01;14;Maanantai;4;6;10
625;22.01.2018;2018;01;15;Maanantai;5;14;19
625;22.01.2018;2018;01;16;Maanantai;2;14;16
625;22.01.2018;2018;01;17;Maanantai;7;9;16
625;22.01.2018;2018;01;18;Maanantai;3;4;7
625;22.01.2018;2018;01;19;Maanantai;2;4;6
625;22.01.2018;2018;01;20;Maanantai;2;1;3
625;22.01.2018;2018;01;21;Maanantai;1;2;3
625;22.01.2018;2018;01;22;Maanantai;1;0;1
625;22.01.2018;2018;01;23;Maanantai;0;0;0
625;23.01.2018;2018;01;00;Tiistai;0;0;0
625;23.01.2018;2018;01;01;Tiistai;0;0;0
625;23.01.2018;2018;01;02;Tiistai;0;1;1
625;23.01.2018;2018;01;03;Tiistai;0;0;0
625;23.01.2018;2018;01;04;Tiistai;0;0;0
625;23.01.2018;2018;01;05;Tiistai;0;1;1
625;23.01.2018;2018;01;06;Tiistai;1;0;1
625;23.01.2018;2018;01;07;Tiistai;5;2;7
625;23.01.2018;2018;01;08;Tiistai;16;8;24
625;23.01.2018;2018;01;09;Tiistai;8;7;15
625;23.01.2018;2018;01;10;Tiistai;4;5;9
625;23.01.2018;2018;01;11;Tiistai;5;5;10
625;23.01.2018;2018;01;12;Tiistai;3;1;4
625;23.01.2018;2018;01;13;Tiistai;6;2;8
625;23.01.2018;2018;01;14;Tiistai;7;3;10
625;23.01.2018;2018;01;15;Tiistai;2;7;9
625;23.01.2018;2018;01;16;Tiistai;1;12;13
625;23.01.2018;2018;01;17;Tiistai;4;12;16
625;23.01.2018;2018;01;18;Tiistai;4;3;7
625;23.01.2018;2018;01;19;Tiistai;2;0;2
625;23.01.2018;2018;01;20;Tiistai;1;1;2
625;23.01.2018;2018;01;21;Tiistai;2;3;5
625;23.01.2018;2018;01;22;Tiistai;0;0;0
625;23.01.2018;2018;01;23;Tiistai;1;1;2
625;24.01.2018;2018;01;00;Keskiviikko;1;0;1
625;24.01.2018;2018;01;01;Keskiviikko;1;0;1
625;24.01.2018;2018;01;02;Keskiviikko;0;1;1
625;24.01.2018;2018;01;03;Keskiviikko;0;1;1
625;24.01.2018;2018;01;04;Keskiviikko;0;0;0
625;24.01.2018;2018;01;05;Keskiviikko;0;1;1
625;24.01.2018;2018;01;06;Keskiviikko;0;1;1
625;24.01.2018;2018;01;07;Keskiviikko;5;1;6
625;24.01.2018;2018;01;08;Keskiviikko;14;8;22
625;24.01.2018;2018;01;09;Keskiviikko;12;12;24
625;24.01.2018;2018;01;10;Keskiviikko;9;5;14
625;24.01.2018;2018;01;11;Keskiviikko;5;6;11
625;24.01.2018;2018;01;12;Keskiviikko;3;1;4
625;24.01.2018;2018;01;13;Keskiviikko;2;4;6
625;24.01.2018;2018;01;14;Keskiviikko;6;11;17
625;24.01.2018;2018;01;15;Keskiviikko;4;19;23
625;24.01.2018;2018;01;16;Keskiviikko;4;12;16
625;24.01.2018;2018;01;17;Keskiviikko;5;24;29
625;24.01.2018;2018;01;18;Keskiviikko;8;5;13
625;24.01.2018;2018;01;19;Keskiviikko;2;1;3
625;24.01.2018;2018;01;20;Keskiviikko;1;1;2
625;24.01.2018;2018;01;21;Keskiviikko;3;0;3
625;24.01.2018;2018;01;22;Keskiviikko;3;4;7
625;24.01.2018;2018;01;23;Keskiviikko;1;1;2
625;25.01.2018;2018;01;00;Torstai;0;0;0
625;25.01.2018;2018;01;01;Torstai;0;0;0
625;25.01.2018;2018;01;02;Torstai;0;1;1
625;25.01.2018;2018;01;03;Torstai;0;1;1
625;25.01.2018;2018;01;04;Torstai;0;0;0
625;25.01.2018;2018;01;05;Torstai;0;1;1
625;25.01.2018;2018;01;06;Torstai;1;1;2
625;25.01.2018;2018;01;07;Torstai;6;3;9
625;25.01.2018;2018;01;08;Torstai;20;2;22
625;25.01.2018;2018;01;09;Torstai;19;6;25
625;25.01.2018;2018;01;10;Torstai;7;9;16
625;25.01.2018;2018;01;11;Torstai;2;4;6
625;25.01.2018;2018;01;12;Torstai;4;4;8
625;25.01.2018;2018;01;13;Torstai;2;6;8
625;25.01.2018;2018;01;14;Torstai;5;3;8
625;25.01.2018;2018;01;15;Torstai;4;11;15
625;25.01.2018;2018;01;16;Torstai;6;10;16
625;25.01.2018;2018;01;17;Torstai;5;13;18
625;25.01.2018;2018;01;18;Torstai;2;2;4
625;25.01.2018;2018;01;19;Torstai;2;4;6
625;25.01.2018;2018;01;20;Torstai;0;2;2
625;25.01.2018;2018;01;21;Torstai;4;1;5
625;25.01.2018;2018;01;22;Torstai;1;2;3
625;25.01.2018;2018;01;23;Torstai;1;3;4
625;26.01.2018;2018;01;00;Perjantai;1;0;1
625;26.01.2018;2018;01;01;Perjantai;0;0;0
625;26.01.2018;2018;01;02;Perjantai;0;0;0
625;26.01.2018;2018;01;03;Perjantai;0;0;0
625;26.01.2018;2018;01;04;Perjantai;0;0;0
625;26.01.2018;2018;01;05;Perjantai;1;2;3
625;26.01.2018;2018;01;06;Perjantai;0;1;1
625;26.01.2018;2018;01;07;Perjantai;3;4;7
625;26.01.2018;2018;01;08;Perjantai;13;5;18
625;26.01.2018;2018;01;09;Perjantai;6;8;14
625;26.01.2018;2018;01;10;Perjantai;3;6;9
625;26.01.2018;2018;01;11;Perjantai;1;1;2
625;26.01.2018;2018;01;12;Perjantai;2;3;5
625;26.01.2018;2018;01;13;Perjantai;1;10;11
625;26.01.2018;2018;01;14;Perjantai;6;11;17
625;26.01.2018;2018;01;15;Perjantai;0;8;8
625;26.01.2018;2018;01;16;Perjantai;4;7;11
625;26.01.2018;2018;01;17;Perjantai;2;6;8
625;26.01.2018;2018;01;18;Perjantai;0;3;3
625;26.01.2018;2018;01;19;Perjantai;2;2;4
625;26.01.2018;2018;01;20;Perjantai;4;0;4
625;26.01.2018;2018;01;21;Perjantai;2;2;4
625;26.01.2018;2018;01;22;Perjantai;2;2;4
625;26.01.2018;2018;01;23;Perjantai;1;3;4
625;27.01.2018;2018;01;00;Lauantai;2;2;4
625;27.01.2018;2018;01;01;Lauantai;0;0;0
625;27.01.2018;2018;01;02;Lauantai;0;0;0
625;27.01.2018;2018;01;03;Lauantai;0;0;0
625;27.01.2018;2018;01;04;Lauantai;0;0;0
625;27.01.2018;2018;01;05;Lauantai;1;0;1
625;27.01.2018;2018;01;06;Lauantai;1;2;3
625;27.01.2018;2018;01;07;Lauantai;1;0;1
625;27.01.2018;2018;01;08;Lauantai;0;2;2
625;27.01.2018;2018;01;09;Lauantai;3;1;4
625;27.01.2018;2018;01;10;Lauantai;3;0;3
625;27.01.2018;2018;01;11;Lauantai;2;1;3
625;27.01.2018;2018;01;12;Lauantai;2;2;4
625;27.01.2018;2018;01;13;Lauantai;0;2;2
625;27.01.2018;2018;01;14;Lauantai;4;3;7
625;27.01.2018;2018;01;15;Lauantai;2;3;5
625;27.01.2018;2018;01;16;Lauantai;6;3;9
625;27.01.2018;2018;01;17;Lauantai;1;1;2
625;27.01.2018;2018;01;18;Lauantai;3;1;4
625;27.01.2018;2018;01;19;Lauantai;4;0;4
625;27.01.2018;2018;01;20;Lauantai;2;4;6
625;27.01.2018;2018;01;21;Lauantai;2;1;3
625;27.01.2018;2018;01;22;Lauantai;3;2;5
625;27.01.2018;2018;01;23;Lauantai;2;2;4
625;28.01.2018;2018;01;00;Sunnuntai;0;0;0
625;28.01.2018;2018;01;01;Sunnuntai;0;1;1
625;28.01.2018;2018;01;02;Sunnuntai;0;1;1
625;28.01.2018;2018;01;03;Sunnuntai;0;0;0
625;28.01.2018;2018;01;04;Sunnuntai;0;1;1
625;28.01.2018;2018;01;05;Sunnuntai;0;0;0
625;28.01.2018;2018;01;06;Sunnuntai;0;0;0
625;28.01.2018;2018;01;07;Sunnuntai;2;0;2
625;28.01.2018;2018;01;08;Sunnuntai;0;2;2
625;28.01.2018;2018;01;09;Sunnuntai;0;0;0
625;28.01.2018;2018;01;10;Sunnuntai;2;2;4
625;28.01.2018;2018;01;11;Sunnuntai;1;2;3
625;28.01.2018;2018;01;12;Sunnuntai;11;10;21
625;28.01.2018;2018;01;13;Sunnuntai;6;9;15
625;28.01.2018;2018;01;14;Sunnuntai;6;7;13
625;28.01.2018;2018;01;15;Sunnuntai;3;6;9
625;28.01.2018;2018;01;16;Sunnuntai;2;4;6
625;28.01.2018;2018;01;17;Sunnuntai;1;2;3
625;28.01.2018;2018;01;18;Sunnuntai;6;3;9
625;28.01.2018;2018;01;19;Sunnuntai;3;3;6
625;28.01.2018;2018;01;20;Sunnuntai;3;4;7
625;28.01.2018;2018;01;21;Sunnuntai;1;2;3
625;28.01.2018;2018;01;22;Sunnuntai;1;3;4
625;28.01.2018;2018;01;23;Sunnuntai;2;1;3
625;29.01.2018;2018;01;00;Maanantai;1;0;1
625;29.01.2018;2018;01;01;Maanantai;0;0;0
625;29.01.2018;2018;01;02;Maanantai;0;0;0
625;29.01.2018;2018;01;03;Maanantai;0;0;0
625;29.01.2018;2018;01;04;Maanantai;0;0;0
625;29.01.2018;2018;01;05;Maanantai;0;0;0
625;29.01.2018;2018;01;06;Maanantai;3;7;10
625;29.01.2018;2018;01;07;Maanantai;5;4;9
625;29.01.2018;2018;01;08;Maanantai;12;6;18
625;29.01.2018;2018;01;09;Maanantai;13;13;26
625;29.01.2018;2018;01;10;Maanantai;11;7;18
625;29.01.2018;2018;01;11;Maanantai;6;3;9
625;29.01.2018;2018;01;12;Maanantai;2;6;8
625;29.01.2018;2018;01;13;Maanantai;5;5;10
625;29.01.2018;2018;01;14;Maanantai;3;16;19
625;29.01.2018;2018;01;15;Maanantai;7;21;28
625;29.01.2018;2018;01;16;Maanantai;3;16;19
625;29.01.2018;2018;01;17;Maanantai;3;18;21
625;29.01.2018;2018;01;18;Maanantai;4;5;9
625;29.01.2018;2018;01;19;Maanantai;2;4;6
625;29.01.2018;2018;01;20;Maanantai;0;3;3
625;29.01.2018;2018;01;21;Maanantai;2;4;6
625;29.01.2018;2018;01;22;Maanantai;3;2;5
625;29.01.2018;2018;01;23;Maanantai;0;2;2
625;30.01.2018;2018;01;00;Tiistai;0;0;0
625;30.01.2018;2018;01;01;Tiistai;1;0;1
625;30.01.2018;2018;01;02;Tiistai;0;0;0
625;30.01.2018;2018;01;03;Tiistai;0;0;0
625;30.01.2018;2018;01;04;Tiistai;1;0;1
625;30.01.2018;2018;01;05;Tiistai;1;0;1
625;30.01.2018;2018;01;06;Tiistai;1;0;1
625;30.01.2018;2018;01;07;Tiistai;10;4;14
625;30.01.2018;2018;01;08;Tiistai;29;14;43
625;30.01.2018;2018;01;09;Tiistai;13;10;23
625;30.01.2018;2018;01;10;Tiistai;8;5;13
625;30.01.2018;2018;01;11;Tiistai;12;2;14
625;30.01.2018;2018;01;12;Tiistai;1;2;3
625;30.01.2018;2018;01;13;Tiistai;6;9;15
625;30.01.2018;2018;01;14;Tiistai;5;8;13
625;30.01.2018;2018;01;15;Tiistai;3;18;21
625;30.01.2018;2018;01;16;Tiistai;3;15;18
625;30.01.2018;2018;01;17;Tiistai;5;22;27
625;30.01.2018;2018;01;18;Tiistai;7;4;11
625;30.01.2018;2018;01;19;Tiistai;5;3;8
625;30.01.2018;2018;01;20;Tiistai;3;10;13
625;30.01.2018;2018;01;21;Tiistai;1;2;3
625;30.01.2018;2018;01;22;Tiistai;5;5;10
625;30.01.2018;2018;01;23;Tiistai;1;3;4
625;31.01.2018;2018;01;00;Keskiviikko;0;1;1
625;31.01.2018;2018;01;01;Keskiviikko;2;0;2
625;31.01.2018;2018;01;02;Keskiviikko;0;0;0
625;31.01.2018;2018;01;03;Keskiviikko;0;0;0
625;31.01.2018;2018;01;04;Keskiviikko;0;0;0
625;31.01.2018;2018;01;05;Keskiviikko;2;0;2
625;31.01.2018;2018;01;06;Keskiviikko;2;3;5
625;31.01.2018;2018;01;07;Keskiviikko;10;2;12
625;31.01.2018;2018;01;08;Keskiviikko;30;14;44
625;31.01.2018;2018;01;09;Keskiviikko;25;8;33
625;31.01.2018;2018;01;10;Keskiviikko;8;11;19
625;31.01.2018;2018;01;11;Keskiviikko;4;8;12
625;31.01.2018;2018;01;12;Keskiviikko;3;2;5
625;31.01.2018;2018;01;13;Keskiviikko;8;7;15
625;31.01.2018;2018;01;14;Keskiviikko;3;10;13
625;31.01.2018;2018;01;15;Keskiviikko;13;21;34
625;31.01.2018;2018;01;16;Keskiviikko;2;19;21
625;31.01.2018;2018;01;17;Keskiviikko;4;25;29
625;31.01.2018;2018;01;18;Keskiviikko;6;4;10
625;31.01.2018;2018;01;19;Keskiviikko;6;3;9
625;31.01.2018;2018;01;20;Keskiviikko;2;5;7
625;31.01.2018;2018;01;21;Keskiviikko;0;1;1
625;31.01.2018;2018;01;22;Keskiviikko;1;2;3
625;31.01.2018;2018;01;23;Keskiviikko;0;0;0
625;01.02.2018;2018;02;00;Torstai;0;0;0
625;01.02.2018;2018;02;01;Torstai;0;0;0
625;01.02.2018;2018;02;02;Torstai;0;0;0
625;01.02.2018;2018;02;03;Torstai;0;0;0
625;01.02.2018;2018;02;04;Torstai;0;0;0
625;01.02.2018;2018;02;05;Torstai;1;0;1
625;01.02.2018;2018;02;06;Torstai;2;0;2
625;01.02.2018;2018;02;07;Torstai;4;2;6
625;01.02.2018;2018;02;08;Torstai;24;9;33
625;01.02.2018;2018;02;09;Torstai;9;7;16
625;01.02.2018;2018;02;10;Torstai;6;10;16
625;01.02.2018;2018;02;11;Torstai;0;2;2
625;01.02.2018;2018;02;12;Torstai;5;6;11
625;01.02.2018;2018;02;13;Torstai;2;8;10
625;01.02.2018;2018;02;14;Torstai;3;7;10
625;01.02.2018;2018;02;15;Torstai;1;10;11
625;01.02.2018;2018;02;16;Torstai;4;17;21
625;01.02.2018;2018;02;17;Torstai;10;14;24
625;01.02.2018;2018;02;18;Torstai;6;3;9
625;01.02.2018;2018;02;19;Torstai;6;3;9
625;01.02.2018;2018;02;20;Torstai;2;4;6
625;01.02.2018;2018;02;21;Torstai;0;1;1
625;01.02.2018;2018;02;22;Torstai;1;2;3
625;01.02.2018;2018;02;23;Torstai;0;0;0
625;02.02.2018;2018;02;00;Perjantai;0;0;0
625;02.02.2018;2018;02;01;Perjantai;0;0;0
625;02.02.2018;2018;02;02;Perjantai;0;0;0
625;02.02.2018;2018;02;03;Perjantai;0;0;0
625;02.02.2018;2018;02;04;Perjantai;0;0;0
625;02.02.2018;2018;02;05;Perjantai;1;0;1
625;02.02.2018;2018;02;06;Perjantai;2;2;4
625;02.02.2018;2018;02;07;Perjantai;10;2;12
625;02.02.2018;2018;02;08;Perjantai;24;12;36
625;02.02.2018;2018;02;09;Perjantai;16;7;23
625;02.02.2018;2018;02;10;Perjantai;7;10;17
625;02.02.2018;2018;02;11;Perjantai;4;6;10
625;02.02.2018;2018;02;12;Perjantai;3;2;5
625;02.02.2018;2018;02;13;Perjantai;6;5;11
625;02.02.2018;2018;02;14;Perjantai;3;10;13
625;02.02.2018;2018;02;15;Perjantai;10;20;30
625;02.02.2018;2018;02;16;Perjantai;1;12;13
625;02.02.2018;2018;02;17;Perjantai;7;7;14
625;02.02.2018;2018;02;18;Perjantai;2;8;10
625;02.02.2018;2018;02;19;Perjantai;1;1;2
625;02.02.2018;2018;02;20;Perjantai;2;4;6
625;02.02.2018;2018;02;21;Perjantai;3;2;5
625;02.02.2018;2018;02;22;Perjantai;1;2;3
625;02.02.2018;2018;02;23;Perjantai;0;0;0
625;03.02.2018;2018;02;00;Lauantai;0;0;0
625;03.02.2018;2018;02;01;Lauantai;1;0;1
625;03.02.2018;2018;02;02;Lauantai;0;0;0
625;03.02.2018;2018;02;03;Lauantai;0;0;0
625;03.02.2018;2018;02;04;Lauantai;0;0;0
625;03.02.2018;2018;02;05;Lauantai;0;0;0
625;03.02.2018;2018;02;06;Lauantai;0;0;0
625;03.02.2018;2018;02;07;Lauantai;1;0;1
625;03.02.2018;2018;02;08;Lauantai;0;2;2
625;03.02.2018;2018;02;09;Lauantai;1;0;1
625;03.02.2018;2018;02;10;Lauantai;3;0;3
625;03.02.2018;2018;02;11;Lauantai;1;2;3
625;03.02.2018;2018;02;12;Lauantai;0;2;2
625;03.02.2018;2018;02;13;Lauantai;0;2;2
625;03.02.2018;2018;02;14;Lauantai;3;1;4
625;03.02.2018;2018;02;15;Lauantai;0;4;4
625;03.02.2018;2018;02;16;Lauantai;0;1;1
625;03.02.2018;2018;02;17;Lauantai;0;2;2
625;03.02.2018;2018;02;18;Lauantai;2;2;4
625;03.02.2018;2018;02;19;Lauantai;0;3;3
625;03.02.2018;2018;02;20;Lauantai;1;2;3
625;03.02.2018;2018;02;21;Lauantai;2;3;5
625;03.02.2018;2018;02;22;Lauantai;1;2;3
625;03.02.2018;2018;02;23;Lauantai;0;1;1
625;04.02.2018;2018;02;00;Sunnuntai;0;0;0
625;04.02.2018;2018;02;01;Sunnuntai;0;0;0
625;04.02.2018;2018;02;02;Sunnuntai;0;0;0
625;04.02.2018;2018;02;03;Sunnuntai;0;0;0
625;04.02.2018;2018;02;04;Sunnuntai;1;0;1
625;04.02.2018;2018;02;05;Sunnuntai;1;0;1
625;04.02.2018;2018;02;06;Sunnuntai;0;0;0
625;04.02.2018;2018;02;07;Sunnuntai;0;0;0
625;04.02.2018;2018;02;08;Sunnuntai;0;1;1
625;04.02.2018;2018;02;09;Sunnuntai;1;0;1
625;04.02.2018;2018;02;10;Sunnuntai;0;0;0
625;04.02.2018;2018;02;11;Sunnuntai;0;0;0
625;04.02.2018;2018;02;12;Sunnuntai;1;1;2
625;04.02.2018;2018;02;13;Sunnuntai;0;0;0
625;04.02.2018;2018;02;14;Sunnuntai;1;1;2
625;04.02.2018;2018;02;15;Sunnuntai;1;1;2
625;04.02.2018;2018;02;16;Sunnuntai;1;3;4
625;04.02.2018;2018;02;17;Sunnuntai;0;0;0
625;04.02.2018;2018;02;18;Sunnuntai;0;2;2
625;04.02.2018;2018;02;19;Sunnuntai;1;2;3
625;04.02.2018;2018;02;20;Sunnuntai;2;0;2
625;04.02.2018;2018;02;21;Sunnuntai;1;2;3
625;04.02.2018;2018;02;22;Sunnuntai;0;0;0
625;04.02.2018;2018;02;23;Sunnuntai;1;1;2
625;05.02.2018;2018;02;00;Maanantai;0;0;0
625;05.02.2018;2018;02;01;Maanantai;0;0;0
625;05.02.2018;2018;02;02;Maanantai;0;0;0
625;05.02.2018;2018;02;03;Maanantai;0;0;0
625;05.02.2018;2018;02;04;Maanantai;0;1;1
625;05.02.2018;2018;02;05;Maanantai;1;0;1
625;05.02.2018;2018;02;06;Maanantai;0;1;1
625;05.02.2018;2018;02;07;Maanantai;8;1;9
625;05.02.2018;2018;02;08;Maanantai;13;7;20
625;05.02.2018;2018;02;09;Maanantai;6;7;13
625;05.02.2018;2018;02;10;Maanantai;6;5;11
625;05.02.2018;2018;02;11;Maanantai;0;3;3
625;05.02.2018;2018;02;12;Maanantai;1;3;4
625;05.02.2018;2018;02;13;Maanantai;3;8;11
625;05.02.2018;2018;02;14;Maanantai;0;8;8
625;05.02.2018;2018;02;15;Maanantai;3;16;19
625;05.02.2018;2018;02;16;Maanantai;1;16;17
625;05.02.2018;2018;02;17;Maanantai;2;12;14
625;05.02.2018;2018;02;18;Maanantai;2;4;6
625;05.02.2018;2018;02;19;Maanantai;3;1;4
625;05.02.2018;2018;02;20;Maanantai;2;1;3
625;05.02.2018;2018;02;21;Maanantai;1;1;2
625;05.02.2018;2018;02;22;Maanantai;1;2;3
625;05.02.2018;2018;02;23;Maanantai;0;1;1
625;06.02.2018;2018;02;00;Tiistai;0;0;0
625;06.02.2018;2018;02;01;Tiistai;0;0;0
625;06.02.2018;2018;02;02;Tiistai;0;0;0
625;06.02.2018;2018;02;03;Tiistai;0;0;0
625;06.02.2018;2018;02;04;Tiistai;0;1;1
625;06.02.2018;2018;02;05;Tiistai;1;0;1
625;06.02.2018;2018;02;06;Tiistai;1;2;3
625;06.02.2018;2018;02;07;Tiistai;3;0;3
625;06.02.2018;2018;02;08;Tiistai;10;6;16
625;06.02.2018;2018;02;09;Tiistai;2;7;9
625;06.02.2018;2018;02;10;Tiistai;7;5;12
625;06.02.2018;2018;02;11;Tiistai;4;2;6
625;06.02.2018;2018;02;12;Tiistai;2;8;10
625;06.02.2018;2018;02;13;Tiistai;1;8;9
625;06.02.2018;2018;02;14;Tiistai;1;11;12
625;06.02.2018;2018;02;15;Tiistai;3;13;16
625;06.02.2018;2018;02;16;Tiistai;5;12;17
625;06.02.2018;2018;02;17;Tiistai;5;10;15
625;06.02.2018;2018;02;18;Tiistai;2;6;8
625;06.02.2018;2018;02;19;Tiistai;2;3;5
625;06.02.2018;2018;02;20;Tiistai;0;0;0
625;06.02.2018;2018;02;21;Tiistai;6;4;10
625;06.02.2018;2018;02;22;Tiistai;2;3;5
625;06.02.2018;2018;02;23;Tiistai;0;0;0
625;07.02.2018;2018;02;00;Keskiviikko;1;0;1
625;07.02.2018;2018;02;01;Keskiviikko;1;0;1
625;07.02.2018;2018;02;02;Keskiviikko;0;0;0
625;07.02.2018;2018;02;03;Keskiviikko;0;0;0
625;07.02.2018;2018;02;04;Keskiviikko;0;2;2
625;07.02.2018;2018;02;05;Keskiviikko;4;4;8
625;07.02.2018;2018;02;06;Keskiviikko;2;3;5
625;07.02.2018;2018;02;07;Keskiviikko;6;1;7
625;07.02.2018;2018;02;08;Keskiviikko;13;6;19
625;07.02.2018;2018;02;09;Keskiviikko;9;9;18
625;07.02.2018;2018;02;10;Keskiviikko;13;10;23
625;07.02.2018;2018;02;11;Keskiviikko;4;1;5
625;07.02.2018;2018;02;12;Keskiviikko;2;4;6
625;07.02.2018;2018;02;13;Keskiviikko;1;9;10
625;07.02.2018;2018;02;14;Keskiviikko;0;11;11
625;07.02.2018;2018;02;15;Keskiviikko;10;23;33
625;07.02.2018;2018;02;16;Keskiviikko;3;15;18
625;07.02.2018;2018;02;17;Keskiviikko;5;15;20
625;07.02.2018;2018;02;18;Keskiviikko;3;8;11
625;07.02.2018;2018;02;19;Keskiviikko;3;11;14
625;07.02.2018;2018;02;20;Keskiviikko;2;4;6
625;07.02.2018;2018;02;21;Keskiviikko;2;1;3
625;07.02.2018;2018;02;22;Keskiviikko;1;0;1
625;07.02.2018;2018;02;23;Keskiviikko;2;0;2
625;08.02.2018;2018;02;00;Torstai;0;1;1
625;08.02.2018;2018;02;01;Torstai;0;0;0
625;08.02.2018;2018;02;02;Torstai;0;0;0
625;08.02.2018;2018;02;03;Torstai;0;0;0
625;08.02.2018;2018;02;04;Torstai;0;1;1
625;08.02.2018;2018;02;05;Torstai;1;0;1
625;08.02.2018;2018;02;06;Torstai;3;1;4
625;08.02.2018;2018;02;07;Torstai;7;4;11
625;08.02.2018;2018;02;08;Torstai;33;12;45
625;08.02.2018;2018;02;09;Torstai;18;12;30
625;08.02.2018;2018;02;10;Torstai;8;5;13
625;08.02.2018;2018;02;11;Torstai;8;3;11
625;08.02.2018;2018;02;12;Torstai;4;7;11
625;08.02.2018;2018;02;13;Torstai;4;13;17
625;08.02.2018;2018;02;14;Torstai;4;8;12
625;08.02.2018;2018;02;15;Torstai;5;17;22
625;08.02.2018;2018;02;16;Torstai;8;24;32
625;08.02.2018;2018;02;17;Torstai;4;22;26
625;08.02.2018;2018;02;18;Torstai;9;2;11
625;08.02.2018;2018;02;19;Torstai;1;6;7
625;08.02.2018;2018;02;20;Torstai;1;3;4
625;08.02.2018;2018;02;21;Torstai;1;2;3
625;08.02.2018;2018;02;22;Torstai;2;2;4
625;08.02.2018;2018;02;23;Torstai;2;1;3
625;09.02.2018;2018;02;00;Perjantai;0;1;1
625;09.02.2018;2018;02;01;Perjantai;0;0;0
625;09.02.2018;2018;02;02;Perjantai;0;0;0
625;09.02.2018;2018;02;03;Perjantai;0;0;0
625;09.02.2018;2018;02;04;Perjantai;0;1;1
625;09.02.2018;2018;02;05;Perjantai;1;0;1
625;09.02.2018;2018;02;06;Perjantai;2;0;2
625;09.02.2018;2018;02;07;Perjantai;6;3;9
625;09.02.2018;2018;02;08;Perjantai;15;7;22
625;09.02.2018;2018;02;09;Perjantai;13;8;21
625;09.02.2018;2018;02;10;Perjantai;11;8;19
625;09.02.2018;2018;02;11;Perjantai;2;3;5
625;09.02.2018;2018;02;12;Perjantai;5;8;13
625;09.02.2018;2018;02;13;Perjantai;4;10;14
625;09.02.2018;2018;02;14;Perjantai;1;11;12
625;09.02.2018;2018;02;15;Perjantai;4;14;18
625;09.02.2018;2018;02;16;Perjantai;5;14;19
625;09.02.2018;2018;02;17;Perjantai;5;6;11
625;09.02.2018;2018;02;18;Perjantai;1;7;8
625;09.02.2018;2018;02;19;Perjantai;4;6;10
625;09.02.2018;2018;02;20;Perjantai;1;2;3
625;09.02.2018;2018;02;21;Perjantai;4;3;7
625;09.02.2018;2018;02;22;Perjantai;3;5;8
625;09.02.2018;2018;02;23;Perjantai;0;1;1
625;10.02.2018;2018;02;00;Lauantai;0;0;0
625;10.02.2018;2018;02;01;Lauantai;1;0;1
625;10.02.2018;2018;02;02;Lauantai;0;2;2
625;10.02.2018;2018;02;03;Lauantai;2;0;2
625;10.02.2018;2018;02;04;Lauantai;0;0;0
625;10.02.2018;2018;02;05;Lauantai;0;0;0
625;10.02.2018;2018;02;06;Lauantai;0;1;1
625;10.02.2018;2018;02;07;Lauantai;1;1;2
625;10.02.2018;2018;02;08;Lauantai;1;1;2
625;10.02.2018;2018;02;09;Lauantai;1;2;3
625;10.02.2018;2018;02;10;Lauantai;1;0;1
625;10.02.2018;2018;02;11;Lauantai;3;2;5
625;10.02.2018;2018;02;12;Lauantai;0;0;0
625;10.02.2018;2018;02;13;Lauantai;2;8;10
625;10.02.2018;2018;02;14;Lauantai;3;3;6
625;10.02.2018;2018;02;15;Lauantai;3;7;10
625;10.02.2018;2018;02;16;Lauantai;0;2;2
625;10.02.2018;2018;02;17;Lauantai;1;3;4
625;10.02.2018;2018;02;18;Lauantai;4;2;6
625;10.02.2018;2018;02;19;Lauantai;1;4;5
625;10.02.2018;2018;02;20;Lauantai;2;2;4
625;10.02.2018;2018;02;21;Lauantai;3;3;6
625;10.02.2018;2018;02;22;Lauantai;3;5;8
625;10.02.2018;2018;02;23;Lauantai;0;0;0
625;11.02.2018;2018;02;00;Sunnuntai;0;0;0
625;11.02.2018;2018;02;01;Sunnuntai;1;0;1
625;11.02.2018;2018;02;02;Sunnuntai;0;0;0
625;11.02.2018;2018;02;03;Sunnuntai;0;0;0
625;11.02.2018;2018;02;04;Sunnuntai;0;0;0
625;11.02.2018;2018;02;05;Sunnuntai;0;0;0
625;11.02.2018;2018;02;06;Sunnuntai;0;0;0
625;11.02.2018;2018;02;07;Sunnuntai;0;3;3
625;11.02.2018;2018;02;08;Sunnuntai;0;2;2
625;11.02.2018;2018;02;09;Sunnuntai;1;0;1
625;11.02.2018;2018;02;10;Sunnuntai;0;1;1
625;11.02.2018;2018;02;11;Sunnuntai;3;2;5
625;11.02.2018;2018;02;12;Sunnuntai;2;4;6
625;11.02.2018;2018;02;13;Sunnuntai;3;8;11
625;11.02.2018;2018;02;14;Sunnuntai;2;3;5
625;11.02.2018;2018;02;15;Sunnuntai;1;4;5
625;11.02.2018;2018;02;16;Sunnuntai;4;4;8
625;11.02.2018;2018;02;17;Sunnuntai;0;2;2
625;11.02.2018;2018;02;18;Sunnuntai;4;7;11
625;11.02.2018;2018;02;19;Sunnuntai;2;2;4
625;11.02.2018;2018;02;20;Sunnuntai;2;1;3
625;11.02.2018;2018;02;21;Sunnuntai;1;1;2
625;11.02.2018;2018;02;22;Sunnuntai;0;6;6
625;11.02.2018;2018;02;23;Sunnuntai;2;2;4
625;12.02.2018;2018;02;00;Maanantai;2;4;6
625;12.02.2018;2018;02;01;Maanantai;0;0;0
625;12.02.2018;2018;02;02;Maanantai;0;0;0
625;12.02.2018;2018;02;03;Maanantai;0;0;0
625;12.02.2018;2018;02;04;Maanantai;0;0;0
625;12.02.2018;2018;02;05;Maanantai;0;1;1
625;12.02.2018;2018;02;06;Maanantai;0;1;1
625;12.02.2018;2018;02;07;Maanantai;10;5;15
625;12.02.2018;2018;02;08;Maanantai;24;12;36
625;12.02.2018;2018;02;09;Maanantai;13;5;18
625;12.02.2018;2018;02;10;Maanantai;13;5;18
625;12.02.2018;2018;02;11;Maanantai;9;6;15
625;12.02.2018;2018;02;12;Maanantai;3;7;10
625;12.02.2018;2018;02;13;Maanantai;4;4;8
625;12.02.2018;2018;02;14;Maanantai;3;11;14
625;12.02.2018;2018;02;15;Maanantai;7;22;29
625;12.02.2018;2018;02;16;Maanantai;10;24;34
625;12.02.2018;2018;02;17;Maanantai;8;17;25
625;12.02.2018;2018;02;18;Maanantai;8;10;18
625;12.02.2018;2018;02;19;Maanantai;3;7;10
625;12.02.2018;2018;02;20;Maanantai;3;7;10
625;12.02.2018;2018;02;21;Maanantai;1;6;7
625;12.02.2018;2018;02;22;Maanantai;6;3;9
625;12.02.2018;2018;02;23;Maanantai;0;0;0
625;13.02.2018;2018;02;00;Tiistai;1;1;2
625;13.02.2018;2018;02;01;Tiistai;0;1;1
625;13.02.2018;2018;02;02;Tiistai;0;0;0
625;13.02.2018;2018;02;03;Tiistai;0;0;0
625;13.02.2018;2018;02;04;Tiistai;0;0;0
625;13.02.2018;2018;02;05;Tiistai;0;0;0
625;13.02.2018;2018;02;06;Tiistai;1;4;5
625;13.02.2018;2018;02;07;Tiistai;12;6;18
625;13.02.2018;2018;02;08;Tiistai;28;18;46
625;13.02.2018;2018;02;09;Tiistai;18;10;28
625;13.02.2018;2018;02;10;Tiistai;20;12;32
625;13.02.2018;2018;02;11;Tiistai;8;7;15
625;13.02.2018;2018;02;12;Tiistai;4;6;10
625;13.02.2018;2018;02;13;Tiistai;12;14;26
625;13.02.2018;2018;02;14;Tiistai;5;11;16
625;13.02.2018;2018;02;15;Tiistai;4;21;25
625;13.02.2018;2018;02;16;Tiistai;7;25;32
625;13.02.2018;2018;02;17;Tiistai;7;18;25
625;13.02.2018;2018;02;18;Tiistai;7;8;15
625;13.02.2018;2018;02;19;Tiistai;4;9;13
625;13.02.2018;2018;02;20;Tiistai;3;4;7
625;13.02.2018;2018;02;21;Tiistai;0;1;1
625;13.02.2018;2018;02;22;Tiistai;2;3;5
625;13.02.2018;2018;02;23;Tiistai;1;0;1
625;14.02.2018;2018;02;00;Keskiviikko;0;0;0
625;14.02.2018;2018;02;01;Keskiviikko;0;0;0
625;14.02.2018;2018;02;02;Keskiviikko;0;0;0
625;14.02.2018;2018;02;03;Keskiviikko;0;0;0
625;14.02.2018;2018;02;04;Keskiviikko;0;0;0
625;14.02.2018;2018;02;05;Keskiviikko;0;0;0
625;14.02.2018;2018;02;06;Keskiviikko;0;4;4
625;14.02.2018;2018;02;07;Keskiviikko;9;3;12
625;14.02.2018;2018;02;08;Keskiviikko;21;12;33
625;14.02.2018;2018;02;09;Keskiviikko;14;14;28
625;14.02.2018;2018;02;10;Keskiviikko;6;5;11
625;14.02.2018;2018;02;11;Keskiviikko;3;2;5
625;14.02.2018;2018;02;12;Keskiviikko;3;8;11
625;14.02.2018;2018;02;13;Keskiviikko;6;9;15
625;14.02.2018;2018;02;14;Keskiviikko;4;15;19
625;14.02.2018;2018;02;15;Keskiviikko;5;17;22
625;14.02.2018;2018;02;16;Keskiviikko;5;15;20
625;14.02.2018;2018;02;17;Keskiviikko;7;13;20
625;14.02.2018;2018;02;18;Keskiviikko;4;13;17
625;14.02.2018;2018;02;19;Keskiviikko;4;8;12
625;14.02.2018;2018;02;20;Keskiviikko;1;8;9
625;14.02.2018;2018;02;21;Keskiviikko;1;8;9
625;14.02.2018;2018;02;22;Keskiviikko;3;3;6
625;14.02.2018;2018;02;23;Keskiviikko;1;1;2
625;15.02.2018;2018;02;00;Torstai;0;2;2
625;15.02.2018;2018;02;01;Torstai;0;0;0
625;15.02.2018;2018;02;02;Torstai;0;0;0
625;15.02.2018;2018;02;03;Torstai;0;0;0
625;15.02.2018;2018;02;04;Torstai;0;0;0
625;15.02.2018;2018;02;05;Torstai;0;0;0
625;15.02.2018;2018;02;06;Torstai;0;1;1
625;15.02.2018;2018;02;07;Torstai;6;5;11
625;15.02.2018;2018;02;08;Torstai;23;16;39
625;15.02.2018;2018;02;09;Torstai;10;7;17
625;15.02.2018;2018;02;10;Torstai;7;12;19
625;15.02.2018;2018;02;11;Torstai;1;3;4
625;15.02.2018;2018;02;12;Torstai;0;6;6
625;15.02.2018;2018;02;13;Torstai;6;11;17
625;15.02.2018;2018;02;14;Torstai;7;7;14
625;15.02.2018;2018;02;15;Torstai;7;18;25
625;15.02.2018;2018;02;16;Torstai;2;17;19
625;15.02.2018;2018;02;17;Torstai;6;21;27
625;15.02.2018;2018;02;18;Torstai;4;8;12
625;15.02.2018;2018;02;19;Torstai;3;6;9
625;15.02.2018;2018;02;20;Torstai;0;1;1
625;15.02.2018;2018;02;21;Torstai;1;2;3
625;15.02.2018;2018;02;22;Torstai;2;0;2
625;15.02.2018;2018;02;23;Torstai;1;0;1
625;16.02.2018;2018;02;00;Perjantai;2;2;4
625;16.02.2018;2018;02;01;Perjantai;0;0;0
625;16.02.2018;2018;02;02;Perjantai;0;1;1
625;16.02.2018;2018;02;03;Perjantai;0;0;0
625;16.02.2018;2018;02;04;Perjantai;1;0;1
625;16.02.2018;2018;02;05;Perjantai;0;1;1
625;16.02.2018;2018;02;06;Perjantai;0;2;2
625;16.02.2018;2018;02;07;Perjantai;3;3;6
625;16.02.2018;2018;02;08;Perjantai;6;10;16
625;16.02.2018;2018;02;09;Perjantai;10;4;14
625;16.02.2018;2018;02;10;Perjantai;6;6;12
625;16.02.2018;2018;02;11;Perjantai;6;1;7
625;16.02.2018;2018;02;12;Perjantai;0;8;8
625;16.02.2018;2018;02;13;Perjantai;4;10;14
625;16.02.2018;2018;02;14;Perjantai;3;17;20
625;16.02.2018;2018;02;15;Perjantai;0;9;9
625;16.02.2018;2018;02;16;Perjantai;5;12;17
625;16.02.2018;2018;02;17;Perjantai;7;15;22
625;16.02.2018;2018;02;18;Perjantai;5;3;8
625;16.02.2018;2018;02;19;Perjantai;3;6;9
625;16.02.2018;2018;02;20;Perjantai;0;2;2
625;16.02.2018;2018;02;21;Perjantai;1;1;2
625;16.02.2018;2018;02;22;Perjantai;2;2;4
625;16.02.2018;2018;02;23;Perjantai;1;1;2
625;17.02.2018;2018;02;00;Lauantai;0;1;1
625;17.02.2018;2018;02;01;Lauantai;1;0;1
625;17.02.2018;2018;02;02;Lauantai;0;2;2
625;17.02.2018;2018;02;03;Lauantai;0;0;0
625;17.02.2018;2018;02;04;Lauantai;0;0;0
625;17.02.2018;2018;02;05;Lauantai;0;0;0
625;17.02.2018;2018;02;06;Lauantai;0;0;0
625;17.02.2018;2018;02;07;Lauantai;0;2;2
625;17.02.2018;2018;02;08;Lauantai;0;2;2
625;17.02.2018;2018;02;09;Lauantai;0;0;0
625;17.02.2018;2018;02;10;Lauantai;1;2;3
625;17.02.2018;2018;02;11;Lauantai;0;0;0
625;17.02.2018;2018;02;12;Lauantai;0;1;1
625;17.02.2018;2018;02;13;Lauantai;1;1;2
625;17.02.2018;2018;02;14;Lauantai;2;2;4
625;17.02.2018;2018;02;15;Lauantai;2;3;5
625;17.02.2018;2018;02;16;Lauantai;1;5;6
625;17.02.2018;2018;02;17;Lauantai;3;2;5
625;17.02.2018;2018;02;18;Lauantai;1;1;2
625;17.02.2018;2018;02;19;Lauantai;1;6;7
625;17.02.2018;2018;02;20;Lauantai;3;4;7
625;17.02.2018;2018;02;21;Lauantai;1;2;3
625;17.02.2018;2018;02;22;Lauantai;2;1;3
625;17.02.2018;2018;02;23;Lauantai;1;0;1
625;18.02.2018;2018;02;00;Sunnuntai;0;1;1
625;18.02.2018;2018;02;01;Sunnuntai;1;0;1
625;18.02.2018;2018;02;02;Sunnuntai;0;0;0
625;18.02.2018;2018;02;03;Sunnuntai;0;0;0
625;18.02.2018;2018;02;04;Sunnuntai;0;0;0
625;18.02.2018;2018;02;05;Sunnuntai;0;0;0
625;18.02.2018;2018;02;06;Sunnuntai;0;0;0
625;18.02.2018;2018;02;07;Sunnuntai;1;0;1
625;18.02.2018;2018;02;08;Sunnuntai;0;2;2
625;18.02.2018;2018;02;09;Sunnuntai;0;1;1
625;18.02.2018;2018;02;10;Sunnuntai;1;0;1
625;18.02.2018;2018;02;11;Sunnuntai;1;1;2
625;18.02.2018;2018;02;12;Sunnuntai;2;1;3
625;18.02.2018;2018;02;13;Sunnuntai;1;2;3
625;18.02.2018;2018;02;14;Sunnuntai;0;6;6
625;18.02.2018;2018;02;15;Sunnuntai;0;1;1
625;18.02.2018;2018;02;16;Sunnuntai;1;2;3
625;18.02.2018;2018;02;17;Sunnuntai;1;1;2
625;18.02.2018;2018;02;18;Sunnuntai;2;3;5
625;18.02.2018;2018;02;19;Sunnuntai;1;6;7
625;18.02.2018;2018;02;20;Sunnuntai;0;2;2
625;18.02.2018;2018;02;21;Sunnuntai;1;0;1
625;18.02.2018;2018;02;22;Sunnuntai;0;1;1
625;18.02.2018;2018;02;23;Sunnuntai;1;0;1
625;19.02.2018;2018;02;00;Maanantai;0;0;0
625;19.02.2018;2018;02;01;Maanantai;0;0;0
625;19.02.2018;2018;02;02;Maanantai;0;0;0
625;19.02.2018;2018;02;03;Maanantai;0;0;0
625;19.02.2018;2018;02;04;Maanantai;0;0;0
625;19.02.2018;2018;02;05;Maanantai;0;0;0
625;19.02.2018;2018;02;06;Maanantai;0;2;2
625;19.02.2018;2018;02;07;Maanantai;11;3;14
625;19.02.2018;2018;02;08;Maanantai;11;5;16
625;19.02.2018;2018;02;09;Maanantai;8;12;20
625;19.02.2018;2018;02;10;Maanantai;0;7;7
625;19.02.2018;2018;02;11;Maanantai;0;0;0
625;19.02.2018;2018;02;12;Maanantai;2;3;5
625;19.02.2018;2018;02;13;Maanantai;2;8;10
625;19.02.2018;2018;02;14;Maanantai;4;10;14
625;19.02.2018;2018;02;15;Maanantai;5;15;20
625;19.02.2018;2018;02;16;Maanantai;1;18;19
625;19.02.2018;2018;02;17;Maanantai;7;11;18
625;19.02.2018;2018;02;18;Maanantai;2;4;6
625;19.02.2018;2018;02;19;Maanantai;2;3;5
625;19.02.2018;2018;02;20;Maanantai;0;5;5
625;19.02.2018;2018;02;21;Maanantai;1;4;5
625;19.02.2018;2018;02;22;Maanantai;0;2;2
625;19.02.2018;2018;02;23;Maanantai;2;0;2
625;20.02.2018;2018;02;00;Tiistai;2;0;2
625;20.02.2018;2018;02;01;Tiistai;1;1;2
625;20.02.2018;2018;02;02;Tiistai;0;0;0
625;20.02.2018;2018;02;03;Tiistai;0;0;0
625;20.02.2018;2018;02;04;Tiistai;0;0;0
625;20.02.2018;2018;02;05;Tiistai;1;0;1
625;20.02.2018;2018;02;06;Tiistai;0;1;1
625;20.02.2018;2018;02;07;Tiistai;3;1;4
625;20.02.2018;2018;02;08;Tiistai;13;4;17
625;20.02.2018;2018;02;09;Tiistai;7;8;15
625;20.02.2018;2018;02;10;Tiistai;4;9;13
625;20.02.2018;2018;02;11;Tiistai;4;5;9
625;20.02.2018;2018;02;12;Tiistai;1;4;5
625;20.02.2018;2018;02;13;Tiistai;1;3;4
625;20.02.2018;2018;02;14;Tiistai;6;11;17
625;20.02.2018;2018;02;15;Tiistai;4;12;16
625;20.02.2018;2018;02;16;Tiistai;1;16;17
625;20.02.2018;2018;02;17;Tiistai;1;12;13
625;20.02.2018;2018;02;18;Tiistai;2;6;8
625;20.02.2018;2018;02;19;Tiistai;4;1;5
625;20.02.2018;2018;02;20;Tiistai;1;4;5
625;20.02.2018;2018;02;21;Tiistai;1;0;1
625;20.02.2018;2018;02;22;Tiistai;0;0;0
625;20.02.2018;2018;02;23;Tiistai;0;0;0
625;21.02.2018;2018;02;00;Keskiviikko;1;1;2
625;21.02.2018;2018;02;01;Keskiviikko;0;0;0
625;21.02.2018;2018;02;02;Keskiviikko;0;0;0
625;21.02.2018;2018;02;03;Keskiviikko;0;0;0
625;21.02.2018;2018;02;04;Keskiviikko;0;1;1
625;21.02.2018;2018;02;05;Keskiviikko;1;0;1
625;21.02.2018;2018;02;06;Keskiviikko;2;2;4
625;21.02.2018;2018;02;07;Keskiviikko;7;3;10
625;21.02.2018;2018;02;08;Keskiviikko;10;4;14
625;21.02.2018;2018;02;09;Keskiviikko;5;11;16
625;21.02.2018;2018;02;10;Keskiviikko;5;11;16
625;21.02.2018;2018;02;11;Keskiviikko;1;2;3
625;21.02.2018;2018;02;12;Keskiviikko;1;2;3
625;21.02.2018;2018;02;13;Keskiviikko;3;8;11
625;21.02.2018;2018;02;14;Keskiviikko;1;8;9
625;21.02.2018;2018;02;15;Keskiviikko;3;23;26
625;21.02.2018;2018;02;16;Keskiviikko;8;16;24
625;21.02.2018;2018;02;17;Keskiviikko;3;12;15
625;21.02.2018;2018;02;18;Keskiviikko;2;5;7
625;21.02.2018;2018;02;19;Keskiviikko;4;7;11
625;21.02.2018;2018;02;20;Keskiviikko;1;6;7
625;21.02.2018;2018;02;21;Keskiviikko;1;0;1
625;21.02.2018;2018;02;22;Keskiviikko;0;0;0
625;21.02.2018;2018;02;23;Keskiviikko;0;0;0
625;22.02.2018;2018;02;00;Torstai;0;0;0
625;22.02.2018;2018;02;01;Torstai;1;0;1
625;22.02.2018;2018;02;02;Torstai;0;0;0
625;22.02.2018;2018;02;03;Torstai;0;0;0
625;22.02.2018;2018;02;04;Torstai;0;0;0
625;22.02.2018;2018;02;05;Torstai;1;0;1
625;22.02.2018;2018;02;06;Torstai;1;2;3
625;22.02.2018;2018;02;07;Torstai;6;1;7
625;22.02.2018;2018;02;08;Torstai;17;6;23
625;22.02.2018;2018;02;09;Torstai;5;7;12
625;22.02.2018;2018;02;10;Torstai;3;3;6
625;22.02.2018;2018;02;11;Torstai;4;7;11
625;22.02.2018;2018;02;12;Torstai;1;7;8
625;22.02.2018;2018;02;13;Torstai;1;6;7
625;22.02.2018;2018;02;14;Torstai;4;10;14
625;22.02.2018;2018;02;15;Torstai;3;11;14
625;22.02.2018;2018;02;16;Torstai;5;20;25
625;22.02.2018;2018;02;17;Torstai;6;15;21
625;22.02.2018;2018;02;18;Torstai;3;6;9
625;22.02.2018;2018;02;19;Torstai;0;5;5
625;22.02.2018;2018;02;20;Torstai;2;7;9
625;22.02.2018;2018;02;21;Torstai;3;3;6
625;22.02.2018;2018;02;22;Torstai;2;1;3
625;22.02.2018;2018;02;23;Torstai;2;1;3
625;23.02.2018;2018;02;00;Perjantai;1;1;2
625;23.02.2018;2018;02;01;Perjantai;1;0;1
625;23.02.2018;2018;02;02;Perjantai;0;0;0
625;23.02.2018;2018;02;03;Perjantai;0;0;0
625;23.02.2018;2018;02;04;Perjantai;1;1;2
625;23.02.2018;2018;02;05;Perjantai;1;0;1
625;23.02.2018;2018;02;06;Perjantai;2;3;5
625;23.02.2018;2018;02;07;Perjantai;4;3;7
625;23.02.2018;2018;02;08;Perjantai;14;5;19
625;23.02.2018;2018;02;09;Perjantai;9;10;19
625;23.02.2018;2018;02;10;Perjantai;6;10;16
625;23.02.2018;2018;02;11;Perjantai;2;1;3
625;23.02.2018;2018;02;12;Perjantai;2;9;11
625;23.02.2018;2018;02;13;Perjantai;7;17;24
625;23.02.2018;2018;02;14;Perjantai;10;8;18
625;23.02.2018;2018;02;15;Perjantai;6;13;19
625;23.02.2018;2018;02;16;Perjantai;4;11;15
625;23.02.2018;2018;02;17;Perjantai;2;8;10
625;23.02.2018;2018;02;18;Perjantai;2;5;7
625;23.02.2018;2018;02;19;Perjantai;1;3;4
625;23.02.2018;2018;02;20;Perjantai;2;3;5
625;23.02.2018;2018;02;21;Perjantai;1;2;3
625;23.02.2018;2018;02;22;Perjantai;0;2;2
625;23.02.2018;2018;02;23;Perjantai;0;2;2
625;24.02.2018;2018;02;00;Lauantai;0;0;0
625;24.02.2018;2018;02;01;Lauantai;1;0;1
625;24.02.2018;2018;02;02;Lauantai;0;0;0
625;24.02.2018;2018;02;03;Lauantai;0;0;0
625;24.02.2018;2018;02;04;Lauantai;0;0;0
625;24.02.2018;2018;02;05;Lauantai;0;0;0
625;24.02.2018;2018;02;06;Lauantai;0;1;1
625;24.02.2018;2018;02;07;Lauantai;0;0;0
625;24.02.2018;2018;02;08;Lauantai;0;0;0
625;24.02.2018;2018;02;09;Lauantai;0;0;0
625;24.02.2018;2018;02;10;Lauantai;1;0;1
625;24.02.2018;2018;02;11;Lauantai;0;0;0
625;24.02.2018;2018;02;12;Lauantai;1;0;1
625;24.02.2018;2018;02;13;Lauantai;2;2;4
625;24.02.2018;2018;02;14;Lauantai;1;2;3
625;24.02.2018;2018;02;15;Lauantai;1;4;5
625;24.02.2018;2018;02;16;Lauantai;0;2;2
625;24.02.2018;2018;02;17;Lauantai;2;1;3
625;24.02.2018;2018;02;18;Lauantai;1;3;4
625;24.02.2018;2018;02;19;Lauantai;1;0;1
625;24.02.2018;2018;02;20;Lauantai;0;1;1
625;24.02.2018;2018;02;21;Lauantai;1;1;2
625;24.02.2018;2018;02;22;Lauantai;1;1;2
625;24.02.2018;2018;02;23;Lauantai;2;1;3
625;25.02.2018;2018;02;00;Sunnuntai;2;0;2
625;25.02.2018;2018;02;01;Sunnuntai;0;2;2
625;25.02.2018;2018;02;02;Sunnuntai;1;0;1
625;25.02.2018;2018;02;03;Sunnuntai;0;0;0
625;25.02.2018;2018;02;04;Sunnuntai;0;0;0
625;25.02.2018;2018;02;05;Sunnuntai;0;0;0
625;25.02.2018;2018;02;06;Sunnuntai;0;0;0
625;25.02.2018;2018;02;07;Sunnuntai;2;1;3
625;25.02.2018;2018;02;08;Sunnuntai;0;1;1
625;25.02.2018;2018;02;09;Sunnuntai;0;1;1
625;25.02.2018;2018;02;10;Sunnuntai;1;0;1
625;25.02.2018;2018;02;11;Sunnuntai;1;4;5
625;25.02.2018;2018;02;12;Sunnuntai;1;1;2
625;25.02.2018;2018;02;13;Sunnuntai;2;5;7
625;25.02.2018;2018;02;14;Sunnuntai;1;5;6
625;25.02.2018;2018;02;15;Sunnuntai;0;5;5
625;25.02.2018;2018;02;16;Sunnuntai;1;6;7
625;25.02.2018;2018;02;17;Sunnuntai;0;0;0
625;25.02.2018;2018;02;18;Sunnuntai;3;2;5
625;25.02.2018;2018;02;19;Sunnuntai;1;4;5
625;25.02.2018;2018;02;20;Sunnuntai;0;0;0
625;25.02.2018;2018;02;21;Sunnuntai;0;0;0
625;25.02.2018;2018;02;22;Sunnuntai;1;1;2
625;25.02.2018;2018;02;23;Sunnuntai;0;0;0
625;26.02.2018;2018;02;00;Maanantai;0;0;0
625;26.02.2018;2018;02;01;Maanantai;0;0;0
625;26.02.2018;2018;02;02;Maanantai;0;0;0
625;26.02.2018;2018;02;03;Maanantai;0;0;0
625;26.02.2018;2018;02;04;Maanantai;0;0;0
625;26.02.2018;2018;02;05;Maanantai;0;1;1
625;26.02.2018;2018;02;06;Maanantai;1;2;3
625;26.02.2018;2018;02;07;Maanantai;6;5;11
625;26.02.2018;2018;02;08;Maanantai;12;6;18
625;26.02.2018;2018;02;09;Maanantai;8;7;15
625;26.02.2018;2018;02;10;Maanantai;1;4;5
625;26.02.2018;2018;02;11;Maanantai;1;1;2
625;26.02.2018;2018;02;12;Maanantai;1;6;7
625;26.02.2018;2018;02;13;Maanantai;4;8;12
625;26.02.2018;2018;02;14;Maanantai;8;9;17
625;26.02.2018;2018;02;15;Maanantai;5;17;22
625;26.02.2018;2018;02;16;Maanantai;3;15;18
625;26.02.2018;2018;02;17;Maanantai;4;15;19
625;26.02.2018;2018;02;18;Maanantai;0;10;10
625;26.02.2018;2018;02;19;Maanantai;3;5;8
625;26.02.2018;2018;02;20;Maanantai;2;1;3
625;26.02.2018;2018;02;21;Maanantai;0;2;2
625;26.02.2018;2018;02;22;Maanantai;1;1;2
625;26.02.2018;2018;02;23;Maanantai;0;0;0
625;27.02.2018;2018;02;00;Tiistai;1;1;2
625;27.02.2018;2018;02;01;Tiistai;0;0;0
625;27.02.2018;2018;02;02;Tiistai;0;0;0
625;27.02.2018;2018;02;03;Tiistai;0;0;0
625;27.02.2018;2018;02;04;Tiistai;0;0;0
625;27.02.2018;2018;02;05;Tiistai;1;0;1
625;27.02.2018;2018;02;06;Tiistai;1;2;3
625;27.02.2018;2018;02;07;Tiistai;7;5;12
625;27.02.2018;2018;02;08;Tiistai;12;5;17
625;27.02.2018;2018;02;09;Tiistai;5;8;13
625;27.02.2018;2018;02;10;Tiistai;5;6;11
625;27.02.2018;2018;02;11;Tiistai;3;4;7
625;27.02.2018;2018;02;12;Tiistai;1;3;4
625;27.02.2018;2018;02;13;Tiistai;2;6;8
625;27.02.2018;2018;02;14;Tiistai;2;10;12
625;27.02.2018;2018;02;15;Tiistai;3;12;15
625;27.02.2018;2018;02;16;Tiistai;3;13;16
625;27.02.2018;2018;02;17;Tiistai;1;8;9
625;27.02.2018;2018;02;18;Tiistai;4;8;12
625;27.02.2018;2018;02;19;Tiistai;1;4;5
625;27.02.2018;2018;02;20;Tiistai;2;0;2
625;27.02.2018;2018;02;21;Tiistai;1;4;5
625;27.02.2018;2018;02;22;Tiistai;0;1;1
625;27.02.2018;2018;02;23;Tiistai;0;0;0
625;28.02.2018;2018;02;00;Keskiviikko;0;1;1
625;28.02.2018;2018;02;01;Keskiviikko;0;0;0
625;28.02.2018;2018;02;02;Keskiviikko;0;0;0
625;28.02.2018;2018;02;03;Keskiviikko;0;0;0
625;28.02.2018;2018;02;04;Keskiviikko;0;0;0
625;28.02.2018;2018;02;05;Keskiviikko;1;0;1
625;28.02.2018;2018;02;06;Keskiviikko;2;2;4
625;28.02.2018;2018;02;07;Keskiviikko;4;2;6
625;28.02.2018;2018;02;08;Keskiviikko;3;5;8
625;28.02.2018;2018;02;09;Keskiviikko;6;8;14
625;28.02.2018;2018;02;10;Keskiviikko;8;3;11
625;28.02.2018;2018;02;11;Keskiviikko;1;0;1
625;28.02.2018;2018;02;12;Keskiviikko;1;3;4
625;28.02.2018;2018;02;13;Keskiviikko;3;6;9
625;28.02.2018;2018;02;14;Keskiviikko;1;11;12
625;28.02.2018;2018;02;15;Keskiviikko;5;14;19
625;28.02.2018;2018;02;16;Keskiviikko;1;9;10
625;28.02.2018;2018;02;17;Keskiviikko;1;7;8
625;28.02.2018;2018;02;18;Keskiviikko;3;7;10
625;28.02.2018;2018;02;19;Keskiviikko;0;2;2
625;28.02.2018;2018;02;20;Keskiviikko;1;2;3
625;28.02.2018;2018;02;21;Keskiviikko;1;2;3
625;28.02.2018;2018;02;22;Keskiviikko;1;0;1
625;28.02.2018;2018;02;23;Keskiviikko;0;1;1
625;01.03.2018;2018;03;00;Torstai;0;0;0
625;01.03.2018;2018;03;01;Torstai;0;0;0
625;01.03.2018;2018;03;02;Torstai;0;1;1
625;01.03.2018;2018;03;03;Torstai;0;0;0
625;01.03.2018;2018;03;04;Torstai;0;0;0
625;01.03.2018;2018;03;05;Torstai;1;0;1
625;01.03.2018;2018;03;06;Torstai;0;1;1
625;01.03.2018;2018;03;07;Torstai;2;3;5
625;01.03.2018;2018;03;08;Torstai;18;4;22
625;01.03.2018;2018;03;09;Torstai;3;6;9
625;01.03.2018;2018;03;10;Torstai;1;3;4
625;01.03.2018;2018;03;11;Torstai;5;3;8
625;01.03.2018;2018;03;12;Torstai;2;6;8
625;01.03.2018;2018;03;13;Torstai;0;3;3
625;01.03.2018;2018;03;14;Torstai;3;11;14
625;01.03.2018;2018;03;15;Torstai;1;8;9
625;01.03.2018;2018;03;16;Torstai;6;16;22
625;01.03.2018;2018;03;17;Torstai;2;14;16
625;01.03.2018;2018;03;18;Torstai;3;10;13
625;01.03.2018;2018;03;19;Torstai;0;1;1
625;01.03.2018;2018;03;20;Torstai;2;4;6
625;01.03.2018;2018;03;21;Torstai;2;3;5
625;01.03.2018;2018;03;22;Torstai;2;1;3
625;01.03.2018;2018;03;23;Torstai;0;2;2
625;02.03.2018;2018;03;00;Perjantai;2;0;2
625;02.03.2018;2018;03;01;Perjantai;0;0;0
625;02.03.2018;2018;03;02;Perjantai;0;0;0
625;02.03.2018;2018;03;03;Perjantai;0;0;0
625;02.03.2018;2018;03;04;Perjantai;0;0;0
625;02.03.2018;2018;03;05;Perjantai;0;0;0
625;02.03.2018;2018;03;06;Perjantai;1;0;1
625;02.03.2018;2018;03;07;Perjantai;7;4;11
625;02.03.2018;2018;03;08;Perjantai;7;5;12
625;02.03.2018;2018;03;09;Perjantai;9;10;19
625;02.03.2018;2018;03;10;Perjantai;5;3;8
625;02.03.2018;2018;03;11;Perjantai;2;1;3
625;02.03.2018;2018;03;12;Perjantai;3;6;9
625;02.03.2018;2018;03;13;Perjantai;6;28;34
625;02.03.2018;2018;03;14;Perjantai;3;12;15
625;02.03.2018;2018;03;15;Perjantai;6;11;17
625;02.03.2018;2018;03;16;Perjantai;1;12;13
625;02.03.2018;2018;03;17;Perjantai;4;10;14
625;02.03.2018;2018;03;18;Perjantai;2;6;8
625;02.03.2018;2018;03;19;Perjantai;1;2;3
625;02.03.2018;2018;03;20;Perjantai;2;3;5
625;02.03.2018;2018;03;21;Perjantai;2;3;5
625;02.03.2018;2018;03;22;Perjantai;2;4;6
625;02.03.2018;2018;03;23;Perjantai;1;1;2
625;03.03.2018;2018;03;00;Lauantai;0;0;0
625;03.03.2018;2018;03;01;Lauantai;0;0;0
625;03.03.2018;2018;03;02;Lauantai;0;0;0
625;03.03.2018;2018;03;03;Lauantai;1;0;1
625;03.03.2018;2018;03;04;Lauantai;0;0;0
625;03.03.2018;2018;03;05;Lauantai;0;0;0
625;03.03.2018;2018;03;06;Lauantai;0;0;0
625;03.03.2018;2018;03;07;Lauantai;1;2;3
625;03.03.2018;2018;03;08;Lauantai;0;2;2
625;03.03.2018;2018;03;09;Lauantai;0;0;0
625;03.03.2018;2018;03;10;Lauantai;2;0;2
625;03.03.2018;2018;03;11;Lauantai;4;4;8
625;03.03.2018;2018;03;12;Lauantai;1;1;2
625;03.03.2018;2018;03;13;Lauantai;2;5;7
625;03.03.2018;2018;03;14;Lauantai;1;0;1
625;03.03.2018;2018;03;15;Lauantai;3;1;4
625;03.03.2018;2018;03;16;Lauantai;1;0;1
625;03.03.2018;2018;03;17;Lauantai;0;0;0
625;03.03.2018;2018;03;18;Lauantai;3;1;4
625;03.03.2018;2018;03;19;Lauantai;3;6;9
625;03.03.2018;2018;03;20;Lauantai;1;2;3
625;03.03.2018;2018;03;21;Lauantai;4;2;6
625;03.03.2018;2018;03;22;Lauantai;2;2;4
625;03.03.2018;2018;03;23;Lauantai;1;0;1
625;04.03.2018;2018;03;00;Sunnuntai;0;0;0
625;04.03.2018;2018;03;01;Sunnuntai;0;1;1
625;04.03.2018;2018;03;02;Sunnuntai;1;0;1
625;04.03.2018;2018;03;03;Sunnuntai;0;0;0
625;04.03.2018;2018;03;04;Sunnuntai;0;0;0
625;04.03.2018;2018;03;05;Sunnuntai;0;0;0
625;04.03.2018;2018;03;06;Sunnuntai;0;0;0
625;04.03.2018;2018;03;07;Sunnuntai;0;1;1
625;04.03.2018;2018;03;08;Sunnuntai;2;2;4
625;04.03.2018;2018;03;09;Sunnuntai;0;2;2
625;04.03.2018;2018;03;10;Sunnuntai;0;0;0
625;04.03.2018;2018;03;11;Sunnuntai;0;2;2
625;04.03.2018;2018;03;12;Sunnuntai;2;2;4
625;04.03.2018;2018;03;13;Sunnuntai;3;0;3
625;04.03.2018;2018;03;14;Sunnuntai;2;2;4
625;04.03.2018;2018;03;15;Sunnuntai;6;4;10
625;04.03.2018;2018;03;16;Sunnuntai;7;5;12
625;04.03.2018;2018;03;17;Sunnuntai;4;3;7
625;04.03.2018;2018;03;18;Sunnuntai;3;1;4
625;04.03.2018;2018;03;19;Sunnuntai;1;2;3
625;04.03.2018;2018;03;20;Sunnuntai;2;2;4
625;04.03.2018;2018;03;21;Sunnuntai;3;2;5
625;04.03.2018;2018;03;22;Sunnuntai;1;1;2
625;04.03.2018;2018;03;23;Sunnuntai;0;1;1
625;05.03.2018;2018;03;00;Maanantai;1;1;2
625;05.03.2018;2018;03;01;Maanantai;0;1;1
625;05.03.2018;2018;03;02;Maanantai;0;0;0
625;05.03.2018;2018;03;03;Maanantai;0;0;0
625;05.03.2018;2018;03;04;Maanantai;0;0;0
625;05.03.2018;2018;03;05;Maanantai;0;1;1
625;05.03.2018;2018;03;06;Maanantai;2;1;3
625;05.03.2018;2018;03;07;Maanantai;10;6;16
625;05.03.2018;2018;03;08;Maanantai;9;5;14
625;05.03.2018;2018;03;09;Maanantai;1;8;9
625;05.03.2018;2018;03;10;Maanantai;0;2;2
625;05.03.2018;2018;03;11;Maanantai;2;1;3
625;05.03.2018;2018;03;12;Maanantai;6;3;9
625;05.03.2018;2018;03;13;Maanantai;6;3;9
625;05.03.2018;2018;03;14;Maanantai;6;2;8
625;05.03.2018;2018;03;15;Maanantai;3;6;9
625;05.03.2018;2018;03;16;Maanantai;8;6;14
625;05.03.2018;2018;03;17;Maanantai;7;12;19
625;05.03.2018;2018;03;18;Maanantai;6;6;12
625;05.03.2018;2018;03;19;Maanantai;0;3;3
625;05.03.2018;2018;03;20;Maanantai;2;0;2
625;05.03.2018;2018;03;21;Maanantai;1;3;4
625;05.03.2018;2018;03;22;Maanantai;0;2;2
625;05.03.2018;2018;03;23;Maanantai;0;1;1
625;06.03.2018;2018;03;00;Tiistai;0;0;0
625;06.03.2018;2018;03;01;Tiistai;0;0;0
625;06.03.2018;2018;03;02;Tiistai;0;1;1
625;06.03.2018;2018;03;03;Tiistai;0;0;0
625;06.03.2018;2018;03;04;Tiistai;0;1;1
625;06.03.2018;2018;03;05;Tiistai;0;0;0
625;06.03.2018;2018;03;06;Tiistai;1;1;2
625;06.03.2018;2018;03;07;Tiistai;3;3;6
625;06.03.2018;2018;03;08;Tiistai;6;4;10
625;06.03.2018;2018;03;09;Tiistai;4;8;12
625;06.03.2018;2018;03;10;Tiistai;1;3;4
625;06.03.2018;2018;03;11;Tiistai;1;1;2
625;06.03.2018;2018;03;12;Tiistai;2;2;4
625;06.03.2018;2018;03;13;Tiistai;3;4;7
625;06.03.2018;2018;03;14;Tiistai;4;2;6
625;06.03.2018;2018;03;15;Tiistai;2;7;9
625;06.03.2018;2018;03;16;Tiistai;2;9;11
625;06.03.2018;2018;03;17;Tiistai;3;4;7
625;06.03.2018;2018;03;18;Tiistai;2;4;6
625;06.03.2018;2018;03;19;Tiistai;1;2;3
625;06.03.2018;2018;03;20;Tiistai;0;4;4
625;06.03.2018;2018;03;21;Tiistai;2;2;4
625;06.03.2018;2018;03;22;Tiistai;1;0;1
625;06.03.2018;2018;03;23;Tiistai;0;0;0
625;07.03.2018;2018;03;00;Keskiviikko;0;0;0
625;07.03.2018;2018;03;01;Keskiviikko;0;0;0
625;07.03.2018;2018;03;02;Keskiviikko;0;0;0
625;07.03.2018;2018;03;03;Keskiviikko;0;0;0
625;07.03.2018;2018;03;04;Keskiviikko;0;2;2
625;07.03.2018;2018;03;05;Keskiviikko;0;0;0
625;07.03.2018;2018;03;06;Keskiviikko;2;1;3
625;07.03.2018;2018;03;07;Keskiviikko;5;4;9
625;07.03.2018;2018;03;08;Keskiviikko;5;7;12
625;07.03.2018;2018;03;09;Keskiviikko;2;9;11
625;07.03.2018;2018;03;10;Keskiviikko;3;7;10
625;07.03.2018;2018;03;11;Keskiviikko;3;1;4
625;07.03.2018;2018;03;12;Keskiviikko;0;5;5
625;07.03.2018;2018;03;13;Keskiviikko;6;4;10
625;07.03.2018;2018;03;14;Keskiviikko;5;4;9
625;07.03.2018;2018;03;15;Keskiviikko;4;4;8
625;07.03.2018;2018;03;16;Keskiviikko;5;7;12
625;07.03.2018;2018;03;17;Keskiviikko;5;9;14
625;07.03.2018;2018;03;18;Keskiviikko;1;3;4
625;07.03.2018;2018;03;19;Keskiviikko;2;4;6
625;07.03.2018;2018;03;20;Keskiviikko;1;4;5
625;07.03.2018;2018;03;21;Keskiviikko;4;1;5
625;07.03.2018;2018;03;22;Keskiviikko;1;0;1
625;07.03.2018;2018;03;23;Keskiviikko;0;0;0
625;08.03.2018;2018;03;00;Torstai;0;1;1
625;08.03.2018;2018;03;01;Torstai;0;0;0
625;08.03.2018;2018;03;02;Torstai;0;0;0
625;08.03.2018;2018;03;03;Torstai;0;0;0
625;08.03.2018;2018;03;04;Torstai;0;0;0
625;08.03.2018;2018;03;05;Torstai;0;0;0
625;08.03.2018;2018;03;06;Torstai;3;2;5
625;08.03.2018;2018;03;07;Torstai;6;8;14
625;08.03.2018;2018;03;08;Torstai;6;1;7
625;08.03.2018;2018;03;09;Torstai;1;5;6
625;08.03.2018;2018;03;10;Torstai;1;5;6
625;08.03.2018;2018;03;11;Torstai;5;3;8
625;08.03.2018;2018;03;12;Torstai;1;2;3
625;08.03.2018;2018;03;13;Torstai;7;14;21
625;08.03.2018;2018;03;14;Torstai;7;6;13
625;08.03.2018;2018;03;15;Torstai;21;20;41
625;08.03.2018;2018;03;16;Torstai;5;11;16
625;08.03.2018;2018;03;17;Torstai;6;8;14
625;08.03.2018;2018;03;18;Torstai;3;4;7
625;08.03.2018;2018;03;19;Torstai;0;5;5
625;08.03.2018;2018;03;20;Torstai;4;0;4
625;08.03.2018;2018;03;21;Torstai;5;4;9
625;08.03.2018;2018;03;22;Torstai;0;1;1
625;08.03.2018;2018;03;23;Torstai;2;0;2
625;09.03.2018;2018;03;00;Perjantai;1;1;2
625;09.03.2018;2018;03;01;Perjantai;0;1;1
625;09.03.2018;2018;03;02;Perjantai;0;0;0
625;09.03.2018;2018;03;03;Perjantai;0;0;0
625;09.03.2018;2018;03;04;Perjantai;0;1;1
625;09.03.2018;2018;03;05;Perjantai;1;0;1
625;09.03.2018;2018;03;06;Perjantai;0;1;1
625;09.03.2018;2018;03;07;Perjantai;3;3;6
625;09.03.2018;2018;03;08;Perjantai;9;8;17
625;09.03.2018;2018;03;09;Perjantai;3;3;6
625;09.03.2018;2018;03;10;Perjantai;8;10;18
625;09.03.2018;2018;03;11;Perjantai;1;4;5
625;09.03.2018;2018;03;12;Perjantai;3;2;5
625;09.03.2018;2018;03;13;Perjantai;7;8;15
625;09.03.2018;2018;03;14;Perjantai;3;3;6
625;09.03.2018;2018;03;15;Perjantai;4;3;7
625;09.03.2018;2018;03;16;Perjantai;3;6;9
625;09.03.2018;2018;03;17;Perjantai;0;2;2
625;09.03.2018;2018;03;18;Perjantai;1;0;1
625;09.03.2018;2018;03;19;Perjantai;2;1;3
625;09.03.2018;2018;03;20;Perjantai;0;1;1
625;09.03.2018;2018;03;21;Perjantai;1;2;3
625;09.03.2018;2018;03;22;Perjantai;0;0;0
625;09.03.2018;2018;03;23;Perjantai;0;0;0
625;10.03.2018;2018;03;00;Lauantai;0;1;1
625;10.03.2018;2018;03;01;Lauantai;1;0;1
625;10.03.2018;2018;03;02;Lauantai;1;0;1
625;10.03.2018;2018;03;03;Lauantai;0;0;0
625;10.03.2018;2018;03;04;Lauantai;0;0;0
625;10.03.2018;2018;03;05;Lauantai;2;0;2
625;10.03.2018;2018;03;06;Lauantai;2;3;5
625;10.03.2018;2018;03;07;Lauantai;0;2;2
625;10.03.2018;2018;03;08;Lauantai;0;1;1
625;10.03.2018;2018;03;09;Lauantai;3;1;4
625;10.03.2018;2018;03;10;Lauantai;4;3;7
625;10.03.2018;2018;03;11;Lauantai;6;3;9
625;10.03.2018;2018;03;12;Lauantai;3;1;4
625;10.03.2018;2018;03;13;Lauantai;0;4;4
625;10.03.2018;2018;03;14;Lauantai;3;1;4
625;10.03.2018;2018;03;15;Lauantai;2;2;4
625;10.03.2018;2018;03;16;Lauantai;1;2;3
625;10.03.2018;2018;03;17;Lauantai;1;2;3
625;10.03.2018;2018;03;18;Lauantai;3;0;3
625;10.03.2018;2018;03;19;Lauantai;3;6;9
625;10.03.2018;2018;03;20;Lauantai;1;3;4
625;10.03.2018;2018;03;21;Lauantai;0;1;1
625;10.03.2018;2018;03;22;Lauantai;1;2;3
625;10.03.2018;2018;03;23;Lauantai;1;0;1
625;11.03.2018;2018;03;00;Sunnuntai;0;1;1
625;11.03.2018;2018;03;01;Sunnuntai;0;0;0
625;11.03.2018;2018;03;02;Sunnuntai;1;0;1
625;11.03.2018;2018;03;03;Sunnuntai;0;0;0
625;11.03.2018;2018;03;04;Sunnuntai;0;0;0
625;11.03.2018;2018;03;05;Sunnuntai;0;0;0
625;11.03.2018;2018;03;06;Sunnuntai;0;0;0
625;11.03.2018;2018;03;07;Sunnuntai;1;0;1
625;11.03.2018;2018;03;08;Sunnuntai;0;1;1
625;11.03.2018;2018;03;09;Sunnuntai;3;2;5
625;11.03.2018;2018;03;10;Sunnuntai;0;4;4
625;11.03.2018;2018;03;11;Sunnuntai;3;1;4
625;11.03.2018;2018;03;12;Sunnuntai;2;3;5
625;11.03.2018;2018;03;13;Sunnuntai;4;3;7
625;11.03.2018;2018;03;14;Sunnuntai;4;4;8
625;11.03.2018;2018;03;15;Sunnuntai;0;3;3
625;11.03.2018;2018;03;16;Sunnuntai;2;2;4
625;11.03.2018;2018;03;17;Sunnuntai;2;3;5
625;11.03.2018;2018;03;18;Sunnuntai;2;6;8
625;11.03.2018;2018;03;19;Sunnuntai;4;2;6
625;11.03.2018;2018;03;20;Sunnuntai;1;0;1
625;11.03.2018;2018;03;21;Sunnuntai;1;0;1
625;11.03.2018;2018;03;22;Sunnuntai;1;1;2
625;11.03.2018;2018;03;23;Sunnuntai;0;0;0
625;12.03.2018;2018;03;00;Maanantai;1;0;1
625;12.03.2018;2018;03;01;Maanantai;0;0;0
625;12.03.2018;2018;03;02;Maanantai;0;0;0
625;12.03.2018;2018;03;03;Maanantai;0;0;0
625;12.03.2018;2018;03;04;Maanantai;0;0;0
625;12.03.2018;2018;03;05;Maanantai;1;0;1
625;12.03.2018;2018;03;06;Maanantai;1;2;3
625;12.03.2018;2018;03;07;Maanantai;12;5;17
625;12.03.2018;2018;03;08;Maanantai;25;10;35
625;12.03.2018;2018;03;09;Maanantai;14;10;24
625;12.03.2018;2018;03;10;Maanantai;17;7;24
625;12.03.2018;2018;03;11;Maanantai;4;3;7
625;12.03.2018;2018;03;12;Maanantai;5;3;8
625;12.03.2018;2018;03;13;Maanantai;6;10;16
625;12.03.2018;2018;03;14;Maanantai;7;15;22
625;12.03.2018;2018;03;15;Maanantai;13;20;33
625;12.03.2018;2018;03;16;Maanantai;7;27;34
625;12.03.2018;2018;03;17;Maanantai;9;15;24
625;12.03.2018;2018;03;18;Maanantai;2;7;9
625;12.03.2018;2018;03;19;Maanantai;4;5;9
625;12.03.2018;2018;03;20;Maanantai;2;2;4
625;12.03.2018;2018;03;21;Maanantai;3;3;6
625;12.03.2018;2018;03;22;Maanantai;1;3;4
625;12.03.2018;2018;03;23;Maanantai;2;0;2
625;13.03.2018;2018;03;00;Tiistai;1;0;1
625;13.03.2018;2018;03;01;Tiistai;1;0;1
625;13.03.2018;2018;03;02;Tiistai;0;1;1
625;13.03.2018;2018;03;03;Tiistai;0;0;0
625;13.03.2018;2018;03;04;Tiistai;0;0;0
625;13.03.2018;2018;03;05;Tiistai;1;0;1
625;13.03.2018;2018;03;06;Tiistai;1;5;6
625;13.03.2018;2018;03;07;Tiistai;8;3;11
625;13.03.2018;2018;03;08;Tiistai;18;10;28
625;13.03.2018;2018;03;09;Tiistai;17;11;28
625;13.03.2018;2018;03;10;Tiistai;11;6;17
625;13.03.2018;2018;03;11;Tiistai;7;3;10
625;13.03.2018;2018;03;12;Tiistai;4;4;8
625;13.03.2018;2018;03;13;Tiistai;4;7;11
625;13.03.2018;2018;03;14;Tiistai;5;14;19
625;13.03.2018;2018;03;15;Tiistai;6;15;21
625;13.03.2018;2018;03;16;Tiistai;9;17;26
625;13.03.2018;2018;03;17;Tiistai;11;16;27
625;13.03.2018;2018;03;18;Tiistai;9;15;24
625;13.03.2018;2018;03;19;Tiistai;2;4;6
625;13.03.2018;2018;03;20;Tiistai;2;5;7
625;13.03.2018;2018;03;21;Tiistai;2;1;3
625;13.03.2018;2018;03;22;Tiistai;1;1;2
625;13.03.2018;2018;03;23;Tiistai;3;0;3
625;14.03.2018;2018;03;00;Keskiviikko;2;2;4
625;14.03.2018;2018;03;01;Keskiviikko;0;0;0
625;14.03.2018;2018;03;02;Keskiviikko;0;0;0
625;14.03.2018;2018;03;03;Keskiviikko;0;0;0
625;14.03.2018;2018;03;04;Keskiviikko;0;0;0
625;14.03.2018;2018;03;05;Keskiviikko;1;0;1
625;14.03.2018;2018;03;06;Keskiviikko;3;4;7
625;14.03.2018;2018;03;07;Keskiviikko;15;3;18
625;14.03.2018;2018;03;08;Keskiviikko;25;8;33
625;14.03.2018;2018;03;09;Keskiviikko;10;14;24
625;14.03.2018;2018;03;10;Keskiviikko;7;7;14
625;14.03.2018;2018;03;11;Keskiviikko;9;3;12
625;14.03.2018;2018;03;12;Keskiviikko;8;3;11
625;14.03.2018;2018;03;13;Keskiviikko;8;11;19
625;14.03.2018;2018;03;14;Keskiviikko;7;9;16
625;14.03.2018;2018;03;15;Keskiviikko;9;19;28
625;14.03.2018;2018;03;16;Keskiviikko;11;20;31
625;14.03.2018;2018;03;17;Keskiviikko;5;21;26
625;14.03.2018;2018;03;18;Keskiviikko;7;10;17
625;14.03.2018;2018;03;19;Keskiviikko;5;3;8
625;14.03.2018;2018;03;20;Keskiviikko;5;8;13
625;14.03.2018;2018;03;21;Keskiviikko;3;2;5
625;14.03.2018;2018;03;22;Keskiviikko;1;2;3
625;14.03.2018;2018;03;23;Keskiviikko;2;1;3
625;15.03.2018;2018;03;00;Torstai;1;0;1
625;15.03.2018;2018;03;01;Torstai;0;0;0
625;15.03.2018;2018;03;02;Torstai;0;0;0
625;15.03.2018;2018;03;03;Torstai;0;0;0
625;15.03.2018;2018;03;04;Torstai;0;0;0
625;15.03.2018;2018;03;05;Torstai;1;0;1
625;15.03.2018;2018;03;06;Torstai;1;1;2
625;15.03.2018;2018;03;07;Torstai;6;3;9
625;15.03.2018;2018;03;08;Torstai;27;6;33
625;15.03.2018;2018;03;09;Torstai;15;7;22
625;15.03.2018;2018;03;10;Torstai;4;7;11
625;15.03.2018;2018;03;11;Torstai;4;1;5
625;15.03.2018;2018;03;12;Torstai;5;9;14
625;15.03.2018;2018;03;13;Torstai;4;9;13
625;15.03.2018;2018;03;14;Torstai;11;10;21
625;15.03.2018;2018;03;15;Torstai;7;17;24
625;15.03.2018;2018;03;16;Torstai;9;28;37
625;15.03.2018;2018;03;17;Torstai;3;12;15
625;15.03.2018;2018;03;18;Torstai;4;4;8
625;15.03.2018;2018;03;19;Torstai;0;5;5
625;15.03.2018;2018;03;20;Torstai;0;2;2
625;15.03.2018;2018;03;21;Torstai;2;1;3
625;15.03.2018;2018;03;22;Torstai;2;2;4
625;15.03.2018;2018;03;23;Torstai;0;2;2
625;16.03.2018;2018;03;00;Perjantai;0;0;0
625;16.03.2018;2018;03;01;Perjantai;0;0;0
625;16.03.2018;2018;03;02;Perjantai;0;0;0
625;16.03.2018;2018;03;03;Perjantai;0;0;0
625;16.03.2018;2018;03;04;Perjantai;0;0;0
625;16.03.2018;2018;03;05;Perjantai;0;0;0
625;16.03.2018;2018;03;06;Perjantai;2;0;2
625;16.03.2018;2018;03;07;Perjantai;7;7;14
625;16.03.2018;2018;03;08;Perjantai;14;7;21
625;16.03.2018;2018;03;09;Perjantai;11;13;24
625;16.03.2018;2018;03;10;Perjantai;11;7;18
625;16.03.2018;2018;03;11;Perjantai;6;8;14
625;16.03.2018;2018;03;12;Perjantai;5;6;11
625;16.03.2018;2018;03;13;Perjantai;6;12;18
625;16.03.2018;2018;03;14;Perjantai;5;17;22
625;16.03.2018;2018;03;15;Perjantai;2;13;15
625;16.03.2018;2018;03;16;Perjantai;5;12;17
625;16.03.2018;2018;03;17;Perjantai;3;11;14
625;16.03.2018;2018;03;18;Perjantai;3;9;12
625;16.03.2018;2018;03;19;Perjantai;2;6;8
625;16.03.2018;2018;03;20;Perjantai;1;3;4
625;16.03.2018;2018;03;21;Perjantai;2;2;4
625;16.03.2018;2018;03;22;Perjantai;1;1;2
625;16.03.2018;2018;03;23;Perjantai;1;1;2
625;17.03.2018;2018;03;00;Lauantai;2;2;4
625;17.03.2018;2018;03;01;Lauantai;1;0;1
625;17.03.2018;2018;03;02;Lauantai;0;1;1
625;17.03.2018;2018;03;03;Lauantai;0;0;0
625;17.03.2018;2018;03;04;Lauantai;0;0;0
625;17.03.2018;2018;03;05;Lauantai;0;0;0
625;17.03.2018;2018;03;06;Lauantai;0;0;0
625;17.03.2018;2018;03;07;Lauantai;1;1;2
625;17.03.2018;2018;03;08;Lauantai;0;0;0
625;17.03.2018;2018;03;09;Lauantai;1;1;2
625;17.03.2018;2018;03;10;Lauantai;0;1;1
625;17.03.2018;2018;03;11;Lauantai;0;3;3
625;17.03.2018;2018;03;12;Lauantai;2;1;3
625;17.03.2018;2018;03;13;Lauantai;0;6;6
625;17.03.2018;2018;03;14;Lauantai;2;5;7
625;17.03.2018;2018;03;15;Lauantai;2;4;6
625;17.03.2018;2018;03;16;Lauantai;1;2;3
625;17.03.2018;2018;03;17;Lauantai;1;1;2
625;17.03.2018;2018;03;18;Lauantai;3;3;6
625;17.03.2018;2018;03;19;Lauantai;0;0;0
625;17.03.2018;2018;03;20;Lauantai;0;0;0
625;17.03.2018;2018;03;21;Lauantai;0;0;0
625;17.03.2018;2018;03;22;Lauantai;0;0;0
625;17.03.2018;2018;03;23;Lauantai;0;0;0
625;18.03.2018;2018;03;00;Sunnuntai;0;1;1
625;18.03.2018;2018;03;01;Sunnuntai;0;0;0
625;18.03.2018;2018;03;02;Sunnuntai;1;0;1
625;18.03.2018;2018;03;03;Sunnuntai;0;0;0
625;18.03.2018;2018;03;04;Sunnuntai;0;0;0
625;18.03.2018;2018;03;05;Sunnuntai;0;0;0
625;18.03.2018;2018;03;06;Sunnuntai;0;0;0
625;18.03.2018;2018;03;07;Sunnuntai;1;0;1
625;18.03.2018;2018;03;08;Sunnuntai;0;1;1
625;18.03.2018;2018;03;09;Sunnuntai;3;2;5
625;18.03.2018;2018;03;10;Sunnuntai;0;4;4
625;18.03.2018;2018;03;11;Sunnuntai;3;1;4
625;18.03.2018;2018;03;12;Sunnuntai;2;3;5
625;18.03.2018;2018;03;13;Sunnuntai;4;3;7
625;18.03.2018;2018;03;14;Sunnuntai;4;4;8
625;18.03.2018;2018;03;15;Sunnuntai;0;3;3
625;18.03.2018;2018;03;16;Sunnuntai;2;2;4
625;18.03.2018;2018;03;17;Sunnuntai;2;3;5
625;18.03.2018;2018;03;18;Sunnuntai;2;6;8
625;18.03.2018;2018;03;19;Sunnuntai;4;2;6
625;18.03.2018;2018;03;20;Sunnuntai;1;0;1
625;18.03.2018;2018;03;21;Sunnuntai;1;0;1
625;18.03.2018;2018;03;22;Sunnuntai;1;1;2
625;18.03.2018;2018;03;23;Sunnuntai;0;0;0
625;19.03.2018;2018;03;00;Maanantai;2;0;2
625;19.03.2018;2018;03;01;Maanantai;0;0;0
625;19.03.2018;2018;03;02;Maanantai;0;0;0
625;19.03.2018;2018;03;03;Maanantai;0;0;0
625;19.03.2018;2018;03;04;Maanantai;0;1;1
625;19.03.2018;2018;03;05;Maanantai;0;0;0
625;19.03.2018;2018;03;06;Maanantai;1;3;4
625;19.03.2018;2018;03;07;Maanantai;3;4;7
625;19.03.2018;2018;03;08;Maanantai;11;10;21
625;19.03.2018;2018;03;09;Maanantai;11;10;21
625;19.03.2018;2018;03;10;Maanantai;12;10;22
625;19.03.2018;2018;03;11;Maanantai;4;3;7
625;19.03.2018;2018;03;12;Maanantai;1;4;5
625;19.03.2018;2018;03;13;Maanantai;6;10;16
625;19.03.2018;2018;03;14;Maanantai;7;9;16
625;19.03.2018;2018;03;15;Maanantai;3;20;23
625;19.03.2018;2018;03;16;Maanantai;4;24;28
625;19.03.2018;2018;03;17;Maanantai;5;22;27
625;19.03.2018;2018;03;18;Maanantai;3;6;9
625;19.03.2018;2018;03;19;Maanantai;0;6;6
625;19.03.2018;2018;03;20;Maanantai;2;4;6
625;19.03.2018;2018;03;21;Maanantai;2;3;5
625;19.03.2018;2018;03;22;Maanantai;0;1;1
625;19.03.2018;2018;03;23;Maanantai;1;2;3
625;20.03.2018;2018;03;00;Tiistai;2;0;2
625;20.03.2018;2018;03;01;Tiistai;0;0;0
625;20.03.2018;2018;03;02;Tiistai;0;0;0
625;20.03.2018;2018;03;03;Tiistai;0;0;0
625;20.03.2018;2018;03;04;Tiistai;0;1;1
625;20.03.2018;2018;03;05;Tiistai;0;0;0
625;20.03.2018;2018;03;06;Tiistai;1;3;4
625;20.03.2018;2018;03;07;Tiistai;3;4;7
625;20.03.2018;2018;03;08;Tiistai;11;11;22
625;20.03.2018;2018;03;09;Tiistai;11;15;26
625;20.03.2018;2018;03;10;Tiistai;13;12;25
625;20.03.2018;2018;03;11;Tiistai;4;2;6
625;20.03.2018;2018;03;12;Tiistai;4;6;10
625;20.03.2018;2018;03;13;Tiistai;4;7;11
625;20.03.2018;2018;03;14;Tiistai;6;22;28
625;20.03.2018;2018;03;15;Tiistai;5;15;20
625;20.03.2018;2018;03;16;Tiistai;6;13;19
625;20.03.2018;2018;03;17;Tiistai;9;10;19
625;20.03.2018;2018;03;18;Tiistai;5;6;11
625;20.03.2018;2018;03;19;Tiistai;0;5;5
625;20.03.2018;2018;03;20;Tiistai;1;3;4
625;20.03.2018;2018;03;21;Tiistai;0;2;2
625;20.03.2018;2018;03;22;Tiistai;2;2;4
625;20.03.2018;2018;03;23;Tiistai;0;0;0
625;21.03.2018;2018;03;00;Keskiviikko;0;0;0
625;21.03.2018;2018;03;01;Keskiviikko;0;0;0
625;21.03.2018;2018;03;02;Keskiviikko;0;0;0
625;21.03.2018;2018;03;03;Keskiviikko;0;0;0
625;21.03.2018;2018;03;04;Keskiviikko;0;1;1
625;21.03.2018;2018;03;05;Keskiviikko;1;0;1
625;21.03.2018;2018;03;06;Keskiviikko;2;3;5
625;21.03.2018;2018;03;07;Keskiviikko;6;4;10
625;21.03.2018;2018;03;08;Keskiviikko;17;10;27
625;21.03.2018;2018;03;09;Keskiviikko;6;9;15
625;21.03.2018;2018;03;10;Keskiviikko;2;4;6
625;21.03.2018;2018;03;11;Keskiviikko;2;3;5
625;21.03.2018;2018;03;12;Keskiviikko;1;2;3
625;21.03.2018;2018;03;13;Keskiviikko;1;6;7
625;21.03.2018;2018;03;14;Keskiviikko;8;18;26
625;21.03.2018;2018;03;15;Keskiviikko;4;19;23
625;21.03.2018;2018;03;16;Keskiviikko;6;19;25
625;21.03.2018;2018;03;17;Keskiviikko;5;16;21
625;21.03.2018;2018;03;18;Keskiviikko;2;3;5
625;21.03.2018;2018;03;19;Keskiviikko;4;2;6
625;21.03.2018;2018;03;20;Keskiviikko;2;4;6
625;21.03.2018;2018;03;21;Keskiviikko;1;2;3
625;21.03.2018;2018;03;22;Keskiviikko;1;2;3
625;21.03.2018;2018;03;23;Keskiviikko;1;1;2
625;22.03.2018;2018;03;00;Torstai;0;0;0
625;22.03.2018;2018;03;01;Torstai;0;0;0
625;22.03.2018;2018;03;02;Torstai;0;2;2
625;22.03.2018;2018;03;03;Torstai;0;0;0
625;22.03.2018;2018;03;04;Torstai;0;2;2
625;22.03.2018;2018;03;05;Torstai;0;0;0
625;22.03.2018;2018;03;06;Torstai;5;3;8
625;22.03.2018;2018;03;07;Torstai;3;6;9
625;22.03.2018;2018;03;08;Torstai;18;7;25
625;22.03.2018;2018;03;09;Torstai;15;12;27
625;22.03.2018;2018;03;10;Torstai;10;5;15
625;22.03.2018;2018;03;11;Torstai;3;2;5
625;22.03.2018;2018;03;12;Torstai;2;4;6
625;22.03.2018;2018;03;13;Torstai;7;12;19
625;22.03.2018;2018;03;14;Torstai;4;12;16
625;22.03.2018;2018;03;15;Torstai;3;17;20
625;22.03.2018;2018;03;16;Torstai;7;20;27
625;22.03.2018;2018;03;17;Torstai;8;15;23
625;22.03.2018;2018;03;18;Torstai;4;5;9
625;22.03.2018;2018;03;19;Torstai;6;6;12
625;22.03.2018;2018;03;20;Torstai;2;2;4
625;22.03.2018;2018;03;21;Torstai;1;2;3
625;22.03.2018;2018;03;22;Torstai;2;1;3
625;22.03.2018;2018;03;23;Torstai;0;0;0
625;23.03.2018;2018;03;00;Perjantai;1;0;1
625;23.03.2018;2018;03;01;Perjantai;0;0;0
625;23.03.2018;2018;03;02;Perjantai;0;1;1
625;23.03.2018;2018;03;03;Perjantai;0;0;0
625;23.03.2018;2018;03;04;Perjantai;0;0;0
625;23.03.2018;2018;03;05;Perjantai;1;0;1
625;23.03.2018;2018;03;06;Perjantai;1;2;3
625;23.03.2018;2018;03;07;Perjantai;2;2;4
625;23.03.2018;2018;03;08;Perjantai;19;7;26
625;23.03.2018;2018;03;09;Perjantai;5;4;9
625;23.03.2018;2018;03;10;Perjantai;3;6;9
625;23.03.2018;2018;03;11;Perjantai;2;6;8
625;23.03.2018;2018;03;12;Perjantai;2;8;10
625;23.03.2018;2018;03;13;Perjantai;7;18;25
625;23.03.2018;2018;03;14;Perjantai;10;16;26
625;23.03.2018;2018;03;15;Perjantai;3;18;21
625;23.03.2018;2018;03;16;Perjantai;2;11;13
625;23.03.2018;2018;03;17;Perjantai;2;8;10
625;23.03.2018;2018;03;18;Perjantai;2;6;8
625;23.03.2018;2018;03;19;Perjantai;2;2;4
625;23.03.2018;2018;03;20;Perjantai;0;1;1
625;23.03.2018;2018;03;21;Perjantai;3;4;7
625;23.03.2018;2018;03;22;Perjantai;1;4;5
625;23.03.2018;2018;03;23;Perjantai;1;0;1
625;24.03.2018;2018;03;00;Lauantai;0;1;1
625;24.03.2018;2018;03;01;Lauantai;2;3;5
625;24.03.2018;2018;03;02;Lauantai;0;0;0
625;24.03.2018;2018;03;03;Lauantai;0;0;0
625;24.03.2018;2018;03;04;Lauantai;0;0;0
625;24.03.2018;2018;03;05;Lauantai;0;0;0
625;24.03.2018;2018;03;06;Lauantai;0;1;1
625;24.03.2018;2018;03;07;Lauantai;1;0;1
625;24.03.2018;2018;03;08;Lauantai;3;1;4
625;24.03.2018;2018;03;09;Lauantai;1;1;2
625;24.03.2018;2018;03;10;Lauantai;2;0;2
625;24.03.2018;2018;03;11;Lauantai;2;2;4
625;24.03.2018;2018;03;12;Lauantai;2;3;5
625;24.03.2018;2018;03;13;Lauantai;5;3;8
625;24.03.2018;2018;03;14;Lauantai;3;2;5
625;24.03.2018;2018;03;15;Lauantai;1;2;3
625;24.03.2018;2018;03;16;Lauantai;1;1;2
625;24.03.2018;2018;03;17;Lauantai;1;4;5
625;24.03.2018;2018;03;18;Lauantai;3;2;5
625;24.03.2018;2018;03;19;Lauantai;3;6;9
625;24.03.2018;2018;03;20;Lauantai;0;1;1
625;24.03.2018;2018;03;21;Lauantai;1;2;3
625;24.03.2018;2018;03;22;Lauantai;0;1;1
625;24.03.2018;2018;03;23;Lauantai;1;1;2
625;25.03.2018;2018;03;00;Sunnuntai;0;2;2
625;25.03.2018;2018;03;01;Sunnuntai;0;2;2
625;25.03.2018;2018;03;02;Sunnuntai;1;0;1
625;25.03.2018;2018;03;03;Sunnuntai;0;0;0
625;25.03.2018;2018;03;04;Sunnuntai;0;0;0
625;25.03.2018;2018;03;05;Sunnuntai;0;0;0
625;25.03.2018;2018;03;06;Sunnuntai;0;1;1
625;25.03.2018;2018;03;07;Sunnuntai;0;0;0
625;25.03.2018;2018;03;08;Sunnuntai;0;0;0
625;25.03.2018;2018;03;09;Sunnuntai;3;2;5
625;25.03.2018;2018;03;10;Sunnuntai;0;4;4
625;25.03.2018;2018;03;11;Sunnuntai;2;1;3
625;25.03.2018;2018;03;12;Sunnuntai;3;4;7
625;25.03.2018;2018;03;13;Sunnuntai;4;6;10
625;25.03.2018;2018;03;14;Sunnuntai;2;5;7
625;25.03.2018;2018;03;15;Sunnuntai;5;5;10
625;25.03.2018;2018;03;16;Sunnuntai;1;4;5
625;25.03.2018;2018;03;17;Sunnuntai;2;6;8
625;25.03.2018;2018;03;18;Sunnuntai;4;5;9
625;25.03.2018;2018;03;19;Sunnuntai;0;4;4
625;25.03.2018;2018;03;20;Sunnuntai;1;5;6
625;25.03.2018;2018;03;21;Sunnuntai;1;5;6
625;25.03.2018;2018;03;22;Sunnuntai;2;1;3
625;25.03.2018;2018;03;23;Sunnuntai;0;1;1
625;26.03.2018;2018;03;00;Maanantai;1;1;2
625;26.03.2018;2018;03;01;Maanantai;1;0;1
625;26.03.2018;2018;03;02;Maanantai;0;0;0
625;26.03.2018;2018;03;03;Maanantai;0;0;0
625;26.03.2018;2018;03;04;Maanantai;0;1;1
625;26.03.2018;2018;03;05;Maanantai;2;0;2
625;26.03.2018;2018;03;06;Maanantai;1;1;2
625;26.03.2018;2018;03;07;Maanantai;10;4;14
625;26.03.2018;2018;03;08;Maanantai;23;8;31
625;26.03.2018;2018;03;09;Maanantai;20;14;34
625;26.03.2018;2018;03;10;Maanantai;6;9;15
625;26.03.2018;2018;03;11;Maanantai;9;2;11
625;26.03.2018;2018;03;12;Maanantai;8;6;14
625;26.03.2018;2018;03;13;Maanantai;8;10;18
625;26.03.2018;2018;03;14;Maanantai;6;11;17
625;26.03.2018;2018;03;15;Maanantai;9;18;27
625;26.03.2018;2018;03;16;Maanantai;13;27;40
625;26.03.2018;2018;03;17;Maanantai;14;22;36
625;26.03.2018;2018;03;18;Maanantai;6;6;12
625;26.03.2018;2018;03;19;Maanantai;1;9;10
625;26.03.2018;2018;03;20;Maanantai;4;4;8
625;26.03.2018;2018;03;21;Maanantai;3;3;6
625;26.03.2018;2018;03;22;Maanantai;2;1;3
625;26.03.2018;2018;03;23;Maanantai;1;1;2
625;27.03.2018;2018;03;00;Tiistai;1;0;1
625;27.03.2018;2018;03;01;Tiistai;0;0;0
625;27.03.2018;2018;03;02;Tiistai;0;0;0
625;27.03.2018;2018;03;03;Tiistai;0;0;0
625;27.03.2018;2018;03;04;Tiistai;0;0;0
625;27.03.2018;2018;03;05;Tiistai;1;0;1
625;27.03.2018;2018;03;06;Tiistai;3;1;4
625;27.03.2018;2018;03;07;Tiistai;8;4;12
625;27.03.2018;2018;03;08;Tiistai;18;10;28
625;27.03.2018;2018;03;09;Tiistai;20;12;32
625;27.03.2018;2018;03;10;Tiistai;14;10;24
625;27.03.2018;2018;03;11;Tiistai;10;0;10
625;27.03.2018;2018;03;12;Tiistai;6;5;11
625;27.03.2018;2018;03;13;Tiistai;10;12;22
625;27.03.2018;2018;03;14;Tiistai;7;17;24
625;27.03.2018;2018;03;15;Tiistai;9;19;28
625;27.03.2018;2018;03;16;Tiistai;4;23;27
625;27.03.2018;2018;03;17;Tiistai;6;22;28
625;27.03.2018;2018;03;18;Tiistai;4;6;10
625;27.03.2018;2018;03;19;Tiistai;4;5;9
625;27.03.2018;2018;03;20;Tiistai;5;3;8
625;27.03.2018;2018;03;21;Tiistai;2;1;3
625;27.03.2018;2018;03;22;Tiistai;4;4;8
625;27.03.2018;2018;03;23;Tiistai;4;0;4
625;28.03.2018;2018;03;00;Keskiviikko;0;0;0
625;28.03.2018;2018;03;01;Keskiviikko;1;0;1
625;28.03.2018;2018;03;02;Keskiviikko;0;0;0
625;28.03.2018;2018;03;03;Keskiviikko;0;0;0
625;28.03.2018;2018;03;04;Keskiviikko;0;0;0
625;28.03.2018;2018;03;05;Keskiviikko;1;0;1
625;28.03.2018;2018;03;06;Keskiviikko;2;1;3
625;28.03.2018;2018;03;07;Keskiviikko;9;3;12
625;28.03.2018;2018;03;08;Keskiviikko;28;13;41
625;28.03.2018;2018;03;09;Keskiviikko;17;8;25
625;28.03.2018;2018;03;10;Keskiviikko;12;8;20
625;28.03.2018;2018;03;11;Keskiviikko;1;1;2
625;28.03.2018;2018;03;12;Keskiviikko;2;6;8
625;28.03.2018;2018;03;13;Keskiviikko;6;9;15
625;28.03.2018;2018;03;14;Keskiviikko;3;16;19
625;28.03.2018;2018;03;15;Keskiviikko;8;21;29
625;28.03.2018;2018;03;16;Keskiviikko;2;12;14
625;28.03.2018;2018;03;17;Keskiviikko;5;21;26
625;28.03.2018;2018;03;18;Keskiviikko;8;10;18
625;28.03.2018;2018;03;19;Keskiviikko;2;5;7
625;28.03.2018;2018;03;20;Keskiviikko;2;3;5
625;28.03.2018;2018;03;21;Keskiviikko;1;5;6
625;28.03.2018;2018;03;22;Keskiviikko;1;2;3
625;28.03.2018;2018;03;23;Keskiviikko;2;2;4
625;29.03.2018;2018;03;00;Torstai;0;0;0
625;29.03.2018;2018;03;01;Torstai;1;0;1
625;29.03.2018;2018;03;02;Torstai;0;0;0
625;29.03.2018;2018;03;03;Torstai;0;0;0
625;29.03.2018;2018;03;04;Torstai;0;0;0
625;29.03.2018;2018;03;05;Torstai;1;0;1
625;29.03.2018;2018;03;06;Torstai;3;1;4
625;29.03.2018;2018;03;07;Torstai;8;2;10
625;29.03.2018;2018;03;08;Torstai;20;11;31
625;29.03.2018;2018;03;09;Torstai;14;9;23
625;29.03.2018;2018;03;10;Torstai;5;5;10
625;29.03.2018;2018;03;11;Torstai;3;4;7
625;29.03.2018;2018;03;12;Torstai;4;3;7
625;29.03.2018;2018;03;13;Torstai;7;17;24
625;29.03.2018;2018;03;14;Torstai;6;9;15
625;29.03.2018;2018;03;15;Torstai;4;24;28
625;29.03.2018;2018;03;16;Torstai;7;17;24
625;29.03.2018;2018;03;17;Torstai;7;14;21
625;29.03.2018;2018;03;18;Torstai;2;8;10
625;29.03.2018;2018;03;19;Torstai;1;4;5
625;29.03.2018;2018;03;20;Torstai;2;1;3
625;29.03.2018;2018;03;21;Torstai;6;3;9
625;29.03.2018;2018;03;22;Torstai;0;0;0
625;29.03.2018;2018;03;23;Torstai;2;0;2
625;30.03.2018;2018;03;00;Perjantai;1;0;1
625;30.03.2018;2018;03;01;Perjantai;1;0;1
625;30.03.2018;2018;03;02;Perjantai;0;0;0
625;30.03.2018;2018;03;03;Perjantai;0;0;0
625;30.03.2018;2018;03;04;Perjantai;0;0;0
625;30.03.2018;2018;03;05;Perjantai;0;0;0
625;30.03.2018;2018;03;06;Perjantai;0;0;0
625;30.03.2018;2018;03;07;Perjantai;1;3;4
625;30.03.2018;2018;03;08;Perjantai;0;2;2
625;30.03.2018;2018;03;09;Perjantai;0;1;1
625;30.03.2018;2018;03;10;Perjantai;1;3;4
625;30.03.2018;2018;03;11;Perjantai;0;2;2
625;30.03.2018;2018;03;12;Perjantai;5;9;14
625;30.03.2018;2018;03;13;Perjantai;4;1;5
625;30.03.2018;2018;03;14;Perjantai;3;4;7
625;30.03.2018;2018;03;15;Perjantai;2;4;6
625;30.03.2018;2018;03;16;Perjantai;7;3;10
625;30.03.2018;2018;03;17;Perjantai;3;3;6
625;30.03.2018;2018;03;18;Perjantai;2;4;6
625;30.03.2018;2018;03;19;Perjantai;2;2;4
625;30.03.2018;2018;03;20;Perjantai;2;1;3
625;30.03.2018;2018;03;21;Perjantai;3;2;5
625;30.03.2018;2018;03;22;Perjantai;0;0;0
625;30.03.2018;2018;03;23;Perjantai;1;1;2
625;31.03.2018;2018;03;00;Lauantai;0;1;1
625;31.03.2018;2018;03;01;Lauantai;0;0;0
625;31.03.2018;2018;03;02;Lauantai;0;0;0
625;31.03.2018;2018;03;03;Lauantai;0;0;0
625;31.03.2018;2018;03;04;Lauantai;0;0;0
625;31.03.2018;2018;03;05;Lauantai;0;0;0
625;31.03.2018;2018;03;06;Lauantai;0;0;0
625;31.03.2018;2018;03;07;Lauantai;0;1;1
625;31.03.2018;2018;03;08;Lauantai;0;3;3
625;31.03.2018;2018;03;09;Lauantai;0;3;3
625;31.03.2018;2018;03;10;Lauantai;0;1;1
625;31.03.2018;2018;03;11;Lauantai;0;1;1
625;31.03.2018;2018;03;12;Lauantai;1;4;5
625;31.03.2018;2018;03;13;Lauantai;0;5;5
625;31.03.2018;2018;03;14;Lauantai;2;4;6
625;31.03.2018;2018;03;15;Lauantai;2;5;7
625;31.03.2018;2018;03;16;Lauantai;5;1;6
625;31.03.2018;2018;03;17;Lauantai;2;2;4
625;31.03.2018;2018;03;18;Lauantai;2;4;6
625;31.03.2018;2018;03;19;Lauantai;2;2;4
625;31.03.2018;2018;03;20;Lauantai;0;0;0
625;31.03.2018;2018;03;21;Lauantai;3;4;7
625;31.03.2018;2018;03;22;Lauantai;0;0;0
625;31.03.2018;2018;03;23;Lauantai;0;0;0
625;01.04.2018;2018;04;00;Sunnuntai;0;0;0
625;01.04.2018;2018;04;01;Sunnuntai;1;0;1
625;01.04.2018;2018;04;02;Sunnuntai;0;0;0
625;01.04.2018;2018;04;03;Sunnuntai;0;0;0
625;01.04.2018;2018;04;04;Sunnuntai;0;0;0
625;01.04.2018;2018;04;05;Sunnuntai;0;0;0
625;01.04.2018;2018;04;06;Sunnuntai;0;0;0
625;01.04.2018;2018;04;07;Sunnuntai;1;1;2
625;01.04.2018;2018;04;08;Sunnuntai;1;3;4
625;01.04.2018;2018;04;09;Sunnuntai;0;0;0
625;01.04.2018;2018;04;10;Sunnuntai;1;1;2
625;01.04.2018;2018;04;11;Sunnuntai;1;2;3
625;01.04.2018;2018;04;12;Sunnuntai;2;2;4
625;01.04.2018;2018;04;13;Sunnuntai;7;6;13
625;01.04.2018;2018;04;14;Sunnuntai;2;2;4
625;01.04.2018;2018;04;15;Sunnuntai;1;4;5
625;01.04.2018;2018;04;16;Sunnuntai;4;4;8
625;01.04.2018;2018;04;17;Sunnuntai;1;1;2
625;01.04.2018;2018;04;18;Sunnuntai;0;3;3
625;01.04.2018;2018;04;19;Sunnuntai;2;4;6
625;01.04.2018;2018;04;20;Sunnuntai;0;2;2
625;01.04.2018;2018;04;21;Sunnuntai;3;1;4
625;01.04.2018;2018;04;22;Sunnuntai;1;4;5
625;01.04.2018;2018;04;23;Sunnuntai;0;1;1
625;02.04.2018;2018;04;00;Maanantai;1;0;1
625;02.04.2018;2018;04;01;Maanantai;0;1;1
625;02.04.2018;2018;04;02;Maanantai;0;0;0
625;02.04.2018;2018;04;03;Maanantai;0;0;0
625;02.04.2018;2018;04;04;Maanantai;0;0;0
625;02.04.2018;2018;04;05;Maanantai;0;0;0
625;02.04.2018;2018;04;06;Maanantai;0;0;0
625;02.04.2018;2018;04;07;Maanantai;1;0;1
625;02.04.2018;2018;04;08;Maanantai;0;2;2
625;02.04.2018;2018;04;09;Maanantai;0;0;0
625;02.04.2018;2018;04;10;Maanantai;0;1;1
625;02.04.2018;2018;04;11;Maanantai;2;4;6
625;02.04.2018;2018;04;12;Maanantai;0;3;3
625;02.04.2018;2018;04;13;Maanantai;3;3;6
625;02.04.2018;2018;04;14;Maanantai;2;6;8
625;02.04.2018;2018;04;15;Maanantai;1;5;6
625;02.04.2018;2018;04;16;Maanantai;3;7;10
625;02.04.2018;2018;04;17;Maanantai;1;3;4
625;02.04.2018;2018;04;18;Maanantai;4;4;8
625;02.04.2018;2018;04;19;Maanantai;1;0;1
625;02.04.2018;2018;04;20;Maanantai;0;0;0
625;02.04.2018;2018;04;21;Maanantai;5;5;10
625;02.04.2018;2018;04;22;Maanantai;2;2;4
625;02.04.2018;2018;04;23;Maanantai;0;0;0
625;03.04.2018;2018;04;00;Tiistai;0;0;0
625;03.04.2018;2018;04;01;Tiistai;0;0;0
625;03.04.2018;2018;04;02;Tiistai;0;0;0
625;03.04.2018;2018;04;03;Tiistai;0;0;0
625;03.04.2018;2018;04;04;Tiistai;1;0;1
625;03.04.2018;2018;04;05;Tiistai;0;0;0
625;03.04.2018;2018;04;06;Tiistai;4;0;4
625;03.04.2018;2018;04;07;Tiistai;9;1;10
625;03.04.2018;2018;04;08;Tiistai;13;10;23
625;03.04.2018;2018;04;09;Tiistai;13;15;28
625;03.04.2018;2018;04;10;Tiistai;11;3;14
625;03.04.2018;2018;04;11;Tiistai;12;4;16
625;03.04.2018;2018;04;12;Tiistai;2;1;3
625;03.04.2018;2018;04;13;Tiistai;3;10;13
625;03.04.2018;2018;04;14;Tiistai;0;10;10
625;03.04.2018;2018;04;15;Tiistai;11;17;28
625;03.04.2018;2018;04;16;Tiistai;5;16;21
625;03.04.2018;2018;04;17;Tiistai;6;13;19
625;03.04.2018;2018;04;18;Tiistai;10;10;20
625;03.04.2018;2018;04;19;Tiistai;2;6;8
625;03.04.2018;2018;04;20;Tiistai;4;3;7
625;03.04.2018;2018;04;21;Tiistai;2;5;7
625;03.04.2018;2018;04;22;Tiistai;1;0;1
625;03.04.2018;2018;04;23;Tiistai;0;0;0
625;04.04.2018;2018;04;00;Keskiviikko;0;0;0
625;04.04.2018;2018;04;01;Keskiviikko;0;0;0
625;04.04.2018;2018;04;02;Keskiviikko;0;0;0
625;04.04.2018;2018;04;03;Keskiviikko;0;1;1
625;04.04.2018;2018;04;04;Keskiviikko;0;0;0
625;04.04.2018;2018;04;05;Keskiviikko;0;0;0
625;04.04.2018;2018;04;06;Keskiviikko;1;0;1
625;04.04.2018;2018;04;07;Keskiviikko;8;4;12
625;04.04.2018;2018;04;08;Keskiviikko;15;14;29
625;04.04.2018;2018;04;09;Keskiviikko;11;11;22
625;04.04.2018;2018;04;10;Keskiviikko;4;4;8
625;04.04.2018;2018;04;11;Keskiviikko;4;2;6
625;04.04.2018;2018;04;12;Keskiviikko;3;7;10
625;04.04.2018;2018;04;13;Keskiviikko;7;16;23
625;04.04.2018;2018;04;14;Keskiviikko;5;12;17
625;04.04.2018;2018;04;15;Keskiviikko;7;15;22
625;04.04.2018;2018;04;16;Keskiviikko;2;24;26
625;04.04.2018;2018;04;17;Keskiviikko;8;18;26
625;04.04.2018;2018;04;18;Keskiviikko;3;7;10
625;04.04.2018;2018;04;19;Keskiviikko;5;6;11
625;04.04.2018;2018;04;20;Keskiviikko;2;5;7
625;04.04.2018;2018;04;21;Keskiviikko;3;4;7
625;04.04.2018;2018;04;22;Keskiviikko;3;0;3
625;04.04.2018;2018;04;23;Keskiviikko;3;0;3
625;05.04.2018;2018;04;00;Torstai;0;0;0
625;05.04.2018;2018;04;01;Torstai;0;0;0
625;05.04.2018;2018;04;02;Torstai;0;0;0
625;05.04.2018;2018;04;03;Torstai;0;0;0
625;05.04.2018;2018;04;04;Torstai;0;0;0
625;05.04.2018;2018;04;05;Torstai;1;0;1
625;05.04.2018;2018;04;06;Torstai;0;2;2
625;05.04.2018;2018;04;07;Torstai;8;4;12
625;05.04.2018;2018;04;08;Torstai;15;5;20
625;05.04.2018;2018;04;09;Torstai;11;12;23
625;05.04.2018;2018;04;10;Torstai;6;9;15
625;05.04.2018;2018;04;11;Torstai;5;3;8
625;05.04.2018;2018;04;12;Torstai;5;4;9
625;05.04.2018;2018;04;13;Torstai;5;17;22
625;05.04.2018;2018;04;14;Torstai;7;13;20
625;05.04.2018;2018;04;15;Torstai;7;15;22
625;05.04.2018;2018;04;16;Torstai;5;22;27
625;05.04.2018;2018;04;17;Torstai;12;17;29
625;05.04.2018;2018;04;18;Torstai;8;9;17
625;05.04.2018;2018;04;19;Torstai;2;3;5
625;05.04.2018;2018;04;20;Torstai;3;5;8
625;05.04.2018;2018;04;21;Torstai;2;0;2
625;05.04.2018;2018;04;22;Torstai;2;0;2
625;05.04.2018;2018;04;23;Torstai;3;0;3
625;06.04.2018;2018;04;00;Perjantai;1;1;2
625;06.04.2018;2018;04;01;Perjantai;1;0;1
625;06.04.2018;2018;04;02;Perjantai;0;0;0
625;06.04.2018;2018;04;03;Perjantai;0;0;0
625;06.04.2018;2018;04;04;Perjantai;0;0;0
625;06.04.2018;2018;04;05;Perjantai;0;0;0
625;06.04.2018;2018;04;06;Perjantai;0;0;0
625;06.04.2018;2018;04;07;Perjantai;6;2;8
625;06.04.2018;2018;04;08;Perjantai;18;7;25
625;06.04.2018;2018;04;09;Perjantai;12;10;22
625;06.04.2018;2018;04;10;Perjantai;9;9;18
625;06.04.2018;2018;04;11;Perjantai;7;2;9
625;06.04.2018;2018;04;12;Perjantai;5;8;13
625;06.04.2018;2018;04;13;Perjantai;10;14;24
625;06.04.2018;2018;04;14;Perjantai;7;15;22
625;06.04.2018;2018;04;15;Perjantai;3;12;15
625;06.04.2018;2018;04;16;Perjantai;5;13;18
625;06.04.2018;2018;04;17;Perjantai;3;8;11
625;06.04.2018;2018;04;18;Perjantai;4;5;9
625;06.04.2018;2018;04;19;Perjantai;2;3;5
625;06.04.2018;2018;04;20;Perjantai;1;5;6
625;06.04.2018;2018;04;21;Perjantai;2;3;5
625;06.04.2018;2018;04;22;Perjantai;1;3;4
625;06.04.2018;2018;04;23;Perjantai;0;1;1
625;07.04.2018;2018;04;00;Lauantai;0;1;1
625;07.04.2018;2018;04;01;Lauantai;0;0;0
625;07.04.2018;2018;04;02;Lauantai;0;0;0
625;07.04.2018;2018;04;03;Lauantai;0;0;0
625;07.04.2018;2018;04;04;Lauantai;0;0;0
625;07.04.2018;2018;04;05;Lauantai;0;0;0
625;07.04.2018;2018;04;06;Lauantai;1;0;1
625;07.04.2018;2018;04;07;Lauantai;2;2;4
625;07.04.2018;2018;04;08;Lauantai;0;3;3
625;07.04.2018;2018;04;09;Lauantai;0;1;1
625;07.04.2018;2018;04;10;Lauantai;3;4;7
625;07.04.2018;2018;04;11;Lauantai;0;3;3
625;07.04.2018;2018;04;12;Lauantai;2;5;7
625;07.04.2018;2018;04;13;Lauantai;3;6;9
625;07.04.2018;2018;04;14;Lauantai;2;3;5
625;07.04.2018;2018;04;15;Lauantai;2;5;7
625;07.04.2018;2018;04;16;Lauantai;3;0;3
625;07.04.2018;2018;04;17;Lauantai;1;0;1
625;07.04.2018;2018;04;18;Lauantai;3;2;5
625;07.04.2018;2018;04;19;Lauantai;1;2;3
625;07.04.2018;2018;04;20;Lauantai;1;4;5
625;07.04.2018;2018;04;21;Lauantai;0;2;2
625;07.04.2018;2018;04;22;Lauantai;1;2;3
625;07.04.2018;2018;04;23;Lauantai;2;1;3
625;08.04.2018;2018;04;00;Sunnuntai;1;0;1
625;08.04.2018;2018;04;01;Sunnuntai;1;0;1
625;08.04.2018;2018;04;02;Sunnuntai;0;0;0
625;08.04.2018;2018;04;03;Sunnuntai;0;0;0
625;08.04.2018;2018;04;04;Sunnuntai;1;0;1
625;08.04.2018;2018;04;05;Sunnuntai;0;0;0
625;08.04.2018;2018;04;06;Sunnuntai;0;0;0
625;08.04.2018;2018;04;07;Sunnuntai;0;0;0
625;08.04.2018;2018;04;08;Sunnuntai;0;1;1
625;08.04.2018;2018;04;09;Sunnuntai;0;0;0
625;08.04.2018;2018;04;10;Sunnuntai;3;1;4
625;08.04.2018;2018;04;11;Sunnuntai;2;2;4
625;08.04.2018;2018;04;12;Sunnuntai;3;4;7
625;08.04.2018;2018;04;13;Sunnuntai;4;3;7
625;08.04.2018;2018;04;14;Sunnuntai;3;4;7
625;08.04.2018;2018;04;15;Sunnuntai;7;6;13
625;08.04.2018;2018;04;16;Sunnuntai;3;4;7
625;08.04.2018;2018;04;17;Sunnuntai;2;4;6
625;08.04.2018;2018;04;18;Sunnuntai;6;4;10
625;08.04.2018;2018;04;19;Sunnuntai;2;6;8
625;08.04.2018;2018;04;20;Sunnuntai;5;0;5
625;08.04.2018;2018;04;21;Sunnuntai;5;6;11
625;08.04.2018;2018;04;22;Sunnuntai;3;4;7
625;08.04.2018;2018;04;23;Sunnuntai;2;1;3
625;09.04.2018;2018;04;00;Maanantai;0;1;1
625;09.04.2018;2018;04;01;Maanantai;0;0;0
625;09.04.2018;2018;04;02;Maanantai;0;0;0
625;09.04.2018;2018;04;03;Maanantai;1;0;1
625;09.04.2018;2018;04;04;Maanantai;0;0;0
625;09.04.2018;2018;04;05;Maanantai;1;0;1
625;09.04.2018;2018;04;06;Maanantai;0;1;1
625;09.04.2018;2018;04;07;Maanantai;8;5;13
625;09.04.2018;2018;04;08;Maanantai;28;11;39
625;09.04.2018;2018;04;09;Maanantai;19;5;24
625;09.04.2018;2018;04;10;Maanantai;5;8;13
625;09.04.2018;2018;04;11;Maanantai;8;4;12
625;09.04.2018;2018;04;12;Maanantai;2;2;4
625;09.04.2018;2018;04;13;Maanantai;5;8;13
625;09.04.2018;2018;04;14;Maanantai;4;6;10
625;09.04.2018;2018;04;15;Maanantai;11;23;34
625;09.04.2018;2018;04;16;Maanantai;10;18;28
625;09.04.2018;2018;04;17;Maanantai;7;15;22
625;09.04.2018;2018;04;18;Maanantai;7;11;18
625;09.04.2018;2018;04;19;Maanantai;3;10;13
625;09.04.2018;2018;04;20;Maanantai;1;2;3
625;09.04.2018;2018;04;21;Maanantai;1;5;6
625;09.04.2018;2018;04;22;Maanantai;1;2;3
625;09.04.2018;2018;04;23;Maanantai;0;0;0
625;10.04.2018;2018;04;00;Tiistai;0;1;1
625;10.04.2018;2018;04;01;Tiistai;0;0;0
625;10.04.2018;2018;04;02;Tiistai;0;0;0
625;10.04.2018;2018;04;03;Tiistai;0;0;0
625;10.04.2018;2018;04;04;Tiistai;0;0;0
625;10.04.2018;2018;04;05;Tiistai;1;0;1
625;10.04.2018;2018;04;06;Tiistai;2;2;4
625;10.04.2018;2018;04;07;Tiistai;2;2;4
625;10.04.2018;2018;04;08;Tiistai;18;10;28
625;10.04.2018;2018;04;09;Tiistai;24;15;39
625;10.04.2018;2018;04;10;Tiistai;21;11;32
625;10.04.2018;2018;04;11;Tiistai;14;2;16
625;10.04.2018;2018;04;12;Tiistai;5;6;11
625;10.04.2018;2018;04;13;Tiistai;7;12;19
625;10.04.2018;2018;04;14;Tiistai;5;19;24
625;10.04.2018;2018;04;15;Tiistai;8;18;26
625;10.04.2018;2018;04;16;Tiistai;5;17;22
625;10.04.2018;2018;04;17;Tiistai;6;12;18
625;10.04.2018;2018;04;18;Tiistai;9;12;21
625;10.04.2018;2018;04;19;Tiistai;3;6;9
625;10.04.2018;2018;04;20;Tiistai;1;5;6
625;10.04.2018;2018;04;21;Tiistai;0;5;5
625;10.04.2018;2018;04;22;Tiistai;2;1;3
625;10.04.2018;2018;04;23;Tiistai;0;0;0
625;11.04.2018;2018;04;00;Keskiviikko;0;1;1
625;11.04.2018;2018;04;01;Keskiviikko;1;0;1
625;11.04.2018;2018;04;02;Keskiviikko;0;0;0
625;11.04.2018;2018;04;03;Keskiviikko;0;0;0
625;11.04.2018;2018;04;04;Keskiviikko;0;0;0
625;11.04.2018;2018;04;05;Keskiviikko;2;0;2
625;11.04.2018;2018;04;06;Keskiviikko;2;1;3
625;11.04.2018;2018;04;07;Keskiviikko;9;4;13
625;11.04.2018;2018;04;08;Keskiviikko;36;12;48
625;11.04.2018;2018;04;09;Keskiviikko;12;15;27
625;11.04.2018;2018;04;10;Keskiviikko;12;6;18
625;11.04.2018;2018;04;11;Keskiviikko;7;3;10
625;11.04.2018;2018;04;12;Keskiviikko;9;7;16
625;11.04.2018;2018;04;13;Keskiviikko;9;6;15
625;11.04.2018;2018;04;14;Keskiviikko;13;21;34
625;11.04.2018;2018;04;15;Keskiviikko;8;23;31
625;11.04.2018;2018;04;16;Keskiviikko;11;24;35
625;11.04.2018;2018;04;17;Keskiviikko;14;20;34
625;11.04.2018;2018;04;18;Keskiviikko;18;14;32
625;11.04.2018;2018;04;19;Keskiviikko;10;4;14
625;11.04.2018;2018;04;20;Keskiviikko;1;12;13
625;11.04.2018;2018;04;21;Keskiviikko;2;1;3
625;11.04.2018;2018;04;22;Keskiviikko;4;2;6
625;11.04.2018;2018;04;23;Keskiviikko;2;0;2
625;12.04.2018;2018;04;00;Torstai;0;0;0
625;12.04.2018;2018;04;01;Torstai;1;0;1
625;12.04.2018;2018;04;02;Torstai;0;0;0
625;12.04.2018;2018;04;03;Torstai;0;0;0
625;12.04.2018;2018;04;04;Torstai;0;0;0
625;12.04.2018;2018;04;05;Torstai;2;1;3
625;12.04.2018;2018;04;06;Torstai;2;1;3
625;12.04.2018;2018;04;07;Torstai;8;3;11
625;12.04.2018;2018;04;08;Torstai;28;18;46
625;12.04.2018;2018;04;09;Torstai;19;15;34
625;12.04.2018;2018;04;10;Torstai;16;7;23
625;12.04.2018;2018;04;11;Torstai;5;1;6
625;12.04.2018;2018;04;12;Torstai;5;6;11
625;12.04.2018;2018;04;13;Torstai;11;19;30
625;12.04.2018;2018;04;14;Torstai;8;19;27
625;12.04.2018;2018;04;15;Torstai;1;18;19
625;12.04.2018;2018;04;16;Torstai;8;21;29
625;12.04.2018;2018;04;17;Torstai;9;11;20
625;12.04.2018;2018;04;18;Torstai;7;5;12
625;12.04.2018;2018;04;19;Torstai;5;9;14
625;12.04.2018;2018;04;20;Torstai;0;8;8
625;12.04.2018;2018;04;21;Torstai;4;6;10
625;12.04.2018;2018;04;22;Torstai;2;5;7
625;12.04.2018;2018;04;23;Torstai;0;0;0
625;13.04.2018;2018;04;00;Perjantai;1;0;1
625;13.04.2018;2018;04;01;Perjantai;1;0;1
625;13.04.2018;2018;04;02;Perjantai;1;0;1
625;13.04.2018;2018;04;03;Perjantai;0;0;0
625;13.04.2018;2018;04;04;Perjantai;0;0;0
625;13.04.2018;2018;04;05;Perjantai;1;0;1
625;13.04.2018;2018;04;06;Perjantai;1;2;3
625;13.04.2018;2018;04;07;Perjantai;4;1;5
625;13.04.2018;2018;04;08;Perjantai;31;14;45
625;13.04.2018;2018;04;09;Perjantai;14;8;22
625;13.04.2018;2018;04;10;Perjantai;10;11;21
625;13.04.2018;2018;04;11;Perjantai;5;1;6
625;13.04.2018;2018;04;12;Perjantai;7;13;20
625;13.04.2018;2018;04;13;Perjantai;9;20;29
625;13.04.2018;2018;04;14;Perjantai;7;13;20
625;13.04.2018;2018;04;15;Perjantai;9;18;27
625;13.04.2018;2018;04;16;Perjantai;6;19;25
625;13.04.2018;2018;04;17;Perjantai;10;12;22
625;13.04.2018;2018;04;18;Perjantai;6;8;14
625;13.04.2018;2018;04;19;Perjantai;5;9;14
625;13.04.2018;2018;04;20;Perjantai;1;8;9
625;13.04.2018;2018;04;21;Perjantai;7;9;16
625;13.04.2018;2018;04;22;Perjantai;2;1;3
625;13.04.2018;2018;04;23;Perjantai;2;1;3
625;14.04.2018;2018;04;00;Lauantai;1;0;1
625;14.04.2018;2018;04;01;Lauantai;4;1;5
625;14.04.2018;2018;04;02;Lauantai;0;0;0
625;14.04.2018;2018;04;03;Lauantai;1;0;1
625;14.04.2018;2018;04;04;Lauantai;0;0;0
625;14.04.2018;2018;04;05;Lauantai;0;1;1
625;14.04.2018;2018;04;06;Lauantai;0;0;0
625;14.04.2018;2018;04;07;Lauantai;1;3;4
625;14.04.2018;2018;04;08;Lauantai;0;0;0
625;14.04.2018;2018;04;09;Lauantai;1;1;2
625;14.04.2018;2018;04;10;Lauantai;1;2;3
625;14.04.2018;2018;04;11;Lauantai;4;1;5
625;14.04.2018;2018;04;12;Lauantai;3;7;10
625;14.04.2018;2018;04;13;Lauantai;6;4;10
625;14.04.2018;2018;04;14;Lauantai;9;12;21
625;14.04.2018;2018;04;15;Lauantai;8;12;20
625;14.04.2018;2018;04;16;Lauantai;3;4;7
625;14.04.2018;2018;04;17;Lauantai;3;12;15
625;14.04.2018;2018;04;18;Lauantai;3;9;12
625;14.04.2018;2018;04;19;Lauantai;1;5;6
625;14.04.2018;2018;04;20;Lauantai;4;4;8
625;14.04.2018;2018;04;21;Lauantai;3;6;9
625;14.04.2018;2018;04;22;Lauantai;3;1;4
625;14.04.2018;2018;04;23;Lauantai;1;2;3
625;15.04.2018;2018;04;00;Sunnuntai;1;0;1
625;15.04.2018;2018;04;01;Sunnuntai;0;1;1
625;15.04.2018;2018;04;02;Sunnuntai;1;0;1
625;15.04.2018;2018;04;03;Sunnuntai;0;0;0
625;15.04.2018;2018;04;04;Sunnuntai;0;1;1
625;15.04.2018;2018;04;05;Sunnuntai;0;0;0
625;15.04.2018;2018;04;06;Sunnuntai;0;2;2
625;15.04.2018;2018;04;07;Sunnuntai;1;3;4
625;15.04.2018;2018;04;08;Sunnuntai;0;0;0
625;15.04.2018;2018;04;09;Sunnuntai;3;2;5
625;15.04.2018;2018;04;10;Sunnuntai;4;3;7
625;15.04.2018;2018;04;11;Sunnuntai;6;2;8
625;15.04.2018;2018;04;12;Sunnuntai;6;8;14
625;15.04.2018;2018;04;13;Sunnuntai;1;16;17
625;15.04.2018;2018;04;14;Sunnuntai;10;11;21
625;15.04.2018;2018;04;15;Sunnuntai;11;11;22
625;15.04.2018;2018;04;16;Sunnuntai;16;16;32
625;15.04.2018;2018;04;17;Sunnuntai;9;8;17
625;15.04.2018;2018;04;18;Sunnuntai;9;8;17
625;15.04.2018;2018;04;19;Sunnuntai;11;15;26
625;15.04.2018;2018;04;20;Sunnuntai;9;3;12
625;15.04.2018;2018;04;21;Sunnuntai;2;2;4
625;15.04.2018;2018;04;22;Sunnuntai;1;4;5
625;15.04.2018;2018;04;23;Sunnuntai;1;0;1
625;16.04.2018;2018;04;00;Maanantai;0;0;0
625;16.04.2018;2018;04;01;Maanantai;0;0;0
625;16.04.2018;2018;04;02;Maanantai;0;1;1
625;16.04.2018;2018;04;03;Maanantai;0;0;0
625;16.04.2018;2018;04;04;Maanantai;0;0;0
625;16.04.2018;2018;04;05;Maanantai;0;0;0
625;16.04.2018;2018;04;06;Maanantai;2;3;5
625;16.04.2018;2018;04;07;Maanantai;11;6;17
625;16.04.2018;2018;04;08;Maanantai;47;18;65
625;16.04.2018;2018;04;09;Maanantai;31;21;52
625;16.04.2018;2018;04;10;Maanantai;12;4;16
625;16.04.2018;2018;04;11;Maanantai;9;6;15
625;16.04.2018;2018;04;12;Maanantai;8;17;25
625;16.04.2018;2018;04;13;Maanantai;11;16;27
625;16.04.2018;2018;04;14;Maanantai;11;18;29
625;16.04.2018;2018;04;15;Maanantai;11;27;38
625;16.04.2018;2018;04;16;Maanantai;13;38;51
625;16.04.2018;2018;04;17;Maanantai;14;25;39
625;16.04.2018;2018;04;18;Maanantai;15;10;25
625;16.04.2018;2018;04;19;Maanantai;4;7;11
625;16.04.2018;2018;04;20;Maanantai;8;3;11
625;16.04.2018;2018;04;21;Maanantai;5;3;8
625;16.04.2018;2018;04;22;Maanantai;2;4;6
625;16.04.2018;2018;04;23;Maanantai;1;0;1
625;17.04.2018;2018;04;00;Tiistai;0;0;0
625;17.04.2018;2018;04;01;Tiistai;0;0;0
625;17.04.2018;2018;04;02;Tiistai;0;1;1
625;17.04.2018;2018;04;03;Tiistai;0;0;0
625;17.04.2018;2018;04;04;Tiistai;0;0;0
625;17.04.2018;2018;04;05;Tiistai;1;0;1
625;17.04.2018;2018;04;06;Tiistai;1;0;1
625;17.04.2018;2018;04;07;Tiistai;12;3;15
625;17.04.2018;2018;04;08;Tiistai;43;18;61
625;17.04.2018;2018;04;09;Tiistai;32;17;49
625;17.04.2018;2018;04;10;Tiistai;22;9;31
625;17.04.2018;2018;04;11;Tiistai;12;2;14
625;17.04.2018;2018;04;12;Tiistai;11;12;23
625;17.04.2018;2018;04;13;Tiistai;5;9;14
625;17.04.2018;2018;04;14;Tiistai;6;23;29
625;17.04.2018;2018;04;15;Tiistai;11;25;36
625;17.04.2018;2018;04;16;Tiistai;11;27;38
625;17.04.2018;2018;04;17;Tiistai;20;26;46
625;17.04.2018;2018;04;18;Tiistai;7;9;16
625;17.04.2018;2018;04;19;Tiistai;11;13;24
625;17.04.2018;2018;04;20;Tiistai;3;7;10
625;17.04.2018;2018;04;21;Tiistai;1;5;6
625;17.04.2018;2018;04;22;Tiistai;1;3;4
625;17.04.2018;2018;04;23;Tiistai;1;1;2
625;18.04.2018;2018;04;00;Keskiviikko;0;0;0
625;18.04.2018;2018;04;01;Keskiviikko;1;0;1
625;18.04.2018;2018;04;02;Keskiviikko;0;0;0
625;18.04.2018;2018;04;03;Keskiviikko;0;0;0
625;18.04.2018;2018;04;04;Keskiviikko;0;0;0
625;18.04.2018;2018;04;05;Keskiviikko;1;0;1
625;18.04.2018;2018;04;06;Keskiviikko;2;0;2
625;18.04.2018;2018;04;07;Keskiviikko;5;6;11
625;18.04.2018;2018;04;08;Keskiviikko;44;20;64
625;18.04.2018;2018;04;09;Keskiviikko;31;18;49
625;18.04.2018;2018;04;10;Keskiviikko;11;12;23
625;18.04.2018;2018;04;11;Keskiviikko;14;5;19
625;18.04.2018;2018;04;12;Keskiviikko;14;11;25
625;18.04.2018;2018;04;13;Keskiviikko;13;16;29
625;18.04.2018;2018;04;14;Keskiviikko;11;25;36
625;18.04.2018;2018;04;15;Keskiviikko;10;39;49
625;18.04.2018;2018;04;16;Keskiviikko;15;38;53
625;18.04.2018;2018;04;17;Keskiviikko;18;29;47
625;18.04.2018;2018;04;18;Keskiviikko;22;15;37
625;18.04.2018;2018;04;19;Keskiviikko;8;14;22
625;18.04.2018;2018;04;20;Keskiviikko;4;9;13
625;18.04.2018;2018;04;21;Keskiviikko;4;7;11
625;18.04.2018;2018;04;22;Keskiviikko;1;5;6
625;18.04.2018;2018;04;23;Keskiviikko;5;2;7
625;19.04.2018;2018;04;00;Torstai;2;0;2
625;19.04.2018;2018;04;01;Torstai;0;1;1
625;19.04.2018;2018;04;02;Torstai;0;0;0
625;19.04.2018;2018;04;03;Torstai;0;0;0
625;19.04.2018;2018;04;04;Torstai;0;0;0
625;19.04.2018;2018;04;05;Torstai;1;1;2
625;19.04.2018;2018;04;06;Torstai;5;1;6
625;19.04.2018;2018;04;07;Torstai;10;10;20
625;19.04.2018;2018;04;08;Torstai;45;15;60
625;19.04.2018;2018;04;09;Torstai;39;19;58
625;19.04.2018;2018;04;10;Torstai;22;7;29
625;19.04.2018;2018;04;11;Torstai;10;4;14
625;19.04.2018;2018;04;12;Torstai;13;3;16
625;19.04.2018;2018;04;13;Torstai;21;33;54
625;19.04.2018;2018;04;14;Torstai;17;15;32
625;19.04.2018;2018;04;15;Torstai;16;30;46
625;19.04.2018;2018;04;16;Torstai;21;43;64
625;19.04.2018;2018;04;17;Torstai;31;42;73
625;19.04.2018;2018;04;18;Torstai;20;20;40
625;19.04.2018;2018;04;19;Torstai;18;14;32
625;19.04.2018;2018;04;20;Torstai;9;15;24
625;19.04.2018;2018;04;21;Torstai;4;2;6
625;19.04.2018;2018;04;22;Torstai;3;6;9
625;19.04.2018;2018;04;23;Torstai;0;2;2
625;20.04.2018;2018;04;00;Perjantai;3;2;5
625;20.04.2018;2018;04;01;Perjantai;0;0;0
625;20.04.2018;2018;04;02;Perjantai;0;1;1
625;20.04.2018;2018;04;03;Perjantai;0;1;1
625;20.04.2018;2018;04;04;Perjantai;0;0;0
625;20.04.2018;2018;04;05;Perjantai;1;0;1
625;20.04.2018;2018;04;06;Perjantai;2;4;6
625;20.04.2018;2018;04;07;Perjantai;8;6;14
625;20.04.2018;2018;04;08;Perjantai;48;13;61
625;20.04.2018;2018;04;09;Perjantai;15;11;26
625;20.04.2018;2018;04;10;Perjantai;8;4;12
625;20.04.2018;2018;04;11;Perjantai;7;3;10
625;20.04.2018;2018;04;12;Perjantai;1;6;7
625;20.04.2018;2018;04;13;Perjantai;8;13;21
625;20.04.2018;2018;04;14;Perjantai;8;30;38
625;20.04.2018;2018;04;15;Perjantai;10;23;33
625;20.04.2018;2018;04;16;Perjantai;9;13;22
625;20.04.2018;2018;04;17;Perjantai;12;9;21
625;20.04.2018;2018;04;18;Perjantai;3;12;15
625;20.04.2018;2018;04;19;Perjantai;15;15;30
625;20.04.2018;2018;04;20;Perjantai;9;9;18
625;20.04.2018;2018;04;21;Perjantai;3;2;5
625;20.04.2018;2018;04;22;Perjantai;4;3;7
625;20.04.2018;2018;04;23;Perjantai;0;0;0
625;21.04.2018;2018;04;00;Lauantai;0;0;0
625;21.04.2018;2018;04;01;Lauantai;1;1;2
625;21.04.2018;2018;04;02;Lauantai;0;1;1
625;21.04.2018;2018;04;03;Lauantai;1;0;1
625;21.04.2018;2018;04;04;Lauantai;0;0;0
625;21.04.2018;2018;04;05;Lauantai;0;0;0
625;21.04.2018;2018;04;06;Lauantai;1;2;3
625;21.04.2018;2018;04;07;Lauantai;0;0;0
625;21.04.2018;2018;04;08;Lauantai;2;1;3
625;21.04.2018;2018;04;09;Lauantai;4;1;5
625;21.04.2018;2018;04;10;Lauantai;6;4;10
625;21.04.2018;2018;04;11;Lauantai;4;4;8
625;21.04.2018;2018;04;12;Lauantai;8;3;11
625;21.04.2018;2018;04;13;Lauantai;9;7;16
625;21.04.2018;2018;04;14;Lauantai;8;8;16
625;21.04.2018;2018;04;15;Lauantai;10;7;17
625;21.04.2018;2018;04;16;Lauantai;6;8;14
625;21.04.2018;2018;04;17;Lauantai;8;5;13
625;21.04.2018;2018;04;18;Lauantai;1;11;12
625;21.04.2018;2018;04;19;Lauantai;6;6;12
625;21.04.2018;2018;04;20;Lauantai;5;5;10
625;21.04.2018;2018;04;21;Lauantai;6;3;9
625;21.04.2018;2018;04;22;Lauantai;8;6;14
625;21.04.2018;2018;04;23;Lauantai;2;1;3
625;22.04.2018;2018;04;00;Sunnuntai;3;1;4
625;22.04.2018;2018;04;01;Sunnuntai;2;0;2
625;22.04.2018;2018;04;02;Sunnuntai;2;2;4
625;22.04.2018;2018;04;03;Sunnuntai;0;1;1
625;22.04.2018;2018;04;04;Sunnuntai;0;0;0
625;22.04.2018;2018;04;05;Sunnuntai;0;1;1
625;22.04.2018;2018;04;06;Sunnuntai;0;0;0
625;22.04.2018;2018;04;07;Sunnuntai;0;1;1
625;22.04.2018;2018;04;08;Sunnuntai;0;2;2
625;22.04.2018;2018;04;09;Sunnuntai;2;2;4
625;22.04.2018;2018;04;10;Sunnuntai;0;4;4
625;22.04.2018;2018;04;11;Sunnuntai;6;7;13
625;22.04.2018;2018;04;12;Sunnuntai;7;3;10
625;22.04.2018;2018;04;13;Sunnuntai;12;15;27
625;22.04.2018;2018;04;14;Sunnuntai;15;13;28
625;22.04.2018;2018;04;15;Sunnuntai;9;16;25
625;22.04.2018;2018;04;16;Sunnuntai;14;13;27
625;22.04.2018;2018;04;17;Sunnuntai;10;12;22
625;22.04.2018;2018;04;18;Sunnuntai;11;15;26
625;22.04.2018;2018;04;19;Sunnuntai;9;11;20
625;22.04.2018;2018;04;20;Sunnuntai;13;10;23
625;22.04.2018;2018;04;21;Sunnuntai;2;7;9
625;22.04.2018;2018;04;22;Sunnuntai;2;1;3
625;22.04.2018;2018;04;23;Sunnuntai;1;1;2
625;23.04.2018;2018;04;00;Maanantai;0;0;0
625;23.04.2018;2018;04;01;Maanantai;0;0;0
625;23.04.2018;2018;04;02;Maanantai;0;0;0
625;23.04.2018;2018;04;03;Maanantai;1;0;1
625;23.04.2018;2018;04;04;Maanantai;1;0;1
625;23.04.2018;2018;04;05;Maanantai;1;1;2
625;23.04.2018;2018;04;06;Maanantai;3;3;6
625;23.04.2018;2018;04;07;Maanantai;17;9;26
625;23.04.2018;2018;04;08;Maanantai;65;32;97
625;23.04.2018;2018;04;09;Maanantai;44;24;68
625;23.04.2018;2018;04;10;Maanantai;9;7;16
625;23.04.2018;2018;04;11;Maanantai;11;4;15
625;23.04.2018;2018;04;12;Maanantai;2;9;11
625;23.04.2018;2018;04;13;Maanantai;23;18;41
625;23.04.2018;2018;04;14;Maanantai;12;22;34
625;23.04.2018;2018;04;15;Maanantai;15;27;42
625;23.04.2018;2018;04;16;Maanantai;25;45;70
625;23.04.2018;2018;04;17;Maanantai;25;34;59
625;23.04.2018;2018;04;18;Maanantai;23;21;44
625;23.04.2018;2018;04;19;Maanantai;15;21;36
625;23.04.2018;2018;04;20;Maanantai;16;7;23
625;23.04.2018;2018;04;21;Maanantai;6;7;13
625;23.04.2018;2018;04;22;Maanantai;7;5;12
625;23.04.2018;2018;04;23;Maanantai;3;2;5
625;24.04.2018;2018;04;00;Tiistai;0;0;0
625;24.04.2018;2018;04;01;Tiistai;0;1;1
625;24.04.2018;2018;04;02;Tiistai;0;2;2
625;24.04.2018;2018;04;03;Tiistai;0;0;0
625;24.04.2018;2018;04;04;Tiistai;0;0;0
625;24.04.2018;2018;04;05;Tiistai;1;0;1
625;24.04.2018;2018;04;06;Tiistai;2;1;3
625;24.04.2018;2018;04;07;Tiistai;14;7;21
625;24.04.2018;2018;04;08;Tiistai;45;23;68
625;24.04.2018;2018;04;09;Tiistai;33;15;48
625;24.04.2018;2018;04;10;Tiistai;15;9;24
625;24.04.2018;2018;04;11;Tiistai;0;0;0
625;24.04.2018;2018;04;12;Tiistai;31;22;53
625;24.04.2018;2018;04;13;Tiistai;8;11;19
625;24.04.2018;2018;04;14;Tiistai;11;34;45
625;24.04.2018;2018;04;15;Tiistai;10;38;48
625;24.04.2018;2018;04;16;Tiistai;14;23;37
625;24.04.2018;2018;04;17;Tiistai;21;37;58
625;24.04.2018;2018;04;18;Tiistai;10;10;20
625;24.04.2018;2018;04;19;Tiistai;8;6;14
625;24.04.2018;2018;04;20;Tiistai;4;12;16
625;24.04.2018;2018;04;21;Tiistai;1;3;4
625;24.04.2018;2018;04;22;Tiistai;2;2;4
625;24.04.2018;2018;04;23;Tiistai;3;0;3
625;25.04.2018;2018;04;00;Keskiviikko;0;0;0
625;25.04.2018;2018;04;01;Keskiviikko;0;0;0
625;25.04.2018;2018;04;02;Keskiviikko;0;0;0
625;25.04.2018;2018;04;03;Keskiviikko;0;0;0
625;25.04.2018;2018;04;04;Keskiviikko;0;1;1
625;25.04.2018;2018;04;05;Keskiviikko;1;1;2
625;25.04.2018;2018;04;06;Keskiviikko;6;5;11
625;25.04.2018;2018;04;07;Keskiviikko;19;6;25
625;25.04.2018;2018;04;08;Keskiviikko;69;32;101
625;25.04.2018;2018;04;09;Keskiviikko;16;18;34
625;25.04.2018;2018;04;10;Keskiviikko;11;9;20
625;25.04.2018;2018;04;11;Keskiviikko;17;18;35
625;25.04.2018;2018;04;12;Keskiviikko;8;5;13
625;25.04.2018;2018;04;13;Keskiviikko;13;13;26
625;25.04.2018;2018;04;14;Keskiviikko;26;33;59
625;25.04.2018;2018;04;15;Keskiviikko;16;26;42
625;25.04.2018;2018;04;16;Keskiviikko;12;37;49
625;25.04.2018;2018;04;17;Keskiviikko;27;42;69
625;25.04.2018;2018;04;18;Keskiviikko;17;10;27
625;25.04.2018;2018;04;19;Keskiviikko;13;17;30
625;25.04.2018;2018;04;20;Keskiviikko;8;9;17
625;25.04.2018;2018;04;21;Keskiviikko;4;3;7
625;25.04.2018;2018;04;22;Keskiviikko;3;6;9
625;25.04.2018;2018;04;23;Keskiviikko;5;0;5
625;26.04.2018;2018;04;00;Torstai;3;0;3
625;26.04.2018;2018;04;01;Torstai;0;1;1
625;26.04.2018;2018;04;02;Torstai;0;0;0
625;26.04.2018;2018;04;03;Torstai;0;0;0
625;26.04.2018;2018;04;04;Torstai;0;0;0
625;26.04.2018;2018;04;05;Torstai;1;0;1
625;26.04.2018;2018;04;06;Torstai;6;4;10
625;26.04.2018;2018;04;07;Torstai;17;6;23
625;26.04.2018;2018;04;08;Torstai;60;32;92
625;26.04.2018;2018;04;09;Torstai;29;17;46
625;26.04.2018;2018;04;10;Torstai;30;9;39
625;26.04.2018;2018;04;11;Torstai;8;6;14
625;26.04.2018;2018;04;12;Torstai;13;14;27
625;26.04.2018;2018;04;13;Torstai;10;14;24
625;26.04.2018;2018;04;14;Torstai;7;14;21
625;26.04.2018;2018;04;15;Torstai;21;38;59
625;26.04.2018;2018;04;16;Torstai;14;27;41
625;26.04.2018;2018;04;17;Torstai;28;30;58
625;26.04.2018;2018;04;18;Torstai;17;16;33
625;26.04.2018;2018;04;19;Torstai;10;15;25
625;26.04.2018;2018;04;20;Torstai;11;11;22
625;26.04.2018;2018;04;21;Torstai;7;4;11
625;26.04.2018;2018;04;22;Torstai;3;2;5
625;26.04.2018;2018;04;23;Torstai;3;1;4
625;27.04.2018;2018;04;00;Perjantai;1;0;1
625;27.04.2018;2018;04;01;Perjantai;1;0;1
625;27.04.2018;2018;04;02;Perjantai;0;0;0
625;27.04.2018;2018;04;03;Perjantai;0;0;0
625;27.04.2018;2018;04;04;Perjantai;0;0;0
625;27.04.2018;2018;04;05;Perjantai;0;1;1
625;27.04.2018;2018;04;06;Perjantai;2;4;6
625;27.04.2018;2018;04;07;Perjantai;15;4;19
625;27.04.2018;2018;04;08;Perjantai;52;21;73
625;27.04.2018;2018;04;09;Perjantai;19;13;32
625;27.04.2018;2018;04;10;Perjantai;16;9;25
625;27.04.2018;2018;04;11;Perjantai;9;8;17
625;27.04.2018;2018;04;12;Perjantai;9;9;18
625;27.04.2018;2018;04;13;Perjantai;22;30;52
625;27.04.2018;2018;04;14;Perjantai;17;29;46
625;27.04.2018;2018;04;15;Perjantai;9;16;25
625;27.04.2018;2018;04;16;Perjantai;13;26;39
625;27.04.2018;2018;04;17;Perjantai;22;29;51
625;27.04.2018;2018;04;18;Perjantai;10;22;32
625;27.04.2018;2018;04;19;Perjantai;14;16;30
625;27.04.2018;2018;04;20;Perjantai;9;14;23
625;27.04.2018;2018;04;21;Perjantai;3;8;11
625;27.04.2018;2018;04;22;Perjantai;5;0;5
625;27.04.2018;2018;04;23;Perjantai;1;1;2
625;28.04.2018;2018;04;00;Lauantai;1;1;2
625;28.04.2018;2018;04;01;Lauantai;1;0;1
625;28.04.2018;2018;04;02;Lauantai;1;1;2
625;28.04.2018;2018;04;03;Lauantai;0;0;0
625;28.04.2018;2018;04;04;Lauantai;0;0;0
625;28.04.2018;2018;04;05;Lauantai;0;0;0
625;28.04.2018;2018;04;06;Lauantai;1;1;2
625;28.04.2018;2018;04;07;Lauantai;2;1;3
625;28.04.2018;2018;04;08;Lauantai;2;1;3
625;28.04.2018;2018;04;09;Lauantai;1;2;3
625;28.04.2018;2018;04;10;Lauantai;6;3;9
625;28.04.2018;2018;04;11;Lauantai;8;8;16
625;28.04.2018;2018;04;12;Lauantai;2;9;11
625;28.04.2018;2018;04;13;Lauantai;14;13;27
625;28.04.2018;2018;04;14;Lauantai;12;20;32
625;28.04.2018;2018;04;15;Lauantai;7;16;23
625;28.04.2018;2018;04;16;Lauantai;11;19;30
625;28.04.2018;2018;04;17;Lauantai;10;13;23
625;28.04.2018;2018;04;18;Lauantai;14;18;32
625;28.04.2018;2018;04;19;Lauantai;12;14;26
625;28.04.2018;2018;04;20;Lauantai;8;5;13
625;28.04.2018;2018;04;21;Lauantai;6;5;11
625;28.04.2018;2018;04;22;Lauantai;1;5;6
625;28.04.2018;2018;04;23;Lauantai;3;3;6
625;29.04.2018;2018;04;00;Sunnuntai;3;3;6
625;29.04.2018;2018;04;01;Sunnuntai;0;0;0
625;29.04.2018;2018;04;02;Sunnuntai;2;0;2
625;29.04.2018;2018;04;03;Sunnuntai;1;0;1
625;29.04.2018;2018;04;04;Sunnuntai;1;1;2
625;29.04.2018;2018;04;05;Sunnuntai;0;0;0
625;29.04.2018;2018;04;06;Sunnuntai;0;1;1
625;29.04.2018;2018;04;07;Sunnuntai;4;0;4
625;29.04.2018;2018;04;08;Sunnuntai;3;0;3
625;29.04.2018;2018;04;09;Sunnuntai;2;1;3
625;29.04.2018;2018;04;10;Sunnuntai;1;3;4
625;29.04.2018;2018;04;11;Sunnuntai;4;6;10
625;29.04.2018;2018;04;12;Sunnuntai;8;7;15
625;29.04.2018;2018;04;13;Sunnuntai;11;11;22
625;29.04.2018;2018;04;14;Sunnuntai;14;13;27
625;29.04.2018;2018;04;15;Sunnuntai;12;14;26
625;29.04.2018;2018;04;16;Sunnuntai;11;12;23
625;29.04.2018;2018;04;17;Sunnuntai;14;7;21
625;29.04.2018;2018;04;18;Sunnuntai;8;10;18
625;29.04.2018;2018;04;19;Sunnuntai;10;17;27
625;29.04.2018;2018;04;20;Sunnuntai;13;14;27
625;29.04.2018;2018;04;21;Sunnuntai;6;9;15
625;29.04.2018;2018;04;22;Sunnuntai;3;7;10
625;29.04.2018;2018;04;23;Sunnuntai;4;5;9
625;30.04.2018;2018;04;00;Maanantai;2;1;3
625;30.04.2018;2018;04;01;Maanantai;2;1;3
625;30.04.2018;2018;04;02;Maanantai;0;0;0
625;30.04.2018;2018;04;03;Maanantai;0;0;0
625;30.04.2018;2018;04;04;Maanantai;0;0;0
625;30.04.2018;2018;04;05;Maanantai;2;1;3
625;30.04.2018;2018;04;06;Maanantai;5;5;10
625;30.04.2018;2018;04;07;Maanantai;9;1;10
625;30.04.2018;2018;04;08;Maanantai;21;14;35
625;30.04.2018;2018;04;09;Maanantai;4;12;16
625;30.04.2018;2018;04;10;Maanantai;7;12;19
625;30.04.2018;2018;04;11;Maanantai;5;9;14
625;30.04.2018;2018;04;12;Maanantai;13;10;23
625;30.04.2018;2018;04;13;Maanantai;9;14;23
625;30.04.2018;2018;04;14;Maanantai;11;18;29
625;30.04.2018;2018;04;15;Maanantai;14;13;27
625;30.04.2018;2018;04;16;Maanantai;17;21;38
625;30.04.2018;2018;04;17;Maanantai;29;19;48
625;30.04.2018;2018;04;18;Maanantai;15;15;30
625;30.04.2018;2018;04;19;Maanantai;4;8;12
625;30.04.2018;2018;04;20;Maanantai;3;4;7
625;30.04.2018;2018;04;21;Maanantai;2;7;9
625;30.04.2018;2018;04;22;Maanantai;5;3;8
625;30.04.2018;2018;04;23;Maanantai;3;3;6
625;01.05.2018;2018;05;00;Tiistai;1;1;2
625;01.05.2018;2018;05;01;Tiistai;3;3;6
625;01.05.2018;2018;05;02;Tiistai;0;0;0
625;01.05.2018;2018;05;03;Tiistai;0;2;2
625;01.05.2018;2018;05;04;Tiistai;1;2;3
625;01.05.2018;2018;05;05;Tiistai;0;0;0
625;01.05.2018;2018;05;06;Tiistai;1;1;2
625;01.05.2018;2018;05;07;Tiistai;0;2;2
625;01.05.2018;2018;05;08;Tiistai;1;4;5
625;01.05.2018;2018;05;09;Tiistai;0;2;2
625;01.05.2018;2018;05;10;Tiistai;5;5;10
625;01.05.2018;2018;05;11;Tiistai;0;5;5
625;01.05.2018;2018;05;12;Tiistai;10;12;22
625;01.05.2018;2018;05;13;Tiistai;9;3;12
625;01.05.2018;2018;05;14;Tiistai;16;16;32
625;01.05.2018;2018;05;15;Tiistai;8;2;10
625;01.05.2018;2018;05;16;Tiistai;18;16;34
625;01.05.2018;2018;05;17;Tiistai;5;3;8
625;01.05.2018;2018;05;18;Tiistai;7;3;10
625;01.05.2018;2018;05;19;Tiistai;6;7;13
625;01.05.2018;2018;05;20;Tiistai;2;9;11
625;01.05.2018;2018;05;21;Tiistai;8;5;13
625;01.05.2018;2018;05;22;Tiistai;5;7;12
625;01.05.2018;2018;05;23;Tiistai;3;2;5
625;02.05.2018;2018;05;00;Keskiviikko;1;0;1
625;02.05.2018;2018;05;01;Keskiviikko;0;0;0
625;02.05.2018;2018;05;02;Keskiviikko;0;0;0
625;02.05.2018;2018;05;03;Keskiviikko;0;0;0
625;02.05.2018;2018;05;04;Keskiviikko;0;1;1
625;02.05.2018;2018;05;05;Keskiviikko;1;0;1
625;02.05.2018;2018;05;06;Keskiviikko;2;4;6
625;02.05.2018;2018;05;07;Keskiviikko;10;6;16
625;02.05.2018;2018;05;08;Keskiviikko;72;32;104
625;02.05.2018;2018;05;09;Keskiviikko;22;15;37
625;02.05.2018;2018;05;10;Keskiviikko;9;4;13
625;02.05.2018;2018;05;11;Keskiviikko;15;7;22
625;02.05.2018;2018;05;12;Keskiviikko;10;10;20
625;02.05.2018;2018;05;13;Keskiviikko;18;14;32
625;02.05.2018;2018;05;14;Keskiviikko;12;23;35
625;02.05.2018;2018;05;15;Keskiviikko;8;26;34
625;02.05.2018;2018;05;16;Keskiviikko;11;26;37
625;02.05.2018;2018;05;17;Keskiviikko;18;24;42
625;02.05.2018;2018;05;18;Keskiviikko;11;12;23
625;02.05.2018;2018;05;19;Keskiviikko;6;10;16
625;02.05.2018;2018;05;20;Keskiviikko;4;4;8
625;02.05.2018;2018;05;21;Keskiviikko;4;4;8
625;02.05.2018;2018;05;22;Keskiviikko;5;3;8
625;02.05.2018;2018;05;23;Keskiviikko;2;2;4
625;03.05.2018;2018;05;00;Torstai;1;0;1
625;03.05.2018;2018;05;01;Torstai;0;1;1
625;03.05.2018;2018;05;02;Torstai;0;0;0
625;03.05.2018;2018;05;03;Torstai;0;0;0
625;03.05.2018;2018;05;04;Torstai;0;0;0
625;03.05.2018;2018;05;05;Torstai;1;0;1
625;03.05.2018;2018;05;06;Torstai;5;2;7
625;03.05.2018;2018;05;07;Torstai;11;10;21
625;03.05.2018;2018;05;08;Torstai;54;21;75
625;03.05.2018;2018;05;09;Torstai;32;21;53
625;03.05.2018;2018;05;10;Torstai;19;7;26
625;03.05.2018;2018;05;11;Torstai;10;4;14
625;03.05.2018;2018;05;12;Torstai;8;11;19
625;03.05.2018;2018;05;13;Torstai;9;25;34
625;03.05.2018;2018;05;14;Torstai;10;22;32
625;03.05.2018;2018;05;15;Torstai;7;24;31
625;03.05.2018;2018;05;16;Torstai;20;37;57
625;03.05.2018;2018;05;17;Torstai;20;36;56
625;03.05.2018;2018;05;18;Torstai;14;26;40
625;03.05.2018;2018;05;19;Torstai;15;7;22
625;03.05.2018;2018;05;20;Torstai;4;12;16
625;03.05.2018;2018;05;21;Torstai;4;6;10
625;03.05.2018;2018;05;22;Torstai;3;4;7
625;03.05.2018;2018;05;23;Torstai;0;3;3
625;04.05.2018;2018;05;00;Perjantai;0;0;0
625;04.05.2018;2018;05;01;Perjantai;0;0;0
625;04.05.2018;2018;05;02;Perjantai;0;0;0
625;04.05.2018;2018;05;03;Perjantai;0;0;0
625;04.05.2018;2018;05;04;Perjantai;0;0;0
625;04.05.2018;2018;05;05;Perjantai;1;0;1
625;04.05.2018;2018;05;06;Perjantai;3;5;8
625;04.05.2018;2018;05;07;Perjantai;8;7;15
625;04.05.2018;2018;05;08;Perjantai;45;20;65
625;04.05.2018;2018;05;09;Perjantai;20;14;34
625;04.05.2018;2018;05;10;Perjantai;12;7;19
625;04.05.2018;2018;05;11;Perjantai;3;4;7
625;04.05.2018;2018;05;12;Perjantai;6;9;15
625;04.05.2018;2018;05;13;Perjantai;5;11;16
625;04.05.2018;2018;05;14;Perjantai;6;20;26
625;04.05.2018;2018;05;15;Perjantai;12;14;26
625;04.05.2018;2018;05;16;Perjantai;10;17;27
625;04.05.2018;2018;05;17;Perjantai;4;11;15
625;04.05.2018;2018;05;18;Perjantai;6;14;20
625;04.05.2018;2018;05;19;Perjantai;5;7;12
625;04.05.2018;2018;05;20;Perjantai;3;3;6
625;04.05.2018;2018;05;21;Perjantai;7;3;10
625;04.05.2018;2018;05;22;Perjantai;2;2;4
625;04.05.2018;2018;05;23;Perjantai;1;2;3
625;05.05.2018;2018;05;00;Lauantai;0;1;1
625;05.05.2018;2018;05;01;Lauantai;2;0;2
625;05.05.2018;2018;05;02;Lauantai;0;0;0
625;05.05.2018;2018;05;03;Lauantai;1;0;1
625;05.05.2018;2018;05;04;Lauantai;1;1;2
625;05.05.2018;2018;05;05;Lauantai;0;0;0
625;05.05.2018;2018;05;06;Lauantai;0;1;1
625;05.05.2018;2018;05;07;Lauantai;1;3;4
625;05.05.2018;2018;05;08;Lauantai;0;0;0
625;05.05.2018;2018;05;09;Lauantai;2;0;2
625;05.05.2018;2018;05;10;Lauantai;4;7;11
625;05.05.2018;2018;05;11;Lauantai;12;7;19
625;05.05.2018;2018;05;12;Lauantai;4;4;8
625;05.05.2018;2018;05;13;Lauantai;8;14;22
625;05.05.2018;2018;05;14;Lauantai;12;13;25
625;05.05.2018;2018;05;15;Lauantai;12;16;28
625;05.05.2018;2018;05;16;Lauantai;12;13;25
625;05.05.2018;2018;05;17;Lauantai;16;20;36
625;05.05.2018;2018;05;18;Lauantai;6;10;16
625;05.05.2018;2018;05;19;Lauantai;11;13;24
625;05.05.2018;2018;05;20;Lauantai;11;9;20
625;05.05.2018;2018;05;21;Lauantai;9;8;17
625;05.05.2018;2018;05;22;Lauantai;3;4;7
625;05.05.2018;2018;05;23;Lauantai;5;2;7
625;06.05.2018;2018;05;00;Sunnuntai;2;1;3
625;06.05.2018;2018;05;01;Sunnuntai;0;1;1
625;06.05.2018;2018;05;02;Sunnuntai;3;3;6
625;06.05.2018;2018;05;03;Sunnuntai;0;0;0
625;06.05.2018;2018;05;04;Sunnuntai;0;1;1
625;06.05.2018;2018;05;05;Sunnuntai;1;0;1
625;06.05.2018;2018;05;06;Sunnuntai;0;0;0
625;06.05.2018;2018;05;07;Sunnuntai;1;2;3
625;06.05.2018;2018;05;08;Sunnuntai;1;0;1
625;06.05.2018;2018;05;09;Sunnuntai;2;5;7
625;06.05.2018;2018;05;10;Sunnuntai;9;6;15
625;06.05.2018;2018;05;11;Sunnuntai;6;11;17
625;06.05.2018;2018;05;12;Sunnuntai;11;11;22
625;06.05.2018;2018;05;13;Sunnuntai;18;22;40
625;06.05.2018;2018;05;14;Sunnuntai;15;20;35
625;06.05.2018;2018;05;15;Sunnuntai;4;15;19
625;06.05.2018;2018;05;16;Sunnuntai;14;16;30
625;06.05.2018;2018;05;17;Sunnuntai;11;15;26
625;06.05.2018;2018;05;18;Sunnuntai;17;13;30
625;06.05.2018;2018;05;19;Sunnuntai;12;11;23
625;06.05.2018;2018;05;20;Sunnuntai;18;15;33
625;06.05.2018;2018;05;21;Sunnuntai;10;11;21
625;06.05.2018;2018;05;22;Sunnuntai;1;4;5
625;06.05.2018;2018;05;23;Sunnuntai;1;1;2
625;07.05.2018;2018;05;00;Maanantai;3;0;3
625;07.05.2018;2018;05;01;Maanantai;0;1;1
625;07.05.2018;2018;05;02;Maanantai;0;0;0
625;07.05.2018;2018;05;03;Maanantai;1;0;1
625;07.05.2018;2018;05;04;Maanantai;0;0;0
625;07.05.2018;2018;05;05;Maanantai;2;0;2
625;07.05.2018;2018;05;06;Maanantai;4;2;6
625;07.05.2018;2018;05;07;Maanantai;17;10;27
625;07.05.2018;2018;05;08;Maanantai;55;25;80
625;07.05.2018;2018;05;09;Maanantai;25;16;41
625;07.05.2018;2018;05;10;Maanantai;17;10;27
625;07.05.2018;2018;05;11;Maanantai;6;5;11
625;07.05.2018;2018;05;12;Maanantai;6;8;14
625;07.05.2018;2018;05;13;Maanantai;19;19;38
625;07.05.2018;2018;05;14;Maanantai;6;17;23
625;07.05.2018;2018;05;15;Maanantai;14;30;44
625;07.05.2018;2018;05;16;Maanantai;19;41;60
625;07.05.2018;2018;05;17;Maanantai;20;32;52
625;07.05.2018;2018;05;18;Maanantai;15;10;25
625;07.05.2018;2018;05;19;Maanantai;8;6;14
625;07.05.2018;2018;05;20;Maanantai;12;7;19
625;07.05.2018;2018;05;21;Maanantai;6;13;19
625;07.05.2018;2018;05;22;Maanantai;4;11;15
625;07.05.2018;2018;05;23;Maanantai;4;1;5
625;08.05.2018;2018;05;00;Tiistai;3;0;3
625;08.05.2018;2018;05;01;Tiistai;0;0;0
625;08.05.2018;2018;05;02;Tiistai;0;0;0
625;08.05.2018;2018;05;03;Tiistai;0;0;0
625;08.05.2018;2018;05;04;Tiistai;0;0;0
625;08.05.2018;2018;05;05;Tiistai;2;0;2
625;08.05.2018;2018;05;06;Tiistai;3;3;6
625;08.05.2018;2018;05;07;Tiistai;15;10;25
625;08.05.2018;2018;05;08;Tiistai;56;37;93
625;08.05.2018;2018;05;09;Tiistai;47;31;78
625;08.05.2018;2018;05;10;Tiistai;31;12;43
625;08.05.2018;2018;05;11;Tiistai;9;11;20
625;08.05.2018;2018;05;12;Tiistai;13;11;24
625;08.05.2018;2018;05;13;Tiistai;17;13;30
625;08.05.2018;2018;05;14;Tiistai;15;35;50
625;08.05.2018;2018;05;15;Tiistai;18;35;53
625;08.05.2018;2018;05;16;Tiistai;32;49;81
625;08.05.2018;2018;05;17;Tiistai;29;51;80
625;08.05.2018;2018;05;18;Tiistai;22;31;53
625;08.05.2018;2018;05;19;Tiistai;17;17;34
625;08.05.2018;2018;05;20;Tiistai;17;18;35
625;08.05.2018;2018;05;21;Tiistai;10;13;23
625;08.05.2018;2018;05;22;Tiistai;5;11;16
625;08.05.2018;2018;05;23;Tiistai;3;2;5
625;09.05.2018;2018;05;00;Keskiviikko;2;1;3
625;09.05.2018;2018;05;01;Keskiviikko;1;0;1
625;09.05.2018;2018;05;02;Keskiviikko;0;0;0
625;09.05.2018;2018;05;03;Keskiviikko;0;0;0
625;09.05.2018;2018;05;04;Keskiviikko;0;0;0
625;09.05.2018;2018;05;05;Keskiviikko;0;0;0
625;09.05.2018;2018;05;06;Keskiviikko;5;3;8
625;09.05.2018;2018;05;07;Keskiviikko;13;6;19
625;09.05.2018;2018;05;08;Keskiviikko;80;31;111
625;09.05.2018;2018;05;09;Keskiviikko;42;28;70
625;09.05.2018;2018;05;10;Keskiviikko;13;9;22
625;09.05.2018;2018;05;11;Keskiviikko;15;11;26
625;09.05.2018;2018;05;12;Keskiviikko;7;12;19
625;09.05.2018;2018;05;13;Keskiviikko;19;49;68
625;09.05.2018;2018;05;14;Keskiviikko;20;22;42
625;09.05.2018;2018;05;15;Keskiviikko;29;27;56
625;09.05.2018;2018;05;16;Keskiviikko;26;51;77
625;09.05.2018;2018;05;17;Keskiviikko;27;40;67
625;09.05.2018;2018;05;18;Keskiviikko;22;25;47
625;09.05.2018;2018;05;19;Keskiviikko;10;13;23
625;09.05.2018;2018;05;20;Keskiviikko;15;20;35
625;09.05.2018;2018;05;21;Keskiviikko;11;12;23
625;09.05.2018;2018;05;22;Keskiviikko;5;4;9
625;09.05.2018;2018;05;23;Keskiviikko;4;4;8
625;10.05.2018;2018;05;00;Torstai;4;3;7
625;10.05.2018;2018;05;01;Torstai;0;4;4
625;10.05.2018;2018;05;02;Torstai;0;2;2
625;10.05.2018;2018;05;03;Torstai;1;0;1
625;10.05.2018;2018;05;04;Torstai;1;1;2
625;10.05.2018;2018;05;05;Torstai;0;1;1
625;10.05.2018;2018;05;06;Torstai;1;3;4
625;10.05.2018;2018;05;07;Torstai;2;3;5
625;10.05.2018;2018;05;08;Torstai;2;4;6
625;10.05.2018;2018;05;09;Torstai;3;4;7
625;10.05.2018;2018;05;10;Torstai;8;8;16
625;10.05.2018;2018;05;11;Torstai;14;11;25
625;10.05.2018;2018;05;12;Torstai;9;17;26
625;10.05.2018;2018;05;13;Torstai;20;31;51
625;10.05.2018;2018;05;14;Torstai;31;35;66
625;10.05.2018;2018;05;15;Torstai;32;44;76
625;10.05.2018;2018;05;16;Torstai;26;23;49
625;10.05.2018;2018;05;17;Torstai;34;33;67
625;10.05.2018;2018;05;18;Torstai;16;27;43
625;10.05.2018;2018;05;19;Torstai;16;25;41
625;10.05.2018;2018;05;20;Torstai;15;23;38
625;10.05.2018;2018;05;21;Torstai;15;18;33
625;10.05.2018;2018;05;22;Torstai;7;6;13
625;10.05.2018;2018;05;23;Torstai;5;3;8
625;11.05.2018;2018;05;00;Perjantai;0;1;1
625;11.05.2018;2018;05;01;Perjantai;1;0;1
625;11.05.2018;2018;05;02;Perjantai;2;1;3
625;11.05.2018;2018;05;03;Perjantai;0;0;0
625;11.05.2018;2018;05;04;Perjantai;1;0;1
625;11.05.2018;2018;05;05;Perjantai;1;1;2
625;11.05.2018;2018;05;06;Perjantai;6;5;11
625;11.05.2018;2018;05;07;Perjantai;10;2;12
625;11.05.2018;2018;05;08;Perjantai;53;19;72
625;11.05.2018;2018;05;09;Perjantai;39;19;58
625;11.05.2018;2018;05;10;Perjantai;7;6;13
625;11.05.2018;2018;05;11;Perjantai;15;16;31
625;11.05.2018;2018;05;12;Perjantai;20;18;38
625;11.05.2018;2018;05;13;Perjantai;12;35;47
625;11.05.2018;2018;05;14;Perjantai;33;46;79
625;11.05.2018;2018;05;15;Perjantai;20;34;54
625;11.05.2018;2018;05;16;Perjantai;34;38;72
625;11.05.2018;2018;05;17;Perjantai;27;28;55
625;11.05.2018;2018;05;18;Perjantai;19;38;57
625;11.05.2018;2018;05;19;Perjantai;11;25;36
625;11.05.2018;2018;05;20;Perjantai;15;14;29
625;11.05.2018;2018;05;21;Perjantai;10;12;22
625;11.05.2018;2018;05;22;Perjantai;8;8;16
625;11.05.2018;2018;05;23;Perjantai;6;7;13
625;12.05.2018;2018;05;00;Lauantai;4;1;5
625;12.05.2018;2018;05;01;Lauantai;1;1;2
625;12.05.2018;2018;05;02;Lauantai;1;0;1
625;12.05.2018;2018;05;03;Lauantai;3;0;3
625;12.05.2018;2018;05;04;Lauantai;1;0;1
625;12.05.2018;2018;05;05;Lauantai;1;1;2
625;12.05.2018;2018;05;06;Lauantai;0;1;1
625;12.05.2018;2018;05;07;Lauantai;3;1;4
625;12.05.2018;2018;05;08;Lauantai;5;2;7
625;12.05.2018;2018;05;09;Lauantai;0;4;4
625;12.05.2018;2018;05;10;Lauantai;11;12;23
625;12.05.2018;2018;05;11;Lauantai;10;13;23
625;12.05.2018;2018;05;12;Lauantai;16;20;36
625;12.05.2018;2018;05;13;Lauantai;29;30;59
625;12.05.2018;2018;05;14;Lauantai;27;33;60
625;12.05.2018;2018;05;15;Lauantai;27;26;53
625;12.05.2018;2018;05;16;Lauantai;28;22;50
625;12.05.2018;2018;05;17;Lauantai;22;19;41
625;12.05.2018;2018;05;18;Lauantai;23;29;52
625;12.05.2018;2018;05;19;Lauantai;23;30;53
625;12.05.2018;2018;05;20;Lauantai;16;14;30
625;12.05.2018;2018;05;21;Lauantai;17;11;28
625;12.05.2018;2018;05;22;Lauantai;8;1;9
625;12.05.2018;2018;05;23;Lauantai;2;8;10
625;13.05.2018;2018;05;00;Sunnuntai;3;1;4
625;13.05.2018;2018;05;01;Sunnuntai;3;1;4
625;13.05.2018;2018;05;02;Sunnuntai;1;1;2
625;13.05.2018;2018;05;03;Sunnuntai;1;1;2
625;13.05.2018;2018;05;04;Sunnuntai;3;0;3
625;13.05.2018;2018;05;05;Sunnuntai;0;0;0
625;13.05.2018;2018;05;06;Sunnuntai;0;1;1
625;13.05.2018;2018;05;07;Sunnuntai;1;0;1
625;13.05.2018;2018;05;08;Sunnuntai;1;2;3
625;13.05.2018;2018;05;09;Sunnuntai;3;5;8
625;13.05.2018;2018;05;10;Sunnuntai;6;6;12
625;13.05.2018;2018;05;11;Sunnuntai;9;7;16
625;13.05.2018;2018;05;12;Sunnuntai;17;14;31
625;13.05.2018;2018;05;13;Sunnuntai;17;14;31
625;13.05.2018;2018;05;14;Sunnuntai;22;25;47
625;13.05.2018;2018;05;15;Sunnuntai;12;30;42
625;13.05.2018;2018;05;16;Sunnuntai;15;25;40
625;13.05.2018;2018;05;17;Sunnuntai;25;29;54
625;13.05.2018;2018;05;18;Sunnuntai;26;26;52
625;13.05.2018;2018;05;19;Sunnuntai;22;25;47
625;13.05.2018;2018;05;20;Sunnuntai;19;15;34
625;13.05.2018;2018;05;21;Sunnuntai;8;15;23
625;13.05.2018;2018;05;22;Sunnuntai;4;6;10
625;13.05.2018;2018;05;23;Sunnuntai;3;0;3
625;14.05.2018;2018;05;00;Maanantai;2;1;3
625;14.05.2018;2018;05;01;Maanantai;2;1;3
625;14.05.2018;2018;05;02;Maanantai;1;0;1
625;14.05.2018;2018;05;03;Maanantai;2;1;3
625;14.05.2018;2018;05;04;Maanantai;0;0;0
625;14.05.2018;2018;05;05;Maanantai;1;1;2
625;14.05.2018;2018;05;06;Maanantai;7;3;10
625;14.05.2018;2018;05;07;Maanantai;25;15;40
625;14.05.2018;2018;05;08;Maanantai;87;38;125
625;14.05.2018;2018;05;09;Maanantai;43;30;73
625;14.05.2018;2018;05;10;Maanantai;16;11;27
625;14.05.2018;2018;05;11;Maanantai;22;15;37
625;14.05.2018;2018;05;12;Maanantai;5;14;19
625;14.05.2018;2018;05;13;Maanantai;27;38;65
625;14.05.2018;2018;05;14;Maanantai;20;37;57
625;14.05.2018;2018;05;15;Maanantai;34;53;87
625;14.05.2018;2018;05;16;Maanantai;35;51;86
625;14.05.2018;2018;05;17;Maanantai;34;57;91
625;14.05.2018;2018;05;18;Maanantai;34;47;81
625;14.05.2018;2018;05;19;Maanantai;17;31;48
625;14.05.2018;2018;05;20;Maanantai;24;27;51
625;14.05.2018;2018;05;21;Maanantai;16;16;32
625;14.05.2018;2018;05;22;Maanantai;6;10;16
625;14.05.2018;2018;05;23;Maanantai;4;2;6
625;15.05.2018;2018;05;00;Tiistai;0;2;2
625;15.05.2018;2018;05;01;Tiistai;1;0;1
625;15.05.2018;2018;05;02;Tiistai;0;0;0
625;15.05.2018;2018;05;03;Tiistai;0;1;1
625;15.05.2018;2018;05;04;Tiistai;0;1;1
625;15.05.2018;2018;05;05;Tiistai;0;3;3
625;15.05.2018;2018;05;06;Tiistai;10;4;14
625;15.05.2018;2018;05;07;Tiistai;20;14;34
625;15.05.2018;2018;05;08;Tiistai;63;39;102
625;15.05.2018;2018;05;09;Tiistai;54;34;88
625;15.05.2018;2018;05;10;Tiistai;28;14;42
625;15.05.2018;2018;05;11;Tiistai;20;13;33
625;15.05.2018;2018;05;12;Tiistai;19;20;39
625;15.05.2018;2018;05;13;Tiistai;21;15;36
625;15.05.2018;2018;05;14;Tiistai;14;39;53
625;15.05.2018;2018;05;15;Tiistai;20;38;58
625;15.05.2018;2018;05;16;Tiistai;30;48;78
625;15.05.2018;2018;05;17;Tiistai;48;59;107
625;15.05.2018;2018;05;18;Tiistai;34;39;73
625;15.05.2018;2018;05;19;Tiistai;16;30;46
625;15.05.2018;2018;05;20;Tiistai;20;35;55
625;15.05.2018;2018;05;21;Tiistai;15;21;36
625;15.05.2018;2018;05;22;Tiistai;11;11;22
625;15.05.2018;2018;05;23;Tiistai;9;3;12
625;16.05.2018;2018;05;00;Keskiviikko;0;0;0
625;16.05.2018;2018;05;01;Keskiviikko;1;1;2
625;16.05.2018;2018;05;02;Keskiviikko;0;0;0
625;16.05.2018;2018;05;03;Keskiviikko;0;0;0
625;16.05.2018;2018;05;04;Keskiviikko;0;1;1
625;16.05.2018;2018;05;05;Keskiviikko;2;0;2
625;16.05.2018;2018;05;06;Keskiviikko;4;6;10
625;16.05.2018;2018;05;07;Keskiviikko;17;14;31
625;16.05.2018;2018;05;08;Keskiviikko;86;52;138
625;16.05.2018;2018;05;09;Keskiviikko;35;23;58
625;16.05.2018;2018;05;10;Keskiviikko;20;15;35
625;16.05.2018;2018;05;11;Keskiviikko;10;15;25
625;16.05.2018;2018;05;12;Keskiviikko;15;22;37
625;16.05.2018;2018;05;13;Keskiviikko;19;29;48
625;16.05.2018;2018;05;14;Keskiviikko;29;47;76
625;16.05.2018;2018;05;15;Keskiviikko;21;48;69
625;16.05.2018;2018;05;16;Keskiviikko;31;40;71
625;16.05.2018;2018;05;17;Keskiviikko;45;66;111
625;16.05.2018;2018;05;18;Keskiviikko;37;29;66
625;16.05.2018;2018;05;19;Keskiviikko;24;26;50
625;16.05.2018;2018;05;20;Keskiviikko;19;29;48
625;16.05.2018;2018;05;21;Keskiviikko;14;27;41
625;16.05.2018;2018;05;22;Keskiviikko;13;14;27
625;16.05.2018;2018;05;23;Keskiviikko;7;4;11
625;17.05.2018;2018;05;00;Torstai;1;1;2
625;17.05.2018;2018;05;01;Torstai;1;3;4
625;17.05.2018;2018;05;02;Torstai;0;0;0
625;17.05.2018;2018;05;03;Torstai;0;1;1
625;17.05.2018;2018;05;04;Torstai;0;0;0
625;17.05.2018;2018;05;05;Torstai;0;1;1
625;17.05.2018;2018;05;06;Torstai;5;3;8
625;17.05.2018;2018;05;07;Torstai;13;10;23
625;17.05.2018;2018;05;08;Torstai;76;34;110
625;17.05.2018;2018;05;09;Torstai;73;59;132
625;17.05.2018;2018;05;10;Torstai;17;8;25
625;17.05.2018;2018;05;11;Torstai;13;7;20
625;17.05.2018;2018;05;12;Torstai;8;16;24
625;17.05.2018;2018;05;13;Torstai;40;53;93
625;17.05.2018;2018;05;14;Torstai;23;33;56
625;17.05.2018;2018;05;15;Torstai;25;39;64
625;17.05.2018;2018;05;16;Torstai;30;44;74
625;17.05.2018;2018;05;17;Torstai;33;53;86
625;17.05.2018;2018;05;18;Torstai;11;31;42
625;17.05.2018;2018;05;19;Torstai;19;34;53
625;17.05.2018;2018;05;20;Torstai;9;12;21
625;17.05.2018;2018;05;21;Torstai;16;13;29
625;17.05.2018;2018;05;22;Torstai;7;4;11
625;17.05.2018;2018;05;23;Torstai;4;2;6
625;18.05.2018;2018;05;00;Perjantai;0;1;1
625;18.05.2018;2018;05;01;Perjantai;0;0;0
625;18.05.2018;2018;05;02;Perjantai;0;0;0
625;18.05.2018;2018;05;03;Perjantai;0;0;0
625;18.05.2018;2018;05;04;Perjantai;0;1;1
625;18.05.2018;2018;05;05;Perjantai;0;0;0
625;18.05.2018;2018;05;06;Perjantai;3;3;6
625;18.05.2018;2018;05;07;Perjantai;11;10;21
625;18.05.2018;2018;05;08;Perjantai;56;36;92
625;18.05.2018;2018;05;09;Perjantai;53;45;98
625;18.05.2018;2018;05;10;Perjantai;10;8;18
625;18.05.2018;2018;05;11;Perjantai;9;4;13
625;18.05.2018;2018;05;12;Perjantai;19;30;49
625;18.05.2018;2018;05;13;Perjantai;13;22;35
625;18.05.2018;2018;05;14;Perjantai;16;45;61
625;18.05.2018;2018;05;15;Perjantai;26;30;56
625;18.05.2018;2018;05;16;Perjantai;16;31;47
625;18.05.2018;2018;05;17;Perjantai;21;34;55
625;18.05.2018;2018;05;18;Perjantai;15;13;28
625;18.05.2018;2018;05;19;Perjantai;11;9;20
625;18.05.2018;2018;05;20;Perjantai;10;15;25
625;18.05.2018;2018;05;21;Perjantai;5;12;17
625;18.05.2018;2018;05;22;Perjantai;6;10;16
625;18.05.2018;2018;05;23;Perjantai;8;5;13
625;19.05.2018;2018;05;00;Lauantai;4;0;4
625;19.05.2018;2018;05;01;Lauantai;0;2;2
625;19.05.2018;2018;05;02;Lauantai;0;0;0
625;19.05.2018;2018;05;03;Lauantai;0;0;0
625;19.05.2018;2018;05;04;Lauantai;1;0;1
625;19.05.2018;2018;05;05;Lauantai;0;0;0
625;19.05.2018;2018;05;06;Lauantai;1;1;2
625;19.05.2018;2018;05;07;Lauantai;1;0;1
625;19.05.2018;2018;05;08;Lauantai;0;3;3
625;19.05.2018;2018;05;09;Lauantai;1;2;3
625;19.05.2018;2018;05;10;Lauantai;12;2;14
625;19.05.2018;2018;05;11;Lauantai;9;6;15
625;19.05.2018;2018;05;12;Lauantai;11;11;22
625;19.05.2018;2018;05;13;Lauantai;20;18;38
625;19.05.2018;2018;05;14;Lauantai;11;11;22
625;19.05.2018;2018;05;15;Lauantai;10;17;27
625;19.05.2018;2018;05;16;Lauantai;14;21;35
625;19.05.2018;2018;05;17;Lauantai;15;11;26
625;19.05.2018;2018;05;18;Lauantai;7;12;19
625;19.05.2018;2018;05;19;Lauantai;16;18;34
625;19.05.2018;2018;05;20;Lauantai;6;8;14
625;19.05.2018;2018;05;21;Lauantai;9;8;17
625;19.05.2018;2018;05;22;Lauantai;2;6;8
625;19.05.2018;2018;05;23;Lauantai;4;7;11
625;20.05.2018;2018;05;00;Sunnuntai;1;3;4
625;20.05.2018;2018;05;01;Sunnuntai;2;2;4
625;20.05.2018;2018;05;02;Sunnuntai;0;0;0
625;20.05.2018;2018;05;03;Sunnuntai;4;2;6
625;20.05.2018;2018;05;04;Sunnuntai;1;0;1
625;20.05.2018;2018;05;05;Sunnuntai;0;0;0
625;20.05.2018;2018;05;06;Sunnuntai;0;1;1
625;20.05.2018;2018;05;07;Sunnuntai;2;2;4
625;20.05.2018;2018;05;08;Sunnuntai;1;3;4
625;20.05.2018;2018;05;09;Sunnuntai;4;6;10
625;20.05.2018;2018;05;10;Sunnuntai;9;7;16
625;20.05.2018;2018;05;11;Sunnuntai;8;9;17
625;20.05.2018;2018;05;12;Sunnuntai;14;11;25
625;20.05.2018;2018;05;13;Sunnuntai;19;25;44
625;20.05.2018;2018;05;14;Sunnuntai;10;18;28
625;20.05.2018;2018;05;15;Sunnuntai;17;21;38
625;20.05.2018;2018;05;16;Sunnuntai;20;20;40
625;20.05.2018;2018;05;17;Sunnuntai;24;31;55
625;20.05.2018;2018;05;18;Sunnuntai;10;19;29
625;20.05.2018;2018;05;19;Sunnuntai;12;14;26
625;20.05.2018;2018;05;20;Sunnuntai;7;14;21
625;20.05.2018;2018;05;21;Sunnuntai;8;9;17
625;20.05.2018;2018;05;22;Sunnuntai;5;7;12
625;20.05.2018;2018;05;23;Sunnuntai;4;0;4
625;21.05.2018;2018;05;00;Maanantai;1;0;1
625;21.05.2018;2018;05;01;Maanantai;1;0;1
625;21.05.2018;2018;05;02;Maanantai;0;0;0
625;21.05.2018;2018;05;03;Maanantai;1;0;1
625;21.05.2018;2018;05;04;Maanantai;0;0;0
625;21.05.2018;2018;05;05;Maanantai;2;0;2
625;21.05.2018;2018;05;06;Maanantai;4;6;10
625;21.05.2018;2018;05;07;Maanantai;21;11;32
625;21.05.2018;2018;05;08;Maanantai;80;42;122
625;21.05.2018;2018;05;09;Maanantai;47;52;99
625;21.05.2018;2018;05;10;Maanantai;20;12;32
625;21.05.2018;2018;05;11;Maanantai;20;14;34
625;21.05.2018;2018;05;12;Maanantai;12;15;27
625;21.05.2018;2018;05;13;Maanantai;15;29;44
625;21.05.2018;2018;05;14;Maanantai;21;31;52
625;21.05.2018;2018;05;15;Maanantai;26;44;70
625;21.05.2018;2018;05;16;Maanantai;20;40;60
625;21.05.2018;2018;05;17;Maanantai;34;52;86
625;21.05.2018;2018;05;18;Maanantai;26;30;56
625;21.05.2018;2018;05;19;Maanantai;10;27;37
625;21.05.2018;2018;05;20;Maanantai;17;19;36
625;21.05.2018;2018;05;21;Maanantai;23;23;46
625;21.05.2018;2018;05;22;Maanantai;17;10;27
625;21.05.2018;2018;05;23;Maanantai;6;1;7
625;22.05.2018;2018;05;00;Tiistai;2;1;3
625;22.05.2018;2018;05;01;Tiistai;0;0;0
625;22.05.2018;2018;05;02;Tiistai;1;0;1
625;22.05.2018;2018;05;03;Tiistai;0;0;0
625;22.05.2018;2018;05;04;Tiistai;0;0;0
625;22.05.2018;2018;05;05;Tiistai;2;1;3
625;22.05.2018;2018;05;06;Tiistai;5;9;14
625;22.05.2018;2018;05;07;Tiistai;26;12;38
625;22.05.2018;2018;05;08;Tiistai;77;36;113
625;22.05.2018;2018;05;09;Tiistai;42;24;66
625;22.05.2018;2018;05;10;Tiistai;47;38;85
625;22.05.2018;2018;05;11;Tiistai;24;13;37
625;22.05.2018;2018;05;12;Tiistai;22;28;50
625;22.05.2018;2018;05;13;Tiistai;17;36;53
625;22.05.2018;2018;05;14;Tiistai;26;44;70
625;22.05.2018;2018;05;15;Tiistai;27;46;73
625;22.05.2018;2018;05;16;Tiistai;32;49;81
625;22.05.2018;2018;05;17;Tiistai;42;53;95
625;22.05.2018;2018;05;18;Tiistai;31;37;68
625;22.05.2018;2018;05;19;Tiistai;26;29;55
625;22.05.2018;2018;05;20;Tiistai;18;30;48
625;22.05.2018;2018;05;21;Tiistai;9;15;24
625;22.05.2018;2018;05;22;Tiistai;5;10;15
625;22.05.2018;2018;05;23;Tiistai;5;5;10
625;23.05.2018;2018;05;00;Keskiviikko;3;1;4
625;23.05.2018;2018;05;01;Keskiviikko;1;0;1
625;23.05.2018;2018;05;02;Keskiviikko;0;1;1
625;23.05.2018;2018;05;03;Keskiviikko;0;0;0
625;23.05.2018;2018;05;04;Keskiviikko;0;0;0
625;23.05.2018;2018;05;05;Keskiviikko;0;2;2
625;23.05.2018;2018;05;06;Keskiviikko;4;6;10
625;23.05.2018;2018;05;07;Keskiviikko;24;11;35
625;23.05.2018;2018;05;08;Keskiviikko;97;50;147
625;23.05.2018;2018;05;09;Keskiviikko;43;16;59
625;23.05.2018;2018;05;10;Keskiviikko;15;11;26
625;23.05.2018;2018;05;11;Keskiviikko;12;5;17
625;23.05.2018;2018;05;12;Keskiviikko;11;19;30
625;23.05.2018;2018;05;13;Keskiviikko;11;14;25
625;23.05.2018;2018;05;14;Keskiviikko;12;36;48
625;23.05.2018;2018;05;15;Keskiviikko;22;35;57
625;23.05.2018;2018;05;16;Keskiviikko;24;56;80
625;23.05.2018;2018;05;17;Keskiviikko;34;45;79
625;23.05.2018;2018;05;18;Keskiviikko;34;23;57
625;23.05.2018;2018;05;19;Keskiviikko;12;19;31
625;23.05.2018;2018;05;20;Keskiviikko;10;27;37
625;23.05.2018;2018;05;21;Keskiviikko;7;6;13
625;23.05.2018;2018;05;22;Keskiviikko;10;5;15
625;23.05.2018;2018;05;23;Keskiviikko;6;4;10
625;24.05.2018;2018;05;00;Torstai;2;1;3
625;24.05.2018;2018;05;01;Torstai;2;0;2
625;24.05.2018;2018;05;02;Torstai;0;0;0
625;24.05.2018;2018;05;03;Torstai;0;0;0
625;24.05.2018;2018;05;04;Torstai;0;1;1
625;24.05.2018;2018;05;05;Torstai;0;1;1
625;24.05.2018;2018;05;06;Torstai;4;3;7
625;24.05.2018;2018;05;07;Torstai;18;9;27
625;24.05.2018;2018;05;08;Torstai;68;34;102
625;24.05.2018;2018;05;09;Torstai;32;24;56
625;24.05.2018;2018;05;10;Torstai;23;10;33
625;24.05.2018;2018;05;11;Torstai;14;6;20
625;24.05.2018;2018;05;12;Torstai;8;9;17
625;24.05.2018;2018;05;13;Torstai;17;37;54
625;24.05.2018;2018;05;14;Torstai;8;22;30
625;24.05.2018;2018;05;15;Torstai;25;42;67
625;24.05.2018;2018;05;16;Torstai;32;57;89
625;24.05.2018;2018;05;17;Torstai;30;41;71
625;24.05.2018;2018;05;18;Torstai;23;26;49
625;24.05.2018;2018;05;19;Torstai;21;16;37
625;24.05.2018;2018;05;20;Torstai;14;24;38
625;24.05.2018;2018;05;21;Torstai;11;11;22
625;24.05.2018;2018;05;22;Torstai;8;12;20
625;24.05.2018;2018;05;23;Torstai;8;2;10
625;25.05.2018;2018;05;00;Perjantai;2;2;4
625;25.05.2018;2018;05;01;Perjantai;0;2;2
625;25.05.2018;2018;05;02;Perjantai;0;0;0
625;25.05.2018;2018;05;03;Perjantai;0;0;0
625;25.05.2018;2018;05;04;Perjantai;0;1;1
625;25.05.2018;2018;05;05;Perjantai;1;2;3
625;25.05.2018;2018;05;06;Perjantai;3;4;7
625;25.05.2018;2018;05;07;Perjantai;12;8;20
625;25.05.2018;2018;05;08;Perjantai;74;37;111
625;25.05.2018;2018;05;09;Perjantai;49;32;81
625;25.05.2018;2018;05;10;Perjantai;14;17;31
625;25.05.2018;2018;05;11;Perjantai;10;8;18
625;25.05.2018;2018;05;12;Perjantai;15;16;31
625;25.05.2018;2018;05;13;Perjantai;16;21;37
625;25.05.2018;2018;05;14;Perjantai;18;46;64
625;25.05.2018;2018;05;15;Perjantai;16;32;48
625;25.05.2018;2018;05;16;Perjantai;21;37;58
625;25.05.2018;2018;05;17;Perjantai;24;35;59
625;25.05.2018;2018;05;18;Perjantai;16;21;37
625;25.05.2018;2018;05;19;Perjantai;5;9;14
625;25.05.2018;2018;05;20;Perjantai;9;17;26
625;25.05.2018;2018;05;21;Perjantai;13;15;28
625;25.05.2018;2018;05;22;Perjantai;8;4;12
625;25.05.2018;2018;05;23;Perjantai;2;3;5
625;26.05.2018;2018;05;00;Lauantai;0;1;1
625;26.05.2018;2018;05;01;Lauantai;1;0;1
625;26.05.2018;2018;05;02;Lauantai;0;2;2
625;26.05.2018;2018;05;03;Lauantai;1;0;1
625;26.05.2018;2018;05;04;Lauantai;0;0;0
625;26.05.2018;2018;05;05;Lauantai;1;0;1
625;26.05.2018;2018;05;06;Lauantai;0;0;0
625;26.05.2018;2018;05;07;Lauantai;1;2;3
625;26.05.2018;2018;05;08;Lauantai;0;1;1
625;26.05.2018;2018;05;09;Lauantai;3;3;6
625;26.05.2018;2018;05;10;Lauantai;9;1;10
625;26.05.2018;2018;05;11;Lauantai;7;6;13
625;26.05.2018;2018;05;12;Lauantai;2;10;12
625;26.05.2018;2018;05;13;Lauantai;11;11;22
625;26.05.2018;2018;05;14;Lauantai;10;19;29
625;26.05.2018;2018;05;15;Lauantai;9;12;21
625;26.05.2018;2018;05;16;Lauantai;4;8;12
625;26.05.2018;2018;05;17;Lauantai;14;11;25
625;26.05.2018;2018;05;18;Lauantai;10;9;19
625;26.05.2018;2018;05;19;Lauantai;10;12;22
625;26.05.2018;2018;05;20;Lauantai;6;4;10
625;26.05.2018;2018;05;21;Lauantai;8;1;9
625;26.05.2018;2018;05;22;Lauantai;6;2;8
625;26.05.2018;2018;05;23;Lauantai;1;3;4
625;27.05.2018;2018;05;00;Sunnuntai;4;0;4
625;27.05.2018;2018;05;01;Sunnuntai;9;0;9
625;27.05.2018;2018;05;02;Sunnuntai;2;0;2
625;27.05.2018;2018;05;03;Sunnuntai;1;0;1
625;27.05.2018;2018;05;04;Sunnuntai;1;0;1
625;27.05.2018;2018;05;05;Sunnuntai;2;0;2
625;27.05.2018;2018;05;06;Sunnuntai;1;0;1
625;27.05.2018;2018;05;07;Sunnuntai;5;0;5
625;27.05.2018;2018;05;08;Sunnuntai;2;0;2
625;27.05.2018;2018;05;09;Sunnuntai;5;0;5
625;27.05.2018;2018;05;10;Sunnuntai;9;0;9
625;27.05.2018;2018;05;11;Sunnuntai;51;0;51
625;27.05.2018;2018;05;12;Sunnuntai;15;0;15
625;27.05.2018;2018;05;13;Sunnuntai;44;0;44
625;27.05.2018;2018;05;14;Sunnuntai;28;0;28
625;27.05.2018;2018;05;15;Sunnuntai;38;0;38
625;27.05.2018;2018;05;16;Sunnuntai;40;0;40
625;27.05.2018;2018;05;17;Sunnuntai;55;0;55
625;27.05.2018;2018;05;18;Sunnuntai;29;0;29
625;27.05.2018;2018;05;19;Sunnuntai;26;0;26
625;27.05.2018;2018;05;20;Sunnuntai;21;0;21
625;27.05.2018;2018;05;21;Sunnuntai;17;0;17
625;27.05.2018;2018;05;22;Sunnuntai;12;0;12
625;27.05.2018;2018;05;23;Sunnuntai;4;0;4
625;28.05.2018;2018;05;00;Maanantai;1;0;1
625;28.05.2018;2018;05;01;Maanantai;1;0;1
625;28.05.2018;2018;05;02;Maanantai;0;0;0
625;28.05.2018;2018;05;03;Maanantai;1;0;1
625;28.05.2018;2018;05;04;Maanantai;0;0;0
625;28.05.2018;2018;05;05;Maanantai;2;0;2
625;28.05.2018;2018;05;06;Maanantai;10;0;10
625;28.05.2018;2018;05;07;Maanantai;32;0;32
625;28.05.2018;2018;05;08;Maanantai;122;0;122
625;28.05.2018;2018;05;09;Maanantai;99;0;99
625;28.05.2018;2018;05;10;Maanantai;32;0;32
625;28.05.2018;2018;05;11;Maanantai;34;0;34
625;28.05.2018;2018;05;12;Maanantai;19;0;19
625;28.05.2018;2018;05;13;Maanantai;47;0;47
625;28.05.2018;2018;05;14;Maanantai;76;0;76
625;28.05.2018;2018;05;15;Maanantai;66;0;66
625;28.05.2018;2018;05;16;Maanantai;66;0;66
625;28.05.2018;2018;05;17;Maanantai;82;0;82
625;28.05.2018;2018;05;18;Maanantai;61;0;61
625;28.05.2018;2018;05;19;Maanantai;47;0;47
625;28.05.2018;2018;05;20;Maanantai;38;0;38
625;28.05.2018;2018;05;21;Maanantai;32;0;32
625;28.05.2018;2018;05;22;Maanantai;10;0;10
625;28.05.2018;2018;05;23;Maanantai;8;0;8
625;29.05.2018;2018;05;00;Tiistai;0;4;4
625;29.05.2018;2018;05;01;Tiistai;3;2;5
625;29.05.2018;2018;05;02;Tiistai;0;1;1
625;29.05.2018;2018;05;03;Tiistai;0;0;0
625;29.05.2018;2018;05;04;Tiistai;0;0;0
625;29.05.2018;2018;05;05;Tiistai;1;0;1
625;29.05.2018;2018;05;06;Tiistai;4;5;9
625;29.05.2018;2018;05;07;Tiistai;25;16;41
625;29.05.2018;2018;05;08;Tiistai;56;34;90
625;29.05.2018;2018;05;09;Tiistai;67;40;107
625;29.05.2018;2018;05;10;Tiistai;43;14;57
625;29.05.2018;2018;05;11;Tiistai;9;7;16
625;29.05.2018;2018;05;12;Tiistai;23;37;60
625;29.05.2018;2018;05;13;Tiistai;33;59;92
625;29.05.2018;2018;05;14;Tiistai;26;36;62
625;29.05.2018;2018;05;15;Tiistai;28;30;58
625;29.05.2018;2018;05;16;Tiistai;35;48;83
625;29.05.2018;2018;05;17;Tiistai;39;45;84
625;29.05.2018;2018;05;18;Tiistai;24;31;55
625;29.05.2018;2018;05;19;Tiistai;10;20;30
625;29.05.2018;2018;05;20;Tiistai;22;19;41
625;29.05.2018;2018;05;21;Tiistai;14;16;30
625;29.05.2018;2018;05;22;Tiistai;8;13;21
625;29.05.2018;2018;05;23;Tiistai;6;2;8
625;30.05.2018;2018;05;00;Keskiviikko;1;3;4
625;30.05.2018;2018;05;01;Keskiviikko;0;1;1
625;30.05.2018;2018;05;02;Keskiviikko;1;0;1
625;30.05.2018;2018;05;03;Keskiviikko;1;1;2
625;30.05.2018;2018;05;04;Keskiviikko;0;0;0
625;30.05.2018;2018;05;05;Keskiviikko;0;0;0
625;30.05.2018;2018;05;06;Keskiviikko;6;4;10
625;30.05.2018;2018;05;07;Keskiviikko;22;10;32
625;30.05.2018;2018;05;08;Keskiviikko;47;24;71
625;30.05.2018;2018;05;09;Keskiviikko;54;43;97
625;30.05.2018;2018;05;10;Keskiviikko;57;20;77
625;30.05.2018;2018;05;11;Keskiviikko;10;14;24
625;30.05.2018;2018;05;12;Keskiviikko;10;14;24
625;30.05.2018;2018;05;13;Keskiviikko;25;51;76
625;30.05.2018;2018;05;14;Keskiviikko;25;37;62
625;30.05.2018;2018;05;15;Keskiviikko;30;24;54
625;30.05.2018;2018;05;16;Keskiviikko;29;47;76
625;30.05.2018;2018;05;17;Keskiviikko;36;49;85
625;30.05.2018;2018;05;18;Keskiviikko;27;26;53
625;30.05.2018;2018;05;19;Keskiviikko;12;20;32
625;30.05.2018;2018;05;20;Keskiviikko;11;19;30
625;30.05.2018;2018;05;21;Keskiviikko;10;8;18
625;30.05.2018;2018;05;22;Keskiviikko;6;6;12
625;30.05.2018;2018;05;23;Keskiviikko;4;3;7
625;31.05.2018;2018;05;00;Torstai;3;2;5
625;31.05.2018;2018;05;01;Torstai;0;0;0
625;31.05.2018;2018;05;02;Torstai;1;1;2
625;31.05.2018;2018;05;03;Torstai;1;0;1
625;31.05.2018;2018;05;04;Torstai;0;0;0
625;31.05.2018;2018;05;05;Torstai;0;0;0
625;31.05.2018;2018;05;06;Torstai;7;6;13
625;31.05.2018;2018;05;07;Torstai;14;10;24
625;31.05.2018;2018;05;08;Torstai;74;45;119
625;31.05.2018;2018;05;09;Torstai;42;28;70
625;31.05.2018;2018;05;10;Torstai;13;12;25
625;31.05.2018;2018;05;11;Torstai;13;12;25
625;31.05.2018;2018;05;12;Torstai;22;51;73
625;31.05.2018;2018;05;13;Torstai;28;43;71
625;31.05.2018;2018;05;14;Torstai;24;31;55
625;31.05.2018;2018;05;15;Torstai;33;22;55
625;31.05.2018;2018;05;16;Torstai;25;45;70
625;31.05.2018;2018;05;17;Torstai;35;43;78
625;31.05.2018;2018;05;18;Torstai;17;30;47
625;31.05.2018;2018;05;19;Torstai;21;16;37
625;31.05.2018;2018;05;20;Torstai;15;20;35
625;31.05.2018;2018;05;21;Torstai;13;11;24
625;31.05.2018;2018;05;22;Torstai;5;10;15
625;31.05.2018;2018;05;23;Torstai;12;1;13
625;01.06.2018;2018;06;00;Perjantai;0;1;1
625;01.06.2018;2018;06;01;Perjantai;1;1;2
625;01.06.2018;2018;06;02;Perjantai;1;1;2
625;01.06.2018;2018;06;03;Perjantai;0;1;1
625;01.06.2018;2018;06;04;Perjantai;0;0;0
625;01.06.2018;2018;06;05;Perjantai;1;0;1
625;01.06.2018;2018;06;06;Perjantai;5;6;11
625;01.06.2018;2018;06;07;Perjantai;22;11;33
625;01.06.2018;2018;06;08;Perjantai;30;19;49
625;01.06.2018;2018;06;09;Perjantai;49;29;78
625;01.06.2018;2018;06;10;Perjantai;56;30;86
625;01.06.2018;2018;06;11;Perjantai;8;9;17
625;01.06.2018;2018;06;12;Perjantai;11;26;37
625;01.06.2018;2018;06;13;Perjantai;14;37;51
625;01.06.2018;2018;06;14;Perjantai;21;24;45
625;01.06.2018;2018;06;15;Perjantai;21;27;48
625;01.06.2018;2018;06;16;Perjantai;30;45;75
625;01.06.2018;2018;06;17;Perjantai;32;33;65
625;01.06.2018;2018;06;18;Perjantai;15;27;42
625;01.06.2018;2018;06;19;Perjantai;10;15;25
625;01.06.2018;2018;06;20;Perjantai;10;19;29
625;01.06.2018;2018;06;21;Perjantai;9;7;16
625;01.06.2018;2018;06;22;Perjantai;8;8;16
625;01.06.2018;2018;06;23;Perjantai;8;2;10
625;02.06.2018;2018;06;00;Lauantai;2;1;3
625;02.06.2018;2018;06;01;Lauantai;1;2;3
625;02.06.2018;2018;06;02;Lauantai;3;1;4
625;02.06.2018;2018;06;03;Lauantai;0;0;0
625;02.06.2018;2018;06;04;Lauantai;1;0;1
625;02.06.2018;2018;06;05;Lauantai;1;1;2
625;02.06.2018;2018;06;06;Lauantai;0;5;5
625;02.06.2018;2018;06;07;Lauantai;9;0;9
625;02.06.2018;2018;06;08;Lauantai;31;5;36
625;02.06.2018;2018;06;09;Lauantai;8;4;12
625;02.06.2018;2018;06;10;Lauantai;15;26;41
625;02.06.2018;2018;06;11;Lauantai;11;22;33
625;02.06.2018;2018;06;12;Lauantai;12;23;35
625;02.06.2018;2018;06;13;Lauantai;16;28;44
625;02.06.2018;2018;06;14;Lauantai;9;25;34
625;02.06.2018;2018;06;15;Lauantai;19;24;43
625;02.06.2018;2018;06;16;Lauantai;8;11;19
625;02.06.2018;2018;06;17;Lauantai;13;19;32
625;02.06.2018;2018;06;18;Lauantai;22;23;45
625;02.06.2018;2018;06;19;Lauantai;20;12;32
625;02.06.2018;2018;06;20;Lauantai;12;24;36
625;02.06.2018;2018;06;21;Lauantai;16;9;25
625;02.06.2018;2018;06;22;Lauantai;6;10;16
625;02.06.2018;2018;06;23;Lauantai;7;5;12
625;03.06.2018;2018;06;00;Sunnuntai;2;2;4
625;03.06.2018;2018;06;01;Sunnuntai;2;3;5
625;03.06.2018;2018;06;02;Sunnuntai;1;1;2
625;03.06.2018;2018;06;03;Sunnuntai;0;1;1
625;03.06.2018;2018;06;04;Sunnuntai;0;0;0
625;03.06.2018;2018;06;05;Sunnuntai;0;2;2
625;03.06.2018;2018;06;06;Sunnuntai;1;3;4
625;03.06.2018;2018;06;07;Sunnuntai;0;2;2
625;03.06.2018;2018;06;08;Sunnuntai;1;2;3
625;03.06.2018;2018;06;09;Sunnuntai;2;3;5
625;03.06.2018;2018;06;10;Sunnuntai;7;8;15
625;03.06.2018;2018;06;11;Sunnuntai;6;6;12
625;03.06.2018;2018;06;12;Sunnuntai;9;7;16
625;03.06.2018;2018;06;13;Sunnuntai;13;15;28
625;03.06.2018;2018;06;14;Sunnuntai;7;19;26
625;03.06.2018;2018;06;15;Sunnuntai;13;26;39
625;03.06.2018;2018;06;16;Sunnuntai;20;20;40
625;03.06.2018;2018;06;17;Sunnuntai;15;31;46
625;03.06.2018;2018;06;18;Sunnuntai;13;11;24
625;03.06.2018;2018;06;19;Sunnuntai;14;9;23
625;03.06.2018;2018;06;20;Sunnuntai;5;11;16
625;03.06.2018;2018;06;21;Sunnuntai;3;6;9
625;03.06.2018;2018;06;22;Sunnuntai;4;5;9
625;03.06.2018;2018;06;23;Sunnuntai;4;0;4
625;04.06.2018;2018;06;00;Maanantai;2;1;3
625;04.06.2018;2018;06;01;Maanantai;0;1;1
625;04.06.2018;2018;06;02;Maanantai;0;0;0
625;04.06.2018;2018;06;03;Maanantai;0;0;0
625;04.06.2018;2018;06;04;Maanantai;0;1;1
625;04.06.2018;2018;06;05;Maanantai;1;0;1
625;04.06.2018;2018;06;06;Maanantai;3;8;11
625;04.06.2018;2018;06;07;Maanantai;13;10;23
625;04.06.2018;2018;06;08;Maanantai;28;16;44
625;04.06.2018;2018;06;09;Maanantai;21;17;38
625;04.06.2018;2018;06;10;Maanantai;7;4;11
625;04.06.2018;2018;06;11;Maanantai;5;6;11
625;04.06.2018;2018;06;12;Maanantai;7;8;15
625;04.06.2018;2018;06;13;Maanantai;9;7;16
625;04.06.2018;2018;06;14;Maanantai;8;6;14
625;04.06.2018;2018;06;15;Maanantai;6;16;22
625;04.06.2018;2018;06;16;Maanantai;16;20;36
625;04.06.2018;2018;06;17;Maanantai;15;24;39
625;04.06.2018;2018;06;18;Maanantai;10;14;24
625;04.06.2018;2018;06;19;Maanantai;4;8;12
625;04.06.2018;2018;06;20;Maanantai;5;5;10
625;04.06.2018;2018;06;21;Maanantai;5;7;12
625;04.06.2018;2018;06;22;Maanantai;3;4;7
625;04.06.2018;2018;06;23;Maanantai;7;1;8
625;05.06.2018;2018;06;00;Tiistai;2;0;2
625;05.06.2018;2018;06;01;Tiistai;1;1;2
625;05.06.2018;2018;06;02;Tiistai;0;0;0
625;05.06.2018;2018;06;03;Tiistai;0;0;0
625;05.06.2018;2018;06;04;Tiistai;0;0;0
625;05.06.2018;2018;06;05;Tiistai;0;0;0
625;05.06.2018;2018;06;06;Tiistai;3;2;5
625;05.06.2018;2018;06;07;Tiistai;8;9;17
625;05.06.2018;2018;06;08;Tiistai;22;14;36
625;05.06.2018;2018;06;09;Tiistai;19;16;35
625;05.06.2018;2018;06;10;Tiistai;8;5;13
625;05.06.2018;2018;06;11;Tiistai;7;6;13
625;05.06.2018;2018;06;12;Tiistai;6;4;10
625;05.06.2018;2018;06;13;Tiistai;10;11;21
625;05.06.2018;2018;06;14;Tiistai;7;9;16
625;05.06.2018;2018;06;15;Tiistai;12;17;29
625;05.06.2018;2018;06;16;Tiistai;18;27;45
625;05.06.2018;2018;06;17;Tiistai;22;30;52
625;05.06.2018;2018;06;18;Tiistai;14;12;26
625;05.06.2018;2018;06;19;Tiistai;7;11;18
625;05.06.2018;2018;06;20;Tiistai;5;14;19
625;05.06.2018;2018;06;21;Tiistai;9;12;21
625;05.06.2018;2018;06;22;Tiistai;4;4;8
625;05.06.2018;2018;06;23;Tiistai;5;3;8
625;06.06.2018;2018;06;00;Keskiviikko;2;2;4
625;06.06.2018;2018;06;01;Keskiviikko;0;0;0
625;06.06.2018;2018;06;02;Keskiviikko;1;0;1
625;06.06.2018;2018;06;03;Keskiviikko;1;0;1
625;06.06.2018;2018;06;04;Keskiviikko;0;0;0
625;06.06.2018;2018;06;05;Keskiviikko;0;2;2
625;06.06.2018;2018;06;06;Keskiviikko;4;6;10
625;06.06.2018;2018;06;07;Keskiviikko;17;12;29
625;06.06.2018;2018;06;08;Keskiviikko;14;13;27
625;06.06.2018;2018;06;09;Keskiviikko;33;24;57
625;06.06.2018;2018;06;10;Keskiviikko;6;10;16
625;06.06.2018;2018;06;11;Keskiviikko;11;2;13
625;06.06.2018;2018;06;12;Keskiviikko;4;8;12
625;06.06.2018;2018;06;13;Keskiviikko;12;10;22
625;06.06.2018;2018;06;14;Keskiviikko;11;8;19
625;06.06.2018;2018;06;15;Keskiviikko;15;21;36
625;06.06.2018;2018;06;16;Keskiviikko;19;26;45
625;06.06.2018;2018;06;17;Keskiviikko;33;36;69
625;06.06.2018;2018;06;18;Keskiviikko;16;19;35
625;06.06.2018;2018;06;19;Keskiviikko;12;15;27
625;06.06.2018;2018;06;20;Keskiviikko;6;13;19
625;06.06.2018;2018;06;21;Keskiviikko;5;12;17
625;06.06.2018;2018;06;22;Keskiviikko;6;11;17
625;06.06.2018;2018;06;23;Keskiviikko;4;2;6
625;07.06.2018;2018;06;00;Torstai;2;1;3
625;07.06.2018;2018;06;01;Torstai;1;2;3
625;07.06.2018;2018;06;02;Torstai;0;0;0
625;07.06.2018;2018;06;03;Torstai;1;1;2
625;07.06.2018;2018;06;04;Torstai;0;1;1
625;07.06.2018;2018;06;05;Torstai;0;2;2
625;07.06.2018;2018;06;06;Torstai;3;6;9
625;07.06.2018;2018;06;07;Torstai;6;8;14
625;07.06.2018;2018;06;08;Torstai;15;12;27
625;07.06.2018;2018;06;09;Torstai;9;10;19
625;07.06.2018;2018;06;10;Torstai;6;5;11
625;07.06.2018;2018;06;11;Torstai;11;2;13
625;07.06.2018;2018;06;12;Torstai;4;8;12
625;07.06.2018;2018;06;13;Torstai;12;10;22
625;07.06.2018;2018;06;14;Torstai;11;8;19
625;07.06.2018;2018;06;15;Torstai;15;21;36
625;07.06.2018;2018;06;16;Torstai;19;26;45
625;07.06.2018;2018;06;17;Torstai;33;36;69
625;07.06.2018;2018;06;18;Torstai;16;19;35
625;07.06.2018;2018;06;19;Torstai;12;15;27
625;07.06.2018;2018;06;20;Torstai;6;13;19
625;07.06.2018;2018;06;21;Torstai;5;12;17
625;07.06.2018;2018;06;22;Torstai;6;11;17
625;07.06.2018;2018;06;23;Torstai;4;2;6
625;08.06.2018;2018;06;00;Perjantai;2;2;4
625;08.06.2018;2018;06;01;Perjantai;0;0;0
625;08.06.2018;2018;06;02;Perjantai;1;0;1
625;08.06.2018;2018;06;03;Perjantai;1;0;1
625;08.06.2018;2018;06;04;Perjantai;0;0;0
625;08.06.2018;2018;06;05;Perjantai;0;2;2
625;08.06.2018;2018;06;06;Perjantai;4;6;10
625;08.06.2018;2018;06;07;Perjantai;17;12;29
625;08.06.2018;2018;06;08;Perjantai;14;13;27
625;08.06.2018;2018;06;09;Perjantai;33;24;57
625;08.06.2018;2018;06;10;Perjantai;6;10;16
625;08.06.2018;2018;06;11;Perjantai;11;2;13
625;08.06.2018;2018;06;12;Perjantai;4;8;12
625;08.06.2018;2018;06;13;Perjantai;12;10;22
625;08.06.2018;2018;06;14;Perjantai;11;8;19
625;08.06.2018;2018;06;15;Perjantai;15;21;36
625;08.06.2018;2018;06;16;Perjantai;19;26;45
625;08.06.2018;2018;06;17;Perjantai;33;36;69
625;08.06.2018;2018;06;18;Perjantai;6;22;28
625;08.06.2018;2018;06;19;Perjantai;8;11;19
625;08.06.2018;2018;06;20;Perjantai;9;12;21
625;08.06.2018;2018;06;21;Perjantai;5;9;14
625;08.06.2018;2018;06;22;Perjantai;5;6;11
625;08.06.2018;2018;06;23;Perjantai;5;1;6
625;09.06.2018;2018;06;00;Lauantai;3;3;6
625;09.06.2018;2018;06;01;Lauantai;0;2;2
625;09.06.2018;2018;06;02;Lauantai;1;0;1
625;09.06.2018;2018;06;03;Lauantai;1;0;1
625;09.06.2018;2018;06;04;Lauantai;0;2;2
625;09.06.2018;2018;06;05;Lauantai;0;2;2
625;09.06.2018;2018;06;06;Lauantai;5;0;5
625;09.06.2018;2018;06;07;Lauantai;9;0;9
625;09.06.2018;2018;06;08;Lauantai;36;0;36
625;09.06.2018;2018;06;09;Lauantai;12;0;12
625;09.06.2018;2018;06;10;Lauantai;41;0;41
625;09.06.2018;2018;06;11;Lauantai;33;0;33
625;09.06.2018;2018;06;12;Lauantai;35;0;35
625;09.06.2018;2018;06;13;Lauantai;44;0;44
625;09.06.2018;2018;06;14;Lauantai;34;0;34
625;09.06.2018;2018;06;15;Lauantai;43;0;43
625;09.06.2018;2018;06;16;Lauantai;19;0;19
625;09.06.2018;2018;06;17;Lauantai;32;0;32
625;09.06.2018;2018;06;18;Lauantai;45;0;45
625;09.06.2018;2018;06;19;Lauantai;32;0;32
625;09.06.2018;2018;06;20;Lauantai;36;0;36
625;09.06.2018;2018;06;21;Lauantai;25;0;25
625;09.06.2018;2018;06;22;Lauantai;16;0;16
625;09.06.2018;2018;06;23;Lauantai;12;0;12
625;10.06.2018;2018;06;00;Sunnuntai;4;0;4
625;10.06.2018;2018;06;01;Sunnuntai;5;0;5
625;10.06.2018;2018;06;02;Sunnuntai;2;0;2
625;10.06.2018;2018;06;03;Sunnuntai;1;0;1
625;10.06.2018;2018;06;04;Sunnuntai;0;0;0
625;10.06.2018;2018;06;05;Sunnuntai;2;0;2
625;10.06.2018;2018;06;06;Sunnuntai;4;0;4
625;10.06.2018;2018;06;07;Sunnuntai;2;0;2
625;10.06.2018;2018;06;08;Sunnuntai;3;0;3
625;10.06.2018;2018;06;09;Sunnuntai;5;0;5
625;10.06.2018;2018;06;10;Sunnuntai;15;0;15
625;10.06.2018;2018;06;11;Sunnuntai;12;0;12
625;10.06.2018;2018;06;12;Sunnuntai;16;0;16
625;10.06.2018;2018;06;13;Sunnuntai;28;0;28
625;10.06.2018;2018;06;14;Sunnuntai;26;0;26
625;10.06.2018;2018;06;15;Sunnuntai;39;0;39
625;10.06.2018;2018;06;16;Sunnuntai;40;0;40
625;10.06.2018;2018;06;17;Sunnuntai;46;0;46
625;10.06.2018;2018;06;18;Sunnuntai;24;0;24
625;10.06.2018;2018;06;19;Sunnuntai;23;0;23
625;10.06.2018;2018;06;20;Sunnuntai;16;0;16
625;10.06.2018;2018;06;21;Sunnuntai;9;0;9
625;10.06.2018;2018;06;22;Sunnuntai;9;0;9
625;10.06.2018;2018;06;23;Sunnuntai;4;0;4
625;11.06.2018;2018;06;00;Maanantai;0;5;5
625;11.06.2018;2018;06;01;Maanantai;2;3;5
625;11.06.2018;2018;06;02;Maanantai;0;0;0
625;11.06.2018;2018;06;03;Maanantai;1;0;1
625;11.06.2018;2018;06;04;Maanantai;0;1;1
625;11.06.2018;2018;06;05;Maanantai;1;1;2
625;11.06.2018;2018;06;06;Maanantai;7;7;14
625;11.06.2018;2018;06;07;Maanantai;12;13;25
625;11.06.2018;2018;06;08;Maanantai;40;22;62
625;11.06.2018;2018;06;09;Maanantai;28;29;57
625;11.06.2018;2018;06;10;Maanantai;6;10;16
625;11.06.2018;2018;06;11;Maanantai;6;12;18
625;11.06.2018;2018;06;12;Maanantai;8;6;14
625;11.06.2018;2018;06;13;Maanantai;17;10;27
625;11.06.2018;2018;06;14;Maanantai;18;20;38
625;11.06.2018;2018;06;15;Maanantai;17;23;40
625;11.06.2018;2018;06;16;Maanantai;27;41;68
625;11.06.2018;2018;06;17;Maanantai;36;41;77
625;11.06.2018;2018;06;18;Maanantai;27;35;62
625;11.06.2018;2018;06;19;Maanantai;23;27;50
625;11.06.2018;2018;06;20;Maanantai;17;12;29
625;11.06.2018;2018;06;21;Maanantai;8;20;28
625;11.06.2018;2018;06;22;Maanantai;8;8;16
625;11.06.2018;2018;06;23;Maanantai;7;8;15
625;12.06.2018;2018;06;00;Tiistai;0;5;5
625;12.06.2018;2018;06;01;Tiistai;2;3;5
625;12.06.2018;2018;06;02;Tiistai;0;0;0
625;12.06.2018;2018;06;03;Tiistai;1;0;1
625;12.06.2018;2018;06;04;Tiistai;0;1;1
625;12.06.2018;2018;06;05;Tiistai;1;1;2
625;12.06.2018;2018;06;06;Tiistai;7;7;14
625;12.06.2018;2018;06;07;Tiistai;12;13;25
625;12.06.2018;2018;06;08;Tiistai;40;22;62
625;12.06.2018;2018;06;09;Tiistai;28;29;57
625;12.06.2018;2018;06;10;Tiistai;6;10;16
625;12.06.2018;2018;06;11;Tiistai;6;12;18
625;12.06.2018;2018;06;12;Tiistai;8;6;14
625;12.06.2018;2018;06;13;Tiistai;14;15;29
625;12.06.2018;2018;06;14;Tiistai;14;17;31
625;12.06.2018;2018;06;15;Tiistai;16;20;36
625;12.06.2018;2018;06;16;Tiistai;16;32;48
625;12.06.2018;2018;06;17;Tiistai;34;50;84
625;12.06.2018;2018;06;18;Tiistai;18;31;49
625;12.06.2018;2018;06;19;Tiistai;8;13;21
625;12.06.2018;2018;06;20;Tiistai;9;13;22
625;12.06.2018;2018;06;21;Tiistai;6;15;21
625;12.06.2018;2018;06;22;Tiistai;8;7;15
625;12.06.2018;2018;06;23;Tiistai;3;1;4
625;13.06.2018;2018;06;00;Keskiviikko;0;1;1
625;13.06.2018;2018;06;01;Keskiviikko;0;0;0
625;13.06.2018;2018;06;02;Keskiviikko;0;1;1
625;13.06.2018;2018;06;03;Keskiviikko;1;0;1
625;13.06.2018;2018;06;04;Keskiviikko;0;0;0
625;13.06.2018;2018;06;05;Keskiviikko;0;2;2
625;13.06.2018;2018;06;06;Keskiviikko;4;10;14
625;13.06.2018;2018;06;07;Keskiviikko;22;8;30
625;13.06.2018;2018;06;08;Keskiviikko;22;22;44
625;13.06.2018;2018;06;09;Keskiviikko;21;21;42
625;13.06.2018;2018;06;10;Keskiviikko;9;11;20
625;13.06.2018;2018;06;11;Keskiviikko;10;9;19
625;13.06.2018;2018;06;12;Keskiviikko;7;8;15
625;13.06.2018;2018;06;13;Keskiviikko;9;10;19
625;13.06.2018;2018;06;14;Keskiviikko;12;16;28
625;13.06.2018;2018;06;15;Keskiviikko;19;17;36
625;13.06.2018;2018;06;16;Keskiviikko;22;27;49
625;13.06.2018;2018;06;17;Keskiviikko;20;43;63
625;13.06.2018;2018;06;18;Keskiviikko;28;27;55
625;13.06.2018;2018;06;19;Keskiviikko;15;19;34
625;13.06.2018;2018;06;20;Keskiviikko;8;6;14
625;13.06.2018;2018;06;21;Keskiviikko;10;12;22
625;13.06.2018;2018;06;22;Keskiviikko;10;12;22
625;13.06.2018;2018;06;23;Keskiviikko;6;4;10
625;14.06.2018;2018;06;00;Torstai;1;5;6
625;14.06.2018;2018;06;01;Torstai;4;3;7
625;14.06.2018;2018;06;02;Torstai;1;0;1
625;14.06.2018;2018;06;03;Torstai;2;2;4
625;14.06.2018;2018;06;04;Torstai;1;0;1
625;14.06.2018;2018;06;05;Torstai;2;1;3
625;14.06.2018;2018;06;06;Torstai;5;6;11
625;14.06.2018;2018;06;07;Torstai;20;9;29
625;14.06.2018;2018;06;08;Torstai;34;24;58
625;14.06.2018;2018;06;09;Torstai;14;14;28
625;14.06.2018;2018;06;10;Torstai;10;8;18
625;14.06.2018;2018;06;11;Torstai;8;8;16
625;14.06.2018;2018;06;12;Torstai;18;13;31
625;14.06.2018;2018;06;13;Torstai;16;16;32
625;14.06.2018;2018;06;14;Torstai;8;9;17
625;14.06.2018;2018;06;15;Torstai;23;17;40
625;14.06.2018;2018;06;16;Torstai;26;44;70
625;14.06.2018;2018;06;17;Torstai;41;36;77
625;14.06.2018;2018;06;18;Torstai;37;44;81
625;14.06.2018;2018;06;19;Torstai;20;29;49
625;14.06.2018;2018;06;20;Torstai;18;21;39
625;14.06.2018;2018;06;21;Torstai;14;11;25
625;14.06.2018;2018;06;22;Torstai;16;10;26
625;14.06.2018;2018;06;23;Torstai;4;3;7
625;15.06.2018;2018;06;00;Perjantai;1;1;2
625;15.06.2018;2018;06;01;Perjantai;4;0;4
625;15.06.2018;2018;06;02;Perjantai;1;0;1
625;15.06.2018;2018;06;03;Perjantai;1;0;1
625;15.06.2018;2018;06;04;Perjantai;3;4;7
625;15.06.2018;2018;06;05;Perjantai;0;1;1
625;15.06.2018;2018;06;06;Perjantai;5;8;13
625;15.06.2018;2018;06;07;Perjantai;18;9;27
625;15.06.2018;2018;06;08;Perjantai;16;13;29
625;15.06.2018;2018;06;09;Perjantai;31;19;50
625;15.06.2018;2018;06;10;Perjantai;5;9;14
625;15.06.2018;2018;06;11;Perjantai;18;8;26
625;15.06.2018;2018;06;12;Perjantai;8;14;22
625;15.06.2018;2018;06;13;Perjantai;15;18;33
625;15.06.2018;2018;06;14;Perjantai;12;17;29
625;15.06.2018;2018;06;15;Perjantai;15;17;32
625;15.06.2018;2018;06;16;Perjantai;16;27;43
625;15.06.2018;2018;06;17;Perjantai;29;29;58
625;15.06.2018;2018;06;18;Perjantai;16;24;40
625;15.06.2018;2018;06;19;Perjantai;19;20;39
625;15.06.2018;2018;06;20;Perjantai;20;17;37
625;15.06.2018;2018;06;21;Perjantai;13;21;34
625;15.06.2018;2018;06;22;Perjantai;12;5;17
625;15.06.2018;2018;06;23;Perjantai;6;6;12
625;16.06.2018;2018;06;00;Lauantai;6;2;8
625;16.06.2018;2018;06;01;Lauantai;2;0;2
625;16.06.2018;2018;06;02;Lauantai;1;0;1
625;16.06.2018;2018;06;03;Lauantai;1;0;1
625;16.06.2018;2018;06;04;Lauantai;2;0;2
625;16.06.2018;2018;06;05;Lauantai;2;0;2
625;16.06.2018;2018;06;06;Lauantai;5;0;5
625;16.06.2018;2018;06;07;Lauantai;9;0;9
625;16.06.2018;2018;06;08;Lauantai;36;0;36
625;16.06.2018;2018;06;09;Lauantai;12;0;12
625;16.06.2018;2018;06;10;Lauantai;41;0;41
625;16.06.2018;2018;06;11;Lauantai;33;0;33
625;16.06.2018;2018;06;12;Lauantai;35;0;35
625;16.06.2018;2018;06;13;Lauantai;44;0;44
625;16.06.2018;2018;06;14;Lauantai;34;0;34
625;16.06.2018;2018;06;15;Lauantai;43;0;43
625;16.06.2018;2018;06;16;Lauantai;19;0;19
625;16.06.2018;2018;06;17;Lauantai;32;0;32
625;16.06.2018;2018;06;18;Lauantai;45;0;45
625;16.06.2018;2018;06;19;Lauantai;32;0;32
625;16.06.2018;2018;06;20;Lauantai;36;0;36
625;16.06.2018;2018;06;21;Lauantai;25;0;25
625;16.06.2018;2018;06;22;Lauantai;16;0;16
625;16.06.2018;2018;06;23;Lauantai;12;0;12
625;17.06.2018;2018;06;00;Sunnuntai;4;0;4
625;17.06.2018;2018;06;01;Sunnuntai;5;0;5
625;17.06.2018;2018;06;02;Sunnuntai;2;0;2
625;17.06.2018;2018;06;03;Sunnuntai;1;0;1
625;17.06.2018;2018;06;04;Sunnuntai;0;0;0
625;17.06.2018;2018;06;05;Sunnuntai;2;0;2
625;17.06.2018;2018;06;06;Sunnuntai;4;0;4
625;17.06.2018;2018;06;07;Sunnuntai;2;0;2
625;17.06.2018;2018;06;08;Sunnuntai;3;0;3
625;17.06.2018;2018;06;09;Sunnuntai;5;0;5
625;17.06.2018;2018;06;10;Sunnuntai;15;0;15
625;17.06.2018;2018;06;11;Sunnuntai;12;0;12
625;17.06.2018;2018;06;12;Sunnuntai;16;0;16
625;17.06.2018;2018;06;13;Sunnuntai;28;0;28
625;17.06.2018;2018;06;14;Sunnuntai;26;0;26
625;17.06.2018;2018;06;15;Sunnuntai;39;0;39
625;17.06.2018;2018;06;16;Sunnuntai;40;0;40
625;17.06.2018;2018;06;17;Sunnuntai;46;0;46
625;17.06.2018;2018;06;18;Sunnuntai;24;0;24
625;17.06.2018;2018;06;19;Sunnuntai;23;0;23
625;17.06.2018;2018;06;20;Sunnuntai;16;0;16
625;17.06.2018;2018;06;21;Sunnuntai;9;0;9
625;17.06.2018;2018;06;22;Sunnuntai;9;0;9
625;17.06.2018;2018;06;23;Sunnuntai;4;0;4
625;18.06.2018;2018;06;00;Maanantai;5;0;5
625;18.06.2018;2018;06;01;Maanantai;5;0;5
625;18.06.2018;2018;06;02;Maanantai;0;0;0
625;18.06.2018;2018;06;03;Maanantai;1;0;1
625;18.06.2018;2018;06;04;Maanantai;1;0;1
625;18.06.2018;2018;06;05;Maanantai;2;0;2
625;18.06.2018;2018;06;06;Maanantai;14;0;14
625;18.06.2018;2018;06;07;Maanantai;25;0;25
625;18.06.2018;2018;06;08;Maanantai;62;0;62
625;18.06.2018;2018;06;09;Maanantai;57;0;57
625;18.06.2018;2018;06;10;Maanantai;16;0;16
625;18.06.2018;2018;06;11;Maanantai;18;0;18
625;18.06.2018;2018;06;12;Maanantai;14;0;14
625;18.06.2018;2018;06;13;Maanantai;27;0;27
625;18.06.2018;2018;06;14;Maanantai;38;0;38
625;18.06.2018;2018;06;15;Maanantai;40;0;40
625;18.06.2018;2018;06;16;Maanantai;68;0;68
625;18.06.2018;2018;06;17;Maanantai;77;0;77
625;18.06.2018;2018;06;18;Maanantai;62;0;62
625;18.06.2018;2018;06;19;Maanantai;50;0;50
625;18.06.2018;2018;06;20;Maanantai;29;0;29
625;18.06.2018;2018;06;21;Maanantai;28;0;28
625;18.06.2018;2018;06;22;Maanantai;16;0;16
625;18.06.2018;2018;06;23;Maanantai;15;0;15
625;19.06.2018;2018;06;00;Tiistai;5;0;5
625;19.06.2018;2018;06;01;Tiistai;5;0;5
625;19.06.2018;2018;06;02;Tiistai;0;0;0
625;19.06.2018;2018;06;03;Tiistai;1;0;1
625;19.06.2018;2018;06;04;Tiistai;1;0;1
625;19.06.2018;2018;06;05;Tiistai;2;0;2
625;19.06.2018;2018;06;06;Tiistai;14;0;14
625;19.06.2018;2018;06;07;Tiistai;25;0;25
625;19.06.2018;2018;06;08;Tiistai;62;0;62
625;19.06.2018;2018;06;09;Tiistai;57;0;57
625;19.06.2018;2018;06;10;Tiistai;16;0;16
625;19.06.2018;2018;06;11;Tiistai;18;0;18
625;19.06.2018;2018;06;12;Tiistai;14;0;14
625;19.06.2018;2018;06;13;Tiistai;29;0;29
625;19.06.2018;2018;06;14;Tiistai;31;0;31
625;19.06.2018;2018;06;15;Tiistai;36;0;36
625;19.06.2018;2018;06;16;Tiistai;48;0;48
625;19.06.2018;2018;06;17;Tiistai;84;0;84
625;19.06.2018;2018;06;18;Tiistai;49;0;49
625;19.06.2018;2018;06;19;Tiistai;21;0;21
625;19.06.2018;2018;06;20;Tiistai;22;0;22
625;19.06.2018;2018;06;21;Tiistai;21;0;21
625;19.06.2018;2018;06;22;Tiistai;15;0;15
625;19.06.2018;2018;06;23;Tiistai;4;0;4
625;20.06.2018;2018;06;00;Keskiviikko;1;0;1
625;20.06.2018;2018;06;01;Keskiviikko;0;0;0
625;20.06.2018;2018;06;02;Keskiviikko;1;0;1
625;20.06.2018;2018;06;03;Keskiviikko;1;0;1
625;20.06.2018;2018;06;04;Keskiviikko;0;0;0
625;20.06.2018;2018;06;05;Keskiviikko;2;0;2
625;20.06.2018;2018;06;06;Keskiviikko;14;0;14
625;20.06.2018;2018;06;07;Keskiviikko;30;0;30
625;20.06.2018;2018;06;08;Keskiviikko;44;0;44
625;20.06.2018;2018;06;09;Keskiviikko;42;0;42
625;20.06.2018;2018;06;10;Keskiviikko;20;0;20
625;20.06.2018;2018;06;11;Keskiviikko;19;0;19
625;20.06.2018;2018;06;12;Keskiviikko;15;0;15
625;20.06.2018;2018;06;13;Keskiviikko;19;0;19
625;20.06.2018;2018;06;14;Keskiviikko;28;0;28
625;20.06.2018;2018;06;15;Keskiviikko;13;13;26
625;20.06.2018;2018;06;16;Keskiviikko;27;43;70
625;20.06.2018;2018;06;17;Keskiviikko;29;31;60
625;20.06.2018;2018;06;18;Keskiviikko;17;21;38
625;20.06.2018;2018;06;19;Keskiviikko;18;15;33
625;20.06.2018;2018;06;20;Keskiviikko;7;14;21
625;20.06.2018;2018;06;21;Keskiviikko;13;15;28
625;20.06.2018;2018;06;22;Keskiviikko;5;10;15
625;20.06.2018;2018;06;23;Keskiviikko;7;3;10
625;21.06.2018;2018;06;00;Torstai;2;1;3
625;21.06.2018;2018;06;01;Torstai;1;0;1
625;21.06.2018;2018;06;02;Torstai;0;2;2
625;21.06.2018;2018;06;03;Torstai;1;1;2
625;21.06.2018;2018;06;04;Torstai;0;3;3
625;21.06.2018;2018;06;05;Torstai;0;0;0
625;21.06.2018;2018;06;06;Torstai;3;5;8
625;21.06.2018;2018;06;07;Torstai;11;5;16
625;21.06.2018;2018;06;08;Torstai;34;16;50
625;21.06.2018;2018;06;09;Torstai;5;12;17
625;21.06.2018;2018;06;10;Torstai;14;7;21
625;21.06.2018;2018;06;11;Torstai;9;14;23
625;21.06.2018;2018;06;12;Torstai;7;9;16
625;21.06.2018;2018;06;13;Torstai;16;20;36
625;21.06.2018;2018;06;14;Torstai;6;12;18
625;21.06.2018;2018;06;15;Torstai;21;22;43
625;21.06.2018;2018;06;16;Torstai;10;19;29
625;21.06.2018;2018;06;17;Torstai;19;15;34
625;21.06.2018;2018;06;18;Torstai;11;16;27
625;21.06.2018;2018;06;19;Torstai;9;17;26
625;21.06.2018;2018;06;20;Torstai;9;11;20
625;21.06.2018;2018;06;21;Torstai;7;6;13
625;21.06.2018;2018;06;22;Torstai;6;14;20
625;21.06.2018;2018;06;23;Torstai;6;2;8
625;22.06.2018;2018;06;00;Perjantai;4;2;6
625;22.06.2018;2018;06;01;Perjantai;1;2;3
625;22.06.2018;2018;06;02;Perjantai;0;0;0
625;22.06.2018;2018;06;03;Perjantai;0;1;1
625;22.06.2018;2018;06;04;Perjantai;0;0;0
625;22.06.2018;2018;06;05;Perjantai;0;0;0
625;22.06.2018;2018;06;06;Perjantai;0;2;2
625;22.06.2018;2018;06;07;Perjantai;0;1;1
625;22.06.2018;2018;06;08;Perjantai;2;3;5
625;22.06.2018;2018;06;09;Perjantai;1;0;1
625;22.06.2018;2018;06;10;Perjantai;1;1;2
625;22.06.2018;2018;06;11;Perjantai;1;0;1
625;22.06.2018;2018;06;12;Perjantai;0;0;0
625;22.06.2018;2018;06;13;Perjantai;0;2;2
625;22.06.2018;2018;06;14;Perjantai;5;2;7
625;22.06.2018;2018;06;15;Perjantai;1;4;5
625;22.06.2018;2018;06;16;Perjantai;1;2;3
625;22.06.2018;2018;06;17;Perjantai;3;0;3
625;22.06.2018;2018;06;18;Perjantai;2;1;3
625;22.06.2018;2018;06;19;Perjantai;1;3;4
625;22.06.2018;2018;06;20;Perjantai;3;8;11
625;22.06.2018;2018;06;21;Perjantai;1;3;4
625;22.06.2018;2018;06;22;Perjantai;4;0;4
625;22.06.2018;2018;06;23;Perjantai;7;4;11
625;23.06.2018;2018;06;00;Lauantai;0;2;2
625;23.06.2018;2018;06;01;Lauantai;2;1;3
625;23.06.2018;2018;06;02;Lauantai;1;1;2
625;23.06.2018;2018;06;03;Lauantai;0;1;1
625;23.06.2018;2018;06;04;Lauantai;0;6;6
625;23.06.2018;2018;06;05;Lauantai;0;0;0
625;23.06.2018;2018;06;06;Lauantai;0;2;2
625;23.06.2018;2018;06;07;Lauantai;3;1;4
625;23.06.2018;2018;06;08;Lauantai;1;2;3
625;23.06.2018;2018;06;09;Lauantai;1;1;2
625;23.06.2018;2018;06;10;Lauantai;1;3;4
625;23.06.2018;2018;06;11;Lauantai;0;1;1
625;23.06.2018;2018;06;12;Lauantai;2;0;2
625;23.06.2018;2018;06;13;Lauantai;4;3;7
625;23.06.2018;2018;06;14;Lauantai;2;2;4
625;23.06.2018;2018;06;15;Lauantai;6;6;12
625;23.06.2018;2018;06;16;Lauantai;4;10;14
625;23.06.2018;2018;06;17;Lauantai;4;6;10
625;23.06.2018;2018;06;18;Lauantai;4;8;12
625;23.06.2018;2018;06;19;Lauantai;6;6;12
625;23.06.2018;2018;06;20;Lauantai;2;2;4
625;23.06.2018;2018;06;21;Lauantai;7;4;11
625;23.06.2018;2018;06;22;Lauantai;5;1;6
625;23.06.2018;2018;06;23;Lauantai;1;2;3
625;24.06.2018;2018;06;00;Sunnuntai;0;2;2
625;24.06.2018;2018;06;01;Sunnuntai;1;0;1
625;24.06.2018;2018;06;02;Sunnuntai;1;1;2
625;24.06.2018;2018;06;03;Sunnuntai;0;0;0
625;24.06.2018;2018;06;04;Sunnuntai;1;0;1
625;24.06.2018;2018;06;05;Sunnuntai;0;1;1
625;24.06.2018;2018;06;06;Sunnuntai;0;0;0
625;24.06.2018;2018;06;07;Sunnuntai;2;1;3
625;24.06.2018;2018;06;08;Sunnuntai;4;2;6
625;24.06.2018;2018;06;09;Sunnuntai;0;0;0
625;24.06.2018;2018;06;10;Sunnuntai;9;6;15
625;24.06.2018;2018;06;11;Sunnuntai;7;5;12
625;24.06.2018;2018;06;12;Sunnuntai;6;8;14
625;24.06.2018;2018;06;13;Sunnuntai;11;14;25
625;24.06.2018;2018;06;14;Sunnuntai;15;14;29
625;24.06.2018;2018;06;15;Sunnuntai;22;29;51
625;24.06.2018;2018;06;16;Sunnuntai;24;22;46
625;24.06.2018;2018;06;17;Sunnuntai;17;17;34
625;24.06.2018;2018;06;18;Sunnuntai;11;17;28
625;24.06.2018;2018;06;19;Sunnuntai;19;16;35
625;24.06.2018;2018;06;20;Sunnuntai;7;6;13
625;24.06.2018;2018;06;21;Sunnuntai;13;8;21
625;24.06.2018;2018;06;22;Sunnuntai;6;5;11
625;24.06.2018;2018;06;23;Sunnuntai;3;3;6
625;25.06.2018;2018;06;00;Maanantai;2;1;3
625;25.06.2018;2018;06;01;Maanantai;1;0;1
625;25.06.2018;2018;06;02;Maanantai;1;0;1
625;25.06.2018;2018;06;03;Maanantai;0;0;0
625;25.06.2018;2018;06;04;Maanantai;0;1;1
625;25.06.2018;2018;06;05;Maanantai;1;0;1
625;25.06.2018;2018;06;06;Maanantai;6;8;14
625;25.06.2018;2018;06;07;Maanantai;19;8;27
625;25.06.2018;2018;06;08;Maanantai;23;22;45
625;25.06.2018;2018;06;09;Maanantai;25;14;39
625;25.06.2018;2018;06;10;Maanantai;8;9;17
625;25.06.2018;2018;06;11;Maanantai;11;3;14
625;25.06.2018;2018;06;12;Maanantai;20;15;35
625;25.06.2018;2018;06;13;Maanantai;25;24;49
625;25.06.2018;2018;06;14;Maanantai;24;41;65
625;25.06.2018;2018;06;15;Maanantai;23;31;54
625;25.06.2018;2018;06;16;Maanantai;24;41;65
625;25.06.2018;2018;06;17;Maanantai;27;34;61
625;25.06.2018;2018;06;18;Maanantai;23;27;50
625;25.06.2018;2018;06;19;Maanantai;16;34;50
625;25.06.2018;2018;06;20;Maanantai;20;16;36
625;25.06.2018;2018;06;21;Maanantai;12;13;25
625;25.06.2018;2018;06;22;Maanantai;11;11;22
625;25.06.2018;2018;06;23;Maanantai;5;4;9
625;26.06.2018;2018;06;00;Tiistai;1;1;2
625;26.06.2018;2018;06;01;Tiistai;1;0;1
625;26.06.2018;2018;06;02;Tiistai;1;0;1
625;26.06.2018;2018;06;03;Tiistai;1;0;1
625;26.06.2018;2018;06;04;Tiistai;2;1;3
625;26.06.2018;2018;06;05;Tiistai;1;0;1
625;26.06.2018;2018;06;06;Tiistai;8;7;15
625;26.06.2018;2018;06;07;Tiistai;17;8;25
625;26.06.2018;2018;06;08;Tiistai;26;11;37
625;26.06.2018;2018;06;09;Tiistai;21;18;39
625;26.06.2018;2018;06;10;Tiistai;11;12;23
625;26.06.2018;2018;06;11;Tiistai;19;11;30
625;26.06.2018;2018;06;12;Tiistai;10;21;31
625;26.06.2018;2018;06;13;Tiistai;17;19;36
625;26.06.2018;2018;06;14;Tiistai;14;25;39
625;26.06.2018;2018;06;15;Tiistai;24;29;53
625;26.06.2018;2018;06;16;Tiistai;23;34;57
625;26.06.2018;2018;06;17;Tiistai;27;40;67
625;26.06.2018;2018;06;18;Tiistai;23;30;53
625;26.06.2018;2018;06;19;Tiistai;26;18;44
625;26.06.2018;2018;06;20;Tiistai;18;23;41
625;26.06.2018;2018;06;21;Tiistai;11;18;29
625;26.06.2018;2018;06;22;Tiistai;5;10;15
625;26.06.2018;2018;06;23;Tiistai;7;5;12
625;27.06.2018;2018;06;00;Keskiviikko;2;1;3
625;27.06.2018;2018;06;01;Keskiviikko;1;3;4
625;27.06.2018;2018;06;02;Keskiviikko;0;3;3
625;27.06.2018;2018;06;03;Keskiviikko;1;0;1
625;27.06.2018;2018;06;04;Keskiviikko;0;0;0
625;27.06.2018;2018;06;05;Keskiviikko;0;1;1
625;27.06.2018;2018;06;06;Keskiviikko;5;7;12
625;27.06.2018;2018;06;07;Keskiviikko;15;6;21
625;27.06.2018;2018;06;08;Keskiviikko;28;18;46
625;27.06.2018;2018;06;09;Keskiviikko;18;14;32
625;27.06.2018;2018;06;10;Keskiviikko;8;7;15
625;27.06.2018;2018;06;11;Keskiviikko;7;5;12
625;27.06.2018;2018;06;12;Keskiviikko;23;16;39
625;27.06.2018;2018;06;13;Keskiviikko;13;8;21
625;27.06.2018;2018;06;14;Keskiviikko;22;21;43
625;27.06.2018;2018;06;15;Keskiviikko;24;24;48
625;27.06.2018;2018;06;16;Keskiviikko;26;39;65
625;27.06.2018;2018;06;17;Keskiviikko;24;35;59
625;27.06.2018;2018;06;18;Keskiviikko;17;28;45
625;27.06.2018;2018;06;19;Keskiviikko;19;17;36
625;27.06.2018;2018;06;20;Keskiviikko;5;20;25
625;27.06.2018;2018;06;21;Keskiviikko;15;16;31
625;27.06.2018;2018;06;22;Keskiviikko;12;7;19
625;27.06.2018;2018;06;23;Keskiviikko;4;1;5
625;28.06.2018;2018;06;00;Torstai;3;3;6
625;28.06.2018;2018;06;01;Torstai;1;1;2
625;28.06.2018;2018;06;02;Torstai;4;0;4
625;28.06.2018;2018;06;03;Torstai;0;0;0
625;28.06.2018;2018;06;04;Torstai;0;0;0
625;28.06.2018;2018;06;05;Torstai;0;0;0
625;28.06.2018;2018;06;06;Torstai;4;6;10
625;28.06.2018;2018;06;07;Torstai;12;3;15
625;28.06.2018;2018;06;08;Torstai;14;12;26
625;28.06.2018;2018;06;09;Torstai;12;6;18
625;28.06.2018;2018;06;10;Torstai;11;12;23
625;28.06.2018;2018;06;11;Torstai;1;1;2
625;28.06.2018;2018;06;12;Torstai;2;4;6
625;28.06.2018;2018;06;13;Torstai;6;4;10
625;28.06.2018;2018;06;14;Torstai;2;8;10
625;28.06.2018;2018;06;15;Torstai;19;22;41
625;28.06.2018;2018;06;16;Torstai;5;14;19
625;28.06.2018;2018;06;17;Torstai;11;10;21
625;28.06.2018;2018;06;18;Torstai;8;8;16
625;28.06.2018;2018;06;19;Torstai;5;1;6
625;28.06.2018;2018;06;20;Torstai;3;7;10
625;28.06.2018;2018;06;21;Torstai;2;2;4
625;28.06.2018;2018;06;22;Torstai;4;4;8
625;28.06.2018;2018;06;23;Torstai;1;0;1
625;29.06.2018;2018;06;00;Perjantai;1;3;4
625;29.06.2018;2018;06;01;Perjantai;0;0;0
625;29.06.2018;2018;06;02;Perjantai;0;0;0
625;29.06.2018;2018;06;03;Perjantai;0;0;0
625;29.06.2018;2018;06;04;Perjantai;1;0;1
625;29.06.2018;2018;06;05;Perjantai;0;0;0
625;29.06.2018;2018;06;06;Perjantai;1;4;5
625;29.06.2018;2018;06;07;Perjantai;10;3;13
625;29.06.2018;2018;06;08;Perjantai;9;13;22
625;29.06.2018;2018;06;09;Perjantai;17;13;30
625;29.06.2018;2018;06;10;Perjantai;6;6;12
625;29.06.2018;2018;06;11;Perjantai;11;4;15
625;29.06.2018;2018;06;12;Perjantai;4;6;10
625;29.06.2018;2018;06;13;Perjantai;12;12;24
625;29.06.2018;2018;06;14;Perjantai;14;11;25
625;29.06.2018;2018;06;15;Perjantai;15;16;31
625;29.06.2018;2018;06;16;Perjantai;13;15;28
625;29.06.2018;2018;06;17;Perjantai;18;14;32
625;29.06.2018;2018;06;18;Perjantai;10;13;23
625;29.06.2018;2018;06;19;Perjantai;11;11;22
625;29.06.2018;2018;06;20;Perjantai;6;5;11
625;29.06.2018;2018;06;21;Perjantai;8;6;14
625;29.06.2018;2018;06;22;Perjantai;6;7;13
625;29.06.2018;2018;06;23;Perjantai;6;3;9
625;30.06.2018;2018;06;00;Lauantai;3;2;5
625;30.06.2018;2018;06;01;Lauantai;1;0;1
625;30.06.2018;2018;06;02;Lauantai;1;0;1
625;30.06.2018;2018;06;03;Lauantai;0;1;1
625;30.06.2018;2018;06;04;Lauantai;0;0;0
625;30.06.2018;2018;06;05;Lauantai;0;0;0
625;30.06.2018;2018;06;06;Lauantai;1;1;2
625;30.06.2018;2018;06;07;Lauantai;4;2;6
625;30.06.2018;2018;06;08;Lauantai;2;4;6
625;30.06.2018;2018;06;09;Lauantai;3;2;5
625;30.06.2018;2018;06;10;Lauantai;4;8;12
625;30.06.2018;2018;06;11;Lauantai;4;3;7
625;30.06.2018;2018;06;12;Lauantai;12;17;29
625;30.06.2018;2018;06;13;Lauantai;7;12;19
625;30.06.2018;2018;06;14;Lauantai;11;11;22
625;30.06.2018;2018;06;15;Lauantai;8;13;21
625;30.06.2018;2018;06;16;Lauantai;11;9;20
625;30.06.2018;2018;06;17;Lauantai;8;12;20
625;30.06.2018;2018;06;18;Lauantai;7;5;12
625;30.06.2018;2018;06;19;Lauantai;10;9;19
625;30.06.2018;2018;06;20;Lauantai;8;9;17
625;30.06.2018;2018;06;21;Lauantai;11;9;20
625;30.06.2018;2018;06;22;Lauantai;4;4;8
625;30.06.2018;2018;06;23;Lauantai;2;2;4
625;01.07.2018;2018;07;00;Sunnuntai;3;4;7
625;01.07.2018;2018;07;01;Sunnuntai;3;1;4
625;01.07.2018;2018;07;02;Sunnuntai;2;0;2
625;01.07.2018;2018;07;03;Sunnuntai;0;0;0
625;01.07.2018;2018;07;04;Sunnuntai;1;2;3
625;01.07.2018;2018;07;05;Sunnuntai;0;0;0
625;01.07.2018;2018;07;06;Sunnuntai;0;1;1
625;01.07.2018;2018;07;07;Sunnuntai;3;4;7
625;01.07.2018;2018;07;08;Sunnuntai;2;4;6
625;01.07.2018;2018;07;09;Sunnuntai;2;1;3
625;01.07.2018;2018;07;10;Sunnuntai;5;2;7
625;01.07.2018;2018;07;11;Sunnuntai;10;10;20
625;01.07.2018;2018;07;12;Sunnuntai;13;11;24
625;01.07.2018;2018;07;13;Sunnuntai;16;12;28
625;01.07.2018;2018;07;14;Sunnuntai;21;30;51
625;01.07.2018;2018;07;15;Sunnuntai;12;27;39
625;01.07.2018;2018;07;16;Sunnuntai;19;17;36
625;01.07.2018;2018;07;17;Sunnuntai;19;17;36
625;01.07.2018;2018;07;18;Sunnuntai;16;29;45
625;01.07.2018;2018;07;19;Sunnuntai;7;14;21
625;01.07.2018;2018;07;20;Sunnuntai;9;14;23
625;01.07.2018;2018;07;21;Sunnuntai;19;13;32
625;01.07.2018;2018;07;22;Sunnuntai;6;5;11
625;01.07.2018;2018;07;23;Sunnuntai;3;3;6
625;02.07.2018;2018;07;00;Maanantai;5;1;6
625;02.07.2018;2018;07;01;Maanantai;1;0;1
625;02.07.2018;2018;07;02;Maanantai;0;0;0
625;02.07.2018;2018;07;03;Maanantai;0;0;0
625;02.07.2018;2018;07;04;Maanantai;0;1;1
625;02.07.2018;2018;07;05;Maanantai;0;0;0
625;02.07.2018;2018;07;06;Maanantai;3;2;5
625;02.07.2018;2018;07;07;Maanantai;12;12;24
625;02.07.2018;2018;07;08;Maanantai;22;18;40
625;02.07.2018;2018;07;09;Maanantai;16;12;28
625;02.07.2018;2018;07;10;Maanantai;16;8;24
625;02.07.2018;2018;07;11;Maanantai;6;8;14
625;02.07.2018;2018;07;12;Maanantai;16;14;30
625;02.07.2018;2018;07;13;Maanantai;27;18;45
625;02.07.2018;2018;07;14;Maanantai;18;35;53
625;02.07.2018;2018;07;15;Maanantai;12;21;33
625;02.07.2018;2018;07;16;Maanantai;17;29;46
625;02.07.2018;2018;07;17;Maanantai;29;38;67
625;02.07.2018;2018;07;18;Maanantai;21;28;49
625;02.07.2018;2018;07;19;Maanantai;26;28;54
625;02.07.2018;2018;07;20;Maanantai;24;31;55
625;02.07.2018;2018;07;21;Maanantai;15;22;37
625;02.07.2018;2018;07;22;Maanantai;17;8;25
625;02.07.2018;2018;07;23;Maanantai;11;2;13
625;03.07.2018;2018;07;00;Tiistai;1;2;3
625;03.07.2018;2018;07;01;Tiistai;2;1;3
625;03.07.2018;2018;07;02;Tiistai;0;0;0
625;03.07.2018;2018;07;03;Tiistai;0;1;1
625;03.07.2018;2018;07;04;Tiistai;0;0;0
625;03.07.2018;2018;07;05;Tiistai;2;1;3
625;03.07.2018;2018;07;06;Tiistai;5;5;10
625;03.07.2018;2018;07;07;Tiistai;14;9;23
625;03.07.2018;2018;07;08;Tiistai;18;18;36
625;03.07.2018;2018;07;09;Tiistai;17;17;34
625;03.07.2018;2018;07;10;Tiistai;18;8;26
625;03.07.2018;2018;07;11;Tiistai;9;10;19
625;03.07.2018;2018;07;12;Tiistai;13;20;33
625;03.07.2018;2018;07;13;Tiistai;20;19;39
625;03.07.2018;2018;07;14;Tiistai;16;17;33
625;03.07.2018;2018;07;15;Tiistai;13;22;35
625;03.07.2018;2018;07;16;Tiistai;21;31;52
625;03.07.2018;2018;07;17;Tiistai;20;31;51
625;03.07.2018;2018;07;18;Tiistai;29;31;60
625;03.07.2018;2018;07;19;Tiistai;10;19;29
625;03.07.2018;2018;07;20;Tiistai;19;13;32
625;03.07.2018;2018;07;21;Tiistai;10;10;20
625;03.07.2018;2018;07;22;Tiistai;12;15;27
625;03.07.2018;2018;07;23;Tiistai;10;4;14
625;04.07.2018;2018;07;00;Keskiviikko;0;1;1
625;04.07.2018;2018;07;01;Keskiviikko;3;0;3
625;04.07.2018;2018;07;02;Keskiviikko;0;0;0
625;04.07.2018;2018;07;03;Keskiviikko;0;0;0
625;04.07.2018;2018;07;04;Keskiviikko;0;0;0
625;04.07.2018;2018;07;05;Keskiviikko;0;0;0
625;04.07.2018;2018;07;06;Keskiviikko;0;0;0
625;04.07.2018;2018;07;07;Keskiviikko;0;0;0
625;04.07.2018;2018;07;08;Keskiviikko;0;0;0
625;04.07.2018;2018;07;09;Keskiviikko;35;27;62
625;04.07.2018;2018;07;10;Keskiviikko;9;5;14
625;04.07.2018;2018;07;11;Keskiviikko;1;5;6
625;04.07.2018;2018;07;12;Keskiviikko;7;4;11
625;04.07.2018;2018;07;13;Keskiviikko;3;5;8
625;04.07.2018;2018;07;14;Keskiviikko;3;9;12
625;04.07.2018;2018;07;15;Keskiviikko;11;10;21
625;04.07.2018;2018;07;16;Keskiviikko;7;14;21
625;04.07.2018;2018;07;17;Keskiviikko;6;19;25
625;04.07.2018;2018;07;18;Keskiviikko;14;21;35
625;04.07.2018;2018;07;19;Keskiviikko;14;13;27
625;04.07.2018;2018;07;20;Keskiviikko;12;15;27
625;04.07.2018;2018;07;21;Keskiviikko;10;13;23
625;04.07.2018;2018;07;22;Keskiviikko;13;11;24
625;04.07.2018;2018;07;23;Keskiviikko;8;3;11
625;05.07.2018;2018;07;00;Torstai;2;0;2
625;05.07.2018;2018;07;01;Torstai;0;0;0
625;05.07.2018;2018;07;02;Torstai;1;0;1
625;05.07.2018;2018;07;03;Torstai;0;0;0
625;05.07.2018;2018;07;04;Torstai;2;1;3
625;05.07.2018;2018;07;05;Torstai;0;1;1
625;05.07.2018;2018;07;06;Torstai;4;6;10
625;05.07.2018;2018;07;07;Torstai;16;10;26
625;05.07.2018;2018;07;08;Torstai;28;19;47
625;05.07.2018;2018;07;09;Torstai;12;13;25
625;05.07.2018;2018;07;10;Torstai;14;12;26
625;05.07.2018;2018;07;11;Torstai;12;13;25
625;05.07.2018;2018;07;12;Torstai;8;8;16
625;05.07.2018;2018;07;13;Torstai;13;18;31
625;05.07.2018;2018;07;14;Torstai;21;19;40
625;05.07.2018;2018;07;15;Torstai;27;18;45
625;05.07.2018;2018;07;16;Torstai;27;26;53
625;05.07.2018;2018;07;17;Torstai;19;23;42
625;05.07.2018;2018;07;18;Torstai;14;14;28
625;05.07.2018;2018;07;19;Torstai;9;9;18
625;05.07.2018;2018;07;20;Torstai;8;10;18
625;05.07.2018;2018;07;21;Torstai;11;8;19
625;05.07.2018;2018;07;22;Torstai;7;10;17
625;05.07.2018;2018;07;23;Torstai;6;1;7
625;06.07.2018;2018;07;00;Perjantai;0;1;1
625;06.07.2018;2018;07;01;Perjantai;3;1;4
625;06.07.2018;2018;07;02;Perjantai;0;0;0
625;06.07.2018;2018;07;03;Perjantai;2;0;2
625;06.07.2018;2018;07;04;Perjantai;0;0;0
625;06.07.2018;2018;07;05;Perjantai;0;1;1
625;06.07.2018;2018;07;06;Perjantai;3;5;8
625;06.07.2018;2018;07;07;Perjantai;9;6;15
625;06.07.2018;2018;07;08;Perjantai;14;10;24
625;06.07.2018;2018;07;09;Perjantai;16;16;32
625;06.07.2018;2018;07;10;Perjantai;11;18;29
625;06.07.2018;2018;07;11;Perjantai;9;7;16
625;06.07.2018;2018;07;12;Perjantai;19;15;34
625;06.07.2018;2018;07;13;Perjantai;18;27;45
625;06.07.2018;2018;07;14;Perjantai;16;8;24
625;06.07.2018;2018;07;15;Perjantai;22;15;37
625;06.07.2018;2018;07;16;Perjantai;19;39;58
625;06.07.2018;2018;07;17;Perjantai;19;23;42
625;06.07.2018;2018;07;18;Perjantai;16;30;46
625;06.07.2018;2018;07;19;Perjantai;12;18;30
625;06.07.2018;2018;07;20;Perjantai;18;15;33
625;06.07.2018;2018;07;21;Perjantai;14;15;29
625;06.07.2018;2018;07;22;Perjantai;16;16;32
625;06.07.2018;2018;07;23;Perjantai;4;6;10
625;07.07.2018;2018;07;00;Lauantai;4;5;9
625;07.07.2018;2018;07;01;Lauantai;2;1;3
625;07.07.2018;2018;07;02;Lauantai;0;3;3
625;07.07.2018;2018;07;03;Lauantai;2;1;3
625;07.07.2018;2018;07;04;Lauantai;2;0;2
625;07.07.2018;2018;07;05;Lauantai;2;1;3
625;07.07.2018;2018;07;06;Lauantai;0;2;2
625;07.07.2018;2018;07;07;Lauantai;3;2;5
625;07.07.2018;2018;07;08;Lauantai;1;3;4
625;07.07.2018;2018;07;09;Lauantai;5;3;8
625;07.07.2018;2018;07;10;Lauantai;12;12;24
625;07.07.2018;2018;07;11;Lauantai;4;10;14
625;07.07.2018;2018;07;12;Lauantai;19;13;32
625;07.07.2018;2018;07;13;Lauantai;19;22;41
625;07.07.2018;2018;07;14;Lauantai;35;36;71
625;07.07.2018;2018;07;15;Lauantai;23;14;37
625;07.07.2018;2018;07;16;Lauantai;21;17;38
625;07.07.2018;2018;07;17;Lauantai;14;18;32
625;07.07.2018;2018;07;18;Lauantai;15;17;32
625;07.07.2018;2018;07;19;Lauantai;13;15;28
625;07.07.2018;2018;07;20;Lauantai;11;22;33
625;07.07.2018;2018;07;21;Lauantai;15;11;26
625;07.07.2018;2018;07;22;Lauantai;8;9;17
625;07.07.2018;2018;07;23;Lauantai;5;10;15
625;08.07.2018;2018;07;00;Sunnuntai;2;2;4
625;08.07.2018;2018;07;01;Sunnuntai;1;1;2
625;08.07.2018;2018;07;02;Sunnuntai;0;2;2
625;08.07.2018;2018;07;03;Sunnuntai;1;0;1
625;08.07.2018;2018;07;04;Sunnuntai;0;1;1
625;08.07.2018;2018;07;05;Sunnuntai;1;1;2
625;08.07.2018;2018;07;06;Sunnuntai;0;2;2
625;08.07.2018;2018;07;07;Sunnuntai;1;1;2
625;08.07.2018;2018;07;08;Sunnuntai;0;3;3
625;08.07.2018;2018;07;09;Sunnuntai;3;0;3
625;08.07.2018;2018;07;10;Sunnuntai;5;3;8
625;08.07.2018;2018;07;11;Sunnuntai;5;7;12
625;08.07.2018;2018;07;12;Sunnuntai;20;12;32
625;08.07.2018;2018;07;13;Sunnuntai;11;22;33
625;08.07.2018;2018;07;14;Sunnuntai;31;30;61
625;08.07.2018;2018;07;15;Sunnuntai;14;19;33
625;08.07.2018;2018;07;16;Sunnuntai;21;28;49
625;08.07.2018;2018;07;17;Sunnuntai;22;21;43
625;08.07.2018;2018;07;18;Sunnuntai;18;23;41
625;08.07.2018;2018;07;19;Sunnuntai;17;22;39
625;08.07.2018;2018;07;20;Sunnuntai;19;15;34
625;08.07.2018;2018;07;21;Sunnuntai;13;10;23
625;08.07.2018;2018;07;22;Sunnuntai;10;4;14
625;08.07.2018;2018;07;23;Sunnuntai;4;5;9
625;06.08.2018;2018;08;00;Maanantai;0;0;0
625;06.08.2018;2018;08;01;Maanantai;0;0;0
625;06.08.2018;2018;08;02;Maanantai;0;0;0
625;06.08.2018;2018;08;03;Maanantai;0;0;0
625;06.08.2018;2018;08;04;Maanantai;0;0;0
625;06.08.2018;2018;08;05;Maanantai;0;0;0
625;06.08.2018;2018;08;06;Maanantai;5;5;10
625;06.08.2018;2018;08;07;Maanantai;10;5;15
625;06.08.2018;2018;08;08;Maanantai;10;10;20
625;06.08.2018;2018;08;09;Maanantai;14;4;18
625;06.08.2018;2018;08;10;Maanantai;12;6;18
625;06.08.2018;2018;08;11;Maanantai;4;8;12
625;06.08.2018;2018;08;12;Maanantai;4;4;8
625;06.08.2018;2018;08;13;Maanantai;5;7;12
625;06.08.2018;2018;08;14;Maanantai;4;7;11
625;06.08.2018;2018;08;15;Maanantai;11;13;24
625;06.08.2018;2018;08;16;Maanantai;22;24;46
625;06.08.2018;2018;08;17;Maanantai;15;30;45
625;06.08.2018;2018;08;18;Maanantai;13;13;26
625;06.08.2018;2018;08;19;Maanantai;11;20;31
625;06.08.2018;2018;08;20;Maanantai;10;11;21
625;06.08.2018;2018;08;21;Maanantai;16;21;37
625;06.08.2018;2018;08;22;Maanantai;9;6;15
625;06.08.2018;2018;08;23;Maanantai;7;4;11
625;07.08.2018;2018;08;00;Tiistai;2;0;2
625;07.08.2018;2018;08;01;Tiistai;0;1;1
625;07.08.2018;2018;08;02;Tiistai;0;1;1
625;07.08.2018;2018;08;03;Tiistai;0;0;0
625;07.08.2018;2018;08;04;Tiistai;0;2;2
625;07.08.2018;2018;08;05;Tiistai;0;1;1
625;07.08.2018;2018;08;06;Tiistai;3;7;10
625;07.08.2018;2018;08;07;Tiistai;10;8;18
625;07.08.2018;2018;08;08;Tiistai;33;15;48
625;07.08.2018;2018;08;09;Tiistai;22;23;45
625;07.08.2018;2018;08;10;Tiistai;7;3;10
625;07.08.2018;2018;08;11;Tiistai;9;13;22
625;07.08.2018;2018;08;12;Tiistai;18;16;34
625;07.08.2018;2018;08;13;Tiistai;20;30;50
625;07.08.2018;2018;08;14;Tiistai;19;18;37
625;07.08.2018;2018;08;15;Tiistai;14;14;28
625;07.08.2018;2018;08;16;Tiistai;23;35;58
625;07.08.2018;2018;08;17;Tiistai;46;50;96
625;07.08.2018;2018;08;18;Tiistai;24;24;48
625;07.08.2018;2018;08;19;Tiistai;18;33;51
625;07.08.2018;2018;08;20;Tiistai;18;29;47
625;07.08.2018;2018;08;21;Tiistai;8;11;19
625;07.08.2018;2018;08;22;Tiistai;6;9;15
625;07.08.2018;2018;08;23;Tiistai;12;4;16
625;08.08.2018;2018;08;00;Keskiviikko;3;2;5
625;08.08.2018;2018;08;01;Keskiviikko;1;2;3
625;08.08.2018;2018;08;02;Keskiviikko;0;0;0
625;08.08.2018;2018;08;03;Keskiviikko;1;1;2
625;08.08.2018;2018;08;04;Keskiviikko;0;1;1
625;08.08.2018;2018;08;05;Keskiviikko;0;2;2
625;08.08.2018;2018;08;06;Keskiviikko;8;14;22
625;08.08.2018;2018;08;07;Keskiviikko;20;11;31
625;08.08.2018;2018;08;08;Keskiviikko;39;24;63
625;08.08.2018;2018;08;09;Keskiviikko;35;26;61
625;08.08.2018;2018;08;10;Keskiviikko;25;12;37
625;08.08.2018;2018;08;11;Keskiviikko;21;18;39
625;08.08.2018;2018;08;12;Keskiviikko;18;15;33
625;08.08.2018;2018;08;13;Keskiviikko;24;28;52
625;08.08.2018;2018;08;14;Keskiviikko;27;25;52
625;08.08.2018;2018;08;15;Keskiviikko;22;40;62
625;08.08.2018;2018;08;16;Keskiviikko;32;57;89
625;08.08.2018;2018;08;17;Keskiviikko;58;59;117
625;08.08.2018;2018;08;18;Keskiviikko;32;28;60
625;08.08.2018;2018;08;19;Keskiviikko;22;24;46
625;08.08.2018;2018;08;20;Keskiviikko;23;15;38
625;08.08.2018;2018;08;21;Keskiviikko;16;14;30
625;08.08.2018;2018;08;22;Keskiviikko;8;8;16
625;08.08.2018;2018;08;23;Keskiviikko;3;2;5
625;09.08.2018;2018;08;00;Torstai;3;3;6
625;09.08.2018;2018;08;01;Torstai;1;0;1
625;09.08.2018;2018;08;02;Torstai;1;0;1
625;09.08.2018;2018;08;03;Torstai;0;0;0
625;09.08.2018;2018;08;04;Torstai;0;2;2
625;09.08.2018;2018;08;05;Torstai;1;0;1
625;09.08.2018;2018;08;06;Torstai;4;4;8
625;09.08.2018;2018;08;07;Torstai;13;6;19
625;09.08.2018;2018;08;08;Torstai;28;11;39
625;09.08.2018;2018;08;09;Torstai;52;21;73
625;09.08.2018;2018;08;10;Torstai;50;24;74
625;09.08.2018;2018;08;11;Torstai;14;10;24
625;09.08.2018;2018;08;12;Torstai;11;6;17
625;09.08.2018;2018;08;13;Torstai;23;51;74
625;09.08.2018;2018;08;14;Torstai;17;23;40
625;09.08.2018;2018;08;15;Torstai;17;33;50
625;09.08.2018;2018;08;16;Torstai;21;43;64
625;09.08.2018;2018;08;17;Torstai;23;41;64
625;09.08.2018;2018;08;18;Torstai;18;39;57
625;09.08.2018;2018;08;19;Torstai;34;34;68
625;09.08.2018;2018;08;20;Torstai;23;22;45
625;09.08.2018;2018;08;21;Torstai;10;14;24
625;09.08.2018;2018;08;22;Torstai;10;15;25
625;09.08.2018;2018;08;23;Torstai;10;5;15
625;10.08.2018;2018;08;00;Perjantai;4;2;6
625;10.08.2018;2018;08;01;Perjantai;2;2;4
625;10.08.2018;2018;08;02;Perjantai;0;0;0
625;10.08.2018;2018;08;03;Perjantai;0;0;0
625;10.08.2018;2018;08;04;Perjantai;0;1;1
625;10.08.2018;2018;08;05;Perjantai;0;0;0
625;10.08.2018;2018;08;06;Perjantai;4;6;10
625;10.08.2018;2018;08;07;Perjantai;20;9;29
625;10.08.2018;2018;08;08;Perjantai;85;35;120
625;10.08.2018;2018;08;09;Perjantai;48;36;84
625;10.08.2018;2018;08;10;Perjantai;16;14;30
625;10.08.2018;2018;08;11;Perjantai;10;12;22
625;10.08.2018;2018;08;12;Perjantai;24;64;88
625;10.08.2018;2018;08;13;Perjantai;22;33;55
625;10.08.2018;2018;08;14;Perjantai;19;25;44
625;10.08.2018;2018;08;15;Perjantai;31;36;67
625;10.08.2018;2018;08;16;Perjantai;35;46;81
625;10.08.2018;2018;08;17;Perjantai;33;46;79
625;10.08.2018;2018;08;18;Perjantai;16;23;39
625;10.08.2018;2018;08;19;Perjantai;13;15;28
625;10.08.2018;2018;08;20;Perjantai;14;14;28
625;10.08.2018;2018;08;21;Perjantai;5;3;8
625;10.08.2018;2018;08;22;Perjantai;3;1;4
625;10.08.2018;2018;08;23;Perjantai;2;0;2
625;11.08.2018;2018;08;00;Lauantai;2;3;5
625;11.08.2018;2018;08;01;Lauantai;3;2;5
625;11.08.2018;2018;08;02;Lauantai;3;4;7
625;11.08.2018;2018;08;03;Lauantai;1;0;1
625;11.08.2018;2018;08;04;Lauantai;1;1;2
625;11.08.2018;2018;08;05;Lauantai;3;1;4
625;11.08.2018;2018;08;06;Lauantai;0;1;1
625;11.08.2018;2018;08;07;Lauantai;1;0;1
625;11.08.2018;2018;08;08;Lauantai;3;0;3
625;11.08.2018;2018;08;09;Lauantai;6;5;11
625;11.08.2018;2018;08;10;Lauantai;5;6;11
625;11.08.2018;2018;08;11;Lauantai;8;5;13
625;11.08.2018;2018;08;12;Lauantai;7;10;17
625;11.08.2018;2018;08;13;Lauantai;10;16;26
625;11.08.2018;2018;08;14;Lauantai;9;14;23
625;11.08.2018;2018;08;15;Lauantai;9;6;15
625;11.08.2018;2018;08;16;Lauantai;9;17;26
625;11.08.2018;2018;08;17;Lauantai;12;11;23
625;11.08.2018;2018;08;18;Lauantai;7;17;24
625;11.08.2018;2018;08;19;Lauantai;10;7;17
625;11.08.2018;2018;08;20;Lauantai;11;11;22
625;11.08.2018;2018;08;21;Lauantai;5;5;10
625;11.08.2018;2018;08;22;Lauantai;8;8;16
625;11.08.2018;2018;08;23;Lauantai;3;3;6
625;12.08.2018;2018;08;00;Sunnuntai;1;3;4
625;12.08.2018;2018;08;01;Sunnuntai;4;6;10
625;12.08.2018;2018;08;02;Sunnuntai;0;1;1
625;12.08.2018;2018;08;03;Sunnuntai;1;2;3
625;12.08.2018;2018;08;04;Sunnuntai;0;0;0
625;12.08.2018;2018;08;05;Sunnuntai;0;1;1
625;12.08.2018;2018;08;06;Sunnuntai;1;1;2
625;12.08.2018;2018;08;07;Sunnuntai;1;1;2
625;12.08.2018;2018;08;08;Sunnuntai;0;1;1
625;12.08.2018;2018;08;09;Sunnuntai;3;3;6
625;12.08.2018;2018;08;10;Sunnuntai;7;1;8
625;12.08.2018;2018;08;11;Sunnuntai;12;9;21
625;12.08.2018;2018;08;12;Sunnuntai;15;13;28
625;12.08.2018;2018;08;13;Sunnuntai;16;10;26
625;12.08.2018;2018;08;14;Sunnuntai;18;21;39
625;12.08.2018;2018;08;15;Sunnuntai;24;29;53
625;12.08.2018;2018;08;16;Sunnuntai;26;16;42
625;12.08.2018;2018;08;17;Sunnuntai;13;20;33
625;12.08.2018;2018;08;18;Sunnuntai;12;14;26
625;12.08.2018;2018;08;19;Sunnuntai;18;30;48
625;12.08.2018;2018;08;20;Sunnuntai;11;9;20
625;12.08.2018;2018;08;21;Sunnuntai;5;13;18
625;12.08.2018;2018;08;22;Sunnuntai;8;6;14
625;12.08.2018;2018;08;23;Sunnuntai;4;1;5
625;13.08.2018;2018;08;00;Maanantai;2;0;2
625;13.08.2018;2018;08;01;Maanantai;1;1;2
625;13.08.2018;2018;08;02;Maanantai;0;1;1
625;13.08.2018;2018;08;03;Maanantai;0;0;0
625;13.08.2018;2018;08;04;Maanantai;1;0;1
625;13.08.2018;2018;08;05;Maanantai;0;1;1
625;13.08.2018;2018;08;06;Maanantai;2;4;6
625;13.08.2018;2018;08;07;Maanantai;11;5;16
625;13.08.2018;2018;08;08;Maanantai;58;20;78
625;13.08.2018;2018;08;09;Maanantai;48;30;78
625;13.08.2018;2018;08;10;Maanantai;37;9;46
625;13.08.2018;2018;08;11;Maanantai;19;2;21
625;13.08.2018;2018;08;12;Maanantai;14;17;31
625;13.08.2018;2018;08;13;Maanantai;9;27;36
625;13.08.2018;2018;08;14;Maanantai;5;17;22
625;13.08.2018;2018;08;15;Maanantai;32;69;101
625;13.08.2018;2018;08;16;Maanantai;22;30;52
625;13.08.2018;2018;08;17;Maanantai;35;56;91
625;13.08.2018;2018;08;18;Maanantai;27;38;65
625;13.08.2018;2018;08;19;Maanantai;12;9;21
625;13.08.2018;2018;08;20;Maanantai;9;18;27
625;13.08.2018;2018;08;21;Maanantai;15;11;26
625;13.08.2018;2018;08;22;Maanantai;12;14;26
625;13.08.2018;2018;08;23;Maanantai;7;0;7
625;14.08.2018;2018;08;00;Tiistai;2;1;3
625;14.08.2018;2018;08;01;Tiistai;0;0;0
625;14.08.2018;2018;08;02;Tiistai;0;2;2
625;14.08.2018;2018;08;03;Tiistai;0;0;0
625;14.08.2018;2018;08;04;Tiistai;0;0;0
625;14.08.2018;2018;08;05;Tiistai;0;0;0
625;14.08.2018;2018;08;06;Tiistai;3;6;9
625;14.08.2018;2018;08;07;Tiistai;18;12;30
625;14.08.2018;2018;08;08;Tiistai;96;46;142
625;14.08.2018;2018;08;09;Tiistai;40;28;68
625;14.08.2018;2018;08;10;Tiistai;55;13;68
625;14.08.2018;2018;08;11;Tiistai;15;2;17
625;14.08.2018;2018;08;12;Tiistai;6;10;16
625;14.08.2018;2018;08;13;Tiistai;13;24;37
625;14.08.2018;2018;08;14;Tiistai;18;49;67
625;14.08.2018;2018;08;15;Tiistai;30;68;98
625;14.08.2018;2018;08;16;Tiistai;36;48;84
625;14.08.2018;2018;08;17;Tiistai;29;57;86
625;14.08.2018;2018;08;18;Tiistai;24;30;54
625;14.08.2018;2018;08;19;Tiistai;18;24;42
625;14.08.2018;2018;08;20;Tiistai;17;19;36
625;14.08.2018;2018;08;21;Tiistai;22;24;46
625;14.08.2018;2018;08;22;Tiistai;17;16;33
625;14.08.2018;2018;08;23;Tiistai;9;2;11
625;15.08.2018;2018;08;00;Keskiviikko;0;1;1
625;15.08.2018;2018;08;01;Keskiviikko;0;0;0
625;15.08.2018;2018;08;02;Keskiviikko;0;1;1
625;15.08.2018;2018;08;03;Keskiviikko;0;0;0
625;15.08.2018;2018;08;04;Keskiviikko;0;0;0
625;15.08.2018;2018;08;05;Keskiviikko;1;0;1
625;15.08.2018;2018;08;06;Keskiviikko;4;7;11
625;15.08.2018;2018;08;07;Keskiviikko;22;10;32
625;15.08.2018;2018;08;08;Keskiviikko;103;64;167
625;15.08.2018;2018;08;09;Keskiviikko;40;19;59
625;15.08.2018;2018;08;10;Keskiviikko;25;11;36
625;15.08.2018;2018;08;11;Keskiviikko;10;9;19
625;15.08.2018;2018;08;12;Keskiviikko;7;10;17
625;15.08.2018;2018;08;13;Keskiviikko;17;20;37
625;15.08.2018;2018;08;14;Keskiviikko;31;51;82
625;15.08.2018;2018;08;15;Keskiviikko;34;52;86
625;15.08.2018;2018;08;16;Keskiviikko;30;50;80
625;15.08.2018;2018;08;17;Keskiviikko;46;56;102
625;15.08.2018;2018;08;18;Keskiviikko;26;29;55
625;15.08.2018;2018;08;19;Keskiviikko;34;37;71
625;15.08.2018;2018;08;20;Keskiviikko;7;10;17
625;15.08.2018;2018;08;21;Keskiviikko;7;14;21
625;15.08.2018;2018;08;22;Keskiviikko;7;14;21
625;15.08.2018;2018;08;23;Keskiviikko;6;3;9
625;16.08.2018;2018;08;00;Torstai;2;1;3
625;16.08.2018;2018;08;01;Torstai;0;1;1
625;16.08.2018;2018;08;02;Torstai;1;0;1
625;16.08.2018;2018;08;03;Torstai;0;0;0
625;16.08.2018;2018;08;04;Torstai;0;1;1
625;16.08.2018;2018;08;05;Torstai;1;0;1
625;16.08.2018;2018;08;06;Torstai;5;6;11
625;16.08.2018;2018;08;07;Torstai;22;12;34
625;16.08.2018;2018;08;08;Torstai;102;47;149
625;16.08.2018;2018;08;09;Torstai;44;31;75
625;16.08.2018;2018;08;10;Torstai;22;15;37
625;16.08.2018;2018;08;11;Torstai;15;12;27
625;16.08.2018;2018;08;12;Torstai;15;19;34
625;16.08.2018;2018;08;13;Torstai;8;19;27
625;16.08.2018;2018;08;14;Torstai;18;45;63
625;16.08.2018;2018;08;15;Torstai;16;48;64
625;16.08.2018;2018;08;16;Torstai;37;69;106
625;16.08.2018;2018;08;17;Torstai;32;34;66
625;16.08.2018;2018;08;18;Torstai;29;28;57
625;16.08.2018;2018;08;19;Torstai;20;34;54
625;16.08.2018;2018;08;20;Torstai;14;22;36
625;16.08.2018;2018;08;21;Torstai;17;7;24
625;16.08.2018;2018;08;22;Torstai;12;17;29
625;16.08.2018;2018;08;23;Torstai;11;5;16
625;17.08.2018;2018;08;00;Perjantai;3;0;3
625;17.08.2018;2018;08;01;Perjantai;1;1;2
625;17.08.2018;2018;08;02;Perjantai;1;0;1
625;17.08.2018;2018;08;03;Perjantai;1;0;1
625;17.08.2018;2018;08;04;Perjantai;0;0;0
625;17.08.2018;2018;08;05;Perjantai;0;0;0
625;17.08.2018;2018;08;06;Perjantai;3;3;6
625;17.08.2018;2018;08;07;Perjantai;8;8;16
625;17.08.2018;2018;08;08;Perjantai;98;48;146
625;17.08.2018;2018;08;09;Perjantai;32;27;59
625;17.08.2018;2018;08;10;Perjantai;15;15;30
625;17.08.2018;2018;08;11;Perjantai;8;11;19
625;17.08.2018;2018;08;12;Perjantai;12;19;31
625;17.08.2018;2018;08;13;Perjantai;15;31;46
625;17.08.2018;2018;08;14;Perjantai;25;47;72
625;17.08.2018;2018;08;15;Perjantai;31;42;73
625;17.08.2018;2018;08;16;Perjantai;34;38;72
625;17.08.2018;2018;08;17;Perjantai;42;32;74
625;17.08.2018;2018;08;18;Perjantai;19;19;38
625;17.08.2018;2018;08;19;Perjantai;11;28;39
625;17.08.2018;2018;08;20;Perjantai;8;9;17
625;17.08.2018;2018;08;21;Perjantai;6;8;14
625;17.08.2018;2018;08;22;Perjantai;5;6;11
625;17.08.2018;2018;08;23;Perjantai;5;1;6
625;18.08.2018;2018;08;00;Lauantai;2;1;3
625;18.08.2018;2018;08;01;Lauantai;1;0;1
625;18.08.2018;2018;08;02;Lauantai;0;0;0
625;18.08.2018;2018;08;03;Lauantai;1;0;1
625;18.08.2018;2018;08;04;Lauantai;0;0;0
625;18.08.2018;2018;08;05;Lauantai;1;0;1
625;18.08.2018;2018;08;06;Lauantai;0;1;1
625;18.08.2018;2018;08;07;Lauantai;0;4;4
625;18.08.2018;2018;08;08;Lauantai;3;2;5
625;18.08.2018;2018;08;09;Lauantai;2;1;3
625;18.08.2018;2018;08;10;Lauantai;5;6;11
625;18.08.2018;2018;08;11;Lauantai;8;9;17
625;18.08.2018;2018;08;12;Lauantai;10;7;17
625;18.08.2018;2018;08;13;Lauantai;15;16;31
625;18.08.2018;2018;08;14;Lauantai;21;19;40
625;18.08.2018;2018;08;15;Lauantai;11;18;29
625;18.08.2018;2018;08;16;Lauantai;13;23;36
625;18.08.2018;2018;08;17;Lauantai;11;8;19
625;18.08.2018;2018;08;18;Lauantai;8;16;24
625;18.08.2018;2018;08;19;Lauantai;7;15;22
625;18.08.2018;2018;08;20;Lauantai;8;9;17
625;18.08.2018;2018;08;21;Lauantai;8;10;18
625;18.08.2018;2018;08;22;Lauantai;5;10;15
625;18.08.2018;2018;08;23;Lauantai;8;3;11
625;19.08.2018;2018;08;00;Sunnuntai;3;4;7
625;19.08.2018;2018;08;01;Sunnuntai;1;1;2
625;19.08.2018;2018;08;02;Sunnuntai;2;2;4
625;19.08.2018;2018;08;03;Sunnuntai;0;0;0
625;19.08.2018;2018;08;04;Sunnuntai;0;2;2
625;19.08.2018;2018;08;05;Sunnuntai;1;0;1
625;19.08.2018;2018;08;06;Sunnuntai;0;2;2
625;19.08.2018;2018;08;07;Sunnuntai;0;3;3
625;19.08.2018;2018;08;08;Sunnuntai;0;1;1
625;19.08.2018;2018;08;09;Sunnuntai;1;3;4
625;19.08.2018;2018;08;10;Sunnuntai;5;3;8
625;19.08.2018;2018;08;11;Sunnuntai;7;6;13
625;19.08.2018;2018;08;12;Sunnuntai;9;8;17
625;19.08.2018;2018;08;13;Sunnuntai;9;9;18
625;19.08.2018;2018;08;14;Sunnuntai;14;14;28
625;19.08.2018;2018;08;15;Sunnuntai;8;14;22
625;19.08.2018;2018;08;16;Sunnuntai;10;14;24
625;19.08.2018;2018;08;17;Sunnuntai;14;14;28
625;19.08.2018;2018;08;18;Sunnuntai;10;5;15
625;19.08.2018;2018;08;19;Sunnuntai;9;8;17
625;19.08.2018;2018;08;20;Sunnuntai;8;7;15
625;19.08.2018;2018;08;21;Sunnuntai;6;9;15
625;19.08.2018;2018;08;22;Sunnuntai;8;7;15
625;19.08.2018;2018;08;23;Sunnuntai;1;2;3
625;20.08.2018;2018;08;00;Maanantai;1;0;1
625;20.08.2018;2018;08;01;Maanantai;0;0;0
625;20.08.2018;2018;08;02;Maanantai;0;0;0
625;20.08.2018;2018;08;03;Maanantai;0;0;0
625;20.08.2018;2018;08;04;Maanantai;0;0;0
625;20.08.2018;2018;08;05;Maanantai;2;0;2
625;20.08.2018;2018;08;06;Maanantai;1;5;6
625;20.08.2018;2018;08;07;Maanantai;21;13;34
625;20.08.2018;2018;08;08;Maanantai;84;30;114
625;20.08.2018;2018;08;09;Maanantai;30;21;51
625;20.08.2018;2018;08;10;Maanantai;36;13;49
625;20.08.2018;2018;08;11;Maanantai;17;4;21
625;20.08.2018;2018;08;12;Maanantai;9;8;17
625;20.08.2018;2018;08;13;Maanantai;15;20;35
625;20.08.2018;2018;08;14;Maanantai;22;33;55
625;20.08.2018;2018;08;15;Maanantai;21;50;71
625;20.08.2018;2018;08;16;Maanantai;28;53;81
625;20.08.2018;2018;08;17;Maanantai;44;48;92
625;20.08.2018;2018;08;18;Maanantai;24;21;45
625;20.08.2018;2018;08;19;Maanantai;14;15;29
625;20.08.2018;2018;08;20;Maanantai;6;20;26
625;20.08.2018;2018;08;21;Maanantai;5;9;14
625;20.08.2018;2018;08;22;Maanantai;6;8;14
625;20.08.2018;2018;08;23;Maanantai;7;6;13
625;21.08.2018;2018;08;00;Tiistai;0;0;0
625;21.08.2018;2018;08;01;Tiistai;0;0;0
625;21.08.2018;2018;08;02;Tiistai;0;1;1
625;21.08.2018;2018;08;03;Tiistai;1;0;1
625;21.08.2018;2018;08;04;Tiistai;0;1;1
625;21.08.2018;2018;08;05;Tiistai;2;0;2
625;21.08.2018;2018;08;06;Tiistai;3;4;7
625;21.08.2018;2018;08;07;Tiistai;18;10;28
625;21.08.2018;2018;08;08;Tiistai;92;38;130
625;21.08.2018;2018;08;09;Tiistai;46;24;70
625;21.08.2018;2018;08;10;Tiistai;30;11;41
625;21.08.2018;2018;08;11;Tiistai;13;14;27
625;21.08.2018;2018;08;12;Tiistai;20;16;36
625;21.08.2018;2018;08;13;Tiistai;16;16;32
625;21.08.2018;2018;08;14;Tiistai;30;50;80
625;21.08.2018;2018;08;15;Tiistai;20;56;76
625;21.08.2018;2018;08;16;Tiistai;33;62;95
625;21.08.2018;2018;08;17;Tiistai;41;58;99
625;21.08.2018;2018;08;18;Tiistai;31;29;60
625;21.08.2018;2018;08;19;Tiistai;11;20;31
625;21.08.2018;2018;08;20;Tiistai;10;10;20
625;21.08.2018;2018;08;21;Tiistai;6;10;16
625;21.08.2018;2018;08;22;Tiistai;6;11;17
625;21.08.2018;2018;08;23;Tiistai;5;1;6
625;22.08.2018;2018;08;00;Keskiviikko;0;0;0
625;22.08.2018;2018;08;01;Keskiviikko;0;0;0
625;22.08.2018;2018;08;02;Keskiviikko;1;0;1
625;22.08.2018;2018;08;03;Keskiviikko;1;0;1
625;22.08.2018;2018;08;04;Keskiviikko;0;0;0
625;22.08.2018;2018;08;05;Keskiviikko;1;0;1
625;22.08.2018;2018;08;06;Keskiviikko;1;2;3
625;22.08.2018;2018;08;07;Keskiviikko;21;11;32
625;22.08.2018;2018;08;08;Keskiviikko;88;40;128
625;22.08.2018;2018;08;09;Keskiviikko;50;26;76
625;22.08.2018;2018;08;10;Keskiviikko;25;4;29
625;22.08.2018;2018;08;11;Keskiviikko;11;9;20
625;22.08.2018;2018;08;12;Keskiviikko;12;17;29
625;22.08.2018;2018;08;13;Keskiviikko;14;20;34
625;22.08.2018;2018;08;14;Keskiviikko;15;33;48
625;22.08.2018;2018;08;15;Keskiviikko;32;53;85
625;22.08.2018;2018;08;16;Keskiviikko;36;49;85
625;22.08.2018;2018;08;17;Keskiviikko;48;55;103
625;22.08.2018;2018;08;18;Keskiviikko;15;17;32
625;22.08.2018;2018;08;19;Keskiviikko;9;17;26
625;22.08.2018;2018;08;20;Keskiviikko;8;11;19
625;22.08.2018;2018;08;21;Keskiviikko;3;5;8
625;22.08.2018;2018;08;22;Keskiviikko;8;3;11
625;22.08.2018;2018;08;23;Keskiviikko;5;1;6
625;23.08.2018;2018;08;00;Torstai;1;1;2
625;23.08.2018;2018;08;01;Torstai;0;0;0
625;23.08.2018;2018;08;02;Torstai;0;0;0
625;23.08.2018;2018;08;03;Torstai;0;0;0
625;23.08.2018;2018;08;04;Torstai;0;1;1
625;23.08.2018;2018;08;05;Torstai;1;0;1
625;23.08.2018;2018;08;06;Torstai;3;3;6
625;23.08.2018;2018;08;07;Torstai;15;6;21
625;23.08.2018;2018;08;08;Torstai;59;19;78
625;23.08.2018;2018;08;09;Torstai;36;17;53
625;23.08.2018;2018;08;10;Torstai;15;5;20
625;23.08.2018;2018;08;11;Torstai;8;5;13
625;23.08.2018;2018;08;12;Torstai;5;7;12
625;23.08.2018;2018;08;13;Torstai;5;9;14
625;23.08.2018;2018;08;14;Torstai;8;29;37
625;23.08.2018;2018;08;15;Torstai;14;25;39
625;23.08.2018;2018;08;16;Torstai;14;32;46
625;23.08.2018;2018;08;17;Torstai;15;17;32
625;23.08.2018;2018;08;18;Torstai;14;15;29
625;23.08.2018;2018;08;19;Torstai;15;19;34
625;23.08.2018;2018;08;20;Torstai;16;19;35
625;23.08.2018;2018;08;21;Torstai;4;6;10
625;23.08.2018;2018;08;22;Torstai;11;8;19
625;23.08.2018;2018;08;23;Torstai;4;2;6
625;24.08.2018;2018;08;00;Perjantai;2;0;2
625;24.08.2018;2018;08;01;Perjantai;0;0;0
625;24.08.2018;2018;08;02;Perjantai;0;0;0
625;24.08.2018;2018;08;03;Perjantai;1;0;1
625;24.08.2018;2018;08;04;Perjantai;0;1;1
625;24.08.2018;2018;08;05;Perjantai;0;0;0
625;24.08.2018;2018;08;06;Perjantai;1;3;4
625;24.08.2018;2018;08;07;Perjantai;14;5;19
625;24.08.2018;2018;08;08;Perjantai;66;19;85
625;24.08.2018;2018;08;09;Perjantai;33;18;51
625;24.08.2018;2018;08;10;Perjantai;14;11;25
625;24.08.2018;2018;08;11;Perjantai;3;6;9
625;24.08.2018;2018;08;12;Perjantai;7;7;14
625;24.08.2018;2018;08;13;Perjantai;8;11;19
625;24.08.2018;2018;08;14;Perjantai;11;27;38
625;24.08.2018;2018;08;15;Perjantai;9;21;30
625;24.08.2018;2018;08;16;Perjantai;11;20;31
625;24.08.2018;2018;08;17;Perjantai;14;22;36
625;24.08.2018;2018;08;18;Perjantai;11;13;24
625;24.08.2018;2018;08;19;Perjantai;8;8;16
625;24.08.2018;2018;08;20;Perjantai;7;14;21
625;24.08.2018;2018;08;21;Perjantai;4;8;12
625;24.08.2018;2018;08;22;Perjantai;4;3;7
625;24.08.2018;2018;08;23;Perjantai;2;1;3
625;25.08.2018;2018;08;00;Lauantai;1;1;2
625;25.08.2018;2018;08;01;Lauantai;0;1;1
625;25.08.2018;2018;08;02;Lauantai;1;0;1
625;25.08.2018;2018;08;03;Lauantai;0;1;1
625;25.08.2018;2018;08;04;Lauantai;0;0;0
625;25.08.2018;2018;08;05;Lauantai;0;0;0
625;25.08.2018;2018;08;06;Lauantai;1;0;1
625;25.08.2018;2018;08;07;Lauantai;2;2;4
625;25.08.2018;2018;08;08;Lauantai;0;0;0
625;25.08.2018;2018;08;09;Lauantai;1;0;1
625;25.08.2018;2018;08;10;Lauantai;2;2;4
625;25.08.2018;2018;08;11;Lauantai;2;3;5
625;25.08.2018;2018;08;12;Lauantai;1;3;4
625;25.08.2018;2018;08;13;Lauantai;2;8;10
625;25.08.2018;2018;08;14;Lauantai;11;8;19
625;25.08.2018;2018;08;15;Lauantai;2;15;17
625;25.08.2018;2018;08;16;Lauantai;14;26;40
625;25.08.2018;2018;08;17;Lauantai;7;8;15
625;25.08.2018;2018;08;18;Lauantai;7;9;16
625;25.08.2018;2018;08;19;Lauantai;12;15;27
625;25.08.2018;2018;08;20;Lauantai;7;8;15
625;25.08.2018;2018;08;21;Lauantai;5;4;9
625;25.08.2018;2018;08;22;Lauantai;5;6;11
625;25.08.2018;2018;08;23;Lauantai;4;1;5
625;26.08.2018;2018;08;00;Sunnuntai;1;2;3
625;26.08.2018;2018;08;01;Sunnuntai;1;2;3
625;26.08.2018;2018;08;02;Sunnuntai;0;0;0
625;26.08.2018;2018;08;03;Sunnuntai;2;0;2
625;26.08.2018;2018;08;04;Sunnuntai;0;1;1
625;26.08.2018;2018;08;05;Sunnuntai;0;0;0
625;26.08.2018;2018;08;06;Sunnuntai;1;1;2
625;26.08.2018;2018;08;07;Sunnuntai;1;1;2
625;26.08.2018;2018;08;08;Sunnuntai;1;1;2
625;26.08.2018;2018;08;09;Sunnuntai;1;1;2
625;26.08.2018;2018;08;10;Sunnuntai;8;3;11
625;26.08.2018;2018;08;11;Sunnuntai;10;11;21
625;26.08.2018;2018;08;12;Sunnuntai;8;6;14
625;26.08.2018;2018;08;13;Sunnuntai;9;14;23
625;26.08.2018;2018;08;14;Sunnuntai;14;11;25
625;26.08.2018;2018;08;15;Sunnuntai;5;11;16
625;26.08.2018;2018;08;16;Sunnuntai;9;6;15
625;26.08.2018;2018;08;17;Sunnuntai;3;6;9
625;26.08.2018;2018;08;18;Sunnuntai;6;4;10
625;26.08.2018;2018;08;19;Sunnuntai;3;9;12
625;26.08.2018;2018;08;20;Sunnuntai;6;6;12
625;26.08.2018;2018;08;21;Sunnuntai;6;4;10
625;26.08.2018;2018;08;22;Sunnuntai;2;4;6
625;26.08.2018;2018;08;23;Sunnuntai;0;1;1
625;27.08.2018;2018;08;00;Maanantai;2;0;2
625;27.08.2018;2018;08;01;Maanantai;0;0;0
625;27.08.2018;2018;08;02;Maanantai;0;0;0
625;27.08.2018;2018;08;03;Maanantai;0;0;0
625;27.08.2018;2018;08;04;Maanantai;0;0;0
625;27.08.2018;2018;08;05;Maanantai;1;0;1
625;27.08.2018;2018;08;06;Maanantai;3;4;7
625;27.08.2018;2018;08;07;Maanantai;15;7;22
625;27.08.2018;2018;08;08;Maanantai;60;23;83
625;27.08.2018;2018;08;09;Maanantai;50;23;73
625;27.08.2018;2018;08;10;Maanantai;16;12;28
625;27.08.2018;2018;08;11;Maanantai;16;7;23
625;27.08.2018;2018;08;12;Maanantai;8;7;15
625;27.08.2018;2018;08;13;Maanantai;12;17;29
625;27.08.2018;2018;08;14;Maanantai;12;30;42
625;27.08.2018;2018;08;15;Maanantai;12;28;40
625;27.08.2018;2018;08;16;Maanantai;16;45;61
625;27.08.2018;2018;08;17;Maanantai;27;39;66
625;27.08.2018;2018;08;18;Maanantai;13;16;29
625;27.08.2018;2018;08;19;Maanantai;12;19;31
625;27.08.2018;2018;08;20;Maanantai;12;12;24
625;27.08.2018;2018;08;21;Maanantai;8;7;15
625;27.08.2018;2018;08;22;Maanantai;6;4;10
625;27.08.2018;2018;08;23;Maanantai;1;4;5
625;28.08.2018;2018;08;00;Tiistai;1;1;2
625;28.08.2018;2018;08;01;Tiistai;1;0;1
625;28.08.2018;2018;08;02;Tiistai;0;0;0
625;28.08.2018;2018;08;03;Tiistai;0;1;1
625;28.08.2018;2018;08;04;Tiistai;0;0;0
625;28.08.2018;2018;08;05;Tiistai;0;0;0
625;28.08.2018;2018;08;06;Tiistai;3;3;6
625;28.08.2018;2018;08;07;Tiistai;21;11;32
625;28.08.2018;2018;08;08;Tiistai;77;38;115
625;28.08.2018;2018;08;09;Tiistai;44;24;68
625;28.08.2018;2018;08;10;Tiistai;22;14;36
625;28.08.2018;2018;08;11;Tiistai;19;9;28
625;28.08.2018;2018;08;12;Tiistai;7;12;19
625;28.08.2018;2018;08;13;Tiistai;14;22;36
625;28.08.2018;2018;08;14;Tiistai;18;42;60
625;28.08.2018;2018;08;15;Tiistai;33;58;91
625;28.08.2018;2018;08;16;Tiistai;22;41;63
625;28.08.2018;2018;08;17;Tiistai;31;39;70
625;28.08.2018;2018;08;18;Tiistai;31;17;48
625;28.08.2018;2018;08;19;Tiistai;17;23;40
625;28.08.2018;2018;08;20;Tiistai;6;14;20
625;28.08.2018;2018;08;21;Tiistai;11;13;24
625;28.08.2018;2018;08;22;Tiistai;4;13;17
625;28.08.2018;2018;08;23;Tiistai;5;1;6
625;29.08.2018;2018;08;00;Keskiviikko;0;1;1
625;29.08.2018;2018;08;01;Keskiviikko;0;0;0
625;29.08.2018;2018;08;02;Keskiviikko;0;0;0
625;29.08.2018;2018;08;03;Keskiviikko;0;0;0
625;29.08.2018;2018;08;04;Keskiviikko;0;0;0
625;29.08.2018;2018;08;05;Keskiviikko;0;0;0
625;29.08.2018;2018;08;06;Keskiviikko;3;4;7
625;29.08.2018;2018;08;07;Keskiviikko;16;7;23
625;29.08.2018;2018;08;08;Keskiviikko;63;31;94
625;29.08.2018;2018;08;09;Keskiviikko;43;32;75
625;29.08.2018;2018;08;10;Keskiviikko;19;5;24
625;29.08.2018;2018;08;11;Keskiviikko;19;10;29
625;29.08.2018;2018;08;12;Keskiviikko;12;10;22
625;29.08.2018;2018;08;13;Keskiviikko;16;21;37
625;29.08.2018;2018;08;14;Keskiviikko;12;33;45
625;29.08.2018;2018;08;15;Keskiviikko;15;36;51
625;29.08.2018;2018;08;16;Keskiviikko;29;48;77
625;29.08.2018;2018;08;17;Keskiviikko;28;50;78
625;29.08.2018;2018;08;18;Keskiviikko;35;35;70
625;29.08.2018;2018;08;19;Keskiviikko;6;20;26
625;29.08.2018;2018;08;20;Keskiviikko;13;19;32
625;29.08.2018;2018;08;21;Keskiviikko;5;8;13
625;29.08.2018;2018;08;22;Keskiviikko;7;5;12
625;29.08.2018;2018;08;23;Keskiviikko;2;2;4
625;30.08.2018;2018;08;00;Torstai;1;1;2
625;30.08.2018;2018;08;01;Torstai;1;2;3
625;30.08.2018;2018;08;02;Torstai;0;0;0
625;30.08.2018;2018;08;03;Torstai;0;1;1
625;30.08.2018;2018;08;04;Torstai;0;0;0
625;30.08.2018;2018;08;05;Torstai;0;1;1
625;30.08.2018;2018;08;06;Torstai;3;4;7
625;30.08.2018;2018;08;07;Torstai;9;2;11
625;30.08.2018;2018;08;08;Torstai;64;25;89
625;30.08.2018;2018;08;09;Torstai;36;17;53
625;30.08.2018;2018;08;10;Torstai;23;3;26
625;30.08.2018;2018;08;11;Torstai;12;9;21
625;30.08.2018;2018;08;12;Torstai;8;8;16
625;30.08.2018;2018;08;13;Torstai;13;25;38
625;30.08.2018;2018;08;14;Torstai;16;21;37
625;30.08.2018;2018;08;15;Torstai;21;29;50
625;30.08.2018;2018;08;16;Torstai;16;55;71
625;30.08.2018;2018;08;17;Torstai;31;50;81
625;30.08.2018;2018;08;18;Torstai;17;11;28
625;30.08.2018;2018;08;19;Torstai;14;19;33
625;30.08.2018;2018;08;20;Torstai;7;6;13
625;30.08.2018;2018;08;21;Torstai;5;8;13
625;30.08.2018;2018;08;22;Torstai;2;5;7
625;30.08.2018;2018;08;23;Torstai;3;1;4
625;31.08.2018;2018;08;00;Perjantai;1;0;1
625;31.08.2018;2018;08;01;Perjantai;0;1;1
625;31.08.2018;2018;08;02;Perjantai;1;1;2
625;31.08.2018;2018;08;03;Perjantai;0;1;1
625;31.08.2018;2018;08;04;Perjantai;0;0;0
625;31.08.2018;2018;08;05;Perjantai;0;1;1
625;31.08.2018;2018;08;06;Perjantai;2;5;7
625;31.08.2018;2018;08;07;Perjantai;13;6;19
625;31.08.2018;2018;08;08;Perjantai;48;23;71
625;31.08.2018;2018;08;09;Perjantai;46;22;68
625;31.08.2018;2018;08;10;Perjantai;19;11;30
625;31.08.2018;2018;08;11;Perjantai;10;7;17
625;31.08.2018;2018;08;12;Perjantai;10;11;21
625;31.08.2018;2018;08;13;Perjantai;12;24;36
625;31.08.2018;2018;08;14;Perjantai;13;24;37
625;31.08.2018;2018;08;15;Perjantai;20;28;48
625;31.08.2018;2018;08;16;Perjantai;14;41;55
625;31.08.2018;2018;08;17;Perjantai;27;22;49
625;31.08.2018;2018;08;18;Perjantai;9;10;19
625;31.08.2018;2018;08;19;Perjantai;12;19;31
625;31.08.2018;2018;08;20;Perjantai;4;12;16
625;31.08.2018;2018;08;21;Perjantai;6;4;10
625;31.08.2018;2018;08;22;Perjantai;8;9;17
625;31.08.2018;2018;08;23;Perjantai;3;3;6
625;01.09.2018;2018;09;00;Lauantai;1;2;3
625;01.09.2018;2018;09;01;Lauantai;0;1;1
625;01.09.2018;2018;09;02;Lauantai;3;1;4
625;01.09.2018;2018;09;03;Lauantai;0;0;0
625;01.09.2018;2018;09;04;Lauantai;0;0;0
625;01.09.2018;2018;09;05;Lauantai;1;1;2
625;01.09.2018;2018;09;06;Lauantai;1;0;1
625;01.09.2018;2018;09;07;Lauantai;2;1;3
625;01.09.2018;2018;09;08;Lauantai;1;0;1
625;01.09.2018;2018;09;09;Lauantai;3;0;3
625;01.09.2018;2018;09;10;Lauantai;3;2;5
625;01.09.2018;2018;09;11;Lauantai;8;2;10
625;01.09.2018;2018;09;12;Lauantai;7;12;19
625;01.09.2018;2018;09;13;Lauantai;9;8;17
625;01.09.2018;2018;09;14;Lauantai;13;12;25
625;01.09.2018;2018;09;15;Lauantai;9;13;22
625;01.09.2018;2018;09;16;Lauantai;6;4;10
625;01.09.2018;2018;09;17;Lauantai;8;19;27
625;01.09.2018;2018;09;18;Lauantai;8;4;12
625;01.09.2018;2018;09;19;Lauantai;11;8;19
625;01.09.2018;2018;09;20;Lauantai;5;9;14
625;01.09.2018;2018;09;21;Lauantai;4;3;7
625;01.09.2018;2018;09;22;Lauantai;3;1;4
625;01.09.2018;2018;09;23;Lauantai;4;1;5
625;02.09.2018;2018;09;00;Sunnuntai;1;0;1
625;02.09.2018;2018;09;01;Sunnuntai;1;3;4
625;02.09.2018;2018;09;02;Sunnuntai;0;1;1
625;02.09.2018;2018;09;03;Sunnuntai;1;0;1
625;02.09.2018;2018;09;04;Sunnuntai;0;1;1
625;02.09.2018;2018;09;05;Sunnuntai;0;0;0
625;02.09.2018;2018;09;06;Sunnuntai;0;0;0
625;02.09.2018;2018;09;07;Sunnuntai;2;1;3
625;02.09.2018;2018;09;08;Sunnuntai;0;1;1
625;02.09.2018;2018;09;09;Sunnuntai;0;0;0
625;02.09.2018;2018;09;10;Sunnuntai;5;3;8
625;02.09.2018;2018;09;11;Sunnuntai;9;5;14
625;02.09.2018;2018;09;12;Sunnuntai;14;9;23
625;02.09.2018;2018;09;13;Sunnuntai;8;11;19
625;02.09.2018;2018;09;14;Sunnuntai;9;21;30
625;02.09.2018;2018;09;15;Sunnuntai;16;17;33
625;02.09.2018;2018;09;16;Sunnuntai;10;20;30
625;02.09.2018;2018;09;17;Sunnuntai;14;23;37
625;02.09.2018;2018;09;18;Sunnuntai;10;10;20
625;02.09.2018;2018;09;19;Sunnuntai;10;17;27
625;02.09.2018;2018;09;20;Sunnuntai;6;5;11
625;02.09.2018;2018;09;21;Sunnuntai;7;1;8
625;02.09.2018;2018;09;22;Sunnuntai;0;3;3
625;02.09.2018;2018;09;23;Sunnuntai;0;0;0
625;03.09.2018;2018;09;00;Maanantai;1;0;1
625;03.09.2018;2018;09;01;Maanantai;0;0;0
625;03.09.2018;2018;09;02;Maanantai;0;0;0
625;03.09.2018;2018;09;03;Maanantai;1;1;2
625;03.09.2018;2018;09;04;Maanantai;1;3;4
625;03.09.2018;2018;09;05;Maanantai;1;0;1
625;03.09.2018;2018;09;06;Maanantai;3;7;10
625;03.09.2018;2018;09;07;Maanantai;14;7;21
625;03.09.2018;2018;09;08;Maanantai;82;44;126
625;03.09.2018;2018;09;09;Maanantai;62;31;93
625;03.09.2018;2018;09;10;Maanantai;26;13;39
625;03.09.2018;2018;09;11;Maanantai;15;11;26
625;03.09.2018;2018;09;12;Maanantai;17;8;25
625;03.09.2018;2018;09;13;Maanantai;15;16;31
625;03.09.2018;2018;09;14;Maanantai;16;35;51
625;03.09.2018;2018;09;15;Maanantai;26;58;84
625;03.09.2018;2018;09;16;Maanantai;22;46;68
625;03.09.2018;2018;09;17;Maanantai;53;70;123
625;03.09.2018;2018;09;18;Maanantai;21;39;60
625;03.09.2018;2018;09;19;Maanantai;18;25;43
625;03.09.2018;2018;09;20;Maanantai;23;31;54
625;03.09.2018;2018;09;21;Maanantai;13;13;26
625;03.09.2018;2018;09;22;Maanantai;7;7;14
625;03.09.2018;2018;09;23;Maanantai;5;4;9
625;04.09.2018;2018;09;00;Tiistai;1;0;1
625;04.09.2018;2018;09;01;Tiistai;1;0;1
625;04.09.2018;2018;09;02;Tiistai;0;0;0
625;04.09.2018;2018;09;03;Tiistai;1;1;2
625;04.09.2018;2018;09;04;Tiistai;1;3;4
625;04.09.2018;2018;09;05;Tiistai;1;0;1
625;04.09.2018;2018;09;06;Tiistai;3;7;10
625;04.09.2018;2018;09;07;Tiistai;14;7;21
625;04.09.2018;2018;09;08;Tiistai;82;44;126
625;04.09.2018;2018;09;09;Tiistai;62;31;93
625;04.09.2018;2018;09;10;Tiistai;26;13;39
625;04.09.2018;2018;09;11;Tiistai;15;13;28
625;04.09.2018;2018;09;12;Tiistai;13;18;31
625;04.09.2018;2018;09;13;Tiistai;16;23;39
625;04.09.2018;2018;09;14;Tiistai;21;37;58
625;04.09.2018;2018;09;15;Tiistai;23;57;80
625;04.09.2018;2018;09;16;Tiistai;33;53;86
625;04.09.2018;2018;09;17;Tiistai;43;60;103
625;04.09.2018;2018;09;18;Tiistai;40;25;65
625;04.09.2018;2018;09;19;Tiistai;17;21;38
625;04.09.2018;2018;09;20;Tiistai;17;21;38
625;04.09.2018;2018;09;21;Tiistai;9;13;22
625;04.09.2018;2018;09;22;Tiistai;8;13;21
625;04.09.2018;2018;09;23;Tiistai;4;0;4
625;05.09.2018;2018;09;00;Keskiviikko;3;1;4
625;05.09.2018;2018;09;01;Keskiviikko;1;1;2
625;05.09.2018;2018;09;02;Keskiviikko;0;0;0
625;05.09.2018;2018;09;03;Keskiviikko;0;0;0
625;05.09.2018;2018;09;04;Keskiviikko;1;2;3
625;05.09.2018;2018;09;05;Keskiviikko;2;0;2
625;05.09.2018;2018;09;06;Keskiviikko;3;6;9
625;05.09.2018;2018;09;07;Keskiviikko;17;14;31
625;05.09.2018;2018;09;08;Keskiviikko;93;45;138
625;05.09.2018;2018;09;09;Keskiviikko;48;17;65
625;05.09.2018;2018;09;10;Keskiviikko;17;16;33
625;05.09.2018;2018;09;11;Keskiviikko;11;4;15
625;05.09.2018;2018;09;12;Keskiviikko;21;25;46
625;05.09.2018;2018;09;13;Keskiviikko;20;41;61
625;05.09.2018;2018;09;14;Keskiviikko;14;31;45
625;05.09.2018;2018;09;15;Keskiviikko;27;38;65
625;05.09.2018;2018;09;16;Keskiviikko;24;42;66
625;05.09.2018;2018;09;17;Keskiviikko;36;42;78
625;05.09.2018;2018;09;18;Keskiviikko;27;21;48
625;05.09.2018;2018;09;19;Keskiviikko;17;20;37
625;05.09.2018;2018;09;20;Keskiviikko;5;18;23
625;05.09.2018;2018;09;21;Keskiviikko;10;12;22
625;05.09.2018;2018;09;22;Keskiviikko;8;6;14
625;05.09.2018;2018;09;23;Keskiviikko;6;3;9
625;06.09.2018;2018;09;00;Torstai;2;1;3
625;06.09.2018;2018;09;01;Torstai;0;1;1
625;06.09.2018;2018;09;02;Torstai;0;0;0
625;06.09.2018;2018;09;03;Torstai;0;0;0
625;06.09.2018;2018;09;04;Torstai;0;1;1
625;06.09.2018;2018;09;05;Torstai;0;0;0
625;06.09.2018;2018;09;06;Torstai;4;7;11
625;06.09.2018;2018;09;07;Torstai;15;13;28
625;06.09.2018;2018;09;08;Torstai;97;42;139
625;06.09.2018;2018;09;09;Torstai;46;21;67
625;06.09.2018;2018;09;10;Torstai;23;9;32
625;06.09.2018;2018;09;11;Torstai;13;11;24
625;06.09.2018;2018;09;12;Torstai;14;11;25
625;06.09.2018;2018;09;13;Torstai;12;22;34
625;06.09.2018;2018;09;14;Torstai;16;40;56
625;06.09.2018;2018;09;15;Torstai;25;36;61
625;06.09.2018;2018;09;16;Torstai;20;46;66
625;06.09.2018;2018;09;17;Torstai;25;46;71
625;06.09.2018;2018;09;18;Torstai;24;23;47
625;06.09.2018;2018;09;19;Torstai;21;22;43
625;06.09.2018;2018;09;20;Torstai;12;15;27
625;06.09.2018;2018;09;21;Torstai;6;10;16
625;06.09.2018;2018;09;22;Torstai;7;7;14
625;06.09.2018;2018;09;23;Torstai;3;1;4
625;07.09.2018;2018;09;00;Perjantai;0;0;0
625;07.09.2018;2018;09;01;Perjantai;2;0;2
625;07.09.2018;2018;09;02;Perjantai;1;0;1
625;07.09.2018;2018;09;03;Perjantai;0;0;0
625;07.09.2018;2018;09;04;Perjantai;0;1;1
625;07.09.2018;2018;09;05;Perjantai;1;0;1
625;07.09.2018;2018;09;06;Perjantai;4;6;10
625;07.09.2018;2018;09;07;Perjantai;15;8;23
625;07.09.2018;2018;09;08;Perjantai;86;41;127
625;07.09.2018;2018;09;09;Perjantai;44;17;61
625;07.09.2018;2018;09;10;Perjantai;15;9;24
625;07.09.2018;2018;09;11;Perjantai;11;8;19
625;07.09.2018;2018;09;12;Perjantai;10;21;31
625;07.09.2018;2018;09;13;Perjantai;21;32;53
625;07.09.2018;2018;09;14;Perjantai;18;35;53
625;07.09.2018;2018;09;15;Perjantai;26;44;70
625;07.09.2018;2018;09;16;Perjantai;21;30;51
625;07.09.2018;2018;09;17;Perjantai;35;42;77
625;07.09.2018;2018;09;18;Perjantai;21;24;45
625;07.09.2018;2018;09;19;Perjantai;10;23;33
625;07.09.2018;2018;09;20;Perjantai;12;13;25
625;07.09.2018;2018;09;21;Perjantai;5;11;16
625;07.09.2018;2018;09;22;Perjantai;3;4;7
625;07.09.2018;2018;09;23;Perjantai;3;3;6
625;08.09.2018;2018;09;00;Lauantai;2;1;3
625;08.09.2018;2018;09;01;Lauantai;2;1;3
625;08.09.2018;2018;09;02;Lauantai;1;0;1
625;08.09.2018;2018;09;03;Lauantai;1;1;2
625;08.09.2018;2018;09;04;Lauantai;1;3;4
625;08.09.2018;2018;09;05;Lauantai;0;1;1
625;08.09.2018;2018;09;06;Lauantai;0;1;1
625;08.09.2018;2018;09;07;Lauantai;4;4;8
625;08.09.2018;2018;09;08;Lauantai;3;2;5
625;08.09.2018;2018;09;09;Lauantai;53;11;64
625;08.09.2018;2018;09;10;Lauantai;15;10;25
625;08.09.2018;2018;09;11;Lauantai;13;7;20
625;08.09.2018;2018;09;12;Lauantai;22;26;48
625;08.09.2018;2018;09;13;Lauantai;30;67;97
625;08.09.2018;2018;09;14;Lauantai;17;32;49
625;08.09.2018;2018;09;15;Lauantai;16;24;40
625;08.09.2018;2018;09;16;Lauantai;16;15;31
625;08.09.2018;2018;09;17;Lauantai;14;20;34
625;08.09.2018;2018;09;18;Lauantai;7;11;18
625;08.09.2018;2018;09;19;Lauantai;10;8;18
625;08.09.2018;2018;09;20;Lauantai;11;10;21
625;08.09.2018;2018;09;21;Lauantai;10;7;17
625;08.09.2018;2018;09;22;Lauantai;4;8;12
625;08.09.2018;2018;09;23;Lauantai;5;4;9
625;09.09.2018;2018;09;00;Sunnuntai;4;3;7
625;09.09.2018;2018;09;01;Sunnuntai;3;1;4
625;09.09.2018;2018;09;02;Sunnuntai;0;0;0
625;09.09.2018;2018;09;03;Sunnuntai;2;4;6
625;09.09.2018;2018;09;04;Sunnuntai;1;1;2
625;09.09.2018;2018;09;05;Sunnuntai;0;1;1
625;09.09.2018;2018;09;06;Sunnuntai;0;1;1
625;09.09.2018;2018;09;07;Sunnuntai;1;3;4
625;09.09.2018;2018;09;08;Sunnuntai;0;4;4
625;09.09.2018;2018;09;09;Sunnuntai;2;0;2
625;09.09.2018;2018;09;10;Sunnuntai;4;10;14
625;09.09.2018;2018;09;11;Sunnuntai;14;10;24
625;09.09.2018;2018;09;12;Sunnuntai;14;16;30
625;09.09.2018;2018;09;13;Sunnuntai;22;18;40
625;09.09.2018;2018;09;14;Sunnuntai;23;19;42
625;09.09.2018;2018;09;15;Sunnuntai;17;25;42
625;09.09.2018;2018;09;16;Sunnuntai;16;20;36
625;09.09.2018;2018;09;17;Sunnuntai;9;17;26
625;09.09.2018;2018;09;18;Sunnuntai;18;19;37
625;09.09.2018;2018;09;19;Sunnuntai;8;9;17
625;09.09.2018;2018;09;20;Sunnuntai;14;11;25
625;09.09.2018;2018;09;21;Sunnuntai;6;11;17
625;09.09.2018;2018;09;22;Sunnuntai;5;7;12
625;09.09.2018;2018;09;23;Sunnuntai;3;1;4
625;10.09.2018;2018;09;00;Maanantai;3;0;3
625;10.09.2018;2018;09;01;Maanantai;0;0;0
625;10.09.2018;2018;09;02;Maanantai;0;0;0
625;10.09.2018;2018;09;03;Maanantai;1;0;1
625;10.09.2018;2018;09;04;Maanantai;0;1;1
625;10.09.2018;2018;09;05;Maanantai;1;0;1
625;10.09.2018;2018;09;06;Maanantai;1;5;6
625;10.09.2018;2018;09;07;Maanantai;15;14;29
625;10.09.2018;2018;09;08;Maanantai;78;33;111
625;10.09.2018;2018;09;09;Maanantai;49;32;81
625;10.09.2018;2018;09;10;Maanantai;35;16;51
625;10.09.2018;2018;09;11;Maanantai;18;10;28
625;10.09.2018;2018;09;12;Maanantai;9;13;22
625;10.09.2018;2018;09;13;Maanantai;16;15;31
625;10.09.2018;2018;09;14;Maanantai;14;36;50
625;10.09.2018;2018;09;15;Maanantai;31;59;90
625;10.09.2018;2018;09;16;Maanantai;32;67;99
625;10.09.2018;2018;09;17;Maanantai;33;50;83
625;10.09.2018;2018;09;18;Maanantai;27;28;55
625;10.09.2018;2018;09;19;Maanantai;20;17;37
625;10.09.2018;2018;09;20;Maanantai;17;17;34
625;10.09.2018;2018;09;21;Maanantai;7;15;22
625;10.09.2018;2018;09;22;Maanantai;8;7;15
625;10.09.2018;2018;09;23;Maanantai;5;4;9
625;11.09.2018;2018;09;00;Tiistai;1;3;4
625;11.09.2018;2018;09;01;Tiistai;0;0;0
625;11.09.2018;2018;09;02;Tiistai;2;0;2
625;11.09.2018;2018;09;03;Tiistai;2;1;3
625;11.09.2018;2018;09;04;Tiistai;0;1;1
625;11.09.2018;2018;09;05;Tiistai;1;1;2
625;11.09.2018;2018;09;06;Tiistai;2;4;6
625;11.09.2018;2018;09;07;Tiistai;14;10;24
625;11.09.2018;2018;09;08;Tiistai;76;29;105
625;11.09.2018;2018;09;09;Tiistai;40;22;62
625;11.09.2018;2018;09;10;Tiistai;23;14;37
625;11.09.2018;2018;09;11;Tiistai;20;8;28
625;11.09.2018;2018;09;12;Tiistai;15;23;38
625;11.09.2018;2018;09;13;Tiistai;11;12;23
625;11.09.2018;2018;09;14;Tiistai;16;29;45
625;11.09.2018;2018;09;15;Tiistai;24;46;70
625;11.09.2018;2018;09;16;Tiistai;18;43;61
625;11.09.2018;2018;09;17;Tiistai;35;37;72
625;11.09.2018;2018;09;18;Tiistai;12;9;21
625;11.09.2018;2018;09;19;Tiistai;6;12;18
625;11.09.2018;2018;09;20;Tiistai;4;11;15
625;11.09.2018;2018;09;21;Tiistai;2;2;4
625;11.09.2018;2018;09;22;Tiistai;4;4;8
625;11.09.2018;2018;09;23;Tiistai;7;1;8
625;12.09.2018;2018;09;00;Keskiviikko;0;0;0
625;12.09.2018;2018;09;01;Keskiviikko;1;0;1
625;12.09.2018;2018;09;02;Keskiviikko;1;0;1
625;12.09.2018;2018;09;03;Keskiviikko;0;0;0
625;12.09.2018;2018;09;04;Keskiviikko;0;0;0
625;12.09.2018;2018;09;05;Keskiviikko;0;1;1
625;12.09.2018;2018;09;06;Keskiviikko;0;3;3
625;12.09.2018;2018;09;07;Keskiviikko;8;11;19
625;12.09.2018;2018;09;08;Keskiviikko;58;21;79
625;12.09.2018;2018;09;09;Keskiviikko;29;18;47
625;12.09.2018;2018;09;10;Keskiviikko;24;9;33
625;12.09.2018;2018;09;11;Keskiviikko;6;3;9
625;12.09.2018;2018;09;12;Keskiviikko;9;10;19
625;12.09.2018;2018;09;13;Keskiviikko;18;15;33
625;12.09.2018;2018;09;14;Keskiviikko;13;29;42
625;12.09.2018;2018;09;15;Keskiviikko;15;29;44
625;12.09.2018;2018;09;16;Keskiviikko;18;46;64
625;12.09.2018;2018;09;17;Keskiviikko;20;27;47
625;12.09.2018;2018;09;18;Keskiviikko;11;13;24
625;12.09.2018;2018;09;19;Keskiviikko;11;14;25
625;12.09.2018;2018;09;20;Keskiviikko;10;10;20
625;12.09.2018;2018;09;21;Keskiviikko;4;9;13
625;12.09.2018;2018;09;22;Keskiviikko;5;5;10
625;12.09.2018;2018;09;23;Keskiviikko;7;2;9
625;13.09.2018;2018;09;00;Torstai;0;1;1
625;13.09.2018;2018;09;01;Torstai;2;0;2
625;13.09.2018;2018;09;02;Torstai;0;0;0
625;13.09.2018;2018;09;03;Torstai;0;0;0
625;13.09.2018;2018;09;04;Torstai;1;1;2
625;13.09.2018;2018;09;05;Torstai;1;0;1
625;13.09.2018;2018;09;06;Torstai;3;5;8
625;13.09.2018;2018;09;07;Torstai;16;6;22
625;13.09.2018;2018;09;08;Torstai;71;29;100
625;13.09.2018;2018;09;09;Torstai;44;26;70
625;13.09.2018;2018;09;10;Torstai;24;8;32
625;13.09.2018;2018;09;11;Torstai;11;11;22
625;13.09.2018;2018;09;12;Torstai;15;14;29
625;13.09.2018;2018;09;13;Torstai;15;30;45
625;13.09.2018;2018;09;14;Torstai;9;24;33
625;13.09.2018;2018;09;15;Torstai;8;32;40
625;13.09.2018;2018;09;16;Torstai;17;44;61
625;13.09.2018;2018;09;17;Torstai;25;42;67
625;13.09.2018;2018;09;18;Torstai;16;22;38
625;13.09.2018;2018;09;19;Torstai;17;14;31
625;13.09.2018;2018;09;20;Torstai;14;24;38
625;13.09.2018;2018;09;21;Torstai;9;16;25
625;13.09.2018;2018;09;22;Torstai;7;9;16
625;13.09.2018;2018;09;23;Torstai;4;3;7
625;14.09.2018;2018;09;00;Perjantai;2;1;3
625;14.09.2018;2018;09;01;Perjantai;1;0;1
625;14.09.2018;2018;09;02;Perjantai;0;0;0
625;14.09.2018;2018;09;03;Perjantai;1;0;1
625;14.09.2018;2018;09;04;Perjantai;0;0;0
625;14.09.2018;2018;09;05;Perjantai;2;0;2
625;14.09.2018;2018;09;06;Perjantai;1;2;3
625;14.09.2018;2018;09;07;Perjantai;12;10;22
625;14.09.2018;2018;09;08;Perjantai;87;32;119
625;14.09.2018;2018;09;09;Perjantai;44;19;63
625;14.09.2018;2018;09;10;Perjantai;11;10;21
625;14.09.2018;2018;09;11;Perjantai;11;7;18
625;14.09.2018;2018;09;12;Perjantai;16;29;45
625;14.09.2018;2018;09;13;Perjantai;13;21;34
625;14.09.2018;2018;09;14;Perjantai;12;33;45
625;14.09.2018;2018;09;15;Perjantai;13;20;33
625;14.09.2018;2018;09;16;Perjantai;14;34;48
625;14.09.2018;2018;09;17;Perjantai;17;25;42
625;14.09.2018;2018;09;18;Perjantai;9;9;18
625;14.09.2018;2018;09;19;Perjantai;9;13;22
625;14.09.2018;2018;09;20;Perjantai;6;8;14
625;14.09.2018;2018;09;21;Perjantai;2;6;8
625;14.09.2018;2018;09;22;Perjantai;10;4;14
625;14.09.2018;2018;09;23;Perjantai;2;1;3
625;15.09.2018;2018;09;00;Lauantai;3;2;5
625;15.09.2018;2018;09;01;Lauantai;0;0;0
625;15.09.2018;2018;09;02;Lauantai;1;2;3
625;15.09.2018;2018;09;03;Lauantai;0;0;0
625;15.09.2018;2018;09;04;Lauantai;0;1;1
625;15.09.2018;2018;09;05;Lauantai;1;0;1
625;15.09.2018;2018;09;06;Lauantai;0;0;0
625;15.09.2018;2018;09;07;Lauantai;2;1;3
625;15.09.2018;2018;09;08;Lauantai;3;1;4
625;15.09.2018;2018;09;09;Lauantai;4;3;7
625;15.09.2018;2018;09;10;Lauantai;7;1;8
625;15.09.2018;2018;09;11;Lauantai;7;5;12
625;15.09.2018;2018;09;12;Lauantai;5;9;14
625;15.09.2018;2018;09;13;Lauantai;7;11;18
625;15.09.2018;2018;09;14;Lauantai;4;4;8
625;15.09.2018;2018;09;15;Lauantai;2;1;3
625;15.09.2018;2018;09;16;Lauantai;5;6;11
625;15.09.2018;2018;09;17;Lauantai;6;7;13
625;15.09.2018;2018;09;18;Lauantai;5;6;11
625;15.09.2018;2018;09;19;Lauantai;4;6;10
625;15.09.2018;2018;09;20;Lauantai;9;8;17
625;15.09.2018;2018;09;21;Lauantai;3;4;7
625;15.09.2018;2018;09;22;Lauantai;2;3;5
625;15.09.2018;2018;09;23;Lauantai;2;3;5
625;16.09.2018;2018;09;00;Sunnuntai;1;1;2
625;16.09.2018;2018;09;01;Sunnuntai;3;0;3
625;16.09.2018;2018;09;02;Sunnuntai;0;0;0
625;16.09.2018;2018;09;03;Sunnuntai;1;1;2
625;16.09.2018;2018;09;04;Sunnuntai;0;0;0
625;16.09.2018;2018;09;05;Sunnuntai;0;0;0
625;16.09.2018;2018;09;06;Sunnuntai;1;0;1
625;16.09.2018;2018;09;07;Sunnuntai;1;1;2
625;16.09.2018;2018;09;08;Sunnuntai;1;1;2
625;16.09.2018;2018;09;09;Sunnuntai;1;1;2
625;16.09.2018;2018;09;10;Sunnuntai;5;6;11
625;16.09.2018;2018;09;11;Sunnuntai;5;4;9
625;16.09.2018;2018;09;12;Sunnuntai;8;7;15
625;16.09.2018;2018;09;13;Sunnuntai;8;10;18
625;16.09.2018;2018;09;14;Sunnuntai;6;8;14
625;16.09.2018;2018;09;15;Sunnuntai;5;5;10
625;16.09.2018;2018;09;16;Sunnuntai;7;15;22
625;16.09.2018;2018;09;17;Sunnuntai;4;4;8
625;16.09.2018;2018;09;18;Sunnuntai;11;4;15
625;16.09.2018;2018;09;19;Sunnuntai;4;8;12
625;16.09.2018;2018;09;20;Sunnuntai;4;8;12
625;16.09.2018;2018;09;21;Sunnuntai;4;3;7
625;16.09.2018;2018;09;22;Sunnuntai;5;7;12
625;16.09.2018;2018;09;23;Sunnuntai;2;2;4
625;17.09.2018;2018;09;00;Maanantai;1;0;1
625;17.09.2018;2018;09;01;Maanantai;0;0;0
625;17.09.2018;2018;09;02;Maanantai;0;0;0
625;17.09.2018;2018;09;03;Maanantai;0;1;1
625;17.09.2018;2018;09;04;Maanantai;0;0;0
625;17.09.2018;2018;09;05;Maanantai;1;0;1
625;17.09.2018;2018;09;06;Maanantai;3;6;9
625;17.09.2018;2018;09;07;Maanantai;15;7;22
625;17.09.2018;2018;09;08;Maanantai;60;23;83
625;17.09.2018;2018;09;09;Maanantai;36;22;58
625;17.09.2018;2018;09;10;Maanantai;12;10;22
625;17.09.2018;2018;09;11;Maanantai;14;7;21
625;17.09.2018;2018;09;12;Maanantai;11;13;24
625;17.09.2018;2018;09;13;Maanantai;13;18;31
625;17.09.2018;2018;09;14;Maanantai;15;30;45
625;17.09.2018;2018;09;15;Maanantai;20;50;70
625;17.09.2018;2018;09;16;Maanantai;18;41;59
625;17.09.2018;2018;09;17;Maanantai;27;36;63
625;17.09.2018;2018;09;18;Maanantai;15;16;31
625;17.09.2018;2018;09;19;Maanantai;11;17;28
625;17.09.2018;2018;09;20;Maanantai;11;16;27
625;17.09.2018;2018;09;21;Maanantai;3;6;9
625;17.09.2018;2018;09;22;Maanantai;3;4;7
625;17.09.2018;2018;09;23;Maanantai;2;1;3
625;18.09.2018;2018;09;00;Tiistai;0;0;0
625;18.09.2018;2018;09;01;Tiistai;0;0;0
625;18.09.2018;2018;09;02;Tiistai;0;0;0
625;18.09.2018;2018;09;03;Tiistai;1;0;1
625;18.09.2018;2018;09;04;Tiistai;0;1;1
625;18.09.2018;2018;09;05;Tiistai;0;0;0
625;18.09.2018;2018;09;06;Tiistai;7;6;13
625;18.09.2018;2018;09;07;Tiistai;11;8;19
625;18.09.2018;2018;09;08;Tiistai;67;26;93
625;18.09.2018;2018;09;09;Tiistai;41;20;61
625;18.09.2018;2018;09;10;Tiistai;21;8;29
625;18.09.2018;2018;09;11;Tiistai;10;8;18
625;18.09.2018;2018;09;12;Tiistai;13;16;29
625;18.09.2018;2018;09;13;Tiistai;8;17;25
625;18.09.2018;2018;09;14;Tiistai;12;29;41
625;18.09.2018;2018;09;15;Tiistai;21;53;74
625;18.09.2018;2018;09;16;Tiistai;22;43;65
625;18.09.2018;2018;09;17;Tiistai;28;44;72
625;18.09.2018;2018;09;18;Tiistai;17;15;32
625;18.09.2018;2018;09;19;Tiistai;10;17;27
625;18.09.2018;2018;09;20;Tiistai;16;23;39
625;18.09.2018;2018;09;21;Tiistai;6;8;14
625;18.09.2018;2018;09;22;Tiistai;6;6;12
625;18.09.2018;2018;09;23;Tiistai;4;2;6
625;19.09.2018;2018;09;00;Keskiviikko;0;2;2
625;19.09.2018;2018;09;01;Keskiviikko;1;0;1
625;19.09.2018;2018;09;02;Keskiviikko;0;0;0
625;19.09.2018;2018;09;03;Keskiviikko;0;0;0
625;19.09.2018;2018;09;04;Keskiviikko;0;0;0
625;19.09.2018;2018;09;05;Keskiviikko;1;0;1
625;19.09.2018;2018;09;06;Keskiviikko;4;7;11
625;19.09.2018;2018;09;07;Keskiviikko;15;7;22
625;19.09.2018;2018;09;08;Keskiviikko;74;31;105
625;19.09.2018;2018;09;09;Keskiviikko;27;15;42
625;19.09.2018;2018;09;10;Keskiviikko;17;7;24
625;19.09.2018;2018;09;11;Keskiviikko;11;3;14
625;19.09.2018;2018;09;12;Keskiviikko;2;11;13
625;19.09.2018;2018;09;13;Keskiviikko;6;12;18
625;19.09.2018;2018;09;14;Keskiviikko;9;33;42
625;19.09.2018;2018;09;15;Keskiviikko;7;30;37
625;19.09.2018;2018;09;16;Keskiviikko;10;28;38
625;19.09.2018;2018;09;17;Keskiviikko;19;37;56
625;19.09.2018;2018;09;18;Keskiviikko;13;16;29
625;19.09.2018;2018;09;19;Keskiviikko;7;11;18
625;19.09.2018;2018;09;20;Keskiviikko;8;9;17
625;19.09.2018;2018;09;21;Keskiviikko;6;13;19
625;19.09.2018;2018;09;22;Keskiviikko;4;3;7
625;19.09.2018;2018;09;23;Keskiviikko;4;1;5
625;20.09.2018;2018;09;00;Torstai;0;0;0
625;20.09.2018;2018;09;01;Torstai;0;1;1
625;20.09.2018;2018;09;02;Torstai;0;0;0
625;20.09.2018;2018;09;03;Torstai;0;0;0
625;20.09.2018;2018;09;04;Torstai;0;1;1
625;20.09.2018;2018;09;05;Torstai;1;0;1
625;20.09.2018;2018;09;06;Torstai;6;5;11
625;20.09.2018;2018;09;07;Torstai;8;6;14
625;20.09.2018;2018;09;08;Torstai;95;44;139
625;20.09.2018;2018;09;09;Torstai;27;10;37
625;20.09.2018;2018;09;10;Torstai;14;7;21
625;20.09.2018;2018;09;11;Torstai;4;3;7
625;20.09.2018;2018;09;12;Torstai;13;6;19
625;20.09.2018;2018;09;13;Torstai;10;21;31
625;20.09.2018;2018;09;14;Torstai;4;30;34
625;20.09.2018;2018;09;15;Torstai;5;34;39
625;20.09.2018;2018;09;16;Torstai;22;33;55
625;20.09.2018;2018;09;17;Torstai;22;39;61
625;20.09.2018;2018;09;18;Torstai;15;14;29
625;20.09.2018;2018;09;19;Torstai;8;18;26
625;20.09.2018;2018;09;20;Torstai;7;6;13
625;20.09.2018;2018;09;21;Torstai;5;10;15
625;20.09.2018;2018;09;22;Torstai;6;6;12
625;20.09.2018;2018;09;23;Torstai;4;0;4
625;21.09.2018;2018;09;00;Perjantai;0;0;0
625;21.09.2018;2018;09;01;Perjantai;0;0;0
625;21.09.2018;2018;09;02;Perjantai;2;0;2
625;21.09.2018;2018;09;03;Perjantai;0;1;1
625;21.09.2018;2018;09;04;Perjantai;0;1;1
625;21.09.2018;2018;09;05;Perjantai;0;0;0
625;21.09.2018;2018;09;06;Perjantai;1;3;4
625;21.09.2018;2018;09;07;Perjantai;11;7;18
625;21.09.2018;2018;09;08;Perjantai;56;23;79
625;21.09.2018;2018;09;09;Perjantai;31;21;52
625;21.09.2018;2018;09;10;Perjantai;21;15;36
625;21.09.2018;2018;09;11;Perjantai;12;6;18
625;21.09.2018;2018;09;12;Perjantai;11;21;32
625;21.09.2018;2018;09;13;Perjantai;6;22;28
625;21.09.2018;2018;09;14;Perjantai;11;43;54
625;21.09.2018;2018;09;15;Perjantai;16;25;41
625;21.09.2018;2018;09;16;Perjantai;18;29;47
625;21.09.2018;2018;09;17;Perjantai;19;25;44
625;21.09.2018;2018;09;18;Perjantai;17;12;29
625;21.09.2018;2018;09;19;Perjantai;6;10;16
625;21.09.2018;2018;09;20;Perjantai;2;3;5
625;21.09.2018;2018;09;21;Perjantai;2;5;7
625;21.09.2018;2018;09;22;Perjantai;4;2;6
625;21.09.2018;2018;09;23;Perjantai;2;5;7
625;22.09.2018;2018;09;00;Lauantai;1;1;2
625;22.09.2018;2018;09;01;Lauantai;0;1;1
625;22.09.2018;2018;09;02;Lauantai;1;3;4
625;22.09.2018;2018;09;03;Lauantai;1;1;2
625;22.09.2018;2018;09;04;Lauantai;1;0;1
625;22.09.2018;2018;09;05;Lauantai;0;0;0
625;22.09.2018;2018;09;06;Lauantai;0;1;1
625;22.09.2018;2018;09;07;Lauantai;1;1;2
625;22.09.2018;2018;09;08;Lauantai;1;2;3
625;22.09.2018;2018;09;09;Lauantai;1;3;4
625;22.09.2018;2018;09;10;Lauantai;0;1;1
625;22.09.2018;2018;09;11;Lauantai;3;1;4
625;22.09.2018;2018;09;12;Lauantai;3;2;5
625;22.09.2018;2018;09;13;Lauantai;5;8;13
625;22.09.2018;2018;09;14;Lauantai;8;10;18
625;22.09.2018;2018;09;15;Lauantai;9;6;15
625;22.09.2018;2018;09;16;Lauantai;6;8;14
625;22.09.2018;2018;09;17;Lauantai;13;15;28
625;22.09.2018;2018;09;18;Lauantai;5;4;9
625;22.09.2018;2018;09;19;Lauantai;7;7;14
625;22.09.2018;2018;09;20;Lauantai;1;3;4
625;22.09.2018;2018;09;21;Lauantai;2;6;8
625;22.09.2018;2018;09;22;Lauantai;3;5;8
625;22.09.2018;2018;09;23;Lauantai;0;0;0
625;23.09.2018;2018;09;00;Sunnuntai;2;1;3
625;23.09.2018;2018;09;01;Sunnuntai;1;2;3
625;23.09.2018;2018;09;02;Sunnuntai;3;0;3
625;23.09.2018;2018;09;03;Sunnuntai;2;0;2
625;23.09.2018;2018;09;04;Sunnuntai;0;0;0
625;23.09.2018;2018;09;05;Sunnuntai;0;0;0
625;23.09.2018;2018;09;06;Sunnuntai;0;1;1
625;23.09.2018;2018;09;07;Sunnuntai;0;0;0
625;23.09.2018;2018;09;08;Sunnuntai;1;0;1
625;23.09.2018;2018;09;09;Sunnuntai;0;2;2
625;23.09.2018;2018;09;10;Sunnuntai;2;3;5
625;23.09.2018;2018;09;11;Sunnuntai;16;8;24
625;23.09.2018;2018;09;12;Sunnuntai;12;21;33
625;23.09.2018;2018;09;13;Sunnuntai;11;15;26
625;23.09.2018;2018;09;14;Sunnuntai;10;9;19
625;23.09.2018;2018;09;15;Sunnuntai;10;20;30
625;23.09.2018;2018;09;16;Sunnuntai;6;9;15
625;23.09.2018;2018;09;17;Sunnuntai;8;7;15
625;23.09.2018;2018;09;18;Sunnuntai;6;7;13
625;23.09.2018;2018;09;19;Sunnuntai;5;12;17
625;23.09.2018;2018;09;20;Sunnuntai;11;9;20
625;23.09.2018;2018;09;21;Sunnuntai;3;4;7
625;23.09.2018;2018;09;22;Sunnuntai;4;5;9
625;23.09.2018;2018;09;23;Sunnuntai;1;2;3
625;24.09.2018;2018;09;00;Maanantai;1;0;1
625;24.09.2018;2018;09;01;Maanantai;0;0;0
625;24.09.2018;2018;09;02;Maanantai;0;1;1
625;24.09.2018;2018;09;03;Maanantai;0;0;0
625;24.09.2018;2018;09;04;Maanantai;0;1;1
625;24.09.2018;2018;09;05;Maanantai;0;0;0
625;24.09.2018;2018;09;06;Maanantai;3;2;5
625;24.09.2018;2018;09;07;Maanantai;10;6;16
625;24.09.2018;2018;09;08;Maanantai;61;25;86
625;24.09.2018;2018;09;09;Maanantai;37;15;52
625;24.09.2018;2018;09;10;Maanantai;14;5;19
625;24.09.2018;2018;09;11;Maanantai;18;8;26
625;24.09.2018;2018;09;12;Maanantai;12;11;23
625;24.09.2018;2018;09;13;Maanantai;15;17;32
625;24.09.2018;2018;09;14;Maanantai;10;21;31
625;24.09.2018;2018;09;15;Maanantai;17;37;54
625;24.09.2018;2018;09;16;Maanantai;19;43;62
625;24.09.2018;2018;09;17;Maanantai;25;34;59
625;24.09.2018;2018;09;18;Maanantai;20;15;35
625;24.09.2018;2018;09;19;Maanantai;7;11;18
625;24.09.2018;2018;09;20;Maanantai;6;15;21
625;24.09.2018;2018;09;21;Maanantai;6;8;14
625;24.09.2018;2018;09;22;Maanantai;4;5;9
625;24.09.2018;2018;09;23;Maanantai;1;1;2
625;25.09.2018;2018;09;00;Tiistai;1;1;2
625;25.09.2018;2018;09;01;Tiistai;0;0;0
625;25.09.2018;2018;09;02;Tiistai;0;0;0
625;25.09.2018;2018;09;03;Tiistai;0;0;0
625;25.09.2018;2018;09;04;Tiistai;0;1;1
625;25.09.2018;2018;09;05;Tiistai;0;0;0
625;25.09.2018;2018;09;06;Tiistai;2;3;5
625;25.09.2018;2018;09;07;Tiistai;11;9;20
625;25.09.2018;2018;09;08;Tiistai;68;33;101
625;25.09.2018;2018;09;09;Tiistai;32;13;45
625;25.09.2018;2018;09;10;Tiistai;19;6;25
625;25.09.2018;2018;09;11;Tiistai;14;11;25
625;25.09.2018;2018;09;12;Tiistai;8;16;24
625;25.09.2018;2018;09;13;Tiistai;10;8;18
625;25.09.2018;2018;09;14;Tiistai;5;24;29
625;25.09.2018;2018;09;15;Tiistai;14;42;56
625;25.09.2018;2018;09;16;Tiistai;14;48;62
625;25.09.2018;2018;09;17;Tiistai;23;34;57
625;25.09.2018;2018;09;18;Tiistai;17;14;31
625;25.09.2018;2018;09;19;Tiistai;16;12;28
625;25.09.2018;2018;09;20;Tiistai;8;7;15
625;25.09.2018;2018;09;21;Tiistai;6;6;12
625;25.09.2018;2018;09;22;Tiistai;3;8;11
625;25.09.2018;2018;09;23;Tiistai;4;2;6
625;26.09.2018;2018;09;00;Keskiviikko;2;0;2
625;26.09.2018;2018;09;01;Keskiviikko;0;0;0
625;26.09.2018;2018;09;02;Keskiviikko;0;1;1
625;26.09.2018;2018;09;03;Keskiviikko;0;1;1
625;26.09.2018;2018;09;04;Keskiviikko;0;1;1
625;26.09.2018;2018;09;05;Keskiviikko;0;0;0
625;26.09.2018;2018;09;06;Keskiviikko;0;1;1
625;26.09.2018;2018;09;07;Keskiviikko;12;7;19
625;26.09.2018;2018;09;08;Keskiviikko;69;28;97
625;26.09.2018;2018;09;09;Keskiviikko;19;13;32
625;26.09.2018;2018;09;10;Keskiviikko;23;13;36
625;26.09.2018;2018;09;11;Keskiviikko;4;4;8
625;26.09.2018;2018;09;12;Keskiviikko;6;3;9
625;26.09.2018;2018;09;13;Keskiviikko;6;10;16
625;26.09.2018;2018;09;14;Keskiviikko;8;25;33
625;26.09.2018;2018;09;15;Keskiviikko;10;26;36
625;26.09.2018;2018;09;16;Keskiviikko;9;22;31
625;26.09.2018;2018;09;17;Keskiviikko;10;18;28
625;26.09.2018;2018;09;18;Keskiviikko;14;15;29
625;26.09.2018;2018;09;19;Keskiviikko;5;9;14
625;26.09.2018;2018;09;20;Keskiviikko;10;12;22
625;26.09.2018;2018;09;21;Keskiviikko;1;3;4
625;26.09.2018;2018;09;22;Keskiviikko;1;2;3
625;26.09.2018;2018;09;23;Keskiviikko;4;0;4
625;27.09.2018;2018;09;00;Torstai;1;0;1
625;27.09.2018;2018;09;01;Torstai;0;0;0
625;27.09.2018;2018;09;02;Torstai;1;1;2
625;27.09.2018;2018;09;03;Torstai;0;0;0
625;27.09.2018;2018;09;04;Torstai;0;0;0
625;27.09.2018;2018;09;05;Torstai;1;0;1
625;27.09.2018;2018;09;06;Torstai;1;3;4
625;27.09.2018;2018;09;07;Torstai;10;7;17
625;27.09.2018;2018;09;08;Torstai;67;20;87
625;27.09.2018;2018;09;09;Torstai;24;19;43
625;27.09.2018;2018;09;10;Torstai;15;2;17
625;27.09.2018;2018;09;11;Torstai;5;2;7
625;27.09.2018;2018;09;12;Torstai;5;10;15
625;27.09.2018;2018;09;13;Torstai;5;17;22
625;27.09.2018;2018;09;14;Torstai;13;22;35
625;27.09.2018;2018;09;15;Torstai;7;21;28
625;27.09.2018;2018;09;16;Torstai;12;36;48
625;27.09.2018;2018;09;17;Torstai;15;23;38
625;27.09.2018;2018;09;18;Torstai;15;15;30
625;27.09.2018;2018;09;19;Torstai;13;11;24
625;27.09.2018;2018;09;20;Torstai;10;11;21
625;27.09.2018;2018;09;21;Torstai;6;12;18
625;27.09.2018;2018;09;22;Torstai;3;5;8
625;27.09.2018;2018;09;23;Torstai;3;0;3
625;28.09.2018;2018;09;00;Perjantai;2;0;2
625;28.09.2018;2018;09;01;Perjantai;1;0;1
625;28.09.2018;2018;09;02;Perjantai;0;1;1
625;28.09.2018;2018;09;03;Perjantai;0;1;1
625;28.09.2018;2018;09;04;Perjantai;0;2;2
625;28.09.2018;2018;09;05;Perjantai;0;0;0
625;28.09.2018;2018;09;06;Perjantai;2;4;6
625;28.09.2018;2018;09;07;Perjantai;13;7;20
625;28.09.2018;2018;09;08;Perjantai;63;31;94
625;28.09.2018;2018;09;09;Perjantai;31;23;54
625;28.09.2018;2018;09;10;Perjantai;8;7;15
625;28.09.2018;2018;09;11;Perjantai;9;6;15
625;28.09.2018;2018;09;12;Perjantai;7;11;18
625;28.09.2018;2018;09;13;Perjantai;11;16;27
625;28.09.2018;2018;09;14;Perjantai;15;31;46
625;28.09.2018;2018;09;15;Perjantai;4;10;14
625;28.09.2018;2018;09;16;Perjantai;11;23;34
625;28.09.2018;2018;09;17;Perjantai;14;23;37
625;28.09.2018;2018;09;18;Perjantai;16;23;39
625;28.09.2018;2018;09;19;Perjantai;10;9;19
625;28.09.2018;2018;09;20;Perjantai;10;12;22
625;28.09.2018;2018;09;21;Perjantai;7;9;16
625;28.09.2018;2018;09;22;Perjantai;3;4;7
625;28.09.2018;2018;09;23;Perjantai;2;1;3
625;29.09.2018;2018;09;00;Lauantai;0;2;2
625;29.09.2018;2018;09;01;Lauantai;2;1;3
625;29.09.2018;2018;09;02;Lauantai;0;0;0
625;29.09.2018;2018;09;03;Lauantai;1;2;3
625;29.09.2018;2018;09;04;Lauantai;0;1;1
625;29.09.2018;2018;09;05;Lauantai;0;1;1
625;29.09.2018;2018;09;06;Lauantai;1;0;1
625;29.09.2018;2018;09;07;Lauantai;2;1;3
625;29.09.2018;2018;09;08;Lauantai;1;1;2
625;29.09.2018;2018;09;09;Lauantai;0;0;0
625;29.09.2018;2018;09;10;Lauantai;4;2;6
625;29.09.2018;2018;09;11;Lauantai;6;4;10
625;29.09.2018;2018;09;12;Lauantai;5;2;7
625;29.09.2018;2018;09;13;Lauantai;6;9;15
625;29.09.2018;2018;09;14;Lauantai;10;8;18
625;29.09.2018;2018;09;15;Lauantai;4;3;7
625;29.09.2018;2018;09;16;Lauantai;9;8;17
625;29.09.2018;2018;09;17;Lauantai;8;9;17
625;29.09.2018;2018;09;18;Lauantai;13;8;21
625;29.09.2018;2018;09;19;Lauantai;7;10;17
625;29.09.2018;2018;09;20;Lauantai;4;6;10
625;29.09.2018;2018;09;21;Lauantai;4;5;9
625;29.09.2018;2018;09;22;Lauantai;4;3;7
625;29.09.2018;2018;09;23;Lauantai;1;3;4
625;30.09.2018;2018;09;00;Sunnuntai;1;2;3
625;30.09.2018;2018;09;01;Sunnuntai;1;2;3
625;30.09.2018;2018;09;02;Sunnuntai;2;2;4
625;30.09.2018;2018;09;03;Sunnuntai;0;2;2
625;30.09.2018;2018;09;04;Sunnuntai;0;0;0
625;30.09.2018;2018;09;05;Sunnuntai;0;0;0
625;30.09.2018;2018;09;06;Sunnuntai;0;0;0
625;30.09.2018;2018;09;07;Sunnuntai;1;2;3
625;30.09.2018;2018;09;08;Sunnuntai;1;1;2
625;30.09.2018;2018;09;09;Sunnuntai;0;2;2
625;30.09.2018;2018;09;10;Sunnuntai;4;3;7
625;30.09.2018;2018;09;11;Sunnuntai;3;2;5
625;30.09.2018;2018;09;12;Sunnuntai;8;9;17
625;30.09.2018;2018;09;13;Sunnuntai;9;10;19
625;30.09.2018;2018;09;14;Sunnuntai;9;12;21
625;30.09.2018;2018;09;15;Sunnuntai;5;9;14
625;30.09.2018;2018;09;16;Sunnuntai;5;10;15
625;30.09.2018;2018;09;17;Sunnuntai;9;9;18
625;30.09.2018;2018;09;18;Sunnuntai;10;11;21
625;30.09.2018;2018;09;19;Sunnuntai;11;10;21
625;30.09.2018;2018;09;20;Sunnuntai;4;5;9
625;30.09.2018;2018;09;21;Sunnuntai;3;3;6
625;30.09.2018;2018;09;22;Sunnuntai;1;3;4
625;30.09.2018;2018;09;23;Sunnuntai;2;2;4