MittausID;Pvm;Vuosi;Kuukausi;Tunti;Viikonpäivä;PP_1;PP_2;PP_YHT;JK_1;JK_2;JK_YHT
96;03.01.2011;2011;01;00;Maanantai;0;0;0;0;1;1
96;03.01.2011;2011;01;01;Maanantai;1;0;1;0;0;0
96;03.01.2011;2011;01;02;Maanantai;5;1;6;4;1;5
96;03.01.2011;2011;01;03;Maanantai;0;2;2;0;0;0
96;03.01.2011;2011;01;04;Maanantai;3;6;9;1;3;4
96;03.01.2011;2011;01;05;Maanantai;13;14;27;3;2;5
96;03.01.2011;2011;01;06;Maanantai;35;29;64;36;12;48
96;03.01.2011;2011;01;07;Maanantai;44;54;98;20;8;28
96;03.01.2011;2011;01;08;Maanantai;37;30;67;17;20;37
96;03.01.2011;2011;01;09;Maanantai;18;32;50;13;17;30
96;03.01.2011;2011;01;10;Maanantai;23;35;58;10;16;26
96;03.01.2011;2011;01;11;Maanantai;33;24;57;22;19;41
96;03.01.2011;2011;01;12;Maanantai;37;20;57;21;23;44
96;03.01.2011;2011;01;13;Maanantai;31;41;72;7;20;27
96;03.01.2011;2011;01;14;Maanantai;39;82;121;11;44;55
96;03.01.2011;2011;01;15;Maanantai;52;74;126;12;50;62
96;03.01.2011;2011;01;16;Maanantai;36;25;61;9;22;31
96;03.01.2011;2011;01;17;Maanantai;35;21;56;19;15;34
96;03.01.2011;2011;01;18;Maanantai;21;22;43;21;18;39
96;03.01.2011;2011;01;19;Maanantai;24;11;35;18;13;31
96;03.01.2011;2011;01;20;Maanantai;17;10;27;8;9;17
96;03.01.2011;2011;01;21;Maanantai;8;2;10;3;1;4
96;03.01.2011;2011;01;22;Maanantai;1;1;2;0;0;0
96;03.01.2011;2011;01;23;Maanantai;1;0;1;3;0;3
96;04.01.2011;2011;01;00;Tiistai;1;1;2;0;0;0
96;04.01.2011;2011;01;01;Tiistai;1;0;1;0;0;0
96;04.01.2011;2011;01;02;Tiistai;0;2;2;0;0;0
96;04.01.2011;2011;01;03;Tiistai;1;2;3;0;0;0
96;04.01.2011;2011;01;04;Tiistai;2;3;5;1;0;1
96;04.01.2011;2011;01;05;Tiistai;19;14;33;11;3;14
96;04.01.2011;2011;01;06;Tiistai;41;29;70;36;9;45
96;04.01.2011;2011;01;07;Tiistai;65;47;112;23;13;36
96;04.01.2011;2011;01;08;Tiistai;21;16;37;13;9;22
96;04.01.2011;2011;01;09;Tiistai;27;24;51;9;16;25
96;04.01.2011;2011;01;10;Tiistai;22;20;42;10;12;22
96;04.01.2011;2011;01;11;Tiistai;21;26;47;13;6;19
96;04.01.2011;2011;01;12;Tiistai;16;24;40;10;13;23
96;04.01.2011;2011;01;13;Tiistai;20;50;70;7;23;30
96;04.01.2011;2011;01;14;Tiistai;28;59;87;7;38;45
96;04.01.2011;2011;01;15;Tiistai;43;70;113;18;60;78
96;04.01.2011;2011;01;16;Tiistai;31;34;65;20;30;50
96;04.01.2011;2011;01;17;Tiistai;23;30;53;7;23;30
96;04.01.2011;2011;01;18;Tiistai;12;16;28;10;9;19
96;04.01.2011;2011;01;19;Tiistai;21;12;33;13;5;18
96;04.01.2011;2011;01;20;Tiistai;35;9;44;20;11;31
96;04.01.2011;2011;01;21;Tiistai;8;6;14;2;4;6
96;04.01.2011;2011;01;22;Tiistai;2;0;2;0;0;0
96;04.01.2011;2011;01;23;Tiistai;3;0;3;0;0;0
96;05.01.2011;2011;01;00;Keskiviikko;1;0;1;0;0;0
96;05.01.2011;2011;01;01;Keskiviikko;0;0;0;1;0;1
96;05.01.2011;2011;01;02;Keskiviikko;0;0;0;0;0;0
96;05.01.2011;2011;01;03;Keskiviikko;0;4;4;0;1;1
96;05.01.2011;2011;01;04;Keskiviikko;4;5;9;0;2;2
96;05.01.2011;2011;01;05;Keskiviikko;19;10;29;5;1;6
96;05.01.2011;2011;01;06;Keskiviikko;29;18;47;32;13;45
96;05.01.2011;2011;01;07;Keskiviikko;55;35;90;18;8;26
96;05.01.2011;2011;01;08;Keskiviikko;31;25;56;13;12;25
96;05.01.2011;2011;01;09;Keskiviikko;15;13;28;2;17;19
96;05.01.2011;2011;01;10;Keskiviikko;15;14;29;6;10;16
96;05.01.2011;2011;01;11;Keskiviikko;27;23;50;14;12;26
96;05.01.2011;2011;01;12;Keskiviikko;24;26;50;8;10;18
96;05.01.2011;2011;01;13;Keskiviikko;32;46;78;8;14;22
96;05.01.2011;2011;01;14;Keskiviikko;32;67;99;6;35;41
96;05.01.2011;2011;01;15;Keskiviikko;38;82;120;9;46;55
96;05.01.2011;2011;01;16;Keskiviikko;24;25;49;11;12;23
96;05.01.2011;2011;01;17;Keskiviikko;18;16;34;9;5;14
96;05.01.2011;2011;01;18;Keskiviikko;6;7;13;10;7;17
96;05.01.2011;2011;01;19;Keskiviikko;10;14;24;8;3;11
96;05.01.2011;2011;01;20;Keskiviikko;13;13;26;4;7;11
96;05.01.2011;2011;01;21;Keskiviikko;2;1;3;0;2;2
96;05.01.2011;2011;01;22;Keskiviikko;8;2;10;0;1;1
96;05.01.2011;2011;01;23;Keskiviikko;1;0;1;0;0;0
96;06.01.2011;2011;01;00;Torstai;3;0;3;0;0;0
96;06.01.2011;2011;01;01;Torstai;5;0;5;0;1;1
96;06.01.2011;2011;01;02;Torstai;2;0;2;2;0;2
96;06.01.2011;2011;01;03;Torstai;6;0;6;4;0;4
96;06.01.2011;2011;01;04;Torstai;2;0;2;0;0;0
96;06.01.2011;2011;01;05;Torstai;0;0;0;0;0;0
96;06.01.2011;2011;01;06;Torstai;9;3;12;3;1;4
96;06.01.2011;2011;01;07;Torstai;1;2;3;1;5;6
96;06.01.2011;2011;01;08;Torstai;2;2;4;2;2;4
96;06.01.2011;2011;01;09;Torstai;5;6;11;8;8;16
96;06.01.2011;2011;01;10;Torstai;2;7;9;3;10;13
96;06.01.2011;2011;01;11;Torstai;6;9;15;15;14;29
96;06.01.2011;2011;01;12;Torstai;10;11;21;14;16;30
96;06.01.2011;2011;01;13;Torstai;25;13;38;11;12;23
96;06.01.2011;2011;01;14;Torstai;15;12;27;18;18;36
96;06.01.2011;2011;01;15;Torstai;8;12;20;12;13;25
96;06.01.2011;2011;01;16;Torstai;9;11;20;6;11;17
96;06.01.2011;2011;01;17;Torstai;10;15;25;8;13;21
96;06.01.2011;2011;01;18;Torstai;1;14;15;4;15;19
96;06.01.2011;2011;01;19;Torstai;10;7;17;9;12;21
96;06.01.2011;2011;01;20;Torstai;5;4;9;4;7;11
96;06.01.2011;2011;01;21;Torstai;19;16;35;10;8;18
96;06.01.2011;2011;01;22;Torstai;7;4;11;2;2;4
96;06.01.2011;2011;01;23;Torstai;2;1;3;0;0;0
96;07.01.2011;2011;01;00;Perjantai;6;0;6;1;0;1
96;07.01.2011;2011;01;01;Perjantai;2;0;2;0;0;0
96;07.01.2011;2011;01;02;Perjantai;2;0;2;0;1;1
96;07.01.2011;2011;01;03;Perjantai;0;0;0;0;0;0
96;07.01.2011;2011;01;04;Perjantai;0;3;3;0;0;0
96;07.01.2011;2011;01;05;Perjantai;3;4;7;0;0;0
96;07.01.2011;2011;01;06;Perjantai;18;14;32;8;6;14
96;07.01.2011;2011;01;07;Perjantai;17;22;39;30;22;52
96;07.01.2011;2011;01;08;Perjantai;32;38;70;14;9;23
96;07.01.2011;2011;01;09;Perjantai;14;32;46;10;12;22
96;07.01.2011;2011;01;10;Perjantai;31;21;52;12;13;25
96;07.01.2011;2011;01;11;Perjantai;13;35;48;7;16;23
96;07.01.2011;2011;01;12;Perjantai;28;29;57;12;15;27
96;07.01.2011;2011;01;13;Perjantai;24;36;60;16;11;27
96;07.01.2011;2011;01;14;Perjantai;35;41;76;8;17;25
96;07.01.2011;2011;01;15;Perjantai;40;67;107;13;42;55
96;07.01.2011;2011;01;16;Perjantai;36;38;74;6;27;33
96;07.01.2011;2011;01;17;Perjantai;29;23;52;17;11;28
96;07.01.2011;2011;01;18;Perjantai;21;14;35;13;18;31
96;07.01.2011;2011;01;19;Perjantai;24;17;41;14;14;28
96;07.01.2011;2011;01;20;Perjantai;20;7;27;10;7;17
96;07.01.2011;2011;01;21;Perjantai;11;9;20;6;9;15
96;07.01.2011;2011;01;22;Perjantai;4;9;13;2;3;5
96;07.01.2011;2011;01;23;Perjantai;4;4;8;1;0;1
96;08.01.2011;2011;01;00;Lauantai;4;1;5;1;0;1
96;08.01.2011;2011;01;01;Lauantai;3;0;3;0;0;0
96;08.01.2011;2011;01;02;Lauantai;2;3;5;1;0;1
96;08.01.2011;2011;01;03;Lauantai;4;0;4;0;0;0
96;08.01.2011;2011;01;04;Lauantai;3;1;4;2;0;2
96;08.01.2011;2011;01;05;Lauantai;1;2;3;5;1;6
96;08.01.2011;2011;01;06;Lauantai;10;6;16;1;0;1
96;08.01.2011;2011;01;07;Lauantai;6;12;18;2;5;7
96;08.01.2011;2011;01;08;Lauantai;0;8;8;2;4;6
96;08.01.2011;2011;01;09;Lauantai;4;19;23;15;5;20
96;08.01.2011;2011;01;10;Lauantai;8;15;23;13;17;30
96;08.01.2011;2011;01;11;Lauantai;11;32;43;6;10;16
96;08.01.2011;2011;01;12;Lauantai;10;12;22;10;16;26
96;08.01.2011;2011;01;13;Lauantai;13;24;37;14;13;27
96;08.01.2011;2011;01;14;Lauantai;29;22;51;15;19;34
96;08.01.2011;2011;01;15;Lauantai;19;22;41;16;21;37
96;08.01.2011;2011;01;16;Lauantai;26;15;41;21;13;34
96;08.01.2011;2011;01;17;Lauantai;25;13;38;14;5;19
96;08.01.2011;2011;01;18;Lauantai;19;4;23;17;16;33
96;08.01.2011;2011;01;19;Lauantai;10;6;16;7;8;15
96;08.01.2011;2011;01;20;Lauantai;11;11;22;5;4;9
96;08.01.2011;2011;01;21;Lauantai;4;6;10;1;2;3
96;08.01.2011;2011;01;22;Lauantai;4;4;8;0;4;4
96;08.01.2011;2011;01;23;Lauantai;3;5;8;1;1;2
96;09.01.2011;2011;01;00;Sunnuntai;4;1;5;0;0;0
96;09.01.2011;2011;01;01;Sunnuntai;7;0;7;0;0;0
96;09.01.2011;2011;01;02;Sunnuntai;2;0;2;0;0;0
96;09.01.2011;2011;01;03;Sunnuntai;3;2;5;1;1;2
96;09.01.2011;2011;01;04;Sunnuntai;3;0;3;2;0;2
96;09.01.2011;2011;01;05;Sunnuntai;2;2;4;1;0;1
96;09.01.2011;2011;01;06;Sunnuntai;6;3;9;2;0;2
96;09.01.2011;2011;01;07;Sunnuntai;3;8;11;1;3;4
96;09.01.2011;2011;01;08;Sunnuntai;3;1;4;4;2;6
96;09.01.2011;2011;01;09;Sunnuntai;3;7;10;2;6;8
96;09.01.2011;2011;01;10;Sunnuntai;4;10;14;7;5;12
96;09.01.2011;2011;01;11;Sunnuntai;5;16;21;18;9;27
96;09.01.2011;2011;01;12;Sunnuntai;14;17;31;16;30;46
96;09.01.2011;2011;01;13;Sunnuntai;16;14;30;20;29;49
96;09.01.2011;2011;01;14;Sunnuntai;18;22;40;10;23;33
96;09.01.2011;2011;01;15;Sunnuntai;18;21;39;19;18;37
96;09.01.2011;2011;01;16;Sunnuntai;21;8;29;15;15;30
96;09.01.2011;2011;01;17;Sunnuntai;16;11;27;18;12;30
96;09.01.2011;2011;01;18;Sunnuntai;3;8;11;12;15;27
96;09.01.2011;2011;01;19;Sunnuntai;11;7;18;21;13;34
96;09.01.2011;2011;01;20;Sunnuntai;9;6;15;10;10;20
96;09.01.2011;2011;01;21;Sunnuntai;11;12;23;5;7;12
96;09.01.2011;2011;01;22;Sunnuntai;8;4;12;2;3;5
96;09.01.2011;2011;01;23;Sunnuntai;4;1;5;0;0;0
96;10.01.2011;2011;01;00;Maanantai;2;2;4;1;0;1
96;10.01.2011;2011;01;01;Maanantai;3;0;3;1;0;1
96;10.01.2011;2011;01;02;Maanantai;3;0;3;0;0;0
96;10.01.2011;2011;01;03;Maanantai;2;7;9;7;5;12
96;10.01.2011;2011;01;04;Maanantai;1;3;4;0;0;0
96;10.01.2011;2011;01;05;Maanantai;3;4;7;1;1;2
96;10.01.2011;2011;01;06;Maanantai;21;18;39;6;1;7
96;10.01.2011;2011;01;07;Maanantai;55;46;101;44;11;55
96;10.01.2011;2011;01;08;Maanantai;72;81;153;38;12;50
96;10.01.2011;2011;01;09;Maanantai;34;51;85;18;14;32
96;10.01.2011;2011;01;10;Maanantai;42;37;79;29;14;43
96;10.01.2011;2011;01;11;Maanantai;36;41;77;13;23;36
96;10.01.2011;2011;01;12;Maanantai;53;51;104;19;24;43
96;10.01.2011;2011;01;13;Maanantai;46;30;76;14;19;33
96;10.01.2011;2011;01;14;Maanantai;53;60;113;17;21;38
96;10.01.2011;2011;01;15;Maanantai;41;91;132;14;30;44
96;10.01.2011;2011;01;16;Maanantai;71;108;179;14;58;72
96;10.01.2011;2011;01;17;Maanantai;52;49;101;16;21;37
96;10.01.2011;2011;01;18;Maanantai;52;28;80;18;25;43
96;10.01.2011;2011;01;19;Maanantai;30;23;53;24;21;45
96;10.01.2011;2011;01;20;Maanantai;37;22;59;11;15;26
96;10.01.2011;2011;01;21;Maanantai;19;12;31;4;3;7
96;10.01.2011;2011;01;22;Maanantai;10;7;17;0;0;0
96;10.01.2011;2011;01;23;Maanantai;1;1;2;0;0;0
96;11.01.2011;2011;01;00;Tiistai;2;1;3;0;0;0
96;11.01.2011;2011;01;01;Tiistai;1;0;1;0;0;0
96;11.01.2011;2011;01;02;Tiistai;0;0;0;0;0;0
96;11.01.2011;2011;01;03;Tiistai;1;0;1;0;0;0
96;11.01.2011;2011;01;04;Tiistai;4;1;5;1;0;1
96;11.01.2011;2011;01;05;Tiistai;6;4;10;11;3;14
96;11.01.2011;2011;01;06;Tiistai;25;23;48;36;9;45
96;11.01.2011;2011;01;07;Tiistai;51;50;101;23;13;36
96;11.01.2011;2011;01;08;Tiistai;92;89;181;13;9;22
96;11.01.2011;2011;01;09;Tiistai;39;36;75;9;16;25
96;11.01.2011;2011;01;10;Tiistai;40;38;78;10;12;22
96;11.01.2011;2011;01;11;Tiistai;35;34;69;13;6;19
96;11.01.2011;2011;01;12;Tiistai;35;34;69;10;13;23
96;11.01.2011;2011;01;13;Tiistai;36;35;71;7;23;30
96;11.01.2011;2011;01;14;Tiistai;57;56;113;7;38;45
96;11.01.2011;2011;01;15;Tiistai;82;79;161;18;60;78
96;11.01.2011;2011;01;16;Tiistai;99;96;195;20;30;50
96;11.01.2011;2011;01;17;Tiistai;53;49;102;7;23;30
96;11.01.2011;2011;01;18;Tiistai;39;36;75;10;9;19
96;11.01.2011;2011;01;19;Tiistai;32;28;60;13;5;18
96;11.01.2011;2011;01;20;Tiistai;28;27;55;20;11;31
96;11.01.2011;2011;01;21;Tiistai;33;30;63;2;4;6
96;11.01.2011;2011;01;22;Tiistai;10;7;17;0;0;0
96;11.01.2011;2011;01;23;Tiistai;5;3;8;0;0;0
96;12.01.2011;2011;01;00;Keskiviikko;1;0;1;0;0;0
96;12.01.2011;2011;01;01;Keskiviikko;0;0;0;1;0;1
96;12.01.2011;2011;01;02;Keskiviikko;1;0;1;0;0;0
96;12.01.2011;2011;01;03;Keskiviikko;0;0;0;0;1;1
96;12.01.2011;2011;01;04;Keskiviikko;5;1;6;0;2;2
96;12.01.2011;2011;01;05;Keskiviikko;2;0;2;5;1;6
96;12.01.2011;2011;01;06;Keskiviikko;22;21;43;32;13;45
96;12.01.2011;2011;01;07;Keskiviikko;59;58;117;18;8;26
96;12.01.2011;2011;01;08;Keskiviikko;88;86;174;13;12;25
96;12.01.2011;2011;01;09;Keskiviikko;46;42;88;2;17;19
96;12.01.2011;2011;01;10;Keskiviikko;35;33;68;6;10;16
96;12.01.2011;2011;01;11;Keskiviikko;32;29;61;14;12;26
96;12.01.2011;2011;01;12;Keskiviikko;36;32;68;8;10;18
96;12.01.2011;2011;01;13;Keskiviikko;43;40;83;8;14;22
96;12.01.2011;2011;01;14;Keskiviikko;52;49;101;6;35;41
96;12.01.2011;2011;01;15;Keskiviikko;88;87;175;9;46;55
96;12.01.2011;2011;01;16;Keskiviikko;92;91;183;11;12;23
96;12.01.2011;2011;01;17;Keskiviikko;57;53;110;9;5;14
96;12.01.2011;2011;01;18;Keskiviikko;44;40;84;10;7;17
96;12.01.2011;2011;01;19;Keskiviikko;33;33;66;8;3;11
96;12.01.2011;2011;01;20;Keskiviikko;28;18;46;4;7;11
96;12.01.2011;2011;01;21;Keskiviikko;23;20;43;0;2;2
96;12.01.2011;2011;01;22;Keskiviikko;8;12;20;0;1;1
96;12.01.2011;2011;01;23;Keskiviikko;2;0;2;0;0;0
96;13.01.2011;2011;01;00;Torstai;3;1;4;0;0;0
96;13.01.2011;2011;01;01;Torstai;0;0;0;0;0;0
96;13.01.2011;2011;01;02;Torstai;5;0;5;0;1;1
96;13.01.2011;2011;01;03;Torstai;1;0;1;0;0;0
96;13.01.2011;2011;01;04;Torstai;1;2;3;1;0;1
96;13.01.2011;2011;01;05;Torstai;0;2;2;0;0;0
96;13.01.2011;2011;01;06;Torstai;18;17;35;8;2;10
96;13.01.2011;2011;01;07;Torstai;50;46;96;34;9;43
96;13.01.2011;2011;01;08;Torstai;101;78;179;21;14;35
96;13.01.2011;2011;01;09;Torstai;32;28;60;14;15;29
96;13.01.2011;2011;01;10;Torstai;33;30;63;6;12;18
96;13.01.2011;2011;01;11;Torstai;28;26;54;4;9;13
96;13.01.2011;2011;01;12;Torstai;34;33;67;19;14;33
96;13.01.2011;2011;01;13;Torstai;37;43;80;15;12;27
96;13.01.2011;2011;01;14;Torstai;29;67;96;10;24;34
96;13.01.2011;2011;01;15;Torstai;61;121;182;5;42;47
96;13.01.2011;2011;01;16;Torstai;64;105;169;31;65;96
96;13.01.2011;2011;01;17;Torstai;43;43;86;10;25;35
96;13.01.2011;2011;01;18;Torstai;44;42;86;10;20;30
96;13.01.2011;2011;01;19;Torstai;29;27;56;10;15;25
96;13.01.2011;2011;01;20;Torstai;26;24;50;15;10;25
96;13.01.2011;2011;01;21;Torstai;17;14;31;0;5;5
96;13.01.2011;2011;01;22;Torstai;9;6;15;0;0;0
96;13.01.2011;2011;01;23;Torstai;2;0;2;0;0;0
96;14.01.2011;2011;01;00;Perjantai;3;0;3;0;0;0
96;14.01.2011;2011;01;01;Perjantai;2;1;3;0;0;0
96;14.01.2011;2011;01;02;Perjantai;1;0;1;0;0;0
96;14.01.2011;2011;01;03;Perjantai;1;0;1;0;0;0
96;14.01.2011;2011;01;04;Perjantai;4;1;5;0;0;0
96;14.01.2011;2011;01;05;Perjantai;3;2;5;0;0;0
96;14.01.2011;2011;01;06;Perjantai;18;15;33;0;0;0
96;14.01.2011;2011;01;07;Perjantai;46;44;90;0;10;10
96;14.01.2011;2011;01;08;Perjantai;80;78;158;15;15;30
96;14.01.2011;2011;01;09;Perjantai;40;39;79;10;20;30
96;14.01.2011;2011;01;10;Perjantai;32;29;61;20;20;40
96;14.01.2011;2011;01;11;Perjantai;31;31;62;30;25;55
96;14.01.2011;2011;01;12;Perjantai;34;42;76;33;33;66
96;14.01.2011;2011;01;13;Perjantai;32;68;100;24;25;49
96;14.01.2011;2011;01;14;Perjantai;38;80;118;11;17;28
96;14.01.2011;2011;01;15;Perjantai;48;96;144;27;60;87
96;14.01.2011;2011;01;16;Perjantai;53;55;108;12;35;47
96;14.01.2011;2011;01;17;Perjantai;39;28;67;13;15;28
96;14.01.2011;2011;01;18;Perjantai;39;13;52;20;15;35
96;14.01.2011;2011;01;19;Perjantai;21;16;37;13;9;22
96;14.01.2011;2011;01;20;Perjantai;26;7;33;10;12;22
96;14.01.2011;2011;01;21;Perjantai;11;8;19;3;7;10
96;14.01.2011;2011;01;22;Perjantai;6;5;11;1;2;3
96;14.01.2011;2011;01;23;Perjantai;5;0;5;2;0;2
96;15.01.2011;2011;01;00;Lauantai;5;2;7;0;0;0
96;15.01.2011;2011;01;01;Lauantai;3;2;5;4;0;4
96;15.01.2011;2011;01;02;Lauantai;3;2;5;1;0;1
96;15.01.2011;2011;01;03;Lauantai;4;1;5;2;0;2
96;15.01.2011;2011;01;04;Lauantai;2;0;2;1;0;1
96;15.01.2011;2011;01;05;Lauantai;0;4;4;0;0;0
96;15.01.2011;2011;01;06;Lauantai;6;5;11;2;0;2
96;15.01.2011;2011;01;07;Lauantai;4;7;11;3;4;7
96;15.01.2011;2011;01;08;Lauantai;4;4;8;0;3;3
96;15.01.2011;2011;01;09;Lauantai;8;12;20;7;7;14
96;15.01.2011;2011;01;10;Lauantai;3;4;7;5;10;15
96;15.01.2011;2011;01;11;Lauantai;10;21;31;2;7;9
96;15.01.2011;2011;01;12;Lauantai;14;23;37;14;10;24
96;15.01.2011;2011;01;13;Lauantai;16;19;35;10;16;26
96;15.01.2011;2011;01;14;Lauantai;13;11;24;10;7;17
96;15.01.2011;2011;01;15;Lauantai;10;19;29;6;11;17
96;15.01.2011;2011;01;16;Lauantai;16;8;24;4;8;12
96;15.01.2011;2011;01;17;Lauantai;10;10;20;8;4;12
96;15.01.2011;2011;01;18;Lauantai;11;17;28;4;6;10
96;15.01.2011;2011;01;19;Lauantai;5;11;16;5;6;11
96;15.01.2011;2011;01;20;Lauantai;10;5;15;5;1;6
96;15.01.2011;2011;01;21;Lauantai;18;7;25;11;4;15
96;15.01.2011;2011;01;22;Lauantai;2;5;7;2;0;2
96;15.01.2011;2011;01;23;Lauantai;6;2;8;1;1;2
96;16.01.2011;2011;01;00;Sunnuntai;4;1;5;0;2;2
96;16.01.2011;2011;01;01;Sunnuntai;6;0;6;0;0;0
96;16.01.2011;2011;01;02;Sunnuntai;1;0;1;0;0;0
96;16.01.2011;2011;01;03;Sunnuntai;5;0;5;1;0;1
96;16.01.2011;2011;01;04;Sunnuntai;2;0;2;0;0;0
96;16.01.2011;2011;01;05;Sunnuntai;0;1;1;0;0;0
96;16.01.2011;2011;01;06;Sunnuntai;2;0;2;4;0;4
96;16.01.2011;2011;01;07;Sunnuntai;4;7;11;1;4;5
96;16.01.2011;2011;01;08;Sunnuntai;3;6;9;0;4;4
96;16.01.2011;2011;01;09;Sunnuntai;1;3;4;9;4;13
96;16.01.2011;2011;01;10;Sunnuntai;5;6;11;6;11;17
96;16.01.2011;2011;01;11;Sunnuntai;4;15;19;9;11;20
96;16.01.2011;2011;01;12;Sunnuntai;13;9;22;13;13;26
96;16.01.2011;2011;01;13;Sunnuntai;16;10;26;23;13;36
96;16.01.2011;2011;01;14;Sunnuntai;16;18;34;12;19;31
96;16.01.2011;2011;01;15;Sunnuntai;16;20;36;16;16;32
96;16.01.2011;2011;01;16;Sunnuntai;10;23;33;9;15;24
96;16.01.2011;2011;01;17;Sunnuntai;12;17;29;11;11;22
96;16.01.2011;2011;01;18;Sunnuntai;21;7;28;5;8;13
96;16.01.2011;2011;01;19;Sunnuntai;15;5;20;9;8;17
96;16.01.2011;2011;01;20;Sunnuntai;11;8;19;8;11;19
96;16.01.2011;2011;01;21;Sunnuntai;11;5;16;4;8;12
96;16.01.2011;2011;01;22;Sunnuntai;6;2;8;0;2;2
96;16.01.2011;2011;01;23;Sunnuntai;1;0;1;0;0;0
96;17.01.2011;2011;01;00;Maanantai;0;0;0;0;0;0
96;17.01.2011;2011;01;01;Maanantai;0;0;0;1;0;1
96;17.01.2011;2011;01;02;Maanantai;0;0;0;0;0;0
96;17.01.2011;2011;01;03;Maanantai;1;0;1;0;0;0
96;17.01.2011;2011;01;04;Maanantai;2;1;3;3;1;4
96;17.01.2011;2011;01;05;Maanantai;0;3;3;0;0;0
96;17.01.2011;2011;01;06;Maanantai;19;18;37;2;1;3
96;17.01.2011;2011;01;07;Maanantai;53;45;98;4;8;12
96;17.01.2011;2011;01;08;Maanantai;82;67;149;9;3;12
96;17.01.2011;2011;01;09;Maanantai;43;29;72;7;10;17
96;17.01.2011;2011;01;10;Maanantai;47;32;79;11;2;13
96;17.01.2011;2011;01;11;Maanantai;34;22;56;2;4;6
96;17.01.2011;2011;01;12;Maanantai;37;23;60;5;11;16
96;17.01.2011;2011;01;13;Maanantai;39;38;77;7;10;17
96;17.01.2011;2011;01;14;Maanantai;41;55;96;7;9;16
96;17.01.2011;2011;01;15;Maanantai;65;89;154;17;30;47
96;17.01.2011;2011;01;16;Maanantai;73;95;168;25;43;68
96;17.01.2011;2011;01;17;Maanantai;56;51;107;10;17;27
96;17.01.2011;2011;01;18;Maanantai;35;25;60;14;18;32
96;17.01.2011;2011;01;19;Maanantai;40;21;61;26;11;37
96;17.01.2011;2011;01;20;Maanantai;38;13;51;12;17;29
96;17.01.2011;2011;01;21;Maanantai;32;17;49;8;8;16
96;17.01.2011;2011;01;22;Maanantai;6;4;10;0;4;4
96;17.01.2011;2011;01;23;Maanantai;7;1;8;2;0;2
96;18.01.2011;2011;01;00;Tiistai;0;1;1;1;0;1
96;18.01.2011;2011;01;01;Tiistai;0;0;0;0;0;0
96;18.01.2011;2011;01;02;Tiistai;1;0;1;0;0;0
96;18.01.2011;2011;01;03;Tiistai;0;1;1;0;0;0
96;18.01.2011;2011;01;04;Tiistai;5;5;10;2;1;3
96;18.01.2011;2011;01;05;Tiistai;3;6;9;0;0;0
96;18.01.2011;2011;01;06;Tiistai;24;16;40;8;2;10
96;18.01.2011;2011;01;07;Tiistai;67;44;111;27;13;40
96;18.01.2011;2011;01;08;Tiistai;120;68;188;22;7;29
96;18.01.2011;2011;01;09;Tiistai;40;40;80;7;9;16
96;18.01.2011;2011;01;10;Tiistai;55;35;90;11;2;13
96;18.01.2011;2011;01;11;Tiistai;37;33;70;1;0;1
96;18.01.2011;2011;01;12;Tiistai;39;36;75;13;0;13
96;18.01.2011;2011;01;13;Tiistai;38;36;74;4;0;4
96;18.01.2011;2011;01;14;Tiistai;59;51;110;3;0;3
96;18.01.2011;2011;01;15;Tiistai;79;77;156;6;0;6
96;18.01.2011;2011;01;16;Tiistai;95;90;185;17;0;17
96;18.01.2011;2011;01;17;Tiistai;56;50;106;3;0;3
96;18.01.2011;2011;01;18;Tiistai;36;29;65;14;0;14
96;18.01.2011;2011;01;19;Tiistai;34;32;66;9;0;9
96;18.01.2011;2011;01;20;Tiistai;23;20;43;5;0;5
96;18.01.2011;2011;01;21;Tiistai;21;17;38;2;0;2
96;18.01.2011;2011;01;22;Tiistai;13;10;23;3;0;3
96;18.01.2011;2011;01;23;Tiistai;7;4;11;0;0;0
96;19.01.2011;2011;01;00;Keskiviikko;4;2;6;1;0;1
96;19.01.2011;2011;01;01;Keskiviikko;0;0;0;1;0;1
96;19.01.2011;2011;01;02;Keskiviikko;2;0;2;0;0;0
96;19.01.2011;2011;01;03;Keskiviikko;0;0;0;0;0;0
96;19.01.2011;2011;01;04;Keskiviikko;4;2;6;1;0;1
96;19.01.2011;2011;01;05;Keskiviikko;4;1;5;0;0;0
96;19.01.2011;2011;01;06;Keskiviikko;29;12;41;5;0;5
96;19.01.2011;2011;01;07;Keskiviikko;68;40;108;20;0;20
96;19.01.2011;2011;01;08;Keskiviikko;137;46;183;21;0;21
96;19.01.2011;2011;01;09;Keskiviikko;68;23;91;20;0;20
96;19.01.2011;2011;01;10;Keskiviikko;87;15;102;13;0;13
96;19.01.2011;2011;01;11;Keskiviikko;68;12;80;15;0;15
96;19.01.2011;2011;01;12;Keskiviikko;81;6;87;37;0;37
96;19.01.2011;2011;01;13;Keskiviikko;76;6;82;40;0;40
96;19.01.2011;2011;01;14;Keskiviikko;92;8;100;33;0;33
96;19.01.2011;2011;01;15;Keskiviikko;148;7;155;45;0;45
96;19.01.2011;2011;01;16;Keskiviikko;173;10;183;72;0;72
96;19.01.2011;2011;01;17;Keskiviikko;118;1;119;37;0;37
96;19.01.2011;2011;01;18;Keskiviikko;103;1;104;39;0;39
96;19.01.2011;2011;01;19;Keskiviikko;78;1;79;44;0;44
96;19.01.2011;2011;01;20;Keskiviikko;57;0;57;21;0;21
96;19.01.2011;2011;01;21;Keskiviikko;42;0;42;18;0;18
96;19.01.2011;2011;01;22;Keskiviikko;21;0;21;3;0;3
96;19.01.2011;2011;01;23;Keskiviikko;10;0;10;3;0;3
96;20.01.2011;2011;01;00;Torstai;6;0;6;1;0;1
96;20.01.2011;2011;01;01;Torstai;2;0;2;0;0;0
96;20.01.2011;2011;01;02;Torstai;5;0;5;2;0;2
96;20.01.2011;2011;01;03;Torstai;1;0;1;1;0;1
96;20.01.2011;2011;01;04;Torstai;8;0;8;1;0;1
96;20.01.2011;2011;01;05;Torstai;5;0;5;0;0;0
96;20.01.2011;2011;01;06;Torstai;48;0;48;9;0;9
96;20.01.2011;2011;01;07;Torstai;107;0;107;41;0;41
96;20.01.2011;2011;01;08;Torstai;194;0;194;39;0;39
96;20.01.2011;2011;01;09;Torstai;57;0;57;30;0;30
96;20.01.2011;2011;01;10;Torstai;62;0;62;24;0;24
96;20.01.2011;2011;01;11;Torstai;71;0;71;21;0;21
96;20.01.2011;2011;01;12;Torstai;89;0;89;40;0;40
96;20.01.2011;2011;01;13;Torstai;84;0;84;29;0;29
96;20.01.2011;2011;01;14;Torstai;105;0;105;37;0;37
96;20.01.2011;2011;01;15;Torstai;170;0;170;51;0;51
96;20.01.2011;2011;01;16;Torstai;196;0;196;88;0;88
96;20.01.2011;2011;01;17;Torstai;112;0;112;40;0;40
96;20.01.2011;2011;01;18;Torstai;90;0;90;43;0;43
96;20.01.2011;2011;01;19;Torstai;52;0;52;76;0;76
96;20.01.2011;2011;01;20;Torstai;43;0;43;25;0;25
96;20.01.2011;2011;01;21;Torstai;63;0;63;31;0;31
96;20.01.2011;2011;01;22;Torstai;20;0;20;7;0;7
96;20.01.2011;2011;01;23;Torstai;10;0;10;1;0;1
96;21.01.2011;2011;01;00;Perjantai;6;0;6;3;0;3
96;21.01.2011;2011;01;01;Perjantai;4;0;4;2;0;2
96;21.01.2011;2011;01;02;Perjantai;2;0;2;0;0;0
96;21.01.2011;2011;01;03;Perjantai;2;0;2;1;0;1
96;21.01.2011;2011;01;04;Perjantai;6;0;6;0;0;0
96;21.01.2011;2011;01;05;Perjantai;6;0;6;0;0;0
96;21.01.2011;2011;01;06;Perjantai;50;0;50;10;0;10
96;21.01.2011;2011;01;07;Perjantai;89;0;89;46;0;46
96;21.01.2011;2011;01;08;Perjantai;173;0;173;58;0;58
96;21.01.2011;2011;01;09;Perjantai;65;0;65;27;0;27
96;21.01.2011;2011;01;10;Perjantai;71;0;71;23;0;23
96;21.01.2011;2011;01;11;Perjantai;84;0;84;34;0;34
96;21.01.2011;2011;01;12;Perjantai;84;0;84;32;0;32
96;21.01.2011;2011;01;13;Perjantai;98;0;98;41;0;41
96;21.01.2011;2011;01;14;Perjantai;139;0;139;46;0;46
96;21.01.2011;2011;01;15;Perjantai;122;0;122;63;0;63
96;21.01.2011;2011;01;16;Perjantai;118;0;118;50;0;50
96;21.01.2011;2011;01;17;Perjantai;69;0;69;27;0;27
96;21.01.2011;2011;01;18;Perjantai;54;0;54;26;0;26
96;21.01.2011;2011;01;19;Perjantai;47;0;47;13;0;13
96;21.01.2011;2011;01;20;Perjantai;34;0;34;15;0;15
96;21.01.2011;2011;01;21;Perjantai;33;0;33;17;0;17
96;21.01.2011;2011;01;22;Perjantai;12;0;12;1;0;1
96;21.01.2011;2011;01;23;Perjantai;6;0;6;0;0;0
96;22.01.2011;2011;01;00;Lauantai;9;0;9;2;0;2
96;22.01.2011;2011;01;01;Lauantai;4;0;4;4;0;4
96;22.01.2011;2011;01;02;Lauantai;8;1;9;0;0;0
96;22.01.2011;2011;01;03;Lauantai;6;0;6;1;0;1
96;22.01.2011;2011;01;04;Lauantai;5;0;5;0;0;0
96;22.01.2011;2011;01;05;Lauantai;3;0;3;3;0;3
96;22.01.2011;2011;01;06;Lauantai;8;1;9;1;0;1
96;22.01.2011;2011;01;07;Lauantai;11;4;15;3;0;3
96;22.01.2011;2011;01;08;Lauantai;9;1;10;2;0;2
96;22.01.2011;2011;01;09;Lauantai;22;6;28;16;0;16
96;22.01.2011;2011;01;10;Lauantai;26;2;28;15;0;15
96;22.01.2011;2011;01;11;Lauantai;34;5;39;21;0;21
96;22.01.2011;2011;01;12;Lauantai;38;5;43;21;0;21
96;22.01.2011;2011;01;13;Lauantai;44;6;50;19;0;19
96;22.01.2011;2011;01;14;Lauantai;41;6;47;23;0;23
96;22.01.2011;2011;01;15;Lauantai;39;7;46;23;0;23
96;22.01.2011;2011;01;16;Lauantai;34;3;37;19;0;19
96;22.01.2011;2011;01;17;Lauantai;32;1;33;15;0;15
96;22.01.2011;2011;01;18;Lauantai;32;2;34;18;0;18
96;22.01.2011;2011;01;19;Lauantai;24;0;24;7;0;7
96;22.01.2011;2011;01;20;Lauantai;14;0;14;8;0;8
96;22.01.2011;2011;01;21;Lauantai;20;1;21;9;0;9
96;22.01.2011;2011;01;22;Lauantai;11;0;11;4;0;4
96;22.01.2011;2011;01;23;Lauantai;11;0;11;3;0;3
96;23.01.2011;2011;01;00;Sunnuntai;9;0;9;0;0;0
96;23.01.2011;2011;01;01;Sunnuntai;12;0;12;1;0;1
96;23.01.2011;2011;01;02;Sunnuntai;3;0;3;3;0;3
96;23.01.2011;2011;01;03;Sunnuntai;9;0;9;2;0;2
96;23.01.2011;2011;01;04;Sunnuntai;6;0;6;2;0;2
96;23.01.2011;2011;01;05;Sunnuntai;8;0;8;1;0;1
96;23.01.2011;2011;01;06;Sunnuntai;19;0;19;4;0;4
96;23.01.2011;2011;01;07;Sunnuntai;5;1;6;4;0;4
96;23.01.2011;2011;01;08;Sunnuntai;8;0;8;6;0;6
96;23.01.2011;2011;01;09;Sunnuntai;7;0;7;16;0;16
96;23.01.2011;2011;01;10;Sunnuntai;12;1;13;11;0;11
96;23.01.2011;2011;01;11;Sunnuntai;11;0;11;13;0;13
96;23.01.2011;2011;01;12;Sunnuntai;24;1;25;20;0;20
96;23.01.2011;2011;01;13;Sunnuntai;32;0;32;24;0;24
96;23.01.2011;2011;01;14;Sunnuntai;52;3;55;20;0;20
96;23.01.2011;2011;01;15;Sunnuntai;43;0;43;31;0;31
96;23.01.2011;2011;01;16;Sunnuntai;35;0;35;27;0;27
96;23.01.2011;2011;01;17;Sunnuntai;32;2;34;21;0;21
96;23.01.2011;2011;01;18;Sunnuntai;25;0;25;15;0;15
96;23.01.2011;2011;01;19;Sunnuntai;19;0;19;19;0;19
96;23.01.2011;2011;01;20;Sunnuntai;26;1;27;22;0;22
96;23.01.2011;2011;01;21;Sunnuntai;26;0;26;10;0;10
96;23.01.2011;2011;01;22;Sunnuntai;7;0;7;6;0;6
96;23.01.2011;2011;01;23;Sunnuntai;3;0;3;1;0;1
96;24.01.2011;2011;01;00;Maanantai;4;0;4;0;0;0
96;24.01.2011;2011;01;01;Maanantai;1;0;1;0;0;0
96;24.01.2011;2011;01;02;Maanantai;2;0;2;0;0;0
96;24.01.2011;2011;01;03;Maanantai;1;0;1;0;0;0
96;24.01.2011;2011;01;04;Maanantai;4;1;5;4;0;4
96;24.01.2011;2011;01;05;Maanantai;5;0;5;0;0;0
96;24.01.2011;2011;01;06;Maanantai;38;5;43;7;0;7
96;24.01.2011;2011;01;07;Maanantai;97;8;105;36;0;36
96;24.01.2011;2011;01;08;Maanantai;183;9;192;41;0;41
96;24.01.2011;2011;01;09;Maanantai;71;7;78;21;0;21
96;24.01.2011;2011;01;10;Maanantai;83;6;89;24;0;24
96;24.01.2011;2011;01;11;Maanantai;52;8;60;13;0;13
96;24.01.2011;2011;01;12;Maanantai;53;7;60;25;0;25
96;24.01.2011;2011;01;13;Maanantai;48;17;65;82;34;116
96;24.01.2011;2011;01;14;Maanantai;35;38;73;18;36;54
96;24.01.2011;2011;01;15;Maanantai;34;106;140;12;40;52
96;24.01.2011;2011;01;16;Maanantai;64;144;208;18;57;75
96;24.01.2011;2011;01;17;Maanantai;47;44;91;27;23;50
96;24.01.2011;2011;01;18;Maanantai;29;42;71;33;38;71
96;24.01.2011;2011;01;19;Maanantai;32;28;60;18;25;43
96;24.01.2011;2011;01;20;Maanantai;49;13;62;18;17;35
96;24.01.2011;2011;01;21;Maanantai;31;7;38;15;8;23
96;24.01.2011;2011;01;22;Maanantai;9;3;12;4;6;10
96;24.01.2011;2011;01;23;Maanantai;4;2;6;1;0;1
96;25.01.2011;2011;01;00;Tiistai;0;2;2;1;0;1
96;25.01.2011;2011;01;01;Tiistai;1;0;1;1;0;1
96;25.01.2011;2011;01;02;Tiistai;0;0;0;0;0;0
96;25.01.2011;2011;01;03;Tiistai;0;0;0;0;0;0
96;25.01.2011;2011;01;04;Tiistai;3;2;5;0;1;1
96;25.01.2011;2011;01;05;Tiistai;3;5;8;0;1;1
96;25.01.2011;2011;01;06;Tiistai;21;17;38;11;4;15
96;25.01.2011;2011;01;07;Tiistai;46;30;76;34;18;52
96;25.01.2011;2011;01;08;Tiistai;115;68;183;26;21;47
96;25.01.2011;2011;01;09;Tiistai;25;30;55;17;15;32
96;25.01.2011;2011;01;10;Tiistai;28;35;63;9;15;24
96;25.01.2011;2011;01;11;Tiistai;23;23;46;11;10;21
96;25.01.2011;2011;01;12;Tiistai;27;36;63;14;18;32
96;25.01.2011;2011;01;13;Tiistai;29;38;67;4;13;17
96;25.01.2011;2011;01;14;Tiistai;34;49;83;10;24;34
96;25.01.2011;2011;01;15;Tiistai;45;93;138;10;48;58
96;25.01.2011;2011;01;16;Tiistai;56;85;141;17;53;70
96;25.01.2011;2011;01;17;Tiistai;35;49;84;13;25;38
96;25.01.2011;2011;01;18;Tiistai;37;39;76;15;22;37
96;25.01.2011;2011;01;19;Tiistai;20;22;42;9;9;18
96;25.01.2011;2011;01;20;Tiistai;34;17;51;16;6;22
96;25.01.2011;2011;01;21;Tiistai;45;11;56;14;6;20
96;25.01.2011;2011;01;22;Tiistai;18;8;26;1;3;4
96;25.01.2011;2011;01;23;Tiistai;4;2;6;0;0;0
96;26.01.2011;2011;01;00;Keskiviikko;2;1;3;1;1;2
96;26.01.2011;2011;01;01;Keskiviikko;0;0;0;1;0;1
96;26.01.2011;2011;01;02;Keskiviikko;0;0;0;0;0;0
96;26.01.2011;2011;01;03;Keskiviikko;1;0;1;0;1;1
96;26.01.2011;2011;01;04;Keskiviikko;2;2;4;0;0;0
96;26.01.2011;2011;01;05;Keskiviikko;2;5;7;0;1;1
96;26.01.2011;2011;01;06;Keskiviikko;20;10;30;4;2;6
96;26.01.2011;2011;01;07;Keskiviikko;59;27;86;39;18;57
96;26.01.2011;2011;01;08;Keskiviikko;92;44;136;26;9;35
96;26.01.2011;2011;01;09;Keskiviikko;37;25;62;11;10;21
96;26.01.2011;2011;01;10;Keskiviikko;33;12;45;8;9;17
96;26.01.2011;2011;01;11;Keskiviikko;18;23;41;3;9;12
96;26.01.2011;2011;01;12;Keskiviikko;27;31;58;10;10;20
96;26.01.2011;2011;01;13;Keskiviikko;31;40;71;13;15;28
96;26.01.2011;2011;01;14;Keskiviikko;27;31;58;4;20;24
96;26.01.2011;2011;01;15;Keskiviikko;34;98;132;11;46;57
96;26.01.2011;2011;01;16;Keskiviikko;48;104;152;8;49;57
96;26.01.2011;2011;01;17;Keskiviikko;33;44;77;8;24;32
96;26.01.2011;2011;01;18;Keskiviikko;24;33;57;12;16;28
96;26.01.2011;2011;01;19;Keskiviikko;22;20;42;8;10;18
96;26.01.2011;2011;01;20;Keskiviikko;24;10;34;13;9;22
96;26.01.2011;2011;01;21;Keskiviikko;23;16;39;10;8;18
96;26.01.2011;2011;01;22;Keskiviikko;7;6;13;2;2;4
96;26.01.2011;2011;01;23;Keskiviikko;4;1;5;1;0;1
96;27.01.2011;2011;01;00;Torstai;1;0;1;0;0;0
96;27.01.2011;2011;01;01;Torstai;2;0;2;0;0;0
96;27.01.2011;2011;01;02;Torstai;3;0;3;0;0;0
96;27.01.2011;2011;01;03;Torstai;0;0;0;0;1;1
96;27.01.2011;2011;01;04;Torstai;1;1;2;0;0;0
96;27.01.2011;2011;01;05;Torstai;3;4;7;0;2;2
96;27.01.2011;2011;01;06;Torstai;41;20;61;6;4;10
96;27.01.2011;2011;01;07;Torstai;83;36;119;43;25;68
96;27.01.2011;2011;01;08;Torstai;66;48;114;13;13;26
96;27.01.2011;2011;01;09;Torstai;43;42;85;8;8;16
96;27.01.2011;2011;01;10;Torstai;34;22;56;10;8;18
96;27.01.2011;2011;01;11;Torstai;19;18;37;11;13;24
96;27.01.2011;2011;01;12;Torstai;35;25;60;14;15;29
96;27.01.2011;2011;01;13;Torstai;29;32;61;12;16;28
96;27.01.2011;2011;01;14;Torstai;52;65;117;14;22;36
96;27.01.2011;2011;01;15;Torstai;48;125;173;13;48;61
96;27.01.2011;2011;01;16;Torstai;42;90;132;21;67;88
96;27.01.2011;2011;01;17;Torstai;48;46;94;10;25;35
96;27.01.2011;2011;01;18;Torstai;44;35;79;29;18;47
96;27.01.2011;2011;01;19;Torstai;32;23;55;29;19;48
96;27.01.2011;2011;01;20;Torstai;22;14;36;12;16;28
96;27.01.2011;2011;01;21;Torstai;41;15;56;11;8;19
96;27.01.2011;2011;01;22;Torstai;10;1;11;2;1;3
96;27.01.2011;2011;01;23;Torstai;1;2;3;1;1;2
96;28.01.2011;2011;01;00;Perjantai;1;1;2;0;1;1
96;28.01.2011;2011;01;01;Perjantai;3;0;3;0;0;0
96;28.01.2011;2011;01;02;Perjantai;3;1;4;2;1;3
96;28.01.2011;2011;01;03;Perjantai;3;0;3;0;0;0
96;28.01.2011;2011;01;04;Perjantai;1;5;6;0;0;0
96;28.01.2011;2011;01;05;Perjantai;1;11;12;0;0;0
96;28.01.2011;2011;01;06;Perjantai;41;23;64;5;3;8
96;28.01.2011;2011;01;07;Perjantai;70;62;132;47;14;61
96;28.01.2011;2011;01;08;Perjantai;72;60;132;21;9;30
96;28.01.2011;2011;01;09;Perjantai;33;43;76;10;15;25
96;28.01.2011;2011;01;10;Perjantai;44;32;76;12;18;30
96;28.01.2011;2011;01;11;Perjantai;36;51;87;11;19;30
96;28.01.2011;2011;01;12;Perjantai;30;51;81;16;31;47
96;28.01.2011;2011;01;13;Perjantai;46;54;100;18;36;54
96;28.01.2011;2011;01;14;Perjantai;66;83;149;21;54;75
96;28.01.2011;2011;01;15;Perjantai;69;96;165;15;54;69
96;28.01.2011;2011;01;16;Perjantai;63;56;119;26;23;49
96;28.01.2011;2011;01;17;Perjantai;30;32;62;13;23;36
96;28.01.2011;2011;01;18;Perjantai;29;20;49;10;13;23
96;28.01.2011;2011;01;19;Perjantai;17;19;36;22;19;41
96;28.01.2011;2011;01;20;Perjantai;26;15;41;14;12;26
96;28.01.2011;2011;01;21;Perjantai;15;14;29;5;10;15
96;28.01.2011;2011;01;22;Perjantai;3;3;6;2;2;4
96;28.01.2011;2011;01;23;Perjantai;5;2;7;4;0;4
96;29.01.2011;2011;01;00;Lauantai;8;4;12;0;0;0
96;29.01.2011;2011;01;01;Lauantai;6;4;10;1;1;2
96;29.01.2011;2011;01;02;Lauantai;5;1;6;1;0;1
96;29.01.2011;2011;01;03;Lauantai;12;0;12;3;1;4
96;29.01.2011;2011;01;04;Lauantai;5;0;5;3;1;4
96;29.01.2011;2011;01;05;Lauantai;2;1;3;1;1;2
96;29.01.2011;2011;01;06;Lauantai;17;7;24;5;0;5
96;29.01.2011;2011;01;07;Lauantai;2;5;7;0;3;3
96;29.01.2011;2011;01;08;Lauantai;3;11;14;0;4;4
96;29.01.2011;2011;01;09;Lauantai;7;19;26;12;13;25
96;29.01.2011;2011;01;10;Lauantai;11;26;37;19;10;29
96;29.01.2011;2011;01;11;Lauantai;9;21;30;5;25;30
96;29.01.2011;2011;01;12;Lauantai;20;11;31;23;22;45
96;29.01.2011;2011;01;13;Lauantai;23;20;43;9;8;17
96;29.01.2011;2011;01;14;Lauantai;14;29;43;15;17;32
96;29.01.2011;2011;01;15;Lauantai;29;22;51;9;24;33
96;29.01.2011;2011;01;16;Lauantai;19;18;37;19;30;49
96;29.01.2011;2011;01;17;Lauantai;26;12;38;10;5;15
96;29.01.2011;2011;01;18;Lauantai;13;6;19;8;9;17
96;29.01.2011;2011;01;19;Lauantai;12;6;18;7;6;13
96;29.01.2011;2011;01;20;Lauantai;13;5;18;3;3;6
96;29.01.2011;2011;01;21;Lauantai;6;13;19;2;3;5
96;29.01.2011;2011;01;22;Lauantai;5;7;12;3;5;8
96;29.01.2011;2011;01;23;Lauantai;3;1;4;0;2;2
96;30.01.2011;2011;01;00;Sunnuntai;2;1;3;1;1;2
96;30.01.2011;2011;01;01;Sunnuntai;5;3;8;0;0;0
96;30.01.2011;2011;01;02;Sunnuntai;8;0;8;3;2;5
96;30.01.2011;2011;01;03;Sunnuntai;6;0;6;2;0;2
96;30.01.2011;2011;01;04;Sunnuntai;5;0;5;3;0;3
96;30.01.2011;2011;01;05;Sunnuntai;2;0;2;0;0;0
96;30.01.2011;2011;01;06;Sunnuntai;12;3;15;4;1;5
96;30.01.2011;2011;01;07;Sunnuntai;2;5;7;1;2;3
96;30.01.2011;2011;01;08;Sunnuntai;2;6;8;6;4;10
96;30.01.2011;2011;01;09;Sunnuntai;4;5;9;6;11;17
96;30.01.2011;2011;01;10;Sunnuntai;2;10;12;12;8;20
96;30.01.2011;2011;01;11;Sunnuntai;8;15;23;29;18;47
96;30.01.2011;2011;01;12;Sunnuntai;20;21;41;43;30;73
96;30.01.2011;2011;01;13;Sunnuntai;27;16;43;29;33;62
96;30.01.2011;2011;01;14;Sunnuntai;13;21;34;33;31;64
96;30.01.2011;2011;01;15;Sunnuntai;10;21;31;25;37;62
96;30.01.2011;2011;01;16;Sunnuntai;22;16;38;16;12;28
96;30.01.2011;2011;01;17;Sunnuntai;14;20;34;13;15;28
96;30.01.2011;2011;01;18;Sunnuntai;14;6;20;9;17;26
96;30.01.2011;2011;01;19;Sunnuntai;18;12;30;11;5;16
96;30.01.2011;2011;01;20;Sunnuntai;16;7;23;15;9;24
96;30.01.2011;2011;01;21;Sunnuntai;12;6;18;5;5;10
96;30.01.2011;2011;01;22;Sunnuntai;8;4;12;1;1;2
96;30.01.2011;2011;01;23;Sunnuntai;1;1;2;1;0;1
96;07.02.2011;2011;02;00;Maanantai;3;1;4;1;0;1
96;07.02.2011;2011;02;01;Maanantai;1;1;2;0;2;2
96;07.02.2011;2011;02;02;Maanantai;0;0;0;1;0;1
96;07.02.2011;2011;02;03;Maanantai;2;0;2;2;3;5
96;07.02.2011;2011;02;04;Maanantai;4;3;7;0;0;0
96;07.02.2011;2011;02;05;Maanantai;5;4;9;0;1;1
96;07.02.2011;2011;02;06;Maanantai;21;19;40;13;2;15
96;07.02.2011;2011;02;07;Maanantai;51;49;100;51;15;66
96;07.02.2011;2011;02;08;Maanantai;47;47;94;17;15;32
96;07.02.2011;2011;02;09;Maanantai;33;31;64;17;12;29
96;07.02.2011;2011;02;10;Maanantai;26;23;49;9;10;19
96;07.02.2011;2011;02;11;Maanantai;24;21;45;15;5;20
96;07.02.2011;2011;02;12;Maanantai;32;29;61;17;3;20
96;07.02.2011;2011;02;13;Maanantai;29;28;57;15;12;27
96;07.02.2011;2011;02;14;Maanantai;35;34;69;14;18;32
96;07.02.2011;2011;02;15;Maanantai;72;69;141;9;55;64
96;07.02.2011;2011;02;16;Maanantai;65;63;128;23;46;69
96;07.02.2011;2011;02;17;Maanantai;37;34;71;24;29;53
96;07.02.2011;2011;02;18;Maanantai;22;19;41;34;34;68
96;07.02.2011;2011;02;19;Maanantai;20;20;40;37;28;65
96;07.02.2011;2011;02;20;Maanantai;19;17;36;17;24;41
96;07.02.2011;2011;02;21;Maanantai;17;16;33;15;17;32
96;07.02.2011;2011;02;22;Maanantai;4;2;6;0;5;5
96;07.02.2011;2011;02;23;Maanantai;3;2;5;2;0;2
96;08.02.2011;2011;02;00;Tiistai;1;1;2;0;0;0
96;08.02.2011;2011;02;01;Tiistai;1;0;1;0;1;1
96;08.02.2011;2011;02;02;Tiistai;1;0;1;0;1;1
96;08.02.2011;2011;02;03;Tiistai;1;0;1;0;0;0
96;08.02.2011;2011;02;04;Tiistai;5;1;6;0;0;0
96;08.02.2011;2011;02;05;Tiistai;7;4;11;0;1;1
96;08.02.2011;2011;02;06;Tiistai;33;32;65;20;12;32
96;08.02.2011;2011;02;07;Tiistai;76;73;149;43;32;75
96;08.02.2011;2011;02;08;Tiistai;64;63;127;15;20;35
96;08.02.2011;2011;02;09;Tiistai;36;34;70;12;11;23
96;08.02.2011;2011;02;10;Tiistai;34;33;67;15;17;32
96;08.02.2011;2011;02;11;Tiistai;37;35;72;23;30;53
96;08.02.2011;2011;02;12;Tiistai;39;37;76;18;29;47
96;08.02.2011;2011;02;13;Tiistai;43;41;84;26;36;62
96;08.02.2011;2011;02;14;Tiistai;58;58;116;24;27;51
96;08.02.2011;2011;02;15;Tiistai;86;83;169;38;40;78
96;08.02.2011;2011;02;16;Tiistai;74;74;148;46;41;87
96;08.02.2011;2011;02;17;Tiistai;47;45;92;34;15;49
96;08.02.2011;2011;02;18;Tiistai;36;33;69;32;17;49
96;08.02.2011;2011;02;19;Tiistai;26;26;52;41;15;56
96;08.02.2011;2011;02;20;Tiistai;28;27;55;21;11;32
96;08.02.2011;2011;02;21;Tiistai;17;15;32;11;10;21
96;08.02.2011;2011;02;22;Tiistai;7;5;12;3;1;4
96;08.02.2011;2011;02;23;Tiistai;5;2;7;0;0;0
96;09.02.2011;2011;02;00;Keskiviikko;3;1;4;0;1;1
96;09.02.2011;2011;02;01;Keskiviikko;2;0;2;1;0;1
96;09.02.2011;2011;02;02;Keskiviikko;0;0;0;0;1;1
96;09.02.2011;2011;02;03;Keskiviikko;1;0;1;0;0;0
96;09.02.2011;2011;02;04;Keskiviikko;3;2;5;1;0;1
96;09.02.2011;2011;02;05;Keskiviikko;7;4;11;6;0;6
96;09.02.2011;2011;02;06;Keskiviikko;28;27;55;15;2;17
96;09.02.2011;2011;02;07;Keskiviikko;65;64;129;49;8;57
96;09.02.2011;2011;02;08;Keskiviikko;65;62;127;14;7;21
96;09.02.2011;2011;02;09;Keskiviikko;46;43;89;25;10;35
96;09.02.2011;2011;02;10;Keskiviikko;28;25;53;19;4;23
96;09.02.2011;2011;02;11;Keskiviikko;26;24;50;14;5;19
96;09.02.2011;2011;02;12;Keskiviikko;37;33;70;21;18;39
96;09.02.2011;2011;02;13;Keskiviikko;37;35;72;30;5;35
96;09.02.2011;2011;02;14;Keskiviikko;46;45;91;19;8;27
96;09.02.2011;2011;02;15;Keskiviikko;87;85;172;41;34;75
96;09.02.2011;2011;02;16;Keskiviikko;77;80;157;52;28;80
96;09.02.2011;2011;02;17;Keskiviikko;35;52;87;39;9;48
96;09.02.2011;2011;02;18;Keskiviikko;33;29;62;60;13;73
96;09.02.2011;2011;02;19;Keskiviikko;32;19;51;41;15;56
96;09.02.2011;2011;02;20;Keskiviikko;23;12;35;30;3;33
96;09.02.2011;2011;02;21;Keskiviikko;19;13;32;14;6;20
96;09.02.2011;2011;02;22;Keskiviikko;5;4;9;4;1;5
96;09.02.2011;2011;02;23;Keskiviikko;2;2;4;3;0;3
96;10.02.2011;2011;02;00;Torstai;3;1;4;0;0;0
96;10.02.2011;2011;02;01;Torstai;2;0;2;1;0;1
96;10.02.2011;2011;02;02;Torstai;1;0;1;0;0;0
96;10.02.2011;2011;02;03;Torstai;0;0;0;0;0;0
96;10.02.2011;2011;02;04;Torstai;3;3;6;0;0;0
96;10.02.2011;2011;02;05;Torstai;1;4;5;0;1;1
96;10.02.2011;2011;02;06;Torstai;28;12;40;10;2;12
96;10.02.2011;2011;02;07;Torstai;54;38;92;41;20;61
96;10.02.2011;2011;02;08;Torstai;52;28;80;24;9;33
96;10.02.2011;2011;02;09;Torstai;31;15;46;6;7;13
96;10.02.2011;2011;02;10;Torstai;18;21;39;4;6;10
96;10.02.2011;2011;02;11;Torstai;26;20;46;6;16;22
96;10.02.2011;2011;02;12;Torstai;24;31;55;8;28;36
96;10.02.2011;2011;02;13;Torstai;23;29;52;10;9;19
96;10.02.2011;2011;02;14;Torstai;30;48;78;15;26;41
96;10.02.2011;2011;02;15;Torstai;31;84;115;10;43;53
96;10.02.2011;2011;02;16;Torstai;42;64;106;10;42;52
96;10.02.2011;2011;02;17;Torstai;25;25;50;13;9;22
96;10.02.2011;2011;02;18;Torstai;23;25;48;8;7;15
96;10.02.2011;2011;02;19;Torstai;16;10;26;8;5;13
96;10.02.2011;2011;02;20;Torstai;19;11;30;9;4;13
96;10.02.2011;2011;02;21;Torstai;21;12;33;2;3;5
96;10.02.2011;2011;02;22;Torstai;5;5;10;0;0;0
96;10.02.2011;2011;02;23;Torstai;4;2;6;1;0;1
96;11.02.2011;2011;02;00;Perjantai;2;1;3;0;0;0
96;11.02.2011;2011;02;01;Perjantai;4;0;4;0;0;0
96;11.02.2011;2011;02;02;Perjantai;1;0;1;1;0;1
96;11.02.2011;2011;02;03;Perjantai;5;0;5;2;0;2
96;11.02.2011;2011;02;04;Perjantai;1;3;4;2;1;3
96;11.02.2011;2011;02;05;Perjantai;0;4;4;0;0;0
96;11.02.2011;2011;02;06;Perjantai;25;12;37;14;3;17
96;11.02.2011;2011;02;07;Perjantai;57;32;89;36;15;51
96;11.02.2011;2011;02;08;Perjantai;32;29;61;11;6;17
96;11.02.2011;2011;02;09;Perjantai;14;20;34;13;6;19
96;11.02.2011;2011;02;10;Perjantai;22;12;34;3;8;11
96;11.02.2011;2011;02;11;Perjantai;21;20;41;8;10;18
96;11.02.2011;2011;02;12;Perjantai;18;24;42;12;20;32
96;11.02.2011;2011;02;13;Perjantai;31;42;73;5;17;22
96;11.02.2011;2011;02;14;Perjantai;33;54;87;14;22;36
96;11.02.2011;2011;02;15;Perjantai;33;66;99;11;44;55
96;11.02.2011;2011;02;16;Perjantai;25;36;61;15;15;30
96;11.02.2011;2011;02;17;Perjantai;17;13;30;16;14;30
96;11.02.2011;2011;02;18;Perjantai;16;14;30;12;9;21
96;11.02.2011;2011;02;19;Perjantai;12;13;25;7;11;18
96;11.02.2011;2011;02;20;Perjantai;10;7;17;8;9;17
96;11.02.2011;2011;02;21;Perjantai;9;15;24;3;6;9
96;11.02.2011;2011;02;22;Perjantai;5;0;5;3;2;5
96;11.02.2011;2011;02;23;Perjantai;7;1;8;0;0;0
96;12.02.2011;2011;02;00;Lauantai;7;2;9;1;1;2
96;12.02.2011;2011;02;01;Lauantai;1;1;2;1;1;2
96;12.02.2011;2011;02;02;Lauantai;3;0;3;0;1;1
96;12.02.2011;2011;02;03;Lauantai;3;3;6;1;2;3
96;12.02.2011;2011;02;04;Lauantai;3;0;3;1;0;1
96;12.02.2011;2011;02;05;Lauantai;0;3;3;0;0;0
96;12.02.2011;2011;02;06;Lauantai;8;2;10;2;0;2
96;12.02.2011;2011;02;07;Lauantai;6;6;12;1;5;6
96;12.02.2011;2011;02;08;Lauantai;4;8;12;1;6;7
96;12.02.2011;2011;02;09;Lauantai;1;14;15;4;6;10
96;12.02.2011;2011;02;10;Lauantai;3;14;17;5;6;11
96;12.02.2011;2011;02;11;Lauantai;12;21;33;7;8;15
96;12.02.2011;2011;02;12;Lauantai;14;15;29;21;13;34
96;12.02.2011;2011;02;13;Lauantai;18;15;33;21;15;36
96;12.02.2011;2011;02;14;Lauantai;15;22;37;19;16;35
96;12.02.2011;2011;02;15;Lauantai;19;13;32;11;11;22
96;12.02.2011;2011;02;16;Lauantai;17;8;25;7;4;11
96;12.02.2011;2011;02;17;Lauantai;17;6;23;4;2;6
96;12.02.2011;2011;02;18;Lauantai;11;7;18;4;2;6
96;12.02.2011;2011;02;19;Lauantai;9;2;11;4;1;5
96;12.02.2011;2011;02;20;Lauantai;7;5;12;5;4;9
96;12.02.2011;2011;02;21;Lauantai;5;6;11;1;5;6
96;12.02.2011;2011;02;22;Lauantai;0;1;1;1;2;3
96;12.02.2011;2011;02;23;Lauantai;2;6;8;0;0;0
96;13.02.2011;2011;02;00;Sunnuntai;6;2;8;0;0;0
96;13.02.2011;2011;02;01;Sunnuntai;2;2;4;0;0;0
96;13.02.2011;2011;02;02;Sunnuntai;4;0;4;1;0;1
96;13.02.2011;2011;02;03;Sunnuntai;1;0;1;1;0;1
96;13.02.2011;2011;02;04;Sunnuntai;3;0;3;2;0;2
96;13.02.2011;2011;02;05;Sunnuntai;1;1;2;0;0;0
96;13.02.2011;2011;02;06;Sunnuntai;7;3;10;2;0;2
96;13.02.2011;2011;02;07;Sunnuntai;3;6;9;1;5;6
96;13.02.2011;2011;02;08;Sunnuntai;1;2;3;1;2;3
96;13.02.2011;2011;02;09;Sunnuntai;2;7;9;1;4;5
96;13.02.2011;2011;02;10;Sunnuntai;3;7;10;5;4;9
96;13.02.2011;2011;02;11;Sunnuntai;6;8;14;4;7;11
96;13.02.2011;2011;02;12;Sunnuntai;10;9;19;11;15;26
96;13.02.2011;2011;02;13;Sunnuntai;13;13;26;14;17;31
96;13.02.2011;2011;02;14;Sunnuntai;11;12;23;15;11;26
96;13.02.2011;2011;02;15;Sunnuntai;12;12;24;13;14;27
96;13.02.2011;2011;02;16;Sunnuntai;15;10;25;12;10;22
96;13.02.2011;2011;02;17;Sunnuntai;19;8;27;10;7;17
96;13.02.2011;2011;02;18;Sunnuntai;12;7;19;9;5;14
96;13.02.2011;2011;02;19;Sunnuntai;4;6;10;10;6;16
96;13.02.2011;2011;02;20;Sunnuntai;10;3;13;5;9;14
96;13.02.2011;2011;02;21;Sunnuntai;9;7;16;6;6;12
96;13.02.2011;2011;02;22;Sunnuntai;1;4;5;2;2;4
96;13.02.2011;2011;02;23;Sunnuntai;1;1;2;3;1;4
96;14.02.2011;2011;02;00;Maanantai;1;0;1;1;0;1
96;14.02.2011;2011;02;01;Maanantai;0;0;0;0;0;0
96;14.02.2011;2011;02;02;Maanantai;0;1;1;0;0;0
96;14.02.2011;2011;02;03;Maanantai;0;0;0;0;0;0
96;14.02.2011;2011;02;04;Maanantai;1;3;4;1;0;1
96;14.02.2011;2011;02;05;Maanantai;1;5;6;2;0;2
96;14.02.2011;2011;02;06;Maanantai;33;10;43;17;2;19
96;14.02.2011;2011;02;07;Maanantai;66;17;83;44;12;56
96;14.02.2011;2011;02;08;Maanantai;36;24;60;12;10;22
96;14.02.2011;2011;02;09;Maanantai;28;21;49;9;8;17
96;14.02.2011;2011;02;10;Maanantai;25;12;37;8;15;23
96;14.02.2011;2011;02;11;Maanantai;15;16;31;8;14;22
96;14.02.2011;2011;02;12;Maanantai;26;23;49;8;24;32
96;14.02.2011;2011;02;13;Maanantai;36;22;58;13;13;26
96;14.02.2011;2011;02;14;Maanantai;22;51;73;10;21;31
96;14.02.2011;2011;02;15;Maanantai;29;83;112;11;65;76
96;14.02.2011;2011;02;16;Maanantai;27;54;81;11;49;60
96;14.02.2011;2011;02;17;Maanantai;22;30;52;9;12;21
96;14.02.2011;2011;02;18;Maanantai;16;20;36;11;16;27
96;14.02.2011;2011;02;19;Maanantai;17;12;29;10;7;17
96;14.02.2011;2011;02;20;Maanantai;15;8;23;10;9;19
96;14.02.2011;2011;02;21;Maanantai;7;7;14;3;8;11
96;14.02.2011;2011;02;22;Maanantai;5;3;8;0;3;3
96;14.02.2011;2011;02;23;Maanantai;3;0;3;0;0;0
96;15.02.2011;2011;02;00;Tiistai;1;1;2;0;0;0
96;15.02.2011;2011;02;01;Tiistai;2;0;2;1;0;1
96;15.02.2011;2011;02;02;Tiistai;2;1;3;0;0;0
96;15.02.2011;2011;02;03;Tiistai;1;0;1;0;0;0
96;15.02.2011;2011;02;04;Tiistai;1;4;5;0;0;0
96;15.02.2011;2011;02;05;Tiistai;2;1;3;0;2;2
96;15.02.2011;2011;02;06;Tiistai;29;11;40;24;6;30
96;15.02.2011;2011;02;07;Tiistai;75;31;106;50;20;70
96;15.02.2011;2011;02;08;Tiistai;44;27;71;19;13;32
96;15.02.2011;2011;02;09;Tiistai;24;10;34;11;4;15
96;15.02.2011;2011;02;10;Tiistai;23;15;38;1;8;9
96;15.02.2011;2011;02;11;Tiistai;22;19;41;12;13;25
96;15.02.2011;2011;02;12;Tiistai;26;25;51;11;14;25
96;15.02.2011;2011;02;13;Tiistai;26;31;57;6;19;25
96;15.02.2011;2011;02;14;Tiistai;25;37;62;6;25;31
96;15.02.2011;2011;02;15;Tiistai;30;95;125;14;67;81
96;15.02.2011;2011;02;16;Tiistai;41;45;86;19;47;66
96;15.02.2011;2011;02;17;Tiistai;29;38;67;4;13;17
96;15.02.2011;2011;02;18;Tiistai;10;13;23;7;13;20
96;15.02.2011;2011;02;19;Tiistai;6;10;16;8;8;16
96;15.02.2011;2011;02;20;Tiistai;28;11;39;18;5;23
96;15.02.2011;2011;02;21;Tiistai;12;10;22;9;3;12
96;15.02.2011;2011;02;22;Tiistai;7;1;8;3;2;5
96;15.02.2011;2011;02;23;Tiistai;5;1;6;1;0;1
96;16.02.2011;2011;02;00;Keskiviikko;0;0;0;0;0;0
96;16.02.2011;2011;02;01;Keskiviikko;0;0;0;0;0;0
96;16.02.2011;2011;02;02;Keskiviikko;0;0;0;0;0;0
96;16.02.2011;2011;02;03;Keskiviikko;0;0;0;1;0;1
96;16.02.2011;2011;02;04;Keskiviikko;1;3;4;0;0;0
96;16.02.2011;2011;02;05;Keskiviikko;1;0;1;0;1;1
96;16.02.2011;2011;02;06;Keskiviikko;21;14;35;14;5;19
96;16.02.2011;2011;02;07;Keskiviikko;60;25;85;52;23;75
96;16.02.2011;2011;02;08;Keskiviikko;54;26;80;15;14;29
96;16.02.2011;2011;02;09;Keskiviikko;16;15;31;12;10;22
96;16.02.2011;2011;02;10;Keskiviikko;15;15;30;4;15;19
96;16.02.2011;2011;02;11;Keskiviikko;23;15;38;14;10;24
96;16.02.2011;2011;02;12;Keskiviikko;28;23;51;6;8;14
96;16.02.2011;2011;02;13;Keskiviikko;25;21;46;13;15;28
96;16.02.2011;2011;02;14;Keskiviikko;22;45;67;8;28;36
96;16.02.2011;2011;02;15;Keskiviikko;28;80;108;16;55;71
96;16.02.2011;2011;02;16;Keskiviikko;35;55;90;11;52;63
96;16.02.2011;2011;02;17;Keskiviikko;25;31;56;7;20;27
96;16.02.2011;2011;02;18;Keskiviikko;19;16;35;13;14;27
96;16.02.2011;2011;02;19;Keskiviikko;23;10;33;9;7;16
96;16.02.2011;2011;02;20;Keskiviikko;17;7;24;6;4;10
96;16.02.2011;2011;02;21;Keskiviikko;9;10;19;6;10;16
96;16.02.2011;2011;02;22;Keskiviikko;4;1;5;0;1;1
96;16.02.2011;2011;02;23;Keskiviikko;5;3;8;2;0;2
96;17.02.2011;2011;02;00;Torstai;0;0;0;0;0;0
96;17.02.2011;2011;02;01;Torstai;2;0;2;1;0;1
96;17.02.2011;2011;02;02;Torstai;2;0;2;0;0;0
96;17.02.2011;2011;02;03;Torstai;1;0;1;0;0;0
96;17.02.2011;2011;02;04;Torstai;1;1;2;0;2;2
96;17.02.2011;2011;02;05;Torstai;0;2;2;0;2;2
96;17.02.2011;2011;02;06;Torstai;22;8;30;15;7;22
96;17.02.2011;2011;02;07;Torstai;58;30;88;45;18;63
96;17.02.2011;2011;02;08;Torstai;37;24;61;19;12;31
96;17.02.2011;2011;02;09;Torstai;24;20;44;15;8;23
96;17.02.2011;2011;02;10;Torstai;14;10;24;8;8;16
96;17.02.2011;2011;02;11;Torstai;26;11;37;11;18;29
96;17.02.2011;2011;02;12;Torstai;25;20;45;19;11;30
96;17.02.2011;2011;02;13;Torstai;21;27;48;13;30;43
96;17.02.2011;2011;02;14;Torstai;31;33;64;7;23;30
96;17.02.2011;2011;02;15;Torstai;26;81;107;12;63;75
96;17.02.2011;2011;02;16;Torstai;26;57;83;15;52;67
96;17.02.2011;2011;02;17;Torstai;21;16;37;15;23;38
96;17.02.2011;2011;02;18;Torstai;18;12;30;17;13;30
96;17.02.2011;2011;02;19;Torstai;16;12;28;11;18;29
96;17.02.2011;2011;02;20;Torstai;21;7;28;7;2;9
96;17.02.2011;2011;02;21;Torstai;9;7;16;10;7;17
96;17.02.2011;2011;02;22;Torstai;1;1;2;2;1;3
96;17.02.2011;2011;02;23;Torstai;2;2;4;2;0;2
96;18.02.2011;2011;02;00;Perjantai;3;1;4;1;0;1
96;18.02.2011;2011;02;01;Perjantai;1;1;2;1;0;1
96;18.02.2011;2011;02;02;Perjantai;0;0;0;0;0;0
96;18.02.2011;2011;02;03;Perjantai;0;0;0;1;0;1
96;18.02.2011;2011;02;04;Perjantai;2;3;5;1;1;2
96;18.02.2011;2011;02;05;Perjantai;0;2;2;0;1;1
96;18.02.2011;2011;02;06;Perjantai;22;12;34;19;1;20
96;18.02.2011;2011;02;07;Perjantai;43;20;63;40;18;58
96;18.02.2011;2011;02;08;Perjantai;32;22;54;18;6;24
96;18.02.2011;2011;02;09;Perjantai;17;21;38;13;13;26
96;18.02.2011;2011;02;10;Perjantai;19;18;37;7;7;14
96;18.02.2011;2011;02;11;Perjantai;12;18;30;8;12;20
96;18.02.2011;2011;02;12;Perjantai;21;25;46;9;17;26
96;18.02.2011;2011;02;13;Perjantai;30;35;65;9;24;33
96;18.02.2011;2011;02;14;Perjantai;13;59;72;7;83;90
96;18.02.2011;2011;02;15;Perjantai;27;53;80;24;65;89
96;18.02.2011;2011;02;16;Perjantai;33;21;54;62;27;89
96;18.02.2011;2011;02;17;Perjantai;20;13;33;7;11;18
96;18.02.2011;2011;02;18;Perjantai;13;12;25;8;9;17
96;18.02.2011;2011;02;19;Perjantai;5;4;9;3;6;9
96;18.02.2011;2011;02;20;Perjantai;8;6;14;4;2;6
96;18.02.2011;2011;02;21;Perjantai;6;8;14;0;9;9
96;18.02.2011;2011;02;22;Perjantai;5;0;5;0;0;0
96;18.02.2011;2011;02;23;Perjantai;11;1;12;1;0;1
96;19.02.2011;2011;02;00;Lauantai;2;2;4;3;2;5
96;19.02.2011;2011;02;01;Lauantai;2;2;4;3;0;3
96;19.02.2011;2011;02;02;Lauantai;1;0;1;0;0;0
96;19.02.2011;2011;02;03;Lauantai;1;0;1;2;0;2
96;19.02.2011;2011;02;04;Lauantai;0;0;0;1;0;1
96;19.02.2011;2011;02;05;Lauantai;1;2;3;0;1;1
96;19.02.2011;2011;02;06;Lauantai;10;1;11;9;2;11
96;19.02.2011;2011;02;07;Lauantai;3;8;11;2;3;5
96;19.02.2011;2011;02;08;Lauantai;3;7;10;4;4;8
96;19.02.2011;2011;02;09;Lauantai;7;14;21;6;7;13
96;19.02.2011;2011;02;10;Lauantai;6;12;18;7;11;18
96;19.02.2011;2011;02;11;Lauantai;15;14;29;10;15;25
96;19.02.2011;2011;02;12;Lauantai;20;18;38;8;15;23
96;19.02.2011;2011;02;13;Lauantai;21;18;39;16;14;30
96;19.02.2011;2011;02;14;Lauantai;15;19;34;14;20;34
96;19.02.2011;2011;02;15;Lauantai;16;32;48;8;24;32
96;19.02.2011;2011;02;16;Lauantai;16;9;25;16;6;22
96;19.02.2011;2011;02;17;Lauantai;13;15;28;11;16;27
96;19.02.2011;2011;02;18;Lauantai;16;10;26;14;15;29
96;19.02.2011;2011;02;19;Lauantai;9;2;11;2;7;9
96;19.02.2011;2011;02;20;Lauantai;19;3;22;10;4;14
96;19.02.2011;2011;02;21;Lauantai;10;13;23;3;3;6
96;19.02.2011;2011;02;22;Lauantai;8;2;10;0;1;1
96;19.02.2011;2011;02;23;Lauantai;3;5;8;0;0;0
96;20.02.2011;2011;02;00;Sunnuntai;2;0;2;0;0;0
96;20.02.2011;2011;02;01;Sunnuntai;5;0;5;0;0;0
96;20.02.2011;2011;02;02;Sunnuntai;3;1;4;1;1;2
96;20.02.2011;2011;02;03;Sunnuntai;2;0;2;2;0;2
96;20.02.2011;2011;02;04;Sunnuntai;2;0;2;3;0;3
96;20.02.2011;2011;02;05;Sunnuntai;0;1;1;0;0;0
96;20.02.2011;2011;02;06;Sunnuntai;9;3;12;7;2;9
96;20.02.2011;2011;02;07;Sunnuntai;1;5;6;1;3;4
96;20.02.2011;2011;02;08;Sunnuntai;1;3;4;4;2;6
96;20.02.2011;2011;02;09;Sunnuntai;5;8;13;10;6;16
96;20.02.2011;2011;02;10;Sunnuntai;4;9;13;5;13;18
96;20.02.2011;2011;02;11;Sunnuntai;12;8;20;15;19;34
96;20.02.2011;2011;02;12;Sunnuntai;16;14;30;19;21;40
96;20.02.2011;2011;02;13;Sunnuntai;9;10;19;23;30;53
96;20.02.2011;2011;02;14;Sunnuntai;16;17;33;19;21;40
96;20.02.2011;2011;02;15;Sunnuntai;17;13;30;25;24;49
96;20.02.2011;2011;02;16;Sunnuntai;11;5;16;18;12;30
96;20.02.2011;2011;02;17;Sunnuntai;16;9;25;12;7;19
96;20.02.2011;2011;02;18;Sunnuntai;14;7;21;9;6;15
96;20.02.2011;2011;02;19;Sunnuntai;12;6;18;9;5;14
96;20.02.2011;2011;02;20;Sunnuntai;7;5;12;8;1;9
96;20.02.2011;2011;02;21;Sunnuntai;7;6;13;5;10;15
96;20.02.2011;2011;02;22;Sunnuntai;2;1;3;4;2;6
96;20.02.2011;2011;02;23;Sunnuntai;3;0;3;0;1;1
96;21.02.2011;2011;02;00;Maanantai;0;1;1;0;0;0
96;21.02.2011;2011;02;01;Maanantai;1;0;1;2;0;2
96;21.02.2011;2011;02;02;Maanantai;0;0;0;0;1;1
96;21.02.2011;2011;02;03;Maanantai;0;0;0;0;0;0
96;21.02.2011;2011;02;04;Maanantai;1;4;5;0;1;1
96;21.02.2011;2011;02;05;Maanantai;1;2;3;0;0;0
96;21.02.2011;2011;02;06;Maanantai;25;13;38;13;4;17
96;21.02.2011;2011;02;07;Maanantai;72;37;109;42;19;61
96;21.02.2011;2011;02;08;Maanantai;41;32;73;14;17;31
96;21.02.2011;2011;02;09;Maanantai;33;27;60;20;10;30
96;21.02.2011;2011;02;10;Maanantai;26;21;47;8;10;18
96;21.02.2011;2011;02;11;Maanantai;18;29;47;12;10;22
96;21.02.2011;2011;02;12;Maanantai;31;26;57;11;14;25
96;21.02.2011;2011;02;13;Maanantai;41;24;65;17;16;33
96;21.02.2011;2011;02;14;Maanantai;28;42;70;9;30;39
96;21.02.2011;2011;02;15;Maanantai;34;99;133;14;69;83
96;21.02.2011;2011;02;16;Maanantai;40;67;107;18;63;81
96;21.02.2011;2011;02;17;Maanantai;28;40;68;13;22;35
96;21.02.2011;2011;02;18;Maanantai;23;38;61;26;19;45
96;21.02.2011;2011;02;19;Maanantai;33;12;45;20;18;38
96;21.02.2011;2011;02;20;Maanantai;32;17;49;14;4;18
96;21.02.2011;2011;02;21;Maanantai;14;12;26;12;5;17
96;21.02.2011;2011;02;22;Maanantai;5;2;7;0;1;1
96;21.02.2011;2011;02;23;Maanantai;2;2;4;3;0;3
96;22.02.2011;2011;02;00;Tiistai;0;1;1;0;0;0
96;22.02.2011;2011;02;01;Tiistai;0;1;1;0;1;1
96;22.02.2011;2011;02;02;Tiistai;0;0;0;0;0;0
96;22.02.2011;2011;02;03;Tiistai;0;0;0;0;0;0
96;22.02.2011;2011;02;04;Tiistai;1;5;6;0;2;2
96;22.02.2011;2011;02;05;Tiistai;0;2;2;0;0;0
96;22.02.2011;2011;02;06;Tiistai;31;16;47;18;5;23
96;22.02.2011;2011;02;07;Tiistai;78;53;131;43;27;70
96;22.02.2011;2011;02;08;Tiistai;66;37;103;21;9;30
96;22.02.2011;2011;02;09;Tiistai;31;34;65;13;13;26
96;22.02.2011;2011;02;10;Tiistai;29;21;50;13;15;28
96;22.02.2011;2011;02;11;Tiistai;29;26;55;12;14;26
96;22.02.2011;2011;02;12;Tiistai;36;43;79;13;19;32
96;22.02.2011;2011;02;13;Tiistai;22;38;60;18;19;37
96;22.02.2011;2011;02;14;Tiistai;42;66;108;19;36;55
96;22.02.2011;2011;02;15;Tiistai;46;93;139;17;57;74
96;22.02.2011;2011;02;16;Tiistai;65;83;148;25;61;86
96;22.02.2011;2011;02;17;Tiistai;41;49;90;18;24;42
96;22.02.2011;2011;02;18;Tiistai;37;31;68;22;25;47
96;22.02.2011;2011;02;19;Tiistai;29;13;42;19;21;40
96;22.02.2011;2011;02;20;Tiistai;39;11;50;19;6;25
96;22.02.2011;2011;02;21;Tiistai;16;12;28;6;9;15
96;22.02.2011;2011;02;22;Tiistai;10;1;11;4;4;8
96;22.02.2011;2011;02;23;Tiistai;9;2;11;0;1;1
96;23.02.2011;2011;02;00;Keskiviikko;0;0;0;2;1;3
96;23.02.2011;2011;02;01;Keskiviikko;0;0;0;0;0;0
96;23.02.2011;2011;02;02;Keskiviikko;0;0;0;0;0;0
96;23.02.2011;2011;02;03;Keskiviikko;0;0;0;0;0;0
96;23.02.2011;2011;02;04;Keskiviikko;1;5;6;0;1;1
96;23.02.2011;2011;02;05;Keskiviikko;1;4;5;0;1;1
96;23.02.2011;2011;02;06;Keskiviikko;31;16;47;11;5;16
96;23.02.2011;2011;02;07;Keskiviikko;65;37;102;42;24;66
96;23.02.2011;2011;02;08;Keskiviikko;67;48;115;21;7;28
96;23.02.2011;2011;02;09;Keskiviikko;36;33;69;21;10;31
96;23.02.2011;2011;02;10;Keskiviikko;31;33;64;8;14;22
96;23.02.2011;2011;02;11;Keskiviikko;26;23;49;9;11;20
96;23.02.2011;2011;02;12;Keskiviikko;30;38;68;36;17;53
96;23.02.2011;2011;02;13;Keskiviikko;37;33;70;32;30;62
96;23.02.2011;2011;02;14;Keskiviikko;43;58;101;16;29;45
96;23.02.2011;2011;02;15;Keskiviikko;42;106;148;10;54;64
96;23.02.2011;2011;02;16;Keskiviikko;48;67;115;17;57;74
96;23.02.2011;2011;02;17;Keskiviikko;35;46;81;15;13;28
96;23.02.2011;2011;02;18;Keskiviikko;24;23;47;15;13;28
96;23.02.2011;2011;02;19;Keskiviikko;31;17;48;12;11;23
96;23.02.2011;2011;02;20;Keskiviikko;24;8;32;9;10;19
96;23.02.2011;2011;02;21;Keskiviikko;15;13;28;4;11;15
96;23.02.2011;2011;02;22;Keskiviikko;3;1;4;2;0;2
96;23.02.2011;2011;02;23;Keskiviikko;4;2;6;1;0;1
96;24.02.2011;2011;02;00;Torstai;1;0;1;0;0;0
96;24.02.2011;2011;02;01;Torstai;0;0;0;0;0;0
96;24.02.2011;2011;02;02;Torstai;2;0;2;1;0;1
96;24.02.2011;2011;02;03;Torstai;1;0;1;0;0;0
96;24.02.2011;2011;02;04;Torstai;2;3;5;0;1;1
96;24.02.2011;2011;02;05;Torstai;0;5;5;0;2;2
96;24.02.2011;2011;02;06;Torstai;28;16;44;19;5;24
96;24.02.2011;2011;02;07;Torstai;65;39;104;39;21;60
96;24.02.2011;2011;02;08;Torstai;59;38;97;21;7;28
96;24.02.2011;2011;02;09;Torstai;31;30;61;16;11;27
96;24.02.2011;2011;02;10;Torstai;17;15;32;8;13;21
96;24.02.2011;2011;02;11;Torstai;38;20;58;10;15;25
96;24.02.2011;2011;02;12;Torstai;44;47;91;10;17;27
96;24.02.2011;2011;02;13;Torstai;31;37;68;9;14;23
96;24.02.2011;2011;02;14;Torstai;37;42;79;8;26;34
96;24.02.2011;2011;02;15;Torstai;57;98;155;11;62;73
96;24.02.2011;2011;02;16;Torstai;38;50;88;20;60;80
96;24.02.2011;2011;02;17;Torstai;29;33;62;10;16;26
96;24.02.2011;2011;02;18;Torstai;23;22;45;15;15;30
96;24.02.2011;2011;02;19;Torstai;21;14;35;15;14;29
96;24.02.2011;2011;02;20;Torstai;30;7;37;8;3;11
96;24.02.2011;2011;02;21;Torstai;15;12;27;6;9;15
96;24.02.2011;2011;02;22;Torstai;4;4;8;1;3;4
96;24.02.2011;2011;02;23;Torstai;2;1;3;2;0;2
96;25.02.2011;2011;02;00;Perjantai;1;1;2;0;0;0
96;25.02.2011;2011;02;01;Perjantai;1;0;1;0;0;0
96;25.02.2011;2011;02;02;Perjantai;1;0;1;0;0;0
96;25.02.2011;2011;02;03;Perjantai;0;0;0;0;0;0
96;25.02.2011;2011;02;04;Perjantai;2;3;5;0;0;0
96;25.02.2011;2011;02;05;Perjantai;0;3;3;0;0;0
96;25.02.2011;2011;02;06;Perjantai;30;17;47;19;2;21
96;25.02.2011;2011;02;07;Perjantai;58;38;96;40;11;51
96;25.02.2011;2011;02;08;Perjantai;59;34;93;16;12;28
96;25.02.2011;2011;02;09;Perjantai;20;30;50;5;4;9
96;25.02.2011;2011;02;10;Perjantai;26;29;55;9;12;21
96;25.02.2011;2011;02;11;Perjantai;31;32;63;10;5;15
96;25.02.2011;2011;02;12;Perjantai;27;47;74;8;23;31
96;25.02.2011;2011;02;13;Perjantai;36;54;90;13;19;32
96;25.02.2011;2011;02;14;Perjantai;39;69;108;5;38;43
96;25.02.2011;2011;02;15;Perjantai;41;83;124;17;36;53
96;25.02.2011;2011;02;16;Perjantai;41;42;83;10;18;28
96;25.02.2011;2011;02;17;Perjantai;35;17;52;9;12;21
96;25.02.2011;2011;02;18;Perjantai;24;15;39;7;10;17
96;25.02.2011;2011;02;19;Perjantai;13;16;29;4;7;11
96;25.02.2011;2011;02;20;Perjantai;14;12;26;8;7;15
96;25.02.2011;2011;02;21;Perjantai;12;4;16;6;3;9
96;25.02.2011;2011;02;22;Perjantai;2;3;5;2;0;2
96;25.02.2011;2011;02;23;Perjantai;6;1;7;0;1;1
96;26.02.2011;2011;02;00;Lauantai;5;0;5;1;0;1
96;26.02.2011;2011;02;01;Lauantai;6;1;7;0;0;0
96;26.02.2011;2011;02;02;Lauantai;2;2;4;0;1;1
96;26.02.2011;2011;02;03;Lauantai;5;0;5;1;0;1
96;26.02.2011;2011;02;04;Lauantai;3;2;5;1;0;1
96;26.02.2011;2011;02;05;Lauantai;0;2;2;0;0;0
96;26.02.2011;2011;02;06;Lauantai;8;8;16;3;0;3
96;26.02.2011;2011;02;07;Lauantai;4;3;7;2;8;10
96;26.02.2011;2011;02;08;Lauantai;6;10;16;6;13;19
96;26.02.2011;2011;02;09;Lauantai;10;26;36;15;13;28
96;26.02.2011;2011;02;10;Lauantai;6;16;22;12;6;18
96;26.02.2011;2011;02;11;Lauantai;13;20;33;11;13;24
96;26.02.2011;2011;02;12;Lauantai;14;21;35;11;12;23
96;26.02.2011;2011;02;13;Lauantai;28;18;46;10;13;23
96;26.02.2011;2011;02;14;Lauantai;34;14;48;9;8;17
96;26.02.2011;2011;02;15;Lauantai;17;23;40;14;15;29
96;26.02.2011;2011;02;16;Lauantai;12;15;27;10;14;24
96;26.02.2011;2011;02;17;Lauantai;21;24;45;13;19;32
96;26.02.2011;2011;02;18;Lauantai;14;25;39;14;18;32
96;26.02.2011;2011;02;19;Lauantai;7;13;20;5;18;23
96;26.02.2011;2011;02;20;Lauantai;20;6;26;14;5;19
96;26.02.2011;2011;02;21;Lauantai;17;8;25;11;5;16
96;26.02.2011;2011;02;22;Lauantai;6;4;10;1;1;2
96;26.02.2011;2011;02;23;Lauantai;1;5;6;2;4;6
96;27.02.2011;2011;02;00;Sunnuntai;2;1;3;1;0;1
96;27.02.2011;2011;02;01;Sunnuntai;6;3;9;1;0;1
96;27.02.2011;2011;02;02;Sunnuntai;8;1;9;1;0;1
96;27.02.2011;2011;02;03;Sunnuntai;6;0;6;1;1;2
96;27.02.2011;2011;02;04;Sunnuntai;10;0;10;4;0;4
96;27.02.2011;2011;02;05;Sunnuntai;1;3;4;1;0;1
96;27.02.2011;2011;02;06;Sunnuntai;4;3;7;4;2;6
96;27.02.2011;2011;02;07;Sunnuntai;4;5;9;4;5;9
96;27.02.2011;2011;02;08;Sunnuntai;4;6;10;3;3;6
96;27.02.2011;2011;02;09;Sunnuntai;2;7;9;15;11;26
96;27.02.2011;2011;02;10;Sunnuntai;6;11;17;14;15;29
96;27.02.2011;2011;02;11;Sunnuntai;12;9;21;24;20;44
96;27.02.2011;2011;02;12;Sunnuntai;14;23;37;19;35;54
96;27.02.2011;2011;02;13;Sunnuntai;22;16;38;19;18;37
96;27.02.2011;2011;02;14;Sunnuntai;17;35;52;14;13;27
96;27.02.2011;2011;02;15;Sunnuntai;26;16;42;16;22;38
96;27.02.2011;2011;02;16;Sunnuntai;10;22;32;18;14;32
96;27.02.2011;2011;02;17;Sunnuntai;18;15;33;16;22;38
96;27.02.2011;2011;02;18;Sunnuntai;16;17;33;13;13;26
96;27.02.2011;2011;02;19;Sunnuntai;21;11;32;11;13;24
96;27.02.2011;2011;02;20;Sunnuntai;15;6;21;16;7;23
96;27.02.2011;2011;02;21;Sunnuntai;9;9;18;3;9;12
96;27.02.2011;2011;02;22;Sunnuntai;7;3;10;5;2;7
96;27.02.2011;2011;02;23;Sunnuntai;5;1;6;0;1;1
96;28.02.2011;2011;02;00;Maanantai;0;0;0;2;1;3
96;28.02.2011;2011;02;01;Maanantai;0;2;2;0;0;0
96;28.02.2011;2011;02;02;Maanantai;2;0;2;0;0;0
96;28.02.2011;2011;02;03;Maanantai;0;0;0;1;0;1
96;28.02.2011;2011;02;04;Maanantai;0;5;5;0;0;0
96;28.02.2011;2011;02;05;Maanantai;0;8;8;1;0;1
96;28.02.2011;2011;02;06;Maanantai;28;29;57;11;5;16
96;28.02.2011;2011;02;07;Maanantai;88;69;157;33;15;48
96;28.02.2011;2011;02;08;Maanantai;62;69;131;27;19;46
96;28.02.2011;2011;02;09;Maanantai;30;42;72;19;10;29
96;28.02.2011;2011;02;10;Maanantai;36;25;61;10;22;32
96;28.02.2011;2011;02;11;Maanantai;39;26;65;14;16;30
96;28.02.2011;2011;02;12;Maanantai;43;41;84;22;15;37
96;28.02.2011;2011;02;13;Maanantai;56;34;90;17;28;45
96;28.02.2011;2011;02;14;Maanantai;32;64;96;25;28;53
96;28.02.2011;2011;02;15;Maanantai;72;103;175;24;77;101
96;28.02.2011;2011;02;16;Maanantai;57;86;143;34;51;85
96;28.02.2011;2011;02;17;Maanantai;60;47;107;27;27;54
96;28.02.2011;2011;02;18;Maanantai;37;38;75;35;42;77
96;28.02.2011;2011;02;19;Maanantai;47;14;61;25;30;55
96;28.02.2011;2011;02;20;Maanantai;41;10;51;24;17;41
96;28.02.2011;2011;02;21;Maanantai;24;13;37;4;16;20
96;28.02.2011;2011;02;22;Maanantai;6;7;13;1;2;3
96;28.02.2011;2011;02;23;Maanantai;0;0;0;2;0;2
96;01.03.2011;2011;03;00;Tiistai;2;2;4;1;0;1
96;01.03.2011;2011;03;01;Tiistai;0;0;0;0;0;0
96;01.03.2011;2011;03;02;Tiistai;0;0;0;0;0;0
96;01.03.2011;2011;03;03;Tiistai;0;0;0;0;0;0
96;01.03.2011;2011;03;04;Tiistai;0;4;4;0;1;1
96;01.03.2011;2011;03;05;Tiistai;1;5;6;0;2;2
96;01.03.2011;2011;03;06;Tiistai;34;23;57;16;4;20
96;01.03.2011;2011;03;07;Tiistai;98;71;169;33;26;59
96;01.03.2011;2011;03;08;Tiistai;61;65;126;21;15;36
96;01.03.2011;2011;03;09;Tiistai;32;30;62;31;24;55
96;01.03.2011;2011;03;10;Tiistai;26;41;67;11;28;39
96;01.03.2011;2011;03;11;Tiistai;41;32;73;20;14;34
96;01.03.2011;2011;03;12;Tiistai;59;54;113;39;39;78
96;01.03.2011;2011;03;13;Tiistai;46;33;79;9;14;23
96;01.03.2011;2011;03;14;Tiistai;44;67;111;12;23;35
96;01.03.2011;2011;03;15;Tiistai;61;121;182;11;63;74
96;01.03.2011;2011;03;16;Tiistai;61;97;158;29;50;79
96;01.03.2011;2011;03;17;Tiistai;55;39;94;17;10;27
96;01.03.2011;2011;03;18;Tiistai;32;33;65;26;16;42
96;01.03.2011;2011;03;19;Tiistai;28;15;43;18;22;40
96;01.03.2011;2011;03;20;Tiistai;32;10;42;14;13;27
96;01.03.2011;2011;03;21;Tiistai;26;18;44;7;14;21
96;01.03.2011;2011;03;22;Tiistai;8;2;10;0;1;1
96;01.03.2011;2011;03;23;Tiistai;5;4;9;2;1;3
96;02.03.2011;2011;03;00;Keskiviikko;0;0;0;0;0;0
96;02.03.2011;2011;03;01;Keskiviikko;0;0;0;0;0;0
96;02.03.2011;2011;03;02;Keskiviikko;0;0;0;0;0;0
96;02.03.2011;2011;03;03;Keskiviikko;0;0;0;1;0;1
96;02.03.2011;2011;03;04;Keskiviikko;1;4;5;0;0;0
96;02.03.2011;2011;03;05;Keskiviikko;2;7;9;0;0;0
96;02.03.2011;2011;03;06;Keskiviikko;26;27;53;16;3;19
96;02.03.2011;2011;03;07;Keskiviikko;100;72;172;37;20;57
96;02.03.2011;2011;03;08;Keskiviikko;81;67;148;22;16;38
96;02.03.2011;2011;03;09;Keskiviikko;41;38;79;20;11;31
96;02.03.2011;2011;03;10;Keskiviikko;29;34;63;16;14;30
96;02.03.2011;2011;03;11;Keskiviikko;40;30;70;15;24;39
96;02.03.2011;2011;03;12;Keskiviikko;50;45;95;8;20;28
96;02.03.2011;2011;03;13;Keskiviikko;50;41;91;14;21;35
96;02.03.2011;2011;03;14;Keskiviikko;40;73;113;8;19;27
96;02.03.2011;2011;03;15;Keskiviikko;67;114;181;7;47;54
96;02.03.2011;2011;03;16;Keskiviikko;65;94;159;14;44;58
96;02.03.2011;2011;03;17;Keskiviikko;59;45;104;17;17;34
96;02.03.2011;2011;03;18;Keskiviikko;41;29;70;17;21;38
96;02.03.2011;2011;03;19;Keskiviikko;41;21;62;10;16;26
96;02.03.2011;2011;03;20;Keskiviikko;45;11;56;12;9;21
96;02.03.2011;2011;03;21;Keskiviikko;24;15;39;5;11;16
96;02.03.2011;2011;03;22;Keskiviikko;5;5;10;2;2;4
96;02.03.2011;2011;03;23;Keskiviikko;4;1;5;2;0;2
96;03.03.2011;2011;03;00;Torstai;2;1;3;0;0;0
96;03.03.2011;2011;03;01;Torstai;2;0;2;2;0;2
96;03.03.2011;2011;03;02;Torstai;1;0;1;0;0;0
96;03.03.2011;2011;03;03;Torstai;1;0;1;0;0;0
96;03.03.2011;2011;03;04;Torstai;0;4;4;1;1;2
96;03.03.2011;2011;03;05;Torstai;1;6;7;0;1;1
96;03.03.2011;2011;03;06;Torstai;47;22;69;12;2;14
96;03.03.2011;2011;03;07;Torstai;100;55;155;39;17;56
96;03.03.2011;2011;03;08;Torstai;53;49;102;15;12;27
96;03.03.2011;2011;03;09;Torstai;28;32;60;13;14;27
96;03.03.2011;2011;03;10;Torstai;20;27;47;4;10;14
96;03.03.2011;2011;03;11;Torstai;25;30;55;18;13;31
96;03.03.2011;2011;03;12;Torstai;35;37;72;8;26;34
96;03.03.2011;2011;03;13;Torstai;41;32;73;15;27;42
96;03.03.2011;2011;03;14;Torstai;43;69;112;10;23;33
96;03.03.2011;2011;03;15;Torstai;59;118;177;14;49;63
96;03.03.2011;2011;03;16;Torstai;63;87;150;13;42;55
96;03.03.2011;2011;03;17;Torstai;54;49;103;18;18;36
96;03.03.2011;2011;03;18;Torstai;26;19;45;17;13;30
96;03.03.2011;2011;03;19;Torstai;35;16;51;19;16;35
96;03.03.2011;2011;03;20;Torstai;49;10;59;5;12;17
96;03.03.2011;2011;03;21;Torstai;16;12;28;9;6;15
96;03.03.2011;2011;03;22;Torstai;18;3;21;2;0;2
96;03.03.2011;2011;03;23;Torstai;2;2;4;2;0;2
96;04.03.2011;2011;03;00;Perjantai;1;0;1;0;1;1
96;04.03.2011;2011;03;01;Perjantai;1;3;4;0;0;0
96;04.03.2011;2011;03;02;Perjantai;2;0;2;0;0;0
96;04.03.2011;2011;03;03;Perjantai;3;0;3;2;0;2
96;04.03.2011;2011;03;04;Perjantai;0;6;6;0;0;0
96;04.03.2011;2011;03;05;Perjantai;1;8;9;0;2;2
96;04.03.2011;2011;03;06;Perjantai;34;27;61;10;1;11
96;04.03.2011;2011;03;07;Perjantai;66;65;131;39;16;55
96;04.03.2011;2011;03;08;Perjantai;51;56;107;10;11;21
96;04.03.2011;2011;03;09;Perjantai;45;44;89;13;12;25
96;04.03.2011;2011;03;10;Perjantai;27;40;67;7;7;14
96;04.03.2011;2011;03;11;Perjantai;48;41;89;11;19;30
96;04.03.2011;2011;03;12;Perjantai;64;45;109;10;22;32
96;04.03.2011;2011;03;13;Perjantai;45;58;103;9;20;29
96;04.03.2011;2011;03;14;Perjantai;45;67;112;13;34;47
96;04.03.2011;2011;03;15;Perjantai;56;65;121;12;30;42
96;04.03.2011;2011;03;16;Perjantai;50;42;92;15;24;39
96;04.03.2011;2011;03;17;Perjantai;44;25;69;12;9;21
96;04.03.2011;2011;03;18;Perjantai;31;13;44;10;8;18
96;04.03.2011;2011;03;19;Perjantai;25;17;42;9;11;20
96;04.03.2011;2011;03;20;Perjantai;19;9;28;6;6;12
96;04.03.2011;2011;03;21;Perjantai;10;12;22;3;9;12
96;04.03.2011;2011;03;22;Perjantai;7;9;16;1;4;5
96;04.03.2011;2011;03;23;Perjantai;9;7;16;0;0;0
96;05.03.2011;2011;03;00;Lauantai;3;1;4;1;0;1
96;05.03.2011;2011;03;01;Lauantai;7;0;7;0;0;0
96;05.03.2011;2011;03;02;Lauantai;5;0;5;2;2;4
96;05.03.2011;2011;03;03;Lauantai;5;1;6;1;0;1
96;05.03.2011;2011;03;04;Lauantai;5;0;5;4;0;4
96;05.03.2011;2011;03;05;Lauantai;0;1;1;0;2;2
96;05.03.2011;2011;03;06;Lauantai;11;6;17;3;0;3
96;05.03.2011;2011;03;07;Lauantai;0;13;13;0;5;5
96;05.03.2011;2011;03;08;Lauantai;6;15;21;3;3;6
96;05.03.2011;2011;03;09;Lauantai;6;17;23;6;6;12
96;05.03.2011;2011;03;10;Lauantai;20;14;34;11;17;28
96;05.03.2011;2011;03;11;Lauantai;11;40;51;2;12;14
96;05.03.2011;2011;03;12;Lauantai;24;22;46;13;17;30
96;05.03.2011;2011;03;13;Lauantai;37;13;50;8;6;14
96;05.03.2011;2011;03;14;Lauantai;22;16;38;5;10;15
96;05.03.2011;2011;03;15;Lauantai;27;41;68;12;21;33
96;05.03.2011;2011;03;16;Lauantai;24;9;33;13;10;23
96;05.03.2011;2011;03;17;Lauantai;19;16;35;10;4;14
96;05.03.2011;2011;03;18;Lauantai;26;10;36;13;7;20
96;05.03.2011;2011;03;19;Lauantai;13;9;22;9;3;12
96;05.03.2011;2011;03;20;Lauantai;22;9;31;9;4;13
96;05.03.2011;2011;03;21;Lauantai;8;14;22;2;3;5
96;05.03.2011;2011;03;22;Lauantai;7;2;9;2;3;5
96;05.03.2011;2011;03;23;Lauantai;5;5;10;0;0;0
96;06.03.2011;2011;03;00;Sunnuntai;3;1;4;1;0;1
96;06.03.2011;2011;03;01;Sunnuntai;5;1;6;1;0;1
96;06.03.2011;2011;03;02;Sunnuntai;5;0;5;1;0;1
96;06.03.2011;2011;03;03;Sunnuntai;11;0;11;2;0;2
96;06.03.2011;2011;03;04;Sunnuntai;6;0;6;0;0;0
96;06.03.2011;2011;03;05;Sunnuntai;0;0;0;0;0;0
96;06.03.2011;2011;03;06;Sunnuntai;10;6;16;2;0;2
96;06.03.2011;2011;03;07;Sunnuntai;1;10;11;0;5;5
96;06.03.2011;2011;03;08;Sunnuntai;6;3;9;5;0;5
96;06.03.2011;2011;03;09;Sunnuntai;1;7;8;11;4;15
96;06.03.2011;2011;03;10;Sunnuntai;5;9;14;11;11;22
96;06.03.2011;2011;03;11;Sunnuntai;13;11;24;24;17;41
96;06.03.2011;2011;03;12;Sunnuntai;17;32;49;6;22;28
96;06.03.2011;2011;03;13;Sunnuntai;28;9;37;17;15;32
96;06.03.2011;2011;03;14;Sunnuntai;17;15;32;21;16;37
96;06.03.2011;2011;03;15;Sunnuntai;10;17;27;17;9;26
96;06.03.2011;2011;03;16;Sunnuntai;15;14;29;10;7;17
96;06.03.2011;2011;03;17;Sunnuntai;19;8;27;19;7;26
96;06.03.2011;2011;03;18;Sunnuntai;13;9;22;5;9;14
96;06.03.2011;2011;03;19;Sunnuntai;5;9;14;2;11;13
96;06.03.2011;2011;03;20;Sunnuntai;17;5;22;5;1;6
96;06.03.2011;2011;03;21;Sunnuntai;12;9;21;1;4;5
96;06.03.2011;2011;03;22;Sunnuntai;4;1;5;1;1;2
96;06.03.2011;2011;03;23;Sunnuntai;7;3;10;0;0;0
96;07.03.2011;2011;03;00;Maanantai;0;3;3;1;0;1
96;07.03.2011;2011;03;01;Maanantai;0;1;1;0;0;0
96;07.03.2011;2011;03;02;Maanantai;1;0;1;0;0;0
96;07.03.2011;2011;03;03;Maanantai;3;0;3;1;0;1
96;07.03.2011;2011;03;04;Maanantai;1;5;6;0;0;0
96;07.03.2011;2011;03;05;Maanantai;2;3;5;0;1;1
96;07.03.2011;2011;03;06;Maanantai;30;25;55;14;3;17
96;07.03.2011;2011;03;07;Maanantai;66;39;105;19;14;33
96;07.03.2011;2011;03;08;Maanantai;19;41;60;2;8;10
96;07.03.2011;2011;03;09;Maanantai;22;29;51;9;7;16
96;07.03.2011;2011;03;10;Maanantai;15;27;42;3;10;13
96;07.03.2011;2011;03;11;Maanantai;18;28;46;11;15;26
96;07.03.2011;2011;03;12;Maanantai;37;34;71;14;10;24
96;07.03.2011;2011;03;13;Maanantai;44;21;65;11;11;22
96;07.03.2011;2011;03;14;Maanantai;28;41;69;7;13;20
96;07.03.2011;2011;03;15;Maanantai;40;101;141;17;46;63
96;07.03.2011;2011;03;16;Maanantai;54;58;112;12;35;47
96;07.03.2011;2011;03;17;Maanantai;37;24;61;16;14;30
96;07.03.2011;2011;03;18;Maanantai;33;21;54;19;24;43
96;07.03.2011;2011;03;19;Maanantai;27;11;38;7;15;22
96;07.03.2011;2011;03;20;Maanantai;19;14;33;13;10;23
96;07.03.2011;2011;03;21;Maanantai;16;15;31;4;7;11
96;07.03.2011;2011;03;22;Maanantai;7;1;8;1;1;2
96;07.03.2011;2011;03;23;Maanantai;4;0;4;0;0;0
96;08.03.2011;2011;03;00;Tiistai;2;0;2;0;0;0
96;08.03.2011;2011;03;01;Tiistai;1;0;1;1;1;2
96;08.03.2011;2011;03;02;Tiistai;3;0;3;0;0;0
96;08.03.2011;2011;03;03;Tiistai;0;0;0;0;0;0
96;08.03.2011;2011;03;04;Tiistai;0;4;4;0;0;0
96;08.03.2011;2011;03;05;Tiistai;4;3;7;0;2;2
96;08.03.2011;2011;03;06;Tiistai;32;20;52;14;5;19
96;08.03.2011;2011;03;07;Tiistai;71;45;116;24;12;36
96;08.03.2011;2011;03;08;Tiistai;24;41;65;11;12;23
96;08.03.2011;2011;03;09;Tiistai;15;34;49;32;36;68
96;08.03.2011;2011;03;10;Tiistai;19;24;43;5;19;24
96;08.03.2011;2011;03;11;Tiistai;33;24;57;15;17;32
96;08.03.2011;2011;03;12;Tiistai;36;33;69;18;22;40
96;08.03.2011;2011;03;13;Tiistai;33;38;71;25;14;39
96;08.03.2011;2011;03;14;Tiistai;38;59;97;13;15;28
96;08.03.2011;2011;03;15;Tiistai;58;98;156;14;31;45
96;08.03.2011;2011;03;16;Tiistai;58;62;120;14;27;41
96;08.03.2011;2011;03;17;Tiistai;35;25;60;12;11;23
96;08.03.2011;2011;03;18;Tiistai;39;18;57;13;14;27
96;08.03.2011;2011;03;19;Tiistai;24;18;42;10;7;17
96;08.03.2011;2011;03;20;Tiistai;19;12;31;10;7;17
96;08.03.2011;2011;03;21;Tiistai;15;22;37;3;9;12
96;08.03.2011;2011;03;22;Tiistai;10;13;23;1;1;2
96;08.03.2011;2011;03;23;Tiistai;9;1;10;0;2;2
96;09.03.2011;2011;03;00;Keskiviikko;5;4;9;1;0;1
96;09.03.2011;2011;03;01;Keskiviikko;8;1;9;1;0;1
96;09.03.2011;2011;03;02;Keskiviikko;9;0;9;1;0;1
96;09.03.2011;2011;03;03;Keskiviikko;7;1;8;2;0;2
96;09.03.2011;2011;03;04;Keskiviikko;3;3;6;0;1;1
96;09.03.2011;2011;03;05;Keskiviikko;5;3;8;0;1;1
96;09.03.2011;2011;03;06;Keskiviikko;47;20;67;10;4;14
96;09.03.2011;2011;03;07;Keskiviikko;69;46;115;21;10;31
96;09.03.2011;2011;03;08;Keskiviikko;23;41;64;13;11;24
96;09.03.2011;2011;03;09;Keskiviikko;22;31;53;9;15;24
96;09.03.2011;2011;03;10;Keskiviikko;23;19;42;9;21;30
96;09.03.2011;2011;03;11;Keskiviikko;23;20;43;7;12;19
96;09.03.2011;2011;03;12;Keskiviikko;42;34;76;9;7;16
96;09.03.2011;2011;03;13;Keskiviikko;42;27;69;14;11;25
96;09.03.2011;2011;03;14;Keskiviikko;22;46;68;13;15;28
96;09.03.2011;2011;03;15;Keskiviikko;43;103;146;9;35;44
96;09.03.2011;2011;03;16;Keskiviikko;46;65;111;20;23;43
96;09.03.2011;2011;03;17;Keskiviikko;40;21;61;18;15;33
96;09.03.2011;2011;03;18;Keskiviikko;32;20;52;10;17;27
96;09.03.2011;2011;03;19;Keskiviikko;12;18;30;7;14;21
96;09.03.2011;2011;03;20;Keskiviikko;20;16;36;12;5;17
96;09.03.2011;2011;03;21;Keskiviikko;17;19;36;1;8;9
96;09.03.2011;2011;03;22;Keskiviikko;3;7;10;1;4;5
96;09.03.2011;2011;03;23;Keskiviikko;2;0;2;0;0;0
96;10.03.2011;2011;03;00;Torstai;1;0;1;1;0;1
96;10.03.2011;2011;03;01;Torstai;1;0;1;0;0;0
96;10.03.2011;2011;03;02;Torstai;3;1;4;1;0;1
96;10.03.2011;2011;03;03;Torstai;0;1;1;0;0;0
96;10.03.2011;2011;03;04;Torstai;2;3;5;0;0;0
96;10.03.2011;2011;03;05;Torstai;4;2;6;0;0;0
96;10.03.2011;2011;03;06;Torstai;31;28;59;0;1;1
96;10.03.2011;2011;03;07;Torstai;51;49;100;0;0;0
96;10.03.2011;2011;03;08;Torstai;33;8;41;6;0;6
96;10.03.2011;2011;03;09;Torstai;38;0;38;9;0;9
96;10.03.2011;2011;03;10;Torstai;19;15;34;14;7;21
96;10.03.2011;2011;03;11;Torstai;17;11;28;4;5;9
96;10.03.2011;2011;03;12;Torstai;30;16;46;12;19;31
96;10.03.2011;2011;03;13;Torstai;17;26;43;11;15;26
96;10.03.2011;2011;03;14;Torstai;23;37;60;6;12;18
96;10.03.2011;2011;03;15;Torstai;34;76;110;8;44;52
96;10.03.2011;2011;03;16;Torstai;43;63;106;6;29;35
96;10.03.2011;2011;03;17;Torstai;35;25;60;15;11;26
96;10.03.2011;2011;03;18;Torstai;22;21;43;9;23;32
96;10.03.2011;2011;03;19;Torstai;24;12;36;15;14;29
96;10.03.2011;2011;03;20;Torstai;29;6;35;15;3;18
96;10.03.2011;2011;03;21;Torstai;20;18;38;7;5;12
96;10.03.2011;2011;03;22;Torstai;4;3;7;2;2;4
96;10.03.2011;2011;03;23;Torstai;2;1;3;0;0;0
96;11.03.2011;2011;03;00;Perjantai;2;2;4;0;1;1
96;11.03.2011;2011;03;01;Perjantai;2;0;2;0;0;0
96;11.03.2011;2011;03;02;Perjantai;0;0;0;0;0;0
96;11.03.2011;2011;03;03;Perjantai;5;0;5;1;0;1
96;11.03.2011;2011;03;04;Perjantai;0;4;4;3;0;3
96;11.03.2011;2011;03;05;Perjantai;1;2;3;1;4;5
96;11.03.2011;2011;03;06;Perjantai;44;13;57;11;4;15
96;11.03.2011;2011;03;07;Perjantai;58;9;67;13;5;18
96;11.03.2011;2011;03;08;Perjantai;20;13;33;1;0;1
96;11.03.2011;2011;03;09;Perjantai;17;14;31;0;0;0
96;11.03.2011;2011;03;10;Perjantai;15;15;30;0;0;0
96;11.03.2011;2011;03;11;Perjantai;14;13;27;5;9;14
96;11.03.2011;2011;03;12;Perjantai;22;20;42;14;12;26
96;11.03.2011;2011;03;13;Perjantai;27;24;51;7;14;21
96;11.03.2011;2011;03;14;Perjantai;17;41;58;9;23;32
96;11.03.2011;2011;03;15;Perjantai;19;66;85;11;29;40
96;11.03.2011;2011;03;16;Perjantai;33;26;59;7;17;24
96;11.03.2011;2011;03;17;Perjantai;23;12;35;6;7;13
96;11.03.2011;2011;03;18;Perjantai;32;11;43;13;7;20
96;11.03.2011;2011;03;19;Perjantai;13;11;24;2;6;8
96;11.03.2011;2011;03;20;Perjantai;18;17;35;8;4;12
96;11.03.2011;2011;03;21;Perjantai;16;8;24;2;1;3
96;11.03.2011;2011;03;22;Perjantai;3;5;8;4;4;8
96;11.03.2011;2011;03;23;Perjantai;0;0;0;0;0;0
96;12.03.2011;2011;03;00;Lauantai;2;2;4;1;0;1
96;12.03.2011;2011;03;01;Lauantai;2;0;2;2;0;2
96;12.03.2011;2011;03;02;Lauantai;0;0;0;1;1;2
96;12.03.2011;2011;03;03;Lauantai;2;1;3;3;3;6
96;12.03.2011;2011;03;04;Lauantai;2;1;3;2;0;2
96;12.03.2011;2011;03;05;Lauantai;1;3;4;0;0;0
96;12.03.2011;2011;03;06;Lauantai;10;6;16;5;0;5
96;12.03.2011;2011;03;07;Lauantai;2;14;16;1;8;9
96;12.03.2011;2011;03;08;Lauantai;3;8;11;6;5;11
96;12.03.2011;2011;03;09;Lauantai;9;25;34;9;11;20
96;12.03.2011;2011;03;10;Lauantai;14;17;31;17;23;40
96;12.03.2011;2011;03;11;Lauantai;25;17;42;18;13;31
96;12.03.2011;2011;03;12;Lauantai;22;18;40;14;25;39
96;12.03.2011;2011;03;13;Lauantai;22;20;42;15;13;28
96;12.03.2011;2011;03;14;Lauantai;28;21;49;22;16;38
96;12.03.2011;2011;03;15;Lauantai;22;25;47;16;25;41
96;12.03.2011;2011;03;16;Lauantai;24;14;38;17;16;33
96;12.03.2011;2011;03;17;Lauantai;15;27;42;7;9;16
96;12.03.2011;2011;03;18;Lauantai;9;10;19;5;18;23
96;12.03.2011;2011;03;19;Lauantai;4;13;17;7;3;10
96;12.03.2011;2011;03;20;Lauantai;14;5;19;8;6;14
96;12.03.2011;2011;03;21;Lauantai;24;11;35;13;2;15
96;12.03.2011;2011;03;22;Lauantai;7;3;10;0;0;0
96;12.03.2011;2011;03;23;Lauantai;4;9;13;0;0;0
96;13.03.2011;2011;03;00;Sunnuntai;3;2;5;2;1;3
96;13.03.2011;2011;03;01;Sunnuntai;5;5;10;2;0;2
96;13.03.2011;2011;03;02;Sunnuntai;6;1;7;0;0;0
96;13.03.2011;2011;03;03;Sunnuntai;13;0;13;4;0;4
96;13.03.2011;2011;03;04;Sunnuntai;4;0;4;0;0;0
96;13.03.2011;2011;03;05;Sunnuntai;1;2;3;0;0;0
96;13.03.2011;2011;03;06;Sunnuntai;2;2;4;2;1;3
96;13.03.2011;2011;03;07;Sunnuntai;3;5;8;5;8;13
96;13.03.2011;2011;03;08;Sunnuntai;5;5;10;3;5;8
96;13.03.2011;2011;03;09;Sunnuntai;8;6;14;4;10;14
96;13.03.2011;2011;03;10;Sunnuntai;4;6;10;11;4;15
96;13.03.2011;2011;03;11;Sunnuntai;9;16;25;14;13;27
96;13.03.2011;2011;03;12;Sunnuntai;16;21;37;18;15;33
96;13.03.2011;2011;03;13;Sunnuntai;16;14;30;16;18;34
96;13.03.2011;2011;03;14;Sunnuntai;19;24;43;17;17;34
96;13.03.2011;2011;03;15;Sunnuntai;23;21;44;8;17;25
96;13.03.2011;2011;03;16;Sunnuntai;23;15;38;13;14;27
96;13.03.2011;2011;03;17;Sunnuntai;17;16;33;10;17;27
96;13.03.2011;2011;03;18;Sunnuntai;22;13;35;17;7;24
96;13.03.2011;2011;03;19;Sunnuntai;11;9;20;12;10;22
96;13.03.2011;2011;03;20;Sunnuntai;11;6;17;8;7;15
96;13.03.2011;2011;03;21;Sunnuntai;11;9;20;4;4;8
96;13.03.2011;2011;03;22;Sunnuntai;2;0;2;3;2;5
96;13.03.2011;2011;03;23;Sunnuntai;5;0;5;1;1;2
96;14.03.2011;2011;03;00;Maanantai;5;1;6;1;0;1
96;14.03.2011;2011;03;01;Maanantai;5;0;5;2;0;2
96;14.03.2011;2011;03;02;Maanantai;1;1;2;0;0;0
96;14.03.2011;2011;03;03;Maanantai;0;0;0;0;0;0
96;14.03.2011;2011;03;04;Maanantai;3;3;6;1;0;1
96;14.03.2011;2011;03;05;Maanantai;2;5;7;2;0;2
96;14.03.2011;2011;03;06;Maanantai;31;18;49;12;4;16
96;14.03.2011;2011;03;07;Maanantai;90;75;165;45;16;61
96;14.03.2011;2011;03;08;Maanantai;62;50;112;22;13;35
96;14.03.2011;2011;03;09;Maanantai;34;39;73;15;8;23
96;14.03.2011;2011;03;10;Maanantai;32;22;54;10;7;17
96;14.03.2011;2011;03;11;Maanantai;25;21;46;12;8;20
96;14.03.2011;2011;03;12;Maanantai;49;28;77;7;10;17
96;14.03.2011;2011;03;13;Maanantai;38;24;62;12;3;15
96;14.03.2011;2011;03;14;Maanantai;49;65;114;5;17;22
96;14.03.2011;2011;03;15;Maanantai;62;130;192;9;37;46
96;14.03.2011;2011;03;16;Maanantai;69;84;153;15;39;54
96;14.03.2011;2011;03;17;Maanantai;51;48;99;19;15;34
96;14.03.2011;2011;03;18;Maanantai;39;25;64;11;19;30
96;14.03.2011;2011;03;19;Maanantai;32;19;51;18;10;28
96;14.03.2011;2011;03;20;Maanantai;37;16;53;10;17;27
96;14.03.2011;2011;03;21;Maanantai;19;15;34;6;7;13
96;14.03.2011;2011;03;22;Maanantai;2;3;5;0;3;3
96;14.03.2011;2011;03;23;Maanantai;3;0;3;0;0;0
96;15.03.2011;2011;03;00;Tiistai;0;2;2;0;0;0
96;15.03.2011;2011;03;01;Tiistai;0;0;0;0;0;0
96;15.03.2011;2011;03;02;Tiistai;1;0;1;0;0;0
96;15.03.2011;2011;03;03;Tiistai;0;1;1;4;1;5
96;15.03.2011;2011;03;04;Tiistai;1;5;6;0;0;0
96;15.03.2011;2011;03;05;Tiistai;2;6;8;0;0;0
96;15.03.2011;2011;03;06;Tiistai;40;22;62;14;2;16
96;15.03.2011;2011;03;07;Tiistai;86;61;147;41;23;64
96;15.03.2011;2011;03;08;Tiistai;67;75;142;10;11;21
96;15.03.2011;2011;03;09;Tiistai;34;42;76;19;22;41
96;15.03.2011;2011;03;10;Tiistai;34;44;78;12;18;30
96;15.03.2011;2011;03;11;Tiistai;40;28;68;17;24;41
96;15.03.2011;2011;03;12;Tiistai;48;36;84;28;13;41
96;15.03.2011;2011;03;13;Tiistai;36;46;82;19;26;45
96;15.03.2011;2011;03;14;Tiistai;42;55;97;16;24;40
96;15.03.2011;2011;03;15;Tiistai;67;117;184;20;47;67
96;15.03.2011;2011;03;16;Tiistai;74;97;171;20;47;67
96;15.03.2011;2011;03;17;Tiistai;43;52;95;16;18;34
96;15.03.2011;2011;03;18;Tiistai;43;39;82;22;42;64
96;15.03.2011;2011;03;19;Tiistai;30;23;53;15;23;38
96;15.03.2011;2011;03;20;Tiistai;37;12;49;11;10;21
96;15.03.2011;2011;03;21;Tiistai;40;12;52;31;4;35
96;15.03.2011;2011;03;22;Tiistai;11;4;15;1;3;4
96;15.03.2011;2011;03;23;Tiistai;11;2;13;1;1;2
96;16.03.2011;2011;03;00;Keskiviikko;0;1;1;0;0;0
96;16.03.2011;2011;03;01;Keskiviikko;3;3;6;0;0;0
96;16.03.2011;2011;03;02;Keskiviikko;0;0;0;0;0;0
96;16.03.2011;2011;03;03;Keskiviikko;0;0;0;0;0;0
96;16.03.2011;2011;03;04;Keskiviikko;2;4;6;0;0;0
96;16.03.2011;2011;03;05;Keskiviikko;1;4;5;0;0;0
96;16.03.2011;2011;03;06;Keskiviikko;38;21;59;11;6;17
96;16.03.2011;2011;03;07;Keskiviikko;99;59;158;45;18;63
96;16.03.2011;2011;03;08;Keskiviikko;76;67;143;22;10;32
96;16.03.2011;2011;03;09;Keskiviikko;41;42;83;30;22;52
96;16.03.2011;2011;03;10;Keskiviikko;39;40;79;40;43;83
96;16.03.2011;2011;03;11;Keskiviikko;37;34;71;19;26;45
96;16.03.2011;2011;03;12;Keskiviikko;46;47;93;21;14;35
96;16.03.2011;2011;03;13;Keskiviikko;45;43;88;24;24;48
96;16.03.2011;2011;03;14;Keskiviikko;47;57;104;24;24;48
96;16.03.2011;2011;03;15;Keskiviikko;63;151;214;18;58;76
96;16.03.2011;2011;03;16;Keskiviikko;79;90;169;16;41;57
96;16.03.2011;2011;03;17;Keskiviikko;42;38;80;24;33;57
96;16.03.2011;2011;03;18;Keskiviikko;44;23;67;18;15;33
96;16.03.2011;2011;03;19;Keskiviikko;35;18;53;9;8;17
96;16.03.2011;2011;03;20;Keskiviikko;31;13;44;16;20;36
96;16.03.2011;2011;03;21;Keskiviikko;19;13;32;6;10;16
96;16.03.2011;2011;03;22;Keskiviikko;5;4;9;1;3;4
96;16.03.2011;2011;03;23;Keskiviikko;3;4;7;2;2;4
96;17.03.2011;2011;03;00;Torstai;1;1;2;0;0;0
96;17.03.2011;2011;03;01;Torstai;2;0;2;0;0;0
96;17.03.2011;2011;03;02;Torstai;2;0;2;0;1;1
96;17.03.2011;2011;03;03;Torstai;2;1;3;1;0;1
96;17.03.2011;2011;03;04;Torstai;2;4;6;0;2;2
96;17.03.2011;2011;03;05;Torstai;4;5;9;1;2;3
96;17.03.2011;2011;03;06;Torstai;40;21;61;15;5;20
96;17.03.2011;2011;03;07;Torstai;89;86;175;41;11;52
96;17.03.2011;2011;03;08;Torstai;91;77;168;33;27;60
96;17.03.2011;2011;03;09;Torstai;48;53;101;66;14;80
96;17.03.2011;2011;03;10;Torstai;28;31;59;16;23;39
96;17.03.2011;2011;03;11;Torstai;40;31;71;19;39;58
96;17.03.2011;2011;03;12;Torstai;60;37;97;16;21;37
96;17.03.2011;2011;03;13;Torstai;42;51;93;9;18;27
96;17.03.2011;2011;03;14;Torstai;53;69;122;24;29;53
96;17.03.2011;2011;03;15;Torstai;67;136;203;7;43;50
96;17.03.2011;2011;03;16;Torstai;89;101;190;14;40;54
96;17.03.2011;2011;03;17;Torstai;44;60;104;9;9;18
96;17.03.2011;2011;03;18;Torstai;47;35;82;16;12;28
96;17.03.2011;2011;03;19;Torstai;37;15;52;11;17;28
96;17.03.2011;2011;03;20;Torstai;22;17;39;8;4;12
96;17.03.2011;2011;03;21;Torstai;24;14;38;6;9;15
96;17.03.2011;2011;03;22;Torstai;6;9;15;1;3;4
96;17.03.2011;2011;03;23;Torstai;3;2;5;0;0;0
96;18.03.2011;2011;03;00;Perjantai;4;1;5;1;0;1
96;18.03.2011;2011;03;01;Perjantai;4;0;4;1;0;1
96;18.03.2011;2011;03;02;Perjantai;8;0;8;1;0;1
96;18.03.2011;2011;03;03;Perjantai;3;1;4;0;0;0
96;18.03.2011;2011;03;04;Perjantai;1;4;5;0;1;1
96;18.03.2011;2011;03;05;Perjantai;1;8;9;0;1;1
96;18.03.2011;2011;03;06;Perjantai;44;21;65;6;3;9
96;18.03.2011;2011;03;07;Perjantai;88;70;158;33;12;45
96;18.03.2011;2011;03;08;Perjantai;67;72;139;18;7;25
96;18.03.2011;2011;03;09;Perjantai;40;35;75;11;13;24
96;18.03.2011;2011;03;10;Perjantai;27;40;67;27;33;60
96;18.03.2011;2011;03;11;Perjantai;36;49;85;12;21;33
96;18.03.2011;2011;03;12;Perjantai;47;56;103;20;31;51
96;18.03.2011;2011;03;13;Perjantai;63;46;109;12;11;23
96;18.03.2011;2011;03;14;Perjantai;55;74;129;14;34;48
96;18.03.2011;2011;03;15;Perjantai;84;96;180;15;43;58
96;18.03.2011;2011;03;16;Perjantai;70;50;120;12;29;41
96;18.03.2011;2011;03;17;Perjantai;52;29;81;15;18;33
96;18.03.2011;2011;03;18;Perjantai;39;21;60;11;16;27
96;18.03.2011;2011;03;19;Perjantai;39;18;57;9;14;23
96;18.03.2011;2011;03;20;Perjantai;19;14;33;6;4;10
96;18.03.2011;2011;03;21;Perjantai;16;12;28;3;9;12
96;18.03.2011;2011;03;22;Perjantai;11;3;14;2;1;3
96;18.03.2011;2011;03;23;Perjantai;8;10;18;1;1;2
96;19.03.2011;2011;03;00;Lauantai;3;4;7;3;1;4
96;19.03.2011;2011;03;01;Lauantai;5;1;6;0;0;0
96;19.03.2011;2011;03;02;Lauantai;4;1;5;4;0;4
96;19.03.2011;2011;03;03;Lauantai;5;0;5;0;0;0
96;19.03.2011;2011;03;04;Lauantai;4;0;4;2;0;2
96;19.03.2011;2011;03;05;Lauantai;1;3;4;0;1;1
96;19.03.2011;2011;03;06;Lauantai;18;8;26;3;0;3
96;19.03.2011;2011;03;07;Lauantai;6;10;16;1;4;5
96;19.03.2011;2011;03;08;Lauantai;8;14;22;7;2;9
96;19.03.2011;2011;03;09;Lauantai;9;22;31;8;10;18
96;19.03.2011;2011;03;10;Lauantai;16;17;33;5;12;17
96;19.03.2011;2011;03;11;Lauantai;18;25;43;8;9;17
96;19.03.2011;2011;03;12;Lauantai;19;11;30;11;8;19
96;19.03.2011;2011;03;13;Lauantai;21;10;31;6;12;18
96;19.03.2011;2011;03;14;Lauantai;18;22;40;13;13;26
96;19.03.2011;2011;03;15;Lauantai;32;24;56;14;7;21
96;19.03.2011;2011;03;16;Lauantai;35;20;55;8;9;17
96;19.03.2011;2011;03;17;Lauantai;18;14;32;6;4;10
96;19.03.2011;2011;03;18;Lauantai;14;7;21;4;3;7
96;19.03.2011;2011;03;19;Lauantai;10;13;23;4;8;12
96;19.03.2011;2011;03;20;Lauantai;9;6;15;7;5;12
96;19.03.2011;2011;03;21;Lauantai;2;13;15;3;10;13
96;19.03.2011;2011;03;22;Lauantai;3;4;7;1;0;1
96;19.03.2011;2011;03;23;Lauantai;6;1;7;1;3;4
96;20.03.2011;2011;03;00;Sunnuntai;1;1;2;2;0;2
96;20.03.2011;2011;03;01;Sunnuntai;4;0;4;1;0;1
96;20.03.2011;2011;03;02;Sunnuntai;2;0;2;2;1;3
96;20.03.2011;2011;03;03;Sunnuntai;5;0;5;5;0;5
96;20.03.2011;2011;03;04;Sunnuntai;3;3;6;8;2;10
96;20.03.2011;2011;03;05;Sunnuntai;0;1;1;0;0;0
96;20.03.2011;2011;03;06;Sunnuntai;13;3;16;8;0;8
96;20.03.2011;2011;03;07;Sunnuntai;3;4;7;1;6;7
96;20.03.2011;2011;03;08;Sunnuntai;6;6;12;6;5;11
96;20.03.2011;2011;03;09;Sunnuntai;6;8;14;9;10;19
96;20.03.2011;2011;03;10;Sunnuntai;8;13;21;18;12;30
96;20.03.2011;2011;03;11;Sunnuntai;15;19;34;9;22;31
96;20.03.2011;2011;03;12;Sunnuntai;24;21;45;30;22;52
96;20.03.2011;2011;03;13;Sunnuntai;46;27;73;29;31;60
96;20.03.2011;2011;03;14;Sunnuntai;29;39;68;30;30;60
96;20.03.2011;2011;03;15;Sunnuntai;41;23;64;24;18;42
96;20.03.2011;2011;03;16;Sunnuntai;33;21;54;16;20;36
96;20.03.2011;2011;03;17;Sunnuntai;27;14;41;21;19;40
96;20.03.2011;2011;03;18;Sunnuntai;20;16;36;11;18;29
96;20.03.2011;2011;03;19;Sunnuntai;22;8;30;17;7;24
96;20.03.2011;2011;03;20;Sunnuntai;20;4;24;4;8;12
96;20.03.2011;2011;03;21;Sunnuntai;12;14;26;5;5;10
96;20.03.2011;2011;03;22;Sunnuntai;6;3;9;3;3;6
96;20.03.2011;2011;03;23;Sunnuntai;2;1;3;1;1;2
96;21.03.2011;2011;03;00;Maanantai;1;1;2;0;0;0
96;21.03.2011;2011;03;01;Maanantai;0;0;0;1;0;1
96;21.03.2011;2011;03;02;Maanantai;0;2;2;0;1;1
96;21.03.2011;2011;03;03;Maanantai;1;0;1;0;0;0
96;21.03.2011;2011;03;04;Maanantai;1;4;5;1;2;3
96;21.03.2011;2011;03;05;Maanantai;3;11;14;1;1;2
96;21.03.2011;2011;03;06;Maanantai;47;27;74;13;3;16
96;21.03.2011;2011;03;07;Maanantai;119;79;198;39;24;63
96;21.03.2011;2011;03;08;Maanantai;88;61;149;29;20;49
96;21.03.2011;2011;03;09;Maanantai;68;45;113;19;35;54
96;21.03.2011;2011;03;10;Maanantai;32;33;65;19;12;31
96;21.03.2011;2011;03;11;Maanantai;39;33;72;6;31;37
96;21.03.2011;2011;03;12;Maanantai;54;45;99;21;16;37
96;21.03.2011;2011;03;13;Maanantai;63;38;101;23;23;46
96;21.03.2011;2011;03;14;Maanantai;55;63;118;10;29;39
96;21.03.2011;2011;03;15;Maanantai;83;122;205;19;53;72
96;21.03.2011;2011;03;16;Maanantai;82;94;176;20;57;77
96;21.03.2011;2011;03;17;Maanantai;63;38;101;12;11;23
96;21.03.2011;2011;03;18;Maanantai;45;38;83;18;17;35
96;21.03.2011;2011;03;19;Maanantai;47;21;68;9;18;27
96;21.03.2011;2011;03;20;Maanantai;45;20;65;13;7;20
96;21.03.2011;2011;03;21;Maanantai;29;20;49;4;5;9
96;21.03.2011;2011;03;22;Maanantai;8;3;11;0;1;1
96;21.03.2011;2011;03;23;Maanantai;0;1;1;0;0;0
96;22.03.2011;2011;03;00;Tiistai;0;1;1;0;0;0
96;22.03.2011;2011;03;01;Tiistai;1;0;1;0;0;0
96;22.03.2011;2011;03;02;Tiistai;3;0;3;0;0;0
96;22.03.2011;2011;03;03;Tiistai;0;0;0;0;0;0
96;22.03.2011;2011;03;04;Tiistai;2;5;7;0;1;1
96;22.03.2011;2011;03;05;Tiistai;1;6;7;3;4;7
96;22.03.2011;2011;03;06;Tiistai;47;21;68;15;9;24
96;22.03.2011;2011;03;07;Tiistai;118;65;183;36;20;56
96;22.03.2011;2011;03;08;Tiistai;87;59;146;18;20;38
96;22.03.2011;2011;03;09;Tiistai;59;45;104;20;13;33
96;22.03.2011;2011;03;10;Tiistai;42;38;80;11;10;21
96;22.03.2011;2011;03;11;Tiistai;46;27;73;6;10;16
96;22.03.2011;2011;03;12;Tiistai;51;39;90;18;16;34
96;22.03.2011;2011;03;13;Tiistai;40;46;86;15;19;34
96;22.03.2011;2011;03;14;Tiistai;46;50;96;14;19;33
96;22.03.2011;2011;03;15;Tiistai;60;122;182;15;49;64
96;22.03.2011;2011;03;16;Tiistai;73;96;169;18;43;61
96;22.03.2011;2011;03;17;Tiistai;62;43;105;13;14;27
96;22.03.2011;2011;03;18;Tiistai;45;28;73;20;26;46
96;22.03.2011;2011;03;19;Tiistai;33;30;63;11;17;28
96;22.03.2011;2011;03;20;Tiistai;39;19;58;16;14;30
96;22.03.2011;2011;03;21;Tiistai;19;13;32;11;5;16
96;22.03.2011;2011;03;22;Tiistai;7;2;9;2;1;3
96;22.03.2011;2011;03;23;Tiistai;3;3;6;0;1;1
96;23.03.2011;2011;03;00;Keskiviikko;3;0;3;0;0;0
96;23.03.2011;2011;03;01;Keskiviikko;1;0;1;0;0;0
96;23.03.2011;2011;03;02;Keskiviikko;2;0;2;0;0;0
96;23.03.2011;2011;03;03;Keskiviikko;0;0;0;0;0;0
96;23.03.2011;2011;03;04;Keskiviikko;1;7;8;0;0;0
96;23.03.2011;2011;03;05;Keskiviikko;3;7;10;0;0;0
96;23.03.2011;2011;03;06;Keskiviikko;44;19;63;17;6;23
96;23.03.2011;2011;03;07;Keskiviikko;112;63;175;40;16;56
96;23.03.2011;2011;03;08;Keskiviikko;84;60;144;18;10;28
96;23.03.2011;2011;03;09;Keskiviikko;43;36;79;18;12;30
96;23.03.2011;2011;03;10;Keskiviikko;39;38;77;10;12;22
96;23.03.2011;2011;03;11;Keskiviikko;42;28;70;9;8;17
96;23.03.2011;2011;03;12;Keskiviikko;49;44;93;11;16;27
96;23.03.2011;2011;03;13;Keskiviikko;43;36;79;14;21;35
96;23.03.2011;2011;03;14;Keskiviikko;45;62;107;12;29;41
96;23.03.2011;2011;03;15;Keskiviikko;57;121;178;11;53;64
96;23.03.2011;2011;03;16;Keskiviikko;79;97;176;24;51;75
96;23.03.2011;2011;03;17;Keskiviikko;50;43;93;16;30;46
96;23.03.2011;2011;03;18;Keskiviikko;56;23;79;15;26;41
96;23.03.2011;2011;03;19;Keskiviikko;38;28;66;11;23;34
96;23.03.2011;2011;03;20;Keskiviikko;32;13;45;16;6;22
96;23.03.2011;2011;03;21;Keskiviikko;24;18;42;4;11;15
96;23.03.2011;2011;03;22;Keskiviikko;8;4;12;3;2;5
96;23.03.2011;2011;03;23;Keskiviikko;5;3;8;0;0;0
96;24.03.2011;2011;03;00;Torstai;4;3;7;1;0;1
96;24.03.2011;2011;03;01;Torstai;3;1;4;0;0;0
96;24.03.2011;2011;03;02;Torstai;3;0;3;0;0;0
96;24.03.2011;2011;03;03;Torstai;0;0;0;0;0;0
96;24.03.2011;2011;03;04;Torstai;1;4;5;1;0;1
96;24.03.2011;2011;03;05;Torstai;3;4;7;0;3;3
96;24.03.2011;2011;03;06;Torstai;40;18;58;19;3;22
96;24.03.2011;2011;03;07;Torstai;102;56;158;49;16;65
96;24.03.2011;2011;03;08;Torstai;82;68;150;17;16;33
96;24.03.2011;2011;03;09;Torstai;36;53;89;12;24;36
96;24.03.2011;2011;03;10;Torstai;31;35;66;29;20;49
96;24.03.2011;2011;03;11;Torstai;29;33;62;14;18;32
96;24.03.2011;2011;03;12;Torstai;48;36;84;19;14;33
96;24.03.2011;2011;03;13;Torstai;32;51;83;12;44;56
96;24.03.2011;2011;03;14;Torstai;39;65;104;22;20;42
96;24.03.2011;2011;03;15;Torstai;47;125;172;11;57;68
96;24.03.2011;2011;03;16;Torstai;73;91;164;11;40;51
96;24.03.2011;2011;03;17;Torstai;47;52;99;8;12;20
96;24.03.2011;2011;03;18;Torstai;39;27;66;23;21;44
96;24.03.2011;2011;03;19;Torstai;45;22;67;16;10;26
96;24.03.2011;2011;03;20;Torstai;42;12;54;9;7;16
96;24.03.2011;2011;03;21;Torstai;17;19;36;1;10;11
96;24.03.2011;2011;03;22;Torstai;5;5;10;1;2;3
96;24.03.2011;2011;03;23;Torstai;3;1;4;2;0;2
96;25.03.2011;2011;03;00;Perjantai;3;1;4;1;0;1
96;25.03.2011;2011;03;01;Perjantai;0;0;0;0;0;0
96;25.03.2011;2011;03;02;Perjantai;1;0;1;1;0;1
96;25.03.2011;2011;03;03;Perjantai;0;1;1;0;0;0
96;25.03.2011;2011;03;04;Perjantai;2;4;6;1;0;1
96;25.03.2011;2011;03;05;Perjantai;3;8;11;0;0;0
96;25.03.2011;2011;03;06;Perjantai;33;22;55;16;2;18
96;25.03.2011;2011;03;07;Perjantai;87;62;149;30;13;43
96;25.03.2011;2011;03;08;Perjantai;73;41;114;11;11;22
96;25.03.2011;2011;03;09;Perjantai;38;34;72;16;14;30
96;25.03.2011;2011;03;10;Perjantai;27;47;74;14;10;24
96;25.03.2011;2011;03;11;Perjantai;32;33;65;8;9;17
96;25.03.2011;2011;03;12;Perjantai;34;47;81;8;25;33
96;25.03.2011;2011;03;13;Perjantai;44;74;118;13;16;29
96;25.03.2011;2011;03;14;Perjantai;64;78;142;21;32;53
96;25.03.2011;2011;03;15;Perjantai;50;98;148;9;50;59
96;25.03.2011;2011;03;16;Perjantai;49;33;82;10;30;40
96;25.03.2011;2011;03;17;Perjantai;47;29;76;13;17;30
96;25.03.2011;2011;03;18;Perjantai;38;24;62;9;10;19
96;25.03.2011;2011;03;19;Perjantai;19;21;40;8;9;17
96;25.03.2011;2011;03;20;Perjantai;21;9;30;9;5;14
96;25.03.2011;2011;03;21;Perjantai;18;15;33;3;9;12
96;25.03.2011;2011;03;22;Perjantai;8;6;14;1;2;3
96;25.03.2011;2011;03;23;Perjantai;11;1;12;0;1;1
96;26.03.2011;2011;03;00;Lauantai;3;3;6;0;1;1
96;26.03.2011;2011;03;01;Lauantai;5;1;6;0;0;0
96;26.03.2011;2011;03;02;Lauantai;3;0;3;2;1;3
96;26.03.2011;2011;03;03;Lauantai;2;0;2;1;0;1
96;26.03.2011;2011;03;04;Lauantai;3;1;4;6;2;8
96;26.03.2011;2011;03;05;Lauantai;0;2;2;0;0;0
96;26.03.2011;2011;03;06;Lauantai;12;6;18;3;3;6
96;26.03.2011;2011;03;07;Lauantai;3;10;13;4;4;8
96;26.03.2011;2011;03;08;Lauantai;5;11;16;4;3;7
96;26.03.2011;2011;03;09;Lauantai;5;26;31;6;18;24
96;26.03.2011;2011;03;10;Lauantai;11;19;30;10;23;33
96;26.03.2011;2011;03;11;Lauantai;21;15;36;14;5;19
96;26.03.2011;2011;03;12;Lauantai;24;25;49;14;14;28
96;26.03.2011;2011;03;13;Lauantai;23;17;40;12;12;24
96;26.03.2011;2011;03;14;Lauantai;23;30;53;12;15;27
96;26.03.2011;2011;03;15;Lauantai;27;25;52;9;20;29
96;26.03.2011;2011;03;16;Lauantai;26;10;36;19;13;32
96;26.03.2011;2011;03;17;Lauantai;27;23;50;7;6;13
96;26.03.2011;2011;03;18;Lauantai;22;13;35;4;9;13
96;26.03.2011;2011;03;19;Lauantai;5;13;18;8;6;14
96;26.03.2011;2011;03;20;Lauantai;10;14;24;4;7;11
96;26.03.2011;2011;03;21;Lauantai;7;10;17;2;6;8
96;26.03.2011;2011;03;22;Lauantai;5;2;7;0;4;4
96;26.03.2011;2011;03;23;Lauantai;5;5;10;0;0;0
96;27.03.2011;2011;03;00;Sunnuntai;4;6;10;0;0;0
96;27.03.2011;2011;03;01;Sunnuntai;2;0;2;1;0;1
96;27.03.2011;2011;03;02;Sunnuntai;0;0;0;0;0;0
96;27.03.2011;2011;03;03;Sunnuntai;4;0;4;3;0;3
96;27.03.2011;2011;03;04;Sunnuntai;3;2;5;1;0;1
96;27.03.2011;2011;03;05;Sunnuntai;7;2;9;3;1;4
96;27.03.2011;2011;03;06;Sunnuntai;4;4;8;1;4;5
96;27.03.2011;2011;03;07;Sunnuntai;4;4;8;1;4;5
96;27.03.2011;2011;03;08;Sunnuntai;1;1;2;1;1;2
96;27.03.2011;2011;03;09;Sunnuntai;4;5;9;7;5;12
96;27.03.2011;2011;03;10;Sunnuntai;3;5;8;5;9;14
96;27.03.2011;2011;03;11;Sunnuntai;4;14;18;12;14;26
96;27.03.2011;2011;03;12;Sunnuntai;23;21;44;13;15;28
96;27.03.2011;2011;03;13;Sunnuntai;26;14;40;17;14;31
96;27.03.2011;2011;03;14;Sunnuntai;13;21;34;16;18;34
96;27.03.2011;2011;03;15;Sunnuntai;19;16;35;22;24;46
96;27.03.2011;2011;03;16;Sunnuntai;22;25;47;16;12;28
96;27.03.2011;2011;03;17;Sunnuntai;13;22;35;17;18;35
96;27.03.2011;2011;03;18;Sunnuntai;27;12;39;12;6;18
96;27.03.2011;2011;03;19;Sunnuntai;16;4;20;11;13;24
96;27.03.2011;2011;03;20;Sunnuntai;15;10;25;10;14;24
96;27.03.2011;2011;03;21;Sunnuntai;17;8;25;6;7;13
96;27.03.2011;2011;03;22;Sunnuntai;8;0;8;5;2;7
96;27.03.2011;2011;03;23;Sunnuntai;4;2;6;0;2;2
96;28.03.2011;2011;03;00;Maanantai;1;0;1;0;0;0
96;28.03.2011;2011;03;01;Maanantai;3;1;4;0;0;0
96;28.03.2011;2011;03;02;Maanantai;0;0;0;0;0;0
96;28.03.2011;2011;03;03;Maanantai;2;0;2;0;0;0
96;28.03.2011;2011;03;04;Maanantai;1;3;4;1;0;1
96;28.03.2011;2011;03;05;Maanantai;1;11;12;0;0;0
96;28.03.2011;2011;03;06;Maanantai;30;15;45;7;4;11
96;28.03.2011;2011;03;07;Maanantai;91;67;158;40;13;53
96;28.03.2011;2011;03;08;Maanantai;71;70;141;18;13;31
96;28.03.2011;2011;03;09;Maanantai;48;45;93;16;11;27
96;28.03.2011;2011;03;10;Maanantai;30;28;58;9;15;24
96;28.03.2011;2011;03;11;Maanantai;32;38;70;22;17;39
96;28.03.2011;2011;03;12;Maanantai;48;37;85;20;22;42
96;28.03.2011;2011;03;13;Maanantai;45;42;87;10;21;31
96;28.03.2011;2011;03;14;Maanantai;53;73;126;10;20;30
96;28.03.2011;2011;03;15;Maanantai;70;132;202;21;57;78
96;28.03.2011;2011;03;16;Maanantai;78;97;175;20;50;70
96;28.03.2011;2011;03;17;Maanantai;53;43;96;28;26;54
96;28.03.2011;2011;03;18;Maanantai;43;31;74;27;28;55
96;28.03.2011;2011;03;19;Maanantai;41;25;66;24;31;55
96;28.03.2011;2011;03;20;Maanantai;46;11;57;25;22;47
96;28.03.2011;2011;03;21;Maanantai;21;17;38;8;12;20
96;28.03.2011;2011;03;22;Maanantai;4;4;8;4;4;8
96;28.03.2011;2011;03;23;Maanantai;3;1;4;2;0;2
96;29.03.2011;2011;03;00;Tiistai;0;0;0;0;0;0
96;29.03.2011;2011;03;01;Tiistai;0;0;0;0;0;0
96;29.03.2011;2011;03;02;Tiistai;3;0;3;0;0;0
96;29.03.2011;2011;03;03;Tiistai;0;0;0;0;0;0
96;29.03.2011;2011;03;04;Tiistai;2;2;4;0;0;0
96;29.03.2011;2011;03;05;Tiistai;2;9;11;0;1;1
96;29.03.2011;2011;03;06;Tiistai;34;24;58;13;7;20
96;29.03.2011;2011;03;07;Tiistai;101;53;154;35;26;61
96;29.03.2011;2011;03;08;Tiistai;77;64;141;7;16;23
96;29.03.2011;2011;03;09;Tiistai;33;48;81;20;12;32
96;29.03.2011;2011;03;10;Tiistai;28;40;68;19;14;33
96;29.03.2011;2011;03;11;Tiistai;36;45;81;11;24;35
96;29.03.2011;2011;03;12;Tiistai;45;38;83;31;18;49
96;29.03.2011;2011;03;13;Tiistai;50;53;103;11;31;42
96;29.03.2011;2011;03;14;Tiistai;50;78;128;9;18;27
96;29.03.2011;2011;03;15;Tiistai;71;122;193;19;53;72
96;29.03.2011;2011;03;16;Tiistai;91;100;191;29;32;61
96;29.03.2011;2011;03;17;Tiistai;59;32;91;23;10;33
96;29.03.2011;2011;03;18;Tiistai;40;45;85;20;26;46
96;29.03.2011;2011;03;19;Tiistai;50;28;78;24;22;46
96;29.03.2011;2011;03;20;Tiistai;41;20;61;21;18;39
96;29.03.2011;2011;03;21;Tiistai;21;13;34;10;12;22
96;29.03.2011;2011;03;22;Tiistai;10;3;13;1;0;1
96;29.03.2011;2011;03;23;Tiistai;1;0;1;0;1;1
96;30.03.2011;2011;03;00;Keskiviikko;3;0;3;0;0;0
96;30.03.2011;2011;03;01;Keskiviikko;1;0;1;0;0;0
96;30.03.2011;2011;03;02;Keskiviikko;0;0;0;1;0;1
96;30.03.2011;2011;03;03;Keskiviikko;1;0;1;0;0;0
96;30.03.2011;2011;03;04;Keskiviikko;2;2;4;0;0;0
96;30.03.2011;2011;03;05;Keskiviikko;3;9;12;0;1;1
96;30.03.2011;2011;03;06;Keskiviikko;33;19;52;6;5;11
96;30.03.2011;2011;03;07;Keskiviikko;93;54;147;32;20;52
96;30.03.2011;2011;03;08;Keskiviikko;92;68;160;19;13;32
96;30.03.2011;2011;03;09;Keskiviikko;46;39;85;9;8;17
96;30.03.2011;2011;03;10;Keskiviikko;28;36;64;4;8;12
96;30.03.2011;2011;03;11;Keskiviikko;42;36;78;29;10;39
96;30.03.2011;2011;03;12;Keskiviikko;45;53;98;16;26;42
96;30.03.2011;2011;03;13;Keskiviikko;50;70;120;30;32;62
96;30.03.2011;2011;03;14;Keskiviikko;51;71;122;12;25;37
96;30.03.2011;2011;03;15;Keskiviikko;67;112;179;10;44;54
96;30.03.2011;2011;03;16;Keskiviikko;97;90;187;28;55;83
96;30.03.2011;2011;03;17;Keskiviikko;64;74;138;14;21;35
96;30.03.2011;2011;03;18;Keskiviikko;49;32;81;25;11;36
96;30.03.2011;2011;03;19;Keskiviikko;45;33;78;12;18;30
96;30.03.2011;2011;03;20;Keskiviikko;38;9;47;13;16;29
96;30.03.2011;2011;03;21;Keskiviikko;27;13;40;11;11;22
96;30.03.2011;2011;03;22;Keskiviikko;5;7;12;3;2;5
96;30.03.2011;2011;03;23;Keskiviikko;6;1;7;1;0;1
96;31.03.2011;2011;03;00;Torstai;2;0;2;0;0;0
96;31.03.2011;2011;03;01;Torstai;1;0;1;1;0;1
96;31.03.2011;2011;03;02;Torstai;0;0;0;0;0;0
96;31.03.2011;2011;03;03;Torstai;7;1;8;0;0;0
96;31.03.2011;2011;03;04;Torstai;3;2;5;0;0;0
96;31.03.2011;2011;03;05;Torstai;2;8;10;0;1;1
96;31.03.2011;2011;03;06;Torstai;33;17;50;11;2;13
96;31.03.2011;2011;03;07;Torstai;102;50;152;29;18;47
96;31.03.2011;2011;03;08;Torstai;79;62;141;15;20;35
96;31.03.2011;2011;03;09;Torstai;48;54;102;17;8;25
96;31.03.2011;2011;03;10;Torstai;42;42;84;13;13;26
96;31.03.2011;2011;03;11;Torstai;36;32;68;7;15;22
96;31.03.2011;2011;03;12;Torstai;52;39;91;11;11;22
96;31.03.2011;2011;03;13;Torstai;52;50;102;11;22;33
96;31.03.2011;2011;03;14;Torstai;65;68;133;12;21;33
96;31.03.2011;2011;03;15;Torstai;72;151;223;8;55;63
96;31.03.2011;2011;03;16;Torstai;82;82;164;13;36;49
96;31.03.2011;2011;03;17;Torstai;69;45;114;32;24;56
96;31.03.2011;2011;03;18;Torstai;56;26;82;30;23;53
96;31.03.2011;2011;03;19;Torstai;35;21;56;28;26;54
96;31.03.2011;2011;03;20;Torstai;38;9;47;11;10;21
96;31.03.2011;2011;03;21;Torstai;15;22;37;4;8;12
96;31.03.2011;2011;03;22;Torstai;12;3;15;3;5;8
96;31.03.2011;2011;03;23;Torstai;6;0;6;0;2;2
96;01.04.2011;2011;04;00;Perjantai;2;1;3;0;0;0
96;01.04.2011;2011;04;01;Perjantai;1;1;2;1;0;1
96;01.04.2011;2011;04;02;Perjantai;6;0;6;1;0;1
96;01.04.2011;2011;04;03;Perjantai;0;0;0;0;1;1
96;01.04.2011;2011;04;04;Perjantai;3;3;6;0;1;1
96;01.04.2011;2011;04;05;Perjantai;1;7;8;0;4;4
96;01.04.2011;2011;04;06;Perjantai;37;23;60;10;7;17
96;01.04.2011;2011;04;07;Perjantai;103;65;168;38;17;55
96;01.04.2011;2011;04;08;Perjantai;67;52;119;13;9;22
96;01.04.2011;2011;04;09;Perjantai;29;45;74;10;16;26
96;01.04.2011;2011;04;10;Perjantai;24;39;63;8;12;20
96;01.04.2011;2011;04;11;Perjantai;31;46;77;11;17;28
96;01.04.2011;2011;04;12;Perjantai;41;63;104;17;26;43
96;01.04.2011;2011;04;13;Perjantai;42;66;108;8;27;35
96;01.04.2011;2011;04;14;Perjantai;77;103;180;14;27;41
96;01.04.2011;2011;04;15;Perjantai;74;115;189;8;36;44
96;01.04.2011;2011;04;16;Perjantai;70;45;115;13;20;33
96;01.04.2011;2011;04;17;Perjantai;56;41;97;19;12;31
96;01.04.2011;2011;04;18;Perjantai;36;26;62;14;9;23
96;01.04.2011;2011;04;19;Perjantai;23;14;37;7;9;16
96;01.04.2011;2011;04;20;Perjantai;26;16;42;7;7;14
96;01.04.2011;2011;04;21;Perjantai;17;12;29;4;4;8
96;01.04.2011;2011;04;22;Perjantai;5;5;10;2;2;4
96;01.04.2011;2011;04;23;Perjantai;14;8;22;3;0;3
96;02.04.2011;2011;04;00;Lauantai;7;3;10;1;0;1
96;02.04.2011;2011;04;01;Lauantai;4;2;6;1;1;2
96;02.04.2011;2011;04;02;Lauantai;4;2;6;1;0;1
96;02.04.2011;2011;04;03;Lauantai;7;0;7;0;0;0
96;02.04.2011;2011;04;04;Lauantai;4;2;6;2;0;2
96;02.04.2011;2011;04;05;Lauantai;0;2;2;0;1;1
96;02.04.2011;2011;04;06;Lauantai;9;6;15;2;0;2
96;02.04.2011;2011;04;07;Lauantai;5;8;13;8;9;17
96;02.04.2011;2011;04;08;Lauantai;6;14;20;6;5;11
96;02.04.2011;2011;04;09;Lauantai;6;30;36;5;12;17
96;02.04.2011;2011;04;10;Lauantai;12;20;32;4;8;12
96;02.04.2011;2011;04;11;Lauantai;16;29;45;8;13;21
96;02.04.2011;2011;04;12;Lauantai;35;25;60;13;14;27
96;02.04.2011;2011;04;13;Lauantai;37;22;59;10;9;19
96;02.04.2011;2011;04;14;Lauantai;32;30;62;11;15;26
96;02.04.2011;2011;04;15;Lauantai;31;26;57;6;11;17
96;02.04.2011;2011;04;16;Lauantai;22;5;27;6;6;12
96;02.04.2011;2011;04;17;Lauantai;20;17;37;5;6;11
96;02.04.2011;2011;04;18;Lauantai;16;10;26;6;9;15
96;02.04.2011;2011;04;19;Lauantai;11;11;22;6;3;9
96;02.04.2011;2011;04;20;Lauantai;13;7;20;4;7;11
96;02.04.2011;2011;04;21;Lauantai;13;11;24;6;9;15
96;02.04.2011;2011;04;22;Lauantai;10;5;15;1;2;3
96;02.04.2011;2011;04;23;Lauantai;5;4;9;3;1;4
96;03.04.2011;2011;04;00;Sunnuntai;5;7;12;0;0;0
96;03.04.2011;2011;04;01;Sunnuntai;7;3;10;0;1;1
96;03.04.2011;2011;04;02;Sunnuntai;2;0;2;2;0;2
96;03.04.2011;2011;04;03;Sunnuntai;7;0;7;2;0;2
96;03.04.2011;2011;04;04;Sunnuntai;4;0;4;3;0;3
96;03.04.2011;2011;04;05;Sunnuntai;1;0;1;2;0;2
96;03.04.2011;2011;04;06;Sunnuntai;11;4;15;7;0;7
96;03.04.2011;2011;04;07;Sunnuntai;0;6;6;0;2;2
96;03.04.2011;2011;04;08;Sunnuntai;2;4;6;2;2;4
96;03.04.2011;2011;04;09;Sunnuntai;3;4;7;5;5;10
96;03.04.2011;2011;04;10;Sunnuntai;6;14;20;9;8;17
96;03.04.2011;2011;04;11;Sunnuntai;10;15;25;19;8;27
96;03.04.2011;2011;04;12;Sunnuntai;13;22;35;11;22;33
96;03.04.2011;2011;04;13;Sunnuntai;32;25;57;11;17;28
96;03.04.2011;2011;04;14;Sunnuntai;29;29;58;12;18;30
96;03.04.2011;2011;04;15;Sunnuntai;27;17;44;16;16;32
96;03.04.2011;2011;04;16;Sunnuntai;23;24;47;22;13;35
96;03.04.2011;2011;04;17;Sunnuntai;23;17;40;22;21;43
96;03.04.2011;2011;04;18;Sunnuntai;22;14;36;24;11;35
96;03.04.2011;2011;04;19;Sunnuntai;21;16;37;11;13;24
96;03.04.2011;2011;04;20;Sunnuntai;15;8;23;11;9;20
96;03.04.2011;2011;04;21;Sunnuntai;11;12;23;9;7;16
96;03.04.2011;2011;04;22;Sunnuntai;5;5;10;5;6;11
96;03.04.2011;2011;04;23;Sunnuntai;2;1;3;0;0;0
96;04.04.2011;2011;04;00;Maanantai;1;1;2;1;1;2
96;04.04.2011;2011;04;01;Maanantai;1;1;2;2;0;2
96;04.04.2011;2011;04;02;Maanantai;0;0;0;0;0;0
96;04.04.2011;2011;04;03;Maanantai;1;3;4;0;0;0
96;04.04.2011;2011;04;04;Maanantai;1;4;5;1;0;1
96;04.04.2011;2011;04;05;Maanantai;4;9;13;2;0;2
96;04.04.2011;2011;04;06;Maanantai;43;19;62;16;4;20
96;04.04.2011;2011;04;07;Maanantai;107;82;189;31;13;44
96;04.04.2011;2011;04;08;Maanantai;75;78;153;21;8;29
96;04.04.2011;2011;04;09;Maanantai;57;59;116;9;6;15
96;04.04.2011;2011;04;10;Maanantai;35;41;76;7;11;18
96;04.04.2011;2011;04;11;Maanantai;50;31;81;7;10;17
96;04.04.2011;2011;04;12;Maanantai;52;58;110;6;14;20
96;04.04.2011;2011;04;13;Maanantai;49;53;102;8;9;17
96;04.04.2011;2011;04;14;Maanantai;58;66;124;5;9;14
96;04.04.2011;2011;04;15;Maanantai;80;163;243;15;45;60
96;04.04.2011;2011;04;16;Maanantai;87;110;197;17;26;43
96;04.04.2011;2011;04;17;Maanantai;64;46;110;11;8;19
96;04.04.2011;2011;04;18;Maanantai;47;39;86;24;17;41
96;04.04.2011;2011;04;19;Maanantai;50;23;73;9;10;19
96;04.04.2011;2011;04;20;Maanantai;33;16;49;7;4;11
96;04.04.2011;2011;04;21;Maanantai;21;15;36;3;5;8
96;04.04.2011;2011;04;22;Maanantai;5;5;10;1;3;4
96;04.04.2011;2011;04;23;Maanantai;5;3;8;2;0;2
96;05.04.2011;2011;04;00;Tiistai;0;0;0;1;0;1
96;05.04.2011;2011;04;01;Tiistai;0;2;2;0;0;0
96;05.04.2011;2011;04;02;Tiistai;2;0;2;0;0;0
96;05.04.2011;2011;04;03;Tiistai;0;0;0;0;0;0
96;05.04.2011;2011;04;04;Tiistai;1;5;6;1;0;1
96;05.04.2011;2011;04;05;Tiistai;2;6;8;0;0;0
96;05.04.2011;2011;04;06;Tiistai;41;24;65;10;4;14
96;05.04.2011;2011;04;07;Tiistai;108;74;182;35;12;47
96;05.04.2011;2011;04;08;Tiistai;76;80;156;16;15;31
96;05.04.2011;2011;04;09;Tiistai;46;68;114;19;14;33
96;05.04.2011;2011;04;10;Tiistai;36;45;81;5;14;19
96;05.04.2011;2011;04;11;Tiistai;47;60;107;18;17;35
96;05.04.2011;2011;04;12;Tiistai;59;71;130;17;17;34
96;05.04.2011;2011;04;13;Tiistai;46;67;113;12;27;39
96;05.04.2011;2011;04;14;Tiistai;84;75;159;22;24;46
96;05.04.2011;2011;04;15;Tiistai;92;138;230;13;40;53
96;05.04.2011;2011;04;16;Tiistai;84;115;199;19;39;58
96;05.04.2011;2011;04;17;Tiistai;83;62;145;19;17;36
96;05.04.2011;2011;04;18;Tiistai;64;38;102;36;21;57
96;05.04.2011;2011;04;19;Tiistai;51;35;86;35;27;62
96;05.04.2011;2011;04;20;Tiistai;45;21;66;19;16;35
96;05.04.2011;2011;04;21;Tiistai;31;19;50;10;13;23
96;05.04.2011;2011;04;22;Tiistai;11;0;11;2;1;3
96;05.04.2011;2011;04;23;Tiistai;5;1;6;2;0;2
96;06.04.2011;2011;04;00;Keskiviikko;1;1;2;0;0;0
96;06.04.2011;2011;04;01;Keskiviikko;3;2;5;0;0;0
96;06.04.2011;2011;04;02;Keskiviikko;1;0;1;1;0;1
96;06.04.2011;2011;04;03;Keskiviikko;0;0;0;0;0;0
96;06.04.2011;2011;04;04;Keskiviikko;2;4;6;0;0;0
96;06.04.2011;2011;04;05;Keskiviikko;5;5;10;0;1;1
96;06.04.2011;2011;04;06;Keskiviikko;46;32;78;11;6;17
96;06.04.2011;2011;04;07;Keskiviikko;102;112;214;36;9;45
96;06.04.2011;2011;04;08;Keskiviikko;84;77;161;13;4;17
96;06.04.2011;2011;04;09;Keskiviikko;42;54;96;12;13;25
96;06.04.2011;2011;04;10;Keskiviikko;31;44;75;4;6;10
96;06.04.2011;2011;04;11;Keskiviikko;58;31;89;9;5;14
96;06.04.2011;2011;04;12;Keskiviikko;41;46;87;9;2;11
96;06.04.2011;2011;04;13;Keskiviikko;38;53;91;8;11;19
96;06.04.2011;2011;04;14;Keskiviikko;48;70;118;7;16;23
96;06.04.2011;2011;04;15;Keskiviikko;63;155;218;14;44;58
96;06.04.2011;2011;04;16;Keskiviikko;74;101;175;11;23;34
96;06.04.2011;2011;04;17;Keskiviikko;54;55;109;3;6;9
96;06.04.2011;2011;04;18;Keskiviikko;48;31;79;10;12;22
96;06.04.2011;2011;04;19;Keskiviikko;39;25;64;12;11;23
96;06.04.2011;2011;04;20;Keskiviikko;33;21;54;13;13;26
96;06.04.2011;2011;04;21;Keskiviikko;25;12;37;5;13;18
96;06.04.2011;2011;04;22;Keskiviikko;6;4;10;1;3;4
96;06.04.2011;2011;04;23;Keskiviikko;2;1;3;7;2;9
96;07.04.2011;2011;04;00;Torstai;5;0;5;1;0;1
96;07.04.2011;2011;04;01;Torstai;0;0;0;0;0;0
96;07.04.2011;2011;04;02;Torstai;4;0;4;1;0;1
96;07.04.2011;2011;04;03;Torstai;5;1;6;0;0;0
96;07.04.2011;2011;04;04;Torstai;2;4;6;0;0;0
96;07.04.2011;2011;04;05;Torstai;0;10;10;0;0;0
96;07.04.2011;2011;04;06;Torstai;34;20;54;11;6;17
96;07.04.2011;2011;04;07;Torstai;101;84;185;34;7;41
96;07.04.2011;2011;04;08;Torstai;67;71;138;12;9;21
96;07.04.2011;2011;04;09;Torstai;34;64;98;12;10;22
96;07.04.2011;2011;04;10;Torstai;30;53;83;10;10;20
96;07.04.2011;2011;04;11;Torstai;53;44;97;6;10;16
96;07.04.2011;2011;04;12;Torstai;62;50;112;7;10;17
96;07.04.2011;2011;04;13;Torstai;60;45;105;8;11;19
96;07.04.2011;2011;04;14;Torstai;39;83;122;8;27;35
96;07.04.2011;2011;04;15;Torstai;76;157;233;11;26;37
96;07.04.2011;2011;04;16;Torstai;84;104;188;12;26;38
96;07.04.2011;2011;04;17;Torstai;82;50;132;15;17;32
96;07.04.2011;2011;04;18;Torstai;49;35;84;26;21;47
96;07.04.2011;2011;04;19;Torstai;47;38;85;27;23;50
96;07.04.2011;2011;04;20;Torstai;54;26;80;10;20;30
96;07.04.2011;2011;04;21;Torstai;24;24;48;8;4;12
96;07.04.2011;2011;04;22;Torstai;13;5;18;2;0;2
96;07.04.2011;2011;04;23;Torstai;6;4;10;2;3;5
96;08.04.2011;2011;04;00;Perjantai;5;1;6;1;1;2
96;08.04.2011;2011;04;01;Perjantai;2;1;3;0;0;0
96;08.04.2011;2011;04;02;Perjantai;2;0;2;0;0;0
96;08.04.2011;2011;04;03;Perjantai;5;0;5;0;0;0
96;08.04.2011;2011;04;04;Perjantai;3;4;7;0;0;0
96;08.04.2011;2011;04;05;Perjantai;1;7;8;0;0;0
96;08.04.2011;2011;04;06;Perjantai;42;26;68;9;3;12
96;08.04.2011;2011;04;07;Perjantai;106;82;188;29;15;44
96;08.04.2011;2011;04;08;Perjantai;52;66;118;18;7;25
96;08.04.2011;2011;04;09;Perjantai;51;67;118;10;5;15
96;08.04.2011;2011;04;10;Perjantai;28;47;75;3;6;9
96;08.04.2011;2011;04;11;Perjantai;54;45;99;12;9;21
96;08.04.2011;2011;04;12;Perjantai;59;68;127;10;15;25
96;08.04.2011;2011;04;13;Perjantai;67;100;167;7;13;20
96;08.04.2011;2011;04;14;Perjantai;75;96;171;3;22;25
96;08.04.2011;2011;04;15;Perjantai;66;119;185;8;35;43
96;08.04.2011;2011;04;16;Perjantai;75;61;136;10;21;31
96;08.04.2011;2011;04;17;Perjantai;57;35;92;11;9;20
96;08.04.2011;2011;04;18;Perjantai;33;40;73;14;6;20
96;08.04.2011;2011;04;19;Perjantai;30;39;69;11;10;21
96;08.04.2011;2011;04;20;Perjantai;45;12;57;8;7;15
96;08.04.2011;2011;04;21;Perjantai;34;16;50;7;10;17
96;08.04.2011;2011;04;22;Perjantai;9;7;16;2;1;3
96;08.04.2011;2011;04;23;Perjantai;9;5;14;0;1;1
96;09.04.2011;2011;04;00;Lauantai;9;5;14;1;0;1
96;09.04.2011;2011;04;01;Lauantai;8;4;12;2;0;2
96;09.04.2011;2011;04;02;Lauantai;8;3;11;2;3;5
96;09.04.2011;2011;04;03;Lauantai;7;0;7;3;0;3
96;09.04.2011;2011;04;04;Lauantai;3;2;5;2;2;4
96;09.04.2011;2011;04;05;Lauantai;0;2;2;1;0;1
96;09.04.2011;2011;04;06;Lauantai;11;5;16;3;0;3
96;09.04.2011;2011;04;07;Lauantai;5;20;25;0;4;4
96;09.04.2011;2011;04;08;Lauantai;13;20;33;6;5;11
96;09.04.2011;2011;04;09;Lauantai;10;29;39;2;9;11
96;09.04.2011;2011;04;10;Lauantai;15;33;48;5;9;14
96;09.04.2011;2011;04;11;Lauantai;26;70;96;11;13;24
96;09.04.2011;2011;04;12;Lauantai;52;52;104;11;21;32
96;09.04.2011;2011;04;13;Lauantai;56;42;98;9;15;24
96;09.04.2011;2011;04;14;Lauantai;45;53;98;15;18;33
96;09.04.2011;2011;04;15;Lauantai;62;42;104;14;9;23
96;09.04.2011;2011;04;16;Lauantai;71;48;119;16;15;31
96;09.04.2011;2011;04;17;Lauantai;51;20;71;15;8;23
96;09.04.2011;2011;04;18;Lauantai;30;17;47;10;7;17
96;09.04.2011;2011;04;19;Lauantai;21;21;42;10;13;23
96;09.04.2011;2011;04;20;Lauantai;20;17;37;10;4;14
96;09.04.2011;2011;04;21;Lauantai;11;16;27;2;9;11
96;09.04.2011;2011;04;22;Lauantai;6;8;14;0;3;3
96;09.04.2011;2011;04;23;Lauantai;8;7;15;1;3;4
96;10.04.2011;2011;04;00;Sunnuntai;5;5;10;5;1;6
96;10.04.2011;2011;04;01;Sunnuntai;7;2;9;0;0;0
96;10.04.2011;2011;04;02;Sunnuntai;5;1;6;6;0;6
96;10.04.2011;2011;04;03;Sunnuntai;10;0;10;4;0;4
96;10.04.2011;2011;04;04;Sunnuntai;6;1;7;3;1;4
96;10.04.2011;2011;04;05;Sunnuntai;3;0;3;0;0;0
96;10.04.2011;2011;04;06;Sunnuntai;13;7;20;4;2;6
96;10.04.2011;2011;04;07;Sunnuntai;4;11;15;2;5;7
96;10.04.2011;2011;04;08;Sunnuntai;6;13;19;9;3;12
96;10.04.2011;2011;04;09;Sunnuntai;7;17;24;10;12;22
96;10.04.2011;2011;04;10;Sunnuntai;13;29;42;11;7;18
96;10.04.2011;2011;04;11;Sunnuntai;16;39;55;12;16;28
96;10.04.2011;2011;04;12;Sunnuntai;35;69;104;24;24;48
96;10.04.2011;2011;04;13;Sunnuntai;79;44;123;19;13;32
96;10.04.2011;2011;04;14;Sunnuntai;71;50;121;14;19;33
96;10.04.2011;2011;04;15;Sunnuntai;57;40;97;18;15;33
96;10.04.2011;2011;04;16;Sunnuntai;52;51;103;20;14;34
96;10.04.2011;2011;04;17;Sunnuntai;43;33;76;9;13;22
96;10.04.2011;2011;04;18;Sunnuntai;48;25;73;15;13;28
96;10.04.2011;2011;04;19;Sunnuntai;28;31;59;18;13;31
96;10.04.2011;2011;04;20;Sunnuntai;24;10;34;10;6;16
96;10.04.2011;2011;04;21;Sunnuntai;23;17;40;6;6;12
96;10.04.2011;2011;04;22;Sunnuntai;1;3;4;3;0;3
96;10.04.2011;2011;04;23;Sunnuntai;1;2;3;1;2;3
96;11.04.2011;2011;04;00;Maanantai;0;1;1;1;0;1
96;11.04.2011;2011;04;01;Maanantai;2;0;2;1;0;1
96;11.04.2011;2011;04;02;Maanantai;0;0;0;0;0;0
96;11.04.2011;2011;04;03;Maanantai;2;0;2;0;0;0
96;11.04.2011;2011;04;04;Maanantai;1;2;3;0;0;0
96;11.04.2011;2011;04;05;Maanantai;6;8;14;0;0;0
96;11.04.2011;2011;04;06;Maanantai;53;28;81;6;2;8
96;11.04.2011;2011;04;07;Maanantai;122;111;233;18;6;24
96;11.04.2011;2011;04;08;Maanantai;89;109;198;19;11;30
96;11.04.2011;2011;04;09;Maanantai;48;67;115;19;12;31
96;11.04.2011;2011;04;10;Maanantai;40;52;92;10;8;18
96;11.04.2011;2011;04;11;Maanantai;39;61;100;6;5;11
96;11.04.2011;2011;04;12;Maanantai;72;47;119;9;11;20
96;11.04.2011;2011;04;13;Maanantai;67;64;131;12;16;28
96;11.04.2011;2011;04;14;Maanantai;62;83;145;6;16;22
96;11.04.2011;2011;04;15;Maanantai;86;176;262;6;33;39
96;11.04.2011;2011;04;16;Maanantai;107;144;251;12;34;46
96;11.04.2011;2011;04;17;Maanantai;86;58;144;32;19;51
96;11.04.2011;2011;04;18;Maanantai;55;43;98;22;26;48
96;11.04.2011;2011;04;19;Maanantai;74;30;104;23;16;39
96;11.04.2011;2011;04;20;Maanantai;51;34;85;16;18;34
96;11.04.2011;2011;04;21;Maanantai;25;21;46;6;11;17
96;11.04.2011;2011;04;22;Maanantai;14;3;17;2;1;3
96;11.04.2011;2011;04;23;Maanantai;3;5;8;3;5;8
96;12.04.2011;2011;04;00;Tiistai;0;0;0;0;0;0
96;12.04.2011;2011;04;01;Tiistai;1;0;1;0;0;0
96;12.04.2011;2011;04;02;Tiistai;3;0;3;0;0;0
96;12.04.2011;2011;04;03;Tiistai;1;0;1;0;0;0
96;12.04.2011;2011;04;04;Tiistai;2;4;6;0;0;0
96;12.04.2011;2011;04;05;Tiistai;4;9;13;0;0;0
96;12.04.2011;2011;04;06;Tiistai;59;33;92;9;4;13
96;12.04.2011;2011;04;07;Tiistai;128;121;249;18;9;27
96;12.04.2011;2011;04;08;Tiistai;102;102;204;15;11;26
96;12.04.2011;2011;04;09;Tiistai;36;65;101;12;11;23
96;12.04.2011;2011;04;10;Tiistai;34;79;113;7;17;24
96;12.04.2011;2011;04;11;Tiistai;66;57;123;9;16;25
96;12.04.2011;2011;04;12;Tiistai;60;50;110;14;17;31
96;12.04.2011;2011;04;13;Tiistai;53;66;119;10;13;23
96;12.04.2011;2011;04;14;Tiistai;81;88;169;9;10;19
96;12.04.2011;2011;04;15;Tiistai;108;182;290;10;28;38
96;12.04.2011;2011;04;16;Tiistai;115;132;247;19;32;51
96;12.04.2011;2011;04;17;Tiistai;70;66;136;21;15;36
96;12.04.2011;2011;04;18;Tiistai;54;36;90;29;17;46
96;12.04.2011;2011;04;19;Tiistai;52;29;81;16;22;38
96;12.04.2011;2011;04;20;Tiistai;40;22;62;15;18;33
96;12.04.2011;2011;04;21;Tiistai;27;19;46;9;11;20
96;12.04.2011;2011;04;22;Tiistai;12;8;20;1;2;3
96;12.04.2011;2011;04;23;Tiistai;4;3;7;0;0;0
96;13.04.2011;2011;04;00;Keskiviikko;3;1;4;1;0;1
96;13.04.2011;2011;04;01;Keskiviikko;4;0;4;0;0;0
96;13.04.2011;2011;04;02;Keskiviikko;1;0;1;0;0;0
96;13.04.2011;2011;04;03;Keskiviikko;0;0;0;0;0;0
96;13.04.2011;2011;04;04;Keskiviikko;1;4;5;0;0;0
96;13.04.2011;2011;04;05;Keskiviikko;4;7;11;0;0;0
96;13.04.2011;2011;04;06;Keskiviikko;50;33;83;8;4;12
96;13.04.2011;2011;04;07;Keskiviikko;117;117;234;29;8;37
96;13.04.2011;2011;04;08;Keskiviikko;87;119;206;13;3;16
96;13.04.2011;2011;04;09;Keskiviikko;51;69;120;8;7;15
96;13.04.2011;2011;04;10;Keskiviikko;45;49;94;4;9;13
96;13.04.2011;2011;04;11;Keskiviikko;53;47;100;9;11;20
96;13.04.2011;2011;04;12;Keskiviikko;58;55;113;9;17;26
96;13.04.2011;2011;04;13;Keskiviikko;60;67;127;1;6;7
96;13.04.2011;2011;04;14;Keskiviikko;66;83;149;2;14;16
96;13.04.2011;2011;04;15;Keskiviikko;82;159;241;10;45;55
96;13.04.2011;2011;04;16;Keskiviikko;92;112;204;16;18;34
96;13.04.2011;2011;04;17;Keskiviikko;57;49;106;13;14;27
96;13.04.2011;2011;04;18;Keskiviikko;51;27;78;7;17;24
96;13.04.2011;2011;04;19;Keskiviikko;49;31;80;14;8;22
96;13.04.2011;2011;04;20;Keskiviikko;47;18;65;20;16;36
96;13.04.2011;2011;04;21;Keskiviikko;36;14;50;11;6;17
96;13.04.2011;2011;04;22;Keskiviikko;6;4;10;1;1;2
96;13.04.2011;2011;04;23;Keskiviikko;3;2;5;2;1;3
96;14.04.2011;2011;04;00;Torstai;5;0;5;1;0;1
96;14.04.2011;2011;04;01;Torstai;2;0;2;1;1;2
96;14.04.2011;2011;04;02;Torstai;1;0;1;2;0;2
96;14.04.2011;2011;04;03;Torstai;6;0;6;0;0;0
96;14.04.2011;2011;04;04;Torstai;2;5;7;1;0;1
96;14.04.2011;2011;04;05;Torstai;3;11;14;0;0;0
96;14.04.2011;2011;04;06;Torstai;53;25;78;7;3;10
96;14.04.2011;2011;04;07;Torstai;128;107;235;26;9;35
96;14.04.2011;2011;04;08;Torstai;97;92;189;13;6;19
96;14.04.2011;2011;04;09;Torstai;52;64;116;14;7;21
96;14.04.2011;2011;04;10;Torstai;32;51;83;14;12;26
96;14.04.2011;2011;04;11;Torstai;32;62;94;6;9;15
96;14.04.2011;2011;04;12;Torstai;62;54;116;15;13;28
96;14.04.2011;2011;04;13;Torstai;68;49;117;11;10;21
96;14.04.2011;2011;04;14;Torstai;80;111;191;8;22;30
96;14.04.2011;2011;04;15;Torstai;86;219;305;12;36;48
96;14.04.2011;2011;04;16;Torstai;109;115;224;11;31;42
96;14.04.2011;2011;04;17;Torstai;83;80;163;16;22;38
96;14.04.2011;2011;04;18;Torstai;65;51;116;14;19;33
96;14.04.2011;2011;04;19;Torstai;56;29;85;14;11;25
96;14.04.2011;2011;04;20;Torstai;40;26;66;14;8;22
96;14.04.2011;2011;04;21;Torstai;30;24;54;9;10;19
96;14.04.2011;2011;04;22;Torstai;16;9;25;2;2;4
96;14.04.2011;2011;04;23;Torstai;8;10;18;0;2;2
96;15.04.2011;2011;04;00;Perjantai;4;0;4;0;0;0
96;15.04.2011;2011;04;01;Perjantai;5;1;6;0;0;0
96;15.04.2011;2011;04;02;Perjantai;5;1;6;0;0;0
96;15.04.2011;2011;04;03;Perjantai;7;0;7;0;1;1
96;15.04.2011;2011;04;04;Perjantai;1;5;6;0;0;0
96;15.04.2011;2011;04;05;Perjantai;3;8;11;0;1;1
96;15.04.2011;2011;04;06;Perjantai;57;30;87;5;4;9
96;15.04.2011;2011;04;07;Perjantai;123;96;219;22;6;28
96;15.04.2011;2011;04;08;Perjantai;83;104;187;19;12;31
96;15.04.2011;2011;04;09;Perjantai;39;66;105;8;27;35
96;15.04.2011;2011;04;10;Perjantai;46;61;107;6;9;15
96;15.04.2011;2011;04;11;Perjantai;56;75;131;16;16;32
96;15.04.2011;2011;04;12;Perjantai;50;96;146;9;12;21
96;15.04.2011;2011;04;13;Perjantai;85;87;172;6;16;22
96;15.04.2011;2011;04;14;Perjantai;84;132;216;10;20;30
96;15.04.2011;2011;04;15;Perjantai;96;158;254;8;20;28
96;15.04.2011;2011;04;16;Perjantai;103;84;187;8;17;25
96;15.04.2011;2011;04;17;Perjantai;79;51;130;9;8;17
96;15.04.2011;2011;04;18;Perjantai;49;42;91;16;9;25
96;15.04.2011;2011;04;19;Perjantai;38;18;56;9;9;18
96;15.04.2011;2011;04;20;Perjantai;42;19;61;5;10;15
96;15.04.2011;2011;04;21;Perjantai;20;17;37;3;4;7
96;15.04.2011;2011;04;22;Perjantai;18;8;26;3;5;8
96;15.04.2011;2011;04;23;Perjantai;12;4;16;2;2;4
96;16.04.2011;2011;04;00;Lauantai;7;1;8;1;0;1
96;16.04.2011;2011;04;01;Lauantai;6;0;6;2;0;2
96;16.04.2011;2011;04;02;Lauantai;6;0;6;2;0;2
96;16.04.2011;2011;04;03;Lauantai;11;0;11;4;0;4
96;16.04.2011;2011;04;04;Lauantai;8;2;10;4;0;4
96;16.04.2011;2011;04;05;Lauantai;3;3;6;2;2;4
96;16.04.2011;2011;04;06;Lauantai;14;8;22;3;1;4
96;16.04.2011;2011;04;07;Lauantai;1;15;16;3;4;7
96;16.04.2011;2011;04;08;Lauantai;8;19;27;4;13;17
96;16.04.2011;2011;04;09;Lauantai;18;54;72;4;7;11
96;16.04.2011;2011;04;10;Lauantai;23;67;90;7;25;32
96;16.04.2011;2011;04;11;Lauantai;45;69;114;11;42;53
96;16.04.2011;2011;04;12;Lauantai;54;60;114;27;31;58
96;16.04.2011;2011;04;13;Lauantai;62;66;128;37;26;63
96;16.04.2011;2011;04;14;Lauantai;83;60;143;27;19;46
96;16.04.2011;2011;04;15;Lauantai;91;50;141;24;20;44
96;16.04.2011;2011;04;16;Lauantai;59;47;106;17;13;30
96;16.04.2011;2011;04;17;Lauantai;53;29;82;30;7;37
96;16.04.2011;2011;04;18;Lauantai;47;29;76;11;15;26
96;16.04.2011;2011;04;19;Lauantai;24;28;52;9;8;17
96;16.04.2011;2011;04;20;Lauantai;30;16;46;4;3;7
96;16.04.2011;2011;04;21;Lauantai;18;18;36;0;5;5
96;16.04.2011;2011;04;22;Lauantai;24;13;37;3;4;7
96;16.04.2011;2011;04;23;Lauantai;13;12;25;1;0;1
96;17.04.2011;2011;04;00;Sunnuntai;4;5;9;1;0;1
96;17.04.2011;2011;04;01;Sunnuntai;14;5;19;1;0;1
96;17.04.2011;2011;04;02;Sunnuntai;12;4;16;4;2;6
96;17.04.2011;2011;04;03;Sunnuntai;9;1;10;3;0;3
96;17.04.2011;2011;04;04;Sunnuntai;11;0;11;3;1;4
96;17.04.2011;2011;04;05;Sunnuntai;2;1;3;1;0;1
96;17.04.2011;2011;04;06;Sunnuntai;10;8;18;6;0;6
96;17.04.2011;2011;04;07;Sunnuntai;8;16;24;1;5;6
96;17.04.2011;2011;04;08;Sunnuntai;9;11;20;7;6;13
96;17.04.2011;2011;04;09;Sunnuntai;13;12;25;8;5;13
96;17.04.2011;2011;04;10;Sunnuntai;14;28;42;7;18;25
96;17.04.2011;2011;04;11;Sunnuntai;20;64;84;8;22;30
96;17.04.2011;2011;04;12;Sunnuntai;50;33;83;16;20;36
96;17.04.2011;2011;04;13;Sunnuntai;54;43;97;19;25;44
96;17.04.2011;2011;04;14;Sunnuntai;41;47;88;25;19;44
96;17.04.2011;2011;04;15;Sunnuntai;45;33;78;14;13;27
96;17.04.2011;2011;04;16;Sunnuntai;36;37;73;14;12;26
96;17.04.2011;2011;04;17;Sunnuntai;50;34;84;17;14;31
96;17.04.2011;2011;04;18;Sunnuntai;38;35;73;11;7;18
96;17.04.2011;2011;04;19;Sunnuntai;15;11;26;11;10;21
96;17.04.2011;2011;04;20;Sunnuntai;23;9;32;7;7;14
96;17.04.2011;2011;04;21;Sunnuntai;20;7;27;4;6;10
96;17.04.2011;2011;04;22;Sunnuntai;3;10;13;2;1;3
96;17.04.2011;2011;04;23;Sunnuntai;4;3;7;2;1;3
96;18.04.2011;2011;04;00;Maanantai;4;3;7;1;0;1
96;18.04.2011;2011;04;01;Maanantai;1;1;2;0;1;1
96;18.04.2011;2011;04;02;Maanantai;1;0;1;0;0;0
96;18.04.2011;2011;04;03;Maanantai;1;0;1;0;0;0
96;18.04.2011;2011;04;04;Maanantai;1;3;4;0;0;0
96;18.04.2011;2011;04;05;Maanantai;6;8;14;1;0;1
96;18.04.2011;2011;04;06;Maanantai;47;32;79;2;1;3
96;18.04.2011;2011;04;07;Maanantai;115;116;231;17;8;25
96;18.04.2011;2011;04;08;Maanantai;98;105;203;12;11;23
96;18.04.2011;2011;04;09;Maanantai;63;74;137;14;12;26
96;18.04.2011;2011;04;10;Maanantai;49;69;118;9;14;23
96;18.04.2011;2011;04;11;Maanantai;65;62;127;10;6;16
96;18.04.2011;2011;04;12;Maanantai;65;63;128;5;8;13
96;18.04.2011;2011;04;13;Maanantai;78;58;136;9;6;15
96;18.04.2011;2011;04;14;Maanantai;81;77;158;12;8;20
96;18.04.2011;2011;04;15;Maanantai;88;186;274;7;32;39
96;18.04.2011;2011;04;16;Maanantai;113;135;248;10;24;34
96;18.04.2011;2011;04;17;Maanantai;72;66;138;6;20;26
96;18.04.2011;2011;04;18;Maanantai;50;50;100;24;12;36
96;18.04.2011;2011;04;19;Maanantai;71;52;123;18;19;37
96;18.04.2011;2011;04;20;Maanantai;65;32;97;15;12;27
96;18.04.2011;2011;04;21;Maanantai;45;20;65;14;7;21
96;18.04.2011;2011;04;22;Maanantai;11;8;19;4;2;6
96;18.04.2011;2011;04;23;Maanantai;2;4;6;0;0;0
96;19.04.2011;2011;04;00;Tiistai;1;0;1;1;0;1
96;19.04.2011;2011;04;01;Tiistai;1;0;1;0;1;1
96;19.04.2011;2011;04;02;Tiistai;3;0;3;0;0;0
96;19.04.2011;2011;04;03;Tiistai;1;2;3;0;0;0
96;19.04.2011;2011;04;04;Tiistai;2;6;8;0;0;0
96;19.04.2011;2011;04;05;Tiistai;5;6;11;0;0;0
96;19.04.2011;2011;04;06;Tiistai;48;36;84;9;2;11
96;19.04.2011;2011;04;07;Tiistai;120;117;237;15;8;23
96;19.04.2011;2011;04;08;Tiistai;110;100;210;17;14;31
96;19.04.2011;2011;04;09;Tiistai;70;79;149;19;10;29
96;19.04.2011;2011;04;10;Tiistai;48;72;120;12;7;19
96;19.04.2011;2011;04;11;Tiistai;56;60;116;14;8;22
96;19.04.2011;2011;04;12;Tiistai;68;64;132;8;9;17
96;19.04.2011;2011;04;13;Tiistai;67;69;136;6;10;16
96;19.04.2011;2011;04;14;Tiistai;73;103;176;5;13;18
96;19.04.2011;2011;04;15;Tiistai;114;180;294;7;36;43
96;19.04.2011;2011;04;16;Tiistai;114;130;244;12;24;36
96;19.04.2011;2011;04;17;Tiistai;87;50;137;15;11;26
96;19.04.2011;2011;04;18;Tiistai;75;58;133;19;18;37
96;19.04.2011;2011;04;19;Tiistai;70;51;121;15;24;39
96;19.04.2011;2011;04;20;Tiistai;59;30;89;11;10;21
96;19.04.2011;2011;04;21;Tiistai;31;24;55;11;12;23
96;19.04.2011;2011;04;22;Tiistai;20;7;27;2;3;5
96;19.04.2011;2011;04;23;Tiistai;7;1;8;0;4;4
96;20.04.2011;2011;04;00;Keskiviikko;6;1;7;1;1;2
96;20.04.2011;2011;04;01;Keskiviikko;2;1;3;0;0;0
96;20.04.2011;2011;04;02;Keskiviikko;3;0;3;0;0;0
96;20.04.2011;2011;04;03;Keskiviikko;1;0;1;0;0;0
96;20.04.2011;2011;04;04;Keskiviikko;2;4;6;1;0;1
96;20.04.2011;2011;04;05;Keskiviikko;7;10;17;0;1;1
96;20.04.2011;2011;04;06;Keskiviikko;50;34;84;5;2;7
96;20.04.2011;2011;04;07;Keskiviikko;112;101;213;16;6;22
96;20.04.2011;2011;04;08;Keskiviikko;69;88;157;15;9;24
96;20.04.2011;2011;04;09;Keskiviikko;43;85;128;12;12;24
96;20.04.2011;2011;04;10;Keskiviikko;58;40;98;5;6;11
96;20.04.2011;2011;04;11;Keskiviikko;46;38;84;6;8;14
96;20.04.2011;2011;04;12;Keskiviikko;49;50;99;7;8;15
96;20.04.2011;2011;04;13;Keskiviikko;43;49;92;9;5;14
96;20.04.2011;2011;04;14;Keskiviikko;74;92;166;8;11;19
96;20.04.2011;2011;04;15;Keskiviikko;89;162;251;6;19;25
96;20.04.2011;2011;04;16;Keskiviikko;84;110;194;8;19;27
96;20.04.2011;2011;04;17;Keskiviikko;65;45;110;13;20;33
96;20.04.2011;2011;04;18;Keskiviikko;53;39;92;18;12;30
96;20.04.2011;2011;04;19;Keskiviikko;56;28;84;10;16;26
96;20.04.2011;2011;04;20;Keskiviikko;49;17;66;11;14;25
96;20.04.2011;2011;04;21;Keskiviikko;16;13;29;9;9;18
96;20.04.2011;2011;04;22;Keskiviikko;12;10;22;2;0;2
96;20.04.2011;2011;04;23;Keskiviikko;6;2;8;1;1;2
96;21.04.2011;2011;04;00;Torstai;4;2;6;2;1;3
96;21.04.2011;2011;04;01;Torstai;6;1;7;0;0;0
96;21.04.2011;2011;04;02;Torstai;4;0;4;1;0;1
96;21.04.2011;2011;04;03;Torstai;4;0;4;1;0;1
96;21.04.2011;2011;04;04;Torstai;8;6;14;1;0;1
96;21.04.2011;2011;04;05;Torstai;3;5;8;1;0;1
96;21.04.2011;2011;04;06;Torstai;39;27;66;4;0;4
96;21.04.2011;2011;04;07;Torstai;96;100;196;14;9;23
96;21.04.2011;2011;04;08;Torstai;87;67;154;12;4;16
96;21.04.2011;2011;04;09;Torstai;44;55;99;4;3;7
96;21.04.2011;2011;04;10;Torstai;41;62;103;4;3;7
96;21.04.2011;2011;04;11;Torstai;51;67;118;7;3;10
96;21.04.2011;2011;04;12;Torstai;66;70;136;3;14;17
96;21.04.2011;2011;04;13;Torstai;73;83;156;14;16;30
96;21.04.2011;2011;04;14;Torstai;68;105;173;7;14;21
96;21.04.2011;2011;04;15;Torstai;86;138;224;8;20;28
96;21.04.2011;2011;04;16;Torstai;79;59;138;8;14;22
96;21.04.2011;2011;04;17;Torstai;67;30;97;7;10;17
96;21.04.2011;2011;04;18;Torstai;44;21;65;9;3;12
96;21.04.2011;2011;04;19;Torstai;26;30;56;4;5;9
96;21.04.2011;2011;04;20;Torstai;27;25;52;4;2;6
96;21.04.2011;2011;04;21;Torstai;24;29;53;0;7;7
96;21.04.2011;2011;04;22;Torstai;8;22;30;3;4;7
96;21.04.2011;2011;04;23;Torstai;5;2;7;2;1;3
96;22.04.2011;2011;04;00;Perjantai;3;3;6;1;0;1
96;22.04.2011;2011;04;01;Perjantai;12;0;12;0;0;0
96;22.04.2011;2011;04;02;Perjantai;12;1;13;0;0;0
96;22.04.2011;2011;04;03;Perjantai;7;0;7;3;0;3
96;22.04.2011;2011;04;04;Perjantai;9;2;11;2;0;2
96;22.04.2011;2011;04;05;Perjantai;4;0;4;0;0;0
96;22.04.2011;2011;04;06;Perjantai;17;3;20;3;0;3
96;22.04.2011;2011;04;07;Perjantai;2;8;10;2;2;4
96;22.04.2011;2011;04;08;Perjantai;4;6;10;4;10;14
96;22.04.2011;2011;04;09;Perjantai;9;6;15;3;4;7
96;22.04.2011;2011;04;10;Perjantai;11;9;20;7;9;16
96;22.04.2011;2011;04;11;Perjantai;21;30;51;8;10;18
96;22.04.2011;2011;04;12;Perjantai;34;36;70;14;15;29
96;22.04.2011;2011;04;13;Perjantai;38;48;86;8;15;23
96;22.04.2011;2011;04;14;Perjantai;31;50;81;12;16;28
96;22.04.2011;2011;04;15;Perjantai;37;25;62;13;12;25
96;22.04.2011;2011;04;16;Perjantai;26;35;61;8;8;16
96;22.04.2011;2011;04;17;Perjantai;21;27;48;7;6;13
96;22.04.2011;2011;04;18;Perjantai;17;26;43;3;5;8
96;22.04.2011;2011;04;19;Perjantai;22;14;36;6;8;14
96;22.04.2011;2011;04;20;Perjantai;12;16;28;9;4;13
96;22.04.2011;2011;04;21;Perjantai;13;23;36;5;6;11
96;22.04.2011;2011;04;22;Perjantai;11;12;23;1;3;4
96;22.04.2011;2011;04;23;Perjantai;6;10;16;0;0;0
96;23.04.2011;2011;04;00;Lauantai;17;2;19;0;0;0
96;23.04.2011;2011;04;01;Lauantai;5;3;8;1;0;1
96;23.04.2011;2011;04;02;Lauantai;7;0;7;0;0;0
96;23.04.2011;2011;04;03;Lauantai;7;0;7;1;0;1
96;23.04.2011;2011;04;04;Lauantai;4;0;4;5;0;5
96;23.04.2011;2011;04;05;Lauantai;1;1;2;0;0;0
96;23.04.2011;2011;04;06;Lauantai;12;3;15;3;2;5
96;23.04.2011;2011;04;07;Lauantai;2;9;11;0;1;1
96;23.04.2011;2011;04;08;Lauantai;13;21;34;4;4;8
96;23.04.2011;2011;04;09;Lauantai;16;35;51;4;8;12
96;23.04.2011;2011;04;10;Lauantai;22;70;92;2;8;10
96;23.04.2011;2011;04;11;Lauantai;34;70;104;2;8;10
96;23.04.2011;2011;04;12;Lauantai;55;55;110;15;9;24
96;23.04.2011;2011;04;13;Lauantai;61;77;138;5;7;12
96;23.04.2011;2011;04;14;Lauantai;54;81;135;7;6;13
96;23.04.2011;2011;04;15;Lauantai;49;56;105;6;12;18
96;23.04.2011;2011;04;16;Lauantai;63;41;104;9;12;21
96;23.04.2011;2011;04;17;Lauantai;44;24;68;7;6;13
96;23.04.2011;2011;04;18;Lauantai;25;30;55;8;7;15
96;23.04.2011;2011;04;19;Lauantai;20;23;43;5;5;10
96;23.04.2011;2011;04;20;Lauantai;20;15;35;6;5;11
96;23.04.2011;2011;04;21;Lauantai;14;21;35;4;6;10
96;23.04.2011;2011;04;22;Lauantai;18;6;24;2;4;6
96;23.04.2011;2011;04;23;Lauantai;5;9;14;3;0;3
96;24.04.2011;2011;04;00;Sunnuntai;7;5;12;3;0;3
96;24.04.2011;2011;04;01;Sunnuntai;6;2;8;0;0;0
96;24.04.2011;2011;04;02;Sunnuntai;13;0;13;0;0;0
96;24.04.2011;2011;04;03;Sunnuntai;8;0;8;1;0;1
96;24.04.2011;2011;04;04;Sunnuntai;6;0;6;0;1;1
96;24.04.2011;2011;04;05;Sunnuntai;4;0;4;1;0;1
96;24.04.2011;2011;04;06;Sunnuntai;13;4;17;4;0;4
96;24.04.2011;2011;04;07;Sunnuntai;4;13;17;3;3;6
96;24.04.2011;2011;04;08;Sunnuntai;12;4;16;1;1;2
96;24.04.2011;2011;04;09;Sunnuntai;12;11;23;5;5;10
96;24.04.2011;2011;04;10;Sunnuntai;11;16;27;3;6;9
96;24.04.2011;2011;04;11;Sunnuntai;26;25;51;5;5;10
96;24.04.2011;2011;04;12;Sunnuntai;33;43;76;6;11;17
96;24.04.2011;2011;04;13;Sunnuntai;34;52;86;7;16;23
96;24.04.2011;2011;04;14;Sunnuntai;47;50;97;13;16;29
96;24.04.2011;2011;04;15;Sunnuntai;44;43;87;5;18;23
96;24.04.2011;2011;04;16;Sunnuntai;48;30;78;5;13;18
96;24.04.2011;2011;04;17;Sunnuntai;37;41;78;11;6;17
96;24.04.2011;2011;04;18;Sunnuntai;32;34;66;7;9;16
96;24.04.2011;2011;04;19;Sunnuntai;30;27;57;10;7;17
96;24.04.2011;2011;04;20;Sunnuntai;25;19;44;6;4;10
96;24.04.2011;2011;04;21;Sunnuntai;15;18;33;4;3;7
96;24.04.2011;2011;04;22;Sunnuntai;20;5;25;1;2;3
96;24.04.2011;2011;04;23;Sunnuntai;8;7;15;0;0;0
96;25.04.2011;2011;04;00;Maanantai;2;4;6;0;0;0
96;25.04.2011;2011;04;01;Maanantai;4;3;7;1;0;1
96;25.04.2011;2011;04;02;Maanantai;7;0;7;0;0;0
96;25.04.2011;2011;04;03;Maanantai;2;0;2;0;0;0
96;25.04.2011;2011;04;04;Maanantai;2;1;3;3;1;4
96;25.04.2011;2011;04;05;Maanantai;3;1;4;2;0;2
96;25.04.2011;2011;04;06;Maanantai;14;7;21;5;4;9
96;25.04.2011;2011;04;07;Maanantai;3;15;18;2;3;5
96;25.04.2011;2011;04;08;Maanantai;10;9;19;1;3;4
96;25.04.2011;2011;04;09;Maanantai;12;17;29;7;6;13
96;25.04.2011;2011;04;10;Maanantai;14;45;59;5;12;17
96;25.04.2011;2011;04;11;Maanantai;28;35;63;8;5;13
96;25.04.2011;2011;04;12;Maanantai;55;64;119;5;10;15
96;25.04.2011;2011;04;13;Maanantai;67;62;129;8;3;11
96;25.04.2011;2011;04;14;Maanantai;50;67;117;11;15;26
96;25.04.2011;2011;04;15;Maanantai;38;56;94;12;12;24
96;25.04.2011;2011;04;16;Maanantai;49;52;101;8;11;19
96;25.04.2011;2011;04;17;Maanantai;46;57;103;8;11;19
96;25.04.2011;2011;04;18;Maanantai;32;28;60;10;10;20
96;25.04.2011;2011;04;19;Maanantai;34;25;59;7;13;20
96;25.04.2011;2011;04;20;Maanantai;28;27;55;7;6;13
96;25.04.2011;2011;04;21;Maanantai;23;19;42;6;4;10
96;25.04.2011;2011;04;22;Maanantai;10;5;15;1;1;2
96;25.04.2011;2011;04;23;Maanantai;2;3;5;3;0;3
96;26.04.2011;2011;04;00;Tiistai;3;0;3;0;0;0
96;26.04.2011;2011;04;01;Tiistai;2;1;3;0;0;0
96;26.04.2011;2011;04;02;Tiistai;1;0;1;0;0;0
96;26.04.2011;2011;04;03;Tiistai;1;0;1;0;0;0
96;26.04.2011;2011;04;04;Tiistai;3;3;6;1;0;1
96;26.04.2011;2011;04;05;Tiistai;6;15;21;0;0;0
96;26.04.2011;2011;04;06;Tiistai;44;35;79;5;5;10
96;26.04.2011;2011;04;07;Tiistai;111;156;267;17;14;31
96;26.04.2011;2011;04;08;Tiistai;105;130;235;10;21;31
96;26.04.2011;2011;04;09;Tiistai;79;79;158;6;5;11
96;26.04.2011;2011;04;10;Tiistai;58;59;117;8;10;18
96;26.04.2011;2011;04;11;Tiistai;45;67;112;9;8;17
96;26.04.2011;2011;04;12;Tiistai;55;60;115;5;11;16
96;26.04.2011;2011;04;13;Tiistai;75;63;138;11;4;15
96;26.04.2011;2011;04;14;Tiistai;75;99;174;8;16;24
96;26.04.2011;2011;04;15;Tiistai;100;166;266;10;18;28
96;26.04.2011;2011;04;16;Tiistai;158;126;284;13;21;34
96;26.04.2011;2011;04;17;Tiistai;75;62;137;5;11;16
96;26.04.2011;2011;04;18;Tiistai;68;48;116;13;12;25
96;26.04.2011;2011;04;19;Tiistai;76;58;134;15;13;28
96;26.04.2011;2011;04;20;Tiistai;68;25;93;16;15;31
96;26.04.2011;2011;04;21;Tiistai;46;28;74;7;9;16
96;26.04.2011;2011;04;22;Tiistai;8;16;24;0;5;5
96;26.04.2011;2011;04;23;Tiistai;10;5;15;1;0;1
96;27.04.2011;2011;04;00;Keskiviikko;7;3;10;1;1;2
96;27.04.2011;2011;04;01;Keskiviikko;0;0;0;2;1;3
96;27.04.2011;2011;04;02;Keskiviikko;3;0;3;0;0;0
96;27.04.2011;2011;04;03;Keskiviikko;3;0;3;0;0;0
96;27.04.2011;2011;04;04;Keskiviikko;1;3;4;1;0;1
96;27.04.2011;2011;04;05;Keskiviikko;8;8;16;0;0;0
96;27.04.2011;2011;04;06;Keskiviikko;55;34;89;4;3;7
96;27.04.2011;2011;04;07;Keskiviikko;122;158;280;22;13;35
96;27.04.2011;2011;04;08;Keskiviikko;100;117;217;9;8;17
96;27.04.2011;2011;04;09;Keskiviikko;62;76;138;12;6;18
96;27.04.2011;2011;04;10;Keskiviikko;42;70;112;7;12;19
96;27.04.2011;2011;04;11;Keskiviikko;69;70;139;11;5;16
96;27.04.2011;2011;04;12;Keskiviikko;60;83;143;10;4;14
96;27.04.2011;2011;04;13;Keskiviikko;92;78;170;5;10;15
96;27.04.2011;2011;04;14;Keskiviikko;84;126;210;9;11;20
96;27.04.2011;2011;04;15;Keskiviikko;142;190;332;11;32;43
96;27.04.2011;2011;04;16;Keskiviikko;131;116;247;9;20;29
96;27.04.2011;2011;04;17;Keskiviikko;107;85;192;16;8;24
96;27.04.2011;2011;04;18;Keskiviikko;115;73;188;35;14;49
96;27.04.2011;2011;04;19;Keskiviikko;76;55;131;14;9;23
96;27.04.2011;2011;04;20;Keskiviikko;72;29;101;17;18;35
96;27.04.2011;2011;04;21;Keskiviikko;43;41;84;4;12;16
96;27.04.2011;2011;04;22;Keskiviikko;9;7;16;2;9;11
96;27.04.2011;2011;04;23;Keskiviikko;7;3;10;0;4;4
96;28.04.2011;2011;04;00;Torstai;6;2;8;0;2;2
96;28.04.2011;2011;04;01;Torstai;2;0;2;2;1;3
96;28.04.2011;2011;04;02;Torstai;5;0;5;2;2;4
96;28.04.2011;2011;04;03;Torstai;5;0;5;0;0;0
96;28.04.2011;2011;04;04;Torstai;4;3;7;0;0;0
96;28.04.2011;2011;04;05;Torstai;6;5;11;0;0;0
96;28.04.2011;2011;04;06;Torstai;53;31;84;6;4;10
96;28.04.2011;2011;04;07;Torstai;111;137;248;16;8;24
96;28.04.2011;2011;04;08;Torstai;95;117;212;13;2;15
96;28.04.2011;2011;04;09;Torstai;42;111;153;10;5;15
96;28.04.2011;2011;04;10;Torstai;36;60;96;7;9;16
96;28.04.2011;2011;04;11;Torstai;59;80;139;7;7;14
96;28.04.2011;2011;04;12;Torstai;76;80;156;7;11;18
96;28.04.2011;2011;04;13;Torstai;82;77;159;7;7;14
96;28.04.2011;2011;04;14;Torstai;79;116;195;9;14;23
96;28.04.2011;2011;04;15;Torstai;120;195;315;8;28;36
96;28.04.2011;2011;04;16;Torstai;136;135;271;8;13;21
96;28.04.2011;2011;04;17;Torstai;93;63;156;8;15;23
96;28.04.2011;2011;04;18;Torstai;87;41;128;15;14;29
96;28.04.2011;2011;04;19;Torstai;60;39;99;12;16;28
96;28.04.2011;2011;04;20;Torstai;57;35;92;7;10;17
96;28.04.2011;2011;04;21;Torstai;19;28;47;11;15;26
96;28.04.2011;2011;04;22;Torstai;13;9;22;2;3;5
96;28.04.2011;2011;04;23;Torstai;4;10;14;2;0;2
96;29.04.2011;2011;04;00;Perjantai;8;0;8;2;1;3
96;29.04.2011;2011;04;01;Perjantai;6;0;6;1;1;2
96;29.04.2011;2011;04;02;Perjantai;8;0;8;2;1;3
96;29.04.2011;2011;04;03;Perjantai;9;0;9;0;0;0
96;29.04.2011;2011;04;04;Perjantai;10;4;14;1;0;1
96;29.04.2011;2011;04;05;Perjantai;7;12;19;0;0;0
96;29.04.2011;2011;04;06;Perjantai;52;31;83;6;0;6
96;29.04.2011;2011;04;07;Perjantai;103;112;215;18;6;24
96;29.04.2011;2011;04;08;Perjantai;87;107;194;8;13;21
96;29.04.2011;2011;04;09;Perjantai;41;104;145;6;14;20
96;29.04.2011;2011;04;10;Perjantai;50;69;119;7;10;17
96;29.04.2011;2011;04;11;Perjantai;73;68;141;2;11;13
96;29.04.2011;2011;04;12;Perjantai;55;83;138;4;7;11
96;29.04.2011;2011;04;13;Perjantai;78;98;176;4;9;13
96;29.04.2011;2011;04;14;Perjantai;97;114;211;7;16;23
96;29.04.2011;2011;04;15;Perjantai;121;145;266;9;19;28
96;29.04.2011;2011;04;16;Perjantai;79;90;169;7;10;17
96;29.04.2011;2011;04;17;Perjantai;76;46;122;12;8;20
96;29.04.2011;2011;04;18;Perjantai;56;43;99;9;10;19
96;29.04.2011;2011;04;19;Perjantai;49;34;83;9;7;16
96;29.04.2011;2011;04;20;Perjantai;47;33;80;12;11;23
96;29.04.2011;2011;04;21;Perjantai;30;34;64;6;18;24
96;29.04.2011;2011;04;22;Perjantai;12;13;25;1;2;3
96;29.04.2011;2011;04;23;Perjantai;19;21;40;2;5;7
96;30.04.2011;2011;04;00;Lauantai;8;8;16;3;2;5
96;30.04.2011;2011;04;01;Lauantai;28;4;32;5;0;5
96;30.04.2011;2011;04;02;Lauantai;12;1;13;1;0;1
96;30.04.2011;2011;04;03;Lauantai;18;5;23;5;2;7
96;30.04.2011;2011;04;04;Lauantai;15;1;16;4;1;5
96;30.04.2011;2011;04;05;Lauantai;5;1;6;2;0;2
96;30.04.2011;2011;04;06;Lauantai;14;10;24;1;0;1
96;30.04.2011;2011;04;07;Lauantai;2;12;14;4;2;6
96;30.04.2011;2011;04;08;Lauantai;7;23;30;5;7;12
96;30.04.2011;2011;04;09;Lauantai;16;41;57;6;9;15
96;30.04.2011;2011;04;10;Lauantai;21;41;62;2;10;12
96;30.04.2011;2011;04;11;Lauantai;38;68;106;3;6;9
96;30.04.2011;2011;04;12;Lauantai;48;80;128;6;10;16
96;30.04.2011;2011;04;13;Lauantai;59;59;118;11;8;19
96;30.04.2011;2011;04;14;Lauantai;47;78;125;7;10;17
96;30.04.2011;2011;04;15;Lauantai;50;56;106;3;4;7
96;30.04.2011;2011;04;16;Lauantai;47;55;102;11;6;17
96;30.04.2011;2011;04;17;Lauantai;84;44;128;24;5;29
96;30.04.2011;2011;04;18;Lauantai;45;34;79;10;2;12
96;30.04.2011;2011;04;19;Lauantai;24;43;67;7;14;21
96;30.04.2011;2011;04;20;Lauantai;34;44;78;9;14;23
96;30.04.2011;2011;04;21;Lauantai;16;40;56;3;20;23
96;30.04.2011;2011;04;22;Lauantai;26;49;75;7;11;18
96;30.04.2011;2011;04;23;Lauantai;37;14;51;2;7;9
96;01.05.2011;2011;05;00;Sunnuntai;51;11;62;3;0;3
96;01.05.2011;2011;05;01;Sunnuntai;30;2;32;3;0;3
96;01.05.2011;2011;05;02;Sunnuntai;48;8;56;8;0;8
96;01.05.2011;2011;05;03;Sunnuntai;47;7;54;6;0;6
96;01.05.2011;2011;05;04;Sunnuntai;32;0;32;6;0;6
96;01.05.2011;2011;05;05;Sunnuntai;9;0;9;0;1;1
96;01.05.2011;2011;05;06;Sunnuntai;16;4;20;1;0;1
96;01.05.2011;2011;05;07;Sunnuntai;7;15;22;3;1;4
96;01.05.2011;2011;05;08;Sunnuntai;9;10;19;4;1;5
96;01.05.2011;2011;05;09;Sunnuntai;7;29;36;11;5;16
96;01.05.2011;2011;05;10;Sunnuntai;19;53;72;8;19;27
96;01.05.2011;2011;05;11;Sunnuntai;28;54;82;5;1;6
96;01.05.2011;2011;05;12;Sunnuntai;43;65;108;14;12;26
96;01.05.2011;2011;05;13;Sunnuntai;61;54;115;9;10;19
96;01.05.2011;2011;05;14;Sunnuntai;54;44;98;7;7;14
96;01.05.2011;2011;05;15;Sunnuntai;42;34;76;4;7;11
96;01.05.2011;2011;05;16;Sunnuntai;51;36;87;13;15;28
96;01.05.2011;2011;05;17;Sunnuntai;55;16;71;22;5;27
96;01.05.2011;2011;05;18;Sunnuntai;35;25;60;11;6;17
96;01.05.2011;2011;05;19;Sunnuntai;38;40;78;6;13;19
96;01.05.2011;2011;05;20;Sunnuntai;25;24;49;8;7;15
96;01.05.2011;2011;05;21;Sunnuntai;26;40;66;1;17;18
96;01.05.2011;2011;05;22;Sunnuntai;8;10;18;3;1;4
96;01.05.2011;2011;05;23;Sunnuntai;5;7;12;3;1;4
96;02.05.2011;2011;05;00;Maanantai;2;2;4;1;1;2
96;02.05.2011;2011;05;01;Maanantai;0;0;0;0;0;0
96;02.05.2011;2011;05;02;Maanantai;2;0;2;0;0;0
96;02.05.2011;2011;05;03;Maanantai;2;0;2;0;0;0
96;02.05.2011;2011;05;04;Maanantai;1;6;7;0;0;0
96;02.05.2011;2011;05;05;Maanantai;4;7;11;0;0;0
96;02.05.2011;2011;05;06;Maanantai;48;39;87;4;5;9
96;02.05.2011;2011;05;07;Maanantai;128;148;276;19;7;26
96;02.05.2011;2011;05;08;Maanantai;106;124;230;8;7;15
96;02.05.2011;2011;05;09;Maanantai;56;83;139;17;13;30
96;02.05.2011;2011;05;10;Maanantai;43;75;118;5;8;13
96;02.05.2011;2011;05;11;Maanantai;70;78;148;13;7;20
96;02.05.2011;2011;05;12;Maanantai;61;51;112;11;11;22
96;02.05.2011;2011;05;13;Maanantai;70;80;150;9;4;13
96;02.05.2011;2011;05;14;Maanantai;89;116;205;9;9;18
96;02.05.2011;2011;05;15;Maanantai;124;185;309;9;23;32
96;02.05.2011;2011;05;16;Maanantai;147;161;308;14;20;34
96;02.05.2011;2011;05;17;Maanantai;82;71;153;8;13;21
96;02.05.2011;2011;05;18;Maanantai;65;45;110;15;14;29
96;02.05.2011;2011;05;19;Maanantai;62;35;97;11;10;21
96;02.05.2011;2011;05;20;Maanantai;57;21;78;11;14;25
96;02.05.2011;2011;05;21;Maanantai;27;32;59;2;7;9
96;02.05.2011;2011;05;22;Maanantai;9;9;18;3;3;6
96;02.05.2011;2011;05;23;Maanantai;5;1;6;1;3;4
96;03.05.2011;2011;05;00;Tiistai;2;1;3;2;1;3
96;03.05.2011;2011;05;01;Tiistai;2;0;2;0;1;1
96;03.05.2011;2011;05;02;Tiistai;6;1;7;1;0;1
96;03.05.2011;2011;05;03;Tiistai;1;0;1;0;0;0
96;03.05.2011;2011;05;04;Tiistai;1;3;4;0;0;0
96;03.05.2011;2011;05;05;Tiistai;6;6;12;0;0;0
96;03.05.2011;2011;05;06;Tiistai;55;36;91;7;6;13
96;03.05.2011;2011;05;07;Tiistai;140;166;306;15;7;22
96;03.05.2011;2011;05;08;Tiistai;96;112;208;14;9;23
96;03.05.2011;2011;05;09;Tiistai;68;78;146;7;10;17
96;03.05.2011;2011;05;10;Tiistai;33;66;99;5;20;25
96;03.05.2011;2011;05;11;Tiistai;69;71;140;6;6;12
96;03.05.2011;2011;05;12;Tiistai;66;58;124;8;8;16
96;03.05.2011;2011;05;13;Tiistai;58;59;117;8;11;19
96;03.05.2011;2011;05;14;Tiistai;79;112;191;7;15;22
96;03.05.2011;2011;05;15;Tiistai;107;148;255;7;28;35
96;03.05.2011;2011;05;16;Tiistai;141;140;281;14;29;43
96;03.05.2011;2011;05;17;Tiistai;85;75;160;16;16;32
96;03.05.2011;2011;05;18;Tiistai;77;49;126;12;27;39
96;03.05.2011;2011;05;19;Tiistai;61;43;104;6;13;19
96;03.05.2011;2011;05;20;Tiistai;60;25;85;9;3;12
96;03.05.2011;2011;05;21;Tiistai;42;28;70;3;4;7
96;03.05.2011;2011;05;22;Tiistai;22;9;31;2;4;6
96;03.05.2011;2011;05;23;Tiistai;9;4;13;0;0;0
96;04.05.2011;2011;05;00;Keskiviikko;1;1;2;2;3;5
96;04.05.2011;2011;05;01;Keskiviikko;0;0;0;0;1;1
96;04.05.2011;2011;05;02;Keskiviikko;1;0;1;0;0;0
96;04.05.2011;2011;05;03;Keskiviikko;0;0;0;0;0;0
96;04.05.2011;2011;05;04;Keskiviikko;1;3;4;0;0;0
96;04.05.2011;2011;05;05;Keskiviikko;7;10;17;0;0;0
96;04.05.2011;2011;05;06;Keskiviikko;53;48;101;9;2;11
96;04.05.2011;2011;05;07;Keskiviikko;134;162;296;16;12;28
96;04.05.2011;2011;05;08;Keskiviikko;101;121;222;8;8;16
96;04.05.2011;2011;05;09;Keskiviikko;63;91;154;15;11;26
96;04.05.2011;2011;05;10;Keskiviikko;51;70;121;8;7;15
96;04.05.2011;2011;05;11;Keskiviikko;50;57;107;3;9;12
96;04.05.2011;2011;05;12;Keskiviikko;72;86;158;6;8;14
96;04.05.2011;2011;05;13;Keskiviikko;65;69;134;10;8;18
96;04.05.2011;2011;05;14;Keskiviikko;83;108;191;9;9;18
96;04.05.2011;2011;05;15;Keskiviikko;128;175;303;9;21;30
96;04.05.2011;2011;05;16;Keskiviikko;159;157;316;15;37;52
96;04.05.2011;2011;05;17;Keskiviikko;85;83;168;20;26;46
96;04.05.2011;2011;05;18;Keskiviikko;127;50;177;23;29;52
96;04.05.2011;2011;05;19;Keskiviikko;77;45;122;19;11;30
96;04.05.2011;2011;05;20;Keskiviikko;82;45;127;17;13;30
96;04.05.2011;2011;05;21;Keskiviikko;36;40;76;3;5;8
96;04.05.2011;2011;05;22;Keskiviikko;12;11;23;2;2;4
96;04.05.2011;2011;05;23;Keskiviikko;11;3;14;1;0;1
96;05.05.2011;2011;05;00;Torstai;4;3;7;0;0;0
96;05.05.2011;2011;05;01;Torstai;3;0;3;0;0;0
96;05.05.2011;2011;05;02;Torstai;0;1;1;0;0;0
96;05.05.2011;2011;05;03;Torstai;0;0;0;0;0;0
96;05.05.2011;2011;05;04;Torstai;2;4;6;2;0;2
96;05.05.2011;2011;05;05;Torstai;9;9;18;0;0;0
96;05.05.2011;2011;05;06;Torstai;53;44;97;4;2;6
96;05.05.2011;2011;05;07;Torstai;123;154;277;20;8;28
96;05.05.2011;2011;05;08;Torstai;108;131;239;4;3;7
96;05.05.2011;2011;05;09;Torstai;49;113;162;7;7;14
96;05.05.2011;2011;05;10;Torstai;47;53;100;4;10;14
96;05.05.2011;2011;05;11;Torstai;65;71;136;3;2;5
96;05.05.2011;2011;05;12;Torstai;77;79;156;8;10;18
96;05.05.2011;2011;05;13;Torstai;71;60;131;8;10;18
96;05.05.2011;2011;05;14;Torstai;73;104;177;7;15;22
96;05.05.2011;2011;05;15;Torstai;93;217;310;5;28;33
96;05.05.2011;2011;05;16;Torstai;139;156;295;10;18;28
96;05.05.2011;2011;05;17;Torstai;97;65;162;30;42;72
96;05.05.2011;2011;05;18;Torstai;73;69;142;19;15;34
96;05.05.2011;2011;05;19;Torstai;70;30;100;10;16;26
96;05.05.2011;2011;05;20;Torstai;46;33;79;14;7;21
96;05.05.2011;2011;05;21;Torstai;34;24;58;6;8;14
96;05.05.2011;2011;05;22;Torstai;15;7;22;2;2;4
96;05.05.2011;2011;05;23;Torstai;4;0;4;4;2;6
96;06.05.2011;2011;05;00;Perjantai;3;1;4;1;0;1
96;06.05.2011;2011;05;01;Perjantai;3;0;3;0;0;0
96;06.05.2011;2011;05;02;Perjantai;3;0;3;0;0;0
96;06.05.2011;2011;05;03;Perjantai;1;1;2;0;0;0
96;06.05.2011;2011;05;04;Perjantai;1;4;5;0;0;0
96;06.05.2011;2011;05;05;Perjantai;6;7;13;0;0;0
96;06.05.2011;2011;05;06;Perjantai;51;48;99;4;2;6
96;06.05.2011;2011;05;07;Perjantai;117;116;233;13;15;28
96;06.05.2011;2011;05;08;Perjantai;89;126;215;13;11;24
96;06.05.2011;2011;05;09;Perjantai;44;106;150;6;9;15
96;06.05.2011;2011;05;10;Perjantai;52;67;119;13;9;22
96;06.05.2011;2011;05;11;Perjantai;61;87;148;11;10;21
96;06.05.2011;2011;05;12;Perjantai;54;80;134;3;12;15
96;06.05.2011;2011;05;13;Perjantai;89;97;186;6;14;20
96;06.05.2011;2011;05;14;Perjantai;96;132;228;11;14;25
96;06.05.2011;2011;05;15;Perjantai;128;171;299;9;18;27
96;06.05.2011;2011;05;16;Perjantai;103;91;194;10;11;21
96;06.05.2011;2011;05;17;Perjantai;88;43;131;11;10;21
96;06.05.2011;2011;05;18;Perjantai;50;45;95;21;6;27
96;06.05.2011;2011;05;19;Perjantai;41;32;73;7;7;14
96;06.05.2011;2011;05;20;Perjantai;57;34;91;13;7;20
96;06.05.2011;2011;05;21;Perjantai;42;24;66;5;3;8
96;06.05.2011;2011;05;22;Perjantai;10;19;29;2;2;4
96;06.05.2011;2011;05;23;Perjantai;18;7;25;0;0;0
96;07.05.2011;2011;05;00;Lauantai;15;8;23;2;0;2
96;07.05.2011;2011;05;01;Lauantai;7;3;10;1;1;2
96;07.05.2011;2011;05;02;Lauantai;12;1;13;1;0;1
96;07.05.2011;2011;05;03;Lauantai;12;0;12;1;0;1
96;07.05.2011;2011;05;04;Lauantai;12;0;12;1;0;1
96;07.05.2011;2011;05;05;Lauantai;1;2;3;0;0;0
96;07.05.2011;2011;05;06;Lauantai;22;11;33;1;1;2
96;07.05.2011;2011;05;07;Lauantai;10;19;29;1;3;4
96;07.05.2011;2011;05;08;Lauantai;6;16;22;2;4;6
96;07.05.2011;2011;05;09;Lauantai;13;27;40;4;9;13
96;07.05.2011;2011;05;10;Lauantai;28;40;68;3;5;8
96;07.05.2011;2011;05;11;Lauantai;21;61;82;7;5;12
96;07.05.2011;2011;05;12;Lauantai;52;61;113;5;8;13
96;07.05.2011;2011;05;13;Lauantai;77;57;134;7;3;10
96;07.05.2011;2011;05;14;Lauantai;59;53;112;14;8;22
96;07.05.2011;2011;05;15;Lauantai;62;56;118;8;9;17
96;07.05.2011;2011;05;16;Lauantai;47;33;80;6;7;13
96;07.05.2011;2011;05;17;Lauantai;62;30;92;13;14;27
96;07.05.2011;2011;05;18;Lauantai;47;35;82;11;5;16
96;07.05.2011;2011;05;19;Lauantai;29;45;74;9;11;20
96;07.05.2011;2011;05;20;Lauantai;33;26;59;9;12;21
96;07.05.2011;2011;05;21;Lauantai;13;29;42;1;6;7
96;07.05.2011;2011;05;22;Lauantai;8;9;17;2;3;5
96;07.05.2011;2011;05;23;Lauantai;18;2;20;1;0;1
96;08.05.2011;2011;05;00;Sunnuntai;12;9;21;3;2;5
96;08.05.2011;2011;05;01;Sunnuntai;8;1;9;1;0;1
96;08.05.2011;2011;05;02;Sunnuntai;11;1;12;1;0;1
96;08.05.2011;2011;05;03;Sunnuntai;9;0;9;1;0;1
96;08.05.2011;2011;05;04;Sunnuntai;5;0;5;1;0;1
96;08.05.2011;2011;05;05;Sunnuntai;1;1;2;0;0;0
96;08.05.2011;2011;05;06;Sunnuntai;12;5;17;2;1;3
96;08.05.2011;2011;05;07;Sunnuntai;7;15;22;3;7;10
96;08.05.2011;2011;05;08;Sunnuntai;12;10;22;4;5;9
96;08.05.2011;2011;05;09;Sunnuntai;22;30;52;7;7;14
96;08.05.2011;2011;05;10;Sunnuntai;20;43;63;15;7;22
96;08.05.2011;2011;05;11;Sunnuntai;47;41;88;4;5;9
96;08.05.2011;2011;05;12;Sunnuntai;46;54;100;10;8;18
96;08.05.2011;2011;05;13;Sunnuntai;46;67;113;3;7;10
96;08.05.2011;2011;05;14;Sunnuntai;64;50;114;8;8;16
96;08.05.2011;2011;05;15;Sunnuntai;55;49;104;7;10;17
96;08.05.2011;2011;05;16;Sunnuntai;69;40;109;14;10;24
96;08.05.2011;2011;05;17;Sunnuntai;45;40;85;7;8;15
96;08.05.2011;2011;05;18;Sunnuntai;63;59;122;9;8;17
96;08.05.2011;2011;05;19;Sunnuntai;35;52;87;11;16;27
96;08.05.2011;2011;05;20;Sunnuntai;33;32;65;15;19;34
96;08.05.2011;2011;05;21;Sunnuntai;19;23;42;4;13;17
96;08.05.2011;2011;05;22;Sunnuntai;7;12;19;3;3;6
96;08.05.2011;2011;05;23;Sunnuntai;4;4;8;2;2;4
96;09.05.2011;2011;05;00;Maanantai;1;3;4;0;0;0
96;09.05.2011;2011;05;01;Maanantai;2;0;2;0;0;0
96;09.05.2011;2011;05;02;Maanantai;2;0;2;0;0;0
96;09.05.2011;2011;05;03;Maanantai;2;0;2;0;0;0
96;09.05.2011;2011;05;04;Maanantai;3;3;6;0;0;0
96;09.05.2011;2011;05;05;Maanantai;4;10;14;0;0;0
96;09.05.2011;2011;05;06;Maanantai;49;44;93;4;1;5
96;09.05.2011;2011;05;07;Maanantai;127;159;286;13;10;23
96;09.05.2011;2011;05;08;Maanantai;114;139;253;15;6;21
96;09.05.2011;2011;05;09;Maanantai;46;100;146;7;6;13
96;09.05.2011;2011;05;10;Maanantai;66;72;138;6;5;11
96;09.05.2011;2011;05;11;Maanantai;76;107;183;12;12;24
96;09.05.2011;2011;05;12;Maanantai;80;76;156;10;14;24
96;09.05.2011;2011;05;13;Maanantai;87;90;177;4;13;17
96;09.05.2011;2011;05;14;Maanantai;114;124;238;10;13;23
96;09.05.2011;2011;05;15;Maanantai;124;203;327;4;15;19
96;09.05.2011;2011;05;16;Maanantai;170;166;336;14;19;33
96;09.05.2011;2011;05;17;Maanantai;91;69;160;11;19;30
96;09.05.2011;2011;05;18;Maanantai;91;37;128;13;6;19
96;09.05.2011;2011;05;19;Maanantai;63;32;95;10;9;19
96;09.05.2011;2011;05;20;Maanantai;60;30;90;15;10;25
96;09.05.2011;2011;05;21;Maanantai;40;48;88;3;8;11
96;09.05.2011;2011;05;22;Maanantai;9;10;19;0;3;3
96;09.05.2011;2011;05;23;Maanantai;12;5;17;1;1;2
96;10.05.2011;2011;05;00;Tiistai;2;1;3;0;0;0
96;10.05.2011;2011;05;01;Tiistai;1;0;1;0;0;0
96;10.05.2011;2011;05;02;Tiistai;1;0;1;0;0;0
96;10.05.2011;2011;05;03;Tiistai;1;0;1;0;0;0
96;10.05.2011;2011;05;04;Tiistai;2;4;6;0;0;0
96;10.05.2011;2011;05;05;Tiistai;7;8;15;0;0;0
96;10.05.2011;2011;05;06;Tiistai;67;50;117;4;4;8
96;10.05.2011;2011;05;07;Tiistai;134;188;322;15;11;26
96;10.05.2011;2011;05;08;Tiistai;79;146;225;16;12;28
96;10.05.2011;2011;05;09;Tiistai;68;101;169;7;3;10
96;10.05.2011;2011;05;10;Tiistai;48;72;120;10;6;16
96;10.05.2011;2011;05;11;Tiistai;71;70;141;13;6;19
96;10.05.2011;2011;05;12;Tiistai;85;78;163;13;5;18
96;10.05.2011;2011;05;13;Tiistai;75;86;161;8;15;23
96;10.05.2011;2011;05;14;Tiistai;95;125;220;5;9;14
96;10.05.2011;2011;05;15;Tiistai;156;210;366;7;24;31
96;10.05.2011;2011;05;16;Tiistai;184;143;327;24;23;47
96;10.05.2011;2011;05;17;Tiistai;96;93;189;14;22;36
96;10.05.2011;2011;05;18;Tiistai;94;52;146;21;25;46
96;10.05.2011;2011;05;19;Tiistai;117;58;175;22;14;36
96;10.05.2011;2011;05;20;Tiistai;55;36;91;10;12;22
96;10.05.2011;2011;05;21;Tiistai;42;29;71;6;10;16
96;10.05.2011;2011;05;22;Tiistai;19;9;28;3;3;6
96;10.05.2011;2011;05;23;Tiistai;7;2;9;1;0;1
96;11.05.2011;2011;05;00;Keskiviikko;3;1;4;1;0;1
96;11.05.2011;2011;05;01;Keskiviikko;4;1;5;0;0;0
96;11.05.2011;2011;05;02;Keskiviikko;2;0;2;0;0;0
96;11.05.2011;2011;05;03;Keskiviikko;1;0;1;0;0;0
96;11.05.2011;2011;05;04;Keskiviikko;1;4;5;0;0;0
96;11.05.2011;2011;05;05;Keskiviikko;7;9;16;0;0;0
96;11.05.2011;2011;05;06;Keskiviikko;63;50;113;4;1;5
96;11.05.2011;2011;05;07;Keskiviikko;141;166;307;13;10;23
96;11.05.2011;2011;05;08;Keskiviikko;123;168;291;5;11;16
96;11.05.2011;2011;05;09;Keskiviikko;61;101;162;12;10;22
96;11.05.2011;2011;05;10;Keskiviikko;52;67;119;7;8;15
96;11.05.2011;2011;05;11;Keskiviikko;65;93;158;7;9;16
96;11.05.2011;2011;05;12;Keskiviikko;68;78;146;2;6;8
96;11.05.2011;2011;05;13;Keskiviikko;96;73;169;6;5;11
96;11.05.2011;2011;05;14;Keskiviikko;104;140;244;8;23;31
96;11.05.2011;2011;05;15;Keskiviikko;153;199;352;6;13;19
96;11.05.2011;2011;05;16;Keskiviikko;154;142;296;11;22;33
96;11.05.2011;2011;05;17;Keskiviikko;67;49;116;5;9;14
96;11.05.2011;2011;05;18;Keskiviikko;77;27;104;9;15;24
96;11.05.2011;2011;05;19;Keskiviikko;60;28;88;13;5;18
96;11.05.2011;2011;05;20;Keskiviikko;48;38;86;9;16;25
96;11.05.2011;2011;05;21;Keskiviikko;35;42;77;4;8;12
96;11.05.2011;2011;05;22;Keskiviikko;17;11;28;0;4;4
96;11.05.2011;2011;05;23;Keskiviikko;6;2;8;1;0;1
96;12.05.2011;2011;05;00;Torstai;3;0;3;2;3;5
96;12.05.2011;2011;05;01;Torstai;2;1;3;1;0;1
96;12.05.2011;2011;05;02;Torstai;5;0;5;0;0;0
96;12.05.2011;2011;05;03;Torstai;1;0;1;0;1;1
96;12.05.2011;2011;05;04;Torstai;1;3;4;0;0;0
96;12.05.2011;2011;05;05;Torstai;6;13;19;0;0;0
96;12.05.2011;2011;05;06;Torstai;53;43;96;5;1;6
96;12.05.2011;2011;05;07;Torstai;125;166;291;17;12;29
96;12.05.2011;2011;05;08;Torstai;109;144;253;13;9;22
96;12.05.2011;2011;05;09;Torstai;40;110;150;5;4;9
96;12.05.2011;2011;05;10;Torstai;50;81;131;5;3;8
96;12.05.2011;2011;05;11;Torstai;72;71;143;9;5;14
96;12.05.2011;2011;05;12;Torstai;67;91;158;13;15;28
96;12.05.2011;2011;05;13;Torstai;89;106;195;8;17;25
96;12.05.2011;2011;05;14;Torstai;94;131;225;6;21;27
96;12.05.2011;2011;05;15;Torstai;121;230;351;12;28;40
96;12.05.2011;2011;05;16;Torstai;147;177;324;14;27;41
96;12.05.2011;2011;05;17;Torstai;122;63;185;27;12;39
96;12.05.2011;2011;05;18;Torstai;72;53;125;24;15;39
96;12.05.2011;2011;05;19;Torstai;72;35;107;13;11;24
96;12.05.2011;2011;05;20;Torstai;68;52;120;11;11;22
96;12.05.2011;2011;05;21;Torstai;38;45;83;4;10;14
96;12.05.2011;2011;05;22;Torstai;21;20;41;1;1;2
96;12.05.2011;2011;05;23;Torstai;15;6;21;0;0;0
96;13.05.2011;2011;05;00;Perjantai;9;1;10;0;2;2
96;13.05.2011;2011;05;01;Perjantai;4;0;4;1;0;1
96;13.05.2011;2011;05;02;Perjantai;3;1;4;0;0;0
96;13.05.2011;2011;05;03;Perjantai;5;2;7;0;0;0
96;13.05.2011;2011;05;04;Perjantai;1;3;4;0;0;0
96;13.05.2011;2011;05;05;Perjantai;7;11;18;0;0;0
96;13.05.2011;2011;05;06;Perjantai;62;38;100;6;4;10
96;13.05.2011;2011;05;07;Perjantai;117;151;268;19;13;32
96;13.05.2011;2011;05;08;Perjantai;103;111;214;10;4;14
96;13.05.2011;2011;05;09;Perjantai;32;110;142;3;3;6
96;13.05.2011;2011;05;10;Perjantai;49;90;139;2;10;12
96;13.05.2011;2011;05;11;Perjantai;67;76;143;4;7;11
96;13.05.2011;2011;05;12;Perjantai;48;114;162;3;16;19
96;13.05.2011;2011;05;13;Perjantai;76;110;186;5;15;20
96;13.05.2011;2011;05;14;Perjantai;115;159;274;6;15;21
96;13.05.2011;2011;05;15;Perjantai;134;197;331;11;15;26
96;13.05.2011;2011;05;16;Perjantai;112;115;227;16;11;27
96;13.05.2011;2011;05;17;Perjantai;91;46;137;16;16;32
96;13.05.2011;2011;05;18;Perjantai;66;39;105;16;13;29
96;13.05.2011;2011;05;19;Perjantai;47;47;94;12;13;25
96;13.05.2011;2011;05;20;Perjantai;54;50;104;7;9;16
96;13.05.2011;2011;05;21;Perjantai;34;29;63;1;3;4
96;13.05.2011;2011;05;22;Perjantai;11;9;20;1;1;2
96;13.05.2011;2011;05;23;Perjantai;13;14;27;0;0;0
96;14.05.2011;2011;05;00;Lauantai;14;15;29;6;2;8
96;14.05.2011;2011;05;01;Lauantai;13;1;14;2;0;2
96;14.05.2011;2011;05;02;Lauantai;18;0;18;0;0;0
96;14.05.2011;2011;05;03;Lauantai;14;2;16;2;0;2
96;14.05.2011;2011;05;04;Lauantai;15;0;15;2;2;4
96;14.05.2011;2011;05;05;Lauantai;7;2;9;1;0;1
96;14.05.2011;2011;05;06;Lauantai;20;6;26;3;0;3
96;14.05.2011;2011;05;07;Lauantai;7;22;29;5;2;7
96;14.05.2011;2011;05;08;Lauantai;6;28;34;1;5;6
96;14.05.2011;2011;05;09;Lauantai;16;61;77;3;7;10
96;14.05.2011;2011;05;10;Lauantai;33;56;89;5;7;12
96;14.05.2011;2011;05;11;Lauantai;46;66;112;9;5;14
96;14.05.2011;2011;05;12;Lauantai;42;70;112;4;7;11
96;14.05.2011;2011;05;13;Lauantai;50;62;112;2;8;10
96;14.05.2011;2011;05;14;Lauantai;68;81;149;3;10;13
96;14.05.2011;2011;05;15;Lauantai;78;63;141;5;6;11
96;14.05.2011;2011;05;16;Lauantai;74;60;134;17;7;24
96;14.05.2011;2011;05;17;Lauantai;80;59;139;27;7;34
96;14.05.2011;2011;05;18;Lauantai;63;37;100;21;11;32
96;14.05.2011;2011;05;19;Lauantai;40;35;75;9;9;18
96;14.05.2011;2011;05;20;Lauantai;36;31;67;1;14;15
96;14.05.2011;2011;05;21;Lauantai;15;48;63;4;8;12
96;14.05.2011;2011;05;22;Lauantai;13;9;22;1;1;2
96;14.05.2011;2011;05;23;Lauantai;13;13;26;0;0;0
96;15.05.2011;2011;05;00;Sunnuntai;15;4;19;0;1;1
96;15.05.2011;2011;05;01;Sunnuntai;15;3;18;3;0;3
96;15.05.2011;2011;05;02;Sunnuntai;13;8;21;2;0;2
96;15.05.2011;2011;05;03;Sunnuntai;14;0;14;3;0;3
96;15.05.2011;2011;05;04;Sunnuntai;11;0;11;17;3;20
96;15.05.2011;2011;05;05;Sunnuntai;3;0;3;0;0;0
96;15.05.2011;2011;05;06;Sunnuntai;12;3;15;3;0;3
96;15.05.2011;2011;05;07;Sunnuntai;4;14;18;0;2;2
96;15.05.2011;2011;05;08;Sunnuntai;6;15;21;3;3;6
96;15.05.2011;2011;05;09;Sunnuntai;7;18;25;4;11;15
96;15.05.2011;2011;05;10;Sunnuntai;18;31;49;6;6;12
96;15.05.2011;2011;05;11;Sunnuntai;37;49;86;9;11;20
96;15.05.2011;2011;05;12;Sunnuntai;26;52;78;11;7;18
96;15.05.2011;2011;05;13;Sunnuntai;67;58;125;13;7;20
96;15.05.2011;2011;05;14;Sunnuntai;50;66;116;15;5;20
96;15.05.2011;2011;05;15;Sunnuntai;47;59;106;8;16;24
96;15.05.2011;2011;05;16;Sunnuntai;79;48;127;17;8;25
96;15.05.2011;2011;05;17;Sunnuntai;68;54;122;3;9;12
96;15.05.2011;2011;05;18;Sunnuntai;73;58;131;19;14;33
96;15.05.2011;2011;05;19;Sunnuntai;39;36;75;8;15;23
96;15.05.2011;2011;05;20;Sunnuntai;36;63;99;6;8;14
96;15.05.2011;2011;05;21;Sunnuntai;7;21;28;6;2;8
96;15.05.2011;2011;05;22;Sunnuntai;8;3;11;2;0;2
96;15.05.2011;2011;05;23;Sunnuntai;1;2;3;0;0;0
96;16.05.2011;2011;05;00;Maanantai;11;23;34;2;3;5
96;16.05.2011;2011;05;01;Maanantai;16;13;29;1;1;2
96;16.05.2011;2011;05;02;Maanantai;20;2;22;0;0;0
96;16.05.2011;2011;05;03;Maanantai;12;1;13;3;0;3
96;16.05.2011;2011;05;04;Maanantai;8;4;12;1;1;2
96;16.05.2011;2011;05;05;Maanantai;7;5;12;1;1;2
96;16.05.2011;2011;05;06;Maanantai;42;40;82;2;2;4
96;16.05.2011;2011;05;07;Maanantai;123;139;262;13;9;22
96;16.05.2011;2011;05;08;Maanantai;77;136;213;9;5;14
96;16.05.2011;2011;05;09;Maanantai;43;82;125;13;8;21
96;16.05.2011;2011;05;10;Maanantai;52;71;123;7;7;14
96;16.05.2011;2011;05;11;Maanantai;71;67;138;9;6;15
96;16.05.2011;2011;05;12;Maanantai;65;70;135;6;8;14
96;16.05.2011;2011;05;13;Maanantai;61;76;137;8;6;14
96;16.05.2011;2011;05;14;Maanantai;84;89;173;3;9;12
96;16.05.2011;2011;05;15;Maanantai;113;176;289;6;12;18
96;16.05.2011;2011;05;16;Maanantai;134;162;296;5;33;38
96;16.05.2011;2011;05;17;Maanantai;88;61;149;18;17;35
96;16.05.2011;2011;05;18;Maanantai;59;25;84;10;4;14
96;16.05.2011;2011;05;19;Maanantai;41;24;65;3;3;6
96;16.05.2011;2011;05;20;Maanantai;26;12;38;8;3;11
96;16.05.2011;2011;05;21;Maanantai;16;22;38;4;3;7
96;16.05.2011;2011;05;22;Maanantai;5;7;12;0;2;2
96;16.05.2011;2011;05;23;Maanantai;2;1;3;3;1;4
96;17.05.2011;2011;05;00;Tiistai;2;2;4;0;0;0
96;17.05.2011;2011;05;01;Tiistai;1;0;1;0;0;0
96;17.05.2011;2011;05;02;Tiistai;1;3;4;0;0;0
96;17.05.2011;2011;05;03;Tiistai;0;0;0;0;0;0
96;17.05.2011;2011;05;04;Tiistai;0;3;3;0;0;0
96;17.05.2011;2011;05;05;Tiistai;5;8;13;0;1;1
96;17.05.2011;2011;05;06;Tiistai;52;42;94;7;2;9
96;17.05.2011;2011;05;07;Tiistai;126;130;256;13;8;21
96;17.05.2011;2011;05;08;Tiistai;82;110;192;17;13;30
96;17.05.2011;2011;05;09;Tiistai;49;63;112;5;10;15
96;17.05.2011;2011;05;10;Tiistai;25;72;97;4;10;14
96;17.05.2011;2011;05;11;Tiistai;59;41;100;10;9;19
96;17.05.2011;2011;05;12;Tiistai;59;52;111;25;26;51
96;17.05.2011;2011;05;13;Tiistai;49;64;113;11;17;28
96;17.05.2011;2011;05;14;Tiistai;55;66;121;4;2;6
96;17.05.2011;2011;05;15;Tiistai;87;180;267;8;8;16
96;17.05.2011;2011;05;16;Tiistai;122;131;253;9;16;25
96;17.05.2011;2011;05;17;Tiistai;88;58;146;17;34;51
96;17.05.2011;2011;05;18;Tiistai;88;51;139;20;16;36
96;17.05.2011;2011;05;19;Tiistai;90;53;143;11;16;27
96;17.05.2011;2011;05;20;Tiistai;66;47;113;10;13;23
96;17.05.2011;2011;05;21;Tiistai;35;28;63;13;14;27
96;17.05.2011;2011;05;22;Tiistai;14;10;24;4;2;6
96;17.05.2011;2011;05;23;Tiistai;6;1;7;2;2;4
96;18.05.2011;2011;05;00;Keskiviikko;2;0;2;0;0;0
96;18.05.2011;2011;05;01;Keskiviikko;3;0;3;1;0;1
96;18.05.2011;2011;05;02;Keskiviikko;1;1;2;0;0;0
96;18.05.2011;2011;05;03;Keskiviikko;0;0;0;0;0;0
96;18.05.2011;2011;05;04;Keskiviikko;0;3;3;0;0;0
96;18.05.2011;2011;05;05;Keskiviikko;5;10;15;0;0;0
96;18.05.2011;2011;05;06;Keskiviikko;55;39;94;4;2;6
96;18.05.2011;2011;05;07;Keskiviikko;128;176;304;15;13;28
96;18.05.2011;2011;05;08;Keskiviikko;112;135;247;15;9;24
96;18.05.2011;2011;05;09;Keskiviikko;48;85;133;10;9;19
96;18.05.2011;2011;05;10;Keskiviikko;36;72;108;6;12;18
96;18.05.2011;2011;05;11;Keskiviikko;67;60;127;2;10;12
96;18.05.2011;2011;05;12;Keskiviikko;76;85;161;3;7;10
96;18.05.2011;2011;05;13;Keskiviikko;84;74;158;6;5;11
96;18.05.2011;2011;05;14;Keskiviikko;101;120;221;8;8;16
96;18.05.2011;2011;05;15;Keskiviikko;146;192;338;8;25;33
96;18.05.2011;2011;05;16;Keskiviikko;132;147;279;9;15;24
96;18.05.2011;2011;05;17;Keskiviikko;102;89;191;10;8;18
96;18.05.2011;2011;05;18;Keskiviikko;97;63;160;20;8;28
96;18.05.2011;2011;05;19;Keskiviikko;86;48;134;5;6;11
96;18.05.2011;2011;05;20;Keskiviikko;85;36;121;13;16;29
96;18.05.2011;2011;05;21;Keskiviikko;39;45;84;5;6;11
96;18.05.2011;2011;05;22;Keskiviikko;18;9;27;2;1;3
96;18.05.2011;2011;05;23;Keskiviikko;12;2;14;2;3;5
96;19.05.2011;2011;05;00;Torstai;3;0;3;0;1;1
96;19.05.2011;2011;05;01;Torstai;3;0;3;0;0;0
96;19.05.2011;2011;05;02;Torstai;3;0;3;0;0;0
96;19.05.2011;2011;05;03;Torstai;2;0;2;0;0;0
96;19.05.2011;2011;05;04;Torstai;2;7;9;0;0;0
96;19.05.2011;2011;05;05;Torstai;4;13;17;1;0;1
96;19.05.2011;2011;05;06;Torstai;47;46;93;2;4;6
96;19.05.2011;2011;05;07;Torstai;122;132;254;16;7;23
96;19.05.2011;2011;05;08;Torstai;98;127;225;15;7;22
96;19.05.2011;2011;05;09;Torstai;34;100;134;8;8;16
96;19.05.2011;2011;05;10;Torstai;36;42;78;7;20;27
96;19.05.2011;2011;05;11;Torstai;35;36;71;7;73;80
96;19.05.2011;2011;05;12;Torstai;39;50;89;11;125;136
96;19.05.2011;2011;05;13;Torstai;36;49;85;20;53;73
96;19.05.2011;2011;05;14;Torstai;50;84;134;61;41;102
96;19.05.2011;2011;05;15;Torstai;96;154;250;69;43;112
96;19.05.2011;2011;05;16;Torstai;94;105;199;65;80;145
96;19.05.2011;2011;05;17;Torstai;77;54;131;55;23;78
96;19.05.2011;2011;05;18;Torstai;75;36;111;76;15;91
96;19.05.2011;2011;05;19;Torstai;53;44;97;45;10;55
96;19.05.2011;2011;05;20;Torstai;54;31;85;16;10;26
96;19.05.2011;2011;05;21;Torstai;44;31;75;9;2;11
96;19.05.2011;2011;05;22;Torstai;10;5;15;2;7;9
96;19.05.2011;2011;05;23;Torstai;10;10;20;4;1;5
96;20.05.2011;2011;05;00;Perjantai;5;4;9;0;0;0
96;20.05.2011;2011;05;01;Perjantai;1;0;1;0;0;0
96;20.05.2011;2011;05;02;Perjantai;3;0;3;0;0;0
96;20.05.2011;2011;05;03;Perjantai;3;0;3;0;0;0
96;20.05.2011;2011;05;04;Perjantai;7;4;11;0;2;2
96;20.05.2011;2011;05;05;Perjantai;5;10;15;0;1;1
96;20.05.2011;2011;05;06;Perjantai;51;39;90;7;2;9
96;20.05.2011;2011;05;07;Perjantai;100;96;196;13;9;22
96;20.05.2011;2011;05;08;Perjantai;91;85;176;10;5;15
96;20.05.2011;2011;05;09;Perjantai;31;108;139;11;82;93
96;20.05.2011;2011;05;10;Perjantai;44;102;146;15;287;302
96;20.05.2011;2011;05;11;Perjantai;55;113;168;26;193;219
96;20.05.2011;2011;05;12;Perjantai;63;121;184;86;109;195
96;20.05.2011;2011;05;13;Perjantai;106;115;221;126;119;245
96;20.05.2011;2011;05;14;Perjantai;138;127;265;157;90;247
96;20.05.2011;2011;05;15;Perjantai;131;164;295;143;97;240
96;20.05.2011;2011;05;16;Perjantai;100;94;194;135;34;169
96;20.05.2011;2011;05;17;Perjantai;118;59;177;143;20;163
96;20.05.2011;2011;05;18;Perjantai;85;52;137;58;10;68
96;20.05.2011;2011;05;19;Perjantai;52;35;87;6;10;16
96;20.05.2011;2011;05;20;Perjantai;44;48;92;8;2;10
96;20.05.2011;2011;05;21;Perjantai;41;33;74;4;2;6
96;20.05.2011;2011;05;22;Perjantai;23;16;39;2;7;9
96;20.05.2011;2011;05;23;Perjantai;16;14;30;0;1;1
96;21.05.2011;2011;05;00;Lauantai;9;6;15;3;0;3
96;21.05.2011;2011;05;01;Lauantai;13;4;17;1;1;2
96;21.05.2011;2011;05;02;Lauantai;16;4;20;0;0;0
96;21.05.2011;2011;05;03;Lauantai;21;3;24;2;0;2
96;21.05.2011;2011;05;04;Lauantai;8;2;10;0;0;0
96;21.05.2011;2011;05;05;Lauantai;4;3;7;0;0;0
96;21.05.2011;2011;05;06;Lauantai;24;10;34;1;2;3
96;21.05.2011;2011;05;07;Lauantai;7;16;23;4;4;8
96;21.05.2011;2011;05;08;Lauantai;10;29;39;3;7;10
96;21.05.2011;2011;05;09;Lauantai;6;102;108;16;218;234
96;21.05.2011;2011;05;10;Lauantai;23;132;155;34;667;701
96;21.05.2011;2011;05;11;Lauantai;31;131;162;69;381;450
96;21.05.2011;2011;05;12;Lauantai;76;95;171;254;233;487
96;21.05.2011;2011;05;13;Lauantai;117;87;204;337;119;456
96;21.05.2011;2011;05;14;Lauantai;117;56;173;384;76;460
96;21.05.2011;2011;05;15;Lauantai;110;45;155;378;88;466
96;21.05.2011;2011;05;16;Lauantai;91;43;134;232;21;253
96;21.05.2011;2011;05;17;Lauantai;73;30;103;159;13;172
96;21.05.2011;2011;05;18;Lauantai;69;17;86;58;7;65
96;21.05.2011;2011;05;19;Lauantai;23;28;51;8;3;11
96;21.05.2011;2011;05;20;Lauantai;30;32;62;4;7;11
96;21.05.2011;2011;05;21;Lauantai;18;28;46;3;4;7
96;21.05.2011;2011;05;22;Lauantai;20;11;31;4;2;6
96;21.05.2011;2011;05;23;Lauantai;17;14;31;3;3;6
96;22.05.2011;2011;05;00;Sunnuntai;8;6;14;0;1;1
96;22.05.2011;2011;05;01;Sunnuntai;7;3;10;1;1;2
96;22.05.2011;2011;05;02;Sunnuntai;15;1;16;1;0;1
96;22.05.2011;2011;05;03;Sunnuntai;10;3;13;2;0;2
96;22.05.2011;2011;05;04;Sunnuntai;4;1;5;2;0;2
96;22.05.2011;2011;05;05;Sunnuntai;2;1;3;1;0;1
96;22.05.2011;2011;05;06;Sunnuntai;11;3;14;0;1;1
96;22.05.2011;2011;05;07;Sunnuntai;9;18;27;1;2;3
96;22.05.2011;2011;05;08;Sunnuntai;13;9;22;3;3;6
96;22.05.2011;2011;05;09;Sunnuntai;10;42;52;9;148;157
96;22.05.2011;2011;05;10;Sunnuntai;14;71;85;10;229;239
96;22.05.2011;2011;05;11;Sunnuntai;25;91;116;35;195;230
96;22.05.2011;2011;05;12;Sunnuntai;69;92;161;141;102;243
96;22.05.2011;2011;05;13;Sunnuntai;112;97;209;192;60;252
96;22.05.2011;2011;05;14;Sunnuntai;125;73;198;213;54;267
96;22.05.2011;2011;05;15;Sunnuntai;131;65;196;217;34;251
96;22.05.2011;2011;05;16;Sunnuntai;133;60;193;212;20;232
96;22.05.2011;2011;05;17;Sunnuntai;90;59;149;46;6;52
96;22.05.2011;2011;05;18;Sunnuntai;69;58;127;8;9;17
96;22.05.2011;2011;05;19;Sunnuntai;57;56;113;8;12;20
96;22.05.2011;2011;05;20;Sunnuntai;50;59;109;9;13;22
96;22.05.2011;2011;05;21;Sunnuntai;26;39;65;5;6;11
96;22.05.2011;2011;05;22;Sunnuntai;11;5;16;0;1;1
96;22.05.2011;2011;05;23;Sunnuntai;4;2;6;1;1;2
96;23.05.2011;2011;05;00;Maanantai;10;0;10;0;1;1
96;23.05.2011;2011;05;01;Maanantai;4;1;5;0;0;0
96;23.05.2011;2011;05;02;Maanantai;0;0;0;0;0;0
96;23.05.2011;2011;05;03;Maanantai;3;1;4;0;0;0
96;23.05.2011;2011;05;04;Maanantai;3;2;5;1;2;3
96;23.05.2011;2011;05;05;Maanantai;7;7;14;0;0;0
96;23.05.2011;2011;05;06;Maanantai;49;51;100;3;4;7
96;23.05.2011;2011;05;07;Maanantai;124;181;305;17;10;27
96;23.05.2011;2011;05;08;Maanantai;93;149;242;12;11;23
96;23.05.2011;2011;05;09;Maanantai;72;111;183;8;3;11
96;23.05.2011;2011;05;10;Maanantai;60;85;145;5;10;15
96;23.05.2011;2011;05;11;Maanantai;45;68;113;9;8;17
96;23.05.2011;2011;05;12;Maanantai;83;81;164;10;18;28
96;23.05.2011;2011;05;13;Maanantai;111;75;186;9;10;19
96;23.05.2011;2011;05;14;Maanantai;105;121;226;8;7;15
96;23.05.2011;2011;05;15;Maanantai;121;182;303;10;17;27
96;23.05.2011;2011;05;16;Maanantai;144;162;306;6;23;29
96;23.05.2011;2011;05;17;Maanantai;80;80;160;11;8;19
96;23.05.2011;2011;05;18;Maanantai;63;44;107;17;23;40
96;23.05.2011;2011;05;19;Maanantai;39;36;75;3;7;10
96;23.05.2011;2011;05;20;Maanantai;58;17;75;5;9;14
96;23.05.2011;2011;05;21;Maanantai;21;21;42;4;7;11
96;23.05.2011;2011;05;22;Maanantai;8;5;13;1;1;2
96;23.05.2011;2011;05;23;Maanantai;4;2;6;1;0;1
96;24.05.2011;2011;05;00;Tiistai;1;2;3;0;1;1
96;24.05.2011;2011;05;01;Tiistai;1;0;1;2;1;3
96;24.05.2011;2011;05;02;Tiistai;1;1;2;0;0;0
96;24.05.2011;2011;05;03;Tiistai;0;0;0;1;1;2
96;24.05.2011;2011;05;04;Tiistai;1;4;5;0;0;0
96;24.05.2011;2011;05;05;Tiistai;8;6;14;0;2;2
96;24.05.2011;2011;05;06;Tiistai;55;65;120;3;4;7
96;24.05.2011;2011;05;07;Tiistai;129;157;286;15;6;21
96;24.05.2011;2011;05;08;Tiistai;103;143;246;18;8;26
96;24.05.2011;2011;05;09;Tiistai;42;83;125;7;11;18
96;24.05.2011;2011;05;10;Tiistai;50;72;122;5;13;18
96;24.05.2011;2011;05;11;Tiistai;68;87;155;7;16;23
96;24.05.2011;2011;05;12;Tiistai;67;67;134;16;15;31
96;24.05.2011;2011;05;13;Tiistai;83;99;182;10;15;25
96;24.05.2011;2011;05;14;Tiistai;105;112;217;9;10;19
96;24.05.2011;2011;05;15;Tiistai;130;178;308;9;18;27
96;24.05.2011;2011;05;16;Tiistai;111;126;237;12;11;23
96;24.05.2011;2011;05;17;Tiistai;87;58;145;12;18;30
96;24.05.2011;2011;05;18;Tiistai;75;52;127;18;12;30
96;24.05.2011;2011;05;19;Tiistai;40;36;76;7;13;20
96;24.05.2011;2011;05;20;Tiistai;51;20;71;3;8;11
96;24.05.2011;2011;05;21;Tiistai;27;17;44;5;5;10
96;24.05.2011;2011;05;22;Tiistai;11;8;19;3;6;9
96;24.05.2011;2011;05;23;Tiistai;4;6;10;2;4;6
96;25.05.2011;2011;05;00;Keskiviikko;7;0;7;0;0;0
96;25.05.2011;2011;05;01;Keskiviikko;2;1;3;0;0;0
96;25.05.2011;2011;05;02;Keskiviikko;3;0;3;0;0;0
96;25.05.2011;2011;05;03;Keskiviikko;1;1;2;2;1;3
96;25.05.2011;2011;05;04;Keskiviikko;1;4;5;0;0;0
96;25.05.2011;2011;05;05;Keskiviikko;8;8;16;0;1;1
96;25.05.2011;2011;05;06;Keskiviikko;58;56;114;7;1;8
96;25.05.2011;2011;05;07;Keskiviikko;119;153;272;10;5;15
96;25.05.2011;2011;05;08;Keskiviikko;113;128;241;13;9;22
96;25.05.2011;2011;05;09;Keskiviikko;47;82;129;6;8;14
96;25.05.2011;2011;05;10;Keskiviikko;54;89;143;4;13;17
96;25.05.2011;2011;05;11;Keskiviikko;69;63;132;8;5;13
96;25.05.2011;2011;05;12;Keskiviikko;85;93;178;11;10;21
96;25.05.2011;2011;05;13;Keskiviikko;84;87;171;5;7;12
96;25.05.2011;2011;05;14;Keskiviikko;75;120;195;8;17;25
96;25.05.2011;2011;05;15;Keskiviikko;120;199;319;14;25;39
96;25.05.2011;2011;05;16;Keskiviikko;147;165;312;10;21;31
96;25.05.2011;2011;05;17;Keskiviikko;102;139;241;17;13;30
96;25.05.2011;2011;05;18;Keskiviikko;94;114;208;12;22;34
96;25.05.2011;2011;05;19;Keskiviikko;76;66;142;11;4;15
96;25.05.2011;2011;05;20;Keskiviikko;146;43;189;10;11;21
96;25.05.2011;2011;05;21;Keskiviikko;116;46;162;11;9;20
96;25.05.2011;2011;05;22;Keskiviikko;38;11;49;1;4;5
96;25.05.2011;2011;05;23;Keskiviikko;13;10;23;1;1;2
96;26.05.2011;2011;05;00;Torstai;6;4;10;1;1;2
96;26.05.2011;2011;05;01;Torstai;14;1;15;10;8;18
96;26.05.2011;2011;05;02;Torstai;11;1;12;4;0;4
96;26.05.2011;2011;05;03;Torstai;4;0;4;0;0;0
96;26.05.2011;2011;05;04;Torstai;3;5;8;2;0;2
96;26.05.2011;2011;05;05;Torstai;6;7;13;0;1;1
96;26.05.2011;2011;05;06;Torstai;69;47;116;2;5;7
96;26.05.2011;2011;05;07;Torstai;120;146;266;10;9;19
96;26.05.2011;2011;05;08;Torstai;97;135;232;10;12;22
96;26.05.2011;2011;05;09;Torstai;37;98;135;4;8;12
96;26.05.2011;2011;05;10;Torstai;54;74;128;2;9;11
96;26.05.2011;2011;05;11;Torstai;45;54;99;9;6;15
96;26.05.2011;2011;05;12;Torstai;75;72;147;5;7;12
96;26.05.2011;2011;05;13;Torstai;74;73;147;8;12;20
96;26.05.2011;2011;05;14;Torstai;96;102;198;10;12;22
96;26.05.2011;2011;05;15;Torstai;140;190;330;11;24;35
96;26.05.2011;2011;05;16;Torstai;148;117;265;13;14;27
96;26.05.2011;2011;05;17;Torstai;98;65;163;6;11;17
96;26.05.2011;2011;05;18;Torstai;86;40;126;24;9;33
96;26.05.2011;2011;05;19;Torstai;60;48;108;8;10;18
96;26.05.2011;2011;05;20;Torstai;50;25;75;5;7;12
96;26.05.2011;2011;05;21;Torstai;37;31;68;4;4;8
96;26.05.2011;2011;05;22;Torstai;20;12;32;1;2;3
96;26.05.2011;2011;05;23;Torstai;6;5;11;0;3;3
96;27.05.2011;2011;05;00;Perjantai;3;6;9;0;2;2
96;27.05.2011;2011;05;01;Perjantai;1;4;5;1;0;1
96;27.05.2011;2011;05;02;Perjantai;1;0;1;0;0;0
96;27.05.2011;2011;05;03;Perjantai;5;1;6;0;0;0
96;27.05.2011;2011;05;04;Perjantai;5;3;8;0;0;0
96;27.05.2011;2011;05;05;Perjantai;7;7;14;0;0;0
96;27.05.2011;2011;05;06;Perjantai;55;53;108;6;4;10
96;27.05.2011;2011;05;07;Perjantai;126;124;250;19;13;32
96;27.05.2011;2011;05;08;Perjantai;110;108;218;10;4;14
96;27.05.2011;2011;05;09;Perjantai;76;68;144;3;3;6
96;27.05.2011;2011;05;10;Perjantai;65;63;128;2;10;12
96;27.05.2011;2011;05;11;Perjantai;68;66;134;4;7;11
96;27.05.2011;2011;05;12;Perjantai;81;79;160;3;16;19
96;27.05.2011;2011;05;13;Perjantai;91;88;179;5;15;20
96;27.05.2011;2011;05;14;Perjantai;120;117;237;6;15;21
96;27.05.2011;2011;05;15;Perjantai;139;124;263;11;15;26
96;27.05.2011;2011;05;16;Perjantai;113;102;215;16;11;27
96;27.05.2011;2011;05;17;Perjantai;85;76;161;16;16;32
96;27.05.2011;2011;05;18;Perjantai;47;45;92;16;13;29
96;27.05.2011;2011;05;19;Perjantai;40;38;78;12;13;25
96;27.05.2011;2011;05;20;Perjantai;48;47;95;7;9;16
96;27.05.2011;2011;05;21;Perjantai;28;26;54;1;3;4
96;27.05.2011;2011;05;22;Perjantai;15;12;27;1;1;2
96;27.05.2011;2011;05;23;Perjantai;12;10;22;0;0;0
96;28.05.2011;2011;05;00;Lauantai;10;8;18;6;2;8
96;28.05.2011;2011;05;01;Lauantai;7;4;11;2;0;2
96;28.05.2011;2011;05;02;Lauantai;7;5;12;0;0;0
96;28.05.2011;2011;05;03;Lauantai;8;7;15;2;0;2
96;28.05.2011;2011;05;04;Lauantai;6;4;10;2;2;4
96;28.05.2011;2011;05;05;Lauantai;5;3;8;1;0;1
96;28.05.2011;2011;05;06;Lauantai;19;16;35;3;0;3
96;28.05.2011;2011;05;07;Lauantai;11;10;21;5;2;7
96;28.05.2011;2011;05;08;Lauantai;12;10;22;1;5;6
96;28.05.2011;2011;05;09;Lauantai;17;15;32;3;7;10
96;28.05.2011;2011;05;10;Lauantai;18;16;34;5;7;12
96;28.05.2011;2011;05;11;Lauantai;30;29;59;9;5;14
96;28.05.2011;2011;05;12;Lauantai;30;29;59;4;7;11
96;28.05.2011;2011;05;13;Lauantai;37;34;71;2;8;10
96;28.05.2011;2011;05;14;Lauantai;36;32;68;3;10;13
96;28.05.2011;2011;05;15;Lauantai;28;27;55;5;6;11
96;28.05.2011;2011;05;16;Lauantai;34;33;67;17;7;24
96;28.05.2011;2011;05;17;Lauantai;25;23;48;27;7;34
96;28.05.2011;2011;05;18;Lauantai;32;30;62;21;11;32
96;28.05.2011;2011;05;19;Lauantai;21;20;41;9;9;18
96;28.05.2011;2011;05;20;Lauantai;33;32;65;1;14;15
96;28.05.2011;2011;05;21;Lauantai;23;20;43;4;8;12
96;28.05.2011;2011;05;22;Lauantai;6;5;11;1;1;2
96;28.05.2011;2011;05;23;Lauantai;10;8;18;0;0;0
96;29.05.2011;2011;05;00;Sunnuntai;11;8;19;0;1;1
96;29.05.2011;2011;05;01;Sunnuntai;7;6;13;3;0;3
96;29.05.2011;2011;05;02;Sunnuntai;11;9;20;2;0;2
96;29.05.2011;2011;05;03;Sunnuntai;13;10;23;3;0;3
96;29.05.2011;2011;05;04;Sunnuntai;12;9;21;17;3;20
96;29.05.2011;2011;05;05;Sunnuntai;6;2;8;0;0;0
96;29.05.2011;2011;05;06;Sunnuntai;10;7;17;3;0;3
96;29.05.2011;2011;05;07;Sunnuntai;8;7;15;0;2;2
96;29.05.2011;2011;05;08;Sunnuntai;7;4;11;3;3;6
96;29.05.2011;2011;05;09;Sunnuntai;24;22;46;4;11;15
96;29.05.2011;2011;05;10;Sunnuntai;15;13;28;6;6;12
96;29.05.2011;2011;05;11;Sunnuntai;32;31;63;9;11;20
96;29.05.2011;2011;05;12;Sunnuntai;37;34;71;11;7;18
96;29.05.2011;2011;05;13;Sunnuntai;46;44;90;13;7;20
96;29.05.2011;2011;05;14;Sunnuntai;48;45;93;15;5;20
96;29.05.2011;2011;05;15;Sunnuntai;44;40;84;8;16;24
96;29.05.2011;2011;05;16;Sunnuntai;43;41;84;17;8;25
96;29.05.2011;2011;05;17;Sunnuntai;21;20;41;3;9;12
96;29.05.2011;2011;05;18;Sunnuntai;28;25;53;19;14;33
96;29.05.2011;2011;05;19;Sunnuntai;21;18;39;8;15;23
96;29.05.2011;2011;05;20;Sunnuntai;26;26;52;6;8;14
96;29.05.2011;2011;05;21;Sunnuntai;13;12;25;6;2;8
96;29.05.2011;2011;05;22;Sunnuntai;7;4;11;2;0;2
96;29.05.2011;2011;05;23;Sunnuntai;4;2;6;0;0;0
96;30.05.2011;2011;05;00;Maanantai;4;3;7;0;1;1
96;30.05.2011;2011;05;01;Maanantai;3;2;5;0;0;0
96;30.05.2011;2011;05;02;Maanantai;2;1;3;0;0;0
96;30.05.2011;2011;05;03;Maanantai;1;0;1;0;0;0
96;30.05.2011;2011;05;04;Maanantai;2;1;3;1;2;3
96;30.05.2011;2011;05;05;Maanantai;6;6;12;0;0;0
96;30.05.2011;2011;05;06;Maanantai;52;49;101;3;4;7
96;30.05.2011;2011;05;07;Maanantai;124;122;246;17;10;27
96;30.05.2011;2011;05;08;Maanantai;110;106;216;12;11;23
96;30.05.2011;2011;05;09;Maanantai;63;60;123;8;3;11
96;30.05.2011;2011;05;10;Maanantai;56;55;111;5;10;15
96;30.05.2011;2011;05;11;Maanantai;62;59;121;9;8;17
96;30.05.2011;2011;05;12;Maanantai;80;83;163;10;18;28
96;30.05.2011;2011;05;13;Maanantai;93;57;150;9;10;19
96;30.05.2011;2011;05;14;Maanantai;76;104;180;8;7;15
96;30.05.2011;2011;05;15;Maanantai;101;179;280;10;17;27
96;30.05.2011;2011;05;16;Maanantai;136;145;281;6;23;29
96;30.05.2011;2011;05;17;Maanantai;93;77;170;11;8;19
96;30.05.2011;2011;05;18;Maanantai;86;52;138;17;23;40
96;30.05.2011;2011;05;19;Maanantai;79;54;133;3;7;10
96;30.05.2011;2011;05;20;Maanantai;63;48;111;5;9;14
96;30.05.2011;2011;05;21;Maanantai;36;30;66;4;7;11
96;30.05.2011;2011;05;22;Maanantai;13;8;21;1;1;2
96;30.05.2011;2011;05;23;Maanantai;7;3;10;1;0;1
96;31.05.2011;2011;05;00;Tiistai;2;2;4;2;0;2
96;31.05.2011;2011;05;01;Tiistai;1;0;1;0;0;0
96;31.05.2011;2011;05;02;Tiistai;3;1;4;0;0;0
96;31.05.2011;2011;05;03;Tiistai;2;0;2;0;0;0
96;31.05.2011;2011;05;04;Tiistai;0;4;4;0;0;0
96;31.05.2011;2011;05;05;Tiistai;6;9;15;0;1;1
96;31.05.2011;2011;05;06;Tiistai;55;47;102;4;2;6
96;31.05.2011;2011;05;07;Tiistai;126;164;290;10;12;22
96;31.05.2011;2011;05;08;Tiistai;104;146;250;15;11;26
96;31.05.2011;2011;05;09;Tiistai;48;117;165;9;18;27
96;31.05.2011;2011;05;10;Tiistai;40;89;129;5;11;16
96;31.05.2011;2011;05;11;Tiistai;88;133;221;16;25;41
96;31.05.2011;2011;05;12;Tiistai;110;89;199;11;10;21
96;31.05.2011;2011;05;13;Tiistai;102;110;212;2;8;10
96;31.05.2011;2011;05;14;Tiistai;87;112;199;6;12;18
96;31.05.2011;2011;05;15;Tiistai;114;219;333;9;25;34
96;31.05.2011;2011;05;16;Tiistai;155;165;320;8;15;23
96;31.05.2011;2011;05;17;Tiistai;132;99;231;15;24;39
96;31.05.2011;2011;05;18;Tiistai;109;85;194;26;21;47
96;31.05.2011;2011;05;19;Tiistai;85;66;151;7;8;15
96;31.05.2011;2011;05;20;Tiistai;70;31;101;9;13;22
96;31.05.2011;2011;05;21;Tiistai;41;32;73;8;1;9
96;31.05.2011;2011;05;22;Tiistai;14;16;30;1;4;5
96;31.05.2011;2011;05;23;Tiistai;11;12;23;1;0;1
96;01.06.2011;2011;06;00;Keskiviikko;4;0;4;1;0;1
96;01.06.2011;2011;06;01;Keskiviikko;0;3;3;0;0;0
96;01.06.2011;2011;06;02;Keskiviikko;3;0;3;0;0;0
96;01.06.2011;2011;06;03;Keskiviikko;0;0;0;0;0;0
96;01.06.2011;2011;06;04;Keskiviikko;1;5;6;0;0;0
96;01.06.2011;2011;06;05;Keskiviikko;8;8;16;0;1;1
96;01.06.2011;2011;06;06;Keskiviikko;64;43;107;2;4;6
96;01.06.2011;2011;06;07;Keskiviikko;127;115;242;13;5;18
96;01.06.2011;2011;06;08;Keskiviikko;66;126;192;12;9;21
96;01.06.2011;2011;06;09;Keskiviikko;43;96;139;11;21;32
96;01.06.2011;2011;06;10;Keskiviikko;50;63;113;6;10;16
96;01.06.2011;2011;06;11;Keskiviikko;77;66;143;10;7;17
96;01.06.2011;2011;06;12;Keskiviikko;56;37;93;1;2;3
96;01.06.2011;2011;06;13;Keskiviikko;42;44;86;1;3;4
96;01.06.2011;2011;06;14;Keskiviikko;46;92;138;6;10;16
96;01.06.2011;2011;06;15;Keskiviikko;77;170;247;7;14;21
96;01.06.2011;2011;06;16;Keskiviikko;77;98;175;5;5;10
96;01.06.2011;2011;06;17;Keskiviikko;65;38;103;4;5;9
96;01.06.2011;2011;06;18;Keskiviikko;53;24;77;7;7;14
96;01.06.2011;2011;06;19;Keskiviikko;27;35;62;2;12;14
96;01.06.2011;2011;06;20;Keskiviikko;26;19;45;4;4;8
96;01.06.2011;2011;06;21;Keskiviikko;24;22;46;0;8;8
96;01.06.2011;2011;06;22;Keskiviikko;10;13;23;2;2;4
96;01.06.2011;2011;06;23;Keskiviikko;5;10;15;1;0;1
96;02.06.2011;2011;06;00;Torstai;8;6;14;1;1;2
96;02.06.2011;2011;06;01;Torstai;5;3;8;2;0;2
96;02.06.2011;2011;06;02;Torstai;11;0;11;3;1;4
96;02.06.2011;2011;06;03;Torstai;10;0;10;2;0;2
96;02.06.2011;2011;06;04;Torstai;14;2;16;3;1;4
96;02.06.2011;2011;06;05;Torstai;1;2;3;1;1;2
96;02.06.2011;2011;06;06;Torstai;26;7;33;3;0;3
96;02.06.2011;2011;06;07;Torstai;5;17;22;0;4;4
96;02.06.2011;2011;06;08;Torstai;10;16;26;11;2;13
96;02.06.2011;2011;06;09;Torstai;8;13;21;5;3;8
96;02.06.2011;2011;06;10;Torstai;18;24;42;17;10;27
96;02.06.2011;2011;06;11;Torstai;31;39;70;10;8;18
96;02.06.2011;2011;06;12;Torstai;36;29;65;12;11;23
96;02.06.2011;2011;06;13;Torstai;63;42;105;6;9;15
96;02.06.2011;2011;06;14;Torstai;32;41;73;3;7;10
96;02.06.2011;2011;06;15;Torstai;34;55;89;7;10;17
96;02.06.2011;2011;06;16;Torstai;30;36;66;5;12;17
96;02.06.2011;2011;06;17;Torstai;50;50;100;17;6;23
96;02.06.2011;2011;06;18;Torstai;44;40;84;17;9;26
96;02.06.2011;2011;06;19;Torstai;27;47;74;12;31;43
96;02.06.2011;2011;06;20;Torstai;46;35;81;6;13;19
96;02.06.2011;2011;06;21;Torstai;23;47;70;5;13;18
96;02.06.2011;2011;06;22;Torstai;16;20;36;2;3;5
96;02.06.2011;2011;06;23;Torstai;5;5;10;1;1;2
96;03.06.2011;2011;06;00;Perjantai;4;2;6;0;0;0
96;03.06.2011;2011;06;01;Perjantai;7;0;7;0;0;0
96;03.06.2011;2011;06;02;Perjantai;0;0;0;0;1;1
96;03.06.2011;2011;06;03;Perjantai;0;0;0;0;0;0
96;03.06.2011;2011;06;04;Perjantai;1;3;4;0;0;0
96;03.06.2011;2011;06;05;Perjantai;5;4;9;0;2;2
96;03.06.2011;2011;06;06;Perjantai;53;34;87;3;4;7
96;03.06.2011;2011;06;07;Perjantai;89;89;178;10;9;19
96;03.06.2011;2011;06;08;Perjantai;50;93;143;7;6;13
96;03.06.2011;2011;06;09;Perjantai;42;95;137;8;10;18
96;03.06.2011;2011;06;10;Perjantai;45;75;120;11;10;21
96;03.06.2011;2011;06;11;Perjantai;62;88;150;5;7;12
96;03.06.2011;2011;06;12;Perjantai;82;87;169;1;7;8
96;03.06.2011;2011;06;13;Perjantai;91;87;178;9;12;21
96;03.06.2011;2011;06;14;Perjantai;79;116;195;7;11;18
96;03.06.2011;2011;06;15;Perjantai;104;157;261;9;27;36
96;03.06.2011;2011;06;16;Perjantai;106;82;188;10;11;21
96;03.06.2011;2011;06;17;Perjantai;100;76;176;7;10;17
96;03.06.2011;2011;06;18;Perjantai;64;45;109;7;8;15
96;03.06.2011;2011;06;19;Perjantai;64;44;108;6;8;14
96;03.06.2011;2011;06;20;Perjantai;46;41;87;5;3;8
96;03.06.2011;2011;06;21;Perjantai;33;36;69;3;6;9
96;03.06.2011;2011;06;22;Perjantai;17;17;34;1;4;5
96;03.06.2011;2011;06;23;Perjantai;17;12;29;3;2;5
96;04.06.2011;2011;06;00;Lauantai;22;8;30;0;0;0
96;04.06.2011;2011;06;01;Lauantai;9;3;12;2;2;4
96;04.06.2011;2011;06;02;Lauantai;13;3;16;4;0;4
96;04.06.2011;2011;06;03;Lauantai;12;0;12;2;0;2
96;04.06.2011;2011;06;04;Lauantai;11;1;12;4;0;4
96;04.06.2011;2011;06;05;Lauantai;6;3;9;0;1;1
96;04.06.2011;2011;06;06;Lauantai;18;16;34;0;0;0
96;04.06.2011;2011;06;07;Lauantai;13;21;34;4;3;7
96;04.06.2011;2011;06;08;Lauantai;9;38;47;4;6;10
96;04.06.2011;2011;06;09;Lauantai;41;52;93;4;4;8
96;04.06.2011;2011;06;10;Lauantai;32;50;82;13;9;22
96;04.06.2011;2011;06;11;Lauantai;38;55;93;6;11;17
96;04.06.2011;2011;06;12;Lauantai;61;64;125;4;4;8
96;04.06.2011;2011;06;13;Lauantai;71;49;120;8;6;14
96;04.06.2011;2011;06;14;Lauantai;56;63;119;2;6;8
96;04.06.2011;2011;06;15;Lauantai;45;33;78;9;6;15
96;04.06.2011;2011;06;16;Lauantai;37;23;60;6;4;10
96;04.06.2011;2011;06;17;Lauantai;27;22;49;6;3;9
96;04.06.2011;2011;06;18;Lauantai;34;28;62;4;4;8
96;04.06.2011;2011;06;19;Lauantai;27;54;81;4;6;10
96;04.06.2011;2011;06;20;Lauantai;24;42;66;6;3;9
96;04.06.2011;2011;06;21;Lauantai;28;40;68;2;6;8
96;04.06.2011;2011;06;22;Lauantai;9;26;35;0;5;5
96;04.06.2011;2011;06;23;Lauantai;22;25;47;3;1;4
96;05.06.2011;2011;06;00;Sunnuntai;12;15;27;2;1;3
96;05.06.2011;2011;06;01;Sunnuntai;35;9;44;4;0;4
96;05.06.2011;2011;06;02;Sunnuntai;33;4;37;6;0;6
96;05.06.2011;2011;06;03;Sunnuntai;30;2;32;4;1;5
96;05.06.2011;2011;06;04;Sunnuntai;25;2;27;2;0;2
96;05.06.2011;2011;06;05;Sunnuntai;4;1;5;0;0;0
96;05.06.2011;2011;06;06;Sunnuntai;23;4;27;1;0;1
96;05.06.2011;2011;06;07;Sunnuntai;8;11;19;1;4;5
96;05.06.2011;2011;06;08;Sunnuntai;1;5;6;6;2;8
96;05.06.2011;2011;06;09;Sunnuntai;11;10;21;4;4;8
96;05.06.2011;2011;06;10;Sunnuntai;23;22;45;5;9;14
96;05.06.2011;2011;06;11;Sunnuntai;26;39;65;4;6;10
96;05.06.2011;2011;06;12;Sunnuntai;41;35;76;6;10;16
96;05.06.2011;2011;06;13;Sunnuntai;45;51;96;5;9;14
96;05.06.2011;2011;06;14;Sunnuntai;58;48;106;8;3;11
96;05.06.2011;2011;06;15;Sunnuntai;49;54;103;15;8;23
96;05.06.2011;2011;06;16;Sunnuntai;51;56;107;8;10;18
96;05.06.2011;2011;06;17;Sunnuntai;60;61;121;19;12;31
96;05.06.2011;2011;06;18;Sunnuntai;37;44;81;10;7;17
96;05.06.2011;2011;06;19;Sunnuntai;47;30;77;11;20;31
96;05.06.2011;2011;06;20;Sunnuntai;34;35;69;4;13;17
96;05.06.2011;2011;06;21;Sunnuntai;28;32;60;2;8;10
96;05.06.2011;2011;06;22;Sunnuntai;9;10;19;7;1;8
96;05.06.2011;2011;06;23;Sunnuntai;10;3;13;0;0;0
96;06.06.2011;2011;06;00;Maanantai;1;2;3;3;1;4
96;06.06.2011;2011;06;01;Maanantai;2;1;3;0;0;0
96;06.06.2011;2011;06;02;Maanantai;2;0;2;0;0;0
96;06.06.2011;2011;06;03;Maanantai;1;0;1;0;0;0
96;06.06.2011;2011;06;04;Maanantai;0;4;4;0;0;0
96;06.06.2011;2011;06;05;Maanantai;8;13;21;1;1;2
96;06.06.2011;2011;06;06;Maanantai;68;48;116;2;4;6
96;06.06.2011;2011;06;07;Maanantai;141;144;285;10;15;25
96;06.06.2011;2011;06;08;Maanantai;59;104;163;11;12;23
96;06.06.2011;2011;06;09;Maanantai;40;97;137;3;12;15
96;06.06.2011;2011;06;10;Maanantai;47;63;110;12;16;28
96;06.06.2011;2011;06;11;Maanantai;53;99;152;5;11;16
96;06.06.2011;2011;06;12;Maanantai;78;79;157;11;20;31
96;06.06.2011;2011;06;13;Maanantai;70;82;152;2;6;8
96;06.06.2011;2011;06;14;Maanantai;84;110;194;6;12;18
96;06.06.2011;2011;06;15;Maanantai;123;227;350;12;28;40
96;06.06.2011;2011;06;16;Maanantai;146;171;317;9;17;26
96;06.06.2011;2011;06;17;Maanantai;132;105;237;11;12;23
96;06.06.2011;2011;06;18;Maanantai;116;71;187;7;17;24
96;06.06.2011;2011;06;19;Maanantai;83;48;131;12;17;29
96;06.06.2011;2011;06;20;Maanantai;78;51;129;10;9;19
96;06.06.2011;2011;06;21;Maanantai;43;33;76;8;11;19
96;06.06.2011;2011;06;22;Maanantai;23;12;35;2;4;6
96;06.06.2011;2011;06;23;Maanantai;7;9;16;0;1;1
96;07.06.2011;2011;06;00;Tiistai;6;0;6;2;0;2
96;07.06.2011;2011;06;01;Tiistai;1;2;3;0;0;0
96;07.06.2011;2011;06;02;Tiistai;2;1;3;0;0;0
96;07.06.2011;2011;06;03;Tiistai;3;1;4;0;0;0
96;07.06.2011;2011;06;04;Tiistai;3;3;6;0;0;0
96;07.06.2011;2011;06;05;Tiistai;6;11;17;0;1;1
96;07.06.2011;2011;06;06;Tiistai;81;56;137;5;2;7
96;07.06.2011;2011;06;07;Tiistai;129;148;277;12;9;21
96;07.06.2011;2011;06;08;Tiistai;80;116;196;15;12;27
96;07.06.2011;2011;06;09;Tiistai;53;70;123;5;14;19
96;07.06.2011;2011;06;10;Tiistai;55;81;136;7;14;21
96;07.06.2011;2011;06;11;Tiistai;78;85;163;8;14;22
96;07.06.2011;2011;06;12;Tiistai;79;79;158;6;11;17
96;07.06.2011;2011;06;13;Tiistai;87;85;172;9;11;20
96;07.06.2011;2011;06;14;Tiistai;115;97;212;7;11;18
96;07.06.2011;2011;06;15;Tiistai;187;205;392;14;25;39
96;07.06.2011;2011;06;16;Tiistai;180;113;293;17;17;34
96;07.06.2011;2011;06;17;Tiistai;136;93;229;21;20;41
96;07.06.2011;2011;06;18;Tiistai;93;84;177;7;12;19
96;07.06.2011;2011;06;19;Tiistai;93;68;161;13;8;21
96;07.06.2011;2011;06;20;Tiistai;58;52;110;8;9;17
96;07.06.2011;2011;06;21;Tiistai;51;20;71;1;4;5
96;07.06.2011;2011;06;22;Tiistai;21;20;41;2;2;4
96;07.06.2011;2011;06;23;Tiistai;10;3;13;2;1;3
96;08.06.2011;2011;06;00;Keskiviikko;2;2;4;0;0;0
96;08.06.2011;2011;06;01;Keskiviikko;4;2;6;0;1;1
96;08.06.2011;2011;06;02;Keskiviikko;3;2;5;0;0;0
96;08.06.2011;2011;06;03;Keskiviikko;1;1;2;0;0;0
96;08.06.2011;2011;06;04;Keskiviikko;0;5;5;2;0;2
96;08.06.2011;2011;06;05;Keskiviikko;5;13;18;1;1;2
96;08.06.2011;2011;06;06;Keskiviikko;66;47;113;3;5;8
96;08.06.2011;2011;06;07;Keskiviikko;133;151;284;11;13;24
96;08.06.2011;2011;06;08;Keskiviikko;75;119;194;10;5;15
96;08.06.2011;2011;06;09;Keskiviikko;54;100;154;4;18;22
96;08.06.2011;2011;06;10;Keskiviikko;61;80;141;3;15;18
96;08.06.2011;2011;06;11;Keskiviikko;89;104;193;10;13;23
96;08.06.2011;2011;06;12;Keskiviikko;105;68;173;6;11;17
96;08.06.2011;2011;06;13;Keskiviikko;117;81;198;6;15;21
96;08.06.2011;2011;06;14;Keskiviikko;155;105;260;15;14;29
96;08.06.2011;2011;06;15;Keskiviikko;188;190;378;11;28;39
96;08.06.2011;2011;06;16;Keskiviikko;221;121;342;14;12;26
96;08.06.2011;2011;06;17;Keskiviikko;154;97;251;12;12;24
96;08.06.2011;2011;06;18;Keskiviikko;138;61;199;10;13;23
96;08.06.2011;2011;06;19;Keskiviikko;92;63;155;9;12;21
96;08.06.2011;2011;06;20;Keskiviikko;82;65;147;8;6;14
96;08.06.2011;2011;06;21;Keskiviikko;83;52;135;9;6;15
96;08.06.2011;2011;06;22;Keskiviikko;31;29;60;4;5;9
96;08.06.2011;2011;06;23;Keskiviikko;26;9;35;2;2;4
96;09.06.2011;2011;06;00;Torstai;16;6;22;0;0;0
96;09.06.2011;2011;06;01;Torstai;15;0;15;0;0;0
96;09.06.2011;2011;06;02;Torstai;3;0;3;0;0;0
96;09.06.2011;2011;06;03;Torstai;5;2;7;0;0;0
96;09.06.2011;2011;06;04;Torstai;6;8;14;0;0;0
96;09.06.2011;2011;06;05;Torstai;13;12;25;0;1;1
96;09.06.2011;2011;06;06;Torstai;70;52;122;4;3;7
96;09.06.2011;2011;06;07;Torstai;125;145;270;7;11;18
96;09.06.2011;2011;06;08;Torstai;74;113;187;9;16;25
96;09.06.2011;2011;06;09;Torstai;64;76;140;7;10;17
96;09.06.2011;2011;06;10;Torstai;56;95;151;4;13;17
96;09.06.2011;2011;06;11;Torstai;88;81;169;8;9;17
96;09.06.2011;2011;06;12;Torstai;90;58;148;6;9;15
96;09.06.2011;2011;06;13;Torstai;101;85;186;7;15;22
96;09.06.2011;2011;06;14;Torstai;135;113;248;5;16;21
96;09.06.2011;2011;06;15;Torstai;156;195;351;13;22;35
96;09.06.2011;2011;06;16;Torstai;196;133;329;15;27;42
96;09.06.2011;2011;06;17;Torstai;127;100;227;6;10;16
96;09.06.2011;2011;06;18;Torstai;99;96;195;9;9;18
96;09.06.2011;2011;06;19;Torstai;89;74;163;10;9;19
96;09.06.2011;2011;06;20;Torstai;95;56;151;10;9;19
96;09.06.2011;2011;06;21;Torstai;63;53;116;2;9;11
96;09.06.2011;2011;06;22;Torstai;31;15;46;3;1;4
96;09.06.2011;2011;06;23;Torstai;7;6;13;2;1;3
96;10.06.2011;2011;06;00;Perjantai;14;2;16;0;0;0
96;10.06.2011;2011;06;01;Perjantai;11;0;11;0;0;0
96;10.06.2011;2011;06;02;Perjantai;12;0;12;0;0;0
96;10.06.2011;2011;06;03;Perjantai;3;2;5;0;0;0
96;10.06.2011;2011;06;04;Perjantai;6;4;10;1;2;3
96;10.06.2011;2011;06;05;Perjantai;10;9;19;0;1;1
96;10.06.2011;2011;06;06;Perjantai;66;54;120;7;3;10
96;10.06.2011;2011;06;07;Perjantai;126;126;252;7;9;16
96;10.06.2011;2011;06;08;Perjantai;80;125;205;4;12;16
96;10.06.2011;2011;06;09;Perjantai;47;79;126;7;15;22
96;10.06.2011;2011;06;10;Perjantai;81;68;149;7;10;17
96;10.06.2011;2011;06;11;Perjantai;77;64;141;6;11;17
96;10.06.2011;2011;06;12;Perjantai;90;74;164;8;15;23
96;10.06.2011;2011;06;13;Perjantai;134;98;232;4;7;11
96;10.06.2011;2011;06;14;Perjantai;154;107;261;6;10;16
96;10.06.2011;2011;06;15;Perjantai;193;127;320;22;17;39
96;10.06.2011;2011;06;16;Perjantai;170;79;249;7;17;24
96;10.06.2011;2011;06;17;Perjantai;113;64;177;19;8;27
96;10.06.2011;2011;06;18;Perjantai;103;46;149;7;8;15
96;10.06.2011;2011;06;19;Perjantai;90;58;148;4;5;9
96;10.06.2011;2011;06;20;Perjantai;73;47;120;1;2;3
96;10.06.2011;2011;06;21;Perjantai;43;48;91;5;7;12
96;10.06.2011;2011;06;22;Perjantai;38;24;62;3;4;7
96;10.06.2011;2011;06;23;Perjantai;32;16;48;1;2;3
96;11.06.2011;2011;06;00;Lauantai;33;17;50;2;1;3
96;11.06.2011;2011;06;01;Lauantai;41;12;53;4;1;5
96;11.06.2011;2011;06;02;Lauantai;32;11;43;1;0;1
96;11.06.2011;2011;06;03;Lauantai;28;5;33;3;0;3
96;11.06.2011;2011;06;04;Lauantai;20;0;20;3;0;3
96;11.06.2011;2011;06;05;Lauantai;6;2;8;0;2;2
96;11.06.2011;2011;06;06;Lauantai;25;15;40;1;0;1
96;11.06.2011;2011;06;07;Lauantai;16;34;50;6;2;8
96;11.06.2011;2011;06;08;Lauantai;17;31;48;2;5;7
96;11.06.2011;2011;06;09;Lauantai;15;58;73;7;16;23
96;11.06.2011;2011;06;10;Lauantai;32;79;111;4;10;14
96;11.06.2011;2011;06;11;Lauantai;36;79;115;7;12;19
96;11.06.2011;2011;06;12;Lauantai;71;68;139;2;10;12
96;11.06.2011;2011;06;13;Lauantai;90;58;148;9;8;17
96;11.06.2011;2011;06;14;Lauantai;76;68;144;6;11;17
96;11.06.2011;2011;06;15;Lauantai;64;72;136;4;10;14
96;11.06.2011;2011;06;16;Lauantai;74;58;132;5;6;11
96;11.06.2011;2011;06;17;Lauantai;79;45;124;7;8;15
96;11.06.2011;2011;06;18;Lauantai;83;40;123;7;10;17
96;11.06.2011;2011;06;19;Lauantai;50;46;96;12;5;17
96;11.06.2011;2011;06;20;Lauantai;33;67;100;3;4;7
96;11.06.2011;2011;06;21;Lauantai;25;55;80;3;5;8
96;11.06.2011;2011;06;22;Lauantai;16;31;47;2;4;6
96;11.06.2011;2011;06;23;Lauantai;21;8;29;2;3;5
96;12.06.2011;2011;06;00;Sunnuntai;24;24;48;1;1;2
96;12.06.2011;2011;06;01;Sunnuntai;30;17;47;6;1;7
96;12.06.2011;2011;06;02;Sunnuntai;27;9;36;4;0;4
96;12.06.2011;2011;06;03;Sunnuntai;30;7;37;3;0;3
96;12.06.2011;2011;06;04;Sunnuntai;15;1;16;5;0;5
96;12.06.2011;2011;06;05;Sunnuntai;13;3;16;0;0;0
96;12.06.2011;2011;06;06;Sunnuntai;24;2;26;0;0;0
96;12.06.2011;2011;06;07;Sunnuntai;4;23;27;2;2;4
96;12.06.2011;2011;06;08;Sunnuntai;8;13;21;1;2;3
96;12.06.2011;2011;06;09;Sunnuntai;5;9;14;1;2;3
96;12.06.2011;2011;06;10;Sunnuntai;6;17;23;2;1;3
96;12.06.2011;2011;06;11;Sunnuntai;13;21;34;1;2;3
96;12.06.2011;2011;06;12;Sunnuntai;35;18;53;3;16;19
96;12.06.2011;2011;06;13;Sunnuntai;42;28;70;4;5;9
96;12.06.2011;2011;06;14;Sunnuntai;23;49;72;2;10;12
96;12.06.2011;2011;06;15;Sunnuntai;40;53;93;5;2;7
96;12.06.2011;2011;06;16;Sunnuntai;39;24;63;7;1;8
96;12.06.2011;2011;06;17;Sunnuntai;39;39;78;15;7;22
96;12.06.2011;2011;06;18;Sunnuntai;43;35;78;8;6;14
96;12.06.2011;2011;06;19;Sunnuntai;30;33;63;3;10;13
96;12.06.2011;2011;06;20;Sunnuntai;33;30;63;10;12;22
96;12.06.2011;2011;06;21;Sunnuntai;19;38;57;2;8;10
96;12.06.2011;2011;06;22;Sunnuntai;2;9;11;2;1;3
96;12.06.2011;2011;06;23;Sunnuntai;12;1;13;0;1;1
96;13.06.2011;2011;06;00;Maanantai;0;2;2;0;0;0
96;13.06.2011;2011;06;01;Maanantai;8;2;10;0;0;0
96;13.06.2011;2011;06;02;Maanantai;2;2;4;0;0;0
96;13.06.2011;2011;06;03;Maanantai;1;0;1;0;0;0
96;13.06.2011;2011;06;04;Maanantai;2;5;7;0;0;0
96;13.06.2011;2011;06;05;Maanantai;8;10;18;0;3;3
96;13.06.2011;2011;06;06;Maanantai;65;49;114;1;0;1
96;13.06.2011;2011;06;07;Maanantai;133;127;260;12;8;20
96;13.06.2011;2011;06;08;Maanantai;60;113;173;4;10;14
96;13.06.2011;2011;06;09;Maanantai;34;80;114;7;3;10
96;13.06.2011;2011;06;10;Maanantai;33;64;97;5;12;17
96;13.06.2011;2011;06;11;Maanantai;50;72;122;11;12;23
96;13.06.2011;2011;06;12;Maanantai;65;59;124;6;6;12
96;13.06.2011;2011;06;13;Maanantai;83;75;158;5;8;13
96;13.06.2011;2011;06;14;Maanantai;84;101;185;3;10;13
96;13.06.2011;2011;06;15;Maanantai;122;240;362;2;19;21
96;13.06.2011;2011;06;16;Maanantai;132;126;258;17;10;27
96;13.06.2011;2011;06;17;Maanantai;108;75;183;8;10;18
96;13.06.2011;2011;06;18;Maanantai;96;62;158;25;18;43
96;13.06.2011;2011;06;19;Maanantai;78;47;125;11;14;25
96;13.06.2011;2011;06;20;Maanantai;73;50;123;13;10;23
96;13.06.2011;2011;06;21;Maanantai;41;36;77;5;7;12
96;13.06.2011;2011;06;22;Maanantai;18;13;31;1;6;7
96;13.06.2011;2011;06;23;Maanantai;6;8;14;1;1;2
96;14.06.2011;2011;06;00;Tiistai;4;4;8;1;0;1
96;14.06.2011;2011;06;01;Tiistai;3;2;5;1;1;2
96;14.06.2011;2011;06;02;Tiistai;2;1;3;0;0;0
96;14.06.2011;2011;06;03;Tiistai;0;2;2;0;0;0
96;14.06.2011;2011;06;04;Tiistai;2;2;4;0;0;0
96;14.06.2011;2011;06;05;Tiistai;9;12;21;0;1;1
96;14.06.2011;2011;06;06;Tiistai;67;49;116;3;0;3
96;14.06.2011;2011;06;07;Tiistai;111;130;241;10;4;14
96;14.06.2011;2011;06;08;Tiistai;60;113;173;3;10;13
96;14.06.2011;2011;06;09;Tiistai;30;77;107;6;5;11
96;14.06.2011;2011;06;10;Tiistai;29;73;102;4;4;8
96;14.06.2011;2011;06;11;Tiistai;61;63;124;0;8;8
96;14.06.2011;2011;06;12;Tiistai;67;72;139;9;10;19
96;14.06.2011;2011;06;13;Tiistai;52;77;129;4;9;13
96;14.06.2011;2011;06;14;Tiistai;78;124;202;7;16;23
96;14.06.2011;2011;06;15;Tiistai;104;203;307;3;15;18
96;14.06.2011;2011;06;16;Tiistai;133;147;280;19;26;45
96;14.06.2011;2011;06;17;Tiistai;109;111;220;13;16;29
96;14.06.2011;2011;06;18;Tiistai;122;74;196;12;4;16
96;14.06.2011;2011;06;19;Tiistai;83;70;153;13;7;20
96;14.06.2011;2011;06;20;Tiistai;105;60;165;11;16;27
96;14.06.2011;2011;06;21;Tiistai;38;32;70;12;4;16
96;14.06.2011;2011;06;22;Tiistai;25;17;42;7;3;10
96;14.06.2011;2011;06;23;Tiistai;12;4;16;3;1;4
96;15.06.2011;2011;06;00;Keskiviikko;3;2;5;0;1;1
96;15.06.2011;2011;06;01;Keskiviikko;10;0;10;0;2;2
96;15.06.2011;2011;06;02;Keskiviikko;6;0;6;0;0;0
96;15.06.2011;2011;06;03;Keskiviikko;1;2;3;1;0;1
96;15.06.2011;2011;06;04;Keskiviikko;4;4;8;0;0;0
96;15.06.2011;2011;06;05;Keskiviikko;9;11;20;0;1;1
96;15.06.2011;2011;06;06;Keskiviikko;68;57;125;0;2;2
96;15.06.2011;2011;06;07;Keskiviikko;122;121;243;5;6;11
96;15.06.2011;2011;06;08;Keskiviikko;75;123;198;9;9;18
96;15.06.2011;2011;06;09;Keskiviikko;48;86;134;7;7;14
96;15.06.2011;2011;06;10;Keskiviikko;41;83;124;5;12;17
96;15.06.2011;2011;06;11;Keskiviikko;52;83;135;4;10;14
96;15.06.2011;2011;06;12;Keskiviikko;89;93;182;5;12;17
96;15.06.2011;2011;06;13;Keskiviikko;76;90;166;5;15;20
96;15.06.2011;2011;06;14;Keskiviikko;96;105;201;7;11;18
96;15.06.2011;2011;06;15;Keskiviikko;112;220;332;10;38;48
96;15.06.2011;2011;06;16;Keskiviikko;157;142;299;8;25;33
96;15.06.2011;2011;06;17;Keskiviikko;140;102;242;15;11;26
96;15.06.2011;2011;06;18;Keskiviikko;106;67;173;12;19;31
96;15.06.2011;2011;06;19;Keskiviikko;92;63;155;14;10;24
96;15.06.2011;2011;06;20;Keskiviikko;79;56;135;13;9;22
96;15.06.2011;2011;06;21;Keskiviikko;46;37;83;8;4;12
96;15.06.2011;2011;06;22;Keskiviikko;37;14;51;4;7;11
96;15.06.2011;2011;06;23;Keskiviikko;9;13;22;1;3;4
96;16.06.2011;2011;06;00;Torstai;9;0;9;0;2;2
96;16.06.2011;2011;06;01;Torstai;7;0;7;0;0;0
96;16.06.2011;2011;06;02;Torstai;8;0;8;0;0;0
96;16.06.2011;2011;06;03;Torstai;4;4;8;3;0;3
96;16.06.2011;2011;06;04;Torstai;2;7;9;1;2;3
96;16.06.2011;2011;06;05;Torstai;12;9;21;0;1;1
96;16.06.2011;2011;06;06;Torstai;68;45;113;8;0;8
96;16.06.2011;2011;06;07;Torstai;100;126;226;13;11;24
96;16.06.2011;2011;06;08;Torstai;64;117;181;8;7;15
96;16.06.2011;2011;06;09;Torstai;53;87;140;2;16;18
96;16.06.2011;2011;06;10;Torstai;40;75;115;4;10;14
96;16.06.2011;2011;06;11;Torstai;50;71;121;8;7;15
96;16.06.2011;2011;06;12;Torstai;97;76;173;6;11;17
96;16.06.2011;2011;06;13;Torstai;77;90;167;4;12;16
96;16.06.2011;2011;06;14;Torstai;82;117;199;2;14;16
96;16.06.2011;2011;06;15;Torstai;110;202;312;5;29;34
96;16.06.2011;2011;06;16;Torstai;136;129;265;11;19;30
96;16.06.2011;2011;06;17;Torstai;123;79;202;10;11;21
96;16.06.2011;2011;06;18;Torstai;112;62;174;11;16;27
96;16.06.2011;2011;06;19;Torstai;74;54;128;10;8;18
96;16.06.2011;2011;06;20;Torstai;58;31;89;9;10;19
96;16.06.2011;2011;06;21;Torstai;26;21;47;5;4;9
96;16.06.2011;2011;06;22;Torstai;9;13;22;0;1;1
96;16.06.2011;2011;06;23;Torstai;6;5;11;0;1;1
96;17.06.2011;2011;06;00;Perjantai;7;3;10;1;0;1
96;17.06.2011;2011;06;01;Perjantai;2;0;2;0;0;0
96;17.06.2011;2011;06;02;Perjantai;7;1;8;0;0;0
96;17.06.2011;2011;06;03;Perjantai;7;2;9;0;0;0
96;17.06.2011;2011;06;04;Perjantai;4;5;9;0;1;1
96;17.06.2011;2011;06;05;Perjantai;5;10;15;0;0;0
96;17.06.2011;2011;06;06;Perjantai;50;45;95;7;3;10
96;17.06.2011;2011;06;07;Perjantai;109;112;221;6;9;15
96;17.06.2011;2011;06;08;Perjantai;46;82;128;5;4;9
96;17.06.2011;2011;06;09;Perjantai;28;84;112;7;6;13
96;17.06.2011;2011;06;10;Perjantai;36;69;105;2;6;8
96;17.06.2011;2011;06;11;Perjantai;53;60;113;7;11;18
96;17.06.2011;2011;06;12;Perjantai;50;75;125;5;11;16
96;17.06.2011;2011;06;13;Perjantai;96;88;184;5;14;19
96;17.06.2011;2011;06;14;Perjantai;86;131;217;2;18;20
96;17.06.2011;2011;06;15;Perjantai;121;182;303;5;18;23
96;17.06.2011;2011;06;16;Perjantai;103;94;197;6;19;25
96;17.06.2011;2011;06;17;Perjantai;74;52;126;6;8;14
96;17.06.2011;2011;06;18;Perjantai;49;54;103;14;5;19
96;17.06.2011;2011;06;19;Perjantai;76;41;117;4;7;11
96;17.06.2011;2011;06;20;Perjantai;53;37;90;4;1;5
96;17.06.2011;2011;06;21;Perjantai;38;45;83;9;7;16
96;17.06.2011;2011;06;22;Perjantai;15;19;34;3;4;7
96;17.06.2011;2011;06;23;Perjantai;14;17;31;1;1;2
96;18.06.2011;2011;06;00;Lauantai;16;9;25;1;1;2
96;18.06.2011;2011;06;01;Lauantai;25;7;32;0;1;1
96;18.06.2011;2011;06;02;Lauantai;24;5;29;2;0;2
96;18.06.2011;2011;06;03;Lauantai;25;2;27;1;1;2
96;18.06.2011;2011;06;04;Lauantai;14;3;17;2;1;3
96;18.06.2011;2011;06;05;Lauantai;4;1;5;1;0;1
96;18.06.2011;2011;06;06;Lauantai;31;7;38;3;0;3
96;18.06.2011;2011;06;07;Lauantai;8;18;26;1;2;3
96;18.06.2011;2011;06;08;Lauantai;7;16;23;0;3;3
96;18.06.2011;2011;06;09;Lauantai;10;45;55;6;16;22
96;18.06.2011;2011;06;10;Lauantai;27;51;78;1;2;3
96;18.06.2011;2011;06;11;Lauantai;30;50;80;5;9;14
96;18.06.2011;2011;06;12;Lauantai;48;60;108;3;7;10
96;18.06.2011;2011;06;13;Lauantai;51;23;74;5;1;6
96;18.06.2011;2011;06;14;Lauantai;33;22;55;1;2;3
96;18.06.2011;2011;06;15;Lauantai;35;45;80;3;8;11
96;18.06.2011;2011;06;16;Lauantai;36;38;74;5;3;8
96;18.06.2011;2011;06;17;Lauantai;36;25;61;3;6;9
96;18.06.2011;2011;06;18;Lauantai;45;26;71;8;4;12
96;18.06.2011;2011;06;19;Lauantai;37;20;57;4;2;6
96;18.06.2011;2011;06;20;Lauantai;21;33;54;5;3;8
96;18.06.2011;2011;06;21;Lauantai;13;47;60;0;7;7
96;18.06.2011;2011;06;22;Lauantai;7;12;19;2;0;2
96;18.06.2011;2011;06;23;Lauantai;8;12;20;1;0;1
96;19.06.2011;2011;06;00;Sunnuntai;11;26;37;2;5;7
96;19.06.2011;2011;06;01;Sunnuntai;12;4;16;0;0;0
96;19.06.2011;2011;06;02;Sunnuntai;13;4;17;2;0;2
96;19.06.2011;2011;06;03;Sunnuntai;21;2;23;0;0;0
96;19.06.2011;2011;06;04;Sunnuntai;20;2;22;3;0;3
96;19.06.2011;2011;06;05;Sunnuntai;3;1;4;0;0;0
96;19.06.2011;2011;06;06;Sunnuntai;18;5;23;1;0;1
96;19.06.2011;2011;06;07;Sunnuntai;6;6;12;2;3;5
96;19.06.2011;2011;06;08;Sunnuntai;5;9;14;1;1;2
96;19.06.2011;2011;06;09;Sunnuntai;6;37;43;3;6;9
96;19.06.2011;2011;06;10;Sunnuntai;10;23;33;4;3;7
96;19.06.2011;2011;06;11;Sunnuntai;22;35;57;6;6;12
96;19.06.2011;2011;06;12;Sunnuntai;29;40;69;7;11;18
96;19.06.2011;2011;06;13;Sunnuntai;35;47;82;4;5;9
96;19.06.2011;2011;06;14;Sunnuntai;33;32;65;5;9;14
96;19.06.2011;2011;06;15;Sunnuntai;44;42;86;5;3;8
96;19.06.2011;2011;06;16;Sunnuntai;25;40;65;5;2;7
96;19.06.2011;2011;06;17;Sunnuntai;37;34;71;11;5;16
96;19.06.2011;2011;06;18;Sunnuntai;34;33;67;15;4;19
96;19.06.2011;2011;06;19;Sunnuntai;39;20;59;7;14;21
96;19.06.2011;2011;06;20;Sunnuntai;27;31;58;5;8;13
96;19.06.2011;2011;06;21;Sunnuntai;16;43;59;1;8;9
96;19.06.2011;2011;06;22;Sunnuntai;6;10;16;3;3;6
96;19.06.2011;2011;06;23;Sunnuntai;11;7;18;4;0;4
96;20.06.2011;2011;06;00;Maanantai;7;1;8;4;1;5
96;20.06.2011;2011;06;01;Maanantai;1;1;2;0;1;1
96;20.06.2011;2011;06;02;Maanantai;2;0;2;0;0;0
96;20.06.2011;2011;06;03;Maanantai;2;0;2;0;0;0
96;20.06.2011;2011;06;04;Maanantai;1;4;5;0;2;2
96;20.06.2011;2011;06;05;Maanantai;5;8;13;1;1;2
96;20.06.2011;2011;06;06;Maanantai;50;50;100;5;2;7
96;20.06.2011;2011;06;07;Maanantai;97;100;197;8;3;11
96;20.06.2011;2011;06;08;Maanantai;49;77;126;7;3;10
96;20.06.2011;2011;06;09;Maanantai;22;66;88;4;8;12
96;20.06.2011;2011;06;10;Maanantai;40;51;91;5;8;13
96;20.06.2011;2011;06;11;Maanantai;33;58;91;2;4;6
96;20.06.2011;2011;06;12;Maanantai;42;30;72;3;4;7
96;20.06.2011;2011;06;13;Maanantai;41;31;72;2;5;7
96;20.06.2011;2011;06;14;Maanantai;23;61;84;2;4;6
96;20.06.2011;2011;06;15;Maanantai;58;143;201;1;7;8
96;20.06.2011;2011;06;16;Maanantai;79;100;179;1;9;10
96;20.06.2011;2011;06;17;Maanantai;53;23;76;6;5;11
96;20.06.2011;2011;06;18;Maanantai;33;32;65;3;2;5
96;20.06.2011;2011;06;19;Maanantai;23;15;38;3;5;8
96;20.06.2011;2011;06;20;Maanantai;38;14;52;2;2;4
96;20.06.2011;2011;06;21;Maanantai;16;22;38;5;5;10
96;20.06.2011;2011;06;22;Maanantai;6;10;16;0;2;2
96;20.06.2011;2011;06;23;Maanantai;4;0;4;1;2;3
96;21.06.2011;2011;06;00;Tiistai;4;1;5;0;0;0
96;21.06.2011;2011;06;01;Tiistai;0;1;1;1;0;1
96;21.06.2011;2011;06;02;Tiistai;0;0;0;0;0;0
96;21.06.2011;2011;06;03;Tiistai;1;0;1;0;1;1
96;21.06.2011;2011;06;04;Tiistai;1;1;2;0;0;0
96;21.06.2011;2011;06;05;Tiistai;6;4;10;0;0;0
96;21.06.2011;2011;06;06;Tiistai;43;24;67;8;1;9
96;21.06.2011;2011;06;07;Tiistai;63;46;109;10;1;11
96;21.06.2011;2011;06;08;Tiistai;36;43;79;4;0;4
96;21.06.2011;2011;06;09;Tiistai;20;49;69;1;1;2
96;21.06.2011;2011;06;10;Tiistai;8;27;35;1;0;1
96;21.06.2011;2011;06;11;Tiistai;12;12;24;1;0;1
96;21.06.2011;2011;06;12;Tiistai;23;19;42;6;3;9
96;21.06.2011;2011;06;13;Tiistai;23;31;54;2;1;3
96;21.06.2011;2011;06;14;Tiistai;49;51;100;2;5;7
96;21.06.2011;2011;06;15;Tiistai;56;130;186;6;17;23
96;21.06.2011;2011;06;16;Tiistai;62;101;163;10;23;33
96;21.06.2011;2011;06;17;Tiistai;46;48;94;7;14;21
96;21.06.2011;2011;06;18;Tiistai;43;40;83;11;10;21
96;21.06.2011;2011;06;19;Tiistai;68;48;116;7;8;15
96;21.06.2011;2011;06;20;Tiistai;51;33;84;7;11;18
96;21.06.2011;2011;06;21;Tiistai;21;40;61;8;9;17
96;21.06.2011;2011;06;22;Tiistai;13;12;25;0;6;6
96;21.06.2011;2011;06;23;Tiistai;10;5;15;2;0;2
96;22.06.2011;2011;06;00;Keskiviikko;4;1;5;2;0;2
96;22.06.2011;2011;06;01;Keskiviikko;4;4;8;0;0;0
96;22.06.2011;2011;06;02;Keskiviikko;1;0;1;0;1;1
96;22.06.2011;2011;06;03;Keskiviikko;1;0;1;0;0;0
96;22.06.2011;2011;06;04;Keskiviikko;3;7;10;0;0;0
96;22.06.2011;2011;06;05;Keskiviikko;4;5;9;0;1;1
96;22.06.2011;2011;06;06;Keskiviikko;49;33;82;4;2;6
96;22.06.2011;2011;06;07;Keskiviikko;83;73;156;8;3;11
96;22.06.2011;2011;06;08;Keskiviikko;35;56;91;3;3;6
96;22.06.2011;2011;06;09;Keskiviikko;20;37;57;3;2;5
96;22.06.2011;2011;06;10;Keskiviikko;22;38;60;7;6;13
96;22.06.2011;2011;06;11;Keskiviikko;27;34;61;3;4;7
96;22.06.2011;2011;06;12;Keskiviikko;28;33;61;5;8;13
96;22.06.2011;2011;06;13;Keskiviikko;37;48;85;0;4;4
96;22.06.2011;2011;06;14;Keskiviikko;40;56;96;1;3;4
96;22.06.2011;2011;06;15;Keskiviikko;60;114;174;5;7;12
96;22.06.2011;2011;06;16;Keskiviikko;75;87;162;3;11;14
96;22.06.2011;2011;06;17;Keskiviikko;51;46;97;4;7;11
96;22.06.2011;2011;06;18;Keskiviikko;50;44;94;13;8;21
96;22.06.2011;2011;06;19;Keskiviikko;42;27;69;10;10;20
96;22.06.2011;2011;06;20;Keskiviikko;51;24;75;12;12;24
96;22.06.2011;2011;06;21;Keskiviikko;28;40;68;4;5;9
96;22.06.2011;2011;06;22;Keskiviikko;17;13;30;4;7;11
96;22.06.2011;2011;06;23;Keskiviikko;7;1;8;1;0;1
96;23.06.2011;2011;06;00;Torstai;4;2;6;0;1;1
96;23.06.2011;2011;06;01;Torstai;4;0;4;0;0;0
96;23.06.2011;2011;06;02;Torstai;7;0;7;0;1;1
96;23.06.2011;2011;06;03;Torstai;4;3;7;2;0;2
96;23.06.2011;2011;06;04;Torstai;1;6;7;1;1;2
96;23.06.2011;2011;06;05;Torstai;6;6;12;0;1;1
96;23.06.2011;2011;06;06;Torstai;55;38;93;5;3;8
96;23.06.2011;2011;06;07;Torstai;87;90;177;5;8;13
96;23.06.2011;2011;06;08;Torstai;43;90;133;3;3;6
96;23.06.2011;2011;06;09;Torstai;40;70;110;7;11;18
96;23.06.2011;2011;06;10;Torstai;40;56;96;4;12;16
96;23.06.2011;2011;06;11;Torstai;47;68;115;5;13;18
96;23.06.2011;2011;06;12;Torstai;70;85;155;8;11;19
96;23.06.2011;2011;06;13;Torstai;94;91;185;5;15;20
96;23.06.2011;2011;06;14;Torstai;98;113;211;9;20;29
96;23.06.2011;2011;06;15;Torstai;108;112;220;4;5;9
96;23.06.2011;2011;06;16;Torstai;94;93;187;0;1;1
96;23.06.2011;2011;06;17;Torstai;53;44;97;11;13;24
96;23.06.2011;2011;06;18;Torstai;43;37;80;2;9;11
96;23.06.2011;2011;06;19;Torstai;39;44;83;7;2;9
96;23.06.2011;2011;06;20;Torstai;42;24;66;7;5;12
96;23.06.2011;2011;06;21;Torstai;26;32;58;1;2;3
96;23.06.2011;2011;06;22;Torstai;22;17;39;2;4;6
96;23.06.2011;2011;06;23;Torstai;11;8;19;2;1;3
96;24.06.2011;2011;06;00;Perjantai;14;5;19;5;2;7
96;24.06.2011;2011;06;01;Perjantai;7;5;12;0;0;0
96;24.06.2011;2011;06;02;Perjantai;6;5;11;0;0;0
96;24.06.2011;2011;06;03;Perjantai;5;3;8;0;0;0
96;24.06.2011;2011;06;04;Perjantai;3;2;5;0;0;0
96;24.06.2011;2011;06;05;Perjantai;2;1;3;0;0;0
96;24.06.2011;2011;06;06;Perjantai;14;13;27;0;0;0
96;24.06.2011;2011;06;07;Perjantai;13;12;25;0;0;0
96;24.06.2011;2011;06;08;Perjantai;15;13;28;0;0;0
96;24.06.2011;2011;06;09;Perjantai;25;23;48;0;0;0
96;24.06.2011;2011;06;10;Perjantai;26;25;51;0;0;0
96;24.06.2011;2011;06;11;Perjantai;40;25;65;2;0;2
96;24.06.2011;2011;06;12;Perjantai;32;15;47;10;3;13
96;24.06.2011;2011;06;13;Perjantai;18;12;30;7;5;12
96;24.06.2011;2011;06;14;Perjantai;15;31;46;4;5;9
96;24.06.2011;2011;06;15;Perjantai;27;28;55;4;7;11
96;24.06.2011;2011;06;16;Perjantai;14;16;30;11;5;16
96;24.06.2011;2011;06;17;Perjantai;22;25;47;9;11;20
96;24.06.2011;2011;06;18;Perjantai;14;24;38;9;12;21
96;24.06.2011;2011;06;19;Perjantai;13;24;37;4;4;8
96;24.06.2011;2011;06;20;Perjantai;11;19;30;7;5;12
96;24.06.2011;2011;06;21;Perjantai;14;18;32;3;4;7
96;24.06.2011;2011;06;22;Perjantai;8;12;20;3;0;3
96;24.06.2011;2011;06;23;Perjantai;8;6;14;0;1;1
96;25.06.2011;2011;06;00;Lauantai;10;10;20;0;3;3
96;25.06.2011;2011;06;01;Lauantai;14;2;16;0;1;1
96;25.06.2011;2011;06;02;Lauantai;18;6;24;0;1;1
96;25.06.2011;2011;06;03;Lauantai;10;6;16;2;0;2
96;25.06.2011;2011;06;04;Lauantai;11;1;12;2;0;2
96;25.06.2011;2011;06;05;Lauantai;4;2;6;1;0;1
96;25.06.2011;2011;06;06;Lauantai;12;5;17;3;1;4
96;25.06.2011;2011;06;07;Lauantai;3;6;9;6;8;14
96;25.06.2011;2011;06;08;Lauantai;2;2;4;3;2;5
96;25.06.2011;2011;06;09;Lauantai;6;13;19;3;4;7
96;25.06.2011;2011;06;10;Lauantai;9;10;19;5;5;10
96;25.06.2011;2011;06;11;Lauantai;25;27;52;7;9;16
96;25.06.2011;2011;06;12;Lauantai;16;20;36;9;5;14
96;25.06.2011;2011;06;13;Lauantai;37;34;71;9;13;22
96;25.06.2011;2011;06;14;Lauantai;30;59;89;6;8;14
96;25.06.2011;2011;06;15;Lauantai;44;42;86;5;7;12
96;25.06.2011;2011;06;16;Lauantai;33;63;96;4;7;11
96;25.06.2011;2011;06;17;Lauantai;44;35;79;16;6;22
96;25.06.2011;2011;06;18;Lauantai;21;36;57;5;4;9
96;25.06.2011;2011;06;19;Lauantai;30;44;74;6;9;15
96;25.06.2011;2011;06;20;Lauantai;26;28;54;6;7;13
96;25.06.2011;2011;06;21;Lauantai;22;26;48;3;6;9
96;25.06.2011;2011;06;22;Lauantai;17;10;27;1;1;2
96;25.06.2011;2011;06;23;Lauantai;7;11;18;0;3;3
96;26.06.2011;2011;06;00;Sunnuntai;13;11;24;1;3;4
96;26.06.2011;2011;06;01;Sunnuntai;8;10;18;0;0;0
96;26.06.2011;2011;06;02;Sunnuntai;9;0;9;2;1;3
96;26.06.2011;2011;06;03;Sunnuntai;13;2;15;0;0;0
96;26.06.2011;2011;06;04;Sunnuntai;10;0;10;0;1;1
96;26.06.2011;2011;06;05;Sunnuntai;3;2;5;0;0;0
96;26.06.2011;2011;06;06;Sunnuntai;15;7;22;0;2;2
96;26.06.2011;2011;06;07;Sunnuntai;0;13;13;3;3;6
96;26.06.2011;2011;06;08;Sunnuntai;2;3;5;3;5;8
96;26.06.2011;2011;06;09;Sunnuntai;0;2;2;0;2;2
96;26.06.2011;2011;06;10;Sunnuntai;2;5;7;0;1;1
96;26.06.2011;2011;06;11;Sunnuntai;5;11;16;1;2;3
96;26.06.2011;2011;06;12;Sunnuntai;19;34;53;6;6;12
96;26.06.2011;2011;06;13;Sunnuntai;32;56;88;8;16;24
96;26.06.2011;2011;06;14;Sunnuntai;31;40;71;6;7;13
96;26.06.2011;2011;06;15;Sunnuntai;37;56;93;8;9;17
96;26.06.2011;2011;06;16;Sunnuntai;46;32;78;6;5;11
96;26.06.2011;2011;06;17;Sunnuntai;63;31;94;18;7;25
96;26.06.2011;2011;06;18;Sunnuntai;34;33;67;6;10;16
96;26.06.2011;2011;06;19;Sunnuntai;31;37;68;14;8;22
96;26.06.2011;2011;06;20;Sunnuntai;35;25;60;12;8;20
96;26.06.2011;2011;06;21;Sunnuntai;26;31;57;1;4;5
96;26.06.2011;2011;06;22;Sunnuntai;6;7;13;1;0;1
96;26.06.2011;2011;06;23;Sunnuntai;15;10;25;1;0;1
96;27.06.2011;2011;06;00;Maanantai;6;5;11;1;1;2
96;27.06.2011;2011;06;01;Maanantai;1;4;5;1;0;1
96;27.06.2011;2011;06;02;Maanantai;0;1;1;3;0;3
96;27.06.2011;2011;06;03;Maanantai;0;0;0;0;0;0
96;27.06.2011;2011;06;04;Maanantai;1;4;5;2;1;3
96;27.06.2011;2011;06;05;Maanantai;9;9;18;0;1;1
96;27.06.2011;2011;06;06;Maanantai;49;39;88;14;22;36
96;27.06.2011;2011;06;07;Maanantai;83;92;175;10;5;15
96;27.06.2011;2011;06;08;Maanantai;42;92;134;8;10;18
96;27.06.2011;2011;06;09;Maanantai;34;90;124;6;11;17
96;27.06.2011;2011;06;10;Maanantai;35;72;107;6;8;14
96;27.06.2011;2011;06;11;Maanantai;48;74;122;8;17;25
96;27.06.2011;2011;06;12;Maanantai;83;86;169;6;15;21
96;27.06.2011;2011;06;13;Maanantai;81;72;153;3;9;12
96;27.06.2011;2011;06;14;Maanantai;76;88;164;3;11;14
96;27.06.2011;2011;06;15;Maanantai;113;185;298;5;12;17
96;27.06.2011;2011;06;16;Maanantai;132;150;282;8;17;25
96;27.06.2011;2011;06;17;Maanantai;94;70;164;14;12;26
96;27.06.2011;2011;06;18;Maanantai;95;74;169;6;8;14
96;27.06.2011;2011;06;19;Maanantai;83;64;147;8;4;12
96;27.06.2011;2011;06;20;Maanantai;98;58;156;12;7;19
96;27.06.2011;2011;06;21;Maanantai;47;37;84;11;12;23
96;27.06.2011;2011;06;22;Maanantai;20;21;41;5;7;12
96;27.06.2011;2011;06;23;Maanantai;12;7;19;1;2;3
96;28.06.2011;2011;06;00;Tiistai;7;2;9;1;0;1
96;28.06.2011;2011;06;01;Tiistai;5;1;6;0;1;1
96;28.06.2011;2011;06;02;Tiistai;4;2;6;2;0;2
96;28.06.2011;2011;06;03;Tiistai;0;1;1;0;0;0
96;28.06.2011;2011;06;04;Tiistai;1;3;4;1;0;1
96;28.06.2011;2011;06;05;Tiistai;8;12;20;0;2;2
96;28.06.2011;2011;06;06;Tiistai;65;48;113;4;3;7
96;28.06.2011;2011;06;07;Tiistai;85;109;194;6;19;25
96;28.06.2011;2011;06;08;Tiistai;39;100;139;0;2;2
96;28.06.2011;2011;06;09;Tiistai;43;80;123;8;12;20
96;28.06.2011;2011;06;10;Tiistai;50;69;119;15;10;25
96;28.06.2011;2011;06;11;Tiistai;66;95;161;13;19;32
96;28.06.2011;2011;06;12;Tiistai;82;76;158;11;11;22
96;28.06.2011;2011;06;13;Tiistai;87;69;156;6;16;22
96;28.06.2011;2011;06;14;Tiistai;89;117;206;7;16;23
96;28.06.2011;2011;06;15;Tiistai;128;194;322;10;30;40
96;28.06.2011;2011;06;16;Tiistai;145;118;263;6;24;30
96;28.06.2011;2011;06;17;Tiistai;111;82;193;9;10;19
96;28.06.2011;2011;06;18;Tiistai;97;82;179;10;10;20
96;28.06.2011;2011;06;19;Tiistai;106;52;158;15;18;33
96;28.06.2011;2011;06;20;Tiistai;77;74;151;12;8;20
96;28.06.2011;2011;06;21;Tiistai;47;50;97;3;10;13
96;28.06.2011;2011;06;22;Tiistai;41;23;64;0;3;3
96;28.06.2011;2011;06;23;Tiistai;17;7;24;4;1;5
96;29.06.2011;2011;06;00;Keskiviikko;7;1;8;0;1;1
96;29.06.2011;2011;06;01;Keskiviikko;5;1;6;1;3;4
96;29.06.2011;2011;06;02;Keskiviikko;5;3;8;1;1;2
96;29.06.2011;2011;06;03;Keskiviikko;3;0;3;0;0;0
96;29.06.2011;2011;06;04;Keskiviikko;4;5;9;0;0;0
96;29.06.2011;2011;06;05;Keskiviikko;4;8;12;0;1;1
96;29.06.2011;2011;06;06;Keskiviikko;58;47;105;1;3;4
96;29.06.2011;2011;06;07;Keskiviikko;90;105;195;4;8;12
96;29.06.2011;2011;06;08;Keskiviikko;47;94;141;7;16;23
96;29.06.2011;2011;06;09;Keskiviikko;44;84;128;2;10;12
96;29.06.2011;2011;06;10;Keskiviikko;45;66;111;4;11;15
96;29.06.2011;2011;06;11;Keskiviikko;59;103;162;5;13;18
96;29.06.2011;2011;06;12;Keskiviikko;76;78;154;5;14;19
96;29.06.2011;2011;06;13;Keskiviikko;85;80;165;9;10;19
96;29.06.2011;2011;06;14;Keskiviikko;113;114;227;7;16;23
96;29.06.2011;2011;06;15;Keskiviikko;136;203;339;3;29;32
96;29.06.2011;2011;06;16;Keskiviikko;133;127;260;16;27;43
96;29.06.2011;2011;06;17;Keskiviikko;105;88;193;6;15;21
96;29.06.2011;2011;06;18;Keskiviikko;99;75;174;12;3;15
96;29.06.2011;2011;06;19;Keskiviikko;82;47;129;8;8;16
96;29.06.2011;2011;06;20;Keskiviikko;81;59;140;10;12;22
96;29.06.2011;2011;06;21;Keskiviikko;52;49;101;5;14;19
96;29.06.2011;2011;06;22;Keskiviikko;29;32;61;3;2;5
96;29.06.2011;2011;06;23;Keskiviikko;17;9;26;2;1;3
96;30.06.2011;2011;06;00;Torstai;14;6;20;0;0;0
96;30.06.2011;2011;06;01;Torstai;5;2;7;0;1;1
96;30.06.2011;2011;06;02;Torstai;17;1;18;2;4;6
96;30.06.2011;2011;06;03;Torstai;7;0;7;0;0;0
96;30.06.2011;2011;06;04;Torstai;6;3;9;2;3;5
96;30.06.2011;2011;06;05;Torstai;3;12;15;1;3;4
96;30.06.2011;2011;06;06;Torstai;66;50;116;3;5;8
96;30.06.2011;2011;06;07;Torstai;99;102;201;6;7;13
96;30.06.2011;2011;06;08;Torstai;36;99;135;8;7;15
96;30.06.2011;2011;06;09;Torstai;41;91;132;6;14;20
96;30.06.2011;2011;06;10;Torstai;54;77;131;5;12;17
96;30.06.2011;2011;06;11;Torstai;48;102;150;10;12;22
96;30.06.2011;2011;06;12;Torstai;76;63;139;7;11;18
96;30.06.2011;2011;06;13;Torstai;91;110;201;8;7;15
96;30.06.2011;2011;06;14;Torstai;111;109;220;7;17;24
96;30.06.2011;2011;06;15;Torstai;118;168;286;5;28;33
96;30.06.2011;2011;06;16;Torstai;133;124;257;5;19;24
96;30.06.2011;2011;06;17;Torstai;107;87;194;8;4;12
96;30.06.2011;2011;06;18;Torstai;117;74;191;21;15;36
96;30.06.2011;2011;06;19;Torstai;68;67;135;5;6;11
96;30.06.2011;2011;06;20;Torstai;86;54;140;7;10;17
96;30.06.2011;2011;06;21;Torstai;67;46;113;7;7;14
96;30.06.2011;2011;06;22;Torstai;19;20;39;1;4;5
96;30.06.2011;2011;06;23;Torstai;16;12;28;1;1;2
96;01.07.2011;2011;07;00;Perjantai;17;5;22;0;0;0
96;01.07.2011;2011;07;01;Perjantai;17;2;19;0;1;1
96;01.07.2011;2011;07;02;Perjantai;10;0;10;1;0;1
96;01.07.2011;2011;07;03;Perjantai;12;0;12;0;2;2
96;01.07.2011;2011;07;04;Perjantai;7;2;9;1;0;1
96;01.07.2011;2011;07;05;Perjantai;9;5;14;0;1;1
96;01.07.2011;2011;07;06;Perjantai;47;45;92;5;4;9
96;01.07.2011;2011;07;07;Perjantai;80;78;158;5;4;9
96;01.07.2011;2011;07;08;Perjantai;37;84;121;3;3;6
96;01.07.2011;2011;07;09;Perjantai;32;74;106;5;17;22
96;01.07.2011;2011;07;10;Perjantai;33;92;125;4;12;16
96;01.07.2011;2011;07;11;Perjantai;46;77;123;2;15;17
96;01.07.2011;2011;07;12;Perjantai;82;83;165;1;14;15
96;01.07.2011;2011;07;13;Perjantai;86;103;189;4;8;12
96;01.07.2011;2011;07;14;Perjantai;116;109;225;9;12;21
96;01.07.2011;2011;07;15;Perjantai;75;123;198;2;9;11
96;01.07.2011;2011;07;16;Perjantai;72;74;146;2;6;8
96;01.07.2011;2011;07;17;Perjantai;66;56;122;2;6;8
96;01.07.2011;2011;07;18;Perjantai;79;59;138;7;2;9
96;01.07.2011;2011;07;19;Perjantai;39;35;74;0;7;7
96;01.07.2011;2011;07;20;Perjantai;54;37;91;5;9;14
96;01.07.2011;2011;07;21;Perjantai;24;29;53;2;6;8
96;01.07.2011;2011;07;22;Perjantai;19;21;40;0;2;2
96;01.07.2011;2011;07;23;Perjantai;18;14;32;0;1;1
96;02.07.2011;2011;07;00;Lauantai;8;4;12;1;2;3
96;02.07.2011;2011;07;01;Lauantai;22;10;32;3;1;4
96;02.07.2011;2011;07;02;Lauantai;17;2;19;1;0;1
96;02.07.2011;2011;07;03;Lauantai;18;1;19;3;0;3
96;02.07.2011;2011;07;04;Lauantai;27;5;32;2;0;2
96;02.07.2011;2011;07;05;Lauantai;7;0;7;2;0;2
96;02.07.2011;2011;07;06;Lauantai;21;13;34;2;1;3
96;02.07.2011;2011;07;07;Lauantai;5;16;21;3;1;4
96;02.07.2011;2011;07;08;Lauantai;11;11;22;4;1;5
96;02.07.2011;2011;07;09;Lauantai;11;40;51;6;9;15
96;02.07.2011;2011;07;10;Lauantai;19;35;54;4;3;7
96;02.07.2011;2011;07;11;Lauantai;34;49;83;8;6;14
96;02.07.2011;2011;07;12;Lauantai;47;64;111;6;4;10
96;02.07.2011;2011;07;13;Lauantai;54;57;111;7;4;11
96;02.07.2011;2011;07;14;Lauantai;58;67;125;4;12;16
96;02.07.2011;2011;07;15;Lauantai;62;91;153;2;11;13
96;02.07.2011;2011;07;16;Lauantai;55;51;106;3;7;10
96;02.07.2011;2011;07;17;Lauantai;41;46;87;3;5;8
96;02.07.2011;2011;07;18;Lauantai;76;46;122;6;5;11
96;02.07.2011;2011;07;19;Lauantai;30;41;71;2;2;4
96;02.07.2011;2011;07;20;Lauantai;38;37;75;3;3;6
96;02.07.2011;2011;07;21;Lauantai;24;35;59;2;4;6
96;02.07.2011;2011;07;22;Lauantai;20;30;50;2;2;4
96;02.07.2011;2011;07;23;Lauantai;14;10;24;2;4;6
96;03.07.2011;2011;07;00;Sunnuntai;13;12;25;0;0;0
96;03.07.2011;2011;07;01;Sunnuntai;15;3;18;1;1;2
96;03.07.2011;2011;07;02;Sunnuntai;21;3;24;2;0;2
96;03.07.2011;2011;07;03;Sunnuntai;31;2;33;1;0;1
96;03.07.2011;2011;07;04;Sunnuntai;20;0;20;0;0;0
96;03.07.2011;2011;07;05;Sunnuntai;6;0;6;2;0;2
96;03.07.2011;2011;07;06;Sunnuntai;15;7;22;0;0;0
96;03.07.2011;2011;07;07;Sunnuntai;4;10;14;4;1;5
96;03.07.2011;2011;07;08;Sunnuntai;7;3;10;2;1;3
96;03.07.2011;2011;07;09;Sunnuntai;10;15;25;5;5;10
96;03.07.2011;2011;07;10;Sunnuntai;16;39;55;5;5;10
96;03.07.2011;2011;07;11;Sunnuntai;18;25;43;3;5;8
96;03.07.2011;2011;07;12;Sunnuntai;51;76;127;5;6;11
96;03.07.2011;2011;07;13;Sunnuntai;44;59;103;2;14;16
96;03.07.2011;2011;07;14;Sunnuntai;58;56;114;9;2;11
96;03.07.2011;2011;07;15;Sunnuntai;47;55;102;5;8;13
96;03.07.2011;2011;07;16;Sunnuntai;47;46;93;11;7;18
96;03.07.2011;2011;07;17;Sunnuntai;61;37;98;16;8;24
96;03.07.2011;2011;07;18;Sunnuntai;36;38;74;15;10;25
96;03.07.2011;2011;07;19;Sunnuntai;30;30;60;6;6;12
96;03.07.2011;2011;07;20;Sunnuntai;28;24;52;9;6;15
96;03.07.2011;2011;07;21;Sunnuntai;20;31;51;1;4;5
96;03.07.2011;2011;07;22;Sunnuntai;14;7;21;3;3;6
96;03.07.2011;2011;07;23;Sunnuntai;6;7;13;2;0;2
96;04.07.2011;2011;07;00;Maanantai;4;3;7;0;0;0
96;04.07.2011;2011;07;01;Maanantai;4;0;4;0;3;3
96;04.07.2011;2011;07;02;Maanantai;2;0;2;0;0;0
96;04.07.2011;2011;07;03;Maanantai;6;1;7;0;0;0
96;04.07.2011;2011;07;04;Maanantai;5;3;8;0;0;0
96;04.07.2011;2011;07;05;Maanantai;7;4;11;0;1;1
96;04.07.2011;2011;07;06;Maanantai;45;35;80;5;1;6
96;04.07.2011;2011;07;07;Maanantai;95;79;174;5;4;9
96;04.07.2011;2011;07;08;Maanantai;25;65;90;2;6;8
96;04.07.2011;2011;07;09;Maanantai;34;76;110;3;8;11
96;04.07.2011;2011;07;10;Maanantai;37;67;104;5;8;13
96;04.07.2011;2011;07;11;Maanantai;50;62;112;10;4;14
96;04.07.2011;2011;07;12;Maanantai;59;67;126;3;12;15
96;04.07.2011;2011;07;13;Maanantai;77;69;146;8;5;13
96;04.07.2011;2011;07;14;Maanantai;71;91;162;14;18;32
96;04.07.2011;2011;07;15;Maanantai;105;156;261;4;16;20
96;04.07.2011;2011;07;16;Maanantai;113;129;242;10;14;24
96;04.07.2011;2011;07;17;Maanantai;96;79;175;4;11;15
96;04.07.2011;2011;07;18;Maanantai;73;59;132;6;8;14
96;04.07.2011;2011;07;19;Maanantai;78;58;136;17;7;24
96;04.07.2011;2011;07;20;Maanantai;85;43;128;6;9;15
96;04.07.2011;2011;07;21;Maanantai;45;31;76;6;8;14
96;04.07.2011;2011;07;22;Maanantai;18;10;28;0;8;8
96;04.07.2011;2011;07;23;Maanantai;11;4;15;2;0;2
96;05.07.2011;2011;07;00;Tiistai;6;8;14;1;1;2
96;05.07.2011;2011;07;01;Tiistai;3;9;12;1;1;2
96;05.07.2011;2011;07;02;Tiistai;7;1;8;1;0;1
96;05.07.2011;2011;07;03;Tiistai;0;0;0;0;0;0
96;05.07.2011;2011;07;04;Tiistai;0;2;2;0;1;1
96;05.07.2011;2011;07;05;Tiistai;6;6;12;0;1;1
96;05.07.2011;2011;07;06;Tiistai;58;50;108;6;0;6
96;05.07.2011;2011;07;07;Tiistai;90;89;179;4;6;10
96;05.07.2011;2011;07;08;Tiistai;36;72;108;3;8;11
96;05.07.2011;2011;07;09;Tiistai;29;54;83;3;11;14
96;05.07.2011;2011;07;10;Tiistai;34;69;103;5;10;15
96;05.07.2011;2011;07;11;Tiistai;29;75;104;3;7;10
96;05.07.2011;2011;07;12;Tiistai;70;74;144;4;6;10
96;05.07.2011;2011;07;13;Tiistai;65;94;159;5;10;15
96;05.07.2011;2011;07;14;Tiistai;54;92;146;4;12;16
96;05.07.2011;2011;07;15;Tiistai;92;171;263;6;24;30
96;05.07.2011;2011;07;16;Tiistai;132;124;256;13;17;30
96;05.07.2011;2011;07;17;Tiistai;111;87;198;13;5;18
96;05.07.2011;2011;07;18;Tiistai;109;63;172;13;10;23
96;05.07.2011;2011;07;19;Tiistai;113;82;195;12;9;21
96;05.07.2011;2011;07;20;Tiistai;59;52;111;9;8;17
96;05.07.2011;2011;07;21;Tiistai;38;52;90;10;12;22
96;05.07.2011;2011;07;22;Tiistai;21;18;39;0;5;5
96;05.07.2011;2011;07;23;Tiistai;12;8;20;1;2;3
96;06.07.2011;2011;07;00;Keskiviikko;7;5;12;0;1;1
96;06.07.2011;2011;07;01;Keskiviikko;5;7;12;0;0;0
96;06.07.2011;2011;07;02;Keskiviikko;5;1;6;0;0;0
96;06.07.2011;2011;07;03;Keskiviikko;1;0;1;0;0;0
96;06.07.2011;2011;07;04;Keskiviikko;4;4;8;0;0;0
96;06.07.2011;2011;07;05;Keskiviikko;8;9;17;1;3;4
96;06.07.2011;2011;07;06;Keskiviikko;52;31;83;5;4;9
96;06.07.2011;2011;07;07;Keskiviikko;83;95;178;7;3;10
96;06.07.2011;2011;07;08;Keskiviikko;34;73;107;5;4;9
96;06.07.2011;2011;07;09;Keskiviikko;32;70;102;5;6;11
96;06.07.2011;2011;07;10;Keskiviikko;29;57;86;16;7;23
96;06.07.2011;2011;07;11;Keskiviikko;48;59;107;3;6;9
96;06.07.2011;2011;07;12;Keskiviikko;69;67;136;2;8;10
96;06.07.2011;2011;07;13;Keskiviikko;64;90;154;9;8;17
96;06.07.2011;2011;07;14;Keskiviikko;79;101;180;5;16;21
96;06.07.2011;2011;07;15;Keskiviikko;112;138;250;6;19;25
96;06.07.2011;2011;07;16;Keskiviikko;111;121;232;7;23;30
96;06.07.2011;2011;07;17;Keskiviikko;103;89;192;4;6;10
96;06.07.2011;2011;07;18;Keskiviikko;88;59;147;11;11;22
96;06.07.2011;2011;07;19;Keskiviikko;69;69;138;11;11;22
96;06.07.2011;2011;07;20;Keskiviikko;90;38;128;9;10;19
96;06.07.2011;2011;07;21;Keskiviikko;57;52;109;7;9;16
96;06.07.2011;2011;07;22;Keskiviikko;24;23;47;3;8;11
96;06.07.2011;2011;07;23;Keskiviikko;13;10;23;2;0;2
96;07.07.2011;2011;07;00;Torstai;12;7;19;1;1;2
96;07.07.2011;2011;07;01;Torstai;15;2;17;1;0;1
96;07.07.2011;2011;07;02;Torstai;9;1;10;1;0;1
96;07.07.2011;2011;07;03;Torstai;8;0;8;1;1;2
96;07.07.2011;2011;07;04;Torstai;3;1;4;1;0;1
96;07.07.2011;2011;07;05;Torstai;8;6;14;0;1;1
96;07.07.2011;2011;07;06;Torstai;59;40;99;4;3;7
96;07.07.2011;2011;07;07;Torstai;79;89;168;8;7;15
96;07.07.2011;2011;07;08;Torstai;31;93;124;6;9;15
96;07.07.2011;2011;07;09;Torstai;38;58;96;8;9;17
96;07.07.2011;2011;07;10;Torstai;29;72;101;7;12;19
96;07.07.2011;2011;07;11;Torstai;50;84;134;5;13;18
96;07.07.2011;2011;07;12;Torstai;59;95;154;3;15;18
96;07.07.2011;2011;07;13;Torstai;85;81;166;6;8;14
96;07.07.2011;2011;07;14;Torstai;95;110;205;3;14;17
96;07.07.2011;2011;07;15;Torstai;122;164;286;3;27;30
96;07.07.2011;2011;07;16;Torstai;114;128;242;9;16;25
96;07.07.2011;2011;07;17;Torstai;104;84;188;8;15;23
96;07.07.2011;2011;07;18;Torstai;98;115;213;10;21;31
96;07.07.2011;2011;07;19;Torstai;71;64;135;7;11;18
96;07.07.2011;2011;07;20;Torstai;100;54;154;28;15;43
96;07.07.2011;2011;07;21;Torstai;54;47;101;7;6;13
96;07.07.2011;2011;07;22;Torstai;27;40;67;4;5;9
96;07.07.2011;2011;07;23;Torstai;12;11;23;5;3;8
96;08.07.2011;2011;07;00;Perjantai;11;4;15;2;2;4
96;08.07.2011;2011;07;01;Perjantai;12;2;14;1;0;1
96;08.07.2011;2011;07;02;Perjantai;12;0;12;0;0;0
96;08.07.2011;2011;07;03;Perjantai;9;0;9;0;0;0
96;08.07.2011;2011;07;04;Perjantai;6;3;9;0;0;0
96;08.07.2011;2011;07;05;Perjantai;8;6;14;2;2;4
96;08.07.2011;2011;07;06;Perjantai;53;43;96;4;7;11
96;08.07.2011;2011;07;07;Perjantai;82;79;161;1;10;11
96;08.07.2011;2011;07;08;Perjantai;40;83;123;4;15;19
96;08.07.2011;2011;07;09;Perjantai;40;77;117;7;16;23
96;08.07.2011;2011;07;10;Perjantai;45;79;124;6;24;30
96;08.07.2011;2011;07;11;Perjantai;74;82;156;10;19;29
96;08.07.2011;2011;07;12;Perjantai;82;97;179;9;23;32
96;08.07.2011;2011;07;13;Perjantai;131;141;272;20;37;57
96;08.07.2011;2011;07;14;Perjantai;100;137;237;23;34;57
96;08.07.2011;2011;07;15;Perjantai;155;150;305;18;80;98
96;08.07.2011;2011;07;16;Perjantai;112;107;219;15;69;84
96;08.07.2011;2011;07;17;Perjantai;116;151;267;27;186;213
96;08.07.2011;2011;07;18;Perjantai;89;83;172;27;84;111
96;08.07.2011;2011;07;19;Perjantai;163;64;227;225;41;266
96;08.07.2011;2011;07;20;Perjantai;122;73;195;77;31;108
96;08.07.2011;2011;07;21;Perjantai;61;71;132;37;27;64
96;08.07.2011;2011;07;22;Perjantai;67;67;134;15;16;31
96;08.07.2011;2011;07;23;Perjantai;39;47;86;19;9;28
96;09.07.2011;2011;07;00;Lauantai;33;17;50;4;4;8
96;09.07.2011;2011;07;01;Lauantai;37;8;45;5;1;6
96;09.07.2011;2011;07;02;Lauantai;33;2;35;5;3;8
96;09.07.2011;2011;07;03;Lauantai;35;3;38;2;0;2
96;09.07.2011;2011;07;04;Lauantai;28;4;32;4;1;5
96;09.07.2011;2011;07;05;Lauantai;12;5;17;1;1;2
96;09.07.2011;2011;07;06;Lauantai;23;17;40;3;8;11
96;09.07.2011;2011;07;07;Lauantai;3;38;41;6;24;30
96;09.07.2011;2011;07;08;Lauantai;27;88;115;7;145;152
96;09.07.2011;2011;07;09;Lauantai;38;88;126;34;134;168
96;09.07.2011;2011;07;10;Lauantai;49;147;196;37;172;209
96;09.07.2011;2011;07;11;Lauantai;78;109;187;49;144;193
96;09.07.2011;2011;07;12;Lauantai;69;149;218;51;193;244
96;09.07.2011;2011;07;13;Lauantai;90;113;203;28;92;120
96;09.07.2011;2011;07;14;Lauantai;147;80;227;140;57;197
96;09.07.2011;2011;07;15;Lauantai;90;71;161;132;40;172
96;09.07.2011;2011;07;16;Lauantai;130;48;178;235;57;292
96;09.07.2011;2011;07;17;Lauantai;59;46;105;53;47;100
96;09.07.2011;2011;07;18;Lauantai;68;80;148;92;62;154
96;09.07.2011;2011;07;19;Lauantai;54;55;109;116;28;144
96;09.07.2011;2011;07;20;Lauantai;98;39;137;151;28;179
96;09.07.2011;2011;07;21;Lauantai;34;42;76;17;9;26
96;09.07.2011;2011;07;22;Lauantai;48;35;83;32;10;42
96;09.07.2011;2011;07;23;Lauantai;33;26;59;48;5;53
96;10.07.2011;2011;07;00;Sunnuntai;8;7;15;7;4;11
96;10.07.2011;2011;07;01;Sunnuntai;21;2;23;4;0;4
96;10.07.2011;2011;07;02;Sunnuntai;17;1;18;1;0;1
96;10.07.2011;2011;07;03;Sunnuntai;20;0;20;5;1;6
96;10.07.2011;2011;07;04;Sunnuntai;16;2;18;3;0;3
96;10.07.2011;2011;07;05;Sunnuntai;8;5;13;1;4;5
96;10.07.2011;2011;07;06;Sunnuntai;20;15;35;4;5;9
96;10.07.2011;2011;07;07;Sunnuntai;11;34;45;7;35;42
96;10.07.2011;2011;07;08;Sunnuntai;16;29;45;8;48;56
96;10.07.2011;2011;07;09;Sunnuntai;20;93;113;20;169;189
96;10.07.2011;2011;07;10;Sunnuntai;20;81;101;10;121;131
96;10.07.2011;2011;07;11;Sunnuntai;48;53;101;44;41;85
96;10.07.2011;2011;07;12;Sunnuntai;110;92;202;101;71;172
96;10.07.2011;2011;07;13;Sunnuntai;64;125;189;40;66;106
96;10.07.2011;2011;07;14;Sunnuntai;59;61;120;38;29;67
96;10.07.2011;2011;07;15;Sunnuntai;141;26;167;250;6;256
96;10.07.2011;2011;07;16;Sunnuntai;71;28;99;56;5;61
96;10.07.2011;2011;07;17;Sunnuntai;36;10;46;19;2;21
96;10.07.2011;2011;07;18;Sunnuntai;22;11;33;2;2;4
96;10.07.2011;2011;07;19;Sunnuntai;20;30;50;10;8;18
96;10.07.2011;2011;07;20;Sunnuntai;25;20;45;9;11;20
96;10.07.2011;2011;07;21;Sunnuntai;17;32;49;2;7;9
96;10.07.2011;2011;07;22;Sunnuntai;15;22;37;2;2;4
96;10.07.2011;2011;07;23;Sunnuntai;5;9;14;2;2;4
96;11.07.2011;2011;07;00;Maanantai;0;3;3;5;1;6
96;11.07.2011;2011;07;01;Maanantai;5;3;8;0;0;0
96;11.07.2011;2011;07;02;Maanantai;5;1;6;0;0;0
96;11.07.2011;2011;07;03;Maanantai;2;0;2;0;0;0
96;11.07.2011;2011;07;04;Maanantai;4;3;7;0;0;0
96;11.07.2011;2011;07;05;Maanantai;5;8;13;0;1;1
96;11.07.2011;2011;07;06;Maanantai;47;29;76;2;2;4
96;11.07.2011;2011;07;07;Maanantai;71;73;144;6;7;13
96;11.07.2011;2011;07;08;Maanantai;33;66;99;4;2;6
96;11.07.2011;2011;07;09;Maanantai;29;52;81;4;5;9
96;11.07.2011;2011;07;10;Maanantai;32;53;85;1;6;7
96;11.07.2011;2011;07;11;Maanantai;40;80;120;7;13;20
96;11.07.2011;2011;07;12;Maanantai;68;62;130;4;9;13
96;11.07.2011;2011;07;13;Maanantai;61;62;123;3;16;19
96;11.07.2011;2011;07;14;Maanantai;73;78;151;2;9;11
96;11.07.2011;2011;07;15;Maanantai;93;142;235;9;17;26
96;11.07.2011;2011;07;16;Maanantai;94;105;199;1;12;13
96;11.07.2011;2011;07;17;Maanantai;81;80;161;7;2;9
96;11.07.2011;2011;07;18;Maanantai;74;65;139;11;6;17
96;11.07.2011;2011;07;19;Maanantai;85;48;133;6;10;16
96;11.07.2011;2011;07;20;Maanantai;69;23;92;5;5;10
96;11.07.2011;2011;07;21;Maanantai;28;33;61;2;3;5
96;11.07.2011;2011;07;22;Maanantai;12;8;20;2;4;6
96;11.07.2011;2011;07;23;Maanantai;8;7;15;0;0;0
96;12.07.2011;2011;07;00;Tiistai;7;4;11;0;1;1
96;12.07.2011;2011;07;01;Tiistai;8;1;9;1;1;2
96;12.07.2011;2011;07;02;Tiistai;6;3;9;0;0;0
96;12.07.2011;2011;07;03;Tiistai;2;1;3;0;1;1
96;12.07.2011;2011;07;04;Tiistai;2;1;3;1;0;1
96;12.07.2011;2011;07;05;Tiistai;7;4;11;0;1;1
96;12.07.2011;2011;07;06;Tiistai;47;34;81;4;0;4
96;12.07.2011;2011;07;07;Tiistai;60;77;137;9;8;17
96;12.07.2011;2011;07;08;Tiistai;23;48;71;5;3;8
96;12.07.2011;2011;07;09;Tiistai;23;32;55;7;10;17
96;12.07.2011;2011;07;10;Tiistai;13;28;41;2;7;9
96;12.07.2011;2011;07;11;Tiistai;19;23;42;3;2;5
96;12.07.2011;2011;07;12;Tiistai;33;16;49;1;3;4
96;12.07.2011;2011;07;13;Tiistai;26;21;47;1;0;1
96;12.07.2011;2011;07;14;Tiistai;31;24;55;1;2;3
96;12.07.2011;2011;07;15;Tiistai;26;91;117;2;6;8
96;12.07.2011;2011;07;16;Tiistai;29;49;78;3;2;5
96;12.07.2011;2011;07;17;Tiistai;21;18;39;1;1;2
96;12.07.2011;2011;07;18;Tiistai;23;14;37;4;2;6
96;12.07.2011;2011;07;19;Tiistai;19;13;32;2;3;5
96;12.07.2011;2011;07;20;Tiistai;29;9;38;7;3;10
96;12.07.2011;2011;07;21;Tiistai;13;32;45;1;5;6
96;12.07.2011;2011;07;22;Tiistai;7;10;17;1;3;4
96;12.07.2011;2011;07;23;Tiistai;6;1;7;0;3;3
96;13.07.2011;2011;07;00;Keskiviikko;2;1;3;1;2;3
96;13.07.2011;2011;07;01;Keskiviikko;1;1;2;2;0;2
96;13.07.2011;2011;07;02;Keskiviikko;5;0;5;1;0;1
96;13.07.2011;2011;07;03;Keskiviikko;0;0;0;0;1;1
96;13.07.2011;2011;07;04;Keskiviikko;3;1;4;0;0;0
96;13.07.2011;2011;07;05;Keskiviikko;3;3;6;1;0;1
96;13.07.2011;2011;07;06;Keskiviikko;37;15;52;6;1;7
96;13.07.2011;2011;07;07;Keskiviikko;62;53;115;8;0;8
96;13.07.2011;2011;07;08;Keskiviikko;21;36;57;4;5;9
96;13.07.2011;2011;07;09;Keskiviikko;20;46;66;12;14;26
96;13.07.2011;2011;07;10;Keskiviikko;26;37;63;2;3;5
96;13.07.2011;2011;07;11;Keskiviikko;26;51;77;7;6;13
96;13.07.2011;2011;07;12;Keskiviikko;53;43;96;4;6;10
96;13.07.2011;2011;07;13;Keskiviikko;60;69;129;2;11;13
96;13.07.2011;2011;07;14;Keskiviikko;48;87;135;2;12;14
96;13.07.2011;2011;07;15;Keskiviikko;65;130;195;4;19;23
96;13.07.2011;2011;07;16;Keskiviikko;82;86;168;11;19;30
96;13.07.2011;2011;07;17;Keskiviikko;68;58;126;17;6;23
96;13.07.2011;2011;07;18;Keskiviikko;77;55;132;9;13;22
96;13.07.2011;2011;07;19;Keskiviikko;63;60;123;11;12;23
96;13.07.2011;2011;07;20;Keskiviikko;81;56;137;7;9;16
96;13.07.2011;2011;07;21;Keskiviikko;34;63;97;5;16;21
96;13.07.2011;2011;07;22;Keskiviikko;23;16;39;1;1;2
96;13.07.2011;2011;07;23;Keskiviikko;25;8;33;0;1;1
96;14.07.2011;2011;07;00;Torstai;20;6;26;0;0;0
96;14.07.2011;2011;07;01;Torstai;13;2;15;0;0;0
96;14.07.2011;2011;07;02;Torstai;18;0;18;3;0;3
96;14.07.2011;2011;07;03;Torstai;10;0;10;1;0;1
96;14.07.2011;2011;07;04;Torstai;8;0;8;0;0;0
96;14.07.2011;2011;07;05;Torstai;9;7;16;3;2;5
96;14.07.2011;2011;07;06;Torstai;53;27;80;5;2;7
96;14.07.2011;2011;07;07;Torstai;63;77;140;10;7;17
96;14.07.2011;2011;07;08;Torstai;34;68;102;4;6;10
96;14.07.2011;2011;07;09;Torstai;24;62;86;4;10;14
96;14.07.2011;2011;07;10;Torstai;40;50;90;2;4;6
96;14.07.2011;2011;07;11;Torstai;35;47;82;5;8;13
96;14.07.2011;2011;07;12;Torstai;50;68;118;6;9;15
96;14.07.2011;2011;07;13;Torstai;78;62;140;6;4;10
96;14.07.2011;2011;07;14;Torstai;69;94;163;6;7;13
96;14.07.2011;2011;07;15;Torstai;93;130;223;9;14;23
96;14.07.2011;2011;07;16;Torstai;109;101;210;3;9;12
96;14.07.2011;2011;07;17;Torstai;74;69;143;15;6;21
96;14.07.2011;2011;07;18;Torstai;67;52;119;14;14;28
96;14.07.2011;2011;07;19;Torstai;57;55;112;8;9;17
96;14.07.2011;2011;07;20;Torstai;45;56;101;5;8;13
96;14.07.2011;2011;07;21;Torstai;34;35;69;2;9;11
96;14.07.2011;2011;07;22;Torstai;26;29;55;1;1;2
96;14.07.2011;2011;07;23;Torstai;14;8;22;2;1;3
96;15.07.2011;2011;07;00;Perjantai;29;1;30;1;0;1
96;15.07.2011;2011;07;01;Perjantai;16;1;17;0;0;0
96;15.07.2011;2011;07;02;Perjantai;11;3;14;0;0;0
96;15.07.2011;2011;07;03;Perjantai;7;0;7;0;0;0
96;15.07.2011;2011;07;04;Perjantai;7;1;8;0;0;0
96;15.07.2011;2011;07;05;Perjantai;8;5;13;0;1;1
96;15.07.2011;2011;07;06;Perjantai;46;26;72;5;3;8
96;15.07.2011;2011;07;07;Perjantai;52;54;106;8;8;16
96;15.07.2011;2011;07;08;Perjantai;31;55;86;2;5;7
96;15.07.2011;2011;07;09;Perjantai;34;56;90;5;8;13
96;15.07.2011;2011;07;10;Perjantai;39;44;83;7;8;15
96;15.07.2011;2011;07;11;Perjantai;38;74;112;8;10;18
96;15.07.2011;2011;07;12;Perjantai;67;71;138;4;13;17
96;15.07.2011;2011;07;13;Perjantai;78;93;171;5;19;24
96;15.07.2011;2011;07;14;Perjantai;96;100;196;9;17;26
96;15.07.2011;2011;07;15;Perjantai;89;119;208;8;15;23
96;15.07.2011;2011;07;16;Perjantai;104;67;171;5;13;18
96;15.07.2011;2011;07;17;Perjantai;74;59;133;5;6;11
96;15.07.2011;2011;07;18;Perjantai;66;80;146;12;10;22
96;15.07.2011;2011;07;19;Perjantai;40;49;89;6;8;14
96;15.07.2011;2011;07;20;Perjantai;48;57;105;9;12;21
96;15.07.2011;2011;07;21;Perjantai;43;41;84;6;5;11
96;15.07.2011;2011;07;22;Perjantai;25;31;56;3;3;6
96;15.07.2011;2011;07;23;Perjantai;29;18;47;1;1;2
96;16.07.2011;2011;07;00;Lauantai;47;13;60;5;0;5
96;16.07.2011;2011;07;01;Lauantai;27;1;28;2;1;3
96;16.07.2011;2011;07;02;Lauantai;32;7;39;2;1;3
96;16.07.2011;2011;07;03;Lauantai;39;2;41;2;1;3
96;16.07.2011;2011;07;04;Lauantai;17;1;18;4;1;5
96;16.07.2011;2011;07;05;Lauantai;9;2;11;2;0;2
96;16.07.2011;2011;07;06;Lauantai;19;7;26;0;1;1
96;16.07.2011;2011;07;07;Lauantai;5;13;18;1;3;4
96;16.07.2011;2011;07;08;Lauantai;9;12;21;3;2;5
96;16.07.2011;2011;07;09;Lauantai;7;24;31;2;5;7
96;16.07.2011;2011;07;10;Lauantai;9;15;24;0;4;4
96;16.07.2011;2011;07;11;Lauantai;9;19;28;2;5;7
96;16.07.2011;2011;07;12;Lauantai;25;27;52;2;5;7
96;16.07.2011;2011;07;13;Lauantai;16;15;31;3;1;4
96;16.07.2011;2011;07;14;Lauantai;11;19;30;1;1;2
96;16.07.2011;2011;07;15;Lauantai;18;22;40;2;1;3
96;16.07.2011;2011;07;16;Lauantai;18;8;26;0;5;5
96;16.07.2011;2011;07;17;Lauantai;13;11;24;3;2;5
96;16.07.2011;2011;07;18;Lauantai;10;11;21;3;6;9
96;16.07.2011;2011;07;19;Lauantai;8;19;27;2;2;4
96;16.07.2011;2011;07;20;Lauantai;14;32;46;5;2;7
96;16.07.2011;2011;07;21;Lauantai;8;26;34;0;2;2
96;16.07.2011;2011;07;22;Lauantai;14;17;31;1;2;3
96;16.07.2011;2011;07;23;Lauantai;6;10;16;1;1;2
96;17.07.2011;2011;07;00;Sunnuntai;15;12;27;0;0;0
96;17.07.2011;2011;07;01;Sunnuntai;6;9;15;2;2;4
96;17.07.2011;2011;07;02;Sunnuntai;9;4;13;2;0;2
96;17.07.2011;2011;07;03;Sunnuntai;13;1;14;3;0;3
96;17.07.2011;2011;07;04;Sunnuntai;22;2;24;4;1;5
96;17.07.2011;2011;07;05;Sunnuntai;5;3;8;3;0;3
96;17.07.2011;2011;07;06;Sunnuntai;17;2;19;3;0;3
96;17.07.2011;2011;07;07;Sunnuntai;3;11;14;0;3;3
96;17.07.2011;2011;07;08;Sunnuntai;8;11;19;2;5;7
96;17.07.2011;2011;07;09;Sunnuntai;8;13;21;7;3;10
96;17.07.2011;2011;07;10;Sunnuntai;21;16;37;4;5;9
96;17.07.2011;2011;07;11;Sunnuntai;19;36;55;8;8;16
96;17.07.2011;2011;07;12;Sunnuntai;45;58;103;3;11;14
96;17.07.2011;2011;07;13;Sunnuntai;53;69;122;2;9;11
96;17.07.2011;2011;07;14;Sunnuntai;37;62;99;1;11;12
96;17.07.2011;2011;07;15;Sunnuntai;58;63;121;2;12;14
96;17.07.2011;2011;07;16;Sunnuntai;69;42;111;11;11;22
96;17.07.2011;2011;07;17;Sunnuntai;76;56;132;12;15;27
96;17.07.2011;2011;07;18;Sunnuntai;86;68;154;5;6;11
96;17.07.2011;2011;07;19;Sunnuntai;55;63;118;9;4;13
96;17.07.2011;2011;07;20;Sunnuntai;46;40;86;8;10;18
96;17.07.2011;2011;07;21;Sunnuntai;33;29;62;2;5;7
96;17.07.2011;2011;07;22;Sunnuntai;26;16;42;4;3;7
96;17.07.2011;2011;07;23;Sunnuntai;9;20;29;0;1;1
96;18.07.2011;2011;07;00;Maanantai;13;4;17;1;0;1
96;18.07.2011;2011;07;01;Maanantai;17;7;24;2;0;2
96;18.07.2011;2011;07;02;Maanantai;3;4;7;4;0;4
96;18.07.2011;2011;07;03;Maanantai;4;1;5;0;0;0
96;18.07.2011;2011;07;04;Maanantai;16;5;21;0;0;0
96;18.07.2011;2011;07;05;Maanantai;7;2;9;2;2;4
96;18.07.2011;2011;07;06;Maanantai;43;30;73;1;0;1
96;18.07.2011;2011;07;07;Maanantai;67;61;128;8;9;17
96;18.07.2011;2011;07;08;Maanantai;21;50;71;0;1;1
96;18.07.2011;2011;07;09;Maanantai;26;66;92;5;9;14
96;18.07.2011;2011;07;10;Maanantai;19;65;84;1;4;5
96;18.07.2011;2011;07;11;Maanantai;43;80;123;8;7;15
96;18.07.2011;2011;07;12;Maanantai;50;70;120;8;7;15
96;18.07.2011;2011;07;13;Maanantai;67;66;133;6;6;12
96;18.07.2011;2011;07;14;Maanantai;91;86;177;9;10;19
96;18.07.2011;2011;07;15;Maanantai;81;166;247;5;17;22
96;18.07.2011;2011;07;16;Maanantai;110;85;195;7;22;29
96;18.07.2011;2011;07;17;Maanantai;89;79;168;7;7;14
96;18.07.2011;2011;07;18;Maanantai;73;67;140;8;7;15
96;18.07.2011;2011;07;19;Maanantai;71;64;135;9;12;21
96;18.07.2011;2011;07;20;Maanantai;73;37;110;20;5;25
96;18.07.2011;2011;07;21;Maanantai;49;38;87;3;9;12
96;18.07.2011;2011;07;22;Maanantai;22;7;29;4;3;7
96;18.07.2011;2011;07;23;Maanantai;12;8;20;0;3;3
96;19.07.2011;2011;07;00;Tiistai;5;1;6;2;0;2
96;19.07.2011;2011;07;01;Tiistai;2;0;2;1;0;1
96;19.07.2011;2011;07;02;Tiistai;3;2;5;0;0;0
96;19.07.2011;2011;07;03;Tiistai;0;1;1;0;0;0
96;19.07.2011;2011;07;04;Tiistai;3;1;4;1;0;1
96;19.07.2011;2011;07;05;Tiistai;6;8;14;0;1;1
96;19.07.2011;2011;07;06;Tiistai;56;28;84;2;1;3
96;19.07.2011;2011;07;07;Tiistai;74;59;133;7;7;14
96;19.07.2011;2011;07;08;Tiistai;34;56;90;3;5;8
96;19.07.2011;2011;07;09;Tiistai;25;67;92;9;8;17
96;19.07.2011;2011;07;10;Tiistai;40;59;99;5;12;17
96;19.07.2011;2011;07;11;Tiistai;40;76;116;4;10;14
96;19.07.2011;2011;07;12;Tiistai;52;36;88;6;2;8
96;19.07.2011;2011;07;13;Tiistai;38;32;70;3;4;7
96;19.07.2011;2011;07;14;Tiistai;38;38;76;3;3;6
96;19.07.2011;2011;07;15;Tiistai;61;119;180;4;5;9
96;19.07.2011;2011;07;16;Tiistai;58;62;120;2;7;9
96;19.07.2011;2011;07;17;Tiistai;43;32;75;10;9;19
96;19.07.2011;2011;07;18;Tiistai;49;32;81;5;10;15
96;19.07.2011;2011;07;19;Tiistai;47;35;82;5;7;12
96;19.07.2011;2011;07;20;Tiistai;29;24;53;2;9;11
96;19.07.2011;2011;07;21;Tiistai;38;19;57;5;7;12
96;19.07.2011;2011;07;22;Tiistai;15;7;22;2;7;9
96;19.07.2011;2011;07;23;Tiistai;7;10;17;0;0;0
96;20.07.2011;2011;07;00;Keskiviikko;6;4;10;0;1;1
96;20.07.2011;2011;07;01;Keskiviikko;2;1;3;1;0;1
96;20.07.2011;2011;07;02;Keskiviikko;7;1;8;0;0;0
96;20.07.2011;2011;07;03;Keskiviikko;1;5;6;1;0;1
96;20.07.2011;2011;07;04;Keskiviikko;1;1;2;1;1;2
96;20.07.2011;2011;07;05;Keskiviikko;4;5;9;1;2;3
96;20.07.2011;2011;07;06;Keskiviikko;52;21;73;3;3;6
96;20.07.2011;2011;07;07;Keskiviikko;65;56;121;5;9;14
96;20.07.2011;2011;07;08;Keskiviikko;36;48;84;2;7;9
96;20.07.2011;2011;07;09;Keskiviikko;22;62;84;7;7;14
96;20.07.2011;2011;07;10;Keskiviikko;42;59;101;7;13;20
96;20.07.2011;2011;07;11;Keskiviikko;48;75;123;6;11;17
96;20.07.2011;2011;07;12;Keskiviikko;54;90;144;8;13;21
96;20.07.2011;2011;07;13;Keskiviikko;88;63;151;7;6;13
96;20.07.2011;2011;07;14;Keskiviikko;80;70;150;5;15;20
96;20.07.2011;2011;07;15;Keskiviikko;102;146;248;5;19;24
96;20.07.2011;2011;07;16;Keskiviikko;98;107;205;22;17;39
96;20.07.2011;2011;07;17;Keskiviikko;82;92;174;9;8;17
96;20.07.2011;2011;07;18;Keskiviikko;91;103;194;12;13;25
96;20.07.2011;2011;07;19;Keskiviikko;72;66;138;5;6;11
96;20.07.2011;2011;07;20;Keskiviikko;88;74;162;12;6;18
96;20.07.2011;2011;07;21;Keskiviikko;49;38;87;8;9;17
96;20.07.2011;2011;07;22;Keskiviikko;35;22;57;1;4;5
96;20.07.2011;2011;07;23;Keskiviikko;20;11;31;0;5;5
96;21.07.2011;2011;07;00;Torstai;28;5;33;4;0;4
96;21.07.2011;2011;07;01;Torstai;27;5;32;1;0;1
96;21.07.2011;2011;07;02;Torstai;10;1;11;0;0;0
96;21.07.2011;2011;07;03;Torstai;10;1;11;0;0;0
96;21.07.2011;2011;07;04;Torstai;4;0;4;3;0;3
96;21.07.2011;2011;07;05;Torstai;9;8;17;1;2;3
96;21.07.2011;2011;07;06;Torstai;44;27;71;2;1;3
96;21.07.2011;2011;07;07;Torstai;64;64;128;7;3;10
96;21.07.2011;2011;07;08;Torstai;28;42;70;5;1;6
96;21.07.2011;2011;07;09;Torstai;31;53;84;4;5;9
96;21.07.2011;2011;07;10;Torstai;23;57;80;2;10;12
96;21.07.2011;2011;07;11;Torstai;38;48;86;4;0;4
96;21.07.2011;2011;07;12;Torstai;56;60;116;1;7;8
96;21.07.2011;2011;07;13;Torstai;58;49;107;2;6;8
96;21.07.2011;2011;07;14;Torstai;58;54;112;2;7;9
96;21.07.2011;2011;07;15;Torstai;65;125;190;4;19;23
96;21.07.2011;2011;07;16;Torstai;75;101;176;12;3;15
96;21.07.2011;2011;07;17;Torstai;62;31;93;4;5;9
96;21.07.2011;2011;07;18;Torstai;48;30;78;3;5;8
96;21.07.2011;2011;07;19;Torstai;37;24;61;3;6;9
96;21.07.2011;2011;07;20;Torstai;39;29;68;6;6;12
96;21.07.2011;2011;07;21;Torstai;26;30;56;7;10;17
96;21.07.2011;2011;07;22;Torstai;9;8;17;2;3;5
96;21.07.2011;2011;07;23;Torstai;4;5;9;1;3;4
96;22.07.2011;2011;07;00;Perjantai;4;1;5;0;0;0
96;22.07.2011;2011;07;01;Perjantai;2;3;5;2;0;2
96;22.07.2011;2011;07;02;Perjantai;7;1;8;0;0;0
96;22.07.2011;2011;07;03;Perjantai;3;3;6;1;0;1
96;22.07.2011;2011;07;04;Perjantai;2;4;6;0;0;0
96;22.07.2011;2011;07;05;Perjantai;5;7;12;1;1;2
96;22.07.2011;2011;07;06;Perjantai;36;15;51;2;2;4
96;22.07.2011;2011;07;07;Perjantai;46;35;81;2;2;4
96;22.07.2011;2011;07;08;Perjantai;12;23;35;1;0;1
96;22.07.2011;2011;07;09;Perjantai;10;22;32;1;1;2
96;22.07.2011;2011;07;10;Perjantai;13;24;37;1;3;4
96;22.07.2011;2011;07;11;Perjantai;13;57;70;4;4;8
96;22.07.2011;2011;07;12;Perjantai;37;64;101;5;5;10
96;22.07.2011;2011;07;13;Perjantai;64;76;140;3;3;6
96;22.07.2011;2011;07;14;Perjantai;54;89;143;3;7;10
96;22.07.2011;2011;07;15;Perjantai;70;120;190;12;19;31
96;22.07.2011;2011;07;16;Perjantai;85;57;142;3;3;6
96;22.07.2011;2011;07;17;Perjantai;64;54;118;8;9;17
96;22.07.2011;2011;07;18;Perjantai;69;59;128;4;9;13
96;22.07.2011;2011;07;19;Perjantai;58;46;104;17;6;23
96;22.07.2011;2011;07;20;Perjantai;51;50;101;4;7;11
96;22.07.2011;2011;07;21;Perjantai;24;57;81;2;6;8
96;22.07.2011;2011;07;22;Perjantai;20;20;40;1;4;5
96;22.07.2011;2011;07;23;Perjantai;21;18;39;0;1;1
96;23.07.2011;2011;07;00;Lauantai;16;5;21;6;0;6
96;23.07.2011;2011;07;01;Lauantai;20;2;22;1;1;2
96;23.07.2011;2011;07;02;Lauantai;30;4;34;2;0;2
96;23.07.2011;2011;07;03;Lauantai;30;4;34;3;0;3
96;23.07.2011;2011;07;04;Lauantai;17;4;21;1;2;3
96;23.07.2011;2011;07;05;Lauantai;8;4;12;1;0;1
96;23.07.2011;2011;07;06;Lauantai;15;10;25;3;1;4
96;23.07.2011;2011;07;07;Lauantai;2;13;15;2;2;4
96;23.07.2011;2011;07;08;Lauantai;8;12;20;0;2;2
96;23.07.2011;2011;07;09;Lauantai;14;41;55;2;5;7
96;23.07.2011;2011;07;10;Lauantai;19;46;65;2;7;9
96;23.07.2011;2011;07;11;Lauantai;41;54;95;5;10;15
96;23.07.2011;2011;07;12;Lauantai;55;54;109;5;4;9
96;23.07.2011;2011;07;13;Lauantai;61;68;129;7;7;14
96;23.07.2011;2011;07;14;Lauantai;68;52;120;8;14;22
96;23.07.2011;2011;07;15;Lauantai;73;71;144;8;3;11
96;23.07.2011;2011;07;16;Lauantai;78;47;125;18;7;25
96;23.07.2011;2011;07;17;Lauantai;72;37;109;28;6;34
96;23.07.2011;2011;07;18;Lauantai;51;40;91;20;8;28
96;23.07.2011;2011;07;19;Lauantai;20;37;57;4;4;8
96;23.07.2011;2011;07;20;Lauantai;35;40;75;3;3;6
96;23.07.2011;2011;07;21;Lauantai;20;51;71;1;6;7
96;23.07.2011;2011;07;22;Lauantai;20;27;47;1;3;4
96;23.07.2011;2011;07;23;Lauantai;17;21;38;2;4;6
96;24.07.2011;2011;07;00;Sunnuntai;15;29;44;0;1;1
96;24.07.2011;2011;07;01;Sunnuntai;32;2;34;2;0;2
96;24.07.2011;2011;07;02;Sunnuntai;27;9;36;5;0;5
96;24.07.2011;2011;07;03;Sunnuntai;40;2;42;5;0;5
96;24.07.2011;2011;07;04;Sunnuntai;13;1;14;3;0;3
96;24.07.2011;2011;07;05;Sunnuntai;8;1;9;0;0;0
96;24.07.2011;2011;07;06;Sunnuntai;14;12;26;2;0;2
96;24.07.2011;2011;07;07;Sunnuntai;4;14;18;1;1;2
96;24.07.2011;2011;07;08;Sunnuntai;5;6;11;1;1;2
96;24.07.2011;2011;07;09;Sunnuntai;6;7;13;4;1;5
96;24.07.2011;2011;07;10;Sunnuntai;16;23;39;3;9;12
96;24.07.2011;2011;07;11;Sunnuntai;17;32;49;0;6;6
96;24.07.2011;2011;07;12;Sunnuntai;41;55;96;6;7;13
96;24.07.2011;2011;07;13;Sunnuntai;40;38;78;3;2;5
96;24.07.2011;2011;07;14;Sunnuntai;19;9;28;0;1;1
96;24.07.2011;2011;07;15;Sunnuntai;25;32;57;3;3;6
96;24.07.2011;2011;07;16;Sunnuntai;17;18;35;5;8;13
96;24.07.2011;2011;07;17;Sunnuntai;36;36;72;9;2;11
96;24.07.2011;2011;07;18;Sunnuntai;23;11;34;5;3;8
96;24.07.2011;2011;07;19;Sunnuntai;13;19;32;3;4;7
96;24.07.2011;2011;07;20;Sunnuntai;21;24;45;9;4;13
96;24.07.2011;2011;07;21;Sunnuntai;16;26;42;1;8;9
96;24.07.2011;2011;07;22;Sunnuntai;9;14;23;1;2;3
96;24.07.2011;2011;07;23;Sunnuntai;2;7;9;4;3;7
96;25.07.2011;2011;07;00;Maanantai;5;3;8;0;4;4
96;25.07.2011;2011;07;01;Maanantai;0;1;1;0;0;0
96;25.07.2011;2011;07;02;Maanantai;1;0;1;0;0;0
96;25.07.2011;2011;07;03;Maanantai;4;0;4;0;0;0
96;25.07.2011;2011;07;04;Maanantai;4;2;6;0;0;0
96;25.07.2011;2011;07;05;Maanantai;8;4;12;0;2;2
96;25.07.2011;2011;07;06;Maanantai;54;31;85;7;1;8
96;25.07.2011;2011;07;07;Maanantai;75;70;145;3;8;11
96;25.07.2011;2011;07;08;Maanantai;34;46;80;4;7;11
96;25.07.2011;2011;07;09;Maanantai;24;61;85;5;5;10
96;25.07.2011;2011;07;10;Maanantai;31;53;84;4;8;12
96;25.07.2011;2011;07;11;Maanantai;45;76;121;5;13;18
96;25.07.2011;2011;07;12;Maanantai;77;59;136;5;12;17
96;25.07.2011;2011;07;13;Maanantai;82;75;157;5;13;18
96;25.07.2011;2011;07;14;Maanantai;68;96;164;6;9;15
96;25.07.2011;2011;07;15;Maanantai;105;142;247;8;16;24
96;25.07.2011;2011;07;16;Maanantai;110;109;219;7;11;18
96;25.07.2011;2011;07;17;Maanantai;92;65;157;14;14;28
96;25.07.2011;2011;07;18;Maanantai;89;65;154;7;7;14
96;25.07.2011;2011;07;19;Maanantai;70;54;124;14;4;18
96;25.07.2011;2011;07;20;Maanantai;73;41;114;7;7;14
96;25.07.2011;2011;07;21;Maanantai;47;36;83;4;7;11
96;25.07.2011;2011;07;22;Maanantai;27;22;49;0;10;10
96;25.07.2011;2011;07;23;Maanantai;19;5;24;2;1;3
96;26.07.2011;2011;07;00;Tiistai;10;4;14;2;0;2
96;26.07.2011;2011;07;01;Tiistai;9;3;12;0;0;0
96;26.07.2011;2011;07;02;Tiistai;4;0;4;0;0;0
96;26.07.2011;2011;07;03;Tiistai;0;2;2;0;0;0
96;26.07.2011;2011;07;04;Tiistai;1;2;3;0;0;0
96;26.07.2011;2011;07;05;Tiistai;4;7;11;1;1;2
96;26.07.2011;2011;07;06;Tiistai;53;27;80;4;0;4
96;26.07.2011;2011;07;07;Tiistai;71;69;140;8;9;17
96;26.07.2011;2011;07;08;Tiistai;28;63;91;3;5;8
96;26.07.2011;2011;07;09;Tiistai;32;46;78;8;9;17
96;26.07.2011;2011;07;10;Tiistai;24;62;86;4;10;14
96;26.07.2011;2011;07;11;Tiistai;45;76;121;6;9;15
96;26.07.2011;2011;07;12;Tiistai;67;69;136;7;6;13
96;26.07.2011;2011;07;13;Tiistai;73;54;127;1;10;11
96;26.07.2011;2011;07;14;Tiistai;72;85;157;4;5;9
96;26.07.2011;2011;07;15;Tiistai;70;150;220;3;19;22
96;26.07.2011;2011;07;16;Tiistai;114;126;240;6;9;15
96;26.07.2011;2011;07;17;Tiistai;82;71;153;13;14;27
96;26.07.2011;2011;07;18;Tiistai;70;70;140;4;10;14
96;26.07.2011;2011;07;19;Tiistai;81;61;142;6;8;14
96;26.07.2011;2011;07;20;Tiistai;67;37;104;11;14;25
96;26.07.2011;2011;07;21;Tiistai;39;41;80;3;7;10
96;26.07.2011;2011;07;22;Tiistai;18;18;36;1;4;5
96;26.07.2011;2011;07;23;Tiistai;18;4;22;1;5;6
96;27.07.2011;2011;07;00;Keskiviikko;4;3;7;1;0;1
96;27.07.2011;2011;07;01;Keskiviikko;10;0;10;3;0;3
96;27.07.2011;2011;07;02;Keskiviikko;5;3;8;0;0;0
96;27.07.2011;2011;07;03;Keskiviikko;0;1;1;0;0;0
96;27.07.2011;2011;07;04;Keskiviikko;1;2;3;0;0;0
96;27.07.2011;2011;07;05;Keskiviikko;8;5;13;0;1;1
96;27.07.2011;2011;07;06;Keskiviikko;50;25;75;4;1;5
96;27.07.2011;2011;07;07;Keskiviikko;67;59;126;11;8;19
96;27.07.2011;2011;07;08;Keskiviikko;25;59;84;4;8;12
96;27.07.2011;2011;07;09;Keskiviikko;34;64;98;1;5;6
96;27.07.2011;2011;07;10;Keskiviikko;29;54;83;4;8;12
96;27.07.2011;2011;07;11;Keskiviikko;27;93;120;3;6;9
96;27.07.2011;2011;07;12;Keskiviikko;65;83;148;10;20;30
96;27.07.2011;2011;07;13;Keskiviikko;90;61;151;3;3;6
96;27.07.2011;2011;07;14;Keskiviikko;76;77;153;7;9;16
96;27.07.2011;2011;07;15;Keskiviikko;94;199;293;4;18;22
96;27.07.2011;2011;07;16;Keskiviikko;112;92;204;4;12;16
96;27.07.2011;2011;07;17;Keskiviikko;101;79;180;14;10;24
96;27.07.2011;2011;07;18;Keskiviikko;92;81;173;8;11;19
96;27.07.2011;2011;07;19;Keskiviikko;80;53;133;3;7;10
96;27.07.2011;2011;07;20;Keskiviikko;109;64;173;12;5;17
96;27.07.2011;2011;07;21;Keskiviikko;59;61;120;5;11;16
96;27.07.2011;2011;07;22;Keskiviikko;33;17;50;6;3;9
96;27.07.2011;2011;07;23;Keskiviikko;13;17;30;4;2;6
96;28.07.2011;2011;07;00;Torstai;22;8;30;0;3;3
96;28.07.2011;2011;07;01;Torstai;18;1;19;1;0;1
96;28.07.2011;2011;07;02;Torstai;13;4;17;2;0;2
96;28.07.2011;2011;07;03;Torstai;6;2;8;0;0;0
96;28.07.2011;2011;07;04;Torstai;9;2;11;0;0;0
96;28.07.2011;2011;07;05;Torstai;4;6;10;0;1;1
96;28.07.2011;2011;07;06;Torstai;52;27;79;5;2;7
96;28.07.2011;2011;07;07;Torstai;57;84;141;5;3;8
96;28.07.2011;2011;07;08;Torstai;37;67;104;7;10;17
96;28.07.2011;2011;07;09;Torstai;40;47;87;5;6;11
96;28.07.2011;2011;07;10;Torstai;34;75;109;2;5;7
96;28.07.2011;2011;07;11;Torstai;49;76;125;3;3;6
96;28.07.2011;2011;07;12;Torstai;62;89;151;6;12;18
96;28.07.2011;2011;07;13;Torstai;93;64;157;4;7;11
96;28.07.2011;2011;07;14;Torstai;90;109;199;3;13;16
96;28.07.2011;2011;07;15;Torstai;106;187;293;6;30;36
96;28.07.2011;2011;07;16;Torstai;102;124;226;7;17;24
96;28.07.2011;2011;07;17;Torstai;90;79;169;7;12;19
96;28.07.2011;2011;07;18;Torstai;78;74;152;9;9;18
96;28.07.2011;2011;07;19;Torstai;79;60;139;7;6;13
96;28.07.2011;2011;07;20;Torstai;71;50;121;13;9;22
96;28.07.2011;2011;07;21;Torstai;50;30;80;8;4;12
96;28.07.2011;2011;07;22;Torstai;35;24;59;3;1;4
96;28.07.2011;2011;07;23;Torstai;20;24;44;3;0;3
96;29.07.2011;2011;07;00;Perjantai;10;2;12;2;0;2
96;29.07.2011;2011;07;01;Perjantai;16;0;16;1;0;1
96;29.07.2011;2011;07;02;Perjantai;7;1;8;0;0;0
96;29.07.2011;2011;07;03;Perjantai;13;2;15;1;0;1
96;29.07.2011;2011;07;04;Perjantai;6;1;7;0;0;0
96;29.07.2011;2011;07;05;Perjantai;8;3;11;0;1;1
96;29.07.2011;2011;07;06;Perjantai;48;33;81;3;1;4
96;29.07.2011;2011;07;07;Perjantai;54;65;119;9;5;14
96;29.07.2011;2011;07;08;Perjantai;29;59;88;6;2;8
96;29.07.2011;2011;07;09;Perjantai;30;56;86;4;8;12
96;29.07.2011;2011;07;10;Perjantai;23;54;77;3;8;11
96;29.07.2011;2011;07;11;Perjantai;46;91;137;2;12;14
96;29.07.2011;2011;07;12;Perjantai;72;73;145;4;6;10
96;29.07.2011;2011;07;13;Perjantai;59;91;150;2;13;15
96;29.07.2011;2011;07;14;Perjantai;73;122;195;6;13;19
96;29.07.2011;2011;07;15;Perjantai;79;140;219;1;7;8
96;29.07.2011;2011;07;16;Perjantai;78;105;183;9;8;17
96;29.07.2011;2011;07;17;Perjantai;77;88;165;6;11;17
96;29.07.2011;2011;07;18;Perjantai;59;81;140;2;6;8
96;29.07.2011;2011;07;19;Perjantai;38;69;107;7;8;15
96;29.07.2011;2011;07;20;Perjantai;40;81;121;8;8;16
96;29.07.2011;2011;07;21;Perjantai;41;62;103;3;14;17
96;29.07.2011;2011;07;22;Perjantai;27;24;51;2;3;5
96;29.07.2011;2011;07;23;Perjantai;33;21;54;2;1;3
96;30.07.2011;2011;07;00;Lauantai;72;4;76;3;1;4
96;30.07.2011;2011;07;01;Lauantai;65;9;74;10;0;10
96;30.07.2011;2011;07;02;Lauantai;52;3;55;8;0;8
96;30.07.2011;2011;07;03;Lauantai;44;4;48;3;0;3
96;30.07.2011;2011;07;04;Lauantai;32;7;39;4;0;4
96;30.07.2011;2011;07;05;Lauantai;13;7;20;3;1;4
96;30.07.2011;2011;07;06;Lauantai;20;15;35;5;1;6
96;30.07.2011;2011;07;07;Lauantai;3;14;17;1;2;3
96;30.07.2011;2011;07;08;Lauantai;8;16;24;2;2;4
96;30.07.2011;2011;07;09;Lauantai;21;60;81;6;10;16
96;30.07.2011;2011;07;10;Lauantai;23;65;88;4;3;7
96;30.07.2011;2011;07;11;Lauantai;39;66;105;8;8;16
96;30.07.2011;2011;07;12;Lauantai;62;87;149;12;12;24
96;30.07.2011;2011;07;13;Lauantai;75;95;170;5;12;17
96;30.07.2011;2011;07;14;Lauantai;71;104;175;2;10;12
96;30.07.2011;2011;07;15;Lauantai;57;70;127;9;10;19
96;30.07.2011;2011;07;16;Lauantai;58;77;135;7;8;15
96;30.07.2011;2011;07;17;Lauantai;90;52;142;10;7;17
96;30.07.2011;2011;07;18;Lauantai;55;59;114;3;4;7
96;30.07.2011;2011;07;19;Lauantai;51;61;112;7;7;14
96;30.07.2011;2011;07;20;Lauantai;20;46;66;3;5;8
96;30.07.2011;2011;07;21;Lauantai;20;54;74;1;0;1
96;30.07.2011;2011;07;22;Lauantai;29;29;58;2;0;2
96;30.07.2011;2011;07;23;Lauantai;32;14;46;3;3;6
96;31.07.2011;2011;07;00;Sunnuntai;52;20;72;3;1;4
96;31.07.2011;2011;07;01;Sunnuntai;65;5;70;0;0;0
96;31.07.2011;2011;07;02;Sunnuntai;62;6;68;9;0;9
96;31.07.2011;2011;07;03;Sunnuntai;59;6;65;9;1;10
96;31.07.2011;2011;07;04;Sunnuntai;37;2;39;10;0;10
96;31.07.2011;2011;07;05;Sunnuntai;11;0;11;2;1;3
96;31.07.2011;2011;07;06;Sunnuntai;13;3;16;3;0;3
96;31.07.2011;2011;07;07;Sunnuntai;2;12;14;1;0;1
96;31.07.2011;2011;07;08;Sunnuntai;8;10;18;1;2;3
96;31.07.2011;2011;07;09;Sunnuntai;14;14;28;8;7;15
96;31.07.2011;2011;07;10;Sunnuntai;10;34;44;5;6;11
96;31.07.2011;2011;07;11;Sunnuntai;27;35;62;5;11;16
96;31.07.2011;2011;07;12;Sunnuntai;59;79;138;5;11;16
96;31.07.2011;2011;07;13;Sunnuntai;62;74;136;3;10;13
96;31.07.2011;2011;07;14;Sunnuntai;42;64;106;7;9;16
96;31.07.2011;2011;07;15;Sunnuntai;58;66;124;4;12;16
96;31.07.2011;2011;07;16;Sunnuntai;74;46;120;17;15;32
96;31.07.2011;2011;07;17;Sunnuntai;83;54;137;29;10;39
96;31.07.2011;2011;07;18;Sunnuntai;54;55;109;15;8;23
96;31.07.2011;2011;07;19;Sunnuntai;38;33;71;14;7;21
96;31.07.2011;2011;07;20;Sunnuntai;40;41;81;5;12;17
96;31.07.2011;2011;07;21;Sunnuntai;39;41;80;3;9;12
96;31.07.2011;2011;07;22;Sunnuntai;13;15;28;1;2;3
96;31.07.2011;2011;07;23;Sunnuntai;6;6;12;2;2;4
96;01.08.2011;2011;08;00;Maanantai;7;1;8;2;0;2
96;01.08.2011;2011;08;01;Maanantai;2;0;2;0;0;0
96;01.08.2011;2011;08;02;Maanantai;1;0;1;0;0;0
96;01.08.2011;2011;08;03;Maanantai;1;0;1;1;0;1
96;01.08.2011;2011;08;04;Maanantai;2;3;5;1;0;1
96;01.08.2011;2011;08;05;Maanantai;8;10;18;1;1;2
96;01.08.2011;2011;08;06;Maanantai;54;30;84;3;2;5
96;01.08.2011;2011;08;07;Maanantai;98;97;195;8;7;15
96;01.08.2011;2011;08;08;Maanantai;47;110;157;5;11;16
96;01.08.2011;2011;08;09;Maanantai;32;79;111;3;3;6
96;01.08.2011;2011;08;10;Maanantai;28;58;86;2;15;17
96;01.08.2011;2011;08;11;Maanantai;51;92;143;4;7;11
96;01.08.2011;2011;08;12;Maanantai;76;91;167;7;4;11
96;01.08.2011;2011;08;13;Maanantai;95;78;173;13;11;24
96;01.08.2011;2011;08;14;Maanantai;78;93;171;6;13;19
96;01.08.2011;2011;08;15;Maanantai;141;161;302;3;21;24
96;01.08.2011;2011;08;16;Maanantai;152;159;311;11;15;26
96;01.08.2011;2011;08;17;Maanantai;99;101;200;13;21;34
96;01.08.2011;2011;08;18;Maanantai;92;66;158;12;10;22
96;01.08.2011;2011;08;19;Maanantai;83;56;139;4;12;16
96;01.08.2011;2011;08;20;Maanantai;91;30;121;13;10;23
96;01.08.2011;2011;08;21;Maanantai;51;33;84;12;7;19
96;01.08.2011;2011;08;22;Maanantai;25;13;38;1;2;3
96;01.08.2011;2011;08;23;Maanantai;11;3;14;1;3;4
96;02.08.2011;2011;08;00;Tiistai;6;1;7;0;1;1
96;02.08.2011;2011;08;01;Tiistai;4;3;7;0;1;1
96;02.08.2011;2011;08;02;Tiistai;3;0;3;0;0;0
96;02.08.2011;2011;08;03;Tiistai;2;0;2;0;0;0
96;02.08.2011;2011;08;04;Tiistai;3;0;3;1;0;1
96;02.08.2011;2011;08;05;Tiistai;8;6;14;0;2;2
96;02.08.2011;2011;08;06;Tiistai;60;26;86;2;1;3
96;02.08.2011;2011;08;07;Tiistai;94;114;208;6;7;13
96;02.08.2011;2011;08;08;Tiistai;53;80;133;2;11;13
96;02.08.2011;2011;08;09;Tiistai;28;74;102;8;6;14
96;02.08.2011;2011;08;10;Tiistai;39;68;107;5;17;22
96;02.08.2011;2011;08;11;Tiistai;47;87;134;3;14;17
96;02.08.2011;2011;08;12;Tiistai;86;95;181;12;15;27
96;02.08.2011;2011;08;13;Tiistai;96;85;181;9;12;21
96;02.08.2011;2011;08;14;Tiistai;59;93;152;4;6;10
96;02.08.2011;2011;08;15;Tiistai;100;185;285;3;22;25
96;02.08.2011;2011;08;16;Tiistai;163;116;279;6;18;24
96;02.08.2011;2011;08;17;Tiistai;97;62;159;11;6;17
96;02.08.2011;2011;08;18;Tiistai;96;75;171;8;15;23
96;02.08.2011;2011;08;19;Tiistai;80;47;127;12;13;25
96;02.08.2011;2011;08;20;Tiistai;69;30;99;11;17;28
96;02.08.2011;2011;08;21;Tiistai;47;48;95;2;5;7
96;02.08.2011;2011;08;22;Tiistai;26;13;39;5;7;12
96;02.08.2011;2011;08;23;Tiistai;16;10;26;0;1;1
96;03.08.2011;2011;08;00;Keskiviikko;3;1;4;2;0;2
96;03.08.2011;2011;08;01;Keskiviikko;4;1;5;0;0;0
96;03.08.2011;2011;08;02;Keskiviikko;6;0;6;0;0;0
96;03.08.2011;2011;08;03;Keskiviikko;1;0;1;0;0;0
96;03.08.2011;2011;08;04;Keskiviikko;1;2;3;1;0;1
96;03.08.2011;2011;08;05;Keskiviikko;4;10;14;0;1;1
96;03.08.2011;2011;08;06;Keskiviikko;57;38;95;2;3;5
96;03.08.2011;2011;08;07;Keskiviikko;89;105;194;6;10;16
96;03.08.2011;2011;08;08;Keskiviikko;55;98;153;3;8;11
96;03.08.2011;2011;08;09;Keskiviikko;30;77;107;5;12;17
96;03.08.2011;2011;08;10;Keskiviikko;39;52;91;9;10;19
96;03.08.2011;2011;08;11;Keskiviikko;51;75;126;0;17;17
96;03.08.2011;2011;08;12;Keskiviikko;74;89;163;11;16;27
96;03.08.2011;2011;08;13;Keskiviikko;84;80;164;6;11;17
96;03.08.2011;2011;08;14;Keskiviikko;89;115;204;6;13;19
96;03.08.2011;2011;08;15;Keskiviikko;103;195;298;4;19;23
96;03.08.2011;2011;08;16;Keskiviikko;143;118;261;5;17;22
96;03.08.2011;2011;08;17;Keskiviikko;92;71;163;12;12;24
96;03.08.2011;2011;08;18;Keskiviikko;112;63;175;12;9;21
96;03.08.2011;2011;08;19;Keskiviikko;75;61;136;11;14;25
96;03.08.2011;2011;08;20;Keskiviikko;64;47;111;9;7;16
96;03.08.2011;2011;08;21;Keskiviikko;52;40;92;6;7;13
96;03.08.2011;2011;08;22;Keskiviikko;19;17;36;1;4;5
96;03.08.2011;2011;08;23;Keskiviikko;26;2;28;1;1;2
96;04.08.2011;2011;08;00;Torstai;10;2;12;2;0;2
96;04.08.2011;2011;08;01;Torstai;5;1;6;0;0;0
96;04.08.2011;2011;08;02;Torstai;4;1;5;0;0;0
96;04.08.2011;2011;08;03;Torstai;9;0;9;0;0;0
96;04.08.2011;2011;08;04;Torstai;6;3;9;0;0;0
96;04.08.2011;2011;08;05;Torstai;7;5;12;0;1;1
96;04.08.2011;2011;08;06;Torstai;48;30;78;2;2;4
96;04.08.2011;2011;08;07;Torstai;73;111;184;4;5;9
96;04.08.2011;2011;08;08;Torstai;48;99;147;2;6;8
96;04.08.2011;2011;08;09;Torstai;29;65;94;5;10;15
96;04.08.2011;2011;08;10;Torstai;41;60;101;3;11;14
96;04.08.2011;2011;08;11;Torstai;39;63;102;6;3;9
96;04.08.2011;2011;08;12;Torstai;47;54;101;7;6;13
96;04.08.2011;2011;08;13;Torstai;80;96;176;7;8;15
96;04.08.2011;2011;08;14;Torstai;69;93;162;4;9;13
96;04.08.2011;2011;08;15;Torstai;101;141;242;9;13;22
96;04.08.2011;2011;08;16;Torstai;149;109;258;7;16;23
96;04.08.2011;2011;08;17;Torstai;86;79;165;14;7;21
96;04.08.2011;2011;08;18;Torstai;81;62;143;11;11;22
96;04.08.2011;2011;08;19;Torstai;68;50;118;11;16;27
96;04.08.2011;2011;08;20;Torstai;53;56;109;8;5;13
96;04.08.2011;2011;08;21;Torstai;31;42;73;6;4;10
96;04.08.2011;2011;08;22;Torstai;10;12;22;1;2;3
96;04.08.2011;2011;08;23;Torstai;11;3;14;2;0;2
96;05.08.2011;2011;08;00;Perjantai;1;3;4;1;1;2
96;05.08.2011;2011;08;01;Perjantai;3;0;3;0;0;0
96;05.08.2011;2011;08;02;Perjantai;4;3;7;0;0;0
96;05.08.2011;2011;08;03;Perjantai;6;0;6;1;0;1
96;05.08.2011;2011;08;04;Perjantai;0;2;2;0;0;0
96;05.08.2011;2011;08;05;Perjantai;4;4;8;1;0;1
96;05.08.2011;2011;08;06;Perjantai;53;30;83;3;2;5
96;05.08.2011;2011;08;07;Perjantai;87;94;181;6;3;9
96;05.08.2011;2011;08;08;Perjantai;49;78;127;6;3;9
96;05.08.2011;2011;08;09;Perjantai;31;80;111;6;7;13
96;05.08.2011;2011;08;10;Perjantai;33;56;89;1;11;12
96;05.08.2011;2011;08;11;Perjantai;43;51;94;0;14;14
96;05.08.2011;2011;08;12;Perjantai;66;95;161;5;8;13
96;05.08.2011;2011;08;13;Perjantai;64;84;148;3;9;12
96;05.08.2011;2011;08;14;Perjantai;78;117;195;6;24;30
96;05.08.2011;2011;08;15;Perjantai;114;145;259;16;17;33
96;05.08.2011;2011;08;16;Perjantai;109;110;219;16;11;27
96;05.08.2011;2011;08;17;Perjantai;76;79;155;15;25;40
96;05.08.2011;2011;08;18;Perjantai;78;70;148;22;16;38
96;05.08.2011;2011;08;19;Perjantai;79;66;145;20;18;38
96;05.08.2011;2011;08;20;Perjantai;83;63;146;61;42;103
96;05.08.2011;2011;08;21;Perjantai;50;59;109;48;49;97
96;05.08.2011;2011;08;22;Perjantai;51;27;78;61;64;125
96;05.08.2011;2011;08;23;Perjantai;34;20;54;31;24;55
96;06.08.2011;2011;08;00;Lauantai;44;17;61;86;79;165
96;06.08.2011;2011;08;01;Lauantai;21;12;33;13;20;33
96;06.08.2011;2011;08;02;Lauantai;24;4;28;4;4;8
96;06.08.2011;2011;08;03;Lauantai;23;7;30;5;4;9
96;06.08.2011;2011;08;04;Lauantai;12;0;12;3;1;4
96;06.08.2011;2011;08;05;Lauantai;6;3;9;4;1;5
96;06.08.2011;2011;08;06;Lauantai;22;10;32;4;0;4
96;06.08.2011;2011;08;07;Lauantai;2;19;21;4;3;7
96;06.08.2011;2011;08;08;Lauantai;8;16;24;3;3;6
96;06.08.2011;2011;08;09;Lauantai;12;38;50;3;9;12
96;06.08.2011;2011;08;10;Lauantai;32;42;74;4;3;7
96;06.08.2011;2011;08;11;Lauantai;27;65;92;2;13;15
96;06.08.2011;2011;08;12;Lauantai;50;85;135;3;10;13
96;06.08.2011;2011;08;13;Lauantai;58;62;120;6;3;9
96;06.08.2011;2011;08;14;Lauantai;64;93;157;2;8;10
96;06.08.2011;2011;08;15;Lauantai;71;96;167;8;15;23
96;06.08.2011;2011;08;16;Lauantai;74;54;128;13;9;22
96;06.08.2011;2011;08;17;Lauantai;48;43;91;20;16;36
96;06.08.2011;2011;08;18;Lauantai;65;67;132;33;25;58
96;06.08.2011;2011;08;19;Lauantai;56;64;120;22;21;43
96;06.08.2011;2011;08;20;Lauantai;43;69;112;26;40;66
96;06.08.2011;2011;08;21;Lauantai;31;53;84;14;28;42
96;06.08.2011;2011;08;22;Lauantai;42;31;73;39;54;93
96;06.08.2011;2011;08;23;Lauantai;39;24;63;37;41;78
96;07.08.2011;2011;08;00;Sunnuntai;45;19;64;26;21;47
96;07.08.2011;2011;08;01;Sunnuntai;7;2;9;6;2;8
96;07.08.2011;2011;08;02;Sunnuntai;40;8;48;4;2;6
96;07.08.2011;2011;08;03;Sunnuntai;12;1;13;3;0;3
96;07.08.2011;2011;08;04;Sunnuntai;13;0;13;1;0;1
96;07.08.2011;2011;08;05;Sunnuntai;5;1;6;1;1;2
96;07.08.2011;2011;08;06;Sunnuntai;22;10;32;2;2;4
96;07.08.2011;2011;08;07;Sunnuntai;4;20;24;0;3;3
96;07.08.2011;2011;08;08;Sunnuntai;11;7;18;2;2;4
96;07.08.2011;2011;08;09;Sunnuntai;8;16;24;2;7;9
96;07.08.2011;2011;08;10;Sunnuntai;13;26;39;4;3;7
96;07.08.2011;2011;08;11;Sunnuntai;18;37;55;2;3;5
96;07.08.2011;2011;08;12;Sunnuntai;40;72;112;5;9;14
96;07.08.2011;2011;08;13;Sunnuntai;55;54;109;9;14;23
96;07.08.2011;2011;08;14;Sunnuntai;45;49;94;4;9;13
96;07.08.2011;2011;08;15;Sunnuntai;62;64;126;11;7;18
96;07.08.2011;2011;08;16;Sunnuntai;53;59;112;5;5;10
96;07.08.2011;2011;08;17;Sunnuntai;58;48;106;20;4;24
96;07.08.2011;2011;08;18;Sunnuntai;45;36;81;14;12;26
96;07.08.2011;2011;08;19;Sunnuntai;59;44;103;11;19;30
96;07.08.2011;2011;08;20;Sunnuntai;50;54;104;12;8;20
96;07.08.2011;2011;08;21;Sunnuntai;20;39;59;6;10;16
96;07.08.2011;2011;08;22;Sunnuntai;19;15;34;3;1;4
96;07.08.2011;2011;08;23;Sunnuntai;2;13;15;0;0;0
96;08.08.2011;2011;08;00;Maanantai;6;3;9;1;1;2
96;08.08.2011;2011;08;01;Maanantai;2;0;2;1;0;1
96;08.08.2011;2011;08;02;Maanantai;5;2;7;0;0;0
96;08.08.2011;2011;08;03;Maanantai;6;0;6;0;0;0
96;08.08.2011;2011;08;04;Maanantai;4;5;9;1;0;1
96;08.08.2011;2011;08;05;Maanantai;4;8;12;3;1;4
96;08.08.2011;2011;08;06;Maanantai;46;22;68;2;4;6
96;08.08.2011;2011;08;07;Maanantai;57;64;121;5;1;6
96;08.08.2011;2011;08;08;Maanantai;30;42;72;3;3;6
96;08.08.2011;2011;08;09;Maanantai;21;37;58;3;2;5
96;08.08.2011;2011;08;10;Maanantai;18;23;41;0;2;2
96;08.08.2011;2011;08;11;Maanantai;13;23;36;1;2;3
96;08.08.2011;2011;08;12;Maanantai;16;23;39;8;2;10
96;08.08.2011;2011;08;13;Maanantai;26;44;70;1;3;4
96;08.08.2011;2011;08;14;Maanantai;30;46;76;2;2;4
96;08.08.2011;2011;08;15;Maanantai;43;122;165;6;10;16
96;08.08.2011;2011;08;16;Maanantai;58;81;139;6;12;18
96;08.08.2011;2011;08;17;Maanantai;41;34;75;5;3;8
96;08.08.2011;2011;08;18;Maanantai;31;25;56;8;10;18
96;08.08.2011;2011;08;19;Maanantai;27;27;54;3;0;3
96;08.08.2011;2011;08;20;Maanantai;42;16;58;7;9;16
96;08.08.2011;2011;08;21;Maanantai;18;16;34;4;10;14
96;08.08.2011;2011;08;22;Maanantai;6;12;18;0;1;1
96;08.08.2011;2011;08;23;Maanantai;9;4;13;1;1;2
96;09.08.2011;2011;08;00;Tiistai;6;0;6;0;0;0
96;09.08.2011;2011;08;01;Tiistai;3;1;4;0;0;0
96;09.08.2011;2011;08;02;Tiistai;2;0;2;0;0;0
96;09.08.2011;2011;08;03;Tiistai;3;0;3;0;0;0
96;09.08.2011;2011;08;04;Tiistai;1;2;3;1;0;1
96;09.08.2011;2011;08;05;Tiistai;5;6;11;0;3;3
96;09.08.2011;2011;08;06;Tiistai;37;37;74;2;2;4
96;09.08.2011;2011;08;07;Tiistai;72;106;178;8;4;12
96;09.08.2011;2011;08;08;Tiistai;52;87;139;4;3;7
96;09.08.2011;2011;08;09;Tiistai;35;68;103;3;12;15
96;09.08.2011;2011;08;10;Tiistai;30;68;98;8;11;19
96;09.08.2011;2011;08;11;Tiistai;66;84;150;7;8;15
96;09.08.2011;2011;08;12;Tiistai;71;80;151;7;13;20
96;09.08.2011;2011;08;13;Tiistai;68;87;155;2;9;11
96;09.08.2011;2011;08;14;Tiistai;83;88;171;7;14;21
96;09.08.2011;2011;08;15;Tiistai;102;165;267;11;22;33
96;09.08.2011;2011;08;16;Tiistai;130;116;246;9;12;21
96;09.08.2011;2011;08;17;Tiistai;83;72;155;13;15;28
96;09.08.2011;2011;08;18;Tiistai;76;53;129;8;7;15
96;09.08.2011;2011;08;19;Tiistai;51;46;97;17;10;27
96;09.08.2011;2011;08;20;Tiistai;70;34;104;18;16;34
96;09.08.2011;2011;08;21;Tiistai;40;35;75;7;9;16
96;09.08.2011;2011;08;22;Tiistai;20;13;33;1;4;5
96;09.08.2011;2011;08;23;Tiistai;17;5;22;3;0;3
96;10.08.2011;2011;08;00;Keskiviikko;9;2;11;1;0;1
96;10.08.2011;2011;08;01;Keskiviikko;4;1;5;0;0;0
96;10.08.2011;2011;08;02;Keskiviikko;5;0;5;0;0;0
96;10.08.2011;2011;08;03;Keskiviikko;1;0;1;0;1;1
96;10.08.2011;2011;08;04;Keskiviikko;1;3;4;1;0;1
96;10.08.2011;2011;08;05;Keskiviikko;6;8;14;0;1;1
96;10.08.2011;2011;08;06;Keskiviikko;53;39;92;4;4;8
96;10.08.2011;2011;08;07;Keskiviikko;98;146;244;9;6;15
96;10.08.2011;2011;08;08;Keskiviikko;80;105;185;12;10;22
96;10.08.2011;2011;08;09;Keskiviikko;47;97;144;6;11;17
96;10.08.2011;2011;08;10;Keskiviikko;32;56;88;4;9;13
96;10.08.2011;2011;08;11;Keskiviikko;63;100;163;7;14;21
96;10.08.2011;2011;08;12;Keskiviikko;77;86;163;4;13;17
96;10.08.2011;2011;08;13;Keskiviikko;91;96;187;6;10;16
96;10.08.2011;2011;08;14;Keskiviikko;91;127;218;6;8;14
96;10.08.2011;2011;08;15;Keskiviikko;106;207;313;4;17;21
96;10.08.2011;2011;08;16;Keskiviikko;113;121;234;8;12;20
96;10.08.2011;2011;08;17;Keskiviikko;82;58;140;17;6;23
96;10.08.2011;2011;08;18;Keskiviikko;107;44;151;16;6;22
96;10.08.2011;2011;08;19;Keskiviikko;54;32;86;8;16;24
96;10.08.2011;2011;08;20;Keskiviikko;65;18;83;4;5;9
96;10.08.2011;2011;08;21;Keskiviikko;21;41;62;5;9;14
96;10.08.2011;2011;08;22;Keskiviikko;10;6;16;2;4;6
96;10.08.2011;2011;08;23;Keskiviikko;11;7;18;0;3;3
96;11.08.2011;2011;08;00;Torstai;9;5;14;0;0;0
96;11.08.2011;2011;08;01;Torstai;6;1;7;0;0;0
96;11.08.2011;2011;08;02;Torstai;3;0;3;0;0;0
96;11.08.2011;2011;08;03;Torstai;2;0;2;0;0;0
96;11.08.2011;2011;08;04;Torstai;2;3;5;2;0;2
96;11.08.2011;2011;08;05;Torstai;7;10;17;0;1;1
96;11.08.2011;2011;08;06;Torstai;54;36;90;4;2;6
96;11.08.2011;2011;08;07;Torstai;87;139;226;15;4;19
96;11.08.2011;2011;08;08;Torstai;58;117;175;8;7;15
96;11.08.2011;2011;08;09;Torstai;57;101;158;15;8;23
96;11.08.2011;2011;08;10;Torstai;44;89;133;8;12;20
96;11.08.2011;2011;08;11;Torstai;57;74;131;6;6;12
96;11.08.2011;2011;08;12;Torstai;84;63;147;7;8;15
96;11.08.2011;2011;08;13;Torstai;93;66;159;6;11;17
96;11.08.2011;2011;08;14;Torstai;84;105;189;10;13;23
96;11.08.2011;2011;08;15;Torstai;101;190;291;18;20;38
96;11.08.2011;2011;08;16;Torstai;117;125;242;10;12;22
96;11.08.2011;2011;08;17;Torstai;94;72;166;9;7;16
96;11.08.2011;2011;08;18;Torstai;80;58;138;9;11;20
96;11.08.2011;2011;08;19;Torstai;77;38;115;8;12;20
96;11.08.2011;2011;08;20;Torstai;67;30;97;8;4;12
96;11.08.2011;2011;08;21;Torstai;28;49;77;6;6;12
96;11.08.2011;2011;08;22;Torstai;15;14;29;1;0;1
96;11.08.2011;2011;08;23;Torstai;5;9;14;0;0;0
96;12.08.2011;2011;08;00;Perjantai;4;0;4;0;0;0
96;12.08.2011;2011;08;01;Perjantai;0;4;4;0;0;0
96;12.08.2011;2011;08;02;Perjantai;7;1;8;1;0;1
96;12.08.2011;2011;08;03;Perjantai;3;0;3;0;0;0
96;12.08.2011;2011;08;04;Perjantai;3;3;6;1;0;1
96;12.08.2011;2011;08;05;Perjantai;6;7;13;0;0;0
96;12.08.2011;2011;08;06;Perjantai;49;37;86;4;5;9
96;12.08.2011;2011;08;07;Perjantai;104;142;246;23;7;30
96;12.08.2011;2011;08;08;Perjantai;87;134;221;12;13;25
96;12.08.2011;2011;08;09;Perjantai;34;123;157;11;9;20
96;12.08.2011;2011;08;10;Perjantai;37;67;104;5;3;8
96;12.08.2011;2011;08;11;Perjantai;51;72;123;3;6;9
96;12.08.2011;2011;08;12;Perjantai;89;69;158;3;8;11
96;12.08.2011;2011;08;13;Perjantai;99;111;210;5;12;17
96;12.08.2011;2011;08;14;Perjantai;127;153;280;2;13;15
96;12.08.2011;2011;08;15;Perjantai;137;174;311;5;26;31
96;12.08.2011;2011;08;16;Perjantai;113;79;192;10;16;26
96;12.08.2011;2011;08;17;Perjantai;91;65;156;11;12;23
96;12.08.2011;2011;08;18;Perjantai;74;70;144;7;18;25
96;12.08.2011;2011;08;19;Perjantai;49;39;88;6;9;15
96;12.08.2011;2011;08;20;Perjantai;55;29;84;6;3;9
96;12.08.2011;2011;08;21;Perjantai;37;37;74;5;6;11
96;12.08.2011;2011;08;22;Perjantai;32;17;49;6;1;7
96;12.08.2011;2011;08;23;Perjantai;23;10;33;1;0;1
96;13.08.2011;2011;08;00;Lauantai;13;17;30;1;1;2
96;13.08.2011;2011;08;01;Lauantai;19;4;23;3;1;4
96;13.08.2011;2011;08;02;Lauantai;10;1;11;2;0;2
96;13.08.2011;2011;08;03;Lauantai;16;1;17;2;0;2
96;13.08.2011;2011;08;04;Lauantai;13;0;13;2;0;2
96;13.08.2011;2011;08;05;Lauantai;6;1;7;0;1;1
96;13.08.2011;2011;08;06;Lauantai;10;11;21;0;1;1
96;13.08.2011;2011;08;07;Lauantai;4;19;23;1;2;3
96;13.08.2011;2011;08;08;Lauantai;11;17;28;5;5;10
96;13.08.2011;2011;08;09;Lauantai;18;52;70;4;8;12
96;13.08.2011;2011;08;10;Lauantai;35;60;95;4;3;7
96;13.08.2011;2011;08;11;Lauantai;42;70;112;5;8;13
96;13.08.2011;2011;08;12;Lauantai;56;66;122;6;4;10
96;13.08.2011;2011;08;13;Lauantai;73;48;121;6;3;9
96;13.08.2011;2011;08;14;Lauantai;51;69;120;8;5;13
96;13.08.2011;2011;08;15;Lauantai;60;69;129;6;16;22
96;13.08.2011;2011;08;16;Lauantai;79;39;118;16;8;24
96;13.08.2011;2011;08;17;Lauantai;63;43;106;10;16;26
96;13.08.2011;2011;08;18;Lauantai;68;60;128;7;4;11
96;13.08.2011;2011;08;19;Lauantai;44;39;83;9;4;13
96;13.08.2011;2011;08;20;Lauantai;30;44;74;5;12;17
96;13.08.2011;2011;08;21;Lauantai;32;30;62;3;4;7
96;13.08.2011;2011;08;22;Lauantai;27;23;50;1;1;2
96;13.08.2011;2011;08;23;Lauantai;17;28;45;1;3;4
96;14.08.2011;2011;08;00;Sunnuntai;15;11;26;2;1;3
96;14.08.2011;2011;08;01;Sunnuntai;22;5;27;0;0;0
96;14.08.2011;2011;08;02;Sunnuntai;10;6;16;1;1;2
96;14.08.2011;2011;08;03;Sunnuntai;21;4;25;1;0;1
96;14.08.2011;2011;08;04;Sunnuntai;23;1;24;3;0;3
96;14.08.2011;2011;08;05;Sunnuntai;10;0;10;1;0;1
96;14.08.2011;2011;08;06;Sunnuntai;10;6;16;1;0;1
96;14.08.2011;2011;08;07;Sunnuntai;6;12;18;0;2;2
96;14.08.2011;2011;08;08;Sunnuntai;7;13;20;5;4;9
96;14.08.2011;2011;08;09;Sunnuntai;12;22;34;2;4;6
96;14.08.2011;2011;08;10;Sunnuntai;18;29;47;6;4;10
96;14.08.2011;2011;08;11;Sunnuntai;37;37;74;3;5;8
96;14.08.2011;2011;08;12;Sunnuntai;61;71;132;10;9;19
96;14.08.2011;2011;08;13;Sunnuntai;90;79;169;4;9;13
96;14.08.2011;2011;08;14;Sunnuntai;83;62;145;8;6;14
96;14.08.2011;2011;08;15;Sunnuntai;58;73;131;7;9;16
96;14.08.2011;2011;08;16;Sunnuntai;63;94;157;23;14;37
96;14.08.2011;2011;08;17;Sunnuntai;96;67;163;43;11;54
96;14.08.2011;2011;08;18;Sunnuntai;77;42;119;17;4;21
96;14.08.2011;2011;08;19;Sunnuntai;83;71;154;17;13;30
96;14.08.2011;2011;08;20;Sunnuntai;47;38;85;4;15;19
96;14.08.2011;2011;08;21;Sunnuntai;28;42;70;4;13;17
96;14.08.2011;2011;08;22;Sunnuntai;9;18;27;2;1;3
96;14.08.2011;2011;08;23;Sunnuntai;12;7;19;2;1;3
96;15.08.2011;2011;08;00;Maanantai;4;5;9;0;0;0
96;15.08.2011;2011;08;01;Maanantai;2;0;2;0;1;1
96;15.08.2011;2011;08;02;Maanantai;1;0;1;0;0;0
96;15.08.2011;2011;08;03;Maanantai;4;0;4;0;0;0
96;15.08.2011;2011;08;04;Maanantai;1;1;2;1;0;1
96;15.08.2011;2011;08;05;Maanantai;8;14;22;0;1;1
96;15.08.2011;2011;08;06;Maanantai;39;49;88;3;2;5
96;15.08.2011;2011;08;07;Maanantai;132;203;335;20;10;30
96;15.08.2011;2011;08;08;Maanantai;83;170;253;9;10;19
96;15.08.2011;2011;08;09;Maanantai;76;97;173;12;8;20
96;15.08.2011;2011;08;10;Maanantai;41;67;108;8;6;14
96;15.08.2011;2011;08;11;Maanantai;66;93;159;3;4;7
96;15.08.2011;2011;08;12;Maanantai;69;92;161;5;11;16
96;15.08.2011;2011;08;13;Maanantai;86;81;167;2;7;9
96;15.08.2011;2011;08;14;Maanantai;107;110;217;5;8;13
96;15.08.2011;2011;08;15;Maanantai;153;227;380;13;25;38
96;15.08.2011;2011;08;16;Maanantai;173;161;334;7;15;22
96;15.08.2011;2011;08;17;Maanantai;113;94;207;14;12;26
96;15.08.2011;2011;08;18;Maanantai;111;78;189;15;15;30
96;15.08.2011;2011;08;19;Maanantai;77;53;130;6;11;17
96;15.08.2011;2011;08;20;Maanantai;74;56;130;7;10;17
96;15.08.2011;2011;08;21;Maanantai;44;29;73;5;11;16
96;15.08.2011;2011;08;22;Maanantai;14;8;22;5;1;6
96;15.08.2011;2011;08;23;Maanantai;7;1;8;1;2;3
96;16.08.2011;2011;08;00;Tiistai;6;1;7;2;1;3
96;16.08.2011;2011;08;01;Tiistai;2;0;2;0;0;0
96;16.08.2011;2011;08;02;Tiistai;0;1;1;0;0;0
96;16.08.2011;2011;08;03;Tiistai;2;0;2;0;0;0
96;16.08.2011;2011;08;04;Tiistai;1;1;2;0;0;0
96;16.08.2011;2011;08;05;Tiistai;8;9;17;0;1;1
96;16.08.2011;2011;08;06;Tiistai;46;38;84;5;1;6
96;16.08.2011;2011;08;07;Tiistai;118;209;327;15;5;20
96;16.08.2011;2011;08;08;Tiistai;99;173;272;9;3;12
96;16.08.2011;2011;08;09;Tiistai;52;104;156;11;6;17
96;16.08.2011;2011;08;10;Tiistai;30;74;104;1;13;14
96;16.08.2011;2011;08;11;Tiistai;54;65;119;5;12;17
96;16.08.2011;2011;08;12;Tiistai;68;78;146;13;6;19
96;16.08.2011;2011;08;13;Tiistai;58;77;135;2;8;10
96;16.08.2011;2011;08;14;Tiistai;95;130;225;3;10;13
96;16.08.2011;2011;08;15;Tiistai;117;221;338;9;24;33
96;16.08.2011;2011;08;16;Tiistai;209;177;386;21;36;57
96;16.08.2011;2011;08;17;Tiistai;130;97;227;44;20;64
96;16.08.2011;2011;08;18;Tiistai;105;70;175;38;12;50
96;16.08.2011;2011;08;19;Tiistai;89;62;151;14;14;28
96;16.08.2011;2011;08;20;Tiistai;77;46;123;14;20;34
96;16.08.2011;2011;08;21;Tiistai;50;43;93;7;8;15
96;16.08.2011;2011;08;22;Tiistai;12;8;20;3;2;5
96;16.08.2011;2011;08;23;Tiistai;8;5;13;3;2;5
96;17.08.2011;2011;08;00;Keskiviikko;5;2;7;0;0;0
96;17.08.2011;2011;08;01;Keskiviikko;7;0;7;0;0;0
96;17.08.2011;2011;08;02;Keskiviikko;2;0;2;0;0;0
96;17.08.2011;2011;08;03;Keskiviikko;0;1;1;0;0;0
96;17.08.2011;2011;08;04;Keskiviikko;0;2;2;0;0;0
96;17.08.2011;2011;08;05;Keskiviikko;6;10;16;1;1;2
96;17.08.2011;2011;08;06;Keskiviikko;47;48;95;4;3;7
96;17.08.2011;2011;08;07;Keskiviikko;130;172;302;13;3;16
96;17.08.2011;2011;08;08;Keskiviikko;91;149;240;8;1;9
96;17.08.2011;2011;08;09;Keskiviikko;51;93;144;2;7;9
96;17.08.2011;2011;08;10;Keskiviikko;34;54;88;7;4;11
96;17.08.2011;2011;08;11;Keskiviikko;33;67;100;1;7;8
96;17.08.2011;2011;08;12;Keskiviikko;70;60;130;4;11;15
96;17.08.2011;2011;08;13;Keskiviikko;64;82;146;5;3;8
96;17.08.2011;2011;08;14;Keskiviikko;93;119;212;4;10;14
96;17.08.2011;2011;08;15;Keskiviikko;106;197;303;2;17;19
96;17.08.2011;2011;08;16;Keskiviikko;143;146;289;10;10;20
96;17.08.2011;2011;08;17;Keskiviikko;88;83;171;21;10;31
96;17.08.2011;2011;08;18;Keskiviikko;99;87;186;27;16;43
96;17.08.2011;2011;08;19;Keskiviikko;71;40;111;9;15;24
96;17.08.2011;2011;08;20;Keskiviikko;67;30;97;5;10;15
96;17.08.2011;2011;08;21;Keskiviikko;36;35;71;7;10;17
96;17.08.2011;2011;08;22;Keskiviikko;10;10;20;0;3;3
96;17.08.2011;2011;08;23;Keskiviikko;3;3;6;0;0;0
96;18.08.2011;2011;08;00;Torstai;11;7;18;1;0;1
96;18.08.2011;2011;08;01;Torstai;10;0;10;1;0;1
96;18.08.2011;2011;08;02;Torstai;7;0;7;0;0;0
96;18.08.2011;2011;08;03;Torstai;6;1;7;0;2;2
96;18.08.2011;2011;08;04;Torstai;1;2;3;1;1;2
96;18.08.2011;2011;08;05;Torstai;4;13;17;0;1;1
96;18.08.2011;2011;08;06;Torstai;41;39;80;1;1;2
96;18.08.2011;2011;08;07;Torstai;118;144;262;14;6;20
96;18.08.2011;2011;08;08;Torstai;102;132;234;13;6;19
96;18.08.2011;2011;08;09;Torstai;50;70;120;4;7;11
96;18.08.2011;2011;08;10;Torstai;28;55;83;6;8;14
96;18.08.2011;2011;08;11;Torstai;39;47;86;9;5;14
96;18.08.2011;2011;08;12;Torstai;36;61;97;4;2;6
96;18.08.2011;2011;08;13;Torstai;59;50;109;5;4;9
96;18.08.2011;2011;08;14;Torstai;58;89;147;1;6;7
96;18.08.2011;2011;08;15;Torstai;98;187;285;5;11;16
96;18.08.2011;2011;08;16;Torstai;126;146;272;7;20;27
96;18.08.2011;2011;08;17;Torstai;73;82;155;12;13;25
96;18.08.2011;2011;08;18;Torstai;55;77;132;9;11;20
96;18.08.2011;2011;08;19;Torstai;53;64;117;13;9;22
96;18.08.2011;2011;08;20;Torstai;61;34;95;3;13;16
96;18.08.2011;2011;08;21;Torstai;55;26;81;1;5;6
96;18.08.2011;2011;08;22;Torstai;34;16;50;0;3;3
96;18.08.2011;2011;08;23;Torstai;31;4;35;0;0;0
96;19.08.2011;2011;08;00;Perjantai;2;3;5;0;0;0
96;19.08.2011;2011;08;01;Perjantai;4;1;5;3;0;3
96;19.08.2011;2011;08;02;Perjantai;2;0;2;0;0;0
96;19.08.2011;2011;08;03;Perjantai;1;0;1;0;0;0
96;19.08.2011;2011;08;04;Perjantai;0;2;2;0;0;0
96;19.08.2011;2011;08;05;Perjantai;3;3;6;0;0;0
96;19.08.2011;2011;08;06;Perjantai;36;35;71;1;3;4
96;19.08.2011;2011;08;07;Perjantai;99;112;211;9;3;12
96;19.08.2011;2011;08;08;Perjantai;97;73;170;11;5;16
96;19.08.2011;2011;08;09;Perjantai;38;92;130;5;6;11
96;19.08.2011;2011;08;10;Perjantai;31;58;89;5;6;11
96;19.08.2011;2011;08;11;Perjantai;39;78;117;4;6;10
96;19.08.2011;2011;08;12;Perjantai;57;74;131;3;8;11
96;19.08.2011;2011;08;13;Perjantai;86;87;173;6;12;18
96;19.08.2011;2011;08;14;Perjantai;83;118;201;5;15;20
96;19.08.2011;2011;08;15;Perjantai;96;155;251;4;14;18
96;19.08.2011;2011;08;16;Perjantai;85;78;163;10;11;21
96;19.08.2011;2011;08;17;Perjantai;47;31;78;4;8;12
96;19.08.2011;2011;08;18;Perjantai;41;38;79;4;5;9
96;19.08.2011;2011;08;19;Perjantai;37;32;69;8;10;18
96;19.08.2011;2011;08;20;Perjantai;34;18;52;2;7;9
96;19.08.2011;2011;08;21;Perjantai;28;20;48;1;2;3
96;19.08.2011;2011;08;22;Perjantai;13;11;24;0;1;1
96;19.08.2011;2011;08;23;Perjantai;12;2;14;1;6;7
96;20.08.2011;2011;08;00;Lauantai;12;14;26;0;0;0
96;20.08.2011;2011;08;01;Lauantai;6;6;12;4;0;4
96;20.08.2011;2011;08;02;Lauantai;7;0;7;0;0;0
96;20.08.2011;2011;08;03;Lauantai;6;0;6;1;0;1
96;20.08.2011;2011;08;04;Lauantai;9;7;16;2;0;2
96;20.08.2011;2011;08;05;Lauantai;5;1;6;0;0;0
96;20.08.2011;2011;08;06;Lauantai;17;11;28;2;0;2
96;20.08.2011;2011;08;07;Lauantai;7;14;21;2;1;3
96;20.08.2011;2011;08;08;Lauantai;12;18;30;4;0;4
96;20.08.2011;2011;08;09;Lauantai;10;48;58;8;10;18
96;20.08.2011;2011;08;10;Lauantai;18;41;59;7;8;15
96;20.08.2011;2011;08;11;Lauantai;33;56;89;4;11;15
96;20.08.2011;2011;08;12;Lauantai;52;62;114;6;12;18
96;20.08.2011;2011;08;13;Lauantai;53;72;125;6;3;9
96;20.08.2011;2011;08;14;Lauantai;51;61;112;3;5;8
96;20.08.2011;2011;08;15;Lauantai;61;64;125;6;12;18
96;20.08.2011;2011;08;16;Lauantai;66;54;120;9;6;15
96;20.08.2011;2011;08;17;Lauantai;62;42;104;15;5;20
96;20.08.2011;2011;08;18;Lauantai;59;40;99;17;9;26
96;20.08.2011;2011;08;19;Lauantai;59;51;110;5;11;16
96;20.08.2011;2011;08;20;Lauantai;28;40;68;6;5;11
96;20.08.2011;2011;08;21;Lauantai;24;47;71;0;13;13
96;20.08.2011;2011;08;22;Lauantai;19;39;58;0;1;1
96;20.08.2011;2011;08;23;Lauantai;17;9;26;1;1;2
96;21.08.2011;2011;08;00;Sunnuntai;18;12;30;0;3;3
96;21.08.2011;2011;08;01;Sunnuntai;32;7;39;1;0;1
96;21.08.2011;2011;08;02;Sunnuntai;16;3;19;1;2;3
96;21.08.2011;2011;08;03;Sunnuntai;24;2;26;4;0;4
96;21.08.2011;2011;08;04;Sunnuntai;18;0;18;3;0;3
96;21.08.2011;2011;08;05;Sunnuntai;3;1;4;0;0;0
96;21.08.2011;2011;08;06;Sunnuntai;12;3;15;3;0;3
96;21.08.2011;2011;08;07;Sunnuntai;7;13;20;0;2;2
96;21.08.2011;2011;08;08;Sunnuntai;7;10;17;2;0;2
96;21.08.2011;2011;08;09;Sunnuntai;8;16;24;4;6;10
96;21.08.2011;2011;08;10;Sunnuntai;13;34;47;12;7;19
96;21.08.2011;2011;08;11;Sunnuntai;34;57;91;6;5;11
96;21.08.2011;2011;08;12;Sunnuntai;54;72;126;10;8;18
96;21.08.2011;2011;08;13;Sunnuntai;71;56;127;11;12;23
96;21.08.2011;2011;08;14;Sunnuntai;55;46;101;1;8;9
96;21.08.2011;2011;08;15;Sunnuntai;52;66;118;8;9;17
96;21.08.2011;2011;08;16;Sunnuntai;49;59;108;10;10;20
96;21.08.2011;2011;08;17;Sunnuntai;67;61;128;25;7;32
96;21.08.2011;2011;08;18;Sunnuntai;84;50;134;22;14;36
96;21.08.2011;2011;08;19;Sunnuntai;49;38;87;15;17;32
96;21.08.2011;2011;08;20;Sunnuntai;37;50;87;10;17;27
96;21.08.2011;2011;08;21;Sunnuntai;24;45;69;5;15;20
96;21.08.2011;2011;08;22;Sunnuntai;13;16;29;2;3;5
96;21.08.2011;2011;08;23;Sunnuntai;8;8;16;1;1;2
96;22.08.2011;2011;08;00;Maanantai;2;1;3;0;0;0
96;22.08.2011;2011;08;01;Maanantai;2;0;2;0;0;0
96;22.08.2011;2011;08;02;Maanantai;3;0;3;0;0;0
96;22.08.2011;2011;08;03;Maanantai;0;1;1;0;0;0
96;22.08.2011;2011;08;04;Maanantai;3;4;7;0;0;0
96;22.08.2011;2011;08;05;Maanantai;2;12;14;0;1;1
96;22.08.2011;2011;08;06;Maanantai;47;42;89;6;3;9
96;22.08.2011;2011;08;07;Maanantai;125;182;307;16;5;21
96;22.08.2011;2011;08;08;Maanantai;90;156;246;7;6;13
96;22.08.2011;2011;08;09;Maanantai;82;99;181;12;10;22
96;22.08.2011;2011;08;10;Maanantai;40;80;120;5;13;18
96;22.08.2011;2011;08;11;Maanantai;46;67;113;2;12;14
96;22.08.2011;2011;08;12;Maanantai;77;76;153;8;7;15
96;22.08.2011;2011;08;13;Maanantai;87;81;168;11;12;23
96;22.08.2011;2011;08;14;Maanantai;83;109;192;3;6;9
96;22.08.2011;2011;08;15;Maanantai;84;159;243;5;12;17
96;22.08.2011;2011;08;16;Maanantai;119;160;279;2;15;17
96;22.08.2011;2011;08;17;Maanantai;85;92;177;4;10;14
96;22.08.2011;2011;08;18;Maanantai;76;45;121;15;17;32
96;22.08.2011;2011;08;19;Maanantai;65;61;126;9;12;21
96;22.08.2011;2011;08;20;Maanantai;59;38;97;7;17;24
96;22.08.2011;2011;08;21;Maanantai;32;29;61;7;5;12
96;22.08.2011;2011;08;22;Maanantai;12;18;30;3;4;7
96;22.08.2011;2011;08;23;Maanantai;3;1;4;1;1;2
96;23.08.2011;2011;08;00;Tiistai;5;1;6;0;0;0
96;23.08.2011;2011;08;01;Tiistai;2;0;2;0;0;0
96;23.08.2011;2011;08;02;Tiistai;0;0;0;0;0;0
96;23.08.2011;2011;08;03;Tiistai;2;0;2;0;0;0
96;23.08.2011;2011;08;04;Tiistai;2;1;3;0;0;0
96;23.08.2011;2011;08;05;Tiistai;3;9;12;0;1;1
96;23.08.2011;2011;08;06;Tiistai;45;37;82;2;2;4
96;23.08.2011;2011;08;07;Tiistai;114;118;232;18;5;23
96;23.08.2011;2011;08;08;Tiistai;104;104;208;12;9;21
96;23.08.2011;2011;08;09;Tiistai;69;59;128;10;5;15
96;23.08.2011;2011;08;10;Tiistai;52;63;115;4;6;10
96;23.08.2011;2011;08;11;Tiistai;53;54;107;6;3;9
96;23.08.2011;2011;08;12;Tiistai;41;65;106;5;6;11
96;23.08.2011;2011;08;13;Tiistai;41;62;103;3;8;11
96;23.08.2011;2011;08;14;Tiistai;77;120;197;3;16;19
96;23.08.2011;2011;08;15;Tiistai;81;163;244;7;19;26
96;23.08.2011;2011;08;16;Tiistai;118;161;279;13;25;38
96;23.08.2011;2011;08;17;Tiistai;72;93;165;17;11;28
96;23.08.2011;2011;08;18;Tiistai;80;66;146;11;13;24
96;23.08.2011;2011;08;19;Tiistai;64;61;125;15;17;32
96;23.08.2011;2011;08;20;Tiistai;51;36;87;17;11;28
96;23.08.2011;2011;08;21;Tiistai;39;28;67;5;11;16
96;23.08.2011;2011;08;22;Tiistai;9;16;25;1;6;7
96;23.08.2011;2011;08;23;Tiistai;7;3;10;0;0;0
96;24.08.2011;2011;08;00;Keskiviikko;4;1;5;0;0;0
96;24.08.2011;2011;08;01;Keskiviikko;5;0;5;0;0;0
96;24.08.2011;2011;08;02;Keskiviikko;14;3;17;0;1;1
96;24.08.2011;2011;08;03;Keskiviikko;8;2;10;1;0;1
96;24.08.2011;2011;08;04;Keskiviikko;6;3;9;2;0;2
96;24.08.2011;2011;08;05;Keskiviikko;4;16;20;1;1;2
96;24.08.2011;2011;08;06;Keskiviikko;38;41;79;3;0;3
96;24.08.2011;2011;08;07;Keskiviikko;128;187;315;19;6;25
96;24.08.2011;2011;08;08;Keskiviikko;87;160;247;8;7;15
96;24.08.2011;2011;08;09;Keskiviikko;82;109;191;11;11;22
96;24.08.2011;2011;08;10;Keskiviikko;53;70;123;8;14;22
96;24.08.2011;2011;08;11;Keskiviikko;63;85;148;9;6;15
96;24.08.2011;2011;08;12;Keskiviikko;102;92;194;8;9;17
96;24.08.2011;2011;08;13;Keskiviikko;109;86;195;4;11;15
96;24.08.2011;2011;08;14;Keskiviikko;118;116;234;4;14;18
96;24.08.2011;2011;08;15;Keskiviikko;128;211;339;7;28;35
96;24.08.2011;2011;08;16;Keskiviikko;183;199;382;9;27;36
96;24.08.2011;2011;08;17;Keskiviikko;126;112;238;14;9;23
96;24.08.2011;2011;08;18;Keskiviikko;143;73;216;16;11;27
96;24.08.2011;2011;08;19;Keskiviikko;126;60;186;20;16;36
96;24.08.2011;2011;08;20;Keskiviikko;67;65;132;11;13;24
96;24.08.2011;2011;08;21;Keskiviikko;39;45;84;2;3;5
96;24.08.2011;2011;08;22;Keskiviikko;31;13;44;2;3;5
96;24.08.2011;2011;08;23;Keskiviikko;3;12;15;0;0;0
96;25.08.2011;2011;08;00;Torstai;6;5;11;0;1;1
96;25.08.2011;2011;08;01;Torstai;6;0;6;0;0;0
96;25.08.2011;2011;08;02;Torstai;1;1;2;0;0;0
96;25.08.2011;2011;08;03;Torstai;1;0;1;0;0;0
96;25.08.2011;2011;08;04;Torstai;2;2;4;0;0;0
96;25.08.2011;2011;08;05;Torstai;3;10;13;0;1;1
96;25.08.2011;2011;08;06;Torstai;42;47;89;2;1;3
96;25.08.2011;2011;08;07;Torstai;135;164;299;10;3;13
96;25.08.2011;2011;08;08;Torstai;134;158;292;7;4;11
96;25.08.2011;2011;08;09;Torstai;52;93;145;10;4;14
96;25.08.2011;2011;08;10;Torstai;62;72;134;3;3;6
96;25.08.2011;2011;08;11;Torstai;42;72;114;3;5;8
96;25.08.2011;2011;08;12;Torstai;83;84;167;5;4;9
96;25.08.2011;2011;08;13;Torstai;77;89;166;7;9;16
96;25.08.2011;2011;08;14;Torstai;112;135;247;4;7;11
96;25.08.2011;2011;08;15;Torstai;117;216;333;6;24;30
96;25.08.2011;2011;08;16;Torstai;165;168;333;6;23;29
96;25.08.2011;2011;08;17;Torstai;116;93;209;10;13;23
96;25.08.2011;2011;08;18;Torstai;105;85;190;15;9;24
96;25.08.2011;2011;08;19;Torstai;84;64;148;12;13;25
96;25.08.2011;2011;08;20;Torstai;103;47;150;10;9;19
96;25.08.2011;2011;08;21;Torstai;50;31;81;1;6;7
96;25.08.2011;2011;08;22;Torstai;26;8;34;5;2;7
96;25.08.2011;2011;08;23;Torstai;23;10;33;0;0;0
96;26.08.2011;2011;08;00;Perjantai;8;6;14;0;0;0
96;26.08.2011;2011;08;01;Perjantai;4;2;6;0;0;0
96;26.08.2011;2011;08;02;Perjantai;8;1;9;0;0;0
96;26.08.2011;2011;08;03;Perjantai;3;0;3;0;0;0
96;26.08.2011;2011;08;04;Perjantai;6;2;8;2;0;2
96;26.08.2011;2011;08;05;Perjantai;6;11;17;1;1;2
96;26.08.2011;2011;08;06;Perjantai;39;51;90;5;5;10
96;26.08.2011;2011;08;07;Perjantai;123;135;258;6;5;11
96;26.08.2011;2011;08;08;Perjantai;113;139;252;13;6;19
96;26.08.2011;2011;08;09;Perjantai;78;98;176;5;17;22
96;26.08.2011;2011;08;10;Perjantai;47;59;106;2;4;6
96;26.08.2011;2011;08;11;Perjantai;68;80;148;5;9;14
96;26.08.2011;2011;08;12;Perjantai;66;84;150;4;10;14
96;26.08.2011;2011;08;13;Perjantai;88;127;215;5;15;20
96;26.08.2011;2011;08;14;Perjantai;102;122;224;2;6;8
96;26.08.2011;2011;08;15;Perjantai;98;161;259;2;21;23
96;26.08.2011;2011;08;16;Perjantai;95;100;195;12;6;18
96;26.08.2011;2011;08;17;Perjantai;53;30;83;3;3;6
96;26.08.2011;2011;08;18;Perjantai;45;26;71;1;7;8
96;26.08.2011;2011;08;19;Perjantai;37;34;71;3;6;9
96;26.08.2011;2011;08;20;Perjantai;29;35;64;8;7;15
96;26.08.2011;2011;08;21;Perjantai;23;35;58;2;4;6
96;26.08.2011;2011;08;22;Perjantai;13;16;29;1;3;4
96;26.08.2011;2011;08;23;Perjantai;15;9;24;1;0;1
96;27.08.2011;2011;08;00;Lauantai;9;4;13;1;0;1
96;27.08.2011;2011;08;01;Lauantai;10;5;15;0;0;0
96;27.08.2011;2011;08;02;Lauantai;15;3;18;0;0;0
96;27.08.2011;2011;08;03;Lauantai;9;4;13;1;0;1
96;27.08.2011;2011;08;04;Lauantai;15;1;16;3;0;3
96;27.08.2011;2011;08;05;Lauantai;9;2;11;0;1;1
96;27.08.2011;2011;08;06;Lauantai;21;12;33;0;1;1
96;27.08.2011;2011;08;07;Lauantai;2;15;17;2;3;5
96;27.08.2011;2011;08;08;Lauantai;6;20;26;3;2;5
96;27.08.2011;2011;08;09;Lauantai;14;45;59;4;6;10
96;27.08.2011;2011;08;10;Lauantai;18;44;62;5;9;14
96;27.08.2011;2011;08;11;Lauantai;28;32;60;5;7;12
96;27.08.2011;2011;08;12;Lauantai;41;45;86;10;3;13
96;27.08.2011;2011;08;13;Lauantai;43;52;95;4;2;6
96;27.08.2011;2011;08;14;Lauantai;41;63;104;10;6;16
96;27.08.2011;2011;08;15;Lauantai;61;57;118;7;7;14
96;27.08.2011;2011;08;16;Lauantai;47;39;86;5;5;10
96;27.08.2011;2011;08;17;Lauantai;62;46;108;11;6;17
96;27.08.2011;2011;08;18;Lauantai;44;48;92;15;7;22
96;27.08.2011;2011;08;19;Lauantai;25;33;58;12;5;17
96;27.08.2011;2011;08;20;Lauantai;32;46;78;8;15;23
96;27.08.2011;2011;08;21;Lauantai;19;41;60;2;16;18
96;27.08.2011;2011;08;22;Lauantai;17;26;43;3;5;8
96;27.08.2011;2011;08;23;Lauantai;19;23;42;5;4;9
96;28.08.2011;2011;08;00;Sunnuntai;11;19;30;0;1;1
96;28.08.2011;2011;08;01;Sunnuntai;20;7;27;3;0;3
96;28.08.2011;2011;08;02;Sunnuntai;25;2;27;3;0;3
96;28.08.2011;2011;08;03;Sunnuntai;44;2;46;2;0;2
96;28.08.2011;2011;08;04;Sunnuntai;11;0;11;2;0;2
96;28.08.2011;2011;08;05;Sunnuntai;5;0;5;1;1;2
96;28.08.2011;2011;08;06;Sunnuntai;15;7;22;2;0;2
96;28.08.2011;2011;08;07;Sunnuntai;4;14;18;1;0;1
96;28.08.2011;2011;08;08;Sunnuntai;9;18;27;5;3;8
96;28.08.2011;2011;08;09;Sunnuntai;13;18;31;3;2;5
96;28.08.2011;2011;08;10;Sunnuntai;10;41;51;4;6;10
96;28.08.2011;2011;08;11;Sunnuntai;29;26;55;5;10;15
96;28.08.2011;2011;08;12;Sunnuntai;60;68;128;4;16;20
96;28.08.2011;2011;08;13;Sunnuntai;59;77;136;1;10;11
96;28.08.2011;2011;08;14;Sunnuntai;68;51;119;6;8;14
96;28.08.2011;2011;08;15;Sunnuntai;78;70;148;10;7;17
96;28.08.2011;2011;08;16;Sunnuntai;59;54;113;7;12;19
96;28.08.2011;2011;08;17;Sunnuntai;79;51;130;22;10;32
96;28.08.2011;2011;08;18;Sunnuntai;79;35;114;11;13;24
96;28.08.2011;2011;08;19;Sunnuntai;44;61;105;11;15;26
96;28.08.2011;2011;08;20;Sunnuntai;45;54;99;4;7;11
96;28.08.2011;2011;08;21;Sunnuntai;12;28;40;2;9;11
96;28.08.2011;2011;08;22;Sunnuntai;8;9;17;1;1;2
96;28.08.2011;2011;08;23;Sunnuntai;8;2;10;1;0;1
96;29.08.2011;2011;08;00;Maanantai;2;2;4;1;0;1
96;29.08.2011;2011;08;01;Maanantai;2;2;4;1;0;1
96;29.08.2011;2011;08;02;Maanantai;3;1;4;1;0;1
96;29.08.2011;2011;08;03;Maanantai;1;0;1;0;0;0
96;29.08.2011;2011;08;04;Maanantai;1;3;4;0;0;0
96;29.08.2011;2011;08;05;Maanantai;6;7;13;0;1;1
96;29.08.2011;2011;08;06;Maanantai;38;50;88;4;3;7
96;29.08.2011;2011;08;07;Maanantai;149;165;314;18;9;27
96;29.08.2011;2011;08;08;Maanantai;107;168;275;13;8;21
96;29.08.2011;2011;08;09;Maanantai;83;97;180;11;11;22
96;29.08.2011;2011;08;10;Maanantai;42;58;100;14;9;23
96;29.08.2011;2011;08;11;Maanantai;67;74;141;7;12;19
96;29.08.2011;2011;08;12;Maanantai;94;81;175;9;8;17
96;29.08.2011;2011;08;13;Maanantai;102;84;186;8;6;14
96;29.08.2011;2011;08;14;Maanantai;91;123;214;9;11;20
96;29.08.2011;2011;08;15;Maanantai;108;230;338;6;24;30
96;29.08.2011;2011;08;16;Maanantai;164;191;355;5;19;24
96;29.08.2011;2011;08;17;Maanantai;130;84;214;23;14;37
96;29.08.2011;2011;08;18;Maanantai;91;73;164;18;11;29
96;29.08.2011;2011;08;19;Maanantai;72;72;144;19;11;30
96;29.08.2011;2011;08;20;Maanantai;74;48;122;12;11;23
96;29.08.2011;2011;08;21;Maanantai;47;26;73;4;9;13
96;29.08.2011;2011;08;22;Maanantai;12;8;20;3;0;3
96;29.08.2011;2011;08;23;Maanantai;4;0;4;0;0;0
96;30.08.2011;2011;08;00;Tiistai;2;2;4;0;1;1
96;30.08.2011;2011;08;01;Tiistai;2;0;2;0;0;0
96;30.08.2011;2011;08;02;Tiistai;0;0;0;0;0;0
96;30.08.2011;2011;08;03;Tiistai;3;1;4;0;0;0
96;30.08.2011;2011;08;04;Tiistai;2;3;5;0;0;0
96;30.08.2011;2011;08;05;Tiistai;5;6;11;0;0;0
96;30.08.2011;2011;08;06;Tiistai;43;45;88;7;1;8
96;30.08.2011;2011;08;07;Tiistai;145;167;312;17;10;27
96;30.08.2011;2011;08;08;Tiistai;131;157;288;17;10;27
96;30.08.2011;2011;08;09;Tiistai;72;114;186;10;11;21
96;30.08.2011;2011;08;10;Tiistai;51;75;126;4;7;11
96;30.08.2011;2011;08;11;Tiistai;71;71;142;9;3;12
96;30.08.2011;2011;08;12;Tiistai;92;107;199;8;21;29
96;30.08.2011;2011;08;13;Tiistai;85;93;178;20;5;25
96;30.08.2011;2011;08;14;Tiistai;101;152;253;4;18;22
96;30.08.2011;2011;08;15;Tiistai;141;267;408;8;23;31
96;30.08.2011;2011;08;16;Tiistai;185;186;371;10;26;36
96;30.08.2011;2011;08;17;Tiistai;150;77;227;13;16;29
96;30.08.2011;2011;08;18;Tiistai;97;56;153;12;16;28
96;30.08.2011;2011;08;19;Tiistai;63;47;110;12;16;28
96;30.08.2011;2011;08;20;Tiistai;79;51;130;15;17;32
96;30.08.2011;2011;08;21;Tiistai;44;36;80;2;8;10
96;30.08.2011;2011;08;22;Tiistai;15;8;23;4;0;4
96;30.08.2011;2011;08;23;Tiistai;6;0;6;0;0;0
96;31.08.2011;2011;08;00;Keskiviikko;2;2;4;0;0;0
96;31.08.2011;2011;08;01;Keskiviikko;1;0;1;0;0;0
96;31.08.2011;2011;08;02;Keskiviikko;1;0;1;0;0;0
96;31.08.2011;2011;08;03;Keskiviikko;0;0;0;0;0;0
96;31.08.2011;2011;08;04;Keskiviikko;0;4;4;0;0;0
96;31.08.2011;2011;08;05;Keskiviikko;4;7;11;0;0;0
96;31.08.2011;2011;08;06;Keskiviikko;46;47;93;3;1;4
96;31.08.2011;2011;08;07;Keskiviikko;140;153;293;14;11;25
96;31.08.2011;2011;08;08;Keskiviikko;127;129;256;12;7;19
96;31.08.2011;2011;08;09;Keskiviikko;63;99;162;7;4;11
96;31.08.2011;2011;08;10;Keskiviikko;60;71;131;5;6;11
96;31.08.2011;2011;08;11;Keskiviikko;78;78;156;7;8;15
96;31.08.2011;2011;08;12;Keskiviikko;74;109;183;9;9;18
96;31.08.2011;2011;08;13;Keskiviikko;82;85;167;4;11;15
96;31.08.2011;2011;08;14;Keskiviikko;102;146;248;4;15;19
96;31.08.2011;2011;08;15;Keskiviikko;101;180;281;5;18;23
96;31.08.2011;2011;08;16;Keskiviikko;110;152;262;0;9;9
96;31.08.2011;2011;08;17;Keskiviikko;98;87;185;8;9;17
96;31.08.2011;2011;08;18;Keskiviikko;68;60;128;11;7;18
96;31.08.2011;2011;08;19;Keskiviikko;56;40;96;9;11;20
96;31.08.2011;2011;08;20;Keskiviikko;69;41;110;12;6;18
96;31.08.2011;2011;08;21;Keskiviikko;32;41;73;6;7;13
96;31.08.2011;2011;08;22;Keskiviikko;11;12;23;3;6;9
96;31.08.2011;2011;08;23;Keskiviikko;9;11;20;1;0;1
96;01.09.2011;2011;09;00;Torstai;5;1;6;0;0;0
96;01.09.2011;2011;09;01;Torstai;3;0;3;0;0;0
96;01.09.2011;2011;09;02;Torstai;3;0;3;0;0;0
96;01.09.2011;2011;09;03;Torstai;3;0;3;0;0;0
96;01.09.2011;2011;09;04;Torstai;3;5;8;0;0;0
96;01.09.2011;2011;09;05;Torstai;2;5;7;0;2;2
96;01.09.2011;2011;09;06;Torstai;40;38;78;8;1;9
96;01.09.2011;2011;09;07;Torstai;125;163;288;20;6;26
96;01.09.2011;2011;09;08;Torstai;145;147;292;10;9;19
96;01.09.2011;2011;09;09;Torstai;62;93;155;11;9;20
96;01.09.2011;2011;09;10;Torstai;41;77;118;3;4;7
96;01.09.2011;2011;09;11;Torstai;67;80;147;3;6;9
96;01.09.2011;2011;09;12;Torstai;79;75;154;5;5;10
96;01.09.2011;2011;09;13;Torstai;80;58;138;3;6;9
96;01.09.2011;2011;09;14;Torstai;77;125;202;4;7;11
96;01.09.2011;2011;09;15;Torstai;125;199;324;7;32;39
96;01.09.2011;2011;09;16;Torstai;126;154;280;3;16;19
96;01.09.2011;2011;09;17;Torstai;98;82;180;6;7;13
96;01.09.2011;2011;09;18;Torstai;80;71;151;13;12;25
96;01.09.2011;2011;09;19;Torstai;50;46;96;11;9;20
96;01.09.2011;2011;09;20;Torstai;58;44;102;12;10;22
96;01.09.2011;2011;09;21;Torstai;32;24;56;6;6;12
96;01.09.2011;2011;09;22;Torstai;3;14;17;0;6;6
96;01.09.2011;2011;09;23;Torstai;8;2;10;1;0;1
96;02.09.2011;2011;09;00;Perjantai;4;3;7;1;0;1
96;02.09.2011;2011;09;01;Perjantai;4;2;6;0;1;1
96;02.09.2011;2011;09;02;Perjantai;1;0;1;0;0;0
96;02.09.2011;2011;09;03;Perjantai;4;1;5;0;0;0
96;02.09.2011;2011;09;04;Perjantai;3;2;5;0;0;0
96;02.09.2011;2011;09;05;Perjantai;7;8;15;1;1;2
96;02.09.2011;2011;09;06;Perjantai;44;46;90;4;2;6
96;02.09.2011;2011;09;07;Perjantai;109;136;245;12;8;20
96;02.09.2011;2011;09;08;Perjantai;139;111;250;15;10;25
96;02.09.2011;2011;09;09;Perjantai;54;112;166;6;6;12
96;02.09.2011;2011;09;10;Perjantai;39;81;120;3;7;10
96;02.09.2011;2011;09;11;Perjantai;60;96;156;4;5;9
96;02.09.2011;2011;09;12;Perjantai;70;94;164;2;6;8
96;02.09.2011;2011;09;13;Perjantai;88;108;196;6;9;15
96;02.09.2011;2011;09;14;Perjantai;86;146;232;6;13;19
96;02.09.2011;2011;09;15;Perjantai;106;227;333;6;14;20
96;02.09.2011;2011;09;16;Perjantai;87;109;196;17;3;20
96;02.09.2011;2011;09;17;Perjantai;68;56;124;7;7;14
96;02.09.2011;2011;09;18;Perjantai;63;45;108;5;7;12
96;02.09.2011;2011;09;19;Perjantai;39;45;84;11;10;21
96;02.09.2011;2011;09;20;Perjantai;50;30;80;11;6;17
96;02.09.2011;2011;09;21;Perjantai;23;35;58;1;6;7
96;02.09.2011;2011;09;22;Perjantai;13;15;28;1;1;2
96;02.09.2011;2011;09;23;Perjantai;10;8;18;1;0;1
96;03.09.2011;2011;09;00;Lauantai;6;7;13;0;4;4
96;03.09.2011;2011;09;01;Lauantai;9;2;11;1;1;2
96;03.09.2011;2011;09;02;Lauantai;12;0;12;2;0;2
96;03.09.2011;2011;09;03;Lauantai;5;1;6;3;0;3
96;03.09.2011;2011;09;04;Lauantai;10;1;11;1;0;1
96;03.09.2011;2011;09;05;Lauantai;0;6;6;0;1;1
96;03.09.2011;2011;09;06;Lauantai;6;6;12;0;0;0
96;03.09.2011;2011;09;07;Lauantai;7;20;27;3;0;3
96;03.09.2011;2011;09;08;Lauantai;14;34;48;2;2;4
96;03.09.2011;2011;09;09;Lauantai;17;68;85;3;9;12
96;03.09.2011;2011;09;10;Lauantai;22;44;66;23;2;25
96;03.09.2011;2011;09;11;Lauantai;39;87;126;4;15;19
96;03.09.2011;2011;09;12;Lauantai;70;105;175;47;21;68
96;03.09.2011;2011;09;13;Lauantai;60;73;133;32;19;51
96;03.09.2011;2011;09;14;Lauantai;78;57;135;71;14;85
96;03.09.2011;2011;09;15;Lauantai;80;44;124;10;3;13
96;03.09.2011;2011;09;16;Lauantai;62;62;124;6;4;10
96;03.09.2011;2011;09;17;Lauantai;52;31;83;11;5;16
96;03.09.2011;2011;09;18;Lauantai;54;39;93;24;8;32
96;03.09.2011;2011;09;19;Lauantai;46;53;99;4;14;18
96;03.09.2011;2011;09;20;Lauantai;33;42;75;3;5;8
96;03.09.2011;2011;09;21;Lauantai;28;46;74;0;8;8
96;03.09.2011;2011;09;22;Lauantai;14;23;37;3;2;5
96;03.09.2011;2011;09;23;Lauantai;16;26;42;2;0;2
96;04.09.2011;2011;09;00;Sunnuntai;13;8;21;1;0;1
96;04.09.2011;2011;09;01;Sunnuntai;25;3;28;0;0;0
96;04.09.2011;2011;09;02;Sunnuntai;19;2;21;1;0;1
96;04.09.2011;2011;09;03;Sunnuntai;15;2;17;3;0;3
96;04.09.2011;2011;09;04;Sunnuntai;11;1;12;1;0;1
96;04.09.2011;2011;09;05;Sunnuntai;4;1;5;1;0;1
96;04.09.2011;2011;09;06;Sunnuntai;8;3;11;3;0;3
96;04.09.2011;2011;09;07;Sunnuntai;6;17;23;2;3;5
96;04.09.2011;2011;09;08;Sunnuntai;6;10;16;4;3;7
96;04.09.2011;2011;09;09;Sunnuntai;16;15;31;5;10;15
96;04.09.2011;2011;09;10;Sunnuntai;23;37;60;6;6;12
96;04.09.2011;2011;09;11;Sunnuntai;20;53;73;6;8;14
96;04.09.2011;2011;09;12;Sunnuntai;33;62;95;7;8;15
96;04.09.2011;2011;09;13;Sunnuntai;52;57;109;2;10;12
96;04.09.2011;2011;09;14;Sunnuntai;61;69;130;3;10;13
96;04.09.2011;2011;09;15;Sunnuntai;61;50;111;10;15;25
96;04.09.2011;2011;09;16;Sunnuntai;84;61;145;9;12;21
96;04.09.2011;2011;09;17;Sunnuntai;72;43;115;17;4;21
96;04.09.2011;2011;09;18;Sunnuntai;75;51;126;26;13;39
96;04.09.2011;2011;09;19;Sunnuntai;37;56;93;9;25;34
96;04.09.2011;2011;09;20;Sunnuntai;43;45;88;11;9;20
96;04.09.2011;2011;09;21;Sunnuntai;26;21;47;7;6;13
96;04.09.2011;2011;09;22;Sunnuntai;11;12;23;1;3;4
96;04.09.2011;2011;09;23;Sunnuntai;2;7;9;1;0;1
96;05.09.2011;2011;09;00;Maanantai;1;1;2;1;0;1
96;05.09.2011;2011;09;01;Maanantai;1;0;1;0;0;0
96;05.09.2011;2011;09;02;Maanantai;1;0;1;0;0;0
96;05.09.2011;2011;09;03;Maanantai;2;0;2;1;0;1
96;05.09.2011;2011;09;04;Maanantai;2;3;5;2;0;2
96;05.09.2011;2011;09;05;Maanantai;4;11;15;1;0;1
96;05.09.2011;2011;09;06;Maanantai;44;40;84;4;3;7
96;05.09.2011;2011;09;07;Maanantai;153;172;325;22;6;28
96;05.09.2011;2011;09;08;Maanantai;138;168;306;13;9;22
96;05.09.2011;2011;09;09;Maanantai;76;115;191;7;11;18
96;05.09.2011;2011;09;10;Maanantai;46;82;128;13;8;21
96;05.09.2011;2011;09;11;Maanantai;55;91;146;6;9;15
96;05.09.2011;2011;09;12;Maanantai;89;95;184;6;10;16
96;05.09.2011;2011;09;13;Maanantai;104;95;199;6;2;8
96;05.09.2011;2011;09;14;Maanantai;110;137;247;7;15;22
96;05.09.2011;2011;09;15;Maanantai;157;244;401;6;23;29
96;05.09.2011;2011;09;16;Maanantai;172;183;355;4;26;30
96;05.09.2011;2011;09;17;Maanantai;115;126;241;12;15;27
96;05.09.2011;2011;09;18;Maanantai;121;89;210;19;22;41
96;05.09.2011;2011;09;19;Maanantai;82;66;148;20;21;41
96;05.09.2011;2011;09;20;Maanantai;81;53;134;11;13;24
96;05.09.2011;2011;09;21;Maanantai;39;30;69;11;16;27
96;05.09.2011;2011;09;22;Maanantai;11;8;19;1;3;4
96;05.09.2011;2011;09;23;Maanantai;9;11;20;1;0;1
96;06.09.2011;2011;09;00;Tiistai;4;3;7;0;0;0
96;06.09.2011;2011;09;01;Tiistai;5;0;5;0;0;0
96;06.09.2011;2011;09;02;Tiistai;5;0;5;0;0;0
96;06.09.2011;2011;09;03;Tiistai;1;0;1;0;0;0
96;06.09.2011;2011;09;04;Tiistai;4;3;7;2;0;2
96;06.09.2011;2011;09;05;Tiistai;4;7;11;0;0;0
96;06.09.2011;2011;09;06;Tiistai;50;49;99;2;3;5
96;06.09.2011;2011;09;07;Tiistai;144;173;317;20;8;28
96;06.09.2011;2011;09;08;Tiistai;138;190;328;10;10;20
96;06.09.2011;2011;09;09;Tiistai;73;105;178;11;3;14
96;06.09.2011;2011;09;10;Tiistai;65;62;127;10;10;20
96;06.09.2011;2011;09;11;Tiistai;54;111;165;4;7;11
96;06.09.2011;2011;09;12;Tiistai;87;109;196;10;11;21
96;06.09.2011;2011;09;13;Tiistai;71;91;162;4;7;11
96;06.09.2011;2011;09;14;Tiistai;96;118;214;9;10;19
96;06.09.2011;2011;09;15;Tiistai;131;243;374;7;22;29
96;06.09.2011;2011;09;16;Tiistai;171;199;370;5;26;31
96;06.09.2011;2011;09;17;Tiistai;116;82;198;4;16;20
96;06.09.2011;2011;09;18;Tiistai;76;61;137;6;8;14
96;06.09.2011;2011;09;19;Tiistai;45;30;75;13;8;21
96;06.09.2011;2011;09;20;Tiistai;56;21;77;8;6;14
96;06.09.2011;2011;09;21;Tiistai;34;24;58;7;7;14
96;06.09.2011;2011;09;22;Tiistai;16;6;22;1;3;4
96;06.09.2011;2011;09;23;Tiistai;10;3;13;0;1;1
96;07.09.2011;2011;09;00;Keskiviikko;3;2;5;0;0;0
96;07.09.2011;2011;09;01;Keskiviikko;5;0;5;0;0;0
96;07.09.2011;2011;09;02;Keskiviikko;4;1;5;1;0;1
96;07.09.2011;2011;09;03;Keskiviikko;5;0;5;1;0;1
96;07.09.2011;2011;09;04;Keskiviikko;3;2;5;0;0;0
96;07.09.2011;2011;09;05;Keskiviikko;5;7;12;0;0;0
96;07.09.2011;2011;09;06;Keskiviikko;46;45;91;5;3;8
96;07.09.2011;2011;09;07;Keskiviikko;124;155;279;18;5;23
96;07.09.2011;2011;09;08;Keskiviikko;155;160;315;17;7;24
96;07.09.2011;2011;09;09;Keskiviikko;60;100;160;12;13;25
96;07.09.2011;2011;09;10;Keskiviikko;47;50;97;10;4;14
96;07.09.2011;2011;09;11;Keskiviikko;58;89;147;2;4;6
96;07.09.2011;2011;09;12;Keskiviikko;78;72;150;8;10;18
96;07.09.2011;2011;09;13;Keskiviikko;81;103;184;4;8;12
96;07.09.2011;2011;09;14;Keskiviikko;107;156;263;4;19;23
96;07.09.2011;2011;09;15;Keskiviikko;136;257;393;7;24;31
96;07.09.2011;2011;09;16;Keskiviikko;142;197;339;9;23;32
96;07.09.2011;2011;09;17;Keskiviikko;127;140;267;5;15;20
96;07.09.2011;2011;09;18;Keskiviikko;127;67;194;23;10;33
96;07.09.2011;2011;09;19;Keskiviikko;121;64;185;15;14;29
96;07.09.2011;2011;09;20;Keskiviikko;87;59;146;11;14;25
96;07.09.2011;2011;09;21;Keskiviikko;41;79;120;4;4;8
96;07.09.2011;2011;09;22;Keskiviikko;7;11;18;1;1;2
96;07.09.2011;2011;09;23;Keskiviikko;23;5;28;2;0;2
96;08.09.2011;2011;09;00;Torstai;9;9;18;0;0;0
96;08.09.2011;2011;09;01;Torstai;6;1;7;1;0;1
96;08.09.2011;2011;09;02;Torstai;4;1;5;0;0;0
96;08.09.2011;2011;09;03;Torstai;7;0;7;1;0;1
96;08.09.2011;2011;09;04;Torstai;5;3;8;0;0;0
96;08.09.2011;2011;09;05;Torstai;6;9;15;1;0;1
96;08.09.2011;2011;09;06;Torstai;52;28;80;8;1;9
96;08.09.2011;2011;09;07;Torstai;134;149;283;20;13;33
96;08.09.2011;2011;09;08;Torstai;161;154;315;71;49;120
96;08.09.2011;2011;09;09;Torstai;49;105;154;11;5;16
96;08.09.2011;2011;09;10;Torstai;45;61;106;10;12;22
96;08.09.2011;2011;09;11;Torstai;69;70;139;4;4;8
96;08.09.2011;2011;09;12;Torstai;94;95;189;4;5;9
96;08.09.2011;2011;09;13;Torstai;70;104;174;4;8;12
96;08.09.2011;2011;09;14;Torstai;77;135;212;5;10;15
96;08.09.2011;2011;09;15;Torstai;107;252;359;3;26;29
96;08.09.2011;2011;09;16;Torstai;162;173;335;8;25;33
96;08.09.2011;2011;09;17;Torstai;99;100;199;22;13;35
96;08.09.2011;2011;09;18;Torstai;62;69;131;8;16;24
96;08.09.2011;2011;09;19;Torstai;65;50;115;12;14;26
96;08.09.2011;2011;09;20;Torstai;94;44;138;7;12;19
96;08.09.2011;2011;09;21;Torstai;31;40;71;2;7;9
96;08.09.2011;2011;09;22;Torstai;12;15;27;0;1;1
96;08.09.2011;2011;09;23;Torstai;3;2;5;1;0;1
96;09.09.2011;2011;09;00;Perjantai;7;2;9;1;0;1
96;09.09.2011;2011;09;01;Perjantai;1;0;1;0;1;1
96;09.09.2011;2011;09;02;Perjantai;2;1;3;0;0;0
96;09.09.2011;2011;09;03;Perjantai;3;0;3;0;0;0
96;09.09.2011;2011;09;04;Perjantai;3;2;5;0;0;0
96;09.09.2011;2011;09;05;Perjantai;5;12;17;1;0;1
96;09.09.2011;2011;09;06;Perjantai;48;40;88;6;2;8
96;09.09.2011;2011;09;07;Perjantai;110;137;247;13;5;18
96;09.09.2011;2011;09;08;Perjantai;145;149;294;9;4;13
96;09.09.2011;2011;09;09;Perjantai;45;106;151;5;10;15
96;09.09.2011;2011;09;10;Perjantai;42;95;137;5;5;10
96;09.09.2011;2011;09;11;Perjantai;56;86;142;9;6;15
96;09.09.2011;2011;09;12;Perjantai;83;90;173;3;8;11
96;09.09.2011;2011;09;13;Perjantai;82;102;184;7;7;14
96;09.09.2011;2011;09;14;Perjantai;110;164;274;2;15;17
96;09.09.2011;2011;09;15;Perjantai;117;191;308;5;18;23
96;09.09.2011;2011;09;16;Perjantai;110;104;214;7;16;23
96;09.09.2011;2011;09;17;Perjantai;75;77;152;15;7;22
96;09.09.2011;2011;09;18;Perjantai;88;56;144;8;7;15
96;09.09.2011;2011;09;19;Perjantai;56;65;121;11;6;17
96;09.09.2011;2011;09;20;Perjantai;49;45;94;2;8;10
96;09.09.2011;2011;09;21;Perjantai;27;34;61;2;2;4
96;09.09.2011;2011;09;22;Perjantai;9;20;29;0;1;1
96;09.09.2011;2011;09;23;Perjantai;14;17;31;2;1;3
96;10.09.2011;2011;09;00;Lauantai;10;3;13;1;0;1
96;10.09.2011;2011;09;01;Lauantai;7;7;14;1;0;1
96;10.09.2011;2011;09;02;Lauantai;22;5;27;1;0;1
96;10.09.2011;2011;09;03;Lauantai;14;2;16;2;1;3
96;10.09.2011;2011;09;04;Lauantai;10;2;12;4;1;5
96;10.09.2011;2011;09;05;Lauantai;3;2;5;3;0;3
96;10.09.2011;2011;09;06;Lauantai;20;3;23;4;0;4
96;10.09.2011;2011;09;07;Lauantai;5;18;23;4;1;5
96;10.09.2011;2011;09;08;Lauantai;13;18;31;4;2;6
96;10.09.2011;2011;09;09;Lauantai;10;30;40;5;1;6
96;10.09.2011;2011;09;10;Lauantai;11;72;83;3;9;12
96;10.09.2011;2011;09;11;Lauantai;43;46;89;5;12;17
96;10.09.2011;2011;09;12;Lauantai;50;58;108;7;8;15
96;10.09.2011;2011;09;13;Lauantai;56;61;117;2;9;11
96;10.09.2011;2011;09;14;Lauantai;43;62;105;12;8;20
96;10.09.2011;2011;09;15;Lauantai;48;69;117;7;17;24
96;10.09.2011;2011;09;16;Lauantai;50;44;94;8;9;17
96;10.09.2011;2011;09;17;Lauantai;51;49;100;16;12;28
96;10.09.2011;2011;09;18;Lauantai;59;42;101;20;7;27
96;10.09.2011;2011;09;19;Lauantai;43;33;76;7;6;13
96;10.09.2011;2011;09;20;Lauantai;30;25;55;3;5;8
96;10.09.2011;2011;09;21;Lauantai;21;36;57;5;6;11
96;10.09.2011;2011;09;22;Lauantai;10;16;26;1;2;3
96;10.09.2011;2011;09;23;Lauantai;10;18;28;0;2;2
96;11.09.2011;2011;09;00;Sunnuntai;13;6;19;0;0;0
96;11.09.2011;2011;09;01;Sunnuntai;13;3;16;1;0;1
96;11.09.2011;2011;09;02;Sunnuntai;17;0;17;0;0;0
96;11.09.2011;2011;09;03;Sunnuntai;12;2;14;1;0;1
96;11.09.2011;2011;09;04;Sunnuntai;12;0;12;0;1;1
96;11.09.2011;2011;09;05;Sunnuntai;5;2;7;0;0;0
96;11.09.2011;2011;09;06;Sunnuntai;13;5;18;1;1;2
96;11.09.2011;2011;09;07;Sunnuntai;4;7;11;1;1;2
96;11.09.2011;2011;09;08;Sunnuntai;6;8;14;2;1;3
96;11.09.2011;2011;09;09;Sunnuntai;10;15;25;3;4;7
96;11.09.2011;2011;09;10;Sunnuntai;9;28;37;2;6;8
96;11.09.2011;2011;09;11;Sunnuntai;13;40;53;6;10;16
96;11.09.2011;2011;09;12;Sunnuntai;49;36;85;5;12;17
96;11.09.2011;2011;09;13;Sunnuntai;63;39;102;12;16;28
96;11.09.2011;2011;09;14;Sunnuntai;49;50;99;31;31;62
96;11.09.2011;2011;09;15;Sunnuntai;52;49;101;2;9;11
96;11.09.2011;2011;09;16;Sunnuntai;74;45;119;27;3;30
96;11.09.2011;2011;09;17;Sunnuntai;57;55;112;14;12;26
96;11.09.2011;2011;09;18;Sunnuntai;60;42;102;12;21;33
96;11.09.2011;2011;09;19;Sunnuntai;26;34;60;7;10;17
96;11.09.2011;2011;09;20;Sunnuntai;39;52;91;8;23;31
96;11.09.2011;2011;09;21;Sunnuntai;17;32;49;4;9;13
96;11.09.2011;2011;09;22;Sunnuntai;7;14;21;2;1;3
96;11.09.2011;2011;09;23;Sunnuntai;8;3;11;2;0;2
96;12.09.2011;2011;09;00;Maanantai;4;2;6;1;0;1
96;12.09.2011;2011;09;01;Maanantai;2;0;2;1;0;1
96;12.09.2011;2011;09;02;Maanantai;1;0;1;0;0;0
96;12.09.2011;2011;09;03;Maanantai;1;1;2;0;0;0
96;12.09.2011;2011;09;04;Maanantai;3;3;6;0;0;0
96;12.09.2011;2011;09;05;Maanantai;4;9;13;2;0;2
96;12.09.2011;2011;09;06;Maanantai;45;33;78;4;3;7
96;12.09.2011;2011;09;07;Maanantai;122;147;269;13;8;21
96;12.09.2011;2011;09;08;Maanantai;144;146;290;13;6;19
96;12.09.2011;2011;09;09;Maanantai;66;117;183;8;16;24
96;12.09.2011;2011;09;10;Maanantai;49;59;108;7;8;15
96;12.09.2011;2011;09;11;Maanantai;62;75;137;9;8;17
96;12.09.2011;2011;09;12;Maanantai;64;53;117;4;8;12
96;12.09.2011;2011;09;13;Maanantai;72;66;138;9;4;13
96;12.09.2011;2011;09;14;Maanantai;91;116;207;3;9;12
96;12.09.2011;2011;09;15;Maanantai;97;221;318;6;18;24
96;12.09.2011;2011;09;16;Maanantai;125;182;307;8;17;25
96;12.09.2011;2011;09;17;Maanantai;78;87;165;5;6;11
96;12.09.2011;2011;09;18;Maanantai;63;57;120;13;10;23
96;12.09.2011;2011;09;19;Maanantai;63;44;107;14;12;26
96;12.09.2011;2011;09;20;Maanantai;67;31;98;11;14;25
96;12.09.2011;2011;09;21;Maanantai;32;25;57;4;5;9
96;12.09.2011;2011;09;22;Maanantai;4;7;11;0;3;3
96;12.09.2011;2011;09;23;Maanantai;7;1;8;0;0;0
96;13.09.2011;2011;09;00;Tiistai;2;2;4;0;0;0
96;13.09.2011;2011;09;01;Tiistai;0;2;2;0;0;0
96;13.09.2011;2011;09;02;Tiistai;3;0;3;0;0;0
96;13.09.2011;2011;09;03;Tiistai;0;0;0;0;0;0
96;13.09.2011;2011;09;04;Tiistai;2;6;8;0;0;0
96;13.09.2011;2011;09;05;Tiistai;3;9;12;2;0;2
96;13.09.2011;2011;09;06;Tiistai;41;29;70;6;0;6
96;13.09.2011;2011;09;07;Tiistai;117;146;263;17;8;25
96;13.09.2011;2011;09;08;Tiistai;135;128;263;11;7;18
96;13.09.2011;2011;09;09;Tiistai;70;110;180;12;7;19
96;13.09.2011;2011;09;10;Tiistai;59;60;119;10;12;22
96;13.09.2011;2011;09;11;Tiistai;58;59;117;5;10;15
96;13.09.2011;2011;09;12;Tiistai;67;87;154;11;3;14
96;13.09.2011;2011;09;13;Tiistai;58;76;134;5;11;16
96;13.09.2011;2011;09;14;Tiistai;59;122;181;6;13;19
96;13.09.2011;2011;09;15;Tiistai;102;233;335;9;26;35
96;13.09.2011;2011;09;16;Tiistai;134;204;338;13;22;35
96;13.09.2011;2011;09;17;Tiistai;102;97;199;10;11;21
96;13.09.2011;2011;09;18;Tiistai;78;79;157;21;20;41
96;13.09.2011;2011;09;19;Tiistai;77;64;141;9;10;19
96;13.09.2011;2011;09;20;Tiistai;78;47;125;9;8;17
96;13.09.2011;2011;09;21;Tiistai;34;26;60;5;4;9
96;13.09.2011;2011;09;22;Tiistai;10;7;17;0;4;4
96;13.09.2011;2011;09;23;Tiistai;5;2;7;0;0;0
96;14.09.2011;2011;09;00;Keskiviikko;4;1;5;0;1;1
96;14.09.2011;2011;09;01;Keskiviikko;3;2;5;0;0;0
96;14.09.2011;2011;09;02;Keskiviikko;1;1;2;0;0;0
96;14.09.2011;2011;09;03;Keskiviikko;1;0;1;0;0;0
96;14.09.2011;2011;09;04;Keskiviikko;4;3;7;0;0;0
96;14.09.2011;2011;09;05;Keskiviikko;3;13;16;0;0;0
96;14.09.2011;2011;09;06;Keskiviikko;40;27;67;5;3;8
96;14.09.2011;2011;09;07;Keskiviikko;115;109;224;21;6;27
96;14.09.2011;2011;09;08;Keskiviikko;140;143;283;11;12;23
96;14.09.2011;2011;09;09;Keskiviikko;49;95;144;6;4;10
96;14.09.2011;2011;09;10;Keskiviikko;52;67;119;7;9;16
96;14.09.2011;2011;09;11;Keskiviikko;56;55;111;3;8;11
96;14.09.2011;2011;09;12;Keskiviikko;90;74;164;6;9;15
96;14.09.2011;2011;09;13;Keskiviikko;79;88;167;3;5;8
96;14.09.2011;2011;09;14;Keskiviikko;91;132;223;4;10;14
96;14.09.2011;2011;09;15;Keskiviikko;109;194;303;9;21;30
96;14.09.2011;2011;09;16;Keskiviikko;102;178;280;13;29;42
96;14.09.2011;2011;09;17;Keskiviikko;70;104;174;7;14;21
96;14.09.2011;2011;09;18;Keskiviikko;118;67;185;12;20;32
96;14.09.2011;2011;09;19;Keskiviikko;75;55;130;11;11;22
96;14.09.2011;2011;09;20;Keskiviikko;70;47;117;13;24;37
96;14.09.2011;2011;09;21;Keskiviikko;33;80;113;5;10;15
96;14.09.2011;2011;09;22;Keskiviikko;11;15;26;1;8;9
96;14.09.2011;2011;09;23;Keskiviikko;3;9;12;0;0;0
96;15.09.2011;2011;09;00;Torstai;5;4;9;0;1;1
96;15.09.2011;2011;09;01;Torstai;4;0;4;0;0;0
96;15.09.2011;2011;09;02;Torstai;7;0;7;0;0;0
96;15.09.2011;2011;09;03;Torstai;4;0;4;0;0;0
96;15.09.2011;2011;09;04;Torstai;2;5;7;1;1;2
96;15.09.2011;2011;09;05;Torstai;2;6;8;1;0;1
96;15.09.2011;2011;09;06;Torstai;51;28;79;2;0;2
96;15.09.2011;2011;09;07;Torstai;101;144;245;19;3;22
96;15.09.2011;2011;09;08;Torstai;162;144;306;12;8;20
96;15.09.2011;2011;09;09;Torstai;69;93;162;8;3;11
96;15.09.2011;2011;09;10;Torstai;48;66;114;6;11;17
96;15.09.2011;2011;09;11;Torstai;75;68;143;5;6;11
96;15.09.2011;2011;09;12;Torstai;67;85;152;4;4;8
96;15.09.2011;2011;09;13;Torstai;62;113;175;6;10;16
96;15.09.2011;2011;09;14;Torstai;92;149;241;12;28;40
96;15.09.2011;2011;09;15;Torstai;128;213;341;12;20;32
96;15.09.2011;2011;09;16;Torstai;139;151;290;5;23;28
96;15.09.2011;2011;09;17;Torstai;95;92;187;12;10;22
96;15.09.2011;2011;09;18;Torstai;74;68;142;11;16;27
96;15.09.2011;2011;09;19;Torstai;52;60;112;18;9;27
96;15.09.2011;2011;09;20;Torstai;63;43;106;6;14;20
96;15.09.2011;2011;09;21;Torstai;42;30;72;7;6;13
96;15.09.2011;2011;09;22;Torstai;17;4;21;4;3;7
96;15.09.2011;2011;09;23;Torstai;8;8;16;2;0;2
96;16.09.2011;2011;09;00;Perjantai;6;0;6;1;2;3
96;16.09.2011;2011;09;01;Perjantai;6;4;10;2;0;2
96;16.09.2011;2011;09;02;Perjantai;6;1;7;1;0;1
96;16.09.2011;2011;09;03;Perjantai;4;0;4;0;0;0
96;16.09.2011;2011;09;04;Perjantai;2;5;7;0;0;0
96;16.09.2011;2011;09;05;Perjantai;6;7;13;1;0;1
96;16.09.2011;2011;09;06;Perjantai;49;38;87;3;4;7
96;16.09.2011;2011;09;07;Perjantai;119;122;241;15;8;23
96;16.09.2011;2011;09;08;Perjantai;136;149;285;20;20;40
96;16.09.2011;2011;09;09;Perjantai;65;105;170;5;15;20
96;16.09.2011;2011;09;10;Perjantai;40;71;111;5;10;15
96;16.09.2011;2011;09;11;Perjantai;69;79;148;3;6;9
96;16.09.2011;2011;09;12;Perjantai;69;122;191;7;10;17
96;16.09.2011;2011;09;13;Perjantai;80;123;203;14;24;38
96;16.09.2011;2011;09;14;Perjantai;115;154;269;7;13;20
96;16.09.2011;2011;09;15;Perjantai;126;191;317;3;14;17
96;16.09.2011;2011;09;16;Perjantai;125;96;221;9;10;19
96;16.09.2011;2011;09;17;Perjantai;84;72;156;13;9;22
96;16.09.2011;2011;09;18;Perjantai;57;47;104;15;5;20
96;16.09.2011;2011;09;19;Perjantai;38;34;72;4;8;12
96;16.09.2011;2011;09;20;Perjantai;47;31;78;10;7;17
96;16.09.2011;2011;09;21;Perjantai;29;37;66;2;8;10
96;16.09.2011;2011;09;22;Perjantai;5;17;22;1;0;1
96;16.09.2011;2011;09;23;Perjantai;13;17;30;0;3;3
96;17.09.2011;2011;09;00;Lauantai;13;2;15;0;0;0
96;17.09.2011;2011;09;01;Lauantai;8;6;14;1;0;1
96;17.09.2011;2011;09;02;Lauantai;11;1;12;1;0;1
96;17.09.2011;2011;09;03;Lauantai;10;1;11;0;0;0
96;17.09.2011;2011;09;04;Lauantai;3;1;4;1;0;1
96;17.09.2011;2011;09;05;Lauantai;2;1;3;0;0;0
96;17.09.2011;2011;09;06;Lauantai;12;12;24;4;0;4
96;17.09.2011;2011;09;07;Lauantai;4;10;14;1;1;2
96;17.09.2011;2011;09;08;Lauantai;20;19;39;8;3;11
96;17.09.2011;2011;09;09;Lauantai;15;45;60;4;22;26
96;17.09.2011;2011;09;10;Lauantai;27;54;81;5;12;17
96;17.09.2011;2011;09;11;Lauantai;47;61;108;6;9;15
96;17.09.2011;2011;09;12;Lauantai;48;79;127;15;12;27
96;17.09.2011;2011;09;13;Lauantai;57;56;113;10;15;25
96;17.09.2011;2011;09;14;Lauantai;67;64;131;15;14;29
96;17.09.2011;2011;09;15;Lauantai;67;78;145;16;7;23
96;17.09.2011;2011;09;16;Lauantai;58;79;137;8;22;30
96;17.09.2011;2011;09;17;Lauantai;49;28;77;8;8;16
96;17.09.2011;2011;09;18;Lauantai;59;37;96;14;5;19
96;17.09.2011;2011;09;19;Lauantai;108;32;140;18;19;37
96;17.09.2011;2011;09;20;Lauantai;42;38;80;6;9;15
96;17.09.2011;2011;09;21;Lauantai;9;38;47;1;8;9
96;17.09.2011;2011;09;22;Lauantai;8;22;30;1;1;2
96;17.09.2011;2011;09;23;Lauantai;6;9;15;1;0;1
96;18.09.2011;2011;09;00;Sunnuntai;6;7;13;1;0;1
96;18.09.2011;2011;09;01;Sunnuntai;11;2;13;0;0;0
96;18.09.2011;2011;09;02;Sunnuntai;13;0;13;1;0;1
96;18.09.2011;2011;09;03;Sunnuntai;13;0;13;2;0;2
96;18.09.2011;2011;09;04;Sunnuntai;12;0;12;4;0;4
96;18.09.2011;2011;09;05;Sunnuntai;6;1;7;0;0;0
96;18.09.2011;2011;09;06;Sunnuntai;18;6;24;3;0;3
96;18.09.2011;2011;09;07;Sunnuntai;3;11;14;1;1;2
96;18.09.2011;2011;09;08;Sunnuntai;3;8;11;4;2;6
96;18.09.2011;2011;09;09;Sunnuntai;8;13;21;6;1;7
96;18.09.2011;2011;09;10;Sunnuntai;22;32;54;7;14;21
96;18.09.2011;2011;09;11;Sunnuntai;33;46;79;6;11;17
96;18.09.2011;2011;09;12;Sunnuntai;65;48;113;21;21;42
96;18.09.2011;2011;09;13;Sunnuntai;57;63;120;15;20;35
96;18.09.2011;2011;09;14;Sunnuntai;58;63;121;13;21;34
96;18.09.2011;2011;09;15;Sunnuntai;62;64;126;18;19;37
96;18.09.2011;2011;09;16;Sunnuntai;74;61;135;15;11;26
96;18.09.2011;2011;09;17;Sunnuntai;51;46;97;28;14;42
96;18.09.2011;2011;09;18;Sunnuntai;49;44;93;13;10;23
96;18.09.2011;2011;09;19;Sunnuntai;36;31;67;14;15;29
96;18.09.2011;2011;09;20;Sunnuntai;32;29;61;6;13;19
96;18.09.2011;2011;09;21;Sunnuntai;26;25;51;4;4;8
96;18.09.2011;2011;09;22;Sunnuntai;5;7;12;1;2;3
96;18.09.2011;2011;09;23;Sunnuntai;9;3;12;0;1;1
96;19.09.2011;2011;09;00;Maanantai;5;1;6;0;0;0
96;19.09.2011;2011;09;01;Maanantai;1;1;2;0;0;0
96;19.09.2011;2011;09;02;Maanantai;2;0;2;0;0;0
96;19.09.2011;2011;09;03;Maanantai;2;0;2;0;0;0
96;19.09.2011;2011;09;04;Maanantai;2;5;7;0;1;1
96;19.09.2011;2011;09;05;Maanantai;5;12;17;1;0;1
96;19.09.2011;2011;09;06;Maanantai;38;36;74;4;4;8
96;19.09.2011;2011;09;07;Maanantai;121;132;253;20;9;29
96;19.09.2011;2011;09;08;Maanantai;152;193;345;14;8;22
96;19.09.2011;2011;09;09;Maanantai;60;84;144;7;5;12
96;19.09.2011;2011;09;10;Maanantai;50;82;132;9;3;12
96;19.09.2011;2011;09;11;Maanantai;68;84;152;7;8;15
96;19.09.2011;2011;09;12;Maanantai;85;81;166;6;10;16
96;19.09.2011;2011;09;13;Maanantai;115;105;220;8;7;15
96;19.09.2011;2011;09;14;Maanantai;104;158;262;4;11;15
96;19.09.2011;2011;09;15;Maanantai;117;225;342;6;25;31
96;19.09.2011;2011;09;16;Maanantai;151;204;355;11;27;38
96;19.09.2011;2011;09;17;Maanantai;113;109;222;14;10;24
96;19.09.2011;2011;09;18;Maanantai;99;73;172;11;27;38
96;19.09.2011;2011;09;19;Maanantai;85;48;133;15;18;33
96;19.09.2011;2011;09;20;Maanantai;86;32;118;11;14;25
96;19.09.2011;2011;09;21;Maanantai;48;37;85;8;5;13
96;19.09.2011;2011;09;22;Maanantai;10;7;17;0;2;2
96;19.09.2011;2011;09;23;Maanantai;7;4;11;0;1;1
96;20.09.2011;2011;09;00;Tiistai;0;4;4;0;0;0
96;20.09.2011;2011;09;01;Tiistai;1;0;1;0;1;1
96;20.09.2011;2011;09;02;Tiistai;0;0;0;0;0;0
96;20.09.2011;2011;09;03;Tiistai;0;0;0;0;0;0
96;20.09.2011;2011;09;04;Tiistai;3;4;7;0;0;0
96;20.09.2011;2011;09;05;Tiistai;4;6;10;2;0;2
96;20.09.2011;2011;09;06;Tiistai;45;42;87;5;2;7
96;20.09.2011;2011;09;07;Tiistai;93;123;216;18;12;30
96;20.09.2011;2011;09;08;Tiistai;118;103;221;10;5;15
96;20.09.2011;2011;09;09;Tiistai;45;56;101;6;3;9
96;20.09.2011;2011;09;10;Tiistai;36;38;74;4;0;4
96;20.09.2011;2011;09;11;Tiistai;32;29;61;8;3;11
96;20.09.2011;2011;09;12;Tiistai;49;34;83;10;8;18
96;20.09.2011;2011;09;13;Tiistai;33;82;115;2;5;7
96;20.09.2011;2011;09;14;Tiistai;67;94;161;3;9;12
96;20.09.2011;2011;09;15;Tiistai;76;179;255;10;23;33
96;20.09.2011;2011;09;16;Tiistai;108;143;251;9;18;27
96;20.09.2011;2011;09;17;Tiistai;69;65;134;14;12;26
96;20.09.2011;2011;09;18;Tiistai;56;77;133;8;17;25
96;20.09.2011;2011;09;19;Tiistai;42;46;88;16;8;24
96;20.09.2011;2011;09;20;Tiistai;101;34;135;16;9;25
96;20.09.2011;2011;09;21;Tiistai;31;24;55;5;3;8
96;20.09.2011;2011;09;22;Tiistai;9;8;17;1;4;5
96;20.09.2011;2011;09;23;Tiistai;10;3;13;2;1;3
96;21.09.2011;2011;09;00;Keskiviikko;4;2;6;1;0;1
96;21.09.2011;2011;09;01;Keskiviikko;1;0;1;0;0;0
96;21.09.2011;2011;09;02;Keskiviikko;1;0;1;0;0;0
96;21.09.2011;2011;09;03;Keskiviikko;0;0;0;0;0;0
96;21.09.2011;2011;09;04;Keskiviikko;3;3;6;0;0;0
96;21.09.2011;2011;09;05;Keskiviikko;2;9;11;0;0;0
96;21.09.2011;2011;09;06;Keskiviikko;41;40;81;3;2;5
96;21.09.2011;2011;09;07;Keskiviikko;123;140;263;19;7;26
96;21.09.2011;2011;09;08;Keskiviikko;138;152;290;15;3;18
96;21.09.2011;2011;09;09;Keskiviikko;65;105;170;4;10;14
96;21.09.2011;2011;09;10;Keskiviikko;57;53;110;3;8;11
96;21.09.2011;2011;09;11;Keskiviikko;66;60;126;5;5;10
96;21.09.2011;2011;09;12;Keskiviikko;76;69;145;7;6;13
96;21.09.2011;2011;09;13;Keskiviikko;73;96;169;3;5;8
96;21.09.2011;2011;09;14;Keskiviikko;99;125;224;11;25;36
96;21.09.2011;2011;09;15;Keskiviikko;111;213;324;12;19;31
96;21.09.2011;2011;09;16;Keskiviikko;140;199;339;14;23;37
96;21.09.2011;2011;09;17;Keskiviikko;96;118;214;6;7;13
96;21.09.2011;2011;09;18;Keskiviikko;108;54;162;10;12;22
96;21.09.2011;2011;09;19;Keskiviikko;82;43;125;17;13;30
96;21.09.2011;2011;09;20;Keskiviikko;57;54;111;6;11;17
96;21.09.2011;2011;09;21;Keskiviikko;35;24;59;5;9;14
96;21.09.2011;2011;09;22;Keskiviikko;7;12;19;0;3;3
96;21.09.2011;2011;09;23;Keskiviikko;8;9;17;0;0;0
96;22.09.2011;2011;09;00;Torstai;4;1;5;0;0;0
96;22.09.2011;2011;09;01;Torstai;3;2;5;2;0;2
96;22.09.2011;2011;09;02;Torstai;3;0;3;0;0;0
96;22.09.2011;2011;09;03;Torstai;1;0;1;0;0;0
96;22.09.2011;2011;09;04;Torstai;5;4;9;1;0;1
96;22.09.2011;2011;09;05;Torstai;6;9;15;1;0;1
96;22.09.2011;2011;09;06;Torstai;47;23;70;3;3;6
96;22.09.2011;2011;09;07;Torstai;105;146;251;18;6;24
96;22.09.2011;2011;09;08;Torstai;136;133;269;18;9;27
96;22.09.2011;2011;09;09;Torstai;48;69;117;5;2;7
96;22.09.2011;2011;09;10;Torstai;38;44;82;7;6;13
96;22.09.2011;2011;09;11;Torstai;55;54;109;6;11;17
96;22.09.2011;2011;09;12;Torstai;47;68;115;5;5;10
96;22.09.2011;2011;09;13;Torstai;58;63;121;4;11;15
96;22.09.2011;2011;09;14;Torstai;60;115;175;1;18;19
96;22.09.2011;2011;09;15;Torstai;93;188;281;4;17;21
96;22.09.2011;2011;09;16;Torstai;102;141;243;10;21;31
96;22.09.2011;2011;09;17;Torstai;77;64;141;8;4;12
96;22.09.2011;2011;09;18;Torstai;56;64;120;3;9;12
96;22.09.2011;2011;09;19;Torstai;41;38;79;10;7;17
96;22.09.2011;2011;09;20;Torstai;54;21;75;5;8;13
96;22.09.2011;2011;09;21;Torstai;27;34;61;2;7;9
96;22.09.2011;2011;09;22;Torstai;4;7;11;0;0;0
96;22.09.2011;2011;09;23;Torstai;3;1;4;0;1;1
96;23.09.2011;2011;09;00;Perjantai;3;1;4;0;0;0
96;23.09.2011;2011;09;01;Perjantai;4;1;5;1;0;1
96;23.09.2011;2011;09;02;Perjantai;3;0;3;0;0;0
96;23.09.2011;2011;09;03;Perjantai;1;0;1;0;0;0
96;23.09.2011;2011;09;04;Perjantai;4;3;7;0;1;1
96;23.09.2011;2011;09;05;Perjantai;3;12;15;2;0;2
96;23.09.2011;2011;09;06;Perjantai;43;28;71;3;2;5
96;23.09.2011;2011;09;07;Perjantai;100;118;218;15;8;23
96;23.09.2011;2011;09;08;Perjantai;113;132;245;8;6;14
96;23.09.2011;2011;09;09;Perjantai;28;57;85;8;2;10
96;23.09.2011;2011;09;10;Perjantai;45;52;97;2;13;15
96;23.09.2011;2011;09;11;Perjantai;50;79;129;8;6;14
96;23.09.2011;2011;09;12;Perjantai;91;98;189;6;6;12
96;23.09.2011;2011;09;13;Perjantai;78;98;176;8;4;12
96;23.09.2011;2011;09;14;Perjantai;95;143;238;5;8;13
96;23.09.2011;2011;09;15;Perjantai;94;144;238;5;14;19
96;23.09.2011;2011;09;16;Perjantai;69;76;145;7;10;17
96;23.09.2011;2011;09;17;Perjantai;60;53;113;11;8;19
96;23.09.2011;2011;09;18;Perjantai;43;40;83;15;13;28
96;23.09.2011;2011;09;19;Perjantai;35;21;56;6;11;17
96;23.09.2011;2011;09;20;Perjantai;26;17;43;4;2;6
96;23.09.2011;2011;09;21;Perjantai;30;21;51;12;6;18
96;23.09.2011;2011;09;22;Perjantai;5;15;20;1;3;4
96;23.09.2011;2011;09;23;Perjantai;6;6;12;3;2;5
96;24.09.2011;2011;09;00;Lauantai;5;9;14;2;2;4
96;24.09.2011;2011;09;01;Lauantai;4;4;8;0;0;0
96;24.09.2011;2011;09;02;Lauantai;7;1;8;3;0;3
96;24.09.2011;2011;09;03;Lauantai;11;1;12;0;0;0
96;24.09.2011;2011;09;04;Lauantai;2;1;3;1;0;1
96;24.09.2011;2011;09;05;Lauantai;3;2;5;0;0;0
96;24.09.2011;2011;09;06;Lauantai;24;8;32;2;0;2
96;24.09.2011;2011;09;07;Lauantai;5;13;18;1;1;2
96;24.09.2011;2011;09;08;Lauantai;10;24;34;3;6;9
96;24.09.2011;2011;09;09;Lauantai;11;40;51;3;2;5
96;24.09.2011;2011;09;10;Lauantai;12;45;57;4;5;9
96;24.09.2011;2011;09;11;Lauantai;30;56;86;5;4;9
96;24.09.2011;2011;09;12;Lauantai;59;48;107;6;9;15
96;24.09.2011;2011;09;13;Lauantai;55;53;108;7;9;16
96;24.09.2011;2011;09;14;Lauantai;63;58;121;8;4;12
96;24.09.2011;2011;09;15;Lauantai;47;56;103;6;8;14
96;24.09.2011;2011;09;16;Lauantai;53;41;94;4;15;19
96;24.09.2011;2011;09;17;Lauantai;44;26;70;6;3;9
96;24.09.2011;2011;09;18;Lauantai;53;16;69;13;11;24
96;24.09.2011;2011;09;19;Lauantai;34;17;51;12;6;18
96;24.09.2011;2011;09;20;Lauantai;16;26;42;3;3;6
96;24.09.2011;2011;09;21;Lauantai;16;21;37;2;8;10
96;24.09.2011;2011;09;22;Lauantai;8;37;45;2;10;12
96;24.09.2011;2011;09;23;Lauantai;8;12;20;1;0;1
96;25.09.2011;2011;09;00;Sunnuntai;14;7;21;0;2;2
96;25.09.2011;2011;09;01;Sunnuntai;6;3;9;0;0;0
96;25.09.2011;2011;09;02;Sunnuntai;17;3;20;1;0;1
96;25.09.2011;2011;09;03;Sunnuntai;15;1;16;7;0;7
96;25.09.2011;2011;09;04;Sunnuntai;13;1;14;5;0;5
96;25.09.2011;2011;09;05;Sunnuntai;3;1;4;0;0;0
96;25.09.2011;2011;09;06;Sunnuntai;18;1;19;3;0;3
96;25.09.2011;2011;09;07;Sunnuntai;2;9;11;1;2;3
96;25.09.2011;2011;09;08;Sunnuntai;6;11;17;2;0;2
96;25.09.2011;2011;09;09;Sunnuntai;9;24;33;3;4;7
96;25.09.2011;2011;09;10;Sunnuntai;20;22;42;5;5;10
96;25.09.2011;2011;09;11;Sunnuntai;17;34;51;8;12;20
96;25.09.2011;2011;09;12;Sunnuntai;32;51;83;5;13;18
96;25.09.2011;2011;09;13;Sunnuntai;58;57;115;10;10;20
96;25.09.2011;2011;09;14;Sunnuntai;52;57;109;14;5;19
96;25.09.2011;2011;09;15;Sunnuntai;53;46;99;6;14;20
96;25.09.2011;2011;09;16;Sunnuntai;67;40;107;22;9;31
96;25.09.2011;2011;09;17;Sunnuntai;60;41;101;10;15;25
96;25.09.2011;2011;09;18;Sunnuntai;51;44;95;16;13;29
96;25.09.2011;2011;09;19;Sunnuntai;28;49;77;5;12;17
96;25.09.2011;2011;09;20;Sunnuntai;31;24;55;11;10;21
96;25.09.2011;2011;09;21;Sunnuntai;19;27;46;5;4;9
96;25.09.2011;2011;09;22;Sunnuntai;8;10;18;4;3;7
96;25.09.2011;2011;09;23;Sunnuntai;7;4;11;1;1;2
96;26.09.2011;2011;09;00;Maanantai;0;0;0;1;0;1
96;26.09.2011;2011;09;01;Maanantai;2;0;2;0;0;0
96;26.09.2011;2011;09;02;Maanantai;0;0;0;0;0;0
96;26.09.2011;2011;09;03;Maanantai;1;0;1;0;0;0
96;26.09.2011;2011;09;04;Maanantai;3;4;7;0;0;0
96;26.09.2011;2011;09;05;Maanantai;2;8;10;0;1;1
96;26.09.2011;2011;09;06;Maanantai;46;38;84;8;0;8
96;26.09.2011;2011;09;07;Maanantai;116;122;238;17;13;30
96;26.09.2011;2011;09;08;Maanantai;141;186;327;10;11;21
96;26.09.2011;2011;09;09;Maanantai;72;99;171;3;9;12
96;26.09.2011;2011;09;10;Maanantai;55;72;127;8;5;13
96;26.09.2011;2011;09;11;Maanantai;72;92;164;9;11;20
96;26.09.2011;2011;09;12;Maanantai;96;78;174;5;4;9
96;26.09.2011;2011;09;13;Maanantai;97;96;193;5;5;10
96;26.09.2011;2011;09;14;Maanantai;89;144;233;4;14;18
96;26.09.2011;2011;09;15;Maanantai;142;221;363;15;23;38
96;26.09.2011;2011;09;16;Maanantai;141;186;327;10;21;31
96;26.09.2011;2011;09;17;Maanantai;112;131;243;14;22;36
96;26.09.2011;2011;09;18;Maanantai;89;89;178;19;13;32
96;26.09.2011;2011;09;19;Maanantai;93;54;147;13;20;33
96;26.09.2011;2011;09;20;Maanantai;71;31;102;24;21;45
96;26.09.2011;2011;09;21;Maanantai;32;30;62;7;10;17
96;26.09.2011;2011;09;22;Maanantai;12;9;21;1;1;2
96;26.09.2011;2011;09;23;Maanantai;6;1;7;1;1;2
96;27.09.2011;2011;09;00;Tiistai;4;0;4;1;0;1
96;27.09.2011;2011;09;01;Tiistai;0;0;0;0;0;0
96;27.09.2011;2011;09;02;Tiistai;0;0;0;0;0;0
96;27.09.2011;2011;09;03;Tiistai;2;0;2;0;0;0
96;27.09.2011;2011;09;04;Tiistai;2;3;5;1;0;1
96;27.09.2011;2011;09;05;Tiistai;5;5;10;1;0;1
96;27.09.2011;2011;09;06;Tiistai;42;34;76;6;5;11
96;27.09.2011;2011;09;07;Tiistai;88;84;172;19;6;25
96;27.09.2011;2011;09;08;Tiistai;105;96;201;12;4;16
96;27.09.2011;2011;09;09;Tiistai;62;75;137;9;6;15
96;27.09.2011;2011;09;10;Tiistai;48;31;79;1;7;8
96;27.09.2011;2011;09;11;Tiistai;44;49;93;6;3;9
96;27.09.2011;2011;09;12;Tiistai;32;55;87;6;7;13
96;27.09.2011;2011;09;13;Tiistai;25;51;76;4;5;9
96;27.09.2011;2011;09;14;Tiistai;40;92;132;1;4;5
96;27.09.2011;2011;09;15;Tiistai;63;163;226;4;17;21
96;27.09.2011;2011;09;16;Tiistai;61;113;174;7;18;25
96;27.09.2011;2011;09;17;Tiistai;56;38;94;4;8;12
96;27.09.2011;2011;09;18;Tiistai;48;33;81;8;9;17
96;27.09.2011;2011;09;19;Tiistai;21;28;49;7;3;10
96;27.09.2011;2011;09;20;Tiistai;32;13;45;4;6;10
96;27.09.2011;2011;09;21;Tiistai;23;10;33;2;1;3
96;27.09.2011;2011;09;22;Tiistai;3;2;5;1;1;2
96;27.09.2011;2011;09;23;Tiistai;7;0;7;1;1;2
96;28.09.2011;2011;09;00;Keskiviikko;0;1;1;0;0;0
96;28.09.2011;2011;09;01;Keskiviikko;1;0;1;0;0;0
96;28.09.2011;2011;09;02;Keskiviikko;0;2;2;0;0;0
96;28.09.2011;2011;09;03;Keskiviikko;1;0;1;0;0;0
96;28.09.2011;2011;09;04;Keskiviikko;2;2;4;0;0;0
96;28.09.2011;2011;09;05;Keskiviikko;3;7;10;1;0;1
96;28.09.2011;2011;09;06;Keskiviikko;41;34;75;4;1;5
96;28.09.2011;2011;09;07;Keskiviikko;98;137;235;16;13;29
96;28.09.2011;2011;09;08;Keskiviikko;163;169;332;16;6;22
96;28.09.2011;2011;09;09;Keskiviikko;61;101;162;7;8;15
96;28.09.2011;2011;09;10;Keskiviikko;65;74;139;5;11;16
96;28.09.2011;2011;09;11;Keskiviikko;64;83;147;4;8;12
96;28.09.2011;2011;09;12;Keskiviikko;96;94;190;19;12;31
96;28.09.2011;2011;09;13;Keskiviikko;81;94;175;10;13;23
96;28.09.2011;2011;09;14;Keskiviikko;120;119;239;6;10;16
96;28.09.2011;2011;09;15;Keskiviikko;103;229;332;12;20;32
96;28.09.2011;2011;09;16;Keskiviikko;102;172;274;4;26;30
96;28.09.2011;2011;09;17;Keskiviikko;66;80;146;9;5;14
96;28.09.2011;2011;09;18;Keskiviikko;77;63;140;9;10;19
96;28.09.2011;2011;09;19;Keskiviikko;60;43;103;11;10;21
96;28.09.2011;2011;09;20;Keskiviikko;77;36;113;16;12;28
96;28.09.2011;2011;09;21;Keskiviikko;49;41;90;12;14;26
96;28.09.2011;2011;09;22;Keskiviikko;6;13;19;1;3;4
96;28.09.2011;2011;09;23;Keskiviikko;7;9;16;0;0;0
96;29.09.2011;2011;09;00;Torstai;3;1;4;0;0;0
96;29.09.2011;2011;09;01;Torstai;5;0;5;1;0;1
96;29.09.2011;2011;09;02;Torstai;6;0;6;1;0;1
96;29.09.2011;2011;09;03;Torstai;2;1;3;0;0;0
96;29.09.2011;2011;09;04;Torstai;3;3;6;0;0;0
96;29.09.2011;2011;09;05;Torstai;4;6;10;1;0;1
96;29.09.2011;2011;09;06;Torstai;41;33;74;3;1;4
96;29.09.2011;2011;09;07;Torstai;110;129;239;20;4;24
96;29.09.2011;2011;09;08;Torstai;150;178;328;14;10;24
96;29.09.2011;2011;09;09;Torstai;69;87;156;8;4;12
96;29.09.2011;2011;09;10;Torstai;57;63;120;7;6;13
96;29.09.2011;2011;09;11;Torstai;57;57;114;3;5;8
96;29.09.2011;2011;09;12;Torstai;65;95;160;7;7;14
96;29.09.2011;2011;09;13;Torstai;62;73;135;9;3;12
96;29.09.2011;2011;09;14;Torstai;78;134;212;8;2;10
96;29.09.2011;2011;09;15;Torstai;96;221;317;9;20;29
96;29.09.2011;2011;09;16;Torstai;130;153;283;5;19;24
96;29.09.2011;2011;09;17;Torstai;93;90;183;17;7;24
96;29.09.2011;2011;09;18;Torstai;68;80;148;9;13;22
96;29.09.2011;2011;09;19;Torstai;52;32;84;10;12;22
96;29.09.2011;2011;09;20;Torstai;60;22;82;4;12;16
96;29.09.2011;2011;09;21;Torstai;39;28;67;2;5;7
96;29.09.2011;2011;09;22;Torstai;5;6;11;1;1;2
96;29.09.2011;2011;09;23;Torstai;3;0;3;0;0;0
96;30.09.2011;2011;09;00;Perjantai;3;2;5;0;0;0
96;30.09.2011;2011;09;01;Perjantai;0;1;1;1;0;1
96;30.09.2011;2011;09;02;Perjantai;5;1;6;0;0;0
96;30.09.2011;2011;09;03;Perjantai;2;2;4;0;1;1
96;30.09.2011;2011;09;04;Perjantai;1;2;3;2;0;2
96;30.09.2011;2011;09;05;Perjantai;3;9;12;1;0;1
96;30.09.2011;2011;09;06;Perjantai;38;21;59;11;0;11
96;30.09.2011;2011;09;07;Perjantai;126;116;242;21;5;26
96;30.09.2011;2011;09;08;Perjantai;156;149;305;7;3;10
96;30.09.2011;2011;09;09;Perjantai;73;96;169;3;5;8
96;30.09.2011;2011;09;10;Perjantai;52;67;119;6;4;10
96;30.09.2011;2011;09;11;Perjantai;45;109;154;5;10;15
96;30.09.2011;2011;09;12;Perjantai;77;103;180;6;13;19
96;30.09.2011;2011;09;13;Perjantai;88;132;220;7;10;17
96;30.09.2011;2011;09;14;Perjantai;116;134;250;7;19;26
96;30.09.2011;2011;09;15;Perjantai;101;163;264;8;25;33
96;30.09.2011;2011;09;16;Perjantai;96;118;214;12;22;34
96;30.09.2011;2011;09;17;Perjantai;71;79;150;6;8;14
96;30.09.2011;2011;09;18;Perjantai;60;79;139;7;15;22
96;30.09.2011;2011;09;19;Perjantai;39;38;77;7;7;14
96;30.09.2011;2011;09;20;Perjantai;37;24;61;6;7;13
96;30.09.2011;2011;09;21;Perjantai;74;22;96;12;6;18
96;30.09.2011;2011;09;22;Perjantai;9;24;33;1;2;3
96;30.09.2011;2011;09;23;Perjantai;12;17;29;1;0;1
96;01.10.2011;2011;10;00;Lauantai;17;6;23;2;2;4
96;01.10.2011;2011;10;01;Lauantai;13;4;17;2;0;2
96;01.10.2011;2011;10;02;Lauantai;18;4;22;3;2;5
96;01.10.2011;2011;10;03;Lauantai;7;3;10;1;0;1
96;01.10.2011;2011;10;04;Lauantai;12;4;16;2;1;3
96;01.10.2011;2011;10;05;Lauantai;2;3;5;0;0;0
96;01.10.2011;2011;10;06;Lauantai;13;6;19;4;0;4
96;01.10.2011;2011;10;07;Lauantai;8;19;27;0;2;2
96;01.10.2011;2011;10;08;Lauantai;13;22;35;0;3;3
96;01.10.2011;2011;10;09;Lauantai;15;44;59;4;5;9
96;01.10.2011;2011;10;10;Lauantai;26;50;76;6;10;16
96;01.10.2011;2011;10;11;Lauantai;37;61;98;8;13;21
96;01.10.2011;2011;10;12;Lauantai;58;59;117;11;8;19
96;01.10.2011;2011;10;13;Lauantai;55;66;121;16;9;25
96;01.10.2011;2011;10;14;Lauantai;72;62;134;5;11;16
96;01.10.2011;2011;10;15;Lauantai;71;64;135;15;10;25
96;01.10.2011;2011;10;16;Lauantai;50;51;101;8;26;34
96;01.10.2011;2011;10;17;Lauantai;75;41;116;45;14;59
96;01.10.2011;2011;10;18;Lauantai;56;32;88;13;8;21
96;01.10.2011;2011;10;19;Lauantai;47;31;78;12;5;17
96;01.10.2011;2011;10;20;Lauantai;18;23;41;13;11;24
96;01.10.2011;2011;10;21;Lauantai;14;29;43;6;21;27
96;01.10.2011;2011;10;22;Lauantai;8;42;50;3;23;26
96;01.10.2011;2011;10;23;Lauantai;3;11;14;0;4;4
96;02.10.2011;2011;10;00;Sunnuntai;17;12;29;5;0;5
96;02.10.2011;2011;10;01;Sunnuntai;6;11;17;3;0;3
96;02.10.2011;2011;10;02;Sunnuntai;17;2;19;0;3;3
96;02.10.2011;2011;10;03;Sunnuntai;13;0;13;2;0;2
96;02.10.2011;2011;10;04;Sunnuntai;5;1;6;1;0;1
96;02.10.2011;2011;10;05;Sunnuntai;3;2;5;0;0;0
96;02.10.2011;2011;10;06;Sunnuntai;8;12;20;1;1;2
96;02.10.2011;2011;10;07;Sunnuntai;9;7;16;0;2;2
96;02.10.2011;2011;10;08;Sunnuntai;5;12;17;6;2;8
96;02.10.2011;2011;10;09;Sunnuntai;15;18;33;7;9;16
96;02.10.2011;2011;10;10;Sunnuntai;12;26;38;6;7;13
96;02.10.2011;2011;10;11;Sunnuntai;25;29;54;8;4;12
96;02.10.2011;2011;10;12;Sunnuntai;41;29;70;11;13;24
96;02.10.2011;2011;10;13;Sunnuntai;48;49;97;9;5;14
96;02.10.2011;2011;10;14;Sunnuntai;39;41;80;6;8;14
96;02.10.2011;2011;10;15;Sunnuntai;35;38;73;7;6;13
96;02.10.2011;2011;10;16;Sunnuntai;29;36;65;9;18;27
96;02.10.2011;2011;10;17;Sunnuntai;35;23;58;14;10;24
96;02.10.2011;2011;10;18;Sunnuntai;24;15;39;6;7;13
96;02.10.2011;2011;10;19;Sunnuntai;15;29;44;7;18;25
96;02.10.2011;2011;10;20;Sunnuntai;27;15;42;7;4;11
96;02.10.2011;2011;10;21;Sunnuntai;14;42;56;4;13;17
96;02.10.2011;2011;10;22;Sunnuntai;5;8;13;0;1;1
96;02.10.2011;2011;10;23;Sunnuntai;8;2;10;0;1;1
96;03.10.2011;2011;10;00;Maanantai;4;1;5;4;0;4
96;03.10.2011;2011;10;01;Maanantai;2;2;4;1;0;1
96;03.10.2011;2011;10;02;Maanantai;1;0;1;0;0;0
96;03.10.2011;2011;10;03;Maanantai;1;0;1;0;0;0
96;03.10.2011;2011;10;04;Maanantai;3;0;3;0;0;0
96;03.10.2011;2011;10;05;Maanantai;1;8;9;0;0;0
96;03.10.2011;2011;10;06;Maanantai;34;39;73;5;1;6
96;03.10.2011;2011;10;07;Maanantai;118;145;263;22;6;28
96;03.10.2011;2011;10;08;Maanantai;126;148;274;14;6;20
96;03.10.2011;2011;10;09;Maanantai;72;112;184;13;6;19
96;03.10.2011;2011;10;10;Maanantai;50;73;123;10;10;20
96;03.10.2011;2011;10;11;Maanantai;80;75;155;5;10;15
96;03.10.2011;2011;10;12;Maanantai;73;85;158;3;2;5
96;03.10.2011;2011;10;13;Maanantai;73;91;164;5;11;16
96;03.10.2011;2011;10;14;Maanantai;83;163;246;3;28;31
96;03.10.2011;2011;10;15;Maanantai;93;264;357;9;22;31
96;03.10.2011;2011;10;16;Maanantai;149;182;331;13;23;36
96;03.10.2011;2011;10;17;Maanantai;104;111;215;18;12;30
96;03.10.2011;2011;10;18;Maanantai;86;69;155;17;18;35
96;03.10.2011;2011;10;19;Maanantai;64;53;117;18;16;34
96;03.10.2011;2011;10;20;Maanantai;67;28;95;8;18;26
96;03.10.2011;2011;10;21;Maanantai;43;19;62;8;7;15
96;03.10.2011;2011;10;22;Maanantai;5;14;19;2;2;4
96;03.10.2011;2011;10;23;Maanantai;4;6;10;0;1;1
96;04.10.2011;2011;10;00;Tiistai;4;3;7;1;0;1
96;04.10.2011;2011;10;01;Tiistai;1;2;3;0;0;0
96;04.10.2011;2011;10;02;Tiistai;2;0;2;0;0;0
96;04.10.2011;2011;10;03;Tiistai;2;0;2;1;0;1
96;04.10.2011;2011;10;04;Tiistai;1;1;2;0;0;0
96;04.10.2011;2011;10;05;Tiistai;4;11;15;1;0;1
96;04.10.2011;2011;10;06;Tiistai;51;34;85;6;2;8
96;04.10.2011;2011;10;07;Tiistai;107;131;238;20;11;31
96;04.10.2011;2011;10;08;Tiistai;142;137;279;7;10;17
96;04.10.2011;2011;10;09;Tiistai;54;105;159;8;10;18
96;04.10.2011;2011;10;10;Tiistai;55;62;117;11;5;16
96;04.10.2011;2011;10;11;Tiistai;61;65;126;6;7;13
96;04.10.2011;2011;10;12;Tiistai;59;65;124;11;18;29
96;04.10.2011;2011;10;13;Tiistai;55;57;112;15;6;21
96;04.10.2011;2011;10;14;Tiistai;71;104;175;1;5;6
96;04.10.2011;2011;10;15;Tiistai;102;237;339;5;17;22
96;04.10.2011;2011;10;16;Tiistai;111;153;264;13;23;36
96;04.10.2011;2011;10;17;Tiistai;68;63;131;5;4;9
96;04.10.2011;2011;10;18;Tiistai;61;61;122;11;10;21
96;04.10.2011;2011;10;19;Tiistai;49;44;93;14;12;26
96;04.10.2011;2011;10;20;Tiistai;49;30;79;12;9;21
96;04.10.2011;2011;10;21;Tiistai;23;26;49;4;6;10
96;04.10.2011;2011;10;22;Tiistai;10;12;22;0;1;1
96;04.10.2011;2011;10;23;Tiistai;7;2;9;0;0;0
96;05.10.2011;2011;10;00;Keskiviikko;1;1;2;0;1;1
96;05.10.2011;2011;10;01;Keskiviikko;3;0;3;0;0;0
96;05.10.2011;2011;10;02;Keskiviikko;0;0;0;0;0;0
96;05.10.2011;2011;10;03;Keskiviikko;0;0;0;0;0;0
96;05.10.2011;2011;10;04;Keskiviikko;2;3;5;0;0;0
96;05.10.2011;2011;10;05;Keskiviikko;5;4;9;0;0;0
96;05.10.2011;2011;10;06;Keskiviikko;45;33;78;3;2;5
96;05.10.2011;2011;10;07;Keskiviikko;106;155;261;21;7;28
96;05.10.2011;2011;10;08;Keskiviikko;145;184;329;6;6;12
96;05.10.2011;2011;10;09;Keskiviikko;68;180;248;7;22;29
96;05.10.2011;2011;10;10;Keskiviikko;60;85;145;9;3;12
96;05.10.2011;2011;10;11;Keskiviikko;82;81;163;4;6;10
96;05.10.2011;2011;10;12;Keskiviikko;136;102;238;7;9;16
96;05.10.2011;2011;10;13;Keskiviikko;105;94;199;13;8;21
96;05.10.2011;2011;10;14;Keskiviikko;89;121;210;10;19;29
96;05.10.2011;2011;10;15;Keskiviikko;131;266;397;12;23;35
96;05.10.2011;2011;10;16;Keskiviikko;137;214;351;3;24;27
96;05.10.2011;2011;10;17;Keskiviikko;125;104;229;14;12;26
96;05.10.2011;2011;10;18;Keskiviikko;85;70;155;19;8;27
96;05.10.2011;2011;10;19;Keskiviikko;87;62;149;13;14;27
96;05.10.2011;2011;10;20;Keskiviikko;79;33;112;21;10;31
96;05.10.2011;2011;10;21;Keskiviikko;44;23;67;9;5;14
96;05.10.2011;2011;10;22;Keskiviikko;14;6;20;3;2;5
96;05.10.2011;2011;10;23;Keskiviikko;15;5;20;1;1;2
96;06.10.2011;2011;10;00;Torstai;4;4;8;1;1;2
96;06.10.2011;2011;10;01;Torstai;3;1;4;0;0;0
96;06.10.2011;2011;10;02;Torstai;4;0;4;1;0;1
96;06.10.2011;2011;10;03;Torstai;2;0;2;1;0;1
96;06.10.2011;2011;10;04;Torstai;5;3;8;0;0;0
96;06.10.2011;2011;10;05;Torstai;5;4;9;1;0;1
96;06.10.2011;2011;10;06;Torstai;38;31;69;7;0;7
96;06.10.2011;2011;10;07;Torstai;99;122;221;17;7;24
96;06.10.2011;2011;10;08;Torstai;157;161;318;11;6;17
96;06.10.2011;2011;10;09;Torstai;60;96;156;7;8;15
96;06.10.2011;2011;10;10;Torstai;53;77;130;3;3;6
96;06.10.2011;2011;10;11;Torstai;67;66;133;9;10;19
96;06.10.2011;2011;10;12;Torstai;77;75;152;4;8;12
96;06.10.2011;2011;10;13;Torstai;65;87;152;8;9;17
96;06.10.2011;2011;10;14;Torstai;76;149;225;0;16;16
96;06.10.2011;2011;10;15;Torstai;75;178;253;4;20;24
96;06.10.2011;2011;10;16;Torstai;107;115;222;5;20;25
96;06.10.2011;2011;10;17;Torstai;67;65;132;3;7;10
96;06.10.2011;2011;10;18;Torstai;41;44;85;2;15;17
96;06.10.2011;2011;10;19;Torstai;30;24;54;4;13;17
96;06.10.2011;2011;10;20;Torstai;45;28;73;12;6;18
96;06.10.2011;2011;10;21;Torstai;23;22;45;6;8;14
96;06.10.2011;2011;10;22;Torstai;10;10;20;1;1;2
96;06.10.2011;2011;10;23;Torstai;5;4;9;1;0;1
96;07.10.2011;2011;10;00;Perjantai;2;0;2;0;0;0
96;07.10.2011;2011;10;01;Perjantai;8;2;10;0;0;0
96;07.10.2011;2011;10;02;Perjantai;3;2;5;0;0;0
96;07.10.2011;2011;10;03;Perjantai;7;1;8;1;0;1
96;07.10.2011;2011;10;04;Perjantai;6;3;9;0;1;1
96;07.10.2011;2011;10;05;Perjantai;4;5;9;1;0;1
96;07.10.2011;2011;10;06;Perjantai;30;26;56;5;2;7
96;07.10.2011;2011;10;07;Perjantai;77;76;153;18;5;23
96;07.10.2011;2011;10;08;Perjantai;115;101;216;8;8;16
96;07.10.2011;2011;10;09;Perjantai;39;59;98;3;6;9
96;07.10.2011;2011;10;10;Perjantai;36;44;80;2;2;4
96;07.10.2011;2011;10;11;Perjantai;42;61;103;5;2;7
96;07.10.2011;2011;10;12;Perjantai;53;58;111;3;4;7
96;07.10.2011;2011;10;13;Perjantai;48;64;112;4;3;7
96;07.10.2011;2011;10;14;Perjantai;49;73;122;2;2;4
96;07.10.2011;2011;10;15;Perjantai;50;86;136;6;10;16
96;07.10.2011;2011;10;16;Perjantai;50;59;109;3;13;16
96;07.10.2011;2011;10;17;Perjantai;33;22;55;5;2;7
96;07.10.2011;2011;10;18;Perjantai;27;12;39;1;3;4
96;07.10.2011;2011;10;19;Perjantai;15;10;25;7;5;12
96;07.10.2011;2011;10;20;Perjantai;15;7;22;2;3;5
96;07.10.2011;2011;10;21;Perjantai;16;15;31;5;5;10
96;07.10.2011;2011;10;22;Perjantai;3;2;5;2;3;5
96;07.10.2011;2011;10;23;Perjantai;5;5;10;0;1;1
96;08.10.2011;2011;10;00;Lauantai;2;1;3;0;0;0
96;08.10.2011;2011;10;01;Lauantai;5;0;5;3;1;4
96;08.10.2011;2011;10;02;Lauantai;6;2;8;3;1;4
96;08.10.2011;2011;10;03;Lauantai;4;0;4;2;0;2
96;08.10.2011;2011;10;04;Lauantai;4;3;7;2;0;2
96;08.10.2011;2011;10;05;Lauantai;2;1;3;0;0;0
96;08.10.2011;2011;10;06;Lauantai;13;6;19;0;1;1
96;08.10.2011;2011;10;07;Lauantai;7;20;27;2;5;7
96;08.10.2011;2011;10;08;Lauantai;16;29;45;0;2;2
96;08.10.2011;2011;10;09;Lauantai;15;51;66;3;5;8
96;08.10.2011;2011;10;10;Lauantai;25;60;85;5;30;35
96;08.10.2011;2011;10;11;Lauantai;49;96;145;13;34;47
96;08.10.2011;2011;10;12;Lauantai;60;73;133;21;27;48
96;08.10.2011;2011;10;13;Lauantai;87;57;144;32;13;45
96;08.10.2011;2011;10;14;Lauantai;84;70;154;28;13;41
96;08.10.2011;2011;10;15;Lauantai;72;49;121;28;13;41
96;08.10.2011;2011;10;16;Lauantai;64;49;113;15;11;26
96;08.10.2011;2011;10;17;Lauantai;47;37;84;4;6;10
96;08.10.2011;2011;10;18;Lauantai;48;31;79;17;9;26
96;08.10.2011;2011;10;19;Lauantai;40;23;63;7;7;14
96;08.10.2011;2011;10;20;Lauantai;21;20;41;5;11;16
96;08.10.2011;2011;10;21;Lauantai;18;43;61;5;6;11
96;08.10.2011;2011;10;22;Lauantai;15;26;41;1;2;3
96;08.10.2011;2011;10;23;Lauantai;14;5;19;6;3;9
96;09.10.2011;2011;10;00;Sunnuntai;2;4;6;0;0;0
96;09.10.2011;2011;10;01;Sunnuntai;9;5;14;1;0;1
96;09.10.2011;2011;10;02;Sunnuntai;8;1;9;0;0;0
96;09.10.2011;2011;10;03;Sunnuntai;18;1;19;0;0;0
96;09.10.2011;2011;10;04;Sunnuntai;13;2;15;1;0;1
96;09.10.2011;2011;10;05;Sunnuntai;4;1;5;0;1;1
96;09.10.2011;2011;10;06;Sunnuntai;8;5;13;5;1;6
96;09.10.2011;2011;10;07;Sunnuntai;2;11;13;0;3;3
96;09.10.2011;2011;10;08;Sunnuntai;3;9;12;2;1;3
96;09.10.2011;2011;10;09;Sunnuntai;10;19;29;1;1;2
96;09.10.2011;2011;10;10;Sunnuntai;18;23;41;10;7;17
96;09.10.2011;2011;10;11;Sunnuntai;23;49;72;6;17;23
96;09.10.2011;2011;10;12;Sunnuntai;49;67;116;11;16;27
96;09.10.2011;2011;10;13;Sunnuntai;59;64;123;17;19;36
96;09.10.2011;2011;10;14;Sunnuntai;56;59;115;12;16;28
96;09.10.2011;2011;10;15;Sunnuntai;56;38;94;19;9;28
96;09.10.2011;2011;10;16;Sunnuntai;73;35;108;28;8;36
96;09.10.2011;2011;10;17;Sunnuntai;58;37;95;8;12;20
96;09.10.2011;2011;10;18;Sunnuntai;50;33;83;9;12;21
96;09.10.2011;2011;10;19;Sunnuntai;26;28;54;10;11;21
96;09.10.2011;2011;10;20;Sunnuntai;22;44;66;6;10;16
96;09.10.2011;2011;10;21;Sunnuntai;21;22;43;3;5;8
96;09.10.2011;2011;10;22;Sunnuntai;5;9;14;0;0;0
96;09.10.2011;2011;10;23;Sunnuntai;3;1;4;0;1;1
96;10.10.2011;2011;10;00;Maanantai;3;4;7;0;0;0
96;10.10.2011;2011;10;01;Maanantai;6;1;7;0;0;0
96;10.10.2011;2011;10;02;Maanantai;3;1;4;0;0;0
96;10.10.2011;2011;10;03;Maanantai;0;0;0;0;0;0
96;10.10.2011;2011;10;04;Maanantai;2;3;5;0;0;0
96;10.10.2011;2011;10;05;Maanantai;2;8;10;0;1;1
96;10.10.2011;2011;10;06;Maanantai;37;31;68;5;2;7
96;10.10.2011;2011;10;07;Maanantai;98;103;201;16;8;24
96;10.10.2011;2011;10;08;Maanantai;107;112;219;5;9;14
96;10.10.2011;2011;10;09;Maanantai;64;64;128;6;3;9
96;10.10.2011;2011;10;10;Maanantai;37;34;71;8;11;19
96;10.10.2011;2011;10;11;Maanantai;46;64;110;7;8;15
96;10.10.2011;2011;10;12;Maanantai;55;40;95;5;5;10
96;10.10.2011;2011;10;13;Maanantai;47;62;109;7;7;14
96;10.10.2011;2011;10;14;Maanantai;61;116;177;11;10;21
96;10.10.2011;2011;10;15;Maanantai;70;189;259;6;28;34
96;10.10.2011;2011;10;16;Maanantai;99;164;263;8;23;31
96;10.10.2011;2011;10;17;Maanantai;75;72;147;6;15;21
96;10.10.2011;2011;10;18;Maanantai;56;59;115;18;9;27
96;10.10.2011;2011;10;19;Maanantai;67;38;105;12;16;28
96;10.10.2011;2011;10;20;Maanantai;52;32;84;7;12;19
96;10.10.2011;2011;10;21;Maanantai;29;30;59;5;5;10
96;10.10.2011;2011;10;22;Maanantai;8;6;14;1;9;10
96;10.10.2011;2011;10;23;Maanantai;6;0;6;1;0;1
96;11.10.2011;2011;10;00;Tiistai;4;0;4;0;0;0
96;11.10.2011;2011;10;01;Tiistai;0;0;0;0;0;0
96;11.10.2011;2011;10;02;Tiistai;0;0;0;1;0;1
96;11.10.2011;2011;10;03;Tiistai;1;0;1;0;1;1
96;11.10.2011;2011;10;04;Tiistai;1;2;3;0;0;0
96;11.10.2011;2011;10;05;Tiistai;0;6;6;1;0;1
96;11.10.2011;2011;10;06;Tiistai;35;30;65;3;3;6
96;11.10.2011;2011;10;07;Tiistai;102;116;218;21;4;25
96;11.10.2011;2011;10;08;Tiistai;130;113;243;9;5;14
96;11.10.2011;2011;10;09;Tiistai;63;88;151;15;7;22
96;11.10.2011;2011;10;10;Tiistai;45;61;106;6;9;15
96;11.10.2011;2011;10;11;Tiistai;68;77;145;7;10;17
96;11.10.2011;2011;10;12;Tiistai;70;71;141;8;17;25
96;11.10.2011;2011;10;13;Tiistai;62;73;135;10;11;21
96;11.10.2011;2011;10;14;Tiistai;52;119;171;10;11;21
96;11.10.2011;2011;10;15;Tiistai;111;221;332;5;28;33
96;11.10.2011;2011;10;16;Tiistai;134;157;291;13;21;34
96;11.10.2011;2011;10;17;Tiistai;86;69;155;23;24;47
96;11.10.2011;2011;10;18;Tiistai;78;77;155;19;22;41
96;11.10.2011;2011;10;19;Tiistai;46;33;79;16;19;35
96;11.10.2011;2011;10;20;Tiistai;70;36;106;18;14;32
96;11.10.2011;2011;10;21;Tiistai;36;27;63;12;15;27
96;11.10.2011;2011;10;22;Tiistai;16;9;25;1;4;5
96;11.10.2011;2011;10;23;Tiistai;15;3;18;0;0;0
96;12.10.2011;2011;10;00;Keskiviikko;3;0;3;0;0;0
96;12.10.2011;2011;10;01;Keskiviikko;4;0;4;0;0;0
96;12.10.2011;2011;10;02;Keskiviikko;0;0;0;0;0;0
96;12.10.2011;2011;10;03;Keskiviikko;0;0;0;0;0;0
96;12.10.2011;2011;10;04;Keskiviikko;1;3;4;0;0;0
96;12.10.2011;2011;10;05;Keskiviikko;3;7;10;1;0;1
96;12.10.2011;2011;10;06;Keskiviikko;50;35;85;4;1;5
96;12.10.2011;2011;10;07;Keskiviikko;118;110;228;24;4;28
96;12.10.2011;2011;10;08;Keskiviikko;166;117;283;14;9;23
96;12.10.2011;2011;10;09;Keskiviikko;55;78;133;9;3;12
96;12.10.2011;2011;10;10;Keskiviikko;41;52;93;4;9;13
96;12.10.2011;2011;10;11;Keskiviikko;47;64;111;6;15;21
96;12.10.2011;2011;10;12;Keskiviikko;74;81;155;9;6;15
96;12.10.2011;2011;10;13;Keskiviikko;81;64;145;16;6;22
96;12.10.2011;2011;10;14;Keskiviikko;86;108;194;9;17;26
96;12.10.2011;2011;10;15;Keskiviikko;76;179;255;11;30;41
96;12.10.2011;2011;10;16;Keskiviikko;117;176;293;8;35;43
96;12.10.2011;2011;10;17;Keskiviikko;85;73;158;5;15;20
96;12.10.2011;2011;10;18;Keskiviikko;96;53;149;21;10;31
96;12.10.2011;2011;10;19;Keskiviikko;65;37;102;11;20;31
96;12.10.2011;2011;10;20;Keskiviikko;49;31;80;12;13;25
96;12.10.2011;2011;10;21;Keskiviikko;28;39;67;6;5;11
96;12.10.2011;2011;10;22;Keskiviikko;15;12;27;4;4;8
96;12.10.2011;2011;10;23;Keskiviikko;6;5;11;1;0;1
96;13.10.2011;2011;10;00;Torstai;1;1;2;0;0;0
96;13.10.2011;2011;10;01;Torstai;3;2;5;0;0;0
96;13.10.2011;2011;10;02;Torstai;3;0;3;0;0;0
96;13.10.2011;2011;10;03;Torstai;2;1;3;0;0;0
96;13.10.2011;2011;10;04;Torstai;1;2;3;1;0;1
96;13.10.2011;2011;10;05;Torstai;1;5;6;1;0;1
96;13.10.2011;2011;10;06;Torstai;42;27;69;2;2;4
96;13.10.2011;2011;10;07;Torstai;115;94;209;26;12;38
96;13.10.2011;2011;10;08;Torstai;156;148;304;14;4;18
96;13.10.2011;2011;10;09;Torstai;54;98;152;6;8;14
96;13.10.2011;2011;10;10;Torstai;37;53;90;8;20;28
96;13.10.2011;2011;10;11;Torstai;66;91;157;13;14;27
96;13.10.2011;2011;10;12;Torstai;69;99;168;13;18;31
96;13.10.2011;2011;10;13;Torstai;84;100;184;8;16;24
96;13.10.2011;2011;10;14;Torstai;108;130;238;14;6;20
96;13.10.2011;2011;10;15;Torstai;101;164;265;9;19;28
96;13.10.2011;2011;10;16;Torstai;111;150;261;10;25;35
96;13.10.2011;2011;10;17;Torstai;80;84;164;10;13;23
96;13.10.2011;2011;10;18;Torstai;68;56;124;10;19;29
96;13.10.2011;2011;10;19;Torstai;62;34;96;11;8;19
96;13.10.2011;2011;10;20;Torstai;69;30;99;15;9;24
96;13.10.2011;2011;10;21;Torstai;25;28;53;2;9;11
96;13.10.2011;2011;10;22;Torstai;13;6;19;0;0;0
96;13.10.2011;2011;10;23;Torstai;10;1;11;0;1;1
96;14.10.2011;2011;10;00;Perjantai;6;1;7;1;1;2
96;14.10.2011;2011;10;01;Perjantai;2;1;3;0;0;0
96;14.10.2011;2011;10;02;Perjantai;2;1;3;0;0;0
96;14.10.2011;2011;10;03;Perjantai;1;1;2;0;0;0
96;14.10.2011;2011;10;04;Perjantai;5;3;8;1;0;1
96;14.10.2011;2011;10;05;Perjantai;1;7;8;1;0;1
96;14.10.2011;2011;10;06;Perjantai;43;24;67;4;1;5
96;14.10.2011;2011;10;07;Perjantai;104;105;209;29;9;38
96;14.10.2011;2011;10;08;Perjantai;137;123;260;13;11;24
96;14.10.2011;2011;10;09;Perjantai;53;102;155;8;14;22
96;14.10.2011;2011;10;10;Perjantai;48;70;118;10;10;20
96;14.10.2011;2011;10;11;Perjantai;49;111;160;5;7;12
96;14.10.2011;2011;10;12;Perjantai;85;89;174;7;11;18
96;14.10.2011;2011;10;13;Perjantai;89;83;172;11;6;17
96;14.10.2011;2011;10;14;Perjantai;101;143;244;6;16;22
96;14.10.2011;2011;10;15;Perjantai;108;176;284;5;24;29
96;14.10.2011;2011;10;16;Perjantai;103;90;193;6;13;19
96;14.10.2011;2011;10;17;Perjantai;71;66;137;12;18;30
96;14.10.2011;2011;10;18;Perjantai;56;36;92;7;13;20
96;14.10.2011;2011;10;19;Perjantai;29;30;59;5;9;14
96;14.10.2011;2011;10;20;Perjantai;47;32;79;4;9;13
96;14.10.2011;2011;10;21;Perjantai;23;13;36;3;5;8
96;14.10.2011;2011;10;22;Perjantai;8;20;28;3;2;5
96;14.10.2011;2011;10;23;Perjantai;11;14;25;0;0;0
96;15.10.2011;2011;10;00;Lauantai;7;8;15;0;0;0
96;15.10.2011;2011;10;01;Lauantai;8;5;13;2;1;3
96;15.10.2011;2011;10;02;Lauantai;11;4;15;0;0;0
96;15.10.2011;2011;10;03;Lauantai;6;0;6;1;0;1
96;15.10.2011;2011;10;04;Lauantai;5;3;8;2;1;3
96;15.10.2011;2011;10;05;Lauantai;2;0;2;0;0;0
96;15.10.2011;2011;10;06;Lauantai;7;7;14;3;0;3
96;15.10.2011;2011;10;07;Lauantai;2;18;20;1;1;2
96;15.10.2011;2011;10;08;Lauantai;11;15;26;4;3;7
96;15.10.2011;2011;10;09;Lauantai;10;36;46;8;6;14
96;15.10.2011;2011;10;10;Lauantai;27;38;65;7;6;13
96;15.10.2011;2011;10;11;Lauantai;36;50;86;6;8;14
96;15.10.2011;2011;10;12;Lauantai;55;61;116;5;11;16
96;15.10.2011;2011;10;13;Lauantai;56;75;131;12;5;17
96;15.10.2011;2011;10;14;Lauantai;56;60;116;8;13;21
96;15.10.2011;2011;10;15;Lauantai;56;66;122;10;7;17
96;15.10.2011;2011;10;16;Lauantai;45;44;89;9;12;21
96;15.10.2011;2011;10;17;Lauantai;53;39;92;10;9;19
96;15.10.2011;2011;10;18;Lauantai;55;21;76;17;8;25
96;15.10.2011;2011;10;19;Lauantai;22;14;36;7;9;16
96;15.10.2011;2011;10;20;Lauantai;26;21;47;3;8;11
96;15.10.2011;2011;10;21;Lauantai;14;32;46;3;5;8
96;15.10.2011;2011;10;22;Lauantai;7;16;23;0;3;3
96;15.10.2011;2011;10;23;Lauantai;5;9;14;1;1;2
96;16.10.2011;2011;10;00;Sunnuntai;3;6;9;0;1;1
96;16.10.2011;2011;10;01;Sunnuntai;6;4;10;1;0;1
96;16.10.2011;2011;10;02;Sunnuntai;7;1;8;2;0;2
96;16.10.2011;2011;10;03;Sunnuntai;12;0;12;1;0;1
96;16.10.2011;2011;10;04;Sunnuntai;12;0;12;6;0;6
96;16.10.2011;2011;10;05;Sunnuntai;3;0;3;1;0;1
96;16.10.2011;2011;10;06;Sunnuntai;15;6;21;1;0;1
96;16.10.2011;2011;10;07;Sunnuntai;3;4;7;0;2;2
96;16.10.2011;2011;10;08;Sunnuntai;8;10;18;6;2;8
96;16.10.2011;2011;10;09;Sunnuntai;5;15;20;2;6;8
96;16.10.2011;2011;10;10;Sunnuntai;23;27;50;12;8;20
96;16.10.2011;2011;10;11;Sunnuntai;25;38;63;13;16;29
96;16.10.2011;2011;10;12;Sunnuntai;38;56;94;9;14;23
96;16.10.2011;2011;10;13;Sunnuntai;55;46;101;11;16;27
96;16.10.2011;2011;10;14;Sunnuntai;61;62;123;11;8;19
96;16.10.2011;2011;10;15;Sunnuntai;56;68;124;8;8;16
96;16.10.2011;2011;10;16;Sunnuntai;74;42;116;23;14;37
96;16.10.2011;2011;10;17;Sunnuntai;37;31;68;13;15;28
96;16.10.2011;2011;10;18;Sunnuntai;69;38;107;9;21;30
96;16.10.2011;2011;10;19;Sunnuntai;17;34;51;14;15;29
96;16.10.2011;2011;10;20;Sunnuntai;24;50;74;6;13;19
96;16.10.2011;2011;10;21;Sunnuntai;24;11;35;3;5;8
96;16.10.2011;2011;10;22;Sunnuntai;7;5;12;1;1;2
96;16.10.2011;2011;10;23;Sunnuntai;5;0;5;0;2;2
96;17.10.2011;2011;10;00;Maanantai;0;1;1;0;0;0
96;17.10.2011;2011;10;01;Maanantai;0;3;3;0;0;0
96;17.10.2011;2011;10;02;Maanantai;0;0;0;0;0;0
96;17.10.2011;2011;10;03;Maanantai;1;0;1;0;0;0
96;17.10.2011;2011;10;04;Maanantai;1;3;4;0;0;0
96;17.10.2011;2011;10;05;Maanantai;2;13;15;0;0;0
96;17.10.2011;2011;10;06;Maanantai;36;29;65;4;1;5
96;17.10.2011;2011;10;07;Maanantai;124;126;250;23;9;32
96;17.10.2011;2011;10;08;Maanantai;143;154;297;12;11;23
96;17.10.2011;2011;10;09;Maanantai;79;81;160;9;9;18
96;17.10.2011;2011;10;10;Maanantai;55;62;117;18;10;28
96;17.10.2011;2011;10;11;Maanantai;52;66;118;6;6;12
96;17.10.2011;2011;10;12;Maanantai;94;85;179;16;8;24
96;17.10.2011;2011;10;13;Maanantai;64;96;160;8;8;16
96;17.10.2011;2011;10;14;Maanantai;94;100;194;10;9;19
96;17.10.2011;2011;10;15;Maanantai;106;217;323;12;29;41
96;17.10.2011;2011;10;16;Maanantai;124;161;285;10;17;27
96;17.10.2011;2011;10;17;Maanantai;84;116;200;7;20;27
96;17.10.2011;2011;10;18;Maanantai;66;64;130;21;19;40
96;17.10.2011;2011;10;19;Maanantai;71;37;108;13;16;29
96;17.10.2011;2011;10;20;Maanantai;57;23;80;10;10;20
96;17.10.2011;2011;10;21;Maanantai;30;26;56;6;6;12
96;17.10.2011;2011;10;22;Maanantai;9;6;15;2;2;4
96;17.10.2011;2011;10;23;Maanantai;5;3;8;1;0;1
96;18.10.2011;2011;10;00;Tiistai;4;2;6;1;0;1
96;18.10.2011;2011;10;01;Tiistai;7;2;9;0;0;0
96;18.10.2011;2011;10;02;Tiistai;2;0;2;0;0;0
96;18.10.2011;2011;10;03;Tiistai;1;0;1;0;0;0
96;18.10.2011;2011;10;04;Tiistai;2;3;5;0;0;0
96;18.10.2011;2011;10;05;Tiistai;1;10;11;0;0;0
96;18.10.2011;2011;10;06;Tiistai;34;37;71;7;2;9
96;18.10.2011;2011;10;07;Tiistai;116;134;250;27;11;38
96;18.10.2011;2011;10;08;Tiistai;157;161;318;26;16;42
96;18.10.2011;2011;10;09;Tiistai;70;100;170;13;21;34
96;18.10.2011;2011;10;10;Tiistai;58;64;122;15;15;30
96;18.10.2011;2011;10;11;Tiistai;52;79;131;10;10;20
96;18.10.2011;2011;10;12;Tiistai;82;99;181;13;10;23
96;18.10.2011;2011;10;13;Tiistai;84;89;173;15;12;27
96;18.10.2011;2011;10;14;Tiistai;69;125;194;10;7;17
96;18.10.2011;2011;10;15;Tiistai;102;233;335;6;18;24
96;18.10.2011;2011;10;16;Tiistai;154;174;328;15;24;39
96;18.10.2011;2011;10;17;Tiistai;82;120;202;18;21;39
96;18.10.2011;2011;10;18;Tiistai;72;94;166;16;28;44
96;18.10.2011;2011;10;19;Tiistai;72;36;108;25;18;43
96;18.10.2011;2011;10;20;Tiistai;62;30;92;17;13;30
96;18.10.2011;2011;10;21;Tiistai;82;26;108;14;4;18
96;18.10.2011;2011;10;22;Tiistai;9;7;16;3;5;8
96;18.10.2011;2011;10;23;Tiistai;7;4;11;0;0;0
96;19.10.2011;2011;10;00;Keskiviikko;4;1;5;0;1;1
96;19.10.2011;2011;10;01;Keskiviikko;2;1;3;1;0;1
96;19.10.2011;2011;10;02;Keskiviikko;1;0;1;0;0;0
96;19.10.2011;2011;10;03;Keskiviikko;1;0;1;1;0;1
96;19.10.2011;2011;10;04;Keskiviikko;2;3;5;0;2;2
96;19.10.2011;2011;10;05;Keskiviikko;5;10;15;0;0;0
96;19.10.2011;2011;10;06;Keskiviikko;32;33;65;6;1;7
96;19.10.2011;2011;10;07;Keskiviikko;110;124;234;24;5;29
96;19.10.2011;2011;10;08;Keskiviikko;145;122;267;13;6;19
96;19.10.2011;2011;10;09;Keskiviikko;54;70;124;9;6;15
96;19.10.2011;2011;10;10;Keskiviikko;36;53;89;5;5;10
96;19.10.2011;2011;10;11;Keskiviikko;57;50;107;9;5;14
96;19.10.2011;2011;10;12;Keskiviikko;60;79;139;8;9;17
96;19.10.2011;2011;10;13;Keskiviikko;47;81;128;8;13;21
96;19.10.2011;2011;10;14;Keskiviikko;60;107;167;4;14;18
96;19.10.2011;2011;10;15;Keskiviikko;81;173;254;9;30;39
96;19.10.2011;2011;10;16;Keskiviikko;122;173;295;9;27;36
96;19.10.2011;2011;10;17;Keskiviikko;82;73;155;9;16;25
96;19.10.2011;2011;10;18;Keskiviikko;86;49;135;24;11;35
96;19.10.2011;2011;10;19;Keskiviikko;65;42;107;7;12;19
96;19.10.2011;2011;10;20;Keskiviikko;45;35;80;9;13;22
96;19.10.2011;2011;10;21;Keskiviikko;33;40;73;7;10;17
96;19.10.2011;2011;10;22;Keskiviikko;11;8;19;2;1;3
96;19.10.2011;2011;10;23;Keskiviikko;8;4;12;0;0;0
96;20.10.2011;2011;10;00;Torstai;3;3;6;0;0;0
96;20.10.2011;2011;10;01;Torstai;1;0;1;0;0;0
96;20.10.2011;2011;10;02;Torstai;1;0;1;2;0;2
96;20.10.2011;2011;10;03;Torstai;1;0;1;0;0;0
96;20.10.2011;2011;10;04;Torstai;2;3;5;1;0;1
96;20.10.2011;2011;10;05;Torstai;5;13;18;1;0;1
96;20.10.2011;2011;10;06;Torstai;34;26;60;7;1;8
96;20.10.2011;2011;10;07;Torstai;105;110;215;24;11;35
96;20.10.2011;2011;10;08;Torstai;143;131;274;17;7;24
96;20.10.2011;2011;10;09;Torstai;49;73;122;7;10;17
96;20.10.2011;2011;10;10;Torstai;51;80;131;7;7;14
96;20.10.2011;2011;10;11;Torstai;57;72;129;7;8;15
96;20.10.2011;2011;10;12;Torstai;74;72;146;12;7;19
96;20.10.2011;2011;10;13;Torstai;60;81;141;2;9;11
96;20.10.2011;2011;10;14;Torstai;78;115;193;8;12;20
96;20.10.2011;2011;10;15;Torstai;106;205;311;11;20;31
96;20.10.2011;2011;10;16;Torstai;108;157;265;21;22;43
96;20.10.2011;2011;10;17;Torstai;91;76;167;23;13;36
96;20.10.2011;2011;10;18;Torstai;62;56;118;5;12;17
96;20.10.2011;2011;10;19;Torstai;42;45;87;12;13;25
96;20.10.2011;2011;10;20;Torstai;67;31;98;11;6;17
96;20.10.2011;2011;10;21;Torstai;52;29;81;2;6;8
96;20.10.2011;2011;10;22;Torstai;11;5;16;3;5;8
96;20.10.2011;2011;10;23;Torstai;9;8;17;0;1;1
96;21.10.2011;2011;10;00;Perjantai;5;5;10;0;0;0
96;21.10.2011;2011;10;01;Perjantai;6;0;6;3;0;3
96;21.10.2011;2011;10;02;Perjantai;8;0;8;1;0;1
96;21.10.2011;2011;10;03;Perjantai;2;0;2;0;0;0
96;21.10.2011;2011;10;04;Perjantai;3;4;7;1;0;1
96;21.10.2011;2011;10;05;Perjantai;2;9;11;0;0;0
96;21.10.2011;2011;10;06;Perjantai;33;27;60;5;0;5
96;21.10.2011;2011;10;07;Perjantai;94;99;193;19;6;25
96;21.10.2011;2011;10;08;Perjantai;112;121;233;12;14;26
96;21.10.2011;2011;10;09;Perjantai;46;88;134;7;4;11
96;21.10.2011;2011;10;10;Perjantai;37;69;106;3;11;14
96;21.10.2011;2011;10;11;Perjantai;60;91;151;10;12;22
96;21.10.2011;2011;10;12;Perjantai;61;77;138;6;12;18
96;21.10.2011;2011;10;13;Perjantai;84;87;171;7;11;18
96;21.10.2011;2011;10;14;Perjantai;74;131;205;6;17;23
96;21.10.2011;2011;10;15;Perjantai;108;158;266;4;18;22
96;21.10.2011;2011;10;16;Perjantai;93;81;174;7;19;26
96;21.10.2011;2011;10;17;Perjantai;59;47;106;9;7;16
96;21.10.2011;2011;10;18;Perjantai;67;40;107;8;11;19
96;21.10.2011;2011;10;19;Perjantai;32;26;58;8;6;14
96;21.10.2011;2011;10;20;Perjantai;21;18;39;9;7;16
96;21.10.2011;2011;10;21;Perjantai;17;30;47;2;5;7
96;21.10.2011;2011;10;22;Perjantai;7;17;24;0;0;0
96;21.10.2011;2011;10;23;Perjantai;11;6;17;1;1;2
96;22.10.2011;2011;10;00;Lauantai;9;12;21;0;2;2
96;22.10.2011;2011;10;01;Lauantai;12;1;13;0;0;0
96;22.10.2011;2011;10;02;Lauantai;12;1;13;0;0;0
96;22.10.2011;2011;10;03;Lauantai;26;0;26;3;0;3
96;22.10.2011;2011;10;04;Lauantai;12;1;13;3;1;4
96;22.10.2011;2011;10;05;Lauantai;6;1;7;2;1;3
96;22.10.2011;2011;10;06;Lauantai;8;7;15;1;0;1
96;22.10.2011;2011;10;07;Lauantai;2;11;13;2;1;3
96;22.10.2011;2011;10;08;Lauantai;8;22;30;3;2;5
96;22.10.2011;2011;10;09;Lauantai;11;33;44;4;2;6
96;22.10.2011;2011;10;10;Lauantai;18;37;55;1;10;11
96;22.10.2011;2011;10;11;Lauantai;27;37;64;2;10;12
96;22.10.2011;2011;10;12;Lauantai;34;30;64;9;8;17
96;22.10.2011;2011;10;13;Lauantai;38;45;83;6;10;16
96;22.10.2011;2011;10;14;Lauantai;45;44;89;5;5;10
96;22.10.2011;2011;10;15;Lauantai;36;37;73;8;7;15
96;22.10.2011;2011;10;16;Lauantai;39;44;83;7;13;20
96;22.10.2011;2011;10;17;Lauantai;55;22;77;11;4;15
96;22.10.2011;2011;10;18;Lauantai;49;15;64;12;7;19
96;22.10.2011;2011;10;19;Lauantai;43;14;57;14;3;17
96;22.10.2011;2011;10;20;Lauantai;12;10;22;6;4;10
96;22.10.2011;2011;10;21;Lauantai;7;29;36;4;12;16
96;22.10.2011;2011;10;22;Lauantai;5;14;19;1;3;4
96;22.10.2011;2011;10;23;Lauantai;0;9;9;0;0;0
96;23.10.2011;2011;10;00;Sunnuntai;13;8;21;0;0;0
96;23.10.2011;2011;10;01;Sunnuntai;6;1;7;1;0;1
96;23.10.2011;2011;10;02;Sunnuntai;10;2;12;2;0;2
96;23.10.2011;2011;10;03;Sunnuntai;12;0;12;1;0;1
96;23.10.2011;2011;10;04;Sunnuntai;13;0;13;2;0;2
96;23.10.2011;2011;10;05;Sunnuntai;1;0;1;1;1;2
96;23.10.2011;2011;10;06;Sunnuntai;8;3;11;3;0;3
96;23.10.2011;2011;10;07;Sunnuntai;6;5;11;1;3;4
96;23.10.2011;2011;10;08;Sunnuntai;1;7;8;1;2;3
96;23.10.2011;2011;10;09;Sunnuntai;1;12;13;7;5;12
96;23.10.2011;2011;10;10;Sunnuntai;6;14;20;2;10;12
96;23.10.2011;2011;10;11;Sunnuntai;14;14;28;7;11;18
96;23.10.2011;2011;10;12;Sunnuntai;23;30;53;10;19;29
96;23.10.2011;2011;10;13;Sunnuntai;30;36;66;4;8;12
96;23.10.2011;2011;10;14;Sunnuntai;30;33;63;6;9;15
96;23.10.2011;2011;10;15;Sunnuntai;19;27;46;4;8;12
96;23.10.2011;2011;10;16;Sunnuntai;32;19;51;18;5;23
96;23.10.2011;2011;10;17;Sunnuntai;37;18;55;10;3;13
96;23.10.2011;2011;10;18;Sunnuntai;22;21;43;15;8;23
96;23.10.2011;2011;10;19;Sunnuntai;7;27;34;5;11;16
96;23.10.2011;2011;10;20;Sunnuntai;19;24;43;9;15;24
96;23.10.2011;2011;10;21;Sunnuntai;21;10;31;3;1;4
96;23.10.2011;2011;10;22;Sunnuntai;5;5;10;1;1;2
96;23.10.2011;2011;10;23;Sunnuntai;3;6;9;1;1;2
96;24.10.2011;2011;10;00;Maanantai;2;0;2;0;0;0
96;24.10.2011;2011;10;01;Maanantai;3;0;3;1;0;1
96;24.10.2011;2011;10;02;Maanantai;1;1;2;0;0;0
96;24.10.2011;2011;10;03;Maanantai;4;2;6;0;0;0
96;24.10.2011;2011;10;04;Maanantai;1;6;7;0;0;0
96;24.10.2011;2011;10;05;Maanantai;4;5;9;5;0;5
96;24.10.2011;2011;10;06;Maanantai;40;27;67;2;2;4
96;24.10.2011;2011;10;07;Maanantai;86;80;166;17;8;25
96;24.10.2011;2011;10;08;Maanantai;45;60;105;5;7;12
96;24.10.2011;2011;10;09;Maanantai;27;50;77;5;4;9
96;24.10.2011;2011;10;10;Maanantai;28;60;88;8;4;12
96;24.10.2011;2011;10;11;Maanantai;27;61;88;3;13;16
96;24.10.2011;2011;10;12;Maanantai;60;64;124;6;11;17
96;24.10.2011;2011;10;13;Maanantai;43;83;126;8;13;21
96;24.10.2011;2011;10;14;Maanantai;61;83;144;6;16;22
96;24.10.2011;2011;10;15;Maanantai;90;154;244;9;19;28
96;24.10.2011;2011;10;16;Maanantai;107;101;208;10;20;30
96;24.10.2011;2011;10;17;Maanantai;109;60;169;8;14;22
96;24.10.2011;2011;10;18;Maanantai;81;30;111;20;11;31
96;24.10.2011;2011;10;19;Maanantai;36;27;63;10;8;18
96;24.10.2011;2011;10;20;Maanantai;40;16;56;11;8;19
96;24.10.2011;2011;10;21;Maanantai;32;19;51;4;5;9
96;24.10.2011;2011;10;22;Maanantai;6;2;8;1;0;1
96;24.10.2011;2011;10;23;Maanantai;3;4;7;0;0;0
96;25.10.2011;2011;10;00;Tiistai;0;1;1;0;0;0
96;25.10.2011;2011;10;01;Tiistai;2;0;2;0;1;1
96;25.10.2011;2011;10;02;Tiistai;0;0;0;0;0;0
96;25.10.2011;2011;10;03;Tiistai;1;1;2;0;0;0
96;25.10.2011;2011;10;04;Tiistai;2;4;6;0;0;0
96;25.10.2011;2011;10;05;Tiistai;3;4;7;0;0;0
96;25.10.2011;2011;10;06;Tiistai;48;26;74;4;2;6
96;25.10.2011;2011;10;07;Tiistai;79;90;169;14;4;18
96;25.10.2011;2011;10;08;Tiistai;41;65;106;8;11;19
96;25.10.2011;2011;10;09;Tiistai;30;55;85;4;1;5
96;25.10.2011;2011;10;10;Tiistai;33;57;90;2;10;12
96;25.10.2011;2011;10;11;Tiistai;32;67;99;8;7;15
96;25.10.2011;2011;10;12;Tiistai;50;66;116;6;13;19
96;25.10.2011;2011;10;13;Tiistai;49;66;115;6;8;14
96;25.10.2011;2011;10;14;Tiistai;53;80;133;5;13;18
96;25.10.2011;2011;10;15;Tiistai;74;154;228;12;14;26
96;25.10.2011;2011;10;16;Tiistai;97;121;218;8;29;37
96;25.10.2011;2011;10;17;Tiistai;80;46;126;15;13;28
96;25.10.2011;2011;10;18;Tiistai;67;41;108;25;13;38
96;25.10.2011;2011;10;19;Tiistai;29;28;57;17;18;35
96;25.10.2011;2011;10;20;Tiistai;45;12;57;15;12;27
96;25.10.2011;2011;10;21;Tiistai;31;17;48;6;3;9
96;25.10.2011;2011;10;22;Tiistai;8;6;14;0;1;1
96;25.10.2011;2011;10;23;Tiistai;8;3;11;0;0;0
96;26.10.2011;2011;10;00;Keskiviikko;5;2;7;0;1;1
96;26.10.2011;2011;10;01;Keskiviikko;5;0;5;0;0;0
96;26.10.2011;2011;10;02;Keskiviikko;1;0;1;1;0;1
96;26.10.2011;2011;10;03;Keskiviikko;0;1;1;0;0;0
96;26.10.2011;2011;10;04;Keskiviikko;3;2;5;2;0;2
96;26.10.2011;2011;10;05;Keskiviikko;6;7;13;0;0;0
96;26.10.2011;2011;10;06;Keskiviikko;46;26;72;0;0;0
96;26.10.2011;2011;10;07;Keskiviikko;78;92;170;14;4;18
96;26.10.2011;2011;10;08;Keskiviikko;46;55;101;9;6;15
96;26.10.2011;2011;10;09;Keskiviikko;22;53;75;6;3;9
96;26.10.2011;2011;10;10;Keskiviikko;27;57;84;6;9;15
96;26.10.2011;2011;10;11;Keskiviikko;42;60;102;10;12;22
96;26.10.2011;2011;10;12;Keskiviikko;49;65;114;4;9;13
96;26.10.2011;2011;10;13;Keskiviikko;43;48;91;2;1;3
96;26.10.2011;2011;10;14;Keskiviikko;60;62;122;5;15;20
96;26.10.2011;2011;10;15;Keskiviikko;73;138;211;6;11;17
96;26.10.2011;2011;10;16;Keskiviikko;81;101;182;4;18;22
96;26.10.2011;2011;10;17;Keskiviikko;71;58;129;11;11;22
96;26.10.2011;2011;10;18;Keskiviikko;61;34;95;17;9;26
96;26.10.2011;2011;10;19;Keskiviikko;37;30;67;9;7;16
96;26.10.2011;2011;10;20;Keskiviikko;42;14;56;9;11;20
96;26.10.2011;2011;10;21;Keskiviikko;28;26;54;5;6;11
96;26.10.2011;2011;10;22;Keskiviikko;11;9;20;0;2;2
96;26.10.2011;2011;10;23;Keskiviikko;10;8;18;0;0;0
96;27.10.2011;2011;10;00;Torstai;5;1;6;1;0;1
96;27.10.2011;2011;10;01;Torstai;8;0;8;0;0;0
96;27.10.2011;2011;10;02;Torstai;6;0;6;0;0;0
96;27.10.2011;2011;10;03;Torstai;0;1;1;1;0;1
96;27.10.2011;2011;10;04;Torstai;3;3;6;1;0;1
96;27.10.2011;2011;10;05;Torstai;6;4;10;0;0;0
96;27.10.2011;2011;10;06;Torstai;43;24;67;3;1;4
96;27.10.2011;2011;10;07;Torstai;62;78;140;16;6;22
96;27.10.2011;2011;10;08;Torstai;41;54;95;8;4;12
96;27.10.2011;2011;10;09;Torstai;29;46;75;4;6;10
96;27.10.2011;2011;10;10;Torstai;24;49;73;8;3;11
96;27.10.2011;2011;10;11;Torstai;27;49;76;4;11;15
96;27.10.2011;2011;10;12;Torstai;53;49;102;7;16;23
96;27.10.2011;2011;10;13;Torstai;39;63;102;6;4;10
96;27.10.2011;2011;10;14;Torstai;45;87;132;8;7;15
96;27.10.2011;2011;10;15;Torstai;62;160;222;4;14;18
96;27.10.2011;2011;10;16;Torstai;81;74;155;10;24;34
96;27.10.2011;2011;10;17;Torstai;53;64;117;13;11;24
96;27.10.2011;2011;10;18;Torstai;48;50;98;2;12;14
96;27.10.2011;2011;10;19;Torstai;38;16;54;7;9;16
96;27.10.2011;2011;10;20;Torstai;57;11;68;13;12;25
96;27.10.2011;2011;10;21;Torstai;27;20;47;9;9;18
96;27.10.2011;2011;10;22;Torstai;10;17;27;4;4;8
96;27.10.2011;2011;10;23;Torstai;5;3;8;0;0;0
96;28.10.2011;2011;10;00;Perjantai;9;6;15;0;0;0
96;28.10.2011;2011;10;01;Perjantai;1;0;1;0;0;0
96;28.10.2011;2011;10;02;Perjantai;4;0;4;1;0;1
96;28.10.2011;2011;10;03;Perjantai;2;0;2;0;0;0
96;28.10.2011;2011;10;04;Perjantai;1;3;4;1;0;1
96;28.10.2011;2011;10;05;Perjantai;3;4;7;0;0;0
96;28.10.2011;2011;10;06;Perjantai;34;29;63;2;2;4
96;28.10.2011;2011;10;07;Perjantai;68;57;125;8;8;16
96;28.10.2011;2011;10;08;Perjantai;28;47;75;9;5;14
96;28.10.2011;2011;10;09;Perjantai;27;45;72;3;5;8
96;28.10.2011;2011;10;10;Perjantai;23;67;90;1;9;10
96;28.10.2011;2011;10;11;Perjantai;41;60;101;6;4;10
96;28.10.2011;2011;10;12;Perjantai;37;50;87;5;9;14
96;28.10.2011;2011;10;13;Perjantai;55;69;124;3;7;10
96;28.10.2011;2011;10;14;Perjantai;42;87;129;8;14;22
96;28.10.2011;2011;10;15;Perjantai;63;96;159;8;21;29
96;28.10.2011;2011;10;16;Perjantai;59;61;120;10;15;25
96;28.10.2011;2011;10;17;Perjantai;50;42;92;3;9;12
96;28.10.2011;2011;10;18;Perjantai;41;32;73;12;7;19
96;28.10.2011;2011;10;19;Perjantai;27;35;62;13;6;19
96;28.10.2011;2011;10;20;Perjantai;32;11;43;2;3;5
96;28.10.2011;2011;10;21;Perjantai;32;29;61;1;5;6
96;28.10.2011;2011;10;22;Perjantai;6;7;13;1;2;3
96;28.10.2011;2011;10;23;Perjantai;11;7;18;0;0;0
96;29.10.2011;2011;10;00;Lauantai;7;4;11;0;0;0
96;29.10.2011;2011;10;01;Lauantai;4;0;4;0;1;1
96;29.10.2011;2011;10;02;Lauantai;9;3;12;1;1;2
96;29.10.2011;2011;10;03;Lauantai;8;1;9;0;0;0
96;29.10.2011;2011;10;04;Lauantai;13;2;15;1;0;1
96;29.10.2011;2011;10;05;Lauantai;0;1;1;2;0;2
96;29.10.2011;2011;10;06;Lauantai;12;5;17;3;0;3
96;29.10.2011;2011;10;07;Lauantai;5;7;12;3;2;5
96;29.10.2011;2011;10;08;Lauantai;5;16;21;6;4;10
96;29.10.2011;2011;10;09;Lauantai;10;28;38;2;5;7
96;29.10.2011;2011;10;10;Lauantai;22;34;56;7;6;13
96;29.10.2011;2011;10;11;Lauantai;36;42;78;5;6;11
96;29.10.2011;2011;10;12;Lauantai;30;63;93;8;8;16
96;29.10.2011;2011;10;13;Lauantai;62;52;114;11;19;30
96;29.10.2011;2011;10;14;Lauantai;49;53;102;5;9;14
96;29.10.2011;2011;10;15;Lauantai;56;69;125;11;10;21
96;29.10.2011;2011;10;16;Lauantai;38;33;71;14;9;23
96;29.10.2011;2011;10;17;Lauantai;37;24;61;7;9;16
96;29.10.2011;2011;10;18;Lauantai;51;19;70;21;13;34
96;29.10.2011;2011;10;19;Lauantai;31;15;46;5;10;15
96;29.10.2011;2011;10;20;Lauantai;19;23;42;5;10;15
96;29.10.2011;2011;10;21;Lauantai;11;41;52;3;9;12
96;29.10.2011;2011;10;22;Lauantai;5;26;31;1;1;2
96;29.10.2011;2011;10;23;Lauantai;1;16;17;2;2;4
96;30.10.2011;2011;10;00;Sunnuntai;5;6;11;1;1;2
96;30.10.2011;2011;10;01;Sunnuntai;7;2;9;1;0;1
96;30.10.2011;2011;10;02;Sunnuntai;10;3;13;1;2;3
96;30.10.2011;2011;10;03;Sunnuntai;12;4;16;6;0;6
96;30.10.2011;2011;10;04;Sunnuntai;11;1;12;5;1;6
96;30.10.2011;2011;10;05;Sunnuntai;5;0;5;1;1;2
96;30.10.2011;2011;10;06;Sunnuntai;11;7;18;3;0;3
96;30.10.2011;2011;10;07;Sunnuntai;4;11;15;1;2;3
96;30.10.2011;2011;10;08;Sunnuntai;7;15;22;2;4;6
96;30.10.2011;2011;10;09;Sunnuntai;11;15;26;4;3;7
96;30.10.2011;2011;10;10;Sunnuntai;12;18;30;7;9;16
96;30.10.2011;2011;10;11;Sunnuntai;18;24;42;5;14;19
96;30.10.2011;2011;10;12;Sunnuntai;28;34;62;11;10;21
96;30.10.2011;2011;10;13;Sunnuntai;36;50;86;3;6;9
96;30.10.2011;2011;10;14;Sunnuntai;36;36;72;9;10;19
96;30.10.2011;2011;10;15;Sunnuntai;35;38;73;7;20;27
96;30.10.2011;2011;10;16;Sunnuntai;65;26;91;24;7;31
96;30.10.2011;2011;10;17;Sunnuntai;34;25;59;10;9;19
96;30.10.2011;2011;10;18;Sunnuntai;30;31;61;10;13;23
96;30.10.2011;2011;10;19;Sunnuntai;21;20;41;7;9;16
96;30.10.2011;2011;10;20;Sunnuntai;30;26;56;8;17;25
96;30.10.2011;2011;10;21;Sunnuntai;14;19;33;2;2;4
96;30.10.2011;2011;10;22;Sunnuntai;3;4;7;1;2;3
96;30.10.2011;2011;10;23;Sunnuntai;3;6;9;2;2;4
96;31.10.2011;2011;10;00;Maanantai;1;0;1;0;0;0
96;31.10.2011;2011;10;01;Maanantai;0;0;0;0;0;0
96;31.10.2011;2011;10;02;Maanantai;2;0;2;0;0;0
96;31.10.2011;2011;10;03;Maanantai;0;2;2;0;0;0
96;31.10.2011;2011;10;04;Maanantai;1;3;4;0;0;0
96;31.10.2011;2011;10;05;Maanantai;2;6;8;1;0;1
96;31.10.2011;2011;10;06;Maanantai;44;33;77;6;3;9
96;31.10.2011;2011;10;07;Maanantai;115;111;226;32;10;42
96;31.10.2011;2011;10;08;Maanantai;130;136;266;18;10;28
96;31.10.2011;2011;10;09;Maanantai;62;81;143;9;5;14
96;31.10.2011;2011;10;10;Maanantai;42;67;109;9;6;15
96;31.10.2011;2011;10;11;Maanantai;52;58;110;9;9;18
96;31.10.2011;2011;10;12;Maanantai;72;61;133;7;7;14
96;31.10.2011;2011;10;13;Maanantai;70;79;149;5;9;14
96;31.10.2011;2011;10;14;Maanantai;82;111;193;3;14;17
96;31.10.2011;2011;10;15;Maanantai;93;194;287;16;23;39
96;31.10.2011;2011;10;16;Maanantai;108;169;277;20;31;51
96;31.10.2011;2011;10;17;Maanantai;80;83;163;15;19;34
96;31.10.2011;2011;10;18;Maanantai;70;55;125;15;19;34
96;31.10.2011;2011;10;19;Maanantai;51;43;94;19;13;32
96;31.10.2011;2011;10;20;Maanantai;62;22;84;8;8;16
96;31.10.2011;2011;10;21;Maanantai;44;19;63;7;3;10
96;31.10.2011;2011;10;22;Maanantai;8;6;14;1;5;6
96;31.10.2011;2011;10;23;Maanantai;4;4;8;1;1;2
96;01.11.2011;2011;11;00;Tiistai;2;0;2;1;1;2
96;01.11.2011;2011;11;01;Tiistai;4;0;4;0;0;0
96;01.11.2011;2011;11;02;Tiistai;2;0;2;0;0;0
96;01.11.2011;2011;11;03;Tiistai;1;0;1;0;0;0
96;01.11.2011;2011;11;04;Tiistai;0;5;5;1;0;1
96;01.11.2011;2011;11;05;Tiistai;2;8;10;2;0;2
96;01.11.2011;2011;11;06;Tiistai;36;46;82;4;4;8
96;01.11.2011;2011;11;07;Tiistai;96;134;230;25;12;37
96;01.11.2011;2011;11;08;Tiistai;146;140;286;15;11;26
96;01.11.2011;2011;11;09;Tiistai;60;107;167;9;7;16
96;01.11.2011;2011;11;10;Tiistai;43;54;97;7;6;13
96;01.11.2011;2011;11;11;Tiistai;58;64;122;7;8;15
96;01.11.2011;2011;11;12;Tiistai;61;86;147;7;16;23
96;01.11.2011;2011;11;13;Tiistai;72;87;159;10;11;21
96;01.11.2011;2011;11;14;Tiistai;79;134;213;6;11;17
96;01.11.2011;2011;11;15;Tiistai;98;214;312;9;28;37
96;01.11.2011;2011;11;16;Tiistai;143;150;293;17;38;55
96;01.11.2011;2011;11;17;Tiistai;76;75;151;18;23;41
96;01.11.2011;2011;11;18;Tiistai;75;47;122;20;25;45
96;01.11.2011;2011;11;19;Tiistai;45;30;75;15;22;37
96;01.11.2011;2011;11;20;Tiistai;67;33;100;8;10;18
96;01.11.2011;2011;11;21;Tiistai;28;28;56;6;7;13
96;01.11.2011;2011;11;22;Tiistai;16;4;20;0;3;3
96;01.11.2011;2011;11;23;Tiistai;9;1;10;0;0;0
96;02.11.2011;2011;11;00;Keskiviikko;4;0;4;0;0;0
96;02.11.2011;2011;11;01;Keskiviikko;0;1;1;0;0;0
96;02.11.2011;2011;11;02;Keskiviikko;2;0;2;0;0;0
96;02.11.2011;2011;11;03;Keskiviikko;0;0;0;0;0;0
96;02.11.2011;2011;11;04;Keskiviikko;1;5;6;0;0;0
96;02.11.2011;2011;11;05;Keskiviikko;3;8;11;0;0;0
96;02.11.2011;2011;11;06;Keskiviikko;44;34;78;7;2;9
96;02.11.2011;2011;11;07;Keskiviikko;114;127;241;18;7;25
96;02.11.2011;2011;11;08;Keskiviikko;142;147;289;13;4;17
96;02.11.2011;2011;11;09;Keskiviikko;58;95;153;10;12;22
96;02.11.2011;2011;11;10;Keskiviikko;60;65;125;10;4;14
96;02.11.2011;2011;11;11;Keskiviikko;48;62;110;11;10;21
96;02.11.2011;2011;11;12;Keskiviikko;78;68;146;8;4;12
96;02.11.2011;2011;11;13;Keskiviikko;74;82;156;3;7;10
96;02.11.2011;2011;11;14;Keskiviikko;94;108;202;8;8;16
96;02.11.2011;2011;11;15;Keskiviikko;91;196;287;11;23;34
96;02.11.2011;2011;11;16;Keskiviikko;128;188;316;14;29;43
96;02.11.2011;2011;11;17;Keskiviikko;80;77;157;10;15;25
96;02.11.2011;2011;11;18;Keskiviikko;86;48;134;24;19;43
96;02.11.2011;2011;11;19;Keskiviikko;71;42;113;10;12;22
96;02.11.2011;2011;11;20;Keskiviikko;52;30;82;14;5;19
96;02.11.2011;2011;11;21;Keskiviikko;34;30;64;8;6;14
96;02.11.2011;2011;11;22;Keskiviikko;14;9;23;1;3;4
96;02.11.2011;2011;11;23;Keskiviikko;9;6;15;1;1;2
96;03.11.2011;2011;11;00;Torstai;4;2;6;2;0;2
96;03.11.2011;2011;11;01;Torstai;2;3;5;0;0;0
96;03.11.2011;2011;11;02;Torstai;2;0;2;1;0;1
96;03.11.2011;2011;11;03;Torstai;6;0;6;3;0;3
96;03.11.2011;2011;11;04;Torstai;1;4;5;0;0;0
96;03.11.2011;2011;11;05;Torstai;3;10;13;2;0;2
96;03.11.2011;2011;11;06;Torstai;36;25;61;6;1;7
96;03.11.2011;2011;11;07;Torstai;103;105;208;29;8;37
96;03.11.2011;2011;11;08;Torstai;126;157;283;15;4;19
96;03.11.2011;2011;11;09;Torstai;46;73;119;8;5;13
96;03.11.2011;2011;11;10;Torstai;52;79;131;8;9;17
96;03.11.2011;2011;11;11;Torstai;58;89;147;7;11;18
96;03.11.2011;2011;11;12;Torstai;80;65;145;10;16;26
96;03.11.2011;2011;11;13;Torstai;70;91;161;6;9;15
96;03.11.2011;2011;11;14;Torstai;91;104;195;9;4;13
96;03.11.2011;2011;11;15;Torstai;92;220;312;9;29;38
96;03.11.2011;2011;11;16;Torstai;115;141;256;11;37;48
96;03.11.2011;2011;11;17;Torstai;69;78;147;11;13;24
96;03.11.2011;2011;11;18;Torstai;62;51;113;9;22;31
96;03.11.2011;2011;11;19;Torstai;40;30;70;10;16;26
96;03.11.2011;2011;11;20;Torstai;51;32;83;6;7;13
96;03.11.2011;2011;11;21;Torstai;26;26;52;3;5;8
96;03.11.2011;2011;11;22;Torstai;13;16;29;3;3;6
96;03.11.2011;2011;11;23;Torstai;5;3;8;0;3;3
96;04.11.2011;2011;11;00;Perjantai;7;1;8;1;1;2
96;04.11.2011;2011;11;01;Perjantai;3;1;4;0;0;0
96;04.11.2011;2011;11;02;Perjantai;7;0;7;0;0;0
96;04.11.2011;2011;11;03;Perjantai;6;1;7;1;0;1
96;04.11.2011;2011;11;04;Perjantai;8;5;13;0;0;0
96;04.11.2011;2011;11;05;Perjantai;2;8;10;1;0;1
96;04.11.2011;2011;11;06;Perjantai;41;35;76;8;1;9
96;04.11.2011;2011;11;07;Perjantai;93;90;183;20;8;28
96;04.11.2011;2011;11;08;Perjantai;119;116;235;11;13;24
96;04.11.2011;2011;11;09;Perjantai;67;82;149;14;9;23
96;04.11.2011;2011;11;10;Perjantai;41;60;101;4;5;9
96;04.11.2011;2011;11;11;Perjantai;51;70;121;10;5;15
96;04.11.2011;2011;11;12;Perjantai;55;86;141;1;15;16
96;04.11.2011;2011;11;13;Perjantai;83;85;168;10;8;18
96;04.11.2011;2011;11;14;Perjantai;82;116;198;7;19;26
96;04.11.2011;2011;11;15;Perjantai;68;139;207;6;21;27
96;04.11.2011;2011;11;16;Perjantai;71;107;178;7;17;24
96;04.11.2011;2011;11;17;Perjantai;62;49;111;9;7;16
96;04.11.2011;2011;11;18;Perjantai;33;32;65;14;16;30
96;04.11.2011;2011;11;19;Perjantai;33;18;51;5;4;9
96;04.11.2011;2011;11;20;Perjantai;33;15;48;9;6;15
96;04.11.2011;2011;11;21;Perjantai;19;20;39;4;1;5
96;04.11.2011;2011;11;22;Perjantai;8;9;17;1;3;4
96;04.11.2011;2011;11;23;Perjantai;14;13;27;1;0;1
96;05.11.2011;2011;11;00;Lauantai;6;8;14;1;1;2
96;05.11.2011;2011;11;01;Lauantai;9;2;11;2;0;2
96;05.11.2011;2011;11;02;Lauantai;8;3;11;1;0;1
96;05.11.2011;2011;11;03;Lauantai;6;0;6;2;0;2
96;05.11.2011;2011;11;04;Lauantai;7;0;7;2;1;3
96;05.11.2011;2011;11;05;Lauantai;3;0;3;0;0;0
96;05.11.2011;2011;11;06;Lauantai;10;5;15;2;1;3
96;05.11.2011;2011;11;07;Lauantai;2;6;8;1;3;4
96;05.11.2011;2011;11;08;Lauantai;5;8;13;6;4;10
96;05.11.2011;2011;11;09;Lauantai;5;17;22;4;5;9
96;05.11.2011;2011;11;10;Lauantai;9;16;25;12;13;25
96;05.11.2011;2011;11;11;Lauantai;26;29;55;7;12;19
96;05.11.2011;2011;11;12;Lauantai;26;31;57;9;20;29
96;05.11.2011;2011;11;13;Lauantai;31;25;56;12;9;21
96;05.11.2011;2011;11;14;Lauantai;22;36;58;9;17;26
96;05.11.2011;2011;11;15;Lauantai;31;27;58;12;17;29
96;05.11.2011;2011;11;16;Lauantai;29;54;83;14;16;30
96;05.11.2011;2011;11;17;Lauantai;26;34;60;7;13;20
96;05.11.2011;2011;11;18;Lauantai;20;28;48;10;9;19
96;05.11.2011;2011;11;19;Lauantai;47;31;78;11;8;19
96;05.11.2011;2011;11;20;Lauantai;24;20;44;4;7;11
96;05.11.2011;2011;11;21;Lauantai;11;16;27;4;0;4
96;05.11.2011;2011;11;22;Lauantai;9;7;16;3;1;4
96;05.11.2011;2011;11;23;Lauantai;10;10;20;1;0;1
96;06.11.2011;2011;11;00;Sunnuntai;5;14;19;0;0;0
96;06.11.2011;2011;11;01;Sunnuntai;10;1;11;0;0;0
96;06.11.2011;2011;11;02;Sunnuntai;8;2;10;3;2;5
96;06.11.2011;2011;11;03;Sunnuntai;11;1;12;3;1;4
96;06.11.2011;2011;11;04;Sunnuntai;6;1;7;0;0;0
96;06.11.2011;2011;11;05;Sunnuntai;6;0;6;0;0;0
96;06.11.2011;2011;11;06;Sunnuntai;9;2;11;2;0;2
96;06.11.2011;2011;11;07;Sunnuntai;0;6;6;1;1;2
96;06.11.2011;2011;11;08;Sunnuntai;2;7;9;2;3;5
96;06.11.2011;2011;11;09;Sunnuntai;8;16;24;8;9;17
96;06.11.2011;2011;11;10;Sunnuntai;14;15;29;8;10;18
96;06.11.2011;2011;11;11;Sunnuntai;16;31;47;15;13;28
96;06.11.2011;2011;11;12;Sunnuntai;28;44;72;7;9;16
96;06.11.2011;2011;11;13;Sunnuntai;47;43;90;9;15;24
96;06.11.2011;2011;11;14;Sunnuntai;40;38;78;13;11;24
96;06.11.2011;2011;11;15;Sunnuntai;31;41;72;13;7;20
96;06.11.2011;2011;11;16;Sunnuntai;43;27;70;23;14;37
96;06.11.2011;2011;11;17;Sunnuntai;47;29;76;18;16;34
96;06.11.2011;2011;11;18;Sunnuntai;44;29;73;9;12;21
96;06.11.2011;2011;11;19;Sunnuntai;17;29;46;8;13;21
96;06.11.2011;2011;11;20;Sunnuntai;26;34;60;14;10;24
96;06.11.2011;2011;11;21;Sunnuntai;15;13;28;5;4;9
96;06.11.2011;2011;11;22;Sunnuntai;8;7;15;2;1;3
96;06.11.2011;2011;11;23;Sunnuntai;2;2;4;0;1;1
96;07.11.2011;2011;11;00;Maanantai;0;3;3;0;0;0
96;07.11.2011;2011;11;01;Maanantai;0;0;0;1;0;1
96;07.11.2011;2011;11;02;Maanantai;0;1;1;0;0;0
96;07.11.2011;2011;11;03;Maanantai;2;1;3;2;0;2
96;07.11.2011;2011;11;04;Maanantai;5;2;7;0;0;0
96;07.11.2011;2011;11;05;Maanantai;4;5;9;0;0;0
96;07.11.2011;2011;11;06;Maanantai;40;36;76;3;2;5
96;07.11.2011;2011;11;07;Maanantai;115;112;227;28;9;37
96;07.11.2011;2011;11;08;Maanantai;107;164;271;18;15;33
96;07.11.2011;2011;11;09;Maanantai;62;92;154;9;9;18
96;07.11.2011;2011;11;10;Maanantai;48;59;107;8;6;14
96;07.11.2011;2011;11;11;Maanantai;58;66;124;11;7;18
96;07.11.2011;2011;11;12;Maanantai;83;83;166;6;4;10
96;07.11.2011;2011;11;13;Maanantai;76;68;144;8;8;16
96;07.11.2011;2011;11;14;Maanantai;85;91;176;5;6;11
96;07.11.2011;2011;11;15;Maanantai;99;218;317;8;29;37
96;07.11.2011;2011;11;16;Maanantai;124;173;297;19;33;52
96;07.11.2011;2011;11;17;Maanantai;77;87;164;15;14;29
96;07.11.2011;2011;11;18;Maanantai;64;51;115;18;18;36
96;07.11.2011;2011;11;19;Maanantai;47;47;94;16;15;31
96;07.11.2011;2011;11;20;Maanantai;63;26;89;8;7;15
96;07.11.2011;2011;11;21;Maanantai;41;24;65;6;4;10
96;07.11.2011;2011;11;22;Maanantai;12;7;19;1;1;2
96;07.11.2011;2011;11;23;Maanantai;4;2;6;1;1;2
96;08.11.2011;2011;11;00;Tiistai;1;3;4;0;0;0
96;08.11.2011;2011;11;01;Tiistai;2;2;4;0;0;0
96;08.11.2011;2011;11;02;Tiistai;2;1;3;0;0;0
96;08.11.2011;2011;11;03;Tiistai;0;0;0;0;0;0
96;08.11.2011;2011;11;04;Tiistai;2;5;7;0;0;0
96;08.11.2011;2011;11;05;Tiistai;5;6;11;2;0;2
96;08.11.2011;2011;11;06;Tiistai;51;30;81;11;4;15
96;08.11.2011;2011;11;07;Tiistai;100;108;208;16;10;26
96;08.11.2011;2011;11;08;Tiistai;126;154;280;12;8;20
96;08.11.2011;2011;11;09;Tiistai;64;93;157;13;5;18
96;08.11.2011;2011;11;10;Tiistai;52;68;120;6;4;10
96;08.11.2011;2011;11;11;Tiistai;41;51;92;8;11;19
96;08.11.2011;2011;11;12;Tiistai;64;93;157;7;6;13
96;08.11.2011;2011;11;13;Tiistai;65;76;141;13;8;21
96;08.11.2011;2011;11;14;Tiistai;74;146;220;8;14;22
96;08.11.2011;2011;11;15;Tiistai;109;201;310;8;20;28
96;08.11.2011;2011;11;16;Tiistai;123;166;289;5;40;45
96;08.11.2011;2011;11;17;Tiistai;90;88;178;15;15;30
96;08.11.2011;2011;11;18;Tiistai;75;74;149;16;19;35
96;08.11.2011;2011;11;19;Tiistai;48;38;86;25;19;44
96;08.11.2011;2011;11;20;Tiistai;57;18;75;8;17;25
96;08.11.2011;2011;11;21;Tiistai;24;22;46;6;4;10
96;08.11.2011;2011;11;22;Tiistai;7;10;17;3;2;5
96;08.11.2011;2011;11;23;Tiistai;12;6;18;1;1;2
96;09.11.2011;2011;11;00;Keskiviikko;5;0;5;0;0;0
96;09.11.2011;2011;11;01;Keskiviikko;1;0;1;0;0;0
96;09.11.2011;2011;11;02;Keskiviikko;2;2;4;0;0;0
96;09.11.2011;2011;11;03;Keskiviikko;1;0;1;0;0;0
96;09.11.2011;2011;11;04;Keskiviikko;3;4;7;0;0;0
96;09.11.2011;2011;11;05;Keskiviikko;5;8;13;0;0;0
96;09.11.2011;2011;11;06;Keskiviikko;45;28;73;6;3;9
96;09.11.2011;2011;11;07;Keskiviikko;98;94;192;18;13;31
96;09.11.2011;2011;11;08;Keskiviikko;159;137;296;15;12;27
96;09.11.2011;2011;11;09;Keskiviikko;80;71;151;13;8;21
96;09.11.2011;2011;11;10;Keskiviikko;51;73;124;5;2;7
96;09.11.2011;2011;11;11;Keskiviikko;41;55;96;9;9;18
96;09.11.2011;2011;11;12;Keskiviikko;74;80;154;10;9;19
96;09.11.2011;2011;11;13;Keskiviikko;75;81;156;7;7;14
96;09.11.2011;2011;11;14;Keskiviikko;93;114;207;8;12;20
96;09.11.2011;2011;11;15;Keskiviikko;76;228;304;6;18;24
96;09.11.2011;2011;11;16;Keskiviikko;93;188;281;13;32;45
96;09.11.2011;2011;11;17;Keskiviikko;85;82;167;12;15;27
96;09.11.2011;2011;11;18;Keskiviikko;77;56;133;26;16;42
96;09.11.2011;2011;11;19;Keskiviikko;68;54;122;12;24;36
96;09.11.2011;2011;11;20;Keskiviikko;54;42;96;13;9;22
96;09.11.2011;2011;11;21;Keskiviikko;58;50;108;4;10;14
96;09.11.2011;2011;11;22;Keskiviikko;11;9;20;0;1;1
96;09.11.2011;2011;11;23;Keskiviikko;9;5;14;1;0;1
96;10.11.2011;2011;11;00;Torstai;2;2;4;0;0;0
96;10.11.2011;2011;11;01;Torstai;4;0;4;0;0;0
96;10.11.2011;2011;11;02;Torstai;1;1;2;0;0;0
96;10.11.2011;2011;11;03;Torstai;1;0;1;0;0;0
96;10.11.2011;2011;11;04;Torstai;6;4;10;1;0;1
96;10.11.2011;2011;11;05;Torstai;4;4;8;0;1;1
96;10.11.2011;2011;11;06;Torstai;45;22;67;2;2;4
96;10.11.2011;2011;11;07;Torstai;78;99;177;14;11;25
96;10.11.2011;2011;11;08;Torstai;139;144;283;15;8;23
96;10.11.2011;2011;11;09;Torstai;45;70;115;6;9;15
96;10.11.2011;2011;11;10;Torstai;49;59;108;7;8;15
96;10.11.2011;2011;11;11;Torstai;41;74;115;0;6;6
96;10.11.2011;2011;11;12;Torstai;65;79;144;1;5;6
96;10.11.2011;2011;11;13;Torstai;63;80;143;2;12;14
96;10.11.2011;2011;11;14;Torstai;77;105;182;4;15;19
96;10.11.2011;2011;11;15;Torstai;79;183;262;5;19;24
96;10.11.2011;2011;11;16;Torstai;111;137;248;8;13;21
96;10.11.2011;2011;11;17;Torstai;84;74;158;10;16;26
96;10.11.2011;2011;11;18;Torstai;56;55;111;9;11;20
96;10.11.2011;2011;11;19;Torstai;45;32;77;13;7;20
96;10.11.2011;2011;11;20;Torstai;57;31;88;14;9;23
96;10.11.2011;2011;11;21;Torstai;37;26;63;8;8;16
96;10.11.2011;2011;11;22;Torstai;13;6;19;3;2;5
96;10.11.2011;2011;11;23;Torstai;7;2;9;1;2;3
96;11.11.2011;2011;11;00;Perjantai;3;3;6;0;4;4
96;11.11.2011;2011;11;01;Perjantai;1;0;1;0;0;0
96;11.11.2011;2011;11;02;Perjantai;8;0;8;0;0;0
96;11.11.2011;2011;11;03;Perjantai;2;0;2;0;0;0
96;11.11.2011;2011;11;04;Perjantai;2;2;4;0;0;0
96;11.11.2011;2011;11;05;Perjantai;6;6;12;3;0;3
96;11.11.2011;2011;11;06;Perjantai;48;21;69;4;2;6
96;11.11.2011;2011;11;07;Perjantai;69;92;161;27;12;39
96;11.11.2011;2011;11;08;Perjantai;116;133;249;11;8;19
96;11.11.2011;2011;11;09;Perjantai;43;78;121;4;5;9
96;11.11.2011;2011;11;10;Perjantai;45;82;127;6;6;12
96;11.11.2011;2011;11;11;Perjantai;50;71;121;9;19;28
96;11.11.2011;2011;11;12;Perjantai;60;80;140;6;5;11
96;11.11.2011;2011;11;13;Perjantai;58;110;168;8;8;16
96;11.11.2011;2011;11;14;Perjantai;91;127;218;9;17;26
96;11.11.2011;2011;11;15;Perjantai;94;153;247;5;34;39
96;11.11.2011;2011;11;16;Perjantai;73;72;145;9;16;25
96;11.11.2011;2011;11;17;Perjantai;47;46;93;7;13;20
96;11.11.2011;2011;11;18;Perjantai;52;26;78;6;11;17
96;11.11.2011;2011;11;19;Perjantai;30;33;63;4;6;10
96;11.11.2011;2011;11;20;Perjantai;43;15;58;6;7;13
96;11.11.2011;2011;11;21;Perjantai;20;16;36;5;7;12
96;11.11.2011;2011;11;22;Perjantai;6;19;25;1;4;5
96;11.11.2011;2011;11;23;Perjantai;6;9;15;1;1;2
96;12.11.2011;2011;11;00;Lauantai;16;13;29;0;5;5
96;12.11.2011;2011;11;01;Lauantai;4;6;10;2;1;3
96;12.11.2011;2011;11;02;Lauantai;2;2;4;2;0;2
96;12.11.2011;2011;11;03;Lauantai;7;0;7;0;0;0
96;12.11.2011;2011;11;04;Lauantai;14;0;14;3;0;3
96;12.11.2011;2011;11;05;Lauantai;3;1;4;0;1;1
96;12.11.2011;2011;11;06;Lauantai;10;8;18;1;1;2
96;12.11.2011;2011;11;07;Lauantai;5;6;11;0;5;5
96;12.11.2011;2011;11;08;Lauantai;8;15;23;2;5;7
96;12.11.2011;2011;11;09;Lauantai;14;43;57;2;5;7
96;12.11.2011;2011;11;10;Lauantai;18;38;56;7;8;15
96;12.11.2011;2011;11;11;Lauantai;32;36;68;1;10;11
96;12.11.2011;2011;11;12;Lauantai;25;51;76;6;5;11
96;12.11.2011;2011;11;13;Lauantai;32;44;76;5;9;14
96;12.11.2011;2011;11;14;Lauantai;35;36;71;5;8;13
96;12.11.2011;2011;11;15;Lauantai;46;57;103;8;4;12
96;12.11.2011;2011;11;16;Lauantai;41;44;85;10;9;19
96;12.11.2011;2011;11;17;Lauantai;20;20;40;6;9;15
96;12.11.2011;2011;11;18;Lauantai;35;15;50;7;5;12
96;12.11.2011;2011;11;19;Lauantai;25;14;39;6;3;9
96;12.11.2011;2011;11;20;Lauantai;11;20;31;7;5;12
96;12.11.2011;2011;11;21;Lauantai;16;20;36;2;6;8
96;12.11.2011;2011;11;22;Lauantai;3;14;17;0;2;2
96;12.11.2011;2011;11;23;Lauantai;16;3;19;0;2;2
96;13.11.2011;2011;11;00;Sunnuntai;3;3;6;2;0;2
96;13.11.2011;2011;11;01;Sunnuntai;7;5;12;1;0;1
96;13.11.2011;2011;11;02;Sunnuntai;11;1;12;0;0;0
96;13.11.2011;2011;11;03;Sunnuntai;14;0;14;2;1;3
96;13.11.2011;2011;11;04;Sunnuntai;6;0;6;2;0;2
96;13.11.2011;2011;11;05;Sunnuntai;2;0;2;0;0;0
96;13.11.2011;2011;11;06;Sunnuntai;5;7;12;2;1;3
96;13.11.2011;2011;11;07;Sunnuntai;4;5;9;0;2;2
96;13.11.2011;2011;11;08;Sunnuntai;8;7;15;5;2;7
96;13.11.2011;2011;11;09;Sunnuntai;8;10;18;7;5;12
96;13.11.2011;2011;11;10;Sunnuntai;11;15;26;4;11;15
96;13.11.2011;2011;11;11;Sunnuntai;14;16;30;13;9;22
96;13.11.2011;2011;11;12;Sunnuntai;19;25;44;14;10;24
96;13.11.2011;2011;11;13;Sunnuntai;34;26;60;8;10;18
96;13.11.2011;2011;11;14;Sunnuntai;18;22;40;14;10;24
96;13.11.2011;2011;11;15;Sunnuntai;31;30;61;6;9;15
96;13.11.2011;2011;11;16;Sunnuntai;28;28;56;17;8;25
96;13.11.2011;2011;11;17;Sunnuntai;24;21;45;17;4;21
96;13.11.2011;2011;11;18;Sunnuntai;23;31;54;9;8;17
96;13.11.2011;2011;11;19;Sunnuntai;17;33;50;16;10;26
96;13.11.2011;2011;11;20;Sunnuntai;35;10;45;6;12;18
96;13.11.2011;2011;11;21;Sunnuntai;16;17;33;3;2;5
96;13.11.2011;2011;11;22;Sunnuntai;4;12;16;1;3;4
96;13.11.2011;2011;11;23;Sunnuntai;4;3;7;1;1;2
96;14.11.2011;2011;11;00;Maanantai;2;0;2;2;1;3
96;14.11.2011;2011;11;01;Maanantai;0;0;0;0;0;0
96;14.11.2011;2011;11;02;Maanantai;0;2;2;0;0;0
96;14.11.2011;2011;11;03;Maanantai;2;0;2;0;0;0
96;14.11.2011;2011;11;04;Maanantai;1;2;3;0;0;0
96;14.11.2011;2011;11;05;Maanantai;4;8;12;0;0;0
96;14.11.2011;2011;11;06;Maanantai;41;29;70;7;3;10
96;14.11.2011;2011;11;07;Maanantai;102;112;214;21;10;31
96;14.11.2011;2011;11;08;Maanantai;127;126;253;18;16;34
96;14.11.2011;2011;11;09;Maanantai;39;76;115;7;8;15
96;14.11.2011;2011;11;10;Maanantai;51;60;111;7;8;15
96;14.11.2011;2011;11;11;Maanantai;46;61;107;11;8;19
96;14.11.2011;2011;11;12;Maanantai;65;66;131;10;12;22
96;14.11.2011;2011;11;13;Maanantai;65;62;127;9;10;19
96;14.11.2011;2011;11;14;Maanantai;75;86;161;6;8;14
96;14.11.2011;2011;11;15;Maanantai;74;206;280;8;29;37
96;14.11.2011;2011;11;16;Maanantai;120;159;279;12;32;44
96;14.11.2011;2011;11;17;Maanantai;65;81;146;8;11;19
96;14.11.2011;2011;11;18;Maanantai;72;42;114;19;14;33
96;14.11.2011;2011;11;19;Maanantai;59;39;98;12;23;35
96;14.11.2011;2011;11;20;Maanantai;66;32;98;8;9;17
96;14.11.2011;2011;11;21;Maanantai;28;18;46;5;7;12
96;14.11.2011;2011;11;22;Maanantai;3;9;12;0;3;3
96;14.11.2011;2011;11;23;Maanantai;7;2;9;0;0;0
96;15.11.2011;2011;11;00;Tiistai;0;0;0;0;0;0
96;15.11.2011;2011;11;01;Tiistai;2;1;3;0;0;0
96;15.11.2011;2011;11;02;Tiistai;0;0;0;0;0;0
96;15.11.2011;2011;11;03;Tiistai;0;0;0;0;1;1
96;15.11.2011;2011;11;04;Tiistai;2;5;7;0;0;0
96;15.11.2011;2011;11;05;Tiistai;2;5;7;0;1;1
96;15.11.2011;2011;11;06;Tiistai;45;34;79;3;4;7
96;15.11.2011;2011;11;07;Tiistai;105;96;201;23;14;37
96;15.11.2011;2011;11;08;Tiistai;130;140;270;16;4;20
96;15.11.2011;2011;11;09;Tiistai;63;74;137;10;11;21
96;15.11.2011;2011;11;10;Tiistai;47;70;117;6;9;15
96;15.11.2011;2011;11;11;Tiistai;47;74;121;11;10;21
96;15.11.2011;2011;11;12;Tiistai;67;65;132;8;13;21
96;15.11.2011;2011;11;13;Tiistai;51;62;113;13;10;23
96;15.11.2011;2011;11;14;Tiistai;88;86;174;0;0;0
96;15.11.2011;2011;11;15;Tiistai;149;146;295;0;0;0
96;15.11.2011;2011;11;16;Tiistai;141;140;281;0;0;0
96;15.11.2011;2011;11;17;Tiistai;87;84;171;0;0;0
96;15.11.2011;2011;11;18;Tiistai;68;65;133;0;0;0
96;15.11.2011;2011;11;19;Tiistai;45;43;88;0;0;0
96;15.11.2011;2011;11;20;Tiistai;51;48;99;0;0;0
96;15.11.2011;2011;11;21;Tiistai;42;39;81;0;0;0
96;15.11.2011;2011;11;22;Tiistai;7;7;14;0;0;0
96;15.11.2011;2011;11;23;Tiistai;7;2;9;9;2;11
96;16.11.2011;2011;11;00;Keskiviikko;4;1;5;0;0;0
96;16.11.2011;2011;11;01;Keskiviikko;1;0;1;0;0;0
96;16.11.2011;2011;11;02;Keskiviikko;0;0;0;0;0;0
96;16.11.2011;2011;11;03;Keskiviikko;0;1;1;0;0;0
96;16.11.2011;2011;11;04;Keskiviikko;2;3;5;0;0;0
96;16.11.2011;2011;11;05;Keskiviikko;5;5;10;1;0;1
96;16.11.2011;2011;11;06;Keskiviikko;37;43;80;8;2;10
96;16.11.2011;2011;11;07;Keskiviikko;101;96;197;26;10;36
96;16.11.2011;2011;11;08;Keskiviikko;101;126;227;13;2;15
96;16.11.2011;2011;11;09;Keskiviikko;65;57;122;5;5;10
96;16.11.2011;2011;11;10;Keskiviikko;47;49;96;4;7;11
96;16.11.2011;2011;11;11;Keskiviikko;32;53;85;5;9;14
96;16.11.2011;2011;11;12;Keskiviikko;57;75;132;4;7;11
96;16.11.2011;2011;11;13;Keskiviikko;58;80;138;3;4;7
96;16.11.2011;2011;11;14;Keskiviikko;83;69;152;4;9;13
96;16.11.2011;2011;11;15;Keskiviikko;94;168;262;11;33;44
96;16.11.2011;2011;11;16;Keskiviikko;105;154;259;10;24;34
96;16.11.2011;2011;11;17;Keskiviikko;74;72;146;17;27;44
96;16.11.2011;2011;11;18;Keskiviikko;74;60;134;19;4;23
96;16.11.2011;2011;11;19;Keskiviikko;69;42;111;13;14;27
96;16.11.2011;2011;11;20;Keskiviikko;60;39;99;14;7;21
96;16.11.2011;2011;11;21;Keskiviikko;44;45;89;7;17;24
96;16.11.2011;2011;11;22;Keskiviikko;8;7;15;1;0;1
96;16.11.2011;2011;11;23;Keskiviikko;6;3;9;0;0;0
96;17.11.2011;2011;11;00;Torstai;4;2;6;1;0;1
96;17.11.2011;2011;11;01;Torstai;5;2;7;0;1;1
96;17.11.2011;2011;11;02;Torstai;1;2;3;0;0;0
96;17.11.2011;2011;11;03;Torstai;3;0;3;0;0;0
96;17.11.2011;2011;11;04;Torstai;3;4;7;0;0;0
96;17.11.2011;2011;11;05;Torstai;3;4;7;1;0;1
96;17.11.2011;2011;11;06;Torstai;38;26;64;5;2;7
96;17.11.2011;2011;11;07;Torstai;103;89;192;20;13;33
96;17.11.2011;2011;11;08;Torstai;118;127;245;16;11;27
96;17.11.2011;2011;11;09;Torstai;57;77;134;9;8;17
96;17.11.2011;2011;11;10;Torstai;43;73;116;8;8;16
96;17.11.2011;2011;11;11;Torstai;50;53;103;14;3;17
96;17.11.2011;2011;11;12;Torstai;62;60;122;7;7;14
96;17.11.2011;2011;11;13;Torstai;64;56;120;8;9;17
96;17.11.2011;2011;11;14;Torstai;67;98;165;9;11;20
96;17.11.2011;2011;11;15;Torstai;96;166;262;11;27;38
96;17.11.2011;2011;11;16;Torstai;96;153;249;11;39;50
96;17.11.2011;2011;11;17;Torstai;76;64;140;16;13;29
96;17.11.2011;2011;11;18;Torstai;54;47;101;16;12;28
96;17.11.2011;2011;11;19;Torstai;46;33;79;13;14;27
96;17.11.2011;2011;11;20;Torstai;47;28;75;13;6;19
96;17.11.2011;2011;11;21;Torstai;29;22;51;9;9;18
96;17.11.2011;2011;11;22;Torstai;10;9;19;3;3;6
96;17.11.2011;2011;11;23;Torstai;7;2;9;0;0;0
96;18.11.2011;2011;11;00;Perjantai;6;1;7;0;0;0
96;18.11.2011;2011;11;01;Perjantai;0;2;2;1;0;1
96;18.11.2011;2011;11;02;Perjantai;3;0;3;0;0;0
96;18.11.2011;2011;11;03;Perjantai;2;0;2;0;0;0
96;18.11.2011;2011;11;04;Perjantai;3;4;7;0;0;0
96;18.11.2011;2011;11;05;Perjantai;5;7;12;0;0;0
96;18.11.2011;2011;11;06;Perjantai;28;30;58;5;3;8
96;18.11.2011;2011;11;07;Perjantai;88;88;176;6;18;24
96;18.11.2011;2011;11;08;Perjantai;112;122;234;7;13;20
96;18.11.2011;2011;11;09;Perjantai;42;71;113;3;4;7
96;18.11.2011;2011;11;10;Perjantai;34;57;91;3;9;12
96;18.11.2011;2011;11;11;Perjantai;38;75;113;6;5;11
96;18.11.2011;2011;11;12;Perjantai;61;63;124;10;6;16
96;18.11.2011;2011;11;13;Perjantai;50;89;139;5;8;13
96;18.11.2011;2011;11;14;Perjantai;73;128;201;5;22;27
96;18.11.2011;2011;11;15;Perjantai;60;133;193;6;33;39
96;18.11.2011;2011;11;16;Perjantai;72;76;148;11;15;26
96;18.11.2011;2011;11;17;Perjantai;53;44;97;14;12;26
96;18.11.2011;2011;11;18;Perjantai;40;39;79;6;10;16
96;18.11.2011;2011;11;19;Perjantai;36;23;59;8;3;11
96;18.11.2011;2011;11;20;Perjantai;34;14;48;6;7;13
96;18.11.2011;2011;11;21;Perjantai;25;18;43;4;7;11
96;18.11.2011;2011;11;22;Perjantai;11;6;17;0;1;1
96;18.11.2011;2011;11;23;Perjantai;6;1;7;0;1;1
96;19.11.2011;2011;11;00;Lauantai;6;10;16;0;1;1
96;19.11.2011;2011;11;01;Lauantai;5;2;7;1;0;1
96;19.11.2011;2011;11;02;Lauantai;8;3;11;2;0;2
96;19.11.2011;2011;11;03;Lauantai;9;2;11;0;0;0
96;19.11.2011;2011;11;04;Lauantai;3;1;4;3;0;3
96;19.11.2011;2011;11;05;Lauantai;3;2;5;1;0;1
96;19.11.2011;2011;11;06;Lauantai;16;8;24;2;2;4
96;19.11.2011;2011;11;07;Lauantai;2;12;14;1;5;6
96;19.11.2011;2011;11;08;Lauantai;7;15;22;5;5;10
96;19.11.2011;2011;11;09;Lauantai;14;34;48;6;7;13
96;19.11.2011;2011;11;10;Lauantai;11;32;43;5;9;14
96;19.11.2011;2011;11;11;Lauantai;33;43;76;8;12;20
96;19.11.2011;2011;11;12;Lauantai;28;35;63;14;12;26
96;19.11.2011;2011;11;13;Lauantai;27;29;56;7;7;14
96;19.11.2011;2011;11;14;Lauantai;34;41;75;7;14;21
96;19.11.2011;2011;11;15;Lauantai;40;46;86;14;14;28
96;19.11.2011;2011;11;16;Lauantai;31;72;103;15;23;38
96;19.11.2011;2011;11;17;Lauantai;35;25;60;10;8;18
96;19.11.2011;2011;11;18;Lauantai;48;16;64;16;9;25
96;19.11.2011;2011;11;19;Lauantai;47;15;62;18;5;23
96;19.11.2011;2011;11;20;Lauantai;17;20;37;8;4;12
96;19.11.2011;2011;11;21;Lauantai;16;30;46;2;8;10
96;19.11.2011;2011;11;22;Lauantai;5;9;14;3;1;4
96;19.11.2011;2011;11;23;Lauantai;18;4;22;6;2;8
96;20.11.2011;2011;11;00;Sunnuntai;10;7;17;1;1;2
96;20.11.2011;2011;11;01;Sunnuntai;9;2;11;0;3;3
96;20.11.2011;2011;11;02;Sunnuntai;10;5;15;1;1;2
96;20.11.2011;2011;11;03;Sunnuntai;10;1;11;4;1;5
96;20.11.2011;2011;11;04;Sunnuntai;11;0;11;4;0;4
96;20.11.2011;2011;11;05;Sunnuntai;1;1;2;0;0;0
96;20.11.2011;2011;11;06;Sunnuntai;11;3;14;2;1;3
96;20.11.2011;2011;11;07;Sunnuntai;2;6;8;0;6;6
96;20.11.2011;2011;11;08;Sunnuntai;5;5;10;1;2;3
96;20.11.2011;2011;11;09;Sunnuntai;6;17;23;6;7;13
96;20.11.2011;2011;11;10;Sunnuntai;3;19;22;7;9;16
96;20.11.2011;2011;11;11;Sunnuntai;17;29;46;10;8;18
96;20.11.2011;2011;11;12;Sunnuntai;18;33;51;17;10;27
96;20.11.2011;2011;11;13;Sunnuntai;26;30;56;6;13;19
96;20.11.2011;2011;11;14;Sunnuntai;23;36;59;5;11;16
96;20.11.2011;2011;11;15;Sunnuntai;36;17;53;16;8;24
96;20.11.2011;2011;11;16;Sunnuntai;54;25;79;11;11;22
96;20.11.2011;2011;11;17;Sunnuntai;38;21;59;10;8;18
96;20.11.2011;2011;11;18;Sunnuntai;18;26;44;12;13;25
96;20.11.2011;2011;11;19;Sunnuntai;13;23;36;6;8;14
96;20.11.2011;2011;11;20;Sunnuntai;25;17;42;10;10;20
96;20.11.2011;2011;11;21;Sunnuntai;14;30;44;7;15;22
96;20.11.2011;2011;11;22;Sunnuntai;5;5;10;1;3;4
96;20.11.2011;2011;11;23;Sunnuntai;1;1;2;1;0;1
96;21.11.2011;2011;11;00;Maanantai;1;0;1;0;0;0
96;21.11.2011;2011;11;01;Maanantai;0;0;0;0;0;0
96;21.11.2011;2011;11;02;Maanantai;2;0;2;1;0;1
96;21.11.2011;2011;11;03;Maanantai;0;1;1;0;0;0
96;21.11.2011;2011;11;04;Maanantai;3;4;7;0;0;0
96;21.11.2011;2011;11;05;Maanantai;3;5;8;0;3;3
96;21.11.2011;2011;11;06;Maanantai;39;30;69;7;3;10
96;21.11.2011;2011;11;07;Maanantai;80;81;161;29;13;42
96;21.11.2011;2011;11;08;Maanantai;99;108;207;22;10;32
96;21.11.2011;2011;11;09;Maanantai;42;63;105;16;17;33
96;21.11.2011;2011;11;10;Maanantai;40;46;86;14;11;25
96;21.11.2011;2011;11;11;Maanantai;39;52;91;12;27;39
96;21.11.2011;2011;11;12;Maanantai;70;46;116;12;8;20
96;21.11.2011;2011;11;13;Maanantai;55;50;105;9;12;21
96;21.11.2011;2011;11;14;Maanantai;72;110;182;9;15;24
96;21.11.2011;2011;11;15;Maanantai;78;167;245;14;34;48
96;21.11.2011;2011;11;16;Maanantai;90;118;208;11;49;60
96;21.11.2011;2011;11;17;Maanantai;69;79;148;15;16;31
96;21.11.2011;2011;11;18;Maanantai;50;46;96;15;22;37
96;21.11.2011;2011;11;19;Maanantai;54;46;100;15;16;31
96;21.11.2011;2011;11;20;Maanantai;38;19;57;15;13;28
96;21.11.2011;2011;11;21;Maanantai;29;19;48;3;3;6
96;21.11.2011;2011;11;22;Maanantai;6;3;9;2;3;5
96;21.11.2011;2011;11;23;Maanantai;7;3;10;1;0;1
96;22.11.2011;2011;11;00;Tiistai;1;2;3;0;0;0
96;22.11.2011;2011;11;01;Tiistai;1;0;1;0;1;1
96;22.11.2011;2011;11;02;Tiistai;1;0;1;0;0;0
96;22.11.2011;2011;11;03;Tiistai;0;0;0;0;0;0
96;22.11.2011;2011;11;04;Tiistai;1;4;5;0;0;0
96;22.11.2011;2011;11;05;Tiistai;2;6;8;1;1;2
96;22.11.2011;2011;11;06;Tiistai;38;28;66;11;3;14
96;22.11.2011;2011;11;07;Tiistai;84;76;160;33;14;47
96;22.11.2011;2011;11;08;Tiistai;93;88;181;20;15;35
96;22.11.2011;2011;11;09;Tiistai;53;72;125;18;13;31
96;22.11.2011;2011;11;10;Tiistai;47;58;105;12;8;20
96;22.11.2011;2011;11;11;Tiistai;46;54;100;11;8;19
96;22.11.2011;2011;11;12;Tiistai;54;52;106;15;9;24
96;22.11.2011;2011;11;13;Tiistai;43;49;92;9;32;41
96;22.11.2011;2011;11;14;Tiistai;74;89;163;8;16;24
96;22.11.2011;2011;11;15;Tiistai;84;127;211;14;48;62
96;22.11.2011;2011;11;16;Tiistai;74;128;202;13;33;46
96;22.11.2011;2011;11;17;Tiistai;80;67;147;17;23;40
96;22.11.2011;2011;11;18;Tiistai;53;50;103;31;24;55
96;22.11.2011;2011;11;19;Tiistai;47;43;90;15;13;28
96;22.11.2011;2011;11;20;Tiistai;40;22;62;12;8;20
96;22.11.2011;2011;11;21;Tiistai;23;26;49;4;5;9
96;22.11.2011;2011;11;22;Tiistai;9;7;16;2;1;3
96;22.11.2011;2011;11;23;Tiistai;5;0;5;0;0;0
96;23.11.2011;2011;11;00;Keskiviikko;5;0;5;1;0;1
96;23.11.2011;2011;11;01;Keskiviikko;4;0;4;0;0;0
96;23.11.2011;2011;11;02;Keskiviikko;1;0;1;0;0;0
96;23.11.2011;2011;11;03;Keskiviikko;3;0;3;0;0;0
96;23.11.2011;2011;11;04;Keskiviikko;4;4;8;0;0;0
96;23.11.2011;2011;11;05;Keskiviikko;1;9;10;1;0;1
96;23.11.2011;2011;11;06;Keskiviikko;35;28;63;12;3;15
96;23.11.2011;2011;11;07;Keskiviikko;87;76;163;34;12;46
96;23.11.2011;2011;11;08;Keskiviikko;122;105;227;18;11;29
96;23.11.2011;2011;11;09;Keskiviikko;45;89;134;6;12;18
96;23.11.2011;2011;11;10;Keskiviikko;65;44;109;3;10;13
96;23.11.2011;2011;11;11;Keskiviikko;39;45;84;20;10;30
96;23.11.2011;2011;11;12;Keskiviikko;65;69;134;10;10;20
96;23.11.2011;2011;11;13;Keskiviikko;54;62;116;5;11;16
96;23.11.2011;2011;11;14;Keskiviikko;70;98;168;8;21;29
96;23.11.2011;2011;11;15;Keskiviikko;91;168;259;11;36;47
96;23.11.2011;2011;11;16;Keskiviikko;89;133;222;14;37;51
96;23.11.2011;2011;11;17;Keskiviikko;72;58;130;13;19;32
96;23.11.2011;2011;11;18;Keskiviikko;57;43;100;29;16;45
96;23.11.2011;2011;11;19;Keskiviikko;69;32;101;13;17;30
96;23.11.2011;2011;11;20;Keskiviikko;42;27;69;8;19;27
96;23.11.2011;2011;11;21;Keskiviikko;28;35;63;4;4;8
96;23.11.2011;2011;11;22;Keskiviikko;10;9;19;0;2;2
96;23.11.2011;2011;11;23;Keskiviikko;7;1;8;0;0;0
96;24.11.2011;2011;11;00;Torstai;7;1;8;1;0;1
96;24.11.2011;2011;11;01;Torstai;2;3;5;0;0;0
96;24.11.2011;2011;11;02;Torstai;0;0;0;1;0;1
96;24.11.2011;2011;11;03;Torstai;2;0;2;1;0;1
96;24.11.2011;2011;11;04;Torstai;4;4;8;0;0;0
96;24.11.2011;2011;11;05;Torstai;2;7;9;0;0;0
96;24.11.2011;2011;11;06;Torstai;30;19;49;4;4;8
96;24.11.2011;2011;11;07;Torstai;75;69;144;31;9;40
96;24.11.2011;2011;11;08;Torstai;96;61;157;10;7;17
96;24.11.2011;2011;11;09;Torstai;52;39;91;7;3;10
96;24.11.2011;2011;11;10;Torstai;44;49;93;9;9;18
96;24.11.2011;2011;11;11;Torstai;38;49;87;7;14;21
96;24.11.2011;2011;11;12;Torstai;56;68;124;12;13;25
96;24.11.2011;2011;11;13;Torstai;57;76;133;8;17;25
96;24.11.2011;2011;11;14;Torstai;73;101;174;4;14;18
96;24.11.2011;2011;11;15;Torstai;93;125;218;11;26;37
96;24.11.2011;2011;11;16;Torstai;73;135;208;10;30;40
96;24.11.2011;2011;11;17;Torstai;71;60;131;14;24;38
96;24.11.2011;2011;11;18;Torstai;53;49;102;15;9;24
96;24.11.2011;2011;11;19;Torstai;32;25;57;10;14;24
96;24.11.2011;2011;11;20;Torstai;39;22;61;8;10;18
96;24.11.2011;2011;11;21;Torstai;30;19;49;5;6;11
96;24.11.2011;2011;11;22;Torstai;20;6;26;1;2;3
96;24.11.2011;2011;11;23;Torstai;6;7;13;0;1;1
96;25.11.2011;2011;11;00;Perjantai;3;0;3;2;0;2
96;25.11.2011;2011;11;01;Perjantai;5;3;8;0;2;2
96;25.11.2011;2011;11;02;Perjantai;3;0;3;1;0;1
96;25.11.2011;2011;11;03;Perjantai;7;1;8;1;0;1
96;25.11.2011;2011;11;04;Perjantai;3;4;7;0;0;0
96;25.11.2011;2011;11;05;Perjantai;0;9;9;1;0;1
96;25.11.2011;2011;11;06;Perjantai;31;22;53;3;4;7
96;25.11.2011;2011;11;07;Perjantai;82;63;145;31;16;47
96;25.11.2011;2011;11;08;Perjantai;88;96;184;13;5;18
96;25.11.2011;2011;11;09;Perjantai;44;74;118;6;7;13
96;25.11.2011;2011;11;10;Perjantai;30;65;95;5;7;12
96;25.11.2011;2011;11;11;Perjantai;45;71;116;7;11;18
96;25.11.2011;2011;11;12;Perjantai;52;65;117;8;12;20
96;25.11.2011;2011;11;13;Perjantai;56;80;136;9;12;21
96;25.11.2011;2011;11;14;Perjantai;51;103;154;4;18;22
96;25.11.2011;2011;11;15;Perjantai;70;95;165;8;19;27
96;25.11.2011;2011;11;16;Perjantai;51;56;107;7;15;22
96;25.11.2011;2011;11;17;Perjantai;20;31;51;1;2;3
96;25.11.2011;2011;11;18;Perjantai;32;22;54;2;7;9
96;25.11.2011;2011;11;19;Perjantai;27;14;41;3;4;7
96;25.11.2011;2011;11;20;Perjantai;22;18;40;2;2;4
96;25.11.2011;2011;11;21;Perjantai;21;13;34;2;3;5
96;25.11.2011;2011;11;22;Perjantai;7;6;13;0;1;1
96;25.11.2011;2011;11;23;Perjantai;6;9;15;1;1;2
96;26.11.2011;2011;11;00;Lauantai;9;3;12;0;2;2
96;26.11.2011;2011;11;01;Lauantai;2;3;5;2;2;4
96;26.11.2011;2011;11;02;Lauantai;7;2;9;3;0;3
96;26.11.2011;2011;11;03;Lauantai;7;4;11;2;0;2
96;26.11.2011;2011;11;04;Lauantai;5;1;6;5;0;5
96;26.11.2011;2011;11;05;Lauantai;0;2;2;0;0;0
96;26.11.2011;2011;11;06;Lauantai;12;6;18;7;3;10
96;26.11.2011;2011;11;07;Lauantai;1;15;16;0;4;4
96;26.11.2011;2011;11;08;Lauantai;6;8;14;2;0;2
96;26.11.2011;2011;11;09;Lauantai;6;17;23;3;2;5
96;26.11.2011;2011;11;10;Lauantai;11;23;34;2;11;13
96;26.11.2011;2011;11;11;Lauantai;9;29;38;8;6;14
96;26.11.2011;2011;11;12;Lauantai;27;17;44;5;9;14
96;26.11.2011;2011;11;13;Lauantai;23;20;43;10;10;20
96;26.11.2011;2011;11;14;Lauantai;32;27;59;5;3;8
96;26.11.2011;2011;11;15;Lauantai;15;28;43;3;14;17
96;26.11.2011;2011;11;16;Lauantai;14;20;34;7;12;19
96;26.11.2011;2011;11;17;Lauantai;27;19;46;12;6;18
96;26.11.2011;2011;11;18;Lauantai;32;15;47;14;5;19
96;26.11.2011;2011;11;19;Lauantai;25;14;39;9;3;12
96;26.11.2011;2011;11;20;Lauantai;9;8;17;4;4;8
96;26.11.2011;2011;11;21;Lauantai;10;17;27;2;5;7
96;26.11.2011;2011;11;22;Lauantai;12;17;29;0;3;3
96;26.11.2011;2011;11;23;Lauantai;4;2;6;0;0;0
96;27.11.2011;2011;11;00;Sunnuntai;3;3;6;1;0;1
96;27.11.2011;2011;11;01;Sunnuntai;4;2;6;1;0;1
96;27.11.2011;2011;11;02;Sunnuntai;9;1;10;0;0;0
96;27.11.2011;2011;11;03;Sunnuntai;3;0;3;4;0;4
96;27.11.2011;2011;11;04;Sunnuntai;5;3;8;5;0;5
96;27.11.2011;2011;11;05;Sunnuntai;2;0;2;1;0;1
96;27.11.2011;2011;11;06;Sunnuntai;5;4;9;6;1;7
96;27.11.2011;2011;11;07;Sunnuntai;1;8;9;2;4;6
96;27.11.2011;2011;11;08;Sunnuntai;2;6;8;3;3;6
96;27.11.2011;2011;11;09;Sunnuntai;8;7;15;7;8;15
96;27.11.2011;2011;11;10;Sunnuntai;3;13;16;6;11;17
96;27.11.2011;2011;11;11;Sunnuntai;10;27;37;0;20;20
96;27.11.2011;2011;11;12;Sunnuntai;20;30;50;12;13;25
96;27.11.2011;2011;11;13;Sunnuntai;27;32;59;9;14;23
96;27.11.2011;2011;11;14;Sunnuntai;26;30;56;8;18;26
96;27.11.2011;2011;11;15;Sunnuntai;25;22;47;11;15;26
96;27.11.2011;2011;11;16;Sunnuntai;28;16;44;20;9;29
96;27.11.2011;2011;11;17;Sunnuntai;16;18;34;13;9;22
96;27.11.2011;2011;11;18;Sunnuntai;25;22;47;10;23;33
96;27.11.2011;2011;11;19;Sunnuntai;21;19;40;2;8;10
96;27.11.2011;2011;11;20;Sunnuntai;13;29;42;6;12;18
96;27.11.2011;2011;11;21;Sunnuntai;23;15;38;3;7;10
96;27.11.2011;2011;11;22;Sunnuntai;3;4;7;3;3;6
96;27.11.2011;2011;11;23;Sunnuntai;5;0;5;1;0;1
96;28.11.2011;2011;11;00;Maanantai;3;5;8;1;0;1
96;28.11.2011;2011;11;01;Maanantai;2;1;3;1;0;1
96;28.11.2011;2011;11;02;Maanantai;0;0;0;1;0;1
96;28.11.2011;2011;11;03;Maanantai;3;0;3;2;0;2
96;28.11.2011;2011;11;04;Maanantai;3;4;7;0;0;0
96;28.11.2011;2011;11;05;Maanantai;0;6;6;1;1;2
96;28.11.2011;2011;11;06;Maanantai;36;23;59;13;3;16
96;28.11.2011;2011;11;07;Maanantai;83;67;150;40;6;46
96;28.11.2011;2011;11;08;Maanantai;98;89;187;29;7;36
96;28.11.2011;2011;11;09;Maanantai;55;67;122;10;15;25
96;28.11.2011;2011;11;10;Maanantai;41;42;83;13;8;21
96;28.11.2011;2011;11;11;Maanantai;39;51;90;4;15;19
96;28.11.2011;2011;11;12;Maanantai;60;59;119;7;13;20
96;28.11.2011;2011;11;13;Maanantai;55;52;107;4;10;14
96;28.11.2011;2011;11;14;Maanantai;69;81;150;6;9;15
96;28.11.2011;2011;11;15;Maanantai;60;176;236;10;27;37
96;28.11.2011;2011;11;16;Maanantai;73;113;186;12;37;49
96;28.11.2011;2011;11;17;Maanantai;57;66;123;10;18;28
96;28.11.2011;2011;11;18;Maanantai;45;40;85;14;20;34
96;28.11.2011;2011;11;19;Maanantai;44;34;78;14;20;34
96;28.11.2011;2011;11;20;Maanantai;44;15;59;12;14;26
96;28.11.2011;2011;11;21;Maanantai;29;18;47;2;8;10
96;28.11.2011;2011;11;22;Maanantai;9;6;15;0;2;2
96;28.11.2011;2011;11;23;Maanantai;7;2;9;1;0;1
96;29.11.2011;2011;11;00;Tiistai;2;1;3;0;1;1
96;29.11.2011;2011;11;01;Tiistai;1;1;2;0;0;0
96;29.11.2011;2011;11;02;Tiistai;1;0;1;0;0;0
96;29.11.2011;2011;11;03;Tiistai;0;0;0;0;0;0
96;29.11.2011;2011;11;04;Tiistai;0;4;4;0;0;0
96;29.11.2011;2011;11;05;Tiistai;2;6;8;1;0;1
96;29.11.2011;2011;11;06;Tiistai;35;27;62;12;4;16
96;29.11.2011;2011;11;07;Tiistai;78;83;161;16;13;29
96;29.11.2011;2011;11;08;Tiistai;97;91;188;16;18;34
96;29.11.2011;2011;11;09;Tiistai;51;68;119;8;2;10
96;29.11.2011;2011;11;10;Tiistai;37;43;80;7;9;16
96;29.11.2011;2011;11;11;Tiistai;39;50;89;6;12;18
96;29.11.2011;2011;11;12;Tiistai;46;56;102;9;28;37
96;29.11.2011;2011;11;13;Tiistai;32;46;78;11;12;23
96;29.11.2011;2011;11;14;Tiistai;44;103;147;3;13;16
96;29.11.2011;2011;11;15;Tiistai;54;148;202;3;24;27
96;29.11.2011;2011;11;16;Tiistai;80;145;225;3;27;30
96;29.11.2011;2011;11;17;Tiistai;40;59;99;1;14;15
96;29.11.2011;2011;11;18;Tiistai;37;52;89;4;11;15
96;29.11.2011;2011;11;19;Tiistai;32;47;79;4;10;14
96;29.11.2011;2011;11;20;Tiistai;29;40;69;1;7;8
96;29.11.2011;2011;11;21;Tiistai;19;21;40;1;2;3
96;29.11.2011;2011;11;22;Tiistai;6;5;11;0;0;0
96;29.11.2011;2011;11;23;Tiistai;5;4;9;0;0;0
96;30.11.2011;2011;11;00;Keskiviikko;5;4;9;0;0;0
96;30.11.2011;2011;11;01;Keskiviikko;1;0;1;0;0;0
96;30.11.2011;2011;11;02;Keskiviikko;1;1;2;0;0;0
96;30.11.2011;2011;11;03;Keskiviikko;1;0;1;0;0;0
96;30.11.2011;2011;11;04;Keskiviikko;0;5;5;1;0;1
96;30.11.2011;2011;11;05;Keskiviikko;3;2;5;2;0;2
96;30.11.2011;2011;11;06;Keskiviikko;34;15;49;3;5;8
96;30.11.2011;2011;11;07;Keskiviikko;76;62;138;29;11;40
96;30.11.2011;2011;11;08;Keskiviikko;95;65;160;26;14;40
96;30.11.2011;2011;11;09;Keskiviikko;36;54;90;10;14;24
96;30.11.2011;2011;11;10;Keskiviikko;31;43;74;6;12;18
96;30.11.2011;2011;11;11;Keskiviikko;27;43;70;7;8;15
96;30.11.2011;2011;11;12;Keskiviikko;40;40;80;11;9;20
96;30.11.2011;2011;11;13;Keskiviikko;43;42;85;12;9;21
96;30.11.2011;2011;11;14;Keskiviikko;51;72;123;9;10;19
96;30.11.2011;2011;11;15;Keskiviikko;38;129;167;5;38;43
96;30.11.2011;2011;11;16;Keskiviikko;62;107;169;10;30;40
96;30.11.2011;2011;11;17;Keskiviikko;45;61;106;17;35;52
96;30.11.2011;2011;11;18;Keskiviikko;46;36;82;27;16;43
96;30.11.2011;2011;11;19;Keskiviikko;63;42;105;15;15;30
96;30.11.2011;2011;11;20;Keskiviikko;35;33;68;13;13;26
96;30.11.2011;2011;11;21;Keskiviikko;22;30;52;3;13;16
96;30.11.2011;2011;11;22;Keskiviikko;9;6;15;0;2;2
96;30.11.2011;2011;11;23;Keskiviikko;8;7;15;1;0;1
96;01.12.2011;2011;12;00;Torstai;3;1;4;0;0;0
96;01.12.2011;2011;12;01;Torstai;2;3;5;0;0;0
96;01.12.2011;2011;12;02;Torstai;1;0;1;0;0;0
96;01.12.2011;2011;12;03;Torstai;0;0;0;0;0;0
96;01.12.2011;2011;12;04;Torstai;1;2;3;1;0;1
96;01.12.2011;2011;12;05;Torstai;1;7;8;1;1;2
96;01.12.2011;2011;12;06;Torstai;34;21;55;10;3;13
96;01.12.2011;2011;12;07;Torstai;79;80;159;27;12;39
96;01.12.2011;2011;12;08;Torstai;91;96;187;16;13;29
96;01.12.2011;2011;12;09;Torstai;45;51;96;14;11;25
96;01.12.2011;2011;12;10;Torstai;41;49;90;8;10;18
96;01.12.2011;2011;12;11;Torstai;38;61;99;7;12;19
96;01.12.2011;2011;12;12;Torstai;50;74;124;12;10;22
96;01.12.2011;2011;12;13;Torstai;58;46;104;16;11;27
96;01.12.2011;2011;12;14;Torstai;67;80;147;11;17;28
96;01.12.2011;2011;12;15;Torstai;61;148;209;5;40;45
96;01.12.2011;2011;12;16;Torstai;96;94;190;4;27;31
96;01.12.2011;2011;12;17;Torstai;52;55;107;12;14;26
96;01.12.2011;2011;12;18;Torstai;45;56;101;18;12;30
96;01.12.2011;2011;12;19;Torstai;34;26;60;12;15;27
96;01.12.2011;2011;12;20;Torstai;44;30;74;13;10;23
96;01.12.2011;2011;12;21;Torstai;31;15;46;7;6;13
96;01.12.2011;2011;12;22;Torstai;19;9;28;1;2;3
96;01.12.2011;2011;12;23;Torstai;6;1;7;0;0;0
96;02.12.2011;2011;12;00;Perjantai;1;1;2;1;0;1
96;02.12.2011;2011;12;01;Perjantai;2;2;4;2;1;3
96;02.12.2011;2011;12;02;Perjantai;1;0;1;0;0;0
96;02.12.2011;2011;12;03;Perjantai;1;1;2;0;0;0
96;02.12.2011;2011;12;04;Perjantai;2;3;5;3;0;3
96;02.12.2011;2011;12;05;Perjantai;2;6;8;1;0;1
96;02.12.2011;2011;12;06;Perjantai;42;24;66;9;3;12
96;02.12.2011;2011;12;07;Perjantai;84;57;141;26;8;34
96;02.12.2011;2011;12;08;Perjantai;76;70;146;18;7;25
96;02.12.2011;2011;12;09;Perjantai;41;58;99;9;14;23
96;02.12.2011;2011;12;10;Perjantai;25;49;74;8;6;14
96;02.12.2011;2011;12;11;Perjantai;38;66;104;10;10;20
96;02.12.2011;2011;12;12;Perjantai;45;61;106;15;25;40
96;02.12.2011;2011;12;13;Perjantai;78;68;146;8;19;27
96;02.12.2011;2011;12;14;Perjantai;69;125;194;2;20;22
96;02.12.2011;2011;12;15;Perjantai;70;113;183;9;32;41
96;02.12.2011;2011;12;16;Perjantai;63;64;127;8;22;30
96;02.12.2011;2011;12;17;Perjantai;43;47;90;8;10;18
96;02.12.2011;2011;12;18;Perjantai;27;36;63;2;6;8
96;02.12.2011;2011;12;19;Perjantai;39;16;55;7;6;13
96;02.12.2011;2011;12;20;Perjantai;26;14;40;7;8;15
96;02.12.2011;2011;12;21;Perjantai;15;13;28;5;4;9
96;02.12.2011;2011;12;22;Perjantai;6;7;13;3;5;8
96;02.12.2011;2011;12;23;Perjantai;6;4;10;0;4;4
96;03.12.2011;2011;12;00;Lauantai;12;4;16;1;0;1
96;03.12.2011;2011;12;01;Lauantai;10;2;12;1;0;1
96;03.12.2011;2011;12;02;Lauantai;9;1;10;6;0;6
96;03.12.2011;2011;12;03;Lauantai;3;1;4;2;0;2
96;03.12.2011;2011;12;04;Lauantai;6;1;7;3;0;3
96;03.12.2011;2011;12;05;Lauantai;3;1;4;0;0;0
96;03.12.2011;2011;12;06;Lauantai;9;4;13;3;0;3
96;03.12.2011;2011;12;07;Lauantai;6;14;20;2;3;5
96;03.12.2011;2011;12;08;Lauantai;6;10;16;7;2;9
96;03.12.2011;2011;12;09;Lauantai;3;32;35;4;7;11
96;03.12.2011;2011;12;10;Lauantai;11;24;35;4;5;9
96;03.12.2011;2011;12;11;Lauantai;14;40;54;7;17;24
96;03.12.2011;2011;12;12;Lauantai;33;32;65;8;9;17
96;03.12.2011;2011;12;13;Lauantai;35;46;81;7;11;18
96;03.12.2011;2011;12;14;Lauantai;40;29;69;6;12;18
96;03.12.2011;2011;12;15;Lauantai;32;50;82;8;15;23
96;03.12.2011;2011;12;16;Lauantai;39;49;88;4;7;11
96;03.12.2011;2011;12;17;Lauantai;29;12;41;7;13;20
96;03.12.2011;2011;12;18;Lauantai;29;12;41;16;5;21
96;03.12.2011;2011;12;19;Lauantai;40;20;60;11;7;18
96;03.12.2011;2011;12;20;Lauantai;14;11;25;4;10;14
96;03.12.2011;2011;12;21;Lauantai;8;15;23;1;8;9
96;03.12.2011;2011;12;22;Lauantai;3;7;10;0;0;0
96;03.12.2011;2011;12;23;Lauantai;4;7;11;2;1;3
96;04.12.2011;2011;12;00;Sunnuntai;8;5;13;5;1;6
96;04.12.2011;2011;12;01;Sunnuntai;7;1;8;18;1;19
96;04.12.2011;2011;12;02;Sunnuntai;6;8;14;3;1;4
96;04.12.2011;2011;12;03;Sunnuntai;13;1;14;2;0;2
96;04.12.2011;2011;12;04;Sunnuntai;7;0;7;7;1;8
96;04.12.2011;2011;12;05;Sunnuntai;4;2;6;0;0;0
96;04.12.2011;2011;12;06;Sunnuntai;7;4;11;1;0;1
96;04.12.2011;2011;12;07;Sunnuntai;4;5;9;0;3;3
96;04.12.2011;2011;12;08;Sunnuntai;3;1;4;1;0;1
96;04.12.2011;2011;12;09;Sunnuntai;2;1;3;3;0;3
96;04.12.2011;2011;12;10;Sunnuntai;4;8;12;8;8;16
96;04.12.2011;2011;12;11;Sunnuntai;8;18;26;7;10;17
96;04.12.2011;2011;12;12;Sunnuntai;16;19;35;4;9;13
96;04.12.2011;2011;12;13;Sunnuntai;34;35;69;6;9;15
96;04.12.2011;2011;12;14;Sunnuntai;13;25;38;14;14;28
96;04.12.2011;2011;12;15;Sunnuntai;21;21;42;7;10;17
96;04.12.2011;2011;12;16;Sunnuntai;33;21;54;17;7;24
96;04.12.2011;2011;12;17;Sunnuntai;14;16;30;8;8;16
96;04.12.2011;2011;12;18;Sunnuntai;18;21;39;12;14;26
96;04.12.2011;2011;12;19;Sunnuntai;14;21;35;11;10;21
96;04.12.2011;2011;12;20;Sunnuntai;18;20;38;9;6;15
96;04.12.2011;2011;12;21;Sunnuntai;21;14;35;3;5;8
96;04.12.2011;2011;12;22;Sunnuntai;6;1;7;3;2;5
96;04.12.2011;2011;12;23;Sunnuntai;1;1;2;1;1;2
96;05.12.2011;2011;12;00;Maanantai;4;0;4;0;0;0
96;05.12.2011;2011;12;01;Maanantai;1;3;4;0;0;0
96;05.12.2011;2011;12;02;Maanantai;4;1;5;0;0;0
96;05.12.2011;2011;12;03;Maanantai;2;1;3;0;0;0
96;05.12.2011;2011;12;04;Maanantai;6;2;8;0;0;0
96;05.12.2011;2011;12;05;Maanantai;3;3;6;0;0;0
96;05.12.2011;2011;12;06;Maanantai;28;13;41;0;0;0
96;05.12.2011;2011;12;07;Maanantai;48;35;83;0;0;0
96;05.12.2011;2011;12;08;Maanantai;44;32;76;0;0;0
96;05.12.2011;2011;12;09;Maanantai;38;40;78;0;0;0
96;05.12.2011;2011;12;10;Maanantai;14;34;48;0;0;0
96;05.12.2011;2011;12;11;Maanantai;26;33;59;0;0;0
96;05.12.2011;2011;12;12;Maanantai;32;36;68;0;0;0
96;05.12.2011;2011;12;13;Maanantai;32;32;64;0;0;0
96;05.12.2011;2011;12;14;Maanantai;42;39;81;0;0;0
96;05.12.2011;2011;12;15;Maanantai;52;50;102;0;0;0
96;05.12.2011;2011;12;16;Maanantai;49;49;98;0;0;0
96;05.12.2011;2011;12;17;Maanantai;44;43;87;0;0;0
96;05.12.2011;2011;12;18;Maanantai;23;20;43;0;0;0
96;05.12.2011;2011;12;19;Maanantai;25;21;46;0;0;0
96;05.12.2011;2011;12;20;Maanantai;15;14;29;0;0;0
96;05.12.2011;2011;12;21;Maanantai;20;18;38;0;0;0
96;05.12.2011;2011;12;22;Maanantai;5;2;7;0;0;0
96;05.12.2011;2011;12;23;Maanantai;4;3;7;0;0;0
96;06.12.2011;2011;12;00;Tiistai;4;2;6;0;0;0
96;06.12.2011;2011;12;01;Tiistai;6;4;10;0;0;0
96;06.12.2011;2011;12;02;Tiistai;3;2;5;0;0;0
96;06.12.2011;2011;12;03;Tiistai;2;0;2;0;0;0
96;06.12.2011;2011;12;04;Tiistai;1;0;1;0;0;0
96;06.12.2011;2011;12;05;Tiistai;5;3;8;0;0;0
96;06.12.2011;2011;12;06;Tiistai;9;7;16;0;0;0
96;06.12.2011;2011;12;07;Tiistai;5;3;8;0;0;0
96;06.12.2011;2011;12;08;Tiistai;3;1;4;0;0;0
96;06.12.2011;2011;12;09;Tiistai;6;4;10;0;0;0
96;06.12.2011;2011;12;10;Tiistai;8;4;12;0;0;0
96;06.12.2011;2011;12;11;Tiistai;14;12;26;0;0;0
96;06.12.2011;2011;12;12;Tiistai;15;13;28;0;0;0
96;06.12.2011;2011;12;13;Tiistai;12;9;21;0;0;0
96;06.12.2011;2011;12;14;Tiistai;16;12;28;0;0;0
96;06.12.2011;2011;12;15;Tiistai;18;17;35;0;0;0
96;06.12.2011;2011;12;16;Tiistai;18;14;32;0;0;0
96;06.12.2011;2011;12;17;Tiistai;14;12;26;0;0;0
96;06.12.2011;2011;12;18;Tiistai;10;7;17;0;0;0
96;06.12.2011;2011;12;19;Tiistai;8;6;14;0;0;0
96;06.12.2011;2011;12;20;Tiistai;7;5;12;0;0;0
96;06.12.2011;2011;12;21;Tiistai;10;9;19;0;0;0
96;06.12.2011;2011;12;22;Tiistai;9;5;14;0;0;0
96;06.12.2011;2011;12;23;Tiistai;5;2;7;0;0;0
96;07.12.2011;2011;12;00;Keskiviikko;2;0;2;0;0;0
96;07.12.2011;2011;12;01;Keskiviikko;0;0;0;0;0;0
96;07.12.2011;2011;12;02;Keskiviikko;0;0;0;0;0;0
96;07.12.2011;2011;12;03;Keskiviikko;1;0;1;0;0;0
96;07.12.2011;2011;12;04;Keskiviikko;4;1;5;0;0;0
96;07.12.2011;2011;12;05;Keskiviikko;5;4;9;0;0;0
96;07.12.2011;2011;12;06;Keskiviikko;31;28;59;0;0;0
96;07.12.2011;2011;12;07;Keskiviikko;75;73;148;0;0;0
96;07.12.2011;2011;12;08;Keskiviikko;82;79;161;0;0;0
96;07.12.2011;2011;12;09;Keskiviikko;56;54;110;0;0;0
96;07.12.2011;2011;12;10;Keskiviikko;43;41;84;0;0;0
96;07.12.2011;2011;12;11;Keskiviikko;39;36;75;0;0;0
96;07.12.2011;2011;12;12;Keskiviikko;52;52;104;0;0;0
96;07.12.2011;2011;12;13;Keskiviikko;53;52;105;0;0;0
96;07.12.2011;2011;12;14;Keskiviikko;54;53;107;0;0;0
96;07.12.2011;2011;12;15;Keskiviikko;107;105;212;0;0;0
96;07.12.2011;2011;12;16;Keskiviikko;101;98;199;0;0;0
96;07.12.2011;2011;12;17;Keskiviikko;59;56;115;0;0;0
96;07.12.2011;2011;12;18;Keskiviikko;49;46;95;0;0;0
96;07.12.2011;2011;12;19;Keskiviikko;45;44;89;0;0;0
96;07.12.2011;2011;12;20;Keskiviikko;42;40;82;0;0;0
96;07.12.2011;2011;12;21;Keskiviikko;28;25;53;0;0;0
96;07.12.2011;2011;12;22;Keskiviikko;11;8;19;0;0;0
96;07.12.2011;2011;12;23;Keskiviikko;5;2;7;0;0;0
96;08.12.2011;2011;12;00;Torstai;3;0;3;0;0;0
96;08.12.2011;2011;12;01;Torstai;3;2;5;0;0;0
96;08.12.2011;2011;12;02;Torstai;2;0;2;0;0;0
96;08.12.2011;2011;12;03;Torstai;0;0;0;0;0;0
96;08.12.2011;2011;12;04;Torstai;4;2;6;0;0;0
96;08.12.2011;2011;12;05;Torstai;6;3;9;0;0;0
96;08.12.2011;2011;12;06;Torstai;27;24;51;0;0;0
96;08.12.2011;2011;12;07;Torstai;78;77;155;0;0;0
96;08.12.2011;2011;12;08;Torstai;100;99;199;0;0;0
96;08.12.2011;2011;12;09;Torstai;42;39;81;0;0;0
96;08.12.2011;2011;12;10;Torstai;28;26;54;0;0;0
96;08.12.2011;2011;12;11;Torstai;41;40;81;0;0;0
96;08.12.2011;2011;12;12;Torstai;38;37;75;0;0;0
96;08.12.2011;2011;12;13;Torstai;47;46;93;0;0;0
96;08.12.2011;2011;12;14;Torstai;59;57;116;0;0;0
96;08.12.2011;2011;12;15;Torstai;104;103;207;0;0;0
96;08.12.2011;2011;12;16;Torstai;90;89;179;0;0;0
96;08.12.2011;2011;12;17;Torstai;61;59;120;0;0;0
96;08.12.2011;2011;12;18;Torstai;41;39;80;0;0;0
96;08.12.2011;2011;12;19;Torstai;33;32;65;0;0;0
96;08.12.2011;2011;12;20;Torstai;25;24;49;0;0;0
96;08.12.2011;2011;12;21;Torstai;19;17;36;0;0;0
96;08.12.2011;2011;12;22;Torstai;9;8;17;0;0;0
96;08.12.2011;2011;12;23;Torstai;6;4;10;0;0;0
96;09.12.2011;2011;12;00;Perjantai;3;1;4;0;0;0
96;09.12.2011;2011;12;01;Perjantai;3;1;4;0;0;0
96;09.12.2011;2011;12;02;Perjantai;3;1;4;0;0;0
96;09.12.2011;2011;12;03;Perjantai;1;0;1;0;0;0
96;09.12.2011;2011;12;04;Perjantai;3;1;4;0;0;0
96;09.12.2011;2011;12;05;Perjantai;5;3;8;0;0;0
96;09.12.2011;2011;12;06;Perjantai;27;24;51;0;0;0
96;09.12.2011;2011;12;07;Perjantai;72;71;143;0;0;0
96;09.12.2011;2011;12;08;Perjantai;81;78;159;0;0;0
96;09.12.2011;2011;12;09;Perjantai;48;46;94;0;0;0
96;09.12.2011;2011;12;10;Perjantai;37;36;73;0;0;0
96;09.12.2011;2011;12;11;Perjantai;52;49;101;0;0;0
96;09.12.2011;2011;12;12;Perjantai;52;48;100;0;0;0
96;09.12.2011;2011;12;13;Perjantai;54;52;106;0;0;0
96;09.12.2011;2011;12;14;Perjantai;78;76;154;0;0;0
96;09.12.2011;2011;12;15;Perjantai;99;97;196;0;0;0
96;09.12.2011;2011;12;16;Perjantai;68;64;132;0;0;0
96;09.12.2011;2011;12;17;Perjantai;42;40;82;0;0;0
96;09.12.2011;2011;12;18;Perjantai;39;37;76;0;0;0
96;09.12.2011;2011;12;19;Perjantai;27;25;52;0;0;0
96;09.12.2011;2011;12;20;Perjantai;24;23;47;0;0;0
96;09.12.2011;2011;12;21;Perjantai;29;28;57;0;0;0
96;09.12.2011;2011;12;22;Perjantai;6;3;9;0;0;0
96;09.12.2011;2011;12;23;Perjantai;10;7;17;0;0;0
96;10.12.2011;2011;12;00;Lauantai;10;9;19;0;0;0
96;10.12.2011;2011;12;01;Lauantai;3;2;5;0;0;0
96;10.12.2011;2011;12;02;Lauantai;10;9;19;0;0;0
96;10.12.2011;2011;12;03;Lauantai;6;4;10;0;0;0
96;10.12.2011;2011;12;04;Lauantai;5;0;5;0;0;0
96;10.12.2011;2011;12;05;Lauantai;2;0;2;0;0;0
96;10.12.2011;2011;12;06;Lauantai;6;4;10;0;0;0
96;10.12.2011;2011;12;07;Lauantai;7;6;13;0;0;0
96;10.12.2011;2011;12;08;Lauantai;6;5;11;0;0;0
96;10.12.2011;2011;12;09;Lauantai;21;19;40;0;0;0
96;10.12.2011;2011;12;10;Lauantai;13;12;25;0;0;0
96;10.12.2011;2011;12;11;Lauantai;21;20;41;0;0;0
96;10.12.2011;2011;12;12;Lauantai;26;21;47;0;0;0
96;10.12.2011;2011;12;13;Lauantai;25;25;50;0;0;0
96;10.12.2011;2011;12;14;Lauantai;25;23;48;0;0;0
96;10.12.2011;2011;12;15;Lauantai;28;25;53;0;0;0
96;10.12.2011;2011;12;16;Lauantai;25;21;46;0;0;0
96;10.12.2011;2011;12;17;Lauantai;18;16;34;0;0;0
96;10.12.2011;2011;12;18;Lauantai;25;20;45;0;0;0
96;10.12.2011;2011;12;19;Lauantai;15;13;28;0;0;0
96;10.12.2011;2011;12;20;Lauantai;16;12;28;0;0;0
96;10.12.2011;2011;12;21;Lauantai;17;12;29;0;0;0
96;10.12.2011;2011;12;22;Lauantai;8;3;11;0;0;0
96;10.12.2011;2011;12;23;Lauantai;8;7;15;0;0;0
96;11.12.2011;2011;12;00;Sunnuntai;6;2;8;0;0;0
96;11.12.2011;2011;12;01;Sunnuntai;6;1;7;0;0;0
96;11.12.2011;2011;12;02;Sunnuntai;4;2;6;0;0;0
96;11.12.2011;2011;12;03;Sunnuntai;4;2;6;0;0;0
96;11.12.2011;2011;12;04;Sunnuntai;7;1;8;0;0;0
96;11.12.2011;2011;12;05;Sunnuntai;2;2;4;0;0;0
96;11.12.2011;2011;12;06;Sunnuntai;3;2;5;0;0;0
96;11.12.2011;2011;12;07;Sunnuntai;2;2;4;0;0;0
96;11.12.2011;2011;12;08;Sunnuntai;6;3;9;0;0;0
96;11.12.2011;2011;12;09;Sunnuntai;4;3;7;0;0;0
96;11.12.2011;2011;12;10;Sunnuntai;11;7;18;0;0;0
96;11.12.2011;2011;12;11;Sunnuntai;9;6;15;0;0;0
96;11.12.2011;2011;12;12;Sunnuntai;25;14;39;0;0;0
96;11.12.2011;2011;12;13;Sunnuntai;16;9;25;0;0;0
96;11.12.2011;2011;12;14;Sunnuntai;26;16;42;0;0;0
96;11.12.2011;2011;12;15;Sunnuntai;25;16;41;0;0;0
96;11.12.2011;2011;12;16;Sunnuntai;26;21;47;0;0;0
96;11.12.2011;2011;12;17;Sunnuntai;16;13;29;0;0;0
96;11.12.2011;2011;12;18;Sunnuntai;24;12;36;0;0;0
96;11.12.2011;2011;12;19;Sunnuntai;15;7;22;0;0;0
96;11.12.2011;2011;12;20;Sunnuntai;26;16;42;0;0;0
96;11.12.2011;2011;12;21;Sunnuntai;30;10;40;0;0;0
96;11.12.2011;2011;12;22;Sunnuntai;5;2;7;0;0;0
96;11.12.2011;2011;12;23;Sunnuntai;3;1;4;0;0;0
96;12.12.2011;2011;12;00;Maanantai;0;0;0;0;0;0
96;12.12.2011;2011;12;01;Maanantai;0;0;0;0;0;0
96;12.12.2011;2011;12;02;Maanantai;1;1;2;0;0;0
96;12.12.2011;2011;12;03;Maanantai;1;0;1;0;2;2
96;12.12.2011;2011;12;04;Maanantai;2;1;3;0;0;0
96;12.12.2011;2011;12;05;Maanantai;6;3;9;0;0;0
96;12.12.2011;2011;12;06;Maanantai;35;23;58;0;0;0
96;12.12.2011;2011;12;07;Maanantai;106;57;163;3;0;3
96;12.12.2011;2011;12;08;Maanantai;118;71;189;19;11;30
96;12.12.2011;2011;12;09;Maanantai;41;48;89;15;22;37
96;12.12.2011;2011;12;10;Maanantai;43;37;80;17;16;33
96;12.12.2011;2011;12;11;Maanantai;31;38;69;8;13;21
96;12.12.2011;2011;12;12;Maanantai;36;49;85;14;12;26
96;12.12.2011;2011;12;13;Maanantai;37;53;90;13;16;29
96;12.12.2011;2011;12;14;Maanantai;71;77;148;11;9;20
96;12.12.2011;2011;12;15;Maanantai;68;111;179;12;43;55
96;12.12.2011;2011;12;16;Maanantai;60;129;189;21;43;64
96;12.12.2011;2011;12;17;Maanantai;69;61;130;13;20;33
96;12.12.2011;2011;12;18;Maanantai;34;47;81;11;13;24
96;12.12.2011;2011;12;19;Maanantai;24;35;59;17;20;37
96;12.12.2011;2011;12;20;Maanantai;39;18;57;14;9;23
96;12.12.2011;2011;12;21;Maanantai;35;12;47;7;6;13
96;12.12.2011;2011;12;22;Maanantai;13;7;20;0;4;4
96;12.12.2011;2011;12;23;Maanantai;3;1;4;0;1;1
96;13.12.2011;2011;12;00;Tiistai;1;0;1;2;0;2
96;13.12.2011;2011;12;01;Tiistai;0;0;0;1;1;2
96;13.12.2011;2011;12;02;Tiistai;1;0;1;0;0;0
96;13.12.2011;2011;12;03;Tiistai;0;2;2;3;4;7
96;13.12.2011;2011;12;04;Tiistai;1;1;2;0;0;0
96;13.12.2011;2011;12;05;Tiistai;2;2;4;0;0;0
96;13.12.2011;2011;12;06;Tiistai;32;33;65;9;6;15
96;13.12.2011;2011;12;07;Tiistai;67;64;131;27;14;41
96;13.12.2011;2011;12;08;Tiistai;85;77;162;20;15;35
96;13.12.2011;2011;12;09;Tiistai;38;51;89;11;18;29
96;13.12.2011;2011;12;10;Tiistai;29;29;58;11;10;21
96;13.12.2011;2011;12;11;Tiistai;27;45;72;5;10;15
96;13.12.2011;2011;12;12;Tiistai;37;57;94;5;11;16
96;13.12.2011;2011;12;13;Tiistai;39;43;82;7;12;19
96;13.12.2011;2011;12;14;Tiistai;67;42;109;7;7;14
96;13.12.2011;2011;12;15;Tiistai;92;73;165;3;0;3
96;13.12.2011;2011;12;16;Tiistai;125;65;190;2;0;2
96;13.12.2011;2011;12;17;Tiistai;68;20;88;25;3;28
96;13.12.2011;2011;12;18;Tiistai;53;33;86;19;9;28
96;13.12.2011;2011;12;19;Tiistai;26;27;53;12;11;23
96;13.12.2011;2011;12;20;Tiistai;32;6;38;9;12;21
96;13.12.2011;2011;12;21;Tiistai;35;15;50;6;6;12
96;13.12.2011;2011;12;22;Tiistai;9;8;17;2;2;4
96;13.12.2011;2011;12;23;Tiistai;3;0;3;0;0;0
96;14.12.2011;2011;12;00;Keskiviikko;2;2;4;0;0;0
96;14.12.2011;2011;12;01;Keskiviikko;2;0;2;0;2;2
96;14.12.2011;2011;12;02;Keskiviikko;0;2;2;1;0;1
96;14.12.2011;2011;12;03;Keskiviikko;2;0;2;0;0;0
96;14.12.2011;2011;12;04;Keskiviikko;1;1;2;0;1;1
96;14.12.2011;2011;12;05;Keskiviikko;1;6;7;2;1;3
96;14.12.2011;2011;12;06;Keskiviikko;25;28;53;9;4;13
96;14.12.2011;2011;12;07;Keskiviikko;67;62;129;24;21;45
96;14.12.2011;2011;12;08;Keskiviikko;83;74;157;14;12;26
96;14.12.2011;2011;12;09;Keskiviikko;40;44;84;7;6;13
96;14.12.2011;2011;12;10;Keskiviikko;38;38;76;7;14;21
96;14.12.2011;2011;12;11;Keskiviikko;22;43;65;4;6;10
96;14.12.2011;2011;12;12;Keskiviikko;35;45;80;13;16;29
96;14.12.2011;2011;12;13;Keskiviikko;26;31;57;7;13;20
96;14.12.2011;2011;12;14;Keskiviikko;50;55;105;16;15;31
96;14.12.2011;2011;12;15;Keskiviikko;52;118;170;8;39;47
96;14.12.2011;2011;12;16;Keskiviikko;60;94;154;10;39;49
96;14.12.2011;2011;12;17;Keskiviikko;41;50;91;9;15;24
96;14.12.2011;2011;12;18;Keskiviikko;50;30;80;22;16;38
96;14.12.2011;2011;12;19;Keskiviikko;43;28;71;18;15;33
96;14.12.2011;2011;12;20;Keskiviikko;40;15;55;9;6;15
96;14.12.2011;2011;12;21;Keskiviikko;25;20;45;6;22;28
96;14.12.2011;2011;12;22;Keskiviikko;8;7;15;5;2;7
96;14.12.2011;2011;12;23;Keskiviikko;8;3;11;0;1;1
96;15.12.2011;2011;12;00;Torstai;1;2;3;0;0;0
96;15.12.2011;2011;12;01;Torstai;3;2;5;0;0;0
96;15.12.2011;2011;12;02;Torstai;2;0;2;0;0;0
96;15.12.2011;2011;12;03;Torstai;2;1;3;4;3;7
96;15.12.2011;2011;12;04;Torstai;2;1;3;0;0;0
96;15.12.2011;2011;12;05;Torstai;2;5;7;0;0;0
96;15.12.2011;2011;12;06;Torstai;26;19;45;9;5;14
96;15.12.2011;2011;12;07;Torstai;47;49;96;29;18;47
96;15.12.2011;2011;12;08;Torstai;85;58;143;25;15;40
96;15.12.2011;2011;12;09;Torstai;37;31;68;10;7;17
96;15.12.2011;2011;12;10;Torstai;29;30;59;13;14;27
96;15.12.2011;2011;12;11;Torstai;24;31;55;7;7;14
96;15.12.2011;2011;12;12;Torstai;31;57;88;11;16;27
96;15.12.2011;2011;12;13;Torstai;41;33;74;11;16;27
96;15.12.2011;2011;12;14;Torstai;43;52;95;16;18;34
96;15.12.2011;2011;12;15;Torstai;52;106;158;11;49;60
96;15.12.2011;2011;12;16;Torstai;59;68;127;14;22;36
96;15.12.2011;2011;12;17;Torstai;31;29;60;5;15;20
96;15.12.2011;2011;12;18;Torstai;29;21;50;12;14;26
96;15.12.2011;2011;12;19;Torstai;28;20;48;13;16;29
96;15.12.2011;2011;12;20;Torstai;25;8;33;11;8;19
96;15.12.2011;2011;12;21;Torstai;9;14;23;6;5;11
96;15.12.2011;2011;12;22;Torstai;8;9;17;0;1;1
96;15.12.2011;2011;12;23;Torstai;9;3;12;1;1;2
96;16.12.2011;2011;12;00;Perjantai;5;0;5;1;0;1
96;16.12.2011;2011;12;01;Perjantai;2;2;4;0;0;0
96;16.12.2011;2011;12;02;Perjantai;0;0;0;0;0;0
96;16.12.2011;2011;12;03;Perjantai;5;2;7;2;0;2
96;16.12.2011;2011;12;04;Perjantai;1;3;4;0;0;0
96;16.12.2011;2011;12;05;Perjantai;6;9;15;1;0;1
96;16.12.2011;2011;12;06;Perjantai;23;20;43;9;3;12
96;16.12.2011;2011;12;07;Perjantai;65;41;106;29;12;41
96;16.12.2011;2011;12;08;Perjantai;71;51;122;23;14;37
96;16.12.2011;2011;12;09;Perjantai;30;48;78;13;6;19
96;16.12.2011;2011;12;10;Perjantai;25;38;63;5;4;9
96;16.12.2011;2011;12;11;Perjantai;33;50;83;6;16;22
96;16.12.2011;2011;12;12;Perjantai;48;42;90;10;11;21
96;16.12.2011;2011;12;13;Perjantai;41;52;93;9;19;28
96;16.12.2011;2011;12;14;Perjantai;51;79;130;17;22;39
96;16.12.2011;2011;12;15;Perjantai;54;122;176;13;42;55
96;16.12.2011;2011;12;16;Perjantai;66;61;127;16;27;43
96;16.12.2011;2011;12;17;Perjantai;29;38;67;16;17;33
96;16.12.2011;2011;12;18;Perjantai;24;31;55;7;20;27
96;16.12.2011;2011;12;19;Perjantai;30;18;48;14;7;21
96;16.12.2011;2011;12;20;Perjantai;23;15;38;8;9;17
96;16.12.2011;2011;12;21;Perjantai;11;18;29;4;6;10
96;16.12.2011;2011;12;22;Perjantai;8;9;17;2;1;3
96;16.12.2011;2011;12;23;Perjantai;10;0;10;2;1;3
96;17.12.2011;2011;12;00;Lauantai;6;0;6;1;1;2
96;17.12.2011;2011;12;01;Lauantai;14;2;16;4;0;4
96;17.12.2011;2011;12;02;Lauantai;10;2;12;0;1;1
96;17.12.2011;2011;12;03;Lauantai;3;1;4;1;0;1
96;17.12.2011;2011;12;04;Lauantai;4;1;5;3;0;3
96;17.12.2011;2011;12;05;Lauantai;2;1;3;0;0;0
96;17.12.2011;2011;12;06;Lauantai;9;10;19;6;1;7
96;17.12.2011;2011;12;07;Lauantai;3;7;10;5;6;11
96;17.12.2011;2011;12;08;Lauantai;2;13;15;5;1;6
96;17.12.2011;2011;12;09;Lauantai;4;19;23;6;10;16
96;17.12.2011;2011;12;10;Lauantai;15;20;35;6;18;24
96;17.12.2011;2011;12;11;Lauantai;17;23;40;9;10;19
96;17.12.2011;2011;12;12;Lauantai;29;31;60;10;11;21
96;17.12.2011;2011;12;13;Lauantai;42;39;81;12;9;21
96;17.12.2011;2011;12;14;Lauantai;35;27;62;12;13;25
96;17.12.2011;2011;12;15;Lauantai;20;20;40;7;16;23
96;17.12.2011;2011;12;16;Lauantai;27;19;46;6;9;15
96;17.12.2011;2011;12;17;Lauantai;27;12;39;8;13;21
96;17.12.2011;2011;12;18;Lauantai;22;14;36;13;6;19
96;17.12.2011;2011;12;19;Lauantai;13;2;15;6;10;16
96;17.12.2011;2011;12;20;Lauantai;10;10;20;7;7;14
96;17.12.2011;2011;12;21;Lauantai;7;13;20;3;9;12
96;17.12.2011;2011;12;22;Lauantai;6;15;21;2;6;8
96;17.12.2011;2011;12;23;Lauantai;1;4;5;0;2;2
96;18.12.2011;2011;12;00;Sunnuntai;5;2;7;3;0;3
96;18.12.2011;2011;12;01;Sunnuntai;5;1;6;1;1;2
96;18.12.2011;2011;12;02;Sunnuntai;10;2;12;2;1;3
96;18.12.2011;2011;12;03;Sunnuntai;6;0;6;0;0;0
96;18.12.2011;2011;12;04;Sunnuntai;5;0;5;7;0;7
96;18.12.2011;2011;12;05;Sunnuntai;0;0;0;0;0;0
96;18.12.2011;2011;12;06;Sunnuntai;8;8;16;5;0;5
96;18.12.2011;2011;12;07;Sunnuntai;2;1;3;2;4;6
96;18.12.2011;2011;12;08;Sunnuntai;1;5;6;3;2;5
96;18.12.2011;2011;12;09;Sunnuntai;3;9;12;2;4;6
96;18.12.2011;2011;12;10;Sunnuntai;3;10;13;9;7;16
96;18.12.2011;2011;12;11;Sunnuntai;9;12;21;11;17;28
96;18.12.2011;2011;12;12;Sunnuntai;6;11;17;11;11;22
96;18.12.2011;2011;12;13;Sunnuntai;20;17;37;5;12;17
96;18.12.2011;2011;12;14;Sunnuntai;14;13;27;7;11;18
96;18.12.2011;2011;12;15;Sunnuntai;9;17;26;5;5;10
96;18.12.2011;2011;12;16;Sunnuntai;26;9;35;16;7;23
96;18.12.2011;2011;12;17;Sunnuntai;13;8;21;11;5;16
96;18.12.2011;2011;12;18;Sunnuntai;18;15;33;10;8;18
96;18.12.2011;2011;12;19;Sunnuntai;6;16;22;6;10;16
96;18.12.2011;2011;12;20;Sunnuntai;19;6;25;8;14;22
96;18.12.2011;2011;12;21;Sunnuntai;9;7;16;3;5;8
96;18.12.2011;2011;12;22;Sunnuntai;6;7;13;0;3;3
96;18.12.2011;2011;12;23;Sunnuntai;2;3;5;0;0;0
96;19.12.2011;2011;12;00;Maanantai;0;0;0;2;0;2
96;19.12.2011;2011;12;01;Maanantai;0;1;1;0;1;1
96;19.12.2011;2011;12;02;Maanantai;2;0;2;0;0;0
96;19.12.2011;2011;12;03;Maanantai;2;1;3;0;0;0
96;19.12.2011;2011;12;04;Maanantai;2;5;7;3;4;7
96;19.12.2011;2011;12;05;Maanantai;5;5;10;1;0;1
96;19.12.2011;2011;12;06;Maanantai;22;24;46;9;2;11
96;19.12.2011;2011;12;07;Maanantai;58;53;111;34;12;46
96;19.12.2011;2011;12;08;Maanantai;69;63;132;22;15;37
96;19.12.2011;2011;12;09;Maanantai;46;47;93;11;8;19
96;19.12.2011;2011;12;10;Maanantai;28;29;57;10;17;27
96;19.12.2011;2011;12;11;Maanantai;22;38;60;16;8;24
96;19.12.2011;2011;12;12;Maanantai;35;47;82;13;10;23
96;19.12.2011;2011;12;13;Maanantai;47;49;96;11;18;29
96;19.12.2011;2011;12;14;Maanantai;51;57;108;10;13;23
96;19.12.2011;2011;12;15;Maanantai;53;111;164;8;39;47
96;19.12.2011;2011;12;16;Maanantai;60;78;138;9;39;48
96;19.12.2011;2011;12;17;Maanantai;57;38;95;15;14;29
96;19.12.2011;2011;12;18;Maanantai;32;26;58;6;12;18
96;19.12.2011;2011;12;19;Maanantai;35;20;55;16;13;29
96;19.12.2011;2011;12;20;Maanantai;29;5;34;12;10;22
96;19.12.2011;2011;12;21;Maanantai;17;8;25;5;10;15
96;19.12.2011;2011;12;22;Maanantai;4;5;9;2;0;2
96;19.12.2011;2011;12;23;Maanantai;2;1;3;0;0;0
96;20.12.2011;2011;12;00;Tiistai;2;0;2;0;1;1
96;20.12.2011;2011;12;01;Tiistai;2;2;4;0;0;0
96;20.12.2011;2011;12;02;Tiistai;3;0;3;0;0;0
96;20.12.2011;2011;12;03;Tiistai;5;1;6;0;2;2
96;20.12.2011;2011;12;04;Tiistai;1;5;6;1;1;2
96;20.12.2011;2011;12;05;Tiistai;5;7;12;0;0;0
96;20.12.2011;2011;12;06;Tiistai;23;23;46;12;6;18
96;20.12.2011;2011;12;07;Tiistai;63;50;113;29;21;50
96;20.12.2011;2011;12;08;Tiistai;52;81;133;19;8;27
96;20.12.2011;2011;12;09;Tiistai;35;59;94;10;12;22
96;20.12.2011;2011;12;10;Tiistai;26;35;61;11;12;23
96;20.12.2011;2011;12;11;Tiistai;32;39;71;11;7;18
96;20.12.2011;2011;12;12;Tiistai;33;37;70;8;16;24
96;20.12.2011;2011;12;13;Tiistai;37;44;81;8;14;22
96;20.12.2011;2011;12;14;Tiistai;37;71;108;15;23;38
96;20.12.2011;2011;12;15;Tiistai;44;77;121;9;35;44
96;20.12.2011;2011;12;16;Tiistai;66;84;150;7;29;36
96;20.12.2011;2011;12;17;Tiistai;52;35;87;13;17;30
96;20.12.2011;2011;12;18;Tiistai;36;22;58;9;8;17
96;20.12.2011;2011;12;19;Tiistai;24;25;49;12;6;18
96;20.12.2011;2011;12;20;Tiistai;28;19;47;11;11;22
96;20.12.2011;2011;12;21;Tiistai;20;12;32;5;11;16
96;20.12.2011;2011;12;22;Tiistai;8;7;15;1;3;4
96;20.12.2011;2011;12;23;Tiistai;6;9;15;0;0;0
96;21.12.2011;2011;12;00;Keskiviikko;2;1;3;0;0;0
96;21.12.2011;2011;12;01;Keskiviikko;1;1;2;0;0;0
96;21.12.2011;2011;12;02;Keskiviikko;3;0;3;1;0;1
96;21.12.2011;2011;12;03;Keskiviikko;0;0;0;0;0;0
96;21.12.2011;2011;12;04;Keskiviikko;1;7;8;0;0;0
96;21.12.2011;2011;12;05;Keskiviikko;4;5;9;1;0;1
96;21.12.2011;2011;12;06;Keskiviikko;25;22;47;7;5;12
96;21.12.2011;2011;12;07;Keskiviikko;51;52;103;31;15;46
96;21.12.2011;2011;12;08;Keskiviikko;50;65;115;16;7;23
96;21.12.2011;2011;12;09;Keskiviikko;20;55;75;7;16;23
96;21.12.2011;2011;12;10;Keskiviikko;26;37;63;10;12;22
96;21.12.2011;2011;12;11;Keskiviikko;26;42;68;5;17;22
96;21.12.2011;2011;12;12;Keskiviikko;49;48;97;7;10;17
96;21.12.2011;2011;12;13;Keskiviikko;30;43;73;9;14;23
96;21.12.2011;2011;12;14;Keskiviikko;32;59;91;9;23;32
96;21.12.2011;2011;12;15;Keskiviikko;55;105;160;6;39;45
96;21.12.2011;2011;12;16;Keskiviikko;65;70;135;16;26;42
96;21.12.2011;2011;12;17;Keskiviikko;49;37;86;12;10;22
96;21.12.2011;2011;12;18;Keskiviikko;28;33;61;18;11;29
96;21.12.2011;2011;12;19;Keskiviikko;28;18;46;10;15;25
96;21.12.2011;2011;12;20;Keskiviikko;28;20;48;4;14;18
96;21.12.2011;2011;12;21;Keskiviikko;21;15;36;3;13;16
96;21.12.2011;2011;12;22;Keskiviikko;8;6;14;2;0;2
96;21.12.2011;2011;12;23;Keskiviikko;5;3;8;0;1;1
96;22.12.2011;2011;12;00;Torstai;5;0;5;1;0;1
96;22.12.2011;2011;12;01;Torstai;1;0;1;2;0;2
96;22.12.2011;2011;12;02;Torstai;8;1;9;1;0;1
96;22.12.2011;2011;12;03;Torstai;1;0;1;0;3;3
96;22.12.2011;2011;12;04;Torstai;3;5;8;0;0;0
96;22.12.2011;2011;12;05;Torstai;3;7;10;0;0;0
96;22.12.2011;2011;12;06;Torstai;23;14;37;11;3;14
96;22.12.2011;2011;12;07;Torstai;33;50;83;20;9;29
96;22.12.2011;2011;12;08;Torstai;36;48;84;13;8;21
96;22.12.2011;2011;12;09;Torstai;15;45;60;6;6;12
96;22.12.2011;2011;12;10;Torstai;25;35;60;4;10;14
96;22.12.2011;2011;12;11;Torstai;33;27;60;6;10;16
96;22.12.2011;2011;12;12;Torstai;28;35;63;9;15;24
96;22.12.2011;2011;12;13;Torstai;22;36;58;6;12;18
96;22.12.2011;2011;12;14;Torstai;42;63;105;3;19;22
96;22.12.2011;2011;12;15;Torstai;40;79;119;14;35;49
96;22.12.2011;2011;12;16;Torstai;37;45;82;15;28;43
96;22.12.2011;2011;12;17;Torstai;38;17;55;9;18;27
96;22.12.2011;2011;12;18;Torstai;21;27;48;6;9;15
96;22.12.2011;2011;12;19;Torstai;17;12;29;11;6;17
96;22.12.2011;2011;12;20;Torstai;23;16;39;3;5;8
96;22.12.2011;2011;12;21;Torstai;9;7;16;5;7;12
96;22.12.2011;2011;12;22;Torstai;9;3;12;2;3;5
96;22.12.2011;2011;12;23;Torstai;2;0;2;1;0;1
96;23.12.2011;2011;12;00;Perjantai;2;0;2;0;0;0
96;23.12.2011;2011;12;01;Perjantai;1;0;1;0;0;0
96;23.12.2011;2011;12;02;Perjantai;0;1;1;2;0;2
96;23.12.2011;2011;12;03;Perjantai;2;0;2;0;0;0
96;23.12.2011;2011;12;04;Perjantai;3;3;6;0;0;0
96;23.12.2011;2011;12;05;Perjantai;0;5;5;0;1;1
96;23.12.2011;2011;12;06;Perjantai;17;13;30;7;3;10
96;23.12.2011;2011;12;07;Perjantai;39;27;66;16;5;21
96;23.12.2011;2011;12;08;Perjantai;23;28;51;8;8;16
96;23.12.2011;2011;12;09;Perjantai;11;19;30;5;8;13
96;23.12.2011;2011;12;10;Perjantai;7;35;42;0;10;10
96;23.12.2011;2011;12;11;Perjantai;17;25;42;4;8;12
96;23.12.2011;2011;12;12;Perjantai;17;26;43;6;8;14
96;23.12.2011;2011;12;13;Perjantai;28;34;62;9;14;23
96;23.12.2011;2011;12;14;Perjantai;30;44;74;3;11;14
96;23.12.2011;2011;12;15;Perjantai;32;44;76;4;15;19
96;23.12.2011;2011;12;16;Perjantai;33;19;52;1;12;13
96;23.12.2011;2011;12;17;Perjantai;23;9;32;8;4;12
96;23.12.2011;2011;12;18;Perjantai;13;8;21;3;2;5
96;23.12.2011;2011;12;19;Perjantai;10;3;13;1;0;1
96;23.12.2011;2011;12;20;Perjantai;4;4;8;0;0;0
96;23.12.2011;2011;12;21;Perjantai;6;2;8;0;0;0
96;23.12.2011;2011;12;22;Perjantai;4;0;4;0;0;0
96;23.12.2011;2011;12;23;Perjantai;3;2;5;0;0;0
96;24.12.2011;2011;12;00;Lauantai;1;0;1;0;0;0
96;24.12.2011;2011;12;01;Lauantai;2;0;2;0;0;0
96;24.12.2011;2011;12;02;Lauantai;1;0;1;0;0;0
96;24.12.2011;2011;12;03;Lauantai;2;0;2;3;0;3
96;24.12.2011;2011;12;04;Lauantai;0;0;0;0;0;0
96;24.12.2011;2011;12;05;Lauantai;0;1;1;0;0;0
96;24.12.2011;2011;12;06;Lauantai;4;4;8;1;1;2
96;24.12.2011;2011;12;07;Lauantai;2;4;6;0;3;3
96;24.12.2011;2011;12;08;Lauantai;11;9;20;2;2;4
96;24.12.2011;2011;12;09;Lauantai;5;9;14;3;3;6
96;24.12.2011;2011;12;10;Lauantai;12;8;20;1;5;6
96;24.12.2011;2011;12;11;Lauantai;9;6;15;2;5;7
96;24.12.2011;2011;12;12;Lauantai;15;7;22;3;4;7
96;24.12.2011;2011;12;13;Lauantai;9;0;9;6;1;7
96;24.12.2011;2011;12;14;Lauantai;10;8;18;2;3;5
96;24.12.2011;2011;12;15;Lauantai;4;7;11;2;4;6
96;24.12.2011;2011;12;16;Lauantai;0;6;6;2;1;3
96;24.12.2011;2011;12;17;Lauantai;1;4;5;2;1;3
96;24.12.2011;2011;12;18;Lauantai;2;3;5;1;3;4
96;24.12.2011;2011;12;19;Lauantai;3;2;5;0;3;3
96;24.12.2011;2011;12;20;Lauantai;2;4;6;2;5;7
96;24.12.2011;2011;12;21;Lauantai;0;7;7;2;3;5
96;24.12.2011;2011;12;22;Lauantai;5;0;5;0;2;2
96;24.12.2011;2011;12;23;Lauantai;0;0;0;0;2;2
96;25.12.2011;2011;12;00;Sunnuntai;0;0;0;0;0;0
96;25.12.2011;2011;12;01;Sunnuntai;0;1;1;1;0;1
96;25.12.2011;2011;12;02;Sunnuntai;2;0;2;0;0;0
96;25.12.2011;2011;12;03;Sunnuntai;0;0;0;1;0;1
96;25.12.2011;2011;12;04;Sunnuntai;0;0;0;0;1;1
96;25.12.2011;2011;12;05;Sunnuntai;0;0;0;1;0;1
96;25.12.2011;2011;12;06;Sunnuntai;4;1;5;1;0;1
96;25.12.2011;2011;12;07;Sunnuntai;1;3;4;2;1;3
96;25.12.2011;2011;12;08;Sunnuntai;3;3;6;0;0;0
96;25.12.2011;2011;12;09;Sunnuntai;5;0;5;1;2;3
96;25.12.2011;2011;12;10;Sunnuntai;1;1;2;7;7;14
96;25.12.2011;2011;12;11;Sunnuntai;2;3;5;3;6;9
96;25.12.2011;2011;12;12;Sunnuntai;3;3;6;4;4;8
96;25.12.2011;2011;12;13;Sunnuntai;1;5;6;7;6;13
96;25.12.2011;2011;12;14;Sunnuntai;0;2;2;6;2;8
96;25.12.2011;2011;12;15;Sunnuntai;4;5;9;6;2;8
96;25.12.2011;2011;12;16;Sunnuntai;5;3;8;8;5;13
96;25.12.2011;2011;12;17;Sunnuntai;5;8;13;3;6;9
96;25.12.2011;2011;12;18;Sunnuntai;6;6;12;6;6;12
96;25.12.2011;2011;12;19;Sunnuntai;2;6;8;1;9;10
96;25.12.2011;2011;12;20;Sunnuntai;4;2;6;5;9;14
96;25.12.2011;2011;12;21;Sunnuntai;5;5;10;0;3;3
96;25.12.2011;2011;12;22;Sunnuntai;2;1;3;0;3;3
96;25.12.2011;2011;12;23;Sunnuntai;1;3;4;1;0;1
96;26.12.2011;2011;12;00;Maanantai;0;1;1;1;1;2
96;26.12.2011;2011;12;01;Maanantai;3;0;3;0;0;0
96;26.12.2011;2011;12;02;Maanantai;1;0;1;0;0;0
96;26.12.2011;2011;12;03;Maanantai;1;0;1;1;1;2
96;26.12.2011;2011;12;04;Maanantai;2;0;2;2;1;3
96;26.12.2011;2011;12;05;Maanantai;1;0;1;1;0;1
96;26.12.2011;2011;12;06;Maanantai;4;4;8;3;0;3
96;26.12.2011;2011;12;07;Maanantai;0;5;5;0;3;3
96;26.12.2011;2011;12;08;Maanantai;4;3;7;3;1;4
96;26.12.2011;2011;12;09;Maanantai;2;3;5;4;6;10
96;26.12.2011;2011;12;10;Maanantai;3;5;8;4;5;9
96;26.12.2011;2011;12;11;Maanantai;0;0;0;8;3;11
96;26.12.2011;2011;12;12;Maanantai;5;1;6;5;11;16
96;26.12.2011;2011;12;13;Maanantai;16;7;23;13;7;20
96;26.12.2011;2011;12;14;Maanantai;4;10;14;12;11;23
96;26.12.2011;2011;12;15;Maanantai;7;15;22;8;8;16
96;26.12.2011;2011;12;16;Maanantai;8;6;14;6;6;12
96;26.12.2011;2011;12;17;Maanantai;6;8;14;6;8;14
96;26.12.2011;2011;12;18;Maanantai;5;3;8;5;5;10
96;26.12.2011;2011;12;19;Maanantai;5;7;12;8;6;14
96;26.12.2011;2011;12;20;Maanantai;5;6;11;4;5;9
96;26.12.2011;2011;12;21;Maanantai;2;10;12;6;6;12
96;26.12.2011;2011;12;22;Maanantai;0;3;3;1;4;5
96;26.12.2011;2011;12;23;Maanantai;1;4;5;3;1;4
96;27.12.2011;2011;12;00;Tiistai;2;0;2;0;0;0
96;27.12.2011;2011;12;01;Tiistai;4;0;4;3;0;3
96;27.12.2011;2011;12;02;Tiistai;1;1;2;0;0;0
96;27.12.2011;2011;12;03;Tiistai;4;0;4;1;0;1
96;27.12.2011;2011;12;04;Tiistai;2;2;4;1;0;1
96;27.12.2011;2011;12;05;Tiistai;1;0;1;1;0;1
96;27.12.2011;2011;12;06;Tiistai;16;7;23;9;3;12
96;27.12.2011;2011;12;07;Tiistai;38;24;62;11;10;21
96;27.12.2011;2011;12;08;Tiistai;8;16;24;4;7;11
96;27.12.2011;2011;12;09;Tiistai;8;8;16;2;5;7
96;27.12.2011;2011;12;10;Tiistai;2;19;21;6;3;9
96;27.12.2011;2011;12;11;Tiistai;8;4;12;4;4;8
96;27.12.2011;2011;12;12;Tiistai;12;10;22;6;4;10
96;27.12.2011;2011;12;13;Tiistai;9;6;15;4;12;16
96;27.12.2011;2011;12;14;Tiistai;16;23;39;2;10;12
96;27.12.2011;2011;12;15;Tiistai;19;39;58;9;25;34
96;27.12.2011;2011;12;16;Tiistai;23;25;48;14;18;32
96;27.12.2011;2011;12;17;Tiistai;16;15;31;7;13;20
96;27.12.2011;2011;12;18;Tiistai;8;16;24;8;15;23
96;27.12.2011;2011;12;19;Tiistai;13;5;18;11;3;14
96;27.12.2011;2011;12;20;Tiistai;26;6;32;16;13;29
96;27.12.2011;2011;12;21;Tiistai;13;7;20;9;8;17
96;27.12.2011;2011;12;22;Tiistai;5;0;5;1;0;1
96;27.12.2011;2011;12;23;Tiistai;0;3;3;1;1;2
96;28.12.2011;2011;12;00;Keskiviikko;2;0;2;0;0;0
96;28.12.2011;2011;12;01;Keskiviikko;3;0;3;0;0;0
96;28.12.2011;2011;12;02;Keskiviikko;2;0;2;1;0;1
96;28.12.2011;2011;12;03;Keskiviikko;0;0;0;0;1;1
96;28.12.2011;2011;12;04;Keskiviikko;3;1;4;1;0;1
96;28.12.2011;2011;12;05;Keskiviikko;3;1;4;1;0;1
96;28.12.2011;2011;12;06;Keskiviikko;8;10;18;10;1;11
96;28.12.2011;2011;12;07;Keskiviikko;37;19;56;16;11;27
96;28.12.2011;2011;12;08;Keskiviikko;10;19;29;11;14;25
96;28.12.2011;2011;12;09;Keskiviikko;14;13;27;9;11;20
96;28.12.2011;2011;12;10;Keskiviikko;7;22;29;6;14;20
96;28.12.2011;2011;12;11;Keskiviikko;13;15;28;8;10;18
96;28.12.2011;2011;12;12;Keskiviikko;26;21;47;7;5;12
96;28.12.2011;2011;12;13;Keskiviikko;27;17;44;13;15;28
96;28.12.2011;2011;12;14;Keskiviikko;27;23;50;14;13;27
96;28.12.2011;2011;12;15;Keskiviikko;21;45;66;15;30;45
96;28.12.2011;2011;12;16;Keskiviikko;23;39;62;20;31;51
96;28.12.2011;2011;12;17;Keskiviikko;24;19;43;14;15;29
96;28.12.2011;2011;12;18;Keskiviikko;21;13;34;13;9;22
96;28.12.2011;2011;12;19;Keskiviikko;19;11;30;12;10;22
96;28.12.2011;2011;12;20;Keskiviikko;28;8;36;10;16;26
96;28.12.2011;2011;12;21;Keskiviikko;11;8;19;5;6;11
96;28.12.2011;2011;12;22;Keskiviikko;13;4;17;2;3;5
96;28.12.2011;2011;12;23;Keskiviikko;2;1;3;0;0;0
96;29.12.2011;2011;12;00;Torstai;0;1;1;1;1;2
96;29.12.2011;2011;12;01;Torstai;1;1;2;0;2;2
96;29.12.2011;2011;12;02;Torstai;1;2;3;1;0;1
96;29.12.2011;2011;12;03;Torstai;0;0;0;0;0;0
96;29.12.2011;2011;12;04;Torstai;1;1;2;1;0;1
96;29.12.2011;2011;12;05;Torstai;2;3;5;0;2;2
96;29.12.2011;2011;12;06;Torstai;13;11;24;13;3;16
96;29.12.2011;2011;12;07;Torstai;27;29;56;12;14;26
96;29.12.2011;2011;12;08;Torstai;19;14;33;10;4;14
96;29.12.2011;2011;12;09;Torstai;9;10;19;3;1;4
96;29.12.2011;2011;12;10;Torstai;14;17;31;5;5;10
96;29.12.2011;2011;12;11;Torstai;9;7;16;9;14;23
96;29.12.2011;2011;12;12;Torstai;15;22;37;3;9;12
96;29.12.2011;2011;12;13;Torstai;21;19;40;7;13;20
96;29.12.2011;2011;12;14;Torstai;21;17;38;11;20;31
96;29.12.2011;2011;12;15;Torstai;18;37;55;15;26;41
96;29.12.2011;2011;12;16;Torstai;32;25;57;16;13;29
96;29.12.2011;2011;12;17;Torstai;38;5;43;9;0;9
96;29.12.2011;2011;12;18;Torstai;20;5;25;13;2;15
96;29.12.2011;2011;12;19;Torstai;27;13;40;8;11;19
96;29.12.2011;2011;12;20;Torstai;11;9;20;6;12;18
96;29.12.2011;2011;12;21;Torstai;8;3;11;7;6;13
96;29.12.2011;2011;12;22;Torstai;6;1;7;2;3;5
96;29.12.2011;2011;12;23;Torstai;5;3;8;1;0;1
96;30.12.2011;2011;12;00;Perjantai;0;1;1;2;1;3
96;30.12.2011;2011;12;01;Perjantai;0;0;0;0;0;0
96;30.12.2011;2011;12;02;Perjantai;2;1;3;0;0;0
96;30.12.2011;2011;12;03;Perjantai;1;0;1;5;1;6
96;30.12.2011;2011;12;04;Perjantai;1;2;3;0;0;0
96;30.12.2011;2011;12;05;Perjantai;2;5;7;1;1;2
96;30.12.2011;2011;12;06;Perjantai;12;4;16;10;2;12
96;30.12.2011;2011;12;07;Perjantai;27;25;52;16;11;27
96;30.12.2011;2011;12;08;Perjantai;13;24;37;7;8;15
96;30.12.2011;2011;12;09;Perjantai;12;33;45;16;13;29
96;30.12.2011;2011;12;10;Perjantai;17;18;35;7;12;19
96;30.12.2011;2011;12;11;Perjantai;22;21;43;10;5;15
96;30.12.2011;2011;12;12;Perjantai;14;19;33;12;15;27
96;30.12.2011;2011;12;13;Perjantai;25;32;57;21;24;45
96;30.12.2011;2011;12;14;Perjantai;22;30;52;8;22;30
96;30.12.2011;2011;12;15;Perjantai;17;51;68;20;22;42
96;30.12.2011;2011;12;16;Perjantai;18;29;47;11;11;22
96;30.12.2011;2011;12;17;Perjantai;26;14;40;43;39;82
96;30.12.2011;2011;12;18;Perjantai;25;15;40;8;6;14
96;30.12.2011;2011;12;19;Perjantai;17;15;32;6;7;13
96;30.12.2011;2011;12;20;Perjantai;19;8;27;9;5;14
96;30.12.2011;2011;12;21;Perjantai;9;13;22;7;9;16
96;30.12.2011;2011;12;22;Perjantai;2;5;7;1;5;6
96;30.12.2011;2011;12;23;Perjantai;6;9;15;3;2;5
96;31.12.2011;2011;12;00;Lauantai;3;3;6;0;0;0
96;31.12.2011;2011;12;01;Lauantai;8;0;8;0;0;0
96;31.12.2011;2011;12;02;Lauantai;0;1;1;2;0;2
96;31.12.2011;2011;12;03;Lauantai;4;0;4;1;0;1
96;31.12.2011;2011;12;04;Lauantai;0;0;0;2;0;2
96;31.12.2011;2011;12;05;Lauantai;2;2;4;0;0;0
96;31.12.2011;2011;12;06;Lauantai;3;3;6;4;0;4
96;31.12.2011;2011;12;07;Lauantai;0;8;8;0;3;3
96;31.12.2011;2011;12;08;Lauantai;2;6;8;4;4;8
96;31.12.2011;2011;12;09;Lauantai;8;17;25;5;5;10
96;31.12.2011;2011;12;10;Lauantai;9;14;23;11;15;26
96;31.12.2011;2011;12;11;Lauantai;9;14;23;6;7;13
96;31.12.2011;2011;12;12;Lauantai;8;19;27;12;14;26
96;31.12.2011;2011;12;13;Lauantai;19;15;34;15;10;25
96;31.12.2011;2011;12;14;Lauantai;14;16;30;7;17;24
96;31.12.2011;2011;12;15;Lauantai;24;11;35;9;15;24
96;31.12.2011;2011;12;16;Lauantai;19;19;38;9;9;18
96;31.12.2011;2011;12;17;Lauantai;7;7;14;5;10;15
96;31.12.2011;2011;12;18;Lauantai;23;9;32;2;6;8
96;31.12.2011;2011;12;19;Lauantai;9;18;27;2;5;7
96;31.12.2011;2011;12;20;Lauantai;17;8;25;3;2;5
96;31.12.2011;2011;12;21;Lauantai;7;11;18;8;5;13
96;31.12.2011;2011;12;22;Lauantai;4;5;9;2;2;4
96;31.12.2011;2011;12;23;Lauantai;5;2;7;1;0;1
96;01.01.2012;2012;01;00;Sunnuntai;1;0;1;2;0;2
96;01.01.2012;2012;01;01;Sunnuntai;0;1;1;1;2;3
96;01.01.2012;2012;01;02;Sunnuntai;0;5;5;2;1;3
96;01.01.2012;2012;01;03;Sunnuntai;9;4;13;5;0;5
96;01.01.2012;2012;01;04;Sunnuntai;9;2;11;5;2;7
96;01.01.2012;2012;01;05;Sunnuntai;3;0;3;2;1;3
96;01.01.2012;2012;01;06;Sunnuntai;6;2;8;3;0;3
96;01.01.2012;2012;01;07;Sunnuntai;1;4;5;0;4;4
96;01.01.2012;2012;01;08;Sunnuntai;3;1;4;3;4;7
96;01.01.2012;2012;01;09;Sunnuntai;4;3;7;4;2;6
96;01.01.2012;2012;01;10;Sunnuntai;0;0;0;7;6;13
96;01.01.2012;2012;01;11;Sunnuntai;4;3;7;3;4;7
96;01.01.2012;2012;01;12;Sunnuntai;5;12;17;10;12;22
96;01.01.2012;2012;01;13;Sunnuntai;5;10;15;9;17;26
96;01.01.2012;2012;01;14;Sunnuntai;10;15;25;11;11;22
96;01.01.2012;2012;01;15;Sunnuntai;12;7;19;13;11;24
96;01.01.2012;2012;01;16;Sunnuntai;9;9;18;11;9;20
96;01.01.2012;2012;01;17;Sunnuntai;6;8;14;6;9;15
96;01.01.2012;2012;01;18;Sunnuntai;5;4;9;16;8;24
96;01.01.2012;2012;01;19;Sunnuntai;6;7;13;11;18;29
96;01.01.2012;2012;01;20;Sunnuntai;9;12;21;6;13;19
96;01.01.2012;2012;01;21;Sunnuntai;4;6;10;4;3;7
96;01.01.2012;2012;01;22;Sunnuntai;1;2;3;1;1;2
96;01.01.2012;2012;01;23;Sunnuntai;2;0;2;0;1;1
96;02.01.2012;2012;01;00;Maanantai;4;0;4;0;0;0
96;02.01.2012;2012;01;01;Maanantai;0;0;0;0;0;0
96;02.01.2012;2012;01;02;Maanantai;0;2;2;0;0;0
96;02.01.2012;2012;01;03;Maanantai;0;0;0;0;0;0
96;02.01.2012;2012;01;04;Maanantai;0;2;2;0;0;0
96;02.01.2012;2012;01;05;Maanantai;6;5;11;1;0;1
96;02.01.2012;2012;01;06;Maanantai;19;20;39;12;4;16
96;02.01.2012;2012;01;07;Maanantai;54;40;94;18;17;35
96;02.01.2012;2012;01;08;Maanantai;31;41;72;20;5;25
96;02.01.2012;2012;01;09;Maanantai;20;33;53;14;15;29
96;02.01.2012;2012;01;10;Maanantai;14;25;39;7;14;21
96;02.01.2012;2012;01;11;Maanantai;23;35;58;7;7;14
96;02.01.2012;2012;01;12;Maanantai;23;32;55;13;18;31
96;02.01.2012;2012;01;13;Maanantai;29;29;58;14;12;26
96;02.01.2012;2012;01;14;Maanantai;27;32;59;4;15;19
96;02.01.2012;2012;01;15;Maanantai;31;93;124;6;31;37
96;02.01.2012;2012;01;16;Maanantai;62;54;116;11;38;49
96;02.01.2012;2012;01;17;Maanantai;38;26;64;11;13;24
96;02.01.2012;2012;01;18;Maanantai;24;22;46;10;13;23
96;02.01.2012;2012;01;19;Maanantai;30;16;46;14;8;22
96;02.01.2012;2012;01;20;Maanantai;22;3;25;8;12;20
96;02.01.2012;2012;01;21;Maanantai;16;9;25;6;6;12
96;02.01.2012;2012;01;22;Maanantai;5;6;11;4;3;7
96;02.01.2012;2012;01;23;Maanantai;3;4;7;0;0;0
96;03.01.2012;2012;01;00;Tiistai;2;1;3;1;0;1
96;03.01.2012;2012;01;01;Tiistai;2;0;2;0;0;0
96;03.01.2012;2012;01;02;Tiistai;2;1;3;0;0;0
96;03.01.2012;2012;01;03;Tiistai;0;1;1;0;0;0
96;03.01.2012;2012;01;04;Tiistai;0;2;2;0;0;0
96;03.01.2012;2012;01;05;Tiistai;3;3;6;1;1;2
96;03.01.2012;2012;01;06;Tiistai;24;21;45;5;2;7
96;03.01.2012;2012;01;07;Tiistai;65;36;101;14;15;29
96;03.01.2012;2012;01;08;Tiistai;46;36;82;13;7;20
96;03.01.2012;2012;01;09;Tiistai;28;26;54;5;11;16
96;03.01.2012;2012;01;10;Tiistai;23;28;51;10;10;20
96;03.01.2012;2012;01;11;Tiistai;17;24;41;10;8;18
96;03.01.2012;2012;01;12;Tiistai;29;32;61;7;12;19
96;03.01.2012;2012;01;13;Tiistai;33;33;66;8;16;24
96;03.01.2012;2012;01;14;Tiistai;35;51;86;7;23;30
96;03.01.2012;2012;01;15;Tiistai;39;102;141;10;43;53
96;03.01.2012;2012;01;16;Tiistai;53;73;126;8;28;36
96;03.01.2012;2012;01;17;Tiistai;35;32;67;14;13;27
96;03.01.2012;2012;01;18;Tiistai;40;32;72;19;25;44
96;03.01.2012;2012;01;19;Tiistai;11;16;27;5;15;20
96;03.01.2012;2012;01;20;Tiistai;36;6;42;23;16;39
96;03.01.2012;2012;01;21;Tiistai;21;17;38;7;8;15
96;03.01.2012;2012;01;22;Tiistai;10;4;14;1;5;6
96;03.01.2012;2012;01;23;Tiistai;8;1;9;1;0;1
96;04.01.2012;2012;01;00;Keskiviikko;2;0;2;0;1;1
96;04.01.2012;2012;01;01;Keskiviikko;5;0;5;0;0;0
96;04.01.2012;2012;01;02;Keskiviikko;2;1;3;0;0;0
96;04.01.2012;2012;01;03;Keskiviikko;1;0;1;0;0;0
96;04.01.2012;2012;01;04;Keskiviikko;0;1;1;1;0;1
96;04.01.2012;2012;01;05;Keskiviikko;6;1;7;1;0;1
96;04.01.2012;2012;01;06;Keskiviikko;30;27;57;10;3;13
96;04.01.2012;2012;01;07;Keskiviikko;56;47;103;20;11;31
96;04.01.2012;2012;01;08;Keskiviikko;54;34;88;24;6;30
96;04.01.2012;2012;01;09;Keskiviikko;35;28;63;9;7;16
96;04.01.2012;2012;01;10;Keskiviikko;28;31;59;12;22;34
96;04.01.2012;2012;01;11;Keskiviikko;20;32;52;5;18;23
96;04.01.2012;2012;01;12;Keskiviikko;30;31;61;5;15;20
96;04.01.2012;2012;01;13;Keskiviikko;34;41;75;6;16;22
96;04.01.2012;2012;01;14;Keskiviikko;28;71;99;6;18;24
96;04.01.2012;2012;01;15;Keskiviikko;40;99;139;10;43;53
96;04.01.2012;2012;01;16;Keskiviikko;46;77;123;9;45;54
96;04.01.2012;2012;01;17;Keskiviikko;37;41;78;14;13;27
96;04.01.2012;2012;01;18;Keskiviikko;32;15;47;17;17;34
96;04.01.2012;2012;01;19;Keskiviikko;34;16;50;12;11;23
96;04.01.2012;2012;01;20;Keskiviikko;24;9;33;10;8;18
96;04.01.2012;2012;01;21;Keskiviikko;19;25;44;6;8;14
96;04.01.2012;2012;01;22;Keskiviikko;7;4;11;1;4;5
96;04.01.2012;2012;01;23;Keskiviikko;6;1;7;1;2;3
96;05.01.2012;2012;01;00;Torstai;1;3;4;1;0;1
96;05.01.2012;2012;01;01;Torstai;2;2;4;0;0;0
96;05.01.2012;2012;01;02;Torstai;0;0;0;1;1;2
96;05.01.2012;2012;01;03;Torstai;2;0;2;0;0;0
96;05.01.2012;2012;01;04;Torstai;0;2;2;0;0;0
96;05.01.2012;2012;01;05;Torstai;7;2;9;0;0;0
96;05.01.2012;2012;01;06;Torstai;28;23;51;6;3;9
96;05.01.2012;2012;01;07;Torstai;55;49;104;18;9;27
96;05.01.2012;2012;01;08;Torstai;77;29;106;19;8;27
96;05.01.2012;2012;01;09;Torstai;30;29;59;18;14;32
96;05.01.2012;2012;01;10;Torstai;22;25;47;3;8;11
96;05.01.2012;2012;01;11;Torstai;27;33;60;19;13;32
96;05.01.2012;2012;01;12;Torstai;33;35;68;11;15;26
96;05.01.2012;2012;01;13;Torstai;32;47;79;16;18;34
96;05.01.2012;2012;01;14;Torstai;30;78;108;8;21;29
96;05.01.2012;2012;01;15;Torstai;40;121;161;12;34;46
96;05.01.2012;2012;01;16;Torstai;42;65;107;7;28;35
96;05.01.2012;2012;01;17;Torstai;39;33;72;12;15;27
96;05.01.2012;2012;01;18;Torstai;21;22;43;9;19;28
96;05.01.2012;2012;01;19;Torstai;23;12;35;11;14;25
96;05.01.2012;2012;01;20;Torstai;27;15;42;8;14;22
96;05.01.2012;2012;01;21;Torstai;13;11;24;4;4;8
96;05.01.2012;2012;01;22;Torstai;9;11;20;0;1;1
96;05.01.2012;2012;01;23;Torstai;2;3;5;1;0;1
96;06.01.2012;2012;01;00;Perjantai;6;3;9;0;0;0
96;06.01.2012;2012;01;01;Perjantai;6;1;7;1;0;1
96;06.01.2012;2012;01;02;Perjantai;5;3;8;2;2;4
96;06.01.2012;2012;01;03;Perjantai;1;4;5;0;0;0
96;06.01.2012;2012;01;04;Perjantai;3;0;3;0;0;0
96;06.01.2012;2012;01;05;Perjantai;1;1;2;0;0;0
96;06.01.2012;2012;01;06;Perjantai;13;7;20;4;0;4
96;06.01.2012;2012;01;07;Perjantai;2;3;5;0;6;6
96;06.01.2012;2012;01;08;Perjantai;4;0;4;1;2;3
96;06.01.2012;2012;01;09;Perjantai;6;12;18;8;9;17
96;06.01.2012;2012;01;10;Perjantai;10;6;16;8;8;16
96;06.01.2012;2012;01;11;Perjantai;6;19;25;10;13;23
96;06.01.2012;2012;01;12;Perjantai;9;22;31;14;16;30
96;06.01.2012;2012;01;13;Perjantai;22;19;41;16;21;37
96;06.01.2012;2012;01;14;Perjantai;17;14;31;10;20;30
96;06.01.2012;2012;01;15;Perjantai;15;15;30;12;15;27
96;06.01.2012;2012;01;16;Perjantai;23;17;40;23;13;36
96;06.01.2012;2012;01;17;Perjantai;15;12;27;17;7;24
96;06.01.2012;2012;01;18;Perjantai;23;11;34;17;21;38
96;06.01.2012;2012;01;19;Perjantai;19;12;31;8;16;24
96;06.01.2012;2012;01;20;Perjantai;8;14;22;6;10;16
96;06.01.2012;2012;01;21;Perjantai;5;10;15;4;10;14
96;06.01.2012;2012;01;22;Perjantai;5;6;11;5;4;9
96;06.01.2012;2012;01;23;Perjantai;6;3;9;4;4;8
96;07.01.2012;2012;01;00;Lauantai;9;2;11;2;0;2
96;07.01.2012;2012;01;01;Lauantai;2;1;3;0;1;1
96;07.01.2012;2012;01;02;Lauantai;8;0;8;2;1;3
96;07.01.2012;2012;01;03;Lauantai;3;1;4;0;0;0
96;07.01.2012;2012;01;04;Lauantai;3;1;4;0;0;0
96;07.01.2012;2012;01;05;Lauantai;5;1;6;6;2;8
96;07.01.2012;2012;01;06;Lauantai;10;3;13;2;0;2
96;07.01.2012;2012;01;07;Lauantai;2;9;11;3;3;6
96;07.01.2012;2012;01;08;Lauantai;3;8;11;4;5;9
96;07.01.2012;2012;01;09;Lauantai;4;19;23;10;7;17
96;07.01.2012;2012;01;10;Lauantai;9;22;31;12;6;18
96;07.01.2012;2012;01;11;Lauantai;15;18;33;6;11;17
96;07.01.2012;2012;01;12;Lauantai;26;22;48;11;18;29
96;07.01.2012;2012;01;13;Lauantai;25;18;43;19;19;38
96;07.01.2012;2012;01;14;Lauantai;22;16;38;12;19;31
96;07.01.2012;2012;01;15;Lauantai;20;20;40;24;23;47
96;07.01.2012;2012;01;16;Lauantai;15;24;39;7;19;26
96;07.01.2012;2012;01;17;Lauantai;15;12;27;13;9;22
96;07.01.2012;2012;01;18;Lauantai;23;9;32;15;14;29
96;07.01.2012;2012;01;19;Lauantai;30;13;43;25;19;44
96;07.01.2012;2012;01;20;Lauantai;17;9;26;9;10;19
96;07.01.2012;2012;01;21;Lauantai;9;25;34;2;8;10
96;07.01.2012;2012;01;22;Lauantai;3;5;8;2;6;8
96;07.01.2012;2012;01;23;Lauantai;5;6;11;2;0;2
96;08.01.2012;2012;01;00;Sunnuntai;6;3;9;0;1;1
96;08.01.2012;2012;01;01;Sunnuntai;1;4;5;1;2;3
96;08.01.2012;2012;01;02;Sunnuntai;5;0;5;1;0;1
96;08.01.2012;2012;01;03;Sunnuntai;4;2;6;2;1;3
96;08.01.2012;2012;01;04;Sunnuntai;6;1;7;4;2;6
96;08.01.2012;2012;01;05;Sunnuntai;0;0;0;0;0;0
96;08.01.2012;2012;01;06;Sunnuntai;10;4;14;3;0;3
96;08.01.2012;2012;01;07;Sunnuntai;1;6;7;0;5;5
96;08.01.2012;2012;01;08;Sunnuntai;3;2;5;2;1;3
96;08.01.2012;2012;01;09;Sunnuntai;1;5;6;10;11;21
96;08.01.2012;2012;01;10;Sunnuntai;4;6;10;13;9;22
96;08.01.2012;2012;01;11;Sunnuntai;8;13;21;17;13;30
96;08.01.2012;2012;01;12;Sunnuntai;11;16;27;19;15;34
96;08.01.2012;2012;01;13;Sunnuntai;24;22;46;17;19;36
96;08.01.2012;2012;01;14;Sunnuntai;10;11;21;20;18;38
96;08.01.2012;2012;01;15;Sunnuntai;24;23;47;21;17;38
96;08.01.2012;2012;01;16;Sunnuntai;24;13;37;34;21;55
96;08.01.2012;2012;01;17;Sunnuntai;17;19;36;21;12;33
96;08.01.2012;2012;01;18;Sunnuntai;15;14;29;27;25;52
96;08.01.2012;2012;01;19;Sunnuntai;11;18;29;18;22;40
96;08.01.2012;2012;01;20;Sunnuntai;13;12;25;10;20;30
96;08.01.2012;2012;01;21;Sunnuntai;13;11;24;9;6;15
96;08.01.2012;2012;01;22;Sunnuntai;7;2;9;3;2;5
96;08.01.2012;2012;01;23;Sunnuntai;5;0;5;0;1;1
96;09.01.2012;2012;01;00;Maanantai;2;0;2;1;0;1
96;09.01.2012;2012;01;01;Maanantai;2;1;3;0;0;0
96;09.01.2012;2012;01;02;Maanantai;0;0;0;0;3;3
96;09.01.2012;2012;01;03;Maanantai;3;2;5;6;2;8
96;09.01.2012;2012;01;04;Maanantai;1;3;4;0;0;0
96;09.01.2012;2012;01;05;Maanantai;2;6;8;1;0;1
96;09.01.2012;2012;01;06;Maanantai;35;22;57;11;4;15
96;09.01.2012;2012;01;07;Maanantai;82;71;153;43;13;56
96;09.01.2012;2012;01;08;Maanantai;84;79;163;25;16;41
96;09.01.2012;2012;01;09;Maanantai;43;60;103;25;12;37
96;09.01.2012;2012;01;10;Maanantai;31;20;51;20;11;31
96;09.01.2012;2012;01;11;Maanantai;33;44;77;21;13;34
96;09.01.2012;2012;01;12;Maanantai;37;47;84;12;15;27
96;09.01.2012;2012;01;13;Maanantai;38;40;78;10;16;26
96;09.01.2012;2012;01;14;Maanantai;60;64;124;7;18;25
96;09.01.2012;2012;01;15;Maanantai;66;133;199;15;34;49
96;09.01.2012;2012;01;16;Maanantai;76;139;215;22;55;77
96;09.01.2012;2012;01;17;Maanantai;46;45;91;19;34;53
96;09.01.2012;2012;01;18;Maanantai;41;34;75;21;18;39
96;09.01.2012;2012;01;19;Maanantai;40;33;73;19;28;47
96;09.01.2012;2012;01;20;Maanantai;38;12;50;14;15;29
96;09.01.2012;2012;01;21;Maanantai;21;20;41;8;11;19
96;09.01.2012;2012;01;22;Maanantai;12;2;14;1;5;6
96;09.01.2012;2012;01;23;Maanantai;3;1;4;1;1;2
96;10.01.2012;2012;01;00;Tiistai;1;0;1;1;0;1
96;10.01.2012;2012;01;01;Tiistai;0;0;0;0;1;1
96;10.01.2012;2012;01;02;Tiistai;3;1;4;0;0;0
96;10.01.2012;2012;01;03;Tiistai;0;0;0;0;1;1
96;10.01.2012;2012;01;04;Tiistai;1;2;3;1;0;1
96;10.01.2012;2012;01;05;Tiistai;3;3;6;0;0;0
96;10.01.2012;2012;01;06;Tiistai;30;24;54;9;4;13
96;10.01.2012;2012;01;07;Tiistai;82;71;153;49;20;69
96;10.01.2012;2012;01;08;Tiistai;94;69;163;29;14;43
96;10.01.2012;2012;01;09;Tiistai;41;65;106;11;14;25
96;10.01.2012;2012;01;10;Tiistai;32;31;63;16;8;24
96;10.01.2012;2012;01;11;Tiistai;27;27;54;10;12;22
96;10.01.2012;2012;01;12;Tiistai;40;43;83;8;10;18
96;10.01.2012;2012;01;13;Tiistai;29;32;61;10;12;22
96;10.01.2012;2012;01;14;Tiistai;48;83;131;15;25;40
96;10.01.2012;2012;01;15;Tiistai;50;135;185;16;34;50
96;10.01.2012;2012;01;16;Tiistai;79;111;190;14;45;59
96;10.01.2012;2012;01;17;Tiistai;49;48;97;21;12;33
96;10.01.2012;2012;01;18;Tiistai;30;26;56;17;19;36
96;10.01.2012;2012;01;19;Tiistai;40;33;73;21;22;43
96;10.01.2012;2012;01;20;Tiistai;36;14;50;17;21;38
96;10.01.2012;2012;01;21;Tiistai;18;13;31;6;8;14
96;10.01.2012;2012;01;22;Tiistai;7;3;10;3;8;11
96;10.01.2012;2012;01;23;Tiistai;9;5;14;2;3;5
96;11.01.2012;2012;01;00;Keskiviikko;5;1;6;0;0;0
96;11.01.2012;2012;01;01;Keskiviikko;1;0;1;0;0;0
96;11.01.2012;2012;01;02;Keskiviikko;0;0;0;0;0;0
96;11.01.2012;2012;01;03;Keskiviikko;0;1;1;0;1;1
96;11.01.2012;2012;01;04;Keskiviikko;1;4;5;0;0;0
96;11.01.2012;2012;01;05;Keskiviikko;3;9;12;0;0;0
96;11.01.2012;2012;01;06;Keskiviikko;32;29;61;10;3;13
96;11.01.2012;2012;01;07;Keskiviikko;92;65;157;35;15;50
96;11.01.2012;2012;01;08;Keskiviikko;82;76;158;35;18;53
96;11.01.2012;2012;01;09;Keskiviikko;52;39;91;15;23;38
96;11.01.2012;2012;01;10;Keskiviikko;37;38;75;12;17;29
96;11.01.2012;2012;01;11;Keskiviikko;30;27;57;12;15;27
96;11.01.2012;2012;01;12;Keskiviikko;43;39;82;13;18;31
96;11.01.2012;2012;01;13;Keskiviikko;39;50;89;18;14;32
96;11.01.2012;2012;01;14;Keskiviikko;48;69;117;13;21;34
96;11.01.2012;2012;01;15;Keskiviikko;59;129;188;14;46;60
96;11.01.2012;2012;01;16;Keskiviikko;61;117;178;16;43;59
96;11.01.2012;2012;01;17;Keskiviikko;49;49;98;18;15;33
96;11.01.2012;2012;01;18;Keskiviikko;44;30;74;36;23;59
96;11.01.2012;2012;01;19;Keskiviikko;45;31;76;19;21;40
96;11.01.2012;2012;01;20;Keskiviikko;36;18;54;21;20;41
96;11.01.2012;2012;01;21;Keskiviikko;18;19;37;6;12;18
96;11.01.2012;2012;01;22;Keskiviikko;5;7;12;1;4;5
96;11.01.2012;2012;01;23;Keskiviikko;1;6;7;1;1;2
96;12.01.2012;2012;01;00;Torstai;4;2;6;3;3;6
96;12.01.2012;2012;01;01;Torstai;3;0;3;0;1;1
96;12.01.2012;2012;01;02;Torstai;3;1;4;0;0;0
96;12.01.2012;2012;01;03;Torstai;2;0;2;1;0;1
96;12.01.2012;2012;01;04;Torstai;1;2;3;1;0;1
96;12.01.2012;2012;01;05;Torstai;1;5;6;1;0;1
96;12.01.2012;2012;01;06;Torstai;24;23;47;11;6;17
96;12.01.2012;2012;01;07;Torstai;71;68;139;25;18;43
96;12.01.2012;2012;01;08;Torstai;91;76;167;19;10;29
96;12.01.2012;2012;01;09;Torstai;34;45;79;22;12;34
96;12.01.2012;2012;01;10;Torstai;24;28;52;6;17;23
96;12.01.2012;2012;01;11;Torstai;33;23;56;17;7;24
96;12.01.2012;2012;01;12;Torstai;33;41;74;14;12;26
96;12.01.2012;2012;01;13;Torstai;31;36;67;17;24;41
96;12.01.2012;2012;01;14;Torstai;35;75;110;11;19;30
96;12.01.2012;2012;01;15;Torstai;57;127;184;9;43;52
96;12.01.2012;2012;01;16;Torstai;72;94;166;11;39;50
96;12.01.2012;2012;01;17;Torstai;44;48;92;14;16;30
96;12.01.2012;2012;01;18;Torstai;27;30;57;6;15;21
96;12.01.2012;2012;01;19;Torstai;25;13;38;7;16;23
96;12.01.2012;2012;01;20;Torstai;27;14;41;7;7;14
96;12.01.2012;2012;01;21;Torstai;23;8;31;4;10;14
96;12.01.2012;2012;01;22;Torstai;2;4;6;3;7;10
96;12.01.2012;2012;01;23;Torstai;5;0;5;0;1;1
96;13.01.2012;2012;01;00;Perjantai;0;0;0;2;2;4
96;13.01.2012;2012;01;01;Perjantai;1;0;1;1;0;1
96;13.01.2012;2012;01;02;Perjantai;1;0;1;4;3;7
96;13.01.2012;2012;01;03;Perjantai;0;0;0;0;0;0
96;13.01.2012;2012;01;04;Perjantai;4;3;7;0;0;0
96;13.01.2012;2012;01;05;Perjantai;2;1;3;0;0;0
96;13.01.2012;2012;01;06;Perjantai;30;17;47;10;2;12
96;13.01.2012;2012;01;07;Perjantai;70;47;117;23;9;32
96;13.01.2012;2012;01;08;Perjantai;69;60;129;19;4;23
96;13.01.2012;2012;01;09;Perjantai;47;35;82;12;9;21
96;13.01.2012;2012;01;10;Perjantai;22;48;70;6;5;11
96;13.01.2012;2012;01;11;Perjantai;28;37;65;7;6;13
96;13.01.2012;2012;01;12;Perjantai;29;35;64;15;13;28
96;13.01.2012;2012;01;13;Perjantai;40;51;91;14;18;32
96;13.01.2012;2012;01;14;Perjantai;48;68;116;10;25;35
96;13.01.2012;2012;01;15;Perjantai;44;105;149;13;27;40
96;13.01.2012;2012;01;16;Perjantai;43;79;122;7;11;18
96;13.01.2012;2012;01;17;Perjantai;38;39;77;19;8;27
96;13.01.2012;2012;01;18;Perjantai;32;37;69;11;14;25
96;13.01.2012;2012;01;19;Perjantai;22;25;47;6;6;12
96;13.01.2012;2012;01;20;Perjantai;23;12;35;3;6;9
96;13.01.2012;2012;01;21;Perjantai;33;13;46;12;4;16
96;13.01.2012;2012;01;22;Perjantai;6;3;9;1;0;1
96;13.01.2012;2012;01;23;Perjantai;4;2;6;0;0;0
96;14.01.2012;2012;01;00;Lauantai;4;2;6;0;1;1
96;14.01.2012;2012;01;01;Lauantai;5;0;5;0;0;0
96;14.01.2012;2012;01;02;Lauantai;4;0;4;0;0;0
96;14.01.2012;2012;01;03;Lauantai;3;1;4;0;0;0
96;14.01.2012;2012;01;04;Lauantai;4;1;5;1;0;1
96;14.01.2012;2012;01;05;Lauantai;2;1;3;0;0;0
96;14.01.2012;2012;01;06;Lauantai;13;4;17;2;0;2
96;14.01.2012;2012;01;07;Lauantai;3;8;11;1;2;3
96;14.01.2012;2012;01;08;Lauantai;4;9;13;1;1;2
96;14.01.2012;2012;01;09;Lauantai;5;21;26;6;4;10
96;14.01.2012;2012;01;10;Lauantai;10;13;23;5;5;10
96;14.01.2012;2012;01;11;Lauantai;13;18;31;8;12;20
96;14.01.2012;2012;01;12;Lauantai;20;22;42;11;6;17
96;14.01.2012;2012;01;13;Lauantai;32;31;63;14;8;22
96;14.01.2012;2012;01;14;Lauantai;22;19;41;13;18;31
96;14.01.2012;2012;01;15;Lauantai;22;33;55;14;7;21
96;14.01.2012;2012;01;16;Lauantai;31;17;48;13;10;23
96;14.01.2012;2012;01;17;Lauantai;25;16;41;11;7;18
96;14.01.2012;2012;01;18;Lauantai;18;14;32;11;5;16
96;14.01.2012;2012;01;19;Lauantai;22;6;28;6;4;10
96;14.01.2012;2012;01;20;Lauantai;12;11;23;1;3;4
96;14.01.2012;2012;01;21;Lauantai;12;13;25;1;5;6
96;14.01.2012;2012;01;22;Lauantai;3;8;11;1;2;3
96;14.01.2012;2012;01;23;Lauantai;1;5;6;0;0;0
96;15.01.2012;2012;01;00;Sunnuntai;1;10;11;0;0;0
96;15.01.2012;2012;01;01;Sunnuntai;7;4;11;0;0;0
96;15.01.2012;2012;01;02;Sunnuntai;8;2;10;2;0;2
96;15.01.2012;2012;01;03;Sunnuntai;4;0;4;2;0;2
96;15.01.2012;2012;01;04;Sunnuntai;2;0;2;1;0;1
96;15.01.2012;2012;01;05;Sunnuntai;0;0;0;0;0;0
96;15.01.2012;2012;01;06;Sunnuntai;7;3;10;4;1;5
96;15.01.2012;2012;01;07;Sunnuntai;0;3;3;0;0;0
96;15.01.2012;2012;01;08;Sunnuntai;4;2;6;1;0;1
96;15.01.2012;2012;01;09;Sunnuntai;2;3;5;4;3;7
96;15.01.2012;2012;01;10;Sunnuntai;5;8;13;3;3;6
96;15.01.2012;2012;01;11;Sunnuntai;3;9;12;9;9;18
96;15.01.2012;2012;01;12;Sunnuntai;11;12;23;20;23;43
96;15.01.2012;2012;01;13;Sunnuntai;14;13;27;4;13;17
96;15.01.2012;2012;01;14;Sunnuntai;19;15;34;8;11;19
96;15.01.2012;2012;01;15;Sunnuntai;15;13;28;17;16;33
96;15.01.2012;2012;01;16;Sunnuntai;27;14;41;12;14;26
96;15.01.2012;2012;01;17;Sunnuntai;16;17;33;20;17;37
96;15.01.2012;2012;01;18;Sunnuntai;17;15;32;24;14;38
96;15.01.2012;2012;01;19;Sunnuntai;10;15;25;10;8;18
96;15.01.2012;2012;01;20;Sunnuntai;14;24;38;3;13;16
96;15.01.2012;2012;01;21;Sunnuntai;11;11;22;5;11;16
96;15.01.2012;2012;01;22;Sunnuntai;5;4;9;1;0;1
96;15.01.2012;2012;01;23;Sunnuntai;2;1;3;2;0;2
96;16.01.2012;2012;01;00;Maanantai;2;1;3;0;1;1
96;16.01.2012;2012;01;01;Maanantai;0;0;0;0;0;0
96;16.01.2012;2012;01;02;Maanantai;2;0;2;0;0;0
96;16.01.2012;2012;01;03;Maanantai;1;0;1;0;0;0
96;16.01.2012;2012;01;04;Maanantai;3;1;4;0;0;0
96;16.01.2012;2012;01;05;Maanantai;2;6;8;0;0;0
96;16.01.2012;2012;01;06;Maanantai;32;17;49;11;0;11
96;16.01.2012;2012;01;07;Maanantai;65;56;121;23;10;33
96;16.01.2012;2012;01;08;Maanantai;84;67;151;14;14;28
96;16.01.2012;2012;01;09;Maanantai;43;35;78;14;9;23
96;16.01.2012;2012;01;10;Maanantai;26;26;52;14;13;27
96;16.01.2012;2012;01;11;Maanantai;29;31;60;7;7;14
96;16.01.2012;2012;01;12;Maanantai;43;38;81;10;10;20
96;16.01.2012;2012;01;13;Maanantai;42;37;79;3;4;7
96;16.01.2012;2012;01;14;Maanantai;34;41;75;6;12;18
96;16.01.2012;2012;01;15;Maanantai;69;85;154;11;9;20
96;16.01.2012;2012;01;16;Maanantai;72;92;164;7;13;20
96;16.01.2012;2012;01;17;Maanantai;40;36;76;3;3;6
96;16.01.2012;2012;01;18;Maanantai;32;33;65;7;6;13
96;16.01.2012;2012;01;19;Maanantai;29;35;64;2;7;9
96;16.01.2012;2012;01;20;Maanantai;29;26;55;0;0;0
96;16.01.2012;2012;01;21;Maanantai;24;15;39;0;0;0
96;16.01.2012;2012;01;22;Maanantai;6;4;10;0;0;0
96;16.01.2012;2012;01;23;Maanantai;2;0;2;0;0;0
96;17.01.2012;2012;01;00;Tiistai;2;0;2;0;0;0
96;17.01.2012;2012;01;01;Tiistai;1;0;1;0;0;0
96;17.01.2012;2012;01;02;Tiistai;0;0;0;0;0;0
96;17.01.2012;2012;01;03;Tiistai;0;0;0;2;0;2
96;17.01.2012;2012;01;04;Tiistai;2;1;3;0;0;0
96;17.01.2012;2012;01;05;Tiistai;3;2;5;0;0;0
96;17.01.2012;2012;01;06;Tiistai;25;25;50;0;0;0
96;17.01.2012;2012;01;07;Tiistai;68;71;139;2;2;4
96;17.01.2012;2012;01;08;Tiistai;81;83;164;2;1;3
96;17.01.2012;2012;01;09;Tiistai;52;45;97;0;2;2
96;17.01.2012;2012;01;10;Tiistai;30;33;63;3;1;4
96;17.01.2012;2012;01;11;Tiistai;40;48;88;1;1;2
96;17.01.2012;2012;01;12;Tiistai;41;48;89;4;2;6
96;17.01.2012;2012;01;13;Tiistai;37;43;80;0;1;1
96;17.01.2012;2012;01;14;Tiistai;47;58;105;2;3;5
96;17.01.2012;2012;01;15;Tiistai;77;100;177;3;5;8
96;17.01.2012;2012;01;16;Tiistai;83;92;175;4;6;10
96;17.01.2012;2012;01;17;Tiistai;42;50;92;2;3;5
96;17.01.2012;2012;01;18;Tiistai;34;45;79;1;3;4
96;17.01.2012;2012;01;19;Tiistai;28;29;57;2;0;2
96;17.01.2012;2012;01;20;Tiistai;31;21;52;1;1;2
96;17.01.2012;2012;01;21;Tiistai;28;23;51;4;1;5
96;17.01.2012;2012;01;22;Tiistai;3;5;8;0;0;0
96;17.01.2012;2012;01;23;Tiistai;2;2;4;0;0;0
96;18.01.2012;2012;01;00;Keskiviikko;3;3;6;0;0;0
96;18.01.2012;2012;01;01;Keskiviikko;1;0;1;0;0;0
96;18.01.2012;2012;01;02;Keskiviikko;1;0;1;0;0;0
96;18.01.2012;2012;01;03;Keskiviikko;0;0;0;0;0;0
96;18.01.2012;2012;01;04;Keskiviikko;2;2;4;0;0;0
96;18.01.2012;2012;01;05;Keskiviikko;4;4;8;0;0;0
96;18.01.2012;2012;01;06;Keskiviikko;30;28;58;0;0;0
96;18.01.2012;2012;01;07;Keskiviikko;75;79;154;1;4;5
96;18.01.2012;2012;01;08;Keskiviikko;67;81;148;5;1;6
96;18.01.2012;2012;01;09;Keskiviikko;42;41;83;1;2;3
96;18.01.2012;2012;01;10;Keskiviikko;38;36;74;0;2;2
96;18.01.2012;2012;01;11;Keskiviikko;28;36;64;4;2;6
96;18.01.2012;2012;01;12;Keskiviikko;47;40;87;3;3;6
96;18.01.2012;2012;01;13;Keskiviikko;42;55;97;2;1;3
96;18.01.2012;2012;01;14;Keskiviikko;47;56;103;5;3;8
96;18.01.2012;2012;01;15;Keskiviikko;78;94;172;7;10;17
96;18.01.2012;2012;01;16;Keskiviikko;73;92;165;4;8;12
96;18.01.2012;2012;01;17;Keskiviikko;41;49;90;5;4;9
96;18.01.2012;2012;01;18;Keskiviikko;49;40;89;3;3;6
96;18.01.2012;2012;01;19;Keskiviikko;26;40;66;5;2;7
96;18.01.2012;2012;01;20;Keskiviikko;26;26;52;2;4;6
96;18.01.2012;2012;01;21;Keskiviikko;23;36;59;0;4;4
96;18.01.2012;2012;01;22;Keskiviikko;7;9;16;0;0;0
96;18.01.2012;2012;01;23;Keskiviikko;5;2;7;0;0;0
96;19.01.2012;2012;01;00;Torstai;2;2;4;0;1;1
96;19.01.2012;2012;01;01;Torstai;4;2;6;0;0;0
96;19.01.2012;2012;01;02;Torstai;0;0;0;0;0;0
96;19.01.2012;2012;01;03;Torstai;1;0;1;0;0;0
96;19.01.2012;2012;01;04;Torstai;2;4;6;0;0;0
96;19.01.2012;2012;01;05;Torstai;4;5;9;0;0;0
96;19.01.2012;2012;01;06;Torstai;32;28;60;2;1;3
96;19.01.2012;2012;01;07;Torstai;68;87;155;2;3;5
96;19.01.2012;2012;01;08;Torstai;75;71;146;1;2;3
96;19.01.2012;2012;01;09;Torstai;45;53;98;2;4;6
96;19.01.2012;2012;01;10;Torstai;33;40;73;2;7;9
96;19.01.2012;2012;01;11;Torstai;25;31;56;4;8;12
96;19.01.2012;2012;01;12;Torstai;33;49;82;1;6;7
96;19.01.2012;2012;01;13;Torstai;39;39;78;6;8;14
96;19.01.2012;2012;01;14;Torstai;44;71;115;8;11;19
96;19.01.2012;2012;01;15;Torstai;62;114;176;13;22;35
96;19.01.2012;2012;01;16;Torstai;80;115;195;8;19;27
96;19.01.2012;2012;01;17;Torstai;41;50;91;7;9;16
96;19.01.2012;2012;01;18;Torstai;33;29;62;7;7;14
96;19.01.2012;2012;01;19;Torstai;30;28;58;3;10;13
96;19.01.2012;2012;01;20;Torstai;32;27;59;7;5;12
96;19.01.2012;2012;01;21;Torstai;21;11;32;4;7;11
96;19.01.2012;2012;01;22;Torstai;9;2;11;0;2;2
96;19.01.2012;2012;01;23;Torstai;4;7;11;0;1;1
96;20.01.2012;2012;01;00;Perjantai;0;2;2;0;0;0
96;20.01.2012;2012;01;01;Perjantai;3;0;3;0;0;0
96;20.01.2012;2012;01;02;Perjantai;2;0;2;2;0;2
96;20.01.2012;2012;01;03;Perjantai;1;1;2;0;0;0
96;20.01.2012;2012;01;04;Perjantai;3;2;5;1;0;1
96;20.01.2012;2012;01;05;Perjantai;4;2;6;1;0;1
96;20.01.2012;2012;01;06;Perjantai;27;22;49;4;3;7
96;20.01.2012;2012;01;07;Perjantai;71;56;127;15;12;27
96;20.01.2012;2012;01;08;Perjantai;74;66;140;12;5;17
96;20.01.2012;2012;01;09;Perjantai;30;43;73;10;8;18
96;20.01.2012;2012;01;10;Perjantai;29;30;59;10;4;14
96;20.01.2012;2012;01;11;Perjantai;30;53;83;6;8;14
96;20.01.2012;2012;01;12;Perjantai;28;52;80;13;4;17
96;20.01.2012;2012;01;13;Perjantai;44;58;102;7;10;17
96;20.01.2012;2012;01;14;Perjantai;41;73;114;8;21;29
96;20.01.2012;2012;01;15;Perjantai;50;99;149;9;28;37
96;20.01.2012;2012;01;16;Perjantai;46;59;105;8;24;32
96;20.01.2012;2012;01;17;Perjantai;32;35;67;10;15;25
96;20.01.2012;2012;01;18;Perjantai;21;37;58;9;8;17
96;20.01.2012;2012;01;19;Perjantai;23;22;45;7;14;21
96;20.01.2012;2012;01;20;Perjantai;30;10;40;12;6;18
96;20.01.2012;2012;01;21;Perjantai;18;9;27;11;4;15
96;20.01.2012;2012;01;22;Perjantai;9;8;17;2;1;3
96;20.01.2012;2012;01;23;Perjantai;3;3;6;1;0;1
96;21.01.2012;2012;01;00;Lauantai;4;3;7;0;0;0
96;21.01.2012;2012;01;01;Lauantai;1;5;6;3;0;3
96;21.01.2012;2012;01;02;Lauantai;5;1;6;3;0;3
96;21.01.2012;2012;01;03;Lauantai;9;0;9;1;0;1
96;21.01.2012;2012;01;04;Lauantai;1;0;1;0;0;0
96;21.01.2012;2012;01;05;Lauantai;0;1;1;0;1;1
96;21.01.2012;2012;01;06;Lauantai;9;7;16;4;1;5
96;21.01.2012;2012;01;07;Lauantai;5;8;13;3;3;6
96;21.01.2012;2012;01;08;Lauantai;2;6;8;6;7;13
96;21.01.2012;2012;01;09;Lauantai;5;19;24;5;4;9
96;21.01.2012;2012;01;10;Lauantai;8;18;26;4;9;13
96;21.01.2012;2012;01;11;Lauantai;14;22;36;11;6;17
96;21.01.2012;2012;01;12;Lauantai;16;29;45;5;7;12
96;21.01.2012;2012;01;13;Lauantai;23;22;45;8;8;16
96;21.01.2012;2012;01;14;Lauantai;17;21;38;6;13;19
96;21.01.2012;2012;01;15;Lauantai;23;20;43;8;21;29
96;21.01.2012;2012;01;16;Lauantai;19;11;30;7;3;10
96;21.01.2012;2012;01;17;Lauantai;24;18;42;9;7;16
96;21.01.2012;2012;01;18;Lauantai;17;13;30;11;10;21
96;21.01.2012;2012;01;19;Lauantai;11;10;21;5;3;8
96;21.01.2012;2012;01;20;Lauantai;12;19;31;2;6;8
96;21.01.2012;2012;01;21;Lauantai;6;11;17;5;6;11
96;21.01.2012;2012;01;22;Lauantai;4;15;19;2;9;11
96;21.01.2012;2012;01;23;Lauantai;3;1;4;0;1;1
96;22.01.2012;2012;01;00;Sunnuntai;3;4;7;1;1;2
96;22.01.2012;2012;01;01;Sunnuntai;3;7;10;1;0;1
96;22.01.2012;2012;01;02;Sunnuntai;8;1;9;0;0;0
96;22.01.2012;2012;01;03;Sunnuntai;3;0;3;4;0;4
96;22.01.2012;2012;01;04;Sunnuntai;3;2;5;10;0;10
96;22.01.2012;2012;01;05;Sunnuntai;1;0;1;0;0;0
96;22.01.2012;2012;01;06;Sunnuntai;2;4;6;0;0;0
96;22.01.2012;2012;01;07;Sunnuntai;0;8;8;2;8;10
96;22.01.2012;2012;01;08;Sunnuntai;3;8;11;0;4;4
96;22.01.2012;2012;01;09;Sunnuntai;0;7;7;4;5;9
96;22.01.2012;2012;01;10;Sunnuntai;6;4;10;3;1;4
96;22.01.2012;2012;01;11;Sunnuntai;5;15;20;8;7;15
96;22.01.2012;2012;01;12;Sunnuntai;6;11;17;10;16;26
96;22.01.2012;2012;01;13;Sunnuntai;16;16;32;9;7;16
96;22.01.2012;2012;01;14;Sunnuntai;9;16;25;10;12;22
96;22.01.2012;2012;01;15;Sunnuntai;13;25;38;11;12;23
96;22.01.2012;2012;01;16;Sunnuntai;24;13;37;16;14;30
96;22.01.2012;2012;01;17;Sunnuntai;23;18;41;10;9;19
96;22.01.2012;2012;01;18;Sunnuntai;19;15;34;15;14;29
96;22.01.2012;2012;01;19;Sunnuntai;11;10;21;7;11;18
96;22.01.2012;2012;01;20;Sunnuntai;12;22;34;5;17;22
96;22.01.2012;2012;01;21;Sunnuntai;6;11;17;2;6;8
96;22.01.2012;2012;01;22;Sunnuntai;5;2;7;3;0;3
96;22.01.2012;2012;01;23;Sunnuntai;1;3;4;1;0;1
96;23.01.2012;2012;01;00;Maanantai;3;2;5;1;0;1
96;23.01.2012;2012;01;01;Maanantai;0;0;0;0;0;0
96;23.01.2012;2012;01;02;Maanantai;0;0;0;2;0;2
96;23.01.2012;2012;01;03;Maanantai;0;2;2;6;4;10
96;23.01.2012;2012;01;04;Maanantai;0;3;3;0;0;0
96;23.01.2012;2012;01;05;Maanantai;0;5;5;1;0;1
96;23.01.2012;2012;01;06;Maanantai;28;23;51;8;4;12
96;23.01.2012;2012;01;07;Maanantai;69;58;127;36;11;47
96;23.01.2012;2012;01;08;Maanantai;83;77;160;18;14;32
96;23.01.2012;2012;01;09;Maanantai;29;44;73;25;15;40
96;23.01.2012;2012;01;10;Maanantai;25;35;60;8;17;25
96;23.01.2012;2012;01;11;Maanantai;34;37;71;11;11;22
96;23.01.2012;2012;01;12;Maanantai;44;43;87;8;5;13
96;23.01.2012;2012;01;13;Maanantai;29;41;70;7;12;19
96;23.01.2012;2012;01;14;Maanantai;39;57;96;11;14;25
96;23.01.2012;2012;01;15;Maanantai;48;128;176;12;47;59
96;23.01.2012;2012;01;16;Maanantai;62;129;191;17;49;66
96;23.01.2012;2012;01;17;Maanantai;49;38;87;13;19;32
96;23.01.2012;2012;01;18;Maanantai;42;49;91;21;25;46
96;23.01.2012;2012;01;19;Maanantai;25;30;55;10;20;30
96;23.01.2012;2012;01;20;Maanantai;42;17;59;12;15;27
96;23.01.2012;2012;01;21;Maanantai;24;16;40;4;7;11
96;23.01.2012;2012;01;22;Maanantai;4;1;5;2;2;4
96;23.01.2012;2012;01;23;Maanantai;3;3;6;0;0;0
96;24.01.2012;2012;01;00;Tiistai;0;0;0;1;0;1
96;24.01.2012;2012;01;01;Tiistai;2;0;2;0;0;0
96;24.01.2012;2012;01;02;Tiistai;0;0;0;1;0;1
96;24.01.2012;2012;01;03;Tiistai;0;0;0;0;0;0
96;24.01.2012;2012;01;04;Tiistai;1;1;2;0;0;0
96;24.01.2012;2012;01;05;Tiistai;1;7;8;0;0;0
96;24.01.2012;2012;01;06;Tiistai;32;26;58;13;7;20
96;24.01.2012;2012;01;07;Tiistai;67;64;131;34;21;55
96;24.01.2012;2012;01;08;Tiistai;83;64;147;24;13;37
96;24.01.2012;2012;01;09;Tiistai;44;55;99;16;11;27
96;24.01.2012;2012;01;10;Tiistai;26;30;56;7;7;14
96;24.01.2012;2012;01;11;Tiistai;24;27;51;11;13;24
96;24.01.2012;2012;01;12;Tiistai;38;43;81;18;29;47
96;24.01.2012;2012;01;13;Tiistai;21;42;63;19;20;39
96;24.01.2012;2012;01;14;Tiistai;39;62;101;4;19;23
96;24.01.2012;2012;01;15;Tiistai;46;150;196;8;45;53
96;24.01.2012;2012;01;16;Tiistai;56;113;169;19;48;67
96;24.01.2012;2012;01;17;Tiistai;41;53;94;9;10;19
96;24.01.2012;2012;01;18;Tiistai;30;34;64;10;27;37
96;24.01.2012;2012;01;19;Tiistai;17;26;43;11;13;24
96;24.01.2012;2012;01;20;Tiistai;45;20;65;17;7;24
96;24.01.2012;2012;01;21;Tiistai;25;21;46;6;6;12
96;24.01.2012;2012;01;22;Tiistai;4;7;11;2;5;7
96;24.01.2012;2012;01;23;Tiistai;2;1;3;0;1;1
96;25.01.2012;2012;01;00;Keskiviikko;3;0;3;0;0;0
96;25.01.2012;2012;01;01;Keskiviikko;0;0;0;0;0;0
96;25.01.2012;2012;01;02;Keskiviikko;1;0;1;0;2;2
96;25.01.2012;2012;01;03;Keskiviikko;0;0;0;0;0;0
96;25.01.2012;2012;01;04;Keskiviikko;2;3;5;1;0;1
96;25.01.2012;2012;01;05;Keskiviikko;3;3;6;1;0;1
96;25.01.2012;2012;01;06;Keskiviikko;26;26;52;16;4;20
96;25.01.2012;2012;01;07;Keskiviikko;60;55;115;34;18;52
96;25.01.2012;2012;01;08;Keskiviikko;85;63;148;29;9;38
96;25.01.2012;2012;01;09;Keskiviikko;33;42;75;11;4;15
96;25.01.2012;2012;01;10;Keskiviikko;19;23;42;6;9;15
96;25.01.2012;2012;01;11;Keskiviikko;21;30;51;6;9;15
96;25.01.2012;2012;01;12;Keskiviikko;36;35;71;9;7;16
96;25.01.2012;2012;01;13;Keskiviikko;28;30;58;6;10;16
96;25.01.2012;2012;01;14;Keskiviikko;18;59;77;7;17;24
96;25.01.2012;2012;01;15;Keskiviikko;44;110;154;10;41;51
96;25.01.2012;2012;01;16;Keskiviikko;48;89;137;12;49;61
96;25.01.2012;2012;01;17;Keskiviikko;49;38;87;11;21;32
96;25.01.2012;2012;01;18;Keskiviikko;33;28;61;8;18;26
96;25.01.2012;2012;01;19;Keskiviikko;34;33;67;16;14;30
96;25.01.2012;2012;01;20;Keskiviikko;18;20;38;8;6;14
96;25.01.2012;2012;01;21;Keskiviikko;14;27;41;6;8;14
96;25.01.2012;2012;01;22;Keskiviikko;10;5;15;2;5;7
96;25.01.2012;2012;01;23;Keskiviikko;4;6;10;0;0;0
96;26.01.2012;2012;01;00;Torstai;3;3;6;0;0;0
96;26.01.2012;2012;01;01;Torstai;2;1;3;0;0;0
96;26.01.2012;2012;01;02;Torstai;1;0;1;1;0;1
96;26.01.2012;2012;01;03;Torstai;0;0;0;1;0;1
96;26.01.2012;2012;01;04;Torstai;6;1;7;0;0;0
96;26.01.2012;2012;01;05;Torstai;3;5;8;0;0;0
96;26.01.2012;2012;01;06;Torstai;29;21;50;12;6;18
96;26.01.2012;2012;01;07;Torstai;62;54;116;26;16;42
96;26.01.2012;2012;01;08;Torstai;75;72;147;18;8;26
96;26.01.2012;2012;01;09;Torstai;31;43;74;11;13;24
96;26.01.2012;2012;01;10;Torstai;19;31;50;9;6;15
96;26.01.2012;2012;01;11;Torstai;31;35;66;6;16;22
96;26.01.2012;2012;01;12;Torstai;45;29;74;7;9;16
96;26.01.2012;2012;01;13;Torstai;25;40;65;12;7;19
96;26.01.2012;2012;01;14;Torstai;34;55;89;3;30;33
96;26.01.2012;2012;01;15;Torstai;53;122;175;11;41;52
96;26.01.2012;2012;01;16;Torstai;63;95;158;16;37;53
96;26.01.2012;2012;01;17;Torstai;36;47;83;14;17;31
96;26.01.2012;2012;01;18;Torstai;31;24;55;10;12;22
96;26.01.2012;2012;01;19;Torstai;26;27;53;15;11;26
96;26.01.2012;2012;01;20;Torstai;23;15;38;11;25;36
96;26.01.2012;2012;01;21;Torstai;18;7;25;4;8;12
96;26.01.2012;2012;01;22;Torstai;7;7;14;2;3;5
96;26.01.2012;2012;01;23;Torstai;3;1;4;0;0;0
96;27.01.2012;2012;01;00;Perjantai;0;1;1;0;0;0
96;27.01.2012;2012;01;01;Perjantai;4;0;4;0;0;0
96;27.01.2012;2012;01;02;Perjantai;0;0;0;1;0;1
96;27.01.2012;2012;01;03;Perjantai;0;0;0;0;0;0
96;27.01.2012;2012;01;04;Perjantai;1;2;3;0;0;0
96;27.01.2012;2012;01;05;Perjantai;2;5;7;0;0;0
96;27.01.2012;2012;01;06;Perjantai;24;17;41;6;2;8
96;27.01.2012;2012;01;07;Perjantai;62;38;100;24;17;41
96;27.01.2012;2012;01;08;Perjantai;71;37;108;17;5;22
96;27.01.2012;2012;01;09;Perjantai;27;28;55;11;9;20
96;27.01.2012;2012;01;10;Perjantai;18;35;53;8;9;17
96;27.01.2012;2012;01;11;Perjantai;22;40;62;3;19;22
96;27.01.2012;2012;01;12;Perjantai;25;51;76;8;18;26
96;27.01.2012;2012;01;13;Perjantai;42;48;90;9;20;29
96;27.01.2012;2012;01;14;Perjantai;48;53;101;9;40;49
96;27.01.2012;2012;01;15;Perjantai;31;81;112;8;45;53
96;27.01.2012;2012;01;16;Perjantai;41;61;102;8;25;33
96;27.01.2012;2012;01;17;Perjantai;31;19;50;3;17;20
96;27.01.2012;2012;01;18;Perjantai;22;22;44;9;5;14
96;27.01.2012;2012;01;19;Perjantai;16;11;27;4;6;10
96;27.01.2012;2012;01;20;Perjantai;13;9;22;4;8;12
96;27.01.2012;2012;01;21;Perjantai;11;13;24;1;8;9
96;27.01.2012;2012;01;22;Perjantai;5;5;10;3;4;7
96;27.01.2012;2012;01;23;Perjantai;2;0;2;0;1;1
96;28.01.2012;2012;01;00;Lauantai;4;0;4;0;0;0
96;28.01.2012;2012;01;01;Lauantai;6;0;6;0;0;0
96;28.01.2012;2012;01;02;Lauantai;3;1;4;0;0;0
96;28.01.2012;2012;01;03;Lauantai;9;0;9;0;0;0
96;28.01.2012;2012;01;04;Lauantai;1;0;1;1;0;1
96;28.01.2012;2012;01;05;Lauantai;1;0;1;1;0;1
96;28.01.2012;2012;01;06;Lauantai;12;2;14;3;0;3
96;28.01.2012;2012;01;07;Lauantai;4;8;12;3;3;6
96;28.01.2012;2012;01;08;Lauantai;6;4;10;3;2;5
96;28.01.2012;2012;01;09;Lauantai;6;10;16;2;3;5
96;28.01.2012;2012;01;10;Lauantai;4;16;20;6;4;10
96;28.01.2012;2012;01;11;Lauantai;11;26;37;3;2;5
96;28.01.2012;2012;01;12;Lauantai;13;12;25;6;10;16
96;28.01.2012;2012;01;13;Lauantai;14;18;32;9;15;24
96;28.01.2012;2012;01;14;Lauantai;15;23;38;4;10;14
96;28.01.2012;2012;01;15;Lauantai;22;20;42;7;14;21
96;28.01.2012;2012;01;16;Lauantai;12;9;21;3;3;6
96;28.01.2012;2012;01;17;Lauantai;11;8;19;7;3;10
96;28.01.2012;2012;01;18;Lauantai;19;8;27;15;11;26
96;28.01.2012;2012;01;19;Lauantai;17;8;25;15;3;18
96;28.01.2012;2012;01;20;Lauantai;7;8;15;4;1;5
96;28.01.2012;2012;01;21;Lauantai;3;5;8;3;6;9
96;28.01.2012;2012;01;22;Lauantai;1;12;13;3;5;8
96;28.01.2012;2012;01;23;Lauantai;3;3;6;1;1;2
96;29.01.2012;2012;01;00;Sunnuntai;2;8;10;0;1;1
96;29.01.2012;2012;01;01;Sunnuntai;2;1;3;1;1;2
96;29.01.2012;2012;01;02;Sunnuntai;1;0;1;1;0;1
96;29.01.2012;2012;01;03;Sunnuntai;3;1;4;0;0;0
96;29.01.2012;2012;01;04;Sunnuntai;2;0;2;0;0;0
96;29.01.2012;2012;01;05;Sunnuntai;1;0;1;1;0;1
96;29.01.2012;2012;01;06;Sunnuntai;7;3;10;0;0;0
96;29.01.2012;2012;01;07;Sunnuntai;1;1;2;1;2;3
96;29.01.2012;2012;01;08;Sunnuntai;1;1;2;2;3;5
96;29.01.2012;2012;01;09;Sunnuntai;2;4;6;5;3;8
96;29.01.2012;2012;01;10;Sunnuntai;3;5;8;4;7;11
96;29.01.2012;2012;01;11;Sunnuntai;7;7;14;0;9;9
96;29.01.2012;2012;01;12;Sunnuntai;6;9;15;5;8;13
96;29.01.2012;2012;01;13;Sunnuntai;17;10;27;6;7;13
96;29.01.2012;2012;01;14;Sunnuntai;14;8;22;13;10;23
96;29.01.2012;2012;01;15;Sunnuntai;13;14;27;5;11;16
96;29.01.2012;2012;01;16;Sunnuntai;11;10;21;13;10;23
96;29.01.2012;2012;01;17;Sunnuntai;7;11;18;9;4;13
96;29.01.2012;2012;01;18;Sunnuntai;25;8;33;10;3;13
96;29.01.2012;2012;01;19;Sunnuntai;10;9;19;3;7;10
96;29.01.2012;2012;01;20;Sunnuntai;7;14;21;3;6;9
96;29.01.2012;2012;01;21;Sunnuntai;8;19;27;6;12;18
96;29.01.2012;2012;01;22;Sunnuntai;2;1;3;1;2;3
96;29.01.2012;2012;01;23;Sunnuntai;0;1;1;1;1;2
96;30.01.2012;2012;01;00;Maanantai;0;0;0;0;0;0
96;30.01.2012;2012;01;01;Maanantai;0;0;0;0;0;0
96;30.01.2012;2012;01;02;Maanantai;1;0;1;0;0;0
96;30.01.2012;2012;01;03;Maanantai;0;0;0;1;0;1
96;30.01.2012;2012;01;04;Maanantai;2;1;3;0;1;1
96;30.01.2012;2012;01;05;Maanantai;1;3;4;1;0;1
96;30.01.2012;2012;01;06;Maanantai;18;13;31;6;4;10
96;30.01.2012;2012;01;07;Maanantai;55;34;89;35;14;49
96;30.01.2012;2012;01;08;Maanantai;57;44;101;13;5;18
96;30.01.2012;2012;01;09;Maanantai;40;25;65;8;14;22
96;30.01.2012;2012;01;10;Maanantai;21;15;36;6;4;10
96;30.01.2012;2012;01;11;Maanantai;24;20;44;5;7;12
96;30.01.2012;2012;01;12;Maanantai;23;37;60;10;14;24
96;30.01.2012;2012;01;13;Maanantai;28;27;55;6;15;21
96;30.01.2012;2012;01;14;Maanantai;20;44;64;6;17;23
96;30.01.2012;2012;01;15;Maanantai;29;91;120;12;28;40
96;30.01.2012;2012;01;16;Maanantai;43;89;132;17;51;68
96;30.01.2012;2012;01;17;Maanantai;33;19;52;9;19;28
96;30.01.2012;2012;01;18;Maanantai;23;23;46;5;8;13
96;30.01.2012;2012;01;19;Maanantai;14;18;32;7;8;15
96;30.01.2012;2012;01;20;Maanantai;27;11;38;5;12;17
96;30.01.2012;2012;01;21;Maanantai;19;10;29;4;7;11
96;30.01.2012;2012;01;22;Maanantai;4;4;8;3;1;4
96;30.01.2012;2012;01;23;Maanantai;3;3;6;0;1;1
96;31.01.2012;2012;01;00;Tiistai;0;0;0;0;1;1
96;31.01.2012;2012;01;01;Tiistai;0;0;0;0;0;0
96;31.01.2012;2012;01;02;Tiistai;0;0;0;0;0;0
96;31.01.2012;2012;01;03;Tiistai;0;0;0;0;0;0
96;31.01.2012;2012;01;04;Tiistai;1;2;3;0;0;0
96;31.01.2012;2012;01;05;Tiistai;2;2;4;1;0;1
96;31.01.2012;2012;01;06;Tiistai;19;9;28;4;3;7
96;31.01.2012;2012;01;07;Tiistai;63;38;101;31;15;46
96;31.01.2012;2012;01;08;Tiistai;65;51;116;12;8;20
96;31.01.2012;2012;01;09;Tiistai;25;23;48;7;8;15
96;31.01.2012;2012;01;10;Tiistai;20;23;43;3;6;9
96;31.01.2012;2012;01;11;Tiistai;17;17;34;6;8;14
96;31.01.2012;2012;01;12;Tiistai;19;28;47;12;12;24
96;31.01.2012;2012;01;13;Tiistai;12;17;29;1;14;15
96;31.01.2012;2012;01;14;Tiistai;42;68;110;10;18;28
96;31.01.2012;2012;01;15;Tiistai;33;93;126;11;42;53
96;31.01.2012;2012;01;16;Tiistai;33;86;119;10;42;52
96;31.01.2012;2012;01;17;Tiistai;17;24;41;6;16;22
96;31.01.2012;2012;01;18;Tiistai;29;29;58;9;16;25
96;31.01.2012;2012;01;19;Tiistai;21;14;35;6;15;21
96;31.01.2012;2012;01;20;Tiistai;21;12;33;10;5;15
96;31.01.2012;2012;01;21;Tiistai;17;9;26;5;5;10
96;31.01.2012;2012;01;22;Tiistai;8;1;9;4;1;5
96;31.01.2012;2012;01;23;Tiistai;2;0;2;0;1;1
96;01.02.2012;2012;02;00;Keskiviikko;2;0;2;0;0;0
96;01.02.2012;2012;02;01;Keskiviikko;2;2;4;0;1;1
96;01.02.2012;2012;02;02;Keskiviikko;1;1;2;0;0;0
96;01.02.2012;2012;02;03;Keskiviikko;0;0;0;0;0;0
96;01.02.2012;2012;02;04;Keskiviikko;2;0;2;0;0;0
96;01.02.2012;2012;02;05;Keskiviikko;2;2;4;1;0;1
96;01.02.2012;2012;02;06;Keskiviikko;19;16;35;3;4;7
96;01.02.2012;2012;02;07;Keskiviikko;55;43;98;25;7;32
96;01.02.2012;2012;02;08;Keskiviikko;73;26;99;20;10;30
96;01.02.2012;2012;02;09;Keskiviikko;22;25;47;11;9;20
96;01.02.2012;2012;02;10;Keskiviikko;26;12;38;11;3;14
96;01.02.2012;2012;02;11;Keskiviikko;18;20;38;6;10;16
96;01.02.2012;2012;02;12;Keskiviikko;26;27;53;7;7;14
96;01.02.2012;2012;02;13;Keskiviikko;23;22;45;4;15;19
96;01.02.2012;2012;02;14;Keskiviikko;41;49;90;4;20;24
96;01.02.2012;2012;02;15;Keskiviikko;29;92;121;6;43;49
96;01.02.2012;2012;02;16;Keskiviikko;30;67;97;10;38;48
96;01.02.2012;2012;02;17;Keskiviikko;22;23;45;5;8;13
96;01.02.2012;2012;02;18;Keskiviikko;32;32;64;8;14;22
96;01.02.2012;2012;02;19;Keskiviikko;17;18;35;9;6;15
96;01.02.2012;2012;02;20;Keskiviikko;23;12;35;3;3;6
96;01.02.2012;2012;02;21;Keskiviikko;4;16;20;4;8;12
96;01.02.2012;2012;02;22;Keskiviikko;5;0;5;0;2;2
96;01.02.2012;2012;02;23;Keskiviikko;3;2;5;1;1;2
96;02.02.2012;2012;02;00;Torstai;2;0;2;0;0;0
96;02.02.2012;2012;02;01;Torstai;1;0;1;0;0;0
96;02.02.2012;2012;02;02;Torstai;4;0;4;0;1;1
96;02.02.2012;2012;02;03;Torstai;2;1;3;1;0;1
96;02.02.2012;2012;02;04;Torstai;2;1;3;0;0;0
96;02.02.2012;2012;02;05;Torstai;0;2;2;0;0;0
96;02.02.2012;2012;02;06;Torstai;17;7;24;2;2;4
96;02.02.2012;2012;02;07;Torstai;50;27;77;20;11;31
96;02.02.2012;2012;02;08;Torstai;57;36;93;20;6;26
96;02.02.2012;2012;02;09;Torstai;22;17;39;3;5;8
96;02.02.2012;2012;02;10;Torstai;19;19;38;6;6;12
96;02.02.2012;2012;02;11;Torstai;16;14;30;5;8;13
96;02.02.2012;2012;02;12;Torstai;20;24;44;12;10;22
96;02.02.2012;2012;02;13;Torstai;23;19;42;6;10;16
96;02.02.2012;2012;02;14;Torstai;28;40;68;3;22;25
96;02.02.2012;2012;02;15;Torstai;17;85;102;9;41;50
96;02.02.2012;2012;02;16;Torstai;33;59;92;13;37;50
96;02.02.2012;2012;02;17;Torstai;20;28;48;10;8;18
96;02.02.2012;2012;02;18;Torstai;18;19;37;5;10;15
96;02.02.2012;2012;02;19;Torstai;13;18;31;2;9;11
96;02.02.2012;2012;02;20;Torstai;25;12;37;9;7;16
96;02.02.2012;2012;02;21;Torstai;11;7;18;2;4;6
96;02.02.2012;2012;02;22;Torstai;4;3;7;0;4;4
96;02.02.2012;2012;02;23;Torstai;2;0;2;0;0;0
96;03.02.2012;2012;02;00;Perjantai;1;0;1;0;0;0
96;03.02.2012;2012;02;01;Perjantai;1;0;1;0;0;0
96;03.02.2012;2012;02;02;Perjantai;1;0;1;0;0;0
96;03.02.2012;2012;02;03;Perjantai;1;0;1;0;0;0
96;03.02.2012;2012;02;04;Perjantai;1;2;3;0;0;0
96;03.02.2012;2012;02;05;Perjantai;0;2;2;2;0;2
96;03.02.2012;2012;02;06;Perjantai;15;9;24;4;2;6
96;03.02.2012;2012;02;07;Perjantai;46;28;74;16;12;28
96;03.02.2012;2012;02;08;Perjantai;48;33;81;18;7;25
96;03.02.2012;2012;02;09;Perjantai;23;20;43;6;3;9
96;03.02.2012;2012;02;10;Perjantai;21;22;43;7;4;11
96;03.02.2012;2012;02;11;Perjantai;19;16;35;6;8;14
96;03.02.2012;2012;02;12;Perjantai;15;28;43;4;13;17
96;03.02.2012;2012;02;13;Perjantai;19;27;46;4;14;18
96;03.02.2012;2012;02;14;Perjantai;27;41;68;7;21;28
96;03.02.2012;2012;02;15;Perjantai;21;74;95;4;36;40
96;03.02.2012;2012;02;16;Perjantai;20;34;54;7;19;26
96;03.02.2012;2012;02;17;Perjantai;20;12;32;7;9;16
96;03.02.2012;2012;02;18;Perjantai;18;17;35;4;4;8
96;03.02.2012;2012;02;19;Perjantai;11;5;16;2;4;6
96;03.02.2012;2012;02;20;Perjantai;10;9;19;3;3;6
96;03.02.2012;2012;02;21;Perjantai;7;4;11;4;4;8
96;03.02.2012;2012;02;22;Perjantai;6;0;6;4;2;6
96;03.02.2012;2012;02;23;Perjantai;3;3;6;0;0;0
96;04.02.2012;2012;02;00;Lauantai;2;0;2;0;0;0
96;04.02.2012;2012;02;01;Lauantai;1;0;1;1;0;1
96;04.02.2012;2012;02;02;Lauantai;1;1;2;0;0;0
96;04.02.2012;2012;02;03;Lauantai;2;1;3;0;0;0
96;04.02.2012;2012;02;04;Lauantai;2;2;4;0;0;0
96;04.02.2012;2012;02;05;Lauantai;2;1;3;0;1;1
96;04.02.2012;2012;02;06;Lauantai;7;3;10;2;0;2
96;04.02.2012;2012;02;07;Lauantai;1;4;5;1;3;4
96;04.02.2012;2012;02;08;Lauantai;4;7;11;1;2;3
96;04.02.2012;2012;02;09;Lauantai;8;7;15;0;2;2
96;04.02.2012;2012;02;10;Lauantai;4;7;11;3;5;8
96;04.02.2012;2012;02;11;Lauantai;2;4;6;2;4;6
96;04.02.2012;2012;02;12;Lauantai;9;7;16;4;6;10
96;04.02.2012;2012;02;13;Lauantai;10;11;21;8;8;16
96;04.02.2012;2012;02;14;Lauantai;11;16;27;2;4;6
96;04.02.2012;2012;02;15;Lauantai;10;11;21;5;10;15
96;04.02.2012;2012;02;16;Lauantai;12;18;30;2;10;12
96;04.02.2012;2012;02;17;Lauantai;17;7;24;10;2;12
96;04.02.2012;2012;02;18;Lauantai;8;6;14;5;4;9
96;04.02.2012;2012;02;19;Lauantai;8;7;15;10;3;13
96;04.02.2012;2012;02;20;Lauantai;6;7;13;0;6;6
96;04.02.2012;2012;02;21;Lauantai;5;8;13;3;4;7
96;04.02.2012;2012;02;22;Lauantai;6;1;7;0;2;2
96;04.02.2012;2012;02;23;Lauantai;2;1;3;0;1;1
96;05.02.2012;2012;02;00;Sunnuntai;4;1;5;0;0;0
96;05.02.2012;2012;02;01;Sunnuntai;3;2;5;1;0;1
96;05.02.2012;2012;02;02;Sunnuntai;1;1;2;0;0;0
96;05.02.2012;2012;02;03;Sunnuntai;2;0;2;2;0;2
96;05.02.2012;2012;02;04;Sunnuntai;2;0;2;0;0;0
96;05.02.2012;2012;02;05;Sunnuntai;1;0;1;1;0;1
96;05.02.2012;2012;02;06;Sunnuntai;9;2;11;2;1;3
96;05.02.2012;2012;02;07;Sunnuntai;2;2;4;3;6;9
96;05.02.2012;2012;02;08;Sunnuntai;4;5;9;0;1;1
96;05.02.2012;2012;02;09;Sunnuntai;6;5;11;1;1;2
96;05.02.2012;2012;02;10;Sunnuntai;2;2;4;1;2;3
96;05.02.2012;2012;02;11;Sunnuntai;3;3;6;1;3;4
96;05.02.2012;2012;02;12;Sunnuntai;7;9;16;5;10;15
96;05.02.2012;2012;02;13;Sunnuntai;4;1;5;4;2;6
96;05.02.2012;2012;02;14;Sunnuntai;9;9;18;1;4;5
96;05.02.2012;2012;02;15;Sunnuntai;4;15;19;2;9;11
96;05.02.2012;2012;02;16;Sunnuntai;14;6;20;10;3;13
96;05.02.2012;2012;02;17;Sunnuntai;9;4;13;6;3;9
96;05.02.2012;2012;02;18;Sunnuntai;8;9;17;6;8;14
96;05.02.2012;2012;02;19;Sunnuntai;5;9;14;1;14;15
96;05.02.2012;2012;02;20;Sunnuntai;9;1;10;2;3;5
96;05.02.2012;2012;02;21;Sunnuntai;9;5;14;1;4;5
96;05.02.2012;2012;02;22;Sunnuntai;0;0;0;2;0;2
96;05.02.2012;2012;02;23;Sunnuntai;1;3;4;0;1;1
96;06.02.2012;2012;02;00;Maanantai;1;0;1;0;0;0
96;06.02.2012;2012;02;01;Maanantai;2;0;2;0;0;0
96;06.02.2012;2012;02;02;Maanantai;0;0;0;1;0;1
96;06.02.2012;2012;02;03;Maanantai;1;0;1;0;0;0
96;06.02.2012;2012;02;04;Maanantai;4;4;8;0;0;0
96;06.02.2012;2012;02;05;Maanantai;5;3;8;0;0;0
96;06.02.2012;2012;02;06;Maanantai;27;25;52;1;0;1
96;06.02.2012;2012;02;07;Maanantai;60;58;118;0;0;0
96;06.02.2012;2012;02;08;Maanantai;63;62;125;0;0;0
96;06.02.2012;2012;02;09;Maanantai;39;37;76;0;0;0
96;06.02.2012;2012;02;10;Maanantai;25;22;47;0;0;0
96;06.02.2012;2012;02;11;Maanantai;30;27;57;0;0;0
96;06.02.2012;2012;02;12;Maanantai;35;33;68;0;0;0
96;06.02.2012;2012;02;13;Maanantai;31;30;61;0;0;0
96;06.02.2012;2012;02;14;Maanantai;42;39;81;0;0;0
96;06.02.2012;2012;02;15;Maanantai;78;76;154;0;0;0
96;06.02.2012;2012;02;16;Maanantai;72;71;143;0;0;0
96;06.02.2012;2012;02;17;Maanantai;38;35;73;0;0;0
96;06.02.2012;2012;02;18;Maanantai;27;25;52;0;0;0
96;06.02.2012;2012;02;19;Maanantai;28;24;52;0;0;0
96;06.02.2012;2012;02;20;Maanantai;20;19;39;0;0;0
96;06.02.2012;2012;02;21;Maanantai;16;14;30;0;0;0
96;06.02.2012;2012;02;22;Maanantai;5;3;8;0;0;0
96;06.02.2012;2012;02;23;Maanantai;3;1;4;0;0;0
96;07.02.2012;2012;02;00;Tiistai;1;0;1;0;0;0
96;07.02.2012;2012;02;01;Tiistai;1;0;1;0;0;0
96;07.02.2012;2012;02;02;Tiistai;0;0;0;0;0;0
96;07.02.2012;2012;02;03;Tiistai;0;0;0;0;0;0
96;07.02.2012;2012;02;04;Tiistai;3;1;4;0;0;0
96;07.02.2012;2012;02;05;Tiistai;1;0;1;0;0;0
96;07.02.2012;2012;02;06;Tiistai;20;18;38;0;0;0
96;07.02.2012;2012;02;07;Tiistai;40;38;78;0;0;0
96;07.02.2012;2012;02;08;Tiistai;52;49;101;0;0;0
96;07.02.2012;2012;02;09;Tiistai;29;28;57;0;0;0
96;07.02.2012;2012;02;10;Tiistai;13;11;24;0;0;0
96;07.02.2012;2012;02;11;Tiistai;12;10;22;0;0;0
96;07.02.2012;2012;02;12;Tiistai;32;29;61;0;0;0
96;07.02.2012;2012;02;13;Tiistai;17;15;32;0;0;0
96;07.02.2012;2012;02;14;Tiistai;21;20;41;0;0;0
96;07.02.2012;2012;02;15;Tiistai;54;50;104;0;0;0
96;07.02.2012;2012;02;16;Tiistai;47;45;92;0;0;0
96;07.02.2012;2012;02;17;Tiistai;22;19;41;0;0;0
96;07.02.2012;2012;02;18;Tiistai;16;16;32;0;0;0
96;07.02.2012;2012;02;19;Tiistai;13;11;24;0;0;0
96;07.02.2012;2012;02;20;Tiistai;13;11;24;0;0;0
96;07.02.2012;2012;02;21;Tiistai;14;12;26;0;0;0
96;07.02.2012;2012;02;22;Tiistai;5;4;9;0;0;0
96;07.02.2012;2012;02;23;Tiistai;1;0;1;0;0;0
96;08.02.2012;2012;02;00;Keskiviikko;2;1;3;0;0;0
96;08.02.2012;2012;02;01;Keskiviikko;0;0;0;0;0;0
96;08.02.2012;2012;02;02;Keskiviikko;0;0;0;0;0;0
96;08.02.2012;2012;02;03;Keskiviikko;0;0;0;0;0;0
96;08.02.2012;2012;02;04;Keskiviikko;3;0;3;0;0;0
96;08.02.2012;2012;02;05;Keskiviikko;2;0;2;0;0;0
96;08.02.2012;2012;02;06;Keskiviikko;20;17;37;0;0;0
96;08.02.2012;2012;02;07;Keskiviikko;42;40;82;0;0;0
96;08.02.2012;2012;02;08;Keskiviikko;49;47;96;0;0;0
96;08.02.2012;2012;02;09;Keskiviikko;28;25;53;0;0;0
96;08.02.2012;2012;02;10;Keskiviikko;18;14;32;0;0;0
96;08.02.2012;2012;02;11;Keskiviikko;19;16;35;0;0;0
96;08.02.2012;2012;02;12;Keskiviikko;22;20;42;0;0;0
96;08.02.2012;2012;02;13;Keskiviikko;24;21;45;0;0;0
96;08.02.2012;2012;02;14;Keskiviikko;40;38;78;0;0;0
96;08.02.2012;2012;02;15;Keskiviikko;51;48;99;0;0;0
96;08.02.2012;2012;02;16;Keskiviikko;44;42;86;0;0;0
96;08.02.2012;2012;02;17;Keskiviikko;25;24;49;0;0;0
96;08.02.2012;2012;02;18;Keskiviikko;32;30;62;0;0;0
96;08.02.2012;2012;02;19;Keskiviikko;25;24;49;0;0;0
96;08.02.2012;2012;02;20;Keskiviikko;21;19;40;0;0;0
96;08.02.2012;2012;02;21;Keskiviikko;12;10;22;0;0;0
96;08.02.2012;2012;02;22;Keskiviikko;6;3;9;0;0;0
96;08.02.2012;2012;02;23;Keskiviikko;5;3;8;0;0;0
96;09.02.2012;2012;02;00;Torstai;2;1;3;0;0;0
96;09.02.2012;2012;02;01;Torstai;2;0;2;0;0;0
96;09.02.2012;2012;02;02;Torstai;1;1;2;0;0;0
96;09.02.2012;2012;02;03;Torstai;1;0;1;0;0;0
96;09.02.2012;2012;02;04;Torstai;3;1;4;0;0;0
96;09.02.2012;2012;02;05;Torstai;2;0;2;0;0;0
96;09.02.2012;2012;02;06;Torstai;18;17;35;0;0;0
96;09.02.2012;2012;02;07;Torstai;43;40;83;0;0;0
96;09.02.2012;2012;02;08;Torstai;58;56;114;0;0;0
96;09.02.2012;2012;02;09;Torstai;24;23;47;0;0;0
96;09.02.2012;2012;02;10;Torstai;15;14;29;0;0;0
96;09.02.2012;2012;02;11;Torstai;20;19;39;0;0;0
96;09.02.2012;2012;02;12;Torstai;29;28;57;0;0;0
96;09.02.2012;2012;02;13;Torstai;25;23;48;0;0;0
96;09.02.2012;2012;02;14;Torstai;38;36;74;0;0;0
96;09.02.2012;2012;02;15;Torstai;58;56;114;0;0;0
96;09.02.2012;2012;02;16;Torstai;54;51;105;0;0;0
96;09.02.2012;2012;02;17;Torstai;25;24;49;0;0;0
96;09.02.2012;2012;02;18;Torstai;18;15;33;0;0;0
96;09.02.2012;2012;02;19;Torstai;23;20;43;0;0;0
96;09.02.2012;2012;02;20;Torstai;16;15;31;0;0;0
96;09.02.2012;2012;02;21;Torstai;14;12;26;0;0;0
96;09.02.2012;2012;02;22;Torstai;4;3;7;0;0;0
96;09.02.2012;2012;02;23;Torstai;1;0;1;0;0;0
96;10.02.2012;2012;02;00;Perjantai;4;1;5;0;0;0
96;10.02.2012;2012;02;01;Perjantai;1;0;1;0;0;0
96;10.02.2012;2012;02;02;Perjantai;1;0;1;0;0;0
96;10.02.2012;2012;02;03;Perjantai;2;1;3;0;0;0
96;10.02.2012;2012;02;04;Perjantai;4;3;7;0;0;0
96;10.02.2012;2012;02;05;Perjantai;5;1;6;0;0;0
96;10.02.2012;2012;02;06;Perjantai;22;21;43;0;0;0
96;10.02.2012;2012;02;07;Perjantai;52;50;102;0;0;0
96;10.02.2012;2012;02;08;Perjantai;66;64;130;0;0;0
96;10.02.2012;2012;02;09;Perjantai;34;33;67;0;0;0
96;10.02.2012;2012;02;10;Perjantai;31;30;61;0;0;0
96;10.02.2012;2012;02;11;Perjantai;36;34;70;0;0;0
96;10.02.2012;2012;02;12;Perjantai;32;31;63;0;0;0
96;10.02.2012;2012;02;13;Perjantai;42;40;82;0;0;0
96;10.02.2012;2012;02;14;Perjantai;54;52;106;0;0;0
96;10.02.2012;2012;02;15;Perjantai;74;73;147;0;0;0
96;10.02.2012;2012;02;16;Perjantai;53;52;105;0;0;0
96;10.02.2012;2012;02;17;Perjantai;36;33;69;0;0;0
96;10.02.2012;2012;02;18;Perjantai;20;19;39;0;0;0
96;10.02.2012;2012;02;19;Perjantai;18;14;32;0;0;0
96;10.02.2012;2012;02;20;Perjantai;18;15;33;0;0;0
96;10.02.2012;2012;02;21;Perjantai;20;17;37;0;0;0
96;10.02.2012;2012;02;22;Perjantai;9;7;16;0;0;0
96;10.02.2012;2012;02;23;Perjantai;8;5;13;0;0;0
96;11.02.2012;2012;02;00;Lauantai;4;2;6;0;0;0
96;11.02.2012;2012;02;01;Lauantai;3;2;5;0;0;0
96;11.02.2012;2012;02;02;Lauantai;7;4;11;0;0;0
96;11.02.2012;2012;02;03;Lauantai;3;1;4;0;0;0
96;11.02.2012;2012;02;04;Lauantai;3;2;5;0;0;0
96;11.02.2012;2012;02;05;Lauantai;1;1;2;0;0;0
96;11.02.2012;2012;02;06;Lauantai;12;9;21;0;0;0
96;11.02.2012;2012;02;07;Lauantai;4;3;7;0;0;0
96;11.02.2012;2012;02;08;Lauantai;7;4;11;0;0;0
96;11.02.2012;2012;02;09;Lauantai;18;17;35;0;0;0
96;11.02.2012;2012;02;10;Lauantai;22;21;43;0;0;0
96;11.02.2012;2012;02;11;Lauantai;19;17;36;0;0;0
96;11.02.2012;2012;02;12;Lauantai;27;23;50;0;0;0
96;11.02.2012;2012;02;13;Lauantai;29;29;58;0;0;0
96;11.02.2012;2012;02;14;Lauantai;26;25;51;0;0;0
96;11.02.2012;2012;02;15;Lauantai;22;20;42;0;0;0
96;11.02.2012;2012;02;16;Lauantai;23;20;43;0;0;0
96;11.02.2012;2012;02;17;Lauantai;19;17;36;0;0;0
96;11.02.2012;2012;02;18;Lauantai;20;18;38;0;0;0
96;11.02.2012;2012;02;19;Lauantai;17;14;31;0;0;0
96;11.02.2012;2012;02;20;Lauantai;11;9;20;0;0;0
96;11.02.2012;2012;02;21;Lauantai;14;12;26;0;0;0
96;11.02.2012;2012;02;22;Lauantai;6;4;10;0;0;0
96;11.02.2012;2012;02;23;Lauantai;7;4;11;0;0;0
96;12.02.2012;2012;02;00;Sunnuntai;2;1;3;0;0;0
96;12.02.2012;2012;02;01;Sunnuntai;4;1;5;0;0;0
96;12.02.2012;2012;02;02;Sunnuntai;4;2;6;0;0;0
96;12.02.2012;2012;02;03;Sunnuntai;7;6;13;0;0;0
96;12.02.2012;2012;02;04;Sunnuntai;1;0;1;0;0;0
96;12.02.2012;2012;02;05;Sunnuntai;0;0;0;0;0;0
96;12.02.2012;2012;02;06;Sunnuntai;4;3;7;0;0;0
96;12.02.2012;2012;02;07;Sunnuntai;4;4;8;0;0;0
96;12.02.2012;2012;02;08;Sunnuntai;4;3;7;0;0;0
96;12.02.2012;2012;02;09;Sunnuntai;5;3;8;0;0;0
96;12.02.2012;2012;02;10;Sunnuntai;7;5;12;0;0;0
96;12.02.2012;2012;02;11;Sunnuntai;9;9;18;0;0;0
96;12.02.2012;2012;02;12;Sunnuntai;10;9;19;0;0;0
96;12.02.2012;2012;02;13;Sunnuntai;14;12;26;0;0;0
96;12.02.2012;2012;02;14;Sunnuntai;20;17;37;0;0;0
96;12.02.2012;2012;02;15;Sunnuntai;13;9;22;0;0;0
96;12.02.2012;2012;02;16;Sunnuntai;19;19;38;0;0;0
96;12.02.2012;2012;02;17;Sunnuntai;17;17;34;0;0;0
96;12.02.2012;2012;02;18;Sunnuntai;24;21;45;0;0;0
96;12.02.2012;2012;02;19;Sunnuntai;11;8;19;0;0;0
96;12.02.2012;2012;02;20;Sunnuntai;19;17;36;0;0;0
96;12.02.2012;2012;02;21;Sunnuntai;9;9;18;0;0;0
96;12.02.2012;2012;02;22;Sunnuntai;3;1;4;0;0;0
96;12.02.2012;2012;02;23;Sunnuntai;3;0;3;0;0;0
96;13.02.2012;2012;02;00;Maanantai;2;1;3;0;0;0
96;13.02.2012;2012;02;01;Maanantai;1;1;2;0;0;0
96;13.02.2012;2012;02;02;Maanantai;0;0;0;0;0;0
96;13.02.2012;2012;02;03;Maanantai;0;0;0;0;0;0
96;13.02.2012;2012;02;04;Maanantai;4;2;6;0;0;0
96;13.02.2012;2012;02;05;Maanantai;5;4;9;0;0;0
96;13.02.2012;2012;02;06;Maanantai;25;25;50;0;0;0
96;13.02.2012;2012;02;07;Maanantai;69;66;135;0;0;0
96;13.02.2012;2012;02;08;Maanantai;83;82;165;0;0;0
96;13.02.2012;2012;02;09;Maanantai;46;45;91;0;0;0
96;13.02.2012;2012;02;10;Maanantai;36;36;72;0;0;0
96;13.02.2012;2012;02;11;Maanantai;44;41;85;0;0;0
96;13.02.2012;2012;02;12;Maanantai;41;39;80;0;0;0
96;13.02.2012;2012;02;13;Maanantai;42;39;81;0;0;0
96;13.02.2012;2012;02;14;Maanantai;56;53;109;0;0;0
96;13.02.2012;2012;02;15;Maanantai;90;89;179;0;0;0
96;13.02.2012;2012;02;16;Maanantai;89;87;176;0;0;0
96;13.02.2012;2012;02;17;Maanantai;48;47;95;0;0;0
96;13.02.2012;2012;02;18;Maanantai;37;34;71;0;0;0
96;13.02.2012;2012;02;19;Maanantai;30;28;58;0;0;0
96;13.02.2012;2012;02;20;Maanantai;24;21;45;0;0;0
96;13.02.2012;2012;02;21;Maanantai;16;14;30;0;0;0
96;13.02.2012;2012;02;22;Maanantai;5;3;8;0;0;0
96;13.02.2012;2012;02;23;Maanantai;2;1;3;0;0;0
96;14.02.2012;2012;02;00;Tiistai;1;1;2;0;0;0
96;14.02.2012;2012;02;01;Tiistai;0;0;0;0;0;0
96;14.02.2012;2012;02;02;Tiistai;2;0;2;0;0;0
96;14.02.2012;2012;02;03;Tiistai;0;0;0;0;0;0
96;14.02.2012;2012;02;04;Tiistai;4;2;6;0;0;0
96;14.02.2012;2012;02;05;Tiistai;4;2;6;0;0;0
96;14.02.2012;2012;02;06;Tiistai;27;24;51;0;0;0
96;14.02.2012;2012;02;07;Tiistai;62;59;121;0;0;0
96;14.02.2012;2012;02;08;Tiistai;65;63;128;0;0;0
96;14.02.2012;2012;02;09;Tiistai;41;40;81;0;0;0
96;14.02.2012;2012;02;10;Tiistai;36;33;69;0;0;0
96;14.02.2012;2012;02;11;Tiistai;25;25;50;0;0;0
96;14.02.2012;2012;02;12;Tiistai;29;25;54;0;0;0
96;14.02.2012;2012;02;13;Tiistai;24;23;47;0;0;0
96;14.02.2012;2012;02;14;Tiistai;42;39;81;0;0;0
96;14.02.2012;2012;02;15;Tiistai;78;76;154;0;0;0
96;14.02.2012;2012;02;16;Tiistai;76;75;151;0;0;0
96;14.02.2012;2012;02;17;Tiistai;36;34;70;0;0;0
96;14.02.2012;2012;02;18;Tiistai;29;26;55;0;0;0
96;14.02.2012;2012;02;19;Tiistai;14;14;28;0;0;0
96;14.02.2012;2012;02;20;Tiistai;20;18;38;0;0;0
96;14.02.2012;2012;02;21;Tiistai;14;13;27;0;0;0
96;14.02.2012;2012;02;22;Tiistai;3;2;5;0;0;0
96;14.02.2012;2012;02;23;Tiistai;3;2;5;0;0;0
96;15.02.2012;2012;02;00;Keskiviikko;1;0;1;0;0;0
96;15.02.2012;2012;02;01;Keskiviikko;0;0;0;0;0;0
96;15.02.2012;2012;02;02;Keskiviikko;0;0;0;0;0;0
96;15.02.2012;2012;02;03;Keskiviikko;0;0;0;0;0;0
96;15.02.2012;2012;02;04;Keskiviikko;5;2;7;0;0;0
96;15.02.2012;2012;02;05;Keskiviikko;4;4;8;0;0;0
96;15.02.2012;2012;02;06;Keskiviikko;28;26;54;0;0;0
96;15.02.2012;2012;02;07;Keskiviikko;64;61;125;0;0;0
96;15.02.2012;2012;02;08;Keskiviikko;74;73;147;0;0;0
96;15.02.2012;2012;02;09;Keskiviikko;36;29;65;0;0;0
96;15.02.2012;2012;02;10;Keskiviikko;37;33;70;0;0;0
96;15.02.2012;2012;02;11;Keskiviikko;31;29;60;0;0;0
96;15.02.2012;2012;02;12;Keskiviikko;43;39;82;0;0;0
96;15.02.2012;2012;02;13;Keskiviikko;39;33;72;0;0;0
96;15.02.2012;2012;02;14;Keskiviikko;52;49;101;0;0;0
96;15.02.2012;2012;02;15;Keskiviikko;85;75;160;0;0;0
96;15.02.2012;2012;02;16;Keskiviikko;88;76;164;0;0;0
96;15.02.2012;2012;02;17;Keskiviikko;51;48;99;0;0;0
96;15.02.2012;2012;02;18;Keskiviikko;38;34;72;0;0;0
96;15.02.2012;2012;02;19;Keskiviikko;33;29;62;0;0;0
96;15.02.2012;2012;02;20;Keskiviikko;25;21;46;0;0;0
96;15.02.2012;2012;02;21;Keskiviikko;35;24;59;0;0;0
96;15.02.2012;2012;02;22;Keskiviikko;7;4;11;0;0;0
96;15.02.2012;2012;02;23;Keskiviikko;3;2;5;0;0;0
96;16.02.2012;2012;02;00;Torstai;3;1;4;0;0;0
96;16.02.2012;2012;02;01;Torstai;0;0;0;0;0;0
96;16.02.2012;2012;02;02;Torstai;1;0;1;0;0;0
96;16.02.2012;2012;02;03;Torstai;1;1;2;0;0;0
96;16.02.2012;2012;02;04;Torstai;3;0;3;0;0;0
96;16.02.2012;2012;02;05;Torstai;4;1;5;0;0;0
96;16.02.2012;2012;02;06;Torstai;25;22;47;0;0;0
96;16.02.2012;2012;02;07;Torstai;79;71;150;0;0;0
96;16.02.2012;2012;02;08;Torstai;71;57;128;0;0;0
96;16.02.2012;2012;02;09;Torstai;34;28;62;0;0;0
96;16.02.2012;2012;02;10;Torstai;32;27;59;0;0;0
96;16.02.2012;2012;02;11;Torstai;31;24;55;0;0;0
96;16.02.2012;2012;02;12;Torstai;54;32;86;0;0;0
96;16.02.2012;2012;02;13;Torstai;47;35;82;0;0;0
96;16.02.2012;2012;02;14;Torstai;59;56;115;0;0;0
96;16.02.2012;2012;02;15;Torstai;83;83;166;0;0;0
96;16.02.2012;2012;02;16;Torstai;70;70;140;0;0;0
96;16.02.2012;2012;02;17;Torstai;41;40;81;0;0;0
96;16.02.2012;2012;02;18;Torstai;31;28;59;0;0;0
96;16.02.2012;2012;02;19;Torstai;22;20;42;0;0;0
96;16.02.2012;2012;02;20;Torstai;22;20;42;0;0;0
96;16.02.2012;2012;02;21;Torstai;16;15;31;0;0;0
96;16.02.2012;2012;02;22;Torstai;5;3;8;0;0;0
96;16.02.2012;2012;02;23;Torstai;2;1;3;0;0;0
96;17.02.2012;2012;02;00;Perjantai;0;0;0;0;0;0
96;17.02.2012;2012;02;01;Perjantai;2;0;2;0;0;0
96;17.02.2012;2012;02;02;Perjantai;2;1;3;0;0;0
96;17.02.2012;2012;02;03;Perjantai;2;1;3;0;0;0
96;17.02.2012;2012;02;04;Perjantai;4;1;5;0;0;0
96;17.02.2012;2012;02;05;Perjantai;4;1;5;0;0;0
96;17.02.2012;2012;02;06;Perjantai;21;20;41;0;0;0
96;17.02.2012;2012;02;07;Perjantai;54;53;107;0;0;0
96;17.02.2012;2012;02;08;Perjantai;71;67;138;0;0;0
96;17.02.2012;2012;02;09;Perjantai;35;33;68;0;0;0
96;17.02.2012;2012;02;10;Perjantai;37;36;73;0;0;0
96;17.02.2012;2012;02;11;Perjantai;41;38;79;0;0;0
96;17.02.2012;2012;02;12;Perjantai;45;41;86;0;0;0
96;17.02.2012;2012;02;13;Perjantai;55;54;109;0;0;0
96;17.02.2012;2012;02;14;Perjantai;58;55;113;0;0;0
96;17.02.2012;2012;02;15;Perjantai;71;68;139;0;0;0
96;17.02.2012;2012;02;16;Perjantai;61;59;120;0;0;0
96;17.02.2012;2012;02;17;Perjantai;33;32;65;0;0;0
96;17.02.2012;2012;02;18;Perjantai;24;23;47;0;0;0
96;17.02.2012;2012;02;19;Perjantai;17;15;32;0;0;0
96;17.02.2012;2012;02;20;Perjantai;17;14;31;0;0;0
96;17.02.2012;2012;02;21;Perjantai;20;19;39;0;0;0
96;17.02.2012;2012;02;22;Perjantai;8;5;13;0;0;0
96;17.02.2012;2012;02;23;Perjantai;6;4;10;0;0;0
96;18.02.2012;2012;02;00;Lauantai;6;5;11;0;0;0
96;18.02.2012;2012;02;01;Lauantai;5;4;9;0;0;0
96;18.02.2012;2012;02;02;Lauantai;3;2;5;0;0;0
96;18.02.2012;2012;02;03;Lauantai;4;2;6;0;0;0
96;18.02.2012;2012;02;04;Lauantai;5;3;8;0;0;0
96;18.02.2012;2012;02;05;Lauantai;0;0;0;0;0;0
96;18.02.2012;2012;02;06;Lauantai;9;6;15;0;0;0
96;18.02.2012;2012;02;07;Lauantai;8;6;14;0;0;0
96;18.02.2012;2012;02;08;Lauantai;11;10;21;0;0;0
96;18.02.2012;2012;02;09;Lauantai;16;13;29;0;0;0
96;18.02.2012;2012;02;10;Lauantai;12;10;22;0;0;0
96;18.02.2012;2012;02;11;Lauantai;24;21;45;0;0;0
96;18.02.2012;2012;02;12;Lauantai;22;21;43;0;0;0
96;18.02.2012;2012;02;13;Lauantai;26;23;49;0;0;0
96;18.02.2012;2012;02;14;Lauantai;30;25;55;0;0;0
96;18.02.2012;2012;02;15;Lauantai;40;17;57;0;0;0
96;18.02.2012;2012;02;16;Lauantai;30;7;37;0;0;0
96;18.02.2012;2012;02;17;Lauantai;29;3;32;0;0;0
96;18.02.2012;2012;02;18;Lauantai;33;4;37;0;0;0
96;18.02.2012;2012;02;19;Lauantai;18;2;20;0;0;0
96;18.02.2012;2012;02;20;Lauantai;16;1;17;0;0;0
96;18.02.2012;2012;02;21;Lauantai;21;0;21;0;0;0
96;18.02.2012;2012;02;22;Lauantai;4;0;4;0;0;0
96;18.02.2012;2012;02;23;Lauantai;11;0;11;0;0;0
96;19.02.2012;2012;02;00;Sunnuntai;16;0;16;0;0;0
96;19.02.2012;2012;02;01;Sunnuntai;2;0;2;0;0;0
96;19.02.2012;2012;02;02;Sunnuntai;6;0;6;0;0;0
96;19.02.2012;2012;02;03;Sunnuntai;0;0;0;0;0;0
96;19.02.2012;2012;02;04;Sunnuntai;5;0;5;0;0;0
96;19.02.2012;2012;02;05;Sunnuntai;0;0;0;0;0;0
96;19.02.2012;2012;02;06;Sunnuntai;8;4;12;0;0;0
96;19.02.2012;2012;02;07;Sunnuntai;7;5;12;0;0;0
96;19.02.2012;2012;02;08;Sunnuntai;5;2;7;0;0;0
96;19.02.2012;2012;02;09;Sunnuntai;2;1;3;0;0;0
96;19.02.2012;2012;02;10;Sunnuntai;4;2;6;0;0;0
96;19.02.2012;2012;02;11;Sunnuntai;6;4;10;0;0;0
96;19.02.2012;2012;02;12;Sunnuntai;6;5;11;0;0;0
96;19.02.2012;2012;02;13;Sunnuntai;5;3;8;0;0;0
96;19.02.2012;2012;02;14;Sunnuntai;6;4;10;0;0;0
96;19.02.2012;2012;02;15;Sunnuntai;8;5;13;0;0;0
96;19.02.2012;2012;02;16;Sunnuntai;7;5;12;0;0;0
96;19.02.2012;2012;02;17;Sunnuntai;9;7;16;0;0;0
96;19.02.2012;2012;02;18;Sunnuntai;13;12;25;0;0;0
96;19.02.2012;2012;02;19;Sunnuntai;6;5;11;0;0;0
96;19.02.2012;2012;02;20;Sunnuntai;7;5;12;0;0;0
96;19.02.2012;2012;02;21;Sunnuntai;7;6;13;0;0;0
96;19.02.2012;2012;02;22;Sunnuntai;4;2;6;0;0;0
96;19.02.2012;2012;02;23;Sunnuntai;1;0;1;0;0;0
96;20.02.2012;2012;02;00;Maanantai;1;0;1;0;0;0
96;20.02.2012;2012;02;01;Maanantai;1;0;1;0;0;0
96;20.02.2012;2012;02;02;Maanantai;1;0;1;0;0;0
96;20.02.2012;2012;02;03;Maanantai;1;0;1;0;0;0
96;20.02.2012;2012;02;04;Maanantai;3;1;4;0;0;0
96;20.02.2012;2012;02;05;Maanantai;4;4;8;0;0;0
96;20.02.2012;2012;02;06;Maanantai;22;20;42;0;0;0
96;20.02.2012;2012;02;07;Maanantai;50;48;98;0;0;0
96;20.02.2012;2012;02;08;Maanantai;61;60;121;0;0;0
96;20.02.2012;2012;02;09;Maanantai;47;46;93;0;0;0
96;20.02.2012;2012;02;10;Maanantai;35;33;68;0;0;0
96;20.02.2012;2012;02;11;Maanantai;37;35;72;0;0;0
96;20.02.2012;2012;02;12;Maanantai;37;35;72;0;0;0
96;20.02.2012;2012;02;13;Maanantai;41;39;80;0;0;0
96;20.02.2012;2012;02;14;Maanantai;51;49;100;0;0;0
96;20.02.2012;2012;02;15;Maanantai;86;84;170;0;0;0
96;20.02.2012;2012;02;16;Maanantai;82;80;162;0;0;0
96;20.02.2012;2012;02;17;Maanantai;49;46;95;0;0;0
96;20.02.2012;2012;02;18;Maanantai;40;37;77;0;0;0
96;20.02.2012;2012;02;19;Maanantai;39;37;76;0;0;0
96;20.02.2012;2012;02;20;Maanantai;25;25;50;0;0;0
96;20.02.2012;2012;02;21;Maanantai;18;17;35;0;0;0
96;20.02.2012;2012;02;22;Maanantai;4;4;8;0;0;0
96;20.02.2012;2012;02;23;Maanantai;4;2;6;0;0;0
96;21.02.2012;2012;02;00;Tiistai;2;1;3;0;0;0
96;21.02.2012;2012;02;01;Tiistai;0;0;0;0;0;0
96;21.02.2012;2012;02;02;Tiistai;0;0;0;0;0;0
96;21.02.2012;2012;02;03;Tiistai;0;0;0;0;0;0
96;21.02.2012;2012;02;04;Tiistai;2;1;3;0;0;0
96;21.02.2012;2012;02;05;Tiistai;4;3;7;0;0;0
96;21.02.2012;2012;02;06;Tiistai;25;21;46;0;0;0
96;21.02.2012;2012;02;07;Tiistai;73;72;145;0;0;0
96;21.02.2012;2012;02;08;Tiistai;75;74;149;0;0;0
96;21.02.2012;2012;02;09;Tiistai;31;29;60;0;0;0
96;21.02.2012;2012;02;10;Tiistai;30;29;59;0;0;0
96;21.02.2012;2012;02;11;Tiistai;34;32;66;0;0;0
96;21.02.2012;2012;02;12;Tiistai;39;36;75;0;0;0
96;21.02.2012;2012;02;13;Tiistai;27;25;52;0;0;0
96;21.02.2012;2012;02;14;Tiistai;52;50;102;0;0;0
96;21.02.2012;2012;02;15;Tiistai;93;90;183;0;0;0
96;21.02.2012;2012;02;16;Tiistai;79;78;157;0;0;0
96;21.02.2012;2012;02;17;Tiistai;40;36;76;0;0;0
96;21.02.2012;2012;02;18;Tiistai;22;20;42;0;0;0
96;21.02.2012;2012;02;19;Tiistai;25;23;48;0;0;0
96;21.02.2012;2012;02;20;Tiistai;21;20;41;0;0;0
96;21.02.2012;2012;02;21;Tiistai;19;15;34;0;0;0
96;21.02.2012;2012;02;22;Tiistai;6;3;9;0;0;0
96;21.02.2012;2012;02;23;Tiistai;7;5;12;0;0;0
96;22.02.2012;2012;02;00;Keskiviikko;4;2;6;0;0;0
96;22.02.2012;2012;02;01;Keskiviikko;3;2;5;0;0;0
96;22.02.2012;2012;02;02;Keskiviikko;3;2;5;0;0;0
96;22.02.2012;2012;02;03;Keskiviikko;5;1;6;0;0;0
96;22.02.2012;2012;02;04;Keskiviikko;1;0;1;0;0;0
96;22.02.2012;2012;02;05;Keskiviikko;6;5;11;0;0;0
96;22.02.2012;2012;02;06;Keskiviikko;28;25;53;0;0;0
96;22.02.2012;2012;02;07;Keskiviikko;80;78;158;0;0;0
96;22.02.2012;2012;02;08;Keskiviikko;92;89;181;0;0;0
96;22.02.2012;2012;02;09;Keskiviikko;33;30;63;0;0;0
96;22.02.2012;2012;02;10;Keskiviikko;40;36;76;0;0;0
96;22.02.2012;2012;02;11;Keskiviikko;39;36;75;0;0;0
96;22.02.2012;2012;02;12;Keskiviikko;49;47;96;0;0;0
96;22.02.2012;2012;02;13;Keskiviikko;42;41;83;0;0;0
96;22.02.2012;2012;02;14;Keskiviikko;54;52;106;0;0;0
96;22.02.2012;2012;02;15;Keskiviikko;93;93;186;0;0;0
96;22.02.2012;2012;02;16;Keskiviikko;72;70;142;0;0;0
96;22.02.2012;2012;02;17;Keskiviikko;59;58;117;0;0;0
96;22.02.2012;2012;02;18;Keskiviikko;37;36;73;0;0;0
96;22.02.2012;2012;02;19;Keskiviikko;28;27;55;0;0;0
96;22.02.2012;2012;02;20;Keskiviikko;30;28;58;0;0;0
96;22.02.2012;2012;02;21;Keskiviikko;27;26;53;0;0;0
96;22.02.2012;2012;02;22;Keskiviikko;7;5;12;0;0;0
96;22.02.2012;2012;02;23;Keskiviikko;8;6;14;0;0;0
96;23.02.2012;2012;02;00;Torstai;3;1;4;0;0;0
96;23.02.2012;2012;02;01;Torstai;0;0;0;0;0;0
96;23.02.2012;2012;02;02;Torstai;2;0;2;0;0;0
96;23.02.2012;2012;02;03;Torstai;1;1;2;0;0;0
96;23.02.2012;2012;02;04;Torstai;2;2;4;0;0;0
96;23.02.2012;2012;02;05;Torstai;6;2;8;0;0;0
96;23.02.2012;2012;02;06;Torstai;23;21;44;0;0;0
96;23.02.2012;2012;02;07;Torstai;73;71;144;0;0;0
96;23.02.2012;2012;02;08;Torstai;86;84;170;0;0;0
96;23.02.2012;2012;02;09;Torstai;40;37;77;0;0;0
96;23.02.2012;2012;02;10;Torstai;30;26;56;0;0;0
96;23.02.2012;2012;02;11;Torstai;38;35;73;0;0;0
96;23.02.2012;2012;02;12;Torstai;48;46;94;0;0;0
96;23.02.2012;2012;02;13;Torstai;46;44;90;0;0;0
96;23.02.2012;2012;02;14;Torstai;55;53;108;0;0;0
96;23.02.2012;2012;02;15;Torstai;92;88;180;0;0;0
96;23.02.2012;2012;02;16;Torstai;73;73;146;0;0;0
96;23.02.2012;2012;02;17;Torstai;44;42;86;0;0;0
96;23.02.2012;2012;02;18;Torstai;36;33;69;0;0;0
96;23.02.2012;2012;02;19;Torstai;18;17;35;0;0;0
96;23.02.2012;2012;02;20;Torstai;24;22;46;0;0;0
96;23.02.2012;2012;02;21;Torstai;17;17;34;0;0;0
96;23.02.2012;2012;02;22;Torstai;8;6;14;0;0;0
96;23.02.2012;2012;02;23;Torstai;3;2;5;0;0;0
96;24.02.2012;2012;02;00;Perjantai;5;1;6;0;0;0
96;24.02.2012;2012;02;01;Perjantai;3;2;5;0;0;0
96;24.02.2012;2012;02;02;Perjantai;6;3;9;0;0;0
96;24.02.2012;2012;02;03;Perjantai;3;1;4;0;0;0
96;24.02.2012;2012;02;04;Perjantai;1;0;1;0;0;0
96;24.02.2012;2012;02;05;Perjantai;5;2;7;0;0;0
96;24.02.2012;2012;02;06;Perjantai;25;22;47;0;0;0
96;24.02.2012;2012;02;07;Perjantai;72;70;142;0;0;0
96;24.02.2012;2012;02;08;Perjantai;63;61;124;0;0;0
96;24.02.2012;2012;02;09;Perjantai;42;41;83;0;0;0
96;24.02.2012;2012;02;10;Perjantai;30;27;57;0;0;0
96;24.02.2012;2012;02;11;Perjantai;37;34;71;0;0;0
96;24.02.2012;2012;02;12;Perjantai;46;43;89;0;0;0
96;24.02.2012;2012;02;13;Perjantai;36;33;69;0;0;0
96;24.02.2012;2012;02;14;Perjantai;53;51;104;0;0;0
96;24.02.2012;2012;02;15;Perjantai;66;64;130;0;0;0
96;24.02.2012;2012;02;16;Perjantai;58;56;114;0;0;0
96;24.02.2012;2012;02;17;Perjantai;32;29;61;0;0;0
96;24.02.2012;2012;02;18;Perjantai;23;21;44;0;0;0
96;24.02.2012;2012;02;19;Perjantai;22;21;43;0;0;0
96;24.02.2012;2012;02;20;Perjantai;13;11;24;0;0;0
96;24.02.2012;2012;02;21;Perjantai;15;12;27;0;0;0
96;24.02.2012;2012;02;22;Perjantai;8;4;12;0;0;0
96;24.02.2012;2012;02;23;Perjantai;7;5;12;0;0;0
96;25.02.2012;2012;02;00;Lauantai;5;3;8;0;0;0
96;25.02.2012;2012;02;01;Lauantai;4;2;6;0;0;0
96;25.02.2012;2012;02;02;Lauantai;4;2;6;0;0;0
96;25.02.2012;2012;02;03;Lauantai;4;1;5;0;0;0
96;25.02.2012;2012;02;04;Lauantai;4;2;6;0;0;0
96;25.02.2012;2012;02;05;Lauantai;1;0;1;0;0;0
96;25.02.2012;2012;02;06;Lauantai;8;6;14;0;0;0
96;25.02.2012;2012;02;07;Lauantai;9;8;17;0;0;0
96;25.02.2012;2012;02;08;Lauantai;10;7;17;0;0;0
96;25.02.2012;2012;02;09;Lauantai;18;14;32;0;0;0
96;25.02.2012;2012;02;10;Lauantai;14;12;26;0;0;0
96;25.02.2012;2012;02;11;Lauantai;17;17;34;0;0;0
96;25.02.2012;2012;02;12;Lauantai;16;15;31;0;0;0
96;25.02.2012;2012;02;13;Lauantai;18;16;34;0;0;0
96;25.02.2012;2012;02;14;Lauantai;25;22;47;0;0;0
96;25.02.2012;2012;02;15;Lauantai;27;23;50;0;0;0
96;25.02.2012;2012;02;16;Lauantai;24;24;48;0;0;0
96;25.02.2012;2012;02;17;Lauantai;21;20;41;0;0;0
96;25.02.2012;2012;02;18;Lauantai;15;12;27;0;0;0
96;25.02.2012;2012;02;19;Lauantai;21;17;38;0;0;0
96;25.02.2012;2012;02;20;Lauantai;12;10;22;0;0;0
96;25.02.2012;2012;02;21;Lauantai;9;6;15;0;0;0
96;25.02.2012;2012;02;22;Lauantai;9;6;15;0;0;0
96;25.02.2012;2012;02;23;Lauantai;6;3;9;0;0;0
96;26.02.2012;2012;02;00;Sunnuntai;4;1;5;0;0;0
96;26.02.2012;2012;02;01;Sunnuntai;6;3;9;0;0;0
96;26.02.2012;2012;02;02;Sunnuntai;2;1;3;0;0;0
96;26.02.2012;2012;02;03;Sunnuntai;3;1;4;0;0;0
96;26.02.2012;2012;02;04;Sunnuntai;2;1;3;0;0;0
96;26.02.2012;2012;02;05;Sunnuntai;2;0;2;0;0;0
96;26.02.2012;2012;02;06;Sunnuntai;6;3;9;0;0;0
96;26.02.2012;2012;02;07;Sunnuntai;4;3;7;0;0;0
96;26.02.2012;2012;02;08;Sunnuntai;5;2;7;0;0;0
96;26.02.2012;2012;02;09;Sunnuntai;6;3;9;0;0;0
96;26.02.2012;2012;02;10;Sunnuntai;9;9;18;0;0;0
96;26.02.2012;2012;02;11;Sunnuntai;13;10;23;0;0;0
96;26.02.2012;2012;02;12;Sunnuntai;14;12;26;0;0;0
96;26.02.2012;2012;02;13;Sunnuntai;19;19;38;0;0;0
96;26.02.2012;2012;02;14;Sunnuntai;17;17;34;0;0;0
96;26.02.2012;2012;02;15;Sunnuntai;14;11;25;0;0;0
96;26.02.2012;2012;02;16;Sunnuntai;21;19;40;0;0;0
96;26.02.2012;2012;02;17;Sunnuntai;15;11;26;0;0;0
96;26.02.2012;2012;02;18;Sunnuntai;18;17;35;0;0;0
96;26.02.2012;2012;02;19;Sunnuntai;10;8;18;0;0;0
96;26.02.2012;2012;02;20;Sunnuntai;14;12;26;0;0;0
96;26.02.2012;2012;02;21;Sunnuntai;13;10;23;0;0;0
96;26.02.2012;2012;02;22;Sunnuntai;4;4;8;0;0;0
96;26.02.2012;2012;02;23;Sunnuntai;3;0;3;0;0;0
96;27.02.2012;2012;02;00;Maanantai;2;0;2;0;0;0
96;27.02.2012;2012;02;01;Maanantai;0;0;0;0;0;0
96;27.02.2012;2012;02;02;Maanantai;0;0;0;0;0;0
96;27.02.2012;2012;02;03;Maanantai;0;0;0;0;0;0
96;27.02.2012;2012;02;04;Maanantai;2;0;2;0;0;0
96;27.02.2012;2012;02;05;Maanantai;6;3;9;0;0;0
96;27.02.2012;2012;02;06;Maanantai;27;25;52;0;0;0
96;27.02.2012;2012;02;07;Maanantai;61;60;121;0;0;0
96;27.02.2012;2012;02;08;Maanantai;71;68;139;0;0;0
96;27.02.2012;2012;02;09;Maanantai;48;47;95;0;0;0
96;27.02.2012;2012;02;10;Maanantai;28;26;54;0;0;0
96;27.02.2012;2012;02;11;Maanantai;32;30;62;0;0;0
96;27.02.2012;2012;02;12;Maanantai;34;34;68;0;0;0
96;27.02.2012;2012;02;13;Maanantai;42;39;81;0;0;0
96;27.02.2012;2012;02;14;Maanantai;55;53;108;0;0;0
96;27.02.2012;2012;02;15;Maanantai;86;84;170;0;0;0
96;27.02.2012;2012;02;16;Maanantai;71;71;142;0;0;0
96;27.02.2012;2012;02;17;Maanantai;50;48;98;0;0;0
96;27.02.2012;2012;02;18;Maanantai;31;30;61;0;0;0
96;27.02.2012;2012;02;19;Maanantai;28;26;54;0;0;0
96;27.02.2012;2012;02;20;Maanantai;20;18;38;0;0;0
96;27.02.2012;2012;02;21;Maanantai;16;14;30;0;0;0
96;27.02.2012;2012;02;22;Maanantai;7;4;11;0;0;0
96;27.02.2012;2012;02;23;Maanantai;6;3;9;0;0;0
96;28.02.2012;2012;02;00;Tiistai;0;0;0;0;0;0
96;28.02.2012;2012;02;01;Tiistai;1;0;1;0;0;0
96;28.02.2012;2012;02;02;Tiistai;0;0;0;0;0;0
96;28.02.2012;2012;02;03;Tiistai;0;0;0;0;0;0
96;28.02.2012;2012;02;04;Tiistai;2;0;2;0;0;0
96;28.02.2012;2012;02;05;Tiistai;5;3;8;0;0;0
96;28.02.2012;2012;02;06;Tiistai;23;22;45;0;0;0
96;28.02.2012;2012;02;07;Tiistai;61;59;120;0;0;0
96;28.02.2012;2012;02;08;Tiistai;69;68;137;0;0;0
96;28.02.2012;2012;02;09;Tiistai;29;25;54;0;0;0
96;28.02.2012;2012;02;10;Tiistai;17;14;31;0;0;0
96;28.02.2012;2012;02;11;Tiistai;20;18;38;0;0;0
96;28.02.2012;2012;02;12;Tiistai;29;27;56;0;0;0
96;28.02.2012;2012;02;13;Tiistai;31;28;59;0;0;0
96;28.02.2012;2012;02;14;Tiistai;50;48;98;0;0;0
96;28.02.2012;2012;02;15;Tiistai;64;63;127;0;0;0
96;28.02.2012;2012;02;16;Tiistai;65;62;127;0;0;0
96;28.02.2012;2012;02;17;Tiistai;37;35;72;0;0;0
96;28.02.2012;2012;02;18;Tiistai;27;26;53;0;0;0
96;28.02.2012;2012;02;19;Tiistai;24;23;47;0;0;0
96;28.02.2012;2012;02;20;Tiistai;24;20;44;0;0;0
96;28.02.2012;2012;02;21;Tiistai;18;15;33;0;0;0
96;28.02.2012;2012;02;22;Tiistai;6;3;9;0;0;0
96;28.02.2012;2012;02;23;Tiistai;2;0;2;0;0;0
96;29.02.2012;2012;02;00;Keskiviikko;2;1;3;0;0;0
96;29.02.2012;2012;02;01;Keskiviikko;4;1;5;0;0;0
96;29.02.2012;2012;02;02;Keskiviikko;1;0;1;0;0;0
96;29.02.2012;2012;02;03;Keskiviikko;3;1;4;0;0;0
96;29.02.2012;2012;02;04;Keskiviikko;0;0;0;0;0;0
96;29.02.2012;2012;02;05;Keskiviikko;7;5;12;0;0;0
96;29.02.2012;2012;02;06;Keskiviikko;27;24;51;0;0;0
96;29.02.2012;2012;02;07;Keskiviikko;65;61;126;0;0;0
96;29.02.2012;2012;02;08;Keskiviikko;82;79;161;0;0;0
96;29.02.2012;2012;02;09;Keskiviikko;41;41;82;0;0;0
96;29.02.2012;2012;02;10;Keskiviikko;33;30;63;0;0;0
96;29.02.2012;2012;02;11;Keskiviikko;33;31;64;0;0;0
96;29.02.2012;2012;02;12;Keskiviikko;42;40;82;0;0;0
96;29.02.2012;2012;02;13;Keskiviikko;37;35;72;0;0;0
96;29.02.2012;2012;02;14;Keskiviikko;60;57;117;0;0;0
96;29.02.2012;2012;02;15;Keskiviikko;83;82;165;0;0;0
96;29.02.2012;2012;02;16;Keskiviikko;79;78;157;0;0;0
96;29.02.2012;2012;02;17;Keskiviikko;51;49;100;0;0;0
96;29.02.2012;2012;02;18;Keskiviikko;35;31;66;0;0;0
96;29.02.2012;2012;02;19;Keskiviikko;36;34;70;0;0;0
96;29.02.2012;2012;02;20;Keskiviikko;23;20;43;0;0;0
96;29.02.2012;2012;02;21;Keskiviikko;17;16;33;0;0;0
96;29.02.2012;2012;02;22;Keskiviikko;5;3;8;0;0;0
96;29.02.2012;2012;02;23;Keskiviikko;4;4;8;0;0;0
96;01.03.2012;2012;03;00;Torstai;1;0;1;0;0;0
96;01.03.2012;2012;03;01;Torstai;3;0;3;0;0;0
96;01.03.2012;2012;03;02;Torstai;2;1;3;0;0;0
96;01.03.2012;2012;03;03;Torstai;1;0;1;0;0;0
96;01.03.2012;2012;03;04;Torstai;2;1;3;0;0;0
96;01.03.2012;2012;03;05;Torstai;5;3;8;0;0;0
96;01.03.2012;2012;03;06;Torstai;30;28;58;0;0;0
96;01.03.2012;2012;03;07;Torstai;62;59;121;0;0;0
96;01.03.2012;2012;03;08;Torstai;77;77;154;0;0;0
96;01.03.2012;2012;03;09;Torstai;41;38;79;0;0;0
96;01.03.2012;2012;03;10;Torstai;32;30;62;0;0;0
96;01.03.2012;2012;03;11;Torstai;38;35;73;0;0;0
96;01.03.2012;2012;03;12;Torstai;42;39;81;0;0;0
96;01.03.2012;2012;03;13;Torstai;31;29;60;0;0;0
96;01.03.2012;2012;03;14;Torstai;46;45;91;0;0;0
96;01.03.2012;2012;03;15;Torstai;88;78;166;0;0;0
96;01.03.2012;2012;03;16;Torstai;128;9;137;0;0;0
96;01.03.2012;2012;03;17;Torstai;93;0;93;0;0;0
96;01.03.2012;2012;03;18;Torstai;39;6;45;0;0;0
96;01.03.2012;2012;03;19;Torstai;26;23;49;0;0;0
96;01.03.2012;2012;03;20;Torstai;29;13;42;0;0;0
96;01.03.2012;2012;03;21;Torstai;23;11;34;0;0;0
96;01.03.2012;2012;03;22;Torstai;5;6;11;0;0;0
96;01.03.2012;2012;03;23;Torstai;2;1;3;0;0;0
96;02.03.2012;2012;03;00;Perjantai;1;1;2;0;0;0
96;02.03.2012;2012;03;01;Perjantai;1;0;1;0;0;0
96;02.03.2012;2012;03;02;Perjantai;2;0;2;0;0;0
96;02.03.2012;2012;03;03;Perjantai;2;0;2;0;0;0
96;02.03.2012;2012;03;04;Perjantai;0;1;1;0;0;0
96;02.03.2012;2012;03;05;Perjantai;4;8;12;0;0;0
96;02.03.2012;2012;03;06;Perjantai;24;17;41;0;0;0
96;02.03.2012;2012;03;07;Perjantai;61;54;115;0;0;0
96;02.03.2012;2012;03;08;Perjantai;72;57;129;0;0;0
96;02.03.2012;2012;03;09;Perjantai;42;56;98;0;0;0
96;02.03.2012;2012;03;10;Perjantai;18;29;47;0;0;0
96;02.03.2012;2012;03;11;Perjantai;34;32;66;0;0;0
96;02.03.2012;2012;03;12;Perjantai;57;34;91;0;0;0
96;02.03.2012;2012;03;13;Perjantai;40;54;94;0;0;0
96;02.03.2012;2012;03;14;Perjantai;47;83;130;0;0;0
96;02.03.2012;2012;03;15;Perjantai;46;87;133;0;0;0
96;02.03.2012;2012;03;16;Perjantai;36;47;83;0;0;0
96;02.03.2012;2012;03;17;Perjantai;24;24;48;0;0;0
96;02.03.2012;2012;03;18;Perjantai;24;14;38;0;0;0
96;02.03.2012;2012;03;19;Perjantai;23;13;36;0;0;0
96;02.03.2012;2012;03;20;Perjantai;22;4;26;0;0;0
96;02.03.2012;2012;03;21;Perjantai;10;14;24;0;0;0
96;02.03.2012;2012;03;22;Perjantai;13;6;19;0;0;0
96;02.03.2012;2012;03;23;Perjantai;7;1;8;0;0;0
96;03.03.2012;2012;03;00;Lauantai;4;2;6;0;0;0
96;03.03.2012;2012;03;01;Lauantai;8;1;9;0;0;0
96;03.03.2012;2012;03;02;Lauantai;3;0;3;0;0;0
96;03.03.2012;2012;03;03;Lauantai;5;2;7;0;0;0
96;03.03.2012;2012;03;04;Lauantai;4;0;4;0;0;0
96;03.03.2012;2012;03;05;Lauantai;1;2;3;0;0;0
96;03.03.2012;2012;03;06;Lauantai;10;5;15;0;0;0
96;03.03.2012;2012;03;07;Lauantai;5;8;13;0;0;0
96;03.03.2012;2012;03;08;Lauantai;4;9;13;0;0;0
96;03.03.2012;2012;03;09;Lauantai;8;22;30;0;0;0
96;03.03.2012;2012;03;10;Lauantai;6;14;20;0;0;0
96;03.03.2012;2012;03;11;Lauantai;9;18;27;0;0;0
96;03.03.2012;2012;03;12;Lauantai;23;24;47;0;0;0
96;03.03.2012;2012;03;13;Lauantai;22;24;46;0;0;0
96;03.03.2012;2012;03;14;Lauantai;33;20;53;0;0;0
96;03.03.2012;2012;03;15;Lauantai;19;17;36;0;0;0
96;03.03.2012;2012;03;16;Lauantai;14;29;43;0;0;0
96;03.03.2012;2012;03;17;Lauantai;13;13;26;0;0;0
96;03.03.2012;2012;03;18;Lauantai;21;14;35;0;0;0
96;03.03.2012;2012;03;19;Lauantai;26;3;29;0;0;0
96;03.03.2012;2012;03;20;Lauantai;7;7;14;0;0;0
96;03.03.2012;2012;03;21;Lauantai;4;14;18;0;0;0
96;03.03.2012;2012;03;22;Lauantai;5;5;10;0;0;0
96;03.03.2012;2012;03;23;Lauantai;5;3;8;0;0;0
96;04.03.2012;2012;03;00;Sunnuntai;6;2;8;0;0;0
96;04.03.2012;2012;03;01;Sunnuntai;2;2;4;0;0;0
96;04.03.2012;2012;03;02;Sunnuntai;0;0;0;0;0;0
96;04.03.2012;2012;03;03;Sunnuntai;6;0;6;0;0;0
96;04.03.2012;2012;03;04;Sunnuntai;6;0;6;0;0;0
96;04.03.2012;2012;03;05;Sunnuntai;0;0;0;0;0;0
96;04.03.2012;2012;03;06;Sunnuntai;5;2;7;0;0;0
96;04.03.2012;2012;03;07;Sunnuntai;0;2;2;0;0;0
96;04.03.2012;2012;03;08;Sunnuntai;2;5;7;0;0;0
96;04.03.2012;2012;03;09;Sunnuntai;6;3;9;0;0;0
96;04.03.2012;2012;03;10;Sunnuntai;6;5;11;0;0;0
96;04.03.2012;2012;03;11;Sunnuntai;3;13;16;0;0;0
96;04.03.2012;2012;03;12;Sunnuntai;11;24;35;0;0;0
96;04.03.2012;2012;03;13;Sunnuntai;20;7;27;0;0;0
96;04.03.2012;2012;03;14;Sunnuntai;8;12;20;0;0;0
96;04.03.2012;2012;03;15;Sunnuntai;12;25;37;0;0;0
96;04.03.2012;2012;03;16;Sunnuntai;15;11;26;0;0;0
96;04.03.2012;2012;03;17;Sunnuntai;15;13;28;0;0;0
96;04.03.2012;2012;03;18;Sunnuntai;23;8;31;0;0;0
96;04.03.2012;2012;03;19;Sunnuntai;11;10;21;0;0;0
96;04.03.2012;2012;03;20;Sunnuntai;13;12;25;0;0;0
96;04.03.2012;2012;03;21;Sunnuntai;7;9;16;0;0;0
96;04.03.2012;2012;03;22;Sunnuntai;5;3;8;0;0;0
96;04.03.2012;2012;03;23;Sunnuntai;5;2;7;0;0;0
96;05.03.2012;2012;03;00;Maanantai;1;0;1;1;1;2
96;05.03.2012;2012;03;01;Maanantai;1;0;1;0;0;0
96;05.03.2012;2012;03;02;Maanantai;2;0;2;0;0;0
96;05.03.2012;2012;03;03;Maanantai;0;0;0;0;0;0
96;05.03.2012;2012;03;04;Maanantai;0;0;0;0;0;0
96;05.03.2012;2012;03;05;Maanantai;5;5;10;0;0;0
96;05.03.2012;2012;03;06;Maanantai;32;9;41;10;3;13
96;05.03.2012;2012;03;07;Maanantai;50;31;81;20;10;30
96;05.03.2012;2012;03;08;Maanantai;25;24;49;8;11;19
96;05.03.2012;2012;03;09;Maanantai;19;21;40;5;8;13
96;05.03.2012;2012;03;10;Maanantai;15;26;41;5;15;20
96;05.03.2012;2012;03;11;Maanantai;15;21;36;7;12;19
96;05.03.2012;2012;03;12;Maanantai;20;26;46;10;14;24
96;05.03.2012;2012;03;13;Maanantai;34;28;62;15;20;35
96;05.03.2012;2012;03;14;Maanantai;32;41;73;9;18;27
96;05.03.2012;2012;03;15;Maanantai;35;77;112;17;32;49
96;05.03.2012;2012;03;16;Maanantai;43;52;95;21;35;56
96;05.03.2012;2012;03;17;Maanantai;40;21;61;17;10;27
96;05.03.2012;2012;03;18;Maanantai;29;24;53;13;12;25
96;05.03.2012;2012;03;19;Maanantai;23;16;39;15;7;22
96;05.03.2012;2012;03;20;Maanantai;18;8;26;5;10;15
96;05.03.2012;2012;03;21;Maanantai;21;14;35;4;6;10
96;05.03.2012;2012;03;22;Maanantai;5;2;7;2;2;4
96;05.03.2012;2012;03;23;Maanantai;0;2;2;0;0;0
96;06.03.2012;2012;03;00;Tiistai;0;0;0;1;0;1
96;06.03.2012;2012;03;01;Tiistai;0;0;0;0;0;0
96;06.03.2012;2012;03;02;Tiistai;0;0;0;0;0;0
96;06.03.2012;2012;03;03;Tiistai;0;0;0;0;0;0
96;06.03.2012;2012;03;04;Tiistai;0;0;0;0;0;0
96;06.03.2012;2012;03;05;Tiistai;4;2;6;0;0;0
96;06.03.2012;2012;03;06;Tiistai;37;16;53;11;1;12
96;06.03.2012;2012;03;07;Tiistai;43;39;82;23;15;38
96;06.03.2012;2012;03;08;Tiistai;24;34;58;17;9;26
96;06.03.2012;2012;03;09;Tiistai;13;26;39;6;8;14
96;06.03.2012;2012;03;10;Tiistai;16;18;34;7;13;20
96;06.03.2012;2012;03;11;Tiistai;20;19;39;5;15;20
96;06.03.2012;2012;03;12;Tiistai;22;29;51;12;19;31
96;06.03.2012;2012;03;13;Tiistai;20;25;45;23;23;46
96;06.03.2012;2012;03;14;Tiistai;21;38;59;8;21;29
96;06.03.2012;2012;03;15;Tiistai;35;73;108;18;26;44
96;06.03.2012;2012;03;16;Tiistai;37;50;87;13;47;60
96;06.03.2012;2012;03;17;Tiistai;34;24;58;11;12;23
96;06.03.2012;2012;03;18;Tiistai;15;18;33;13;9;22
96;06.03.2012;2012;03;19;Tiistai;13;26;39;13;15;28
96;06.03.2012;2012;03;20;Tiistai;30;7;37;8;7;15
96;06.03.2012;2012;03;21;Tiistai;18;7;25;6;7;13
96;06.03.2012;2012;03;22;Tiistai;3;3;6;0;0;0
96;06.03.2012;2012;03;23;Tiistai;0;1;1;2;0;2
96;07.03.2012;2012;03;00;Keskiviikko;2;0;2;0;0;0
96;07.03.2012;2012;03;01;Keskiviikko;0;0;0;0;0;0
96;07.03.2012;2012;03;02;Keskiviikko;1;0;1;0;0;0
96;07.03.2012;2012;03;03;Keskiviikko;1;0;1;0;0;0
96;07.03.2012;2012;03;04;Keskiviikko;2;1;3;0;0;0
96;07.03.2012;2012;03;05;Keskiviikko;3;3;6;1;0;1
96;07.03.2012;2012;03;06;Keskiviikko;31;14;45;6;5;11
96;07.03.2012;2012;03;07;Keskiviikko;45;36;81;29;14;43
96;07.03.2012;2012;03;08;Keskiviikko;32;25;57;16;9;25
96;07.03.2012;2012;03;09;Keskiviikko;11;23;34;10;14;24
96;07.03.2012;2012;03;10;Keskiviikko;17;23;40;8;17;25
96;07.03.2012;2012;03;11;Keskiviikko;20;23;43;10;13;23
96;07.03.2012;2012;03;12;Keskiviikko;25;17;42;18;11;29
96;07.03.2012;2012;03;13;Keskiviikko;40;33;73;38;39;77
96;07.03.2012;2012;03;14;Keskiviikko;48;42;90;46;53;99
96;07.03.2012;2012;03;15;Keskiviikko;75;32;107;25;38;63
96;07.03.2012;2012;03;16;Keskiviikko;57;36;93;14;27;41
96;07.03.2012;2012;03;17;Keskiviikko;46;11;57;10;14;24
96;07.03.2012;2012;03;18;Keskiviikko;43;13;56;12;7;19
96;07.03.2012;2012;03;19;Keskiviikko;30;14;44;15;4;19
96;07.03.2012;2012;03;20;Keskiviikko;32;1;33;6;7;13
96;07.03.2012;2012;03;21;Keskiviikko;17;7;24;5;9;14
96;07.03.2012;2012;03;22;Keskiviikko;3;1;4;1;5;6
96;07.03.2012;2012;03;23;Keskiviikko;7;1;8;1;0;1
96;08.03.2012;2012;03;00;Torstai;3;1;4;1;0;1
96;08.03.2012;2012;03;01;Torstai;2;0;2;1;0;1
96;08.03.2012;2012;03;02;Torstai;2;0;2;0;0;0
96;08.03.2012;2012;03;03;Torstai;3;0;3;2;1;3
96;08.03.2012;2012;03;04;Torstai;1;0;1;1;0;1
96;08.03.2012;2012;03;05;Torstai;4;2;6;1;0;1
96;08.03.2012;2012;03;06;Torstai;36;1;37;16;4;20
96;08.03.2012;2012;03;07;Torstai;76;16;92;25;7;32
96;08.03.2012;2012;03;08;Torstai;43;10;53;19;9;28
96;08.03.2012;2012;03;09;Torstai;39;14;53;15;9;24
96;08.03.2012;2012;03;10;Torstai;33;6;39;5;9;14
96;08.03.2012;2012;03;11;Torstai;37;7;44;18;8;26
96;08.03.2012;2012;03;12;Torstai;43;17;60;14;4;18
96;08.03.2012;2012;03;13;Torstai;32;9;41;12;9;21
96;08.03.2012;2012;03;14;Torstai;37;23;60;8;21;29
96;08.03.2012;2012;03;15;Torstai;59;45;104;20;24;44
96;08.03.2012;2012;03;16;Torstai;58;37;95;16;19;35
96;08.03.2012;2012;03;17;Torstai;31;14;45;20;13;33
96;08.03.2012;2012;03;18;Torstai;28;10;38;8;10;18
96;08.03.2012;2012;03;19;Torstai;28;11;39;11;11;22
96;08.03.2012;2012;03;20;Torstai;14;6;20;8;8;16
96;08.03.2012;2012;03;21;Torstai;21;5;26;4;9;13
96;08.03.2012;2012;03;22;Torstai;3;4;7;3;3;6
96;08.03.2012;2012;03;23;Torstai;1;1;2;0;0;0
96;09.03.2012;2012;03;00;Perjantai;0;0;0;0;1;1
96;09.03.2012;2012;03;01;Perjantai;1;0;1;0;1;1
96;09.03.2012;2012;03;02;Perjantai;5;1;6;1;0;1
96;09.03.2012;2012;03;03;Perjantai;0;0;0;0;0;0
96;09.03.2012;2012;03;04;Perjantai;0;2;2;0;1;1
96;09.03.2012;2012;03;05;Perjantai;3;2;5;0;0;0
96;09.03.2012;2012;03;06;Perjantai;31;17;48;11;4;15
96;09.03.2012;2012;03;07;Perjantai;46;25;71;20;7;27
96;09.03.2012;2012;03;08;Perjantai;30;24;54;17;5;22
96;09.03.2012;2012;03;09;Perjantai;15;19;34;6;10;16
96;09.03.2012;2012;03;10;Perjantai;9;20;29;6;8;14
96;09.03.2012;2012;03;11;Perjantai;24;33;57;3;7;10
96;09.03.2012;2012;03;12;Perjantai;26;15;41;10;12;22
96;09.03.2012;2012;03;13;Perjantai;35;39;74;11;13;24
96;09.03.2012;2012;03;14;Perjantai;29;54;83;9;21;30
96;09.03.2012;2012;03;15;Perjantai;36;54;90;9;31;40
96;09.03.2012;2012;03;16;Perjantai;29;33;62;5;18;23
96;09.03.2012;2012;03;17;Perjantai;31;5;36;12;2;14
96;09.03.2012;2012;03;18;Perjantai;24;4;28;2;0;2
96;09.03.2012;2012;03;19;Perjantai;16;6;22;1;0;1
96;09.03.2012;2012;03;20;Perjantai;11;8;19;0;0;0
96;09.03.2012;2012;03;21;Perjantai;10;10;20;0;0;0
96;09.03.2012;2012;03;22;Perjantai;2;2;4;0;0;0
96;09.03.2012;2012;03;23;Perjantai;2;2;4;0;0;0
96;10.03.2012;2012;03;00;Lauantai;5;0;5;0;0;0
96;10.03.2012;2012;03;01;Lauantai;2;0;2;0;0;0
96;10.03.2012;2012;03;02;Lauantai;2;0;2;1;0;1
96;10.03.2012;2012;03;03;Lauantai;2;0;2;0;0;0
96;10.03.2012;2012;03;04;Lauantai;1;0;1;8;0;8
96;10.03.2012;2012;03;05;Lauantai;3;0;3;0;0;0
96;10.03.2012;2012;03;06;Lauantai;15;0;15;9;1;10
96;10.03.2012;2012;03;07;Lauantai;11;2;13;2;3;5
96;10.03.2012;2012;03;08;Lauantai;13;5;18;5;5;10
96;10.03.2012;2012;03;09;Lauantai;12;6;18;12;12;24
96;10.03.2012;2012;03;10;Lauantai;6;9;15;24;26;50
96;10.03.2012;2012;03;11;Lauantai;23;8;31;15;28;43
96;10.03.2012;2012;03;12;Lauantai;12;16;28;14;41;55
96;10.03.2012;2012;03;13;Lauantai;24;15;39;14;23;37
96;10.03.2012;2012;03;14;Lauantai;28;2;30;15;33;48
96;10.03.2012;2012;03;15;Lauantai;15;4;19;12;46;58
96;10.03.2012;2012;03;16;Lauantai;20;24;44;12;36;48
96;10.03.2012;2012;03;17;Lauantai;20;14;34;12;15;27
96;10.03.2012;2012;03;18;Lauantai;23;13;36;15;6;21
96;10.03.2012;2012;03;19;Lauantai;49;10;59;23;6;29
96;10.03.2012;2012;03;20;Lauantai;10;8;18;3;7;10
96;10.03.2012;2012;03;21;Lauantai;7;8;15;5;12;17
96;10.03.2012;2012;03;22;Lauantai;7;5;12;0;3;3
96;10.03.2012;2012;03;23;Lauantai;6;2;8;0;0;0
96;11.03.2012;2012;03;00;Sunnuntai;3;3;6;1;4;5
96;11.03.2012;2012;03;01;Sunnuntai;0;1;1;1;1;2
96;11.03.2012;2012;03;02;Sunnuntai;0;1;1;1;2;3
96;11.03.2012;2012;03;03;Sunnuntai;5;0;5;6;0;6
96;11.03.2012;2012;03;04;Sunnuntai;4;1;5;1;0;1
96;11.03.2012;2012;03;05;Sunnuntai;1;0;1;1;0;1
96;11.03.2012;2012;03;06;Sunnuntai;4;3;7;10;0;10
96;11.03.2012;2012;03;07;Sunnuntai;2;5;7;1;2;3
96;11.03.2012;2012;03;08;Sunnuntai;2;5;7;4;3;7
96;11.03.2012;2012;03;09;Sunnuntai;3;2;5;9;14;23
96;11.03.2012;2012;03;10;Sunnuntai;11;8;19;14;15;29
96;11.03.2012;2012;03;11;Sunnuntai;12;7;19;15;33;48
96;11.03.2012;2012;03;12;Sunnuntai;17;19;36;15;30;45
96;11.03.2012;2012;03;13;Sunnuntai;18;7;25;11;20;31
96;11.03.2012;2012;03;14;Sunnuntai;22;6;28;21;19;40
96;11.03.2012;2012;03;15;Sunnuntai;16;10;26;13;27;40
96;11.03.2012;2012;03;16;Sunnuntai;24;9;33;28;30;58
96;11.03.2012;2012;03;17;Sunnuntai;18;11;29;21;11;32
96;11.03.2012;2012;03;18;Sunnuntai;28;10;38;18;14;32
96;11.03.2012;2012;03;19;Sunnuntai;14;11;25;8;16;24
96;11.03.2012;2012;03;20;Sunnuntai;16;14;30;12;9;21
96;11.03.2012;2012;03;21;Sunnuntai;12;4;16;4;0;4
96;11.03.2012;2012;03;22;Sunnuntai;8;3;11;1;0;1
96;11.03.2012;2012;03;23;Sunnuntai;3;1;4;2;0;2
96;12.03.2012;2012;03;00;Maanantai;0;0;0;0;1;1
96;12.03.2012;2012;03;01;Maanantai;0;0;0;0;0;0
96;12.03.2012;2012;03;02;Maanantai;0;0;0;0;0;0
96;12.03.2012;2012;03;03;Maanantai;4;0;4;0;0;0
96;12.03.2012;2012;03;04;Maanantai;1;2;3;3;4;7
96;12.03.2012;2012;03;05;Maanantai;4;6;10;0;1;1
96;12.03.2012;2012;03;06;Maanantai;41;23;64;12;4;16
96;12.03.2012;2012;03;07;Maanantai;91;48;139;49;14;63
96;12.03.2012;2012;03;08;Maanantai;77;95;172;29;16;45
96;12.03.2012;2012;03;09;Maanantai;56;41;97;25;15;40
96;12.03.2012;2012;03;10;Maanantai;30;34;64;12;21;33
96;12.03.2012;2012;03;11;Maanantai;44;33;77;6;17;23
96;12.03.2012;2012;03;12;Maanantai;33;29;62;20;24;44
96;12.03.2012;2012;03;13;Maanantai;46;29;75;22;26;48
96;12.03.2012;2012;03;14;Maanantai;29;56;85;18;37;55
96;12.03.2012;2012;03;15;Maanantai;64;99;163;22;63;85
96;12.03.2012;2012;03;16;Maanantai;69;90;159;21;70;91
96;12.03.2012;2012;03;17;Maanantai;61;38;99;21;12;33
96;12.03.2012;2012;03;18;Maanantai;28;32;60;25;20;45
96;12.03.2012;2012;03;19;Maanantai;32;30;62;17;20;37
96;12.03.2012;2012;03;20;Maanantai;37;13;50;9;5;14
96;12.03.2012;2012;03;21;Maanantai;20;12;32;4;11;15
96;12.03.2012;2012;03;22;Maanantai;9;5;14;0;2;2
96;12.03.2012;2012;03;23;Maanantai;4;0;4;1;0;1
96;13.03.2012;2012;03;00;Tiistai;0;1;1;1;0;1
96;13.03.2012;2012;03;01;Tiistai;0;0;0;0;0;0
96;13.03.2012;2012;03;02;Tiistai;0;0;0;1;0;1
96;13.03.2012;2012;03;03;Tiistai;5;3;8;0;0;0
96;13.03.2012;2012;03;04;Tiistai;1;2;3;0;0;0
96;13.03.2012;2012;03;05;Tiistai;3;9;12;0;0;0
96;13.03.2012;2012;03;06;Tiistai;43;12;55;20;6;26
96;13.03.2012;2012;03;07;Tiistai;71;52;123;40;13;53
96;13.03.2012;2012;03;08;Tiistai;104;74;178;25;16;41
96;13.03.2012;2012;03;09;Tiistai;42;48;90;15;17;32
96;13.03.2012;2012;03;10;Tiistai;34;38;72;21;14;35
96;13.03.2012;2012;03;11;Tiistai;39;32;71;8;14;22
96;13.03.2012;2012;03;12;Tiistai;45;29;74;12;18;30
96;13.03.2012;2012;03;13;Tiistai;31;32;63;15;15;30
96;13.03.2012;2012;03;14;Tiistai;31;53;84;10;24;34
96;13.03.2012;2012;03;15;Tiistai;61;114;175;17;68;85
96;13.03.2012;2012;03;16;Tiistai;69;88;157;15;70;85
96;13.03.2012;2012;03;17;Tiistai;39;49;88;20;31;51
96;13.03.2012;2012;03;18;Tiistai;30;39;69;14;26;40
96;13.03.2012;2012;03;19;Tiistai;27;28;55;14;21;35
96;13.03.2012;2012;03;20;Tiistai;31;11;42;22;16;38
96;13.03.2012;2012;03;21;Tiistai;51;15;66;23;11;34
96;13.03.2012;2012;03;22;Tiistai;2;2;4;1;1;2
96;13.03.2012;2012;03;23;Tiistai;4;0;4;0;0;0
96;14.03.2012;2012;03;00;Keskiviikko;2;0;2;1;2;3
96;14.03.2012;2012;03;01;Keskiviikko;1;0;1;3;0;3
96;14.03.2012;2012;03;02;Keskiviikko;0;0;0;1;0;1
96;14.03.2012;2012;03;03;Keskiviikko;0;0;0;0;0;0
96;14.03.2012;2012;03;04;Keskiviikko;1;2;3;0;0;0
96;14.03.2012;2012;03;05;Keskiviikko;3;7;10;1;0;1
96;14.03.2012;2012;03;06;Keskiviikko;38;23;61;15;8;23
96;14.03.2012;2012;03;07;Keskiviikko;75;55;130;43;17;60
96;14.03.2012;2012;03;08;Keskiviikko;117;53;170;33;15;48
96;14.03.2012;2012;03;09;Keskiviikko;32;37;69;26;28;54
96;14.03.2012;2012;03;10;Keskiviikko;33;30;63;12;18;30
96;14.03.2012;2012;03;11;Keskiviikko;44;30;74;16;25;41
96;14.03.2012;2012;03;12;Keskiviikko;44;59;103;20;32;52
96;14.03.2012;2012;03;13;Keskiviikko;50;30;80;28;15;43
96;14.03.2012;2012;03;14;Keskiviikko;40;49;89;11;25;36
96;14.03.2012;2012;03;15;Keskiviikko;53;104;157;21;66;87
96;14.03.2012;2012;03;16;Keskiviikko;55;84;139;21;55;76
96;14.03.2012;2012;03;17;Keskiviikko;37;34;71;18;11;29
96;14.03.2012;2012;03;18;Keskiviikko;35;26;61;27;24;51
96;14.03.2012;2012;03;19;Keskiviikko;45;22;67;21;19;40
96;14.03.2012;2012;03;20;Keskiviikko;31;22;53;11;12;23
96;14.03.2012;2012;03;21;Keskiviikko;24;23;47;2;21;23
96;14.03.2012;2012;03;22;Keskiviikko;6;6;12;0;4;4
96;14.03.2012;2012;03;23;Keskiviikko;1;2;3;0;1;1
96;15.03.2012;2012;03;00;Torstai;4;1;5;4;0;4
96;15.03.2012;2012;03;01;Torstai;2;0;2;1;1;2
96;15.03.2012;2012;03;02;Torstai;2;1;3;0;0;0
96;15.03.2012;2012;03;03;Torstai;1;0;1;2;0;2
96;15.03.2012;2012;03;04;Torstai;1;1;2;0;0;0
96;15.03.2012;2012;03;05;Torstai;3;5;8;0;0;0
96;15.03.2012;2012;03;06;Torstai;34;11;45;14;4;18
96;15.03.2012;2012;03;07;Torstai;56;47;103;46;21;67
96;15.03.2012;2012;03;08;Torstai;83;70;153;18;16;34
96;15.03.2012;2012;03;09;Torstai;38;43;81;13;9;22
96;15.03.2012;2012;03;10;Torstai;43;26;69;12;17;29
96;15.03.2012;2012;03;11;Torstai;23;32;55;8;16;24
96;15.03.2012;2012;03;12;Torstai;56;41;97;21;18;39
96;15.03.2012;2012;03;13;Torstai;43;44;87;28;28;56
96;15.03.2012;2012;03;14;Torstai;27;56;83;16;32;48
96;15.03.2012;2012;03;15;Torstai;52;89;141;13;50;63
96;15.03.2012;2012;03;16;Torstai;56;79;135;12;56;68
96;15.03.2012;2012;03;17;Torstai;30;34;64;14;20;34
96;15.03.2012;2012;03;18;Torstai;37;25;62;20;23;43
96;15.03.2012;2012;03;19;Torstai;24;18;42;13;24;37
96;15.03.2012;2012;03;20;Torstai;18;14;32;13;13;26
96;15.03.2012;2012;03;21;Torstai;13;14;27;5;10;15
96;15.03.2012;2012;03;22;Torstai;6;5;11;1;2;3
96;15.03.2012;2012;03;23;Torstai;3;3;6;1;0;1
96;16.03.2012;2012;03;00;Perjantai;3;1;4;0;0;0
96;16.03.2012;2012;03;01;Perjantai;3;0;3;0;0;0
96;16.03.2012;2012;03;02;Perjantai;2;1;3;2;0;2
96;16.03.2012;2012;03;03;Perjantai;1;0;1;0;0;0
96;16.03.2012;2012;03;04;Perjantai;4;2;6;0;0;0
96;16.03.2012;2012;03;05;Perjantai;2;5;7;0;1;1
96;16.03.2012;2012;03;06;Perjantai;34;9;43;17;8;25
96;16.03.2012;2012;03;07;Perjantai;68;41;109;32;18;50
96;16.03.2012;2012;03;08;Perjantai;87;49;136;40;13;53
96;16.03.2012;2012;03;09;Perjantai;26;43;69;12;22;34
96;16.03.2012;2012;03;10;Perjantai;27;26;53;14;9;23
96;16.03.2012;2012;03;11;Perjantai;27;49;76;4;32;36
96;16.03.2012;2012;03;12;Perjantai;41;36;77;22;38;60
96;16.03.2012;2012;03;13;Perjantai;48;35;83;9;41;50
96;16.03.2012;2012;03;14;Perjantai;49;57;106;15;53;68
96;16.03.2012;2012;03;15;Perjantai;33;94;127;15;71;86
96;16.03.2012;2012;03;16;Perjantai;54;57;111;13;37;50
96;16.03.2012;2012;03;17;Perjantai;31;30;61;9;9;18
96;16.03.2012;2012;03;18;Perjantai;16;12;28;12;13;25
96;16.03.2012;2012;03;19;Perjantai;21;9;30;9;16;25
96;16.03.2012;2012;03;20;Perjantai;21;12;33;10;6;16
96;16.03.2012;2012;03;21;Perjantai;15;10;25;2;8;10
96;16.03.2012;2012;03;22;Perjantai;9;5;14;0;0;0
96;16.03.2012;2012;03;23;Perjantai;7;3;10;1;0;1
96;17.03.2012;2012;03;00;Lauantai;3;2;5;0;0;0
96;17.03.2012;2012;03;01;Lauantai;4;1;5;2;1;3
96;17.03.2012;2012;03;02;Lauantai;7;2;9;0;0;0
96;17.03.2012;2012;03;03;Lauantai;7;1;8;3;0;3
96;17.03.2012;2012;03;04;Lauantai;0;2;2;0;0;0
96;17.03.2012;2012;03;05;Lauantai;0;2;2;0;1;1
96;17.03.2012;2012;03;06;Lauantai;8;3;11;5;0;5
96;17.03.2012;2012;03;07;Lauantai;7;5;12;2;6;8
96;17.03.2012;2012;03;08;Lauantai;5;7;12;4;5;9
96;17.03.2012;2012;03;09;Lauantai;2;19;21;2;8;10
96;17.03.2012;2012;03;10;Lauantai;14;11;25;9;10;19
96;17.03.2012;2012;03;11;Lauantai;19;13;32;9;13;22
96;17.03.2012;2012;03;12;Lauantai;16;25;41;11;14;25
96;17.03.2012;2012;03;13;Lauantai;18;22;40;11;13;24
96;17.03.2012;2012;03;14;Lauantai;17;21;38;11;14;25
96;17.03.2012;2012;03;15;Lauantai;21;20;41;8;16;24
96;17.03.2012;2012;03;16;Lauantai;16;22;38;8;16;24
96;17.03.2012;2012;03;17;Lauantai;19;17;36;8;17;25
96;17.03.2012;2012;03;18;Lauantai;28;10;38;13;6;19
96;17.03.2012;2012;03;19;Lauantai;29;12;41;23;4;27
96;17.03.2012;2012;03;20;Lauantai;13;10;23;9;7;16
96;17.03.2012;2012;03;21;Lauantai;11;30;41;3;9;12
96;17.03.2012;2012;03;22;Lauantai;5;6;11;4;6;10
96;17.03.2012;2012;03;23;Lauantai;1;4;5;2;0;2
96;18.03.2012;2012;03;00;Sunnuntai;1;1;2;0;0;0
96;18.03.2012;2012;03;01;Sunnuntai;5;2;7;1;1;2
96;18.03.2012;2012;03;02;Sunnuntai;4;0;4;2;0;2
96;18.03.2012;2012;03;03;Sunnuntai;3;1;4;1;1;2
96;18.03.2012;2012;03;04;Sunnuntai;4;0;4;2;0;2
96;18.03.2012;2012;03;05;Sunnuntai;1;1;2;3;0;3
96;18.03.2012;2012;03;06;Sunnuntai;10;4;14;5;5;10
96;18.03.2012;2012;03;07;Sunnuntai;3;2;5;4;5;9
96;18.03.2012;2012;03;08;Sunnuntai;7;3;10;7;6;13
96;18.03.2012;2012;03;09;Sunnuntai;0;8;8;13;5;18
96;18.03.2012;2012;03;10;Sunnuntai;5;14;19;11;15;26
96;18.03.2012;2012;03;11;Sunnuntai;12;11;23;24;28;52
96;18.03.2012;2012;03;12;Sunnuntai;19;11;30;19;26;45
96;18.03.2012;2012;03;13;Sunnuntai;21;16;37;17;14;31
96;18.03.2012;2012;03;14;Sunnuntai;21;23;44;23;21;44
96;18.03.2012;2012;03;15;Sunnuntai;14;22;36;22;17;39
96;18.03.2012;2012;03;16;Sunnuntai;39;8;47;27;15;42
96;18.03.2012;2012;03;17;Sunnuntai;17;13;30;27;9;36
96;18.03.2012;2012;03;18;Sunnuntai;31;13;44;17;25;42
96;18.03.2012;2012;03;19;Sunnuntai;17;6;23;13;13;26
96;18.03.2012;2012;03;20;Sunnuntai;16;13;29;9;24;33
96;18.03.2012;2012;03;21;Sunnuntai;10;14;24;2;11;13
96;18.03.2012;2012;03;22;Sunnuntai;4;6;10;2;1;3
96;18.03.2012;2012;03;23;Sunnuntai;4;2;6;1;1;2
96;19.03.2012;2012;03;00;Maanantai;0;0;0;0;0;0
96;19.03.2012;2012;03;01;Maanantai;0;0;0;0;0;0
96;19.03.2012;2012;03;02;Maanantai;0;2;2;0;0;0
96;19.03.2012;2012;03;03;Maanantai;1;0;1;0;0;0
96;19.03.2012;2012;03;04;Maanantai;1;1;2;0;0;0
96;19.03.2012;2012;03;05;Maanantai;2;8;10;0;0;0
96;19.03.2012;2012;03;06;Maanantai;30;11;41;17;6;23
96;19.03.2012;2012;03;07;Maanantai;84;51;135;48;23;71
96;19.03.2012;2012;03;08;Maanantai;75;68;143;29;23;52
96;19.03.2012;2012;03;09;Maanantai;40;40;80;19;17;36
96;19.03.2012;2012;03;10;Maanantai;44;29;73;12;18;30
96;19.03.2012;2012;03;11;Maanantai;57;43;100;26;30;56
96;19.03.2012;2012;03;12;Maanantai;56;35;91;32;36;68
96;19.03.2012;2012;03;13;Maanantai;36;35;71;12;19;31
96;19.03.2012;2012;03;14;Maanantai;38;60;98;16;18;34
96;19.03.2012;2012;03;15;Maanantai;35;100;135;13;54;67
96;19.03.2012;2012;03;16;Maanantai;58;90;148;14;39;53
96;19.03.2012;2012;03;17;Maanantai;49;38;87;15;16;31
96;19.03.2012;2012;03;18;Maanantai;34;24;58;19;20;39
96;19.03.2012;2012;03;19;Maanantai;25;26;51;24;16;40
96;19.03.2012;2012;03;20;Maanantai;24;17;41;18;10;28
96;19.03.2012;2012;03;21;Maanantai;18;17;35;4;11;15
96;19.03.2012;2012;03;22;Maanantai;5;8;13;4;2;6
96;19.03.2012;2012;03;23;Maanantai;2;0;2;0;0;0
96;20.03.2012;2012;03;00;Tiistai;0;2;2;0;0;0
96;20.03.2012;2012;03;01;Tiistai;2;1;3;0;1;1
96;20.03.2012;2012;03;02;Tiistai;1;0;1;0;1;1
96;20.03.2012;2012;03;03;Tiistai;1;0;1;0;0;0
96;20.03.2012;2012;03;04;Tiistai;1;1;2;0;0;0
96;20.03.2012;2012;03;05;Tiistai;4;7;11;0;0;0
96;20.03.2012;2012;03;06;Tiistai;30;17;47;14;7;21
96;20.03.2012;2012;03;07;Tiistai;75;63;138;41;16;57
96;20.03.2012;2012;03;08;Tiistai;77;69;146;25;12;37
96;20.03.2012;2012;03;09;Tiistai;44;32;76;19;21;40
96;20.03.2012;2012;03;10;Tiistai;27;28;55;17;20;37
96;20.03.2012;2012;03;11;Tiistai;34;32;66;16;26;42
96;20.03.2012;2012;03;12;Tiistai;46;36;82;17;31;48
96;20.03.2012;2012;03;13;Tiistai;30;36;66;20;18;38
96;20.03.2012;2012;03;14;Tiistai;37;76;113;9;16;25
96;20.03.2012;2012;03;15;Tiistai;47;128;175;22;63;85
96;20.03.2012;2012;03;16;Tiistai;70;95;165;19;34;53
96;20.03.2012;2012;03;17;Tiistai;49;40;89;13;24;37
96;20.03.2012;2012;03;18;Tiistai;37;32;69;18;16;34
96;20.03.2012;2012;03;19;Tiistai;40;27;67;19;18;37
96;20.03.2012;2012;03;20;Tiistai;33;17;50;13;6;19
96;20.03.2012;2012;03;21;Tiistai;18;19;37;6;13;19
96;20.03.2012;2012;03;22;Tiistai;8;6;14;2;4;6
96;20.03.2012;2012;03;23;Tiistai;5;0;5;2;0;2
96;21.03.2012;2012;03;00;Keskiviikko;3;0;3;1;1;2
96;21.03.2012;2012;03;01;Keskiviikko;2;0;2;2;1;3
96;21.03.2012;2012;03;02;Keskiviikko;0;0;0;1;0;1
96;21.03.2012;2012;03;03;Keskiviikko;1;2;3;0;0;0
96;21.03.2012;2012;03;04;Keskiviikko;8;4;12;0;0;0
96;21.03.2012;2012;03;05;Keskiviikko;4;9;13;1;0;1
96;21.03.2012;2012;03;06;Keskiviikko;33;21;54;18;7;25
96;21.03.2012;2012;03;07;Keskiviikko;82;54;136;43;20;63
96;21.03.2012;2012;03;08;Keskiviikko;93;57;150;42;7;49
96;21.03.2012;2012;03;09;Keskiviikko;36;46;82;14;23;37
96;21.03.2012;2012;03;10;Keskiviikko;27;35;62;6;18;24
96;21.03.2012;2012;03;11;Keskiviikko;29;32;61;21;18;39
96;21.03.2012;2012;03;12;Keskiviikko;36;40;76;23;15;38
96;21.03.2012;2012;03;13;Keskiviikko;53;53;106;13;13;26
96;21.03.2012;2012;03;14;Keskiviikko;64;49;113;16;17;33
96;21.03.2012;2012;03;15;Keskiviikko;56;113;169;36;48;84
96;21.03.2012;2012;03;16;Keskiviikko;54;111;165;17;41;58
96;21.03.2012;2012;03;17;Keskiviikko;57;45;102;19;19;38
96;21.03.2012;2012;03;18;Keskiviikko;71;23;94;24;15;39
96;21.03.2012;2012;03;19;Keskiviikko;45;43;88;25;15;40
96;21.03.2012;2012;03;20;Keskiviikko;42;15;57;8;5;13
96;21.03.2012;2012;03;21;Keskiviikko;28;21;49;3;10;13
96;21.03.2012;2012;03;22;Keskiviikko;9;10;19;1;6;7
96;21.03.2012;2012;03;23;Keskiviikko;3;7;10;4;4;8
96;22.03.2012;2012;03;00;Torstai;2;1;3;1;0;1
96;22.03.2012;2012;03;01;Torstai;4;0;4;0;0;0
96;22.03.2012;2012;03;02;Torstai;4;0;4;0;0;0
96;22.03.2012;2012;03;03;Torstai;0;0;0;0;0;0
96;22.03.2012;2012;03;04;Torstai;1;1;2;0;0;0
96;22.03.2012;2012;03;05;Torstai;3;7;10;0;0;0
96;22.03.2012;2012;03;06;Torstai;41;15;56;10;5;15
96;22.03.2012;2012;03;07;Torstai;64;59;123;43;16;59
96;22.03.2012;2012;03;08;Torstai;69;86;155;26;12;38
96;22.03.2012;2012;03;09;Torstai;30;47;77;11;11;22
96;22.03.2012;2012;03;10;Torstai;38;30;68;3;13;16
96;22.03.2012;2012;03;11;Torstai;43;25;68;3;6;9
96;22.03.2012;2012;03;12;Torstai;25;36;61;8;14;22
96;22.03.2012;2012;03;13;Torstai;29;34;63;13;10;23
96;22.03.2012;2012;03;14;Torstai;42;58;100;10;14;24
96;22.03.2012;2012;03;15;Torstai;56;109;165;8;33;41
96;22.03.2012;2012;03;16;Torstai;66;105;171;16;36;52
96;22.03.2012;2012;03;17;Torstai;39;44;83;10;15;25
96;22.03.2012;2012;03;18;Torstai;41;36;77;10;15;25
96;22.03.2012;2012;03;19;Torstai;29;24;53;27;15;42
96;22.03.2012;2012;03;20;Torstai;26;16;42;22;15;37
96;22.03.2012;2012;03;21;Torstai;20;10;30;9;17;26
96;22.03.2012;2012;03;22;Torstai;8;7;15;0;4;4
96;22.03.2012;2012;03;23;Torstai;2;5;7;2;0;2
96;23.03.2012;2012;03;00;Perjantai;2;1;3;1;1;2
96;23.03.2012;2012;03;01;Perjantai;2;0;2;1;0;1
96;23.03.2012;2012;03;02;Perjantai;5;0;5;1;0;1
96;23.03.2012;2012;03;03;Perjantai;1;0;1;1;0;1
96;23.03.2012;2012;03;04;Perjantai;8;2;10;1;0;1
96;23.03.2012;2012;03;05;Perjantai;3;9;12;1;0;1
96;23.03.2012;2012;03;06;Perjantai;38;16;54;8;6;14
96;23.03.2012;2012;03;07;Perjantai;78;60;138;37;19;56
96;23.03.2012;2012;03;08;Perjantai;82;75;157;21;15;36
96;23.03.2012;2012;03;09;Perjantai;28;41;69;13;14;27
96;23.03.2012;2012;03;10;Perjantai;30;32;62;15;23;38
96;23.03.2012;2012;03;11;Perjantai;35;54;89;18;9;27
96;23.03.2012;2012;03;12;Perjantai;46;49;95;23;22;45
96;23.03.2012;2012;03;13;Perjantai;34;67;101;15;19;34
96;23.03.2012;2012;03;14;Perjantai;67;71;138;12;22;34
96;23.03.2012;2012;03;15;Perjantai;54;93;147;7;43;50
96;23.03.2012;2012;03;16;Perjantai;53;51;104;9;23;32
96;23.03.2012;2012;03;17;Perjantai;41;21;62;10;9;19
96;23.03.2012;2012;03;18;Perjantai;22;15;37;12;14;26
96;23.03.2012;2012;03;19;Perjantai;24;21;45;10;7;17
96;23.03.2012;2012;03;20;Perjantai;14;7;21;8;11;19
96;23.03.2012;2012;03;21;Perjantai;7;13;20;5;13;18
96;23.03.2012;2012;03;22;Perjantai;5;5;10;3;4;7
96;23.03.2012;2012;03;23;Perjantai;4;2;6;3;0;3
96;24.03.2012;2012;03;00;Lauantai;4;1;5;1;2;3
96;24.03.2012;2012;03;01;Lauantai;12;0;12;3;0;3
96;24.03.2012;2012;03;02;Lauantai;6;0;6;3;0;3
96;24.03.2012;2012;03;03;Lauantai;7;0;7;0;0;0
96;24.03.2012;2012;03;04;Lauantai;4;0;4;1;1;2
96;24.03.2012;2012;03;05;Lauantai;3;4;7;0;0;0
96;24.03.2012;2012;03;06;Lauantai;13;5;18;9;0;9
96;24.03.2012;2012;03;07;Lauantai;1;7;8;1;6;7
96;24.03.2012;2012;03;08;Lauantai;10;13;23;11;7;18
96;24.03.2012;2012;03;09;Lauantai;6;18;24;3;10;13
96;24.03.2012;2012;03;10;Lauantai;12;17;29;8;9;17
96;24.03.2012;2012;03;11;Lauantai;15;34;49;7;15;22
96;24.03.2012;2012;03;12;Lauantai;21;22;43;13;13;26
96;24.03.2012;2012;03;13;Lauantai;23;22;45;12;23;35
96;24.03.2012;2012;03;14;Lauantai;34;24;58;13;8;21
96;24.03.2012;2012;03;15;Lauantai;22;33;55;17;20;37
96;24.03.2012;2012;03;16;Lauantai;30;51;81;9;19;28
96;24.03.2012;2012;03;17;Lauantai;23;18;41;15;8;23
96;24.03.2012;2012;03;18;Lauantai;32;11;43;16;4;20
96;24.03.2012;2012;03;19;Lauantai;18;15;33;10;15;25
96;24.03.2012;2012;03;20;Lauantai;32;8;40;21;5;26
96;24.03.2012;2012;03;21;Lauantai;13;11;24;5;7;12
96;24.03.2012;2012;03;22;Lauantai;6;20;26;0;11;11
96;24.03.2012;2012;03;23;Lauantai;5;6;11;1;0;1
96;25.03.2012;2012;03;00;Sunnuntai;3;2;5;3;2;5
96;25.03.2012;2012;03;01;Sunnuntai;4;3;7;1;0;1
96;25.03.2012;2012;03;02;Sunnuntai;0;0;0;0;0;0
96;25.03.2012;2012;03;03;Sunnuntai;8;0;8;3;1;4
96;25.03.2012;2012;03;04;Sunnuntai;2;2;4;3;0;3
96;25.03.2012;2012;03;05;Sunnuntai;11;4;15;8;1;9
96;25.03.2012;2012;03;06;Sunnuntai;0;0;0;0;0;0
96;25.03.2012;2012;03;07;Sunnuntai;2;5;7;0;4;4
96;25.03.2012;2012;03;08;Sunnuntai;7;5;12;4;4;8
96;25.03.2012;2012;03;09;Sunnuntai;4;11;15;4;8;12
96;25.03.2012;2012;03;10;Sunnuntai;3;7;10;6;6;12
96;25.03.2012;2012;03;11;Sunnuntai;6;10;16;13;11;24
96;25.03.2012;2012;03;12;Sunnuntai;13;13;26;17;19;36
96;25.03.2012;2012;03;13;Sunnuntai;18;26;44;20;27;47
96;25.03.2012;2012;03;14;Sunnuntai;17;24;41;18;20;38
96;25.03.2012;2012;03;15;Sunnuntai;33;18;51;11;10;21
96;25.03.2012;2012;03;16;Sunnuntai;33;29;62;19;11;30
96;25.03.2012;2012;03;17;Sunnuntai;30;22;52;21;13;34
96;25.03.2012;2012;03;18;Sunnuntai;32;20;52;22;18;40
96;25.03.2012;2012;03;19;Sunnuntai;13;16;29;11;10;21
96;25.03.2012;2012;03;20;Sunnuntai;21;23;44;9;17;26
96;25.03.2012;2012;03;21;Sunnuntai;16;17;33;6;17;23
96;25.03.2012;2012;03;22;Sunnuntai;4;3;7;1;1;2
96;25.03.2012;2012;03;23;Sunnuntai;6;3;9;3;0;3
96;26.03.2012;2012;03;00;Maanantai;3;0;3;1;1;2
96;26.03.2012;2012;03;01;Maanantai;1;0;1;1;0;1
96;26.03.2012;2012;03;02;Maanantai;0;0;0;0;0;0
96;26.03.2012;2012;03;03;Maanantai;0;0;0;0;0;0
96;26.03.2012;2012;03;04;Maanantai;1;1;2;0;0;0
96;26.03.2012;2012;03;05;Maanantai;5;7;12;0;1;1
96;26.03.2012;2012;03;06;Maanantai;31;21;52;10;3;13
96;26.03.2012;2012;03;07;Maanantai;79;46;125;38;12;50
96;26.03.2012;2012;03;08;Maanantai;93;76;169;31;10;41
96;26.03.2012;2012;03;09;Maanantai;75;49;124;17;10;27
96;26.03.2012;2012;03;10;Maanantai;47;27;74;19;10;29
96;26.03.2012;2012;03;11;Maanantai;35;29;64;9;8;17
96;26.03.2012;2012;03;12;Maanantai;46;53;99;19;21;40
96;26.03.2012;2012;03;13;Maanantai;37;42;79;13;16;29
96;26.03.2012;2012;03;14;Maanantai;56;67;123;16;20;36
96;26.03.2012;2012;03;15;Maanantai;51;112;163;3;40;43
96;26.03.2012;2012;03;16;Maanantai;65;84;149;10;37;47
96;26.03.2012;2012;03;17;Maanantai;42;34;76;17;13;30
96;26.03.2012;2012;03;18;Maanantai;31;26;57;15;13;28
96;26.03.2012;2012;03;19;Maanantai;13;18;31;7;16;23
96;26.03.2012;2012;03;20;Maanantai;23;14;37;12;7;19
96;26.03.2012;2012;03;21;Maanantai;16;9;25;9;6;15
96;26.03.2012;2012;03;22;Maanantai;2;3;5;0;0;0
96;26.03.2012;2012;03;23;Maanantai;2;1;3;0;0;0
96;27.03.2012;2012;03;00;Tiistai;1;0;1;0;0;0
96;27.03.2012;2012;03;01;Tiistai;0;0;0;0;0;0
96;27.03.2012;2012;03;02;Tiistai;0;0;0;0;0;0
96;27.03.2012;2012;03;03;Tiistai;0;0;0;3;4;7
96;27.03.2012;2012;03;04;Tiistai;2;1;3;0;0;0
96;27.03.2012;2012;03;05;Tiistai;5;3;8;1;0;1
96;27.03.2012;2012;03;06;Tiistai;36;13;49;10;7;17
96;27.03.2012;2012;03;07;Tiistai;68;54;122;38;13;51
96;27.03.2012;2012;03;08;Tiistai;90;62;152;18;14;32
96;27.03.2012;2012;03;09;Tiistai;41;40;81;7;20;27
96;27.03.2012;2012;03;10;Tiistai;22;31;53;14;14;28
96;27.03.2012;2012;03;11;Tiistai;38;37;75;8;7;15
96;27.03.2012;2012;03;12;Tiistai;47;46;93;11;18;29
96;27.03.2012;2012;03;13;Tiistai;40;35;75;13;18;31
96;27.03.2012;2012;03;14;Tiistai;64;59;123;16;24;40
96;27.03.2012;2012;03;15;Tiistai;50;101;151;12;40;52
96;27.03.2012;2012;03;16;Tiistai;59;94;153;11;43;54
96;27.03.2012;2012;03;17;Tiistai;36;47;83;24;20;44
96;27.03.2012;2012;03;18;Tiistai;29;25;54;26;26;52
96;27.03.2012;2012;03;19;Tiistai;36;16;52;25;14;39
96;27.03.2012;2012;03;20;Tiistai;21;14;35;23;17;40
96;27.03.2012;2012;03;21;Tiistai;13;22;35;7;11;18
96;27.03.2012;2012;03;22;Tiistai;5;3;8;1;4;5
96;27.03.2012;2012;03;23;Tiistai;5;1;6;1;0;1
96;28.03.2012;2012;03;00;Keskiviikko;1;2;3;0;0;0
96;28.03.2012;2012;03;01;Keskiviikko;2;0;2;0;0;0
96;28.03.2012;2012;03;02;Keskiviikko;1;0;1;0;0;0
96;28.03.2012;2012;03;03;Keskiviikko;0;0;0;0;0;0
96;28.03.2012;2012;03;04;Keskiviikko;2;1;3;0;0;0
96;28.03.2012;2012;03;05;Keskiviikko;5;7;12;0;1;1
96;28.03.2012;2012;03;06;Keskiviikko;37;21;58;16;9;25
96;28.03.2012;2012;03;07;Keskiviikko;62;55;117;48;14;62
96;28.03.2012;2012;03;08;Keskiviikko;96;59;155;25;13;38
96;28.03.2012;2012;03;09;Keskiviikko;49;52;101;12;10;22
96;28.03.2012;2012;03;10;Keskiviikko;33;30;63;8;10;18
96;28.03.2012;2012;03;11;Keskiviikko;22;42;64;11;15;26
96;28.03.2012;2012;03;12;Keskiviikko;32;56;88;32;33;65
96;28.03.2012;2012;03;13;Keskiviikko;45;60;105;15;14;29
96;28.03.2012;2012;03;14;Keskiviikko;57;72;129;4;27;31
96;28.03.2012;2012;03;15;Keskiviikko;46;132;178;11;41;52
96;28.03.2012;2012;03;16;Keskiviikko;60;92;152;11;48;59
96;28.03.2012;2012;03;17;Keskiviikko;43;52;95;16;24;40
96;28.03.2012;2012;03;18;Keskiviikko;34;54;88;19;40;59
96;28.03.2012;2012;03;19;Keskiviikko;35;23;58;19;12;31
96;28.03.2012;2012;03;20;Keskiviikko;44;29;73;20;24;44
96;28.03.2012;2012;03;21;Keskiviikko;45;24;69;15;10;25
96;28.03.2012;2012;03;22;Keskiviikko;10;8;18;0;4;4
96;28.03.2012;2012;03;23;Keskiviikko;7;3;10;0;0;0
96;29.03.2012;2012;03;00;Torstai;1;1;2;0;1;1
96;29.03.2012;2012;03;01;Torstai;0;0;0;0;0;0
96;29.03.2012;2012;03;02;Torstai;1;1;2;1;0;1
96;29.03.2012;2012;03;03;Torstai;0;0;0;0;0;0
96;29.03.2012;2012;03;04;Torstai;4;3;7;1;0;1
96;29.03.2012;2012;03;05;Torstai;3;3;6;0;0;0
96;29.03.2012;2012;03;06;Torstai;31;14;45;12;6;18
96;29.03.2012;2012;03;07;Torstai;67;51;118;35;11;46
96;29.03.2012;2012;03;08;Torstai;84;69;153;25;12;37
96;29.03.2012;2012;03;09;Torstai;39;43;82;13;12;25
96;29.03.2012;2012;03;10;Torstai;34;34;68;6;9;15
96;29.03.2012;2012;03;11;Torstai;40;27;67;8;7;15
96;29.03.2012;2012;03;12;Torstai;54;36;90;12;10;22
96;29.03.2012;2012;03;13;Torstai;41;42;83;11;13;24
96;29.03.2012;2012;03;14;Torstai;48;69;117;10;22;32
96;29.03.2012;2012;03;15;Torstai;41;101;142;6;46;52
96;29.03.2012;2012;03;16;Torstai;55;103;158;16;35;51
96;29.03.2012;2012;03;17;Torstai;42;53;95;16;17;33
96;29.03.2012;2012;03;18;Torstai;28;39;67;16;19;35
96;29.03.2012;2012;03;19;Torstai;34;25;59;12;12;24
96;29.03.2012;2012;03;20;Torstai;31;24;55;21;16;37
96;29.03.2012;2012;03;21;Torstai;29;17;46;6;14;20
96;29.03.2012;2012;03;22;Torstai;6;6;12;2;3;5
96;29.03.2012;2012;03;23;Torstai;3;2;5;0;0;0
96;30.03.2012;2012;03;00;Perjantai;2;0;2;2;0;2
96;30.03.2012;2012;03;01;Perjantai;0;0;0;1;0;1
96;30.03.2012;2012;03;02;Perjantai;0;0;0;0;0;0
96;30.03.2012;2012;03;03;Perjantai;1;0;1;0;0;0
96;30.03.2012;2012;03;04;Perjantai;2;1;3;0;0;0
96;30.03.2012;2012;03;05;Perjantai;3;4;7;0;0;0
96;30.03.2012;2012;03;06;Perjantai;28;14;42;9;4;13
96;30.03.2012;2012;03;07;Perjantai;75;46;121;38;11;49
96;30.03.2012;2012;03;08;Perjantai;93;73;166;22;11;33
96;30.03.2012;2012;03;09;Perjantai;38;31;69;10;10;20
96;30.03.2012;2012;03;10;Perjantai;29;35;64;8;7;15
96;30.03.2012;2012;03;11;Perjantai;36;47;83;11;16;27
96;30.03.2012;2012;03;12;Perjantai;50;45;95;17;19;36
96;30.03.2012;2012;03;13;Perjantai;35;55;90;18;21;39
96;30.03.2012;2012;03;14;Perjantai;44;88;132;7;29;36
96;30.03.2012;2012;03;15;Perjantai;52;117;169;14;35;49
96;30.03.2012;2012;03;16;Perjantai;60;53;113;10;24;34
96;30.03.2012;2012;03;17;Perjantai;24;33;57;13;19;32
96;30.03.2012;2012;03;18;Perjantai;32;16;48;16;9;25
96;30.03.2012;2012;03;19;Perjantai;27;24;51;6;9;15
96;30.03.2012;2012;03;20;Perjantai;26;20;46;10;5;15
96;30.03.2012;2012;03;21;Perjantai;22;30;52;6;9;15
96;30.03.2012;2012;03;22;Perjantai;8;4;12;0;4;4
96;30.03.2012;2012;03;23;Perjantai;8;3;11;0;1;1
96;31.03.2012;2012;03;00;Lauantai;3;2;5;0;0;0
96;31.03.2012;2012;03;01;Lauantai;5;0;5;1;1;2
96;31.03.2012;2012;03;02;Lauantai;8;1;9;3;0;3
96;31.03.2012;2012;03;03;Lauantai;2;2;4;1;1;2
96;31.03.2012;2012;03;04;Lauantai;3;0;3;0;0;0
96;31.03.2012;2012;03;05;Lauantai;1;3;4;0;2;2
96;31.03.2012;2012;03;06;Lauantai;16;6;22;6;3;9
96;31.03.2012;2012;03;07;Lauantai;2;7;9;1;4;5
96;31.03.2012;2012;03;08;Lauantai;5;16;21;3;2;5
96;31.03.2012;2012;03;09;Lauantai;5;25;30;9;12;21
96;31.03.2012;2012;03;10;Lauantai;20;28;48;18;12;30
96;31.03.2012;2012;03;11;Lauantai;30;34;64;29;20;49
96;31.03.2012;2012;03;12;Lauantai;27;36;63;25;30;55
96;31.03.2012;2012;03;13;Lauantai;41;26;67;14;17;31
96;31.03.2012;2012;03;14;Lauantai;29;27;56;13;28;41
96;31.03.2012;2012;03;15;Lauantai;22;37;59;7;13;20
96;31.03.2012;2012;03;16;Lauantai;19;43;62;8;22;30
96;31.03.2012;2012;03;17;Lauantai;31;20;51;35;14;49
96;31.03.2012;2012;03;18;Lauantai;26;10;36;16;4;20
96;31.03.2012;2012;03;19;Lauantai;38;14;52;25;23;48
96;31.03.2012;2012;03;20;Lauantai;22;29;51;10;13;23
96;31.03.2012;2012;03;21;Lauantai;7;18;25;4;10;14
96;31.03.2012;2012;03;22;Lauantai;4;1;5;1;2;3
96;31.03.2012;2012;03;23;Lauantai;5;8;13;0;0;0
96;01.04.2012;2012;04;00;Sunnuntai;2;2;4;0;0;0
96;01.04.2012;2012;04;01;Sunnuntai;7;1;8;3;0;3
96;01.04.2012;2012;04;02;Sunnuntai;6;2;8;1;0;1
96;01.04.2012;2012;04;03;Sunnuntai;3;0;3;0;0;0
96;01.04.2012;2012;04;04;Sunnuntai;2;1;3;5;0;5
96;01.04.2012;2012;04;05;Sunnuntai;0;0;0;0;1;1
96;01.04.2012;2012;04;06;Sunnuntai;15;5;20;7;0;7
96;01.04.2012;2012;04;07;Sunnuntai;5;3;8;1;4;5
96;01.04.2012;2012;04;08;Sunnuntai;4;3;7;2;3;5
96;01.04.2012;2012;04;09;Sunnuntai;2;3;5;6;9;15
96;01.04.2012;2012;04;10;Sunnuntai;5;5;10;8;13;21
96;01.04.2012;2012;04;11;Sunnuntai;9;19;28;17;14;31
96;01.04.2012;2012;04;12;Sunnuntai;20;24;44;22;27;49
96;01.04.2012;2012;04;13;Sunnuntai;27;18;45;18;18;36
96;01.04.2012;2012;04;14;Sunnuntai;17;34;51;12;14;26
96;01.04.2012;2012;04;15;Sunnuntai;31;25;56;13;14;27
96;01.04.2012;2012;04;16;Sunnuntai;32;23;55;33;15;48
96;01.04.2012;2012;04;17;Sunnuntai;24;7;31;16;11;27
96;01.04.2012;2012;04;18;Sunnuntai;31;20;51;23;18;41
96;01.04.2012;2012;04;19;Sunnuntai;13;11;24;12;12;24
96;01.04.2012;2012;04;20;Sunnuntai;13;21;34;16;14;30
96;01.04.2012;2012;04;21;Sunnuntai;6;21;27;3;9;12
96;01.04.2012;2012;04;22;Sunnuntai;1;7;8;2;3;5
96;01.04.2012;2012;04;23;Sunnuntai;1;4;5;0;0;0
96;02.04.2012;2012;04;00;Maanantai;1;0;1;0;0;0
96;02.04.2012;2012;04;01;Maanantai;2;0;2;2;2;4
96;02.04.2012;2012;04;02;Maanantai;0;0;0;0;0;0
96;02.04.2012;2012;04;03;Maanantai;0;0;0;0;0;0
96;02.04.2012;2012;04;04;Maanantai;3;3;6;0;1;1
96;02.04.2012;2012;04;05;Maanantai;1;4;5;0;0;0
96;02.04.2012;2012;04;06;Maanantai;31;19;50;11;3;14
96;02.04.2012;2012;04;07;Maanantai;69;54;123;26;14;40
96;02.04.2012;2012;04;08;Maanantai;94;69;163;24;10;34
96;02.04.2012;2012;04;09;Maanantai;43;43;86;28;13;41
96;02.04.2012;2012;04;10;Maanantai;32;33;65;9;17;26
96;02.04.2012;2012;04;11;Maanantai;44;52;96;11;11;22
96;02.04.2012;2012;04;12;Maanantai;45;43;88;11;11;22
96;02.04.2012;2012;04;13;Maanantai;53;50;103;13;14;27
96;02.04.2012;2012;04;14;Maanantai;53;68;121;13;29;42
96;02.04.2012;2012;04;15;Maanantai;59;139;198;17;45;62
96;02.04.2012;2012;04;16;Maanantai;58;110;168;16;42;58
96;02.04.2012;2012;04;17;Maanantai;62;55;117;19;15;34
96;02.04.2012;2012;04;18;Maanantai;48;35;83;21;20;41
96;02.04.2012;2012;04;19;Maanantai;35;33;68;18;30;48
96;02.04.2012;2012;04;20;Maanantai;30;22;52;16;15;31
96;02.04.2012;2012;04;21;Maanantai;27;25;52;7;13;20
96;02.04.2012;2012;04;22;Maanantai;13;4;17;2;2;4
96;02.04.2012;2012;04;23;Maanantai;2;2;4;2;2;4
96;03.04.2012;2012;04;00;Tiistai;0;0;0;0;0;0
96;03.04.2012;2012;04;01;Tiistai;1;0;1;0;2;2
96;03.04.2012;2012;04;02;Tiistai;0;0;0;0;0;0
96;03.04.2012;2012;04;03;Tiistai;0;0;0;0;0;0
96;03.04.2012;2012;04;04;Tiistai;1;1;2;0;0;0
96;03.04.2012;2012;04;05;Tiistai;1;6;7;0;0;0
96;03.04.2012;2012;04;06;Tiistai;40;21;61;10;5;15
96;03.04.2012;2012;04;07;Tiistai;78;53;131;31;13;44
96;03.04.2012;2012;04;08;Tiistai;85;72;157;29;12;41
96;03.04.2012;2012;04;09;Tiistai;44;54;98;10;10;20
96;03.04.2012;2012;04;10;Tiistai;29;38;67;13;13;26
96;03.04.2012;2012;04;11;Tiistai;45;40;85;8;15;23
96;03.04.2012;2012;04;12;Tiistai;46;56;102;8;12;20
96;03.04.2012;2012;04;13;Tiistai;37;40;77;13;10;23
96;03.04.2012;2012;04;14;Tiistai;60;84;144;12;22;34
96;03.04.2012;2012;04;15;Tiistai;65;126;191;14;46;60
96;03.04.2012;2012;04;16;Tiistai;83;106;189;19;38;57
96;03.04.2012;2012;04;17;Tiistai;44;52;96;20;17;37
96;03.04.2012;2012;04;18;Tiistai;42;39;81;30;26;56
96;03.04.2012;2012;04;19;Tiistai;32;23;55;22;18;40
96;03.04.2012;2012;04;20;Tiistai;35;12;47;17;11;28
96;03.04.2012;2012;04;21;Tiistai;31;16;47;12;8;20
96;03.04.2012;2012;04;22;Tiistai;6;5;11;0;4;4
96;03.04.2012;2012;04;23;Tiistai;4;1;5;1;0;1
96;04.04.2012;2012;04;00;Keskiviikko;2;1;3;0;0;0
96;04.04.2012;2012;04;01;Keskiviikko;1;1;2;0;0;0
96;04.04.2012;2012;04;02;Keskiviikko;0;0;0;0;0;0
96;04.04.2012;2012;04;03;Keskiviikko;0;0;0;0;0;0
96;04.04.2012;2012;04;04;Keskiviikko;1;1;2;0;2;2
96;04.04.2012;2012;04;05;Keskiviikko;2;8;10;0;0;0
96;04.04.2012;2012;04;06;Keskiviikko;29;22;51;10;5;15
96;04.04.2012;2012;04;07;Keskiviikko;85;61;146;30;8;38
96;04.04.2012;2012;04;08;Keskiviikko;84;57;141;22;14;36
96;04.04.2012;2012;04;09;Keskiviikko;57;58;115;17;14;31
96;04.04.2012;2012;04;10;Keskiviikko;36;37;73;14;16;30
96;04.04.2012;2012;04;11;Keskiviikko;38;47;85;20;13;33
96;04.04.2012;2012;04;12;Keskiviikko;53;77;130;12;24;36
96;04.04.2012;2012;04;13;Keskiviikko;64;51;115;13;15;28
96;04.04.2012;2012;04;14;Keskiviikko;63;62;125;17;17;34
96;04.04.2012;2012;04;15;Keskiviikko;57;146;203;9;45;54
96;04.04.2012;2012;04;16;Keskiviikko;70;116;186;18;35;53
96;04.04.2012;2012;04;17;Keskiviikko;44;51;95;14;17;31
96;04.04.2012;2012;04;18;Keskiviikko;52;36;88;18;15;33
96;04.04.2012;2012;04;19;Keskiviikko;46;25;71;18;11;29
96;04.04.2012;2012;04;20;Keskiviikko;44;16;60;4;11;15
96;04.04.2012;2012;04;21;Keskiviikko;23;31;54;2;11;13
96;04.04.2012;2012;04;22;Keskiviikko;6;6;12;4;4;8
96;04.04.2012;2012;04;23;Keskiviikko;6;5;11;1;0;1
96;05.04.2012;2012;04;00;Torstai;10;0;10;0;0;0
96;05.04.2012;2012;04;01;Torstai;7;2;9;0;0;0
96;05.04.2012;2012;04;02;Torstai;5;2;7;1;0;1
96;05.04.2012;2012;04;03;Torstai;2;0;2;1;0;1
96;05.04.2012;2012;04;04;Torstai;6;3;9;0;2;2
96;05.04.2012;2012;04;05;Torstai;0;6;6;0;0;0
96;05.04.2012;2012;04;06;Torstai;41;17;58;11;6;17
96;05.04.2012;2012;04;07;Torstai;70;58;128;29;15;44
96;05.04.2012;2012;04;08;Torstai;73;76;149;25;14;39
96;05.04.2012;2012;04;09;Torstai;17;45;62;8;13;21
96;05.04.2012;2012;04;10;Torstai;31;37;68;6;6;12
96;05.04.2012;2012;04;11;Torstai;41;35;76;8;17;25
96;05.04.2012;2012;04;12;Torstai;59;46;105;13;18;31
96;05.04.2012;2012;04;13;Torstai;59;74;133;12;10;22
96;05.04.2012;2012;04;14;Torstai;55;75;130;11;20;31
96;05.04.2012;2012;04;15;Torstai;59;116;175;8;32;40
96;05.04.2012;2012;04;16;Torstai;49;46;95;7;35;42
96;05.04.2012;2012;04;17;Torstai;36;37;73;11;10;21
96;05.04.2012;2012;04;18;Torstai;23;15;38;11;11;22
96;05.04.2012;2012;04;19;Torstai;37;22;59;6;8;14
96;05.04.2012;2012;04;20;Torstai;27;13;40;6;7;13
96;05.04.2012;2012;04;21;Torstai;10;21;31;4;6;10
96;05.04.2012;2012;04;22;Torstai;14;14;28;1;2;3
96;05.04.2012;2012;04;23;Torstai;7;3;10;1;0;1
96;06.04.2012;2012;04;00;Perjantai;4;3;7;2;1;3
96;06.04.2012;2012;04;01;Perjantai;3;0;3;0;0;0
96;06.04.2012;2012;04;02;Perjantai;5;0;5;0;0;0
96;06.04.2012;2012;04;03;Perjantai;7;1;8;2;2;4
96;06.04.2012;2012;04;04;Perjantai;2;0;2;2;0;2
96;06.04.2012;2012;04;05;Perjantai;2;1;3;1;1;2
96;06.04.2012;2012;04;06;Perjantai;15;4;19;5;0;5
96;06.04.2012;2012;04;07;Perjantai;4;9;13;0;6;6
96;06.04.2012;2012;04;08;Perjantai;4;3;7;3;3;6
96;06.04.2012;2012;04;09;Perjantai;5;5;10;5;0;5
96;06.04.2012;2012;04;10;Perjantai;5;17;22;8;7;15
96;06.04.2012;2012;04;11;Perjantai;11;14;25;12;9;21
96;06.04.2012;2012;04;12;Perjantai;17;22;39;10;14;24
96;06.04.2012;2012;04;13;Perjantai;24;17;41;12;14;26
96;06.04.2012;2012;04;14;Perjantai;17;28;45;14;12;26
96;06.04.2012;2012;04;15;Perjantai;7;21;28;11;18;29
96;06.04.2012;2012;04;16;Perjantai;28;15;43;13;11;24
96;06.04.2012;2012;04;17;Perjantai;20;19;39;9;7;16
96;06.04.2012;2012;04;18;Perjantai;12;19;31;10;15;25
96;06.04.2012;2012;04;19;Perjantai;11;6;17;5;10;15
96;06.04.2012;2012;04;20;Perjantai;12;6;18;10;1;11
96;06.04.2012;2012;04;21;Perjantai;13;15;28;5;6;11
96;06.04.2012;2012;04;22;Perjantai;1;12;13;2;4;6
96;06.04.2012;2012;04;23;Perjantai;6;1;7;0;1;1
96;07.04.2012;2012;04;00;Lauantai;7;4;11;0;0;0
96;07.04.2012;2012;04;01;Lauantai;1;0;1;0;0;0
96;07.04.2012;2012;04;02;Lauantai;3;0;3;1;0;1
96;07.04.2012;2012;04;03;Lauantai;6;2;8;2;1;3
96;07.04.2012;2012;04;04;Lauantai;2;1;3;1;0;1
96;07.04.2012;2012;04;05;Lauantai;1;1;2;0;0;0
96;07.04.2012;2012;04;06;Lauantai;12;7;19;4;2;6
96;07.04.2012;2012;04;07;Lauantai;4;7;11;2;6;8
96;07.04.2012;2012;04;08;Lauantai;6;10;16;1;4;5
96;07.04.2012;2012;04;09;Lauantai;10;19;29;9;7;16
96;07.04.2012;2012;04;10;Lauantai;7;24;31;3;6;9
96;07.04.2012;2012;04;11;Lauantai;23;19;42;7;13;20
96;07.04.2012;2012;04;12;Lauantai;30;38;68;12;17;29
96;07.04.2012;2012;04;13;Lauantai;30;36;66;13;11;24
96;07.04.2012;2012;04;14;Lauantai;28;20;48;12;17;29
96;07.04.2012;2012;04;15;Lauantai;20;37;57;11;13;24
96;07.04.2012;2012;04;16;Lauantai;28;24;52;11;9;20
96;07.04.2012;2012;04;17;Lauantai;40;21;61;9;7;16
96;07.04.2012;2012;04;18;Lauantai;25;14;39;7;5;12
96;07.04.2012;2012;04;19;Lauantai;12;6;18;4;4;8
96;07.04.2012;2012;04;20;Lauantai;8;16;24;1;6;7
96;07.04.2012;2012;04;21;Lauantai;9;13;22;6;3;9
96;07.04.2012;2012;04;22;Lauantai;10;7;17;0;6;6
96;07.04.2012;2012;04;23;Lauantai;2;10;12;0;0;0
96;08.04.2012;2012;04;00;Sunnuntai;3;5;8;0;0;0
96;08.04.2012;2012;04;01;Sunnuntai;5;2;7;2;0;2
96;08.04.2012;2012;04;02;Sunnuntai;2;1;3;4;0;4
96;08.04.2012;2012;04;03;Sunnuntai;9;1;10;5;0;5
96;08.04.2012;2012;04;04;Sunnuntai;7;0;7;0;0;0
96;08.04.2012;2012;04;05;Sunnuntai;5;1;6;1;1;2
96;08.04.2012;2012;04;06;Sunnuntai;9;4;13;6;0;6
96;08.04.2012;2012;04;07;Sunnuntai;3;7;10;2;2;4
96;08.04.2012;2012;04;08;Sunnuntai;3;1;4;3;5;8
96;08.04.2012;2012;04;09;Sunnuntai;4;6;10;3;4;7
96;08.04.2012;2012;04;10;Sunnuntai;6;13;19;8;8;16
96;08.04.2012;2012;04;11;Sunnuntai;4;12;16;11;11;22
96;08.04.2012;2012;04;12;Sunnuntai;17;14;31;6;15;21
96;08.04.2012;2012;04;13;Sunnuntai;18;22;40;9;11;20
96;08.04.2012;2012;04;14;Sunnuntai;11;25;36;7;12;19
96;08.04.2012;2012;04;15;Sunnuntai;10;24;34;10;8;18
96;08.04.2012;2012;04;16;Sunnuntai;31;14;45;14;11;25
96;08.04.2012;2012;04;17;Sunnuntai;12;23;35;11;10;21
96;08.04.2012;2012;04;18;Sunnuntai;20;7;27;11;11;22
96;08.04.2012;2012;04;19;Sunnuntai;9;18;27;5;9;14
96;08.04.2012;2012;04;20;Sunnuntai;13;13;26;6;8;14
96;08.04.2012;2012;04;21;Sunnuntai;9;10;19;2;6;8
96;08.04.2012;2012;04;22;Sunnuntai;1;8;9;1;0;1
96;08.04.2012;2012;04;23;Sunnuntai;2;5;7;0;0;0
96;09.04.2012;2012;04;00;Maanantai;2;1;3;1;0;1
96;09.04.2012;2012;04;01;Maanantai;2;0;2;1;0;1
96;09.04.2012;2012;04;02;Maanantai;1;1;2;0;0;0
96;09.04.2012;2012;04;03;Maanantai;1;0;1;1;0;1
96;09.04.2012;2012;04;04;Maanantai;0;0;0;0;0;0
96;09.04.2012;2012;04;05;Maanantai;0;0;0;0;0;0
96;09.04.2012;2012;04;06;Maanantai;12;2;14;5;0;5
96;09.04.2012;2012;04;07;Maanantai;2;6;8;1;4;5
96;09.04.2012;2012;04;08;Maanantai;2;2;4;4;4;8
96;09.04.2012;2012;04;09;Maanantai;7;10;17;12;8;20
96;09.04.2012;2012;04;10;Maanantai;8;16;24;5;8;13
96;09.04.2012;2012;04;11;Maanantai;13;11;24;14;8;22
96;09.04.2012;2012;04;12;Maanantai;18;24;42;18;6;24
96;09.04.2012;2012;04;13;Maanantai;17;25;42;3;13;16
96;09.04.2012;2012;04;14;Maanantai;15;27;42;12;9;21
96;09.04.2012;2012;04;15;Maanantai;23;29;52;11;12;23
96;09.04.2012;2012;04;16;Maanantai;32;15;47;20;9;29
96;09.04.2012;2012;04;17;Maanantai;18;22;40;14;13;27
96;09.04.2012;2012;04;18;Maanantai;22;23;45;12;14;26
96;09.04.2012;2012;04;19;Maanantai;17;21;38;6;14;20
96;09.04.2012;2012;04;20;Maanantai;17;23;40;11;11;22
96;09.04.2012;2012;04;21;Maanantai;8;17;25;5;4;9
96;09.04.2012;2012;04;22;Maanantai;7;3;10;3;1;4
96;09.04.2012;2012;04;23;Maanantai;5;3;8;2;0;2
96;10.04.2012;2012;04;00;Tiistai;1;0;1;0;0;0
96;10.04.2012;2012;04;01;Tiistai;4;0;4;0;1;1
96;10.04.2012;2012;04;02;Tiistai;0;0;0;0;0;0
96;10.04.2012;2012;04;03;Tiistai;1;0;1;0;0;0
96;10.04.2012;2012;04;04;Tiistai;3;4;7;0;0;0
96;10.04.2012;2012;04;05;Tiistai;2;8;10;0;0;0
96;10.04.2012;2012;04;06;Tiistai;35;19;54;11;3;14
96;10.04.2012;2012;04;07;Tiistai;78;67;145;36;8;44
96;10.04.2012;2012;04;08;Tiistai;69;88;157;16;20;36
96;10.04.2012;2012;04;09;Tiistai;37;77;114;19;11;30
96;10.04.2012;2012;04;10;Tiistai;29;35;64;11;6;17
96;10.04.2012;2012;04;11;Tiistai;48;43;91;9;6;15
96;10.04.2012;2012;04;12;Tiistai;50;54;104;7;13;20
96;10.04.2012;2012;04;13;Tiistai;40;35;75;10;10;20
96;10.04.2012;2012;04;14;Tiistai;41;79;120;6;17;23
96;10.04.2012;2012;04;15;Tiistai;55;114;169;11;32;43
96;10.04.2012;2012;04;16;Tiistai;75;99;174;8;29;37
96;10.04.2012;2012;04;17;Tiistai;45;41;86;10;4;14
96;10.04.2012;2012;04;18;Tiistai;31;19;50;17;10;27
96;10.04.2012;2012;04;19;Tiistai;22;27;49;11;9;20
96;10.04.2012;2012;04;20;Tiistai;27;23;50;15;8;23
96;10.04.2012;2012;04;21;Tiistai;22;26;48;11;9;20
96;10.04.2012;2012;04;22;Tiistai;15;2;17;2;2;4
96;10.04.2012;2012;04;23;Tiistai;4;1;5;0;0;0
96;11.04.2012;2012;04;00;Keskiviikko;3;0;3;0;1;1
96;11.04.2012;2012;04;01;Keskiviikko;2;2;4;0;0;0
96;11.04.2012;2012;04;02;Keskiviikko;0;0;0;0;0;0
96;11.04.2012;2012;04;03;Keskiviikko;1;0;1;0;0;0
96;11.04.2012;2012;04;04;Keskiviikko;1;3;4;0;0;0
96;11.04.2012;2012;04;05;Keskiviikko;5;6;11;0;0;0
96;11.04.2012;2012;04;06;Keskiviikko;36;26;62;11;4;15
96;11.04.2012;2012;04;07;Keskiviikko;56;63;119;25;10;35
96;11.04.2012;2012;04;08;Keskiviikko;80;43;123;18;11;29
96;11.04.2012;2012;04;09;Keskiviikko;30;46;76;15;9;24
96;11.04.2012;2012;04;10;Keskiviikko;27;31;58;6;6;12
96;11.04.2012;2012;04;11;Keskiviikko;29;30;59;4;10;14
96;11.04.2012;2012;04;12;Keskiviikko;34;42;76;9;7;16
96;11.04.2012;2012;04;13;Keskiviikko;32;31;63;8;7;15
96;11.04.2012;2012;04;14;Keskiviikko;37;69;106;12;22;34
96;11.04.2012;2012;04;15;Keskiviikko;42;119;161;12;35;47
96;11.04.2012;2012;04;16;Keskiviikko;58;74;132;14;28;42
96;11.04.2012;2012;04;17;Keskiviikko;46;47;93;16;14;30
96;11.04.2012;2012;04;18;Keskiviikko;26;24;50;16;12;28
96;11.04.2012;2012;04;19;Keskiviikko;43;25;68;17;18;35
96;11.04.2012;2012;04;20;Keskiviikko;26;30;56;12;12;24
96;11.04.2012;2012;04;21;Keskiviikko;36;26;62;7;16;23
96;11.04.2012;2012;04;22;Keskiviikko;3;2;5;2;3;5
96;11.04.2012;2012;04;23;Keskiviikko;6;5;11;0;0;0
96;12.04.2012;2012;04;00;Torstai;5;1;6;2;0;2
96;12.04.2012;2012;04;01;Torstai;1;0;1;0;0;0
96;12.04.2012;2012;04;02;Torstai;4;0;4;1;0;1
96;12.04.2012;2012;04;03;Torstai;3;0;3;0;0;0
96;12.04.2012;2012;04;04;Torstai;3;2;5;0;0;0
96;12.04.2012;2012;04;05;Torstai;3;5;8;0;0;0
96;12.04.2012;2012;04;06;Torstai;30;20;50;11;2;13
96;12.04.2012;2012;04;07;Torstai;60;81;141;27;9;36
96;12.04.2012;2012;04;08;Torstai;84;77;161;21;7;28
96;12.04.2012;2012;04;09;Torstai;29;58;87;12;9;21
96;12.04.2012;2012;04;10;Torstai;39;35;74;13;13;26
96;12.04.2012;2012;04;11;Torstai;32;35;67;11;11;22
96;12.04.2012;2012;04;12;Torstai;55;44;99;11;12;23
96;12.04.2012;2012;04;13;Torstai;44;59;103;9;17;26
96;12.04.2012;2012;04;14;Torstai;66;69;135;13;17;30
96;12.04.2012;2012;04;15;Torstai;57;120;177;12;26;38
96;12.04.2012;2012;04;16;Torstai;59;114;173;9;27;36
96;12.04.2012;2012;04;17;Torstai;86;55;141;12;18;30
96;12.04.2012;2012;04;18;Torstai;30;32;62;14;17;31
96;12.04.2012;2012;04;19;Torstai;27;22;49;17;19;36
96;12.04.2012;2012;04;20;Torstai;34;17;51;24;18;42
96;12.04.2012;2012;04;21;Torstai;22;31;53;9;12;21
96;12.04.2012;2012;04;22;Torstai;4;11;15;1;8;9
96;12.04.2012;2012;04;23;Torstai;1;2;3;0;1;1
96;13.04.2012;2012;04;00;Perjantai;3;2;5;1;1;2
96;13.04.2012;2012;04;01;Perjantai;5;0;5;2;2;4
96;13.04.2012;2012;04;02;Perjantai;4;0;4;3;0;3
96;13.04.2012;2012;04;03;Perjantai;2;0;2;1;0;1
96;13.04.2012;2012;04;04;Perjantai;1;3;4;1;1;2
96;13.04.2012;2012;04;05;Perjantai;3;10;13;0;0;0
96;13.04.2012;2012;04;06;Perjantai;33;20;53;10;3;13
96;13.04.2012;2012;04;07;Perjantai;69;63;132;28;11;39
96;13.04.2012;2012;04;08;Perjantai;77;82;159;19;18;37
96;13.04.2012;2012;04;09;Perjantai;46;68;114;11;10;21
96;13.04.2012;2012;04;10;Perjantai;36;42;78;7;7;14
96;13.04.2012;2012;04;11;Perjantai;36;51;87;14;8;22
96;13.04.2012;2012;04;12;Perjantai;47;67;114;8;14;22
96;13.04.2012;2012;04;13;Perjantai;48;72;120;8;18;26
96;13.04.2012;2012;04;14;Perjantai;60;97;157;9;19;28
96;13.04.2012;2012;04;15;Perjantai;64;124;188;14;46;60
96;13.04.2012;2012;04;16;Perjantai;64;88;152;18;27;45
96;13.04.2012;2012;04;17;Perjantai;48;35;83;16;12;28
96;13.04.2012;2012;04;18;Perjantai;42;24;66;14;14;28
96;13.04.2012;2012;04;19;Perjantai;39;24;63;10;9;19
96;13.04.2012;2012;04;20;Perjantai;45;26;71;12;7;19
96;13.04.2012;2012;04;21;Perjantai;24;20;44;4;9;13
96;13.04.2012;2012;04;22;Perjantai;6;17;23;1;4;5
96;13.04.2012;2012;04;23;Perjantai;3;5;8;2;0;2
96;14.04.2012;2012;04;00;Lauantai;5;1;6;2;1;3
96;14.04.2012;2012;04;01;Lauantai;7;2;9;1;0;1
96;14.04.2012;2012;04;02;Lauantai;11;0;11;1;1;2
96;14.04.2012;2012;04;03;Lauantai;6;0;6;7;1;8
96;14.04.2012;2012;04;04;Lauantai;4;0;4;1;0;1
96;14.04.2012;2012;04;05;Lauantai;0;2;2;0;0;0
96;14.04.2012;2012;04;06;Lauantai;11;7;18;4;0;4
96;14.04.2012;2012;04;07;Lauantai;2;13;15;2;4;6
96;14.04.2012;2012;04;08;Lauantai;4;20;24;5;7;12
96;14.04.2012;2012;04;09;Lauantai;13;32;45;3;8;11
96;14.04.2012;2012;04;10;Lauantai;14;23;37;5;10;15
96;14.04.2012;2012;04;11;Lauantai;6;27;33;8;9;17
96;14.04.2012;2012;04;12;Lauantai;20;18;38;7;5;12
96;14.04.2012;2012;04;13;Lauantai;31;7;38;7;4;11
96;14.04.2012;2012;04;14;Lauantai;25;15;40;7;6;13
96;14.04.2012;2012;04;15;Lauantai;20;15;35;3;8;11
96;14.04.2012;2012;04;16;Lauantai;21;17;38;5;1;6
96;14.04.2012;2012;04;17;Lauantai;18;11;29;4;4;8
96;14.04.2012;2012;04;18;Lauantai;15;6;21;7;0;7
96;14.04.2012;2012;04;19;Lauantai;11;8;19;3;4;7
96;14.04.2012;2012;04;20;Lauantai;11;5;16;6;9;15
96;14.04.2012;2012;04;21;Lauantai;5;15;20;0;2;2
96;14.04.2012;2012;04;22;Lauantai;4;5;9;0;0;0
96;14.04.2012;2012;04;23;Lauantai;2;3;5;0;0;0
96;15.04.2012;2012;04;00;Sunnuntai;3;2;5;2;0;2
96;15.04.2012;2012;04;01;Sunnuntai;3;0;3;5;1;6
96;15.04.2012;2012;04;02;Sunnuntai;9;2;11;3;0;3
96;15.04.2012;2012;04;03;Sunnuntai;1;1;2;0;0;0
96;15.04.2012;2012;04;04;Sunnuntai;6;0;6;1;0;1
96;15.04.2012;2012;04;05;Sunnuntai;0;0;0;1;0;1
96;15.04.2012;2012;04;06;Sunnuntai;8;3;11;5;1;6
96;15.04.2012;2012;04;07;Sunnuntai;0;12;12;5;10;15
96;15.04.2012;2012;04;08;Sunnuntai;6;3;9;1;2;3
96;15.04.2012;2012;04;09;Sunnuntai;7;9;16;6;10;16
96;15.04.2012;2012;04;10;Sunnuntai;7;5;12;2;10;12
96;15.04.2012;2012;04;11;Sunnuntai;3;14;17;9;13;22
96;15.04.2012;2012;04;12;Sunnuntai;16;12;28;8;10;18
96;15.04.2012;2012;04;13;Sunnuntai;26;19;45;11;15;26
96;15.04.2012;2012;04;14;Sunnuntai;15;39;54;16;23;39
96;15.04.2012;2012;04;15;Sunnuntai;29;23;52;4;10;14
96;15.04.2012;2012;04;16;Sunnuntai;42;23;65;19;11;30
96;15.04.2012;2012;04;17;Sunnuntai;24;21;45;17;16;33
96;15.04.2012;2012;04;18;Sunnuntai;23;14;37;17;17;34
96;15.04.2012;2012;04;19;Sunnuntai;9;18;27;8;17;25
96;15.04.2012;2012;04;20;Sunnuntai;12;20;32;7;10;17
96;15.04.2012;2012;04;21;Sunnuntai;7;8;15;3;2;5
96;15.04.2012;2012;04;22;Sunnuntai;4;5;9;0;2;2
96;15.04.2012;2012;04;23;Sunnuntai;4;1;5;1;0;1
96;16.04.2012;2012;04;00;Maanantai;0;3;3;1;1;2
96;16.04.2012;2012;04;01;Maanantai;1;0;1;2;2;4
96;16.04.2012;2012;04;02;Maanantai;0;0;0;0;0;0
96;16.04.2012;2012;04;03;Maanantai;0;0;0;0;0;0
96;16.04.2012;2012;04;04;Maanantai;1;4;5;0;0;0
96;16.04.2012;2012;04;05;Maanantai;5;6;11;0;0;0
96;16.04.2012;2012;04;06;Maanantai;34;32;66;8;3;11
96;16.04.2012;2012;04;07;Maanantai;91;75;166;33;7;40
96;16.04.2012;2012;04;08;Maanantai;85;89;174;19;13;32
96;16.04.2012;2012;04;09;Maanantai;40;88;128;12;8;20
96;16.04.2012;2012;04;10;Maanantai;42;56;98;4;11;15
96;16.04.2012;2012;04;11;Maanantai;57;62;119;12;7;19
96;16.04.2012;2012;04;12;Maanantai;51;73;124;7;14;21
96;16.04.2012;2012;04;13;Maanantai;52;45;97;14;10;24
96;16.04.2012;2012;04;14;Maanantai;52;85;137;6;19;25
96;16.04.2012;2012;04;15;Maanantai;66;144;210;8;43;51
96;16.04.2012;2012;04;16;Maanantai;108;131;239;15;28;43
96;16.04.2012;2012;04;17;Maanantai;56;69;125;22;25;47
96;16.04.2012;2012;04;18;Maanantai;60;43;103;29;26;55
96;16.04.2012;2012;04;19;Maanantai;54;38;92;29;36;65
96;16.04.2012;2012;04;20;Maanantai;38;22;60;21;18;39
96;16.04.2012;2012;04;21;Maanantai;31;32;63;10;8;18
96;16.04.2012;2012;04;22;Maanantai;8;10;18;1;7;8
96;16.04.2012;2012;04;23;Maanantai;2;2;4;0;0;0
96;17.04.2012;2012;04;00;Tiistai;1;1;2;0;0;0
96;17.04.2012;2012;04;01;Tiistai;1;1;2;0;0;0
96;17.04.2012;2012;04;02;Tiistai;1;0;1;1;0;1
96;17.04.2012;2012;04;03;Tiistai;0;0;0;0;0;0
96;17.04.2012;2012;04;04;Tiistai;2;3;5;0;0;0
96;17.04.2012;2012;04;05;Tiistai;3;9;12;0;0;0
96;17.04.2012;2012;04;06;Tiistai;43;28;71;7;4;11
96;17.04.2012;2012;04;07;Tiistai;97;80;177;23;12;35
96;17.04.2012;2012;04;08;Tiistai;110;92;202;17;6;23
96;17.04.2012;2012;04;09;Tiistai;53;74;127;14;10;24
96;17.04.2012;2012;04;10;Tiistai;41;46;87;10;13;23
96;17.04.2012;2012;04;11;Tiistai;35;47;82;8;7;15
96;17.04.2012;2012;04;12;Tiistai;58;43;101;17;32;49
96;17.04.2012;2012;04;13;Tiistai;39;58;97;21;10;31
96;17.04.2012;2012;04;14;Tiistai;51;90;141;9;15;24
96;17.04.2012;2012;04;15;Tiistai;60;134;194;8;36;44
96;17.04.2012;2012;04;16;Tiistai;106;129;235;11;27;38
96;17.04.2012;2012;04;17;Tiistai;40;45;85;17;10;27
96;17.04.2012;2012;04;18;Tiistai;43;54;97;13;30;43
96;17.04.2012;2012;04;19;Tiistai;42;27;69;19;9;28
96;17.04.2012;2012;04;20;Tiistai;27;35;62;18;10;28
96;17.04.2012;2012;04;21;Tiistai;11;25;36;4;7;11
96;17.04.2012;2012;04;22;Tiistai;5;7;12;1;2;3
96;17.04.2012;2012;04;23;Tiistai;4;1;5;1;2;3
96;18.04.2012;2012;04;00;Keskiviikko;2;0;2;1;0;1
96;18.04.2012;2012;04;01;Keskiviikko;2;0;2;0;0;0
96;18.04.2012;2012;04;02;Keskiviikko;1;0;1;1;0;1
96;18.04.2012;2012;04;03;Keskiviikko;0;0;0;0;0;0
96;18.04.2012;2012;04;04;Keskiviikko;1;1;2;0;0;0
96;18.04.2012;2012;04;05;Keskiviikko;1;5;6;1;1;2
96;18.04.2012;2012;04;06;Keskiviikko;43;14;57;9;5;14
96;18.04.2012;2012;04;07;Keskiviikko;87;71;158;38;18;56
96;18.04.2012;2012;04;08;Keskiviikko;67;79;146;22;3;25
96;18.04.2012;2012;04;09;Keskiviikko;40;51;91;13;10;23
96;18.04.2012;2012;04;10;Keskiviikko;26;35;61;6;9;15
96;18.04.2012;2012;04;11;Keskiviikko;34;42;76;8;16;24
96;18.04.2012;2012;04;12;Keskiviikko;38;34;72;10;4;14
96;18.04.2012;2012;04;13;Keskiviikko;33;52;85;11;20;31
96;18.04.2012;2012;04;14;Keskiviikko;44;58;102;7;15;22
96;18.04.2012;2012;04;15;Keskiviikko;54;123;177;13;35;48
96;18.04.2012;2012;04;16;Keskiviikko;72;118;190;15;44;59
96;18.04.2012;2012;04;17;Keskiviikko;60;44;104;16;8;24
96;18.04.2012;2012;04;18;Keskiviikko;42;36;78;13;17;30
96;18.04.2012;2012;04;19;Keskiviikko;48;42;90;24;19;43
96;18.04.2012;2012;04;20;Keskiviikko;34;18;52;20;12;32
96;18.04.2012;2012;04;21;Keskiviikko;25;24;49;8;17;25
96;18.04.2012;2012;04;22;Keskiviikko;9;12;21;4;3;7
96;18.04.2012;2012;04;23;Keskiviikko;1;5;6;1;0;1
96;19.04.2012;2012;04;00;Torstai;3;2;5;1;1;2
96;19.04.2012;2012;04;01;Torstai;1;0;1;0;0;0
96;19.04.2012;2012;04;02;Torstai;2;0;2;1;2;3
96;19.04.2012;2012;04;03;Torstai;0;0;0;0;0;0
96;19.04.2012;2012;04;04;Torstai;1;1;2;0;0;0
96;19.04.2012;2012;04;05;Torstai;4;4;8;0;0;0
96;19.04.2012;2012;04;06;Torstai;53;20;73;8;3;11
96;19.04.2012;2012;04;07;Torstai;72;83;155;30;13;43
96;19.04.2012;2012;04;08;Torstai;91;98;189;30;14;44
96;19.04.2012;2012;04;09;Torstai;44;45;89;11;7;18
96;19.04.2012;2012;04;10;Torstai;34;45;79;13;14;27
96;19.04.2012;2012;04;11;Torstai;41;59;100;7;6;13
96;19.04.2012;2012;04;12;Torstai;48;83;131;10;10;20
96;19.04.2012;2012;04;13;Torstai;58;59;117;11;10;21
96;19.04.2012;2012;04;14;Torstai;75;92;167;7;14;21
96;19.04.2012;2012;04;15;Torstai;60;153;213;15;35;50
96;19.04.2012;2012;04;16;Torstai;80;131;211;10;25;35
96;19.04.2012;2012;04;17;Torstai;62;49;111;21;7;28
96;19.04.2012;2012;04;18;Torstai;51;55;106;22;14;36
96;19.04.2012;2012;04;19;Torstai;46;46;92;9;17;26
96;19.04.2012;2012;04;20;Torstai;52;26;78;21;23;44
96;19.04.2012;2012;04;21;Torstai;22;20;42;8;16;24
96;19.04.2012;2012;04;22;Torstai;9;5;14;2;4;6
96;19.04.2012;2012;04;23;Torstai;3;2;5;1;0;1
96;20.04.2012;2012;04;00;Perjantai;1;2;3;0;1;1
96;20.04.2012;2012;04;01;Perjantai;2;1;3;0;0;0
96;20.04.2012;2012;04;02;Perjantai;2;0;2;0;0;0
96;20.04.2012;2012;04;03;Perjantai;1;0;1;0;0;0
96;20.04.2012;2012;04;04;Perjantai;2;1;3;0;0;0
96;20.04.2012;2012;04;05;Perjantai;3;6;9;1;0;1
96;20.04.2012;2012;04;06;Perjantai;46;25;71;10;5;15
96;20.04.2012;2012;04;07;Perjantai;95;74;169;23;13;36
96;20.04.2012;2012;04;08;Perjantai;89;86;175;22;11;33
96;20.04.2012;2012;04;09;Perjantai;31;123;154;14;19;33
96;20.04.2012;2012;04;10;Perjantai;47;63;110;29;22;51
96;20.04.2012;2012;04;11;Perjantai;85;80;165;11;9;20
96;20.04.2012;2012;04;12;Perjantai;49;91;140;6;11;17
96;20.04.2012;2012;04;13;Perjantai;62;83;145;8;15;23
96;20.04.2012;2012;04;14;Perjantai;57;102;159;9;24;33
96;20.04.2012;2012;04;15;Perjantai;76;137;213;9;44;53
96;20.04.2012;2012;04;16;Perjantai;69;77;146;12;16;28
96;20.04.2012;2012;04;17;Perjantai;59;43;102;8;11;19
96;20.04.2012;2012;04;18;Perjantai;51;37;88;4;17;21
96;20.04.2012;2012;04;19;Perjantai;40;27;67;12;9;21
96;20.04.2012;2012;04;20;Perjantai;31;21;52;5;10;15
96;20.04.2012;2012;04;21;Perjantai;22;20;42;7;6;13
96;20.04.2012;2012;04;22;Perjantai;6;14;20;1;3;4
96;20.04.2012;2012;04;23;Perjantai;6;9;15;5;6;11
96;21.04.2012;2012;04;00;Lauantai;6;2;8;0;1;1
96;21.04.2012;2012;04;01;Lauantai;5;2;7;0;0;0
96;21.04.2012;2012;04;02;Lauantai;9;0;9;0;0;0
96;21.04.2012;2012;04;03;Lauantai;12;3;15;1;0;1
96;21.04.2012;2012;04;04;Lauantai;2;1;3;0;1;1
96;21.04.2012;2012;04;05;Lauantai;4;2;6;1;0;1
96;21.04.2012;2012;04;06;Lauantai;19;5;24;3;1;4
96;21.04.2012;2012;04;07;Lauantai;1;11;12;0;2;2
96;21.04.2012;2012;04;08;Lauantai;5;16;21;5;5;10
96;21.04.2012;2012;04;09;Lauantai;10;25;35;6;6;12
96;21.04.2012;2012;04;10;Lauantai;5;26;31;6;9;15
96;21.04.2012;2012;04;11;Lauantai;17;26;43;5;24;29
96;21.04.2012;2012;04;12;Lauantai;23;24;47;18;28;46
96;21.04.2012;2012;04;13;Lauantai;21;28;49;20;18;38
96;21.04.2012;2012;04;14;Lauantai;26;41;67;23;13;36
96;21.04.2012;2012;04;15;Lauantai;34;38;72;15;16;31
96;21.04.2012;2012;04;16;Lauantai;39;25;64;17;11;28
96;21.04.2012;2012;04;17;Lauantai;35;19;54;13;12;25
96;21.04.2012;2012;04;18;Lauantai;23;21;44;19;12;31
96;21.04.2012;2012;04;19;Lauantai;16;15;31;9;9;18
96;21.04.2012;2012;04;20;Lauantai;20;22;42;5;7;12
96;21.04.2012;2012;04;21;Lauantai;10;28;38;5;3;8
96;21.04.2012;2012;04;22;Lauantai;8;6;14;1;2;3
96;21.04.2012;2012;04;23;Lauantai;6;10;16;0;1;1
96;22.04.2012;2012;04;00;Sunnuntai;5;0;5;0;0;0
96;22.04.2012;2012;04;01;Sunnuntai;4;1;5;0;1;1
96;22.04.2012;2012;04;02;Sunnuntai;5;0;5;1;0;1
96;22.04.2012;2012;04;03;Sunnuntai;12;0;12;0;0;0
96;22.04.2012;2012;04;04;Sunnuntai;3;0;3;2;0;2
96;22.04.2012;2012;04;05;Sunnuntai;1;0;1;3;0;3
96;22.04.2012;2012;04;06;Sunnuntai;10;10;20;2;0;2
96;22.04.2012;2012;04;07;Sunnuntai;2;6;8;3;5;8
96;22.04.2012;2012;04;08;Sunnuntai;8;8;16;2;6;8
96;22.04.2012;2012;04;09;Sunnuntai;4;9;13;9;12;21
96;22.04.2012;2012;04;10;Sunnuntai;7;30;37;4;17;21
96;22.04.2012;2012;04;11;Sunnuntai;24;40;64;13;32;45
96;22.04.2012;2012;04;12;Sunnuntai;29;85;114;18;51;69
96;22.04.2012;2012;04;13;Sunnuntai;44;48;92;49;42;91
96;22.04.2012;2012;04;14;Sunnuntai;49;35;84;50;20;70
96;22.04.2012;2012;04;15;Sunnuntai;53;50;103;27;20;47
96;22.04.2012;2012;04;16;Sunnuntai;74;35;109;37;14;51
96;22.04.2012;2012;04;17;Sunnuntai;52;32;84;30;23;53
96;22.04.2012;2012;04;18;Sunnuntai;38;40;78;20;29;49
96;22.04.2012;2012;04;19;Sunnuntai;22;28;50;18;13;31
96;22.04.2012;2012;04;20;Sunnuntai;33;23;56;5;23;28
96;22.04.2012;2012;04;21;Sunnuntai;11;30;41;5;17;22
96;22.04.2012;2012;04;22;Sunnuntai;9;12;21;1;3;4
96;22.04.2012;2012;04;23;Sunnuntai;5;3;8;0;0;0
96;23.04.2012;2012;04;00;Maanantai;2;1;3;1;1;2
96;23.04.2012;2012;04;01;Maanantai;1;0;1;0;0;0
96;23.04.2012;2012;04;02;Maanantai;1;0;1;0;0;0
96;23.04.2012;2012;04;03;Maanantai;1;0;1;0;0;0
96;23.04.2012;2012;04;04;Maanantai;1;5;6;0;1;1
96;23.04.2012;2012;04;05;Maanantai;4;9;13;0;0;0
96;23.04.2012;2012;04;06;Maanantai;33;28;61;4;3;7
96;23.04.2012;2012;04;07;Maanantai;123;106;229;29;7;36
96;23.04.2012;2012;04;08;Maanantai;92;117;209;14;8;22
96;23.04.2012;2012;04;09;Maanantai;55;72;127;16;8;24
96;23.04.2012;2012;04;10;Maanantai;55;65;120;8;11;19
96;23.04.2012;2012;04;11;Maanantai;63;62;125;12;12;24
96;23.04.2012;2012;04;12;Maanantai;65;82;147;8;19;27
96;23.04.2012;2012;04;13;Maanantai;63;79;142;9;13;22
96;23.04.2012;2012;04;14;Maanantai;62;128;190;9;17;26
96;23.04.2012;2012;04;15;Maanantai;106;173;279;37;25;62
96;23.04.2012;2012;04;16;Maanantai;117;155;272;73;46;119
96;23.04.2012;2012;04;17;Maanantai;89;88;177;173;24;197
96;23.04.2012;2012;04;18;Maanantai;72;57;129;184;37;221
96;23.04.2012;2012;04;19;Maanantai;63;62;125;119;21;140
96;23.04.2012;2012;04;20;Maanantai;51;33;84;22;17;39
96;23.04.2012;2012;04;21;Maanantai;34;26;60;11;9;20
96;23.04.2012;2012;04;22;Maanantai;6;6;12;4;9;13
96;23.04.2012;2012;04;23;Maanantai;5;6;11;3;1;4
96;24.04.2012;2012;04;00;Tiistai;2;1;3;0;0;0
96;24.04.2012;2012;04;01;Tiistai;0;0;0;0;0;0
96;24.04.2012;2012;04;02;Tiistai;0;0;0;0;0;0
96;24.04.2012;2012;04;03;Tiistai;1;0;1;0;0;0
96;24.04.2012;2012;04;04;Tiistai;0;4;4;0;1;1
96;24.04.2012;2012;04;05;Tiistai;6;8;14;0;1;1
96;24.04.2012;2012;04;06;Tiistai;45;25;70;4;3;7
96;24.04.2012;2012;04;07;Tiistai;101;97;198;26;6;32
96;24.04.2012;2012;04;08;Tiistai;116;124;240;21;16;37
96;24.04.2012;2012;04;09;Tiistai;46;88;134;14;5;19
96;24.04.2012;2012;04;10;Tiistai;51;50;101;8;11;19
96;24.04.2012;2012;04;11;Tiistai;34;50;84;13;11;24
96;24.04.2012;2012;04;12;Tiistai;51;59;110;8;10;18
96;24.04.2012;2012;04;13;Tiistai;55;54;109;8;8;16
96;24.04.2012;2012;04;14;Tiistai;53;113;166;6;13;19
96;24.04.2012;2012;04;15;Tiistai;76;145;221;12;21;33
96;24.04.2012;2012;04;16;Tiistai;96;136;232;10;20;30
96;24.04.2012;2012;04;17;Tiistai;50;50;100;18;11;29
96;24.04.2012;2012;04;18;Tiistai;44;44;88;16;16;32
96;24.04.2012;2012;04;19;Tiistai;27;33;60;17;17;34
96;24.04.2012;2012;04;20;Tiistai;33;18;51;6;12;18
96;24.04.2012;2012;04;21;Tiistai;23;28;51;6;14;20
96;24.04.2012;2012;04;22;Tiistai;5;4;9;1;3;4
96;24.04.2012;2012;04;23;Tiistai;2;4;6;0;0;0
96;25.04.2012;2012;04;00;Keskiviikko;3;2;5;0;1;1
96;25.04.2012;2012;04;01;Keskiviikko;0;0;0;0;0;0
96;25.04.2012;2012;04;02;Keskiviikko;3;0;3;0;0;0
96;25.04.2012;2012;04;03;Keskiviikko;0;0;0;0;0;0
96;25.04.2012;2012;04;04;Keskiviikko;2;1;3;0;2;2
96;25.04.2012;2012;04;05;Keskiviikko;1;10;11;0;0;0
96;25.04.2012;2012;04;06;Keskiviikko;29;22;51;5;2;7
96;25.04.2012;2012;04;07;Keskiviikko;97;71;168;30;8;38
96;25.04.2012;2012;04;08;Keskiviikko;81;80;161;14;5;19
96;25.04.2012;2012;04;09;Keskiviikko;34;43;77;7;6;13
96;25.04.2012;2012;04;10;Keskiviikko;27;42;69;9;9;18
96;25.04.2012;2012;04;11;Keskiviikko;38;49;87;16;12;28
96;25.04.2012;2012;04;12;Keskiviikko;44;52;96;11;15;26
96;25.04.2012;2012;04;13;Keskiviikko;39;52;91;8;10;18
96;25.04.2012;2012;04;14;Keskiviikko;57;106;163;5;20;25
96;25.04.2012;2012;04;15;Keskiviikko;79;116;195;9;22;31
96;25.04.2012;2012;04;16;Keskiviikko;85;132;217;12;29;41
96;25.04.2012;2012;04;17;Keskiviikko;45;66;111;19;15;34
96;25.04.2012;2012;04;18;Keskiviikko;72;43;115;22;14;36
96;25.04.2012;2012;04;19;Keskiviikko;40;45;85;26;29;55
96;25.04.2012;2012;04;20;Keskiviikko;45;36;81;14;22;36
96;25.04.2012;2012;04;21;Keskiviikko;25;31;56;12;13;25
96;25.04.2012;2012;04;22;Keskiviikko;8;12;20;3;5;8
96;25.04.2012;2012;04;23;Keskiviikko;3;3;6;1;0;1
96;26.04.2012;2012;04;00;Torstai;8;1;9;0;0;0
96;26.04.2012;2012;04;01;Torstai;3;0;3;0;0;0
96;26.04.2012;2012;04;02;Torstai;3;0;3;0;0;0
96;26.04.2012;2012;04;03;Torstai;1;0;1;0;0;0
96;26.04.2012;2012;04;04;Torstai;5;1;6;0;1;1
96;26.04.2012;2012;04;05;Torstai;4;10;14;0;0;0
96;26.04.2012;2012;04;06;Torstai;35;28;63;7;3;10
96;26.04.2012;2012;04;07;Torstai;103;127;230;27;11;38
96;26.04.2012;2012;04;08;Torstai;94;123;217;23;9;32
96;26.04.2012;2012;04;09;Torstai;45;84;129;9;7;16
96;26.04.2012;2012;04;10;Torstai;39;76;115;14;15;29
96;26.04.2012;2012;04;11;Torstai;63;55;118;13;12;25
96;26.04.2012;2012;04;12;Torstai;50;68;118;9;16;25
96;26.04.2012;2012;04;13;Torstai;68;65;133;12;19;31
96;26.04.2012;2012;04;14;Torstai;52;90;142;2;14;16
96;26.04.2012;2012;04;15;Torstai;67;170;237;12;35;47
96;26.04.2012;2012;04;16;Torstai;101;164;265;6;38;44
96;26.04.2012;2012;04;17;Torstai;67;81;148;7;9;16
96;26.04.2012;2012;04;18;Torstai;53;51;104;15;15;30
96;26.04.2012;2012;04;19;Torstai;57;42;99;16;15;31
96;26.04.2012;2012;04;20;Torstai;51;33;84;20;14;34
96;26.04.2012;2012;04;21;Torstai;29;29;58;7;11;18
96;26.04.2012;2012;04;22;Torstai;5;10;15;5;3;8
96;26.04.2012;2012;04;23;Torstai;2;4;6;0;2;2
96;27.04.2012;2012;04;00;Perjantai;3;1;4;0;0;0
96;27.04.2012;2012;04;01;Perjantai;4;0;4;1;1;2
96;27.04.2012;2012;04;02;Perjantai;5;1;6;0;1;1
96;27.04.2012;2012;04;03;Perjantai;2;0;2;0;0;0
96;27.04.2012;2012;04;04;Perjantai;8;3;11;0;1;1
96;27.04.2012;2012;04;05;Perjantai;2;7;9;0;0;0
96;27.04.2012;2012;04;06;Perjantai;31;26;57;5;2;7
96;27.04.2012;2012;04;07;Perjantai;83;56;139;23;2;25
96;27.04.2012;2012;04;08;Perjantai;55;50;105;12;4;16
96;27.04.2012;2012;04;09;Perjantai;25;59;84;7;3;10
96;27.04.2012;2012;04;10;Perjantai;27;44;71;4;6;10
96;27.04.2012;2012;04;11;Perjantai;35;69;104;5;12;17
96;27.04.2012;2012;04;12;Perjantai;28;40;68;4;4;8
96;27.04.2012;2012;04;13;Perjantai;44;53;97;1;1;2
96;27.04.2012;2012;04;14;Perjantai;49;79;128;4;6;10
96;27.04.2012;2012;04;15;Perjantai;46;99;145;4;9;13
96;27.04.2012;2012;04;16;Perjantai;33;59;92;0;3;3
96;27.04.2012;2012;04;17;Perjantai;22;21;43;2;4;6
96;27.04.2012;2012;04;18;Perjantai;18;18;36;8;4;12
96;27.04.2012;2012;04;19;Perjantai;18;24;42;4;6;10
96;27.04.2012;2012;04;20;Perjantai;23;14;37;7;7;14
96;27.04.2012;2012;04;21;Perjantai;11;24;35;4;4;8
96;27.04.2012;2012;04;22;Perjantai;3;2;5;3;1;4
96;27.04.2012;2012;04;23;Perjantai;1;5;6;1;0;1
96;28.04.2012;2012;04;00;Lauantai;3;2;5;1;0;1
96;28.04.2012;2012;04;01;Lauantai;6;0;6;2;3;5
96;28.04.2012;2012;04;02;Lauantai;7;2;9;4;0;4
96;28.04.2012;2012;04;03;Lauantai;6;0;6;1;0;1
96;28.04.2012;2012;04;04;Lauantai;7;2;9;1;2;3
96;28.04.2012;2012;04;05;Lauantai;4;0;4;1;0;1
96;28.04.2012;2012;04;06;Lauantai;7;3;10;1;0;1
96;28.04.2012;2012;04;07;Lauantai;4;5;9;1;0;1
96;28.04.2012;2012;04;08;Lauantai;5;9;14;4;6;10
96;28.04.2012;2012;04;09;Lauantai;16;16;32;4;5;9
96;28.04.2012;2012;04;10;Lauantai;10;18;28;3;3;6
96;28.04.2012;2012;04;11;Lauantai;21;24;45;3;2;5
96;28.04.2012;2012;04;12;Lauantai;28;20;48;8;6;14
96;28.04.2012;2012;04;13;Lauantai;43;29;72;11;10;21
96;28.04.2012;2012;04;14;Lauantai;18;22;40;11;5;16
96;28.04.2012;2012;04;15;Lauantai;30;27;57;2;3;5
96;28.04.2012;2012;04;16;Lauantai;17;17;34;13;2;15
96;28.04.2012;2012;04;17;Lauantai;35;24;59;21;5;26
96;28.04.2012;2012;04;18;Lauantai;17;10;27;10;0;10
96;28.04.2012;2012;04;19;Lauantai;19;10;29;6;8;14
96;28.04.2012;2012;04;20;Lauantai;15;15;30;1;2;3
96;28.04.2012;2012;04;21;Lauantai;9;8;17;4;4;8
96;28.04.2012;2012;04;22;Lauantai;4;5;9;1;6;7
96;28.04.2012;2012;04;23;Lauantai;11;7;18;1;1;2
96;29.04.2012;2012;04;00;Sunnuntai;4;3;7;2;1;3
96;29.04.2012;2012;04;01;Sunnuntai;9;3;12;0;0;0
96;29.04.2012;2012;04;02;Sunnuntai;3;1;4;2;0;2
96;29.04.2012;2012;04;03;Sunnuntai;7;2;9;2;0;2
96;29.04.2012;2012;04;04;Sunnuntai;4;0;4;1;0;1
96;29.04.2012;2012;04;05;Sunnuntai;4;1;5;1;2;3
96;29.04.2012;2012;04;06;Sunnuntai;3;4;7;2;2;4
96;29.04.2012;2012;04;07;Sunnuntai;1;2;3;1;1;2
96;29.04.2012;2012;04;08;Sunnuntai;3;1;4;3;1;4
96;29.04.2012;2012;04;09;Sunnuntai;11;11;22;3;1;4
96;29.04.2012;2012;04;10;Sunnuntai;8;8;16;3;3;6
96;29.04.2012;2012;04;11;Sunnuntai;20;27;47;10;4;14
96;29.04.2012;2012;04;12;Sunnuntai;14;23;37;5;2;7
96;29.04.2012;2012;04;13;Sunnuntai;32;26;58;4;5;9
96;29.04.2012;2012;04;14;Sunnuntai;45;31;76;8;5;13
96;29.04.2012;2012;04;15;Sunnuntai;32;26;58;28;11;39
96;29.04.2012;2012;04;16;Sunnuntai;32;21;53;8;7;15
96;29.04.2012;2012;04;17;Sunnuntai;26;33;59;9;6;15
96;29.04.2012;2012;04;18;Sunnuntai;32;23;55;9;8;17
96;29.04.2012;2012;04;19;Sunnuntai;19;27;46;6;12;18
96;29.04.2012;2012;04;20;Sunnuntai;13;20;33;2;2;4
96;29.04.2012;2012;04;21;Sunnuntai;6;9;15;2;3;5
96;29.04.2012;2012;04;22;Sunnuntai;9;11;20;1;1;2
96;29.04.2012;2012;04;23;Sunnuntai;5;7;12;1;5;6
96;30.04.2012;2012;04;00;Maanantai;3;6;9;0;2;2
96;30.04.2012;2012;04;01;Maanantai;2;3;5;0;0;0
96;30.04.2012;2012;04;02;Maanantai;4;1;5;0;0;0
96;30.04.2012;2012;04;03;Maanantai;9;1;10;1;0;1
96;30.04.2012;2012;04;04;Maanantai;4;3;7;0;0;0
96;30.04.2012;2012;04;05;Maanantai;2;2;4;1;0;1
96;30.04.2012;2012;04;06;Maanantai;20;20;40;1;0;1
96;30.04.2012;2012;04;07;Maanantai;53;39;92;7;1;8
96;30.04.2012;2012;04;08;Maanantai;40;49;89;4;4;8
96;30.04.2012;2012;04;09;Maanantai;16;64;80;15;11;26
96;30.04.2012;2012;04;10;Maanantai;30;42;72;6;2;8
96;30.04.2012;2012;04;11;Maanantai;35;58;93;12;7;19
96;30.04.2012;2012;04;12;Maanantai;54;54;108;21;9;30
96;30.04.2012;2012;04;13;Maanantai;69;69;138;18;16;34
96;30.04.2012;2012;04;14;Maanantai;54;89;143;8;12;20
96;30.04.2012;2012;04;15;Maanantai;70;109;179;16;10;26
96;30.04.2012;2012;04;16;Maanantai;63;83;146;4;7;11
96;30.04.2012;2012;04;17;Maanantai;46;48;94;8;8;16
96;30.04.2012;2012;04;18;Maanantai;41;50;91;27;8;35
96;30.04.2012;2012;04;19;Maanantai;17;46;63;4;4;8
96;30.04.2012;2012;04;20;Maanantai;11;15;26;0;5;5
96;30.04.2012;2012;04;21;Maanantai;21;25;46;0;2;2
96;30.04.2012;2012;04;22;Maanantai;11;18;29;2;3;5
96;30.04.2012;2012;04;23;Maanantai;15;11;26;4;1;5
96;01.05.2012;2012;05;00;Tiistai;27;6;33;2;1;3
96;01.05.2012;2012;05;01;Tiistai;29;2;31;3;0;3
96;01.05.2012;2012;05;02;Tiistai;31;7;38;4;1;5
96;01.05.2012;2012;05;03;Tiistai;21;6;27;2;1;3
96;01.05.2012;2012;05;04;Tiistai;21;2;23;6;0;6
96;01.05.2012;2012;05;05;Tiistai;6;0;6;2;0;2
96;01.05.2012;2012;05;06;Tiistai;9;8;17;1;0;1
96;01.05.2012;2012;05;07;Tiistai;5;7;12;2;0;2
96;01.05.2012;2012;05;08;Tiistai;4;3;7;5;3;8
96;01.05.2012;2012;05;09;Tiistai;4;13;17;4;2;6
96;01.05.2012;2012;05;10;Tiistai;19;46;65;1;6;7
96;01.05.2012;2012;05;11;Tiistai;24;38;62;4;8;12
96;01.05.2012;2012;05;12;Tiistai;28;70;98;10;6;16
96;01.05.2012;2012;05;13;Tiistai;55;40;95;11;8;19
96;01.05.2012;2012;05;14;Tiistai;58;34;92;11;11;22
96;01.05.2012;2012;05;15;Tiistai;44;49;93;9;8;17
96;01.05.2012;2012;05;16;Tiistai;46;19;65;9;14;23
96;01.05.2012;2012;05;17;Tiistai;36;23;59;6;2;8
96;01.05.2012;2012;05;18;Tiistai;26;20;46;9;11;20
96;01.05.2012;2012;05;19;Tiistai;22;17;39;13;10;23
96;01.05.2012;2012;05;20;Tiistai;26;17;43;11;2;13
96;01.05.2012;2012;05;21;Tiistai;20;17;37;2;7;9
96;01.05.2012;2012;05;22;Tiistai;6;7;13;2;2;4
96;01.05.2012;2012;05;23;Tiistai;6;2;8;3;3;6
96;02.05.2012;2012;05;00;Keskiviikko;3;1;4;0;0;0
96;02.05.2012;2012;05;01;Keskiviikko;1;0;1;1;0;1
96;02.05.2012;2012;05;02;Keskiviikko;0;2;2;0;0;0
96;02.05.2012;2012;05;03;Keskiviikko;1;1;2;0;0;0
96;02.05.2012;2012;05;04;Keskiviikko;1;2;3;0;0;0
96;02.05.2012;2012;05;05;Keskiviikko;5;9;14;0;0;0
96;02.05.2012;2012;05;06;Keskiviikko;40;26;66;1;1;2
96;02.05.2012;2012;05;07;Keskiviikko;91;95;186;30;6;36
96;02.05.2012;2012;05;08;Keskiviikko;69;103;172;18;10;28
96;02.05.2012;2012;05;09;Keskiviikko;32;78;110;11;12;23
96;02.05.2012;2012;05;10;Keskiviikko;33;63;96;8;5;13
96;02.05.2012;2012;05;11;Keskiviikko;57;47;104;7;7;14
96;02.05.2012;2012;05;12;Keskiviikko;55;84;139;8;10;18
96;02.05.2012;2012;05;13;Keskiviikko;62;63;125;8;14;22
96;02.05.2012;2012;05;14;Keskiviikko;81;79;160;8;10;18
96;02.05.2012;2012;05;15;Keskiviikko;95;167;262;17;17;34
96;02.05.2012;2012;05;16;Keskiviikko;99;140;239;12;23;35
96;02.05.2012;2012;05;17;Keskiviikko;73;66;139;9;12;21
96;02.05.2012;2012;05;18;Keskiviikko;72;51;123;29;18;47
96;02.05.2012;2012;05;19;Keskiviikko;79;47;126;22;15;37
96;02.05.2012;2012;05;20;Keskiviikko;51;28;79;13;34;47
96;02.05.2012;2012;05;21;Keskiviikko;33;34;67;7;14;21
96;02.05.2012;2012;05;22;Keskiviikko;7;7;14;5;2;7
96;02.05.2012;2012;05;23;Keskiviikko;8;2;10;3;1;4
96;03.05.2012;2012;05;00;Torstai;2;0;2;1;0;1
96;03.05.2012;2012;05;01;Torstai;1;0;1;0;0;0
96;03.05.2012;2012;05;02;Torstai;0;0;0;0;0;0
96;03.05.2012;2012;05;03;Torstai;1;0;1;0;0;0
96;03.05.2012;2012;05;04;Torstai;2;2;4;1;0;1
96;03.05.2012;2012;05;05;Torstai;5;8;13;0;1;1
96;03.05.2012;2012;05;06;Torstai;37;40;77;6;2;8
96;03.05.2012;2012;05;07;Torstai;94;88;182;26;4;30
96;03.05.2012;2012;05;08;Torstai;83;109;192;15;5;20
96;03.05.2012;2012;05;09;Torstai;55;65;120;8;5;13
96;03.05.2012;2012;05;10;Torstai;36;64;100;10;8;18
96;03.05.2012;2012;05;11;Torstai;60;58;118;3;5;8
96;03.05.2012;2012;05;12;Torstai;57;63;120;8;8;16
96;03.05.2012;2012;05;13;Torstai;49;60;109;6;9;15
96;03.05.2012;2012;05;14;Torstai;60;100;160;7;11;18
96;03.05.2012;2012;05;15;Torstai;114;167;281;8;24;32
96;03.05.2012;2012;05;16;Torstai;134;146;280;14;23;37
96;03.05.2012;2012;05;17;Torstai;71;63;134;17;15;32
96;03.05.2012;2012;05;18;Torstai;67;60;127;13;14;27
96;03.05.2012;2012;05;19;Torstai;52;46;98;8;16;24
96;03.05.2012;2012;05;20;Torstai;55;23;78;10;10;20
96;03.05.2012;2012;05;21;Torstai;38;27;65;3;3;6
96;03.05.2012;2012;05;22;Torstai;11;11;22;1;4;5
96;03.05.2012;2012;05;23;Torstai;3;1;4;0;0;0
96;04.05.2012;2012;05;00;Perjantai;3;0;3;0;0;0
96;04.05.2012;2012;05;01;Perjantai;0;2;2;1;0;1
96;04.05.2012;2012;05;02;Perjantai;2;0;2;0;0;0
96;04.05.2012;2012;05;03;Perjantai;6;0;6;0;0;0
96;04.05.2012;2012;05;04;Perjantai;2;2;4;0;0;0
96;04.05.2012;2012;05;05;Perjantai;2;10;12;0;0;0
96;04.05.2012;2012;05;06;Perjantai;37;33;70;5;0;5
96;04.05.2012;2012;05;07;Perjantai;103;93;196;23;3;26
96;04.05.2012;2012;05;08;Perjantai;86;103;189;7;12;19
96;04.05.2012;2012;05;09;Perjantai;41;93;134;8;10;18
96;04.05.2012;2012;05;10;Perjantai;39;53;92;5;10;15
96;04.05.2012;2012;05;11;Perjantai;54;74;128;5;11;16
96;04.05.2012;2012;05;12;Perjantai;74;72;146;13;14;27
96;04.05.2012;2012;05;13;Perjantai;62;87;149;21;12;33
96;04.05.2012;2012;05;14;Perjantai;82;133;215;4;20;24
96;04.05.2012;2012;05;15;Perjantai;102;152;254;13;30;43
96;04.05.2012;2012;05;16;Perjantai;85;96;181;10;13;23
96;04.05.2012;2012;05;17;Perjantai;86;62;148;11;13;24
96;04.05.2012;2012;05;18;Perjantai;60;38;98;12;10;22
96;04.05.2012;2012;05;19;Perjantai;39;46;85;9;17;26
96;04.05.2012;2012;05;20;Perjantai;40;24;64;6;6;12
96;04.05.2012;2012;05;21;Perjantai;28;24;52;6;3;9
96;04.05.2012;2012;05;22;Perjantai;19;19;38;0;2;2
96;04.05.2012;2012;05;23;Perjantai;20;11;31;1;5;6
96;05.05.2012;2012;05;00;Lauantai;19;10;29;0;0;0
96;05.05.2012;2012;05;01;Lauantai;11;5;16;1;0;1
96;05.05.2012;2012;05;02;Lauantai;6;1;7;1;0;1
96;05.05.2012;2012;05;03;Lauantai;9;0;9;0;0;0
96;05.05.2012;2012;05;04;Lauantai;6;2;8;0;0;0
96;05.05.2012;2012;05;05;Lauantai;1;2;3;0;1;1
96;05.05.2012;2012;05;06;Lauantai;11;8;19;0;0;0
96;05.05.2012;2012;05;07;Lauantai;6;14;20;0;0;0
96;05.05.2012;2012;05;08;Lauantai;3;17;20;1;3;4
96;05.05.2012;2012;05;09;Lauantai;14;31;45;2;6;8
96;05.05.2012;2012;05;10;Lauantai;14;40;54;3;12;15
96;05.05.2012;2012;05;11;Lauantai;20;31;51;9;33;42
96;05.05.2012;2012;05;12;Lauantai;23;39;62;17;21;38
96;05.05.2012;2012;05;13;Lauantai;27;46;73;34;16;50
96;05.05.2012;2012;05;14;Lauantai;29;49;78;18;5;23
96;05.05.2012;2012;05;15;Lauantai;31;20;51;9;7;16
96;05.05.2012;2012;05;16;Lauantai;25;18;43;6;7;13
96;05.05.2012;2012;05;17;Lauantai;45;18;63;18;3;21
96;05.05.2012;2012;05;18;Lauantai;27;20;47;10;4;14
96;05.05.2012;2012;05;19;Lauantai;12;7;19;7;4;11
96;05.05.2012;2012;05;20;Lauantai;13;8;21;3;3;6
96;05.05.2012;2012;05;21;Lauantai;9;23;32;2;9;11
96;05.05.2012;2012;05;22;Lauantai;1;17;18;0;4;4
96;05.05.2012;2012;05;23;Lauantai;4;6;10;3;0;3
96;06.05.2012;2012;05;00;Sunnuntai;4;4;8;0;0;0
96;06.05.2012;2012;05;01;Sunnuntai;5;0;5;0;0;0
96;06.05.2012;2012;05;02;Sunnuntai;4;3;7;0;0;0
96;06.05.2012;2012;05;03;Sunnuntai;2;0;2;2;0;2
96;06.05.2012;2012;05;04;Sunnuntai;2;0;2;2;0;2
96;06.05.2012;2012;05;05;Sunnuntai;1;0;1;0;0;0
96;06.05.2012;2012;05;06;Sunnuntai;10;4;14;2;1;3
96;06.05.2012;2012;05;07;Sunnuntai;3;6;9;0;1;1
96;06.05.2012;2012;05;08;Sunnuntai;0;11;11;2;5;7
96;06.05.2012;2012;05;09;Sunnuntai;7;16;23;3;6;9
96;06.05.2012;2012;05;10;Sunnuntai;7;14;21;4;7;11
96;06.05.2012;2012;05;11;Sunnuntai;18;28;46;10;29;39
96;06.05.2012;2012;05;12;Sunnuntai;21;40;61;19;22;41
96;06.05.2012;2012;05;13;Sunnuntai;46;54;100;15;24;39
96;06.05.2012;2012;05;14;Sunnuntai;45;38;83;32;17;49
96;06.05.2012;2012;05;15;Sunnuntai;65;43;108;22;12;34
96;06.05.2012;2012;05;16;Sunnuntai;55;37;92;28;16;44
96;06.05.2012;2012;05;17;Sunnuntai;47;17;64;33;11;44
96;06.05.2012;2012;05;18;Sunnuntai;62;29;91;21;12;33
96;06.05.2012;2012;05;19;Sunnuntai;29;37;66;15;25;40
96;06.05.2012;2012;05;20;Sunnuntai;28;29;57;13;13;26
96;06.05.2012;2012;05;21;Sunnuntai;14;39;53;6;12;18
96;06.05.2012;2012;05;22;Sunnuntai;8;12;20;1;4;5
96;06.05.2012;2012;05;23;Sunnuntai;5;5;10;1;0;1
96;07.05.2012;2012;05;00;Maanantai;2;4;6;1;4;5
96;07.05.2012;2012;05;01;Maanantai;0;0;0;1;1;2
96;07.05.2012;2012;05;02;Maanantai;0;0;0;0;0;0
96;07.05.2012;2012;05;03;Maanantai;1;0;1;0;0;0
96;07.05.2012;2012;05;04;Maanantai;2;1;3;0;0;0
96;07.05.2012;2012;05;05;Maanantai;4;6;10;0;0;0
96;07.05.2012;2012;05;06;Maanantai;44;35;79;2;1;3
96;07.05.2012;2012;05;07;Maanantai;126;115;241;25;4;29
96;07.05.2012;2012;05;08;Maanantai;106;141;247;21;8;29
96;07.05.2012;2012;05;09;Maanantai;53;100;153;13;7;20
96;07.05.2012;2012;05;10;Maanantai;53;70;123;6;8;14
96;07.05.2012;2012;05;11;Maanantai;68;57;125;9;6;15
96;07.05.2012;2012;05;12;Maanantai;61;76;137;8;6;14
96;07.05.2012;2012;05;13;Maanantai;73;59;132;14;17;31
96;07.05.2012;2012;05;14;Maanantai;82;89;171;15;12;27
96;07.05.2012;2012;05;15;Maanantai;112;193;305;12;23;35
96;07.05.2012;2012;05;16;Maanantai;140;156;296;13;14;27
96;07.05.2012;2012;05;17;Maanantai;108;90;198;19;21;40
96;07.05.2012;2012;05;18;Maanantai;94;63;157;22;13;35
96;07.05.2012;2012;05;19;Maanantai;63;54;117;17;14;31
96;07.05.2012;2012;05;20;Maanantai;55;43;98;9;12;21
96;07.05.2012;2012;05;21;Maanantai;28;28;56;14;10;24
96;07.05.2012;2012;05;22;Maanantai;8;7;15;2;4;6
96;07.05.2012;2012;05;23;Maanantai;4;1;5;1;0;1
96;08.05.2012;2012;05;00;Tiistai;7;2;9;0;1;1
96;08.05.2012;2012;05;01;Tiistai;3;0;3;2;0;2
96;08.05.2012;2012;05;02;Tiistai;2;0;2;1;0;1
96;08.05.2012;2012;05;03;Tiistai;0;0;0;1;1;2
96;08.05.2012;2012;05;04;Tiistai;3;3;6;0;0;0
96;08.05.2012;2012;05;05;Tiistai;7;6;13;0;0;0
96;08.05.2012;2012;05;06;Tiistai;44;45;89;8;3;11
96;08.05.2012;2012;05;07;Tiistai;124;150;274;22;7;29
96;08.05.2012;2012;05;08;Tiistai;122;151;273;17;5;22
96;08.05.2012;2012;05;09;Tiistai;72;95;167;11;10;21
96;08.05.2012;2012;05;10;Tiistai;40;73;113;10;9;19
96;08.05.2012;2012;05;11;Tiistai;55;78;133;12;10;22
96;08.05.2012;2012;05;12;Tiistai;69;70;139;7;11;18
96;08.05.2012;2012;05;13;Tiistai;72;84;156;15;7;22
96;08.05.2012;2012;05;14;Tiistai;124;118;242;13;11;24
96;08.05.2012;2012;05;15;Tiistai;128;208;336;14;18;32
96;08.05.2012;2012;05;16;Tiistai;163;171;334;11;24;35
96;08.05.2012;2012;05;17;Tiistai;94;86;180;18;12;30
96;08.05.2012;2012;05;18;Tiistai;84;69;153;17;23;40
96;08.05.2012;2012;05;19;Tiistai;82;50;132;30;18;48
96;08.05.2012;2012;05;20;Tiistai;57;45;102;9;12;21
96;08.05.2012;2012;05;21;Tiistai;27;23;50;9;4;13
96;08.05.2012;2012;05;22;Tiistai;13;12;25;0;0;0
96;08.05.2012;2012;05;23;Tiistai;10;10;20;2;1;3
96;09.05.2012;2012;05;00;Keskiviikko;7;1;8;1;2;3
96;09.05.2012;2012;05;01;Keskiviikko;3;0;3;1;0;1
96;09.05.2012;2012;05;02;Keskiviikko;0;0;0;1;0;1
96;09.05.2012;2012;05;03;Keskiviikko;0;1;1;0;0;0
96;09.05.2012;2012;05;04;Keskiviikko;2;1;3;0;0;0
96;09.05.2012;2012;05;05;Keskiviikko;3;7;10;0;0;0
96;09.05.2012;2012;05;06;Keskiviikko;47;44;91;1;2;3
96;09.05.2012;2012;05;07;Keskiviikko;130;128;258;19;10;29
96;09.05.2012;2012;05;08;Keskiviikko;120;135;255;13;7;20
96;09.05.2012;2012;05;09;Keskiviikko;53;91;144;6;6;12
96;09.05.2012;2012;05;10;Keskiviikko;52;78;130;4;6;10
96;09.05.2012;2012;05;11;Keskiviikko;66;72;138;13;11;24
96;09.05.2012;2012;05;12;Keskiviikko;70;77;147;6;11;17
96;09.05.2012;2012;05;13;Keskiviikko;62;77;139;6;8;14
96;09.05.2012;2012;05;14;Keskiviikko;89;102;191;14;19;33
96;09.05.2012;2012;05;15;Keskiviikko;130;196;326;9;33;42
96;09.05.2012;2012;05;16;Keskiviikko;124;170;294;10;22;32
96;09.05.2012;2012;05;17;Keskiviikko;101;94;195;17;8;25
96;09.05.2012;2012;05;18;Keskiviikko;61;56;117;20;21;41
96;09.05.2012;2012;05;19;Keskiviikko;63;57;120;9;14;23
96;09.05.2012;2012;05;20;Keskiviikko;54;41;95;11;8;19
96;09.05.2012;2012;05;21;Keskiviikko;34;37;71;6;7;13
96;09.05.2012;2012;05;22;Keskiviikko;11;11;22;5;6;11
96;09.05.2012;2012;05;23;Keskiviikko;4;2;6;0;2;2
96;10.05.2012;2012;05;00;Torstai;6;0;6;0;1;1
96;10.05.2012;2012;05;01;Torstai;2;1;3;0;0;0
96;10.05.2012;2012;05;02;Torstai;3;1;4;0;0;0
96;10.05.2012;2012;05;03;Torstai;1;0;1;0;0;0
96;10.05.2012;2012;05;04;Torstai;2;1;3;0;0;0
96;10.05.2012;2012;05;05;Torstai;2;8;10;0;1;1
96;10.05.2012;2012;05;06;Torstai;42;24;66;0;1;1
96;10.05.2012;2012;05;07;Torstai;94;83;177;19;10;29
96;10.05.2012;2012;05;08;Torstai;76;103;179;14;10;24
96;10.05.2012;2012;05;09;Torstai;38;56;94;3;2;5
96;10.05.2012;2012;05;10;Torstai;25;34;59;7;5;12
96;10.05.2012;2012;05;11;Torstai;29;26;55;3;6;9
96;10.05.2012;2012;05;12;Torstai;27;57;84;6;3;9
96;10.05.2012;2012;05;13;Torstai;36;42;78;8;11;19
96;10.05.2012;2012;05;14;Torstai;55;100;155;8;13;21
96;10.05.2012;2012;05;15;Torstai;88;158;246;8;33;41
96;10.05.2012;2012;05;16;Torstai;98;142;240;12;26;38
96;10.05.2012;2012;05;17;Torstai;68;78;146;16;10;26
96;10.05.2012;2012;05;18;Torstai;70;75;145;10;13;23
96;10.05.2012;2012;05;19;Torstai;45;44;89;8;13;21
96;10.05.2012;2012;05;20;Torstai;54;34;88;6;7;13
96;10.05.2012;2012;05;21;Torstai;28;15;43;4;6;10
96;10.05.2012;2012;05;22;Torstai;11;11;22;4;6;10
96;10.05.2012;2012;05;23;Torstai;12;9;21;0;2;2
96;11.05.2012;2012;05;00;Perjantai;3;0;3;0;0;0
96;11.05.2012;2012;05;01;Perjantai;1;1;2;1;0;1
96;11.05.2012;2012;05;02;Perjantai;1;1;2;0;0;0
96;11.05.2012;2012;05;03;Perjantai;0;0;0;0;0;0
96;11.05.2012;2012;05;04;Perjantai;4;1;5;1;0;1
96;11.05.2012;2012;05;05;Perjantai;7;6;13;1;0;1
96;11.05.2012;2012;05;06;Perjantai;34;25;59;5;2;7
96;11.05.2012;2012;05;07;Perjantai;84;73;157;17;8;25
96;11.05.2012;2012;05;08;Perjantai;66;55;121;10;2;12
96;11.05.2012;2012;05;09;Perjantai;27;44;71;6;3;9
96;11.05.2012;2012;05;10;Perjantai;25;36;61;3;3;6
96;11.05.2012;2012;05;11;Perjantai;30;38;68;7;3;10
96;11.05.2012;2012;05;12;Perjantai;29;27;56;3;7;10
96;11.05.2012;2012;05;13;Perjantai;34;65;99;3;14;17
96;11.05.2012;2012;05;14;Perjantai;37;87;124;5;18;23
96;11.05.2012;2012;05;15;Perjantai;57;107;164;6;28;34
96;11.05.2012;2012;05;16;Perjantai;77;76;153;9;19;28
96;11.05.2012;2012;05;17;Perjantai;45;41;86;12;7;19
96;11.05.2012;2012;05;18;Perjantai;43;40;83;14;13;27
96;11.05.2012;2012;05;19;Perjantai;31;26;57;4;9;13
96;11.05.2012;2012;05;20;Perjantai;26;21;47;3;3;6
96;11.05.2012;2012;05;21;Perjantai;17;18;35;5;2;7
96;11.05.2012;2012;05;22;Perjantai;12;12;24;3;2;5
96;11.05.2012;2012;05;23;Perjantai;9;12;21;3;3;6
96;12.05.2012;2012;05;00;Lauantai;6;7;13;0;2;2
96;12.05.2012;2012;05;01;Lauantai;9;5;14;0;0;0
96;12.05.2012;2012;05;02;Lauantai;15;1;16;2;0;2
96;12.05.2012;2012;05;03;Lauantai;5;3;8;0;0;0
96;12.05.2012;2012;05;04;Lauantai;6;1;7;5;0;5
96;12.05.2012;2012;05;05;Lauantai;6;1;7;2;0;2
96;12.05.2012;2012;05;06;Lauantai;12;6;18;0;1;1
96;12.05.2012;2012;05;07;Lauantai;4;11;15;0;2;2
96;12.05.2012;2012;05;08;Lauantai;5;8;13;1;0;1
96;12.05.2012;2012;05;09;Lauantai;8;12;20;0;2;2
96;12.05.2012;2012;05;10;Lauantai;13;18;31;5;0;5
96;12.05.2012;2012;05;11;Lauantai;12;19;31;0;2;2
96;12.05.2012;2012;05;12;Lauantai;20;25;45;3;2;5
96;12.05.2012;2012;05;13;Lauantai;31;40;71;7;13;20
96;12.05.2012;2012;05;14;Lauantai;32;34;66;7;6;13
96;12.05.2012;2012;05;15;Lauantai;43;52;95;7;17;24
96;12.05.2012;2012;05;16;Lauantai;40;39;79;10;11;21
96;12.05.2012;2012;05;17;Lauantai;41;39;80;15;11;26
96;12.05.2012;2012;05;18;Lauantai;41;28;69;18;7;25
96;12.05.2012;2012;05;19;Lauantai;30;35;65;9;16;25
96;12.05.2012;2012;05;20;Lauantai;19;15;34;6;12;18
96;12.05.2012;2012;05;21;Lauantai;19;41;60;4;3;7
96;12.05.2012;2012;05;22;Lauantai;11;19;30;1;4;5
96;12.05.2012;2012;05;23;Lauantai;7;8;15;3;4;7
96;13.05.2012;2012;05;00;Sunnuntai;13;8;21;1;4;5
96;13.05.2012;2012;05;01;Sunnuntai;12;5;17;3;2;5
96;13.05.2012;2012;05;02;Sunnuntai;7;0;7;3;0;3
96;13.05.2012;2012;05;03;Sunnuntai;9;0;9;3;0;3
96;13.05.2012;2012;05;04;Sunnuntai;8;1;9;1;0;1
96;13.05.2012;2012;05;05;Sunnuntai;1;1;2;0;0;0
96;13.05.2012;2012;05;06;Sunnuntai;13;5;18;0;1;1
96;13.05.2012;2012;05;07;Sunnuntai;4;13;17;0;0;0
96;13.05.2012;2012;05;08;Sunnuntai;4;9;13;1;4;5
96;13.05.2012;2012;05;09;Sunnuntai;27;13;40;6;2;8
96;13.05.2012;2012;05;10;Sunnuntai;22;25;47;6;3;9
96;13.05.2012;2012;05;11;Sunnuntai;34;48;82;5;11;16
96;13.05.2012;2012;05;12;Sunnuntai;47;39;86;15;14;29
96;13.05.2012;2012;05;13;Sunnuntai;70;42;112;16;5;21
96;13.05.2012;2012;05;14;Sunnuntai;41;44;85;13;12;25
96;13.05.2012;2012;05;15;Sunnuntai;50;58;108;7;3;10
96;13.05.2012;2012;05;16;Sunnuntai;46;24;70;14;2;16
96;13.05.2012;2012;05;17;Sunnuntai;32;47;79;4;8;12
96;13.05.2012;2012;05;18;Sunnuntai;50;30;80;13;9;22
96;13.05.2012;2012;05;19;Sunnuntai;45;63;108;16;8;24
96;13.05.2012;2012;05;20;Sunnuntai;29;49;78;9;13;22
96;13.05.2012;2012;05;21;Sunnuntai;23;24;47;8;10;18
96;13.05.2012;2012;05;22;Sunnuntai;6;2;8;1;2;3
96;13.05.2012;2012;05;23;Sunnuntai;6;2;8;3;1;4
96;14.05.2012;2012;05;00;Maanantai;4;0;4;0;0;0
96;14.05.2012;2012;05;01;Maanantai;1;0;1;1;0;1
96;14.05.2012;2012;05;02;Maanantai;1;0;1;0;0;0
96;14.05.2012;2012;05;03;Maanantai;2;1;3;0;0;0
96;14.05.2012;2012;05;04;Maanantai;4;3;7;0;1;1
96;14.05.2012;2012;05;05;Maanantai;4;12;16;1;1;2
96;14.05.2012;2012;05;06;Maanantai;46;42;88;6;2;8
96;14.05.2012;2012;05;07;Maanantai;123;118;241;17;12;29
96;14.05.2012;2012;05;08;Maanantai;108;152;260;14;8;22
96;14.05.2012;2012;05;09;Maanantai;65;94;159;6;5;11
96;14.05.2012;2012;05;10;Maanantai;39;58;97;17;6;23
96;14.05.2012;2012;05;11;Maanantai;44;41;85;8;5;13
96;14.05.2012;2012;05;12;Maanantai;41;55;96;14;7;21
96;14.05.2012;2012;05;13;Maanantai;50;59;109;5;12;17
96;14.05.2012;2012;05;14;Maanantai;62;93;155;8;13;21
96;14.05.2012;2012;05;15;Maanantai;82;175;257;6;23;29
96;14.05.2012;2012;05;16;Maanantai;98;143;241;8;24;32
96;14.05.2012;2012;05;17;Maanantai;66;72;138;13;12;25
96;14.05.2012;2012;05;18;Maanantai;52;38;90;10;15;25
96;14.05.2012;2012;05;19;Maanantai;43;33;76;15;18;33
96;14.05.2012;2012;05;20;Maanantai;34;16;50;9;8;17
96;14.05.2012;2012;05;21;Maanantai;25;21;46;8;6;14
96;14.05.2012;2012;05;22;Maanantai;10;8;18;2;4;6
96;14.05.2012;2012;05;23;Maanantai;3;6;9;2;3;5
96;15.05.2012;2012;05;00;Tiistai;6;1;7;2;2;4
96;15.05.2012;2012;05;01;Tiistai;2;0;2;0;0;0
96;15.05.2012;2012;05;02;Tiistai;0;0;0;0;0;0
96;15.05.2012;2012;05;03;Tiistai;1;0;1;0;0;0
96;15.05.2012;2012;05;04;Tiistai;4;1;5;0;1;1
96;15.05.2012;2012;05;05;Tiistai;3;11;14;1;0;1
96;15.05.2012;2012;05;06;Tiistai;36;50;86;6;1;7
96;15.05.2012;2012;05;07;Tiistai;116;126;242;19;8;27
96;15.05.2012;2012;05;08;Tiistai;98;158;256;14;5;19
96;15.05.2012;2012;05;09;Tiistai;50;87;137;5;18;23
96;15.05.2012;2012;05;10;Tiistai;39;59;98;6;6;12
96;15.05.2012;2012;05;11;Tiistai;53;69;122;5;9;14
96;15.05.2012;2012;05;12;Tiistai;71;74;145;5;23;28
96;15.05.2012;2012;05;13;Tiistai;68;91;159;8;12;20
96;15.05.2012;2012;05;14;Tiistai;77;135;212;12;22;34
96;15.05.2012;2012;05;15;Tiistai;107;207;314;12;19;31
96;15.05.2012;2012;05;16;Tiistai;168;154;322;16;27;43
96;15.05.2012;2012;05;17;Tiistai;83;70;153;12;13;25
96;15.05.2012;2012;05;18;Tiistai;98;76;174;14;12;26
96;15.05.2012;2012;05;19;Tiistai;72;44;116;21;18;39
96;15.05.2012;2012;05;20;Tiistai;59;41;100;20;15;35
96;15.05.2012;2012;05;21;Tiistai;31;36;67;6;11;17
96;15.05.2012;2012;05;22;Tiistai;12;12;24;1;8;9
96;15.05.2012;2012;05;23;Tiistai;8;1;9;0;0;0
96;16.05.2012;2012;05;00;Keskiviikko;3;1;4;0;1;1
96;16.05.2012;2012;05;01;Keskiviikko;3;0;3;0;0;0
96;16.05.2012;2012;05;02;Keskiviikko;0;0;0;0;0;0
96;16.05.2012;2012;05;03;Keskiviikko;0;0;0;0;0;0
96;16.05.2012;2012;05;04;Keskiviikko;6;4;10;0;1;1
96;16.05.2012;2012;05;05;Keskiviikko;5;10;15;0;0;0
96;16.05.2012;2012;05;06;Keskiviikko;32;43;75;8;0;8
96;16.05.2012;2012;05;07;Keskiviikko;108;133;241;22;11;33
96;16.05.2012;2012;05;08;Keskiviikko;106;167;273;18;13;31
96;16.05.2012;2012;05;09;Keskiviikko;61;100;161;2;4;6
96;16.05.2012;2012;05;10;Keskiviikko;41;74;115;6;10;16
96;16.05.2012;2012;05;11;Keskiviikko;55;85;140;7;11;18
96;16.05.2012;2012;05;12;Keskiviikko;84;76;160;10;12;22
96;16.05.2012;2012;05;13;Keskiviikko;69;102;171;2;8;10
96;16.05.2012;2012;05;14;Keskiviikko;113;134;247;3;10;13
96;16.05.2012;2012;05;15;Keskiviikko;135;202;337;13;28;41
96;16.05.2012;2012;05;16;Keskiviikko;131;159;290;16;29;45
96;16.05.2012;2012;05;17;Keskiviikko;105;81;186;14;16;30
96;16.05.2012;2012;05;18;Keskiviikko;84;63;147;19;9;28
96;16.05.2012;2012;05;19;Keskiviikko;82;50;132;16;10;26
96;16.05.2012;2012;05;20;Keskiviikko;47;55;102;7;14;21
96;16.05.2012;2012;05;21;Keskiviikko;42;54;96;5;4;9
96;16.05.2012;2012;05;22;Keskiviikko;20;17;37;2;7;9
96;16.05.2012;2012;05;23;Keskiviikko;16;17;33;4;1;5
96;17.05.2012;2012;05;00;Torstai;14;7;21;2;1;3
96;17.05.2012;2012;05;01;Torstai;13;0;13;2;0;2
96;17.05.2012;2012;05;02;Torstai;26;2;28;1;0;1
96;17.05.2012;2012;05;03;Torstai;16;4;20;1;0;1
96;17.05.2012;2012;05;04;Torstai;8;3;11;1;0;1
96;17.05.2012;2012;05;05;Torstai;4;1;5;0;3;3
96;17.05.2012;2012;05;06;Torstai;17;9;26;0;0;0
96;17.05.2012;2012;05;07;Torstai;4;11;15;0;3;3
96;17.05.2012;2012;05;08;Torstai;4;7;11;0;1;1
96;17.05.2012;2012;05;09;Torstai;4;4;8;0;4;4
96;17.05.2012;2012;05;10;Torstai;5;7;12;2;4;6
96;17.05.2012;2012;05;11;Torstai;22;32;54;8;4;12
96;17.05.2012;2012;05;12;Torstai;29;18;47;8;6;14
96;17.05.2012;2012;05;13;Torstai;30;47;77;10;14;24
96;17.05.2012;2012;05;14;Torstai;34;38;72;10;15;25
96;17.05.2012;2012;05;15;Torstai;33;63;96;8;8;16
96;17.05.2012;2012;05;16;Torstai;61;39;100;17;8;25
96;17.05.2012;2012;05;17;Torstai;30;13;43;3;8;11
96;17.05.2012;2012;05;18;Torstai;21;36;57;10;8;18
96;17.05.2012;2012;05;19;Torstai;15;27;42;4;8;12
96;17.05.2012;2012;05;20;Torstai;14;15;29;5;5;10
96;17.05.2012;2012;05;21;Torstai;13;18;31;1;2;3
96;17.05.2012;2012;05;22;Torstai;13;7;20;2;2;4
96;17.05.2012;2012;05;23;Torstai;9;7;16;1;1;2
96;18.05.2012;2012;05;00;Perjantai;2;0;2;0;0;0
96;18.05.2012;2012;05;01;Perjantai;3;1;4;0;0;0
96;18.05.2012;2012;05;02;Perjantai;1;1;2;0;1;1
96;18.05.2012;2012;05;03;Perjantai;3;1;4;0;0;0
96;18.05.2012;2012;05;04;Perjantai;5;3;8;0;0;0
96;18.05.2012;2012;05;05;Perjantai;5;9;14;0;0;0
96;18.05.2012;2012;05;06;Perjantai;31;32;63;4;2;6
96;18.05.2012;2012;05;07;Perjantai;60;70;130;4;8;12
96;18.05.2012;2012;05;08;Perjantai;40;86;126;6;8;14
96;18.05.2012;2012;05;09;Perjantai;39;65;104;6;3;9
96;18.05.2012;2012;05;10;Perjantai;27;23;50;4;4;8
96;18.05.2012;2012;05;11;Perjantai;23;34;57;3;5;8
96;18.05.2012;2012;05;12;Perjantai;21;44;65;2;6;8
96;18.05.2012;2012;05;13;Perjantai;41;41;82;8;12;20
96;18.05.2012;2012;05;14;Perjantai;47;74;121;0;11;11
96;18.05.2012;2012;05;15;Perjantai;73;94;167;5;13;18
96;18.05.2012;2012;05;16;Perjantai;44;63;107;3;11;14
96;18.05.2012;2012;05;17;Perjantai;49;45;94;12;19;31
96;18.05.2012;2012;05;18;Perjantai;34;38;72;3;9;12
96;18.05.2012;2012;05;19;Perjantai;34;33;67;9;2;11
96;18.05.2012;2012;05;20;Perjantai;33;18;51;6;9;15
96;18.05.2012;2012;05;21;Perjantai;14;15;29;4;6;10
96;18.05.2012;2012;05;22;Perjantai;15;11;26;2;4;6
96;18.05.2012;2012;05;23;Perjantai;7;6;13;2;0;2
96;19.05.2012;2012;05;00;Lauantai;3;8;11;0;1;1
96;19.05.2012;2012;05;01;Lauantai;6;3;9;1;0;1
96;19.05.2012;2012;05;02;Lauantai;5;1;6;1;0;1
96;19.05.2012;2012;05;03;Lauantai;6;4;10;1;0;1
96;19.05.2012;2012;05;04;Lauantai;3;3;6;0;0;0
96;19.05.2012;2012;05;05;Lauantai;4;2;6;0;2;2
96;19.05.2012;2012;05;06;Lauantai;13;9;22;2;1;3
96;19.05.2012;2012;05;07;Lauantai;6;11;17;3;7;10
96;19.05.2012;2012;05;08;Lauantai;16;31;47;10;8;18
96;19.05.2012;2012;05;09;Lauantai;23;47;70;10;6;16
96;19.05.2012;2012;05;10;Lauantai;28;55;83;3;9;12
96;19.05.2012;2012;05;11;Lauantai;37;52;89;10;9;19
96;19.05.2012;2012;05;12;Lauantai;47;61;108;11;14;25
96;19.05.2012;2012;05;13;Lauantai;104;68;172;11;7;18
96;19.05.2012;2012;05;14;Lauantai;77;60;137;6;14;20
96;19.05.2012;2012;05;15;Lauantai;46;50;96;9;8;17
96;19.05.2012;2012;05;16;Lauantai;41;42;83;9;6;15
96;19.05.2012;2012;05;17;Lauantai;52;54;106;22;5;27
96;19.05.2012;2012;05;18;Lauantai;54;45;99;18;13;31
96;19.05.2012;2012;05;19;Lauantai;37;37;74;10;12;22
96;19.05.2012;2012;05;20;Lauantai;30;29;59;5;10;15
96;19.05.2012;2012;05;21;Lauantai;16;30;46;3;5;8
96;19.05.2012;2012;05;22;Lauantai;13;20;33;1;3;4
96;19.05.2012;2012;05;23;Lauantai;12;6;18;0;3;3
96;20.05.2012;2012;05;00;Sunnuntai;3;7;10;1;2;3
96;20.05.2012;2012;05;01;Sunnuntai;11;4;15;2;0;2
96;20.05.2012;2012;05;02;Sunnuntai;13;1;14;2;0;2
96;20.05.2012;2012;05;03;Sunnuntai;16;2;18;2;0;2
96;20.05.2012;2012;05;04;Sunnuntai;9;0;9;2;0;2
96;20.05.2012;2012;05;05;Sunnuntai;4;1;5;0;0;0
96;20.05.2012;2012;05;06;Sunnuntai;10;3;13;1;0;1
96;20.05.2012;2012;05;07;Sunnuntai;4;10;14;2;3;5
96;20.05.2012;2012;05;08;Sunnuntai;5;12;17;1;0;1
96;20.05.2012;2012;05;09;Sunnuntai;7;21;28;4;4;8
96;20.05.2012;2012;05;10;Sunnuntai;12;23;35;5;8;13
96;20.05.2012;2012;05;11;Sunnuntai;25;42;67;3;12;15
96;20.05.2012;2012;05;12;Sunnuntai;35;60;95;5;11;16
96;20.05.2012;2012;05;13;Sunnuntai;63;58;121;12;11;23
96;20.05.2012;2012;05;14;Sunnuntai;55;49;104;11;7;18
96;20.05.2012;2012;05;15;Sunnuntai;52;36;88;4;6;10
96;20.05.2012;2012;05;16;Sunnuntai;29;18;47;11;5;16
96;20.05.2012;2012;05;17;Sunnuntai;25;24;49;7;9;16
96;20.05.2012;2012;05;18;Sunnuntai;30;30;60;11;6;17
96;20.05.2012;2012;05;19;Sunnuntai;21;22;43;5;9;14
96;20.05.2012;2012;05;20;Sunnuntai;23;12;35;4;8;12
96;20.05.2012;2012;05;21;Sunnuntai;8;13;21;3;3;6
96;20.05.2012;2012;05;22;Sunnuntai;2;5;7;4;4;8
96;20.05.2012;2012;05;23;Sunnuntai;5;8;13;1;0;1
96;21.05.2012;2012;05;00;Maanantai;3;0;3;0;0;0
96;21.05.2012;2012;05;01;Maanantai;1;1;2;0;0;0
96;21.05.2012;2012;05;02;Maanantai;2;0;2;0;0;0
96;21.05.2012;2012;05;03;Maanantai;6;0;6;1;0;1
96;21.05.2012;2012;05;04;Maanantai;2;1;3;0;0;0
96;21.05.2012;2012;05;05;Maanantai;4;11;15;0;0;0
96;21.05.2012;2012;05;06;Maanantai;40;49;89;3;0;3
96;21.05.2012;2012;05;07;Maanantai;128;149;277;15;8;23
96;21.05.2012;2012;05;08;Maanantai;89;176;265;12;7;19
96;21.05.2012;2012;05;09;Maanantai;53;97;150;21;6;27
96;21.05.2012;2012;05;10;Maanantai;49;77;126;9;9;18
96;21.05.2012;2012;05;11;Maanantai;66;52;118;11;7;18
96;21.05.2012;2012;05;12;Maanantai;82;67;149;11;8;19
96;21.05.2012;2012;05;13;Maanantai;77;77;154;8;16;24
96;21.05.2012;2012;05;14;Maanantai;93;124;217;13;13;26
96;21.05.2012;2012;05;15;Maanantai;127;183;310;9;16;25
96;21.05.2012;2012;05;16;Maanantai;143;173;316;14;17;31
96;21.05.2012;2012;05;17;Maanantai;109;88;197;20;18;38
96;21.05.2012;2012;05;18;Maanantai;82;63;145;16;9;25
96;21.05.2012;2012;05;19;Maanantai;64;44;108;13;14;27
96;21.05.2012;2012;05;20;Maanantai;72;45;117;18;16;34
96;21.05.2012;2012;05;21;Maanantai;39;32;71;11;9;20
96;21.05.2012;2012;05;22;Maanantai;13;17;30;1;4;5
96;21.05.2012;2012;05;23;Maanantai;9;4;13;3;0;3
96;22.05.2012;2012;05;00;Tiistai;2;0;2;0;1;1
96;22.05.2012;2012;05;01;Tiistai;0;0;0;1;1;2
96;22.05.2012;2012;05;02;Tiistai;1;0;1;0;0;0
96;22.05.2012;2012;05;03;Tiistai;0;0;0;0;0;0
96;22.05.2012;2012;05;04;Tiistai;3;1;4;0;0;0
96;22.05.2012;2012;05;05;Tiistai;8;6;14;0;1;1
96;22.05.2012;2012;05;06;Tiistai;41;39;80;3;3;6
96;22.05.2012;2012;05;07;Tiistai;129;154;283;18;9;27
96;22.05.2012;2012;05;08;Tiistai;109;164;273;8;7;15
96;22.05.2012;2012;05;09;Tiistai;59;88;147;12;7;19
96;22.05.2012;2012;05;10;Tiistai;36;66;102;9;5;14
96;22.05.2012;2012;05;11;Tiistai;62;71;133;11;10;21
96;22.05.2012;2012;05;12;Tiistai;74;60;134;8;6;14
96;22.05.2012;2012;05;13;Tiistai;84;83;167;6;10;16
96;22.05.2012;2012;05;14;Tiistai;91;104;195;7;8;15
96;22.05.2012;2012;05;15;Tiistai;120;176;296;8;28;36
96;22.05.2012;2012;05;16;Tiistai;154;203;357;9;20;29
96;22.05.2012;2012;05;17;Tiistai;115;88;203;12;18;30
96;22.05.2012;2012;05;18;Tiistai;90;75;165;13;14;27
96;22.05.2012;2012;05;19;Tiistai;81;54;135;17;13;30
96;22.05.2012;2012;05;20;Tiistai;54;58;112;18;37;55
96;22.05.2012;2012;05;21;Tiistai;42;33;75;8;11;19
96;22.05.2012;2012;05;22;Tiistai;20;12;32;1;2;3
96;22.05.2012;2012;05;23;Tiistai;5;8;13;3;2;5
96;23.05.2012;2012;05;00;Keskiviikko;5;6;11;2;1;3
96;23.05.2012;2012;05;01;Keskiviikko;1;1;2;0;0;0
96;23.05.2012;2012;05;02;Keskiviikko;4;0;4;0;0;0
96;23.05.2012;2012;05;03;Keskiviikko;0;1;1;0;0;0
96;23.05.2012;2012;05;04;Keskiviikko;2;2;4;0;0;0
96;23.05.2012;2012;05;05;Keskiviikko;6;7;13;0;0;0
96;23.05.2012;2012;05;06;Keskiviikko;46;49;95;2;2;4
96;23.05.2012;2012;05;07;Keskiviikko;124;120;244;17;7;24
96;23.05.2012;2012;05;08;Keskiviikko;99;163;262;15;10;25
96;23.05.2012;2012;05;09;Keskiviikko;74;140;214;7;19;26
96;23.05.2012;2012;05;10;Keskiviikko;49;78;127;4;11;15
96;23.05.2012;2012;05;11;Keskiviikko;98;80;178;9;23;32
96;23.05.2012;2012;05;12;Keskiviikko;81;77;158;13;16;29
96;23.05.2012;2012;05;13;Keskiviikko;82;83;165;12;8;20
96;23.05.2012;2012;05;14;Keskiviikko;103;113;216;14;11;25
96;23.05.2012;2012;05;15;Keskiviikko;132;185;317;11;20;31
96;23.05.2012;2012;05;16;Keskiviikko;112;181;293;16;24;40
96;23.05.2012;2012;05;17;Keskiviikko;116;92;208;15;14;29
96;23.05.2012;2012;05;18;Keskiviikko;105;63;168;10;11;21
96;23.05.2012;2012;05;19;Keskiviikko;79;52;131;20;13;33
96;23.05.2012;2012;05;20;Keskiviikko;63;50;113;12;7;19
96;23.05.2012;2012;05;21;Keskiviikko;33;56;89;6;10;16
96;23.05.2012;2012;05;22;Keskiviikko;15;19;34;5;1;6
96;23.05.2012;2012;05;23;Keskiviikko;9;4;13;0;2;2
96;24.05.2012;2012;05;00;Torstai;4;5;9;1;1;2
96;24.05.2012;2012;05;01;Torstai;1;1;2;2;1;3
96;24.05.2012;2012;05;02;Torstai;5;0;5;0;0;0
96;24.05.2012;2012;05;03;Torstai;3;0;3;0;0;0
96;24.05.2012;2012;05;04;Torstai;6;2;8;1;0;1
96;24.05.2012;2012;05;05;Torstai;5;5;10;1;1;2
96;24.05.2012;2012;05;06;Torstai;44;44;88;3;1;4
96;24.05.2012;2012;05;07;Torstai;128;115;243;25;24;49
96;24.05.2012;2012;05;08;Torstai;115;169;284;18;33;51
96;24.05.2012;2012;05;09;Torstai;53;107;160;9;7;16
96;24.05.2012;2012;05;10;Torstai;44;85;129;6;10;16
96;24.05.2012;2012;05;11;Torstai;67;81;148;7;12;19
96;24.05.2012;2012;05;12;Torstai;87;91;178;11;20;31
96;24.05.2012;2012;05;13;Torstai;79;95;174;15;16;31
96;24.05.2012;2012;05;14;Torstai;88;125;213;15;11;26
96;24.05.2012;2012;05;15;Torstai;94;173;267;15;17;32
96;24.05.2012;2012;05;16;Torstai;131;186;317;8;20;28
96;24.05.2012;2012;05;17;Torstai;102;86;188;12;13;25
96;24.05.2012;2012;05;18;Torstai;97;59;156;10;14;24
96;24.05.2012;2012;05;19;Torstai;68;42;110;7;12;19
96;24.05.2012;2012;05;20;Torstai;62;46;108;8;13;21
96;24.05.2012;2012;05;21;Torstai;38;36;74;4;12;16
96;24.05.2012;2012;05;22;Torstai;22;16;38;5;4;9
96;24.05.2012;2012;05;23;Torstai;1;5;6;4;0;4
96;25.05.2012;2012;05;00;Perjantai;7;6;13;1;0;1
96;25.05.2012;2012;05;01;Perjantai;3;0;3;0;0;0
96;25.05.2012;2012;05;02;Perjantai;1;1;2;1;0;1
96;25.05.2012;2012;05;03;Perjantai;2;0;2;1;0;1
96;25.05.2012;2012;05;04;Perjantai;3;1;4;0;0;0
96;25.05.2012;2012;05;05;Perjantai;2;7;9;1;0;1
96;25.05.2012;2012;05;06;Perjantai;41;50;91;2;3;5
96;25.05.2012;2012;05;07;Perjantai;111;132;243;10;5;15
96;25.05.2012;2012;05;08;Perjantai;101;150;251;9;10;19
96;25.05.2012;2012;05;09;Perjantai;48;106;154;8;6;14
96;25.05.2012;2012;05;10;Perjantai;54;73;127;6;4;10
96;25.05.2012;2012;05;11;Perjantai;52;61;113;14;6;20
96;25.05.2012;2012;05;12;Perjantai;58;74;132;4;5;9
96;25.05.2012;2012;05;13;Perjantai;83;98;181;4;6;10
96;25.05.2012;2012;05;14;Perjantai;99;120;219;4;16;20
96;25.05.2012;2012;05;15;Perjantai;107;157;264;4;20;24
96;25.05.2012;2012;05;16;Perjantai;106;106;212;10;4;14
96;25.05.2012;2012;05;17;Perjantai;87;64;151;5;12;17
96;25.05.2012;2012;05;18;Perjantai;59;57;116;7;4;11
96;25.05.2012;2012;05;19;Perjantai;50;57;107;5;9;14
96;25.05.2012;2012;05;20;Perjantai;57;38;95;9;6;15
96;25.05.2012;2012;05;21;Perjantai;30;33;63;9;4;13
96;25.05.2012;2012;05;22;Perjantai;17;26;43;0;4;4
96;25.05.2012;2012;05;23;Perjantai;13;8;21;0;1;1
96;26.05.2012;2012;05;00;Lauantai;15;10;25;2;1;3
96;26.05.2012;2012;05;01;Lauantai;7;4;11;0;0;0
96;26.05.2012;2012;05;02;Lauantai;17;4;21;0;0;0
96;26.05.2012;2012;05;03;Lauantai;7;5;12;2;0;2
96;26.05.2012;2012;05;04;Lauantai;10;0;10;1;0;1
96;26.05.2012;2012;05;05;Lauantai;7;1;8;0;1;1
96;26.05.2012;2012;05;06;Lauantai;14;14;28;2;0;2
96;26.05.2012;2012;05;07;Lauantai;8;15;23;1;3;4
96;26.05.2012;2012;05;08;Lauantai;13;26;39;0;1;1
96;26.05.2012;2012;05;09;Lauantai;18;57;75;3;6;9
96;26.05.2012;2012;05;10;Lauantai;12;69;81;4;7;11
96;26.05.2012;2012;05;11;Lauantai;49;80;129;4;4;8
96;26.05.2012;2012;05;12;Lauantai;65;60;125;4;4;8
96;26.05.2012;2012;05;13;Lauantai;77;68;145;4;13;17
96;26.05.2012;2012;05;14;Lauantai;59;56;115;5;17;22
96;26.05.2012;2012;05;15;Lauantai;84;47;131;12;9;21
96;26.05.2012;2012;05;16;Lauantai;74;49;123;11;6;17
96;26.05.2012;2012;05;17;Lauantai;63;52;115;8;8;16
96;26.05.2012;2012;05;18;Lauantai;64;36;100;10;8;18
96;26.05.2012;2012;05;19;Lauantai;57;50;107;6;3;9
96;26.05.2012;2012;05;20;Lauantai;28;48;76;6;4;10
96;26.05.2012;2012;05;21;Lauantai;29;43;72;1;6;7
96;26.05.2012;2012;05;22;Lauantai;18;21;39;1;3;4
96;26.05.2012;2012;05;23;Lauantai;8;13;21;3;2;5
96;27.05.2012;2012;05;00;Sunnuntai;9;12;21;0;0;0
96;27.05.2012;2012;05;01;Sunnuntai;19;1;20;0;0;0
96;27.05.2012;2012;05;02;Sunnuntai;17;7;24;1;1;2
96;27.05.2012;2012;05;03;Sunnuntai;33;1;34;0;0;0
96;27.05.2012;2012;05;04;Sunnuntai;12;0;12;2;0;2
96;27.05.2012;2012;05;05;Sunnuntai;5;1;6;0;0;0
96;27.05.2012;2012;05;06;Sunnuntai;17;4;21;2;0;2
96;27.05.2012;2012;05;07;Sunnuntai;5;9;14;5;1;6
96;27.05.2012;2012;05;08;Sunnuntai;5;8;13;1;0;1
96;27.05.2012;2012;05;09;Sunnuntai;14;27;41;5;5;10
96;27.05.2012;2012;05;10;Sunnuntai;13;30;43;4;9;13
96;27.05.2012;2012;05;11;Sunnuntai;39;39;78;3;0;3
96;27.05.2012;2012;05;12;Sunnuntai;45;50;95;10;12;22
96;27.05.2012;2012;05;13;Sunnuntai;68;66;134;6;10;16
96;27.05.2012;2012;05;14;Sunnuntai;57;52;109;8;6;14
96;27.05.2012;2012;05;15;Sunnuntai;70;74;144;13;10;23
96;27.05.2012;2012;05;16;Sunnuntai;75;53;128;18;14;32
96;27.05.2012;2012;05;17;Sunnuntai;71;63;134;14;9;23
96;27.05.2012;2012;05;18;Sunnuntai;44;68;112;14;16;30
96;27.05.2012;2012;05;19;Sunnuntai;44;48;92;12;15;27
96;27.05.2012;2012;05;20;Sunnuntai;47;47;94;5;18;23
96;27.05.2012;2012;05;21;Sunnuntai;35;47;82;4;8;12
96;27.05.2012;2012;05;22;Sunnuntai;9;6;15;2;1;3
96;27.05.2012;2012;05;23;Sunnuntai;6;6;12;0;0;0
96;28.05.2012;2012;05;00;Maanantai;5;1;6;0;0;0
96;28.05.2012;2012;05;01;Maanantai;0;1;1;1;1;2
96;28.05.2012;2012;05;02;Maanantai;1;2;3;0;2;2
96;28.05.2012;2012;05;03;Maanantai;1;0;1;0;0;0
96;28.05.2012;2012;05;04;Maanantai;2;2;4;0;0;0
96;28.05.2012;2012;05;05;Maanantai;5;7;12;0;0;0
96;28.05.2012;2012;05;06;Maanantai;43;34;77;4;2;6
96;28.05.2012;2012;05;07;Maanantai;92;117;209;13;3;16
96;28.05.2012;2012;05;08;Maanantai;91;141;232;6;6;12
96;28.05.2012;2012;05;09;Maanantai;55;112;167;4;6;10
96;28.05.2012;2012;05;10;Maanantai;36;62;98;6;12;18
96;28.05.2012;2012;05;11;Maanantai;62;56;118;9;6;15
96;28.05.2012;2012;05;12;Maanantai;73;76;149;9;7;16
96;28.05.2012;2012;05;13;Maanantai;99;105;204;7;7;14
96;28.05.2012;2012;05;14;Maanantai;85;94;179;7;9;16
96;28.05.2012;2012;05;15;Maanantai;106;155;261;7;20;27
96;28.05.2012;2012;05;16;Maanantai;140;156;296;9;28;37
96;28.05.2012;2012;05;17;Maanantai;113;74;187;12;15;27
96;28.05.2012;2012;05;18;Maanantai;78;62;140;15;14;29
96;28.05.2012;2012;05;19;Maanantai;73;42;115;13;12;25
96;28.05.2012;2012;05;20;Maanantai;69;45;114;9;9;18
96;28.05.2012;2012;05;21;Maanantai;49;42;91;7;7;14
96;28.05.2012;2012;05;22;Maanantai;8;10;18;1;0;1
96;28.05.2012;2012;05;23;Maanantai;4;6;10;0;1;1
96;29.05.2012;2012;05;00;Tiistai;1;0;1;0;0;0
96;29.05.2012;2012;05;01;Tiistai;4;1;5;1;0;1
96;29.05.2012;2012;05;02;Tiistai;1;0;1;0;0;0
96;29.05.2012;2012;05;03;Tiistai;2;1;3;0;0;0
96;29.05.2012;2012;05;04;Tiistai;3;1;4;0;0;0
96;29.05.2012;2012;05;05;Tiistai;5;2;7;0;0;0
96;29.05.2012;2012;05;06;Tiistai;53;47;100;5;2;7
96;29.05.2012;2012;05;07;Tiistai;111;135;246;14;9;23
96;29.05.2012;2012;05;08;Tiistai;94;173;267;11;18;29
96;29.05.2012;2012;05;09;Tiistai;47;152;199;10;14;24
96;29.05.2012;2012;05;10;Tiistai;48;51;99;5;8;13
96;29.05.2012;2012;05;11;Tiistai;59;77;136;8;11;19
96;29.05.2012;2012;05;12;Tiistai;140;65;205;9;12;21
96;29.05.2012;2012;05;13;Tiistai;86;81;167;14;10;24
96;29.05.2012;2012;05;14;Tiistai;96;103;199;3;8;11
96;29.05.2012;2012;05;15;Tiistai;112;178;290;8;20;28
96;29.05.2012;2012;05;16;Tiistai;134;150;284;8;10;18
96;29.05.2012;2012;05;17;Tiistai;97;76;173;11;12;23
96;29.05.2012;2012;05;18;Tiistai;80;68;148;9;15;24
96;29.05.2012;2012;05;19;Tiistai;72;37;109;12;12;24
96;29.05.2012;2012;05;20;Tiistai;70;35;105;11;11;22
96;29.05.2012;2012;05;21;Tiistai;42;38;80;5;10;15
96;29.05.2012;2012;05;22;Tiistai;16;7;23;2;6;8
96;29.05.2012;2012;05;23;Tiistai;5;3;8;1;0;1
96;30.05.2012;2012;05;00;Keskiviikko;5;1;6;0;1;1
96;30.05.2012;2012;05;01;Keskiviikko;2;0;2;0;3;3
96;30.05.2012;2012;05;02;Keskiviikko;3;1;4;0;0;0
96;30.05.2012;2012;05;03;Keskiviikko;2;1;3;0;0;0
96;30.05.2012;2012;05;04;Keskiviikko;2;1;3;1;0;1
96;30.05.2012;2012;05;05;Keskiviikko;7;10;17;0;5;5
96;30.05.2012;2012;05;06;Keskiviikko;41;47;88;3;1;4
96;30.05.2012;2012;05;07;Keskiviikko;129;109;238;20;5;25
96;30.05.2012;2012;05;08;Keskiviikko;83;159;242;3;8;11
96;30.05.2012;2012;05;09;Keskiviikko;53;142;195;10;11;21
96;30.05.2012;2012;05;10;Keskiviikko;37;89;126;5;9;14
96;30.05.2012;2012;05;11;Keskiviikko;67;69;136;4;11;15
96;30.05.2012;2012;05;12;Keskiviikko;140;78;218;11;12;23
96;30.05.2012;2012;05;13;Keskiviikko;79;73;152;5;4;9
96;30.05.2012;2012;05;14;Keskiviikko;94;106;200;12;12;24
96;30.05.2012;2012;05;15;Keskiviikko;107;161;268;6;21;27
96;30.05.2012;2012;05;16;Keskiviikko;131;151;282;10;18;28
96;30.05.2012;2012;05;17;Keskiviikko;107;73;180;17;21;38
96;30.05.2012;2012;05;18;Keskiviikko;86;45;131;9;3;12
96;30.05.2012;2012;05;19;Keskiviikko;70;61;131;14;5;19
96;30.05.2012;2012;05;20;Keskiviikko;54;47;101;7;16;23
96;30.05.2012;2012;05;21;Keskiviikko;30;44;74;10;10;20
96;30.05.2012;2012;05;22;Keskiviikko;15;22;37;1;9;10
96;30.05.2012;2012;05;23;Keskiviikko;5;6;11;0;1;1
96;31.05.2012;2012;05;00;Torstai;3;1;4;0;0;0
96;31.05.2012;2012;05;01;Torstai;3;1;4;0;1;1
96;31.05.2012;2012;05;02;Torstai;1;0;1;0;0;0
96;31.05.2012;2012;05;03;Torstai;5;1;6;2;0;2
96;31.05.2012;2012;05;04;Torstai;5;1;6;1;2;3
96;31.05.2012;2012;05;05;Torstai;6;4;10;0;0;0
96;31.05.2012;2012;05;06;Torstai;48;36;84;3;1;4
96;31.05.2012;2012;05;07;Torstai;121;125;246;18;10;28
96;31.05.2012;2012;05;08;Torstai;95;129;224;5;17;22
96;31.05.2012;2012;05;09;Torstai;54;102;156;10;13;23
96;31.05.2012;2012;05;10;Torstai;51;71;122;8;7;15
96;31.05.2012;2012;05;11;Torstai;92;67;159;8;9;17
96;31.05.2012;2012;05;12;Torstai;82;74;156;7;6;13
96;31.05.2012;2012;05;13;Torstai;77;74;151;8;9;17
96;31.05.2012;2012;05;14;Torstai;80;106;186;5;17;22
96;31.05.2012;2012;05;15;Torstai;99;174;273;6;22;28
96;31.05.2012;2012;05;16;Torstai;122;165;287;4;10;14
96;31.05.2012;2012;05;17;Torstai;81;90;171;8;21;29
96;31.05.2012;2012;05;18;Torstai;102;60;162;14;10;24
96;31.05.2012;2012;05;19;Torstai;69;52;121;13;18;31
96;31.05.2012;2012;05;20;Torstai;58;28;86;11;10;21
96;31.05.2012;2012;05;21;Torstai;42;29;71;2;4;6
96;31.05.2012;2012;05;22;Torstai;11;13;24;0;1;1
96;31.05.2012;2012;05;23;Torstai;4;3;7;0;0;0
96;01.06.2012;2012;06;00;Perjantai;3;3;6;0;3;3
96;01.06.2012;2012;06;01;Perjantai;0;2;2;1;0;1
96;01.06.2012;2012;06;02;Perjantai;3;2;5;1;0;1
96;01.06.2012;2012;06;03;Perjantai;1;1;2;0;1;1
96;01.06.2012;2012;06;04;Perjantai;2;0;2;1;0;1
96;01.06.2012;2012;06;05;Perjantai;8;6;14;0;0;0
96;01.06.2012;2012;06;06;Perjantai;48;45;93;3;3;6
96;01.06.2012;2012;06;07;Perjantai;105;100;205;16;6;22
96;01.06.2012;2012;06;08;Perjantai;66;125;191;11;6;17
96;01.06.2012;2012;06;09;Perjantai;46;96;142;4;6;10
96;01.06.2012;2012;06;10;Perjantai;61;65;126;7;17;24
96;01.06.2012;2012;06;11;Perjantai;58;69;127;8;8;16
96;01.06.2012;2012;06;12;Perjantai;66;77;143;4;15;19
96;01.06.2012;2012;06;13;Perjantai;87;75;162;3;12;15
96;01.06.2012;2012;06;14;Perjantai;76;122;198;2;16;18
96;01.06.2012;2012;06;15;Perjantai;76;135;211;4;13;17
96;01.06.2012;2012;06;16;Perjantai;87;99;186;8;4;12
96;01.06.2012;2012;06;17;Perjantai;61;42;103;7;8;15
96;01.06.2012;2012;06;18;Perjantai;47;29;76;9;10;19
96;01.06.2012;2012;06;19;Perjantai;27;14;41;4;8;12
96;01.06.2012;2012;06;20;Perjantai;19;13;32;5;5;10
96;01.06.2012;2012;06;21;Perjantai;18;28;46;2;4;6
96;01.06.2012;2012;06;22;Perjantai;4;8;12;0;1;1
96;01.06.2012;2012;06;23;Perjantai;5;7;12;1;3;4
96;02.06.2012;2012;06;00;Lauantai;7;5;12;1;1;2
96;02.06.2012;2012;06;01;Lauantai;4;1;5;0;0;0
96;02.06.2012;2012;06;02;Lauantai;6;3;9;1;0;1
96;02.06.2012;2012;06;03;Lauantai;10;0;10;5;0;5
96;02.06.2012;2012;06;04;Lauantai;8;0;8;1;0;1
96;02.06.2012;2012;06;05;Lauantai;9;1;10;0;0;0
96;02.06.2012;2012;06;06;Lauantai;18;10;28;3;0;3
96;02.06.2012;2012;06;07;Lauantai;10;21;31;2;4;6
96;02.06.2012;2012;06;08;Lauantai;11;34;45;2;3;5
96;02.06.2012;2012;06;09;Lauantai;23;30;53;0;5;5
96;02.06.2012;2012;06;10;Lauantai;32;46;78;6;2;8
96;02.06.2012;2012;06;11;Lauantai;25;39;64;1;8;9
96;02.06.2012;2012;06;12;Lauantai;39;34;73;7;5;12
96;02.06.2012;2012;06;13;Lauantai;25;40;65;3;7;10
96;02.06.2012;2012;06;14;Lauantai;29;37;66;3;5;8
96;02.06.2012;2012;06;15;Lauantai;19;33;52;4;11;15
96;02.06.2012;2012;06;16;Lauantai;26;13;39;5;2;7
96;02.06.2012;2012;06;17;Lauantai;21;7;28;2;1;3
96;02.06.2012;2012;06;18;Lauantai;20;11;31;3;2;5
96;02.06.2012;2012;06;19;Lauantai;8;10;18;0;3;3
96;02.06.2012;2012;06;20;Lauantai;1;13;14;3;6;9
96;02.06.2012;2012;06;21;Lauantai;12;18;30;1;1;2
96;02.06.2012;2012;06;22;Lauantai;3;17;20;0;1;1
96;02.06.2012;2012;06;23;Lauantai;8;5;13;1;0;1
96;03.06.2012;2012;06;00;Sunnuntai;7;10;17;0;1;1
96;03.06.2012;2012;06;01;Sunnuntai;4;6;10;0;0;0
96;03.06.2012;2012;06;02;Sunnuntai;13;1;14;1;0;1
96;03.06.2012;2012;06;03;Sunnuntai;14;1;15;4;0;4
96;03.06.2012;2012;06;04;Sunnuntai;6;1;7;2;0;2
96;03.06.2012;2012;06;05;Sunnuntai;2;0;2;6;0;6
96;03.06.2012;2012;06;06;Sunnuntai;14;5;19;2;0;2
96;03.06.2012;2012;06;07;Sunnuntai;6;8;14;0;1;1
96;03.06.2012;2012;06;08;Sunnuntai;4;10;14;1;2;3
96;03.06.2012;2012;06;09;Sunnuntai;6;6;12;2;4;6
96;03.06.2012;2012;06;10;Sunnuntai;11;8;19;5;7;12
96;03.06.2012;2012;06;11;Sunnuntai;9;30;39;7;10;17
96;03.06.2012;2012;06;12;Sunnuntai;24;39;63;5;3;8
96;03.06.2012;2012;06;13;Sunnuntai;50;46;96;6;13;19
96;03.06.2012;2012;06;14;Sunnuntai;35;44;79;7;6;13
96;03.06.2012;2012;06;15;Sunnuntai;35;36;71;5;8;13
96;03.06.2012;2012;06;16;Sunnuntai;28;29;57;9;6;15
96;03.06.2012;2012;06;17;Sunnuntai;24;20;44;6;1;7
96;03.06.2012;2012;06;18;Sunnuntai;27;10;37;8;3;11
96;03.06.2012;2012;06;19;Sunnuntai;24;11;35;3;10;13
96;03.06.2012;2012;06;20;Sunnuntai;14;23;37;4;10;14
96;03.06.2012;2012;06;21;Sunnuntai;13;20;33;4;6;10
96;03.06.2012;2012;06;22;Sunnuntai;5;11;16;0;2;2
96;03.06.2012;2012;06;23;Sunnuntai;6;4;10;0;2;2
96;04.06.2012;2012;06;00;Maanantai;0;2;2;1;0;1
96;04.06.2012;2012;06;01;Maanantai;1;0;1;0;0;0
96;04.06.2012;2012;06;02;Maanantai;3;0;3;1;1;2
96;04.06.2012;2012;06;03;Maanantai;1;1;2;0;0;0
96;04.06.2012;2012;06;04;Maanantai;1;1;2;0;0;0
96;04.06.2012;2012;06;05;Maanantai;3;8;11;1;0;1
96;04.06.2012;2012;06;06;Maanantai;44;59;103;6;2;8
96;04.06.2012;2012;06;07;Maanantai;99;118;217;8;7;15
96;04.06.2012;2012;06;08;Maanantai;52;96;148;9;2;11
96;04.06.2012;2012;06;09;Maanantai;39;60;99;6;10;16
96;04.06.2012;2012;06;10;Maanantai;19;33;52;9;9;18
96;04.06.2012;2012;06;11;Maanantai;48;52;100;5;8;13
96;04.06.2012;2012;06;12;Maanantai;42;45;87;16;18;34
96;04.06.2012;2012;06;13;Maanantai;62;57;119;2;5;7
96;04.06.2012;2012;06;14;Maanantai;46;75;121;7;12;19
96;04.06.2012;2012;06;15;Maanantai;78;157;235;7;17;24
96;04.06.2012;2012;06;16;Maanantai;98;135;233;7;13;20
96;04.06.2012;2012;06;17;Maanantai;79;57;136;13;7;20
96;04.06.2012;2012;06;18;Maanantai;41;41;82;9;9;18
96;04.06.2012;2012;06;19;Maanantai;43;25;68;9;14;23
96;04.06.2012;2012;06;20;Maanantai;45;19;64;9;11;20
96;04.06.2012;2012;06;21;Maanantai;33;24;57;8;4;12
96;04.06.2012;2012;06;22;Maanantai;11;7;18;0;3;3
96;04.06.2012;2012;06;23;Maanantai;4;7;11;0;1;1
96;05.06.2012;2012;06;00;Tiistai;3;2;5;0;1;1
96;05.06.2012;2012;06;01;Tiistai;2;1;3;0;0;0
96;05.06.2012;2012;06;02;Tiistai;1;0;1;0;0;0
96;05.06.2012;2012;06;03;Tiistai;0;0;0;0;0;0
96;05.06.2012;2012;06;04;Tiistai;1;1;2;0;0;0
96;05.06.2012;2012;06;05;Tiistai;4;8;12;1;0;1
96;05.06.2012;2012;06;06;Tiistai;46;44;90;2;0;2
96;05.06.2012;2012;06;07;Tiistai;89;106;195;12;6;18
96;05.06.2012;2012;06;08;Tiistai;65;96;161;11;1;12
96;05.06.2012;2012;06;09;Tiistai;49;51;100;5;11;16
96;05.06.2012;2012;06;10;Tiistai;20;45;65;5;11;16
96;05.06.2012;2012;06;11;Tiistai;32;60;92;6;12;18
96;05.06.2012;2012;06;12;Tiistai;57;73;130;19;28;47
96;05.06.2012;2012;06;13;Tiistai;53;61;114;9;12;21
96;05.06.2012;2012;06;14;Tiistai;47;90;137;4;5;9
96;05.06.2012;2012;06;15;Tiistai;95;173;268;9;22;31
96;05.06.2012;2012;06;16;Tiistai;112;141;253;6;16;22
96;05.06.2012;2012;06;17;Tiistai;77;85;162;9;10;19
96;05.06.2012;2012;06;18;Tiistai;51;61;112;12;14;26
96;05.06.2012;2012;06;19;Tiistai;65;44;109;8;13;21
96;05.06.2012;2012;06;20;Tiistai;62;33;95;12;6;18
96;05.06.2012;2012;06;21;Tiistai;32;31;63;5;6;11
96;05.06.2012;2012;06;22;Tiistai;13;8;21;2;3;5
96;05.06.2012;2012;06;23;Tiistai;5;1;6;0;0;0
96;06.06.2012;2012;06;00;Keskiviikko;4;0;4;0;0;0
96;06.06.2012;2012;06;01;Keskiviikko;3;3;6;0;0;0
96;06.06.2012;2012;06;02;Keskiviikko;0;1;1;0;0;0
96;06.06.2012;2012;06;03;Keskiviikko;0;1;1;0;0;0
96;06.06.2012;2012;06;04;Keskiviikko;1;2;3;0;0;0
96;06.06.2012;2012;06;05;Keskiviikko;5;9;14;0;0;0
96;06.06.2012;2012;06;06;Keskiviikko;61;47;108;3;1;4
96;06.06.2012;2012;06;07;Keskiviikko;105;122;227;12;8;20
96;06.06.2012;2012;06;08;Keskiviikko;68;119;187;9;9;18
96;06.06.2012;2012;06;09;Keskiviikko;48;63;111;6;9;15
96;06.06.2012;2012;06;10;Keskiviikko;19;54;73;4;6;10
96;06.06.2012;2012;06;11;Keskiviikko;43;93;136;5;5;10
96;06.06.2012;2012;06;12;Keskiviikko;79;66;145;8;5;13
96;06.06.2012;2012;06;13;Keskiviikko;78;70;148;4;6;10
96;06.06.2012;2012;06;14;Keskiviikko;85;91;176;4;11;15
96;06.06.2012;2012;06;15;Keskiviikko;117;168;285;7;17;24
96;06.06.2012;2012;06;16;Keskiviikko;165;153;318;9;19;28
96;06.06.2012;2012;06;17;Keskiviikko;111;92;203;28;19;47
96;06.06.2012;2012;06;18;Keskiviikko;105;62;167;16;9;25
96;06.06.2012;2012;06;19;Keskiviikko;94;65;159;13;14;27
96;06.06.2012;2012;06;20;Keskiviikko;70;58;128;9;7;16
96;06.06.2012;2012;06;21;Keskiviikko;50;31;81;12;9;21
96;06.06.2012;2012;06;22;Keskiviikko;18;23;41;6;3;9
96;06.06.2012;2012;06;23;Keskiviikko;12;3;15;1;2;3
96;07.06.2012;2012;06;00;Torstai;5;2;7;0;0;0
96;07.06.2012;2012;06;01;Torstai;5;2;7;0;0;0
96;07.06.2012;2012;06;02;Torstai;3;0;3;0;0;0
96;07.06.2012;2012;06;03;Torstai;1;1;2;1;0;1
96;07.06.2012;2012;06;04;Torstai;1;1;2;1;0;1
96;07.06.2012;2012;06;05;Torstai;7;9;16;0;1;1
96;07.06.2012;2012;06;06;Torstai;48;45;93;1;0;1
96;07.06.2012;2012;06;07;Torstai;114;137;251;10;3;13
96;07.06.2012;2012;06;08;Torstai;64;112;176;8;5;13
96;07.06.2012;2012;06;09;Torstai;50;68;118;3;10;13
96;07.06.2012;2012;06;10;Torstai;23;69;92;6;13;19
96;07.06.2012;2012;06;11;Torstai;51;50;101;9;10;19
96;07.06.2012;2012;06;12;Torstai;60;53;113;12;8;20
96;07.06.2012;2012;06;13;Torstai;60;68;128;4;7;11
96;07.06.2012;2012;06;14;Torstai;50;96;146;5;16;21
96;07.06.2012;2012;06;15;Torstai;101;169;270;6;16;22
96;07.06.2012;2012;06;16;Torstai;129;161;290;7;17;24
96;07.06.2012;2012;06;17;Torstai;96;77;173;12;10;22
96;07.06.2012;2012;06;18;Torstai;88;37;125;5;8;13
96;07.06.2012;2012;06;19;Torstai;65;44;109;11;18;29
96;07.06.2012;2012;06;20;Torstai;61;45;106;14;13;27
96;07.06.2012;2012;06;21;Torstai;44;27;71;6;8;14
96;07.06.2012;2012;06;22;Torstai;13;16;29;2;2;4
96;07.06.2012;2012;06;23;Torstai;5;7;12;0;1;1
96;08.06.2012;2012;06;00;Perjantai;3;1;4;0;1;1
96;08.06.2012;2012;06;01;Perjantai;7;2;9;0;0;0
96;08.06.2012;2012;06;02;Perjantai;3;1;4;1;0;1
96;08.06.2012;2012;06;03;Perjantai;2;3;5;0;0;0
96;08.06.2012;2012;06;04;Perjantai;4;2;6;1;0;1
96;08.06.2012;2012;06;05;Perjantai;10;9;19;2;0;2
96;08.06.2012;2012;06;06;Perjantai;56;51;107;2;1;3
96;08.06.2012;2012;06;07;Perjantai;98;93;191;16;5;21
96;08.06.2012;2012;06;08;Perjantai;62;116;178;13;3;16
96;08.06.2012;2012;06;09;Perjantai;38;60;98;5;7;12
96;08.06.2012;2012;06;10;Perjantai;26;51;77;2;10;12
96;08.06.2012;2012;06;11;Perjantai;45;57;102;8;3;11
96;08.06.2012;2012;06;12;Perjantai;47;80;127;4;6;10
96;08.06.2012;2012;06;13;Perjantai;61;79;140;6;22;28
96;08.06.2012;2012;06;14;Perjantai;79;97;176;3;12;15
96;08.06.2012;2012;06;15;Perjantai;96;139;235;10;19;29
96;08.06.2012;2012;06;16;Perjantai;103;102;205;3;8;11
96;08.06.2012;2012;06;17;Perjantai;55;67;122;10;9;19
96;08.06.2012;2012;06;18;Perjantai;66;60;126;6;10;16
96;08.06.2012;2012;06;19;Perjantai;41;27;68;6;4;10
96;08.06.2012;2012;06;20;Perjantai;48;22;70;14;5;19
96;08.06.2012;2012;06;21;Perjantai;39;45;84;2;4;6
96;08.06.2012;2012;06;22;Perjantai;15;14;29;1;3;4
96;08.06.2012;2012;06;23;Perjantai;15;8;23;1;1;2
96;09.06.2012;2012;06;00;Lauantai;11;10;21;0;1;1
96;09.06.2012;2012;06;01;Lauantai;15;7;22;0;0;0
96;09.06.2012;2012;06;02;Lauantai;13;5;18;1;0;1
96;09.06.2012;2012;06;03;Lauantai;11;1;12;5;0;5
96;09.06.2012;2012;06;04;Lauantai;15;1;16;1;0;1
96;09.06.2012;2012;06;05;Lauantai;11;3;14;0;0;0
96;09.06.2012;2012;06;06;Lauantai;14;8;22;1;1;2
96;09.06.2012;2012;06;07;Lauantai;2;10;12;0;1;1
96;09.06.2012;2012;06;08;Lauantai;6;16;22;0;2;2
96;09.06.2012;2012;06;09;Lauantai;15;33;48;2;3;5
96;09.06.2012;2012;06;10;Lauantai;12;37;49;5;4;9
96;09.06.2012;2012;06;11;Lauantai;26;48;74;4;8;12
96;09.06.2012;2012;06;12;Lauantai;30;60;90;5;5;10
96;09.06.2012;2012;06;13;Lauantai;43;39;82;9;7;16
96;09.06.2012;2012;06;14;Lauantai;45;43;88;1;10;11
96;09.06.2012;2012;06;15;Lauantai;59;57;116;6;12;18
96;09.06.2012;2012;06;16;Lauantai;47;38;85;4;6;10
96;09.06.2012;2012;06;17;Lauantai;59;45;104;5;5;10
96;09.06.2012;2012;06;18;Lauantai;52;28;80;9;4;13
96;09.06.2012;2012;06;19;Lauantai;26;33;59;13;10;23
96;09.06.2012;2012;06;20;Lauantai;16;31;47;5;8;13
96;09.06.2012;2012;06;21;Lauantai;21;47;68;2;5;7
96;09.06.2012;2012;06;22;Lauantai;14;16;30;2;0;2
96;09.06.2012;2012;06;23;Lauantai;6;11;17;1;2;3
96;10.06.2012;2012;06;00;Sunnuntai;13;7;20;1;1;2
96;10.06.2012;2012;06;01;Sunnuntai;7;3;10;1;0;1
96;10.06.2012;2012;06;02;Sunnuntai;25;2;27;2;0;2
96;10.06.2012;2012;06;03;Sunnuntai;8;2;10;4;0;4
96;10.06.2012;2012;06;04;Sunnuntai;16;0;16;2;0;2
96;10.06.2012;2012;06;05;Sunnuntai;3;1;4;1;1;2
96;10.06.2012;2012;06;06;Sunnuntai;22;7;29;5;2;7
96;10.06.2012;2012;06;07;Sunnuntai;8;14;22;1;3;4
96;10.06.2012;2012;06;08;Sunnuntai;7;7;14;3;3;6
96;10.06.2012;2012;06;09;Sunnuntai;29;49;78;9;6;15
96;10.06.2012;2012;06;10;Sunnuntai;28;38;66;6;8;14
96;10.06.2012;2012;06;11;Sunnuntai;26;47;73;12;5;17
96;10.06.2012;2012;06;12;Sunnuntai;45;61;106;16;13;29
96;10.06.2012;2012;06;13;Sunnuntai;69;54;123;8;12;20
96;10.06.2012;2012;06;14;Sunnuntai;51;66;117;16;8;24
96;10.06.2012;2012;06;15;Sunnuntai;54;60;114;7;9;16
96;10.06.2012;2012;06;16;Sunnuntai;73;72;145;9;9;18
96;10.06.2012;2012;06;17;Sunnuntai;70;48;118;15;8;23
96;10.06.2012;2012;06;18;Sunnuntai;50;47;97;19;9;28
96;10.06.2012;2012;06;19;Sunnuntai;43;51;94;8;11;19
96;10.06.2012;2012;06;20;Sunnuntai;24;37;61;7;15;22
96;10.06.2012;2012;06;21;Sunnuntai;27;39;66;5;7;12
96;10.06.2012;2012;06;22;Sunnuntai;5;7;12;0;0;0
96;10.06.2012;2012;06;23;Sunnuntai;4;4;8;2;2;4
96;11.06.2012;2012;06;00;Maanantai;3;4;7;0;0;0
96;11.06.2012;2012;06;01;Maanantai;2;0;2;0;0;0
96;11.06.2012;2012;06;02;Maanantai;2;0;2;0;0;0
96;11.06.2012;2012;06;03;Maanantai;3;0;3;1;0;1
96;11.06.2012;2012;06;04;Maanantai;6;2;8;0;0;0
96;11.06.2012;2012;06;05;Maanantai;9;5;14;1;0;1
96;11.06.2012;2012;06;06;Maanantai;57;41;98;6;1;7
96;11.06.2012;2012;06;07;Maanantai;113;118;231;12;5;17
96;11.06.2012;2012;06;08;Maanantai;59;123;182;6;6;12
96;11.06.2012;2012;06;09;Maanantai;43;88;131;5;6;11
96;11.06.2012;2012;06;10;Maanantai;37;60;97;17;7;24
96;11.06.2012;2012;06;11;Maanantai;51;58;109;5;8;13
96;11.06.2012;2012;06;12;Maanantai;72;74;146;3;9;12
96;11.06.2012;2012;06;13;Maanantai;78;72;150;10;14;24
96;11.06.2012;2012;06;14;Maanantai;70;88;158;9;12;21
96;11.06.2012;2012;06;15;Maanantai;91;186;277;10;17;27
96;11.06.2012;2012;06;16;Maanantai;130;135;265;11;20;31
96;11.06.2012;2012;06;17;Maanantai;94;94;188;11;21;32
96;11.06.2012;2012;06;18;Maanantai;87;69;156;17;12;29
96;11.06.2012;2012;06;19;Maanantai;68;34;102;11;10;21
96;11.06.2012;2012;06;20;Maanantai;41;33;74;11;14;25
96;11.06.2012;2012;06;21;Maanantai;58;40;98;5;5;10
96;11.06.2012;2012;06;22;Maanantai;22;21;43;6;4;10
96;11.06.2012;2012;06;23;Maanantai;7;6;13;0;1;1
96;12.06.2012;2012;06;00;Tiistai;2;4;6;0;0;0
96;12.06.2012;2012;06;01;Tiistai;1;1;2;1;1;2
96;12.06.2012;2012;06;02;Tiistai;6;1;7;2;1;3
96;12.06.2012;2012;06;03;Tiistai;5;1;6;0;0;0
96;12.06.2012;2012;06;04;Tiistai;2;2;4;0;0;0
96;12.06.2012;2012;06;05;Tiistai;6;9;15;1;0;1
96;12.06.2012;2012;06;06;Tiistai;41;62;103;3;3;6
96;12.06.2012;2012;06;07;Tiistai;125;130;255;9;8;17
96;12.06.2012;2012;06;08;Tiistai;73;120;193;6;7;13
96;12.06.2012;2012;06;09;Tiistai;43;85;128;3;15;18
96;12.06.2012;2012;06;10;Tiistai;59;59;118;9;6;15
96;12.06.2012;2012;06;11;Tiistai;72;71;143;9;17;26
96;12.06.2012;2012;06;12;Tiistai;62;69;131;12;9;21
96;12.06.2012;2012;06;13;Tiistai;70;77;147;7;11;18
96;12.06.2012;2012;06;14;Tiistai;81;98;179;7;24;31
96;12.06.2012;2012;06;15;Tiistai;116;209;325;9;31;40
96;12.06.2012;2012;06;16;Tiistai;167;161;328;7;15;22
96;12.06.2012;2012;06;17;Tiistai;111;84;195;14;17;31
96;12.06.2012;2012;06;18;Tiistai;80;75;155;11;16;27
96;12.06.2012;2012;06;19;Tiistai;74;60;134;14;10;24
96;12.06.2012;2012;06;20;Tiistai;77;45;122;7;9;16
96;12.06.2012;2012;06;21;Tiistai;41;36;77;4;19;23
96;12.06.2012;2012;06;22;Tiistai;20;19;39;9;2;11
96;12.06.2012;2012;06;23;Tiistai;15;7;22;0;1;1
96;13.06.2012;2012;06;00;Keskiviikko;10;2;12;0;1;1
96;13.06.2012;2012;06;01;Keskiviikko;3;0;3;1;1;2
96;13.06.2012;2012;06;02;Keskiviikko;2;0;2;2;0;2
96;13.06.2012;2012;06;03;Keskiviikko;2;0;2;0;1;1
96;13.06.2012;2012;06;04;Keskiviikko;4;3;7;0;0;0
96;13.06.2012;2012;06;05;Keskiviikko;9;6;15;1;0;1
96;13.06.2012;2012;06;06;Keskiviikko;60;55;115;7;3;10
96;13.06.2012;2012;06;07;Keskiviikko;128;143;271;8;12;20
96;13.06.2012;2012;06;08;Keskiviikko;81;133;214;3;10;13
96;13.06.2012;2012;06;09;Keskiviikko;47;71;118;5;7;12
96;13.06.2012;2012;06;10;Keskiviikko;32;74;106;5;10;15
96;13.06.2012;2012;06;11;Keskiviikko;68;74;142;6;13;19
96;13.06.2012;2012;06;12;Keskiviikko;71;76;147;3;8;11
96;13.06.2012;2012;06;13;Keskiviikko;90;91;181;6;8;14
96;13.06.2012;2012;06;14;Keskiviikko;87;92;179;4;18;22
96;13.06.2012;2012;06;15;Keskiviikko;131;177;308;5;24;29
96;13.06.2012;2012;06;16;Keskiviikko;155;173;328;7;17;24
96;13.06.2012;2012;06;17;Keskiviikko;127;84;211;18;23;41
96;13.06.2012;2012;06;18;Keskiviikko;97;80;177;24;16;40
96;13.06.2012;2012;06;19;Keskiviikko;95;67;162;13;11;24
96;13.06.2012;2012;06;20;Keskiviikko;73;68;141;15;11;26
96;13.06.2012;2012;06;21;Keskiviikko;47;64;111;12;2;14
96;13.06.2012;2012;06;22;Keskiviikko;22;19;41;3;4;7
96;13.06.2012;2012;06;23;Keskiviikko;15;9;24;1;2;3
96;14.06.2012;2012;06;00;Torstai;13;2;15;0;1;1
96;14.06.2012;2012;06;01;Torstai;5;3;8;1;0;1
96;14.06.2012;2012;06;02;Torstai;3;1;4;0;0;0
96;14.06.2012;2012;06;03;Torstai;2;3;5;2;0;2
96;14.06.2012;2012;06;04;Torstai;4;2;6;0;1;1
96;14.06.2012;2012;06;05;Torstai;9;7;16;0;0;0
96;14.06.2012;2012;06;06;Torstai;55;44;99;5;2;7
96;14.06.2012;2012;06;07;Torstai;118;137;255;14;13;27
96;14.06.2012;2012;06;08;Torstai;65;124;189;8;6;14
96;14.06.2012;2012;06;09;Torstai;49;85;134;1;7;8
96;14.06.2012;2012;06;10;Torstai;34;69;103;5;5;10
96;14.06.2012;2012;06;11;Torstai;58;87;145;7;9;16
96;14.06.2012;2012;06;12;Torstai;84;68;152;12;9;21
96;14.06.2012;2012;06;13;Torstai;87;87;174;5;16;21
96;14.06.2012;2012;06;14;Torstai;98;111;209;8;11;19
96;14.06.2012;2012;06;15;Torstai;112;218;330;12;26;38
96;14.06.2012;2012;06;16;Torstai;165;152;317;14;12;26
96;14.06.2012;2012;06;17;Torstai;102;150;252;10;16;26
96;14.06.2012;2012;06;18;Torstai;91;97;188;11;11;22
96;14.06.2012;2012;06;19;Torstai;105;65;170;11;14;25
96;14.06.2012;2012;06;20;Torstai;103;37;140;13;10;23
96;14.06.2012;2012;06;21;Torstai;39;44;83;9;6;15
96;14.06.2012;2012;06;22;Torstai;23;14;37;5;1;6
96;14.06.2012;2012;06;23;Torstai;10;6;16;0;1;1
96;15.06.2012;2012;06;00;Perjantai;8;4;12;1;1;2
96;15.06.2012;2012;06;01;Perjantai;8;0;8;0;0;0
96;15.06.2012;2012;06;02;Perjantai;0;1;1;0;2;2
96;15.06.2012;2012;06;03;Perjantai;7;1;8;0;0;0
96;15.06.2012;2012;06;04;Perjantai;4;2;6;0;0;0
96;15.06.2012;2012;06;05;Perjantai;12;12;24;0;0;0
96;15.06.2012;2012;06;06;Perjantai;52;32;84;2;2;4
96;15.06.2012;2012;06;07;Perjantai;115;121;236;15;9;24
96;15.06.2012;2012;06;08;Perjantai;63;119;182;3;9;12
96;15.06.2012;2012;06;09;Perjantai;53;87;140;2;2;4
96;15.06.2012;2012;06;10;Perjantai;29;70;99;12;21;33
96;15.06.2012;2012;06;11;Perjantai;49;75;124;10;10;20
96;15.06.2012;2012;06;12;Perjantai;83;69;152;15;13;28
96;15.06.2012;2012;06;13;Perjantai;74;100;174;3;9;12
96;15.06.2012;2012;06;14;Perjantai;87;117;204;2;16;18
96;15.06.2012;2012;06;15;Perjantai;92;161;253;10;18;28
96;15.06.2012;2012;06;16;Perjantai;122;104;226;7;7;14
96;15.06.2012;2012;06;17;Perjantai;92;61;153;14;7;21
96;15.06.2012;2012;06;18;Perjantai;64;34;98;8;7;15
96;15.06.2012;2012;06;19;Perjantai;41;56;97;8;6;14
96;15.06.2012;2012;06;20;Perjantai;42;57;99;13;8;21
96;15.06.2012;2012;06;21;Perjantai;31;32;63;4;4;8
96;15.06.2012;2012;06;22;Perjantai;24;25;49;1;3;4
96;15.06.2012;2012;06;23;Perjantai;16;19;35;2;2;4
96;16.06.2012;2012;06;00;Lauantai;18;13;31;0;0;0
96;16.06.2012;2012;06;01;Lauantai;24;6;30;0;0;0
96;16.06.2012;2012;06;02;Lauantai;20;0;20;5;0;5
96;16.06.2012;2012;06;03;Lauantai;14;0;14;0;0;0
96;16.06.2012;2012;06;04;Lauantai;16;2;18;2;0;2
96;16.06.2012;2012;06;05;Lauantai;9;5;14;0;0;0
96;16.06.2012;2012;06;06;Lauantai;20;13;33;4;0;4
96;16.06.2012;2012;06;07;Lauantai;10;19;29;4;2;6
96;16.06.2012;2012;06;08;Lauantai;9;25;34;1;4;5
96;16.06.2012;2012;06;09;Lauantai;19;44;63;0;9;9
96;16.06.2012;2012;06;10;Lauantai;31;56;87;0;6;6
96;16.06.2012;2012;06;11;Lauantai;39;68;107;8;11;19
96;16.06.2012;2012;06;12;Lauantai;60;82;142;6;12;18
96;16.06.2012;2012;06;13;Lauantai;73;87;160;7;12;19
96;16.06.2012;2012;06;14;Lauantai;88;49;137;4;10;14
96;16.06.2012;2012;06;15;Lauantai;87;68;155;5;11;16
96;16.06.2012;2012;06;16;Lauantai;76;73;149;5;6;11
96;16.06.2012;2012;06;17;Lauantai;59;68;127;11;7;18
96;16.06.2012;2012;06;18;Lauantai;63;63;126;6;2;8
96;16.06.2012;2012;06;19;Lauantai;52;38;90;12;5;17
96;16.06.2012;2012;06;20;Lauantai;22;25;47;7;10;17
96;16.06.2012;2012;06;21;Lauantai;17;33;50;2;2;4
96;16.06.2012;2012;06;22;Lauantai;17;31;48;14;13;27
96;16.06.2012;2012;06;23;Lauantai;19;27;46;3;3;6
96;17.06.2012;2012;06;00;Sunnuntai;14;13;27;2;3;5
96;17.06.2012;2012;06;01;Sunnuntai;17;1;18;1;0;1
96;17.06.2012;2012;06;02;Sunnuntai;19;2;21;4;0;4
96;17.06.2012;2012;06;03;Sunnuntai;19;5;24;3;0;3
96;17.06.2012;2012;06;04;Sunnuntai;19;3;22;1;0;1
96;17.06.2012;2012;06;05;Sunnuntai;2;1;3;1;0;1
96;17.06.2012;2012;06;06;Sunnuntai;13;6;19;0;0;0
96;17.06.2012;2012;06;07;Sunnuntai;9;10;19;2;1;3
96;17.06.2012;2012;06;08;Sunnuntai;2;8;10;2;2;4
96;17.06.2012;2012;06;09;Sunnuntai;7;11;18;1;5;6
96;17.06.2012;2012;06;10;Sunnuntai;14;17;31;1;3;4
96;17.06.2012;2012;06;11;Sunnuntai;13;26;39;4;3;7
96;17.06.2012;2012;06;12;Sunnuntai;23;37;60;3;4;7
96;17.06.2012;2012;06;13;Sunnuntai;32;40;72;3;8;11
96;17.06.2012;2012;06;14;Sunnuntai;59;49;108;5;7;12
96;17.06.2012;2012;06;15;Sunnuntai;41;61;102;2;5;7
96;17.06.2012;2012;06;16;Sunnuntai;33;42;75;6;6;12
96;17.06.2012;2012;06;17;Sunnuntai;46;35;81;11;7;18
96;17.06.2012;2012;06;18;Sunnuntai;48;38;86;10;13;23
96;17.06.2012;2012;06;19;Sunnuntai;56;47;103;13;17;30
96;17.06.2012;2012;06;20;Sunnuntai;35;39;74;9;20;29
96;17.06.2012;2012;06;21;Sunnuntai;19;45;64;7;8;15
96;17.06.2012;2012;06;22;Sunnuntai;18;8;26;1;2;3
96;17.06.2012;2012;06;23;Sunnuntai;4;7;11;1;1;2
96;18.06.2012;2012;06;00;Maanantai;2;3;5;2;1;3
96;18.06.2012;2012;06;01;Maanantai;1;0;1;2;2;4
96;18.06.2012;2012;06;02;Maanantai;7;1;8;0;1;1
96;18.06.2012;2012;06;03;Maanantai;5;1;6;0;0;0
96;18.06.2012;2012;06;04;Maanantai;3;2;5;0;0;0
96;18.06.2012;2012;06;05;Maanantai;11;13;24;1;0;1
96;18.06.2012;2012;06;06;Maanantai;45;31;76;5;4;9
96;18.06.2012;2012;06;07;Maanantai;80;81;161;12;5;17
96;18.06.2012;2012;06;08;Maanantai;51;49;100;5;1;6
96;18.06.2012;2012;06;09;Maanantai;29;44;73;3;2;5
96;18.06.2012;2012;06;10;Maanantai;19;44;63;5;2;7
96;18.06.2012;2012;06;11;Maanantai;34;42;76;2;5;7
96;18.06.2012;2012;06;12;Maanantai;41;55;96;5;7;12
96;18.06.2012;2012;06;13;Maanantai;48;59;107;4;6;10
96;18.06.2012;2012;06;14;Maanantai;50;73;123;5;7;12
96;18.06.2012;2012;06;15;Maanantai;63;157;220;5;17;22
96;18.06.2012;2012;06;16;Maanantai;77;98;175;9;17;26
96;18.06.2012;2012;06;17;Maanantai;62;68;130;8;15;23
96;18.06.2012;2012;06;18;Maanantai;72;61;133;16;8;24
96;18.06.2012;2012;06;19;Maanantai;73;50;123;13;13;26
96;18.06.2012;2012;06;20;Maanantai;75;25;100;12;13;25
96;18.06.2012;2012;06;21;Maanantai;36;41;77;12;11;23
96;18.06.2012;2012;06;22;Maanantai;18;9;27;1;2;3
96;18.06.2012;2012;06;23;Maanantai;8;2;10;0;0;0
96;19.06.2012;2012;06;00;Tiistai;2;3;5;1;2;3
96;19.06.2012;2012;06;01;Tiistai;5;4;9;0;0;0
96;19.06.2012;2012;06;02;Tiistai;1;0;1;0;0;0
96;19.06.2012;2012;06;03;Tiistai;8;3;11;0;0;0
96;19.06.2012;2012;06;04;Tiistai;1;0;1;0;0;0
96;19.06.2012;2012;06;05;Tiistai;9;11;20;1;0;1
96;19.06.2012;2012;06;06;Tiistai;47;46;93;4;2;6
96;19.06.2012;2012;06;07;Tiistai;94;112;206;14;4;18
96;19.06.2012;2012;06;08;Tiistai;56;96;152;3;3;6
96;19.06.2012;2012;06;09;Tiistai;42;76;118;5;9;14
96;19.06.2012;2012;06;10;Tiistai;28;58;86;6;7;13
96;19.06.2012;2012;06;11;Tiistai;54;65;119;4;7;11
96;19.06.2012;2012;06;12;Tiistai;73;61;134;6;8;14
96;19.06.2012;2012;06;13;Tiistai;67;71;138;5;9;14
96;19.06.2012;2012;06;14;Tiistai;80;92;172;9;12;21
96;19.06.2012;2012;06;15;Tiistai;80;170;250;6;19;25
96;19.06.2012;2012;06;16;Tiistai;107;139;246;7;11;18
96;19.06.2012;2012;06;17;Tiistai;99;90;189;7;6;13
96;19.06.2012;2012;06;18;Tiistai;86;63;149;11;11;22
96;19.06.2012;2012;06;19;Tiistai;68;53;121;7;17;24
96;19.06.2012;2012;06;20;Tiistai;49;50;99;13;12;25
96;19.06.2012;2012;06;21;Tiistai;27;41;68;3;4;7
96;19.06.2012;2012;06;22;Tiistai;26;8;34;2;0;2
96;19.06.2012;2012;06;23;Tiistai;7;2;9;0;0;0
96;20.06.2012;2012;06;00;Keskiviikko;5;7;12;0;0;0
96;20.06.2012;2012;06;01;Keskiviikko;4;0;4;0;0;0
96;20.06.2012;2012;06;02;Keskiviikko;5;0;5;0;0;0
96;20.06.2012;2012;06;03;Keskiviikko;0;0;0;0;0;0
96;20.06.2012;2012;06;04;Keskiviikko;1;2;3;0;0;0
96;20.06.2012;2012;06;05;Keskiviikko;10;15;25;1;0;1
96;20.06.2012;2012;06;06;Keskiviikko;42;38;80;4;1;5
96;20.06.2012;2012;06;07;Keskiviikko;90;100;190;13;5;18
96;20.06.2012;2012;06;08;Keskiviikko;61;89;150;4;5;9
96;20.06.2012;2012;06;09;Keskiviikko;38;55;93;3;9;12
96;20.06.2012;2012;06;10;Keskiviikko;20;50;70;3;6;9
96;20.06.2012;2012;06;11;Keskiviikko;46;67;113;3;6;9
96;20.06.2012;2012;06;12;Keskiviikko;69;63;132;10;4;14
96;20.06.2012;2012;06;13;Keskiviikko;69;64;133;6;7;13
96;20.06.2012;2012;06;14;Keskiviikko;72;99;171;4;11;15
96;20.06.2012;2012;06;15;Keskiviikko;77;166;243;5;17;22
96;20.06.2012;2012;06;16;Keskiviikko;93;135;228;7;6;13
96;20.06.2012;2012;06;17;Keskiviikko;92;86;178;6;7;13
96;20.06.2012;2012;06;18;Keskiviikko;73;62;135;10;5;15
96;20.06.2012;2012;06;19;Keskiviikko;57;40;97;11;12;23
96;20.06.2012;2012;06;20;Keskiviikko;57;35;92;6;7;13
96;20.06.2012;2012;06;21;Keskiviikko;23;28;51;2;2;4
96;20.06.2012;2012;06;22;Keskiviikko;12;12;24;0;2;2
96;20.06.2012;2012;06;23;Keskiviikko;4;5;9;1;1;2
96;21.06.2012;2012;06;00;Torstai;2;5;7;2;0;2
96;21.06.2012;2012;06;01;Torstai;4;0;4;0;0;0
96;21.06.2012;2012;06;02;Torstai;3;5;8;0;0;0
96;21.06.2012;2012;06;03;Torstai;2;0;2;0;0;0
96;21.06.2012;2012;06;04;Torstai;1;3;4;0;0;0
96;21.06.2012;2012;06;05;Torstai;6;9;15;1;1;2
96;21.06.2012;2012;06;06;Torstai;38;24;62;4;4;8
96;21.06.2012;2012;06;07;Torstai;72;70;142;12;5;17
96;21.06.2012;2012;06;08;Torstai;48;55;103;3;4;7
96;21.06.2012;2012;06;09;Torstai;29;51;80;5;3;8
96;21.06.2012;2012;06;10;Torstai;24;45;69;2;2;4
96;21.06.2012;2012;06;11;Torstai;43;62;105;7;4;11
96;21.06.2012;2012;06;12;Torstai;51;54;105;7;5;12
96;21.06.2012;2012;06;13;Torstai;69;75;144;8;7;15
96;21.06.2012;2012;06;14;Torstai;64;71;135;4;16;20
96;21.06.2012;2012;06;15;Torstai;78;119;197;9;24;33
96;21.06.2012;2012;06;16;Torstai;61;75;136;6;5;11
96;21.06.2012;2012;06;17;Torstai;68;45;113;11;2;13
96;21.06.2012;2012;06;18;Torstai;41;37;78;11;8;19
96;21.06.2012;2012;06;19;Torstai;34;40;74;1;7;8
96;21.06.2012;2012;06;20;Torstai;44;34;78;8;5;13
96;21.06.2012;2012;06;21;Torstai;22;46;68;6;5;11
96;21.06.2012;2012;06;22;Torstai;4;13;17;0;2;2
96;21.06.2012;2012;06;23;Torstai;6;14;20;0;0;0
96;22.06.2012;2012;06;00;Perjantai;8;9;17;0;0;0
96;22.06.2012;2012;06;01;Perjantai;10;6;16;0;0;0
96;22.06.2012;2012;06;02;Perjantai;3;0;3;3;0;3
96;22.06.2012;2012;06;03;Perjantai;6;1;7;3;0;3
96;22.06.2012;2012;06;04;Perjantai;7;6;13;1;0;1
96;22.06.2012;2012;06;05;Perjantai;9;1;10;0;0;0
96;22.06.2012;2012;06;06;Perjantai;19;11;30;2;0;2
96;22.06.2012;2012;06;07;Perjantai;6;19;25;6;3;9
96;22.06.2012;2012;06;08;Perjantai;14;28;42;1;3;4
96;22.06.2012;2012;06;09;Perjantai;27;33;60;3;4;7
96;22.06.2012;2012;06;10;Perjantai;42;60;102;5;7;12
96;22.06.2012;2012;06;11;Perjantai;51;45;96;6;3;9
96;22.06.2012;2012;06;12;Perjantai;67;18;85;11;7;18
96;22.06.2012;2012;06;13;Perjantai;37;21;58;5;5;10
96;22.06.2012;2012;06;14;Perjantai;44;21;65;5;2;7
96;22.06.2012;2012;06;15;Perjantai;16;42;58;4;5;9
96;22.06.2012;2012;06;16;Perjantai;24;13;37;2;8;10
96;22.06.2012;2012;06;17;Perjantai;22;25;47;13;5;18
96;22.06.2012;2012;06;18;Perjantai;25;31;56;12;5;17
96;22.06.2012;2012;06;19;Perjantai;26;18;44;6;7;13
96;22.06.2012;2012;06;20;Perjantai;20;37;57;1;1;2
96;22.06.2012;2012;06;21;Perjantai;16;40;56;2;4;6
96;22.06.2012;2012;06;22;Perjantai;16;18;34;2;1;3
96;22.06.2012;2012;06;23;Perjantai;11;21;32;0;2;2
96;23.06.2012;2012;06;00;Lauantai;9;14;23;0;2;2
96;23.06.2012;2012;06;01;Lauantai;12;12;24;3;1;4
96;23.06.2012;2012;06;02;Lauantai;20;7;27;0;0;0
96;23.06.2012;2012;06;03;Lauantai;17;0;17;0;0;0
96;23.06.2012;2012;06;04;Lauantai;13;4;17;4;0;4
96;23.06.2012;2012;06;05;Lauantai;14;3;17;0;1;1
96;23.06.2012;2012;06;06;Lauantai;23;5;28;3;2;5
96;23.06.2012;2012;06;07;Lauantai;5;8;13;2;1;3
96;23.06.2012;2012;06;08;Lauantai;10;13;23;1;1;2
96;23.06.2012;2012;06;09;Lauantai;12;13;25;28;8;36
96;23.06.2012;2012;06;10;Lauantai;18;22;40;28;5;33
96;23.06.2012;2012;06;11;Lauantai;20;28;48;20;6;26
96;23.06.2012;2012;06;12;Lauantai;32;38;70;13;7;20
96;23.06.2012;2012;06;13;Lauantai;38;30;68;9;5;14
96;23.06.2012;2012;06;14;Lauantai;24;45;69;6;4;10
96;23.06.2012;2012;06;15;Lauantai;30;56;86;22;13;35
96;23.06.2012;2012;06;16;Lauantai;42;39;81;18;5;23
96;23.06.2012;2012;06;17;Lauantai;39;36;75;18;11;29
96;23.06.2012;2012;06;18;Lauantai;31;43;74;25;9;34
96;23.06.2012;2012;06;19;Lauantai;33;44;77;19;7;26
96;23.06.2012;2012;06;20;Lauantai;26;24;50;3;4;7
96;23.06.2012;2012;06;21;Lauantai;18;23;41;1;4;5
96;23.06.2012;2012;06;22;Lauantai;20;11;31;3;0;3
96;23.06.2012;2012;06;23;Lauantai;7;16;23;1;1;2
96;24.06.2012;2012;06;00;Sunnuntai;4;4;8;0;0;0
96;24.06.2012;2012;06;01;Sunnuntai;6;4;10;0;0;0
96;24.06.2012;2012;06;02;Sunnuntai;11;2;13;0;0;0
96;24.06.2012;2012;06;03;Sunnuntai;7;1;8;0;0;0
96;24.06.2012;2012;06;04;Sunnuntai;7;2;9;1;0;1
96;24.06.2012;2012;06;05;Sunnuntai;8;3;11;0;0;0
96;24.06.2012;2012;06;06;Sunnuntai;18;10;28;3;0;3
96;24.06.2012;2012;06;07;Sunnuntai;4;13;17;2;2;4
96;24.06.2012;2012;06;08;Sunnuntai;5;6;11;4;2;6
96;24.06.2012;2012;06;09;Sunnuntai;10;13;23;12;7;19
96;24.06.2012;2012;06;10;Sunnuntai;15;14;29;7;9;16
96;24.06.2012;2012;06;11;Sunnuntai;27;43;70;9;8;17
96;24.06.2012;2012;06;12;Sunnuntai;28;58;86;13;11;24
96;24.06.2012;2012;06;13;Sunnuntai;54;61;115;6;10;16
96;24.06.2012;2012;06;14;Sunnuntai;42;35;77;4;7;11
96;24.06.2012;2012;06;15;Sunnuntai;49;50;99;7;12;19
96;24.06.2012;2012;06;16;Sunnuntai;43;53;96;14;6;20
96;24.06.2012;2012;06;17;Sunnuntai;62;27;89;12;9;21
96;24.06.2012;2012;06;18;Sunnuntai;59;41;100;3;9;12
96;24.06.2012;2012;06;19;Sunnuntai;34;32;66;7;16;23
96;24.06.2012;2012;06;20;Sunnuntai;25;36;61;7;10;17
96;24.06.2012;2012;06;21;Sunnuntai;25;41;66;7;8;15
96;24.06.2012;2012;06;22;Sunnuntai;8;10;18;2;5;7
96;24.06.2012;2012;06;23;Sunnuntai;3;8;11;2;1;3
96;25.06.2012;2012;06;00;Maanantai;4;7;11;0;0;0
96;25.06.2012;2012;06;01;Maanantai;4;4;8;0;0;0
96;25.06.2012;2012;06;02;Maanantai;5;1;6;0;3;3
96;25.06.2012;2012;06;03;Maanantai;2;1;3;0;0;0
96;25.06.2012;2012;06;04;Maanantai;5;3;8;1;0;1
96;25.06.2012;2012;06;05;Maanantai;13;8;21;1;0;1
96;25.06.2012;2012;06;06;Maanantai;41;37;78;2;2;4
96;25.06.2012;2012;06;07;Maanantai;77;84;161;5;2;7
96;25.06.2012;2012;06;08;Maanantai;42;77;119;3;2;5
96;25.06.2012;2012;06;09;Maanantai;33;66;99;7;4;11
96;25.06.2012;2012;06;10;Maanantai;18;57;75;8;7;15
96;25.06.2012;2012;06;11;Maanantai;45;48;93;2;7;9
96;25.06.2012;2012;06;12;Maanantai;50;52;102;5;11;16
96;25.06.2012;2012;06;13;Maanantai;42;71;113;5;10;15
96;25.06.2012;2012;06;14;Maanantai;69;78;147;4;7;11
96;25.06.2012;2012;06;15;Maanantai;75;173;248;11;17;28
96;25.06.2012;2012;06;16;Maanantai;96;138;234;7;6;13
96;25.06.2012;2012;06;17;Maanantai;60;72;132;3;10;13
96;25.06.2012;2012;06;18;Maanantai;65;55;120;7;4;11
96;25.06.2012;2012;06;19;Maanantai;57;35;92;11;11;22
96;25.06.2012;2012;06;20;Maanantai;54;24;78;13;7;20
96;25.06.2012;2012;06;21;Maanantai;28;36;64;9;8;17
96;25.06.2012;2012;06;22;Maanantai;9;14;23;4;4;8
96;25.06.2012;2012;06;23;Maanantai;12;1;13;1;1;2
96;26.06.2012;2012;06;00;Tiistai;3;1;4;0;1;1
96;26.06.2012;2012;06;01;Tiistai;0;0;0;0;0;0
96;26.06.2012;2012;06;02;Tiistai;3;1;4;0;0;0
96;26.06.2012;2012;06;03;Tiistai;0;1;1;0;0;0
96;26.06.2012;2012;06;04;Tiistai;3;1;4;1;0;1
96;26.06.2012;2012;06;05;Tiistai;11;10;21;0;0;0
96;26.06.2012;2012;06;06;Tiistai;49;35;84;2;4;6
96;26.06.2012;2012;06;07;Tiistai;67;91;158;5;7;12
96;26.06.2012;2012;06;08;Tiistai;47;67;114;3;10;13
96;26.06.2012;2012;06;09;Tiistai;25;60;85;1;3;4
96;26.06.2012;2012;06;10;Tiistai;21;36;57;5;7;12
96;26.06.2012;2012;06;11;Tiistai;29;41;70;3;9;12
96;26.06.2012;2012;06;12;Tiistai;36;41;77;5;6;11
96;26.06.2012;2012;06;13;Tiistai;45;58;103;4;5;9
96;26.06.2012;2012;06;14;Tiistai;41;104;145;3;15;18
96;26.06.2012;2012;06;15;Tiistai;72;149;221;6;15;21
96;26.06.2012;2012;06;16;Tiistai;91;122;213;5;13;18
96;26.06.2012;2012;06;17;Tiistai;64;66;130;8;9;17
96;26.06.2012;2012;06;18;Tiistai;57;34;91;9;6;15
96;26.06.2012;2012;06;19;Tiistai;50;32;82;6;7;13
96;26.06.2012;2012;06;20;Tiistai;45;24;69;5;7;12
96;26.06.2012;2012;06;21;Tiistai;21;41;62;1;8;9
96;26.06.2012;2012;06;22;Tiistai;18;14;32;2;2;4
96;26.06.2012;2012;06;23;Tiistai;13;3;16;0;0;0
96;27.06.2012;2012;06;00;Keskiviikko;5;3;8;3;2;5
96;27.06.2012;2012;06;01;Keskiviikko;5;1;6;0;0;0
96;27.06.2012;2012;06;02;Keskiviikko;2;2;4;0;0;0
96;27.06.2012;2012;06;03;Keskiviikko;1;0;1;0;0;0
96;27.06.2012;2012;06;04;Keskiviikko;1;0;1;0;0;0
96;27.06.2012;2012;06;05;Keskiviikko;11;10;21;1;0;1
96;27.06.2012;2012;06;06;Keskiviikko;48;35;83;3;2;5
96;27.06.2012;2012;06;07;Keskiviikko;70;86;156;7;3;10
96;27.06.2012;2012;06;08;Keskiviikko;36;69;105;6;7;13
96;27.06.2012;2012;06;09;Keskiviikko;29;52;81;6;9;15
96;27.06.2012;2012;06;10;Keskiviikko;24;52;76;1;10;11
96;27.06.2012;2012;06;11;Keskiviikko;37;39;76;3;5;8
96;27.06.2012;2012;06;12;Keskiviikko;45;63;108;4;5;9
96;27.06.2012;2012;06;13;Keskiviikko;55;59;114;5;6;11
96;27.06.2012;2012;06;14;Keskiviikko;68;89;157;3;10;13
96;27.06.2012;2012;06;15;Keskiviikko;71;143;214;4;15;19
96;27.06.2012;2012;06;16;Keskiviikko;85;96;181;4;8;12
96;27.06.2012;2012;06;17;Keskiviikko;58;39;97;1;4;5
96;27.06.2012;2012;06;18;Keskiviikko;43;24;67;1;4;5
96;27.06.2012;2012;06;19;Keskiviikko;27;20;47;3;5;8
96;27.06.2012;2012;06;20;Keskiviikko;38;20;58;9;3;12
96;27.06.2012;2012;06;21;Keskiviikko;20;27;47;1;8;9
96;27.06.2012;2012;06;22;Keskiviikko;7;6;13;2;3;5
96;27.06.2012;2012;06;23;Keskiviikko;2;1;3;0;1;1
96;28.06.2012;2012;06;00;Torstai;3;5;8;0;1;1
96;28.06.2012;2012;06;01;Torstai;0;0;0;1;1;2
96;28.06.2012;2012;06;02;Torstai;4;0;4;1;1;2
96;28.06.2012;2012;06;03;Torstai;3;0;3;0;0;0
96;28.06.2012;2012;06;04;Torstai;2;1;3;0;0;0
96;28.06.2012;2012;06;05;Torstai;9;12;21;1;0;1
96;28.06.2012;2012;06;06;Torstai;45;34;79;2;3;5
96;28.06.2012;2012;06;07;Torstai;79;72;151;9;1;10
96;28.06.2012;2012;06;08;Torstai;42;53;95;6;3;9
96;28.06.2012;2012;06;09;Torstai;37;53;90;2;3;5
96;28.06.2012;2012;06;10;Torstai;19;44;63;4;8;12
96;28.06.2012;2012;06;11;Torstai;38;54;92;6;4;10
96;28.06.2012;2012;06;12;Torstai;45;47;92;10;5;15
96;28.06.2012;2012;06;13;Torstai;43;41;84;9;6;15
96;28.06.2012;2012;06;14;Torstai;52;73;125;1;10;11
96;28.06.2012;2012;06;15;Torstai;66;125;191;3;10;13
96;28.06.2012;2012;06;16;Torstai;94;84;178;2;5;7
96;28.06.2012;2012;06;17;Torstai;77;62;139;9;5;14
96;28.06.2012;2012;06;18;Torstai;55;29;84;10;7;17
96;28.06.2012;2012;06;19;Torstai;46;40;86;8;5;13
96;28.06.2012;2012;06;20;Torstai;39;34;73;8;11;19
96;28.06.2012;2012;06;21;Torstai;26;40;66;6;15;21
96;28.06.2012;2012;06;22;Torstai;6;12;18;3;1;4
96;28.06.2012;2012;06;23;Torstai;6;5;11;2;1;3
96;29.06.2012;2012;06;00;Perjantai;8;8;16;0;1;1
96;29.06.2012;2012;06;01;Perjantai;6;0;6;0;0;0
96;29.06.2012;2012;06;02;Perjantai;5;1;6;1;0;1
96;29.06.2012;2012;06;03;Perjantai;3;3;6;0;0;0
96;29.06.2012;2012;06;04;Perjantai;3;2;5;0;0;0
96;29.06.2012;2012;06;05;Perjantai;11;6;17;2;0;2
96;29.06.2012;2012;06;06;Perjantai;50;31;81;2;3;5
96;29.06.2012;2012;06;07;Perjantai;72;77;149;4;0;4
96;29.06.2012;2012;06;08;Perjantai;38;68;106;6;2;8
96;29.06.2012;2012;06;09;Perjantai;29;54;83;3;4;7
96;29.06.2012;2012;06;10;Perjantai;24;52;76;3;5;8
96;29.06.2012;2012;06;11;Perjantai;36;64;100;4;7;11
96;29.06.2012;2012;06;12;Perjantai;61;72;133;3;6;9
96;29.06.2012;2012;06;13;Perjantai;55;77;132;6;9;15
96;29.06.2012;2012;06;14;Perjantai;49;109;158;6;20;26
96;29.06.2012;2012;06;15;Perjantai;87;128;215;8;10;18
96;29.06.2012;2012;06;16;Perjantai;78;71;149;6;8;14
96;29.06.2012;2012;06;17;Perjantai;70;38;108;15;6;21
96;29.06.2012;2012;06;18;Perjantai;54;46;100;11;9;20
96;29.06.2012;2012;06;19;Perjantai;54;29;83;2;10;12
96;29.06.2012;2012;06;20;Perjantai;45;37;82;6;5;11
96;29.06.2012;2012;06;21;Perjantai;27;51;78;4;5;9
96;29.06.2012;2012;06;22;Perjantai;16;26;42;2;4;6
96;29.06.2012;2012;06;23;Perjantai;24;24;48;2;1;3
96;30.06.2012;2012;06;00;Lauantai;18;6;24;1;1;2
96;30.06.2012;2012;06;01;Lauantai;9;4;13;1;0;1
96;30.06.2012;2012;06;02;Lauantai;16;1;17;1;1;2
96;30.06.2012;2012;06;03;Lauantai;19;0;19;1;0;1
96;30.06.2012;2012;06;04;Lauantai;8;0;8;4;0;4
96;30.06.2012;2012;06;05;Lauantai;6;4;10;1;0;1
96;30.06.2012;2012;06;06;Lauantai;24;7;31;4;0;4
96;30.06.2012;2012;06;07;Lauantai;6;24;30;1;0;1
96;30.06.2012;2012;06;08;Lauantai;8;13;21;1;4;5
96;30.06.2012;2012;06;09;Lauantai;12;39;51;7;6;13
96;30.06.2012;2012;06;10;Lauantai;10;30;40;2;3;5
96;30.06.2012;2012;06;11;Lauantai;22;33;55;3;3;6
96;30.06.2012;2012;06;12;Lauantai;23;47;70;3;4;7
96;30.06.2012;2012;06;13;Lauantai;42;35;77;2;4;6
96;30.06.2012;2012;06;14;Lauantai;29;43;72;21;8;29
96;30.06.2012;2012;06;15;Lauantai;31;47;78;2;7;9
96;30.06.2012;2012;06;16;Lauantai;27;36;63;6;6;12
96;30.06.2012;2012;06;17;Lauantai;25;20;45;8;7;15
96;30.06.2012;2012;06;18;Lauantai;27;25;52;2;7;9
96;30.06.2012;2012;06;19;Lauantai;14;13;27;4;3;7
96;30.06.2012;2012;06;20;Lauantai;22;11;33;3;2;5
96;30.06.2012;2012;06;21;Lauantai;12;28;40;3;0;3
96;30.06.2012;2012;06;22;Lauantai;9;8;17;0;2;2
96;30.06.2012;2012;06;23;Lauantai;4;5;9;1;0;1
96;01.07.2012;2012;07;00;Sunnuntai;7;4;11;1;2;3
96;01.07.2012;2012;07;01;Sunnuntai;4;1;5;1;0;1
96;01.07.2012;2012;07;02;Sunnuntai;6;2;8;0;2;2
96;01.07.2012;2012;07;03;Sunnuntai;6;0;6;1;1;2
96;01.07.2012;2012;07;04;Sunnuntai;13;1;14;1;0;1
96;01.07.2012;2012;07;05;Sunnuntai;2;1;3;1;0;1
96;01.07.2012;2012;07;06;Sunnuntai;14;5;19;5;0;5
96;01.07.2012;2012;07;07;Sunnuntai;3;9;12;1;2;3
96;01.07.2012;2012;07;08;Sunnuntai;3;4;7;0;3;3
96;01.07.2012;2012;07;09;Sunnuntai;3;11;14;0;1;1
96;01.07.2012;2012;07;10;Sunnuntai;15;14;29;5;3;8
96;01.07.2012;2012;07;11;Sunnuntai;12;25;37;4;7;11
96;01.07.2012;2012;07;12;Sunnuntai;28;30;58;8;8;16
96;01.07.2012;2012;07;13;Sunnuntai;35;48;83;7;7;14
96;01.07.2012;2012;07;14;Sunnuntai;45;44;89;9;9;18
96;01.07.2012;2012;07;15;Sunnuntai;35;31;66;7;9;16
96;01.07.2012;2012;07;16;Sunnuntai;21;20;41;2;3;5
96;01.07.2012;2012;07;17;Sunnuntai;43;43;86;10;6;16
96;01.07.2012;2012;07;18;Sunnuntai;29;39;68;5;11;16
96;01.07.2012;2012;07;19;Sunnuntai;24;47;71;5;8;13
96;01.07.2012;2012;07;20;Sunnuntai;38;30;68;10;7;17
96;01.07.2012;2012;07;21;Sunnuntai;11;26;37;2;3;5
96;01.07.2012;2012;07;22;Sunnuntai;14;5;19;1;0;1
96;01.07.2012;2012;07;23;Sunnuntai;36;5;41;1;0;1
96;02.07.2012;2012;07;00;Maanantai;7;9;16;0;1;1
96;02.07.2012;2012;07;01;Maanantai;7;2;9;1;0;1
96;02.07.2012;2012;07;02;Maanantai;3;0;3;0;0;0
96;02.07.2012;2012;07;03;Maanantai;2;3;5;1;0;1
96;02.07.2012;2012;07;04;Maanantai;5;1;6;0;0;0
96;02.07.2012;2012;07;05;Maanantai;6;5;11;1;0;1
96;02.07.2012;2012;07;06;Maanantai;28;18;46;2;1;3
96;02.07.2012;2012;07;07;Maanantai;55;62;117;6;9;15
96;02.07.2012;2012;07;08;Maanantai;45;39;84;3;7;10
96;02.07.2012;2012;07;09;Maanantai;25;41;66;5;9;14
96;02.07.2012;2012;07;10;Maanantai;25;51;76;0;5;5
96;02.07.2012;2012;07;11;Maanantai;47;65;112;12;7;19
96;02.07.2012;2012;07;12;Maanantai;65;74;139;6;7;13
96;02.07.2012;2012;07;13;Maanantai;69;70;139;6;14;20
96;02.07.2012;2012;07;14;Maanantai;59;84;143;6;11;17
96;02.07.2012;2012;07;15;Maanantai;98;101;199;16;12;28
96;02.07.2012;2012;07;16;Maanantai;89;87;176;11;17;28
96;02.07.2012;2012;07;17;Maanantai;81;81;162;20;9;29
96;02.07.2012;2012;07;18;Maanantai;66;55;121;12;10;22
96;02.07.2012;2012;07;19;Maanantai;48;51;99;7;9;16
96;02.07.2012;2012;07;20;Maanantai;70;52;122;9;7;16
96;02.07.2012;2012;07;21;Maanantai;47;38;85;6;7;13
96;02.07.2012;2012;07;22;Maanantai;14;13;27;3;4;7
96;02.07.2012;2012;07;23;Maanantai;4;17;21;1;3;4
96;03.07.2012;2012;07;00;Tiistai;8;2;10;0;1;1
96;03.07.2012;2012;07;01;Tiistai;3;3;6;0;1;1
96;03.07.2012;2012;07;02;Tiistai;6;3;9;0;0;0
96;03.07.2012;2012;07;03;Tiistai;0;1;1;0;0;0
96;03.07.2012;2012;07;04;Tiistai;0;3;3;0;0;0
96;03.07.2012;2012;07;05;Tiistai;8;13;21;0;1;1
96;03.07.2012;2012;07;06;Tiistai;46;27;73;1;1;2
96;03.07.2012;2012;07;07;Tiistai;77;77;154;9;7;16
96;03.07.2012;2012;07;08;Tiistai;50;78;128;8;6;14
96;03.07.2012;2012;07;09;Tiistai;31;67;98;4;4;8
96;03.07.2012;2012;07;10;Tiistai;26;50;76;6;5;11
96;03.07.2012;2012;07;11;Tiistai;41;75;116;5;14;19
96;03.07.2012;2012;07;12;Tiistai;71;71;142;15;5;20
96;03.07.2012;2012;07;13;Tiistai;59;68;127;3;2;5
96;03.07.2012;2012;07;14;Tiistai;79;88;167;10;5;15
96;03.07.2012;2012;07;15;Tiistai;98;168;266;10;21;31
96;03.07.2012;2012;07;16;Tiistai;100;121;221;9;10;19
96;03.07.2012;2012;07;17;Tiistai;112;83;195;9;11;20
96;03.07.2012;2012;07;18;Tiistai;82;68;150;13;7;20
96;03.07.2012;2012;07;19;Tiistai;75;69;144;12;11;23
96;03.07.2012;2012;07;20;Tiistai;80;69;149;7;13;20
96;03.07.2012;2012;07;21;Tiistai;33;43;76;6;2;8
96;03.07.2012;2012;07;22;Tiistai;12;12;24;5;7;12
96;03.07.2012;2012;07;23;Tiistai;13;10;23;0;0;0
96;04.07.2012;2012;07;00;Keskiviikko;7;3;10;0;1;1
96;04.07.2012;2012;07;01;Keskiviikko;8;0;8;1;0;1
96;04.07.2012;2012;07;02;Keskiviikko;3;1;4;0;1;1
96;04.07.2012;2012;07;03;Keskiviikko;4;1;5;0;0;0
96;04.07.2012;2012;07;04;Keskiviikko;1;4;5;0;0;0
96;04.07.2012;2012;07;05;Keskiviikko;7;10;17;0;1;1
96;04.07.2012;2012;07;06;Keskiviikko;48;34;82;2;5;7
96;04.07.2012;2012;07;07;Keskiviikko;79;91;170;3;1;4
96;04.07.2012;2012;07;08;Keskiviikko;54;75;129;2;9;11
96;04.07.2012;2012;07;09;Keskiviikko;36;71;107;8;5;13
96;04.07.2012;2012;07;10;Keskiviikko;33;60;93;7;5;12
96;04.07.2012;2012;07;11;Keskiviikko;53;71;124;10;11;21
96;04.07.2012;2012;07;12;Keskiviikko;71;76;147;8;10;18
96;04.07.2012;2012;07;13;Keskiviikko;63;65;128;6;5;11
96;04.07.2012;2012;07;14;Keskiviikko;81;73;154;6;14;20
96;04.07.2012;2012;07;15;Keskiviikko;87;146;233;5;27;32
96;04.07.2012;2012;07;16;Keskiviikko;130;97;227;5;15;20
96;04.07.2012;2012;07;17;Keskiviikko;95;118;213;3;16;19
96;04.07.2012;2012;07;18;Keskiviikko;102;90;192;6;4;10
96;04.07.2012;2012;07;19;Keskiviikko;68;56;124;12;16;28
96;04.07.2012;2012;07;20;Keskiviikko;93;62;155;7;11;18
96;04.07.2012;2012;07;21;Keskiviikko;50;52;102;6;4;10
96;04.07.2012;2012;07;22;Keskiviikko;32;21;53;1;0;1
96;04.07.2012;2012;07;23;Keskiviikko;17;4;21;1;1;2
96;05.07.2012;2012;07;00;Torstai;10;9;19;1;0;1
96;05.07.2012;2012;07;01;Torstai;13;0;13;0;1;1
96;05.07.2012;2012;07;02;Torstai;6;2;8;0;0;0
96;05.07.2012;2012;07;03;Torstai;10;0;10;1;1;2
96;05.07.2012;2012;07;04;Torstai;3;1;4;1;0;1
96;05.07.2012;2012;07;05;Torstai;12;10;22;0;0;0
96;05.07.2012;2012;07;06;Torstai;44;37;81;4;3;7
96;05.07.2012;2012;07;07;Torstai;72;64;136;6;1;7
96;05.07.2012;2012;07;08;Torstai;44;59;103;2;3;5
96;05.07.2012;2012;07;09;Torstai;24;55;79;0;1;1
96;05.07.2012;2012;07;10;Torstai;19;62;81;3;3;6
96;05.07.2012;2012;07;11;Torstai;38;77;115;4;11;15
96;05.07.2012;2012;07;12;Torstai;73;77;150;6;12;18
96;05.07.2012;2012;07;13;Torstai;60;85;145;6;10;16
96;05.07.2012;2012;07;14;Torstai;91;91;182;12;12;24
96;05.07.2012;2012;07;15;Torstai;97;151;248;9;18;27
96;05.07.2012;2012;07;16;Torstai;103;102;205;6;23;29
96;05.07.2012;2012;07;17;Torstai;84;88;172;16;8;24
96;05.07.2012;2012;07;18;Torstai;92;71;163;7;8;15
96;05.07.2012;2012;07;19;Torstai;96;60;156;4;6;10
96;05.07.2012;2012;07;20;Torstai;77;40;117;5;4;9
96;05.07.2012;2012;07;21;Torstai;48;48;96;8;8;16
96;05.07.2012;2012;07;22;Torstai;28;23;51;1;5;6
96;05.07.2012;2012;07;23;Torstai;23;9;32;2;0;2
96;06.07.2012;2012;07;00;Perjantai;15;6;21;1;0;1
96;06.07.2012;2012;07;01;Perjantai;16;2;18;3;0;3
96;06.07.2012;2012;07;02;Perjantai;14;0;14;0;0;0
96;06.07.2012;2012;07;03;Perjantai;10;1;11;0;0;0
96;06.07.2012;2012;07;04;Perjantai;5;2;7;0;0;0
96;06.07.2012;2012;07;05;Perjantai;8;11;19;0;0;0
96;06.07.2012;2012;07;06;Perjantai;47;39;86;1;2;3
96;06.07.2012;2012;07;07;Perjantai;65;64;129;6;2;8
96;06.07.2012;2012;07;08;Perjantai;46;57;103;5;3;8
96;06.07.2012;2012;07;09;Perjantai;32;63;95;2;6;8
96;06.07.2012;2012;07;10;Perjantai;28;62;90;3;10;13
96;06.07.2012;2012;07;11;Perjantai;59;77;136;5;11;16
96;06.07.2012;2012;07;12;Perjantai;70;68;138;7;4;11
96;06.07.2012;2012;07;13;Perjantai;75;98;173;4;7;11
96;06.07.2012;2012;07;14;Perjantai;93;93;186;4;14;18
96;06.07.2012;2012;07;15;Perjantai;110;130;240;6;13;19
96;06.07.2012;2012;07;16;Perjantai;95;79;174;8;10;18
96;06.07.2012;2012;07;17;Perjantai;76;64;140;6;6;12
96;06.07.2012;2012;07;18;Perjantai;99;58;157;6;4;10
96;06.07.2012;2012;07;19;Perjantai;74;60;134;4;6;10
96;06.07.2012;2012;07;20;Perjantai;60;55;115;7;4;11
96;06.07.2012;2012;07;21;Perjantai;46;59;105;5;6;11
96;06.07.2012;2012;07;22;Perjantai;35;34;69;3;5;8
96;06.07.2012;2012;07;23;Perjantai;26;17;43;3;1;4
96;07.07.2012;2012;07;00;Lauantai;23;6;29;1;1;2
96;07.07.2012;2012;07;01;Lauantai;27;1;28;0;0;0
96;07.07.2012;2012;07;02;Lauantai;29;0;29;1;0;1
96;07.07.2012;2012;07;03;Lauantai;23;5;28;1;0;1
96;07.07.2012;2012;07;04;Lauantai;35;1;36;1;0;1
96;07.07.2012;2012;07;05;Lauantai;4;7;11;0;0;0
96;07.07.2012;2012;07;06;Lauantai;15;12;27;7;0;7
96;07.07.2012;2012;07;07;Lauantai;10;17;27;0;1;1
96;07.07.2012;2012;07;08;Lauantai;12;16;28;0;2;2
96;07.07.2012;2012;07;09;Lauantai;15;41;56;1;3;4
96;07.07.2012;2012;07;10;Lauantai;31;69;100;2;3;5
96;07.07.2012;2012;07;11;Lauantai;55;77;132;6;13;19
96;07.07.2012;2012;07;12;Lauantai;72;63;135;4;5;9
96;07.07.2012;2012;07;13;Lauantai;85;78;163;5;3;8
96;07.07.2012;2012;07;14;Lauantai;73;65;138;3;2;5
96;07.07.2012;2012;07;15;Lauantai;76;59;135;7;7;14
96;07.07.2012;2012;07;16;Lauantai;61;64;125;4;5;9
96;07.07.2012;2012;07;17;Lauantai;63;57;120;5;12;17
96;07.07.2012;2012;07;18;Lauantai;48;34;82;8;3;11
96;07.07.2012;2012;07;19;Lauantai;61;44;105;4;5;9
96;07.07.2012;2012;07;20;Lauantai;30;52;82;1;1;2
96;07.07.2012;2012;07;21;Lauantai;19;40;59;4;2;6
96;07.07.2012;2012;07;22;Lauantai;12;27;39;2;1;3
96;07.07.2012;2012;07;23;Lauantai;18;18;36;0;0;0
96;08.07.2012;2012;07;00;Sunnuntai;24;19;43;0;1;1
96;08.07.2012;2012;07;01;Sunnuntai;17;5;22;1;0;1
96;08.07.2012;2012;07;02;Sunnuntai;34;10;44;1;0;1
96;08.07.2012;2012;07;03;Sunnuntai;21;2;23;3;0;3
96;08.07.2012;2012;07;04;Sunnuntai;26;2;28;2;0;2
96;08.07.2012;2012;07;05;Sunnuntai;10;2;12;0;0;0
96;08.07.2012;2012;07;06;Sunnuntai;13;8;21;1;0;1
96;08.07.2012;2012;07;07;Sunnuntai;1;5;6;0;3;3
96;08.07.2012;2012;07;08;Sunnuntai;2;3;5;2;1;3
96;08.07.2012;2012;07;09;Sunnuntai;6;1;7;0;0;0
96;08.07.2012;2012;07;10;Sunnuntai;4;8;12;1;1;2
96;08.07.2012;2012;07;11;Sunnuntai;12;23;35;2;2;4
96;08.07.2012;2012;07;12;Sunnuntai;18;52;70;5;8;13
96;08.07.2012;2012;07;13;Sunnuntai;45;46;91;4;12;16
96;08.07.2012;2012;07;14;Sunnuntai;39;46;85;5;4;9
96;08.07.2012;2012;07;15;Sunnuntai;52;52;104;1;8;9
96;08.07.2012;2012;07;16;Sunnuntai;44;46;90;5;6;11
96;08.07.2012;2012;07;17;Sunnuntai;39;32;71;10;4;14
96;08.07.2012;2012;07;18;Sunnuntai;42;29;71;7;7;14
96;08.07.2012;2012;07;19;Sunnuntai;55;28;83;9;17;26
96;08.07.2012;2012;07;20;Sunnuntai;28;35;63;6;7;13
96;08.07.2012;2012;07;21;Sunnuntai;18;33;51;7;7;14
96;08.07.2012;2012;07;22;Sunnuntai;16;10;26;4;0;4
96;08.07.2012;2012;07;23;Sunnuntai;4;10;14;0;2;2
96;09.07.2012;2012;07;00;Maanantai;6;2;8;2;2;4
96;09.07.2012;2012;07;01;Maanantai;1;1;2;2;1;3
96;09.07.2012;2012;07;02;Maanantai;3;1;4;1;2;3
96;09.07.2012;2012;07;03;Maanantai;4;1;5;0;0;0
96;09.07.2012;2012;07;04;Maanantai;0;2;2;0;1;1
96;09.07.2012;2012;07;05;Maanantai;8;10;18;0;0;0
96;09.07.2012;2012;07;06;Maanantai;34;34;68;4;2;6
96;09.07.2012;2012;07;07;Maanantai;56;47;103;8;4;12
96;09.07.2012;2012;07;08;Maanantai;34;37;71;2;4;6
96;09.07.2012;2012;07;09;Maanantai;20;44;64;2;5;7
96;09.07.2012;2012;07;10;Maanantai;21;59;80;4;7;11
96;09.07.2012;2012;07;11;Maanantai;24;42;66;4;7;11
96;09.07.2012;2012;07;12;Maanantai;56;53;109;11;9;20
96;09.07.2012;2012;07;13;Maanantai;63;82;145;8;12;20
96;09.07.2012;2012;07;14;Maanantai;55;89;144;4;13;17
96;09.07.2012;2012;07;15;Maanantai;95;131;226;9;12;21
96;09.07.2012;2012;07;16;Maanantai;78;100;178;6;9;15
96;09.07.2012;2012;07;17;Maanantai;73;69;142;13;12;25
96;09.07.2012;2012;07;18;Maanantai;74;70;144;19;16;35
96;09.07.2012;2012;07;19;Maanantai;68;63;131;16;8;24
96;09.07.2012;2012;07;20;Maanantai;61;53;114;12;5;17
96;09.07.2012;2012;07;21;Maanantai;39;47;86;6;6;12
96;09.07.2012;2012;07;22;Maanantai;25;20;45;4;5;9
96;09.07.2012;2012;07;23;Maanantai;11;7;18;1;2;3
96;10.07.2012;2012;07;00;Tiistai;4;7;11;0;0;0
96;10.07.2012;2012;07;01;Tiistai;2;3;5;0;0;0
96;10.07.2012;2012;07;02;Tiistai;4;1;5;0;0;0
96;10.07.2012;2012;07;03;Tiistai;2;0;2;0;0;0
96;10.07.2012;2012;07;04;Tiistai;2;0;2;0;0;0
96;10.07.2012;2012;07;05;Tiistai;8;11;19;1;0;1
96;10.07.2012;2012;07;06;Tiistai;45;34;79;5;2;7
96;10.07.2012;2012;07;07;Tiistai;77;54;131;5;2;7
96;10.07.2012;2012;07;08;Tiistai;42;66;108;2;4;6
96;10.07.2012;2012;07;09;Tiistai;29;68;97;0;6;6
96;10.07.2012;2012;07;10;Tiistai;26;57;83;9;10;19
96;10.07.2012;2012;07;11;Tiistai;30;53;83;4;8;12
96;10.07.2012;2012;07;12;Tiistai;41;67;108;1;10;11
96;10.07.2012;2012;07;13;Tiistai;64;59;123;6;8;14
96;10.07.2012;2012;07;14;Tiistai;57;111;168;7;6;13
96;10.07.2012;2012;07;15;Tiistai;64;137;201;5;9;14
96;10.07.2012;2012;07;16;Tiistai;76;90;166;7;4;11
96;10.07.2012;2012;07;17;Tiistai;58;52;110;8;6;14
96;10.07.2012;2012;07;18;Tiistai;39;43;82;6;9;15
96;10.07.2012;2012;07;19;Tiistai;49;30;79;9;11;20
96;10.07.2012;2012;07;20;Tiistai;37;28;65;7;11;18
96;10.07.2012;2012;07;21;Tiistai;19;32;51;3;6;9
96;10.07.2012;2012;07;22;Tiistai;6;10;16;2;3;5
96;10.07.2012;2012;07;23;Tiistai;8;4;12;1;1;2
96;11.07.2012;2012;07;00;Keskiviikko;7;3;10;0;1;1
96;11.07.2012;2012;07;01;Keskiviikko;8;0;8;1;0;1
96;11.07.2012;2012;07;02;Keskiviikko;3;1;4;0;1;1
96;11.07.2012;2012;07;03;Keskiviikko;4;1;5;0;0;0
96;11.07.2012;2012;07;04;Keskiviikko;1;4;5;0;0;0
96;11.07.2012;2012;07;05;Keskiviikko;7;10;17;0;1;1
96;11.07.2012;2012;07;06;Keskiviikko;48;34;82;2;5;7
96;11.07.2012;2012;07;07;Keskiviikko;79;91;170;3;1;4
96;11.07.2012;2012;07;08;Keskiviikko;54;75;129;2;9;11
96;11.07.2012;2012;07;09;Keskiviikko;36;71;107;8;5;13
96;11.07.2012;2012;07;10;Keskiviikko;33;60;93;7;5;12
96;11.07.2012;2012;07;11;Keskiviikko;53;71;124;10;11;21
96;11.07.2012;2012;07;12;Keskiviikko;71;76;147;8;10;18
96;11.07.2012;2012;07;13;Keskiviikko;63;65;128;6;5;11
96;11.07.2012;2012;07;14;Keskiviikko;81;73;154;6;14;20
96;11.07.2012;2012;07;15;Keskiviikko;87;146;233;5;27;32
96;11.07.2012;2012;07;16;Keskiviikko;130;97;227;5;15;20
96;11.07.2012;2012;07;17;Keskiviikko;95;118;213;3;16;19
96;11.07.2012;2012;07;18;Keskiviikko;102;90;192;6;4;10
96;11.07.2012;2012;07;19;Keskiviikko;68;56;124;12;16;28
96;11.07.2012;2012;07;20;Keskiviikko;93;62;155;7;11;18
96;11.07.2012;2012;07;21;Keskiviikko;50;52;102;6;4;10
96;11.07.2012;2012;07;22;Keskiviikko;32;21;53;1;0;1
96;11.07.2012;2012;07;23;Keskiviikko;17;4;21;1;1;2
96;12.07.2012;2012;07;00;Torstai;0;0;0;0;0;0
96;12.07.2012;2012;07;01;Torstai;0;0;0;0;0;0
96;12.07.2012;2012;07;02;Torstai;0;0;0;0;0;0
96;12.07.2012;2012;07;03;Torstai;0;0;0;0;0;0
96;12.07.2012;2012;07;04;Torstai;0;0;0;0;0;0
96;12.07.2012;2012;07;05;Torstai;11;11;22;0;0;0
96;12.07.2012;2012;07;06;Torstai;41;38;79;1;1;2
96;12.07.2012;2012;07;07;Torstai;71;65;136;7;0;7
96;12.07.2012;2012;07;08;Torstai;33;54;87;1;2;3
96;12.07.2012;2012;07;09;Torstai;28;60;88;4;3;7
96;12.07.2012;2012;07;10;Torstai;20;56;76;1;5;6
96;12.07.2012;2012;07;11;Torstai;30;45;75;4;4;8
96;12.07.2012;2012;07;12;Torstai;51;39;90;6;6;12
96;12.07.2012;2012;07;13;Torstai;42;62;104;2;7;9
96;12.07.2012;2012;07;14;Torstai;46;77;123;3;11;14
96;12.07.2012;2012;07;15;Torstai;68;137;205;5;7;12
96;12.07.2012;2012;07;16;Torstai;80;80;160;9;7;16
96;12.07.2012;2012;07;17;Torstai;69;105;174;4;12;16
96;12.07.2012;2012;07;18;Torstai;74;74;148;9;11;20
96;12.07.2012;2012;07;19;Torstai;56;51;107;6;10;16
96;12.07.2012;2012;07;20;Torstai;91;50;141;10;4;14
96;12.07.2012;2012;07;21;Torstai;30;34;64;5;7;12
96;12.07.2012;2012;07;22;Torstai;13;18;31;4;7;11
96;12.07.2012;2012;07;23;Torstai;12;4;16;1;4;5
96;13.07.2012;2012;07;00;Perjantai;17;5;22;2;0;2
96;13.07.2012;2012;07;01;Perjantai;6;3;9;2;0;2
96;13.07.2012;2012;07;02;Perjantai;7;2;9;0;0;0
96;13.07.2012;2012;07;03;Perjantai;1;1;2;0;0;0
96;13.07.2012;2012;07;04;Perjantai;4;4;8;1;1;2
96;13.07.2012;2012;07;05;Perjantai;5;11;16;0;0;0
96;13.07.2012;2012;07;06;Perjantai;40;44;84;1;3;4
96;13.07.2012;2012;07;07;Perjantai;61;62;123;5;0;5
96;13.07.2012;2012;07;08;Perjantai;34;39;73;1;4;5
96;13.07.2012;2012;07;09;Perjantai;18;60;78;6;4;10
96;13.07.2012;2012;07;10;Perjantai;33;49;82;3;7;10
96;13.07.2012;2012;07;11;Perjantai;41;56;97;5;5;10
96;13.07.2012;2012;07;12;Perjantai;45;45;90;7;8;15
96;13.07.2012;2012;07;13;Perjantai;57;60;117;2;4;6
96;13.07.2012;2012;07;14;Perjantai;47;64;111;3;7;10
96;13.07.2012;2012;07;15;Perjantai;48;88;136;9;9;18
96;13.07.2012;2012;07;16;Perjantai;37;39;76;10;4;14
96;13.07.2012;2012;07;17;Perjantai;36;22;58;3;3;6
96;13.07.2012;2012;07;18;Perjantai;31;15;46;0;2;2
96;13.07.2012;2012;07;19;Perjantai;8;12;20;2;6;8
96;13.07.2012;2012;07;20;Perjantai;9;8;17;6;3;9
96;13.07.2012;2012;07;21;Perjantai;10;26;36;1;0;1
96;13.07.2012;2012;07;22;Perjantai;9;7;16;1;1;2
96;13.07.2012;2012;07;23;Perjantai;3;5;8;0;1;1
96;14.07.2012;2012;07;00;Lauantai;9;4;13;3;0;3
96;14.07.2012;2012;07;01;Lauantai;6;4;10;0;0;0
96;14.07.2012;2012;07;02;Lauantai;2;0;2;0;0;0
96;14.07.2012;2012;07;03;Lauantai;7;0;7;0;0;0
96;14.07.2012;2012;07;04;Lauantai;3;0;3;2;0;2
96;14.07.2012;2012;07;05;Lauantai;2;1;3;0;0;0
96;14.07.2012;2012;07;06;Lauantai;19;7;26;2;0;2
96;14.07.2012;2012;07;07;Lauantai;2;11;13;2;1;3
96;14.07.2012;2012;07;08;Lauantai;4;12;16;1;3;4
96;14.07.2012;2012;07;09;Lauantai;11;32;43;3;3;6
96;14.07.2012;2012;07;10;Lauantai;18;32;50;2;5;7
96;14.07.2012;2012;07;11;Lauantai;33;40;73;4;3;7
96;14.07.2012;2012;07;12;Lauantai;32;53;85;9;7;16
96;14.07.2012;2012;07;13;Lauantai;42;56;98;3;5;8
96;14.07.2012;2012;07;14;Lauantai;34;21;55;5;7;12
96;14.07.2012;2012;07;15;Lauantai;30;36;66;1;1;2
96;14.07.2012;2012;07;16;Lauantai;20;37;57;2;6;8
96;14.07.2012;2012;07;17;Lauantai;35;24;59;9;6;15
96;14.07.2012;2012;07;18;Lauantai;21;32;53;10;7;17
96;14.07.2012;2012;07;19;Lauantai;19;22;41;2;4;6
96;14.07.2012;2012;07;20;Lauantai;18;28;46;2;2;4
96;14.07.2012;2012;07;21;Lauantai;19;32;51;5;3;8
96;14.07.2012;2012;07;22;Lauantai;11;19;30;0;0;0
96;14.07.2012;2012;07;23;Lauantai;14;21;35;1;2;3
96;15.07.2012;2012;07;00;Sunnuntai;19;13;32;0;1;1
96;15.07.2012;2012;07;01;Sunnuntai;16;0;16;1;0;1
96;15.07.2012;2012;07;02;Sunnuntai;19;1;20;3;2;5
96;15.07.2012;2012;07;03;Sunnuntai;29;4;33;1;0;1
96;15.07.2012;2012;07;04;Sunnuntai;18;0;18;2;1;3
96;15.07.2012;2012;07;05;Sunnuntai;7;1;8;1;0;1
96;15.07.2012;2012;07;06;Sunnuntai;15;7;22;3;0;3
96;15.07.2012;2012;07;07;Sunnuntai;8;9;17;2;3;5
96;15.07.2012;2012;07;08;Sunnuntai;5;6;11;0;5;5
96;15.07.2012;2012;07;09;Sunnuntai;18;18;36;4;4;8
96;15.07.2012;2012;07;10;Sunnuntai;26;24;50;4;3;7
96;15.07.2012;2012;07;11;Sunnuntai;29;43;72;3;3;6
96;15.07.2012;2012;07;12;Sunnuntai;50;57;107;7;11;18
96;15.07.2012;2012;07;13;Sunnuntai;64;51;115;10;7;17
96;15.07.2012;2012;07;14;Sunnuntai;55;49;104;4;8;12
96;15.07.2012;2012;07;15;Sunnuntai;49;78;127;16;8;24
96;15.07.2012;2012;07;16;Sunnuntai;51;44;95;11;3;14
96;15.07.2012;2012;07;17;Sunnuntai;78;50;128;22;10;32
96;15.07.2012;2012;07;18;Sunnuntai;59;45;104;12;4;16
96;15.07.2012;2012;07;19;Sunnuntai;46;48;94;7;9;16
96;15.07.2012;2012;07;20;Sunnuntai;36;56;92;4;13;17
96;15.07.2012;2012;07;21;Sunnuntai;29;30;59;5;8;13
96;15.07.2012;2012;07;22;Sunnuntai;6;10;16;4;2;6
96;15.07.2012;2012;07;23;Sunnuntai;7;8;15;1;4;5
96;16.07.2012;2012;07;00;Maanantai;3;3;6;1;1;2
96;16.07.2012;2012;07;01;Maanantai;6;3;9;1;0;1
96;16.07.2012;2012;07;02;Maanantai;11;2;13;0;0;0
96;16.07.2012;2012;07;03;Maanantai;4;0;4;0;0;0
96;16.07.2012;2012;07;04;Maanantai;1;4;5;1;0;1
96;16.07.2012;2012;07;05;Maanantai;8;13;21;0;1;1
96;16.07.2012;2012;07;06;Maanantai;47;37;84;4;4;8
96;16.07.2012;2012;07;07;Maanantai;78;52;130;6;3;9
96;16.07.2012;2012;07;08;Maanantai;30;55;85;1;8;9
96;16.07.2012;2012;07;09;Maanantai;34;69;103;8;6;14
96;16.07.2012;2012;07;10;Maanantai;44;78;122;4;3;7
96;16.07.2012;2012;07;11;Maanantai;61;67;128;9;16;25
96;16.07.2012;2012;07;12;Maanantai;63;81;144;7;5;12
96;16.07.2012;2012;07;13;Maanantai;77;73;150;4;8;12
96;16.07.2012;2012;07;14;Maanantai;89;108;197;14;11;25
96;16.07.2012;2012;07;15;Maanantai;84;118;202;7;22;29
96;16.07.2012;2012;07;16;Maanantai;93;93;186;4;7;11
96;16.07.2012;2012;07;17;Maanantai;82;74;156;8;6;14
96;16.07.2012;2012;07;18;Maanantai;70;60;130;13;8;21
96;16.07.2012;2012;07;19;Maanantai;64;46;110;6;11;17
96;16.07.2012;2012;07;20;Maanantai;64;51;115;7;8;15
96;16.07.2012;2012;07;21;Maanantai;34;36;70;6;2;8
96;16.07.2012;2012;07;22;Maanantai;8;15;23;2;3;5
96;16.07.2012;2012;07;23;Maanantai;10;4;14;2;0;2
96;17.07.2012;2012;07;00;Tiistai;11;4;15;2;3;5
96;17.07.2012;2012;07;01;Tiistai;5;1;6;0;2;2
96;17.07.2012;2012;07;02;Tiistai;2;0;2;0;0;0
96;17.07.2012;2012;07;03;Tiistai;2;2;4;0;0;0
96;17.07.2012;2012;07;04;Tiistai;2;1;3;0;1;1
96;17.07.2012;2012;07;05;Tiistai;9;9;18;0;1;1
96;17.07.2012;2012;07;06;Tiistai;51;32;83;3;4;7
96;17.07.2012;2012;07;07;Tiistai;83;59;142;8;1;9
96;17.07.2012;2012;07;08;Tiistai;33;66;99;7;10;17
96;17.07.2012;2012;07;09;Tiistai;36;64;100;3;8;11
96;17.07.2012;2012;07;10;Tiistai;42;71;113;3;5;8
96;17.07.2012;2012;07;11;Tiistai;48;62;110;11;10;21
96;17.07.2012;2012;07;12;Tiistai;67;74;141;7;11;18
96;17.07.2012;2012;07;13;Tiistai;73;87;160;6;11;17
96;17.07.2012;2012;07;14;Tiistai;93;95;188;4;17;21
96;17.07.2012;2012;07;15;Tiistai;95;152;247;1;10;11
96;17.07.2012;2012;07;16;Tiistai;103;99;202;10;12;22
96;17.07.2012;2012;07;17;Tiistai;94;61;155;8;5;13
96;17.07.2012;2012;07;18;Tiistai;101;63;164;6;7;13
96;17.07.2012;2012;07;19;Tiistai;82;78;160;19;17;36
96;17.07.2012;2012;07;20;Tiistai;58;45;103;15;17;32
96;17.07.2012;2012;07;21;Tiistai;41;35;76;3;7;10
96;17.07.2012;2012;07;22;Tiistai;19;18;37;3;3;6
96;17.07.2012;2012;07;23;Tiistai;17;8;25;2;1;3
96;18.07.2012;2012;07;00;Keskiviikko;11;6;17;1;1;2
96;18.07.2012;2012;07;01;Keskiviikko;7;3;10;0;1;1
96;18.07.2012;2012;07;02;Keskiviikko;5;0;5;0;0;0
96;18.07.2012;2012;07;03;Keskiviikko;7;1;8;2;0;2
96;18.07.2012;2012;07;04;Keskiviikko;1;0;1;0;0;0
96;18.07.2012;2012;07;05;Keskiviikko;10;12;22;2;2;4
96;18.07.2012;2012;07;06;Keskiviikko;54;38;92;2;0;2
96;18.07.2012;2012;07;07;Keskiviikko;91;56;147;6;5;11
96;18.07.2012;2012;07;08;Keskiviikko;26;47;73;4;6;10
96;18.07.2012;2012;07;09;Keskiviikko;37;66;103;7;7;14
96;18.07.2012;2012;07;10;Keskiviikko;36;56;92;3;8;11
96;18.07.2012;2012;07;11;Keskiviikko;37;69;106;3;4;7
96;18.07.2012;2012;07;12;Keskiviikko;62;63;125;3;7;10
96;18.07.2012;2012;07;13;Keskiviikko;81;82;163;7;4;11
96;18.07.2012;2012;07;14;Keskiviikko;80;93;173;5;13;18
96;18.07.2012;2012;07;15;Keskiviikko;101;128;229;6;22;28
96;18.07.2012;2012;07;16;Keskiviikko;103;96;199;11;13;24
96;18.07.2012;2012;07;17;Keskiviikko;83;85;168;8;6;14
96;18.07.2012;2012;07;18;Keskiviikko;102;60;162;11;8;19
96;18.07.2012;2012;07;19;Keskiviikko;73;50;123;10;12;22
96;18.07.2012;2012;07;20;Keskiviikko;53;49;102;6;4;10
96;18.07.2012;2012;07;21;Keskiviikko;33;34;67;5;4;9
96;18.07.2012;2012;07;22;Keskiviikko;20;20;40;3;2;5
96;18.07.2012;2012;07;23;Keskiviikko;9;11;20;0;0;0
96;19.07.2012;2012;07;00;Torstai;9;8;17;0;3;3
96;19.07.2012;2012;07;01;Torstai;14;1;15;0;1;1
96;19.07.2012;2012;07;02;Torstai;8;1;9;2;2;4
96;19.07.2012;2012;07;03;Torstai;11;4;15;0;0;0
96;19.07.2012;2012;07;04;Torstai;5;1;6;1;0;1
96;19.07.2012;2012;07;05;Torstai;7;8;15;0;2;2
96;19.07.2012;2012;07;06;Torstai;50;35;85;4;0;4
96;19.07.2012;2012;07;07;Torstai;61;79;140;6;4;10
96;19.07.2012;2012;07;08;Torstai;22;42;64;2;6;8
96;19.07.2012;2012;07;09;Torstai;29;63;92;2;5;7
96;19.07.2012;2012;07;10;Torstai;21;40;61;6;5;11
96;19.07.2012;2012;07;11;Torstai;26;28;54;3;3;6
96;19.07.2012;2012;07;12;Torstai;24;45;69;3;3;6
96;19.07.2012;2012;07;13;Torstai;41;49;90;4;7;11
96;19.07.2012;2012;07;14;Torstai;49;77;126;3;6;9
96;19.07.2012;2012;07;15;Torstai;52;142;194;4;4;8
96;19.07.2012;2012;07;16;Torstai;47;66;113;1;7;8
96;19.07.2012;2012;07;17;Torstai;61;48;109;2;4;6
96;19.07.2012;2012;07;18;Torstai;62;54;116;4;5;9
96;19.07.2012;2012;07;19;Torstai;35;34;69;9;10;19
96;19.07.2012;2012;07;20;Torstai;27;28;55;7;6;13
96;19.07.2012;2012;07;21;Torstai;27;36;63;5;1;6
96;19.07.2012;2012;07;22;Torstai;12;8;20;1;3;4
96;19.07.2012;2012;07;23;Torstai;7;6;13;1;0;1
96;20.07.2012;2012;07;00;Perjantai;3;2;5;1;0;1
96;20.07.2012;2012;07;01;Perjantai;5;3;8;0;0;0
96;20.07.2012;2012;07;02;Perjantai;12;0;12;1;0;1
96;20.07.2012;2012;07;03;Perjantai;2;2;4;0;0;0
96;20.07.2012;2012;07;04;Perjantai;1;1;2;1;0;1
96;20.07.2012;2012;07;05;Perjantai;5;8;13;0;0;0
96;20.07.2012;2012;07;06;Perjantai;46;39;85;5;2;7
96;20.07.2012;2012;07;07;Perjantai;72;50;122;3;2;5
96;20.07.2012;2012;07;08;Perjantai;30;45;75;8;4;12
96;20.07.2012;2012;07;09;Perjantai;30;64;94;6;8;14
96;20.07.2012;2012;07;10;Perjantai;39;61;100;9;6;15
96;20.07.2012;2012;07;11;Perjantai;55;69;124;3;6;9
96;20.07.2012;2012;07;12;Perjantai;64;71;135;0;10;10
96;20.07.2012;2012;07;13;Perjantai;78;68;146;3;5;8
96;20.07.2012;2012;07;14;Perjantai;84;95;179;7;5;12
96;20.07.2012;2012;07;15;Perjantai;98;127;225;9;14;23
96;20.07.2012;2012;07;16;Perjantai;76;80;156;5;8;13
96;20.07.2012;2012;07;17;Perjantai;83;54;137;7;9;16
96;20.07.2012;2012;07;18;Perjantai;61;66;127;4;13;17
96;20.07.2012;2012;07;19;Perjantai;63;43;106;5;6;11
96;20.07.2012;2012;07;20;Perjantai;43;30;73;7;5;12
96;20.07.2012;2012;07;21;Perjantai;22;36;58;3;7;10
96;20.07.2012;2012;07;22;Perjantai;14;21;35;2;3;5
96;20.07.2012;2012;07;23;Perjantai;18;10;28;0;2;2
96;21.07.2012;2012;07;00;Lauantai;13;6;19;2;0;2
96;21.07.2012;2012;07;01;Lauantai;15;8;23;0;1;1
96;21.07.2012;2012;07;02;Lauantai;9;2;11;1;0;1
96;21.07.2012;2012;07;03;Lauantai;15;3;18;3;1;4
96;21.07.2012;2012;07;04;Lauantai;15;4;19;2;0;2
96;21.07.2012;2012;07;05;Lauantai;6;4;10;2;0;2
96;21.07.2012;2012;07;06;Lauantai;19;10;29;2;0;2
96;21.07.2012;2012;07;07;Lauantai;6;9;15;1;4;5
96;21.07.2012;2012;07;08;Lauantai;9;20;29;2;4;6
96;21.07.2012;2012;07;09;Lauantai;15;44;59;3;6;9
96;21.07.2012;2012;07;10;Lauantai;28;48;76;2;0;2
96;21.07.2012;2012;07;11;Lauantai;34;30;64;4;5;9
96;21.07.2012;2012;07;12;Lauantai;43;22;65;1;4;5
96;21.07.2012;2012;07;13;Lauantai;31;32;63;2;1;3
96;21.07.2012;2012;07;14;Lauantai;24;34;58;1;2;3
96;21.07.2012;2012;07;15;Lauantai;39;44;83;7;3;10
96;21.07.2012;2012;07;16;Lauantai;41;30;71;0;4;4
96;21.07.2012;2012;07;17;Lauantai;31;40;71;3;6;9
96;21.07.2012;2012;07;18;Lauantai;39;28;67;2;4;6
96;21.07.2012;2012;07;19;Lauantai;20;40;60;2;6;8
96;21.07.2012;2012;07;20;Lauantai;24;34;58;4;5;9
96;21.07.2012;2012;07;21;Lauantai;16;23;39;1;4;5
96;21.07.2012;2012;07;22;Lauantai;8;21;29;2;1;3
96;21.07.2012;2012;07;23;Lauantai;10;8;18;2;0;2
96;22.07.2012;2012;07;00;Sunnuntai;13;17;30;0;1;1
96;22.07.2012;2012;07;01;Sunnuntai;15;3;18;1;0;1
96;22.07.2012;2012;07;02;Sunnuntai;23;1;24;2;0;2
96;22.07.2012;2012;07;03;Sunnuntai;24;1;25;4;0;4
96;22.07.2012;2012;07;04;Sunnuntai;9;1;10;4;0;4
96;22.07.2012;2012;07;05;Sunnuntai;11;2;13;0;0;0
96;22.07.2012;2012;07;06;Sunnuntai;17;6;23;0;0;0
96;22.07.2012;2012;07;07;Sunnuntai;7;9;16;2;2;4
96;22.07.2012;2012;07;08;Sunnuntai;11;9;20;5;2;7
96;22.07.2012;2012;07;09;Sunnuntai;8;18;26;1;4;5
96;22.07.2012;2012;07;10;Sunnuntai;18;31;49;9;5;14
96;22.07.2012;2012;07;11;Sunnuntai;18;34;52;8;6;14
96;22.07.2012;2012;07;12;Sunnuntai;45;45;90;5;4;9
96;22.07.2012;2012;07;13;Sunnuntai;35;47;82;5;3;8
96;22.07.2012;2012;07;14;Sunnuntai;61;47;108;0;9;9
96;22.07.2012;2012;07;15;Sunnuntai;43;37;80;3;3;6
96;22.07.2012;2012;07;16;Sunnuntai;42;41;83;6;8;14
96;22.07.2012;2012;07;17;Sunnuntai;48;26;74;8;3;11
96;22.07.2012;2012;07;18;Sunnuntai;37;37;74;8;5;13
96;22.07.2012;2012;07;19;Sunnuntai;35;28;63;8;4;12
96;22.07.2012;2012;07;20;Sunnuntai;36;40;76;8;9;17
96;22.07.2012;2012;07;21;Sunnuntai;15;32;47;1;6;7
96;22.07.2012;2012;07;22;Sunnuntai;13;13;26;0;2;2
96;22.07.2012;2012;07;23;Sunnuntai;6;7;13;2;2;4
96;23.07.2012;2012;07;00;Maanantai;4;4;8;0;2;2
96;23.07.2012;2012;07;01;Maanantai;1;1;2;3;1;4
96;23.07.2012;2012;07;02;Maanantai;6;2;8;1;0;1
96;23.07.2012;2012;07;03;Maanantai;2;2;4;2;0;2
96;23.07.2012;2012;07;04;Maanantai;3;1;4;0;0;0
96;23.07.2012;2012;07;05;Maanantai;11;9;20;1;0;1
96;23.07.2012;2012;07;06;Maanantai;48;42;90;5;2;7
96;23.07.2012;2012;07;07;Maanantai;80;57;137;5;7;12
96;23.07.2012;2012;07;08;Maanantai;35;60;95;2;5;7
96;23.07.2012;2012;07;09;Maanantai;26;67;93;7;7;14
96;23.07.2012;2012;07;10;Maanantai;29;67;96;5;6;11
96;23.07.2012;2012;07;11;Maanantai;34;64;98;3;6;9
96;23.07.2012;2012;07;12;Maanantai;72;73;145;3;12;15
96;23.07.2012;2012;07;13;Maanantai;92;76;168;5;5;10
96;23.07.2012;2012;07;14;Maanantai;65;95;160;9;6;15
96;23.07.2012;2012;07;15;Maanantai;56;123;179;3;11;14
96;23.07.2012;2012;07;16;Maanantai;86;87;173;8;2;10
96;23.07.2012;2012;07;17;Maanantai;52;50;102;4;8;12
96;23.07.2012;2012;07;18;Maanantai;58;57;115;4;7;11
96;23.07.2012;2012;07;19;Maanantai;49;34;83;7;12;19
96;23.07.2012;2012;07;20;Maanantai;30;35;65;9;7;16
96;23.07.2012;2012;07;21;Maanantai;27;30;57;2;6;8
96;23.07.2012;2012;07;22;Maanantai;12;13;25;1;1;2
96;23.07.2012;2012;07;23;Maanantai;8;4;12;2;3;5
96;24.07.2012;2012;07;00;Tiistai;6;0;6;2;0;2
96;24.07.2012;2012;07;01;Tiistai;4;0;4;0;0;0
96;24.07.2012;2012;07;02;Tiistai;4;2;6;0;0;0
96;24.07.2012;2012;07;03;Tiistai;1;0;1;0;0;0
96;24.07.2012;2012;07;04;Tiistai;0;1;1;0;0;0
96;24.07.2012;2012;07;05;Tiistai;9;17;26;0;0;0
96;24.07.2012;2012;07;06;Tiistai;45;37;82;3;2;5
96;24.07.2012;2012;07;07;Tiistai;73;67;140;8;2;10
96;24.07.2012;2012;07;08;Tiistai;37;55;92;3;4;7
96;24.07.2012;2012;07;09;Tiistai;34;56;90;13;10;23
96;24.07.2012;2012;07;10;Tiistai;25;62;87;2;8;10
96;24.07.2012;2012;07;11;Tiistai;54;64;118;6;9;15
96;24.07.2012;2012;07;12;Tiistai;64;69;133;9;8;17
96;24.07.2012;2012;07;13;Tiistai;85;92;177;6;8;14
96;24.07.2012;2012;07;14;Tiistai;96;89;185;2;9;11
96;24.07.2012;2012;07;15;Tiistai;83;163;246;5;9;14
96;24.07.2012;2012;07;16;Tiistai;114;115;229;12;10;22
96;24.07.2012;2012;07;17;Tiistai;73;77;150;6;11;17
96;24.07.2012;2012;07;18;Tiistai;80;75;155;9;10;19
96;24.07.2012;2012;07;19;Tiistai;85;69;154;13;7;20
96;24.07.2012;2012;07;20;Tiistai;71;54;125;4;15;19
96;24.07.2012;2012;07;21;Tiistai;42;35;77;6;7;13
96;24.07.2012;2012;07;22;Tiistai;10;10;20;1;2;3
96;24.07.2012;2012;07;23;Tiistai;12;11;23;0;1;1
96;25.07.2012;2012;07;00;Keskiviikko;9;1;10;1;0;1
96;25.07.2012;2012;07;01;Keskiviikko;5;0;5;0;0;0
96;25.07.2012;2012;07;02;Keskiviikko;5;3;8;0;0;0
96;25.07.2012;2012;07;03;Keskiviikko;6;0;6;0;0;0
96;25.07.2012;2012;07;04;Keskiviikko;2;0;2;4;0;4
96;25.07.2012;2012;07;05;Keskiviikko;7;13;20;0;2;2
96;25.07.2012;2012;07;06;Keskiviikko;53;37;90;5;2;7
96;25.07.2012;2012;07;07;Keskiviikko;102;74;176;6;4;10
96;25.07.2012;2012;07;08;Keskiviikko;47;54;101;3;7;10
96;25.07.2012;2012;07;09;Keskiviikko;28;56;84;5;5;10
96;25.07.2012;2012;07;10;Keskiviikko;46;55;101;3;5;8
96;25.07.2012;2012;07;11;Keskiviikko;41;63;104;5;8;13
96;25.07.2012;2012;07;12;Keskiviikko;52;67;119;4;6;10
96;25.07.2012;2012;07;13;Keskiviikko;71;68;139;4;5;9
96;25.07.2012;2012;07;14;Keskiviikko;65;92;157;8;8;16
96;25.07.2012;2012;07;15;Keskiviikko;70;142;212;5;17;22
96;25.07.2012;2012;07;16;Keskiviikko;75;86;161;7;6;13
96;25.07.2012;2012;07;17;Keskiviikko;47;37;84;5;4;9
96;25.07.2012;2012;07;18;Keskiviikko;45;26;71;3;3;6
96;25.07.2012;2012;07;19;Keskiviikko;32;24;56;2;7;9
96;25.07.2012;2012;07;20;Keskiviikko;26;23;49;7;3;10
96;25.07.2012;2012;07;21;Keskiviikko;17;34;51;2;3;5
96;25.07.2012;2012;07;22;Keskiviikko;8;17;25;2;1;3
96;25.07.2012;2012;07;23;Keskiviikko;2;14;16;1;1;2
96;26.07.2012;2012;07;00;Torstai;4;3;7;0;0;0
96;26.07.2012;2012;07;01;Torstai;3;3;6;0;0;0
96;26.07.2012;2012;07;02;Torstai;4;2;6;1;0;1
96;26.07.2012;2012;07;03;Torstai;1;0;1;0;0;0
96;26.07.2012;2012;07;04;Torstai;5;1;6;0;0;0
96;26.07.2012;2012;07;05;Torstai;8;11;19;0;0;0
96;26.07.2012;2012;07;06;Torstai;44;39;83;2;2;4
96;26.07.2012;2012;07;07;Torstai;83;61;144;5;3;8
96;26.07.2012;2012;07;08;Torstai;50;60;110;3;8;11
96;26.07.2012;2012;07;09;Torstai;22;50;72;5;1;6
96;26.07.2012;2012;07;10;Torstai;37;67;104;4;7;11
96;26.07.2012;2012;07;11;Torstai;56;67;123;7;12;19
96;26.07.2012;2012;07;12;Torstai;74;81;155;6;9;15
96;26.07.2012;2012;07;13;Torstai;73;72;145;7;6;13
96;26.07.2012;2012;07;14;Torstai;70;108;178;12;6;18
96;26.07.2012;2012;07;15;Torstai;115;139;254;8;15;23
96;26.07.2012;2012;07;16;Torstai;85;108;193;7;9;16
96;26.07.2012;2012;07;17;Torstai;86;80;166;12;11;23
96;26.07.2012;2012;07;18;Torstai;90;70;160;14;9;23
96;26.07.2012;2012;07;19;Torstai;71;66;137;11;7;18
96;26.07.2012;2012;07;20;Torstai;54;42;96;9;6;15
96;26.07.2012;2012;07;21;Torstai;40;37;77;4;1;5
96;26.07.2012;2012;07;22;Torstai;21;19;40;2;3;5
96;26.07.2012;2012;07;23;Torstai;16;9;25;1;1;2
96;27.07.2012;2012;07;00;Perjantai;17;4;21;1;1;2
96;27.07.2012;2012;07;01;Perjantai;13;0;13;0;0;0
96;27.07.2012;2012;07;02;Perjantai;7;0;7;4;0;4
96;27.07.2012;2012;07;03;Perjantai;10;1;11;0;0;0
96;27.07.2012;2012;07;04;Perjantai;9;2;11;1;1;2
96;27.07.2012;2012;07;05;Perjantai;9;8;17;1;0;1
96;27.07.2012;2012;07;06;Perjantai;54;37;91;8;0;8
96;27.07.2012;2012;07;07;Perjantai;73;68;141;2;3;5
96;27.07.2012;2012;07;08;Perjantai;38;54;92;2;4;6
96;27.07.2012;2012;07;09;Perjantai;25;53;78;6;5;11
96;27.07.2012;2012;07;10;Perjantai;39;57;96;5;5;10
96;27.07.2012;2012;07;11;Perjantai;41;65;106;5;4;9
96;27.07.2012;2012;07;12;Perjantai;67;86;153;3;12;15
96;27.07.2012;2012;07;13;Perjantai;62;119;181;3;7;10
96;27.07.2012;2012;07;14;Perjantai;103;152;255;3;7;10
96;27.07.2012;2012;07;15;Perjantai;100;147;247;4;12;16
96;27.07.2012;2012;07;16;Perjantai;75;90;165;7;9;16
96;27.07.2012;2012;07;17;Perjantai;70;101;171;7;11;18
96;27.07.2012;2012;07;18;Perjantai;64;84;148;7;12;19
96;27.07.2012;2012;07;19;Perjantai;51;68;119;7;11;18
96;27.07.2012;2012;07;20;Perjantai;50;49;99;5;3;8
96;27.07.2012;2012;07;21;Perjantai;36;44;80;2;3;5
96;27.07.2012;2012;07;22;Perjantai;35;31;66;1;0;1
96;27.07.2012;2012;07;23;Perjantai;48;16;64;3;1;4
96;28.07.2012;2012;07;00;Lauantai;46;7;53;1;2;3
96;28.07.2012;2012;07;01;Lauantai;67;2;69;4;0;4
96;28.07.2012;2012;07;02;Lauantai;67;3;70;7;0;7
96;28.07.2012;2012;07;03;Lauantai;42;1;43;10;0;10
96;28.07.2012;2012;07;04;Lauantai;18;0;18;4;0;4
96;28.07.2012;2012;07;05;Lauantai;10;0;10;1;1;2
96;28.07.2012;2012;07;06;Lauantai;22;11;33;1;0;1
96;28.07.2012;2012;07;07;Lauantai;6;14;20;1;1;2
96;28.07.2012;2012;07;08;Lauantai;9;22;31;2;5;7
96;28.07.2012;2012;07;09;Lauantai;18;58;76;3;5;8
96;28.07.2012;2012;07;10;Lauantai;23;52;75;1;5;6
96;28.07.2012;2012;07;11;Lauantai;37;64;101;6;9;15
96;28.07.2012;2012;07;12;Lauantai;61;73;134;6;4;10
96;28.07.2012;2012;07;13;Lauantai;70;62;132;3;13;16
96;28.07.2012;2012;07;14;Lauantai;83;68;151;8;9;17
96;28.07.2012;2012;07;15;Lauantai;83;52;135;11;3;14
96;28.07.2012;2012;07;16;Lauantai;72;68;140;10;6;16
96;28.07.2012;2012;07;17;Lauantai;55;56;111;3;6;9
96;28.07.2012;2012;07;18;Lauantai;53;59;112;4;3;7
96;28.07.2012;2012;07;19;Lauantai;33;61;94;5;3;8
96;28.07.2012;2012;07;20;Lauantai;28;47;75;2;1;3
96;28.07.2012;2012;07;21;Lauantai;37;41;78;1;4;5
96;28.07.2012;2012;07;22;Lauantai;26;32;58;1;2;3
96;28.07.2012;2012;07;23;Lauantai;30;25;55;0;1;1
96;29.07.2012;2012;07;00;Sunnuntai;56;6;62;3;3;6
96;29.07.2012;2012;07;01;Sunnuntai;83;5;88;4;0;4
96;29.07.2012;2012;07;02;Sunnuntai;51;5;56;5;0;5
96;29.07.2012;2012;07;03;Sunnuntai;54;2;56;12;0;12
96;29.07.2012;2012;07;04;Sunnuntai;30;0;30;8;1;9
96;29.07.2012;2012;07;05;Sunnuntai;12;2;14;1;1;2
96;29.07.2012;2012;07;06;Sunnuntai;16;8;24;1;1;2
96;29.07.2012;2012;07;07;Sunnuntai;5;8;13;4;1;5
96;29.07.2012;2012;07;08;Sunnuntai;5;6;11;2;6;8
96;29.07.2012;2012;07;09;Sunnuntai;5;6;11;0;3;3
96;29.07.2012;2012;07;10;Sunnuntai;8;10;18;2;4;6
96;29.07.2012;2012;07;11;Sunnuntai;19;31;50;4;10;14
96;29.07.2012;2012;07;12;Sunnuntai;33;52;85;5;8;13
96;29.07.2012;2012;07;13;Sunnuntai;43;49;92;6;3;9
96;29.07.2012;2012;07;14;Sunnuntai;36;49;85;7;3;10
96;29.07.2012;2012;07;15;Sunnuntai;51;41;92;3;6;9
96;29.07.2012;2012;07;16;Sunnuntai;49;45;94;6;4;10
96;29.07.2012;2012;07;17;Sunnuntai;33;29;62;5;4;9
96;29.07.2012;2012;07;18;Sunnuntai;23;12;35;2;4;6
96;29.07.2012;2012;07;19;Sunnuntai;18;19;37;4;7;11
96;29.07.2012;2012;07;20;Sunnuntai;27;42;69;3;7;10
96;29.07.2012;2012;07;21;Sunnuntai;17;28;45;9;12;21
96;29.07.2012;2012;07;22;Sunnuntai;10;12;22;2;3;5
96;29.07.2012;2012;07;23;Sunnuntai;8;0;8;0;1;1
96;30.07.2012;2012;07;00;Maanantai;3;1;4;0;1;1
96;30.07.2012;2012;07;01;Maanantai;4;0;4;1;0;1
96;30.07.2012;2012;07;02;Maanantai;2;1;3;1;0;1
96;30.07.2012;2012;07;03;Maanantai;5;0;5;0;0;0
96;30.07.2012;2012;07;04;Maanantai;1;1;2;1;0;1
96;30.07.2012;2012;07;05;Maanantai;10;4;14;1;0;1
96;30.07.2012;2012;07;06;Maanantai;45;37;82;2;1;3
96;30.07.2012;2012;07;07;Maanantai;86;89;175;5;6;11
96;30.07.2012;2012;07;08;Maanantai;36;77;113;2;5;7
96;30.07.2012;2012;07;09;Maanantai;26;58;84;9;11;20
96;30.07.2012;2012;07;10;Maanantai;28;58;86;6;9;15
96;30.07.2012;2012;07;11;Maanantai;28;64;92;4;0;4
96;30.07.2012;2012;07;12;Maanantai;49;69;118;6;4;10
96;30.07.2012;2012;07;13;Maanantai;69;84;153;2;2;4
96;30.07.2012;2012;07;14;Maanantai;75;94;169;6;14;20
96;30.07.2012;2012;07;15;Maanantai;130;151;281;6;7;13
96;30.07.2012;2012;07;16;Maanantai;103;111;214;3;11;14
96;30.07.2012;2012;07;17;Maanantai;39;38;77;8;4;12
96;30.07.2012;2012;07;18;Maanantai;49;26;75;2;2;4
96;30.07.2012;2012;07;19;Maanantai;37;26;63;4;4;8
96;30.07.2012;2012;07;20;Maanantai;20;9;29;0;4;4
96;30.07.2012;2012;07;21;Maanantai;31;26;57;1;8;9
96;30.07.2012;2012;07;22;Maanantai;9;7;16;1;3;4
96;30.07.2012;2012;07;23;Maanantai;11;6;17;1;0;1
96;31.07.2012;2012;07;00;Tiistai;3;4;7;1;0;1
96;31.07.2012;2012;07;01;Tiistai;0;1;1;1;0;1
96;31.07.2012;2012;07;02;Tiistai;2;1;3;0;0;0
96;31.07.2012;2012;07;03;Tiistai;2;0;2;0;0;0
96;31.07.2012;2012;07;04;Tiistai;2;2;4;0;0;0
96;31.07.2012;2012;07;05;Tiistai;5;6;11;0;0;0
96;31.07.2012;2012;07;06;Tiistai;39;48;87;1;1;2
96;31.07.2012;2012;07;07;Tiistai;102;90;192;9;8;17
96;31.07.2012;2012;07;08;Tiistai;50;83;133;4;4;8
96;31.07.2012;2012;07;09;Tiistai;25;74;99;6;7;13
96;31.07.2012;2012;07;10;Tiistai;43;59;102;3;4;7
96;31.07.2012;2012;07;11;Tiistai;49;73;122;2;6;8
96;31.07.2012;2012;07;12;Tiistai;76;73;149;11;8;19
96;31.07.2012;2012;07;13;Tiistai;67;77;144;5;3;8
96;31.07.2012;2012;07;14;Tiistai;80;96;176;8;16;24
96;31.07.2012;2012;07;15;Tiistai;113;159;272;1;7;8
96;31.07.2012;2012;07;16;Tiistai;109;117;226;13;6;19
96;31.07.2012;2012;07;17;Tiistai;55;55;110;3;10;13
96;31.07.2012;2012;07;18;Tiistai;68;51;119;5;13;18
96;31.07.2012;2012;07;19;Tiistai;54;47;101;11;10;21
96;31.07.2012;2012;07;20;Tiistai;52;39;91;4;7;11
96;31.07.2012;2012;07;21;Tiistai;36;30;66;9;8;17
96;31.07.2012;2012;07;22;Tiistai;14;11;25;0;1;1
96;31.07.2012;2012;07;23;Tiistai;7;4;11;0;1;1
96;01.08.2012;2012;08;00;Keskiviikko;5;3;8;0;0;0
96;01.08.2012;2012;08;01;Keskiviikko;7;0;7;0;1;1
96;01.08.2012;2012;08;02;Keskiviikko;2;5;7;0;0;0
96;01.08.2012;2012;08;03;Keskiviikko;2;0;2;0;0;0
96;01.08.2012;2012;08;04;Keskiviikko;2;0;2;0;0;0
96;01.08.2012;2012;08;05;Keskiviikko;3;5;8;0;0;0
96;01.08.2012;2012;08;06;Keskiviikko;62;42;104;5;0;5
96;01.08.2012;2012;08;07;Keskiviikko;96;92;188;8;5;13
96;01.08.2012;2012;08;08;Keskiviikko;53;83;136;5;6;11
96;01.08.2012;2012;08;09;Keskiviikko;23;83;106;5;4;9
96;01.08.2012;2012;08;10;Keskiviikko;34;70;104;5;4;9
96;01.08.2012;2012;08;11;Keskiviikko;72;73;145;5;6;11
96;01.08.2012;2012;08;12;Keskiviikko;77;79;156;6;12;18
96;01.08.2012;2012;08;13;Keskiviikko;76;85;161;6;5;11
96;01.08.2012;2012;08;14;Keskiviikko;81;109;190;3;10;13
96;01.08.2012;2012;08;15;Keskiviikko;114;185;299;7;26;33
96;01.08.2012;2012;08;16;Keskiviikko;113;125;238;6;13;19
96;01.08.2012;2012;08;17;Keskiviikko;72;46;118;7;6;13
96;01.08.2012;2012;08;18;Keskiviikko;75;27;102;12;5;17
96;01.08.2012;2012;08;19;Keskiviikko;60;56;116;5;13;18
96;01.08.2012;2012;08;20;Keskiviikko;53;38;91;6;3;9
96;01.08.2012;2012;08;21;Keskiviikko;32;40;72;6;13;19
96;01.08.2012;2012;08;22;Keskiviikko;18;17;35;1;2;3
96;01.08.2012;2012;08;23;Keskiviikko;2;8;10;3;0;3
96;02.08.2012;2012;08;00;Torstai;10;3;13;1;1;2
96;02.08.2012;2012;08;01;Torstai;7;2;9;0;0;0
96;02.08.2012;2012;08;02;Torstai;3;0;3;0;0;0
96;02.08.2012;2012;08;03;Torstai;4;0;4;0;0;0
96;02.08.2012;2012;08;04;Torstai;9;7;16;0;0;0
96;02.08.2012;2012;08;05;Torstai;5;8;13;1;1;2
96;02.08.2012;2012;08;06;Torstai;57;40;97;3;1;4
96;02.08.2012;2012;08;07;Torstai;81;87;168;4;0;4
96;02.08.2012;2012;08;08;Torstai;54;89;143;2;4;6
96;02.08.2012;2012;08;09;Torstai;19;51;70;6;5;11
96;02.08.2012;2012;08;10;Torstai;31;59;90;2;5;7
96;02.08.2012;2012;08;11;Torstai;47;69;116;3;12;15
96;02.08.2012;2012;08;12;Torstai;65;54;119;8;10;18
96;02.08.2012;2012;08;13;Torstai;71;81;152;3;6;9
96;02.08.2012;2012;08;14;Torstai;75;104;179;5;8;13
96;02.08.2012;2012;08;15;Torstai;101;163;264;9;16;25
96;02.08.2012;2012;08;16;Torstai;131;105;236;7;6;13
96;02.08.2012;2012;08;17;Torstai;41;34;75;3;3;6
96;02.08.2012;2012;08;18;Torstai;55;43;98;2;8;10
96;02.08.2012;2012;08;19;Torstai;29;35;64;5;9;14
96;02.08.2012;2012;08;20;Torstai;38;27;65;8;5;13
96;02.08.2012;2012;08;21;Torstai;22;33;55;4;4;8
96;02.08.2012;2012;08;22;Torstai;8;13;21;2;4;6
96;02.08.2012;2012;08;23;Torstai;3;5;8;2;3;5
96;03.08.2012;2012;08;00;Perjantai;3;3;6;0;1;1
96;03.08.2012;2012;08;01;Perjantai;3;1;4;1;0;1
96;03.08.2012;2012;08;02;Perjantai;10;1;11;0;0;0
96;03.08.2012;2012;08;03;Perjantai;5;0;5;1;0;1
96;03.08.2012;2012;08;04;Perjantai;7;3;10;0;0;0
96;03.08.2012;2012;08;05;Perjantai;6;9;15;1;0;1
96;03.08.2012;2012;08;06;Perjantai;52;33;85;1;0;1
96;03.08.2012;2012;08;07;Perjantai;73;70;143;3;2;5
96;03.08.2012;2012;08;08;Perjantai;30;75;105;4;6;10
96;03.08.2012;2012;08;09;Perjantai;31;60;91;7;6;13
96;03.08.2012;2012;08;10;Perjantai;27;56;83;4;9;13
96;03.08.2012;2012;08;11;Perjantai;47;75;122;6;11;17
96;03.08.2012;2012;08;12;Perjantai;75;69;144;8;8;16
96;03.08.2012;2012;08;13;Perjantai;81;81;162;6;12;18
96;03.08.2012;2012;08;14;Perjantai;69;110;179;6;23;29
96;03.08.2012;2012;08;15;Perjantai;80;128;208;6;9;15
96;03.08.2012;2012;08;16;Perjantai;92;72;164;8;4;12
96;03.08.2012;2012;08;17;Perjantai;54;47;101;4;4;8
96;03.08.2012;2012;08;18;Perjantai;52;34;86;15;5;20
96;03.08.2012;2012;08;19;Perjantai;38;47;85;3;10;13
96;03.08.2012;2012;08;20;Perjantai;31;36;67;9;3;12
96;03.08.2012;2012;08;21;Perjantai;26;32;58;4;2;6
96;03.08.2012;2012;08;22;Perjantai;11;17;28;2;0;2
96;03.08.2012;2012;08;23;Perjantai;17;7;24;2;3;5
96;04.08.2012;2012;08;00;Lauantai;17;10;27;0;3;3
96;04.08.2012;2012;08;01;Lauantai;16;2;18;1;0;1
96;04.08.2012;2012;08;02;Lauantai;12;2;14;2;0;2
96;04.08.2012;2012;08;03;Lauantai;8;0;8;1;0;1
96;04.08.2012;2012;08;04;Lauantai;16;2;18;3;1;4
96;04.08.2012;2012;08;05;Lauantai;4;4;8;2;0;2
96;04.08.2012;2012;08;06;Lauantai;16;10;26;0;0;0
96;04.08.2012;2012;08;07;Lauantai;5;15;20;3;1;4
96;04.08.2012;2012;08;08;Lauantai;3;20;23;1;1;2
96;04.08.2012;2012;08;09;Lauantai;11;34;45;4;4;8
96;04.08.2012;2012;08;10;Lauantai;24;47;71;6;4;10
96;04.08.2012;2012;08;11;Lauantai;38;48;86;3;1;4
96;04.08.2012;2012;08;12;Lauantai;57;56;113;6;4;10
96;04.08.2012;2012;08;13;Lauantai;57;51;108;6;1;7
96;04.08.2012;2012;08;14;Lauantai;30;61;91;2;5;7
96;04.08.2012;2012;08;15;Lauantai;44;53;97;5;11;16
96;04.08.2012;2012;08;16;Lauantai;38;45;83;1;7;8
96;04.08.2012;2012;08;17;Lauantai;40;39;79;7;4;11
96;04.08.2012;2012;08;18;Lauantai;44;50;94;5;5;10
96;04.08.2012;2012;08;19;Lauantai;36;50;86;6;7;13
96;04.08.2012;2012;08;20;Lauantai;28;30;58;1;2;3
96;04.08.2012;2012;08;21;Lauantai;24;55;79;5;5;10
96;04.08.2012;2012;08;22;Lauantai;16;23;39;2;3;5
96;04.08.2012;2012;08;23;Lauantai;15;12;27;3;2;5
96;05.08.2012;2012;08;00;Sunnuntai;17;7;24;0;0;0
96;05.08.2012;2012;08;01;Sunnuntai;23;4;27;4;1;5
96;05.08.2012;2012;08;02;Sunnuntai;26;2;28;1;0;1
96;05.08.2012;2012;08;03;Sunnuntai;23;6;29;2;0;2
96;05.08.2012;2012;08;04;Sunnuntai;25;1;26;1;0;1
96;05.08.2012;2012;08;05;Sunnuntai;3;2;5;0;0;0
96;05.08.2012;2012;08;06;Sunnuntai;14;12;26;1;3;4
96;05.08.2012;2012;08;07;Sunnuntai;5;16;21;1;1;2
96;05.08.2012;2012;08;08;Sunnuntai;6;10;16;3;2;5
96;05.08.2012;2012;08;09;Sunnuntai;6;24;30;5;6;11
96;05.08.2012;2012;08;10;Sunnuntai;25;32;57;7;8;15
96;05.08.2012;2012;08;11;Sunnuntai;27;48;75;3;7;10
96;05.08.2012;2012;08;12;Sunnuntai;44;46;90;9;6;15
96;05.08.2012;2012;08;13;Sunnuntai;61;48;109;5;5;10
96;05.08.2012;2012;08;14;Sunnuntai;40;50;90;3;7;10
96;05.08.2012;2012;08;15;Sunnuntai;46;49;95;7;3;10
96;05.08.2012;2012;08;16;Sunnuntai;47;66;113;6;10;16
96;05.08.2012;2012;08;17;Sunnuntai;90;61;151;12;6;18
96;05.08.2012;2012;08;18;Sunnuntai;74;43;117;11;3;14
96;05.08.2012;2012;08;19;Sunnuntai;41;50;91;11;17;28
96;05.08.2012;2012;08;20;Sunnuntai;58;47;105;8;11;19
96;05.08.2012;2012;08;21;Sunnuntai;14;43;57;1;14;15
96;05.08.2012;2012;08;22;Sunnuntai;18;9;27;3;1;4
96;05.08.2012;2012;08;23;Sunnuntai;10;8;18;4;1;5
96;27.08.2012;2012;08;00;Maanantai;5;2;7;2;2;4
96;27.08.2012;2012;08;01;Maanantai;4;1;5;0;0;0
96;27.08.2012;2012;08;02;Maanantai;1;0;1;1;0;1
96;27.08.2012;2012;08;03;Maanantai;1;0;1;0;0;0
96;27.08.2012;2012;08;04;Maanantai;1;0;1;1;0;1
96;27.08.2012;2012;08;05;Maanantai;9;12;21;0;0;0
96;27.08.2012;2012;08;06;Maanantai;47;45;92;2;5;7
96;27.08.2012;2012;08;07;Maanantai;151;157;308;16;5;21
96;27.08.2012;2012;08;08;Maanantai;126;180;306;12;9;21
96;27.08.2012;2012;08;09;Maanantai;83;123;206;5;7;12
96;27.08.2012;2012;08;10;Maanantai;46;74;120;6;9;15
96;27.08.2012;2012;08;11;Maanantai;64;81;145;7;19;26
96;27.08.2012;2012;08;12;Maanantai;95;98;193;2;10;12
96;27.08.2012;2012;08;13;Maanantai;83;93;176;11;11;22
96;27.08.2012;2012;08;14;Maanantai;89;153;242;5;14;19
96;27.08.2012;2012;08;15;Maanantai;138;247;385;9;21;30
96;27.08.2012;2012;08;16;Maanantai;164;202;366;12;19;31
96;27.08.2012;2012;08;17;Maanantai;99;94;193;11;14;25
96;27.08.2012;2012;08;18;Maanantai;102;83;185;9;15;24
96;27.08.2012;2012;08;19;Maanantai;71;63;134;12;18;30
96;27.08.2012;2012;08;20;Maanantai;90;48;138;19;16;35
96;27.08.2012;2012;08;21;Maanantai;36;20;56;8;5;13
96;27.08.2012;2012;08;22;Maanantai;9;9;18;2;0;2
96;27.08.2012;2012;08;23;Maanantai;7;5;12;2;1;3
96;28.08.2012;2012;08;00;Tiistai;7;1;8;0;0;0
96;28.08.2012;2012;08;01;Tiistai;1;1;2;0;1;1
96;28.08.2012;2012;08;02;Tiistai;0;4;4;0;0;0
96;28.08.2012;2012;08;03;Tiistai;0;0;0;0;0;0
96;28.08.2012;2012;08;04;Tiistai;3;0;3;0;0;0
96;28.08.2012;2012;08;05;Tiistai;4;15;19;0;0;0
96;28.08.2012;2012;08;06;Tiistai;46;43;89;3;2;5
96;28.08.2012;2012;08;07;Tiistai;158;198;356;15;8;23
96;28.08.2012;2012;08;08;Tiistai;138;185;323;14;12;26
96;28.08.2012;2012;08;09;Tiistai;75;110;185;11;8;19
96;28.08.2012;2012;08;10;Tiistai;56;83;139;10;1;11
96;28.08.2012;2012;08;11;Tiistai;72;69;141;7;13;20
96;28.08.2012;2012;08;12;Tiistai;99;97;196;3;16;19
96;28.08.2012;2012;08;13;Tiistai;102;90;192;16;8;24
96;28.08.2012;2012;08;14;Tiistai;99;166;265;7;11;18
96;28.08.2012;2012;08;15;Tiistai;138;295;433;11;32;43
96;28.08.2012;2012;08;16;Tiistai;198;190;388;15;22;37
96;28.08.2012;2012;08;17;Tiistai;132;115;247;9;11;20
96;28.08.2012;2012;08;18;Tiistai;125;91;216;20;9;29
96;28.08.2012;2012;08;19;Tiistai;106;47;153;22;13;35
96;28.08.2012;2012;08;20;Tiistai;75;35;110;20;9;29
96;28.08.2012;2012;08;21;Tiistai;38;33;71;3;6;9
96;28.08.2012;2012;08;22;Tiistai;8;9;17;5;4;9
96;28.08.2012;2012;08;23;Tiistai;4;2;6;2;4;6
96;29.08.2012;2012;08;00;Keskiviikko;2;2;4;1;0;1
96;29.08.2012;2012;08;01;Keskiviikko;1;1;2;0;0;0
96;29.08.2012;2012;08;02;Keskiviikko;2;0;2;0;0;0
96;29.08.2012;2012;08;03;Keskiviikko;2;0;2;0;0;0
96;29.08.2012;2012;08;04;Keskiviikko;2;1;3;0;2;2
96;29.08.2012;2012;08;05;Keskiviikko;6;16;22;0;0;0
96;29.08.2012;2012;08;06;Keskiviikko;53;55;108;3;6;9
96;29.08.2012;2012;08;07;Keskiviikko;164;169;333;23;7;30
96;29.08.2012;2012;08;08;Keskiviikko;168;160;328;7;11;18
96;29.08.2012;2012;08;09;Keskiviikko;57;142;199;9;10;19
96;29.08.2012;2012;08;10;Keskiviikko;40;84;124;6;13;19
96;29.08.2012;2012;08;11;Keskiviikko;61;100;161;4;14;18
96;29.08.2012;2012;08;12;Keskiviikko;76;103;179;4;7;11
96;29.08.2012;2012;08;13;Keskiviikko;94;85;179;10;6;16
96;29.08.2012;2012;08;14;Keskiviikko;94;156;250;9;16;25
96;29.08.2012;2012;08;15;Keskiviikko;136;287;423;6;27;33
96;29.08.2012;2012;08;16;Keskiviikko;136;260;396;6;18;24
96;29.08.2012;2012;08;17;Keskiviikko;121;138;259;8;12;20
96;29.08.2012;2012;08;18;Keskiviikko;124;76;200;17;10;27
96;29.08.2012;2012;08;19;Keskiviikko;106;70;176;7;8;15
96;29.08.2012;2012;08;20;Keskiviikko;85;82;167;13;10;23
96;29.08.2012;2012;08;21;Keskiviikko;36;56;92;3;13;16
96;29.08.2012;2012;08;22;Keskiviikko;15;15;30;0;0;0
96;29.08.2012;2012;08;23;Keskiviikko;13;7;20;1;1;2
96;30.08.2012;2012;08;00;Torstai;11;2;13;0;0;0
96;30.08.2012;2012;08;01;Torstai;6;4;10;2;0;2
96;30.08.2012;2012;08;02;Torstai;8;0;8;0;0;0
96;30.08.2012;2012;08;03;Torstai;10;1;11;0;0;0
96;30.08.2012;2012;08;04;Torstai;11;0;11;0;0;0
96;30.08.2012;2012;08;05;Torstai;4;11;15;1;0;1
96;30.08.2012;2012;08;06;Torstai;57;46;103;3;3;6
96;30.08.2012;2012;08;07;Torstai;148;179;327;16;11;27
96;30.08.2012;2012;08;08;Torstai;137;164;301;17;11;28
96;30.08.2012;2012;08;09;Torstai;70;95;165;18;9;27
96;30.08.2012;2012;08;10;Torstai;35;63;98;6;7;13
96;30.08.2012;2012;08;11;Torstai;69;89;158;3;6;9
96;30.08.2012;2012;08;12;Torstai;82;100;182;4;10;14
96;30.08.2012;2012;08;13;Torstai;90;102;192;4;9;13
96;30.08.2012;2012;08;14;Torstai;100;129;229;9;11;20
96;30.08.2012;2012;08;15;Torstai;128;253;381;8;14;22
96;30.08.2012;2012;08;16;Torstai;155;184;339;9;16;25
96;30.08.2012;2012;08;17;Torstai;89;99;188;12;12;24
96;30.08.2012;2012;08;18;Torstai;89;72;161;8;13;21
96;30.08.2012;2012;08;19;Torstai;70;42;112;6;6;12
96;30.08.2012;2012;08;20;Torstai;62;36;98;8;12;20
96;30.08.2012;2012;08;21;Torstai;29;25;54;4;7;11
96;30.08.2012;2012;08;22;Torstai;5;9;14;2;1;3
96;30.08.2012;2012;08;23;Torstai;8;3;11;1;1;2
96;31.08.2012;2012;08;00;Perjantai;8;2;10;1;0;1
96;31.08.2012;2012;08;01;Perjantai;6;1;7;0;0;0
96;31.08.2012;2012;08;02;Perjantai;6;1;7;0;0;0
96;31.08.2012;2012;08;03;Perjantai;1;2;3;0;0;0
96;31.08.2012;2012;08;04;Perjantai;2;2;4;0;0;0
96;31.08.2012;2012;08;05;Perjantai;7;8;15;1;0;1
96;31.08.2012;2012;08;06;Perjantai;42;40;82;1;3;4
96;31.08.2012;2012;08;07;Perjantai;136;155;291;19;4;23
96;31.08.2012;2012;08;08;Perjantai;117;155;272;11;8;19
96;31.08.2012;2012;08;09;Perjantai;53;96;149;8;7;15
96;31.08.2012;2012;08;10;Perjantai;46;94;140;3;6;9
96;31.08.2012;2012;08;11;Perjantai;51;98;149;9;7;16
96;31.08.2012;2012;08;12;Perjantai;68;106;174;6;8;14
96;31.08.2012;2012;08;13;Perjantai;74;123;197;10;7;17
96;31.08.2012;2012;08;14;Perjantai;109;167;276;7;9;16
96;31.08.2012;2012;08;15;Perjantai;126;185;311;10;16;26
96;31.08.2012;2012;08;16;Perjantai;101;105;206;10;6;16
96;31.08.2012;2012;08;17;Perjantai;79;61;140;4;9;13
96;31.08.2012;2012;08;18;Perjantai;61;52;113;2;7;9
96;31.08.2012;2012;08;19;Perjantai;41;41;82;4;6;10
96;31.08.2012;2012;08;20;Perjantai;51;30;81;5;9;14
96;31.08.2012;2012;08;21;Perjantai;42;34;76;2;3;5
96;31.08.2012;2012;08;22;Perjantai;11;17;28;0;2;2
96;31.08.2012;2012;08;23;Perjantai;11;16;27;0;0;0
96;01.09.2012;2012;09;00;Lauantai;16;7;23;1;1;2
96;01.09.2012;2012;09;01;Lauantai;21;9;30;4;0;4
96;01.09.2012;2012;09;02;Lauantai;10;4;14;1;0;1
96;01.09.2012;2012;09;03;Lauantai;11;2;13;1;0;1
96;01.09.2012;2012;09;04;Lauantai;8;2;10;1;0;1
96;01.09.2012;2012;09;05;Lauantai;3;3;6;0;0;0
96;01.09.2012;2012;09;06;Lauantai;10;9;19;3;1;4
96;01.09.2012;2012;09;07;Lauantai;4;22;26;1;2;3
96;01.09.2012;2012;09;08;Lauantai;8;20;28;1;5;6
96;01.09.2012;2012;09;09;Lauantai;14;54;68;5;4;9
96;01.09.2012;2012;09;10;Lauantai;18;47;65;5;7;12
96;01.09.2012;2012;09;11;Lauantai;32;57;89;8;4;12
96;01.09.2012;2012;09;12;Lauantai;40;62;102;10;13;23
96;01.09.2012;2012;09;13;Lauantai;57;75;132;7;10;17
96;01.09.2012;2012;09;14;Lauantai;57;50;107;4;6;10
96;01.09.2012;2012;09;15;Lauantai;51;46;97;12;8;20
96;01.09.2012;2012;09;16;Lauantai;53;41;94;8;8;16
96;01.09.2012;2012;09;17;Lauantai;46;43;89;11;5;16
96;01.09.2012;2012;09;18;Lauantai;61;31;92;10;7;17
96;01.09.2012;2012;09;19;Lauantai;40;39;79;3;4;7
96;01.09.2012;2012;09;20;Lauantai;21;43;64;5;6;11
96;01.09.2012;2012;09;21;Lauantai;19;39;58;1;4;5
96;01.09.2012;2012;09;22;Lauantai;9;29;38;0;1;1
96;01.09.2012;2012;09;23;Lauantai;10;17;27;2;0;2
96;02.09.2012;2012;09;00;Sunnuntai;10;6;16;3;2;5
96;02.09.2012;2012;09;01;Sunnuntai;10;8;18;0;0;0
96;02.09.2012;2012;09;02;Sunnuntai;28;0;28;2;0;2
96;02.09.2012;2012;09;03;Sunnuntai;20;2;22;5;0;5
96;02.09.2012;2012;09;04;Sunnuntai;8;3;11;3;0;3
96;02.09.2012;2012;09;05;Sunnuntai;5;1;6;0;2;2
96;02.09.2012;2012;09;06;Sunnuntai;7;8;15;0;1;1
96;02.09.2012;2012;09;07;Sunnuntai;5;12;17;2;3;5
96;02.09.2012;2012;09;08;Sunnuntai;3;8;11;4;3;7
96;02.09.2012;2012;09;09;Sunnuntai;7;11;18;4;1;5
96;02.09.2012;2012;09;10;Sunnuntai;10;22;32;2;9;11
96;02.09.2012;2012;09;11;Sunnuntai;13;45;58;6;3;9
96;02.09.2012;2012;09;12;Sunnuntai;19;50;69;5;8;13
96;02.09.2012;2012;09;13;Sunnuntai;33;32;65;6;4;10
96;02.09.2012;2012;09;14;Sunnuntai;50;33;83;2;7;9
96;02.09.2012;2012;09;15;Sunnuntai;23;23;46;11;8;19
96;02.09.2012;2012;09;16;Sunnuntai;42;27;69;16;4;20
96;02.09.2012;2012;09;17;Sunnuntai;29;23;52;11;5;16
96;02.09.2012;2012;09;18;Sunnuntai;29;23;52;16;10;26
96;02.09.2012;2012;09;19;Sunnuntai;20;24;44;5;12;17
96;02.09.2012;2012;09;20;Sunnuntai;27;29;56;4;11;15
96;02.09.2012;2012;09;21;Sunnuntai;17;23;40;8;10;18
96;02.09.2012;2012;09;22;Sunnuntai;12;7;19;0;2;2
96;02.09.2012;2012;09;23;Sunnuntai;5;5;10;0;0;0
96;12.11.2012;2012;11;00;Maanantai;1;0;1;1;0;1
96;12.11.2012;2012;11;01;Maanantai;0;0;0;0;0;0
96;12.11.2012;2012;11;02;Maanantai;1;0;1;0;0;0
96;12.11.2012;2012;11;03;Maanantai;1;1;2;0;0;0
96;12.11.2012;2012;11;04;Maanantai;1;0;1;0;1;1
96;12.11.2012;2012;11;05;Maanantai;4;12;16;0;0;0
96;12.11.2012;2012;11;06;Maanantai;43;19;62;3;4;7
96;12.11.2012;2012;11;07;Maanantai;108;63;171;11;6;17
96;12.11.2012;2012;11;08;Maanantai;62;76;138;4;9;13
96;12.11.2012;2012;11;09;Maanantai;47;52;99;3;8;11
96;12.11.2012;2012;11;10;Maanantai;40;53;93;6;5;11
96;12.11.2012;2012;11;11;Maanantai;54;46;100;6;7;13
96;12.11.2012;2012;11;12;Maanantai;51;53;104;7;7;14
96;12.11.2012;2012;11;13;Maanantai;57;61;118;3;9;12
96;12.11.2012;2012;11;14;Maanantai;62;85;147;7;22;29
96;12.11.2012;2012;11;15;Maanantai;70;186;256;3;26;29
96;12.11.2012;2012;11;16;Maanantai;69;93;162;7;14;21
96;12.11.2012;2012;11;17;Maanantai;50;64;114;5;6;11
96;12.11.2012;2012;11;18;Maanantai;44;35;79;12;9;21
96;12.11.2012;2012;11;19;Maanantai;20;23;43;18;14;32
96;12.11.2012;2012;11;20;Maanantai;39;30;69;5;9;14
96;12.11.2012;2012;11;21;Maanantai;15;23;38;1;8;9
96;12.11.2012;2012;11;22;Maanantai;5;11;16;1;0;1
96;12.11.2012;2012;11;23;Maanantai;2;1;3;1;0;1
96;13.11.2012;2012;11;00;Tiistai;4;0;4;0;0;0
96;13.11.2012;2012;11;01;Tiistai;1;0;1;0;0;0
96;13.11.2012;2012;11;02;Tiistai;1;0;1;0;0;0
96;13.11.2012;2012;11;03;Tiistai;0;0;0;0;0;0
96;13.11.2012;2012;11;04;Tiistai;1;1;2;0;1;1
96;13.11.2012;2012;11;05;Tiistai;5;9;14;0;0;0
96;13.11.2012;2012;11;06;Tiistai;47;29;76;5;5;10
96;13.11.2012;2012;11;07;Tiistai;118;100;218;14;9;23
96;13.11.2012;2012;11;08;Tiistai;84;94;178;5;2;7
96;13.11.2012;2012;11;09;Tiistai;59;58;117;12;12;24
96;13.11.2012;2012;11;10;Tiistai;46;56;102;3;3;6
96;13.11.2012;2012;11;11;Tiistai;44;53;97;5;10;15
96;13.11.2012;2012;11;12;Tiistai;66;65;131;13;4;17
96;13.11.2012;2012;11;13;Tiistai;49;57;106;4;11;15
96;13.11.2012;2012;11;14;Tiistai;62;111;173;6;10;16
96;13.11.2012;2012;11;15;Tiistai;82;205;287;9;26;35
96;13.11.2012;2012;11;16;Tiistai;91;94;185;24;28;52
96;13.11.2012;2012;11;17;Tiistai;48;87;135;15;22;37
96;13.11.2012;2012;11;18;Tiistai;47;51;98;19;11;30
96;13.11.2012;2012;11;19;Tiistai;42;37;79;11;14;25
96;13.11.2012;2012;11;20;Tiistai;57;34;91;19;20;39
96;13.11.2012;2012;11;21;Tiistai;32;28;60;2;6;8
96;13.11.2012;2012;11;22;Tiistai;7;5;12;1;1;2
96;13.11.2012;2012;11;23;Tiistai;4;0;4;1;0;1
96;14.11.2012;2012;11;00;Keskiviikko;2;2;4;0;0;0
96;14.11.2012;2012;11;01;Keskiviikko;0;1;1;0;0;0
96;14.11.2012;2012;11;02;Keskiviikko;2;0;2;0;0;0
96;14.11.2012;2012;11;03;Keskiviikko;0;0;0;0;0;0
96;14.11.2012;2012;11;04;Keskiviikko;2;1;3;0;0;0
96;14.11.2012;2012;11;05;Keskiviikko;2;16;18;0;0;0
96;14.11.2012;2012;11;06;Keskiviikko;42;39;81;6;3;9
96;14.11.2012;2012;11;07;Keskiviikko;134;102;236;22;10;32
96;14.11.2012;2012;11;08;Keskiviikko;81;82;163;15;12;27
96;14.11.2012;2012;11;09;Keskiviikko;45;71;116;8;19;27
96;14.11.2012;2012;11;10;Keskiviikko;45;51;96;15;14;29
96;14.11.2012;2012;11;11;Keskiviikko;32;49;81;1;9;10
96;14.11.2012;2012;11;12;Keskiviikko;41;55;96;5;4;9
96;14.11.2012;2012;11;13;Keskiviikko;43;61;104;0;4;4
96;14.11.2012;2012;11;14;Keskiviikko;51;106;157;1;5;6
96;14.11.2012;2012;11;15;Keskiviikko;80;196;276;6;22;28
96;14.11.2012;2012;11;16;Keskiviikko;66;139;205;3;17;20
96;14.11.2012;2012;11;17;Keskiviikko;53;72;125;7;13;20
96;14.11.2012;2012;11;18;Keskiviikko;81;33;114;20;9;29
96;14.11.2012;2012;11;19;Keskiviikko;41;31;72;5;11;16
96;14.11.2012;2012;11;20;Keskiviikko;36;36;72;4;5;9
96;14.11.2012;2012;11;21;Keskiviikko;20;48;68;1;6;7
96;14.11.2012;2012;11;22;Keskiviikko;4;7;11;0;1;1
96;14.11.2012;2012;11;23;Keskiviikko;5;9;14;0;1;1
96;15.11.2012;2012;11;00;Torstai;8;0;8;1;0;1
96;15.11.2012;2012;11;01;Torstai;9;1;10;0;0;0
96;15.11.2012;2012;11;02;Torstai;3;0;3;0;0;0
96;15.11.2012;2012;11;03;Torstai;3;0;3;2;0;2
96;15.11.2012;2012;11;04;Torstai;1;1;2;0;1;1
96;15.11.2012;2012;11;05;Torstai;3;9;12;1;0;1
96;15.11.2012;2012;11;06;Torstai;49;26;75;10;6;16
96;15.11.2012;2012;11;07;Torstai;104;98;202;31;10;41
96;15.11.2012;2012;11;08;Torstai;104;67;171;4;5;9
96;15.11.2012;2012;11;09;Torstai;55;83;138;10;9;19
96;15.11.2012;2012;11;10;Torstai;22;32;54;7;2;9
96;15.11.2012;2012;11;11;Torstai;57;61;118;3;6;9
96;15.11.2012;2012;11;12;Torstai;66;64;130;5;8;13
96;15.11.2012;2012;11;13;Torstai;61;69;130;10;13;23
96;15.11.2012;2012;11;14;Torstai;57;108;165;9;16;25
96;15.11.2012;2012;11;15;Torstai;76;175;251;7;34;41
96;15.11.2012;2012;11;16;Torstai;80;107;187;18;29;47
96;15.11.2012;2012;11;17;Torstai;66;59;125;11;16;27
96;15.11.2012;2012;11;18;Torstai;34;39;73;21;14;35
96;15.11.2012;2012;11;19;Torstai;29;18;47;8;14;22
96;15.11.2012;2012;11;20;Torstai;33;28;61;16;13;29
96;15.11.2012;2012;11;21;Torstai;20;14;34;6;6;12
96;15.11.2012;2012;11;22;Torstai;8;9;17;0;1;1
96;15.11.2012;2012;11;23;Torstai;4;5;9;0;0;0
96;16.11.2012;2012;11;00;Perjantai;8;2;10;1;0;1
96;16.11.2012;2012;11;01;Perjantai;7;1;8;0;0;0
96;16.11.2012;2012;11;02;Perjantai;1;1;2;0;0;0
96;16.11.2012;2012;11;03;Perjantai;3;0;3;0;1;1
96;16.11.2012;2012;11;04;Perjantai;1;0;1;0;0;0
96;16.11.2012;2012;11;05;Perjantai;2;9;11;0;1;1
96;16.11.2012;2012;11;06;Perjantai;41;30;71;6;4;10
96;16.11.2012;2012;11;07;Perjantai;101;104;205;25;9;34
96;16.11.2012;2012;11;08;Perjantai;58;62;120;12;8;20
96;16.11.2012;2012;11;09;Perjantai;56;69;125;6;7;13
96;16.11.2012;2012;11;10;Perjantai;48;50;98;6;8;14
96;16.11.2012;2012;11;11;Perjantai;54;45;99;7;12;19
96;16.11.2012;2012;11;12;Perjantai;41;52;93;7;11;18
96;16.11.2012;2012;11;13;Perjantai;54;51;105;6;15;21
96;16.11.2012;2012;11;14;Perjantai;51;96;147;6;17;23
96;16.11.2012;2012;11;15;Perjantai;52;109;161;7;20;27
96;16.11.2012;2012;11;16;Perjantai;43;35;78;6;20;26
96;16.11.2012;2012;11;17;Perjantai;25;21;46;4;5;9
96;16.11.2012;2012;11;18;Perjantai;20;22;42;0;8;8
96;16.11.2012;2012;11;19;Perjantai;9;15;24;7;2;9
96;16.11.2012;2012;11;20;Perjantai;16;8;24;2;2;4
96;16.11.2012;2012;11;21;Perjantai;17;10;27;3;8;11
96;16.11.2012;2012;11;22;Perjantai;5;2;7;1;1;2
96;16.11.2012;2012;11;23;Perjantai;3;1;4;0;2;2
96;17.11.2012;2012;11;00;Lauantai;4;7;11;1;0;1
96;17.11.2012;2012;11;01;Lauantai;3;2;5;2;0;2
96;17.11.2012;2012;11;02;Lauantai;3;0;3;0;0;0
96;17.11.2012;2012;11;03;Lauantai;5;0;5;1;1;2
96;17.11.2012;2012;11;04;Lauantai;3;0;3;5;0;5
96;17.11.2012;2012;11;05;Lauantai;1;3;4;0;0;0
96;17.11.2012;2012;11;06;Lauantai;12;8;20;4;0;4
96;17.11.2012;2012;11;07;Lauantai;6;8;14;0;2;2
96;17.11.2012;2012;11;08;Lauantai;5;9;14;0;5;5
96;17.11.2012;2012;11;09;Lauantai;5;20;25;4;10;14
96;17.11.2012;2012;11;10;Lauantai;6;21;27;1;5;6
96;17.11.2012;2012;11;11;Lauantai;23;32;55;7;12;19
96;17.11.2012;2012;11;12;Lauantai;28;30;58;5;6;11
96;17.11.2012;2012;11;13;Lauantai;28;34;62;5;11;16
96;17.11.2012;2012;11;14;Lauantai;32;39;71;6;11;17
96;17.11.2012;2012;11;15;Lauantai;41;34;75;7;22;29
96;17.11.2012;2012;11;16;Lauantai;29;31;60;6;22;28
96;17.11.2012;2012;11;17;Lauantai;16;18;34;7;8;15
96;17.11.2012;2012;11;18;Lauantai;28;17;45;14;4;18
96;17.11.2012;2012;11;19;Lauantai;27;12;39;24;8;32
96;17.11.2012;2012;11;20;Lauantai;13;18;31;3;7;10
96;17.11.2012;2012;11;21;Lauantai;5;19;24;4;3;7
96;17.11.2012;2012;11;22;Lauantai;8;3;11;2;1;3
96;17.11.2012;2012;11;23;Lauantai;3;17;20;1;2;3
96;18.11.2012;2012;11;00;Sunnuntai;2;7;9;0;1;1
96;18.11.2012;2012;11;01;Sunnuntai;9;3;12;1;0;1
96;18.11.2012;2012;11;02;Sunnuntai;12;1;13;0;0;0
96;18.11.2012;2012;11;03;Sunnuntai;13;1;14;2;0;2
96;18.11.2012;2012;11;04;Sunnuntai;7;3;10;4;0;4
96;18.11.2012;2012;11;05;Sunnuntai;0;4;4;0;0;0
96;18.11.2012;2012;11;06;Sunnuntai;12;4;16;2;0;2
96;18.11.2012;2012;11;07;Sunnuntai;0;6;6;2;2;4
96;18.11.2012;2012;11;08;Sunnuntai;3;5;8;2;2;4
96;18.11.2012;2012;11;09;Sunnuntai;8;8;16;5;4;9
96;18.11.2012;2012;11;10;Sunnuntai;13;9;22;6;4;10
96;18.11.2012;2012;11;11;Sunnuntai;14;21;35;11;15;26
96;18.11.2012;2012;11;12;Sunnuntai;25;31;56;4;15;19
96;18.11.2012;2012;11;13;Sunnuntai;36;37;73;14;15;29
96;18.11.2012;2012;11;14;Sunnuntai;14;30;44;10;12;22
96;18.11.2012;2012;11;15;Sunnuntai;24;18;42;5;11;16
96;18.11.2012;2012;11;16;Sunnuntai;26;22;48;19;8;27
96;18.11.2012;2012;11;17;Sunnuntai;16;17;33;13;10;23
96;18.11.2012;2012;11;18;Sunnuntai;19;17;36;9;16;25
96;18.11.2012;2012;11;19;Sunnuntai;17;8;25;11;10;21
96;18.11.2012;2012;11;20;Sunnuntai;20;10;30;8;9;17
96;18.11.2012;2012;11;21;Sunnuntai;14;31;45;3;12;15
96;18.11.2012;2012;11;22;Sunnuntai;2;5;7;2;1;3
96;18.11.2012;2012;11;23;Sunnuntai;0;1;1;1;0;1
96;19.11.2012;2012;11;00;Maanantai;4;0;4;3;0;3
96;19.11.2012;2012;11;01;Maanantai;0;0;0;2;0;2
96;19.11.2012;2012;11;02;Maanantai;0;0;0;0;1;1
96;19.11.2012;2012;11;03;Maanantai;0;0;0;0;1;1
96;19.11.2012;2012;11;04;Maanantai;1;1;2;0;0;0
96;19.11.2012;2012;11;05;Maanantai;1;9;10;1;2;3
96;19.11.2012;2012;11;06;Maanantai;45;36;81;6;4;10
96;19.11.2012;2012;11;07;Maanantai;114;92;206;19;13;32
96;19.11.2012;2012;11;08;Maanantai;93;86;179;6;4;10
96;19.11.2012;2012;11;09;Maanantai;65;82;147;7;11;18
96;19.11.2012;2012;11;10;Maanantai;42;60;102;3;7;10
96;19.11.2012;2012;11;11;Maanantai;35;56;91;8;10;18
96;19.11.2012;2012;11;12;Maanantai;56;76;132;9;7;16
96;19.11.2012;2012;11;13;Maanantai;63;78;141;3;11;14
96;19.11.2012;2012;11;14;Maanantai;65;93;158;2;13;15
96;19.11.2012;2012;11;15;Maanantai;79;161;240;8;24;32
96;19.11.2012;2012;11;16;Maanantai;94;102;196;13;24;37
96;19.11.2012;2012;11;17;Maanantai;49;65;114;10;13;23
96;19.11.2012;2012;11;18;Maanantai;49;51;100;13;23;36
96;19.11.2012;2012;11;19;Maanantai;50;32;82;17;13;30
96;19.11.2012;2012;11;20;Maanantai;35;27;62;9;13;22
96;19.11.2012;2012;11;21;Maanantai;19;14;33;5;7;12
96;19.11.2012;2012;11;22;Maanantai;8;7;15;1;2;3
96;19.11.2012;2012;11;23;Maanantai;1;2;3;2;1;3
96;20.11.2012;2012;11;00;Tiistai;3;1;4;1;0;1
96;20.11.2012;2012;11;01;Tiistai;4;0;4;0;0;0
96;20.11.2012;2012;11;02;Tiistai;3;1;4;0;0;0
96;20.11.2012;2012;11;03;Tiistai;0;1;1;0;0;0
96;20.11.2012;2012;11;04;Tiistai;2;3;5;0;0;0
96;20.11.2012;2012;11;05;Tiistai;4;8;12;0;0;0
96;20.11.2012;2012;11;06;Tiistai;45;38;83;8;2;10
96;20.11.2012;2012;11;07;Tiistai;132;99;231;14;13;27
96;20.11.2012;2012;11;08;Tiistai;85;99;184;6;10;16
96;20.11.2012;2012;11;09;Tiistai;56;61;117;3;12;15
96;20.11.2012;2012;11;10;Tiistai;37;43;80;4;8;12
96;20.11.2012;2012;11;11;Tiistai;44;45;89;1;4;5
96;20.11.2012;2012;11;12;Tiistai;49;51;100;3;8;11
96;20.11.2012;2012;11;13;Tiistai;45;47;92;8;8;16
96;20.11.2012;2012;11;14;Tiistai;55;86;141;5;12;17
96;20.11.2012;2012;11;15;Tiistai;83;176;259;2;29;31
96;20.11.2012;2012;11;16;Tiistai;75;110;185;8;32;40
96;20.11.2012;2012;11;17;Tiistai;47;81;128;9;6;15
96;20.11.2012;2012;11;18;Tiistai;43;33;76;8;13;21
96;20.11.2012;2012;11;19;Tiistai;34;26;60;10;13;23
96;20.11.2012;2012;11;20;Tiistai;35;25;60;5;12;17
96;20.11.2012;2012;11;21;Tiistai;23;14;37;2;5;7
96;20.11.2012;2012;11;22;Tiistai;8;3;11;0;2;2
96;20.11.2012;2012;11;23;Tiistai;11;1;12;1;0;1
96;21.11.2012;2012;11;00;Keskiviikko;1;0;1;0;0;0
96;21.11.2012;2012;11;01;Keskiviikko;2;1;3;0;0;0
96;21.11.2012;2012;11;02;Keskiviikko;2;1;3;0;0;0
96;21.11.2012;2012;11;03;Keskiviikko;0;0;0;0;0;0
96;21.11.2012;2012;11;04;Keskiviikko;1;1;2;0;0;0
96;21.11.2012;2012;11;05;Keskiviikko;2;14;16;0;0;0
96;21.11.2012;2012;11;06;Keskiviikko;44;37;81;3;4;7
96;21.11.2012;2012;11;07;Keskiviikko;130;123;253;11;9;20
96;21.11.2012;2012;11;08;Keskiviikko;98;97;195;2;7;9
96;21.11.2012;2012;11;09;Keskiviikko;35;66;101;7;4;11
96;21.11.2012;2012;11;10;Keskiviikko;33;43;76;4;7;11
96;21.11.2012;2012;11;11;Keskiviikko;37;45;82;3;7;10
96;21.11.2012;2012;11;12;Keskiviikko;60;66;126;5;10;15
96;21.11.2012;2012;11;13;Keskiviikko;36;61;97;2;6;8
96;21.11.2012;2012;11;14;Keskiviikko;57;94;151;1;11;12
96;21.11.2012;2012;11;15;Keskiviikko;76;163;239;5;22;27
96;21.11.2012;2012;11;16;Keskiviikko;75;123;198;7;20;27
96;21.11.2012;2012;11;17;Keskiviikko;53;67;120;5;10;15
96;21.11.2012;2012;11;18;Keskiviikko;70;48;118;16;16;32
96;21.11.2012;2012;11;19;Keskiviikko;46;34;80;12;11;23
96;21.11.2012;2012;11;20;Keskiviikko;32;25;57;5;13;18
96;21.11.2012;2012;11;21;Keskiviikko;19;34;53;2;3;5
96;21.11.2012;2012;11;22;Keskiviikko;10;2;12;1;1;2
96;21.11.2012;2012;11;23;Keskiviikko;3;4;7;1;0;1
96;22.11.2012;2012;11;00;Torstai;3;0;3;0;1;1
96;22.11.2012;2012;11;01;Torstai;4;0;4;0;0;0
96;22.11.2012;2012;11;02;Torstai;0;1;1;0;0;0
96;22.11.2012;2012;11;03;Torstai;1;1;2;0;0;0
96;22.11.2012;2012;11;04;Torstai;5;1;6;0;0;0
96;22.11.2012;2012;11;05;Torstai;1;11;12;0;0;0
96;22.11.2012;2012;11;06;Torstai;39;29;68;4;5;9
96;22.11.2012;2012;11;07;Torstai;107;96;203;13;15;28
96;22.11.2012;2012;11;08;Torstai;91;73;164;4;12;16
96;22.11.2012;2012;11;09;Torstai;54;65;119;9;7;16
96;22.11.2012;2012;11;10;Torstai;29;43;72;4;11;15
96;22.11.2012;2012;11;11;Torstai;41;59;100;6;7;13
96;22.11.2012;2012;11;12;Torstai;59;66;125;7;11;18
96;22.11.2012;2012;11;13;Torstai;57;74;131;14;15;29
96;22.11.2012;2012;11;14;Torstai;50;91;141;8;18;26
96;22.11.2012;2012;11;15;Torstai;89;184;273;6;28;34
96;22.11.2012;2012;11;16;Torstai;66;112;178;9;22;31
96;22.11.2012;2012;11;17;Torstai;53;53;106;10;17;27
96;22.11.2012;2012;11;18;Torstai;54;38;92;5;9;14
96;22.11.2012;2012;11;19;Torstai;35;23;58;13;8;21
96;22.11.2012;2012;11;20;Torstai;35;14;49;13;1;14
96;22.11.2012;2012;11;21;Torstai;15;18;33;5;6;11
96;22.11.2012;2012;11;22;Torstai;10;8;18;0;2;2
96;22.11.2012;2012;11;23;Torstai;3;4;7;0;1;1
96;23.11.2012;2012;11;00;Perjantai;3;1;4;0;1;1
96;23.11.2012;2012;11;01;Perjantai;1;1;2;0;0;0
96;23.11.2012;2012;11;02;Perjantai;3;1;4;0;0;0
96;23.11.2012;2012;11;03;Perjantai;5;2;7;2;0;2
96;23.11.2012;2012;11;04;Perjantai;6;0;6;0;1;1
96;23.11.2012;2012;11;05;Perjantai;4;5;9;0;0;0
96;23.11.2012;2012;11;06;Perjantai;33;37;70;5;6;11
96;23.11.2012;2012;11;07;Perjantai;107;72;179;18;8;26
96;23.11.2012;2012;11;08;Perjantai;64;71;135;4;5;9
96;23.11.2012;2012;11;09;Perjantai;55;55;110;5;6;11
96;23.11.2012;2012;11;10;Perjantai;33;42;75;5;14;19
96;23.11.2012;2012;11;11;Perjantai;34;52;86;11;8;19
96;23.11.2012;2012;11;12;Perjantai;49;61;110;4;10;14
96;23.11.2012;2012;11;13;Perjantai;48;68;116;3;15;18
96;23.11.2012;2012;11;14;Perjantai;40;122;162;4;19;23
96;23.11.2012;2012;11;15;Perjantai;59;117;176;10;16;26
96;23.11.2012;2012;11;16;Perjantai;75;59;134;5;11;16
96;23.11.2012;2012;11;17;Perjantai;29;39;68;7;10;17
96;23.11.2012;2012;11;18;Perjantai;24;37;61;7;8;15
96;23.11.2012;2012;11;19;Perjantai;30;23;53;6;4;10
96;23.11.2012;2012;11;20;Perjantai;19;11;30;7;6;13
96;23.11.2012;2012;11;21;Perjantai;10;19;29;3;8;11
96;23.11.2012;2012;11;22;Perjantai;6;15;21;1;1;2
96;23.11.2012;2012;11;23;Perjantai;12;4;16;0;1;1
96;24.11.2012;2012;11;00;Lauantai;4;2;6;2;0;2
96;24.11.2012;2012;11;01;Lauantai;9;2;11;0;1;1
96;24.11.2012;2012;11;02;Lauantai;8;0;8;0;0;0
96;24.11.2012;2012;11;03;Lauantai;12;1;13;3;0;3
96;24.11.2012;2012;11;04;Lauantai;5;4;9;1;1;2
96;24.11.2012;2012;11;05;Lauantai;6;7;13;1;0;1
96;24.11.2012;2012;11;06;Lauantai;9;7;16;2;0;2
96;24.11.2012;2012;11;07;Lauantai;6;11;17;1;2;3
96;24.11.2012;2012;11;08;Lauantai;3;20;23;3;9;12
96;24.11.2012;2012;11;09;Lauantai;14;43;57;1;6;7
96;24.11.2012;2012;11;10;Lauantai;19;29;48;6;8;14
96;24.11.2012;2012;11;11;Lauantai;33;34;67;7;13;20
96;24.11.2012;2012;11;12;Lauantai;38;53;91;7;18;25
96;24.11.2012;2012;11;13;Lauantai;46;35;81;9;12;21
96;24.11.2012;2012;11;14;Lauantai;27;45;72;7;7;14
96;24.11.2012;2012;11;15;Lauantai;38;42;80;4;8;12
96;24.11.2012;2012;11;16;Lauantai;45;39;84;10;15;25
96;24.11.2012;2012;11;17;Lauantai;41;26;67;9;7;16
96;24.11.2012;2012;11;18;Lauantai;22;24;46;10;3;13
96;24.11.2012;2012;11;19;Lauantai;33;18;51;16;7;23
96;24.11.2012;2012;11;20;Lauantai;10;13;23;7;2;9
96;24.11.2012;2012;11;21;Lauantai;10;18;28;1;6;7
96;24.11.2012;2012;11;22;Lauantai;2;24;26;0;3;3
96;24.11.2012;2012;11;23;Lauantai;6;13;19;1;1;2
96;25.11.2012;2012;11;00;Sunnuntai;7;8;15;1;2;3
96;25.11.2012;2012;11;01;Sunnuntai;12;5;17;2;1;3
96;25.11.2012;2012;11;02;Sunnuntai;10;2;12;3;0;3
96;25.11.2012;2012;11;03;Sunnuntai;13;0;13;1;1;2
96;25.11.2012;2012;11;04;Sunnuntai;6;4;10;2;1;3
96;25.11.2012;2012;11;05;Sunnuntai;4;2;6;0;0;0
96;25.11.2012;2012;11;06;Sunnuntai;13;2;15;1;0;1
96;25.11.2012;2012;11;07;Sunnuntai;2;8;10;1;6;7
96;25.11.2012;2012;11;08;Sunnuntai;2;5;7;3;1;4
96;25.11.2012;2012;11;09;Sunnuntai;6;11;17;4;3;7
96;25.11.2012;2012;11;10;Sunnuntai;10;9;19;3;12;15
96;25.11.2012;2012;11;11;Sunnuntai;19;31;50;5;6;11
96;25.11.2012;2012;11;12;Sunnuntai;29;48;77;8;10;18
96;25.11.2012;2012;11;13;Sunnuntai;44;26;70;11;9;20
96;25.11.2012;2012;11;14;Sunnuntai;22;44;66;6;8;14
96;25.11.2012;2012;11;15;Sunnuntai;33;43;76;10;7;17
96;25.11.2012;2012;11;16;Sunnuntai;45;28;73;18;12;30
96;25.11.2012;2012;11;17;Sunnuntai;33;14;47;12;7;19
96;25.11.2012;2012;11;18;Sunnuntai;18;20;38;13;16;29
96;25.11.2012;2012;11;19;Sunnuntai;22;14;36;7;15;22
96;25.11.2012;2012;11;20;Sunnuntai;11;23;34;10;11;21
96;25.11.2012;2012;11;21;Sunnuntai;10;18;28;0;3;3
96;25.11.2012;2012;11;22;Sunnuntai;4;5;9;1;4;5
96;25.11.2012;2012;11;23;Sunnuntai;5;3;8;0;2;2
96;26.11.2012;2012;11;00;Maanantai;3;2;5;3;1;4
96;26.11.2012;2012;11;01;Maanantai;0;1;1;0;1;1
96;26.11.2012;2012;11;02;Maanantai;1;1;2;0;0;0
96;26.11.2012;2012;11;03;Maanantai;3;0;3;1;0;1
96;26.11.2012;2012;11;04;Maanantai;1;1;2;0;0;0
96;26.11.2012;2012;11;05;Maanantai;3;11;14;2;0;2
96;26.11.2012;2012;11;06;Maanantai;48;31;79;7;7;14
96;26.11.2012;2012;11;07;Maanantai;124;96;220;23;13;36
96;26.11.2012;2012;11;08;Maanantai;88;80;168;7;13;20
96;26.11.2012;2012;11;09;Maanantai;47;67;114;7;12;19
96;26.11.2012;2012;11;10;Maanantai;42;58;100;3;7;10
96;26.11.2012;2012;11;11;Maanantai;44;52;96;7;6;13
96;26.11.2012;2012;11;12;Maanantai;60;47;107;14;17;31
96;26.11.2012;2012;11;13;Maanantai;39;59;98;6;10;16
96;26.11.2012;2012;11;14;Maanantai;53;103;156;10;18;28
96;26.11.2012;2012;11;15;Maanantai;87;189;276;5;36;41
96;26.11.2012;2012;11;16;Maanantai;79;115;194;10;20;30
96;26.11.2012;2012;11;17;Maanantai;48;69;117;10;17;27
96;26.11.2012;2012;11;18;Maanantai;58;37;95;19;17;36
96;26.11.2012;2012;11;19;Maanantai;39;20;59;6;13;19
96;26.11.2012;2012;11;20;Maanantai;36;24;60;7;7;14
96;26.11.2012;2012;11;21;Maanantai;19;17;36;5;7;12
96;26.11.2012;2012;11;22;Maanantai;10;5;15;3;5;8
96;26.11.2012;2012;11;23;Maanantai;1;0;1;0;0;0
96;27.11.2012;2012;11;00;Tiistai;1;0;1;0;1;1
96;27.11.2012;2012;11;01;Tiistai;2;2;4;0;0;0
96;27.11.2012;2012;11;02;Tiistai;0;0;0;1;0;1
96;27.11.2012;2012;11;03;Tiistai;0;0;0;1;0;1
96;27.11.2012;2012;11;04;Tiistai;2;2;4;1;1;2
96;27.11.2012;2012;11;05;Tiistai;3;17;20;0;0;0
96;27.11.2012;2012;11;06;Tiistai;49;29;78;6;3;9
96;27.11.2012;2012;11;07;Tiistai;121;110;231;19;19;38
96;27.11.2012;2012;11;08;Tiistai;76;95;171;4;5;9
96;27.11.2012;2012;11;09;Tiistai;62;67;129;10;9;19
96;27.11.2012;2012;11;10;Tiistai;36;62;98;7;12;19
96;27.11.2012;2012;11;11;Tiistai;37;67;104;2;12;14
96;27.11.2012;2012;11;12;Tiistai;57;65;122;6;10;16
96;27.11.2012;2012;11;13;Tiistai;54;61;115;7;7;14
96;27.11.2012;2012;11;14;Tiistai;62;82;144;11;17;28
96;27.11.2012;2012;11;15;Tiistai;69;176;245;5;33;38
96;27.11.2012;2012;11;16;Tiistai;75;113;188;11;29;40
96;27.11.2012;2012;11;17;Tiistai;41;73;114;17;18;35
96;27.11.2012;2012;11;18;Tiistai;42;40;82;13;11;24
96;27.11.2012;2012;11;19;Tiistai;38;31;69;13;14;27
96;27.11.2012;2012;11;20;Tiistai;43;23;66;7;11;18
96;27.11.2012;2012;11;21;Tiistai;16;20;36;4;5;9
96;27.11.2012;2012;11;22;Tiistai;8;3;11;1;3;4
96;27.11.2012;2012;11;23;Tiistai;8;1;9;4;0;4
96;28.11.2012;2012;11;00;Keskiviikko;5;0;5;0;1;1
96;28.11.2012;2012;11;01;Keskiviikko;1;0;1;0;0;0
96;28.11.2012;2012;11;02;Keskiviikko;2;0;2;0;0;0
96;28.11.2012;2012;11;03;Keskiviikko;4;0;4;1;0;1
96;28.11.2012;2012;11;04;Keskiviikko;5;3;8;0;1;1
96;28.11.2012;2012;11;05;Keskiviikko;2;13;15;2;1;3
96;28.11.2012;2012;11;06;Keskiviikko;48;31;79;9;6;15
96;28.11.2012;2012;11;07;Keskiviikko;117;97;214;19;13;32
96;28.11.2012;2012;11;08;Keskiviikko;88;71;159;16;7;23
96;28.11.2012;2012;11;09;Keskiviikko;39;45;84;5;21;26
96;28.11.2012;2012;11;10;Keskiviikko;35;51;86;12;8;20
96;28.11.2012;2012;11;11;Keskiviikko;47;55;102;4;12;16
96;28.11.2012;2012;11;12;Keskiviikko;56;54;110;13;19;32
96;28.11.2012;2012;11;13;Keskiviikko;48;57;105;4;13;17
96;28.11.2012;2012;11;14;Keskiviikko;62;75;137;7;13;20
96;28.11.2012;2012;11;15;Keskiviikko;68;179;247;9;38;47
96;28.11.2012;2012;11;16;Keskiviikko;62;123;185;4;23;27
96;28.11.2012;2012;11;17;Keskiviikko;52;60;112;12;24;36
96;28.11.2012;2012;11;18;Keskiviikko;66;32;98;23;19;42
96;28.11.2012;2012;11;19;Keskiviikko;35;30;65;8;12;20
96;28.11.2012;2012;11;20;Keskiviikko;32;20;52;7;14;21
96;28.11.2012;2012;11;21;Keskiviikko;16;30;46;1;9;10
96;28.11.2012;2012;11;22;Keskiviikko;8;4;12;0;0;0
96;28.11.2012;2012;11;23;Keskiviikko;4;1;5;0;0;0
96;29.11.2012;2012;11;00;Torstai;3;5;8;0;0;0
96;29.11.2012;2012;11;01;Torstai;2;0;2;0;0;0
96;29.11.2012;2012;11;02;Torstai;1;0;1;1;0;1
96;29.11.2012;2012;11;03;Torstai;1;0;1;0;0;0
96;29.11.2012;2012;11;04;Torstai;1;2;3;0;0;0
96;29.11.2012;2012;11;05;Torstai;4;12;16;0;0;0
96;29.11.2012;2012;11;06;Torstai;39;28;67;9;4;13
96;29.11.2012;2012;11;07;Torstai;78;55;133;19;10;29
96;29.11.2012;2012;11;08;Torstai;109;78;187;8;9;17
96;29.11.2012;2012;11;09;Torstai;32;58;90;4;5;9
96;29.11.2012;2012;11;10;Torstai;41;48;89;3;7;10
96;29.11.2012;2012;11;11;Torstai;34;48;82;6;8;14
96;29.11.2012;2012;11;12;Torstai;53;43;96;7;8;15
96;29.11.2012;2012;11;13;Torstai;30;40;70;4;8;12
96;29.11.2012;2012;11;14;Torstai;50;79;129;5;19;24
96;29.11.2012;2012;11;15;Torstai;54;136;190;4;32;36
96;29.11.2012;2012;11;16;Torstai;71;119;190;5;35;40
96;29.11.2012;2012;11;17;Torstai;73;64;137;9;15;24
96;29.11.2012;2012;11;18;Torstai;32;45;77;7;10;17
96;29.11.2012;2012;11;19;Torstai;42;20;62;8;9;17
96;29.11.2012;2012;11;20;Torstai;40;21;61;6;9;15
96;29.11.2012;2012;11;21;Torstai;13;23;36;4;9;13
96;29.11.2012;2012;11;22;Torstai;6;3;9;1;3;4
96;29.11.2012;2012;11;23;Torstai;3;0;3;0;0;0
96;30.11.2012;2012;11;00;Perjantai;4;0;4;0;0;0
96;30.11.2012;2012;11;01;Perjantai;3;1;4;1;1;2
96;30.11.2012;2012;11;02;Perjantai;5;1;6;1;0;1
96;30.11.2012;2012;11;03;Perjantai;3;0;3;1;0;1
96;30.11.2012;2012;11;04;Perjantai;5;0;5;2;0;2
96;30.11.2012;2012;11;05;Perjantai;1;11;12;0;1;1
96;30.11.2012;2012;11;06;Perjantai;33;19;52;5;2;7
96;30.11.2012;2012;11;07;Perjantai;73;43;116;10;4;14
96;30.11.2012;2012;11;08;Perjantai;94;59;153;5;5;10
96;30.11.2012;2012;11;09;Perjantai;27;57;84;9;5;14
96;30.11.2012;2012;11;10;Perjantai;29;46;75;4;15;19
96;30.11.2012;2012;11;11;Perjantai;38;41;79;5;10;15
96;30.11.2012;2012;11;12;Perjantai;32;45;77;13;15;28
96;30.11.2012;2012;11;13;Perjantai;50;51;101;2;19;21
96;30.11.2012;2012;11;14;Perjantai;41;70;111;4;21;25
96;30.11.2012;2012;11;15;Perjantai;54;108;162;2;24;26
96;30.11.2012;2012;11;16;Perjantai;42;56;98;8;19;27
96;30.11.2012;2012;11;17;Perjantai;33;41;74;8;6;14
96;30.11.2012;2012;11;18;Perjantai;29;25;54;6;2;8
96;30.11.2012;2012;11;19;Perjantai;15;9;24;4;4;8
96;30.11.2012;2012;11;20;Perjantai;18;11;29;5;2;7
96;30.11.2012;2012;11;21;Perjantai;9;17;26;4;4;8
96;30.11.2012;2012;11;22;Perjantai;5;7;12;1;2;3
96;30.11.2012;2012;11;23;Perjantai;6;4;10;2;0;2
96;01.12.2012;2012;12;00;Lauantai;7;5;12;2;1;3
96;01.12.2012;2012;12;01;Lauantai;3;2;5;0;1;1
96;01.12.2012;2012;12;02;Lauantai;6;1;7;0;0;0
96;01.12.2012;2012;12;03;Lauantai;4;0;4;3;0;3
96;01.12.2012;2012;12;04;Lauantai;2;0;2;1;0;1
96;01.12.2012;2012;12;05;Lauantai;2;3;5;1;0;1
96;01.12.2012;2012;12;06;Lauantai;19;5;24;4;0;4
96;01.12.2012;2012;12;07;Lauantai;5;15;20;0;3;3
96;01.12.2012;2012;12;08;Lauantai;11;12;23;0;4;4
96;01.12.2012;2012;12;09;Lauantai;9;22;31;6;9;15
96;01.12.2012;2012;12;10;Lauantai;11;14;25;3;4;7
96;01.12.2012;2012;12;11;Lauantai;14;22;36;2;4;6
96;01.12.2012;2012;12;12;Lauantai;14;38;52;6;10;16
96;01.12.2012;2012;12;13;Lauantai;27;28;55;7;9;16
96;01.12.2012;2012;12;14;Lauantai;19;28;47;3;14;17
96;01.12.2012;2012;12;15;Lauantai;25;31;56;6;14;20
96;01.12.2012;2012;12;16;Lauantai;20;29;49;1;17;18
96;01.12.2012;2012;12;17;Lauantai;25;15;40;2;7;9
96;01.12.2012;2012;12;18;Lauantai;17;13;30;10;5;15
96;01.12.2012;2012;12;19;Lauantai;26;8;34;13;6;19
96;01.12.2012;2012;12;20;Lauantai;7;17;24;6;5;11
96;01.12.2012;2012;12;21;Lauantai;7;12;19;4;4;8
96;01.12.2012;2012;12;22;Lauantai;8;4;12;2;0;2
96;01.12.2012;2012;12;23;Lauantai;3;3;6;2;0;2
96;02.12.2012;2012;12;00;Sunnuntai;9;1;10;2;2;4
96;02.12.2012;2012;12;01;Sunnuntai;12;1;13;1;0;1
96;02.12.2012;2012;12;02;Sunnuntai;8;3;11;3;0;3
96;02.12.2012;2012;12;03;Sunnuntai;5;1;6;2;0;2
96;02.12.2012;2012;12;04;Sunnuntai;6;1;7;0;0;0
96;02.12.2012;2012;12;05;Sunnuntai;6;0;6;0;0;0
96;02.12.2012;2012;12;06;Sunnuntai;14;2;16;5;1;6
96;02.12.2012;2012;12;07;Sunnuntai;2;6;8;3;4;7
96;02.12.2012;2012;12;08;Sunnuntai;2;3;5;1;1;2
96;02.12.2012;2012;12;09;Sunnuntai;1;13;14;8;5;13
96;02.12.2012;2012;12;10;Sunnuntai;5;6;11;8;11;19
96;02.12.2012;2012;12;11;Sunnuntai;7;20;27;9;10;19
96;02.12.2012;2012;12;12;Sunnuntai;17;23;40;11;14;25
96;02.12.2012;2012;12;13;Sunnuntai;19;18;37;10;13;23
96;02.12.2012;2012;12;14;Sunnuntai;22;23;45;11;12;23
96;02.12.2012;2012;12;15;Sunnuntai;13;20;33;16;8;24
96;02.12.2012;2012;12;16;Sunnuntai;23;8;31;21;5;26
96;02.12.2012;2012;12;17;Sunnuntai;22;18;40;19;5;24
96;02.12.2012;2012;12;18;Sunnuntai;19;14;33;8;17;25
96;02.12.2012;2012;12;19;Sunnuntai;19;15;34;10;8;18
96;02.12.2012;2012;12;20;Sunnuntai;21;13;34;9;7;16
96;02.12.2012;2012;12;21;Sunnuntai;14;11;25;4;3;7
96;02.12.2012;2012;12;22;Sunnuntai;2;1;3;1;0;1
96;02.12.2012;2012;12;23;Sunnuntai;5;2;7;0;0;0
96;03.12.2012;2012;12;00;Maanantai;1;1;2;0;0;0
96;03.12.2012;2012;12;01;Maanantai;1;0;1;0;0;0
96;03.12.2012;2012;12;02;Maanantai;1;0;1;0;0;0
96;03.12.2012;2012;12;03;Maanantai;0;1;1;4;2;6
96;03.12.2012;2012;12;04;Maanantai;1;1;2;0;0;0
96;03.12.2012;2012;12;05;Maanantai;1;9;10;0;0;0
96;03.12.2012;2012;12;06;Maanantai;28;18;46;17;5;22
96;03.12.2012;2012;12;07;Maanantai;83;39;122;27;13;40
96;03.12.2012;2012;12;08;Maanantai;97;58;155;17;10;27
96;03.12.2012;2012;12;09;Maanantai;37;43;80;11;11;22
96;03.12.2012;2012;12;10;Maanantai;32;32;64;11;8;19
96;03.12.2012;2012;12;11;Maanantai;46;35;81;11;8;19
96;03.12.2012;2012;12;12;Maanantai;41;33;74;15;14;29
96;03.12.2012;2012;12;13;Maanantai;37;32;69;6;14;20
96;03.12.2012;2012;12;14;Maanantai;40;63;103;8;19;27
96;03.12.2012;2012;12;15;Maanantai;48;93;141;3;33;36
96;03.12.2012;2012;12;16;Maanantai;47;118;165;14;49;63
96;03.12.2012;2012;12;17;Maanantai;39;56;95;9;13;22
96;03.12.2012;2012;12;18;Maanantai;27;27;54;10;10;20
96;03.12.2012;2012;12;19;Maanantai;35;7;42;4;9;13
96;03.12.2012;2012;12;20;Maanantai;26;17;43;5;6;11
96;03.12.2012;2012;12;21;Maanantai;14;14;28;4;6;10
96;03.12.2012;2012;12;22;Maanantai;6;6;12;0;0;0
96;03.12.2012;2012;12;23;Maanantai;1;0;1;1;1;2
96;04.12.2012;2012;12;00;Tiistai;3;0;3;0;0;0
96;04.12.2012;2012;12;01;Tiistai;0;0;0;0;0;0
96;04.12.2012;2012;12;02;Tiistai;0;0;0;0;0;0
96;04.12.2012;2012;12;03;Tiistai;0;0;0;1;0;1
96;04.12.2012;2012;12;04;Tiistai;1;0;1;0;1;1
96;04.12.2012;2012;12;05;Tiistai;2;7;9;1;0;1
96;04.12.2012;2012;12;06;Tiistai;32;21;53;17;3;20
96;04.12.2012;2012;12;07;Tiistai;107;64;171;49;10;59
96;04.12.2012;2012;12;08;Tiistai;64;48;112;11;3;14
96;04.12.2012;2012;12;09;Tiistai;40;39;79;11;9;20
96;04.12.2012;2012;12;10;Tiistai;34;24;58;5;6;11
96;04.12.2012;2012;12;11;Tiistai;35;32;67;10;11;21
96;04.12.2012;2012;12;12;Tiistai;31;31;62;8;8;16
96;04.12.2012;2012;12;13;Tiistai;34;40;74;9;16;25
96;04.12.2012;2012;12;14;Tiistai;35;51;86;9;20;29
96;04.12.2012;2012;12;15;Tiistai;42;107;149;13;45;58
96;04.12.2012;2012;12;16;Tiistai;37;66;103;8;35;43
96;04.12.2012;2012;12;17;Tiistai;30;41;71;1;16;17
96;04.12.2012;2012;12;18;Tiistai;27;20;47;8;9;17
96;04.12.2012;2012;12;19;Tiistai;21;15;36;7;6;13
96;04.12.2012;2012;12;20;Tiistai;18;17;35;7;7;14
96;04.12.2012;2012;12;21;Tiistai;12;12;24;5;7;12
96;04.12.2012;2012;12;22;Tiistai;4;3;7;2;0;2
96;04.12.2012;2012;12;23;Tiistai;2;1;3;0;0;0
96;05.12.2012;2012;12;00;Keskiviikko;3;0;3;1;0;1
96;05.12.2012;2012;12;01;Keskiviikko;0;0;0;0;0;0
96;05.12.2012;2012;12;02;Keskiviikko;1;1;2;0;0;0
96;05.12.2012;2012;12;03;Keskiviikko;1;0;1;0;0;0
96;05.12.2012;2012;12;04;Keskiviikko;1;1;2;0;0;0
96;05.12.2012;2012;12;05;Keskiviikko;3;8;11;1;2;3
96;05.12.2012;2012;12;06;Keskiviikko;32;20;52;18;4;22
96;05.12.2012;2012;12;07;Keskiviikko;96;66;162;32;18;50
96;05.12.2012;2012;12;08;Keskiviikko;91;58;149;11;17;28
96;05.12.2012;2012;12;09;Keskiviikko;35;39;74;7;8;15
96;05.12.2012;2012;12;10;Keskiviikko;41;39;80;20;17;37
96;05.12.2012;2012;12;11;Keskiviikko;22;43;65;10;7;17
96;05.12.2012;2012;12;12;Keskiviikko;43;55;98;13;17;30
96;05.12.2012;2012;12;13;Keskiviikko;45;48;93;5;10;15
96;05.12.2012;2012;12;14;Keskiviikko;40;68;108;9;23;32
96;05.12.2012;2012;12;15;Keskiviikko;47;130;177;6;38;44
96;05.12.2012;2012;12;16;Keskiviikko;56;75;131;9;32;41
96;05.12.2012;2012;12;17;Keskiviikko;39;36;75;7;12;19
96;05.12.2012;2012;12;18;Keskiviikko;32;22;54;15;12;27
96;05.12.2012;2012;12;19;Keskiviikko;34;18;52;4;4;8
96;05.12.2012;2012;12;20;Keskiviikko;19;18;37;9;8;17
96;05.12.2012;2012;12;21;Keskiviikko;13;15;28;2;5;7
96;05.12.2012;2012;12;22;Keskiviikko;8;7;15;0;1;1
96;05.12.2012;2012;12;23;Keskiviikko;4;1;5;0;0;0
96;06.12.2012;2012;12;00;Torstai;6;1;7;3;0;3
96;06.12.2012;2012;12;01;Torstai;5;1;6;2;0;2
96;06.12.2012;2012;12;02;Torstai;1;0;1;2;0;2
96;06.12.2012;2012;12;03;Torstai;7;1;8;3;0;3
96;06.12.2012;2012;12;04;Torstai;2;0;2;2;0;2
96;06.12.2012;2012;12;05;Torstai;1;3;4;0;0;0
96;06.12.2012;2012;12;06;Torstai;12;0;12;6;1;7
96;06.12.2012;2012;12;07;Torstai;3;6;9;0;4;4
96;06.12.2012;2012;12;08;Torstai;2;1;3;0;3;3
96;06.12.2012;2012;12;09;Torstai;3;3;6;1;2;3
96;06.12.2012;2012;12;10;Torstai;5;5;10;7;2;9
96;06.12.2012;2012;12;11;Torstai;9;11;20;4;8;12
96;06.12.2012;2012;12;12;Torstai;10;7;17;4;5;9
96;06.12.2012;2012;12;13;Torstai;11;11;22;11;6;17
96;06.12.2012;2012;12;14;Torstai;11;14;25;14;6;20
96;06.12.2012;2012;12;15;Torstai;9;15;24;4;11;15
96;06.12.2012;2012;12;16;Torstai;12;6;18;5;9;14
96;06.12.2012;2012;12;17;Torstai;5;11;16;4;6;10
96;06.12.2012;2012;12;18;Torstai;7;7;14;2;3;5
96;06.12.2012;2012;12;19;Torstai;4;3;7;2;3;5
96;06.12.2012;2012;12;20;Torstai;2;5;7;3;3;6
96;06.12.2012;2012;12;21;Torstai;7;8;15;3;3;6
96;06.12.2012;2012;12;22;Torstai;4;1;5;0;3;3
96;06.12.2012;2012;12;23;Torstai;5;0;5;0;0;0
96;07.12.2012;2012;12;00;Perjantai;0;0;0;0;0;0
96;07.12.2012;2012;12;01;Perjantai;0;0;0;1;0;1
96;07.12.2012;2012;12;02;Perjantai;0;0;0;0;0;0
96;07.12.2012;2012;12;03;Perjantai;0;0;0;0;0;0
96;07.12.2012;2012;12;04;Perjantai;1;1;2;2;0;2
96;07.12.2012;2012;12;05;Perjantai;1;6;7;1;0;1
96;07.12.2012;2012;12;06;Perjantai;33;17;50;9;4;13
96;07.12.2012;2012;12;07;Perjantai;41;20;61;13;4;17
96;07.12.2012;2012;12;08;Perjantai;24;27;51;4;5;9
96;07.12.2012;2012;12;09;Perjantai;21;18;39;6;12;18
96;07.12.2012;2012;12;10;Perjantai;18;28;46;7;9;16
96;07.12.2012;2012;12;11;Perjantai;15;34;49;6;7;13
96;07.12.2012;2012;12;12;Perjantai;33;40;73;8;11;19
96;07.12.2012;2012;12;13;Perjantai;29;47;76;12;13;25
96;07.12.2012;2012;12;14;Perjantai;39;60;99;7;29;36
96;07.12.2012;2012;12;15;Perjantai;45;47;92;7;26;33
96;07.12.2012;2012;12;16;Perjantai;29;37;66;8;5;13
96;07.12.2012;2012;12;17;Perjantai;25;19;44;11;9;20
96;07.12.2012;2012;12;18;Perjantai;27;25;52;4;9;13
96;07.12.2012;2012;12;19;Perjantai;17;12;29;5;10;15
96;07.12.2012;2012;12;20;Perjantai;15;11;26;7;4;11
96;07.12.2012;2012;12;21;Perjantai;22;14;36;4;6;10
96;07.12.2012;2012;12;22;Perjantai;3;1;4;2;2;4
96;07.12.2012;2012;12;23;Perjantai;3;3;6;1;1;2
96;08.12.2012;2012;12;00;Lauantai;3;7;10;0;2;2
96;08.12.2012;2012;12;01;Lauantai;4;1;5;1;1;2
96;08.12.2012;2012;12;02;Lauantai;5;0;5;3;0;3
96;08.12.2012;2012;12;03;Lauantai;9;2;11;0;0;0
96;08.12.2012;2012;12;04;Lauantai;3;1;4;0;0;0
96;08.12.2012;2012;12;05;Lauantai;0;3;3;1;0;1
96;08.12.2012;2012;12;06;Lauantai;5;4;9;3;1;4
96;08.12.2012;2012;12;07;Lauantai;1;7;8;1;3;4
96;08.12.2012;2012;12;08;Lauantai;4;11;15;2;7;9
96;08.12.2012;2012;12;09;Lauantai;4;29;33;2;8;10
96;08.12.2012;2012;12;10;Lauantai;13;17;30;4;12;16
96;08.12.2012;2012;12;11;Lauantai;16;23;39;5;13;18
96;08.12.2012;2012;12;12;Lauantai;16;24;40;11;12;23
96;08.12.2012;2012;12;13;Lauantai;23;9;32;8;8;16
96;08.12.2012;2012;12;14;Lauantai;16;23;39;12;15;27
96;08.12.2012;2012;12;15;Lauantai;18;16;34;8;19;27
96;08.12.2012;2012;12;16;Lauantai;20;11;31;5;8;13
96;08.12.2012;2012;12;17;Lauantai;19;15;34;7;4;11
96;08.12.2012;2012;12;18;Lauantai;13;9;22;12;7;19
96;08.12.2012;2012;12;19;Lauantai;6;19;25;6;7;13
96;08.12.2012;2012;12;20;Lauantai;11;5;16;6;13;19
96;08.12.2012;2012;12;21;Lauantai;11;13;24;0;8;8
96;08.12.2012;2012;12;22;Lauantai;4;7;11;3;1;4
96;08.12.2012;2012;12;23;Lauantai;7;4;11;1;0;1
96;09.12.2012;2012;12;00;Sunnuntai;2;3;5;0;0;0
96;09.12.2012;2012;12;01;Sunnuntai;6;6;12;2;0;2
96;09.12.2012;2012;12;02;Sunnuntai;10;0;10;1;0;1
96;09.12.2012;2012;12;03;Sunnuntai;7;0;7;1;2;3
96;09.12.2012;2012;12;04;Sunnuntai;7;2;9;4;0;4
96;09.12.2012;2012;12;05;Sunnuntai;1;4;5;0;0;0
96;09.12.2012;2012;12;06;Sunnuntai;5;1;6;4;1;5
96;09.12.2012;2012;12;07;Sunnuntai;3;6;9;1;5;6
96;09.12.2012;2012;12;08;Sunnuntai;2;5;7;2;1;3
96;09.12.2012;2012;12;09;Sunnuntai;2;6;8;4;6;10
96;09.12.2012;2012;12;10;Sunnuntai;3;11;14;8;12;20
96;09.12.2012;2012;12;11;Sunnuntai;10;15;25;2;10;12
96;09.12.2012;2012;12;12;Sunnuntai;13;19;32;7;15;22
96;09.12.2012;2012;12;13;Sunnuntai;21;17;38;12;11;23
96;09.12.2012;2012;12;14;Sunnuntai;18;23;41;11;16;27
96;09.12.2012;2012;12;15;Sunnuntai;16;20;36;11;16;27
96;09.12.2012;2012;12;16;Sunnuntai;23;16;39;21;8;29
96;09.12.2012;2012;12;17;Sunnuntai;24;22;46;12;9;21
96;09.12.2012;2012;12;18;Sunnuntai;19;14;33;11;6;17
96;09.12.2012;2012;12;19;Sunnuntai;16;16;32;10;20;30
96;09.12.2012;2012;12;20;Sunnuntai;23;18;41;10;8;18
96;09.12.2012;2012;12;21;Sunnuntai;7;19;26;4;11;15
96;09.12.2012;2012;12;22;Sunnuntai;2;1;3;2;3;5
96;09.12.2012;2012;12;23;Sunnuntai;4;0;4;3;1;4
96;10.12.2012;2012;12;00;Maanantai;0;4;4;0;0;0
96;10.12.2012;2012;12;01;Maanantai;0;0;0;0;0;0
96;10.12.2012;2012;12;02;Maanantai;0;0;0;1;0;1
96;10.12.2012;2012;12;03;Maanantai;0;0;0;0;1;1
96;10.12.2012;2012;12;04;Maanantai;2;4;6;2;3;5
96;10.12.2012;2012;12;05;Maanantai;4;11;15;1;2;3
96;10.12.2012;2012;12;06;Maanantai;34;30;64;16;6;22
96;10.12.2012;2012;12;07;Maanantai;94;75;169;40;12;52
96;10.12.2012;2012;12;08;Maanantai;79;57;136;14;9;23
96;10.12.2012;2012;12;09;Maanantai;44;44;88;15;7;22
96;10.12.2012;2012;12;10;Maanantai;24;31;55;9;13;22
96;10.12.2012;2012;12;11;Maanantai;29;47;76;10;12;22
96;10.12.2012;2012;12;12;Maanantai;40;46;86;10;13;23
96;10.12.2012;2012;12;13;Maanantai;45;44;89;12;11;23
96;10.12.2012;2012;12;14;Maanantai;49;72;121;5;23;28
96;10.12.2012;2012;12;15;Maanantai;65;144;209;10;29;39
96;10.12.2012;2012;12;16;Maanantai;62;94;156;16;32;48
96;10.12.2012;2012;12;17;Maanantai;49;39;88;7;17;24
96;10.12.2012;2012;12;18;Maanantai;43;20;63;13;16;29
96;10.12.2012;2012;12;19;Maanantai;22;19;41;18;16;34
96;10.12.2012;2012;12;20;Maanantai;30;17;47;14;10;24
96;10.12.2012;2012;12;21;Maanantai;19;18;37;4;8;12
96;10.12.2012;2012;12;22;Maanantai;2;1;3;2;2;4
96;10.12.2012;2012;12;23;Maanantai;1;2;3;0;1;1
96;11.12.2012;2012;12;00;Tiistai;2;0;2;0;0;0
96;11.12.2012;2012;12;01;Tiistai;0;0;0;0;0;0
96;11.12.2012;2012;12;02;Tiistai;0;0;0;0;0;0
96;11.12.2012;2012;12;03;Tiistai;0;0;0;3;0;3
96;11.12.2012;2012;12;04;Tiistai;1;1;2;0;0;0
96;11.12.2012;2012;12;05;Tiistai;2;15;17;1;0;1
96;11.12.2012;2012;12;06;Tiistai;40;36;76;19;4;23
96;11.12.2012;2012;12;07;Tiistai;112;77;189;34;16;50
96;11.12.2012;2012;12;08;Tiistai;56;66;122;5;6;11
96;11.12.2012;2012;12;09;Tiistai;44;53;97;9;13;22
96;11.12.2012;2012;12;10;Tiistai;32;29;61;8;12;20
96;11.12.2012;2012;12;11;Tiistai;33;45;78;8;11;19
96;11.12.2012;2012;12;12;Tiistai;38;47;85;14;23;37
96;11.12.2012;2012;12;13;Tiistai;49;47;96;13;17;30
96;11.12.2012;2012;12;14;Tiistai;39;88;127;10;24;34
96;11.12.2012;2012;12;15;Tiistai;70;154;224;8;39;47
96;11.12.2012;2012;12;16;Tiistai;57;106;163;12;32;44
96;11.12.2012;2012;12;17;Tiistai;48;41;89;20;22;42
96;11.12.2012;2012;12;18;Tiistai;42;32;74;8;12;20
96;11.12.2012;2012;12;19;Tiistai;34;20;54;9;13;22
96;11.12.2012;2012;12;20;Tiistai;33;20;53;7;8;15
96;11.12.2012;2012;12;21;Tiistai;14;19;33;3;6;9
96;11.12.2012;2012;12;22;Tiistai;10;4;14;1;1;2
96;11.12.2012;2012;12;23;Tiistai;2;9;11;0;0;0
96;12.12.2012;2012;12;00;Keskiviikko;6;0;6;3;0;3
96;12.12.2012;2012;12;01;Keskiviikko;2;4;6;1;0;1
96;12.12.2012;2012;12;02;Keskiviikko;1;0;1;0;0;0
96;12.12.2012;2012;12;03;Keskiviikko;12;1;13;2;1;3
96;12.12.2012;2012;12;04;Keskiviikko;3;1;4;0;0;0
96;12.12.2012;2012;12;05;Keskiviikko;4;11;15;4;6;10
96;12.12.2012;2012;12;06;Keskiviikko;42;35;77;16;7;23
96;12.12.2012;2012;12;07;Keskiviikko;113;81;194;29;5;34
96;12.12.2012;2012;12;08;Keskiviikko;67;67;134;12;11;23
96;12.12.2012;2012;12;09;Keskiviikko;53;45;98;7;20;27
96;12.12.2012;2012;12;10;Keskiviikko;28;39;67;16;8;24
96;12.12.2012;2012;12;11;Keskiviikko;40;56;96;9;11;20
96;12.12.2012;2012;12;12;Keskiviikko;36;53;89;5;18;23
96;12.12.2012;2012;12;13;Keskiviikko;46;46;92;8;11;19
96;12.12.2012;2012;12;14;Keskiviikko;55;71;126;11;31;42
96;12.12.2012;2012;12;15;Keskiviikko;70;144;214;6;45;51
96;12.12.2012;2012;12;16;Keskiviikko;62;101;163;10;27;37
96;12.12.2012;2012;12;17;Keskiviikko;36;53;89;11;16;27
96;12.12.2012;2012;12;18;Keskiviikko;76;36;112;28;13;41
96;12.12.2012;2012;12;19;Keskiviikko;40;26;66;9;11;20
96;12.12.2012;2012;12;20;Keskiviikko;33;26;59;16;25;41
96;12.12.2012;2012;12;21;Keskiviikko;15;25;40;2;17;19
96;12.12.2012;2012;12;22;Keskiviikko;7;0;7;4;6;10
96;12.12.2012;2012;12;23;Keskiviikko;6;3;9;0;1;1
96;13.12.2012;2012;12;00;Torstai;2;0;2;3;5;8
96;13.12.2012;2012;12;01;Torstai;4;0;4;0;0;0
96;13.12.2012;2012;12;02;Torstai;0;1;1;0;0;0
96;13.12.2012;2012;12;03;Torstai;3;0;3;0;1;1
96;13.12.2012;2012;12;04;Torstai;5;1;6;0;0;0
96;13.12.2012;2012;12;05;Torstai;5;12;17;2;1;3
96;13.12.2012;2012;12;06;Torstai;37;28;65;13;4;17
96;13.12.2012;2012;12;07;Torstai;99;75;174;22;15;37
96;13.12.2012;2012;12;08;Torstai;68;58;126;5;7;12
96;13.12.2012;2012;12;09;Torstai;42;39;81;6;12;18
96;13.12.2012;2012;12;10;Torstai;28;26;54;5;13;18
96;13.12.2012;2012;12;11;Torstai;33;46;79;7;10;17
96;13.12.2012;2012;12;12;Torstai;31;42;73;16;9;25
96;13.12.2012;2012;12;13;Torstai;38;43;81;6;17;23
96;13.12.2012;2012;12;14;Torstai;37;71;108;5;24;29
96;13.12.2012;2012;12;15;Torstai;46;173;219;7;42;49
96;13.12.2012;2012;12;16;Torstai;57;94;151;9;26;35
96;13.12.2012;2012;12;17;Torstai;38;49;87;10;11;21
96;13.12.2012;2012;12;18;Torstai;45;26;71;3;13;16
96;13.12.2012;2012;12;19;Torstai;21;32;53;9;9;18
96;13.12.2012;2012;12;20;Torstai;27;22;49;10;9;19
96;13.12.2012;2012;12;21;Torstai;20;23;43;5;5;10
96;13.12.2012;2012;12;22;Torstai;7;4;11;2;5;7
96;13.12.2012;2012;12;23;Torstai;6;4;10;0;1;1
96;14.12.2012;2012;12;00;Perjantai;3;1;4;0;0;0
96;14.12.2012;2012;12;01;Perjantai;1;0;1;0;0;0
96;14.12.2012;2012;12;02;Perjantai;5;0;5;0;0;0
96;14.12.2012;2012;12;03;Perjantai;2;0;2;1;0;1
96;14.12.2012;2012;12;04;Perjantai;1;3;4;2;3;5
96;14.12.2012;2012;12;05;Perjantai;2;10;12;1;1;2
96;14.12.2012;2012;12;06;Perjantai;39;34;73;11;5;16
96;14.12.2012;2012;12;07;Perjantai;100;72;172;20;11;31
96;14.12.2012;2012;12;08;Perjantai;66;44;110;12;14;26
96;14.12.2012;2012;12;09;Perjantai;37;52;89;6;14;20
96;14.12.2012;2012;12;10;Perjantai;19;22;41;7;9;16
96;14.12.2012;2012;12;11;Perjantai;27;62;89;16;13;29
96;14.12.2012;2012;12;12;Perjantai;40;40;80;6;20;26
96;14.12.2012;2012;12;13;Perjantai;32;72;104;10;15;25
96;14.12.2012;2012;12;14;Perjantai;35;99;134;4;27;31
96;14.12.2012;2012;12;15;Perjantai;59;137;196;8;33;41
96;14.12.2012;2012;12;16;Perjantai;48;54;102;9;25;34
96;14.12.2012;2012;12;17;Perjantai;34;22;56;15;11;26
96;14.12.2012;2012;12;18;Perjantai;17;18;35;13;10;23
96;14.12.2012;2012;12;19;Perjantai;14;27;41;6;8;14
96;14.12.2012;2012;12;20;Perjantai;19;14;33;4;4;8
96;14.12.2012;2012;12;21;Perjantai;13;10;23;0;7;7
96;14.12.2012;2012;12;22;Perjantai;7;3;10;3;0;3
96;14.12.2012;2012;12;23;Perjantai;7;4;11;3;1;4
96;15.12.2012;2012;12;00;Lauantai;6;8;14;3;1;4
96;15.12.2012;2012;12;01;Lauantai;9;0;9;4;1;5
96;15.12.2012;2012;12;02;Lauantai;5;0;5;9;0;9
96;15.12.2012;2012;12;03;Lauantai;7;2;9;0;0;0
96;15.12.2012;2012;12;04;Lauantai;6;0;6;1;4;5
96;15.12.2012;2012;12;05;Lauantai;1;2;3;0;0;0
96;15.12.2012;2012;12;06;Lauantai;7;8;15;4;0;4
96;15.12.2012;2012;12;07;Lauantai;4;9;13;0;4;4
96;15.12.2012;2012;12;08;Lauantai;3;11;14;2;5;7
96;15.12.2012;2012;12;09;Lauantai;5;17;22;5;5;10
96;15.12.2012;2012;12;10;Lauantai;10;12;22;6;4;10
96;15.12.2012;2012;12;11;Lauantai;11;27;38;3;9;12
96;15.12.2012;2012;12;12;Lauantai;18;23;41;8;14;22
96;15.12.2012;2012;12;13;Lauantai;20;31;51;9;9;18
96;15.12.2012;2012;12;14;Lauantai;19;39;58;8;11;19
96;15.12.2012;2012;12;15;Lauantai;34;29;63;8;14;22
96;15.12.2012;2012;12;16;Lauantai;22;13;35;4;4;8
96;15.12.2012;2012;12;17;Lauantai;22;13;35;7;4;11
96;15.12.2012;2012;12;18;Lauantai;22;12;34;9;4;13
96;15.12.2012;2012;12;19;Lauantai;14;15;29;10;5;15
96;15.12.2012;2012;12;20;Lauantai;5;3;8;6;6;12
96;15.12.2012;2012;12;21;Lauantai;15;17;32;5;8;13
96;15.12.2012;2012;12;22;Lauantai;2;6;8;0;2;2
96;15.12.2012;2012;12;23;Lauantai;4;4;8;1;0;1
96;16.12.2012;2012;12;00;Sunnuntai;3;2;5;1;1;2
96;16.12.2012;2012;12;01;Sunnuntai;7;1;8;0;0;0
96;16.12.2012;2012;12;02;Sunnuntai;4;0;4;1;0;1
96;16.12.2012;2012;12;03;Sunnuntai;4;0;4;0;0;0
96;16.12.2012;2012;12;04;Sunnuntai;3;0;3;0;0;0
96;16.12.2012;2012;12;05;Sunnuntai;4;0;4;1;1;2
96;16.12.2012;2012;12;06;Sunnuntai;12;3;15;9;0;9
96;16.12.2012;2012;12;07;Sunnuntai;2;4;6;0;5;5
96;16.12.2012;2012;12;08;Sunnuntai;2;4;6;1;2;3
96;16.12.2012;2012;12;09;Sunnuntai;2;6;8;4;3;7
96;16.12.2012;2012;12;10;Sunnuntai;2;10;12;8;1;9
96;16.12.2012;2012;12;11;Sunnuntai;3;7;10;5;7;12
96;16.12.2012;2012;12;12;Sunnuntai;11;18;29;6;16;22
96;16.12.2012;2012;12;13;Sunnuntai;16;17;33;7;10;17
96;16.12.2012;2012;12;14;Sunnuntai;13;16;29;12;18;30
96;16.12.2012;2012;12;15;Sunnuntai;15;21;36;8;12;20
96;16.12.2012;2012;12;16;Sunnuntai;21;16;37;18;13;31
96;16.12.2012;2012;12;17;Sunnuntai;28;11;39;11;5;16
96;16.12.2012;2012;12;18;Sunnuntai;11;20;31;11;13;24
96;16.12.2012;2012;12;19;Sunnuntai;20;18;38;6;11;17
96;16.12.2012;2012;12;20;Sunnuntai;10;21;31;7;8;15
96;16.12.2012;2012;12;21;Sunnuntai;9;12;21;7;11;18
96;16.12.2012;2012;12;22;Sunnuntai;7;5;12;0;0;0
96;16.12.2012;2012;12;23;Sunnuntai;0;0;0;4;1;5
96;17.12.2012;2012;12;00;Maanantai;1;1;2;0;0;0
96;17.12.2012;2012;12;01;Maanantai;2;0;2;0;1;1
96;17.12.2012;2012;12;02;Maanantai;0;0;0;0;0;0
96;17.12.2012;2012;12;03;Maanantai;0;0;0;0;0;0
96;17.12.2012;2012;12;04;Maanantai;1;1;2;0;0;0
96;17.12.2012;2012;12;05;Maanantai;2;6;8;0;0;0
96;17.12.2012;2012;12;06;Maanantai;27;37;64;8;3;11
96;17.12.2012;2012;12;07;Maanantai;64;53;117;24;12;36
96;17.12.2012;2012;12;08;Maanantai;76;80;156;19;15;34
96;17.12.2012;2012;12;09;Maanantai;38;50;88;9;6;15
96;17.12.2012;2012;12;10;Maanantai;25;41;66;14;12;26
96;17.12.2012;2012;12;11;Maanantai;38;67;105;3;15;18
96;17.12.2012;2012;12;12;Maanantai;34;44;78;9;15;24
96;17.12.2012;2012;12;13;Maanantai;41;55;96;9;9;18
96;17.12.2012;2012;12;14;Maanantai;41;69;110;12;15;27
96;17.12.2012;2012;12;15;Maanantai;56;126;182;3;38;41
96;17.12.2012;2012;12;16;Maanantai;71;111;182;12;29;41
96;17.12.2012;2012;12;17;Maanantai;36;35;71;8;17;25
96;17.12.2012;2012;12;18;Maanantai;35;25;60;12;14;26
96;17.12.2012;2012;12;19;Maanantai;20;13;33;11;7;18
96;17.12.2012;2012;12;20;Maanantai;21;14;35;5;5;10
96;17.12.2012;2012;12;21;Maanantai;18;14;32;2;10;12
96;17.12.2012;2012;12;22;Maanantai;7;10;17;2;4;6
96;17.12.2012;2012;12;23;Maanantai;3;1;4;0;0;0
96;18.12.2012;2012;12;00;Tiistai;3;0;3;0;0;0
96;18.12.2012;2012;12;01;Tiistai;0;0;0;0;0;0
96;18.12.2012;2012;12;02;Tiistai;1;1;2;1;1;2
96;18.12.2012;2012;12;03;Tiistai;0;1;1;0;0;0
96;18.12.2012;2012;12;04;Tiistai;2;1;3;2;4;6
96;18.12.2012;2012;12;05;Tiistai;2;5;7;0;0;0
96;18.12.2012;2012;12;06;Tiistai;29;25;54;14;2;16
96;18.12.2012;2012;12;07;Tiistai;68;51;119;24;12;36
96;18.12.2012;2012;12;08;Tiistai;58;72;130;11;15;26
96;18.12.2012;2012;12;09;Tiistai;27;37;64;12;16;28
96;18.12.2012;2012;12;10;Tiistai;26;28;54;9;8;17
96;18.12.2012;2012;12;11;Tiistai;27;41;68;8;7;15
96;18.12.2012;2012;12;12;Tiistai;41;41;82;17;16;33
96;18.12.2012;2012;12;13;Tiistai;30;42;72;6;15;21
96;18.12.2012;2012;12;14;Tiistai;32;71;103;5;13;18
96;18.12.2012;2012;12;15;Tiistai;47;108;155;8;27;35
96;18.12.2012;2012;12;16;Tiistai;53;98;151;6;38;44
96;18.12.2012;2012;12;17;Tiistai;46;51;97;7;17;24
96;18.12.2012;2012;12;18;Tiistai;25;35;60;8;15;23
96;18.12.2012;2012;12;19;Tiistai;28;11;39;3;8;11
96;18.12.2012;2012;12;20;Tiistai;30;10;40;12;6;18
96;18.12.2012;2012;12;21;Tiistai;33;22;55;10;6;16
96;18.12.2012;2012;12;22;Tiistai;7;6;13;1;2;3
96;18.12.2012;2012;12;23;Tiistai;4;3;7;0;0;0
96;19.12.2012;2012;12;00;Keskiviikko;6;4;10;1;1;2
96;19.12.2012;2012;12;01;Keskiviikko;2;0;2;0;0;0
96;19.12.2012;2012;12;02;Keskiviikko;2;0;2;0;0;0
96;19.12.2012;2012;12;03;Keskiviikko;0;1;1;1;0;1
96;19.12.2012;2012;12;04;Keskiviikko;3;0;3;1;2;3
96;19.12.2012;2012;12;05;Keskiviikko;0;5;5;1;1;2
96;19.12.2012;2012;12;06;Keskiviikko;30;23;53;12;2;14
96;19.12.2012;2012;12;07;Keskiviikko;51;53;104;22;9;31
96;19.12.2012;2012;12;08;Keskiviikko;56;50;106;18;7;25
96;19.12.2012;2012;12;09;Keskiviikko;23;34;57;12;9;21
96;19.12.2012;2012;12;10;Keskiviikko;20;17;37;4;5;9
96;19.12.2012;2012;12;11;Keskiviikko;22;25;47;9;12;21
96;19.12.2012;2012;12;12;Keskiviikko;18;36;54;10;7;17
96;19.12.2012;2012;12;13;Keskiviikko;23;29;52;5;8;13
96;19.12.2012;2012;12;14;Keskiviikko;36;44;80;2;18;20
96;19.12.2012;2012;12;15;Keskiviikko;38;93;131;5;47;52
96;19.12.2012;2012;12;16;Keskiviikko;51;70;121;8;33;41
96;19.12.2012;2012;12;17;Keskiviikko;34;21;55;7;19;26
96;19.12.2012;2012;12;18;Keskiviikko;45;18;63;13;7;20
96;19.12.2012;2012;12;19;Keskiviikko;28;21;49;9;11;20
96;19.12.2012;2012;12;20;Keskiviikko;16;18;34;9;13;22
96;19.12.2012;2012;12;21;Keskiviikko;16;14;30;7;9;16
96;19.12.2012;2012;12;22;Keskiviikko;6;5;11;0;0;0
96;19.12.2012;2012;12;23;Keskiviikko;2;3;5;0;0;0
96;20.12.2012;2012;12;00;Torstai;4;4;8;1;0;1
96;20.12.2012;2012;12;01;Torstai;2;0;2;0;0;0
96;20.12.2012;2012;12;02;Torstai;4;0;4;0;0;0
96;20.12.2012;2012;12;03;Torstai;3;1;4;0;0;0
96;20.12.2012;2012;12;04;Torstai;1;0;1;1;3;4
96;20.12.2012;2012;12;05;Torstai;3;4;7;0;0;0
96;20.12.2012;2012;12;06;Torstai;30;18;48;11;4;15
96;20.12.2012;2012;12;07;Torstai;52;43;95;24;7;31
96;20.12.2012;2012;12;08;Torstai;61;46;107;12;8;20
96;20.12.2012;2012;12;09;Torstai;11;34;45;5;9;14
96;20.12.2012;2012;12;10;Torstai;17;25;42;6;8;14
96;20.12.2012;2012;12;11;Torstai;12;24;36;4;10;14
96;20.12.2012;2012;12;12;Torstai;26;29;55;17;15;32
96;20.12.2012;2012;12;13;Torstai;35;44;79;9;14;23
96;20.12.2012;2012;12;14;Torstai;28;51;79;5;14;19
96;20.12.2012;2012;12;15;Torstai;42;82;124;12;32;44
96;20.12.2012;2012;12;16;Torstai;50;63;113;6;31;37
96;20.12.2012;2012;12;17;Torstai;32;30;62;16;16;32
96;20.12.2012;2012;12;18;Torstai;28;36;64;4;20;24
96;20.12.2012;2012;12;19;Torstai;13;21;34;4;5;9
96;20.12.2012;2012;12;20;Torstai;26;5;31;4;5;9
96;20.12.2012;2012;12;21;Torstai;37;9;46;14;5;19
96;20.12.2012;2012;12;22;Torstai;12;8;20;1;2;3
96;20.12.2012;2012;12;23;Torstai;2;0;2;2;0;2
96;21.12.2012;2012;12;00;Perjantai;4;2;6;1;0;1
96;21.12.2012;2012;12;01;Perjantai;0;0;0;0;0;0
96;21.12.2012;2012;12;02;Perjantai;4;0;4;0;0;0
96;21.12.2012;2012;12;03;Perjantai;2;0;2;0;0;0
96;21.12.2012;2012;12;04;Perjantai;8;0;8;1;2;3
96;21.12.2012;2012;12;05;Perjantai;0;4;4;0;0;0
96;21.12.2012;2012;12;06;Perjantai;23;10;33;11;3;14
96;21.12.2012;2012;12;07;Perjantai;47;35;82;23;4;27
96;21.12.2012;2012;12;08;Perjantai;44;31;75;11;5;16
96;21.12.2012;2012;12;09;Perjantai;24;17;41;9;7;16
96;21.12.2012;2012;12;10;Perjantai;11;19;30;3;7;10
96;21.12.2012;2012;12;11;Perjantai;10;15;25;3;7;10
96;21.12.2012;2012;12;12;Perjantai;19;27;46;6;6;12
96;21.12.2012;2012;12;13;Perjantai;21;30;51;9;20;29
96;21.12.2012;2012;12;14;Perjantai;19;46;65;6;26;32
96;21.12.2012;2012;12;15;Perjantai;33;49;82;2;22;24
96;21.12.2012;2012;12;16;Perjantai;25;31;56;11;11;22
96;21.12.2012;2012;12;17;Perjantai;14;14;28;3;5;8
96;21.12.2012;2012;12;18;Perjantai;17;9;26;2;6;8
96;21.12.2012;2012;12;19;Perjantai;10;6;16;4;5;9
96;21.12.2012;2012;12;20;Perjantai;5;5;10;2;2;4
96;21.12.2012;2012;12;21;Perjantai;12;13;25;1;5;6
96;21.12.2012;2012;12;22;Perjantai;5;3;8;0;1;1
96;21.12.2012;2012;12;23;Perjantai;2;3;5;1;2;3
96;22.12.2012;2012;12;00;Lauantai;3;1;4;1;0;1
96;22.12.2012;2012;12;01;Lauantai;3;1;4;1;2;3
96;22.12.2012;2012;12;02;Lauantai;1;0;1;2;0;2
96;22.12.2012;2012;12;03;Lauantai;5;0;5;0;0;0
96;22.12.2012;2012;12;04;Lauantai;0;0;0;0;0;0
96;22.12.2012;2012;12;05;Lauantai;0;0;0;0;0;0
96;22.12.2012;2012;12;06;Lauantai;11;3;14;3;0;3
96;22.12.2012;2012;12;07;Lauantai;3;2;5;1;3;4
96;22.12.2012;2012;12;08;Lauantai;5;7;12;0;2;2
96;22.12.2012;2012;12;09;Lauantai;3;14;17;0;2;2
96;22.12.2012;2012;12;10;Lauantai;10;9;19;3;4;7
96;22.12.2012;2012;12;11;Lauantai;7;9;16;3;3;6
96;22.12.2012;2012;12;12;Lauantai;8;10;18;5;7;12
96;22.12.2012;2012;12;13;Lauantai;9;9;18;3;7;10
96;22.12.2012;2012;12;14;Lauantai;17;15;32;3;8;11
96;22.12.2012;2012;12;15;Lauantai;12;15;27;6;7;13
96;22.12.2012;2012;12;16;Lauantai;10;8;18;3;4;7
96;22.12.2012;2012;12;17;Lauantai;17;3;20;2;1;3
96;22.12.2012;2012;12;18;Lauantai;11;3;14;2;2;4
96;22.12.2012;2012;12;19;Lauantai;3;3;6;2;1;3
96;22.12.2012;2012;12;20;Lauantai;2;3;5;4;3;7
96;22.12.2012;2012;12;21;Lauantai;4;5;9;2;5;7
96;22.12.2012;2012;12;22;Lauantai;0;1;1;1;1;2
96;22.12.2012;2012;12;23;Lauantai;1;0;1;0;1;1
96;23.12.2012;2012;12;00;Sunnuntai;1;1;2;2;0;2
96;23.12.2012;2012;12;01;Sunnuntai;2;0;2;0;0;0
96;23.12.2012;2012;12;02;Sunnuntai;0;0;0;0;0;0
96;23.12.2012;2012;12;03;Sunnuntai;3;0;3;0;0;0
96;23.12.2012;2012;12;04;Sunnuntai;1;0;1;0;0;0
96;23.12.2012;2012;12;05;Sunnuntai;2;0;2;1;0;1
96;23.12.2012;2012;12;06;Sunnuntai;9;5;14;7;1;8
96;23.12.2012;2012;12;07;Sunnuntai;1;3;4;1;4;5
96;23.12.2012;2012;12;08;Sunnuntai;2;5;7;1;1;2
96;23.12.2012;2012;12;09;Sunnuntai;2;3;5;0;7;7
96;23.12.2012;2012;12;10;Sunnuntai;2;1;3;3;3;6
96;23.12.2012;2012;12;11;Sunnuntai;5;7;12;3;2;5
96;23.12.2012;2012;12;12;Sunnuntai;11;8;19;6;4;10
96;23.12.2012;2012;12;13;Sunnuntai;10;10;20;6;2;8
96;23.12.2012;2012;12;14;Sunnuntai;9;7;16;8;8;16
96;23.12.2012;2012;12;15;Sunnuntai;6;15;21;5;8;13
96;23.12.2012;2012;12;16;Sunnuntai;5;5;10;5;2;7
96;23.12.2012;2012;12;17;Sunnuntai;7;3;10;3;7;10
96;23.12.2012;2012;12;18;Sunnuntai;10;5;15;5;3;8
96;23.12.2012;2012;12;19;Sunnuntai;3;4;7;1;2;3
96;23.12.2012;2012;12;20;Sunnuntai;5;2;7;5;3;8
96;23.12.2012;2012;12;21;Sunnuntai;6;7;13;0;4;4
96;23.12.2012;2012;12;22;Sunnuntai;0;0;0;0;2;2
96;23.12.2012;2012;12;23;Sunnuntai;1;0;1;0;0;0
96;24.12.2012;2012;12;00;Maanantai;0;0;0;0;0;0
96;24.12.2012;2012;12;01;Maanantai;0;0;0;0;0;0
96;24.12.2012;2012;12;02;Maanantai;0;0;0;0;0;0
96;24.12.2012;2012;12;03;Maanantai;1;2;3;1;0;1
96;24.12.2012;2012;12;04;Maanantai;0;0;0;0;0;0
96;24.12.2012;2012;12;05;Maanantai;0;1;1;1;0;1
96;24.12.2012;2012;12;06;Maanantai;11;3;14;4;0;4
96;24.12.2012;2012;12;07;Maanantai;2;6;8;1;0;1
96;24.12.2012;2012;12;08;Maanantai;2;2;4;1;2;3
96;24.12.2012;2012;12;09;Maanantai;4;5;9;3;2;5
96;24.12.2012;2012;12;10;Maanantai;5;5;10;2;4;6
96;24.12.2012;2012;12;11;Maanantai;9;2;11;4;3;7
96;24.12.2012;2012;12;12;Maanantai;4;5;9;8;3;11
96;24.12.2012;2012;12;13;Maanantai;14;0;14;5;2;7
96;24.12.2012;2012;12;14;Maanantai;3;2;5;5;5;10
96;24.12.2012;2012;12;15;Maanantai;3;7;10;3;5;8
96;24.12.2012;2012;12;16;Maanantai;0;2;2;1;1;2
96;24.12.2012;2012;12;17;Maanantai;0;4;4;2;2;4
96;24.12.2012;2012;12;18;Maanantai;0;1;1;1;3;4
96;24.12.2012;2012;12;19;Maanantai;0;0;0;0;1;1
96;24.12.2012;2012;12;20;Maanantai;3;1;4;3;2;5
96;24.12.2012;2012;12;21;Maanantai;3;5;8;0;4;4
96;24.12.2012;2012;12;22;Maanantai;1;3;4;0;2;2
96;24.12.2012;2012;12;23;Maanantai;1;0;1;0;0;0
96;25.12.2012;2012;12;00;Tiistai;0;1;1;0;1;1
96;25.12.2012;2012;12;01;Tiistai;0;0;0;0;0;0
96;25.12.2012;2012;12;02;Tiistai;0;0;0;0;0;0
96;25.12.2012;2012;12;03;Tiistai;0;1;1;1;0;1
96;25.12.2012;2012;12;04;Tiistai;0;0;0;2;0;2
96;25.12.2012;2012;12;05;Tiistai;0;0;0;0;0;0
96;25.12.2012;2012;12;06;Tiistai;10;4;14;7;0;7
96;25.12.2012;2012;12;07;Tiistai;0;3;3;0;2;2
96;25.12.2012;2012;12;08;Tiistai;2;2;4;1;0;1
96;25.12.2012;2012;12;09;Tiistai;1;1;2;4;2;6
96;25.12.2012;2012;12;10;Tiistai;1;0;1;2;1;3
96;25.12.2012;2012;12;11;Tiistai;2;1;3;1;2;3
96;25.12.2012;2012;12;12;Tiistai;6;3;9;2;7;9
96;25.12.2012;2012;12;13;Tiistai;5;6;11;8;7;15
96;25.12.2012;2012;12;14;Tiistai;2;8;10;2;5;7
96;25.12.2012;2012;12;15;Tiistai;6;9;15;1;9;10
96;25.12.2012;2012;12;16;Tiistai;3;0;3;6;6;12
96;25.12.2012;2012;12;17;Tiistai;2;4;6;3;1;4
96;25.12.2012;2012;12;18;Tiistai;1;5;6;1;6;7
96;25.12.2012;2012;12;19;Tiistai;1;5;6;4;0;4
96;25.12.2012;2012;12;20;Tiistai;2;1;3;3;0;3
96;25.12.2012;2012;12;21;Tiistai;2;4;6;1;5;6
96;25.12.2012;2012;12;22;Tiistai;0;2;2;3;2;5
96;25.12.2012;2012;12;23;Tiistai;0;1;1;0;1;1
96;26.12.2012;2012;12;00;Keskiviikko;0;1;1;0;0;0
96;26.12.2012;2012;12;01;Keskiviikko;0;0;0;0;0;0
96;26.12.2012;2012;12;02;Keskiviikko;0;0;0;0;0;0
96;26.12.2012;2012;12;03;Keskiviikko;0;1;1;0;0;0
96;26.12.2012;2012;12;04;Keskiviikko;1;0;1;1;0;1
96;26.12.2012;2012;12;05;Keskiviikko;1;0;1;0;0;0
96;26.12.2012;2012;12;06;Keskiviikko;8;4;12;3;1;4
96;26.12.2012;2012;12;07;Keskiviikko;0;4;4;1;3;4
96;26.12.2012;2012;12;08;Keskiviikko;0;2;2;0;3;3
96;26.12.2012;2012;12;09;Keskiviikko;3;2;5;4;3;7
96;26.12.2012;2012;12;10;Keskiviikko;0;5;5;6;5;11
96;26.12.2012;2012;12;11;Keskiviikko;3;3;6;5;11;16
96;26.12.2012;2012;12;12;Keskiviikko;7;6;13;12;11;23
96;26.12.2012;2012;12;13;Keskiviikko;15;6;21;15;6;21
96;26.12.2012;2012;12;14;Keskiviikko;5;7;12;1;9;10
96;26.12.2012;2012;12;15;Keskiviikko;6;10;16;3;3;6
96;26.12.2012;2012;12;16;Keskiviikko;3;4;7;7;4;11
96;26.12.2012;2012;12;17;Keskiviikko;7;6;13;5;5;10
96;26.12.2012;2012;12;18;Keskiviikko;2;3;5;4;6;10
96;26.12.2012;2012;12;19;Keskiviikko;4;4;8;3;5;8
96;26.12.2012;2012;12;20;Keskiviikko;4;4;8;4;4;8
96;26.12.2012;2012;12;21;Keskiviikko;1;13;14;2;8;10
96;26.12.2012;2012;12;22;Keskiviikko;3;4;7;2;4;6
96;26.12.2012;2012;12;23;Keskiviikko;1;1;2;0;2;2
96;27.12.2012;2012;12;00;Torstai;3;0;3;0;1;1
96;27.12.2012;2012;12;01;Torstai;3;0;3;1;0;1
96;27.12.2012;2012;12;02;Torstai;1;0;1;1;0;1
96;27.12.2012;2012;12;03;Torstai;3;0;3;1;0;1
96;27.12.2012;2012;12;04;Torstai;0;0;0;2;0;2
96;27.12.2012;2012;12;05;Torstai;3;5;8;0;0;0
96;27.12.2012;2012;12;06;Torstai;17;8;25;5;1;6
96;27.12.2012;2012;12;07;Torstai;23;13;36;2;5;7
96;27.12.2012;2012;12;08;Torstai;12;18;30;3;4;7
96;27.12.2012;2012;12;09;Torstai;12;12;24;3;5;8
96;27.12.2012;2012;12;10;Torstai;7;10;17;2;1;3
96;27.12.2012;2012;12;11;Torstai;10;11;21;2;5;7
96;27.12.2012;2012;12;12;Torstai;18;11;29;3;5;8
96;27.12.2012;2012;12;13;Torstai;16;19;35;3;0;3
96;27.12.2012;2012;12;14;Torstai;17;21;38;6;2;8
96;27.12.2012;2012;12;15;Torstai;36;30;66;6;8;14
96;27.12.2012;2012;12;16;Torstai;46;39;85;4;4;8
96;27.12.2012;2012;12;17;Torstai;17;12;29;1;3;4
96;27.12.2012;2012;12;18;Torstai;19;16;35;1;6;7
96;27.12.2012;2012;12;19;Torstai;11;3;14;1;0;1
96;27.12.2012;2012;12;20;Torstai;11;4;15;1;2;3
96;27.12.2012;2012;12;21;Torstai;12;10;22;7;1;8
96;27.12.2012;2012;12;22;Torstai;6;2;8;2;0;2
96;27.12.2012;2012;12;23;Torstai;10;1;11;1;0;1
96;28.12.2012;2012;12;00;Perjantai;5;0;5;0;0;0
96;28.12.2012;2012;12;01;Perjantai;1;0;1;0;0;0
96;28.12.2012;2012;12;02;Perjantai;0;0;0;2;0;2
96;28.12.2012;2012;12;03;Perjantai;0;0;0;0;0;0
96;28.12.2012;2012;12;04;Perjantai;2;0;2;1;2;3
96;28.12.2012;2012;12;05;Perjantai;5;4;9;0;1;1
96;28.12.2012;2012;12;06;Perjantai;22;11;33;2;0;2
96;28.12.2012;2012;12;07;Perjantai;33;11;44;5;0;5
96;28.12.2012;2012;12;08;Perjantai;16;13;29;3;1;4
96;28.12.2012;2012;12;09;Perjantai;14;14;28;6;1;7
96;28.12.2012;2012;12;10;Perjantai;24;17;41;2;0;2
96;28.12.2012;2012;12;11;Perjantai;21;15;36;6;4;10
96;28.12.2012;2012;12;12;Perjantai;29;25;54;3;1;4
96;28.12.2012;2012;12;13;Perjantai;35;25;60;2;5;7
96;28.12.2012;2012;12;14;Perjantai;28;30;58;4;2;6
96;28.12.2012;2012;12;15;Perjantai;40;37;77;7;6;13
96;28.12.2012;2012;12;16;Perjantai;29;30;59;3;3;6
96;28.12.2012;2012;12;17;Perjantai;28;15;43;2;4;6
96;28.12.2012;2012;12;18;Perjantai;20;15;35;5;2;7
96;28.12.2012;2012;12;19;Perjantai;17;11;28;4;3;7
96;28.12.2012;2012;12;20;Perjantai;24;8;32;1;0;1
96;28.12.2012;2012;12;21;Perjantai;9;13;22;1;2;3
96;28.12.2012;2012;12;22;Perjantai;4;2;6;1;0;1
96;28.12.2012;2012;12;23;Perjantai;6;1;7;0;0;0
96;29.12.2012;2012;12;00;Lauantai;5;2;7;0;0;0
96;29.12.2012;2012;12;01;Lauantai;1;0;1;0;0;0
96;29.12.2012;2012;12;02;Lauantai;3;0;3;0;0;0
96;29.12.2012;2012;12;03;Lauantai;2;1;3;0;0;0
96;29.12.2012;2012;12;04;Lauantai;0;0;0;0;0;0
96;29.12.2012;2012;12;05;Lauantai;2;1;3;0;0;0
96;29.12.2012;2012;12;06;Lauantai;12;2;14;2;0;2
96;29.12.2012;2012;12;07;Lauantai;5;3;8;0;3;3
96;29.12.2012;2012;12;08;Lauantai;4;5;9;0;1;1
96;29.12.2012;2012;12;09;Lauantai;9;8;17;2;0;2
96;29.12.2012;2012;12;10;Lauantai;7;1;8;3;2;5
96;29.12.2012;2012;12;11;Lauantai;11;7;18;4;2;6
96;29.12.2012;2012;12;12;Lauantai;10;16;26;6;5;11
96;29.12.2012;2012;12;13;Lauantai;13;15;28;5;2;7
96;29.12.2012;2012;12;14;Lauantai;12;14;26;4;3;7
96;29.12.2012;2012;12;15;Lauantai;20;25;45;1;5;6
96;29.12.2012;2012;12;16;Lauantai;21;19;40;4;8;12
96;29.12.2012;2012;12;17;Lauantai;13;13;26;3;4;7
96;29.12.2012;2012;12;18;Lauantai;11;6;17;7;5;12
96;29.12.2012;2012;12;19;Lauantai;18;7;25;6;1;7
96;29.12.2012;2012;12;20;Lauantai;6;5;11;2;2;4
96;29.12.2012;2012;12;21;Lauantai;10;3;13;5;1;6
96;29.12.2012;2012;12;22;Lauantai;5;3;8;0;0;0
96;29.12.2012;2012;12;23;Lauantai;2;1;3;0;2;2
96;30.12.2012;2012;12;00;Sunnuntai;5;1;6;0;0;0
96;30.12.2012;2012;12;01;Sunnuntai;2;0;2;0;0;0
96;30.12.2012;2012;12;02;Sunnuntai;3;0;3;1;0;1
96;30.12.2012;2012;12;03;Sunnuntai;5;0;5;1;0;1
96;30.12.2012;2012;12;04;Sunnuntai;4;1;5;0;0;0
96;30.12.2012;2012;12;05;Sunnuntai;3;0;3;0;0;0
96;30.12.2012;2012;12;06;Sunnuntai;10;7;17;0;0;0
96;30.12.2012;2012;12;07;Sunnuntai;5;1;6;0;0;0
96;30.12.2012;2012;12;08;Sunnuntai;3;0;3;0;0;0
96;30.12.2012;2012;12;09;Sunnuntai;6;7;13;0;0;0
96;30.12.2012;2012;12;10;Sunnuntai;7;3;10;2;0;2
96;30.12.2012;2012;12;11;Sunnuntai;7;7;14;0;1;1
96;30.12.2012;2012;12;12;Sunnuntai;13;11;24;0;2;2
96;30.12.2012;2012;12;13;Sunnuntai;14;14;28;2;1;3
96;30.12.2012;2012;12;14;Sunnuntai;11;9;20;0;1;1
96;30.12.2012;2012;12;15;Sunnuntai;20;24;44;1;2;3
96;30.12.2012;2012;12;16;Sunnuntai;16;11;27;1;1;2
96;30.12.2012;2012;12;17;Sunnuntai;13;11;24;0;0;0
96;30.12.2012;2012;12;18;Sunnuntai;22;8;30;5;6;11
96;30.12.2012;2012;12;19;Sunnuntai;16;10;26;1;0;1
96;30.12.2012;2012;12;20;Sunnuntai;10;5;15;1;0;1
96;30.12.2012;2012;12;21;Sunnuntai;9;7;16;0;0;0
96;30.12.2012;2012;12;22;Sunnuntai;3;1;4;0;0;0
96;30.12.2012;2012;12;23;Sunnuntai;2;1;3;0;0;0
96;31.12.2012;2012;12;00;Maanantai;1;0;1;0;0;0
96;31.12.2012;2012;12;01;Maanantai;1;0;1;0;0;0
96;31.12.2012;2012;12;02;Maanantai;1;0;1;0;0;0
96;31.12.2012;2012;12;03;Maanantai;0;0;0;0;0;0
96;31.12.2012;2012;12;04;Maanantai;1;0;1;2;0;2
96;31.12.2012;2012;12;05;Maanantai;5;2;7;0;0;0
96;31.12.2012;2012;12;06;Maanantai;19;17;36;0;0;0
96;31.12.2012;2012;12;07;Maanantai;27;24;51;0;0;0
96;31.12.2012;2012;12;08;Maanantai;11;10;21;0;0;0
96;31.12.2012;2012;12;09;Maanantai;12;9;21;0;0;0
96;31.12.2012;2012;12;10;Maanantai;10;7;17;2;0;2
96;31.12.2012;2012;12;11;Maanantai;18;15;33;0;0;0
96;31.12.2012;2012;12;12;Maanantai;23;20;43;0;0;0
96;31.12.2012;2012;12;13;Maanantai;22;21;43;0;0;0
96;31.12.2012;2012;12;14;Maanantai;27;25;52;0;0;0
96;31.12.2012;2012;12;15;Maanantai;32;29;61;0;0;0
96;31.12.2012;2012;12;16;Maanantai;20;19;39;0;0;0
96;31.12.2012;2012;12;17;Maanantai;21;19;40;0;0;0
96;31.12.2012;2012;12;18;Maanantai;15;13;28;0;0;0
96;31.12.2012;2012;12;19;Maanantai;30;29;59;0;0;0
96;31.12.2012;2012;12;20;Maanantai;83;79;162;2;0;2
96;31.12.2012;2012;12;21;Maanantai;15;15;30;0;0;0
96;31.12.2012;2012;12;22;Maanantai;9;6;15;0;0;0
96;31.12.2012;2012;12;23;Maanantai;13;11;24;0;0;0
96;01.01.2013;2013;01;00;Tiistai;6;3;9;0;0;0
96;01.01.2013;2013;01;01;Tiistai;5;1;6;1;0;1
96;01.01.2013;2013;01;02;Tiistai;7;5;12;0;0;0
96;01.01.2013;2013;01;03;Tiistai;6;3;9;0;0;0
96;01.01.2013;2013;01;04;Tiistai;4;1;5;0;0;0
96;01.01.2013;2013;01;05;Tiistai;3;1;4;0;0;0
96;01.01.2013;2013;01;06;Tiistai;7;4;11;0;0;0
96;01.01.2013;2013;01;07;Tiistai;4;2;6;2;0;2
96;01.01.2013;2013;01;08;Tiistai;4;1;5;0;0;0
96;01.01.2013;2013;01;09;Tiistai;4;2;6;0;0;0
96;01.01.2013;2013;01;10;Tiistai;6;4;10;0;0;0
96;01.01.2013;2013;01;11;Tiistai;3;3;6;1;0;1
96;01.01.2013;2013;01;12;Tiistai;7;4;11;0;0;0
96;01.01.2013;2013;01;13;Tiistai;7;6;13;2;0;2
96;01.01.2013;2013;01;14;Tiistai;12;5;17;2;0;2
96;01.01.2013;2013;01;15;Tiistai;13;7;20;3;0;3
96;01.01.2013;2013;01;16;Tiistai;7;3;10;0;0;0
96;01.01.2013;2013;01;17;Tiistai;7;6;13;9;0;9
96;01.01.2013;2013;01;18;Tiistai;12;4;16;5;0;5
96;01.01.2013;2013;01;19;Tiistai;8;5;13;4;0;4
96;01.01.2013;2013;01;20;Tiistai;15;7;22;5;0;5
96;01.01.2013;2013;01;21;Tiistai;11;6;17;6;0;6
96;01.01.2013;2013;01;22;Tiistai;5;2;7;0;0;0
96;01.01.2013;2013;01;23;Tiistai;1;0;1;1;0;1
96;02.01.2013;2013;01;00;Keskiviikko;1;0;1;0;0;0
96;02.01.2013;2013;01;01;Keskiviikko;2;0;2;0;0;0
96;02.01.2013;2013;01;02;Keskiviikko;1;0;1;1;0;1
96;02.01.2013;2013;01;03;Keskiviikko;0;0;0;0;0;0
96;02.01.2013;2013;01;04;Keskiviikko;2;1;3;0;0;0
96;02.01.2013;2013;01;05;Keskiviikko;5;3;8;0;0;0
96;02.01.2013;2013;01;06;Keskiviikko;27;20;47;2;0;2
96;02.01.2013;2013;01;07;Keskiviikko;80;52;132;4;0;4
96;02.01.2013;2013;01;08;Keskiviikko;42;24;66;4;0;4
96;02.01.2013;2013;01;09;Keskiviikko;31;18;49;2;0;2
96;02.01.2013;2013;01;10;Keskiviikko;24;14;38;6;0;6
96;02.01.2013;2013;01;11;Keskiviikko;27;17;44;2;0;2
96;02.01.2013;2013;01;12;Keskiviikko;36;26;62;6;2;8
96;02.01.2013;2013;01;13;Keskiviikko;29;29;58;7;0;7
96;02.01.2013;2013;01;14;Keskiviikko;35;37;72;2;13;15
96;02.01.2013;2013;01;15;Keskiviikko;57;62;119;6;25;31
96;02.01.2013;2013;01;16;Keskiviikko;48;56;104;4;20;24
96;02.01.2013;2013;01;17;Keskiviikko;25;30;55;2;11;13
96;02.01.2013;2013;01;18;Keskiviikko;31;27;58;11;30;41
96;02.01.2013;2013;01;19;Keskiviikko;22;13;35;9;10;19
96;02.01.2013;2013;01;20;Keskiviikko;24;15;39;18;13;31
96;02.01.2013;2013;01;21;Keskiviikko;15;12;27;2;7;9
96;02.01.2013;2013;01;22;Keskiviikko;4;2;6;0;2;2
96;02.01.2013;2013;01;23;Keskiviikko;2;0;2;0;0;0
96;03.01.2013;2013;01;00;Torstai;1;0;1;0;0;0
96;03.01.2013;2013;01;01;Torstai;1;0;1;0;0;0
96;03.01.2013;2013;01;02;Torstai;0;0;0;0;0;0
96;03.01.2013;2013;01;03;Torstai;0;0;0;0;0;0
96;03.01.2013;2013;01;04;Torstai;2;1;3;1;0;1
96;03.01.2013;2013;01;05;Torstai;3;4;7;1;0;1
96;03.01.2013;2013;01;06;Torstai;33;16;49;5;3;8
96;03.01.2013;2013;01;07;Torstai;68;54;122;14;6;20
96;03.01.2013;2013;01;08;Torstai;38;35;73;7;3;10
96;03.01.2013;2013;01;09;Torstai;21;33;54;6;4;10
96;03.01.2013;2013;01;10;Torstai;18;21;39;6;7;13
96;03.01.2013;2013;01;11;Torstai;27;23;50;4;8;12
96;03.01.2013;2013;01;12;Torstai;20;23;43;2;6;8
96;03.01.2013;2013;01;13;Torstai;26;33;59;13;18;31
96;03.01.2013;2013;01;14;Torstai;35;44;79;5;25;30
96;03.01.2013;2013;01;15;Torstai;49;78;127;2;45;47
96;03.01.2013;2013;01;16;Torstai;61;60;121;4;30;34
96;03.01.2013;2013;01;17;Torstai;32;20;52;10;15;25
96;03.01.2013;2013;01;18;Torstai;25;15;40;12;8;20
96;03.01.2013;2013;01;19;Torstai;23;18;41;6;17;23
96;03.01.2013;2013;01;20;Torstai;24;7;31;6;6;12
96;03.01.2013;2013;01;21;Torstai;10;13;23;0;8;8
96;03.01.2013;2013;01;22;Torstai;4;2;6;2;1;3
96;03.01.2013;2013;01;23;Torstai;6;2;8;0;0;0
96;04.01.2013;2013;01;00;Perjantai;5;1;6;1;1;2
96;04.01.2013;2013;01;01;Perjantai;0;0;0;0;0;0
96;04.01.2013;2013;01;02;Perjantai;0;0;0;1;0;1
96;04.01.2013;2013;01;03;Perjantai;1;0;1;0;0;0
96;04.01.2013;2013;01;04;Perjantai;1;1;2;0;0;0
96;04.01.2013;2013;01;05;Perjantai;1;3;4;0;0;0
96;04.01.2013;2013;01;06;Perjantai;25;20;45;3;4;7
96;04.01.2013;2013;01;07;Perjantai;52;54;106;9;10;19
96;04.01.2013;2013;01;08;Perjantai;54;59;113;9;5;14
96;04.01.2013;2013;01;09;Perjantai;21;28;49;5;9;14
96;04.01.2013;2013;01;10;Perjantai;13;27;40;5;12;17
96;04.01.2013;2013;01;11;Perjantai;26;23;49;13;7;20
96;04.01.2013;2013;01;12;Perjantai;18;32;50;4;14;18
96;04.01.2013;2013;01;13;Perjantai;37;42;79;6;8;14
96;04.01.2013;2013;01;14;Perjantai;42;51;93;7;16;23
96;04.01.2013;2013;01;15;Perjantai;73;90;163;5;20;25
96;04.01.2013;2013;01;16;Perjantai;59;46;105;8;20;28
96;04.01.2013;2013;01;17;Perjantai;38;27;65;5;10;15
96;04.01.2013;2013;01;18;Perjantai;20;14;34;12;11;23
96;04.01.2013;2013;01;19;Perjantai;10;8;18;6;4;10
96;04.01.2013;2013;01;20;Perjantai;14;8;22;7;9;16
96;04.01.2013;2013;01;21;Perjantai;8;11;19;1;2;3
96;04.01.2013;2013;01;22;Perjantai;6;4;10;1;1;2
96;04.01.2013;2013;01;23;Perjantai;5;1;6;0;0;0
96;05.01.2013;2013;01;00;Lauantai;5;1;6;0;1;1
96;05.01.2013;2013;01;01;Lauantai;2;0;2;2;0;2
96;05.01.2013;2013;01;02;Lauantai;3;2;5;0;0;0
96;05.01.2013;2013;01;03;Lauantai;4;1;5;0;1;1
96;05.01.2013;2013;01;04;Lauantai;3;0;3;2;0;2
96;05.01.2013;2013;01;05;Lauantai;1;0;1;0;0;0
96;05.01.2013;2013;01;06;Lauantai;12;3;15;3;0;3
96;05.01.2013;2013;01;07;Lauantai;2;6;8;1;5;6
96;05.01.2013;2013;01;08;Lauantai;2;6;8;1;3;4
96;05.01.2013;2013;01;09;Lauantai;4;12;16;2;2;4
96;05.01.2013;2013;01;10;Lauantai;12;12;24;12;7;19
96;05.01.2013;2013;01;11;Lauantai;4;21;25;5;11;16
96;05.01.2013;2013;01;12;Lauantai;18;17;35;9;10;19
96;05.01.2013;2013;01;13;Lauantai;12;22;34;5;4;9
96;05.01.2013;2013;01;14;Lauantai;22;14;36;4;15;19
96;05.01.2013;2013;01;15;Lauantai;18;31;49;12;16;28
96;05.01.2013;2013;01;16;Lauantai;24;31;55;8;20;28
96;05.01.2013;2013;01;17;Lauantai;20;17;37;7;7;14
96;05.01.2013;2013;01;18;Lauantai;20;10;30;10;6;16
96;05.01.2013;2013;01;19;Lauantai;27;9;36;19;2;21
96;05.01.2013;2013;01;20;Lauantai;15;5;20;8;4;12
96;05.01.2013;2013;01;21;Lauantai;8;8;16;5;8;13
96;05.01.2013;2013;01;22;Lauantai;3;4;7;1;3;4
96;05.01.2013;2013;01;23;Lauantai;2;5;7;0;1;1
96;06.01.2013;2013;01;00;Sunnuntai;3;4;7;1;2;3
96;06.01.2013;2013;01;01;Sunnuntai;3;3;6;2;1;3
96;06.01.2013;2013;01;02;Sunnuntai;3;0;3;0;0;0
96;06.01.2013;2013;01;03;Sunnuntai;2;1;3;1;0;1
96;06.01.2013;2013;01;04;Sunnuntai;3;0;3;3;0;3
96;06.01.2013;2013;01;05;Sunnuntai;1;1;2;0;0;0
96;06.01.2013;2013;01;06;Sunnuntai;11;3;14;3;1;4
96;06.01.2013;2013;01;07;Sunnuntai;2;2;4;1;4;5
96;06.01.2013;2013;01;08;Sunnuntai;2;0;2;0;2;2
96;06.01.2013;2013;01;09;Sunnuntai;2;3;5;3;3;6
96;06.01.2013;2013;01;10;Sunnuntai;4;6;10;8;6;14
96;06.01.2013;2013;01;11;Sunnuntai;4;9;13;6;11;17
96;06.01.2013;2013;01;12;Sunnuntai;13;14;27;2;8;10
96;06.01.2013;2013;01;13;Sunnuntai;14;13;27;2;5;7
96;06.01.2013;2013;01;14;Sunnuntai;10;10;20;8;6;14
96;06.01.2013;2013;01;15;Sunnuntai;11;17;28;8;14;22
96;06.01.2013;2013;01;16;Sunnuntai;13;9;22;3;14;17
96;06.01.2013;2013;01;17;Sunnuntai;14;6;20;16;9;25
96;06.01.2013;2013;01;18;Sunnuntai;28;11;39;9;17;26
96;06.01.2013;2013;01;19;Sunnuntai;7;11;18;2;13;15
96;06.01.2013;2013;01;20;Sunnuntai;7;9;16;6;11;17
96;06.01.2013;2013;01;21;Sunnuntai;6;12;18;3;8;11
96;06.01.2013;2013;01;22;Sunnuntai;2;2;4;1;1;2
96;06.01.2013;2013;01;23;Sunnuntai;4;2;6;0;0;0
96;07.01.2013;2013;01;00;Maanantai;1;0;1;0;0;0
96;07.01.2013;2013;01;01;Maanantai;2;0;2;1;0;1
96;07.01.2013;2013;01;02;Maanantai;3;0;3;0;0;0
96;07.01.2013;2013;01;03;Maanantai;0;0;0;0;0;0
96;07.01.2013;2013;01;04;Maanantai;0;0;0;0;0;0
96;07.01.2013;2013;01;05;Maanantai;3;8;11;1;1;2
96;07.01.2013;2013;01;06;Maanantai;33;32;65;6;6;12
96;07.01.2013;2013;01;07;Maanantai;98;81;179;23;14;37
96;07.01.2013;2013;01;08;Maanantai;52;51;103;6;5;11
96;07.01.2013;2013;01;09;Maanantai;37;41;78;15;13;28
96;07.01.2013;2013;01;10;Maanantai;31;34;65;1;7;8
96;07.01.2013;2013;01;11;Maanantai;38;28;66;7;18;25
96;07.01.2013;2013;01;12;Maanantai;39;53;92;4;12;16
96;07.01.2013;2013;01;13;Maanantai;40;49;89;3;8;11
96;07.01.2013;2013;01;14;Maanantai;42;77;119;0;15;15
96;07.01.2013;2013;01;15;Maanantai;68;153;221;9;54;63
96;07.01.2013;2013;01;16;Maanantai;66;94;160;4;40;44
96;07.01.2013;2013;01;17;Maanantai;37;66;103;6;15;21
96;07.01.2013;2013;01;18;Maanantai;26;31;57;7;12;19
96;07.01.2013;2013;01;19;Maanantai;33;22;55;5;25;30
96;07.01.2013;2013;01;20;Maanantai;32;18;50;5;10;15
96;07.01.2013;2013;01;21;Maanantai;15;9;24;2;6;8
96;07.01.2013;2013;01;22;Maanantai;5;1;6;0;4;4
96;07.01.2013;2013;01;23;Maanantai;2;0;2;0;1;1
96;08.01.2013;2013;01;00;Tiistai;0;0;0;1;0;1
96;08.01.2013;2013;01;01;Tiistai;0;0;0;0;0;0
96;08.01.2013;2013;01;02;Tiistai;0;1;1;0;1;1
96;08.01.2013;2013;01;03;Tiistai;1;0;1;0;0;0
96;08.01.2013;2013;01;04;Tiistai;1;2;3;0;0;0
96;08.01.2013;2013;01;05;Tiistai;4;4;8;0;0;0
96;08.01.2013;2013;01;06;Tiistai;24;28;52;1;5;6
96;08.01.2013;2013;01;07;Tiistai;57;76;133;7;8;15
96;08.01.2013;2013;01;08;Tiistai;99;77;176;2;11;13
96;08.01.2013;2013;01;09;Tiistai;32;50;82;2;4;6
96;08.01.2013;2013;01;10;Tiistai;37;36;73;7;10;17
96;08.01.2013;2013;01;11;Tiistai;28;28;56;4;12;16
96;08.01.2013;2013;01;12;Tiistai;39;44;83;4;10;14
96;08.01.2013;2013;01;13;Tiistai;30;49;79;1;9;10
96;08.01.2013;2013;01;14;Tiistai;38;78;116;4;13;17
96;08.01.2013;2013;01;15;Tiistai;51;136;187;5;45;50
96;08.01.2013;2013;01;16;Tiistai;60;131;191;4;46;50
96;08.01.2013;2013;01;17;Tiistai;39;55;94;6;22;28
96;08.01.2013;2013;01;18;Tiistai;37;45;82;7;11;18
96;08.01.2013;2013;01;19;Tiistai;22;34;56;4;15;19
96;08.01.2013;2013;01;20;Tiistai;38;24;62;7;10;17
96;08.01.2013;2013;01;21;Tiistai;32;20;52;2;7;9
96;08.01.2013;2013;01;22;Tiistai;11;4;15;3;1;4
96;08.01.2013;2013;01;23;Tiistai;10;4;14;0;2;2
96;09.01.2013;2013;01;00;Keskiviikko;1;2;3;0;0;0
96;09.01.2013;2013;01;01;Keskiviikko;0;0;0;0;0;0
96;09.01.2013;2013;01;02;Keskiviikko;2;0;2;0;1;1
96;09.01.2013;2013;01;03;Keskiviikko;0;0;0;0;0;0
96;09.01.2013;2013;01;04;Keskiviikko;1;0;1;0;0;0
96;09.01.2013;2013;01;05;Keskiviikko;4;6;10;0;0;0
96;09.01.2013;2013;01;06;Keskiviikko;35;22;57;6;2;8
96;09.01.2013;2013;01;07;Keskiviikko;76;52;128;20;4;24
96;09.01.2013;2013;01;08;Keskiviikko;91;71;162;13;5;18
96;09.01.2013;2013;01;09;Keskiviikko;48;36;84;2;3;5
96;09.01.2013;2013;01;10;Keskiviikko;46;35;81;5;4;9
96;09.01.2013;2013;01;11;Keskiviikko;40;22;62;6;11;17
96;09.01.2013;2013;01;12;Keskiviikko;55;35;90;4;7;11
96;09.01.2013;2013;01;13;Keskiviikko;34;35;69;7;12;19
96;09.01.2013;2013;01;14;Keskiviikko;43;52;95;3;7;10
96;09.01.2013;2013;01;15;Keskiviikko;61;116;177;9;40;49
96;09.01.2013;2013;01;16;Keskiviikko;65;110;175;8;38;46
96;09.01.2013;2013;01;17;Keskiviikko;54;57;111;14;23;37
96;09.01.2013;2013;01;18;Keskiviikko;42;37;79;14;10;24
96;09.01.2013;2013;01;19;Keskiviikko;45;36;81;12;11;23
96;09.01.2013;2013;01;20;Keskiviikko;29;31;60;3;9;12
96;09.01.2013;2013;01;21;Keskiviikko;25;31;56;2;9;11
96;09.01.2013;2013;01;22;Keskiviikko;9;11;20;2;3;5
96;09.01.2013;2013;01;23;Keskiviikko;9;2;11;0;2;2
96;10.01.2013;2013;01;00;Torstai;5;0;5;2;1;3
96;10.01.2013;2013;01;01;Torstai;2;1;3;0;1;1
96;10.01.2013;2013;01;02;Torstai;2;2;4;0;0;0
96;10.01.2013;2013;01;03;Torstai;0;1;1;0;0;0
96;10.01.2013;2013;01;04;Torstai;1;0;1;0;0;0
96;10.01.2013;2013;01;05;Torstai;3;8;11;0;0;0
96;10.01.2013;2013;01;06;Torstai;24;22;46;1;3;4
96;10.01.2013;2013;01;07;Torstai;50;58;108;6;1;7
96;10.01.2013;2013;01;08;Torstai;97;77;174;4;5;9
96;10.01.2013;2013;01;09;Torstai;33;37;70;1;6;7
96;10.01.2013;2013;01;10;Torstai;33;32;65;1;4;5
96;10.01.2013;2013;01;11;Torstai;34;35;69;1;2;3
96;10.01.2013;2013;01;12;Torstai;33;39;72;3;7;10
96;10.01.2013;2013;01;13;Torstai;26;38;64;2;9;11
96;10.01.2013;2013;01;14;Torstai;29;82;111;0;12;12
96;10.01.2013;2013;01;15;Torstai;66;153;219;4;24;28
96;10.01.2013;2013;01;16;Torstai;81;123;204;2;29;31
96;10.01.2013;2013;01;17;Torstai;41;44;85;5;17;22
96;10.01.2013;2013;01;18;Torstai;30;33;63;7;14;21
96;10.01.2013;2013;01;19;Torstai;25;20;45;3;8;11
96;10.01.2013;2013;01;20;Torstai;20;25;45;3;7;10
96;10.01.2013;2013;01;21;Torstai;30;17;47;2;5;7
96;10.01.2013;2013;01;22;Torstai;2;3;5;0;3;3
96;10.01.2013;2013;01;23;Torstai;3;1;4;2;3;5
96;11.01.2013;2013;01;00;Perjantai;3;0;3;1;1;2
96;11.01.2013;2013;01;01;Perjantai;0;0;0;0;1;1
96;11.01.2013;2013;01;02;Perjantai;5;0;5;0;0;0
96;11.01.2013;2013;01;03;Perjantai;0;0;0;0;0;0
96;11.01.2013;2013;01;04;Perjantai;1;1;2;0;0;0
96;11.01.2013;2013;01;05;Perjantai;4;8;12;0;0;0
96;11.01.2013;2013;01;06;Perjantai;27;19;46;5;3;8
96;11.01.2013;2013;01;07;Perjantai;49;51;100;17;8;25
96;11.01.2013;2013;01;08;Perjantai;104;75;179;11;10;21
96;11.01.2013;2013;01;09;Perjantai;30;34;64;5;5;10
96;11.01.2013;2013;01;10;Perjantai;24;41;65;5;7;12
96;11.01.2013;2013;01;11;Perjantai;48;31;79;4;13;17
96;11.01.2013;2013;01;12;Perjantai;28;38;66;9;12;21
96;11.01.2013;2013;01;13;Perjantai;45;50;95;5;18;23
96;11.01.2013;2013;01;14;Perjantai;42;67;109;2;22;24
96;11.01.2013;2013;01;15;Perjantai;53;99;152;4;43;47
96;11.01.2013;2013;01;16;Perjantai;56;69;125;11;21;32
96;11.01.2013;2013;01;17;Perjantai;26;32;58;6;10;16
96;11.01.2013;2013;01;18;Perjantai;24;23;47;7;2;9
96;11.01.2013;2013;01;19;Perjantai;17;23;40;3;5;8
96;11.01.2013;2013;01;20;Perjantai;19;14;33;2;7;9
96;11.01.2013;2013;01;21;Perjantai;19;9;28;3;7;10
96;11.01.2013;2013;01;22;Perjantai;10;4;14;0;3;3
96;11.01.2013;2013;01;23;Perjantai;6;8;14;0;1;1
96;12.01.2013;2013;01;00;Lauantai;4;1;5;1;0;1
96;12.01.2013;2013;01;01;Lauantai;9;0;9;0;0;0
96;12.01.2013;2013;01;02;Lauantai;4;3;7;0;0;0
96;12.01.2013;2013;01;03;Lauantai;2;0;2;1;0;1
96;12.01.2013;2013;01;04;Lauantai;4;0;4;0;2;2
96;12.01.2013;2013;01;05;Lauantai;2;0;2;0;0;0
96;12.01.2013;2013;01;06;Lauantai;12;4;16;0;0;0
96;12.01.2013;2013;01;07;Lauantai;5;11;16;0;2;2
96;12.01.2013;2013;01;08;Lauantai;6;7;13;2;2;4
96;12.01.2013;2013;01;09;Lauantai;11;18;29;3;4;7
96;12.01.2013;2013;01;10;Lauantai;13;13;26;5;6;11
96;12.01.2013;2013;01;11;Lauantai;17;18;35;10;5;15
96;12.01.2013;2013;01;12;Lauantai;26;24;50;7;5;12
96;12.01.2013;2013;01;13;Lauantai;24;27;51;8;20;28
96;12.01.2013;2013;01;14;Lauantai;24;28;52;5;12;17
96;12.01.2013;2013;01;15;Lauantai;30;37;67;4;19;23
96;12.01.2013;2013;01;16;Lauantai;27;16;43;5;8;13
96;12.01.2013;2013;01;17;Lauantai;28;23;51;7;8;15
96;12.01.2013;2013;01;18;Lauantai;38;11;49;14;5;19
96;12.01.2013;2013;01;19;Lauantai;14;16;30;6;4;10
96;12.01.2013;2013;01;20;Lauantai;5;7;12;4;8;12
96;12.01.2013;2013;01;21;Lauantai;8;7;15;1;8;9
96;12.01.2013;2013;01;22;Lauantai;4;4;8;0;4;4
96;12.01.2013;2013;01;23;Lauantai;5;4;9;0;0;0
96;13.01.2013;2013;01;00;Sunnuntai;6;4;10;0;1;1
96;13.01.2013;2013;01;01;Sunnuntai;0;1;1;2;1;3
96;13.01.2013;2013;01;02;Sunnuntai;2;1;3;0;0;0
96;13.01.2013;2013;01;03;Sunnuntai;5;1;6;0;0;0
96;13.01.2013;2013;01;04;Sunnuntai;2;1;3;1;0;1
96;13.01.2013;2013;01;05;Sunnuntai;2;0;2;0;1;1
96;13.01.2013;2013;01;06;Sunnuntai;10;7;17;1;1;2
96;13.01.2013;2013;01;07;Sunnuntai;6;5;11;1;3;4
96;13.01.2013;2013;01;08;Sunnuntai;2;4;6;0;2;2
96;13.01.2013;2013;01;09;Sunnuntai;8;6;14;0;1;1
96;13.01.2013;2013;01;10;Sunnuntai;5;5;10;4;3;7
96;13.01.2013;2013;01;11;Sunnuntai;8;8;16;3;5;8
96;13.01.2013;2013;01;12;Sunnuntai;12;13;25;4;8;12
96;13.01.2013;2013;01;13;Sunnuntai;15;19;34;2;10;12
96;13.01.2013;2013;01;14;Sunnuntai;20;13;33;5;12;17
96;13.01.2013;2013;01;15;Sunnuntai;19;20;39;4;9;13
96;13.01.2013;2013;01;16;Sunnuntai;30;24;54;6;4;10
96;13.01.2013;2013;01;17;Sunnuntai;24;16;40;9;5;14
96;13.01.2013;2013;01;18;Sunnuntai;29;24;53;3;12;15
96;13.01.2013;2013;01;19;Sunnuntai;14;10;24;5;13;18
96;13.01.2013;2013;01;20;Sunnuntai;16;16;32;6;5;11
96;13.01.2013;2013;01;21;Sunnuntai;16;8;24;2;4;6
96;13.01.2013;2013;01;22;Sunnuntai;7;5;12;0;2;2
96;13.01.2013;2013;01;23;Sunnuntai;6;3;9;0;0;0
96;14.01.2013;2013;01;00;Maanantai;2;1;3;0;0;0
96;14.01.2013;2013;01;01;Maanantai;0;0;0;0;0;0
96;14.01.2013;2013;01;02;Maanantai;0;0;0;0;0;0
96;14.01.2013;2013;01;03;Maanantai;1;0;1;0;0;0
96;14.01.2013;2013;01;04;Maanantai;2;1;3;0;1;1
96;14.01.2013;2013;01;05;Maanantai;5;8;13;0;1;1
96;14.01.2013;2013;01;06;Maanantai;34;26;60;2;1;3
96;14.01.2013;2013;01;07;Maanantai;90;89;179;8;7;15
96;14.01.2013;2013;01;08;Maanantai;61;62;123;3;7;10
96;14.01.2013;2013;01;09;Maanantai;42;38;80;8;7;15
96;14.01.2013;2013;01;10;Maanantai;35;40;75;0;10;10
96;14.01.2013;2013;01;11;Maanantai;40;38;78;4;2;6
96;14.01.2013;2013;01;12;Maanantai;59;61;120;4;5;9
96;14.01.2013;2013;01;13;Maanantai;38;44;82;2;8;10
96;14.01.2013;2013;01;14;Maanantai;55;79;134;5;20;25
96;14.01.2013;2013;01;15;Maanantai;75;157;232;4;22;26
96;14.01.2013;2013;01;16;Maanantai;66;90;156;3;26;29
96;14.01.2013;2013;01;17;Maanantai;45;56;101;8;17;25
96;14.01.2013;2013;01;18;Maanantai;33;34;67;2;19;21
96;14.01.2013;2013;01;19;Maanantai;23;25;48;6;15;21
96;14.01.2013;2013;01;20;Maanantai;27;24;51;7;14;21
96;14.01.2013;2013;01;21;Maanantai;24;17;41;2;2;4
96;14.01.2013;2013;01;22;Maanantai;12;3;15;1;1;2
96;14.01.2013;2013;01;23;Maanantai;4;0;4;0;1;1
96;15.01.2013;2013;01;00;Tiistai;1;0;1;0;0;0
96;15.01.2013;2013;01;01;Tiistai;1;0;1;0;0;0
96;15.01.2013;2013;01;02;Tiistai;0;0;0;0;0;0
96;15.01.2013;2013;01;03;Tiistai;1;0;1;0;1;1
96;15.01.2013;2013;01;04;Tiistai;1;0;1;1;0;1
96;15.01.2013;2013;01;05;Tiistai;4;3;7;0;1;1
96;15.01.2013;2013;01;06;Tiistai;27;27;54;2;2;4
96;15.01.2013;2013;01;07;Tiistai;63;74;137;1;10;11
96;15.01.2013;2013;01;08;Tiistai;104;83;187;0;6;6
96;15.01.2013;2013;01;09;Tiistai;41;50;91;3;3;6
96;15.01.2013;2013;01;10;Tiistai;27;32;59;7;3;10
96;15.01.2013;2013;01;11;Tiistai;30;38;68;2;5;7
96;15.01.2013;2013;01;12;Tiistai;42;62;104;3;17;20
96;15.01.2013;2013;01;13;Tiistai;35;59;94;3;9;12
96;15.01.2013;2013;01;14;Tiistai;50;57;107;4;9;13
96;15.01.2013;2013;01;15;Tiistai;82;134;216;3;34;37
96;15.01.2013;2013;01;16;Tiistai;59;140;199;7;33;40
96;15.01.2013;2013;01;17;Tiistai;47;49;96;4;17;21
96;15.01.2013;2013;01;18;Tiistai;37;44;81;5;26;31
96;15.01.2013;2013;01;19;Tiistai;31;40;71;4;13;17
96;15.01.2013;2013;01;20;Tiistai;35;27;62;5;10;15
96;15.01.2013;2013;01;21;Tiistai;32;29;61;4;8;12
96;15.01.2013;2013;01;22;Tiistai;12;1;13;2;1;3
96;15.01.2013;2013;01;23;Tiistai;11;2;13;2;0;2
96;16.01.2013;2013;01;00;Keskiviikko;4;3;7;1;0;1
96;16.01.2013;2013;01;01;Keskiviikko;0;0;0;2;1;3
96;16.01.2013;2013;01;02;Keskiviikko;2;1;3;0;0;0
96;16.01.2013;2013;01;03;Keskiviikko;0;0;0;0;0;0
96;16.01.2013;2013;01;04;Keskiviikko;1;0;1;0;1;1
96;16.01.2013;2013;01;05;Keskiviikko;2;6;8;0;1;1
96;16.01.2013;2013;01;06;Keskiviikko;24;23;47;4;4;8
96;16.01.2013;2013;01;07;Keskiviikko;47;50;97;13;7;20
96;16.01.2013;2013;01;08;Keskiviikko;81;71;152;6;10;16
96;16.01.2013;2013;01;09;Keskiviikko;42;39;81;6;5;11
96;16.01.2013;2013;01;10;Keskiviikko;26;19;45;6;7;13
96;16.01.2013;2013;01;11;Keskiviikko;26;25;51;4;6;10
96;16.01.2013;2013;01;12;Keskiviikko;34;39;73;2;14;16
96;16.01.2013;2013;01;13;Keskiviikko;22;32;54;4;13;17
96;16.01.2013;2013;01;14;Keskiviikko;33;52;85;0;15;15
96;16.01.2013;2013;01;15;Keskiviikko;48;100;148;9;27;36
96;16.01.2013;2013;01;16;Keskiviikko;57;77;134;9;42;51
96;16.01.2013;2013;01;17;Keskiviikko;26;43;69;4;16;20
96;16.01.2013;2013;01;18;Keskiviikko;31;22;53;10;6;16
96;16.01.2013;2013;01;19;Keskiviikko;29;11;40;3;9;12
96;16.01.2013;2013;01;20;Keskiviikko;21;16;37;4;9;13
96;16.01.2013;2013;01;21;Keskiviikko;11;24;35;3;5;8
96;16.01.2013;2013;01;22;Keskiviikko;10;7;17;1;3;4
96;16.01.2013;2013;01;23;Keskiviikko;4;1;5;1;0;1
96;17.01.2013;2013;01;00;Torstai;3;0;3;0;0;0
96;17.01.2013;2013;01;01;Torstai;2;2;4;0;1;1
96;17.01.2013;2013;01;02;Torstai;2;0;2;0;0;0
96;17.01.2013;2013;01;03;Torstai;0;0;0;1;1;2
96;17.01.2013;2013;01;04;Torstai;1;0;1;0;0;0
96;17.01.2013;2013;01;05;Torstai;0;4;4;0;1;1
96;17.01.2013;2013;01;06;Torstai;20;14;34;3;1;4
96;17.01.2013;2013;01;07;Torstai;45;43;88;3;7;10
96;17.01.2013;2013;01;08;Torstai;92;62;154;4;4;8
96;17.01.2013;2013;01;09;Torstai;32;28;60;3;7;10
96;17.01.2013;2013;01;10;Torstai;26;23;49;1;4;5
96;17.01.2013;2013;01;11;Torstai;25;21;46;6;5;11
96;17.01.2013;2013;01;12;Torstai;30;27;57;5;5;10
96;17.01.2013;2013;01;13;Torstai;29;39;68;1;12;13
96;17.01.2013;2013;01;14;Torstai;35;59;94;4;11;15
96;17.01.2013;2013;01;15;Torstai;51;107;158;6;36;42
96;17.01.2013;2013;01;16;Torstai;47;77;124;3;49;52
96;17.01.2013;2013;01;17;Torstai;28;33;61;3;10;13
96;17.01.2013;2013;01;18;Torstai;25;30;55;5;7;12
96;17.01.2013;2013;01;19;Torstai;19;16;35;1;6;7
96;17.01.2013;2013;01;20;Torstai;21;23;44;1;4;5
96;17.01.2013;2013;01;21;Torstai;17;13;30;0;3;3
96;17.01.2013;2013;01;22;Torstai;5;2;7;1;2;3
96;17.01.2013;2013;01;23;Torstai;0;0;0;0;1;1
96;18.01.2013;2013;01;00;Perjantai;2;0;2;0;0;0
96;18.01.2013;2013;01;01;Perjantai;3;0;3;0;0;0
96;18.01.2013;2013;01;02;Perjantai;0;0;0;0;0;0
96;18.01.2013;2013;01;03;Perjantai;0;0;0;0;0;0
96;18.01.2013;2013;01;04;Perjantai;2;0;2;1;0;1
96;18.01.2013;2013;01;05;Perjantai;3;3;6;0;2;2
96;18.01.2013;2013;01;06;Perjantai;22;25;47;1;3;4
96;18.01.2013;2013;01;07;Perjantai;59;59;118;2;4;6
96;18.01.2013;2013;01;08;Perjantai;89;71;160;4;7;11
96;18.01.2013;2013;01;09;Perjantai;34;39;73;3;3;6
96;18.01.2013;2013;01;10;Perjantai;38;31;69;1;6;7
96;18.01.2013;2013;01;11;Perjantai;32;45;77;0;3;3
96;18.01.2013;2013;01;12;Perjantai;36;40;76;1;4;5
96;18.01.2013;2013;01;13;Perjantai;38;51;89;0;8;8
96;18.01.2013;2013;01;14;Perjantai;53;74;127;5;11;16
96;18.01.2013;2013;01;15;Perjantai;79;104;183;5;14;19
96;18.01.2013;2013;01;16;Perjantai;56;65;121;0;10;10
96;18.01.2013;2013;01;17;Perjantai;39;40;79;2;8;10
96;18.01.2013;2013;01;18;Perjantai;27;26;53;1;7;8
96;18.01.2013;2013;01;19;Perjantai;15;20;35;1;3;4
96;18.01.2013;2013;01;20;Perjantai;17;18;35;0;7;7
96;18.01.2013;2013;01;21;Perjantai;18;13;31;2;2;4
96;18.01.2013;2013;01;22;Perjantai;8;8;16;1;0;1
96;18.01.2013;2013;01;23;Perjantai;6;4;10;0;0;0
96;19.01.2013;2013;01;00;Lauantai;2;3;5;1;0;1
96;19.01.2013;2013;01;01;Lauantai;6;2;8;0;0;0
96;19.01.2013;2013;01;02;Lauantai;8;3;11;0;0;0
96;19.01.2013;2013;01;03;Lauantai;3;0;3;1;0;1
96;19.01.2013;2013;01;04;Lauantai;5;2;7;0;2;2
96;19.01.2013;2013;01;05;Lauantai;3;0;3;0;0;0
96;19.01.2013;2013;01;06;Lauantai;8;7;15;0;0;0
96;19.01.2013;2013;01;07;Lauantai;5;3;8;0;2;2
96;19.01.2013;2013;01;08;Lauantai;5;4;9;2;2;4
96;19.01.2013;2013;01;09;Lauantai;8;5;13;3;4;7
96;19.01.2013;2013;01;10;Lauantai;15;13;28;5;6;11
96;19.01.2013;2013;01;11;Lauantai;23;19;42;10;5;15
96;19.01.2013;2013;01;12;Lauantai;23;21;44;7;5;12
96;19.01.2013;2013;01;13;Lauantai;23;22;45;8;20;28
96;19.01.2013;2013;01;14;Lauantai;22;21;43;5;12;17
96;19.01.2013;2013;01;15;Lauantai;27;24;51;4;19;23
96;19.01.2013;2013;01;16;Lauantai;29;28;57;5;8;13
96;19.01.2013;2013;01;17;Lauantai;23;21;44;7;8;15
96;19.01.2013;2013;01;18;Lauantai;17;14;31;14;5;19
96;19.01.2013;2013;01;19;Lauantai;26;23;49;6;4;10
96;19.01.2013;2013;01;20;Lauantai;12;10;22;4;8;12
96;19.01.2013;2013;01;21;Lauantai;6;3;9;1;8;9
96;19.01.2013;2013;01;22;Lauantai;9;6;15;0;4;4
96;19.01.2013;2013;01;23;Lauantai;4;3;7;0;0;0
96;20.01.2013;2013;01;00;Sunnuntai;1;1;2;0;1;1
96;20.01.2013;2013;01;01;Sunnuntai;6;3;9;2;1;3
96;20.01.2013;2013;01;02;Sunnuntai;3;1;4;0;0;0
96;20.01.2013;2013;01;03;Sunnuntai;1;0;1;0;0;0
96;20.01.2013;2013;01;04;Sunnuntai;6;6;12;1;0;1
96;20.01.2013;2013;01;05;Sunnuntai;1;0;1;0;1;1
96;20.01.2013;2013;01;06;Sunnuntai;9;7;16;1;1;2
96;20.01.2013;2013;01;07;Sunnuntai;5;3;8;1;3;4
96;20.01.2013;2013;01;08;Sunnuntai;2;0;2;0;2;2
96;20.01.2013;2013;01;09;Sunnuntai;5;4;9;0;1;1
96;20.01.2013;2013;01;10;Sunnuntai;10;9;19;4;3;7
96;20.01.2013;2013;01;11;Sunnuntai;12;10;22;3;5;8
96;20.01.2013;2013;01;12;Sunnuntai;13;10;23;4;8;12
96;20.01.2013;2013;01;13;Sunnuntai;20;18;38;2;10;12
96;20.01.2013;2013;01;14;Sunnuntai;15;15;30;5;12;17
96;20.01.2013;2013;01;15;Sunnuntai;22;20;42;4;9;13
96;20.01.2013;2013;01;16;Sunnuntai;17;16;33;6;4;10
96;20.01.2013;2013;01;17;Sunnuntai;13;12;25;9;5;14
96;20.01.2013;2013;01;18;Sunnuntai;21;19;40;3;12;15
96;20.01.2013;2013;01;19;Sunnuntai;10;9;19;5;13;18
96;20.01.2013;2013;01;20;Sunnuntai;14;13;27;6;5;11
96;20.01.2013;2013;01;21;Sunnuntai;20;18;38;2;4;6
96;20.01.2013;2013;01;22;Sunnuntai;4;1;5;0;2;2
96;20.01.2013;2013;01;23;Sunnuntai;3;0;3;0;0;0
96;21.01.2013;2013;01;00;Maanantai;3;0;3;0;0;0
96;21.01.2013;2013;01;01;Maanantai;3;1;4;0;0;0
96;21.01.2013;2013;01;02;Maanantai;2;1;3;0;0;0
96;21.01.2013;2013;01;03;Maanantai;2;0;2;0;0;0
96;21.01.2013;2013;01;04;Maanantai;2;0;2;0;0;0
96;21.01.2013;2013;01;05;Maanantai;7;4;11;0;0;0
96;21.01.2013;2013;01;06;Maanantai;29;26;55;0;0;0
96;21.01.2013;2013;01;07;Maanantai;56;54;110;0;0;0
96;21.01.2013;2013;01;08;Maanantai;76;76;152;0;0;0
96;21.01.2013;2013;01;09;Maanantai;42;41;83;0;0;0
96;21.01.2013;2013;01;10;Maanantai;35;33;68;0;0;0
96;21.01.2013;2013;01;11;Maanantai;27;25;52;0;0;0
96;21.01.2013;2013;01;12;Maanantai;44;42;86;0;0;0
96;21.01.2013;2013;01;13;Maanantai;34;31;65;0;0;0
96;21.01.2013;2013;01;14;Maanantai;59;58;117;0;0;0
96;21.01.2013;2013;01;15;Maanantai;95;92;187;0;0;0
96;21.01.2013;2013;01;16;Maanantai;93;91;184;0;0;0
96;21.01.2013;2013;01;17;Maanantai;57;55;112;0;0;0
96;21.01.2013;2013;01;18;Maanantai;37;35;72;0;0;0
96;21.01.2013;2013;01;19;Maanantai;37;36;73;0;0;0
96;21.01.2013;2013;01;20;Maanantai;28;26;54;0;0;0
96;21.01.2013;2013;01;21;Maanantai;18;15;33;0;0;0
96;21.01.2013;2013;01;22;Maanantai;10;8;18;0;0;0
96;21.01.2013;2013;01;23;Maanantai;4;2;6;0;0;0
96;22.01.2013;2013;01;00;Tiistai;2;0;2;0;0;0
96;22.01.2013;2013;01;01;Tiistai;3;1;4;0;0;0
96;22.01.2013;2013;01;02;Tiistai;1;1;2;0;0;0
96;22.01.2013;2013;01;03;Tiistai;1;0;1;0;0;0
96;22.01.2013;2013;01;04;Tiistai;1;1;2;0;0;0
96;22.01.2013;2013;01;05;Tiistai;6;4;10;0;0;0
96;22.01.2013;2013;01;06;Tiistai;30;29;59;0;0;0
96;22.01.2013;2013;01;07;Tiistai;68;67;135;0;0;0
96;22.01.2013;2013;01;08;Tiistai;94;93;187;0;0;0
96;22.01.2013;2013;01;09;Tiistai;42;41;83;0;0;0
96;22.01.2013;2013;01;10;Tiistai;44;43;87;0;0;0
96;22.01.2013;2013;01;11;Tiistai;35;31;66;0;0;0
96;22.01.2013;2013;01;12;Tiistai;45;43;88;0;0;0
96;22.01.2013;2013;01;13;Tiistai;41;39;80;0;0;0
96;22.01.2013;2013;01;14;Tiistai;52;49;101;0;0;0
96;22.01.2013;2013;01;15;Tiistai;109;107;216;0;0;0
96;22.01.2013;2013;01;16;Tiistai;97;96;193;0;0;0
96;22.01.2013;2013;01;17;Tiistai;53;52;105;0;0;0
96;22.01.2013;2013;01;18;Tiistai;35;33;68;0;0;0
96;22.01.2013;2013;01;19;Tiistai;34;31;65;0;0;0
96;22.01.2013;2013;01;20;Tiistai;28;25;53;0;0;0
96;22.01.2013;2013;01;21;Tiistai;24;23;47;0;0;0
96;22.01.2013;2013;01;22;Tiistai;7;4;11;0;0;0
96;22.01.2013;2013;01;23;Tiistai;4;2;6;0;0;0
96;23.01.2013;2013;01;00;Keskiviikko;1;0;1;0;0;0
96;23.01.2013;2013;01;01;Keskiviikko;2;1;3;0;0;0
96;23.01.2013;2013;01;02;Keskiviikko;0;0;0;0;0;0
96;23.01.2013;2013;01;03;Keskiviikko;0;0;0;0;0;0
96;23.01.2013;2013;01;04;Keskiviikko;1;0;1;0;0;0
96;23.01.2013;2013;01;05;Keskiviikko;5;4;9;0;0;0
96;23.01.2013;2013;01;06;Keskiviikko;31;28;59;0;0;0
96;23.01.2013;2013;01;07;Keskiviikko;64;61;125;0;0;0
96;23.01.2013;2013;01;08;Keskiviikko;80;79;159;0;0;0
96;23.01.2013;2013;01;09;Keskiviikko;50;48;98;0;0;0
96;23.01.2013;2013;01;10;Keskiviikko;36;34;70;0;0;0
96;23.01.2013;2013;01;11;Keskiviikko;32;30;62;0;0;0
96;23.01.2013;2013;01;12;Keskiviikko;47;45;92;0;0;0
96;23.01.2013;2013;01;13;Keskiviikko;38;36;74;0;0;0
96;23.01.2013;2013;01;14;Keskiviikko;58;57;115;0;0;0
96;23.01.2013;2013;01;15;Keskiviikko;78;76;154;0;0;0
96;23.01.2013;2013;01;16;Keskiviikko;81;80;161;0;0;0
96;23.01.2013;2013;01;17;Keskiviikko;53;51;104;0;0;0
96;23.01.2013;2013;01;18;Keskiviikko;40;37;77;0;0;0
96;23.01.2013;2013;01;19;Keskiviikko;46;43;89;0;0;0
96;23.01.2013;2013;01;20;Keskiviikko;29;28;57;0;0;0
96;23.01.2013;2013;01;21;Keskiviikko;29;27;56;0;0;0
96;23.01.2013;2013;01;22;Keskiviikko;7;5;12;0;0;0
96;23.01.2013;2013;01;23;Keskiviikko;5;5;10;0;0;0
96;24.01.2013;2013;01;00;Torstai;0;0;0;0;0;0
96;24.01.2013;2013;01;01;Torstai;0;0;0;0;0;0
96;24.01.2013;2013;01;02;Torstai;2;0;2;0;0;0
96;24.01.2013;2013;01;03;Torstai;3;1;4;0;0;0
96;24.01.2013;2013;01;04;Torstai;2;0;2;0;0;0
96;24.01.2013;2013;01;05;Torstai;5;4;9;0;0;0
96;24.01.2013;2013;01;06;Torstai;30;26;56;0;0;0
96;24.01.2013;2013;01;07;Torstai;63;62;125;0;0;0
96;24.01.2013;2013;01;08;Torstai;78;76;154;0;0;0
96;24.01.2013;2013;01;09;Torstai;37;36;73;0;0;0
96;24.01.2013;2013;01;10;Torstai;41;40;81;0;0;0
96;24.01.2013;2013;01;11;Torstai;28;26;54;0;0;0
96;24.01.2013;2013;01;12;Torstai;44;41;85;0;0;0
96;24.01.2013;2013;01;13;Torstai;33;31;64;0;0;0
96;24.01.2013;2013;01;14;Torstai;45;45;90;0;0;0
96;24.01.2013;2013;01;15;Torstai;81;88;169;0;0;0
96;24.01.2013;2013;01;16;Torstai;78;89;167;0;0;0
96;24.01.2013;2013;01;17;Torstai;47;49;96;0;0;0
96;24.01.2013;2013;01;18;Torstai;36;34;70;0;0;0
96;24.01.2013;2013;01;19;Torstai;27;20;47;0;0;0
96;24.01.2013;2013;01;20;Torstai;17;18;35;0;0;0
96;24.01.2013;2013;01;21;Torstai;18;22;40;0;0;0
96;24.01.2013;2013;01;22;Torstai;11;10;21;0;0;0
96;24.01.2013;2013;01;23;Torstai;3;1;4;0;0;0
96;25.01.2013;2013;01;00;Perjantai;1;1;2;0;0;0
96;25.01.2013;2013;01;01;Perjantai;1;0;1;0;0;0
96;25.01.2013;2013;01;02;Perjantai;0;0;0;0;0;0
96;25.01.2013;2013;01;03;Perjantai;0;0;0;0;0;0
96;25.01.2013;2013;01;04;Perjantai;1;0;1;0;0;0
96;25.01.2013;2013;01;05;Perjantai;6;5;11;0;0;0
96;25.01.2013;2013;01;06;Perjantai;24;23;47;0;0;0
96;25.01.2013;2013;01;07;Perjantai;61;57;118;0;0;0
96;25.01.2013;2013;01;08;Perjantai;78;77;155;0;0;0
96;25.01.2013;2013;01;09;Perjantai;31;29;60;0;0;0
96;25.01.2013;2013;01;10;Perjantai;34;33;67;0;0;0
96;25.01.2013;2013;01;11;Perjantai;36;35;71;0;0;0
96;25.01.2013;2013;01;12;Perjantai;49;48;97;0;0;0
96;25.01.2013;2013;01;13;Perjantai;45;42;87;0;0;0
96;25.01.2013;2013;01;14;Perjantai;59;61;120;0;0;0
96;25.01.2013;2013;01;15;Perjantai;85;78;163;0;0;0
96;25.01.2013;2013;01;16;Perjantai;46;45;91;0;0;0
96;25.01.2013;2013;01;17;Perjantai;39;36;75;0;0;0
96;25.01.2013;2013;01;18;Perjantai;27;25;52;0;0;0
96;25.01.2013;2013;01;19;Perjantai;17;16;33;0;0;0
96;25.01.2013;2013;01;20;Perjantai;21;17;38;0;0;0
96;25.01.2013;2013;01;21;Perjantai;13;11;24;0;0;0
96;25.01.2013;2013;01;22;Perjantai;11;10;21;0;0;0
96;25.01.2013;2013;01;23;Perjantai;8;6;14;0;0;0
96;26.01.2013;2013;01;00;Lauantai;4;2;6;0;0;0
96;26.01.2013;2013;01;01;Lauantai;4;1;5;0;0;0
96;26.01.2013;2013;01;02;Lauantai;3;0;3;0;0;0
96;26.01.2013;2013;01;03;Lauantai;6;3;9;0;0;0
96;26.01.2013;2013;01;04;Lauantai;4;0;4;0;0;0
96;26.01.2013;2013;01;05;Lauantai;1;0;1;0;0;0
96;26.01.2013;2013;01;06;Lauantai;10;8;18;0;0;0
96;26.01.2013;2013;01;07;Lauantai;6;5;11;0;0;0
96;26.01.2013;2013;01;08;Lauantai;6;6;12;0;0;0
96;26.01.2013;2013;01;09;Lauantai;9;6;15;0;0;0
96;26.01.2013;2013;01;10;Lauantai;14;12;26;0;0;0
96;26.01.2013;2013;01;11;Lauantai;22;21;43;0;0;0
96;26.01.2013;2013;01;12;Lauantai;19;19;38;0;0;0
96;26.01.2013;2013;01;13;Lauantai;24;22;46;0;0;0
96;26.01.2013;2013;01;14;Lauantai;28;26;54;0;0;0
96;26.01.2013;2013;01;15;Lauantai;25;22;47;0;0;0
96;26.01.2013;2013;01;16;Lauantai;22;20;42;0;0;0
96;26.01.2013;2013;01;17;Lauantai;30;26;56;0;0;0
96;26.01.2013;2013;01;18;Lauantai;17;14;31;0;0;0
96;26.01.2013;2013;01;19;Lauantai;15;12;27;0;0;0
96;26.01.2013;2013;01;20;Lauantai;11;11;22;0;0;0
96;26.01.2013;2013;01;21;Lauantai;13;10;23;0;0;0
96;26.01.2013;2013;01;22;Lauantai;12;10;22;0;0;0
96;26.01.2013;2013;01;23;Lauantai;4;4;8;0;0;0
96;27.01.2013;2013;01;00;Sunnuntai;4;4;8;0;0;0
96;27.01.2013;2013;01;01;Sunnuntai;7;5;12;0;0;0
96;27.01.2013;2013;01;02;Sunnuntai;3;2;5;0;0;0
96;27.01.2013;2013;01;03;Sunnuntai;2;1;3;0;0;0
96;27.01.2013;2013;01;04;Sunnuntai;5;3;8;0;0;0
96;27.01.2013;2013;01;05;Sunnuntai;2;0;2;0;0;0
96;27.01.2013;2013;01;06;Sunnuntai;9;7;16;0;0;0
96;27.01.2013;2013;01;07;Sunnuntai;4;3;7;0;0;0
96;27.01.2013;2013;01;08;Sunnuntai;4;1;5;0;0;0
96;27.01.2013;2013;01;09;Sunnuntai;4;2;6;0;0;0
96;27.01.2013;2013;01;10;Sunnuntai;4;4;8;0;0;0
96;27.01.2013;2013;01;11;Sunnuntai;10;9;19;0;0;0
96;27.01.2013;2013;01;12;Sunnuntai;16;14;30;0;0;0
96;27.01.2013;2013;01;13;Sunnuntai;15;13;28;0;0;0
96;27.01.2013;2013;01;14;Sunnuntai;20;18;38;0;0;0
96;27.01.2013;2013;01;15;Sunnuntai;19;19;38;0;0;0
96;27.01.2013;2013;01;16;Sunnuntai;21;18;39;0;0;0
96;27.01.2013;2013;01;17;Sunnuntai;25;22;47;0;0;0
96;27.01.2013;2013;01;18;Sunnuntai;21;18;39;0;0;0
96;27.01.2013;2013;01;19;Sunnuntai;22;20;42;0;0;0
96;27.01.2013;2013;01;20;Sunnuntai;16;15;31;0;0;0
96;27.01.2013;2013;01;21;Sunnuntai;12;9;21;0;0;0
96;27.01.2013;2013;01;22;Sunnuntai;6;3;9;0;0;0
96;27.01.2013;2013;01;23;Sunnuntai;4;3;7;0;0;0
96;28.01.2013;2013;01;00;Maanantai;2;0;2;0;0;0
96;28.01.2013;2013;01;01;Maanantai;1;1;2;1;0;1
96;28.01.2013;2013;01;02;Maanantai;0;0;0;0;0;0
96;28.01.2013;2013;01;03;Maanantai;0;0;0;0;0;0
96;28.01.2013;2013;01;04;Maanantai;1;0;1;0;0;0
96;28.01.2013;2013;01;05;Maanantai;5;4;9;1;1;2
96;28.01.2013;2013;01;06;Maanantai;27;25;52;6;6;12
96;28.01.2013;2013;01;07;Maanantai;61;58;119;23;14;37
96;28.01.2013;2013;01;08;Maanantai;84;79;163;6;5;11
96;28.01.2013;2013;01;09;Maanantai;39;37;76;15;13;28
96;28.01.2013;2013;01;10;Maanantai;35;34;69;1;7;8
96;28.01.2013;2013;01;11;Maanantai;25;22;47;7;18;25
96;28.01.2013;2013;01;12;Maanantai;37;35;72;4;12;16
96;28.01.2013;2013;01;13;Maanantai;41;40;81;3;8;11
96;28.01.2013;2013;01;14;Maanantai;57;54;111;0;15;15
96;28.01.2013;2013;01;15;Maanantai;85;82;167;9;54;63
96;28.01.2013;2013;01;16;Maanantai;83;81;164;4;40;44
96;28.01.2013;2013;01;17;Maanantai;53;49;102;6;15;21
96;28.01.2013;2013;01;18;Maanantai;32;31;63;7;12;19
96;28.01.2013;2013;01;19;Maanantai;35;33;68;5;25;30
96;28.01.2013;2013;01;20;Maanantai;21;19;40;5;10;15
96;28.01.2013;2013;01;21;Maanantai;13;13;26;2;6;8
96;28.01.2013;2013;01;22;Maanantai;5;2;7;0;4;4
96;28.01.2013;2013;01;23;Maanantai;2;1;3;0;1;1
96;29.01.2013;2013;01;00;Tiistai;1;0;1;0;0;0
96;29.01.2013;2013;01;01;Tiistai;1;0;1;0;0;0
96;29.01.2013;2013;01;02;Tiistai;1;0;1;0;0;0
96;29.01.2013;2013;01;03;Tiistai;2;0;2;0;1;1
96;29.01.2013;2013;01;04;Tiistai;1;0;1;1;0;1
96;29.01.2013;2013;01;05;Tiistai;5;4;9;0;1;1
96;29.01.2013;2013;01;06;Tiistai;27;25;52;2;2;4
96;29.01.2013;2013;01;07;Tiistai;73;71;144;1;10;11
96;29.01.2013;2013;01;08;Tiistai;86;85;171;0;6;6
96;29.01.2013;2013;01;09;Tiistai;41;38;79;3;3;6
96;29.01.2013;2013;01;10;Tiistai;37;35;72;7;3;10
96;29.01.2013;2013;01;11;Tiistai;43;41;84;2;5;7
96;29.01.2013;2013;01;12;Tiistai;46;44;90;3;17;20
96;29.01.2013;2013;01;13;Tiistai;43;40;83;3;9;12
96;29.01.2013;2013;01;14;Tiistai;57;56;113;4;9;13
96;29.01.2013;2013;01;15;Tiistai;100;79;179;3;34;37
96;29.01.2013;2013;01;16;Tiistai;106;68;174;7;33;40
96;29.01.2013;2013;01;17;Tiistai;82;35;117;4;17;21
96;29.01.2013;2013;01;18;Tiistai;63;19;82;5;26;31
96;29.01.2013;2013;01;19;Tiistai;51;13;64;4;13;17
96;29.01.2013;2013;01;20;Tiistai;30;21;51;5;10;15
96;29.01.2013;2013;01;21;Tiistai;38;24;62;4;8;12
96;29.01.2013;2013;01;22;Tiistai;11;4;15;2;1;3
96;29.01.2013;2013;01;23;Tiistai;5;1;6;2;0;2
96;30.01.2013;2013;01;00;Keskiviikko;2;0;2;1;0;1
96;30.01.2013;2013;01;01;Keskiviikko;2;1;3;2;2;4
96;30.01.2013;2013;01;02;Keskiviikko;2;0;2;0;0;0
96;30.01.2013;2013;01;03;Keskiviikko;0;0;0;0;0;0
96;30.01.2013;2013;01;04;Keskiviikko;0;2;2;1;0;1
96;30.01.2013;2013;01;05;Keskiviikko;0;6;6;0;2;2
96;30.01.2013;2013;01;06;Keskiviikko;23;33;56;15;6;21
96;30.01.2013;2013;01;07;Keskiviikko;88;66;154;38;13;51
96;30.01.2013;2013;01;08;Keskiviikko;77;85;162;20;8;28
96;30.01.2013;2013;01;09;Keskiviikko;60;38;98;13;11;24
96;30.01.2013;2013;01;10;Keskiviikko;45;28;73;7;10;17
96;30.01.2013;2013;01;11;Keskiviikko;26;32;58;11;12;23
96;30.01.2013;2013;01;12;Keskiviikko;31;42;73;9;16;25
96;30.01.2013;2013;01;13;Keskiviikko;21;68;89;11;15;26
96;30.01.2013;2013;01;14;Keskiviikko;40;66;106;7;14;21
96;30.01.2013;2013;01;15;Keskiviikko;53;125;178;7;39;46
96;30.01.2013;2013;01;16;Keskiviikko;73;102;175;14;45;59
96;30.01.2013;2013;01;17;Keskiviikko;30;57;87;8;15;23
96;30.01.2013;2013;01;18;Keskiviikko;30;39;69;12;18;30
96;30.01.2013;2013;01;19;Keskiviikko;38;11;49;18;3;21
96;30.01.2013;2013;01;20;Keskiviikko;50;8;58;7;2;9
96;30.01.2013;2013;01;21;Keskiviikko;33;7;40;6;2;8
96;30.01.2013;2013;01;22;Keskiviikko;10;1;11;1;0;1
96;30.01.2013;2013;01;23;Keskiviikko;9;2;11;1;0;1
96;31.01.2013;2013;01;00;Torstai;0;1;1;1;0;1
96;31.01.2013;2013;01;01;Torstai;2;1;3;1;0;1
96;31.01.2013;2013;01;02;Torstai;0;0;0;0;0;0
96;31.01.2013;2013;01;03;Torstai;1;0;1;3;2;5
96;31.01.2013;2013;01;04;Torstai;3;1;4;0;0;0
96;31.01.2013;2013;01;05;Torstai;2;1;3;0;1;1
96;31.01.2013;2013;01;06;Torstai;39;6;45;14;3;17
96;31.01.2013;2013;01;07;Torstai;85;23;108;28;4;32
96;31.01.2013;2013;01;08;Torstai;94;49;143;12;4;16
96;31.01.2013;2013;01;09;Torstai;43;41;84;1;0;1
96;31.01.2013;2013;01;10;Torstai;34;32;66;0;0;0
96;31.01.2013;2013;01;11;Torstai;36;29;65;3;2;5
96;31.01.2013;2013;01;12;Torstai;35;56;91;4;10;14
96;31.01.2013;2013;01;13;Torstai;34;49;83;15;22;37
96;31.01.2013;2013;01;14;Torstai;41;55;96;9;22;31
96;31.01.2013;2013;01;15;Torstai;48;121;169;7;41;48
96;31.01.2013;2013;01;16;Torstai;60;79;139;13;29;42
96;31.01.2013;2013;01;17;Torstai;39;47;86;7;14;21
96;31.01.2013;2013;01;18;Torstai;35;30;65;8;17;25
96;31.01.2013;2013;01;19;Torstai;27;28;55;11;15;26
96;31.01.2013;2013;01;20;Torstai;23;12;35;11;9;20
96;31.01.2013;2013;01;21;Torstai;20;18;38;7;3;10
96;31.01.2013;2013;01;22;Torstai;6;5;11;4;3;7
96;31.01.2013;2013;01;23;Torstai;4;1;5;1;1;2
96;01.02.2013;2013;02;00;Perjantai;2;1;3;1;1;2
96;01.02.2013;2013;02;01;Perjantai;0;0;0;0;1;1
96;01.02.2013;2013;02;02;Perjantai;0;0;0;0;0;0
96;01.02.2013;2013;02;03;Perjantai;3;0;3;2;1;3
96;01.02.2013;2013;02;04;Perjantai;3;0;3;0;0;0
96;01.02.2013;2013;02;05;Perjantai;2;2;4;0;0;0
96;01.02.2013;2013;02;06;Perjantai;22;20;42;18;4;22
96;01.02.2013;2013;02;07;Perjantai;59;50;109;28;20;48
96;01.02.2013;2013;02;08;Perjantai;76;80;156;17;16;33
96;01.02.2013;2013;02;09;Perjantai;45;40;85;10;15;25
96;01.02.2013;2013;02;10;Perjantai;30;51;81;11;11;22
96;01.02.2013;2013;02;11;Perjantai;38;57;95;15;16;31
96;01.02.2013;2013;02;12;Perjantai;43;58;101;24;29;53
96;01.02.2013;2013;02;13;Perjantai;34;58;92;13;17;30
96;01.02.2013;2013;02;14;Perjantai;40;93;133;7;30;37
96;01.02.2013;2013;02;15;Perjantai;57;103;160;17;48;65
96;01.02.2013;2013;02;16;Perjantai;51;60;111;13;28;41
96;01.02.2013;2013;02;17;Perjantai;44;33;77;7;11;18
96;01.02.2013;2013;02;18;Perjantai;29;26;55;3;10;13
96;01.02.2013;2013;02;19;Perjantai;16;20;36;7;10;17
96;01.02.2013;2013;02;20;Perjantai;12;12;24;7;4;11
96;01.02.2013;2013;02;21;Perjantai;21;10;31;2;10;12
96;01.02.2013;2013;02;22;Perjantai;5;11;16;2;3;5
96;01.02.2013;2013;02;23;Perjantai;7;3;10;1;0;1
96;02.02.2013;2013;02;00;Lauantai;5;3;8;0;0;0
96;02.02.2013;2013;02;01;Lauantai;7;0;7;1;0;1
96;02.02.2013;2013;02;02;Lauantai;4;0;4;5;0;5
96;02.02.2013;2013;02;03;Lauantai;3;0;3;0;0;0
96;02.02.2013;2013;02;04;Lauantai;5;0;5;2;0;2
96;02.02.2013;2013;02;05;Lauantai;0;2;2;0;0;0
96;02.02.2013;2013;02;06;Lauantai;11;4;15;3;0;3
96;02.02.2013;2013;02;07;Lauantai;3;3;6;2;5;7
96;02.02.2013;2013;02;08;Lauantai;3;6;9;4;4;8
96;02.02.2013;2013;02;09;Lauantai;2;19;21;8;4;12
96;02.02.2013;2013;02;10;Lauantai;9;22;31;11;10;21
96;02.02.2013;2013;02;11;Lauantai;12;22;34;6;15;21
96;02.02.2013;2013;02;12;Lauantai;12;14;26;12;12;24
96;02.02.2013;2013;02;13;Lauantai;12;13;25;8;14;22
96;02.02.2013;2013;02;14;Lauantai;19;28;47;7;10;17
96;02.02.2013;2013;02;15;Lauantai;18;23;41;8;16;24
96;02.02.2013;2013;02;16;Lauantai;11;25;36;18;23;41
96;02.02.2013;2013;02;17;Lauantai;9;18;27;16;7;23
96;02.02.2013;2013;02;18;Lauantai;23;7;30;11;4;15
96;02.02.2013;2013;02;19;Lauantai;18;10;28;22;9;31
96;02.02.2013;2013;02;20;Lauantai;4;6;10;7;5;12
96;02.02.2013;2013;02;21;Lauantai;6;9;15;2;4;6
96;02.02.2013;2013;02;22;Lauantai;4;10;14;2;12;14
96;02.02.2013;2013;02;23;Lauantai;2;10;12;1;1;2
96;03.02.2013;2013;02;00;Sunnuntai;4;2;6;3;0;3
96;03.02.2013;2013;02;01;Sunnuntai;7;1;8;2;0;2
96;03.02.2013;2013;02;02;Sunnuntai;6;0;6;3;1;4
96;03.02.2013;2013;02;03;Sunnuntai;1;1;2;1;1;2
96;03.02.2013;2013;02;04;Sunnuntai;8;2;10;2;1;3
96;03.02.2013;2013;02;05;Sunnuntai;1;0;1;1;0;1
96;03.02.2013;2013;02;06;Sunnuntai;7;4;11;3;1;4
96;03.02.2013;2013;02;07;Sunnuntai;2;3;5;0;6;6
96;03.02.2013;2013;02;08;Sunnuntai;3;2;5;1;0;1
96;03.02.2013;2013;02;09;Sunnuntai;2;10;12;6;6;12
96;03.02.2013;2013;02;10;Sunnuntai;4;13;17;11;4;15
96;03.02.2013;2013;02;11;Sunnuntai;8;7;15;6;12;18
96;03.02.2013;2013;02;12;Sunnuntai;9;12;21;12;16;28
96;03.02.2013;2013;02;13;Sunnuntai;16;14;30;13;16;29
96;03.02.2013;2013;02;14;Sunnuntai;24;16;40;14;14;28
96;03.02.2013;2013;02;15;Sunnuntai;9;28;37;10;12;22
96;03.02.2013;2013;02;16;Sunnuntai;21;15;36;23;10;33
96;03.02.2013;2013;02;17;Sunnuntai;13;14;27;15;12;27
96;03.02.2013;2013;02;18;Sunnuntai;27;16;43;21;15;36
96;03.02.2013;2013;02;19;Sunnuntai;13;10;23;5;11;16
96;03.02.2013;2013;02;20;Sunnuntai;9;17;26;11;16;27
96;03.02.2013;2013;02;21;Sunnuntai;11;25;36;7;13;20
96;03.02.2013;2013;02;22;Sunnuntai;3;5;8;4;4;8
96;03.02.2013;2013;02;23;Sunnuntai;1;2;3;0;0;0
96;04.02.2013;2013;02;00;Maanantai;5;3;8;3;0;3
96;04.02.2013;2013;02;01;Maanantai;1;0;1;0;0;0
96;04.02.2013;2013;02;02;Maanantai;0;0;0;0;1;1
96;04.02.2013;2013;02;03;Maanantai;0;3;3;0;0;0
96;04.02.2013;2013;02;04;Maanantai;3;0;3;2;3;5
96;04.02.2013;2013;02;05;Maanantai;4;8;12;0;1;1
96;04.02.2013;2013;02;06;Maanantai;35;39;74;16;5;21
96;04.02.2013;2013;02;07;Maanantai;80;59;139;35;10;45
96;04.02.2013;2013;02;08;Maanantai;105;85;190;19;4;23
96;04.02.2013;2013;02;09;Maanantai;56;54;110;9;16;25
96;04.02.2013;2013;02;10;Maanantai;30;48;78;11;17;28
96;04.02.2013;2013;02;11;Maanantai;28;45;73;11;12;23
96;04.02.2013;2013;02;12;Maanantai;44;55;99;16;24;40
96;04.02.2013;2013;02;13;Maanantai;35;38;73;12;10;22
96;04.02.2013;2013;02;14;Maanantai;62;91;153;10;17;27
96;04.02.2013;2013;02;15;Maanantai;52;124;176;13;45;58
96;04.02.2013;2013;02;16;Maanantai;56;158;214;11;52;63
96;04.02.2013;2013;02;17;Maanantai;48;73;121;10;23;33
96;04.02.2013;2013;02;18;Maanantai;44;30;74;19;17;36
96;04.02.2013;2013;02;19;Maanantai;37;31;68;13;17;30
96;04.02.2013;2013;02;20;Maanantai;26;24;50;10;12;22
96;04.02.2013;2013;02;21;Maanantai;20;20;40;9;8;17
96;04.02.2013;2013;02;22;Maanantai;9;4;13;0;2;2
96;04.02.2013;2013;02;23;Maanantai;0;3;3;0;0;0
96;05.02.2013;2013;02;00;Tiistai;1;1;2;2;0;2
96;05.02.2013;2013;02;01;Tiistai;1;0;1;0;0;0
96;05.02.2013;2013;02;02;Tiistai;0;0;0;0;1;1
96;05.02.2013;2013;02;03;Tiistai;0;1;1;0;0;0
96;05.02.2013;2013;02;04;Tiistai;1;0;1;0;1;1
96;05.02.2013;2013;02;05;Tiistai;1;5;6;0;0;0
96;05.02.2013;2013;02;06;Tiistai;35;26;61;17;5;22
96;05.02.2013;2013;02;07;Tiistai;81;64;145;36;9;45
96;05.02.2013;2013;02;08;Tiistai;94;87;181;14;14;28
96;05.02.2013;2013;02;09;Tiistai;34;56;90;12;10;22
96;05.02.2013;2013;02;10;Tiistai;47;35;82;11;6;17
96;05.02.2013;2013;02;11;Tiistai;22;40;62;21;17;38
96;05.02.2013;2013;02;12;Tiistai;36;61;97;9;19;28
96;05.02.2013;2013;02;13;Tiistai;21;44;65;9;19;28
96;05.02.2013;2013;02;14;Tiistai;52;73;125;14;24;38
96;05.02.2013;2013;02;15;Tiistai;56;137;193;13;43;56
96;05.02.2013;2013;02;16;Tiistai;73;130;203;14;41;55
96;05.02.2013;2013;02;17;Tiistai;36;51;87;11;26;37
96;05.02.2013;2013;02;18;Tiistai;27;35;62;23;25;48
96;05.02.2013;2013;02;19;Tiistai;37;38;75;18;15;33
96;05.02.2013;2013;02;20;Tiistai;43;17;60;13;11;24
96;05.02.2013;2013;02;21;Tiistai;31;14;45;4;5;9
96;05.02.2013;2013;02;22;Tiistai;9;7;16;2;2;4
96;05.02.2013;2013;02;23;Tiistai;4;2;6;0;0;0
96;06.02.2013;2013;02;00;Keskiviikko;1;0;1;0;0;0
96;06.02.2013;2013;02;01;Keskiviikko;2;1;3;0;0;0
96;06.02.2013;2013;02;02;Keskiviikko;3;1;4;1;1;2
96;06.02.2013;2013;02;03;Keskiviikko;4;1;5;0;0;0
96;06.02.2013;2013;02;04;Keskiviikko;2;1;3;0;1;1
96;06.02.2013;2013;02;05;Keskiviikko;1;7;8;1;0;1
96;06.02.2013;2013;02;06;Keskiviikko;32;26;58;16;2;18
96;06.02.2013;2013;02;07;Keskiviikko;88;68;156;38;17;55
96;06.02.2013;2013;02;08;Keskiviikko;105;90;195;20;17;37
96;06.02.2013;2013;02;09;Keskiviikko;37;46;83;8;13;21
96;06.02.2013;2013;02;10;Keskiviikko;33;41;74;17;13;30
96;06.02.2013;2013;02;11;Keskiviikko;40;30;70;12;9;21
96;06.02.2013;2013;02;12;Keskiviikko;37;51;88;14;9;23
96;06.02.2013;2013;02;13;Keskiviikko;35;28;63;13;10;23
96;06.02.2013;2013;02;14;Keskiviikko;40;77;117;7;19;26
96;06.02.2013;2013;02;15;Keskiviikko;50;111;161;9;44;53
96;06.02.2013;2013;02;16;Keskiviikko;57;114;171;11;46;57
96;06.02.2013;2013;02;17;Keskiviikko;45;60;105;16;27;43
96;06.02.2013;2013;02;18;Keskiviikko;43;36;79;22;15;37
96;06.02.2013;2013;02;19;Keskiviikko;51;23;74;19;14;33
96;06.02.2013;2013;02;20;Keskiviikko;29;25;54;12;15;27
96;06.02.2013;2013;02;21;Keskiviikko;14;32;46;5;16;21
96;06.02.2013;2013;02;22;Keskiviikko;9;10;19;1;1;2
96;06.02.2013;2013;02;23;Keskiviikko;5;7;12;1;2;3
96;07.02.2013;2013;02;00;Torstai;4;1;5;2;0;2
96;07.02.2013;2013;02;01;Torstai;0;1;1;0;0;0
96;07.02.2013;2013;02;02;Torstai;7;1;8;0;0;0
96;07.02.2013;2013;02;03;Torstai;2;0;2;0;0;0
96;07.02.2013;2013;02;04;Torstai;2;1;3;0;1;1
96;07.02.2013;2013;02;05;Torstai;1;4;5;1;1;2
96;07.02.2013;2013;02;06;Torstai;25;24;49;16;8;24
96;07.02.2013;2013;02;07;Torstai;81;58;139;38;11;49
96;07.02.2013;2013;02;08;Torstai;110;80;190;19;8;27
96;07.02.2013;2013;02;09;Torstai;38;45;83;11;9;20
96;07.02.2013;2013;02;10;Torstai;26;30;56;12;13;25
96;07.02.2013;2013;02;11;Torstai;29;31;60;7;10;17
96;07.02.2013;2013;02;12;Torstai;38;43;81;14;11;25
96;07.02.2013;2013;02;13;Torstai;29;49;78;16;15;31
96;07.02.2013;2013;02;14;Torstai;31;68;99;5;14;19
96;07.02.2013;2013;02;15;Torstai;49;115;164;8;49;57
96;07.02.2013;2013;02;16;Torstai;68;110;178;11;45;56
96;07.02.2013;2013;02;17;Torstai;43;43;86;14;24;38
96;07.02.2013;2013;02;18;Torstai;26;23;49;25;16;41
96;07.02.2013;2013;02;19;Torstai;27;33;60;8;12;20
96;07.02.2013;2013;02;20;Torstai;34;17;51;6;6;12
96;07.02.2013;2013;02;21;Torstai;20;15;35;7;8;15
96;07.02.2013;2013;02;22;Torstai;9;9;18;3;4;7
96;07.02.2013;2013;02;23;Torstai;3;0;3;3;1;4
96;08.02.2013;2013;02;00;Perjantai;1;0;1;0;0;0
96;08.02.2013;2013;02;01;Perjantai;3;0;3;1;0;1
96;08.02.2013;2013;02;02;Perjantai;4;0;4;2;2;4
96;08.02.2013;2013;02;03;Perjantai;3;0;3;0;0;0
96;08.02.2013;2013;02;04;Perjantai;12;1;13;1;0;1
96;08.02.2013;2013;02;05;Perjantai;3;7;10;0;1;1
96;08.02.2013;2013;02;06;Perjantai;32;21;53;15;1;16
96;08.02.2013;2013;02;07;Perjantai;55;59;114;28;7;35
96;08.02.2013;2013;02;08;Perjantai;93;53;146;24;10;34
96;08.02.2013;2013;02;09;Perjantai;19;34;53;14;10;24
96;08.02.2013;2013;02;10;Perjantai;25;27;52;9;9;18
96;08.02.2013;2013;02;11;Perjantai;26;43;69;7;11;18
96;08.02.2013;2013;02;12;Perjantai;23;47;70;8;17;25
96;08.02.2013;2013;02;13;Perjantai;35;39;74;15;21;36
96;08.02.2013;2013;02;14;Perjantai;44;65;109;8;20;28
96;08.02.2013;2013;02;15;Perjantai;50;107;157;22;29;51
96;08.02.2013;2013;02;16;Perjantai;47;52;99;7;25;32
96;08.02.2013;2013;02;17;Perjantai;30;23;53;8;5;13
96;08.02.2013;2013;02;18;Perjantai;17;23;40;7;14;21
96;08.02.2013;2013;02;19;Perjantai;18;15;33;7;10;17
96;08.02.2013;2013;02;20;Perjantai;15;16;31;7;3;10
96;08.02.2013;2013;02;21;Perjantai;19;16;35;5;9;14
96;08.02.2013;2013;02;22;Perjantai;6;7;13;1;3;4
96;08.02.2013;2013;02;23;Perjantai;7;3;10;1;0;1
96;09.02.2013;2013;02;00;Lauantai;8;1;9;2;1;3
96;09.02.2013;2013;02;01;Lauantai;7;1;8;2;1;3
96;09.02.2013;2013;02;02;Lauantai;5;0;5;0;0;0
96;09.02.2013;2013;02;03;Lauantai;5;0;5;2;0;2
96;09.02.2013;2013;02;04;Lauantai;7;2;9;0;1;1
96;09.02.2013;2013;02;05;Lauantai;3;0;3;0;2;2
96;09.02.2013;2013;02;06;Lauantai;17;1;18;6;0;6
96;09.02.2013;2013;02;07;Lauantai;1;9;10;1;6;7
96;09.02.2013;2013;02;08;Lauantai;7;8;15;3;7;10
96;09.02.2013;2013;02;09;Lauantai;4;20;24;7;11;18
96;09.02.2013;2013;02;10;Lauantai;3;13;16;3;9;12
96;09.02.2013;2013;02;11;Lauantai;7;11;18;4;5;9
96;09.02.2013;2013;02;12;Lauantai;19;24;43;14;11;25
96;09.02.2013;2013;02;13;Lauantai;19;17;36;8;15;23
96;09.02.2013;2013;02;14;Lauantai;17;25;42;9;15;24
96;09.02.2013;2013;02;15;Lauantai;26;25;51;12;11;23
96;09.02.2013;2013;02;16;Lauantai;18;17;35;8;7;15
96;09.02.2013;2013;02;17;Lauantai;12;20;32;4;7;11
96;09.02.2013;2013;02;18;Lauantai;23;15;38;8;4;12
96;09.02.2013;2013;02;19;Lauantai;10;10;20;12;6;18
96;09.02.2013;2013;02;20;Lauantai;8;9;17;3;6;9
96;09.02.2013;2013;02;21;Lauantai;9;10;19;5;11;16
96;09.02.2013;2013;02;22;Lauantai;2;7;9;0;1;1
96;09.02.2013;2013;02;23;Lauantai;4;0;4;1;2;3
96;10.02.2013;2013;02;00;Sunnuntai;6;2;8;0;0;0
96;10.02.2013;2013;02;01;Sunnuntai;4;2;6;0;1;1
96;10.02.2013;2013;02;02;Sunnuntai;3;2;5;1;0;1
96;10.02.2013;2013;02;03;Sunnuntai;3;1;4;1;0;1
96;10.02.2013;2013;02;04;Sunnuntai;5;3;8;2;0;2
96;10.02.2013;2013;02;05;Sunnuntai;2;0;2;1;0;1
96;10.02.2013;2013;02;06;Sunnuntai;11;5;16;4;1;5
96;10.02.2013;2013;02;07;Sunnuntai;2;5;7;1;3;4
96;10.02.2013;2013;02;08;Sunnuntai;1;5;6;2;1;3
96;10.02.2013;2013;02;09;Sunnuntai;4;11;15;2;6;8
96;10.02.2013;2013;02;10;Sunnuntai;8;9;17;9;12;21
96;10.02.2013;2013;02;11;Sunnuntai;15;15;30;11;16;27
96;10.02.2013;2013;02;12;Sunnuntai;12;19;31;14;22;36
96;10.02.2013;2013;02;13;Sunnuntai;22;29;51;15;13;28
96;10.02.2013;2013;02;14;Sunnuntai;17;24;41;6;16;22
96;10.02.2013;2013;02;15;Sunnuntai;22;25;47;9;10;19
96;10.02.2013;2013;02;16;Sunnuntai;30;17;47;19;10;29
96;10.02.2013;2013;02;17;Sunnuntai;20;16;36;16;6;22
96;10.02.2013;2013;02;18;Sunnuntai;24;15;39;22;10;32
96;10.02.2013;2013;02;19;Sunnuntai;12;4;16;12;17;29
96;10.02.2013;2013;02;20;Sunnuntai;12;15;27;5;18;23
96;10.02.2013;2013;02;21;Sunnuntai;6;10;16;3;7;10
96;10.02.2013;2013;02;22;Sunnuntai;4;2;6;1;2;3
96;10.02.2013;2013;02;23;Sunnuntai;5;1;6;2;1;3
96;11.02.2013;2013;02;00;Maanantai;2;1;3;3;1;4
96;11.02.2013;2013;02;01;Maanantai;0;0;0;0;0;0
96;11.02.2013;2013;02;02;Maanantai;0;0;0;0;0;0
96;11.02.2013;2013;02;03;Maanantai;0;0;0;0;0;0
96;11.02.2013;2013;02;04;Maanantai;2;0;2;0;0;0
96;11.02.2013;2013;02;05;Maanantai;5;6;11;0;1;1
96;11.02.2013;2013;02;06;Maanantai;19;27;46;11;5;16
96;11.02.2013;2013;02;07;Maanantai;82;57;139;18;16;34
96;11.02.2013;2013;02;08;Maanantai;104;88;192;14;12;26
96;11.02.2013;2013;02;09;Maanantai;54;45;99;8;18;26
96;11.02.2013;2013;02;10;Maanantai;27;46;73;12;13;25
96;11.02.2013;2013;02;11;Maanantai;38;38;76;13;16;29
96;11.02.2013;2013;02;12;Maanantai;31;33;64;15;25;40
96;11.02.2013;2013;02;13;Maanantai;39;49;88;20;16;36
96;11.02.2013;2013;02;14;Maanantai;44;56;100;13;17;30
96;11.02.2013;2013;02;15;Maanantai;48;124;172;15;47;62
96;11.02.2013;2013;02;16;Maanantai;75;124;199;19;50;69
96;11.02.2013;2013;02;17;Maanantai;60;61;121;11;23;34
96;11.02.2013;2013;02;18;Maanantai;43;49;92;21;17;38
96;11.02.2013;2013;02;19;Maanantai;42;28;70;13;8;21
96;11.02.2013;2013;02;20;Maanantai;26;17;43;10;12;22
96;11.02.2013;2013;02;21;Maanantai;23;15;38;7;10;17
96;11.02.2013;2013;02;22;Maanantai;6;4;10;2;3;5
96;11.02.2013;2013;02;23;Maanantai;3;0;3;0;0;0
96;12.02.2013;2013;02;00;Tiistai;3;0;3;0;0;0
96;12.02.2013;2013;02;01;Tiistai;0;0;0;0;0;0
96;12.02.2013;2013;02;02;Tiistai;3;0;3;0;0;0
96;12.02.2013;2013;02;03;Tiistai;1;0;1;0;0;0
96;12.02.2013;2013;02;04;Tiistai;1;0;1;0;0;0
96;12.02.2013;2013;02;05;Tiistai;2;6;8;0;1;1
96;12.02.2013;2013;02;06;Tiistai;20;19;39;18;3;21
96;12.02.2013;2013;02;07;Tiistai;82;61;143;29;11;40
96;12.02.2013;2013;02;08;Tiistai;114;74;188;15;10;25
96;12.02.2013;2013;02;09;Tiistai;49;46;95;14;12;26
96;12.02.2013;2013;02;10;Tiistai;42;39;81;77;70;147
96;12.02.2013;2013;02;11;Tiistai;34;37;71;7;12;19
96;12.02.2013;2013;02;12;Tiistai;30;50;80;11;20;31
96;12.02.2013;2013;02;13;Tiistai;36;49;85;11;17;28
96;12.02.2013;2013;02;14;Tiistai;32;76;108;24;30;54
96;12.02.2013;2013;02;15;Tiistai;64;113;177;7;34;41
96;12.02.2013;2013;02;16;Tiistai;73;140;213;18;49;67
96;12.02.2013;2013;02;17;Tiistai;41;49;90;17;26;43
96;12.02.2013;2013;02;18;Tiistai;34;41;75;23;11;34
96;12.02.2013;2013;02;19;Tiistai;28;32;60;13;17;30
96;12.02.2013;2013;02;20;Tiistai;30;26;56;14;15;29
96;12.02.2013;2013;02;21;Tiistai;23;21;44;6;6;12
96;12.02.2013;2013;02;22;Tiistai;11;3;14;2;3;5
96;12.02.2013;2013;02;23;Tiistai;5;3;8;1;0;1
96;13.02.2013;2013;02;00;Keskiviikko;5;0;5;1;0;1
96;13.02.2013;2013;02;01;Keskiviikko;1;0;1;1;0;1
96;13.02.2013;2013;02;02;Keskiviikko;5;2;7;0;1;1
96;13.02.2013;2013;02;03;Keskiviikko;3;0;3;1;0;1
96;13.02.2013;2013;02;04;Keskiviikko;2;1;3;1;0;1
96;13.02.2013;2013;02;05;Keskiviikko;1;7;8;0;0;0
96;13.02.2013;2013;02;06;Keskiviikko;18;24;42;15;5;20
96;13.02.2013;2013;02;07;Keskiviikko;82;69;151;31;15;46
96;13.02.2013;2013;02;08;Keskiviikko;101;83;184;30;11;41
96;13.02.2013;2013;02;09;Keskiviikko;29;46;75;11;17;28
96;13.02.2013;2013;02;10;Keskiviikko;29;38;67;14;10;24
96;13.02.2013;2013;02;11;Keskiviikko;34;30;64;16;15;31
96;13.02.2013;2013;02;12;Keskiviikko;39;49;88;7;21;28
96;13.02.2013;2013;02;13;Keskiviikko;38;44;82;13;17;30
96;13.02.2013;2013;02;14;Keskiviikko;39;61;100;12;19;31
96;13.02.2013;2013;02;15;Keskiviikko;59;126;185;10;45;55
96;13.02.2013;2013;02;16;Keskiviikko;67;99;166;17;48;65
96;13.02.2013;2013;02;17;Keskiviikko;52;55;107;15;20;35
96;13.02.2013;2013;02;18;Keskiviikko;49;36;85;25;17;42
96;13.02.2013;2013;02;19;Keskiviikko;39;28;67;18;11;29
96;13.02.2013;2013;02;20;Keskiviikko;26;33;59;14;15;29
96;13.02.2013;2013;02;21;Keskiviikko;24;22;46;3;12;15
96;13.02.2013;2013;02;22;Keskiviikko;7;7;14;1;4;5
96;13.02.2013;2013;02;23;Keskiviikko;9;3;12;0;0;0
96;14.02.2013;2013;02;00;Torstai;2;2;4;0;0;0
96;14.02.2013;2013;02;01;Torstai;0;1;1;0;0;0
96;14.02.2013;2013;02;02;Torstai;3;0;3;1;0;1
96;14.02.2013;2013;02;03;Torstai;2;0;2;0;0;0
96;14.02.2013;2013;02;04;Torstai;2;1;3;1;2;3
96;14.02.2013;2013;02;05;Torstai;4;8;12;0;0;0
96;14.02.2013;2013;02;06;Torstai;26;22;48;18;7;25
96;14.02.2013;2013;02;07;Torstai;74;61;135;33;9;42
96;14.02.2013;2013;02;08;Torstai;103;104;207;27;15;42
96;14.02.2013;2013;02;09;Torstai;41;41;82;8;15;23
96;14.02.2013;2013;02;10;Torstai;34;30;64;10;12;22
96;14.02.2013;2013;02;11;Torstai;53;35;88;12;14;26
96;14.02.2013;2013;02;12;Torstai;50;30;80;11;15;26
96;14.02.2013;2013;02;13;Torstai;31;58;89;14;14;28
96;14.02.2013;2013;02;14;Torstai;52;67;119;20;25;45
96;14.02.2013;2013;02;15;Torstai;56;130;186;7;40;47
96;14.02.2013;2013;02;16;Torstai;79;101;180;15;33;48
96;14.02.2013;2013;02;17;Torstai;50;41;91;6;21;27
96;14.02.2013;2013;02;18;Torstai;42;28;70;14;16;30
96;14.02.2013;2013;02;19;Torstai;30;19;49;19;12;31
96;14.02.2013;2013;02;20;Torstai;40;14;54;20;6;26
96;14.02.2013;2013;02;21;Torstai;38;14;52;8;6;14
96;14.02.2013;2013;02;22;Torstai;12;6;18;0;1;1
96;14.02.2013;2013;02;23;Torstai;2;1;3;0;0;0
96;15.02.2013;2013;02;00;Perjantai;3;0;3;1;1;2
96;15.02.2013;2013;02;01;Perjantai;4;0;4;1;0;1
96;15.02.2013;2013;02;02;Perjantai;1;2;3;1;0;1
96;15.02.2013;2013;02;03;Perjantai;1;0;1;1;0;1
96;15.02.2013;2013;02;04;Perjantai;2;1;3;2;4;6
96;15.02.2013;2013;02;05;Perjantai;2;6;8;0;0;0
96;15.02.2013;2013;02;06;Perjantai;27;29;56;23;4;27
96;15.02.2013;2013;02;07;Perjantai;82;42;124;25;9;34
96;15.02.2013;2013;02;08;Perjantai;94;53;147;26;9;35
96;15.02.2013;2013;02;09;Perjantai;42;45;87;7;6;13
96;15.02.2013;2013;02;10;Perjantai;28;38;66;12;12;24
96;15.02.2013;2013;02;11;Perjantai;37;35;72;11;14;25
96;15.02.2013;2013;02;12;Perjantai;32;54;86;13;15;28
96;15.02.2013;2013;02;13;Perjantai;30;47;77;14;14;28
96;15.02.2013;2013;02;14;Perjantai;40;92;132;8;75;83
96;15.02.2013;2013;02;15;Perjantai;41;132;173;11;48;59
96;15.02.2013;2013;02;16;Perjantai;56;58;114;62;33;95
96;15.02.2013;2013;02;17;Perjantai;46;29;75;12;16;28
96;15.02.2013;2013;02;18;Perjantai;37;23;60;8;8;16
96;15.02.2013;2013;02;19;Perjantai;23;24;47;6;12;18
96;15.02.2013;2013;02;20;Perjantai;19;5;24;6;1;7
96;15.02.2013;2013;02;21;Perjantai;11;14;25;4;4;8
96;15.02.2013;2013;02;22;Perjantai;5;7;12;3;2;5
96;15.02.2013;2013;02;23;Perjantai;6;3;9;1;0;1
96;16.02.2013;2013;02;00;Lauantai;2;6;8;4;1;5
96;16.02.2013;2013;02;01;Lauantai;3;0;3;0;0;0
96;16.02.2013;2013;02;02;Lauantai;5;0;5;0;0;0
96;16.02.2013;2013;02;03;Lauantai;3;1;4;1;0;1
96;16.02.2013;2013;02;04;Lauantai;7;0;7;1;0;1
96;16.02.2013;2013;02;05;Lauantai;1;1;2;0;1;1
96;16.02.2013;2013;02;06;Lauantai;14;7;21;10;2;12
96;16.02.2013;2013;02;07;Lauantai;2;7;9;2;2;4
96;16.02.2013;2013;02;08;Lauantai;3;12;15;2;7;9
96;16.02.2013;2013;02;09;Lauantai;7;11;18;7;7;14
96;16.02.2013;2013;02;10;Lauantai;7;17;24;7;11;18
96;16.02.2013;2013;02;11;Lauantai;10;32;42;6;12;18
96;16.02.2013;2013;02;12;Lauantai;34;18;52;10;19;29
96;16.02.2013;2013;02;13;Lauantai;32;27;59;11;29;40
96;16.02.2013;2013;02;14;Lauantai;26;25;51;9;19;28
96;16.02.2013;2013;02;15;Lauantai;26;33;59;11;11;22
96;16.02.2013;2013;02;16;Lauantai;26;31;57;11;19;30
96;16.02.2013;2013;02;17;Lauantai;14;19;33;11;6;17
96;16.02.2013;2013;02;18;Lauantai;24;11;35;16;10;26
96;16.02.2013;2013;02;19;Lauantai;27;12;39;22;7;29
96;16.02.2013;2013;02;20;Lauantai;9;10;19;3;4;7
96;16.02.2013;2013;02;21;Lauantai;6;12;18;2;9;11
96;16.02.2013;2013;02;22;Lauantai;6;26;32;1;10;11
96;16.02.2013;2013;02;23;Lauantai;6;6;12;1;1;2
96;17.02.2013;2013;02;00;Sunnuntai;2;4;6;2;1;3
96;17.02.2013;2013;02;01;Sunnuntai;7;0;7;0;1;1
96;17.02.2013;2013;02;02;Sunnuntai;4;2;6;1;0;1
96;17.02.2013;2013;02;03;Sunnuntai;6;0;6;0;0;0
96;17.02.2013;2013;02;04;Sunnuntai;5;0;5;3;0;3
96;17.02.2013;2013;02;05;Sunnuntai;4;3;7;0;0;0
96;17.02.2013;2013;02;06;Sunnuntai;14;5;19;5;1;6
96;17.02.2013;2013;02;07;Sunnuntai;3;4;7;0;6;6
96;17.02.2013;2013;02;08;Sunnuntai;2;3;5;7;4;11
96;17.02.2013;2013;02;09;Sunnuntai;8;5;13;4;9;13
96;17.02.2013;2013;02;10;Sunnuntai;1;9;10;8;6;14
96;17.02.2013;2013;02;11;Sunnuntai;7;9;16;15;16;31
96;17.02.2013;2013;02;12;Sunnuntai;27;23;50;8;17;25
96;17.02.2013;2013;02;13;Sunnuntai;23;22;45;14;17;31
96;17.02.2013;2013;02;14;Sunnuntai;24;27;51;9;9;18
96;17.02.2013;2013;02;15;Sunnuntai;17;20;37;7;13;20
96;17.02.2013;2013;02;16;Sunnuntai;28;10;38;25;9;34
96;17.02.2013;2013;02;17;Sunnuntai;22;15;37;9;5;14
96;17.02.2013;2013;02;18;Sunnuntai;13;10;23;32;26;58
96;17.02.2013;2013;02;19;Sunnuntai;11;7;18;9;11;20
96;17.02.2013;2013;02;20;Sunnuntai;10;14;24;15;15;30
96;17.02.2013;2013;02;21;Sunnuntai;6;19;25;3;10;13
96;17.02.2013;2013;02;22;Sunnuntai;2;3;5;3;2;5
96;17.02.2013;2013;02;23;Sunnuntai;5;6;11;0;2;2
96;18.02.2013;2013;02;00;Maanantai;4;0;4;3;0;3
96;18.02.2013;2013;02;01;Maanantai;2;0;2;1;0;1
96;18.02.2013;2013;02;02;Maanantai;0;0;0;0;0;0
96;18.02.2013;2013;02;03;Maanantai;0;0;0;1;1;2
96;18.02.2013;2013;02;04;Maanantai;1;1;2;3;4;7
96;18.02.2013;2013;02;05;Maanantai;2;8;10;1;0;1
96;18.02.2013;2013;02;06;Maanantai;29;23;52;13;4;17
96;18.02.2013;2013;02;07;Maanantai;77;50;127;25;12;37
96;18.02.2013;2013;02;08;Maanantai;100;71;171;19;9;28
96;18.02.2013;2013;02;09;Maanantai;47;40;87;16;17;33
96;18.02.2013;2013;02;10;Maanantai;25;36;61;16;11;27
96;18.02.2013;2013;02;11;Maanantai;30;31;61;6;21;27
96;18.02.2013;2013;02;12;Maanantai;36;49;85;22;17;39
96;18.02.2013;2013;02;13;Maanantai;45;47;92;22;18;40
96;18.02.2013;2013;02;14;Maanantai;42;74;116;15;26;41
96;18.02.2013;2013;02;15;Maanantai;57;140;197;17;47;64
96;18.02.2013;2013;02;16;Maanantai;58;114;172;15;50;65
96;18.02.2013;2013;02;17;Maanantai;51;58;109;20;20;40
96;18.02.2013;2013;02;18;Maanantai;36;40;76;24;15;39
96;18.02.2013;2013;02;19;Maanantai;33;27;60;10;17;27
96;18.02.2013;2013;02;20;Maanantai;26;13;39;12;12;24
96;18.02.2013;2013;02;21;Maanantai;21;22;43;7;2;9
96;18.02.2013;2013;02;22;Maanantai;11;2;13;0;3;3
96;18.02.2013;2013;02;23;Maanantai;6;1;7;2;0;2
96;19.02.2013;2013;02;00;Tiistai;3;3;6;0;0;0
96;19.02.2013;2013;02;01;Tiistai;3;0;3;0;0;0
96;19.02.2013;2013;02;02;Tiistai;3;1;4;0;0;0
96;19.02.2013;2013;02;03;Tiistai;0;1;1;0;0;0
96;19.02.2013;2013;02;04;Tiistai;2;0;2;0;1;1
96;19.02.2013;2013;02;05;Tiistai;2;5;7;2;0;2
96;19.02.2013;2013;02;06;Tiistai;27;21;48;14;4;18
96;19.02.2013;2013;02;07;Tiistai;82;65;147;27;14;41
96;19.02.2013;2013;02;08;Tiistai;104;71;175;20;13;33
96;19.02.2013;2013;02;09;Tiistai;23;51;74;10;11;21
96;19.02.2013;2013;02;10;Tiistai;37;37;74;11;14;25
96;19.02.2013;2013;02;11;Tiistai;39;31;70;9;15;24
96;19.02.2013;2013;02;12;Tiistai;35;45;80;17;26;43
96;19.02.2013;2013;02;13;Tiistai;28;49;77;11;23;34
96;19.02.2013;2013;02;14;Tiistai;41;73;114;8;31;39
96;19.02.2013;2013;02;15;Tiistai;57;128;185;15;40;55
96;19.02.2013;2013;02;16;Tiistai;95;102;197;12;45;57
96;19.02.2013;2013;02;17;Tiistai;46;57;103;35;33;68
96;19.02.2013;2013;02;18;Tiistai;40;33;73;21;18;39
96;19.02.2013;2013;02;19;Tiistai;29;28;57;14;18;32
96;19.02.2013;2013;02;20;Tiistai;29;24;53;9;12;21
96;19.02.2013;2013;02;21;Tiistai;21;22;43;7;12;19
96;19.02.2013;2013;02;22;Tiistai;10;1;11;1;1;2
96;19.02.2013;2013;02;23;Tiistai;2;1;3;0;1;1
96;20.02.2013;2013;02;00;Keskiviikko;0;0;0;1;0;1
96;20.02.2013;2013;02;01;Keskiviikko;0;0;0;0;0;0
96;20.02.2013;2013;02;02;Keskiviikko;0;0;0;1;0;1
96;20.02.2013;2013;02;03;Keskiviikko;3;0;3;0;0;0
96;20.02.2013;2013;02;04;Keskiviikko;1;1;2;0;0;0
96;20.02.2013;2013;02;05;Keskiviikko;3;5;8;0;0;0
96;20.02.2013;2013;02;06;Keskiviikko;24;20;44;17;5;22
96;20.02.2013;2013;02;07;Keskiviikko;81;44;125;35;11;46
96;20.02.2013;2013;02;08;Keskiviikko;110;64;174;20;11;31
96;20.02.2013;2013;02;09;Keskiviikko;26;33;59;14;7;21
96;20.02.2013;2013;02;10;Keskiviikko;24;29;53;13;15;28
96;20.02.2013;2013;02;11;Keskiviikko;24;23;47;9;13;22
96;20.02.2013;2013;02;12;Keskiviikko;32;35;67;10;22;32
96;20.02.2013;2013;02;13;Keskiviikko;43;46;89;15;24;39
96;20.02.2013;2013;02;14;Keskiviikko;45;59;104;13;29;42
96;20.02.2013;2013;02;15;Keskiviikko;47;124;171;5;66;71
96;20.02.2013;2013;02;16;Keskiviikko;69;109;178;21;50;71
96;20.02.2013;2013;02;17;Keskiviikko;50;48;98;12;21;33
96;20.02.2013;2013;02;18;Keskiviikko;47;32;79;18;12;30
96;20.02.2013;2013;02;19;Keskiviikko;34;16;50;21;11;32
96;20.02.2013;2013;02;20;Keskiviikko;25;32;57;11;10;21
96;20.02.2013;2013;02;21;Keskiviikko;12;31;43;6;13;19
96;20.02.2013;2013;02;22;Keskiviikko;13;7;20;2;3;5
96;20.02.2013;2013;02;23;Keskiviikko;8;3;11;0;0;0
96;21.02.2013;2013;02;00;Torstai;4;0;4;0;0;0
96;21.02.2013;2013;02;01;Torstai;1;0;1;2;0;2
96;21.02.2013;2013;02;02;Torstai;2;2;4;0;0;0
96;21.02.2013;2013;02;03;Torstai;3;0;3;0;0;0
96;21.02.2013;2013;02;04;Torstai;3;0;3;0;0;0
96;21.02.2013;2013;02;05;Torstai;3;5;8;0;0;0
96;21.02.2013;2013;02;06;Torstai;23;19;42;18;11;29
96;21.02.2013;2013;02;07;Torstai;77;53;130;30;11;41
96;21.02.2013;2013;02;08;Torstai;109;85;194;26;7;33
96;21.02.2013;2013;02;09;Torstai;33;47;80;7;16;23
96;21.02.2013;2013;02;10;Torstai;25;35;60;19;15;34
96;21.02.2013;2013;02;11;Torstai;47;32;79;9;12;21
96;21.02.2013;2013;02;12;Torstai;44;34;78;12;15;27
96;21.02.2013;2013;02;13;Torstai;39;53;92;11;17;28
96;21.02.2013;2013;02;14;Torstai;51;69;120;10;25;35
96;21.02.2013;2013;02;15;Torstai;59;135;194;10;44;54
96;21.02.2013;2013;02;16;Torstai;62;103;165;11;51;62
96;21.02.2013;2013;02;17;Torstai;43;42;85;18;19;37
96;21.02.2013;2013;02;18;Torstai;35;47;82;19;19;38
96;21.02.2013;2013;02;19;Torstai;41;26;67;14;14;28
96;21.02.2013;2013;02;20;Torstai;43;15;58;12;12;24
96;21.02.2013;2013;02;21;Torstai;18;13;31;13;11;24
96;21.02.2013;2013;02;22;Torstai;12;6;18;0;3;3
96;21.02.2013;2013;02;23;Torstai;3;1;4;1;0;1
96;22.02.2013;2013;02;00;Perjantai;2;1;3;1;1;2
96;22.02.2013;2013;02;01;Perjantai;0;0;0;0;1;1
96;22.02.2013;2013;02;02;Perjantai;1;0;1;2;0;2
96;22.02.2013;2013;02;03;Perjantai;0;0;0;0;0;0
96;22.02.2013;2013;02;04;Perjantai;3;1;4;0;0;0
96;22.02.2013;2013;02;05;Perjantai;3;7;10;0;0;0
96;22.02.2013;2013;02;06;Perjantai;24;17;41;14;8;22
96;22.02.2013;2013;02;07;Perjantai;73;57;130;30;15;45
96;22.02.2013;2013;02;08;Perjantai;89;58;147;26;14;40
96;22.02.2013;2013;02;09;Perjantai;31;45;76;9;17;26
96;22.02.2013;2013;02;10;Perjantai;38;45;83;11;7;18
96;22.02.2013;2013;02;11;Perjantai;32;54;86;14;17;31
96;22.02.2013;2013;02;12;Perjantai;49;51;100;9;24;33
96;22.02.2013;2013;02;13;Perjantai;50;74;124;13;28;41
96;22.02.2013;2013;02;14;Perjantai;39;83;122;14;30;44
96;22.02.2013;2013;02;15;Perjantai;71;114;185;7;43;50
96;22.02.2013;2013;02;16;Perjantai;60;54;114;8;34;42
96;22.02.2013;2013;02;17;Perjantai;38;24;62;12;10;22
96;22.02.2013;2013;02;18;Perjantai;33;27;60;10;7;17
96;22.02.2013;2013;02;19;Perjantai;24;21;45;7;6;13
96;22.02.2013;2013;02;20;Perjantai;21;8;29;10;6;16
96;22.02.2013;2013;02;21;Perjantai;11;18;29;1;10;11
96;22.02.2013;2013;02;22;Perjantai;15;7;22;0;3;3
96;22.02.2013;2013;02;23;Perjantai;8;1;9;6;1;7
96;23.02.2013;2013;02;00;Lauantai;9;4;13;2;0;2
96;23.02.2013;2013;02;01;Lauantai;3;1;4;1;0;1
96;23.02.2013;2013;02;02;Lauantai;6;0;6;1;0;1
96;23.02.2013;2013;02;03;Lauantai;5;1;6;3;0;3
96;23.02.2013;2013;02;04;Lauantai;2;1;3;1;0;1
96;23.02.2013;2013;02;05;Lauantai;3;1;4;0;0;0
96;23.02.2013;2013;02;06;Lauantai;10;7;17;6;4;10
96;23.02.2013;2013;02;07;Lauantai;5;13;18;0;2;2
96;23.02.2013;2013;02;08;Lauantai;5;10;15;0;4;4
96;23.02.2013;2013;02;09;Lauantai;6;17;23;7;9;16
96;23.02.2013;2013;02;10;Lauantai;11;17;28;14;11;25
96;23.02.2013;2013;02;11;Lauantai;23;19;42;8;9;17
96;23.02.2013;2013;02;12;Lauantai;19;30;49;9;15;24
96;23.02.2013;2013;02;13;Lauantai;23;32;55;17;11;28
96;23.02.2013;2013;02;14;Lauantai;19;33;52;9;13;22
96;23.02.2013;2013;02;15;Lauantai;28;22;50;9;13;22
96;23.02.2013;2013;02;16;Lauantai;30;7;37;9;11;20
96;23.02.2013;2013;02;17;Lauantai;22;24;46;18;1;19
96;23.02.2013;2013;02;18;Lauantai;14;12;26;20;5;25
96;23.02.2013;2013;02;19;Lauantai;11;21;32;8;17;25
96;23.02.2013;2013;02;20;Lauantai;5;15;20;5;6;11
96;23.02.2013;2013;02;21;Lauantai;8;11;19;5;12;17
96;23.02.2013;2013;02;22;Lauantai;8;14;22;0;13;13
96;23.02.2013;2013;02;23;Lauantai;9;6;15;1;1;2
96;24.02.2013;2013;02;00;Sunnuntai;9;2;11;0;2;2
96;24.02.2013;2013;02;01;Sunnuntai;2;0;2;1;0;1
96;24.02.2013;2013;02;02;Sunnuntai;12;1;13;0;0;0
96;24.02.2013;2013;02;03;Sunnuntai;4;0;4;3;0;3
96;24.02.2013;2013;02;04;Sunnuntai;7;0;7;4;0;4
96;24.02.2013;2013;02;05;Sunnuntai;1;0;1;0;1;1
96;24.02.2013;2013;02;06;Sunnuntai;5;7;12;3;1;4
96;24.02.2013;2013;02;07;Sunnuntai;4;4;8;1;4;5
96;24.02.2013;2013;02;08;Sunnuntai;1;1;2;4;10;14
96;24.02.2013;2013;02;09;Sunnuntai;3;8;11;5;14;19
96;24.02.2013;2013;02;10;Sunnuntai;4;14;18;10;10;20
96;24.02.2013;2013;02;11;Sunnuntai;10;14;24;14;18;32
96;24.02.2013;2013;02;12;Sunnuntai;21;20;41;29;20;49
96;24.02.2013;2013;02;13;Sunnuntai;32;19;51;12;28;40
96;24.02.2013;2013;02;14;Sunnuntai;36;21;57;29;25;54
96;24.02.2013;2013;02;15;Sunnuntai;17;27;44;16;40;56
96;24.02.2013;2013;02;16;Sunnuntai;20;17;37;14;14;28
96;24.02.2013;2013;02;17;Sunnuntai;22;21;43;13;10;23
96;24.02.2013;2013;02;18;Sunnuntai;19;12;31;13;7;20
96;24.02.2013;2013;02;19;Sunnuntai;18;11;29;15;10;25
96;24.02.2013;2013;02;20;Sunnuntai;13;11;24;13;5;18
96;24.02.2013;2013;02;21;Sunnuntai;12;27;39;7;19;26
96;24.02.2013;2013;02;22;Sunnuntai;4;3;7;3;1;4
96;24.02.2013;2013;02;23;Sunnuntai;5;3;8;1;0;1
96;25.02.2013;2013;02;00;Maanantai;3;0;3;1;1;2
96;25.02.2013;2013;02;01;Maanantai;2;0;2;1;1;2
96;25.02.2013;2013;02;02;Maanantai;5;1;6;0;0;0
96;25.02.2013;2013;02;03;Maanantai;1;0;1;0;0;0
96;25.02.2013;2013;02;04;Maanantai;2;1;3;1;0;1
96;25.02.2013;2013;02;05;Maanantai;3;8;11;0;1;1
96;25.02.2013;2013;02;06;Maanantai;30;26;56;13;8;21
96;25.02.2013;2013;02;07;Maanantai;80;46;126;35;7;42
96;25.02.2013;2013;02;08;Maanantai;98;78;176;14;16;30
96;25.02.2013;2013;02;09;Maanantai;54;50;104;14;17;31
96;25.02.2013;2013;02;10;Maanantai;33;32;65;20;18;38
96;25.02.2013;2013;02;11;Maanantai;33;35;68;23;15;38
96;25.02.2013;2013;02;12;Maanantai;50;38;88;15;22;37
96;25.02.2013;2013;02;13;Maanantai;50;34;84;27;15;42
96;25.02.2013;2013;02;14;Maanantai;58;80;138;7;40;47
96;25.02.2013;2013;02;15;Maanantai;72;146;218;13;41;54
96;25.02.2013;2013;02;16;Maanantai;78;113;191;11;52;63
96;25.02.2013;2013;02;17;Maanantai;54;64;118;10;28;38
96;25.02.2013;2013;02;18;Maanantai;53;25;78;26;13;39
96;25.02.2013;2013;02;19;Maanantai;36;28;64;11;22;33
96;25.02.2013;2013;02;20;Maanantai;37;12;49;12;16;28
96;25.02.2013;2013;02;21;Maanantai;12;20;32;5;12;17
96;25.02.2013;2013;02;22;Maanantai;6;3;9;2;5;7
96;25.02.2013;2013;02;23;Maanantai;5;0;5;1;2;3
96;26.02.2013;2013;02;00;Tiistai;0;0;0;1;0;1
96;26.02.2013;2013;02;01;Tiistai;0;0;0;0;0;0
96;26.02.2013;2013;02;02;Tiistai;0;0;0;1;0;1
96;26.02.2013;2013;02;03;Tiistai;0;0;0;0;0;0
96;26.02.2013;2013;02;04;Tiistai;1;0;1;0;1;1
96;26.02.2013;2013;02;05;Tiistai;2;6;8;0;0;0
96;26.02.2013;2013;02;06;Tiistai;33;22;55;15;6;21
96;26.02.2013;2013;02;07;Tiistai;87;26;113;25;4;29
96;26.02.2013;2013;02;08;Tiistai;97;57;154;24;5;29
96;26.02.2013;2013;02;09;Tiistai;41;41;82;8;5;13
96;26.02.2013;2013;02;10;Tiistai;37;28;65;16;8;24
96;26.02.2013;2013;02;11;Tiistai;36;29;65;14;13;27
96;26.02.2013;2013;02;12;Tiistai;45;42;87;24;22;46
96;26.02.2013;2013;02;13;Tiistai;33;34;67;18;19;37
96;26.02.2013;2013;02;14;Tiistai;47;61;108;8;17;25
96;26.02.2013;2013;02;15;Tiistai;45;110;155;12;49;61
96;26.02.2013;2013;02;16;Tiistai;68;116;184;15;65;80
96;26.02.2013;2013;02;17;Tiistai;65;51;116;20;19;39
96;26.02.2013;2013;02;18;Tiistai;38;44;82;28;35;63
96;26.02.2013;2013;02;19;Tiistai;29;34;63;12;26;38
96;26.02.2013;2013;02;20;Tiistai;40;16;56;13;14;27
96;26.02.2013;2013;02;21;Tiistai;53;20;73;13;9;22
96;26.02.2013;2013;02;22;Tiistai;8;4;12;2;6;8
96;26.02.2013;2013;02;23;Tiistai;6;2;8;1;1;2
96;27.02.2013;2013;02;00;Keskiviikko;5;2;7;0;3;3
96;27.02.2013;2013;02;01;Keskiviikko;1;0;1;0;0;0
96;27.02.2013;2013;02;02;Keskiviikko;1;1;2;0;0;0
96;27.02.2013;2013;02;03;Keskiviikko;3;0;3;0;0;0
96;27.02.2013;2013;02;04;Keskiviikko;1;0;1;0;0;0
96;27.02.2013;2013;02;05;Keskiviikko;2;7;9;0;1;1
96;27.02.2013;2013;02;06;Keskiviikko;21;29;50;17;7;24
96;27.02.2013;2013;02;07;Keskiviikko;83;70;153;27;18;45
96;27.02.2013;2013;02;08;Keskiviikko;103;82;185;20;9;29
96;27.02.2013;2013;02;09;Keskiviikko;43;49;92;12;16;28
96;27.02.2013;2013;02;10;Keskiviikko;36;35;71;6;5;11
96;27.02.2013;2013;02;11;Keskiviikko;37;46;83;7;11;18
96;27.02.2013;2013;02;12;Keskiviikko;37;42;79;11;16;27
96;27.02.2013;2013;02;13;Keskiviikko;47;39;86;9;17;26
96;27.02.2013;2013;02;14;Keskiviikko;30;64;94;11;15;26
96;27.02.2013;2013;02;15;Keskiviikko;52;122;174;5;45;50
96;27.02.2013;2013;02;16;Keskiviikko;85;104;189;15;51;66
96;27.02.2013;2013;02;17;Keskiviikko;57;53;110;11;17;28
96;27.02.2013;2013;02;18;Keskiviikko;44;53;97;18;14;32
96;27.02.2013;2013;02;19;Keskiviikko;36;21;57;17;11;28
96;27.02.2013;2013;02;20;Keskiviikko;42;20;62;10;9;19
96;27.02.2013;2013;02;21;Keskiviikko;28;18;46;4;10;14
96;27.02.2013;2013;02;22;Keskiviikko;12;5;17;2;3;5
96;27.02.2013;2013;02;23;Keskiviikko;6;2;8;1;3;4
96;28.02.2013;2013;02;00;Torstai;1;0;1;1;0;1
96;28.02.2013;2013;02;01;Torstai;4;2;6;1;1;2
96;28.02.2013;2013;02;02;Torstai;2;0;2;0;0;0
96;28.02.2013;2013;02;03;Torstai;3;0;3;0;0;0
96;28.02.2013;2013;02;04;Torstai;1;1;2;0;1;1
96;28.02.2013;2013;02;05;Torstai;5;7;12;3;2;5
96;28.02.2013;2013;02;06;Torstai;25;24;49;11;4;15
96;28.02.2013;2013;02;07;Torstai;83;45;128;35;14;49
96;28.02.2013;2013;02;08;Torstai;86;74;160;19;12;31
96;28.02.2013;2013;02;09;Torstai;40;48;88;14;16;30
96;28.02.2013;2013;02;10;Torstai;31;39;70;12;15;27
96;28.02.2013;2013;02;11;Torstai;21;30;51;15;15;30
96;28.02.2013;2013;02;12;Torstai;41;55;96;15;9;24
96;28.02.2013;2013;02;13;Torstai;35;40;75;14;26;40
96;28.02.2013;2013;02;14;Torstai;49;54;103;13;16;29
96;28.02.2013;2013;02;15;Torstai;43;147;190;7;30;37
96;28.02.2013;2013;02;16;Torstai;43;103;146;10;30;40
96;28.02.2013;2013;02;17;Torstai;37;39;76;7;18;25
96;28.02.2013;2013;02;18;Torstai;34;35;69;12;11;23
96;28.02.2013;2013;02;19;Torstai;18;16;34;8;5;13
96;28.02.2013;2013;02;20;Torstai;27;17;44;16;11;27
96;28.02.2013;2013;02;21;Torstai;28;16;44;10;7;17
96;28.02.2013;2013;02;22;Torstai;14;4;18;2;3;5
96;28.02.2013;2013;02;23;Torstai;4;2;6;0;0;0
96;01.03.2013;2013;03;00;Perjantai;1;0;1;0;1;1
96;01.03.2013;2013;03;01;Perjantai;2;0;2;2;1;3
96;01.03.2013;2013;03;02;Perjantai;2;1;3;0;0;0
96;01.03.2013;2013;03;03;Perjantai;2;0;2;0;0;0
96;01.03.2013;2013;03;04;Perjantai;3;1;4;4;2;6
96;01.03.2013;2013;03;05;Perjantai;2;4;6;0;0;0
96;01.03.2013;2013;03;06;Perjantai;28;21;49;14;2;16
96;01.03.2013;2013;03;07;Perjantai;48;49;97;29;10;39
96;01.03.2013;2013;03;08;Perjantai;74;50;124;25;14;39
96;01.03.2013;2013;03;09;Perjantai;36;48;84;7;11;18
96;01.03.2013;2013;03;10;Perjantai;33;36;69;18;7;25
96;01.03.2013;2013;03;11;Perjantai;21;44;65;18;19;37
96;01.03.2013;2013;03;12;Perjantai;37;41;78;15;17;32
96;01.03.2013;2013;03;13;Perjantai;35;43;78;9;27;36
96;01.03.2013;2013;03;14;Perjantai;43;80;123;8;40;48
96;01.03.2013;2013;03;15;Perjantai;53;83;136;9;45;54
96;01.03.2013;2013;03;16;Perjantai;33;57;90;11;21;32
96;01.03.2013;2013;03;17;Perjantai;49;26;75;5;11;16
96;01.03.2013;2013;03;18;Perjantai;25;22;47;8;8;16
96;01.03.2013;2013;03;19;Perjantai;19;11;30;7;5;12
96;01.03.2013;2013;03;20;Perjantai;16;15;31;9;7;16
96;01.03.2013;2013;03;21;Perjantai;13;12;25;5;5;10
96;01.03.2013;2013;03;22;Perjantai;9;2;11;1;3;4
96;01.03.2013;2013;03;23;Perjantai;9;6;15;0;1;1
96;02.03.2013;2013;03;00;Lauantai;6;3;9;1;0;1
96;02.03.2013;2013;03;01;Lauantai;5;2;7;3;0;3
96;02.03.2013;2013;03;02;Lauantai;4;0;4;1;0;1
96;02.03.2013;2013;03;03;Lauantai;3;1;4;1;0;1
96;02.03.2013;2013;03;04;Lauantai;7;0;7;2;2;4
96;02.03.2013;2013;03;05;Lauantai;3;3;6;1;1;2
96;02.03.2013;2013;03;06;Lauantai;17;3;20;5;1;6
96;02.03.2013;2013;03;07;Lauantai;1;10;11;1;2;3
96;02.03.2013;2013;03;08;Lauantai;9;5;14;2;3;5
96;02.03.2013;2013;03;09;Lauantai;5;17;22;5;7;12
96;02.03.2013;2013;03;10;Lauantai;1;16;17;3;7;10
96;02.03.2013;2013;03;11;Lauantai;8;13;21;5;12;17
96;02.03.2013;2013;03;12;Lauantai;20;19;39;13;9;22
96;02.03.2013;2013;03;13;Lauantai;20;20;40;8;9;17
96;02.03.2013;2013;03;14;Lauantai;21;13;34;7;9;16
96;02.03.2013;2013;03;15;Lauantai;18;16;34;11;9;20
96;02.03.2013;2013;03;16;Lauantai;21;21;42;8;11;19
96;02.03.2013;2013;03;17;Lauantai;14;9;23;6;4;10
96;02.03.2013;2013;03;18;Lauantai;22;7;29;8;3;11
96;02.03.2013;2013;03;19;Lauantai;12;4;16;8;4;12
96;02.03.2013;2013;03;20;Lauantai;5;7;12;3;9;12
96;02.03.2013;2013;03;21;Lauantai;6;14;20;3;12;15
96;02.03.2013;2013;03;22;Lauantai;7;6;13;1;4;5
96;02.03.2013;2013;03;23;Lauantai;3;0;3;0;0;0
96;03.03.2013;2013;03;00;Sunnuntai;0;0;0;0;1;1
96;03.03.2013;2013;03;01;Sunnuntai;1;2;3;0;1;1
96;03.03.2013;2013;03;02;Sunnuntai;2;0;2;2;0;2
96;03.03.2013;2013;03;03;Sunnuntai;1;0;1;3;0;3
96;03.03.2013;2013;03;04;Sunnuntai;3;0;3;2;1;3
96;03.03.2013;2013;03;05;Sunnuntai;2;1;3;0;0;0
96;03.03.2013;2013;03;06;Sunnuntai;13;7;20;1;3;4
96;03.03.2013;2013;03;07;Sunnuntai;2;6;8;3;2;5
96;03.03.2013;2013;03;08;Sunnuntai;2;5;7;4;4;8
96;03.03.2013;2013;03;09;Sunnuntai;3;5;8;4;7;11
96;03.03.2013;2013;03;10;Sunnuntai;2;7;9;9;8;17
96;03.03.2013;2013;03;11;Sunnuntai;7;1;8;10;10;20
96;03.03.2013;2013;03;12;Sunnuntai;13;15;28;10;20;30
96;03.03.2013;2013;03;13;Sunnuntai;14;10;24;20;24;44
96;03.03.2013;2013;03;14;Sunnuntai;9;17;26;17;23;40
96;03.03.2013;2013;03;15;Sunnuntai;13;21;34;10;12;22
96;03.03.2013;2013;03;16;Sunnuntai;22;17;39;12;14;26
96;03.03.2013;2013;03;17;Sunnuntai;21;12;33;14;10;24
96;03.03.2013;2013;03;18;Sunnuntai;25;13;38;16;8;24
96;03.03.2013;2013;03;19;Sunnuntai;18;15;33;8;9;17
96;03.03.2013;2013;03;20;Sunnuntai;11;21;32;5;14;19
96;03.03.2013;2013;03;21;Sunnuntai;11;11;22;1;5;6
96;03.03.2013;2013;03;22;Sunnuntai;7;4;11;3;3;6
96;03.03.2013;2013;03;23;Sunnuntai;3;0;3;1;0;1
96;04.03.2013;2013;03;00;Maanantai;1;1;2;1;1;2
96;04.03.2013;2013;03;01;Maanantai;0;0;0;0;0;0
96;04.03.2013;2013;03;02;Maanantai;3;0;3;0;0;0
96;04.03.2013;2013;03;03;Maanantai;0;0;0;1;0;1
96;04.03.2013;2013;03;04;Maanantai;1;0;1;0;1;1
96;04.03.2013;2013;03;05;Maanantai;3;6;9;1;0;1
96;04.03.2013;2013;03;06;Maanantai;22;19;41;13;2;15
96;04.03.2013;2013;03;07;Maanantai;54;35;89;27;10;37
96;04.03.2013;2013;03;08;Maanantai;48;28;76;14;12;26
96;04.03.2013;2013;03;09;Maanantai;20;24;44;6;13;19
96;04.03.2013;2013;03;10;Maanantai;16;27;43;9;15;24
96;04.03.2013;2013;03;11;Maanantai;22;20;42;9;11;20
96;04.03.2013;2013;03;12;Maanantai;27;21;48;15;16;31
96;04.03.2013;2013;03;13;Maanantai;32;30;62;16;12;28
96;04.03.2013;2013;03;14;Maanantai;31;32;63;17;25;42
96;04.03.2013;2013;03;15;Maanantai;28;80;108;7;38;45
96;04.03.2013;2013;03;16;Maanantai;39;71;110;6;38;44
96;04.03.2013;2013;03;17;Maanantai;42;24;66;11;7;18
96;04.03.2013;2013;03;18;Maanantai;19;22;41;7;6;13
96;04.03.2013;2013;03;19;Maanantai;14;13;27;12;5;17
96;04.03.2013;2013;03;20;Maanantai;22;14;36;17;10;27
96;04.03.2013;2013;03;21;Maanantai;17;11;28;8;8;16
96;04.03.2013;2013;03;22;Maanantai;4;6;10;1;3;4
96;04.03.2013;2013;03;23;Maanantai;0;3;3;1;0;1
96;05.03.2013;2013;03;00;Tiistai;2;0;2;2;0;2
96;05.03.2013;2013;03;01;Tiistai;1;0;1;0;0;0
96;05.03.2013;2013;03;02;Tiistai;2;0;2;0;0;0
96;05.03.2013;2013;03;03;Tiistai;1;0;1;0;0;0
96;05.03.2013;2013;03;04;Tiistai;1;0;1;0;0;0
96;05.03.2013;2013;03;05;Tiistai;1;6;7;0;0;0
96;05.03.2013;2013;03;06;Tiistai;22;21;43;15;1;16
96;05.03.2013;2013;03;07;Tiistai;58;31;89;28;15;43
96;05.03.2013;2013;03;08;Tiistai;41;33;74;9;7;16
96;05.03.2013;2013;03;09;Tiistai;22;20;42;12;13;25
96;05.03.2013;2013;03;10;Tiistai;17;25;42;8;17;25
96;05.03.2013;2013;03;11;Tiistai;16;18;34;8;13;21
96;05.03.2013;2013;03;12;Tiistai;23;19;42;10;16;26
96;05.03.2013;2013;03;13;Tiistai;25;26;51;16;16;32
96;05.03.2013;2013;03;14;Tiistai;29;36;65;13;15;28
96;05.03.2013;2013;03;15;Tiistai;28;66;94;8;37;45
96;05.03.2013;2013;03;16;Tiistai;44;65;109;10;35;45
96;05.03.2013;2013;03;17;Tiistai;22;26;48;10;15;25
96;05.03.2013;2013;03;18;Tiistai;20;32;52;5;15;20
96;05.03.2013;2013;03;19;Tiistai;16;11;27;8;14;22
96;05.03.2013;2013;03;20;Tiistai;24;10;34;8;10;18
96;05.03.2013;2013;03;21;Tiistai;29;18;47;19;4;23
96;05.03.2013;2013;03;22;Tiistai;7;10;17;5;2;7
96;05.03.2013;2013;03;23;Tiistai;4;0;4;0;0;0
96;06.03.2013;2013;03;00;Keskiviikko;7;0;7;2;1;3
96;06.03.2013;2013;03;01;Keskiviikko;1;0;1;0;0;0
96;06.03.2013;2013;03;02;Keskiviikko;0;0;0;0;0;0
96;06.03.2013;2013;03;03;Keskiviikko;0;0;0;1;0;1
96;06.03.2013;2013;03;04;Keskiviikko;3;0;3;3;3;6
96;06.03.2013;2013;03;05;Keskiviikko;5;6;11;0;0;0
96;06.03.2013;2013;03;06;Keskiviikko;23;19;42;15;6;21
96;06.03.2013;2013;03;07;Keskiviikko;56;41;97;18;9;27
96;06.03.2013;2013;03;08;Keskiviikko;36;25;61;2;1;3
96;06.03.2013;2013;03;09;Keskiviikko;17;14;31;0;0;0
96;06.03.2013;2013;03;10;Keskiviikko;14;12;26;0;0;0
96;06.03.2013;2013;03;11;Keskiviikko;11;9;20;0;0;0
96;06.03.2013;2013;03;12;Keskiviikko;18;17;35;1;0;1
96;06.03.2013;2013;03;13;Keskiviikko;17;14;31;0;0;0
96;06.03.2013;2013;03;14;Keskiviikko;19;17;36;0;0;0
96;06.03.2013;2013;03;15;Keskiviikko;60;15;75;7;0;7
96;06.03.2013;2013;03;16;Keskiviikko;49;10;59;9;0;9
96;06.03.2013;2013;03;17;Keskiviikko;14;8;22;1;0;1
96;06.03.2013;2013;03;18;Keskiviikko;16;21;37;0;1;1
96;06.03.2013;2013;03;19;Keskiviikko;11;12;23;6;4;10
96;06.03.2013;2013;03;20;Keskiviikko;5;8;13;5;2;7
96;06.03.2013;2013;03;21;Keskiviikko;4;9;13;5;1;6
96;06.03.2013;2013;03;22;Keskiviikko;2;7;9;4;3;7
96;06.03.2013;2013;03;23;Keskiviikko;2;0;2;0;1;1
96;07.03.2013;2013;03;00;Torstai;0;2;2;1;0;1
96;07.03.2013;2013;03;01;Torstai;0;0;0;1;2;3
96;07.03.2013;2013;03;02;Torstai;0;1;1;0;1;1
96;07.03.2013;2013;03;03;Torstai;2;2;4;0;0;0
96;07.03.2013;2013;03;04;Torstai;0;1;1;0;3;3
96;07.03.2013;2013;03;05;Torstai;4;3;7;0;0;0
96;07.03.2013;2013;03;06;Torstai;26;19;45;27;101;128
96;07.03.2013;2013;03;07;Torstai;45;38;83;4;2;6
96;07.03.2013;2013;03;08;Torstai;17;30;47;1;3;4
96;07.03.2013;2013;03;09;Torstai;14;25;39;6;7;13
96;07.03.2013;2013;03;10;Torstai;12;31;43;6;6;12
96;07.03.2013;2013;03;11;Torstai;25;34;59;10;7;17
96;07.03.2013;2013;03;12;Torstai;26;20;46;12;15;27
96;07.03.2013;2013;03;13;Torstai;16;25;41;14;17;31
96;07.03.2013;2013;03;14;Torstai;24;35;59;7;20;27
96;07.03.2013;2013;03;15;Torstai;38;83;121;13;46;59
96;07.03.2013;2013;03;16;Torstai;43;46;89;12;20;32
96;07.03.2013;2013;03;17;Torstai;48;29;77;11;14;25
96;07.03.2013;2013;03;18;Torstai;38;15;53;10;9;19
96;07.03.2013;2013;03;19;Torstai;21;12;33;5;9;14
96;07.03.2013;2013;03;20;Torstai;18;13;31;6;2;8
96;07.03.2013;2013;03;21;Torstai;12;8;20;2;8;10
96;07.03.2013;2013;03;22;Torstai;9;4;13;2;2;4
96;07.03.2013;2013;03;23;Torstai;2;1;3;1;1;2
96;08.03.2013;2013;03;00;Perjantai;0;0;0;2;0;2
96;08.03.2013;2013;03;01;Perjantai;1;0;1;0;0;0
96;08.03.2013;2013;03;02;Perjantai;2;1;3;0;0;0
96;08.03.2013;2013;03;03;Perjantai;0;0;0;1;0;1
96;08.03.2013;2013;03;04;Perjantai;0;0;0;0;0;0
96;08.03.2013;2013;03;05;Perjantai;4;6;10;0;0;0
96;08.03.2013;2013;03;06;Perjantai;25;18;43;14;9;23
96;08.03.2013;2013;03;07;Perjantai;60;33;93;17;4;21
96;08.03.2013;2013;03;08;Perjantai;29;21;50;15;10;25
96;08.03.2013;2013;03;09;Perjantai;17;25;42;7;8;15
96;08.03.2013;2013;03;10;Perjantai;16;23;39;8;14;22
96;08.03.2013;2013;03;11;Perjantai;30;20;50;9;4;13
96;08.03.2013;2013;03;12;Perjantai;13;21;34;9;12;21
96;08.03.2013;2013;03;13;Perjantai;32;46;78;9;7;16
96;08.03.2013;2013;03;14;Perjantai;25;58;83;6;22;28
96;08.03.2013;2013;03;15;Perjantai;48;80;128;12;27;39
96;08.03.2013;2013;03;16;Perjantai;33;33;66;9;8;17
96;08.03.2013;2013;03;17;Perjantai;26;31;57;7;12;19
96;08.03.2013;2013;03;18;Perjantai;27;16;43;10;9;19
96;08.03.2013;2013;03;19;Perjantai;18;11;29;8;8;16
96;08.03.2013;2013;03;20;Perjantai;21;7;28;8;2;10
96;08.03.2013;2013;03;21;Perjantai;15;14;29;2;4;6
96;08.03.2013;2013;03;22;Perjantai;5;6;11;2;2;4
96;08.03.2013;2013;03;23;Perjantai;3;1;4;1;0;1
96;09.03.2013;2013;03;00;Lauantai;5;1;6;1;2;3
96;09.03.2013;2013;03;01;Lauantai;1;0;1;2;0;2
96;09.03.2013;2013;03;02;Lauantai;4;0;4;0;0;0
96;09.03.2013;2013;03;03;Lauantai;2;0;2;1;0;1
96;09.03.2013;2013;03;04;Lauantai;4;0;4;2;1;3
96;09.03.2013;2013;03;05;Lauantai;0;1;1;0;0;0
96;09.03.2013;2013;03;06;Lauantai;12;6;18;7;0;7
96;09.03.2013;2013;03;07;Lauantai;3;6;9;1;4;5
96;09.03.2013;2013;03;08;Lauantai;0;11;11;0;2;2
96;09.03.2013;2013;03;09;Lauantai;7;16;23;7;9;16
96;09.03.2013;2013;03;10;Lauantai;5;9;14;8;11;19
96;09.03.2013;2013;03;11;Lauantai;12;21;33;6;10;16
96;09.03.2013;2013;03;12;Lauantai;16;20;36;11;10;21
96;09.03.2013;2013;03;13;Lauantai;20;21;41;12;16;28
96;09.03.2013;2013;03;14;Lauantai;24;15;39;15;18;33
96;09.03.2013;2013;03;15;Lauantai;17;18;35;9;9;18
96;09.03.2013;2013;03;16;Lauantai;20;19;39;14;9;23
96;09.03.2013;2013;03;17;Lauantai;18;11;29;7;4;11
96;09.03.2013;2013;03;18;Lauantai;20;3;23;9;6;15
96;09.03.2013;2013;03;19;Lauantai;10;7;17;11;7;18
96;09.03.2013;2013;03;20;Lauantai;7;9;16;3;1;4
96;09.03.2013;2013;03;21;Lauantai;4;8;12;3;9;12
96;09.03.2013;2013;03;22;Lauantai;2;5;7;1;0;1
96;09.03.2013;2013;03;23;Lauantai;2;5;7;0;0;0
96;10.03.2013;2013;03;00;Sunnuntai;0;6;6;1;1;2
96;10.03.2013;2013;03;01;Sunnuntai;1;0;1;1;0;1
96;10.03.2013;2013;03;02;Sunnuntai;0;0;0;4;0;4
96;10.03.2013;2013;03;03;Sunnuntai;5;1;6;0;0;0
96;10.03.2013;2013;03;04;Sunnuntai;8;0;8;1;0;1
96;10.03.2013;2013;03;05;Sunnuntai;0;0;0;0;1;1
96;10.03.2013;2013;03;06;Sunnuntai;9;4;13;5;7;12
96;10.03.2013;2013;03;07;Sunnuntai;2;5;7;2;6;8
96;10.03.2013;2013;03;08;Sunnuntai;2;3;5;4;3;7
96;10.03.2013;2013;03;09;Sunnuntai;6;4;10;7;5;12
96;10.03.2013;2013;03;10;Sunnuntai;8;6;14;8;9;17
96;10.03.2013;2013;03;11;Sunnuntai;6;11;17;12;11;23
96;10.03.2013;2013;03;12;Sunnuntai;13;14;27;13;17;30
96;10.03.2013;2013;03;13;Sunnuntai;21;23;44;12;13;25
96;10.03.2013;2013;03;14;Sunnuntai;20;17;37;17;19;36
96;10.03.2013;2013;03;15;Sunnuntai;19;27;46;12;16;28
96;10.03.2013;2013;03;16;Sunnuntai;29;9;38;19;6;25
96;10.03.2013;2013;03;17;Sunnuntai;24;7;31;12;12;24
96;10.03.2013;2013;03;18;Sunnuntai;19;10;29;14;19;33
96;10.03.2013;2013;03;19;Sunnuntai;6;22;28;10;16;26
96;10.03.2013;2013;03;20;Sunnuntai;14;14;28;8;8;16
96;10.03.2013;2013;03;21;Sunnuntai;7;15;22;1;8;9
96;10.03.2013;2013;03;22;Sunnuntai;2;4;6;1;3;4
96;10.03.2013;2013;03;23;Sunnuntai;2;0;2;1;0;1
96;11.03.2013;2013;03;00;Maanantai;3;0;3;2;1;3
96;11.03.2013;2013;03;01;Maanantai;0;0;0;0;0;0
96;11.03.2013;2013;03;02;Maanantai;1;0;1;0;0;0
96;11.03.2013;2013;03;03;Maanantai;0;0;0;0;0;0
96;11.03.2013;2013;03;04;Maanantai;1;1;2;1;1;2
96;11.03.2013;2013;03;05;Maanantai;1;6;7;0;0;0
96;11.03.2013;2013;03;06;Maanantai;26;19;45;17;15;32
96;11.03.2013;2013;03;07;Maanantai;82;44;126;35;14;49
96;11.03.2013;2013;03;08;Maanantai;69;62;131;24;18;42
96;11.03.2013;2013;03;09;Maanantai;41;29;70;13;21;34
96;11.03.2013;2013;03;10;Maanantai;26;34;60;19;18;37
96;11.03.2013;2013;03;11;Maanantai;22;16;38;10;14;24
96;11.03.2013;2013;03;12;Maanantai;39;39;78;20;27;47
96;11.03.2013;2013;03;13;Maanantai;34;32;66;19;15;34
96;11.03.2013;2013;03;14;Maanantai;43;41;84;20;47;67
96;11.03.2013;2013;03;15;Maanantai;51;119;170;11;65;76
96;11.03.2013;2013;03;16;Maanantai;65;87;152;17;62;79
96;11.03.2013;2013;03;17;Maanantai;44;45;89;18;15;33
96;11.03.2013;2013;03;18;Maanantai;41;18;59;21;22;43
96;11.03.2013;2013;03;19;Maanantai;34;31;65;15;17;32
96;11.03.2013;2013;03;20;Maanantai;32;8;40;6;6;12
96;11.03.2013;2013;03;21;Maanantai;18;9;27;11;9;20
96;11.03.2013;2013;03;22;Maanantai;6;6;12;1;2;3
96;11.03.2013;2013;03;23;Maanantai;3;0;3;2;0;2
96;12.03.2013;2013;03;00;Tiistai;0;0;0;0;0;0
96;12.03.2013;2013;03;01;Tiistai;0;0;0;0;0;0
96;12.03.2013;2013;03;02;Tiistai;0;0;0;0;0;0
96;12.03.2013;2013;03;03;Tiistai;0;0;0;0;0;0
96;12.03.2013;2013;03;04;Tiistai;1;0;1;0;1;1
96;12.03.2013;2013;03;05;Tiistai;2;4;6;0;1;1
96;12.03.2013;2013;03;06;Tiistai;21;22;43;27;9;36
96;12.03.2013;2013;03;07;Tiistai;83;43;126;34;10;44
96;12.03.2013;2013;03;08;Tiistai;78;52;130;26;15;41
96;12.03.2013;2013;03;09;Tiistai;40;29;69;15;11;26
96;12.03.2013;2013;03;10;Tiistai;31;20;51;7;16;23
96;12.03.2013;2013;03;11;Tiistai;17;29;46;8;15;23
96;12.03.2013;2013;03;12;Tiistai;22;24;46;10;30;40
96;12.03.2013;2013;03;13;Tiistai;24;40;64;41;41;82
96;12.03.2013;2013;03;14;Tiistai;48;50;98;28;48;76
96;12.03.2013;2013;03;15;Tiistai;57;108;165;10;58;68
96;12.03.2013;2013;03;16;Tiistai;68;85;153;12;47;59
96;12.03.2013;2013;03;17;Tiistai;35;56;91;14;31;45
96;12.03.2013;2013;03;18;Tiistai;36;39;75;10;27;37
96;12.03.2013;2013;03;19;Tiistai;27;29;56;14;9;23
96;12.03.2013;2013;03;20;Tiistai;27;16;43;9;5;14
96;12.03.2013;2013;03;21;Tiistai;40;11;51;19;10;29
96;12.03.2013;2013;03;22;Tiistai;6;4;10;4;1;5
96;12.03.2013;2013;03;23;Tiistai;7;1;8;1;0;1
96;13.03.2013;2013;03;00;Keskiviikko;0;0;0;1;0;1
96;13.03.2013;2013;03;01;Keskiviikko;1;0;1;0;0;0
96;13.03.2013;2013;03;02;Keskiviikko;0;0;0;0;0;0
96;13.03.2013;2013;03;03;Keskiviikko;0;0;0;0;0;0
96;13.03.2013;2013;03;04;Keskiviikko;1;0;1;0;0;0
96;13.03.2013;2013;03;05;Keskiviikko;1;4;5;0;1;1
96;13.03.2013;2013;03;06;Keskiviikko;14;11;25;15;7;22
96;13.03.2013;2013;03;07;Keskiviikko;83;39;122;28;16;44
96;13.03.2013;2013;03;08;Keskiviikko;77;48;125;26;9;35
96;13.03.2013;2013;03;09;Keskiviikko;42;21;63;13;20;33
96;13.03.2013;2013;03;10;Keskiviikko;20;18;38;13;22;35
96;13.03.2013;2013;03;11;Keskiviikko;25;15;40;14;11;25
96;13.03.2013;2013;03;12;Keskiviikko;27;28;55;29;24;53
96;13.03.2013;2013;03;13;Keskiviikko;41;29;70;26;33;59
96;13.03.2013;2013;03;14;Keskiviikko;42;40;82;14;20;34
96;13.03.2013;2013;03;15;Keskiviikko;38;102;140;14;58;72
96;13.03.2013;2013;03;16;Keskiviikko;55;94;149;22;75;97
96;13.03.2013;2013;03;17;Keskiviikko;37;46;83;15;26;41
96;13.03.2013;2013;03;18;Keskiviikko;44;30;74;17;13;30
96;13.03.2013;2013;03;19;Keskiviikko;38;20;58;17;21;38
96;13.03.2013;2013;03;20;Keskiviikko;16;31;47;8;17;25
96;13.03.2013;2013;03;21;Keskiviikko;10;15;25;3;10;13
96;13.03.2013;2013;03;22;Keskiviikko;11;17;28;2;2;4
96;13.03.2013;2013;03;23;Keskiviikko;5;1;6;0;2;2
96;14.03.2013;2013;03;00;Torstai;3;0;3;1;1;2
96;14.03.2013;2013;03;01;Torstai;4;0;4;1;0;1
96;14.03.2013;2013;03;02;Torstai;1;0;1;1;0;1
96;14.03.2013;2013;03;03;Torstai;1;0;1;0;0;0
96;14.03.2013;2013;03;04;Torstai;3;0;3;0;0;0
96;14.03.2013;2013;03;05;Torstai;2;3;5;0;1;1
96;14.03.2013;2013;03;06;Torstai;12;15;27;13;3;16
96;14.03.2013;2013;03;07;Torstai;61;28;89;32;9;41
96;14.03.2013;2013;03;08;Torstai;84;46;130;15;8;23
96;14.03.2013;2013;03;09;Torstai;26;28;54;6;12;18
96;14.03.2013;2013;03;10;Torstai;25;30;55;17;11;28
96;14.03.2013;2013;03;11;Torstai;26;28;54;13;12;25
96;14.03.2013;2013;03;12;Torstai;48;22;70;22;16;38
96;14.03.2013;2013;03;13;Torstai;29;32;61;13;28;41
96;14.03.2013;2013;03;14;Torstai;48;56;104;14;40;54
96;14.03.2013;2013;03;15;Torstai;40;97;137;14;67;81
96;14.03.2013;2013;03;16;Torstai;46;76;122;16;51;67
96;14.03.2013;2013;03;17;Torstai;37;38;75;16;25;41
96;14.03.2013;2013;03;18;Torstai;47;29;76;16;25;41
96;14.03.2013;2013;03;19;Torstai;25;15;40;4;14;18
96;14.03.2013;2013;03;20;Torstai;17;18;35;12;5;17
96;14.03.2013;2013;03;21;Torstai;33;11;44;19;12;31
96;14.03.2013;2013;03;22;Torstai;7;15;22;2;4;6
96;14.03.2013;2013;03;23;Torstai;2;2;4;0;2;2
96;15.03.2013;2013;03;00;Perjantai;1;0;1;0;1;1
96;15.03.2013;2013;03;01;Perjantai;0;1;1;0;0;0
96;15.03.2013;2013;03;02;Perjantai;3;1;4;1;0;1
96;15.03.2013;2013;03;03;Perjantai;6;0;6;0;0;0
96;15.03.2013;2013;03;04;Perjantai;1;0;1;0;0;0
96;15.03.2013;2013;03;05;Perjantai;2;3;5;0;1;1
96;15.03.2013;2013;03;06;Perjantai;11;15;26;9;4;13
96;15.03.2013;2013;03;07;Perjantai;61;22;83;28;11;39
96;15.03.2013;2013;03;08;Perjantai;75;50;125;18;9;27
96;15.03.2013;2013;03;09;Perjantai;34;35;69;8;7;15
96;15.03.2013;2013;03;10;Perjantai;23;38;61;8;15;23
96;15.03.2013;2013;03;11;Perjantai;28;35;63;25;30;55
96;15.03.2013;2013;03;12;Perjantai;31;33;64;34;56;90
96;15.03.2013;2013;03;13;Perjantai;39;45;84;20;26;46
96;15.03.2013;2013;03;14;Perjantai;43;69;112;11;37;48
96;15.03.2013;2013;03;15;Perjantai;50;102;152;16;42;58
96;15.03.2013;2013;03;16;Perjantai;37;48;85;16;34;50
96;15.03.2013;2013;03;17;Perjantai;30;33;63;15;15;30
96;15.03.2013;2013;03;18;Perjantai;24;20;44;14;13;27
96;15.03.2013;2013;03;19;Perjantai;27;26;53;6;2;8
96;15.03.2013;2013;03;20;Perjantai;13;9;22;9;9;18
96;15.03.2013;2013;03;21;Perjantai;15;17;32;5;4;9
96;15.03.2013;2013;03;22;Perjantai;6;5;11;0;3;3
96;15.03.2013;2013;03;23;Perjantai;3;4;7;1;0;1
96;16.03.2013;2013;03;00;Lauantai;2;8;10;0;1;1
96;16.03.2013;2013;03;01;Lauantai;4;0;4;0;0;0
96;16.03.2013;2013;03;02;Lauantai;3;1;4;0;0;0
96;16.03.2013;2013;03;03;Lauantai;5;0;5;2;0;2
96;16.03.2013;2013;03;04;Lauantai;4;0;4;1;1;2
96;16.03.2013;2013;03;05;Lauantai;0;1;1;0;0;0
96;16.03.2013;2013;03;06;Lauantai;7;3;10;8;0;8
96;16.03.2013;2013;03;07;Lauantai;3;6;9;1;5;6
96;16.03.2013;2013;03;08;Lauantai;5;13;18;4;7;11
96;16.03.2013;2013;03;09;Lauantai;8;17;25;6;14;20
96;16.03.2013;2013;03;10;Lauantai;14;24;38;14;11;25
96;16.03.2013;2013;03;11;Lauantai;20;11;31;11;15;26
96;16.03.2013;2013;03;12;Lauantai;27;31;58;15;24;39
96;16.03.2013;2013;03;13;Lauantai;27;31;58;13;24;37
96;16.03.2013;2013;03;14;Lauantai;30;24;54;14;23;37
96;16.03.2013;2013;03;15;Lauantai;23;37;60;26;19;45
96;16.03.2013;2013;03;16;Lauantai;24;29;53;16;10;26
96;16.03.2013;2013;03;17;Lauantai;31;15;46;18;7;25
96;16.03.2013;2013;03;18;Lauantai;34;11;45;19;5;24
96;16.03.2013;2013;03;19;Lauantai;22;14;36;15;11;26
96;16.03.2013;2013;03;20;Lauantai;11;7;18;4;7;11
96;16.03.2013;2013;03;21;Lauantai;5;16;21;4;4;8
96;16.03.2013;2013;03;22;Lauantai;4;12;16;0;10;10
96;16.03.2013;2013;03;23;Lauantai;3;4;7;1;2;3
96;17.03.2013;2013;03;00;Sunnuntai;4;0;4;0;0;0
96;17.03.2013;2013;03;01;Sunnuntai;3;1;4;2;0;2
96;17.03.2013;2013;03;02;Sunnuntai;14;1;15;0;0;0
96;17.03.2013;2013;03;03;Sunnuntai;3;1;4;2;0;2
96;17.03.2013;2013;03;04;Sunnuntai;3;0;3;3;0;3
96;17.03.2013;2013;03;05;Sunnuntai;1;1;2;1;1;2
96;17.03.2013;2013;03;06;Sunnuntai;8;4;12;6;2;8
96;17.03.2013;2013;03;07;Sunnuntai;5;3;8;1;4;5
96;17.03.2013;2013;03;08;Sunnuntai;2;3;5;8;7;15
96;17.03.2013;2013;03;09;Sunnuntai;5;5;10;9;6;15
96;17.03.2013;2013;03;10;Sunnuntai;3;6;9;10;8;18
96;17.03.2013;2013;03;11;Sunnuntai;9;8;17;9;12;21
96;17.03.2013;2013;03;12;Sunnuntai;18;18;36;17;18;35
96;17.03.2013;2013;03;13;Sunnuntai;19;25;44;17;19;36
96;17.03.2013;2013;03;14;Sunnuntai;20;18;38;14;18;32
96;17.03.2013;2013;03;15;Sunnuntai;20;32;52;12;20;32
96;17.03.2013;2013;03;16;Sunnuntai;27;41;68;25;17;42
96;17.03.2013;2013;03;17;Sunnuntai;27;12;39;16;12;28
96;17.03.2013;2013;03;18;Sunnuntai;13;22;35;19;24;43
96;17.03.2013;2013;03;19;Sunnuntai;6;19;25;11;13;24
96;17.03.2013;2013;03;20;Sunnuntai;43;14;57;12;16;28
96;17.03.2013;2013;03;21;Sunnuntai;15;14;29;3;6;9
96;17.03.2013;2013;03;22;Sunnuntai;4;5;9;0;2;2
96;17.03.2013;2013;03;23;Sunnuntai;5;2;7;0;1;1
96;18.03.2013;2013;03;00;Maanantai;1;0;1;0;0;0
96;18.03.2013;2013;03;01;Maanantai;1;0;1;1;0;1
96;18.03.2013;2013;03;02;Maanantai;2;0;2;0;0;0
96;18.03.2013;2013;03;03;Maanantai;0;0;0;1;0;1
96;18.03.2013;2013;03;04;Maanantai;1;2;3;0;1;1
96;18.03.2013;2013;03;05;Maanantai;26;19;45;14;7;21
96;18.03.2013;2013;03;06;Maanantai;71;46;117;34;18;52
96;18.03.2013;2013;03;07;Maanantai;69;69;138;24;14;38
96;18.03.2013;2013;03;08;Maanantai;57;43;100;10;8;18
96;18.03.2013;2013;03;09;Maanantai;45;34;79;13;12;25
96;18.03.2013;2013;03;10;Maanantai;36;19;55;14;16;30
96;18.03.2013;2013;03;11;Maanantai;35;40;75;18;24;42
96;18.03.2013;2013;03;12;Maanantai;42;37;79;15;23;38
96;18.03.2013;2013;03;13;Maanantai;52;60;112;9;32;41
96;18.03.2013;2013;03;14;Maanantai;58;129;187;15;57;72
96;18.03.2013;2013;03;15;Maanantai;83;107;190;14;41;55
96;18.03.2013;2013;03;16;Maanantai;44;50;94;14;18;32
96;18.03.2013;2013;03;17;Maanantai;47;30;77;22;22;44
96;18.03.2013;2013;03;18;Maanantai;34;32;66;14;26;40
96;18.03.2013;2013;03;19;Maanantai;34;16;50;9;12;21
96;18.03.2013;2013;03;20;Maanantai;26;13;39;7;6;13
96;18.03.2013;2013;03;21;Maanantai;5;0;5;2;4;6
96;18.03.2013;2013;03;22;Maanantai;2;0;2;0;2;2
96;18.03.2013;2013;03;23;Maanantai;2;1;3;3;0;3
96;19.03.2013;2013;03;00;Tiistai;0;0;0;0;0;0
96;19.03.2013;2013;03;01;Tiistai;0;0;0;0;0;0
96;19.03.2013;2013;03;02;Tiistai;0;0;0;0;2;2
96;19.03.2013;2013;03;03;Tiistai;1;1;2;0;0;0
96;19.03.2013;2013;03;04;Tiistai;3;7;10;0;1;1
96;19.03.2013;2013;03;05;Tiistai;23;19;42;13;3;16
96;19.03.2013;2013;03;06;Tiistai;76;56;132;37;13;50
96;19.03.2013;2013;03;07;Tiistai;100;73;173;21;17;38
96;19.03.2013;2013;03;08;Tiistai;32;36;68;8;11;19
96;19.03.2013;2013;03;09;Tiistai;31;37;68;15;16;31
96;19.03.2013;2013;03;10;Tiistai;21;36;57;15;16;31
96;19.03.2013;2013;03;11;Tiistai;30;36;66;8;19;27
96;19.03.2013;2013;03;12;Tiistai;35;35;70;10;14;24
96;19.03.2013;2013;03;13;Tiistai;54;72;126;10;26;36
96;19.03.2013;2013;03;14;Tiistai;47;108;155;10;41;51
96;19.03.2013;2013;03;15;Tiistai;67;96;163;13;58;71
96;19.03.2013;2013;03;16;Tiistai;38;44;82;23;16;39
96;19.03.2013;2013;03;17;Tiistai;38;25;63;8;17;25
96;19.03.2013;2013;03;18;Tiistai;32;19;51;9;23;32
96;19.03.2013;2013;03;19;Tiistai;23;25;48;14;20;34
96;19.03.2013;2013;03;20;Tiistai;19;10;29;7;10;17
96;19.03.2013;2013;03;21;Tiistai;6;4;10;2;3;5
96;19.03.2013;2013;03;22;Tiistai;9;1;10;2;0;2
96;19.03.2013;2013;03;23;Tiistai;1;0;1;0;0;0
96;20.03.2013;2013;03;00;Keskiviikko;3;0;3;0;0;0
96;20.03.2013;2013;03;01;Keskiviikko;1;0;1;0;0;0
96;20.03.2013;2013;03;02;Keskiviikko;0;0;0;0;0;0
96;20.03.2013;2013;03;03;Keskiviikko;1;0;1;0;0;0
96;20.03.2013;2013;03;04;Keskiviikko;3;7;10;0;1;1
96;20.03.2013;2013;03;05;Keskiviikko;31;28;59;10;5;15
96;20.03.2013;2013;03;06;Keskiviikko;75;55;130;39;16;55
96;20.03.2013;2013;03;07;Keskiviikko;115;63;178;33;27;60
96;20.03.2013;2013;03;08;Keskiviikko;37;31;68;15;19;34
96;20.03.2013;2013;03;09;Keskiviikko;22;34;56;23;26;49
96;20.03.2013;2013;03;10;Keskiviikko;36;29;65;19;24;43
96;20.03.2013;2013;03;11;Keskiviikko;40;42;82;20;25;45
96;20.03.2013;2013;03;12;Keskiviikko;45;38;83;19;21;40
96;20.03.2013;2013;03;13;Keskiviikko;47;45;92;16;25;41
96;20.03.2013;2013;03;14;Keskiviikko;53;114;167;14;53;67
96;20.03.2013;2013;03;15;Keskiviikko;94;104;198;13;54;67
96;20.03.2013;2013;03;16;Keskiviikko;46;43;89;23;34;57
96;20.03.2013;2013;03;17;Keskiviikko;47;24;71;25;21;46
96;20.03.2013;2013;03;18;Keskiviikko;41;26;67;23;17;40
96;20.03.2013;2013;03;19;Keskiviikko;32;24;56;8;18;26
96;20.03.2013;2013;03;20;Keskiviikko;14;35;49;5;15;20
96;20.03.2013;2013;03;21;Keskiviikko;10;9;19;2;2;4
96;20.03.2013;2013;03;22;Keskiviikko;7;1;8;1;0;1
96;20.03.2013;2013;03;23;Keskiviikko;1;4;5;0;0;0
96;21.03.2013;2013;03;00;Torstai;3;2;5;1;0;1
96;21.03.2013;2013;03;01;Torstai;2;0;2;0;0;0
96;21.03.2013;2013;03;02;Torstai;5;0;5;1;0;1
96;21.03.2013;2013;03;03;Torstai;2;0;2;1;0;1
96;21.03.2013;2013;03;04;Torstai;3;7;10;0;1;1
96;21.03.2013;2013;03;05;Torstai;32;21;53;22;4;26
96;21.03.2013;2013;03;06;Torstai;79;40;119;37;14;51
96;21.03.2013;2013;03;07;Torstai;82;64;146;15;13;28
96;21.03.2013;2013;03;08;Torstai;39;40;79;14;17;31
96;21.03.2013;2013;03;09;Torstai;29;21;50;14;6;20
96;21.03.2013;2013;03;10;Torstai;28;35;63;15;16;31
96;21.03.2013;2013;03;11;Torstai;46;35;81;10;16;26
96;21.03.2013;2013;03;12;Torstai;30;39;69;16;22;38
96;21.03.2013;2013;03;13;Torstai;46;62;108;11;23;34
96;21.03.2013;2013;03;14;Torstai;52;118;170;15;53;68
96;21.03.2013;2013;03;15;Torstai;68;111;179;11;51;62
96;21.03.2013;2013;03;16;Torstai;38;46;84;12;22;34
96;21.03.2013;2013;03;17;Torstai;41;28;69;14;17;31
96;21.03.2013;2013;03;18;Torstai;24;20;44;8;19;27
96;21.03.2013;2013;03;19;Torstai;43;20;63;6;14;20
96;21.03.2013;2013;03;20;Torstai;19;17;36;6;7;13
96;21.03.2013;2013;03;21;Torstai;13;7;20;1;3;4
96;21.03.2013;2013;03;22;Torstai;5;1;6;3;3;6
96;21.03.2013;2013;03;23;Torstai;2;2;4;0;1;1
96;22.03.2013;2013;03;00;Perjantai;2;1;3;0;0;0
96;22.03.2013;2013;03;01;Perjantai;1;0;1;0;0;0
96;22.03.2013;2013;03;02;Perjantai;1;0;1;0;0;0
96;22.03.2013;2013;03;03;Perjantai;2;0;2;0;0;0
96;22.03.2013;2013;03;04;Perjantai;2;5;7;1;0;1
96;22.03.2013;2013;03;05;Perjantai;24;22;46;17;14;31
96;22.03.2013;2013;03;06;Perjantai;70;48;118;32;9;41
96;22.03.2013;2013;03;07;Perjantai;66;54;120;21;8;29
96;22.03.2013;2013;03;08;Perjantai;35;42;77;16;10;26
96;22.03.2013;2013;03;09;Perjantai;34;29;63;9;15;24
96;22.03.2013;2013;03;10;Perjantai;36;39;75;14;18;32
96;22.03.2013;2013;03;11;Perjantai;24;43;67;19;25;44
96;22.03.2013;2013;03;12;Perjantai;45;55;100;18;28;46
96;22.03.2013;2013;03;13;Perjantai;45;61;106;13;29;42
96;22.03.2013;2013;03;14;Perjantai;61;105;166;3;39;42
96;22.03.2013;2013;03;15;Perjantai;51;58;109;11;28;39
96;22.03.2013;2013;03;16;Perjantai;30;42;72;8;9;17
96;22.03.2013;2013;03;17;Perjantai;20;29;49;11;9;20
96;22.03.2013;2013;03;18;Perjantai;20;26;46;9;12;21
96;22.03.2013;2013;03;19;Perjantai;32;16;48;9;7;16
96;22.03.2013;2013;03;20;Perjantai;15;15;30;4;9;13
96;22.03.2013;2013;03;21;Perjantai;7;2;9;4;4;8
96;22.03.2013;2013;03;22;Perjantai;12;2;14;1;2;3
96;22.03.2013;2013;03;23;Perjantai;8;1;9;1;0;1
96;23.03.2013;2013;03;00;Lauantai;4;5;9;0;0;0
96;23.03.2013;2013;03;01;Lauantai;5;0;5;0;0;0
96;23.03.2013;2013;03;02;Lauantai;5;1;6;1;0;1
96;23.03.2013;2013;03;03;Lauantai;7;1;8;2;1;3
96;23.03.2013;2013;03;04;Lauantai;1;1;2;0;0;0
96;23.03.2013;2013;03;05;Lauantai;12;6;18;24;113;137
96;23.03.2013;2013;03;06;Lauantai;5;8;13;4;2;6
96;23.03.2013;2013;03;07;Lauantai;7;12;19;5;8;13
96;23.03.2013;2013;03;08;Lauantai;5;18;23;10;12;22
96;23.03.2013;2013;03;09;Lauantai;16;18;34;16;21;37
96;23.03.2013;2013;03;10;Lauantai;27;29;56;11;20;31
96;23.03.2013;2013;03;11;Lauantai;15;26;41;16;15;31
96;23.03.2013;2013;03;12;Lauantai;27;30;57;13;21;34
96;23.03.2013;2013;03;13;Lauantai;23;40;63;12;18;30
96;23.03.2013;2013;03;14;Lauantai;36;26;62;10;24;34
96;23.03.2013;2013;03;15;Lauantai;28;21;49;12;10;22
96;23.03.2013;2013;03;16;Lauantai;26;27;53;19;10;29
96;23.03.2013;2013;03;17;Lauantai;26;8;34;16;9;25
96;23.03.2013;2013;03;18;Lauantai;14;13;27;11;19;30
96;23.03.2013;2013;03;19;Lauantai;14;7;21;7;8;15
96;23.03.2013;2013;03;20;Lauantai;10;17;27;7;10;17
96;23.03.2013;2013;03;21;Lauantai;3;14;17;0;8;8
96;23.03.2013;2013;03;22;Lauantai;6;6;12;2;2;4
96;23.03.2013;2013;03;23;Lauantai;9;6;15;3;0;3
96;24.03.2013;2013;03;00;Sunnuntai;6;2;8;1;2;3
96;24.03.2013;2013;03;01;Sunnuntai;2;0;2;6;0;6
96;24.03.2013;2013;03;02;Sunnuntai;13;0;13;1;0;1
96;24.03.2013;2013;03;03;Sunnuntai;2;0;2;4;0;4
96;24.03.2013;2013;03;04;Sunnuntai;3;0;3;1;1;2
96;24.03.2013;2013;03;05;Sunnuntai;16;4;20;9;4;13
96;24.03.2013;2013;03;06;Sunnuntai;5;8;13;1;4;5
96;24.03.2013;2013;03;07;Sunnuntai;4;9;13;1;3;4
96;24.03.2013;2013;03;08;Sunnuntai;6;9;15;5;6;11
96;24.03.2013;2013;03;09;Sunnuntai;4;11;15;15;16;31
96;24.03.2013;2013;03;10;Sunnuntai;13;9;22;12;20;32
96;24.03.2013;2013;03;11;Sunnuntai;17;20;37;16;23;39
96;24.03.2013;2013;03;12;Sunnuntai;24;25;49;10;23;33
96;24.03.2013;2013;03;13;Sunnuntai;20;22;42;27;26;53
96;24.03.2013;2013;03;14;Sunnuntai;21;30;51;19;35;54
96;24.03.2013;2013;03;15;Sunnuntai;27;13;40;23;19;42
96;24.03.2013;2013;03;16;Sunnuntai;23;16;39;24;20;44
96;24.03.2013;2013;03;17;Sunnuntai;36;22;58;16;20;36
96;24.03.2013;2013;03;18;Sunnuntai;13;9;22;10;12;22
96;24.03.2013;2013;03;19;Sunnuntai;12;18;30;13;21;34
96;24.03.2013;2013;03;20;Sunnuntai;11;10;21;5;7;12
96;24.03.2013;2013;03;21;Sunnuntai;6;4;10;0;1;1
96;24.03.2013;2013;03;22;Sunnuntai;2;1;3;0;1;1
96;24.03.2013;2013;03;23;Sunnuntai;0;0;0;4;0;4
96;25.03.2013;2013;03;00;Maanantai;2;1;3;1;0;1
96;25.03.2013;2013;03;01;Maanantai;1;0;1;0;0;0
96;25.03.2013;2013;03;02;Maanantai;0;1;1;0;0;0
96;25.03.2013;2013;03;03;Maanantai;2;0;2;2;3;5
96;25.03.2013;2013;03;04;Maanantai;1;7;8;0;0;0
96;25.03.2013;2013;03;05;Maanantai;26;29;55;56;92;148
96;25.03.2013;2013;03;06;Maanantai;86;63;149;25;17;42
96;25.03.2013;2013;03;07;Maanantai;77;69;146;24;13;37
96;25.03.2013;2013;03;08;Maanantai;33;47;80;9;16;25
96;25.03.2013;2013;03;09;Maanantai;37;44;81;14;19;33
96;25.03.2013;2013;03;10;Maanantai;42;30;72;10;12;22
96;25.03.2013;2013;03;11;Maanantai;61;52;113;10;25;35
96;25.03.2013;2013;03;12;Maanantai;72;33;105;18;28;46
96;25.03.2013;2013;03;13;Maanantai;57;56;113;37;41;78
96;25.03.2013;2013;03;14;Maanantai;67;135;202;17;56;73
96;25.03.2013;2013;03;15;Maanantai;97;89;186;20;51;71
96;25.03.2013;2013;03;16;Maanantai;62;59;121;15;8;23
96;25.03.2013;2013;03;17;Maanantai;53;40;93;25;18;43
96;25.03.2013;2013;03;18;Maanantai;57;18;75;27;19;46
96;25.03.2013;2013;03;19;Maanantai;33;23;56;14;6;20
96;25.03.2013;2013;03;20;Maanantai;22;21;43;2;11;13
96;25.03.2013;2013;03;21;Maanantai;8;4;12;3;3;6
96;25.03.2013;2013;03;22;Maanantai;5;2;7;0;2;2
96;25.03.2013;2013;03;23;Maanantai;0;1;1;0;0;0
96;26.03.2013;2013;03;00;Tiistai;1;0;1;0;0;0
96;26.03.2013;2013;03;01;Tiistai;0;0;0;1;0;1
96;26.03.2013;2013;03;02;Tiistai;0;1;1;0;0;0
96;26.03.2013;2013;03;03;Tiistai;1;2;3;0;0;0
96;26.03.2013;2013;03;04;Tiistai;4;5;9;0;1;1
96;26.03.2013;2013;03;05;Tiistai;26;27;53;13;8;21
96;26.03.2013;2013;03;06;Tiistai;90;62;152;39;20;59
96;26.03.2013;2013;03;07;Tiistai;84;72;156;24;11;35
96;26.03.2013;2013;03;08;Tiistai;38;51;89;9;21;30
96;26.03.2013;2013;03;09;Tiistai;36;40;76;11;16;27
96;26.03.2013;2013;03;10;Tiistai;37;30;67;14;12;26
96;26.03.2013;2013;03;11;Tiistai;62;41;103;12;15;27
96;26.03.2013;2013;03;12;Tiistai;51;39;90;24;24;48
96;26.03.2013;2013;03;13;Tiistai;47;57;104;17;24;41
96;26.03.2013;2013;03;14;Tiistai;54;121;175;11;49;60
96;26.03.2013;2013;03;15;Tiistai;90;119;209;12;47;59
96;26.03.2013;2013;03;16;Tiistai;54;44;98;27;26;53
96;26.03.2013;2013;03;17;Tiistai;60;21;81;24;19;43
96;26.03.2013;2013;03;18;Tiistai;42;21;63;9;19;28
96;26.03.2013;2013;03;19;Tiistai;33;15;48;12;14;26
96;26.03.2013;2013;03;20;Tiistai;20;25;45;3;6;9
96;26.03.2013;2013;03;21;Tiistai;9;6;15;1;0;1
96;26.03.2013;2013;03;22;Tiistai;11;2;13;1;2;3
96;26.03.2013;2013;03;23;Tiistai;2;0;2;0;0;0
96;27.03.2013;2013;03;00;Keskiviikko;1;1;2;0;1;1
96;27.03.2013;2013;03;01;Keskiviikko;0;0;0;0;0;0
96;27.03.2013;2013;03;02;Keskiviikko;0;0;0;0;0;0
96;27.03.2013;2013;03;03;Keskiviikko;1;0;1;0;1;1
96;27.03.2013;2013;03;04;Keskiviikko;1;6;7;0;0;0
96;27.03.2013;2013;03;05;Keskiviikko;30;32;62;14;42;56
96;27.03.2013;2013;03;06;Keskiviikko;83;57;140;35;18;53
96;27.03.2013;2013;03;07;Keskiviikko;90;61;151;20;8;28
96;27.03.2013;2013;03;08;Keskiviikko;39;38;77;6;6;12
96;27.03.2013;2013;03;09;Keskiviikko;22;44;66;6;19;25
96;27.03.2013;2013;03;10;Keskiviikko;32;32;64;13;12;25
96;27.03.2013;2013;03;11;Keskiviikko;47;43;90;16;14;30
96;27.03.2013;2013;03;12;Keskiviikko;60;52;112;16;28;44
96;27.03.2013;2013;03;13;Keskiviikko;60;72;132;11;30;41
96;27.03.2013;2013;03;14;Keskiviikko;53;127;180;13;52;65
96;27.03.2013;2013;03;15;Keskiviikko;75;94;169;16;53;69
96;27.03.2013;2013;03;16;Keskiviikko;55;56;111;14;22;36
96;27.03.2013;2013;03;17;Keskiviikko;43;36;79;16;11;27
96;27.03.2013;2013;03;18;Keskiviikko;37;23;60;17;15;32
96;27.03.2013;2013;03;19;Keskiviikko;35;27;62;5;6;11
96;27.03.2013;2013;03;20;Keskiviikko;15;21;36;12;15;27
96;27.03.2013;2013;03;21;Keskiviikko;8;6;14;1;0;1
96;27.03.2013;2013;03;22;Keskiviikko;10;3;13;1;0;1
96;27.03.2013;2013;03;23;Keskiviikko;7;4;11;1;0;1
96;28.03.2013;2013;03;00;Torstai;5;0;5;0;0;0
96;28.03.2013;2013;03;01;Torstai;0;0;0;1;1;2
96;28.03.2013;2013;03;02;Torstai;1;0;1;0;0;0
96;28.03.2013;2013;03;03;Torstai;4;0;4;0;1;1
96;28.03.2013;2013;03;04;Torstai;1;4;5;0;0;0
96;28.03.2013;2013;03;05;Torstai;36;18;54;21;9;30
96;28.03.2013;2013;03;06;Torstai;70;41;111;28;14;42
96;28.03.2013;2013;03;07;Torstai;60;54;114;15;8;23
96;28.03.2013;2013;03;08;Torstai;31;25;56;9;11;20
96;28.03.2013;2013;03;09;Torstai;34;33;67;11;16;27
96;28.03.2013;2013;03;10;Torstai;42;42;84;11;16;27
96;28.03.2013;2013;03;11;Torstai;52;42;94;16;16;32
96;28.03.2013;2013;03;12;Torstai;47;30;77;15;31;46
96;28.03.2013;2013;03;13;Torstai;46;68;114;12;34;46
96;28.03.2013;2013;03;14;Torstai;55;98;153;10;31;41
96;28.03.2013;2013;03;15;Torstai;47;55;102;7;20;27
96;28.03.2013;2013;03;16;Torstai;30;32;62;9;16;25
96;28.03.2013;2013;03;17;Torstai;31;21;52;11;16;27
96;28.03.2013;2013;03;18;Torstai;14;8;22;5;6;11
96;28.03.2013;2013;03;19;Torstai;17;8;25;7;4;11
96;28.03.2013;2013;03;20;Torstai;10;12;22;5;6;11
96;28.03.2013;2013;03;21;Torstai;4;9;13;0;3;3
96;28.03.2013;2013;03;22;Torstai;4;5;9;0;0;0
96;28.03.2013;2013;03;23;Torstai;2;0;2;1;0;1
96;29.03.2013;2013;03;00;Perjantai;6;2;8;2;1;3
96;29.03.2013;2013;03;01;Perjantai;4;0;4;1;0;1
96;29.03.2013;2013;03;02;Perjantai;6;0;6;1;0;1
96;29.03.2013;2013;03;03;Perjantai;9;0;9;0;1;1
96;29.03.2013;2013;03;04;Perjantai;2;0;2;0;1;1
96;29.03.2013;2013;03;05;Perjantai;10;2;12;11;4;15
96;29.03.2013;2013;03;06;Perjantai;3;4;7;2;3;5
96;29.03.2013;2013;03;07;Perjantai;1;0;1;6;3;9
96;29.03.2013;2013;03;08;Perjantai;3;9;12;3;6;9
96;29.03.2013;2013;03;09;Perjantai;3;5;8;9;7;16
96;29.03.2013;2013;03;10;Perjantai;4;10;14;9;11;20
96;29.03.2013;2013;03;11;Perjantai;22;9;31;13;12;25
96;29.03.2013;2013;03;12;Perjantai;15;16;31;13;18;31
96;29.03.2013;2013;03;13;Perjantai;10;9;19;14;16;30
96;29.03.2013;2013;03;14;Perjantai;13;15;28;7;24;31
96;29.03.2013;2013;03;15;Perjantai;12;8;20;17;7;24
96;29.03.2013;2013;03;16;Perjantai;12;12;24;7;6;13
96;29.03.2013;2013;03;17;Perjantai;7;12;19;4;5;9
96;29.03.2013;2013;03;18;Perjantai;9;9;18;9;8;17
96;29.03.2013;2013;03;19;Perjantai;6;3;9;8;4;12
96;29.03.2013;2013;03;20;Perjantai;5;11;16;1;5;6
96;29.03.2013;2013;03;21;Perjantai;4;3;7;0;2;2
96;29.03.2013;2013;03;22;Perjantai;2;2;4;0;0;0
96;29.03.2013;2013;03;23;Perjantai;3;2;5;2;1;3
96;30.03.2013;2013;03;00;Lauantai;5;0;5;1;1;2
96;30.03.2013;2013;03;01;Lauantai;4;4;8;2;1;3
96;30.03.2013;2013;03;02;Lauantai;3;0;3;3;0;3
96;30.03.2013;2013;03;03;Lauantai;5;0;5;0;1;1
96;30.03.2013;2013;03;04;Lauantai;0;1;1;0;0;0
96;30.03.2013;2013;03;05;Lauantai;6;5;11;8;1;9
96;30.03.2013;2013;03;06;Lauantai;0;6;6;4;4;8
96;30.03.2013;2013;03;07;Lauantai;3;8;11;2;2;4
96;30.03.2013;2013;03;08;Lauantai;7;26;33;4;10;14
96;30.03.2013;2013;03;09;Lauantai;14;18;32;13;16;29
96;30.03.2013;2013;03;10;Lauantai;20;28;48;10;12;22
96;30.03.2013;2013;03;11;Lauantai;31;23;54;15;17;32
96;30.03.2013;2013;03;12;Lauantai;29;18;47;14;21;35
96;30.03.2013;2013;03;13;Lauantai;15;26;41;10;13;23
96;30.03.2013;2013;03;14;Lauantai;23;28;51;11;5;16
96;30.03.2013;2013;03;15;Lauantai;30;12;42;6;8;14
96;30.03.2013;2013;03;16;Lauantai;20;7;27;4;5;9
96;30.03.2013;2013;03;17;Lauantai;19;7;26;6;6;12
96;30.03.2013;2013;03;18;Lauantai;7;5;12;2;3;5
96;30.03.2013;2013;03;19;Lauantai;4;9;13;4;3;7
96;30.03.2013;2013;03;20;Lauantai;3;12;15;4;6;10
96;30.03.2013;2013;03;21;Lauantai;4;3;7;1;3;4
96;30.03.2013;2013;03;22;Lauantai;2;5;7;0;1;1
96;30.03.2013;2013;03;23;Lauantai;3;1;4;1;0;1
96;31.03.2013;2013;03;00;Sunnuntai;8;0;8;0;0;0
96;31.03.2013;2013;03;01;Sunnuntai;6;1;7;1;0;1
96;31.03.2013;2013;03;02;Sunnuntai;6;1;7;1;0;1
96;31.03.2013;2013;03;03;Sunnuntai;7;1;8;1;0;1
96;31.03.2013;2013;03;04;Sunnuntai;1;0;1;0;0;0
96;31.03.2013;2013;03;05;Sunnuntai;7;4;11;6;1;7
96;31.03.2013;2013;03;06;Sunnuntai;3;4;7;1;4;5
96;31.03.2013;2013;03;07;Sunnuntai;1;1;2;2;5;7
96;31.03.2013;2013;03;08;Sunnuntai;11;0;11;3;3;6
96;31.03.2013;2013;03;09;Sunnuntai;4;6;10;8;7;15
96;31.03.2013;2013;03;10;Sunnuntai;5;6;11;10;5;15
96;31.03.2013;2013;03;11;Sunnuntai;9;9;18;19;13;32
96;31.03.2013;2013;03;12;Sunnuntai;16;13;29;10;7;17
96;31.03.2013;2013;03;13;Sunnuntai;11;16;27;10;13;23
96;31.03.2013;2013;03;14;Sunnuntai;7;22;29;27;28;55
96;31.03.2013;2013;03;15;Sunnuntai;19;13;32;14;6;20
96;31.03.2013;2013;03;16;Sunnuntai;10;7;17;12;13;25
96;31.03.2013;2013;03;17;Sunnuntai;18;18;36;9;24;33
96;31.03.2013;2013;03;18;Sunnuntai;3;16;19;5;13;18
96;31.03.2013;2013;03;19;Sunnuntai;7;13;20;7;14;21
96;31.03.2013;2013;03;20;Sunnuntai;19;11;30;4;3;7
96;31.03.2013;2013;03;21;Sunnuntai;5;5;10;1;3;4
96;31.03.2013;2013;03;22;Sunnuntai;4;7;11;0;0;0
96;31.03.2013;2013;03;23;Sunnuntai;3;3;6;0;1;1
96;01.04.2013;2013;04;00;Maanantai;2;3;5;2;0;2
96;01.04.2013;2013;04;01;Maanantai;0;0;0;0;0;0
96;01.04.2013;2013;04;02;Maanantai;3;0;3;0;0;0
96;01.04.2013;2013;04;03;Maanantai;2;0;2;0;0;0
96;01.04.2013;2013;04;04;Maanantai;0;1;1;0;1;1
96;01.04.2013;2013;04;05;Maanantai;11;1;12;6;0;6
96;01.04.2013;2013;04;06;Maanantai;5;5;10;27;124;151
96;01.04.2013;2013;04;07;Maanantai;3;5;8;2;8;10
96;01.04.2013;2013;04;08;Maanantai;4;9;13;5;6;11
96;01.04.2013;2013;04;09;Maanantai;7;8;15;10;4;14
96;01.04.2013;2013;04;10;Maanantai;7;9;16;9;14;23
96;01.04.2013;2013;04;11;Maanantai;12;11;23;21;19;40
96;01.04.2013;2013;04;12;Maanantai;17;11;28;12;18;30
96;01.04.2013;2013;04;13;Maanantai;14;17;31;25;29;54
96;01.04.2013;2013;04;14;Maanantai;13;20;33;6;22;28
96;01.04.2013;2013;04;15;Maanantai;18;12;30;13;10;23
96;01.04.2013;2013;04;16;Maanantai;21;9;30;19;8;27
96;01.04.2013;2013;04;17;Maanantai;29;11;40;12;11;23
96;01.04.2013;2013;04;18;Maanantai;5;8;13;9;18;27
96;01.04.2013;2013;04;19;Maanantai;12;15;27;11;10;21
96;01.04.2013;2013;04;20;Maanantai;15;14;29;3;9;12
96;01.04.2013;2013;04;21;Maanantai;8;3;11;6;5;11
96;01.04.2013;2013;04;22;Maanantai;1;0;1;1;1;2
96;01.04.2013;2013;04;23;Maanantai;1;0;1;4;1;5
96;02.04.2013;2013;04;00;Tiistai;0;0;0;0;0;0
96;02.04.2013;2013;04;01;Tiistai;0;0;0;1;0;1
96;02.04.2013;2013;04;02;Tiistai;0;1;1;0;0;0
96;02.04.2013;2013;04;03;Tiistai;2;0;2;0;1;1
96;02.04.2013;2013;04;04;Tiistai;4;13;17;0;0;0
96;02.04.2013;2013;04;05;Tiistai;17;14;31;15;0;15
96;02.04.2013;2013;04;06;Tiistai;77;47;124;29;11;40
96;02.04.2013;2013;04;07;Tiistai;65;70;135;15;8;23
96;02.04.2013;2013;04;08;Tiistai;55;39;94;9;7;16
96;02.04.2013;2013;04;09;Tiistai;33;35;68;9;15;24
96;02.04.2013;2013;04;10;Tiistai;27;24;51;17;13;30
96;02.04.2013;2013;04;11;Tiistai;46;36;82;9;17;26
96;02.04.2013;2013;04;12;Tiistai;39;35;74;15;20;35
96;02.04.2013;2013;04;13;Tiistai;59;59;118;12;22;34
96;02.04.2013;2013;04;14;Tiistai;56;97;153;10;44;54
96;02.04.2013;2013;04;15;Tiistai;78;82;160;25;38;63
96;02.04.2013;2013;04;16;Tiistai;54;43;97;14;19;33
96;02.04.2013;2013;04;17;Tiistai;44;31;75;22;16;38
96;02.04.2013;2013;04;18;Tiistai;42;21;63;16;14;30
96;02.04.2013;2013;04;19;Tiistai;38;9;47;30;8;38
96;02.04.2013;2013;04;20;Tiistai;25;19;44;8;11;19
96;02.04.2013;2013;04;21;Tiistai;6;4;10;2;3;5
96;02.04.2013;2013;04;22;Tiistai;3;0;3;1;2;3
96;02.04.2013;2013;04;23;Tiistai;4;0;4;1;0;1
96;03.04.2013;2013;04;00;Keskiviikko;0;0;0;0;0;0
96;03.04.2013;2013;04;01;Keskiviikko;0;0;0;1;1;2
96;03.04.2013;2013;04;02;Keskiviikko;0;0;0;1;0;1
96;03.04.2013;2013;04;03;Keskiviikko;1;1;2;8;8;16
96;03.04.2013;2013;04;04;Keskiviikko;2;8;10;2;3;5
96;03.04.2013;2013;04;05;Keskiviikko;26;21;47;20;6;26
96;03.04.2013;2013;04;06;Keskiviikko;63;44;107;45;62;107
96;03.04.2013;2013;04;07;Keskiviikko;83;79;162;17;16;33
96;03.04.2013;2013;04;08;Keskiviikko;39;43;82;9;9;18
96;03.04.2013;2013;04;09;Keskiviikko;25;40;65;6;14;20
96;03.04.2013;2013;04;10;Keskiviikko;26;19;45;7;12;19
96;03.04.2013;2013;04;11;Keskiviikko;42;40;82;13;22;35
96;03.04.2013;2013;04;12;Keskiviikko;54;35;89;16;18;34
96;03.04.2013;2013;04;13;Keskiviikko;52;59;111;26;21;47
96;03.04.2013;2013;04;14;Keskiviikko;63;90;153;20;38;58
96;03.04.2013;2013;04;15;Keskiviikko;62;96;158;12;46;58
96;03.04.2013;2013;04;16;Keskiviikko;55;48;103;18;25;43
96;03.04.2013;2013;04;17;Keskiviikko;61;27;88;43;22;65
96;03.04.2013;2013;04;18;Keskiviikko;38;21;59;25;17;42
96;03.04.2013;2013;04;19;Keskiviikko;29;22;51;11;18;29
96;03.04.2013;2013;04;20;Keskiviikko;15;28;43;7;7;14
96;03.04.2013;2013;04;21;Keskiviikko;8;5;13;3;2;5
96;03.04.2013;2013;04;22;Keskiviikko;4;3;7;0;3;3
96;03.04.2013;2013;04;23;Keskiviikko;1;1;2;1;1;2
96;04.04.2013;2013;04;00;Torstai;3;0;3;1;0;1
96;04.04.2013;2013;04;01;Torstai;2;0;2;0;0;0
96;04.04.2013;2013;04;02;Torstai;1;0;1;0;0;0
96;04.04.2013;2013;04;03;Torstai;1;0;1;0;0;0
96;04.04.2013;2013;04;04;Torstai;2;7;9;5;3;8
96;04.04.2013;2013;04;05;Torstai;30;18;48;19;5;24
96;04.04.2013;2013;04;06;Torstai;63;44;107;29;9;38
96;04.04.2013;2013;04;07;Torstai;69;67;136;12;6;18
96;04.04.2013;2013;04;08;Torstai;37;54;91;10;11;21
96;04.04.2013;2013;04;09;Torstai;32;35;67;9;10;19
96;04.04.2013;2013;04;10;Torstai;24;26;50;10;21;31
96;04.04.2013;2013;04;11;Torstai;51;35;86;9;22;31
96;04.04.2013;2013;04;12;Torstai;39;35;74;11;28;39
96;04.04.2013;2013;04;13;Torstai;59;52;111;13;24;37
96;04.04.2013;2013;04;14;Torstai;62;109;171;15;39;54
96;04.04.2013;2013;04;15;Torstai;65;98;163;16;42;58
96;04.04.2013;2013;04;16;Torstai;49;41;90;19;20;39
96;04.04.2013;2013;04;17;Torstai;44;32;76;13;19;32
96;04.04.2013;2013;04;18;Torstai;26;21;47;14;24;38
96;04.04.2013;2013;04;19;Torstai;32;20;52;28;11;39
96;04.04.2013;2013;04;20;Torstai;27;19;46;10;8;18
96;04.04.2013;2013;04;21;Torstai;10;10;20;4;4;8
96;04.04.2013;2013;04;22;Torstai;5;4;9;0;1;1
96;04.04.2013;2013;04;23;Torstai;1;1;2;1;0;1
96;05.04.2013;2013;04;00;Perjantai;3;1;4;1;1;2
96;05.04.2013;2013;04;01;Perjantai;5;0;5;0;0;0
96;05.04.2013;2013;04;02;Perjantai;5;5;10;0;3;3
96;05.04.2013;2013;04;03;Perjantai;3;0;3;2;0;2
96;05.04.2013;2013;04;04;Perjantai;1;6;7;1;1;2
96;05.04.2013;2013;04;05;Perjantai;31;17;48;15;6;21
96;05.04.2013;2013;04;06;Perjantai;62;41;103;34;12;46
96;05.04.2013;2013;04;07;Perjantai;63;75;138;12;16;28
96;05.04.2013;2013;04;08;Perjantai;40;45;85;14;11;25
96;05.04.2013;2013;04;09;Perjantai;41;33;74;7;18;25
96;05.04.2013;2013;04;10;Perjantai;33;49;82;14;9;23
96;05.04.2013;2013;04;11;Perjantai;48;55;103;13;16;29
96;05.04.2013;2013;04;12;Perjantai;36;49;85;13;19;32
96;05.04.2013;2013;04;13;Perjantai;48;63;111;11;23;34
96;05.04.2013;2013;04;14;Perjantai;55;91;146;17;44;61
96;05.04.2013;2013;04;15;Perjantai;65;52;117;11;20;31
96;05.04.2013;2013;04;16;Perjantai;45;27;72;14;8;22
96;05.04.2013;2013;04;17;Perjantai;32;26;58;10;11;21
96;05.04.2013;2013;04;18;Perjantai;19;19;38;7;9;16
96;05.04.2013;2013;04;19;Perjantai;15;9;24;7;6;13
96;05.04.2013;2013;04;20;Perjantai;17;18;35;9;6;15
96;05.04.2013;2013;04;21;Perjantai;7;5;12;5;2;7
96;05.04.2013;2013;04;22;Perjantai;2;2;4;0;1;1
96;05.04.2013;2013;04;23;Perjantai;3;4;7;2;1;3
96;06.04.2013;2013;04;00;Lauantai;4;2;6;0;0;0
96;06.04.2013;2013;04;01;Lauantai;6;2;8;0;0;0
96;06.04.2013;2013;04;02;Lauantai;7;0;7;2;0;2
96;06.04.2013;2013;04;03;Lauantai;9;0;9;0;1;1
96;06.04.2013;2013;04;04;Lauantai;3;1;4;0;0;0
96;06.04.2013;2013;04;05;Lauantai;19;8;27;8;5;13
96;06.04.2013;2013;04;06;Lauantai;3;8;11;4;5;9
96;06.04.2013;2013;04;07;Lauantai;5;16;21;7;9;16
96;06.04.2013;2013;04;08;Lauantai;5;23;28;9;10;19
96;06.04.2013;2013;04;09;Lauantai;7;12;19;6;5;11
96;06.04.2013;2013;04;10;Lauantai;17;17;34;13;17;30
96;06.04.2013;2013;04;11;Lauantai;17;26;43;8;20;28
96;06.04.2013;2013;04;12;Lauantai;23;35;58;20;12;32
96;06.04.2013;2013;04;13;Lauantai;34;35;69;13;13;26
96;06.04.2013;2013;04;14;Lauantai;22;25;47;11;17;28
96;06.04.2013;2013;04;15;Lauantai;30;27;57;18;15;33
96;06.04.2013;2013;04;16;Lauantai;15;13;28;11;4;15
96;06.04.2013;2013;04;17;Lauantai;23;11;34;22;11;33
96;06.04.2013;2013;04;18;Lauantai;14;4;18;14;6;20
96;06.04.2013;2013;04;19;Lauantai;20;11;31;10;12;22
96;06.04.2013;2013;04;20;Lauantai;4;19;23;4;10;14
96;06.04.2013;2013;04;21;Lauantai;7;1;8;1;1;2
96;06.04.2013;2013;04;22;Lauantai;2;4;6;2;3;5
96;06.04.2013;2013;04;23;Lauantai;4;2;6;0;0;0
96;07.04.2013;2013;04;00;Sunnuntai;2;1;3;2;1;3
96;07.04.2013;2013;04;01;Sunnuntai;3;1;4;1;0;1
96;07.04.2013;2013;04;02;Sunnuntai;4;0;4;0;0;0
96;07.04.2013;2013;04;03;Sunnuntai;1;0;1;1;0;1
96;07.04.2013;2013;04;04;Sunnuntai;0;0;0;0;0;0
96;07.04.2013;2013;04;05;Sunnuntai;12;3;15;2;3;5
96;07.04.2013;2013;04;06;Sunnuntai;2;5;7;1;6;7
96;07.04.2013;2013;04;07;Sunnuntai;4;9;13;2;3;5
96;07.04.2013;2013;04;08;Sunnuntai;3;6;9;7;10;17
96;07.04.2013;2013;04;09;Sunnuntai;7;11;18;11;7;18
96;07.04.2013;2013;04;10;Sunnuntai;13;8;21;15;16;31
96;07.04.2013;2013;04;11;Sunnuntai;17;28;45;13;16;29
96;07.04.2013;2013;04;12;Sunnuntai;26;22;48;20;14;34
96;07.04.2013;2013;04;13;Sunnuntai;27;15;42;15;13;28
96;07.04.2013;2013;04;14;Sunnuntai;15;18;33;8;12;20
96;07.04.2013;2013;04;15;Sunnuntai;18;16;34;26;14;40
96;07.04.2013;2013;04;16;Sunnuntai;24;14;38;25;12;37
96;07.04.2013;2013;04;17;Sunnuntai;27;14;41;34;16;50
96;07.04.2013;2013;04;18;Sunnuntai;11;9;20;14;14;28
96;07.04.2013;2013;04;19;Sunnuntai;24;17;41;10;20;30
96;07.04.2013;2013;04;20;Sunnuntai;8;16;24;6;9;15
96;07.04.2013;2013;04;21;Sunnuntai;4;2;6;3;1;4
96;07.04.2013;2013;04;22;Sunnuntai;5;1;6;2;1;3
96;07.04.2013;2013;04;23;Sunnuntai;1;2;3;2;1;3
96;27.05.2013;2013;05;00;Maanantai;0;0;0;0;0;0
96;27.05.2013;2013;05;01;Maanantai;0;0;0;0;0;0
96;27.05.2013;2013;05;02;Maanantai;0;0;0;0;0;0
96;27.05.2013;2013;05;03;Maanantai;0;0;0;0;0;0
96;27.05.2013;2013;05;04;Maanantai;0;0;0;0;0;0
96;27.05.2013;2013;05;05;Maanantai;0;0;0;0;0;0
96;27.05.2013;2013;05;06;Maanantai;0;0;0;0;0;0
96;27.05.2013;2013;05;07;Maanantai;145;161;306;12;7;19
96;27.05.2013;2013;05;08;Maanantai;71;189;260;10;6;16
96;27.05.2013;2013;05;09;Maanantai;54;108;162;8;7;15
96;27.05.2013;2013;05;10;Maanantai;64;71;135;2;5;7
96;27.05.2013;2013;05;11;Maanantai;79;73;152;9;4;13
96;27.05.2013;2013;05;12;Maanantai;85;88;173;12;8;20
96;27.05.2013;2013;05;13;Maanantai;124;88;212;6;7;13
96;27.05.2013;2013;05;14;Maanantai;117;126;243;5;11;16
96;27.05.2013;2013;05;15;Maanantai;165;225;390;8;23;31
96;27.05.2013;2013;05;16;Maanantai;166;136;302;8;26;34
96;27.05.2013;2013;05;17;Maanantai;111;106;217;10;8;18
96;27.05.2013;2013;05;18;Maanantai;109;68;177;13;10;23
96;27.05.2013;2013;05;19;Maanantai;75;54;129;21;14;35
96;27.05.2013;2013;05;20;Maanantai;75;46;121;12;10;22
96;27.05.2013;2013;05;21;Maanantai;54;40;94;5;8;13
96;27.05.2013;2013;05;22;Maanantai;11;12;23;4;4;8
96;27.05.2013;2013;05;23;Maanantai;9;4;13;4;1;5
96;28.05.2013;2013;05;00;Tiistai;3;1;4;0;0;0
96;28.05.2013;2013;05;01;Tiistai;1;0;1;0;0;0
96;28.05.2013;2013;05;02;Tiistai;0;0;0;1;1;2
96;28.05.2013;2013;05;03;Tiistai;0;1;1;0;0;0
96;28.05.2013;2013;05;04;Tiistai;1;2;3;0;0;0
96;28.05.2013;2013;05;05;Tiistai;4;10;14;0;0;0
96;28.05.2013;2013;05;06;Tiistai;45;48;93;9;2;11
96;28.05.2013;2013;05;07;Tiistai;112;150;262;15;10;25
96;28.05.2013;2013;05;08;Tiistai;97;121;218;17;8;25
96;28.05.2013;2013;05;09;Tiistai;51;65;116;3;7;10
96;28.05.2013;2013;05;10;Tiistai;37;63;100;5;10;15
96;28.05.2013;2013;05;11;Tiistai;43;58;101;10;8;18
96;28.05.2013;2013;05;12;Tiistai;59;59;118;10;10;20
96;28.05.2013;2013;05;13;Tiistai;61;60;121;17;11;28
96;28.05.2013;2013;05;14;Tiistai;75;77;152;3;7;10
96;28.05.2013;2013;05;15;Tiistai;89;163;252;6;20;26
96;28.05.2013;2013;05;16;Tiistai;118;138;256;13;14;27
96;28.05.2013;2013;05;17;Tiistai;70;73;143;11;21;32
96;28.05.2013;2013;05;18;Tiistai;56;67;123;13;8;21
96;28.05.2013;2013;05;19;Tiistai;55;48;103;27;10;37
96;28.05.2013;2013;05;20;Tiistai;50;42;92;10;23;33
96;28.05.2013;2013;05;21;Tiistai;35;36;71;4;14;18
96;28.05.2013;2013;05;22;Tiistai;14;11;25;2;2;4
96;28.05.2013;2013;05;23;Tiistai;10;3;13;1;2;3
96;29.05.2013;2013;05;00;Keskiviikko;0;0;0;0;0;0
96;29.05.2013;2013;05;01;Keskiviikko;0;0;0;0;0;0
96;29.05.2013;2013;05;02;Keskiviikko;0;0;0;0;0;0
96;29.05.2013;2013;05;03;Keskiviikko;0;0;0;0;0;0
96;29.05.2013;2013;05;04;Keskiviikko;0;0;0;0;0;0
96;29.05.2013;2013;05;05;Keskiviikko;0;0;0;0;0;0
96;29.05.2013;2013;05;06;Keskiviikko;0;0;0;0;0;0
96;29.05.2013;2013;05;07;Keskiviikko;170;158;328;14;16;30
96;29.05.2013;2013;05;08;Keskiviikko;108;167;275;10;17;27
96;29.05.2013;2013;05;09;Keskiviikko;58;119;177;8;5;13
96;29.05.2013;2013;05;10;Keskiviikko;53;95;148;7;12;19
96;29.05.2013;2013;05;11;Keskiviikko;79;105;184;10;14;24
96;29.05.2013;2013;05;12;Keskiviikko;128;110;238;14;14;28
96;29.05.2013;2013;05;13;Keskiviikko;108;83;191;6;15;21
96;29.05.2013;2013;05;14;Keskiviikko;123;122;245;4;19;23
96;29.05.2013;2013;05;15;Keskiviikko;184;206;390;12;26;38
96;29.05.2013;2013;05;16;Keskiviikko;201;152;353;16;17;33
96;29.05.2013;2013;05;17;Keskiviikko;137;83;220;11;8;19
96;29.05.2013;2013;05;18;Keskiviikko;138;67;205;11;8;19
96;29.05.2013;2013;05;19;Keskiviikko;101;56;157;20;12;32
96;29.05.2013;2013;05;20;Keskiviikko;67;82;149;9;8;17
96;29.05.2013;2013;05;21;Keskiviikko;71;44;115;7;9;16
96;29.05.2013;2013;05;22;Keskiviikko;26;15;41;4;0;4
96;29.05.2013;2013;05;23;Keskiviikko;23;10;33;2;2;4
96;30.05.2013;2013;05;00;Torstai;13;2;15;2;2;4
96;30.05.2013;2013;05;01;Torstai;4;1;5;0;1;1
96;30.05.2013;2013;05;02;Torstai;7;3;10;5;0;5
96;30.05.2013;2013;05;03;Torstai;4;0;4;1;0;1
96;30.05.2013;2013;05;04;Torstai;5;2;7;0;0;0
96;30.05.2013;2013;05;05;Torstai;9;8;17;0;1;1
96;30.05.2013;2013;05;06;Torstai;69;47;116;3;1;4
96;30.05.2013;2013;05;07;Torstai;160;156;316;7;14;21
96;30.05.2013;2013;05;08;Torstai;89;164;253;9;14;23
96;30.05.2013;2013;05;09;Torstai;72;131;203;4;8;12
96;30.05.2013;2013;05;10;Torstai;83;91;174;11;10;21
96;30.05.2013;2013;05;11;Torstai;104;75;179;9;9;18
96;30.05.2013;2013;05;12;Torstai;101;94;195;7;19;26
96;30.05.2013;2013;05;13;Torstai;115;95;210;10;16;26
96;30.05.2013;2013;05;14;Torstai;130;110;240;12;16;28
96;30.05.2013;2013;05;15;Torstai;182;186;368;15;33;48
96;30.05.2013;2013;05;16;Torstai;188;147;335;9;8;17
96;30.05.2013;2013;05;17;Torstai;168;111;279;24;14;38
96;30.05.2013;2013;05;18;Torstai;129;62;191;8;9;17
96;30.05.2013;2013;05;19;Torstai;114;75;189;12;8;20
96;30.05.2013;2013;05;20;Torstai;110;64;174;12;6;18
96;30.05.2013;2013;05;21;Torstai;96;51;147;7;7;14
96;30.05.2013;2013;05;22;Torstai;23;22;45;6;2;8
96;30.05.2013;2013;05;23;Torstai;13;7;20;1;1;2
96;31.05.2013;2013;05;00;Perjantai;15;19;34;1;2;3
96;31.05.2013;2013;05;01;Perjantai;6;0;6;1;0;1
96;31.05.2013;2013;05;02;Perjantai;11;2;13;1;0;1
96;31.05.2013;2013;05;03;Perjantai;6;0;6;0;0;0
96;31.05.2013;2013;05;04;Perjantai;1;4;5;0;0;0
96;31.05.2013;2013;05;05;Perjantai;8;13;21;2;0;2
96;31.05.2013;2013;05;06;Perjantai;64;56;120;6;4;10
96;31.05.2013;2013;05;07;Perjantai;127;149;276;6;8;14
96;31.05.2013;2013;05;08;Perjantai;79;157;236;7;15;22
96;31.05.2013;2013;05;09;Perjantai;72;79;151;5;14;19
96;31.05.2013;2013;05;10;Perjantai;74;104;178;3;11;14
96;31.05.2013;2013;05;11;Perjantai;83;81;164;10;11;21
96;31.05.2013;2013;05;12;Perjantai;107;90;197;8;12;20
96;31.05.2013;2013;05;13;Perjantai;122;109;231;6;8;14
96;31.05.2013;2013;05;14;Perjantai;135;123;258;7;14;21
96;31.05.2013;2013;05;15;Perjantai;147;171;318;7;13;20
96;31.05.2013;2013;05;16;Perjantai;104;91;195;6;9;15
96;31.05.2013;2013;05;17;Perjantai;91;71;162;8;8;16
96;31.05.2013;2013;05;18;Perjantai;77;63;140;4;5;9
96;31.05.2013;2013;05;19;Perjantai;69;58;127;4;6;10
96;31.05.2013;2013;05;20;Perjantai;53;55;108;6;4;10
96;31.05.2013;2013;05;21;Perjantai;48;48;96;6;3;9
96;31.05.2013;2013;05;22;Perjantai;30;19;49;3;2;5
96;31.05.2013;2013;05;23;Perjantai;27;11;38;1;1;2
96;01.06.2013;2013;06;00;Lauantai;19;18;37;2;0;2
96;01.06.2013;2013;06;01;Lauantai;25;5;30;1;0;1
96;01.06.2013;2013;06;02;Lauantai;24;1;25;2;0;2
96;01.06.2013;2013;06;03;Lauantai;23;2;25;1;1;2
96;01.06.2013;2013;06;04;Lauantai;25;3;28;2;0;2
96;01.06.2013;2013;06;05;Lauantai;1;1;2;1;1;2
96;01.06.2013;2013;06;06;Lauantai;20;12;32;2;0;2
96;01.06.2013;2013;06;07;Lauantai;13;31;44;1;5;6
96;01.06.2013;2013;06;08;Lauantai;11;43;54;2;2;4
96;01.06.2013;2013;06;09;Lauantai;18;72;90;4;12;16
96;01.06.2013;2013;06;10;Lauantai;52;72;124;2;6;8
96;01.06.2013;2013;06;11;Lauantai;62;49;111;5;11;16
96;01.06.2013;2013;06;12;Lauantai;76;64;140;5;7;12
96;01.06.2013;2013;06;13;Lauantai;75;48;123;8;7;15
96;01.06.2013;2013;06;14;Lauantai;72;56;128;7;6;13
96;01.06.2013;2013;06;15;Lauantai;51;51;102;5;5;10
96;01.06.2013;2013;06;16;Lauantai;73;46;119;1;2;3
96;01.06.2013;2013;06;17;Lauantai;56;44;100;6;5;11
96;01.06.2013;2013;06;18;Lauantai;40;49;89;7;2;9
96;01.06.2013;2013;06;19;Lauantai;31;55;86;5;1;6
96;01.06.2013;2013;06;20;Lauantai;42;51;93;10;5;15
96;01.06.2013;2013;06;21;Lauantai;28;40;68;9;6;15
96;01.06.2013;2013;06;22;Lauantai;20;32;52;7;8;15
96;01.06.2013;2013;06;23;Lauantai;24;27;51;0;1;1
96;02.06.2013;2013;06;00;Sunnuntai;23;15;38;2;1;3
96;02.06.2013;2013;06;01;Sunnuntai;20;4;24;1;0;1
96;02.06.2013;2013;06;02;Sunnuntai;35;1;36;6;1;7
96;02.06.2013;2013;06;03;Sunnuntai;27;2;29;5;0;5
96;02.06.2013;2013;06;04;Sunnuntai;30;1;31;13;0;13
96;02.06.2013;2013;06;05;Sunnuntai;4;0;4;3;2;5
96;02.06.2013;2013;06;06;Sunnuntai;14;12;26;3;0;3
96;02.06.2013;2013;06;07;Sunnuntai;10;11;21;2;4;6
96;02.06.2013;2013;06;08;Sunnuntai;13;14;27;6;1;7
96;02.06.2013;2013;06;09;Sunnuntai;29;49;78;2;8;10
96;02.06.2013;2013;06;10;Sunnuntai;34;35;69;6;7;13
96;02.06.2013;2013;06;11;Sunnuntai;45;48;93;8;5;13
96;02.06.2013;2013;06;12;Sunnuntai;58;65;123;2;14;16
96;02.06.2013;2013;06;13;Sunnuntai;67;59;126;5;10;15
96;02.06.2013;2013;06;14;Sunnuntai;72;73;145;3;12;15
96;02.06.2013;2013;06;15;Sunnuntai;80;77;157;6;8;14
96;02.06.2013;2013;06;16;Sunnuntai;85;53;138;3;8;11
96;02.06.2013;2013;06;17;Sunnuntai;84;60;144;9;8;17
96;02.06.2013;2013;06;18;Sunnuntai;53;57;110;8;2;10
96;02.06.2013;2013;06;19;Sunnuntai;46;46;92;4;5;9
96;02.06.2013;2013;06;20;Sunnuntai;42;55;97;9;8;17
96;02.06.2013;2013;06;21;Sunnuntai;31;35;66;4;11;15
96;02.06.2013;2013;06;22;Sunnuntai;25;16;41;4;0;4
96;02.06.2013;2013;06;23;Sunnuntai;7;5;12;2;0;2
96;17.06.2013;2013;06;00;Maanantai;3;0;3;0;0;0
96;17.06.2013;2013;06;01;Maanantai;3;2;5;0;0;0
96;17.06.2013;2013;06;02;Maanantai;0;2;2;0;0;0
96;17.06.2013;2013;06;03;Maanantai;4;1;5;0;0;0
96;17.06.2013;2013;06;04;Maanantai;1;2;3;0;0;0
96;17.06.2013;2013;06;05;Maanantai;12;7;19;0;0;0
96;17.06.2013;2013;06;06;Maanantai;55;50;105;4;1;5
96;17.06.2013;2013;06;07;Maanantai;91;88;179;5;6;11
96;17.06.2013;2013;06;08;Maanantai;28;73;101;5;4;9
96;17.06.2013;2013;06;09;Maanantai;25;58;83;8;6;14
96;17.06.2013;2013;06;10;Maanantai;31;38;69;5;10;15
96;17.06.2013;2013;06;11;Maanantai;25;45;70;1;6;7
96;17.06.2013;2013;06;12;Maanantai;27;37;64;4;6;10
96;17.06.2013;2013;06;13;Maanantai;44;38;82;3;4;7
96;17.06.2013;2013;06;14;Maanantai;45;65;110;11;6;17
96;17.06.2013;2013;06;15;Maanantai;71;175;246;8;22;30
96;17.06.2013;2013;06;16;Maanantai;97;118;215;13;16;29
96;17.06.2013;2013;06;17;Maanantai;62;68;130;8;10;18
96;17.06.2013;2013;06;18;Maanantai;67;27;94;9;4;13
96;17.06.2013;2013;06;19;Maanantai;42;34;76;14;13;27
96;17.06.2013;2013;06;20;Maanantai;40;33;73;7;10;17
96;17.06.2013;2013;06;21;Maanantai;20;29;49;7;9;16
96;17.06.2013;2013;06;22;Maanantai;10;16;26;4;1;5
96;17.06.2013;2013;06;23;Maanantai;3;10;13;1;3;4
96;18.06.2013;2013;06;00;Tiistai;8;2;10;0;0;0
96;18.06.2013;2013;06;01;Tiistai;2;2;4;1;0;1
96;18.06.2013;2013;06;02;Tiistai;0;0;0;0;0;0
96;18.06.2013;2013;06;03;Tiistai;0;2;2;0;0;0
96;18.06.2013;2013;06;04;Tiistai;1;4;5;0;0;0
96;18.06.2013;2013;06;05;Tiistai;9;10;19;1;1;2
96;18.06.2013;2013;06;06;Tiistai;40;38;78;1;1;2
96;18.06.2013;2013;06;07;Tiistai;95;103;198;7;7;14
96;18.06.2013;2013;06;08;Tiistai;77;97;174;1;5;6
96;18.06.2013;2013;06;09;Tiistai;27;61;88;4;5;9
96;18.06.2013;2013;06;10;Tiistai;32;61;93;2;8;10
96;18.06.2013;2013;06;11;Tiistai;48;56;104;11;8;19
96;18.06.2013;2013;06;12;Tiistai;64;46;110;8;6;14
96;18.06.2013;2013;06;13;Tiistai;69;62;131;4;4;8
96;18.06.2013;2013;06;14;Tiistai;69;74;143;2;4;6
96;18.06.2013;2013;06;15;Tiistai;73;155;228;6;4;10
96;18.06.2013;2013;06;16;Tiistai;94;155;249;3;10;13
96;18.06.2013;2013;06;17;Tiistai;84;87;171;7;5;12
96;18.06.2013;2013;06;18;Tiistai;65;59;124;6;8;14
96;18.06.2013;2013;06;19;Tiistai;53;40;93;4;5;9
96;18.06.2013;2013;06;20;Tiistai;68;49;117;11;9;20
96;18.06.2013;2013;06;21;Tiistai;35;40;75;10;11;21
96;18.06.2013;2013;06;22;Tiistai;22;19;41;4;4;8
96;18.06.2013;2013;06;23;Tiistai;15;4;19;1;0;1
96;19.06.2013;2013;06;00;Keskiviikko;7;0;7;0;1;1
96;19.06.2013;2013;06;01;Keskiviikko;3;1;4;0;0;0
96;19.06.2013;2013;06;02;Keskiviikko;6;2;8;0;0;0
96;19.06.2013;2013;06;03;Keskiviikko;2;0;2;1;0;1
96;19.06.2013;2013;06;04;Keskiviikko;1;1;2;0;2;2
96;19.06.2013;2013;06;05;Keskiviikko;10;9;19;0;0;0
96;19.06.2013;2013;06;06;Keskiviikko;65;43;108;7;4;11
96;19.06.2013;2013;06;07;Keskiviikko;111;112;223;8;1;9
96;19.06.2013;2013;06;08;Keskiviikko;45;68;113;2;5;7
96;19.06.2013;2013;06;09;Keskiviikko;22;55;77;2;4;6
96;19.06.2013;2013;06;10;Keskiviikko;23;58;81;8;5;13
96;19.06.2013;2013;06;11;Keskiviikko;50;51;101;1;6;7
96;19.06.2013;2013;06;12;Keskiviikko;57;63;120;4;5;9
96;19.06.2013;2013;06;13;Keskiviikko;61;84;145;12;12;24
96;19.06.2013;2013;06;14;Keskiviikko;58;98;156;2;7;9
96;19.06.2013;2013;06;15;Keskiviikko;105;189;294;6;15;21
96;19.06.2013;2013;06;16;Keskiviikko;115;131;246;8;6;14
96;19.06.2013;2013;06;17;Keskiviikko;100;87;187;7;9;16
96;19.06.2013;2013;06;18;Keskiviikko;90;62;152;23;8;31
96;19.06.2013;2013;06;19;Keskiviikko;69;59;128;7;7;14
96;19.06.2013;2013;06;20;Keskiviikko;50;51;101;11;10;21
96;19.06.2013;2013;06;21;Keskiviikko;40;53;93;4;6;10
96;19.06.2013;2013;06;22;Keskiviikko;17;22;39;5;3;8
96;19.06.2013;2013;06;23;Keskiviikko;14;7;21;3;1;4
96;20.06.2013;2013;06;00;Torstai;8;6;14;2;0;2
96;20.06.2013;2013;06;01;Torstai;9;2;11;0;0;0
96;20.06.2013;2013;06;02;Torstai;10;2;12;1;0;1
96;20.06.2013;2013;06;03;Torstai;4;1;5;0;0;0
96;20.06.2013;2013;06;04;Torstai;2;4;6;0;0;0
96;20.06.2013;2013;06;05;Torstai;10;9;19;2;2;4
96;20.06.2013;2013;06;06;Torstai;56;44;100;5;2;7
96;20.06.2013;2013;06;07;Torstai;132;106;238;9;5;14
96;20.06.2013;2013;06;08;Torstai;48;99;147;3;4;7
96;20.06.2013;2013;06;09;Torstai;35;72;107;3;6;9
96;20.06.2013;2013;06;10;Torstai;43;53;96;3;3;6
96;20.06.2013;2013;06;11;Torstai;48;64;112;1;9;10
96;20.06.2013;2013;06;12;Torstai;59;73;132;4;5;9
96;20.06.2013;2013;06;13;Torstai;91;79;170;6;7;13
96;20.06.2013;2013;06;14;Torstai;74;120;194;2;7;9
96;20.06.2013;2013;06;15;Torstai;69;133;202;6;7;13
96;20.06.2013;2013;06;16;Torstai;56;51;107;1;5;6
96;20.06.2013;2013;06;17;Torstai;41;31;72;3;3;6
96;20.06.2013;2013;06;18;Torstai;22;14;36;3;1;4
96;20.06.2013;2013;06;19;Torstai;30;27;57;7;8;15
96;20.06.2013;2013;06;20;Torstai;57;37;94;3;7;10
96;20.06.2013;2013;06;21;Torstai;13;26;39;1;1;2
96;20.06.2013;2013;06;22;Torstai;6;9;15;2;3;5
96;20.06.2013;2013;06;23;Torstai;6;3;9;1;0;1
96;21.06.2013;2013;06;00;Perjantai;37;31;68;6;3;9
96;21.06.2013;2013;06;01;Perjantai;2;1;3;0;0;0
96;21.06.2013;2013;06;02;Perjantai;3;1;4;1;0;1
96;21.06.2013;2013;06;03;Perjantai;1;7;8;1;1;2
96;21.06.2013;2013;06;04;Perjantai;4;0;4;0;1;1
96;21.06.2013;2013;06;05;Perjantai;0;1;1;1;0;1
96;21.06.2013;2013;06;06;Perjantai;13;12;25;0;1;1
96;21.06.2013;2013;06;07;Perjantai;4;21;25;2;3;5
96;21.06.2013;2013;06;08;Perjantai;4;21;25;4;9;13
96;21.06.2013;2013;06;09;Perjantai;28;47;75;5;10;15
96;21.06.2013;2013;06;10;Perjantai;32;35;67;1;3;4
96;21.06.2013;2013;06;11;Perjantai;41;38;79;5;4;9
96;21.06.2013;2013;06;12;Perjantai;34;31;65;10;8;18
96;21.06.2013;2013;06;13;Perjantai;29;21;50;8;8;16
96;21.06.2013;2013;06;14;Perjantai;27;27;54;3;4;7
96;21.06.2013;2013;06;15;Perjantai;31;31;62;1;6;7
96;21.06.2013;2013;06;16;Perjantai;22;39;61;2;7;9
96;21.06.2013;2013;06;17;Perjantai;17;24;41;10;4;14
96;21.06.2013;2013;06;18;Perjantai;25;24;49;4;0;4
96;21.06.2013;2013;06;19;Perjantai;19;19;38;2;5;7
96;21.06.2013;2013;06;20;Perjantai;21;25;46;5;8;13
96;21.06.2013;2013;06;21;Perjantai;19;40;59;2;8;10
96;21.06.2013;2013;06;22;Perjantai;7;24;31;3;1;4
96;21.06.2013;2013;06;23;Perjantai;8;23;31;4;1;5
96;22.06.2013;2013;06;00;Lauantai;10;21;31;3;3;6
96;22.06.2013;2013;06;01;Lauantai;5;6;11;2;1;3
96;22.06.2013;2013;06;02;Lauantai;30;7;37;2;0;2
96;22.06.2013;2013;06;03;Lauantai;28;0;28;6;1;7
96;22.06.2013;2013;06;04;Lauantai;13;5;18;2;0;2
96;22.06.2013;2013;06;05;Lauantai;6;4;10;1;3;4
96;22.06.2013;2013;06;06;Lauantai;19;10;29;2;1;3
96;22.06.2013;2013;06;07;Lauantai;6;9;15;3;1;4
96;22.06.2013;2013;06;08;Lauantai;4;6;10;2;3;5
96;22.06.2013;2013;06;09;Lauantai;10;14;24;2;4;6
96;22.06.2013;2013;06;10;Lauantai;17;19;36;5;2;7
96;22.06.2013;2013;06;11;Lauantai;23;15;38;8;3;11
96;22.06.2013;2013;06;12;Lauantai;27;33;60;5;11;16
96;22.06.2013;2013;06;13;Lauantai;15;22;37;7;6;13
96;22.06.2013;2013;06;14;Lauantai;13;24;37;4;1;5
96;22.06.2013;2013;06;15;Lauantai;24;20;44;2;4;6
96;22.06.2013;2013;06;16;Lauantai;12;17;29;1;1;2
96;22.06.2013;2013;06;17;Lauantai;13;9;22;6;4;10
96;22.06.2013;2013;06;18;Lauantai;12;11;23;8;5;13
96;22.06.2013;2013;06;19;Lauantai;21;22;43;1;8;9
96;22.06.2013;2013;06;20;Lauantai;27;46;73;1;12;13
96;22.06.2013;2013;06;21;Lauantai;11;37;48;1;1;2
96;22.06.2013;2013;06;22;Lauantai;12;2;14;1;3;4
96;22.06.2013;2013;06;23;Lauantai;7;12;19;0;1;1
96;23.06.2013;2013;06;00;Sunnuntai;7;8;15;1;2;3
96;23.06.2013;2013;06;01;Sunnuntai;9;6;15;0;1;1
96;23.06.2013;2013;06;02;Sunnuntai;12;3;15;0;0;0
96;23.06.2013;2013;06;03;Sunnuntai;9;2;11;1;0;1
96;23.06.2013;2013;06;04;Sunnuntai;10;5;15;1;0;1
96;23.06.2013;2013;06;05;Sunnuntai;2;3;5;1;1;2
96;23.06.2013;2013;06;06;Sunnuntai;11;12;23;4;4;8
96;23.06.2013;2013;06;07;Sunnuntai;6;8;14;3;1;4
96;23.06.2013;2013;06;08;Sunnuntai;4;10;14;7;6;13
96;23.06.2013;2013;06;09;Sunnuntai;4;6;10;5;2;7
96;23.06.2013;2013;06;10;Sunnuntai;17;20;37;1;9;10
96;23.06.2013;2013;06;11;Sunnuntai;17;21;38;3;2;5
96;23.06.2013;2013;06;12;Sunnuntai;22;31;53;6;6;12
96;23.06.2013;2013;06;13;Sunnuntai;21;29;50;5;12;17
96;23.06.2013;2013;06;14;Sunnuntai;23;42;65;5;4;9
96;23.06.2013;2013;06;15;Sunnuntai;34;38;72;6;7;13
96;23.06.2013;2013;06;16;Sunnuntai;30;33;63;7;10;17
96;23.06.2013;2013;06;17;Sunnuntai;57;39;96;15;1;16
96;23.06.2013;2013;06;18;Sunnuntai;40;26;66;10;6;16
96;23.06.2013;2013;06;19;Sunnuntai;34;45;79;2;12;14
96;23.06.2013;2013;06;20;Sunnuntai;42;42;84;8;12;20
96;23.06.2013;2013;06;21;Sunnuntai;20;35;55;7;11;18
96;23.06.2013;2013;06;22;Sunnuntai;15;12;27;1;2;3
96;23.06.2013;2013;06;23;Sunnuntai;9;8;17;3;1;4
96;24.06.2013;2013;06;00;Maanantai;7;1;8;1;0;1
96;24.06.2013;2013;06;01;Maanantai;3;4;7;0;0;0
96;24.06.2013;2013;06;02;Maanantai;7;1;8;0;0;0
96;24.06.2013;2013;06;03;Maanantai;6;2;8;0;0;0
96;24.06.2013;2013;06;04;Maanantai;1;2;3;1;1;2
96;24.06.2013;2013;06;05;Maanantai;11;9;20;0;1;1
96;24.06.2013;2013;06;06;Maanantai;59;53;112;4;1;5
96;24.06.2013;2013;06;07;Maanantai;108;106;214;11;5;16
96;24.06.2013;2013;06;08;Maanantai;49;92;141;4;11;15
96;24.06.2013;2013;06;09;Maanantai;35;70;105;9;8;17
96;24.06.2013;2013;06;10;Maanantai;56;75;131;9;14;23
96;24.06.2013;2013;06;11;Maanantai;68;72;140;13;6;19
96;24.06.2013;2013;06;12;Maanantai;54;89;143;14;9;23
96;24.06.2013;2013;06;13;Maanantai;75;87;162;7;8;15
96;24.06.2013;2013;06;14;Maanantai;88;101;189;5;6;11
96;24.06.2013;2013;06;15;Maanantai;115;184;299;13;23;36
96;24.06.2013;2013;06;16;Maanantai;136;118;254;12;14;26
96;24.06.2013;2013;06;17;Maanantai;127;94;221;13;11;24
96;24.06.2013;2013;06;18;Maanantai;110;82;192;21;10;31
96;24.06.2013;2013;06;19;Maanantai;79;59;138;13;14;27
96;24.06.2013;2013;06;20;Maanantai;68;51;119;9;8;17
96;24.06.2013;2013;06;21;Maanantai;51;38;89;10;4;14
96;24.06.2013;2013;06;22;Maanantai;18;17;35;2;4;6
96;24.06.2013;2013;06;23;Maanantai;14;12;26;2;4;6
96;25.06.2013;2013;06;00;Tiistai;8;4;12;3;2;5
96;25.06.2013;2013;06;01;Tiistai;4;3;7;0;0;0
96;25.06.2013;2013;06;02;Tiistai;2;4;6;1;0;1
96;25.06.2013;2013;06;03;Tiistai;2;1;3;0;1;1
96;25.06.2013;2013;06;04;Tiistai;1;2;3;0;1;1
96;25.06.2013;2013;06;05;Tiistai;9;11;20;0;0;0
96;25.06.2013;2013;06;06;Tiistai;63;61;124;2;4;6
96;25.06.2013;2013;06;07;Tiistai;123;113;236;6;4;10
96;25.06.2013;2013;06;08;Tiistai;54;79;133;6;6;12
96;25.06.2013;2013;06;09;Tiistai;47;82;129;4;5;9
96;25.06.2013;2013;06;10;Tiistai;43;69;112;5;7;12
96;25.06.2013;2013;06;11;Tiistai;59;82;141;10;12;22
96;25.06.2013;2013;06;12;Tiistai;59;81;140;5;6;11
96;25.06.2013;2013;06;13;Tiistai;75;84;159;8;7;15
96;25.06.2013;2013;06;14;Tiistai;83;111;194;9;5;14
96;25.06.2013;2013;06;15;Tiistai;102;189;291;6;6;12
96;25.06.2013;2013;06;16;Tiistai;123;120;243;4;6;10
96;25.06.2013;2013;06;17;Tiistai;88;89;177;5;10;15
96;25.06.2013;2013;06;18;Tiistai;74;79;153;11;6;17
96;25.06.2013;2013;06;19;Tiistai;72;53;125;9;18;27
96;25.06.2013;2013;06;20;Tiistai;53;44;97;15;9;24
96;25.06.2013;2013;06;21;Tiistai;51;36;87;6;9;15
96;25.06.2013;2013;06;22;Tiistai;13;11;24;1;1;2
96;25.06.2013;2013;06;23;Tiistai;5;6;11;2;0;2
96;26.06.2013;2013;06;00;Keskiviikko;6;1;7;0;1;1
96;26.06.2013;2013;06;01;Keskiviikko;5;3;8;0;0;0
96;26.06.2013;2013;06;02;Keskiviikko;5;5;10;0;0;0
96;26.06.2013;2013;06;03;Keskiviikko;5;1;6;0;0;0
96;26.06.2013;2013;06;04;Keskiviikko;5;3;8;0;0;0
96;26.06.2013;2013;06;05;Keskiviikko;8;6;14;1;1;2
96;26.06.2013;2013;06;06;Keskiviikko;66;60;126;3;4;7
96;26.06.2013;2013;06;07;Keskiviikko;109;105;214;7;11;18
96;26.06.2013;2013;06;08;Keskiviikko;61;99;160;2;4;6
96;26.06.2013;2013;06;09;Keskiviikko;40;82;122;9;10;19
96;26.06.2013;2013;06;10;Keskiviikko;36;58;94;4;8;12
96;26.06.2013;2013;06;11;Keskiviikko;43;92;135;3;10;13
96;26.06.2013;2013;06;12;Keskiviikko;85;88;173;6;8;14
96;26.06.2013;2013;06;13;Keskiviikko;97;82;179;4;9;13
96;26.06.2013;2013;06;14;Keskiviikko;117;120;237;12;13;25
96;26.06.2013;2013;06;15;Keskiviikko;150;174;324;16;23;39
96;26.06.2013;2013;06;16;Keskiviikko;154;120;274;14;9;23
96;26.06.2013;2013;06;17;Keskiviikko;136;74;210;11;9;20
96;26.06.2013;2013;06;18;Keskiviikko;128;59;187;11;3;14
96;26.06.2013;2013;06;19;Keskiviikko;105;61;166;9;5;14
96;26.06.2013;2013;06;20;Keskiviikko;87;41;128;6;6;12
96;26.06.2013;2013;06;21;Keskiviikko;50;39;89;7;7;14
96;26.06.2013;2013;06;22;Keskiviikko;37;17;54;2;2;4
96;26.06.2013;2013;06;23;Keskiviikko;21;18;39;1;0;1
96;27.06.2013;2013;06;00;Torstai;9;4;13;0;2;2
96;27.06.2013;2013;06;01;Torstai;11;7;18;1;0;1
96;27.06.2013;2013;06;02;Torstai;5;1;6;0;0;0
96;27.06.2013;2013;06;03;Torstai;9;1;10;1;2;3
96;27.06.2013;2013;06;04;Torstai;3;5;8;0;0;0
96;27.06.2013;2013;06;05;Torstai;11;7;18;1;1;2
96;27.06.2013;2013;06;06;Torstai;53;57;110;4;7;11
96;27.06.2013;2013;06;07;Torstai;96;118;214;8;7;15
96;27.06.2013;2013;06;08;Torstai;53;80;133;3;6;9
96;27.06.2013;2013;06;09;Torstai;38;75;113;7;3;10
96;27.06.2013;2013;06;10;Torstai;34;57;91;4;12;16
96;27.06.2013;2013;06;11;Torstai;66;81;147;10;9;19
96;27.06.2013;2013;06;12;Torstai;87;57;144;11;15;26
96;27.06.2013;2013;06;13;Torstai;101;65;166;7;9;16
96;27.06.2013;2013;06;14;Torstai;100;57;157;4;7;11
96;27.06.2013;2013;06;15;Torstai;124;141;265;8;13;21
96;27.06.2013;2013;06;16;Torstai;146;100;246;3;12;15
96;27.06.2013;2013;06;17;Torstai;84;67;151;5;7;12
96;27.06.2013;2013;06;18;Torstai;73;51;124;4;9;13
96;27.06.2013;2013;06;19;Torstai;40;38;78;8;2;10
96;27.06.2013;2013;06;20;Torstai;40;31;71;6;4;10
96;27.06.2013;2013;06;21;Torstai;33;28;61;1;3;4
96;27.06.2013;2013;06;22;Torstai;11;4;15;3;1;4
96;27.06.2013;2013;06;23;Torstai;7;8;15;0;4;4
96;28.06.2013;2013;06;00;Perjantai;5;4;9;1;0;1
96;28.06.2013;2013;06;01;Perjantai;5;0;5;0;1;1
96;28.06.2013;2013;06;02;Perjantai;2;5;7;0;0;0
96;28.06.2013;2013;06;03;Perjantai;2;1;3;0;1;1
96;28.06.2013;2013;06;04;Perjantai;4;2;6;1;0;1
96;28.06.2013;2013;06;05;Perjantai;8;6;14;0;1;1
96;28.06.2013;2013;06;06;Perjantai;40;62;102;2;1;3
96;28.06.2013;2013;06;07;Perjantai;75;93;168;8;6;14
96;28.06.2013;2013;06;08;Perjantai;31;71;102;2;4;6
96;28.06.2013;2013;06;09;Perjantai;14;35;49;0;4;4
96;28.06.2013;2013;06;10;Perjantai;10;25;35;1;3;4
96;28.06.2013;2013;06;11;Perjantai;23;30;53;3;1;4
96;28.06.2013;2013;06;12;Perjantai;35;53;88;3;3;6
96;28.06.2013;2013;06;13;Perjantai;34;60;94;1;3;4
96;28.06.2013;2013;06;14;Perjantai;45;97;142;1;3;4
96;28.06.2013;2013;06;15;Perjantai;71;122;193;4;6;10
96;28.06.2013;2013;06;16;Perjantai;64;63;127;2;2;4
96;28.06.2013;2013;06;17;Perjantai;49;43;92;7;7;14
96;28.06.2013;2013;06;18;Perjantai;47;26;73;2;5;7
96;28.06.2013;2013;06;19;Perjantai;35;42;77;9;4;13
96;28.06.2013;2013;06;20;Perjantai;29;36;65;5;9;14
96;28.06.2013;2013;06;21;Perjantai;24;49;73;7;4;11
96;28.06.2013;2013;06;22;Perjantai;22;16;38;1;2;3
96;28.06.2013;2013;06;23;Perjantai;14;12;26;2;2;4
96;29.06.2013;2013;06;00;Lauantai;17;5;22;2;0;2
96;29.06.2013;2013;06;01;Lauantai;23;10;33;3;0;3
96;29.06.2013;2013;06;02;Lauantai;18;1;19;0;0;0
96;29.06.2013;2013;06;03;Lauantai;19;2;21;3;0;3
96;29.06.2013;2013;06;04;Lauantai;11;3;14;1;0;1
96;29.06.2013;2013;06;05;Lauantai;6;3;9;1;0;1
96;29.06.2013;2013;06;06;Lauantai;15;8;23;0;2;2
96;29.06.2013;2013;06;07;Lauantai;5;17;22;1;3;4
96;29.06.2013;2013;06;08;Lauantai;9;20;29;3;0;3
96;29.06.2013;2013;06;09;Lauantai;16;54;70;3;5;8
96;29.06.2013;2013;06;10;Lauantai;35;42;77;5;11;16
96;29.06.2013;2013;06;11;Lauantai;37;60;97;5;9;14
96;29.06.2013;2013;06;12;Lauantai;62;65;127;9;11;20
96;29.06.2013;2013;06;13;Lauantai;72;90;162;1;11;12
96;29.06.2013;2013;06;14;Lauantai;58;51;109;2;8;10
96;29.06.2013;2013;06;15;Lauantai;78;44;122;6;12;18
96;29.06.2013;2013;06;16;Lauantai;93;54;147;9;8;17
96;29.06.2013;2013;06;17;Lauantai;61;42;103;8;7;15
96;29.06.2013;2013;06;18;Lauantai;53;45;98;11;8;19
96;29.06.2013;2013;06;19;Lauantai;44;37;81;4;1;5
96;29.06.2013;2013;06;20;Lauantai;33;45;78;5;3;8
96;29.06.2013;2013;06;21;Lauantai;29;39;68;4;4;8
96;29.06.2013;2013;06;22;Lauantai;21;11;32;1;2;3
96;29.06.2013;2013;06;23;Lauantai;16;15;31;1;1;2
96;30.06.2013;2013;06;00;Sunnuntai;25;11;36;1;2;3
96;30.06.2013;2013;06;01;Sunnuntai;21;6;27;1;0;1
96;30.06.2013;2013;06;02;Sunnuntai;14;4;18;0;0;0
96;30.06.2013;2013;06;03;Sunnuntai;28;1;29;3;0;3
96;30.06.2013;2013;06;04;Sunnuntai;5;5;10;1;0;1
96;30.06.2013;2013;06;05;Sunnuntai;6;1;7;1;0;1
96;30.06.2013;2013;06;06;Sunnuntai;9;5;14;0;0;0
96;30.06.2013;2013;06;07;Sunnuntai;4;12;16;3;2;5
96;30.06.2013;2013;06;08;Sunnuntai;0;4;4;1;1;2
96;30.06.2013;2013;06;09;Sunnuntai;2;0;2;1;2;3
96;30.06.2013;2013;06;10;Sunnuntai;4;3;7;0;0;0
96;30.06.2013;2013;06;11;Sunnuntai;10;18;28;2;1;3
96;30.06.2013;2013;06;12;Sunnuntai;20;42;62;6;6;12
96;30.06.2013;2013;06;13;Sunnuntai;31;38;69;6;9;15
96;30.06.2013;2013;06;14;Sunnuntai;40;36;76;6;9;15
96;30.06.2013;2013;06;15;Sunnuntai;29;42;71;4;11;15
96;30.06.2013;2013;06;16;Sunnuntai;41;48;89;7;7;14
96;30.06.2013;2013;06;17;Sunnuntai;34;47;81;4;7;11
96;30.06.2013;2013;06;18;Sunnuntai;35;32;67;11;7;18
96;30.06.2013;2013;06;19;Sunnuntai;38;28;66;6;7;13
96;30.06.2013;2013;06;20;Sunnuntai;32;22;54;1;6;7
96;30.06.2013;2013;06;21;Sunnuntai;20;16;36;7;6;13
96;30.06.2013;2013;06;22;Sunnuntai;9;22;31;1;2;3
96;30.06.2013;2013;06;23;Sunnuntai;9;9;18;2;1;3
96;01.07.2013;2013;07;00;Maanantai;10;4;14;0;2;2
96;01.07.2013;2013;07;01;Maanantai;1;0;1;0;0;0
96;01.07.2013;2013;07;02;Maanantai;4;3;7;0;0;0
96;01.07.2013;2013;07;03;Maanantai;4;3;7;0;0;0
96;01.07.2013;2013;07;04;Maanantai;1;1;2;1;0;1
96;01.07.2013;2013;07;05;Maanantai;6;3;9;0;0;0
96;01.07.2013;2013;07;06;Maanantai;38;36;74;1;1;2
96;01.07.2013;2013;07;07;Maanantai;66;54;120;5;1;6
96;01.07.2013;2013;07;08;Maanantai;21;42;63;2;3;5
96;01.07.2013;2013;07;09;Maanantai;25;46;71;2;5;7
96;01.07.2013;2013;07;10;Maanantai;25;26;51;5;4;9
96;01.07.2013;2013;07;11;Maanantai;15;10;25;2;3;5
96;01.07.2013;2013;07;12;Maanantai;36;27;63;5;5;10
96;01.07.2013;2013;07;13;Maanantai;40;43;83;4;5;9
96;01.07.2013;2013;07;14;Maanantai;23;52;75;1;8;9
96;01.07.2013;2013;07;15;Maanantai;51;92;143;10;8;18
96;01.07.2013;2013;07;16;Maanantai;47;71;118;2;3;5
96;01.07.2013;2013;07;17;Maanantai;46;44;90;3;4;7
96;01.07.2013;2013;07;18;Maanantai;39;18;57;0;4;4
96;01.07.2013;2013;07;19;Maanantai;32;17;49;7;12;19
96;01.07.2013;2013;07;20;Maanantai;22;22;44;9;9;18
96;01.07.2013;2013;07;21;Maanantai;18;22;40;1;4;5
96;01.07.2013;2013;07;22;Maanantai;6;10;16;1;3;4
96;01.07.2013;2013;07;23;Maanantai;1;3;4;0;1;1
96;02.07.2013;2013;07;00;Tiistai;1;0;1;0;0;0
96;02.07.2013;2013;07;01;Tiistai;0;2;2;0;0;0
96;02.07.2013;2013;07;02;Tiistai;2;1;3;0;0;0
96;02.07.2013;2013;07;03;Tiistai;1;1;2;0;0;0
96;02.07.2013;2013;07;04;Tiistai;0;2;2;1;0;1
96;02.07.2013;2013;07;05;Tiistai;5;7;12;1;0;1
96;02.07.2013;2013;07;06;Tiistai;42;36;78;5;1;6
96;02.07.2013;2013;07;07;Tiistai;75;79;154;8;4;12
96;02.07.2013;2013;07;08;Tiistai;32;58;90;4;2;6
96;02.07.2013;2013;07;09;Tiistai;31;51;82;1;3;4
96;02.07.2013;2013;07;10;Tiistai;31;59;90;4;5;9
96;02.07.2013;2013;07;11;Tiistai;36;44;80;1;3;4
96;02.07.2013;2013;07;12;Tiistai;30;54;84;4;5;9
96;02.07.2013;2013;07;13;Tiistai;45;54;99;2;3;5
96;02.07.2013;2013;07;14;Tiistai;50;55;105;1;7;8
96;02.07.2013;2013;07;15;Tiistai;64;130;194;6;8;14
96;02.07.2013;2013;07;16;Tiistai;59;75;134;3;11;14
96;02.07.2013;2013;07;17;Tiistai;38;37;75;5;6;11
96;02.07.2013;2013;07;18;Tiistai;34;23;57;2;4;6
96;02.07.2013;2013;07;19;Tiistai;23;22;45;5;2;7
96;02.07.2013;2013;07;20;Tiistai;26;18;44;4;6;10
96;02.07.2013;2013;07;21;Tiistai;18;34;52;8;7;15
96;02.07.2013;2013;07;22;Tiistai;16;11;27;2;3;5
96;02.07.2013;2013;07;23;Tiistai;9;6;15;2;1;3
96;03.07.2013;2013;07;00;Keskiviikko;15;3;18;1;3;4
96;03.07.2013;2013;07;01;Keskiviikko;5;2;7;1;1;2
96;03.07.2013;2013;07;02;Keskiviikko;1;5;6;0;1;1
96;03.07.2013;2013;07;03;Keskiviikko;2;1;3;0;0;0
96;03.07.2013;2013;07;04;Keskiviikko;6;3;9;2;0;2
96;03.07.2013;2013;07;05;Keskiviikko;8;8;16;0;0;0
96;03.07.2013;2013;07;06;Keskiviikko;51;53;104;1;6;7
96;03.07.2013;2013;07;07;Keskiviikko;68;83;151;6;2;8
96;03.07.2013;2013;07;08;Keskiviikko;35;73;108;4;12;16
96;03.07.2013;2013;07;09;Keskiviikko;36;74;110;9;4;13
96;03.07.2013;2013;07;10;Keskiviikko;36;59;95;7;3;10
96;03.07.2013;2013;07;11;Keskiviikko;34;45;79;6;10;16
96;03.07.2013;2013;07;12;Keskiviikko;41;55;96;2;3;5
96;03.07.2013;2013;07;13;Keskiviikko;52;67;119;5;6;11
96;03.07.2013;2013;07;14;Keskiviikko;47;52;99;7;4;11
96;03.07.2013;2013;07;15;Keskiviikko;67;128;195;2;8;10
96;03.07.2013;2013;07;16;Keskiviikko;70;95;165;7;13;20
96;03.07.2013;2013;07;17;Keskiviikko;54;38;92;5;4;9
96;03.07.2013;2013;07;18;Keskiviikko;63;51;114;6;6;12
96;03.07.2013;2013;07;19;Keskiviikko;42;37;79;10;9;19
96;03.07.2013;2013;07;20;Keskiviikko;46;33;79;8;2;10
96;03.07.2013;2013;07;21;Keskiviikko;36;46;82;4;7;11
96;03.07.2013;2013;07;22;Keskiviikko;9;10;19;0;2;2
96;03.07.2013;2013;07;23;Keskiviikko;13;5;18;0;1;1
96;04.07.2013;2013;07;00;Torstai;9;3;12;0;0;0
96;04.07.2013;2013;07;01;Torstai;3;1;4;1;0;1
96;04.07.2013;2013;07;02;Torstai;0;4;4;0;0;0
96;04.07.2013;2013;07;03;Torstai;6;1;7;0;0;0
96;04.07.2013;2013;07;04;Torstai;3;2;5;0;0;0
96;04.07.2013;2013;07;05;Torstai;11;5;16;0;0;0
96;04.07.2013;2013;07;06;Torstai;60;42;102;2;3;5
96;04.07.2013;2013;07;07;Torstai;80;82;162;7;5;12
96;04.07.2013;2013;07;08;Torstai;34;62;96;6;4;10
96;04.07.2013;2013;07;09;Torstai;30;58;88;5;6;11
96;04.07.2013;2013;07;10;Torstai;31;44;75;14;7;21
96;04.07.2013;2013;07;11;Torstai;40;57;97;41;12;53
96;04.07.2013;2013;07;12;Torstai;63;84;147;16;12;28
96;04.07.2013;2013;07;13;Torstai;89;63;152;8;5;13
96;04.07.2013;2013;07;14;Torstai;88;91;179;3;9;12
96;04.07.2013;2013;07;15;Torstai;89;162;251;7;13;20
96;04.07.2013;2013;07;16;Torstai;95;112;207;8;6;14
96;04.07.2013;2013;07;17;Torstai;78;60;138;2;6;8
96;04.07.2013;2013;07;18;Torstai;59;26;85;6;11;17
96;04.07.2013;2013;07;19;Torstai;37;30;67;10;7;17
96;04.07.2013;2013;07;20;Torstai;48;23;71;4;7;11
96;04.07.2013;2013;07;21;Torstai;28;31;59;4;6;10
96;04.07.2013;2013;07;22;Torstai;9;13;22;2;2;4
96;04.07.2013;2013;07;23;Torstai;10;5;15;2;2;4
96;05.07.2013;2013;07;00;Perjantai;6;2;8;1;0;1
96;05.07.2013;2013;07;01;Perjantai;1;0;1;0;0;0
96;05.07.2013;2013;07;02;Perjantai;1;0;1;0;0;0
96;05.07.2013;2013;07;03;Perjantai;5;0;5;0;1;1
96;05.07.2013;2013;07;04;Perjantai;8;6;14;0;0;0
96;05.07.2013;2013;07;05;Perjantai;6;8;14;0;0;0
96;05.07.2013;2013;07;06;Perjantai;52;54;106;3;1;4
96;05.07.2013;2013;07;07;Perjantai;97;76;173;9;3;12
96;05.07.2013;2013;07;08;Perjantai;25;45;70;2;7;9
96;05.07.2013;2013;07;09;Perjantai;28;55;83;4;2;6
96;05.07.2013;2013;07;10;Perjantai;33;55;88;6;5;11
96;05.07.2013;2013;07;11;Perjantai;46;76;122;37;3;40
96;05.07.2013;2013;07;12;Perjantai;72;100;172;6;3;9
96;05.07.2013;2013;07;13;Perjantai;64;98;162;3;10;13
96;05.07.2013;2013;07;14;Perjantai;57;107;164;6;9;15
96;05.07.2013;2013;07;15;Perjantai;90;123;213;7;11;18
96;05.07.2013;2013;07;16;Perjantai;81;72;153;6;4;10
96;05.07.2013;2013;07;17;Perjantai;65;59;124;6;5;11
96;05.07.2013;2013;07;18;Perjantai;40;47;87;12;0;12
96;05.07.2013;2013;07;19;Perjantai;38;59;97;7;3;10
96;05.07.2013;2013;07;20;Perjantai;51;45;96;7;8;15
96;05.07.2013;2013;07;21;Perjantai;40;48;88;4;7;11
96;05.07.2013;2013;07;22;Perjantai;17;29;46;1;4;5
96;05.07.2013;2013;07;23;Perjantai;22;13;35;0;5;5
96;06.07.2013;2013;07;00;Lauantai;13;8;21;0;0;0
96;06.07.2013;2013;07;01;Lauantai;23;6;29;4;0;4
96;06.07.2013;2013;07;02;Lauantai;18;5;23;3;1;4
96;06.07.2013;2013;07;03;Lauantai;12;4;16;1;0;1
96;06.07.2013;2013;07;04;Lauantai;9;0;9;2;1;3
96;06.07.2013;2013;07;05;Lauantai;3;5;8;0;1;1
96;06.07.2013;2013;07;06;Lauantai;21;13;34;6;1;7
96;06.07.2013;2013;07;07;Lauantai;5;16;21;1;2;3
96;06.07.2013;2013;07;08;Lauantai;7;18;25;4;5;9
96;06.07.2013;2013;07;09;Lauantai;15;35;50;2;3;5
96;06.07.2013;2013;07;10;Lauantai;21;28;49;3;5;8
96;06.07.2013;2013;07;11;Lauantai;24;44;68;3;5;8
96;06.07.2013;2013;07;12;Lauantai;36;55;91;6;1;7
96;06.07.2013;2013;07;13;Lauantai;50;46;96;7;6;13
96;06.07.2013;2013;07;14;Lauantai;40;49;89;1;4;5
96;06.07.2013;2013;07;15;Lauantai;37;64;101;4;11;15
96;06.07.2013;2013;07;16;Lauantai;46;41;87;6;1;7
96;06.07.2013;2013;07;17;Lauantai;65;39;104;18;3;21
96;06.07.2013;2013;07;18;Lauantai;45;39;84;18;5;23
96;06.07.2013;2013;07;19;Lauantai;24;33;57;13;8;21
96;06.07.2013;2013;07;20;Lauantai;41;34;75;8;4;12
96;06.07.2013;2013;07;21;Lauantai;39;62;101;3;2;5
96;06.07.2013;2013;07;22;Lauantai;19;29;48;5;6;11
96;06.07.2013;2013;07;23;Lauantai;17;23;40;1;0;1
96;07.07.2013;2013;07;00;Sunnuntai;19;7;26;1;2;3
96;07.07.2013;2013;07;01;Sunnuntai;10;8;18;2;0;2
96;07.07.2013;2013;07;02;Sunnuntai;19;2;21;2;0;2
96;07.07.2013;2013;07;03;Sunnuntai;32;8;40;2;0;2
96;07.07.2013;2013;07;04;Sunnuntai;18;4;22;2;2;4
96;07.07.2013;2013;07;05;Sunnuntai;12;1;13;1;0;1
96;07.07.2013;2013;07;06;Sunnuntai;17;14;31;2;0;2
96;07.07.2013;2013;07;07;Sunnuntai;9;16;25;0;2;2
96;07.07.2013;2013;07;08;Sunnuntai;9;13;22;2;2;4
96;07.07.2013;2013;07;09;Sunnuntai;13;22;35;6;3;9
96;07.07.2013;2013;07;10;Sunnuntai;12;33;45;3;12;15
96;07.07.2013;2013;07;11;Sunnuntai;25;63;88;9;7;16
96;07.07.2013;2013;07;12;Sunnuntai;53;56;109;31;6;37
96;07.07.2013;2013;07;13;Sunnuntai;64;63;127;14;6;20
96;07.07.2013;2013;07;14;Sunnuntai;59;62;121;5;12;17
96;07.07.2013;2013;07;15;Sunnuntai;66;49;115;9;7;16
96;07.07.2013;2013;07;16;Sunnuntai;65;44;109;7;6;13
96;07.07.2013;2013;07;17;Sunnuntai;61;47;108;13;3;16
96;07.07.2013;2013;07;18;Sunnuntai;76;40;116;15;6;21
96;07.07.2013;2013;07;19;Sunnuntai;44;57;101;16;9;25
96;07.07.2013;2013;07;20;Sunnuntai;32;59;91;7;6;13
96;07.07.2013;2013;07;21;Sunnuntai;25;38;63;3;12;15
96;07.07.2013;2013;07;22;Sunnuntai;19;16;35;2;4;6
96;07.07.2013;2013;07;23;Sunnuntai;3;2;5;1;0;1
96;08.07.2013;2013;07;00;Maanantai;11;6;17;2;0;2
96;08.07.2013;2013;07;01;Maanantai;0;1;1;0;0;0
96;08.07.2013;2013;07;02;Maanantai;3;1;4;0;1;1
96;08.07.2013;2013;07;03;Maanantai;9;0;9;0;1;1
96;08.07.2013;2013;07;04;Maanantai;2;2;4;1;0;1
96;08.07.2013;2013;07;05;Maanantai;5;13;18;1;0;1
96;08.07.2013;2013;07;06;Maanantai;45;43;88;2;0;2
96;08.07.2013;2013;07;07;Maanantai;89;81;170;7;3;10
96;08.07.2013;2013;07;08;Maanantai;36;61;97;8;5;13
96;08.07.2013;2013;07;09;Maanantai;33;59;92;16;6;22
96;08.07.2013;2013;07;10;Maanantai;32;54;86;4;11;15
96;08.07.2013;2013;07;11;Maanantai;36;56;92;7;10;17
96;08.07.2013;2013;07;12;Maanantai;53;49;102;9;13;22
96;08.07.2013;2013;07;13;Maanantai;56;68;124;9;10;19
96;08.07.2013;2013;07;14;Maanantai;71;70;141;5;9;14
96;08.07.2013;2013;07;15;Maanantai;95;151;246;7;14;21
96;08.07.2013;2013;07;16;Maanantai;101;106;207;3;5;8
96;08.07.2013;2013;07;17;Maanantai;74;59;133;11;7;18
96;08.07.2013;2013;07;18;Maanantai;61;49;110;10;8;18
96;08.07.2013;2013;07;19;Maanantai;47;29;76;6;5;11
96;08.07.2013;2013;07;20;Maanantai;57;25;82;12;7;19
96;08.07.2013;2013;07;21;Maanantai;22;35;57;7;9;16
96;08.07.2013;2013;07;22;Maanantai;13;9;22;2;1;3
96;08.07.2013;2013;07;23;Maanantai;8;3;11;1;1;2
96;09.07.2013;2013;07;00;Tiistai;2;0;2;0;0;0
96;09.07.2013;2013;07;01;Tiistai;7;3;10;0;0;0
96;09.07.2013;2013;07;02;Tiistai;2;4;6;0;0;0
96;09.07.2013;2013;07;03;Tiistai;3;1;4;1;1;2
96;09.07.2013;2013;07;04;Tiistai;3;1;4;1;0;1
96;09.07.2013;2013;07;05;Tiistai;9;9;18;0;0;0
96;09.07.2013;2013;07;06;Tiistai;53;45;98;2;2;4
96;09.07.2013;2013;07;07;Tiistai;74;71;145;10;5;15
96;09.07.2013;2013;07;08;Tiistai;35;63;98;3;4;7
96;09.07.2013;2013;07;09;Tiistai;29;45;74;9;4;13
96;09.07.2013;2013;07;10;Tiistai;28;49;77;5;5;10
96;09.07.2013;2013;07;11;Tiistai;38;57;95;7;6;13
96;09.07.2013;2013;07;12;Tiistai;41;52;93;4;3;7
96;09.07.2013;2013;07;13;Tiistai;44;41;85;5;3;8
96;09.07.2013;2013;07;14;Tiistai;34;67;101;4;4;8
96;09.07.2013;2013;07;15;Tiistai;72;132;204;1;8;9
96;09.07.2013;2013;07;16;Tiistai;59;79;138;2;1;3
96;09.07.2013;2013;07;17;Tiistai;48;52;100;6;2;8
96;09.07.2013;2013;07;18;Tiistai;46;37;83;7;3;10
96;09.07.2013;2013;07;19;Tiistai;38;37;75;5;10;15
96;09.07.2013;2013;07;20;Tiistai;46;26;72;8;3;11
96;09.07.2013;2013;07;21;Tiistai;20;25;45;7;7;14
96;09.07.2013;2013;07;22;Tiistai;19;8;27;2;2;4
96;09.07.2013;2013;07;23;Tiistai;9;0;9;1;1;2
96;10.07.2013;2013;07;00;Keskiviikko;6;5;11;2;1;3
96;10.07.2013;2013;07;01;Keskiviikko;2;1;3;0;0;0
96;10.07.2013;2013;07;02;Keskiviikko;1;0;1;0;0;0
96;10.07.2013;2013;07;03;Keskiviikko;2;4;6;0;0;0
96;10.07.2013;2013;07;04;Keskiviikko;3;3;6;1;0;1
96;10.07.2013;2013;07;05;Keskiviikko;9;9;18;0;0;0
96;10.07.2013;2013;07;06;Keskiviikko;43;40;83;5;2;7
96;10.07.2013;2013;07;07;Keskiviikko;62;67;129;7;2;9
96;10.07.2013;2013;07;08;Keskiviikko;27;57;84;1;2;3
96;10.07.2013;2013;07;09;Keskiviikko;22;42;64;4;3;7
96;10.07.2013;2013;07;10;Keskiviikko;28;46;74;5;7;12
96;10.07.2013;2013;07;11;Keskiviikko;30;44;74;7;10;17
96;10.07.2013;2013;07;12;Keskiviikko;52;46;98;3;8;11
96;10.07.2013;2013;07;13;Keskiviikko;54;67;121;5;5;10
96;10.07.2013;2013;07;14;Keskiviikko;45;76;121;6;4;10
96;10.07.2013;2013;07;15;Keskiviikko;71;154;225;6;12;18
96;10.07.2013;2013;07;16;Keskiviikko;93;82;175;6;9;15
96;10.07.2013;2013;07;17;Keskiviikko;70;71;141;11;7;18
96;10.07.2013;2013;07;18;Keskiviikko;55;42;97;6;6;12
96;10.07.2013;2013;07;19;Keskiviikko;54;48;102;8;8;16
96;10.07.2013;2013;07;20;Keskiviikko;39;41;80;6;12;18
96;10.07.2013;2013;07;21;Keskiviikko;31;56;87;3;5;8
96;10.07.2013;2013;07;22;Keskiviikko;5;17;22;0;4;4
96;10.07.2013;2013;07;23;Keskiviikko;11;16;27;1;2;3
96;11.07.2013;2013;07;00;Torstai;30;7;37;1;0;1
96;11.07.2013;2013;07;01;Torstai;12;0;12;0;0;0
96;11.07.2013;2013;07;02;Torstai;12;1;13;0;0;0
96;11.07.2013;2013;07;03;Torstai;7;3;10;0;0;0
96;11.07.2013;2013;07;04;Torstai;2;2;4;0;1;1
96;11.07.2013;2013;07;05;Torstai;8;7;15;0;0;0
96;11.07.2013;2013;07;06;Torstai;57;41;98;3;0;3
96;11.07.2013;2013;07;07;Torstai;78;67;145;8;1;9
96;11.07.2013;2013;07;08;Torstai;32;65;97;3;2;5
96;11.07.2013;2013;07;09;Torstai;33;48;81;4;3;7
96;11.07.2013;2013;07;10;Torstai;31;49;80;8;4;12
96;11.07.2013;2013;07;11;Torstai;38;58;96;3;6;9
96;11.07.2013;2013;07;12;Torstai;49;53;102;7;9;16
96;11.07.2013;2013;07;13;Torstai;57;71;128;6;10;16
96;11.07.2013;2013;07;14;Torstai;65;70;135;2;5;7
96;11.07.2013;2013;07;15;Torstai;77;171;248;7;19;26
96;11.07.2013;2013;07;16;Torstai;97;111;208;4;9;13
96;11.07.2013;2013;07;17;Torstai;82;81;163;5;3;8
96;11.07.2013;2013;07;18;Torstai;65;65;130;14;11;25
96;11.07.2013;2013;07;19;Torstai;68;58;126;16;12;28
96;11.07.2013;2013;07;20;Torstai;66;38;104;6;9;15
96;11.07.2013;2013;07;21;Torstai;36;38;74;9;10;19
96;11.07.2013;2013;07;22;Torstai;16;20;36;5;1;6
96;11.07.2013;2013;07;23;Torstai;10;8;18;1;0;1
96;12.07.2013;2013;07;00;Perjantai;24;5;29;1;1;2
96;12.07.2013;2013;07;01;Perjantai;11;1;12;0;1;1
96;12.07.2013;2013;07;02;Perjantai;13;2;15;1;0;1
96;12.07.2013;2013;07;03;Perjantai;11;2;13;3;1;4
96;12.07.2013;2013;07;04;Perjantai;6;6;12;0;1;1
96;12.07.2013;2013;07;05;Perjantai;7;5;12;0;0;0
96;12.07.2013;2013;07;06;Perjantai;53;34;87;6;1;7
96;12.07.2013;2013;07;07;Perjantai;69;71;140;5;4;9
96;12.07.2013;2013;07;08;Perjantai;28;51;79;5;7;12
96;12.07.2013;2013;07;09;Perjantai;24;54;78;2;5;7
96;12.07.2013;2013;07;10;Perjantai;27;44;71;6;11;17
96;12.07.2013;2013;07;11;Perjantai;46;46;92;2;5;7
96;12.07.2013;2013;07;12;Perjantai;55;60;115;8;7;15
96;12.07.2013;2013;07;13;Perjantai;67;91;158;6;5;11
96;12.07.2013;2013;07;14;Perjantai;74;98;172;7;15;22
96;12.07.2013;2013;07;15;Perjantai;80;99;179;2;12;14
96;12.07.2013;2013;07;16;Perjantai;67;76;143;5;9;14
96;12.07.2013;2013;07;17;Perjantai;54;45;99;6;9;15
96;12.07.2013;2013;07;18;Perjantai;59;48;107;4;4;8
96;12.07.2013;2013;07;19;Perjantai;31;55;86;9;8;17
96;12.07.2013;2013;07;20;Perjantai;44;36;80;10;14;24
96;12.07.2013;2013;07;21;Perjantai;38;57;95;5;4;9
96;12.07.2013;2013;07;22;Perjantai;21;36;57;4;9;13
96;12.07.2013;2013;07;23;Perjantai;21;13;34;2;5;7
96;13.07.2013;2013;07;00;Lauantai;32;7;39;0;0;0
96;13.07.2013;2013;07;01;Lauantai;18;4;22;1;0;1
96;13.07.2013;2013;07;02;Lauantai;19;1;20;2;0;2
96;13.07.2013;2013;07;03;Lauantai;26;4;30;2;0;2
96;13.07.2013;2013;07;04;Lauantai;15;5;20;3;1;4
96;13.07.2013;2013;07;05;Lauantai;8;2;10;0;2;2
96;13.07.2013;2013;07;06;Lauantai;20;10;30;1;0;1
96;13.07.2013;2013;07;07;Lauantai;10;13;23;2;5;7
96;13.07.2013;2013;07;08;Lauantai;5;10;15;0;1;1
96;13.07.2013;2013;07;09;Lauantai;6;20;26;1;4;5
96;13.07.2013;2013;07;10;Lauantai;20;34;54;4;4;8
96;13.07.2013;2013;07;11;Lauantai;22;23;45;2;4;6
96;13.07.2013;2013;07;12;Lauantai;27;34;61;5;4;9
96;13.07.2013;2013;07;13;Lauantai;29;39;68;3;8;11
96;13.07.2013;2013;07;14;Lauantai;46;53;99;2;6;8
96;13.07.2013;2013;07;15;Lauantai;28;37;65;4;8;12
96;13.07.2013;2013;07;16;Lauantai;42;38;80;4;5;9
96;13.07.2013;2013;07;17;Lauantai;33;40;73;5;5;10
96;13.07.2013;2013;07;18;Lauantai;32;41;73;11;9;20
96;13.07.2013;2013;07;19;Lauantai;21;46;67;7;9;16
96;13.07.2013;2013;07;20;Lauantai;22;51;73;4;4;8
96;13.07.2013;2013;07;21;Lauantai;31;45;76;5;5;10
96;13.07.2013;2013;07;22;Lauantai;18;26;44;1;2;3
96;13.07.2013;2013;07;23;Lauantai;21;22;43;2;1;3
96;14.07.2013;2013;07;00;Sunnuntai;23;16;39;2;1;3
96;14.07.2013;2013;07;01;Sunnuntai;30;12;42;1;2;3
96;14.07.2013;2013;07;02;Sunnuntai;30;4;34;2;0;2
96;14.07.2013;2013;07;03;Sunnuntai;19;2;21;2;0;2
96;14.07.2013;2013;07;04;Sunnuntai;29;1;30;4;0;4
96;14.07.2013;2013;07;05;Sunnuntai;6;5;11;3;2;5
96;14.07.2013;2013;07;06;Sunnuntai;9;7;16;0;0;0
96;14.07.2013;2013;07;07;Sunnuntai;9;11;20;1;3;4
96;14.07.2013;2013;07;08;Sunnuntai;2;6;8;3;3;6
96;14.07.2013;2013;07;09;Sunnuntai;6;4;10;0;3;3
96;14.07.2013;2013;07;10;Sunnuntai;13;18;31;6;6;12
96;14.07.2013;2013;07;11;Sunnuntai;11;29;40;6;3;9
96;14.07.2013;2013;07;12;Sunnuntai;47;50;97;5;7;12
96;14.07.2013;2013;07;13;Sunnuntai;46;50;96;3;5;8
96;14.07.2013;2013;07;14;Sunnuntai;46;48;94;3;8;11
96;14.07.2013;2013;07;15;Sunnuntai;47;47;94;2;2;4
96;14.07.2013;2013;07;16;Sunnuntai;49;48;97;8;8;16
96;14.07.2013;2013;07;17;Sunnuntai;46;41;87;5;2;7
96;14.07.2013;2013;07;18;Sunnuntai;58;27;85;20;10;30
96;14.07.2013;2013;07;19;Sunnuntai;38;37;75;10;8;18
96;14.07.2013;2013;07;20;Sunnuntai;26;33;59;14;8;22
96;14.07.2013;2013;07;21;Sunnuntai;24;58;82;4;7;11
96;14.07.2013;2013;07;22;Sunnuntai;18;22;40;5;5;10
96;14.07.2013;2013;07;23;Sunnuntai;14;7;21;2;2;4
96;15.07.2013;2013;07;00;Maanantai;4;3;7;0;0;0
96;15.07.2013;2013;07;01;Maanantai;7;2;9;1;1;2
96;15.07.2013;2013;07;02;Maanantai;1;2;3;0;0;0
96;15.07.2013;2013;07;03;Maanantai;4;1;5;0;0;0
96;15.07.2013;2013;07;04;Maanantai;5;1;6;0;1;1
96;15.07.2013;2013;07;05;Maanantai;4;11;15;0;0;0
96;15.07.2013;2013;07;06;Maanantai;31;32;63;1;0;1
96;15.07.2013;2013;07;07;Maanantai;70;58;128;5;4;9
96;15.07.2013;2013;07;08;Maanantai;44;61;105;8;5;13
96;15.07.2013;2013;07;09;Maanantai;17;51;68;4;9;13
96;15.07.2013;2013;07;10;Maanantai;29;78;107;4;8;12
96;15.07.2013;2013;07;11;Maanantai;34;69;103;4;8;12
96;15.07.2013;2013;07;12;Maanantai;63;59;122;9;8;17
96;15.07.2013;2013;07;13;Maanantai;73;66;139;4;2;6
96;15.07.2013;2013;07;14;Maanantai;64;45;109;2;4;6
96;15.07.2013;2013;07;15;Maanantai;57;114;171;4;6;10
96;15.07.2013;2013;07;16;Maanantai;77;91;168;1;11;12
96;15.07.2013;2013;07;17;Maanantai;58;42;100;4;10;14
96;15.07.2013;2013;07;18;Maanantai;49;24;73;2;1;3
96;15.07.2013;2013;07;19;Maanantai;28;16;44;10;6;16
96;15.07.2013;2013;07;20;Maanantai;35;16;51;7;6;13
96;15.07.2013;2013;07;21;Maanantai;20;19;39;10;10;20
96;15.07.2013;2013;07;22;Maanantai;10;10;20;0;0;0
96;15.07.2013;2013;07;23;Maanantai;3;0;3;1;2;3
96;16.07.2013;2013;07;00;Tiistai;3;1;4;1;1;2
96;16.07.2013;2013;07;01;Tiistai;1;0;1;0;0;0
96;16.07.2013;2013;07;02;Tiistai;1;0;1;0;0;0
96;16.07.2013;2013;07;03;Tiistai;0;1;1;0;0;0
96;16.07.2013;2013;07;04;Tiistai;1;0;1;0;1;1
96;16.07.2013;2013;07;05;Tiistai;8;6;14;0;0;0
96;16.07.2013;2013;07;06;Tiistai;36;37;73;5;2;7
96;16.07.2013;2013;07;07;Tiistai;59;60;119;3;3;6
96;16.07.2013;2013;07;08;Tiistai;21;43;64;4;4;8
96;16.07.2013;2013;07;09;Tiistai;22;31;53;1;3;4
96;16.07.2013;2013;07;10;Tiistai;20;37;57;3;9;12
96;16.07.2013;2013;07;11;Tiistai;21;35;56;4;4;8
96;16.07.2013;2013;07;12;Tiistai;34;65;99;5;2;7
96;16.07.2013;2013;07;13;Tiistai;38;55;93;4;5;9
96;16.07.2013;2013;07;14;Tiistai;52;63;115;4;8;12
96;16.07.2013;2013;07;15;Tiistai;75;135;210;2;10;12
96;16.07.2013;2013;07;16;Tiistai;93;65;158;7;9;16
96;16.07.2013;2013;07;17;Tiistai;63;73;136;7;11;18
96;16.07.2013;2013;07;18;Tiistai;44;59;103;10;17;27
96;16.07.2013;2013;07;19;Tiistai;67;40;107;7;15;22
96;16.07.2013;2013;07;20;Tiistai;49;34;83;9;9;18
96;16.07.2013;2013;07;21;Tiistai;41;22;63;7;8;15
96;16.07.2013;2013;07;22;Tiistai;18;13;31;1;0;1
96;16.07.2013;2013;07;23;Tiistai;15;4;19;0;2;2
96;17.07.2013;2013;07;00;Keskiviikko;7;5;12;3;1;4
96;17.07.2013;2013;07;01;Keskiviikko;6;1;7;1;0;1
96;17.07.2013;2013;07;02;Keskiviikko;3;1;4;0;0;0
96;17.07.2013;2013;07;03;Keskiviikko;2;1;3;0;0;0
96;17.07.2013;2013;07;04;Keskiviikko;4;0;4;1;0;1
96;17.07.2013;2013;07;05;Keskiviikko;4;5;9;0;2;2
96;17.07.2013;2013;07;06;Keskiviikko;46;25;71;2;0;2
96;17.07.2013;2013;07;07;Keskiviikko;47;45;92;6;0;6
96;17.07.2013;2013;07;08;Keskiviikko;24;47;71;7;2;9
96;17.07.2013;2013;07;09;Keskiviikko;10;28;38;1;7;8
96;17.07.2013;2013;07;10;Keskiviikko;17;23;40;2;3;5
96;17.07.2013;2013;07;11;Keskiviikko;14;40;54;4;1;5
96;17.07.2013;2013;07;12;Keskiviikko;35;44;79;3;5;8
96;17.07.2013;2013;07;13;Keskiviikko;46;51;97;5;3;8
96;17.07.2013;2013;07;14;Keskiviikko;28;68;96;3;1;4
96;17.07.2013;2013;07;15;Keskiviikko;63;124;187;6;4;10
96;17.07.2013;2013;07;16;Keskiviikko;48;78;126;3;12;15
96;17.07.2013;2013;07;17;Keskiviikko;40;64;104;4;7;11
96;17.07.2013;2013;07;18;Keskiviikko;52;40;92;12;7;19
96;17.07.2013;2013;07;19;Keskiviikko;46;24;70;12;10;22
96;17.07.2013;2013;07;20;Keskiviikko;48;40;88;3;9;12
96;17.07.2013;2013;07;21;Keskiviikko;33;46;79;3;12;15
96;17.07.2013;2013;07;22;Keskiviikko;17;15;32;3;2;5
96;17.07.2013;2013;07;23;Keskiviikko;14;5;19;1;0;1
96;18.07.2013;2013;07;00;Torstai;9;4;13;1;0;1
96;18.07.2013;2013;07;01;Torstai;6;1;7;0;1;1
96;18.07.2013;2013;07;02;Torstai;4;0;4;1;1;2
96;18.07.2013;2013;07;03;Torstai;7;5;12;1;0;1
96;18.07.2013;2013;07;04;Torstai;3;3;6;1;2;3
96;18.07.2013;2013;07;05;Torstai;10;8;18;0;0;0
96;18.07.2013;2013;07;06;Torstai;46;28;74;3;0;3
96;18.07.2013;2013;07;07;Torstai;70;61;131;3;3;6
96;18.07.2013;2013;07;08;Torstai;23;62;85;1;3;4
96;18.07.2013;2013;07;09;Torstai;20;49;69;5;1;6
96;18.07.2013;2013;07;10;Torstai;21;44;65;7;14;21
96;18.07.2013;2013;07;11;Torstai;26;48;74;7;8;15
96;18.07.2013;2013;07;12;Torstai;57;58;115;5;7;12
96;18.07.2013;2013;07;13;Torstai;46;80;126;3;7;10
96;18.07.2013;2013;07;14;Torstai;45;65;110;1;5;6
96;18.07.2013;2013;07;15;Torstai;75;135;210;4;9;13
96;18.07.2013;2013;07;16;Torstai;57;90;147;7;6;13
96;18.07.2013;2013;07;17;Torstai;54;53;107;10;10;20
96;18.07.2013;2013;07;18;Torstai;55;45;100;7;8;15
96;18.07.2013;2013;07;19;Torstai;38;28;66;4;6;10
96;18.07.2013;2013;07;20;Torstai;37;19;56;10;3;13
96;18.07.2013;2013;07;21;Torstai;26;33;59;2;7;9
96;18.07.2013;2013;07;22;Torstai;6;7;13;1;5;6
96;18.07.2013;2013;07;23;Torstai;10;2;12;1;1;2
96;19.07.2013;2013;07;00;Perjantai;4;2;6;1;0;1
96;19.07.2013;2013;07;01;Perjantai;6;3;9;2;1;3
96;19.07.2013;2013;07;02;Perjantai;3;1;4;1;0;1
96;19.07.2013;2013;07;03;Perjantai;3;1;4;0;1;1
96;19.07.2013;2013;07;04;Perjantai;6;0;6;0;0;0
96;19.07.2013;2013;07;05;Perjantai;9;1;10;0;0;0
96;19.07.2013;2013;07;06;Perjantai;40;32;72;2;4;6
96;19.07.2013;2013;07;07;Perjantai;56;52;108;3;3;6
96;19.07.2013;2013;07;08;Perjantai;17;43;60;4;1;5
96;19.07.2013;2013;07;09;Perjantai;12;37;49;3;6;9
96;19.07.2013;2013;07;10;Perjantai;22;48;70;2;6;8
96;19.07.2013;2013;07;11;Perjantai;23;46;69;5;7;12
96;19.07.2013;2013;07;12;Perjantai;43;38;81;4;7;11
96;19.07.2013;2013;07;13;Perjantai;51;59;110;4;9;13
96;19.07.2013;2013;07;14;Perjantai;51;93;144;7;8;15
96;19.07.2013;2013;07;15;Perjantai;57;112;169;7;8;15
96;19.07.2013;2013;07;16;Perjantai;56;51;107;5;9;14
96;19.07.2013;2013;07;17;Perjantai;50;45;95;6;4;10
96;19.07.2013;2013;07;18;Perjantai;41;35;76;10;6;16
96;19.07.2013;2013;07;19;Perjantai;33;34;67;8;7;15
96;19.07.2013;2013;07;20;Perjantai;28;33;61;3;7;10
96;19.07.2013;2013;07;21;Perjantai;22;31;53;2;5;7
96;19.07.2013;2013;07;22;Perjantai;17;12;29;0;2;2
96;19.07.2013;2013;07;23;Perjantai;15;14;29;2;0;2
96;20.07.2013;2013;07;00;Lauantai;10;10;20;1;0;1
96;20.07.2013;2013;07;01;Lauantai;9;1;10;1;0;1
96;20.07.2013;2013;07;02;Lauantai;16;1;17;0;0;0
96;20.07.2013;2013;07;03;Lauantai;18;1;19;0;0;0
96;20.07.2013;2013;07;04;Lauantai;5;4;9;2;1;3
96;20.07.2013;2013;07;05;Lauantai;1;1;2;0;0;0
96;20.07.2013;2013;07;06;Lauantai;22;11;33;2;1;3
96;20.07.2013;2013;07;07;Lauantai;7;9;16;0;2;2
96;20.07.2013;2013;07;08;Lauantai;6;16;22;2;1;3
96;20.07.2013;2013;07;09;Lauantai;19;40;59;4;2;6
96;20.07.2013;2013;07;10;Lauantai;25;54;79;3;8;11
96;20.07.2013;2013;07;11;Lauantai;33;62;95;5;11;16
96;20.07.2013;2013;07;12;Lauantai;56;51;107;9;9;18
96;20.07.2013;2013;07;13;Lauantai;58;54;112;11;9;20
96;20.07.2013;2013;07;14;Lauantai;63;64;127;6;5;11
96;20.07.2013;2013;07;15;Lauantai;62;58;120;14;13;27
96;20.07.2013;2013;07;16;Lauantai;44;33;77;9;6;15
96;20.07.2013;2013;07;17;Lauantai;48;35;83;9;8;17
96;20.07.2013;2013;07;18;Lauantai;30;27;57;10;4;14
96;20.07.2013;2013;07;19;Lauantai;32;26;58;6;9;15
96;20.07.2013;2013;07;20;Lauantai;29;31;60;3;2;5
96;20.07.2013;2013;07;21;Lauantai;27;38;65;1;3;4
96;20.07.2013;2013;07;22;Lauantai;15;16;31;2;1;3
96;20.07.2013;2013;07;23;Lauantai;18;24;42;0;5;5
96;21.07.2013;2013;07;00;Sunnuntai;11;8;19;1;0;1
96;21.07.2013;2013;07;01;Sunnuntai;16;4;20;2;0;2
96;21.07.2013;2013;07;02;Sunnuntai;10;3;13;1;0;1
96;21.07.2013;2013;07;03;Sunnuntai;20;4;24;1;0;1
96;21.07.2013;2013;07;04;Sunnuntai;15;3;18;2;1;3
96;21.07.2013;2013;07;05;Sunnuntai;11;2;13;1;0;1
96;21.07.2013;2013;07;06;Sunnuntai;11;8;19;2;1;3
96;21.07.2013;2013;07;07;Sunnuntai;11;8;19;1;0;1
96;21.07.2013;2013;07;08;Sunnuntai;7;6;13;3;1;4
96;21.07.2013;2013;07;09;Sunnuntai;11;8;19;1;0;1
96;21.07.2013;2013;07;10;Sunnuntai;12;21;33;4;1;5
96;21.07.2013;2013;07;11;Sunnuntai;27;24;51;7;4;11
96;21.07.2013;2013;07;12;Sunnuntai;36;50;86;3;7;10
96;21.07.2013;2013;07;13;Sunnuntai;43;57;100;2;14;16
96;21.07.2013;2013;07;14;Sunnuntai;37;32;69;8;13;21
96;21.07.2013;2013;07;15;Sunnuntai;57;53;110;4;3;7
96;21.07.2013;2013;07;16;Sunnuntai;56;31;87;5;4;9
96;21.07.2013;2013;07;17;Sunnuntai;44;53;97;10;7;17
96;21.07.2013;2013;07;18;Sunnuntai;66;38;104;12;7;19
96;21.07.2013;2013;07;19;Sunnuntai;23;36;59;9;14;23
96;21.07.2013;2013;07;20;Sunnuntai;19;35;54;6;5;11
96;21.07.2013;2013;07;21;Sunnuntai;20;61;81;3;9;12
96;21.07.2013;2013;07;22;Sunnuntai;12;9;21;2;4;6
96;21.07.2013;2013;07;23;Sunnuntai;15;9;24;0;2;2
96;22.07.2013;2013;07;00;Maanantai;8;5;13;1;1;2
96;22.07.2013;2013;07;01;Maanantai;3;0;3;0;0;0
96;22.07.2013;2013;07;02;Maanantai;4;2;6;0;0;0
96;22.07.2013;2013;07;03;Maanantai;2;2;4;0;0;0
96;22.07.2013;2013;07;04;Maanantai;2;4;6;0;1;1
96;22.07.2013;2013;07;05;Maanantai;3;5;8;0;0;0
96;22.07.2013;2013;07;06;Maanantai;48;39;87;5;2;7
96;22.07.2013;2013;07;07;Maanantai;58;58;116;4;0;4
96;22.07.2013;2013;07;08;Maanantai;29;62;91;4;1;5
96;22.07.2013;2013;07;09;Maanantai;22;54;76;3;7;10
96;22.07.2013;2013;07;10;Maanantai;24;48;72;2;9;11
96;22.07.2013;2013;07;11;Maanantai;34;56;90;8;4;12
96;22.07.2013;2013;07;12;Maanantai;36;65;101;8;10;18
96;22.07.2013;2013;07;13;Maanantai;60;52;112;3;5;8
96;22.07.2013;2013;07;14;Maanantai;34;71;105;1;3;4
96;22.07.2013;2013;07;15;Maanantai;52;132;184;1;5;6
96;22.07.2013;2013;07;16;Maanantai;73;105;178;4;10;14
96;22.07.2013;2013;07;17;Maanantai;51;57;108;8;6;14
96;22.07.2013;2013;07;18;Maanantai;54;53;107;14;18;32
96;22.07.2013;2013;07;19;Maanantai;50;53;103;14;14;28
96;22.07.2013;2013;07;20;Maanantai;50;32;82;8;9;17
96;22.07.2013;2013;07;21;Maanantai;32;31;63;2;4;6
96;22.07.2013;2013;07;22;Maanantai;14;7;21;2;1;3
96;22.07.2013;2013;07;23;Maanantai;6;4;10;1;0;1
96;23.07.2013;2013;07;00;Tiistai;4;4;8;0;0;0
96;23.07.2013;2013;07;01;Tiistai;5;0;5;2;1;3
96;23.07.2013;2013;07;02;Tiistai;1;5;6;0;0;0
96;23.07.2013;2013;07;03;Tiistai;0;0;0;0;1;1
96;23.07.2013;2013;07;04;Tiistai;2;1;3;0;0;0
96;23.07.2013;2013;07;05;Tiistai;6;12;18;0;0;0
96;23.07.2013;2013;07;06;Tiistai;55;36;91;3;2;5
96;23.07.2013;2013;07;07;Tiistai;61;67;128;5;3;8
96;23.07.2013;2013;07;08;Tiistai;29;53;82;3;2;5
96;23.07.2013;2013;07;09;Tiistai;23;46;69;4;8;12
96;23.07.2013;2013;07;10;Tiistai;24;60;84;4;6;10
96;23.07.2013;2013;07;11;Tiistai;32;53;85;6;5;11
96;23.07.2013;2013;07;12;Tiistai;65;77;142;7;10;17
96;23.07.2013;2013;07;13;Tiistai;72;77;149;4;7;11
96;23.07.2013;2013;07;14;Tiistai;83;105;188;7;12;19
96;23.07.2013;2013;07;15;Tiistai;96;149;245;10;12;22
96;23.07.2013;2013;07;16;Tiistai;105;107;212;11;14;25
96;23.07.2013;2013;07;17;Tiistai;80;62;142;20;10;30
96;23.07.2013;2013;07;18;Tiistai;78;57;135;28;15;43
96;23.07.2013;2013;07;19;Tiistai;67;63;130;10;6;16
96;23.07.2013;2013;07;20;Tiistai;58;32;90;10;8;18
96;23.07.2013;2013;07;21;Tiistai;39;47;86;5;7;12
96;23.07.2013;2013;07;22;Tiistai;13;19;32;2;2;4
96;23.07.2013;2013;07;23;Tiistai;14;8;22;0;2;2
96;24.07.2013;2013;07;00;Keskiviikko;9;5;14;0;0;0
96;24.07.2013;2013;07;01;Keskiviikko;9;6;15;0;0;0
96;24.07.2013;2013;07;02;Keskiviikko;8;0;8;1;0;1
96;24.07.2013;2013;07;03;Keskiviikko;10;0;10;1;2;3
96;24.07.2013;2013;07;04;Keskiviikko;2;4;6;2;1;3
96;24.07.2013;2013;07;05;Keskiviikko;6;6;12;0;0;0
96;24.07.2013;2013;07;06;Keskiviikko;58;40;98;4;3;7
96;24.07.2013;2013;07;07;Keskiviikko;64;65;129;8;2;10
96;24.07.2013;2013;07;08;Keskiviikko;34;65;99;1;4;5
96;24.07.2013;2013;07;09;Keskiviikko;20;70;90;6;3;9
96;24.07.2013;2013;07;10;Keskiviikko;30;46;76;8;6;14
96;24.07.2013;2013;07;11;Keskiviikko;58;93;151;7;14;21
96;24.07.2013;2013;07;12;Keskiviikko;62;73;135;7;14;21
96;24.07.2013;2013;07;13;Keskiviikko;71;85;156;4;4;8
96;24.07.2013;2013;07;14;Keskiviikko;78;87;165;6;13;19
96;24.07.2013;2013;07;15;Keskiviikko;89;174;263;7;23;30
96;24.07.2013;2013;07;16;Keskiviikko;125;113;238;7;10;17
96;24.07.2013;2013;07;17;Keskiviikko;91;95;186;4;7;11
96;24.07.2013;2013;07;18;Keskiviikko;82;79;161;18;11;29
96;24.07.2013;2013;07;19;Keskiviikko;60;49;109;9;14;23
96;24.07.2013;2013;07;20;Keskiviikko;84;63;147;13;11;24
96;24.07.2013;2013;07;21;Keskiviikko;71;59;130;4;5;9
96;24.07.2013;2013;07;22;Keskiviikko;24;25;49;4;3;7
96;24.07.2013;2013;07;23;Keskiviikko;22;14;36;2;1;3
96;25.07.2013;2013;07;00;Torstai;20;3;23;3;2;5
96;25.07.2013;2013;07;01;Torstai;15;5;20;2;0;2
96;25.07.2013;2013;07;02;Torstai;13;1;14;1;0;1
96;25.07.2013;2013;07;03;Torstai;14;1;15;3;3;6
96;25.07.2013;2013;07;04;Torstai;6;4;10;2;0;2
96;25.07.2013;2013;07;05;Torstai;10;4;14;0;0;0
96;25.07.2013;2013;07;06;Torstai;59;35;94;0;2;2
96;25.07.2013;2013;07;07;Torstai;61;67;128;8;9;17
96;25.07.2013;2013;07;08;Torstai;41;58;99;3;8;11
96;25.07.2013;2013;07;09;Torstai;32;58;90;1;5;6
96;25.07.2013;2013;07;10;Torstai;36;48;84;1;4;5
96;25.07.2013;2013;07;11;Torstai;47;82;129;6;10;16
96;25.07.2013;2013;07;12;Torstai;69;69;138;4;8;12
96;25.07.2013;2013;07;13;Torstai;85;91;176;6;8;14
96;25.07.2013;2013;07;14;Torstai;73;90;163;7;10;17
96;25.07.2013;2013;07;15;Torstai;118;160;278;4;16;20
96;25.07.2013;2013;07;16;Torstai;110;89;199;5;15;20
96;25.07.2013;2013;07;17;Torstai;75;83;158;6;12;18
96;25.07.2013;2013;07;18;Torstai;94;86;180;19;8;27
96;25.07.2013;2013;07;19;Torstai;74;54;128;11;6;17
96;25.07.2013;2013;07;20;Torstai;68;48;116;9;7;16
96;25.07.2013;2013;07;21;Torstai;54;65;119;8;15;23
96;25.07.2013;2013;07;22;Torstai;33;21;54;7;4;11
96;25.07.2013;2013;07;23;Torstai;18;8;26;0;1;1
96;26.07.2013;2013;07;00;Perjantai;22;10;32;0;0;0
96;26.07.2013;2013;07;01;Perjantai;7;1;8;1;0;1
96;26.07.2013;2013;07;02;Perjantai;12;2;14;0;0;0
96;26.07.2013;2013;07;03;Perjantai;5;0;5;1;1;2
96;26.07.2013;2013;07;04;Perjantai;2;3;5;1;0;1
96;26.07.2013;2013;07;05;Perjantai;2;9;11;1;0;1
96;26.07.2013;2013;07;06;Perjantai;51;29;80;2;0;2
96;26.07.2013;2013;07;07;Perjantai;52;68;120;4;5;9
96;26.07.2013;2013;07;08;Perjantai;31;53;84;5;7;12
96;26.07.2013;2013;07;09;Perjantai;27;52;79;7;6;13
96;26.07.2013;2013;07;10;Perjantai;34;66;100;7;8;15
96;26.07.2013;2013;07;11;Perjantai;62;76;138;3;0;3
96;26.07.2013;2013;07;12;Perjantai;76;76;152;13;11;24
96;26.07.2013;2013;07;13;Perjantai;76;107;183;8;14;22
96;26.07.2013;2013;07;14;Perjantai;101;140;241;3;11;14
96;26.07.2013;2013;07;15;Perjantai;100;133;233;4;13;17
96;26.07.2013;2013;07;16;Perjantai;109;79;188;8;8;16
96;26.07.2013;2013;07;17;Perjantai;69;73;142;5;8;13
96;26.07.2013;2013;07;18;Perjantai;76;98;174;2;5;7
96;26.07.2013;2013;07;19;Perjantai;64;65;129;9;7;16
96;26.07.2013;2013;07;20;Perjantai;38;66;104;4;8;12
96;26.07.2013;2013;07;21;Perjantai;45;49;94;2;9;11
96;26.07.2013;2013;07;22;Perjantai;43;30;73;3;4;7
96;26.07.2013;2013;07;23;Perjantai;46;17;63;4;1;5
96;27.07.2013;2013;07;00;Lauantai;64;10;74;7;0;7
96;27.07.2013;2013;07;01;Lauantai;92;9;101;6;0;6
96;27.07.2013;2013;07;02;Lauantai;61;7;68;6;0;6
96;27.07.2013;2013;07;03;Lauantai;41;2;43;4;1;5
96;27.07.2013;2013;07;04;Lauantai;42;2;44;4;0;4
96;27.07.2013;2013;07;05;Lauantai;11;4;15;2;0;2
96;27.07.2013;2013;07;06;Lauantai;23;15;38;2;2;4
96;27.07.2013;2013;07;07;Lauantai;7;13;20;3;2;5
96;27.07.2013;2013;07;08;Lauantai;10;20;30;1;2;3
96;27.07.2013;2013;07;09;Lauantai;19;52;71;3;7;10
96;27.07.2013;2013;07;10;Lauantai;33;65;98;3;4;7
96;27.07.2013;2013;07;11;Lauantai;47;49;96;2;9;11
96;27.07.2013;2013;07;12;Lauantai;54;79;133;6;10;16
96;27.07.2013;2013;07;13;Lauantai;86;91;177;5;8;13
96;27.07.2013;2013;07;14;Lauantai;63;72;135;4;10;14
96;27.07.2013;2013;07;15;Lauantai;74;59;133;6;11;17
96;27.07.2013;2013;07;16;Lauantai;52;61;113;5;5;10
96;27.07.2013;2013;07;17;Lauantai;47;51;98;4;4;8
96;27.07.2013;2013;07;18;Lauantai;43;65;108;5;2;7
96;27.07.2013;2013;07;19;Lauantai;24;47;71;4;6;10
96;27.07.2013;2013;07;20;Lauantai;29;47;76;2;6;8
96;27.07.2013;2013;07;21;Lauantai;27;36;63;2;5;7
96;27.07.2013;2013;07;22;Lauantai;24;44;68;1;2;3
96;27.07.2013;2013;07;23;Lauantai;23;24;47;2;0;2
96;28.07.2013;2013;07;00;Sunnuntai;47;20;67;6;0;6
96;28.07.2013;2013;07;01;Sunnuntai;91;22;113;6;0;6
96;28.07.2013;2013;07;02;Sunnuntai;67;2;69;6;1;7
96;28.07.2013;2013;07;03;Sunnuntai;39;3;42;4;0;4
96;28.07.2013;2013;07;04;Sunnuntai;34;6;40;5;0;5
96;28.07.2013;2013;07;05;Sunnuntai;10;4;14;1;0;1
96;28.07.2013;2013;07;06;Sunnuntai;18;5;23;0;0;0
96;28.07.2013;2013;07;07;Sunnuntai;4;7;11;2;0;2
96;28.07.2013;2013;07;08;Sunnuntai;4;5;9;2;4;6
96;28.07.2013;2013;07;09;Sunnuntai;9;13;22;2;2;4
96;28.07.2013;2013;07;10;Sunnuntai;11;23;34;4;1;5
96;28.07.2013;2013;07;11;Sunnuntai;22;28;50;5;6;11
96;28.07.2013;2013;07;12;Sunnuntai;45;52;97;4;7;11
96;28.07.2013;2013;07;13;Sunnuntai;69;87;156;4;13;17
96;28.07.2013;2013;07;14;Sunnuntai;72;42;114;3;11;14
96;28.07.2013;2013;07;15;Sunnuntai;61;62;123;3;6;9
96;28.07.2013;2013;07;16;Sunnuntai;59;66;125;5;12;17
96;28.07.2013;2013;07;17;Sunnuntai;94;40;134;15;2;17
96;28.07.2013;2013;07;18;Sunnuntai;62;37;99;20;3;23
96;28.07.2013;2013;07;19;Sunnuntai;83;43;126;13;3;16
96;28.07.2013;2013;07;20;Sunnuntai;43;43;86;7;11;18
96;28.07.2013;2013;07;21;Sunnuntai;20;34;54;3;7;10
96;28.07.2013;2013;07;22;Sunnuntai;12;8;20;3;0;3
96;28.07.2013;2013;07;23;Sunnuntai;12;5;17;0;1;1
96;29.07.2013;2013;07;00;Maanantai;2;3;5;3;1;4
96;29.07.2013;2013;07;01;Maanantai;1;4;5;1;0;1
96;29.07.2013;2013;07;02;Maanantai;6;1;7;0;0;0
96;29.07.2013;2013;07;03;Maanantai;6;0;6;0;1;1
96;29.07.2013;2013;07;04;Maanantai;3;3;6;2;0;2
96;29.07.2013;2013;07;05;Maanantai;6;10;16;2;0;2
96;29.07.2013;2013;07;06;Maanantai;50;42;92;3;2;5
96;29.07.2013;2013;07;07;Maanantai;83;105;188;5;4;9
96;29.07.2013;2013;07;08;Maanantai;32;95;127;4;8;12
96;29.07.2013;2013;07;09;Maanantai;38;71;109;3;7;10
96;29.07.2013;2013;07;10;Maanantai;43;52;95;4;4;8
96;29.07.2013;2013;07;11;Maanantai;65;89;154;4;10;14
96;29.07.2013;2013;07;12;Maanantai;84;75;159;17;14;31
96;29.07.2013;2013;07;13;Maanantai;83;86;169;7;8;15
96;29.07.2013;2013;07;14;Maanantai;94;115;209;8;4;12
96;29.07.2013;2013;07;15;Maanantai;134;163;297;3;14;17
96;29.07.2013;2013;07;16;Maanantai;143;120;263;8;10;18
96;29.07.2013;2013;07;17;Maanantai;111;81;192;10;5;15
96;29.07.2013;2013;07;18;Maanantai;74;44;118;7;13;20
96;29.07.2013;2013;07;19;Maanantai;81;63;144;15;14;29
96;29.07.2013;2013;07;20;Maanantai;47;39;86;7;13;20
96;29.07.2013;2013;07;21;Maanantai;35;39;74;7;8;15
96;29.07.2013;2013;07;22;Maanantai;35;11;46;2;2;4
96;29.07.2013;2013;07;23;Maanantai;14;16;30;2;2;4
96;30.07.2013;2013;07;00;Tiistai;7;4;11;1;1;2
96;30.07.2013;2013;07;01;Tiistai;6;1;7;0;0;0
96;30.07.2013;2013;07;02;Tiistai;5;2;7;1;0;1
96;30.07.2013;2013;07;03;Tiistai;1;0;1;0;1;1
96;30.07.2013;2013;07;04;Tiistai;5;3;8;0;1;1
96;30.07.2013;2013;07;05;Tiistai;3;9;12;0;0;0
96;30.07.2013;2013;07;06;Tiistai;44;27;71;2;0;2
96;30.07.2013;2013;07;07;Tiistai;61;95;156;8;2;10
96;30.07.2013;2013;07;08;Tiistai;31;68;99;2;2;4
96;30.07.2013;2013;07;09;Tiistai;20;51;71;3;2;5
96;30.07.2013;2013;07;10;Tiistai;22;28;50;1;2;3
96;30.07.2013;2013;07;11;Tiistai;24;25;49;0;0;0
96;30.07.2013;2013;07;12;Tiistai;18;25;43;7;1;8
96;30.07.2013;2013;07;13;Tiistai;25;47;72;3;3;6
96;30.07.2013;2013;07;14;Tiistai;39;71;110;2;4;6
96;30.07.2013;2013;07;15;Tiistai;67;114;181;5;7;12
96;30.07.2013;2013;07;16;Tiistai;62;64;126;1;8;9
96;30.07.2013;2013;07;17;Tiistai;52;41;93;6;3;9
96;30.07.2013;2013;07;18;Tiistai;23;48;71;10;9;19
96;30.07.2013;2013;07;19;Tiistai;50;24;74;12;11;23
96;30.07.2013;2013;07;20;Tiistai;32;31;63;7;11;18
96;30.07.2013;2013;07;21;Tiistai;23;20;43;2;5;7
96;30.07.2013;2013;07;22;Tiistai;9;15;24;1;2;3
96;30.07.2013;2013;07;23;Tiistai;7;6;13;2;0;2
96;31.07.2013;2013;07;00;Keskiviikko;6;2;8;0;1;1
96;31.07.2013;2013;07;01;Keskiviikko;10;3;13;0;0;0
96;31.07.2013;2013;07;02;Keskiviikko;8;4;12;0;0;0
96;31.07.2013;2013;07;03;Keskiviikko;3;3;6;0;0;0
96;31.07.2013;2013;07;04;Keskiviikko;4;0;4;1;2;3
96;31.07.2013;2013;07;05;Keskiviikko;5;8;13;0;0;0
96;31.07.2013;2013;07;06;Keskiviikko;37;42;79;0;2;2
96;31.07.2013;2013;07;07;Keskiviikko;71;93;164;4;1;5
96;31.07.2013;2013;07;08;Keskiviikko;30;69;99;3;1;4
96;31.07.2013;2013;07;09;Keskiviikko;28;56;84;7;7;14
96;31.07.2013;2013;07;10;Keskiviikko;40;49;89;8;10;18
96;31.07.2013;2013;07;11;Keskiviikko;37;62;99;5;7;12
96;31.07.2013;2013;07;12;Keskiviikko;43;42;85;1;2;3
96;31.07.2013;2013;07;13;Keskiviikko;39;60;99;6;3;9
96;31.07.2013;2013;07;14;Keskiviikko;52;76;128;1;4;5
96;31.07.2013;2013;07;15;Keskiviikko;75;144;219;6;4;10
96;31.07.2013;2013;07;16;Keskiviikko;87;84;171;7;2;9
96;31.07.2013;2013;07;17;Keskiviikko;55;43;98;7;6;13
96;31.07.2013;2013;07;18;Keskiviikko;51;27;78;11;7;18
96;31.07.2013;2013;07;19;Keskiviikko;33;33;66;5;6;11
96;31.07.2013;2013;07;20;Keskiviikko;42;30;72;5;4;9
96;31.07.2013;2013;07;21;Keskiviikko;18;23;41;5;3;8
96;31.07.2013;2013;07;22;Keskiviikko;15;15;30;0;2;2
96;31.07.2013;2013;07;23;Keskiviikko;9;11;20;0;1;1
96;01.08.2013;2013;08;00;Torstai;3;8;11;0;2;2
96;01.08.2013;2013;08;01;Torstai;5;0;5;4;0;4
96;01.08.2013;2013;08;02;Torstai;3;1;4;1;1;2
96;01.08.2013;2013;08;03;Torstai;3;0;3;0;0;0
96;01.08.2013;2013;08;04;Torstai;2;2;4;0;1;1
96;01.08.2013;2013;08;05;Torstai;7;3;10;0;0;0
96;01.08.2013;2013;08;06;Torstai;45;23;68;3;1;4
96;01.08.2013;2013;08;07;Torstai;73;58;131;6;0;6
96;01.08.2013;2013;08;08;Torstai;36;56;92;1;2;3
96;01.08.2013;2013;08;09;Torstai;21;33;54;1;4;5
96;01.08.2013;2013;08;10;Torstai;23;27;50;3;4;7
96;01.08.2013;2013;08;11;Torstai;37;55;92;6;7;13
96;01.08.2013;2013;08;12;Torstai;33;73;106;4;7;11
96;01.08.2013;2013;08;13;Torstai;54;54;108;5;6;11
96;01.08.2013;2013;08;14;Torstai;43;83;126;2;4;6
96;01.08.2013;2013;08;15;Torstai;79;131;210;4;20;24
96;01.08.2013;2013;08;16;Torstai;83;80;163;8;9;17
96;01.08.2013;2013;08;17;Torstai;49;50;99;5;6;11
96;01.08.2013;2013;08;18;Torstai;51;34;85;6;5;11
96;01.08.2013;2013;08;19;Torstai;41;21;62;5;6;11
96;01.08.2013;2013;08;20;Torstai;28;27;55;5;2;7
96;01.08.2013;2013;08;21;Torstai;22;18;40;3;3;6
96;01.08.2013;2013;08;22;Torstai;11;6;17;4;1;5
96;01.08.2013;2013;08;23;Torstai;5;2;7;0;1;1
96;02.08.2013;2013;08;00;Perjantai;2;5;7;0;0;0
96;02.08.2013;2013;08;01;Perjantai;4;1;5;0;0;0
96;02.08.2013;2013;08;02;Perjantai;1;0;1;0;0;0
96;02.08.2013;2013;08;03;Perjantai;1;0;1;0;1;1
96;02.08.2013;2013;08;04;Perjantai;4;3;7;0;0;0
96;02.08.2013;2013;08;05;Perjantai;3;7;10;0;1;1
96;02.08.2013;2013;08;06;Perjantai;51;41;92;2;5;7
96;02.08.2013;2013;08;07;Perjantai;75;95;170;8;4;12
96;02.08.2013;2013;08;08;Perjantai;32;87;119;2;4;6
96;02.08.2013;2013;08;09;Perjantai;18;63;81;4;7;11
96;02.08.2013;2013;08;10;Perjantai;47;66;113;1;5;6
96;02.08.2013;2013;08;11;Perjantai;67;96;163;6;8;14
96;02.08.2013;2013;08;12;Perjantai;72;90;162;4;5;9
96;02.08.2013;2013;08;13;Perjantai;92;104;196;6;4;10
96;02.08.2013;2013;08;14;Perjantai;112;115;227;10;12;22
96;02.08.2013;2013;08;15;Perjantai;90;132;222;9;14;23
96;02.08.2013;2013;08;16;Perjantai;86;72;158;7;18;25
96;02.08.2013;2013;08;17;Perjantai;69;65;134;8;7;15
96;02.08.2013;2013;08;18;Perjantai;65;67;132;8;6;14
96;02.08.2013;2013;08;19;Perjantai;63;53;116;10;7;17
96;02.08.2013;2013;08;20;Perjantai;63;47;110;5;5;10
96;02.08.2013;2013;08;21;Perjantai;33;51;84;2;4;6
96;02.08.2013;2013;08;22;Perjantai;21;22;43;2;2;4
96;02.08.2013;2013;08;23;Perjantai;17;10;27;0;2;2
96;03.08.2013;2013;08;00;Lauantai;21;12;33;2;0;2
96;03.08.2013;2013;08;01;Lauantai;21;13;34;1;0;1
96;03.08.2013;2013;08;02;Lauantai;22;11;33;0;0;0
96;03.08.2013;2013;08;03;Lauantai;14;3;17;1;0;1
96;03.08.2013;2013;08;04;Lauantai;19;3;22;2;1;3
96;03.08.2013;2013;08;05;Lauantai;10;1;11;3;0;3
96;03.08.2013;2013;08;06;Lauantai;22;10;32;3;1;4
96;03.08.2013;2013;08;07;Lauantai;6;19;25;1;1;2
96;03.08.2013;2013;08;08;Lauantai;3;28;31;1;1;2
96;03.08.2013;2013;08;09;Lauantai;11;38;49;1;3;4
96;03.08.2013;2013;08;10;Lauantai;28;50;78;10;3;13
96;03.08.2013;2013;08;11;Lauantai;43;65;108;5;3;8
96;03.08.2013;2013;08;12;Lauantai;42;77;119;3;2;5
96;03.08.2013;2013;08;13;Lauantai;49;71;120;0;6;6
96;03.08.2013;2013;08;14;Lauantai;70;72;142;5;5;10
96;03.08.2013;2013;08;15;Lauantai;82;64;146;5;9;14
96;03.08.2013;2013;08;16;Lauantai;60;44;104;8;5;13
96;03.08.2013;2013;08;17;Lauantai;62;41;103;7;7;14
96;03.08.2013;2013;08;18;Lauantai;43;55;98;17;14;31
96;03.08.2013;2013;08;19;Lauantai;42;69;111;5;6;11
96;03.08.2013;2013;08;20;Lauantai;37;45;82;16;6;22
96;03.08.2013;2013;08;21;Lauantai;32;60;92;7;5;12
96;03.08.2013;2013;08;22;Lauantai;22;25;47;2;2;4
96;03.08.2013;2013;08;23;Lauantai;28;19;47;2;1;3
96;04.08.2013;2013;08;00;Sunnuntai;27;14;41;1;2;3
96;04.08.2013;2013;08;01;Sunnuntai;20;6;26;1;0;1
96;04.08.2013;2013;08;02;Sunnuntai;24;1;25;3;0;3
96;04.08.2013;2013;08;03;Sunnuntai;21;2;23;2;0;2
96;04.08.2013;2013;08;04;Sunnuntai;22;0;22;3;1;4
96;04.08.2013;2013;08;05;Sunnuntai;2;3;5;2;0;2
96;04.08.2013;2013;08;06;Sunnuntai;20;12;32;1;1;2
96;04.08.2013;2013;08;07;Sunnuntai;3;10;13;4;4;8
96;04.08.2013;2013;08;08;Sunnuntai;13;15;28;0;2;2
96;04.08.2013;2013;08;09;Sunnuntai;13;20;33;5;4;9
96;04.08.2013;2013;08;10;Sunnuntai;21;37;58;6;6;12
96;04.08.2013;2013;08;11;Sunnuntai;39;48;87;9;9;18
96;04.08.2013;2013;08;12;Sunnuntai;54;66;120;3;10;13
96;04.08.2013;2013;08;13;Sunnuntai;66;73;139;6;8;14
96;04.08.2013;2013;08;14;Sunnuntai;70;71;141;3;9;12
96;04.08.2013;2013;08;15;Sunnuntai;86;59;145;6;3;9
96;04.08.2013;2013;08;16;Sunnuntai;77;64;141;7;6;13
96;04.08.2013;2013;08;17;Sunnuntai;90;84;174;12;6;18
96;04.08.2013;2013;08;18;Sunnuntai;73;49;122;7;11;18
96;04.08.2013;2013;08;19;Sunnuntai;79;77;156;7;18;25
96;04.08.2013;2013;08;20;Sunnuntai;57;60;117;10;10;20
96;04.08.2013;2013;08;21;Sunnuntai;27;45;72;3;3;6
96;04.08.2013;2013;08;22;Sunnuntai;9;12;21;1;5;6
96;04.08.2013;2013;08;23;Sunnuntai;13;17;30;1;2;3
96;05.08.2013;2013;08;00;Maanantai;13;7;20;2;2;4
96;05.08.2013;2013;08;01;Maanantai;4;0;4;0;0;0
96;05.08.2013;2013;08;02;Maanantai;2;0;2;1;0;1
96;05.08.2013;2013;08;03;Maanantai;6;0;6;0;1;1
96;05.08.2013;2013;08;04;Maanantai;9;4;13;0;0;0
96;05.08.2013;2013;08;05;Maanantai;5;6;11;0;0;0
96;05.08.2013;2013;08;06;Maanantai;37;45;82;3;3;6
96;05.08.2013;2013;08;07;Maanantai;66;100;166;10;6;16
96;05.08.2013;2013;08;08;Maanantai;46;104;150;6;5;11
96;05.08.2013;2013;08;09;Maanantai;45;90;135;6;6;12
96;05.08.2013;2013;08;10;Maanantai;41;90;131;3;10;13
96;05.08.2013;2013;08;11;Maanantai;61;84;145;2;8;10
96;05.08.2013;2013;08;12;Maanantai;84;64;148;6;4;10
96;05.08.2013;2013;08;13;Maanantai;91;82;173;10;6;16
96;05.08.2013;2013;08;14;Maanantai;99;92;191;2;12;14
96;05.08.2013;2013;08;15;Maanantai;137;147;284;6;17;23
96;05.08.2013;2013;08;16;Maanantai;152;125;277;9;14;23
96;05.08.2013;2013;08;17;Maanantai;97;71;168;14;10;24
96;05.08.2013;2013;08;18;Maanantai;89;76;165;17;17;34
96;05.08.2013;2013;08;19;Maanantai;115;64;179;14;14;28
96;05.08.2013;2013;08;20;Maanantai;76;51;127;9;12;21
96;05.08.2013;2013;08;21;Maanantai;42;32;74;3;4;7
96;05.08.2013;2013;08;22;Maanantai;26;13;39;7;1;8
96;05.08.2013;2013;08;23;Maanantai;13;9;22;0;1;1
96;06.08.2013;2013;08;00;Tiistai;7;6;13;2;1;3
96;06.08.2013;2013;08;01;Tiistai;7;3;10;3;0;3
96;06.08.2013;2013;08;02;Tiistai;4;3;7;1;1;2
96;06.08.2013;2013;08;03;Tiistai;2;0;2;0;1;1
96;06.08.2013;2013;08;04;Tiistai;2;2;4;0;0;0
96;06.08.2013;2013;08;05;Tiistai;1;12;13;0;2;2
96;06.08.2013;2013;08;06;Tiistai;56;34;90;1;2;3
96;06.08.2013;2013;08;07;Tiistai;90;143;233;9;8;17
96;06.08.2013;2013;08;08;Tiistai;55;117;172;2;3;5
96;06.08.2013;2013;08;09;Tiistai;41;89;130;7;11;18
96;06.08.2013;2013;08;10;Tiistai;40;69;109;0;9;9
96;06.08.2013;2013;08;11;Tiistai;67;68;135;4;9;13
96;06.08.2013;2013;08;12;Tiistai;76;73;149;3;11;14
96;06.08.2013;2013;08;13;Tiistai;95;81;176;9;11;20
96;06.08.2013;2013;08;14;Tiistai;86;106;192;7;16;23
96;06.08.2013;2013;08;15;Tiistai;162;179;341;2;16;18
96;06.08.2013;2013;08;16;Tiistai;174;133;307;13;10;23
96;06.08.2013;2013;08;17;Tiistai;91;97;188;3;13;16
96;06.08.2013;2013;08;18;Tiistai;99;64;163;10;14;24
96;06.08.2013;2013;08;19;Tiistai;74;59;133;4;11;15
96;06.08.2013;2013;08;20;Tiistai;62;50;112;10;13;23
96;06.08.2013;2013;08;21;Tiistai;61;49;110;11;7;18
96;06.08.2013;2013;08;22;Tiistai;26;24;50;3;3;6
96;06.08.2013;2013;08;23;Tiistai;11;15;26;1;2;3
96;07.08.2013;2013;08;00;Keskiviikko;10;7;17;1;0;1
96;07.08.2013;2013;08;01;Keskiviikko;3;3;6;4;0;4
96;07.08.2013;2013;08;02;Keskiviikko;4;0;4;0;0;0
96;07.08.2013;2013;08;03;Keskiviikko;5;0;5;0;1;1
96;07.08.2013;2013;08;04;Keskiviikko;2;1;3;0;1;1
96;07.08.2013;2013;08;05;Keskiviikko;6;10;16;0;0;0
96;07.08.2013;2013;08;06;Keskiviikko;54;52;106;1;4;5
96;07.08.2013;2013;08;07;Keskiviikko;88;130;218;5;4;9
96;07.08.2013;2013;08;08;Keskiviikko;66;107;173;11;3;14
96;07.08.2013;2013;08;09;Keskiviikko;51;91;142;10;12;22
96;07.08.2013;2013;08;10;Keskiviikko;32;71;103;8;9;17
96;07.08.2013;2013;08;11;Keskiviikko;54;82;136;7;9;16
96;07.08.2013;2013;08;12;Keskiviikko;81;82;163;3;7;10
96;07.08.2013;2013;08;13;Keskiviikko;90;97;187;10;19;29
96;07.08.2013;2013;08;14;Keskiviikko;77;118;195;7;15;22
96;07.08.2013;2013;08;15;Keskiviikko;109;190;299;5;20;25
96;07.08.2013;2013;08;16;Keskiviikko;128;116;244;8;8;16
96;07.08.2013;2013;08;17;Keskiviikko;68;42;110;7;13;20
96;07.08.2013;2013;08;18;Keskiviikko;42;19;61;17;9;26
96;07.08.2013;2013;08;19;Keskiviikko;38;27;65;6;9;15
96;07.08.2013;2013;08;20;Keskiviikko;22;19;41;8;5;13
96;07.08.2013;2013;08;21;Keskiviikko;15;23;38;2;4;6
96;07.08.2013;2013;08;22;Keskiviikko;15;7;22;0;0;0
96;07.08.2013;2013;08;23;Keskiviikko;4;11;15;1;2;3
96;08.08.2013;2013;08;00;Torstai;2;3;5;0;1;1
96;08.08.2013;2013;08;01;Torstai;1;0;1;0;0;0
96;08.08.2013;2013;08;02;Torstai;1;1;2;0;0;0
96;08.08.2013;2013;08;03;Torstai;10;2;12;1;0;1
96;08.08.2013;2013;08;04;Torstai;3;1;4;0;0;0
96;08.08.2013;2013;08;05;Torstai;4;7;11;1;0;1
96;08.08.2013;2013;08;06;Torstai;51;30;81;2;3;5
96;08.08.2013;2013;08;07;Torstai;92;114;206;6;3;9
96;08.08.2013;2013;08;08;Torstai;54;83;137;12;1;13
96;08.08.2013;2013;08;09;Torstai;32;67;99;8;4;12
96;08.08.2013;2013;08;10;Torstai;19;50;69;3;4;7
96;08.08.2013;2013;08;11;Torstai;40;52;92;7;15;22
96;08.08.2013;2013;08;12;Torstai;57;67;124;5;12;17
96;08.08.2013;2013;08;13;Torstai;56;67;123;6;7;13
96;08.08.2013;2013;08;14;Torstai;48;113;161;6;15;21
96;08.08.2013;2013;08;15;Torstai;97;204;301;8;16;24
96;08.08.2013;2013;08;16;Torstai;111;131;242;5;16;21
96;08.08.2013;2013;08;17;Torstai;73;83;156;6;9;15
96;08.08.2013;2013;08;18;Torstai;93;62;155;8;5;13
96;08.08.2013;2013;08;19;Torstai;74;60;134;16;14;30
96;08.08.2013;2013;08;20;Torstai;66;45;111;9;10;19
96;08.08.2013;2013;08;21;Torstai;26;37;63;4;6;10
96;08.08.2013;2013;08;22;Torstai;31;17;48;8;2;10
96;08.08.2013;2013;08;23;Torstai;5;5;10;1;0;1
96;09.08.2013;2013;08;00;Perjantai;6;3;9;0;1;1
96;09.08.2013;2013;08;01;Perjantai;4;3;7;1;0;1
96;09.08.2013;2013;08;02;Perjantai;2;0;2;0;0;0
96;09.08.2013;2013;08;03;Perjantai;1;1;2;1;0;1
96;09.08.2013;2013;08;04;Perjantai;1;1;2;0;0;0
96;09.08.2013;2013;08;05;Perjantai;1;9;10;1;1;2
96;09.08.2013;2013;08;06;Perjantai;46;28;74;3;4;7
96;09.08.2013;2013;08;07;Perjantai;67;83;150;2;7;9
96;09.08.2013;2013;08;08;Perjantai;66;86;152;4;7;11
96;09.08.2013;2013;08;09;Perjantai;30;65;95;8;4;12
96;09.08.2013;2013;08;10;Perjantai;33;64;97;3;1;4
96;09.08.2013;2013;08;11;Perjantai;45;64;109;3;4;7
96;09.08.2013;2013;08;12;Perjantai;50;51;101;4;4;8
96;09.08.2013;2013;08;13;Perjantai;46;61;107;10;11;21
96;09.08.2013;2013;08;14;Perjantai;64;125;189;7;17;24
96;09.08.2013;2013;08;15;Perjantai;83;152;235;8;15;23
96;09.08.2013;2013;08;16;Perjantai;84;82;166;11;10;21
96;09.08.2013;2013;08;17;Perjantai;53;60;113;5;6;11
96;09.08.2013;2013;08;18;Perjantai;46;45;91;7;0;7
96;09.08.2013;2013;08;19;Perjantai;32;42;74;6;4;10
96;09.08.2013;2013;08;20;Perjantai;32;31;63;8;12;20
96;09.08.2013;2013;08;21;Perjantai;25;33;58;6;3;9
96;09.08.2013;2013;08;22;Perjantai;14;22;36;1;4;5
96;09.08.2013;2013;08;23;Perjantai;12;7;19;3;3;6
96;10.08.2013;2013;08;00;Lauantai;15;10;25;0;1;1
96;10.08.2013;2013;08;01;Lauantai;11;9;20;0;0;0
96;10.08.2013;2013;08;02;Lauantai;17;2;19;1;0;1
96;10.08.2013;2013;08;03;Lauantai;18;3;21;3;0;3
96;10.08.2013;2013;08;04;Lauantai;11;2;13;1;0;1
96;10.08.2013;2013;08;05;Lauantai;4;3;7;0;1;1
96;10.08.2013;2013;08;06;Lauantai;21;14;35;0;1;1
96;10.08.2013;2013;08;07;Lauantai;4;16;20;2;1;3
96;10.08.2013;2013;08;08;Lauantai;10;25;35;0;2;2
96;10.08.2013;2013;08;09;Lauantai;15;52;67;2;5;7
96;10.08.2013;2013;08;10;Lauantai;30;46;76;4;5;9
96;10.08.2013;2013;08;11;Lauantai;31;66;97;4;4;8
96;10.08.2013;2013;08;12;Lauantai;59;77;136;9;5;14
96;10.08.2013;2013;08;13;Lauantai;77;87;164;8;8;16
96;10.08.2013;2013;08;14;Lauantai;69;66;135;4;5;9
96;10.08.2013;2013;08;15;Lauantai;63;79;142;6;6;12
96;10.08.2013;2013;08;16;Lauantai;69;71;140;16;8;24
96;10.08.2013;2013;08;17;Lauantai;58;48;106;18;6;24
96;10.08.2013;2013;08;18;Lauantai;71;47;118;10;11;21
96;10.08.2013;2013;08;19;Lauantai;42;43;85;16;7;23
96;10.08.2013;2013;08;20;Lauantai;47;52;99;8;11;19
96;10.08.2013;2013;08;21;Lauantai;25;65;90;3;3;6
96;10.08.2013;2013;08;22;Lauantai;17;25;42;2;0;2
96;10.08.2013;2013;08;23;Lauantai;21;33;54;2;0;2
96;11.08.2013;2013;08;00;Sunnuntai;13;8;21;1;2;3
96;11.08.2013;2013;08;01;Sunnuntai;33;6;39;3;0;3
96;11.08.2013;2013;08;02;Sunnuntai;24;4;28;4;0;4
96;11.08.2013;2013;08;03;Sunnuntai;26;2;28;2;0;2
96;11.08.2013;2013;08;04;Sunnuntai;26;1;27;0;1;1
96;11.08.2013;2013;08;05;Sunnuntai;10;1;11;3;1;4
96;11.08.2013;2013;08;06;Sunnuntai;22;6;28;1;0;1
96;11.08.2013;2013;08;07;Sunnuntai;5;16;21;2;3;5
96;11.08.2013;2013;08;08;Sunnuntai;8;9;17;2;4;6
96;11.08.2013;2013;08;09;Sunnuntai;15;23;38;8;6;14
96;11.08.2013;2013;08;10;Sunnuntai;26;31;57;8;8;16
96;11.08.2013;2013;08;11;Sunnuntai;23;53;76;5;12;17
96;11.08.2013;2013;08;12;Sunnuntai;46;83;129;6;16;22
96;11.08.2013;2013;08;13;Sunnuntai;70;61;131;10;8;18
96;11.08.2013;2013;08;14;Sunnuntai;75;61;136;10;2;12
96;11.08.2013;2013;08;15;Sunnuntai;59;69;128;4;9;13
96;11.08.2013;2013;08;16;Sunnuntai;54;77;131;6;15;21
96;11.08.2013;2013;08;17;Sunnuntai;68;43;111;19;15;34
96;11.08.2013;2013;08;18;Sunnuntai;64;48;112;14;7;21
96;11.08.2013;2013;08;19;Sunnuntai;70;55;125;13;11;24
96;11.08.2013;2013;08;20;Sunnuntai;37;37;74;2;8;10
96;11.08.2013;2013;08;21;Sunnuntai;31;41;72;5;7;12
96;11.08.2013;2013;08;22;Sunnuntai;12;7;19;2;1;3
96;11.08.2013;2013;08;23;Sunnuntai;4;6;10;2;1;3
96;12.08.2013;2013;08;00;Maanantai;2;1;3;0;2;2
96;12.08.2013;2013;08;01;Maanantai;3;1;4;0;1;1
96;12.08.2013;2013;08;02;Maanantai;6;1;7;0;0;0
96;12.08.2013;2013;08;03;Maanantai;4;1;5;0;0;0
96;12.08.2013;2013;08;04;Maanantai;2;5;7;1;0;1
96;12.08.2013;2013;08;05;Maanantai;10;10;20;1;0;1
96;12.08.2013;2013;08;06;Maanantai;22;32;54;2;1;3
96;12.08.2013;2013;08;07;Maanantai;75;115;190;5;7;12
96;12.08.2013;2013;08;08;Maanantai;145;172;317;15;7;22
96;12.08.2013;2013;08;09;Maanantai;68;132;200;6;8;14
96;12.08.2013;2013;08;10;Maanantai;43;109;152;3;5;8
96;12.08.2013;2013;08;11;Maanantai;44;60;104;4;4;8
96;12.08.2013;2013;08;12;Maanantai;99;65;164;5;10;15
96;12.08.2013;2013;08;13;Maanantai;90;84;174;14;11;25
96;12.08.2013;2013;08;14;Maanantai;74;143;217;6;7;13
96;12.08.2013;2013;08;15;Maanantai;102;212;314;11;21;32
96;12.08.2013;2013;08;16;Maanantai;174;220;394;13;17;30
96;12.08.2013;2013;08;17;Maanantai;110;94;204;8;8;16
96;12.08.2013;2013;08;18;Maanantai;97;75;172;18;19;37
96;12.08.2013;2013;08;19;Maanantai;79;52;131;4;14;18
96;12.08.2013;2013;08;20;Maanantai;78;58;136;13;15;28
96;12.08.2013;2013;08;21;Maanantai;36;38;74;7;10;17
96;12.08.2013;2013;08;22;Maanantai;23;22;45;4;3;7
96;12.08.2013;2013;08;23;Maanantai;20;8;28;0;1;1
96;13.08.2013;2013;08;00;Tiistai;1;2;3;0;0;0
96;13.08.2013;2013;08;01;Tiistai;7;4;11;1;1;2
96;13.08.2013;2013;08;02;Tiistai;8;1;9;0;0;0
96;13.08.2013;2013;08;03;Tiistai;3;3;6;0;0;0
96;13.08.2013;2013;08;04;Tiistai;1;1;2;1;0;1
96;13.08.2013;2013;08;05;Tiistai;7;10;17;0;0;0
96;13.08.2013;2013;08;06;Tiistai;47;50;97;6;5;11
96;13.08.2013;2013;08;07;Tiistai;125;162;287;7;6;13
96;13.08.2013;2013;08;08;Tiistai;108;202;310;6;6;12
96;13.08.2013;2013;08;09;Tiistai;47;73;120;3;7;10
96;13.08.2013;2013;08;10;Tiistai;34;63;97;2;3;5
96;13.08.2013;2013;08;11;Tiistai;58;51;109;5;4;9
96;13.08.2013;2013;08;12;Tiistai;64;56;120;4;10;14
96;13.08.2013;2013;08;13;Tiistai;84;83;167;6;10;16
96;13.08.2013;2013;08;14;Tiistai;82;119;201;12;11;23
96;13.08.2013;2013;08;15;Tiistai;106;199;305;3;22;25
96;13.08.2013;2013;08;16;Tiistai;126;167;293;14;7;21
96;13.08.2013;2013;08;17;Tiistai;71;66;137;12;6;18
96;13.08.2013;2013;08;18;Tiistai;47;73;120;10;12;22
96;13.08.2013;2013;08;19;Tiistai;51;37;88;11;16;27
96;13.08.2013;2013;08;20;Tiistai;83;37;120;13;11;24
96;13.08.2013;2013;08;21;Tiistai;25;28;53;8;5;13
96;13.08.2013;2013;08;22;Tiistai;9;7;16;3;4;7
96;13.08.2013;2013;08;23;Tiistai;5;1;6;0;2;2
96;14.08.2013;2013;08;00;Keskiviikko;2;1;3;1;0;1
96;14.08.2013;2013;08;01;Keskiviikko;0;1;1;0;0;0
96;14.08.2013;2013;08;02;Keskiviikko;2;0;2;0;0;0
96;14.08.2013;2013;08;03;Keskiviikko;1;1;2;0;1;1
96;14.08.2013;2013;08;04;Keskiviikko;1;1;2;1;0;1
96;14.08.2013;2013;08;05;Keskiviikko;6;16;22;0;0;0
96;14.08.2013;2013;08;06;Keskiviikko;42;53;95;9;3;12
96;14.08.2013;2013;08;07;Keskiviikko;117;181;298;12;7;19
96;14.08.2013;2013;08;08;Keskiviikko;135;175;310;5;6;11
96;14.08.2013;2013;08;09;Keskiviikko;48;82;130;2;12;14
96;14.08.2013;2013;08;10;Keskiviikko;55;82;137;7;6;13
96;14.08.2013;2013;08;11;Keskiviikko;52;88;140;4;7;11
96;14.08.2013;2013;08;12;Keskiviikko;88;84;172;9;12;21
96;14.08.2013;2013;08;13;Keskiviikko;102;86;188;4;8;12
96;14.08.2013;2013;08;14;Keskiviikko;105;135;240;7;13;20
96;14.08.2013;2013;08;15;Keskiviikko;125;244;369;6;26;32
96;14.08.2013;2013;08;16;Keskiviikko;133;190;323;11;17;28
96;14.08.2013;2013;08;17;Keskiviikko;82;121;203;14;12;26
96;14.08.2013;2013;08;18;Keskiviikko;97;80;177;22;12;34
96;14.08.2013;2013;08;19;Keskiviikko;61;55;116;10;16;26
96;14.08.2013;2013;08;20;Keskiviikko;60;46;106;8;11;19
96;14.08.2013;2013;08;21;Keskiviikko;39;49;88;1;3;4
96;14.08.2013;2013;08;22;Keskiviikko;15;3;18;0;1;1
96;14.08.2013;2013;08;23;Keskiviikko;10;11;21;0;0;0
96;15.08.2013;2013;08;00;Torstai;3;5;8;0;0;0
96;15.08.2013;2013;08;01;Torstai;13;1;14;0;0;0
96;15.08.2013;2013;08;02;Torstai;9;0;9;0;0;0
96;15.08.2013;2013;08;03;Torstai;4;0;4;1;1;2
96;15.08.2013;2013;08;04;Torstai;3;4;7;0;0;0
96;15.08.2013;2013;08;05;Torstai;6;11;17;0;0;0
96;15.08.2013;2013;08;06;Torstai;18;21;39;6;1;7
96;15.08.2013;2013;08;07;Torstai;62;89;151;10;1;11
96;15.08.2013;2013;08;08;Torstai;108;179;287;4;5;9
96;15.08.2013;2013;08;09;Torstai;47;95;142;6;2;8
96;15.08.2013;2013;08;10;Torstai;46;60;106;3;4;7
96;15.08.2013;2013;08;11;Torstai;40;60;100;4;1;5
96;15.08.2013;2013;08;12;Torstai;45;82;127;5;6;11
96;15.08.2013;2013;08;13;Torstai;83;65;148;10;8;18
96;15.08.2013;2013;08;14;Torstai;70;93;163;4;11;15
96;15.08.2013;2013;08;15;Torstai;115;141;256;6;14;20
96;15.08.2013;2013;08;16;Torstai;138;198;336;14;29;43
96;15.08.2013;2013;08;17;Torstai;84;98;182;12;20;32
96;15.08.2013;2013;08;18;Torstai;66;72;138;5;9;14
96;15.08.2013;2013;08;19;Torstai;57;55;112;12;10;22
96;15.08.2013;2013;08;20;Torstai;84;56;140;10;7;17
96;15.08.2013;2013;08;21;Torstai;56;46;102;9;5;14
96;15.08.2013;2013;08;22;Torstai;40;18;58;3;9;12
96;15.08.2013;2013;08;23;Torstai;16;2;18;1;2;3
96;16.08.2013;2013;08;00;Perjantai;8;0;8;1;2;3
96;16.08.2013;2013;08;01;Perjantai;6;3;9;2;2;4
96;16.08.2013;2013;08;02;Perjantai;2;1;3;0;1;1
96;16.08.2013;2013;08;03;Perjantai;9;0;9;0;0;0
96;16.08.2013;2013;08;04;Perjantai;2;2;4;0;0;0
96;16.08.2013;2013;08;05;Perjantai;5;6;11;0;1;1
96;16.08.2013;2013;08;06;Perjantai;37;36;73;3;2;5
96;16.08.2013;2013;08;07;Perjantai;87;101;188;6;3;9
96;16.08.2013;2013;08;08;Perjantai;66;79;145;4;1;5
96;16.08.2013;2013;08;09;Perjantai;49;60;109;3;7;10
96;16.08.2013;2013;08;10;Perjantai;35;49;84;5;9;14
96;16.08.2013;2013;08;11;Perjantai;36;69;105;7;6;13
96;16.08.2013;2013;08;12;Perjantai;58;85;143;11;17;28
96;16.08.2013;2013;08;13;Perjantai;62;110;172;1;8;9
96;16.08.2013;2013;08;14;Perjantai;89;121;210;10;12;22
96;16.08.2013;2013;08;15;Perjantai;96;167;263;11;13;24
96;16.08.2013;2013;08;16;Perjantai;82;100;182;5;9;14
96;16.08.2013;2013;08;17;Perjantai;51;73;124;9;9;18
96;16.08.2013;2013;08;18;Perjantai;54;60;114;9;13;22
96;16.08.2013;2013;08;19;Perjantai;57;63;120;7;16;23
96;16.08.2013;2013;08;20;Perjantai;40;51;91;8;6;14
96;16.08.2013;2013;08;21;Perjantai;46;34;80;5;6;11
96;16.08.2013;2013;08;22;Perjantai;18;31;49;4;4;8
96;16.08.2013;2013;08;23;Perjantai;24;25;49;5;4;9
96;17.08.2013;2013;08;00;Lauantai;22;17;39;3;2;5
96;17.08.2013;2013;08;01;Lauantai;24;5;29;4;3;7
96;17.08.2013;2013;08;02;Lauantai;12;6;18;3;0;3
96;17.08.2013;2013;08;03;Lauantai;22;0;22;0;2;2
96;17.08.2013;2013;08;04;Lauantai;7;3;10;3;2;5
96;17.08.2013;2013;08;05;Lauantai;2;3;5;1;1;2
96;17.08.2013;2013;08;06;Lauantai;17;15;32;2;0;2
96;17.08.2013;2013;08;07;Lauantai;8;15;23;0;2;2
96;17.08.2013;2013;08;08;Lauantai;11;21;32;5;2;7
96;17.08.2013;2013;08;09;Lauantai;22;49;71;2;5;7
96;17.08.2013;2013;08;10;Lauantai;39;72;111;3;6;9
96;17.08.2013;2013;08;11;Lauantai;48;79;127;6;11;17
96;17.08.2013;2013;08;12;Lauantai;61;50;111;7;6;13
96;17.08.2013;2013;08;13;Lauantai;56;61;117;5;6;11
96;17.08.2013;2013;08;14;Lauantai;72;59;131;5;7;12
96;17.08.2013;2013;08;15;Lauantai;52;41;93;2;4;6
96;17.08.2013;2013;08;16;Lauantai;27;20;47;4;2;6
96;17.08.2013;2013;08;17;Lauantai;22;18;40;7;8;15
96;17.08.2013;2013;08;18;Lauantai;24;9;33;8;2;10
96;17.08.2013;2013;08;19;Lauantai;12;7;19;5;6;11
96;17.08.2013;2013;08;20;Lauantai;8;24;32;2;7;9
96;17.08.2013;2013;08;21;Lauantai;8;24;32;8;11;19
96;17.08.2013;2013;08;22;Lauantai;5;10;15;3;6;9
96;17.08.2013;2013;08;23;Lauantai;6;11;17;1;0;1
96;18.08.2013;2013;08;00;Sunnuntai;4;9;13;2;1;3
96;18.08.2013;2013;08;01;Sunnuntai;9;0;9;6;1;7
96;18.08.2013;2013;08;02;Sunnuntai;20;0;20;2;0;2
96;18.08.2013;2013;08;03;Sunnuntai;11;3;14;3;1;4
96;18.08.2013;2013;08;04;Sunnuntai;8;0;8;1;0;1
96;18.08.2013;2013;08;05;Sunnuntai;5;1;6;0;0;0
96;18.08.2013;2013;08;06;Sunnuntai;12;11;23;0;2;2
96;18.08.2013;2013;08;07;Sunnuntai;4;11;15;2;0;2
96;18.08.2013;2013;08;08;Sunnuntai;8;10;18;4;2;6
96;18.08.2013;2013;08;09;Sunnuntai;4;13;17;8;5;13
96;18.08.2013;2013;08;10;Sunnuntai;19;27;46;7;9;16
96;18.08.2013;2013;08;11;Sunnuntai;23;45;68;5;11;16
96;18.08.2013;2013;08;12;Sunnuntai;52;57;109;7;12;19
96;18.08.2013;2013;08;13;Sunnuntai;57;73;130;5;10;15
96;18.08.2013;2013;08;14;Sunnuntai;56;55;111;6;5;11
96;18.08.2013;2013;08;15;Sunnuntai;66;70;136;3;7;10
96;18.08.2013;2013;08;16;Sunnuntai;47;59;106;10;17;27
96;18.08.2013;2013;08;17;Sunnuntai;72;40;112;31;11;42
96;18.08.2013;2013;08;18;Sunnuntai;70;54;124;18;13;31
96;18.08.2013;2013;08;19;Sunnuntai;36;65;101;20;29;49
96;18.08.2013;2013;08;20;Sunnuntai;41;54;95;14;13;27
96;18.08.2013;2013;08;21;Sunnuntai;30;32;62;3;12;15
96;18.08.2013;2013;08;22;Sunnuntai;12;11;23;3;2;5
96;18.08.2013;2013;08;23;Sunnuntai;7;1;8;1;2;3
96;19.08.2013;2013;08;00;Maanantai;3;1;4;1;0;1
96;19.08.2013;2013;08;01;Maanantai;3;2;5;0;0;0
96;19.08.2013;2013;08;02;Maanantai;4;0;4;0;0;0
96;19.08.2013;2013;08;03;Maanantai;2;1;3;0;0;0
96;19.08.2013;2013;08;04;Maanantai;6;1;7;0;0;0
96;19.08.2013;2013;08;05;Maanantai;6;5;11;1;0;1
96;19.08.2013;2013;08;06;Maanantai;41;59;100;4;2;6
96;19.08.2013;2013;08;07;Maanantai;101;140;241;6;5;11
96;19.08.2013;2013;08;08;Maanantai;78;146;224;7;4;11
96;19.08.2013;2013;08;09;Maanantai;75;91;166;13;5;18
96;19.08.2013;2013;08;10;Maanantai;29;65;94;6;5;11
96;19.08.2013;2013;08;11;Maanantai;44;40;84;10;4;14
96;19.08.2013;2013;08;12;Maanantai;38;33;71;1;7;8
96;19.08.2013;2013;08;13;Maanantai;51;36;87;2;8;10
96;19.08.2013;2013;08;14;Maanantai;68;113;181;3;11;14
96;19.08.2013;2013;08;15;Maanantai;85;215;300;9;15;24
96;19.08.2013;2013;08;16;Maanantai;128;166;294;8;20;28
96;19.08.2013;2013;08;17;Maanantai;81;69;150;13;20;33
96;19.08.2013;2013;08;18;Maanantai;71;67;138;4;19;23
96;19.08.2013;2013;08;19;Maanantai;65;46;111;9;14;23
96;19.08.2013;2013;08;20;Maanantai;56;25;81;10;12;22
96;19.08.2013;2013;08;21;Maanantai;21;33;54;5;10;15
96;19.08.2013;2013;08;22;Maanantai;12;10;22;3;8;11
96;19.08.2013;2013;08;23;Maanantai;4;2;6;1;2;3
96;20.08.2013;2013;08;00;Tiistai;5;2;7;0;0;0
96;20.08.2013;2013;08;01;Tiistai;1;0;1;0;0;0
96;20.08.2013;2013;08;02;Tiistai;1;0;1;0;0;0
96;20.08.2013;2013;08;03;Tiistai;2;1;3;0;0;0
96;20.08.2013;2013;08;04;Tiistai;1;3;4;0;0;0
96;20.08.2013;2013;08;05;Tiistai;6;6;12;0;0;0
96;20.08.2013;2013;08;06;Tiistai;50;48;98;5;7;12
96;20.08.2013;2013;08;07;Tiistai;112;187;299;11;4;15
96;20.08.2013;2013;08;08;Tiistai;102;200;302;9;5;14
96;20.08.2013;2013;08;09;Tiistai;55;87;142;9;14;23
96;20.08.2013;2013;08;10;Tiistai;39;70;109;4;4;8
96;20.08.2013;2013;08;11;Tiistai;62;73;135;6;6;12
96;20.08.2013;2013;08;12;Tiistai;70;80;150;10;8;18
96;20.08.2013;2013;08;13;Tiistai;92;99;191;9;5;14
96;20.08.2013;2013;08;14;Tiistai;124;128;252;6;20;26
96;20.08.2013;2013;08;15;Tiistai;139;223;362;10;26;36
96;20.08.2013;2013;08;16;Tiistai;211;168;379;8;22;30
96;20.08.2013;2013;08;17;Tiistai;110;111;221;13;7;20
96;20.08.2013;2013;08;18;Tiistai;88;81;169;22;17;39
96;20.08.2013;2013;08;19;Tiistai;95;66;161;16;16;32
96;20.08.2013;2013;08;20;Tiistai;81;56;137;15;20;35
96;20.08.2013;2013;08;21;Tiistai;34;33;67;10;7;17
96;20.08.2013;2013;08;22;Tiistai;9;6;15;1;1;2
96;20.08.2013;2013;08;23;Tiistai;12;5;17;0;1;1
96;21.08.2013;2013;08;00;Keskiviikko;10;2;12;0;1;1
96;21.08.2013;2013;08;01;Keskiviikko;1;0;1;0;0;0
96;21.08.2013;2013;08;02;Keskiviikko;3;0;3;1;1;2
96;21.08.2013;2013;08;03;Keskiviikko;5;1;6;0;0;0
96;21.08.2013;2013;08;04;Keskiviikko;3;3;6;0;1;1
96;21.08.2013;2013;08;05;Keskiviikko;4;7;11;0;0;0
96;21.08.2013;2013;08;06;Keskiviikko;39;61;100;1;2;3
96;21.08.2013;2013;08;07;Keskiviikko;130;208;338;12;5;17
96;21.08.2013;2013;08;08;Keskiviikko;98;159;257;8;10;18
96;21.08.2013;2013;08;09;Keskiviikko;66;92;158;11;3;14
96;21.08.2013;2013;08;10;Keskiviikko;37;61;98;6;7;13
96;21.08.2013;2013;08;11;Keskiviikko;52;79;131;15;9;24
96;21.08.2013;2013;08;12;Keskiviikko;69;98;167;7;10;17
96;21.08.2013;2013;08;13;Keskiviikko;72;98;170;8;9;17
96;21.08.2013;2013;08;14;Keskiviikko;113;137;250;11;19;30
96;21.08.2013;2013;08;15;Keskiviikko;156;227;383;8;19;27
96;21.08.2013;2013;08;16;Keskiviikko;169;180;349;5;23;28
96;21.08.2013;2013;08;17;Keskiviikko;107;88;195;12;8;20
96;21.08.2013;2013;08;18;Keskiviikko;132;77;209;21;10;31
96;21.08.2013;2013;08;19;Keskiviikko;74;54;128;14;6;20
96;21.08.2013;2013;08;20;Keskiviikko;54;55;109;7;15;22
96;21.08.2013;2013;08;21;Keskiviikko;33;63;96;7;7;14
96;21.08.2013;2013;08;22;Keskiviikko;10;19;29;2;2;4
96;21.08.2013;2013;08;23;Keskiviikko;14;3;17;0;1;1
96;22.08.2013;2013;08;00;Torstai;4;0;4;1;0;1
96;22.08.2013;2013;08;01;Torstai;3;1;4;0;0;0
96;22.08.2013;2013;08;02;Torstai;3;0;3;0;0;0
96;22.08.2013;2013;08;03;Torstai;0;1;1;0;0;0
96;22.08.2013;2013;08;04;Torstai;2;4;6;0;1;1
96;22.08.2013;2013;08;05;Torstai;4;9;13;0;0;0
96;22.08.2013;2013;08;06;Torstai;46;51;97;2;1;3
96;22.08.2013;2013;08;07;Torstai;137;157;294;13;12;25
96;22.08.2013;2013;08;08;Torstai;119;166;285;10;10;20
96;22.08.2013;2013;08;09;Torstai;73;89;162;13;6;19
96;22.08.2013;2013;08;10;Torstai;56;56;112;8;4;12
96;22.08.2013;2013;08;11;Torstai;51;70;121;7;10;17
96;22.08.2013;2013;08;12;Torstai;79;74;153;10;9;19
96;22.08.2013;2013;08;13;Torstai;81;96;177;5;14;19
96;22.08.2013;2013;08;14;Torstai;104;107;211;3;6;9
96;22.08.2013;2013;08;15;Torstai;136;227;363;6;31;37
96;22.08.2013;2013;08;16;Torstai;173;188;361;7;20;27
96;22.08.2013;2013;08;17;Torstai;117;101;218;10;14;24
96;22.08.2013;2013;08;18;Torstai;70;93;163;18;14;32
96;22.08.2013;2013;08;19;Torstai;95;57;152;14;9;23
96;22.08.2013;2013;08;20;Torstai;69;48;117;11;11;22
96;22.08.2013;2013;08;21;Torstai;29;38;67;0;9;9
96;22.08.2013;2013;08;22;Torstai;29;4;33;3;3;6
96;22.08.2013;2013;08;23;Torstai;12;4;16;2;0;2
96;23.08.2013;2013;08;00;Perjantai;7;3;10;1;1;2
96;23.08.2013;2013;08;01;Perjantai;8;0;8;0;0;0
96;23.08.2013;2013;08;02;Perjantai;4;2;6;0;0;0
96;23.08.2013;2013;08;03;Perjantai;1;3;4;0;0;0
96;23.08.2013;2013;08;04;Perjantai;3;3;6;0;0;0
96;23.08.2013;2013;08;05;Perjantai;4;8;12;0;0;0
96;23.08.2013;2013;08;06;Perjantai;42;54;96;5;8;13
96;23.08.2013;2013;08;07;Perjantai;114;148;262;6;4;10
96;23.08.2013;2013;08;08;Perjantai;84;147;231;6;6;12
96;23.08.2013;2013;08;09;Perjantai;55;93;148;10;6;16
96;23.08.2013;2013;08;10;Perjantai;30;74;104;4;7;11
96;23.08.2013;2013;08;11;Perjantai;61;76;137;7;5;12
96;23.08.2013;2013;08;12;Perjantai;87;87;174;4;11;15
96;23.08.2013;2013;08;13;Perjantai;100;119;219;2;4;6
96;23.08.2013;2013;08;14;Perjantai;117;171;288;6;17;23
96;23.08.2013;2013;08;15;Perjantai;136;156;292;8;15;23
96;23.08.2013;2013;08;16;Perjantai;131;93;224;9;11;20
96;23.08.2013;2013;08;17;Perjantai;81;72;153;8;6;14
96;23.08.2013;2013;08;18;Perjantai;58;91;149;6;3;9
96;23.08.2013;2013;08;19;Perjantai;37;52;89;7;9;16
96;23.08.2013;2013;08;20;Perjantai;54;54;108;8;6;14
96;23.08.2013;2013;08;21;Perjantai;59;40;99;5;6;11
96;23.08.2013;2013;08;22;Perjantai;42;15;57;5;1;6
96;23.08.2013;2013;08;23;Perjantai;18;17;35;1;0;1
96;24.08.2013;2013;08;00;Lauantai;17;5;22;2;3;5
96;24.08.2013;2013;08;01;Lauantai;12;2;14;1;1;2
96;24.08.2013;2013;08;02;Lauantai;16;3;19;5;0;5
96;24.08.2013;2013;08;03;Lauantai;18;1;19;1;0;1
96;24.08.2013;2013;08;04;Lauantai;11;1;12;3;0;3
96;24.08.2013;2013;08;05;Lauantai;2;1;3;0;0;0
96;24.08.2013;2013;08;06;Lauantai;13;5;18;2;0;2
96;24.08.2013;2013;08;07;Lauantai;5;17;22;0;3;3
96;24.08.2013;2013;08;08;Lauantai;11;18;29;1;0;1
96;24.08.2013;2013;08;09;Lauantai;13;39;52;1;8;9
96;24.08.2013;2013;08;10;Lauantai;33;42;75;4;4;8
96;24.08.2013;2013;08;11;Lauantai;34;66;100;3;3;6
96;24.08.2013;2013;08;12;Lauantai;59;69;128;5;12;17
96;24.08.2013;2013;08;13;Lauantai;52;69;121;8;8;16
96;24.08.2013;2013;08;14;Lauantai;59;50;109;6;6;12
96;24.08.2013;2013;08;15;Lauantai;63;95;158;7;9;16
96;24.08.2013;2013;08;16;Lauantai;60;60;120;10;12;22
96;24.08.2013;2013;08;17;Lauantai;66;58;124;16;7;23
96;24.08.2013;2013;08;18;Lauantai;94;51;145;15;8;23
96;24.08.2013;2013;08;19;Lauantai;39;46;85;3;9;12
96;24.08.2013;2013;08;20;Lauantai;28;36;64;4;6;10
96;24.08.2013;2013;08;21;Lauantai;21;45;66;6;4;10
96;24.08.2013;2013;08;22;Lauantai;11;25;36;0;1;1
96;24.08.2013;2013;08;23;Lauantai;14;17;31;1;0;1
96;25.08.2013;2013;08;00;Sunnuntai;15;7;22;1;3;4
96;25.08.2013;2013;08;01;Sunnuntai;15;3;18;1;0;1
96;25.08.2013;2013;08;02;Sunnuntai;18;0;18;0;2;2
96;25.08.2013;2013;08;03;Sunnuntai;15;2;17;2;0;2
96;25.08.2013;2013;08;04;Sunnuntai;17;0;17;1;0;1
96;25.08.2013;2013;08;05;Sunnuntai;6;1;7;0;1;1
96;25.08.2013;2013;08;06;Sunnuntai;10;7;17;2;1;3
96;25.08.2013;2013;08;07;Sunnuntai;6;7;13;1;4;5
96;25.08.2013;2013;08;08;Sunnuntai;6;12;18;2;1;3
96;25.08.2013;2013;08;09;Sunnuntai;5;19;24;1;5;6
96;25.08.2013;2013;08;10;Sunnuntai;15;21;36;6;4;10
96;25.08.2013;2013;08;11;Sunnuntai;22;50;72;10;10;20
96;25.08.2013;2013;08;12;Sunnuntai;52;58;110;4;9;13
96;25.08.2013;2013;08;13;Sunnuntai;68;60;128;8;5;13
96;25.08.2013;2013;08;14;Sunnuntai;63;67;130;7;10;17
96;25.08.2013;2013;08;15;Sunnuntai;51;67;118;4;12;16
96;25.08.2013;2013;08;16;Sunnuntai;46;65;111;12;8;20
96;25.08.2013;2013;08;17;Sunnuntai;102;68;170;24;13;37
96;25.08.2013;2013;08;18;Sunnuntai;71;42;113;14;10;24
96;25.08.2013;2013;08;19;Sunnuntai;48;59;107;21;15;36
96;25.08.2013;2013;08;20;Sunnuntai;33;46;79;8;17;25
96;25.08.2013;2013;08;21;Sunnuntai;27;53;80;5;4;9
96;25.08.2013;2013;08;22;Sunnuntai;11;18;29;2;2;4
96;25.08.2013;2013;08;23;Sunnuntai;13;8;21;2;3;5
96;26.08.2013;2013;08;00;Maanantai;11;1;12;0;0;0
96;26.08.2013;2013;08;01;Maanantai;3;3;6;0;0;0
96;26.08.2013;2013;08;02;Maanantai;6;1;7;0;0;0
96;26.08.2013;2013;08;03;Maanantai;1;0;1;0;0;0
96;26.08.2013;2013;08;04;Maanantai;4;4;8;0;0;0
96;26.08.2013;2013;08;05;Maanantai;4;7;11;1;1;2
96;26.08.2013;2013;08;06;Maanantai;52;41;93;1;5;6
96;26.08.2013;2013;08;07;Maanantai;120;168;288;8;5;13
96;26.08.2013;2013;08;08;Maanantai;149;176;325;12;10;22
96;26.08.2013;2013;08;09;Maanantai;69;108;177;18;2;20
96;26.08.2013;2013;08;10;Maanantai;48;66;114;4;4;8
96;26.08.2013;2013;08;11;Maanantai;70;97;167;4;6;10
96;26.08.2013;2013;08;12;Maanantai;88;98;186;8;9;17
96;26.08.2013;2013;08;13;Maanantai;113;104;217;4;15;19
96;26.08.2013;2013;08;14;Maanantai;147;151;298;11;12;23
96;26.08.2013;2013;08;15;Maanantai;145;244;389;8;24;32
96;26.08.2013;2013;08;16;Maanantai;193;213;406;13;18;31
96;26.08.2013;2013;08;17;Maanantai;107;102;209;13;14;27
96;26.08.2013;2013;08;18;Maanantai;106;68;174;14;5;19
96;26.08.2013;2013;08;19;Maanantai;82;48;130;14;21;35
96;26.08.2013;2013;08;20;Maanantai;61;47;108;9;9;18
96;26.08.2013;2013;08;21;Maanantai;28;41;69;7;7;14
96;26.08.2013;2013;08;22;Maanantai;12;13;25;5;3;8
96;26.08.2013;2013;08;23;Maanantai;7;4;11;0;0;0
96;27.08.2013;2013;08;00;Tiistai;6;2;8;0;1;1
96;27.08.2013;2013;08;01;Tiistai;1;0;1;0;0;0
96;27.08.2013;2013;08;02;Tiistai;4;0;4;1;0;1
96;27.08.2013;2013;08;03;Tiistai;0;0;0;0;0;0
96;27.08.2013;2013;08;04;Tiistai;4;3;7;0;0;0
96;27.08.2013;2013;08;05;Tiistai;9;9;18;0;0;0
96;27.08.2013;2013;08;06;Tiistai;47;46;93;1;3;4
96;27.08.2013;2013;08;07;Tiistai;147;198;345;16;10;26
96;27.08.2013;2013;08;08;Tiistai;123;200;323;9;7;16
96;27.08.2013;2013;08;09;Tiistai;72;112;184;9;11;20
96;27.08.2013;2013;08;10;Tiistai;55;91;146;5;8;13
96;27.08.2013;2013;08;11;Tiistai;74;104;178;8;6;14
96;27.08.2013;2013;08;12;Tiistai;98;80;178;7;12;19
96;27.08.2013;2013;08;13;Tiistai;96;82;178;11;10;21
96;27.08.2013;2013;08;14;Tiistai;154;148;302;7;16;23
96;27.08.2013;2013;08;15;Tiistai;176;267;443;8;26;34
96;27.08.2013;2013;08;16;Tiistai;195;201;396;11;12;23
96;27.08.2013;2013;08;17;Tiistai;124;106;230;11;8;19
96;27.08.2013;2013;08;18;Tiistai;90;97;187;16;10;26
96;27.08.2013;2013;08;19;Tiistai;98;69;167;18;10;28
96;27.08.2013;2013;08;20;Tiistai;68;42;110;9;8;17
96;27.08.2013;2013;08;21;Tiistai;36;39;75;4;7;11
96;27.08.2013;2013;08;22;Tiistai;17;13;30;2;3;5
96;27.08.2013;2013;08;23;Tiistai;9;1;10;4;4;8
96;28.08.2013;2013;08;00;Keskiviikko;4;4;8;1;2;3
96;28.08.2013;2013;08;01;Keskiviikko;3;2;5;0;0;0
96;28.08.2013;2013;08;02;Keskiviikko;0;1;1;0;0;0
96;28.08.2013;2013;08;03;Keskiviikko;0;0;0;0;0;0
96;28.08.2013;2013;08;04;Keskiviikko;1;4;5;0;0;0
96;28.08.2013;2013;08;05;Keskiviikko;4;11;15;0;0;0
96;28.08.2013;2013;08;06;Keskiviikko;58;47;105;3;3;6
96;28.08.2013;2013;08;07;Keskiviikko;146;191;337;10;5;15
96;28.08.2013;2013;08;08;Keskiviikko;141;197;338;16;8;24
96;28.08.2013;2013;08;09;Keskiviikko;77;123;200;15;8;23
96;28.08.2013;2013;08;10;Keskiviikko;40;84;124;7;8;15
96;28.08.2013;2013;08;11;Keskiviikko;75;96;171;6;11;17
96;28.08.2013;2013;08;12;Keskiviikko;90;95;185;4;12;16
96;28.08.2013;2013;08;13;Keskiviikko;92;99;191;8;10;18
96;28.08.2013;2013;08;14;Keskiviikko;116;158;274;11;13;24
96;28.08.2013;2013;08;15;Keskiviikko;131;222;353;7;22;29
96;28.08.2013;2013;08;16;Keskiviikko;154;202;356;12;15;27
96;28.08.2013;2013;08;17;Keskiviikko;104;109;213;11;10;21
96;28.08.2013;2013;08;18;Keskiviikko;123;86;209;25;12;37
96;28.08.2013;2013;08;19;Keskiviikko;85;61;146;14;17;31
96;28.08.2013;2013;08;20;Keskiviikko;54;55;109;7;14;21
96;28.08.2013;2013;08;21;Keskiviikko;43;53;96;2;8;10
96;28.08.2013;2013;08;22;Keskiviikko;18;10;28;1;1;2
96;28.08.2013;2013;08;23;Keskiviikko;10;13;23;0;4;4
96;29.08.2013;2013;08;00;Torstai;9;6;15;0;1;1
96;29.08.2013;2013;08;01;Torstai;11;1;12;0;1;1
96;29.08.2013;2013;08;02;Torstai;6;1;7;0;0;0
96;29.08.2013;2013;08;03;Torstai;13;1;14;0;0;0
96;29.08.2013;2013;08;04;Torstai;13;3;16;0;0;0
96;29.08.2013;2013;08;05;Torstai;11;11;22;2;0;2
96;29.08.2013;2013;08;06;Torstai;47;42;89;4;1;5
96;29.08.2013;2013;08;07;Torstai;131;167;298;12;9;21
96;29.08.2013;2013;08;08;Torstai;159;172;331;12;7;19
96;29.08.2013;2013;08;09;Torstai;77;117;194;12;10;22
96;29.08.2013;2013;08;10;Torstai;55;70;125;7;9;16
96;29.08.2013;2013;08;11;Torstai;71;92;163;9;11;20
96;29.08.2013;2013;08;12;Torstai;75;101;176;10;13;23
96;29.08.2013;2013;08;13;Torstai;96;112;208;5;7;12
96;29.08.2013;2013;08;14;Torstai;99;164;263;4;17;21
96;29.08.2013;2013;08;15;Torstai;142;261;403;16;18;34
96;29.08.2013;2013;08;16;Torstai;161;187;348;13;16;29
96;29.08.2013;2013;08;17;Torstai;119;102;221;8;7;15
96;29.08.2013;2013;08;18;Torstai;94;145;239;4;29;33
96;29.08.2013;2013;08;19;Torstai;72;31;103;17;9;26
96;29.08.2013;2013;08;20;Torstai;157;37;194;31;21;52
96;29.08.2013;2013;08;21;Torstai;27;39;66;11;5;16
96;29.08.2013;2013;08;22;Torstai;8;12;20;0;4;4
96;29.08.2013;2013;08;23;Torstai;8;1;9;0;0;0
96;30.08.2013;2013;08;00;Perjantai;8;1;9;0;0;0
96;30.08.2013;2013;08;01;Perjantai;9;1;10;1;2;3
96;30.08.2013;2013;08;02;Perjantai;5;0;5;0;0;0
96;30.08.2013;2013;08;03;Perjantai;3;1;4;0;0;0
96;30.08.2013;2013;08;04;Perjantai;2;3;5;0;0;0
96;30.08.2013;2013;08;05;Perjantai;3;9;12;0;0;0
96;30.08.2013;2013;08;06;Perjantai;50;42;92;4;3;7
96;30.08.2013;2013;08;07;Perjantai;118;142;260;9;8;17
96;30.08.2013;2013;08;08;Perjantai;155;176;331;13;7;20
96;30.08.2013;2013;08;09;Perjantai;65;100;165;9;15;24
96;30.08.2013;2013;08;10;Perjantai;50;74;124;9;11;20
96;30.08.2013;2013;08;11;Perjantai;63;100;163;8;16;24
96;30.08.2013;2013;08;12;Perjantai;107;130;237;2;11;13
96;30.08.2013;2013;08;13;Perjantai;99;146;245;5;12;17
96;30.08.2013;2013;08;14;Perjantai;174;179;353;7;12;19
96;30.08.2013;2013;08;15;Perjantai;129;188;317;4;17;21
96;30.08.2013;2013;08;16;Perjantai;111;128;239;11;12;23
96;30.08.2013;2013;08;17;Perjantai;85;76;161;6;9;15
96;30.08.2013;2013;08;18;Perjantai;64;148;212;13;21;34
96;30.08.2013;2013;08;19;Perjantai;42;38;80;10;9;19
96;30.08.2013;2013;08;20;Perjantai;130;41;171;21;12;33
96;30.08.2013;2013;08;21;Perjantai;47;41;88;7;2;9
96;30.08.2013;2013;08;22;Perjantai;11;21;32;1;3;4
96;30.08.2013;2013;08;23;Perjantai;10;14;24;2;1;3
96;31.08.2013;2013;08;00;Lauantai;25;5;30;2;0;2
96;31.08.2013;2013;08;01;Lauantai;11;8;19;2;0;2
96;31.08.2013;2013;08;02;Lauantai;18;1;19;1;0;1
96;31.08.2013;2013;08;03;Lauantai;20;1;21;4;1;5
96;31.08.2013;2013;08;04;Lauantai;17;2;19;1;0;1
96;31.08.2013;2013;08;05;Lauantai;2;4;6;0;0;0
96;31.08.2013;2013;08;06;Lauantai;21;8;29;2;1;3
96;31.08.2013;2013;08;07;Lauantai;7;18;25;0;2;2
96;31.08.2013;2013;08;08;Lauantai;11;24;35;4;2;6
96;31.08.2013;2013;08;09;Lauantai;13;40;53;2;5;7
96;31.08.2013;2013;08;10;Lauantai;30;59;89;4;10;14
96;31.08.2013;2013;08;11;Lauantai;36;47;83;3;7;10
96;31.08.2013;2013;08;12;Lauantai;55;55;110;6;4;10
96;31.08.2013;2013;08;13;Lauantai;70;87;157;4;5;9
96;31.08.2013;2013;08;14;Lauantai;63;92;155;7;10;17
96;31.08.2013;2013;08;15;Lauantai;72;76;148;7;15;22
96;31.08.2013;2013;08;16;Lauantai;59;72;131;10;15;25
96;31.08.2013;2013;08;17;Lauantai;72;52;124;14;6;20
96;31.08.2013;2013;08;18;Lauantai;50;46;96;13;9;22
96;31.08.2013;2013;08;19;Lauantai;61;29;90;16;15;31
96;31.08.2013;2013;08;20;Lauantai;25;35;60;5;8;13
96;31.08.2013;2013;08;21;Lauantai;30;49;79;1;4;5
96;31.08.2013;2013;08;22;Lauantai;20;15;35;2;1;3
96;31.08.2013;2013;08;23;Lauantai;8;11;19;3;3;6
96;01.09.2013;2013;09;00;Sunnuntai;13;13;26;2;0;2
96;01.09.2013;2013;09;01;Sunnuntai;17;4;21;0;0;0
96;01.09.2013;2013;09;02;Sunnuntai;19;4;23;1;0;1
96;01.09.2013;2013;09;03;Sunnuntai;14;2;16;2;0;2
96;01.09.2013;2013;09;04;Sunnuntai;13;3;16;0;1;1
96;01.09.2013;2013;09;05;Sunnuntai;8;1;9;2;1;3
96;01.09.2013;2013;09;06;Sunnuntai;12;3;15;2;0;2
96;01.09.2013;2013;09;07;Sunnuntai;6;12;18;0;0;0
96;01.09.2013;2013;09;08;Sunnuntai;7;14;21;3;2;5
96;01.09.2013;2013;09;09;Sunnuntai;12;41;53;3;7;10
96;01.09.2013;2013;09;10;Sunnuntai;39;46;85;7;10;17
96;01.09.2013;2013;09;11;Sunnuntai;47;63;110;11;10;21
96;01.09.2013;2013;09;12;Sunnuntai;48;70;118;11;12;23
96;01.09.2013;2013;09;13;Sunnuntai;52;69;121;8;9;17
96;01.09.2013;2013;09;14;Sunnuntai;56;34;90;11;12;23
96;01.09.2013;2013;09;15;Sunnuntai;50;68;118;7;13;20
96;01.09.2013;2013;09;16;Sunnuntai;90;66;156;21;10;31
96;01.09.2013;2013;09;17;Sunnuntai;37;57;94;18;8;26
96;01.09.2013;2013;09;18;Sunnuntai;80;62;142;12;16;28
96;01.09.2013;2013;09;19;Sunnuntai;31;33;64;15;16;31
96;01.09.2013;2013;09;20;Sunnuntai;31;47;78;12;17;29
96;01.09.2013;2013;09;21;Sunnuntai;25;38;63;10;5;15
96;01.09.2013;2013;09;22;Sunnuntai;15;7;22;5;7;12
96;01.09.2013;2013;09;23;Sunnuntai;6;3;9;2;0;2
96;02.09.2013;2013;09;00;Maanantai;7;6;13;2;0;2
96;02.09.2013;2013;09;01;Maanantai;3;1;4;1;0;1
96;02.09.2013;2013;09;02;Maanantai;0;1;1;1;0;1
96;02.09.2013;2013;09;03;Maanantai;2;1;3;1;0;1
96;02.09.2013;2013;09;04;Maanantai;1;2;3;0;0;0
96;02.09.2013;2013;09;05;Maanantai;3;5;8;0;0;0
96;02.09.2013;2013;09;06;Maanantai;40;33;73;4;2;6
96;02.09.2013;2013;09;07;Maanantai;99;120;219;17;2;19
96;02.09.2013;2013;09;08;Maanantai;141;113;254;10;4;14
96;02.09.2013;2013;09;09;Maanantai;48;76;124;11;7;18
96;02.09.2013;2013;09;10;Maanantai;47;51;98;10;5;15
96;02.09.2013;2013;09;11;Maanantai;30;63;93;2;9;11
96;02.09.2013;2013;09;12;Maanantai;75;70;145;5;14;19
96;02.09.2013;2013;09;13;Maanantai;60;76;136;8;8;16
96;02.09.2013;2013;09;14;Maanantai;91;148;239;13;14;27
96;02.09.2013;2013;09;15;Maanantai;103;203;306;11;16;27
96;02.09.2013;2013;09;16;Maanantai;130;180;310;12;22;34
96;02.09.2013;2013;09;17;Maanantai;66;109;175;21;11;32
96;02.09.2013;2013;09;18;Maanantai;83;74;157;9;16;25
96;02.09.2013;2013;09;19;Maanantai;74;57;131;10;18;28
96;02.09.2013;2013;09;20;Maanantai;72;48;120;15;13;28
96;02.09.2013;2013;09;21;Maanantai;26;35;61;7;8;15
96;02.09.2013;2013;09;22;Maanantai;11;11;22;3;5;8
96;02.09.2013;2013;09;23;Maanantai;4;2;6;0;0;0
96;03.09.2013;2013;09;00;Tiistai;1;2;3;0;0;0
96;03.09.2013;2013;09;01;Tiistai;0;0;0;0;0;0
96;03.09.2013;2013;09;02;Tiistai;3;1;4;0;1;1
96;03.09.2013;2013;09;03;Tiistai;1;0;1;0;0;0
96;03.09.2013;2013;09;04;Tiistai;2;2;4;0;0;0
96;03.09.2013;2013;09;05;Tiistai;2;11;13;1;1;2
96;03.09.2013;2013;09;06;Tiistai;46;41;87;6;8;14
96;03.09.2013;2013;09;07;Tiistai;138;182;320;16;7;23
96;03.09.2013;2013;09;08;Tiistai;156;202;358;14;7;21
96;03.09.2013;2013;09;09;Tiistai;82;109;191;9;9;18
96;03.09.2013;2013;09;10;Tiistai;53;89;142;3;10;13
96;03.09.2013;2013;09;11;Tiistai;56;99;155;8;13;21
96;03.09.2013;2013;09;12;Tiistai;90;88;178;11;5;16
96;03.09.2013;2013;09;13;Tiistai;110;73;183;12;9;21
96;03.09.2013;2013;09;14;Tiistai;115;161;276;13;15;28
96;03.09.2013;2013;09;15;Tiistai;131;302;433;10;23;33
96;03.09.2013;2013;09;16;Tiistai;189;198;387;11;16;27
96;03.09.2013;2013;09;17;Tiistai;104;94;198;13;8;21
96;03.09.2013;2013;09;18;Tiistai;71;90;161;12;13;25
96;03.09.2013;2013;09;19;Tiistai;88;73;161;14;19;33
96;03.09.2013;2013;09;20;Tiistai;75;49;124;21;13;34
96;03.09.2013;2013;09;21;Tiistai;46;36;82;7;6;13
96;03.09.2013;2013;09;22;Tiistai;21;14;35;1;2;3
96;03.09.2013;2013;09;23;Tiistai;4;3;7;3;2;5
96;04.09.2013;2013;09;00;Keskiviikko;2;0;2;1;1;2
96;04.09.2013;2013;09;01;Keskiviikko;2;0;2;0;0;0
96;04.09.2013;2013;09;02;Keskiviikko;0;0;0;1;0;1
96;04.09.2013;2013;09;03;Keskiviikko;0;3;3;0;0;0
96;04.09.2013;2013;09;04;Keskiviikko;0;3;3;0;1;1
96;04.09.2013;2013;09;05;Keskiviikko;5;8;13;1;0;1
96;04.09.2013;2013;09;06;Keskiviikko;49;41;90;6;5;11
96;04.09.2013;2013;09;07;Keskiviikko;122;209;331;12;4;16
96;04.09.2013;2013;09;08;Keskiviikko;142;206;348;5;4;9
96;04.09.2013;2013;09;09;Keskiviikko;62;109;171;18;5;23
96;04.09.2013;2013;09;10;Keskiviikko;59;80;139;17;15;32
96;04.09.2013;2013;09;11;Keskiviikko;76;117;193;7;15;22
96;04.09.2013;2013;09;12;Keskiviikko;98;162;260;16;30;46
96;04.09.2013;2013;09;13;Keskiviikko;73;98;171;11;14;25
96;04.09.2013;2013;09;14;Keskiviikko;120;147;267;4;8;12
96;04.09.2013;2013;09;15;Keskiviikko;128;203;331;7;24;31
96;04.09.2013;2013;09;16;Keskiviikko;185;219;404;8;19;27
96;04.09.2013;2013;09;17;Keskiviikko;117;107;224;8;13;21
96;04.09.2013;2013;09;18;Keskiviikko;122;90;212;17;13;30
96;04.09.2013;2013;09;19;Keskiviikko;110;60;170;18;13;31
96;04.09.2013;2013;09;20;Keskiviikko;47;69;116;16;24;40
96;04.09.2013;2013;09;21;Keskiviikko;42;67;109;6;9;15
96;04.09.2013;2013;09;22;Keskiviikko;10;17;27;2;3;5
96;04.09.2013;2013;09;23;Keskiviikko;10;21;31;1;2;3
96;05.09.2013;2013;09;00;Torstai;2;6;8;0;0;0
96;05.09.2013;2013;09;01;Torstai;6;2;8;0;0;0
96;05.09.2013;2013;09;02;Torstai;6;0;6;0;0;0
96;05.09.2013;2013;09;03;Torstai;8;1;9;1;1;2
96;05.09.2013;2013;09;04;Torstai;7;1;8;0;1;1
96;05.09.2013;2013;09;05;Torstai;6;10;16;1;2;3
96;05.09.2013;2013;09;06;Torstai;53;40;93;1;2;3
96;05.09.2013;2013;09;07;Torstai;128;159;287;13;9;22
96;05.09.2013;2013;09;08;Torstai;168;167;335;6;3;9
96;05.09.2013;2013;09;09;Torstai;83;113;196;7;4;11
96;05.09.2013;2013;09;10;Torstai;55;81;136;2;5;7
96;05.09.2013;2013;09;11;Torstai;63;90;153;7;5;12
96;05.09.2013;2013;09;12;Torstai;65;97;162;4;6;10
96;05.09.2013;2013;09;13;Torstai;76;118;194;6;10;16
96;05.09.2013;2013;09;14;Torstai;103;156;259;4;12;16
96;05.09.2013;2013;09;15;Torstai;160;234;394;10;15;25
96;05.09.2013;2013;09;16;Torstai;174;208;382;9;17;26
96;05.09.2013;2013;09;17;Torstai;102;120;222;12;14;26
96;05.09.2013;2013;09;18;Torstai;103;81;184;12;6;18
96;05.09.2013;2013;09;19;Torstai;101;64;165;14;15;29
96;05.09.2013;2013;09;20;Torstai;82;52;134;12;17;29
96;05.09.2013;2013;09;21;Torstai;49;32;81;7;5;12
96;05.09.2013;2013;09;22;Torstai;17;6;23;2;2;4
96;05.09.2013;2013;09;23;Torstai;10;4;14;0;2;2
96;06.09.2013;2013;09;00;Perjantai;4;0;4;0;0;0
96;06.09.2013;2013;09;01;Perjantai;2;0;2;0;0;0
96;06.09.2013;2013;09;02;Perjantai;0;0;0;0;0;0
96;06.09.2013;2013;09;03;Perjantai;1;0;1;0;0;0
96;06.09.2013;2013;09;04;Perjantai;0;1;1;1;0;1
96;06.09.2013;2013;09;05;Perjantai;6;9;15;1;1;2
96;06.09.2013;2013;09;06;Perjantai;39;32;71;1;2;3
96;06.09.2013;2013;09;07;Perjantai;110;149;259;12;3;15
96;06.09.2013;2013;09;08;Perjantai;178;178;356;5;4;9
96;06.09.2013;2013;09;09;Perjantai;58;128;186;8;5;13
96;06.09.2013;2013;09;10;Perjantai;52;81;133;6;10;16
96;06.09.2013;2013;09;11;Perjantai;79;82;161;9;5;14
96;06.09.2013;2013;09;12;Perjantai;92;137;229;5;10;15
96;06.09.2013;2013;09;13;Perjantai;109;115;224;10;10;20
96;06.09.2013;2013;09;14;Perjantai;134;193;327;8;13;21
96;06.09.2013;2013;09;15;Perjantai;135;184;319;11;22;33
96;06.09.2013;2013;09;16;Perjantai;109;110;219;2;8;10
96;06.09.2013;2013;09;17;Perjantai;94;90;184;8;15;23
96;06.09.2013;2013;09;18;Perjantai;68;89;157;13;9;22
96;06.09.2013;2013;09;19;Perjantai;46;49;95;8;5;13
96;06.09.2013;2013;09;20;Perjantai;55;37;92;10;10;20
96;06.09.2013;2013;09;21;Perjantai;54;37;91;12;8;20
96;06.09.2013;2013;09;22;Perjantai;25;29;54;5;1;6
96;06.09.2013;2013;09;23;Perjantai;18;15;33;1;0;1
96;07.09.2013;2013;09;00;Lauantai;12;9;21;1;0;1
96;07.09.2013;2013;09;01;Lauantai;26;4;30;5;1;6
96;07.09.2013;2013;09;02;Lauantai;28;3;31;0;0;0
96;07.09.2013;2013;09;03;Lauantai;21;1;22;0;0;0
96;07.09.2013;2013;09;04;Lauantai;18;2;20;2;1;3
96;07.09.2013;2013;09;05;Lauantai;10;0;10;1;1;2
96;07.09.2013;2013;09;06;Lauantai;12;13;25;0;0;0
96;07.09.2013;2013;09;07;Lauantai;5;16;21;0;1;1
96;07.09.2013;2013;09;08;Lauantai;7;39;46;7;3;10
96;07.09.2013;2013;09;09;Lauantai;12;43;55;3;6;9
96;07.09.2013;2013;09;10;Lauantai;29;58;87;7;9;16
96;07.09.2013;2013;09;11;Lauantai;35;45;80;3;10;13
96;07.09.2013;2013;09;12;Lauantai;56;50;106;7;6;13
96;07.09.2013;2013;09;13;Lauantai;52;63;115;2;12;14
96;07.09.2013;2013;09;14;Lauantai;65;78;143;13;13;26
96;07.09.2013;2013;09;15;Lauantai;62;52;114;10;7;17
96;07.09.2013;2013;09;16;Lauantai;53;64;117;17;9;26
96;07.09.2013;2013;09;17;Lauantai;72;53;125;12;10;22
96;07.09.2013;2013;09;18;Lauantai;70;38;108;16;4;20
96;07.09.2013;2013;09;19;Lauantai;44;28;72;16;9;25
96;07.09.2013;2013;09;20;Lauantai;27;41;68;8;13;21
96;07.09.2013;2013;09;21;Lauantai;29;41;70;4;6;10
96;07.09.2013;2013;09;22;Lauantai;15;15;30;1;1;2
96;07.09.2013;2013;09;23;Lauantai;12;23;35;4;6;10
96;08.09.2013;2013;09;00;Sunnuntai;9;10;19;0;1;1
96;08.09.2013;2013;09;01;Sunnuntai;19;8;27;2;0;2
96;08.09.2013;2013;09;02;Sunnuntai;26;3;29;1;1;2
96;08.09.2013;2013;09;03;Sunnuntai;16;1;17;0;1;1
96;08.09.2013;2013;09;04;Sunnuntai;15;0;15;2;0;2
96;08.09.2013;2013;09;05;Sunnuntai;6;0;6;0;0;0
96;08.09.2013;2013;09;06;Sunnuntai;9;9;18;3;0;3
96;08.09.2013;2013;09;07;Sunnuntai;4;5;9;0;1;1
96;08.09.2013;2013;09;08;Sunnuntai;8;6;14;2;2;4
96;08.09.2013;2013;09;09;Sunnuntai;9;16;25;4;2;6
96;08.09.2013;2013;09;10;Sunnuntai;15;17;32;2;8;10
96;08.09.2013;2013;09;11;Sunnuntai;23;53;76;7;14;21
96;08.09.2013;2013;09;12;Sunnuntai;38;72;110;11;10;21
96;08.09.2013;2013;09;13;Sunnuntai;53;55;108;10;16;26
96;08.09.2013;2013;09;14;Sunnuntai;70;62;132;8;8;16
96;08.09.2013;2013;09;15;Sunnuntai;51;54;105;2;1;3
96;08.09.2013;2013;09;16;Sunnuntai;71;42;113;10;6;16
96;08.09.2013;2013;09;17;Sunnuntai;55;48;103;13;7;20
96;08.09.2013;2013;09;18;Sunnuntai;70;53;123;11;12;23
96;08.09.2013;2013;09;19;Sunnuntai;34;62;96;13;21;34
96;08.09.2013;2013;09;20;Sunnuntai;24;62;86;11;15;26
96;08.09.2013;2013;09;21;Sunnuntai;25;19;44;6;12;18
96;08.09.2013;2013;09;22;Sunnuntai;12;14;26;2;0;2
96;08.09.2013;2013;09;23;Sunnuntai;1;8;9;0;0;0
96;09.09.2013;2013;09;00;Maanantai;3;1;4;3;1;4
96;09.09.2013;2013;09;01;Maanantai;3;1;4;0;0;0
96;09.09.2013;2013;09;02;Maanantai;1;0;1;0;0;0
96;09.09.2013;2013;09;03;Maanantai;2;1;3;0;0;0
96;09.09.2013;2013;09;04;Maanantai;1;2;3;0;0;0
96;09.09.2013;2013;09;05;Maanantai;4;14;18;1;0;1
96;09.09.2013;2013;09;06;Maanantai;23;30;53;2;3;5
96;09.09.2013;2013;09;07;Maanantai;98;101;199;14;8;22
96;09.09.2013;2013;09;08;Maanantai;177;221;398;15;7;22
96;09.09.2013;2013;09;09;Maanantai;71;137;208;5;10;15
96;09.09.2013;2013;09;10;Maanantai;71;123;194;12;7;19
96;09.09.2013;2013;09;11;Maanantai;67;87;154;2;6;8
96;09.09.2013;2013;09;12;Maanantai;105;125;230;2;9;11
96;09.09.2013;2013;09;13;Maanantai;95;108;203;8;13;21
96;09.09.2013;2013;09;14;Maanantai;107;141;248;8;10;18
96;09.09.2013;2013;09;15;Maanantai;152;235;387;16;23;39
96;09.09.2013;2013;09;16;Maanantai;190;229;419;5;17;22
96;09.09.2013;2013;09;17;Maanantai;133;106;239;15;6;21
96;09.09.2013;2013;09;18;Maanantai;118;109;227;17;16;33
96;09.09.2013;2013;09;19;Maanantai;83;61;144;18;19;37
96;09.09.2013;2013;09;20;Maanantai;77;46;123;15;20;35
96;09.09.2013;2013;09;21;Maanantai;51;39;90;8;12;20
96;09.09.2013;2013;09;22;Maanantai;12;17;29;8;4;12
96;09.09.2013;2013;09;23;Maanantai;3;11;14;0;2;2
96;10.09.2013;2013;09;00;Tiistai;1;3;4;0;0;0
96;10.09.2013;2013;09;01;Tiistai;2;0;2;0;1;1
96;10.09.2013;2013;09;02;Tiistai;5;0;5;0;0;0
96;10.09.2013;2013;09;03;Tiistai;4;2;6;0;0;0
96;10.09.2013;2013;09;04;Tiistai;3;0;3;0;0;0
96;10.09.2013;2013;09;05;Tiistai;3;5;8;0;0;0
96;10.09.2013;2013;09;06;Tiistai;52;40;92;6;2;8
96;10.09.2013;2013;09;07;Tiistai;141;171;312;11;10;21
96;10.09.2013;2013;09;08;Tiistai;183;197;380;17;17;34
96;10.09.2013;2013;09;09;Tiistai;64;123;187;15;2;17
96;10.09.2013;2013;09;10;Tiistai;60;88;148;6;12;18
96;10.09.2013;2013;09;11;Tiistai;62;114;176;10;11;21
96;10.09.2013;2013;09;12;Tiistai;76;106;182;15;15;30
96;10.09.2013;2013;09;13;Tiistai;89;109;198;8;12;20
96;10.09.2013;2013;09;14;Tiistai;116;147;263;6;14;20
96;10.09.2013;2013;09;15;Tiistai;159;257;416;8;21;29
96;10.09.2013;2013;09;16;Tiistai;186;181;367;9;18;27
96;10.09.2013;2013;09;17;Tiistai;130;88;218;11;13;24
96;10.09.2013;2013;09;18;Tiistai;97;97;194;15;10;25
96;10.09.2013;2013;09;19;Tiistai;91;84;175;18;16;34
96;10.09.2013;2013;09;20;Tiistai;69;49;118;14;17;31
96;10.09.2013;2013;09;21;Tiistai;35;32;67;6;6;12
96;10.09.2013;2013;09;22;Tiistai;13;20;33;1;0;1
96;10.09.2013;2013;09;23;Tiistai;10;1;11;0;0;0
96;11.09.2013;2013;09;00;Keskiviikko;5;1;6;0;0;0
96;11.09.2013;2013;09;01;Keskiviikko;3;0;3;0;0;0
96;11.09.2013;2013;09;02;Keskiviikko;3;0;3;0;0;0
96;11.09.2013;2013;09;03;Keskiviikko;1;1;2;0;1;1
96;11.09.2013;2013;09;04;Keskiviikko;1;2;3;0;0;0
96;11.09.2013;2013;09;05;Keskiviikko;4;9;13;1;0;1
96;11.09.2013;2013;09;06;Keskiviikko;49;44;93;10;4;14
96;11.09.2013;2013;09;07;Keskiviikko;140;174;314;13;8;21
96;11.09.2013;2013;09;08;Keskiviikko;173;188;361;12;9;21
96;11.09.2013;2013;09;09;Keskiviikko;78;101;179;7;11;18
96;11.09.2013;2013;09;10;Keskiviikko;63;98;161;5;9;14
96;11.09.2013;2013;09;11;Keskiviikko;58;78;136;4;6;10
96;11.09.2013;2013;09;12;Keskiviikko;77;96;173;12;12;24
96;11.09.2013;2013;09;13;Keskiviikko;82;92;174;6;9;15
96;11.09.2013;2013;09;14;Keskiviikko;106;179;285;6;14;20
96;11.09.2013;2013;09;15;Keskiviikko;125;234;359;5;20;25
96;11.09.2013;2013;09;16;Keskiviikko;165;200;365;9;18;27
96;11.09.2013;2013;09;17;Keskiviikko;128;123;251;13;13;26
96;11.09.2013;2013;09;18;Keskiviikko;127;82;209;25;18;43
96;11.09.2013;2013;09;19;Keskiviikko;95;75;170;14;16;30
96;11.09.2013;2013;09;20;Keskiviikko;63;69;132;6;10;16
96;11.09.2013;2013;09;21;Keskiviikko;43;79;122;3;10;13
96;11.09.2013;2013;09;22;Keskiviikko;26;20;46;3;2;5
96;11.09.2013;2013;09;23;Keskiviikko;5;10;15;0;2;2
96;12.09.2013;2013;09;00;Torstai;18;11;29;0;1;1
96;12.09.2013;2013;09;01;Torstai;15;6;21;0;0;0
96;12.09.2013;2013;09;02;Torstai;8;0;8;0;0;0
96;12.09.2013;2013;09;03;Torstai;11;1;12;0;0;0
96;12.09.2013;2013;09;04;Torstai;8;4;12;2;1;3
96;12.09.2013;2013;09;05;Torstai;4;8;12;1;0;1
96;12.09.2013;2013;09;06;Torstai;48;29;77;4;1;5
96;12.09.2013;2013;09;07;Torstai;107;137;244;12;4;16
96;12.09.2013;2013;09;08;Torstai;153;197;350;15;7;22
96;12.09.2013;2013;09;09;Torstai;81;120;201;11;5;16
96;12.09.2013;2013;09;10;Torstai;60;82;142;10;8;18
96;12.09.2013;2013;09;11;Torstai;61;91;152;7;7;14
96;12.09.2013;2013;09;12;Torstai;92;87;179;10;14;24
96;12.09.2013;2013;09;13;Torstai;68;94;162;6;11;17
96;12.09.2013;2013;09;14;Torstai;112;144;256;5;15;20
96;12.09.2013;2013;09;15;Torstai;134;233;367;7;20;27
96;12.09.2013;2013;09;16;Torstai;153;199;352;13;10;23
96;12.09.2013;2013;09;17;Torstai;99;105;204;8;14;22
96;12.09.2013;2013;09;18;Torstai;95;80;175;16;9;25
96;12.09.2013;2013;09;19;Torstai;93;54;147;9;12;21
96;12.09.2013;2013;09;20;Torstai;55;46;101;15;15;30
96;12.09.2013;2013;09;21;Torstai;40;36;76;4;1;5
96;12.09.2013;2013;09;22;Torstai;10;12;22;5;5;10
96;12.09.2013;2013;09;23;Torstai;9;11;20;0;2;2
96;13.09.2013;2013;09;00;Perjantai;8;10;18;0;0;0
96;13.09.2013;2013;09;01;Perjantai;7;2;9;0;0;0
96;13.09.2013;2013;09;02;Perjantai;6;0;6;2;0;2
96;13.09.2013;2013;09;03;Perjantai;5;1;6;0;0;0
96;13.09.2013;2013;09;04;Perjantai;2;1;3;0;0;0
96;13.09.2013;2013;09;05;Perjantai;4;10;14;1;0;1
96;13.09.2013;2013;09;06;Perjantai;43;47;90;4;3;7
96;13.09.2013;2013;09;07;Perjantai;135;151;286;9;14;23
96;13.09.2013;2013;09;08;Perjantai;174;172;346;0;0;0
96;13.09.2013;2013;09;09;Perjantai;77;75;152;0;0;0
96;13.09.2013;2013;09;10;Perjantai;70;68;138;0;0;0
96;13.09.2013;2013;09;11;Perjantai;76;97;173;1;4;5
96;13.09.2013;2013;09;12;Perjantai;76;99;175;8;13;21
96;13.09.2013;2013;09;13;Perjantai;92;113;205;3;10;13
96;13.09.2013;2013;09;14;Perjantai;118;183;301;9;17;26
96;13.09.2013;2013;09;15;Perjantai;141;193;334;7;10;17
96;13.09.2013;2013;09;16;Perjantai;118;107;225;6;19;25
96;13.09.2013;2013;09;17;Perjantai;104;77;181;16;6;22
96;13.09.2013;2013;09;18;Perjantai;57;45;102;9;11;20
96;13.09.2013;2013;09;19;Perjantai;50;57;107;3;5;8
96;13.09.2013;2013;09;20;Perjantai;50;33;83;11;8;19
96;13.09.2013;2013;09;21;Perjantai;25;15;40;8;4;12
96;13.09.2013;2013;09;22;Perjantai;23;15;38;1;5;6
96;13.09.2013;2013;09;23;Perjantai;8;16;24;2;0;2
96;14.09.2013;2013;09;00;Lauantai;6;9;15;0;3;3
96;14.09.2013;2013;09;01;Lauantai;12;3;15;3;1;4
96;14.09.2013;2013;09;02;Lauantai;11;2;13;4;3;7
96;14.09.2013;2013;09;03;Lauantai;9;2;11;0;1;1
96;14.09.2013;2013;09;04;Lauantai;3;4;7;1;0;1
96;14.09.2013;2013;09;05;Lauantai;3;2;5;0;0;0
96;14.09.2013;2013;09;06;Lauantai;19;7;26;1;1;2
96;14.09.2013;2013;09;07;Lauantai;7;14;21;0;4;4
96;14.09.2013;2013;09;08;Lauantai;8;30;38;2;1;3
96;14.09.2013;2013;09;09;Lauantai;22;39;61;3;6;9
96;14.09.2013;2013;09;10;Lauantai;37;58;95;7;6;13
96;14.09.2013;2013;09;11;Lauantai;47;54;101;5;6;11
96;14.09.2013;2013;09;12;Lauantai;56;95;151;6;10;16
96;14.09.2013;2013;09;13;Lauantai;53;75;128;8;4;12
96;14.09.2013;2013;09;14;Lauantai;71;81;152;7;7;14
96;14.09.2013;2013;09;15;Lauantai;76;68;144;10;6;16
96;14.09.2013;2013;09;16;Lauantai;81;61;142;9;10;19
96;14.09.2013;2013;09;17;Lauantai;50;73;123;7;17;24
96;14.09.2013;2013;09;18;Lauantai;69;88;157;10;15;25
96;14.09.2013;2013;09;19;Lauantai;45;39;84;12;7;19
96;14.09.2013;2013;09;20;Lauantai;67;39;106;12;7;19
96;14.09.2013;2013;09;21;Lauantai;32;36;68;7;4;11
96;14.09.2013;2013;09;22;Lauantai;17;9;26;0;2;2
96;14.09.2013;2013;09;23;Lauantai;11;13;24;1;2;3
96;15.09.2013;2013;09;00;Sunnuntai;18;15;33;1;0;1
96;15.09.2013;2013;09;01;Sunnuntai;10;12;22;1;1;2
96;15.09.2013;2013;09;02;Sunnuntai;17;2;19;2;0;2
96;15.09.2013;2013;09;03;Sunnuntai;18;1;19;3;0;3
96;15.09.2013;2013;09;04;Sunnuntai;9;0;9;0;0;0
96;15.09.2013;2013;09;05;Sunnuntai;8;0;8;1;1;2
96;15.09.2013;2013;09;06;Sunnuntai;11;9;20;1;2;3
96;15.09.2013;2013;09;07;Sunnuntai;8;5;13;0;1;1
96;15.09.2013;2013;09;08;Sunnuntai;6;9;15;3;2;5
96;15.09.2013;2013;09;09;Sunnuntai;10;18;28;2;6;8
96;15.09.2013;2013;09;10;Sunnuntai;20;22;42;6;10;16
96;15.09.2013;2013;09;11;Sunnuntai;32;39;71;8;7;15
96;15.09.2013;2013;09;12;Sunnuntai;54;75;129;9;8;17
96;15.09.2013;2013;09;13;Sunnuntai;64;72;136;1;7;8
96;15.09.2013;2013;09;14;Sunnuntai;71;64;135;5;3;8
96;15.09.2013;2013;09;15;Sunnuntai;77;79;156;6;7;13
96;15.09.2013;2013;09;16;Sunnuntai;76;41;117;26;6;32
96;15.09.2013;2013;09;17;Sunnuntai;56;52;108;13;10;23
96;15.09.2013;2013;09;18;Sunnuntai;55;64;119;21;25;46
96;15.09.2013;2013;09;19;Sunnuntai;43;51;94;15;17;32
96;15.09.2013;2013;09;20;Sunnuntai;31;43;74;8;16;24
96;15.09.2013;2013;09;21;Sunnuntai;23;28;51;9;5;14
96;15.09.2013;2013;09;22;Sunnuntai;14;7;21;4;5;9
96;15.09.2013;2013;09;23;Sunnuntai;3;3;6;4;0;4
96;16.09.2013;2013;09;00;Maanantai;11;0;11;1;2;3
96;16.09.2013;2013;09;01;Maanantai;3;1;4;0;0;0
96;16.09.2013;2013;09;02;Maanantai;0;0;0;1;0;1
96;16.09.2013;2013;09;03;Maanantai;0;1;1;0;1;1
96;16.09.2013;2013;09;04;Maanantai;1;1;2;0;0;0
96;16.09.2013;2013;09;05;Maanantai;5;11;16;0;0;0
96;16.09.2013;2013;09;06;Maanantai;37;45;82;3;5;8
96;16.09.2013;2013;09;07;Maanantai;129;164;293;14;6;20
96;16.09.2013;2013;09;08;Maanantai;129;181;310;7;16;23
96;16.09.2013;2013;09;09;Maanantai;77;124;201;12;4;16
96;16.09.2013;2013;09;10;Maanantai;66;97;163;3;7;10
96;16.09.2013;2013;09;11;Maanantai;73;82;155;3;5;8
96;16.09.2013;2013;09;12;Maanantai;63;86;149;5;13;18
96;16.09.2013;2013;09;13;Maanantai;76;105;181;7;12;19
96;16.09.2013;2013;09;14;Maanantai;130;145;275;7;19;26
96;16.09.2013;2013;09;15;Maanantai;117;229;346;3;16;19
96;16.09.2013;2013;09;16;Maanantai;154;223;377;8;11;19
96;16.09.2013;2013;09;17;Maanantai;90;125;215;15;4;19
96;16.09.2013;2013;09;18;Maanantai;73;98;171;10;23;33
96;16.09.2013;2013;09;19;Maanantai;72;48;120;15;15;30
96;16.09.2013;2013;09;20;Maanantai;66;37;103;12;19;31
96;16.09.2013;2013;09;21;Maanantai;38;31;69;5;10;15
96;16.09.2013;2013;09;22;Maanantai;12;10;22;2;1;3
96;16.09.2013;2013;09;23;Maanantai;5;4;9;1;1;2
96;17.09.2013;2013;09;00;Tiistai;3;2;5;1;0;1
96;17.09.2013;2013;09;01;Tiistai;2;0;2;0;0;0
96;17.09.2013;2013;09;02;Tiistai;0;0;0;0;0;0
96;17.09.2013;2013;09;03;Tiistai;0;0;0;0;0;0
96;17.09.2013;2013;09;04;Tiistai;2;1;3;0;0;0
96;17.09.2013;2013;09;05;Tiistai;2;10;12;1;0;1
96;17.09.2013;2013;09;06;Tiistai;44;45;89;3;4;7
96;17.09.2013;2013;09;07;Tiistai;145;195;340;18;5;23
96;17.09.2013;2013;09;08;Tiistai;178;196;374;14;17;31
96;17.09.2013;2013;09;09;Tiistai;79;109;188;9;6;15
96;17.09.2013;2013;09;10;Tiistai;49;82;131;7;9;16
96;17.09.2013;2013;09;11;Tiistai;60;69;129;5;11;16
96;17.09.2013;2013;09;12;Tiistai;93;90;183;13;22;35
96;17.09.2013;2013;09;13;Tiistai;73;106;179;12;11;23
96;17.09.2013;2013;09;14;Tiistai;94;163;257;9;19;28
96;17.09.2013;2013;09;15;Tiistai;132;261;393;6;19;25
96;17.09.2013;2013;09;16;Tiistai;177;221;398;6;11;17
96;17.09.2013;2013;09;17;Tiistai;99;111;210;10;18;28
96;17.09.2013;2013;09;18;Tiistai;87;101;188;6;9;15
96;17.09.2013;2013;09;19;Tiistai;84;60;144;11;19;30
96;17.09.2013;2013;09;20;Tiistai;81;42;123;14;12;26
96;17.09.2013;2013;09;21;Tiistai;41;37;78;5;12;17
96;17.09.2013;2013;09;22;Tiistai;16;5;21;1;0;1
96;17.09.2013;2013;09;23;Tiistai;6;6;12;2;1;3
96;18.09.2013;2013;09;00;Keskiviikko;8;1;9;2;1;3
96;18.09.2013;2013;09;01;Keskiviikko;3;0;3;0;0;0
96;18.09.2013;2013;09;02;Keskiviikko;0;0;0;0;0;0
96;18.09.2013;2013;09;03;Keskiviikko;1;1;2;1;0;1
96;18.09.2013;2013;09;04;Keskiviikko;1;0;1;0;0;0
96;18.09.2013;2013;09;05;Keskiviikko;0;10;10;1;0;1
96;18.09.2013;2013;09;06;Keskiviikko;40;41;81;4;3;7
96;18.09.2013;2013;09;07;Keskiviikko;142;193;335;15;3;18
96;18.09.2013;2013;09;08;Keskiviikko;168;203;371;9;8;17
96;18.09.2013;2013;09;09;Keskiviikko;79;142;221;16;12;28
96;18.09.2013;2013;09;10;Keskiviikko;44;91;135;5;8;13
96;18.09.2013;2013;09;11;Keskiviikko;68;95;163;5;2;7
96;18.09.2013;2013;09;12;Keskiviikko;76;93;169;7;7;14
96;18.09.2013;2013;09;13;Keskiviikko;62;102;164;9;8;17
96;18.09.2013;2013;09;14;Keskiviikko;100;133;233;5;15;20
96;18.09.2013;2013;09;15;Keskiviikko;138;230;368;12;16;28
96;18.09.2013;2013;09;16;Keskiviikko;145;226;371;8;16;24
96;18.09.2013;2013;09;17;Keskiviikko;93;125;218;6;14;20
96;18.09.2013;2013;09;18;Keskiviikko;89;77;166;7;14;21
96;18.09.2013;2013;09;19;Keskiviikko;74;81;155;13;16;29
96;18.09.2013;2013;09;20;Keskiviikko;45;35;80;11;13;24
96;18.09.2013;2013;09;21;Keskiviikko;24;39;63;5;8;13
96;18.09.2013;2013;09;22;Keskiviikko;18;10;28;2;2;4
96;18.09.2013;2013;09;23;Keskiviikko;4;3;7;0;4;4
96;19.09.2013;2013;09;00;Torstai;6;1;7;2;1;3
96;19.09.2013;2013;09;01;Torstai;2;1;3;1;0;1
96;19.09.2013;2013;09;02;Torstai;4;3;7;1;0;1
96;19.09.2013;2013;09;03;Torstai;1;0;1;0;0;0
96;19.09.2013;2013;09;04;Torstai;3;4;7;0;0;0
96;19.09.2013;2013;09;05;Torstai;2;9;11;2;0;2
96;19.09.2013;2013;09;06;Torstai;48;55;103;8;2;10
96;19.09.2013;2013;09;07;Torstai;124;176;300;12;7;19
96;19.09.2013;2013;09;08;Torstai;147;211;358;12;15;27
96;19.09.2013;2013;09;09;Torstai;80;131;211;13;7;20
96;19.09.2013;2013;09;10;Torstai;64;87;151;5;16;21
96;19.09.2013;2013;09;11;Torstai;72;81;153;9;8;17
96;19.09.2013;2013;09;12;Torstai;67;97;164;7;10;17
96;19.09.2013;2013;09;13;Torstai;72;95;167;3;10;13
96;19.09.2013;2013;09;14;Torstai;103;170;273;1;11;12
96;19.09.2013;2013;09;15;Torstai;134;237;371;6;25;31
96;19.09.2013;2013;09;16;Torstai;142;182;324;6;13;19
96;19.09.2013;2013;09;17;Torstai;114;101;215;9;12;21
96;19.09.2013;2013;09;18;Torstai;93;69;162;16;10;26
96;19.09.2013;2013;09;19;Torstai;75;67;142;13;15;28
96;19.09.2013;2013;09;20;Torstai;61;52;113;8;19;27
96;19.09.2013;2013;09;21;Torstai;37;33;70;4;6;10
96;19.09.2013;2013;09;22;Torstai;14;33;47;1;3;4
96;19.09.2013;2013;09;23;Torstai;8;8;16;0;2;2
96;20.09.2013;2013;09;00;Perjantai;5;5;10;0;1;1
96;20.09.2013;2013;09;01;Perjantai;11;1;12;2;0;2
96;20.09.2013;2013;09;02;Perjantai;5;1;6;1;1;2
96;20.09.2013;2013;09;03;Perjantai;6;0;6;0;1;1
96;20.09.2013;2013;09;04;Perjantai;4;1;5;0;1;1
96;20.09.2013;2013;09;05;Perjantai;1;9;10;1;0;1
96;20.09.2013;2013;09;06;Perjantai;21;24;45;4;0;4
96;20.09.2013;2013;09;07;Perjantai;93;104;197;5;5;10
96;20.09.2013;2013;09;08;Perjantai;141;206;347;17;6;23
96;20.09.2013;2013;09;09;Perjantai;58;126;184;5;13;18
96;20.09.2013;2013;09;10;Perjantai;59;71;130;3;11;14
96;20.09.2013;2013;09;11;Perjantai;61;86;147;1;8;9
96;20.09.2013;2013;09;12;Perjantai;76;88;164;4;4;8
96;20.09.2013;2013;09;13;Perjantai;59;114;173;7;11;18
96;20.09.2013;2013;09;14;Perjantai;90;144;234;10;7;17
96;20.09.2013;2013;09;15;Perjantai;125;199;324;8;11;19
96;20.09.2013;2013;09;16;Perjantai;94;127;221;9;11;20
96;20.09.2013;2013;09;17;Perjantai;81;81;162;5;7;12
96;20.09.2013;2013;09;18;Perjantai;52;46;98;9;8;17
96;20.09.2013;2013;09;19;Perjantai;59;50;109;3;5;8
96;20.09.2013;2013;09;20;Perjantai;31;31;62;7;3;10
96;20.09.2013;2013;09;21;Perjantai;30;22;52;5;4;9
96;20.09.2013;2013;09;22;Perjantai;20;19;39;0;0;0
96;20.09.2013;2013;09;23;Perjantai;7;10;17;2;3;5
96;21.09.2013;2013;09;00;Lauantai;14;16;30;0;0;0
96;21.09.2013;2013;09;01;Lauantai;7;5;12;2;0;2
96;21.09.2013;2013;09;02;Lauantai;16;6;22;2;1;3
96;21.09.2013;2013;09;03;Lauantai;13;2;15;1;0;1
96;21.09.2013;2013;09;04;Lauantai;13;1;14;1;2;3
96;21.09.2013;2013;09;05;Lauantai;3;4;7;0;0;0
96;21.09.2013;2013;09;06;Lauantai;14;11;25;3;1;4
96;21.09.2013;2013;09;07;Lauantai;4;19;23;0;2;2
96;21.09.2013;2013;09;08;Lauantai;11;20;31;2;3;5
96;21.09.2013;2013;09;09;Lauantai;18;49;67;4;11;15
96;21.09.2013;2013;09;10;Lauantai;27;48;75;3;9;12
96;21.09.2013;2013;09;11;Lauantai;26;61;87;2;11;13
96;21.09.2013;2013;09;12;Lauantai;39;65;104;6;10;16
96;21.09.2013;2013;09;13;Lauantai;60;55;115;4;5;9
96;21.09.2013;2013;09;14;Lauantai;63;47;110;12;9;21
96;21.09.2013;2013;09;15;Lauantai;53;55;108;12;16;28
96;21.09.2013;2013;09;16;Lauantai;62;80;142;5;15;20
96;21.09.2013;2013;09;17;Lauantai;33;35;68;4;4;8
96;21.09.2013;2013;09;18;Lauantai;47;29;76;13;10;23
96;21.09.2013;2013;09;19;Lauantai;71;22;93;19;8;27
96;21.09.2013;2013;09;20;Lauantai;17;22;39;4;3;7
96;21.09.2013;2013;09;21;Lauantai;7;26;33;2;4;6
96;21.09.2013;2013;09;22;Lauantai;6;11;17;0;0;0
96;21.09.2013;2013;09;23;Lauantai;4;12;16;0;0;0
96;22.09.2013;2013;09;00;Sunnuntai;7;8;15;0;0;0
96;22.09.2013;2013;09;01;Sunnuntai;7;3;10;1;0;1
96;22.09.2013;2013;09;02;Sunnuntai;10;3;13;0;0;0
96;22.09.2013;2013;09;03;Sunnuntai;11;1;12;0;0;0
96;22.09.2013;2013;09;04;Sunnuntai;14;0;14;0;0;0
96;22.09.2013;2013;09;05;Sunnuntai;3;1;4;0;0;0
96;22.09.2013;2013;09;06;Sunnuntai;14;3;17;1;1;2
96;22.09.2013;2013;09;07;Sunnuntai;3;7;10;1;3;4
96;22.09.2013;2013;09;08;Sunnuntai;4;7;11;1;5;6
96;22.09.2013;2013;09;09;Sunnuntai;10;11;21;3;8;11
96;22.09.2013;2013;09;10;Sunnuntai;15;38;53;6;6;12
96;22.09.2013;2013;09;11;Sunnuntai;27;70;97;5;8;13
96;22.09.2013;2013;09;12;Sunnuntai;43;66;109;7;20;27
96;22.09.2013;2013;09;13;Sunnuntai;55;60;115;12;7;19
96;22.09.2013;2013;09;14;Sunnuntai;61;48;109;11;5;16
96;22.09.2013;2013;09;15;Sunnuntai;55;43;98;8;9;17
96;22.09.2013;2013;09;16;Sunnuntai;61;32;93;17;6;23
96;22.09.2013;2013;09;17;Sunnuntai;36;26;62;5;6;11
96;22.09.2013;2013;09;18;Sunnuntai;29;40;69;8;9;17
96;22.09.2013;2013;09;19;Sunnuntai;19;27;46;4;19;23
96;22.09.2013;2013;09;20;Sunnuntai;22;25;47;7;11;18
96;22.09.2013;2013;09;21;Sunnuntai;14;17;31;1;1;2
96;22.09.2013;2013;09;22;Sunnuntai;6;15;21;0;1;1
96;22.09.2013;2013;09;23;Sunnuntai;3;0;3;0;0;0
96;23.09.2013;2013;09;00;Maanantai;5;1;6;1;1;2
96;23.09.2013;2013;09;01;Maanantai;0;0;0;0;0;0
96;23.09.2013;2013;09;02;Maanantai;2;0;2;0;0;0
96;23.09.2013;2013;09;03;Maanantai;3;0;3;0;0;0
96;23.09.2013;2013;09;04;Maanantai;2;3;5;0;1;1
96;23.09.2013;2013;09;05;Maanantai;3;6;9;0;0;0
96;23.09.2013;2013;09;06;Maanantai;40;42;82;5;1;6
96;23.09.2013;2013;09;07;Maanantai;123;132;255;10;6;16
96;23.09.2013;2013;09;08;Maanantai;120;169;289;18;8;26
96;23.09.2013;2013;09;09;Maanantai;79;133;212;5;5;10
96;23.09.2013;2013;09;10;Maanantai;65;86;151;8;7;15
96;23.09.2013;2013;09;11;Maanantai;65;79;144;6;20;26
96;23.09.2013;2013;09;12;Maanantai;84;92;176;8;7;15
96;23.09.2013;2013;09;13;Maanantai;68;102;170;13;15;28
96;23.09.2013;2013;09;14;Maanantai;106;154;260;10;17;27
96;23.09.2013;2013;09;15;Maanantai;112;252;364;6;24;30
96;23.09.2013;2013;09;16;Maanantai;143;180;323;8;20;28
96;23.09.2013;2013;09;17;Maanantai;120;86;206;11;7;18
96;23.09.2013;2013;09;18;Maanantai;98;64;162;14;19;33
96;23.09.2013;2013;09;19;Maanantai;59;58;117;10;17;27
96;23.09.2013;2013;09;20;Maanantai;40;51;91;7;21;28
96;23.09.2013;2013;09;21;Maanantai;32;37;69;1;6;7
96;23.09.2013;2013;09;22;Maanantai;18;8;26;4;5;9
96;23.09.2013;2013;09;23;Maanantai;6;0;6;0;0;0
96;24.09.2013;2013;09;00;Tiistai;2;0;2;1;0;1
96;24.09.2013;2013;09;01;Tiistai;1;0;1;0;1;1
96;24.09.2013;2013;09;02;Tiistai;0;0;0;0;0;0
96;24.09.2013;2013;09;03;Tiistai;0;0;0;0;0;0
96;24.09.2013;2013;09;04;Tiistai;1;0;1;0;0;0
96;24.09.2013;2013;09;05;Tiistai;3;7;10;2;1;3
96;24.09.2013;2013;09;06;Tiistai;45;51;96;4;1;5
96;24.09.2013;2013;09;07;Tiistai;115;146;261;12;6;18
96;24.09.2013;2013;09;08;Tiistai;163;172;335;8;10;18
96;24.09.2013;2013;09;09;Tiistai;48;99;147;9;8;17
96;24.09.2013;2013;09;10;Tiistai;53;60;113;8;3;11
96;24.09.2013;2013;09;11;Tiistai;71;61;132;10;6;16
96;24.09.2013;2013;09;12;Tiistai;85;87;172;13;18;31
96;24.09.2013;2013;09;13;Tiistai;65;92;157;6;4;10
96;24.09.2013;2013;09;14;Tiistai;77;155;232;12;5;17
96;24.09.2013;2013;09;15;Tiistai;116;250;366;7;16;23
96;24.09.2013;2013;09;16;Tiistai;140;167;307;8;26;34
96;24.09.2013;2013;09;17;Tiistai;93;96;189;6;11;17
96;24.09.2013;2013;09;18;Tiistai;78;59;137;12;13;25
96;24.09.2013;2013;09;19;Tiistai;65;69;134;10;17;27
96;24.09.2013;2013;09;20;Tiistai;59;31;90;14;9;23
96;24.09.2013;2013;09;21;Tiistai;39;26;65;8;4;12
96;24.09.2013;2013;09;22;Tiistai;9;14;23;3;0;3
96;24.09.2013;2013;09;23;Tiistai;8;0;8;1;1;2
96;25.09.2013;2013;09;00;Keskiviikko;1;0;1;0;1;1
96;25.09.2013;2013;09;01;Keskiviikko;1;0;1;0;0;0
96;25.09.2013;2013;09;02;Keskiviikko;2;1;3;1;1;2
96;25.09.2013;2013;09;03;Keskiviikko;0;0;0;0;0;0
96;25.09.2013;2013;09;04;Keskiviikko;2;1;3;0;0;0
96;25.09.2013;2013;09;05;Keskiviikko;0;6;6;0;1;1
96;25.09.2013;2013;09;06;Keskiviikko;49;28;77;4;1;5
96;25.09.2013;2013;09;07;Keskiviikko;114;139;253;19;5;24
96;25.09.2013;2013;09;08;Keskiviikko;171;167;338;9;10;19
96;25.09.2013;2013;09;09;Keskiviikko;74;103;177;4;5;9
96;25.09.2013;2013;09;10;Keskiviikko;45;68;113;7;6;13
96;25.09.2013;2013;09;11;Keskiviikko;50;67;117;4;4;8
96;25.09.2013;2013;09;12;Keskiviikko;93;73;166;4;9;13
96;25.09.2013;2013;09;13;Keskiviikko;87;93;180;6;9;15
96;25.09.2013;2013;09;14;Keskiviikko;94;145;239;6;11;17
96;25.09.2013;2013;09;15;Keskiviikko;105;227;332;8;16;24
96;25.09.2013;2013;09;16;Keskiviikko;119;203;322;11;14;25
96;25.09.2013;2013;09;17;Keskiviikko;87;109;196;20;15;35
96;25.09.2013;2013;09;18;Keskiviikko;103;80;183;14;16;30
96;25.09.2013;2013;09;19;Keskiviikko;76;51;127;6;10;16
96;25.09.2013;2013;09;20;Keskiviikko;57;47;104;14;16;30
96;25.09.2013;2013;09;21;Keskiviikko;50;52;102;9;10;19
96;25.09.2013;2013;09;22;Keskiviikko;15;9;24;6;1;7
96;25.09.2013;2013;09;23;Keskiviikko;6;4;10;1;0;1
96;26.09.2013;2013;09;00;Torstai;5;1;6;1;0;1
96;26.09.2013;2013;09;01;Torstai;7;0;7;0;0;0
96;26.09.2013;2013;09;02;Torstai;2;0;2;0;0;0
96;26.09.2013;2013;09;03;Torstai;1;0;1;0;0;0
96;26.09.2013;2013;09;04;Torstai;3;2;5;2;0;2
96;26.09.2013;2013;09;05;Torstai;4;2;6;0;0;0
96;26.09.2013;2013;09;06;Torstai;35;24;59;3;3;6
96;26.09.2013;2013;09;07;Torstai;104;126;230;12;8;20
96;26.09.2013;2013;09;08;Torstai;155;128;283;11;4;15
96;26.09.2013;2013;09;09;Torstai;67;71;138;8;9;17
96;26.09.2013;2013;09;10;Torstai;56;60;116;4;4;8
96;26.09.2013;2013;09;11;Torstai;52;82;134;4;14;18
96;26.09.2013;2013;09;12;Torstai;69;73;142;4;8;12
96;26.09.2013;2013;09;13;Torstai;58;70;128;9;9;18
96;26.09.2013;2013;09;14;Torstai;83;121;204;5;10;15
96;26.09.2013;2013;09;15;Torstai;78;190;268;6;22;28
96;26.09.2013;2013;09;16;Torstai;102;192;294;3;15;18
96;26.09.2013;2013;09;17;Torstai;70;92;162;8;9;17
96;26.09.2013;2013;09;18;Torstai;64;68;132;14;13;27
96;26.09.2013;2013;09;19;Torstai;68;39;107;11;17;28
96;26.09.2013;2013;09;20;Torstai;42;39;81;8;5;13
96;26.09.2013;2013;09;21;Torstai;30;21;51;4;7;11
96;26.09.2013;2013;09;22;Torstai;12;8;20;2;3;5
96;26.09.2013;2013;09;23;Torstai;5;2;7;1;0;1
96;27.09.2013;2013;09;00;Perjantai;5;3;8;9;8;17
96;27.09.2013;2013;09;01;Perjantai;1;0;1;1;0;1
96;27.09.2013;2013;09;02;Perjantai;1;0;1;0;0;0
96;27.09.2013;2013;09;03;Perjantai;0;1;1;0;0;0
96;27.09.2013;2013;09;04;Perjantai;2;1;3;1;0;1
96;27.09.2013;2013;09;05;Perjantai;3;5;8;1;0;1
96;27.09.2013;2013;09;06;Perjantai;40;29;69;7;0;7
96;27.09.2013;2013;09;07;Perjantai;99;79;178;12;6;18
96;27.09.2013;2013;09;08;Perjantai;104;90;194;3;0;3
96;27.09.2013;2013;09;09;Perjantai;56;56;112;6;3;9
96;27.09.2013;2013;09;10;Perjantai;40;44;84;3;7;10
96;27.09.2013;2013;09;11;Perjantai;48;82;130;4;4;8
96;27.09.2013;2013;09;12;Perjantai;58;76;134;9;15;24
96;27.09.2013;2013;09;13;Perjantai;54;117;171;7;11;18
96;27.09.2013;2013;09;14;Perjantai;71;130;201;7;19;26
96;27.09.2013;2013;09;15;Perjantai;91;155;246;6;17;23
96;27.09.2013;2013;09;16;Perjantai;91;98;189;9;9;18
96;27.09.2013;2013;09;17;Perjantai;64;50;114;8;10;18
96;27.09.2013;2013;09;18;Perjantai;44;53;97;5;6;11
96;27.09.2013;2013;09;19;Perjantai;43;30;73;4;11;15
96;27.09.2013;2013;09;20;Perjantai;49;28;77;15;6;21
96;27.09.2013;2013;09;21;Perjantai;23;38;61;4;6;10
96;27.09.2013;2013;09;22;Perjantai;23;20;43;2;4;6
96;27.09.2013;2013;09;23;Perjantai;7;11;18;2;0;2
96;28.09.2013;2013;09;00;Lauantai;6;18;24;1;3;4
96;28.09.2013;2013;09;01;Lauantai;15;8;23;1;0;1
96;28.09.2013;2013;09;02;Lauantai;9;1;10;2;0;2
96;28.09.2013;2013;09;03;Lauantai;7;3;10;0;0;0
96;28.09.2013;2013;09;04;Lauantai;5;3;8;1;1;2
96;28.09.2013;2013;09;05;Lauantai;3;2;5;0;1;1
96;28.09.2013;2013;09;06;Lauantai;15;8;23;3;0;3
96;28.09.2013;2013;09;07;Lauantai;0;12;12;0;1;1
96;28.09.2013;2013;09;08;Lauantai;8;30;38;8;5;13
96;28.09.2013;2013;09;09;Lauantai;13;36;49;5;6;11
96;28.09.2013;2013;09;10;Lauantai;29;60;89;4;13;17
96;28.09.2013;2013;09;11;Lauantai;34;42;76;8;13;21
96;28.09.2013;2013;09;12;Lauantai;43;50;93;6;14;20
96;28.09.2013;2013;09;13;Lauantai;40;71;111;9;11;20
96;28.09.2013;2013;09;14;Lauantai;57;53;110;11;6;17
96;28.09.2013;2013;09;15;Lauantai;53;58;111;6;5;11
96;28.09.2013;2013;09;16;Lauantai;37;37;74;4;10;14
96;28.09.2013;2013;09;17;Lauantai;58;40;98;16;7;23
96;28.09.2013;2013;09;18;Lauantai;55;29;84;14;11;25
96;28.09.2013;2013;09;19;Lauantai;36;22;58;10;11;21
96;28.09.2013;2013;09;20;Lauantai;29;24;53;7;7;14
96;28.09.2013;2013;09;21;Lauantai;21;42;63;1;6;7
96;28.09.2013;2013;09;22;Lauantai;11;26;37;1;1;2
96;28.09.2013;2013;09;23;Lauantai;13;8;21;1;5;6
96;29.09.2013;2013;09;00;Sunnuntai;11;20;31;0;0;0
96;29.09.2013;2013;09;01;Sunnuntai;11;3;14;1;1;2
96;29.09.2013;2013;09;02;Sunnuntai;16;1;17;1;0;1
96;29.09.2013;2013;09;03;Sunnuntai;19;4;23;1;0;1
96;29.09.2013;2013;09;04;Sunnuntai;12;1;13;1;0;1
96;29.09.2013;2013;09;05;Sunnuntai;1;0;1;0;1;1
96;29.09.2013;2013;09;06;Sunnuntai;14;9;23;4;0;4
96;29.09.2013;2013;09;07;Sunnuntai;2;9;11;1;1;2
96;29.09.2013;2013;09;08;Sunnuntai;3;5;8;2;3;5
96;29.09.2013;2013;09;09;Sunnuntai;9;11;20;7;2;9
96;29.09.2013;2013;09;10;Sunnuntai;21;32;53;4;15;19
96;29.09.2013;2013;09;11;Sunnuntai;15;52;67;5;13;18
96;29.09.2013;2013;09;12;Sunnuntai;34;64;98;10;7;17
96;29.09.2013;2013;09;13;Sunnuntai;49;60;109;9;8;17
96;29.09.2013;2013;09;14;Sunnuntai;50;42;92;6;4;10
96;29.09.2013;2013;09;15;Sunnuntai;50;61;111;11;9;20
96;29.09.2013;2013;09;16;Sunnuntai;62;40;102;22;11;33
96;29.09.2013;2013;09;17;Sunnuntai;34;37;71;21;12;33
96;29.09.2013;2013;09;18;Sunnuntai;56;44;100;12;20;32
96;29.09.2013;2013;09;19;Sunnuntai;21;41;62;6;19;25
96;29.09.2013;2013;09;20;Sunnuntai;27;40;67;10;9;19
96;29.09.2013;2013;09;21;Sunnuntai;13;18;31;2;1;3
96;29.09.2013;2013;09;22;Sunnuntai;10;6;16;2;3;5
96;29.09.2013;2013;09;23;Sunnuntai;6;6;12;1;2;3
96;30.09.2013;2013;09;00;Maanantai;1;0;1;3;1;4
96;30.09.2013;2013;09;01;Maanantai;7;1;8;0;0;0
96;30.09.2013;2013;09;02;Maanantai;3;0;3;0;0;0
96;30.09.2013;2013;09;03;Maanantai;0;0;0;0;0;0
96;30.09.2013;2013;09;04;Maanantai;2;1;3;0;1;1
96;30.09.2013;2013;09;05;Maanantai;3;9;12;1;0;1
96;30.09.2013;2013;09;06;Maanantai;38;45;83;3;2;5
96;30.09.2013;2013;09;07;Maanantai;113;108;221;13;5;18
96;30.09.2013;2013;09;08;Maanantai;143;169;312;8;9;17
96;30.09.2013;2013;09;09;Maanantai;57;111;168;6;7;13
96;30.09.2013;2013;09;10;Maanantai;54;75;129;8;6;14
96;30.09.2013;2013;09;11;Maanantai;66;65;131;5;15;20
96;30.09.2013;2013;09;12;Maanantai;82;73;155;8;12;20
96;30.09.2013;2013;09;13;Maanantai;81;98;179;6;6;12
96;30.09.2013;2013;09;14;Maanantai;88;172;260;6;12;18
96;30.09.2013;2013;09;15;Maanantai;113;216;329;3;11;14
96;30.09.2013;2013;09;16;Maanantai;129;165;294;9;18;27
96;30.09.2013;2013;09;17;Maanantai;101;128;229;10;7;17
96;30.09.2013;2013;09;18;Maanantai;74;66;140;12;13;25
96;30.09.2013;2013;09;19;Maanantai;73;40;113;18;17;35
96;30.09.2013;2013;09;20;Maanantai;54;39;93;14;11;25
96;30.09.2013;2013;09;21;Maanantai;27;20;47;8;5;13
96;30.09.2013;2013;09;22;Maanantai;20;12;32;5;3;8
96;30.09.2013;2013;09;23;Maanantai;3;2;5;0;0;0
96;01.10.2013;2013;10;00;Tiistai;7;0;7;1;0;1
96;01.10.2013;2013;10;01;Tiistai;2;1;3;0;0;0
96;01.10.2013;2013;10;02;Tiistai;2;0;2;0;0;0
96;01.10.2013;2013;10;03;Tiistai;2;1;3;0;0;0
96;01.10.2013;2013;10;04;Tiistai;5;2;7;0;0;0
96;01.10.2013;2013;10;05;Tiistai;2;9;11;1;0;1
96;01.10.2013;2013;10;06;Tiistai;48;35;83;3;2;5
96;01.10.2013;2013;10;07;Tiistai;109;160;269;14;7;21
96;01.10.2013;2013;10;08;Tiistai;159;169;328;11;3;14
96;01.10.2013;2013;10;09;Tiistai;57;92;149;7;8;15
96;01.10.2013;2013;10;10;Tiistai;60;66;126;6;7;13
96;01.10.2013;2013;10;11;Tiistai;64;86;150;8;8;16
96;01.10.2013;2013;10;12;Tiistai;73;90;163;12;11;23
96;01.10.2013;2013;10;13;Tiistai;75;94;169;4;6;10
96;01.10.2013;2013;10;14;Tiistai;100;138;238;6;8;14
96;01.10.2013;2013;10;15;Tiistai;136;221;357;8;20;28
96;01.10.2013;2013;10;16;Tiistai;137;200;337;9;25;34
96;01.10.2013;2013;10;17;Tiistai;109;124;233;26;17;43
96;01.10.2013;2013;10;18;Tiistai;76;90;166;10;20;30
96;01.10.2013;2013;10;19;Tiistai;69;49;118;14;13;27
96;01.10.2013;2013;10;20;Tiistai;88;36;124;8;10;18
96;01.10.2013;2013;10;21;Tiistai;49;24;73;10;7;17
96;01.10.2013;2013;10;22;Tiistai;16;5;21;1;0;1
96;01.10.2013;2013;10;23;Tiistai;6;5;11;3;2;5
96;02.10.2013;2013;10;00;Keskiviikko;6;0;6;2;2;4
96;02.10.2013;2013;10;01;Keskiviikko;1;0;1;2;1;3
96;02.10.2013;2013;10;02;Keskiviikko;2;0;2;0;0;0
96;02.10.2013;2013;10;03;Keskiviikko;2;0;2;2;0;2
96;02.10.2013;2013;10;04;Keskiviikko;1;1;2;1;0;1
96;02.10.2013;2013;10;05;Keskiviikko;1;9;10;0;1;1
96;02.10.2013;2013;10;06;Keskiviikko;39;50;89;3;2;5
96;02.10.2013;2013;10;07;Keskiviikko;110;148;258;16;8;24
96;02.10.2013;2013;10;08;Keskiviikko;142;138;280;8;21;29
96;02.10.2013;2013;10;09;Keskiviikko;61;74;135;3;7;10
96;02.10.2013;2013;10;10;Keskiviikko;56;75;131;10;11;21
96;02.10.2013;2013;10;11;Keskiviikko;67;61;128;5;13;18
96;02.10.2013;2013;10;12;Keskiviikko;61;78;139;11;11;22
96;02.10.2013;2013;10;13;Keskiviikko;66;89;155;8;10;18
96;02.10.2013;2013;10;14;Keskiviikko;77;156;233;12;11;23
96;02.10.2013;2013;10;15;Keskiviikko;112;202;314;11;24;35
96;02.10.2013;2013;10;16;Keskiviikko;131;191;322;13;20;33
96;02.10.2013;2013;10;17;Keskiviikko;112;89;201;12;14;26
96;02.10.2013;2013;10;18;Keskiviikko;114;89;203;21;10;31
96;02.10.2013;2013;10;19;Keskiviikko;93;64;157;22;14;36
96;02.10.2013;2013;10;20;Keskiviikko;65;42;107;7;16;23
96;02.10.2013;2013;10;21;Keskiviikko;29;61;90;2;5;7
96;02.10.2013;2013;10;22;Keskiviikko;24;14;38;3;1;4
96;02.10.2013;2013;10;23;Keskiviikko;5;7;12;1;2;3
96;03.10.2013;2013;10;00;Torstai;4;3;7;0;2;2
96;03.10.2013;2013;10;01;Torstai;3;0;3;0;1;1
96;03.10.2013;2013;10;02;Torstai;0;0;0;0;0;0
96;03.10.2013;2013;10;03;Torstai;3;0;3;1;0;1
96;03.10.2013;2013;10;04;Torstai;4;1;5;0;0;0
96;03.10.2013;2013;10;05;Torstai;2;10;12;0;0;0
96;03.10.2013;2013;10;06;Torstai;34;38;72;7;3;10
96;03.10.2013;2013;10;07;Torstai;104;149;253;12;6;18
96;03.10.2013;2013;10;08;Torstai;192;175;367;6;8;14
96;03.10.2013;2013;10;09;Torstai;87;103;190;10;8;18
96;03.10.2013;2013;10;10;Torstai;44;76;120;7;11;18
96;03.10.2013;2013;10;11;Torstai;66;92;158;7;5;12
96;03.10.2013;2013;10;12;Torstai;73;95;168;6;14;20
96;03.10.2013;2013;10;13;Torstai;60;130;190;6;12;18
96;03.10.2013;2013;10;14;Torstai;89;152;241;9;13;22
96;03.10.2013;2013;10;15;Torstai;124;221;345;11;19;30
96;03.10.2013;2013;10;16;Torstai;153;190;343;11;18;29
96;03.10.2013;2013;10;17;Torstai;100;115;215;13;19;32
96;03.10.2013;2013;10;18;Torstai;72;92;164;8;24;32
96;03.10.2013;2013;10;19;Torstai;57;46;103;11;18;29
96;03.10.2013;2013;10;20;Torstai;86;46;132;16;9;25
96;03.10.2013;2013;10;21;Torstai;47;29;76;4;5;9
96;03.10.2013;2013;10;22;Torstai;17;9;26;0;0;0
96;03.10.2013;2013;10;23;Torstai;7;15;22;0;1;1
96;04.10.2013;2013;10;00;Perjantai;3;2;5;1;0;1
96;04.10.2013;2013;10;01;Perjantai;3;2;5;1;0;1
96;04.10.2013;2013;10;02;Perjantai;16;1;17;0;0;0
96;04.10.2013;2013;10;03;Perjantai;11;1;12;0;0;0
96;04.10.2013;2013;10;04;Perjantai;9;3;12;0;1;1
96;04.10.2013;2013;10;05;Perjantai;6;8;14;1;0;1
96;04.10.2013;2013;10;06;Perjantai;38;29;67;4;2;6
96;04.10.2013;2013;10;07;Perjantai;100;130;230;12;5;17
96;04.10.2013;2013;10;08;Perjantai;132;135;267;11;12;23
96;04.10.2013;2013;10;09;Perjantai;48;113;161;12;13;25
96;04.10.2013;2013;10;10;Perjantai;63;70;133;5;13;18
96;04.10.2013;2013;10;11;Perjantai;36;82;118;6;12;18
96;04.10.2013;2013;10;12;Perjantai;77;104;181;6;13;19
96;04.10.2013;2013;10;13;Perjantai;92;119;211;6;9;15
96;04.10.2013;2013;10;14;Perjantai;81;166;247;10;16;26
96;04.10.2013;2013;10;15;Perjantai;94;181;275;7;16;23
96;04.10.2013;2013;10;16;Perjantai;88;97;185;7;15;22
96;04.10.2013;2013;10;17;Perjantai;71;59;130;13;7;20
96;04.10.2013;2013;10;18;Perjantai;53;42;95;6;16;22
96;04.10.2013;2013;10;19;Perjantai;43;43;86;8;3;11
96;04.10.2013;2013;10;20;Perjantai;35;16;51;8;8;16
96;04.10.2013;2013;10;21;Perjantai;28;34;62;6;1;7
96;04.10.2013;2013;10;22;Perjantai;18;14;32;5;2;7
96;04.10.2013;2013;10;23;Perjantai;9;8;17;0;0;0
96;05.10.2013;2013;10;00;Lauantai;13;18;31;3;3;6
96;05.10.2013;2013;10;01;Lauantai;8;6;14;0;0;0
96;05.10.2013;2013;10;02;Lauantai;14;4;18;1;0;1
96;05.10.2013;2013;10;03;Lauantai;13;0;13;1;0;1
96;05.10.2013;2013;10;04;Lauantai;7;1;8;0;0;0
96;05.10.2013;2013;10;05;Lauantai;1;3;4;0;0;0
96;05.10.2013;2013;10;06;Lauantai;12;11;23;2;0;2
96;05.10.2013;2013;10;07;Lauantai;4;21;25;1;4;5
96;05.10.2013;2013;10;08;Lauantai;6;18;24;9;3;12
96;05.10.2013;2013;10;09;Lauantai;19;46;65;1;3;4
96;05.10.2013;2013;10;10;Lauantai;24;40;64;3;8;11
96;05.10.2013;2013;10;11;Lauantai;38;42;80;3;9;12
96;05.10.2013;2013;10;12;Lauantai;31;54;85;3;4;7
96;05.10.2013;2013;10;13;Lauantai;42;50;92;10;8;18
96;05.10.2013;2013;10;14;Lauantai;39;33;72;8;2;10
96;05.10.2013;2013;10;15;Lauantai;43;61;104;4;10;14
96;05.10.2013;2013;10;16;Lauantai;31;23;54;4;9;13
96;05.10.2013;2013;10;17;Lauantai;54;30;84;35;10;45
96;05.10.2013;2013;10;18;Lauantai;30;33;63;18;8;26
96;05.10.2013;2013;10;19;Lauantai;40;31;71;6;25;31
96;05.10.2013;2013;10;20;Lauantai;30;33;63;12;31;43
96;05.10.2013;2013;10;21;Lauantai;14;28;42;8;43;51
96;05.10.2013;2013;10;22;Lauantai;8;33;41;3;9;12
96;05.10.2013;2013;10;23;Lauantai;10;3;13;1;0;1
96;06.10.2013;2013;10;00;Sunnuntai;8;18;26;1;0;1
96;06.10.2013;2013;10;01;Sunnuntai;15;4;19;0;0;0
96;06.10.2013;2013;10;02;Sunnuntai;10;2;12;2;0;2
96;06.10.2013;2013;10;03;Sunnuntai;17;2;19;1;0;1
96;06.10.2013;2013;10;04;Sunnuntai;10;2;12;1;0;1
96;06.10.2013;2013;10;05;Sunnuntai;3;0;3;0;0;0
96;06.10.2013;2013;10;06;Sunnuntai;10;5;15;2;0;2
96;06.10.2013;2013;10;07;Sunnuntai;4;8;12;0;2;2
96;06.10.2013;2013;10;08;Sunnuntai;4;11;15;1;1;2
96;06.10.2013;2013;10;09;Sunnuntai;8;14;22;6;7;13
96;06.10.2013;2013;10;10;Sunnuntai;23;19;42;8;19;27
96;06.10.2013;2013;10;11;Sunnuntai;17;32;49;8;14;22
96;06.10.2013;2013;10;12;Sunnuntai;32;59;91;15;8;23
96;06.10.2013;2013;10;13;Sunnuntai;44;51;95;16;13;29
96;06.10.2013;2013;10;14;Sunnuntai;50;66;116;6;10;16
96;06.10.2013;2013;10;15;Sunnuntai;38;50;88;14;22;36
96;06.10.2013;2013;10;16;Sunnuntai;54;49;103;25;13;38
96;06.10.2013;2013;10;17;Sunnuntai;45;47;92;8;10;18
96;06.10.2013;2013;10;18;Sunnuntai;50;36;86;13;28;41
96;06.10.2013;2013;10;19;Sunnuntai;28;23;51;9;9;18
96;06.10.2013;2013;10;20;Sunnuntai;35;38;73;5;12;17
96;06.10.2013;2013;10;21;Sunnuntai;21;28;49;6;9;15
96;06.10.2013;2013;10;22;Sunnuntai;9;4;13;1;1;2
96;06.10.2013;2013;10;23;Sunnuntai;3;3;6;0;1;1
96;07.10.2013;2013;10;00;Maanantai;5;1;6;0;1;1
96;07.10.2013;2013;10;01;Maanantai;0;0;0;0;0;0
96;07.10.2013;2013;10;02;Maanantai;2;0;2;1;0;1
96;07.10.2013;2013;10;03;Maanantai;2;0;2;0;0;0
96;07.10.2013;2013;10;04;Maanantai;1;1;2;0;1;1
96;07.10.2013;2013;10;05;Maanantai;8;8;16;0;0;0
96;07.10.2013;2013;10;06;Maanantai;39;55;94;6;0;6
96;07.10.2013;2013;10;07;Maanantai;108;155;263;10;3;13
96;07.10.2013;2013;10;08;Maanantai;131;181;312;10;10;20
96;07.10.2013;2013;10;09;Maanantai;83;117;200;14;7;21
96;07.10.2013;2013;10;10;Maanantai;51;77;128;11;16;27
96;07.10.2013;2013;10;11;Maanantai;73;79;152;7;9;16
96;07.10.2013;2013;10;12;Maanantai;91;99;190;9;6;15
96;07.10.2013;2013;10;13;Maanantai;79;105;184;5;9;14
96;07.10.2013;2013;10;14;Maanantai;97;145;242;3;10;13
96;07.10.2013;2013;10;15;Maanantai;134;233;367;11;18;29
96;07.10.2013;2013;10;16;Maanantai;165;179;344;11;15;26
96;07.10.2013;2013;10;17;Maanantai;117;121;238;22;18;40
96;07.10.2013;2013;10;18;Maanantai;87;75;162;20;18;38
96;07.10.2013;2013;10;19;Maanantai;62;55;117;15;25;40
96;07.10.2013;2013;10;20;Maanantai;52;36;88;12;12;24
96;07.10.2013;2013;10;21;Maanantai;37;10;47;10;4;14
96;07.10.2013;2013;10;22;Maanantai;16;11;27;0;2;2
96;07.10.2013;2013;10;23;Maanantai;6;3;9;2;0;2
96;08.10.2013;2013;10;00;Tiistai;1;1;2;1;0;1
96;08.10.2013;2013;10;01;Tiistai;0;1;1;0;0;0
96;08.10.2013;2013;10;02;Tiistai;0;0;0;0;0;0
96;08.10.2013;2013;10;03;Tiistai;2;0;2;0;0;0
96;08.10.2013;2013;10;04;Tiistai;2;3;5;1;0;1
96;08.10.2013;2013;10;05;Tiistai;1;8;9;0;0;0
96;08.10.2013;2013;10;06;Tiistai;47;36;83;8;3;11
96;08.10.2013;2013;10;07;Tiistai;119;148;267;14;5;19
96;08.10.2013;2013;10;08;Tiistai;162;171;333;12;4;16
96;08.10.2013;2013;10;09;Tiistai;65;94;159;13;8;21
96;08.10.2013;2013;10;10;Tiistai;43;71;114;5;8;13
96;08.10.2013;2013;10;11;Tiistai;52;80;132;7;9;16
96;08.10.2013;2013;10;12;Tiistai;63;81;144;4;5;9
96;08.10.2013;2013;10;13;Tiistai;64;85;149;5;13;18
96;08.10.2013;2013;10;14;Tiistai;104;133;237;8;7;15
96;08.10.2013;2013;10;15;Tiistai;115;218;333;4;16;20
96;08.10.2013;2013;10;16;Tiistai;166;199;365;9;19;28
96;08.10.2013;2013;10;17;Tiistai;84;95;179;21;19;40
96;08.10.2013;2013;10;18;Tiistai;84;68;152;13;16;29
96;08.10.2013;2013;10;19;Tiistai;57;51;108;19;20;39
96;08.10.2013;2013;10;20;Tiistai;45;59;104;13;20;33
96;08.10.2013;2013;10;21;Tiistai;31;31;62;6;11;17
96;08.10.2013;2013;10;22;Tiistai;13;5;18;0;2;2
96;08.10.2013;2013;10;23;Tiistai;10;1;11;0;1;1
96;09.10.2013;2013;10;00;Keskiviikko;5;2;7;0;0;0
96;09.10.2013;2013;10;01;Keskiviikko;2;0;2;0;0;0
96;09.10.2013;2013;10;02;Keskiviikko;0;3;3;0;1;1
96;09.10.2013;2013;10;03;Keskiviikko;2;1;3;0;0;0
96;09.10.2013;2013;10;04;Keskiviikko;5;2;7;0;0;0
96;09.10.2013;2013;10;05;Keskiviikko;1;5;6;1;0;1
96;09.10.2013;2013;10;06;Keskiviikko;42;36;78;5;5;10
96;09.10.2013;2013;10;07;Keskiviikko;102;123;225;8;2;10
96;09.10.2013;2013;10;08;Keskiviikko;135;130;265;13;3;16
96;09.10.2013;2013;10;09;Keskiviikko;65;106;171;13;7;20
96;09.10.2013;2013;10;10;Keskiviikko;48;70;118;4;7;11
96;09.10.2013;2013;10;11;Keskiviikko;63;65;128;14;14;28
96;09.10.2013;2013;10;12;Keskiviikko;80;83;163;14;9;23
96;09.10.2013;2013;10;13;Keskiviikko;60;82;142;5;9;14
96;09.10.2013;2013;10;14;Keskiviikko;102;150;252;7;22;29
96;09.10.2013;2013;10;15;Keskiviikko;76;186;262;3;19;22
96;09.10.2013;2013;10;16;Keskiviikko;111;140;251;8;14;22
96;09.10.2013;2013;10;17;Keskiviikko;81;76;157;6;7;13
96;09.10.2013;2013;10;18;Keskiviikko;64;38;102;7;12;19
96;09.10.2013;2013;10;19;Keskiviikko;49;28;77;10;12;22
96;09.10.2013;2013;10;20;Keskiviikko;45;27;72;9;11;20
96;09.10.2013;2013;10;21;Keskiviikko;28;19;47;3;6;9
96;09.10.2013;2013;10;22;Keskiviikko;13;7;20;2;0;2
96;09.10.2013;2013;10;23;Keskiviikko;7;2;9;2;0;2
96;10.10.2013;2013;10;00;Torstai;0;0;0;0;0;0
96;10.10.2013;2013;10;01;Torstai;1;0;1;0;0;0
96;10.10.2013;2013;10;02;Torstai;1;1;2;0;0;0
96;10.10.2013;2013;10;03;Torstai;0;1;1;3;1;4
96;10.10.2013;2013;10;04;Torstai;4;1;5;0;0;0
96;10.10.2013;2013;10;05;Torstai;5;11;16;1;0;1
96;10.10.2013;2013;10;06;Torstai;41;37;78;9;2;11
96;10.10.2013;2013;10;07;Torstai;110;150;260;11;6;17
96;10.10.2013;2013;10;08;Torstai;147;151;298;8;10;18
96;10.10.2013;2013;10;09;Torstai;100;98;198;8;8;16
96;10.10.2013;2013;10;10;Torstai;57;69;126;4;19;23
96;10.10.2013;2013;10;11;Torstai;69;101;170;12;14;26
96;10.10.2013;2013;10;12;Torstai;94;121;215;13;10;23
96;10.10.2013;2013;10;13;Torstai;90;120;210;19;16;35
96;10.10.2013;2013;10;14;Torstai;109;168;277;11;14;25
96;10.10.2013;2013;10;15;Torstai;141;232;373;14;18;32
96;10.10.2013;2013;10;16;Torstai;146;193;339;7;20;27
96;10.10.2013;2013;10;17;Torstai;88;100;188;13;12;25
96;10.10.2013;2013;10;18;Torstai;68;67;135;11;11;22
96;10.10.2013;2013;10;19;Torstai;71;51;122;13;9;22
96;10.10.2013;2013;10;20;Torstai;63;33;96;13;13;26
96;10.10.2013;2013;10;21;Torstai;33;17;50;7;12;19
96;10.10.2013;2013;10;22;Torstai;16;7;23;0;3;3
96;10.10.2013;2013;10;23;Torstai;8;9;17;3;2;5
96;11.10.2013;2013;10;00;Perjantai;3;0;3;1;0;1
96;11.10.2013;2013;10;01;Perjantai;7;1;8;0;0;0
96;11.10.2013;2013;10;02;Perjantai;3;0;3;0;0;0
96;11.10.2013;2013;10;03;Perjantai;11;1;12;0;0;0
96;11.10.2013;2013;10;04;Perjantai;5;2;7;2;0;2
96;11.10.2013;2013;10;05;Perjantai;4;6;10;1;0;1
96;11.10.2013;2013;10;06;Perjantai;47;37;84;7;7;14
96;11.10.2013;2013;10;07;Perjantai;95;118;213;7;2;9
96;11.10.2013;2013;10;08;Perjantai;146;132;278;15;12;27
96;11.10.2013;2013;10;09;Perjantai;63;96;159;12;13;25
96;11.10.2013;2013;10;10;Perjantai;44;69;113;9;4;13
96;11.10.2013;2013;10;11;Perjantai;64;76;140;8;10;18
96;11.10.2013;2013;10;12;Perjantai;89;95;184;8;7;15
96;11.10.2013;2013;10;13;Perjantai;72;116;188;8;8;16
96;11.10.2013;2013;10;14;Perjantai;101;189;290;18;19;37
96;11.10.2013;2013;10;15;Perjantai;99;188;287;15;25;40
96;11.10.2013;2013;10;16;Perjantai;97;96;193;7;7;14
96;11.10.2013;2013;10;17;Perjantai;63;69;132;6;9;15
96;11.10.2013;2013;10;18;Perjantai;57;45;102;10;7;17
96;11.10.2013;2013;10;19;Perjantai;44;34;78;8;13;21
96;11.10.2013;2013;10;20;Perjantai;46;24;70;8;7;15
96;11.10.2013;2013;10;21;Perjantai;28;25;53;3;2;5
96;11.10.2013;2013;10;22;Perjantai;16;11;27;2;3;5
96;11.10.2013;2013;10;23;Perjantai;9;3;12;1;3;4
96;12.10.2013;2013;10;00;Lauantai;10;4;14;1;0;1
96;12.10.2013;2013;10;01;Lauantai;7;8;15;3;0;3
96;12.10.2013;2013;10;02;Lauantai;8;0;8;1;1;2
96;12.10.2013;2013;10;03;Lauantai;14;0;14;1;1;2
96;12.10.2013;2013;10;04;Lauantai;10;1;11;3;0;3
96;12.10.2013;2013;10;05;Lauantai;0;2;2;0;0;0
96;12.10.2013;2013;10;06;Lauantai;12;12;24;1;0;1
96;12.10.2013;2013;10;07;Lauantai;13;19;32;1;3;4
96;12.10.2013;2013;10;08;Lauantai;16;25;41;3;6;9
96;12.10.2013;2013;10;09;Lauantai;19;67;86;4;8;12
96;12.10.2013;2013;10;10;Lauantai;30;48;78;9;35;44
96;12.10.2013;2013;10;11;Lauantai;41;69;110;15;71;86
96;12.10.2013;2013;10;12;Lauantai;76;77;153;33;26;59
96;12.10.2013;2013;10;13;Lauantai;51;64;115;48;28;76
96;12.10.2013;2013;10;14;Lauantai;65;71;136;56;16;72
96;12.10.2013;2013;10;15;Lauantai;85;69;154;22;9;31
96;12.10.2013;2013;10;16;Lauantai;52;88;140;19;18;37
96;12.10.2013;2013;10;17;Lauantai;52;37;89;15;9;24
96;12.10.2013;2013;10;18;Lauantai;56;23;79;16;8;24
96;12.10.2013;2013;10;19;Lauantai;68;32;100;17;9;26
96;12.10.2013;2013;10;20;Lauantai;22;27;49;7;6;13
96;12.10.2013;2013;10;21;Lauantai;23;38;61;2;4;6
96;12.10.2013;2013;10;22;Lauantai;14;19;33;1;1;2
96;12.10.2013;2013;10;23;Lauantai;18;20;38;2;0;2
96;13.10.2013;2013;10;00;Sunnuntai;8;19;27;2;1;3
96;13.10.2013;2013;10;01;Sunnuntai;10;3;13;0;0;0
96;13.10.2013;2013;10;02;Sunnuntai;12;4;16;2;0;2
96;13.10.2013;2013;10;03;Sunnuntai;21;3;24;5;0;5
96;13.10.2013;2013;10;04;Sunnuntai;16;0;16;2;0;2
96;13.10.2013;2013;10;05;Sunnuntai;6;1;7;0;1;1
96;13.10.2013;2013;10;06;Sunnuntai;9;3;12;2;0;2
96;13.10.2013;2013;10;07;Sunnuntai;3;14;17;1;0;1
96;13.10.2013;2013;10;08;Sunnuntai;4;3;7;0;0;0
96;13.10.2013;2013;10;09;Sunnuntai;5;12;17;6;8;14
96;13.10.2013;2013;10;10;Sunnuntai;12;27;39;5;9;14
96;13.10.2013;2013;10;11;Sunnuntai;13;38;51;13;25;38
96;13.10.2013;2013;10;12;Sunnuntai;37;58;95;20;14;34
96;13.10.2013;2013;10;13;Sunnuntai;41;73;114;33;16;49
96;13.10.2013;2013;10;14;Sunnuntai;55;41;96;25;15;40
96;13.10.2013;2013;10;15;Sunnuntai;53;48;101;16;8;24
96;13.10.2013;2013;10;16;Sunnuntai;61;42;103;24;7;31
96;13.10.2013;2013;10;17;Sunnuntai;57;44;101;14;16;30
96;13.10.2013;2013;10;18;Sunnuntai;34;35;69;19;27;46
96;13.10.2013;2013;10;19;Sunnuntai;29;47;76;8;19;27
96;13.10.2013;2013;10;20;Sunnuntai;18;26;44;12;12;24
96;13.10.2013;2013;10;21;Sunnuntai;17;13;30;8;3;11
96;13.10.2013;2013;10;22;Sunnuntai;11;10;21;2;2;4
96;13.10.2013;2013;10;23;Sunnuntai;5;3;8;1;1;2
96;14.10.2013;2013;10;00;Maanantai;2;1;3;0;1;1
96;14.10.2013;2013;10;01;Maanantai;1;0;1;2;0;2
96;14.10.2013;2013;10;02;Maanantai;0;0;0;0;0;0
96;14.10.2013;2013;10;03;Maanantai;0;0;0;0;0;0
96;14.10.2013;2013;10;04;Maanantai;2;1;3;1;0;1
96;14.10.2013;2013;10;05;Maanantai;2;9;11;0;1;1
96;14.10.2013;2013;10;06;Maanantai;37;34;71;6;6;12
96;14.10.2013;2013;10;07;Maanantai;103;125;228;19;7;26
96;14.10.2013;2013;10;08;Maanantai;128;144;272;19;6;25
96;14.10.2013;2013;10;09;Maanantai;72;88;160;16;11;27
96;14.10.2013;2013;10;10;Maanantai;52;78;130;10;13;23
96;14.10.2013;2013;10;11;Maanantai;47;73;120;8;16;24
96;14.10.2013;2013;10;12;Maanantai;68;67;135;12;7;19
96;14.10.2013;2013;10;13;Maanantai;62;68;130;7;13;20
96;14.10.2013;2013;10;14;Maanantai;77;106;183;1;13;14
96;14.10.2013;2013;10;15;Maanantai;98;209;307;7;16;23
96;14.10.2013;2013;10;16;Maanantai;107;174;281;10;19;29
96;14.10.2013;2013;10;17;Maanantai;82;95;177;17;13;30
96;14.10.2013;2013;10;18;Maanantai;70;53;123;11;13;24
96;14.10.2013;2013;10;19;Maanantai;53;30;83;16;8;24
96;14.10.2013;2013;10;20;Maanantai;57;24;81;8;13;21
96;14.10.2013;2013;10;21;Maanantai;42;18;60;8;8;16
96;14.10.2013;2013;10;22;Maanantai;9;9;18;1;1;2
96;14.10.2013;2013;10;23;Maanantai;1;4;5;0;1;1
96;15.10.2013;2013;10;00;Tiistai;2;0;2;2;0;2
96;15.10.2013;2013;10;01;Tiistai;3;0;3;0;1;1
96;15.10.2013;2013;10;02;Tiistai;0;0;0;0;0;0
96;15.10.2013;2013;10;03;Tiistai;1;0;1;0;0;0
96;15.10.2013;2013;10;04;Tiistai;2;1;3;0;0;0
96;15.10.2013;2013;10;05;Tiistai;3;6;9;1;0;1
96;15.10.2013;2013;10;06;Tiistai;41;44;85;3;4;7
96;15.10.2013;2013;10;07;Tiistai;113;151;264;17;10;27
96;15.10.2013;2013;10;08;Tiistai;118;146;264;8;6;14
96;15.10.2013;2013;10;09;Tiistai;65;83;148;15;12;27
96;15.10.2013;2013;10;10;Tiistai;54;71;125;6;7;13
96;15.10.2013;2013;10;11;Tiistai;54;82;136;5;9;14
96;15.10.2013;2013;10;12;Tiistai;84;65;149;13;20;33
96;15.10.2013;2013;10;13;Tiistai;70;83;153;15;7;22
96;15.10.2013;2013;10;14;Tiistai;70;138;208;9;22;31
96;15.10.2013;2013;10;15;Tiistai;92;224;316;9;21;30
96;15.10.2013;2013;10;16;Tiistai;144;189;333;14;21;35
96;15.10.2013;2013;10;17;Tiistai;90;94;184;9;13;22
96;15.10.2013;2013;10;18;Tiistai;58;65;123;19;17;36
96;15.10.2013;2013;10;19;Tiistai;78;51;129;19;22;41
96;15.10.2013;2013;10;20;Tiistai;43;32;75;9;11;20
96;15.10.2013;2013;10;21;Tiistai;37;29;66;8;8;16
96;15.10.2013;2013;10;22;Tiistai;4;8;12;2;3;5
96;15.10.2013;2013;10;23;Tiistai;6;2;8;0;0;0
96;16.10.2013;2013;10;00;Keskiviikko;2;2;4;2;0;2
96;16.10.2013;2013;10;01;Keskiviikko;0;0;0;0;1;1
96;16.10.2013;2013;10;02;Keskiviikko;3;1;4;0;0;0
96;16.10.2013;2013;10;03;Keskiviikko;1;1;2;1;0;1
96;16.10.2013;2013;10;04;Keskiviikko;3;2;5;0;0;0
96;16.10.2013;2013;10;05;Keskiviikko;2;6;8;2;3;5
96;16.10.2013;2013;10;06;Keskiviikko;39;27;66;4;5;9
96;16.10.2013;2013;10;07;Keskiviikko;107;119;226;18;9;27
96;16.10.2013;2013;10;08;Keskiviikko;146;113;259;12;6;18
96;16.10.2013;2013;10;09;Keskiviikko;84;81;165;8;6;14
96;16.10.2013;2013;10;10;Keskiviikko;50;57;107;9;14;23
96;16.10.2013;2013;10;11;Keskiviikko;58;80;138;9;15;24
96;16.10.2013;2013;10;12;Keskiviikko;80;77;157;9;13;22
96;16.10.2013;2013;10;13;Keskiviikko;62;96;158;12;15;27
96;16.10.2013;2013;10;14;Keskiviikko;88;140;228;7;16;23
96;16.10.2013;2013;10;15;Keskiviikko;95;174;269;9;23;32
96;16.10.2013;2013;10;16;Keskiviikko;126;173;299;12;24;36
96;16.10.2013;2013;10;17;Keskiviikko;68;111;179;7;8;15
96;16.10.2013;2013;10;18;Keskiviikko;89;51;140;17;11;28
96;16.10.2013;2013;10;19;Keskiviikko;70;57;127;12;8;20
96;16.10.2013;2013;10;20;Keskiviikko;56;32;88;10;16;26
96;16.10.2013;2013;10;21;Keskiviikko;29;36;65;7;15;22
96;16.10.2013;2013;10;22;Keskiviikko;15;10;25;2;2;4
96;16.10.2013;2013;10;23;Keskiviikko;2;5;7;0;0;0
96;17.10.2013;2013;10;00;Torstai;4;3;7;0;0;0
96;17.10.2013;2013;10;01;Torstai;2;1;3;1;0;1
96;17.10.2013;2013;10;02;Torstai;2;0;2;0;0;0
96;17.10.2013;2013;10;03;Torstai;1;0;1;0;0;0
96;17.10.2013;2013;10;04;Torstai;2;3;5;0;0;0
96;17.10.2013;2013;10;05;Torstai;4;8;12;4;3;7
96;17.10.2013;2013;10;06;Torstai;39;32;71;6;5;11
96;17.10.2013;2013;10;07;Torstai;114;107;221;21;4;25
96;17.10.2013;2013;10;08;Torstai;127;115;242;6;5;11
96;17.10.2013;2013;10;09;Torstai;59;90;149;7;8;15
96;17.10.2013;2013;10;10;Torstai;57;66;123;10;8;18
96;17.10.2013;2013;10;11;Torstai;39;57;96;8;18;26
96;17.10.2013;2013;10;12;Torstai;57;67;124;5;8;13
96;17.10.2013;2013;10;13;Torstai;54;84;138;5;8;13
96;17.10.2013;2013;10;14;Torstai;72;126;198;9;11;20
96;17.10.2013;2013;10;15;Torstai;90;184;274;8;22;30
96;17.10.2013;2013;10;16;Torstai;124;161;285;8;21;29
96;17.10.2013;2013;10;17;Torstai;60;83;143;7;3;10
96;17.10.2013;2013;10;18;Torstai;50;54;104;16;14;30
96;17.10.2013;2013;10;19;Torstai;56;31;87;6;8;14
96;17.10.2013;2013;10;20;Torstai;40;23;63;6;9;15
96;17.10.2013;2013;10;21;Torstai;30;21;51;5;5;10
96;17.10.2013;2013;10;22;Torstai;11;13;24;0;1;1
96;17.10.2013;2013;10;23;Torstai;5;4;9;1;0;1
96;18.10.2013;2013;10;00;Perjantai;5;1;6;1;0;1
96;18.10.2013;2013;10;01;Perjantai;7;1;8;0;0;0
96;18.10.2013;2013;10;02;Perjantai;6;1;7;0;0;0
96;18.10.2013;2013;10;03;Perjantai;0;0;0;0;0;0
96;18.10.2013;2013;10;04;Perjantai;4;4;8;0;1;1
96;18.10.2013;2013;10;05;Perjantai;4;6;10;3;1;4
96;18.10.2013;2013;10;06;Perjantai;40;24;64;10;3;13
96;18.10.2013;2013;10;07;Perjantai;92;73;165;22;6;28
96;18.10.2013;2013;10;08;Perjantai;89;101;190;16;12;28
96;18.10.2013;2013;10;09;Perjantai;60;54;114;11;16;27
96;18.10.2013;2013;10;10;Perjantai;35;59;94;3;13;16
96;18.10.2013;2013;10;11;Perjantai;41;58;99;5;7;12
96;18.10.2013;2013;10;12;Perjantai;60;54;114;14;15;29
96;18.10.2013;2013;10;13;Perjantai;62;81;143;5;21;26
96;18.10.2013;2013;10;14;Perjantai;77;114;191;10;17;27
96;18.10.2013;2013;10;15;Perjantai;94;139;233;9;25;34
96;18.10.2013;2013;10;16;Perjantai;62;75;137;5;14;19
96;18.10.2013;2013;10;17;Perjantai;44;47;91;7;9;16
96;18.10.2013;2013;10;18;Perjantai;46;27;73;17;8;25
96;18.10.2013;2013;10;19;Perjantai;33;21;54;12;6;18
96;18.10.2013;2013;10;20;Perjantai;32;18;50;6;4;10
96;18.10.2013;2013;10;21;Perjantai;24;31;55;4;4;8
96;18.10.2013;2013;10;22;Perjantai;5;14;19;0;5;5
96;18.10.2013;2013;10;23;Perjantai;7;4;11;1;3;4
96;19.10.2013;2013;10;00;Lauantai;2;14;16;1;1;2
96;19.10.2013;2013;10;01;Lauantai;2;2;4;3;2;5
96;19.10.2013;2013;10;02;Lauantai;11;3;14;2;1;3
96;19.10.2013;2013;10;03;Lauantai;13;2;15;0;1;1
96;19.10.2013;2013;10;04;Lauantai;6;1;7;5;0;5
96;19.10.2013;2013;10;05;Lauantai;5;0;5;0;1;1
96;19.10.2013;2013;10;06;Lauantai;13;6;19;0;1;1
96;19.10.2013;2013;10;07;Lauantai;1;13;14;3;5;8
96;19.10.2013;2013;10;08;Lauantai;4;18;22;3;0;3
96;19.10.2013;2013;10;09;Lauantai;7;21;28;4;3;7
96;19.10.2013;2013;10;10;Lauantai;8;16;24;6;11;17
96;19.10.2013;2013;10;11;Lauantai;14;22;36;18;11;29
96;19.10.2013;2013;10;12;Lauantai;25;25;50;9;17;26
96;19.10.2013;2013;10;13;Lauantai;27;22;49;15;12;27
96;19.10.2013;2013;10;14;Lauantai;24;27;51;14;11;25
96;19.10.2013;2013;10;15;Lauantai;29;34;63;14;14;28
96;19.10.2013;2013;10;16;Lauantai;42;32;74;6;20;26
96;19.10.2013;2013;10;17;Lauantai;29;24;53;21;8;29
96;19.10.2013;2013;10;18;Lauantai;18;14;32;12;6;18
96;19.10.2013;2013;10;19;Lauantai;26;11;37;10;10;20
96;19.10.2013;2013;10;20;Lauantai;17;8;25;7;0;7
96;19.10.2013;2013;10;21;Lauantai;13;21;34;4;4;8
96;19.10.2013;2013;10;22;Lauantai;10;13;23;2;6;8
96;19.10.2013;2013;10;23;Lauantai;5;9;14;1;1;2
96;20.10.2013;2013;10;00;Sunnuntai;6;3;9;1;2;3
96;20.10.2013;2013;10;01;Sunnuntai;3;0;3;0;1;1
96;20.10.2013;2013;10;02;Sunnuntai;5;1;6;3;0;3
96;20.10.2013;2013;10;03;Sunnuntai;5;1;6;2;0;2
96;20.10.2013;2013;10;04;Sunnuntai;7;1;8;2;0;2
96;20.10.2013;2013;10;05;Sunnuntai;2;0;2;1;0;1
96;20.10.2013;2013;10;06;Sunnuntai;14;5;19;2;2;4
96;20.10.2013;2013;10;07;Sunnuntai;1;7;8;2;3;5
96;20.10.2013;2013;10;08;Sunnuntai;6;6;12;0;2;2
96;20.10.2013;2013;10;09;Sunnuntai;5;6;11;4;2;6
96;20.10.2013;2013;10;10;Sunnuntai;10;10;20;8;7;15
96;20.10.2013;2013;10;11;Sunnuntai;6;16;22;5;10;15
96;20.10.2013;2013;10;12;Sunnuntai;24;30;54;16;11;27
96;20.10.2013;2013;10;13;Sunnuntai;35;15;50;13;7;20
96;20.10.2013;2013;10;14;Sunnuntai;21;19;40;9;16;25
96;20.10.2013;2013;10;15;Sunnuntai;23;39;62;11;10;21
96;20.10.2013;2013;10;16;Sunnuntai;33;29;62;23;6;29
96;20.10.2013;2013;10;17;Sunnuntai;25;18;43;10;12;22
96;20.10.2013;2013;10;18;Sunnuntai;29;14;43;19;22;41
96;20.10.2013;2013;10;19;Sunnuntai;12;32;44;10;17;27
96;20.10.2013;2013;10;20;Sunnuntai;27;27;54;5;5;10
96;20.10.2013;2013;10;21;Sunnuntai;18;16;34;1;3;4
96;20.10.2013;2013;10;22;Sunnuntai;10;7;17;1;4;5
96;20.10.2013;2013;10;23;Sunnuntai;3;3;6;0;1;1
96;21.10.2013;2013;10;00;Maanantai;2;1;3;3;0;3
96;21.10.2013;2013;10;01;Maanantai;0;1;1;0;0;0
96;21.10.2013;2013;10;02;Maanantai;1;1;2;1;0;1
96;21.10.2013;2013;10;03;Maanantai;3;0;3;0;0;0
96;21.10.2013;2013;10;04;Maanantai;0;3;3;1;0;1
96;21.10.2013;2013;10;05;Maanantai;2;5;7;0;0;0
96;21.10.2013;2013;10;06;Maanantai;34;22;56;8;2;10
96;21.10.2013;2013;10;07;Maanantai;57;58;115;22;9;31
96;21.10.2013;2013;10;08;Maanantai;39;52;91;8;7;15
96;21.10.2013;2013;10;09;Maanantai;23;40;63;7;6;13
96;21.10.2013;2013;10;10;Maanantai;24;55;79;10;10;20
96;21.10.2013;2013;10;11;Maanantai;37;66;103;6;11;17
96;21.10.2013;2013;10;12;Maanantai;38;64;102;11;20;31
96;21.10.2013;2013;10;13;Maanantai;43;59;102;15;13;28
96;21.10.2013;2013;10;14;Maanantai;45;60;105;14;11;25
96;21.10.2013;2013;10;15;Maanantai;52;104;156;9;28;37
96;21.10.2013;2013;10;16;Maanantai;75;89;164;18;25;43
96;21.10.2013;2013;10;17;Maanantai;83;34;117;18;18;36
96;21.10.2013;2013;10;18;Maanantai;50;21;71;15;19;34
96;21.10.2013;2013;10;19;Maanantai;20;23;43;11;12;23
96;21.10.2013;2013;10;20;Maanantai;29;15;44;12;14;26
96;21.10.2013;2013;10;21;Maanantai;14;9;23;5;8;13
96;21.10.2013;2013;10;22;Maanantai;11;12;23;3;0;3
96;21.10.2013;2013;10;23;Maanantai;1;5;6;0;1;1
96;22.10.2013;2013;10;00;Tiistai;2;1;3;0;0;0
96;22.10.2013;2013;10;01;Tiistai;2;0;2;0;0;0
96;22.10.2013;2013;10;02;Tiistai;0;0;0;0;0;0
96;22.10.2013;2013;10;03;Tiistai;0;1;1;0;0;0
96;22.10.2013;2013;10;04;Tiistai;1;0;1;0;1;1
96;22.10.2013;2013;10;05;Tiistai;1;3;4;1;0;1
96;22.10.2013;2013;10;06;Tiistai;30;22;52;11;4;15
96;22.10.2013;2013;10;07;Tiistai;58;55;113;23;8;31
96;22.10.2013;2013;10;08;Tiistai;37;55;92;6;9;15
96;22.10.2013;2013;10;09;Tiistai;28;39;67;5;6;11
96;22.10.2013;2013;10;10;Tiistai;19;37;56;4;10;14
96;22.10.2013;2013;10;11;Tiistai;26;46;72;14;15;29
96;22.10.2013;2013;10;12;Tiistai;51;55;106;10;18;28
96;22.10.2013;2013;10;13;Tiistai;42;60;102;8;16;24
96;22.10.2013;2013;10;14;Tiistai;45;61;106;8;17;25
96;22.10.2013;2013;10;15;Tiistai;68;91;159;15;24;39
96;22.10.2013;2013;10;16;Tiistai;82;80;162;15;31;46
96;22.10.2013;2013;10;17;Tiistai;41;54;95;11;8;19
96;22.10.2013;2013;10;18;Tiistai;60;55;115;15;21;36
96;22.10.2013;2013;10;19;Tiistai;27;13;40;13;11;24
96;22.10.2013;2013;10;20;Tiistai;54;18;72;20;5;25
96;22.10.2013;2013;10;21;Tiistai;29;19;48;5;7;12
96;22.10.2013;2013;10;22;Tiistai;5;9;14;1;2;3
96;22.10.2013;2013;10;23;Tiistai;7;2;9;0;0;0
96;23.10.2013;2013;10;00;Keskiviikko;6;1;7;3;0;3
96;23.10.2013;2013;10;01;Keskiviikko;1;0;1;0;0;0
96;23.10.2013;2013;10;02;Keskiviikko;0;1;1;0;0;0
96;23.10.2013;2013;10;03;Keskiviikko;1;0;1;0;0;0
96;23.10.2013;2013;10;04;Keskiviikko;3;0;3;0;1;1
96;23.10.2013;2013;10;05;Keskiviikko;1;3;4;0;1;1
96;23.10.2013;2013;10;06;Keskiviikko;33;23;56;9;3;12
96;23.10.2013;2013;10;07;Keskiviikko;57;41;98;25;6;31
96;23.10.2013;2013;10;08;Keskiviikko;31;41;72;8;10;18
96;23.10.2013;2013;10;09;Keskiviikko;12;13;25;2;3;5
96;23.10.2013;2013;10;10;Keskiviikko;8;21;29;4;6;10
96;23.10.2013;2013;10;11;Keskiviikko;19;13;32;3;4;7
96;23.10.2013;2013;10;12;Keskiviikko;26;20;46;5;7;12
96;23.10.2013;2013;10;13;Keskiviikko;20;16;36;2;5;7
96;23.10.2013;2013;10;14;Keskiviikko;24;35;59;0;6;6
96;23.10.2013;2013;10;15;Keskiviikko;40;84;124;2;21;23
96;23.10.2013;2013;10;16;Keskiviikko;46;54;100;5;15;20
96;23.10.2013;2013;10;17;Keskiviikko;32;29;61;4;1;5
96;23.10.2013;2013;10;18;Keskiviikko;25;23;48;4;4;8
96;23.10.2013;2013;10;19;Keskiviikko;20;11;31;8;5;13
96;23.10.2013;2013;10;20;Keskiviikko;18;8;26;10;5;15
96;23.10.2013;2013;10;21;Keskiviikko;15;21;36;1;3;4
96;23.10.2013;2013;10;22;Keskiviikko;5;4;9;1;1;2
96;23.10.2013;2013;10;23;Keskiviikko;4;4;8;0;2;2
96;24.10.2013;2013;10;00;Torstai;5;3;8;1;1;2
96;24.10.2013;2013;10;01;Torstai;3;0;3;1;0;1
96;24.10.2013;2013;10;02;Torstai;4;1;5;0;1;1
96;24.10.2013;2013;10;03;Torstai;0;2;2;2;0;2
96;24.10.2013;2013;10;04;Torstai;2;1;3;0;0;0
96;24.10.2013;2013;10;05;Torstai;3;3;6;0;0;0
96;24.10.2013;2013;10;06;Torstai;32;23;55;11;1;12
96;24.10.2013;2013;10;07;Torstai;56;55;111;13;7;20
96;24.10.2013;2013;10;08;Torstai;32;37;69;9;6;15
96;24.10.2013;2013;10;09;Torstai;23;31;54;6;5;11
96;24.10.2013;2013;10;10;Torstai;9;34;43;6;12;18
96;24.10.2013;2013;10;11;Torstai;24;34;58;7;12;19
96;24.10.2013;2013;10;12;Torstai;38;39;77;4;5;9
96;24.10.2013;2013;10;13;Torstai;31;26;57;2;5;7
96;24.10.2013;2013;10;14;Torstai;15;37;52;3;2;5
96;24.10.2013;2013;10;15;Torstai;40;86;126;4;15;19
96;24.10.2013;2013;10;16;Torstai;54;50;104;4;9;13
96;24.10.2013;2013;10;17;Torstai;26;35;61;8;6;14
96;24.10.2013;2013;10;18;Torstai;35;23;58;10;6;16
96;24.10.2013;2013;10;19;Torstai;22;19;41;9;9;18
96;24.10.2013;2013;10;20;Torstai;20;14;34;6;9;15
96;24.10.2013;2013;10;21;Torstai;17;23;40;3;5;8
96;24.10.2013;2013;10;22;Torstai;8;2;10;1;2;3
96;24.10.2013;2013;10;23;Torstai;5;8;13;0;0;0
96;25.10.2013;2013;10;00;Perjantai;5;1;6;1;0;1
96;25.10.2013;2013;10;01;Perjantai;2;0;2;0;0;0
96;25.10.2013;2013;10;02;Perjantai;10;0;10;0;0;0
96;25.10.2013;2013;10;03;Perjantai;4;1;5;0;0;0
96;25.10.2013;2013;10;04;Perjantai;5;3;8;0;0;0
96;25.10.2013;2013;10;05;Perjantai;1;4;5;0;0;0
96;25.10.2013;2013;10;06;Perjantai;33;21;54;10;3;13
96;25.10.2013;2013;10;07;Perjantai;56;43;99;11;6;17
96;25.10.2013;2013;10;08;Perjantai;37;33;70;7;2;9
96;25.10.2013;2013;10;09;Perjantai;26;25;51;4;9;13
96;25.10.2013;2013;10;10;Perjantai;27;38;65;2;7;9
96;25.10.2013;2013;10;11;Perjantai;25;38;63;6;7;13
96;25.10.2013;2013;10;12;Perjantai;41;45;86;8;4;12
96;25.10.2013;2013;10;13;Perjantai;31;61;92;9;8;17
96;25.10.2013;2013;10;14;Perjantai;38;71;109;4;14;18
96;25.10.2013;2013;10;15;Perjantai;46;92;138;5;14;19
96;25.10.2013;2013;10;16;Perjantai;48;57;105;8;8;16
96;25.10.2013;2013;10;17;Perjantai;42;35;77;13;5;18
96;25.10.2013;2013;10;18;Perjantai;38;21;59;6;10;16
96;25.10.2013;2013;10;19;Perjantai;15;23;38;10;11;21
96;25.10.2013;2013;10;20;Perjantai;14;17;31;4;3;7
96;25.10.2013;2013;10;21;Perjantai;12;22;34;3;3;6
96;25.10.2013;2013;10;22;Perjantai;10;10;20;2;1;3
96;25.10.2013;2013;10;23;Perjantai;10;2;12;0;1;1
96;26.10.2013;2013;10;00;Lauantai;5;2;7;1;0;1
96;26.10.2013;2013;10;01;Lauantai;2;1;3;1;0;1
96;26.10.2013;2013;10;02;Lauantai;5;1;6;2;0;2
96;26.10.2013;2013;10;03;Lauantai;4;1;5;0;0;0
96;26.10.2013;2013;10;04;Lauantai;6;0;6;3;1;4
96;26.10.2013;2013;10;05;Lauantai;3;0;3;0;0;0
96;26.10.2013;2013;10;06;Lauantai;17;9;26;2;1;3
96;26.10.2013;2013;10;07;Lauantai;0;12;12;2;4;6
96;26.10.2013;2013;10;08;Lauantai;5;18;23;0;2;2
96;26.10.2013;2013;10;09;Lauantai;12;22;34;2;2;4
96;26.10.2013;2013;10;10;Lauantai;16;32;48;4;2;6
96;26.10.2013;2013;10;11;Lauantai;18;21;39;15;13;28
96;26.10.2013;2013;10;12;Lauantai;28;40;68;6;13;19
96;26.10.2013;2013;10;13;Lauantai;40;41;81;6;11;17
96;26.10.2013;2013;10;14;Lauantai;47;50;97;5;7;12
96;26.10.2013;2013;10;15;Lauantai;40;39;79;14;17;31
96;26.10.2013;2013;10;16;Lauantai;42;70;112;7;20;27
96;26.10.2013;2013;10;17;Lauantai;33;35;68;10;13;23
96;26.10.2013;2013;10;18;Lauantai;27;24;51;8;10;18
96;26.10.2013;2013;10;19;Lauantai;48;25;73;13;13;26
96;26.10.2013;2013;10;20;Lauantai;13;18;31;3;5;8
96;26.10.2013;2013;10;21;Lauantai;15;14;29;3;8;11
96;26.10.2013;2013;10;22;Lauantai;7;18;25;0;3;3
96;26.10.2013;2013;10;23;Lauantai;9;6;15;0;0;0
96;27.10.2013;2013;10;00;Sunnuntai;3;8;11;1;2;3
96;27.10.2013;2013;10;01;Sunnuntai;6;2;8;1;1;2
96;27.10.2013;2013;10;02;Sunnuntai;4;3;7;2;1;3
96;27.10.2013;2013;10;03;Sunnuntai;20;2;22;2;0;2
96;27.10.2013;2013;10;04;Sunnuntai;4;1;5;0;0;0
96;27.10.2013;2013;10;05;Sunnuntai;2;1;3;0;0;0
96;27.10.2013;2013;10;06;Sunnuntai;8;8;16;4;1;5
96;27.10.2013;2013;10;07;Sunnuntai;2;11;13;1;2;3
96;27.10.2013;2013;10;08;Sunnuntai;7;9;16;0;4;4
96;27.10.2013;2013;10;09;Sunnuntai;13;8;21;4;6;10
96;27.10.2013;2013;10;10;Sunnuntai;11;15;26;6;6;12
96;27.10.2013;2013;10;11;Sunnuntai;12;16;28;6;5;11
96;27.10.2013;2013;10;12;Sunnuntai;28;33;61;8;9;17
96;27.10.2013;2013;10;13;Sunnuntai;27;33;60;7;9;16
96;27.10.2013;2013;10;14;Sunnuntai;24;30;54;8;11;19
96;27.10.2013;2013;10;15;Sunnuntai;28;24;52;10;7;17
96;27.10.2013;2013;10;16;Sunnuntai;50;20;70;20;3;23
96;27.10.2013;2013;10;17;Sunnuntai;32;29;61;15;8;23
96;27.10.2013;2013;10;18;Sunnuntai;20;25;45;15;34;49
96;27.10.2013;2013;10;19;Sunnuntai;14;29;43;13;16;29
96;27.10.2013;2013;10;20;Sunnuntai;12;21;33;4;9;13
96;27.10.2013;2013;10;21;Sunnuntai;22;17;39;3;5;8
96;27.10.2013;2013;10;22;Sunnuntai;7;5;12;3;0;3
96;27.10.2013;2013;10;23;Sunnuntai;1;4;5;2;0;2
96;28.10.2013;2013;10;00;Maanantai;1;4;5;1;1;2
96;28.10.2013;2013;10;01;Maanantai;1;0;1;1;1;2
96;28.10.2013;2013;10;02;Maanantai;0;0;0;1;0;1
96;28.10.2013;2013;10;03;Maanantai;0;0;0;0;0;0
96;28.10.2013;2013;10;04;Maanantai;2;1;3;0;0;0
96;28.10.2013;2013;10;05;Maanantai;2;8;10;0;0;0
96;28.10.2013;2013;10;06;Maanantai;42;37;79;3;1;4
96;28.10.2013;2013;10;07;Maanantai;107;103;210;12;6;18
96;28.10.2013;2013;10;08;Maanantai;133;118;251;8;10;18
96;28.10.2013;2013;10;09;Maanantai;65;56;121;6;7;13
96;28.10.2013;2013;10;10;Maanantai;40;56;96;2;8;10
96;28.10.2013;2013;10;11;Maanantai;35;42;77;2;6;8
96;28.10.2013;2013;10;12;Maanantai;43;57;100;4;8;12
96;28.10.2013;2013;10;13;Maanantai;43;68;111;1;5;6
96;28.10.2013;2013;10;14;Maanantai;63;131;194;2;11;13
96;28.10.2013;2013;10;15;Maanantai;87;217;304;6;30;36
96;28.10.2013;2013;10;16;Maanantai;120;149;269;7;26;33
96;28.10.2013;2013;10;17;Maanantai;66;84;150;21;12;33
96;28.10.2013;2013;10;18;Maanantai;52;51;103;21;23;44
96;28.10.2013;2013;10;19;Maanantai;52;23;75;14;12;26
96;28.10.2013;2013;10;20;Maanantai;44;29;73;19;11;30
96;28.10.2013;2013;10;21;Maanantai;32;26;58;9;6;15
96;28.10.2013;2013;10;22;Maanantai;13;1;14;2;1;3
96;28.10.2013;2013;10;23;Maanantai;1;5;6;1;0;1
96;29.10.2013;2013;10;00;Tiistai;3;2;5;1;1;2
96;29.10.2013;2013;10;01;Tiistai;0;0;0;0;0;0
96;29.10.2013;2013;10;02;Tiistai;0;0;0;0;0;0
96;29.10.2013;2013;10;03;Tiistai;0;0;0;0;0;0
96;29.10.2013;2013;10;04;Tiistai;3;2;5;0;0;0
96;29.10.2013;2013;10;05;Tiistai;2;10;12;1;0;1
96;29.10.2013;2013;10;06;Tiistai;48;38;86;11;4;15
96;29.10.2013;2013;10;07;Tiistai;116;103;219;18;8;26
96;29.10.2013;2013;10;08;Tiistai;113;115;228;11;9;20
96;29.10.2013;2013;10;09;Tiistai;70;73;143;4;7;11
96;29.10.2013;2013;10;10;Tiistai;38;61;99;7;3;10
96;29.10.2013;2013;10;11;Tiistai;40;70;110;6;6;12
96;29.10.2013;2013;10;12;Tiistai;76;76;152;11;14;25
96;29.10.2013;2013;10;13;Tiistai;57;77;134;8;14;22
96;29.10.2013;2013;10;14;Tiistai;54;99;153;9;14;23
96;29.10.2013;2013;10;15;Tiistai;102;195;297;13;26;39
96;29.10.2013;2013;10;16;Tiistai;122;148;270;10;23;33
96;29.10.2013;2013;10;17;Tiistai;83;85;168;7;22;29
96;29.10.2013;2013;10;18;Tiistai;49;52;101;12;24;36
96;29.10.2013;2013;10;19;Tiistai;57;25;82;12;15;27
96;29.10.2013;2013;10;20;Tiistai;45;28;73;13;10;23
96;29.10.2013;2013;10;21;Tiistai;21;30;51;7;8;15
96;29.10.2013;2013;10;22;Tiistai;15;9;24;2;4;6
96;29.10.2013;2013;10;23;Tiistai;6;1;7;1;1;2
96;30.10.2013;2013;10;00;Keskiviikko;2;1;3;1;0;1
96;30.10.2013;2013;10;01;Keskiviikko;0;1;1;0;0;0
96;30.10.2013;2013;10;02;Keskiviikko;1;0;1;0;0;0
96;30.10.2013;2013;10;03;Keskiviikko;0;0;0;0;0;0
96;30.10.2013;2013;10;04;Keskiviikko;4;1;5;0;0;0
96;30.10.2013;2013;10;05;Keskiviikko;3;9;12;0;0;0
96;30.10.2013;2013;10;06;Keskiviikko;54;30;84;4;4;8
96;30.10.2013;2013;10;07;Keskiviikko;116;108;224;27;4;31
96;30.10.2013;2013;10;08;Keskiviikko;171;111;282;12;8;20
96;30.10.2013;2013;10;09;Keskiviikko;54;82;136;10;10;20
96;30.10.2013;2013;10;10;Keskiviikko;41;78;119;2;8;10
96;30.10.2013;2013;10;11;Keskiviikko;61;70;131;10;9;19
96;30.10.2013;2013;10;12;Keskiviikko;64;84;148;12;7;19
96;30.10.2013;2013;10;13;Keskiviikko;79;86;165;6;8;14
96;30.10.2013;2013;10;14;Keskiviikko;90;154;244;8;13;21
96;30.10.2013;2013;10;15;Keskiviikko;90;218;308;3;21;24
96;30.10.2013;2013;10;16;Keskiviikko;96;174;270;9;22;31
96;30.10.2013;2013;10;17;Keskiviikko;86;92;178;15;13;28
96;30.10.2013;2013;10;18;Keskiviikko;88;65;153;27;12;39
96;30.10.2013;2013;10;19;Keskiviikko;89;36;125;17;15;32
96;30.10.2013;2013;10;20;Keskiviikko;53;52;105;14;10;24
96;30.10.2013;2013;10;21;Keskiviikko;23;51;74;2;7;9
96;30.10.2013;2013;10;22;Keskiviikko;13;9;22;2;1;3
96;30.10.2013;2013;10;23;Keskiviikko;3;6;9;0;1;1
96;31.10.2013;2013;10;00;Torstai;6;2;8;0;0;0
96;31.10.2013;2013;10;01;Torstai;2;0;2;1;0;1
96;31.10.2013;2013;10;02;Torstai;2;1;3;0;0;0
96;31.10.2013;2013;10;03;Torstai;4;2;6;0;0;0
96;31.10.2013;2013;10;04;Torstai;6;2;8;0;0;0
96;31.10.2013;2013;10;05;Torstai;5;8;13;1;0;1
96;31.10.2013;2013;10;06;Torstai;41;31;72;9;2;11
96;31.10.2013;2013;10;07;Torstai;104;100;204;23;4;27
96;31.10.2013;2013;10;08;Torstai;137;102;239;17;11;28
96;31.10.2013;2013;10;09;Torstai;63;83;146;9;13;22
96;31.10.2013;2013;10;10;Torstai;50;53;103;10;11;21
96;31.10.2013;2013;10;11;Torstai;46;58;104;6;17;23
96;31.10.2013;2013;10;12;Torstai;53;78;131;7;6;13
96;31.10.2013;2013;10;13;Torstai;65;77;142;12;8;20
96;31.10.2013;2013;10;14;Torstai;61;118;179;3;8;11
96;31.10.2013;2013;10;15;Torstai;96;207;303;6;26;32
96;31.10.2013;2013;10;16;Torstai;82;177;259;7;23;30
96;31.10.2013;2013;10;17;Torstai;94;101;195;9;10;19
96;31.10.2013;2013;10;18;Torstai;63;40;103;12;20;32
96;31.10.2013;2013;10;19;Torstai;51;23;74;10;5;15
96;31.10.2013;2013;10;20;Torstai;36;25;61;7;7;14
96;31.10.2013;2013;10;21;Torstai;29;23;52;4;6;10
96;31.10.2013;2013;10;22;Torstai;16;6;22;2;2;4
96;31.10.2013;2013;10;23;Torstai;6;13;19;1;1;2
96;01.11.2013;2013;11;00;Perjantai;1;5;6;1;0;1
96;01.11.2013;2013;11;01;Perjantai;0;0;0;0;0;0
96;01.11.2013;2013;11;02;Perjantai;1;1;2;0;0;0
96;01.11.2013;2013;11;03;Perjantai;2;0;2;1;0;1
96;01.11.2013;2013;11;04;Perjantai;6;1;7;0;0;0
96;01.11.2013;2013;11;05;Perjantai;4;11;15;1;0;1
96;01.11.2013;2013;11;06;Perjantai;44;31;75;4;5;9
96;01.11.2013;2013;11;07;Perjantai;97;97;194;22;6;28
96;01.11.2013;2013;11;08;Perjantai;135;110;245;17;8;25
96;01.11.2013;2013;11;09;Perjantai;64;90;154;13;3;16
96;01.11.2013;2013;11;10;Perjantai;52;73;125;9;12;21
96;01.11.2013;2013;11;11;Perjantai;45;73;118;11;8;19
96;01.11.2013;2013;11;12;Perjantai;54;57;111;10;10;20
96;01.11.2013;2013;11;13;Perjantai;65;105;170;5;9;14
96;01.11.2013;2013;11;14;Perjantai;77;147;224;6;19;25
96;01.11.2013;2013;11;15;Perjantai;88;182;270;11;28;39
96;01.11.2013;2013;11;16;Perjantai;110;96;206;9;14;23
96;01.11.2013;2013;11;17;Perjantai;72;40;112;9;6;15
96;01.11.2013;2013;11;18;Perjantai;33;30;63;5;13;18
96;01.11.2013;2013;11;19;Perjantai;36;34;70;6;6;12
96;01.11.2013;2013;11;20;Perjantai;28;31;59;6;9;15
96;01.11.2013;2013;11;21;Perjantai;12;22;34;5;5;10
96;01.11.2013;2013;11;22;Perjantai;10;10;20;7;3;10
96;01.11.2013;2013;11;23;Perjantai;7;5;12;1;2;3
96;02.11.2013;2013;11;00;Lauantai;18;17;35;0;0;0
96;02.11.2013;2013;11;01;Lauantai;10;1;11;1;1;2
96;02.11.2013;2013;11;02;Lauantai;10;1;11;2;0;2
96;02.11.2013;2013;11;03;Lauantai;10;6;16;1;4;5
96;02.11.2013;2013;11;04;Lauantai;2;1;3;3;0;3
96;02.11.2013;2013;11;05;Lauantai;5;0;5;0;1;1
96;02.11.2013;2013;11;06;Lauantai;10;7;17;2;0;2
96;02.11.2013;2013;11;07;Lauantai;3;11;14;1;4;5
96;02.11.2013;2013;11;08;Lauantai;7;10;17;3;5;8
96;02.11.2013;2013;11;09;Lauantai;10;18;28;8;3;11
96;02.11.2013;2013;11;10;Lauantai;22;27;49;3;6;9
96;02.11.2013;2013;11;11;Lauantai;19;24;43;10;10;20
96;02.11.2013;2013;11;12;Lauantai;31;32;63;11;13;24
96;02.11.2013;2013;11;13;Lauantai;42;44;86;7;10;17
96;02.11.2013;2013;11;14;Lauantai;25;30;55;13;16;29
96;02.11.2013;2013;11;15;Lauantai;25;44;69;3;9;12
96;02.11.2013;2013;11;16;Lauantai;28;68;96;19;9;28
96;02.11.2013;2013;11;17;Lauantai;24;35;59;12;13;25
96;02.11.2013;2013;11;18;Lauantai;31;29;60;11;22;33
96;02.11.2013;2013;11;19;Lauantai;59;32;91;15;7;22
96;02.11.2013;2013;11;20;Lauantai;26;24;50;3;5;8
96;02.11.2013;2013;11;21;Lauantai;15;26;41;4;2;6
96;02.11.2013;2013;11;22;Lauantai;10;14;24;0;2;2
96;02.11.2013;2013;11;23;Lauantai;9;14;23;3;1;4
96;03.11.2013;2013;11;00;Sunnuntai;9;6;15;2;3;5
96;03.11.2013;2013;11;01;Sunnuntai;7;2;9;2;3;5
96;03.11.2013;2013;11;02;Sunnuntai;10;1;11;3;0;3
96;03.11.2013;2013;11;03;Sunnuntai;12;3;15;5;2;7
96;03.11.2013;2013;11;04;Sunnuntai;11;1;12;2;0;2
96;03.11.2013;2013;11;05;Sunnuntai;1;2;3;2;0;2
96;03.11.2013;2013;11;06;Sunnuntai;9;6;15;1;0;1
96;03.11.2013;2013;11;07;Sunnuntai;3;12;15;1;1;2
96;03.11.2013;2013;11;08;Sunnuntai;1;8;9;2;1;3
96;03.11.2013;2013;11;09;Sunnuntai;6;12;18;5;6;11
96;03.11.2013;2013;11;10;Sunnuntai;12;22;34;7;9;16
96;03.11.2013;2013;11;11;Sunnuntai;20;23;43;6;9;15
96;03.11.2013;2013;11;12;Sunnuntai;26;38;64;9;16;25
96;03.11.2013;2013;11;13;Sunnuntai;46;33;79;8;7;15
96;03.11.2013;2013;11;14;Sunnuntai;31;33;64;16;4;20
96;03.11.2013;2013;11;15;Sunnuntai;24;48;72;8;8;16
96;03.11.2013;2013;11;16;Sunnuntai;50;36;86;14;10;24
96;03.11.2013;2013;11;17;Sunnuntai;37;28;65;5;6;11
96;03.11.2013;2013;11;18;Sunnuntai;50;38;88;17;21;38
96;03.11.2013;2013;11;19;Sunnuntai;25;28;53;11;21;32
96;03.11.2013;2013;11;20;Sunnuntai;33;29;62;17;12;29
96;03.11.2013;2013;11;21;Sunnuntai;20;16;36;3;6;9
96;03.11.2013;2013;11;22;Sunnuntai;9;7;16;4;3;7
96;03.11.2013;2013;11;23;Sunnuntai;4;6;10;1;1;2
96;04.11.2013;2013;11;00;Maanantai;3;2;5;3;2;5
96;04.11.2013;2013;11;01;Maanantai;4;0;4;0;1;1
96;04.11.2013;2013;11;02;Maanantai;3;0;3;0;0;0
96;04.11.2013;2013;11;03;Maanantai;0;0;0;0;0;0
96;04.11.2013;2013;11;04;Maanantai;3;1;4;0;0;0
96;04.11.2013;2013;11;05;Maanantai;2;3;5;0;1;1
96;04.11.2013;2013;11;06;Maanantai;29;29;58;7;2;9
96;04.11.2013;2013;11;07;Maanantai;111;94;205;21;7;28
96;04.11.2013;2013;11;08;Maanantai;152;117;269;12;5;17
96;04.11.2013;2013;11;09;Maanantai;40;77;117;11;4;15
96;04.11.2013;2013;11;10;Maanantai;49;65;114;4;4;8
96;04.11.2013;2013;11;11;Maanantai;57;54;111;7;18;25
96;04.11.2013;2013;11;12;Maanantai;74;74;148;9;11;20
96;04.11.2013;2013;11;13;Maanantai;48;64;112;9;8;17
96;04.11.2013;2013;11;14;Maanantai;63;105;168;3;14;17
96;04.11.2013;2013;11;15;Maanantai;77;206;283;3;25;28
96;04.11.2013;2013;11;16;Maanantai;82;138;220;6;29;35
96;04.11.2013;2013;11;17;Maanantai;71;71;142;9;11;20
96;04.11.2013;2013;11;18;Maanantai;56;27;83;11;12;23
96;04.11.2013;2013;11;19;Maanantai;37;28;65;11;9;20
96;04.11.2013;2013;11;20;Maanantai;42;26;68;10;7;17
96;04.11.2013;2013;11;21;Maanantai;32;18;50;4;13;17
96;04.11.2013;2013;11;22;Maanantai;9;5;14;3;3;6
96;04.11.2013;2013;11;23;Maanantai;5;0;5;1;5;6
96;05.11.2013;2013;11;00;Tiistai;0;0;0;1;1;2
96;05.11.2013;2013;11;01;Tiistai;1;0;1;0;0;0
96;05.11.2013;2013;11;02;Tiistai;0;0;0;1;0;1
96;05.11.2013;2013;11;03;Tiistai;0;0;0;0;0;0
96;05.11.2013;2013;11;04;Tiistai;2;2;4;0;0;0
96;05.11.2013;2013;11;05;Tiistai;5;2;7;3;3;6
96;05.11.2013;2013;11;06;Tiistai;29;26;55;13;1;14
96;05.11.2013;2013;11;07;Tiistai;77;78;155;26;11;37
96;05.11.2013;2013;11;08;Tiistai;143;87;230;18;8;26
96;05.11.2013;2013;11;09;Tiistai;56;51;107;13;6;19
96;05.11.2013;2013;11;10;Tiistai;32;42;74;7;13;20
96;05.11.2013;2013;11;11;Tiistai;32;36;68;10;11;21
96;05.11.2013;2013;11;12;Tiistai;50;54;104;10;15;25
96;05.11.2013;2013;11;13;Tiistai;35;69;104;6;11;17
96;05.11.2013;2013;11;14;Tiistai;51;90;141;8;18;26
96;05.11.2013;2013;11;15;Tiistai;66;172;238;8;36;44
96;05.11.2013;2013;11;16;Tiistai;77;135;212;9;25;34
96;05.11.2013;2013;11;17;Tiistai;56;68;124;11;16;27
96;05.11.2013;2013;11;18;Tiistai;51;30;81;9;14;23
96;05.11.2013;2013;11;19;Tiistai;45;31;76;11;11;22
96;05.11.2013;2013;11;20;Tiistai;36;32;68;5;7;12
96;05.11.2013;2013;11;21;Tiistai;20;23;43;1;8;9
96;05.11.2013;2013;11;22;Tiistai;10;5;15;1;2;3
96;05.11.2013;2013;11;23;Tiistai;7;0;7;2;0;2
96;06.11.2013;2013;11;00;Keskiviikko;3;0;3;2;1;3
96;06.11.2013;2013;11;01;Keskiviikko;1;0;1;0;0;0
96;06.11.2013;2013;11;02;Keskiviikko;0;0;0;0;0;0
96;06.11.2013;2013;11;03;Keskiviikko;0;0;0;0;0;0
96;06.11.2013;2013;11;04;Keskiviikko;1;1;2;0;0;0
96;06.11.2013;2013;11;05;Keskiviikko;4;2;6;0;0;0
96;06.11.2013;2013;11;06;Keskiviikko;30;28;58;9;4;13
96;06.11.2013;2013;11;07;Keskiviikko;79;92;171;21;3;24
96;06.11.2013;2013;11;08;Keskiviikko;112;97;209;21;6;27
96;06.11.2013;2013;11;09;Keskiviikko;50;44;94;10;2;12
96;06.11.2013;2013;11;10;Keskiviikko;46;55;101;8;10;18
96;06.11.2013;2013;11;11;Keskiviikko;40;55;95;10;14;24
96;06.11.2013;2013;11;12;Keskiviikko;68;61;129;13;11;24
96;06.11.2013;2013;11;13;Keskiviikko;38;47;85;13;8;21
96;06.11.2013;2013;11;14;Keskiviikko;60;92;152;8;14;22
96;06.11.2013;2013;11;15;Keskiviikko;65;172;237;11;30;41
96;06.11.2013;2013;11;16;Keskiviikko;78;146;224;3;28;31
96;06.11.2013;2013;11;17;Keskiviikko;57;75;132;14;7;21
96;06.11.2013;2013;11;18;Keskiviikko;78;46;124;25;14;39
96;06.11.2013;2013;11;19;Keskiviikko;46;33;79;19;18;37
96;06.11.2013;2013;11;20;Keskiviikko;46;43;89;11;13;24
96;06.11.2013;2013;11;21;Keskiviikko;30;34;64;2;7;9
96;06.11.2013;2013;11;22;Keskiviikko;9;9;18;2;3;5
96;06.11.2013;2013;11;23;Keskiviikko;6;4;10;0;1;1
96;07.11.2013;2013;11;00;Torstai;2;5;7;0;0;0
96;07.11.2013;2013;11;01;Torstai;1;1;2;2;1;3
96;07.11.2013;2013;11;02;Torstai;9;3;12;1;0;1
96;07.11.2013;2013;11;03;Torstai;0;1;1;1;0;1
96;07.11.2013;2013;11;04;Torstai;2;0;2;0;1;1
96;07.11.2013;2013;11;05;Torstai;3;6;9;2;1;3
96;07.11.2013;2013;11;06;Torstai;34;25;59;7;1;8
96;07.11.2013;2013;11;07;Torstai;77;83;160;18;12;30
96;07.11.2013;2013;11;08;Torstai;111;100;211;26;6;32
96;07.11.2013;2013;11;09;Torstai;45;55;100;11;7;18
96;07.11.2013;2013;11;10;Torstai;42;46;88;13;13;26
96;07.11.2013;2013;11;11;Torstai;45;61;106;9;9;18
96;07.11.2013;2013;11;12;Torstai;63;59;122;12;11;23
96;07.11.2013;2013;11;13;Torstai;55;52;107;8;9;17
96;07.11.2013;2013;11;14;Torstai;55;92;147;13;18;31
96;07.11.2013;2013;11;15;Torstai;67;170;237;9;25;34
96;07.11.2013;2013;11;16;Torstai;88;160;248;12;27;39
96;07.11.2013;2013;11;17;Torstai;67;72;139;11;15;26
96;07.11.2013;2013;11;18;Torstai;50;57;107;16;15;31
96;07.11.2013;2013;11;19;Torstai;50;30;80;12;10;22
96;07.11.2013;2013;11;20;Torstai;46;34;80;10;12;22
96;07.11.2013;2013;11;21;Torstai;30;25;55;8;5;13
96;07.11.2013;2013;11;22;Torstai;7;10;17;2;4;6
96;07.11.2013;2013;11;23;Torstai;5;9;14;1;3;4
96;08.11.2013;2013;11;00;Perjantai;8;4;12;0;0;0
96;08.11.2013;2013;11;01;Perjantai;4;0;4;0;1;1
96;08.11.2013;2013;11;02;Perjantai;3;0;3;0;0;0
96;08.11.2013;2013;11;03;Perjantai;7;0;7;1;0;1
96;08.11.2013;2013;11;04;Perjantai;4;1;5;2;0;2
96;08.11.2013;2013;11;05;Perjantai;2;4;6;2;1;3
96;08.11.2013;2013;11;06;Perjantai;28;31;59;7;7;14
96;08.11.2013;2013;11;07;Perjantai;71;91;162;14;8;22
96;08.11.2013;2013;11;08;Perjantai;112;102;214;15;11;26
96;08.11.2013;2013;11;09;Perjantai;44;66;110;8;10;18
96;08.11.2013;2013;11;10;Perjantai;44;61;105;7;9;16
96;08.11.2013;2013;11;11;Perjantai;38;53;91;2;11;13
96;08.11.2013;2013;11;12;Perjantai;56;66;122;15;10;25
96;08.11.2013;2013;11;13;Perjantai;48;79;127;10;14;24
96;08.11.2013;2013;11;14;Perjantai;72;112;184;9;16;25
96;08.11.2013;2013;11;15;Perjantai;69;135;204;11;19;30
96;08.11.2013;2013;11;16;Perjantai;72;74;146;4;7;11
96;08.11.2013;2013;11;17;Perjantai;56;41;97;5;6;11
96;08.11.2013;2013;11;18;Perjantai;27;31;58;12;10;22
96;08.11.2013;2013;11;19;Perjantai;29;25;54;6;8;14
96;08.11.2013;2013;11;20;Perjantai;23;18;41;5;3;8
96;08.11.2013;2013;11;21;Perjantai;16;14;30;4;3;7
96;08.11.2013;2013;11;22;Perjantai;6;10;16;2;1;3
96;08.11.2013;2013;11;23;Perjantai;6;9;15;2;2;4
96;09.11.2013;2013;11;00;Lauantai;9;9;18;2;0;2
96;09.11.2013;2013;11;01;Lauantai;6;3;9;1;0;1
96;09.11.2013;2013;11;02;Lauantai;5;1;6;2;0;2
96;09.11.2013;2013;11;03;Lauantai;6;0;6;1;0;1
96;09.11.2013;2013;11;04;Lauantai;8;3;11;1;1;2
96;09.11.2013;2013;11;05;Lauantai;0;1;1;1;0;1
96;09.11.2013;2013;11;06;Lauantai;16;5;21;1;3;4
96;09.11.2013;2013;11;07;Lauantai;4;21;25;0;4;4
96;09.11.2013;2013;11;08;Lauantai;11;32;43;2;5;7
96;09.11.2013;2013;11;09;Lauantai;12;34;46;2;2;4
96;09.11.2013;2013;11;10;Lauantai;18;32;50;6;8;14
96;09.11.2013;2013;11;11;Lauantai;27;29;56;7;8;15
96;09.11.2013;2013;11;12;Lauantai;24;26;50;9;12;21
96;09.11.2013;2013;11;13;Lauantai;37;36;73;8;10;18
96;09.11.2013;2013;11;14;Lauantai;37;46;83;3;8;11
96;09.11.2013;2013;11;15;Lauantai;47;42;89;5;8;13
96;09.11.2013;2013;11;16;Lauantai;22;27;49;6;5;11
96;09.11.2013;2013;11;17;Lauantai;26;29;55;7;6;13
96;09.11.2013;2013;11;18;Lauantai;33;26;59;12;5;17
96;09.11.2013;2013;11;19;Lauantai;28;11;39;2;9;11
96;09.11.2013;2013;11;20;Lauantai;27;18;45;7;8;15
96;09.11.2013;2013;11;21;Lauantai;9;15;24;3;4;7
96;09.11.2013;2013;11;22;Lauantai;3;16;19;0;3;3
96;09.11.2013;2013;11;23;Lauantai;8;7;15;1;1;2
96;10.11.2013;2013;11;00;Sunnuntai;13;11;24;2;0;2
96;10.11.2013;2013;11;01;Sunnuntai;4;1;5;2;0;2
96;10.11.2013;2013;11;02;Sunnuntai;8;1;9;2;1;3
96;10.11.2013;2013;11;03;Sunnuntai;13;0;13;2;0;2
96;10.11.2013;2013;11;04;Sunnuntai;4;1;5;2;0;2
96;10.11.2013;2013;11;05;Sunnuntai;2;0;2;0;1;1
96;10.11.2013;2013;11;06;Sunnuntai;15;7;22;3;0;3
96;10.11.2013;2013;11;07;Sunnuntai;2;9;11;1;5;6
96;10.11.2013;2013;11;08;Sunnuntai;4;6;10;0;2;2
96;10.11.2013;2013;11;09;Sunnuntai;5;12;17;2;1;3
96;10.11.2013;2013;11;10;Sunnuntai;3;5;8;1;1;2
96;10.11.2013;2013;11;11;Sunnuntai;10;8;18;6;8;14
96;10.11.2013;2013;11;12;Sunnuntai;14;10;24;5;10;15
96;10.11.2013;2013;11;13;Sunnuntai;18;14;32;2;4;6
96;10.11.2013;2013;11;14;Sunnuntai;17;15;32;3;3;6
96;10.11.2013;2013;11;15;Sunnuntai;13;20;33;10;11;21
96;10.11.2013;2013;11;16;Sunnuntai;26;14;40;12;9;21
96;10.11.2013;2013;11;17;Sunnuntai;18;13;31;16;20;36
96;10.11.2013;2013;11;18;Sunnuntai;13;20;33;7;21;28
96;10.11.2013;2013;11;19;Sunnuntai;17;21;38;10;12;22
96;10.11.2013;2013;11;20;Sunnuntai;22;16;38;14;12;26
96;10.11.2013;2013;11;21;Sunnuntai;17;39;56;6;7;13
96;10.11.2013;2013;11;22;Sunnuntai;7;4;11;3;1;4
96;10.11.2013;2013;11;23;Sunnuntai;0;0;0;0;0;0
96;11.11.2013;2013;11;00;Maanantai;3;1;4;0;1;1
96;11.11.2013;2013;11;01;Maanantai;0;0;0;0;0;0
96;11.11.2013;2013;11;02;Maanantai;1;0;1;0;0;0
96;11.11.2013;2013;11;03;Maanantai;1;1;2;0;0;0
96;11.11.2013;2013;11;04;Maanantai;1;1;2;0;0;0
96;11.11.2013;2013;11;05;Maanantai;3;5;8;0;0;0
96;11.11.2013;2013;11;06;Maanantai;32;33;65;7;1;8
96;11.11.2013;2013;11;07;Maanantai;98;86;184;22;10;32
96;11.11.2013;2013;11;08;Maanantai;117;111;228;15;11;26
96;11.11.2013;2013;11;09;Maanantai;51;74;125;9;5;14
96;11.11.2013;2013;11;10;Maanantai;45;69;114;6;7;13
96;11.11.2013;2013;11;11;Maanantai;51;67;118;19;12;31
96;11.11.2013;2013;11;12;Maanantai;84;80;164;10;14;24
96;11.11.2013;2013;11;13;Maanantai;59;72;131;8;6;14
96;11.11.2013;2013;11;14;Maanantai;76;109;185;7;15;22
96;11.11.2013;2013;11;15;Maanantai;93;195;288;11;30;41
96;11.11.2013;2013;11;16;Maanantai;109;137;246;16;38;54
96;11.11.2013;2013;11;17;Maanantai;71;89;160;8;16;24
96;11.11.2013;2013;11;18;Maanantai;56;48;104;15;24;39
96;11.11.2013;2013;11;19;Maanantai;49;39;88;18;15;33
96;11.11.2013;2013;11;20;Maanantai;46;28;74;16;9;25
96;11.11.2013;2013;11;21;Maanantai;34;19;53;8;7;15
96;11.11.2013;2013;11;22;Maanantai;11;8;19;2;2;4
96;11.11.2013;2013;11;23;Maanantai;1;0;1;1;0;1
96;12.11.2013;2013;11;00;Tiistai;2;0;2;0;0;0
96;12.11.2013;2013;11;01;Tiistai;1;0;1;0;1;1
96;12.11.2013;2013;11;02;Tiistai;0;0;0;0;0;0
96;12.11.2013;2013;11;03;Tiistai;0;0;0;0;0;0
96;12.11.2013;2013;11;04;Tiistai;1;2;3;0;0;0
96;12.11.2013;2013;11;05;Tiistai;2;11;13;0;0;0
96;12.11.2013;2013;11;06;Tiistai;37;30;67;11;3;14
96;12.11.2013;2013;11;07;Tiistai;96;79;175;20;14;34
96;12.11.2013;2013;11;08;Tiistai;111;78;189;16;5;21
96;12.11.2013;2013;11;09;Tiistai;74;54;128;10;9;19
96;12.11.2013;2013;11;10;Tiistai;45;49;94;8;8;16
96;12.11.2013;2013;11;11;Tiistai;35;53;88;8;7;15
96;12.11.2013;2013;11;12;Tiistai;56;75;131;9;16;25
96;12.11.2013;2013;11;13;Tiistai;49;65;114;17;10;27
96;12.11.2013;2013;11;14;Tiistai;72;125;197;7;17;24
96;12.11.2013;2013;11;15;Tiistai;95;175;270;7;24;31
96;12.11.2013;2013;11;16;Tiistai;95;126;221;17;27;44
96;12.11.2013;2013;11;17;Tiistai;66;74;140;9;14;23
96;12.11.2013;2013;11;18;Tiistai;52;56;108;19;18;37
96;12.11.2013;2013;11;19;Tiistai;42;44;86;14;19;33
96;12.11.2013;2013;11;20;Tiistai;48;32;80;13;11;24
96;12.11.2013;2013;11;21;Tiistai;21;31;52;8;6;14
96;12.11.2013;2013;11;22;Tiistai;15;4;19;4;3;7
96;12.11.2013;2013;11;23;Tiistai;10;2;12;1;1;2
96;13.11.2013;2013;11;00;Keskiviikko;1;2;3;0;0;0
96;13.11.2013;2013;11;01;Keskiviikko;2;0;2;0;0;0
96;13.11.2013;2013;11;02;Keskiviikko;0;0;0;1;0;1
96;13.11.2013;2013;11;03;Keskiviikko;1;0;1;0;0;0
96;13.11.2013;2013;11;04;Keskiviikko;2;3;5;0;0;0
96;13.11.2013;2013;11;05;Keskiviikko;3;9;12;0;1;1
96;13.11.2013;2013;11;06;Keskiviikko;36;41;77;7;5;12
96;13.11.2013;2013;11;07;Keskiviikko;94;97;191;26;12;38
96;13.11.2013;2013;11;08;Keskiviikko;129;117;246;18;7;25
96;13.11.2013;2013;11;09;Keskiviikko;48;63;111;10;2;12
96;13.11.2013;2013;11;10;Keskiviikko;51;51;102;12;8;20
96;13.11.2013;2013;11;11;Keskiviikko;57;58;115;12;8;20
96;13.11.2013;2013;11;12;Keskiviikko;65;70;135;11;7;18
96;13.11.2013;2013;11;13;Keskiviikko;61;71;132;6;14;20
96;13.11.2013;2013;11;14;Keskiviikko;69;122;191;11;22;33
96;13.11.2013;2013;11;15;Keskiviikko;79;192;271;8;31;39
96;13.11.2013;2013;11;16;Keskiviikko;109;154;263;14;27;41
96;13.11.2013;2013;11;17;Keskiviikko;72;67;139;16;24;40
96;13.11.2013;2013;11;18;Keskiviikko;92;56;148;19;12;31
96;13.11.2013;2013;11;19;Keskiviikko;61;35;96;16;20;36
96;13.11.2013;2013;11;20;Keskiviikko;43;36;79;9;13;22
96;13.11.2013;2013;11;21;Keskiviikko;35;46;81;3;10;13
96;13.11.2013;2013;11;22;Keskiviikko;12;11;23;4;2;6
96;13.11.2013;2013;11;23;Keskiviikko;7;6;13;0;2;2
96;14.11.2013;2013;11;00;Torstai;1;0;1;0;0;0
96;14.11.2013;2013;11;01;Torstai;0;2;2;0;0;0
96;14.11.2013;2013;11;02;Torstai;2;0;2;1;0;1
96;14.11.2013;2013;11;03;Torstai;1;0;1;2;2;4
96;14.11.2013;2013;11;04;Torstai;2;1;3;1;0;1
96;14.11.2013;2013;11;05;Torstai;6;10;16;2;0;2
96;14.11.2013;2013;11;06;Torstai;49;31;80;11;4;15
96;14.11.2013;2013;11;07;Torstai;90;98;188;13;8;21
96;14.11.2013;2013;11;08;Torstai;135;105;240;15;8;23
96;14.11.2013;2013;11;09;Torstai;62;80;142;9;8;17
96;14.11.2013;2013;11;10;Torstai;57;47;104;5;6;11
96;14.11.2013;2013;11;11;Torstai;42;54;96;7;14;21
96;14.11.2013;2013;11;12;Torstai;53;76;129;7;8;15
96;14.11.2013;2013;11;13;Torstai;47;80;127;7;11;18
96;14.11.2013;2013;11;14;Torstai;62;92;154;12;18;30
96;14.11.2013;2013;11;15;Torstai;93;179;272;10;37;47
96;14.11.2013;2013;11;16;Torstai;85;137;222;14;24;38
96;14.11.2013;2013;11;17;Torstai;57;76;133;7;10;17
96;14.11.2013;2013;11;18;Torstai;56;48;104;15;12;27
96;14.11.2013;2013;11;19;Torstai;64;37;101;10;11;21
96;14.11.2013;2013;11;20;Torstai;51;23;74;10;7;17
96;14.11.2013;2013;11;21;Torstai;27;27;54;6;8;14
96;14.11.2013;2013;11;22;Torstai;7;13;20;1;2;3
96;14.11.2013;2013;11;23;Torstai;7;1;8;2;2;4
96;15.11.2013;2013;11;00;Perjantai;7;0;7;3;0;3
96;15.11.2013;2013;11;01;Perjantai;8;0;8;0;0;0
96;15.11.2013;2013;11;02;Perjantai;9;0;9;0;0;0
96;15.11.2013;2013;11;03;Perjantai;6;0;6;0;0;0
96;15.11.2013;2013;11;04;Perjantai;6;3;9;1;0;1
96;15.11.2013;2013;11;05;Perjantai;2;7;9;1;0;1
96;15.11.2013;2013;11;06;Perjantai;35;24;59;6;2;8
96;15.11.2013;2013;11;07;Perjantai;83;71;154;20;16;36
96;15.11.2013;2013;11;08;Perjantai;107;97;204;23;8;31
96;15.11.2013;2013;11;09;Perjantai;48;59;107;6;4;10
96;15.11.2013;2013;11;10;Perjantai;40;43;83;3;15;18
96;15.11.2013;2013;11;11;Perjantai;55;62;117;12;10;22
96;15.11.2013;2013;11;12;Perjantai;49;66;115;8;6;14
96;15.11.2013;2013;11;13;Perjantai;58;91;149;6;25;31
96;15.11.2013;2013;11;14;Perjantai;83;109;192;4;20;24
96;15.11.2013;2013;11;15;Perjantai;76;153;229;6;25;31
96;15.11.2013;2013;11;16;Perjantai;66;66;132;5;15;20
96;15.11.2013;2013;11;17;Perjantai;39;36;75;4;12;16
96;15.11.2013;2013;11;18;Perjantai;38;36;74;7;11;18
96;15.11.2013;2013;11;19;Perjantai;27;25;52;4;8;12
96;15.11.2013;2013;11;20;Perjantai;26;14;40;7;6;13
96;15.11.2013;2013;11;21;Perjantai;17;22;39;4;1;5
96;15.11.2013;2013;11;22;Perjantai;6;6;12;2;4;6
96;15.11.2013;2013;11;23;Perjantai;9;6;15;0;1;1
96;16.11.2013;2013;11;00;Lauantai;8;3;11;2;0;2
96;16.11.2013;2013;11;01;Lauantai;6;1;7;0;0;0
96;16.11.2013;2013;11;02;Lauantai;13;0;13;0;0;0
96;16.11.2013;2013;11;03;Lauantai;5;0;5;2;0;2
96;16.11.2013;2013;11;04;Lauantai;6;2;8;2;1;3
96;16.11.2013;2013;11;05;Lauantai;5;3;8;0;0;0
96;16.11.2013;2013;11;06;Lauantai;11;9;20;1;0;1
96;16.11.2013;2013;11;07;Lauantai;4;13;17;1;4;5
96;16.11.2013;2013;11;08;Lauantai;8;16;24;3;5;8
96;16.11.2013;2013;11;09;Lauantai;8;27;35;2;5;7
96;16.11.2013;2013;11;10;Lauantai;17;20;37;4;3;7
96;16.11.2013;2013;11;11;Lauantai;22;40;62;10;12;22
96;16.11.2013;2013;11;12;Lauantai;34;34;68;10;16;26
96;16.11.2013;2013;11;13;Lauantai;41;44;85;6;10;16
96;16.11.2013;2013;11;14;Lauantai;45;39;84;14;7;21
96;16.11.2013;2013;11;15;Lauantai;44;51;95;18;14;32
96;16.11.2013;2013;11;16;Lauantai;37;53;90;8;27;35
96;16.11.2013;2013;11;17;Lauantai;20;22;42;5;12;17
96;16.11.2013;2013;11;18;Lauantai;24;19;43;19;50;69
96;16.11.2013;2013;11;19;Lauantai;45;31;76;25;57;82
96;16.11.2013;2013;11;20;Lauantai;15;23;38;8;20;28
96;16.11.2013;2013;11;21;Lauantai;14;31;45;2;6;8
96;16.11.2013;2013;11;22;Lauantai;15;8;23;22;3;25
96;16.11.2013;2013;11;23;Lauantai;17;7;24;96;5;101
96;17.11.2013;2013;11;00;Sunnuntai;7;12;19;3;2;5
96;17.11.2013;2013;11;01;Sunnuntai;9;4;13;0;2;2
96;17.11.2013;2013;11;02;Sunnuntai;11;7;18;2;0;2
96;17.11.2013;2013;11;03;Sunnuntai;6;1;7;5;1;6
96;17.11.2013;2013;11;04;Sunnuntai;10;2;12;5;0;5
96;17.11.2013;2013;11;05;Sunnuntai;2;0;2;0;0;0
96;17.11.2013;2013;11;06;Sunnuntai;11;8;19;3;0;3
96;17.11.2013;2013;11;07;Sunnuntai;2;8;10;1;2;3
96;17.11.2013;2013;11;08;Sunnuntai;2;3;5;1;1;2
96;17.11.2013;2013;11;09;Sunnuntai;4;4;8;2;2;4
96;17.11.2013;2013;11;10;Sunnuntai;3;10;13;5;4;9
96;17.11.2013;2013;11;11;Sunnuntai;12;22;34;5;5;10
96;17.11.2013;2013;11;12;Sunnuntai;19;25;44;11;5;16
96;17.11.2013;2013;11;13;Sunnuntai;23;26;49;8;5;13
96;17.11.2013;2013;11;14;Sunnuntai;21;41;62;7;15;22
96;17.11.2013;2013;11;15;Sunnuntai;29;28;57;10;10;20
96;17.11.2013;2013;11;16;Sunnuntai;40;15;55;12;7;19
96;17.11.2013;2013;11;17;Sunnuntai;27;26;53;17;15;32
96;17.11.2013;2013;11;18;Sunnuntai;25;27;52;18;18;36
96;17.11.2013;2013;11;19;Sunnuntai;25;21;46;7;9;16
96;17.11.2013;2013;11;20;Sunnuntai;30;23;53;6;7;13
96;17.11.2013;2013;11;21;Sunnuntai;25;21;46;8;8;16
96;17.11.2013;2013;11;22;Sunnuntai;5;6;11;1;3;4
96;17.11.2013;2013;11;23;Sunnuntai;3;1;4;0;2;2
96;18.11.2013;2013;11;00;Maanantai;9;0;9;1;0;1
96;18.11.2013;2013;11;01;Maanantai;0;0;0;1;0;1
96;18.11.2013;2013;11;02;Maanantai;0;0;0;1;0;1
96;18.11.2013;2013;11;03;Maanantai;4;1;5;0;0;0
96;18.11.2013;2013;11;04;Maanantai;2;1;3;0;0;0
96;18.11.2013;2013;11;05;Maanantai;2;5;7;0;0;0
96;18.11.2013;2013;11;06;Maanantai;27;30;57;3;3;6
96;18.11.2013;2013;11;07;Maanantai;92;92;184;23;6;29
96;18.11.2013;2013;11;08;Maanantai;95;106;201;13;9;22
96;18.11.2013;2013;11;09;Maanantai;62;68;130;7;4;11
96;18.11.2013;2013;11;10;Maanantai;46;68;114;8;11;19
96;18.11.2013;2013;11;11;Maanantai;43;45;88;15;9;24
96;18.11.2013;2013;11;12;Maanantai;63;49;112;18;16;34
96;18.11.2013;2013;11;13;Maanantai;70;66;136;13;13;26
96;18.11.2013;2013;11;14;Maanantai;59;114;173;7;16;23
96;18.11.2013;2013;11;15;Maanantai;90;188;278;9;32;41
96;18.11.2013;2013;11;16;Maanantai;100;148;248;8;25;33
96;18.11.2013;2013;11;17;Maanantai;61;89;150;6;13;19
96;18.11.2013;2013;11;18;Maanantai;58;26;84;15;19;34
96;18.11.2013;2013;11;19;Maanantai;44;50;94;21;20;41
96;18.11.2013;2013;11;20;Maanantai;46;25;71;13;10;23
96;18.11.2013;2013;11;21;Maanantai;17;20;37;2;5;7
96;18.11.2013;2013;11;22;Maanantai;13;6;19;2;4;6
96;18.11.2013;2013;11;23;Maanantai;1;2;3;0;1;1
96;19.11.2013;2013;11;00;Tiistai;2;0;2;0;0;0
96;19.11.2013;2013;11;01;Tiistai;2;0;2;0;0;0
96;19.11.2013;2013;11;02;Tiistai;0;1;1;0;0;0
96;19.11.2013;2013;11;03;Tiistai;0;1;1;0;0;0
96;19.11.2013;2013;11;04;Tiistai;1;0;1;0;0;0
96;19.11.2013;2013;11;05;Tiistai;1;5;6;0;0;0
96;19.11.2013;2013;11;06;Tiistai;32;17;49;6;4;10
96;19.11.2013;2013;11;07;Tiistai;94;87;181;19;8;27
96;19.11.2013;2013;11;08;Tiistai;96;113;209;17;9;26
96;19.11.2013;2013;11;09;Tiistai;52;66;118;15;8;23
96;19.11.2013;2013;11;10;Tiistai;47;40;87;5;14;19
96;19.11.2013;2013;11;11;Tiistai;45;53;98;13;13;26
96;19.11.2013;2013;11;12;Tiistai;52;75;127;8;20;28
96;19.11.2013;2013;11;13;Tiistai;46;65;111;5;7;12
96;19.11.2013;2013;11;14;Tiistai;50;79;129;4;10;14
96;19.11.2013;2013;11;15;Tiistai;74;135;209;10;22;32
96;19.11.2013;2013;11;16;Tiistai;73;126;199;11;16;27
96;19.11.2013;2013;11;17;Tiistai;50;76;126;7;9;16
96;19.11.2013;2013;11;18;Tiistai;33;43;76;14;14;28
96;19.11.2013;2013;11;19;Tiistai;41;37;78;7;14;21
96;19.11.2013;2013;11;20;Tiistai;28;29;57;10;11;21
96;19.11.2013;2013;11;21;Tiistai;55;30;85;13;11;24
96;19.11.2013;2013;11;22;Tiistai;2;7;9;3;2;5
96;19.11.2013;2013;11;23;Tiistai;7;3;10;1;0;1
96;20.11.2013;2013;11;00;Keskiviikko;2;0;2;0;0;0
96;20.11.2013;2013;11;01;Keskiviikko;1;1;2;0;0;0
96;20.11.2013;2013;11;02;Keskiviikko;3;0;3;0;0;0
96;20.11.2013;2013;11;03;Keskiviikko;2;0;2;0;0;0
96;20.11.2013;2013;11;04;Keskiviikko;1;1;2;1;1;2
96;20.11.2013;2013;11;05;Keskiviikko;3;8;11;0;0;0
96;20.11.2013;2013;11;06;Keskiviikko;39;32;71;8;2;10
96;20.11.2013;2013;11;07;Keskiviikko;93;79;172;24;10;34
96;20.11.2013;2013;11;08;Keskiviikko;100;125;225;17;6;23
96;20.11.2013;2013;11;09;Keskiviikko;50;58;108;12;8;20
96;20.11.2013;2013;11;10;Keskiviikko;51;68;119;3;10;13
96;20.11.2013;2013;11;11;Keskiviikko;49;51;100;8;13;21
96;20.11.2013;2013;11;12;Keskiviikko;73;68;141;9;12;21
96;20.11.2013;2013;11;13;Keskiviikko;56;40;96;8;11;19
96;20.11.2013;2013;11;14;Keskiviikko;54;118;172;7;18;25
96;20.11.2013;2013;11;15;Keskiviikko;93;169;262;14;21;35
96;20.11.2013;2013;11;16;Keskiviikko;95;119;214;12;23;35
96;20.11.2013;2013;11;17;Keskiviikko;69;69;138;15;14;29
96;20.11.2013;2013;11;18;Keskiviikko;83;44;127;19;20;39
96;20.11.2013;2013;11;19;Keskiviikko;53;43;96;16;15;31
96;20.11.2013;2013;11;20;Keskiviikko;42;49;91;13;12;25
96;20.11.2013;2013;11;21;Keskiviikko;29;47;76;5;6;11
96;20.11.2013;2013;11;22;Keskiviikko;17;10;27;3;1;4
96;20.11.2013;2013;11;23;Keskiviikko;6;3;9;0;1;1
96;21.11.2013;2013;11;00;Torstai;4;2;6;4;1;5
96;21.11.2013;2013;11;01;Torstai;3;0;3;0;0;0
96;21.11.2013;2013;11;02;Torstai;4;0;4;0;0;0
96;21.11.2013;2013;11;03;Torstai;3;0;3;0;0;0
96;21.11.2013;2013;11;04;Torstai;4;1;5;0;0;0
96;21.11.2013;2013;11;05;Torstai;6;8;14;1;1;2
96;21.11.2013;2013;11;06;Torstai;40;27;67;9;3;12
96;21.11.2013;2013;11;07;Torstai;85;78;163;28;6;34
96;21.11.2013;2013;11;08;Torstai;118;84;202;16;12;28
96;21.11.2013;2013;11;09;Torstai;43;62;105;12;8;20
96;21.11.2013;2013;11;10;Torstai;35;52;87;7;10;17
96;21.11.2013;2013;11;11;Torstai;54;47;101;6;15;21
96;21.11.2013;2013;11;12;Torstai;55;55;110;8;14;22
96;21.11.2013;2013;11;13;Torstai;59;74;133;8;10;18
96;21.11.2013;2013;11;14;Torstai;68;95;163;12;22;34
96;21.11.2013;2013;11;15;Torstai;73;151;224;10;34;44
96;21.11.2013;2013;11;16;Torstai;77;108;185;8;31;39
96;21.11.2013;2013;11;17;Torstai;57;62;119;10;14;24
96;21.11.2013;2013;11;18;Torstai;44;35;79;14;22;36
96;21.11.2013;2013;11;19;Torstai;36;24;60;9;13;22
96;21.11.2013;2013;11;20;Torstai;39;25;64;7;11;18
96;21.11.2013;2013;11;21;Torstai;27;25;52;10;4;14
96;21.11.2013;2013;11;22;Torstai;7;16;23;2;3;5
96;21.11.2013;2013;11;23;Torstai;5;6;11;1;2;3
96;22.11.2013;2013;11;00;Perjantai;7;1;8;2;0;2
96;22.11.2013;2013;11;01;Perjantai;1;2;3;0;0;0
96;22.11.2013;2013;11;02;Perjantai;6;0;6;0;0;0
96;22.11.2013;2013;11;03;Perjantai;6;0;6;0;0;0
96;22.11.2013;2013;11;04;Perjantai;4;4;8;0;2;2
96;22.11.2013;2013;11;05;Perjantai;3;6;9;0;0;0
96;22.11.2013;2013;11;06;Perjantai;31;28;59;10;4;14
96;22.11.2013;2013;11;07;Perjantai;71;65;136;24;7;31
96;22.11.2013;2013;11;08;Perjantai;73;86;159;16;6;22
96;22.11.2013;2013;11;09;Perjantai;27;46;73;6;6;12
96;22.11.2013;2013;11;10;Perjantai;31;39;70;10;8;18
96;22.11.2013;2013;11;11;Perjantai;46;49;95;6;12;18
96;22.11.2013;2013;11;12;Perjantai;50;46;96;10;12;22
96;22.11.2013;2013;11;13;Perjantai;64;64;128;7;15;22
96;22.11.2013;2013;11;14;Perjantai;50;89;139;14;20;34
96;22.11.2013;2013;11;15;Perjantai;65;120;185;6;35;41
96;22.11.2013;2013;11;16;Perjantai;64;81;145;13;13;26
96;22.11.2013;2013;11;17;Perjantai;35;34;69;9;9;18
96;22.11.2013;2013;11;18;Perjantai;35;45;80;7;12;19
96;22.11.2013;2013;11;19;Perjantai;22;19;41;11;5;16
96;22.11.2013;2013;11;20;Perjantai;29;9;38;11;6;17
96;22.11.2013;2013;11;21;Perjantai;12;24;36;1;6;7
96;22.11.2013;2013;11;22;Perjantai;12;12;24;3;3;6
96;22.11.2013;2013;11;23;Perjantai;3;5;8;4;0;4
96;23.11.2013;2013;11;00;Lauantai;5;2;7;0;0;0
96;23.11.2013;2013;11;01;Lauantai;6;1;7;4;0;4
96;23.11.2013;2013;11;02;Lauantai;10;0;10;3;0;3
96;23.11.2013;2013;11;03;Lauantai;6;0;6;2;0;2
96;23.11.2013;2013;11;04;Lauantai;8;3;11;3;1;4
96;23.11.2013;2013;11;05;Lauantai;3;0;3;0;0;0
96;23.11.2013;2013;11;06;Lauantai;14;5;19;2;3;5
96;23.11.2013;2013;11;07;Lauantai;4;8;12;0;1;1
96;23.11.2013;2013;11;08;Lauantai;9;8;17;5;6;11
96;23.11.2013;2013;11;09;Lauantai;6;22;28;5;6;11
96;23.11.2013;2013;11;10;Lauantai;12;7;19;5;0;5
96;23.11.2013;2013;11;11;Lauantai;16;23;39;8;10;18
96;23.11.2013;2013;11;12;Lauantai;30;24;54;10;6;16
96;23.11.2013;2013;11;13;Lauantai;24;22;46;6;6;12
96;23.11.2013;2013;11;14;Lauantai;20;31;51;4;5;9
96;23.11.2013;2013;11;15;Lauantai;21;26;47;16;13;29
96;23.11.2013;2013;11;16;Lauantai;27;24;51;6;20;26
96;23.11.2013;2013;11;17;Lauantai;15;10;25;2;9;11
96;23.11.2013;2013;11;18;Lauantai;20;15;35;10;8;18
96;23.11.2013;2013;11;19;Lauantai;38;15;53;17;4;21
96;23.11.2013;2013;11;20;Lauantai;19;17;36;6;6;12
96;23.11.2013;2013;11;21;Lauantai;7;23;30;3;6;9
96;23.11.2013;2013;11;22;Lauantai;13;5;18;2;3;5
96;23.11.2013;2013;11;23;Lauantai;7;11;18;2;4;6
96;24.11.2013;2013;11;00;Sunnuntai;2;14;16;1;3;4
96;24.11.2013;2013;11;01;Sunnuntai;1;10;11;2;0;2
96;24.11.2013;2013;11;02;Sunnuntai;9;0;9;3;0;3
96;24.11.2013;2013;11;03;Sunnuntai;6;0;6;4;0;4
96;24.11.2013;2013;11;04;Sunnuntai;6;0;6;7;1;8
96;24.11.2013;2013;11;05;Sunnuntai;2;1;3;1;0;1
96;24.11.2013;2013;11;06;Sunnuntai;15;3;18;5;2;7
96;24.11.2013;2013;11;07;Sunnuntai;5;4;9;2;6;8
96;24.11.2013;2013;11;08;Sunnuntai;3;3;6;2;4;6
96;24.11.2013;2013;11;09;Sunnuntai;1;7;8;6;6;12
96;24.11.2013;2013;11;10;Sunnuntai;3;11;14;5;8;13
96;24.11.2013;2013;11;11;Sunnuntai;11;10;21;12;16;28
96;24.11.2013;2013;11;12;Sunnuntai;28;23;51;12;16;28
96;24.11.2013;2013;11;13;Sunnuntai;26;23;49;11;17;28
96;24.11.2013;2013;11;14;Sunnuntai;21;25;46;16;15;31
96;24.11.2013;2013;11;15;Sunnuntai;25;26;51;13;14;27
96;24.11.2013;2013;11;16;Sunnuntai;26;15;41;23;17;40
96;24.11.2013;2013;11;17;Sunnuntai;27;21;48;12;15;27
96;24.11.2013;2013;11;18;Sunnuntai;30;20;50;19;16;35
96;24.11.2013;2013;11;19;Sunnuntai;17;23;40;6;18;24
96;24.11.2013;2013;11;20;Sunnuntai;15;17;32;7;16;23
96;24.11.2013;2013;11;21;Sunnuntai;13;16;29;6;11;17
96;24.11.2013;2013;11;22;Sunnuntai;2;3;5;1;0;1
96;24.11.2013;2013;11;23;Sunnuntai;4;6;10;1;0;1
96;25.11.2013;2013;11;00;Maanantai;3;0;3;1;0;1
96;25.11.2013;2013;11;01;Maanantai;0;1;1;1;3;4
96;25.11.2013;2013;11;02;Maanantai;0;0;0;0;0;0
96;25.11.2013;2013;11;03;Maanantai;0;0;0;0;0;0
96;25.11.2013;2013;11;04;Maanantai;3;2;5;1;0;1
96;25.11.2013;2013;11;05;Maanantai;1;8;9;0;2;2
96;25.11.2013;2013;11;06;Maanantai;25;20;45;4;3;7
96;25.11.2013;2013;11;07;Maanantai;80;72;152;18;5;23
96;25.11.2013;2013;11;08;Maanantai;85;76;161;16;6;22
96;25.11.2013;2013;11;09;Maanantai;46;51;97;5;7;12
96;25.11.2013;2013;11;10;Maanantai;52;51;103;4;11;15
96;25.11.2013;2013;11;11;Maanantai;34;51;85;10;9;19
96;25.11.2013;2013;11;12;Maanantai;55;52;107;11;10;21
96;25.11.2013;2013;11;13;Maanantai;63;54;117;7;10;17
96;25.11.2013;2013;11;14;Maanantai;54;83;137;10;14;24
96;25.11.2013;2013;11;15;Maanantai;79;149;228;10;30;40
96;25.11.2013;2013;11;16;Maanantai;68;121;189;13;28;41
96;25.11.2013;2013;11;17;Maanantai;57;70;127;13;13;26
96;25.11.2013;2013;11;18;Maanantai;40;31;71;22;12;34
96;25.11.2013;2013;11;19;Maanantai;43;33;76;12;13;25
96;25.11.2013;2013;11;20;Maanantai;37;30;67;10;7;17
96;25.11.2013;2013;11;21;Maanantai;23;22;45;5;4;9
96;25.11.2013;2013;11;22;Maanantai;11;10;21;1;1;2
96;25.11.2013;2013;11;23;Maanantai;3;0;3;2;1;3
96;26.11.2013;2013;11;00;Tiistai;6;7;13;0;0;0
96;26.11.2013;2013;11;01;Tiistai;4;0;4;1;0;1
96;26.11.2013;2013;11;02;Tiistai;2;0;2;0;0;0
96;26.11.2013;2013;11;03;Tiistai;0;0;0;0;0;0
96;26.11.2013;2013;11;04;Tiistai;1;2;3;0;1;1
96;26.11.2013;2013;11;05;Tiistai;3;12;15;2;0;2
96;26.11.2013;2013;11;06;Tiistai;28;27;55;14;2;16
96;26.11.2013;2013;11;07;Tiistai;92;79;171;24;11;35
96;26.11.2013;2013;11;08;Tiistai;107;95;202;20;13;33
96;26.11.2013;2013;11;09;Tiistai;38;50;88;10;10;20
96;26.11.2013;2013;11;10;Tiistai;41;63;104;3;12;15
96;26.11.2013;2013;11;11;Tiistai;39;51;90;6;11;17
96;26.11.2013;2013;11;12;Tiistai;50;73;123;5;15;20
96;26.11.2013;2013;11;13;Tiistai;41;64;105;2;10;12
96;26.11.2013;2013;11;14;Tiistai;57;77;134;6;17;23
96;26.11.2013;2013;11;15;Tiistai;79;161;240;4;25;29
96;26.11.2013;2013;11;16;Tiistai;92;150;242;5;26;31
96;26.11.2013;2013;11;17;Tiistai;57;60;117;5;15;20
96;26.11.2013;2013;11;18;Tiistai;42;39;81;12;14;26
96;26.11.2013;2013;11;19;Tiistai;35;28;63;7;7;14
96;26.11.2013;2013;11;20;Tiistai;33;20;53;4;2;6
96;26.11.2013;2013;11;21;Tiistai;22;17;39;1;4;5
96;26.11.2013;2013;11;22;Tiistai;7;3;10;0;2;2
96;26.11.2013;2013;11;23;Tiistai;9;3;12;0;1;1
96;27.11.2013;2013;11;00;Keskiviikko;2;0;2;0;0;0
96;27.11.2013;2013;11;01;Keskiviikko;0;0;0;0;0;0
96;27.11.2013;2013;11;02;Keskiviikko;1;0;1;0;0;0
96;27.11.2013;2013;11;03;Keskiviikko;0;0;0;0;0;0
96;27.11.2013;2013;11;04;Keskiviikko;2;0;2;0;0;0
96;27.11.2013;2013;11;05;Keskiviikko;4;7;11;0;3;3
96;27.11.2013;2013;11;06;Keskiviikko;33;29;62;7;3;10
96;27.11.2013;2013;11;07;Keskiviikko;75;64;139;12;11;23
96;27.11.2013;2013;11;08;Keskiviikko;106;87;193;13;19;32
96;27.11.2013;2013;11;09;Keskiviikko;39;57;96;5;11;16
96;27.11.2013;2013;11;10;Keskiviikko;43;48;91;11;18;29
96;27.11.2013;2013;11;11;Keskiviikko;42;28;70;3;2;5
96;27.11.2013;2013;11;12;Keskiviikko;42;35;77;8;15;23
96;27.11.2013;2013;11;13;Keskiviikko;35;51;86;2;15;17
96;27.11.2013;2013;11;14;Keskiviikko;63;93;156;7;15;22
96;27.11.2013;2013;11;15;Keskiviikko;59;106;165;8;27;35
96;27.11.2013;2013;11;16;Keskiviikko;75;80;155;7;13;20
96;27.11.2013;2013;11;17;Keskiviikko;41;29;70;5;5;10
96;27.11.2013;2013;11;18;Keskiviikko;39;22;61;10;5;15
96;27.11.2013;2013;11;19;Keskiviikko;33;20;53;3;4;7
96;27.11.2013;2013;11;20;Keskiviikko;13;18;31;7;12;19
96;27.11.2013;2013;11;21;Keskiviikko;16;17;33;3;8;11
96;27.11.2013;2013;11;22;Keskiviikko;3;4;7;3;1;4
96;27.11.2013;2013;11;23;Keskiviikko;1;1;2;2;0;2
96;28.11.2013;2013;11;00;Torstai;1;0;1;2;0;2
96;28.11.2013;2013;11;01;Torstai;1;0;1;1;0;1
96;28.11.2013;2013;11;02;Torstai;1;1;2;0;0;0
96;28.11.2013;2013;11;03;Torstai;0;0;0;0;0;0
96;28.11.2013;2013;11;04;Torstai;2;1;3;1;0;1
96;28.11.2013;2013;11;05;Torstai;3;8;11;1;2;3
96;28.11.2013;2013;11;06;Torstai;22;9;31;8;1;9
96;28.11.2013;2013;11;07;Torstai;47;31;78;31;12;43
96;28.11.2013;2013;11;08;Torstai;88;57;145;22;9;31
96;28.11.2013;2013;11;09;Torstai;44;27;71;7;7;14
96;28.11.2013;2013;11;10;Torstai;24;21;45;18;12;30
96;28.11.2013;2013;11;11;Torstai;33;19;52;8;13;21
96;28.11.2013;2013;11;12;Torstai;41;30;71;18;21;39
96;28.11.2013;2013;11;13;Torstai;32;50;82;13;17;30
96;28.11.2013;2013;11;14;Torstai;39;54;93;13;19;32
96;28.11.2013;2013;11;15;Torstai;43;88;131;11;27;38
96;28.11.2013;2013;11;16;Torstai;50;85;135;7;38;45
96;28.11.2013;2013;11;17;Torstai;32;29;61;8;15;23
96;28.11.2013;2013;11;18;Torstai;21;21;42;11;9;20
96;28.11.2013;2013;11;19;Torstai;37;14;51;8;13;21
96;28.11.2013;2013;11;20;Torstai;22;24;46;10;10;20
96;28.11.2013;2013;11;21;Torstai;19;17;36;6;6;12
96;28.11.2013;2013;11;22;Torstai;5;10;15;1;1;2
96;28.11.2013;2013;11;23;Torstai;7;3;10;1;1;2
96;29.11.2013;2013;11;00;Perjantai;2;1;3;0;0;0
96;29.11.2013;2013;11;01;Perjantai;1;1;2;1;0;1
96;29.11.2013;2013;11;02;Perjantai;3;1;4;2;1;3
96;29.11.2013;2013;11;03;Perjantai;2;0;2;0;0;0
96;29.11.2013;2013;11;04;Perjantai;1;0;1;3;0;3
96;29.11.2013;2013;11;05;Perjantai;4;6;10;2;0;2
96;29.11.2013;2013;11;06;Perjantai;24;16;40;10;2;12
96;29.11.2013;2013;11;07;Perjantai;64;35;99;22;7;29
96;29.11.2013;2013;11;08;Perjantai;88;67;155;18;9;27
96;29.11.2013;2013;11;09;Perjantai;39;33;72;12;11;23
96;29.11.2013;2013;11;10;Perjantai;29;38;67;4;9;13
96;29.11.2013;2013;11;11;Perjantai;31;51;82;12;9;21
96;29.11.2013;2013;11;12;Perjantai;37;40;77;20;17;37
96;29.11.2013;2013;11;13;Perjantai;45;46;91;12;14;26
96;29.11.2013;2013;11;14;Perjantai;27;81;108;8;20;28
96;29.11.2013;2013;11;15;Perjantai;45;93;138;12;29;41
96;29.11.2013;2013;11;16;Perjantai;47;52;99;7;18;25
96;29.11.2013;2013;11;17;Perjantai;28;33;61;11;10;21
96;29.11.2013;2013;11;18;Perjantai;18;15;33;9;8;17
96;29.11.2013;2013;11;19;Perjantai;22;11;33;7;9;16
96;29.11.2013;2013;11;20;Perjantai;16;16;32;11;8;19
96;29.11.2013;2013;11;21;Perjantai;18;12;30;6;4;10
96;29.11.2013;2013;11;22;Perjantai;8;5;13;3;4;7
96;29.11.2013;2013;11;23;Perjantai;7;4;11;1;2;3
96;30.11.2013;2013;11;00;Lauantai;9;7;16;1;1;2
96;30.11.2013;2013;11;01;Lauantai;4;0;4;1;0;1
96;30.11.2013;2013;11;02;Lauantai;6;0;6;2;0;2
96;30.11.2013;2013;11;03;Lauantai;4;2;6;1;0;1
96;30.11.2013;2013;11;04;Lauantai;3;1;4;2;1;3
96;30.11.2013;2013;11;05;Lauantai;1;0;1;0;0;0
96;30.11.2013;2013;11;06;Lauantai;14;4;18;2;1;3
96;30.11.2013;2013;11;07;Lauantai;8;12;20;1;8;9
96;30.11.2013;2013;11;08;Lauantai;7;7;14;1;3;4
96;30.11.2013;2013;11;09;Lauantai;4;18;22;0;1;1
96;30.11.2013;2013;11;10;Lauantai;10;6;16;6;1;7
96;30.11.2013;2013;11;11;Lauantai;12;20;32;1;2;3
96;30.11.2013;2013;11;12;Lauantai;13;16;29;5;3;8
96;30.11.2013;2013;11;13;Lauantai;19;21;40;3;2;5
96;30.11.2013;2013;11;14;Lauantai;16;14;30;5;6;11
96;30.11.2013;2013;11;15;Lauantai;27;27;54;2;6;8
96;30.11.2013;2013;11;16;Lauantai;20;25;45;1;12;13
96;30.11.2013;2013;11;17;Lauantai;25;11;36;8;9;17
96;30.11.2013;2013;11;18;Lauantai;26;15;41;9;20;29
96;30.11.2013;2013;11;19;Lauantai;27;14;41;9;16;25
96;30.11.2013;2013;11;20;Lauantai;10;10;20;5;6;11
96;30.11.2013;2013;11;21;Lauantai;9;14;23;1;7;8
96;30.11.2013;2013;11;22;Lauantai;8;11;19;1;2;3
96;30.11.2013;2013;11;23;Lauantai;7;2;9;3;1;4
96;01.12.2013;2013;12;00;Sunnuntai;2;1;3;1;3;4
96;01.12.2013;2013;12;01;Sunnuntai;7;2;9;8;7;15
96;01.12.2013;2013;12;02;Sunnuntai;7;2;9;4;0;4
96;01.12.2013;2013;12;03;Sunnuntai;8;1;9;0;0;0
96;01.12.2013;2013;12;04;Sunnuntai;5;0;5;3;0;3
96;01.12.2013;2013;12;05;Sunnuntai;2;0;2;0;0;0
96;01.12.2013;2013;12;06;Sunnuntai;11;7;18;0;0;0
96;01.12.2013;2013;12;07;Sunnuntai;2;4;6;1;4;5
96;01.12.2013;2013;12;08;Sunnuntai;2;5;7;1;0;1
96;01.12.2013;2013;12;09;Sunnuntai;5;5;10;0;1;1
96;01.12.2013;2013;12;10;Sunnuntai;4;5;9;3;4;7
96;01.12.2013;2013;12;11;Sunnuntai;6;8;14;0;0;0
96;01.12.2013;2013;12;12;Sunnuntai;11;14;25;1;0;1
96;01.12.2013;2013;12;13;Sunnuntai;19;19;38;0;2;2
96;01.12.2013;2013;12;14;Sunnuntai;19;20;39;1;1;2
96;01.12.2013;2013;12;15;Sunnuntai;19;18;37;3;2;5
96;01.12.2013;2013;12;16;Sunnuntai;30;16;46;1;2;3
96;01.12.2013;2013;12;17;Sunnuntai;25;10;35;1;2;3
96;01.12.2013;2013;12;18;Sunnuntai;25;19;44;3;9;12
96;01.12.2013;2013;12;19;Sunnuntai;13;19;32;6;7;13
96;01.12.2013;2013;12;20;Sunnuntai;21;23;44;4;3;7
96;01.12.2013;2013;12;21;Sunnuntai;16;4;20;1;6;7
96;01.12.2013;2013;12;22;Sunnuntai;5;7;12;1;1;2
96;01.12.2013;2013;12;23;Sunnuntai;6;0;6;1;0;1
96;02.12.2013;2013;12;00;Maanantai;1;1;2;0;0;0
96;02.12.2013;2013;12;01;Maanantai;1;0;1;0;0;0
96;02.12.2013;2013;12;02;Maanantai;1;2;3;0;0;0
96;02.12.2013;2013;12;03;Maanantai;1;0;1;0;0;0
96;02.12.2013;2013;12;04;Maanantai;3;1;4;0;0;0
96;02.12.2013;2013;12;05;Maanantai;4;13;17;0;0;0
96;02.12.2013;2013;12;06;Maanantai;29;22;51;1;2;3
96;02.12.2013;2013;12;07;Maanantai;70;61;131;3;14;17
96;02.12.2013;2013;12;08;Maanantai;75;85;160;4;5;9
96;02.12.2013;2013;12;09;Maanantai;43;58;101;4;6;10
96;02.12.2013;2013;12;10;Maanantai;29;36;65;5;8;13
96;02.12.2013;2013;12;11;Maanantai;52;32;84;7;12;19
96;02.12.2013;2013;12;12;Maanantai;57;46;103;11;14;25
96;02.12.2013;2013;12;13;Maanantai;43;55;98;1;10;11
96;02.12.2013;2013;12;14;Maanantai;42;82;124;2;21;23
96;02.12.2013;2013;12;15;Maanantai;49;141;190;1;37;38
96;02.12.2013;2013;12;16;Maanantai;67;129;196;3;31;34
96;02.12.2013;2013;12;17;Maanantai;31;64;95;3;11;14
96;02.12.2013;2013;12;18;Maanantai;35;45;80;1;10;11
96;02.12.2013;2013;12;19;Maanantai;22;24;46;0;6;6
96;02.12.2013;2013;12;20;Maanantai;23;28;51;1;6;7
96;02.12.2013;2013;12;21;Maanantai;20;25;45;0;3;3
96;02.12.2013;2013;12;22;Maanantai;15;9;24;0;0;0
96;02.12.2013;2013;12;23;Maanantai;3;0;3;0;2;2
96;03.12.2013;2013;12;00;Tiistai;1;0;1;0;0;0
96;03.12.2013;2013;12;01;Tiistai;1;0;1;0;0;0
96;03.12.2013;2013;12;02;Tiistai;1;0;1;0;0;0
96;03.12.2013;2013;12;03;Tiistai;1;0;1;0;1;1
96;03.12.2013;2013;12;04;Tiistai;3;1;4;0;0;0
96;03.12.2013;2013;12;05;Tiistai;5;6;11;0;0;0
96;03.12.2013;2013;12;06;Tiistai;32;28;60;2;1;3
96;03.12.2013;2013;12;07;Tiistai;73;72;145;1;3;4
96;03.12.2013;2013;12;08;Tiistai;91;91;182;2;3;5
96;03.12.2013;2013;12;09;Tiistai;57;55;112;3;3;6
96;03.12.2013;2013;12;10;Tiistai;43;54;97;4;10;14
96;03.12.2013;2013;12;11;Tiistai;35;32;67;6;8;14
96;03.12.2013;2013;12;12;Tiistai;38;49;87;8;17;25
96;03.12.2013;2013;12;13;Tiistai;33;45;78;9;14;23
96;03.12.2013;2013;12;14;Tiistai;40;82;122;8;16;24
96;03.12.2013;2013;12;15;Tiistai;59;139;198;6;29;35
96;03.12.2013;2013;12;16;Tiistai;81;88;169;14;36;50
96;03.12.2013;2013;12;17;Tiistai;40;57;97;9;11;20
96;03.12.2013;2013;12;18;Tiistai;45;25;70;18;17;35
96;03.12.2013;2013;12;19;Tiistai;37;38;75;9;11;20
96;03.12.2013;2013;12;20;Tiistai;29;28;57;9;6;15
96;03.12.2013;2013;12;21;Tiistai;24;18;42;6;8;14
96;03.12.2013;2013;12;22;Tiistai;13;2;15;0;2;2
96;03.12.2013;2013;12;23;Tiistai;2;2;4;1;1;2
96;04.12.2013;2013;12;00;Keskiviikko;3;1;4;0;0;0
96;04.12.2013;2013;12;01;Keskiviikko;0;0;0;0;0;0
96;04.12.2013;2013;12;02;Keskiviikko;2;0;2;0;0;0
96;04.12.2013;2013;12;03;Keskiviikko;0;0;0;0;1;1
96;04.12.2013;2013;12;04;Keskiviikko;3;0;3;1;0;1
96;04.12.2013;2013;12;05;Keskiviikko;1;8;9;0;0;0
96;04.12.2013;2013;12;06;Keskiviikko;32;18;50;10;3;13
96;04.12.2013;2013;12;07;Keskiviikko;76;50;126;24;15;39
96;04.12.2013;2013;12;08;Keskiviikko;87;73;160;26;10;36
96;04.12.2013;2013;12;09;Keskiviikko;35;33;68;17;10;27
96;04.12.2013;2013;12;10;Keskiviikko;39;36;75;13;9;22
96;04.12.2013;2013;12;11;Keskiviikko;30;36;66;10;17;27
96;04.12.2013;2013;12;12;Keskiviikko;44;43;87;12;26;38
96;04.12.2013;2013;12;13;Keskiviikko;42;69;111;13;7;20
96;04.12.2013;2013;12;14;Keskiviikko;28;74;102;10;24;34
96;04.12.2013;2013;12;15;Keskiviikko;53;123;176;13;41;54
96;04.12.2013;2013;12;16;Keskiviikko;63;105;168;16;40;56
96;04.12.2013;2013;12;17;Keskiviikko;48;42;90;10;16;26
96;04.12.2013;2013;12;18;Keskiviikko;60;31;91;16;9;25
96;04.12.2013;2013;12;19;Keskiviikko;50;26;76;15;17;32
96;04.12.2013;2013;12;20;Keskiviikko;35;30;65;15;14;29
96;04.12.2013;2013;12;21;Keskiviikko;26;31;57;4;6;10
96;04.12.2013;2013;12;22;Keskiviikko;16;14;30;2;4;6
96;04.12.2013;2013;12;23;Keskiviikko;3;2;5;0;1;1
96;05.12.2013;2013;12;00;Torstai;5;6;11;1;0;1
96;05.12.2013;2013;12;01;Torstai;2;0;2;0;0;0
96;05.12.2013;2013;12;02;Torstai;7;1;8;0;0;0
96;05.12.2013;2013;12;03;Torstai;3;0;3;1;1;2
96;05.12.2013;2013;12;04;Torstai;6;2;8;0;0;0
96;05.12.2013;2013;12;05;Torstai;4;9;13;1;0;1
96;05.12.2013;2013;12;06;Torstai;33;17;50;6;3;9
96;05.12.2013;2013;12;07;Torstai;59;65;124;24;13;37
96;05.12.2013;2013;12;08;Torstai;90;66;156;13;12;25
96;05.12.2013;2013;12;09;Torstai;29;44;73;7;10;17
96;05.12.2013;2013;12;10;Torstai;31;45;76;14;12;26
96;05.12.2013;2013;12;11;Torstai;27;46;73;4;13;17
96;05.12.2013;2013;12;12;Torstai;49;66;115;6;14;20
96;05.12.2013;2013;12;13;Torstai;34;62;96;5;17;22
96;05.12.2013;2013;12;14;Torstai;52;81;133;9;22;31
96;05.12.2013;2013;12;15;Torstai;63;111;174;2;37;39
96;05.12.2013;2013;12;16;Torstai;60;61;121;9;14;23
96;05.12.2013;2013;12;17;Torstai;33;30;63;7;12;19
96;05.12.2013;2013;12;18;Torstai;34;21;55;15;11;26
96;05.12.2013;2013;12;19;Torstai;27;34;61;8;16;24
96;05.12.2013;2013;12;20;Torstai;25;22;47;7;6;13
96;05.12.2013;2013;12;21;Torstai;11;21;32;2;4;6
96;05.12.2013;2013;12;22;Torstai;10;5;15;3;0;3
96;05.12.2013;2013;12;23;Torstai;6;4;10;1;2;3
96;06.12.2013;2013;12;00;Perjantai;4;8;12;1;2;3
96;06.12.2013;2013;12;01;Perjantai;3;4;7;2;0;2
96;06.12.2013;2013;12;02;Perjantai;8;0;8;2;0;2
96;06.12.2013;2013;12;03;Perjantai;5;2;7;2;0;2
96;06.12.2013;2013;12;04;Perjantai;8;2;10;3;0;3
96;06.12.2013;2013;12;05;Perjantai;2;0;2;0;1;1
96;06.12.2013;2013;12;06;Perjantai;13;4;17;6;2;8
96;06.12.2013;2013;12;07;Perjantai;2;10;12;1;4;5
96;06.12.2013;2013;12;08;Perjantai;1;5;6;1;1;2
96;06.12.2013;2013;12;09;Perjantai;4;9;13;5;8;13
96;06.12.2013;2013;12;10;Perjantai;4;5;9;6;5;11
96;06.12.2013;2013;12;11;Perjantai;7;15;22;2;6;8
96;06.12.2013;2013;12;12;Perjantai;16;13;29;12;11;23
96;06.12.2013;2013;12;13;Perjantai;18;12;30;6;12;18
96;06.12.2013;2013;12;14;Perjantai;11;11;22;10;11;21
96;06.12.2013;2013;12;15;Perjantai;12;19;31;8;11;19
96;06.12.2013;2013;12;16;Perjantai;7;17;24;5;12;17
96;06.12.2013;2013;12;17;Perjantai;10;18;28;1;8;9
96;06.12.2013;2013;12;18;Perjantai;7;7;14;3;7;10
96;06.12.2013;2013;12;19;Perjantai;9;3;12;2;3;5
96;06.12.2013;2013;12;20;Perjantai;9;10;19;4;2;6
96;06.12.2013;2013;12;21;Perjantai;7;11;18;4;6;10
96;06.12.2013;2013;12;22;Perjantai;5;10;15;1;3;4
96;06.12.2013;2013;12;23;Perjantai;4;10;14;2;0;2
96;07.12.2013;2013;12;00;Lauantai;5;4;9;0;2;2
96;07.12.2013;2013;12;01;Lauantai;3;1;4;2;1;3
96;07.12.2013;2013;12;02;Lauantai;0;2;2;2;0;2
96;07.12.2013;2013;12;03;Lauantai;2;0;2;2;1;3
96;07.12.2013;2013;12;04;Lauantai;4;2;6;2;0;2
96;07.12.2013;2013;12;05;Lauantai;0;0;0;1;0;1
96;07.12.2013;2013;12;06;Lauantai;5;5;10;1;0;1
96;07.12.2013;2013;12;07;Lauantai;4;14;18;3;4;7
96;07.12.2013;2013;12;08;Lauantai;2;11;13;1;8;9
96;07.12.2013;2013;12;09;Lauantai;6;16;22;3;6;9
96;07.12.2013;2013;12;10;Lauantai;16;29;45;11;13;24
96;07.12.2013;2013;12;11;Lauantai;15;19;34;6;8;14
96;07.12.2013;2013;12;12;Lauantai;27;30;57;9;9;18
96;07.12.2013;2013;12;13;Lauantai;14;25;39;5;8;13
96;07.12.2013;2013;12;14;Lauantai;26;22;48;6;9;15
96;07.12.2013;2013;12;15;Lauantai;20;34;54;4;18;22
96;07.12.2013;2013;12;16;Lauantai;18;13;31;7;7;14
96;07.12.2013;2013;12;17;Lauantai;19;12;31;8;4;12
96;07.12.2013;2013;12;18;Lauantai;29;8;37;11;3;14
96;07.12.2013;2013;12;19;Lauantai;18;15;33;6;9;15
96;07.12.2013;2013;12;20;Lauantai;11;11;22;4;2;6
96;07.12.2013;2013;12;21;Lauantai;4;15;19;3;4;7
96;07.12.2013;2013;12;22;Lauantai;5;10;15;4;2;6
96;07.12.2013;2013;12;23;Lauantai;6;0;6;2;2;4
96;08.12.2013;2013;12;00;Sunnuntai;3;5;8;0;0;0
96;08.12.2013;2013;12;01;Sunnuntai;3;1;4;0;0;0
96;08.12.2013;2013;12;02;Sunnuntai;9;1;10;0;0;0
96;08.12.2013;2013;12;03;Sunnuntai;4;1;5;2;0;2
96;08.12.2013;2013;12;04;Sunnuntai;3;1;4;0;0;0
96;08.12.2013;2013;12;05;Sunnuntai;1;0;1;1;0;1
96;08.12.2013;2013;12;06;Sunnuntai;6;10;16;4;0;4
96;08.12.2013;2013;12;07;Sunnuntai;3;7;10;1;5;6
96;08.12.2013;2013;12;08;Sunnuntai;0;3;3;0;1;1
96;08.12.2013;2013;12;09;Sunnuntai;1;6;7;2;4;6
96;08.12.2013;2013;12;10;Sunnuntai;8;8;16;5;3;8
96;08.12.2013;2013;12;11;Sunnuntai;8;7;15;4;3;7
96;08.12.2013;2013;12;12;Sunnuntai;10;23;33;5;18;23
96;08.12.2013;2013;12;13;Sunnuntai;17;13;30;11;9;20
96;08.12.2013;2013;12;14;Sunnuntai;12;16;28;6;9;15
96;08.12.2013;2013;12;15;Sunnuntai;17;17;34;7;14;21
96;08.12.2013;2013;12;16;Sunnuntai;20;11;31;15;8;23
96;08.12.2013;2013;12;17;Sunnuntai;18;8;26;8;5;13
96;08.12.2013;2013;12;18;Sunnuntai;21;13;34;12;15;27
96;08.12.2013;2013;12;19;Sunnuntai;8;6;14;9;17;26
96;08.12.2013;2013;12;20;Sunnuntai;12;11;23;6;11;17
96;08.12.2013;2013;12;21;Sunnuntai;7;14;21;7;5;12
96;08.12.2013;2013;12;22;Sunnuntai;4;4;8;1;6;7
96;08.12.2013;2013;12;23;Sunnuntai;2;0;2;2;3;5
96;09.12.2013;2013;12;00;Maanantai;1;0;1;0;0;0
96;09.12.2013;2013;12;01;Maanantai;0;0;0;0;2;2
96;09.12.2013;2013;12;02;Maanantai;0;0;0;1;0;1
96;09.12.2013;2013;12;03;Maanantai;1;0;1;0;0;0
96;09.12.2013;2013;12;04;Maanantai;1;1;2;0;0;0
96;09.12.2013;2013;12;05;Maanantai;3;8;11;0;0;0
96;09.12.2013;2013;12;06;Maanantai;26;20;46;12;2;14
96;09.12.2013;2013;12;07;Maanantai;82;57;139;33;8;41
96;09.12.2013;2013;12;08;Maanantai;79;56;135;20;12;32
96;09.12.2013;2013;12;09;Maanantai;35;48;83;5;15;20
96;09.12.2013;2013;12;10;Maanantai;29;47;76;12;9;21
96;09.12.2013;2013;12;11;Maanantai;32;41;73;11;12;23
96;09.12.2013;2013;12;12;Maanantai;35;38;73;7;16;23
96;09.12.2013;2013;12;13;Maanantai;37;46;83;14;14;28
96;09.12.2013;2013;12;14;Maanantai;44;65;109;9;22;31
96;09.12.2013;2013;12;15;Maanantai;59;118;177;11;37;48
96;09.12.2013;2013;12;16;Maanantai;65;95;160;14;29;43
96;09.12.2013;2013;12;17;Maanantai;38;39;77;13;26;39
96;09.12.2013;2013;12;18;Maanantai;32;17;49;6;5;11
96;09.12.2013;2013;12;19;Maanantai;22;27;49;7;15;22
96;09.12.2013;2013;12;20;Maanantai;30;13;43;11;4;15
96;09.12.2013;2013;12;21;Maanantai;18;17;35;3;8;11
96;09.12.2013;2013;12;22;Maanantai;7;5;12;2;1;3
96;09.12.2013;2013;12;23;Maanantai;2;1;3;0;0;0
96;10.12.2013;2013;12;00;Tiistai;3;0;3;0;0;0
96;10.12.2013;2013;12;01;Tiistai;0;0;0;1;0;1
96;10.12.2013;2013;12;02;Tiistai;0;0;0;0;0;0
96;10.12.2013;2013;12;03;Tiistai;0;0;0;0;0;0
96;10.12.2013;2013;12;04;Tiistai;1;0;1;0;0;0
96;10.12.2013;2013;12;05;Tiistai;2;8;10;0;0;0
96;10.12.2013;2013;12;06;Tiistai;28;25;53;10;2;12
96;10.12.2013;2013;12;07;Tiistai;72;73;145;22;14;36
96;10.12.2013;2013;12;08;Tiistai;88;60;148;21;9;30
96;10.12.2013;2013;12;09;Tiistai;48;43;91;12;16;28
96;10.12.2013;2013;12;10;Tiistai;28;38;66;4;5;9
96;10.12.2013;2013;12;11;Tiistai;23;35;58;10;14;24
96;10.12.2013;2013;12;12;Tiistai;30;47;77;10;13;23
96;10.12.2013;2013;12;13;Tiistai;27;34;61;6;9;15
96;10.12.2013;2013;12;14;Tiistai;40;60;100;5;19;24
96;10.12.2013;2013;12;15;Tiistai;67;102;169;18;7;25
96;10.12.2013;2013;12;16;Tiistai;147;33;180;43;7;50
96;10.12.2013;2013;12;17;Tiistai;67;3;70;20;0;20
96;10.12.2013;2013;12;18;Tiistai;59;7;66;21;0;21
96;10.12.2013;2013;12;19;Tiistai;37;3;40;15;0;15
96;10.12.2013;2013;12;20;Tiistai;44;4;48;21;0;21
96;10.12.2013;2013;12;21;Tiistai;44;3;47;14;0;14
96;10.12.2013;2013;12;22;Tiistai;18;0;18;1;0;1
96;10.12.2013;2013;12;23;Tiistai;3;0;3;0;0;0
96;11.12.2013;2013;12;00;Keskiviikko;5;0;5;0;0;0
96;11.12.2013;2013;12;01;Keskiviikko;1;0;1;1;0;1
96;11.12.2013;2013;12;02;Keskiviikko;0;0;0;1;0;1
96;11.12.2013;2013;12;03;Keskiviikko;1;0;1;1;0;1
96;11.12.2013;2013;12;04;Keskiviikko;1;0;1;0;0;0
96;11.12.2013;2013;12;05;Keskiviikko;7;4;11;2;2;4
96;11.12.2013;2013;12;06;Keskiviikko;39;27;66;4;2;6
96;11.12.2013;2013;12;07;Keskiviikko;67;67;134;8;7;15
96;11.12.2013;2013;12;08;Keskiviikko;81;69;150;7;5;12
96;11.12.2013;2013;12;09;Keskiviikko;42;40;82;11;3;14
96;11.12.2013;2013;12;10;Keskiviikko;49;43;92;8;9;17
96;11.12.2013;2013;12;11;Keskiviikko;43;34;77;4;9;13
96;11.12.2013;2013;12;12;Keskiviikko;40;51;91;11;13;24
96;11.12.2013;2013;12;13;Keskiviikko;32;43;75;3;15;18
96;11.12.2013;2013;12;14;Keskiviikko;42;53;95;5;15;20
96;11.12.2013;2013;12;15;Keskiviikko;51;136;187;5;27;32
96;11.12.2013;2013;12;16;Keskiviikko;60;87;147;7;29;36
96;11.12.2013;2013;12;17;Keskiviikko;54;44;98;6;12;18
96;11.12.2013;2013;12;18;Keskiviikko;42;26;68;11;5;16
96;11.12.2013;2013;12;19;Keskiviikko;43;25;68;8;3;11
96;11.12.2013;2013;12;20;Keskiviikko;33;18;51;1;7;8
96;11.12.2013;2013;12;21;Keskiviikko;21;27;48;3;11;14
96;11.12.2013;2013;12;22;Keskiviikko;8;7;15;2;0;2
96;11.12.2013;2013;12;23;Keskiviikko;6;5;11;0;1;1
96;12.12.2013;2013;12;00;Torstai;0;5;5;1;0;1
96;12.12.2013;2013;12;01;Torstai;1;0;1;0;0;0
96;12.12.2013;2013;12;02;Torstai;1;0;1;3;0;3
96;12.12.2013;2013;12;03;Torstai;4;0;4;0;0;0
96;12.12.2013;2013;12;04;Torstai;4;1;5;0;0;0
96;12.12.2013;2013;12;05;Torstai;5;2;7;1;2;3
96;12.12.2013;2013;12;06;Torstai;14;16;30;7;1;8
96;12.12.2013;2013;12;07;Torstai;43;31;74;29;8;37
96;12.12.2013;2013;12;08;Torstai;91;62;153;17;7;24
96;12.12.2013;2013;12;09;Torstai;28;32;60;10;7;17
96;12.12.2013;2013;12;10;Torstai;26;31;57;9;13;22
96;12.12.2013;2013;12;11;Torstai;20;30;50;11;12;23
96;12.12.2013;2013;12;12;Torstai;49;33;82;14;9;23
96;12.12.2013;2013;12;13;Torstai;46;46;92;10;7;17
96;12.12.2013;2013;12;14;Torstai;26;51;77;11;14;25
96;12.12.2013;2013;12;15;Torstai;36;78;114;3;28;31
96;12.12.2013;2013;12;16;Torstai;45;96;141;8;35;43
96;12.12.2013;2013;12;17;Torstai;41;28;69;8;8;16
96;12.12.2013;2013;12;18;Torstai;29;25;54;6;9;15
96;12.12.2013;2013;12;19;Torstai;29;21;50;2;8;10
96;12.12.2013;2013;12;20;Torstai;33;22;55;5;3;8
96;12.12.2013;2013;12;21;Torstai;17;23;40;5;2;7
96;12.12.2013;2013;12;22;Torstai;13;9;22;1;4;5
96;12.12.2013;2013;12;23;Torstai;2;2;4;0;0;0
96;13.12.2013;2013;12;00;Perjantai;2;0;2;0;1;1
96;13.12.2013;2013;12;01;Perjantai;0;0;0;1;0;1
96;13.12.2013;2013;12;02;Perjantai;1;0;1;0;0;0
96;13.12.2013;2013;12;03;Perjantai;0;1;1;0;0;0
96;13.12.2013;2013;12;04;Perjantai;1;0;1;1;1;2
96;13.12.2013;2013;12;05;Perjantai;1;4;5;3;2;5
96;13.12.2013;2013;12;06;Perjantai;27;11;38;14;1;15
96;13.12.2013;2013;12;07;Perjantai;62;39;101;17;9;26
96;13.12.2013;2013;12;08;Perjantai;52;54;106;14;9;23
96;13.12.2013;2013;12;09;Perjantai;29;33;62;10;6;16
96;13.12.2013;2013;12;10;Perjantai;39;38;77;5;18;23
96;13.12.2013;2013;12;11;Perjantai;25;40;65;10;7;17
96;13.12.2013;2013;12;12;Perjantai;29;45;74;10;16;26
96;13.12.2013;2013;12;13;Perjantai;46;64;110;9;11;20
96;13.12.2013;2013;12;14;Perjantai;33;66;99;14;24;38
96;13.12.2013;2013;12;15;Perjantai;47;101;148;7;27;34
96;13.12.2013;2013;12;16;Perjantai;40;52;92;16;18;34
96;13.12.2013;2013;12;17;Perjantai;32;35;67;15;10;25
96;13.12.2013;2013;12;18;Perjantai;23;14;37;10;6;16
96;13.12.2013;2013;12;19;Perjantai;34;18;52;5;5;10
96;13.12.2013;2013;12;20;Perjantai;18;8;26;4;1;5
96;13.12.2013;2013;12;21;Perjantai;12;14;26;3;3;6
96;13.12.2013;2013;12;22;Perjantai;7;5;12;3;3;6
96;13.12.2013;2013;12;23;Perjantai;5;3;8;3;2;5
96;14.12.2013;2013;12;00;Lauantai;13;6;19;1;1;2
96;14.12.2013;2013;12;01;Lauantai;8;0;8;1;0;1
96;14.12.2013;2013;12;02;Lauantai;4;0;4;3;0;3
96;14.12.2013;2013;12;03;Lauantai;6;0;6;1;0;1
96;14.12.2013;2013;12;04;Lauantai;8;0;8;3;0;3
96;14.12.2013;2013;12;05;Lauantai;1;0;1;1;1;2
96;14.12.2013;2013;12;06;Lauantai;13;5;18;3;0;3
96;14.12.2013;2013;12;07;Lauantai;5;10;15;1;2;3
96;14.12.2013;2013;12;08;Lauantai;4;9;13;6;0;6
96;14.12.2013;2013;12;09;Lauantai;3;19;22;4;5;9
96;14.12.2013;2013;12;10;Lauantai;11;13;24;6;10;16
96;14.12.2013;2013;12;11;Lauantai;8;17;25;8;6;14
96;14.12.2013;2013;12;12;Lauantai;16;24;40;9;7;16
96;14.12.2013;2013;12;13;Lauantai;17;30;47;9;11;20
96;14.12.2013;2013;12;14;Lauantai;31;22;53;8;15;23
96;14.12.2013;2013;12;15;Lauantai;32;32;64;8;17;25
96;14.12.2013;2013;12;16;Lauantai;21;24;45;6;22;28
96;14.12.2013;2013;12;17;Lauantai;12;28;40;9;8;17
96;14.12.2013;2013;12;18;Lauantai;22;11;33;10;4;14
96;14.12.2013;2013;12;19;Lauantai;24;9;33;23;9;32
96;14.12.2013;2013;12;20;Lauantai;10;11;21;3;11;14
96;14.12.2013;2013;12;21;Lauantai;9;11;20;1;9;10
96;14.12.2013;2013;12;22;Lauantai;2;5;7;0;3;3
96;14.12.2013;2013;12;23;Lauantai;3;1;4;2;1;3
96;15.12.2013;2013;12;00;Sunnuntai;8;4;12;2;1;3
96;15.12.2013;2013;12;01;Sunnuntai;8;5;13;3;0;3
96;15.12.2013;2013;12;02;Sunnuntai;6;3;9;3;0;3
96;15.12.2013;2013;12;03;Sunnuntai;6;1;7;1;0;1
96;15.12.2013;2013;12;04;Sunnuntai;2;0;2;3;1;4
96;15.12.2013;2013;12;05;Sunnuntai;1;0;1;0;0;0
96;15.12.2013;2013;12;06;Sunnuntai;14;4;18;8;1;9
96;15.12.2013;2013;12;07;Sunnuntai;2;6;8;2;4;6
96;15.12.2013;2013;12;08;Sunnuntai;3;8;11;3;1;4
96;15.12.2013;2013;12;09;Sunnuntai;5;8;13;8;12;20
96;15.12.2013;2013;12;10;Sunnuntai;3;11;14;9;5;14
96;15.12.2013;2013;12;11;Sunnuntai;6;16;22;8;14;22
96;15.12.2013;2013;12;12;Sunnuntai;19;21;40;7;22;29
96;15.12.2013;2013;12;13;Sunnuntai;20;19;39;7;9;16
96;15.12.2013;2013;12;14;Sunnuntai;24;29;53;11;18;29
96;15.12.2013;2013;12;15;Sunnuntai;18;22;40;9;14;23
96;15.12.2013;2013;12;16;Sunnuntai;27;17;44;24;8;32
96;15.12.2013;2013;12;17;Sunnuntai;20;13;33;19;7;26
96;15.12.2013;2013;12;18;Sunnuntai;17;29;46;11;20;31
96;15.12.2013;2013;12;19;Sunnuntai;9;12;21;15;14;29
96;15.12.2013;2013;12;20;Sunnuntai;20;22;42;7;21;28
96;15.12.2013;2013;12;21;Sunnuntai;15;10;25;2;7;9
96;15.12.2013;2013;12;22;Sunnuntai;2;4;6;0;0;0
96;15.12.2013;2013;12;23;Sunnuntai;3;0;3;0;0;0
96;16.12.2013;2013;12;00;Maanantai;4;0;4;1;1;2
96;16.12.2013;2013;12;01;Maanantai;0;0;0;1;0;1
96;16.12.2013;2013;12;02;Maanantai;1;0;1;0;0;0
96;16.12.2013;2013;12;03;Maanantai;0;0;0;0;0;0
96;16.12.2013;2013;12;04;Maanantai;4;1;5;2;1;3
96;16.12.2013;2013;12;05;Maanantai;4;5;9;1;1;2
96;16.12.2013;2013;12;06;Maanantai;31;23;54;12;2;14
96;16.12.2013;2013;12;07;Maanantai;80;61;141;31;10;41
96;16.12.2013;2013;12;08;Maanantai;57;69;126;18;6;24
96;16.12.2013;2013;12;09;Maanantai;37;53;90;10;7;17
96;16.12.2013;2013;12;10;Maanantai;25;39;64;12;12;24
96;16.12.2013;2013;12;11;Maanantai;39;33;72;9;6;15
96;16.12.2013;2013;12;12;Maanantai;37;43;80;5;6;11
96;16.12.2013;2013;12;13;Maanantai;40;52;92;5;12;17
96;16.12.2013;2013;12;14;Maanantai;46;64;110;8;14;22
96;16.12.2013;2013;12;15;Maanantai;68;121;189;8;37;45
96;16.12.2013;2013;12;16;Maanantai;65;92;157;5;36;41
96;16.12.2013;2013;12;17;Maanantai;56;39;95;6;13;19
96;16.12.2013;2013;12;18;Maanantai;23;17;40;7;14;21
96;16.12.2013;2013;12;19;Maanantai;34;21;55;5;4;9
96;16.12.2013;2013;12;20;Maanantai;30;15;45;3;4;7
96;16.12.2013;2013;12;21;Maanantai;19;20;39;6;7;13
96;16.12.2013;2013;12;22;Maanantai;13;4;17;2;1;3
96;16.12.2013;2013;12;23;Maanantai;2;0;2;0;0;0
96;17.12.2013;2013;12;00;Tiistai;1;0;1;1;0;1
96;17.12.2013;2013;12;01;Tiistai;0;0;0;0;1;1
96;17.12.2013;2013;12;02;Tiistai;1;0;1;0;0;0
96;17.12.2013;2013;12;03;Tiistai;0;0;0;0;0;0
96;17.12.2013;2013;12;04;Tiistai;1;0;1;1;0;1
96;17.12.2013;2013;12;05;Tiistai;3;6;9;1;0;1
96;17.12.2013;2013;12;06;Tiistai;21;13;34;7;3;10
96;17.12.2013;2013;12;07;Tiistai;86;39;125;18;6;24
96;17.12.2013;2013;12;08;Tiistai;80;49;129;10;7;17
96;17.12.2013;2013;12;09;Tiistai;34;27;61;10;7;17
96;17.12.2013;2013;12;10;Tiistai;20;27;47;7;5;12
96;17.12.2013;2013;12;11;Tiistai;36;33;69;5;6;11
96;17.12.2013;2013;12;12;Tiistai;45;39;84;4;7;11
96;17.12.2013;2013;12;13;Tiistai;30;35;65;8;7;15
96;17.12.2013;2013;12;14;Tiistai;40;59;99;6;19;25
96;17.12.2013;2013;12;15;Tiistai;48;75;123;12;20;32
96;17.12.2013;2013;12;16;Tiistai;60;79;139;16;30;46
96;17.12.2013;2013;12;17;Tiistai;37;35;72;9;12;21
96;17.12.2013;2013;12;18;Tiistai;31;29;60;8;10;18
96;17.12.2013;2013;12;19;Tiistai;35;22;57;13;13;26
96;17.12.2013;2013;12;20;Tiistai;32;16;48;3;5;8
96;17.12.2013;2013;12;21;Tiistai;13;15;28;1;9;10
96;17.12.2013;2013;12;22;Tiistai;8;12;20;1;3;4
96;17.12.2013;2013;12;23;Tiistai;2;3;5;1;0;1
96;18.12.2013;2013;12;00;Keskiviikko;1;0;1;0;1;1
96;18.12.2013;2013;12;01;Keskiviikko;3;0;3;0;0;0
96;18.12.2013;2013;12;02;Keskiviikko;0;0;0;0;0;0
96;18.12.2013;2013;12;03;Keskiviikko;0;0;0;0;0;0
96;18.12.2013;2013;12;04;Keskiviikko;5;2;7;0;0;0
96;18.12.2013;2013;12;05;Keskiviikko;5;6;11;0;0;0
96;18.12.2013;2013;12;06;Keskiviikko;37;22;59;1;0;1
96;18.12.2013;2013;12;07;Keskiviikko;71;67;138;4;7;11
96;18.12.2013;2013;12;08;Keskiviikko;46;70;116;2;2;4
96;18.12.2013;2013;12;09;Keskiviikko;30;35;65;0;2;2
96;18.12.2013;2013;12;10;Keskiviikko;28;42;70;1;7;8
96;18.12.2013;2013;12;11;Keskiviikko;40;32;72;1;3;4
96;18.12.2013;2013;12;12;Keskiviikko;39;46;85;2;6;8
96;18.12.2013;2013;12;13;Keskiviikko;39;56;95;0;10;10
96;18.12.2013;2013;12;14;Keskiviikko;36;46;82;0;8;8
96;18.12.2013;2013;12;15;Keskiviikko;62;101;163;3;11;14
96;18.12.2013;2013;12;16;Keskiviikko;66;106;172;0;12;12
96;18.12.2013;2013;12;17;Keskiviikko;42;50;92;1;7;8
96;18.12.2013;2013;12;18;Keskiviikko;41;35;76;2;5;7
96;18.12.2013;2013;12;19;Keskiviikko;37;39;76;1;10;11
96;18.12.2013;2013;12;20;Keskiviikko;22;33;55;1;10;11
96;18.12.2013;2013;12;21;Keskiviikko;14;26;40;0;1;1
96;18.12.2013;2013;12;22;Keskiviikko;11;11;22;0;0;0
96;18.12.2013;2013;12;23;Keskiviikko;6;8;14;0;0;0
96;19.12.2013;2013;12;00;Torstai;3;2;5;1;0;1
96;19.12.2013;2013;12;01;Torstai;3;2;5;0;0;0
96;19.12.2013;2013;12;02;Torstai;1;1;2;3;0;3
96;19.12.2013;2013;12;03;Torstai;3;0;3;0;0;0
96;19.12.2013;2013;12;04;Torstai;4;2;6;0;0;0
96;19.12.2013;2013;12;05;Torstai;6;3;9;1;2;3
96;19.12.2013;2013;12;06;Torstai;29;27;56;7;1;8
96;19.12.2013;2013;12;07;Torstai;66;66;132;29;8;37
96;19.12.2013;2013;12;08;Torstai;54;55;109;17;7;24
96;19.12.2013;2013;12;09;Torstai;33;35;68;10;7;17
96;19.12.2013;2013;12;10;Torstai;30;28;58;9;13;22
96;19.12.2013;2013;12;11;Torstai;29;31;60;11;12;23
96;19.12.2013;2013;12;12;Torstai;37;38;75;14;9;23
96;19.12.2013;2013;12;13;Torstai;45;50;95;10;7;17
96;19.12.2013;2013;12;14;Torstai;51;59;110;11;14;25
96;19.12.2013;2013;12;15;Torstai;79;84;163;3;28;31
96;19.12.2013;2013;12;16;Torstai;69;73;142;8;35;43
96;19.12.2013;2013;12;17;Torstai;44;41;85;8;8;16
96;19.12.2013;2013;12;18;Torstai;29;29;58;6;9;15
96;19.12.2013;2013;12;19;Torstai;27;24;51;2;8;10
96;19.12.2013;2013;12;20;Torstai;19;17;36;5;3;8
96;19.12.2013;2013;12;21;Torstai;14;13;27;5;2;7
96;19.12.2013;2013;12;22;Torstai;8;7;15;1;4;5
96;19.12.2013;2013;12;23;Torstai;2;1;3;0;0;0
96;20.12.2013;2013;12;00;Perjantai;1;0;1;0;1;1
96;20.12.2013;2013;12;01;Perjantai;2;1;3;1;0;1
96;20.12.2013;2013;12;02;Perjantai;2;0;2;0;0;0
96;20.12.2013;2013;12;03;Perjantai;3;2;5;0;0;0
96;20.12.2013;2013;12;04;Perjantai;2;1;3;1;1;2
96;20.12.2013;2013;12;05;Perjantai;5;4;9;3;2;5
96;20.12.2013;2013;12;06;Perjantai;22;22;44;14;1;15
96;20.12.2013;2013;12;07;Perjantai;53;52;105;17;9;26
96;20.12.2013;2013;12;08;Perjantai;43;41;84;14;9;23
96;20.12.2013;2013;12;09;Perjantai;20;19;39;10;6;16
96;20.12.2013;2013;12;10;Perjantai;24;22;46;5;18;23
96;20.12.2013;2013;12;11;Perjantai;24;22;46;10;7;17
96;20.12.2013;2013;12;12;Perjantai;31;31;62;10;16;26
96;20.12.2013;2013;12;13;Perjantai;50;48;98;9;11;20
96;20.12.2013;2013;12;14;Perjantai;46;44;90;14;24;38
96;20.12.2013;2013;12;15;Perjantai;57;54;111;7;27;34
96;20.12.2013;2013;12;16;Perjantai;40;38;78;16;18;34
96;20.12.2013;2013;12;17;Perjantai;24;19;43;15;10;25
96;20.12.2013;2013;12;18;Perjantai;20;20;40;10;6;16
96;20.12.2013;2013;12;19;Perjantai;18;13;31;5;5;10
96;20.12.2013;2013;12;20;Perjantai;16;14;30;4;1;5
96;20.12.2013;2013;12;21;Perjantai;13;15;28;3;3;6
96;20.12.2013;2013;12;22;Perjantai;8;5;13;3;3;6
96;20.12.2013;2013;12;23;Perjantai;5;4;9;3;2;5
96;21.12.2013;2013;12;00;Lauantai;2;0;2;1;0;1
96;21.12.2013;2013;12;01;Lauantai;3;1;4;0;0;0
96;21.12.2013;2013;12;02;Lauantai;7;3;10;0;0;0
96;21.12.2013;2013;12;03;Lauantai;3;1;4;0;0;0
96;21.12.2013;2013;12;04;Lauantai;3;1;4;1;0;1
96;21.12.2013;2013;12;05;Lauantai;0;3;3;0;0;0
96;21.12.2013;2013;12;06;Lauantai;11;7;18;2;0;2
96;21.12.2013;2013;12;07;Lauantai;2;5;7;0;2;2
96;21.12.2013;2013;12;08;Lauantai;7;8;15;4;3;7
96;21.12.2013;2013;12;09;Lauantai;2;18;20;3;10;13
96;21.12.2013;2013;12;10;Lauantai;14;15;29;5;7;12
96;21.12.2013;2013;12;11;Lauantai;16;20;36;12;7;19
96;21.12.2013;2013;12;12;Lauantai;16;20;36;8;8;16
96;21.12.2013;2013;12;13;Lauantai;21;19;40;7;20;27
96;21.12.2013;2013;12;14;Lauantai;19;35;54;6;11;17
96;21.12.2013;2013;12;15;Lauantai;20;23;43;6;6;12
96;21.12.2013;2013;12;16;Lauantai;20;19;39;12;7;19
96;21.12.2013;2013;12;17;Lauantai;20;12;32;7;2;9
96;21.12.2013;2013;12;18;Lauantai;21;7;28;14;9;23
96;21.12.2013;2013;12;19;Lauantai;7;11;18;7;3;10
96;21.12.2013;2013;12;20;Lauantai;15;5;20;4;1;5
96;21.12.2013;2013;12;21;Lauantai;8;18;26;6;10;16
96;21.12.2013;2013;12;22;Lauantai;1;2;3;0;0;0
96;21.12.2013;2013;12;23;Lauantai;6;4;10;0;1;1
96;22.12.2013;2013;12;00;Sunnuntai;6;4;10;1;1;2
96;22.12.2013;2013;12;01;Sunnuntai;3;1;4;1;0;1
96;22.12.2013;2013;12;02;Sunnuntai;3;0;3;2;0;2
96;22.12.2013;2013;12;03;Sunnuntai;3;1;4;0;1;1
96;22.12.2013;2013;12;04;Sunnuntai;3;0;3;8;1;9
96;22.12.2013;2013;12;05;Sunnuntai;0;1;1;0;0;0
96;22.12.2013;2013;12;06;Sunnuntai;6;4;10;1;2;3
96;22.12.2013;2013;12;07;Sunnuntai;0;6;6;2;2;4
96;22.12.2013;2013;12;08;Sunnuntai;2;6;8;0;4;4
96;22.12.2013;2013;12;09;Sunnuntai;5;8;13;4;1;5
96;22.12.2013;2013;12;10;Sunnuntai;8;11;19;6;7;13
96;22.12.2013;2013;12;11;Sunnuntai;10;13;23;3;7;10
96;22.12.2013;2013;12;12;Sunnuntai;12;22;34;9;8;17
96;22.12.2013;2013;12;13;Sunnuntai;30;22;52;8;12;20
96;22.12.2013;2013;12;14;Sunnuntai;17;9;26;12;8;20
96;22.12.2013;2013;12;15;Sunnuntai;19;18;37;5;8;13
96;22.12.2013;2013;12;16;Sunnuntai;18;12;30;9;10;19
96;22.12.2013;2013;12;17;Sunnuntai;8;9;17;6;8;14
96;22.12.2013;2013;12;18;Sunnuntai;12;7;19;9;8;17
96;22.12.2013;2013;12;19;Sunnuntai;8;11;19;3;8;11
96;22.12.2013;2013;12;20;Sunnuntai;9;4;13;3;2;5
96;22.12.2013;2013;12;21;Sunnuntai;7;7;14;2;2;4
96;22.12.2013;2013;12;22;Sunnuntai;4;1;5;0;2;2
96;22.12.2013;2013;12;23;Sunnuntai;3;0;3;0;1;1
96;23.12.2013;2013;12;00;Maanantai;2;0;2;0;0;0
96;23.12.2013;2013;12;01;Maanantai;1;1;2;0;0;0
96;23.12.2013;2013;12;02;Maanantai;0;0;0;0;0;0
96;23.12.2013;2013;12;03;Maanantai;1;0;1;0;0;0
96;23.12.2013;2013;12;04;Maanantai;3;0;3;1;0;1
96;23.12.2013;2013;12;05;Maanantai;2;3;5;1;0;1
96;23.12.2013;2013;12;06;Maanantai;20;5;25;9;1;10
96;23.12.2013;2013;12;07;Maanantai;20;20;40;12;2;14
96;23.12.2013;2013;12;08;Maanantai;13;17;30;7;6;13
96;23.12.2013;2013;12;09;Maanantai;6;11;17;3;6;9
96;23.12.2013;2013;12;10;Maanantai;17;11;28;4;5;9
96;23.12.2013;2013;12;11;Maanantai;11;14;25;9;8;17
96;23.12.2013;2013;12;12;Maanantai;17;24;41;6;9;15
96;23.12.2013;2013;12;13;Maanantai;16;23;39;8;8;16
96;23.12.2013;2013;12;14;Maanantai;18;34;52;2;12;14
96;23.12.2013;2013;12;15;Maanantai;25;41;66;10;10;20
96;23.12.2013;2013;12;16;Maanantai;19;15;34;8;14;22
96;23.12.2013;2013;12;17;Maanantai;14;13;27;3;8;11
96;23.12.2013;2013;12;18;Maanantai;10;3;13;4;4;8
96;23.12.2013;2013;12;19;Maanantai;9;4;13;3;1;4
96;23.12.2013;2013;12;20;Maanantai;6;3;9;1;2;3
96;23.12.2013;2013;12;21;Maanantai;5;7;12;0;3;3
96;23.12.2013;2013;12;22;Maanantai;4;2;6;2;1;3
96;23.12.2013;2013;12;23;Maanantai;1;0;1;0;1;1
96;24.12.2013;2013;12;00;Tiistai;1;0;1;2;1;3
96;24.12.2013;2013;12;01;Tiistai;0;0;0;0;0;0
96;24.12.2013;2013;12;02;Tiistai;0;1;1;0;0;0
96;24.12.2013;2013;12;03;Tiistai;0;0;0;0;0;0
96;24.12.2013;2013;12;04;Tiistai;0;1;1;0;0;0
96;24.12.2013;2013;12;05;Tiistai;0;0;0;0;0;0
96;24.12.2013;2013;12;06;Tiistai;7;3;10;7;0;7
96;24.12.2013;2013;12;07;Tiistai;5;10;15;1;2;3
96;24.12.2013;2013;12;08;Tiistai;4;5;9;2;4;6
96;24.12.2013;2013;12;09;Tiistai;2;7;9;4;8;12
96;24.12.2013;2013;12;10;Tiistai;5;5;10;5;6;11
96;24.12.2013;2013;12;11;Tiistai;7;10;17;7;9;16
96;24.12.2013;2013;12;12;Tiistai;7;5;12;10;2;12
96;24.12.2013;2013;12;13;Tiistai;5;6;11;6;4;10
96;24.12.2013;2013;12;14;Tiistai;1;10;11;3;8;11
96;24.12.2013;2013;12;15;Tiistai;7;11;18;2;2;4
96;24.12.2013;2013;12;16;Tiistai;2;1;3;3;5;8
96;24.12.2013;2013;12;17;Tiistai;3;3;6;3;0;3
96;24.12.2013;2013;12;18;Tiistai;1;1;2;1;1;2
96;24.12.2013;2013;12;19;Tiistai;2;2;4;1;3;4
96;24.12.2013;2013;12;20;Tiistai;7;3;10;1;0;1
96;24.12.2013;2013;12;21;Tiistai;3;7;10;0;3;3
96;24.12.2013;2013;12;22;Tiistai;0;1;1;0;1;1
96;24.12.2013;2013;12;23;Tiistai;0;0;0;0;0;0
96;25.12.2013;2013;12;00;Keskiviikko;1;1;2;1;2;3
96;25.12.2013;2013;12;01;Keskiviikko;0;0;0;0;1;1
96;25.12.2013;2013;12;02;Keskiviikko;0;0;0;0;1;1
96;25.12.2013;2013;12;03;Keskiviikko;0;0;0;0;1;1
96;25.12.2013;2013;12;04;Keskiviikko;1;0;1;0;0;0
96;25.12.2013;2013;12;05;Keskiviikko;0;0;0;0;0;0
96;25.12.2013;2013;12;06;Keskiviikko;5;0;5;0;0;0
96;25.12.2013;2013;12;07;Keskiviikko;0;5;5;1;4;5
96;25.12.2013;2013;12;08;Keskiviikko;1;0;1;1;1;2
96;25.12.2013;2013;12;09;Keskiviikko;1;0;1;1;1;2
96;25.12.2013;2013;12;10;Keskiviikko;2;0;2;0;1;1
96;25.12.2013;2013;12;11;Keskiviikko;3;1;4;2;1;3
96;25.12.2013;2013;12;12;Keskiviikko;5;3;8;4;1;5
96;25.12.2013;2013;12;13;Keskiviikko;4;3;7;4;2;6
96;25.12.2013;2013;12;14;Keskiviikko;2;2;4;3;3;6
96;25.12.2013;2013;12;15;Keskiviikko;4;4;8;0;4;4
96;25.12.2013;2013;12;16;Keskiviikko;0;2;2;4;2;6
96;25.12.2013;2013;12;17;Keskiviikko;4;3;7;2;3;5
96;25.12.2013;2013;12;18;Keskiviikko;4;1;5;1;4;5
96;25.12.2013;2013;12;19;Keskiviikko;3;0;3;1;1;2
96;25.12.2013;2013;12;20;Keskiviikko;8;5;13;0;1;1
96;25.12.2013;2013;12;21;Keskiviikko;6;3;9;1;4;5
96;25.12.2013;2013;12;22;Keskiviikko;0;1;1;1;0;1
96;25.12.2013;2013;12;23;Keskiviikko;2;1;3;0;0;0
96;26.12.2013;2013;12;00;Torstai;0;0;0;0;0;0
96;26.12.2013;2013;12;01;Torstai;0;0;0;0;1;1
96;26.12.2013;2013;12;02;Torstai;1;1;2;0;0;0
96;26.12.2013;2013;12;03;Torstai;0;0;0;0;0;0
96;26.12.2013;2013;12;04;Torstai;0;0;0;0;0;0
96;26.12.2013;2013;12;05;Torstai;1;0;1;0;0;0
96;26.12.2013;2013;12;06;Torstai;6;0;6;4;0;4
96;26.12.2013;2013;12;07;Torstai;0;6;6;0;1;1
96;26.12.2013;2013;12;08;Torstai;0;2;2;1;1;2
96;26.12.2013;2013;12;09;Torstai;3;2;5;1;5;6
96;26.12.2013;2013;12;10;Torstai;3;6;9;6;3;9
96;26.12.2013;2013;12;11;Torstai;7;1;8;12;9;21
96;26.12.2013;2013;12;12;Torstai;11;5;16;5;7;12
96;26.12.2013;2013;12;13;Torstai;13;7;20;10;11;21
96;26.12.2013;2013;12;14;Torstai;9;10;19;11;9;20
96;26.12.2013;2013;12;15;Torstai;7;7;14;5;7;12
96;26.12.2013;2013;12;16;Torstai;11;4;15;5;5;10
96;26.12.2013;2013;12;17;Torstai;6;6;12;5;4;9
96;26.12.2013;2013;12;18;Torstai;4;5;9;9;13;22
96;26.12.2013;2013;12;19;Torstai;6;11;17;11;9;20
96;26.12.2013;2013;12;20;Torstai;10;6;16;2;4;6
96;26.12.2013;2013;12;21;Torstai;10;17;27;1;3;4
96;26.12.2013;2013;12;22;Torstai;5;5;10;2;2;4
96;26.12.2013;2013;12;23;Torstai;1;4;5;3;2;5
96;27.12.2013;2013;12;00;Perjantai;0;2;2;0;0;0
96;27.12.2013;2013;12;01;Perjantai;4;0;4;4;1;5
96;27.12.2013;2013;12;02;Perjantai;0;0;0;0;0;0
96;27.12.2013;2013;12;03;Perjantai;4;0;4;5;0;5
96;27.12.2013;2013;12;04;Perjantai;6;1;7;3;0;3
96;27.12.2013;2013;12;05;Perjantai;7;4;11;0;0;0
96;27.12.2013;2013;12;06;Perjantai;13;5;18;10;0;10
96;27.12.2013;2013;12;07;Perjantai;32;17;49;12;9;21
96;27.12.2013;2013;12;08;Perjantai;13;13;26;2;4;6
96;27.12.2013;2013;12;09;Perjantai;6;21;27;4;8;12
96;27.12.2013;2013;12;10;Perjantai;16;11;27;12;13;25
96;27.12.2013;2013;12;11;Perjantai;16;28;44;7;11;18
96;27.12.2013;2013;12;12;Perjantai;15;29;44;7;19;26
96;27.12.2013;2013;12;13;Perjantai;34;24;58;21;8;29
96;27.12.2013;2013;12;14;Perjantai;16;35;51;6;14;20
96;27.12.2013;2013;12;15;Perjantai;24;34;58;8;20;28
96;27.12.2013;2013;12;16;Perjantai;21;25;46;13;21;34
96;27.12.2013;2013;12;17;Perjantai;19;23;42;12;21;33
96;27.12.2013;2013;12;18;Perjantai;14;16;30;6;6;12
96;27.12.2013;2013;12;19;Perjantai;13;5;18;4;4;8
96;27.12.2013;2013;12;20;Perjantai;10;7;17;9;6;15
96;27.12.2013;2013;12;21;Perjantai;12;14;26;7;3;10
96;27.12.2013;2013;12;22;Perjantai;9;2;11;2;2;4
96;27.12.2013;2013;12;23;Perjantai;1;2;3;1;2;3
96;28.12.2013;2013;12;00;Lauantai;2;1;3;1;0;1
96;28.12.2013;2013;12;01;Lauantai;2;2;4;0;0;0
96;28.12.2013;2013;12;02;Lauantai;1;1;2;2;0;2
96;28.12.2013;2013;12;03;Lauantai;2;0;2;1;0;1
96;28.12.2013;2013;12;04;Lauantai;3;0;3;0;0;0
96;28.12.2013;2013;12;05;Lauantai;0;1;1;0;0;0
96;28.12.2013;2013;12;06;Lauantai;10;7;17;0;0;0
96;28.12.2013;2013;12;07;Lauantai;3;7;10;0;3;3
96;28.12.2013;2013;12;08;Lauantai;1;4;5;2;1;3
96;28.12.2013;2013;12;09;Lauantai;1;13;14;0;5;5
96;28.12.2013;2013;12;10;Lauantai;4;11;15;2;5;7
96;28.12.2013;2013;12;11;Lauantai;11;21;32;9;7;16
96;28.12.2013;2013;12;12;Lauantai;17;18;35;10;6;16
96;28.12.2013;2013;12;13;Lauantai;21;19;40;12;13;25
96;28.12.2013;2013;12;14;Lauantai;23;20;43;7;9;16
96;28.12.2013;2013;12;15;Lauantai;24;26;50;9;6;15
96;28.12.2013;2013;12;16;Lauantai;10;7;17;11;12;23
96;28.12.2013;2013;12;17;Lauantai;18;14;32;7;7;14
96;28.12.2013;2013;12;18;Lauantai;18;7;25;9;10;19
96;28.12.2013;2013;12;19;Lauantai;12;10;22;13;8;21
96;28.12.2013;2013;12;20;Lauantai;10;7;17;6;10;16
96;28.12.2013;2013;12;21;Lauantai;3;13;16;0;5;5
96;28.12.2013;2013;12;22;Lauantai;2;4;6;0;2;2
96;28.12.2013;2013;12;23;Lauantai;3;9;12;1;1;2
96;29.12.2013;2013;12;00;Sunnuntai;2;0;2;1;0;1
96;29.12.2013;2013;12;01;Sunnuntai;3;4;7;2;0;2
96;29.12.2013;2013;12;02;Sunnuntai;3;1;4;0;0;0
96;29.12.2013;2013;12;03;Sunnuntai;4;0;4;2;4;6
96;29.12.2013;2013;12;04;Sunnuntai;7;1;8;3;0;3
96;29.12.2013;2013;12;05;Sunnuntai;3;2;5;2;1;3
96;29.12.2013;2013;12;06;Sunnuntai;7;5;12;4;1;5
96;29.12.2013;2013;12;07;Sunnuntai;3;4;7;1;3;4
96;29.12.2013;2013;12;08;Sunnuntai;4;3;7;1;3;4
96;29.12.2013;2013;12;09;Sunnuntai;1;4;5;2;1;3
96;29.12.2013;2013;12;10;Sunnuntai;3;5;8;3;4;7
96;29.12.2013;2013;12;11;Sunnuntai;4;13;17;9;10;19
96;29.12.2013;2013;12;12;Sunnuntai;15;16;31;13;17;30
96;29.12.2013;2013;12;13;Sunnuntai;15;16;31;8;5;13
96;29.12.2013;2013;12;14;Sunnuntai;19;19;38;11;19;30
96;29.12.2013;2013;12;15;Sunnuntai;22;19;41;9;11;20
96;29.12.2013;2013;12;16;Sunnuntai;30;12;42;18;7;25
96;29.12.2013;2013;12;17;Sunnuntai;24;4;28;7;4;11
96;29.12.2013;2013;12;18;Sunnuntai;8;22;30;11;10;21
96;29.12.2013;2013;12;19;Sunnuntai;13;11;24;6;12;18
96;29.12.2013;2013;12;20;Sunnuntai;12;7;19;10;10;20
96;29.12.2013;2013;12;21;Sunnuntai;6;11;17;7;1;8
96;29.12.2013;2013;12;22;Sunnuntai;6;5;11;1;5;6
96;29.12.2013;2013;12;23;Sunnuntai;2;2;4;1;1;2
96;06.01.2014;2014;01;00;Maanantai;3;6;9;2;1;3
96;06.01.2014;2014;01;01;Maanantai;2;0;2;0;0;0
96;06.01.2014;2014;01;02;Maanantai;5;0;5;1;0;1
96;06.01.2014;2014;01;03;Maanantai;1;0;1;2;0;2
96;06.01.2014;2014;01;04;Maanantai;2;0;2;3;0;3
96;06.01.2014;2014;01;05;Maanantai;1;0;1;1;0;1
96;06.01.2014;2014;01;06;Maanantai;11;7;18;5;1;6
96;06.01.2014;2014;01;07;Maanantai;1;7;8;3;5;8
96;06.01.2014;2014;01;08;Maanantai;0;9;9;1;3;4
96;06.01.2014;2014;01;09;Maanantai;8;13;21;4;10;14
96;06.01.2014;2014;01;10;Maanantai;17;7;24;10;12;22
96;06.01.2014;2014;01;11;Maanantai;12;18;30;8;16;24
96;06.01.2014;2014;01;12;Maanantai;21;23;44;11;27;38
96;06.01.2014;2014;01;13;Maanantai;29;28;57;16;23;39
96;06.01.2014;2014;01;14;Maanantai;21;34;55;17;13;30
96;06.01.2014;2014;01;15;Maanantai;20;19;39;12;17;29
96;06.01.2014;2014;01;16;Maanantai;35;14;49;21;12;33
96;06.01.2014;2014;01;17;Maanantai;24;16;40;20;10;30
96;06.01.2014;2014;01;18;Maanantai;26;18;44;15;27;42
96;06.01.2014;2014;01;19;Maanantai;16;16;32;15;16;31
96;06.01.2014;2014;01;20;Maanantai;13;14;27;17;18;35
96;06.01.2014;2014;01;21;Maanantai;9;24;33;7;7;14
96;06.01.2014;2014;01;22;Maanantai;5;9;14;3;6;9
96;06.01.2014;2014;01;23;Maanantai;2;2;4;0;1;1
96;07.01.2014;2014;01;00;Tiistai;2;1;3;1;1;2
96;07.01.2014;2014;01;01;Tiistai;1;1;2;0;0;0
96;07.01.2014;2014;01;02;Tiistai;0;0;0;0;0;0
96;07.01.2014;2014;01;03;Tiistai;1;0;1;0;0;0
96;07.01.2014;2014;01;04;Tiistai;1;0;1;0;0;0
96;07.01.2014;2014;01;05;Tiistai;1;13;14;0;0;0
96;07.01.2014;2014;01;06;Tiistai;28;17;45;11;1;12
96;07.01.2014;2014;01;07;Tiistai;77;84;161;30;13;43
96;07.01.2014;2014;01;08;Tiistai;79;86;165;31;9;40
96;07.01.2014;2014;01;09;Tiistai;40;52;92;6;17;23
96;07.01.2014;2014;01;10;Tiistai;34;36;70;14;13;27
96;07.01.2014;2014;01;11;Tiistai;32;39;71;8;16;24
96;07.01.2014;2014;01;12;Tiistai;37;36;73;14;13;27
96;07.01.2014;2014;01;13;Tiistai;35;43;78;11;13;24
96;07.01.2014;2014;01;14;Tiistai;52;55;107;11;18;29
96;07.01.2014;2014;01;15;Tiistai;50;142;192;7;37;44
96;07.01.2014;2014;01;16;Tiistai;80;136;216;13;39;52
96;07.01.2014;2014;01;17;Tiistai;59;60;119;15;15;30
96;07.01.2014;2014;01;18;Tiistai;42;26;68;11;14;25
96;07.01.2014;2014;01;19;Tiistai;38;31;69;14;22;36
96;07.01.2014;2014;01;20;Tiistai;41;24;65;9;20;29
96;07.01.2014;2014;01;21;Tiistai;26;29;55;1;6;7
96;07.01.2014;2014;01;22;Tiistai;11;7;18;3;6;9
96;07.01.2014;2014;01;23;Tiistai;9;3;12;0;2;2
96;08.01.2014;2014;01;00;Keskiviikko;0;6;6;0;1;1
96;08.01.2014;2014;01;01;Keskiviikko;1;0;1;0;1;1
96;08.01.2014;2014;01;02;Keskiviikko;1;1;2;0;0;0
96;08.01.2014;2014;01;03;Keskiviikko;0;0;0;1;0;1
96;08.01.2014;2014;01;04;Keskiviikko;1;1;2;0;0;0
96;08.01.2014;2014;01;05;Keskiviikko;1;9;10;2;3;5
96;08.01.2014;2014;01;06;Keskiviikko;46;16;62;5;2;7
96;08.01.2014;2014;01;07;Keskiviikko;78;60;138;17;8;25
96;08.01.2014;2014;01;08;Keskiviikko;82;83;165;19;11;30
96;08.01.2014;2014;01;09;Keskiviikko;46;44;90;8;8;16
96;08.01.2014;2014;01;10;Keskiviikko;50;44;94;13;13;26
96;08.01.2014;2014;01;11;Keskiviikko;43;35;78;12;17;29
96;08.01.2014;2014;01;12;Keskiviikko;45;52;97;8;16;24
96;08.01.2014;2014;01;13;Keskiviikko;40;57;97;8;15;23
96;08.01.2014;2014;01;14;Keskiviikko;59;66;125;9;18;27
96;08.01.2014;2014;01;15;Keskiviikko;75;144;219;9;33;42
96;08.01.2014;2014;01;16;Keskiviikko;67;108;175;18;39;57
96;08.01.2014;2014;01;17;Keskiviikko;67;55;122;7;21;28
96;08.01.2014;2014;01;18;Keskiviikko;56;35;91;18;19;37
96;08.01.2014;2014;01;19;Keskiviikko;54;18;72;15;16;31
96;08.01.2014;2014;01;20;Keskiviikko;37;28;65;10;13;23
96;08.01.2014;2014;01;21;Keskiviikko;44;21;65;5;8;13
96;08.01.2014;2014;01;22;Keskiviikko;6;4;10;1;2;3
96;08.01.2014;2014;01;23;Keskiviikko;8;5;13;0;1;1
96;09.01.2014;2014;01;00;Torstai;1;0;1;2;1;3
96;09.01.2014;2014;01;01;Torstai;1;0;1;0;0;0
96;09.01.2014;2014;01;02;Torstai;2;1;3;0;0;0
96;09.01.2014;2014;01;03;Torstai;1;0;1;0;0;0
96;09.01.2014;2014;01;04;Torstai;1;0;1;0;0;0
96;09.01.2014;2014;01;05;Torstai;3;12;15;0;1;1
96;09.01.2014;2014;01;06;Torstai;43;16;59;8;5;13
96;09.01.2014;2014;01;07;Torstai;95;61;156;18;11;29
96;09.01.2014;2014;01;08;Torstai;94;90;184;14;7;21
96;09.01.2014;2014;01;09;Torstai;38;50;88;9;10;19
96;09.01.2014;2014;01;10;Torstai;29;44;73;7;20;27
96;09.01.2014;2014;01;11;Torstai;41;37;78;12;7;19
96;09.01.2014;2014;01;12;Torstai;43;30;73;11;12;23
96;09.01.2014;2014;01;13;Torstai;33;44;77;7;9;16
96;09.01.2014;2014;01;14;Torstai;29;90;119;5;20;25
96;09.01.2014;2014;01;15;Torstai;46;145;191;2;39;41
96;09.01.2014;2014;01;16;Torstai;59;102;161;8;37;45
96;09.01.2014;2014;01;17;Torstai;50;44;94;8;19;27
96;09.01.2014;2014;01;18;Torstai;42;29;71;19;16;35
96;09.01.2014;2014;01;19;Torstai;31;26;57;6;22;28
96;09.01.2014;2014;01;20;Torstai;42;22;64;10;8;18
96;09.01.2014;2014;01;21;Torstai;18;12;30;5;4;9
96;09.01.2014;2014;01;22;Torstai;10;4;14;1;6;7
96;09.01.2014;2014;01;23;Torstai;7;2;9;3;2;5
96;10.01.2014;2014;01;00;Perjantai;0;0;0;0;1;1
96;10.01.2014;2014;01;01;Perjantai;2;1;3;0;0;0
96;10.01.2014;2014;01;02;Perjantai;1;0;1;0;1;1
96;10.01.2014;2014;01;03;Perjantai;0;0;0;1;0;1
96;10.01.2014;2014;01;04;Perjantai;1;0;1;1;0;1
96;10.01.2014;2014;01;05;Perjantai;0;5;5;3;4;7
96;10.01.2014;2014;01;06;Perjantai;21;19;40;9;2;11
96;10.01.2014;2014;01;07;Perjantai;64;53;117;25;8;33
96;10.01.2014;2014;01;08;Perjantai;83;59;142;11;16;27
96;10.01.2014;2014;01;09;Perjantai;30;44;74;10;6;16
96;10.01.2014;2014;01;10;Perjantai;19;25;44;7;10;17
96;10.01.2014;2014;01;11;Perjantai;32;35;67;10;10;20
96;10.01.2014;2014;01;12;Perjantai;22;37;59;15;18;33
96;10.01.2014;2014;01;13;Perjantai;38;63;101;10;11;21
96;10.01.2014;2014;01;14;Perjantai;40;72;112;8;22;30
96;10.01.2014;2014;01;15;Perjantai;51;112;163;11;36;47
96;10.01.2014;2014;01;16;Perjantai;45;68;113;5;23;28
96;10.01.2014;2014;01;17;Perjantai;35;22;57;6;7;13
96;10.01.2014;2014;01;18;Perjantai;31;12;43;5;7;12
96;10.01.2014;2014;01;19;Perjantai;25;25;50;6;19;25
96;10.01.2014;2014;01;20;Perjantai;14;13;27;5;9;14
96;10.01.2014;2014;01;21;Perjantai;23;8;31;4;6;10
96;10.01.2014;2014;01;22;Perjantai;12;5;17;4;2;6
96;10.01.2014;2014;01;23;Perjantai;7;1;8;0;0;0
96;11.01.2014;2014;01;00;Lauantai;1;1;2;0;1;1
96;11.01.2014;2014;01;01;Lauantai;5;1;6;1;0;1
96;11.01.2014;2014;01;02;Lauantai;6;0;6;0;0;0
96;11.01.2014;2014;01;03;Lauantai;1;1;2;0;0;0
96;11.01.2014;2014;01;04;Lauantai;4;0;4;0;0;0
96;11.01.2014;2014;01;05;Lauantai;0;0;0;0;0;0
96;11.01.2014;2014;01;06;Lauantai;8;7;15;2;1;3
96;11.01.2014;2014;01;07;Lauantai;1;13;14;0;5;5
96;11.01.2014;2014;01;08;Lauantai;4;10;14;5;5;10
96;11.01.2014;2014;01;09;Lauantai;2;15;17;3;4;7
96;11.01.2014;2014;01;10;Lauantai;6;11;17;4;4;8
96;11.01.2014;2014;01;11;Lauantai;10;21;31;5;11;16
96;11.01.2014;2014;01;12;Lauantai;20;13;33;14;11;25
96;11.01.2014;2014;01;13;Lauantai;16;20;36;14;11;25
96;11.01.2014;2014;01;14;Lauantai;12;21;33;9;16;25
96;11.01.2014;2014;01;15;Lauantai;19;24;43;10;10;20
96;11.01.2014;2014;01;16;Lauantai;13;26;39;12;6;18
96;11.01.2014;2014;01;17;Lauantai;16;9;25;5;9;14
96;11.01.2014;2014;01;18;Lauantai;19;7;26;14;7;21
96;11.01.2014;2014;01;19;Lauantai;22;8;30;13;15;28
96;11.01.2014;2014;01;20;Lauantai;8;12;20;6;14;20
96;11.01.2014;2014;01;21;Lauantai;5;17;22;3;8;11
96;11.01.2014;2014;01;22;Lauantai;3;7;10;2;1;3
96;11.01.2014;2014;01;23;Lauantai;3;14;17;0;4;4
96;12.01.2014;2014;01;00;Sunnuntai;4;5;9;0;0;0
96;12.01.2014;2014;01;01;Sunnuntai;2;2;4;1;0;1
96;12.01.2014;2014;01;02;Sunnuntai;3;2;5;0;0;0
96;12.01.2014;2014;01;03;Sunnuntai;5;0;5;0;0;0
96;12.01.2014;2014;01;04;Sunnuntai;3;1;4;4;0;4
96;12.01.2014;2014;01;05;Sunnuntai;0;0;0;2;0;2
96;12.01.2014;2014;01;06;Sunnuntai;10;3;13;3;1;4
96;12.01.2014;2014;01;07;Sunnuntai;0;4;4;0;5;5
96;12.01.2014;2014;01;08;Sunnuntai;1;7;8;2;4;6
96;12.01.2014;2014;01;09;Sunnuntai;1;6;7;5;8;13
96;12.01.2014;2014;01;10;Sunnuntai;8;5;13;7;3;10
96;12.01.2014;2014;01;11;Sunnuntai;8;19;27;8;10;18
96;12.01.2014;2014;01;12;Sunnuntai;19;20;39;18;13;31
96;12.01.2014;2014;01;13;Sunnuntai;16;28;44;11;13;24
96;12.01.2014;2014;01;14;Sunnuntai;12;30;42;11;20;31
96;12.01.2014;2014;01;15;Sunnuntai;24;30;54;15;19;34
96;12.01.2014;2014;01;16;Sunnuntai;25;19;44;33;10;43
96;12.01.2014;2014;01;17;Sunnuntai;19;15;34;11;9;20
96;12.01.2014;2014;01;18;Sunnuntai;19;15;34;25;19;44
96;12.01.2014;2014;01;19;Sunnuntai;14;17;31;6;19;25
96;12.01.2014;2014;01;20;Sunnuntai;17;12;29;5;14;19
96;12.01.2014;2014;01;21;Sunnuntai;9;17;26;4;8;12
96;12.01.2014;2014;01;22;Sunnuntai;5;3;8;1;1;2
96;12.01.2014;2014;01;23;Sunnuntai;3;0;3;1;0;1
96;13.01.2014;2014;01;00;Maanantai;2;0;2;0;0;0
96;13.01.2014;2014;01;01;Maanantai;0;0;0;0;1;1
96;13.01.2014;2014;01;02;Maanantai;1;2;3;0;0;0
96;13.01.2014;2014;01;03;Maanantai;0;0;0;0;0;0
96;13.01.2014;2014;01;04;Maanantai;1;0;1;0;0;0
96;13.01.2014;2014;01;05;Maanantai;0;9;9;0;0;0
96;13.01.2014;2014;01;06;Maanantai;28;14;42;9;4;13
96;13.01.2014;2014;01;07;Maanantai;77;57;134;29;12;41
96;13.01.2014;2014;01;08;Maanantai;86;80;166;12;10;22
96;13.01.2014;2014;01;09;Maanantai;37;36;73;14;13;27
96;13.01.2014;2014;01;10;Maanantai;38;37;75;7;6;13
96;13.01.2014;2014;01;11;Maanantai;34;16;50;8;19;27
96;13.01.2014;2014;01;12;Maanantai;37;31;68;10;13;23
96;13.01.2014;2014;01;13;Maanantai;37;47;84;13;11;24
96;13.01.2014;2014;01;14;Maanantai;32;61;93;10;24;34
96;13.01.2014;2014;01;15;Maanantai;43;129;172;10;43;53
96;13.01.2014;2014;01;16;Maanantai;50;89;139;6;41;47
96;13.01.2014;2014;01;17;Maanantai;46;52;98;11;14;25
96;13.01.2014;2014;01;18;Maanantai;32;38;70;18;19;37
96;13.01.2014;2014;01;19;Maanantai;28;26;54;11;16;27
96;13.01.2014;2014;01;20;Maanantai;31;14;45;7;9;16
96;13.01.2014;2014;01;21;Maanantai;17;18;35;8;3;11
96;13.01.2014;2014;01;22;Maanantai;10;5;15;4;2;6
96;13.01.2014;2014;01;23;Maanantai;0;1;1;0;1;1
96;14.01.2014;2014;01;00;Tiistai;0;0;0;0;0;0
96;14.01.2014;2014;01;01;Tiistai;1;0;1;0;0;0
96;14.01.2014;2014;01;02;Tiistai;0;1;1;0;0;0
96;14.01.2014;2014;01;03;Tiistai;0;0;0;0;0;0
96;14.01.2014;2014;01;04;Tiistai;1;1;2;0;0;0
96;14.01.2014;2014;01;05;Tiistai;1;9;10;2;2;4
96;14.01.2014;2014;01;06;Tiistai;27;16;43;15;3;18
96;14.01.2014;2014;01;07;Tiistai;80;65;145;34;9;43
96;14.01.2014;2014;01;08;Tiistai;74;66;140;23;6;29
96;14.01.2014;2014;01;09;Tiistai;33;28;61;14;10;24
96;14.01.2014;2014;01;10;Tiistai;32;32;64;7;8;15
96;14.01.2014;2014;01;11;Tiistai;30;24;54;12;7;19
96;14.01.2014;2014;01;12;Tiistai;29;42;71;14;35;49
96;14.01.2014;2014;01;13;Tiistai;26;29;55;17;9;26
96;14.01.2014;2014;01;14;Tiistai;29;64;93;8;26;34
96;14.01.2014;2014;01;15;Tiistai;49;110;159;5;41;46
96;14.01.2014;2014;01;16;Tiistai;64;100;164;21;45;66
96;14.01.2014;2014;01;17;Tiistai;36;43;79;18;33;51
96;14.01.2014;2014;01;18;Tiistai;26;34;60;9;23;32
96;14.01.2014;2014;01;19;Tiistai;32;19;51;15;11;26
96;14.01.2014;2014;01;20;Tiistai;43;10;53;24;5;29
96;14.01.2014;2014;01;21;Tiistai;22;23;45;2;8;10
96;14.01.2014;2014;01;22;Tiistai;6;3;9;2;2;4
96;14.01.2014;2014;01;23;Tiistai;5;2;7;0;0;0
96;15.01.2014;2014;01;00;Keskiviikko;0;0;0;0;0;0
96;15.01.2014;2014;01;01;Keskiviikko;0;0;0;0;0;0
96;15.01.2014;2014;01;02;Keskiviikko;0;0;0;0;0;0
96;15.01.2014;2014;01;03;Keskiviikko;0;0;0;0;0;0
96;15.01.2014;2014;01;04;Keskiviikko;1;0;1;0;1;1
96;15.01.2014;2014;01;05;Keskiviikko;0;5;5;1;0;1
96;15.01.2014;2014;01;06;Keskiviikko;23;11;34;9;2;11
96;15.01.2014;2014;01;07;Keskiviikko;66;50;116;31;7;38
96;15.01.2014;2014;01;08;Keskiviikko;70;54;124;16;9;25
96;15.01.2014;2014;01;09;Keskiviikko;26;30;56;14;11;25
96;15.01.2014;2014;01;10;Keskiviikko;28;37;65;9;14;23
96;15.01.2014;2014;01;11;Keskiviikko;18;22;40;6;9;15
96;15.01.2014;2014;01;12;Keskiviikko;32;27;59;13;16;29
96;15.01.2014;2014;01;13;Keskiviikko;23;43;66;13;11;24
96;15.01.2014;2014;01;14;Keskiviikko;22;67;89;11;33;44
96;15.01.2014;2014;01;15;Keskiviikko;41;101;142;12;45;57
96;15.01.2014;2014;01;16;Keskiviikko;64;67;131;14;47;61
96;15.01.2014;2014;01;17;Keskiviikko;26;43;69;12;14;26
96;15.01.2014;2014;01;18;Keskiviikko;35;27;62;10;16;26
96;15.01.2014;2014;01;19;Keskiviikko;36;19;55;13;8;21
96;15.01.2014;2014;01;20;Keskiviikko;28;24;52;8;5;13
96;15.01.2014;2014;01;21;Keskiviikko;11;18;29;6;14;20
96;15.01.2014;2014;01;22;Keskiviikko;5;2;7;3;2;5
96;15.01.2014;2014;01;23;Keskiviikko;6;3;9;0;1;1
96;16.01.2014;2014;01;00;Torstai;1;6;7;0;0;0
96;16.01.2014;2014;01;01;Torstai;3;0;3;0;0;0
96;16.01.2014;2014;01;02;Torstai;1;0;1;2;0;2
96;16.01.2014;2014;01;03;Torstai;9;0;9;1;0;1
96;16.01.2014;2014;01;04;Torstai;1;0;1;0;1;1
96;16.01.2014;2014;01;05;Torstai;0;5;5;0;1;1
96;16.01.2014;2014;01;06;Torstai;21;11;32;12;2;14
96;16.01.2014;2014;01;07;Torstai;58;47;105;40;14;54
96;16.01.2014;2014;01;08;Torstai;71;46;117;19;3;22
96;16.01.2014;2014;01;09;Torstai;29;35;64;5;12;17
96;16.01.2014;2014;01;10;Torstai;24;16;40;10;10;20
96;16.01.2014;2014;01;11;Torstai;20;18;38;9;9;18
96;16.01.2014;2014;01;12;Torstai;31;33;64;17;13;30
96;16.01.2014;2014;01;13;Torstai;18;27;45;7;15;22
96;16.01.2014;2014;01;14;Torstai;27;55;82;12;28;40
96;16.01.2014;2014;01;15;Torstai;35;100;135;12;53;65
96;16.01.2014;2014;01;16;Torstai;45;80;125;14;36;50
96;16.01.2014;2014;01;17;Torstai;37;47;84;13;19;32
96;16.01.2014;2014;01;18;Torstai;29;26;55;13;22;35
96;16.01.2014;2014;01;19;Torstai;32;21;53;5;13;18
96;16.01.2014;2014;01;20;Torstai;26;19;45;17;12;29
96;16.01.2014;2014;01;21;Torstai;16;13;29;6;9;15
96;16.01.2014;2014;01;22;Torstai;4;12;16;1;2;3
96;16.01.2014;2014;01;23;Torstai;2;1;3;2;1;3
96;17.01.2014;2014;01;00;Perjantai;1;0;1;1;1;2
96;17.01.2014;2014;01;01;Perjantai;1;0;1;3;0;3
96;17.01.2014;2014;01;02;Perjantai;4;0;4;0;0;0
96;17.01.2014;2014;01;03;Perjantai;1;0;1;0;2;2
96;17.01.2014;2014;01;04;Perjantai;2;3;5;3;0;3
96;17.01.2014;2014;01;05;Perjantai;0;4;4;0;1;1
96;17.01.2014;2014;01;06;Perjantai;26;11;37;11;3;14
96;17.01.2014;2014;01;07;Perjantai;54;47;101;31;10;41
96;17.01.2014;2014;01;08;Perjantai;57;52;109;10;7;17
96;17.01.2014;2014;01;09;Perjantai;31;23;54;11;12;23
96;17.01.2014;2014;01;10;Perjantai;20;28;48;10;6;16
96;17.01.2014;2014;01;11;Perjantai;26;30;56;10;11;21
96;17.01.2014;2014;01;12;Perjantai;35;28;63;3;14;17
96;17.01.2014;2014;01;13;Perjantai;28;56;84;5;18;23
96;17.01.2014;2014;01;14;Perjantai;31;70;101;5;32;37
96;17.01.2014;2014;01;15;Perjantai;37;99;136;6;49;55
96;17.01.2014;2014;01;16;Perjantai;34;60;94;8;13;21
96;17.01.2014;2014;01;17;Perjantai;21;31;52;7;16;23
96;17.01.2014;2014;01;18;Perjantai;26;15;41;10;5;15
96;17.01.2014;2014;01;19;Perjantai;24;10;34;5;6;11
96;17.01.2014;2014;01;20;Perjantai;18;10;28;7;4;11
96;17.01.2014;2014;01;21;Perjantai;10;7;17;0;6;6
96;17.01.2014;2014;01;22;Perjantai;5;11;16;2;2;4
96;17.01.2014;2014;01;23;Perjantai;8;1;9;2;1;3
96;18.01.2014;2014;01;00;Lauantai;2;5;7;0;0;0
96;18.01.2014;2014;01;01;Lauantai;7;2;9;1;1;2
96;18.01.2014;2014;01;02;Lauantai;1;0;1;2;1;3
96;18.01.2014;2014;01;03;Lauantai;2;0;2;1;0;1
96;18.01.2014;2014;01;04;Lauantai;0;0;0;1;0;1
96;18.01.2014;2014;01;05;Lauantai;0;0;0;1;0;1
96;18.01.2014;2014;01;06;Lauantai;10;4;14;4;2;6
96;18.01.2014;2014;01;07;Lauantai;4;10;14;3;7;10
96;18.01.2014;2014;01;08;Lauantai;2;10;12;1;2;3
96;18.01.2014;2014;01;09;Lauantai;5;19;24;1;7;8
96;18.01.2014;2014;01;10;Lauantai;4;15;19;8;16;24
96;18.01.2014;2014;01;11;Lauantai;9;19;28;6;14;20
96;18.01.2014;2014;01;12;Lauantai;19;12;31;11;8;19
96;18.01.2014;2014;01;13;Lauantai;12;17;29;9;10;19
96;18.01.2014;2014;01;14;Lauantai;19;26;45;5;15;20
96;18.01.2014;2014;01;15;Lauantai;16;25;41;14;16;30
96;18.01.2014;2014;01;16;Lauantai;15;23;38;15;24;39
96;18.01.2014;2014;01;17;Lauantai;11;7;18;12;2;14
96;18.01.2014;2014;01;18;Lauantai;13;10;23;9;6;15
96;18.01.2014;2014;01;19;Lauantai;22;6;28;18;3;21
96;18.01.2014;2014;01;20;Lauantai;11;4;15;2;3;5
96;18.01.2014;2014;01;21;Lauantai;8;14;22;0;5;5
96;18.01.2014;2014;01;22;Lauantai;7;2;9;0;3;3
96;18.01.2014;2014;01;23;Lauantai;3;14;17;0;2;2
96;19.01.2014;2014;01;00;Sunnuntai;4;1;5;1;0;1
96;19.01.2014;2014;01;01;Sunnuntai;3;0;3;1;0;1
96;19.01.2014;2014;01;02;Sunnuntai;1;0;1;1;0;1
96;19.01.2014;2014;01;03;Sunnuntai;2;1;3;2;0;2
96;19.01.2014;2014;01;04;Sunnuntai;2;0;2;2;0;2
96;19.01.2014;2014;01;05;Sunnuntai;0;0;0;0;1;1
96;19.01.2014;2014;01;06;Sunnuntai;6;3;9;4;2;6
96;19.01.2014;2014;01;07;Sunnuntai;1;5;6;2;5;7
96;19.01.2014;2014;01;08;Sunnuntai;1;6;7;0;2;2
96;19.01.2014;2014;01;09;Sunnuntai;4;3;7;1;3;4
96;19.01.2014;2014;01;10;Sunnuntai;3;8;11;1;3;4
96;19.01.2014;2014;01;11;Sunnuntai;9;13;22;8;9;17
96;19.01.2014;2014;01;12;Sunnuntai;10;7;17;8;9;17
96;19.01.2014;2014;01;13;Sunnuntai;19;22;41;15;8;23
96;19.01.2014;2014;01;14;Sunnuntai;6;19;25;4;11;15
96;19.01.2014;2014;01;15;Sunnuntai;17;18;35;7;9;16
96;19.01.2014;2014;01;16;Sunnuntai;16;9;25;15;7;22
96;19.01.2014;2014;01;17;Sunnuntai;13;8;21;11;6;17
96;19.01.2014;2014;01;18;Sunnuntai;21;17;38;16;15;31
96;19.01.2014;2014;01;19;Sunnuntai;11;11;22;8;16;24
96;19.01.2014;2014;01;20;Sunnuntai;18;8;26;7;6;13
96;19.01.2014;2014;01;21;Sunnuntai;6;14;20;2;2;4
96;19.01.2014;2014;01;22;Sunnuntai;5;2;7;3;3;6
96;19.01.2014;2014;01;23;Sunnuntai;2;0;2;0;1;1
96;20.01.2014;2014;01;00;Maanantai;1;1;2;1;0;1
96;20.01.2014;2014;01;01;Maanantai;0;2;2;1;0;1
96;20.01.2014;2014;01;02;Maanantai;0;0;0;0;0;0
96;20.01.2014;2014;01;03;Maanantai;1;0;1;0;0;0
96;20.01.2014;2014;01;04;Maanantai;1;1;2;0;0;0
96;20.01.2014;2014;01;05;Maanantai;1;9;10;1;0;1
96;20.01.2014;2014;01;06;Maanantai;27;10;37;6;5;11
96;20.01.2014;2014;01;07;Maanantai;68;42;110;30;16;46
96;20.01.2014;2014;01;08;Maanantai;100;65;165;24;7;31
96;20.01.2014;2014;01;09;Maanantai;27;39;66;14;4;18
96;20.01.2014;2014;01;10;Maanantai;30;17;47;7;12;19
96;20.01.2014;2014;01;11;Maanantai;19;27;46;8;15;23
96;20.01.2014;2014;01;12;Maanantai;31;29;60;11;13;24
96;20.01.2014;2014;01;13;Maanantai;30;26;56;14;16;30
96;20.01.2014;2014;01;14;Maanantai;27;74;101;7;28;35
96;20.01.2014;2014;01;15;Maanantai;38;130;168;13;45;58
96;20.01.2014;2014;01;16;Maanantai;57;84;141;13;50;63
96;20.01.2014;2014;01;17;Maanantai;47;47;94;9;16;25
96;20.01.2014;2014;01;18;Maanantai;38;31;69;23;24;47
96;20.01.2014;2014;01;19;Maanantai;25;25;50;14;28;42
96;20.01.2014;2014;01;20;Maanantai;31;26;57;14;13;27
96;20.01.2014;2014;01;21;Maanantai;23;20;43;9;7;16
96;20.01.2014;2014;01;22;Maanantai;12;7;19;4;4;8
96;20.01.2014;2014;01;23;Maanantai;4;1;5;0;0;0
96;21.01.2014;2014;01;00;Tiistai;0;0;0;1;0;1
96;21.01.2014;2014;01;01;Tiistai;2;0;2;0;0;0
96;21.01.2014;2014;01;02;Tiistai;0;0;0;1;0;1
96;21.01.2014;2014;01;03;Tiistai;0;0;0;0;1;1
96;21.01.2014;2014;01;04;Tiistai;1;2;3;1;0;1
96;21.01.2014;2014;01;05;Tiistai;2;6;8;2;0;2
96;21.01.2014;2014;01;06;Tiistai;33;16;49;9;3;12
96;21.01.2014;2014;01;07;Tiistai;84;74;158;19;8;27
96;21.01.2014;2014;01;08;Tiistai;99;83;182;29;13;42
96;21.01.2014;2014;01;09;Tiistai;33;40;73;19;8;27
96;21.01.2014;2014;01;10;Tiistai;30;28;58;17;9;26
96;21.01.2014;2014;01;11;Tiistai;28;27;55;11;17;28
96;21.01.2014;2014;01;12;Tiistai;36;42;78;16;12;28
96;21.01.2014;2014;01;13;Tiistai;28;26;54;10;15;25
96;21.01.2014;2014;01;14;Tiistai;30;62;92;9;22;31
96;21.01.2014;2014;01;15;Tiistai;53;122;175;13;35;48
96;21.01.2014;2014;01;16;Tiistai;58;116;174;22;47;69
96;21.01.2014;2014;01;17;Tiistai;37;45;82;11;26;37
96;21.01.2014;2014;01;18;Tiistai;34;39;73;14;29;43
96;21.01.2014;2014;01;19;Tiistai;29;27;56;22;12;34
96;21.01.2014;2014;01;20;Tiistai;45;25;70;13;8;21
96;21.01.2014;2014;01;21;Tiistai;25;14;39;5;7;12
96;21.01.2014;2014;01;22;Tiistai;8;6;14;2;1;3
96;21.01.2014;2014;01;23;Tiistai;6;3;9;0;1;1
96;22.01.2014;2014;01;00;Keskiviikko;1;0;1;0;1;1
96;22.01.2014;2014;01;01;Keskiviikko;0;0;0;0;0;0
96;22.01.2014;2014;01;02;Keskiviikko;1;0;1;0;0;0
96;22.01.2014;2014;01;03;Keskiviikko;0;0;0;0;0;0
96;22.01.2014;2014;01;04;Keskiviikko;1;1;2;0;0;0
96;22.01.2014;2014;01;05;Keskiviikko;1;7;8;0;2;2
96;22.01.2014;2014;01;06;Keskiviikko;33;22;55;9;1;10
96;22.01.2014;2014;01;07;Keskiviikko;79;65;144;36;12;48
96;22.01.2014;2014;01;08;Keskiviikko;97;65;162;26;14;40
96;22.01.2014;2014;01;09;Keskiviikko;23;26;49;12;11;23
96;22.01.2014;2014;01;10;Keskiviikko;35;33;68;10;6;16
96;22.01.2014;2014;01;11;Keskiviikko;39;16;55;11;14;25
96;22.01.2014;2014;01;12;Keskiviikko;48;25;73;20;11;31
96;22.01.2014;2014;01;13;Keskiviikko;22;43;65;12;21;33
96;22.01.2014;2014;01;14;Keskiviikko;32;55;87;11;23;34
96;22.01.2014;2014;01;15;Keskiviikko;40;121;161;10;40;50
96;22.01.2014;2014;01;16;Keskiviikko;54;93;147;9;45;54
96;22.01.2014;2014;01;17;Keskiviikko;53;51;104;7;20;27
96;22.01.2014;2014;01;18;Keskiviikko;48;27;75;25;14;39
96;22.01.2014;2014;01;19;Keskiviikko;35;22;57;10;14;24
96;22.01.2014;2014;01;20;Keskiviikko;32;16;48;5;13;18
96;22.01.2014;2014;01;21;Keskiviikko;26;23;49;9;14;23
96;22.01.2014;2014;01;22;Keskiviikko;5;9;14;5;1;6
96;22.01.2014;2014;01;23;Keskiviikko;3;2;5;1;2;3
96;23.01.2014;2014;01;00;Torstai;2;2;4;0;0;0
96;23.01.2014;2014;01;01;Torstai;0;0;0;0;0;0
96;23.01.2014;2014;01;02;Torstai;3;1;4;0;0;0
96;23.01.2014;2014;01;03;Torstai;0;0;0;1;0;1
96;23.01.2014;2014;01;04;Torstai;2;2;4;0;2;2
96;23.01.2014;2014;01;05;Torstai;3;10;13;1;0;1
96;23.01.2014;2014;01;06;Torstai;25;16;41;9;2;11
96;23.01.2014;2014;01;07;Torstai;78;55;133;22;14;36
96;23.01.2014;2014;01;08;Torstai;70;64;134;23;4;27
96;23.01.2014;2014;01;09;Torstai;41;41;82;10;9;19
96;23.01.2014;2014;01;10;Torstai;46;24;70;11;7;18
96;23.01.2014;2014;01;11;Torstai;23;35;58;9;9;18
96;23.01.2014;2014;01;12;Torstai;35;34;69;10;16;26
96;23.01.2014;2014;01;13;Torstai;29;39;68;10;6;16
96;23.01.2014;2014;01;14;Torstai;32;64;96;6;19;25
96;23.01.2014;2014;01;15;Torstai;43;121;164;12;43;55
96;23.01.2014;2014;01;16;Torstai;46;85;131;20;36;56
96;23.01.2014;2014;01;17;Torstai;42;44;86;14;15;29
96;23.01.2014;2014;01;18;Torstai;34;28;62;9;13;22
96;23.01.2014;2014;01;19;Torstai;32;17;49;8;12;20
96;23.01.2014;2014;01;20;Torstai;24;20;44;17;5;22
96;23.01.2014;2014;01;21;Torstai;24;19;43;5;12;17
96;23.01.2014;2014;01;22;Torstai;9;4;13;4;0;4
96;23.01.2014;2014;01;23;Torstai;1;0;1;1;0;1
96;24.01.2014;2014;01;00;Perjantai;2;1;3;1;0;1
96;24.01.2014;2014;01;01;Perjantai;0;1;1;0;0;0
96;24.01.2014;2014;01;02;Perjantai;0;0;0;1;0;1
96;24.01.2014;2014;01;03;Perjantai;1;0;1;0;0;0
96;24.01.2014;2014;01;04;Perjantai;2;4;6;0;0;0
96;24.01.2014;2014;01;05;Perjantai;1;6;7;0;1;1
96;24.01.2014;2014;01;06;Perjantai;33;19;52;10;4;14
96;24.01.2014;2014;01;07;Perjantai;62;57;119;18;13;31
96;24.01.2014;2014;01;08;Perjantai;55;62;117;18;12;30
96;24.01.2014;2014;01;09;Perjantai;30;46;76;5;7;12
96;24.01.2014;2014;01;10;Perjantai;37;27;64;11;10;21
96;24.01.2014;2014;01;11;Perjantai;31;46;77;15;17;32
96;24.01.2014;2014;01;12;Perjantai;34;43;77;13;16;29
96;24.01.2014;2014;01;13;Perjantai;39;60;99;9;9;18
96;24.01.2014;2014;01;14;Perjantai;45;82;127;9;33;42
96;24.01.2014;2014;01;15;Perjantai;58;97;155;13;41;54
96;24.01.2014;2014;01;16;Perjantai;49;65;114;9;26;35
96;24.01.2014;2014;01;17;Perjantai;40;44;84;11;13;24
96;24.01.2014;2014;01;18;Perjantai;21;31;52;10;21;31
96;24.01.2014;2014;01;19;Perjantai;22;16;38;7;7;14
96;24.01.2014;2014;01;20;Perjantai;19;11;30;12;3;15
96;24.01.2014;2014;01;21;Perjantai;27;28;55;17;3;20
96;24.01.2014;2014;01;22;Perjantai;9;5;14;3;0;3
96;24.01.2014;2014;01;23;Perjantai;9;4;13;4;2;6
96;25.01.2014;2014;01;00;Lauantai;4;5;9;2;3;5
96;25.01.2014;2014;01;01;Lauantai;8;0;8;2;0;2
96;25.01.2014;2014;01;02;Lauantai;2;1;3;0;0;0
96;25.01.2014;2014;01;03;Lauantai;3;0;3;1;0;1
96;25.01.2014;2014;01;04;Lauantai;3;0;3;3;1;4
96;25.01.2014;2014;01;05;Lauantai;1;3;4;1;0;1
96;25.01.2014;2014;01;06;Lauantai;10;8;18;3;1;4
96;25.01.2014;2014;01;07;Lauantai;10;10;20;4;10;14
96;25.01.2014;2014;01;08;Lauantai;4;13;17;6;7;13
96;25.01.2014;2014;01;09;Lauantai;7;22;29;4;7;11
96;25.01.2014;2014;01;10;Lauantai;10;15;25;13;14;27
96;25.01.2014;2014;01;11;Lauantai;20;20;40;7;17;24
96;25.01.2014;2014;01;12;Lauantai;9;22;31;13;11;24
96;25.01.2014;2014;01;13;Lauantai;19;21;40;12;20;32
96;25.01.2014;2014;01;14;Lauantai;30;32;62;11;8;19
96;25.01.2014;2014;01;15;Lauantai;13;32;45;17;13;30
96;25.01.2014;2014;01;16;Lauantai;30;26;56;18;21;39
96;25.01.2014;2014;01;17;Lauantai;30;15;45;28;10;38
96;25.01.2014;2014;01;18;Lauantai;23;9;32;18;22;40
96;25.01.2014;2014;01;19;Lauantai;16;16;32;11;7;18
96;25.01.2014;2014;01;20;Lauantai;13;8;21;7;2;9
96;25.01.2014;2014;01;21;Lauantai;8;15;23;5;14;19
96;25.01.2014;2014;01;22;Lauantai;3;10;13;1;9;10
96;25.01.2014;2014;01;23;Lauantai;5;6;11;3;0;3
96;26.01.2014;2014;01;00;Sunnuntai;3;4;7;0;0;0
96;26.01.2014;2014;01;01;Sunnuntai;5;2;7;4;1;5
96;26.01.2014;2014;01;02;Sunnuntai;5;3;8;1;2;3
96;26.01.2014;2014;01;03;Sunnuntai;8;0;8;0;0;0
96;26.01.2014;2014;01;04;Sunnuntai;5;0;5;0;0;0
96;26.01.2014;2014;01;05;Sunnuntai;1;0;1;1;0;1
96;26.01.2014;2014;01;06;Sunnuntai;10;4;14;2;3;5
96;26.01.2014;2014;01;07;Sunnuntai;0;4;4;1;5;6
96;26.01.2014;2014;01;08;Sunnuntai;6;8;14;0;6;6
96;26.01.2014;2014;01;09;Sunnuntai;2;9;11;9;7;16
96;26.01.2014;2014;01;10;Sunnuntai;6;9;15;9;10;19
96;26.01.2014;2014;01;11;Sunnuntai;10;27;37;18;19;37
96;26.01.2014;2014;01;12;Sunnuntai;17;14;31;20;22;42
96;26.01.2014;2014;01;13;Sunnuntai;25;20;45;19;17;36
96;26.01.2014;2014;01;14;Sunnuntai;19;23;42;15;19;34
96;26.01.2014;2014;01;15;Sunnuntai;25;31;56;11;16;27
96;26.01.2014;2014;01;16;Sunnuntai;30;18;48;19;13;32
96;26.01.2014;2014;01;17;Sunnuntai;24;15;39;18;10;28
96;26.01.2014;2014;01;18;Sunnuntai;21;23;44;20;20;40
96;26.01.2014;2014;01;19;Sunnuntai;14;19;33;12;18;30
96;26.01.2014;2014;01;20;Sunnuntai;15;22;37;7;16;23
96;26.01.2014;2014;01;21;Sunnuntai;8;8;16;3;6;9
96;26.01.2014;2014;01;22;Sunnuntai;6;4;10;3;5;8
96;26.01.2014;2014;01;23;Sunnuntai;5;2;7;1;0;1
96;27.01.2014;2014;01;00;Maanantai;2;1;3;1;0;1
96;27.01.2014;2014;01;01;Maanantai;2;0;2;0;0;0
96;27.01.2014;2014;01;02;Maanantai;1;0;1;1;0;1
96;27.01.2014;2014;01;03;Maanantai;1;0;1;0;0;0
96;27.01.2014;2014;01;04;Maanantai;1;2;3;0;0;0
96;27.01.2014;2014;01;05;Maanantai;0;8;8;0;0;0
96;27.01.2014;2014;01;06;Maanantai;29;19;48;9;6;15
96;27.01.2014;2014;01;07;Maanantai;58;70;128;34;12;46
96;27.01.2014;2014;01;08;Maanantai;93;72;165;30;15;45
96;27.01.2014;2014;01;09;Maanantai;56;57;113;9;13;22
96;27.01.2014;2014;01;10;Maanantai;37;45;82;9;13;22
96;27.01.2014;2014;01;11;Maanantai;35;31;66;8;9;17
96;27.01.2014;2014;01;12;Maanantai;40;53;93;9;26;35
96;27.01.2014;2014;01;13;Maanantai;35;35;70;13;18;31
96;27.01.2014;2014;01;14;Maanantai;32;84;116;13;29;42
96;27.01.2014;2014;01;15;Maanantai;40;117;157;18;44;62
96;27.01.2014;2014;01;16;Maanantai;76;107;183;24;32;56
96;27.01.2014;2014;01;17;Maanantai;37;57;94;19;15;34
96;27.01.2014;2014;01;18;Maanantai;36;25;61;21;21;42
96;27.01.2014;2014;01;19;Maanantai;24;23;47;14;11;25
96;27.01.2014;2014;01;20;Maanantai;30;25;55;15;9;24
96;27.01.2014;2014;01;21;Maanantai;16;15;31;9;11;20
96;27.01.2014;2014;01;22;Maanantai;12;2;14;3;1;4
96;27.01.2014;2014;01;23;Maanantai;0;0;0;2;1;3
96;28.01.2014;2014;01;00;Tiistai;1;0;1;0;0;0
96;28.01.2014;2014;01;01;Tiistai;0;0;0;0;0;0
96;28.01.2014;2014;01;02;Tiistai;1;0;1;0;0;0
96;28.01.2014;2014;01;03;Tiistai;1;0;1;0;0;0
96;28.01.2014;2014;01;04;Tiistai;1;1;2;0;1;1
96;28.01.2014;2014;01;05;Tiistai;3;6;9;0;0;0
96;28.01.2014;2014;01;06;Tiistai;31;14;45;8;4;12
96;28.01.2014;2014;01;07;Tiistai;76;71;147;37;11;48
96;28.01.2014;2014;01;08;Tiistai;74;81;155;36;12;48
96;28.01.2014;2014;01;09;Tiistai;46;54;100;13;10;23
96;28.01.2014;2014;01;10;Tiistai;41;30;71;11;13;24
96;28.01.2014;2014;01;11;Tiistai;40;33;73;11;14;25
96;28.01.2014;2014;01;12;Tiistai;37;55;92;11;28;39
96;28.01.2014;2014;01;13;Tiistai;30;34;64;14;15;29
96;28.01.2014;2014;01;14;Tiistai;29;66;95;11;23;34
96;28.01.2014;2014;01;15;Tiistai;46;156;202;15;41;56
96;28.01.2014;2014;01;16;Tiistai;62;126;188;24;43;67
96;28.01.2014;2014;01;17;Tiistai;43;60;103;18;22;40
96;28.01.2014;2014;01;18;Tiistai;32;38;70;13;33;46
96;28.01.2014;2014;01;19;Tiistai;28;28;56;13;15;28
96;28.01.2014;2014;01;20;Tiistai;30;15;45;17;9;26
96;28.01.2014;2014;01;21;Tiistai;46;24;70;20;3;23
96;28.01.2014;2014;01;22;Tiistai;8;3;11;1;1;2
96;28.01.2014;2014;01;23;Tiistai;6;2;8;0;1;1
96;29.01.2014;2014;01;00;Keskiviikko;2;1;3;0;0;0
96;29.01.2014;2014;01;01;Keskiviikko;2;1;3;0;0;0
96;29.01.2014;2014;01;02;Keskiviikko;0;0;0;0;0;0
96;29.01.2014;2014;01;03;Keskiviikko;2;1;3;0;0;0
96;29.01.2014;2014;01;04;Keskiviikko;2;3;5;1;1;2
96;29.01.2014;2014;01;05;Keskiviikko;3;7;10;2;1;3
96;29.01.2014;2014;01;06;Keskiviikko;32;12;44;14;1;15
96;29.01.2014;2014;01;07;Keskiviikko;71;61;132;32;10;42
96;29.01.2014;2014;01;08;Keskiviikko;80;59;139;27;12;39
96;29.01.2014;2014;01;09;Keskiviikko;24;26;50;12;10;22
96;29.01.2014;2014;01;10;Keskiviikko;25;25;50;10;11;21
96;29.01.2014;2014;01;11;Keskiviikko;33;24;57;11;13;24
96;29.01.2014;2014;01;12;Keskiviikko;36;37;73;13;15;28
96;29.01.2014;2014;01;13;Keskiviikko;29;37;66;14;15;29
96;29.01.2014;2014;01;14;Keskiviikko;26;55;81;16;33;49
96;29.01.2014;2014;01;15;Keskiviikko;43;131;174;12;44;56
96;29.01.2014;2014;01;16;Keskiviikko;49;78;127;19;39;58
96;29.01.2014;2014;01;17;Keskiviikko;39;54;93;10;15;25
96;29.01.2014;2014;01;18;Keskiviikko;41;26;67;23;24;47
96;29.01.2014;2014;01;19;Keskiviikko;31;30;61;16;14;30
96;29.01.2014;2014;01;20;Keskiviikko;23;22;45;7;7;14
96;29.01.2014;2014;01;21;Keskiviikko;23;24;47;6;16;22
96;29.01.2014;2014;01;22;Keskiviikko;12;2;14;1;1;2
96;29.01.2014;2014;01;23;Keskiviikko;3;1;4;1;2;3
96;30.01.2014;2014;01;00;Torstai;0;1;1;0;0;0
96;30.01.2014;2014;01;01;Torstai;0;0;0;1;0;1
96;30.01.2014;2014;01;02;Torstai;1;0;1;0;0;0
96;30.01.2014;2014;01;03;Torstai;1;0;1;0;0;0
96;30.01.2014;2014;01;04;Torstai;1;1;2;1;0;1
96;30.01.2014;2014;01;05;Torstai;1;8;9;0;1;1
96;30.01.2014;2014;01;06;Torstai;21;15;36;13;2;15
96;30.01.2014;2014;01;07;Torstai;51;45;96;29;9;38
96;30.01.2014;2014;01;08;Torstai;91;52;143;21;8;29
96;30.01.2014;2014;01;09;Torstai;34;33;67;3;12;15
96;30.01.2014;2014;01;10;Torstai;24;24;48;6;7;13
96;30.01.2014;2014;01;11;Torstai;24;27;51;10;5;15
96;30.01.2014;2014;01;12;Torstai;32;37;69;9;16;25
96;30.01.2014;2014;01;13;Torstai;38;29;67;12;21;33
96;30.01.2014;2014;01;14;Torstai;28;45;73;16;17;33
96;30.01.2014;2014;01;15;Torstai;40;113;153;16;39;55
96;30.01.2014;2014;01;16;Torstai;39;77;116;11;36;47
96;30.01.2014;2014;01;17;Torstai;33;51;84;9;16;25
96;30.01.2014;2014;01;18;Torstai;20;36;56;4;8;12
96;30.01.2014;2014;01;19;Torstai;29;11;40;7;9;16
96;30.01.2014;2014;01;20;Torstai;20;16;36;4;3;7
96;30.01.2014;2014;01;21;Torstai;12;14;26;4;10;14
96;30.01.2014;2014;01;22;Torstai;4;6;10;6;4;10
96;30.01.2014;2014;01;23;Torstai;1;1;2;0;0;0
96;31.01.2014;2014;01;00;Perjantai;2;0;2;0;1;1
96;31.01.2014;2014;01;01;Perjantai;3;0;3;0;0;0
96;31.01.2014;2014;01;02;Perjantai;0;0;0;0;0;0
96;31.01.2014;2014;01;03;Perjantai;1;0;1;0;0;0
96;31.01.2014;2014;01;04;Perjantai;1;2;3;2;0;2
96;31.01.2014;2014;01;05;Perjantai;0;3;3;0;1;1
96;31.01.2014;2014;01;06;Perjantai;17;15;32;9;4;13
96;31.01.2014;2014;01;07;Perjantai;54;45;99;20;9;29
96;31.01.2014;2014;01;08;Perjantai;59;40;99;18;10;28
96;31.01.2014;2014;01;09;Perjantai;30;29;59;5;11;16
96;31.01.2014;2014;01;10;Perjantai;16;16;32;11;13;24
96;31.01.2014;2014;01;11;Perjantai;17;22;39;15;10;25
96;31.01.2014;2014;01;12;Perjantai;26;31;57;10;7;17
96;31.01.2014;2014;01;13;Perjantai;30;60;90;5;17;22
96;31.01.2014;2014;01;14;Perjantai;19;57;76;6;23;29
96;31.01.2014;2014;01;15;Perjantai;29;97;126;11;36;47
96;31.01.2014;2014;01;16;Perjantai;30;50;80;12;21;33
96;31.01.2014;2014;01;17;Perjantai;26;18;44;3;8;11
96;31.01.2014;2014;01;18;Perjantai;18;12;30;13;2;15
96;31.01.2014;2014;01;19;Perjantai;20;17;37;6;5;11
96;31.01.2014;2014;01;20;Perjantai;11;11;22;1;6;7
96;31.01.2014;2014;01;21;Perjantai;8;13;21;5;9;14
96;31.01.2014;2014;01;22;Perjantai;6;8;14;2;4;6
96;31.01.2014;2014;01;23;Perjantai;4;3;7;4;1;5
96;01.02.2014;2014;02;00;Lauantai;4;3;7;0;0;0
96;01.02.2014;2014;02;01;Lauantai;4;0;4;1;0;1
96;01.02.2014;2014;02;02;Lauantai;3;0;3;0;0;0
96;01.02.2014;2014;02;03;Lauantai;2;0;2;1;0;1
96;01.02.2014;2014;02;04;Lauantai;4;0;4;5;0;5
96;01.02.2014;2014;02;05;Lauantai;0;1;1;0;0;0
96;01.02.2014;2014;02;06;Lauantai;15;4;19;3;2;5
96;01.02.2014;2014;02;07;Lauantai;4;16;20;3;3;6
96;01.02.2014;2014;02;08;Lauantai;7;10;17;3;4;7
96;01.02.2014;2014;02;09;Lauantai;5;24;29;1;7;8
96;01.02.2014;2014;02;10;Lauantai;8;22;30;6;6;12
96;01.02.2014;2014;02;11;Lauantai;6;12;18;5;11;16
96;01.02.2014;2014;02;12;Lauantai;8;16;24;10;10;20
96;01.02.2014;2014;02;13;Lauantai;20;16;36;8;11;19
96;01.02.2014;2014;02;14;Lauantai;21;13;34;8;12;20
96;01.02.2014;2014;02;15;Lauantai;18;29;47;20;17;37
96;01.02.2014;2014;02;16;Lauantai;18;33;51;6;16;22
96;01.02.2014;2014;02;17;Lauantai;19;8;27;11;12;23
96;01.02.2014;2014;02;18;Lauantai;23;10;33;24;15;39
96;01.02.2014;2014;02;19;Lauantai;24;11;35;28;28;56
96;01.02.2014;2014;02;20;Lauantai;11;11;22;5;7;12
96;01.02.2014;2014;02;21;Lauantai;5;11;16;3;8;11
96;01.02.2014;2014;02;22;Lauantai;12;11;23;23;1;24
96;01.02.2014;2014;02;23;Lauantai;6;4;10;13;1;14
96;02.02.2014;2014;02;00;Sunnuntai;6;3;9;1;0;1
96;02.02.2014;2014;02;01;Sunnuntai;6;4;10;4;2;6
96;02.02.2014;2014;02;02;Sunnuntai;4;1;5;1;0;1
96;02.02.2014;2014;02;03;Sunnuntai;2;1;3;2;1;3
96;02.02.2014;2014;02;04;Sunnuntai;4;0;4;2;1;3
96;02.02.2014;2014;02;05;Sunnuntai;0;0;0;0;1;1
96;02.02.2014;2014;02;06;Sunnuntai;7;2;9;2;0;2
96;02.02.2014;2014;02;07;Sunnuntai;1;9;10;2;1;3
96;02.02.2014;2014;02;08;Sunnuntai;2;4;6;0;2;2
96;02.02.2014;2014;02;09;Sunnuntai;5;6;11;7;4;11
96;02.02.2014;2014;02;10;Sunnuntai;7;14;21;9;6;15
96;02.02.2014;2014;02;11;Sunnuntai;7;18;25;9;9;18
96;02.02.2014;2014;02;12;Sunnuntai;14;9;23;11;19;30
96;02.02.2014;2014;02;13;Sunnuntai;24;22;46;9;8;17
96;02.02.2014;2014;02;14;Sunnuntai;16;21;37;6;17;23
96;02.02.2014;2014;02;15;Sunnuntai;16;25;41;18;16;34
96;02.02.2014;2014;02;16;Sunnuntai;23;11;34;26;10;36
96;02.02.2014;2014;02;17;Sunnuntai;25;18;43;19;20;39
96;02.02.2014;2014;02;18;Sunnuntai;24;26;50;11;16;27
96;02.02.2014;2014;02;19;Sunnuntai;16;19;35;7;19;26
96;02.02.2014;2014;02;20;Sunnuntai;19;20;39;19;10;29
96;02.02.2014;2014;02;21;Sunnuntai;10;20;30;3;3;6
96;02.02.2014;2014;02;22;Sunnuntai;9;1;10;1;1;2
96;02.02.2014;2014;02;23;Sunnuntai;1;1;2;1;0;1
96;03.02.2014;2014;02;00;Maanantai;5;1;6;0;0;0
96;03.02.2014;2014;02;01;Maanantai;0;1;1;0;0;0
96;03.02.2014;2014;02;02;Maanantai;0;0;0;0;0;0
96;03.02.2014;2014;02;03;Maanantai;0;0;0;0;0;0
96;03.02.2014;2014;02;04;Maanantai;5;4;9;3;2;5
96;03.02.2014;2014;02;05;Maanantai;1;8;9;0;1;1
96;03.02.2014;2014;02;06;Maanantai;21;30;51;12;5;17
96;03.02.2014;2014;02;07;Maanantai;78;90;168;39;14;53
96;03.02.2014;2014;02;08;Maanantai;81;80;161;30;8;38
96;03.02.2014;2014;02;09;Maanantai;42;53;95;11;8;19
96;03.02.2014;2014;02;10;Maanantai;29;41;70;14;13;27
96;03.02.2014;2014;02;11;Maanantai;24;40;64;11;13;24
96;03.02.2014;2014;02;12;Maanantai;35;52;87;15;13;28
96;03.02.2014;2014;02;13;Maanantai;36;38;74;6;9;15
96;03.02.2014;2014;02;14;Maanantai;39;98;137;11;17;28
96;03.02.2014;2014;02;15;Maanantai;58;131;189;14;39;53
96;03.02.2014;2014;02;16;Maanantai;87;110;197;10;44;54
96;03.02.2014;2014;02;17;Maanantai;43;70;113;18;14;32
96;03.02.2014;2014;02;18;Maanantai;47;39;86;19;24;43
96;03.02.2014;2014;02;19;Maanantai;45;22;67;15;22;37
96;03.02.2014;2014;02;20;Maanantai;35;19;54;11;13;24
96;03.02.2014;2014;02;21;Maanantai;22;22;44;5;10;15
96;03.02.2014;2014;02;22;Maanantai;13;9;22;1;0;1
96;03.02.2014;2014;02;23;Maanantai;3;3;6;0;0;0
96;04.02.2014;2014;02;00;Tiistai;3;0;3;0;1;1
96;04.02.2014;2014;02;01;Tiistai;0;0;0;0;0;0
96;04.02.2014;2014;02;02;Tiistai;0;0;0;0;0;0
96;04.02.2014;2014;02;03;Tiistai;0;1;1;0;0;0
96;04.02.2014;2014;02;04;Tiistai;1;2;3;0;0;0
96;04.02.2014;2014;02;05;Tiistai;2;4;6;1;2;3
96;04.02.2014;2014;02;06;Tiistai;33;20;53;9;3;12
96;04.02.2014;2014;02;07;Tiistai;100;78;178;28;12;40
96;04.02.2014;2014;02;08;Tiistai;107;91;198;15;5;20
96;04.02.2014;2014;02;09;Tiistai;41;43;84;5;11;16
96;04.02.2014;2014;02;10;Tiistai;28;55;83;12;11;23
96;04.02.2014;2014;02;11;Tiistai;45;45;90;7;12;19
96;04.02.2014;2014;02;12;Tiistai;50;51;101;12;14;26
96;04.02.2014;2014;02;13;Tiistai;27;57;84;6;10;16
96;04.02.2014;2014;02;14;Tiistai;41;82;123;5;13;18
96;04.02.2014;2014;02;15;Tiistai;49;192;241;17;29;46
96;04.02.2014;2014;02;16;Tiistai;75;125;200;9;36;45
96;04.02.2014;2014;02;17;Tiistai;62;63;125;11;15;26
96;04.02.2014;2014;02;18;Tiistai;34;46;80;21;18;39
96;04.02.2014;2014;02;19;Tiistai;38;43;81;11;18;29
96;04.02.2014;2014;02;20;Tiistai;33;28;61;12;6;18
96;04.02.2014;2014;02;21;Tiistai;33;19;52;7;4;11
96;04.02.2014;2014;02;22;Tiistai;9;3;12;0;2;2
96;04.02.2014;2014;02;23;Tiistai;6;1;7;3;1;4
96;05.02.2014;2014;02;00;Keskiviikko;1;0;1;1;0;1
96;05.02.2014;2014;02;01;Keskiviikko;0;0;0;0;0;0
96;05.02.2014;2014;02;02;Keskiviikko;0;0;0;0;0;0
96;05.02.2014;2014;02;03;Keskiviikko;0;0;0;2;0;2
96;05.02.2014;2014;02;04;Keskiviikko;1;1;2;0;0;0
96;05.02.2014;2014;02;05;Keskiviikko;1;12;13;0;1;1
96;05.02.2014;2014;02;06;Keskiviikko;34;23;57;19;7;26
96;05.02.2014;2014;02;07;Keskiviikko;78;93;171;34;5;39
96;05.02.2014;2014;02;08;Keskiviikko;85;85;170;23;17;40
96;05.02.2014;2014;02;09;Keskiviikko;33;56;89;8;13;21
96;05.02.2014;2014;02;10;Keskiviikko;37;42;79;18;15;33
96;05.02.2014;2014;02;11;Keskiviikko;38;30;68;13;11;24
96;05.02.2014;2014;02;12;Keskiviikko;52;49;101;12;18;30
96;05.02.2014;2014;02;13;Keskiviikko;37;58;95;16;12;28
96;05.02.2014;2014;02;14;Keskiviikko;46;98;144;19;28;47
96;05.02.2014;2014;02;15;Keskiviikko;58;130;188;16;48;64
96;05.02.2014;2014;02;16;Keskiviikko;54;118;172;16;35;51
96;05.02.2014;2014;02;17;Keskiviikko;51;81;132;12;15;27
96;05.02.2014;2014;02;18;Keskiviikko;63;35;98;32;14;46
96;05.02.2014;2014;02;19;Keskiviikko;58;28;86;26;17;43
96;05.02.2014;2014;02;20;Keskiviikko;29;39;68;7;13;20
96;05.02.2014;2014;02;21;Keskiviikko;24;36;60;4;14;18
96;05.02.2014;2014;02;22;Keskiviikko;7;5;12;2;1;3
96;05.02.2014;2014;02;23;Keskiviikko;9;3;12;2;0;2
96;06.02.2014;2014;02;00;Torstai;3;7;10;0;0;0
96;06.02.2014;2014;02;01;Torstai;3;1;4;0;0;0
96;06.02.2014;2014;02;02;Torstai;6;3;9;1;0;1
96;06.02.2014;2014;02;03;Torstai;2;0;2;2;0;2
96;06.02.2014;2014;02;04;Torstai;2;1;3;0;1;1
96;06.02.2014;2014;02;05;Torstai;1;9;10;0;0;0
96;06.02.2014;2014;02;06;Torstai;31;24;55;10;3;13
96;06.02.2014;2014;02;07;Torstai;71;68;139;37;4;41
96;06.02.2014;2014;02;08;Torstai;83;81;164;31;10;41
96;06.02.2014;2014;02;09;Torstai;47;36;83;15;16;31
96;06.02.2014;2014;02;10;Torstai;32;29;61;11;9;20
96;06.02.2014;2014;02;11;Torstai;24;37;61;16;11;27
96;06.02.2014;2014;02;12;Torstai;29;49;78;12;15;27
96;06.02.2014;2014;02;13;Torstai;27;57;84;19;17;36
96;06.02.2014;2014;02;14;Torstai;32;75;107;21;16;37
96;06.02.2014;2014;02;15;Torstai;44;153;197;15;44;59
96;06.02.2014;2014;02;16;Torstai;53;124;177;27;42;69
96;06.02.2014;2014;02;17;Torstai;46;49;95;12;27;39
96;06.02.2014;2014;02;18;Torstai;29;45;74;18;20;38
96;06.02.2014;2014;02;19;Torstai;33;36;69;17;15;32
96;06.02.2014;2014;02;20;Torstai;33;20;53;11;16;27
96;06.02.2014;2014;02;21;Torstai;20;18;38;5;4;9
96;06.02.2014;2014;02;22;Torstai;11;15;26;4;3;7
96;06.02.2014;2014;02;23;Torstai;2;1;3;2;3;5
96;07.02.2014;2014;02;00;Perjantai;2;0;2;1;0;1
96;07.02.2014;2014;02;01;Perjantai;4;0;4;0;0;0
96;07.02.2014;2014;02;02;Perjantai;0;1;1;0;0;0
96;07.02.2014;2014;02;03;Perjantai;2;0;2;1;0;1
96;07.02.2014;2014;02;04;Perjantai;2;3;5;2;1;3
96;07.02.2014;2014;02;05;Perjantai;2;3;5;1;0;1
96;07.02.2014;2014;02;06;Perjantai;26;13;39;13;3;16
96;07.02.2014;2014;02;07;Perjantai;72;65;137;42;13;55
96;07.02.2014;2014;02;08;Perjantai;67;61;128;28;14;42
96;07.02.2014;2014;02;09;Perjantai;19;40;59;18;9;27
96;07.02.2014;2014;02;10;Perjantai;28;36;64;13;16;29
96;07.02.2014;2014;02;11;Perjantai;25;52;77;9;15;24
96;07.02.2014;2014;02;12;Perjantai;53;56;109;13;15;28
96;07.02.2014;2014;02;13;Perjantai;23;72;95;7;19;26
96;07.02.2014;2014;02;14;Perjantai;48;72;120;9;31;40
96;07.02.2014;2014;02;15;Perjantai;59;107;166;15;38;53
96;07.02.2014;2014;02;16;Perjantai;43;74;117;15;24;39
96;07.02.2014;2014;02;17;Perjantai;32;43;75;14;18;32
96;07.02.2014;2014;02;18;Perjantai;40;23;63;20;12;32
96;07.02.2014;2014;02;19;Perjantai;11;15;26;10;6;16
96;07.02.2014;2014;02;20;Perjantai;13;9;22;12;2;14
96;07.02.2014;2014;02;21;Perjantai;15;26;41;2;11;13
96;07.02.2014;2014;02;22;Perjantai;7;4;11;1;1;2
96;07.02.2014;2014;02;23;Perjantai;3;8;11;0;0;0
96;08.02.2014;2014;02;00;Lauantai;6;2;8;3;1;4
96;08.02.2014;2014;02;01;Lauantai;3;3;6;1;0;1
96;08.02.2014;2014;02;02;Lauantai;7;1;8;0;0;0
96;08.02.2014;2014;02;03;Lauantai;6;0;6;4;0;4
96;08.02.2014;2014;02;04;Lauantai;6;0;6;2;1;3
96;08.02.2014;2014;02;05;Lauantai;2;0;2;1;0;1
96;08.02.2014;2014;02;06;Lauantai;10;5;15;6;0;6
96;08.02.2014;2014;02;07;Lauantai;2;11;13;1;4;5
96;08.02.2014;2014;02;08;Lauantai;3;13;16;2;6;8
96;08.02.2014;2014;02;09;Lauantai;9;20;29;3;4;7
96;08.02.2014;2014;02;10;Lauantai;8;14;22;3;6;9
96;08.02.2014;2014;02;11;Lauantai;11;18;29;2;11;13
96;08.02.2014;2014;02;12;Lauantai;19;15;34;6;7;13
96;08.02.2014;2014;02;13;Lauantai;10;18;28;8;6;14
96;08.02.2014;2014;02;14;Lauantai;13;22;35;4;9;13
96;08.02.2014;2014;02;15;Lauantai;26;31;57;14;18;32
96;08.02.2014;2014;02;16;Lauantai;16;26;42;9;27;36
96;08.02.2014;2014;02;17;Lauantai;10;13;23;11;5;16
96;08.02.2014;2014;02;18;Lauantai;28;9;37;14;10;24
96;08.02.2014;2014;02;19;Lauantai;23;13;36;17;5;22
96;08.02.2014;2014;02;20;Lauantai;10;13;23;5;10;15
96;08.02.2014;2014;02;21;Lauantai;5;20;25;3;8;11
96;08.02.2014;2014;02;22;Lauantai;5;7;12;2;2;4
96;08.02.2014;2014;02;23;Lauantai;3;5;8;1;2;3
96;09.02.2014;2014;02;00;Sunnuntai;5;5;10;1;0;1
96;09.02.2014;2014;02;01;Sunnuntai;3;2;5;0;0;0
96;09.02.2014;2014;02;02;Sunnuntai;2;0;2;2;0;2
96;09.02.2014;2014;02;03;Sunnuntai;9;2;11;1;0;1
96;09.02.2014;2014;02;04;Sunnuntai;6;0;6;3;2;5
96;09.02.2014;2014;02;05;Sunnuntai;0;1;1;1;0;1
96;09.02.2014;2014;02;06;Sunnuntai;12;3;15;1;0;1
96;09.02.2014;2014;02;07;Sunnuntai;2;4;6;0;4;4
96;09.02.2014;2014;02;08;Sunnuntai;3;5;8;1;4;5
96;09.02.2014;2014;02;09;Sunnuntai;3;4;7;5;3;8
96;09.02.2014;2014;02;10;Sunnuntai;2;9;11;5;8;13
96;09.02.2014;2014;02;11;Sunnuntai;4;12;16;6;9;15
96;09.02.2014;2014;02;12;Sunnuntai;17;12;29;12;8;20
96;09.02.2014;2014;02;13;Sunnuntai;9;34;43;14;14;28
96;09.02.2014;2014;02;14;Sunnuntai;20;17;37;13;16;29
96;09.02.2014;2014;02;15;Sunnuntai;30;30;60;12;25;37
96;09.02.2014;2014;02;16;Sunnuntai;26;18;44;26;14;40
96;09.02.2014;2014;02;17;Sunnuntai;28;24;52;23;8;31
96;09.02.2014;2014;02;18;Sunnuntai;16;15;31;9;17;26
96;09.02.2014;2014;02;19;Sunnuntai;13;31;44;13;24;37
96;09.02.2014;2014;02;20;Sunnuntai;9;12;21;7;10;17
96;09.02.2014;2014;02;21;Sunnuntai;20;17;37;5;1;6
96;09.02.2014;2014;02;22;Sunnuntai;4;3;7;1;1;2
96;09.02.2014;2014;02;23;Sunnuntai;1;5;6;0;0;0
96;10.02.2014;2014;02;00;Maanantai;1;0;1;1;0;1
96;10.02.2014;2014;02;01;Maanantai;0;1;1;0;0;0
96;10.02.2014;2014;02;02;Maanantai;0;0;0;0;0;0
96;10.02.2014;2014;02;03;Maanantai;1;0;1;1;0;1
96;10.02.2014;2014;02;04;Maanantai;1;3;4;0;1;1
96;10.02.2014;2014;02;05;Maanantai;0;7;7;0;1;1
96;10.02.2014;2014;02;06;Maanantai;30;19;49;11;5;16
96;10.02.2014;2014;02;07;Maanantai;64;79;143;34;13;47
96;10.02.2014;2014;02;08;Maanantai;82;74;156;17;8;25
96;10.02.2014;2014;02;09;Maanantai;32;46;78;9;17;26
96;10.02.2014;2014;02;10;Maanantai;36;45;81;14;20;34
96;10.02.2014;2014;02;11;Maanantai;47;40;87;9;11;20
96;10.02.2014;2014;02;12;Maanantai;39;58;97;17;14;31
96;10.02.2014;2014;02;13;Maanantai;51;45;96;9;14;23
96;10.02.2014;2014;02;14;Maanantai;54;70;124;15;22;37
96;10.02.2014;2014;02;15;Maanantai;56;124;180;7;47;54
96;10.02.2014;2014;02;16;Maanantai;84;102;186;11;32;43
96;10.02.2014;2014;02;17;Maanantai;41;50;91;8;13;21
96;10.02.2014;2014;02;18;Maanantai;45;32;77;21;25;46
96;10.02.2014;2014;02;19;Maanantai;28;19;47;6;17;23
96;10.02.2014;2014;02;20;Maanantai;27;19;46;17;20;37
96;10.02.2014;2014;02;21;Maanantai;21;15;36;6;4;10
96;10.02.2014;2014;02;22;Maanantai;10;15;25;4;1;5
96;10.02.2014;2014;02;23;Maanantai;4;1;5;1;0;1
96;11.02.2014;2014;02;00;Tiistai;1;0;1;0;0;0
96;11.02.2014;2014;02;01;Tiistai;0;0;0;2;0;2
96;11.02.2014;2014;02;02;Tiistai;0;0;0;0;0;0
96;11.02.2014;2014;02;03;Tiistai;0;0;0;0;0;0
96;11.02.2014;2014;02;04;Tiistai;1;1;2;0;1;1
96;11.02.2014;2014;02;05;Tiistai;2;7;9;0;0;0
96;11.02.2014;2014;02;06;Tiistai;30;24;54;8;1;9
96;11.02.2014;2014;02;07;Tiistai;84;68;152;32;10;42
96;11.02.2014;2014;02;08;Tiistai;113;68;181;15;5;20
96;11.02.2014;2014;02;09;Tiistai;31;42;73;7;7;14
96;11.02.2014;2014;02;10;Tiistai;33;39;72;9;10;19
96;11.02.2014;2014;02;11;Tiistai;34;37;71;6;11;17
96;11.02.2014;2014;02;12;Tiistai;30;21;51;5;28;33
96;11.02.2014;2014;02;13;Tiistai;20;31;51;15;14;29
96;11.02.2014;2014;02;14;Tiistai;37;56;93;10;21;31
96;11.02.2014;2014;02;15;Tiistai;49;151;200;9;41;50
96;11.02.2014;2014;02;16;Tiistai;62;113;175;11;31;42
96;11.02.2014;2014;02;17;Tiistai;43;50;93;11;16;27
96;11.02.2014;2014;02;18;Tiistai;28;43;71;14;20;34
96;11.02.2014;2014;02;19;Tiistai;29;29;58;8;14;22
96;11.02.2014;2014;02;20;Tiistai;26;15;41;16;9;25
96;11.02.2014;2014;02;21;Tiistai;38;17;55;12;3;15
96;11.02.2014;2014;02;22;Tiistai;8;11;19;5;3;8
96;11.02.2014;2014;02;23;Tiistai;4;0;4;0;1;1
96;12.02.2014;2014;02;00;Keskiviikko;1;2;3;1;0;1
96;12.02.2014;2014;02;01;Keskiviikko;0;1;1;0;0;0
96;12.02.2014;2014;02;02;Keskiviikko;0;0;0;0;1;1
96;12.02.2014;2014;02;03;Keskiviikko;0;0;0;0;0;0
96;12.02.2014;2014;02;04;Keskiviikko;1;1;2;0;4;4
96;12.02.2014;2014;02;05;Keskiviikko;2;8;10;2;0;2
96;12.02.2014;2014;02;06;Keskiviikko;30;18;48;13;4;17
96;12.02.2014;2014;02;07;Keskiviikko;68;55;123;28;12;40
96;12.02.2014;2014;02;08;Keskiviikko;105;65;170;29;7;36
96;12.02.2014;2014;02;09;Keskiviikko;33;34;67;10;7;17
96;12.02.2014;2014;02;10;Keskiviikko;30;34;64;13;11;24
96;12.02.2014;2014;02;11;Keskiviikko;31;36;67;12;17;29
96;12.02.2014;2014;02;12;Keskiviikko;39;50;89;11;18;29
96;12.02.2014;2014;02;13;Keskiviikko;35;51;86;7;16;23
96;12.02.2014;2014;02;14;Keskiviikko;39;72;111;10;24;34
96;12.02.2014;2014;02;15;Keskiviikko;40;129;169;4;41;45
96;12.02.2014;2014;02;16;Keskiviikko;71;109;180;18;47;65
96;12.02.2014;2014;02;17;Keskiviikko;39;43;82;5;23;28
96;12.02.2014;2014;02;18;Keskiviikko;65;42;107;27;17;44
96;12.02.2014;2014;02;19;Keskiviikko;48;16;64;14;23;37
96;12.02.2014;2014;02;20;Keskiviikko;28;22;50;12;14;26
96;12.02.2014;2014;02;21;Keskiviikko;28;36;64;4;8;12
96;12.02.2014;2014;02;22;Keskiviikko;10;11;21;6;1;7
96;12.02.2014;2014;02;23;Keskiviikko;1;4;5;1;2;3
96;13.02.2014;2014;02;00;Torstai;1;0;1;0;0;0
96;13.02.2014;2014;02;01;Torstai;3;0;3;0;0;0
96;13.02.2014;2014;02;02;Torstai;0;0;0;0;0;0
96;13.02.2014;2014;02;03;Torstai;1;1;2;0;0;0
96;13.02.2014;2014;02;04;Torstai;1;2;3;2;0;2
96;13.02.2014;2014;02;05;Torstai;2;10;12;0;0;0
96;13.02.2014;2014;02;06;Torstai;29;26;55;12;2;14
96;13.02.2014;2014;02;07;Torstai;78;62;140;30;11;41
96;13.02.2014;2014;02;08;Torstai;96;67;163;14;11;25
96;13.02.2014;2014;02;09;Torstai;37;43;80;14;11;25
96;13.02.2014;2014;02;10;Torstai;24;34;58;9;13;22
96;13.02.2014;2014;02;11;Torstai;20;28;48;6;13;19
96;13.02.2014;2014;02;12;Torstai;28;52;80;15;16;31
96;13.02.2014;2014;02;13;Torstai;36;57;93;16;13;29
96;13.02.2014;2014;02;14;Torstai;45;65;110;12;26;38
96;13.02.2014;2014;02;15;Torstai;53;106;159;11;47;58
96;13.02.2014;2014;02;16;Torstai;48;121;169;17;36;53
96;13.02.2014;2014;02;17;Torstai;40;36;76;13;17;30
96;13.02.2014;2014;02;18;Torstai;36;45;81;11;10;21
96;13.02.2014;2014;02;19;Torstai;38;24;62;12;19;31
96;13.02.2014;2014;02;20;Torstai;30;27;57;8;7;15
96;13.02.2014;2014;02;21;Torstai;14;27;41;3;9;12
96;13.02.2014;2014;02;22;Torstai;7;8;15;2;3;5
96;13.02.2014;2014;02;23;Torstai;2;6;8;0;0;0
96;14.02.2014;2014;02;00;Perjantai;2;0;2;1;1;2
96;14.02.2014;2014;02;01;Perjantai;7;0;7;0;0;0
96;14.02.2014;2014;02;02;Perjantai;4;1;5;1;0;1
96;14.02.2014;2014;02;03;Perjantai;4;1;5;2;0;2
96;14.02.2014;2014;02;04;Perjantai;5;1;6;0;1;1
96;14.02.2014;2014;02;05;Perjantai;0;9;9;0;1;1
96;14.02.2014;2014;02;06;Perjantai;18;21;39;12;4;16
96;14.02.2014;2014;02;07;Perjantai;69;72;141;26;14;40
96;14.02.2014;2014;02;08;Perjantai;75;64;139;24;10;34
96;14.02.2014;2014;02;09;Perjantai;40;52;92;10;11;21
96;14.02.2014;2014;02;10;Perjantai;29;38;67;8;11;19
96;14.02.2014;2014;02;11;Perjantai;28;38;66;22;9;31
96;14.02.2014;2014;02;12;Perjantai;40;43;83;5;14;19
96;14.02.2014;2014;02;13;Perjantai;30;59;89;7;24;31
96;14.02.2014;2014;02;14;Perjantai;46;91;137;12;49;61
96;14.02.2014;2014;02;15;Perjantai;62;112;174;12;54;66
96;14.02.2014;2014;02;16;Perjantai;46;48;94;33;17;50
96;14.02.2014;2014;02;17;Perjantai;43;41;84;16;11;27
96;14.02.2014;2014;02;18;Perjantai;29;21;50;4;8;12
96;14.02.2014;2014;02;19;Perjantai;14;21;35;2;4;6
96;14.02.2014;2014;02;20;Perjantai;18;7;25;5;4;9
96;14.02.2014;2014;02;21;Perjantai;18;11;29;8;1;9
96;14.02.2014;2014;02;22;Perjantai;8;10;18;2;1;3
96;14.02.2014;2014;02;23;Perjantai;4;5;9;11;9;20
96;15.02.2014;2014;02;00;Lauantai;6;4;10;3;1;4
96;15.02.2014;2014;02;01;Lauantai;4;3;7;1;0;1
96;15.02.2014;2014;02;02;Lauantai;2;2;4;0;0;0
96;15.02.2014;2014;02;03;Lauantai;8;6;14;4;0;4
96;15.02.2014;2014;02;04;Lauantai;5;4;9;2;1;3
96;15.02.2014;2014;02;05;Lauantai;1;0;1;1;0;1
96;15.02.2014;2014;02;06;Lauantai;11;10;21;6;0;6
96;15.02.2014;2014;02;07;Lauantai;10;9;19;1;4;5
96;15.02.2014;2014;02;08;Lauantai;12;9;21;2;6;8
96;15.02.2014;2014;02;09;Lauantai;13;10;23;3;4;7
96;15.02.2014;2014;02;10;Lauantai;15;13;28;3;6;9
96;15.02.2014;2014;02;11;Lauantai;16;13;29;2;11;13
96;15.02.2014;2014;02;12;Lauantai;23;22;45;6;7;13
96;15.02.2014;2014;02;13;Lauantai;27;26;53;8;6;14
96;15.02.2014;2014;02;14;Lauantai;25;25;50;4;9;13
96;15.02.2014;2014;02;15;Lauantai;26;25;51;14;18;32
96;15.02.2014;2014;02;16;Lauantai;19;17;36;9;27;36
96;15.02.2014;2014;02;17;Lauantai;19;18;37;11;5;16
96;15.02.2014;2014;02;18;Lauantai;21;19;40;14;10;24
96;15.02.2014;2014;02;19;Lauantai;15;13;28;17;5;22
96;15.02.2014;2014;02;20;Lauantai;11;10;21;5;10;15
96;15.02.2014;2014;02;21;Lauantai;13;9;22;3;8;11
96;15.02.2014;2014;02;22;Lauantai;10;9;19;2;2;4
96;15.02.2014;2014;02;23;Lauantai;7;5;12;1;2;3
96;16.02.2014;2014;02;00;Sunnuntai;4;2;6;1;0;1
96;16.02.2014;2014;02;01;Sunnuntai;1;1;2;0;0;0
96;16.02.2014;2014;02;02;Sunnuntai;3;1;4;2;0;2
96;16.02.2014;2014;02;03;Sunnuntai;4;3;7;1;0;1
96;16.02.2014;2014;02;04;Sunnuntai;2;1;3;3;2;5
96;16.02.2014;2014;02;05;Sunnuntai;0;0;0;1;0;1
96;16.02.2014;2014;02;06;Sunnuntai;9;6;15;1;0;1
96;16.02.2014;2014;02;07;Sunnuntai;6;4;10;0;4;4
96;16.02.2014;2014;02;08;Sunnuntai;5;2;7;1;4;5
96;16.02.2014;2014;02;09;Sunnuntai;4;2;6;5;3;8
96;16.02.2014;2014;02;10;Sunnuntai;5;3;8;5;8;13
96;16.02.2014;2014;02;11;Sunnuntai;11;9;20;6;9;15
96;16.02.2014;2014;02;12;Sunnuntai;14;11;25;12;8;20
96;16.02.2014;2014;02;13;Sunnuntai;18;15;33;14;14;28
96;16.02.2014;2014;02;14;Sunnuntai;18;16;34;13;16;29
96;16.02.2014;2014;02;15;Sunnuntai;20;17;37;12;25;37
96;16.02.2014;2014;02;16;Sunnuntai;23;21;44;26;14;40
96;16.02.2014;2014;02;17;Sunnuntai;24;23;47;23;8;31
96;16.02.2014;2014;02;18;Sunnuntai;23;20;43;9;17;26
96;16.02.2014;2014;02;19;Sunnuntai;13;10;23;13;24;37
96;16.02.2014;2014;02;20;Sunnuntai;18;14;32;7;10;17
96;16.02.2014;2014;02;21;Sunnuntai;11;10;21;5;1;6
96;16.02.2014;2014;02;22;Sunnuntai;7;6;13;1;1;2
96;16.02.2014;2014;02;23;Sunnuntai;3;1;4;0;0;0
96;17.02.2014;2014;02;00;Maanantai;2;0;2;1;0;1
96;17.02.2014;2014;02;01;Maanantai;1;0;1;0;0;0
96;17.02.2014;2014;02;02;Maanantai;1;0;1;0;0;0
96;17.02.2014;2014;02;03;Maanantai;0;0;0;1;0;1
96;17.02.2014;2014;02;04;Maanantai;2;1;3;0;1;1
96;17.02.2014;2014;02;05;Maanantai;5;4;9;0;1;1
96;17.02.2014;2014;02;06;Maanantai;33;31;64;11;5;16
96;17.02.2014;2014;02;07;Maanantai;73;72;145;34;13;47
96;17.02.2014;2014;02;08;Maanantai;74;71;145;17;8;25
96;17.02.2014;2014;02;09;Maanantai;47;44;91;9;17;26
96;17.02.2014;2014;02;10;Maanantai;40;38;78;14;20;34
96;17.02.2014;2014;02;11;Maanantai;42;41;83;9;11;20
96;17.02.2014;2014;02;12;Maanantai;39;37;76;17;14;31
96;17.02.2014;2014;02;13;Maanantai;47;45;92;9;14;23
96;17.02.2014;2014;02;14;Maanantai;65;62;127;15;22;37
96;17.02.2014;2014;02;15;Maanantai;97;98;195;7;47;54
96;17.02.2014;2014;02;16;Maanantai;73;92;165;11;32;43
96;17.02.2014;2014;02;17;Maanantai;39;48;87;8;13;21
96;17.02.2014;2014;02;18;Maanantai;40;33;73;21;25;46
96;17.02.2014;2014;02;19;Maanantai;37;18;55;6;17;23
96;17.02.2014;2014;02;20;Maanantai;23;26;49;17;20;37
96;17.02.2014;2014;02;21;Maanantai;20;11;31;6;4;10
96;17.02.2014;2014;02;22;Maanantai;10;2;12;4;1;5
96;17.02.2014;2014;02;23;Maanantai;2;0;2;1;0;1
96;18.02.2014;2014;02;00;Tiistai;4;0;4;0;1;1
96;18.02.2014;2014;02;01;Tiistai;2;0;2;0;0;0
96;18.02.2014;2014;02;02;Tiistai;0;1;1;0;0;0
96;18.02.2014;2014;02;03;Tiistai;2;0;2;0;1;1
96;18.02.2014;2014;02;04;Tiistai;1;2;3;0;1;1
96;18.02.2014;2014;02;05;Tiistai;3;6;9;0;1;1
96;18.02.2014;2014;02;06;Tiistai;38;21;59;7;2;9
96;18.02.2014;2014;02;07;Tiistai;78;63;141;15;6;21
96;18.02.2014;2014;02;08;Tiistai;83;49;132;7;10;17
96;18.02.2014;2014;02;09;Tiistai;37;33;70;3;13;16
96;18.02.2014;2014;02;10;Tiistai;37;32;69;2;13;15
96;18.02.2014;2014;02;11;Tiistai;38;39;77;10;12;22
96;18.02.2014;2014;02;12;Tiistai;40;49;89;9;10;19
96;18.02.2014;2014;02;13;Tiistai;32;42;74;2;14;16
96;18.02.2014;2014;02;14;Tiistai;46;70;116;4;12;16
96;18.02.2014;2014;02;15;Tiistai;45;140;185;9;34;43
96;18.02.2014;2014;02;16;Tiistai;60;106;166;6;29;35
96;18.02.2014;2014;02;17;Tiistai;38;47;85;9;18;27
96;18.02.2014;2014;02;18;Tiistai;29;35;64;24;20;44
96;18.02.2014;2014;02;19;Tiistai;40;21;61;20;27;47
96;18.02.2014;2014;02;20;Tiistai;34;31;65;11;9;20
96;18.02.2014;2014;02;21;Tiistai;27;28;55;3;9;12
96;18.02.2014;2014;02;22;Tiistai;12;14;26;6;2;8
96;18.02.2014;2014;02;23;Tiistai;9;0;9;1;2;3
96;19.02.2014;2014;02;00;Keskiviikko;1;0;1;0;0;0
96;19.02.2014;2014;02;01;Keskiviikko;2;2;4;0;0;0
96;19.02.2014;2014;02;02;Keskiviikko;2;2;4;0;0;0
96;19.02.2014;2014;02;03;Keskiviikko;0;0;0;0;0;0
96;19.02.2014;2014;02;04;Keskiviikko;0;2;2;1;1;2
96;19.02.2014;2014;02;05;Keskiviikko;2;10;12;0;0;0
96;19.02.2014;2014;02;06;Keskiviikko;27;24;51;10;1;11
96;19.02.2014;2014;02;07;Keskiviikko;79;77;156;32;5;37
96;19.02.2014;2014;02;08;Keskiviikko;82;86;168;20;11;31
96;19.02.2014;2014;02;09;Keskiviikko;38;53;91;12;13;25
96;19.02.2014;2014;02;10;Keskiviikko;43;46;89;13;17;30
96;19.02.2014;2014;02;11;Keskiviikko;40;61;101;9;14;23
96;19.02.2014;2014;02;12;Keskiviikko;41;60;101;9;23;32
96;19.02.2014;2014;02;13;Keskiviikko;42;53;95;12;18;30
96;19.02.2014;2014;02;14;Keskiviikko;40;69;109;14;18;32
96;19.02.2014;2014;02;15;Keskiviikko;34;128;162;12;51;63
96;19.02.2014;2014;02;16;Keskiviikko;44;82;126;10;31;41
96;19.02.2014;2014;02;17;Keskiviikko;65;56;121;21;16;37
96;19.02.2014;2014;02;18;Keskiviikko;45;31;76;25;18;43
96;19.02.2014;2014;02;19;Keskiviikko;38;27;65;18;11;29
96;19.02.2014;2014;02;20;Keskiviikko;33;26;59;11;16;27
96;19.02.2014;2014;02;21;Keskiviikko;17;31;48;4;9;13
96;19.02.2014;2014;02;22;Keskiviikko;8;9;17;4;0;4
96;19.02.2014;2014;02;23;Keskiviikko;1;0;1;1;0;1
96;20.02.2014;2014;02;00;Torstai;1;0;1;0;0;0
96;20.02.2014;2014;02;01;Torstai;3;2;5;1;0;1
96;20.02.2014;2014;02;02;Torstai;0;0;0;0;0;0
96;20.02.2014;2014;02;03;Torstai;0;0;0;0;0;0
96;20.02.2014;2014;02;04;Torstai;2;1;3;0;0;0
96;20.02.2014;2014;02;05;Torstai;1;9;10;0;1;1
96;20.02.2014;2014;02;06;Torstai;32;20;52;16;0;16
96;20.02.2014;2014;02;07;Torstai;77;71;148;36;10;46
96;20.02.2014;2014;02;08;Torstai;99;80;179;21;9;30
96;20.02.2014;2014;02;09;Torstai;45;43;88;12;19;31
96;20.02.2014;2014;02;10;Torstai;27;29;56;13;15;28
96;20.02.2014;2014;02;11;Torstai;34;31;65;12;8;20
96;20.02.2014;2014;02;12;Torstai;32;41;73;16;12;28
96;20.02.2014;2014;02;13;Torstai;42;30;72;11;14;25
96;20.02.2014;2014;02;14;Torstai;34;79;113;4;18;22
96;20.02.2014;2014;02;15;Torstai;50;139;189;8;43;51
96;20.02.2014;2014;02;16;Torstai;66;119;185;9;40;49
96;20.02.2014;2014;02;17;Torstai;45;59;104;10;21;31
96;20.02.2014;2014;02;18;Torstai;46;34;80;12;16;28
96;20.02.2014;2014;02;19;Torstai;32;25;57;15;13;28
96;20.02.2014;2014;02;20;Torstai;29;16;45;7;7;14
96;20.02.2014;2014;02;21;Torstai;20;18;38;6;8;14
96;20.02.2014;2014;02;22;Torstai;5;6;11;1;0;1
96;20.02.2014;2014;02;23;Torstai;1;1;2;3;0;3
96;21.02.2014;2014;02;00;Perjantai;6;3;9;1;0;1
96;21.02.2014;2014;02;01;Perjantai;2;0;2;0;0;0
96;21.02.2014;2014;02;02;Perjantai;1;1;2;0;0;0
96;21.02.2014;2014;02;03;Perjantai;0;0;0;0;0;0
96;21.02.2014;2014;02;04;Perjantai;3;1;4;0;0;0
96;21.02.2014;2014;02;05;Perjantai;1;5;6;0;0;0
96;21.02.2014;2014;02;06;Perjantai;28;25;53;17;4;21
96;21.02.2014;2014;02;07;Perjantai;79;64;143;22;12;34
96;21.02.2014;2014;02;08;Perjantai;70;64;134;24;7;31
96;21.02.2014;2014;02;09;Perjantai;40;36;76;6;15;21
96;21.02.2014;2014;02;10;Perjantai;36;34;70;13;13;26
96;21.02.2014;2014;02;11;Perjantai;39;56;95;12;21;33
96;21.02.2014;2014;02;12;Perjantai;41;56;97;8;16;24
96;21.02.2014;2014;02;13;Perjantai;39;92;131;7;16;23
96;21.02.2014;2014;02;14;Perjantai;29;65;94;6;25;31
96;21.02.2014;2014;02;15;Perjantai;35;76;111;5;36;41
96;21.02.2014;2014;02;16;Perjantai;34;60;94;16;11;27
96;21.02.2014;2014;02;17;Perjantai;30;38;68;12;9;21
96;21.02.2014;2014;02;18;Perjantai;26;26;52;8;11;19
96;21.02.2014;2014;02;19;Perjantai;23;27;50;13;6;19
96;21.02.2014;2014;02;20;Perjantai;18;14;32;5;4;9
96;21.02.2014;2014;02;21;Perjantai;10;18;28;3;4;7
96;21.02.2014;2014;02;22;Perjantai;8;8;16;1;2;3
96;21.02.2014;2014;02;23;Perjantai;8;11;19;0;1;1
96;22.02.2014;2014;02;00;Lauantai;9;2;11;3;2;5
96;22.02.2014;2014;02;01;Lauantai;2;0;2;1;1;2
96;22.02.2014;2014;02;02;Lauantai;3;2;5;0;1;1
96;22.02.2014;2014;02;03;Lauantai;4;0;4;3;0;3
96;22.02.2014;2014;02;04;Lauantai;2;0;2;1;0;1
96;22.02.2014;2014;02;05;Lauantai;1;3;4;1;1;2
96;22.02.2014;2014;02;06;Lauantai;10;4;14;6;2;8
96;22.02.2014;2014;02;07;Lauantai;4;15;19;0;2;2
96;22.02.2014;2014;02;08;Lauantai;2;6;8;4;3;7
96;22.02.2014;2014;02;09;Lauantai;11;10;21;2;5;7
96;22.02.2014;2014;02;10;Lauantai;14;12;26;5;5;10
96;22.02.2014;2014;02;11;Lauantai;10;31;41;12;12;24
96;22.02.2014;2014;02;12;Lauantai;23;12;35;5;6;11
96;22.02.2014;2014;02;13;Lauantai;12;24;36;17;14;31
96;22.02.2014;2014;02;14;Lauantai;21;16;37;17;9;26
96;22.02.2014;2014;02;15;Lauantai;15;18;33;12;13;25
96;22.02.2014;2014;02;16;Lauantai;22;24;46;16;10;26
96;22.02.2014;2014;02;17;Lauantai;32;9;41;22;6;28
96;22.02.2014;2014;02;18;Lauantai;16;11;27;11;6;17
96;22.02.2014;2014;02;19;Lauantai;12;15;27;11;5;16
96;22.02.2014;2014;02;20;Lauantai;16;19;35;7;17;24
96;22.02.2014;2014;02;21;Lauantai;7;12;19;5;7;12
96;22.02.2014;2014;02;22;Lauantai;7;13;20;5;15;20
96;22.02.2014;2014;02;23;Lauantai;3;8;11;5;3;8
96;23.02.2014;2014;02;00;Sunnuntai;4;8;12;2;3;5
96;23.02.2014;2014;02;01;Sunnuntai;7;1;8;0;1;1
96;23.02.2014;2014;02;02;Sunnuntai;5;3;8;2;0;2
96;23.02.2014;2014;02;03;Sunnuntai;5;1;6;4;1;5
96;23.02.2014;2014;02;04;Sunnuntai;2;1;3;0;2;2
96;23.02.2014;2014;02;05;Sunnuntai;1;0;1;0;2;2
96;23.02.2014;2014;02;06;Sunnuntai;10;6;16;6;2;8
96;23.02.2014;2014;02;07;Sunnuntai;0;8;8;1;5;6
96;23.02.2014;2014;02;08;Sunnuntai;5;7;12;2;3;5
96;23.02.2014;2014;02;09;Sunnuntai;6;6;12;3;7;10
96;23.02.2014;2014;02;10;Sunnuntai;5;5;10;1;8;9
96;23.02.2014;2014;02;11;Sunnuntai;8;16;24;11;8;19
96;23.02.2014;2014;02;12;Sunnuntai;19;25;44;20;20;40
96;23.02.2014;2014;02;13;Sunnuntai;27;16;43;13;14;27
96;23.02.2014;2014;02;14;Sunnuntai;18;19;37;7;18;25
96;23.02.2014;2014;02;15;Sunnuntai;17;16;33;11;16;27
96;23.02.2014;2014;02;16;Sunnuntai;16;14;30;16;12;28
96;23.02.2014;2014;02;17;Sunnuntai;19;16;35;10;12;22
96;23.02.2014;2014;02;18;Sunnuntai;26;16;42;25;11;36
96;23.02.2014;2014;02;19;Sunnuntai;18;16;34;19;13;32
96;23.02.2014;2014;02;20;Sunnuntai;36;6;42;13;4;17
96;23.02.2014;2014;02;21;Sunnuntai;20;30;50;1;8;9
96;23.02.2014;2014;02;22;Sunnuntai;9;5;14;2;3;5
96;23.02.2014;2014;02;23;Sunnuntai;1;1;2;0;0;0
96;24.02.2014;2014;02;00;Maanantai;0;0;0;0;0;0
96;24.02.2014;2014;02;01;Maanantai;0;0;0;0;0;0
96;24.02.2014;2014;02;02;Maanantai;0;0;0;0;0;0
96;24.02.2014;2014;02;03;Maanantai;0;0;0;0;0;0
96;24.02.2014;2014;02;04;Maanantai;2;1;3;0;0;0
96;24.02.2014;2014;02;05;Maanantai;5;10;15;1;2;3
96;24.02.2014;2014;02;06;Maanantai;27;23;50;10;1;11
96;24.02.2014;2014;02;07;Maanantai;76;48;124;41;9;50
96;24.02.2014;2014;02;08;Maanantai;99;66;165;24;10;34
96;24.02.2014;2014;02;09;Maanantai;39;44;83;12;9;21
96;24.02.2014;2014;02;10;Maanantai;38;28;66;9;12;21
96;24.02.2014;2014;02;11;Maanantai;29;29;58;7;12;19
96;24.02.2014;2014;02;12;Maanantai;57;52;109;17;12;29
96;24.02.2014;2014;02;13;Maanantai;37;53;90;13;10;23
96;24.02.2014;2014;02;14;Maanantai;61;64;125;18;20;38
96;24.02.2014;2014;02;15;Maanantai;46;102;148;13;40;53
96;24.02.2014;2014;02;16;Maanantai;78;113;191;10;31;41
96;24.02.2014;2014;02;17;Maanantai;53;52;105;10;18;28
96;24.02.2014;2014;02;18;Maanantai;46;36;82;16;7;23
96;24.02.2014;2014;02;19;Maanantai;36;26;62;30;26;56
96;24.02.2014;2014;02;20;Maanantai;33;17;50;11;11;22
96;24.02.2014;2014;02;21;Maanantai;21;16;37;7;3;10
96;24.02.2014;2014;02;22;Maanantai;10;6;16;0;2;2
96;24.02.2014;2014;02;23;Maanantai;3;3;6;0;2;2
96;25.02.2014;2014;02;00;Tiistai;2;0;2;0;0;0
96;25.02.2014;2014;02;01;Tiistai;0;0;0;0;0;0
96;25.02.2014;2014;02;02;Tiistai;1;1;2;0;0;0
96;25.02.2014;2014;02;03;Tiistai;1;0;1;0;0;0
96;25.02.2014;2014;02;04;Tiistai;4;2;6;0;0;0
96;25.02.2014;2014;02;05;Tiistai;3;8;11;1;1;2
96;25.02.2014;2014;02;06;Tiistai;46;25;71;17;1;18
96;25.02.2014;2014;02;07;Tiistai;117;61;178;32;15;47
96;25.02.2014;2014;02;08;Tiistai;119;70;189;12;13;25
96;25.02.2014;2014;02;09;Tiistai;41;53;94;9;12;21
96;25.02.2014;2014;02;10;Tiistai;44;28;72;7;12;19
96;25.02.2014;2014;02;11;Tiistai;54;33;87;14;13;27
96;25.02.2014;2014;02;12;Tiistai;46;42;88;17;10;27
96;25.02.2014;2014;02;13;Tiistai;63;41;104;13;23;36
96;25.02.2014;2014;02;14;Tiistai;55;67;122;16;13;29
96;25.02.2014;2014;02;15;Tiistai;51;166;217;10;41;51
96;25.02.2014;2014;02;16;Tiistai;78;115;193;15;40;55
96;25.02.2014;2014;02;17;Tiistai;55;50;105;27;18;45
96;25.02.2014;2014;02;18;Tiistai;49;33;82;16;16;32
96;25.02.2014;2014;02;19;Tiistai;57;22;79;19;22;41
96;25.02.2014;2014;02;20;Tiistai;46;22;68;12;13;25
96;25.02.2014;2014;02;21;Tiistai;24;20;44;5;4;9
96;25.02.2014;2014;02;22;Tiistai;15;2;17;4;4;8
96;25.02.2014;2014;02;23;Tiistai;6;0;6;2;0;2
96;26.02.2014;2014;02;00;Keskiviikko;1;0;1;1;0;1
96;26.02.2014;2014;02;01;Keskiviikko;0;0;0;0;0;0
96;26.02.2014;2014;02;02;Keskiviikko;0;0;0;0;0;0
96;26.02.2014;2014;02;03;Keskiviikko;0;1;1;0;0;0
96;26.02.2014;2014;02;04;Keskiviikko;2;1;3;0;1;1
96;26.02.2014;2014;02;05;Keskiviikko;1;9;10;0;0;0
96;26.02.2014;2014;02;06;Keskiviikko;38;34;72;9;3;12
96;26.02.2014;2014;02;07;Keskiviikko;84;70;154;39;13;52
96;26.02.2014;2014;02;08;Keskiviikko;92;81;173;18;17;35
96;26.02.2014;2014;02;09;Keskiviikko;47;40;87;20;12;32
96;26.02.2014;2014;02;10;Keskiviikko;32;42;74;9;13;22
96;26.02.2014;2014;02;11;Keskiviikko;45;54;99;9;6;15
96;26.02.2014;2014;02;12;Keskiviikko;59;49;108;22;20;42
96;26.02.2014;2014;02;13;Keskiviikko;44;55;99;11;13;24
96;26.02.2014;2014;02;14;Keskiviikko;60;94;154;13;28;41
96;26.02.2014;2014;02;15;Keskiviikko;76;147;223;10;43;53
96;26.02.2014;2014;02;16;Keskiviikko;106;132;238;11;37;48
96;26.02.2014;2014;02;17;Keskiviikko;85;80;165;12;20;32
96;26.02.2014;2014;02;18;Keskiviikko;61;20;81;19;17;36
96;26.02.2014;2014;02;19;Keskiviikko;35;28;63;14;20;34
96;26.02.2014;2014;02;20;Keskiviikko;32;19;51;19;10;29
96;26.02.2014;2014;02;21;Keskiviikko;30;18;48;2;6;8
96;26.02.2014;2014;02;22;Keskiviikko;14;12;26;3;1;4
96;26.02.2014;2014;02;23;Keskiviikko;3;4;7;0;1;1
96;27.02.2014;2014;02;00;Torstai;8;1;9;2;0;2
96;27.02.2014;2014;02;01;Torstai;2;0;2;0;0;0
96;27.02.2014;2014;02;02;Torstai;5;2;7;0;0;0
96;27.02.2014;2014;02;03;Torstai;4;0;4;1;0;1
96;27.02.2014;2014;02;04;Torstai;5;2;7;1;1;2
96;27.02.2014;2014;02;05;Torstai;4;6;10;1;0;1
96;27.02.2014;2014;02;06;Torstai;36;18;54;12;2;14
96;27.02.2014;2014;02;07;Torstai;107;63;170;33;12;45
96;27.02.2014;2014;02;08;Torstai;137;85;222;19;9;28
96;27.02.2014;2014;02;09;Torstai;80;47;127;56;16;72
96;27.02.2014;2014;02;10;Torstai;39;32;71;19;18;37
96;27.02.2014;2014;02;11;Torstai;54;47;101;14;66;80
96;27.02.2014;2014;02;12;Torstai;62;52;114;15;20;35
96;27.02.2014;2014;02;13;Torstai;40;53;93;17;14;31
96;27.02.2014;2014;02;14;Torstai;48;75;123;10;22;32
96;27.02.2014;2014;02;15;Torstai;59;136;195;8;37;45
96;27.02.2014;2014;02;16;Torstai;73;112;185;12;30;42
96;27.02.2014;2014;02;17;Torstai;44;62;106;11;16;27
96;27.02.2014;2014;02;18;Torstai;45;36;81;17;7;24
96;27.02.2014;2014;02;19;Torstai;39;27;66;22;10;32
96;27.02.2014;2014;02;20;Torstai;39;19;58;15;7;22
96;27.02.2014;2014;02;21;Torstai;29;22;51;11;7;18
96;27.02.2014;2014;02;22;Torstai;15;4;19;2;2;4
96;27.02.2014;2014;02;23;Torstai;5;1;6;0;2;2
96;28.02.2014;2014;02;00;Perjantai;6;1;7;0;1;1
96;28.02.2014;2014;02;01;Perjantai;2;0;2;0;0;0
96;28.02.2014;2014;02;02;Perjantai;1;0;1;0;0;0
96;28.02.2014;2014;02;03;Perjantai;1;0;1;0;0;0
96;28.02.2014;2014;02;04;Perjantai;3;1;4;1;0;1
96;28.02.2014;2014;02;05;Perjantai;1;7;8;0;0;0
96;28.02.2014;2014;02;06;Perjantai;28;24;52;11;4;15
96;28.02.2014;2014;02;07;Perjantai;65;57;122;27;14;41
96;28.02.2014;2014;02;08;Perjantai;74;62;136;20;8;28
96;28.02.2014;2014;02;09;Perjantai;39;34;73;19;16;35
96;28.02.2014;2014;02;10;Perjantai;25;36;61;7;7;14
96;28.02.2014;2014;02;11;Perjantai;42;41;83;10;10;20
96;28.02.2014;2014;02;12;Perjantai;47;58;105;13;18;31
96;28.02.2014;2014;02;13;Perjantai;50;60;110;8;8;16
96;28.02.2014;2014;02;14;Perjantai;35;99;134;17;28;45
96;28.02.2014;2014;02;15;Perjantai;47;95;142;7;27;34
96;28.02.2014;2014;02;16;Perjantai;34;65;99;11;17;28
96;28.02.2014;2014;02;17;Perjantai;30;33;63;9;15;24
96;28.02.2014;2014;02;18;Perjantai;44;19;63;6;7;13
96;28.02.2014;2014;02;19;Perjantai;22;17;39;9;6;15
96;28.02.2014;2014;02;20;Perjantai;15;15;30;8;6;14
96;28.02.2014;2014;02;21;Perjantai;22;16;38;2;1;3
96;28.02.2014;2014;02;22;Perjantai;3;9;12;3;0;3
96;28.02.2014;2014;02;23;Perjantai;4;4;8;0;5;5
96;01.03.2014;2014;03;00;Lauantai;5;3;8;2;0;2
96;01.03.2014;2014;03;01;Lauantai;2;4;6;1;1;2
96;01.03.2014;2014;03;02;Lauantai;8;0;8;3;2;5
96;01.03.2014;2014;03;03;Lauantai;4;1;5;2;0;2
96;01.03.2014;2014;03;04;Lauantai;3;1;4;1;2;3
96;01.03.2014;2014;03;05;Lauantai;0;0;0;1;1;2
96;01.03.2014;2014;03;06;Lauantai;16;10;26;4;1;5
96;01.03.2014;2014;03;07;Lauantai;1;10;11;0;5;5
96;01.03.2014;2014;03;08;Lauantai;5;8;13;4;10;14
96;01.03.2014;2014;03;09;Lauantai;6;20;26;7;9;16
96;01.03.2014;2014;03;10;Lauantai;19;31;50;3;12;15
96;01.03.2014;2014;03;11;Lauantai;17;30;47;13;11;24
96;01.03.2014;2014;03;12;Lauantai;25;27;52;14;7;21
96;01.03.2014;2014;03;13;Lauantai;23;22;45;7;14;21
96;01.03.2014;2014;03;14;Lauantai;38;20;58;13;26;39
96;01.03.2014;2014;03;15;Lauantai;26;41;67;13;11;24
96;01.03.2014;2014;03;16;Lauantai;18;39;57;9;16;25
96;01.03.2014;2014;03;17;Lauantai;8;13;21;4;6;10
96;01.03.2014;2014;03;18;Lauantai;19;13;32;13;6;19
96;01.03.2014;2014;03;19;Lauantai;30;20;50;22;6;28
96;01.03.2014;2014;03;20;Lauantai;20;10;30;5;8;13
96;01.03.2014;2014;03;21;Lauantai;7;28;35;8;4;12
96;01.03.2014;2014;03;22;Lauantai;5;3;8;1;6;7
96;01.03.2014;2014;03;23;Lauantai;4;3;7;2;0;2
96;02.03.2014;2014;03;00;Sunnuntai;10;3;13;1;2;3
96;02.03.2014;2014;03;01;Sunnuntai;4;1;5;0;1;1
96;02.03.2014;2014;03;02;Sunnuntai;3;1;4;1;0;1
96;02.03.2014;2014;03;03;Sunnuntai;12;1;13;3;0;3
96;02.03.2014;2014;03;04;Sunnuntai;5;0;5;1;0;1
96;02.03.2014;2014;03;05;Sunnuntai;3;0;3;0;2;2
96;02.03.2014;2014;03;06;Sunnuntai;12;8;20;2;0;2
96;02.03.2014;2014;03;07;Sunnuntai;2;4;6;1;2;3
96;02.03.2014;2014;03;08;Sunnuntai;0;5;5;2;5;7
96;02.03.2014;2014;03;09;Sunnuntai;1;5;6;5;5;10
96;02.03.2014;2014;03;10;Sunnuntai;5;19;24;10;13;23
96;02.03.2014;2014;03;11;Sunnuntai;26;26;52;12;13;25
96;02.03.2014;2014;03;12;Sunnuntai;30;31;61;15;17;32
96;02.03.2014;2014;03;13;Sunnuntai;17;32;49;18;22;40
96;02.03.2014;2014;03;14;Sunnuntai;31;20;51;19;11;30
96;02.03.2014;2014;03;15;Sunnuntai;15;20;35;14;21;35
96;02.03.2014;2014;03;16;Sunnuntai;29;14;43;23;14;37
96;02.03.2014;2014;03;17;Sunnuntai;19;16;35;20;9;29
96;02.03.2014;2014;03;18;Sunnuntai;19;16;35;13;17;30
96;02.03.2014;2014;03;19;Sunnuntai;4;20;24;7;16;23
96;02.03.2014;2014;03;20;Sunnuntai;16;15;31;9;10;19
96;02.03.2014;2014;03;21;Sunnuntai;12;16;28;3;3;6
96;02.03.2014;2014;03;22;Sunnuntai;3;3;6;2;1;3
96;02.03.2014;2014;03;23;Sunnuntai;3;5;8;0;0;0
96;03.03.2014;2014;03;00;Maanantai;1;0;1;1;0;1
96;03.03.2014;2014;03;01;Maanantai;1;2;3;1;1;2
96;03.03.2014;2014;03;02;Maanantai;0;2;2;2;1;3
96;03.03.2014;2014;03;03;Maanantai;3;0;3;1;0;1
96;03.03.2014;2014;03;04;Maanantai;2;1;3;0;0;0
96;03.03.2014;2014;03;05;Maanantai;1;6;7;1;0;1
96;03.03.2014;2014;03;06;Maanantai;38;13;51;12;0;12
96;03.03.2014;2014;03;07;Maanantai;83;43;126;28;10;38
96;03.03.2014;2014;03;08;Maanantai;35;43;78;10;3;13
96;03.03.2014;2014;03;09;Maanantai;19;36;55;9;11;20
96;03.03.2014;2014;03;10;Maanantai;21;31;52;7;8;15
96;03.03.2014;2014;03;11;Maanantai;31;31;62;7;14;21
96;03.03.2014;2014;03;12;Maanantai;38;35;73;18;7;25
96;03.03.2014;2014;03;13;Maanantai;34;20;54;6;17;23
96;03.03.2014;2014;03;14;Maanantai;34;57;91;13;15;28
96;03.03.2014;2014;03;15;Maanantai;29;89;118;10;30;40
96;03.03.2014;2014;03;16;Maanantai;49;70;119;9;30;39
96;03.03.2014;2014;03;17;Maanantai;35;30;65;10;10;20
96;03.03.2014;2014;03;18;Maanantai;26;19;45;12;7;19
96;03.03.2014;2014;03;19;Maanantai;15;11;26;7;11;18
96;03.03.2014;2014;03;20;Maanantai;25;16;41;8;11;19
96;03.03.2014;2014;03;21;Maanantai;15;13;28;3;7;10
96;03.03.2014;2014;03;22;Maanantai;5;3;8;3;2;5
96;03.03.2014;2014;03;23;Maanantai;3;2;5;2;0;2
96;04.03.2014;2014;03;00;Tiistai;4;1;5;0;0;0
96;04.03.2014;2014;03;01;Tiistai;5;0;5;1;0;1
96;04.03.2014;2014;03;02;Tiistai;0;0;0;0;0;0
96;04.03.2014;2014;03;03;Tiistai;1;2;3;0;0;0
96;04.03.2014;2014;03;04;Tiistai;2;2;4;0;2;2
96;04.03.2014;2014;03;05;Tiistai;1;6;7;1;1;2
96;04.03.2014;2014;03;06;Tiistai;38;19;57;14;1;15
96;04.03.2014;2014;03;07;Tiistai;54;56;110;30;11;41
96;04.03.2014;2014;03;08;Tiistai;40;38;78;9;9;18
96;04.03.2014;2014;03;09;Tiistai;26;31;57;10;5;15
96;04.03.2014;2014;03;10;Tiistai;22;41;63;7;11;18
96;04.03.2014;2014;03;11;Tiistai;32;29;61;7;8;15
96;04.03.2014;2014;03;12;Tiistai;42;30;72;10;15;25
96;04.03.2014;2014;03;13;Tiistai;23;30;53;10;10;20
96;04.03.2014;2014;03;14;Tiistai;30;59;89;6;20;26
96;04.03.2014;2014;03;15;Tiistai;35;94;129;13;26;39
96;04.03.2014;2014;03;16;Tiistai;51;79;130;10;20;30
96;04.03.2014;2014;03;17;Tiistai;51;30;81;10;18;28
96;04.03.2014;2014;03;18;Tiistai;19;18;37;11;12;23
96;04.03.2014;2014;03;19;Tiistai;23;26;49;13;16;29
96;04.03.2014;2014;03;20;Tiistai;25;28;53;14;15;29
96;04.03.2014;2014;03;21;Tiistai;15;17;32;2;3;5
96;04.03.2014;2014;03;22;Tiistai;7;5;12;1;0;1
96;04.03.2014;2014;03;23;Tiistai;6;1;7;1;2;3
96;05.03.2014;2014;03;00;Keskiviikko;4;2;6;0;1;1
96;05.03.2014;2014;03;01;Keskiviikko;8;2;10;0;0;0
96;05.03.2014;2014;03;02;Keskiviikko;8;0;8;1;0;1
96;05.03.2014;2014;03;03;Keskiviikko;6;0;6;0;0;0
96;05.03.2014;2014;03;04;Keskiviikko;2;1;3;2;1;3
96;05.03.2014;2014;03;05;Keskiviikko;1;5;6;0;0;0
96;05.03.2014;2014;03;06;Keskiviikko;28;17;45;16;2;18
96;05.03.2014;2014;03;07;Keskiviikko;65;51;116;20;7;27
96;05.03.2014;2014;03;08;Keskiviikko;42;35;77;13;6;19
96;05.03.2014;2014;03;09;Keskiviikko;18;31;49;8;1;9
96;05.03.2014;2014;03;10;Keskiviikko;13;33;46;5;14;19
96;05.03.2014;2014;03;11;Keskiviikko;21;28;49;3;8;11
96;05.03.2014;2014;03;12;Keskiviikko;36;31;67;15;12;27
96;05.03.2014;2014;03;13;Keskiviikko;22;32;54;15;19;34
96;05.03.2014;2014;03;14;Keskiviikko;25;41;66;8;13;21
96;05.03.2014;2014;03;15;Keskiviikko;34;79;113;7;36;43
96;05.03.2014;2014;03;16;Keskiviikko;43;79;122;11;27;38
96;05.03.2014;2014;03;17;Keskiviikko;40;31;71;15;12;27
96;05.03.2014;2014;03;18;Keskiviikko;26;24;50;11;14;25
96;05.03.2014;2014;03;19;Keskiviikko;33;14;47;18;16;34
96;05.03.2014;2014;03;20;Keskiviikko;27;17;44;6;7;13
96;05.03.2014;2014;03;21;Keskiviikko;11;32;43;6;13;19
96;05.03.2014;2014;03;22;Keskiviikko;7;7;14;3;3;6
96;05.03.2014;2014;03;23;Keskiviikko;8;5;13;0;0;0
96;06.03.2014;2014;03;00;Torstai;5;0;5;0;1;1
96;06.03.2014;2014;03;01;Torstai;1;1;2;1;0;1
96;06.03.2014;2014;03;02;Torstai;6;1;7;4;2;6
96;06.03.2014;2014;03;03;Torstai;3;1;4;0;0;0
96;06.03.2014;2014;03;04;Torstai;2;2;4;0;0;0
96;06.03.2014;2014;03;05;Torstai;2;7;9;1;1;2
96;06.03.2014;2014;03;06;Torstai;32;16;48;10;3;13
96;06.03.2014;2014;03;07;Torstai;65;46;111;27;5;32
96;06.03.2014;2014;03;08;Torstai;37;43;80;14;10;24
96;06.03.2014;2014;03;09;Torstai;20;25;45;9;3;12
96;06.03.2014;2014;03;10;Torstai;19;29;48;9;16;25
96;06.03.2014;2014;03;11;Torstai;28;41;69;10;5;15
96;06.03.2014;2014;03;12;Torstai;33;27;60;6;16;22
96;06.03.2014;2014;03;13;Torstai;28;26;54;7;9;16
96;06.03.2014;2014;03;14;Torstai;43;41;84;10;16;26
96;06.03.2014;2014;03;15;Torstai;36;102;138;11;32;43
96;06.03.2014;2014;03;16;Torstai;33;70;103;12;23;35
96;06.03.2014;2014;03;17;Torstai;42;28;70;21;12;33
96;06.03.2014;2014;03;18;Torstai;32;27;59;15;14;29
96;06.03.2014;2014;03;19;Torstai;20;14;34;10;10;20
96;06.03.2014;2014;03;20;Torstai;28;15;43;14;12;26
96;06.03.2014;2014;03;21;Torstai;14;17;31;5;3;8
96;06.03.2014;2014;03;22;Torstai;6;8;14;1;2;3
96;06.03.2014;2014;03;23;Torstai;1;0;1;3;2;5
96;07.03.2014;2014;03;00;Perjantai;3;1;4;1;0;1
96;07.03.2014;2014;03;01;Perjantai;2;1;3;0;1;1
96;07.03.2014;2014;03;02;Perjantai;8;0;8;0;0;0
96;07.03.2014;2014;03;03;Perjantai;0;0;0;0;0;0
96;07.03.2014;2014;03;04;Perjantai;6;1;7;1;1;2
96;07.03.2014;2014;03;05;Perjantai;3;8;11;1;1;2
96;07.03.2014;2014;03;06;Perjantai;32;27;59;14;2;16
96;07.03.2014;2014;03;07;Perjantai;50;42;92;15;5;20
96;07.03.2014;2014;03;08;Perjantai;31;27;58;8;8;16
96;07.03.2014;2014;03;09;Perjantai;18;33;51;13;10;23
96;07.03.2014;2014;03;10;Perjantai;13;16;29;4;7;11
96;07.03.2014;2014;03;11;Perjantai;16;28;44;7;8;15
96;07.03.2014;2014;03;12;Perjantai;41;20;61;10;10;20
96;07.03.2014;2014;03;13;Perjantai;42;42;84;5;7;12
96;07.03.2014;2014;03;14;Perjantai;30;82;112;6;16;22
96;07.03.2014;2014;03;15;Perjantai;37;64;101;7;24;31
96;07.03.2014;2014;03;16;Perjantai;33;38;71;12;19;31
96;07.03.2014;2014;03;17;Perjantai;33;24;57;7;15;22
96;07.03.2014;2014;03;18;Perjantai;18;26;44;9;13;22
96;07.03.2014;2014;03;19;Perjantai;18;9;27;4;2;6
96;07.03.2014;2014;03;20;Perjantai;25;8;33;8;3;11
96;07.03.2014;2014;03;21;Perjantai;16;11;27;1;4;5
96;07.03.2014;2014;03;22;Perjantai;5;5;10;0;4;4
96;07.03.2014;2014;03;23;Perjantai;10;3;13;0;0;0
96;08.03.2014;2014;03;00;Lauantai;4;2;6;0;0;0
96;08.03.2014;2014;03;01;Lauantai;3;0;3;1;0;1
96;08.03.2014;2014;03;02;Lauantai;3;0;3;3;0;3
96;08.03.2014;2014;03;03;Lauantai;3;0;3;2;1;3
96;08.03.2014;2014;03;04;Lauantai;2;0;2;2;0;2
96;08.03.2014;2014;03;05;Lauantai;3;0;3;0;0;0
96;08.03.2014;2014;03;06;Lauantai;7;9;16;4;0;4
96;08.03.2014;2014;03;07;Lauantai;1;7;8;0;2;2
96;08.03.2014;2014;03;08;Lauantai;4;15;19;0;3;3
96;08.03.2014;2014;03;09;Lauantai;9;16;25;5;9;14
96;08.03.2014;2014;03;10;Lauantai;7;20;27;10;11;21
96;08.03.2014;2014;03;11;Lauantai;26;33;59;13;9;22
96;08.03.2014;2014;03;12;Lauantai;31;34;65;22;23;45
96;08.03.2014;2014;03;13;Lauantai;39;31;70;20;29;49
96;08.03.2014;2014;03;14;Lauantai;23;34;57;15;20;35
96;08.03.2014;2014;03;15;Lauantai;34;38;72;18;14;32
96;08.03.2014;2014;03;16;Lauantai;29;38;67;17;13;30
96;08.03.2014;2014;03;17;Lauantai;20;18;38;15;12;27
96;08.03.2014;2014;03;18;Lauantai;25;20;45;17;8;25
96;08.03.2014;2014;03;19;Lauantai;39;19;58;10;12;22
96;08.03.2014;2014;03;20;Lauantai;16;12;28;4;2;6
96;08.03.2014;2014;03;21;Lauantai;11;16;27;4;8;12
96;08.03.2014;2014;03;22;Lauantai;7;7;14;1;1;2
96;08.03.2014;2014;03;23;Lauantai;6;5;11;2;0;2
96;09.03.2014;2014;03;00;Sunnuntai;7;10;17;2;0;2
96;09.03.2014;2014;03;01;Sunnuntai;8;3;11;1;0;1
96;09.03.2014;2014;03;02;Sunnuntai;7;2;9;2;0;2
96;09.03.2014;2014;03;03;Sunnuntai;8;1;9;1;1;2
96;09.03.2014;2014;03;04;Sunnuntai;6;0;6;0;0;0
96;09.03.2014;2014;03;05;Sunnuntai;1;2;3;0;0;0
96;09.03.2014;2014;03;06;Sunnuntai;11;5;16;7;1;8
96;09.03.2014;2014;03;07;Sunnuntai;0;2;2;3;6;9
96;09.03.2014;2014;03;08;Sunnuntai;3;6;9;6;4;10
96;09.03.2014;2014;03;09;Sunnuntai;5;9;14;5;12;17
96;09.03.2014;2014;03;10;Sunnuntai;14;21;35;6;14;20
96;09.03.2014;2014;03;11;Sunnuntai;22;20;42;17;17;34
96;09.03.2014;2014;03;12;Sunnuntai;24;33;57;13;26;39
96;09.03.2014;2014;03;13;Sunnuntai;26;27;53;21;19;40
96;09.03.2014;2014;03;14;Sunnuntai;33;30;63;15;9;24
96;09.03.2014;2014;03;15;Sunnuntai;30;25;55;13;14;27
96;09.03.2014;2014;03;16;Sunnuntai;26;35;61;24;18;42
96;09.03.2014;2014;03;17;Sunnuntai;36;20;56;20;9;29
96;09.03.2014;2014;03;18;Sunnuntai;29;19;48;15;23;38
96;09.03.2014;2014;03;19;Sunnuntai;11;18;29;11;20;31
96;09.03.2014;2014;03;20;Sunnuntai;37;24;61;7;14;21
96;09.03.2014;2014;03;21;Sunnuntai;6;12;18;6;10;16
96;09.03.2014;2014;03;22;Sunnuntai;8;8;16;1;2;3
96;09.03.2014;2014;03;23;Sunnuntai;2;2;4;4;3;7
96;10.03.2014;2014;03;00;Maanantai;2;2;4;1;1;2
96;10.03.2014;2014;03;01;Maanantai;0;0;0;0;0;0
96;10.03.2014;2014;03;02;Maanantai;0;0;0;0;1;1
96;10.03.2014;2014;03;03;Maanantai;2;2;4;0;0;0
96;10.03.2014;2014;03;04;Maanantai;1;2;3;0;0;0
96;10.03.2014;2014;03;05;Maanantai;1;7;8;0;0;0
96;10.03.2014;2014;03;06;Maanantai;36;25;61;6;3;9
96;10.03.2014;2014;03;07;Maanantai;84;84;168;24;9;33
96;10.03.2014;2014;03;08;Maanantai;113;101;214;18;7;25
96;10.03.2014;2014;03;09;Maanantai;65;48;113;18;9;27
96;10.03.2014;2014;03;10;Maanantai;40;50;90;11;15;26
96;10.03.2014;2014;03;11;Maanantai;34;48;82;7;9;16
96;10.03.2014;2014;03;12;Maanantai;58;61;119;16;16;32
96;10.03.2014;2014;03;13;Maanantai;55;60;115;11;16;27
96;10.03.2014;2014;03;14;Maanantai;63;71;134;13;19;32
96;10.03.2014;2014;03;15;Maanantai;62;149;211;7;32;39
96;10.03.2014;2014;03;16;Maanantai;79;147;226;12;37;49
96;10.03.2014;2014;03;17;Maanantai;58;72;130;12;15;27
96;10.03.2014;2014;03;18;Maanantai;47;45;92;21;18;39
96;10.03.2014;2014;03;19;Maanantai;44;34;78;13;21;34
96;10.03.2014;2014;03;20;Maanantai;44;20;64;11;7;18
96;10.03.2014;2014;03;21;Maanantai;23;24;47;1;13;14
96;10.03.2014;2014;03;22;Maanantai;6;8;14;4;5;9
96;10.03.2014;2014;03;23;Maanantai;3;0;3;0;0;0
96;11.03.2014;2014;03;00;Tiistai;0;1;1;0;0;0
96;11.03.2014;2014;03;01;Tiistai;3;0;3;0;0;0
96;11.03.2014;2014;03;02;Tiistai;0;0;0;0;0;0
96;11.03.2014;2014;03;03;Tiistai;1;0;1;0;0;0
96;11.03.2014;2014;03;04;Tiistai;2;2;4;0;0;0
96;11.03.2014;2014;03;05;Tiistai;0;6;6;0;0;0
96;11.03.2014;2014;03;06;Tiistai;37;23;60;4;4;8
96;11.03.2014;2014;03;07;Tiistai;105;85;190;23;6;29
96;11.03.2014;2014;03;08;Tiistai;129;90;219;18;7;25
96;11.03.2014;2014;03;09;Tiistai;47;47;94;9;7;16
96;11.03.2014;2014;03;10;Tiistai;30;55;85;10;13;23
96;11.03.2014;2014;03;11;Tiistai;47;46;93;12;10;22
96;11.03.2014;2014;03;12;Tiistai;61;61;122;17;12;29
96;11.03.2014;2014;03;13;Tiistai;54;68;122;7;19;26
96;11.03.2014;2014;03;14;Tiistai;53;98;151;7;24;31
96;11.03.2014;2014;03;15;Tiistai;75;162;237;13;32;45
96;11.03.2014;2014;03;16;Tiistai;89;161;250;26;29;55
96;11.03.2014;2014;03;17;Tiistai;57;69;126;20;32;52
96;11.03.2014;2014;03;18;Tiistai;56;64;120;25;30;55
96;11.03.2014;2014;03;19;Tiistai;45;33;78;14;22;36
96;11.03.2014;2014;03;20;Tiistai;52;25;77;15;11;26
96;11.03.2014;2014;03;21;Tiistai;43;28;71;17;10;27
96;11.03.2014;2014;03;22;Tiistai;13;3;16;2;2;4
96;11.03.2014;2014;03;23;Tiistai;6;4;10;0;1;1
96;12.03.2014;2014;03;00;Keskiviikko;5;1;6;0;0;0
96;12.03.2014;2014;03;01;Keskiviikko;2;0;2;0;1;1
96;12.03.2014;2014;03;02;Keskiviikko;5;0;5;0;0;0
96;12.03.2014;2014;03;03;Keskiviikko;0;0;0;0;0;0
96;12.03.2014;2014;03;04;Keskiviikko;1;1;2;0;0;0
96;12.03.2014;2014;03;05;Keskiviikko;1;7;8;0;0;0
96;12.03.2014;2014;03;06;Keskiviikko;29;21;50;4;2;6
96;12.03.2014;2014;03;07;Keskiviikko;84;79;163;24;6;30
96;12.03.2014;2014;03;08;Keskiviikko;114;85;199;15;14;29
96;12.03.2014;2014;03;09;Keskiviikko;34;45;79;12;7;19
96;12.03.2014;2014;03;10;Keskiviikko;27;50;77;21;17;38
96;12.03.2014;2014;03;11;Keskiviikko;44;57;101;10;8;18
96;12.03.2014;2014;03;12;Keskiviikko;58;56;114;16;13;29
96;12.03.2014;2014;03;13;Keskiviikko;55;44;99;9;17;26
96;12.03.2014;2014;03;14;Keskiviikko;51;70;121;10;12;22
96;12.03.2014;2014;03;15;Keskiviikko;56;141;197;18;31;49
96;12.03.2014;2014;03;16;Keskiviikko;70;130;200;17;31;48
96;12.03.2014;2014;03;17;Keskiviikko;60;66;126;8;16;24
96;12.03.2014;2014;03;18;Keskiviikko;67;38;105;29;16;45
96;12.03.2014;2014;03;19;Keskiviikko;55;31;86;21;15;36
96;12.03.2014;2014;03;20;Keskiviikko;38;35;73;8;10;18
96;12.03.2014;2014;03;21;Keskiviikko;28;39;67;4;12;16
96;12.03.2014;2014;03;22;Keskiviikko;12;17;29;2;5;7
96;12.03.2014;2014;03;23;Keskiviikko;4;4;8;2;1;3
96;13.03.2014;2014;03;00;Torstai;2;1;3;0;1;1
96;13.03.2014;2014;03;01;Torstai;1;0;1;0;1;1
96;13.03.2014;2014;03;02;Torstai;0;1;1;0;0;0
96;13.03.2014;2014;03;03;Torstai;2;0;2;1;0;1
96;13.03.2014;2014;03;04;Torstai;2;3;5;0;0;0
96;13.03.2014;2014;03;05;Torstai;1;6;7;0;0;0
96;13.03.2014;2014;03;06;Torstai;32;33;65;10;3;13
96;13.03.2014;2014;03;07;Torstai;81;90;171;32;7;39
96;13.03.2014;2014;03;08;Torstai;105;85;190;22;7;29
96;13.03.2014;2014;03;09;Torstai;59;89;148;11;12;23
96;13.03.2014;2014;03;10;Torstai;50;54;104;25;20;45
96;13.03.2014;2014;03;11;Torstai;62;49;111;9;9;18
96;13.03.2014;2014;03;12;Torstai;61;54;115;15;10;25
96;13.03.2014;2014;03;13;Torstai;47;53;100;13;9;22
96;13.03.2014;2014;03;14;Torstai;39;83;122;7;15;22
96;13.03.2014;2014;03;15;Torstai;66;163;229;5;31;36
96;13.03.2014;2014;03;16;Torstai;67;175;242;15;32;47
96;13.03.2014;2014;03;17;Torstai;80;71;151;19;19;38
96;13.03.2014;2014;03;18;Torstai;55;32;87;16;19;35
96;13.03.2014;2014;03;19;Torstai;31;27;58;6;8;14
96;13.03.2014;2014;03;20;Torstai;37;22;59;9;7;16
96;13.03.2014;2014;03;21;Torstai;19;23;42;9;3;12
96;13.03.2014;2014;03;22;Torstai;7;6;13;2;0;2
96;13.03.2014;2014;03;23;Torstai;6;4;10;1;0;1
96;14.03.2014;2014;03;00;Perjantai;2;3;5;0;0;0
96;14.03.2014;2014;03;01;Perjantai;2;1;3;0;0;0
96;14.03.2014;2014;03;02;Perjantai;1;1;2;0;0;0
96;14.03.2014;2014;03;03;Perjantai;4;0;4;1;0;1
96;14.03.2014;2014;03;04;Perjantai;4;3;7;1;0;1
96;14.03.2014;2014;03;05;Perjantai;2;4;6;0;0;0
96;14.03.2014;2014;03;06;Perjantai;30;25;55;3;3;6
96;14.03.2014;2014;03;07;Perjantai;92;70;162;20;10;30
96;14.03.2014;2014;03;08;Perjantai;83;75;158;24;12;36
96;14.03.2014;2014;03;09;Perjantai;35;43;78;4;8;12
96;14.03.2014;2014;03;10;Perjantai;32;63;95;4;11;15
96;14.03.2014;2014;03;11;Perjantai;49;59;108;8;18;26
96;14.03.2014;2014;03;12;Perjantai;52;46;98;14;12;26
96;14.03.2014;2014;03;13;Perjantai;49;62;111;24;11;35
96;14.03.2014;2014;03;14;Perjantai;52;118;170;6;20;26
96;14.03.2014;2014;03;15;Perjantai;51;125;176;13;27;40
96;14.03.2014;2014;03;16;Perjantai;62;69;131;9;9;18
96;14.03.2014;2014;03;17;Perjantai;52;41;93;8;9;17
96;14.03.2014;2014;03;18;Perjantai;28;29;57;39;50;89
96;14.03.2014;2014;03;19;Perjantai;21;19;40;12;10;22
96;14.03.2014;2014;03;20;Perjantai;33;22;55;11;2;13
96;14.03.2014;2014;03;21;Perjantai;16;12;28;0;6;6
96;14.03.2014;2014;03;22;Perjantai;7;5;12;2;3;5
96;14.03.2014;2014;03;23;Perjantai;11;5;16;1;0;1
96;15.03.2014;2014;03;00;Lauantai;8;5;13;1;2;3
96;15.03.2014;2014;03;01;Lauantai;9;2;11;1;0;1
96;15.03.2014;2014;03;02;Lauantai;3;2;5;2;2;4
96;15.03.2014;2014;03;03;Lauantai;6;2;8;2;0;2
96;15.03.2014;2014;03;04;Lauantai;6;1;7;3;1;4
96;15.03.2014;2014;03;05;Lauantai;0;1;1;0;0;0
96;15.03.2014;2014;03;06;Lauantai;10;12;22;4;1;5
96;15.03.2014;2014;03;07;Lauantai;2;11;13;1;2;3
96;15.03.2014;2014;03;08;Lauantai;9;14;23;4;9;13
96;15.03.2014;2014;03;09;Lauantai;10;37;47;8;14;22
96;15.03.2014;2014;03;10;Lauantai;20;39;59;11;12;23
96;15.03.2014;2014;03;11;Lauantai;34;42;76;13;18;31
96;15.03.2014;2014;03;12;Lauantai;37;57;94;15;13;28
96;15.03.2014;2014;03;13;Lauantai;37;42;79;13;18;31
96;15.03.2014;2014;03;14;Lauantai;47;46;93;14;13;27
96;15.03.2014;2014;03;15;Lauantai;39;37;76;12;22;34
96;15.03.2014;2014;03;16;Lauantai;28;14;42;10;16;26
96;15.03.2014;2014;03;17;Lauantai;41;17;58;21;5;26
96;15.03.2014;2014;03;18;Lauantai;42;22;64;14;2;16
96;15.03.2014;2014;03;19;Lauantai;17;16;33;10;11;21
96;15.03.2014;2014;03;20;Lauantai;16;19;35;4;12;16
96;15.03.2014;2014;03;21;Lauantai;12;20;32;3;8;11
96;15.03.2014;2014;03;22;Lauantai;8;7;15;1;3;4
96;15.03.2014;2014;03;23;Lauantai;11;7;18;0;1;1
96;16.03.2014;2014;03;00;Sunnuntai;4;7;11;2;0;2
96;16.03.2014;2014;03;01;Sunnuntai;3;0;3;2;0;2
96;16.03.2014;2014;03;02;Sunnuntai;9;1;10;0;0;0
96;16.03.2014;2014;03;03;Sunnuntai;15;0;15;2;0;2
96;16.03.2014;2014;03;04;Sunnuntai;4;0;4;5;0;5
96;16.03.2014;2014;03;05;Sunnuntai;1;0;1;0;0;0
96;16.03.2014;2014;03;06;Sunnuntai;9;1;10;4;2;6
96;16.03.2014;2014;03;07;Sunnuntai;2;6;8;1;4;5
96;16.03.2014;2014;03;08;Sunnuntai;7;3;10;5;9;14
96;16.03.2014;2014;03;09;Sunnuntai;9;12;21;8;7;15
96;16.03.2014;2014;03;10;Sunnuntai;6;12;18;12;9;21
96;16.03.2014;2014;03;11;Sunnuntai;12;24;36;11;12;23
96;16.03.2014;2014;03;12;Sunnuntai;17;36;53;16;21;37
96;16.03.2014;2014;03;13;Sunnuntai;26;38;64;21;21;42
96;16.03.2014;2014;03;14;Sunnuntai;21;30;51;17;22;39
96;16.03.2014;2014;03;15;Sunnuntai;34;23;57;18;24;42
96;16.03.2014;2014;03;16;Sunnuntai;43;28;71;29;13;42
96;16.03.2014;2014;03;17;Sunnuntai;36;14;50;7;19;26
96;16.03.2014;2014;03;18;Sunnuntai;20;31;51;20;21;41
96;16.03.2014;2014;03;19;Sunnuntai;12;19;31;22;18;40
96;16.03.2014;2014;03;20;Sunnuntai;15;24;39;13;8;21
96;16.03.2014;2014;03;21;Sunnuntai;17;18;35;3;6;9
96;16.03.2014;2014;03;22;Sunnuntai;5;7;12;0;0;0
96;16.03.2014;2014;03;23;Sunnuntai;3;1;4;1;1;2
96;17.03.2014;2014;03;00;Maanantai;3;0;3;0;0;0
96;17.03.2014;2014;03;01;Maanantai;1;0;1;0;0;0
96;17.03.2014;2014;03;02;Maanantai;0;0;0;0;0;0
96;17.03.2014;2014;03;03;Maanantai;0;0;0;0;1;1
96;17.03.2014;2014;03;04;Maanantai;3;1;4;0;0;0
96;17.03.2014;2014;03;05;Maanantai;0;7;7;1;2;3
96;17.03.2014;2014;03;06;Maanantai;25;20;45;14;0;14
96;17.03.2014;2014;03;07;Maanantai;80;67;147;29;10;39
96;17.03.2014;2014;03;08;Maanantai;93;83;176;24;8;32
96;17.03.2014;2014;03;09;Maanantai;41;52;93;8;5;13
96;17.03.2014;2014;03;10;Maanantai;36;58;94;10;18;28
96;17.03.2014;2014;03;11;Maanantai;35;50;85;12;14;26
96;17.03.2014;2014;03;12;Maanantai;48;42;90;13;15;28
96;17.03.2014;2014;03;13;Maanantai;49;58;107;12;18;30
96;17.03.2014;2014;03;14;Maanantai;68;72;140;15;23;38
96;17.03.2014;2014;03;15;Maanantai;66;132;198;19;36;55
96;17.03.2014;2014;03;16;Maanantai;73;110;183;9;46;55
96;17.03.2014;2014;03;17;Maanantai;51;60;111;17;15;32
96;17.03.2014;2014;03;18;Maanantai;44;47;91;19;21;40
96;17.03.2014;2014;03;19;Maanantai;34;29;63;13;20;33
96;17.03.2014;2014;03;20;Maanantai;37;22;59;11;13;24
96;17.03.2014;2014;03;21;Maanantai;33;24;57;5;6;11
96;17.03.2014;2014;03;22;Maanantai;9;8;17;3;3;6
96;17.03.2014;2014;03;23;Maanantai;3;3;6;1;2;3
96;18.03.2014;2014;03;00;Tiistai;3;1;4;0;0;0
96;18.03.2014;2014;03;01;Tiistai;1;1;2;0;0;0
96;18.03.2014;2014;03;02;Tiistai;0;0;0;0;0;0
96;18.03.2014;2014;03;03;Tiistai;0;0;0;0;0;0
96;18.03.2014;2014;03;04;Tiistai;1;2;3;0;0;0
96;18.03.2014;2014;03;05;Tiistai;2;6;8;0;1;1
96;18.03.2014;2014;03;06;Tiistai;39;30;69;15;2;17
96;18.03.2014;2014;03;07;Tiistai;91;69;160;24;5;29
96;18.03.2014;2014;03;08;Tiistai;116;91;207;21;6;27
96;18.03.2014;2014;03;09;Tiistai;37;54;91;14;7;21
96;18.03.2014;2014;03;10;Tiistai;40;43;83;13;8;21
96;18.03.2014;2014;03;11;Tiistai;31;50;81;12;22;34
96;18.03.2014;2014;03;12;Tiistai;49;43;92;19;29;48
96;18.03.2014;2014;03;13;Tiistai;53;56;109;13;25;38
96;18.03.2014;2014;03;14;Tiistai;45;91;136;7;21;28
96;18.03.2014;2014;03;15;Tiistai;71;170;241;12;46;58
96;18.03.2014;2014;03;16;Tiistai;75;118;193;17;25;42
96;18.03.2014;2014;03;17;Tiistai;56;57;113;10;17;27
96;18.03.2014;2014;03;18;Tiistai;36;49;85;26;25;51
96;18.03.2014;2014;03;19;Tiistai;51;37;88;20;14;34
96;18.03.2014;2014;03;20;Tiistai;53;24;77;18;18;36
96;18.03.2014;2014;03;21;Tiistai;32;25;57;4;3;7
96;18.03.2014;2014;03;22;Tiistai;10;4;14;2;1;3
96;18.03.2014;2014;03;23;Tiistai;2;1;3;0;1;1
96;19.03.2014;2014;03;00;Keskiviikko;1;1;2;0;0;0
96;19.03.2014;2014;03;01;Keskiviikko;4;0;4;0;0;0
96;19.03.2014;2014;03;02;Keskiviikko;0;0;0;0;0;0
96;19.03.2014;2014;03;03;Keskiviikko;1;0;1;0;0;0
96;19.03.2014;2014;03;04;Keskiviikko;1;1;2;0;0;0
96;19.03.2014;2014;03;05;Keskiviikko;1;7;8;0;0;0
96;19.03.2014;2014;03;06;Keskiviikko;33;33;66;10;5;15
96;19.03.2014;2014;03;07;Keskiviikko;86;83;169;22;4;26
96;19.03.2014;2014;03;08;Keskiviikko;111;82;193;24;13;37
96;19.03.2014;2014;03;09;Keskiviikko;40;53;93;11;9;20
96;19.03.2014;2014;03;10;Keskiviikko;37;44;81;18;19;37
96;19.03.2014;2014;03;11;Keskiviikko;40;38;78;12;11;23
96;19.03.2014;2014;03;12;Keskiviikko;61;46;107;18;26;44
96;19.03.2014;2014;03;13;Keskiviikko;41;61;102;7;12;19
96;19.03.2014;2014;03;14;Keskiviikko;50;93;143;9;27;36
96;19.03.2014;2014;03;15;Keskiviikko;57;143;200;9;30;39
96;19.03.2014;2014;03;16;Keskiviikko;80;113;193;10;33;43
96;19.03.2014;2014;03;17;Keskiviikko;59;85;144;9;16;25
96;19.03.2014;2014;03;18;Keskiviikko;66;52;118;13;21;34
96;19.03.2014;2014;03;19;Keskiviikko;52;21;73;12;15;27
96;19.03.2014;2014;03;20;Keskiviikko;28;36;64;9;13;22
96;19.03.2014;2014;03;21;Keskiviikko;22;45;67;3;12;15
96;19.03.2014;2014;03;22;Keskiviikko;12;6;18;2;7;9
96;19.03.2014;2014;03;23;Keskiviikko;6;5;11;0;1;1
96;20.03.2014;2014;03;00;Torstai;2;2;4;0;1;1
96;20.03.2014;2014;03;01;Torstai;7;0;7;1;0;1
96;20.03.2014;2014;03;02;Torstai;2;0;2;1;1;2
96;20.03.2014;2014;03;03;Torstai;2;0;2;0;0;0
96;20.03.2014;2014;03;04;Torstai;3;1;4;1;0;1
96;20.03.2014;2014;03;05;Torstai;3;6;9;0;0;0
96;20.03.2014;2014;03;06;Torstai;38;26;64;5;2;7
96;20.03.2014;2014;03;07;Torstai;96;70;166;27;11;38
96;20.03.2014;2014;03;08;Torstai;116;83;199;17;11;28
96;20.03.2014;2014;03;09;Torstai;41;57;98;8;14;22
96;20.03.2014;2014;03;10;Torstai;41;45;86;29;14;43
96;20.03.2014;2014;03;11;Torstai;54;48;102;7;12;19
96;20.03.2014;2014;03;12;Torstai;42;55;97;16;30;46
96;20.03.2014;2014;03;13;Torstai;63;63;126;15;9;24
96;20.03.2014;2014;03;14;Torstai;46;79;125;12;13;25
96;20.03.2014;2014;03;15;Torstai;61;156;217;8;32;40
96;20.03.2014;2014;03;16;Torstai;67;119;186;13;33;46
96;20.03.2014;2014;03;17;Torstai;44;72;116;15;18;33
96;20.03.2014;2014;03;18;Torstai;45;36;81;17;20;37
96;20.03.2014;2014;03;19;Torstai;49;27;76;13;15;28
96;20.03.2014;2014;03;20;Torstai;34;20;54;4;20;24
96;20.03.2014;2014;03;21;Torstai;25;22;47;5;4;9
96;20.03.2014;2014;03;22;Torstai;7;6;13;2;3;5
96;20.03.2014;2014;03;23;Torstai;4;4;8;3;1;4
96;21.03.2014;2014;03;00;Perjantai;0;0;0;0;0;0
96;21.03.2014;2014;03;01;Perjantai;0;1;1;1;0;1
96;21.03.2014;2014;03;02;Perjantai;1;0;1;0;0;0
96;21.03.2014;2014;03;03;Perjantai;3;0;3;0;0;0
96;21.03.2014;2014;03;04;Perjantai;2;3;5;0;0;0
96;21.03.2014;2014;03;05;Perjantai;2;4;6;0;1;1
96;21.03.2014;2014;03;06;Perjantai;25;18;43;15;4;19
96;21.03.2014;2014;03;07;Perjantai;61;52;113;23;8;31
96;21.03.2014;2014;03;08;Perjantai;71;53;124;16;8;24
96;21.03.2014;2014;03;09;Perjantai;24;35;59;8;4;12
96;21.03.2014;2014;03;10;Perjantai;17;33;50;7;6;13
96;21.03.2014;2014;03;11;Perjantai;19;37;56;5;11;16
96;21.03.2014;2014;03;12;Perjantai;30;34;64;18;8;26
96;21.03.2014;2014;03;13;Perjantai;30;37;67;6;13;19
96;21.03.2014;2014;03;14;Perjantai;41;61;102;7;23;30
96;21.03.2014;2014;03;15;Perjantai;35;86;121;11;16;27
96;21.03.2014;2014;03;16;Perjantai;38;68;106;11;24;35
96;21.03.2014;2014;03;17;Perjantai;32;37;69;7;20;27
96;21.03.2014;2014;03;18;Perjantai;25;32;57;6;20;26
96;21.03.2014;2014;03;19;Perjantai;11;16;27;10;4;14
96;21.03.2014;2014;03;20;Perjantai;21;10;31;3;4;7
96;21.03.2014;2014;03;21;Perjantai;35;24;59;9;4;13
96;21.03.2014;2014;03;22;Perjantai;7;6;13;5;3;8
96;21.03.2014;2014;03;23;Perjantai;5;0;5;3;0;3
96;22.03.2014;2014;03;00;Lauantai;13;5;18;3;0;3
96;22.03.2014;2014;03;01;Lauantai;5;2;7;1;0;1
96;22.03.2014;2014;03;02;Lauantai;6;2;8;0;0;0
96;22.03.2014;2014;03;03;Lauantai;5;1;6;4;1;5
96;22.03.2014;2014;03;04;Lauantai;3;0;3;0;0;0
96;22.03.2014;2014;03;05;Lauantai;1;1;2;2;1;3
96;22.03.2014;2014;03;06;Lauantai;15;5;20;4;2;6
96;22.03.2014;2014;03;07;Lauantai;4;10;14;2;3;5
96;22.03.2014;2014;03;08;Lauantai;3;11;14;7;7;14
96;22.03.2014;2014;03;09;Lauantai;13;22;35;10;10;20
96;22.03.2014;2014;03;10;Lauantai;14;20;34;18;11;29
96;22.03.2014;2014;03;11;Lauantai;15;22;37;15;13;28
96;22.03.2014;2014;03;12;Lauantai;21;19;40;11;11;22
96;22.03.2014;2014;03;13;Lauantai;29;23;52;14;20;34
96;22.03.2014;2014;03;14;Lauantai;25;37;62;14;9;23
96;22.03.2014;2014;03;15;Lauantai;28;42;70;12;24;36
96;22.03.2014;2014;03;16;Lauantai;26;28;54;10;13;23
96;22.03.2014;2014;03;17;Lauantai;25;33;58;18;9;27
96;22.03.2014;2014;03;18;Lauantai;36;21;57;21;8;29
96;22.03.2014;2014;03;19;Lauantai;19;24;43;11;14;25
96;22.03.2014;2014;03;20;Lauantai;13;13;26;10;8;18
96;22.03.2014;2014;03;21;Lauantai;8;13;21;2;10;12
96;22.03.2014;2014;03;22;Lauantai;4;34;38;2;11;13
96;22.03.2014;2014;03;23;Lauantai;7;11;18;1;2;3
96;23.03.2014;2014;03;00;Sunnuntai;12;13;25;2;1;3
96;23.03.2014;2014;03;01;Sunnuntai;8;5;13;0;0;0
96;23.03.2014;2014;03;02;Sunnuntai;7;0;7;0;1;1
96;23.03.2014;2014;03;03;Sunnuntai;10;1;11;0;0;0
96;23.03.2014;2014;03;04;Sunnuntai;10;1;11;3;0;3
96;23.03.2014;2014;03;05;Sunnuntai;2;0;2;1;1;2
96;23.03.2014;2014;03;06;Sunnuntai;10;5;15;0;2;2
96;23.03.2014;2014;03;07;Sunnuntai;5;5;10;1;4;5
96;23.03.2014;2014;03;08;Sunnuntai;0;5;5;4;7;11
96;23.03.2014;2014;03;09;Sunnuntai;9;6;15;7;8;15
96;23.03.2014;2014;03;10;Sunnuntai;12;24;36;12;8;20
96;23.03.2014;2014;03;11;Sunnuntai;13;20;33;14;17;31
96;23.03.2014;2014;03;12;Sunnuntai;16;29;45;11;18;29
96;23.03.2014;2014;03;13;Sunnuntai;42;25;67;19;15;34
96;23.03.2014;2014;03;14;Sunnuntai;20;22;42;13;15;28
96;23.03.2014;2014;03;15;Sunnuntai;21;29;50;15;16;31
96;23.03.2014;2014;03;16;Sunnuntai;23;15;38;32;11;43
96;23.03.2014;2014;03;17;Sunnuntai;24;24;48;21;12;33
96;23.03.2014;2014;03;18;Sunnuntai;42;15;57;27;19;46
96;23.03.2014;2014;03;19;Sunnuntai;19;26;45;15;22;37
96;23.03.2014;2014;03;20;Sunnuntai;17;12;29;14;19;33
96;23.03.2014;2014;03;21;Sunnuntai;15;21;36;5;10;15
96;23.03.2014;2014;03;22;Sunnuntai;5;3;8;4;2;6
96;23.03.2014;2014;03;23;Sunnuntai;0;4;4;0;0;0
96;31.03.2014;2014;03;00;Maanantai;3;2;5;4;3;7
96;31.03.2014;2014;03;01;Maanantai;1;0;1;1;0;1
96;31.03.2014;2014;03;02;Maanantai;0;0;0;0;0;0
96;31.03.2014;2014;03;03;Maanantai;1;1;2;1;0;1
96;31.03.2014;2014;03;04;Maanantai;2;1;3;0;0;0
96;31.03.2014;2014;03;05;Maanantai;1;6;7;1;1;2
96;31.03.2014;2014;03;06;Maanantai;29;26;55;5;1;6
96;31.03.2014;2014;03;07;Maanantai;105;66;171;19;9;28
96;31.03.2014;2014;03;08;Maanantai;85;90;175;18;9;27
96;31.03.2014;2014;03;09;Maanantai;39;68;107;10;5;15
96;31.03.2014;2014;03;10;Maanantai;47;41;88;6;10;16
96;31.03.2014;2014;03;11;Maanantai;53;62;115;12;8;20
96;31.03.2014;2014;03;12;Maanantai;53;62;115;18;9;27
96;31.03.2014;2014;03;13;Maanantai;50;62;112;10;12;22
96;31.03.2014;2014;03;14;Maanantai;58;91;149;9;19;28
96;31.03.2014;2014;03;15;Maanantai;82;145;227;9;29;38
96;31.03.2014;2014;03;16;Maanantai;77;145;222;15;26;41
96;31.03.2014;2014;03;17;Maanantai;67;74;141;15;20;35
96;31.03.2014;2014;03;18;Maanantai;56;59;115;32;29;61
96;31.03.2014;2014;03;19;Maanantai;46;31;77;16;28;44
96;31.03.2014;2014;03;20;Maanantai;34;23;57;15;13;28
96;31.03.2014;2014;03;21;Maanantai;21;25;46;7;5;12
96;31.03.2014;2014;03;22;Maanantai;9;2;11;1;4;5
96;31.03.2014;2014;03;23;Maanantai;3;7;10;5;1;6
96;01.04.2014;2014;04;00;Tiistai;2;5;7;1;0;1
96;01.04.2014;2014;04;01;Tiistai;0;0;0;0;0;0
96;01.04.2014;2014;04;02;Tiistai;0;0;0;0;0;0
96;01.04.2014;2014;04;03;Tiistai;2;1;3;0;0;0
96;01.04.2014;2014;04;04;Tiistai;2;1;3;0;0;0
96;01.04.2014;2014;04;05;Tiistai;4;7;11;0;1;1
96;01.04.2014;2014;04;06;Tiistai;34;23;57;9;3;12
96;01.04.2014;2014;04;07;Tiistai;98;70;168;25;8;33
96;01.04.2014;2014;04;08;Tiistai;125;99;224;13;10;23
96;01.04.2014;2014;04;09;Tiistai;47;64;111;17;12;29
96;01.04.2014;2014;04;10;Tiistai;53;47;100;8;7;15
96;01.04.2014;2014;04;11;Tiistai;42;50;92;9;7;16
96;01.04.2014;2014;04;12;Tiistai;57;61;118;15;13;28
96;01.04.2014;2014;04;13;Tiistai;44;63;107;7;14;21
96;01.04.2014;2014;04;14;Tiistai;62;79;141;10;13;23
96;01.04.2014;2014;04;15;Tiistai;77;159;236;9;28;37
96;01.04.2014;2014;04;16;Tiistai;91;146;237;11;30;41
96;01.04.2014;2014;04;17;Tiistai;75;78;153;9;15;24
96;01.04.2014;2014;04;18;Tiistai;46;41;87;29;18;47
96;01.04.2014;2014;04;19;Tiistai;45;37;82;16;20;36
96;01.04.2014;2014;04;20;Tiistai;52;21;73;17;15;32
96;01.04.2014;2014;04;21;Tiistai;38;31;69;3;6;9
96;01.04.2014;2014;04;22;Tiistai;13;7;20;6;0;6
96;01.04.2014;2014;04;23;Tiistai;5;1;6;0;4;4
96;02.04.2014;2014;04;00;Keskiviikko;5;0;5;1;0;1
96;02.04.2014;2014;04;01;Keskiviikko;1;0;1;0;0;0
96;02.04.2014;2014;04;02;Keskiviikko;0;0;0;0;1;1
96;02.04.2014;2014;04;03;Keskiviikko;0;0;0;0;0;0
96;02.04.2014;2014;04;04;Keskiviikko;1;0;1;0;0;0
96;02.04.2014;2014;04;05;Keskiviikko;3;7;10;1;0;1
96;02.04.2014;2014;04;06;Keskiviikko;31;22;53;5;3;8
96;02.04.2014;2014;04;07;Keskiviikko;106;98;204;24;8;32
96;02.04.2014;2014;04;08;Keskiviikko;118;89;207;14;8;22
96;02.04.2014;2014;04;09;Keskiviikko;49;51;100;15;6;21
96;02.04.2014;2014;04;10;Keskiviikko;41;62;103;7;18;25
96;02.04.2014;2014;04;11;Keskiviikko;53;62;115;8;9;17
96;02.04.2014;2014;04;12;Keskiviikko;71;64;135;18;14;32
96;02.04.2014;2014;04;13;Keskiviikko;66;75;141;12;17;29
96;02.04.2014;2014;04;14;Keskiviikko;71;91;162;11;16;27
96;02.04.2014;2014;04;15;Keskiviikko;65;165;230;14;32;46
96;02.04.2014;2014;04;16;Keskiviikko;80;126;206;15;26;41
96;02.04.2014;2014;04;17;Keskiviikko;59;113;172;10;16;26
96;02.04.2014;2014;04;18;Keskiviikko;61;78;139;20;14;34
96;02.04.2014;2014;04;19;Keskiviikko;59;31;90;26;20;46
96;02.04.2014;2014;04;20;Keskiviikko;50;35;85;6;19;25
96;02.04.2014;2014;04;21;Keskiviikko;59;35;94;15;4;19
96;02.04.2014;2014;04;22;Keskiviikko;11;8;19;8;3;11
96;02.04.2014;2014;04;23;Keskiviikko;3;1;4;1;3;4
96;03.04.2014;2014;04;00;Torstai;2;0;2;0;0;0
96;03.04.2014;2014;04;01;Torstai;0;1;1;0;1;1
96;03.04.2014;2014;04;02;Torstai;2;0;2;1;0;1
96;03.04.2014;2014;04;03;Torstai;1;0;1;0;0;0
96;03.04.2014;2014;04;04;Torstai;2;2;4;0;0;0
96;03.04.2014;2014;04;05;Torstai;1;5;6;0;0;0
96;03.04.2014;2014;04;06;Torstai;28;21;49;6;1;7
96;03.04.2014;2014;04;07;Torstai;87;78;165;16;4;20
96;03.04.2014;2014;04;08;Torstai;97;97;194;12;12;24
96;03.04.2014;2014;04;09;Torstai;65;63;128;11;9;20
96;03.04.2014;2014;04;10;Torstai;42;44;86;17;9;26
96;03.04.2014;2014;04;11;Torstai;44;40;84;12;13;25
96;03.04.2014;2014;04;12;Torstai;61;57;118;18;17;35
96;03.04.2014;2014;04;13;Torstai;59;62;121;12;9;21
96;03.04.2014;2014;04;14;Torstai;60;80;140;9;19;28
96;03.04.2014;2014;04;15;Torstai;76;163;239;7;36;43
96;03.04.2014;2014;04;16;Torstai;87;125;212;13;21;34
96;03.04.2014;2014;04;17;Torstai;75;61;136;9;14;23
96;03.04.2014;2014;04;18;Torstai;55;64;119;14;16;30
96;03.04.2014;2014;04;19;Torstai;52;40;92;19;16;35
96;03.04.2014;2014;04;20;Torstai;50;26;76;11;10;21
96;03.04.2014;2014;04;21;Torstai;38;27;65;7;9;16
96;03.04.2014;2014;04;22;Torstai;11;10;21;2;3;5
96;03.04.2014;2014;04;23;Torstai;7;11;18;0;1;1
96;04.04.2014;2014;04;00;Perjantai;1;3;4;1;2;3
96;04.04.2014;2014;04;01;Perjantai;5;1;6;0;0;0
96;04.04.2014;2014;04;02;Perjantai;14;0;14;0;0;0
96;04.04.2014;2014;04;03;Perjantai;0;0;0;0;0;0
96;04.04.2014;2014;04;04;Perjantai;6;0;6;2;1;3
96;04.04.2014;2014;04;05;Perjantai;3;5;8;0;0;0
96;04.04.2014;2014;04;06;Perjantai;35;20;55;7;1;8
96;04.04.2014;2014;04;07;Perjantai;102;74;176;23;8;31
96;04.04.2014;2014;04;08;Perjantai;98;67;165;15;8;23
96;04.04.2014;2014;04;09;Perjantai;44;75;119;11;8;19
96;04.04.2014;2014;04;10;Perjantai;32;45;77;12;8;20
96;04.04.2014;2014;04;11;Perjantai;40;46;86;8;10;18
96;04.04.2014;2014;04;12;Perjantai;52;66;118;17;11;28
96;04.04.2014;2014;04;13;Perjantai;60;79;139;11;15;26
96;04.04.2014;2014;04;14;Perjantai;61;101;162;5;24;29
96;04.04.2014;2014;04;15;Perjantai;75;128;203;6;30;36
96;04.04.2014;2014;04;16;Perjantai;66;84;150;9;15;24
96;04.04.2014;2014;04;17;Perjantai;53;43;96;14;18;32
96;04.04.2014;2014;04;18;Perjantai;54;29;83;12;12;24
96;04.04.2014;2014;04;19;Perjantai;28;38;66;11;13;24
96;04.04.2014;2014;04;20;Perjantai;40;13;53;6;6;12
96;04.04.2014;2014;04;21;Perjantai;15;27;42;8;5;13
96;04.04.2014;2014;04;22;Perjantai;7;12;19;2;1;3
96;04.04.2014;2014;04;23;Perjantai;12;6;18;2;1;3
96;05.04.2014;2014;04;00;Lauantai;11;4;15;2;2;4
96;05.04.2014;2014;04;01;Lauantai;4;1;5;2;0;2
96;05.04.2014;2014;04;02;Lauantai;2;0;2;1;0;1
96;05.04.2014;2014;04;03;Lauantai;7;0;7;1;0;1
96;05.04.2014;2014;04;04;Lauantai;0;0;0;1;1;2
96;05.04.2014;2014;04;05;Lauantai;0;1;1;2;0;2
96;05.04.2014;2014;04;06;Lauantai;15;7;22;6;0;6
96;05.04.2014;2014;04;07;Lauantai;4;11;15;2;7;9
96;05.04.2014;2014;04;08;Lauantai;3;15;18;1;4;5
96;05.04.2014;2014;04;09;Lauantai;12;30;42;6;6;12
96;05.04.2014;2014;04;10;Lauantai;17;43;60;10;11;21
96;05.04.2014;2014;04;11;Lauantai;24;25;49;11;12;23
96;05.04.2014;2014;04;12;Lauantai;26;36;62;9;20;29
96;05.04.2014;2014;04;13;Lauantai;37;46;83;14;11;25
96;05.04.2014;2014;04;14;Lauantai;47;34;81;13;7;20
96;05.04.2014;2014;04;15;Lauantai;33;43;76;12;18;30
96;05.04.2014;2014;04;16;Lauantai;29;45;74;8;25;33
96;05.04.2014;2014;04;17;Lauantai;23;25;48;9;6;15
96;05.04.2014;2014;04;18;Lauantai;50;18;68;15;11;26
96;05.04.2014;2014;04;19;Lauantai;47;12;59;25;9;34
96;05.04.2014;2014;04;20;Lauantai;21;15;36;8;8;16
96;05.04.2014;2014;04;21;Lauantai;14;22;36;4;5;9
96;05.04.2014;2014;04;22;Lauantai;2;9;11;0;3;3
96;05.04.2014;2014;04;23;Lauantai;5;4;9;3;3;6
96;06.04.2014;2014;04;00;Sunnuntai;5;3;8;2;2;4
96;06.04.2014;2014;04;01;Sunnuntai;4;1;5;0;0;0
96;06.04.2014;2014;04;02;Sunnuntai;8;0;8;4;0;4
96;06.04.2014;2014;04;03;Sunnuntai;10;2;12;1;0;1
96;06.04.2014;2014;04;04;Sunnuntai;2;0;2;3;1;4
96;06.04.2014;2014;04;05;Sunnuntai;3;2;5;0;0;0
96;06.04.2014;2014;04;06;Sunnuntai;9;4;13;5;1;6
96;06.04.2014;2014;04;07;Sunnuntai;3;10;13;2;3;5
96;06.04.2014;2014;04;08;Sunnuntai;1;7;8;3;5;8
96;06.04.2014;2014;04;09;Sunnuntai;3;9;12;8;9;17
96;06.04.2014;2014;04;10;Sunnuntai;20;22;42;15;21;36
96;06.04.2014;2014;04;11;Sunnuntai;14;35;49;14;11;25
96;06.04.2014;2014;04;12;Sunnuntai;31;41;72;8;13;21
96;06.04.2014;2014;04;13;Sunnuntai;52;46;98;19;20;39
96;06.04.2014;2014;04;14;Sunnuntai;31;34;65;6;22;28
96;06.04.2014;2014;04;15;Sunnuntai;48;37;85;17;14;31
96;06.04.2014;2014;04;16;Sunnuntai;55;35;90;27;20;47
96;06.04.2014;2014;04;17;Sunnuntai;29;31;60;19;14;33
96;06.04.2014;2014;04;18;Sunnuntai;33;22;55;24;22;46
96;06.04.2014;2014;04;19;Sunnuntai;25;31;56;12;18;30
96;06.04.2014;2014;04;20;Sunnuntai;16;26;42;20;14;34
96;06.04.2014;2014;04;21;Sunnuntai;14;16;30;11;5;16
96;06.04.2014;2014;04;22;Sunnuntai;4;5;9;5;4;9
96;06.04.2014;2014;04;23;Sunnuntai;3;1;4;2;3;5
96;07.04.2014;2014;04;00;Maanantai;3;2;5;0;2;2
96;07.04.2014;2014;04;01;Maanantai;1;0;1;0;0;0
96;07.04.2014;2014;04;02;Maanantai;0;1;1;0;1;1
96;07.04.2014;2014;04;03;Maanantai;0;1;1;0;0;0
96;07.04.2014;2014;04;04;Maanantai;2;1;3;1;0;1
96;07.04.2014;2014;04;05;Maanantai;0;6;6;2;0;2
96;07.04.2014;2014;04;06;Maanantai;34;25;59;5;1;6
96;07.04.2014;2014;04;07;Maanantai;103;79;182;21;8;29
96;07.04.2014;2014;04;08;Maanantai;101;106;207;14;12;26
96;07.04.2014;2014;04;09;Maanantai;46;78;124;9;10;19
96;07.04.2014;2014;04;10;Maanantai;43;65;108;14;8;22
96;07.04.2014;2014;04;11;Maanantai;47;64;111;18;12;30
96;07.04.2014;2014;04;12;Maanantai;73;49;122;17;12;29
96;07.04.2014;2014;04;13;Maanantai;78;85;163;14;13;27
96;07.04.2014;2014;04;14;Maanantai;76;117;193;8;20;28
96;07.04.2014;2014;04;15;Maanantai;85;159;244;14;22;36
96;07.04.2014;2014;04;16;Maanantai;107;145;252;19;31;50
96;07.04.2014;2014;04;17;Maanantai;78;66;144;19;13;32
96;07.04.2014;2014;04;18;Maanantai;68;50;118;17;16;33
96;07.04.2014;2014;04;19;Maanantai;46;33;79;14;19;33
96;07.04.2014;2014;04;20;Maanantai;31;30;61;8;9;17
96;07.04.2014;2014;04;21;Maanantai;45;27;72;10;4;14
96;07.04.2014;2014;04;22;Maanantai;5;11;16;2;1;3
96;07.04.2014;2014;04;23;Maanantai;7;2;9;1;1;2
96;08.04.2014;2014;04;00;Tiistai;0;0;0;0;1;1
96;08.04.2014;2014;04;01;Tiistai;0;0;0;0;0;0
96;08.04.2014;2014;04;02;Tiistai;1;1;2;0;0;0
96;08.04.2014;2014;04;03;Tiistai;0;0;0;0;0;0
96;08.04.2014;2014;04;04;Tiistai;1;1;2;0;0;0
96;08.04.2014;2014;04;05;Tiistai;0;9;9;0;1;1
96;08.04.2014;2014;04;06;Tiistai;33;28;61;10;2;12
96;08.04.2014;2014;04;07;Tiistai;130;86;216;19;6;25
96;08.04.2014;2014;04;08;Tiistai;107;109;216;21;11;32
96;08.04.2014;2014;04;09;Tiistai;46;75;121;8;2;10
96;08.04.2014;2014;04;10;Tiistai;47;56;103;14;16;30
96;08.04.2014;2014;04;11;Tiistai;55;61;116;8;16;24
96;08.04.2014;2014;04;12;Tiistai;70;61;131;15;12;27
96;08.04.2014;2014;04;13;Tiistai;75;75;150;16;10;26
96;08.04.2014;2014;04;14;Tiistai;79;107;186;13;13;26
96;08.04.2014;2014;04;15;Tiistai;75;152;227;11;23;34
96;08.04.2014;2014;04;16;Tiistai;106;146;252;14;31;45
96;08.04.2014;2014;04;17;Tiistai;78;62;140;16;16;32
96;08.04.2014;2014;04;18;Tiistai;52;54;106;21;30;51
96;08.04.2014;2014;04;19;Tiistai;58;35;93;16;11;27
96;08.04.2014;2014;04;20;Tiistai;48;43;91;12;25;37
96;08.04.2014;2014;04;21;Tiistai;16;25;41;4;8;12
96;08.04.2014;2014;04;22;Tiistai;17;8;25;3;5;8
96;08.04.2014;2014;04;23;Tiistai;5;1;6;0;1;1
96;09.04.2014;2014;04;00;Keskiviikko;2;1;3;0;0;0
96;09.04.2014;2014;04;01;Keskiviikko;1;0;1;3;2;5
96;09.04.2014;2014;04;02;Keskiviikko;1;0;1;0;0;0
96;09.04.2014;2014;04;03;Keskiviikko;1;0;1;0;0;0
96;09.04.2014;2014;04;04;Keskiviikko;1;1;2;0;0;0
96;09.04.2014;2014;04;05;Keskiviikko;2;6;8;1;0;1
96;09.04.2014;2014;04;06;Keskiviikko;38;35;73;9;1;10
96;09.04.2014;2014;04;07;Keskiviikko;102;101;203;21;5;26
96;09.04.2014;2014;04;08;Keskiviikko;109;132;241;13;5;18
96;09.04.2014;2014;04;09;Keskiviikko;42;70;112;13;8;21
96;09.04.2014;2014;04;10;Keskiviikko;56;73;129;12;9;21
96;09.04.2014;2014;04;11;Keskiviikko;71;61;132;9;20;29
96;09.04.2014;2014;04;12;Keskiviikko;89;80;169;11;7;18
96;09.04.2014;2014;04;13;Keskiviikko;57;84;141;5;10;15
96;09.04.2014;2014;04;14;Keskiviikko;83;94;177;5;14;19
96;09.04.2014;2014;04;15;Keskiviikko;89;172;261;7;31;38
96;09.04.2014;2014;04;16;Keskiviikko;77;161;238;13;19;32
96;09.04.2014;2014;04;17;Keskiviikko;83;83;166;12;17;29
96;09.04.2014;2014;04;18;Keskiviikko;63;84;147;13;33;46
96;09.04.2014;2014;04;19;Keskiviikko;73;20;93;12;14;26
96;09.04.2014;2014;04;20;Keskiviikko;59;44;103;10;8;18
96;09.04.2014;2014;04;21;Keskiviikko;60;49;109;16;15;31
96;09.04.2014;2014;04;22;Keskiviikko;9;13;22;2;1;3
96;09.04.2014;2014;04;23;Keskiviikko;9;3;12;0;1;1
96;10.04.2014;2014;04;00;Torstai;7;2;9;0;1;1
96;10.04.2014;2014;04;01;Torstai;2;0;2;0;0;0
96;10.04.2014;2014;04;02;Torstai;1;1;2;1;0;1
96;10.04.2014;2014;04;03;Torstai;3;1;4;0;0;0
96;10.04.2014;2014;04;04;Torstai;2;1;3;1;0;1
96;10.04.2014;2014;04;05;Torstai;1;5;6;1;0;1
96;10.04.2014;2014;04;06;Torstai;38;18;56;6;2;8
96;10.04.2014;2014;04;07;Torstai;100;104;204;12;9;21
96;10.04.2014;2014;04;08;Torstai;113;126;239;16;9;25
96;10.04.2014;2014;04;09;Torstai;85;90;175;10;12;22
96;10.04.2014;2014;04;10;Torstai;51;58;109;13;12;25
96;10.04.2014;2014;04;11;Torstai;55;52;107;11;11;22
96;10.04.2014;2014;04;12;Torstai;51;55;106;16;7;23
96;10.04.2014;2014;04;13;Torstai;55;75;130;15;18;33
96;10.04.2014;2014;04;14;Torstai;68;115;183;11;13;24
96;10.04.2014;2014;04;15;Torstai;61;178;239;13;27;40
96;10.04.2014;2014;04;16;Torstai;89;162;251;6;30;36
96;10.04.2014;2014;04;17;Torstai;79;75;154;9;13;22
96;10.04.2014;2014;04;18;Torstai;66;70;136;12;11;23
96;10.04.2014;2014;04;19;Torstai;54;30;84;17;16;33
96;10.04.2014;2014;04;20;Torstai;52;38;90;12;12;24
96;10.04.2014;2014;04;21;Torstai;28;33;61;3;7;10
96;10.04.2014;2014;04;22;Torstai;10;7;17;1;1;2
96;10.04.2014;2014;04;23;Torstai;3;4;7;3;4;7
96;11.04.2014;2014;04;00;Perjantai;4;0;4;0;0;0
96;11.04.2014;2014;04;01;Perjantai;3;1;4;1;0;1
96;11.04.2014;2014;04;02;Perjantai;1;0;1;0;0;0
96;11.04.2014;2014;04;03;Perjantai;3;0;3;0;0;0
96;11.04.2014;2014;04;04;Perjantai;2;4;6;1;0;1
96;11.04.2014;2014;04;05;Perjantai;4;4;8;1;3;4
96;11.04.2014;2014;04;06;Perjantai;40;22;62;7;1;8
96;11.04.2014;2014;04;07;Perjantai;89;91;180;13;7;20
96;11.04.2014;2014;04;08;Perjantai;89;87;176;18;9;27
96;11.04.2014;2014;04;09;Perjantai;35;59;94;9;12;21
96;11.04.2014;2014;04;10;Perjantai;32;52;84;7;10;17
96;11.04.2014;2014;04;11;Perjantai;38;46;84;8;11;19
96;11.04.2014;2014;04;12;Perjantai;69;60;129;13;18;31
96;11.04.2014;2014;04;13;Perjantai;54;89;143;7;9;16
96;11.04.2014;2014;04;14;Perjantai;64;113;177;5;22;27
96;11.04.2014;2014;04;15;Perjantai;79;148;227;8;21;29
96;11.04.2014;2014;04;16;Perjantai;57;73;130;10;11;21
96;11.04.2014;2014;04;17;Perjantai;61;61;122;11;5;16
96;11.04.2014;2014;04;18;Perjantai;54;30;84;4;10;14
96;11.04.2014;2014;04;19;Perjantai;27;25;52;4;8;12
96;11.04.2014;2014;04;20;Perjantai;34;22;56;8;7;15
96;11.04.2014;2014;04;21;Perjantai;14;15;29;5;11;16
96;11.04.2014;2014;04;22;Perjantai;15;13;28;3;0;3
96;11.04.2014;2014;04;23;Perjantai;19;5;24;1;0;1
96;12.04.2014;2014;04;00;Lauantai;15;7;22;0;0;0
96;12.04.2014;2014;04;01;Lauantai;13;0;13;1;0;1
96;12.04.2014;2014;04;02;Lauantai;14;2;16;1;0;1
96;12.04.2014;2014;04;03;Lauantai;2;2;4;2;0;2
96;12.04.2014;2014;04;04;Lauantai;4;4;8;0;0;0
96;12.04.2014;2014;04;05;Lauantai;0;1;1;0;0;0
96;12.04.2014;2014;04;06;Lauantai;14;11;25;2;0;2
96;12.04.2014;2014;04;07;Lauantai;4;12;16;0;2;2
96;12.04.2014;2014;04;08;Lauantai;3;18;21;3;3;6
96;12.04.2014;2014;04;09;Lauantai;15;37;52;10;5;15
96;12.04.2014;2014;04;10;Lauantai;17;49;66;7;19;26
96;12.04.2014;2014;04;11;Lauantai;38;47;85;14;16;30
96;12.04.2014;2014;04;12;Lauantai;47;80;127;26;28;54
96;12.04.2014;2014;04;13;Lauantai;72;61;133;14;15;29
96;12.04.2014;2014;04;14;Lauantai;64;74;138;25;15;40
96;12.04.2014;2014;04;15;Lauantai;65;61;126;19;16;35
96;12.04.2014;2014;04;16;Lauantai;48;37;85;11;9;20
96;12.04.2014;2014;04;17;Lauantai;31;50;81;8;19;27
96;12.04.2014;2014;04;18;Lauantai;62;31;93;18;14;32
96;12.04.2014;2014;04;19;Lauantai;19;19;38;12;13;25
96;12.04.2014;2014;04;20;Lauantai;23;38;61;8;11;19
96;12.04.2014;2014;04;21;Lauantai;16;33;49;4;8;12
96;12.04.2014;2014;04;22;Lauantai;7;11;18;2;3;5
96;12.04.2014;2014;04;23;Lauantai;12;6;18;1;0;1
96;13.04.2014;2014;04;00;Sunnuntai;3;8;11;0;0;0
96;13.04.2014;2014;04;01;Sunnuntai;10;4;14;0;0;0
96;13.04.2014;2014;04;02;Sunnuntai;11;4;15;2;0;2
96;13.04.2014;2014;04;03;Sunnuntai;4;1;5;0;0;0
96;13.04.2014;2014;04;04;Sunnuntai;11;1;12;0;0;0
96;13.04.2014;2014;04;05;Sunnuntai;1;0;1;1;1;2
96;13.04.2014;2014;04;06;Sunnuntai;8;11;19;2;1;3
96;13.04.2014;2014;04;07;Sunnuntai;3;6;9;0;3;3
96;13.04.2014;2014;04;08;Sunnuntai;4;8;12;1;1;2
96;13.04.2014;2014;04;09;Sunnuntai;6;5;11;2;4;6
96;13.04.2014;2014;04;10;Sunnuntai;7;17;24;5;10;15
96;13.04.2014;2014;04;11;Sunnuntai;19;28;47;7;11;18
96;13.04.2014;2014;04;12;Sunnuntai;30;38;68;10;20;30
96;13.04.2014;2014;04;13;Sunnuntai;37;25;62;13;11;24
96;13.04.2014;2014;04;14;Sunnuntai;38;32;70;11;11;22
96;13.04.2014;2014;04;15;Sunnuntai;39;31;70;13;9;22
96;13.04.2014;2014;04;16;Sunnuntai;32;27;59;20;7;27
96;13.04.2014;2014;04;17;Sunnuntai;19;11;30;7;5;12
96;13.04.2014;2014;04;18;Sunnuntai;21;20;41;12;15;27
96;13.04.2014;2014;04;19;Sunnuntai;11;8;19;10;15;25
96;13.04.2014;2014;04;20;Sunnuntai;13;20;33;5;12;17
96;13.04.2014;2014;04;21;Sunnuntai;12;13;25;1;4;5
96;13.04.2014;2014;04;22;Sunnuntai;7;11;18;2;0;2
96;13.04.2014;2014;04;23;Sunnuntai;4;5;9;2;4;6
96;21.04.2014;2014;04;00;Maanantai;6;11;17;2;1;3
96;21.04.2014;2014;04;01;Maanantai;2;4;6;0;1;1
96;21.04.2014;2014;04;02;Maanantai;1;3;4;0;1;1
96;21.04.2014;2014;04;03;Maanantai;8;3;11;2;1;3
96;21.04.2014;2014;04;04;Maanantai;1;0;1;2;0;2
96;21.04.2014;2014;04;05;Maanantai;2;2;4;0;0;0
96;21.04.2014;2014;04;06;Maanantai;18;8;26;3;0;3
96;21.04.2014;2014;04;07;Maanantai;3;9;12;3;1;4
96;21.04.2014;2014;04;08;Maanantai;5;13;18;2;3;5
96;21.04.2014;2014;04;09;Maanantai;9;17;26;6;7;13
96;21.04.2014;2014;04;10;Maanantai;15;17;32;4;3;7
96;21.04.2014;2014;04;11;Maanantai;19;29;48;6;5;11
96;21.04.2014;2014;04;12;Maanantai;35;28;63;6;7;13
96;21.04.2014;2014;04;13;Maanantai;35;41;76;6;7;13
96;21.04.2014;2014;04;14;Maanantai;37;29;66;5;3;8
96;21.04.2014;2014;04;15;Maanantai;32;43;75;6;8;14
96;21.04.2014;2014;04;16;Maanantai;48;49;97;11;11;22
96;21.04.2014;2014;04;17;Maanantai;48;42;90;18;9;27
96;21.04.2014;2014;04;18;Maanantai;29;54;83;12;19;31
96;21.04.2014;2014;04;19;Maanantai;31;37;68;10;21;31
96;21.04.2014;2014;04;20;Maanantai;25;25;50;9;14;23
96;21.04.2014;2014;04;21;Maanantai;12;20;32;6;1;7
96;21.04.2014;2014;04;22;Maanantai;9;13;22;2;0;2
96;21.04.2014;2014;04;23;Maanantai;4;2;6;0;2;2
96;22.04.2014;2014;04;00;Tiistai;1;5;6;0;0;0
96;22.04.2014;2014;04;01;Tiistai;0;0;0;1;0;1
96;22.04.2014;2014;04;02;Tiistai;0;0;0;0;0;0
96;22.04.2014;2014;04;03;Tiistai;1;2;3;0;0;0
96;22.04.2014;2014;04;04;Tiistai;1;1;2;0;0;0
96;22.04.2014;2014;04;05;Tiistai;3;9;12;0;0;0
96;22.04.2014;2014;04;06;Tiistai;35;25;60;6;1;7
96;22.04.2014;2014;04;07;Tiistai;107;103;210;16;9;25
96;22.04.2014;2014;04;08;Tiistai;106;130;236;13;6;19
96;22.04.2014;2014;04;09;Tiistai;52;91;143;8;8;16
96;22.04.2014;2014;04;10;Tiistai;48;54;102;4;6;10
96;22.04.2014;2014;04;11;Tiistai;46;86;132;7;21;28
96;22.04.2014;2014;04;12;Tiistai;70;55;125;6;13;19
96;22.04.2014;2014;04;13;Tiistai;75;75;150;6;11;17
96;22.04.2014;2014;04;14;Tiistai;91;90;181;13;25;38
96;22.04.2014;2014;04;15;Tiistai;102;174;276;8;23;31
96;22.04.2014;2014;04;16;Tiistai;123;151;274;10;21;31
96;22.04.2014;2014;04;17;Tiistai;85;74;159;14;12;26
96;22.04.2014;2014;04;18;Tiistai;72;49;121;19;18;37
96;22.04.2014;2014;04;19;Tiistai;68;49;117;15;16;31
96;22.04.2014;2014;04;20;Tiistai;47;28;75;11;13;24
96;22.04.2014;2014;04;21;Tiistai;32;33;65;2;6;8
96;22.04.2014;2014;04;22;Tiistai;12;11;23;2;0;2
96;22.04.2014;2014;04;23;Tiistai;7;1;8;0;0;0
96;23.04.2014;2014;04;00;Keskiviikko;2;2;4;0;2;2
96;23.04.2014;2014;04;01;Keskiviikko;0;0;0;0;0;0
96;23.04.2014;2014;04;02;Keskiviikko;1;1;2;0;0;0
96;23.04.2014;2014;04;03;Keskiviikko;2;1;3;0;0;0
96;23.04.2014;2014;04;04;Keskiviikko;2;1;3;0;0;0
96;23.04.2014;2014;04;05;Keskiviikko;2;8;10;1;1;2
96;23.04.2014;2014;04;06;Keskiviikko;40;39;79;5;2;7
96;23.04.2014;2014;04;07;Keskiviikko;112;93;205;19;8;27
96;23.04.2014;2014;04;08;Keskiviikko;104;121;225;14;6;20
96;23.04.2014;2014;04;09;Keskiviikko;55;94;149;5;7;12
96;23.04.2014;2014;04;10;Keskiviikko;47;78;125;6;6;12
96;23.04.2014;2014;04;11;Keskiviikko;52;64;116;6;6;12
96;23.04.2014;2014;04;12;Keskiviikko;80;74;154;6;12;18
96;23.04.2014;2014;04;13;Keskiviikko;67;55;122;6;6;12
96;23.04.2014;2014;04;14;Keskiviikko;100;120;220;7;13;20
96;23.04.2014;2014;04;15;Keskiviikko;136;171;307;16;20;36
96;23.04.2014;2014;04;16;Keskiviikko;102;144;246;19;15;34
96;23.04.2014;2014;04;17;Keskiviikko;78;102;180;9;15;24
96;23.04.2014;2014;04;18;Keskiviikko;76;85;161;16;24;40
96;23.04.2014;2014;04;19;Keskiviikko;79;32;111;17;13;30
96;23.04.2014;2014;04;20;Keskiviikko;40;38;78;14;19;33
96;23.04.2014;2014;04;21;Keskiviikko;92;49;141;27;8;35
96;23.04.2014;2014;04;22;Keskiviikko;17;8;25;5;2;7
96;23.04.2014;2014;04;23;Keskiviikko;8;4;12;1;0;1
96;24.04.2014;2014;04;00;Torstai;2;1;3;0;2;2
96;24.04.2014;2014;04;01;Torstai;1;2;3;1;0;1
96;24.04.2014;2014;04;02;Torstai;1;0;1;0;0;0
96;24.04.2014;2014;04;03;Torstai;0;2;2;0;0;0
96;24.04.2014;2014;04;04;Torstai;2;3;5;0;0;0
96;24.04.2014;2014;04;05;Torstai;3;7;10;2;0;2
96;24.04.2014;2014;04;06;Torstai;37;38;75;5;3;8
96;24.04.2014;2014;04;07;Torstai;94;93;187;15;9;24
96;24.04.2014;2014;04;08;Torstai;92;130;222;13;6;19
96;24.04.2014;2014;04;09;Torstai;59;70;129;9;4;13
96;24.04.2014;2014;04;10;Torstai;47;64;111;10;4;14
96;24.04.2014;2014;04;11;Torstai;51;61;112;10;11;21
96;24.04.2014;2014;04;12;Torstai;45;75;120;5;9;14
96;24.04.2014;2014;04;13;Torstai;67;75;142;6;5;11
96;24.04.2014;2014;04;14;Torstai;69;102;171;7;10;17
96;24.04.2014;2014;04;15;Torstai;102;160;262;4;16;20
96;24.04.2014;2014;04;16;Torstai;108;172;280;10;20;30
96;24.04.2014;2014;04;17;Torstai;72;70;142;11;6;17
96;24.04.2014;2014;04;18;Torstai;88;59;147;10;16;26
96;24.04.2014;2014;04;19;Torstai;63;44;107;10;15;25
96;24.04.2014;2014;04;20;Torstai;49;21;70;6;14;20
96;24.04.2014;2014;04;21;Torstai;35;30;65;11;7;18
96;24.04.2014;2014;04;22;Torstai;11;9;20;2;3;5
96;24.04.2014;2014;04;23;Torstai;4;2;6;0;3;3
96;25.04.2014;2014;04;00;Perjantai;0;1;1;1;1;2
96;25.04.2014;2014;04;01;Perjantai;1;0;1;0;1;1
96;25.04.2014;2014;04;02;Perjantai;5;0;5;0;0;0
96;25.04.2014;2014;04;03;Perjantai;2;0;2;0;0;0
96;25.04.2014;2014;04;04;Perjantai;2;4;6;2;0;2
96;25.04.2014;2014;04;05;Perjantai;2;8;10;1;0;1
96;25.04.2014;2014;04;06;Perjantai;34;40;74;3;0;3
96;25.04.2014;2014;04;07;Perjantai;86;91;177;12;8;20
96;25.04.2014;2014;04;08;Perjantai;96;100;196;19;5;24
96;25.04.2014;2014;04;09;Perjantai;50;84;134;8;5;13
96;25.04.2014;2014;04;10;Perjantai;41;60;101;9;8;17
96;25.04.2014;2014;04;11;Perjantai;55;78;133;14;10;24
96;25.04.2014;2014;04;12;Perjantai;62;94;156;28;37;65
96;25.04.2014;2014;04;13;Perjantai;66;99;165;3;8;11
96;25.04.2014;2014;04;14;Perjantai;85;137;222;9;11;20
96;25.04.2014;2014;04;15;Perjantai;111;149;260;11;18;29
96;25.04.2014;2014;04;16;Perjantai;84;103;187;8;15;23
96;25.04.2014;2014;04;17;Perjantai;74;69;143;11;10;21
96;25.04.2014;2014;04;18;Perjantai;71;48;119;6;3;9
96;25.04.2014;2014;04;19;Perjantai;41;29;70;13;17;30
96;25.04.2014;2014;04;20;Perjantai;41;29;70;2;7;9
96;25.04.2014;2014;04;21;Perjantai;40;36;76;6;6;12
96;25.04.2014;2014;04;22;Perjantai;23;21;44;2;3;5
96;25.04.2014;2014;04;23;Perjantai;14;3;17;0;1;1
96;26.04.2014;2014;04;00;Lauantai;14;3;17;0;1;1
96;26.04.2014;2014;04;01;Lauantai;7;3;10;0;0;0
96;26.04.2014;2014;04;02;Lauantai;9;2;11;2;0;2
96;26.04.2014;2014;04;03;Lauantai;11;1;12;0;0;0
96;26.04.2014;2014;04;04;Lauantai;4;3;7;3;1;4
96;26.04.2014;2014;04;05;Lauantai;1;0;1;1;0;1
96;26.04.2014;2014;04;06;Lauantai;16;7;23;1;1;2
96;26.04.2014;2014;04;07;Lauantai;4;17;21;1;4;5
96;26.04.2014;2014;04;08;Lauantai;12;46;58;2;2;4
96;26.04.2014;2014;04;09;Lauantai;33;64;97;6;14;20
96;26.04.2014;2014;04;10;Lauantai;46;110;156;32;59;91
96;26.04.2014;2014;04;11;Lauantai;48;92;140;24;46;70
96;26.04.2014;2014;04;12;Lauantai;70;89;159;97;40;137
96;26.04.2014;2014;04;13;Lauantai;85;74;159;111;25;136
96;26.04.2014;2014;04;14;Lauantai;87;80;167;44;15;59
96;26.04.2014;2014;04;15;Lauantai;83;86;169;25;16;41
96;26.04.2014;2014;04;16;Lauantai;59;141;200;9;23;32
96;26.04.2014;2014;04;17;Lauantai;61;54;115;11;9;20
96;26.04.2014;2014;04;18;Lauantai;50;34;84;10;7;17
96;26.04.2014;2014;04;19;Lauantai;30;23;53;4;5;9
96;26.04.2014;2014;04;20;Lauantai;78;66;144;25;6;31
96;26.04.2014;2014;04;21;Lauantai;37;65;102;0;12;12
96;26.04.2014;2014;04;22;Lauantai;27;43;70;2;6;8
96;26.04.2014;2014;04;23;Lauantai;29;27;56;4;2;6
96;27.04.2014;2014;04;00;Sunnuntai;24;15;39;2;0;2
96;27.04.2014;2014;04;01;Sunnuntai;22;9;31;2;0;2
96;27.04.2014;2014;04;02;Sunnuntai;33;3;36;3;0;3
96;27.04.2014;2014;04;03;Sunnuntai;14;0;14;2;0;2
96;27.04.2014;2014;04;04;Sunnuntai;18;3;21;7;0;7
96;27.04.2014;2014;04;05;Sunnuntai;14;4;18;1;1;2
96;27.04.2014;2014;04;06;Sunnuntai;20;6;26;2;0;2
96;27.04.2014;2014;04;07;Sunnuntai;8;8;16;3;2;5
96;27.04.2014;2014;04;08;Sunnuntai;4;16;20;7;6;13
96;27.04.2014;2014;04;09;Sunnuntai;14;16;30;5;7;12
96;27.04.2014;2014;04;10;Sunnuntai;18;27;45;10;11;21
96;27.04.2014;2014;04;11;Sunnuntai;34;56;90;16;19;35
96;27.04.2014;2014;04;12;Sunnuntai;43;58;101;11;11;22
96;27.04.2014;2014;04;13;Sunnuntai;63;52;115;11;9;20
96;27.04.2014;2014;04;14;Sunnuntai;64;62;126;5;8;13
96;27.04.2014;2014;04;15;Sunnuntai;59;60;119;9;3;12
96;27.04.2014;2014;04;16;Sunnuntai;79;52;131;20;6;26
96;27.04.2014;2014;04;17;Sunnuntai;79;47;126;23;12;35
96;27.04.2014;2014;04;18;Sunnuntai;57;42;99;21;25;46
96;27.04.2014;2014;04;19;Sunnuntai;24;34;58;8;24;32
96;27.04.2014;2014;04;20;Sunnuntai;36;35;71;7;15;22
96;27.04.2014;2014;04;21;Sunnuntai;19;53;72;2;18;20
96;27.04.2014;2014;04;22;Sunnuntai;7;7;14;0;3;3
96;27.04.2014;2014;04;23;Sunnuntai;3;4;7;1;0;1
96;28.04.2014;2014;04;00;Maanantai;4;6;10;1;1;2
96;28.04.2014;2014;04;01;Maanantai;0;1;1;0;0;0
96;28.04.2014;2014;04;02;Maanantai;5;1;6;0;0;0
96;28.04.2014;2014;04;03;Maanantai;5;0;5;0;0;0
96;28.04.2014;2014;04;04;Maanantai;6;2;8;1;0;1
96;28.04.2014;2014;04;05;Maanantai;3;8;11;2;0;2
96;28.04.2014;2014;04;06;Maanantai;46;50;96;5;5;10
96;28.04.2014;2014;04;07;Maanantai;111;106;217;16;5;21
96;28.04.2014;2014;04;08;Maanantai;110;150;260;16;7;23
96;28.04.2014;2014;04;09;Maanantai;56;90;146;10;7;17
96;28.04.2014;2014;04;10;Maanantai;53;89;142;9;7;16
96;28.04.2014;2014;04;11;Maanantai;73;73;146;10;7;17
96;28.04.2014;2014;04;12;Maanantai;95;78;173;5;7;12
96;28.04.2014;2014;04;13;Maanantai;81;88;169;5;7;12
96;28.04.2014;2014;04;14;Maanantai;82;147;229;9;13;22
96;28.04.2014;2014;04;15;Maanantai;107;177;284;3;27;30
96;28.04.2014;2014;04;16;Maanantai;145;153;298;9;11;20
96;28.04.2014;2014;04;17;Maanantai;73;98;171;10;16;26
96;28.04.2014;2014;04;18;Maanantai;88;56;144;6;10;16
96;28.04.2014;2014;04;19;Maanantai;75;73;148;11;17;28
96;28.04.2014;2014;04;20;Maanantai;70;34;104;6;12;18
96;28.04.2014;2014;04;21;Maanantai;42;27;69;4;7;11
96;28.04.2014;2014;04;22;Maanantai;18;7;25;3;1;4
96;28.04.2014;2014;04;23;Maanantai;2;1;3;1;2;3
96;29.04.2014;2014;04;00;Tiistai;1;2;3;0;0;0
96;29.04.2014;2014;04;01;Tiistai;8;2;10;1;0;1
96;29.04.2014;2014;04;02;Tiistai;6;0;6;1;0;1
96;29.04.2014;2014;04;03;Tiistai;4;2;6;0;1;1
96;29.04.2014;2014;04;04;Tiistai;8;1;9;0;0;0
96;29.04.2014;2014;04;05;Tiistai;4;11;15;0;1;1
96;29.04.2014;2014;04;06;Tiistai;50;37;87;4;0;4
96;29.04.2014;2014;04;07;Tiistai;109;116;225;12;12;24
96;29.04.2014;2014;04;08;Tiistai;118;137;255;17;6;23
96;29.04.2014;2014;04;09;Tiistai;44;79;123;3;5;8
96;29.04.2014;2014;04;10;Tiistai;40;67;107;12;5;17
96;29.04.2014;2014;04;11;Tiistai;58;63;121;11;11;22
96;29.04.2014;2014;04;12;Tiistai;64;55;119;5;7;12
96;29.04.2014;2014;04;13;Tiistai;132;3;135;16;1;17
96;29.04.2014;2014;04;14;Tiistai;226;0;226;17;0;17
96;29.04.2014;2014;04;15;Tiistai;253;1;254;28;0;28
96;29.04.2014;2014;04;16;Tiistai;252;0;252;26;0;26
96;29.04.2014;2014;04;17;Tiistai;176;0;176;38;0;38
96;29.04.2014;2014;04;18;Tiistai;258;0;258;149;2;151
96;29.04.2014;2014;04;19;Tiistai;254;0;254;158;0;158
96;29.04.2014;2014;04;20;Tiistai;231;0;231;120;0;120
96;29.04.2014;2014;04;21;Tiistai;210;0;210;126;0;126
96;29.04.2014;2014;04;22;Tiistai;33;0;33;1;0;1
96;29.04.2014;2014;04;23;Tiistai;14;0;14;1;0;1
96;30.04.2014;2014;04;00;Keskiviikko;6;0;6;1;0;1
96;30.04.2014;2014;04;01;Keskiviikko;8;0;8;0;0;0
96;30.04.2014;2014;04;02;Keskiviikko;5;0;5;1;0;1
96;30.04.2014;2014;04;03;Keskiviikko;5;0;5;1;0;1
96;30.04.2014;2014;04;04;Keskiviikko;11;0;11;0;0;0
96;30.04.2014;2014;04;05;Keskiviikko;19;0;19;0;0;0
96;30.04.2014;2014;04;06;Keskiviikko;86;0;86;7;0;7
96;30.04.2014;2014;04;07;Keskiviikko;204;0;204;19;0;19
96;30.04.2014;2014;04;08;Keskiviikko;189;0;189;22;0;22
96;30.04.2014;2014;04;09;Keskiviikko;108;0;108;21;0;21
96;30.04.2014;2014;04;10;Keskiviikko;102;0;102;17;0;17
96;30.04.2014;2014;04;11;Keskiviikko;114;0;114;15;0;15
96;30.04.2014;2014;04;12;Keskiviikko;127;1;128;22;0;22
96;30.04.2014;2014;04;13;Keskiviikko;168;0;168;21;0;21
96;30.04.2014;2014;04;14;Keskiviikko;214;0;214;17;0;17
96;30.04.2014;2014;04;15;Keskiviikko;255;0;255;27;0;27
96;30.04.2014;2014;04;16;Keskiviikko;176;0;176;15;0;15
96;30.04.2014;2014;04;17;Keskiviikko;136;0;136;9;0;9
96;30.04.2014;2014;04;18;Keskiviikko;98;0;98;11;0;11
96;30.04.2014;2014;04;19;Keskiviikko;96;0;96;12;0;12
96;30.04.2014;2014;04;20;Keskiviikko;73;0;73;14;0;14
96;30.04.2014;2014;04;21;Keskiviikko;70;0;70;11;0;11
96;30.04.2014;2014;04;22;Keskiviikko;34;0;34;4;0;4
96;30.04.2014;2014;04;23;Keskiviikko;26;0;26;5;0;5
96;01.05.2014;2014;05;00;Torstai;42;0;42;6;0;6
96;01.05.2014;2014;05;01;Torstai;40;0;40;4;0;4
96;01.05.2014;2014;05;02;Torstai;32;0;32;10;0;10
96;01.05.2014;2014;05;03;Torstai;27;0;27;4;0;4
96;01.05.2014;2014;05;04;Torstai;23;0;23;13;0;13
96;01.05.2014;2014;05;05;Torstai;11;0;11;2;0;2
96;01.05.2014;2014;05;06;Torstai;20;0;20;10;0;10
96;01.05.2014;2014;05;07;Torstai;10;0;10;4;0;4
96;01.05.2014;2014;05;08;Torstai;12;0;12;6;0;6
96;01.05.2014;2014;05;09;Torstai;22;0;22;4;0;4
96;01.05.2014;2014;05;10;Torstai;41;0;41;4;0;4
96;01.05.2014;2014;05;11;Torstai;66;0;66;11;0;11
96;01.05.2014;2014;05;12;Torstai;138;0;138;10;0;10
96;01.05.2014;2014;05;13;Torstai;112;1;113;19;0;19
96;01.05.2014;2014;05;14;Torstai;108;0;108;16;0;16
96;01.05.2014;2014;05;15;Torstai;63;0;63;15;0;15
96;01.05.2014;2014;05;16;Torstai;100;0;100;15;0;15
96;01.05.2014;2014;05;17;Torstai;53;0;53;16;0;16
96;01.05.2014;2014;05;18;Torstai;50;0;50;16;0;16
96;01.05.2014;2014;05;19;Torstai;64;0;64;22;0;22
96;01.05.2014;2014;05;20;Torstai;60;0;60;13;0;13
96;01.05.2014;2014;05;21;Torstai;36;0;36;9;0;9
96;01.05.2014;2014;05;22;Torstai;19;0;19;3;0;3
96;01.05.2014;2014;05;23;Torstai;8;0;8;2;0;2
96;02.05.2014;2014;05;00;Perjantai;4;0;4;1;0;1
96;02.05.2014;2014;05;01;Perjantai;4;0;4;1;0;1
96;02.05.2014;2014;05;02;Perjantai;2;0;2;0;0;0
96;02.05.2014;2014;05;03;Perjantai;1;0;1;0;0;0
96;02.05.2014;2014;05;04;Perjantai;4;0;4;0;0;0
96;02.05.2014;2014;05;05;Perjantai;6;0;6;2;0;2
96;02.05.2014;2014;05;06;Perjantai;62;0;62;5;0;5
96;02.05.2014;2014;05;07;Perjantai;126;0;126;19;0;19
96;02.05.2014;2014;05;08;Perjantai;98;0;98;13;0;13
96;02.05.2014;2014;05;09;Perjantai;76;0;76;11;0;11
96;02.05.2014;2014;05;10;Perjantai;81;0;81;17;0;17
96;02.05.2014;2014;05;11;Perjantai;102;0;102;10;0;10
96;02.05.2014;2014;05;12;Perjantai;99;0;99;15;0;15
96;02.05.2014;2014;05;13;Perjantai;119;1;120;13;0;13
96;02.05.2014;2014;05;14;Perjantai;157;1;158;19;0;19
96;02.05.2014;2014;05;15;Perjantai;186;0;186;37;0;37
96;02.05.2014;2014;05;16;Perjantai;133;0;133;16;0;16
96;02.05.2014;2014;05;17;Perjantai;106;0;106;18;0;18
96;02.05.2014;2014;05;18;Perjantai;87;0;87;13;0;13
96;02.05.2014;2014;05;19;Perjantai;55;0;55;34;0;34
96;02.05.2014;2014;05;20;Perjantai;58;0;58;16;0;16
96;02.05.2014;2014;05;21;Perjantai;47;0;47;17;0;17
96;02.05.2014;2014;05;22;Perjantai;19;0;19;1;0;1
96;02.05.2014;2014;05;23;Perjantai;16;0;16;4;0;4
96;03.05.2014;2014;05;00;Lauantai;21;0;21;1;0;1
96;03.05.2014;2014;05;01;Lauantai;14;0;14;0;0;0
96;03.05.2014;2014;05;02;Lauantai;6;0;6;0;0;0
96;03.05.2014;2014;05;03;Lauantai;5;0;5;0;0;0
96;03.05.2014;2014;05;04;Lauantai;9;0;9;1;0;1
96;03.05.2014;2014;05;05;Lauantai;5;0;5;0;0;0
96;03.05.2014;2014;05;06;Lauantai;28;0;28;1;0;1
96;03.05.2014;2014;05;07;Lauantai;19;0;19;5;1;6
96;03.05.2014;2014;05;08;Lauantai;20;0;20;7;0;7
96;03.05.2014;2014;05;09;Lauantai;48;0;48;5;0;5
96;03.05.2014;2014;05;10;Lauantai;69;0;69;19;0;19
96;03.05.2014;2014;05;11;Lauantai;95;0;95;41;0;41
96;03.05.2014;2014;05;12;Lauantai;102;0;102;28;0;28
96;03.05.2014;2014;05;13;Lauantai;120;2;122;43;0;43
96;03.05.2014;2014;05;14;Lauantai;129;0;129;32;0;32
96;03.05.2014;2014;05;15;Lauantai;140;0;140;33;0;33
96;03.05.2014;2014;05;16;Lauantai;86;0;86;14;0;14
96;03.05.2014;2014;05;17;Lauantai;78;0;78;26;0;26
96;03.05.2014;2014;05;18;Lauantai;68;1;69;34;0;34
96;03.05.2014;2014;05;19;Lauantai;75;0;75;36;0;36
96;03.05.2014;2014;05;20;Lauantai;41;0;41;11;0;11
96;03.05.2014;2014;05;21;Lauantai;53;0;53;16;0;16
96;03.05.2014;2014;05;22;Lauantai;39;0;39;10;0;10
96;03.05.2014;2014;05;23;Lauantai;24;0;24;2;0;2
96;04.05.2014;2014;05;00;Sunnuntai;13;0;13;2;0;2
96;04.05.2014;2014;05;01;Sunnuntai;17;0;17;3;0;3
96;04.05.2014;2014;05;02;Sunnuntai;6;0;6;2;0;2
96;04.05.2014;2014;05;03;Sunnuntai;12;0;12;0;0;0
96;04.05.2014;2014;05;04;Sunnuntai;6;0;6;2;0;2
96;04.05.2014;2014;05;05;Sunnuntai;3;0;3;1;0;1
96;04.05.2014;2014;05;06;Sunnuntai;24;0;24;3;0;3
96;04.05.2014;2014;05;07;Sunnuntai;15;0;15;0;0;0
96;04.05.2014;2014;05;08;Sunnuntai;13;0;13;7;0;7
96;04.05.2014;2014;05;09;Sunnuntai;23;0;23;6;0;6
96;04.05.2014;2014;05;10;Sunnuntai;50;0;50;13;0;13
96;04.05.2014;2014;05;11;Sunnuntai;82;0;82;16;0;16
96;04.05.2014;2014;05;12;Sunnuntai;94;0;94;23;0;23
96;04.05.2014;2014;05;13;Sunnuntai;123;0;123;21;0;21
96;04.05.2014;2014;05;14;Sunnuntai;100;1;101;16;0;16
96;04.05.2014;2014;05;15;Sunnuntai;95;0;95;16;0;16
96;04.05.2014;2014;05;16;Sunnuntai;108;0;108;18;0;18
96;04.05.2014;2014;05;17;Sunnuntai;84;1;85;24;0;24
96;04.05.2014;2014;05;18;Sunnuntai;106;0;106;32;0;32
96;04.05.2014;2014;05;19;Sunnuntai;64;0;64;33;0;33
96;04.05.2014;2014;05;20;Sunnuntai;68;0;68;32;0;32
96;04.05.2014;2014;05;21;Sunnuntai;46;0;46;21;0;21
96;04.05.2014;2014;05;22;Sunnuntai;25;0;25;3;0;3
96;04.05.2014;2014;05;23;Sunnuntai;7;0;7;0;0;0
96;05.05.2014;2014;05;00;Maanantai;3;0;3;1;0;1
96;05.05.2014;2014;05;01;Maanantai;3;0;3;0;0;0
96;05.05.2014;2014;05;02;Maanantai;2;0;2;0;0;0
96;05.05.2014;2014;05;03;Maanantai;3;0;3;0;0;0
96;05.05.2014;2014;05;04;Maanantai;3;0;3;0;0;0
96;05.05.2014;2014;05;05;Maanantai;11;0;11;2;0;2
96;05.05.2014;2014;05;06;Maanantai;89;0;89;9;0;9
96;05.05.2014;2014;05;07;Maanantai;259;0;259;32;0;32
96;05.05.2014;2014;05;08;Maanantai;248;0;248;25;0;25
96;05.05.2014;2014;05;09;Maanantai;144;0;144;15;0;15
96;05.05.2014;2014;05;10;Maanantai;109;0;109;15;0;15
96;05.05.2014;2014;05;11;Maanantai;132;0;132;22;0;22
96;05.05.2014;2014;05;12;Maanantai;139;0;139;13;0;13
96;05.05.2014;2014;05;13;Maanantai;130;1;131;14;1;15
96;05.05.2014;2014;05;14;Maanantai;193;0;193;15;0;15
96;05.05.2014;2014;05;15;Maanantai;283;0;283;33;0;33
96;05.05.2014;2014;05;16;Maanantai;292;0;292;28;0;28
96;05.05.2014;2014;05;17;Maanantai;175;0;175;30;0;30
96;05.05.2014;2014;05;18;Maanantai;113;0;113;30;0;30
96;05.05.2014;2014;05;19;Maanantai;91;0;91;29;0;29
96;05.05.2014;2014;05;20;Maanantai;94;0;94;25;0;25
96;05.05.2014;2014;05;21;Maanantai;56;0;56;12;0;12
96;05.05.2014;2014;05;22;Maanantai;25;0;25;4;0;4
96;05.05.2014;2014;05;23;Maanantai;5;0;5;2;0;2
96;06.05.2014;2014;05;00;Tiistai;3;0;3;2;0;2
96;06.05.2014;2014;05;01;Tiistai;0;0;0;0;0;0
96;06.05.2014;2014;05;02;Tiistai;0;0;0;0;0;0
96;06.05.2014;2014;05;03;Tiistai;4;0;4;0;0;0
96;06.05.2014;2014;05;04;Tiistai;2;0;2;0;0;0
96;06.05.2014;2014;05;05;Tiistai;15;0;15;1;0;1
96;06.05.2014;2014;05;06;Tiistai;88;0;88;8;0;8
96;06.05.2014;2014;05;07;Tiistai;260;0;260;26;0;26
96;06.05.2014;2014;05;08;Tiistai;276;0;276;18;0;18
96;06.05.2014;2014;05;09;Tiistai;153;0;153;12;0;12
96;06.05.2014;2014;05;10;Tiistai;114;0;114;20;0;20
96;06.05.2014;2014;05;11;Tiistai;102;0;102;18;0;18
96;06.05.2014;2014;05;12;Tiistai;123;0;123;25;0;25
96;06.05.2014;2014;05;13;Tiistai;148;0;148;11;0;11
96;06.05.2014;2014;05;14;Tiistai;203;0;203;21;0;21
96;06.05.2014;2014;05;15;Tiistai;337;0;337;34;0;34
96;06.05.2014;2014;05;16;Tiistai;284;0;284;25;0;25
96;06.05.2014;2014;05;17;Tiistai;146;0;146;23;0;23
96;06.05.2014;2014;05;18;Tiistai;124;0;124;23;0;23
96;06.05.2014;2014;05;19;Tiistai;99;0;99;25;0;25
96;06.05.2014;2014;05;20;Tiistai;90;0;90;10;0;10
96;06.05.2014;2014;05;21;Tiistai;64;0;64;18;0;18
96;06.05.2014;2014;05;22;Tiistai;27;0;27;6;0;6
96;06.05.2014;2014;05;23;Tiistai;18;0;18;3;0;3
96;07.05.2014;2014;05;00;Keskiviikko;6;0;6;1;0;1
96;07.05.2014;2014;05;01;Keskiviikko;5;0;5;4;0;4
96;07.05.2014;2014;05;02;Keskiviikko;2;0;2;1;0;1
96;07.05.2014;2014;05;03;Keskiviikko;4;0;4;0;0;0
96;07.05.2014;2014;05;04;Keskiviikko;2;0;2;0;0;0
96;07.05.2014;2014;05;05;Keskiviikko;13;0;13;1;0;1
96;07.05.2014;2014;05;06;Keskiviikko;88;0;88;10;0;10
96;07.05.2014;2014;05;07;Keskiviikko;242;0;242;20;1;21
96;07.05.2014;2014;05;08;Keskiviikko;248;0;248;24;0;24
96;07.05.2014;2014;05;09;Keskiviikko;143;0;143;20;0;20
96;07.05.2014;2014;05;10;Keskiviikko;115;0;115;18;0;18
96;07.05.2014;2014;05;11;Keskiviikko;121;0;121;26;0;26
96;07.05.2014;2014;05;12;Keskiviikko;157;1;158;18;0;18
96;07.05.2014;2014;05;13;Keskiviikko;124;0;124;18;0;18
96;07.05.2014;2014;05;14;Keskiviikko;208;1;209;22;0;22
96;07.05.2014;2014;05;15;Keskiviikko;285;0;285;43;0;43
96;07.05.2014;2014;05;16;Keskiviikko;295;0;295;28;0;28
96;07.05.2014;2014;05;17;Keskiviikko;183;0;183;38;0;38
96;07.05.2014;2014;05;18;Keskiviikko;133;0;133;30;0;30
96;07.05.2014;2014;05;19;Keskiviikko;96;0;96;19;0;19
96;07.05.2014;2014;05;20;Keskiviikko;91;0;91;30;0;30
96;07.05.2014;2014;05;21;Keskiviikko;77;0;77;23;0;23
96;07.05.2014;2014;05;22;Keskiviikko;27;0;27;7;0;7
96;07.05.2014;2014;05;23;Keskiviikko;13;0;13;2;0;2
96;08.05.2014;2014;05;00;Torstai;6;0;6;1;0;1
96;08.05.2014;2014;05;01;Torstai;5;0;5;0;0;0
96;08.05.2014;2014;05;02;Torstai;3;0;3;3;0;3
96;08.05.2014;2014;05;03;Torstai;1;0;1;0;0;0
96;08.05.2014;2014;05;04;Torstai;2;0;2;0;0;0
96;08.05.2014;2014;05;05;Torstai;13;0;13;2;0;2
96;08.05.2014;2014;05;06;Torstai;80;0;80;11;0;11
96;08.05.2014;2014;05;07;Torstai;218;0;218;23;0;23
96;08.05.2014;2014;05;08;Torstai;262;0;262;25;0;25
96;08.05.2014;2014;05;09;Torstai;145;0;145;11;0;11
96;08.05.2014;2014;05;10;Torstai;107;0;107;18;0;18
96;08.05.2014;2014;05;11;Torstai;110;0;110;11;0;11
96;08.05.2014;2014;05;12;Torstai;115;1;116;15;0;15
96;08.05.2014;2014;05;13;Torstai;137;3;140;14;0;14
96;08.05.2014;2014;05;14;Torstai;161;2;163;20;1;21
96;08.05.2014;2014;05;15;Torstai;289;2;291;29;0;29
96;08.05.2014;2014;05;16;Torstai;284;1;285;37;0;37
96;08.05.2014;2014;05;17;Torstai;169;2;171;28;0;28
96;08.05.2014;2014;05;18;Torstai;132;3;135;36;0;36
96;08.05.2014;2014;05;19;Torstai;102;0;102;44;0;44
96;08.05.2014;2014;05;20;Torstai;97;0;97;20;0;20
96;08.05.2014;2014;05;21;Torstai;77;0;77;21;0;21
96;08.05.2014;2014;05;22;Torstai;28;0;28;5;0;5
96;08.05.2014;2014;05;23;Torstai;16;0;16;1;0;1
96;09.05.2014;2014;05;00;Perjantai;11;0;11;1;0;1
96;09.05.2014;2014;05;01;Perjantai;3;0;3;2;0;2
96;09.05.2014;2014;05;02;Perjantai;4;0;4;1;0;1
96;09.05.2014;2014;05;03;Perjantai;0;0;0;0;0;0
96;09.05.2014;2014;05;04;Perjantai;7;0;7;1;0;1
96;09.05.2014;2014;05;05;Perjantai;12;0;12;2;0;2
96;09.05.2014;2014;05;06;Perjantai;93;0;93;9;0;9
96;09.05.2014;2014;05;07;Perjantai;227;0;227;30;0;30
96;09.05.2014;2014;05;08;Perjantai;224;0;224;19;0;19
96;09.05.2014;2014;05;09;Perjantai;136;0;136;11;0;11
96;09.05.2014;2014;05;10;Perjantai;97;0;97;10;0;10
96;09.05.2014;2014;05;11;Perjantai;108;0;108;6;0;6
96;09.05.2014;2014;05;12;Perjantai;117;0;117;15;0;15
96;09.05.2014;2014;05;13;Perjantai;131;0;131;12;0;12
96;09.05.2014;2014;05;14;Perjantai;149;0;149;8;0;8
96;09.05.2014;2014;05;15;Perjantai;244;0;244;19;0;19
96;09.05.2014;2014;05;16;Perjantai;142;0;142;10;0;10
96;09.05.2014;2014;05;17;Perjantai;96;0;96;6;0;6
96;09.05.2014;2014;05;18;Perjantai;76;0;76;8;0;8
96;09.05.2014;2014;05;19;Perjantai;46;0;46;11;0;11
96;09.05.2014;2014;05;20;Perjantai;47;0;47;10;0;10
96;09.05.2014;2014;05;21;Perjantai;42;0;42;5;0;5
96;09.05.2014;2014;05;22;Perjantai;26;0;26;5;0;5
96;09.05.2014;2014;05;23;Perjantai;16;0;16;1;0;1
96;10.05.2014;2014;05;00;Lauantai;11;0;11;2;0;2
96;10.05.2014;2014;05;01;Lauantai;10;0;10;4;0;4
96;10.05.2014;2014;05;02;Lauantai;10;0;10;0;0;0
96;10.05.2014;2014;05;03;Lauantai;7;0;7;0;0;0
96;10.05.2014;2014;05;04;Lauantai;6;0;6;3;0;3
96;10.05.2014;2014;05;05;Lauantai;4;0;4;2;0;2
96;10.05.2014;2014;05;06;Lauantai;26;0;26;1;0;1
96;10.05.2014;2014;05;07;Lauantai;13;0;13;4;0;4
96;10.05.2014;2014;05;08;Lauantai;29;0;29;5;0;5
96;10.05.2014;2014;05;09;Lauantai;27;0;27;7;0;7
96;10.05.2014;2014;05;10;Lauantai;53;0;53;6;0;6
96;10.05.2014;2014;05;11;Lauantai;53;0;53;8;0;8
96;10.05.2014;2014;05;12;Lauantai;69;0;69;12;0;12
96;10.05.2014;2014;05;13;Lauantai;60;0;60;18;0;18
96;10.05.2014;2014;05;14;Lauantai;55;0;55;12;0;12
96;10.05.2014;2014;05;15;Lauantai;80;0;80;15;0;15
96;10.05.2014;2014;05;16;Lauantai;54;0;54;4;0;4
96;10.05.2014;2014;05;17;Lauantai;30;0;30;7;0;7
96;10.05.2014;2014;05;18;Lauantai;36;0;36;15;0;15
96;10.05.2014;2014;05;19;Lauantai;33;0;33;18;0;18
96;10.05.2014;2014;05;20;Lauantai;39;0;39;18;0;18
96;10.05.2014;2014;05;21;Lauantai;32;0;32;10;0;10
96;10.05.2014;2014;05;22;Lauantai;19;0;19;7;0;7
96;10.05.2014;2014;05;23;Lauantai;14;0;14;2;0;2
96;11.05.2014;2014;05;00;Sunnuntai;15;0;15;0;0;0
96;11.05.2014;2014;05;01;Sunnuntai;11;0;11;0;0;0
96;11.05.2014;2014;05;02;Sunnuntai;19;0;19;0;0;0
96;11.05.2014;2014;05;03;Sunnuntai;9;0;9;0;0;0
96;11.05.2014;2014;05;04;Sunnuntai;4;0;4;3;0;3
96;11.05.2014;2014;05;05;Sunnuntai;0;0;0;1;0;1
96;11.05.2014;2014;05;06;Sunnuntai;20;0;20;2;0;2
96;11.05.2014;2014;05;07;Sunnuntai;12;0;12;6;0;6
96;11.05.2014;2014;05;08;Sunnuntai;8;0;8;6;0;6
96;11.05.2014;2014;05;09;Sunnuntai;17;0;17;5;0;5
96;11.05.2014;2014;05;10;Sunnuntai;31;0;31;14;0;14
96;11.05.2014;2014;05;11;Sunnuntai;22;0;22;11;0;11
96;11.05.2014;2014;05;12;Sunnuntai;69;0;69;15;0;15
96;11.05.2014;2014;05;13;Sunnuntai;71;0;71;14;0;14
96;11.05.2014;2014;05;14;Sunnuntai;50;0;50;10;0;10
96;11.05.2014;2014;05;15;Sunnuntai;41;0;41;10;0;10
96;11.05.2014;2014;05;16;Sunnuntai;54;0;54;12;0;12
96;11.05.2014;2014;05;17;Sunnuntai;69;0;69;27;0;27
96;11.05.2014;2014;05;18;Sunnuntai;47;0;47;27;0;27
96;11.05.2014;2014;05;19;Sunnuntai;40;0;40;32;0;32
96;11.05.2014;2014;05;20;Sunnuntai;54;0;54;14;0;14
96;11.05.2014;2014;05;21;Sunnuntai;30;0;30;13;0;13
96;11.05.2014;2014;05;22;Sunnuntai;17;0;17;5;0;5
96;11.05.2014;2014;05;23;Sunnuntai;6;0;6;4;0;4
96;12.05.2014;2014;05;00;Maanantai;5;0;5;1;0;1
96;12.05.2014;2014;05;01;Maanantai;5;0;5;1;0;1
96;12.05.2014;2014;05;02;Maanantai;3;0;3;0;0;0
96;12.05.2014;2014;05;03;Maanantai;3;0;3;1;0;1
96;12.05.2014;2014;05;04;Maanantai;3;0;3;1;0;1
96;12.05.2014;2014;05;05;Maanantai;11;0;11;1;0;1
96;12.05.2014;2014;05;06;Maanantai;89;0;89;8;0;8
96;12.05.2014;2014;05;07;Maanantai;225;0;225;22;0;22
96;12.05.2014;2014;05;08;Maanantai;234;0;234;16;0;16
96;12.05.2014;2014;05;09;Maanantai;131;0;131;17;0;17
96;12.05.2014;2014;05;10;Maanantai;101;0;101;10;0;10
96;12.05.2014;2014;05;11;Maanantai;115;0;115;11;0;11
96;12.05.2014;2014;05;12;Maanantai;124;0;124;16;0;16
96;12.05.2014;2014;05;13;Maanantai;124;0;124;10;0;10
96;12.05.2014;2014;05;14;Maanantai;157;1;158;23;0;23
96;12.05.2014;2014;05;15;Maanantai;278;1;279;21;0;21
96;12.05.2014;2014;05;16;Maanantai;247;0;247;41;0;41
96;12.05.2014;2014;05;17;Maanantai;128;0;128;22;0;22
96;12.05.2014;2014;05;18;Maanantai;119;0;119;18;0;18
96;12.05.2014;2014;05;19;Maanantai;68;0;68;23;0;23
96;12.05.2014;2014;05;20;Maanantai;80;0;80;17;0;17
96;12.05.2014;2014;05;21;Maanantai;60;0;60;12;0;12
96;12.05.2014;2014;05;22;Maanantai;17;0;17;1;0;1
96;12.05.2014;2014;05;23;Maanantai;4;0;4;1;0;1
96;13.05.2014;2014;05;00;Tiistai;4;0;4;0;0;0
96;13.05.2014;2014;05;01;Tiistai;3;0;3;0;0;0
96;13.05.2014;2014;05;02;Tiistai;2;0;2;0;0;0
96;13.05.2014;2014;05;03;Tiistai;0;0;0;0;0;0
96;13.05.2014;2014;05;04;Tiistai;5;0;5;0;0;0
96;13.05.2014;2014;05;05;Tiistai;13;0;13;1;0;1
96;13.05.2014;2014;05;06;Tiistai;95;1;96;8;0;8
96;13.05.2014;2014;05;07;Tiistai;224;0;224;30;0;30
96;13.05.2014;2014;05;08;Tiistai;231;0;231;15;0;15
96;13.05.2014;2014;05;09;Tiistai;139;0;139;15;0;15
96;13.05.2014;2014;05;10;Tiistai;98;0;98;15;0;15
96;13.05.2014;2014;05;11;Tiistai;102;0;102;23;0;23
96;13.05.2014;2014;05;12;Tiistai;108;0;108;31;0;31
96;13.05.2014;2014;05;13;Tiistai;148;0;148;25;0;25
96;13.05.2014;2014;05;14;Tiistai;217;0;217;22;0;22
96;13.05.2014;2014;05;15;Tiistai;319;0;319;36;0;36
96;13.05.2014;2014;05;16;Tiistai;268;0;268;24;0;24
96;13.05.2014;2014;05;17;Tiistai;123;0;123;10;0;10
96;13.05.2014;2014;05;18;Tiistai;107;0;107;29;0;29
96;13.05.2014;2014;05;19;Tiistai;108;0;108;23;0;23
96;13.05.2014;2014;05;20;Tiistai;86;0;86;30;0;30
96;13.05.2014;2014;05;21;Tiistai;64;0;64;15;0;15
96;13.05.2014;2014;05;22;Tiistai;20;0;20;3;0;3
96;13.05.2014;2014;05;23;Tiistai;11;0;11;0;0;0
96;14.05.2014;2014;05;00;Keskiviikko;5;0;5;1;0;1
96;14.05.2014;2014;05;01;Keskiviikko;3;0;3;0;0;0
96;14.05.2014;2014;05;02;Keskiviikko;2;0;2;1;0;1
96;14.05.2014;2014;05;03;Keskiviikko;0;0;0;0;0;0
96;14.05.2014;2014;05;04;Keskiviikko;3;0;3;0;0;0
96;14.05.2014;2014;05;05;Keskiviikko;11;0;11;3;0;3
96;14.05.2014;2014;05;06;Keskiviikko;93;0;93;7;0;7
96;14.05.2014;2014;05;07;Keskiviikko;227;0;227;19;0;19
96;14.05.2014;2014;05;08;Keskiviikko;241;0;241;28;0;28
96;14.05.2014;2014;05;09;Keskiviikko;131;0;131;14;0;14
96;14.05.2014;2014;05;10;Keskiviikko;99;0;99;18;0;18
96;14.05.2014;2014;05;11;Keskiviikko;105;0;105;12;0;12
96;14.05.2014;2014;05;12;Keskiviikko;112;0;112;13;0;13
96;14.05.2014;2014;05;13;Keskiviikko;130;0;130;22;0;22
96;14.05.2014;2014;05;14;Keskiviikko;173;0;173;16;0;16
96;14.05.2014;2014;05;15;Keskiviikko;294;0;294;20;0;20
96;14.05.2014;2014;05;16;Keskiviikko;259;0;259;31;0;31
96;14.05.2014;2014;05;17;Keskiviikko;149;0;149;30;0;30
96;14.05.2014;2014;05;18;Keskiviikko;125;0;125;30;0;30
96;14.05.2014;2014;05;19;Keskiviikko;94;0;94;30;0;30
96;14.05.2014;2014;05;20;Keskiviikko;99;0;99;27;0;27
96;14.05.2014;2014;05;21;Keskiviikko;83;0;83;9;0;9
96;14.05.2014;2014;05;22;Keskiviikko;28;0;28;6;0;6
96;14.05.2014;2014;05;23;Keskiviikko;12;0;12;4;0;4
96;15.05.2014;2014;05;00;Torstai;5;0;5;2;0;2
96;15.05.2014;2014;05;01;Torstai;3;0;3;3;0;3
96;15.05.2014;2014;05;02;Torstai;5;0;5;0;0;0
96;15.05.2014;2014;05;03;Torstai;1;0;1;0;0;0
96;15.05.2014;2014;05;04;Torstai;4;0;4;0;0;0
96;15.05.2014;2014;05;05;Torstai;11;0;11;1;0;1
96;15.05.2014;2014;05;06;Torstai;78;0;78;6;0;6
96;15.05.2014;2014;05;07;Torstai;240;0;240;28;0;28
96;15.05.2014;2014;05;08;Torstai;272;0;272;24;0;24
96;15.05.2014;2014;05;09;Torstai;137;0;137;20;0;20
96;15.05.2014;2014;05;10;Torstai;137;1;138;19;0;19
96;15.05.2014;2014;05;11;Torstai;124;0;124;21;0;21
96;15.05.2014;2014;05;12;Torstai;135;0;135;23;0;23
96;15.05.2014;2014;05;13;Torstai;142;1;143;13;0;13
96;15.05.2014;2014;05;14;Torstai;176;0;176;10;0;10
96;15.05.2014;2014;05;15;Torstai;271;0;271;45;0;45
96;15.05.2014;2014;05;16;Torstai;295;0;295;32;0;32
96;15.05.2014;2014;05;17;Torstai;172;0;172;35;0;35
96;15.05.2014;2014;05;18;Torstai;129;0;129;29;0;29
96;15.05.2014;2014;05;19;Torstai;118;0;118;31;0;31
96;15.05.2014;2014;05;20;Torstai;89;0;89;40;0;40
96;15.05.2014;2014;05;21;Torstai;66;0;66;16;0;16
96;15.05.2014;2014;05;22;Torstai;26;0;26;9;0;9
96;15.05.2014;2014;05;23;Torstai;17;0;17;2;0;2
96;16.05.2014;2014;05;00;Perjantai;5;0;5;3;0;3
96;16.05.2014;2014;05;01;Perjantai;2;0;2;1;0;1
96;16.05.2014;2014;05;02;Perjantai;1;0;1;0;0;0
96;16.05.2014;2014;05;03;Perjantai;1;0;1;1;0;1
96;16.05.2014;2014;05;04;Perjantai;7;0;7;1;0;1
96;16.05.2014;2014;05;05;Perjantai;8;0;8;1;0;1
96;16.05.2014;2014;05;06;Perjantai;59;0;59;9;0;9
96;16.05.2014;2014;05;07;Perjantai;175;0;175;20;0;20
96;16.05.2014;2014;05;08;Perjantai;136;0;136;14;0;14
96;16.05.2014;2014;05;09;Perjantai;65;0;65;9;0;9
96;16.05.2014;2014;05;10;Perjantai;80;0;80;5;0;5
96;16.05.2014;2014;05;11;Perjantai;85;0;85;10;0;10
96;16.05.2014;2014;05;12;Perjantai;95;0;95;14;0;14
96;16.05.2014;2014;05;13;Perjantai;146;0;146;20;0;20
96;16.05.2014;2014;05;14;Perjantai;177;0;177;23;0;23
96;16.05.2014;2014;05;15;Perjantai;188;0;188;38;0;38
96;16.05.2014;2014;05;16;Perjantai;152;0;152;17;0;17
96;16.05.2014;2014;05;17;Perjantai;113;0;113;19;0;19
96;16.05.2014;2014;05;18;Perjantai;106;0;106;30;0;30
96;16.05.2014;2014;05;19;Perjantai;96;0;96;16;0;16
96;16.05.2014;2014;05;20;Perjantai;61;0;61;16;0;16
96;16.05.2014;2014;05;21;Perjantai;49;0;49;9;0;9
96;16.05.2014;2014;05;22;Perjantai;27;0;27;2;0;2
96;16.05.2014;2014;05;23;Perjantai;48;0;48;4;0;4
96;17.05.2014;2014;05;00;Lauantai;23;0;23;2;0;2
96;17.05.2014;2014;05;01;Lauantai;15;0;15;1;0;1
96;17.05.2014;2014;05;02;Lauantai;8;0;8;1;0;1
96;17.05.2014;2014;05;03;Lauantai;7;0;7;0;0;0
96;17.05.2014;2014;05;04;Lauantai;4;0;4;4;0;4
96;17.05.2014;2014;05;05;Lauantai;1;0;1;1;0;1
96;17.05.2014;2014;05;06;Lauantai;24;0;24;2;0;2
96;17.05.2014;2014;05;07;Lauantai;17;0;17;0;0;0
96;17.05.2014;2014;05;08;Lauantai;35;0;35;11;0;11
96;17.05.2014;2014;05;09;Lauantai;52;0;52;6;0;6
96;17.05.2014;2014;05;10;Lauantai;63;1;64;22;0;22
96;17.05.2014;2014;05;11;Lauantai;98;3;101;16;0;16
96;17.05.2014;2014;05;12;Lauantai;121;4;125;30;0;30
96;17.05.2014;2014;05;13;Lauantai;117;3;120;22;0;22
96;17.05.2014;2014;05;14;Lauantai;119;0;119;20;0;20
96;17.05.2014;2014;05;15;Lauantai;155;0;155;13;0;13
96;17.05.2014;2014;05;16;Lauantai;88;1;89;19;0;19
96;17.05.2014;2014;05;17;Lauantai;106;0;106;21;0;21
96;17.05.2014;2014;05;18;Lauantai;91;0;91;23;0;23
96;17.05.2014;2014;05;19;Lauantai;71;0;71;21;0;21
96;17.05.2014;2014;05;20;Lauantai;49;0;49;12;0;12
96;17.05.2014;2014;05;21;Lauantai;86;0;86;16;0;16
96;17.05.2014;2014;05;22;Lauantai;27;0;27;2;0;2
96;17.05.2014;2014;05;23;Lauantai;35;0;35;4;0;4
96;18.05.2014;2014;05;00;Sunnuntai;17;0;17;0;0;0
96;18.05.2014;2014;05;01;Sunnuntai;21;0;21;2;0;2
96;18.05.2014;2014;05;02;Sunnuntai;9;0;9;2;0;2
96;18.05.2014;2014;05;03;Sunnuntai;22;0;22;1;0;1
96;18.05.2014;2014;05;04;Sunnuntai;13;0;13;4;0;4
96;18.05.2014;2014;05;05;Sunnuntai;9;0;9;2;0;2
96;18.05.2014;2014;05;06;Sunnuntai;20;0;20;2;0;2
96;18.05.2014;2014;05;07;Sunnuntai;15;0;15;1;0;1
96;18.05.2014;2014;05;08;Sunnuntai;20;0;20;5;0;5
96;18.05.2014;2014;05;09;Sunnuntai;46;0;46;5;0;5
96;18.05.2014;2014;05;10;Sunnuntai;71;0;71;10;0;10
96;18.05.2014;2014;05;11;Sunnuntai;84;0;84;17;0;17
96;18.05.2014;2014;05;12;Sunnuntai;123;1;124;24;0;24
96;18.05.2014;2014;05;13;Sunnuntai;145;2;147;26;0;26
96;18.05.2014;2014;05;14;Sunnuntai;149;0;149;15;0;15
96;18.05.2014;2014;05;15;Sunnuntai;149;0;149;23;0;23
96;18.05.2014;2014;05;16;Sunnuntai;144;0;144;22;0;22
96;18.05.2014;2014;05;17;Sunnuntai;111;0;111;20;0;20
96;18.05.2014;2014;05;18;Sunnuntai;113;0;113;26;0;26
96;18.05.2014;2014;05;19;Sunnuntai;78;0;78;27;0;27
96;18.05.2014;2014;05;20;Sunnuntai;82;0;82;30;0;30
96;18.05.2014;2014;05;21;Sunnuntai;62;0;62;14;0;14
96;18.05.2014;2014;05;22;Sunnuntai;27;0;27;9;0;9
96;18.05.2014;2014;05;23;Sunnuntai;9;0;9;6;0;6
96;19.05.2014;2014;05;00;Maanantai;1;0;1;1;0;1
96;19.05.2014;2014;05;01;Maanantai;6;0;6;0;0;0
96;19.05.2014;2014;05;02;Maanantai;0;0;0;0;0;0
96;19.05.2014;2014;05;03;Maanantai;2;0;2;1;0;1
96;19.05.2014;2014;05;04;Maanantai;2;0;2;0;0;0
96;19.05.2014;2014;05;05;Maanantai;16;0;16;2;0;2
96;19.05.2014;2014;05;06;Maanantai;90;0;90;8;0;8
96;19.05.2014;2014;05;07;Maanantai;270;0;270;24;0;24
96;19.05.2014;2014;05;08;Maanantai;273;0;273;17;0;17
96;19.05.2014;2014;05;09;Maanantai;166;2;168;17;0;17
96;19.05.2014;2014;05;10;Maanantai;132;5;137;9;0;9
96;19.05.2014;2014;05;11;Maanantai;132;24;156;27;0;27
96;19.05.2014;2014;05;12;Maanantai;137;30;167;17;0;17
96;19.05.2014;2014;05;13;Maanantai;152;45;197;13;0;13
96;19.05.2014;2014;05;14;Maanantai;202;41;243;19;0;19
96;19.05.2014;2014;05;15;Maanantai;319;38;357;26;0;26
96;19.05.2014;2014;05;16;Maanantai;276;67;343;32;0;32
96;19.05.2014;2014;05;17;Maanantai;182;17;199;19;0;19
96;19.05.2014;2014;05;18;Maanantai;148;26;174;30;0;30
96;19.05.2014;2014;05;19;Maanantai;150;7;157;21;0;21
96;19.05.2014;2014;05;20;Maanantai;149;2;151;27;0;27
96;19.05.2014;2014;05;21;Maanantai;96;0;96;7;0;7
96;19.05.2014;2014;05;22;Maanantai;30;0;30;5;0;5
96;19.05.2014;2014;05;23;Maanantai;16;0;16;3;0;3
96;20.05.2014;2014;05;00;Tiistai;3;0;3;0;0;0
96;20.05.2014;2014;05;01;Tiistai;8;0;8;0;0;0
96;20.05.2014;2014;05;02;Tiistai;0;0;0;0;0;0
96;20.05.2014;2014;05;03;Tiistai;3;0;3;0;0;0
96;20.05.2014;2014;05;04;Tiistai;3;0;3;1;0;1
96;20.05.2014;2014;05;05;Tiistai;9;0;9;1;0;1
96;20.05.2014;2014;05;06;Tiistai;94;0;94;7;0;7
96;20.05.2014;2014;05;07;Tiistai;283;0;283;22;0;22
96;20.05.2014;2014;05;08;Tiistai;233;0;233;19;0;19
96;20.05.2014;2014;05;09;Tiistai;136;0;136;11;0;11
96;20.05.2014;2014;05;10;Tiistai;88;0;88;12;0;12
96;20.05.2014;2014;05;11;Tiistai;115;0;115;16;0;16
96;20.05.2014;2014;05;12;Tiistai;139;0;139;26;0;26
96;20.05.2014;2014;05;13;Tiistai;182;0;182;22;0;22
96;20.05.2014;2014;05;14;Tiistai;200;0;200;20;0;20
96;20.05.2014;2014;05;15;Tiistai;359;1;360;18;0;18
96;20.05.2014;2014;05;16;Tiistai;296;0;296;30;0;30
96;20.05.2014;2014;05;17;Tiistai;179;0;179;19;0;19
96;20.05.2014;2014;05;18;Tiistai;153;0;153;30;0;30
96;20.05.2014;2014;05;19;Tiistai;151;0;151;38;0;38
96;20.05.2014;2014;05;20;Tiistai;129;0;129;29;0;29
96;20.05.2014;2014;05;21;Tiistai;92;0;92;13;0;13
96;20.05.2014;2014;05;22;Tiistai;26;0;26;5;0;5
96;20.05.2014;2014;05;23;Tiistai;6;0;6;3;0;3
96;21.05.2014;2014;05;00;Keskiviikko;5;0;5;1;0;1
96;21.05.2014;2014;05;01;Keskiviikko;1;0;1;2;0;2
96;21.05.2014;2014;05;02;Keskiviikko;2;0;2;2;0;2
96;21.05.2014;2014;05;03;Keskiviikko;2;0;2;0;0;0
96;21.05.2014;2014;05;04;Keskiviikko;2;0;2;0;0;0
96;21.05.2014;2014;05;05;Keskiviikko;12;0;12;1;0;1
96;21.05.2014;2014;05;06;Keskiviikko;95;0;95;9;0;9
96;21.05.2014;2014;05;07;Keskiviikko;283;0;283;17;0;17
96;21.05.2014;2014;05;08;Keskiviikko;258;0;258;15;0;15
96;21.05.2014;2014;05;09;Keskiviikko;143;0;143;39;0;39
96;21.05.2014;2014;05;10;Keskiviikko;111;0;111;48;0;48
96;21.05.2014;2014;05;11;Keskiviikko;145;0;145;26;0;26
96;21.05.2014;2014;05;12;Keskiviikko;145;1;146;38;0;38
96;21.05.2014;2014;05;13;Keskiviikko;182;0;182;37;0;37
96;21.05.2014;2014;05;14;Keskiviikko;209;1;210;27;0;27
96;21.05.2014;2014;05;15;Keskiviikko;356;0;356;48;0;48
96;21.05.2014;2014;05;16;Keskiviikko;325;0;325;35;0;35
96;21.05.2014;2014;05;17;Keskiviikko;219;0;219;38;0;38
96;21.05.2014;2014;05;18;Keskiviikko;168;0;168;36;0;36
96;21.05.2014;2014;05;19;Keskiviikko;152;0;152;44;0;44
96;21.05.2014;2014;05;20;Keskiviikko;131;0;131;17;0;17
96;21.05.2014;2014;05;21;Keskiviikko;88;0;88;16;0;16
96;21.05.2014;2014;05;22;Keskiviikko;33;0;33;5;0;5
96;21.05.2014;2014;05;23;Keskiviikko;24;0;24;7;0;7
96;22.05.2014;2014;05;00;Torstai;6;0;6;1;0;1
96;22.05.2014;2014;05;01;Torstai;3;0;3;1;0;1
96;22.05.2014;2014;05;02;Torstai;4;0;4;2;0;2
96;22.05.2014;2014;05;03;Torstai;0;0;0;1;0;1
96;22.05.2014;2014;05;04;Torstai;2;0;2;0;0;0
96;22.05.2014;2014;05;05;Torstai;13;0;13;0;0;0
96;22.05.2014;2014;05;06;Torstai;89;0;89;4;0;4
96;22.05.2014;2014;05;07;Torstai;259;0;259;24;0;24
96;22.05.2014;2014;05;08;Torstai;275;0;275;16;0;16
96;22.05.2014;2014;05;09;Torstai;201;1;202;28;0;28
96;22.05.2014;2014;05;10;Torstai;147;0;147;44;0;44
96;22.05.2014;2014;05;11;Torstai;163;2;165;31;0;31
96;22.05.2014;2014;05;12;Torstai;172;2;174;43;0;43
96;22.05.2014;2014;05;13;Torstai;193;0;193;39;0;39
96;22.05.2014;2014;05;14;Torstai;247;0;247;40;0;40
96;22.05.2014;2014;05;15;Torstai;330;0;330;29;0;29
96;22.05.2014;2014;05;16;Torstai;327;0;327;29;0;29
96;22.05.2014;2014;05;17;Torstai;178;0;178;24;0;24
96;22.05.2014;2014;05;18;Torstai;144;0;144;7;0;7
96;22.05.2014;2014;05;19;Torstai;129;0;129;28;0;28
96;22.05.2014;2014;05;20;Torstai;81;0;81;20;0;20
96;22.05.2014;2014;05;21;Torstai;69;0;69;8;0;8
96;22.05.2014;2014;05;22;Torstai;31;0;31;6;0;6
96;22.05.2014;2014;05;23;Torstai;20;0;20;1;0;1
96;23.05.2014;2014;05;00;Perjantai;12;0;12;0;0;0
96;23.05.2014;2014;05;01;Perjantai;2;0;2;0;0;0
96;23.05.2014;2014;05;02;Perjantai;2;0;2;1;0;1
96;23.05.2014;2014;05;03;Perjantai;3;0;3;0;0;0
96;23.05.2014;2014;05;04;Perjantai;4;0;4;2;0;2
96;23.05.2014;2014;05;05;Perjantai;10;0;10;1;0;1
96;23.05.2014;2014;05;06;Perjantai;85;0;85;19;0;19
96;23.05.2014;2014;05;07;Perjantai;252;0;252;26;0;26
96;23.05.2014;2014;05;08;Perjantai;224;0;224;10;0;10
96;23.05.2014;2014;05;09;Perjantai;165;0;165;12;0;12
96;23.05.2014;2014;05;10;Perjantai;117;0;117;15;0;15
96;23.05.2014;2014;05;11;Perjantai;133;1;134;15;0;15
96;23.05.2014;2014;05;12;Perjantai;191;4;195;25;0;25
96;23.05.2014;2014;05;13;Perjantai;198;4;202;14;0;14
96;23.05.2014;2014;05;14;Perjantai;251;3;254;19;0;19
96;23.05.2014;2014;05;15;Perjantai;294;0;294;22;0;22
96;23.05.2014;2014;05;16;Perjantai;220;0;220;18;0;18
96;23.05.2014;2014;05;17;Perjantai;176;0;176;17;0;17
96;23.05.2014;2014;05;18;Perjantai;139;0;139;26;0;26
96;23.05.2014;2014;05;19;Perjantai;123;0;123;21;0;21
96;23.05.2014;2014;05;20;Perjantai;134;1;135;20;0;20
96;23.05.2014;2014;05;21;Perjantai;105;0;105;16;0;16
96;23.05.2014;2014;05;22;Perjantai;51;0;51;8;0;8
96;23.05.2014;2014;05;23;Perjantai;44;0;44;3;0;3
96;24.05.2014;2014;05;00;Lauantai;48;0;48;5;0;5
96;24.05.2014;2014;05;01;Lauantai;23;0;23;2;0;2
96;24.05.2014;2014;05;02;Lauantai;29;0;29;4;0;4
96;24.05.2014;2014;05;03;Lauantai;23;0;23;4;0;4
96;24.05.2014;2014;05;04;Lauantai;27;0;27;0;0;0
96;24.05.2014;2014;05;05;Lauantai;5;0;5;1;0;1
96;24.05.2014;2014;05;06;Lauantai;31;0;31;10;0;10
96;24.05.2014;2014;05;07;Lauantai;34;0;34;5;0;5
96;24.05.2014;2014;05;08;Lauantai;36;0;36;7;0;7
96;24.05.2014;2014;05;09;Lauantai;81;0;81;17;0;17
96;24.05.2014;2014;05;10;Lauantai;106;0;106;12;0;12
96;24.05.2014;2014;05;11;Lauantai;138;0;138;16;0;16
96;24.05.2014;2014;05;12;Lauantai;145;0;145;12;0;12
96;24.05.2014;2014;05;13;Lauantai;156;1;157;23;0;23
96;24.05.2014;2014;05;14;Lauantai;144;0;144;13;0;13
96;24.05.2014;2014;05;15;Lauantai;173;0;173;18;0;18
96;24.05.2014;2014;05;16;Lauantai;129;0;129;20;0;20
96;24.05.2014;2014;05;17;Lauantai;155;0;155;20;0;20
96;24.05.2014;2014;05;18;Lauantai;138;0;138;12;0;12
96;24.05.2014;2014;05;19;Lauantai;84;0;84;19;0;19
96;24.05.2014;2014;05;20;Lauantai;79;0;79;17;0;17
96;24.05.2014;2014;05;21;Lauantai;73;0;73;8;0;8
96;24.05.2014;2014;05;22;Lauantai;50;0;50;8;0;8
96;24.05.2014;2014;05;23;Lauantai;54;0;54;4;0;4
96;25.05.2014;2014;05;00;Sunnuntai;27;0;27;1;0;1
96;25.05.2014;2014;05;01;Sunnuntai;35;0;35;0;0;0
96;25.05.2014;2014;05;02;Sunnuntai;23;0;23;0;0;0
96;25.05.2014;2014;05;03;Sunnuntai;28;0;28;5;0;5
96;25.05.2014;2014;05;04;Sunnuntai;17;0;17;3;0;3
96;25.05.2014;2014;05;05;Sunnuntai;7;0;7;3;0;3
96;25.05.2014;2014;05;06;Sunnuntai;24;0;24;3;0;3
96;25.05.2014;2014;05;07;Sunnuntai;12;0;12;6;0;6
96;25.05.2014;2014;05;08;Sunnuntai;8;0;8;2;0;2
96;25.05.2014;2014;05;09;Sunnuntai;14;0;14;2;0;2
96;25.05.2014;2014;05;10;Sunnuntai;15;0;15;3;0;3
96;25.05.2014;2014;05;11;Sunnuntai;15;0;15;6;0;6
96;25.05.2014;2014;05;12;Sunnuntai;39;0;39;16;0;16
96;25.05.2014;2014;05;13;Sunnuntai;44;0;44;6;0;6
96;25.05.2014;2014;05;14;Sunnuntai;51;0;51;7;0;7
96;25.05.2014;2014;05;15;Sunnuntai;63;0;63;10;0;10
96;25.05.2014;2014;05;16;Sunnuntai;78;0;78;10;0;10
96;25.05.2014;2014;05;17;Sunnuntai;77;0;77;20;0;20
96;25.05.2014;2014;05;18;Sunnuntai;52;0;52;23;0;23
96;25.05.2014;2014;05;19;Sunnuntai;59;0;59;16;0;16
96;25.05.2014;2014;05;20;Sunnuntai;72;0;72;16;0;16
96;25.05.2014;2014;05;21;Sunnuntai;40;0;40;6;0;6
96;25.05.2014;2014;05;22;Sunnuntai;6;0;6;4;0;4
96;25.05.2014;2014;05;23;Sunnuntai;17;0;17;0;0;0
96;26.05.2014;2014;05;00;Maanantai;16;0;16;2;0;2
96;26.05.2014;2014;05;01;Maanantai;6;0;6;1;0;1
96;26.05.2014;2014;05;02;Maanantai;4;0;4;0;0;0
96;26.05.2014;2014;05;03;Maanantai;3;0;3;1;0;1
96;26.05.2014;2014;05;04;Maanantai;5;0;5;0;0;0
96;26.05.2014;2014;05;05;Maanantai;15;0;15;0;0;0
96;26.05.2014;2014;05;06;Maanantai;73;0;73;7;0;7
96;26.05.2014;2014;05;07;Maanantai;210;0;210;32;0;32
96;26.05.2014;2014;05;08;Maanantai;215;0;215;11;0;11
96;26.05.2014;2014;05;09;Maanantai;124;0;124;13;0;13
96;26.05.2014;2014;05;10;Maanantai;106;0;106;13;0;13
96;26.05.2014;2014;05;11;Maanantai;106;0;106;23;0;23
96;26.05.2014;2014;05;12;Maanantai;133;0;133;13;0;13
96;26.05.2014;2014;05;13;Maanantai;139;0;139;22;0;22
96;26.05.2014;2014;05;14;Maanantai;176;0;176;14;0;14
96;26.05.2014;2014;05;15;Maanantai;237;0;237;28;0;28
96;26.05.2014;2014;05;16;Maanantai;221;0;221;24;0;24
96;26.05.2014;2014;05;17;Maanantai;134;0;134;19;0;19
96;26.05.2014;2014;05;18;Maanantai;81;0;81;25;0;25
96;26.05.2014;2014;05;19;Maanantai;64;0;64;13;0;13
96;26.05.2014;2014;05;20;Maanantai;77;0;77;13;0;13
96;26.05.2014;2014;05;21;Maanantai;62;0;62;20;0;20
96;26.05.2014;2014;05;22;Maanantai;19;0;19;8;0;8
96;26.05.2014;2014;05;23;Maanantai;7;0;7;1;0;1
96;27.05.2014;2014;05;00;Tiistai;4;0;4;1;0;1
96;27.05.2014;2014;05;01;Tiistai;4;0;4;1;0;1
96;27.05.2014;2014;05;02;Tiistai;1;0;1;0;0;0
96;27.05.2014;2014;05;03;Tiistai;0;0;0;0;0;0
96;27.05.2014;2014;05;04;Tiistai;2;0;2;0;0;0
96;27.05.2014;2014;05;05;Tiistai;18;0;18;2;0;2
96;27.05.2014;2014;05;06;Tiistai;88;0;88;16;0;16
96;27.05.2014;2014;05;07;Tiistai;218;0;218;24;0;24
96;27.05.2014;2014;05;08;Tiistai;221;0;221;12;0;12
96;27.05.2014;2014;05;09;Tiistai;135;0;135;14;0;14
96;27.05.2014;2014;05;10;Tiistai;122;0;122;6;0;6
96;27.05.2014;2014;05;11;Tiistai;139;0;139;27;0;27
96;27.05.2014;2014;05;12;Tiistai;148;0;148;11;0;11
96;27.05.2014;2014;05;13;Tiistai;176;0;176;15;0;15
96;27.05.2014;2014;05;14;Tiistai;167;1;168;24;0;24
96;27.05.2014;2014;05;15;Tiistai;261;0;261;18;0;18
96;27.05.2014;2014;05;16;Tiistai;259;0;259;21;0;21
96;27.05.2014;2014;05;17;Tiistai;146;0;146;27;0;27
96;27.05.2014;2014;05;18;Tiistai;108;0;108;13;0;13
96;27.05.2014;2014;05;19;Tiistai;85;0;85;21;0;21
96;27.05.2014;2014;05;20;Tiistai;87;0;87;18;0;18
96;27.05.2014;2014;05;21;Tiistai;65;0;65;7;0;7
96;27.05.2014;2014;05;22;Tiistai;27;0;27;1;0;1
96;27.05.2014;2014;05;23;Tiistai;8;0;8;0;0;0
96;28.05.2014;2014;05;00;Keskiviikko;4;0;4;1;0;1
96;28.05.2014;2014;05;01;Keskiviikko;7;0;7;0;0;0
96;28.05.2014;2014;05;02;Keskiviikko;3;0;3;0;0;0
96;28.05.2014;2014;05;03;Keskiviikko;1;0;1;0;0;0
96;28.05.2014;2014;05;04;Keskiviikko;5;0;5;0;0;0
96;28.05.2014;2014;05;05;Keskiviikko;15;0;15;2;0;2
96;28.05.2014;2014;05;06;Keskiviikko;85;0;85;12;0;12
96;28.05.2014;2014;05;07;Keskiviikko;224;0;224;28;0;28
96;28.05.2014;2014;05;08;Keskiviikko;219;0;219;19;0;19
96;28.05.2014;2014;05;09;Keskiviikko;127;0;127;14;0;14
96;28.05.2014;2014;05;10;Keskiviikko;172;0;172;16;0;16
96;28.05.2014;2014;05;11;Keskiviikko;162;3;165;32;0;32
96;28.05.2014;2014;05;12;Keskiviikko;213;1;214;16;0;16
96;28.05.2014;2014;05;13;Keskiviikko;164;0;164;20;0;20
96;28.05.2014;2014;05;14;Keskiviikko;185;0;185;29;0;29
96;28.05.2014;2014;05;15;Keskiviikko;325;0;325;35;0;35
96;28.05.2014;2014;05;16;Keskiviikko;262;0;262;22;0;22
96;28.05.2014;2014;05;17;Keskiviikko;172;0;172;48;0;48
96;28.05.2014;2014;05;18;Keskiviikko;140;0;140;48;0;48
96;28.05.2014;2014;05;19;Keskiviikko;124;0;124;41;0;41
96;28.05.2014;2014;05;20;Keskiviikko;99;0;99;20;0;20
96;28.05.2014;2014;05;21;Keskiviikko;82;0;82;9;0;9
96;28.05.2014;2014;05;22;Keskiviikko;34;0;34;4;0;4
96;28.05.2014;2014;05;23;Keskiviikko;24;0;24;3;0;3
96;29.05.2014;2014;05;00;Torstai;17;0;17;3;0;3
96;29.05.2014;2014;05;01;Torstai;22;0;22;1;0;1
96;29.05.2014;2014;05;02;Torstai;15;0;15;0;0;0
96;29.05.2014;2014;05;03;Torstai;16;0;16;3;0;3
96;29.05.2014;2014;05;04;Torstai;9;0;9;1;0;1
96;29.05.2014;2014;05;05;Torstai;4;0;4;1;0;1
96;29.05.2014;2014;05;06;Torstai;30;0;30;2;0;2
96;29.05.2014;2014;05;07;Torstai;17;0;17;5;0;5
96;29.05.2014;2014;05;08;Torstai;23;0;23;4;0;4
96;29.05.2014;2014;05;09;Torstai;35;0;35;13;0;13
96;29.05.2014;2014;05;10;Torstai;36;0;36;8;0;8
96;29.05.2014;2014;05;11;Torstai;60;0;60;12;0;12
96;29.05.2014;2014;05;12;Torstai;93;0;93;13;0;13
96;29.05.2014;2014;05;13;Torstai;116;1;117;13;0;13
96;29.05.2014;2014;05;14;Torstai;108;0;108;19;0;19
96;29.05.2014;2014;05;15;Torstai;101;0;101;22;0;22
96;29.05.2014;2014;05;16;Torstai;121;0;121;12;0;12
96;29.05.2014;2014;05;17;Torstai;100;0;100;8;0;8
96;29.05.2014;2014;05;18;Torstai;92;0;92;21;0;21
96;29.05.2014;2014;05;19;Torstai;92;0;92;14;0;14
96;29.05.2014;2014;05;20;Torstai;70;0;70;19;0;19
96;29.05.2014;2014;05;21;Torstai;52;0;52;12;0;12
96;29.05.2014;2014;05;22;Torstai;18;0;18;8;0;8
96;29.05.2014;2014;05;23;Torstai;18;0;18;4;0;4
96;30.05.2014;2014;05;00;Perjantai;6;0;6;1;0;1
96;30.05.2014;2014;05;01;Perjantai;3;0;3;0;0;0
96;30.05.2014;2014;05;02;Perjantai;5;0;5;0;0;0
96;30.05.2014;2014;05;03;Perjantai;5;0;5;1;0;1
96;30.05.2014;2014;05;04;Perjantai;5;0;5;1;0;1
96;30.05.2014;2014;05;05;Perjantai;12;0;12;0;0;0
96;30.05.2014;2014;05;06;Perjantai;60;0;60;5;0;5
96;30.05.2014;2014;05;07;Perjantai;98;0;98;13;0;13
96;30.05.2014;2014;05;08;Perjantai;107;0;107;8;0;8
96;30.05.2014;2014;05;09;Perjantai;76;0;76;8;0;8
96;30.05.2014;2014;05;10;Perjantai;67;0;67;4;0;4
96;30.05.2014;2014;05;11;Perjantai;68;0;68;13;0;13
96;30.05.2014;2014;05;12;Perjantai;61;1;62;5;0;5
96;30.05.2014;2014;05;13;Perjantai;62;0;62;6;0;6
96;30.05.2014;2014;05;14;Perjantai;90;1;91;9;0;9
96;30.05.2014;2014;05;15;Perjantai;110;3;113;18;0;18
96;30.05.2014;2014;05;16;Perjantai;92;1;93;15;0;15
96;30.05.2014;2014;05;17;Perjantai;60;0;60;4;0;4
96;30.05.2014;2014;05;18;Perjantai;44;0;44;12;0;12
96;30.05.2014;2014;05;19;Perjantai;44;0;44;8;0;8
96;30.05.2014;2014;05;20;Perjantai;41;0;41;4;0;4
96;30.05.2014;2014;05;21;Perjantai;33;0;33;6;0;6
96;30.05.2014;2014;05;22;Perjantai;14;0;14;4;0;4
96;30.05.2014;2014;05;23;Perjantai;8;0;8;0;0;0
96;31.05.2014;2014;05;00;Lauantai;6;0;6;1;0;1
96;31.05.2014;2014;05;01;Lauantai;2;0;2;0;0;0
96;31.05.2014;2014;05;02;Lauantai;4;0;4;3;0;3
96;31.05.2014;2014;05;03;Lauantai;8;0;8;4;0;4
96;31.05.2014;2014;05;04;Lauantai;2;0;2;3;0;3
96;31.05.2014;2014;05;05;Lauantai;2;0;2;2;0;2
96;31.05.2014;2014;05;06;Lauantai;31;0;31;4;0;4
96;31.05.2014;2014;05;07;Lauantai;19;0;19;3;0;3
96;31.05.2014;2014;05;08;Lauantai;34;0;34;4;0;4
96;31.05.2014;2014;05;09;Lauantai;42;0;42;9;0;9
96;31.05.2014;2014;05;10;Lauantai;68;0;68;15;0;15
96;31.05.2014;2014;05;11;Lauantai;76;0;76;11;0;11
96;31.05.2014;2014;05;12;Lauantai;114;0;114;18;0;18
96;31.05.2014;2014;05;13;Lauantai;93;0;93;20;0;20
96;31.05.2014;2014;05;14;Lauantai;129;0;129;24;0;24
96;31.05.2014;2014;05;15;Lauantai;130;0;130;28;0;28
96;31.05.2014;2014;05;16;Lauantai;90;0;90;25;0;25
96;31.05.2014;2014;05;17;Lauantai;54;0;54;8;0;8
96;31.05.2014;2014;05;18;Lauantai;60;0;60;6;0;6
96;31.05.2014;2014;05;19;Lauantai;61;0;61;8;0;8
96;31.05.2014;2014;05;20;Lauantai;35;0;35;9;0;9
96;31.05.2014;2014;05;21;Lauantai;53;0;53;9;0;9
96;31.05.2014;2014;05;22;Lauantai;26;0;26;3;0;3
96;31.05.2014;2014;05;23;Lauantai;26;0;26;8;0;8
96;01.06.2014;2014;06;00;Sunnuntai;32;0;32;5;0;5
96;01.06.2014;2014;06;01;Sunnuntai;18;1;19;4;0;4
96;01.06.2014;2014;06;02;Sunnuntai;22;0;22;1;0;1
96;01.06.2014;2014;06;03;Sunnuntai;25;0;25;4;0;4
96;01.06.2014;2014;06;04;Sunnuntai;14;0;14;5;0;5
96;01.06.2014;2014;06;05;Sunnuntai;4;0;4;3;0;3
96;01.06.2014;2014;06;06;Sunnuntai;17;0;17;2;0;2
96;01.06.2014;2014;06;07;Sunnuntai;7;0;7;3;0;3
96;01.06.2014;2014;06;08;Sunnuntai;9;0;9;4;0;4
96;01.06.2014;2014;06;09;Sunnuntai;31;0;31;7;0;7
96;01.06.2014;2014;06;10;Sunnuntai;35;0;35;17;0;17
96;01.06.2014;2014;06;11;Sunnuntai;31;0;31;10;0;10
96;01.06.2014;2014;06;12;Sunnuntai;64;0;64;25;0;25
96;01.06.2014;2014;06;13;Sunnuntai;85;0;85;11;0;11
96;01.06.2014;2014;06;14;Sunnuntai;104;0;104;20;0;20
96;01.06.2014;2014;06;15;Sunnuntai;83;0;83;16;0;16
96;01.06.2014;2014;06;16;Sunnuntai;84;0;84;22;0;22
96;01.06.2014;2014;06;17;Sunnuntai;83;0;83;21;0;21
96;01.06.2014;2014;06;18;Sunnuntai;84;0;84;22;0;22
96;01.06.2014;2014;06;19;Sunnuntai;64;0;64;19;0;19
96;01.06.2014;2014;06;20;Sunnuntai;51;0;51;19;0;19
96;01.06.2014;2014;06;21;Sunnuntai;41;0;41;10;0;10
96;01.06.2014;2014;06;22;Sunnuntai;33;0;33;4;0;4
96;01.06.2014;2014;06;23;Sunnuntai;14;0;14;0;0;0
96;02.06.2014;2014;06;00;Maanantai;7;0;7;1;0;1
96;02.06.2014;2014;06;01;Maanantai;4;0;4;0;0;0
96;02.06.2014;2014;06;02;Maanantai;1;0;1;0;0;0
96;02.06.2014;2014;06;03;Maanantai;1;0;1;1;0;1
96;02.06.2014;2014;06;04;Maanantai;4;0;4;0;0;0
96;02.06.2014;2014;06;05;Maanantai;19;0;19;3;0;3
96;02.06.2014;2014;06;06;Maanantai;107;0;107;6;0;6
96;02.06.2014;2014;06;07;Maanantai;214;0;214;15;0;15
96;02.06.2014;2014;06;08;Maanantai;207;0;207;15;0;15
96;02.06.2014;2014;06;09;Maanantai;140;0;140;17;0;17
96;02.06.2014;2014;06;10;Maanantai;109;0;109;14;0;14
96;02.06.2014;2014;06;11;Maanantai;152;1;153;22;0;22
96;02.06.2014;2014;06;12;Maanantai;174;2;176;32;0;32
96;02.06.2014;2014;06;13;Maanantai;154;0;154;23;0;23
96;02.06.2014;2014;06;14;Maanantai;194;0;194;25;0;25
96;02.06.2014;2014;06;15;Maanantai;306;0;306;41;0;41
96;02.06.2014;2014;06;16;Maanantai;310;0;310;43;0;43
96;02.06.2014;2014;06;17;Maanantai;215;0;215;40;0;40
96;02.06.2014;2014;06;18;Maanantai;151;0;151;33;0;33
96;02.06.2014;2014;06;19;Maanantai;125;0;125;28;0;28
96;02.06.2014;2014;06;20;Maanantai;136;0;136;22;0;22
96;02.06.2014;2014;06;21;Maanantai;89;0;89;11;0;11
96;02.06.2014;2014;06;22;Maanantai;16;0;16;6;0;6
96;02.06.2014;2014;06;23;Maanantai;15;0;15;5;0;5
96;03.06.2014;2014;06;00;Tiistai;5;0;5;0;0;0
96;03.06.2014;2014;06;01;Tiistai;6;0;6;0;0;0
96;03.06.2014;2014;06;02;Tiistai;13;0;13;0;0;0
96;03.06.2014;2014;06;03;Tiistai;2;0;2;0;0;0
96;03.06.2014;2014;06;04;Tiistai;1;0;1;1;0;1
96;03.06.2014;2014;06;05;Tiistai;19;0;19;1;0;1
96;03.06.2014;2014;06;06;Tiistai;101;0;101;9;0;9
96;03.06.2014;2014;06;07;Tiistai;250;0;250;17;0;17
96;03.06.2014;2014;06;08;Tiistai;224;0;224;9;0;9
96;03.06.2014;2014;06;09;Tiistai;153;0;153;18;0;18
96;03.06.2014;2014;06;10;Tiistai;129;0;129;21;0;21
96;03.06.2014;2014;06;11;Tiistai;143;1;144;23;0;23
96;03.06.2014;2014;06;12;Tiistai;186;0;186;21;0;21
96;03.06.2014;2014;06;13;Tiistai;169;1;170;30;0;30
96;03.06.2014;2014;06;14;Tiistai;208;0;208;27;0;27
96;03.06.2014;2014;06;15;Tiistai;374;0;374;40;0;40
96;03.06.2014;2014;06;16;Tiistai;331;0;331;38;0;38
96;03.06.2014;2014;06;17;Tiistai;231;0;231;39;0;39
96;03.06.2014;2014;06;18;Tiistai;163;0;163;40;0;40
96;03.06.2014;2014;06;19;Tiistai;150;0;150;58;0;58
96;03.06.2014;2014;06;20;Tiistai;163;0;163;34;0;34
96;03.06.2014;2014;06;21;Tiistai;116;0;116;6;0;6
96;03.06.2014;2014;06;22;Tiistai;42;0;42;2;0;2
96;03.06.2014;2014;06;23;Tiistai;12;0;12;4;0;4
96;04.06.2014;2014;06;00;Keskiviikko;18;0;18;8;0;8
96;04.06.2014;2014;06;01;Keskiviikko;6;0;6;1;0;1
96;04.06.2014;2014;06;02;Keskiviikko;7;0;7;1;0;1
96;04.06.2014;2014;06;03;Keskiviikko;11;0;11;1;0;1
96;04.06.2014;2014;06;04;Keskiviikko;6;0;6;0;0;0
96;04.06.2014;2014;06;05;Keskiviikko;14;0;14;1;0;1
96;04.06.2014;2014;06;06;Keskiviikko;104;0;104;7;0;7
96;04.06.2014;2014;06;07;Keskiviikko;231;0;231;15;0;15
96;04.06.2014;2014;06;08;Keskiviikko;197;0;197;16;0;16
96;04.06.2014;2014;06;09;Keskiviikko;133;0;133;12;0;12
96;04.06.2014;2014;06;10;Keskiviikko;92;0;92;11;0;11
96;04.06.2014;2014;06;11;Keskiviikko;110;0;110;9;0;9
96;04.06.2014;2014;06;12;Keskiviikko;140;0;140;15;0;15
96;04.06.2014;2014;06;13;Keskiviikko;152;0;152;10;0;10
96;04.06.2014;2014;06;14;Keskiviikko;182;0;182;22;0;22
96;04.06.2014;2014;06;15;Keskiviikko;294;0;294;25;0;25
96;04.06.2014;2014;06;16;Keskiviikko;302;0;302;31;0;31
96;04.06.2014;2014;06;17;Keskiviikko;212;0;212;40;0;40
96;04.06.2014;2014;06;18;Keskiviikko;159;0;159;21;0;21
96;04.06.2014;2014;06;19;Keskiviikko;162;0;162;30;0;30
96;04.06.2014;2014;06;20;Keskiviikko;126;0;126;23;0;23
96;04.06.2014;2014;06;21;Keskiviikko;120;0;120;11;0;11
96;04.06.2014;2014;06;22;Keskiviikko;57;0;57;7;0;7
96;04.06.2014;2014;06;23;Keskiviikko;26;0;26;1;0;1
96;05.06.2014;2014;06;00;Torstai;7;0;7;3;0;3
96;05.06.2014;2014;06;01;Torstai;8;0;8;0;0;0
96;05.06.2014;2014;06;02;Torstai;3;0;3;0;0;0
96;05.06.2014;2014;06;03;Torstai;2;0;2;4;0;4
96;05.06.2014;2014;06;04;Torstai;11;0;11;1;0;1
96;05.06.2014;2014;06;05;Torstai;25;0;25;1;0;1
96;05.06.2014;2014;06;06;Torstai;107;0;107;12;0;12
96;05.06.2014;2014;06;07;Torstai;227;0;227;15;0;15
96;05.06.2014;2014;06;08;Torstai;208;0;208;10;0;10
96;05.06.2014;2014;06;09;Torstai;161;0;161;14;0;14
96;05.06.2014;2014;06;10;Torstai;125;0;125;15;0;15
96;05.06.2014;2014;06;11;Torstai;127;0;127;21;0;21
96;05.06.2014;2014;06;12;Torstai;156;1;157;16;0;16
96;05.06.2014;2014;06;13;Torstai;113;2;115;1;0;1
96;05.06.2014;2014;06;14;Torstai;181;1;182;18;0;18
96;05.06.2014;2014;06;15;Torstai;302;0;302;27;0;27
96;05.06.2014;2014;06;16;Torstai;306;0;306;31;0;31
96;05.06.2014;2014;06;17;Torstai;186;0;186;20;0;20
96;05.06.2014;2014;06;18;Torstai;138;0;138;19;0;19
96;05.06.2014;2014;06;19;Torstai;147;0;147;6;0;6
96;05.06.2014;2014;06;20;Torstai;136;0;136;24;0;24
96;05.06.2014;2014;06;21;Torstai;90;0;90;10;0;10
96;05.06.2014;2014;06;22;Torstai;53;0;53;5;0;5
96;05.06.2014;2014;06;23;Torstai;16;0;16;4;0;4
96;06.06.2014;2014;06;00;Perjantai;18;0;18;4;0;4
96;06.06.2014;2014;06;01;Perjantai;14;0;14;1;0;1
96;06.06.2014;2014;06;02;Perjantai;6;0;6;1;0;1
96;06.06.2014;2014;06;03;Perjantai;1;0;1;0;0;0
96;06.06.2014;2014;06;04;Perjantai;7;0;7;0;0;0
96;06.06.2014;2014;06;05;Perjantai;17;0;17;2;0;2
96;06.06.2014;2014;06;06;Perjantai;108;0;108;7;0;7
96;06.06.2014;2014;06;07;Perjantai;215;0;215;21;0;21
96;06.06.2014;2014;06;08;Perjantai;189;0;189;10;0;10
96;06.06.2014;2014;06;09;Perjantai;127;0;127;8;0;8
96;06.06.2014;2014;06;10;Perjantai;103;0;103;10;0;10
96;06.06.2014;2014;06;11;Perjantai;126;0;126;14;0;14
96;06.06.2014;2014;06;12;Perjantai;149;0;149;20;0;20
96;06.06.2014;2014;06;13;Perjantai;169;0;169;20;0;20
96;06.06.2014;2014;06;14;Perjantai;243;0;243;37;0;37
96;06.06.2014;2014;06;15;Perjantai;278;0;278;33;0;33
96;06.06.2014;2014;06;16;Perjantai;210;0;210;24;0;24
96;06.06.2014;2014;06;17;Perjantai;152;0;152;19;0;19
96;06.06.2014;2014;06;18;Perjantai;96;0;96;6;0;6
96;06.06.2014;2014;06;19;Perjantai;79;0;79;9;0;9
96;06.06.2014;2014;06;20;Perjantai;71;0;71;9;0;9
96;06.06.2014;2014;06;21;Perjantai;58;0;58;11;0;11
96;06.06.2014;2014;06;22;Perjantai;41;1;42;7;0;7
96;06.06.2014;2014;06;23;Perjantai;41;0;41;8;0;8
96;07.06.2014;2014;06;00;Lauantai;22;0;22;5;0;5
96;07.06.2014;2014;06;01;Lauantai;22;0;22;1;0;1
96;07.06.2014;2014;06;02;Lauantai;24;0;24;1;0;1
96;07.06.2014;2014;06;03;Lauantai;15;0;15;4;0;4
96;07.06.2014;2014;06;04;Lauantai;13;0;13;5;0;5
96;07.06.2014;2014;06;05;Lauantai;9;0;9;5;0;5
96;07.06.2014;2014;06;06;Lauantai;32;0;32;6;0;6
96;07.06.2014;2014;06;07;Lauantai;28;0;28;1;0;1
96;07.06.2014;2014;06;08;Lauantai;26;0;26;2;0;2
96;07.06.2014;2014;06;09;Lauantai;65;0;65;5;0;5
96;07.06.2014;2014;06;10;Lauantai;77;0;77;15;0;15
96;07.06.2014;2014;06;11;Lauantai;123;0;123;17;0;17
96;07.06.2014;2014;06;12;Lauantai;116;0;116;22;0;22
96;07.06.2014;2014;06;13;Lauantai;141;0;141;25;0;25
96;07.06.2014;2014;06;14;Lauantai;130;0;130;18;0;18
96;07.06.2014;2014;06;15;Lauantai;141;0;141;17;0;17
96;07.06.2014;2014;06;16;Lauantai;95;0;95;13;0;13
96;07.06.2014;2014;06;17;Lauantai;119;0;119;14;0;14
96;07.06.2014;2014;06;18;Lauantai;105;0;105;8;0;8
96;07.06.2014;2014;06;19;Lauantai;77;0;77;15;0;15
96;07.06.2014;2014;06;20;Lauantai;76;0;76;15;0;15
96;07.06.2014;2014;06;21;Lauantai;66;0;66;15;0;15
96;07.06.2014;2014;06;22;Lauantai;46;0;46;5;0;5
96;07.06.2014;2014;06;23;Lauantai;28;0;28;6;0;6
96;08.06.2014;2014;06;00;Sunnuntai;28;0;28;5;0;5
96;08.06.2014;2014;06;01;Sunnuntai;33;0;33;3;0;3
96;08.06.2014;2014;06;02;Sunnuntai;26;0;26;2;0;2
96;08.06.2014;2014;06;03;Sunnuntai;25;0;25;1;0;1
96;08.06.2014;2014;06;04;Sunnuntai;11;0;11;5;0;5
96;08.06.2014;2014;06;05;Sunnuntai;2;0;2;3;0;3
96;08.06.2014;2014;06;06;Sunnuntai;23;0;23;15;0;15
96;08.06.2014;2014;06;07;Sunnuntai;15;0;15;1;0;1
96;08.06.2014;2014;06;08;Sunnuntai;9;0;9;0;0;0
96;08.06.2014;2014;06;09;Sunnuntai;11;0;11;3;0;3
96;08.06.2014;2014;06;10;Sunnuntai;16;0;16;2;0;2
96;08.06.2014;2014;06;11;Sunnuntai;25;0;25;8;0;8
96;08.06.2014;2014;06;12;Sunnuntai;68;0;68;10;0;10
96;08.06.2014;2014;06;13;Sunnuntai;88;0;88;12;0;12
96;08.06.2014;2014;06;14;Sunnuntai;89;0;89;8;0;8
96;08.06.2014;2014;06;15;Sunnuntai;88;0;88;11;0;11
96;08.06.2014;2014;06;16;Sunnuntai;80;0;80;15;0;15
96;08.06.2014;2014;06;17;Sunnuntai;89;0;89;20;0;20
96;08.06.2014;2014;06;18;Sunnuntai;67;0;67;22;0;22
96;08.06.2014;2014;06;19;Sunnuntai;47;0;47;19;0;19
96;08.06.2014;2014;06;20;Sunnuntai;54;0;54;19;0;19
96;08.06.2014;2014;06;21;Sunnuntai;46;0;46;7;0;7
96;08.06.2014;2014;06;22;Sunnuntai;17;0;17;2;0;2
96;08.06.2014;2014;06;23;Sunnuntai;12;0;12;4;0;4
96;09.06.2014;2014;06;00;Maanantai;8;0;8;1;0;1
96;09.06.2014;2014;06;01;Maanantai;3;0;3;0;0;0
96;09.06.2014;2014;06;02;Maanantai;4;0;4;1;0;1
96;09.06.2014;2014;06;03;Maanantai;1;0;1;0;0;0
96;09.06.2014;2014;06;04;Maanantai;6;0;6;1;0;1
96;09.06.2014;2014;06;05;Maanantai;8;0;8;0;0;0
96;09.06.2014;2014;06;06;Maanantai;66;0;66;6;0;6
96;09.06.2014;2014;06;07;Maanantai;179;0;179;13;0;13
96;09.06.2014;2014;06;08;Maanantai;140;0;140;16;0;16
96;09.06.2014;2014;06;09;Maanantai;109;0;109;17;0;17
96;09.06.2014;2014;06;10;Maanantai;101;0;101;18;0;18
96;09.06.2014;2014;06;11;Maanantai;100;0;100;19;0;19
96;09.06.2014;2014;06;12;Maanantai;111;0;111;23;0;23
96;09.06.2014;2014;06;13;Maanantai;118;0;118;13;0;13
96;09.06.2014;2014;06;14;Maanantai;138;0;138;13;0;13
96;09.06.2014;2014;06;15;Maanantai;269;0;269;25;0;25
96;09.06.2014;2014;06;16;Maanantai;240;0;240;19;0;19
96;09.06.2014;2014;06;17;Maanantai;140;0;140;13;0;13
96;09.06.2014;2014;06;18;Maanantai;130;0;130;23;0;23
96;09.06.2014;2014;06;19;Maanantai;109;0;109;22;0;22
96;09.06.2014;2014;06;20;Maanantai;75;0;75;12;0;12
96;09.06.2014;2014;06;21;Maanantai;71;0;71;19;0;19
96;09.06.2014;2014;06;22;Maanantai;36;0;36;4;0;4
96;09.06.2014;2014;06;23;Maanantai;16;0;16;4;0;4
96;10.06.2014;2014;06;00;Tiistai;6;0;6;1;0;1
96;10.06.2014;2014;06;01;Tiistai;6;0;6;2;0;2
96;10.06.2014;2014;06;02;Tiistai;5;0;5;0;0;0
96;10.06.2014;2014;06;03;Tiistai;2;0;2;0;0;0
96;10.06.2014;2014;06;04;Tiistai;2;0;2;2;0;2
96;10.06.2014;2014;06;05;Tiistai;16;0;16;1;0;1
96;10.06.2014;2014;06;06;Tiistai;92;0;92;4;0;4
96;10.06.2014;2014;06;07;Tiistai;229;0;229;18;0;18
96;10.06.2014;2014;06;08;Tiistai;177;0;177;9;0;9
96;10.06.2014;2014;06;09;Tiistai;101;0;101;3;0;3
96;10.06.2014;2014;06;10;Tiistai;97;0;97;9;0;9
96;10.06.2014;2014;06;11;Tiistai;132;0;132;12;0;12
96;10.06.2014;2014;06;12;Tiistai;124;0;124;20;0;20
96;10.06.2014;2014;06;13;Tiistai;146;0;146;11;0;11
96;10.06.2014;2014;06;14;Tiistai;159;0;159;23;0;23
96;10.06.2014;2014;06;15;Tiistai;301;0;301;42;0;42
96;10.06.2014;2014;06;16;Tiistai;302;0;302;34;0;34
96;10.06.2014;2014;06;17;Tiistai;190;0;190;32;0;32
96;10.06.2014;2014;06;18;Tiistai;145;1;146;18;0;18
96;10.06.2014;2014;06;19;Tiistai;103;0;103;26;0;26
96;10.06.2014;2014;06;20;Tiistai;117;0;117;25;0;25
96;10.06.2014;2014;06;21;Tiistai;74;0;74;18;0;18
96;10.06.2014;2014;06;22;Tiistai;29;0;29;9;0;9
96;10.06.2014;2014;06;23;Tiistai;10;0;10;3;0;3
96;11.06.2014;2014;06;00;Keskiviikko;12;0;12;3;0;3
96;11.06.2014;2014;06;01;Keskiviikko;3;0;3;0;0;0
96;11.06.2014;2014;06;02;Keskiviikko;0;0;0;2;0;2
96;11.06.2014;2014;06;03;Keskiviikko;7;0;7;0;0;0
96;11.06.2014;2014;06;04;Keskiviikko;5;0;5;0;0;0
96;11.06.2014;2014;06;05;Keskiviikko;10;0;10;3;0;3
96;11.06.2014;2014;06;06;Keskiviikko;102;0;102;7;0;7
96;11.06.2014;2014;06;07;Keskiviikko;229;0;229;20;0;20
96;11.06.2014;2014;06;08;Keskiviikko;203;0;203;15;3;18
96;11.06.2014;2014;06;09;Keskiviikko;136;0;136;24;0;24
96;11.06.2014;2014;06;10;Keskiviikko;108;0;108;23;0;23
96;11.06.2014;2014;06;11;Keskiviikko;164;1;165;21;0;21
96;11.06.2014;2014;06;12;Keskiviikko;146;0;146;27;0;27
96;11.06.2014;2014;06;13;Keskiviikko;164;0;164;13;0;13
96;11.06.2014;2014;06;14;Keskiviikko;190;0;190;24;0;24
96;11.06.2014;2014;06;15;Keskiviikko;335;0;335;39;0;39
96;11.06.2014;2014;06;16;Keskiviikko;343;0;343;38;0;38
96;11.06.2014;2014;06;17;Keskiviikko;206;0;206;30;0;30
96;11.06.2014;2014;06;18;Keskiviikko;162;0;162;31;0;31
96;11.06.2014;2014;06;19;Keskiviikko;178;0;178;36;0;36
96;11.06.2014;2014;06;20;Keskiviikko;126;0;126;21;0;21
96;11.06.2014;2014;06;21;Keskiviikko;93;0;93;11;0;11
96;11.06.2014;2014;06;22;Keskiviikko;40;0;40;8;0;8
96;11.06.2014;2014;06;23;Keskiviikko;30;0;30;3;0;3
96;12.06.2014;2014;06;00;Torstai;12;0;12;0;0;0
96;12.06.2014;2014;06;01;Torstai;9;0;9;0;0;0
96;12.06.2014;2014;06;02;Torstai;4;0;4;1;0;1
96;12.06.2014;2014;06;03;Torstai;7;0;7;5;0;5
96;12.06.2014;2014;06;04;Torstai;7;0;7;5;0;5
96;12.06.2014;2014;06;05;Torstai;11;0;11;1;0;1
96;12.06.2014;2014;06;06;Torstai;92;0;92;5;0;5
96;12.06.2014;2014;06;07;Torstai;200;0;200;14;0;14
96;12.06.2014;2014;06;08;Torstai;165;0;165;13;0;13
96;12.06.2014;2014;06;09;Torstai;113;0;113;10;0;10
96;12.06.2014;2014;06;10;Torstai;85;0;85;10;0;10
96;12.06.2014;2014;06;11;Torstai;79;0;79;11;0;11
96;12.06.2014;2014;06;12;Torstai;106;0;106;8;0;8
96;12.06.2014;2014;06;13;Torstai;100;0;100;9;0;9
96;12.06.2014;2014;06;14;Torstai;122;0;122;18;0;18
96;12.06.2014;2014;06;15;Torstai;267;0;267;16;0;16
96;12.06.2014;2014;06;16;Torstai;242;0;242;19;0;19
96;12.06.2014;2014;06;17;Torstai;131;0;131;19;0;19
96;12.06.2014;2014;06;18;Torstai;110;0;110;13;0;13
96;12.06.2014;2014;06;19;Torstai;65;1;66;13;0;13
96;12.06.2014;2014;06;20;Torstai;60;0;60;12;0;12
96;12.06.2014;2014;06;21;Torstai;65;0;65;13;0;13
96;12.06.2014;2014;06;22;Torstai;32;0;32;4;0;4
96;12.06.2014;2014;06;23;Torstai;15;0;15;2;0;2
96;13.06.2014;2014;06;00;Perjantai;4;0;4;1;0;1
96;13.06.2014;2014;06;01;Perjantai;9;0;9;2;0;2
96;13.06.2014;2014;06;02;Perjantai;6;0;6;0;0;0
96;13.06.2014;2014;06;03;Perjantai;2;0;2;0;0;0
96;13.06.2014;2014;06;04;Perjantai;3;0;3;0;0;0
96;13.06.2014;2014;06;05;Perjantai;9;0;9;1;0;1
96;13.06.2014;2014;06;06;Perjantai;89;0;89;3;0;3
96;13.06.2014;2014;06;07;Perjantai;171;0;171;19;0;19
96;13.06.2014;2014;06;08;Perjantai;136;0;136;9;0;9
96;13.06.2014;2014;06;09;Perjantai;93;0;93;13;0;13
96;13.06.2014;2014;06;10;Perjantai;100;0;100;3;0;3
96;13.06.2014;2014;06;11;Perjantai;85;0;85;13;0;13
96;13.06.2014;2014;06;12;Perjantai;114;0;114;9;0;9
96;13.06.2014;2014;06;13;Perjantai;119;0;119;14;0;14
96;13.06.2014;2014;06;14;Perjantai;158;0;158;12;0;12
96;13.06.2014;2014;06;15;Perjantai;236;0;236;10;0;10
96;13.06.2014;2014;06;16;Perjantai;149;0;149;13;0;13
96;13.06.2014;2014;06;17;Perjantai;124;0;124;18;0;18
96;13.06.2014;2014;06;18;Perjantai;71;0;71;11;0;11
96;13.06.2014;2014;06;19;Perjantai;64;0;64;3;0;3
96;13.06.2014;2014;06;20;Perjantai;58;0;58;8;0;8
96;13.06.2014;2014;06;21;Perjantai;61;0;61;4;0;4
96;13.06.2014;2014;06;22;Perjantai;33;0;33;8;0;8
96;13.06.2014;2014;06;23;Perjantai;26;0;26;1;0;1
96;14.06.2014;2014;06;00;Lauantai;31;0;31;1;0;1
96;14.06.2014;2014;06;01;Lauantai;16;0;16;1;0;1
96;14.06.2014;2014;06;02;Lauantai;17;0;17;3;0;3
96;14.06.2014;2014;06;03;Lauantai;15;0;15;1;0;1
96;14.06.2014;2014;06;04;Lauantai;13;0;13;3;0;3
96;14.06.2014;2014;06;05;Lauantai;9;0;9;0;0;0
96;14.06.2014;2014;06;06;Lauantai;30;0;30;2;0;2
96;14.06.2014;2014;06;07;Lauantai;16;0;16;2;0;2
96;14.06.2014;2014;06;08;Lauantai;34;0;34;4;0;4
96;14.06.2014;2014;06;09;Lauantai;63;0;63;6;0;6
96;14.06.2014;2014;06;10;Lauantai;69;0;69;13;0;13
96;14.06.2014;2014;06;11;Lauantai;81;0;81;12;0;12
96;14.06.2014;2014;06;12;Lauantai;117;0;117;18;0;18
96;14.06.2014;2014;06;13;Lauantai;135;0;135;22;0;22
96;14.06.2014;2014;06;14;Lauantai;130;1;131;18;0;18
96;14.06.2014;2014;06;15;Lauantai;119;0;119;18;0;18
96;14.06.2014;2014;06;16;Lauantai;100;0;100;21;0;21
96;14.06.2014;2014;06;17;Lauantai;103;0;103;11;0;11
96;14.06.2014;2014;06;18;Lauantai;98;0;98;22;0;22
96;14.06.2014;2014;06;19;Lauantai;85;0;85;12;0;12
96;14.06.2014;2014;06;20;Lauantai;71;0;71;10;0;10
96;14.06.2014;2014;06;21;Lauantai;46;0;46;13;0;13
96;14.06.2014;2014;06;22;Lauantai;34;0;34;5;0;5
96;14.06.2014;2014;06;23;Lauantai;28;0;28;6;0;6
96;15.06.2014;2014;06;00;Sunnuntai;27;0;27;2;0;2
96;15.06.2014;2014;06;01;Sunnuntai;27;0;27;4;0;4
96;15.06.2014;2014;06;02;Sunnuntai;13;0;13;2;0;2
96;15.06.2014;2014;06;03;Sunnuntai;17;0;17;3;0;3
96;15.06.2014;2014;06;04;Sunnuntai;23;0;23;4;0;4
96;15.06.2014;2014;06;05;Sunnuntai;5;0;5;5;0;5
96;15.06.2014;2014;06;06;Sunnuntai;22;0;22;4;0;4
96;15.06.2014;2014;06;07;Sunnuntai;16;0;16;1;0;1
96;15.06.2014;2014;06;08;Sunnuntai;12;0;12;5;0;5
96;15.06.2014;2014;06;09;Sunnuntai;16;1;17;1;0;1
96;15.06.2014;2014;06;10;Sunnuntai;50;0;50;13;0;13
96;15.06.2014;2014;06;11;Sunnuntai;68;0;68;17;0;17
96;15.06.2014;2014;06;12;Sunnuntai;102;0;102;13;0;13
96;15.06.2014;2014;06;13;Sunnuntai;96;0;96;12;0;12
96;15.06.2014;2014;06;14;Sunnuntai;128;0;128;19;0;19
96;15.06.2014;2014;06;15;Sunnuntai;116;0;116;15;0;15
96;15.06.2014;2014;06;16;Sunnuntai;129;0;129;26;0;26
96;15.06.2014;2014;06;17;Sunnuntai;95;0;95;19;0;19
96;15.06.2014;2014;06;18;Sunnuntai;85;0;85;25;0;25
96;15.06.2014;2014;06;19;Sunnuntai;92;0;92;22;0;22
96;15.06.2014;2014;06;20;Sunnuntai;76;0;76;31;0;31
96;15.06.2014;2014;06;21;Sunnuntai;54;0;54;10;0;10
96;15.06.2014;2014;06;22;Sunnuntai;25;0;25;3;0;3
96;15.06.2014;2014;06;23;Sunnuntai;13;0;13;5;0;5
96;16.06.2014;2014;06;00;Maanantai;4;0;4;2;0;2
96;16.06.2014;2014;06;01;Maanantai;3;0;3;0;0;0
96;16.06.2014;2014;06;02;Maanantai;2;0;2;1;0;1
96;16.06.2014;2014;06;03;Maanantai;5;0;5;0;0;0
96;16.06.2014;2014;06;04;Maanantai;1;0;1;1;0;1
96;16.06.2014;2014;06;05;Maanantai;12;0;12;1;0;1
96;16.06.2014;2014;06;06;Maanantai;53;0;53;6;0;6
96;16.06.2014;2014;06;07;Maanantai;133;0;133;11;0;11
96;16.06.2014;2014;06;08;Maanantai;110;0;110;5;0;5
96;16.06.2014;2014;06;09;Maanantai;82;0;82;7;0;7
96;16.06.2014;2014;06;10;Maanantai;76;0;76;7;0;7
96;16.06.2014;2014;06;11;Maanantai;91;0;91;34;0;34
96;16.06.2014;2014;06;12;Maanantai;92;0;92;9;0;9
96;16.06.2014;2014;06;13;Maanantai;96;0;96;18;0;18
96;16.06.2014;2014;06;14;Maanantai;149;0;149;14;0;14
96;16.06.2014;2014;06;15;Maanantai;210;0;210;33;0;33
96;16.06.2014;2014;06;16;Maanantai;179;0;179;40;0;40
96;16.06.2014;2014;06;17;Maanantai;146;0;146;17;0;17
96;16.06.2014;2014;06;18;Maanantai;112;0;112;43;0;43
96;16.06.2014;2014;06;19;Maanantai;89;0;89;18;0;18
96;16.06.2014;2014;06;20;Maanantai;85;0;85;13;0;13
96;16.06.2014;2014;06;21;Maanantai;65;0;65;11;0;11
96;16.06.2014;2014;06;22;Maanantai;25;0;25;4;0;4
96;16.06.2014;2014;06;23;Maanantai;17;0;17;1;0;1
96;17.06.2014;2014;06;00;Tiistai;7;0;7;3;0;3
96;17.06.2014;2014;06;01;Tiistai;4;0;4;0;0;0
96;17.06.2014;2014;06;02;Tiistai;1;0;1;1;0;1
96;17.06.2014;2014;06;03;Tiistai;0;0;0;0;0;0
96;17.06.2014;2014;06;04;Tiistai;3;0;3;1;0;1
96;17.06.2014;2014;06;05;Tiistai;13;0;13;0;0;0
96;17.06.2014;2014;06;06;Tiistai;83;0;83;1;0;1
96;17.06.2014;2014;06;07;Tiistai;177;0;177;7;0;7
96;17.06.2014;2014;06;08;Tiistai;123;0;123;5;0;5
96;17.06.2014;2014;06;09;Tiistai;65;0;65;3;0;3
96;17.06.2014;2014;06;10;Tiistai;86;0;86;6;0;6
96;17.06.2014;2014;06;11;Tiistai;82;1;83;4;0;4
96;17.06.2014;2014;06;12;Tiistai;98;0;98;8;0;8
96;17.06.2014;2014;06;13;Tiistai;118;0;118;17;0;17
96;17.06.2014;2014;06;14;Tiistai;134;0;134;12;0;12
96;17.06.2014;2014;06;15;Tiistai;237;0;237;20;0;20
96;17.06.2014;2014;06;16;Tiistai;213;0;213;20;0;20
96;17.06.2014;2014;06;17;Tiistai;148;0;148;30;0;30
96;17.06.2014;2014;06;18;Tiistai;123;0;123;24;0;24
96;17.06.2014;2014;06;19;Tiistai;76;0;76;18;0;18
96;17.06.2014;2014;06;20;Tiistai;86;0;86;10;0;10
96;17.06.2014;2014;06;21;Tiistai;81;0;81;16;0;16
96;17.06.2014;2014;06;22;Tiistai;30;0;30;3;0;3
96;17.06.2014;2014;06;23;Tiistai;12;0;12;0;0;0
96;18.06.2014;2014;06;00;Keskiviikko;8;0;8;3;0;3
96;18.06.2014;2014;06;01;Keskiviikko;3;0;3;0;0;0
96;18.06.2014;2014;06;02;Keskiviikko;6;0;6;0;0;0
96;18.06.2014;2014;06;03;Keskiviikko;3;0;3;1;0;1
96;18.06.2014;2014;06;04;Keskiviikko;3;0;3;2;0;2
96;18.06.2014;2014;06;05;Keskiviikko;14;0;14;2;0;2
96;18.06.2014;2014;06;06;Keskiviikko;86;0;86;4;0;4
96;18.06.2014;2014;06;07;Keskiviikko;174;0;174;14;0;14
96;18.06.2014;2014;06;08;Keskiviikko;165;0;165;8;0;8
96;18.06.2014;2014;06;09;Keskiviikko;89;0;89;9;0;9
96;18.06.2014;2014;06;10;Keskiviikko;76;0;76;18;0;18
96;18.06.2014;2014;06;11;Keskiviikko;92;0;92;16;0;16
96;18.06.2014;2014;06;12;Keskiviikko;117;0;117;9;0;9
96;18.06.2014;2014;06;13;Keskiviikko;123;0;123;12;0;12
96;18.06.2014;2014;06;14;Keskiviikko;147;0;147;16;0;16
96;18.06.2014;2014;06;15;Keskiviikko;240;0;240;35;0;35
96;18.06.2014;2014;06;16;Keskiviikko;221;0;221;24;0;24
96;18.06.2014;2014;06;17;Keskiviikko;143;0;143;22;0;22
96;18.06.2014;2014;06;18;Keskiviikko;129;0;129;19;0;19
96;18.06.2014;2014;06;19;Keskiviikko;112;0;112;10;0;10
96;18.06.2014;2014;06;20;Keskiviikko;78;0;78;6;0;6
96;18.06.2014;2014;06;21;Keskiviikko;66;0;66;12;0;12
96;18.06.2014;2014;06;22;Keskiviikko;35;0;35;6;0;6
96;18.06.2014;2014;06;23;Keskiviikko;13;0;13;1;0;1
96;19.06.2014;2014;06;00;Torstai;15;0;15;1;0;1
96;19.06.2014;2014;06;01;Torstai;4;0;4;1;0;1
96;19.06.2014;2014;06;02;Torstai;2;0;2;2;0;2
96;19.06.2014;2014;06;03;Torstai;7;0;7;0;0;0
96;19.06.2014;2014;06;04;Torstai;4;0;4;1;0;1
96;19.06.2014;2014;06;05;Torstai;11;0;11;1;0;1
96;19.06.2014;2014;06;06;Torstai;66;0;66;4;0;4
96;19.06.2014;2014;06;07;Torstai;162;0;162;13;0;13
96;19.06.2014;2014;06;08;Torstai;145;0;145;8;0;8
96;19.06.2014;2014;06;09;Torstai;98;0;98;12;0;12
96;19.06.2014;2014;06;10;Torstai;106;0;106;9;0;9
96;19.06.2014;2014;06;11;Torstai;101;0;101;12;0;12
96;19.06.2014;2014;06;12;Torstai;138;0;138;9;0;9
96;19.06.2014;2014;06;13;Torstai;127;0;127;13;0;13
96;19.06.2014;2014;06;14;Torstai;189;0;189;8;0;8
96;19.06.2014;2014;06;15;Torstai;221;0;221;22;0;22
96;19.06.2014;2014;06;16;Torstai;114;0;114;15;0;15
96;19.06.2014;2014;06;17;Torstai;83;0;83;12;0;12
96;19.06.2014;2014;06;18;Torstai;63;0;63;10;0;10
96;19.06.2014;2014;06;19;Torstai;99;0;99;11;0;11
96;19.06.2014;2014;06;20;Torstai;106;0;106;25;0;25
96;19.06.2014;2014;06;21;Torstai;55;0;55;7;0;7
96;19.06.2014;2014;06;22;Torstai;17;0;17;3;0;3
96;19.06.2014;2014;06;23;Torstai;6;0;6;3;0;3
96;20.06.2014;2014;06;00;Perjantai;44;0;44;5;0;5
96;20.06.2014;2014;06;01;Perjantai;17;0;17;5;0;5
96;20.06.2014;2014;06;02;Perjantai;6;0;6;0;0;0
96;20.06.2014;2014;06;03;Perjantai;5;0;5;1;0;1
96;20.06.2014;2014;06;04;Perjantai;8;0;8;1;0;1
96;20.06.2014;2014;06;05;Perjantai;7;0;7;0;0;0
96;20.06.2014;2014;06;06;Perjantai;30;0;30;8;0;8
96;20.06.2014;2014;06;07;Perjantai;18;0;18;2;0;2
96;20.06.2014;2014;06;08;Perjantai;21;0;21;5;0;5
96;20.06.2014;2014;06;09;Perjantai;46;0;46;33;0;33
96;20.06.2014;2014;06;10;Perjantai;58;0;58;12;0;12
96;20.06.2014;2014;06;11;Perjantai;59;0;59;23;0;23
96;20.06.2014;2014;06;12;Perjantai;68;0;68;24;0;24
96;20.06.2014;2014;06;13;Perjantai;48;0;48;21;0;21
96;20.06.2014;2014;06;14;Perjantai;45;0;45;12;0;12
96;20.06.2014;2014;06;15;Perjantai;56;0;56;21;0;21
96;20.06.2014;2014;06;16;Perjantai;54;0;54;16;0;16
96;20.06.2014;2014;06;17;Perjantai;56;0;56;35;0;35
96;20.06.2014;2014;06;18;Perjantai;39;0;39;12;0;12
96;20.06.2014;2014;06;19;Perjantai;34;0;34;11;0;11
96;20.06.2014;2014;06;20;Perjantai;37;0;37;2;0;2
96;20.06.2014;2014;06;21;Perjantai;34;0;34;4;0;4
96;20.06.2014;2014;06;22;Perjantai;20;0;20;2;0;2
96;20.06.2014;2014;06;23;Perjantai;15;0;15;3;0;3
96;21.06.2014;2014;06;00;Lauantai;17;0;17;5;0;5
96;21.06.2014;2014;06;01;Lauantai;15;0;15;0;0;0
96;21.06.2014;2014;06;02;Lauantai;8;0;8;0;0;0
96;21.06.2014;2014;06;03;Lauantai;11;0;11;3;0;3
96;21.06.2014;2014;06;04;Lauantai;9;0;9;0;0;0
96;21.06.2014;2014;06;05;Lauantai;5;0;5;0;0;0
96;21.06.2014;2014;06;06;Lauantai;26;0;26;1;0;1
96;21.06.2014;2014;06;07;Lauantai;13;0;13;4;0;4
96;21.06.2014;2014;06;08;Lauantai;2;0;2;6;0;6
96;21.06.2014;2014;06;09;Lauantai;7;0;7;8;0;8
96;21.06.2014;2014;06;10;Lauantai;14;0;14;1;0;1
96;21.06.2014;2014;06;11;Lauantai;21;0;21;4;0;4
96;21.06.2014;2014;06;12;Lauantai;29;0;29;7;0;7
96;21.06.2014;2014;06;13;Lauantai;35;0;35;10;0;10
96;21.06.2014;2014;06;14;Lauantai;45;0;45;6;0;6
96;21.06.2014;2014;06;15;Lauantai;45;0;45;11;0;11
96;21.06.2014;2014;06;16;Lauantai;41;0;41;14;0;14
96;21.06.2014;2014;06;17;Lauantai;58;0;58;20;0;20
96;21.06.2014;2014;06;18;Lauantai;51;0;51;8;0;8
96;21.06.2014;2014;06;19;Lauantai;35;0;35;10;0;10
96;21.06.2014;2014;06;20;Lauantai;37;0;37;11;0;11
96;21.06.2014;2014;06;21;Lauantai;33;0;33;8;0;8
96;21.06.2014;2014;06;22;Lauantai;19;0;19;3;0;3
96;21.06.2014;2014;06;23;Lauantai;15;0;15;1;0;1
96;22.06.2014;2014;06;00;Sunnuntai;9;0;9;2;0;2
96;22.06.2014;2014;06;01;Sunnuntai;5;0;5;0;0;0
96;22.06.2014;2014;06;02;Sunnuntai;5;0;5;1;0;1
96;22.06.2014;2014;06;03;Sunnuntai;9;0;9;27;0;27
96;22.06.2014;2014;06;04;Sunnuntai;5;0;5;4;0;4
96;22.06.2014;2014;06;05;Sunnuntai;4;0;4;0;0;0
96;22.06.2014;2014;06;06;Sunnuntai;25;0;25;5;0;5
96;22.06.2014;2014;06;07;Sunnuntai;16;0;16;7;0;7
96;22.06.2014;2014;06;08;Sunnuntai;14;0;14;8;0;8
96;22.06.2014;2014;06;09;Sunnuntai;25;0;25;11;0;11
96;22.06.2014;2014;06;10;Sunnuntai;41;0;41;2;0;2
96;22.06.2014;2014;06;11;Sunnuntai;54;0;54;12;0;12
96;22.06.2014;2014;06;12;Sunnuntai;79;0;79;22;0;22
96;22.06.2014;2014;06;13;Sunnuntai;59;0;59;18;0;18
96;22.06.2014;2014;06;14;Sunnuntai;55;0;55;9;0;9
96;22.06.2014;2014;06;15;Sunnuntai;40;0;40;7;0;7
96;22.06.2014;2014;06;16;Sunnuntai;33;0;33;17;0;17
96;22.06.2014;2014;06;17;Sunnuntai;39;0;39;17;0;17
96;22.06.2014;2014;06;18;Sunnuntai;35;0;35;10;0;10
96;22.06.2014;2014;06;19;Sunnuntai;32;0;32;9;0;9
96;22.06.2014;2014;06;20;Sunnuntai;48;0;48;18;0;18
96;22.06.2014;2014;06;21;Sunnuntai;36;0;36;17;0;17
96;22.06.2014;2014;06;22;Sunnuntai;17;0;17;7;0;7
96;22.06.2014;2014;06;23;Sunnuntai;9;0;9;1;0;1
96;23.06.2014;2014;06;00;Maanantai;9;0;9;2;0;2
96;23.06.2014;2014;06;01;Maanantai;9;0;9;1;0;1
96;23.06.2014;2014;06;02;Maanantai;3;0;3;0;0;0
96;23.06.2014;2014;06;03;Maanantai;8;0;8;1;0;1
96;23.06.2014;2014;06;04;Maanantai;4;0;4;0;0;0
96;23.06.2014;2014;06;05;Maanantai;14;0;14;1;0;1
96;23.06.2014;2014;06;06;Maanantai;76;0;76;6;0;6
96;23.06.2014;2014;06;07;Maanantai;174;0;174;16;0;16
96;23.06.2014;2014;06;08;Maanantai;148;0;148;15;0;15
96;23.06.2014;2014;06;09;Maanantai;101;0;101;8;0;8
96;23.06.2014;2014;06;10;Maanantai;103;0;103;11;0;11
96;23.06.2014;2014;06;11;Maanantai;82;0;82;18;0;18
96;23.06.2014;2014;06;12;Maanantai;125;0;125;16;0;16
96;23.06.2014;2014;06;13;Maanantai;138;0;138;18;0;18
96;23.06.2014;2014;06;14;Maanantai;142;0;142;8;0;8
96;23.06.2014;2014;06;15;Maanantai;246;0;246;24;0;24
96;23.06.2014;2014;06;16;Maanantai;210;0;210;13;0;13
96;23.06.2014;2014;06;17;Maanantai;138;0;138;8;0;8
96;23.06.2014;2014;06;18;Maanantai;98;0;98;16;0;16
96;23.06.2014;2014;06;19;Maanantai;57;0;57;11;0;11
96;23.06.2014;2014;06;20;Maanantai;56;0;56;16;0;16
96;23.06.2014;2014;06;21;Maanantai;61;0;61;11;0;11
96;23.06.2014;2014;06;22;Maanantai;24;0;24;5;0;5
96;23.06.2014;2014;06;23;Maanantai;9;0;9;3;0;3
96;24.06.2014;2014;06;00;Tiistai;8;0;8;1;0;1
96;24.06.2014;2014;06;01;Tiistai;0;0;0;0;0;0
96;24.06.2014;2014;06;02;Tiistai;7;0;7;0;0;0
96;24.06.2014;2014;06;03;Tiistai;1;0;1;1;0;1
96;24.06.2014;2014;06;04;Tiistai;7;0;7;0;0;0
96;24.06.2014;2014;06;05;Tiistai;12;0;12;2;0;2
96;24.06.2014;2014;06;06;Tiistai;86;0;86;7;0;7
96;24.06.2014;2014;06;07;Tiistai;175;0;175;15;0;15
96;24.06.2014;2014;06;08;Tiistai;153;0;153;9;0;9
96;24.06.2014;2014;06;09;Tiistai;97;0;97;7;0;7
96;24.06.2014;2014;06;10;Tiistai;64;0;64;12;0;12
96;24.06.2014;2014;06;11;Tiistai;92;0;92;8;0;8
96;24.06.2014;2014;06;12;Tiistai;105;1;106;17;0;17
96;24.06.2014;2014;06;13;Tiistai;107;0;107;11;0;11
96;24.06.2014;2014;06;14;Tiistai;127;0;127;20;0;20
96;24.06.2014;2014;06;15;Tiistai;243;0;243;23;0;23
96;24.06.2014;2014;06;16;Tiistai;222;0;222;20;0;20
96;24.06.2014;2014;06;17;Tiistai;127;0;127;16;0;16
96;24.06.2014;2014;06;18;Tiistai;136;0;136;23;0;23
96;24.06.2014;2014;06;19;Tiistai;81;0;81;15;0;15
96;24.06.2014;2014;06;20;Tiistai;67;0;67;7;0;7
96;24.06.2014;2014;06;21;Tiistai;65;0;65;17;0;17
96;24.06.2014;2014;06;22;Tiistai;26;0;26;6;0;6
96;24.06.2014;2014;06;23;Tiistai;13;0;13;1;0;1
96;25.06.2014;2014;06;00;Keskiviikko;9;0;9;2;0;2
96;25.06.2014;2014;06;01;Keskiviikko;4;0;4;1;0;1
96;25.06.2014;2014;06;02;Keskiviikko;6;0;6;1;0;1
96;25.06.2014;2014;06;03;Keskiviikko;0;0;0;0;0;0
96;25.06.2014;2014;06;04;Keskiviikko;4;0;4;1;0;1
96;25.06.2014;2014;06;05;Keskiviikko;9;0;9;0;0;0
96;25.06.2014;2014;06;06;Keskiviikko;90;0;90;5;0;5
96;25.06.2014;2014;06;07;Keskiviikko;184;0;184;10;0;10
96;25.06.2014;2014;06;08;Keskiviikko;163;0;163;8;0;8
96;25.06.2014;2014;06;09;Keskiviikko;92;0;92;17;0;17
96;25.06.2014;2014;06;10;Keskiviikko;81;0;81;12;0;12
96;25.06.2014;2014;06;11;Keskiviikko;99;0;99;9;0;9
96;25.06.2014;2014;06;12;Keskiviikko;109;0;109;24;0;24
96;25.06.2014;2014;06;13;Keskiviikko;126;0;126;11;0;11
96;25.06.2014;2014;06;14;Keskiviikko;135;0;135;20;0;20
96;25.06.2014;2014;06;15;Keskiviikko;257;0;257;25;0;25
96;25.06.2014;2014;06;16;Keskiviikko;209;0;209;27;0;27
96;25.06.2014;2014;06;17;Keskiviikko;164;0;164;30;0;30
96;25.06.2014;2014;06;18;Keskiviikko;133;0;133;18;0;18
96;25.06.2014;2014;06;19;Keskiviikko;80;0;80;31;0;31
96;25.06.2014;2014;06;20;Keskiviikko;76;0;76;15;0;15
96;25.06.2014;2014;06;21;Keskiviikko;84;0;84;12;0;12
96;25.06.2014;2014;06;22;Keskiviikko;47;0;47;10;0;10
96;25.06.2014;2014;06;23;Keskiviikko;21;0;21;4;0;4
96;26.06.2014;2014;06;00;Torstai;7;0;7;2;0;2
96;26.06.2014;2014;06;01;Torstai;10;0;10;1;0;1
96;26.06.2014;2014;06;02;Torstai;6;0;6;0;0;0
96;26.06.2014;2014;06;03;Torstai;6;0;6;0;0;0
96;26.06.2014;2014;06;04;Torstai;6;0;6;2;0;2
96;26.06.2014;2014;06;05;Torstai;9;0;9;1;0;1
96;26.06.2014;2014;06;06;Torstai;80;0;80;4;0;4
96;26.06.2014;2014;06;07;Torstai;162;0;162;10;0;10
96;26.06.2014;2014;06;08;Torstai;141;0;141;6;0;6
96;26.06.2014;2014;06;09;Torstai;73;0;73;4;0;4
96;26.06.2014;2014;06;10;Torstai;79;0;79;5;0;5
96;26.06.2014;2014;06;11;Torstai;81;0;81;12;0;12
96;26.06.2014;2014;06;12;Torstai;110;0;110;2;0;2
96;26.06.2014;2014;06;13;Torstai;109;0;109;9;0;9
96;26.06.2014;2014;06;14;Torstai;131;0;131;10;0;10
96;26.06.2014;2014;06;15;Torstai;230;0;230;24;0;24
96;26.06.2014;2014;06;16;Torstai;169;0;169;17;0;17
96;26.06.2014;2014;06;17;Torstai;139;0;139;12;0;12
96;26.06.2014;2014;06;18;Torstai;107;0;107;9;0;9
96;26.06.2014;2014;06;19;Torstai;87;0;87;4;0;4
96;26.06.2014;2014;06;20;Torstai;63;0;63;10;0;10
96;26.06.2014;2014;06;21;Torstai;63;0;63;8;0;8
96;26.06.2014;2014;06;22;Torstai;30;0;30;2;0;2
96;26.06.2014;2014;06;23;Torstai;14;0;14;1;0;1
96;27.06.2014;2014;06;00;Perjantai;10;0;10;3;0;3
96;27.06.2014;2014;06;01;Perjantai;9;0;9;2;0;2
96;27.06.2014;2014;06;02;Perjantai;6;0;6;2;0;2
96;27.06.2014;2014;06;03;Perjantai;5;0;5;0;0;0
96;27.06.2014;2014;06;04;Perjantai;3;0;3;1;0;1
96;27.06.2014;2014;06;05;Perjantai;9;0;9;1;0;1
96;27.06.2014;2014;06;06;Perjantai;71;0;71;4;0;4
96;27.06.2014;2014;06;07;Perjantai;152;0;152;14;0;14
96;27.06.2014;2014;06;08;Perjantai;149;0;149;10;0;10
96;27.06.2014;2014;06;09;Perjantai;70;0;70;6;0;6
96;27.06.2014;2014;06;10;Perjantai;71;0;71;5;0;5
96;27.06.2014;2014;06;11;Perjantai;73;0;73;8;0;8
96;27.06.2014;2014;06;12;Perjantai;112;0;112;8;0;8
96;27.06.2014;2014;06;13;Perjantai;127;0;127;11;0;11
96;27.06.2014;2014;06;14;Perjantai;180;0;180;16;0;16
96;27.06.2014;2014;06;15;Perjantai;198;0;198;13;0;13
96;27.06.2014;2014;06;16;Perjantai;162;0;162;9;0;9
96;27.06.2014;2014;06;17;Perjantai;121;0;121;12;0;12
96;27.06.2014;2014;06;18;Perjantai;99;0;99;14;0;14
96;27.06.2014;2014;06;19;Perjantai;67;0;67;18;0;18
96;27.06.2014;2014;06;20;Perjantai;72;0;72;17;0;17
96;27.06.2014;2014;06;21;Perjantai;63;0;63;5;0;5
96;27.06.2014;2014;06;22;Perjantai;34;0;34;6;0;6
96;27.06.2014;2014;06;23;Perjantai;27;0;27;3;0;3
96;28.06.2014;2014;06;00;Lauantai;15;0;15;0;0;0
96;28.06.2014;2014;06;01;Lauantai;16;0;16;0;0;0
96;28.06.2014;2014;06;02;Lauantai;8;0;8;2;0;2
96;28.06.2014;2014;06;03;Lauantai;17;0;17;3;0;3
96;28.06.2014;2014;06;04;Lauantai;8;0;8;1;0;1
96;28.06.2014;2014;06;05;Lauantai;7;0;7;2;0;2
96;28.06.2014;2014;06;06;Lauantai;29;0;29;0;0;0
96;28.06.2014;2014;06;07;Lauantai;23;0;23;3;0;3
96;28.06.2014;2014;06;08;Lauantai;23;0;23;4;0;4
96;28.06.2014;2014;06;09;Lauantai;62;0;62;6;0;6
96;28.06.2014;2014;06;10;Lauantai;67;0;67;5;0;5
96;28.06.2014;2014;06;11;Lauantai;90;0;90;11;0;11
96;28.06.2014;2014;06;12;Lauantai;94;0;94;14;0;14
96;28.06.2014;2014;06;13;Lauantai;134;0;134;11;0;11
96;28.06.2014;2014;06;14;Lauantai;110;0;110;19;0;19
96;28.06.2014;2014;06;15;Lauantai;129;0;129;12;0;12
96;28.06.2014;2014;06;16;Lauantai;83;0;83;14;0;14
96;28.06.2014;2014;06;17;Lauantai;79;0;79;13;0;13
96;28.06.2014;2014;06;18;Lauantai;93;0;93;24;0;24
96;28.06.2014;2014;06;19;Lauantai;51;0;51;10;0;10
96;28.06.2014;2014;06;20;Lauantai;43;0;43;6;0;6
96;28.06.2014;2014;06;21;Lauantai;47;0;47;6;0;6
96;28.06.2014;2014;06;22;Lauantai;42;0;42;2;0;2
96;28.06.2014;2014;06;23;Lauantai;25;0;25;2;0;2
96;29.06.2014;2014;06;00;Sunnuntai;21;0;21;0;0;0
96;29.06.2014;2014;06;01;Sunnuntai;24;0;24;5;0;5
96;29.06.2014;2014;06;02;Sunnuntai;17;0;17;2;0;2
96;29.06.2014;2014;06;03;Sunnuntai;29;0;29;3;0;3
96;29.06.2014;2014;06;04;Sunnuntai;14;0;14;7;0;7
96;29.06.2014;2014;06;05;Sunnuntai;8;0;8;1;0;1
96;29.06.2014;2014;06;06;Sunnuntai;32;0;32;1;0;1
96;29.06.2014;2014;06;07;Sunnuntai;14;0;14;3;0;3
96;29.06.2014;2014;06;08;Sunnuntai;21;0;21;4;0;4
96;29.06.2014;2014;06;09;Sunnuntai;30;0;30;9;0;9
96;29.06.2014;2014;06;10;Sunnuntai;56;0;56;8;0;8
96;29.06.2014;2014;06;11;Sunnuntai;71;0;71;21;0;21
96;29.06.2014;2014;06;12;Sunnuntai;88;0;88;17;0;17
96;29.06.2014;2014;06;13;Sunnuntai;116;0;116;20;0;20
96;29.06.2014;2014;06;14;Sunnuntai;99;1;100;21;0;21
96;29.06.2014;2014;06;15;Sunnuntai;109;0;109;20;0;20
96;29.06.2014;2014;06;16;Sunnuntai;103;0;103;15;0;15
96;29.06.2014;2014;06;17;Sunnuntai;116;0;116;22;0;22
96;29.06.2014;2014;06;18;Sunnuntai;86;0;86;10;0;10
96;29.06.2014;2014;06;19;Sunnuntai;75;0;75;12;0;12
96;29.06.2014;2014;06;20;Sunnuntai;48;0;48;12;0;12
96;29.06.2014;2014;06;21;Sunnuntai;56;0;56;5;0;5
96;29.06.2014;2014;06;22;Sunnuntai;27;0;27;7;0;7
96;29.06.2014;2014;06;23;Sunnuntai;20;0;20;6;0;6
96;30.06.2014;2014;06;00;Maanantai;11;0;11;0;0;0
96;30.06.2014;2014;06;01;Maanantai;7;0;7;0;0;0
96;30.06.2014;2014;06;02;Maanantai;3;0;3;0;0;0
96;30.06.2014;2014;06;03;Maanantai;6;0;6;0;0;0
96;30.06.2014;2014;06;04;Maanantai;4;0;4;1;0;1
96;30.06.2014;2014;06;05;Maanantai;16;0;16;2;0;2
96;30.06.2014;2014;06;06;Maanantai;93;0;93;4;0;4
96;30.06.2014;2014;06;07;Maanantai;166;0;166;18;0;18
96;30.06.2014;2014;06;08;Maanantai;109;0;109;13;0;13
96;30.06.2014;2014;06;09;Maanantai;108;0;108;13;0;13
96;30.06.2014;2014;06;10;Maanantai;99;0;99;15;0;15
96;30.06.2014;2014;06;11;Maanantai;89;0;89;15;0;15
96;30.06.2014;2014;06;12;Maanantai;116;0;116;18;0;18
96;30.06.2014;2014;06;13;Maanantai;109;0;109;7;0;7
96;30.06.2014;2014;06;14;Maanantai;142;0;142;21;0;21
96;30.06.2014;2014;06;15;Maanantai;230;0;230;22;0;22
96;30.06.2014;2014;06;16;Maanantai;195;0;195;18;0;18
96;30.06.2014;2014;06;17;Maanantai;162;0;162;21;0;21
96;30.06.2014;2014;06;18;Maanantai;121;0;121;18;0;18
96;30.06.2014;2014;06;19;Maanantai;101;0;101;21;0;21
96;30.06.2014;2014;06;20;Maanantai;102;0;102;16;0;16
96;30.06.2014;2014;06;21;Maanantai;73;0;73;10;0;10
96;30.06.2014;2014;06;22;Maanantai;31;0;31;1;0;1
96;30.06.2014;2014;06;23;Maanantai;17;0;17;3;0;3
96;01.07.2014;2014;07;00;Tiistai;4;0;4;0;0;0
96;01.07.2014;2014;07;01;Tiistai;3;0;3;1;0;1
96;01.07.2014;2014;07;02;Tiistai;9;0;9;0;0;0
96;01.07.2014;2014;07;03;Tiistai;3;0;3;0;0;0
96;01.07.2014;2014;07;04;Tiistai;5;0;5;0;0;0
96;01.07.2014;2014;07;05;Tiistai;14;0;14;2;0;2
96;01.07.2014;2014;07;06;Tiistai;100;0;100;2;0;2
96;01.07.2014;2014;07;07;Tiistai;183;0;183;25;0;25
96;01.07.2014;2014;07;08;Tiistai;119;0;119;4;0;4
96;01.07.2014;2014;07;09;Tiistai;118;0;118;14;0;14
96;01.07.2014;2014;07;10;Tiistai;105;0;105;10;0;10
96;01.07.2014;2014;07;11;Tiistai;123;0;123;22;0;22
96;01.07.2014;2014;07;12;Tiistai;157;0;157;21;0;21
96;01.07.2014;2014;07;13;Tiistai;167;0;167;16;0;16
96;01.07.2014;2014;07;14;Tiistai;196;0;196;32;0;32
96;01.07.2014;2014;07;15;Tiistai;270;0;270;35;0;35
96;01.07.2014;2014;07;16;Tiistai;223;0;223;24;0;24
96;01.07.2014;2014;07;17;Tiistai;157;0;157;30;0;30
96;01.07.2014;2014;07;18;Tiistai;149;0;149;27;0;27
96;01.07.2014;2014;07;19;Tiistai;113;0;113;27;0;27
96;01.07.2014;2014;07;20;Tiistai;92;0;92;13;0;13
96;01.07.2014;2014;07;21;Tiistai;83;0;83;9;0;9
96;01.07.2014;2014;07;22;Tiistai;39;0;39;9;0;9
96;01.07.2014;2014;07;23;Tiistai;17;0;17;2;0;2
96;02.07.2014;2014;07;00;Keskiviikko;14;0;14;1;0;1
96;02.07.2014;2014;07;01;Keskiviikko;11;0;11;1;0;1
96;02.07.2014;2014;07;02;Keskiviikko;7;0;7;1;0;1
96;02.07.2014;2014;07;03;Keskiviikko;6;0;6;2;0;2
96;02.07.2014;2014;07;04;Keskiviikko;5;0;5;1;0;1
96;02.07.2014;2014;07;05;Keskiviikko;15;0;15;3;0;3
96;02.07.2014;2014;07;06;Keskiviikko;97;0;97;2;0;2
96;02.07.2014;2014;07;07;Keskiviikko;153;0;153;13;0;13
96;02.07.2014;2014;07;08;Keskiviikko;67;0;67;2;0;2
96;02.07.2014;2014;07;09;Keskiviikko;39;0;39;2;0;2
96;02.07.2014;2014;07;10;Keskiviikko;30;0;30;6;0;6
96;02.07.2014;2014;07;11;Keskiviikko;26;0;26;3;0;3
96;02.07.2014;2014;07;12;Keskiviikko;43;1;44;1;0;1
96;02.07.2014;2014;07;13;Keskiviikko;44;0;44;2;0;2
96;02.07.2014;2014;07;14;Keskiviikko;64;2;66;7;0;7
96;02.07.2014;2014;07;15;Keskiviikko;144;4;148;11;0;11
96;02.07.2014;2014;07;16;Keskiviikko;71;0;71;8;0;8
96;02.07.2014;2014;07;17;Keskiviikko;42;0;42;4;0;4
96;02.07.2014;2014;07;18;Keskiviikko;45;0;45;6;0;6
96;02.07.2014;2014;07;19;Keskiviikko;31;0;31;16;0;16
96;02.07.2014;2014;07;20;Keskiviikko;44;0;44;10;0;10
96;02.07.2014;2014;07;21;Keskiviikko;26;0;26;6;0;6
96;02.07.2014;2014;07;22;Keskiviikko;8;0;8;3;0;3
96;02.07.2014;2014;07;23;Keskiviikko;9;0;9;1;0;1
96;03.07.2014;2014;07;00;Torstai;5;0;5;2;0;2
96;03.07.2014;2014;07;01;Torstai;8;0;8;0;0;0
96;03.07.2014;2014;07;02;Torstai;4;0;4;1;0;1
96;03.07.2014;2014;07;03;Torstai;2;0;2;0;0;0
96;03.07.2014;2014;07;04;Torstai;6;0;6;1;0;1
96;03.07.2014;2014;07;05;Torstai;13;0;13;1;0;1
96;03.07.2014;2014;07;06;Torstai;77;0;77;1;0;1
96;03.07.2014;2014;07;07;Torstai;126;0;126;12;0;12
96;03.07.2014;2014;07;08;Torstai;111;0;111;10;0;10
96;03.07.2014;2014;07;09;Torstai;80;0;80;9;0;9
96;03.07.2014;2014;07;10;Torstai;52;0;52;9;0;9
96;03.07.2014;2014;07;11;Torstai;72;0;72;12;0;12
96;03.07.2014;2014;07;12;Torstai;89;0;89;18;0;18
96;03.07.2014;2014;07;13;Torstai;98;1;99;18;0;18
96;03.07.2014;2014;07;14;Torstai;108;0;108;11;0;11
96;03.07.2014;2014;07;15;Torstai;184;1;185;15;0;15
96;03.07.2014;2014;07;16;Torstai;135;0;135;15;0;15
96;03.07.2014;2014;07;17;Torstai;95;0;95;5;0;5
96;03.07.2014;2014;07;18;Torstai;61;0;61;6;0;6
96;03.07.2014;2014;07;19;Torstai;43;0;43;15;0;15
96;03.07.2014;2014;07;20;Torstai;65;0;65;20;0;20
96;03.07.2014;2014;07;21;Torstai;63;0;63;6;0;6
96;03.07.2014;2014;07;22;Torstai;30;0;30;3;0;3
96;03.07.2014;2014;07;23;Torstai;16;0;16;2;0;2
96;04.07.2014;2014;07;00;Perjantai;5;0;5;2;0;2
96;04.07.2014;2014;07;01;Perjantai;5;0;5;0;0;0
96;04.07.2014;2014;07;02;Perjantai;4;0;4;1;0;1
96;04.07.2014;2014;07;03;Perjantai;4;0;4;2;0;2
96;04.07.2014;2014;07;04;Perjantai;7;0;7;4;0;4
96;04.07.2014;2014;07;05;Perjantai;7;0;7;1;0;1
96;04.07.2014;2014;07;06;Perjantai;86;0;86;10;0;10
96;04.07.2014;2014;07;07;Perjantai;125;0;125;11;0;11
96;04.07.2014;2014;07;08;Perjantai;107;0;107;11;0;11
96;04.07.2014;2014;07;09;Perjantai;93;0;93;15;0;15
96;04.07.2014;2014;07;10;Perjantai;78;0;78;10;0;10
96;04.07.2014;2014;07;11;Perjantai;103;0;103;16;0;16
96;04.07.2014;2014;07;12;Perjantai;100;0;100;9;0;9
96;04.07.2014;2014;07;13;Perjantai;129;0;129;18;0;18
96;04.07.2014;2014;07;14;Perjantai;182;0;182;24;0;24
96;04.07.2014;2014;07;15;Perjantai;223;0;223;15;0;15
96;04.07.2014;2014;07;16;Perjantai;151;0;151;11;0;11
96;04.07.2014;2014;07;17;Perjantai;85;0;85;5;0;5
96;04.07.2014;2014;07;18;Perjantai;64;0;64;8;0;8
96;04.07.2014;2014;07;19;Perjantai;44;0;44;6;0;6
96;04.07.2014;2014;07;20;Perjantai;49;0;49;1;0;1
96;04.07.2014;2014;07;21;Perjantai;46;0;46;3;0;3
96;04.07.2014;2014;07;22;Perjantai;21;0;21;5;0;5
96;04.07.2014;2014;07;23;Perjantai;22;0;22;0;0;0
96;05.07.2014;2014;07;00;Lauantai;13;0;13;1;0;1
96;05.07.2014;2014;07;01;Lauantai;23;0;23;2;0;2
96;05.07.2014;2014;07;02;Lauantai;17;0;17;1;0;1
96;05.07.2014;2014;07;03;Lauantai;8;0;8;0;0;0
96;05.07.2014;2014;07;04;Lauantai;10;0;10;5;0;5
96;05.07.2014;2014;07;05;Lauantai;6;0;6;1;0;1
96;05.07.2014;2014;07;06;Lauantai;29;0;29;2;0;2
96;05.07.2014;2014;07;07;Lauantai;28;0;28;9;0;9
96;05.07.2014;2014;07;08;Lauantai;37;0;37;2;0;2
96;05.07.2014;2014;07;09;Lauantai;55;0;55;5;0;5
96;05.07.2014;2014;07;10;Lauantai;87;0;87;11;0;11
96;05.07.2014;2014;07;11;Lauantai;74;0;74;11;0;11
96;05.07.2014;2014;07;12;Lauantai;136;0;136;17;0;17
96;05.07.2014;2014;07;13;Lauantai;135;0;135;18;0;18
96;05.07.2014;2014;07;14;Lauantai;144;0;144;26;0;26
96;05.07.2014;2014;07;15;Lauantai;134;0;134;26;0;26
96;05.07.2014;2014;07;16;Lauantai;144;0;144;27;0;27
96;05.07.2014;2014;07;17;Lauantai;131;0;131;25;0;25
96;05.07.2014;2014;07;18;Lauantai;99;0;99;11;0;11
96;05.07.2014;2014;07;19;Lauantai;69;0;69;11;0;11
96;05.07.2014;2014;07;20;Lauantai;78;0;78;10;0;10
96;05.07.2014;2014;07;21;Lauantai;88;0;88;7;0;7
96;05.07.2014;2014;07;22;Lauantai;52;0;52;2;0;2
96;05.07.2014;2014;07;23;Lauantai;42;0;42;2;0;2
96;06.07.2014;2014;07;00;Sunnuntai;21;0;21;0;0;0
96;06.07.2014;2014;07;01;Sunnuntai;24;0;24;5;0;5
96;06.07.2014;2014;07;02;Sunnuntai;17;0;17;2;0;2
96;06.07.2014;2014;07;03;Sunnuntai;29;0;29;3;0;3
96;06.07.2014;2014;07;04;Sunnuntai;14;0;14;7;0;7
96;06.07.2014;2014;07;05;Sunnuntai;8;0;8;1;0;1
96;06.07.2014;2014;07;06;Sunnuntai;32;0;32;1;0;1
96;06.07.2014;2014;07;07;Sunnuntai;14;0;14;3;0;3
96;06.07.2014;2014;07;08;Sunnuntai;21;0;21;4;0;4
96;06.07.2014;2014;07;09;Sunnuntai;30;0;30;9;0;9
96;06.07.2014;2014;07;10;Sunnuntai;56;0;56;8;0;8
96;06.07.2014;2014;07;11;Sunnuntai;71;0;71;21;0;21
96;06.07.2014;2014;07;12;Sunnuntai;88;0;88;17;0;17
96;06.07.2014;2014;07;13;Sunnuntai;116;0;116;20;0;20
96;06.07.2014;2014;07;14;Sunnuntai;99;1;100;21;0;21
96;06.07.2014;2014;07;15;Sunnuntai;109;0;109;20;0;20
96;06.07.2014;2014;07;16;Sunnuntai;103;0;103;15;0;15
96;06.07.2014;2014;07;17;Sunnuntai;116;0;116;22;0;22
96;06.07.2014;2014;07;18;Sunnuntai;86;0;86;10;0;10
96;06.07.2014;2014;07;19;Sunnuntai;75;0;75;12;0;12
96;06.07.2014;2014;07;20;Sunnuntai;48;0;48;12;0;12
96;06.07.2014;2014;07;21;Sunnuntai;56;0;56;5;0;5
96;06.07.2014;2014;07;22;Sunnuntai;27;0;27;7;0;7
96;06.07.2014;2014;07;23;Sunnuntai;20;0;20;6;0;6
96;07.07.2014;2014;07;00;Maanantai;14;0;14;1;0;1
96;07.07.2014;2014;07;01;Maanantai;6;0;6;0;0;0
96;07.07.2014;2014;07;02;Maanantai;6;0;6;1;0;1
96;07.07.2014;2014;07;03;Maanantai;4;0;4;0;0;0
96;07.07.2014;2014;07;04;Maanantai;6;0;6;1;0;1
96;07.07.2014;2014;07;05;Maanantai;19;0;19;3;0;3
96;07.07.2014;2014;07;06;Maanantai;97;0;97;7;0;7
96;07.07.2014;2014;07;07;Maanantai;174;0;174;11;0;11
96;07.07.2014;2014;07;08;Maanantai;94;0;94;16;0;16
96;07.07.2014;2014;07;09;Maanantai;107;0;107;9;0;9
96;07.07.2014;2014;07;10;Maanantai;96;1;97;22;0;22
96;07.07.2014;2014;07;11;Maanantai;135;1;136;21;0;21
96;07.07.2014;2014;07;12;Maanantai;148;1;149;23;0;23
96;07.07.2014;2014;07;13;Maanantai;153;1;154;14;0;14
96;07.07.2014;2014;07;14;Maanantai;184;0;184;27;0;27
96;07.07.2014;2014;07;15;Maanantai;282;0;282;40;0;40
96;07.07.2014;2014;07;16;Maanantai;227;0;227;25;0;25
96;07.07.2014;2014;07;17;Maanantai;155;0;155;34;0;34
96;07.07.2014;2014;07;18;Maanantai;149;0;149;18;0;18
96;07.07.2014;2014;07;19;Maanantai;137;0;137;20;0;20
96;07.07.2014;2014;07;20;Maanantai;114;1;115;17;0;17
96;07.07.2014;2014;07;21;Maanantai;101;0;101;6;0;6
96;07.07.2014;2014;07;22;Maanantai;38;0;38;6;0;6
96;07.07.2014;2014;07;23;Maanantai;27;0;27;5;0;5
96;08.07.2014;2014;07;00;Tiistai;17;0;17;5;0;5
96;08.07.2014;2014;07;01;Tiistai;6;0;6;1;0;1
96;08.07.2014;2014;07;02;Tiistai;3;0;3;0;0;0
96;08.07.2014;2014;07;03;Tiistai;7;0;7;1;0;1
96;08.07.2014;2014;07;04;Tiistai;0;0;0;2;0;2
96;08.07.2014;2014;07;05;Tiistai;24;0;24;2;0;2
96;08.07.2014;2014;07;06;Tiistai;121;0;121;11;0;11
96;08.07.2014;2014;07;07;Tiistai;172;0;172;22;0;22
96;08.07.2014;2014;07;08;Tiistai;117;0;117;9;0;9
96;08.07.2014;2014;07;09;Tiistai;113;0;113;23;0;23
96;08.07.2014;2014;07;10;Tiistai;122;0;122;6;0;6
96;08.07.2014;2014;07;11;Tiistai;144;3;147;16;0;16
96;08.07.2014;2014;07;12;Tiistai;163;2;165;32;0;32
96;08.07.2014;2014;07;13;Tiistai;158;2;160;17;0;17
96;08.07.2014;2014;07;14;Tiistai;217;1;218;25;0;25
96;08.07.2014;2014;07;15;Tiistai;294;0;294;40;0;40
96;08.07.2014;2014;07;16;Tiistai;206;1;207;16;0;16
96;08.07.2014;2014;07;17;Tiistai;147;0;147;14;0;14
96;08.07.2014;2014;07;18;Tiistai;125;0;125;17;0;17
96;08.07.2014;2014;07;19;Tiistai;159;0;159;10;0;10
96;08.07.2014;2014;07;20;Tiistai;109;0;109;16;0;16
96;08.07.2014;2014;07;21;Tiistai;81;1;82;11;0;11
96;08.07.2014;2014;07;22;Tiistai;52;0;52;3;0;3
96;08.07.2014;2014;07;23;Tiistai;23;0;23;5;0;5
96;09.07.2014;2014;07;00;Keskiviikko;13;0;13;1;0;1
96;09.07.2014;2014;07;01;Keskiviikko;18;0;18;0;0;0
96;09.07.2014;2014;07;02;Keskiviikko;6;0;6;3;0;3
96;09.07.2014;2014;07;03;Keskiviikko;4;0;4;0;0;0
96;09.07.2014;2014;07;04;Keskiviikko;8;0;8;0;0;0
96;09.07.2014;2014;07;05;Keskiviikko;22;0;22;1;0;1
96;09.07.2014;2014;07;06;Keskiviikko;113;0;113;7;0;7
96;09.07.2014;2014;07;07;Keskiviikko;179;0;179;15;0;15
96;09.07.2014;2014;07;08;Keskiviikko;110;0;110;7;0;7
96;09.07.2014;2014;07;09;Keskiviikko;98;0;98;11;0;11
96;09.07.2014;2014;07;10;Keskiviikko;119;0;119;6;0;6
96;09.07.2014;2014;07;11;Keskiviikko;130;0;130;7;0;7
96;09.07.2014;2014;07;12;Keskiviikko;139;0;139;12;0;12
96;09.07.2014;2014;07;13;Keskiviikko;156;0;156;13;0;13
96;09.07.2014;2014;07;14;Keskiviikko;203;0;203;22;0;22
96;09.07.2014;2014;07;15;Keskiviikko;267;4;271;20;0;20
96;09.07.2014;2014;07;16;Keskiviikko;207;0;207;20;0;20
96;09.07.2014;2014;07;17;Keskiviikko;164;0;164;19;0;19
96;09.07.2014;2014;07;18;Keskiviikko;153;0;153;14;0;14
96;09.07.2014;2014;07;19;Keskiviikko;137;0;137;14;0;14
96;09.07.2014;2014;07;20;Keskiviikko;125;0;125;18;0;18
96;09.07.2014;2014;07;21;Keskiviikko;100;0;100;14;0;14
96;09.07.2014;2014;07;22;Keskiviikko;63;0;63;5;0;5
96;09.07.2014;2014;07;23;Keskiviikko;38;0;38;2;0;2
96;10.07.2014;2014;07;00;Torstai;62;0;62;4;0;4
96;10.07.2014;2014;07;01;Torstai;21;0;21;1;0;1
96;10.07.2014;2014;07;02;Torstai;18;0;18;0;0;0
96;10.07.2014;2014;07;03;Torstai;14;0;14;0;0;0
96;10.07.2014;2014;07;04;Torstai;3;0;3;0;0;0
96;10.07.2014;2014;07;05;Torstai;21;0;21;10;0;10
96;10.07.2014;2014;07;06;Torstai;99;0;99;6;0;6
96;10.07.2014;2014;07;07;Torstai;167;0;167;11;0;11
96;10.07.2014;2014;07;08;Torstai;97;0;97;7;0;7
96;10.07.2014;2014;07;09;Torstai;105;0;105;16;0;16
96;10.07.2014;2014;07;10;Torstai;94;0;94;10;0;10
96;10.07.2014;2014;07;11;Torstai;106;0;106;14;0;14
96;10.07.2014;2014;07;12;Torstai;147;0;147;17;0;17
96;10.07.2014;2014;07;13;Torstai;167;0;167;22;0;22
96;10.07.2014;2014;07;14;Torstai;168;0;168;34;0;34
96;10.07.2014;2014;07;15;Torstai;261;0;261;26;0;26
96;10.07.2014;2014;07;16;Torstai;185;0;185;17;0;17
96;10.07.2014;2014;07;17;Torstai;165;0;165;14;0;14
96;10.07.2014;2014;07;18;Torstai;157;0;157;21;0;21
96;10.07.2014;2014;07;19;Torstai;130;0;130;15;0;15
96;10.07.2014;2014;07;20;Torstai;133;0;133;12;0;12
96;10.07.2014;2014;07;21;Torstai;88;0;88;14;0;14
96;10.07.2014;2014;07;22;Torstai;47;0;47;7;0;7
96;10.07.2014;2014;07;23;Torstai;33;0;33;1;0;1
96;11.07.2014;2014;07;00;Perjantai;36;0;36;4;0;4
96;11.07.2014;2014;07;01;Perjantai;20;0;20;0;0;0
96;11.07.2014;2014;07;02;Perjantai;11;0;11;0;0;0
96;11.07.2014;2014;07;03;Perjantai;0;0;0;6;0;6
96;11.07.2014;2014;07;04;Perjantai;3;0;3;3;0;3
96;11.07.2014;2014;07;05;Perjantai;25;0;25;2;0;2
96;11.07.2014;2014;07;06;Perjantai;94;0;94;7;0;7
96;11.07.2014;2014;07;07;Perjantai;143;0;143;11;0;11
96;11.07.2014;2014;07;08;Perjantai;90;0;90;9;0;9
96;11.07.2014;2014;07;09;Perjantai;102;1;103;9;0;9
96;11.07.2014;2014;07;10;Perjantai;88;0;88;9;0;9
96;11.07.2014;2014;07;11;Perjantai;142;0;142;16;0;16
96;11.07.2014;2014;07;12;Perjantai;157;0;157;16;0;16
96;11.07.2014;2014;07;13;Perjantai;166;0;166;17;0;17
96;11.07.2014;2014;07;14;Perjantai;243;2;245;34;0;34
96;11.07.2014;2014;07;15;Perjantai;230;0;230;16;0;16
96;11.07.2014;2014;07;16;Perjantai;176;0;176;20;0;20
96;11.07.2014;2014;07;17;Perjantai;145;0;145;19;0;19
96;11.07.2014;2014;07;18;Perjantai;139;1;140;15;0;15
96;11.07.2014;2014;07;19;Perjantai;95;3;98;24;0;24
96;11.07.2014;2014;07;20;Perjantai;120;0;120;22;0;22
96;11.07.2014;2014;07;21;Perjantai;88;0;88;16;0;16
96;11.07.2014;2014;07;22;Perjantai;41;0;41;11;0;11
96;11.07.2014;2014;07;23;Perjantai;61;0;61;6;0;6
96;12.07.2014;2014;07;00;Lauantai;53;0;53;2;0;2
96;12.07.2014;2014;07;01;Lauantai;34;0;34;1;0;1
96;12.07.2014;2014;07;02;Lauantai;31;0;31;2;0;2
96;12.07.2014;2014;07;03;Lauantai;32;0;32;3;0;3
96;12.07.2014;2014;07;04;Lauantai;7;0;7;16;0;16
96;12.07.2014;2014;07;05;Lauantai;0;0;0;15;0;15
96;12.07.2014;2014;07;06;Lauantai;0;0;0;45;0;45
96;12.07.2014;2014;07;07;Lauantai;0;0;0;45;0;45
96;12.07.2014;2014;07;08;Lauantai;30;0;30;15;0;15
96;12.07.2014;2014;07;09;Lauantai;71;0;71;11;0;11
96;12.07.2014;2014;07;10;Lauantai;82;0;82;9;0;9
96;12.07.2014;2014;07;11;Lauantai;101;0;101;13;0;13
96;12.07.2014;2014;07;12;Lauantai;160;0;160;12;0;12
96;12.07.2014;2014;07;13;Lauantai;161;0;161;42;0;42
96;12.07.2014;2014;07;14;Lauantai;176;0;176;53;0;53
96;12.07.2014;2014;07;15;Lauantai;114;0;114;317;0;317
96;12.07.2014;2014;07;16;Lauantai;148;0;148;510;0;510
96;12.07.2014;2014;07;17;Lauantai;129;0;129;23;0;23
96;12.07.2014;2014;07;18;Lauantai;108;0;108;11;0;11
96;12.07.2014;2014;07;19;Lauantai;136;0;136;26;0;26
96;12.07.2014;2014;07;20;Lauantai;102;0;102;12;0;12
96;12.07.2014;2014;07;21;Lauantai;99;0;99;14;0;14
96;12.07.2014;2014;07;22;Lauantai;91;0;91;5;0;5
96;12.07.2014;2014;07;23;Lauantai;38;0;38;6;0;6
96;13.07.2014;2014;07;00;Sunnuntai;40;0;40;1;0;1
96;13.07.2014;2014;07;01;Sunnuntai;41;0;41;1;0;1
96;13.07.2014;2014;07;02;Sunnuntai;32;0;32;2;0;2
96;13.07.2014;2014;07;03;Sunnuntai;43;0;43;1;0;1
96;13.07.2014;2014;07;04;Sunnuntai;18;0;18;3;0;3
96;13.07.2014;2014;07;05;Sunnuntai;11;0;11;13;0;13
96;13.07.2014;2014;07;06;Sunnuntai;35;0;35;4;0;4
96;13.07.2014;2014;07;07;Sunnuntai;25;0;25;3;0;3
96;13.07.2014;2014;07;08;Sunnuntai;19;0;19;5;0;5
96;13.07.2014;2014;07;09;Sunnuntai;21;0;21;3;0;3
96;13.07.2014;2014;07;10;Sunnuntai;48;0;48;8;0;8
96;13.07.2014;2014;07;11;Sunnuntai;75;0;75;7;0;7
96;13.07.2014;2014;07;12;Sunnuntai;117;0;117;13;0;13
96;13.07.2014;2014;07;13;Sunnuntai;126;0;126;16;0;16
96;13.07.2014;2014;07;14;Sunnuntai;115;0;115;15;0;15
96;13.07.2014;2014;07;15;Sunnuntai;148;0;148;23;0;23
96;13.07.2014;2014;07;16;Sunnuntai;144;0;144;23;0;23
96;13.07.2014;2014;07;17;Sunnuntai;125;0;125;20;0;20
96;13.07.2014;2014;07;18;Sunnuntai;118;0;118;20;0;20
96;13.07.2014;2014;07;19;Sunnuntai;132;0;132;15;0;15
96;13.07.2014;2014;07;20;Sunnuntai;98;0;98;6;0;6
96;13.07.2014;2014;07;21;Sunnuntai;66;0;66;8;0;8
96;13.07.2014;2014;07;22;Sunnuntai;28;0;28;2;0;2
96;13.07.2014;2014;07;23;Sunnuntai;17;0;17;4;0;4
96;14.07.2014;2014;07;00;Maanantai;16;0;16;1;0;1
96;14.07.2014;2014;07;01;Maanantai;12;0;12;0;0;0
96;14.07.2014;2014;07;02;Maanantai;5;0;5;1;0;1
96;14.07.2014;2014;07;03;Maanantai;4;0;4;2;0;2
96;14.07.2014;2014;07;04;Maanantai;5;0;5;2;0;2
96;14.07.2014;2014;07;05;Maanantai;19;0;19;2;0;2
96;14.07.2014;2014;07;06;Maanantai;103;0;103;8;0;8
96;14.07.2014;2014;07;07;Maanantai;179;0;179;11;0;11
96;14.07.2014;2014;07;08;Maanantai;82;0;82;4;0;4
96;14.07.2014;2014;07;09;Maanantai;85;0;85;5;0;5
96;14.07.2014;2014;07;10;Maanantai;86;0;86;16;0;16
96;14.07.2014;2014;07;11;Maanantai;104;0;104;7;0;7
96;14.07.2014;2014;07;12;Maanantai;153;0;153;16;0;16
96;14.07.2014;2014;07;13;Maanantai;145;0;145;11;0;11
96;14.07.2014;2014;07;14;Maanantai;186;0;186;22;0;22
96;14.07.2014;2014;07;15;Maanantai;248;0;248;27;0;27
96;14.07.2014;2014;07;16;Maanantai;191;0;191;13;0;13
96;14.07.2014;2014;07;17;Maanantai;163;1;164;13;0;13
96;14.07.2014;2014;07;18;Maanantai;112;0;112;9;0;9
96;14.07.2014;2014;07;19;Maanantai;53;0;53;21;0;21
96;14.07.2014;2014;07;20;Maanantai;68;0;68;5;0;5
96;14.07.2014;2014;07;21;Maanantai;62;0;62;8;0;8
96;14.07.2014;2014;07;22;Maanantai;18;0;18;7;0;7
96;14.07.2014;2014;07;23;Maanantai;14;0;14;1;0;1
96;15.07.2014;2014;07;00;Tiistai;12;0;12;1;0;1
96;15.07.2014;2014;07;01;Tiistai;10;0;10;1;0;1
96;15.07.2014;2014;07;02;Tiistai;0;0;0;0;0;0
96;15.07.2014;2014;07;03;Tiistai;0;0;0;0;0;0
96;15.07.2014;2014;07;04;Tiistai;2;0;2;2;0;2
96;15.07.2014;2014;07;05;Tiistai;21;0;21;15;0;15
96;15.07.2014;2014;07;06;Tiistai;111;0;111;5;0;5
96;15.07.2014;2014;07;07;Tiistai;152;0;152;10;0;10
96;15.07.2014;2014;07;08;Tiistai;77;0;77;6;0;6
96;15.07.2014;2014;07;09;Tiistai;88;0;88;7;0;7
96;15.07.2014;2014;07;10;Tiistai;75;0;75;19;0;19
96;15.07.2014;2014;07;11;Tiistai;106;0;106;11;0;11
96;15.07.2014;2014;07;12;Tiistai;107;0;107;13;0;13
96;15.07.2014;2014;07;13;Tiistai;127;1;128;14;0;14
96;15.07.2014;2014;07;14;Tiistai;171;0;171;30;0;30
96;15.07.2014;2014;07;15;Tiistai;246;0;246;28;0;28
96;15.07.2014;2014;07;16;Tiistai;190;0;190;22;0;22
96;15.07.2014;2014;07;17;Tiistai;152;0;152;29;0;29
96;15.07.2014;2014;07;18;Tiistai;157;0;157;22;0;22
96;15.07.2014;2014;07;19;Tiistai;148;0;148;36;0;36
96;15.07.2014;2014;07;20;Tiistai;88;0;88;8;0;8
96;15.07.2014;2014;07;21;Tiistai;50;0;50;11;0;11
96;15.07.2014;2014;07;22;Tiistai;22;0;22;17;0;17
96;15.07.2014;2014;07;23;Tiistai;0;0;0;23;0;23
96;16.07.2014;2014;07;00;Keskiviikko;0;0;0;11;0;11
96;16.07.2014;2014;07;01;Keskiviikko;0;0;0;6;0;6
96;16.07.2014;2014;07;02;Keskiviikko;0;0;0;3;0;3
96;16.07.2014;2014;07;03;Keskiviikko;0;0;0;8;0;8
96;16.07.2014;2014;07;04;Keskiviikko;0;0;0;4;0;4
96;16.07.2014;2014;07;05;Keskiviikko;0;0;0;28;0;28
96;16.07.2014;2014;07;06;Keskiviikko;0;0;0;99;0;99
96;16.07.2014;2014;07;07;Keskiviikko;0;0;0;168;0;168
96;16.07.2014;2014;07;08;Keskiviikko;0;0;0;115;0;115
96;16.07.2014;2014;07;09;Keskiviikko;0;0;0;107;0;107
96;16.07.2014;2014;07;10;Keskiviikko;0;0;0;115;0;115
96;16.07.2014;2014;07;11;Keskiviikko;0;0;0;131;0;131
96;16.07.2014;2014;07;12;Keskiviikko;79;0;79;77;0;77
96;16.07.2014;2014;07;13;Keskiviikko;122;0;122;10;0;10
96;16.07.2014;2014;07;14;Keskiviikko;170;0;170;14;0;14
96;16.07.2014;2014;07;15;Keskiviikko;209;0;209;18;0;18
96;16.07.2014;2014;07;16;Keskiviikko;139;0;139;14;0;14
96;16.07.2014;2014;07;17;Keskiviikko;132;0;132;20;0;20
96;16.07.2014;2014;07;18;Keskiviikko;131;0;131;14;0;14
96;16.07.2014;2014;07;19;Keskiviikko;81;0;81;11;0;11
96;16.07.2014;2014;07;20;Keskiviikko;93;0;93;19;0;19
96;16.07.2014;2014;07;21;Keskiviikko;78;0;78;20;0;20
96;16.07.2014;2014;07;22;Keskiviikko;27;0;27;6;0;6
96;16.07.2014;2014;07;23;Keskiviikko;29;0;29;10;0;10
96;17.07.2014;2014;07;00;Torstai;7;0;7;1;0;1
96;17.07.2014;2014;07;01;Torstai;8;0;8;5;0;5
96;17.07.2014;2014;07;02;Torstai;0;0;0;11;0;11
96;17.07.2014;2014;07;03;Torstai;0;0;0;15;0;15
96;17.07.2014;2014;07;04;Torstai;0;0;0;3;0;3
96;17.07.2014;2014;07;05;Torstai;0;0;0;29;0;29
96;17.07.2014;2014;07;06;Torstai;0;0;0;93;0;93
96;17.07.2014;2014;07;07;Torstai;0;0;0;163;0;163
96;17.07.2014;2014;07;08;Torstai;0;0;0;82;0;82
96;17.07.2014;2014;07;09;Torstai;0;0;0;90;0;90
96;17.07.2014;2014;07;10;Torstai;0;0;0;77;0;77
96;17.07.2014;2014;07;11;Torstai;0;0;0;132;0;132
96;17.07.2014;2014;07;12;Torstai;134;0;134;20;0;20
96;17.07.2014;2014;07;13;Torstai;142;1;143;13;0;13
96;17.07.2014;2014;07;14;Torstai;147;1;148;12;0;12
96;17.07.2014;2014;07;15;Torstai;236;0;236;26;0;26
96;17.07.2014;2014;07;16;Torstai;165;0;165;30;0;30
96;17.07.2014;2014;07;17;Torstai;123;0;123;11;0;11
96;17.07.2014;2014;07;18;Torstai;117;0;117;7;0;7
96;17.07.2014;2014;07;19;Torstai;94;0;94;9;0;9
96;17.07.2014;2014;07;20;Torstai;67;1;68;10;0;10
96;17.07.2014;2014;07;21;Torstai;72;0;72;3;0;3
96;17.07.2014;2014;07;22;Torstai;36;0;36;2;0;2
96;17.07.2014;2014;07;23;Torstai;11;0;11;3;0;3
96;18.07.2014;2014;07;00;Perjantai;9;0;9;1;0;1
96;18.07.2014;2014;07;01;Perjantai;0;0;0;10;0;10
96;18.07.2014;2014;07;02;Perjantai;0;0;0;5;0;5
96;18.07.2014;2014;07;03;Perjantai;0;0;0;4;0;4
96;18.07.2014;2014;07;04;Perjantai;0;0;0;3;0;3
96;18.07.2014;2014;07;05;Perjantai;0;0;0;22;0;22
96;18.07.2014;2014;07;06;Perjantai;0;0;0;101;0;101
96;18.07.2014;2014;07;07;Perjantai;0;0;0;138;0;138
96;18.07.2014;2014;07;08;Perjantai;0;0;0;88;0;88
96;18.07.2014;2014;07;09;Perjantai;0;0;0;97;0;97
96;18.07.2014;2014;07;10;Perjantai;0;0;0;89;0;89
96;18.07.2014;2014;07;11;Perjantai;35;0;35;73;0;73
96;18.07.2014;2014;07;12;Perjantai;107;0;107;10;0;10
96;18.07.2014;2014;07;13;Perjantai;88;0;88;8;0;8
96;18.07.2014;2014;07;14;Perjantai;111;0;111;7;0;7
96;18.07.2014;2014;07;15;Perjantai;159;0;159;13;0;13
96;18.07.2014;2014;07;16;Perjantai;138;0;138;12;0;12
96;18.07.2014;2014;07;17;Perjantai;94;0;94;12;0;12
96;18.07.2014;2014;07;18;Perjantai;124;0;124;9;0;9
96;18.07.2014;2014;07;19;Perjantai;80;0;80;11;0;11
96;18.07.2014;2014;07;20;Perjantai;111;0;111;11;0;11
96;18.07.2014;2014;07;21;Perjantai;66;0;66;13;0;13
96;18.07.2014;2014;07;22;Perjantai;40;0;40;4;0;4
96;18.07.2014;2014;07;23;Perjantai;46;0;46;3;0;3
96;19.07.2014;2014;07;00;Lauantai;32;0;32;1;0;1
96;19.07.2014;2014;07;01;Lauantai;18;0;18;4;0;4
96;19.07.2014;2014;07;02;Lauantai;20;0;20;1;0;1
96;19.07.2014;2014;07;03;Lauantai;19;0;19;5;0;5
96;19.07.2014;2014;07;04;Lauantai;19;0;19;7;0;7
96;19.07.2014;2014;07;05;Lauantai;8;0;8;2;0;2
96;19.07.2014;2014;07;06;Lauantai;33;0;33;3;0;3
96;19.07.2014;2014;07;07;Lauantai;33;0;33;4;0;4
96;19.07.2014;2014;07;08;Lauantai;29;0;29;3;0;3
96;19.07.2014;2014;07;09;Lauantai;92;1;93;5;0;5
96;19.07.2014;2014;07;10;Lauantai;109;0;109;2;0;2
96;19.07.2014;2014;07;11;Lauantai;117;0;117;9;0;9
96;19.07.2014;2014;07;12;Lauantai;170;0;170;11;0;11
96;19.07.2014;2014;07;13;Lauantai;121;0;121;23;0;23
96;19.07.2014;2014;07;14;Lauantai;133;3;136;5;0;5
96;19.07.2014;2014;07;15;Lauantai;81;1;82;3;0;3
96;19.07.2014;2014;07;16;Lauantai;55;0;55;7;0;7
96;19.07.2014;2014;07;17;Lauantai;52;0;52;4;0;4
96;19.07.2014;2014;07;18;Lauantai;68;0;68;8;0;8
96;19.07.2014;2014;07;19;Lauantai;45;0;45;8;0;8
96;19.07.2014;2014;07;20;Lauantai;58;0;58;10;0;10
96;19.07.2014;2014;07;21;Lauantai;58;0;58;3;0;3
96;19.07.2014;2014;07;22;Lauantai;28;0;28;2;0;2
96;19.07.2014;2014;07;23;Lauantai;42;0;42;7;0;7
96;20.07.2014;2014;07;00;Sunnuntai;30;0;30;2;0;2
96;20.07.2014;2014;07;01;Sunnuntai;30;0;30;3;0;3
96;20.07.2014;2014;07;02;Sunnuntai;31;0;31;2;0;2
96;20.07.2014;2014;07;03;Sunnuntai;22;0;22;3;0;3
96;20.07.2014;2014;07;04;Sunnuntai;16;0;16;7;0;7
96;20.07.2014;2014;07;05;Sunnuntai;13;0;13;0;0;0
96;20.07.2014;2014;07;06;Sunnuntai;25;0;25;1;0;1
96;20.07.2014;2014;07;07;Sunnuntai;28;0;28;5;0;5
96;20.07.2014;2014;07;08;Sunnuntai;16;0;16;5;0;5
96;20.07.2014;2014;07;09;Sunnuntai;38;0;38;6;0;6
96;20.07.2014;2014;07;10;Sunnuntai;46;0;46;7;0;7
96;20.07.2014;2014;07;11;Sunnuntai;76;2;78;9;0;9
96;20.07.2014;2014;07;12;Sunnuntai;133;0;133;14;0;14
96;20.07.2014;2014;07;13;Sunnuntai;112;0;112;16;0;16
96;20.07.2014;2014;07;14;Sunnuntai;137;0;137;12;0;12
96;20.07.2014;2014;07;15;Sunnuntai;99;0;99;15;0;15
96;20.07.2014;2014;07;16;Sunnuntai;115;0;115;15;0;15
96;20.07.2014;2014;07;17;Sunnuntai;107;1;108;14;0;14
96;20.07.2014;2014;07;18;Sunnuntai;99;0;99;11;0;11
96;20.07.2014;2014;07;19;Sunnuntai;116;0;116;19;0;19
96;20.07.2014;2014;07;20;Sunnuntai;68;0;68;14;0;14
96;20.07.2014;2014;07;21;Sunnuntai;65;0;65;16;0;16
96;20.07.2014;2014;07;22;Sunnuntai;45;0;45;4;0;4
96;20.07.2014;2014;07;23;Sunnuntai;25;0;25;0;0;0
96;21.07.2014;2014;07;00;Maanantai;9;0;9;6;0;6
96;21.07.2014;2014;07;01;Maanantai;0;0;0;9;0;9
96;21.07.2014;2014;07;02;Maanantai;0;0;0;4;0;4
96;21.07.2014;2014;07;03;Maanantai;0;0;0;4;0;4
96;21.07.2014;2014;07;04;Maanantai;0;0;0;3;0;3
96;21.07.2014;2014;07;05;Maanantai;0;0;0;18;0;18
96;21.07.2014;2014;07;06;Maanantai;0;0;0;105;0;105
96;21.07.2014;2014;07;07;Maanantai;0;0;0;181;0;181
96;21.07.2014;2014;07;08;Maanantai;58;0;58;43;0;43
96;21.07.2014;2014;07;09;Maanantai;98;0;98;10;0;10
96;21.07.2014;2014;07;10;Maanantai;113;0;113;19;0;19
96;21.07.2014;2014;07;11;Maanantai;140;0;140;11;0;11
96;21.07.2014;2014;07;12;Maanantai;144;0;144;13;0;13
96;21.07.2014;2014;07;13;Maanantai;153;0;153;18;0;18
96;21.07.2014;2014;07;14;Maanantai;201;1;202;29;0;29
96;21.07.2014;2014;07;15;Maanantai;288;0;288;36;0;36
96;21.07.2014;2014;07;16;Maanantai;193;0;193;26;0;26
96;21.07.2014;2014;07;17;Maanantai;188;0;188;25;0;25
96;21.07.2014;2014;07;18;Maanantai;152;0;152;22;0;22
96;21.07.2014;2014;07;19;Maanantai;139;0;139;29;0;29
96;21.07.2014;2014;07;20;Maanantai;135;0;135;10;0;10
96;21.07.2014;2014;07;21;Maanantai;99;0;99;11;0;11
96;21.07.2014;2014;07;22;Maanantai;37;0;37;8;0;8
96;21.07.2014;2014;07;23;Maanantai;22;0;22;6;0;6
96;22.07.2014;2014;07;00;Tiistai;28;0;28;0;0;0
96;22.07.2014;2014;07;01;Tiistai;9;0;9;2;0;2
96;22.07.2014;2014;07;02;Tiistai;11;0;11;0;0;0
96;22.07.2014;2014;07;03;Tiistai;0;0;0;0;0;0
96;22.07.2014;2014;07;04;Tiistai;7;0;7;0;0;0
96;22.07.2014;2014;07;05;Tiistai;25;0;25;3;0;3
96;22.07.2014;2014;07;06;Tiistai;108;0;108;8;0;8
96;22.07.2014;2014;07;07;Tiistai;168;0;168;10;0;10
96;22.07.2014;2014;07;08;Tiistai;112;0;112;9;0;9
96;22.07.2014;2014;07;09;Tiistai;113;0;113;16;0;16
96;22.07.2014;2014;07;10;Tiistai;120;0;120;20;0;20
96;22.07.2014;2014;07;11;Tiistai;125;1;126;7;0;7
96;22.07.2014;2014;07;12;Tiistai;153;0;153;15;0;15
96;22.07.2014;2014;07;13;Tiistai;147;0;147;10;0;10
96;22.07.2014;2014;07;14;Tiistai;221;0;221;26;0;26
96;22.07.2014;2014;07;15;Tiistai;301;0;301;30;0;30
96;22.07.2014;2014;07;16;Tiistai;189;0;189;22;0;22
96;22.07.2014;2014;07;17;Tiistai;142;0;142;26;0;26
96;22.07.2014;2014;07;18;Tiistai;142;0;142;15;0;15
96;22.07.2014;2014;07;19;Tiistai;130;0;130;23;0;23
96;22.07.2014;2014;07;20;Tiistai;135;0;135;20;0;20
96;22.07.2014;2014;07;21;Tiistai;98;0;98;10;0;10
96;22.07.2014;2014;07;22;Tiistai;56;0;56;9;0;9
96;22.07.2014;2014;07;23;Tiistai;24;0;24;7;0;7
96;23.07.2014;2014;07;00;Keskiviikko;26;0;26;2;0;2
96;23.07.2014;2014;07;01;Keskiviikko;9;0;9;1;0;1
96;23.07.2014;2014;07;02;Keskiviikko;10;0;10;0;0;0
96;23.07.2014;2014;07;03;Keskiviikko;4;0;4;1;0;1
96;23.07.2014;2014;07;04;Keskiviikko;6;0;6;0;0;0
96;23.07.2014;2014;07;05;Keskiviikko;21;0;21;2;0;2
96;23.07.2014;2014;07;06;Keskiviikko;116;0;116;8;0;8
96;23.07.2014;2014;07;07;Keskiviikko;162;0;162;6;0;6
96;23.07.2014;2014;07;08;Keskiviikko;105;0;105;6;0;6
96;23.07.2014;2014;07;09;Keskiviikko;84;0;84;3;0;3
96;23.07.2014;2014;07;10;Keskiviikko;106;0;106;10;0;10
96;23.07.2014;2014;07;11;Keskiviikko;115;2;117;11;0;11
96;23.07.2014;2014;07;12;Keskiviikko;168;4;172;12;0;12
96;23.07.2014;2014;07;13;Keskiviikko;172;0;172;11;0;11
96;23.07.2014;2014;07;14;Keskiviikko;192;0;192;12;0;12
96;23.07.2014;2014;07;15;Keskiviikko;266;0;266;39;0;39
96;23.07.2014;2014;07;16;Keskiviikko;175;0;175;19;0;19
96;23.07.2014;2014;07;17;Keskiviikko;175;0;175;11;0;11
96;23.07.2014;2014;07;18;Keskiviikko;156;0;156;24;0;24
96;23.07.2014;2014;07;19;Keskiviikko;153;0;153;19;0;19
96;23.07.2014;2014;07;20;Keskiviikko;166;0;166;19;0;19
96;23.07.2014;2014;07;21;Keskiviikko;103;1;104;11;0;11
96;23.07.2014;2014;07;22;Keskiviikko;60;0;60;88;0;88
96;23.07.2014;2014;07;23;Keskiviikko;47;0;47;6;0;6
96;24.07.2014;2014;07;00;Torstai;28;0;28;2;0;2
96;24.07.2014;2014;07;01;Torstai;19;0;19;0;0;0
96;24.07.2014;2014;07;02;Torstai;17;0;17;4;0;4
96;24.07.2014;2014;07;03;Torstai;11;0;11;0;0;0
96;24.07.2014;2014;07;04;Torstai;12;0;12;2;0;2
96;24.07.2014;2014;07;05;Torstai;23;0;23;1;0;1
96;24.07.2014;2014;07;06;Torstai;95;0;95;6;0;6
96;24.07.2014;2014;07;07;Torstai;157;0;157;5;0;5
96;24.07.2014;2014;07;08;Torstai;119;0;119;9;0;9
96;24.07.2014;2014;07;09;Torstai;113;0;113;6;0;6
96;24.07.2014;2014;07;10;Torstai;86;0;86;11;0;11
96;24.07.2014;2014;07;11;Torstai;123;0;123;7;0;7
96;24.07.2014;2014;07;12;Torstai;135;1;136;14;0;14
96;24.07.2014;2014;07;13;Torstai;162;0;162;12;0;12
96;24.07.2014;2014;07;14;Torstai;201;1;202;20;0;20
96;24.07.2014;2014;07;15;Torstai;262;0;262;32;0;32
96;24.07.2014;2014;07;16;Torstai;219;0;219;17;0;17
96;24.07.2014;2014;07;17;Torstai;167;0;167;25;0;25
96;24.07.2014;2014;07;18;Torstai;137;0;137;15;0;15
96;24.07.2014;2014;07;19;Torstai;157;0;157;16;0;16
96;24.07.2014;2014;07;20;Torstai;117;0;117;15;0;15
96;24.07.2014;2014;07;21;Torstai;119;0;119;11;0;11
96;24.07.2014;2014;07;22;Torstai;52;0;52;15;0;15
96;24.07.2014;2014;07;23;Torstai;39;0;39;1;0;1
96;25.07.2014;2014;07;00;Perjantai;32;0;32;2;0;2
96;25.07.2014;2014;07;01;Perjantai;0;0;0;19;0;19
96;25.07.2014;2014;07;02;Perjantai;0;0;0;8;0;8
96;25.07.2014;2014;07;03;Perjantai;0;0;0;4;0;4
96;25.07.2014;2014;07;04;Perjantai;0;0;0;7;0;7
96;25.07.2014;2014;07;05;Perjantai;0;0;0;28;0;28
96;25.07.2014;2014;07;06;Perjantai;0;0;0;97;0;97
96;25.07.2014;2014;07;07;Perjantai;0;0;0;171;0;171
96;25.07.2014;2014;07;08;Perjantai;0;0;0;91;0;91
96;25.07.2014;2014;07;09;Perjantai;18;0;18;84;0;84
96;25.07.2014;2014;07;10;Perjantai;108;0;108;7;0;7
96;25.07.2014;2014;07;11;Perjantai;146;1;147;18;0;18
96;25.07.2014;2014;07;12;Perjantai;162;1;163;16;0;16
96;25.07.2014;2014;07;13;Perjantai;175;0;175;20;0;20
96;25.07.2014;2014;07;14;Perjantai;226;0;226;26;0;26
96;25.07.2014;2014;07;15;Perjantai;245;0;245;20;0;20
96;25.07.2014;2014;07;16;Perjantai;174;0;174;22;0;22
96;25.07.2014;2014;07;17;Perjantai;166;0;166;21;0;21
96;25.07.2014;2014;07;18;Perjantai;153;0;153;16;0;16
96;25.07.2014;2014;07;19;Perjantai;155;0;155;13;0;13
96;25.07.2014;2014;07;20;Perjantai;149;0;149;6;0;6
96;25.07.2014;2014;07;21;Perjantai;113;0;113;11;0;11
96;25.07.2014;2014;07;22;Perjantai;77;0;77;10;0;10
96;25.07.2014;2014;07;23;Perjantai;14;0;14;55;0;55
96;26.07.2014;2014;07;00;Lauantai;0;0;0;58;0;58
96;26.07.2014;2014;07;01;Lauantai;0;0;0;68;0;68
96;26.07.2014;2014;07;02;Lauantai;0;0;0;103;0;103
96;26.07.2014;2014;07;03;Lauantai;0;0;0;75;0;75
96;26.07.2014;2014;07;04;Lauantai;0;0;0;39;0;39
96;26.07.2014;2014;07;05;Lauantai;0;0;0;16;0;16
96;26.07.2014;2014;07;06;Lauantai;0;0;0;36;0;36
96;26.07.2014;2014;07;07;Lauantai;0;0;0;35;0;35
96;26.07.2014;2014;07;08;Lauantai;0;0;0;27;0;27
96;26.07.2014;2014;07;09;Lauantai;0;0;0;63;0;63
96;26.07.2014;2014;07;10;Lauantai;0;0;0;88;0;88
96;26.07.2014;2014;07;11;Lauantai;0;0;0;107;0;107
96;26.07.2014;2014;07;12;Lauantai;137;3;140;36;0;36
96;26.07.2014;2014;07;13;Lauantai;179;2;181;15;0;15
96;26.07.2014;2014;07;14;Lauantai;145;0;145;8;0;8
96;26.07.2014;2014;07;15;Lauantai;138;0;138;9;0;9
96;26.07.2014;2014;07;16;Lauantai;127;0;127;11;0;11
96;26.07.2014;2014;07;17;Lauantai;117;0;117;14;0;14
96;26.07.2014;2014;07;18;Lauantai;118;0;118;14;0;14
96;26.07.2014;2014;07;19;Lauantai;92;0;92;8;0;8
96;26.07.2014;2014;07;20;Lauantai;102;1;103;11;0;11
96;26.07.2014;2014;07;21;Lauantai;87;3;90;9;0;9
96;26.07.2014;2014;07;22;Lauantai;75;0;75;9;0;9
96;26.07.2014;2014;07;23;Lauantai;94;0;94;4;0;4
96;27.07.2014;2014;07;00;Sunnuntai;97;0;97;4;0;4
96;27.07.2014;2014;07;01;Sunnuntai;100;0;100;11;0;11
96;27.07.2014;2014;07;02;Sunnuntai;56;0;56;50;0;50
96;27.07.2014;2014;07;03;Sunnuntai;37;0;37;62;0;62
96;27.07.2014;2014;07;04;Sunnuntai;56;0;56;10;0;10
96;27.07.2014;2014;07;05;Sunnuntai;21;0;21;4;0;4
96;27.07.2014;2014;07;06;Sunnuntai;35;0;35;1;0;1
96;27.07.2014;2014;07;07;Sunnuntai;22;0;22;5;0;5
96;27.07.2014;2014;07;08;Sunnuntai;30;0;30;11;0;11
96;27.07.2014;2014;07;09;Sunnuntai;27;0;27;3;0;3
96;27.07.2014;2014;07;10;Sunnuntai;58;0;58;10;0;10
96;27.07.2014;2014;07;11;Sunnuntai;87;0;87;11;0;11
96;27.07.2014;2014;07;12;Sunnuntai;103;1;104;23;0;23
96;27.07.2014;2014;07;13;Sunnuntai;108;0;108;6;0;6
96;27.07.2014;2014;07;14;Sunnuntai;91;0;91;9;0;9
96;27.07.2014;2014;07;15;Sunnuntai;108;0;108;12;0;12
96;27.07.2014;2014;07;16;Sunnuntai;114;0;114;13;0;13
96;27.07.2014;2014;07;17;Sunnuntai;123;0;123;9;0;9
96;27.07.2014;2014;07;18;Sunnuntai;103;0;103;9;0;9
96;27.07.2014;2014;07;19;Sunnuntai;116;0;116;15;0;15
96;27.07.2014;2014;07;20;Sunnuntai;84;0;84;10;0;10
96;27.07.2014;2014;07;21;Sunnuntai;78;0;78;7;0;7
96;27.07.2014;2014;07;22;Sunnuntai;46;0;46;8;0;8
96;27.07.2014;2014;07;23;Sunnuntai;15;0;15;8;0;8
96;28.07.2014;2014;07;00;Maanantai;8;0;8;2;0;2
96;28.07.2014;2014;07;01;Maanantai;15;0;15;1;0;1
96;28.07.2014;2014;07;02;Maanantai;4;0;4;0;0;0
96;28.07.2014;2014;07;03;Maanantai;4;0;4;0;0;0
96;28.07.2014;2014;07;04;Maanantai;3;0;3;2;0;2
96;28.07.2014;2014;07;05;Maanantai;16;0;16;3;0;3
96;28.07.2014;2014;07;06;Maanantai;109;0;109;3;0;3
96;28.07.2014;2014;07;07;Maanantai;169;0;169;4;0;4
96;28.07.2014;2014;07;08;Maanantai;77;0;77;6;0;6
96;28.07.2014;2014;07;09;Maanantai;37;0;37;3;0;3
96;28.07.2014;2014;07;10;Maanantai;38;0;38;2;0;2
96;28.07.2014;2014;07;11;Maanantai;50;0;50;7;0;7
96;28.07.2014;2014;07;12;Maanantai;86;0;86;14;0;14
96;28.07.2014;2014;07;13;Maanantai;96;0;96;12;0;12
96;28.07.2014;2014;07;14;Maanantai;141;0;141;6;0;6
96;28.07.2014;2014;07;15;Maanantai;187;0;187;11;0;11
96;28.07.2014;2014;07;16;Maanantai;123;0;123;11;0;11
96;28.07.2014;2014;07;17;Maanantai;111;0;111;11;0;11
96;28.07.2014;2014;07;18;Maanantai;83;0;83;21;0;21
96;28.07.2014;2014;07;19;Maanantai;104;0;104;30;0;30
96;28.07.2014;2014;07;20;Maanantai;71;2;73;28;0;28
96;28.07.2014;2014;07;21;Maanantai;65;0;65;13;0;13
96;28.07.2014;2014;07;22;Maanantai;34;0;34;3;0;3
96;28.07.2014;2014;07;23;Maanantai;13;0;13;0;0;0
96;29.07.2014;2014;07;00;Tiistai;5;0;5;3;0;3
96;29.07.2014;2014;07;01;Tiistai;5;0;5;2;0;2
96;29.07.2014;2014;07;02;Tiistai;7;0;7;1;0;1
96;29.07.2014;2014;07;03;Tiistai;0;0;0;0;0;0
96;29.07.2014;2014;07;04;Tiistai;1;0;1;0;0;0
96;29.07.2014;2014;07;05;Tiistai;25;0;25;3;0;3
96;29.07.2014;2014;07;06;Tiistai;95;0;95;4;0;4
96;29.07.2014;2014;07;07;Tiistai;167;0;167;19;0;19
96;29.07.2014;2014;07;08;Tiistai;125;0;125;7;0;7
96;29.07.2014;2014;07;09;Tiistai;83;0;83;12;1;13
96;29.07.2014;2014;07;10;Tiistai;98;0;98;12;1;13
96;29.07.2014;2014;07;11;Tiistai;127;0;127;16;0;16
96;29.07.2014;2014;07;12;Tiistai;176;0;176;14;0;14
96;29.07.2014;2014;07;13;Tiistai;148;0;148;13;2;15
96;29.07.2014;2014;07;14;Tiistai;174;0;174;21;0;21
96;29.07.2014;2014;07;15;Tiistai;284;0;284;42;0;42
96;29.07.2014;2014;07;16;Tiistai;209;0;209;19;0;19
96;29.07.2014;2014;07;17;Tiistai;145;0;145;23;0;23
96;29.07.2014;2014;07;18;Tiistai;155;0;155;24;0;24
96;29.07.2014;2014;07;19;Tiistai;112;0;112;34;0;34
96;29.07.2014;2014;07;20;Tiistai;123;0;123;12;0;12
96;29.07.2014;2014;07;21;Tiistai;67;0;67;11;0;11
96;29.07.2014;2014;07;22;Tiistai;38;0;38;7;0;7
96;29.07.2014;2014;07;23;Tiistai;12;0;12;8;0;8
96;30.07.2014;2014;07;00;Keskiviikko;8;0;8;0;0;0
96;30.07.2014;2014;07;01;Keskiviikko;3;0;3;0;0;0
96;30.07.2014;2014;07;02;Keskiviikko;3;0;3;1;0;1
96;30.07.2014;2014;07;03;Keskiviikko;2;0;2;0;0;0
96;30.07.2014;2014;07;04;Keskiviikko;1;0;1;0;0;0
96;30.07.2014;2014;07;05;Keskiviikko;19;0;19;3;0;3
96;30.07.2014;2014;07;06;Keskiviikko;101;0;101;7;0;7
96;30.07.2014;2014;07;07;Keskiviikko;174;0;174;13;0;13
96;30.07.2014;2014;07;08;Keskiviikko;107;0;107;10;0;10
96;30.07.2014;2014;07;09;Keskiviikko;108;0;108;10;0;10
96;30.07.2014;2014;07;10;Keskiviikko;101;0;101;13;0;13
96;30.07.2014;2014;07;11;Keskiviikko;115;0;115;15;0;15
96;30.07.2014;2014;07;12;Keskiviikko;146;0;146;14;0;14
96;30.07.2014;2014;07;13;Keskiviikko;156;0;156;7;0;7
96;30.07.2014;2014;07;14;Keskiviikko;181;0;181;20;0;20
96;30.07.2014;2014;07;15;Keskiviikko;279;0;279;30;0;30
96;30.07.2014;2014;07;16;Keskiviikko;223;0;223;24;0;24
96;30.07.2014;2014;07;17;Keskiviikko;186;0;186;19;0;19
96;30.07.2014;2014;07;18;Keskiviikko;158;0;158;48;0;48
96;30.07.2014;2014;07;19;Keskiviikko;123;0;123;19;0;19
96;30.07.2014;2014;07;20;Keskiviikko;114;0;114;12;0;12
96;30.07.2014;2014;07;21;Keskiviikko;72;0;72;12;0;12
96;30.07.2014;2014;07;22;Keskiviikko;49;0;49;4;0;4
96;30.07.2014;2014;07;23;Keskiviikko;28;0;28;3;0;3
96;31.07.2014;2014;07;00;Torstai;24;0;24;0;0;0
96;31.07.2014;2014;07;01;Torstai;3;0;3;0;0;0
96;31.07.2014;2014;07;02;Torstai;3;0;3;0;0;0
96;31.07.2014;2014;07;03;Torstai;5;0;5;0;0;0
96;31.07.2014;2014;07;04;Torstai;3;0;3;0;0;0
96;31.07.2014;2014;07;05;Torstai;16;0;16;2;0;2
96;31.07.2014;2014;07;06;Torstai;71;0;71;5;0;5
96;31.07.2014;2014;07;07;Torstai;134;0;134;17;0;17
96;31.07.2014;2014;07;08;Torstai;82;0;82;4;0;4
96;31.07.2014;2014;07;09;Torstai;69;0;69;5;0;5
96;31.07.2014;2014;07;10;Torstai;58;2;60;10;0;10
96;31.07.2014;2014;07;11;Torstai;68;0;68;14;0;14
96;31.07.2014;2014;07;12;Torstai;75;0;75;13;0;13
96;31.07.2014;2014;07;13;Torstai;46;1;47;1;0;1
96;31.07.2014;2014;07;14;Torstai;49;2;51;2;0;2
96;31.07.2014;2014;07;15;Torstai;128;1;129;4;0;4
96;31.07.2014;2014;07;16;Torstai;63;2;65;2;0;2
96;31.07.2014;2014;07;17;Torstai;21;1;22;4;0;4
96;31.07.2014;2014;07;18;Torstai;36;3;39;1;0;1
96;31.07.2014;2014;07;19;Torstai;32;1;33;8;0;8
96;31.07.2014;2014;07;20;Torstai;48;0;48;9;0;9
96;31.07.2014;2014;07;21;Torstai;39;0;39;10;0;10
96;31.07.2014;2014;07;22;Torstai;16;0;16;9;0;9
96;31.07.2014;2014;07;23;Torstai;20;0;20;6;0;6
96;01.08.2014;2014;08;00;Perjantai;11;0;11;0;0;0
96;01.08.2014;2014;08;01;Perjantai;12;0;12;0;0;0
96;01.08.2014;2014;08;02;Perjantai;6;0;6;2;0;2
96;01.08.2014;2014;08;03;Perjantai;6;0;6;0;0;0
96;01.08.2014;2014;08;04;Perjantai;7;0;7;1;0;1
96;01.08.2014;2014;08;05;Perjantai;17;0;17;3;0;3
96;01.08.2014;2014;08;06;Perjantai;76;0;76;6;0;6
96;01.08.2014;2014;08;07;Perjantai;139;0;139;16;0;16
96;01.08.2014;2014;08;08;Perjantai;96;0;96;7;0;7
96;01.08.2014;2014;08;09;Perjantai;106;0;106;16;0;16
96;01.08.2014;2014;08;10;Perjantai;102;0;102;11;0;11
96;01.08.2014;2014;08;11;Perjantai;136;0;136;13;0;13
96;01.08.2014;2014;08;12;Perjantai;135;0;135;20;0;20
96;01.08.2014;2014;08;13;Perjantai;191;0;191;19;0;19
96;01.08.2014;2014;08;14;Perjantai;243;0;243;18;0;18
96;01.08.2014;2014;08;15;Perjantai;243;0;243;36;0;36
96;01.08.2014;2014;08;16;Perjantai;162;0;162;24;0;24
96;01.08.2014;2014;08;17;Perjantai;153;0;153;18;0;18
96;01.08.2014;2014;08;18;Perjantai;156;0;156;25;0;25
96;01.08.2014;2014;08;19;Perjantai;128;0;128;15;0;15
96;01.08.2014;2014;08;20;Perjantai;120;0;120;12;0;12
96;01.08.2014;2014;08;21;Perjantai;95;0;95;26;0;26
96;01.08.2014;2014;08;22;Perjantai;87;0;87;9;0;9
96;01.08.2014;2014;08;23;Perjantai;41;0;41;4;0;4
96;02.08.2014;2014;08;00;Lauantai;33;0;33;4;0;4
96;02.08.2014;2014;08;01;Lauantai;29;0;29;4;0;4
96;02.08.2014;2014;08;02;Lauantai;15;0;15;1;0;1
96;02.08.2014;2014;08;03;Lauantai;13;0;13;0;0;0
96;02.08.2014;2014;08;04;Lauantai;13;0;13;1;0;1
96;02.08.2014;2014;08;05;Lauantai;14;0;14;2;0;2
96;02.08.2014;2014;08;06;Lauantai;39;0;39;5;0;5
96;02.08.2014;2014;08;07;Lauantai;21;0;21;7;0;7
96;02.08.2014;2014;08;08;Lauantai;40;0;40;10;0;10
96;02.08.2014;2014;08;09;Lauantai;79;0;79;18;0;18
96;02.08.2014;2014;08;10;Lauantai;65;0;65;6;0;6
96;02.08.2014;2014;08;11;Lauantai;121;0;121;14;0;14
96;02.08.2014;2014;08;12;Lauantai;137;0;137;22;0;22
96;02.08.2014;2014;08;13;Lauantai;135;0;135;12;0;12
96;02.08.2014;2014;08;14;Lauantai;130;0;130;16;0;16
96;02.08.2014;2014;08;15;Lauantai;152;0;152;17;0;17
96;02.08.2014;2014;08;16;Lauantai;100;0;100;28;0;28
96;02.08.2014;2014;08;17;Lauantai;145;0;145;27;0;27
96;02.08.2014;2014;08;18;Lauantai;117;0;117;37;0;37
96;02.08.2014;2014;08;19;Lauantai;117;0;117;25;0;25
96;02.08.2014;2014;08;20;Lauantai;109;0;109;31;0;31
96;02.08.2014;2014;08;21;Lauantai;129;0;129;24;0;24
96;02.08.2014;2014;08;22;Lauantai;89;0;89;10;0;10
96;02.08.2014;2014;08;23;Lauantai;53;0;53;10;0;10
96;03.08.2014;2014;08;00;Sunnuntai;50;0;50;4;0;4
96;03.08.2014;2014;08;01;Sunnuntai;40;0;40;10;0;10
96;03.08.2014;2014;08;02;Sunnuntai;45;0;45;8;0;8
96;03.08.2014;2014;08;03;Sunnuntai;31;0;31;1;0;1
96;03.08.2014;2014;08;04;Sunnuntai;28;0;28;4;0;4
96;03.08.2014;2014;08;05;Sunnuntai;5;0;5;8;0;8
96;03.08.2014;2014;08;06;Sunnuntai;26;0;26;1;0;1
96;03.08.2014;2014;08;07;Sunnuntai;13;0;13;5;0;5
96;03.08.2014;2014;08;08;Sunnuntai;21;0;21;8;0;8
96;03.08.2014;2014;08;09;Sunnuntai;39;0;39;7;0;7
96;03.08.2014;2014;08;10;Sunnuntai;63;0;63;12;0;12
96;03.08.2014;2014;08;11;Sunnuntai;75;0;75;12;0;12
96;03.08.2014;2014;08;12;Sunnuntai;116;0;116;18;0;18
96;03.08.2014;2014;08;13;Sunnuntai;132;1;133;15;0;15
96;03.08.2014;2014;08;14;Sunnuntai;114;0;114;18;0;18
96;03.08.2014;2014;08;15;Sunnuntai;133;0;133;23;0;23
96;03.08.2014;2014;08;16;Sunnuntai;166;0;166;15;0;15
96;03.08.2014;2014;08;17;Sunnuntai;157;0;157;17;0;17
96;03.08.2014;2014;08;18;Sunnuntai;124;0;124;25;0;25
96;03.08.2014;2014;08;19;Sunnuntai;159;0;159;28;0;28
96;03.08.2014;2014;08;20;Sunnuntai;108;0;108;13;0;13
96;03.08.2014;2014;08;21;Sunnuntai;71;0;71;11;0;11
96;03.08.2014;2014;08;22;Sunnuntai;50;0;50;3;0;3
96;03.08.2014;2014;08;23;Sunnuntai;24;0;24;3;0;3
96;04.08.2014;2014;08;00;Maanantai;11;0;11;0;0;0
96;04.08.2014;2014;08;01;Maanantai;9;0;9;1;0;1
96;04.08.2014;2014;08;02;Maanantai;5;0;5;0;0;0
96;04.08.2014;2014;08;03;Maanantai;9;0;9;2;0;2
96;04.08.2014;2014;08;04;Maanantai;10;0;10;1;0;1
96;04.08.2014;2014;08;05;Maanantai;15;0;15;14;0;14
96;04.08.2014;2014;08;06;Maanantai;102;0;102;8;0;8
96;04.08.2014;2014;08;07;Maanantai;240;0;240;17;0;17
96;04.08.2014;2014;08;08;Maanantai;153;0;153;11;0;11
96;04.08.2014;2014;08;09;Maanantai;127;0;127;11;0;11
96;04.08.2014;2014;08;10;Maanantai;108;1;109;6;0;6
96;04.08.2014;2014;08;11;Maanantai;156;0;156;10;0;10
96;04.08.2014;2014;08;12;Maanantai;168;0;168;16;0;16
96;04.08.2014;2014;08;13;Maanantai;147;0;147;14;0;14
96;04.08.2014;2014;08;14;Maanantai;215;0;215;19;0;19
96;04.08.2014;2014;08;15;Maanantai;320;0;320;38;0;38
96;04.08.2014;2014;08;16;Maanantai;246;0;246;34;0;34
96;04.08.2014;2014;08;17;Maanantai;185;1;186;18;0;18
96;04.08.2014;2014;08;18;Maanantai;175;2;177;13;0;13
96;04.08.2014;2014;08;19;Maanantai;149;0;149;9;0;9
96;04.08.2014;2014;08;20;Maanantai;130;0;130;8;0;8
96;04.08.2014;2014;08;21;Maanantai;126;0;126;16;0;16
96;04.08.2014;2014;08;22;Maanantai;38;0;38;3;0;3
96;04.08.2014;2014;08;23;Maanantai;28;0;28;4;0;4
96;05.08.2014;2014;08;00;Tiistai;16;0;16;1;0;1
96;05.08.2014;2014;08;01;Tiistai;7;0;7;1;0;1
96;05.08.2014;2014;08;02;Tiistai;6;0;6;1;0;1
96;05.08.2014;2014;08;03;Tiistai;0;0;0;0;0;0
96;05.08.2014;2014;08;04;Tiistai;4;0;4;1;0;1
96;05.08.2014;2014;08;05;Tiistai;17;0;17;8;0;8
96;05.08.2014;2014;08;06;Tiistai;138;0;138;6;0;6
96;05.08.2014;2014;08;07;Tiistai;248;0;248;22;0;22
96;05.08.2014;2014;08;08;Tiistai;171;0;171;7;0;7
96;05.08.2014;2014;08;09;Tiistai;139;0;139;15;0;15
96;05.08.2014;2014;08;10;Tiistai;112;0;112;8;0;8
96;05.08.2014;2014;08;11;Tiistai;181;4;185;13;0;13
96;05.08.2014;2014;08;12;Tiistai;143;5;148;15;0;15
96;05.08.2014;2014;08;13;Tiistai;182;2;184;11;0;11
96;05.08.2014;2014;08;14;Tiistai;223;5;228;30;0;30
96;05.08.2014;2014;08;15;Tiistai;348;0;348;33;0;33
96;05.08.2014;2014;08;16;Tiistai;318;0;318;27;0;27
96;05.08.2014;2014;08;17;Tiistai;195;0;195;24;0;24
96;05.08.2014;2014;08;18;Tiistai;173;0;173;23;0;23
96;05.08.2014;2014;08;19;Tiistai;162;1;163;18;0;18
96;05.08.2014;2014;08;20;Tiistai;125;1;126;17;0;17
96;05.08.2014;2014;08;21;Tiistai;119;0;119;19;0;19
96;05.08.2014;2014;08;22;Tiistai;67;0;67;8;0;8
96;05.08.2014;2014;08;23;Tiistai;18;0;18;3;0;3
96;06.08.2014;2014;08;00;Keskiviikko;29;0;29;1;0;1
96;06.08.2014;2014;08;01;Keskiviikko;15;0;15;0;0;0
96;06.08.2014;2014;08;02;Keskiviikko;8;0;8;0;0;0
96;06.08.2014;2014;08;03;Keskiviikko;3;0;3;3;0;3
96;06.08.2014;2014;08;04;Keskiviikko;5;0;5;0;0;0
96;06.08.2014;2014;08;05;Keskiviikko;18;0;18;1;0;1
96;06.08.2014;2014;08;06;Keskiviikko;114;0;114;8;0;8
96;06.08.2014;2014;08;07;Keskiviikko;260;0;260;21;0;21
96;06.08.2014;2014;08;08;Keskiviikko;208;0;208;20;0;20
96;06.08.2014;2014;08;09;Keskiviikko;122;0;122;12;0;12
96;06.08.2014;2014;08;10;Keskiviikko;140;1;141;10;0;10
96;06.08.2014;2014;08;11;Keskiviikko;187;1;188;12;0;12
96;06.08.2014;2014;08;12;Keskiviikko;158;1;159;17;0;17
96;06.08.2014;2014;08;13;Keskiviikko;192;2;194;16;0;16
96;06.08.2014;2014;08;14;Keskiviikko;260;0;260;38;0;38
96;06.08.2014;2014;08;15;Keskiviikko;364;0;364;36;0;36
96;06.08.2014;2014;08;16;Keskiviikko;299;0;299;25;0;25
96;06.08.2014;2014;08;17;Keskiviikko;236;0;236;27;0;27
96;06.08.2014;2014;08;18;Keskiviikko;210;0;210;48;0;48
96;06.08.2014;2014;08;19;Keskiviikko;169;0;169;42;2;44
96;06.08.2014;2014;08;20;Keskiviikko;171;0;171;32;0;32
96;06.08.2014;2014;08;21;Keskiviikko;109;0;109;14;0;14
96;06.08.2014;2014;08;22;Keskiviikko;48;0;48;3;0;3
96;06.08.2014;2014;08;23;Keskiviikko;28;2;30;4;0;4
96;07.08.2014;2014;08;00;Torstai;16;0;16;3;0;3
96;07.08.2014;2014;08;01;Torstai;10;0;10;2;0;2
96;07.08.2014;2014;08;02;Torstai;6;0;6;2;0;2
96;07.08.2014;2014;08;03;Torstai;5;0;5;0;0;0
96;07.08.2014;2014;08;04;Torstai;8;0;8;3;0;3
96;07.08.2014;2014;08;05;Torstai;19;0;19;1;0;1
96;07.08.2014;2014;08;06;Torstai;105;0;105;8;0;8
96;07.08.2014;2014;08;07;Torstai;263;0;263;19;0;19
96;07.08.2014;2014;08;08;Torstai;221;0;221;16;0;16
96;07.08.2014;2014;08;09;Torstai;228;0;228;5;0;5
96;07.08.2014;2014;08;10;Torstai;126;0;126;11;0;11
96;07.08.2014;2014;08;11;Torstai;161;1;162;18;0;18
96;07.08.2014;2014;08;12;Torstai;206;2;208;23;0;23
96;07.08.2014;2014;08;13;Torstai;251;0;251;30;0;30
96;07.08.2014;2014;08;14;Torstai;226;0;226;26;0;26
96;07.08.2014;2014;08;15;Torstai;367;0;367;29;0;29
96;07.08.2014;2014;08;16;Torstai;283;0;283;25;0;25
96;07.08.2014;2014;08;17;Torstai;234;2;236;27;0;27
96;07.08.2014;2014;08;18;Torstai;185;1;186;15;0;15
96;07.08.2014;2014;08;19;Torstai;144;0;144;10;0;10
96;07.08.2014;2014;08;20;Torstai;205;1;206;16;0;16
96;07.08.2014;2014;08;21;Torstai;101;0;101;10;0;10
96;07.08.2014;2014;08;22;Torstai;36;0;36;5;0;5
96;07.08.2014;2014;08;23;Torstai;19;0;19;3;0;3
96;08.08.2014;2014;08;00;Perjantai;12;0;12;0;0;0
96;08.08.2014;2014;08;01;Perjantai;4;0;4;0;0;0
96;08.08.2014;2014;08;02;Perjantai;4;0;4;0;0;0
96;08.08.2014;2014;08;03;Perjantai;3;0;3;1;0;1
96;08.08.2014;2014;08;04;Perjantai;11;0;11;0;0;0
96;08.08.2014;2014;08;05;Perjantai;14;0;14;10;0;10
96;08.08.2014;2014;08;06;Perjantai;80;0;80;6;0;6
96;08.08.2014;2014;08;07;Perjantai;243;0;243;23;0;23
96;08.08.2014;2014;08;08;Perjantai;196;0;196;17;0;17
96;08.08.2014;2014;08;09;Perjantai;156;0;156;24;0;24
96;08.08.2014;2014;08;10;Perjantai;108;0;108;12;0;12
96;08.08.2014;2014;08;11;Perjantai;175;0;175;17;0;17
96;08.08.2014;2014;08;12;Perjantai;195;0;195;21;0;21
96;08.08.2014;2014;08;13;Perjantai;190;0;190;23;0;23
96;08.08.2014;2014;08;14;Perjantai;283;0;283;24;0;24
96;08.08.2014;2014;08;15;Perjantai;268;0;268;40;0;40
96;08.08.2014;2014;08;16;Perjantai;201;0;201;20;0;20
96;08.08.2014;2014;08;17;Perjantai;165;0;165;26;0;26
96;08.08.2014;2014;08;18;Perjantai;162;0;162;28;0;28
96;08.08.2014;2014;08;19;Perjantai;174;0;174;27;0;27
96;08.08.2014;2014;08;20;Perjantai;139;0;139;49;0;49
96;08.08.2014;2014;08;21;Perjantai;127;0;127;50;0;50
96;08.08.2014;2014;08;22;Perjantai;85;0;85;49;0;49
96;08.08.2014;2014;08;23;Perjantai;64;0;64;37;0;37
96;09.08.2014;2014;08;00;Lauantai;49;0;49;20;0;20
96;09.08.2014;2014;08;01;Lauantai;52;0;52;3;0;3
96;09.08.2014;2014;08;02;Lauantai;30;0;30;5;0;5
96;09.08.2014;2014;08;03;Lauantai;23;0;23;5;0;5
96;09.08.2014;2014;08;04;Lauantai;23;0;23;2;0;2
96;09.08.2014;2014;08;05;Lauantai;10;0;10;6;0;6
96;09.08.2014;2014;08;06;Lauantai;31;0;31;4;0;4
96;09.08.2014;2014;08;07;Lauantai;24;0;24;5;0;5
96;09.08.2014;2014;08;08;Lauantai;49;0;49;5;0;5
96;09.08.2014;2014;08;09;Lauantai;67;0;67;7;0;7
96;09.08.2014;2014;08;10;Lauantai;92;0;92;21;0;21
96;09.08.2014;2014;08;11;Lauantai;108;0;108;18;0;18
96;09.08.2014;2014;08;12;Lauantai;131;0;131;10;0;10
96;09.08.2014;2014;08;13;Lauantai;130;0;130;11;0;11
96;09.08.2014;2014;08;14;Lauantai;117;0;117;10;0;10
96;09.08.2014;2014;08;15;Lauantai;141;0;141;26;0;26
96;09.08.2014;2014;08;16;Lauantai;55;0;55;10;0;10
96;09.08.2014;2014;08;17;Lauantai;56;0;56;11;0;11
96;09.08.2014;2014;08;18;Lauantai;40;0;40;12;0;12
96;09.08.2014;2014;08;19;Lauantai;37;0;37;12;0;12
96;09.08.2014;2014;08;20;Lauantai;61;0;61;19;0;19
96;09.08.2014;2014;08;21;Lauantai;26;0;26;24;0;24
96;09.08.2014;2014;08;22;Lauantai;15;0;15;20;0;20
96;09.08.2014;2014;08;23;Lauantai;29;2;31;16;0;16
96;10.08.2014;2014;08;00;Sunnuntai;8;0;8;2;0;2
96;10.08.2014;2014;08;01;Sunnuntai;16;0;16;2;0;2
96;10.08.2014;2014;08;02;Sunnuntai;9;0;9;1;0;1
96;10.08.2014;2014;08;03;Sunnuntai;14;0;14;6;0;6
96;10.08.2014;2014;08;04;Sunnuntai;12;0;12;7;0;7
96;10.08.2014;2014;08;05;Sunnuntai;6;0;6;2;0;2
96;10.08.2014;2014;08;06;Sunnuntai;20;0;20;1;0;1
96;10.08.2014;2014;08;07;Sunnuntai;23;0;23;4;0;4
96;10.08.2014;2014;08;08;Sunnuntai;9;0;9;7;0;7
96;10.08.2014;2014;08;09;Sunnuntai;20;0;20;5;0;5
96;10.08.2014;2014;08;10;Sunnuntai;29;0;29;5;0;5
96;10.08.2014;2014;08;11;Sunnuntai;57;0;57;11;0;11
96;10.08.2014;2014;08;12;Sunnuntai;81;0;81;18;0;18
96;10.08.2014;2014;08;13;Sunnuntai;118;0;118;28;0;28
96;10.08.2014;2014;08;14;Sunnuntai;102;0;102;17;0;17
96;10.08.2014;2014;08;15;Sunnuntai;117;0;117;25;0;25
96;10.08.2014;2014;08;16;Sunnuntai;109;0;109;26;0;26
96;10.08.2014;2014;08;17;Sunnuntai;129;0;129;23;0;23
96;10.08.2014;2014;08;18;Sunnuntai;143;0;143;25;0;25
96;10.08.2014;2014;08;19;Sunnuntai;126;0;126;40;0;40
96;10.08.2014;2014;08;20;Sunnuntai;106;0;106;22;0;22
96;10.08.2014;2014;08;21;Sunnuntai;73;0;73;16;0;16
96;10.08.2014;2014;08;22;Sunnuntai;30;0;30;10;0;10
96;10.08.2014;2014;08;23;Sunnuntai;16;0;16;4;0;4
96;11.08.2014;2014;08;00;Maanantai;11;0;11;2;0;2
96;11.08.2014;2014;08;01;Maanantai;6;0;6;0;0;0
96;11.08.2014;2014;08;02;Maanantai;3;0;3;2;0;2
96;11.08.2014;2014;08;03;Maanantai;7;0;7;0;0;0
96;11.08.2014;2014;08;04;Maanantai;4;0;4;1;0;1
96;11.08.2014;2014;08;05;Maanantai;18;0;18;1;0;1
96;11.08.2014;2014;08;06;Maanantai;106;0;106;6;0;6
96;11.08.2014;2014;08;07;Maanantai;371;0;371;25;0;25
96;11.08.2014;2014;08;08;Maanantai;239;0;239;27;0;27
96;11.08.2014;2014;08;09;Maanantai;200;0;200;15;0;15
96;11.08.2014;2014;08;10;Maanantai;131;0;131;15;0;15
96;11.08.2014;2014;08;11;Maanantai;140;0;140;14;0;14
96;11.08.2014;2014;08;12;Maanantai;197;0;197;34;0;34
96;11.08.2014;2014;08;13;Maanantai;233;0;233;29;0;29
96;11.08.2014;2014;08;14;Maanantai;290;0;290;33;0;33
96;11.08.2014;2014;08;15;Maanantai;415;0;415;44;0;44
96;11.08.2014;2014;08;16;Maanantai;391;0;391;45;0;45
96;11.08.2014;2014;08;17;Maanantai;213;0;213;29;0;29
96;11.08.2014;2014;08;18;Maanantai;243;0;243;31;0;31
96;11.08.2014;2014;08;19;Maanantai;175;0;175;28;0;28
96;11.08.2014;2014;08;20;Maanantai;119;0;119;34;0;34
96;11.08.2014;2014;08;21;Maanantai;89;0;89;17;0;17
96;11.08.2014;2014;08;22;Maanantai;40;0;40;2;0;2
96;11.08.2014;2014;08;23;Maanantai;32;0;32;5;0;5
96;12.08.2014;2014;08;00;Tiistai;9;0;9;2;0;2
96;12.08.2014;2014;08;01;Tiistai;4;0;4;0;0;0
96;12.08.2014;2014;08;02;Tiistai;4;0;4;0;0;0
96;12.08.2014;2014;08;03;Tiistai;3;0;3;0;0;0
96;12.08.2014;2014;08;04;Tiistai;3;0;3;1;0;1
96;12.08.2014;2014;08;05;Tiistai;15;0;15;2;0;2
96;12.08.2014;2014;08;06;Tiistai;94;0;94;6;0;6
96;12.08.2014;2014;08;07;Tiistai;319;0;319;22;0;22
96;12.08.2014;2014;08;08;Tiistai;212;0;212;23;0;23
96;12.08.2014;2014;08;09;Tiistai;136;1;137;24;0;24
96;12.08.2014;2014;08;10;Tiistai;60;2;62;9;0;9
96;12.08.2014;2014;08;11;Tiistai;49;5;54;5;0;5
96;12.08.2014;2014;08;12;Tiistai;88;4;92;9;0;9
96;12.08.2014;2014;08;13;Tiistai;120;0;120;17;0;17
96;12.08.2014;2014;08;14;Tiistai;187;0;187;20;0;20
96;12.08.2014;2014;08;15;Tiistai;344;0;344;22;0;22
96;12.08.2014;2014;08;16;Tiistai;297;0;297;40;0;40
96;12.08.2014;2014;08;17;Tiistai;201;0;201;14;0;14
96;12.08.2014;2014;08;18;Tiistai;140;0;140;24;0;24
96;12.08.2014;2014;08;19;Tiistai;152;0;152;33;0;33
96;12.08.2014;2014;08;20;Tiistai;108;0;108;21;0;21
96;12.08.2014;2014;08;21;Tiistai;59;0;59;29;0;29
96;12.08.2014;2014;08;22;Tiistai;27;0;27;4;0;4
96;12.08.2014;2014;08;23;Tiistai;11;0;11;4;0;4
96;13.08.2014;2014;08;00;Keskiviikko;7;0;7;0;0;0
96;13.08.2014;2014;08;01;Keskiviikko;9;0;9;1;0;1
96;13.08.2014;2014;08;02;Keskiviikko;3;0;3;1;0;1
96;13.08.2014;2014;08;03;Keskiviikko;0;0;0;0;0;0
96;13.08.2014;2014;08;04;Keskiviikko;9;0;9;1;0;1
96;13.08.2014;2014;08;05;Keskiviikko;12;0;12;2;0;2
96;13.08.2014;2014;08;06;Keskiviikko;103;0;103;3;0;3
96;13.08.2014;2014;08;07;Keskiviikko;402;0;402;32;0;32
96;13.08.2014;2014;08;08;Keskiviikko;248;0;248;21;0;21
96;13.08.2014;2014;08;09;Keskiviikko;214;0;214;12;0;12
96;13.08.2014;2014;08;10;Keskiviikko;136;0;136;22;0;22
96;13.08.2014;2014;08;11;Keskiviikko;176;0;176;16;0;16
96;13.08.2014;2014;08;12;Keskiviikko;190;0;190;18;0;18
96;13.08.2014;2014;08;13;Keskiviikko;192;0;192;23;0;23
96;13.08.2014;2014;08;14;Keskiviikko;327;0;327;20;0;20
96;13.08.2014;2014;08;15;Keskiviikko;357;0;357;27;0;27
96;13.08.2014;2014;08;16;Keskiviikko;321;0;321;32;0;32
96;13.08.2014;2014;08;17;Keskiviikko;185;0;185;24;0;24
96;13.08.2014;2014;08;18;Keskiviikko;222;0;222;32;0;32
96;13.08.2014;2014;08;19;Keskiviikko;137;0;137;18;0;18
96;13.08.2014;2014;08;20;Keskiviikko;147;0;147;19;0;19
96;13.08.2014;2014;08;21;Keskiviikko;74;0;74;17;0;17
96;13.08.2014;2014;08;22;Keskiviikko;36;0;36;8;0;8
96;13.08.2014;2014;08;23;Keskiviikko;15;0;15;2;0;2
96;14.08.2014;2014;08;00;Torstai;15;0;15;0;0;0
96;14.08.2014;2014;08;01;Torstai;3;0;3;1;0;1
96;14.08.2014;2014;08;02;Torstai;3;0;3;0;0;0
96;14.08.2014;2014;08;03;Torstai;5;0;5;0;0;0
96;14.08.2014;2014;08;04;Torstai;5;0;5;1;0;1
96;14.08.2014;2014;08;05;Torstai;13;0;13;1;0;1
96;14.08.2014;2014;08;06;Torstai;90;0;90;13;0;13
96;14.08.2014;2014;08;07;Torstai;440;0;440;37;0;37
96;14.08.2014;2014;08;08;Torstai;290;0;290;26;0;26
96;14.08.2014;2014;08;09;Torstai;220;0;220;27;0;27
96;14.08.2014;2014;08;10;Torstai;150;0;150;32;0;32
96;14.08.2014;2014;08;11;Torstai;230;0;230;21;0;21
96;14.08.2014;2014;08;12;Torstai;197;0;197;29;0;29
96;14.08.2014;2014;08;13;Torstai;187;0;187;20;0;20
96;14.08.2014;2014;08;14;Torstai;292;0;292;20;0;20
96;14.08.2014;2014;08;15;Torstai;369;0;369;28;0;28
96;14.08.2014;2014;08;16;Torstai;317;0;317;27;0;27
96;14.08.2014;2014;08;17;Torstai;184;0;184;19;0;19
96;14.08.2014;2014;08;18;Torstai;169;0;169;21;0;21
96;14.08.2014;2014;08;19;Torstai;158;0;158;20;0;20
96;14.08.2014;2014;08;20;Torstai;131;0;131;15;0;15
96;14.08.2014;2014;08;21;Torstai;97;0;97;15;0;15
96;14.08.2014;2014;08;22;Torstai;79;0;79;6;0;6
96;14.08.2014;2014;08;23;Torstai;10;0;10;16;0;16
96;15.08.2014;2014;08;00;Perjantai;12;0;12;14;0;14
96;15.08.2014;2014;08;01;Perjantai;4;0;4;17;0;17
96;15.08.2014;2014;08;02;Perjantai;4;0;4;10;0;10
96;15.08.2014;2014;08;03;Perjantai;3;0;3;11;0;11
96;15.08.2014;2014;08;04;Perjantai;11;0;11;4;0;4
96;15.08.2014;2014;08;05;Perjantai;14;0;14;12;0;12
96;15.08.2014;2014;08;06;Perjantai;80;0;80;20;0;20
96;15.08.2014;2014;08;07;Perjantai;243;0;243;30;0;30
96;15.08.2014;2014;08;08;Perjantai;196;0;196;19;0;19
96;15.08.2014;2014;08;09;Perjantai;156;0;156;18;0;18
96;15.08.2014;2014;08;10;Perjantai;108;0;108;15;0;15
96;15.08.2014;2014;08;11;Perjantai;175;0;175;15;0;15
96;15.08.2014;2014;08;12;Perjantai;195;0;195;17;0;17
96;15.08.2014;2014;08;13;Perjantai;190;0;190;23;0;23
96;15.08.2014;2014;08;14;Perjantai;283;0;283;32;0;32
96;15.08.2014;2014;08;15;Perjantai;268;0;268;30;0;30
96;15.08.2014;2014;08;16;Perjantai;201;0;201;21;0;21
96;15.08.2014;2014;08;17;Perjantai;165;0;165;16;0;16
96;15.08.2014;2014;08;18;Perjantai;162;0;162;34;0;34
96;15.08.2014;2014;08;19;Perjantai;174;0;174;12;0;12
96;15.08.2014;2014;08;20;Perjantai;139;0;139;7;0;7
96;15.08.2014;2014;08;21;Perjantai;127;0;127;6;0;6
96;15.08.2014;2014;08;22;Perjantai;85;0;85;9;0;9
96;15.08.2014;2014;08;23;Perjantai;64;0;64;3;0;3
96;16.08.2014;2014;08;00;Lauantai;49;0;49;2;0;2
96;16.08.2014;2014;08;01;Lauantai;52;0;52;3;0;3
96;16.08.2014;2014;08;02;Lauantai;30;0;30;2;0;2
96;16.08.2014;2014;08;03;Lauantai;23;0;23;2;0;2
96;16.08.2014;2014;08;04;Lauantai;23;0;23;6;0;6
96;16.08.2014;2014;08;05;Lauantai;10;0;10;6;0;6
96;16.08.2014;2014;08;06;Lauantai;51;0;51;17;0;17
96;16.08.2014;2014;08;07;Lauantai;34;0;34;13;0;13
96;16.08.2014;2014;08;08;Lauantai;69;0;69;29;0;29
96;16.08.2014;2014;08;09;Lauantai;127;0;127;24;0;24
96;16.08.2014;2014;08;10;Lauantai;172;0;172;24;0;24
96;16.08.2014;2014;08;11;Lauantai;208;0;208;23;0;23
96;16.08.2014;2014;08;12;Lauantai;231;0;231;45;0;45
96;16.08.2014;2014;08;13;Lauantai;280;0;280;20;0;20
96;16.08.2014;2014;08;14;Lauantai;267;0;267;19;0;19
96;16.08.2014;2014;08;15;Lauantai;261;0;261;16;0;16
96;16.08.2014;2014;08;16;Lauantai;135;0;135;16;0;16
96;16.08.2014;2014;08;17;Lauantai;146;0;146;19;0;19
96;16.08.2014;2014;08;18;Lauantai;179;0;179;19;0;19
96;16.08.2014;2014;08;19;Lauantai;67;0;67;3;0;3
96;16.08.2014;2014;08;20;Lauantai;71;0;71;5;0;5
96;16.08.2014;2014;08;21;Lauantai;36;0;36;4;0;4
96;16.08.2014;2014;08;22;Lauantai;15;0;15;2;0;2
96;16.08.2014;2014;08;23;Lauantai;29;2;31;4;0;4
96;17.08.2014;2014;08;00;Sunnuntai;20;0;20;3;0;3
96;17.08.2014;2014;08;01;Sunnuntai;22;0;22;0;0;0
96;17.08.2014;2014;08;02;Sunnuntai;20;0;20;1;0;1
96;17.08.2014;2014;08;03;Sunnuntai;30;0;30;5;0;5
96;17.08.2014;2014;08;04;Sunnuntai;12;0;12;2;0;2
96;17.08.2014;2014;08;05;Sunnuntai;3;0;3;1;0;1
96;17.08.2014;2014;08;06;Sunnuntai;21;0;21;2;0;2
96;17.08.2014;2014;08;07;Sunnuntai;12;0;12;6;0;6
96;17.08.2014;2014;08;08;Sunnuntai;13;0;13;1;0;1
96;17.08.2014;2014;08;09;Sunnuntai;26;0;26;6;0;6
96;17.08.2014;2014;08;10;Sunnuntai;46;0;46;9;0;9
96;17.08.2014;2014;08;11;Sunnuntai;87;0;87;16;0;16
96;17.08.2014;2014;08;12;Sunnuntai;133;0;133;22;0;22
96;17.08.2014;2014;08;13;Sunnuntai;132;0;132;15;0;15
96;17.08.2014;2014;08;14;Sunnuntai;111;0;111;16;0;16
96;17.08.2014;2014;08;15;Sunnuntai;130;0;130;21;0;21
96;17.08.2014;2014;08;16;Sunnuntai;110;0;110;21;0;21
96;17.08.2014;2014;08;17;Sunnuntai;108;0;108;33;0;33
96;17.08.2014;2014;08;18;Sunnuntai;93;0;93;26;0;26
96;17.08.2014;2014;08;19;Sunnuntai;101;0;101;42;0;42
96;17.08.2014;2014;08;20;Sunnuntai;115;0;115;19;0;19
96;17.08.2014;2014;08;21;Sunnuntai;58;0;58;15;0;15
96;17.08.2014;2014;08;22;Sunnuntai;20;0;20;20;0;20
96;17.08.2014;2014;08;23;Sunnuntai;0;0;0;15;0;15
96;18.08.2014;2014;08;00;Maanantai;9;0;9;0;0;0
96;18.08.2014;2014;08;01;Maanantai;4;0;4;0;0;0
96;18.08.2014;2014;08;02;Maanantai;0;0;0;0;0;0
96;18.08.2014;2014;08;03;Maanantai;3;0;3;0;0;0
96;18.08.2014;2014;08;04;Maanantai;10;0;10;0;0;0
96;18.08.2014;2014;08;05;Maanantai;14;0;14;0;0;0
96;18.08.2014;2014;08;06;Maanantai;101;0;101;0;0;0
96;18.08.2014;2014;08;07;Maanantai;375;0;375;0;0;0
96;18.08.2014;2014;08;08;Maanantai;255;0;255;0;0;0
96;18.08.2014;2014;08;09;Maanantai;196;0;196;0;0;0
96;18.08.2014;2014;08;10;Maanantai;159;0;159;0;0;0
96;18.08.2014;2014;08;11;Maanantai;152;0;152;0;0;0
96;18.08.2014;2014;08;12;Maanantai;172;0;172;0;0;0
96;18.08.2014;2014;08;13;Maanantai;198;0;198;0;0;0
96;18.08.2014;2014;08;14;Maanantai;288;0;288;0;0;0
96;18.08.2014;2014;08;15;Maanantai;425;0;425;0;0;0
96;18.08.2014;2014;08;16;Maanantai;334;0;334;0;0;0
96;18.08.2014;2014;08;17;Maanantai;90;0;90;0;0;0
96;18.08.2014;2014;08;18;Maanantai;116;0;116;0;0;0
96;18.08.2014;2014;08;19;Maanantai;80;0;80;0;0;0
96;18.08.2014;2014;08;20;Maanantai;70;0;70;0;0;0
96;18.08.2014;2014;08;21;Maanantai;51;0;51;0;0;0
96;18.08.2014;2014;08;22;Maanantai;20;0;20;0;0;0
96;18.08.2014;2014;08;23;Maanantai;9;0;9;0;0;0
96;19.08.2014;2014;08;00;Tiistai;4;0;4;0;0;0
96;19.08.2014;2014;08;01;Tiistai;3;0;3;0;0;0
96;19.08.2014;2014;08;02;Tiistai;1;0;1;0;0;0
96;19.08.2014;2014;08;03;Tiistai;2;0;2;0;0;0
96;19.08.2014;2014;08;04;Tiistai;5;0;5;0;0;0
96;19.08.2014;2014;08;05;Tiistai;15;0;15;0;0;0
96;19.08.2014;2014;08;06;Tiistai;90;0;90;0;0;0
96;19.08.2014;2014;08;07;Tiistai;385;0;385;0;0;0
96;19.08.2014;2014;08;08;Tiistai;211;0;211;0;0;0
96;19.08.2014;2014;08;09;Tiistai;213;0;213;0;0;0
96;19.08.2014;2014;08;10;Tiistai;114;0;114;0;0;0
96;19.08.2014;2014;08;11;Tiistai;153;0;153;0;0;0
96;19.08.2014;2014;08;12;Tiistai;157;0;157;0;0;0
96;19.08.2014;2014;08;13;Tiistai;184;0;184;0;0;0
96;19.08.2014;2014;08;14;Tiistai;248;0;248;0;0;0
96;19.08.2014;2014;08;15;Tiistai;421;0;421;0;0;0
96;19.08.2014;2014;08;16;Tiistai;360;0;360;0;0;0
96;19.08.2014;2014;08;17;Tiistai;246;0;246;0;0;0
96;19.08.2014;2014;08;18;Tiistai;154;0;154;0;0;0
96;19.08.2014;2014;08;19;Tiistai;212;0;212;0;0;0
96;19.08.2014;2014;08;20;Tiistai;131;0;131;0;0;0
96;19.08.2014;2014;08;21;Tiistai;81;0;81;0;0;0
96;19.08.2014;2014;08;22;Tiistai;21;0;21;0;0;0
96;19.08.2014;2014;08;23;Tiistai;12;0;12;0;0;0
96;20.08.2014;2014;08;00;Keskiviikko;2;0;2;0;0;0
96;20.08.2014;2014;08;01;Keskiviikko;2;0;2;0;0;0
96;20.08.2014;2014;08;02;Keskiviikko;3;0;3;0;0;0
96;20.08.2014;2014;08;03;Keskiviikko;1;0;1;0;0;0
96;20.08.2014;2014;08;04;Keskiviikko;7;0;7;0;0;0
96;20.08.2014;2014;08;05;Keskiviikko;13;0;13;0;0;0
96;20.08.2014;2014;08;06;Keskiviikko;94;0;94;0;0;0
96;20.08.2014;2014;08;07;Keskiviikko;374;0;374;0;0;0
96;20.08.2014;2014;08;08;Keskiviikko;262;0;262;0;0;0
96;20.08.2014;2014;08;09;Keskiviikko;251;0;251;0;0;0
96;20.08.2014;2014;08;10;Keskiviikko;127;0;127;0;0;0
96;20.08.2014;2014;08;11;Keskiviikko;157;0;157;0;0;0
96;20.08.2014;2014;08;12;Keskiviikko;192;0;192;0;0;0
96;20.08.2014;2014;08;13;Keskiviikko;217;0;217;0;0;0
96;20.08.2014;2014;08;14;Keskiviikko;319;0;319;0;0;0
96;20.08.2014;2014;08;15;Keskiviikko;360;0;360;0;0;0
96;20.08.2014;2014;08;16;Keskiviikko;369;0;369;0;0;0
96;20.08.2014;2014;08;17;Keskiviikko;180;0;180;0;0;0
96;20.08.2014;2014;08;18;Keskiviikko;188;0;188;0;0;0
96;20.08.2014;2014;08;19;Keskiviikko;131;0;131;0;0;0
96;20.08.2014;2014;08;20;Keskiviikko;132;0;132;0;0;0
96;20.08.2014;2014;08;21;Keskiviikko;88;0;88;0;0;0
96;20.08.2014;2014;08;22;Keskiviikko;18;0;18;0;0;0
96;20.08.2014;2014;08;23;Keskiviikko;17;0;17;0;0;0
96;21.08.2014;2014;08;00;Torstai;3;0;3;0;0;0
96;21.08.2014;2014;08;01;Torstai;2;0;2;0;0;0
96;21.08.2014;2014;08;02;Torstai;6;0;6;0;0;0
96;21.08.2014;2014;08;03;Torstai;4;0;4;0;0;0
96;21.08.2014;2014;08;04;Torstai;2;0;2;0;0;0
96;21.08.2014;2014;08;05;Torstai;13;0;13;0;0;0
96;21.08.2014;2014;08;06;Torstai;95;0;95;0;0;0
96;21.08.2014;2014;08;07;Torstai;344;0;344;0;0;0
96;21.08.2014;2014;08;08;Torstai;234;0;234;0;0;0
96;21.08.2014;2014;08;09;Torstai;199;0;199;0;0;0
96;21.08.2014;2014;08;10;Torstai;124;0;124;0;0;0
96;21.08.2014;2014;08;11;Torstai;158;0;158;0;0;0
96;21.08.2014;2014;08;12;Torstai;151;0;151;0;0;0
96;21.08.2014;2014;08;13;Torstai;204;0;204;0;0;0
96;21.08.2014;2014;08;14;Torstai;338;0;338;0;0;0
96;21.08.2014;2014;08;15;Torstai;411;0;411;0;0;0
96;21.08.2014;2014;08;16;Torstai;357;0;357;0;0;0
96;21.08.2014;2014;08;17;Torstai;142;0;142;0;0;0
96;21.08.2014;2014;08;18;Torstai;136;0;136;0;0;0
96;21.08.2014;2014;08;19;Torstai;152;0;152;0;0;0
96;21.08.2014;2014;08;20;Torstai;115;0;115;0;0;0
96;21.08.2014;2014;08;21;Torstai;97;0;97;0;0;0
96;21.08.2014;2014;08;22;Torstai;46;0;46;0;0;0
96;21.08.2014;2014;08;23;Torstai;19;0;19;0;0;0
96;22.08.2014;2014;08;00;Perjantai;13;0;13;0;0;0
96;22.08.2014;2014;08;01;Perjantai;8;0;8;0;0;0
96;22.08.2014;2014;08;02;Perjantai;1;0;1;0;0;0
96;22.08.2014;2014;08;03;Perjantai;7;0;7;0;0;0
96;22.08.2014;2014;08;04;Perjantai;6;0;6;0;0;0
96;22.08.2014;2014;08;05;Perjantai;14;0;14;0;0;0
96;22.08.2014;2014;08;06;Perjantai;90;0;90;0;0;0
96;22.08.2014;2014;08;07;Perjantai;308;0;308;0;0;0
96;22.08.2014;2014;08;08;Perjantai;209;0;209;0;0;0
96;22.08.2014;2014;08;09;Perjantai;187;0;187;0;0;0
96;22.08.2014;2014;08;10;Perjantai;130;0;130;0;0;0
96;22.08.2014;2014;08;11;Perjantai;157;0;157;0;0;0
96;22.08.2014;2014;08;12;Perjantai;193;0;193;0;0;0
96;22.08.2014;2014;08;13;Perjantai;238;0;238;0;0;0
96;22.08.2014;2014;08;14;Perjantai;293;0;293;0;0;0
96;22.08.2014;2014;08;15;Perjantai;296;0;296;0;0;0
96;22.08.2014;2014;08;16;Perjantai;183;0;183;0;0;0
96;22.08.2014;2014;08;17;Perjantai;138;0;138;0;0;0
96;22.08.2014;2014;08;18;Perjantai;129;0;129;0;0;0
96;22.08.2014;2014;08;19;Perjantai;106;0;106;0;0;0
96;22.08.2014;2014;08;20;Perjantai;89;0;89;0;0;0
96;22.08.2014;2014;08;21;Perjantai;69;0;69;0;0;0
96;22.08.2014;2014;08;22;Perjantai;53;0;53;0;0;0
96;22.08.2014;2014;08;23;Perjantai;30;0;30;0;0;0
96;23.08.2014;2014;08;00;Lauantai;18;0;18;0;0;0
96;23.08.2014;2014;08;01;Lauantai;20;0;20;0;0;0
96;23.08.2014;2014;08;02;Lauantai;9;0;9;0;0;0
96;23.08.2014;2014;08;03;Lauantai;16;0;16;0;0;0
96;23.08.2014;2014;08;04;Lauantai;19;0;19;0;0;0
96;23.08.2014;2014;08;05;Lauantai;13;0;13;0;0;0
96;23.08.2014;2014;08;06;Lauantai;28;0;28;0;0;0
96;23.08.2014;2014;08;07;Lauantai;35;0;35;0;0;0
96;23.08.2014;2014;08;08;Lauantai;35;0;35;0;0;0
96;23.08.2014;2014;08;09;Lauantai;73;0;73;0;0;0
96;23.08.2014;2014;08;10;Lauantai;92;0;92;0;0;0
96;23.08.2014;2014;08;11;Lauantai;100;0;100;0;0;0
96;23.08.2014;2014;08;12;Lauantai;141;0;141;0;0;0
96;23.08.2014;2014;08;13;Lauantai;130;0;130;0;0;0
96;23.08.2014;2014;08;14;Lauantai;126;0;126;0;0;0
96;23.08.2014;2014;08;15;Lauantai;124;0;124;0;0;0
96;23.08.2014;2014;08;16;Lauantai;110;0;110;0;0;0
96;23.08.2014;2014;08;17;Lauantai;82;0;82;0;0;0
96;23.08.2014;2014;08;18;Lauantai;83;0;83;0;0;0
96;23.08.2014;2014;08;19;Lauantai;80;0;80;0;0;0
96;23.08.2014;2014;08;20;Lauantai;82;0;82;0;0;0
96;23.08.2014;2014;08;21;Lauantai;40;0;40;0;0;0
96;23.08.2014;2014;08;22;Lauantai;44;0;44;0;0;0
96;23.08.2014;2014;08;23;Lauantai;32;0;32;0;0;0
96;24.08.2014;2014;08;00;Sunnuntai;15;0;15;0;0;0
96;24.08.2014;2014;08;01;Sunnuntai;21;0;21;0;0;0
96;24.08.2014;2014;08;02;Sunnuntai;18;0;18;0;0;0
96;24.08.2014;2014;08;03;Sunnuntai;10;0;10;0;0;0
96;24.08.2014;2014;08;04;Sunnuntai;20;0;20;0;0;0
96;24.08.2014;2014;08;05;Sunnuntai;11;0;11;0;0;0
96;24.08.2014;2014;08;06;Sunnuntai;24;0;24;0;0;0
96;24.08.2014;2014;08;07;Sunnuntai;22;0;22;0;0;0
96;24.08.2014;2014;08;08;Sunnuntai;11;0;11;0;0;0
96;24.08.2014;2014;08;09;Sunnuntai;33;0;33;0;0;0
96;24.08.2014;2014;08;10;Sunnuntai;54;0;54;0;0;0
96;24.08.2014;2014;08;11;Sunnuntai;84;0;84;0;0;0
96;24.08.2014;2014;08;12;Sunnuntai;110;0;110;0;0;0
96;24.08.2014;2014;08;13;Sunnuntai;115;0;115;0;0;0
96;24.08.2014;2014;08;14;Sunnuntai;111;0;111;0;0;0
96;24.08.2014;2014;08;15;Sunnuntai;107;0;107;0;0;0
96;24.08.2014;2014;08;16;Sunnuntai;116;0;116;0;0;0
96;24.08.2014;2014;08;17;Sunnuntai;129;0;129;0;0;0
96;24.08.2014;2014;08;18;Sunnuntai;109;0;109;0;0;0
96;24.08.2014;2014;08;19;Sunnuntai;95;0;95;0;0;0
96;24.08.2014;2014;08;20;Sunnuntai;78;0;78;0;0;0
96;24.08.2014;2014;08;21;Sunnuntai;39;0;39;0;0;0
96;24.08.2014;2014;08;22;Sunnuntai;23;0;23;0;0;0
96;24.08.2014;2014;08;23;Sunnuntai;16;0;16;0;0;0
96;25.08.2014;2014;08;00;Maanantai;5;0;5;0;0;0
96;25.08.2014;2014;08;01;Maanantai;4;0;4;0;0;0
96;25.08.2014;2014;08;02;Maanantai;1;0;1;0;0;0
96;25.08.2014;2014;08;03;Maanantai;2;0;2;0;0;0
96;25.08.2014;2014;08;04;Maanantai;4;0;4;0;0;0
96;25.08.2014;2014;08;05;Maanantai;11;0;11;4;0;4
96;25.08.2014;2014;08;06;Maanantai;70;0;70;18;0;18
96;25.08.2014;2014;08;07;Maanantai;370;0;370;38;0;38
96;25.08.2014;2014;08;08;Maanantai;260;0;260;35;0;35
96;25.08.2014;2014;08;09;Maanantai;320;0;320;22;0;22
96;25.08.2014;2014;08;10;Maanantai;190;0;190;24;0;24
96;25.08.2014;2014;08;11;Maanantai;230;0;230;34;0;34
96;25.08.2014;2014;08;12;Maanantai;200;0;200;35;0;35
96;25.08.2014;2014;08;13;Maanantai;230;0;230;34;0;34
96;25.08.2014;2014;08;14;Maanantai;260;0;260;33;0;33
96;25.08.2014;2014;08;15;Maanantai;390;0;390;40;0;40
96;25.08.2014;2014;08;16;Maanantai;330;0;330;35;0;35
96;25.08.2014;2014;08;17;Maanantai;170;0;170;21;0;21
96;25.08.2014;2014;08;18;Maanantai;180;0;180;15;0;15
96;25.08.2014;2014;08;19;Maanantai;120;0;120;16;0;16
96;25.08.2014;2014;08;20;Maanantai;120;0;120;15;0;15
96;25.08.2014;2014;08;21;Maanantai;71;0;71;10;0;10
96;25.08.2014;2014;08;22;Maanantai;26;0;26;6;0;6
96;25.08.2014;2014;08;23;Maanantai;10;0;10;1;0;1
96;26.08.2014;2014;08;00;Tiistai;2;1;3;0;0;0
96;26.08.2014;2014;08;01;Tiistai;2;1;3;0;0;0
96;26.08.2014;2014;08;02;Tiistai;1;1;2;0;0;0
96;26.08.2014;2014;08;03;Tiistai;2;1;3;0;0;0
96;26.08.2014;2014;08;04;Tiistai;1;0;1;0;0;0
96;26.08.2014;2014;08;05;Tiistai;5;6;11;1;0;1
96;26.08.2014;2014;08;06;Tiistai;45;45;90;10;6;16
96;26.08.2014;2014;08;07;Tiistai;180;180;360;20;19;39
96;26.08.2014;2014;08;08;Tiistai;84;84;168;26;5;31
96;26.08.2014;2014;08;09;Tiistai;151;160;311;26;27;53
96;26.08.2014;2014;08;10;Tiistai;49;96;145;22;32;54
96;26.08.2014;2014;08;11;Tiistai;101;129;230;14;11;25
96;26.08.2014;2014;08;12;Tiistai;95;127;222;13;11;24
96;26.08.2014;2014;08;13;Tiistai;105;82;187;4;6;10
96;26.08.2014;2014;08;14;Tiistai;104;149;253;8;16;24
96;26.08.2014;2014;08;15;Tiistai;123;255;378;9;29;38
96;26.08.2014;2014;08;16;Tiistai;118;183;301;12;16;28
96;26.08.2014;2014;08;17;Tiistai;76;68;144;8;7;15
96;26.08.2014;2014;08;18;Tiistai;67;56;123;10;11;21
96;26.08.2014;2014;08;19;Tiistai;42;50;92;9;13;22
96;26.08.2014;2014;08;20;Tiistai;52;38;90;7;7;14
96;26.08.2014;2014;08;21;Tiistai;32;32;64;4;7;11
96;26.08.2014;2014;08;22;Tiistai;17;7;24;3;2;5
96;26.08.2014;2014;08;23;Tiistai;7;3;10;0;0;0
96;27.08.2014;2014;08;00;Keskiviikko;3;2;5;1;0;1
96;27.08.2014;2014;08;01;Keskiviikko;3;0;3;0;1;1
96;27.08.2014;2014;08;02;Keskiviikko;4;0;4;0;0;0
96;27.08.2014;2014;08;03;Keskiviikko;0;2;2;1;0;1
96;27.08.2014;2014;08;04;Keskiviikko;4;1;5;1;1;2
96;27.08.2014;2014;08;05;Keskiviikko;5;10;15;0;1;1
96;27.08.2014;2014;08;06;Keskiviikko;35;34;69;5;1;6
96;27.08.2014;2014;08;07;Keskiviikko;189;234;423;20;3;23
96;27.08.2014;2014;08;08;Keskiviikko;97;106;203;10;6;16
96;27.08.2014;2014;08;09;Keskiviikko;159;126;285;10;18;28
96;27.08.2014;2014;08;10;Keskiviikko;43;50;93;6;20;26
96;27.08.2014;2014;08;11;Keskiviikko;96;104;200;10;8;18
96;27.08.2014;2014;08;12;Keskiviikko;78;96;174;15;11;26
96;27.08.2014;2014;08;13;Keskiviikko;108;115;223;10;14;24
96;27.08.2014;2014;08;14;Keskiviikko;85;178;263;11;25;36
96;27.08.2014;2014;08;15;Keskiviikko;87;238;325;6;14;20
96;27.08.2014;2014;08;16;Keskiviikko;107;159;266;9;14;23
96;27.08.2014;2014;08;17;Keskiviikko;60;64;124;8;9;17
96;27.08.2014;2014;08;18;Keskiviikko;72;48;120;8;16;24
96;27.08.2014;2014;08;19;Keskiviikko;58;37;95;7;4;11
96;27.08.2014;2014;08;20;Keskiviikko;38;45;83;10;9;19
96;27.08.2014;2014;08;21;Keskiviikko;25;42;67;3;8;11
96;27.08.2014;2014;08;22;Keskiviikko;19;18;37;3;1;4
96;27.08.2014;2014;08;23;Keskiviikko;5;7;12;1;1;2
96;28.08.2014;2014;08;00;Torstai;2;1;3;0;1;1
96;28.08.2014;2014;08;01;Torstai;6;1;7;0;0;0
96;28.08.2014;2014;08;02;Torstai;13;2;15;1;0;1
96;28.08.2014;2014;08;03;Torstai;15;1;16;0;0;0
96;28.08.2014;2014;08;04;Torstai;8;3;11;0;0;0
96;28.08.2014;2014;08;05;Torstai;11;9;20;1;1;2
96;28.08.2014;2014;08;06;Torstai;40;40;80;5;1;6
96;28.08.2014;2014;08;07;Torstai;173;226;399;11;4;15
96;28.08.2014;2014;08;08;Torstai;95;136;231;13;6;19
96;28.08.2014;2014;08;09;Torstai;150;144;294;19;8;27
96;28.08.2014;2014;08;10;Torstai;72;84;156;13;34;47
96;28.08.2014;2014;08;11;Torstai;89;134;223;7;5;12
96;28.08.2014;2014;08;12;Torstai;95;95;190;19;17;36
96;28.08.2014;2014;08;13;Torstai;110;130;240;10;7;17
96;28.08.2014;2014;08;14;Torstai;85;166;251;6;24;30
96;28.08.2014;2014;08;15;Torstai;96;205;301;5;18;23
96;28.08.2014;2014;08;16;Torstai;96;154;250;7;22;29
96;28.08.2014;2014;08;17;Torstai;90;79;169;5;3;8
96;28.08.2014;2014;08;18;Torstai;54;89;143;10;5;15
96;28.08.2014;2014;08;19;Torstai;63;46;109;16;11;27
96;28.08.2014;2014;08;20;Torstai;38;48;86;9;8;17
96;28.08.2014;2014;08;21;Torstai;34;41;75;3;4;7
96;28.08.2014;2014;08;22;Torstai;11;9;20;3;2;5
96;28.08.2014;2014;08;23;Torstai;7;2;9;2;2;4
96;29.08.2014;2014;08;00;Perjantai;1;2;3;0;0;0
96;29.08.2014;2014;08;01;Perjantai;2;1;3;0;2;2
96;29.08.2014;2014;08;02;Perjantai;3;2;5;1;1;2
96;29.08.2014;2014;08;03;Perjantai;0;1;1;1;0;1
96;29.08.2014;2014;08;04;Perjantai;0;2;2;0;0;0
96;29.08.2014;2014;08;05;Perjantai;4;7;11;0;0;0
96;29.08.2014;2014;08;06;Perjantai;55;40;95;3;5;8
96;29.08.2014;2014;08;07;Perjantai;153;176;329;10;8;18
96;29.08.2014;2014;08;08;Perjantai;145;103;248;9;4;13
96;29.08.2014;2014;08;09;Perjantai;142;166;308;15;7;22
96;29.08.2014;2014;08;10;Perjantai;51;108;159;16;25;41
96;29.08.2014;2014;08;11;Perjantai;115;152;267;10;10;20
96;29.08.2014;2014;08;12;Perjantai;82;130;212;12;12;24
96;29.08.2014;2014;08;13;Perjantai;125;156;281;11;15;26
96;29.08.2014;2014;08;14;Perjantai;95;207;302;9;19;28
96;29.08.2014;2014;08;15;Perjantai;116;204;320;8;17;25
96;29.08.2014;2014;08;16;Perjantai;83;93;176;2;15;17
96;29.08.2014;2014;08;17;Perjantai;51;59;110;9;7;16
96;29.08.2014;2014;08;18;Perjantai;45;69;114;8;5;13
96;29.08.2014;2014;08;19;Perjantai;49;56;105;5;8;13
96;29.08.2014;2014;08;20;Perjantai;41;42;83;8;2;10
96;29.08.2014;2014;08;21;Perjantai;36;40;76;3;1;4
96;29.08.2014;2014;08;22;Perjantai;28;12;40;2;1;3
96;29.08.2014;2014;08;23;Perjantai;22;7;29;1;0;1
96;30.08.2014;2014;08;00;Lauantai;11;2;13;0;0;0
96;30.08.2014;2014;08;01;Lauantai;9;6;15;2;1;3
96;30.08.2014;2014;08;02;Lauantai;12;3;15;1;0;1
96;30.08.2014;2014;08;03;Lauantai;6;2;8;0;0;0
96;30.08.2014;2014;08;04;Lauantai;4;2;6;3;1;4
96;30.08.2014;2014;08;05;Lauantai;2;0;2;2;0;2
96;30.08.2014;2014;08;06;Lauantai;18;10;28;3;1;4
96;30.08.2014;2014;08;07;Lauantai;2;26;28;1;1;2
96;30.08.2014;2014;08;08;Lauantai;7;23;30;5;3;8
96;30.08.2014;2014;08;09;Lauantai;16;51;67;1;4;5
96;30.08.2014;2014;08;10;Lauantai;26;49;75;9;8;17
96;30.08.2014;2014;08;11;Lauantai;25;49;74;4;3;7
96;30.08.2014;2014;08;12;Lauantai;46;69;115;2;6;8
96;30.08.2014;2014;08;13;Lauantai;48;60;108;4;8;12
96;30.08.2014;2014;08;14;Lauantai;57;45;102;2;7;9
96;30.08.2014;2014;08;15;Lauantai;67;64;131;10;6;16
96;30.08.2014;2014;08;16;Lauantai;52;40;92;6;12;18
96;30.08.2014;2014;08;17;Lauantai;48;36;84;17;6;23
96;30.08.2014;2014;08;18;Lauantai;44;32;76;14;8;22
96;30.08.2014;2014;08;19;Lauantai;25;40;65;10;11;21
96;30.08.2014;2014;08;20;Lauantai;25;25;50;10;13;23
96;30.08.2014;2014;08;21;Lauantai;19;30;49;3;6;9
96;30.08.2014;2014;08;22;Lauantai;16;13;29;1;2;3
96;30.08.2014;2014;08;23;Lauantai;12;20;32;2;0;2
96;31.08.2014;2014;08;00;Sunnuntai;15;18;33;1;2;3
96;31.08.2014;2014;08;01;Sunnuntai;8;5;13;1;0;1
96;31.08.2014;2014;08;02;Sunnuntai;17;2;19;1;0;1
96;31.08.2014;2014;08;03;Sunnuntai;25;1;26;2;0;2
96;31.08.2014;2014;08;04;Sunnuntai;4;5;9;2;2;4
96;31.08.2014;2014;08;05;Sunnuntai;7;1;8;1;1;2
96;31.08.2014;2014;08;06;Sunnuntai;17;5;22;2;2;4
96;31.08.2014;2014;08;07;Sunnuntai;4;14;18;0;1;1
96;31.08.2014;2014;08;08;Sunnuntai;7;6;13;3;1;4
96;31.08.2014;2014;08;09;Sunnuntai;5;13;18;1;6;7
96;31.08.2014;2014;08;10;Sunnuntai;23;31;54;6;7;13
96;31.08.2014;2014;08;11;Sunnuntai;33;39;72;8;9;17
96;31.08.2014;2014;08;12;Sunnuntai;41;51;92;18;9;27
96;31.08.2014;2014;08;13;Sunnuntai;47;68;115;5;4;9
96;31.08.2014;2014;08;14;Sunnuntai;42;62;104;11;10;21
96;31.08.2014;2014;08;15;Sunnuntai;50;53;103;7;12;19
96;31.08.2014;2014;08;16;Sunnuntai;59;41;100;20;6;26
96;31.08.2014;2014;08;17;Sunnuntai;43;40;83;13;11;24
96;31.08.2014;2014;08;18;Sunnuntai;55;51;106;13;11;24
96;31.08.2014;2014;08;19;Sunnuntai;45;40;85;9;21;30
96;31.08.2014;2014;08;20;Sunnuntai;19;39;58;12;11;23
96;31.08.2014;2014;08;21;Sunnuntai;18;29;47;4;7;11
96;31.08.2014;2014;08;22;Sunnuntai;14;6;20;2;2;4
96;31.08.2014;2014;08;23;Sunnuntai;5;7;12;1;0;1
96;01.09.2014;2014;09;00;Maanantai;3;0;3;2;2;4
96;01.09.2014;2014;09;01;Maanantai;2;4;6;0;0;0
96;01.09.2014;2014;09;02;Maanantai;0;1;1;0;0;0
96;01.09.2014;2014;09;03;Maanantai;0;0;0;0;0;0
96;01.09.2014;2014;09;04;Maanantai;1;2;3;2;2;4
96;01.09.2014;2014;09;05;Maanantai;4;4;8;0;0;0
96;01.09.2014;2014;09;06;Maanantai;53;48;101;5;2;7
96;01.09.2014;2014;09;07;Maanantai;185;188;373;13;5;18
96;01.09.2014;2014;09;08;Maanantai;159;138;297;10;10;20
96;01.09.2014;2014;09;09;Maanantai;125;127;252;11;12;23
96;01.09.2014;2014;09;10;Maanantai;85;86;171;16;9;25
96;01.09.2014;2014;09;11;Maanantai;69;96;165;8;4;12
96;01.09.2014;2014;09;12;Maanantai;91;96;187;10;6;16
96;01.09.2014;2014;09;13;Maanantai;82;132;214;7;16;23
96;01.09.2014;2014;09;14;Maanantai;106;203;309;9;15;24
96;01.09.2014;2014;09;15;Maanantai;114;278;392;7;23;30
96;01.09.2014;2014;09;16;Maanantai;163;212;375;11;20;31
96;01.09.2014;2014;09;17;Maanantai;89;96;185;10;6;16
96;01.09.2014;2014;09;18;Maanantai;61;76;137;13;9;22
96;01.09.2014;2014;09;19;Maanantai;72;54;126;10;18;28
96;01.09.2014;2014;09;20;Maanantai;69;50;119;15;11;26
96;01.09.2014;2014;09;21;Maanantai;30;32;62;10;9;19
96;01.09.2014;2014;09;22;Maanantai;12;8;20;0;3;3
96;01.09.2014;2014;09;23;Maanantai;3;6;9;1;2;3
96;02.09.2014;2014;09;00;Tiistai;3;1;4;1;0;1
96;02.09.2014;2014;09;01;Tiistai;0;2;2;0;0;0
96;02.09.2014;2014;09;02;Tiistai;0;0;0;0;0;0
96;02.09.2014;2014;09;03;Tiistai;1;0;1;0;1;1
96;02.09.2014;2014;09;04;Tiistai;0;3;3;0;1;1
96;02.09.2014;2014;09;05;Tiistai;5;12;17;0;1;1
96;02.09.2014;2014;09;06;Tiistai;43;49;92;5;3;8
96;02.09.2014;2014;09;07;Tiistai;196;209;405;15;5;20
96;02.09.2014;2014;09;08;Tiistai;146;133;279;17;7;24
96;02.09.2014;2014;09;09;Tiistai;107;117;224;15;12;27
96;02.09.2014;2014;09;10;Tiistai;74;71;145;18;6;24
96;02.09.2014;2014;09;11;Tiistai;78;126;204;15;15;30
96;02.09.2014;2014;09;12;Tiistai;79;119;198;10;25;35
96;02.09.2014;2014;09;13;Tiistai;100;145;245;11;22;33
96;02.09.2014;2014;09;14;Tiistai;88;135;223;8;10;18
96;02.09.2014;2014;09;15;Tiistai;128;307;435;4;31;35
96;02.09.2014;2014;09;16;Tiistai;151;240;391;10;16;26
96;02.09.2014;2014;09;17;Tiistai;127;105;232;10;23;33
96;02.09.2014;2014;09;18;Tiistai;86;74;160;13;15;28
96;02.09.2014;2014;09;19;Tiistai;82;67;149;15;17;32
96;02.09.2014;2014;09;20;Tiistai;81;59;140;6;9;15
96;02.09.2014;2014;09;21;Tiistai;32;51;83;2;9;11
96;02.09.2014;2014;09;22;Tiistai;12;15;27;0;3;3
96;02.09.2014;2014;09;23;Tiistai;3;2;5;2;2;4
96;03.09.2014;2014;09;00;Keskiviikko;6;5;11;0;1;1
96;03.09.2014;2014;09;01;Keskiviikko;4;2;6;5;0;5
96;03.09.2014;2014;09;02;Keskiviikko;3;2;5;0;0;0
96;03.09.2014;2014;09;03;Keskiviikko;8;3;11;0;0;0
96;03.09.2014;2014;09;04;Keskiviikko;3;3;6;0;0;0
96;03.09.2014;2014;09;05;Keskiviikko;3;10;13;2;1;3
96;03.09.2014;2014;09;06;Keskiviikko;42;56;98;3;1;4
96;03.09.2014;2014;09;07;Keskiviikko;197;213;410;14;5;19
96;03.09.2014;2014;09;08;Keskiviikko;130;151;281;16;9;25
96;03.09.2014;2014;09;09;Keskiviikko;108;139;247;10;5;15
96;03.09.2014;2014;09;10;Keskiviikko;63;63;126;7;7;14
96;03.09.2014;2014;09;11;Keskiviikko;70;91;161;14;5;19
96;03.09.2014;2014;09;12;Keskiviikko;112;154;266;6;6;12
96;03.09.2014;2014;09;13;Keskiviikko;94;155;249;9;10;19
96;03.09.2014;2014;09;14;Keskiviikko;109;201;310;4;16;20
96;03.09.2014;2014;09;15;Keskiviikko;116;251;367;6;27;33
96;03.09.2014;2014;09;16;Keskiviikko;146;204;350;9;13;22
96;03.09.2014;2014;09;17;Keskiviikko;87;108;195;13;12;25
96;03.09.2014;2014;09;18;Keskiviikko;105;79;184;16;12;28
96;03.09.2014;2014;09;19;Keskiviikko;74;53;127;13;18;31
96;03.09.2014;2014;09;20;Keskiviikko;62;67;129;12;13;25
96;03.09.2014;2014;09;21;Keskiviikko;31;48;79;7;12;19
96;03.09.2014;2014;09;22;Keskiviikko;12;10;22;2;4;6
96;03.09.2014;2014;09;23;Keskiviikko;4;4;8;3;0;3
96;04.09.2014;2014;09;00;Torstai;1;1;2;1;1;2
96;04.09.2014;2014;09;01;Torstai;5;0;5;0;1;1
96;04.09.2014;2014;09;02;Torstai;2;0;2;0;0;0
96;04.09.2014;2014;09;03;Torstai;0;0;0;0;0;0
96;04.09.2014;2014;09;04;Torstai;3;5;8;0;0;0
96;04.09.2014;2014;09;05;Torstai;5;10;15;0;1;1
96;04.09.2014;2014;09;06;Torstai;50;45;95;2;4;6
96;04.09.2014;2014;09;07;Torstai;184;191;375;10;6;16
96;04.09.2014;2014;09;08;Torstai;186;148;334;18;26;44
96;04.09.2014;2014;09;09;Torstai;79;109;188;9;10;19
96;04.09.2014;2014;09;10;Torstai;59;88;147;18;9;27
96;04.09.2014;2014;09;11;Torstai;77;90;167;6;4;10
96;04.09.2014;2014;09;12;Torstai;99;111;210;13;13;26
96;04.09.2014;2014;09;13;Torstai;82;128;210;5;9;14
96;04.09.2014;2014;09;14;Torstai;94;236;330;5;15;20
96;04.09.2014;2014;09;15;Torstai;124;262;386;7;22;29
96;04.09.2014;2014;09;16;Torstai;128;184;312;5;18;23
96;04.09.2014;2014;09;17;Torstai;75;104;179;8;10;18
96;04.09.2014;2014;09;18;Torstai;93;64;157;14;14;28
96;04.09.2014;2014;09;19;Torstai;71;70;141;5;10;15
96;04.09.2014;2014;09;20;Torstai;54;53;107;10;8;18
96;04.09.2014;2014;09;21;Torstai;35;43;78;4;6;10
96;04.09.2014;2014;09;22;Torstai;10;9;19;11;5;16
96;04.09.2014;2014;09;23;Torstai;4;5;9;1;2;3
96;05.09.2014;2014;09;00;Perjantai;1;0;1;2;0;2
96;05.09.2014;2014;09;01;Perjantai;5;3;8;0;0;0
96;05.09.2014;2014;09;02;Perjantai;1;1;2;0;0;0
96;05.09.2014;2014;09;03;Perjantai;1;0;1;0;0;0
96;05.09.2014;2014;09;04;Perjantai;0;3;3;0;0;0
96;05.09.2014;2014;09;05;Perjantai;5;5;10;0;0;0
96;05.09.2014;2014;09;06;Perjantai;50;47;97;9;2;11
96;05.09.2014;2014;09;07;Perjantai;183;226;409;16;14;30
96;05.09.2014;2014;09;08;Perjantai;133;116;249;14;7;21
96;05.09.2014;2014;09;09;Perjantai;117;111;228;24;10;34
96;05.09.2014;2014;09;10;Perjantai;139;101;240;12;10;22
96;05.09.2014;2014;09;11;Perjantai;83;120;203;9;12;21
96;05.09.2014;2014;09;12;Perjantai;95;143;238;13;21;34
96;05.09.2014;2014;09;13;Perjantai;87;163;250;5;8;13
96;05.09.2014;2014;09;14;Perjantai;94;232;326;8;21;29
96;05.09.2014;2014;09;15;Perjantai;151;202;353;8;28;36
96;05.09.2014;2014;09;16;Perjantai;103;92;195;10;6;16
96;05.09.2014;2014;09;17;Perjantai;72;109;181;9;16;25
96;05.09.2014;2014;09;18;Perjantai;61;90;151;6;10;16
96;05.09.2014;2014;09;19;Perjantai;35;69;104;8;6;14
96;05.09.2014;2014;09;20;Perjantai;48;32;80;3;4;7
96;05.09.2014;2014;09;21;Perjantai;84;29;113;16;8;24
96;05.09.2014;2014;09;22;Perjantai;15;19;34;1;5;6
96;05.09.2014;2014;09;23;Perjantai;16;17;33;1;4;5
96;06.09.2014;2014;09;00;Lauantai;17;8;25;0;1;1
96;06.09.2014;2014;09;01;Lauantai;16;6;22;1;0;1
96;06.09.2014;2014;09;02;Lauantai;29;2;31;3;3;6
96;06.09.2014;2014;09;03;Lauantai;21;3;24;2;1;3
96;06.09.2014;2014;09;04;Lauantai;8;2;10;3;1;4
96;06.09.2014;2014;09;05;Lauantai;0;3;3;1;0;1
96;06.09.2014;2014;09;06;Lauantai;17;12;29;2;0;2
96;06.09.2014;2014;09;07;Lauantai;6;16;22;3;2;5
96;06.09.2014;2014;09;08;Lauantai;8;24;32;6;6;12
96;06.09.2014;2014;09;09;Lauantai;21;51;72;3;34;37
96;06.09.2014;2014;09;10;Lauantai;38;67;105;2;31;33
96;06.09.2014;2014;09;11;Lauantai;37;74;111;18;21;39
96;06.09.2014;2014;09;12;Lauantai;70;76;146;42;16;58
96;06.09.2014;2014;09;13;Lauantai;68;68;136;21;15;36
96;06.09.2014;2014;09;14;Lauantai;79;82;161;18;12;30
96;06.09.2014;2014;09;15;Lauantai;77;51;128;14;11;25
96;06.09.2014;2014;09;16;Lauantai;55;45;100;6;1;7
96;06.09.2014;2014;09;17;Lauantai;75;42;117;16;7;23
96;06.09.2014;2014;09;18;Lauantai;41;34;75;14;7;21
96;06.09.2014;2014;09;19;Lauantai;28;40;68;6;9;15
96;06.09.2014;2014;09;20;Lauantai;29;35;64;8;4;12
96;06.09.2014;2014;09;21;Lauantai;21;38;59;5;7;12
96;06.09.2014;2014;09;22;Lauantai;8;17;25;1;3;4
96;06.09.2014;2014;09;23;Lauantai;19;19;38;2;1;3
96;07.09.2014;2014;09;00;Sunnuntai;13;15;28;0;6;6
96;07.09.2014;2014;09;01;Sunnuntai;14;3;17;2;0;2
96;07.09.2014;2014;09;02;Sunnuntai;17;6;23;1;0;1
96;07.09.2014;2014;09;03;Sunnuntai;16;4;20;1;0;1
96;07.09.2014;2014;09;04;Sunnuntai;7;5;12;2;0;2
96;07.09.2014;2014;09;05;Sunnuntai;1;6;7;0;1;1
96;07.09.2014;2014;09;06;Sunnuntai;14;9;23;1;2;3
96;07.09.2014;2014;09;07;Sunnuntai;3;12;15;2;2;4
96;07.09.2014;2014;09;08;Sunnuntai;7;12;19;2;3;5
96;07.09.2014;2014;09;09;Sunnuntai;9;13;22;6;5;11
96;07.09.2014;2014;09;10;Sunnuntai;15;34;49;2;5;7
96;07.09.2014;2014;09;11;Sunnuntai;23;33;56;6;5;11
96;07.09.2014;2014;09;12;Sunnuntai;33;62;95;5;16;21
96;07.09.2014;2014;09;13;Sunnuntai;51;71;122;10;7;17
96;07.09.2014;2014;09;14;Sunnuntai;54;67;121;6;8;14
96;07.09.2014;2014;09;15;Sunnuntai;51;49;100;3;10;13
96;07.09.2014;2014;09;16;Sunnuntai;79;50;129;25;11;36
96;07.09.2014;2014;09;17;Sunnuntai;50;45;95;13;16;29
96;07.09.2014;2014;09;18;Sunnuntai;52;51;103;13;20;33
96;07.09.2014;2014;09;19;Sunnuntai;36;57;93;11;13;24
96;07.09.2014;2014;09;20;Sunnuntai;34;52;86;10;7;17
96;07.09.2014;2014;09;21;Sunnuntai;22;33;55;2;9;11
96;07.09.2014;2014;09;22;Sunnuntai;16;10;26;2;2;4
96;07.09.2014;2014;09;23;Sunnuntai;1;5;6;1;0;1
96;08.09.2014;2014;09;00;Maanantai;2;0;2;0;1;1
96;08.09.2014;2014;09;01;Maanantai;3;1;4;0;0;0
96;08.09.2014;2014;09;02;Maanantai;0;0;0;0;0;0
96;08.09.2014;2014;09;03;Maanantai;2;2;4;0;0;0
96;08.09.2014;2014;09;04;Maanantai;0;1;1;0;0;0
96;08.09.2014;2014;09;05;Maanantai;5;4;9;1;2;3
96;08.09.2014;2014;09;06;Maanantai;52;54;106;5;2;7
96;08.09.2014;2014;09;07;Maanantai;169;180;349;13;10;23
96;08.09.2014;2014;09;08;Maanantai;124;152;276;18;6;24
96;08.09.2014;2014;09;09;Maanantai;104;131;235;8;4;12
96;08.09.2014;2014;09;10;Maanantai;43;102;145;9;11;20
96;08.09.2014;2014;09;11;Maanantai;65;123;188;5;13;18
96;08.09.2014;2014;09;12;Maanantai;88;132;220;5;9;14
96;08.09.2014;2014;09;13;Maanantai;103;136;239;3;12;15
96;08.09.2014;2014;09;14;Maanantai;122;219;341;6;18;24
96;08.09.2014;2014;09;15;Maanantai;165;286;451;6;22;28
96;08.09.2014;2014;09;16;Maanantai;160;204;364;15;20;35
96;08.09.2014;2014;09;17;Maanantai;104;98;202;19;9;28
96;08.09.2014;2014;09;18;Maanantai;80;84;164;14;13;27
96;08.09.2014;2014;09;19;Maanantai;73;74;147;14;14;28
96;08.09.2014;2014;09;20;Maanantai;60;59;119;12;9;21
96;08.09.2014;2014;09;21;Maanantai;44;45;89;6;6;12
96;08.09.2014;2014;09;22;Maanantai;11;6;17;1;5;6
96;08.09.2014;2014;09;23;Maanantai;3;2;5;0;1;1
96;09.09.2014;2014;09;00;Tiistai;3;4;7;0;0;0
96;09.09.2014;2014;09;01;Tiistai;1;0;1;0;0;0
96;09.09.2014;2014;09;02;Tiistai;0;1;1;0;0;0
96;09.09.2014;2014;09;03;Tiistai;1;1;2;1;0;1
96;09.09.2014;2014;09;04;Tiistai;3;2;5;0;0;0
96;09.09.2014;2014;09;05;Tiistai;4;8;12;2;1;3
96;09.09.2014;2014;09;06;Tiistai;47;56;103;2;2;4
96;09.09.2014;2014;09;07;Tiistai;201;183;384;17;11;28
96;09.09.2014;2014;09;08;Tiistai;152;178;330;10;6;16
96;09.09.2014;2014;09;09;Tiistai;139;161;300;12;21;33
96;09.09.2014;2014;09;10;Tiistai;69;81;150;9;5;14
96;09.09.2014;2014;09;11;Tiistai;96;110;206;9;9;18
96;09.09.2014;2014;09;12;Tiistai;93;137;230;12;13;25
96;09.09.2014;2014;09;13;Tiistai;91;111;202;4;6;10
96;09.09.2014;2014;09;14;Tiistai;94;214;308;11;18;29
96;09.09.2014;2014;09;15;Tiistai;159;284;443;10;30;40
96;09.09.2014;2014;09;16;Tiistai;153;213;366;10;19;29
96;09.09.2014;2014;09;17;Tiistai;130;93;223;5;9;14
96;09.09.2014;2014;09;18;Tiistai;88;74;162;10;7;17
96;09.09.2014;2014;09;19;Tiistai;94;75;169;8;15;23
96;09.09.2014;2014;09;20;Tiistai;64;64;128;11;14;25
96;09.09.2014;2014;09;21;Tiistai;41;44;85;5;11;16
96;09.09.2014;2014;09;22;Tiistai;23;16;39;3;1;4
96;09.09.2014;2014;09;23;Tiistai;4;2;6;2;1;3
96;10.09.2014;2014;09;00;Keskiviikko;3;2;5;0;0;0
96;10.09.2014;2014;09;01;Keskiviikko;2;0;2;0;0;0
96;10.09.2014;2014;09;02;Keskiviikko;0;0;0;0;0;0
96;10.09.2014;2014;09;03;Keskiviikko;0;0;0;0;0;0
96;10.09.2014;2014;09;04;Keskiviikko;1;2;3;0;0;0
96;10.09.2014;2014;09;05;Keskiviikko;3;8;11;0;0;0
96;10.09.2014;2014;09;06;Keskiviikko;50;56;106;2;4;6
96;10.09.2014;2014;09;07;Keskiviikko;180;203;383;14;6;20
96;10.09.2014;2014;09;08;Keskiviikko;138;131;269;12;12;24
96;10.09.2014;2014;09;09;Keskiviikko;122;143;265;9;10;19
96;10.09.2014;2014;09;10;Keskiviikko;63;92;155;7;6;13
96;10.09.2014;2014;09;11;Keskiviikko;89;130;219;8;11;19
96;10.09.2014;2014;09;12;Keskiviikko;104;140;244;9;10;19
96;10.09.2014;2014;09;13;Keskiviikko;96;161;257;7;14;21
96;10.09.2014;2014;09;14;Keskiviikko;171;179;350;15;14;29
96;10.09.2014;2014;09;15;Keskiviikko;141;280;421;8;26;34
96;10.09.2014;2014;09;16;Keskiviikko;171;201;372;11;17;28
96;10.09.2014;2014;09;17;Keskiviikko;95;137;232;14;18;32
96;10.09.2014;2014;09;18;Keskiviikko;124;126;250;9;13;22
96;10.09.2014;2014;09;19;Keskiviikko;68;62;130;23;11;34
96;10.09.2014;2014;09;20;Keskiviikko;75;79;154;12;17;29
96;10.09.2014;2014;09;21;Keskiviikko;71;79;150;8;9;17
96;10.09.2014;2014;09;22;Keskiviikko;21;22;43;3;5;8
96;10.09.2014;2014;09;23;Keskiviikko;8;9;17;4;0;4
96;11.09.2014;2014;09;00;Torstai;14;3;17;1;0;1
96;11.09.2014;2014;09;01;Torstai;10;0;10;0;0;0
96;11.09.2014;2014;09;02;Torstai;8;2;10;1;0;1
96;11.09.2014;2014;09;03;Torstai;7;5;12;2;0;2
96;11.09.2014;2014;09;04;Torstai;8;3;11;0;0;0
96;11.09.2014;2014;09;05;Torstai;8;8;16;1;0;1
96;11.09.2014;2014;09;06;Torstai;46;42;88;3;1;4
96;11.09.2014;2014;09;07;Torstai;145;215;360;16;7;23
96;11.09.2014;2014;09;08;Torstai;151;150;301;11;7;18
96;11.09.2014;2014;09;09;Torstai;107;104;211;9;4;13
96;11.09.2014;2014;09;10;Torstai;68;100;168;11;10;21
96;11.09.2014;2014;09;11;Torstai;94;96;190;7;10;17
96;11.09.2014;2014;09;12;Torstai;99;116;215;15;11;26
96;11.09.2014;2014;09;13;Torstai;86;121;207;3;9;12
96;11.09.2014;2014;09;14;Torstai;92;240;332;7;29;36
96;11.09.2014;2014;09;15;Torstai;134;251;385;5;19;24
96;11.09.2014;2014;09;16;Torstai;138;214;352;15;27;42
96;11.09.2014;2014;09;17;Torstai;74;93;167;13;6;19
96;11.09.2014;2014;09;18;Torstai;85;97;182;15;21;36
96;11.09.2014;2014;09;19;Torstai;84;68;152;8;14;22
96;11.09.2014;2014;09;20;Torstai;43;59;102;8;8;16
96;11.09.2014;2014;09;21;Torstai;37;43;80;8;11;19
96;11.09.2014;2014;09;22;Torstai;9;16;25;3;2;5
96;11.09.2014;2014;09;23;Torstai;8;5;13;3;0;3
96;12.09.2014;2014;09;00;Perjantai;7;2;9;1;1;2
96;12.09.2014;2014;09;01;Perjantai;3;2;5;1;0;1
96;12.09.2014;2014;09;02;Perjantai;3;1;4;1;0;1
96;12.09.2014;2014;09;03;Perjantai;4;0;4;0;1;1
96;12.09.2014;2014;09;04;Perjantai;3;2;5;0;1;1
96;12.09.2014;2014;09;05;Perjantai;6;6;12;0;0;0
96;12.09.2014;2014;09;06;Perjantai;46;39;85;5;0;5
96;12.09.2014;2014;09;07;Perjantai;151;163;314;7;6;13
96;12.09.2014;2014;09;08;Perjantai;136;99;235;7;6;13
96;12.09.2014;2014;09;09;Perjantai;55;117;172;8;5;13
96;12.09.2014;2014;09;10;Perjantai;43;85;128;6;9;15
96;12.09.2014;2014;09;11;Perjantai;51;105;156;3;4;7
96;12.09.2014;2014;09;12;Perjantai;99;137;236;4;13;17
96;12.09.2014;2014;09;13;Perjantai;77;149;226;6;11;17
96;12.09.2014;2014;09;14;Perjantai;86;221;307;10;12;22
96;12.09.2014;2014;09;15;Perjantai;127;183;310;2;14;16
96;12.09.2014;2014;09;16;Perjantai;105;99;204;5;8;13
96;12.09.2014;2014;09;17;Perjantai;81;72;153;3;9;12
96;12.09.2014;2014;09;18;Perjantai;53;53;106;12;3;15
96;12.09.2014;2014;09;19;Perjantai;49;42;91;6;10;16
96;12.09.2014;2014;09;20;Perjantai;46;42;88;4;6;10
96;12.09.2014;2014;09;21;Perjantai;43;32;75;3;4;7
96;12.09.2014;2014;09;22;Perjantai;15;8;23;1;1;2
96;12.09.2014;2014;09;23;Perjantai;24;13;37;1;1;2
96;13.09.2014;2014;09;00;Lauantai;12;6;18;0;0;0
96;13.09.2014;2014;09;01;Lauantai;10;7;17;3;1;4
96;13.09.2014;2014;09;02;Lauantai;8;5;13;0;0;0
96;13.09.2014;2014;09;03;Lauantai;17;0;17;1;0;1
96;13.09.2014;2014;09;04;Lauantai;10;0;10;0;0;0
96;13.09.2014;2014;09;05;Lauantai;4;7;11;0;4;4
96;13.09.2014;2014;09;06;Lauantai;18;15;33;4;0;4
96;13.09.2014;2014;09;07;Lauantai;15;25;40;1;3;4
96;13.09.2014;2014;09;08;Lauantai;7;19;26;5;2;7
96;13.09.2014;2014;09;09;Lauantai;15;46;61;3;8;11
96;13.09.2014;2014;09;10;Lauantai;32;35;67;5;7;12
96;13.09.2014;2014;09;11;Lauantai;36;64;100;12;9;21
96;13.09.2014;2014;09;12;Lauantai;63;72;135;5;12;17
96;13.09.2014;2014;09;13;Lauantai;48;70;118;38;10;48
96;13.09.2014;2014;09;14;Lauantai;77;77;154;12;13;25
96;13.09.2014;2014;09;15;Lauantai;64;58;122;6;11;17
96;13.09.2014;2014;09;16;Lauantai;67;58;125;5;9;14
96;13.09.2014;2014;09;17;Lauantai;57;47;104;12;2;14
96;13.09.2014;2014;09;18;Lauantai;60;34;94;12;8;20
96;13.09.2014;2014;09;19;Lauantai;37;32;69;11;11;22
96;13.09.2014;2014;09;20;Lauantai;27;25;52;12;12;24
96;13.09.2014;2014;09;21;Lauantai;15;41;56;4;6;10
96;13.09.2014;2014;09;22;Lauantai;6;16;22;4;7;11
96;13.09.2014;2014;09;23;Lauantai;12;11;23;1;0;1
96;14.09.2014;2014;09;00;Sunnuntai;16;12;28;1;1;2
96;14.09.2014;2014;09;01;Sunnuntai;13;6;19;0;0;0
96;14.09.2014;2014;09;02;Sunnuntai;14;3;17;4;0;4
96;14.09.2014;2014;09;03;Sunnuntai;11;0;11;0;1;1
96;14.09.2014;2014;09;04;Sunnuntai;5;5;10;4;1;5
96;14.09.2014;2014;09;05;Sunnuntai;6;3;9;0;1;1
96;14.09.2014;2014;09;06;Sunnuntai;18;6;24;0;0;0
96;14.09.2014;2014;09;07;Sunnuntai;3;9;12;0;2;2
96;14.09.2014;2014;09;08;Sunnuntai;12;12;24;4;3;7
96;14.09.2014;2014;09;09;Sunnuntai;13;13;26;4;5;9
96;14.09.2014;2014;09;10;Sunnuntai;19;31;50;4;5;9
96;14.09.2014;2014;09;11;Sunnuntai;28;37;65;2;9;11
96;14.09.2014;2014;09;12;Sunnuntai;57;55;112;8;8;16
96;14.09.2014;2014;09;13;Sunnuntai;57;60;117;9;10;19
96;14.09.2014;2014;09;14;Sunnuntai;54;70;124;9;9;18
96;14.09.2014;2014;09;15;Sunnuntai;54;113;167;6;14;20
96;14.09.2014;2014;09;16;Sunnuntai;76;58;134;16;3;19
96;14.09.2014;2014;09;17;Sunnuntai;72;49;121;9;9;18
96;14.09.2014;2014;09;18;Sunnuntai;74;68;142;22;21;43
96;14.09.2014;2014;09;19;Sunnuntai;33;43;76;16;19;35
96;14.09.2014;2014;09;20;Sunnuntai;35;46;81;7;9;16
96;14.09.2014;2014;09;21;Sunnuntai;23;19;42;11;6;17
96;14.09.2014;2014;09;22;Sunnuntai;15;10;25;2;2;4
96;14.09.2014;2014;09;23;Sunnuntai;4;3;7;0;2;2
96;15.09.2014;2014;09;00;Maanantai;3;0;3;0;0;0
96;15.09.2014;2014;09;01;Maanantai;6;0;6;0;0;0
96;15.09.2014;2014;09;02;Maanantai;1;0;1;2;0;2
96;15.09.2014;2014;09;03;Maanantai;2;2;4;0;0;0
96;15.09.2014;2014;09;04;Maanantai;0;7;7;0;0;0
96;15.09.2014;2014;09;05;Maanantai;4;4;8;0;1;1
96;15.09.2014;2014;09;06;Maanantai;50;47;97;4;2;6
96;15.09.2014;2014;09;07;Maanantai;173;161;334;13;9;22
96;15.09.2014;2014;09;08;Maanantai;194;145;339;12;5;17
96;15.09.2014;2014;09;09;Maanantai;117;102;219;9;8;17
96;15.09.2014;2014;09;10;Maanantai;79;69;148;7;15;22
96;15.09.2014;2014;09;11;Maanantai;74;109;183;5;9;14
96;15.09.2014;2014;09;12;Maanantai;89;118;207;5;9;14
96;15.09.2014;2014;09;13;Maanantai;106;144;250;13;15;28
96;15.09.2014;2014;09;14;Maanantai;133;212;345;16;16;32
96;15.09.2014;2014;09;15;Maanantai;137;285;422;6;28;34
96;15.09.2014;2014;09;16;Maanantai;163;202;365;12;16;28
96;15.09.2014;2014;09;17;Maanantai;92;112;204;13;13;26
96;15.09.2014;2014;09;18;Maanantai;101;92;193;11;15;26
96;15.09.2014;2014;09;19;Maanantai;79;69;148;14;19;33
96;15.09.2014;2014;09;20;Maanantai;58;66;124;9;14;23
96;15.09.2014;2014;09;21;Maanantai;34;31;65;11;9;20
96;15.09.2014;2014;09;22;Maanantai;10;10;20;5;4;9
96;15.09.2014;2014;09;23;Maanantai;2;4;6;0;0;0
96;16.09.2014;2014;09;00;Tiistai;2;1;3;0;1;1
96;16.09.2014;2014;09;01;Tiistai;1;0;1;0;0;0
96;16.09.2014;2014;09;02;Tiistai;1;0;1;0;0;0
96;16.09.2014;2014;09;03;Tiistai;0;0;0;0;0;0
96;16.09.2014;2014;09;04;Tiistai;0;2;2;1;0;1
96;16.09.2014;2014;09;05;Tiistai;3;10;13;0;0;0
96;16.09.2014;2014;09;06;Tiistai;67;43;110;0;4;4
96;16.09.2014;2014;09;07;Tiistai;187;169;356;18;3;21
96;16.09.2014;2014;09;08;Tiistai;188;184;372;7;12;19
96;16.09.2014;2014;09;09;Tiistai;121;154;275;22;20;42
96;16.09.2014;2014;09;10;Tiistai;84;81;165;8;4;12
96;16.09.2014;2014;09;11;Tiistai;111;97;208;10;8;18
96;16.09.2014;2014;09;12;Tiistai;98;110;208;7;23;30
96;16.09.2014;2014;09;13;Tiistai;95;137;232;12;8;20
96;16.09.2014;2014;09;14;Tiistai;123;188;311;10;17;27
96;16.09.2014;2014;09;15;Tiistai;154;274;428;10;20;30
96;16.09.2014;2014;09;16;Tiistai;165;207;372;11;32;43
96;16.09.2014;2014;09;17;Tiistai;102;88;190;8;7;15
96;16.09.2014;2014;09;18;Tiistai;78;91;169;13;9;22
96;16.09.2014;2014;09;19;Tiistai;61;65;126;17;13;30
96;16.09.2014;2014;09;20;Tiistai;54;49;103;13;12;25
96;16.09.2014;2014;09;21;Tiistai;32;36;68;6;7;13
96;16.09.2014;2014;09;22;Tiistai;7;8;15;2;5;7
96;16.09.2014;2014;09;23;Tiistai;4;3;7;0;0;0
96;17.09.2014;2014;09;00;Keskiviikko;2;0;2;0;0;0
96;17.09.2014;2014;09;01;Keskiviikko;0;2;2;0;1;1
96;17.09.2014;2014;09;02;Keskiviikko;1;1;2;0;0;0
96;17.09.2014;2014;09;03;Keskiviikko;4;0;4;0;0;0
96;17.09.2014;2014;09;04;Keskiviikko;0;2;2;0;0;0
96;17.09.2014;2014;09;05;Keskiviikko;2;6;8;1;1;2
96;17.09.2014;2014;09;06;Keskiviikko;59;48;107;2;4;6
96;17.09.2014;2014;09;07;Keskiviikko;190;195;385;17;6;23
96;17.09.2014;2014;09;08;Keskiviikko;171;174;345;11;7;18
96;17.09.2014;2014;09;09;Keskiviikko;122;144;266;16;11;27
96;17.09.2014;2014;09;10;Keskiviikko;69;70;139;6;7;13
96;17.09.2014;2014;09;11;Keskiviikko;88;100;188;2;7;9
96;17.09.2014;2014;09;12;Keskiviikko;86;99;185;5;9;14
96;17.09.2014;2014;09;13;Keskiviikko;98;140;238;2;11;13
96;17.09.2014;2014;09;14;Keskiviikko;110;242;352;7;13;20
96;17.09.2014;2014;09;15;Keskiviikko;120;307;427;13;29;42
96;17.09.2014;2014;09;16;Keskiviikko;144;182;326;11;19;30
96;17.09.2014;2014;09;17;Keskiviikko;118;126;244;13;12;25
96;17.09.2014;2014;09;18;Keskiviikko;114;80;194;24;17;41
96;17.09.2014;2014;09;19;Keskiviikko;71;69;140;13;11;24
96;17.09.2014;2014;09;20;Keskiviikko;63;63;126;9;10;19
96;17.09.2014;2014;09;21;Keskiviikko;28;55;83;3;9;12
96;17.09.2014;2014;09;22;Keskiviikko;8;9;17;3;2;5
96;17.09.2014;2014;09;23;Keskiviikko;6;9;15;1;0;1
96;18.09.2014;2014;09;00;Torstai;5;3;8;0;0;0
96;18.09.2014;2014;09;01;Torstai;5;0;5;0;0;0
96;18.09.2014;2014;09;02;Torstai;4;1;5;1;0;1
96;18.09.2014;2014;09;03;Torstai;4;1;5;0;0;0
96;18.09.2014;2014;09;04;Torstai;0;4;4;0;0;0
96;18.09.2014;2014;09;05;Torstai;1;9;10;0;1;1
96;18.09.2014;2014;09;06;Torstai;53;53;106;1;1;2
96;18.09.2014;2014;09;07;Torstai;156;174;330;15;3;18
96;18.09.2014;2014;09;08;Torstai;153;170;323;7;5;12
96;18.09.2014;2014;09;09;Torstai;91;99;190;14;13;27
96;18.09.2014;2014;09;10;Torstai;77;81;158;17;10;27
96;18.09.2014;2014;09;11;Torstai;71;99;170;8;2;10
96;18.09.2014;2014;09;12;Torstai;107;108;215;9;9;18
96;18.09.2014;2014;09;13;Torstai;66;141;207;4;16;20
96;18.09.2014;2014;09;14;Torstai;113;224;337;5;8;13
96;18.09.2014;2014;09;15;Torstai;148;282;430;5;25;30
96;18.09.2014;2014;09;16;Torstai;125;189;314;5;20;25
96;18.09.2014;2014;09;17;Torstai;85;108;193;11;12;23
96;18.09.2014;2014;09;18;Torstai;72;79;151;10;12;22
96;18.09.2014;2014;09;19;Torstai;74;73;147;15;10;25
96;18.09.2014;2014;09;20;Torstai;51;36;87;11;4;15
96;18.09.2014;2014;09;21;Torstai;38;56;94;8;4;12
96;18.09.2014;2014;09;22;Torstai;14;17;31;2;2;4
96;18.09.2014;2014;09;23;Torstai;5;3;8;1;3;4
96;19.09.2014;2014;09;00;Perjantai;2;2;4;0;0;0
96;19.09.2014;2014;09;01;Perjantai;11;2;13;1;2;3
96;19.09.2014;2014;09;02;Perjantai;7;2;9;2;0;2
96;19.09.2014;2014;09;03;Perjantai;7;1;8;0;0;0
96;19.09.2014;2014;09;04;Perjantai;2;4;6;0;1;1
96;19.09.2014;2014;09;05;Perjantai;3;7;10;1;0;1
96;19.09.2014;2014;09;06;Perjantai;50;38;88;6;1;7
96;19.09.2014;2014;09;07;Perjantai;131;164;295;11;3;14
96;19.09.2014;2014;09;08;Perjantai;115;137;252;7;11;18
96;19.09.2014;2014;09;09;Perjantai;74;112;186;10;6;16
96;19.09.2014;2014;09;10;Perjantai;58;89;147;6;15;21
96;19.09.2014;2014;09;11;Perjantai;81;106;187;6;7;13
96;19.09.2014;2014;09;12;Perjantai;102;122;224;17;24;41
96;19.09.2014;2014;09;13;Perjantai;76;181;257;6;7;13
96;19.09.2014;2014;09;14;Perjantai;111;222;333;11;21;32
96;19.09.2014;2014;09;15;Perjantai;124;215;339;4;18;22
96;19.09.2014;2014;09;16;Perjantai;83;102;185;5;7;12
96;19.09.2014;2014;09;17;Perjantai;61;74;135;9;6;15
96;19.09.2014;2014;09;18;Perjantai;72;61;133;4;3;7
96;19.09.2014;2014;09;19;Perjantai;50;44;94;2;6;8
96;19.09.2014;2014;09;20;Perjantai;34;20;54;2;5;7
96;19.09.2014;2014;09;21;Perjantai;22;25;47;3;2;5
96;19.09.2014;2014;09;22;Perjantai;13;24;37;3;1;4
96;19.09.2014;2014;09;23;Perjantai;11;7;18;2;1;3
96;20.09.2014;2014;09;00;Lauantai;12;11;23;0;0;0
96;20.09.2014;2014;09;01;Lauantai;11;1;12;0;2;2
96;20.09.2014;2014;09;02;Lauantai;6;0;6;1;1;2
96;20.09.2014;2014;09;03;Lauantai;13;1;14;1;0;1
96;20.09.2014;2014;09;04;Lauantai;5;2;7;0;1;1
96;20.09.2014;2014;09;05;Lauantai;3;6;9;0;2;2
96;20.09.2014;2014;09;06;Lauantai;17;11;28;2;1;3
96;20.09.2014;2014;09;07;Lauantai;4;22;26;1;3;4
96;20.09.2014;2014;09;08;Lauantai;13;37;50;2;4;6
96;20.09.2014;2014;09;09;Lauantai;15;44;59;9;4;13
96;20.09.2014;2014;09;10;Lauantai;25;56;81;6;7;13
96;20.09.2014;2014;09;11;Lauantai;44;67;111;7;13;20
96;20.09.2014;2014;09;12;Lauantai;57;69;126;10;9;19
96;20.09.2014;2014;09;13;Lauantai;51;72;123;8;12;20
96;20.09.2014;2014;09;14;Lauantai;62;83;145;6;10;16
96;20.09.2014;2014;09;15;Lauantai;70;71;141;12;11;23
96;20.09.2014;2014;09;16;Lauantai;45;82;127;12;14;26
96;20.09.2014;2014;09;17;Lauantai;79;57;136;22;17;39
96;20.09.2014;2014;09;18;Lauantai;50;48;98;6;5;11
96;20.09.2014;2014;09;19;Lauantai;65;44;109;10;12;22
96;20.09.2014;2014;09;20;Lauantai;24;39;63;7;3;10
96;20.09.2014;2014;09;21;Lauantai;21;32;53;1;6;7
96;20.09.2014;2014;09;22;Lauantai;15;12;27;1;0;1
96;20.09.2014;2014;09;23;Lauantai;11;7;18;2;1;3
96;21.09.2014;2014;09;00;Sunnuntai;14;8;22;0;1;1
96;21.09.2014;2014;09;01;Sunnuntai;6;9;15;1;1;2
96;21.09.2014;2014;09;02;Sunnuntai;12;1;13;1;1;2
96;21.09.2014;2014;09;03;Sunnuntai;13;0;13;1;0;1
96;21.09.2014;2014;09;04;Sunnuntai;9;2;11;1;0;1
96;21.09.2014;2014;09;05;Sunnuntai;1;2;3;2;1;3
96;21.09.2014;2014;09;06;Sunnuntai;11;15;26;1;3;4
96;21.09.2014;2014;09;07;Sunnuntai;5;18;23;1;3;4
96;21.09.2014;2014;09;08;Sunnuntai;9;9;18;4;4;8
96;21.09.2014;2014;09;09;Sunnuntai;9;20;29;5;5;10
96;21.09.2014;2014;09;10;Sunnuntai;9;29;38;5;9;14
96;21.09.2014;2014;09;11;Sunnuntai;23;38;61;3;9;12
96;21.09.2014;2014;09;12;Sunnuntai;42;63;105;6;9;15
96;21.09.2014;2014;09;13;Sunnuntai;52;71;123;4;6;10
96;21.09.2014;2014;09;14;Sunnuntai;55;61;116;11;11;22
96;21.09.2014;2014;09;15;Sunnuntai;62;49;111;17;10;27
96;21.09.2014;2014;09;16;Sunnuntai;71;37;108;20;14;34
96;21.09.2014;2014;09;17;Sunnuntai;28;30;58;14;9;23
96;21.09.2014;2014;09;18;Sunnuntai;63;51;114;16;19;35
96;21.09.2014;2014;09;19;Sunnuntai;20;32;52;8;12;20
96;21.09.2014;2014;09;20;Sunnuntai;28;45;73;8;15;23
96;21.09.2014;2014;09;21;Sunnuntai;12;25;37;6;3;9
96;21.09.2014;2014;09;22;Sunnuntai;6;8;14;0;1;1
96;21.09.2014;2014;09;23;Sunnuntai;2;6;8;2;0;2
96;22.09.2014;2014;09;00;Maanantai;1;2;3;0;1;1
96;22.09.2014;2014;09;01;Maanantai;1;2;3;0;0;0
96;22.09.2014;2014;09;02;Maanantai;2;0;2;0;0;0
96;22.09.2014;2014;09;03;Maanantai;3;0;3;1;1;2
96;22.09.2014;2014;09;04;Maanantai;0;2;2;0;0;0
96;22.09.2014;2014;09;05;Maanantai;2;5;7;0;4;4
96;22.09.2014;2014;09;06;Maanantai;45;37;82;0;2;2
96;22.09.2014;2014;09;07;Maanantai;154;166;320;15;5;20
96;22.09.2014;2014;09;08;Maanantai;155;151;306;7;8;15
96;22.09.2014;2014;09;09;Maanantai;110;96;206;8;8;16
96;22.09.2014;2014;09;10;Maanantai;72;93;165;6;11;17
96;22.09.2014;2014;09;11;Maanantai;88;108;196;7;8;15
96;22.09.2014;2014;09;12;Maanantai;83;108;191;9;10;19
96;22.09.2014;2014;09;13;Maanantai;85;138;223;5;9;14
96;22.09.2014;2014;09;14;Maanantai;93;180;273;9;14;23
96;22.09.2014;2014;09;15;Maanantai;144;252;396;3;23;26
96;22.09.2014;2014;09;16;Maanantai;140;177;317;6;14;20
96;22.09.2014;2014;09;17;Maanantai;93;80;173;5;4;9
96;22.09.2014;2014;09;18;Maanantai;96;60;156;17;17;34
96;22.09.2014;2014;09;19;Maanantai;63;70;133;12;17;29
96;22.09.2014;2014;09;20;Maanantai;43;44;87;13;11;24
96;22.09.2014;2014;09;21;Maanantai;38;39;77;7;6;13
96;22.09.2014;2014;09;22;Maanantai;9;4;13;2;0;2
96;22.09.2014;2014;09;23;Maanantai;1;2;3;0;1;1
96;23.09.2014;2014;09;00;Tiistai;0;0;0;1;0;1
96;23.09.2014;2014;09;01;Tiistai;1;0;1;0;0;0
96;23.09.2014;2014;09;02;Tiistai;2;0;2;0;0;0
96;23.09.2014;2014;09;03;Tiistai;3;2;5;0;0;0
96;23.09.2014;2014;09;04;Tiistai;3;2;5;0;0;0
96;23.09.2014;2014;09;05;Tiistai;7;3;10;0;2;2
96;23.09.2014;2014;09;06;Tiistai;58;41;99;2;3;5
96;23.09.2014;2014;09;07;Tiistai;181;162;343;13;6;19
96;23.09.2014;2014;09;08;Tiistai;176;120;296;10;8;18
96;23.09.2014;2014;09;09;Tiistai;73;97;170;7;3;10
96;23.09.2014;2014;09;10;Tiistai;44;81;125;5;7;12
96;23.09.2014;2014;09;11;Tiistai;90;80;170;2;4;6
96;23.09.2014;2014;09;12;Tiistai;89;105;194;12;15;27
96;23.09.2014;2014;09;13;Tiistai;78;113;191;6;11;17
96;23.09.2014;2014;09;14;Tiistai;96;174;270;3;12;15
96;23.09.2014;2014;09;15;Tiistai;98;258;356;8;21;29
96;23.09.2014;2014;09;16;Tiistai;116;177;293;12;16;28
96;23.09.2014;2014;09;17;Tiistai;92;86;178;5;8;13
96;23.09.2014;2014;09;18;Tiistai;70;65;135;12;12;24
96;23.09.2014;2014;09;19;Tiistai;59;47;106;10;8;18
96;23.09.2014;2014;09;20;Tiistai;44;34;78;2;7;9
96;23.09.2014;2014;09;21;Tiistai;29;37;66;6;5;11
96;23.09.2014;2014;09;22;Tiistai;12;14;26;2;0;2
96;23.09.2014;2014;09;23;Tiistai;7;3;10;0;1;1
96;24.09.2014;2014;09;00;Keskiviikko;5;0;5;1;0;1
96;24.09.2014;2014;09;01;Keskiviikko;5;3;8;1;0;1
96;24.09.2014;2014;09;02;Keskiviikko;4;0;4;0;0;0
96;24.09.2014;2014;09;03;Keskiviikko;6;1;7;0;1;1
96;24.09.2014;2014;09;04;Keskiviikko;1;3;4;0;0;0
96;24.09.2014;2014;09;05;Keskiviikko;2;4;6;1;1;2
96;24.09.2014;2014;09;06;Keskiviikko;43;35;78;5;0;5
96;24.09.2014;2014;09;07;Keskiviikko;147;135;282;12;5;17
96;24.09.2014;2014;09;08;Keskiviikko;148;111;259;7;5;12
96;24.09.2014;2014;09;09;Keskiviikko;52;100;152;8;5;13
96;24.09.2014;2014;09;10;Keskiviikko;49;64;113;7;5;12
96;24.09.2014;2014;09;11;Keskiviikko;71;70;141;6;6;12
96;24.09.2014;2014;09;12;Keskiviikko;64;76;140;9;9;18
96;24.09.2014;2014;09;13;Keskiviikko;53;125;178;3;8;11
96;24.09.2014;2014;09;14;Keskiviikko;73;157;230;7;18;25
96;24.09.2014;2014;09;15;Keskiviikko;96;193;289;3;25;28
96;24.09.2014;2014;09;16;Keskiviikko;87;156;243;6;13;19
96;24.09.2014;2014;09;17;Keskiviikko;69;65;134;13;10;23
96;24.09.2014;2014;09;18;Keskiviikko;80;34;114;5;8;13
96;24.09.2014;2014;09;19;Keskiviikko;54;30;84;3;7;10
96;24.09.2014;2014;09;20;Keskiviikko;38;42;80;7;8;15
96;24.09.2014;2014;09;21;Keskiviikko;25;26;51;0;0;0
96;24.09.2014;2014;09;22;Keskiviikko;7;3;10;1;0;1
96;24.09.2014;2014;09;23;Keskiviikko;2;2;4;1;0;1
96;25.09.2014;2014;09;00;Torstai;1;0;1;1;0;1
96;25.09.2014;2014;09;01;Torstai;2;0;2;0;1;1
96;25.09.2014;2014;09;02;Torstai;2;0;2;1;1;2
96;25.09.2014;2014;09;03;Torstai;0;0;0;0;0;0
96;25.09.2014;2014;09;04;Torstai;2;3;5;0;0;0
96;25.09.2014;2014;09;05;Torstai;4;7;11;1;2;3
96;25.09.2014;2014;09;06;Torstai;46;24;70;4;0;4
96;25.09.2014;2014;09;07;Torstai;134;129;263;14;5;19
96;25.09.2014;2014;09;08;Torstai;140;101;241;9;8;17
96;25.09.2014;2014;09;09;Torstai;60;75;135;11;6;17
96;25.09.2014;2014;09;10;Torstai;56;86;142;7;10;17
96;25.09.2014;2014;09;11;Torstai;67;96;163;6;3;9
96;25.09.2014;2014;09;12;Torstai;77;85;162;4;8;12
96;25.09.2014;2014;09;13;Torstai;87;141;228;9;18;27
96;25.09.2014;2014;09;14;Torstai;99;146;245;9;19;28
96;25.09.2014;2014;09;15;Torstai;106;209;315;5;17;22
96;25.09.2014;2014;09;16;Torstai;115;147;262;8;18;26
96;25.09.2014;2014;09;17;Torstai;68;87;155;3;7;10
96;25.09.2014;2014;09;18;Torstai;60;71;131;9;8;17
96;25.09.2014;2014;09;19;Torstai;62;50;112;8;11;19
96;25.09.2014;2014;09;20;Torstai;49;42;91;7;11;18
96;25.09.2014;2014;09;21;Torstai;33;40;73;4;2;6
96;25.09.2014;2014;09;22;Torstai;9;8;17;2;3;5
96;25.09.2014;2014;09;23;Torstai;3;6;9;0;1;1
96;26.09.2014;2014;09;00;Perjantai;2;4;6;1;0;1
96;26.09.2014;2014;09;01;Perjantai;0;0;0;0;0;0
96;26.09.2014;2014;09;02;Perjantai;10;0;10;0;0;0
96;26.09.2014;2014;09;03;Perjantai;2;1;3;0;0;0
96;26.09.2014;2014;09;04;Perjantai;3;1;4;2;1;3
96;26.09.2014;2014;09;05;Perjantai;6;4;10;1;0;1
96;26.09.2014;2014;09;06;Perjantai;52;27;79;3;3;6
96;26.09.2014;2014;09;07;Perjantai;111;130;241;5;4;9
96;26.09.2014;2014;09;08;Perjantai;124;108;232;5;3;8
96;26.09.2014;2014;09;09;Perjantai;51;96;147;6;3;9
96;26.09.2014;2014;09;10;Perjantai;61;79;140;2;10;12
96;26.09.2014;2014;09;11;Perjantai;52;109;161;5;8;13
96;26.09.2014;2014;09;12;Perjantai;97;101;198;7;11;18
96;26.09.2014;2014;09;13;Perjantai;77;135;212;4;15;19
96;26.09.2014;2014;09;14;Perjantai;95;157;252;7;23;30
96;26.09.2014;2014;09;15;Perjantai;72;187;259;9;18;27
96;26.09.2014;2014;09;16;Perjantai;78;80;158;1;8;9
96;26.09.2014;2014;09;17;Perjantai;48;55;103;3;7;10
96;26.09.2014;2014;09;18;Perjantai;44;23;67;8;7;15
96;26.09.2014;2014;09;19;Perjantai;31;20;51;6;2;8
96;26.09.2014;2014;09;20;Perjantai;25;14;39;3;4;7
96;26.09.2014;2014;09;21;Perjantai;11;24;35;2;4;6
96;26.09.2014;2014;09;22;Perjantai;8;15;23;1;1;2
96;26.09.2014;2014;09;23;Perjantai;9;3;12;1;1;2
96;27.09.2014;2014;09;00;Lauantai;3;12;15;0;0;0
96;27.09.2014;2014;09;01;Lauantai;3;3;6;3;1;4
96;27.09.2014;2014;09;02;Lauantai;3;1;4;3;1;4
96;27.09.2014;2014;09;03;Lauantai;9;0;9;3;0;3
96;27.09.2014;2014;09;04;Lauantai;6;1;7;1;1;2
96;27.09.2014;2014;09;05;Lauantai;0;1;1;1;0;1
96;27.09.2014;2014;09;06;Lauantai;15;9;24;0;2;2
96;27.09.2014;2014;09;07;Lauantai;7;16;23;2;3;5
96;27.09.2014;2014;09;08;Lauantai;10;18;28;3;2;5
96;27.09.2014;2014;09;09;Lauantai;10;33;43;2;7;9
96;27.09.2014;2014;09;10;Lauantai;21;43;64;2;5;7
96;27.09.2014;2014;09;11;Lauantai;29;49;78;8;14;22
96;27.09.2014;2014;09;12;Lauantai;36;50;86;5;8;13
96;27.09.2014;2014;09;13;Lauantai;43;39;82;4;10;14
96;27.09.2014;2014;09;14;Lauantai;52;24;76;13;2;15
96;27.09.2014;2014;09;15;Lauantai;36;35;71;3;3;6
96;27.09.2014;2014;09;16;Lauantai;33;24;57;7;5;12
96;27.09.2014;2014;09;17;Lauantai;30;33;63;18;3;21
96;27.09.2014;2014;09;18;Lauantai;26;16;42;10;4;14
96;27.09.2014;2014;09;19;Lauantai;25;16;41;5;14;19
96;27.09.2014;2014;09;20;Lauantai;18;15;33;3;9;12
96;27.09.2014;2014;09;21;Lauantai;21;31;52;2;7;9
96;27.09.2014;2014;09;22;Lauantai;10;15;25;2;1;3
96;27.09.2014;2014;09;23;Lauantai;11;7;18;1;1;2
96;28.09.2014;2014;09;00;Sunnuntai;8;7;15;0;2;2
96;28.09.2014;2014;09;01;Sunnuntai;8;3;11;0;1;1
96;28.09.2014;2014;09;02;Sunnuntai;8;0;8;1;0;1
96;28.09.2014;2014;09;03;Sunnuntai;14;2;16;3;0;3
96;28.09.2014;2014;09;04;Sunnuntai;10;0;10;0;0;0
96;28.09.2014;2014;09;05;Sunnuntai;3;0;3;1;0;1
96;28.09.2014;2014;09;06;Sunnuntai;4;7;11;1;1;2
96;28.09.2014;2014;09;07;Sunnuntai;7;2;9;2;3;5
96;28.09.2014;2014;09;08;Sunnuntai;7;8;15;4;2;6
96;28.09.2014;2014;09;09;Sunnuntai;8;11;19;3;2;5
96;28.09.2014;2014;09;10;Sunnuntai;13;22;35;5;8;13
96;28.09.2014;2014;09;11;Sunnuntai;26;36;62;7;7;14
96;28.09.2014;2014;09;12;Sunnuntai;44;51;95;13;12;25
96;28.09.2014;2014;09;13;Sunnuntai;38;50;88;11;11;22
96;28.09.2014;2014;09;14;Sunnuntai;48;61;109;14;4;18
96;28.09.2014;2014;09;15;Sunnuntai;57;61;118;4;8;12
96;28.09.2014;2014;09;16;Sunnuntai;59;30;89;24;9;33
96;28.09.2014;2014;09;17;Sunnuntai;41;40;81;13;10;23
96;28.09.2014;2014;09;18;Sunnuntai;40;42;82;11;16;27
96;28.09.2014;2014;09;19;Sunnuntai;18;25;43;9;16;25
96;28.09.2014;2014;09;20;Sunnuntai;23;40;63;6;9;15
96;28.09.2014;2014;09;21;Sunnuntai;20;18;38;5;1;6
96;28.09.2014;2014;09;22;Sunnuntai;12;6;18;1;0;1
96;28.09.2014;2014;09;23;Sunnuntai;5;1;6;1;0;1
96;29.09.2014;2014;09;00;Maanantai;3;0;3;0;0;0
96;29.09.2014;2014;09;01;Maanantai;6;0;6;0;0;0
96;29.09.2014;2014;09;02;Maanantai;0;0;0;0;0;0
96;29.09.2014;2014;09;03;Maanantai;1;1;2;0;0;0
96;29.09.2014;2014;09;04;Maanantai;3;2;5;0;1;1
96;29.09.2014;2014;09;05;Maanantai;2;3;5;2;1;3
96;29.09.2014;2014;09;06;Maanantai;44;39;83;2;2;4
96;29.09.2014;2014;09;07;Maanantai;155;147;302;13;5;18
96;29.09.2014;2014;09;08;Maanantai;152;141;293;17;3;20
96;29.09.2014;2014;09;09;Maanantai;95;98;193;14;8;22
96;29.09.2014;2014;09;10;Maanantai;64;82;146;5;6;11
96;29.09.2014;2014;09;11;Maanantai;69;114;183;4;5;9
96;29.09.2014;2014;09;12;Maanantai;98;131;229;16;12;28
96;29.09.2014;2014;09;13;Maanantai;75;122;197;8;8;16
96;29.09.2014;2014;09;14;Maanantai;86;177;263;10;21;31
96;29.09.2014;2014;09;15;Maanantai;125;267;392;2;14;16
96;29.09.2014;2014;09;16;Maanantai;131;172;303;8;16;24
96;29.09.2014;2014;09;17;Maanantai;84;89;173;6;12;18
96;29.09.2014;2014;09;18;Maanantai;85;99;184;13;14;27
96;29.09.2014;2014;09;19;Maanantai;57;71;128;12;14;26
96;29.09.2014;2014;09;20;Maanantai;59;53;112;8;11;19
96;29.09.2014;2014;09;21;Maanantai;33;30;63;8;14;22
96;29.09.2014;2014;09;22;Maanantai;15;11;26;2;2;4
96;29.09.2014;2014;09;23;Maanantai;3;2;5;0;0;0
96;30.09.2014;2014;09;00;Tiistai;0;2;2;0;0;0
96;30.09.2014;2014;09;01;Tiistai;1;0;1;0;0;0
96;30.09.2014;2014;09;02;Tiistai;2;0;2;0;0;0
96;30.09.2014;2014;09;03;Tiistai;1;1;2;0;0;0
96;30.09.2014;2014;09;04;Tiistai;1;1;2;0;1;1
96;30.09.2014;2014;09;05;Tiistai;2;8;10;1;1;2
96;30.09.2014;2014;09;06;Tiistai;42;43;85;3;8;11
96;30.09.2014;2014;09;07;Tiistai;201;172;373;12;5;17
96;30.09.2014;2014;09;08;Tiistai;147;142;289;9;4;13
96;30.09.2014;2014;09;09;Tiistai;105;129;234;12;4;16
96;30.09.2014;2014;09;10;Tiistai;65;78;143;2;3;5
96;30.09.2014;2014;09;11;Tiistai;100;110;210;9;7;16
96;30.09.2014;2014;09;12;Tiistai;101;105;206;3;8;11
96;30.09.2014;2014;09;13;Tiistai;84;129;213;5;12;17
96;30.09.2014;2014;09;14;Tiistai;94;165;259;9;19;28
96;30.09.2014;2014;09;15;Tiistai;110;285;395;6;22;28
96;30.09.2014;2014;09;16;Tiistai;159;249;408;10;17;27
96;30.09.2014;2014;09;17;Tiistai;87;130;217;3;17;20
96;30.09.2014;2014;09;18;Tiistai;81;113;194;11;17;28
96;30.09.2014;2014;09;19;Tiistai;65;61;126;12;16;28
96;30.09.2014;2014;09;20;Tiistai;55;44;99;11;10;21
96;30.09.2014;2014;09;21;Tiistai;83;33;116;17;7;24
96;30.09.2014;2014;09;22;Tiistai;13;10;23;2;6;8
96;30.09.2014;2014;09;23;Tiistai;8;4;12;3;0;3
96;01.10.2014;2014;10;00;Keskiviikko;1;1;2;0;0;0
96;01.10.2014;2014;10;01;Keskiviikko;2;1;3;0;0;0
96;01.10.2014;2014;10;02;Keskiviikko;2;0;2;0;0;0
96;01.10.2014;2014;10;03;Keskiviikko;0;0;0;0;0;0
96;01.10.2014;2014;10;04;Keskiviikko;1;1;2;1;2;3
96;01.10.2014;2014;10;05;Keskiviikko;3;8;11;1;0;1
96;01.10.2014;2014;10;06;Keskiviikko;52;44;96;1;4;5
96;01.10.2014;2014;10;07;Keskiviikko;165;180;345;21;4;25
96;01.10.2014;2014;10;08;Keskiviikko;138;147;285;12;8;20
96;01.10.2014;2014;10;09;Keskiviikko;145;116;261;14;6;20
96;01.10.2014;2014;10;10;Keskiviikko;83;66;149;5;8;13
96;01.10.2014;2014;10;11;Keskiviikko;100;75;175;8;16;24
96;01.10.2014;2014;10;12;Keskiviikko;88;111;199;13;16;29
96;01.10.2014;2014;10;13;Keskiviikko;65;152;217;9;14;23
96;01.10.2014;2014;10;14;Keskiviikko;88;204;292;7;11;18
96;01.10.2014;2014;10;15;Keskiviikko;142;243;385;5;18;23
96;01.10.2014;2014;10;16;Keskiviikko;139;239;378;10;28;38
96;01.10.2014;2014;10;17;Keskiviikko;102;128;230;8;9;17
96;01.10.2014;2014;10;18;Keskiviikko;115;93;208;19;14;33
96;01.10.2014;2014;10;19;Keskiviikko;58;55;113;10;19;29
96;01.10.2014;2014;10;20;Keskiviikko;59;73;132;7;17;24
96;01.10.2014;2014;10;21;Keskiviikko;29;61;90;4;9;13
96;01.10.2014;2014;10;22;Keskiviikko;11;14;25;2;2;4
96;01.10.2014;2014;10;23;Keskiviikko;4;5;9;2;0;2
96;02.10.2014;2014;10;00;Torstai;4;2;6;1;1;2
96;02.10.2014;2014;10;01;Torstai;2;1;3;0;1;1
96;02.10.2014;2014;10;02;Torstai;2;0;2;0;0;0
96;02.10.2014;2014;10;03;Torstai;3;0;3;0;0;0
96;02.10.2014;2014;10;04;Torstai;5;2;7;1;0;1
96;02.10.2014;2014;10;05;Torstai;1;7;8;2;0;2
96;02.10.2014;2014;10;06;Torstai;43;37;80;0;1;1
96;02.10.2014;2014;10;07;Torstai;164;144;308;11;9;20
96;02.10.2014;2014;10;08;Torstai;156;118;274;19;13;32
96;02.10.2014;2014;10;09;Torstai;112;84;196;11;10;21
96;02.10.2014;2014;10;10;Torstai;90;75;165;15;12;27
96;02.10.2014;2014;10;11;Torstai;67;100;167;5;6;11
96;02.10.2014;2014;10;12;Torstai;67;78;145;10;9;19
96;02.10.2014;2014;10;13;Torstai;55;126;181;5;14;19
96;02.10.2014;2014;10;14;Torstai;97;171;268;4;14;18
96;02.10.2014;2014;10;15;Torstai;100;227;327;3;8;11
96;02.10.2014;2014;10;16;Torstai;132;183;315;6;17;23
96;02.10.2014;2014;10;17;Torstai;82;92;174;11;14;25
96;02.10.2014;2014;10;18;Torstai;78;98;176;15;11;26
96;02.10.2014;2014;10;19;Torstai;74;49;123;11;20;31
96;02.10.2014;2014;10;20;Torstai;69;37;106;9;11;20
96;02.10.2014;2014;10;21;Torstai;25;38;63;3;4;7
96;02.10.2014;2014;10;22;Torstai;15;20;35;3;6;9
96;02.10.2014;2014;10;23;Torstai;3;3;6;1;1;2
96;03.10.2014;2014;10;00;Perjantai;4;5;9;1;0;1
96;03.10.2014;2014;10;01;Perjantai;4;1;5;1;0;1
96;03.10.2014;2014;10;02;Perjantai;6;0;6;0;0;0
96;03.10.2014;2014;10;03;Perjantai;1;3;4;0;0;0
96;03.10.2014;2014;10;04;Perjantai;0;3;3;0;0;0
96;03.10.2014;2014;10;05;Perjantai;3;7;10;2;0;2
96;03.10.2014;2014;10;06;Perjantai;48;29;77;3;3;6
96;03.10.2014;2014;10;07;Perjantai;145;123;268;13;6;19
96;03.10.2014;2014;10;08;Perjantai;161;99;260;8;5;13
96;03.10.2014;2014;10;09;Perjantai;64;108;172;5;5;10
96;03.10.2014;2014;10;10;Perjantai;57;78;135;3;7;10
96;03.10.2014;2014;10;11;Perjantai;69;104;173;3;8;11
96;03.10.2014;2014;10;12;Perjantai;110;135;245;10;14;24
96;03.10.2014;2014;10;13;Perjantai;79;141;220;8;15;23
96;03.10.2014;2014;10;14;Perjantai;100;185;285;7;22;29
96;03.10.2014;2014;10;15;Perjantai;98;211;309;6;21;27
96;03.10.2014;2014;10;16;Perjantai;115;106;221;7;17;24
96;03.10.2014;2014;10;17;Perjantai;69;60;129;9;11;20
96;03.10.2014;2014;10;18;Perjantai;63;41;104;21;9;30
96;03.10.2014;2014;10;19;Perjantai;33;42;75;6;9;15
96;03.10.2014;2014;10;20;Perjantai;36;42;78;3;12;15
96;03.10.2014;2014;10;21;Perjantai;32;31;63;1;2;3
96;03.10.2014;2014;10;22;Perjantai;15;22;37;4;7;11
96;03.10.2014;2014;10;23;Perjantai;13;13;26;2;2;4
96;04.10.2014;2014;10;00;Lauantai;16;12;28;3;2;5
96;04.10.2014;2014;10;01;Lauantai;17;6;23;13;2;15
96;04.10.2014;2014;10;02;Lauantai;17;3;20;1;0;1
96;04.10.2014;2014;10;03;Lauantai;15;0;15;2;0;2
96;04.10.2014;2014;10;04;Lauantai;7;1;8;4;0;4
96;04.10.2014;2014;10;05;Lauantai;2;2;4;1;0;1
96;04.10.2014;2014;10;06;Lauantai;11;16;27;2;2;4
96;04.10.2014;2014;10;07;Lauantai;3;15;18;0;2;2
96;04.10.2014;2014;10;08;Lauantai;19;27;46;2;4;6
96;04.10.2014;2014;10;09;Lauantai;18;50;68;6;3;9
96;04.10.2014;2014;10;10;Lauantai;22;51;73;7;6;13
96;04.10.2014;2014;10;11;Lauantai;30;40;70;6;4;10
96;04.10.2014;2014;10;12;Lauantai;52;69;121;9;8;17
96;04.10.2014;2014;10;13;Lauantai;36;54;90;10;7;17
96;04.10.2014;2014;10;14;Lauantai;59;57;116;5;10;15
96;04.10.2014;2014;10;15;Lauantai;53;58;111;10;14;24
96;04.10.2014;2014;10;16;Lauantai;50;52;102;12;14;26
96;04.10.2014;2014;10;17;Lauantai;73;47;120;35;15;50
96;04.10.2014;2014;10;18;Lauantai;39;37;76;5;12;17
96;04.10.2014;2014;10;19;Lauantai;34;25;59;9;17;26
96;04.10.2014;2014;10;20;Lauantai;19;32;51;11;11;22
96;04.10.2014;2014;10;21;Lauantai;16;57;73;9;21;30
96;04.10.2014;2014;10;22;Lauantai;22;22;44;4;14;18
96;04.10.2014;2014;10;23;Lauantai;12;24;36;1;3;4
96;05.10.2014;2014;10;00;Sunnuntai;13;8;21;2;0;2
96;05.10.2014;2014;10;01;Sunnuntai;9;5;14;2;0;2
96;05.10.2014;2014;10;02;Sunnuntai;13;4;17;4;0;4
96;05.10.2014;2014;10;03;Sunnuntai;22;1;23;1;0;1
96;05.10.2014;2014;10;04;Sunnuntai;11;2;13;2;0;2
96;05.10.2014;2014;10;05;Sunnuntai;1;2;3;1;0;1
96;05.10.2014;2014;10;06;Sunnuntai;11;5;16;2;2;4
96;05.10.2014;2014;10;07;Sunnuntai;7;16;23;0;4;4
96;05.10.2014;2014;10;08;Sunnuntai;8;13;21;7;5;12
96;05.10.2014;2014;10;09;Sunnuntai;18;13;31;2;8;10
96;05.10.2014;2014;10;10;Sunnuntai;18;22;40;4;5;9
96;05.10.2014;2014;10;11;Sunnuntai;27;33;60;6;6;12
96;05.10.2014;2014;10;12;Sunnuntai;41;38;79;6;12;18
96;05.10.2014;2014;10;13;Sunnuntai;42;65;107;10;14;24
96;05.10.2014;2014;10;14;Sunnuntai;42;56;98;5;10;15
96;05.10.2014;2014;10;15;Sunnuntai;40;51;91;11;15;26
96;05.10.2014;2014;10;16;Sunnuntai;75;49;124;27;7;34
96;05.10.2014;2014;10;17;Sunnuntai;35;46;81;14;12;26
96;05.10.2014;2014;10;18;Sunnuntai;36;41;77;19;32;51
96;05.10.2014;2014;10;19;Sunnuntai;40;32;72;15;14;29
96;05.10.2014;2014;10;20;Sunnuntai;26;60;86;12;25;37
96;05.10.2014;2014;10;21;Sunnuntai;15;26;41;4;7;11
96;05.10.2014;2014;10;22;Sunnuntai;7;11;18;1;0;1
96;05.10.2014;2014;10;23;Sunnuntai;14;6;20;2;0;2
96;06.10.2014;2014;10;00;Maanantai;0;3;3;0;0;0
96;06.10.2014;2014;10;01;Maanantai;0;0;0;0;0;0
96;06.10.2014;2014;10;02;Maanantai;0;0;0;1;0;1
96;06.10.2014;2014;10;03;Maanantai;2;0;2;0;0;0
96;06.10.2014;2014;10;04;Maanantai;1;2;3;0;1;1
96;06.10.2014;2014;10;05;Maanantai;6;5;11;1;0;1
96;06.10.2014;2014;10;06;Maanantai;49;40;89;4;1;5
96;06.10.2014;2014;10;07;Maanantai;147;141;288;15;5;20
96;06.10.2014;2014;10;08;Maanantai;156;110;266;10;7;17
96;06.10.2014;2014;10;09;Maanantai;106;105;211;15;13;28
96;06.10.2014;2014;10;10;Maanantai;61;83;144;11;9;20
96;06.10.2014;2014;10;11;Maanantai;67;92;159;9;8;17
96;06.10.2014;2014;10;12;Maanantai;78;99;177;9;9;18
96;06.10.2014;2014;10;13;Maanantai;78;94;172;8;10;18
96;06.10.2014;2014;10;14;Maanantai;88;156;244;6;14;20
96;06.10.2014;2014;10;15;Maanantai;88;278;366;8;23;31
96;06.10.2014;2014;10;16;Maanantai;135;187;322;9;16;25
96;06.10.2014;2014;10;17;Maanantai;88;87;175;9;10;19
96;06.10.2014;2014;10;18;Maanantai;79;75;154;13;16;29
96;06.10.2014;2014;10;19;Maanantai;51;40;91;5;19;24
96;06.10.2014;2014;10;20;Maanantai;51;48;99;5;6;11
96;06.10.2014;2014;10;21;Maanantai;31;30;61;1;1;2
96;06.10.2014;2014;10;22;Maanantai;12;10;22;4;5;9
96;06.10.2014;2014;10;23;Maanantai;2;4;6;0;1;1
96;07.10.2014;2014;10;00;Tiistai;4;0;4;2;2;4
96;07.10.2014;2014;10;01;Tiistai;0;0;0;1;0;1
96;07.10.2014;2014;10;02;Tiistai;1;0;1;0;1;1
96;07.10.2014;2014;10;03;Tiistai;1;1;2;0;0;0
96;07.10.2014;2014;10;04;Tiistai;1;1;2;0;0;0
96;07.10.2014;2014;10;05;Tiistai;4;8;12;0;0;0
96;07.10.2014;2014;10;06;Tiistai;58;40;98;2;3;5
96;07.10.2014;2014;10;07;Tiistai;178;177;355;21;8;29
96;07.10.2014;2014;10;08;Tiistai;125;135;260;6;3;9
96;07.10.2014;2014;10;09;Tiistai;117;104;221;9;9;18
96;07.10.2014;2014;10;10;Tiistai;59;79;138;12;4;16
96;07.10.2014;2014;10;11;Tiistai;90;87;177;5;10;15
96;07.10.2014;2014;10;12;Tiistai;83;93;176;6;12;18
96;07.10.2014;2014;10;13;Tiistai;67;115;182;10;11;21
96;07.10.2014;2014;10;14;Tiistai;88;183;271;4;13;17
96;07.10.2014;2014;10;15;Tiistai;102;268;370;6;19;25
96;07.10.2014;2014;10;16;Tiistai;137;185;322;13;19;32
96;07.10.2014;2014;10;17;Tiistai;80;88;168;14;18;32
96;07.10.2014;2014;10;18;Tiistai;79;100;179;15;16;31
96;07.10.2014;2014;10;19;Tiistai;65;63;128;12;16;28
96;07.10.2014;2014;10;20;Tiistai;56;53;109;7;15;22
96;07.10.2014;2014;10;21;Tiistai;33;50;83;4;2;6
96;07.10.2014;2014;10;22;Tiistai;6;11;17;1;3;4
96;07.10.2014;2014;10;23;Tiistai;6;3;9;0;0;0
96;08.10.2014;2014;10;00;Keskiviikko;1;1;2;0;1;1
96;08.10.2014;2014;10;01;Keskiviikko;1;0;1;0;0;0
96;08.10.2014;2014;10;02;Keskiviikko;1;0;1;0;0;0
96;08.10.2014;2014;10;03;Keskiviikko;0;2;2;0;0;0
96;08.10.2014;2014;10;04;Keskiviikko;2;2;4;0;0;0
96;08.10.2014;2014;10;05;Keskiviikko;6;4;10;0;1;1
96;08.10.2014;2014;10;06;Keskiviikko;57;51;108;1;4;5
96;08.10.2014;2014;10;07;Keskiviikko;177;176;353;15;9;24
96;08.10.2014;2014;10;08;Keskiviikko;143;146;289;25;12;37
96;08.10.2014;2014;10;09;Keskiviikko;123;141;264;13;15;28
96;08.10.2014;2014;10;10;Keskiviikko;66;91;157;8;20;28
96;08.10.2014;2014;10;11;Keskiviikko;89;134;223;21;36;57
96;08.10.2014;2014;10;12;Keskiviikko;104;163;267;9;18;27
96;08.10.2014;2014;10;13;Keskiviikko;94;224;318;16;28;44
96;08.10.2014;2014;10;14;Keskiviikko;121;209;330;17;17;34
96;08.10.2014;2014;10;15;Keskiviikko;109;261;370;14;22;36
96;08.10.2014;2014;10;16;Keskiviikko;143;219;362;19;29;48
96;08.10.2014;2014;10;17;Keskiviikko;129;108;237;10;14;24
96;08.10.2014;2014;10;18;Keskiviikko;118;91;209;12;16;28
96;08.10.2014;2014;10;19;Keskiviikko;74;65;139;8;13;21
96;08.10.2014;2014;10;20;Keskiviikko;68;58;126;6;16;22
96;08.10.2014;2014;10;21;Keskiviikko;30;45;75;4;2;6
96;08.10.2014;2014;10;22;Keskiviikko;10;8;18;0;1;1
96;08.10.2014;2014;10;23;Keskiviikko;5;3;8;0;0;0
96;09.10.2014;2014;10;00;Torstai;0;0;0;0;0;0
96;09.10.2014;2014;10;01;Torstai;1;0;1;0;0;0
96;09.10.2014;2014;10;02;Torstai;0;0;0;1;0;1
96;09.10.2014;2014;10;03;Torstai;2;0;2;0;0;0
96;09.10.2014;2014;10;04;Torstai;6;1;7;0;0;0
96;09.10.2014;2014;10;05;Torstai;4;8;12;1;0;1
96;09.10.2014;2014;10;06;Torstai;51;37;88;2;2;4
96;09.10.2014;2014;10;07;Torstai;166;118;284;16;2;18
96;09.10.2014;2014;10;08;Torstai;120;97;217;4;8;12
96;09.10.2014;2014;10;09;Torstai;98;87;185;11;7;18
96;09.10.2014;2014;10;10;Torstai;56;72;128;6;9;15
96;09.10.2014;2014;10;11;Torstai;63;110;173;9;17;26
96;09.10.2014;2014;10;12;Torstai;99;118;217;15;20;35
96;09.10.2014;2014;10;13;Torstai;79;139;218;11;11;22
96;09.10.2014;2014;10;14;Torstai;86;183;269;8;23;31
96;09.10.2014;2014;10;15;Torstai;89;235;324;4;12;16
96;09.10.2014;2014;10;16;Torstai;111;170;281;7;14;21
96;09.10.2014;2014;10;17;Torstai;83;65;148;7;9;16
96;09.10.2014;2014;10;18;Torstai;57;74;131;6;17;23
96;09.10.2014;2014;10;19;Torstai;36;38;74;6;6;12
96;09.10.2014;2014;10;20;Torstai;32;29;61;10;4;14
96;09.10.2014;2014;10;21;Torstai;26;39;65;0;4;4
96;09.10.2014;2014;10;22;Torstai;9;12;21;0;1;1
96;09.10.2014;2014;10;23;Torstai;1;6;7;1;2;3
96;10.10.2014;2014;10;00;Perjantai;2;2;4;1;0;1
96;10.10.2014;2014;10;01;Perjantai;7;0;7;0;0;0
96;10.10.2014;2014;10;02;Perjantai;10;0;10;0;0;0
96;10.10.2014;2014;10;03;Perjantai;4;2;6;0;0;0
96;10.10.2014;2014;10;04;Perjantai;6;2;8;0;1;1
96;10.10.2014;2014;10;05;Perjantai;3;9;12;2;0;2
96;10.10.2014;2014;10;06;Perjantai;49;28;77;4;2;6
96;10.10.2014;2014;10;07;Perjantai;113;88;201;13;3;16
96;10.10.2014;2014;10;08;Perjantai;107;67;174;7;3;10
96;10.10.2014;2014;10;09;Perjantai;65;70;135;6;1;7
96;10.10.2014;2014;10;10;Perjantai;61;37;98;2;10;12
96;10.10.2014;2014;10;11;Perjantai;35;61;96;1;7;8
96;10.10.2014;2014;10;12;Perjantai;63;65;128;6;7;13
96;10.10.2014;2014;10;13;Perjantai;45;115;160;3;14;17
96;10.10.2014;2014;10;14;Perjantai;55;169;224;2;26;28
96;10.10.2014;2014;10;15;Perjantai;48;143;191;2;20;22
96;10.10.2014;2014;10;16;Perjantai;67;76;143;4;16;20
96;10.10.2014;2014;10;17;Perjantai;40;51;91;4;6;10
96;10.10.2014;2014;10;18;Perjantai;33;45;78;3;10;13
96;10.10.2014;2014;10;19;Perjantai;25;22;47;3;7;10
96;10.10.2014;2014;10;20;Perjantai;43;11;54;8;2;10
96;10.10.2014;2014;10;21;Perjantai;24;26;50;2;5;7
96;10.10.2014;2014;10;22;Perjantai;11;12;23;0;2;2
96;10.10.2014;2014;10;23;Perjantai;11;7;18;0;1;1
96;11.10.2014;2014;10;00;Lauantai;6;6;12;3;0;3
96;11.10.2014;2014;10;01;Lauantai;7;2;9;1;1;2
96;11.10.2014;2014;10;02;Lauantai;8;1;9;2;0;2
96;11.10.2014;2014;10;03;Lauantai;7;1;8;0;0;0
96;11.10.2014;2014;10;04;Lauantai;7;3;10;1;3;4
96;11.10.2014;2014;10;05;Lauantai;0;4;4;1;4;5
96;11.10.2014;2014;10;06;Lauantai;8;12;20;1;1;2
96;11.10.2014;2014;10;07;Lauantai;5;18;23;1;2;3
96;11.10.2014;2014;10;08;Lauantai;11;21;32;4;3;7
96;11.10.2014;2014;10;09;Lauantai;15;45;60;1;8;9
96;11.10.2014;2014;10;10;Lauantai;24;44;68;4;16;20
96;11.10.2014;2014;10;11;Lauantai;38;55;93;7;34;41
96;11.10.2014;2014;10;12;Lauantai;57;63;120;12;24;36
96;11.10.2014;2014;10;13;Lauantai;45;56;101;26;16;42
96;11.10.2014;2014;10;14;Lauantai;56;57;113;19;7;26
96;11.10.2014;2014;10;15;Lauantai;57;44;101;14;10;24
96;11.10.2014;2014;10;16;Lauantai;40;53;93;11;2;13
96;11.10.2014;2014;10;17;Lauantai;42;30;72;8;5;13
96;11.10.2014;2014;10;18;Lauantai;52;14;66;10;3;13
96;11.10.2014;2014;10;19;Lauantai;24;18;42;9;6;15
96;11.10.2014;2014;10;20;Lauantai;15;27;42;4;12;16
96;11.10.2014;2014;10;21;Lauantai;15;26;41;3;7;10
96;11.10.2014;2014;10;22;Lauantai;10;7;17;0;0;0
96;11.10.2014;2014;10;23;Lauantai;3;9;12;4;2;6
96;12.10.2014;2014;10;00;Sunnuntai;7;13;20;0;2;2
96;12.10.2014;2014;10;01;Sunnuntai;12;4;16;1;0;1
96;12.10.2014;2014;10;02;Sunnuntai;7;3;10;1;0;1
96;12.10.2014;2014;10;03;Sunnuntai;10;2;12;1;0;1
96;12.10.2014;2014;10;04;Sunnuntai;7;1;8;3;0;3
96;12.10.2014;2014;10;05;Sunnuntai;1;0;1;2;1;3
96;12.10.2014;2014;10;06;Sunnuntai;12;9;21;0;1;1
96;12.10.2014;2014;10;07;Sunnuntai;7;15;22;1;4;5
96;12.10.2014;2014;10;08;Sunnuntai;4;6;10;2;2;4
96;12.10.2014;2014;10;09;Sunnuntai;7;13;20;4;3;7
96;12.10.2014;2014;10;10;Sunnuntai;14;25;39;2;8;10
96;12.10.2014;2014;10;11;Sunnuntai;21;64;85;15;61;76
96;12.10.2014;2014;10;12;Sunnuntai;37;66;103;19;25;44
96;12.10.2014;2014;10;13;Sunnuntai;54;40;94;35;15;50
96;12.10.2014;2014;10;14;Sunnuntai;40;48;88;26;7;33
96;12.10.2014;2014;10;15;Sunnuntai;47;46;93;18;14;32
96;12.10.2014;2014;10;16;Sunnuntai;71;34;105;18;11;29
96;12.10.2014;2014;10;17;Sunnuntai;52;35;87;10;11;21
96;12.10.2014;2014;10;18;Sunnuntai;30;45;75;21;17;38
96;12.10.2014;2014;10;19;Sunnuntai;27;34;61;11;21;32
96;12.10.2014;2014;10;20;Sunnuntai;18;25;43;13;10;23
96;12.10.2014;2014;10;21;Sunnuntai;9;16;25;2;6;8
96;12.10.2014;2014;10;22;Sunnuntai;11;5;16;4;3;7
96;12.10.2014;2014;10;23;Sunnuntai;4;4;8;3;0;3
96;13.10.2014;2014;10;00;Maanantai;2;2;4;0;0;0
96;13.10.2014;2014;10;01;Maanantai;2;0;2;0;0;0
96;13.10.2014;2014;10;02;Maanantai;3;0;3;0;0;0
96;13.10.2014;2014;10;03;Maanantai;1;1;2;0;0;0
96;13.10.2014;2014;10;04;Maanantai;4;1;5;0;0;0
96;13.10.2014;2014;10;05;Maanantai;4;9;13;0;0;0
96;13.10.2014;2014;10;06;Maanantai;46;43;89;3;0;3
96;13.10.2014;2014;10;07;Maanantai;151;124;275;15;6;21
96;13.10.2014;2014;10;08;Maanantai;148;110;258;15;8;23
96;13.10.2014;2014;10;09;Maanantai;94;80;174;13;7;20
96;13.10.2014;2014;10;10;Maanantai;57;56;113;7;10;17
96;13.10.2014;2014;10;11;Maanantai;51;86;137;8;8;16
96;13.10.2014;2014;10;12;Maanantai;83;80;163;13;10;23
96;13.10.2014;2014;10;13;Maanantai;72;100;172;8;13;21
96;13.10.2014;2014;10;14;Maanantai;75;161;236;9;21;30
96;13.10.2014;2014;10;15;Maanantai;109;260;369;6;19;25
96;13.10.2014;2014;10;16;Maanantai;122;189;311;9;17;26
96;13.10.2014;2014;10;17;Maanantai;89;73;162;14;6;20
96;13.10.2014;2014;10;18;Maanantai;60;56;116;17;15;32
96;13.10.2014;2014;10;19;Maanantai;62;47;109;4;16;20
96;13.10.2014;2014;10;20;Maanantai;34;51;85;9;13;22
96;13.10.2014;2014;10;21;Maanantai;24;28;52;2;5;7
96;13.10.2014;2014;10;22;Maanantai;3;4;7;2;2;4
96;13.10.2014;2014;10;23;Maanantai;1;2;3;0;1;1
96;14.10.2014;2014;10;00;Tiistai;3;1;4;1;0;1
96;14.10.2014;2014;10;01;Tiistai;0;0;0;1;1;2
96;14.10.2014;2014;10;02;Tiistai;0;0;0;0;0;0
96;14.10.2014;2014;10;03;Tiistai;1;0;1;0;0;0
96;14.10.2014;2014;10;04;Tiistai;1;2;3;1;1;2
96;14.10.2014;2014;10;05;Tiistai;4;10;14;0;0;0
96;14.10.2014;2014;10;06;Tiistai;59;44;103;7;1;8
96;14.10.2014;2014;10;07;Tiistai;165;133;298;19;9;28
96;14.10.2014;2014;10;08;Tiistai;143;127;270;10;4;14
96;14.10.2014;2014;10;09;Tiistai;98;78;176;17;8;25
96;14.10.2014;2014;10;10;Tiistai;59;44;103;7;6;13
96;14.10.2014;2014;10;11;Tiistai;60;75;135;10;17;27
96;14.10.2014;2014;10;12;Tiistai;67;96;163;11;20;31
96;14.10.2014;2014;10;13;Tiistai;81;83;164;14;12;26
96;14.10.2014;2014;10;14;Tiistai;74;159;233;5;20;25
96;14.10.2014;2014;10;15;Tiistai;102;247;349;5;17;22
96;14.10.2014;2014;10;16;Tiistai;124;203;327;12;22;34
96;14.10.2014;2014;10;17;Tiistai;81;103;184;12;26;38
96;14.10.2014;2014;10;18;Tiistai;56;84;140;20;23;43
96;14.10.2014;2014;10;19;Tiistai;49;51;100;8;18;26
96;14.10.2014;2014;10;20;Tiistai;81;31;112;15;11;26
96;14.10.2014;2014;10;21;Tiistai;28;30;58;8;4;12
96;14.10.2014;2014;10;22;Tiistai;13;6;19;1;3;4
96;14.10.2014;2014;10;23;Tiistai;4;1;5;0;4;4
96;15.10.2014;2014;10;00;Keskiviikko;1;2;3;1;2;3
96;15.10.2014;2014;10;01;Keskiviikko;3;1;4;0;0;0
96;15.10.2014;2014;10;02;Keskiviikko;1;0;1;0;0;0
96;15.10.2014;2014;10;03;Keskiviikko;1;0;1;0;0;0
96;15.10.2014;2014;10;04;Keskiviikko;1;2;3;0;0;0
96;15.10.2014;2014;10;05;Keskiviikko;5;6;11;0;0;0
96;15.10.2014;2014;10;06;Keskiviikko;40;39;79;5;1;6
96;15.10.2014;2014;10;07;Keskiviikko;144;139;283;20;7;27
96;15.10.2014;2014;10;08;Keskiviikko;111;104;215;18;11;29
96;15.10.2014;2014;10;09;Keskiviikko;107;78;185;16;7;23
96;15.10.2014;2014;10;10;Keskiviikko;62;48;110;7;7;14
96;15.10.2014;2014;10;11;Keskiviikko;90;83;173;9;9;18
96;15.10.2014;2014;10;12;Keskiviikko;64;90;154;9;12;21
96;15.10.2014;2014;10;13;Keskiviikko;65;107;172;4;19;23
96;15.10.2014;2014;10;14;Keskiviikko;77;177;254;11;17;28
96;15.10.2014;2014;10;15;Keskiviikko;78;218;296;6;28;34
96;15.10.2014;2014;10;16;Keskiviikko;108;177;285;16;34;50
96;15.10.2014;2014;10;17;Keskiviikko;60;99;159;14;16;30
96;15.10.2014;2014;10;18;Keskiviikko;84;73;157;20;24;44
96;15.10.2014;2014;10;19;Keskiviikko;40;39;79;13;17;30
96;15.10.2014;2014;10;20;Keskiviikko;58;26;84;12;10;22
96;15.10.2014;2014;10;21;Keskiviikko;51;35;86;9;9;18
96;15.10.2014;2014;10;22;Keskiviikko;8;5;13;2;0;2
96;15.10.2014;2014;10;23;Keskiviikko;3;3;6;0;1;1
96;16.10.2014;2014;10;00;Torstai;3;1;4;2;0;2
96;16.10.2014;2014;10;01;Torstai;2;1;3;0;0;0
96;16.10.2014;2014;10;02;Torstai;5;0;5;0;0;0
96;16.10.2014;2014;10;03;Torstai;0;0;0;0;0;0
96;16.10.2014;2014;10;04;Torstai;2;1;3;1;1;2
96;16.10.2014;2014;10;05;Torstai;4;6;10;0;0;0
96;16.10.2014;2014;10;06;Torstai;44;31;75;3;3;6
96;16.10.2014;2014;10;07;Torstai;136;132;268;17;4;21
96;16.10.2014;2014;10;08;Torstai;117;93;210;13;9;22
96;16.10.2014;2014;10;09;Torstai;100;76;176;10;6;16
96;16.10.2014;2014;10;10;Torstai;67;51;118;19;12;31
96;16.10.2014;2014;10;11;Torstai;67;82;149;11;13;24
96;16.10.2014;2014;10;12;Torstai;68;79;147;10;16;26
96;16.10.2014;2014;10;13;Torstai;57;112;169;10;16;26
96;16.10.2014;2014;10;14;Torstai;65;173;238;10;14;24
96;16.10.2014;2014;10;15;Torstai;101;240;341;8;27;35
96;16.10.2014;2014;10;16;Torstai;114;178;292;4;23;27
96;16.10.2014;2014;10;17;Torstai;59;90;149;13;14;27
96;16.10.2014;2014;10;18;Torstai;60;83;143;9;18;27
96;16.10.2014;2014;10;19;Torstai;66;28;94;10;13;23
96;16.10.2014;2014;10;20;Torstai;46;39;85;7;12;19
96;16.10.2014;2014;10;21;Torstai;27;46;73;4;8;12
96;16.10.2014;2014;10;22;Torstai;15;12;27;0;1;1
96;16.10.2014;2014;10;23;Torstai;12;3;15;5;6;11
96;17.10.2014;2014;10;00;Perjantai;2;3;5;0;1;1
96;17.10.2014;2014;10;01;Perjantai;6;2;8;1;0;1
96;17.10.2014;2014;10;02;Perjantai;2;1;3;0;0;0
96;17.10.2014;2014;10;03;Perjantai;7;0;7;0;1;1
96;17.10.2014;2014;10;04;Perjantai;4;1;5;0;2;2
96;17.10.2014;2014;10;05;Perjantai;3;9;12;1;1;2
96;17.10.2014;2014;10;06;Perjantai;52;44;96;6;0;6
96;17.10.2014;2014;10;07;Perjantai;147;100;247;20;7;27
96;17.10.2014;2014;10;08;Perjantai;113;94;207;10;9;19
96;17.10.2014;2014;10;09;Perjantai;59;79;138;10;4;14
96;17.10.2014;2014;10;10;Perjantai;52;45;97;5;7;12
96;17.10.2014;2014;10;11;Perjantai;44;78;122;8;11;19
96;17.10.2014;2014;10;12;Perjantai;68;111;179;4;17;21
96;17.10.2014;2014;10;13;Perjantai;77;114;191;7;20;27
96;17.10.2014;2014;10;14;Perjantai;81;189;270;4;22;26
96;17.10.2014;2014;10;15;Perjantai;84;162;246;17;26;43
96;17.10.2014;2014;10;16;Perjantai;81;101;182;5;10;15
96;17.10.2014;2014;10;17;Perjantai;52;64;116;9;16;25
96;17.10.2014;2014;10;18;Perjantai;35;34;69;13;4;17
96;17.10.2014;2014;10;19;Perjantai;34;28;62;3;8;11
96;17.10.2014;2014;10;20;Perjantai;28;15;43;3;3;6
96;17.10.2014;2014;10;21;Perjantai;16;27;43;3;6;9
96;17.10.2014;2014;10;22;Perjantai;15;5;20;1;2;3
96;17.10.2014;2014;10;23;Perjantai;13;8;21;1;0;1
96;18.10.2014;2014;10;00;Lauantai;8;6;14;0;1;1
96;18.10.2014;2014;10;01;Lauantai;7;2;9;1;0;1
96;18.10.2014;2014;10;02;Lauantai;6;2;8;4;1;5
96;18.10.2014;2014;10;03;Lauantai;9;1;10;0;0;0
96;18.10.2014;2014;10;04;Lauantai;0;0;0;0;1;1
96;18.10.2014;2014;10;05;Lauantai;1;0;1;3;3;6
96;18.10.2014;2014;10;06;Lauantai;9;9;18;3;1;4
96;18.10.2014;2014;10;07;Lauantai;5;11;16;2;4;6
96;18.10.2014;2014;10;08;Lauantai;9;12;21;1;4;5
96;18.10.2014;2014;10;09;Lauantai;10;36;46;3;7;10
96;18.10.2014;2014;10;10;Lauantai;18;32;50;11;7;18
96;18.10.2014;2014;10;11;Lauantai;24;39;63;4;7;11
96;18.10.2014;2014;10;12;Lauantai;32;38;70;7;11;18
96;18.10.2014;2014;10;13;Lauantai;40;44;84;6;10;16
96;18.10.2014;2014;10;14;Lauantai;38;44;82;14;7;21
96;18.10.2014;2014;10;15;Lauantai;30;42;72;4;7;11
96;18.10.2014;2014;10;16;Lauantai;38;33;71;6;7;13
96;18.10.2014;2014;10;17;Lauantai;36;30;66;5;11;16
96;18.10.2014;2014;10;18;Lauantai;37;20;57;13;4;17
96;18.10.2014;2014;10;19;Lauantai;18;16;34;6;4;10
96;18.10.2014;2014;10;20;Lauantai;13;24;37;4;8;12
96;18.10.2014;2014;10;21;Lauantai;15;30;45;2;4;6
96;18.10.2014;2014;10;22;Lauantai;15;17;32;2;1;3
96;18.10.2014;2014;10;23;Lauantai;6;6;12;3;2;5
96;19.10.2014;2014;10;00;Sunnuntai;6;5;11;1;0;1
96;19.10.2014;2014;10;01;Sunnuntai;2;1;3;1;0;1
96;19.10.2014;2014;10;02;Sunnuntai;5;0;5;0;0;0
96;19.10.2014;2014;10;03;Sunnuntai;7;0;7;1;0;1
96;19.10.2014;2014;10;04;Sunnuntai;7;0;7;0;1;1
96;19.10.2014;2014;10;05;Sunnuntai;3;1;4;2;2;4
96;19.10.2014;2014;10;06;Sunnuntai;19;5;24;1;1;2
96;19.10.2014;2014;10;07;Sunnuntai;1;8;9;1;3;4
96;19.10.2014;2014;10;08;Sunnuntai;2;6;8;0;4;4
96;19.10.2014;2014;10;09;Sunnuntai;3;5;8;2;1;3
96;19.10.2014;2014;10;10;Sunnuntai;4;6;10;8;8;16
96;19.10.2014;2014;10;11;Sunnuntai;9;14;23;2;6;8
96;19.10.2014;2014;10;12;Sunnuntai;18;16;34;7;9;16
96;19.10.2014;2014;10;13;Sunnuntai;18;12;30;6;4;10
96;19.10.2014;2014;10;14;Sunnuntai;20;18;38;4;11;15
96;19.10.2014;2014;10;15;Sunnuntai;12;23;35;9;3;12
96;19.10.2014;2014;10;16;Sunnuntai;35;18;53;9;7;16
96;19.10.2014;2014;10;17;Sunnuntai;14;23;37;6;7;13
96;19.10.2014;2014;10;18;Sunnuntai;15;26;41;6;7;13
96;19.10.2014;2014;10;19;Sunnuntai;18;14;32;7;8;15
96;19.10.2014;2014;10;20;Sunnuntai;17;17;34;7;5;12
96;19.10.2014;2014;10;21;Sunnuntai;15;21;36;0;6;6
96;19.10.2014;2014;10;22;Sunnuntai;8;6;14;2;2;4
96;19.10.2014;2014;10;23;Sunnuntai;4;4;8;2;0;2
96;20.10.2014;2014;10;00;Maanantai;2;1;3;0;0;0
96;20.10.2014;2014;10;01;Maanantai;1;0;1;0;1;1
96;20.10.2014;2014;10;02;Maanantai;2;0;2;0;0;0
96;20.10.2014;2014;10;03;Maanantai;1;1;2;1;1;2
96;20.10.2014;2014;10;04;Maanantai;5;2;7;1;0;1
96;20.10.2014;2014;10;05;Maanantai;4;3;7;2;1;3
96;20.10.2014;2014;10;06;Maanantai;39;35;74;2;2;4
96;20.10.2014;2014;10;07;Maanantai;75;58;133;12;6;18
96;20.10.2014;2014;10;08;Maanantai;57;52;109;4;6;10
96;20.10.2014;2014;10;09;Maanantai;23;36;59;5;12;17
96;20.10.2014;2014;10;10;Maanantai;21;43;64;2;3;5
96;20.10.2014;2014;10;11;Maanantai;23;71;94;5;13;18
96;20.10.2014;2014;10;12;Maanantai;46;58;104;9;11;20
96;20.10.2014;2014;10;13;Maanantai;47;76;123;4;14;18
96;20.10.2014;2014;10;14;Maanantai;51;84;135;8;11;19
96;20.10.2014;2014;10;15;Maanantai;66;132;198;6;21;27
96;20.10.2014;2014;10;16;Maanantai;92;88;180;3;17;20
96;20.10.2014;2014;10;17;Maanantai;82;42;124;10;8;18
96;20.10.2014;2014;10;18;Maanantai;43;41;84;8;4;12
96;20.10.2014;2014;10;19;Maanantai;28;24;52;6;8;14
96;20.10.2014;2014;10;20;Maanantai;27;19;46;8;6;14
96;20.10.2014;2014;10;21;Maanantai;17;18;35;3;5;8
96;20.10.2014;2014;10;22;Maanantai;7;5;12;5;1;6
96;20.10.2014;2014;10;23;Maanantai;5;1;6;1;1;2
96;21.10.2014;2014;10;00;Tiistai;1;1;2;0;0;0
96;21.10.2014;2014;10;01;Tiistai;2;0;2;0;0;0
96;21.10.2014;2014;10;02;Tiistai;1;2;3;0;0;0
96;21.10.2014;2014;10;03;Tiistai;2;0;2;0;0;0
96;21.10.2014;2014;10;04;Tiistai;1;1;2;0;1;1
96;21.10.2014;2014;10;05;Tiistai;5;8;13;0;0;0
96;21.10.2014;2014;10;06;Tiistai;33;26;59;7;1;8
96;21.10.2014;2014;10;07;Tiistai;77;67;144;18;7;25
96;21.10.2014;2014;10;08;Tiistai;37;55;92;5;8;13
96;21.10.2014;2014;10;09;Tiistai;28;43;71;4;9;13
96;21.10.2014;2014;10;10;Tiistai;24;48;72;1;6;7
96;21.10.2014;2014;10;11;Tiistai;33;66;99;5;14;19
96;21.10.2014;2014;10;12;Tiistai;43;46;89;2;5;7
96;21.10.2014;2014;10;13;Tiistai;42;64;106;6;12;18
96;21.10.2014;2014;10;14;Tiistai;57;78;135;4;12;16
96;21.10.2014;2014;10;15;Tiistai;82;134;216;4;26;30
96;21.10.2014;2014;10;16;Tiistai;66;93;159;10;24;34
96;21.10.2014;2014;10;17;Tiistai;56;56;112;7;14;21
96;21.10.2014;2014;10;18;Tiistai;48;48;96;8;29;37
96;21.10.2014;2014;10;19;Tiistai;46;28;74;14;23;37
96;21.10.2014;2014;10;20;Tiistai;42;21;63;13;8;21
96;21.10.2014;2014;10;21;Tiistai;27;28;55;5;1;6
96;21.10.2014;2014;10;22;Tiistai;11;3;14;0;1;1
96;21.10.2014;2014;10;23;Tiistai;5;4;9;3;1;4
96;22.10.2014;2014;10;00;Keskiviikko;0;2;2;0;0;0
96;22.10.2014;2014;10;01;Keskiviikko;3;1;4;1;0;1
96;22.10.2014;2014;10;02;Keskiviikko;1;1;2;0;0;0
96;22.10.2014;2014;10;03;Keskiviikko;1;0;1;0;0;0
96;22.10.2014;2014;10;04;Keskiviikko;1;2;3;0;0;0
96;22.10.2014;2014;10;05;Keskiviikko;4;9;13;0;1;1
96;22.10.2014;2014;10;06;Keskiviikko;47;34;81;4;2;6
96;22.10.2014;2014;10;07;Keskiviikko;74;65;139;11;6;17
96;22.10.2014;2014;10;08;Keskiviikko;55;55;110;3;4;7
96;22.10.2014;2014;10;09;Keskiviikko;26;42;68;4;11;15
96;22.10.2014;2014;10;10;Keskiviikko;30;37;67;11;11;22
96;22.10.2014;2014;10;11;Keskiviikko;29;38;67;7;11;18
96;22.10.2014;2014;10;12;Keskiviikko;41;42;83;6;9;15
96;22.10.2014;2014;10;13;Keskiviikko;42;64;106;1;4;5
96;22.10.2014;2014;10;14;Keskiviikko;52;62;114;3;13;16
96;22.10.2014;2014;10;15;Keskiviikko;65;138;203;5;23;28
96;22.10.2014;2014;10;16;Keskiviikko;59;89;148;8;11;19
96;22.10.2014;2014;10;17;Keskiviikko;54;51;105;8;7;15
96;22.10.2014;2014;10;18;Keskiviikko;54;36;90;6;14;20
96;22.10.2014;2014;10;19;Keskiviikko;34;23;57;12;10;22
96;22.10.2014;2014;10;20;Keskiviikko;29;24;53;7;17;24
96;22.10.2014;2014;10;21;Keskiviikko;13;23;36;7;2;9
96;22.10.2014;2014;10;22;Keskiviikko;6;2;8;1;2;3
96;22.10.2014;2014;10;23;Keskiviikko;7;5;12;0;3;3
96;23.10.2014;2014;10;00;Torstai;0;0;0;2;1;3
96;23.10.2014;2014;10;01;Torstai;0;0;0;1;2;3
96;23.10.2014;2014;10;02;Torstai;0;1;1;0;1;1
96;23.10.2014;2014;10;03;Torstai;2;0;2;1;0;1
96;23.10.2014;2014;10;04;Torstai;3;1;4;0;1;1
96;23.10.2014;2014;10;05;Torstai;2;6;8;1;1;2
96;23.10.2014;2014;10;06;Torstai;42;22;64;12;1;13
96;23.10.2014;2014;10;07;Torstai;68;63;131;15;8;23
96;23.10.2014;2014;10;08;Torstai;44;44;88;3;6;9
96;23.10.2014;2014;10;09;Torstai;21;30;51;5;13;18
96;23.10.2014;2014;10;10;Torstai;27;33;60;4;3;7
96;23.10.2014;2014;10;11;Torstai;28;31;59;6;8;14
96;23.10.2014;2014;10;12;Torstai;40;32;72;7;13;20
96;23.10.2014;2014;10;13;Torstai;38;32;70;8;10;18
96;23.10.2014;2014;10;14;Torstai;37;69;106;5;10;15
96;23.10.2014;2014;10;15;Torstai;60;114;174;5;22;27
96;23.10.2014;2014;10;16;Torstai;47;92;139;7;16;23
96;23.10.2014;2014;10;17;Torstai;47;48;95;9;5;14
96;23.10.2014;2014;10;18;Torstai;42;31;73;8;7;15
96;23.10.2014;2014;10;19;Torstai;33;30;63;4;3;7
96;23.10.2014;2014;10;20;Torstai;27;27;54;7;2;9
96;23.10.2014;2014;10;21;Torstai;7;27;34;0;5;5
96;23.10.2014;2014;10;22;Torstai;2;3;5;0;1;1
96;23.10.2014;2014;10;23;Torstai;4;5;9;1;1;2
96;24.10.2014;2014;10;00;Perjantai;0;1;1;0;0;0
96;24.10.2014;2014;10;01;Perjantai;0;0;0;0;0;0
96;24.10.2014;2014;10;02;Perjantai;5;0;5;0;0;0
96;24.10.2014;2014;10;03;Perjantai;4;0;4;0;0;0
96;24.10.2014;2014;10;04;Perjantai;4;2;6;0;1;1
96;24.10.2014;2014;10;05;Perjantai;6;4;10;1;0;1
96;24.10.2014;2014;10;06;Perjantai;57;24;81;9;3;12
96;24.10.2014;2014;10;07;Perjantai;51;41;92;12;8;20
96;24.10.2014;2014;10;08;Perjantai;39;18;57;5;4;9
96;24.10.2014;2014;10;09;Perjantai;29;11;40;4;3;7
96;24.10.2014;2014;10;10;Perjantai;34;5;39;4;3;7
96;24.10.2014;2014;10;11;Perjantai;42;9;51;6;4;10
96;24.10.2014;2014;10;12;Perjantai;48;9;57;10;8;18
96;24.10.2014;2014;10;13;Perjantai;75;2;77;6;2;8
96;24.10.2014;2014;10;14;Perjantai;98;3;101;14;8;22
96;24.10.2014;2014;10;15;Perjantai;100;24;124;16;8;24
96;24.10.2014;2014;10;16;Perjantai;45;30;75;10;5;15
96;24.10.2014;2014;10;17;Perjantai;24;22;46;8;4;12
96;24.10.2014;2014;10;18;Perjantai;21;18;39;6;3;9
96;24.10.2014;2014;10;19;Perjantai;13;11;24;4;2;6
96;24.10.2014;2014;10;20;Perjantai;13;11;24;2;1;3
96;24.10.2014;2014;10;21;Perjantai;10;10;20;0;0;0
96;24.10.2014;2014;10;22;Perjantai;2;2;4;0;0;0
96;24.10.2014;2014;10;23;Perjantai;3;0;3;0;0;0
96;25.10.2014;2014;10;00;Lauantai;1;1;2;0;0;0
96;25.10.2014;2014;10;01;Lauantai;1;0;1;0;0;0
96;25.10.2014;2014;10;02;Lauantai;3;0;3;0;0;0
96;25.10.2014;2014;10;03;Lauantai;4;3;7;0;0;0
96;25.10.2014;2014;10;04;Lauantai;1;0;1;0;0;0
96;25.10.2014;2014;10;05;Lauantai;1;1;2;0;0;0
96;25.10.2014;2014;10;06;Lauantai;17;1;18;2;0;2
96;25.10.2014;2014;10;07;Lauantai;3;7;10;2;6;8
96;25.10.2014;2014;10;08;Lauantai;5;7;12;5;3;8
96;25.10.2014;2014;10;09;Lauantai;10;7;17;3;2;5
96;25.10.2014;2014;10;10;Lauantai;7;6;13;3;1;4
96;25.10.2014;2014;10;11;Lauantai;13;11;24;1;2;3
96;25.10.2014;2014;10;12;Lauantai;11;14;25;4;4;8
96;25.10.2014;2014;10;13;Lauantai;17;13;30;4;2;6
96;25.10.2014;2014;10;14;Lauantai;27;10;37;1;3;4
96;25.10.2014;2014;10;15;Lauantai;13;21;34;5;3;8
96;25.10.2014;2014;10;16;Lauantai;15;14;29;2;2;4
96;25.10.2014;2014;10;17;Lauantai;14;11;25;7;3;10
96;25.10.2014;2014;10;18;Lauantai;9;8;17;2;2;4
96;25.10.2014;2014;10;19;Lauantai;10;9;19;8;1;9
96;25.10.2014;2014;10;20;Lauantai;5;6;11;4;1;5
96;25.10.2014;2014;10;21;Lauantai;3;14;17;3;4;7
96;25.10.2014;2014;10;22;Lauantai;7;2;9;1;3;4
96;25.10.2014;2014;10;23;Lauantai;1;9;10;1;0;1
96;26.10.2014;2014;10;00;Sunnuntai;3;3;6;2;0;2
96;26.10.2014;2014;10;01;Sunnuntai;3;1;4;0;0;0
96;26.10.2014;2014;10;02;Sunnuntai;1;1;2;1;1;2
96;26.10.2014;2014;10;03;Sunnuntai;6;0;6;1;0;1
96;26.10.2014;2014;10;04;Sunnuntai;1;0;1;0;0;0
96;26.10.2014;2014;10;05;Sunnuntai;0;1;1;0;0;0
96;26.10.2014;2014;10;06;Sunnuntai;10;2;12;1;0;1
96;26.10.2014;2014;10;07;Sunnuntai;2;5;7;2;6;8
96;26.10.2014;2014;10;08;Sunnuntai;4;6;10;6;6;12
96;26.10.2014;2014;10;09;Sunnuntai;5;8;13;4;5;9
96;26.10.2014;2014;10;10;Sunnuntai;6;11;17;8;7;15
96;26.10.2014;2014;10;11;Sunnuntai;19;14;33;8;7;15
96;26.10.2014;2014;10;12;Sunnuntai;24;24;48;7;6;13
96;26.10.2014;2014;10;13;Sunnuntai;27;17;44;12;9;21
96;26.10.2014;2014;10;14;Sunnuntai;26;24;50;11;9;20
96;26.10.2014;2014;10;15;Sunnuntai;19;25;44;9;6;15
96;26.10.2014;2014;10;16;Sunnuntai;33;21;54;7;2;9
96;26.10.2014;2014;10;17;Sunnuntai;22;20;42;12;3;15
96;26.10.2014;2014;10;18;Sunnuntai;27;22;49;6;16;22
96;26.10.2014;2014;10;19;Sunnuntai;8;12;20;8;12;20
96;26.10.2014;2014;10;20;Sunnuntai;14;33;47;7;6;13
96;26.10.2014;2014;10;21;Sunnuntai;17;16;33;5;6;11
96;26.10.2014;2014;10;22;Sunnuntai;2;4;6;4;2;6
96;26.10.2014;2014;10;23;Sunnuntai;3;2;5;2;3;5
96;27.10.2014;2014;10;00;Maanantai;1;1;2;2;0;2
96;27.10.2014;2014;10;01;Maanantai;2;0;2;0;1;1
96;27.10.2014;2014;10;02;Maanantai;2;0;2;0;0;0
96;27.10.2014;2014;10;03;Maanantai;1;0;1;1;0;1
96;27.10.2014;2014;10;04;Maanantai;2;2;4;0;0;0
96;27.10.2014;2014;10;05;Maanantai;5;3;8;0;0;0
96;27.10.2014;2014;10;06;Maanantai;47;39;86;5;1;6
96;27.10.2014;2014;10;07;Maanantai;137;125;262;20;6;26
96;27.10.2014;2014;10;08;Maanantai;102;117;219;10;5;15
96;27.10.2014;2014;10;09;Maanantai;91;71;162;15;11;26
96;27.10.2014;2014;10;10;Maanantai;41;53;94;8;6;14
96;27.10.2014;2014;10;11;Maanantai;47;68;115;7;12;19
96;27.10.2014;2014;10;12;Maanantai;62;71;133;9;14;23
96;27.10.2014;2014;10;13;Maanantai;62;99;161;10;19;29
96;27.10.2014;2014;10;14;Maanantai;56;136;192;6;22;28
96;27.10.2014;2014;10;15;Maanantai;89;227;316;12;23;35
96;27.10.2014;2014;10;16;Maanantai;121;183;304;13;26;39
96;27.10.2014;2014;10;17;Maanantai;59;62;121;17;18;35
96;27.10.2014;2014;10;18;Maanantai;68;63;131;22;29;51
96;27.10.2014;2014;10;19;Maanantai;53;35;88;12;16;28
96;27.10.2014;2014;10;20;Maanantai;43;37;80;8;11;19
96;27.10.2014;2014;10;21;Maanantai;27;33;60;5;1;6
96;27.10.2014;2014;10;22;Maanantai;8;6;14;1;0;1
96;27.10.2014;2014;10;23;Maanantai;5;0;5;2;1;3
96;28.10.2014;2014;10;00;Tiistai;1;0;1;0;0;0
96;28.10.2014;2014;10;01;Tiistai;0;0;0;0;0;0
96;28.10.2014;2014;10;02;Tiistai;0;2;2;0;0;0
96;28.10.2014;2014;10;03;Tiistai;0;0;0;0;0;0
96;28.10.2014;2014;10;04;Tiistai;2;1;3;1;0;1
96;28.10.2014;2014;10;05;Tiistai;2;9;11;1;0;1
96;28.10.2014;2014;10;06;Tiistai;58;48;106;7;3;10
96;28.10.2014;2014;10;07;Tiistai;151;138;289;28;8;36
96;28.10.2014;2014;10;08;Tiistai;113;127;240;9;8;17
96;28.10.2014;2014;10;09;Tiistai;111;87;198;15;9;24
96;28.10.2014;2014;10;10;Tiistai;38;43;81;9;7;16
96;28.10.2014;2014;10;11;Tiistai;63;69;132;10;9;19
96;28.10.2014;2014;10;12;Tiistai;61;96;157;12;18;30
96;28.10.2014;2014;10;13;Tiistai;54;84;138;5;6;11
96;28.10.2014;2014;10;14;Tiistai;53;137;190;6;13;19
96;28.10.2014;2014;10;15;Tiistai;92;227;319;6;23;29
96;28.10.2014;2014;10;16;Tiistai;91;165;256;14;14;28
96;28.10.2014;2014;10;17;Tiistai;66;90;156;13;13;26
96;28.10.2014;2014;10;18;Tiistai;42;84;126;13;22;35
96;28.10.2014;2014;10;19;Tiistai;67;38;105;14;14;28
96;28.10.2014;2014;10;20;Tiistai;65;44;109;16;10;26
96;28.10.2014;2014;10;21;Tiistai;39;27;66;5;7;12
96;28.10.2014;2014;10;22;Tiistai;16;12;28;3;2;5
96;28.10.2014;2014;10;23;Tiistai;4;1;5;2;1;3
96;29.10.2014;2014;10;00;Keskiviikko;1;1;2;0;0;0
96;29.10.2014;2014;10;01;Keskiviikko;0;0;0;0;0;0
96;29.10.2014;2014;10;02;Keskiviikko;3;0;3;0;0;0
96;29.10.2014;2014;10;03;Keskiviikko;6;0;6;0;1;1
96;29.10.2014;2014;10;04;Keskiviikko;6;2;8;0;0;0
96;29.10.2014;2014;10;05;Keskiviikko;1;6;7;1;0;1
96;29.10.2014;2014;10;06;Keskiviikko;49;40;89;11;2;13
96;29.10.2014;2014;10;07;Keskiviikko;130;110;240;22;4;26
96;29.10.2014;2014;10;08;Keskiviikko;112;76;188;16;3;19
96;29.10.2014;2014;10;09;Keskiviikko;93;55;148;8;8;16
96;29.10.2014;2014;10;10;Keskiviikko;46;64;110;12;9;21
96;29.10.2014;2014;10;11;Keskiviikko;59;74;133;13;9;22
96;29.10.2014;2014;10;12;Keskiviikko;64;69;133;11;10;21
96;29.10.2014;2014;10;13;Keskiviikko;52;79;131;5;20;25
96;29.10.2014;2014;10;14;Keskiviikko;90;146;236;12;19;31
96;29.10.2014;2014;10;15;Keskiviikko;61;220;281;13;24;37
96;29.10.2014;2014;10;16;Keskiviikko;88;157;245;15;30;45
96;29.10.2014;2014;10;17;Keskiviikko;56;75;131;10;13;23
96;29.10.2014;2014;10;18;Keskiviikko;101;62;163;26;17;43
96;29.10.2014;2014;10;19;Keskiviikko;60;37;97;21;19;40
96;29.10.2014;2014;10;20;Keskiviikko;41;73;114;7;11;18
96;29.10.2014;2014;10;21;Keskiviikko;19;43;62;4;6;10
96;29.10.2014;2014;10;22;Keskiviikko;9;8;17;2;1;3
96;29.10.2014;2014;10;23;Keskiviikko;3;6;9;4;2;6
96;30.10.2014;2014;10;00;Torstai;2;3;5;1;1;2
96;30.10.2014;2014;10;01;Torstai;1;0;1;0;0;0
96;30.10.2014;2014;10;02;Torstai;0;1;1;0;0;0
96;30.10.2014;2014;10;03;Torstai;2;0;2;0;0;0
96;30.10.2014;2014;10;04;Torstai;3;2;5;0;0;0
96;30.10.2014;2014;10;05;Torstai;5;5;10;2;0;2
96;30.10.2014;2014;10;06;Torstai;46;50;96;7;3;10
96;30.10.2014;2014;10;07;Torstai;120;110;230;12;14;26
96;30.10.2014;2014;10;08;Torstai;121;100;221;10;10;20
96;30.10.2014;2014;10;09;Torstai;90;101;191;8;9;17
96;30.10.2014;2014;10;10;Torstai;75;55;130;7;6;13
96;30.10.2014;2014;10;11;Torstai;59;95;154;6;10;16
96;30.10.2014;2014;10;12;Torstai;57;91;148;6;9;15
96;30.10.2014;2014;10;13;Torstai;68;90;158;7;7;14
96;30.10.2014;2014;10;14;Torstai;76;164;240;8;18;26
96;30.10.2014;2014;10;15;Torstai;90;227;317;14;27;41
96;30.10.2014;2014;10;16;Torstai;80;180;260;16;19;35
96;30.10.2014;2014;10;17;Torstai;80;80;160;7;9;16
96;30.10.2014;2014;10;18;Torstai;65;55;120;10;6;16
96;30.10.2014;2014;10;19;Torstai;55;50;105;6;7;13
96;30.10.2014;2014;10;20;Torstai;50;35;85;8;2;10
96;30.10.2014;2014;10;21;Torstai;25;30;55;2;4;6
96;30.10.2014;2014;10;22;Torstai;6;8;14;0;0;0
96;30.10.2014;2014;10;23;Torstai;3;5;8;0;0;0
96;31.10.2014;2014;10;00;Perjantai;2;1;3;0;0;0
96;31.10.2014;2014;10;01;Perjantai;1;2;3;0;0;0
96;31.10.2014;2014;10;02;Perjantai;2;1;3;0;0;0
96;31.10.2014;2014;10;03;Perjantai;1;0;1;0;0;0
96;31.10.2014;2014;10;04;Perjantai;2;2;4;0;0;0
96;31.10.2014;2014;10;05;Perjantai;4;5;9;0;0;0
96;31.10.2014;2014;10;06;Perjantai;50;20;70;5;9;14
96;31.10.2014;2014;10;07;Perjantai;130;80;210;11;18;29
96;31.10.2014;2014;10;08;Perjantai;115;80;195;9;6;15
96;31.10.2014;2014;10;09;Perjantai;75;70;145;15;11;26
96;31.10.2014;2014;10;10;Perjantai;40;50;90;7;7;14
96;31.10.2014;2014;10;11;Perjantai;60;70;130;5;8;13
96;31.10.2014;2014;10;12;Perjantai;61;100;161;9;14;23
96;31.10.2014;2014;10;13;Perjantai;60;100;160;9;9;18
96;31.10.2014;2014;10;14;Perjantai;68;180;248;6;16;22
96;31.10.2014;2014;10;15;Perjantai;90;150;240;8;9;17
96;31.10.2014;2014;10;16;Perjantai;65;80;145;6;8;14
96;31.10.2014;2014;10;17;Perjantai;55;40;95;5;4;9
96;31.10.2014;2014;10;18;Perjantai;30;37;67;6;3;9
96;31.10.2014;2014;10;19;Perjantai;33;27;60;4;2;6
96;31.10.2014;2014;10;20;Perjantai;32;20;52;3;3;6
96;31.10.2014;2014;10;21;Perjantai;15;22;37;3;1;4
96;31.10.2014;2014;10;22;Perjantai;9;10;19;1;1;2
96;31.10.2014;2014;10;23;Perjantai;8;8;16;1;0;1
96;01.11.2014;2014;11;00;Lauantai;5;11;16;1;0;1
96;01.11.2014;2014;11;01;Lauantai;8;2;10;1;0;1
96;01.11.2014;2014;11;02;Lauantai;12;1;13;0;0;0
96;01.11.2014;2014;11;03;Lauantai;11;0;11;1;0;1
96;01.11.2014;2014;11;04;Lauantai;5;1;6;1;0;1
96;01.11.2014;2014;11;05;Lauantai;2;1;3;0;0;0
96;01.11.2014;2014;11;06;Lauantai;10;8;18;2;1;3
96;01.11.2014;2014;11;07;Lauantai;7;10;17;1;2;3
96;01.11.2014;2014;11;08;Lauantai;9;16;25;1;3;4
96;01.11.2014;2014;11;09;Lauantai;12;20;32;3;4;7
96;01.11.2014;2014;11;10;Lauantai;16;28;44;3;4;7
96;01.11.2014;2014;11;11;Lauantai;28;25;53;4;3;7
96;01.11.2014;2014;11;12;Lauantai;40;35;75;5;8;13
96;01.11.2014;2014;11;13;Lauantai;22;30;52;8;4;12
96;01.11.2014;2014;11;14;Lauantai;30;35;65;6;7;13
96;01.11.2014;2014;11;15;Lauantai;29;40;69;5;4;9
96;01.11.2014;2014;11;16;Lauantai;40;50;90;9;16;25
96;01.11.2014;2014;11;17;Lauantai;33;33;66;5;5;10
96;01.11.2014;2014;11;18;Lauantai;25;20;45;4;6;10
96;01.11.2014;2014;11;19;Lauantai;33;35;68;7;6;13
96;01.11.2014;2014;11;20;Lauantai;15;21;36;2;3;5
96;01.11.2014;2014;11;21;Lauantai;9;20;29;1;1;2
96;01.11.2014;2014;11;22;Lauantai;6;13;19;0;1;1
96;01.11.2014;2014;11;23;Lauantai;7;8;15;0;0;0
96;02.11.2014;2014;11;00;Sunnuntai;5;5;10;0;0;0
96;02.11.2014;2014;11;01;Sunnuntai;8;2;10;0;0;0
96;02.11.2014;2014;11;02;Sunnuntai;9;7;16;0;1;1
96;02.11.2014;2014;11;03;Sunnuntai;6;2;8;0;0;0
96;02.11.2014;2014;11;04;Sunnuntai;1;1;2;1;0;1
96;02.11.2014;2014;11;05;Sunnuntai;0;0;0;0;0;0
96;02.11.2014;2014;11;06;Sunnuntai;0;0;0;0;0;0
96;02.11.2014;2014;11;07;Sunnuntai;0;2;2;0;0;0
96;02.11.2014;2014;11;08;Sunnuntai;2;4;6;0;2;2
96;02.11.2014;2014;11;09;Sunnuntai;4;6;10;1;1;2
96;02.11.2014;2014;11;10;Sunnuntai;6;8;14;1;1;2
96;02.11.2014;2014;11;11;Sunnuntai;8;10;18;2;2;4
96;02.11.2014;2014;11;12;Sunnuntai;10;12;22;1;3;4
96;02.11.2014;2014;11;13;Sunnuntai;10;14;24;1;1;2
96;02.11.2014;2014;11;14;Sunnuntai;12;16;28;1;2;3
96;02.11.2014;2014;11;15;Sunnuntai;14;16;30;2;5;7
96;02.11.2014;2014;11;16;Sunnuntai;26;15;41;5;3;8
96;02.11.2014;2014;11;17;Sunnuntai;10;7;17;1;2;3
96;02.11.2014;2014;11;18;Sunnuntai;16;20;36;4;3;7
96;02.11.2014;2014;11;19;Sunnuntai;11;15;26;1;1;2
96;02.11.2014;2014;11;20;Sunnuntai;14;25;39;0;4;4
96;02.11.2014;2014;11;21;Sunnuntai;9;12;21;1;1;2
96;02.11.2014;2014;11;22;Sunnuntai;3;8;11;0;0;0
96;02.11.2014;2014;11;23;Sunnuntai;0;1;1;0;0;0
96;08.12.2014;2014;12;00;Maanantai;3;0;3;0;0;0
96;08.12.2014;2014;12;01;Maanantai;2;0;2;0;0;0
96;08.12.2014;2014;12;02;Maanantai;2;0;2;1;0;1
96;08.12.2014;2014;12;03;Maanantai;2;0;2;0;0;0
96;08.12.2014;2014;12;04;Maanantai;4;5;9;0;0;0
96;08.12.2014;2014;12;05;Maanantai;2;2;4;0;0;0
96;08.12.2014;2014;12;06;Maanantai;47;32;79;6;6;12
96;08.12.2014;2014;12;07;Maanantai;116;81;197;21;9;30
96;08.12.2014;2014;12;08;Maanantai;78;74;152;9;5;14
96;08.12.2014;2014;12;09;Maanantai;78;56;134;7;16;23
96;08.12.2014;2014;12;10;Maanantai;53;74;127;9;7;16
96;08.12.2014;2014;12;11;Maanantai;58;45;103;9;5;14
96;08.12.2014;2014;12;12;Maanantai;61;86;147;8;15;23
96;08.12.2014;2014;12;13;Maanantai;48;53;101;8;18;26
96;08.12.2014;2014;12;14;Maanantai;64;91;155;7;22;29
96;08.12.2014;2014;12;15;Maanantai;61;183;244;16;34;50
96;08.12.2014;2014;12;16;Maanantai;72;138;210;19;36;55
96;08.12.2014;2014;12;17;Maanantai;41;52;93;13;18;31
96;08.12.2014;2014;12;18;Maanantai;56;49;105;20;16;36
96;08.12.2014;2014;12;19;Maanantai;52;28;80;15;23;38
96;08.12.2014;2014;12;20;Maanantai;35;40;75;9;13;22
96;08.12.2014;2014;12;21;Maanantai;22;28;50;2;9;11
96;08.12.2014;2014;12;22;Maanantai;9;11;20;4;2;6
96;08.12.2014;2014;12;23;Maanantai;4;1;5;0;3;3
96;09.12.2014;2014;12;00;Tiistai;1;0;1;0;0;0
96;09.12.2014;2014;12;01;Tiistai;2;0;2;1;0;1
96;09.12.2014;2014;12;02;Tiistai;0;1;1;1;0;1
96;09.12.2014;2014;12;03;Tiistai;2;0;2;0;0;0
96;09.12.2014;2014;12;04;Tiistai;1;2;3;0;1;1
96;09.12.2014;2014;12;05;Tiistai;7;3;10;1;1;2
96;09.12.2014;2014;12;06;Tiistai;37;40;77;10;2;12
96;09.12.2014;2014;12;07;Tiistai;105;108;213;25;12;37
96;09.12.2014;2014;12;08;Tiistai;106;83;189;15;9;24
96;09.12.2014;2014;12;09;Tiistai;67;62;129;15;15;30
96;09.12.2014;2014;12;10;Tiistai;52;34;86;9;8;17
96;09.12.2014;2014;12;11;Tiistai;58;52;110;18;7;25
96;09.12.2014;2014;12;12;Tiistai;47;58;105;9;18;27
96;09.12.2014;2014;12;13;Tiistai;53;67;120;11;23;34
96;09.12.2014;2014;12;14;Tiistai;70;111;181;12;19;31
96;09.12.2014;2014;12;15;Tiistai;65;169;234;9;34;43
96;09.12.2014;2014;12;16;Tiistai;90;139;229;21;35;56
96;09.12.2014;2014;12;17;Tiistai;40;57;97;13;23;36
96;09.12.2014;2014;12;18;Tiistai;44;77;121;19;22;41
96;09.12.2014;2014;12;19;Tiistai;44;23;67;11;17;28
96;09.12.2014;2014;12;20;Tiistai;52;38;90;15;4;19
96;09.12.2014;2014;12;21;Tiistai;30;22;52;2;4;6
96;09.12.2014;2014;12;22;Tiistai;9;9;18;2;1;3
96;09.12.2014;2014;12;23;Tiistai;5;5;10;2;1;3
96;10.12.2014;2014;12;00;Keskiviikko;3;3;6;2;1;3
96;10.12.2014;2014;12;01;Keskiviikko;0;2;2;0;0;0
96;10.12.2014;2014;12;02;Keskiviikko;3;2;5;0;0;0
96;10.12.2014;2014;12;03;Keskiviikko;3;0;3;2;1;3
96;10.12.2014;2014;12;04;Keskiviikko;3;2;5;0;1;1
96;10.12.2014;2014;12;05;Keskiviikko;3;3;6;0;1;1
96;10.12.2014;2014;12;06;Keskiviikko;35;36;71;6;3;9
96;10.12.2014;2014;12;07;Keskiviikko;102;100;202;29;10;39
96;10.12.2014;2014;12;08;Keskiviikko;97;85;182;9;16;25
96;10.12.2014;2014;12;09;Keskiviikko;87;62;149;19;14;33
96;10.12.2014;2014;12;10;Keskiviikko;48;43;91;12;7;19
96;10.12.2014;2014;12;11;Keskiviikko;58;47;105;18;15;33
96;10.12.2014;2014;12;12;Keskiviikko;62;70;132;10;10;20
96;10.12.2014;2014;12;13;Keskiviikko;52;95;147;5;20;25
96;10.12.2014;2014;12;14;Keskiviikko;58;118;176;8;23;31
96;10.12.2014;2014;12;15;Keskiviikko;80;168;248;6;37;43
96;10.12.2014;2014;12;16;Keskiviikko;68;139;207;9;20;29
96;10.12.2014;2014;12;17;Keskiviikko;43;58;101;9;17;26
96;10.12.2014;2014;12;18;Keskiviikko;48;32;80;17;9;26
96;10.12.2014;2014;12;19;Keskiviikko;40;26;66;9;13;22
96;10.12.2014;2014;12;20;Keskiviikko;34;50;84;7;8;15
96;10.12.2014;2014;12;21;Keskiviikko;17;21;38;1;6;7
96;10.12.2014;2014;12;22;Keskiviikko;9;9;18;1;0;1
96;10.12.2014;2014;12;23;Keskiviikko;2;3;5;0;1;1
96;11.12.2014;2014;12;00;Torstai;1;1;2;0;0;0
96;11.12.2014;2014;12;01;Torstai;2;1;3;0;0;0
96;11.12.2014;2014;12;02;Torstai;3;2;5;0;0;0
96;11.12.2014;2014;12;03;Torstai;1;1;2;0;1;1
96;11.12.2014;2014;12;04;Torstai;2;1;3;0;1;1
96;11.12.2014;2014;12;05;Torstai;5;4;9;0;0;0
96;11.12.2014;2014;12;06;Torstai;32;23;55;4;3;7
96;11.12.2014;2014;12;07;Torstai;98;86;184;12;11;23
96;11.12.2014;2014;12;08;Torstai;77;56;133;6;7;13
96;11.12.2014;2014;12;09;Torstai;69;52;121;11;7;18
96;11.12.2014;2014;12;10;Torstai;54;62;116;7;7;14
96;11.12.2014;2014;12;11;Torstai;64;56;120;13;9;22
96;11.12.2014;2014;12;12;Torstai;43;43;86;8;8;16
96;11.12.2014;2014;12;13;Torstai;47;76;123;9;12;21
96;11.12.2014;2014;12;14;Torstai;45;150;195;8;16;24
96;11.12.2014;2014;12;15;Torstai;76;152;228;10;37;47
96;11.12.2014;2014;12;16;Torstai;80;118;198;14;30;44
96;11.12.2014;2014;12;17;Torstai;52;53;105;13;13;26
96;11.12.2014;2014;12;18;Torstai;43;54;97;12;14;26
96;11.12.2014;2014;12;19;Torstai;36;33;69;7;7;14
96;11.12.2014;2014;12;20;Torstai;37;22;59;7;6;13
96;11.12.2014;2014;12;21;Torstai;23;19;42;4;4;8
96;11.12.2014;2014;12;22;Torstai;8;6;14;3;2;5
96;11.12.2014;2014;12;23;Torstai;4;3;7;2;0;2
96;12.12.2014;2014;12;00;Perjantai;5;2;7;0;0;0
96;12.12.2014;2014;12;01;Perjantai;2;0;2;0;0;0
96;12.12.2014;2014;12;02;Perjantai;5;1;6;1;1;2
96;12.12.2014;2014;12;03;Perjantai;2;1;3;1;0;1
96;12.12.2014;2014;12;04;Perjantai;5;1;6;1;0;1
96;12.12.2014;2014;12;05;Perjantai;1;5;6;2;0;2
96;12.12.2014;2014;12;06;Perjantai;32;37;69;13;3;16
96;12.12.2014;2014;12;07;Perjantai;98;64;162;18;12;30
96;12.12.2014;2014;12;08;Perjantai;56;52;108;8;5;13
96;12.12.2014;2014;12;09;Perjantai;58;63;121;7;8;15
96;12.12.2014;2014;12;10;Perjantai;46;56;102;7;8;15
96;12.12.2014;2014;12;11;Perjantai;53;65;118;9;13;22
96;12.12.2014;2014;12;12;Perjantai;51;82;133;1;11;12
96;12.12.2014;2014;12;13;Perjantai;49;95;144;13;13;26
96;12.12.2014;2014;12;14;Perjantai;52;136;188;11;28;39
96;12.12.2014;2014;12;15;Perjantai;70;124;194;6;20;26
96;12.12.2014;2014;12;16;Perjantai;56;65;121;5;18;23
96;12.12.2014;2014;12;17;Perjantai;36;28;64;8;4;12
96;12.12.2014;2014;12;18;Perjantai;35;29;64;7;8;15
96;12.12.2014;2014;12;19;Perjantai;18;26;44;7;11;18
96;12.12.2014;2014;12;20;Perjantai;23;13;36;6;3;9
96;12.12.2014;2014;12;21;Perjantai;24;16;40;7;4;11
96;12.12.2014;2014;12;22;Perjantai;5;14;19;2;2;4
96;12.12.2014;2014;12;23;Perjantai;12;14;26;2;0;2
96;13.12.2014;2014;12;00;Lauantai;6;2;8;0;2;2
96;13.12.2014;2014;12;01;Lauantai;10;2;12;1;2;3
96;13.12.2014;2014;12;02;Lauantai;11;1;12;1;0;1
96;13.12.2014;2014;12;03;Lauantai;11;3;14;0;0;0
96;13.12.2014;2014;12;04;Lauantai;8;1;9;5;2;7
96;13.12.2014;2014;12;05;Lauantai;2;5;7;1;0;1
96;13.12.2014;2014;12;06;Lauantai;15;8;23;6;2;8
96;13.12.2014;2014;12;07;Lauantai;6;8;14;1;4;5
96;13.12.2014;2014;12;08;Lauantai;4;10;14;0;4;4
96;13.12.2014;2014;12;09;Lauantai;11;26;37;7;6;13
96;13.12.2014;2014;12;10;Lauantai;11;24;35;6;9;15
96;13.12.2014;2014;12;11;Lauantai;28;27;55;8;5;13
96;13.12.2014;2014;12;12;Lauantai;27;29;56;12;10;22
96;13.12.2014;2014;12;13;Lauantai;34;37;71;7;10;17
96;13.12.2014;2014;12;14;Lauantai;35;41;76;8;18;26
96;13.12.2014;2014;12;15;Lauantai;22;35;57;6;16;22
96;13.12.2014;2014;12;16;Lauantai;24;57;81;3;13;16
96;13.12.2014;2014;12;17;Lauantai;25;17;42;6;5;11
96;13.12.2014;2014;12;18;Lauantai;30;31;61;9;13;22
96;13.12.2014;2014;12;19;Lauantai;35;18;53;14;12;26
96;13.12.2014;2014;12;20;Lauantai;17;11;28;5;4;9
96;13.12.2014;2014;12;21;Lauantai;9;26;35;5;12;17
96;13.12.2014;2014;12;22;Lauantai;8;8;16;1;2;3
96;13.12.2014;2014;12;23;Lauantai;7;4;11;6;2;8
96;14.12.2014;2014;12;00;Sunnuntai;10;7;17;7;0;7
96;14.12.2014;2014;12;01;Sunnuntai;4;1;5;0;0;0
96;14.12.2014;2014;12;02;Sunnuntai;7;2;9;1;0;1
96;14.12.2014;2014;12;03;Sunnuntai;16;1;17;4;1;5
96;14.12.2014;2014;12;04;Sunnuntai;12;2;14;5;2;7
96;14.12.2014;2014;12;05;Sunnuntai;2;3;5;1;0;1
96;14.12.2014;2014;12;06;Sunnuntai;19;4;23;4;2;6
96;14.12.2014;2014;12;07;Sunnuntai;3;10;13;0;5;5
96;14.12.2014;2014;12;08;Sunnuntai;6;6;12;2;1;3
96;14.12.2014;2014;12;09;Sunnuntai;5;8;13;7;3;10
96;14.12.2014;2014;12;10;Sunnuntai;7;20;27;8;9;17
96;14.12.2014;2014;12;11;Sunnuntai;7;21;28;13;13;26
96;14.12.2014;2014;12;12;Sunnuntai;22;23;45;10;17;27
96;14.12.2014;2014;12;13;Sunnuntai;20;35;55;13;14;27
96;14.12.2014;2014;12;14;Sunnuntai;23;42;65;10;15;25
96;14.12.2014;2014;12;15;Sunnuntai;21;28;49;4;9;13
96;14.12.2014;2014;12;16;Sunnuntai;43;17;60;17;13;30
96;14.12.2014;2014;12;17;Sunnuntai;22;19;41;17;7;24
96;14.12.2014;2014;12;18;Sunnuntai;31;34;65;20;25;45
96;14.12.2014;2014;12;19;Sunnuntai;10;20;30;8;19;27
96;14.12.2014;2014;12;20;Sunnuntai;24;16;40;12;11;23
96;14.12.2014;2014;12;21;Sunnuntai;16;15;31;0;5;5
96;14.12.2014;2014;12;22;Sunnuntai;8;4;12;0;0;0
96;14.12.2014;2014;12;23;Sunnuntai;3;1;4;1;0;1
96;15.12.2014;2014;12;00;Maanantai;4;0;4;0;1;1
96;15.12.2014;2014;12;01;Maanantai;1;0;1;0;0;0
96;15.12.2014;2014;12;02;Maanantai;1;0;1;1;0;1
96;15.12.2014;2014;12;03;Maanantai;4;0;4;1;1;2
96;15.12.2014;2014;12;04;Maanantai;3;5;8;1;0;1
96;15.12.2014;2014;12;05;Maanantai;2;7;9;0;1;1
96;15.12.2014;2014;12;06;Maanantai;27;27;54;11;6;17
96;15.12.2014;2014;12;07;Maanantai;98;87;185;22;13;35
96;15.12.2014;2014;12;08;Maanantai;85;80;165;10;11;21
96;15.12.2014;2014;12;09;Maanantai;67;61;128;13;6;19
96;15.12.2014;2014;12;10;Maanantai;41;40;81;5;14;19
96;15.12.2014;2014;12;11;Maanantai;45;64;109;8;9;17
96;15.12.2014;2014;12;12;Maanantai;55;76;131;14;9;23
96;15.12.2014;2014;12;13;Maanantai;77;50;127;9;12;21
96;15.12.2014;2014;12;14;Maanantai;65;102;167;12;27;39
96;15.12.2014;2014;12;15;Maanantai;68;179;247;14;43;57
96;15.12.2014;2014;12;16;Maanantai;84;141;225;11;24;35
96;15.12.2014;2014;12;17;Maanantai;60;52;112;14;13;27
96;15.12.2014;2014;12;18;Maanantai;55;34;89;13;11;24
96;15.12.2014;2014;12;19;Maanantai;45;25;70;9;14;23
96;15.12.2014;2014;12;20;Maanantai;36;15;51;10;8;18
96;15.12.2014;2014;12;21;Maanantai;13;23;36;0;4;4
96;15.12.2014;2014;12;22;Maanantai;8;10;18;2;0;2
96;15.12.2014;2014;12;23;Maanantai;6;1;7;0;1;1
96;16.12.2014;2014;12;00;Tiistai;3;3;6;1;0;1
96;16.12.2014;2014;12;01;Tiistai;1;2;3;1;0;1
96;16.12.2014;2014;12;02;Tiistai;0;2;2;0;1;1
96;16.12.2014;2014;12;03;Tiistai;0;0;0;0;0;0
96;16.12.2014;2014;12;04;Tiistai;1;1;2;0;0;0
96;16.12.2014;2014;12;05;Tiistai;1;5;6;0;2;2
96;16.12.2014;2014;12;06;Tiistai;33;35;68;13;7;20
96;16.12.2014;2014;12;07;Tiistai;110;97;207;29;10;39
96;16.12.2014;2014;12;08;Tiistai;71;71;142;13;10;23
96;16.12.2014;2014;12;09;Tiistai;66;57;123;10;8;18
96;16.12.2014;2014;12;10;Tiistai;50;40;90;5;11;16
96;16.12.2014;2014;12;11;Tiistai;50;46;96;5;7;12
96;16.12.2014;2014;12;12;Tiistai;34;63;97;12;12;24
96;16.12.2014;2014;12;13;Tiistai;48;77;125;13;14;27
96;16.12.2014;2014;12;14;Tiistai;52;90;142;12;24;36
96;16.12.2014;2014;12;15;Tiistai;73;146;219;13;40;53
96;16.12.2014;2014;12;16;Tiistai;105;121;226;15;26;41
96;16.12.2014;2014;12;17;Tiistai;38;60;98;6;12;18
96;16.12.2014;2014;12;18;Tiistai;39;30;69;15;18;33
96;16.12.2014;2014;12;19;Tiistai;27;20;47;11;11;22
96;16.12.2014;2014;12;20;Tiistai;46;19;65;11;12;23
96;16.12.2014;2014;12;21;Tiistai;11;17;28;3;14;17
96;16.12.2014;2014;12;22;Tiistai;11;6;17;3;2;5
96;16.12.2014;2014;12;23;Tiistai;3;1;4;3;0;3
96;17.12.2014;2014;12;00;Keskiviikko;1;0;1;0;0;0
96;17.12.2014;2014;12;01;Keskiviikko;1;1;2;0;0;0
96;17.12.2014;2014;12;02;Keskiviikko;0;1;1;0;1;1
96;17.12.2014;2014;12;03;Keskiviikko;0;0;0;0;0;0
96;17.12.2014;2014;12;04;Keskiviikko;1;1;2;0;1;1
96;17.12.2014;2014;12;05;Keskiviikko;5;6;11;1;1;2
96;17.12.2014;2014;12;06;Keskiviikko;27;31;58;11;5;16
96;17.12.2014;2014;12;07;Keskiviikko;95;95;190;21;13;34
96;17.12.2014;2014;12;08;Keskiviikko;66;74;140;18;17;35
96;17.12.2014;2014;12;09;Keskiviikko;64;48;112;15;14;29
96;17.12.2014;2014;12;10;Keskiviikko;42;47;89;7;10;17
96;17.12.2014;2014;12;11;Keskiviikko;41;52;93;10;16;26
96;17.12.2014;2014;12;12;Keskiviikko;61;59;120;11;14;25
96;17.12.2014;2014;12;13;Keskiviikko;40;64;104;12;17;29
96;17.12.2014;2014;12;14;Keskiviikko;48;97;145;14;21;35
96;17.12.2014;2014;12;15;Keskiviikko;79;138;217;7;40;47
96;17.12.2014;2014;12;16;Keskiviikko;84;118;202;16;28;44
96;17.12.2014;2014;12;17;Keskiviikko;58;53;111;10;8;18
96;17.12.2014;2014;12;18;Keskiviikko;49;48;97;16;16;32
96;17.12.2014;2014;12;19;Keskiviikko;36;34;70;6;14;20
96;17.12.2014;2014;12;20;Keskiviikko;47;46;93;7;9;16
96;17.12.2014;2014;12;21;Keskiviikko;32;23;55;2;4;6
96;17.12.2014;2014;12;22;Keskiviikko;7;9;16;2;1;3
96;17.12.2014;2014;12;23;Keskiviikko;4;1;5;0;0;0
96;18.12.2014;2014;12;00;Torstai;2;1;3;2;0;2
96;18.12.2014;2014;12;01;Torstai;0;0;0;0;0;0
96;18.12.2014;2014;12;02;Torstai;1;0;1;0;0;0
96;18.12.2014;2014;12;03;Torstai;5;0;5;0;0;0
96;18.12.2014;2014;12;04;Torstai;2;2;4;0;1;1
96;18.12.2014;2014;12;05;Torstai;3;8;11;2;0;2
96;18.12.2014;2014;12;06;Torstai;35;31;66;11;5;16
96;18.12.2014;2014;12;07;Torstai;98;87;185;14;10;24
96;18.12.2014;2014;12;08;Torstai;67;64;131;7;12;19
96;18.12.2014;2014;12;09;Torstai;49;41;90;13;4;17
96;18.12.2014;2014;12;10;Torstai;29;45;74;8;10;18
96;18.12.2014;2014;12;11;Torstai;41;70;111;10;16;26
96;18.12.2014;2014;12;12;Torstai;56;60;116;13;11;24
96;18.12.2014;2014;12;13;Torstai;63;63;126;8;23;31
96;18.12.2014;2014;12;14;Torstai;61;90;151;7;27;34
96;18.12.2014;2014;12;15;Torstai;49;142;191;3;36;39
96;18.12.2014;2014;12;16;Torstai;84;111;195;10;26;36
96;18.12.2014;2014;12;17;Torstai;52;57;109;13;17;30
96;18.12.2014;2014;12;18;Torstai;37;34;71;7;13;20
96;18.12.2014;2014;12;19;Torstai;44;22;66;10;12;22
96;18.12.2014;2014;12;20;Torstai;27;17;44;8;5;13
96;18.12.2014;2014;12;21;Torstai;16;19;35;5;3;8
96;18.12.2014;2014;12;22;Torstai;8;11;19;2;3;5
96;18.12.2014;2014;12;23;Torstai;4;11;15;0;2;2
96;19.12.2014;2014;12;00;Perjantai;5;4;9;0;0;0
96;19.12.2014;2014;12;01;Perjantai;2;0;2;0;0;0
96;19.12.2014;2014;12;02;Perjantai;4;1;5;0;0;0
96;19.12.2014;2014;12;03;Perjantai;4;1;5;1;0;1
96;19.12.2014;2014;12;04;Perjantai;6;3;9;1;1;2
96;19.12.2014;2014;12;05;Perjantai;2;5;7;0;0;0
96;19.12.2014;2014;12;06;Perjantai;30;27;57;6;5;11
96;19.12.2014;2014;12;07;Perjantai;91;64;155;11;14;25
96;19.12.2014;2014;12;08;Perjantai;61;61;122;5;7;12
96;19.12.2014;2014;12;09;Perjantai;35;66;101;4;17;21
96;19.12.2014;2014;12;10;Perjantai;40;56;96;1;7;8
96;19.12.2014;2014;12;11;Perjantai;41;73;114;2;14;16
96;19.12.2014;2014;12;12;Perjantai;38;47;85;0;12;12
96;19.12.2014;2014;12;13;Perjantai;35;57;92;5;18;23
96;19.12.2014;2014;12;14;Perjantai;48;106;154;5;22;27
96;19.12.2014;2014;12;15;Perjantai;49;95;144;1;19;20
96;19.12.2014;2014;12;16;Perjantai;44;67;111;2;6;8
96;19.12.2014;2014;12;17;Perjantai;35;41;76;4;6;10
96;19.12.2014;2014;12;18;Perjantai;35;34;69;1;5;6
96;19.12.2014;2014;12;19;Perjantai;28;18;46;4;1;5
96;19.12.2014;2014;12;20;Perjantai;18;11;29;1;4;5
96;19.12.2014;2014;12;21;Perjantai;23;19;42;2;6;8
96;19.12.2014;2014;12;22;Perjantai;13;13;26;1;2;3
96;19.12.2014;2014;12;23;Perjantai;5;4;9;0;2;2
96;20.12.2014;2014;12;00;Lauantai;5;7;12;1;0;1
96;20.12.2014;2014;12;01;Lauantai;8;2;10;1;0;1
96;20.12.2014;2014;12;02;Lauantai;8;5;13;0;0;0
96;20.12.2014;2014;12;03;Lauantai;6;0;6;0;0;0
96;20.12.2014;2014;12;04;Lauantai;4;0;4;2;0;2
96;20.12.2014;2014;12;05;Lauantai;2;3;5;3;2;5
96;20.12.2014;2014;12;06;Lauantai;9;3;12;2;0;2
96;20.12.2014;2014;12;07;Lauantai;4;11;15;0;6;6
96;20.12.2014;2014;12;08;Lauantai;8;24;32;2;5;7
96;20.12.2014;2014;12;09;Lauantai;14;22;36;2;8;10
96;20.12.2014;2014;12;10;Lauantai;16;21;37;1;2;3
96;20.12.2014;2014;12;11;Lauantai;19;24;43;6;5;11
96;20.12.2014;2014;12;12;Lauantai;31;18;49;6;9;15
96;20.12.2014;2014;12;13;Lauantai;17;29;46;7;10;17
96;20.12.2014;2014;12;14;Lauantai;19;25;44;9;5;14
96;20.12.2014;2014;12;15;Lauantai;26;16;42;5;7;12
96;20.12.2014;2014;12;16;Lauantai;22;13;35;6;6;12
96;20.12.2014;2014;12;17;Lauantai;23;16;39;4;1;5
96;20.12.2014;2014;12;18;Lauantai;27;8;35;11;1;12
96;20.12.2014;2014;12;19;Lauantai;14;12;26;5;6;11
96;20.12.2014;2014;12;20;Lauantai;11;16;27;8;5;13
96;20.12.2014;2014;12;21;Lauantai;15;11;26;2;3;5
96;20.12.2014;2014;12;22;Lauantai;5;9;14;0;2;2
96;20.12.2014;2014;12;23;Lauantai;4;2;6;2;1;3
96;21.12.2014;2014;12;00;Sunnuntai;9;7;16;1;0;1
96;21.12.2014;2014;12;01;Sunnuntai;5;1;6;2;2;4
96;21.12.2014;2014;12;02;Sunnuntai;2;1;3;0;0;0
96;21.12.2014;2014;12;03;Sunnuntai;7;1;8;0;1;1
96;21.12.2014;2014;12;04;Sunnuntai;2;0;2;2;0;2
96;21.12.2014;2014;12;05;Sunnuntai;1;0;1;1;1;2
96;21.12.2014;2014;12;06;Sunnuntai;10;3;13;1;0;1
96;21.12.2014;2014;12;07;Sunnuntai;2;7;9;2;4;6
96;21.12.2014;2014;12;08;Sunnuntai;2;11;13;3;5;8
96;21.12.2014;2014;12;09;Sunnuntai;5;9;14;3;5;8
96;21.12.2014;2014;12;10;Sunnuntai;7;14;21;5;4;9
96;21.12.2014;2014;12;11;Sunnuntai;10;16;26;11;7;18
96;21.12.2014;2014;12;12;Sunnuntai;25;20;45;1;9;10
96;21.12.2014;2014;12;13;Sunnuntai;24;13;37;4;13;17
96;21.12.2014;2014;12;14;Sunnuntai;14;18;32;4;4;8
96;21.12.2014;2014;12;15;Sunnuntai;16;23;39;5;4;9
96;21.12.2014;2014;12;16;Sunnuntai;32;12;44;6;5;11
96;21.12.2014;2014;12;17;Sunnuntai;19;20;39;5;3;8
96;21.12.2014;2014;12;18;Sunnuntai;25;9;34;5;12;17
96;21.12.2014;2014;12;19;Sunnuntai;11;11;22;7;11;18
96;21.12.2014;2014;12;20;Sunnuntai;13;20;33;2;3;5
96;21.12.2014;2014;12;21;Sunnuntai;23;12;35;1;4;5
96;21.12.2014;2014;12;22;Sunnuntai;7;4;11;1;0;1
96;21.12.2014;2014;12;23;Sunnuntai;1;2;3;4;3;7
96;22.12.2014;2014;12;00;Maanantai;0;1;1;2;2;4
96;22.12.2014;2014;12;01;Maanantai;0;1;1;0;0;0
96;22.12.2014;2014;12;02;Maanantai;3;0;3;0;0;0
96;22.12.2014;2014;12;03;Maanantai;1;0;1;0;0;0
96;22.12.2014;2014;12;04;Maanantai;2;2;4;0;0;0
96;22.12.2014;2014;12;05;Maanantai;4;5;9;0;1;1
96;22.12.2014;2014;12;06;Maanantai;32;25;57;7;1;8
96;22.12.2014;2014;12;07;Maanantai;52;48;100;5;7;12
96;22.12.2014;2014;12;08;Maanantai;17;30;47;4;2;6
96;22.12.2014;2014;12;09;Maanantai;22;33;55;2;7;9
96;22.12.2014;2014;12;10;Maanantai;17;20;37;7;7;14
96;22.12.2014;2014;12;11;Maanantai;18;23;41;5;13;18
96;22.12.2014;2014;12;12;Maanantai;28;32;60;7;15;22
96;22.12.2014;2014;12;13;Maanantai;33;36;69;2;9;11
96;22.12.2014;2014;12;14;Maanantai;44;52;96;3;5;8
96;22.12.2014;2014;12;15;Maanantai;35;91;126;7;20;27
96;22.12.2014;2014;12;16;Maanantai;42;53;95;6;13;19
96;22.12.2014;2014;12;17;Maanantai;33;35;68;1;4;5
96;22.12.2014;2014;12;18;Maanantai;26;17;43;4;5;9
96;22.12.2014;2014;12;19;Maanantai;21;11;32;3;4;7
96;22.12.2014;2014;12;20;Maanantai;21;13;34;5;3;8
96;22.12.2014;2014;12;21;Maanantai;11;7;18;3;7;10
96;22.12.2014;2014;12;22;Maanantai;2;4;6;1;6;7
96;22.12.2014;2014;12;23;Maanantai;3;3;6;0;0;0
96;23.12.2014;2014;12;00;Tiistai;0;1;1;1;0;1
96;23.12.2014;2014;12;01;Tiistai;1;1;2;0;0;0
96;23.12.2014;2014;12;02;Tiistai;4;1;5;0;2;2
96;23.12.2014;2014;12;03;Tiistai;2;1;3;0;0;0
96;23.12.2014;2014;12;04;Tiistai;6;4;10;0;0;0
96;23.12.2014;2014;12;05;Tiistai;3;4;7;0;0;0
96;23.12.2014;2014;12;06;Tiistai;23;19;42;11;3;14
96;23.12.2014;2014;12;07;Tiistai;48;28;76;16;3;19
96;23.12.2014;2014;12;08;Tiistai;14;22;36;5;6;11
96;23.12.2014;2014;12;09;Tiistai;9;24;33;5;8;13
96;23.12.2014;2014;12;10;Tiistai;19;21;40;4;3;7
96;23.12.2014;2014;12;11;Tiistai;15;26;41;5;8;13
96;23.12.2014;2014;12;12;Tiistai;30;39;69;6;10;16
96;23.12.2014;2014;12;13;Tiistai;33;35;68;6;14;20
96;23.12.2014;2014;12;14;Tiistai;33;53;86;7;19;26
96;23.12.2014;2014;12;15;Tiistai;23;45;68;2;10;12
96;23.12.2014;2014;12;16;Tiistai;14;27;41;3;6;9
96;23.12.2014;2014;12;17;Tiistai;21;3;24;3;3;6
96;23.12.2014;2014;12;18;Tiistai;6;13;19;9;8;17
96;23.12.2014;2014;12;19;Tiistai;6;10;16;5;6;11
96;23.12.2014;2014;12;20;Tiistai;12;8;20;5;5;10
96;23.12.2014;2014;12;21;Tiistai;11;15;26;2;4;6
96;23.12.2014;2014;12;22;Tiistai;5;2;7;1;1;2
96;23.12.2014;2014;12;23;Tiistai;1;6;7;2;0;2
96;24.12.2014;2014;12;00;Keskiviikko;1;1;2;0;0;0
96;24.12.2014;2014;12;01;Keskiviikko;0;0;0;0;0;0
96;24.12.2014;2014;12;02;Keskiviikko;2;2;4;1;0;1
96;24.12.2014;2014;12;03;Keskiviikko;0;0;0;0;0;0
96;24.12.2014;2014;12;04;Keskiviikko;2;0;2;1;0;1
96;24.12.2014;2014;12;05;Keskiviikko;1;0;1;0;0;0
96;24.12.2014;2014;12;06;Keskiviikko;14;4;18;2;1;3
96;24.12.2014;2014;12;07;Keskiviikko;1;5;6;2;3;5
96;24.12.2014;2014;12;08;Keskiviikko;2;6;8;1;5;6
96;24.12.2014;2014;12;09;Keskiviikko;5;5;10;1;3;4
96;24.12.2014;2014;12;10;Keskiviikko;6;6;12;7;0;7
96;24.12.2014;2014;12;11;Keskiviikko;7;3;10;1;2;3
96;24.12.2014;2014;12;12;Keskiviikko;10;4;14;3;1;4
96;24.12.2014;2014;12;13;Keskiviikko;13;4;17;1;1;2
96;24.12.2014;2014;12;14;Keskiviikko;4;7;11;1;3;4
96;24.12.2014;2014;12;15;Keskiviikko;3;8;11;0;4;4
96;24.12.2014;2014;12;16;Keskiviikko;0;2;2;0;1;1
96;24.12.2014;2014;12;17;Keskiviikko;0;1;1;2;1;3
96;24.12.2014;2014;12;18;Keskiviikko;2;1;3;0;2;2
96;24.12.2014;2014;12;19;Keskiviikko;2;0;2;1;2;3
96;24.12.2014;2014;12;20;Keskiviikko;5;3;8;3;1;4
96;24.12.2014;2014;12;21;Keskiviikko;1;10;11;0;3;3
96;24.12.2014;2014;12;22;Keskiviikko;0;2;2;0;0;0
96;24.12.2014;2014;12;23;Keskiviikko;0;1;1;0;0;0
96;25.12.2014;2014;12;00;Torstai;0;0;0;0;1;1
96;25.12.2014;2014;12;01;Torstai;0;1;1;0;0;0
96;25.12.2014;2014;12;02;Torstai;0;0;0;0;0;0
96;25.12.2014;2014;12;03;Torstai;0;0;0;0;0;0
96;25.12.2014;2014;12;04;Torstai;0;0;0;0;0;0
96;25.12.2014;2014;12;05;Torstai;0;0;0;0;0;0
96;25.12.2014;2014;12;06;Torstai;9;2;11;6;0;6
96;25.12.2014;2014;12;07;Torstai;0;5;5;0;4;4
96;25.12.2014;2014;12;08;Torstai;2;0;2;1;2;3
96;25.12.2014;2014;12;09;Torstai;0;2;2;1;2;3
96;25.12.2014;2014;12;10;Torstai;2;1;3;1;0;1
96;25.12.2014;2014;12;11;Torstai;2;0;2;3;3;6
96;25.12.2014;2014;12;12;Torstai;11;1;12;2;7;9
96;25.12.2014;2014;12;13;Torstai;4;1;5;10;2;12
96;25.12.2014;2014;12;14;Torstai;5;7;12;4;12;16
96;25.12.2014;2014;12;15;Torstai;2;6;8;1;6;7
96;25.12.2014;2014;12;16;Torstai;5;8;13;6;4;10
96;25.12.2014;2014;12;17;Torstai;1;3;4;1;2;3
96;25.12.2014;2014;12;18;Torstai;6;5;11;0;3;3
96;25.12.2014;2014;12;19;Torstai;2;1;3;3;3;6
96;25.12.2014;2014;12;20;Torstai;3;6;9;1;0;1
96;25.12.2014;2014;12;21;Torstai;1;18;19;2;3;5
96;25.12.2014;2014;12;22;Torstai;5;2;7;1;0;1
96;25.12.2014;2014;12;23;Torstai;2;2;4;0;1;1
96;26.12.2014;2014;12;00;Perjantai;4;1;5;0;1;1
96;26.12.2014;2014;12;01;Perjantai;1;0;1;0;0;0
96;26.12.2014;2014;12;02;Perjantai;1;0;1;0;0;0
96;26.12.2014;2014;12;03;Perjantai;0;1;1;0;0;0
96;26.12.2014;2014;12;04;Perjantai;2;0;2;1;1;2
96;26.12.2014;2014;12;05;Perjantai;0;0;0;1;1;2
96;26.12.2014;2014;12;06;Perjantai;16;2;18;3;0;3
96;26.12.2014;2014;12;07;Perjantai;0;6;6;1;1;2
96;26.12.2014;2014;12;08;Perjantai;1;2;3;2;3;5
96;26.12.2014;2014;12;09;Perjantai;3;2;5;1;7;8
96;26.12.2014;2014;12;10;Perjantai;8;4;12;7;1;8
96;26.12.2014;2014;12;11;Perjantai;6;7;13;3;9;12
96;26.12.2014;2014;12;12;Perjantai;13;9;22;4;5;9
96;26.12.2014;2014;12;13;Perjantai;11;9;20;6;6;12
96;26.12.2014;2014;12;14;Perjantai;9;18;27;5;7;12
96;26.12.2014;2014;12;15;Perjantai;13;8;21;2;6;8
96;26.12.2014;2014;12;16;Perjantai;3;2;5;3;7;10
96;26.12.2014;2014;12;17;Perjantai;4;8;12;2;3;5
96;26.12.2014;2014;12;18;Perjantai;4;8;12;4;6;10
96;26.12.2014;2014;12;19;Perjantai;0;5;5;4;10;14
96;26.12.2014;2014;12;20;Perjantai;6;5;11;2;3;5
96;26.12.2014;2014;12;21;Perjantai;3;8;11;1;3;4
96;26.12.2014;2014;12;22;Perjantai;0;2;2;0;0;0
96;26.12.2014;2014;12;23;Perjantai;2;7;9;0;0;0
96;27.12.2014;2014;12;00;Lauantai;1;5;6;2;1;3
96;27.12.2014;2014;12;01;Lauantai;3;2;5;0;0;0
96;27.12.2014;2014;12;02;Lauantai;1;0;1;0;1;1
96;27.12.2014;2014;12;03;Lauantai;2;0;2;0;0;0
96;27.12.2014;2014;12;04;Lauantai;4;3;7;3;0;3
96;27.12.2014;2014;12;05;Lauantai;7;4;11;5;0;5
96;27.12.2014;2014;12;06;Lauantai;14;2;16;1;1;2
96;27.12.2014;2014;12;07;Lauantai;0;6;6;1;1;2
96;27.12.2014;2014;12;08;Lauantai;5;7;12;1;3;4
96;27.12.2014;2014;12;09;Lauantai;9;19;28;1;4;5
96;27.12.2014;2014;12;10;Lauantai;15;15;30;4;1;5
96;27.12.2014;2014;12;11;Lauantai;15;18;33;8;7;15
96;27.12.2014;2014;12;12;Lauantai;17;13;30;9;3;12
96;27.12.2014;2014;12;13;Lauantai;17;10;27;4;3;7
96;27.12.2014;2014;12;14;Lauantai;18;25;43;8;12;20
96;27.12.2014;2014;12;15;Lauantai;18;17;35;5;9;14
96;27.12.2014;2014;12;16;Lauantai;15;23;38;2;15;17
96;27.12.2014;2014;12;17;Lauantai;8;10;18;3;5;8
96;27.12.2014;2014;12;18;Lauantai;17;10;27;4;2;6
96;27.12.2014;2014;12;19;Lauantai;21;1;22;10;8;18
96;27.12.2014;2014;12;20;Lauantai;9;3;12;4;4;8
96;27.12.2014;2014;12;21;Lauantai;4;13;17;1;3;4
96;27.12.2014;2014;12;22;Lauantai;5;1;6;1;0;1
96;27.12.2014;2014;12;23;Lauantai;3;2;5;2;2;4
96;28.12.2014;2014;12;00;Sunnuntai;3;2;5;0;0;0
96;28.12.2014;2014;12;01;Sunnuntai;0;1;1;0;0;0
96;28.12.2014;2014;12;02;Sunnuntai;4;0;4;2;0;2
96;28.12.2014;2014;12;03;Sunnuntai;3;1;4;0;0;0
96;28.12.2014;2014;12;04;Sunnuntai;3;2;5;1;0;1
96;28.12.2014;2014;12;05;Sunnuntai;2;0;2;1;1;2
96;28.12.2014;2014;12;06;Sunnuntai;10;5;15;1;2;3
96;28.12.2014;2014;12;07;Sunnuntai;2;4;6;2;5;7
96;28.12.2014;2014;12;08;Sunnuntai;0;1;1;1;1;2
96;28.12.2014;2014;12;09;Sunnuntai;3;3;6;1;2;3
96;28.12.2014;2014;12;10;Sunnuntai;1;8;9;3;1;4
96;28.12.2014;2014;12;11;Sunnuntai;5;11;16;1;5;6
96;28.12.2014;2014;12;12;Sunnuntai;7;12;19;4;2;6
96;28.12.2014;2014;12;13;Sunnuntai;9;13;22;7;7;14
96;28.12.2014;2014;12;14;Sunnuntai;9;15;24;4;9;13
96;28.12.2014;2014;12;15;Sunnuntai;8;9;17;5;11;16
96;28.12.2014;2014;12;16;Sunnuntai;14;5;19;7;3;10
96;28.12.2014;2014;12;17;Sunnuntai;12;4;16;7;5;12
96;28.12.2014;2014;12;18;Sunnuntai;5;6;11;3;3;6
96;28.12.2014;2014;12;19;Sunnuntai;4;11;15;8;4;12
96;28.12.2014;2014;12;20;Sunnuntai;10;8;18;7;6;13
96;28.12.2014;2014;12;21;Sunnuntai;3;8;11;1;2;3
96;28.12.2014;2014;12;22;Sunnuntai;1;2;3;1;0;1
96;28.12.2014;2014;12;23;Sunnuntai;2;0;2;2;1;3
96;29.12.2014;2014;12;00;Maanantai;2;1;3;1;0;1
96;29.12.2014;2014;12;01;Maanantai;2;1;3;0;0;0
96;29.12.2014;2014;12;02;Maanantai;4;0;4;0;0;0
96;29.12.2014;2014;12;03;Maanantai;0;0;0;0;0;0
96;29.12.2014;2014;12;04;Maanantai;2;1;3;0;1;1
96;29.12.2014;2014;12;05;Maanantai;1;3;4;0;1;1
96;29.12.2014;2014;12;06;Maanantai;34;14;48;6;5;11
96;29.12.2014;2014;12;07;Maanantai;40;32;72;12;6;18
96;29.12.2014;2014;12;08;Maanantai;14;27;41;8;8;16
96;29.12.2014;2014;12;09;Maanantai;13;22;35;7;6;13
96;29.12.2014;2014;12;10;Maanantai;13;18;31;2;5;7
96;29.12.2014;2014;12;11;Maanantai;13;24;37;5;5;10
96;29.12.2014;2014;12;12;Maanantai;28;37;65;7;7;14
96;29.12.2014;2014;12;13;Maanantai;24;25;49;10;7;17
96;29.12.2014;2014;12;14;Maanantai;23;44;67;5;10;15
96;29.12.2014;2014;12;15;Maanantai;27;78;105;9;20;29
96;29.12.2014;2014;12;16;Maanantai;33;47;80;12;26;38
96;29.12.2014;2014;12;17;Maanantai;27;25;52;4;6;10
96;29.12.2014;2014;12;18;Maanantai;24;10;34;9;6;15
96;29.12.2014;2014;12;19;Maanantai;16;9;25;8;11;19
96;29.12.2014;2014;12;20;Maanantai;21;9;30;7;7;14
96;29.12.2014;2014;12;21;Maanantai;8;10;18;2;5;7
96;29.12.2014;2014;12;22;Maanantai;4;3;7;0;0;0
96;29.12.2014;2014;12;23;Maanantai;7;0;7;0;5;5
96;30.12.2014;2014;12;00;Tiistai;1;1;2;0;0;0
96;30.12.2014;2014;12;01;Tiistai;0;0;0;1;0;1
96;30.12.2014;2014;12;02;Tiistai;1;0;1;0;0;0
96;30.12.2014;2014;12;03;Tiistai;2;0;2;0;0;0
96;30.12.2014;2014;12;04;Tiistai;1;1;2;0;0;0
96;30.12.2014;2014;12;05;Tiistai;2;6;8;4;3;7
96;30.12.2014;2014;12;06;Tiistai;31;19;50;9;3;12
96;30.12.2014;2014;12;07;Tiistai;53;32;85;5;2;7
96;30.12.2014;2014;12;08;Tiistai;17;23;40;0;4;4
96;30.12.2014;2014;12;09;Tiistai;17;21;38;7;7;14
96;30.12.2014;2014;12;10;Tiistai;15;21;36;3;3;6
96;30.12.2014;2014;12;11;Tiistai;16;20;36;6;8;14
96;30.12.2014;2014;12;12;Tiistai;30;35;65;6;7;13
96;30.12.2014;2014;12;13;Tiistai;35;38;73;7;7;14
96;30.12.2014;2014;12;14;Tiistai;37;54;91;2;14;16
96;30.12.2014;2014;12;15;Tiistai;43;68;111;3;15;18
96;30.12.2014;2014;12;16;Tiistai;33;48;81;3;10;13
96;30.12.2014;2014;12;17;Tiistai;31;23;54;4;9;13
96;30.12.2014;2014;12;18;Tiistai;20;25;45;7;7;14
96;30.12.2014;2014;12;19;Tiistai;24;16;40;3;6;9
96;30.12.2014;2014;12;20;Tiistai;22;7;29;5;5;10
96;30.12.2014;2014;12;21;Tiistai;15;16;31;5;1;6
96;30.12.2014;2014;12;22;Tiistai;7;9;16;1;0;1
96;30.12.2014;2014;12;23;Tiistai;1;1;2;0;2;2
96;31.12.2014;2014;12;00;Keskiviikko;4;0;4;0;1;1
96;31.12.2014;2014;12;01;Keskiviikko;1;1;2;1;1;2
96;31.12.2014;2014;12;02;Keskiviikko;2;0;2;0;0;0
96;31.12.2014;2014;12;03;Keskiviikko;4;0;4;0;0;0
96;31.12.2014;2014;12;04;Keskiviikko;2;0;2;0;0;0
96;31.12.2014;2014;12;05;Keskiviikko;4;4;8;1;1;2
96;31.12.2014;2014;12;06;Keskiviikko;17;18;35;0;0;0
96;31.12.2014;2014;12;07;Keskiviikko;44;37;81;1;1;2
96;31.12.2014;2014;12;08;Keskiviikko;17;16;33;1;1;2
96;31.12.2014;2014;12;09;Keskiviikko;14;15;29;0;0;0
96;31.12.2014;2014;12;10;Keskiviikko;21;18;39;2;3;5
96;31.12.2014;2014;12;11;Keskiviikko;20;27;47;2;1;3
96;31.12.2014;2014;12;12;Keskiviikko;29;26;55;1;4;5
96;31.12.2014;2014;12;13;Keskiviikko;29;35;64;3;3;6
96;31.12.2014;2014;12;14;Keskiviikko;34;50;84;9;8;17
96;31.12.2014;2014;12;15;Keskiviikko;42;53;95;5;16;21
96;31.12.2014;2014;12;16;Keskiviikko;27;17;44;3;8;11
96;31.12.2014;2014;12;17;Keskiviikko;20;15;35;3;5;8
96;31.12.2014;2014;12;18;Keskiviikko;12;12;24;1;2;3
96;31.12.2014;2014;12;19;Keskiviikko;8;17;25;1;4;5
96;31.12.2014;2014;12;20;Keskiviikko;14;9;23;4;5;9
96;31.12.2014;2014;12;21;Keskiviikko;4;7;11;2;3;5
96;31.12.2014;2014;12;22;Keskiviikko;2;4;6;2;2;4
96;31.12.2014;2014;12;23;Keskiviikko;6;5;11;0;0;0
96;01.01.2015;2015;01;00;Torstai;6;5;11;0;2;2
96;01.01.2015;2015;01;01;Torstai;14;0;14;0;2;2
96;01.01.2015;2015;01;02;Torstai;8;9;17;1;0;1
96;01.01.2015;2015;01;03;Torstai;9;0;9;4;0;4
96;01.01.2015;2015;01;04;Torstai;10;2;12;2;0;2
96;01.01.2015;2015;01;05;Torstai;3;1;4;1;0;1
96;01.01.2015;2015;01;06;Torstai;13;4;17;0;0;0
96;01.01.2015;2015;01;07;Torstai;6;5;11;1;2;3
96;01.01.2015;2015;01;08;Torstai;4;3;7;1;1;2
96;01.01.2015;2015;01;09;Torstai;2;4;6;1;2;3
96;01.01.2015;2015;01;10;Torstai;3;3;6;6;4;10
96;01.01.2015;2015;01;11;Torstai;14;5;19;3;9;12
96;01.01.2015;2015;01;12;Torstai;11;4;15;8;6;14
96;01.01.2015;2015;01;13;Torstai;12;6;18;7;6;13
96;01.01.2015;2015;01;14;Torstai;6;18;24;6;7;13
96;01.01.2015;2015;01;15;Torstai;10;12;22;5;9;14
96;01.01.2015;2015;01;16;Torstai;12;12;24;3;9;12
96;01.01.2015;2015;01;17;Torstai;8;7;15;3;6;9
96;01.01.2015;2015;01;18;Torstai;7;3;10;1;11;12
96;01.01.2015;2015;01;19;Torstai;3;11;14;2;2;4
96;01.01.2015;2015;01;20;Torstai;9;15;24;7;6;13
96;01.01.2015;2015;01;21;Torstai;3;7;10;2;2;4
96;01.01.2015;2015;01;22;Torstai;4;2;6;2;2;4
96;01.01.2015;2015;01;23;Torstai;4;1;5;4;2;6
96;02.01.2015;2015;01;00;Perjantai;3;2;5;1;1;2
96;02.01.2015;2015;01;01;Perjantai;1;0;1;0;0;0
96;02.01.2015;2015;01;02;Perjantai;2;2;4;0;1;1
96;02.01.2015;2015;01;03;Perjantai;1;0;1;1;0;1
96;02.01.2015;2015;01;04;Perjantai;1;2;3;0;0;0
96;02.01.2015;2015;01;05;Perjantai;1;2;3;0;2;2
96;02.01.2015;2015;01;06;Perjantai;17;17;34;4;2;6
96;02.01.2015;2015;01;07;Perjantai;36;33;69;5;2;7
96;02.01.2015;2015;01;08;Perjantai;12;16;28;1;2;3
96;02.01.2015;2015;01;09;Perjantai;13;22;35;1;4;5
96;02.01.2015;2015;01;10;Perjantai;15;28;43;3;7;10
96;02.01.2015;2015;01;11;Perjantai;19;22;41;3;6;9
96;02.01.2015;2015;01;12;Perjantai;24;30;54;1;8;9
96;02.01.2015;2015;01;13;Perjantai;21;33;54;3;8;11
96;02.01.2015;2015;01;14;Perjantai;25;55;80;1;12;13
96;02.01.2015;2015;01;15;Perjantai;28;47;75;1;17;18
96;02.01.2015;2015;01;16;Perjantai;18;37;55;3;13;16
96;02.01.2015;2015;01;17;Perjantai;19;17;36;2;7;9
96;02.01.2015;2015;01;18;Perjantai;22;11;33;3;6;9
96;02.01.2015;2015;01;19;Perjantai;15;11;26;2;6;8
96;02.01.2015;2015;01;20;Perjantai;14;8;22;3;7;10
96;02.01.2015;2015;01;21;Perjantai;8;9;17;0;5;5
96;02.01.2015;2015;01;22;Perjantai;2;6;8;0;4;4
96;02.01.2015;2015;01;23;Perjantai;4;2;6;1;0;1
96;03.01.2015;2015;01;00;Lauantai;3;1;4;1;3;4
96;03.01.2015;2015;01;01;Lauantai;1;1;2;1;0;1
96;03.01.2015;2015;01;02;Lauantai;1;0;1;0;1;1
96;03.01.2015;2015;01;03;Lauantai;1;0;1;0;0;0
96;03.01.2015;2015;01;04;Lauantai;2;0;2;2;0;2
96;03.01.2015;2015;01;05;Lauantai;2;2;4;2;3;5
96;03.01.2015;2015;01;06;Lauantai;16;3;19;3;0;3
96;03.01.2015;2015;01;07;Lauantai;5;6;11;0;5;5
96;03.01.2015;2015;01;08;Lauantai;5;4;9;0;1;1
96;03.01.2015;2015;01;09;Lauantai;9;19;28;1;2;3
96;03.01.2015;2015;01;10;Lauantai;9;8;17;3;6;9
96;03.01.2015;2015;01;11;Lauantai;6;9;15;7;5;12
96;03.01.2015;2015;01;12;Lauantai;10;14;24;8;9;17
96;03.01.2015;2015;01;13;Lauantai;16;21;37;10;13;23
96;03.01.2015;2015;01;14;Lauantai;19;30;49;10;19;29
96;03.01.2015;2015;01;15;Lauantai;16;8;24;8;7;15
96;03.01.2015;2015;01;16;Lauantai;20;13;33;11;13;24
96;03.01.2015;2015;01;17;Lauantai;10;9;19;11;14;25
96;03.01.2015;2015;01;18;Lauantai;27;7;34;15;9;24
96;03.01.2015;2015;01;19;Lauantai;9;6;15;8;4;12
96;03.01.2015;2015;01;20;Lauantai;11;10;21;10;7;17
96;03.01.2015;2015;01;21;Lauantai;0;7;7;2;4;6
96;03.01.2015;2015;01;22;Lauantai;6;8;14;2;13;15
96;03.01.2015;2015;01;23;Lauantai;0;0;0;2;2;4
96;04.01.2015;2015;01;00;Sunnuntai;0;3;3;2;3;5
96;04.01.2015;2015;01;01;Sunnuntai;6;0;6;0;0;0
96;04.01.2015;2015;01;02;Sunnuntai;3;1;4;0;0;0
96;04.01.2015;2015;01;03;Sunnuntai;3;0;3;1;1;2
96;04.01.2015;2015;01;04;Sunnuntai;5;0;5;3;0;3
96;04.01.2015;2015;01;05;Sunnuntai;0;1;1;5;2;7
96;04.01.2015;2015;01;06;Sunnuntai;8;1;9;2;0;2
96;04.01.2015;2015;01;07;Sunnuntai;0;10;10;1;9;10
96;04.01.2015;2015;01;08;Sunnuntai;5;7;12;2;2;4
96;04.01.2015;2015;01;09;Sunnuntai;6;1;7;5;5;10
96;04.01.2015;2015;01;10;Sunnuntai;2;9;11;5;12;17
96;04.01.2015;2015;01;11;Sunnuntai;6;20;26;10;11;21
96;04.01.2015;2015;01;12;Sunnuntai;14;19;33;10;17;27
96;04.01.2015;2015;01;13;Sunnuntai;23;25;48;15;18;33
96;04.01.2015;2015;01;14;Sunnuntai;22;15;37;12;8;20
96;04.01.2015;2015;01;15;Sunnuntai;17;19;36;5;17;22
96;04.01.2015;2015;01;16;Sunnuntai;22;15;37;13;10;23
96;04.01.2015;2015;01;17;Sunnuntai;36;10;46;13;9;22
96;04.01.2015;2015;01;18;Sunnuntai;20;5;25;13;17;30
96;04.01.2015;2015;01;19;Sunnuntai;14;13;27;10;16;26
96;04.01.2015;2015;01;20;Sunnuntai;5;26;31;6;9;15
96;04.01.2015;2015;01;21;Sunnuntai;6;12;18;5;10;15
96;04.01.2015;2015;01;22;Sunnuntai;1;3;4;1;2;3
96;04.01.2015;2015;01;23;Sunnuntai;1;1;2;1;0;1
96;05.01.2015;2015;01;00;Maanantai;3;1;4;0;0;0
96;05.01.2015;2015;01;01;Maanantai;0;0;0;0;0;0
96;05.01.2015;2015;01;02;Maanantai;4;2;6;0;0;0
96;05.01.2015;2015;01;03;Maanantai;2;0;2;1;0;1
96;05.01.2015;2015;01;04;Maanantai;1;2;3;0;1;1
96;05.01.2015;2015;01;05;Maanantai;2;3;5;1;2;3
96;05.01.2015;2015;01;06;Maanantai;19;12;31;12;4;16
96;05.01.2015;2015;01;07;Maanantai;41;35;76;22;7;29
96;05.01.2015;2015;01;08;Maanantai;11;17;28;5;7;12
96;05.01.2015;2015;01;09;Maanantai;14;23;37;6;11;17
96;05.01.2015;2015;01;10;Maanantai;9;17;26;8;0;8
96;05.01.2015;2015;01;11;Maanantai;19;14;33;6;12;18
96;05.01.2015;2015;01;12;Maanantai;9;17;26;9;7;16
96;05.01.2015;2015;01;13;Maanantai;13;22;35;10;7;17
96;05.01.2015;2015;01;14;Maanantai;23;40;63;8;16;24
96;05.01.2015;2015;01;15;Maanantai;32;39;71;5;21;26
96;05.01.2015;2015;01;16;Maanantai;34;51;85;10;20;30
96;05.01.2015;2015;01;17;Maanantai;21;22;43;6;5;11
96;05.01.2015;2015;01;18;Maanantai;21;11;32;8;7;15
96;05.01.2015;2015;01;19;Maanantai;14;7;21;8;4;12
96;05.01.2015;2015;01;20;Maanantai;14;9;23;9;5;14
96;05.01.2015;2015;01;21;Maanantai;6;5;11;5;8;13
96;05.01.2015;2015;01;22;Maanantai;3;2;5;1;0;1
96;05.01.2015;2015;01;23;Maanantai;0;1;1;0;0;0
96;06.01.2015;2015;01;00;Tiistai;3;1;4;0;0;0
96;06.01.2015;2015;01;01;Tiistai;2;0;2;0;0;0
96;06.01.2015;2015;01;02;Tiistai;1;0;1;0;0;0
96;06.01.2015;2015;01;03;Tiistai;1;0;1;1;0;1
96;06.01.2015;2015;01;04;Tiistai;1;0;1;1;1;2
96;06.01.2015;2015;01;05;Tiistai;0;1;1;0;1;1
96;06.01.2015;2015;01;06;Tiistai;4;3;7;3;0;3
96;06.01.2015;2015;01;07;Tiistai;3;5;8;2;3;5
96;06.01.2015;2015;01;08;Tiistai;5;1;6;1;5;6
96;06.01.2015;2015;01;09;Tiistai;1;1;2;5;4;9
96;06.01.2015;2015;01;10;Tiistai;3;13;16;6;2;8
96;06.01.2015;2015;01;11;Tiistai;3;6;9;6;7;13
96;06.01.2015;2015;01;12;Tiistai;12;14;26;7;7;14
96;06.01.2015;2015;01;13;Tiistai;11;9;20;12;11;23
96;06.01.2015;2015;01;14;Tiistai;6;19;25;7;10;17
96;06.01.2015;2015;01;15;Tiistai;19;11;30;12;7;19
96;06.01.2015;2015;01;16;Tiistai;19;9;28;18;6;24
96;06.01.2015;2015;01;17;Tiistai;17;8;25;2;3;5
96;06.01.2015;2015;01;18;Tiistai;11;8;19;16;16;32
96;06.01.2015;2015;01;19;Tiistai;16;7;23;7;16;23
96;06.01.2015;2015;01;20;Tiistai;4;15;19;5;11;16
96;06.01.2015;2015;01;21;Tiistai;8;19;27;3;10;13
96;06.01.2015;2015;01;22;Tiistai;3;1;4;2;1;3
96;06.01.2015;2015;01;23;Tiistai;2;4;6;1;1;2
96;07.01.2015;2015;01;00;Keskiviikko;1;2;3;1;1;2
96;07.01.2015;2015;01;01;Keskiviikko;1;0;1;0;0;0
96;07.01.2015;2015;01;02;Keskiviikko;0;0;0;0;0;0
96;07.01.2015;2015;01;03;Keskiviikko;1;0;1;0;1;1
96;07.01.2015;2015;01;04;Keskiviikko;1;2;3;0;1;1
96;07.01.2015;2015;01;05;Keskiviikko;2;3;5;2;1;3
96;07.01.2015;2015;01;06;Keskiviikko;35;24;59;10;6;16
96;07.01.2015;2015;01;07;Keskiviikko;106;81;187;30;9;39
96;07.01.2015;2015;01;08;Keskiviikko;81;68;149;13;10;23
96;07.01.2015;2015;01;09;Keskiviikko;66;46;112;14;6;20
96;07.01.2015;2015;01;10;Keskiviikko;34;27;61;15;12;27
96;07.01.2015;2015;01;11;Keskiviikko;34;45;79;15;10;25
96;07.01.2015;2015;01;12;Keskiviikko;35;41;76;17;11;28
96;07.01.2015;2015;01;13;Keskiviikko;44;43;87;22;15;37
96;07.01.2015;2015;01;14;Keskiviikko;56;80;136;25;5;30
96;07.01.2015;2015;01;15;Keskiviikko;84;106;190;28;15;43
96;07.01.2015;2015;01;16;Keskiviikko;115;78;193;31;14;45
96;07.01.2015;2015;01;17;Keskiviikko;67;28;95;21;8;29
96;07.01.2015;2015;01;18;Keskiviikko;59;9;68;42;1;43
96;07.01.2015;2015;01;19;Keskiviikko;46;8;54;29;1;30
96;07.01.2015;2015;01;20;Keskiviikko;48;10;58;22;0;22
96;07.01.2015;2015;01;21;Keskiviikko;21;3;24;11;1;12
96;07.01.2015;2015;01;22;Keskiviikko;7;1;8;5;1;6
96;07.01.2015;2015;01;23;Keskiviikko;7;2;9;5;1;6
96;08.01.2015;2015;01;00;Torstai;2;1;3;1;0;1
96;08.01.2015;2015;01;01;Torstai;3;0;3;0;0;0
96;08.01.2015;2015;01;02;Torstai;1;0;1;0;0;0
96;08.01.2015;2015;01;03;Torstai;0;0;0;1;0;1
96;08.01.2015;2015;01;04;Torstai;6;0;6;1;0;1
96;08.01.2015;2015;01;05;Torstai;6;3;9;4;1;5
96;08.01.2015;2015;01;06;Torstai;36;16;52;8;3;11
96;08.01.2015;2015;01;07;Torstai;114;69;183;8;5;13
96;08.01.2015;2015;01;08;Torstai;111;63;174;22;6;28
96;08.01.2015;2015;01;09;Torstai;65;39;104;13;4;17
96;08.01.2015;2015;01;10;Torstai;52;34;86;7;9;16
96;08.01.2015;2015;01;11;Torstai;47;44;91;13;7;20
96;08.01.2015;2015;01;12;Torstai;39;44;83;13;14;27
96;08.01.2015;2015;01;13;Torstai;42;62;104;12;8;20
96;08.01.2015;2015;01;14;Torstai;55;100;155;12;14;26
96;08.01.2015;2015;01;15;Torstai;76;132;208;10;44;54
96;08.01.2015;2015;01;16;Torstai;78;109;187;19;25;44
96;08.01.2015;2015;01;17;Torstai;41;44;85;11;15;26
96;08.01.2015;2015;01;18;Torstai;39;19;58;23;12;35
96;08.01.2015;2015;01;19;Torstai;38;29;67;23;24;47
96;08.01.2015;2015;01;20;Torstai;26;11;37;10;12;22
96;08.01.2015;2015;01;21;Torstai;12;14;26;2;6;8
96;08.01.2015;2015;01;22;Torstai;5;6;11;1;1;2
96;08.01.2015;2015;01;23;Torstai;3;0;3;0;0;0
96;09.01.2015;2015;01;00;Perjantai;1;1;2;1;0;1
96;09.01.2015;2015;01;01;Perjantai;0;0;0;0;0;0
96;09.01.2015;2015;01;02;Perjantai;2;0;2;0;0;0
96;09.01.2015;2015;01;03;Perjantai;2;0;2;2;2;4
96;09.01.2015;2015;01;04;Perjantai;3;0;3;0;0;0
96;09.01.2015;2015;01;05;Perjantai;7;2;9;1;1;2
96;09.01.2015;2015;01;06;Perjantai;25;13;38;12;2;14
96;09.01.2015;2015;01;07;Perjantai;85;62;147;25;5;30
96;09.01.2015;2015;01;08;Perjantai;89;60;149;15;2;17
96;09.01.2015;2015;01;09;Perjantai;55;38;93;18;6;24
96;09.01.2015;2015;01;10;Perjantai;27;33;60;7;11;18
96;09.01.2015;2015;01;11;Perjantai;19;41;60;9;8;17
96;09.01.2015;2015;01;12;Perjantai;34;58;92;10;17;27
96;09.01.2015;2015;01;13;Perjantai;37;74;111;11;13;24
96;09.01.2015;2015;01;14;Perjantai;50;120;170;14;37;51
96;09.01.2015;2015;01;15;Perjantai;45;75;120;20;37;57
96;09.01.2015;2015;01;16;Perjantai;52;51;103;11;25;36
96;09.01.2015;2015;01;17;Perjantai;32;46;78;9;8;17
96;09.01.2015;2015;01;18;Perjantai;36;22;58;11;21;32
96;09.01.2015;2015;01;19;Perjantai;19;23;42;8;8;16
96;09.01.2015;2015;01;20;Perjantai;22;15;37;5;7;12
96;09.01.2015;2015;01;21;Perjantai;16;16;32;1;8;9
96;09.01.2015;2015;01;22;Perjantai;6;5;11;1;2;3
96;09.01.2015;2015;01;23;Perjantai;6;8;14;3;2;5
96;10.01.2015;2015;01;00;Lauantai;5;4;9;2;1;3
96;10.01.2015;2015;01;01;Lauantai;1;2;3;0;0;0
96;10.01.2015;2015;01;02;Lauantai;2;3;5;0;0;0
96;10.01.2015;2015;01;03;Lauantai;2;1;3;2;1;3
96;10.01.2015;2015;01;04;Lauantai;0;0;0;2;1;3
96;10.01.2015;2015;01;05;Lauantai;1;2;3;4;5;9
96;10.01.2015;2015;01;06;Lauantai;3;10;13;5;1;6
96;10.01.2015;2015;01;07;Lauantai;4;12;16;2;3;5
96;10.01.2015;2015;01;08;Lauantai;3;11;14;2;1;3
96;10.01.2015;2015;01;09;Lauantai;2;20;22;3;2;5
96;10.01.2015;2015;01;10;Lauantai;5;12;17;9;10;19
96;10.01.2015;2015;01;11;Lauantai;16;22;38;7;9;16
96;10.01.2015;2015;01;12;Lauantai;13;17;30;7;19;26
96;10.01.2015;2015;01;13;Lauantai;21;28;49;9;11;20
96;10.01.2015;2015;01;14;Lauantai;26;22;48;2;8;10
96;10.01.2015;2015;01;15;Lauantai;15;17;32;9;17;26
96;10.01.2015;2015;01;16;Lauantai;16;26;42;6;13;19
96;10.01.2015;2015;01;17;Lauantai;13;17;30;4;9;13
96;10.01.2015;2015;01;18;Lauantai;20;18;38;16;8;24
96;10.01.2015;2015;01;19;Lauantai;18;9;27;15;9;24
96;10.01.2015;2015;01;20;Lauantai;10;9;19;9;15;24
96;10.01.2015;2015;01;21;Lauantai;9;16;25;2;10;12
96;10.01.2015;2015;01;22;Lauantai;1;5;6;2;1;3
96;10.01.2015;2015;01;23;Lauantai;4;5;9;0;1;1
96;11.01.2015;2015;01;00;Sunnuntai;4;2;6;2;2;4
96;11.01.2015;2015;01;01;Sunnuntai;2;1;3;0;0;0
96;11.01.2015;2015;01;02;Sunnuntai;1;1;2;0;1;1
96;11.01.2015;2015;01;03;Sunnuntai;3;2;5;1;0;1
96;11.01.2015;2015;01;04;Sunnuntai;7;0;7;0;0;0
96;11.01.2015;2015;01;05;Sunnuntai;1;0;1;1;0;1
96;11.01.2015;2015;01;06;Sunnuntai;8;4;12;6;1;7
96;11.01.2015;2015;01;07;Sunnuntai;1;7;8;0;6;6
96;11.01.2015;2015;01;08;Sunnuntai;5;6;11;2;2;4
96;11.01.2015;2015;01;09;Sunnuntai;2;5;7;2;5;7
96;11.01.2015;2015;01;10;Sunnuntai;4;6;10;5;5;10
96;11.01.2015;2015;01;11;Sunnuntai;3;11;14;12;9;21
96;11.01.2015;2015;01;12;Sunnuntai;19;16;35;9;12;21
96;11.01.2015;2015;01;13;Sunnuntai;16;9;25;7;11;18
96;11.01.2015;2015;01;14;Sunnuntai;10;21;31;11;12;23
96;11.01.2015;2015;01;15;Sunnuntai;17;35;52;15;11;26
96;11.01.2015;2015;01;16;Sunnuntai;26;12;38;20;7;27
96;11.01.2015;2015;01;17;Sunnuntai;23;11;34;8;6;14
96;11.01.2015;2015;01;18;Sunnuntai;17;13;30;7;14;21
96;11.01.2015;2015;01;19;Sunnuntai;8;12;20;6;6;12
96;11.01.2015;2015;01;20;Sunnuntai;10;17;27;5;16;21
96;11.01.2015;2015;01;21;Sunnuntai;5;13;18;7;5;12
96;11.01.2015;2015;01;22;Sunnuntai;1;3;4;0;1;1
96;11.01.2015;2015;01;23;Sunnuntai;3;2;5;1;2;3
96;12.01.2015;2015;01;00;Maanantai;3;0;3;1;0;1
96;12.01.2015;2015;01;01;Maanantai;4;0;4;2;1;3
96;12.01.2015;2015;01;02;Maanantai;1;0;1;1;0;1
96;12.01.2015;2015;01;03;Maanantai;1;1;2;0;0;0
96;12.01.2015;2015;01;04;Maanantai;0;1;1;5;5;10
96;12.01.2015;2015;01;05;Maanantai;3;6;9;1;0;1
96;12.01.2015;2015;01;06;Maanantai;27;7;34;16;7;23
96;12.01.2015;2015;01;07;Maanantai;97;61;158;51;10;61
96;12.01.2015;2015;01;08;Maanantai;99;57;156;23;7;30
96;12.01.2015;2015;01;09;Maanantai;45;40;85;19;13;32
96;12.01.2015;2015;01;10;Maanantai;31;23;54;11;5;16
96;12.01.2015;2015;01;11;Maanantai;25;41;66;18;14;32
96;12.01.2015;2015;01;12;Maanantai;26;40;66;17;18;35
96;12.01.2015;2015;01;13;Maanantai;24;36;60;8;15;23
96;12.01.2015;2015;01;14;Maanantai;39;70;109;15;30;45
96;12.01.2015;2015;01;15;Maanantai;43;127;170;8;57;65
96;12.01.2015;2015;01;16;Maanantai;38;94;132;14;46;60
96;12.01.2015;2015;01;17;Maanantai;41;45;86;12;11;23
96;12.01.2015;2015;01;18;Maanantai;27;32;59;5;12;17
96;12.01.2015;2015;01;19;Maanantai;17;21;38;8;9;17
96;12.01.2015;2015;01;20;Maanantai;23;21;44;8;10;18
96;12.01.2015;2015;01;21;Maanantai;13;19;32;2;11;13
96;12.01.2015;2015;01;22;Maanantai;4;5;9;0;0;0
96;12.01.2015;2015;01;23;Maanantai;3;2;5;1;0;1
96;13.01.2015;2015;01;00;Tiistai;2;0;2;0;0;0
96;13.01.2015;2015;01;01;Tiistai;0;0;0;0;0;0
96;13.01.2015;2015;01;02;Tiistai;0;0;0;0;0;0
96;13.01.2015;2015;01;03;Tiistai;0;0;0;0;1;1
96;13.01.2015;2015;01;04;Tiistai;1;1;2;0;0;0
96;13.01.2015;2015;01;05;Tiistai;4;6;10;1;1;2
96;13.01.2015;2015;01;06;Tiistai;26;15;41;10;5;15
96;13.01.2015;2015;01;07;Tiistai;88;69;157;45;12;57
96;13.01.2015;2015;01;08;Tiistai;103;72;175;19;14;33
96;13.01.2015;2015;01;09;Tiistai;55;43;98;17;12;29
96;13.01.2015;2015;01;10;Tiistai;24;31;55;15;12;27
96;13.01.2015;2015;01;11;Tiistai;49;48;97;15;12;27
96;13.01.2015;2015;01;12;Tiistai;39;40;79;19;29;48
96;13.01.2015;2015;01;13;Tiistai;31;49;80;9;24;33
96;13.01.2015;2015;01;14;Tiistai;32;83;115;15;33;48
96;13.01.2015;2015;01;15;Tiistai;56;150;206;11;74;85
96;13.01.2015;2015;01;16;Tiistai;50;116;166;14;35;49
96;13.01.2015;2015;01;17;Tiistai;27;59;86;16;17;33
96;13.01.2015;2015;01;18;Tiistai;37;34;71;22;17;39
96;13.01.2015;2015;01;19;Tiistai;31;29;60;7;22;29
96;13.01.2015;2015;01;20;Tiistai;29;27;56;9;14;23
96;13.01.2015;2015;01;21;Tiistai;16;21;37;4;4;8
96;13.01.2015;2015;01;22;Tiistai;6;6;12;1;0;1
96;13.01.2015;2015;01;23;Tiistai;3;1;4;1;1;2
96;14.01.2015;2015;01;00;Keskiviikko;1;2;3;0;0;0
96;14.01.2015;2015;01;01;Keskiviikko;1;0;1;0;2;2
96;14.01.2015;2015;01;02;Keskiviikko;0;0;0;2;1;3
96;14.01.2015;2015;01;03;Keskiviikko;1;1;2;0;0;0
96;14.01.2015;2015;01;04;Keskiviikko;1;1;2;0;0;0
96;14.01.2015;2015;01;05;Keskiviikko;1;5;6;2;2;4
96;14.01.2015;2015;01;06;Keskiviikko;23;17;40;16;7;23
96;14.01.2015;2015;01;07;Keskiviikko;93;75;168;40;13;53
96;14.01.2015;2015;01;08;Keskiviikko;92;76;168;28;10;38
96;14.01.2015;2015;01;09;Keskiviikko;73;37;110;26;12;38
96;14.01.2015;2015;01;10;Keskiviikko;32;35;67;5;20;25
96;14.01.2015;2015;01;11;Keskiviikko;59;54;113;23;22;45
96;14.01.2015;2015;01;12;Keskiviikko;47;48;95;12;14;26
96;14.01.2015;2015;01;13;Keskiviikko;45;69;114;7;19;26
96;14.01.2015;2015;01;14;Keskiviikko;45;122;167;11;47;58
96;14.01.2015;2015;01;15;Keskiviikko;55;136;191;8;48;56
96;14.01.2015;2015;01;16;Keskiviikko;62;131;193;21;52;73
96;14.01.2015;2015;01;17;Keskiviikko;55;45;100;16;22;38
96;14.01.2015;2015;01;18;Keskiviikko;51;41;92;20;13;33
96;14.01.2015;2015;01;19;Keskiviikko;29;25;54;16;14;30
96;14.01.2015;2015;01;20;Keskiviikko;31;33;64;12;14;26
96;14.01.2015;2015;01;21;Keskiviikko;12;20;32;4;8;12
96;14.01.2015;2015;01;22;Keskiviikko;4;5;9;0;0;0
96;14.01.2015;2015;01;23;Keskiviikko;2;2;4;1;2;3
96;15.01.2015;2015;01;00;Torstai;1;2;3;0;2;2
96;15.01.2015;2015;01;01;Torstai;0;1;1;0;0;0
96;15.01.2015;2015;01;02;Torstai;0;0;0;1;0;1
96;15.01.2015;2015;01;03;Torstai;3;0;3;2;0;2
96;15.01.2015;2015;01;04;Torstai;2;1;3;0;0;0
96;15.01.2015;2015;01;05;Torstai;4;3;7;3;3;6
96;15.01.2015;2015;01;06;Torstai;33;25;58;9;3;12
96;15.01.2015;2015;01;07;Torstai;101;69;170;40;10;50
96;15.01.2015;2015;01;08;Torstai;100;81;181;24;7;31
96;15.01.2015;2015;01;09;Torstai;54;40;94;19;10;29
96;15.01.2015;2015;01;10;Torstai;41;54;95;11;17;28
96;15.01.2015;2015;01;11;Torstai;36;50;86;12;18;30
96;15.01.2015;2015;01;12;Torstai;50;57;107;29;17;46
96;15.01.2015;2015;01;13;Torstai;52;57;109;12;12;24
96;15.01.2015;2015;01;14;Torstai;46;120;166;18;35;53
96;15.01.2015;2015;01;15;Torstai;73;149;222;12;46;58
96;15.01.2015;2015;01;16;Torstai;74;120;194;16;35;51
96;15.01.2015;2015;01;17;Torstai;42;52;94;15;23;38
96;15.01.2015;2015;01;18;Torstai;57;46;103;19;13;32
96;15.01.2015;2015;01;19;Torstai;45;21;66;20;17;37
96;15.01.2015;2015;01;20;Torstai;37;27;64;10;10;20
96;15.01.2015;2015;01;21;Torstai;15;20;35;3;7;10
96;15.01.2015;2015;01;22;Torstai;13;8;21;0;1;1
96;15.01.2015;2015;01;23;Torstai;3;4;7;0;2;2
96;16.01.2015;2015;01;00;Perjantai;6;1;7;1;1;2
96;16.01.2015;2015;01;01;Perjantai;1;0;1;0;0;0
96;16.01.2015;2015;01;02;Perjantai;4;2;6;0;0;0
96;16.01.2015;2015;01;03;Perjantai;1;0;1;0;0;0
96;16.01.2015;2015;01;04;Perjantai;1;4;5;0;0;0
96;16.01.2015;2015;01;05;Perjantai;4;5;9;0;2;2
96;16.01.2015;2015;01;06;Perjantai;27;23;50;12;4;16
96;16.01.2015;2015;01;07;Perjantai;87;72;159;40;15;55
96;16.01.2015;2015;01;08;Perjantai;64;47;111;22;6;28
96;16.01.2015;2015;01;09;Perjantai;56;35;91;20;13;33
96;16.01.2015;2015;01;10;Perjantai;33;37;70;12;10;22
96;16.01.2015;2015;01;11;Perjantai;60;40;100;17;12;29
96;16.01.2015;2015;01;12;Perjantai;48;42;90;27;11;38
96;16.01.2015;2015;01;13;Perjantai;66;51;117;27;10;37
96;16.01.2015;2015;01;14;Perjantai;67;77;144;27;18;45
96;16.01.2015;2015;01;15;Perjantai;85;82;167;34;13;47
96;16.01.2015;2015;01;16;Perjantai;65;31;96;21;11;32
96;16.01.2015;2015;01;17;Perjantai;46;27;73;16;10;26
96;16.01.2015;2015;01;18;Perjantai;30;13;43;21;4;25
96;16.01.2015;2015;01;19;Perjantai;26;16;42;13;6;19
96;16.01.2015;2015;01;20;Perjantai;30;9;39;14;1;15
96;16.01.2015;2015;01;21;Perjantai;14;7;21;4;5;9
96;16.01.2015;2015;01;22;Perjantai;5;3;8;2;2;4
96;16.01.2015;2015;01;23;Perjantai;3;3;6;3;1;4
96;17.01.2015;2015;01;00;Lauantai;5;5;10;2;0;2
96;17.01.2015;2015;01;01;Lauantai;2;3;5;0;0;0
96;17.01.2015;2015;01;02;Lauantai;3;0;3;1;0;1
96;17.01.2015;2015;01;03;Lauantai;3;1;4;2;0;2
96;17.01.2015;2015;01;04;Lauantai;2;3;5;3;1;4
96;17.01.2015;2015;01;05;Lauantai;3;2;5;0;0;0
96;17.01.2015;2015;01;06;Lauantai;15;2;17;3;0;3
96;17.01.2015;2015;01;07;Lauantai;5;14;19;1;7;8
96;17.01.2015;2015;01;08;Lauantai;3;6;9;2;6;8
96;17.01.2015;2015;01;09;Lauantai;8;17;25;7;1;8
96;17.01.2015;2015;01;10;Lauantai;9;13;22;6;11;17
96;17.01.2015;2015;01;11;Lauantai;13;20;33;6;9;15
96;17.01.2015;2015;01;12;Lauantai;25;13;38;5;13;18
96;17.01.2015;2015;01;13;Lauantai;21;19;40;6;15;21
96;17.01.2015;2015;01;14;Lauantai;28;20;48;11;17;28
96;17.01.2015;2015;01;15;Lauantai;19;30;49;6;12;18
96;17.01.2015;2015;01;16;Lauantai;18;22;40;5;15;20
96;17.01.2015;2015;01;17;Lauantai;17;11;28;7;13;20
96;17.01.2015;2015;01;18;Lauantai;29;12;41;7;9;16
96;17.01.2015;2015;01;19;Lauantai;21;4;25;13;9;22
96;17.01.2015;2015;01;20;Lauantai;10;14;24;7;5;12
96;17.01.2015;2015;01;21;Lauantai;15;19;34;1;7;8
96;17.01.2015;2015;01;22;Lauantai;5;2;7;2;0;2
96;17.01.2015;2015;01;23;Lauantai;3;0;3;3;1;4
96;18.01.2015;2015;01;00;Sunnuntai;2;5;7;0;1;1
96;18.01.2015;2015;01;01;Sunnuntai;1;3;4;4;0;4
96;18.01.2015;2015;01;02;Sunnuntai;4;2;6;2;0;2
96;18.01.2015;2015;01;03;Sunnuntai;6;4;10;1;0;1
96;18.01.2015;2015;01;04;Sunnuntai;3;0;3;3;0;3
96;18.01.2015;2015;01;05;Sunnuntai;3;0;3;0;0;0
96;18.01.2015;2015;01;06;Sunnuntai;14;1;15;4;2;6
96;18.01.2015;2015;01;07;Sunnuntai;4;6;10;1;5;6
96;18.01.2015;2015;01;08;Sunnuntai;6;2;8;2;1;3
96;18.01.2015;2015;01;09;Sunnuntai;5;1;6;5;6;11
96;18.01.2015;2015;01;10;Sunnuntai;4;12;16;9;13;22
96;18.01.2015;2015;01;11;Sunnuntai;3;7;10;11;14;25
96;18.01.2015;2015;01;12;Sunnuntai;22;14;36;15;10;25
96;18.01.2015;2015;01;13;Sunnuntai;22;21;43;17;17;34
96;18.01.2015;2015;01;14;Sunnuntai;24;25;49;10;19;29
96;18.01.2015;2015;01;15;Sunnuntai;24;21;45;20;12;32
96;18.01.2015;2015;01;16;Sunnuntai;35;13;48;23;13;36
96;18.01.2015;2015;01;17;Sunnuntai;20;17;37;13;18;31
96;18.01.2015;2015;01;18;Sunnuntai;21;19;40;20;19;39
96;18.01.2015;2015;01;19;Sunnuntai;10;16;26;15;25;40
96;18.01.2015;2015;01;20;Sunnuntai;18;29;47;8;20;28
96;18.01.2015;2015;01;21;Sunnuntai;15;16;31;0;9;9
96;18.01.2015;2015;01;22;Sunnuntai;7;5;12;3;3;6
96;18.01.2015;2015;01;23;Sunnuntai;6;0;6;0;1;1
96;19.01.2015;2015;01;00;Maanantai;3;1;4;1;0;1
96;19.01.2015;2015;01;01;Maanantai;1;0;1;1;1;2
96;19.01.2015;2015;01;02;Maanantai;2;2;4;0;0;0
96;19.01.2015;2015;01;03;Maanantai;0;0;0;0;0;0
96;19.01.2015;2015;01;04;Maanantai;1;2;3;1;2;3
96;19.01.2015;2015;01;05;Maanantai;5;11;16;1;0;1
96;19.01.2015;2015;01;06;Maanantai;29;14;43;18;7;25
96;19.01.2015;2015;01;07;Maanantai;104;58;162;43;11;54
96;19.01.2015;2015;01;08;Maanantai;119;59;178;35;19;54
96;19.01.2015;2015;01;09;Maanantai;76;40;116;24;15;39
96;19.01.2015;2015;01;10;Maanantai;43;30;73;11;14;25
96;19.01.2015;2015;01;11;Maanantai;37;46;83;17;18;35
96;19.01.2015;2015;01;12;Maanantai;54;54;108;12;22;34
96;19.01.2015;2015;01;13;Maanantai;58;53;111;22;22;44
96;19.01.2015;2015;01;14;Maanantai;23;87;110;11;38;49
96;19.01.2015;2015;01;15;Maanantai;60;133;193;12;60;72
96;19.01.2015;2015;01;16;Maanantai;70;110;180;13;50;63
96;19.01.2015;2015;01;17;Maanantai;53;44;97;11;27;38
96;19.01.2015;2015;01;18;Maanantai;44;35;79;19;20;39
96;19.01.2015;2015;01;19;Maanantai;28;27;55;11;15;26
96;19.01.2015;2015;01;20;Maanantai;36;19;55;8;18;26
96;19.01.2015;2015;01;21;Maanantai;17;17;34;9;5;14
96;19.01.2015;2015;01;22;Maanantai;10;7;17;1;0;1
96;19.01.2015;2015;01;23;Maanantai;7;0;7;2;0;2
96;20.01.2015;2015;01;00;Tiistai;1;0;1;0;1;1
96;20.01.2015;2015;01;01;Tiistai;0;0;0;0;1;1
96;20.01.2015;2015;01;02;Tiistai;0;0;0;1;0;1
96;20.01.2015;2015;01;03;Tiistai;0;1;1;1;0;1
96;20.01.2015;2015;01;04;Tiistai;0;1;1;0;2;2
96;20.01.2015;2015;01;05;Tiistai;7;2;9;1;1;2
96;20.01.2015;2015;01;06;Tiistai;26;19;45;15;9;24
96;20.01.2015;2015;01;07;Tiistai;103;57;160;57;12;69
96;20.01.2015;2015;01;08;Tiistai;82;58;140;28;8;36
96;20.01.2015;2015;01;09;Tiistai;71;44;115;19;11;30
96;20.01.2015;2015;01;10;Tiistai;34;23;57;11;16;27
96;20.01.2015;2015;01;11;Tiistai;43;37;80;15;17;32
96;20.01.2015;2015;01;12;Tiistai;32;25;57;22;15;37
96;20.01.2015;2015;01;13;Tiistai;33;42;75;11;25;36
96;20.01.2015;2015;01;14;Tiistai;42;80;122;8;29;37
96;20.01.2015;2015;01;15;Tiistai;40;140;180;13;58;71
96;20.01.2015;2015;01;16;Tiistai;52;103;155;19;62;81
96;20.01.2015;2015;01;17;Tiistai;22;36;58;10;34;44
96;20.01.2015;2015;01;18;Tiistai;29;34;63;14;18;32
96;20.01.2015;2015;01;19;Tiistai;30;15;45;14;16;30
96;20.01.2015;2015;01;20;Tiistai;25;10;35;6;13;19
96;20.01.2015;2015;01;21;Tiistai;24;24;48;23;8;31
96;20.01.2015;2015;01;22;Tiistai;10;2;12;4;3;7
96;20.01.2015;2015;01;23;Tiistai;6;5;11;2;0;2
96;21.01.2015;2015;01;00;Keskiviikko;1;0;1;0;1;1
96;21.01.2015;2015;01;01;Keskiviikko;3;0;3;0;0;0
96;21.01.2015;2015;01;02;Keskiviikko;2;0;2;0;0;0
96;21.01.2015;2015;01;03;Keskiviikko;1;1;2;1;0;1
96;21.01.2015;2015;01;04;Keskiviikko;6;2;8;2;0;2
96;21.01.2015;2015;01;05;Keskiviikko;3;4;7;2;1;3
96;21.01.2015;2015;01;06;Keskiviikko;34;20;54;18;3;21
96;21.01.2015;2015;01;07;Keskiviikko;93;64;157;48;15;63
96;21.01.2015;2015;01;08;Keskiviikko;82;56;138;26;11;37
96;21.01.2015;2015;01;09;Keskiviikko;67;45;112;27;9;36
96;21.01.2015;2015;01;10;Keskiviikko;51;41;92;18;11;29
96;21.01.2015;2015;01;11;Keskiviikko;67;36;103;24;13;37
96;21.01.2015;2015;01;12;Keskiviikko;54;46;100;20;15;35
96;21.01.2015;2015;01;13;Keskiviikko;38;53;91;13;29;42
96;21.01.2015;2015;01;14;Keskiviikko;44;87;131;11;36;47
96;21.01.2015;2015;01;15;Keskiviikko;45;123;168;14;70;84
96;21.01.2015;2015;01;16;Keskiviikko;70;106;176;17;46;63
96;21.01.2015;2015;01;17;Keskiviikko;35;35;70;12;14;26
96;21.01.2015;2015;01;18;Keskiviikko;59;28;87;21;14;35
96;21.01.2015;2015;01;19;Keskiviikko;33;30;63;15;18;33
96;21.01.2015;2015;01;20;Keskiviikko;26;30;56;8;15;23
96;21.01.2015;2015;01;21;Keskiviikko;16;30;46;8;16;24
96;21.01.2015;2015;01;22;Keskiviikko;12;7;19;3;4;7
96;21.01.2015;2015;01;23;Keskiviikko;4;0;4;2;0;2
96;22.01.2015;2015;01;00;Torstai;5;0;5;0;1;1
96;22.01.2015;2015;01;01;Torstai;0;0;0;0;0;0
96;22.01.2015;2015;01;02;Torstai;1;0;1;0;0;0
96;22.01.2015;2015;01;03;Torstai;0;0;0;0;0;0
96;22.01.2015;2015;01;04;Torstai;1;1;2;0;0;0
96;22.01.2015;2015;01;05;Torstai;2;7;9;2;3;5
96;22.01.2015;2015;01;06;Torstai;28;12;40;12;6;18
96;22.01.2015;2015;01;07;Torstai;96;43;139;42;13;55
96;22.01.2015;2015;01;08;Torstai;110;45;155;31;11;42
96;22.01.2015;2015;01;09;Torstai;58;40;98;17;11;28
96;22.01.2015;2015;01;10;Torstai;23;26;49;24;11;35
96;22.01.2015;2015;01;11;Torstai;49;35;84;15;25;40
96;22.01.2015;2015;01;12;Torstai;39;49;88;17;12;29
96;22.01.2015;2015;01;13;Torstai;32;51;83;11;17;28
96;22.01.2015;2015;01;14;Torstai;44;104;148;11;33;44
96;22.01.2015;2015;01;15;Torstai;33;137;170;11;60;71
96;22.01.2015;2015;01;16;Torstai;56;92;148;11;48;59
96;22.01.2015;2015;01;17;Torstai;49;37;86;13;23;36
96;22.01.2015;2015;01;18;Torstai;28;38;66;17;26;43
96;22.01.2015;2015;01;19;Torstai;30;16;46;12;12;24
96;22.01.2015;2015;01;20;Torstai;20;18;38;12;12;24
96;22.01.2015;2015;01;21;Torstai;17;22;39;4;12;16
96;22.01.2015;2015;01;22;Torstai;9;10;19;0;2;2
96;22.01.2015;2015;01;23;Torstai;1;0;1;0;1;1
96;23.01.2015;2015;01;00;Perjantai;0;1;1;0;0;0
96;23.01.2015;2015;01;01;Perjantai;0;0;0;0;0;0
96;23.01.2015;2015;01;02;Perjantai;4;1;5;0;0;0
96;23.01.2015;2015;01;03;Perjantai;0;0;0;0;0;0
96;23.01.2015;2015;01;04;Perjantai;3;1;4;0;0;0
96;23.01.2015;2015;01;05;Perjantai;1;1;2;1;1;2
96;23.01.2015;2015;01;06;Perjantai;34;9;43;18;4;22
96;23.01.2015;2015;01;07;Perjantai;90;38;128;52;19;71
96;23.01.2015;2015;01;08;Perjantai;62;36;98;23;8;31
96;23.01.2015;2015;01;09;Perjantai;26;26;52;16;14;30
96;23.01.2015;2015;01;10;Perjantai;23;37;60;13;16;29
96;23.01.2015;2015;01;11;Perjantai;47;31;78;7;20;27
96;23.01.2015;2015;01;12;Perjantai;36;37;73;20;19;39
96;23.01.2015;2015;01;13;Perjantai;33;61;94;12;37;49
96;23.01.2015;2015;01;14;Perjantai;27;91;118;6;43;49
96;23.01.2015;2015;01;15;Perjantai;31;93;124;7;43;50
96;23.01.2015;2015;01;16;Perjantai;32;45;77;9;28;37
96;23.01.2015;2015;01;17;Perjantai;27;33;60;3;25;28
96;23.01.2015;2015;01;18;Perjantai;16;21;37;6;11;17
96;23.01.2015;2015;01;19;Perjantai;16;11;27;8;11;19
96;23.01.2015;2015;01;20;Perjantai;7;8;15;10;6;16
96;23.01.2015;2015;01;21;Perjantai;21;15;36;9;5;14
96;23.01.2015;2015;01;22;Perjantai;8;2;10;2;4;6
96;23.01.2015;2015;01;23;Perjantai;10;2;12;3;1;4
96;24.01.2015;2015;01;00;Lauantai;1;5;6;1;5;6
96;24.01.2015;2015;01;01;Lauantai;4;0;4;1;1;2
96;24.01.2015;2015;01;02;Lauantai;2;0;2;2;0;2
96;24.01.2015;2015;01;03;Lauantai;4;0;4;3;0;3
96;24.01.2015;2015;01;04;Lauantai;7;2;9;3;0;3
96;24.01.2015;2015;01;05;Lauantai;1;2;3;0;1;1
96;24.01.2015;2015;01;06;Lauantai;16;5;21;7;0;7
96;24.01.2015;2015;01;07;Lauantai;1;7;8;3;2;5
96;24.01.2015;2015;01;08;Lauantai;3;7;10;2;3;5
96;24.01.2015;2015;01;09;Lauantai;5;12;17;5;11;16
96;24.01.2015;2015;01;10;Lauantai;6;14;20;5;6;11
96;24.01.2015;2015;01;11;Lauantai;23;20;43;11;12;23
96;24.01.2015;2015;01;12;Lauantai;33;21;54;9;12;21
96;24.01.2015;2015;01;13;Lauantai;19;22;41;12;15;27
96;24.01.2015;2015;01;14;Lauantai;20;23;43;12;13;25
96;24.01.2015;2015;01;15;Lauantai;24;25;49;10;9;19
96;24.01.2015;2015;01;16;Lauantai;25;27;52;9;4;13
96;24.01.2015;2015;01;17;Lauantai;26;12;38;16;13;29
96;24.01.2015;2015;01;18;Lauantai;18;5;23;11;8;19
96;24.01.2015;2015;01;19;Lauantai;9;11;20;7;10;17
96;24.01.2015;2015;01;20;Lauantai;9;9;18;11;7;18
96;24.01.2015;2015;01;21;Lauantai;3;15;18;6;4;10
96;24.01.2015;2015;01;22;Lauantai;4;7;11;7;7;14
96;24.01.2015;2015;01;23;Lauantai;3;5;8;2;1;3
96;25.01.2015;2015;01;00;Sunnuntai;5;5;10;2;2;4
96;25.01.2015;2015;01;01;Sunnuntai;5;1;6;2;1;3
96;25.01.2015;2015;01;02;Sunnuntai;2;1;3;2;0;2
96;25.01.2015;2015;01;03;Sunnuntai;10;0;10;0;1;1
96;25.01.2015;2015;01;04;Sunnuntai;0;0;0;2;1;3
96;25.01.2015;2015;01;05;Sunnuntai;0;1;1;0;0;0
96;25.01.2015;2015;01;06;Sunnuntai;11;8;19;3;1;4
96;25.01.2015;2015;01;07;Sunnuntai;0;4;4;1;2;3
96;25.01.2015;2015;01;08;Sunnuntai;0;3;3;1;2;3
96;25.01.2015;2015;01;09;Sunnuntai;7;5;12;6;4;10
96;25.01.2015;2015;01;10;Sunnuntai;10;14;24;6;4;10
96;25.01.2015;2015;01;11;Sunnuntai;19;12;31;9;10;19
96;25.01.2015;2015;01;12;Sunnuntai;34;18;52;16;9;25
96;25.01.2015;2015;01;13;Sunnuntai;18;17;35;15;14;29
96;25.01.2015;2015;01;14;Sunnuntai;24;20;44;16;12;28
96;25.01.2015;2015;01;15;Sunnuntai;22;26;48;10;13;23
96;25.01.2015;2015;01;16;Sunnuntai;36;17;53;19;6;25
96;25.01.2015;2015;01;17;Sunnuntai;22;13;35;7;9;16
96;25.01.2015;2015;01;18;Sunnuntai;19;20;39;25;11;36
96;25.01.2015;2015;01;19;Sunnuntai;10;18;28;9;15;24
96;25.01.2015;2015;01;20;Sunnuntai;15;21;36;11;18;29
96;25.01.2015;2015;01;21;Sunnuntai;11;18;29;6;11;17
96;25.01.2015;2015;01;22;Sunnuntai;3;2;5;0;5;5
96;25.01.2015;2015;01;23;Sunnuntai;4;2;6;0;0;0
96;26.01.2015;2015;01;00;Maanantai;0;1;1;0;1;1
96;26.01.2015;2015;01;01;Maanantai;4;0;4;1;0;1
96;26.01.2015;2015;01;02;Maanantai;1;1;2;0;0;0
96;26.01.2015;2015;01;03;Maanantai;1;0;1;0;0;0
96;26.01.2015;2015;01;04;Maanantai;2;2;4;0;1;1
96;26.01.2015;2015;01;05;Maanantai;2;7;9;1;1;2
96;26.01.2015;2015;01;06;Maanantai;33;21;54;8;10;18
96;26.01.2015;2015;01;07;Maanantai;108;63;171;39;19;58
96;26.01.2015;2015;01;08;Maanantai;81;75;156;18;18;36
96;26.01.2015;2015;01;09;Maanantai;61;43;104;19;14;33
96;26.01.2015;2015;01;10;Maanantai;51;47;98;12;15;27
96;26.01.2015;2015;01;11;Maanantai;55;42;97;13;17;30
96;26.01.2015;2015;01;12;Maanantai;38;33;71;21;18;39
96;26.01.2015;2015;01;13;Maanantai;53;51;104;10;23;33
96;26.01.2015;2015;01;14;Maanantai;49;78;127;11;34;45
96;26.01.2015;2015;01;15;Maanantai;79;161;240;12;40;52
96;26.01.2015;2015;01;16;Maanantai;56;103;159;13;31;44
96;26.01.2015;2015;01;17;Maanantai;61;33;94;16;21;37
96;26.01.2015;2015;01;18;Maanantai;60;24;84;20;4;24
96;26.01.2015;2015;01;19;Maanantai;64;10;74;23;3;26
96;26.01.2015;2015;01;20;Maanantai;45;6;51;21;0;21
96;26.01.2015;2015;01;21;Maanantai;26;0;26;11;0;11
96;26.01.2015;2015;01;22;Maanantai;12;0;12;4;0;4
96;26.01.2015;2015;01;23;Maanantai;5;0;5;1;0;1
96;27.01.2015;2015;01;00;Tiistai;0;0;0;0;0;0
96;27.01.2015;2015;01;01;Tiistai;0;0;0;0;0;0
96;27.01.2015;2015;01;02;Tiistai;2;0;2;0;0;0
96;27.01.2015;2015;01;03;Tiistai;1;0;1;0;0;0
96;27.01.2015;2015;01;04;Tiistai;3;0;3;3;0;3
96;27.01.2015;2015;01;05;Tiistai;5;0;5;3;0;3
96;27.01.2015;2015;01;06;Tiistai;43;0;43;21;0;21
96;27.01.2015;2015;01;07;Tiistai;199;0;199;52;0;52
96;27.01.2015;2015;01;08;Tiistai;198;0;198;35;0;35
96;27.01.2015;2015;01;09;Tiistai;60;0;60;47;0;47
96;27.01.2015;2015;01;10;Tiistai;75;0;75;38;0;38
96;27.01.2015;2015;01;11;Tiistai;89;0;89;36;0;36
96;27.01.2015;2015;01;12;Tiistai;101;1;102;48;0;48
96;27.01.2015;2015;01;13;Tiistai;98;5;103;40;4;44
96;27.01.2015;2015;01;14;Tiistai;118;5;123;51;0;51
96;27.01.2015;2015;01;15;Tiistai;209;7;216;53;1;54
96;27.01.2015;2015;01;16;Tiistai;179;8;187;52;1;53
96;27.01.2015;2015;01;17;Tiistai;84;2;86;38;2;40
96;27.01.2015;2015;01;18;Tiistai;83;7;90;34;0;34
96;27.01.2015;2015;01;19;Tiistai;81;1;82;42;1;43
96;27.01.2015;2015;01;20;Tiistai;59;3;62;33;1;34
96;27.01.2015;2015;01;21;Tiistai;54;2;56;28;3;31
96;27.01.2015;2015;01;22;Tiistai;13;0;13;4;0;4
96;27.01.2015;2015;01;23;Tiistai;3;0;3;2;0;2
96;28.01.2015;2015;01;00;Keskiviikko;3;0;3;3;0;3
96;28.01.2015;2015;01;01;Keskiviikko;4;0;4;0;0;0
96;28.01.2015;2015;01;02;Keskiviikko;2;0;2;0;0;0
96;28.01.2015;2015;01;03;Keskiviikko;2;0;2;0;0;0
96;28.01.2015;2015;01;04;Keskiviikko;3;0;3;1;0;1
96;28.01.2015;2015;01;05;Keskiviikko;13;0;13;1;0;1
96;28.01.2015;2015;01;06;Keskiviikko;62;2;64;16;0;16
96;28.01.2015;2015;01;07;Keskiviikko;182;0;182;54;0;54
96;28.01.2015;2015;01;08;Keskiviikko;163;1;164;45;0;45
96;28.01.2015;2015;01;09;Keskiviikko;82;1;83;24;0;24
96;28.01.2015;2015;01;10;Keskiviikko;85;1;86;28;0;28
96;28.01.2015;2015;01;11;Keskiviikko;91;0;91;37;0;37
96;28.01.2015;2015;01;12;Keskiviikko;104;0;104;28;0;28
96;28.01.2015;2015;01;13;Keskiviikko;116;0;116;37;0;37
96;28.01.2015;2015;01;14;Keskiviikko;128;0;128;37;0;37
96;28.01.2015;2015;01;15;Keskiviikko;190;0;190;51;0;51
96;28.01.2015;2015;01;16;Keskiviikko;166;0;166;49;0;49
96;28.01.2015;2015;01;17;Keskiviikko;89;0;89;45;0;45
96;28.01.2015;2015;01;18;Keskiviikko;94;0;94;42;0;42
96;28.01.2015;2015;01;19;Keskiviikko;72;0;72;29;0;29
96;28.01.2015;2015;01;20;Keskiviikko;53;0;53;18;0;18
96;28.01.2015;2015;01;21;Keskiviikko;28;0;28;16;0;16
96;28.01.2015;2015;01;22;Keskiviikko;21;0;21;4;0;4
96;28.01.2015;2015;01;23;Keskiviikko;10;0;10;2;0;2
96;29.01.2015;2015;01;00;Torstai;3;0;3;0;0;0
96;29.01.2015;2015;01;01;Torstai;0;0;0;2;0;2
96;29.01.2015;2015;01;02;Torstai;0;0;0;0;0;0
96;29.01.2015;2015;01;03;Torstai;0;0;0;5;0;5
96;29.01.2015;2015;01;04;Torstai;3;0;3;0;0;0
96;29.01.2015;2015;01;05;Torstai;11;0;11;1;0;1
96;29.01.2015;2015;01;06;Torstai;52;2;54;19;0;19
96;29.01.2015;2015;01;07;Torstai;175;1;176;53;0;53
96;29.01.2015;2015;01;08;Torstai;199;1;200;32;0;32
96;29.01.2015;2015;01;09;Torstai;51;29;80;53;33;86
96;29.01.2015;2015;01;10;Torstai;32;35;67;18;14;32
96;29.01.2015;2015;01;11;Torstai;28;43;71;9;9;18
96;29.01.2015;2015;01;12;Torstai;50;45;95;15;17;32
96;29.01.2015;2015;01;13;Torstai;29;56;85;8;15;23
96;29.01.2015;2015;01;14;Torstai;48;88;136;12;23;35
96;29.01.2015;2015;01;15;Torstai;48;103;151;16;52;68
96;29.01.2015;2015;01;16;Torstai;59;94;153;19;25;44
96;29.01.2015;2015;01;17;Torstai;40;39;79;15;16;31
96;29.01.2015;2015;01;18;Torstai;35;50;85;28;26;54
96;29.01.2015;2015;01;19;Torstai;24;25;49;14;14;28
96;29.01.2015;2015;01;20;Torstai;31;17;48;13;15;28
96;29.01.2015;2015;01;21;Torstai;14;18;32;4;6;10
96;29.01.2015;2015;01;22;Torstai;6;6;12;1;2;3
96;29.01.2015;2015;01;23;Torstai;2;1;3;2;0;2
96;30.01.2015;2015;01;00;Perjantai;1;1;2;0;0;0
96;30.01.2015;2015;01;01;Perjantai;0;2;2;0;0;0
96;30.01.2015;2015;01;02;Perjantai;1;0;1;0;0;0
96;30.01.2015;2015;01;03;Perjantai;1;0;1;1;0;1
96;30.01.2015;2015;01;04;Perjantai;5;2;7;2;4;6
96;30.01.2015;2015;01;05;Perjantai;3;1;4;0;2;2
96;30.01.2015;2015;01;06;Perjantai;27;18;45;14;6;20
96;30.01.2015;2015;01;07;Perjantai;98;65;163;42;17;59
96;30.01.2015;2015;01;08;Perjantai;94;64;158;19;17;36
96;30.01.2015;2015;01;09;Perjantai;40;54;94;10;10;20
96;30.01.2015;2015;01;10;Perjantai;26;56;82;8;22;30
96;30.01.2015;2015;01;11;Perjantai;48;61;109;13;37;50
96;30.01.2015;2015;01;12;Perjantai;55;77;132;24;31;55
96;30.01.2015;2015;01;13;Perjantai;46;84;130;17;20;37
96;30.01.2015;2015;01;14;Perjantai;47;88;135;14;25;39
96;30.01.2015;2015;01;15;Perjantai;43;94;137;14;48;62
96;30.01.2015;2015;01;16;Perjantai;54;61;115;15;28;43
96;30.01.2015;2015;01;17;Perjantai;44;42;86;11;19;30
96;30.01.2015;2015;01;18;Perjantai;30;35;65;13;21;34
96;30.01.2015;2015;01;19;Perjantai;18;24;42;10;6;16
96;30.01.2015;2015;01;20;Perjantai;19;25;44;11;4;15
96;30.01.2015;2015;01;21;Perjantai;22;13;35;9;3;12
96;30.01.2015;2015;01;22;Perjantai;12;2;14;2;2;4
96;30.01.2015;2015;01;23;Perjantai;11;2;13;0;3;3
96;31.01.2015;2015;01;00;Lauantai;0;1;1;0;3;3
96;31.01.2015;2015;01;01;Lauantai;4;2;6;0;1;1
96;31.01.2015;2015;01;02;Lauantai;3;3;6;0;0;0
96;31.01.2015;2015;01;03;Lauantai;7;1;8;1;0;1
96;31.01.2015;2015;01;04;Lauantai;5;0;5;2;0;2
96;31.01.2015;2015;01;05;Lauantai;2;2;4;1;0;1
96;31.01.2015;2015;01;06;Lauantai;12;2;14;7;1;8
96;31.01.2015;2015;01;07;Lauantai;10;9;19;1;5;6
96;31.01.2015;2015;01;08;Lauantai;1;9;10;2;5;7
96;31.01.2015;2015;01;09;Lauantai;13;17;30;8;7;15
96;31.01.2015;2015;01;10;Lauantai;17;21;38;10;12;22
96;31.01.2015;2015;01;11;Lauantai;20;24;44;10;10;20
96;31.01.2015;2015;01;12;Lauantai;19;16;35;13;18;31
96;31.01.2015;2015;01;13;Lauantai;18;31;49;7;13;20
96;31.01.2015;2015;01;14;Lauantai;25;29;54;9;13;22
96;31.01.2015;2015;01;15;Lauantai;25;24;49;12;19;31
96;31.01.2015;2015;01;16;Lauantai;30;14;44;12;11;23
96;31.01.2015;2015;01;17;Lauantai;14;22;36;16;14;30
96;31.01.2015;2015;01;18;Lauantai;30;18;48;21;7;28
96;31.01.2015;2015;01;19;Lauantai;21;10;31;8;13;21
96;31.01.2015;2015;01;20;Lauantai;7;13;20;9;5;14
96;31.01.2015;2015;01;21;Lauantai;3;32;35;1;11;12
96;31.01.2015;2015;01;22;Lauantai;2;7;9;0;3;3
96;31.01.2015;2015;01;23;Lauantai;2;4;6;0;1;1
96;01.02.2015;2015;02;00;Sunnuntai;3;6;9;0;2;2
96;01.02.2015;2015;02;01;Sunnuntai;3;2;5;1;1;2
96;01.02.2015;2015;02;02;Sunnuntai;5;1;6;1;1;2
96;01.02.2015;2015;02;03;Sunnuntai;8;1;9;3;0;3
96;01.02.2015;2015;02;04;Sunnuntai;4;3;7;3;0;3
96;01.02.2015;2015;02;05;Sunnuntai;2;0;2;0;1;1
96;01.02.2015;2015;02;06;Sunnuntai;6;5;11;5;2;7
96;01.02.2015;2015;02;07;Sunnuntai;0;4;4;3;2;5
96;01.02.2015;2015;02;08;Sunnuntai;1;6;7;1;0;1
96;01.02.2015;2015;02;09;Sunnuntai;3;1;4;6;3;9
96;01.02.2015;2015;02;10;Sunnuntai;3;8;11;8;8;16
96;01.02.2015;2015;02;11;Sunnuntai;4;9;13;7;6;13
96;01.02.2015;2015;02;12;Sunnuntai;17;13;30;15;14;29
96;01.02.2015;2015;02;13;Sunnuntai;17;19;36;10;12;22
96;01.02.2015;2015;02;14;Sunnuntai;20;15;35;11;12;23
96;01.02.2015;2015;02;15;Sunnuntai;23;15;38;13;11;24
96;01.02.2015;2015;02;16;Sunnuntai;20;6;26;18;12;30
96;01.02.2015;2015;02;17;Sunnuntai;15;12;27;13;13;26
96;01.02.2015;2015;02;18;Sunnuntai;13;14;27;13;14;27
96;01.02.2015;2015;02;19;Sunnuntai;13;10;23;12;14;26
96;01.02.2015;2015;02;20;Sunnuntai;8;15;23;7;5;12
96;01.02.2015;2015;02;21;Sunnuntai;6;8;14;2;9;11
96;01.02.2015;2015;02;22;Sunnuntai;3;3;6;2;3;5
96;01.02.2015;2015;02;23;Sunnuntai;0;1;1;1;2;3
96;02.02.2015;2015;02;00;Maanantai;1;1;2;0;2;2
96;02.02.2015;2015;02;01;Maanantai;1;0;1;0;0;0
96;02.02.2015;2015;02;02;Maanantai;1;0;1;0;0;0
96;02.02.2015;2015;02;03;Maanantai;0;0;0;0;0;0
96;02.02.2015;2015;02;04;Maanantai;2;1;3;9;2;11
96;02.02.2015;2015;02;05;Maanantai;5;5;10;2;1;3
96;02.02.2015;2015;02;06;Maanantai;21;18;39;15;7;22
96;02.02.2015;2015;02;07;Maanantai;107;71;178;46;9;55
96;02.02.2015;2015;02;08;Maanantai;110;83;193;34;14;48
96;02.02.2015;2015;02;09;Maanantai;56;47;103;22;7;29
96;02.02.2015;2015;02;10;Maanantai;38;28;66;10;17;27
96;02.02.2015;2015;02;11;Maanantai;44;37;81;24;17;41
96;02.02.2015;2015;02;12;Maanantai;50;47;97;14;15;29
96;02.02.2015;2015;02;13;Maanantai;37;45;82;12;8;20
96;02.02.2015;2015;02;14;Maanantai;40;87;127;15;33;48
96;02.02.2015;2015;02;15;Maanantai;55;137;192;10;53;63
96;02.02.2015;2015;02;16;Maanantai;75;119;194;17;36;53
96;02.02.2015;2015;02;17;Maanantai;54;59;113;9;16;25
96;02.02.2015;2015;02;18;Maanantai;39;29;68;12;20;32
96;02.02.2015;2015;02;19;Maanantai;19;35;54;21;14;35
96;02.02.2015;2015;02;20;Maanantai;38;30;68;13;16;29
96;02.02.2015;2015;02;21;Maanantai;17;31;48;3;10;13
96;02.02.2015;2015;02;22;Maanantai;8;4;12;0;2;2
96;02.02.2015;2015;02;23;Maanantai;0;1;1;2;2;4
96;03.02.2015;2015;02;00;Tiistai;0;2;2;0;0;0
96;03.02.2015;2015;02;01;Tiistai;1;0;1;0;0;0
96;03.02.2015;2015;02;02;Tiistai;2;0;2;0;0;0
96;03.02.2015;2015;02;03;Tiistai;0;0;0;2;0;2
96;03.02.2015;2015;02;04;Tiistai;1;3;4;0;1;1
96;03.02.2015;2015;02;05;Tiistai;6;5;11;1;1;2
96;03.02.2015;2015;02;06;Tiistai;38;29;67;10;8;18
96;03.02.2015;2015;02;07;Tiistai;97;71;168;47;10;57
96;03.02.2015;2015;02;08;Tiistai;109;72;181;32;9;41
96;03.02.2015;2015;02;09;Tiistai;40;37;77;20;8;28
96;03.02.2015;2015;02;10;Tiistai;33;32;65;14;13;27
96;03.02.2015;2015;02;11;Tiistai;46;35;81;9;18;27
96;03.02.2015;2015;02;12;Tiistai;48;52;100;15;17;32
96;03.02.2015;2015;02;13;Tiistai;27;77;104;8;26;34
96;03.02.2015;2015;02;14;Tiistai;43;88;131;10;24;34
96;03.02.2015;2015;02;15;Tiistai;60;151;211;15;53;68
96;03.02.2015;2015;02;16;Tiistai;63;119;182;13;40;53
96;03.02.2015;2015;02;17;Tiistai;41;43;84;6;15;21
96;03.02.2015;2015;02;18;Tiistai;39;37;76;16;17;33
96;03.02.2015;2015;02;19;Tiistai;42;28;70;14;19;33
96;03.02.2015;2015;02;20;Tiistai;32;27;59;12;16;28
96;03.02.2015;2015;02;21;Tiistai;22;25;47;6;13;19
96;03.02.2015;2015;02;22;Tiistai;3;6;9;3;2;5
96;03.02.2015;2015;02;23;Tiistai;4;6;10;2;2;4
96;04.02.2015;2015;02;00;Keskiviikko;0;0;0;0;0;0
96;04.02.2015;2015;02;01;Keskiviikko;0;1;1;0;0;0
96;04.02.2015;2015;02;02;Keskiviikko;0;1;1;1;0;1
96;04.02.2015;2015;02;03;Keskiviikko;0;0;0;0;0;0
96;04.02.2015;2015;02;04;Keskiviikko;3;3;6;1;0;1
96;04.02.2015;2015;02;05;Keskiviikko;5;8;13;2;2;4
96;04.02.2015;2015;02;06;Keskiviikko;42;36;78;20;9;29
96;04.02.2015;2015;02;07;Keskiviikko;101;84;185;40;13;53
96;04.02.2015;2015;02;08;Keskiviikko;94;60;154;28;11;39
96;04.02.2015;2015;02;09;Keskiviikko;59;41;100;29;14;43
96;04.02.2015;2015;02;10;Keskiviikko;28;36;64;10;8;18
96;04.02.2015;2015;02;11;Keskiviikko;45;32;77;9;13;22
96;04.02.2015;2015;02;12;Keskiviikko;52;50;102;16;20;36
96;04.02.2015;2015;02;13;Keskiviikko;33;68;101;14;20;34
96;04.02.2015;2015;02;14;Keskiviikko;37;86;123;10;31;41
96;04.02.2015;2015;02;15;Keskiviikko;80;122;202;11;62;73
96;04.02.2015;2015;02;16;Keskiviikko;68;125;193;13;36;49
96;04.02.2015;2015;02;17;Keskiviikko;62;56;118;15;20;35
96;04.02.2015;2015;02;18;Keskiviikko;50;38;88;18;21;39
96;04.02.2015;2015;02;19;Keskiviikko;39;23;62;14;17;31
96;04.02.2015;2015;02;20;Keskiviikko;33;22;55;8;17;25
96;04.02.2015;2015;02;21;Keskiviikko;13;28;41;5;10;15
96;04.02.2015;2015;02;22;Keskiviikko;5;9;14;0;3;3
96;04.02.2015;2015;02;23;Keskiviikko;3;2;5;1;0;1
96;05.02.2015;2015;02;00;Torstai;2;2;4;2;2;4
96;05.02.2015;2015;02;01;Torstai;0;0;0;0;0;0
96;05.02.2015;2015;02;02;Torstai;0;0;0;0;0;0
96;05.02.2015;2015;02;03;Torstai;0;1;1;0;0;0
96;05.02.2015;2015;02;04;Torstai;2;3;5;0;0;0
96;05.02.2015;2015;02;05;Torstai;4;5;9;2;0;2
96;05.02.2015;2015;02;06;Torstai;46;26;72;15;4;19
96;05.02.2015;2015;02;07;Torstai;108;73;181;48;9;57
96;05.02.2015;2015;02;08;Torstai;101;67;168;22;9;31
96;05.02.2015;2015;02;09;Torstai;51;40;91;21;8;29
96;05.02.2015;2015;02;10;Torstai;44;31;75;19;5;24
96;05.02.2015;2015;02;11;Torstai;57;35;92;23;14;37
96;05.02.2015;2015;02;12;Torstai;43;41;84;11;14;25
96;05.02.2015;2015;02;13;Torstai;54;57;111;11;14;25
96;05.02.2015;2015;02;14;Torstai;41;106;147;12;34;46
96;05.02.2015;2015;02;15;Torstai;73;153;226;15;51;66
96;05.02.2015;2015;02;16;Torstai;63;145;208;14;34;48
96;05.02.2015;2015;02;17;Torstai;52;43;95;16;21;37
96;05.02.2015;2015;02;18;Torstai;33;35;68;30;29;59
96;05.02.2015;2015;02;19;Torstai;40;25;65;13;7;20
96;05.02.2015;2015;02;20;Torstai;43;18;61;10;3;13
96;05.02.2015;2015;02;21;Torstai;17;23;40;3;5;8
96;05.02.2015;2015;02;22;Torstai;11;13;24;4;3;7
96;05.02.2015;2015;02;23;Torstai;4;4;8;4;2;6
96;06.02.2015;2015;02;00;Perjantai;6;1;7;0;2;2
96;06.02.2015;2015;02;01;Perjantai;6;1;7;1;0;1
96;06.02.2015;2015;02;02;Perjantai;6;3;9;0;0;0
96;06.02.2015;2015;02;03;Perjantai;2;3;5;2;0;2
96;06.02.2015;2015;02;04;Perjantai;5;4;9;0;0;0
96;06.02.2015;2015;02;05;Perjantai;5;5;10;1;2;3
96;06.02.2015;2015;02;06;Perjantai;41;23;64;16;5;21
96;06.02.2015;2015;02;07;Perjantai;129;68;197;42;7;49
96;06.02.2015;2015;02;08;Perjantai;102;50;152;22;8;30
96;06.02.2015;2015;02;09;Perjantai;53;42;95;18;5;23
96;06.02.2015;2015;02;10;Perjantai;35;52;87;13;14;27
96;06.02.2015;2015;02;11;Perjantai;61;58;119;23;33;56
96;06.02.2015;2015;02;12;Perjantai;66;62;128;27;32;59
96;06.02.2015;2015;02;13;Perjantai;62;79;141;17;34;51
96;06.02.2015;2015;02;14;Perjantai;52;95;147;20;43;63
96;06.02.2015;2015;02;15;Perjantai;69;100;169;15;49;64
96;06.02.2015;2015;02;16;Perjantai;60;48;108;14;12;26
96;06.02.2015;2015;02;17;Perjantai;51;38;89;12;10;22
96;06.02.2015;2015;02;18;Perjantai;29;28;57;8;11;19
96;06.02.2015;2015;02;19;Perjantai;26;8;34;12;11;23
96;06.02.2015;2015;02;20;Perjantai;22;13;35;10;3;13
96;06.02.2015;2015;02;21;Perjantai;7;16;23;1;6;7
96;06.02.2015;2015;02;22;Perjantai;3;4;7;1;2;3
96;06.02.2015;2015;02;23;Perjantai;4;5;9;2;5;7
96;07.02.2015;2015;02;00;Lauantai;0;6;6;2;1;3
96;07.02.2015;2015;02;01;Lauantai;1;1;2;0;0;0
96;07.02.2015;2015;02;02;Lauantai;5;2;7;0;0;0
96;07.02.2015;2015;02;03;Lauantai;6;2;8;0;0;0
96;07.02.2015;2015;02;04;Lauantai;1;0;1;2;1;3
96;07.02.2015;2015;02;05;Lauantai;3;3;6;1;0;1
96;07.02.2015;2015;02;06;Lauantai;12;9;21;4;1;5
96;07.02.2015;2015;02;07;Lauantai;9;14;23;4;3;7
96;07.02.2015;2015;02;08;Lauantai;8;4;12;6;10;16
96;07.02.2015;2015;02;09;Lauantai;6;12;18;12;9;21
96;07.02.2015;2015;02;10;Lauantai;16;14;30;13;10;23
96;07.02.2015;2015;02;11;Lauantai;15;19;34;13;14;27
96;07.02.2015;2015;02;12;Lauantai;29;24;53;14;13;27
96;07.02.2015;2015;02;13;Lauantai;15;27;42;8;11;19
96;07.02.2015;2015;02;14;Lauantai;23;23;46;7;19;26
96;07.02.2015;2015;02;15;Lauantai;22;28;50;17;14;31
96;07.02.2015;2015;02;16;Lauantai;22;14;36;11;17;28
96;07.02.2015;2015;02;17;Lauantai;19;12;31;9;5;14
96;07.02.2015;2015;02;18;Lauantai;34;17;51;9;12;21
96;07.02.2015;2015;02;19;Lauantai;5;12;17;4;5;9
96;07.02.2015;2015;02;20;Lauantai;12;11;23;9;6;15
96;07.02.2015;2015;02;21;Lauantai;10;16;26;1;3;4
96;07.02.2015;2015;02;22;Lauantai;0;3;3;2;3;5
96;07.02.2015;2015;02;23;Lauantai;3;6;9;4;0;4
96;08.02.2015;2015;02;00;Sunnuntai;6;4;10;5;3;8
96;08.02.2015;2015;02;01;Sunnuntai;8;3;11;1;0;1
96;08.02.2015;2015;02;02;Sunnuntai;2;0;2;1;0;1
96;08.02.2015;2015;02;03;Sunnuntai;3;1;4;1;0;1
96;08.02.2015;2015;02;04;Sunnuntai;2;2;4;1;0;1
96;08.02.2015;2015;02;05;Sunnuntai;1;1;2;1;1;2
96;08.02.2015;2015;02;06;Sunnuntai;7;1;8;3;0;3
96;08.02.2015;2015;02;07;Sunnuntai;2;8;10;5;5;10
96;08.02.2015;2015;02;08;Sunnuntai;4;4;8;4;2;6
96;08.02.2015;2015;02;09;Sunnuntai;3;1;4;3;2;5
96;08.02.2015;2015;02;10;Sunnuntai;7;14;21;8;9;17
96;08.02.2015;2015;02;11;Sunnuntai;4;11;15;12;9;21
96;08.02.2015;2015;02;12;Sunnuntai;17;13;30;13;13;26
96;08.02.2015;2015;02;13;Sunnuntai;15;23;38;10;20;30
96;08.02.2015;2015;02;14;Sunnuntai;11;25;36;13;8;21
96;08.02.2015;2015;02;15;Sunnuntai;11;13;24;7;14;21
96;08.02.2015;2015;02;16;Sunnuntai;24;21;45;8;12;20
96;08.02.2015;2015;02;17;Sunnuntai;15;18;33;1;9;10
96;08.02.2015;2015;02;18;Sunnuntai;12;17;29;1;6;7
96;08.02.2015;2015;02;19;Sunnuntai;12;9;21;0;7;7
96;08.02.2015;2015;02;20;Sunnuntai;16;18;34;1;3;4
96;08.02.2015;2015;02;21;Sunnuntai;11;13;24;0;4;4
96;08.02.2015;2015;02;22;Sunnuntai;4;3;7;0;0;0
96;08.02.2015;2015;02;23;Sunnuntai;5;3;8;0;0;0
96;09.02.2015;2015;02;00;Maanantai;2;0;2;0;0;0
96;09.02.2015;2015;02;01;Maanantai;3;0;3;0;0;0
96;09.02.2015;2015;02;02;Maanantai;0;0;0;0;0;0
96;09.02.2015;2015;02;03;Maanantai;2;0;2;0;0;0
96;09.02.2015;2015;02;04;Maanantai;3;0;3;0;0;0
96;09.02.2015;2015;02;05;Maanantai;6;2;8;0;1;1
96;09.02.2015;2015;02;06;Maanantai;19;18;37;1;0;1
96;09.02.2015;2015;02;07;Maanantai;83;83;166;0;0;0
96;09.02.2015;2015;02;08;Maanantai;78;75;153;0;2;2
96;09.02.2015;2015;02;09;Maanantai;62;49;111;1;2;3
96;09.02.2015;2015;02;10;Maanantai;46;35;81;1;4;5
96;09.02.2015;2015;02;11;Maanantai;41;42;83;7;8;15
96;09.02.2015;2015;02;12;Maanantai;47;39;86;5;5;10
96;09.02.2015;2015;02;13;Maanantai;48;52;100;5;9;14
96;09.02.2015;2015;02;14;Maanantai;52;72;124;12;26;38
96;09.02.2015;2015;02;15;Maanantai;68;136;204;13;44;57
96;09.02.2015;2015;02;16;Maanantai;80;111;191;20;31;51
96;09.02.2015;2015;02;17;Maanantai;59;53;112;11;11;22
96;09.02.2015;2015;02;18;Maanantai;44;31;75;16;22;38
96;09.02.2015;2015;02;19;Maanantai;37;27;64;8;23;31
96;09.02.2015;2015;02;20;Maanantai;48;24;72;10;11;21
96;09.02.2015;2015;02;21;Maanantai;24;22;46;1;9;10
96;09.02.2015;2015;02;22;Maanantai;3;2;5;3;1;4
96;09.02.2015;2015;02;23;Maanantai;2;0;2;2;1;3
96;10.02.2015;2015;02;00;Tiistai;1;1;2;1;2;3
96;10.02.2015;2015;02;01;Tiistai;0;0;0;0;0;0
96;10.02.2015;2015;02;02;Tiistai;0;1;1;0;0;0
96;10.02.2015;2015;02;03;Tiistai;2;0;2;0;2;2
96;10.02.2015;2015;02;04;Tiistai;2;4;6;0;0;0
96;10.02.2015;2015;02;05;Tiistai;3;6;9;1;2;3
96;10.02.2015;2015;02;06;Tiistai;36;28;64;14;4;18
96;10.02.2015;2015;02;07;Tiistai;136;74;210;46;6;52
96;10.02.2015;2015;02;08;Tiistai;98;70;168;22;16;38
96;10.02.2015;2015;02;09;Tiistai;81;41;122;25;20;45
96;10.02.2015;2015;02;10;Tiistai;33;36;69;13;25;38
96;10.02.2015;2015;02;11;Tiistai;41;55;96;17;13;30
96;10.02.2015;2015;02;12;Tiistai;43;48;91;15;25;40
96;10.02.2015;2015;02;13;Tiistai;44;52;96;11;31;42
96;10.02.2015;2015;02;14;Tiistai;55;73;128;10;31;41
96;10.02.2015;2015;02;15;Tiistai;51;160;211;11;52;63
96;10.02.2015;2015;02;16;Tiistai;72;119;191;18;36;54
96;10.02.2015;2015;02;17;Tiistai;41;48;89;16;26;42
96;10.02.2015;2015;02;18;Tiistai;43;35;78;24;33;57
96;10.02.2015;2015;02;19;Tiistai;34;30;64;12;33;45
96;10.02.2015;2015;02;20;Tiistai;27;10;37;10;6;16
96;10.02.2015;2015;02;21;Tiistai;35;19;54;10;7;17
96;10.02.2015;2015;02;22;Tiistai;9;3;12;1;1;2
96;10.02.2015;2015;02;23;Tiistai;2;1;3;0;1;1
96;11.02.2015;2015;02;00;Keskiviikko;2;1;3;0;1;1
96;11.02.2015;2015;02;01;Keskiviikko;3;0;3;0;0;0
96;11.02.2015;2015;02;02;Keskiviikko;0;0;0;0;0;0
96;11.02.2015;2015;02;03;Keskiviikko;1;0;1;0;0;0
96;11.02.2015;2015;02;04;Keskiviikko;2;1;3;0;1;1
96;11.02.2015;2015;02;05;Keskiviikko;7;1;8;2;1;3
96;11.02.2015;2015;02;06;Keskiviikko;28;19;47;15;6;21
96;11.02.2015;2015;02;07;Keskiviikko;92;49;141;48;9;57
96;11.02.2015;2015;02;08;Keskiviikko;63;57;120;29;12;41
96;11.02.2015;2015;02;09;Keskiviikko;44;34;78;31;14;45
96;11.02.2015;2015;02;10;Keskiviikko;31;26;57;11;15;26
96;11.02.2015;2015;02;11;Keskiviikko;46;26;72;25;15;40
96;11.02.2015;2015;02;12;Keskiviikko;41;52;93;19;40;59
96;11.02.2015;2015;02;13;Keskiviikko;26;45;71;13;26;39
96;11.02.2015;2015;02;14;Keskiviikko;27;63;90;16;33;49
96;11.02.2015;2015;02;15;Keskiviikko;44;106;150;19;58;77
96;11.02.2015;2015;02;16;Keskiviikko;48;68;116;22;44;66
96;11.02.2015;2015;02;17;Keskiviikko;31;40;71;10;21;31
96;11.02.2015;2015;02;18;Keskiviikko;35;17;52;25;7;32
96;11.02.2015;2015;02;19;Keskiviikko;25;15;40;14;11;25
96;11.02.2015;2015;02;20;Keskiviikko;23;15;38;9;10;19
96;11.02.2015;2015;02;21;Keskiviikko;7;18;25;4;8;12
96;11.02.2015;2015;02;22;Keskiviikko;5;6;11;2;0;2
96;11.02.2015;2015;02;23;Keskiviikko;3;6;9;0;2;2
96;12.02.2015;2015;02;00;Torstai;3;2;5;0;0;0
96;12.02.2015;2015;02;01;Torstai;3;0;3;0;0;0
96;12.02.2015;2015;02;02;Torstai;0;1;1;0;0;0
96;12.02.2015;2015;02;03;Torstai;4;0;4;3;1;4
96;12.02.2015;2015;02;04;Torstai;3;2;5;2;2;4
96;12.02.2015;2015;02;05;Torstai;5;1;6;1;1;2
96;12.02.2015;2015;02;06;Torstai;33;13;46;18;3;21
96;12.02.2015;2015;02;07;Torstai;70;39;109;47;15;62
96;12.02.2015;2015;02;08;Torstai;90;33;123;24;12;36
96;12.02.2015;2015;02;09;Torstai;37;28;65;21;12;33
96;12.02.2015;2015;02;10;Torstai;27;23;50;11;11;22
96;12.02.2015;2015;02;11;Torstai;33;37;70;14;18;32
96;12.02.2015;2015;02;12;Torstai;37;43;80;14;18;32
96;12.02.2015;2015;02;13;Torstai;25;35;60;16;17;33
96;12.02.2015;2015;02;14;Torstai;30;73;103;14;34;48
96;12.02.2015;2015;02;15;Torstai;50;94;144;7;41;48
96;12.02.2015;2015;02;16;Torstai;58;60;118;10;30;40
96;12.02.2015;2015;02;17;Torstai;31;30;61;17;17;34
96;12.02.2015;2015;02;18;Torstai;31;31;62;14;15;29
96;12.02.2015;2015;02;19;Torstai;22;12;34;17;16;33
96;12.02.2015;2015;02;20;Torstai;20;19;39;10;6;16
96;12.02.2015;2015;02;21;Torstai;24;10;34;3;6;9
96;12.02.2015;2015;02;22;Torstai;5;3;8;3;8;11
96;12.02.2015;2015;02;23;Torstai;1;1;2;0;1;1
96;13.02.2015;2015;02;00;Perjantai;1;0;1;2;3;5
96;13.02.2015;2015;02;01;Perjantai;1;0;1;0;0;0
96;13.02.2015;2015;02;02;Perjantai;0;0;0;4;0;4
96;13.02.2015;2015;02;03;Perjantai;3;0;3;2;0;2
96;13.02.2015;2015;02;04;Perjantai;1;1;2;0;1;1
96;13.02.2015;2015;02;05;Perjantai;3;4;7;1;3;4
96;13.02.2015;2015;02;06;Perjantai;29;13;42;18;4;22
96;13.02.2015;2015;02;07;Perjantai;88;31;119;42;14;56
96;13.02.2015;2015;02;08;Perjantai;51;33;84;15;15;30
96;13.02.2015;2015;02;09;Perjantai;28;20;48;18;10;28
96;13.02.2015;2015;02;10;Perjantai;25;18;43;14;16;30
96;13.02.2015;2015;02;11;Perjantai;33;31;64;18;23;41
96;13.02.2015;2015;02;12;Perjantai;36;55;91;13;45;58
96;13.02.2015;2015;02;13;Perjantai;49;51;100;25;47;72
96;13.02.2015;2015;02;14;Perjantai;35;83;118;14;72;86
96;13.02.2015;2015;02;15;Perjantai;39;86;125;11;50;61
96;13.02.2015;2015;02;16;Perjantai;47;48;95;51;18;69
96;13.02.2015;2015;02;17;Perjantai;31;26;57;7;32;39
96;13.02.2015;2015;02;18;Perjantai;21;33;54;15;18;33
96;13.02.2015;2015;02;19;Perjantai;22;11;33;7;8;15
96;13.02.2015;2015;02;20;Perjantai;33;9;42;6;4;10
96;13.02.2015;2015;02;21;Perjantai;17;13;30;10;6;16
96;13.02.2015;2015;02;22;Perjantai;5;2;7;2;2;4
96;13.02.2015;2015;02;23;Perjantai;6;1;7;3;1;4
96;14.02.2015;2015;02;00;Lauantai;2;1;3;1;1;2
96;14.02.2015;2015;02;01;Lauantai;4;1;5;1;0;1
96;14.02.2015;2015;02;02;Lauantai;4;0;4;0;0;0
96;14.02.2015;2015;02;03;Lauantai;7;2;9;1;0;1
96;14.02.2015;2015;02;04;Lauantai;2;1;3;0;1;1
96;14.02.2015;2015;02;05;Lauantai;1;2;3;2;1;3
96;14.02.2015;2015;02;06;Lauantai;9;7;16;1;0;1
96;14.02.2015;2015;02;07;Lauantai;6;10;16;1;8;9
96;14.02.2015;2015;02;08;Lauantai;5;6;11;9;3;12
96;14.02.2015;2015;02;09;Lauantai;2;15;17;4;5;9
96;14.02.2015;2015;02;10;Lauantai;8;18;26;7;4;11
96;14.02.2015;2015;02;11;Lauantai;11;19;30;9;9;18
96;14.02.2015;2015;02;12;Lauantai;21;21;42;13;22;35
96;14.02.2015;2015;02;13;Lauantai;18;21;39;10;9;19
96;14.02.2015;2015;02;14;Lauantai;14;24;38;13;17;30
96;14.02.2015;2015;02;15;Lauantai;20;21;41;10;14;24
96;14.02.2015;2015;02;16;Lauantai;28;18;46;13;11;24
96;14.02.2015;2015;02;17;Lauantai;17;9;26;12;8;20
96;14.02.2015;2015;02;18;Lauantai;28;8;36;13;7;20
96;14.02.2015;2015;02;19;Lauantai;14;10;24;9;3;12
96;14.02.2015;2015;02;20;Lauantai;21;6;27;4;5;9
96;14.02.2015;2015;02;21;Lauantai;6;15;21;5;14;19
96;14.02.2015;2015;02;22;Lauantai;4;7;11;1;1;2
96;14.02.2015;2015;02;23;Lauantai;13;2;15;0;1;1
96;15.02.2015;2015;02;00;Sunnuntai;5;3;8;1;1;2
96;15.02.2015;2015;02;01;Sunnuntai;7;0;7;2;1;3
96;15.02.2015;2015;02;02;Sunnuntai;1;0;1;0;0;0
96;15.02.2015;2015;02;03;Sunnuntai;8;0;8;4;0;4
96;15.02.2015;2015;02;04;Sunnuntai;3;1;4;4;0;4
96;15.02.2015;2015;02;05;Sunnuntai;1;1;2;0;0;0
96;15.02.2015;2015;02;06;Sunnuntai;9;4;13;4;2;6
96;15.02.2015;2015;02;07;Sunnuntai;3;3;6;1;3;4
96;15.02.2015;2015;02;08;Sunnuntai;4;3;7;1;3;4
96;15.02.2015;2015;02;09;Sunnuntai;4;2;6;4;5;9
96;15.02.2015;2015;02;10;Sunnuntai;6;4;10;0;3;3
96;15.02.2015;2015;02;11;Sunnuntai;7;10;17;13;9;22
96;15.02.2015;2015;02;12;Sunnuntai;19;10;29;9;15;24
96;15.02.2015;2015;02;13;Sunnuntai;14;20;34;17;16;33
96;15.02.2015;2015;02;14;Sunnuntai;10;22;32;11;14;25
96;15.02.2015;2015;02;15;Sunnuntai;27;14;41;16;13;29
96;15.02.2015;2015;02;16;Sunnuntai;30;14;44;31;16;47
96;15.02.2015;2015;02;17;Sunnuntai;18;16;34;16;3;19
96;15.02.2015;2015;02;18;Sunnuntai;25;16;41;20;13;33
96;15.02.2015;2015;02;19;Sunnuntai;10;15;25;5;16;21
96;15.02.2015;2015;02;20;Sunnuntai;16;12;28;7;11;18
96;15.02.2015;2015;02;21;Sunnuntai;14;17;31;7;6;13
96;15.02.2015;2015;02;22;Sunnuntai;4;0;4;8;4;12
96;15.02.2015;2015;02;23;Sunnuntai;1;0;1;1;1;2
96;16.02.2015;2015;02;00;Maanantai;2;2;4;0;1;1
96;16.02.2015;2015;02;01;Maanantai;0;0;0;2;0;2
96;16.02.2015;2015;02;02;Maanantai;0;0;0;0;1;1
96;16.02.2015;2015;02;03;Maanantai;1;0;1;0;0;0
96;16.02.2015;2015;02;04;Maanantai;1;3;4;0;0;0
96;16.02.2015;2015;02;05;Maanantai;4;8;12;1;0;1
96;16.02.2015;2015;02;06;Maanantai;25;14;39;17;5;22
96;16.02.2015;2015;02;07;Maanantai;104;72;176;44;13;57
96;16.02.2015;2015;02;08;Maanantai;72;61;133;23;11;34
96;16.02.2015;2015;02;09;Maanantai;52;40;92;26;13;39
96;16.02.2015;2015;02;10;Maanantai;57;38;95;16;19;35
96;16.02.2015;2015;02;11;Maanantai;39;37;76;14;11;25
96;16.02.2015;2015;02;12;Maanantai;31;45;76;19;15;34
96;16.02.2015;2015;02;13;Maanantai;46;47;93;7;13;20
96;16.02.2015;2015;02;14;Maanantai;53;87;140;6;30;36
96;16.02.2015;2015;02;15;Maanantai;53;142;195;11;56;67
96;16.02.2015;2015;02;16;Maanantai;71;87;158;13;53;66
96;16.02.2015;2015;02;17;Maanantai;40;51;91;11;14;25
96;16.02.2015;2015;02;18;Maanantai;56;26;82;18;20;38
96;16.02.2015;2015;02;19;Maanantai;35;36;71;12;17;29
96;16.02.2015;2015;02;20;Maanantai;32;14;46;12;6;18
96;16.02.2015;2015;02;21;Maanantai;13;14;27;9;7;16
96;16.02.2015;2015;02;22;Maanantai;5;6;11;2;3;5
96;16.02.2015;2015;02;23;Maanantai;2;2;4;1;0;1
96;17.02.2015;2015;02;00;Tiistai;1;0;1;2;0;2
96;17.02.2015;2015;02;01;Tiistai;0;1;1;0;2;2
96;17.02.2015;2015;02;02;Tiistai;0;0;0;0;0;0
96;17.02.2015;2015;02;03;Tiistai;4;0;4;0;0;0
96;17.02.2015;2015;02;04;Tiistai;2;1;3;0;0;0
96;17.02.2015;2015;02;05;Tiistai;3;6;9;1;1;2
96;17.02.2015;2015;02;06;Tiistai;29;28;57;17;6;23
96;17.02.2015;2015;02;07;Tiistai;105;82;187;49;8;57
96;17.02.2015;2015;02;08;Tiistai;97;79;176;18;14;32
96;17.02.2015;2015;02;09;Tiistai;64;47;111;35;7;42
96;17.02.2015;2015;02;10;Tiistai;33;34;67;11;12;23
96;17.02.2015;2015;02;11;Tiistai;29;44;73;21;8;29
96;17.02.2015;2015;02;12;Tiistai;36;55;91;15;15;30
96;17.02.2015;2015;02;13;Tiistai;34;63;97;15;19;34
96;17.02.2015;2015;02;14;Tiistai;41;88;129;11;28;39
96;17.02.2015;2015;02;15;Tiistai;55;120;175;11;59;70
96;17.02.2015;2015;02;16;Tiistai;60;107;167;15;29;44
96;17.02.2015;2015;02;17;Tiistai;47;47;94;8;21;29
96;17.02.2015;2015;02;18;Tiistai;39;25;64;16;12;28
96;17.02.2015;2015;02;19;Tiistai;36;26;62;16;14;30
96;17.02.2015;2015;02;20;Tiistai;35;13;48;12;5;17
96;17.02.2015;2015;02;21;Tiistai;14;16;30;3;7;10
96;17.02.2015;2015;02;22;Tiistai;7;10;17;2;1;3
96;17.02.2015;2015;02;23;Tiistai;4;1;5;0;1;1
96;18.02.2015;2015;02;00;Keskiviikko;2;1;3;3;2;5
96;18.02.2015;2015;02;01;Keskiviikko;4;2;6;2;1;3
96;18.02.2015;2015;02;02;Keskiviikko;4;0;4;1;0;1
96;18.02.2015;2015;02;03;Keskiviikko;1;0;1;1;1;2
96;18.02.2015;2015;02;04;Keskiviikko;0;1;1;0;2;2
96;18.02.2015;2015;02;05;Keskiviikko;7;10;17;1;0;1
96;18.02.2015;2015;02;06;Keskiviikko;51;21;72;20;6;26
96;18.02.2015;2015;02;07;Keskiviikko;168;79;247;42;9;51
96;18.02.2015;2015;02;08;Keskiviikko;120;72;192;26;20;46
96;18.02.2015;2015;02;09;Keskiviikko;53;45;98;34;20;54
96;18.02.2015;2015;02;10;Keskiviikko;48;39;87;8;11;19
96;18.02.2015;2015;02;11;Keskiviikko;57;52;109;15;7;22
96;18.02.2015;2015;02;12;Keskiviikko;59;46;105;11;12;23
96;18.02.2015;2015;02;13;Keskiviikko;51;81;132;9;38;47
96;18.02.2015;2015;02;14;Keskiviikko;44;94;138;26;31;57
96;18.02.2015;2015;02;15;Keskiviikko;61;147;208;15;44;59
96;18.02.2015;2015;02;16;Keskiviikko;69;109;178;15;49;64
96;18.02.2015;2015;02;17;Keskiviikko;57;31;88;15;16;31
96;18.02.2015;2015;02;18;Keskiviikko;57;33;90;11;20;31
96;18.02.2015;2015;02;19;Keskiviikko;36;27;63;13;12;25
96;18.02.2015;2015;02;20;Keskiviikko;34;23;57;9;19;28
96;18.02.2015;2015;02;21;Keskiviikko;13;30;43;6;8;14
96;18.02.2015;2015;02;22;Keskiviikko;7;6;13;1;1;2
96;18.02.2015;2015;02;23;Keskiviikko;3;3;6;0;1;1
96;19.02.2015;2015;02;00;Torstai;0;1;1;1;1;2
96;19.02.2015;2015;02;01;Torstai;0;1;1;1;1;2
96;19.02.2015;2015;02;02;Torstai;0;1;1;0;0;0
96;19.02.2015;2015;02;03;Torstai;1;0;1;0;1;1
96;19.02.2015;2015;02;04;Torstai;1;2;3;0;1;1
96;19.02.2015;2015;02;05;Torstai;5;5;10;3;0;3
96;19.02.2015;2015;02;06;Torstai;34;28;62;16;6;22
96;19.02.2015;2015;02;07;Torstai;120;68;188;45;9;54
96;19.02.2015;2015;02;08;Torstai;82;72;154;26;9;35
96;19.02.2015;2015;02;09;Torstai;48;44;92;11;8;19
96;19.02.2015;2015;02;10;Torstai;36;38;74;11;22;33
96;19.02.2015;2015;02;11;Torstai;48;51;99;22;22;44
96;19.02.2015;2015;02;12;Torstai;62;44;106;12;20;32
96;19.02.2015;2015;02;13;Torstai;35;46;81;12;20;32
96;19.02.2015;2015;02;14;Torstai;37;107;144;10;48;58
96;19.02.2015;2015;02;15;Torstai;52;140;192;10;42;52
96;19.02.2015;2015;02;16;Torstai;70;101;171;10;28;38
96;19.02.2015;2015;02;17;Torstai;58;34;92;6;18;24
96;19.02.2015;2015;02;18;Torstai;33;26;59;12;15;27
96;19.02.2015;2015;02;19;Torstai;34;25;59;14;19;33
96;19.02.2015;2015;02;20;Torstai;31;16;47;6;6;12
96;19.02.2015;2015;02;21;Torstai;11;14;25;8;10;18
96;19.02.2015;2015;02;22;Torstai;7;11;18;0;1;1
96;19.02.2015;2015;02;23;Torstai;1;1;2;0;2;2
96;20.02.2015;2015;02;00;Perjantai;1;1;2;2;0;2
96;20.02.2015;2015;02;01;Perjantai;0;0;0;0;1;1
96;20.02.2015;2015;02;02;Perjantai;1;0;1;1;0;1
96;20.02.2015;2015;02;03;Perjantai;3;0;3;0;0;0
96;20.02.2015;2015;02;04;Perjantai;1;1;2;0;1;1
96;20.02.2015;2015;02;05;Perjantai;3;4;7;1;0;1
96;20.02.2015;2015;02;06;Perjantai;38;9;47;13;5;18
96;20.02.2015;2015;02;07;Perjantai;90;40;130;45;9;54
96;20.02.2015;2015;02;08;Perjantai;85;45;130;19;7;26
96;20.02.2015;2015;02;09;Perjantai;36;37;73;18;14;32
96;20.02.2015;2015;02;10;Perjantai;41;45;86;11;21;32
96;20.02.2015;2015;02;11;Perjantai;42;43;85;24;24;48
96;20.02.2015;2015;02;12;Perjantai;48;57;105;21;14;35
96;20.02.2015;2015;02;13;Perjantai;45;66;111;9;24;33
96;20.02.2015;2015;02;14;Perjantai;39;79;118;15;51;66
96;20.02.2015;2015;02;15;Perjantai;56;80;136;11;39;50
96;20.02.2015;2015;02;16;Perjantai;47;51;98;15;19;34
96;20.02.2015;2015;02;17;Perjantai;40;23;63;13;14;27
96;20.02.2015;2015;02;18;Perjantai;22;14;36;12;8;20
96;20.02.2015;2015;02;19;Perjantai;20;10;30;7;11;18
96;20.02.2015;2015;02;20;Perjantai;21;17;38;9;4;13
96;20.02.2015;2015;02;21;Perjantai;16;13;29;4;6;10
96;20.02.2015;2015;02;22;Perjantai;3;5;8;8;2;10
96;20.02.2015;2015;02;23;Perjantai;5;4;9;3;1;4
96;21.02.2015;2015;02;00;Lauantai;5;2;7;2;0;2
96;21.02.2015;2015;02;01;Lauantai;5;0;5;1;1;2
96;21.02.2015;2015;02;02;Lauantai;0;1;1;0;0;0
96;21.02.2015;2015;02;03;Lauantai;3;0;3;3;0;3
96;21.02.2015;2015;02;04;Lauantai;2;0;2;2;3;5
96;21.02.2015;2015;02;05;Lauantai;4;1;5;2;2;4
96;21.02.2015;2015;02;06;Lauantai;14;5;19;7;0;7
96;21.02.2015;2015;02;07;Lauantai;4;6;10;3;6;9
96;21.02.2015;2015;02;08;Lauantai;3;13;16;1;4;5
96;21.02.2015;2015;02;09;Lauantai;4;21;25;9;12;21
96;21.02.2015;2015;02;10;Lauantai;7;18;25;13;20;33
96;21.02.2015;2015;02;11;Lauantai;14;21;35;10;15;25
96;21.02.2015;2015;02;12;Lauantai;33;30;63;7;3;10
96;21.02.2015;2015;02;13;Lauantai;28;21;49;14;10;24
96;21.02.2015;2015;02;14;Lauantai;15;17;32;2;18;20
96;21.02.2015;2015;02;15;Lauantai;20;21;41;12;26;38
96;21.02.2015;2015;02;16;Lauantai;18;22;40;12;26;38
96;21.02.2015;2015;02;17;Lauantai;32;11;43;29;14;43
96;21.02.2015;2015;02;18;Lauantai;10;16;26;17;13;30
96;21.02.2015;2015;02;19;Lauantai;37;7;44;17;19;36
96;21.02.2015;2015;02;20;Lauantai;18;9;27;8;6;14
96;21.02.2015;2015;02;21;Lauantai;5;17;22;6;9;15
96;21.02.2015;2015;02;22;Lauantai;5;12;17;2;13;15
96;21.02.2015;2015;02;23;Lauantai;4;1;5;1;0;1
96;22.02.2015;2015;02;00;Sunnuntai;5;3;8;2;1;3
96;22.02.2015;2015;02;01;Sunnuntai;5;3;8;1;0;1
96;22.02.2015;2015;02;02;Sunnuntai;6;1;7;6;1;7
96;22.02.2015;2015;02;03;Sunnuntai;4;0;4;2;0;2
96;22.02.2015;2015;02;04;Sunnuntai;3;1;4;1;0;1
96;22.02.2015;2015;02;05;Sunnuntai;1;2;3;2;0;2
96;22.02.2015;2015;02;06;Sunnuntai;16;1;17;6;1;7
96;22.02.2015;2015;02;07;Sunnuntai;5;8;13;1;2;3
96;22.02.2015;2015;02;08;Sunnuntai;3;8;11;5;5;10
96;22.02.2015;2015;02;09;Sunnuntai;5;4;9;9;8;17
96;22.02.2015;2015;02;10;Sunnuntai;3;14;17;23;16;39
96;22.02.2015;2015;02;11;Sunnuntai;11;15;26;13;17;30
96;22.02.2015;2015;02;12;Sunnuntai;24;13;37;15;12;27
96;22.02.2015;2015;02;13;Sunnuntai;18;20;38;18;18;36
96;22.02.2015;2015;02;14;Sunnuntai;15;17;32;15;10;25
96;22.02.2015;2015;02;15;Sunnuntai;14;31;45;8;17;25
96;22.02.2015;2015;02;16;Sunnuntai;21;23;44;10;12;22
96;22.02.2015;2015;02;17;Sunnuntai;12;18;30;11;14;25
96;22.02.2015;2015;02;18;Sunnuntai;19;5;24;14;14;28
96;22.02.2015;2015;02;19;Sunnuntai;19;15;34;25;18;43
96;22.02.2015;2015;02;20;Sunnuntai;11;22;33;9;11;20
96;22.02.2015;2015;02;21;Sunnuntai;8;11;19;7;10;17
96;22.02.2015;2015;02;22;Sunnuntai;11;4;15;1;4;5
96;22.02.2015;2015;02;23;Sunnuntai;5;0;5;1;1;2
96;23.02.2015;2015;02;00;Maanantai;1;0;1;1;2;3
96;23.02.2015;2015;02;01;Maanantai;0;1;1;0;0;0
96;23.02.2015;2015;02;02;Maanantai;1;3;4;0;0;0
96;23.02.2015;2015;02;03;Maanantai;1;0;1;0;0;0
96;23.02.2015;2015;02;04;Maanantai;2;1;3;0;1;1
96;23.02.2015;2015;02;05;Maanantai;10;3;13;1;4;5
96;23.02.2015;2015;02;06;Maanantai;40;21;61;19;7;26
96;23.02.2015;2015;02;07;Maanantai;110;76;186;44;10;54
96;23.02.2015;2015;02;08;Maanantai;90;62;152;24;10;34
96;23.02.2015;2015;02;09;Maanantai;62;61;123;26;11;37
96;23.02.2015;2015;02;10;Maanantai;32;33;65;15;13;28
96;23.02.2015;2015;02;11;Maanantai;47;47;94;17;13;30
96;23.02.2015;2015;02;12;Maanantai;39;55;94;24;11;35
96;23.02.2015;2015;02;13;Maanantai;41;61;102;9;18;27
96;23.02.2015;2015;02;14;Maanantai;47;93;140;17;25;42
96;23.02.2015;2015;02;15;Maanantai;58;128;186;12;49;61
96;23.02.2015;2015;02;16;Maanantai;86;92;178;12;47;59
96;23.02.2015;2015;02;17;Maanantai;47;55;102;13;17;30
96;23.02.2015;2015;02;18;Maanantai;47;38;85;22;17;39
96;23.02.2015;2015;02;19;Maanantai;35;17;52;15;13;28
96;23.02.2015;2015;02;20;Maanantai;35;30;65;7;18;25
96;23.02.2015;2015;02;21;Maanantai;17;16;33;2;10;12
96;23.02.2015;2015;02;22;Maanantai;10;2;12;3;1;4
96;23.02.2015;2015;02;23;Maanantai;1;2;3;3;5;8
96;24.02.2015;2015;02;00;Tiistai;1;0;1;1;0;1
96;24.02.2015;2015;02;01;Tiistai;0;0;0;0;1;1
96;24.02.2015;2015;02;02;Tiistai;2;0;2;0;0;0
96;24.02.2015;2015;02;03;Tiistai;2;0;2;0;0;0
96;24.02.2015;2015;02;04;Tiistai;3;1;4;0;1;1
96;24.02.2015;2015;02;05;Tiistai;8;4;12;1;3;4
96;24.02.2015;2015;02;06;Tiistai;37;27;64;11;8;19
96;24.02.2015;2015;02;07;Tiistai;125;57;182;50;12;62
96;24.02.2015;2015;02;08;Tiistai;98;67;165;25;8;33
96;24.02.2015;2015;02;09;Tiistai;53;54;107;10;14;24
96;24.02.2015;2015;02;10;Tiistai;34;27;61;17;17;34
96;24.02.2015;2015;02;11;Tiistai;43;44;87;10;11;21
96;24.02.2015;2015;02;12;Tiistai;50;38;88;13;19;32
96;24.02.2015;2015;02;13;Tiistai;41;56;97;10;11;21
96;24.02.2015;2015;02;14;Tiistai;35;79;114;13;36;49
96;24.02.2015;2015;02;15;Tiistai;39;150;189;7;56;63
96;24.02.2015;2015;02;16;Tiistai;47;106;153;8;54;62
96;24.02.2015;2015;02;17;Tiistai;40;54;94;11;16;27
96;24.02.2015;2015;02;18;Tiistai;28;35;63;10;19;29
96;24.02.2015;2015;02;19;Tiistai;23;24;47;18;9;27
96;24.02.2015;2015;02;20;Tiistai;57;11;68;16;20;36
96;24.02.2015;2015;02;21;Tiistai;24;25;49;5;6;11
96;24.02.2015;2015;02;22;Tiistai;3;4;7;6;4;10
96;24.02.2015;2015;02;23;Tiistai;6;3;9;1;3;4
96;25.02.2015;2015;02;00;Keskiviikko;1;1;2;0;0;0
96;25.02.2015;2015;02;01;Keskiviikko;2;0;2;0;0;0
96;25.02.2015;2015;02;02;Keskiviikko;1;0;1;1;1;2
96;25.02.2015;2015;02;03;Keskiviikko;2;1;3;0;0;0
96;25.02.2015;2015;02;04;Keskiviikko;1;1;2;1;0;1
96;25.02.2015;2015;02;05;Keskiviikko;3;5;8;2;1;3
96;25.02.2015;2015;02;06;Keskiviikko;38;29;67;23;8;31
96;25.02.2015;2015;02;07;Keskiviikko;88;82;170;37;19;56
96;25.02.2015;2015;02;08;Keskiviikko;83;71;154;25;17;42
96;25.02.2015;2015;02;09;Keskiviikko;65;52;117;14;10;24
96;25.02.2015;2015;02;10;Keskiviikko;34;42;76;11;17;28
96;25.02.2015;2015;02;11;Keskiviikko;44;39;83;30;17;47
96;25.02.2015;2015;02;12;Keskiviikko;39;51;90;17;25;42
96;25.02.2015;2015;02;13;Keskiviikko;39;66;105;17;17;34
96;25.02.2015;2015;02;14;Keskiviikko;38;104;142;11;26;37
96;25.02.2015;2015;02;15;Keskiviikko;57;139;196;17;46;63
96;25.02.2015;2015;02;16;Keskiviikko;85;119;204;16;33;49
96;25.02.2015;2015;02;17;Keskiviikko;50;52;102;14;28;42
96;25.02.2015;2015;02;18;Keskiviikko;54;39;93;10;18;28
96;25.02.2015;2015;02;19;Keskiviikko;38;28;66;17;13;30
96;25.02.2015;2015;02;20;Keskiviikko;40;24;64;14;11;25
96;25.02.2015;2015;02;21;Keskiviikko;14;22;36;2;13;15
96;25.02.2015;2015;02;22;Keskiviikko;4;3;7;2;4;6
96;25.02.2015;2015;02;23;Keskiviikko;4;4;8;0;0;0
96;26.02.2015;2015;02;00;Torstai;1;0;1;0;3;3
96;26.02.2015;2015;02;01;Torstai;2;0;2;2;1;3
96;26.02.2015;2015;02;02;Torstai;1;0;1;1;0;1
96;26.02.2015;2015;02;03;Torstai;0;0;0;2;0;2
96;26.02.2015;2015;02;04;Torstai;1;2;3;0;1;1
96;26.02.2015;2015;02;05;Torstai;5;4;9;0;2;2
96;26.02.2015;2015;02;06;Torstai;34;18;52;12;2;14
96;26.02.2015;2015;02;07;Torstai;124;59;183;40;15;55
96;26.02.2015;2015;02;08;Torstai;84;62;146;24;12;36
96;26.02.2015;2015;02;09;Torstai;62;34;96;22;13;35
96;26.02.2015;2015;02;10;Torstai;39;27;66;13;15;28
96;26.02.2015;2015;02;11;Torstai;45;49;94;20;19;39
96;26.02.2015;2015;02;12;Torstai;52;54;106;18;18;36
96;26.02.2015;2015;02;13;Torstai;45;52;97;15;19;34
96;26.02.2015;2015;02;14;Torstai;45;92;137;8;29;37
96;26.02.2015;2015;02;15;Torstai;50;151;201;15;39;54
96;26.02.2015;2015;02;16;Torstai;63;108;171;11;31;42
96;26.02.2015;2015;02;17;Torstai;50;51;101;13;15;28
96;26.02.2015;2015;02;18;Torstai;45;39;84;13;23;36
96;26.02.2015;2015;02;19;Torstai;41;24;65;14;13;27
96;26.02.2015;2015;02;20;Torstai;38;21;59;6;9;15
96;26.02.2015;2015;02;21;Torstai;19;18;37;5;12;17
96;26.02.2015;2015;02;22;Torstai;9;1;10;4;6;10
96;26.02.2015;2015;02;23;Torstai;2;2;4;2;5;7
96;27.02.2015;2015;02;00;Perjantai;1;0;1;0;0;0
96;27.02.2015;2015;02;01;Perjantai;2;1;3;1;0;1
96;27.02.2015;2015;02;02;Perjantai;6;0;6;2;1;3
96;27.02.2015;2015;02;03;Perjantai;1;0;1;0;0;0
96;27.02.2015;2015;02;04;Perjantai;1;2;3;0;0;0
96;27.02.2015;2015;02;05;Perjantai;7;1;8;1;2;3
96;27.02.2015;2015;02;06;Perjantai;33;20;53;17;8;25
96;27.02.2015;2015;02;07;Perjantai;87;56;143;35;10;45
96;27.02.2015;2015;02;08;Perjantai;75;40;115;17;7;24
96;27.02.2015;2015;02;09;Perjantai;57;52;109;10;10;20
96;27.02.2015;2015;02;10;Perjantai;26;42;68;7;26;33
96;27.02.2015;2015;02;11;Perjantai;46;61;107;13;15;28
96;27.02.2015;2015;02;12;Perjantai;51;60;111;24;22;46
96;27.02.2015;2015;02;13;Perjantai;46;79;125;18;25;43
96;27.02.2015;2015;02;14;Perjantai;58;98;156;12;38;50
96;27.02.2015;2015;02;15;Perjantai;40;91;131;8;46;54
96;27.02.2015;2015;02;16;Perjantai;34;42;76;10;23;33
96;27.02.2015;2015;02;17;Perjantai;42;33;75;8;22;30
96;27.02.2015;2015;02;18;Perjantai;43;17;60;11;16;27
96;27.02.2015;2015;02;19;Perjantai;24;17;41;7;8;15
96;27.02.2015;2015;02;20;Perjantai;27;7;34;7;7;14
96;27.02.2015;2015;02;21;Perjantai;10;18;28;3;9;12
96;27.02.2015;2015;02;22;Perjantai;8;4;12;3;1;4
96;27.02.2015;2015;02;23;Perjantai;8;4;12;1;1;2
96;28.02.2015;2015;02;00;Lauantai;2;2;4;0;2;2
96;28.02.2015;2015;02;01;Lauantai;4;4;8;0;0;0
96;28.02.2015;2015;02;02;Lauantai;7;1;8;3;0;3
96;28.02.2015;2015;02;03;Lauantai;1;2;3;1;0;1
96;28.02.2015;2015;02;04;Lauantai;2;1;3;0;1;1
96;28.02.2015;2015;02;05;Lauantai;0;2;2;2;1;3
96;28.02.2015;2015;02;06;Lauantai;13;11;24;4;2;6
96;28.02.2015;2015;02;07;Lauantai;6;12;18;2;4;6
96;28.02.2015;2015;02;08;Lauantai;1;8;9;3;6;9
96;28.02.2015;2015;02;09;Lauantai;6;19;25;9;5;14
96;28.02.2015;2015;02;10;Lauantai;13;15;28;10;8;18
96;28.02.2015;2015;02;11;Lauantai;21;23;44;9;12;21
96;28.02.2015;2015;02;12;Lauantai;29;26;55;5;9;14
96;28.02.2015;2015;02;13;Lauantai;23;17;40;12;7;19
96;28.02.2015;2015;02;14;Lauantai;20;27;47;4;8;12
96;28.02.2015;2015;02;15;Lauantai;24;25;49;9;13;22
96;28.02.2015;2015;02;16;Lauantai;30;27;57;8;9;17
96;28.02.2015;2015;02;17;Lauantai;12;14;26;6;7;13
96;28.02.2015;2015;02;18;Lauantai;14;15;29;11;9;20
96;28.02.2015;2015;02;19;Lauantai;35;10;45;14;9;23
96;28.02.2015;2015;02;20;Lauantai;14;13;27;4;3;7
96;28.02.2015;2015;02;21;Lauantai;8;11;19;3;10;13
96;28.02.2015;2015;02;22;Lauantai;4;7;11;1;3;4
96;28.02.2015;2015;02;23;Lauantai;13;6;19;0;1;1
96;01.03.2015;2015;03;00;Sunnuntai;5;5;10;0;0;0
96;01.03.2015;2015;03;01;Sunnuntai;2;3;5;3;0;3
96;01.03.2015;2015;03;02;Sunnuntai;3;0;3;2;0;2
96;01.03.2015;2015;03;03;Sunnuntai;2;0;2;2;0;2
96;01.03.2015;2015;03;04;Sunnuntai;6;1;7;2;0;2
96;01.03.2015;2015;03;05;Sunnuntai;2;1;3;1;0;1
96;01.03.2015;2015;03;06;Sunnuntai;13;6;19;1;2;3
96;01.03.2015;2015;03;07;Sunnuntai;1;5;6;0;3;3
96;01.03.2015;2015;03;08;Sunnuntai;4;4;8;4;6;10
96;01.03.2015;2015;03;09;Sunnuntai;6;6;12;10;5;15
96;01.03.2015;2015;03;10;Sunnuntai;5;12;17;5;7;12
96;01.03.2015;2015;03;11;Sunnuntai;9;16;25;3;18;21
96;01.03.2015;2015;03;12;Sunnuntai;21;16;37;13;15;28
96;01.03.2015;2015;03;13;Sunnuntai;26;17;43;12;12;24
96;01.03.2015;2015;03;14;Sunnuntai;24;16;40;16;18;34
96;01.03.2015;2015;03;15;Sunnuntai;21;16;37;12;11;23
96;01.03.2015;2015;03;16;Sunnuntai;22;13;35;24;7;31
96;01.03.2015;2015;03;17;Sunnuntai;19;8;27;26;13;39
96;01.03.2015;2015;03;18;Sunnuntai;15;9;24;19;11;30
96;01.03.2015;2015;03;19;Sunnuntai;6;7;13;7;12;19
96;01.03.2015;2015;03;20;Sunnuntai;7;11;18;11;14;25
96;01.03.2015;2015;03;21;Sunnuntai;11;14;25;8;8;16
96;01.03.2015;2015;03;22;Sunnuntai;2;3;5;1;3;4
96;01.03.2015;2015;03;23;Sunnuntai;8;0;8;2;1;3
96;02.03.2015;2015;03;00;Maanantai;1;1;2;1;2;3
96;02.03.2015;2015;03;01;Maanantai;0;2;2;0;1;1
96;02.03.2015;2015;03;02;Maanantai;0;0;0;1;0;1
96;02.03.2015;2015;03;03;Maanantai;3;0;3;0;0;0
96;02.03.2015;2015;03;04;Maanantai;1;2;3;1;1;2
96;02.03.2015;2015;03;05;Maanantai;3;2;5;1;1;2
96;02.03.2015;2015;03;06;Maanantai;34;16;50;7;4;11
96;02.03.2015;2015;03;07;Maanantai;69;31;100;34;10;44
96;02.03.2015;2015;03;08;Maanantai;34;39;73;11;4;15
96;02.03.2015;2015;03;09;Maanantai;13;19;32;7;8;15
96;02.03.2015;2015;03;10;Maanantai;8;31;39;6;10;16
96;02.03.2015;2015;03;11;Maanantai;24;26;50;13;13;26
96;02.03.2015;2015;03;12;Maanantai;33;28;61;17;13;30
96;02.03.2015;2015;03;13;Maanantai;33;37;70;10;11;21
96;02.03.2015;2015;03;14;Maanantai;41;38;79;7;14;21
96;02.03.2015;2015;03;15;Maanantai;38;76;114;12;34;46
96;02.03.2015;2015;03;16;Maanantai;35;51;86;11;29;40
96;02.03.2015;2015;03;17;Maanantai;31;28;59;13;11;24
96;02.03.2015;2015;03;18;Maanantai;26;10;36;7;9;16
96;02.03.2015;2015;03;19;Maanantai;26;16;42;9;8;17
96;02.03.2015;2015;03;20;Maanantai;32;11;43;10;8;18
96;02.03.2015;2015;03;21;Maanantai;10;17;27;4;10;14
96;02.03.2015;2015;03;22;Maanantai;5;3;8;1;2;3
96;02.03.2015;2015;03;23;Maanantai;3;1;4;0;3;3
96;03.03.2015;2015;03;00;Tiistai;1;1;2;1;1;2
96;03.03.2015;2015;03;01;Tiistai;1;0;1;2;0;2
96;03.03.2015;2015;03;02;Tiistai;0;0;0;0;1;1
96;03.03.2015;2015;03;03;Tiistai;1;2;3;0;0;0
96;03.03.2015;2015;03;04;Tiistai;2;2;4;1;1;2
96;03.03.2015;2015;03;05;Tiistai;2;3;5;0;0;0
96;03.03.2015;2015;03;06;Tiistai;42;15;57;12;8;20
96;03.03.2015;2015;03;07;Tiistai;63;34;97;28;10;38
96;03.03.2015;2015;03;08;Tiistai;38;35;73;8;3;11
96;03.03.2015;2015;03;09;Tiistai;17;33;50;10;10;20
96;03.03.2015;2015;03;10;Tiistai;16;25;41;16;29;45
96;03.03.2015;2015;03;11;Tiistai;18;23;41;19;20;39
96;03.03.2015;2015;03;12;Tiistai;46;41;87;14;14;28
96;03.03.2015;2015;03;13;Tiistai;26;30;56;16;11;27
96;03.03.2015;2015;03;14;Tiistai;31;51;82;5;16;21
96;03.03.2015;2015;03;15;Tiistai;40;83;123;5;35;40
96;03.03.2015;2015;03;16;Tiistai;42;65;107;16;31;47
96;03.03.2015;2015;03;17;Tiistai;25;39;64;10;22;32
96;03.03.2015;2015;03;18;Tiistai;25;28;53;16;17;33
96;03.03.2015;2015;03;19;Tiistai;24;7;31;7;29;36
96;03.03.2015;2015;03;20;Tiistai;33;11;44;19;13;32
96;03.03.2015;2015;03;21;Tiistai;26;11;37;5;4;9
96;03.03.2015;2015;03;22;Tiistai;3;4;7;0;1;1
96;03.03.2015;2015;03;23;Tiistai;3;1;4;0;1;1
96;04.03.2015;2015;03;00;Keskiviikko;3;1;4;4;1;5
96;04.03.2015;2015;03;01;Keskiviikko;1;0;1;0;2;2
96;04.03.2015;2015;03;02;Keskiviikko;0;0;0;0;0;0
96;04.03.2015;2015;03;03;Keskiviikko;4;1;5;2;0;2
96;04.03.2015;2015;03;04;Keskiviikko;2;1;3;1;1;2
96;04.03.2015;2015;03;05;Keskiviikko;5;2;7;1;0;1
96;04.03.2015;2015;03;06;Keskiviikko;33;15;48;11;4;15
96;04.03.2015;2015;03;07;Keskiviikko;55;49;104;28;7;35
96;04.03.2015;2015;03;08;Keskiviikko;33;34;67;9;5;14
96;04.03.2015;2015;03;09;Keskiviikko;21;20;41;8;14;22
96;04.03.2015;2015;03;10;Keskiviikko;15;26;41;3;18;21
96;04.03.2015;2015;03;11;Keskiviikko;22;36;58;13;14;27
96;04.03.2015;2015;03;12;Keskiviikko;43;31;74;10;11;21
96;04.03.2015;2015;03;13;Keskiviikko;21;23;44;17;18;35
96;04.03.2015;2015;03;14;Keskiviikko;41;51;92;14;20;34
96;04.03.2015;2015;03;15;Keskiviikko;32;88;120;6;36;42
96;04.03.2015;2015;03;16;Keskiviikko;46;62;108;8;28;36
96;04.03.2015;2015;03;17;Keskiviikko;26;39;65;10;16;26
96;04.03.2015;2015;03;18;Keskiviikko;35;14;49;17;18;35
96;04.03.2015;2015;03;19;Keskiviikko;26;12;38;7;17;24
96;04.03.2015;2015;03;20;Keskiviikko;22;13;35;11;10;21
96;04.03.2015;2015;03;21;Keskiviikko;15;16;31;6;8;14
96;04.03.2015;2015;03;22;Keskiviikko;9;4;13;2;2;4
96;04.03.2015;2015;03;23;Keskiviikko;8;6;14;1;1;2
96;05.03.2015;2015;03;00;Torstai;1;2;3;1;0;1
96;05.03.2015;2015;03;01;Torstai;3;0;3;1;4;5
96;05.03.2015;2015;03;02;Torstai;4;0;4;0;0;0
96;05.03.2015;2015;03;03;Torstai;0;0;0;1;0;1
96;05.03.2015;2015;03;04;Torstai;3;1;4;3;1;4
96;05.03.2015;2015;03;05;Torstai;4;5;9;0;1;1
96;05.03.2015;2015;03;06;Torstai;34;18;52;14;7;21
96;05.03.2015;2015;03;07;Torstai;61;36;97;34;14;48
96;05.03.2015;2015;03;08;Torstai;30;36;66;17;16;33
96;05.03.2015;2015;03;09;Torstai;20;22;42;4;9;13
96;05.03.2015;2015;03;10;Torstai;21;16;37;2;7;9
96;05.03.2015;2015;03;11;Torstai;41;36;77;14;6;20
96;05.03.2015;2015;03;12;Torstai;40;26;66;15;8;23
96;05.03.2015;2015;03;13;Torstai;34;39;73;13;12;25
96;05.03.2015;2015;03;14;Torstai;29;35;64;2;16;18
96;05.03.2015;2015;03;15;Torstai;37;112;149;9;35;44
96;05.03.2015;2015;03;16;Torstai;37;52;89;10;19;29
96;05.03.2015;2015;03;17;Torstai;31;44;75;10;14;24
96;05.03.2015;2015;03;18;Torstai;24;22;46;15;12;27
96;05.03.2015;2015;03;19;Torstai;21;22;43;6;4;10
96;05.03.2015;2015;03;20;Torstai;18;18;36;11;11;22
96;05.03.2015;2015;03;21;Torstai;4;22;26;4;8;12
96;05.03.2015;2015;03;22;Torstai;4;6;10;3;3;6
96;05.03.2015;2015;03;23;Torstai;7;4;11;1;0;1
96;06.03.2015;2015;03;00;Perjantai;3;3;6;0;0;0
96;06.03.2015;2015;03;01;Perjantai;0;1;1;0;0;0
96;06.03.2015;2015;03;02;Perjantai;3;0;3;0;0;0
96;06.03.2015;2015;03;03;Perjantai;2;0;2;0;0;0
96;06.03.2015;2015;03;04;Perjantai;9;3;12;0;2;2
96;06.03.2015;2015;03;05;Perjantai;5;2;7;6;3;9
96;06.03.2015;2015;03;06;Perjantai;40;17;57;9;3;12
96;06.03.2015;2015;03;07;Perjantai;53;42;95;25;5;30
96;06.03.2015;2015;03;08;Perjantai;23;28;51;15;13;28
96;06.03.2015;2015;03;09;Perjantai;21;22;43;6;6;12
96;06.03.2015;2015;03;10;Perjantai;22;16;38;6;11;17
96;06.03.2015;2015;03;11;Perjantai;23;33;56;6;4;10
96;06.03.2015;2015;03;12;Perjantai;27;29;56;11;20;31
96;06.03.2015;2015;03;13;Perjantai;30;38;68;12;11;23
96;06.03.2015;2015;03;14;Perjantai;23;56;79;11;22;33
96;06.03.2015;2015;03;15;Perjantai;33;69;102;9;25;34
96;06.03.2015;2015;03;16;Perjantai;26;44;70;6;11;17
96;06.03.2015;2015;03;17;Perjantai;26;25;51;5;9;14
96;06.03.2015;2015;03;18;Perjantai;21;20;41;11;6;17
96;06.03.2015;2015;03;19;Perjantai;19;16;35;7;9;16
96;06.03.2015;2015;03;20;Perjantai;20;14;34;8;8;16
96;06.03.2015;2015;03;21;Perjantai;11;15;26;3;10;13
96;06.03.2015;2015;03;22;Perjantai;7;6;13;2;4;6
96;06.03.2015;2015;03;23;Perjantai;7;3;10;0;4;4
96;07.03.2015;2015;03;00;Lauantai;4;6;10;0;1;1
96;07.03.2015;2015;03;01;Lauantai;3;2;5;0;0;0
96;07.03.2015;2015;03;02;Lauantai;2;1;3;0;1;1
96;07.03.2015;2015;03;03;Lauantai;8;1;9;3;1;4
96;07.03.2015;2015;03;04;Lauantai;4;1;5;1;0;1
96;07.03.2015;2015;03;05;Lauantai;5;3;8;1;1;2
96;07.03.2015;2015;03;06;Lauantai;23;4;27;2;3;5
96;07.03.2015;2015;03;07;Lauantai;1;17;18;1;4;5
96;07.03.2015;2015;03;08;Lauantai;3;11;14;2;9;11
96;07.03.2015;2015;03;09;Lauantai;2;22;24;6;9;15
96;07.03.2015;2015;03;10;Lauantai;13;16;29;14;11;25
96;07.03.2015;2015;03;11;Lauantai;14;32;46;12;11;23
96;07.03.2015;2015;03;12;Lauantai;24;22;46;14;6;20
96;07.03.2015;2015;03;13;Lauantai;19;19;38;9;6;15
96;07.03.2015;2015;03;14;Lauantai;24;22;46;3;9;12
96;07.03.2015;2015;03;15;Lauantai;19;21;40;5;7;12
96;07.03.2015;2015;03;16;Lauantai;18;30;48;4;12;16
96;07.03.2015;2015;03;17;Lauantai;15;12;27;7;4;11
96;07.03.2015;2015;03;18;Lauantai;14;14;28;7;3;10
96;07.03.2015;2015;03;19;Lauantai;22;7;29;13;3;16
96;07.03.2015;2015;03;20;Lauantai;4;13;17;5;4;9
96;07.03.2015;2015;03;21;Lauantai;12;12;24;2;12;14
96;07.03.2015;2015;03;22;Lauantai;5;7;12;0;0;0
96;07.03.2015;2015;03;23;Lauantai;7;1;8;1;0;1
96;08.03.2015;2015;03;00;Sunnuntai;3;2;5;1;0;1
96;08.03.2015;2015;03;01;Sunnuntai;6;2;8;1;0;1
96;08.03.2015;2015;03;02;Sunnuntai;3;1;4;1;0;1
96;08.03.2015;2015;03;03;Sunnuntai;5;1;6;2;0;2
96;08.03.2015;2015;03;04;Sunnuntai;2;0;2;2;0;2
96;08.03.2015;2015;03;05;Sunnuntai;0;0;0;2;2;4
96;08.03.2015;2015;03;06;Sunnuntai;18;11;29;6;1;7
96;08.03.2015;2015;03;07;Sunnuntai;8;4;12;2;4;6
96;08.03.2015;2015;03;08;Sunnuntai;4;5;9;5;11;16
96;08.03.2015;2015;03;09;Sunnuntai;2;9;11;6;6;12
96;08.03.2015;2015;03;10;Sunnuntai;4;7;11;6;12;18
96;08.03.2015;2015;03;11;Sunnuntai;16;18;34;16;16;32
96;08.03.2015;2015;03;12;Sunnuntai;26;20;46;12;8;20
96;08.03.2015;2015;03;13;Sunnuntai;20;34;54;11;9;20
96;08.03.2015;2015;03;14;Sunnuntai;19;26;45;11;13;24
96;08.03.2015;2015;03;15;Sunnuntai;27;37;64;13;19;32
96;08.03.2015;2015;03;16;Sunnuntai;51;24;75;27;16;43
96;08.03.2015;2015;03;17;Sunnuntai;22;21;43;11;9;20
96;08.03.2015;2015;03;18;Sunnuntai;28;19;47;21;22;43
96;08.03.2015;2015;03;19;Sunnuntai;23;28;51;9;24;33
96;08.03.2015;2015;03;20;Sunnuntai;12;14;26;8;8;16
96;08.03.2015;2015;03;21;Sunnuntai;7;8;15;2;8;10
96;08.03.2015;2015;03;22;Sunnuntai;7;3;10;2;0;2
96;08.03.2015;2015;03;23;Sunnuntai;5;3;8;4;0;4
96;09.03.2015;2015;03;00;Maanantai;3;0;3;0;0;0
96;09.03.2015;2015;03;01;Maanantai;0;0;0;0;2;2
96;09.03.2015;2015;03;02;Maanantai;2;0;2;0;0;0
96;09.03.2015;2015;03;03;Maanantai;2;0;2;0;0;0
96;09.03.2015;2015;03;04;Maanantai;2;3;5;1;1;2
96;09.03.2015;2015;03;05;Maanantai;5;7;12;3;6;9
96;09.03.2015;2015;03;06;Maanantai;48;23;71;8;4;12
96;09.03.2015;2015;03;07;Maanantai;110;68;178;40;6;46
96;09.03.2015;2015;03;08;Maanantai;118;71;189;27;7;34
96;09.03.2015;2015;03;09;Maanantai;77;59;136;22;18;40
96;09.03.2015;2015;03;10;Maanantai;57;34;91;19;9;28
96;09.03.2015;2015;03;11;Maanantai;45;35;80;23;14;37
96;09.03.2015;2015;03;12;Maanantai;45;53;98;17;23;40
96;09.03.2015;2015;03;13;Maanantai;38;66;104;13;17;30
96;09.03.2015;2015;03;14;Maanantai;52;95;147;10;31;41
96;09.03.2015;2015;03;15;Maanantai;48;158;206;12;51;63
96;09.03.2015;2015;03;16;Maanantai;64;119;183;21;38;59
96;09.03.2015;2015;03;17;Maanantai;44;58;102;17;15;32
96;09.03.2015;2015;03;18;Maanantai;47;44;91;16;23;39
96;09.03.2015;2015;03;19;Maanantai;43;30;73;17;24;41
96;09.03.2015;2015;03;20;Maanantai;38;27;65;12;8;20
96;09.03.2015;2015;03;21;Maanantai;22;12;34;7;6;13
96;09.03.2015;2015;03;22;Maanantai;7;6;13;2;1;3
96;09.03.2015;2015;03;23;Maanantai;1;1;2;0;1;1
96;10.03.2015;2015;03;00;Tiistai;0;2;2;2;0;2
96;10.03.2015;2015;03;01;Tiistai;0;0;0;0;1;1
96;10.03.2015;2015;03;02;Tiistai;2;1;3;0;0;0
96;10.03.2015;2015;03;03;Tiistai;2;0;2;0;0;0
96;10.03.2015;2015;03;04;Tiistai;0;1;1;0;1;1
96;10.03.2015;2015;03;05;Tiistai;4;6;10;2;2;4
96;10.03.2015;2015;03;06;Tiistai;34;30;64;10;6;16
96;10.03.2015;2015;03;07;Tiistai;134;78;212;38;7;45
96;10.03.2015;2015;03;08;Tiistai;100;62;162;25;15;40
96;10.03.2015;2015;03;09;Tiistai;85;58;143;27;15;42
96;10.03.2015;2015;03;10;Tiistai;48;39;87;24;15;39
96;10.03.2015;2015;03;11;Tiistai;62;32;94;15;14;29
96;10.03.2015;2015;03;12;Tiistai;44;53;97;16;14;30
96;10.03.2015;2015;03;13;Tiistai;45;60;105;8;9;17
96;10.03.2015;2015;03;14;Tiistai;32;82;114;5;28;33
96;10.03.2015;2015;03;15;Tiistai;47;152;199;9;38;47
96;10.03.2015;2015;03;16;Tiistai;66;135;201;7;28;35
96;10.03.2015;2015;03;17;Tiistai;44;52;96;9;11;20
96;10.03.2015;2015;03;18;Tiistai;36;37;73;15;10;25
96;10.03.2015;2015;03;19;Tiistai;37;24;61;12;14;26
96;10.03.2015;2015;03;20;Tiistai;36;20;56;12;11;23
96;10.03.2015;2015;03;21;Tiistai;21;16;37;7;7;14
96;10.03.2015;2015;03;22;Tiistai;4;4;8;2;2;4
96;10.03.2015;2015;03;23;Tiistai;3;0;3;3;2;5
96;11.03.2015;2015;03;00;Keskiviikko;0;0;0;2;0;2
96;11.03.2015;2015;03;01;Keskiviikko;2;0;2;1;0;1
96;11.03.2015;2015;03;02;Keskiviikko;2;1;3;1;0;1
96;11.03.2015;2015;03;03;Keskiviikko;1;0;1;0;0;0
96;11.03.2015;2015;03;04;Keskiviikko;3;1;4;0;2;2
96;11.03.2015;2015;03;05;Keskiviikko;5;5;10;0;1;1
96;11.03.2015;2015;03;06;Keskiviikko;43;24;67;12;3;15
96;11.03.2015;2015;03;07;Keskiviikko;113;73;186;46;7;53
96;11.03.2015;2015;03;08;Keskiviikko;106;88;194;29;11;40
96;11.03.2015;2015;03;09;Keskiviikko;82;44;126;18;17;35
96;11.03.2015;2015;03;10;Keskiviikko;43;34;77;18;21;39
96;11.03.2015;2015;03;11;Keskiviikko;52;38;90;14;9;23
96;11.03.2015;2015;03;12;Keskiviikko;70;77;147;17;26;43
96;11.03.2015;2015;03;13;Keskiviikko;69;72;141;7;24;31
96;11.03.2015;2015;03;14;Keskiviikko;82;103;185;28;41;69
96;11.03.2015;2015;03;15;Keskiviikko;72;167;239;26;52;78
96;11.03.2015;2015;03;16;Keskiviikko;86;120;206;17;47;64
96;11.03.2015;2015;03;17;Keskiviikko;89;65;154;19;16;35
96;11.03.2015;2015;03;18;Keskiviikko;89;40;129;25;20;45
96;11.03.2015;2015;03;19;Keskiviikko;53;28;81;19;17;36
96;11.03.2015;2015;03;20;Keskiviikko;66;43;109;13;21;34
96;11.03.2015;2015;03;21;Keskiviikko;20;25;45;5;8;13
96;11.03.2015;2015;03;22;Keskiviikko;14;6;20;1;2;3
96;11.03.2015;2015;03;23;Keskiviikko;4;6;10;2;1;3
96;12.03.2015;2015;03;00;Torstai;3;1;4;1;2;3
96;12.03.2015;2015;03;01;Torstai;1;1;2;0;0;0
96;12.03.2015;2015;03;02;Torstai;3;1;4;1;0;1
96;12.03.2015;2015;03;03;Torstai;5;0;5;0;0;0
96;12.03.2015;2015;03;04;Torstai;1;2;3;0;0;0
96;12.03.2015;2015;03;05;Torstai;6;8;14;3;2;5
96;12.03.2015;2015;03;06;Torstai;35;23;58;16;6;22
96;12.03.2015;2015;03;07;Torstai;124;77;201;42;10;52
96;12.03.2015;2015;03;08;Torstai;122;71;193;19;12;31
96;12.03.2015;2015;03;09;Torstai;71;34;105;21;18;39
96;12.03.2015;2015;03;10;Torstai;39;37;76;22;33;55
96;12.03.2015;2015;03;11;Torstai;52;56;108;14;12;26
96;12.03.2015;2015;03;12;Torstai;67;54;121;13;19;32
96;12.03.2015;2015;03;13;Torstai;58;75;133;15;26;41
96;12.03.2015;2015;03;14;Torstai;60;134;194;10;28;38
96;12.03.2015;2015;03;15;Torstai;68;133;201;8;50;58
96;12.03.2015;2015;03;16;Torstai;113;120;233;21;39;60
96;12.03.2015;2015;03;17;Torstai;67;67;134;18;29;47
96;12.03.2015;2015;03;18;Torstai;55;72;127;21;18;39
96;12.03.2015;2015;03;19;Torstai;58;31;89;7;24;31
96;12.03.2015;2015;03;20;Torstai;60;32;92;13;8;21
96;12.03.2015;2015;03;21;Torstai;33;24;57;8;8;16
96;12.03.2015;2015;03;22;Torstai;20;13;33;2;0;2
96;12.03.2015;2015;03;23;Torstai;6;5;11;0;2;2
96;13.03.2015;2015;03;00;Perjantai;2;2;4;1;1;2
96;13.03.2015;2015;03;01;Perjantai;1;3;4;0;0;0
96;13.03.2015;2015;03;02;Perjantai;0;0;0;0;0;0
96;13.03.2015;2015;03;03;Perjantai;4;0;4;1;0;1
96;13.03.2015;2015;03;04;Perjantai;2;3;5;1;0;1
96;13.03.2015;2015;03;05;Perjantai;2;3;5;1;1;2
96;13.03.2015;2015;03;06;Perjantai;48;29;77;14;2;16
96;13.03.2015;2015;03;07;Perjantai;126;72;198;33;9;42
96;13.03.2015;2015;03;08;Perjantai;96;57;153;22;9;31
96;13.03.2015;2015;03;09;Perjantai;47;48;95;22;26;48
96;13.03.2015;2015;03;10;Perjantai;40;46;86;4;32;36
96;13.03.2015;2015;03;11;Perjantai;53;55;108;24;10;34
96;13.03.2015;2015;03;12;Perjantai;50;86;136;17;20;37
96;13.03.2015;2015;03;13;Perjantai;63;97;160;14;42;56
96;13.03.2015;2015;03;14;Perjantai;92;126;218;12;55;67
96;13.03.2015;2015;03;15;Perjantai;91;143;234;14;38;52
96;13.03.2015;2015;03;16;Perjantai;67;53;120;13;22;35
96;13.03.2015;2015;03;17;Perjantai;69;37;106;12;13;25
96;13.03.2015;2015;03;18;Perjantai;34;26;60;12;8;20
96;13.03.2015;2015;03;19;Perjantai;37;17;54;2;4;6
96;13.03.2015;2015;03;20;Perjantai;17;17;34;15;8;23
96;13.03.2015;2015;03;21;Perjantai;23;18;41;4;3;7
96;13.03.2015;2015;03;22;Perjantai;7;5;12;0;2;2
96;13.03.2015;2015;03;23;Perjantai;12;12;24;3;3;6
96;14.03.2015;2015;03;00;Lauantai;7;4;11;0;0;0
96;14.03.2015;2015;03;01;Lauantai;7;1;8;2;0;2
96;14.03.2015;2015;03;02;Lauantai;11;1;12;2;0;2
96;14.03.2015;2015;03;03;Lauantai;10;0;10;2;0;2
96;14.03.2015;2015;03;04;Lauantai;11;0;11;0;0;0
96;14.03.2015;2015;03;05;Lauantai;2;1;3;1;0;1
96;14.03.2015;2015;03;06;Lauantai;12;4;16;3;3;6
96;14.03.2015;2015;03;07;Lauantai;8;14;22;3;8;11
96;14.03.2015;2015;03;08;Lauantai;4;12;16;8;9;17
96;14.03.2015;2015;03;09;Lauantai;10;31;41;9;10;19
96;14.03.2015;2015;03;10;Lauantai;11;26;37;15;10;25
96;14.03.2015;2015;03;11;Lauantai;40;36;76;15;10;25
96;14.03.2015;2015;03;12;Lauantai;43;45;88;25;20;45
96;14.03.2015;2015;03;13;Lauantai;46;40;86;18;27;45
96;14.03.2015;2015;03;14;Lauantai;41;29;70;16;27;43
96;14.03.2015;2015;03;15;Lauantai;48;32;80;10;13;23
96;14.03.2015;2015;03;16;Lauantai;47;18;65;15;11;26
96;14.03.2015;2015;03;17;Lauantai;38;15;53;23;12;35
96;14.03.2015;2015;03;18;Lauantai;33;23;56;13;9;22
96;14.03.2015;2015;03;19;Lauantai;15;15;30;6;11;17
96;14.03.2015;2015;03;20;Lauantai;15;18;33;7;10;17
96;14.03.2015;2015;03;21;Lauantai;12;18;30;2;8;10
96;14.03.2015;2015;03;22;Lauantai;12;6;18;3;5;8
96;14.03.2015;2015;03;23;Lauantai;4;4;8;2;2;4
96;15.03.2015;2015;03;00;Sunnuntai;6;7;13;0;1;1
96;15.03.2015;2015;03;01;Sunnuntai;8;7;15;0;2;2
96;15.03.2015;2015;03;02;Sunnuntai;4;0;4;0;0;0
96;15.03.2015;2015;03;03;Sunnuntai;9;0;9;4;0;4
96;15.03.2015;2015;03;04;Sunnuntai;3;1;4;3;0;3
96;15.03.2015;2015;03;05;Sunnuntai;2;3;5;0;0;0
96;15.03.2015;2015;03;06;Sunnuntai;28;6;34;1;2;3
96;15.03.2015;2015;03;07;Sunnuntai;0;6;6;2;5;7
96;15.03.2015;2015;03;08;Sunnuntai;2;0;2;9;6;15
96;15.03.2015;2015;03;09;Sunnuntai;7;9;16;9;7;16
96;15.03.2015;2015;03;10;Sunnuntai;21;12;33;16;14;30
96;15.03.2015;2015;03;11;Sunnuntai;22;26;48;20;15;35
96;15.03.2015;2015;03;12;Sunnuntai;38;33;71;23;13;36
96;15.03.2015;2015;03;13;Sunnuntai;42;34;76;17;16;33
96;15.03.2015;2015;03;14;Sunnuntai;41;34;75;22;20;42
96;15.03.2015;2015;03;15;Sunnuntai;35;35;70;14;15;29
96;15.03.2015;2015;03;16;Sunnuntai;69;26;95;30;13;43
96;15.03.2015;2015;03;17;Sunnuntai;35;30;65;23;11;34
96;15.03.2015;2015;03;18;Sunnuntai;27;31;58;21;28;49
96;15.03.2015;2015;03;19;Sunnuntai;15;18;33;12;17;29
96;15.03.2015;2015;03;20;Sunnuntai;26;28;54;13;14;27
96;15.03.2015;2015;03;21;Sunnuntai;14;9;23;6;7;13
96;15.03.2015;2015;03;22;Sunnuntai;4;3;7;2;1;3
96;15.03.2015;2015;03;23;Sunnuntai;4;0;4;1;1;2
96;16.03.2015;2015;03;00;Maanantai;2;1;3;1;0;1
96;16.03.2015;2015;03;01;Maanantai;0;0;0;0;1;1
96;16.03.2015;2015;03;02;Maanantai;3;0;3;2;0;2
96;16.03.2015;2015;03;03;Maanantai;0;0;0;0;0;0
96;16.03.2015;2015;03;04;Maanantai;1;2;3;0;1;1
96;16.03.2015;2015;03;05;Maanantai;3;6;9;1;1;2
96;16.03.2015;2015;03;06;Maanantai;48;25;73;14;3;17
96;16.03.2015;2015;03;07;Maanantai;132;86;218;45;21;66
96;16.03.2015;2015;03;08;Maanantai;123;71;194;14;7;21
96;16.03.2015;2015;03;09;Maanantai;66;64;130;20;32;52
96;16.03.2015;2015;03;10;Maanantai;67;38;105;17;18;35
96;16.03.2015;2015;03;11;Maanantai;59;41;100;16;17;33
96;16.03.2015;2015;03;12;Maanantai;69;54;123;25;21;46
96;16.03.2015;2015;03;13;Maanantai;60;87;147;21;33;54
96;16.03.2015;2015;03;14;Maanantai;54;72;126;13;37;50
96;16.03.2015;2015;03;15;Maanantai;87;176;263;20;50;70
96;16.03.2015;2015;03;16;Maanantai;83;146;229;11;49;60
96;16.03.2015;2015;03;17;Maanantai;59;70;129;21;23;44
96;16.03.2015;2015;03;18;Maanantai;71;54;125;23;18;41
96;16.03.2015;2015;03;19;Maanantai;62;32;94;16;20;36
96;16.03.2015;2015;03;20;Maanantai;55;27;82;12;15;27
96;16.03.2015;2015;03;21;Maanantai;34;28;62;8;6;14
96;16.03.2015;2015;03;22;Maanantai;9;1;10;0;1;1
96;16.03.2015;2015;03;23;Maanantai;2;0;2;2;2;4
96;17.03.2015;2015;03;00;Tiistai;1;1;2;0;0;0
96;17.03.2015;2015;03;01;Tiistai;0;0;0;0;0;0
96;17.03.2015;2015;03;02;Tiistai;0;0;0;0;0;0
96;17.03.2015;2015;03;03;Tiistai;2;0;2;0;0;0
96;17.03.2015;2015;03;04;Tiistai;1;2;3;0;1;1
96;17.03.2015;2015;03;05;Tiistai;7;8;15;2;1;3
96;17.03.2015;2015;03;06;Tiistai;60;24;84;10;2;12
96;17.03.2015;2015;03;07;Tiistai;141;94;235;36;11;47
96;17.03.2015;2015;03;08;Tiistai;100;81;181;23;11;34
96;17.03.2015;2015;03;09;Tiistai;84;53;137;30;18;48
96;17.03.2015;2015;03;10;Tiistai;50;39;89;24;26;50
96;17.03.2015;2015;03;11;Tiistai;90;70;160;55;49;104
96;17.03.2015;2015;03;12;Tiistai;63;44;107;34;32;66
96;17.03.2015;2015;03;13;Tiistai;55;84;139;9;27;36
96;17.03.2015;2015;03;14;Tiistai;57;108;165;20;27;47
96;17.03.2015;2015;03;15;Tiistai;84;174;258;11;38;49
96;17.03.2015;2015;03;16;Tiistai;81;140;221;15;41;56
96;17.03.2015;2015;03;17;Tiistai;41;62;103;21;13;34
96;17.03.2015;2015;03;18;Tiistai;47;40;87;13;21;34
96;17.03.2015;2015;03;19;Tiistai;51;45;96;15;18;33
96;17.03.2015;2015;03;20;Tiistai;50;14;64;20;15;35
96;17.03.2015;2015;03;21;Tiistai;24;19;43;4;9;13
96;17.03.2015;2015;03;22;Tiistai;5;6;11;0;0;0
96;17.03.2015;2015;03;23;Tiistai;0;1;1;0;0;0
96;18.03.2015;2015;03;00;Keskiviikko;2;1;3;0;3;3
96;18.03.2015;2015;03;01;Keskiviikko;2;0;2;0;0;0
96;18.03.2015;2015;03;02;Keskiviikko;2;0;2;0;0;0
96;18.03.2015;2015;03;03;Keskiviikko;1;1;2;0;0;0
96;18.03.2015;2015;03;04;Keskiviikko;1;5;6;0;1;1
96;18.03.2015;2015;03;05;Keskiviikko;10;17;27;3;2;5
96;18.03.2015;2015;03;06;Keskiviikko;86;47;133;25;5;30
96;18.03.2015;2015;03;07;Keskiviikko;167;118;285;42;8;50
96;18.03.2015;2015;03;08;Keskiviikko;63;57;120;16;24;40
96;18.03.2015;2015;03;09;Keskiviikko;88;51;139;32;20;52
96;18.03.2015;2015;03;10;Keskiviikko;54;42;96;15;21;36
96;18.03.2015;2015;03;11;Keskiviikko;62;73;135;18;12;30
96;18.03.2015;2015;03;12;Keskiviikko;51;87;138;13;15;28
96;18.03.2015;2015;03;13;Keskiviikko;72;96;168;13;29;42
96;18.03.2015;2015;03;14;Keskiviikko;57;109;166;10;33;43
96;18.03.2015;2015;03;15;Keskiviikko;77;182;259;7;67;74
96;18.03.2015;2015;03;16;Keskiviikko;55;92;147;19;18;37
96;18.03.2015;2015;03;17;Keskiviikko;60;41;101;19;12;31
96;18.03.2015;2015;03;18;Keskiviikko;70;31;101;20;11;31
96;18.03.2015;2015;03;19;Keskiviikko;44;35;79;18;13;31
96;18.03.2015;2015;03;20;Keskiviikko;37;37;74;12;13;25
96;18.03.2015;2015;03;21;Keskiviikko;16;4;20;5;4;9
96;18.03.2015;2015;03;22;Keskiviikko;5;0;5;3;2;5
96;18.03.2015;2015;03;23;Keskiviikko;1;1;2;0;0;0
96;19.03.2015;2015;03;00;Torstai;2;1;3;0;1;1
96;19.03.2015;2015;03;01;Torstai;0;0;0;0;1;1
96;19.03.2015;2015;03;02;Torstai;3;0;3;0;0;0
96;19.03.2015;2015;03;03;Torstai;1;1;2;0;0;0
96;19.03.2015;2015;03;04;Torstai;4;9;13;0;0;0
96;19.03.2015;2015;03;05;Torstai;3;9;12;0;0;0
96;19.03.2015;2015;03;06;Torstai;45;32;77;13;3;16
96;19.03.2015;2015;03;07;Torstai;106;88;194;35;8;43
96;19.03.2015;2015;03;08;Torstai;106;76;182;21;11;32
96;19.03.2015;2015;03;09;Torstai;79;48;127;14;11;25
96;19.03.2015;2015;03;10;Torstai;62;61;123;18;17;35
96;19.03.2015;2015;03;11;Torstai;57;62;119;12;8;20
96;19.03.2015;2015;03;12;Torstai;47;50;97;23;14;37
96;19.03.2015;2015;03;13;Torstai;50;50;100;18;8;26
96;19.03.2015;2015;03;14;Torstai;51;122;173;1;17;18
96;19.03.2015;2015;03;15;Torstai;55;140;195;5;30;35
96;19.03.2015;2015;03;16;Torstai;71;126;197;12;24;36
96;19.03.2015;2015;03;17;Torstai;48;66;114;20;17;37
96;19.03.2015;2015;03;18;Torstai;34;44;78;21;20;41
96;19.03.2015;2015;03;19;Torstai;74;23;97;23;16;39
96;19.03.2015;2015;03;20;Torstai;43;30;73;12;17;29
96;19.03.2015;2015;03;21;Torstai;23;20;43;7;11;18
96;19.03.2015;2015;03;22;Torstai;11;6;17;0;1;1
96;19.03.2015;2015;03;23;Torstai;4;2;6;3;0;3
96;20.03.2015;2015;03;00;Perjantai;4;0;4;0;0;0
96;20.03.2015;2015;03;01;Perjantai;2;0;2;0;0;0
96;20.03.2015;2015;03;02;Perjantai;2;0;2;3;0;3
96;20.03.2015;2015;03;03;Perjantai;1;1;2;0;0;0
96;20.03.2015;2015;03;04;Perjantai;3;4;7;0;0;0
96;20.03.2015;2015;03;05;Perjantai;6;7;13;1;0;1
96;20.03.2015;2015;03;06;Perjantai;36;24;60;12;4;16
96;20.03.2015;2015;03;07;Perjantai;120;69;189;39;10;49
96;20.03.2015;2015;03;08;Perjantai;119;76;195;18;10;28
96;20.03.2015;2015;03;09;Perjantai;42;54;96;13;16;29
96;20.03.2015;2015;03;10;Perjantai;55;34;89;15;26;41
96;20.03.2015;2015;03;11;Perjantai;55;64;119;19;23;42
96;20.03.2015;2015;03;12;Perjantai;66;76;142;11;19;30
96;20.03.2015;2015;03;13;Perjantai;39;104;143;12;20;32
96;20.03.2015;2015;03;14;Perjantai;62;142;204;8;28;36
96;20.03.2015;2015;03;15;Perjantai;45;138;183;7;29;36
96;20.03.2015;2015;03;16;Perjantai;59;71;130;14;14;28
96;20.03.2015;2015;03;17;Perjantai;41;50;91;13;16;29
96;20.03.2015;2015;03;18;Perjantai;28;41;69;8;19;27
96;20.03.2015;2015;03;19;Perjantai;20;16;36;13;6;19
96;20.03.2015;2015;03;20;Perjantai;35;12;47;11;4;15
96;20.03.2015;2015;03;21;Perjantai;22;20;42;7;7;14
96;20.03.2015;2015;03;22;Perjantai;16;7;23;2;2;4
96;20.03.2015;2015;03;23;Perjantai;6;4;10;4;4;8
96;21.03.2015;2015;03;00;Lauantai;3;0;3;2;1;3
96;21.03.2015;2015;03;01;Lauantai;4;1;5;1;0;1
96;21.03.2015;2015;03;02;Lauantai;3;1;4;1;0;1
96;21.03.2015;2015;03;03;Lauantai;3;0;3;2;0;2
96;21.03.2015;2015;03;04;Lauantai;9;0;9;2;1;3
96;21.03.2015;2015;03;05;Lauantai;2;1;3;1;0;1
96;21.03.2015;2015;03;06;Lauantai;16;9;25;6;1;7
96;21.03.2015;2015;03;07;Lauantai;4;11;15;2;5;7
96;21.03.2015;2015;03;08;Lauantai;9;6;15;5;8;13
96;21.03.2015;2015;03;09;Lauantai;6;27;33;13;8;21
96;21.03.2015;2015;03;10;Lauantai;10;25;35;8;13;21
96;21.03.2015;2015;03;11;Lauantai;27;31;58;14;20;34
96;21.03.2015;2015;03;12;Lauantai;28;32;60;7;12;19
96;21.03.2015;2015;03;13;Lauantai;36;30;66;15;12;27
96;21.03.2015;2015;03;14;Lauantai;39;42;81;17;18;35
96;21.03.2015;2015;03;15;Lauantai;30;34;64;12;10;22
96;21.03.2015;2015;03;16;Lauantai;33;19;52;10;11;21
96;21.03.2015;2015;03;17;Lauantai;44;25;69;18;4;22
96;21.03.2015;2015;03;18;Lauantai;23;11;34;17;15;32
96;21.03.2015;2015;03;19;Lauantai;20;22;42;9;5;14
96;21.03.2015;2015;03;20;Lauantai;15;20;35;12;8;20
96;21.03.2015;2015;03;21;Lauantai;10;28;38;2;10;12
96;21.03.2015;2015;03;22;Lauantai;10;4;14;1;2;3
96;21.03.2015;2015;03;23;Lauantai;8;5;13;1;3;4
96;22.03.2015;2015;03;00;Sunnuntai;4;6;10;1;3;4
96;22.03.2015;2015;03;01;Sunnuntai;4;0;4;2;0;2
96;22.03.2015;2015;03;02;Sunnuntai;5;0;5;1;0;1
96;22.03.2015;2015;03;03;Sunnuntai;4;1;5;3;0;3
96;22.03.2015;2015;03;04;Sunnuntai;7;0;7;0;1;1
96;22.03.2015;2015;03;05;Sunnuntai;1;3;4;0;0;0
96;22.03.2015;2015;03;06;Sunnuntai;17;5;22;4;2;6
96;22.03.2015;2015;03;07;Sunnuntai;0;10;10;1;7;8
96;22.03.2015;2015;03;08;Sunnuntai;4;4;8;4;3;7
96;22.03.2015;2015;03;09;Sunnuntai;7;4;11;7;2;9
96;22.03.2015;2015;03;10;Sunnuntai;6;11;17;8;16;24
96;22.03.2015;2015;03;11;Sunnuntai;13;23;36;8;11;19
96;22.03.2015;2015;03;12;Sunnuntai;19;20;39;10;16;26
96;22.03.2015;2015;03;13;Sunnuntai;34;23;57;12;16;28
96;22.03.2015;2015;03;14;Sunnuntai;23;25;48;9;13;22
96;22.03.2015;2015;03;15;Sunnuntai;25;23;48;7;11;18
96;22.03.2015;2015;03;16;Sunnuntai;41;21;62;24;7;31
96;22.03.2015;2015;03;17;Sunnuntai;21;7;28;10;6;16
96;22.03.2015;2015;03;18;Sunnuntai;22;12;34;14;24;38
96;22.03.2015;2015;03;19;Sunnuntai;16;16;32;3;16;19
96;22.03.2015;2015;03;20;Sunnuntai;21;19;40;11;11;22
96;22.03.2015;2015;03;21;Sunnuntai;6;12;18;2;9;11
96;22.03.2015;2015;03;22;Sunnuntai;3;2;5;2;1;3
96;22.03.2015;2015;03;23;Sunnuntai;0;5;5;1;0;1
96;23.03.2015;2015;03;00;Maanantai;0;1;1;0;0;0
96;23.03.2015;2015;03;01;Maanantai;0;0;0;0;0;0
96;23.03.2015;2015;03;02;Maanantai;3;1;4;1;0;1
96;23.03.2015;2015;03;03;Maanantai;2;0;2;0;1;1
96;23.03.2015;2015;03;04;Maanantai;0;0;0;1;0;1
96;23.03.2015;2015;03;05;Maanantai;3;5;8;0;1;1
96;23.03.2015;2015;03;06;Maanantai;38;20;58;13;3;16
96;23.03.2015;2015;03;07;Maanantai;115;65;180;34;13;47
96;23.03.2015;2015;03;08;Maanantai;86;81;167;14;11;25
96;23.03.2015;2015;03;09;Maanantai;67;48;115;20;16;36
96;23.03.2015;2015;03;10;Maanantai;45;52;97;13;27;40
96;23.03.2015;2015;03;11;Maanantai;64;41;105;17;15;32
96;23.03.2015;2015;03;12;Maanantai;62;61;123;21;14;35
96;23.03.2015;2015;03;13;Maanantai;42;60;102;16;13;29
96;23.03.2015;2015;03;14;Maanantai;64;82;146;5;23;28
96;23.03.2015;2015;03;15;Maanantai;67;144;211;9;41;50
96;23.03.2015;2015;03;16;Maanantai;71;112;183;17;37;54
96;23.03.2015;2015;03;17;Maanantai;48;48;96;13;28;41
96;23.03.2015;2015;03;18;Maanantai;32;32;64;18;20;38
96;23.03.2015;2015;03;19;Maanantai;38;33;71;15;23;38
96;23.03.2015;2015;03;20;Maanantai;38;25;63;14;5;19
96;23.03.2015;2015;03;21;Maanantai;25;20;45;6;10;16
96;23.03.2015;2015;03;22;Maanantai;4;7;11;3;2;5
96;23.03.2015;2015;03;23;Maanantai;1;1;2;4;1;5
96;24.03.2015;2015;03;00;Tiistai;2;0;2;0;0;0
96;24.03.2015;2015;03;01;Tiistai;0;1;1;0;0;0
96;24.03.2015;2015;03;02;Tiistai;0;1;1;0;0;0
96;24.03.2015;2015;03;03;Tiistai;2;0;2;0;0;0
96;24.03.2015;2015;03;04;Tiistai;3;1;4;2;4;6
96;24.03.2015;2015;03;05;Tiistai;8;5;13;0;1;1
96;24.03.2015;2015;03;06;Tiistai;42;18;60;19;2;21
96;24.03.2015;2015;03;07;Tiistai;114;83;197;32;8;40
96;24.03.2015;2015;03;08;Tiistai;111;83;194;26;12;38
96;24.03.2015;2015;03;09;Tiistai;70;55;125;16;14;30
96;24.03.2015;2015;03;10;Tiistai;33;28;61;6;7;13
96;24.03.2015;2015;03;11;Tiistai;41;50;91;11;16;27
96;24.03.2015;2015;03;12;Tiistai;36;41;77;12;22;34
96;24.03.2015;2015;03;13;Tiistai;30;58;88;9;15;24
96;24.03.2015;2015;03;14;Tiistai;47;85;132;13;25;38
96;24.03.2015;2015;03;15;Tiistai;49;138;187;8;41;49
96;24.03.2015;2015;03;16;Tiistai;50;88;138;11;31;42
96;24.03.2015;2015;03;17;Tiistai;38;48;86;6;20;26
96;24.03.2015;2015;03;18;Tiistai;28;39;67;19;22;41
96;24.03.2015;2015;03;19;Tiistai;28;19;47;13;15;28
96;24.03.2015;2015;03;20;Tiistai;38;23;61;13;10;23
96;24.03.2015;2015;03;21;Tiistai;30;19;49;11;6;17
96;24.03.2015;2015;03;22;Tiistai;5;2;7;1;1;2
96;24.03.2015;2015;03;23;Tiistai;3;1;4;2;0;2
96;25.03.2015;2015;03;00;Keskiviikko;1;0;1;0;2;2
96;25.03.2015;2015;03;01;Keskiviikko;0;0;0;0;1;1
96;25.03.2015;2015;03;02;Keskiviikko;1;0;1;0;0;0
96;25.03.2015;2015;03;03;Keskiviikko;1;0;1;0;0;0
96;25.03.2015;2015;03;04;Keskiviikko;1;1;2;2;5;7
96;25.03.2015;2015;03;05;Keskiviikko;6;7;13;0;0;0
96;25.03.2015;2015;03;06;Keskiviikko;41;23;64;12;4;16
96;25.03.2015;2015;03;07;Keskiviikko;79;68;147;37;10;47
96;25.03.2015;2015;03;08;Keskiviikko;94;52;146;25;9;34
96;25.03.2015;2015;03;09;Keskiviikko;40;34;74;14;13;27
96;25.03.2015;2015;03;10;Keskiviikko;30;47;77;17;18;35
96;25.03.2015;2015;03;11;Keskiviikko;52;51;103;17;22;39
96;25.03.2015;2015;03;12;Keskiviikko;61;76;137;22;20;42
96;25.03.2015;2015;03;13;Keskiviikko;43;85;128;10;34;44
96;25.03.2015;2015;03;14;Keskiviikko;55;85;140;16;30;46
96;25.03.2015;2015;03;15;Keskiviikko;64;138;202;18;56;74
96;25.03.2015;2015;03;16;Keskiviikko;70;107;177;16;38;54
96;25.03.2015;2015;03;17;Keskiviikko;56;60;116;20;24;44
96;25.03.2015;2015;03;18;Keskiviikko;48;29;77;30;16;46
96;25.03.2015;2015;03;19;Keskiviikko;42;27;69;12;18;30
96;25.03.2015;2015;03;20;Keskiviikko;43;38;81;16;14;30
96;25.03.2015;2015;03;21;Keskiviikko;12;21;33;8;9;17
96;25.03.2015;2015;03;22;Keskiviikko;5;2;7;1;2;3
96;25.03.2015;2015;03;23;Keskiviikko;0;0;0;2;2;4
96;26.03.2015;2015;03;00;Torstai;1;2;3;0;0;0
96;26.03.2015;2015;03;01;Torstai;1;0;1;0;0;0
96;26.03.2015;2015;03;02;Torstai;0;0;0;1;0;1
96;26.03.2015;2015;03;03;Torstai;0;0;0;0;0;0
96;26.03.2015;2015;03;04;Torstai;4;0;4;0;1;1
96;26.03.2015;2015;03;05;Torstai;3;2;5;0;2;2
96;26.03.2015;2015;03;06;Torstai;44;23;67;11;4;15
96;26.03.2015;2015;03;07;Torstai;114;59;173;42;14;56
96;26.03.2015;2015;03;08;Torstai;117;50;167;24;10;34
96;26.03.2015;2015;03;09;Torstai;39;42;81;18;15;33
96;26.03.2015;2015;03;10;Torstai;38;44;82;18;17;35
96;26.03.2015;2015;03;11;Torstai;47;58;105;16;20;36
96;26.03.2015;2015;03;12;Torstai;61;56;117;19;25;44
96;26.03.2015;2015;03;13;Torstai;40;91;131;10;21;31
96;26.03.2015;2015;03;14;Torstai;44;133;177;9;33;42
96;26.03.2015;2015;03;15;Torstai;83;144;227;7;40;47
96;26.03.2015;2015;03;16;Torstai;59;108;167;11;34;45
96;26.03.2015;2015;03;17;Torstai;58;53;111;10;18;28
96;26.03.2015;2015;03;18;Torstai;35;46;81;14;17;31
96;26.03.2015;2015;03;19;Torstai;48;23;71;15;10;25
96;26.03.2015;2015;03;20;Torstai;45;17;62;15;9;24
96;26.03.2015;2015;03;21;Torstai;22;19;41;6;13;19
96;26.03.2015;2015;03;22;Torstai;8;4;12;4;4;8
96;26.03.2015;2015;03;23;Torstai;6;5;11;1;0;1
96;27.03.2015;2015;03;00;Perjantai;6;1;7;1;0;1
96;27.03.2015;2015;03;01;Perjantai;5;1;6;0;3;3
96;27.03.2015;2015;03;02;Perjantai;2;1;3;1;0;1
96;27.03.2015;2015;03;03;Perjantai;1;1;2;1;1;2
96;27.03.2015;2015;03;04;Perjantai;2;0;2;1;1;2
96;27.03.2015;2015;03;05;Perjantai;10;6;16;1;0;1
96;27.03.2015;2015;03;06;Perjantai;42;26;68;10;6;16
96;27.03.2015;2015;03;07;Perjantai;98;55;153;43;13;56
96;27.03.2015;2015;03;08;Perjantai;86;68;154;20;12;32
96;27.03.2015;2015;03;09;Perjantai;48;42;90;18;17;35
96;27.03.2015;2015;03;10;Perjantai;33;63;96;14;20;34
96;27.03.2015;2015;03;11;Perjantai;48;50;98;15;30;45
96;27.03.2015;2015;03;12;Perjantai;58;59;117;22;17;39
96;27.03.2015;2015;03;13;Perjantai;32;120;152;19;34;53
96;27.03.2015;2015;03;14;Perjantai;55;118;173;11;38;49
96;27.03.2015;2015;03;15;Perjantai;54;109;163;11;41;52
96;27.03.2015;2015;03;16;Perjantai;56;59;115;10;18;28
96;27.03.2015;2015;03;17;Perjantai;36;46;82;9;8;17
96;27.03.2015;2015;03;18;Perjantai;35;34;69;3;14;17
96;27.03.2015;2015;03;19;Perjantai;32;26;58;10;10;20
96;27.03.2015;2015;03;20;Perjantai;25;21;46;6;3;9
96;27.03.2015;2015;03;21;Perjantai;14;18;32;4;1;5
96;27.03.2015;2015;03;22;Perjantai;15;6;21;1;0;1
96;27.03.2015;2015;03;23;Perjantai;3;5;8;0;0;0
96;28.03.2015;2015;03;00;Lauantai;4;1;5;0;0;0
96;28.03.2015;2015;03;01;Lauantai;3;0;3;0;0;0
96;28.03.2015;2015;03;02;Lauantai;2;1;3;0;2;2
96;28.03.2015;2015;03;03;Lauantai;4;0;4;1;0;1
96;28.03.2015;2015;03;04;Lauantai;8;1;9;2;0;2
96;28.03.2015;2015;03;05;Lauantai;2;2;4;0;1;1
96;28.03.2015;2015;03;06;Lauantai;12;7;19;5;1;6
96;28.03.2015;2015;03;07;Lauantai;5;11;16;4;5;9
96;28.03.2015;2015;03;08;Lauantai;3;15;18;6;8;14
96;28.03.2015;2015;03;09;Lauantai;6;15;21;7;6;13
96;28.03.2015;2015;03;10;Lauantai;8;15;23;8;1;9
96;28.03.2015;2015;03;11;Lauantai;13;15;28;2;11;13
96;28.03.2015;2015;03;12;Lauantai;27;29;56;6;4;10
96;28.03.2015;2015;03;13;Lauantai;23;20;43;4;3;7
96;28.03.2015;2015;03;14;Lauantai;18;23;41;4;10;14
96;28.03.2015;2015;03;15;Lauantai;26;20;46;11;11;22
96;28.03.2015;2015;03;16;Lauantai;15;19;34;4;11;15
96;28.03.2015;2015;03;17;Lauantai;20;12;32;6;4;10
96;28.03.2015;2015;03;18;Lauantai;29;14;43;16;8;24
96;28.03.2015;2015;03;19;Lauantai;17;11;28;15;3;18
96;28.03.2015;2015;03;20;Lauantai;16;14;30;6;9;15
96;28.03.2015;2015;03;21;Lauantai;9;19;28;0;10;10
96;28.03.2015;2015;03;22;Lauantai;3;9;12;3;2;5
96;28.03.2015;2015;03;23;Lauantai;6;4;10;0;0;0
96;29.03.2015;2015;03;00;Sunnuntai;5;2;7;0;1;1
96;29.03.2015;2015;03;01;Sunnuntai;2;1;3;0;0;0
96;29.03.2015;2015;03;02;Sunnuntai;0;0;0;0;0;0
96;29.03.2015;2015;03;03;Sunnuntai;6;0;6;2;0;2
96;29.03.2015;2015;03;04;Sunnuntai;4;0;4;6;0;6
96;29.03.2015;2015;03;05;Sunnuntai;1;0;1;2;0;2
96;29.03.2015;2015;03;06;Sunnuntai;16;3;19;3;1;4
96;29.03.2015;2015;03;07;Sunnuntai;2;4;6;0;3;3
96;29.03.2015;2015;03;08;Sunnuntai;0;5;5;4;2;6
96;29.03.2015;2015;03;09;Sunnuntai;5;5;10;3;6;9
96;29.03.2015;2015;03;10;Sunnuntai;8;13;21;12;12;24
96;29.03.2015;2015;03;11;Sunnuntai;9;12;21;9;14;23
96;29.03.2015;2015;03;12;Sunnuntai;35;32;67;16;13;29
96;29.03.2015;2015;03;13;Sunnuntai;18;25;43;15;22;37
96;29.03.2015;2015;03;14;Sunnuntai;19;29;48;12;9;21
96;29.03.2015;2015;03;15;Sunnuntai;26;21;47;15;11;26
96;29.03.2015;2015;03;16;Sunnuntai;48;22;70;14;14;28
96;29.03.2015;2015;03;17;Sunnuntai;22;22;44;8;9;17
96;29.03.2015;2015;03;18;Sunnuntai;25;20;45;13;25;38
96;29.03.2015;2015;03;19;Sunnuntai;11;23;34;13;22;35
96;29.03.2015;2015;03;20;Sunnuntai;24;22;46;8;10;18
96;29.03.2015;2015;03;21;Sunnuntai;19;17;36;5;9;14
96;29.03.2015;2015;03;22;Sunnuntai;11;2;13;4;7;11
96;29.03.2015;2015;03;23;Sunnuntai;3;2;5;3;0;3
96;30.03.2015;2015;03;00;Maanantai;0;1;1;1;1;2
96;30.03.2015;2015;03;01;Maanantai;4;0;4;0;1;1
96;30.03.2015;2015;03;02;Maanantai;0;0;0;1;0;1
96;30.03.2015;2015;03;03;Maanantai;1;1;2;0;0;0
96;30.03.2015;2015;03;04;Maanantai;2;0;2;3;5;8
96;30.03.2015;2015;03;05;Maanantai;8;5;13;0;0;0
96;30.03.2015;2015;03;06;Maanantai;36;14;50;12;3;15
96;30.03.2015;2015;03;07;Maanantai;77;67;144;18;9;27
96;30.03.2015;2015;03;08;Maanantai;77;66;143;16;7;23
96;30.03.2015;2015;03;09;Maanantai;51;39;90;15;14;29
96;30.03.2015;2015;03;10;Maanantai;48;50;98;12;10;22
96;30.03.2015;2015;03;11;Maanantai;44;41;85;12;14;26
96;30.03.2015;2015;03;12;Maanantai;64;37;101;18;9;27
96;30.03.2015;2015;03;13;Maanantai;46;47;93;25;13;38
96;30.03.2015;2015;03;14;Maanantai;48;81;129;6;28;34
96;30.03.2015;2015;03;15;Maanantai;61;140;201;9;24;33
96;30.03.2015;2015;03;16;Maanantai;63;108;171;10;28;38
96;30.03.2015;2015;03;17;Maanantai;41;64;105;6;13;19
96;30.03.2015;2015;03;18;Maanantai;43;35;78;15;11;26
96;30.03.2015;2015;03;19;Maanantai;27;19;46;16;19;35
96;30.03.2015;2015;03;20;Maanantai;33;23;56;9;5;14
96;30.03.2015;2015;03;21;Maanantai;16;18;34;8;9;17
96;30.03.2015;2015;03;22;Maanantai;12;6;18;3;3;6
96;30.03.2015;2015;03;23;Maanantai;3;3;6;0;0;0
96;31.03.2015;2015;03;00;Tiistai;0;0;0;2;2;4
96;31.03.2015;2015;03;01;Tiistai;0;1;1;1;0;1
96;31.03.2015;2015;03;02;Tiistai;0;0;0;0;0;0
96;31.03.2015;2015;03;03;Tiistai;2;0;2;1;0;1
96;31.03.2015;2015;03;04;Tiistai;1;0;1;0;1;1
96;31.03.2015;2015;03;05;Tiistai;5;8;13;2;4;6
96;31.03.2015;2015;03;06;Tiistai;34;21;55;10;4;14
96;31.03.2015;2015;03;07;Tiistai;83;48;131;32;8;40
96;31.03.2015;2015;03;08;Tiistai;82;73;155;17;12;29
96;31.03.2015;2015;03;09;Tiistai;40;31;71;10;19;29
96;31.03.2015;2015;03;10;Tiistai;59;38;97;14;11;25
96;31.03.2015;2015;03;11;Tiistai;63;44;107;14;10;24
96;31.03.2015;2015;03;12;Tiistai;56;43;99;16;12;28
96;31.03.2015;2015;03;13;Tiistai;34;75;109;6;17;23
96;31.03.2015;2015;03;14;Tiistai;42;64;106;5;23;28
96;31.03.2015;2015;03;15;Tiistai;46;125;171;12;30;42
96;31.03.2015;2015;03;16;Tiistai;64;82;146;9;18;27
96;31.03.2015;2015;03;17;Tiistai;45;44;89;13;17;30
96;31.03.2015;2015;03;18;Tiistai;31;36;67;32;14;46
96;31.03.2015;2015;03;19;Tiistai;37;32;69;13;16;29
96;31.03.2015;2015;03;20;Tiistai;23;26;49;8;13;21
96;31.03.2015;2015;03;21;Tiistai;21;23;44;8;7;15
96;31.03.2015;2015;03;22;Tiistai;9;7;16;0;2;2
96;31.03.2015;2015;03;23;Tiistai;1;5;6;0;2;2
96;01.04.2015;2015;04;00;Keskiviikko;1;0;1;0;2;2
96;01.04.2015;2015;04;01;Keskiviikko;0;0;0;0;1;1
96;01.04.2015;2015;04;02;Keskiviikko;1;0;1;0;0;0
96;01.04.2015;2015;04;03;Keskiviikko;1;0;1;0;0;0
96;01.04.2015;2015;04;04;Keskiviikko;1;1;2;2;5;7
96;01.04.2015;2015;04;05;Keskiviikko;6;7;13;0;0;0
96;01.04.2015;2015;04;06;Keskiviikko;41;23;64;12;4;16
96;01.04.2015;2015;04;07;Keskiviikko;79;68;147;37;10;47
96;01.04.2015;2015;04;08;Keskiviikko;94;52;146;25;9;34
96;01.04.2015;2015;04;09;Keskiviikko;40;34;74;14;13;27
96;01.04.2015;2015;04;10;Keskiviikko;30;47;77;17;18;35
96;01.04.2015;2015;04;11;Keskiviikko;52;51;103;17;22;39
96;01.04.2015;2015;04;12;Keskiviikko;61;76;137;22;20;42
96;01.04.2015;2015;04;13;Keskiviikko;43;85;128;10;34;44
96;01.04.2015;2015;04;14;Keskiviikko;55;85;140;16;30;46
96;01.04.2015;2015;04;15;Keskiviikko;64;138;202;18;56;74
96;01.04.2015;2015;04;16;Keskiviikko;70;107;177;16;38;54
96;01.04.2015;2015;04;17;Keskiviikko;56;60;116;20;24;44
96;01.04.2015;2015;04;18;Keskiviikko;48;29;77;30;16;46
96;01.04.2015;2015;04;19;Keskiviikko;42;27;69;12;18;30
96;01.04.2015;2015;04;20;Keskiviikko;43;38;81;16;14;30
96;01.04.2015;2015;04;21;Keskiviikko;12;21;33;8;9;17
96;01.04.2015;2015;04;22;Keskiviikko;5;2;7;1;2;3
96;01.04.2015;2015;04;23;Keskiviikko;0;0;0;2;2;4
96;02.04.2015;2015;04;00;Torstai;6;3;9;1;0;1
96;02.04.2015;2015;04;01;Torstai;5;0;5;0;0;0
96;02.04.2015;2015;04;02;Torstai;6;0;6;0;0;0
96;02.04.2015;2015;04;03;Torstai;7;1;8;0;0;0
96;02.04.2015;2015;04;04;Torstai;1;1;2;1;1;2
96;02.04.2015;2015;04;05;Torstai;1;5;6;1;0;1
96;02.04.2015;2015;04;06;Torstai;48;26;74;10;3;13
96;02.04.2015;2015;04;07;Torstai;106;73;179;29;11;40
96;02.04.2015;2015;04;08;Torstai;87;62;149;16;7;23
96;02.04.2015;2015;04;09;Torstai;36;67;103;12;15;27
96;02.04.2015;2015;04;10;Torstai;46;53;99;7;9;16
96;02.04.2015;2015;04;11;Torstai;56;73;129;10;11;21
96;02.04.2015;2015;04;12;Torstai;60;63;123;9;22;31
96;02.04.2015;2015;04;13;Torstai;36;94;130;7;17;24
96;02.04.2015;2015;04;14;Torstai;57;142;199;4;30;34
96;02.04.2015;2015;04;15;Torstai;59;105;164;11;30;41
96;02.04.2015;2015;04;16;Torstai;36;65;101;11;13;24
96;02.04.2015;2015;04;17;Torstai;35;43;78;10;13;23
96;02.04.2015;2015;04;18;Torstai;40;33;73;12;8;20
96;02.04.2015;2015;04;19;Torstai;30;19;49;7;3;10
96;02.04.2015;2015;04;20;Torstai;36;18;54;11;12;23
96;02.04.2015;2015;04;21;Torstai;12;21;33;3;2;5
96;02.04.2015;2015;04;22;Torstai;13;7;20;0;2;2
96;02.04.2015;2015;04;23;Torstai;1;4;5;2;3;5
96;03.04.2015;2015;04;00;Perjantai;9;6;15;1;0;1
96;03.04.2015;2015;04;01;Perjantai;5;1;6;0;1;1
96;03.04.2015;2015;04;02;Perjantai;2;2;4;0;0;0
96;03.04.2015;2015;04;03;Perjantai;6;4;10;0;0;0
96;03.04.2015;2015;04;04;Perjantai;3;2;5;1;0;1
96;03.04.2015;2015;04;05;Perjantai;0;0;0;0;2;2
96;03.04.2015;2015;04;06;Perjantai;8;8;16;5;0;5
96;03.04.2015;2015;04;07;Perjantai;6;5;11;6;11;17
96;03.04.2015;2015;04;08;Perjantai;0;6;6;3;2;5
96;03.04.2015;2015;04;09;Perjantai;1;9;10;6;10;16
96;03.04.2015;2015;04;10;Perjantai;7;6;13;7;9;16
96;03.04.2015;2015;04;11;Perjantai;13;12;25;11;17;28
96;03.04.2015;2015;04;12;Perjantai;17;12;29;9;14;23
96;03.04.2015;2015;04;13;Perjantai;17;13;30;9;11;20
96;03.04.2015;2015;04;14;Perjantai;18;14;32;11;12;23
96;03.04.2015;2015;04;15;Perjantai;16;17;33;10;11;21
96;03.04.2015;2015;04;16;Perjantai;12;20;32;15;16;31
96;03.04.2015;2015;04;17;Perjantai;8;31;39;6;12;18
96;03.04.2015;2015;04;18;Perjantai;13;31;44;4;20;24
96;03.04.2015;2015;04;19;Perjantai;14;8;22;5;4;9
96;03.04.2015;2015;04;20;Perjantai;7;14;21;12;5;17
96;03.04.2015;2015;04;21;Perjantai;31;13;44;7;3;10
96;03.04.2015;2015;04;22;Perjantai;5;10;15;2;3;5
96;03.04.2015;2015;04;23;Perjantai;3;4;7;1;1;2
96;04.04.2015;2015;04;00;Lauantai;2;1;3;1;3;4
96;04.04.2015;2015;04;01;Lauantai;6;3;9;1;0;1
96;04.04.2015;2015;04;02;Lauantai;7;0;7;1;0;1
96;04.04.2015;2015;04;03;Lauantai;5;0;5;1;0;1
96;04.04.2015;2015;04;04;Lauantai;5;1;6;1;0;1
96;04.04.2015;2015;04;05;Lauantai;0;1;1;1;0;1
96;04.04.2015;2015;04;06;Lauantai;16;7;23;2;0;2
96;04.04.2015;2015;04;07;Lauantai;5;9;14;2;4;6
96;04.04.2015;2015;04;08;Lauantai;5;19;24;1;2;3
96;04.04.2015;2015;04;09;Lauantai;15;21;36;4;6;10
96;04.04.2015;2015;04;10;Lauantai;14;23;37;6;11;17
96;04.04.2015;2015;04;11;Lauantai;23;26;49;7;13;20
96;04.04.2015;2015;04;12;Lauantai;25;42;67;10;9;19
96;04.04.2015;2015;04;13;Lauantai;31;37;68;2;16;18
96;04.04.2015;2015;04;14;Lauantai;37;31;68;7;8;15
96;04.04.2015;2015;04;15;Lauantai;36;30;66;8;11;19
96;04.04.2015;2015;04;16;Lauantai;26;19;45;11;7;18
96;04.04.2015;2015;04;17;Lauantai;21;40;61;7;15;22
96;04.04.2015;2015;04;18;Lauantai;18;26;44;7;11;18
96;04.04.2015;2015;04;19;Lauantai;18;7;25;5;8;13
96;04.04.2015;2015;04;20;Lauantai;16;18;34;12;5;17
96;04.04.2015;2015;04;21;Lauantai;11;14;25;2;6;8
96;04.04.2015;2015;04;22;Lauantai;9;7;16;3;1;4
96;04.04.2015;2015;04;23;Lauantai;2;8;10;2;1;3
96;05.04.2015;2015;04;00;Sunnuntai;2;5;7;1;1;2
96;05.04.2015;2015;04;01;Sunnuntai;6;3;9;1;1;2
96;05.04.2015;2015;04;02;Sunnuntai;5;0;5;0;0;0
96;05.04.2015;2015;04;03;Sunnuntai;10;0;10;1;0;1
96;05.04.2015;2015;04;04;Sunnuntai;6;0;6;2;0;2
96;05.04.2015;2015;04;05;Sunnuntai;2;0;2;1;1;2
96;05.04.2015;2015;04;06;Sunnuntai;9;4;13;1;4;5
96;05.04.2015;2015;04;07;Sunnuntai;4;6;10;3;5;8
96;05.04.2015;2015;04;08;Sunnuntai;3;6;9;2;3;5
96;05.04.2015;2015;04;09;Sunnuntai;6;14;20;3;3;6
96;05.04.2015;2015;04;10;Sunnuntai;14;16;30;5;8;13
96;05.04.2015;2015;04;11;Sunnuntai;14;27;41;7;14;21
96;05.04.2015;2015;04;12;Sunnuntai;19;28;47;18;13;31
96;05.04.2015;2015;04;13;Sunnuntai;41;39;80;7;16;23
96;05.04.2015;2015;04;14;Sunnuntai;30;32;62;10;9;19
96;05.04.2015;2015;04;15;Sunnuntai;37;29;66;7;12;19
96;05.04.2015;2015;04;16;Sunnuntai;33;19;52;20;18;38
96;05.04.2015;2015;04;17;Sunnuntai;16;28;44;13;15;28
96;05.04.2015;2015;04;18;Sunnuntai;22;19;41;15;13;28
96;05.04.2015;2015;04;19;Sunnuntai;15;35;50;9;20;29
96;05.04.2015;2015;04;20;Sunnuntai;19;17;36;9;7;16
96;05.04.2015;2015;04;21;Sunnuntai;9;13;22;2;4;6
96;05.04.2015;2015;04;22;Sunnuntai;9;6;15;1;1;2
96;05.04.2015;2015;04;23;Sunnuntai;2;6;8;3;3;6
96;06.04.2015;2015;04;00;Maanantai;7;2;9;1;0;1
96;06.04.2015;2015;04;01;Maanantai;2;0;2;2;4;6
96;06.04.2015;2015;04;02;Maanantai;1;0;1;0;0;0
96;06.04.2015;2015;04;03;Maanantai;4;0;4;1;0;1
96;06.04.2015;2015;04;04;Maanantai;4;1;5;1;1;2
96;06.04.2015;2015;04;05;Maanantai;1;0;1;1;0;1
96;06.04.2015;2015;04;06;Maanantai;10;4;14;3;2;5
96;06.04.2015;2015;04;07;Maanantai;3;6;9;4;9;13
96;06.04.2015;2015;04;08;Maanantai;2;7;9;5;3;8
96;06.04.2015;2015;04;09;Maanantai;6;11;17;9;7;16
96;06.04.2015;2015;04;10;Maanantai;10;9;19;13;13;26
96;06.04.2015;2015;04;11;Maanantai;13;22;35;13;16;29
96;06.04.2015;2015;04;12;Maanantai;25;19;44;13;20;33
96;06.04.2015;2015;04;13;Maanantai;22;18;40;6;4;10
96;06.04.2015;2015;04;14;Maanantai;16;27;43;8;5;13
96;06.04.2015;2015;04;15;Maanantai;19;18;37;12;7;19
96;06.04.2015;2015;04;16;Maanantai;22;50;72;13;13;26
96;06.04.2015;2015;04;17;Maanantai;25;8;33;10;3;13
96;06.04.2015;2015;04;18;Maanantai;18;22;40;8;17;25
96;06.04.2015;2015;04;19;Maanantai;42;26;68;13;8;21
96;06.04.2015;2015;04;20;Maanantai;19;23;42;8;16;24
96;06.04.2015;2015;04;21;Maanantai;12;15;27;8;5;13
96;06.04.2015;2015;04;22;Maanantai;8;4;12;3;2;5
96;06.04.2015;2015;04;23;Maanantai;3;2;5;1;4;5
96;07.04.2015;2015;04;00;Tiistai;2;2;4;3;3;6
96;07.04.2015;2015;04;01;Tiistai;0;0;0;0;0;0
96;07.04.2015;2015;04;02;Tiistai;1;0;1;0;1;1
96;07.04.2015;2015;04;03;Tiistai;2;0;2;1;2;3
96;07.04.2015;2015;04;04;Tiistai;2;1;3;0;1;1
96;07.04.2015;2015;04;05;Tiistai;4;2;6;2;1;3
96;07.04.2015;2015;04;06;Tiistai;43;29;72;4;2;6
96;07.04.2015;2015;04;07;Tiistai;91;93;184;22;13;35
96;07.04.2015;2015;04;08;Tiistai;76;79;155;20;11;31
96;07.04.2015;2015;04;09;Tiistai;65;50;115;16;13;29
96;07.04.2015;2015;04;10;Tiistai;47;57;104;7;17;24
96;07.04.2015;2015;04;11;Tiistai;50;68;118;19;10;29
96;07.04.2015;2015;04;12;Tiistai;63;57;120;9;13;22
96;07.04.2015;2015;04;13;Tiistai;51;79;130;13;11;24
96;07.04.2015;2015;04;14;Tiistai;57;128;185;9;30;39
96;07.04.2015;2015;04;15;Tiistai;92;155;247;19;35;54
96;07.04.2015;2015;04;16;Tiistai;75;159;234;16;32;48
96;07.04.2015;2015;04;17;Tiistai;65;68;133;27;17;44
96;07.04.2015;2015;04;18;Tiistai;50;55;105;15;29;44
96;07.04.2015;2015;04;19;Tiistai;67;39;106;24;25;49
96;07.04.2015;2015;04;20;Tiistai;37;25;62;20;27;47
96;07.04.2015;2015;04;21;Tiistai;29;25;54;10;12;22
96;07.04.2015;2015;04;22;Tiistai;18;5;23;5;2;7
96;07.04.2015;2015;04;23;Tiistai;6;1;7;1;3;4
96;08.04.2015;2015;04;00;Keskiviikko;1;0;1;2;3;5
96;08.04.2015;2015;04;01;Keskiviikko;1;0;1;1;0;1
96;08.04.2015;2015;04;02;Keskiviikko;0;0;0;0;0;0
96;08.04.2015;2015;04;03;Keskiviikko;0;1;1;0;2;2
96;08.04.2015;2015;04;04;Keskiviikko;1;1;2;0;0;0
96;08.04.2015;2015;04;05;Keskiviikko;4;11;15;1;0;1
96;08.04.2015;2015;04;06;Keskiviikko;38;32;70;8;2;10
96;08.04.2015;2015;04;07;Keskiviikko;112;88;200;25;7;32
96;08.04.2015;2015;04;08;Keskiviikko;91;88;179;21;11;32
96;08.04.2015;2015;04;09;Keskiviikko;75;46;121;14;6;20
96;08.04.2015;2015;04;10;Keskiviikko;43;51;94;19;12;31
96;08.04.2015;2015;04;11;Keskiviikko;74;63;137;9;17;26
96;08.04.2015;2015;04;12;Keskiviikko;77;53;130;16;7;23
96;08.04.2015;2015;04;13;Keskiviikko;59;93;152;13;16;29
96;08.04.2015;2015;04;14;Keskiviikko;73;120;193;11;23;34
96;08.04.2015;2015;04;15;Keskiviikko;93;149;242;17;25;42
96;08.04.2015;2015;04;16;Keskiviikko;73;165;238;11;32;43
96;08.04.2015;2015;04;17;Keskiviikko;67;65;132;14;16;30
96;08.04.2015;2015;04;18;Keskiviikko;81;33;114;22;8;30
96;08.04.2015;2015;04;19;Keskiviikko;46;29;75;14;18;32
96;08.04.2015;2015;04;20;Keskiviikko;37;33;70;9;21;30
96;08.04.2015;2015;04;21;Keskiviikko;22;24;46;11;9;20
96;08.04.2015;2015;04;22;Keskiviikko;10;7;17;3;5;8
96;08.04.2015;2015;04;23;Keskiviikko;3;8;11;1;0;1
96;09.04.2015;2015;04;00;Torstai;1;3;4;0;1;1
96;09.04.2015;2015;04;01;Torstai;1;0;1;0;0;0
96;09.04.2015;2015;04;02;Torstai;1;1;2;0;0;0
96;09.04.2015;2015;04;03;Torstai;3;1;4;0;1;1
96;09.04.2015;2015;04;04;Torstai;2;3;5;0;0;0
96;09.04.2015;2015;04;05;Torstai;6;5;11;0;0;0
96;09.04.2015;2015;04;06;Torstai;47;26;73;12;4;16
96;09.04.2015;2015;04;07;Torstai;113;112;225;20;9;29
96;09.04.2015;2015;04;08;Torstai;105;91;196;22;12;34
96;09.04.2015;2015;04;09;Torstai;65;82;147;14;13;27
96;09.04.2015;2015;04;10;Torstai;67;48;115;7;15;22
96;09.04.2015;2015;04;11;Torstai;40;53;93;16;8;24
96;09.04.2015;2015;04;12;Torstai;43;61;104;17;11;28
96;09.04.2015;2015;04;13;Torstai;60;80;140;13;17;30
96;09.04.2015;2015;04;14;Torstai;59;139;198;24;28;52
96;09.04.2015;2015;04;15;Torstai;72;158;230;13;28;41
96;09.04.2015;2015;04;16;Torstai;81;132;213;14;30;44
96;09.04.2015;2015;04;17;Torstai;39;47;86;11;12;23
96;09.04.2015;2015;04;18;Torstai;55;46;101;17;15;32
96;09.04.2015;2015;04;19;Torstai;45;44;89;15;23;38
96;09.04.2015;2015;04;20;Torstai;40;34;74;14;16;30
96;09.04.2015;2015;04;21;Torstai;14;19;33;7;8;15
96;09.04.2015;2015;04;22;Torstai;4;10;14;1;2;3
96;09.04.2015;2015;04;23;Torstai;3;3;6;1;4;5
96;10.04.2015;2015;04;00;Perjantai;3;1;4;0;1;1
96;10.04.2015;2015;04;01;Perjantai;1;2;3;1;1;2
96;10.04.2015;2015;04;02;Perjantai;2;0;2;0;0;0
96;10.04.2015;2015;04;03;Perjantai;3;1;4;0;0;0
96;10.04.2015;2015;04;04;Perjantai;4;2;6;0;0;0
96;10.04.2015;2015;04;05;Perjantai;4;8;12;0;1;1
96;10.04.2015;2015;04;06;Perjantai;33;32;65;10;3;13
96;10.04.2015;2015;04;07;Perjantai;101;91;192;24;11;35
96;10.04.2015;2015;04;08;Perjantai;104;80;184;11;7;18
96;10.04.2015;2015;04;09;Perjantai;56;73;129;6;9;15
96;10.04.2015;2015;04;10;Perjantai;36;57;93;7;14;21
96;10.04.2015;2015;04;11;Perjantai;42;77;119;16;9;25
96;10.04.2015;2015;04;12;Perjantai;57;88;145;7;15;22
96;10.04.2015;2015;04;13;Perjantai;59;67;126;5;10;15
96;10.04.2015;2015;04;14;Perjantai;51;114;165;6;20;26
96;10.04.2015;2015;04;15;Perjantai;54;150;204;5;18;23
96;10.04.2015;2015;04;16;Perjantai;59;76;135;11;13;24
96;10.04.2015;2015;04;17;Perjantai;36;56;92;12;24;36
96;10.04.2015;2015;04;18;Perjantai;35;48;83;10;13;23
96;10.04.2015;2015;04;19;Perjantai;27;29;56;5;13;18
96;10.04.2015;2015;04;20;Perjantai;32;29;61;13;4;17
96;10.04.2015;2015;04;21;Perjantai;35;29;64;11;5;16
96;10.04.2015;2015;04;22;Perjantai;22;10;32;0;5;5
96;10.04.2015;2015;04;23;Perjantai;4;8;12;1;4;5
96;11.04.2015;2015;04;00;Lauantai;4;6;10;1;0;1
96;11.04.2015;2015;04;01;Lauantai;7;1;8;1;0;1
96;11.04.2015;2015;04;02;Lauantai;11;0;11;0;1;1
96;11.04.2015;2015;04;03;Lauantai;13;0;13;0;0;0
96;11.04.2015;2015;04;04;Lauantai;5;2;7;3;1;4
96;11.04.2015;2015;04;05;Lauantai;0;4;4;1;0;1
96;11.04.2015;2015;04;06;Lauantai;14;7;21;2;0;2
96;11.04.2015;2015;04;07;Lauantai;4;21;25;3;4;7
96;11.04.2015;2015;04;08;Lauantai;11;15;26;7;5;12
96;11.04.2015;2015;04;09;Lauantai;12;36;48;11;11;22
96;11.04.2015;2015;04;10;Lauantai;21;59;80;7;10;17
96;11.04.2015;2015;04;11;Lauantai;37;51;88;9;17;26
96;11.04.2015;2015;04;12;Lauantai;49;45;94;15;14;29
96;11.04.2015;2015;04;13;Lauantai;62;65;127;12;21;33
96;11.04.2015;2015;04;14;Lauantai;62;67;129;16;12;28
96;11.04.2015;2015;04;15;Lauantai;66;52;118;18;12;30
96;11.04.2015;2015;04;16;Lauantai;63;34;97;11;10;21
96;11.04.2015;2015;04;17;Lauantai;41;42;83;14;13;27
96;11.04.2015;2015;04;18;Lauantai;62;21;83;20;8;28
96;11.04.2015;2015;04;19;Lauantai;22;11;33;8;8;16
96;11.04.2015;2015;04;20;Lauantai;30;25;55;11;12;23
96;11.04.2015;2015;04;21;Lauantai;14;39;53;4;7;11
96;11.04.2015;2015;04;22;Lauantai;9;9;18;4;3;7
96;11.04.2015;2015;04;23;Lauantai;9;18;27;2;6;8
96;12.04.2015;2015;04;00;Sunnuntai;2;6;8;0;1;1
96;12.04.2015;2015;04;01;Sunnuntai;6;1;7;2;1;3
96;12.04.2015;2015;04;02;Sunnuntai;11;0;11;0;0;0
96;12.04.2015;2015;04;03;Sunnuntai;6;1;7;2;1;3
96;12.04.2015;2015;04;04;Sunnuntai;3;1;4;1;0;1
96;12.04.2015;2015;04;05;Sunnuntai;3;2;5;1;0;1
96;12.04.2015;2015;04;06;Sunnuntai;8;10;18;1;0;1
96;12.04.2015;2015;04;07;Sunnuntai;5;10;15;1;7;8
96;12.04.2015;2015;04;08;Sunnuntai;1;14;15;6;3;9
96;12.04.2015;2015;04;09;Sunnuntai;12;15;27;5;13;18
96;12.04.2015;2015;04;10;Sunnuntai;13;28;41;16;15;31
96;12.04.2015;2015;04;11;Sunnuntai;34;56;90;21;14;35
96;12.04.2015;2015;04;12;Sunnuntai;55;71;126;15;21;36
96;12.04.2015;2015;04;13;Sunnuntai;64;41;105;10;16;26
96;12.04.2015;2015;04;14;Sunnuntai;33;68;101;13;17;30
96;12.04.2015;2015;04;15;Sunnuntai;49;48;97;10;17;27
96;12.04.2015;2015;04;16;Sunnuntai;53;43;96;22;12;34
96;12.04.2015;2015;04;17;Sunnuntai;46;41;87;26;9;35
96;12.04.2015;2015;04;18;Sunnuntai;34;43;77;20;38;58
96;12.04.2015;2015;04;19;Sunnuntai;42;31;73;11;30;41
96;12.04.2015;2015;04;20;Sunnuntai;19;37;56;16;16;32
96;12.04.2015;2015;04;21;Sunnuntai;18;16;34;5;9;14
96;12.04.2015;2015;04;22;Sunnuntai;9;8;17;2;4;6
96;12.04.2015;2015;04;23;Sunnuntai;4;2;6;2;1;3
96;13.04.2015;2015;04;00;Maanantai;0;7;7;0;1;1
96;13.04.2015;2015;04;01;Maanantai;0;0;0;0;1;1
96;13.04.2015;2015;04;02;Maanantai;0;1;1;1;1;2
96;13.04.2015;2015;04;03;Maanantai;1;1;2;1;0;1
96;13.04.2015;2015;04;04;Maanantai;0;2;2;2;0;2
96;13.04.2015;2015;04;05;Maanantai;6;7;13;0;0;0
96;13.04.2015;2015;04;06;Maanantai;52;25;77;10;3;13
96;13.04.2015;2015;04;07;Maanantai;107;118;225;21;6;27
96;13.04.2015;2015;04;08;Maanantai;121;106;227;13;11;24
96;13.04.2015;2015;04;09;Maanantai;70;80;150;13;10;23
96;13.04.2015;2015;04;10;Maanantai;53;63;116;8;17;25
96;13.04.2015;2015;04;11;Maanantai;59;64;123;17;16;33
96;13.04.2015;2015;04;12;Maanantai;86;75;161;17;15;32
96;13.04.2015;2015;04;13;Maanantai;75;75;150;10;17;27
96;13.04.2015;2015;04;14;Maanantai;87;145;232;11;15;26
96;13.04.2015;2015;04;15;Maanantai;75;180;255;8;32;40
96;13.04.2015;2015;04;16;Maanantai;82;159;241;18;30;48
96;13.04.2015;2015;04;17;Maanantai;65;111;176;10;24;34
96;13.04.2015;2015;04;18;Maanantai;55;74;129;18;26;44
96;13.04.2015;2015;04;19;Maanantai;30;35;65;17;16;33
96;13.04.2015;2015;04;20;Maanantai;41;35;76;5;8;13
96;13.04.2015;2015;04;21;Maanantai;69;35;104;14;11;25
96;13.04.2015;2015;04;22;Maanantai;10;5;15;3;3;6
96;13.04.2015;2015;04;23;Maanantai;4;4;8;0;2;2
96;14.04.2015;2015;04;00;Tiistai;1;2;3;0;2;2
96;14.04.2015;2015;04;01;Tiistai;2;0;2;0;1;1
96;14.04.2015;2015;04;02;Tiistai;1;1;2;0;0;0
96;14.04.2015;2015;04;03;Tiistai;0;0;0;0;0;0
96;14.04.2015;2015;04;04;Tiistai;1;0;1;0;1;1
96;14.04.2015;2015;04;05;Tiistai;4;7;11;2;0;2
96;14.04.2015;2015;04;06;Tiistai;51;46;97;10;5;15
96;14.04.2015;2015;04;07;Tiistai;138;126;264;29;6;35
96;14.04.2015;2015;04;08;Tiistai;123;92;215;16;5;21
96;14.04.2015;2015;04;09;Tiistai;54;97;151;10;16;26
96;14.04.2015;2015;04;10;Tiistai;52;62;114;7;16;23
96;14.04.2015;2015;04;11;Tiistai;58;75;133;18;11;29
96;14.04.2015;2015;04;12;Tiistai;79;73;152;10;13;23
96;14.04.2015;2015;04;13;Tiistai;57;92;149;11;17;28
96;14.04.2015;2015;04;14;Tiistai;69;146;215;6;17;23
96;14.04.2015;2015;04;15;Tiistai;81;232;313;20;29;49
96;14.04.2015;2015;04;16;Tiistai;71;184;255;10;34;44
96;14.04.2015;2015;04;17;Tiistai;77;85;162;18;17;35
96;14.04.2015;2015;04;18;Tiistai;66;49;115;17;17;34
96;14.04.2015;2015;04;19;Tiistai;57;44;101;18;24;42
96;14.04.2015;2015;04;20;Tiistai;35;50;85;7;17;24
96;14.04.2015;2015;04;21;Tiistai;20;31;51;6;10;16
96;14.04.2015;2015;04;22;Tiistai;7;3;10;3;0;3
96;14.04.2015;2015;04;23;Tiistai;4;1;5;2;1;3
96;15.04.2015;2015;04;00;Keskiviikko;0;1;1;0;2;2
96;15.04.2015;2015;04;01;Keskiviikko;1;0;1;1;0;1
96;15.04.2015;2015;04;02;Keskiviikko;2;0;2;0;0;0
96;15.04.2015;2015;04;03;Keskiviikko;0;0;0;0;0;0
96;15.04.2015;2015;04;04;Keskiviikko;1;2;3;0;0;0
96;15.04.2015;2015;04;05;Keskiviikko;5;4;9;0;0;0
96;15.04.2015;2015;04;06;Keskiviikko;53;34;87;7;3;10
96;15.04.2015;2015;04;07;Keskiviikko;145;129;274;29;7;36
96;15.04.2015;2015;04;08;Keskiviikko;105;96;201;17;12;29
96;15.04.2015;2015;04;09;Keskiviikko;72;58;130;25;9;34
96;15.04.2015;2015;04;10;Keskiviikko;40;60;100;12;12;24
96;15.04.2015;2015;04;11;Keskiviikko;44;63;107;11;11;22
96;15.04.2015;2015;04;12;Keskiviikko;65;76;141;14;17;31
96;15.04.2015;2015;04;13;Keskiviikko;56;78;134;14;27;41
96;15.04.2015;2015;04;14;Keskiviikko;69;134;203;8;23;31
96;15.04.2015;2015;04;15;Keskiviikko;87;187;274;10;35;45
96;15.04.2015;2015;04;16;Keskiviikko;87;163;250;11;27;38
96;15.04.2015;2015;04;17;Keskiviikko;75;76;151;18;26;44
96;15.04.2015;2015;04;18;Keskiviikko;79;63;142;12;30;42
96;15.04.2015;2015;04;19;Keskiviikko;46;27;73;13;13;26
96;15.04.2015;2015;04;20;Keskiviikko;36;42;78;8;4;12
96;15.04.2015;2015;04;21;Keskiviikko;62;43;105;21;4;25
96;15.04.2015;2015;04;22;Keskiviikko;10;9;19;2;2;4
96;15.04.2015;2015;04;23;Keskiviikko;4;1;5;1;4;5
96;16.04.2015;2015;04;00;Torstai;3;2;5;0;0;0
96;16.04.2015;2015;04;01;Torstai;0;0;0;1;0;1
96;16.04.2015;2015;04;02;Torstai;2;0;2;0;0;0
96;16.04.2015;2015;04;03;Torstai;0;1;1;0;1;1
96;16.04.2015;2015;04;04;Torstai;1;1;2;0;0;0
96;16.04.2015;2015;04;05;Torstai;8;2;10;1;1;2
96;16.04.2015;2015;04;06;Torstai;53;25;78;7;3;10
96;16.04.2015;2015;04;07;Torstai;121;103;224;21;9;30
96;16.04.2015;2015;04;08;Torstai;116;102;218;15;11;26
96;16.04.2015;2015;04;09;Torstai;66;71;137;15;13;28
96;16.04.2015;2015;04;10;Torstai;42;49;91;9;18;27
96;16.04.2015;2015;04;11;Torstai;77;67;144;13;11;24
96;16.04.2015;2015;04;12;Torstai;72;70;142;11;11;22
96;16.04.2015;2015;04;13;Torstai;44;94;138;6;16;22
96;16.04.2015;2015;04;14;Torstai;72;143;215;7;23;30
96;16.04.2015;2015;04;15;Torstai;78;187;265;8;35;43
96;16.04.2015;2015;04;16;Torstai;84;175;259;10;30;40
96;16.04.2015;2015;04;17;Torstai;51;59;110;15;15;30
96;16.04.2015;2015;04;18;Torstai;64;51;115;21;20;41
96;16.04.2015;2015;04;19;Torstai;56;40;96;14;22;36
96;16.04.2015;2015;04;20;Torstai;48;41;89;10;8;18
96;16.04.2015;2015;04;21;Torstai;29;38;67;8;10;18
96;16.04.2015;2015;04;22;Torstai;8;8;16;3;5;8
96;16.04.2015;2015;04;23;Torstai;6;1;7;0;2;2
96;17.04.2015;2015;04;00;Perjantai;5;4;9;0;0;0
96;17.04.2015;2015;04;01;Perjantai;5;0;5;0;0;0
96;17.04.2015;2015;04;02;Perjantai;0;0;0;1;1;2
96;17.04.2015;2015;04;03;Perjantai;6;1;7;0;1;1
96;17.04.2015;2015;04;04;Perjantai;5;2;7;0;0;0
96;17.04.2015;2015;04;05;Perjantai;3;4;7;0;0;0
96;17.04.2015;2015;04;06;Perjantai;48;30;78;6;3;9
96;17.04.2015;2015;04;07;Perjantai;121;114;235;16;10;26
96;17.04.2015;2015;04;08;Perjantai;94;90;184;9;8;17
96;17.04.2015;2015;04;09;Perjantai;53;76;129;13;12;25
96;17.04.2015;2015;04;10;Perjantai;40;68;108;8;17;25
96;17.04.2015;2015;04;11;Perjantai;66;93;159;10;8;18
96;17.04.2015;2015;04;12;Perjantai;74;84;158;9;14;23
96;17.04.2015;2015;04;13;Perjantai;69;115;184;13;17;30
96;17.04.2015;2015;04;14;Perjantai;58;155;213;7;29;36
96;17.04.2015;2015;04;15;Perjantai;74;144;218;10;27;37
96;17.04.2015;2015;04;16;Perjantai;85;100;185;14;19;33
96;17.04.2015;2015;04;17;Perjantai;73;54;127;5;9;14
96;17.04.2015;2015;04;18;Perjantai;54;40;94;13;13;26
96;17.04.2015;2015;04;19;Perjantai;44;37;81;12;17;29
96;17.04.2015;2015;04;20;Perjantai;39;26;65;8;6;14
96;17.04.2015;2015;04;21;Perjantai;26;20;46;4;4;8
96;17.04.2015;2015;04;22;Perjantai;15;20;35;3;0;3
96;17.04.2015;2015;04;23;Perjantai;9;16;25;1;1;2
96;18.04.2015;2015;04;00;Lauantai;4;3;7;0;1;1
96;18.04.2015;2015;04;01;Lauantai;6;4;10;1;1;2
96;18.04.2015;2015;04;02;Lauantai;12;0;12;0;2;2
96;18.04.2015;2015;04;03;Lauantai;9;0;9;1;0;1
96;18.04.2015;2015;04;04;Lauantai;2;1;3;1;1;2
96;18.04.2015;2015;04;05;Lauantai;1;4;5;1;0;1
96;18.04.2015;2015;04;06;Lauantai;19;12;31;5;0;5
96;18.04.2015;2015;04;07;Lauantai;9;14;23;2;1;3
96;18.04.2015;2015;04;08;Lauantai;6;29;35;3;7;10
96;18.04.2015;2015;04;09;Lauantai;16;53;69;8;7;15
96;18.04.2015;2015;04;10;Lauantai;24;52;76;11;18;29
96;18.04.2015;2015;04;11;Lauantai;42;68;110;9;41;50
96;18.04.2015;2015;04;12;Lauantai;66;60;126;27;24;51
96;18.04.2015;2015;04;13;Lauantai;61;83;144;21;10;31
96;18.04.2015;2015;04;14;Lauantai;76;88;164;20;22;42
96;18.04.2015;2015;04;15;Lauantai;74;105;179;13;27;40
96;18.04.2015;2015;04;16;Lauantai;61;36;97;11;13;24
96;18.04.2015;2015;04;17;Lauantai;61;23;84;19;9;28
96;18.04.2015;2015;04;18;Lauantai;62;25;87;36;6;42
96;18.04.2015;2015;04;19;Lauantai;32;31;63;7;13;20
96;18.04.2015;2015;04;20;Lauantai;31;30;61;6;11;17
96;18.04.2015;2015;04;21;Lauantai;17;31;48;5;3;8
96;18.04.2015;2015;04;22;Lauantai;12;18;30;2;3;5
96;18.04.2015;2015;04;23;Lauantai;6;10;16;2;4;6
96;19.04.2015;2015;04;00;Sunnuntai;9;7;16;1;1;2
96;19.04.2015;2015;04;01;Sunnuntai;4;2;6;0;0;0
96;19.04.2015;2015;04;02;Sunnuntai;8;2;10;3;0;3
96;19.04.2015;2015;04;03;Sunnuntai;13;1;14;3;0;3
96;19.04.2015;2015;04;04;Sunnuntai;5;0;5;3;0;3
96;19.04.2015;2015;04;05;Sunnuntai;4;2;6;1;0;1
96;19.04.2015;2015;04;06;Sunnuntai;20;9;29;4;0;4
96;19.04.2015;2015;04;07;Sunnuntai;9;7;16;2;2;4
96;19.04.2015;2015;04;08;Sunnuntai;8;8;16;6;9;15
96;19.04.2015;2015;04;09;Sunnuntai;13;17;30;6;8;14
96;19.04.2015;2015;04;10;Sunnuntai;14;33;47;14;21;35
96;19.04.2015;2015;04;11;Sunnuntai;22;57;79;14;40;54
96;19.04.2015;2015;04;12;Sunnuntai;48;64;112;21;19;40
96;19.04.2015;2015;04;13;Sunnuntai;67;86;153;26;11;37
96;19.04.2015;2015;04;14;Sunnuntai;62;63;125;18;16;34
96;19.04.2015;2015;04;15;Sunnuntai;49;45;94;19;11;30
96;19.04.2015;2015;04;16;Sunnuntai;82;41;123;20;19;39
96;19.04.2015;2015;04;17;Sunnuntai;33;36;69;13;4;17
96;19.04.2015;2015;04;18;Sunnuntai;41;37;78;14;14;28
96;19.04.2015;2015;04;19;Sunnuntai;24;35;59;8;16;24
96;19.04.2015;2015;04;20;Sunnuntai;21;33;54;2;12;14
96;19.04.2015;2015;04;21;Sunnuntai;18;20;38;7;4;11
96;19.04.2015;2015;04;22;Sunnuntai;6;9;15;3;2;5
96;19.04.2015;2015;04;23;Sunnuntai;9;7;16;1;1;2
96;20.04.2015;2015;04;00;Maanantai;3;0;3;1;1;2
96;20.04.2015;2015;04;01;Maanantai;4;1;5;0;0;0
96;20.04.2015;2015;04;02;Maanantai;2;0;2;0;0;0
96;20.04.2015;2015;04;03;Maanantai;1;0;1;0;0;0
96;20.04.2015;2015;04;04;Maanantai;3;1;4;1;0;1
96;20.04.2015;2015;04;05;Maanantai;5;8;13;2;1;3
96;20.04.2015;2015;04;06;Maanantai;54;39;93;8;0;8
96;20.04.2015;2015;04;07;Maanantai;135;117;252;21;5;26
96;20.04.2015;2015;04;08;Maanantai;105;116;221;19;11;30
96;20.04.2015;2015;04;09;Maanantai;95;80;175;11;12;23
96;20.04.2015;2015;04;10;Maanantai;51;66;117;10;15;25
96;20.04.2015;2015;04;11;Maanantai;47;70;117;10;10;20
96;20.04.2015;2015;04;12;Maanantai;86;85;171;28;3;31
96;20.04.2015;2015;04;13;Maanantai;88;99;187;12;15;27
96;20.04.2015;2015;04;14;Maanantai;82;143;225;12;23;35
96;20.04.2015;2015;04;15;Maanantai;103;209;312;8;23;31
96;20.04.2015;2015;04;16;Maanantai;123;166;289;10;25;35
96;20.04.2015;2015;04;17;Maanantai;73;84;157;11;19;30
96;20.04.2015;2015;04;18;Maanantai;78;61;139;13;15;28
96;20.04.2015;2015;04;19;Maanantai;52;38;90;9;12;21
96;20.04.2015;2015;04;20;Maanantai;52;42;94;8;3;11
96;20.04.2015;2015;04;21;Maanantai;33;30;63;2;6;8
96;20.04.2015;2015;04;22;Maanantai;9;11;20;3;0;3
96;20.04.2015;2015;04;23;Maanantai;1;2;3;1;2;3
96;21.04.2015;2015;04;00;Tiistai;3;3;6;0;1;1
96;21.04.2015;2015;04;01;Tiistai;1;0;1;0;0;0
96;21.04.2015;2015;04;02;Tiistai;1;0;1;0;0;0
96;21.04.2015;2015;04;03;Tiistai;1;0;1;1;0;1
96;21.04.2015;2015;04;04;Tiistai;1;2;3;0;0;0
96;21.04.2015;2015;04;05;Tiistai;6;8;14;0;2;2
96;21.04.2015;2015;04;06;Tiistai;48;37;85;10;1;11
96;21.04.2015;2015;04;07;Tiistai;131;117;248;21;9;30
96;21.04.2015;2015;04;08;Tiistai;131;138;269;20;9;29
96;21.04.2015;2015;04;09;Tiistai;81;75;156;16;11;27
96;21.04.2015;2015;04;10;Tiistai;58;98;156;10;13;23
96;21.04.2015;2015;04;11;Tiistai;83;65;148;14;13;27
96;21.04.2015;2015;04;12;Tiistai;104;87;191;13;24;37
96;21.04.2015;2015;04;13;Tiistai;67;99;166;15;13;28
96;21.04.2015;2015;04;14;Tiistai;84;153;237;18;18;36
96;21.04.2015;2015;04;15;Tiistai;111;179;290;8;28;36
96;21.04.2015;2015;04;16;Tiistai;123;167;290;11;19;30
96;21.04.2015;2015;04;17;Tiistai;71;84;155;19;21;40
96;21.04.2015;2015;04;18;Tiistai;68;69;137;18;16;34
96;21.04.2015;2015;04;19;Tiistai;78;47;125;20;23;43
96;21.04.2015;2015;04;20;Tiistai;69;47;116;11;21;32
96;21.04.2015;2015;04;21;Tiistai;39;42;81;5;10;15
96;21.04.2015;2015;04;22;Tiistai;12;13;25;5;7;12
96;21.04.2015;2015;04;23;Tiistai;3;1;4;1;1;2
96;22.04.2015;2015;04;00;Keskiviikko;1;1;2;1;2;3
96;22.04.2015;2015;04;01;Keskiviikko;2;1;3;0;0;0
96;22.04.2015;2015;04;02;Keskiviikko;1;0;1;0;1;1
96;22.04.2015;2015;04;03;Keskiviikko;2;1;3;0;0;0
96;22.04.2015;2015;04;04;Keskiviikko;4;4;8;0;0;0
96;22.04.2015;2015;04;05;Keskiviikko;5;11;16;1;1;2
96;22.04.2015;2015;04;06;Keskiviikko;61;41;102;9;1;10
96;22.04.2015;2015;04;07;Keskiviikko;135;131;266;20;6;26
96;22.04.2015;2015;04;08;Keskiviikko;83;102;185;11;6;17
96;22.04.2015;2015;04;09;Keskiviikko;99;84;183;19;10;29
96;22.04.2015;2015;04;10;Keskiviikko;50;53;103;15;15;30
96;22.04.2015;2015;04;11;Keskiviikko;61;80;141;8;14;22
96;22.04.2015;2015;04;12;Keskiviikko;75;79;154;8;9;17
96;22.04.2015;2015;04;13;Keskiviikko;80;98;178;9;11;20
96;22.04.2015;2015;04;14;Keskiviikko;109;127;236;7;24;31
96;22.04.2015;2015;04;15;Keskiviikko;104;203;307;10;26;36
96;22.04.2015;2015;04;16;Keskiviikko;113;183;296;19;26;45
96;22.04.2015;2015;04;17;Keskiviikko;70;118;188;21;28;49
96;22.04.2015;2015;04;18;Keskiviikko;88;102;190;16;16;32
96;22.04.2015;2015;04;19;Keskiviikko;66;32;98;9;12;21
96;22.04.2015;2015;04;20;Keskiviikko;55;58;113;9;9;18
96;22.04.2015;2015;04;21;Keskiviikko;110;47;157;23;7;30
96;22.04.2015;2015;04;22;Keskiviikko;15;9;24;3;2;5
96;22.04.2015;2015;04;23;Keskiviikko;9;12;21;1;5;6
96;23.04.2015;2015;04;00;Torstai;4;2;6;2;0;2
96;23.04.2015;2015;04;01;Torstai;1;1;2;0;0;0
96;23.04.2015;2015;04;02;Torstai;0;1;1;1;1;2
96;23.04.2015;2015;04;03;Torstai;4;1;5;1;0;1
96;23.04.2015;2015;04;04;Torstai;2;2;4;0;0;0
96;23.04.2015;2015;04;05;Torstai;8;7;15;0;1;1
96;23.04.2015;2015;04;06;Torstai;53;38;91;8;1;9
96;23.04.2015;2015;04;07;Torstai;124;127;251;22;6;28
96;23.04.2015;2015;04;08;Torstai;93;106;199;16;11;27
96;23.04.2015;2015;04;09;Torstai;92;86;178;17;12;29
96;23.04.2015;2015;04;10;Torstai;69;59;128;13;8;21
96;23.04.2015;2015;04;11;Torstai;72;71;143;8;12;20
96;23.04.2015;2015;04;12;Torstai;73;80;153;22;19;41
96;23.04.2015;2015;04;13;Torstai;60;94;154;5;12;17
96;23.04.2015;2015;04;14;Torstai;98;135;233;17;15;32
96;23.04.2015;2015;04;15;Torstai;101;197;298;12;26;38
96;23.04.2015;2015;04;16;Torstai;104;147;251;13;35;48
96;23.04.2015;2015;04;17;Torstai;86;75;161;27;17;44
96;23.04.2015;2015;04;18;Torstai;73;59;132;30;21;51
96;23.04.2015;2015;04;19;Torstai;65;49;114;18;22;40
96;23.04.2015;2015;04;20;Torstai;64;37;101;14;6;20
96;23.04.2015;2015;04;21;Torstai;22;29;51;7;7;14
96;23.04.2015;2015;04;22;Torstai;11;11;22;0;2;2
96;23.04.2015;2015;04;23;Torstai;10;8;18;1;2;3
96;24.04.2015;2015;04;00;Perjantai;1;5;6;0;0;0
96;24.04.2015;2015;04;01;Perjantai;0;1;1;0;0;0
96;24.04.2015;2015;04;02;Perjantai;1;1;2;0;1;1
96;24.04.2015;2015;04;03;Perjantai;6;0;6;0;0;0
96;24.04.2015;2015;04;04;Perjantai;2;2;4;1;0;1
96;24.04.2015;2015;04;05;Perjantai;6;13;19;1;0;1
96;24.04.2015;2015;04;06;Perjantai;38;37;75;6;1;7
96;24.04.2015;2015;04;07;Perjantai;134;106;240;18;10;28
96;24.04.2015;2015;04;08;Perjantai;90;98;188;9;10;19
96;24.04.2015;2015;04;09;Perjantai;63;76;139;14;12;26
96;24.04.2015;2015;04;10;Perjantai;38;67;105;10;10;20
96;24.04.2015;2015;04;11;Perjantai;70;80;150;8;8;16
96;24.04.2015;2015;04;12;Perjantai;58;99;157;7;9;16
96;24.04.2015;2015;04;13;Perjantai;70;117;187;4;12;16
96;24.04.2015;2015;04;14;Perjantai;88;138;226;11;19;30
96;24.04.2015;2015;04;15;Perjantai;71;161;232;4;24;28
96;24.04.2015;2015;04;16;Perjantai;87;77;164;9;17;26
96;24.04.2015;2015;04;17;Perjantai;57;68;125;11;6;17
96;24.04.2015;2015;04;18;Perjantai;47;30;77;13;15;28
96;24.04.2015;2015;04;19;Perjantai;35;39;74;6;8;14
96;24.04.2015;2015;04;20;Perjantai;36;28;64;6;9;15
96;24.04.2015;2015;04;21;Perjantai;38;25;63;5;3;8
96;24.04.2015;2015;04;22;Perjantai;13;18;31;3;4;7
96;24.04.2015;2015;04;23;Perjantai;15;13;28;0;0;0
96;25.04.2015;2015;04;00;Lauantai;8;2;10;0;6;6
96;25.04.2015;2015;04;01;Lauantai;6;3;9;0;0;0
96;25.04.2015;2015;04;02;Lauantai;11;2;13;1;0;1
96;25.04.2015;2015;04;03;Lauantai;8;1;9;3;0;3
96;25.04.2015;2015;04;04;Lauantai;4;1;5;3;1;4
96;25.04.2015;2015;04;05;Lauantai;2;3;5;1;1;2
96;25.04.2015;2015;04;06;Lauantai;11;9;20;3;0;3
96;25.04.2015;2015;04;07;Lauantai;5;24;29;1;4;5
96;25.04.2015;2015;04;08;Lauantai;10;18;28;2;2;4
96;25.04.2015;2015;04;09;Lauantai;16;61;77;2;17;19
96;25.04.2015;2015;04;10;Lauantai;28;82;110;10;39;49
96;25.04.2015;2015;04;11;Lauantai;43;67;110;25;21;46
96;25.04.2015;2015;04;12;Lauantai;68;60;128;30;17;47
96;25.04.2015;2015;04;13;Lauantai;62;49;111;17;13;30
96;25.04.2015;2015;04;14;Lauantai;54;78;132;14;8;22
96;25.04.2015;2015;04;15;Lauantai;45;72;117;9;18;27
96;25.04.2015;2015;04;16;Lauantai;60;96;156;9;16;25
96;25.04.2015;2015;04;17;Lauantai;50;45;95;19;7;26
96;25.04.2015;2015;04;18;Lauantai;46;12;58;4;1;5
96;25.04.2015;2015;04;19;Lauantai;21;24;45;6;10;16
96;25.04.2015;2015;04;20;Lauantai;40;40;80;9;11;20
96;25.04.2015;2015;04;21;Lauantai;57;86;143;7;13;20
96;25.04.2015;2015;04;22;Lauantai;35;41;76;2;7;9
96;25.04.2015;2015;04;23;Lauantai;41;10;51;3;3;6
96;26.04.2015;2015;04;00;Sunnuntai;22;15;37;2;1;3
96;26.04.2015;2015;04;01;Sunnuntai;20;2;22;2;0;2
96;26.04.2015;2015;04;02;Sunnuntai;24;3;27;2;1;3
96;26.04.2015;2015;04;03;Sunnuntai;13;1;14;1;0;1
96;26.04.2015;2015;04;04;Sunnuntai;6;1;7;2;1;3
96;26.04.2015;2015;04;05;Sunnuntai;2;1;3;0;2;2
96;26.04.2015;2015;04;06;Sunnuntai;18;5;23;2;0;2
96;26.04.2015;2015;04;07;Sunnuntai;2;15;17;1;3;4
96;26.04.2015;2015;04;08;Sunnuntai;7;13;20;7;3;10
96;26.04.2015;2015;04;09;Sunnuntai;11;19;30;6;5;11
96;26.04.2015;2015;04;10;Sunnuntai;11;20;31;4;7;11
96;26.04.2015;2015;04;11;Sunnuntai;33;52;85;12;15;27
96;26.04.2015;2015;04;12;Sunnuntai;53;45;98;18;25;43
96;26.04.2015;2015;04;13;Sunnuntai;46;64;110;10;13;23
96;26.04.2015;2015;04;14;Sunnuntai;56;61;117;6;11;17
96;26.04.2015;2015;04;15;Sunnuntai;44;60;104;6;12;18
96;26.04.2015;2015;04;16;Sunnuntai;73;48;121;23;7;30
96;26.04.2015;2015;04;17;Sunnuntai;65;39;104;17;13;30
96;26.04.2015;2015;04;18;Sunnuntai;45;35;80;17;23;40
96;26.04.2015;2015;04;19;Sunnuntai;20;42;62;7;21;28
96;26.04.2015;2015;04;20;Sunnuntai;25;44;69;6;14;20
96;26.04.2015;2015;04;21;Sunnuntai;16;26;42;3;5;8
96;26.04.2015;2015;04;22;Sunnuntai;5;12;17;1;0;1
96;26.04.2015;2015;04;23;Sunnuntai;8;8;16;3;2;5
96;27.04.2015;2015;04;00;Maanantai;3;1;4;1;0;1
96;27.04.2015;2015;04;01;Maanantai;1;1;2;0;0;0
96;27.04.2015;2015;04;02;Maanantai;1;0;1;0;0;0
96;27.04.2015;2015;04;03;Maanantai;0;0;0;0;0;0
96;27.04.2015;2015;04;04;Maanantai;1;1;2;0;0;0
96;27.04.2015;2015;04;05;Maanantai;6;9;15;0;1;1
96;27.04.2015;2015;04;06;Maanantai;43;31;74;7;1;8
96;27.04.2015;2015;04;07;Maanantai;111;97;208;14;6;20
96;27.04.2015;2015;04;08;Maanantai;89;97;186;13;4;17
96;27.04.2015;2015;04;09;Maanantai;62;93;155;12;3;15
96;27.04.2015;2015;04;10;Maanantai;49;75;124;19;21;40
96;27.04.2015;2015;04;11;Maanantai;82;73;155;14;10;24
96;27.04.2015;2015;04;12;Maanantai;62;75;137;9;4;13
96;27.04.2015;2015;04;13;Maanantai;67;88;155;4;14;18
96;27.04.2015;2015;04;14;Maanantai;93;127;220;12;13;25
96;27.04.2015;2015;04;15;Maanantai;98;196;294;6;26;32
96;27.04.2015;2015;04;16;Maanantai;97;152;249;16;20;36
96;27.04.2015;2015;04;17;Maanantai;70;90;160;8;10;18
96;27.04.2015;2015;04;18;Maanantai;61;66;127;11;17;28
96;27.04.2015;2015;04;19;Maanantai;55;57;112;6;12;18
96;27.04.2015;2015;04;20;Maanantai;86;41;127;10;8;18
96;27.04.2015;2015;04;21;Maanantai;42;33;75;2;5;7
96;27.04.2015;2015;04;22;Maanantai;10;17;27;4;2;6
96;27.04.2015;2015;04;23;Maanantai;3;2;5;0;1;1
96;28.04.2015;2015;04;00;Tiistai;1;3;4;0;0;0
96;28.04.2015;2015;04;01;Tiistai;15;0;15;0;1;1
96;28.04.2015;2015;04;02;Tiistai;2;1;3;0;0;0
96;28.04.2015;2015;04;03;Tiistai;7;0;7;2;0;2
96;28.04.2015;2015;04;04;Tiistai;3;2;5;0;1;1
96;28.04.2015;2015;04;05;Tiistai;8;9;17;1;0;1
96;28.04.2015;2015;04;06;Tiistai;55;46;101;3;2;5
96;28.04.2015;2015;04;07;Tiistai;136;133;269;24;5;29
96;28.04.2015;2015;04;08;Tiistai;115;137;252;10;11;21
96;28.04.2015;2015;04;09;Tiistai;72;64;136;10;10;20
96;28.04.2015;2015;04;10;Tiistai;68;111;179;12;16;28
96;28.04.2015;2015;04;11;Tiistai;82;71;153;7;11;18
96;28.04.2015;2015;04;12;Tiistai;106;65;171;10;6;16
96;28.04.2015;2015;04;13;Tiistai;72;107;179;11;15;26
96;28.04.2015;2015;04;14;Tiistai;88;132;220;8;7;15
96;28.04.2015;2015;04;15;Tiistai;114;211;325;15;22;37
96;28.04.2015;2015;04;16;Tiistai;141;161;302;14;20;34
96;28.04.2015;2015;04;17;Tiistai;77;90;167;18;13;31
96;28.04.2015;2015;04;18;Tiistai;69;58;127;12;19;31
96;28.04.2015;2015;04;19;Tiistai;68;45;113;9;27;36
96;28.04.2015;2015;04;20;Tiistai;73;52;125;10;12;22
96;28.04.2015;2015;04;21;Tiistai;31;51;82;11;8;19
96;28.04.2015;2015;04;22;Tiistai;12;10;22;3;4;7
96;28.04.2015;2015;04;23;Tiistai;12;3;15;1;0;1
96;29.04.2015;2015;04;00;Keskiviikko;10;2;12;0;1;1
96;29.04.2015;2015;04;01;Keskiviikko;4;2;6;1;0;1
96;29.04.2015;2015;04;02;Keskiviikko;10;2;12;1;0;1
96;29.04.2015;2015;04;03;Keskiviikko;13;1;14;0;1;1
96;29.04.2015;2015;04;04;Keskiviikko;1;1;2;0;0;0
96;29.04.2015;2015;04;05;Keskiviikko;8;10;18;0;0;0
96;29.04.2015;2015;04;06;Keskiviikko;53;50;103;8;2;10
96;29.04.2015;2015;04;07;Keskiviikko;137;119;256;23;10;33
96;29.04.2015;2015;04;08;Keskiviikko;70;105;175;13;10;23
96;29.04.2015;2015;04;09;Keskiviikko;63;91;154;14;11;25
96;29.04.2015;2015;04;10;Keskiviikko;53;61;114;8;5;13
96;29.04.2015;2015;04;11;Keskiviikko;83;63;146;13;8;21
96;29.04.2015;2015;04;12;Keskiviikko;80;88;168;7;18;25
96;29.04.2015;2015;04;13;Keskiviikko;55;99;154;2;15;17
96;29.04.2015;2015;04;14;Keskiviikko;98;160;258;9;19;28
96;29.04.2015;2015;04;15;Keskiviikko;101;200;301;3;26;29
96;29.04.2015;2015;04;16;Keskiviikko;95;148;243;8;18;26
96;29.04.2015;2015;04;17;Keskiviikko;72;83;155;7;9;16
96;29.04.2015;2015;04;18;Keskiviikko;68;50;118;26;28;54
96;29.04.2015;2015;04;19;Keskiviikko;60;35;95;11;16;27
96;29.04.2015;2015;04;20;Keskiviikko;59;46;105;8;8;16
96;29.04.2015;2015;04;21;Keskiviikko;30;51;81;3;11;14
96;29.04.2015;2015;04;22;Keskiviikko;17;23;40;1;1;2
96;29.04.2015;2015;04;23;Keskiviikko;7;7;14;2;1;3
96;30.04.2015;2015;04;00;Torstai;6;1;7;1;1;2
96;30.04.2015;2015;04;01;Torstai;3;7;10;0;0;0
96;30.04.2015;2015;04;02;Torstai;9;1;10;0;0;0
96;30.04.2015;2015;04;03;Torstai;13;1;14;1;1;2
96;30.04.2015;2015;04;04;Torstai;3;1;4;0;0;0
96;30.04.2015;2015;04;05;Torstai;10;10;20;1;0;1
96;30.04.2015;2015;04;06;Torstai;58;42;100;4;3;7
96;30.04.2015;2015;04;07;Torstai;113;105;218;20;7;27
96;30.04.2015;2015;04;08;Torstai;80;114;194;6;8;14
96;30.04.2015;2015;04;09;Torstai;60;63;123;6;7;13
96;30.04.2015;2015;04;10;Torstai;50;68;118;10;7;17
96;30.04.2015;2015;04;11;Torstai;75;82;157;7;12;19
96;30.04.2015;2015;04;12;Torstai;58;76;134;8;7;15
96;30.04.2015;2015;04;13;Torstai;82;91;173;6;8;14
96;30.04.2015;2015;04;14;Torstai;100;163;263;7;15;22
96;30.04.2015;2015;04;15;Torstai;108;147;255;5;20;25
96;30.04.2015;2015;04;16;Torstai;93;121;214;7;10;17
96;30.04.2015;2015;04;17;Torstai;68;54;122;4;6;10
96;30.04.2015;2015;04;18;Torstai;46;53;99;10;4;14
96;30.04.2015;2015;04;19;Torstai;25;39;64;2;12;14
96;30.04.2015;2015;04;20;Torstai;32;50;82;5;4;9
96;30.04.2015;2015;04;21;Torstai;27;44;71;0;2;2
96;30.04.2015;2015;04;22;Torstai;18;24;42;4;1;5
96;30.04.2015;2015;04;23;Torstai;30;9;39;2;5;7
96;01.05.2015;2015;05;00;Perjantai;26;20;46;1;0;1
96;01.05.2015;2015;05;01;Perjantai;30;5;35;9;2;11
96;01.05.2015;2015;05;02;Perjantai;29;12;41;5;1;6
96;01.05.2015;2015;05;03;Perjantai;38;3;41;8;2;10
96;01.05.2015;2015;05;04;Perjantai;21;5;26;6;0;6
96;01.05.2015;2015;05;05;Perjantai;11;4;15;1;0;1
96;01.05.2015;2015;05;06;Perjantai;18;8;26;4;3;7
96;01.05.2015;2015;05;07;Perjantai;3;10;13;3;5;8
96;01.05.2015;2015;05;08;Perjantai;5;7;12;0;1;1
96;01.05.2015;2015;05;09;Perjantai;6;11;17;2;5;7
96;01.05.2015;2015;05;10;Perjantai;10;28;38;3;5;8
96;01.05.2015;2015;05;11;Perjantai;18;72;90;9;8;17
96;01.05.2015;2015;05;12;Perjantai;28;77;105;8;7;15
96;01.05.2015;2015;05;13;Perjantai;63;53;116;8;12;20
96;01.05.2015;2015;05;14;Perjantai;47;39;86;5;15;20
96;01.05.2015;2015;05;15;Perjantai;45;33;78;6;6;12
96;01.05.2015;2015;05;16;Perjantai;30;12;42;2;2;4
96;01.05.2015;2015;05;17;Perjantai;19;19;38;7;2;9
96;01.05.2015;2015;05;18;Perjantai;16;18;34;4;4;8
96;01.05.2015;2015;05;19;Perjantai;17;13;30;6;3;9
96;01.05.2015;2015;05;20;Perjantai;16;13;29;6;4;10
96;01.05.2015;2015;05;21;Perjantai;12;19;31;2;7;9
96;01.05.2015;2015;05;22;Perjantai;12;13;25;1;2;3
96;01.05.2015;2015;05;23;Perjantai;5;5;10;0;0;0
96;02.05.2015;2015;05;00;Lauantai;2;3;5;1;0;1
96;02.05.2015;2015;05;01;Lauantai;2;5;7;0;2;2
96;02.05.2015;2015;05;02;Lauantai;8;0;8;4;0;4
96;02.05.2015;2015;05;03;Lauantai;8;0;8;0;1;1
96;02.05.2015;2015;05;04;Lauantai;6;1;7;2;1;3
96;02.05.2015;2015;05;05;Lauantai;1;2;3;0;0;0
96;02.05.2015;2015;05;06;Lauantai;23;7;30;2;2;4
96;02.05.2015;2015;05;07;Lauantai;6;7;13;2;6;8
96;02.05.2015;2015;05;08;Lauantai;4;15;19;4;5;9
96;02.05.2015;2015;05;09;Lauantai;22;52;74;10;11;21
96;02.05.2015;2015;05;10;Lauantai;23;57;80;5;5;10
96;02.05.2015;2015;05;11;Lauantai;50;60;110;11;14;25
96;02.05.2015;2015;05;12;Lauantai;45;59;104;6;8;14
96;02.05.2015;2015;05;13;Lauantai;63;58;121;11;8;19
96;02.05.2015;2015;05;14;Lauantai;55;69;124;6;6;12
96;02.05.2015;2015;05;15;Lauantai;44;62;106;7;10;17
96;02.05.2015;2015;05;16;Lauantai;42;33;75;4;10;14
96;02.05.2015;2015;05;17;Lauantai;41;28;69;20;6;26
96;02.05.2015;2015;05;18;Lauantai;51;24;75;9;8;17
96;02.05.2015;2015;05;19;Lauantai;18;42;60;9;13;22
96;02.05.2015;2015;05;20;Lauantai;16;17;33;6;6;12
96;02.05.2015;2015;05;21;Lauantai;12;22;34;1;8;9
96;02.05.2015;2015;05;22;Lauantai;19;10;29;0;2;2
96;02.05.2015;2015;05;23;Lauantai;9;1;10;1;1;2
96;03.05.2015;2015;05;00;Sunnuntai;7;2;9;0;0;0
96;03.05.2015;2015;05;01;Sunnuntai;7;0;7;0;0;0
96;03.05.2015;2015;05;02;Sunnuntai;4;0;4;0;1;1
96;03.05.2015;2015;05;03;Sunnuntai;4;0;4;0;0;0
96;03.05.2015;2015;05;04;Sunnuntai;3;0;3;1;0;1
96;03.05.2015;2015;05;05;Sunnuntai;0;1;1;0;0;0
96;03.05.2015;2015;05;06;Sunnuntai;11;5;16;1;0;1
96;03.05.2015;2015;05;07;Sunnuntai;4;8;12;0;2;2
96;03.05.2015;2015;05;08;Sunnuntai;4;8;12;2;2;4
96;03.05.2015;2015;05;09;Sunnuntai;7;9;16;2;3;5
96;03.05.2015;2015;05;10;Sunnuntai;10;8;18;5;7;12
96;03.05.2015;2015;05;11;Sunnuntai;20;22;42;7;9;16
96;03.05.2015;2015;05;12;Sunnuntai;32;27;59;15;13;28
96;03.05.2015;2015;05;13;Sunnuntai;42;39;81;9;10;19
96;03.05.2015;2015;05;14;Sunnuntai;34;41;75;4;6;10
96;03.05.2015;2015;05;15;Sunnuntai;27;41;68;13;13;26
96;03.05.2015;2015;05;16;Sunnuntai;54;35;89;18;10;28
96;03.05.2015;2015;05;17;Sunnuntai;40;19;59;9;6;15
96;03.05.2015;2015;05;18;Sunnuntai;21;37;58;22;15;37
96;03.05.2015;2015;05;19;Sunnuntai;16;21;37;11;12;23
96;03.05.2015;2015;05;20;Sunnuntai;25;28;53;1;11;12
96;03.05.2015;2015;05;21;Sunnuntai;14;28;42;6;2;8
96;03.05.2015;2015;05;22;Sunnuntai;11;5;16;4;4;8
96;03.05.2015;2015;05;23;Sunnuntai;7;2;9;1;0;1
96;04.05.2015;2015;05;00;Maanantai;2;1;3;0;1;1
96;04.05.2015;2015;05;01;Maanantai;0;4;4;0;0;0
96;04.05.2015;2015;05;02;Maanantai;2;0;2;0;1;1
96;04.05.2015;2015;05;03;Maanantai;3;2;5;0;0;0
96;04.05.2015;2015;05;04;Maanantai;0;5;5;0;0;0
96;04.05.2015;2015;05;05;Maanantai;8;13;21;0;2;2
96;04.05.2015;2015;05;06;Maanantai;59;36;95;9;2;11
96;04.05.2015;2015;05;07;Maanantai;138;120;258;16;5;21
96;04.05.2015;2015;05;08;Maanantai;107;123;230;18;5;23
96;04.05.2015;2015;05;09;Maanantai;53;105;158;14;6;20
96;04.05.2015;2015;05;10;Maanantai;62;68;130;11;9;20
96;04.05.2015;2015;05;11;Maanantai;76;74;150;17;7;24
96;04.05.2015;2015;05;12;Maanantai;81;77;158;15;16;31
96;04.05.2015;2015;05;13;Maanantai;92;99;191;8;11;19
96;04.05.2015;2015;05;14;Maanantai;99;155;254;8;13;21
96;04.05.2015;2015;05;15;Maanantai;105;241;346;4;23;27
96;04.05.2015;2015;05;16;Maanantai;138;203;341;8;16;24
96;04.05.2015;2015;05;17;Maanantai;108;78;186;22;12;34
96;04.05.2015;2015;05;18;Maanantai;80;63;143;23;30;53
96;04.05.2015;2015;05;19;Maanantai;74;58;132;13;21;34
96;04.05.2015;2015;05;20;Maanantai;78;57;135;11;17;28
96;04.05.2015;2015;05;21;Maanantai;24;61;85;6;9;15
96;04.05.2015;2015;05;22;Maanantai;14;7;21;1;1;2
96;04.05.2015;2015;05;23;Maanantai;9;4;13;2;0;2
96;05.05.2015;2015;05;00;Tiistai;3;3;6;0;2;2
96;05.05.2015;2015;05;01;Tiistai;2;2;4;1;0;1
96;05.05.2015;2015;05;02;Tiistai;3;1;4;2;0;2
96;05.05.2015;2015;05;03;Tiistai;3;0;3;0;1;1
96;05.05.2015;2015;05;04;Tiistai;2;4;6;0;0;0
96;05.05.2015;2015;05;05;Tiistai;6;17;23;0;0;0
96;05.05.2015;2015;05;06;Tiistai;66;46;112;10;4;14
96;05.05.2015;2015;05;07;Tiistai;149;146;295;25;6;31
96;05.05.2015;2015;05;08;Tiistai;119;115;234;8;11;19
96;05.05.2015;2015;05;09;Tiistai;74;81;155;12;4;16
96;05.05.2015;2015;05;10;Tiistai;63;87;150;8;6;14
96;05.05.2015;2015;05;11;Tiistai;79;64;143;8;13;21
96;05.05.2015;2015;05;12;Tiistai;89;85;174;11;19;30
96;05.05.2015;2015;05;13;Tiistai;67;75;142;16;9;25
96;05.05.2015;2015;05;14;Tiistai;98;172;270;10;15;25
96;05.05.2015;2015;05;15;Tiistai;106;245;351;7;24;31
96;05.05.2015;2015;05;16;Tiistai;117;174;291;10;26;36
96;05.05.2015;2015;05;17;Tiistai;82;85;167;12;15;27
96;05.05.2015;2015;05;18;Tiistai;69;78;147;18;16;34
96;05.05.2015;2015;05;19;Tiistai;71;52;123;7;10;17
96;05.05.2015;2015;05;20;Tiistai;55;48;103;10;16;26
96;05.05.2015;2015;05;21;Tiistai;34;46;80;4;5;9
96;05.05.2015;2015;05;22;Tiistai;11;7;18;0;4;4
96;05.05.2015;2015;05;23;Tiistai;6;6;12;1;1;2
96;06.05.2015;2015;05;00;Keskiviikko;1;1;2;0;0;0
96;06.05.2015;2015;05;01;Keskiviikko;0;1;1;1;0;1
96;06.05.2015;2015;05;02;Keskiviikko;2;1;3;0;0;0
96;06.05.2015;2015;05;03;Keskiviikko;0;3;3;0;0;0
96;06.05.2015;2015;05;04;Keskiviikko;2;1;3;1;0;1
96;06.05.2015;2015;05;05;Keskiviikko;10;10;20;1;0;1
96;06.05.2015;2015;05;06;Keskiviikko;57;44;101;5;2;7
96;06.05.2015;2015;05;07;Keskiviikko;137;146;283;12;7;19
96;06.05.2015;2015;05;08;Keskiviikko;115;107;222;18;6;24
96;06.05.2015;2015;05;09;Keskiviikko;77;90;167;14;9;23
96;06.05.2015;2015;05;10;Keskiviikko;54;67;121;9;10;19
96;06.05.2015;2015;05;11;Keskiviikko;59;78;137;11;8;19
96;06.05.2015;2015;05;12;Keskiviikko;85;97;182;8;10;18
96;06.05.2015;2015;05;13;Keskiviikko;100;108;208;7;15;22
96;06.05.2015;2015;05;14;Keskiviikko;97;141;238;3;14;17
96;06.05.2015;2015;05;15;Keskiviikko;113;231;344;4;19;23
96;06.05.2015;2015;05;16;Keskiviikko;125;179;304;7;9;16
96;06.05.2015;2015;05;17;Keskiviikko;90;92;182;6;13;19
96;06.05.2015;2015;05;18;Keskiviikko;85;84;169;8;11;19
96;06.05.2015;2015;05;19;Keskiviikko;74;46;120;17;12;29
96;06.05.2015;2015;05;20;Keskiviikko;54;50;104;8;12;20
96;06.05.2015;2015;05;21;Keskiviikko;26;38;64;1;6;7
96;06.05.2015;2015;05;22;Keskiviikko;11;9;20;4;2;6
96;06.05.2015;2015;05;23;Keskiviikko;3;9;12;0;2;2
96;07.05.2015;2015;05;00;Torstai;1;2;3;0;1;1
96;07.05.2015;2015;05;01;Torstai;1;3;4;1;2;3
96;07.05.2015;2015;05;02;Torstai;1;0;1;1;0;1
96;07.05.2015;2015;05;03;Torstai;4;0;4;1;0;1
96;07.05.2015;2015;05;04;Torstai;2;2;4;1;1;2
96;07.05.2015;2015;05;05;Torstai;9;9;18;1;1;2
96;07.05.2015;2015;05;06;Torstai;59;46;105;6;0;6
96;07.05.2015;2015;05;07;Torstai;133;136;269;22;12;34
96;07.05.2015;2015;05;08;Torstai;116;121;237;12;7;19
96;07.05.2015;2015;05;09;Torstai;89;88;177;11;6;17
96;07.05.2015;2015;05;10;Torstai;78;110;188;12;13;25
96;07.05.2015;2015;05;11;Torstai;66;80;146;6;15;21
96;07.05.2015;2015;05;12;Torstai;65;95;160;12;11;23
96;07.05.2015;2015;05;13;Torstai;82;91;173;5;12;17
96;07.05.2015;2015;05;14;Torstai;105;156;261;8;20;28
96;07.05.2015;2015;05;15;Torstai;105;226;331;8;35;43
96;07.05.2015;2015;05;16;Torstai;123;156;279;10;22;32
96;07.05.2015;2015;05;17;Torstai;96;92;188;13;10;23
96;07.05.2015;2015;05;18;Torstai;86;64;150;24;29;53
96;07.05.2015;2015;05;19;Torstai;76;54;130;14;18;32
96;07.05.2015;2015;05;20;Torstai;69;52;121;11;3;14
96;07.05.2015;2015;05;21;Torstai;35;28;63;5;9;14
96;07.05.2015;2015;05;22;Torstai;12;9;21;1;3;4
96;07.05.2015;2015;05;23;Torstai;9;4;13;1;1;2
96;08.05.2015;2015;05;00;Perjantai;1;4;5;0;1;1
96;08.05.2015;2015;05;01;Perjantai;3;0;3;1;0;1
96;08.05.2015;2015;05;02;Perjantai;2;0;2;0;0;0
96;08.05.2015;2015;05;03;Perjantai;2;0;2;0;0;0
96;08.05.2015;2015;05;04;Perjantai;4;4;8;0;2;2
96;08.05.2015;2015;05;05;Perjantai;5;9;14;2;1;3
96;08.05.2015;2015;05;06;Perjantai;52;52;104;8;2;10
96;08.05.2015;2015;05;07;Perjantai;134;127;261;11;7;18
96;08.05.2015;2015;05;08;Perjantai;99;117;216;12;11;23
96;08.05.2015;2015;05;09;Perjantai;56;65;121;8;11;19
96;08.05.2015;2015;05;10;Perjantai;47;50;97;5;6;11
96;08.05.2015;2015;05;11;Perjantai;51;68;119;2;14;16
96;08.05.2015;2015;05;12;Perjantai;45;88;133;2;9;11
96;08.05.2015;2015;05;13;Perjantai;65;90;155;8;18;26
96;08.05.2015;2015;05;14;Perjantai;80;182;262;9;20;29
96;08.05.2015;2015;05;15;Perjantai;95;168;263;4;15;19
96;08.05.2015;2015;05;16;Perjantai;88;102;190;8;20;28
96;08.05.2015;2015;05;17;Perjantai;62;77;139;5;18;23
96;08.05.2015;2015;05;18;Perjantai;68;47;115;7;8;15
96;08.05.2015;2015;05;19;Perjantai;61;45;106;8;10;18
96;08.05.2015;2015;05;20;Perjantai;42;36;78;4;7;11
96;08.05.2015;2015;05;21;Perjantai;20;29;49;3;2;5
96;08.05.2015;2015;05;22;Perjantai;18;7;25;1;2;3
96;08.05.2015;2015;05;23;Perjantai;9;4;13;1;2;3
96;09.05.2015;2015;05;00;Lauantai;4;4;8;0;0;0
96;09.05.2015;2015;05;01;Lauantai;9;0;9;0;2;2
96;09.05.2015;2015;05;02;Lauantai;10;2;12;1;0;1
96;09.05.2015;2015;05;03;Lauantai;8;4;12;1;0;1
96;09.05.2015;2015;05;04;Lauantai;8;1;9;4;0;4
96;09.05.2015;2015;05;05;Lauantai;5;2;7;1;0;1
96;09.05.2015;2015;05;06;Lauantai;19;8;27;1;1;2
96;09.05.2015;2015;05;07;Lauantai;7;16;23;3;6;9
96;09.05.2015;2015;05;08;Lauantai;4;32;36;2;4;6
96;09.05.2015;2015;05;09;Lauantai;23;37;60;5;8;13
96;09.05.2015;2015;05;10;Lauantai;18;27;45;3;4;7
96;09.05.2015;2015;05;11;Lauantai;25;36;61;5;9;14
96;09.05.2015;2015;05;12;Lauantai;52;29;81;9;6;15
96;09.05.2015;2015;05;13;Lauantai;39;30;69;3;4;7
96;09.05.2015;2015;05;14;Lauantai;34;66;100;3;7;10
96;09.05.2015;2015;05;15;Lauantai;38;43;81;5;10;15
96;09.05.2015;2015;05;16;Lauantai;24;26;50;8;4;12
96;09.05.2015;2015;05;17;Lauantai;38;9;47;3;0;3
96;09.05.2015;2015;05;18;Lauantai;23;18;41;3;2;5
96;09.05.2015;2015;05;19;Lauantai;15;17;32;5;5;10
96;09.05.2015;2015;05;20;Lauantai;19;13;32;4;5;9
96;09.05.2015;2015;05;21;Lauantai;8;28;36;2;6;8
96;09.05.2015;2015;05;22;Lauantai;6;12;18;4;2;6
96;09.05.2015;2015;05;23;Lauantai;16;8;24;2;1;3
96;10.05.2015;2015;05;00;Sunnuntai;6;4;10;1;1;2
96;10.05.2015;2015;05;01;Sunnuntai;8;2;10;1;0;1
96;10.05.2015;2015;05;02;Sunnuntai;4;1;5;0;1;1
96;10.05.2015;2015;05;03;Sunnuntai;4;0;4;0;1;1
96;10.05.2015;2015;05;04;Sunnuntai;5;1;6;3;1;4
96;10.05.2015;2015;05;05;Sunnuntai;4;0;4;0;0;0
96;10.05.2015;2015;05;06;Sunnuntai;14;9;23;2;2;4
96;10.05.2015;2015;05;07;Sunnuntai;3;15;18;1;3;4
96;10.05.2015;2015;05;08;Sunnuntai;2;10;12;2;5;7
96;10.05.2015;2015;05;09;Sunnuntai;23;19;42;7;4;11
96;10.05.2015;2015;05;10;Sunnuntai;30;27;57;16;5;21
96;10.05.2015;2015;05;11;Sunnuntai;39;42;81;14;14;28
96;10.05.2015;2015;05;12;Sunnuntai;51;50;101;14;10;24
96;10.05.2015;2015;05;13;Sunnuntai;57;52;109;5;8;13
96;10.05.2015;2015;05;14;Sunnuntai;57;59;116;7;8;15
96;10.05.2015;2015;05;15;Sunnuntai;32;58;90;8;4;12
96;10.05.2015;2015;05;16;Sunnuntai;73;45;118;13;5;18
96;10.05.2015;2015;05;17;Sunnuntai;47;42;89;9;7;16
96;10.05.2015;2015;05;18;Sunnuntai;65;63;128;15;6;21
96;10.05.2015;2015;05;19;Sunnuntai;36;49;85;13;10;23
96;10.05.2015;2015;05;20;Sunnuntai;46;42;88;11;11;22
96;10.05.2015;2015;05;21;Sunnuntai;24;34;58;5;6;11
96;10.05.2015;2015;05;22;Sunnuntai;9;14;23;2;3;5
96;10.05.2015;2015;05;23;Sunnuntai;4;6;10;0;2;2
96;11.05.2015;2015;05;00;Maanantai;4;1;5;1;1;2
96;11.05.2015;2015;05;01;Maanantai;2;0;2;2;3;5
96;11.05.2015;2015;05;02;Maanantai;3;0;3;0;0;0
96;11.05.2015;2015;05;03;Maanantai;2;2;4;0;0;0
96;11.05.2015;2015;05;04;Maanantai;0;1;1;0;0;0
96;11.05.2015;2015;05;05;Maanantai;7;15;22;0;2;2
96;11.05.2015;2015;05;06;Maanantai;43;31;74;5;4;9
96;11.05.2015;2015;05;07;Maanantai;144;115;259;15;6;21
96;11.05.2015;2015;05;08;Maanantai;91;116;207;14;6;20
96;11.05.2015;2015;05;09;Maanantai;61;95;156;14;5;19
96;11.05.2015;2015;05;10;Maanantai;48;58;106;12;7;19
96;11.05.2015;2015;05;11;Maanantai;74;85;159;15;7;22
96;11.05.2015;2015;05;12;Maanantai;81;84;165;11;14;25
96;11.05.2015;2015;05;13;Maanantai;84;94;178;7;15;22
96;11.05.2015;2015;05;14;Maanantai;111;137;248;17;21;38
96;11.05.2015;2015;05;15;Maanantai;91;206;297;9;27;36
96;11.05.2015;2015;05;16;Maanantai;150;181;331;16;28;44
96;11.05.2015;2015;05;17;Maanantai;97;74;171;17;21;38
96;11.05.2015;2015;05;18;Maanantai;85;46;131;13;18;31
96;11.05.2015;2015;05;19;Maanantai;75;46;121;16;14;30
96;11.05.2015;2015;05;20;Maanantai;92;65;157;16;14;30
96;11.05.2015;2015;05;21;Maanantai;29;38;67;3;8;11
96;11.05.2015;2015;05;22;Maanantai;8;24;32;1;1;2
96;11.05.2015;2015;05;23;Maanantai;3;4;7;0;1;1
96;12.05.2015;2015;05;00;Tiistai;3;2;5;3;1;4
96;12.05.2015;2015;05;01;Tiistai;1;1;2;0;1;1
96;12.05.2015;2015;05;02;Tiistai;0;1;1;0;0;0
96;12.05.2015;2015;05;03;Tiistai;2;0;2;0;0;0
96;12.05.2015;2015;05;04;Tiistai;1;1;2;1;0;1
96;12.05.2015;2015;05;05;Tiistai;6;7;13;0;2;2
96;12.05.2015;2015;05;06;Tiistai;55;39;94;7;1;8
96;12.05.2015;2015;05;07;Tiistai;125;99;224;19;5;24
96;12.05.2015;2015;05;08;Tiistai;77;77;154;17;8;25
96;12.05.2015;2015;05;09;Tiistai;55;67;122;15;5;20
96;12.05.2015;2015;05;10;Tiistai;39;44;83;8;7;15
96;12.05.2015;2015;05;11;Tiistai;44;52;96;10;6;16
96;12.05.2015;2015;05;12;Tiistai;60;56;116;4;7;11
96;12.05.2015;2015;05;13;Tiistai;46;67;113;3;15;18
96;12.05.2015;2015;05;14;Tiistai;66;106;172;11;15;26
96;12.05.2015;2015;05;15;Tiistai;71;165;236;6;19;25
96;12.05.2015;2015;05;16;Tiistai;83;143;226;6;13;19
96;12.05.2015;2015;05;17;Tiistai;52;58;110;11;8;19
96;12.05.2015;2015;05;18;Tiistai;68;44;112;20;18;38
96;12.05.2015;2015;05;19;Tiistai;40;27;67;15;12;27
96;12.05.2015;2015;05;20;Tiistai;62;32;94;6;10;16
96;12.05.2015;2015;05;21;Tiistai;20;32;52;6;8;14
96;12.05.2015;2015;05;22;Tiistai;7;8;15;1;3;4
96;12.05.2015;2015;05;23;Tiistai;6;7;13;1;0;1
96;13.05.2015;2015;05;00;Keskiviikko;2;10;12;1;0;1
96;13.05.2015;2015;05;01;Keskiviikko;2;1;3;0;1;1
96;13.05.2015;2015;05;02;Keskiviikko;1;1;2;0;0;0
96;13.05.2015;2015;05;03;Keskiviikko;7;0;7;0;0;0
96;13.05.2015;2015;05;04;Keskiviikko;0;0;0;1;0;1
96;13.05.2015;2015;05;05;Keskiviikko;6;11;17;0;0;0
96;13.05.2015;2015;05;06;Keskiviikko;49;40;89;7;2;9
96;13.05.2015;2015;05;07;Keskiviikko;118;132;250;15;8;23
96;13.05.2015;2015;05;08;Keskiviikko;100;101;201;11;9;20
96;13.05.2015;2015;05;09;Keskiviikko;64;56;120;16;3;19
96;13.05.2015;2015;05;10;Keskiviikko;51;52;103;8;2;10
96;13.05.2015;2015;05;11;Keskiviikko;47;40;87;9;11;20
96;13.05.2015;2015;05;12;Keskiviikko;49;56;105;4;5;9
96;13.05.2015;2015;05;13;Keskiviikko;50;57;107;4;12;16
96;13.05.2015;2015;05;14;Keskiviikko;68;122;190;2;12;14
96;13.05.2015;2015;05;15;Keskiviikko;62;143;205;4;14;18
96;13.05.2015;2015;05;16;Keskiviikko;60;105;165;1;9;10
96;13.05.2015;2015;05;17;Keskiviikko;49;36;85;2;6;8
96;13.05.2015;2015;05;18;Keskiviikko;46;21;67;7;3;10
96;13.05.2015;2015;05;19;Keskiviikko;30;24;54;3;5;8
96;13.05.2015;2015;05;20;Keskiviikko;23;21;44;7;7;14
96;13.05.2015;2015;05;21;Keskiviikko;14;37;51;1;5;6
96;13.05.2015;2015;05;22;Keskiviikko;7;9;16;4;3;7
96;13.05.2015;2015;05;23;Keskiviikko;2;8;10;2;2;4
96;14.05.2015;2015;05;00;Torstai;5;2;7;3;1;4
96;14.05.2015;2015;05;01;Torstai;5;2;7;1;1;2
96;14.05.2015;2015;05;02;Torstai;1;1;2;0;0;0
96;14.05.2015;2015;05;03;Torstai;3;3;6;1;0;1
96;14.05.2015;2015;05;04;Torstai;1;1;2;0;1;1
96;14.05.2015;2015;05;05;Torstai;3;2;5;0;0;0
96;14.05.2015;2015;05;06;Torstai;18;18;36;1;1;2
96;14.05.2015;2015;05;07;Torstai;8;11;19;0;2;2
96;14.05.2015;2015;05;08;Torstai;4;19;23;3;2;5
96;14.05.2015;2015;05;09;Torstai;15;34;49;11;128;139
96;14.05.2015;2015;05;10;Torstai;13;39;52;17;163;180
96;14.05.2015;2015;05;11;Torstai;11;36;47;40;273;313
96;14.05.2015;2015;05;12;Torstai;31;33;64;77;60;137
96;14.05.2015;2015;05;13;Torstai;50;46;96;135;59;194
96;14.05.2015;2015;05;14;Torstai;40;46;86;122;17;139
96;14.05.2015;2015;05;15;Torstai;68;56;124;154;33;187
96;14.05.2015;2015;05;16;Torstai;43;24;67;92;4;96
96;14.05.2015;2015;05;17;Torstai;56;21;77;89;13;102
96;14.05.2015;2015;05;18;Torstai;30;36;66;29;10;39
96;14.05.2015;2015;05;19;Torstai;12;21;33;5;12;17
96;14.05.2015;2015;05;20;Torstai;22;22;44;8;8;16
96;14.05.2015;2015;05;21;Torstai;12;22;34;1;3;4
96;14.05.2015;2015;05;22;Torstai;6;4;10;2;1;3
96;14.05.2015;2015;05;23;Torstai;5;10;15;0;0;0
96;15.05.2015;2015;05;00;Perjantai;1;3;4;0;2;2
96;15.05.2015;2015;05;01;Perjantai;2;4;6;0;1;1
96;15.05.2015;2015;05;02;Perjantai;4;0;4;0;0;0
96;15.05.2015;2015;05;03;Perjantai;1;2;3;0;1;1
96;15.05.2015;2015;05;04;Perjantai;1;3;4;1;0;1
96;15.05.2015;2015;05;05;Perjantai;8;8;16;0;0;0
96;15.05.2015;2015;05;06;Perjantai;43;21;64;3;1;4
96;15.05.2015;2015;05;07;Perjantai;68;50;118;6;6;12
96;15.05.2015;2015;05;08;Perjantai;42;60;102;5;3;8
96;15.05.2015;2015;05;09;Perjantai;19;52;71;7;102;109
96;15.05.2015;2015;05;10;Perjantai;30;64;94;11;309;320
96;15.05.2015;2015;05;11;Perjantai;30;60;90;47;169;216
96;15.05.2015;2015;05;12;Perjantai;39;53;92;96;133;229
96;15.05.2015;2015;05;13;Perjantai;55;55;110;144;101;245
96;15.05.2015;2015;05;14;Perjantai;70;93;163;156;81;237
96;15.05.2015;2015;05;15;Perjantai;59;90;149;138;49;187
96;15.05.2015;2015;05;16;Perjantai;53;65;118;119;22;141
96;15.05.2015;2015;05;17;Perjantai;44;37;81;123;14;137
96;15.05.2015;2015;05;18;Perjantai;47;30;77;35;8;43
96;15.05.2015;2015;05;19;Perjantai;30;30;60;7;2;9
96;15.05.2015;2015;05;20;Perjantai;40;35;75;4;10;14
96;15.05.2015;2015;05;21;Perjantai;20;30;50;3;2;5
96;15.05.2015;2015;05;22;Perjantai;2;9;11;1;1;2
96;15.05.2015;2015;05;23;Perjantai;6;10;16;1;3;4
96;16.05.2015;2015;05;00;Lauantai;8;4;12;1;2;3
96;16.05.2015;2015;05;01;Lauantai;9;1;10;1;0;1
96;16.05.2015;2015;05;02;Lauantai;3;1;4;0;1;1
96;16.05.2015;2015;05;03;Lauantai;10;2;12;0;2;2
96;16.05.2015;2015;05;04;Lauantai;4;4;8;2;1;3
96;16.05.2015;2015;05;05;Lauantai;6;3;9;0;1;1
96;16.05.2015;2015;05;06;Lauantai;17;9;26;2;2;4
96;16.05.2015;2015;05;07;Lauantai;8;17;25;2;4;6
96;16.05.2015;2015;05;08;Lauantai;9;25;34;5;6;11
96;16.05.2015;2015;05;09;Lauantai;16;55;71;16;152;168
96;16.05.2015;2015;05;10;Lauantai;24;98;122;41;512;553
96;16.05.2015;2015;05;11;Lauantai;35;105;140;43;246;289
96;16.05.2015;2015;05;12;Lauantai;75;95;170;146;252;398
96;16.05.2015;2015;05;13;Lauantai;82;93;175;236;233;469
96;16.05.2015;2015;05;14;Lauantai;97;87;184;293;115;408
96;16.05.2015;2015;05;15;Lauantai;98;51;149;298;64;362
96;16.05.2015;2015;05;16;Lauantai;83;37;120;216;21;237
96;16.05.2015;2015;05;17;Lauantai;67;50;117;148;14;162
96;16.05.2015;2015;05;18;Lauantai;44;46;90;53;8;61
96;16.05.2015;2015;05;19;Lauantai;23;39;62;13;4;17
96;16.05.2015;2015;05;20;Lauantai;20;35;55;9;12;21
96;16.05.2015;2015;05;21;Lauantai;23;39;62;4;5;9
96;16.05.2015;2015;05;22;Lauantai;7;14;21;0;1;1
96;16.05.2015;2015;05;23;Lauantai;14;13;27;1;4;5
96;17.05.2015;2015;05;00;Sunnuntai;13;12;25;1;0;1
96;17.05.2015;2015;05;01;Sunnuntai;18;9;27;1;1;2
96;17.05.2015;2015;05;02;Sunnuntai;5;5;10;1;0;1
96;17.05.2015;2015;05;03;Sunnuntai;21;2;23;5;1;6
96;17.05.2015;2015;05;04;Sunnuntai;8;3;11;1;1;2
96;17.05.2015;2015;05;05;Sunnuntai;11;1;12;1;1;2
96;17.05.2015;2015;05;06;Sunnuntai;20;9;29;2;0;2
96;17.05.2015;2015;05;07;Sunnuntai;2;19;21;3;6;9
96;17.05.2015;2015;05;08;Sunnuntai;5;13;18;3;7;10
96;17.05.2015;2015;05;09;Sunnuntai;7;23;30;6;98;104
96;17.05.2015;2015;05;10;Sunnuntai;14;50;64;21;339;360
96;17.05.2015;2015;05;11;Sunnuntai;19;64;83;36;221;257
96;17.05.2015;2015;05;12;Sunnuntai;50;84;134;106;155;261
96;17.05.2015;2015;05;13;Sunnuntai;66;64;130;163;76;239
96;17.05.2015;2015;05;14;Sunnuntai;65;55;120;164;36;200
96;17.05.2015;2015;05;15;Sunnuntai;64;43;107;131;14;145
96;17.05.2015;2015;05;16;Sunnuntai;73;26;99;142;9;151
96;17.05.2015;2015;05;17;Sunnuntai;42;31;73;35;12;47
96;17.05.2015;2015;05;18;Sunnuntai;35;35;70;11;15;26
96;17.05.2015;2015;05;19;Sunnuntai;28;36;64;11;13;24
96;17.05.2015;2015;05;20;Sunnuntai;31;31;62;14;7;21
96;17.05.2015;2015;05;21;Sunnuntai;15;34;49;4;4;8
96;17.05.2015;2015;05;22;Sunnuntai;12;10;22;4;0;4
96;17.05.2015;2015;05;23;Sunnuntai;4;8;12;0;3;3
96;18.05.2015;2015;05;00;Maanantai;4;5;9;0;1;1
96;18.05.2015;2015;05;01;Maanantai;2;1;3;1;0;1
96;18.05.2015;2015;05;02;Maanantai;0;0;0;1;1;2
96;18.05.2015;2015;05;03;Maanantai;3;0;3;0;0;0
96;18.05.2015;2015;05;04;Maanantai;3;1;4;0;0;0
96;18.05.2015;2015;05;05;Maanantai;6;8;14;0;2;2
96;18.05.2015;2015;05;06;Maanantai;75;46;121;7;2;9
96;18.05.2015;2015;05;07;Maanantai;141;149;290;17;5;22
96;18.05.2015;2015;05;08;Maanantai;100;124;224;17;7;24
96;18.05.2015;2015;05;09;Maanantai;45;80;125;15;11;26
96;18.05.2015;2015;05;10;Maanantai;52;66;118;6;7;13
96;18.05.2015;2015;05;11;Maanantai;76;93;169;7;8;15
96;18.05.2015;2015;05;12;Maanantai;70;86;156;11;13;24
96;18.05.2015;2015;05;13;Maanantai;56;114;170;3;17;20
96;18.05.2015;2015;05;14;Maanantai;86;134;220;7;18;25
96;18.05.2015;2015;05;15;Maanantai;96;232;328;9;16;25
96;18.05.2015;2015;05;16;Maanantai;125;200;325;8;18;26
96;18.05.2015;2015;05;17;Maanantai;94;76;170;9;11;20
96;18.05.2015;2015;05;18;Maanantai;89;61;150;12;17;29
96;18.05.2015;2015;05;19;Maanantai;61;56;117;11;16;27
96;18.05.2015;2015;05;20;Maanantai;44;47;91;8;5;13
96;18.05.2015;2015;05;21;Maanantai;26;27;53;3;1;4
96;18.05.2015;2015;05;22;Maanantai;8;10;18;0;1;1
96;18.05.2015;2015;05;23;Maanantai;1;4;5;3;2;5
96;19.05.2015;2015;05;00;Tiistai;2;2;4;0;2;2
96;19.05.2015;2015;05;01;Tiistai;2;1;3;0;0;0
96;19.05.2015;2015;05;02;Tiistai;1;0;1;0;1;1
96;19.05.2015;2015;05;03;Tiistai;4;1;5;0;0;0
96;19.05.2015;2015;05;04;Tiistai;1;2;3;0;1;1
96;19.05.2015;2015;05;05;Tiistai;8;12;20;0;0;0
96;19.05.2015;2015;05;06;Tiistai;67;36;103;8;3;11
96;19.05.2015;2015;05;07;Tiistai;141;128;269;18;11;29
96;19.05.2015;2015;05;08;Tiistai;79;113;192;10;10;20
96;19.05.2015;2015;05;09;Tiistai;64;69;133;12;12;24
96;19.05.2015;2015;05;10;Tiistai;44;48;92;12;6;18
96;19.05.2015;2015;05;11;Tiistai;67;63;130;11;11;22
96;19.05.2015;2015;05;12;Tiistai;66;74;140;5;5;10
96;19.05.2015;2015;05;13;Tiistai;65;82;147;10;10;20
96;19.05.2015;2015;05;14;Tiistai;70;134;204;5;10;15
96;19.05.2015;2015;05;15;Tiistai;95;219;314;17;28;45
96;19.05.2015;2015;05;16;Tiistai;100;143;243;5;17;22
96;19.05.2015;2015;05;17;Tiistai;74;75;149;12;5;17
96;19.05.2015;2015;05;18;Tiistai;60;53;113;8;14;22
96;19.05.2015;2015;05;19;Tiistai;53;41;94;12;11;23
96;19.05.2015;2015;05;20;Tiistai;58;39;97;7;6;13
96;19.05.2015;2015;05;21;Tiistai;26;32;58;5;1;6
96;19.05.2015;2015;05;22;Tiistai;16;12;28;1;3;4
96;19.05.2015;2015;05;23;Tiistai;6;8;14;1;0;1
96;20.05.2015;2015;05;00;Keskiviikko;6;2;8;0;1;1
96;20.05.2015;2015;05;01;Keskiviikko;2;0;2;0;1;1
96;20.05.2015;2015;05;02;Keskiviikko;3;1;4;0;0;0
96;20.05.2015;2015;05;03;Keskiviikko;1;1;2;0;0;0
96;20.05.2015;2015;05;04;Keskiviikko;2;1;3;0;0;0
96;20.05.2015;2015;05;05;Keskiviikko;7;12;19;0;0;0
96;20.05.2015;2015;05;06;Keskiviikko;53;49;102;6;0;6
96;20.05.2015;2015;05;07;Keskiviikko;121;137;258;15;4;19
96;20.05.2015;2015;05;08;Keskiviikko;85;115;200;15;10;25
96;20.05.2015;2015;05;09;Keskiviikko;67;79;146;9;5;14
96;20.05.2015;2015;05;10;Keskiviikko;36;68;104;10;8;18
96;20.05.2015;2015;05;11;Keskiviikko;57;73;130;10;6;16
96;20.05.2015;2015;05;12;Keskiviikko;62;44;106;4;7;11
96;20.05.2015;2015;05;13;Keskiviikko;66;68;134;4;4;8
96;20.05.2015;2015;05;14;Keskiviikko;85;124;209;3;9;12
96;20.05.2015;2015;05;15;Keskiviikko;72;167;239;4;12;16
96;20.05.2015;2015;05;16;Keskiviikko;107;159;266;10;12;22
96;20.05.2015;2015;05;17;Keskiviikko;58;87;145;13;12;25
96;20.05.2015;2015;05;18;Keskiviikko;61;62;123;11;11;22
96;20.05.2015;2015;05;19;Keskiviikko;70;43;113;14;14;28
96;20.05.2015;2015;05;20;Keskiviikko;62;39;101;10;7;17
96;20.05.2015;2015;05;21;Keskiviikko;25;32;57;2;13;15
96;20.05.2015;2015;05;22;Keskiviikko;12;15;27;0;5;5
96;20.05.2015;2015;05;23;Keskiviikko;2;6;8;2;2;4
96;21.05.2015;2015;05;00;Torstai;6;2;8;2;1;3
96;21.05.2015;2015;05;01;Torstai;4;3;7;0;0;0
96;21.05.2015;2015;05;02;Torstai;1;2;3;0;1;1
96;21.05.2015;2015;05;03;Torstai;6;1;7;0;0;0
96;21.05.2015;2015;05;04;Torstai;4;3;7;2;1;3
96;21.05.2015;2015;05;05;Torstai;7;10;17;3;0;3
96;21.05.2015;2015;05;06;Torstai;64;53;117;4;3;7
96;21.05.2015;2015;05;07;Torstai;133;154;287;19;6;25
96;21.05.2015;2015;05;08;Torstai;87;130;217;11;8;19
96;21.05.2015;2015;05;09;Torstai;50;84;134;6;10;16
96;21.05.2015;2015;05;10;Torstai;43;78;121;15;6;21
96;21.05.2015;2015;05;11;Torstai;61;89;150;13;8;21
96;21.05.2015;2015;05;12;Torstai;88;87;175;11;4;15
96;21.05.2015;2015;05;13;Torstai;89;95;184;9;16;25
96;21.05.2015;2015;05;14;Torstai;100;140;240;8;14;22
96;21.05.2015;2015;05;15;Torstai;130;201;331;12;17;29
96;21.05.2015;2015;05;16;Torstai;114;180;294;13;18;31
96;21.05.2015;2015;05;17;Torstai;109;82;191;20;7;27
96;21.05.2015;2015;05;18;Torstai;94;69;163;21;14;35
96;21.05.2015;2015;05;19;Torstai;88;84;172;16;16;32
96;21.05.2015;2015;05;20;Torstai;86;41;127;10;10;20
96;21.05.2015;2015;05;21;Torstai;38;39;77;7;6;13
96;21.05.2015;2015;05;22;Torstai;16;16;32;0;2;2
96;21.05.2015;2015;05;23;Torstai;4;11;15;1;0;1
96;22.05.2015;2015;05;00;Perjantai;10;2;12;2;1;3
96;22.05.2015;2015;05;01;Perjantai;1;1;2;0;0;0
96;22.05.2015;2015;05;02;Perjantai;2;0;2;0;0;0
96;22.05.2015;2015;05;03;Perjantai;3;2;5;0;1;1
96;22.05.2015;2015;05;04;Perjantai;3;2;5;0;2;2
96;22.05.2015;2015;05;05;Perjantai;7;10;17;0;1;1
96;22.05.2015;2015;05;06;Perjantai;45;39;84;5;0;5
96;22.05.2015;2015;05;07;Perjantai;121;139;260;12;7;19
96;22.05.2015;2015;05;08;Perjantai;88;118;206;9;3;12
96;22.05.2015;2015;05;09;Perjantai;59;76;135;12;10;22
96;22.05.2015;2015;05;10;Perjantai;49;60;109;24;8;32
96;22.05.2015;2015;05;11;Perjantai;76;87;163;50;11;61
96;22.05.2015;2015;05;12;Perjantai;116;121;237;17;10;27
96;22.05.2015;2015;05;13;Perjantai;86;86;172;6;4;10
96;22.05.2015;2015;05;14;Perjantai;93;153;246;4;3;7
96;22.05.2015;2015;05;15;Perjantai;95;158;253;7;11;18
96;22.05.2015;2015;05;16;Perjantai;93;100;193;11;14;25
96;22.05.2015;2015;05;17;Perjantai;75;54;129;8;14;22
96;22.05.2015;2015;05;18;Perjantai;61;64;125;9;10;19
96;22.05.2015;2015;05;19;Perjantai;68;42;110;3;5;8
96;22.05.2015;2015;05;20;Perjantai;64;40;104;3;5;8
96;22.05.2015;2015;05;21;Perjantai;38;46;84;2;3;5
96;22.05.2015;2015;05;22;Perjantai;23;25;48;2;2;4
96;22.05.2015;2015;05;23;Perjantai;16;5;21;4;3;7
96;23.05.2015;2015;05;00;Lauantai;6;8;14;1;2;3
96;23.05.2015;2015;05;01;Lauantai;10;7;17;1;0;1
96;23.05.2015;2015;05;02;Lauantai;19;2;21;1;0;1
96;23.05.2015;2015;05;03;Lauantai;22;2;24;1;0;1
96;23.05.2015;2015;05;04;Lauantai;4;0;4;0;1;1
96;23.05.2015;2015;05;05;Lauantai;6;2;8;0;0;0
96;23.05.2015;2015;05;06;Lauantai;24;9;33;3;0;3
96;23.05.2015;2015;05;07;Lauantai;6;21;27;0;2;2
96;23.05.2015;2015;05;08;Lauantai;9;20;29;3;2;5
96;23.05.2015;2015;05;09;Lauantai;5;23;28;2;0;2
96;23.05.2015;2015;05;10;Lauantai;11;23;34;2;4;6
96;23.05.2015;2015;05;11;Lauantai;19;26;45;3;2;5
96;23.05.2015;2015;05;12;Lauantai;20;22;42;1;4;5
96;23.05.2015;2015;05;13;Lauantai;35;34;69;4;8;12
96;23.05.2015;2015;05;14;Lauantai;31;42;73;14;14;28
96;23.05.2015;2015;05;15;Lauantai;38;33;71;13;6;19
96;23.05.2015;2015;05;16;Lauantai;19;18;37;5;2;7
96;23.05.2015;2015;05;17;Lauantai;21;13;34;6;3;9
96;23.05.2015;2015;05;18;Lauantai;34;6;40;3;0;3
96;23.05.2015;2015;05;19;Lauantai;12;7;19;5;4;9
96;23.05.2015;2015;05;20;Lauantai;22;19;41;2;5;7
96;23.05.2015;2015;05;21;Lauantai;15;29;44;6;3;9
96;23.05.2015;2015;05;22;Lauantai;5;9;14;2;2;4
96;23.05.2015;2015;05;23;Lauantai;7;12;19;0;3;3
96;24.05.2015;2015;05;00;Sunnuntai;2;2;4;1;0;1
96;24.05.2015;2015;05;01;Sunnuntai;6;4;10;0;0;0
96;24.05.2015;2015;05;02;Sunnuntai;7;4;11;2;0;2
96;24.05.2015;2015;05;03;Sunnuntai;12;0;12;2;0;2
96;24.05.2015;2015;05;04;Sunnuntai;14;0;14;1;0;1
96;24.05.2015;2015;05;05;Sunnuntai;5;1;6;2;0;2
96;24.05.2015;2015;05;06;Sunnuntai;21;8;29;3;1;4
96;24.05.2015;2015;05;07;Sunnuntai;5;9;14;0;2;2
96;24.05.2015;2015;05;08;Sunnuntai;8;14;22;2;1;3
96;24.05.2015;2015;05;09;Sunnuntai;15;19;34;10;4;14
96;24.05.2015;2015;05;10;Sunnuntai;15;42;57;18;9;27
96;24.05.2015;2015;05;11;Sunnuntai;39;38;77;35;11;46
96;24.05.2015;2015;05;12;Sunnuntai;52;45;97;33;32;65
96;24.05.2015;2015;05;13;Sunnuntai;72;44;116;32;9;41
96;24.05.2015;2015;05;14;Sunnuntai;50;49;99;17;11;28
96;24.05.2015;2015;05;15;Sunnuntai;56;48;104;30;12;42
96;24.05.2015;2015;05;16;Sunnuntai;66;49;115;25;7;32
96;24.05.2015;2015;05;17;Sunnuntai;47;42;89;33;10;43
96;24.05.2015;2015;05;18;Sunnuntai;42;52;94;67;15;82
96;24.05.2015;2015;05;19;Sunnuntai;47;46;93;32;23;55
96;24.05.2015;2015;05;20;Sunnuntai;28;60;88;6;9;15
96;24.05.2015;2015;05;21;Sunnuntai;25;27;52;2;6;8
96;24.05.2015;2015;05;22;Sunnuntai;7;8;15;4;4;8
96;24.05.2015;2015;05;23;Sunnuntai;5;1;6;1;0;1
96;25.05.2015;2015;05;00;Maanantai;3;2;5;0;1;1
96;25.05.2015;2015;05;01;Maanantai;3;0;3;2;1;3
96;25.05.2015;2015;05;02;Maanantai;2;0;2;0;1;1
96;25.05.2015;2015;05;03;Maanantai;7;0;7;0;0;0
96;25.05.2015;2015;05;04;Maanantai;1;1;2;0;0;0
96;25.05.2015;2015;05;05;Maanantai;7;14;21;0;1;1
96;25.05.2015;2015;05;06;Maanantai;62;42;104;9;1;10
96;25.05.2015;2015;05;07;Maanantai;137;142;279;19;6;25
96;25.05.2015;2015;05;08;Maanantai;98;157;255;7;7;14
96;25.05.2015;2015;05;09;Maanantai;51;90;141;8;9;17
96;25.05.2015;2015;05;10;Maanantai;55;62;117;4;8;12
96;25.05.2015;2015;05;11;Maanantai;89;84;173;13;9;22
96;25.05.2015;2015;05;12;Maanantai;99;102;201;11;12;23
96;25.05.2015;2015;05;13;Maanantai;80;108;188;8;15;23
96;25.05.2015;2015;05;14;Maanantai;83;133;216;6;20;26
96;25.05.2015;2015;05;15;Maanantai;92;219;311;5;17;22
96;25.05.2015;2015;05;16;Maanantai;114;153;267;8;16;24
96;25.05.2015;2015;05;17;Maanantai;82;85;167;10;12;22
96;25.05.2015;2015;05;18;Maanantai;87;55;142;13;14;27
96;25.05.2015;2015;05;19;Maanantai;60;47;107;8;17;25
96;25.05.2015;2015;05;20;Maanantai;74;42;116;5;11;16
96;25.05.2015;2015;05;21;Maanantai;24;33;57;4;4;8
96;25.05.2015;2015;05;22;Maanantai;3;12;15;3;2;5
96;25.05.2015;2015;05;23;Maanantai;2;8;10;1;3;4
96;26.05.2015;2015;05;00;Tiistai;0;2;2;1;2;3
96;26.05.2015;2015;05;01;Tiistai;6;1;7;0;0;0
96;26.05.2015;2015;05;02;Tiistai;1;0;1;1;0;1
96;26.05.2015;2015;05;03;Tiistai;1;1;2;1;1;2
96;26.05.2015;2015;05;04;Tiistai;1;1;2;0;1;1
96;26.05.2015;2015;05;05;Tiistai;2;16;18;0;0;0
96;26.05.2015;2015;05;06;Tiistai;58;46;104;9;0;9
96;26.05.2015;2015;05;07;Tiistai;133;109;242;14;4;18
96;26.05.2015;2015;05;08;Tiistai;78;106;184;8;5;13
96;26.05.2015;2015;05;09;Tiistai;54;78;132;5;14;19
96;26.05.2015;2015;05;10;Tiistai;34;74;108;3;6;9
96;26.05.2015;2015;05;11;Tiistai;100;99;199;10;6;16
96;26.05.2015;2015;05;12;Tiistai;83;59;142;7;6;13
96;26.05.2015;2015;05;13;Tiistai;78;128;206;6;15;21
96;26.05.2015;2015;05;14;Tiistai;76;119;195;5;15;20
96;26.05.2015;2015;05;15;Tiistai;111;208;319;5;24;29
96;26.05.2015;2015;05;16;Tiistai;119;150;269;6;16;22
96;26.05.2015;2015;05;17;Tiistai;100;101;201;14;21;35
96;26.05.2015;2015;05;18;Tiistai;83;61;144;19;16;35
96;26.05.2015;2015;05;19;Tiistai;81;77;158;14;11;25
96;26.05.2015;2015;05;20;Tiistai;71;51;122;12;13;25
96;26.05.2015;2015;05;21;Tiistai;46;48;94;2;5;7
96;26.05.2015;2015;05;22;Tiistai;17;13;30;1;1;2
96;26.05.2015;2015;05;23;Tiistai;9;5;14;0;1;1
96;27.05.2015;2015;05;00;Keskiviikko;1;3;4;0;1;1
96;27.05.2015;2015;05;01;Keskiviikko;3;2;5;2;0;2
96;27.05.2015;2015;05;02;Keskiviikko;2;1;3;1;0;1
96;27.05.2015;2015;05;03;Keskiviikko;2;0;2;1;1;2
96;27.05.2015;2015;05;04;Keskiviikko;3;1;4;0;1;1
96;27.05.2015;2015;05;05;Keskiviikko;6;13;19;0;3;3
96;27.05.2015;2015;05;06;Keskiviikko;59;39;98;4;2;6
96;27.05.2015;2015;05;07;Keskiviikko;126;119;245;19;5;24
96;27.05.2015;2015;05;08;Keskiviikko;92;113;205;9;4;13
96;27.05.2015;2015;05;09;Keskiviikko;54;95;149;8;6;14
96;27.05.2015;2015;05;10;Keskiviikko;99;65;164;6;10;16
96;27.05.2015;2015;05;11;Keskiviikko;69;57;126;16;10;26
96;27.05.2015;2015;05;12;Keskiviikko;52;66;118;7;8;15
96;27.05.2015;2015;05;13;Keskiviikko;66;74;140;5;7;12
96;27.05.2015;2015;05;14;Keskiviikko;66;89;155;8;12;20
96;27.05.2015;2015;05;15;Keskiviikko;72;164;236;7;29;36
96;27.05.2015;2015;05;16;Keskiviikko;87;137;224;18;28;46
96;27.05.2015;2015;05;17;Keskiviikko;75;83;158;13;14;27
96;27.05.2015;2015;05;18;Keskiviikko;105;56;161;23;7;30
96;27.05.2015;2015;05;19;Keskiviikko;71;49;120;18;12;30
96;27.05.2015;2015;05;20;Keskiviikko;64;64;128;6;15;21
96;27.05.2015;2015;05;21;Keskiviikko;40;40;80;8;7;15
96;27.05.2015;2015;05;22;Keskiviikko;12;7;19;2;6;8
96;27.05.2015;2015;05;23;Keskiviikko;16;9;25;3;0;3
96;28.05.2015;2015;05;00;Torstai;3;3;6;0;0;0
96;28.05.2015;2015;05;01;Torstai;2;0;2;1;1;2
96;28.05.2015;2015;05;02;Torstai;3;0;3;1;0;1
96;28.05.2015;2015;05;03;Torstai;3;0;3;0;1;1
96;28.05.2015;2015;05;04;Torstai;3;1;4;1;0;1
96;28.05.2015;2015;05;05;Torstai;5;15;20;0;0;0
96;28.05.2015;2015;05;06;Torstai;67;46;113;6;1;7
96;28.05.2015;2015;05;07;Torstai;119;125;244;14;5;19
96;28.05.2015;2015;05;08;Torstai;118;147;265;11;4;15
96;28.05.2015;2015;05;09;Torstai;67;91;158;13;12;25
96;28.05.2015;2015;05;10;Torstai;52;84;136;5;4;9
96;28.05.2015;2015;05;11;Torstai;88;102;190;27;12;39
96;28.05.2015;2015;05;12;Torstai;114;140;254;26;8;34
96;28.05.2015;2015;05;13;Torstai;108;87;195;10;10;20
96;28.05.2015;2015;05;14;Torstai;80;122;202;7;10;17
96;28.05.2015;2015;05;15;Torstai;111;213;324;11;15;26
96;28.05.2015;2015;05;16;Torstai;103;162;265;6;18;24
96;28.05.2015;2015;05;17;Torstai;103;85;188;14;7;21
96;28.05.2015;2015;05;18;Torstai;78;65;143;15;3;18
96;28.05.2015;2015;05;19;Torstai;69;48;117;13;12;25
96;28.05.2015;2015;05;20;Torstai;68;47;115;3;10;13
96;28.05.2015;2015;05;21;Torstai;45;43;88;8;4;12
96;28.05.2015;2015;05;22;Torstai;19;12;31;0;2;2
96;28.05.2015;2015;05;23;Torstai;5;7;12;0;0;0
96;29.05.2015;2015;05;00;Perjantai;10;3;13;0;2;2
96;29.05.2015;2015;05;01;Perjantai;3;2;5;0;1;1
96;29.05.2015;2015;05;02;Perjantai;3;0;3;0;0;0
96;29.05.2015;2015;05;03;Perjantai;0;1;1;2;2;4
96;29.05.2015;2015;05;04;Perjantai;3;1;4;0;0;0
96;29.05.2015;2015;05;05;Perjantai;6;12;18;0;0;0
96;29.05.2015;2015;05;06;Perjantai;61;40;101;5;2;7
96;29.05.2015;2015;05;07;Perjantai;109;130;239;10;4;14
96;29.05.2015;2015;05;08;Perjantai;86;132;218;13;10;23
96;29.05.2015;2015;05;09;Perjantai;58;72;130;8;6;14
96;29.05.2015;2015;05;10;Perjantai;61;84;145;11;9;20
96;29.05.2015;2015;05;11;Perjantai;96;110;206;53;14;67
96;29.05.2015;2015;05;12;Perjantai;106;102;208;39;14;53
96;29.05.2015;2015;05;13;Perjantai;101;96;197;24;14;38
96;29.05.2015;2015;05;14;Perjantai;87;127;214;14;19;33
96;29.05.2015;2015;05;15;Perjantai;127;175;302;4;16;20
96;29.05.2015;2015;05;16;Perjantai;99;95;194;6;6;12
96;29.05.2015;2015;05;17;Perjantai;62;82;144;4;13;17
96;29.05.2015;2015;05;18;Perjantai;48;39;87;6;6;12
96;29.05.2015;2015;05;19;Perjantai;45;33;78;7;3;10
96;29.05.2015;2015;05;20;Perjantai;61;30;91;14;4;18
96;29.05.2015;2015;05;21;Perjantai;33;24;57;3;6;9
96;29.05.2015;2015;05;22;Perjantai;15;6;21;0;2;2
96;29.05.2015;2015;05;23;Perjantai;8;7;15;0;1;1
96;30.05.2015;2015;05;00;Lauantai;4;8;12;1;1;2
96;30.05.2015;2015;05;01;Lauantai;6;4;10;1;0;1
96;30.05.2015;2015;05;02;Lauantai;6;1;7;0;1;1
96;30.05.2015;2015;05;03;Lauantai;5;2;7;0;0;0
96;30.05.2015;2015;05;04;Lauantai;2;1;3;1;1;2
96;30.05.2015;2015;05;05;Lauantai;1;2;3;2;0;2
96;30.05.2015;2015;05;06;Lauantai;20;6;26;2;0;2
96;30.05.2015;2015;05;07;Lauantai;17;19;36;1;6;7
96;30.05.2015;2015;05;08;Lauantai;7;43;50;3;1;4
96;30.05.2015;2015;05;09;Lauantai;39;46;85;7;5;12
96;30.05.2015;2015;05;10;Lauantai;46;43;89;9;5;14
96;30.05.2015;2015;05;11;Lauantai;39;56;95;12;6;18
96;30.05.2015;2015;05;12;Lauantai;50;57;107;9;10;19
96;30.05.2015;2015;05;13;Lauantai;64;53;117;3;10;13
96;30.05.2015;2015;05;14;Lauantai;51;78;129;7;6;13
96;30.05.2015;2015;05;15;Lauantai;59;75;134;12;5;17
96;30.05.2015;2015;05;16;Lauantai;41;52;93;7;9;16
96;30.05.2015;2015;05;17;Lauantai;42;44;86;3;6;9
96;30.05.2015;2015;05;18;Lauantai;62;54;116;7;7;14
96;30.05.2015;2015;05;19;Lauantai;29;52;81;5;4;9
96;30.05.2015;2015;05;20;Lauantai;36;58;94;8;9;17
96;30.05.2015;2015;05;21;Lauantai;28;52;80;3;3;6
96;30.05.2015;2015;05;22;Lauantai;54;28;82;4;2;6
96;30.05.2015;2015;05;23;Lauantai;36;23;59;3;2;5
96;31.05.2015;2015;05;00;Sunnuntai;28;13;41;2;2;4
96;31.05.2015;2015;05;01;Sunnuntai;35;2;37;3;1;4
96;31.05.2015;2015;05;02;Sunnuntai;47;3;50;5;2;7
96;31.05.2015;2015;05;03;Sunnuntai;21;3;24;6;1;7
96;31.05.2015;2015;05;04;Sunnuntai;16;1;17;8;1;9
96;31.05.2015;2015;05;05;Sunnuntai;7;1;8;1;0;1
96;31.05.2015;2015;05;06;Sunnuntai;15;4;19;0;0;0
96;31.05.2015;2015;05;07;Sunnuntai;3;20;23;0;2;2
96;31.05.2015;2015;05;08;Sunnuntai;11;16;27;1;2;3
96;31.05.2015;2015;05;09;Sunnuntai;20;38;58;4;4;8
96;31.05.2015;2015;05;10;Sunnuntai;29;23;52;2;5;7
96;31.05.2015;2015;05;11;Sunnuntai;22;18;40;6;6;12
96;31.05.2015;2015;05;12;Sunnuntai;27;24;51;7;7;14
96;31.05.2015;2015;05;13;Sunnuntai;26;31;57;8;6;14
96;31.05.2015;2015;05;14;Sunnuntai;23;23;46;10;3;13
96;31.05.2015;2015;05;15;Sunnuntai;31;34;65;8;2;10
96;31.05.2015;2015;05;16;Sunnuntai;29;26;55;8;3;11
96;31.05.2015;2015;05;17;Sunnuntai;32;25;57;3;7;10
96;31.05.2015;2015;05;18;Sunnuntai;42;26;68;13;12;25
96;31.05.2015;2015;05;19;Sunnuntai;19;18;37;5;8;13
96;31.05.2015;2015;05;20;Sunnuntai;16;20;36;9;3;12
96;31.05.2015;2015;05;21;Sunnuntai;19;15;34;3;3;6
96;31.05.2015;2015;05;22;Sunnuntai;5;14;19;5;0;5
96;31.05.2015;2015;05;23;Sunnuntai;7;4;11;0;2;2
96;01.06.2015;2015;06;00;Maanantai;1;3;4;0;4;4
96;01.06.2015;2015;06;01;Maanantai;2;0;2;2;2;4
96;01.06.2015;2015;06;02;Maanantai;0;2;2;0;0;0
96;01.06.2015;2015;06;03;Maanantai;3;0;3;0;0;0
96;01.06.2015;2015;06;04;Maanantai;2;0;2;0;0;0
96;01.06.2015;2015;06;05;Maanantai;10;12;22;1;1;2
96;01.06.2015;2015;06;06;Maanantai;64;50;114;6;3;9
96;01.06.2015;2015;06;07;Maanantai;120;131;251;18;9;27
96;01.06.2015;2015;06;08;Maanantai;57;107;164;7;8;15
96;01.06.2015;2015;06;09;Maanantai;30;51;81;9;5;14
96;01.06.2015;2015;06;10;Maanantai;35;42;77;5;7;12
96;01.06.2015;2015;06;11;Maanantai;48;71;119;4;9;13
96;01.06.2015;2015;06;12;Maanantai;55;67;122;6;11;17
96;01.06.2015;2015;06;13;Maanantai;53;75;128;5;11;16
96;01.06.2015;2015;06;14;Maanantai;70;109;179;6;10;16
96;01.06.2015;2015;06;15;Maanantai;103;180;283;10;17;27
96;01.06.2015;2015;06;16;Maanantai;104;121;225;9;21;30
96;01.06.2015;2015;06;17;Maanantai;58;45;103;5;1;6
96;01.06.2015;2015;06;18;Maanantai;48;40;88;4;4;8
96;01.06.2015;2015;06;19;Maanantai;30;30;60;5;11;16
96;01.06.2015;2015;06;20;Maanantai;40;17;57;7;4;11
96;01.06.2015;2015;06;21;Maanantai;16;38;54;2;3;5
96;01.06.2015;2015;06;22;Maanantai;11;17;28;1;6;7
96;01.06.2015;2015;06;23;Maanantai;1;3;4;1;0;1
96;02.06.2015;2015;06;00;Tiistai;0;2;2;2;3;5
96;02.06.2015;2015;06;01;Tiistai;6;1;7;1;2;3
96;02.06.2015;2015;06;02;Tiistai;0;0;0;0;1;1
96;02.06.2015;2015;06;03;Tiistai;0;0;0;0;0;0
96;02.06.2015;2015;06;04;Tiistai;3;2;5;1;0;1
96;02.06.2015;2015;06;05;Tiistai;11;13;24;1;1;2
96;02.06.2015;2015;06;06;Tiistai;65;40;105;8;2;10
96;02.06.2015;2015;06;07;Tiistai;130;132;262;15;5;20
96;02.06.2015;2015;06;08;Tiistai;79;122;201;23;12;35
96;02.06.2015;2015;06;09;Tiistai;41;77;118;24;21;45
96;02.06.2015;2015;06;10;Tiistai;33;68;101;14;9;23
96;02.06.2015;2015;06;11;Tiistai;49;60;109;39;7;46
96;02.06.2015;2015;06;12;Tiistai;92;59;151;41;9;50
96;02.06.2015;2015;06;13;Tiistai;72;73;145;31;5;36
96;02.06.2015;2015;06;14;Tiistai;62;99;161;19;7;26
96;02.06.2015;2015;06;15;Tiistai;124;205;329;15;11;26
96;02.06.2015;2015;06;16;Tiistai;128;151;279;23;19;42
96;02.06.2015;2015;06;17;Tiistai;93;76;169;11;11;22
96;02.06.2015;2015;06;18;Tiistai;80;76;156;9;6;15
96;02.06.2015;2015;06;19;Tiistai;86;58;144;14;8;22
96;02.06.2015;2015;06;20;Tiistai;46;42;88;9;10;19
96;02.06.2015;2015;06;21;Tiistai;37;44;81;7;7;14
96;02.06.2015;2015;06;22;Tiistai;15;16;31;2;3;5
96;02.06.2015;2015;06;23;Tiistai;7;4;11;0;0;0
96;03.06.2015;2015;06;00;Keskiviikko;5;3;8;0;1;1
96;03.06.2015;2015;06;01;Keskiviikko;5;1;6;0;0;0
96;03.06.2015;2015;06;02;Keskiviikko;2;1;3;1;1;2
96;03.06.2015;2015;06;03;Keskiviikko;1;0;1;0;0;0
96;03.06.2015;2015;06;04;Keskiviikko;4;0;4;0;0;0
96;03.06.2015;2015;06;05;Keskiviikko;12;12;24;0;0;0
96;03.06.2015;2015;06;06;Keskiviikko;53;40;93;8;1;9
96;03.06.2015;2015;06;07;Keskiviikko;99;84;183;16;2;18
96;03.06.2015;2015;06;08;Keskiviikko;47;46;93;7;8;15
96;03.06.2015;2015;06;09;Keskiviikko;25;33;58;3;1;4
96;03.06.2015;2015;06;10;Keskiviikko;20;22;42;6;2;8
96;03.06.2015;2015;06;11;Keskiviikko;11;23;34;1;7;8
96;03.06.2015;2015;06;12;Keskiviikko;49;38;87;5;14;19
96;03.06.2015;2015;06;13;Keskiviikko;37;47;84;1;5;6
96;03.06.2015;2015;06;14;Keskiviikko;50;80;130;4;5;9
96;03.06.2015;2015;06;15;Keskiviikko;60;163;223;5;25;30
96;03.06.2015;2015;06;16;Keskiviikko;72;93;165;7;15;22
96;03.06.2015;2015;06;17;Keskiviikko;62;63;125;10;9;19
96;03.06.2015;2015;06;18;Keskiviikko;75;51;126;9;15;24
96;03.06.2015;2015;06;19;Keskiviikko;53;43;96;11;4;15
96;03.06.2015;2015;06;20;Keskiviikko;34;42;76;3;8;11
96;03.06.2015;2015;06;21;Keskiviikko;24;34;58;7;6;13
96;03.06.2015;2015;06;22;Keskiviikko;9;11;20;1;2;3
96;03.06.2015;2015;06;23;Keskiviikko;8;10;18;1;1;2
96;04.06.2015;2015;06;00;Torstai;5;3;8;1;1;2
96;04.06.2015;2015;06;01;Torstai;3;0;3;0;0;0
96;04.06.2015;2015;06;02;Torstai;1;0;1;0;0;0
96;04.06.2015;2015;06;03;Torstai;1;3;4;0;0;0
96;04.06.2015;2015;06;04;Torstai;6;0;6;1;1;2
96;04.06.2015;2015;06;05;Torstai;6;15;21;0;0;0
96;04.06.2015;2015;06;06;Torstai;68;44;112;6;2;8
96;04.06.2015;2015;06;07;Torstai;113;103;216;20;4;24
96;04.06.2015;2015;06;08;Torstai;50;96;146;5;6;11
96;04.06.2015;2015;06;09;Torstai;46;62;108;8;11;19
96;04.06.2015;2015;06;10;Torstai;38;81;119;7;14;21
96;04.06.2015;2015;06;11;Torstai;59;106;165;9;12;21
96;04.06.2015;2015;06;12;Torstai;72;103;175;10;18;28
96;04.06.2015;2015;06;13;Torstai;85;77;162;4;11;15
96;04.06.2015;2015;06;14;Torstai;107;112;219;19;12;31
96;04.06.2015;2015;06;15;Torstai;142;176;318;10;12;22
96;04.06.2015;2015;06;16;Torstai;119;131;250;10;28;38
96;04.06.2015;2015;06;17;Torstai;120;78;198;12;6;18
96;04.06.2015;2015;06;18;Torstai;87;80;167;10;5;15
96;04.06.2015;2015;06;19;Torstai;60;55;115;9;11;20
96;04.06.2015;2015;06;20;Torstai;56;31;87;7;11;18
96;04.06.2015;2015;06;21;Torstai;28;45;73;1;4;5
96;04.06.2015;2015;06;22;Torstai;19;22;41;1;2;3
96;04.06.2015;2015;06;23;Torstai;6;8;14;1;2;3
96;05.06.2015;2015;06;00;Perjantai;5;7;12;0;0;0
96;05.06.2015;2015;06;01;Perjantai;2;1;3;1;0;1
96;05.06.2015;2015;06;02;Perjantai;5;1;6;1;1;2
96;05.06.2015;2015;06;03;Perjantai;3;0;3;0;2;2
96;05.06.2015;2015;06;04;Perjantai;5;0;5;0;1;1
96;05.06.2015;2015;06;05;Perjantai;8;13;21;0;0;0
96;05.06.2015;2015;06;06;Perjantai;61;40;101;5;1;6
96;05.06.2015;2015;06;07;Perjantai;104;100;204;23;7;30
96;05.06.2015;2015;06;08;Perjantai;65;101;166;18;14;32
96;05.06.2015;2015;06;09;Perjantai;32;64;96;21;4;25
96;05.06.2015;2015;06;10;Perjantai;45;55;100;16;4;20
96;05.06.2015;2015;06;11;Perjantai;45;51;96;12;15;27
96;05.06.2015;2015;06;12;Perjantai;80;61;141;16;9;25
96;05.06.2015;2015;06;13;Perjantai;65;102;167;15;7;22
96;05.06.2015;2015;06;14;Perjantai;86;118;204;11;8;19
96;05.06.2015;2015;06;15;Perjantai;89;147;236;7;20;27
96;05.06.2015;2015;06;16;Perjantai;86;111;197;9;6;15
96;05.06.2015;2015;06;17;Perjantai;66;69;135;12;6;18
96;05.06.2015;2015;06;18;Perjantai;65;67;132;12;12;24
96;05.06.2015;2015;06;19;Perjantai;63;39;102;10;4;14
96;05.06.2015;2015;06;20;Perjantai;57;38;95;3;5;8
96;05.06.2015;2015;06;21;Perjantai;33;46;79;6;9;15
96;05.06.2015;2015;06;22;Perjantai;25;25;50;3;4;7
96;05.06.2015;2015;06;23;Perjantai;19;12;31;3;3;6
96;06.06.2015;2015;06;00;Lauantai;17;22;39;2;4;6
96;06.06.2015;2015;06;01;Lauantai;17;7;24;1;0;1
96;06.06.2015;2015;06;02;Lauantai;22;3;25;0;0;0
96;06.06.2015;2015;06;03;Lauantai;14;3;17;2;0;2
96;06.06.2015;2015;06;04;Lauantai;8;1;9;4;1;5
96;06.06.2015;2015;06;05;Lauantai;8;2;10;1;0;1
96;06.06.2015;2015;06;06;Lauantai;23;6;29;3;2;5
96;06.06.2015;2015;06;07;Lauantai;9;17;26;5;4;9
96;06.06.2015;2015;06;08;Lauantai;13;34;47;3;7;10
96;06.06.2015;2015;06;09;Lauantai;21;48;69;7;2;9
96;06.06.2015;2015;06;10;Lauantai;34;49;83;9;9;18
96;06.06.2015;2015;06;11;Lauantai;46;75;121;7;2;9
96;06.06.2015;2015;06;12;Lauantai;67;64;131;6;8;14
96;06.06.2015;2015;06;13;Lauantai;42;59;101;3;3;6
96;06.06.2015;2015;06;14;Lauantai;53;54;107;1;5;6
96;06.06.2015;2015;06;15;Lauantai;41;61;102;3;4;7
96;06.06.2015;2015;06;16;Lauantai;34;40;74;3;5;8
96;06.06.2015;2015;06;17;Lauantai;46;24;70;5;1;6
96;06.06.2015;2015;06;18;Lauantai;29;10;39;6;1;7
96;06.06.2015;2015;06;19;Lauantai;17;8;25;2;1;3
96;06.06.2015;2015;06;20;Lauantai;18;12;30;3;4;7
96;06.06.2015;2015;06;21;Lauantai;8;20;28;0;1;1
96;06.06.2015;2015;06;22;Lauantai;2;6;8;0;0;0
96;06.06.2015;2015;06;23;Lauantai;4;9;13;1;0;1
96;07.06.2015;2015;06;00;Sunnuntai;5;3;8;1;4;5
96;07.06.2015;2015;06;01;Sunnuntai;5;1;6;0;1;1
96;07.06.2015;2015;06;02;Sunnuntai;7;2;9;0;0;0
96;07.06.2015;2015;06;03;Sunnuntai;3;1;4;1;0;1
96;07.06.2015;2015;06;04;Sunnuntai;3;0;3;0;0;0
96;07.06.2015;2015;06;05;Sunnuntai;1;2;3;1;0;1
96;07.06.2015;2015;06;06;Sunnuntai;18;10;28;1;1;2
96;07.06.2015;2015;06;07;Sunnuntai;1;9;10;1;1;2
96;07.06.2015;2015;06;08;Sunnuntai;7;1;8;1;1;2
96;07.06.2015;2015;06;09;Sunnuntai;5;13;18;0;0;0
96;07.06.2015;2015;06;10;Sunnuntai;5;10;15;0;0;0
96;07.06.2015;2015;06;11;Sunnuntai;6;6;12;3;0;3
96;07.06.2015;2015;06;12;Sunnuntai;8;10;18;12;1;13
96;07.06.2015;2015;06;13;Sunnuntai;12;11;23;5;1;6
96;07.06.2015;2015;06;14;Sunnuntai;11;15;26;1;5;6
96;07.06.2015;2015;06;15;Sunnuntai;9;12;21;0;4;4
96;07.06.2015;2015;06;16;Sunnuntai;26;3;29;7;1;8
96;07.06.2015;2015;06;17;Sunnuntai;12;5;17;3;0;3
96;07.06.2015;2015;06;18;Sunnuntai;6;12;18;4;7;11
96;07.06.2015;2015;06;19;Sunnuntai;7;9;16;2;3;5
96;07.06.2015;2015;06;20;Sunnuntai;12;9;21;2;8;10
96;07.06.2015;2015;06;21;Sunnuntai;10;9;19;4;3;7
96;07.06.2015;2015;06;22;Sunnuntai;12;6;18;1;3;4
96;07.06.2015;2015;06;23;Sunnuntai;3;3;6;2;2;4
96;08.06.2015;2015;06;00;Maanantai;2;3;5;0;0;0
96;08.06.2015;2015;06;01;Maanantai;1;0;1;1;0;1
96;08.06.2015;2015;06;02;Maanantai;0;0;0;0;0;0
96;08.06.2015;2015;06;03;Maanantai;0;0;0;0;0;0
96;08.06.2015;2015;06;04;Maanantai;2;1;3;1;0;1
96;08.06.2015;2015;06;05;Maanantai;8;7;15;0;1;1
96;08.06.2015;2015;06;06;Maanantai;64;37;101;5;2;7
96;08.06.2015;2015;06;07;Maanantai;125;96;221;8;8;16
96;08.06.2015;2015;06;08;Maanantai;71;97;168;7;5;12
96;08.06.2015;2015;06;09;Maanantai;40;79;119;6;9;15
96;08.06.2015;2015;06;10;Maanantai;42;52;94;5;2;7
96;08.06.2015;2015;06;11;Maanantai;62;58;120;11;6;17
96;08.06.2015;2015;06;12;Maanantai;76;64;140;14;6;20
96;08.06.2015;2015;06;13;Maanantai;57;75;132;11;4;15
96;08.06.2015;2015;06;14;Maanantai;73;89;162;11;7;18
96;08.06.2015;2015;06;15;Maanantai;94;194;288;11;11;22
96;08.06.2015;2015;06;16;Maanantai;102;131;233;24;18;42
96;08.06.2015;2015;06;17;Maanantai;111;74;185;15;11;26
96;08.06.2015;2015;06;18;Maanantai;101;63;164;12;6;18
96;08.06.2015;2015;06;19;Maanantai;65;63;128;9;14;23
96;08.06.2015;2015;06;20;Maanantai;57;37;94;8;8;16
96;08.06.2015;2015;06;21;Maanantai;39;42;81;5;3;8
96;08.06.2015;2015;06;22;Maanantai;12;11;23;1;1;2
96;08.06.2015;2015;06;23;Maanantai;11;4;15;1;3;4
96;09.06.2015;2015;06;00;Tiistai;5;4;9;2;1;3
96;09.06.2015;2015;06;01;Tiistai;4;5;9;0;1;1
96;09.06.2015;2015;06;02;Tiistai;1;4;5;0;1;1
96;09.06.2015;2015;06;03;Tiistai;3;1;4;3;2;5
96;09.06.2015;2015;06;04;Tiistai;3;2;5;1;0;1
96;09.06.2015;2015;06;05;Tiistai;5;12;17;0;0;0
96;09.06.2015;2015;06;06;Tiistai;72;52;124;4;5;9
96;09.06.2015;2015;06;07;Tiistai;118;134;252;19;5;24
96;09.06.2015;2015;06;08;Tiistai;73;108;181;19;9;28
96;09.06.2015;2015;06;09;Tiistai;53;71;124;15;4;19
96;09.06.2015;2015;06;10;Tiistai;45;64;109;7;7;14
96;09.06.2015;2015;06;11;Tiistai;59;64;123;26;13;39
96;09.06.2015;2015;06;12;Tiistai;79;57;136;61;10;71
96;09.06.2015;2015;06;13;Tiistai;42;64;106;32;13;45
96;09.06.2015;2015;06;14;Tiistai;77;100;177;27;6;33
96;09.06.2015;2015;06;15;Tiistai;110;178;288;35;22;57
96;09.06.2015;2015;06;16;Tiistai;125;145;270;57;14;71
96;09.06.2015;2015;06;17;Tiistai;93;74;167;35;19;54
96;09.06.2015;2015;06;18;Tiistai;78;64;142;9;10;19
96;09.06.2015;2015;06;19;Tiistai;70;36;106;9;6;15
96;09.06.2015;2015;06;20;Tiistai;55;45;100;8;9;17
96;09.06.2015;2015;06;21;Tiistai;45;42;87;5;8;13
96;09.06.2015;2015;06;22;Tiistai;10;16;26;2;2;4
96;09.06.2015;2015;06;23;Tiistai;6;8;14;1;1;2
96;10.06.2015;2015;06;00;Keskiviikko;4;3;7;1;4;5
96;10.06.2015;2015;06;01;Keskiviikko;5;4;9;1;0;1
96;10.06.2015;2015;06;02;Keskiviikko;0;1;1;0;1;1
96;10.06.2015;2015;06;03;Keskiviikko;1;3;4;0;0;0
96;10.06.2015;2015;06;04;Keskiviikko;4;1;5;0;1;1
96;10.06.2015;2015;06;05;Keskiviikko;8;8;16;0;1;1
96;10.06.2015;2015;06;06;Keskiviikko;66;47;113;4;0;4
96;10.06.2015;2015;06;07;Keskiviikko;98;115;213;15;4;19
96;10.06.2015;2015;06;08;Keskiviikko;45;71;116;11;10;21
96;10.06.2015;2015;06;09;Keskiviikko;29;47;76;6;2;8
96;10.06.2015;2015;06;10;Keskiviikko;31;32;63;1;4;5
96;10.06.2015;2015;06;11;Keskiviikko;32;29;61;7;1;8
96;10.06.2015;2015;06;12;Keskiviikko;44;48;92;10;8;18
96;10.06.2015;2015;06;13;Keskiviikko;41;66;107;2;6;8
96;10.06.2015;2015;06;14;Keskiviikko;55;73;128;10;7;17
96;10.06.2015;2015;06;15;Keskiviikko;86;154;240;3;14;17
96;10.06.2015;2015;06;16;Keskiviikko;78;131;209;6;13;19
96;10.06.2015;2015;06;17;Keskiviikko;80;81;161;14;4;18
96;10.06.2015;2015;06;18;Keskiviikko;64;63;127;16;9;25
96;10.06.2015;2015;06;19;Keskiviikko;55;44;99;9;12;21
96;10.06.2015;2015;06;20;Keskiviikko;57;47;104;8;15;23
96;10.06.2015;2015;06;21;Keskiviikko;39;45;84;4;7;11
96;10.06.2015;2015;06;22;Keskiviikko;13;16;29;1;1;2
96;10.06.2015;2015;06;23;Keskiviikko;6;4;10;4;2;6
96;11.06.2015;2015;06;00;Torstai;5;5;10;2;1;3
96;11.06.2015;2015;06;01;Torstai;3;3;6;0;1;1
96;11.06.2015;2015;06;02;Torstai;3;0;3;1;0;1
96;11.06.2015;2015;06;03;Torstai;3;0;3;0;0;0
96;11.06.2015;2015;06;04;Torstai;2;4;6;2;0;2
96;11.06.2015;2015;06;05;Torstai;7;9;16;0;0;0
96;11.06.2015;2015;06;06;Torstai;70;44;114;4;0;4
96;11.06.2015;2015;06;07;Torstai;108;112;220;10;8;18
96;11.06.2015;2015;06;08;Torstai;57;103;160;13;8;21
96;11.06.2015;2015;06;09;Torstai;45;75;120;17;7;24
96;11.06.2015;2015;06;10;Torstai;60;77;137;14;12;26
96;11.06.2015;2015;06;11;Torstai;66;66;132;8;4;12
96;11.06.2015;2015;06;12;Torstai;66;65;131;16;6;22
96;11.06.2015;2015;06;13;Torstai;54;89;143;6;4;10
96;11.06.2015;2015;06;14;Torstai;68;85;153;7;9;16
96;11.06.2015;2015;06;15;Torstai;103;167;270;14;17;31
96;11.06.2015;2015;06;16;Torstai;98;129;227;27;9;36
96;11.06.2015;2015;06;17;Torstai;80;74;154;9;9;18
96;11.06.2015;2015;06;18;Torstai;72;42;114;46;7;53
96;11.06.2015;2015;06;19;Torstai;60;50;110;32;18;50
96;11.06.2015;2015;06;20;Torstai;71;52;123;10;7;17
96;11.06.2015;2015;06;21;Torstai;47;35;82;3;2;5
96;11.06.2015;2015;06;22;Torstai;17;9;26;3;1;4
96;11.06.2015;2015;06;23;Torstai;8;8;16;1;2;3
96;12.06.2015;2015;06;00;Perjantai;3;4;7;0;1;1
96;12.06.2015;2015;06;01;Perjantai;5;3;8;1;0;1
96;12.06.2015;2015;06;02;Perjantai;0;1;1;0;0;0
96;12.06.2015;2015;06;03;Perjantai;4;0;4;1;0;1
96;12.06.2015;2015;06;04;Perjantai;1;2;3;1;1;2
96;12.06.2015;2015;06;05;Perjantai;8;10;18;2;1;3
96;12.06.2015;2015;06;06;Perjantai;79;38;117;5;0;5
96;12.06.2015;2015;06;07;Perjantai;84;101;185;13;5;18
96;12.06.2015;2015;06;08;Perjantai;43;78;121;6;33;39
96;12.06.2015;2015;06;09;Perjantai;33;55;88;18;50;68
96;12.06.2015;2015;06;10;Perjantai;40;47;87;40;38;78
96;12.06.2015;2015;06;11;Perjantai;77;62;139;56;8;64
96;12.06.2015;2015;06;12;Perjantai;64;67;131;41;12;53
96;12.06.2015;2015;06;13;Perjantai;79;79;158;18;17;35
96;12.06.2015;2015;06;14;Perjantai;63;144;207;31;136;167
96;12.06.2015;2015;06;15;Perjantai;107;166;273;9;20;29
96;12.06.2015;2015;06;16;Perjantai;95;90;185;39;44;83
96;12.06.2015;2015;06;17;Perjantai;62;77;139;57;36;93
96;12.06.2015;2015;06;18;Perjantai;45;40;85;34;67;101
96;12.06.2015;2015;06;19;Perjantai;46;35;81;31;30;61
96;12.06.2015;2015;06;20;Perjantai;50;31;81;68;4;72
96;12.06.2015;2015;06;21;Perjantai;43;34;77;70;7;77
96;12.06.2015;2015;06;22;Perjantai;12;24;36;2;6;8
96;12.06.2015;2015;06;23;Perjantai;14;18;32;0;1;1
96;13.06.2015;2015;06;00;Lauantai;3;7;10;0;1;1
96;13.06.2015;2015;06;01;Lauantai;10;2;12;3;0;3
96;13.06.2015;2015;06;02;Lauantai;15;1;16;0;1;1
96;13.06.2015;2015;06;03;Lauantai;11;2;13;1;0;1
96;13.06.2015;2015;06;04;Lauantai;8;0;8;0;1;1
96;13.06.2015;2015;06;05;Lauantai;1;5;6;0;1;1
96;13.06.2015;2015;06;06;Lauantai;26;13;39;3;2;5
96;13.06.2015;2015;06;07;Lauantai;12;13;25;3;9;12
96;13.06.2015;2015;06;08;Lauantai;10;24;34;8;107;115
96;13.06.2015;2015;06;09;Lauantai;16;41;57;9;50;59
96;13.06.2015;2015;06;10;Lauantai;25;20;45;10;32;42
96;13.06.2015;2015;06;11;Lauantai;14;15;29;83;22;105
96;13.06.2015;2015;06;12;Lauantai;35;39;74;46;14;60
96;13.06.2015;2015;06;13;Lauantai;33;33;66;52;14;66
96;13.06.2015;2015;06;14;Lauantai;46;62;108;10;40;50
96;13.06.2015;2015;06;15;Lauantai;37;70;107;20;122;142
96;13.06.2015;2015;06;16;Lauantai;52;47;99;33;55;88
96;13.06.2015;2015;06;17;Lauantai;50;55;105;36;52;88
96;13.06.2015;2015;06;18;Lauantai;63;44;107;46;29;75
96;13.06.2015;2015;06;19;Lauantai;29;13;42;44;12;56
96;13.06.2015;2015;06;20;Lauantai;36;20;56;135;17;152
96;13.06.2015;2015;06;21;Lauantai;21;39;60;3;9;12
96;13.06.2015;2015;06;22;Lauantai;14;29;43;3;4;7
96;13.06.2015;2015;06;23;Lauantai;14;18;32;0;1;1
96;14.06.2015;2015;06;00;Sunnuntai;12;7;19;0;1;1
96;14.06.2015;2015;06;01;Sunnuntai;15;3;18;2;0;2
96;14.06.2015;2015;06;02;Sunnuntai;11;2;13;0;0;0
96;14.06.2015;2015;06;03;Sunnuntai;19;2;21;6;0;6
96;14.06.2015;2015;06;04;Sunnuntai;8;0;8;0;0;0
96;14.06.2015;2015;06;05;Sunnuntai;6;2;8;1;1;2
96;14.06.2015;2015;06;06;Sunnuntai;14;3;17;1;1;2
96;14.06.2015;2015;06;07;Sunnuntai;5;10;15;0;10;10
96;14.06.2015;2015;06;08;Sunnuntai;6;11;17;11;81;92
96;14.06.2015;2015;06;09;Sunnuntai;12;12;24;16;89;105
96;14.06.2015;2015;06;10;Sunnuntai;20;19;39;10;31;41
96;14.06.2015;2015;06;11;Sunnuntai;36;40;76;46;38;84
96;14.06.2015;2015;06;12;Sunnuntai;64;70;134;108;15;123
96;14.06.2015;2015;06;13;Sunnuntai;75;59;134;57;31;88
96;14.06.2015;2015;06;14;Sunnuntai;55;79;134;11;122;133
96;14.06.2015;2015;06;15;Sunnuntai;44;92;136;23;94;117
96;14.06.2015;2015;06;16;Sunnuntai;86;60;146;56;21;77
96;14.06.2015;2015;06;17;Sunnuntai;74;43;117;27;53;80
96;14.06.2015;2015;06;18;Sunnuntai;90;41;131;31;27;58
96;14.06.2015;2015;06;19;Sunnuntai;35;42;77;38;12;50
96;14.06.2015;2015;06;20;Sunnuntai;32;38;70;142;20;162
96;14.06.2015;2015;06;21;Sunnuntai;22;32;54;8;7;15
96;14.06.2015;2015;06;22;Sunnuntai;20;19;39;1;4;5
96;14.06.2015;2015;06;23;Sunnuntai;10;5;15;0;4;4
96;15.06.2015;2015;06;00;Maanantai;5;2;7;1;3;4
96;15.06.2015;2015;06;01;Maanantai;1;1;2;1;0;1
96;15.06.2015;2015;06;02;Maanantai;3;0;3;0;0;0
96;15.06.2015;2015;06;03;Maanantai;4;1;5;0;0;0
96;15.06.2015;2015;06;04;Maanantai;2;1;3;0;0;0
96;15.06.2015;2015;06;05;Maanantai;5;9;14;0;1;1
96;15.06.2015;2015;06;06;Maanantai;40;20;60;2;1;3
96;15.06.2015;2015;06;07;Maanantai;57;60;117;12;2;14
96;15.06.2015;2015;06;08;Maanantai;27;47;74;9;86;95
96;15.06.2015;2015;06;09;Maanantai;27;21;48;7;2;9
96;15.06.2015;2015;06;10;Maanantai;16;21;37;2;9;11
96;15.06.2015;2015;06;11;Maanantai;18;27;45;13;6;19
96;15.06.2015;2015;06;12;Maanantai;27;28;55;101;9;110
96;15.06.2015;2015;06;13;Maanantai;31;49;80;5;69;74
96;15.06.2015;2015;06;14;Maanantai;41;35;76;2;10;12
96;15.06.2015;2015;06;15;Maanantai;48;98;146;2;14;16
96;15.06.2015;2015;06;16;Maanantai;57;67;124;9;13;22
96;15.06.2015;2015;06;17;Maanantai;31;29;60;39;5;44
96;15.06.2015;2015;06;18;Maanantai;37;34;71;37;7;44
96;15.06.2015;2015;06;19;Maanantai;15;18;33;3;5;8
96;15.06.2015;2015;06;20;Maanantai;31;12;43;5;2;7
96;15.06.2015;2015;06;21;Maanantai;8;18;26;0;2;2
96;15.06.2015;2015;06;22;Maanantai;8;7;15;0;0;0
96;15.06.2015;2015;06;23;Maanantai;1;5;6;2;3;5
96;16.06.2015;2015;06;00;Tiistai;4;3;7;0;0;0
96;16.06.2015;2015;06;01;Tiistai;2;0;2;0;0;0
96;16.06.2015;2015;06;02;Tiistai;0;0;0;0;0;0
96;16.06.2015;2015;06;03;Tiistai;1;1;2;0;0;0
96;16.06.2015;2015;06;04;Tiistai;1;1;2;1;0;1
96;16.06.2015;2015;06;05;Tiistai;6;12;18;0;0;0
96;16.06.2015;2015;06;06;Tiistai;48;27;75;6;0;6
96;16.06.2015;2015;06;07;Tiistai;87;66;153;14;3;17
96;16.06.2015;2015;06;08;Tiistai;38;72;110;9;111;120
96;16.06.2015;2015;06;09;Tiistai;29;47;76;5;4;9
96;16.06.2015;2015;06;10;Tiistai;22;31;53;7;2;9
96;16.06.2015;2015;06;11;Tiistai;41;33;74;7;5;12
96;16.06.2015;2015;06;12;Tiistai;46;35;81;105;7;112
96;16.06.2015;2015;06;13;Tiistai;38;45;83;9;117;126
96;16.06.2015;2015;06;14;Tiistai;50;69;119;8;116;124
96;16.06.2015;2015;06;15;Tiistai;49;121;170;6;10;16
96;16.06.2015;2015;06;16;Tiistai;86;93;179;41;11;52
96;16.06.2015;2015;06;17;Tiistai;49;42;91;137;8;145
96;16.06.2015;2015;06;18;Tiistai;49;42;91;36;11;47
96;16.06.2015;2015;06;19;Tiistai;51;26;77;12;8;20
96;16.06.2015;2015;06;20;Tiistai;44;22;66;14;14;28
96;16.06.2015;2015;06;21;Tiistai;19;25;44;7;2;9
96;16.06.2015;2015;06;22;Tiistai;12;8;20;4;0;4
96;16.06.2015;2015;06;23;Tiistai;5;7;12;2;2;4
96;17.06.2015;2015;06;00;Keskiviikko;5;4;9;2;1;3
96;17.06.2015;2015;06;01;Keskiviikko;1;1;2;0;0;0
96;17.06.2015;2015;06;02;Keskiviikko;3;1;4;0;0;0
96;17.06.2015;2015;06;03;Keskiviikko;5;1;6;0;0;0
96;17.06.2015;2015;06;04;Keskiviikko;3;2;5;0;0;0
96;17.06.2015;2015;06;05;Keskiviikko;5;14;19;2;0;2
96;17.06.2015;2015;06;06;Keskiviikko;57;43;100;6;2;8
96;17.06.2015;2015;06;07;Keskiviikko;83;101;184;14;9;23
96;17.06.2015;2015;06;08;Keskiviikko;35;74;109;3;9;12
96;17.06.2015;2015;06;09;Keskiviikko;26;52;78;27;289;316
96;17.06.2015;2015;06;10;Keskiviikko;39;54;93;12;8;20
96;17.06.2015;2015;06;11;Keskiviikko;52;50;102;146;12;158
96;17.06.2015;2015;06;12;Keskiviikko;66;42;108;77;14;91
96;17.06.2015;2015;06;13;Keskiviikko;50;98;148;10;59;69
96;17.06.2015;2015;06;14;Keskiviikko;60;103;163;21;22;43
96;17.06.2015;2015;06;15;Keskiviikko;107;172;279;14;27;41
96;17.06.2015;2015;06;16;Keskiviikko;117;101;218;15;20;35
96;17.06.2015;2015;06;17;Keskiviikko;91;104;195;30;12;42
96;17.06.2015;2015;06;18;Keskiviikko;102;66;168;20;12;32
96;17.06.2015;2015;06;19;Keskiviikko;74;55;129;8;14;22
96;17.06.2015;2015;06;20;Keskiviikko;95;58;153;8;13;21
96;17.06.2015;2015;06;21;Keskiviikko;58;45;103;9;4;13
96;17.06.2015;2015;06;22;Keskiviikko;21;18;39;2;4;6
96;17.06.2015;2015;06;23;Keskiviikko;14;6;20;1;2;3
96;18.06.2015;2015;06;00;Torstai;6;4;10;1;4;5
96;18.06.2015;2015;06;01;Torstai;3;0;3;0;0;0
96;18.06.2015;2015;06;02;Torstai;3;0;3;1;0;1
96;18.06.2015;2015;06;03;Torstai;2;0;2;0;0;0
96;18.06.2015;2015;06;04;Torstai;5;1;6;1;0;1
96;18.06.2015;2015;06;05;Torstai;11;12;23;1;0;1
96;18.06.2015;2015;06;06;Torstai;59;38;97;5;4;9
96;18.06.2015;2015;06;07;Torstai;87;80;167;12;6;18
96;18.06.2015;2015;06;08;Torstai;40;80;120;5;8;13
96;18.06.2015;2015;06;09;Torstai;38;60;98;14;11;25
96;18.06.2015;2015;06;10;Torstai;35;45;80;7;9;16
96;18.06.2015;2015;06;11;Torstai;63;62;125;5;6;11
96;18.06.2015;2015;06;12;Torstai;55;81;136;6;13;19
96;18.06.2015;2015;06;13;Torstai;66;82;148;13;3;16
96;18.06.2015;2015;06;14;Torstai;80;108;188;2;14;16
96;18.06.2015;2015;06;15;Torstai;88;146;234;8;12;20
96;18.06.2015;2015;06;16;Torstai;73;85;158;14;6;20
96;18.06.2015;2015;06;17;Torstai;64;46;110;5;5;10
96;18.06.2015;2015;06;18;Torstai;53;36;89;5;8;13
96;18.06.2015;2015;06;19;Torstai;54;72;126;6;10;16
96;18.06.2015;2015;06;20;Torstai;82;34;116;10;9;19
96;18.06.2015;2015;06;21;Torstai;22;25;47;3;3;6
96;18.06.2015;2015;06;22;Torstai;7;17;24;3;3;6
96;18.06.2015;2015;06;23;Torstai;21;14;35;0;1;1
96;19.06.2015;2015;06;00;Perjantai;26;46;72;5;6;11
96;19.06.2015;2015;06;01;Perjantai;3;2;5;3;5;8
96;19.06.2015;2015;06;02;Perjantai;7;0;7;0;1;1
96;19.06.2015;2015;06;03;Perjantai;5;2;7;1;0;1
96;19.06.2015;2015;06;04;Perjantai;1;0;1;0;0;0
96;19.06.2015;2015;06;05;Perjantai;2;2;4;2;3;5
96;19.06.2015;2015;06;06;Perjantai;26;12;38;1;3;4
96;19.06.2015;2015;06;07;Perjantai;3;21;24;1;4;5
96;19.06.2015;2015;06;08;Perjantai;8;25;33;7;3;10
96;19.06.2015;2015;06;09;Perjantai;28;43;71;6;14;20
96;19.06.2015;2015;06;10;Perjantai;43;33;76;3;6;9
96;19.06.2015;2015;06;11;Perjantai;53;30;83;4;5;9
96;19.06.2015;2015;06;12;Perjantai;39;18;57;9;10;19
96;19.06.2015;2015;06;13;Perjantai;35;46;81;4;2;6
96;19.06.2015;2015;06;14;Perjantai;23;44;67;3;5;8
96;19.06.2015;2015;06;15;Perjantai;28;39;67;6;8;14
96;19.06.2015;2015;06;16;Perjantai;22;26;48;1;5;6
96;19.06.2015;2015;06;17;Perjantai;29;23;52;17;3;20
96;19.06.2015;2015;06;18;Perjantai;23;29;52;5;4;9
96;19.06.2015;2015;06;19;Perjantai;12;20;32;1;9;10
96;19.06.2015;2015;06;20;Perjantai;39;34;73;1;9;10
96;19.06.2015;2015;06;21;Perjantai;29;39;68;0;4;4
96;19.06.2015;2015;06;22;Perjantai;10;31;41;0;1;1
96;19.06.2015;2015;06;23;Perjantai;6;23;29;1;2;3
96;20.06.2015;2015;06;00;Lauantai;6;22;28;2;0;2
96;20.06.2015;2015;06;01;Lauantai;16;7;23;5;4;9
96;20.06.2015;2015;06;02;Lauantai;10;2;12;2;0;2
96;20.06.2015;2015;06;03;Lauantai;12;2;14;2;1;3
96;20.06.2015;2015;06;04;Lauantai;13;2;15;2;0;2
96;20.06.2015;2015;06;05;Lauantai;7;3;10;3;3;6
96;20.06.2015;2015;06;06;Lauantai;19;8;27;1;0;1
96;20.06.2015;2015;06;07;Lauantai;11;20;31;2;5;7
96;20.06.2015;2015;06;08;Lauantai;4;10;14;1;3;4
96;20.06.2015;2015;06;09;Lauantai;17;15;32;3;14;17
96;20.06.2015;2015;06;10;Lauantai;19;15;34;4;4;8
96;20.06.2015;2015;06;11;Lauantai;18;21;39;5;2;7
96;20.06.2015;2015;06;12;Lauantai;35;33;68;8;9;17
96;20.06.2015;2015;06;13;Lauantai;24;55;79;7;6;13
96;20.06.2015;2015;06;14;Lauantai;44;39;83;2;8;10
96;20.06.2015;2015;06;15;Lauantai;32;42;74;6;6;12
96;20.06.2015;2015;06;16;Lauantai;49;41;90;21;6;27
96;20.06.2015;2015;06;17;Lauantai;40;42;82;20;6;26
96;20.06.2015;2015;06;18;Lauantai;44;37;81;15;9;24
96;20.06.2015;2015;06;19;Lauantai;39;38;77;15;11;26
96;20.06.2015;2015;06;20;Lauantai;35;23;58;4;4;8
96;20.06.2015;2015;06;21;Lauantai;18;24;42;1;4;5
96;20.06.2015;2015;06;22;Lauantai;15;15;30;3;5;8
96;20.06.2015;2015;06;23;Lauantai;12;10;22;0;1;1
96;21.06.2015;2015;06;00;Sunnuntai;11;5;16;0;0;0
96;21.06.2015;2015;06;01;Sunnuntai;11;7;18;1;1;2
96;21.06.2015;2015;06;02;Sunnuntai;6;1;7;0;1;1
96;21.06.2015;2015;06;03;Sunnuntai;10;4;14;0;1;1
96;21.06.2015;2015;06;04;Sunnuntai;2;2;4;2;0;2
96;21.06.2015;2015;06;05;Sunnuntai;4;1;5;0;0;0
96;21.06.2015;2015;06;06;Sunnuntai;15;3;18;1;2;3
96;21.06.2015;2015;06;07;Sunnuntai;5;11;16;0;0;0
96;21.06.2015;2015;06;08;Sunnuntai;6;5;11;6;1;7
96;21.06.2015;2015;06;09;Sunnuntai;7;15;22;3;29;32
96;21.06.2015;2015;06;10;Sunnuntai;10;8;18;1;0;1
96;21.06.2015;2015;06;11;Sunnuntai;14;22;36;3;3;6
96;21.06.2015;2015;06;12;Sunnuntai;16;38;54;11;4;15
96;21.06.2015;2015;06;13;Sunnuntai;28;42;70;11;7;18
96;21.06.2015;2015;06;14;Sunnuntai;29;44;73;4;4;8
96;21.06.2015;2015;06;15;Sunnuntai;34;25;59;9;6;15
96;21.06.2015;2015;06;16;Sunnuntai;54;42;96;34;10;44
96;21.06.2015;2015;06;17;Sunnuntai;45;44;89;5;5;10
96;21.06.2015;2015;06;18;Sunnuntai;50;44;94;11;10;21
96;21.06.2015;2015;06;19;Sunnuntai;34;43;77;4;11;15
96;21.06.2015;2015;06;20;Sunnuntai;33;32;65;7;8;15
96;21.06.2015;2015;06;21;Sunnuntai;18;33;51;3;6;9
96;21.06.2015;2015;06;22;Sunnuntai;10;8;18;3;2;5
96;21.06.2015;2015;06;23;Sunnuntai;5;7;12;1;0;1
96;22.06.2015;2015;06;00;Maanantai;4;2;6;2;0;2
96;22.06.2015;2015;06;01;Maanantai;6;0;6;3;2;5
96;22.06.2015;2015;06;02;Maanantai;2;6;8;0;0;0
96;22.06.2015;2015;06;03;Maanantai;3;0;3;0;0;0
96;22.06.2015;2015;06;04;Maanantai;3;2;5;0;0;0
96;22.06.2015;2015;06;05;Maanantai;6;12;18;0;1;1
96;22.06.2015;2015;06;06;Maanantai;50;49;99;4;2;6
96;22.06.2015;2015;06;07;Maanantai;82;92;174;3;10;13
96;22.06.2015;2015;06;08;Maanantai;53;98;151;7;7;14
96;22.06.2015;2015;06;09;Maanantai;46;60;106;6;5;11
96;22.06.2015;2015;06;10;Maanantai;42;66;108;3;8;11
96;22.06.2015;2015;06;11;Maanantai;69;73;142;7;11;18
96;22.06.2015;2015;06;12;Maanantai;79;84;163;15;9;24
96;22.06.2015;2015;06;13;Maanantai;73;77;150;4;8;12
96;22.06.2015;2015;06;14;Maanantai;89;91;180;10;6;16
96;22.06.2015;2015;06;15;Maanantai;120;155;275;10;13;23
96;22.06.2015;2015;06;16;Maanantai;136;116;252;11;15;26
96;22.06.2015;2015;06;17;Maanantai;103;73;176;4;3;7
96;22.06.2015;2015;06;18;Maanantai;83;86;169;6;8;14
96;22.06.2015;2015;06;19;Maanantai;77;64;141;5;12;17
96;22.06.2015;2015;06;20;Maanantai;63;45;108;5;2;7
96;22.06.2015;2015;06;21;Maanantai;25;28;53;5;2;7
96;22.06.2015;2015;06;22;Maanantai;14;9;23;0;1;1
96;22.06.2015;2015;06;23;Maanantai;9;7;16;3;0;3
96;23.06.2015;2015;06;00;Tiistai;4;3;7;0;0;0
96;23.06.2015;2015;06;01;Tiistai;1;0;1;0;1;1
96;23.06.2015;2015;06;02;Tiistai;4;1;5;0;0;0
96;23.06.2015;2015;06;03;Tiistai;2;1;3;1;0;1
96;23.06.2015;2015;06;04;Tiistai;2;4;6;0;0;0
96;23.06.2015;2015;06;05;Tiistai;6;9;15;0;0;0
96;23.06.2015;2015;06;06;Tiistai;61;27;88;2;1;3
96;23.06.2015;2015;06;07;Tiistai;57;75;132;7;6;13
96;23.06.2015;2015;06;08;Tiistai;32;66;98;4;9;13
96;23.06.2015;2015;06;09;Tiistai;32;33;65;4;5;9
96;23.06.2015;2015;06;10;Tiistai;14;28;42;5;11;16
96;23.06.2015;2015;06;11;Tiistai;19;15;34;3;2;5
96;23.06.2015;2015;06;12;Tiistai;18;22;40;1;2;3
96;23.06.2015;2015;06;13;Tiistai;22;19;41;4;0;4
96;23.06.2015;2015;06;14;Tiistai;24;33;57;2;6;8
96;23.06.2015;2015;06;15;Tiistai;56;95;151;5;8;13
96;23.06.2015;2015;06;16;Tiistai;59;49;108;5;12;17
96;23.06.2015;2015;06;17;Tiistai;39;30;69;1;2;3
96;23.06.2015;2015;06;18;Tiistai;25;22;47;2;1;3
96;23.06.2015;2015;06;19;Tiistai;23;18;41;3;3;6
96;23.06.2015;2015;06;20;Tiistai;21;11;32;3;3;6
96;23.06.2015;2015;06;21;Tiistai;9;20;29;2;3;5
96;23.06.2015;2015;06;22;Tiistai;6;3;9;0;5;5
96;23.06.2015;2015;06;23;Tiistai;4;3;7;1;1;2
96;24.06.2015;2015;06;00;Keskiviikko;2;3;5;1;1;2
96;24.06.2015;2015;06;01;Keskiviikko;1;1;2;0;1;1
96;24.06.2015;2015;06;02;Keskiviikko;2;1;3;1;0;1
96;24.06.2015;2015;06;03;Keskiviikko;0;0;0;0;0;0
96;24.06.2015;2015;06;04;Keskiviikko;4;1;5;1;0;1
96;24.06.2015;2015;06;05;Keskiviikko;6;9;15;0;0;0
96;24.06.2015;2015;06;06;Keskiviikko;55;37;92;3;0;3
96;24.06.2015;2015;06;07;Keskiviikko;65;79;144;11;4;15
96;24.06.2015;2015;06;08;Keskiviikko;28;67;95;9;5;14
96;24.06.2015;2015;06;09;Keskiviikko;37;49;86;4;11;15
96;24.06.2015;2015;06;10;Keskiviikko;24;57;81;7;7;14
96;24.06.2015;2015;06;11;Keskiviikko;47;36;83;7;9;16
96;24.06.2015;2015;06;12;Keskiviikko;36;55;91;4;8;12
96;24.06.2015;2015;06;13;Keskiviikko;40;36;76;4;7;11
96;24.06.2015;2015;06;14;Keskiviikko;47;40;87;3;5;8
96;24.06.2015;2015;06;15;Keskiviikko;59;94;153;4;11;15
96;24.06.2015;2015;06;16;Keskiviikko;55;63;118;6;6;12
96;24.06.2015;2015;06;17;Keskiviikko;34;38;72;2;3;5
96;24.06.2015;2015;06;18;Keskiviikko;37;26;63;3;5;8
96;24.06.2015;2015;06;19;Keskiviikko;31;35;66;15;5;20
96;24.06.2015;2015;06;20;Keskiviikko;33;27;60;2;11;13
96;24.06.2015;2015;06;21;Keskiviikko;23;25;48;9;3;12
96;24.06.2015;2015;06;22;Keskiviikko;14;8;22;4;3;7
96;24.06.2015;2015;06;23;Keskiviikko;2;11;13;1;1;2
96;25.06.2015;2015;06;00;Torstai;3;4;7;2;0;2
96;25.06.2015;2015;06;01;Torstai;0;0;0;1;0;1
96;25.06.2015;2015;06;02;Torstai;2;1;3;1;0;1
96;25.06.2015;2015;06;03;Torstai;5;0;5;1;0;1
96;25.06.2015;2015;06;04;Torstai;6;0;6;0;0;0
96;25.06.2015;2015;06;05;Torstai;7;7;14;0;2;2
96;25.06.2015;2015;06;06;Torstai;49;29;78;4;0;4
96;25.06.2015;2015;06;07;Torstai;59;54;113;6;0;6
96;25.06.2015;2015;06;08;Torstai;24;39;63;2;2;4
96;25.06.2015;2015;06;09;Torstai;19;33;52;4;4;8
96;25.06.2015;2015;06;10;Torstai;18;13;31;0;3;3
96;25.06.2015;2015;06;11;Torstai;24;26;50;2;5;7
96;25.06.2015;2015;06;12;Torstai;32;28;60;2;2;4
96;25.06.2015;2015;06;13;Torstai;30;31;61;4;4;8
96;25.06.2015;2015;06;14;Torstai;25;35;60;1;2;3
96;25.06.2015;2015;06;15;Torstai;47;116;163;7;8;15
96;25.06.2015;2015;06;16;Torstai;46;59;105;5;14;19
96;25.06.2015;2015;06;17;Torstai;31;42;73;6;3;9
96;25.06.2015;2015;06;18;Torstai;42;34;76;7;3;10
96;25.06.2015;2015;06;19;Torstai;33;33;66;7;7;14
96;25.06.2015;2015;06;20;Torstai;29;28;57;6;4;10
96;25.06.2015;2015;06;21;Torstai;20;23;43;7;11;18
96;25.06.2015;2015;06;22;Torstai;4;8;12;4;6;10
96;25.06.2015;2015;06;23;Torstai;10;3;13;2;3;5
96;26.06.2015;2015;06;00;Perjantai;9;10;19;0;4;4
96;26.06.2015;2015;06;01;Perjantai;4;0;4;2;0;2
96;26.06.2015;2015;06;02;Perjantai;1;1;2;0;0;0
96;26.06.2015;2015;06;03;Perjantai;3;0;3;1;0;1
96;26.06.2015;2015;06;04;Perjantai;3;1;4;2;0;2
96;26.06.2015;2015;06;05;Perjantai;3;8;11;1;1;2
96;26.06.2015;2015;06;06;Perjantai;57;35;92;4;2;6
96;26.06.2015;2015;06;07;Perjantai;64;72;136;10;3;13
96;26.06.2015;2015;06;08;Perjantai;36;51;87;5;5;10
96;26.06.2015;2015;06;09;Perjantai;20;56;76;2;7;9
96;26.06.2015;2015;06;10;Perjantai;23;51;74;5;6;11
96;26.06.2015;2015;06;11;Perjantai;39;46;85;6;4;10
96;26.06.2015;2015;06;12;Perjantai;48;46;94;4;3;7
96;26.06.2015;2015;06;13;Perjantai;53;73;126;8;3;11
96;26.06.2015;2015;06;14;Perjantai;53;76;129;5;4;9
96;26.06.2015;2015;06;15;Perjantai;74;108;182;7;18;25
96;26.06.2015;2015;06;16;Perjantai;69;77;146;5;3;8
96;26.06.2015;2015;06;17;Perjantai;44;58;102;7;4;11
96;26.06.2015;2015;06;18;Perjantai;37;47;84;7;3;10
96;26.06.2015;2015;06;19;Perjantai;20;29;49;5;1;6
96;26.06.2015;2015;06;20;Perjantai;35;33;68;6;7;13
96;26.06.2015;2015;06;21;Perjantai;23;34;57;4;6;10
96;26.06.2015;2015;06;22;Perjantai;14;24;38;1;3;4
96;26.06.2015;2015;06;23;Perjantai;21;14;35;1;1;2
96;27.06.2015;2015;06;00;Lauantai;12;6;18;2;3;5
96;27.06.2015;2015;06;01;Lauantai;9;5;14;1;1;2
96;27.06.2015;2015;06;02;Lauantai;12;1;13;1;0;1
96;27.06.2015;2015;06;03;Lauantai;7;0;7;3;1;4
96;27.06.2015;2015;06;04;Lauantai;10;6;16;0;0;0
96;27.06.2015;2015;06;05;Lauantai;5;3;8;0;0;0
96;27.06.2015;2015;06;06;Lauantai;17;10;27;3;1;4
96;27.06.2015;2015;06;07;Lauantai;4;14;18;0;1;1
96;27.06.2015;2015;06;08;Lauantai;8;21;29;4;3;7
96;27.06.2015;2015;06;09;Lauantai;18;28;46;2;6;8
96;27.06.2015;2015;06;10;Lauantai;25;28;53;4;3;7
96;27.06.2015;2015;06;11;Lauantai;36;37;73;6;4;10
96;27.06.2015;2015;06;12;Lauantai;30;49;79;4;5;9
96;27.06.2015;2015;06;13;Lauantai;37;48;85;7;4;11
96;27.06.2015;2015;06;14;Lauantai;40;50;90;4;2;6
96;27.06.2015;2015;06;15;Lauantai;58;39;97;7;7;14
96;27.06.2015;2015;06;16;Lauantai;29;24;53;4;7;11
96;27.06.2015;2015;06;17;Lauantai;36;26;62;4;0;4
96;27.06.2015;2015;06;18;Lauantai;25;33;58;2;4;6
96;27.06.2015;2015;06;19;Lauantai;18;12;30;5;5;10
96;27.06.2015;2015;06;20;Lauantai;25;28;53;4;3;7
96;27.06.2015;2015;06;21;Lauantai;9;22;31;4;2;6
96;27.06.2015;2015;06;22;Lauantai;8;15;23;2;2;4
96;27.06.2015;2015;06;23;Lauantai;4;17;21;2;1;3
96;28.06.2015;2015;06;00;Sunnuntai;11;11;22;1;3;4
96;28.06.2015;2015;06;01;Sunnuntai;6;6;12;1;0;1
96;28.06.2015;2015;06;02;Sunnuntai;11;3;14;3;3;6
96;28.06.2015;2015;06;03;Sunnuntai;15;0;15;2;0;2
96;28.06.2015;2015;06;04;Sunnuntai;5;0;5;1;0;1
96;28.06.2015;2015;06;05;Sunnuntai;2;0;2;1;2;3
96;28.06.2015;2015;06;06;Sunnuntai;24;11;35;4;0;4
96;28.06.2015;2015;06;07;Sunnuntai;2;9;11;2;0;2
96;28.06.2015;2015;06;08;Sunnuntai;7;6;13;0;4;4
96;28.06.2015;2015;06;09;Sunnuntai;15;11;26;3;3;6
96;28.06.2015;2015;06;10;Sunnuntai;18;18;36;3;3;6
96;28.06.2015;2015;06;11;Sunnuntai;23;52;75;10;6;16
96;28.06.2015;2015;06;12;Sunnuntai;56;78;134;4;5;9
96;28.06.2015;2015;06;13;Sunnuntai;48;45;93;3;10;13
96;28.06.2015;2015;06;14;Sunnuntai;49;51;100;7;6;13
96;28.06.2015;2015;06;15;Sunnuntai;53;46;99;18;8;26
96;28.06.2015;2015;06;16;Sunnuntai;56;60;116;70;8;78
96;28.06.2015;2015;06;17;Sunnuntai;77;53;130;75;3;78
96;28.06.2015;2015;06;18;Sunnuntai;57;36;93;61;7;68
96;28.06.2015;2015;06;19;Sunnuntai;40;44;84;53;7;60
96;28.06.2015;2015;06;20;Sunnuntai;28;25;53;11;8;19
96;28.06.2015;2015;06;21;Sunnuntai;24;33;57;3;7;10
96;28.06.2015;2015;06;22;Sunnuntai;14;12;26;3;4;7
96;28.06.2015;2015;06;23;Sunnuntai;11;3;14;2;0;2
96;29.06.2015;2015;06;00;Maanantai;7;4;11;1;3;4
96;29.06.2015;2015;06;01;Maanantai;8;4;12;1;2;3
96;29.06.2015;2015;06;02;Maanantai;1;2;3;0;0;0
96;29.06.2015;2015;06;03;Maanantai;4;1;5;2;1;3
96;29.06.2015;2015;06;04;Maanantai;3;1;4;1;0;1
96;29.06.2015;2015;06;05;Maanantai;9;9;18;0;0;0
96;29.06.2015;2015;06;06;Maanantai;57;31;88;5;3;8
96;29.06.2015;2015;06;07;Maanantai;73;99;172;12;4;16
96;29.06.2015;2015;06;08;Maanantai;41;90;131;14;3;17
96;29.06.2015;2015;06;09;Maanantai;34;45;79;49;3;52
96;29.06.2015;2015;06;10;Maanantai;32;74;106;14;9;23
96;29.06.2015;2015;06;11;Maanantai;56;53;109;37;12;49
96;29.06.2015;2015;06;12;Maanantai;67;72;139;28;6;34
96;29.06.2015;2015;06;13;Maanantai;97;67;164;8;6;14
96;29.06.2015;2015;06;14;Maanantai;75;102;177;19;9;28
96;29.06.2015;2015;06;15;Maanantai;117;148;265;21;19;40
96;29.06.2015;2015;06;16;Maanantai;101;122;223;19;17;36
96;29.06.2015;2015;06;17;Maanantai;94;82;176;5;9;14
96;29.06.2015;2015;06;18;Maanantai;79;71;150;11;5;16
96;29.06.2015;2015;06;19;Maanantai;68;44;112;9;10;19
96;29.06.2015;2015;06;20;Maanantai;56;33;89;6;6;12
96;29.06.2015;2015;06;21;Maanantai;39;33;72;0;1;1
96;29.06.2015;2015;06;22;Maanantai;17;23;40;0;1;1
96;29.06.2015;2015;06;23;Maanantai;5;7;12;1;1;2
96;30.06.2015;2015;06;00;Tiistai;7;3;10;0;2;2
96;30.06.2015;2015;06;01;Tiistai;0;1;1;1;0;1
96;30.06.2015;2015;06;02;Tiistai;1;1;2;0;0;0
96;30.06.2015;2015;06;03;Tiistai;0;0;0;0;0;0
96;30.06.2015;2015;06;04;Tiistai;2;1;3;1;0;1
96;30.06.2015;2015;06;05;Tiistai;5;7;12;1;2;3
96;30.06.2015;2015;06;06;Tiistai;54;36;90;3;1;4
96;30.06.2015;2015;06;07;Tiistai;54;80;134;7;3;10
96;30.06.2015;2015;06;08;Tiistai;30;81;111;2;4;6
96;30.06.2015;2015;06;09;Tiistai;24;63;87;1;3;4
96;30.06.2015;2015;06;10;Tiistai;27;49;76;2;8;10
96;30.06.2015;2015;06;11;Tiistai;27;38;65;8;4;12
96;30.06.2015;2015;06;12;Tiistai;45;46;91;4;4;8
96;30.06.2015;2015;06;13;Tiistai;49;60;109;2;5;7
96;30.06.2015;2015;06;14;Tiistai;53;85;138;2;9;11
96;30.06.2015;2015;06;15;Tiistai;95;143;238;6;16;22
96;30.06.2015;2015;06;16;Tiistai;59;91;150;5;7;12
96;30.06.2015;2015;06;17;Tiistai;69;80;149;8;2;10
96;30.06.2015;2015;06;18;Tiistai;58;42;100;7;2;9
96;30.06.2015;2015;06;19;Tiistai;45;49;94;11;11;22
96;30.06.2015;2015;06;20;Tiistai;85;35;120;10;11;21
96;30.06.2015;2015;06;21;Tiistai;27;36;63;5;4;9
96;30.06.2015;2015;06;22;Tiistai;11;13;24;1;2;3
96;30.06.2015;2015;06;23;Tiistai;8;17;25;1;2;3
96;01.07.2015;2015;07;00;Keskiviikko;11;6;17;0;0;0
96;01.07.2015;2015;07;01;Keskiviikko;8;0;8;0;1;1
96;01.07.2015;2015;07;02;Keskiviikko;3;3;6;0;0;0
96;01.07.2015;2015;07;03;Keskiviikko;3;0;3;0;0;0
96;01.07.2015;2015;07;04;Keskiviikko;3;5;8;1;3;4
96;01.07.2015;2015;07;05;Keskiviikko;9;9;18;0;0;0
96;01.07.2015;2015;07;06;Keskiviikko;60;48;108;7;3;10
96;01.07.2015;2015;07;07;Keskiviikko;77;86;163;11;8;19
96;01.07.2015;2015;07;08;Keskiviikko;51;80;131;5;10;15
96;01.07.2015;2015;07;09;Keskiviikko;57;62;119;11;5;16
96;01.07.2015;2015;07;10;Keskiviikko;42;68;110;7;11;18
96;01.07.2015;2015;07;11;Keskiviikko;63;64;127;13;3;16
96;01.07.2015;2015;07;12;Keskiviikko;68;75;143;25;2;27
96;01.07.2015;2015;07;13;Keskiviikko;83;71;154;12;2;14
96;01.07.2015;2015;07;14;Keskiviikko;81;103;184;5;7;12
96;01.07.2015;2015;07;15;Keskiviikko;143;186;329;14;18;32
96;01.07.2015;2015;07;16;Keskiviikko;120;122;242;8;9;17
96;01.07.2015;2015;07;17;Keskiviikko;101;85;186;17;7;24
96;01.07.2015;2015;07;18;Keskiviikko;99;63;162;18;6;24
96;01.07.2015;2015;07;19;Keskiviikko;76;54;130;12;13;25
96;01.07.2015;2015;07;20;Keskiviikko;78;51;129;8;6;14
96;01.07.2015;2015;07;21;Keskiviikko;46;57;103;6;9;15
96;01.07.2015;2015;07;22;Keskiviikko;29;26;55;7;0;7
96;01.07.2015;2015;07;23;Keskiviikko;17;22;39;2;0;2
96;02.07.2015;2015;07;00;Torstai;8;4;12;0;0;0
96;02.07.2015;2015;07;01;Torstai;6;1;7;0;1;1
96;02.07.2015;2015;07;02;Torstai;7;3;10;0;0;0
96;02.07.2015;2015;07;03;Torstai;8;1;9;0;0;0
96;02.07.2015;2015;07;04;Torstai;5;4;9;0;0;0
96;02.07.2015;2015;07;05;Torstai;9;11;20;2;1;3
96;02.07.2015;2015;07;06;Torstai;55;44;99;4;1;5
96;02.07.2015;2015;07;07;Torstai;53;84;137;4;3;7
96;02.07.2015;2015;07;08;Torstai;39;89;128;7;4;11
96;02.07.2015;2015;07;09;Torstai;35;49;84;2;1;3
96;02.07.2015;2015;07;10;Torstai;27;57;84;7;8;15
96;02.07.2015;2015;07;11;Torstai;49;52;101;6;8;14
96;02.07.2015;2015;07;12;Torstai;72;86;158;5;9;14
96;02.07.2015;2015;07;13;Torstai;72;74;146;4;8;12
96;02.07.2015;2015;07;14;Torstai;79;76;155;7;11;18
96;02.07.2015;2015;07;15;Torstai;108;177;285;3;11;14
96;02.07.2015;2015;07;16;Torstai;114;111;225;7;9;16
96;02.07.2015;2015;07;17;Torstai;75;65;140;2;2;4
96;02.07.2015;2015;07;18;Torstai;50;45;95;4;6;10
96;02.07.2015;2015;07;19;Torstai;39;19;58;2;3;5
96;02.07.2015;2015;07;20;Torstai;37;12;49;0;2;2
96;02.07.2015;2015;07;21;Torstai;33;15;48;2;2;4
96;02.07.2015;2015;07;22;Torstai;16;10;26;1;3;4
96;02.07.2015;2015;07;23;Torstai;2;8;10;2;1;3
96;03.07.2015;2015;07;00;Perjantai;10;5;15;1;1;2
96;03.07.2015;2015;07;01;Perjantai;6;1;7;0;0;0
96;03.07.2015;2015;07;02;Perjantai;2;1;3;1;1;2
96;03.07.2015;2015;07;03;Perjantai;3;3;6;0;1;1
96;03.07.2015;2015;07;04;Perjantai;2;1;3;1;1;2
96;03.07.2015;2015;07;05;Perjantai;5;5;10;0;1;1
96;03.07.2015;2015;07;06;Perjantai;43;33;76;4;4;8
96;03.07.2015;2015;07;07;Perjantai;55;74;129;6;7;13
96;03.07.2015;2015;07;08;Perjantai;33;83;116;5;4;9
96;03.07.2015;2015;07;09;Perjantai;24;49;73;8;2;10
96;03.07.2015;2015;07;10;Perjantai;33;56;89;8;4;12
96;03.07.2015;2015;07;11;Perjantai;46;72;118;3;3;6
96;03.07.2015;2015;07;12;Perjantai;76;68;144;7;5;12
96;03.07.2015;2015;07;13;Perjantai;79;107;186;3;3;6
96;03.07.2015;2015;07;14;Perjantai;88;105;193;6;18;24
96;03.07.2015;2015;07;15;Perjantai;104;123;227;7;13;20
96;03.07.2015;2015;07;16;Perjantai;95;91;186;9;6;15
96;03.07.2015;2015;07;17;Perjantai;94;83;177;8;7;15
96;03.07.2015;2015;07;18;Perjantai;58;59;117;8;6;14
96;03.07.2015;2015;07;19;Perjantai;60;40;100;6;6;12
96;03.07.2015;2015;07;20;Perjantai;39;24;63;2;4;6
96;03.07.2015;2015;07;21;Perjantai;27;27;54;0;2;2
96;03.07.2015;2015;07;22;Perjantai;12;11;23;0;1;1
96;03.07.2015;2015;07;23;Perjantai;13;8;21;1;0;1
96;04.07.2015;2015;07;00;Lauantai;11;6;17;1;1;2
96;04.07.2015;2015;07;01;Lauantai;8;2;10;1;1;2
96;04.07.2015;2015;07;02;Lauantai;14;2;16;1;6;7
96;04.07.2015;2015;07;03;Lauantai;15;1;16;1;0;1
96;04.07.2015;2015;07;04;Lauantai;9;2;11;0;0;0
96;04.07.2015;2015;07;05;Lauantai;3;5;8;0;2;2
96;04.07.2015;2015;07;06;Lauantai;24;6;30;0;0;0
96;04.07.2015;2015;07;07;Lauantai;4;12;16;0;0;0
96;04.07.2015;2015;07;08;Lauantai;10;14;24;2;2;4
96;04.07.2015;2015;07;09;Lauantai;8;14;22;1;0;1
96;04.07.2015;2015;07;10;Lauantai;12;20;32;3;3;6
96;04.07.2015;2015;07;11;Lauantai;24;25;49;2;4;6
96;04.07.2015;2015;07;12;Lauantai;33;23;56;4;4;8
96;04.07.2015;2015;07;13;Lauantai;19;25;44;7;3;10
96;04.07.2015;2015;07;14;Lauantai;20;49;69;1;5;6
96;04.07.2015;2015;07;15;Lauantai;28;42;70;4;7;11
96;04.07.2015;2015;07;16;Lauantai;32;36;68;12;5;17
96;04.07.2015;2015;07;17;Lauantai;36;34;70;7;8;15
96;04.07.2015;2015;07;18;Lauantai;34;39;73;8;3;11
96;04.07.2015;2015;07;19;Lauantai;22;23;45;4;10;14
96;04.07.2015;2015;07;20;Lauantai;27;16;43;1;5;6
96;04.07.2015;2015;07;21;Lauantai;12;31;43;0;3;3
96;04.07.2015;2015;07;22;Lauantai;11;24;35;1;1;2
96;04.07.2015;2015;07;23;Lauantai;13;16;29;0;0;0
96;05.07.2015;2015;07;00;Sunnuntai;13;16;29;0;2;2
96;05.07.2015;2015;07;01;Sunnuntai;9;3;12;1;2;3
96;05.07.2015;2015;07;02;Sunnuntai;23;1;24;2;1;3
96;05.07.2015;2015;07;03;Sunnuntai;26;2;28;2;0;2
96;05.07.2015;2015;07;04;Sunnuntai;12;1;13;6;2;8
96;05.07.2015;2015;07;05;Sunnuntai;5;1;6;2;0;2
96;05.07.2015;2015;07;06;Sunnuntai;19;8;27;0;0;0
96;05.07.2015;2015;07;07;Sunnuntai;7;12;19;1;1;2
96;05.07.2015;2015;07;08;Sunnuntai;7;10;17;4;2;6
96;05.07.2015;2015;07;09;Sunnuntai;9;21;30;9;1;10
96;05.07.2015;2015;07;10;Sunnuntai;20;11;31;3;5;8
96;05.07.2015;2015;07;11;Sunnuntai;23;37;60;4;5;9
96;05.07.2015;2015;07;12;Sunnuntai;31;54;85;4;11;15
96;05.07.2015;2015;07;13;Sunnuntai;39;53;92;6;11;17
96;05.07.2015;2015;07;14;Sunnuntai;58;72;130;9;5;14
96;05.07.2015;2015;07;15;Sunnuntai;62;80;142;14;11;25
96;05.07.2015;2015;07;16;Sunnuntai;59;49;108;28;14;42
96;05.07.2015;2015;07;17;Sunnuntai;57;44;101;12;5;17
96;05.07.2015;2015;07;18;Sunnuntai;75;42;117;20;14;34
96;05.07.2015;2015;07;19;Sunnuntai;43;50;93;7;11;18
96;05.07.2015;2015;07;20;Sunnuntai;40;43;83;6;4;10
96;05.07.2015;2015;07;21;Sunnuntai;30;35;65;1;1;2
96;05.07.2015;2015;07;22;Sunnuntai;19;13;32;5;2;7
96;05.07.2015;2015;07;23;Sunnuntai;13;4;17;0;0;0
96;06.07.2015;2015;07;00;Maanantai;11;9;20;0;0;0
96;06.07.2015;2015;07;01;Maanantai;4;2;6;1;2;3
96;06.07.2015;2015;07;02;Maanantai;2;4;6;2;0;2
96;06.07.2015;2015;07;03;Maanantai;8;0;8;0;0;0
96;06.07.2015;2015;07;04;Maanantai;5;4;9;0;1;1
96;06.07.2015;2015;07;05;Maanantai;8;8;16;0;2;2
96;06.07.2015;2015;07;06;Maanantai;46;37;83;3;2;5
96;06.07.2015;2015;07;07;Maanantai;66;73;139;12;6;18
96;06.07.2015;2015;07;08;Maanantai;41;66;107;6;3;9
96;06.07.2015;2015;07;09;Maanantai;37;54;91;1;6;7
96;06.07.2015;2015;07;10;Maanantai;32;46;78;6;4;10
96;06.07.2015;2015;07;11;Maanantai;55;74;129;4;8;12
96;06.07.2015;2015;07;12;Maanantai;61;71;132;3;9;12
96;06.07.2015;2015;07;13;Maanantai;68;60;128;6;4;10
96;06.07.2015;2015;07;14;Maanantai;54;92;146;8;8;16
96;06.07.2015;2015;07;15;Maanantai;89;138;227;13;14;27
96;06.07.2015;2015;07;16;Maanantai;107;107;214;8;15;23
96;06.07.2015;2015;07;17;Maanantai;89;54;143;34;11;45
96;06.07.2015;2015;07;18;Maanantai;72;57;129;19;6;25
96;06.07.2015;2015;07;19;Maanantai;78;48;126;16;10;26
96;06.07.2015;2015;07;20;Maanantai;63;45;108;10;5;15
96;06.07.2015;2015;07;21;Maanantai;29;57;86;4;3;7
96;06.07.2015;2015;07;22;Maanantai;14;22;36;3;2;5
96;06.07.2015;2015;07;23;Maanantai;12;6;18;2;1;3
96;07.07.2015;2015;07;00;Tiistai;11;6;17;1;2;3
96;07.07.2015;2015;07;01;Tiistai;4;3;7;4;0;4
96;07.07.2015;2015;07;02;Tiistai;9;1;10;0;1;1
96;07.07.2015;2015;07;03;Tiistai;3;6;9;1;1;2
96;07.07.2015;2015;07;04;Tiistai;2;2;4;0;1;1
96;07.07.2015;2015;07;05;Tiistai;11;8;19;0;1;1
96;07.07.2015;2015;07;06;Tiistai;38;34;72;6;2;8
96;07.07.2015;2015;07;07;Tiistai;72;77;149;8;2;10
96;07.07.2015;2015;07;08;Tiistai;33;72;105;4;3;7
96;07.07.2015;2015;07;09;Tiistai;34;54;88;2;2;4
96;07.07.2015;2015;07;10;Tiistai;26;45;71;2;6;8
96;07.07.2015;2015;07;11;Tiistai;37;53;90;4;6;10
96;07.07.2015;2015;07;12;Tiistai;52;66;118;5;6;11
96;07.07.2015;2015;07;13;Tiistai;54;65;119;2;6;8
96;07.07.2015;2015;07;14;Tiistai;65;77;142;6;2;8
96;07.07.2015;2015;07;15;Tiistai;82;154;236;7;9;16
96;07.07.2015;2015;07;16;Tiistai;89;90;179;6;5;11
96;07.07.2015;2015;07;17;Tiistai;81;63;144;11;10;21
96;07.07.2015;2015;07;18;Tiistai;67;50;117;15;10;25
96;07.07.2015;2015;07;19;Tiistai;48;44;92;8;9;17
96;07.07.2015;2015;07;20;Tiistai;65;37;102;6;3;9
96;07.07.2015;2015;07;21;Tiistai;42;51;93;6;5;11
96;07.07.2015;2015;07;22;Tiistai;16;13;29;2;3;5
96;07.07.2015;2015;07;23;Tiistai;11;9;20;4;2;6
96;08.07.2015;2015;07;00;Keskiviikko;8;3;11;0;2;2
96;08.07.2015;2015;07;01;Keskiviikko;5;5;10;1;0;1
96;08.07.2015;2015;07;02;Keskiviikko;10;1;11;0;0;0
96;08.07.2015;2015;07;03;Keskiviikko;5;2;7;2;0;2
96;08.07.2015;2015;07;04;Keskiviikko;4;4;8;0;0;0
96;08.07.2015;2015;07;05;Keskiviikko;10;11;21;1;1;2
96;08.07.2015;2015;07;06;Keskiviikko;57;35;92;5;2;7
96;08.07.2015;2015;07;07;Keskiviikko;56;82;138;8;2;10
96;08.07.2015;2015;07;08;Keskiviikko;20;69;89;5;7;12
96;08.07.2015;2015;07;09;Keskiviikko;26;45;71;1;2;3
96;08.07.2015;2015;07;10;Keskiviikko;23;46;69;5;7;12
96;08.07.2015;2015;07;11;Keskiviikko;39;41;80;4;6;10
96;08.07.2015;2015;07;12;Keskiviikko;41;39;80;2;1;3
96;08.07.2015;2015;07;13;Keskiviikko;50;65;115;3;5;8
96;08.07.2015;2015;07;14;Keskiviikko;61;69;130;2;3;5
96;08.07.2015;2015;07;15;Keskiviikko;71;136;207;3;19;22
96;08.07.2015;2015;07;16;Keskiviikko;83;107;190;9;9;18
96;08.07.2015;2015;07;17;Keskiviikko;67;74;141;6;3;9
96;08.07.2015;2015;07;18;Keskiviikko;58;50;108;10;9;19
96;08.07.2015;2015;07;19;Keskiviikko;36;38;74;5;6;11
96;08.07.2015;2015;07;20;Keskiviikko;39;30;69;11;12;23
96;08.07.2015;2015;07;21;Keskiviikko;25;35;60;7;6;13
96;08.07.2015;2015;07;22;Keskiviikko;26;15;41;1;1;2
96;08.07.2015;2015;07;23;Keskiviikko;13;16;29;3;2;5
96;09.07.2015;2015;07;00;Torstai;12;3;15;2;1;3
96;09.07.2015;2015;07;01;Torstai;11;3;14;0;0;0
96;09.07.2015;2015;07;02;Torstai;4;3;7;2;0;2
96;09.07.2015;2015;07;03;Torstai;6;3;9;0;1;1
96;09.07.2015;2015;07;04;Torstai;3;4;7;2;1;3
96;09.07.2015;2015;07;05;Torstai;8;5;13;0;0;0
96;09.07.2015;2015;07;06;Torstai;44;22;66;2;3;5
96;09.07.2015;2015;07;07;Torstai;39;49;88;8;0;8
96;09.07.2015;2015;07;08;Torstai;25;43;68;1;3;4
96;09.07.2015;2015;07;09;Torstai;27;37;64;2;2;4
96;09.07.2015;2015;07;10;Torstai;20;23;43;3;9;12
96;09.07.2015;2015;07;11;Torstai;37;27;64;1;3;4
96;09.07.2015;2015;07;12;Torstai;32;26;58;2;1;3
96;09.07.2015;2015;07;13;Torstai;25;23;48;0;4;4
96;09.07.2015;2015;07;14;Torstai;29;29;58;2;2;4
96;09.07.2015;2015;07;15;Torstai;28;71;99;0;6;6
96;09.07.2015;2015;07;16;Torstai;43;50;93;0;7;7
96;09.07.2015;2015;07;17;Torstai;30;41;71;5;5;10
96;09.07.2015;2015;07;18;Torstai;23;30;53;4;6;10
96;09.07.2015;2015;07;19;Torstai;28;26;54;4;6;10
96;09.07.2015;2015;07;20;Torstai;40;18;58;2;3;5
96;09.07.2015;2015;07;21;Torstai;19;21;40;2;3;5
96;09.07.2015;2015;07;22;Torstai;6;11;17;1;3;4
96;09.07.2015;2015;07;23;Torstai;7;7;14;1;0;1
96;10.07.2015;2015;07;00;Perjantai;7;4;11;0;1;1
96;10.07.2015;2015;07;01;Perjantai;2;0;2;2;0;2
96;10.07.2015;2015;07;02;Perjantai;0;0;0;0;0;0
96;10.07.2015;2015;07;03;Perjantai;5;0;5;0;0;0
96;10.07.2015;2015;07;04;Perjantai;3;1;4;0;1;1
96;10.07.2015;2015;07;05;Perjantai;6;6;12;0;0;0
96;10.07.2015;2015;07;06;Perjantai;37;24;61;4;1;5
96;10.07.2015;2015;07;07;Perjantai;43;55;98;11;4;15
96;10.07.2015;2015;07;08;Perjantai;18;46;64;3;3;6
96;10.07.2015;2015;07;09;Perjantai;24;34;58;4;3;7
96;10.07.2015;2015;07;10;Perjantai;20;53;73;2;4;6
96;10.07.2015;2015;07;11;Perjantai;33;64;97;3;5;8
96;10.07.2015;2015;07;12;Perjantai;52;53;105;4;4;8
96;10.07.2015;2015;07;13;Perjantai;48;64;112;3;7;10
96;10.07.2015;2015;07;14;Perjantai;58;77;135;9;3;12
96;10.07.2015;2015;07;15;Perjantai;56;100;156;13;16;29
96;10.07.2015;2015;07;16;Perjantai;74;75;149;6;6;12
96;10.07.2015;2015;07;17;Perjantai;45;52;97;4;6;10
96;10.07.2015;2015;07;18;Perjantai;37;60;97;6;9;15
96;10.07.2015;2015;07;19;Perjantai;26;52;78;28;6;34
96;10.07.2015;2015;07;20;Perjantai;36;34;70;7;5;12
96;10.07.2015;2015;07;21;Perjantai;20;34;54;2;4;6
96;10.07.2015;2015;07;22;Perjantai;25;36;61;1;2;3
96;10.07.2015;2015;07;23;Perjantai;9;19;28;0;5;5
96;11.07.2015;2015;07;00;Lauantai;24;7;31;2;0;2
96;11.07.2015;2015;07;01;Lauantai;15;8;23;5;0;5
96;11.07.2015;2015;07;02;Lauantai;28;4;32;2;0;2
96;11.07.2015;2015;07;03;Lauantai;13;7;20;1;1;2
96;11.07.2015;2015;07;04;Lauantai;12;6;18;2;1;3
96;11.07.2015;2015;07;05;Lauantai;3;4;7;1;0;1
96;11.07.2015;2015;07;06;Lauantai;18;12;30;3;1;4
96;11.07.2015;2015;07;07;Lauantai;10;15;25;5;2;7
96;11.07.2015;2015;07;08;Lauantai;14;21;35;3;3;6
96;11.07.2015;2015;07;09;Lauantai;14;24;38;3;2;5
96;11.07.2015;2015;07;10;Lauantai;16;36;52;0;5;5
96;11.07.2015;2015;07;11;Lauantai;39;53;92;6;8;14
96;11.07.2015;2015;07;12;Lauantai;54;66;120;3;7;10
96;11.07.2015;2015;07;13;Lauantai;52;67;119;3;1;4
96;11.07.2015;2015;07;14;Lauantai;61;67;128;8;10;18
96;11.07.2015;2015;07;15;Lauantai;59;50;109;6;4;10
96;11.07.2015;2015;07;16;Lauantai;55;44;99;5;15;20
96;11.07.2015;2015;07;17;Lauantai;46;35;81;7;5;12
96;11.07.2015;2015;07;18;Lauantai;37;41;78;7;4;11
96;11.07.2015;2015;07;19;Lauantai;19;36;55;5;10;15
96;11.07.2015;2015;07;20;Lauantai;28;23;51;4;6;10
96;11.07.2015;2015;07;21;Lauantai;11;37;48;2;3;5
96;11.07.2015;2015;07;22;Lauantai;10;35;45;1;2;3
96;11.07.2015;2015;07;23;Lauantai;10;7;17;5;1;6
96;12.07.2015;2015;07;00;Sunnuntai;18;14;32;2;3;5
96;12.07.2015;2015;07;01;Sunnuntai;17;3;20;2;0;2
96;12.07.2015;2015;07;02;Sunnuntai;21;3;24;2;1;3
96;12.07.2015;2015;07;03;Sunnuntai;23;3;26;2;0;2
96;12.07.2015;2015;07;04;Sunnuntai;11;0;11;3;3;6
96;12.07.2015;2015;07;05;Sunnuntai;4;2;6;0;0;0
96;12.07.2015;2015;07;06;Sunnuntai;13;8;21;1;0;1
96;12.07.2015;2015;07;07;Sunnuntai;5;9;14;0;3;3
96;12.07.2015;2015;07;08;Sunnuntai;4;4;8;4;3;7
96;12.07.2015;2015;07;09;Sunnuntai;5;21;26;4;5;9
96;12.07.2015;2015;07;10;Sunnuntai;19;26;45;1;5;6
96;12.07.2015;2015;07;11;Sunnuntai;18;30;48;4;8;12
96;12.07.2015;2015;07;12;Sunnuntai;35;45;80;6;8;14
96;12.07.2015;2015;07;13;Sunnuntai;62;70;132;7;8;15
96;12.07.2015;2015;07;14;Sunnuntai;53;51;104;11;14;25
96;12.07.2015;2015;07;15;Sunnuntai;44;40;84;10;3;13
96;12.07.2015;2015;07;16;Sunnuntai;46;55;101;8;16;24
96;12.07.2015;2015;07;17;Sunnuntai;49;41;90;7;5;12
96;12.07.2015;2015;07;18;Sunnuntai;56;37;93;11;4;15
96;12.07.2015;2015;07;19;Sunnuntai;36;51;87;5;5;10
96;12.07.2015;2015;07;20;Sunnuntai;27;32;59;5;6;11
96;12.07.2015;2015;07;21;Sunnuntai;20;25;45;6;4;10
96;12.07.2015;2015;07;22;Sunnuntai;12;19;31;2;3;5
96;12.07.2015;2015;07;23;Sunnuntai;26;9;35;0;2;2
96;13.07.2015;2015;07;00;Maanantai;4;1;5;2;0;2
96;13.07.2015;2015;07;01;Maanantai;6;1;7;0;1;1
96;13.07.2015;2015;07;02;Maanantai;4;2;6;0;0;0
96;13.07.2015;2015;07;03;Maanantai;1;0;1;0;1;1
96;13.07.2015;2015;07;04;Maanantai;4;4;8;0;1;1
96;13.07.2015;2015;07;05;Maanantai;3;10;13;0;1;1
96;13.07.2015;2015;07;06;Maanantai;40;32;72;4;2;6
96;13.07.2015;2015;07;07;Maanantai;61;57;118;8;1;9
96;13.07.2015;2015;07;08;Maanantai;31;62;93;6;3;9
96;13.07.2015;2015;07;09;Maanantai;34;62;96;0;6;6
96;13.07.2015;2015;07;10;Maanantai;33;38;71;4;8;12
96;13.07.2015;2015;07;11;Maanantai;50;50;100;4;4;8
96;13.07.2015;2015;07;12;Maanantai;58;71;129;6;2;8
96;13.07.2015;2015;07;13;Maanantai;47;80;127;5;7;12
96;13.07.2015;2015;07;14;Maanantai;70;77;147;3;3;6
96;13.07.2015;2015;07;15;Maanantai;73;148;221;5;15;20
96;13.07.2015;2015;07;16;Maanantai;95;88;183;4;11;15
96;13.07.2015;2015;07;17;Maanantai;60;69;129;6;3;9
96;13.07.2015;2015;07;18;Maanantai;54;44;98;9;3;12
96;13.07.2015;2015;07;19;Maanantai;73;45;118;10;7;17
96;13.07.2015;2015;07;20;Maanantai;55;35;90;13;6;19
96;13.07.2015;2015;07;21;Maanantai;26;56;82;18;10;28
96;13.07.2015;2015;07;22;Maanantai;11;20;31;1;2;3
96;13.07.2015;2015;07;23;Maanantai;3;6;9;0;3;3
96;14.07.2015;2015;07;00;Tiistai;1;4;5;0;1;1
96;14.07.2015;2015;07;01;Tiistai;10;3;13;0;0;0
96;14.07.2015;2015;07;02;Tiistai;2;2;4;1;0;1
96;14.07.2015;2015;07;03;Tiistai;0;5;5;0;2;2
96;14.07.2015;2015;07;04;Tiistai;3;4;7;0;2;2
96;14.07.2015;2015;07;05;Tiistai;7;13;20;0;1;1
96;14.07.2015;2015;07;06;Tiistai;47;34;81;4;2;6
96;14.07.2015;2015;07;07;Tiistai;58;75;133;8;3;11
96;14.07.2015;2015;07;08;Tiistai;20;60;80;1;3;4
96;14.07.2015;2015;07;09;Tiistai;23;49;72;2;7;9
96;14.07.2015;2015;07;10;Tiistai;37;49;86;7;2;9
96;14.07.2015;2015;07;11;Tiistai;46;56;102;4;9;13
96;14.07.2015;2015;07;12;Tiistai;49;61;110;5;4;9
96;14.07.2015;2015;07;13;Tiistai;64;67;131;5;9;14
96;14.07.2015;2015;07;14;Tiistai;57;93;150;5;9;14
96;14.07.2015;2015;07;15;Tiistai;80;116;196;7;8;15
96;14.07.2015;2015;07;16;Tiistai;101;96;197;9;10;19
96;14.07.2015;2015;07;17;Tiistai;65;68;133;8;6;14
96;14.07.2015;2015;07;18;Tiistai;92;46;138;13;9;22
96;14.07.2015;2015;07;19;Tiistai;52;37;89;7;13;20
96;14.07.2015;2015;07;20;Tiistai;67;32;99;10;14;24
96;14.07.2015;2015;07;21;Tiistai;21;38;59;8;3;11
96;14.07.2015;2015;07;22;Tiistai;8;12;20;3;5;8
96;14.07.2015;2015;07;23;Tiistai;10;11;21;2;0;2
96;15.07.2015;2015;07;00;Keskiviikko;6;2;8;2;1;3
96;15.07.2015;2015;07;01;Keskiviikko;1;0;1;2;1;3
96;15.07.2015;2015;07;02;Keskiviikko;1;4;5;0;1;1
96;15.07.2015;2015;07;03;Keskiviikko;3;0;3;0;0;0
96;15.07.2015;2015;07;04;Keskiviikko;4;2;6;0;1;1
96;15.07.2015;2015;07;05;Keskiviikko;6;8;14;1;1;2
96;15.07.2015;2015;07;06;Keskiviikko;49;29;78;4;1;5
96;15.07.2015;2015;07;07;Keskiviikko;67;64;131;9;3;12
96;15.07.2015;2015;07;08;Keskiviikko;32;51;83;7;4;11
96;15.07.2015;2015;07;09;Keskiviikko;27;63;90;4;5;9
96;15.07.2015;2015;07;10;Keskiviikko;37;52;89;4;8;12
96;15.07.2015;2015;07;11;Keskiviikko;43;43;86;5;8;13
96;15.07.2015;2015;07;12;Keskiviikko;53;64;117;4;3;7
96;15.07.2015;2015;07;13;Keskiviikko;72;50;122;4;5;9
96;15.07.2015;2015;07;14;Keskiviikko;65;72;137;5;3;8
96;15.07.2015;2015;07;15;Keskiviikko;82;143;225;8;16;24
96;15.07.2015;2015;07;16;Keskiviikko;102;92;194;6;13;19
96;15.07.2015;2015;07;17;Keskiviikko;85;51;136;7;8;15
96;15.07.2015;2015;07;18;Keskiviikko;62;49;111;15;13;28
96;15.07.2015;2015;07;19;Keskiviikko;46;46;92;14;11;25
96;15.07.2015;2015;07;20;Keskiviikko;44;39;83;12;9;21
96;15.07.2015;2015;07;21;Keskiviikko;30;42;72;2;9;11
96;15.07.2015;2015;07;22;Keskiviikko;23;18;41;3;0;3
96;15.07.2015;2015;07;23;Keskiviikko;6;7;13;0;0;0
96;16.07.2015;2015;07;00;Torstai;14;2;16;0;0;0
96;16.07.2015;2015;07;01;Torstai;13;1;14;2;1;3
96;16.07.2015;2015;07;02;Torstai;4;0;4;1;0;1
96;16.07.2015;2015;07;03;Torstai;0;0;0;1;0;1
96;16.07.2015;2015;07;04;Torstai;8;4;12;0;1;1
96;16.07.2015;2015;07;05;Torstai;12;9;21;2;1;3
96;16.07.2015;2015;07;06;Torstai;50;20;70;4;1;5
96;16.07.2015;2015;07;07;Torstai;58;45;103;6;2;8
96;16.07.2015;2015;07;08;Torstai;28;41;69;4;3;7
96;16.07.2015;2015;07;09;Torstai;25;39;64;2;4;6
96;16.07.2015;2015;07;10;Torstai;32;41;73;5;6;11
96;16.07.2015;2015;07;11;Torstai;33;41;74;6;4;10
96;16.07.2015;2015;07;12;Torstai;40;51;91;4;7;11
96;16.07.2015;2015;07;13;Torstai;53;67;120;6;9;15
96;16.07.2015;2015;07;14;Torstai;50;91;141;3;2;5
96;16.07.2015;2015;07;15;Torstai;71;119;190;4;14;18
96;16.07.2015;2015;07;16;Torstai;70;84;154;5;8;13
96;16.07.2015;2015;07;17;Torstai;73;59;132;7;5;12
96;16.07.2015;2015;07;18;Torstai;66;49;115;7;7;14
96;16.07.2015;2015;07;19;Torstai;56;29;85;6;9;15
96;16.07.2015;2015;07;20;Torstai;41;31;72;4;10;14
96;16.07.2015;2015;07;21;Torstai;24;37;61;8;8;16
96;16.07.2015;2015;07;22;Torstai;21;11;32;5;4;9
96;16.07.2015;2015;07;23;Torstai;10;7;17;2;2;4
96;17.07.2015;2015;07;00;Perjantai;11;4;15;0;0;0
96;17.07.2015;2015;07;01;Perjantai;2;1;3;0;3;3
96;17.07.2015;2015;07;02;Perjantai;1;2;3;2;2;4
96;17.07.2015;2015;07;03;Perjantai;3;0;3;0;1;1
96;17.07.2015;2015;07;04;Perjantai;5;3;8;1;0;1
96;17.07.2015;2015;07;05;Perjantai;5;8;13;1;2;3
96;17.07.2015;2015;07;06;Perjantai;40;27;67;5;1;6
96;17.07.2015;2015;07;07;Perjantai;57;56;113;6;6;12
96;17.07.2015;2015;07;08;Perjantai;29;55;84;2;5;7
96;17.07.2015;2015;07;09;Perjantai;27;54;81;5;5;10
96;17.07.2015;2015;07;10;Perjantai;25;40;65;4;1;5
96;17.07.2015;2015;07;11;Perjantai;52;59;111;1;13;14
96;17.07.2015;2015;07;12;Perjantai;60;66;126;5;6;11
96;17.07.2015;2015;07;13;Perjantai;66;83;149;3;9;12
96;17.07.2015;2015;07;14;Perjantai;70;108;178;5;12;17
96;17.07.2015;2015;07;15;Perjantai;90;98;188;8;12;20
96;17.07.2015;2015;07;16;Perjantai;97;83;180;15;6;21
96;17.07.2015;2015;07;17;Perjantai;51;64;115;9;10;19
96;17.07.2015;2015;07;18;Perjantai;53;53;106;4;6;10
96;17.07.2015;2015;07;19;Perjantai;56;35;91;11;5;16
96;17.07.2015;2015;07;20;Perjantai;43;42;85;5;3;8
96;17.07.2015;2015;07;21;Perjantai;38;54;92;6;5;11
96;17.07.2015;2015;07;22;Perjantai;15;24;39;1;5;6
96;17.07.2015;2015;07;23;Perjantai;25;10;35;2;1;3
96;18.07.2015;2015;07;00;Lauantai;22;14;36;2;2;4
96;18.07.2015;2015;07;01;Lauantai;21;6;27;1;1;2
96;18.07.2015;2015;07;02;Lauantai;9;5;14;0;1;1
96;18.07.2015;2015;07;03;Lauantai;21;0;21;1;0;1
96;18.07.2015;2015;07;04;Lauantai;7;6;13;2;0;2
96;18.07.2015;2015;07;05;Lauantai;4;2;6;0;0;0
96;18.07.2015;2015;07;06;Lauantai;31;5;36;2;0;2
96;18.07.2015;2015;07;07;Lauantai;13;12;25;1;3;4
96;18.07.2015;2015;07;08;Lauantai;13;16;29;3;2;5
96;18.07.2015;2015;07;09;Lauantai;27;39;66;3;4;7
96;18.07.2015;2015;07;10;Lauantai;37;52;89;5;6;11
96;18.07.2015;2015;07;11;Lauantai;49;63;112;6;8;14
96;18.07.2015;2015;07;12;Lauantai;62;76;138;8;3;11
96;18.07.2015;2015;07;13;Lauantai;52;67;119;7;11;18
96;18.07.2015;2015;07;14;Lauantai;57;73;130;10;8;18
96;18.07.2015;2015;07;15;Lauantai;76;172;248;5;17;22
96;18.07.2015;2015;07;16;Lauantai;59;59;118;6;9;15
96;18.07.2015;2015;07;17;Lauantai;68;37;105;3;3;6
96;18.07.2015;2015;07;18;Lauantai;161;55;216;11;3;14
96;18.07.2015;2015;07;19;Lauantai;53;42;95;1;4;5
96;18.07.2015;2015;07;20;Lauantai;29;28;57;4;2;6
96;18.07.2015;2015;07;21;Lauantai;26;26;52;1;3;4
96;18.07.2015;2015;07;22;Lauantai;18;15;33;0;1;1
96;18.07.2015;2015;07;23;Lauantai;13;13;26;0;1;1
96;19.07.2015;2015;07;00;Sunnuntai;12;7;19;0;2;2
96;19.07.2015;2015;07;01;Sunnuntai;17;2;19;0;0;0
96;19.07.2015;2015;07;02;Sunnuntai;19;3;22;1;0;1
96;19.07.2015;2015;07;03;Sunnuntai;16;3;19;1;0;1
96;19.07.2015;2015;07;04;Sunnuntai;9;1;10;0;1;1
96;19.07.2015;2015;07;05;Sunnuntai;2;2;4;2;0;2
96;19.07.2015;2015;07;06;Sunnuntai;13;9;22;2;1;3
96;19.07.2015;2015;07;07;Sunnuntai;4;13;17;2;3;5
96;19.07.2015;2015;07;08;Sunnuntai;2;6;8;0;5;5
96;19.07.2015;2015;07;09;Sunnuntai;6;13;19;2;1;3
96;19.07.2015;2015;07;10;Sunnuntai;9;13;22;2;1;3
96;19.07.2015;2015;07;11;Sunnuntai;18;20;38;1;4;5
96;19.07.2015;2015;07;12;Sunnuntai;26;17;43;8;4;12
96;19.07.2015;2015;07;13;Sunnuntai;42;29;71;5;4;9
96;19.07.2015;2015;07;14;Sunnuntai;21;41;62;2;5;7
96;19.07.2015;2015;07;15;Sunnuntai;28;19;47;9;3;12
96;19.07.2015;2015;07;16;Sunnuntai;32;14;46;8;3;11
96;19.07.2015;2015;07;17;Sunnuntai;31;29;60;5;4;9
96;19.07.2015;2015;07;18;Sunnuntai;39;38;77;8;12;20
96;19.07.2015;2015;07;19;Sunnuntai;36;42;78;13;14;27
96;19.07.2015;2015;07;20;Sunnuntai;31;43;74;9;14;23
96;19.07.2015;2015;07;21;Sunnuntai;24;45;69;3;7;10
96;19.07.2015;2015;07;22;Sunnuntai;24;18;42;2;0;2
96;19.07.2015;2015;07;23;Sunnuntai;9;8;17;1;0;1
96;20.07.2015;2015;07;00;Maanantai;8;4;12;2;0;2
96;20.07.2015;2015;07;01;Maanantai;2;3;5;1;0;1
96;20.07.2015;2015;07;02;Maanantai;3;1;4;0;0;0
96;20.07.2015;2015;07;03;Maanantai;2;0;2;0;0;0
96;20.07.2015;2015;07;04;Maanantai;7;7;14;0;1;1
96;20.07.2015;2015;07;05;Maanantai;6;8;14;1;1;2
96;20.07.2015;2015;07;06;Maanantai;50;25;75;2;4;6
96;20.07.2015;2015;07;07;Maanantai;63;55;118;10;2;12
96;20.07.2015;2015;07;08;Maanantai;31;62;93;5;3;8
96;20.07.2015;2015;07;09;Maanantai;33;62;95;3;2;5
96;20.07.2015;2015;07;10;Maanantai;45;63;108;7;7;14
96;20.07.2015;2015;07;11;Maanantai;56;73;129;6;4;10
96;20.07.2015;2015;07;12;Maanantai;67;72;139;6;9;15
96;20.07.2015;2015;07;13;Maanantai;76;80;156;6;6;12
96;20.07.2015;2015;07;14;Maanantai;81;89;170;4;10;14
96;20.07.2015;2015;07;15;Maanantai;94;122;216;9;13;22
96;20.07.2015;2015;07;16;Maanantai;92;93;185;12;12;24
96;20.07.2015;2015;07;17;Maanantai;105;71;176;10;5;15
96;20.07.2015;2015;07;18;Maanantai;88;71;159;13;7;20
96;20.07.2015;2015;07;19;Maanantai;55;43;98;10;12;22
96;20.07.2015;2015;07;20;Maanantai;77;37;114;10;5;15
96;20.07.2015;2015;07;21;Maanantai;33;51;84;4;5;9
96;20.07.2015;2015;07;22;Maanantai;25;20;45;3;5;8
96;20.07.2015;2015;07;23;Maanantai;11;7;18;4;4;8
96;21.07.2015;2015;07;00;Tiistai;6;8;14;3;1;4
96;21.07.2015;2015;07;01;Tiistai;8;1;9;0;0;0
96;21.07.2015;2015;07;02;Tiistai;3;0;3;1;1;2
96;21.07.2015;2015;07;03;Tiistai;3;2;5;0;0;0
96;21.07.2015;2015;07;04;Tiistai;5;5;10;0;1;1
96;21.07.2015;2015;07;05;Tiistai;7;6;13;2;0;2
96;21.07.2015;2015;07;06;Tiistai;47;28;75;3;0;3
96;21.07.2015;2015;07;07;Tiistai;53;69;122;9;3;12
96;21.07.2015;2015;07;08;Tiistai;40;63;103;4;8;12
96;21.07.2015;2015;07;09;Tiistai;32;49;81;6;17;23
96;21.07.2015;2015;07;10;Tiistai;38;41;79;0;7;7
96;21.07.2015;2015;07;11;Tiistai;41;56;97;7;6;13
96;21.07.2015;2015;07;12;Tiistai;46;51;97;5;2;7
96;21.07.2015;2015;07;13;Tiistai;62;55;117;2;3;5
96;21.07.2015;2015;07;14;Tiistai;56;83;139;1;3;4
96;21.07.2015;2015;07;15;Tiistai;93;109;202;6;18;24
96;21.07.2015;2015;07;16;Tiistai;91;82;173;4;8;12
96;21.07.2015;2015;07;17;Tiistai;69;51;120;7;6;13
96;21.07.2015;2015;07;18;Tiistai;69;46;115;15;14;29
96;21.07.2015;2015;07;19;Tiistai;60;52;112;11;12;23
96;21.07.2015;2015;07;20;Tiistai;72;50;122;4;6;10
96;21.07.2015;2015;07;21;Tiistai;37;41;78;4;8;12
96;21.07.2015;2015;07;22;Tiistai;24;26;50;2;0;2
96;21.07.2015;2015;07;23;Tiistai;18;9;27;3;0;3
96;22.07.2015;2015;07;00;Keskiviikko;9;9;18;1;3;4
96;22.07.2015;2015;07;01;Keskiviikko;6;6;12;0;1;1
96;22.07.2015;2015;07;02;Keskiviikko;7;0;7;1;0;1
96;22.07.2015;2015;07;03;Keskiviikko;2;0;2;3;0;3
96;22.07.2015;2015;07;04;Keskiviikko;5;4;9;2;1;3
96;22.07.2015;2015;07;05;Keskiviikko;3;10;13;1;2;3
96;22.07.2015;2015;07;06;Keskiviikko;38;43;81;3;1;4
96;22.07.2015;2015;07;07;Keskiviikko;53;75;128;12;3;15
96;22.07.2015;2015;07;08;Keskiviikko;29;63;92;1;8;9
96;22.07.2015;2015;07;09;Keskiviikko;32;57;89;6;7;13
96;22.07.2015;2015;07;10;Keskiviikko;33;60;93;2;5;7
96;22.07.2015;2015;07;11;Keskiviikko;52;61;113;4;5;9
96;22.07.2015;2015;07;12;Keskiviikko;57;61;118;11;3;14
96;22.07.2015;2015;07;13;Keskiviikko;69;71;140;3;5;8
96;22.07.2015;2015;07;14;Keskiviikko;62;80;142;3;9;12
96;22.07.2015;2015;07;15;Keskiviikko;102;144;246;7;22;29
96;22.07.2015;2015;07;16;Keskiviikko;106;89;195;12;11;23
96;22.07.2015;2015;07;17;Keskiviikko;90;94;184;10;7;17
96;22.07.2015;2015;07;18;Keskiviikko;95;63;158;20;10;30
96;22.07.2015;2015;07;19;Keskiviikko;96;42;138;10;12;22
96;22.07.2015;2015;07;20;Keskiviikko;61;56;117;6;9;15
96;22.07.2015;2015;07;21;Keskiviikko;44;36;80;3;6;9
96;22.07.2015;2015;07;22;Keskiviikko;20;26;46;1;1;2
96;22.07.2015;2015;07;23;Keskiviikko;15;12;27;1;2;3
96;23.07.2015;2015;07;00;Torstai;14;9;23;3;0;3
96;23.07.2015;2015;07;01;Torstai;5;2;7;1;2;3
96;23.07.2015;2015;07;02;Torstai;8;0;8;0;0;0
96;23.07.2015;2015;07;03;Torstai;8;3;11;1;1;2
96;23.07.2015;2015;07;04;Torstai;5;5;10;0;0;0
96;23.07.2015;2015;07;05;Torstai;7;10;17;1;0;1
96;23.07.2015;2015;07;06;Torstai;47;28;75;3;1;4
96;23.07.2015;2015;07;07;Torstai;56;62;118;9;2;11
96;23.07.2015;2015;07;08;Torstai;47;82;129;1;1;2
96;23.07.2015;2015;07;09;Torstai;37;58;95;5;10;15
96;23.07.2015;2015;07;10;Torstai;40;65;105;6;6;12
96;23.07.2015;2015;07;11;Torstai;63;58;121;9;6;15
96;23.07.2015;2015;07;12;Torstai;87;83;170;3;8;11
96;23.07.2015;2015;07;13;Torstai;59;58;117;7;6;13
96;23.07.2015;2015;07;14;Torstai;70;73;143;2;8;10
96;23.07.2015;2015;07;15;Torstai;103;141;244;10;23;33
96;23.07.2015;2015;07;16;Torstai;116;94;210;5;13;18
96;23.07.2015;2015;07;17;Torstai;77;79;156;10;9;19
96;23.07.2015;2015;07;18;Torstai;65;43;108;11;6;17
96;23.07.2015;2015;07;19;Torstai;51;20;71;3;2;5
96;23.07.2015;2015;07;20;Torstai;64;42;106;7;9;16
96;23.07.2015;2015;07;21;Torstai;50;39;89;5;3;8
96;23.07.2015;2015;07;22;Torstai;11;10;21;4;4;8
96;23.07.2015;2015;07;23;Torstai;12;7;19;1;1;2
96;24.07.2015;2015;07;00;Perjantai;7;5;12;1;0;1
96;24.07.2015;2015;07;01;Perjantai;1;3;4;2;2;4
96;24.07.2015;2015;07;02;Perjantai;1;0;1;0;0;0
96;24.07.2015;2015;07;03;Perjantai;1;0;1;0;0;0
96;24.07.2015;2015;07;04;Perjantai;3;4;7;0;0;0
96;24.07.2015;2015;07;05;Perjantai;7;7;14;0;0;0
96;24.07.2015;2015;07;06;Perjantai;55;21;76;2;3;5
96;24.07.2015;2015;07;07;Perjantai;36;42;78;7;4;11
96;24.07.2015;2015;07;08;Perjantai;26;40;66;3;2;5
96;24.07.2015;2015;07;09;Perjantai;16;42;58;0;4;4
96;24.07.2015;2015;07;10;Perjantai;30;37;67;5;6;11
96;24.07.2015;2015;07;11;Perjantai;36;40;76;1;1;2
96;24.07.2015;2015;07;12;Perjantai;35;44;79;1;3;4
96;24.07.2015;2015;07;13;Perjantai;34;40;74;2;0;2
96;24.07.2015;2015;07;14;Perjantai;42;87;129;3;5;8
96;24.07.2015;2015;07;15;Perjantai;53;86;139;8;6;14
96;24.07.2015;2015;07;16;Perjantai;38;92;130;3;10;13
96;24.07.2015;2015;07;17;Perjantai;41;68;109;5;9;14
96;24.07.2015;2015;07;18;Perjantai;44;70;114;7;7;14
96;24.07.2015;2015;07;19;Perjantai;36;52;88;2;1;3
96;24.07.2015;2015;07;20;Perjantai;40;53;93;5;3;8
96;24.07.2015;2015;07;21;Perjantai;38;35;73;2;9;11
96;24.07.2015;2015;07;22;Perjantai;14;24;38;2;2;4
96;24.07.2015;2015;07;23;Perjantai;36;23;59;1;3;4
96;25.07.2015;2015;07;00;Lauantai;34;19;53;8;1;9
96;25.07.2015;2015;07;01;Lauantai;66;7;73;11;0;11
96;25.07.2015;2015;07;02;Lauantai;42;6;48;5;0;5
96;25.07.2015;2015;07;03;Lauantai;28;2;30;6;0;6
96;25.07.2015;2015;07;04;Lauantai;23;4;27;13;1;14
96;25.07.2015;2015;07;05;Lauantai;12;0;12;6;0;6
96;25.07.2015;2015;07;06;Lauantai;21;12;33;6;2;8
96;25.07.2015;2015;07;07;Lauantai;8;13;21;2;3;5
96;25.07.2015;2015;07;08;Lauantai;15;20;35;2;4;6
96;25.07.2015;2015;07;09;Lauantai;21;38;59;5;3;8
96;25.07.2015;2015;07;10;Lauantai;15;27;42;0;4;4
96;25.07.2015;2015;07;11;Lauantai;20;22;42;5;2;7
96;25.07.2015;2015;07;12;Lauantai;36;62;98;2;14;16
96;25.07.2015;2015;07;13;Lauantai;48;101;149;19;43;62
96;25.07.2015;2015;07;14;Lauantai;43;115;158;24;235;259
96;25.07.2015;2015;07;15;Lauantai;51;121;172;70;366;436
96;25.07.2015;2015;07;16;Lauantai;58;60;118;11;11;22
96;25.07.2015;2015;07;17;Lauantai;55;87;142;12;9;21
96;25.07.2015;2015;07;18;Lauantai;46;58;104;7;8;15
96;25.07.2015;2015;07;19;Lauantai;38;80;118;5;5;10
96;25.07.2015;2015;07;20;Lauantai;40;58;98;6;7;13
96;25.07.2015;2015;07;21;Lauantai;28;54;82;6;7;13
96;25.07.2015;2015;07;22;Lauantai;30;33;63;4;4;8
96;25.07.2015;2015;07;23;Lauantai;39;22;61;1;2;3
96;26.07.2015;2015;07;00;Sunnuntai;51;10;61;4;4;8
96;26.07.2015;2015;07;01;Sunnuntai;117;9;126;10;1;11
96;26.07.2015;2015;07;02;Sunnuntai;60;5;65;22;0;22
96;26.07.2015;2015;07;03;Sunnuntai;69;3;72;13;0;13
96;26.07.2015;2015;07;04;Sunnuntai;33;3;36;14;4;18
96;26.07.2015;2015;07;05;Sunnuntai;14;1;15;6;1;7
96;26.07.2015;2015;07;06;Sunnuntai;13;8;21;3;1;4
96;26.07.2015;2015;07;07;Sunnuntai;5;15;20;3;4;7
96;26.07.2015;2015;07;08;Sunnuntai;15;8;23;1;3;4
96;26.07.2015;2015;07;09;Sunnuntai;10;25;35;1;5;6
96;26.07.2015;2015;07;10;Sunnuntai;17;21;38;5;3;8
96;26.07.2015;2015;07;11;Sunnuntai;24;37;61;4;5;9
96;26.07.2015;2015;07;12;Sunnuntai;49;45;94;1;4;5
96;26.07.2015;2015;07;13;Sunnuntai;38;42;80;6;6;12
96;26.07.2015;2015;07;14;Sunnuntai;37;39;76;11;9;20
96;26.07.2015;2015;07;15;Sunnuntai;36;47;83;5;6;11
96;26.07.2015;2015;07;16;Sunnuntai;38;42;80;5;6;11
96;26.07.2015;2015;07;17;Sunnuntai;43;33;76;6;2;8
96;26.07.2015;2015;07;18;Sunnuntai;38;26;64;3;6;9
96;26.07.2015;2015;07;19;Sunnuntai;44;32;76;8;7;15
96;26.07.2015;2015;07;20;Sunnuntai;19;26;45;4;3;7
96;26.07.2015;2015;07;21;Sunnuntai;9;15;24;3;2;5
96;26.07.2015;2015;07;22;Sunnuntai;8;4;12;1;0;1
96;26.07.2015;2015;07;23;Sunnuntai;5;5;10;0;1;1
96;27.07.2015;2015;07;00;Maanantai;4;2;6;2;2;4
96;27.07.2015;2015;07;01;Maanantai;6;0;6;0;0;0
96;27.07.2015;2015;07;02;Maanantai;1;0;1;0;0;0
96;27.07.2015;2015;07;03;Maanantai;2;0;2;0;0;0
96;27.07.2015;2015;07;04;Maanantai;3;4;7;0;0;0
96;27.07.2015;2015;07;05;Maanantai;6;5;11;0;0;0
96;27.07.2015;2015;07;06;Maanantai;52;25;77;1;4;5
96;27.07.2015;2015;07;07;Maanantai;54;51;105;6;1;7
96;27.07.2015;2015;07;08;Maanantai;24;67;91;6;3;9
96;27.07.2015;2015;07;09;Maanantai;27;41;68;3;5;8
96;27.07.2015;2015;07;10;Maanantai;23;34;57;9;10;19
96;27.07.2015;2015;07;11;Maanantai;30;50;80;7;7;14
96;27.07.2015;2015;07;12;Maanantai;52;45;97;3;7;10
96;27.07.2015;2015;07;13;Maanantai;46;69;115;6;7;13
96;27.07.2015;2015;07;14;Maanantai;52;80;132;6;8;14
96;27.07.2015;2015;07;15;Maanantai;68;120;188;4;9;13
96;27.07.2015;2015;07;16;Maanantai;73;71;144;11;10;21
96;27.07.2015;2015;07;17;Maanantai;59;69;128;5;8;13
96;27.07.2015;2015;07;18;Maanantai;60;71;131;7;5;12
96;27.07.2015;2015;07;19;Maanantai;54;38;92;14;10;24
96;27.07.2015;2015;07;20;Maanantai;64;40;104;8;8;16
96;27.07.2015;2015;07;21;Maanantai;22;38;60;8;4;12
96;27.07.2015;2015;07;22;Maanantai;11;14;25;3;3;6
96;27.07.2015;2015;07;23;Maanantai;4;3;7;0;2;2
96;28.07.2015;2015;07;00;Tiistai;5;7;12;1;0;1
96;28.07.2015;2015;07;01;Tiistai;5;0;5;1;4;5
96;28.07.2015;2015;07;02;Tiistai;3;2;5;0;1;1
96;28.07.2015;2015;07;03;Tiistai;4;0;4;0;0;0
96;28.07.2015;2015;07;04;Tiistai;3;7;10;0;1;1
96;28.07.2015;2015;07;05;Tiistai;13;8;21;0;1;1
96;28.07.2015;2015;07;06;Tiistai;41;32;73;1;4;5
96;28.07.2015;2015;07;07;Tiistai;65;73;138;9;4;13
96;28.07.2015;2015;07;08;Tiistai;31;69;100;5;2;7
96;28.07.2015;2015;07;09;Tiistai;30;60;90;5;5;10
96;28.07.2015;2015;07;10;Tiistai;41;58;99;3;3;6
96;28.07.2015;2015;07;11;Tiistai;57;64;121;13;5;18
96;28.07.2015;2015;07;12;Tiistai;57;76;133;4;10;14
96;28.07.2015;2015;07;13;Tiistai;72;70;142;5;2;7
96;28.07.2015;2015;07;14;Tiistai;58;84;142;3;9;12
96;28.07.2015;2015;07;15;Tiistai;103;123;226;6;11;17
96;28.07.2015;2015;07;16;Tiistai;97;122;219;5;14;19
96;28.07.2015;2015;07;17;Tiistai;78;65;143;9;7;16
96;28.07.2015;2015;07;18;Tiistai;79;67;146;11;3;14
96;28.07.2015;2015;07;19;Tiistai;65;66;131;11;9;20
96;28.07.2015;2015;07;20;Tiistai;68;57;125;9;7;16
96;28.07.2015;2015;07;21;Tiistai;33;66;99;2;6;8
96;28.07.2015;2015;07;22;Tiistai;19;21;40;2;1;3
96;28.07.2015;2015;07;23;Tiistai;16;15;31;1;1;2
96;29.07.2015;2015;07;00;Keskiviikko;9;5;14;1;1;2
96;29.07.2015;2015;07;01;Keskiviikko;6;2;8;0;0;0
96;29.07.2015;2015;07;02;Keskiviikko;4;0;4;0;0;0
96;29.07.2015;2015;07;03;Keskiviikko;4;1;5;0;0;0
96;29.07.2015;2015;07;04;Keskiviikko;4;3;7;0;2;2
96;29.07.2015;2015;07;05;Keskiviikko;13;9;22;0;0;0
96;29.07.2015;2015;07;06;Keskiviikko;40;32;72;2;3;5
96;29.07.2015;2015;07;07;Keskiviikko;63;82;145;11;3;14
96;29.07.2015;2015;07;08;Keskiviikko;29;74;103;9;4;13
96;29.07.2015;2015;07;09;Keskiviikko;35;52;87;3;11;14
96;29.07.2015;2015;07;10;Keskiviikko;24;72;96;5;7;12
96;29.07.2015;2015;07;11;Keskiviikko;52;77;129;13;5;18
96;29.07.2015;2015;07;12;Keskiviikko;80;75;155;3;3;6
96;29.07.2015;2015;07;13;Keskiviikko;64;81;145;3;9;12
96;29.07.2015;2015;07;14;Keskiviikko;74;100;174;3;4;7
96;29.07.2015;2015;07;15;Keskiviikko;99;168;267;6;11;17
96;29.07.2015;2015;07;16;Keskiviikko;87;84;171;15;13;28
96;29.07.2015;2015;07;17;Keskiviikko;44;53;97;10;6;16
96;29.07.2015;2015;07;18;Keskiviikko;46;30;76;7;5;12
96;29.07.2015;2015;07;19;Keskiviikko;45;24;69;2;3;5
96;29.07.2015;2015;07;20;Keskiviikko;34;22;56;3;5;8
96;29.07.2015;2015;07;21;Keskiviikko;22;29;51;2;3;5
96;29.07.2015;2015;07;22;Keskiviikko;11;4;15;4;3;7
96;29.07.2015;2015;07;23;Keskiviikko;4;3;7;1;1;2
96;30.07.2015;2015;07;00;Torstai;3;3;6;2;2;4
96;30.07.2015;2015;07;01;Torstai;4;2;6;1;1;2
96;30.07.2015;2015;07;02;Torstai;4;0;4;0;0;0
96;30.07.2015;2015;07;03;Torstai;2;0;2;0;1;1
96;30.07.2015;2015;07;04;Torstai;3;2;5;1;0;1
96;30.07.2015;2015;07;05;Torstai;9;7;16;0;0;0
96;30.07.2015;2015;07;06;Torstai;43;27;70;3;2;5
96;30.07.2015;2015;07;07;Torstai;54;72;126;7;1;8
96;30.07.2015;2015;07;08;Torstai;29;62;91;4;3;7
96;30.07.2015;2015;07;09;Torstai;22;46;68;4;5;9
96;30.07.2015;2015;07;10;Torstai;26;54;80;5;11;16
96;30.07.2015;2015;07;11;Torstai;47;59;106;12;8;20
96;30.07.2015;2015;07;12;Torstai;65;65;130;13;8;21
96;30.07.2015;2015;07;13;Torstai;72;69;141;8;7;15
96;30.07.2015;2015;07;14;Torstai;75;111;186;13;10;23
96;30.07.2015;2015;07;15;Torstai;91;137;228;5;16;21
96;30.07.2015;2015;07;16;Torstai;100;84;184;14;8;22
96;30.07.2015;2015;07;17;Torstai;72;99;171;22;12;34
96;30.07.2015;2015;07;18;Torstai;83;76;159;16;10;26
96;30.07.2015;2015;07;19;Torstai;81;39;120;19;8;27
96;30.07.2015;2015;07;20;Torstai;88;40;128;15;9;24
96;30.07.2015;2015;07;21;Torstai;37;40;77;7;6;13
96;30.07.2015;2015;07;22;Torstai;28;16;44;2;3;5
96;30.07.2015;2015;07;23;Torstai;11;11;22;1;2;3
96;31.07.2015;2015;07;00;Perjantai;10;6;16;2;0;2
96;31.07.2015;2015;07;01;Perjantai;5;3;8;0;0;0
96;31.07.2015;2015;07;02;Perjantai;1;3;4;1;1;2
96;31.07.2015;2015;07;03;Perjantai;4;2;6;0;0;0
96;31.07.2015;2015;07;04;Perjantai;3;4;7;0;0;0
96;31.07.2015;2015;07;05;Perjantai;5;9;14;0;1;1
96;31.07.2015;2015;07;06;Perjantai;49;29;78;3;3;6
96;31.07.2015;2015;07;07;Perjantai;56;58;114;9;2;11
96;31.07.2015;2015;07;08;Perjantai;27;65;92;3;5;8
96;31.07.2015;2015;07;09;Perjantai;29;49;78;9;11;20
96;31.07.2015;2015;07;10;Perjantai;37;71;108;3;5;8
96;31.07.2015;2015;07;11;Perjantai;51;47;98;10;4;14
96;31.07.2015;2015;07;12;Perjantai;70;44;114;7;3;10
96;31.07.2015;2015;07;13;Perjantai;58;56;114;8;6;14
96;31.07.2015;2015;07;14;Perjantai;58;82;140;6;10;16
96;31.07.2015;2015;07;15;Perjantai;81;101;182;4;8;12
96;31.07.2015;2015;07;16;Perjantai;90;76;166;5;8;13
96;31.07.2015;2015;07;17;Perjantai;57;66;123;8;8;16
96;31.07.2015;2015;07;18;Perjantai;64;39;103;4;6;10
96;31.07.2015;2015;07;19;Perjantai;62;54;116;4;11;15
96;31.07.2015;2015;07;20;Perjantai;44;54;98;6;6;12
96;31.07.2015;2015;07;21;Perjantai;29;45;74;3;5;8
96;31.07.2015;2015;07;22;Perjantai;18;15;33;1;1;2
96;31.07.2015;2015;07;23;Perjantai;11;14;25;3;0;3
96;01.08.2015;2015;08;00;Lauantai;16;7;23;1;4;5
96;01.08.2015;2015;08;01;Lauantai;17;4;21;0;0;0
96;01.08.2015;2015;08;02;Lauantai;12;2;14;1;0;1
96;01.08.2015;2015;08;03;Lauantai;21;5;26;0;0;0
96;01.08.2015;2015;08;04;Lauantai;7;3;10;1;0;1
96;01.08.2015;2015;08;05;Lauantai;2;2;4;0;0;0
96;01.08.2015;2015;08;06;Lauantai;17;8;25;1;1;2
96;01.08.2015;2015;08;07;Lauantai;8;14;22;0;2;2
96;01.08.2015;2015;08;08;Lauantai;5;11;16;0;2;2
96;01.08.2015;2015;08;09;Lauantai;5;15;20;0;2;2
96;01.08.2015;2015;08;10;Lauantai;9;31;40;5;3;8
96;01.08.2015;2015;08;11;Lauantai;22;39;61;1;8;9
96;01.08.2015;2015;08;12;Lauantai;29;34;63;5;5;10
96;01.08.2015;2015;08;13;Lauantai;43;40;83;1;6;7
96;01.08.2015;2015;08;14;Lauantai;28;39;67;1;3;4
96;01.08.2015;2015;08;15;Lauantai;25;31;56;1;4;5
96;01.08.2015;2015;08;16;Lauantai;27;22;49;5;3;8
96;01.08.2015;2015;08;17;Lauantai;20;22;42;3;1;4
96;01.08.2015;2015;08;18;Lauantai;29;13;42;6;4;10
96;01.08.2015;2015;08;19;Lauantai;15;11;26;12;5;17
96;01.08.2015;2015;08;20;Lauantai;23;17;40;3;5;8
96;01.08.2015;2015;08;21;Lauantai;14;31;45;5;3;8
96;01.08.2015;2015;08;22;Lauantai;15;23;38;0;0;0
96;01.08.2015;2015;08;23;Lauantai;6;7;13;3;0;3
96;02.08.2015;2015;08;00;Sunnuntai;14;5;19;2;1;3
96;02.08.2015;2015;08;01;Sunnuntai;6;1;7;1;0;1
96;02.08.2015;2015;08;02;Sunnuntai;12;3;15;2;0;2
96;02.08.2015;2015;08;03;Sunnuntai;10;1;11;4;0;4
96;02.08.2015;2015;08;04;Sunnuntai;11;0;11;2;1;3
96;02.08.2015;2015;08;05;Sunnuntai;7;2;9;1;0;1
96;02.08.2015;2015;08;06;Sunnuntai;12;5;17;5;2;7
96;02.08.2015;2015;08;07;Sunnuntai;2;12;14;2;1;3
96;02.08.2015;2015;08;08;Sunnuntai;11;10;21;2;3;5
96;02.08.2015;2015;08;09;Sunnuntai;14;12;26;4;2;6
96;02.08.2015;2015;08;10;Sunnuntai;16;23;39;4;4;8
96;02.08.2015;2015;08;11;Sunnuntai;23;20;43;7;2;9
96;02.08.2015;2015;08;12;Sunnuntai;24;28;52;8;4;12
96;02.08.2015;2015;08;13;Sunnuntai;44;47;91;1;8;9
96;02.08.2015;2015;08;14;Sunnuntai;24;51;75;11;10;21
96;02.08.2015;2015;08;15;Sunnuntai;37;43;80;6;7;13
96;02.08.2015;2015;08;16;Sunnuntai;55;34;89;11;5;16
96;02.08.2015;2015;08;17;Sunnuntai;45;43;88;7;5;12
96;02.08.2015;2015;08;18;Sunnuntai;45;43;88;11;10;21
96;02.08.2015;2015;08;19;Sunnuntai;28;40;68;9;16;25
96;02.08.2015;2015;08;20;Sunnuntai;40;40;80;3;11;14
96;02.08.2015;2015;08;21;Sunnuntai;17;25;42;4;2;6
96;02.08.2015;2015;08;22;Sunnuntai;18;16;34;4;1;5
96;02.08.2015;2015;08;23;Sunnuntai;21;8;29;5;3;8
96;03.08.2015;2015;08;00;Maanantai;7;7;14;3;1;4
96;03.08.2015;2015;08;01;Maanantai;4;1;5;0;0;0
96;03.08.2015;2015;08;02;Maanantai;4;2;6;0;2;2
96;03.08.2015;2015;08;03;Maanantai;4;1;5;3;0;3
96;03.08.2015;2015;08;04;Maanantai;5;4;9;1;0;1
96;03.08.2015;2015;08;05;Maanantai;6;10;16;1;1;2
96;03.08.2015;2015;08;06;Maanantai;45;29;74;2;2;4
96;03.08.2015;2015;08;07;Maanantai;72;64;136;11;4;15
96;03.08.2015;2015;08;08;Maanantai;47;85;132;10;9;19
96;03.08.2015;2015;08;09;Maanantai;32;28;60;4;3;7
96;03.08.2015;2015;08;10;Maanantai;28;49;77;2;8;10
96;03.08.2015;2015;08;11;Maanantai;38;33;71;4;7;11
96;03.08.2015;2015;08;12;Maanantai;58;78;136;7;12;19
96;03.08.2015;2015;08;13;Maanantai;64;79;143;3;13;16
96;03.08.2015;2015;08;14;Maanantai;76;122;198;5;6;11
96;03.08.2015;2015;08;15;Maanantai;119;163;282;9;14;23
96;03.08.2015;2015;08;16;Maanantai;130;120;250;11;14;25
96;03.08.2015;2015;08;17;Maanantai;96;61;157;11;9;20
96;03.08.2015;2015;08;18;Maanantai;86;75;161;14;7;21
96;03.08.2015;2015;08;19;Maanantai;77;55;132;9;10;19
96;03.08.2015;2015;08;20;Maanantai;53;46;99;13;11;24
96;03.08.2015;2015;08;21;Maanantai;30;31;61;8;4;12
96;03.08.2015;2015;08;22;Maanantai;18;15;33;8;2;10
96;03.08.2015;2015;08;23;Maanantai;9;8;17;1;0;1
96;04.08.2015;2015;08;00;Tiistai;5;4;9;0;1;1
96;04.08.2015;2015;08;01;Tiistai;5;3;8;0;0;0
96;04.08.2015;2015;08;02;Tiistai;0;0;0;0;1;1
96;04.08.2015;2015;08;03;Tiistai;1;0;1;0;0;0
96;04.08.2015;2015;08;04;Tiistai;5;3;8;0;0;0
96;04.08.2015;2015;08;05;Tiistai;9;7;16;3;1;4
96;04.08.2015;2015;08;06;Tiistai;52;43;95;5;1;6
96;04.08.2015;2015;08;07;Tiistai;89;82;171;10;6;16
96;04.08.2015;2015;08;08;Tiistai;56;110;166;6;3;9
96;04.08.2015;2015;08;09;Tiistai;31;54;85;2;4;6
96;04.08.2015;2015;08;10;Tiistai;51;67;118;7;5;12
96;04.08.2015;2015;08;11;Tiistai;50;68;118;4;4;8
96;04.08.2015;2015;08;12;Tiistai;71;93;164;10;16;26
96;04.08.2015;2015;08;13;Tiistai;72;94;166;10;7;17
96;04.08.2015;2015;08;14;Tiistai;85;107;192;7;15;22
96;04.08.2015;2015;08;15;Tiistai;129;182;311;8;18;26
96;04.08.2015;2015;08;16;Tiistai;134;99;233;7;16;23
96;04.08.2015;2015;08;17;Tiistai;112;81;193;14;13;27
96;04.08.2015;2015;08;18;Tiistai;86;63;149;18;6;24
96;04.08.2015;2015;08;19;Tiistai;95;57;152;17;8;25
96;04.08.2015;2015;08;20;Tiistai;90;71;161;9;16;25
96;04.08.2015;2015;08;21;Tiistai;38;68;106;13;3;16
96;04.08.2015;2015;08;22;Tiistai;24;22;46;2;2;4
96;04.08.2015;2015;08;23;Tiistai;6;10;16;1;4;5
96;05.08.2015;2015;08;00;Keskiviikko;13;7;20;5;2;7
96;05.08.2015;2015;08;01;Keskiviikko;2;2;4;0;0;0
96;05.08.2015;2015;08;02;Keskiviikko;2;1;3;0;0;0
96;05.08.2015;2015;08;03;Keskiviikko;4;1;5;2;0;2
96;05.08.2015;2015;08;04;Keskiviikko;5;4;9;0;1;1
96;05.08.2015;2015;08;05;Keskiviikko;11;7;18;0;0;0
96;05.08.2015;2015;08;06;Keskiviikko;51;38;89;1;1;2
96;05.08.2015;2015;08;07;Keskiviikko;87;99;186;13;4;17
96;05.08.2015;2015;08;08;Keskiviikko;54;103;157;6;6;12
96;05.08.2015;2015;08;09;Keskiviikko;47;69;116;5;4;9
96;05.08.2015;2015;08;10;Keskiviikko;44;57;101;8;8;16
96;05.08.2015;2015;08;11;Keskiviikko;59;73;132;5;7;12
96;05.08.2015;2015;08;12;Keskiviikko;82;73;155;8;7;15
96;05.08.2015;2015;08;13;Keskiviikko;87;98;185;10;8;18
96;05.08.2015;2015;08;14;Keskiviikko;88;109;197;3;20;23
96;05.08.2015;2015;08;15;Keskiviikko;120;183;303;8;11;19
96;05.08.2015;2015;08;16;Keskiviikko;109;135;244;9;17;26
96;05.08.2015;2015;08;17;Keskiviikko;103;83;186;14;12;26
96;05.08.2015;2015;08;18;Keskiviikko;128;81;209;16;12;28
96;05.08.2015;2015;08;19;Keskiviikko;84;69;153;14;12;26
96;05.08.2015;2015;08;20;Keskiviikko;87;52;139;6;8;14
96;05.08.2015;2015;08;21;Keskiviikko;65;60;125;5;3;8
96;05.08.2015;2015;08;22;Keskiviikko;24;22;46;3;0;3
96;05.08.2015;2015;08;23;Keskiviikko;8;14;22;1;1;2
96;06.08.2015;2015;08;00;Torstai;7;4;11;0;4;4
96;06.08.2015;2015;08;01;Torstai;12;2;14;0;0;0
96;06.08.2015;2015;08;02;Torstai;3;3;6;0;0;0
96;06.08.2015;2015;08;03;Torstai;2;3;5;0;0;0
96;06.08.2015;2015;08;04;Torstai;7;5;12;1;0;1
96;06.08.2015;2015;08;05;Torstai;10;4;14;2;2;4
96;06.08.2015;2015;08;06;Torstai;49;40;89;3;2;5
96;06.08.2015;2015;08;07;Torstai;70;118;188;10;5;15
96;06.08.2015;2015;08;08;Torstai;43;88;131;1;4;5
96;06.08.2015;2015;08;09;Torstai;36;46;82;2;2;4
96;06.08.2015;2015;08;10;Torstai;30;40;70;5;2;7
96;06.08.2015;2015;08;11;Torstai;40;22;62;3;6;9
96;06.08.2015;2015;08;12;Torstai;26;55;81;4;4;8
96;06.08.2015;2015;08;13;Torstai;69;61;130;8;6;14
96;06.08.2015;2015;08;14;Torstai;55;88;143;2;5;7
96;06.08.2015;2015;08;15;Torstai;68;142;210;4;12;16
96;06.08.2015;2015;08;16;Torstai;73;85;158;5;14;19
96;06.08.2015;2015;08;17;Torstai;65;35;100;4;6;10
96;06.08.2015;2015;08;18;Torstai;37;44;81;7;3;10
96;06.08.2015;2015;08;19;Torstai;45;37;82;6;10;16
96;06.08.2015;2015;08;20;Torstai;29;22;51;6;6;12
96;06.08.2015;2015;08;21;Torstai;28;22;50;6;1;7
96;06.08.2015;2015;08;22;Torstai;11;13;24;1;2;3
96;06.08.2015;2015;08;23;Torstai;5;5;10;0;3;3
96;07.08.2015;2015;08;00;Perjantai;3;2;5;5;0;5
96;07.08.2015;2015;08;01;Perjantai;1;2;3;0;2;2
96;07.08.2015;2015;08;02;Perjantai;0;1;1;0;0;0
96;07.08.2015;2015;08;03;Perjantai;4;1;5;0;0;0
96;07.08.2015;2015;08;04;Perjantai;3;2;5;0;1;1
96;07.08.2015;2015;08;05;Perjantai;4;11;15;0;0;0
96;07.08.2015;2015;08;06;Perjantai;48;21;69;3;2;5
96;07.08.2015;2015;08;07;Perjantai;74;79;153;14;3;17
96;07.08.2015;2015;08;08;Perjantai;33;86;119;6;2;8
96;07.08.2015;2015;08;09;Perjantai;27;45;72;2;3;5
96;07.08.2015;2015;08;10;Perjantai;25;35;60;4;7;11
96;07.08.2015;2015;08;11;Perjantai;33;39;72;3;3;6
96;07.08.2015;2015;08;12;Perjantai;45;59;104;4;6;10
96;07.08.2015;2015;08;13;Perjantai;48;76;124;5;12;17
96;07.08.2015;2015;08;14;Perjantai;62;96;158;4;13;17
96;07.08.2015;2015;08;15;Perjantai;57;110;167;3;12;15
96;07.08.2015;2015;08;16;Perjantai;81;78;159;5;11;16
96;07.08.2015;2015;08;17;Perjantai;69;75;144;6;5;11
96;07.08.2015;2015;08;18;Perjantai;79;62;141;7;12;19
96;07.08.2015;2015;08;19;Perjantai;60;71;131;3;9;12
96;07.08.2015;2015;08;20;Perjantai;42;43;85;4;9;13
96;07.08.2015;2015;08;21;Perjantai;32;56;88;8;8;16
96;07.08.2015;2015;08;22;Perjantai;27;34;61;3;2;5
96;07.08.2015;2015;08;23;Perjantai;32;16;48;4;4;8
96;08.08.2015;2015;08;00;Lauantai;15;7;22;0;1;1
96;08.08.2015;2015;08;01;Lauantai;20;3;23;1;0;1
96;08.08.2015;2015;08;02;Lauantai;13;3;16;1;0;1
96;08.08.2015;2015;08;03;Lauantai;22;0;22;1;0;1
96;08.08.2015;2015;08;04;Lauantai;9;3;12;2;1;3
96;08.08.2015;2015;08;05;Lauantai;4;4;8;1;0;1
96;08.08.2015;2015;08;06;Lauantai;16;11;27;2;1;3
96;08.08.2015;2015;08;07;Lauantai;9;13;22;0;1;1
96;08.08.2015;2015;08;08;Lauantai;6;18;24;1;2;3
96;08.08.2015;2015;08;09;Lauantai;14;46;60;5;3;8
96;08.08.2015;2015;08;10;Lauantai;18;26;44;3;2;5
96;08.08.2015;2015;08;11;Lauantai;32;46;78;4;8;12
96;08.08.2015;2015;08;12;Lauantai;45;46;91;5;6;11
96;08.08.2015;2015;08;13;Lauantai;49;45;94;6;8;14
96;08.08.2015;2015;08;14;Lauantai;52;36;88;5;8;13
96;08.08.2015;2015;08;15;Lauantai;38;55;93;6;3;9
96;08.08.2015;2015;08;16;Lauantai;32;41;73;5;8;13
96;08.08.2015;2015;08;17;Lauantai;36;35;71;4;1;5
96;08.08.2015;2015;08;18;Lauantai;40;37;77;4;7;11
96;08.08.2015;2015;08;19;Lauantai;36;56;92;12;4;16
96;08.08.2015;2015;08;20;Lauantai;37;36;73;3;5;8
96;08.08.2015;2015;08;21;Lauantai;32;44;76;8;5;13
96;08.08.2015;2015;08;22;Lauantai;13;24;37;0;3;3
96;08.08.2015;2015;08;23;Lauantai;16;18;34;1;0;1
96;09.08.2015;2015;08;00;Sunnuntai;11;7;18;1;2;3
96;09.08.2015;2015;08;01;Sunnuntai;12;5;17;0;0;0
96;09.08.2015;2015;08;02;Sunnuntai;15;2;17;4;2;6
96;09.08.2015;2015;08;03;Sunnuntai;23;5;28;1;1;2
96;09.08.2015;2015;08;04;Sunnuntai;19;3;22;2;0;2
96;09.08.2015;2015;08;05;Sunnuntai;3;1;4;2;0;2
96;09.08.2015;2015;08;06;Sunnuntai;15;6;21;1;1;2
96;09.08.2015;2015;08;07;Sunnuntai;4;10;14;1;1;2
96;09.08.2015;2015;08;08;Sunnuntai;9;7;16;4;2;6
96;09.08.2015;2015;08;09;Sunnuntai;5;16;21;5;3;8
96;09.08.2015;2015;08;10;Sunnuntai;14;18;32;4;3;7
96;09.08.2015;2015;08;11;Sunnuntai;29;37;66;6;5;11
96;09.08.2015;2015;08;12;Sunnuntai;42;63;105;6;8;14
96;09.08.2015;2015;08;13;Sunnuntai;50;46;96;10;5;15
96;09.08.2015;2015;08;14;Sunnuntai;43;58;101;13;10;23
96;09.08.2015;2015;08;15;Sunnuntai;59;53;112;5;11;16
96;09.08.2015;2015;08;16;Sunnuntai;77;50;127;15;7;22
96;09.08.2015;2015;08;17;Sunnuntai;59;59;118;10;11;21
96;09.08.2015;2015;08;18;Sunnuntai;69;63;132;12;12;24
96;09.08.2015;2015;08;19;Sunnuntai;53;60;113;5;5;10
96;09.08.2015;2015;08;20;Sunnuntai;36;52;88;10;9;19
96;09.08.2015;2015;08;21;Sunnuntai;50;34;84;9;8;17
96;09.08.2015;2015;08;22;Sunnuntai;13;13;26;1;1;2
96;09.08.2015;2015;08;23;Sunnuntai;10;8;18;3;2;5
96;10.08.2015;2015;08;00;Maanantai;12;5;17;1;1;2
96;10.08.2015;2015;08;01;Maanantai;6;0;6;0;1;1
96;10.08.2015;2015;08;02;Maanantai;1;1;2;0;0;0
96;10.08.2015;2015;08;03;Maanantai;4;0;4;0;0;0
96;10.08.2015;2015;08;04;Maanantai;3;3;6;0;0;0
96;10.08.2015;2015;08;05;Maanantai;5;9;14;1;2;3
96;10.08.2015;2015;08;06;Maanantai;50;40;90;4;0;4
96;10.08.2015;2015;08;07;Maanantai;110;119;229;16;14;30
96;10.08.2015;2015;08;08;Maanantai;62;119;181;7;3;10
96;10.08.2015;2015;08;09;Maanantai;64;75;139;8;6;14
96;10.08.2015;2015;08;10;Maanantai;41;61;102;5;8;13
96;10.08.2015;2015;08;11;Maanantai;65;62;127;5;10;15
96;10.08.2015;2015;08;12;Maanantai;78;102;180;9;15;24
96;10.08.2015;2015;08;13;Maanantai;93;102;195;6;4;10
96;10.08.2015;2015;08;14;Maanantai;85;102;187;4;8;12
96;10.08.2015;2015;08;15;Maanantai;145;227;372;11;14;25
96;10.08.2015;2015;08;16;Maanantai;184;154;338;13;16;29
96;10.08.2015;2015;08;17;Maanantai;122;92;214;13;13;26
96;10.08.2015;2015;08;18;Maanantai;97;93;190;14;9;23
96;10.08.2015;2015;08;19;Maanantai;85;73;158;9;9;18
96;10.08.2015;2015;08;20;Maanantai;72;48;120;10;11;21
96;10.08.2015;2015;08;21;Maanantai;63;51;114;6;5;11
96;10.08.2015;2015;08;22;Maanantai;24;14;38;3;3;6
96;10.08.2015;2015;08;23;Maanantai;13;10;23;0;1;1
96;11.08.2015;2015;08;00;Tiistai;7;4;11;1;0;1
96;11.08.2015;2015;08;01;Tiistai;2;1;3;0;0;0
96;11.08.2015;2015;08;02;Tiistai;1;3;4;0;0;0
96;11.08.2015;2015;08;03;Tiistai;1;0;1;0;0;0
96;11.08.2015;2015;08;04;Tiistai;7;2;9;0;0;0
96;11.08.2015;2015;08;05;Tiistai;9;9;18;0;2;2
96;11.08.2015;2015;08;06;Tiistai;45;46;91;6;1;7
96;11.08.2015;2015;08;07;Tiistai;116;128;244;11;8;19
96;11.08.2015;2015;08;08;Tiistai;95;132;227;6;4;10
96;11.08.2015;2015;08;09;Tiistai;60;59;119;7;11;18
96;11.08.2015;2015;08;10;Tiistai;52;82;134;11;6;17
96;11.08.2015;2015;08;11;Tiistai;95;88;183;6;7;13
96;11.08.2015;2015;08;12;Tiistai;103;88;191;12;9;21
96;11.08.2015;2015;08;13;Tiistai;99;109;208;8;12;20
96;11.08.2015;2015;08;14;Tiistai;103;155;258;7;10;17
96;11.08.2015;2015;08;15;Tiistai;129;201;330;9;14;23
96;11.08.2015;2015;08;16;Tiistai;162;152;314;11;18;29
96;11.08.2015;2015;08;17;Tiistai;108;81;189;16;4;20
96;11.08.2015;2015;08;18;Tiistai;101;66;167;15;12;27
96;11.08.2015;2015;08;19;Tiistai;83;67;150;7;10;17
96;11.08.2015;2015;08;20;Tiistai;68;43;111;10;14;24
96;11.08.2015;2015;08;21;Tiistai;53;44;97;10;4;14
96;11.08.2015;2015;08;22;Tiistai;20;16;36;5;1;6
96;11.08.2015;2015;08;23;Tiistai;6;4;10;0;1;1
96;12.08.2015;2015;08;00;Keskiviikko;7;0;7;1;0;1
96;12.08.2015;2015;08;01;Keskiviikko;3;0;3;1;0;1
96;12.08.2015;2015;08;02;Keskiviikko;2;0;2;0;0;0
96;12.08.2015;2015;08;03;Keskiviikko;0;1;1;0;0;0
96;12.08.2015;2015;08;04;Keskiviikko;4;2;6;0;0;0
96;12.08.2015;2015;08;05;Keskiviikko;7;7;14;2;0;2
96;12.08.2015;2015;08;06;Keskiviikko;46;47;93;5;3;8
96;12.08.2015;2015;08;07;Keskiviikko;108;126;234;9;5;14
96;12.08.2015;2015;08;08;Keskiviikko;115;157;272;13;6;19
96;12.08.2015;2015;08;09;Keskiviikko;96;126;222;20;8;28
96;12.08.2015;2015;08;10;Keskiviikko;52;73;125;5;8;13
96;12.08.2015;2015;08;11;Keskiviikko;52;76;128;9;2;11
96;12.08.2015;2015;08;12;Keskiviikko;80;144;224;8;14;22
96;12.08.2015;2015;08;13;Keskiviikko;91;102;193;8;10;18
96;12.08.2015;2015;08;14;Keskiviikko;85;125;210;6;17;23
96;12.08.2015;2015;08;15;Keskiviikko;111;201;312;1;21;22
96;12.08.2015;2015;08;16;Keskiviikko;127;151;278;18;7;25
96;12.08.2015;2015;08;17;Keskiviikko;106;121;227;12;15;27
96;12.08.2015;2015;08;18;Keskiviikko;122;77;199;19;24;43
96;12.08.2015;2015;08;19;Keskiviikko;91;53;144;10;9;19
96;12.08.2015;2015;08;20;Keskiviikko;77;67;144;10;15;25
96;12.08.2015;2015;08;21;Keskiviikko;37;50;87;5;4;9
96;12.08.2015;2015;08;22;Keskiviikko;10;14;24;0;4;4
96;12.08.2015;2015;08;23;Keskiviikko;5;4;9;0;1;1
96;13.08.2015;2015;08;00;Torstai;7;5;12;0;1;1
96;13.08.2015;2015;08;01;Torstai;3;2;5;0;1;1
96;13.08.2015;2015;08;02;Torstai;6;1;7;0;0;0
96;13.08.2015;2015;08;03;Torstai;7;0;7;0;0;0
96;13.08.2015;2015;08;04;Torstai;4;2;6;0;0;0
96;13.08.2015;2015;08;05;Torstai;8;6;14;1;1;2
96;13.08.2015;2015;08;06;Torstai;45;44;89;10;5;15
96;13.08.2015;2015;08;07;Torstai;163;157;320;13;7;20
96;13.08.2015;2015;08;08;Torstai;117;201;318;9;5;14
96;13.08.2015;2015;08;09;Torstai;84;112;196;6;6;12
96;13.08.2015;2015;08;10;Torstai;52;75;127;7;7;14
96;13.08.2015;2015;08;11;Torstai;74;101;175;12;14;26
96;13.08.2015;2015;08;12;Torstai;109;112;221;6;3;9
96;13.08.2015;2015;08;13;Torstai;124;94;218;6;14;20
96;13.08.2015;2015;08;14;Torstai;110;151;261;8;17;25
96;13.08.2015;2015;08;15;Torstai;142;230;372;5;21;26
96;13.08.2015;2015;08;16;Torstai;164;181;345;9;14;23
96;13.08.2015;2015;08;17;Torstai;115;98;213;18;14;32
96;13.08.2015;2015;08;18;Torstai;106;64;170;10;8;18
96;13.08.2015;2015;08;19;Torstai;86;70;156;6;17;23
96;13.08.2015;2015;08;20;Torstai;78;59;137;14;11;25
96;13.08.2015;2015;08;21;Torstai;45;44;89;8;4;12
96;13.08.2015;2015;08;22;Torstai;24;17;41;1;4;5
96;13.08.2015;2015;08;23;Torstai;14;12;26;1;1;2
96;14.08.2015;2015;08;00;Perjantai;11;4;15;1;1;2
96;14.08.2015;2015;08;01;Perjantai;18;1;19;1;2;3
96;14.08.2015;2015;08;02;Perjantai;8;2;10;0;0;0
96;14.08.2015;2015;08;03;Perjantai;10;1;11;0;0;0
96;14.08.2015;2015;08;04;Perjantai;8;2;10;0;0;0
96;14.08.2015;2015;08;05;Perjantai;9;7;16;0;1;1
96;14.08.2015;2015;08;06;Perjantai;42;31;73;5;2;7
96;14.08.2015;2015;08;07;Perjantai;131;124;255;12;8;20
96;14.08.2015;2015;08;08;Perjantai;108;136;244;10;7;17
96;14.08.2015;2015;08;09;Perjantai;73;105;178;9;8;17
96;14.08.2015;2015;08;10;Perjantai;54;65;119;4;7;11
96;14.08.2015;2015;08;11;Perjantai;64;118;182;10;6;16
96;14.08.2015;2015;08;12;Perjantai;90;94;184;10;13;23
96;14.08.2015;2015;08;13;Perjantai;105;135;240;4;14;18
96;14.08.2015;2015;08;14;Perjantai;119;182;301;4;12;16
96;14.08.2015;2015;08;15;Perjantai;108;181;289;11;21;32
96;14.08.2015;2015;08;16;Perjantai;104;110;214;7;19;26
96;14.08.2015;2015;08;17;Perjantai;86;68;154;12;9;21
96;14.08.2015;2015;08;18;Perjantai;70;87;157;5;7;12
96;14.08.2015;2015;08;19;Perjantai;79;43;122;10;5;15
96;14.08.2015;2015;08;20;Perjantai;47;52;99;11;2;13
96;14.08.2015;2015;08;21;Perjantai;28;51;79;5;1;6
96;14.08.2015;2015;08;22;Perjantai;29;19;48;2;1;3
96;14.08.2015;2015;08;23;Perjantai;28;13;41;1;2;3
96;15.08.2015;2015;08;00;Lauantai;16;9;25;1;3;4
96;15.08.2015;2015;08;01;Lauantai;28;7;35;2;0;2
96;15.08.2015;2015;08;02;Lauantai;9;0;9;4;0;4
96;15.08.2015;2015;08;03;Lauantai;18;4;22;1;1;2
96;15.08.2015;2015;08;04;Lauantai;6;4;10;1;1;2
96;15.08.2015;2015;08;05;Lauantai;5;2;7;0;0;0
96;15.08.2015;2015;08;06;Lauantai;16;13;29;0;0;0
96;15.08.2015;2015;08;07;Lauantai;5;18;23;2;5;7
96;15.08.2015;2015;08;08;Lauantai;10;26;36;3;2;5
96;15.08.2015;2015;08;09;Lauantai;13;32;45;6;3;9
96;15.08.2015;2015;08;10;Lauantai;19;58;77;4;7;11
96;15.08.2015;2015;08;11;Lauantai;42;78;120;6;9;15
96;15.08.2015;2015;08;12;Lauantai;47;79;126;3;6;9
96;15.08.2015;2015;08;13;Lauantai;52;61;113;6;9;15
96;15.08.2015;2015;08;14;Lauantai;86;54;140;8;8;16
96;15.08.2015;2015;08;15;Lauantai;67;64;131;7;6;13
96;15.08.2015;2015;08;16;Lauantai;57;52;109;10;5;15
96;15.08.2015;2015;08;17;Lauantai;74;75;149;9;3;12
96;15.08.2015;2015;08;18;Lauantai;67;55;122;8;12;20
96;15.08.2015;2015;08;19;Lauantai;57;61;118;8;3;11
96;15.08.2015;2015;08;20;Lauantai;35;50;85;6;7;13
96;15.08.2015;2015;08;21;Lauantai;33;46;79;8;7;15
96;15.08.2015;2015;08;22;Lauantai;25;20;45;3;5;8
96;15.08.2015;2015;08;23;Lauantai;16;13;29;1;2;3
96;16.08.2015;2015;08;00;Sunnuntai;18;20;38;3;0;3
96;16.08.2015;2015;08;01;Sunnuntai;16;13;29;1;0;1
96;16.08.2015;2015;08;02;Sunnuntai;23;0;23;2;0;2
96;16.08.2015;2015;08;03;Sunnuntai;18;0;18;3;0;3
96;16.08.2015;2015;08;04;Sunnuntai;17;3;20;3;0;3
96;16.08.2015;2015;08;05;Sunnuntai;3;3;6;1;1;2
96;16.08.2015;2015;08;06;Sunnuntai;17;8;25;1;0;1
96;16.08.2015;2015;08;07;Sunnuntai;2;14;16;1;4;5
96;16.08.2015;2015;08;08;Sunnuntai;6;8;14;2;2;4
96;16.08.2015;2015;08;09;Sunnuntai;14;11;25;4;5;9
96;16.08.2015;2015;08;10;Sunnuntai;26;31;57;7;3;10
96;16.08.2015;2015;08;11;Sunnuntai;39;67;106;11;10;21
96;16.08.2015;2015;08;12;Sunnuntai;48;64;112;4;5;9
96;16.08.2015;2015;08;13;Sunnuntai;89;65;154;9;7;16
96;16.08.2015;2015;08;14;Sunnuntai;81;78;159;5;8;13
96;16.08.2015;2015;08;15;Sunnuntai;93;70;163;11;13;24
96;16.08.2015;2015;08;16;Sunnuntai;125;73;198;20;14;34
96;16.08.2015;2015;08;17;Sunnuntai;108;64;172;14;15;29
96;16.08.2015;2015;08;18;Sunnuntai;97;65;162;14;19;33
96;16.08.2015;2015;08;19;Sunnuntai;59;56;115;10;12;22
96;16.08.2015;2015;08;20;Sunnuntai;39;64;103;16;12;28
96;16.08.2015;2015;08;21;Sunnuntai;32;39;71;6;4;10
96;16.08.2015;2015;08;22;Sunnuntai;11;21;32;3;5;8
96;16.08.2015;2015;08;23;Sunnuntai;7;4;11;1;3;4
96;17.08.2015;2015;08;00;Maanantai;4;1;5;2;0;2
96;17.08.2015;2015;08;01;Maanantai;2;1;3;0;1;1
96;17.08.2015;2015;08;02;Maanantai;1;0;1;0;0;0
96;17.08.2015;2015;08;03;Maanantai;1;0;1;0;0;0
96;17.08.2015;2015;08;04;Maanantai;5;2;7;1;0;1
96;17.08.2015;2015;08;05;Maanantai;6;12;18;3;2;5
96;17.08.2015;2015;08;06;Maanantai;45;35;80;4;4;8
96;17.08.2015;2015;08;07;Maanantai;143;156;299;12;7;19
96;17.08.2015;2015;08;08;Maanantai;125;171;296;11;11;22
96;17.08.2015;2015;08;09;Maanantai;87;84;171;7;6;13
96;17.08.2015;2015;08;10;Maanantai;70;72;142;7;11;18
96;17.08.2015;2015;08;11;Maanantai;72;88;160;8;11;19
96;17.08.2015;2015;08;12;Maanantai;94;106;200;11;18;29
96;17.08.2015;2015;08;13;Maanantai;92;108;200;7;12;19
96;17.08.2015;2015;08;14;Maanantai;129;148;277;9;15;24
96;17.08.2015;2015;08;15;Maanantai;172;226;398;12;28;40
96;17.08.2015;2015;08;16;Maanantai;201;234;435;16;28;44
96;17.08.2015;2015;08;17;Maanantai;114;111;225;20;11;31
96;17.08.2015;2015;08;18;Maanantai;142;85;227;19;13;32
96;17.08.2015;2015;08;19;Maanantai;104;58;162;21;20;41
96;17.08.2015;2015;08;20;Maanantai;87;60;147;12;12;24
96;17.08.2015;2015;08;21;Maanantai;43;49;92;6;11;17
96;17.08.2015;2015;08;22;Maanantai;15;22;37;3;3;6
96;17.08.2015;2015;08;23;Maanantai;11;4;15;3;3;6
96;18.08.2015;2015;08;00;Tiistai;9;4;13;1;1;2
96;18.08.2015;2015;08;01;Tiistai;1;0;1;1;0;1
96;18.08.2015;2015;08;02;Tiistai;1;0;1;0;0;0
96;18.08.2015;2015;08;03;Tiistai;3;3;6;0;0;0
96;18.08.2015;2015;08;04;Tiistai;4;4;8;0;0;0
96;18.08.2015;2015;08;05;Tiistai;8;9;17;2;2;4
96;18.08.2015;2015;08;06;Tiistai;59;38;97;8;2;10
96;18.08.2015;2015;08;07;Tiistai;151;193;344;15;8;23
96;18.08.2015;2015;08;08;Tiistai;133;171;304;10;12;22
96;18.08.2015;2015;08;09;Tiistai;90;116;206;8;12;20
96;18.08.2015;2015;08;10;Tiistai;60;90;150;7;9;16
96;18.08.2015;2015;08;11;Tiistai;95;97;192;12;10;22
96;18.08.2015;2015;08;12;Tiistai;115;89;204;5;15;20
96;18.08.2015;2015;08;13;Tiistai;104;101;205;6;10;16
96;18.08.2015;2015;08;14;Tiistai;124;161;285;10;19;29
96;18.08.2015;2015;08;15;Tiistai;178;248;426;12;34;46
96;18.08.2015;2015;08;16;Tiistai;192;239;431;7;23;30
96;18.08.2015;2015;08;17;Tiistai;149;119;268;11;12;23
96;18.08.2015;2015;08;18;Tiistai;137;75;212;18;12;30
96;18.08.2015;2015;08;19;Tiistai;104;71;175;11;13;24
96;18.08.2015;2015;08;20;Tiistai;101;90;191;8;8;16
96;18.08.2015;2015;08;21;Tiistai;60;55;115;5;5;10
96;18.08.2015;2015;08;22;Tiistai;20;8;28;4;6;10
96;18.08.2015;2015;08;23;Tiistai;10;5;15;0;2;2
96;19.08.2015;2015;08;00;Keskiviikko;5;5;10;1;1;2
96;19.08.2015;2015;08;01;Keskiviikko;3;0;3;0;0;0
96;19.08.2015;2015;08;02;Keskiviikko;0;0;0;0;1;1
96;19.08.2015;2015;08;03;Keskiviikko;1;0;1;0;0;0
96;19.08.2015;2015;08;04;Keskiviikko;3;4;7;1;1;2
96;19.08.2015;2015;08;05;Keskiviikko;8;9;17;1;1;2
96;19.08.2015;2015;08;06;Keskiviikko;55;45;100;5;2;7
96;19.08.2015;2015;08;07;Keskiviikko;130;182;312;14;8;22
96;19.08.2015;2015;08;08;Keskiviikko;126;186;312;10;14;24
96;19.08.2015;2015;08;09;Keskiviikko;106;88;194;8;9;17
96;19.08.2015;2015;08;10;Keskiviikko;70;79;149;12;10;22
96;19.08.2015;2015;08;11;Keskiviikko;96;96;192;14;12;26
96;19.08.2015;2015;08;12;Keskiviikko;110;95;205;11;8;19
96;19.08.2015;2015;08;13;Keskiviikko;112;134;246;11;14;25
96;19.08.2015;2015;08;14;Keskiviikko;150;181;331;13;27;40
96;19.08.2015;2015;08;15;Keskiviikko;175;229;404;11;31;42
96;19.08.2015;2015;08;16;Keskiviikko;203;212;415;13;23;36
96;19.08.2015;2015;08;17;Keskiviikko;129;125;254;16;15;31
96;19.08.2015;2015;08;18;Keskiviikko;161;93;254;27;20;47
96;19.08.2015;2015;08;19;Keskiviikko;107;69;176;12;12;24
96;19.08.2015;2015;08;20;Keskiviikko;113;81;194;14;21;35
96;19.08.2015;2015;08;21;Keskiviikko;60;69;129;8;8;16
96;19.08.2015;2015;08;22;Keskiviikko;18;15;33;2;9;11
96;19.08.2015;2015;08;23;Keskiviikko;11;6;17;2;0;2
96;20.08.2015;2015;08;00;Torstai;4;6;10;1;1;2
96;20.08.2015;2015;08;01;Torstai;4;1;5;2;0;2
96;20.08.2015;2015;08;02;Torstai;4;1;5;0;0;0
96;20.08.2015;2015;08;03;Torstai;5;1;6;0;0;0
96;20.08.2015;2015;08;04;Torstai;2;3;5;1;1;2
96;20.08.2015;2015;08;05;Torstai;6;10;16;2;10;12
96;20.08.2015;2015;08;06;Torstai;50;36;86;5;3;8
96;20.08.2015;2015;08;07;Torstai;135;172;307;11;9;20
96;20.08.2015;2015;08;08;Torstai;141;206;347;6;12;18
96;20.08.2015;2015;08;09;Torstai;96;112;208;10;7;17
96;20.08.2015;2015;08;10;Torstai;90;82;172;6;2;8
96;20.08.2015;2015;08;11;Torstai;56;109;165;4;6;10
96;20.08.2015;2015;08;12;Torstai;95;85;180;14;19;33
96;20.08.2015;2015;08;13;Torstai;115;101;216;14;14;28
96;20.08.2015;2015;08;14;Torstai;148;177;325;7;18;25
96;20.08.2015;2015;08;15;Torstai;161;234;395;13;25;38
96;20.08.2015;2015;08;16;Torstai;194;230;424;12;23;35
96;20.08.2015;2015;08;17;Torstai;111;123;234;13;17;30
96;20.08.2015;2015;08;18;Torstai;105;102;207;14;13;27
96;20.08.2015;2015;08;19;Torstai;85;74;159;11;8;19
96;20.08.2015;2015;08;20;Torstai;96;79;175;7;5;12
96;20.08.2015;2015;08;21;Torstai;81;47;128;5;4;9
96;20.08.2015;2015;08;22;Torstai;59;21;80;7;4;11
96;20.08.2015;2015;08;23;Torstai;27;9;36;1;6;7
96;21.08.2015;2015;08;00;Perjantai;7;6;13;1;0;1
96;21.08.2015;2015;08;01;Perjantai;5;1;6;0;0;0
96;21.08.2015;2015;08;02;Perjantai;6;2;8;1;0;1
96;21.08.2015;2015;08;03;Perjantai;2;0;2;0;0;0
96;21.08.2015;2015;08;04;Perjantai;5;4;9;1;0;1
96;21.08.2015;2015;08;05;Perjantai;7;4;11;3;12;15
96;21.08.2015;2015;08;06;Perjantai;49;38;87;2;2;4
96;21.08.2015;2015;08;07;Perjantai;119;154;273;14;9;23
96;21.08.2015;2015;08;08;Perjantai;118;150;268;8;4;12
96;21.08.2015;2015;08;09;Perjantai;52;92;144;10;8;18
96;21.08.2015;2015;08;10;Perjantai;76;76;152;7;5;12
96;21.08.2015;2015;08;11;Perjantai;52;95;147;3;13;16
96;21.08.2015;2015;08;12;Perjantai;82;106;188;9;13;22
96;21.08.2015;2015;08;13;Perjantai;107;139;246;9;7;16
96;21.08.2015;2015;08;14;Perjantai;133;185;318;3;16;19
96;21.08.2015;2015;08;15;Perjantai;133;159;292;8;17;25
96;21.08.2015;2015;08;16;Perjantai;118;115;233;11;9;20
96;21.08.2015;2015;08;17;Perjantai;94;91;185;8;11;19
96;21.08.2015;2015;08;18;Perjantai;85;70;155;6;8;14
96;21.08.2015;2015;08;19;Perjantai;57;55;112;6;10;16
96;21.08.2015;2015;08;20;Perjantai;49;46;95;12;4;16
96;21.08.2015;2015;08;21;Perjantai;53;45;98;8;6;14
96;21.08.2015;2015;08;22;Perjantai;27;36;63;4;2;6
96;21.08.2015;2015;08;23;Perjantai;35;8;43;1;2;3
96;22.08.2015;2015;08;00;Lauantai;28;4;32;5;3;8
96;22.08.2015;2015;08;01;Lauantai;14;7;21;2;1;3
96;22.08.2015;2015;08;02;Lauantai;21;6;27;0;0;0
96;22.08.2015;2015;08;03;Lauantai;13;0;13;3;0;3
96;22.08.2015;2015;08;04;Lauantai;9;1;10;2;2;4
96;22.08.2015;2015;08;05;Lauantai;3;4;7;3;6;9
96;22.08.2015;2015;08;06;Lauantai;15;10;25;2;0;2
96;22.08.2015;2015;08;07;Lauantai;9;16;25;1;1;2
96;22.08.2015;2015;08;08;Lauantai;9;21;30;1;2;3
96;22.08.2015;2015;08;09;Lauantai;16;42;58;3;11;14
96;22.08.2015;2015;08;10;Lauantai;22;54;76;13;9;22
96;22.08.2015;2015;08;11;Lauantai;37;61;98;6;4;10
96;22.08.2015;2015;08;12;Lauantai;78;66;144;10;11;21
96;22.08.2015;2015;08;13;Lauantai;83;85;168;8;11;19
96;22.08.2015;2015;08;14;Lauantai;91;86;177;4;9;13
96;22.08.2015;2015;08;15;Lauantai;86;50;136;6;2;8
96;22.08.2015;2015;08;16;Lauantai;82;72;154;13;8;21
96;22.08.2015;2015;08;17;Lauantai;86;57;143;8;11;19
96;22.08.2015;2015;08;18;Lauantai;79;57;136;11;3;14
96;22.08.2015;2015;08;19;Lauantai;36;53;89;5;3;8
96;22.08.2015;2015;08;20;Lauantai;48;66;114;8;9;17
96;22.08.2015;2015;08;21;Lauantai;38;50;88;3;4;7
96;22.08.2015;2015;08;22;Lauantai;28;24;52;3;5;8
96;22.08.2015;2015;08;23;Lauantai;24;13;37;1;1;2
96;23.08.2015;2015;08;00;Sunnuntai;24;9;33;3;2;5
96;23.08.2015;2015;08;01;Sunnuntai;22;8;30;1;0;1
96;23.08.2015;2015;08;02;Sunnuntai;19;6;25;3;0;3
96;23.08.2015;2015;08;03;Sunnuntai;18;0;18;1;0;1
96;23.08.2015;2015;08;04;Sunnuntai;9;0;9;1;2;3
96;23.08.2015;2015;08;05;Sunnuntai;6;5;11;3;2;5
96;23.08.2015;2015;08;06;Sunnuntai;13;7;20;2;0;2
96;23.08.2015;2015;08;07;Sunnuntai;4;18;22;1;1;2
96;23.08.2015;2015;08;08;Sunnuntai;11;10;21;2;5;7
96;23.08.2015;2015;08;09;Sunnuntai;19;18;37;6;2;8
96;23.08.2015;2015;08;10;Sunnuntai;28;33;61;5;6;11
96;23.08.2015;2015;08;11;Sunnuntai;33;41;74;6;7;13
96;23.08.2015;2015;08;12;Sunnuntai;55;59;114;5;8;13
96;23.08.2015;2015;08;13;Sunnuntai;78;67;145;0;9;9
96;23.08.2015;2015;08;14;Sunnuntai;59;63;122;3;6;9
96;23.08.2015;2015;08;15;Sunnuntai;80;67;147;7;11;18
96;23.08.2015;2015;08;16;Sunnuntai;81;60;141;17;9;26
96;23.08.2015;2015;08;17;Sunnuntai;107;69;176;6;7;13
96;23.08.2015;2015;08;18;Sunnuntai;90;43;133;13;16;29
96;23.08.2015;2015;08;19;Sunnuntai;51;50;101;11;12;23
96;23.08.2015;2015;08;20;Sunnuntai;45;53;98;12;19;31
96;23.08.2015;2015;08;21;Sunnuntai;28;29;57;3;10;13
96;23.08.2015;2015;08;22;Sunnuntai;16;15;31;3;2;5
96;23.08.2015;2015;08;23;Sunnuntai;4;6;10;0;1;1
96;24.08.2015;2015;08;00;Maanantai;5;0;5;3;5;8
96;24.08.2015;2015;08;01;Maanantai;0;4;4;1;0;1
96;24.08.2015;2015;08;02;Maanantai;0;0;0;0;0;0
96;24.08.2015;2015;08;03;Maanantai;2;0;2;1;0;1
96;24.08.2015;2015;08;04;Maanantai;3;1;4;0;0;0
96;24.08.2015;2015;08;05;Maanantai;6;10;16;0;1;1
96;24.08.2015;2015;08;06;Maanantai;46;46;92;5;0;5
96;24.08.2015;2015;08;07;Maanantai;170;168;338;15;12;27
96;24.08.2015;2015;08;08;Maanantai;123;206;329;10;13;23
96;24.08.2015;2015;08;09;Maanantai;186;141;327;26;20;46
96;24.08.2015;2015;08;10;Maanantai;118;112;230;15;20;35
96;24.08.2015;2015;08;11;Maanantai;144;118;262;27;32;59
96;24.08.2015;2015;08;12;Maanantai;168;125;293;15;8;23
96;24.08.2015;2015;08;13;Maanantai;115;116;231;13;10;23
96;24.08.2015;2015;08;14;Maanantai;127;173;300;6;23;29
96;24.08.2015;2015;08;15;Maanantai;161;259;420;10;25;35
96;24.08.2015;2015;08;16;Maanantai;201;228;429;9;24;33
96;24.08.2015;2015;08;17;Maanantai;125;113;238;16;9;25
96;24.08.2015;2015;08;18;Maanantai;112;84;196;19;18;37
96;24.08.2015;2015;08;19;Maanantai;98;69;167;9;9;18
96;24.08.2015;2015;08;20;Maanantai;104;70;174;17;19;36
96;24.08.2015;2015;08;21;Maanantai;52;54;106;9;5;14
96;24.08.2015;2015;08;22;Maanantai;15;20;35;1;7;8
96;24.08.2015;2015;08;23;Maanantai;5;6;11;0;3;3
96;25.08.2015;2015;08;00;Tiistai;4;2;6;0;1;1
96;25.08.2015;2015;08;01;Tiistai;2;1;3;0;0;0
96;25.08.2015;2015;08;02;Tiistai;1;0;1;0;0;0
96;25.08.2015;2015;08;03;Tiistai;1;1;2;0;0;0
96;25.08.2015;2015;08;04;Tiistai;4;3;7;0;0;0
96;25.08.2015;2015;08;05;Tiistai;8;6;14;0;1;1
96;25.08.2015;2015;08;06;Tiistai;49;58;107;9;0;9
96;25.08.2015;2015;08;07;Tiistai;204;194;398;13;13;26
96;25.08.2015;2015;08;08;Tiistai;176;240;416;11;12;23
96;25.08.2015;2015;08;09;Tiistai;177;162;339;32;24;56
96;25.08.2015;2015;08;10;Tiistai;114;138;252;15;28;43
96;25.08.2015;2015;08;11;Tiistai;148;123;271;25;28;53
96;25.08.2015;2015;08;12;Tiistai;123;130;253;28;16;44
96;25.08.2015;2015;08;13;Tiistai;112;102;214;22;3;25
96;25.08.2015;2015;08;14;Tiistai;148;165;313;9;18;27
96;25.08.2015;2015;08;15;Tiistai;205;286;491;8;25;33
96;25.08.2015;2015;08;16;Tiistai;212;243;455;12;30;42
96;25.08.2015;2015;08;17;Tiistai;145;121;266;8;18;26
96;25.08.2015;2015;08;18;Tiistai;128;103;231;15;22;37
96;25.08.2015;2015;08;19;Tiistai;108;77;185;13;11;24
96;25.08.2015;2015;08;20;Tiistai;90;71;161;16;12;28
96;25.08.2015;2015;08;21;Tiistai;50;37;87;9;5;14
96;25.08.2015;2015;08;22;Tiistai;27;27;54;4;6;10
96;25.08.2015;2015;08;23;Tiistai;8;9;17;0;6;6
96;26.08.2015;2015;08;00;Keskiviikko;7;5;12;0;0;0
96;26.08.2015;2015;08;01;Keskiviikko;7;0;7;0;0;0
96;26.08.2015;2015;08;02;Keskiviikko;4;2;6;1;0;1
96;26.08.2015;2015;08;03;Keskiviikko;11;2;13;2;4;6
96;26.08.2015;2015;08;04;Keskiviikko;8;2;10;0;0;0
96;26.08.2015;2015;08;05;Keskiviikko;7;9;16;2;7;9
96;26.08.2015;2015;08;06;Keskiviikko;64;56;120;4;1;5
96;26.08.2015;2015;08;07;Keskiviikko;169;193;362;14;6;20
96;26.08.2015;2015;08;08;Keskiviikko;177;226;403;13;9;22
96;26.08.2015;2015;08;09;Keskiviikko;188;146;334;21;37;58
96;26.08.2015;2015;08;10;Keskiviikko;114;99;213;15;31;46
96;26.08.2015;2015;08;11;Keskiviikko;135;128;263;26;32;58
96;26.08.2015;2015;08;12;Keskiviikko;148;119;267;25;7;32
96;26.08.2015;2015;08;13;Keskiviikko;140;142;282;16;18;34
96;26.08.2015;2015;08;14;Keskiviikko;154;198;352;5;21;26
96;26.08.2015;2015;08;15;Keskiviikko;152;221;373;5;18;23
96;26.08.2015;2015;08;16;Keskiviikko;193;261;454;7;12;19
96;26.08.2015;2015;08;17;Keskiviikko;133;106;239;12;14;26
96;26.08.2015;2015;08;18;Keskiviikko;145;86;231;25;17;42
96;26.08.2015;2015;08;19;Keskiviikko;98;56;154;18;18;36
96;26.08.2015;2015;08;20;Keskiviikko;78;76;154;13;17;30
96;26.08.2015;2015;08;21;Keskiviikko;34;41;75;3;5;8
96;26.08.2015;2015;08;22;Keskiviikko;18;22;40;2;4;6
96;26.08.2015;2015;08;23;Keskiviikko;7;15;22;1;0;1
96;27.08.2015;2015;08;00;Torstai;8;2;10;1;1;2
96;27.08.2015;2015;08;01;Torstai;4;1;5;1;0;1
96;27.08.2015;2015;08;02;Torstai;5;1;6;1;0;1
96;27.08.2015;2015;08;03;Torstai;1;0;1;0;0;0
96;27.08.2015;2015;08;04;Torstai;4;2;6;1;0;1
96;27.08.2015;2015;08;05;Torstai;5;6;11;0;0;0
96;27.08.2015;2015;08;06;Torstai;45;34;79;5;0;5
96;27.08.2015;2015;08;07;Torstai;145;160;305;4;8;12
96;27.08.2015;2015;08;08;Torstai;160;207;367;20;14;34
96;27.08.2015;2015;08;09;Torstai;155;157;312;29;15;44
96;27.08.2015;2015;08;10;Torstai;97;116;213;17;18;35
96;27.08.2015;2015;08;11;Torstai;103;110;213;17;37;54
96;27.08.2015;2015;08;12;Torstai;97;121;218;18;12;30
96;27.08.2015;2015;08;13;Torstai;99;112;211;17;10;27
96;27.08.2015;2015;08;14;Torstai;144;188;332;6;24;30
96;27.08.2015;2015;08;15;Torstai;106;243;349;3;29;32
96;27.08.2015;2015;08;16;Torstai;171;177;348;6;14;20
96;27.08.2015;2015;08;17;Torstai;83;85;168;5;8;13
96;27.08.2015;2015;08;18;Torstai;83;94;177;15;17;32
96;27.08.2015;2015;08;19;Torstai;57;55;112;12;11;23
96;27.08.2015;2015;08;20;Torstai;76;50;126;13;12;25
96;27.08.2015;2015;08;21;Torstai;44;39;83;6;9;15
96;27.08.2015;2015;08;22;Torstai;20;23;43;2;7;9
96;27.08.2015;2015;08;23;Torstai;4;2;6;1;1;2
96;28.08.2015;2015;08;00;Perjantai;3;5;8;1;1;2
96;28.08.2015;2015;08;01;Perjantai;5;0;5;0;0;0
96;28.08.2015;2015;08;02;Perjantai;5;2;7;0;1;1
96;28.08.2015;2015;08;03;Perjantai;3;1;4;1;1;2
96;28.08.2015;2015;08;04;Perjantai;4;3;7;0;0;0
96;28.08.2015;2015;08;05;Perjantai;5;6;11;0;0;0
96;28.08.2015;2015;08;06;Perjantai;41;31;72;3;0;3
96;28.08.2015;2015;08;07;Perjantai;127;109;236;7;2;9
96;28.08.2015;2015;08;08;Perjantai;156;120;276;16;12;28
96;28.08.2015;2015;08;09;Perjantai;85;128;213;12;15;27
96;28.08.2015;2015;08;10;Perjantai;89;80;169;3;15;18
96;28.08.2015;2015;08;11;Perjantai;60;112;172;8;22;30
96;28.08.2015;2015;08;12;Perjantai;79;86;165;9;7;16
96;28.08.2015;2015;08;13;Perjantai;59;79;138;3;13;16
96;28.08.2015;2015;08;14;Perjantai;63;126;189;2;15;17
96;28.08.2015;2015;08;15;Perjantai;72;114;186;2;24;26
96;28.08.2015;2015;08;16;Perjantai;74;77;151;4;8;12
96;28.08.2015;2015;08;17;Perjantai;45;34;79;5;4;9
96;28.08.2015;2015;08;18;Perjantai;42;19;61;1;4;5
96;28.08.2015;2015;08;19;Perjantai;22;9;31;3;2;5
96;28.08.2015;2015;08;20;Perjantai;12;13;25;2;4;6
96;28.08.2015;2015;08;21;Perjantai;12;17;29;0;4;4
96;28.08.2015;2015;08;22;Perjantai;5;2;7;0;1;1
96;28.08.2015;2015;08;23;Perjantai;8;5;13;1;1;2
96;29.08.2015;2015;08;00;Lauantai;8;4;12;1;1;2
96;29.08.2015;2015;08;01;Lauantai;6;2;8;1;1;2
96;29.08.2015;2015;08;02;Lauantai;9;3;12;0;0;0
96;29.08.2015;2015;08;03;Lauantai;9;2;11;7;0;7
96;29.08.2015;2015;08;04;Lauantai;4;1;5;2;1;3
96;29.08.2015;2015;08;05;Lauantai;2;3;5;0;0;0
96;29.08.2015;2015;08;06;Lauantai;12;9;21;1;0;1
96;29.08.2015;2015;08;07;Lauantai;5;13;18;1;3;4
96;29.08.2015;2015;08;08;Lauantai;17;14;31;3;2;5
96;29.08.2015;2015;08;09;Lauantai;23;36;59;1;1;2
96;29.08.2015;2015;08;10;Lauantai;22;41;63;2;6;8
96;29.08.2015;2015;08;11;Lauantai;46;59;105;10;7;17
96;29.08.2015;2015;08;12;Lauantai;58;63;121;9;9;18
96;29.08.2015;2015;08;13;Lauantai;60;75;135;3;9;12
96;29.08.2015;2015;08;14;Lauantai;67;65;132;7;6;13
96;29.08.2015;2015;08;15;Lauantai;85;70;155;4;14;18
96;29.08.2015;2015;08;16;Lauantai;65;60;125;6;5;11
96;29.08.2015;2015;08;17;Lauantai;61;63;124;10;3;13
96;29.08.2015;2015;08;18;Lauantai;73;58;131;11;7;18
96;29.08.2015;2015;08;19;Lauantai;43;46;89;12;7;19
96;29.08.2015;2015;08;20;Lauantai;38;46;84;2;7;9
96;29.08.2015;2015;08;21;Lauantai;34;52;86;4;5;9
96;29.08.2015;2015;08;22;Lauantai;22;13;35;3;4;7
96;29.08.2015;2015;08;23;Lauantai;12;14;26;1;1;2
96;30.08.2015;2015;08;00;Sunnuntai;13;5;18;0;0;0
96;30.08.2015;2015;08;01;Sunnuntai;15;4;19;1;0;1
96;30.08.2015;2015;08;02;Sunnuntai;23;2;25;2;1;3
96;30.08.2015;2015;08;03;Sunnuntai;25;1;26;1;2;3
96;30.08.2015;2015;08;04;Sunnuntai;9;3;12;1;0;1
96;30.08.2015;2015;08;05;Sunnuntai;0;1;1;1;1;2
96;30.08.2015;2015;08;06;Sunnuntai;15;13;28;2;1;3
96;30.08.2015;2015;08;07;Sunnuntai;2;17;19;0;2;2
96;30.08.2015;2015;08;08;Sunnuntai;9;7;16;4;4;8
96;30.08.2015;2015;08;09;Sunnuntai;12;21;33;5;4;9
96;30.08.2015;2015;08;10;Sunnuntai;21;32;53;4;7;11
96;30.08.2015;2015;08;11;Sunnuntai;35;43;78;12;6;18
96;30.08.2015;2015;08;12;Sunnuntai;36;69;105;5;13;18
96;30.08.2015;2015;08;13;Sunnuntai;59;57;116;7;6;13
96;30.08.2015;2015;08;14;Sunnuntai;75;47;122;9;10;19
96;30.08.2015;2015;08;15;Sunnuntai;70;60;130;10;12;22
96;30.08.2015;2015;08;16;Sunnuntai;90;75;165;22;8;30
96;30.08.2015;2015;08;17;Sunnuntai;82;48;130;14;12;26
96;30.08.2015;2015;08;18;Sunnuntai;67;65;132;10;23;33
96;30.08.2015;2015;08;19;Sunnuntai;52;44;96;7;10;17
96;30.08.2015;2015;08;20;Sunnuntai;29;53;82;4;15;19
96;30.08.2015;2015;08;21;Sunnuntai;27;24;51;4;3;7
96;30.08.2015;2015;08;22;Sunnuntai;7;4;11;3;5;8
96;30.08.2015;2015;08;23;Sunnuntai;3;5;8;0;2;2
96;31.08.2015;2015;08;00;Maanantai;2;1;3;1;0;1
96;31.08.2015;2015;08;01;Maanantai;1;1;2;2;0;2
96;31.08.2015;2015;08;02;Maanantai;2;0;2;0;1;1
96;31.08.2015;2015;08;03;Maanantai;2;0;2;0;0;0
96;31.08.2015;2015;08;04;Maanantai;3;0;3;0;0;0
96;31.08.2015;2015;08;05;Maanantai;7;5;12;0;1;1
96;31.08.2015;2015;08;06;Maanantai;50;46;96;1;0;1
96;31.08.2015;2015;08;07;Maanantai;143;141;284;16;3;19
96;31.08.2015;2015;08;08;Maanantai;156;189;345;15;6;21
96;31.08.2015;2015;08;09;Maanantai;120;120;240;19;9;28
96;31.08.2015;2015;08;10;Maanantai;74;101;175;6;4;10
96;31.08.2015;2015;08;11;Maanantai;82;116;198;9;13;22
96;31.08.2015;2015;08;12;Maanantai;131;107;238;16;14;30
96;31.08.2015;2015;08;13;Maanantai;115;161;276;7;12;19
96;31.08.2015;2015;08;14;Maanantai;110;172;282;6;16;22
96;31.08.2015;2015;08;15;Maanantai;153;254;407;8;21;29
96;31.08.2015;2015;08;16;Maanantai;182;191;373;7;20;27
96;31.08.2015;2015;08;17;Maanantai;127;123;250;17;18;35
96;31.08.2015;2015;08;18;Maanantai;100;103;203;19;15;34
96;31.08.2015;2015;08;19;Maanantai;72;87;159;11;15;26
96;31.08.2015;2015;08;20;Maanantai;99;63;162;10;18;28
96;31.08.2015;2015;08;21;Maanantai;38;57;95;8;4;12
96;31.08.2015;2015;08;22;Maanantai;9;12;21;4;3;7
96;31.08.2015;2015;08;23;Maanantai;5;2;7;0;1;1
96;01.09.2015;2015;09;00;Tiistai;3;4;7;1;0;1
96;01.09.2015;2015;09;01;Tiistai;4;0;4;0;0;0
96;01.09.2015;2015;09;02;Tiistai;2;0;2;0;0;0
96;01.09.2015;2015;09;03;Tiistai;1;4;5;0;0;0
96;01.09.2015;2015;09;04;Tiistai;1;1;2;0;0;0
96;01.09.2015;2015;09;05;Tiistai;9;7;16;0;1;1
96;01.09.2015;2015;09;06;Tiistai;50;39;89;4;2;6
96;01.09.2015;2015;09;07;Tiistai;145;134;279;15;4;19
96;01.09.2015;2015;09;08;Tiistai;202;147;349;27;8;35
96;01.09.2015;2015;09;09;Tiistai;100;124;224;14;4;18
96;01.09.2015;2015;09;10;Tiistai;73;83;156;7;11;18
96;01.09.2015;2015;09;11;Tiistai;104;94;198;8;16;24
96;01.09.2015;2015;09;12;Tiistai;117;110;227;9;10;19
96;01.09.2015;2015;09;13;Tiistai;85;149;234;14;11;25
96;01.09.2015;2015;09;14;Tiistai;84;180;264;17;25;42
96;01.09.2015;2015;09;15;Tiistai;141;256;397;10;18;28
96;01.09.2015;2015;09;16;Tiistai;187;202;389;14;23;37
96;01.09.2015;2015;09;17;Tiistai;120;110;230;11;11;22
96;01.09.2015;2015;09;18;Tiistai;107;94;201;17;13;30
96;01.09.2015;2015;09;19;Tiistai;112;81;193;15;9;24
96;01.09.2015;2015;09;20;Tiistai;74;68;142;4;10;14
96;01.09.2015;2015;09;21;Tiistai;41;36;77;10;6;16
96;01.09.2015;2015;09;22;Tiistai;20;21;41;3;5;8
96;01.09.2015;2015;09;23;Tiistai;6;2;8;1;4;5
96;02.09.2015;2015;09;00;Keskiviikko;5;2;7;1;1;2
96;02.09.2015;2015;09;01;Keskiviikko;5;2;7;0;0;0
96;02.09.2015;2015;09;02;Keskiviikko;2;0;2;0;0;0
96;02.09.2015;2015;09;03;Keskiviikko;1;1;2;0;0;0
96;02.09.2015;2015;09;04;Keskiviikko;3;0;3;0;0;0
96;02.09.2015;2015;09;05;Keskiviikko;10;9;19;1;2;3
96;02.09.2015;2015;09;06;Keskiviikko;46;43;89;6;1;7
96;02.09.2015;2015;09;07;Keskiviikko;155;212;367;15;8;23
96;02.09.2015;2015;09;08;Keskiviikko;194;206;400;23;12;35
96;02.09.2015;2015;09;09;Keskiviikko;114;114;228;21;10;31
96;02.09.2015;2015;09;10;Keskiviikko;225;104;329;27;6;33
96;02.09.2015;2015;09;11;Keskiviikko;94;112;206;10;14;24
96;02.09.2015;2015;09;12;Keskiviikko;113;115;228;10;13;23
96;02.09.2015;2015;09;13;Keskiviikko;100;111;211;5;5;10
96;02.09.2015;2015;09;14;Keskiviikko;94;218;312;9;18;27
96;02.09.2015;2015;09;15;Keskiviikko;120;296;416;8;22;30
96;02.09.2015;2015;09;16;Keskiviikko;180;247;427;13;16;29
96;02.09.2015;2015;09;17;Keskiviikko;120;121;241;14;14;28
96;02.09.2015;2015;09;18;Keskiviikko;128;120;248;17;16;33
96;02.09.2015;2015;09;19;Keskiviikko;99;62;161;11;15;26
96;02.09.2015;2015;09;20;Keskiviikko;64;100;164;9;17;26
96;02.09.2015;2015;09;21;Keskiviikko;51;55;106;6;6;12
96;02.09.2015;2015;09;22;Keskiviikko;12;18;30;2;5;7
96;02.09.2015;2015;09;23;Keskiviikko;3;3;6;0;0;0
96;03.09.2015;2015;09;00;Torstai;4;0;4;1;0;1
96;03.09.2015;2015;09;01;Torstai;3;2;5;0;0;0
96;03.09.2015;2015;09;02;Torstai;3;0;3;0;0;0
96;03.09.2015;2015;09;03;Torstai;3;0;3;0;0;0
96;03.09.2015;2015;09;04;Torstai;3;1;4;0;0;0
96;03.09.2015;2015;09;05;Torstai;6;6;12;1;1;2
96;03.09.2015;2015;09;06;Torstai;49;39;88;6;3;9
96;03.09.2015;2015;09;07;Torstai;152;148;300;20;7;27
96;03.09.2015;2015;09;08;Torstai;200;148;348;14;5;19
96;03.09.2015;2015;09;09;Torstai;129;92;221;17;5;22
96;03.09.2015;2015;09;10;Torstai;73;79;152;11;9;20
96;03.09.2015;2015;09;11;Torstai;70;108;178;30;12;42
96;03.09.2015;2015;09;12;Torstai;104;104;208;12;7;19
96;03.09.2015;2015;09;13;Torstai;79;136;215;7;10;17
96;03.09.2015;2015;09;14;Torstai;119;207;326;6;18;24
96;03.09.2015;2015;09;15;Torstai;129;260;389;3;32;35
96;03.09.2015;2015;09;16;Torstai;166;211;377;9;23;32
96;03.09.2015;2015;09;17;Torstai;104;97;201;11;12;23
96;03.09.2015;2015;09;18;Torstai;92;62;154;14;21;35
96;03.09.2015;2015;09;19;Torstai;103;86;189;15;12;27
96;03.09.2015;2015;09;20;Torstai;61;58;119;13;10;23
96;03.09.2015;2015;09;21;Torstai;34;41;75;8;8;16
96;03.09.2015;2015;09;22;Torstai;17;13;30;1;2;3
96;03.09.2015;2015;09;23;Torstai;3;2;5;0;0;0
96;04.09.2015;2015;09;00;Perjantai;2;2;4;0;2;2
96;04.09.2015;2015;09;01;Perjantai;4;1;5;0;0;0
96;04.09.2015;2015;09;02;Perjantai;10;2;12;0;0;0
96;04.09.2015;2015;09;03;Perjantai;3;0;3;1;0;1
96;04.09.2015;2015;09;04;Perjantai;2;0;2;0;0;0
96;04.09.2015;2015;09;05;Perjantai;6;8;14;1;4;5
96;04.09.2015;2015;09;06;Perjantai;46;36;82;6;1;7
96;04.09.2015;2015;09;07;Perjantai;106;135;241;14;3;17
96;04.09.2015;2015;09;08;Perjantai;166;150;316;17;4;21
96;04.09.2015;2015;09;09;Perjantai;71;101;172;8;7;15
96;04.09.2015;2015;09;10;Perjantai;91;92;183;8;12;20
96;04.09.2015;2015;09;11;Perjantai;91;125;216;8;17;25
96;04.09.2015;2015;09;12;Perjantai;93;232;325;12;29;41
96;04.09.2015;2015;09;13;Perjantai;90;177;267;11;13;24
96;04.09.2015;2015;09;14;Perjantai;165;211;376;23;17;40
96;04.09.2015;2015;09;15;Perjantai;128;179;307;8;25;33
96;04.09.2015;2015;09;16;Perjantai;150;114;264;9;19;28
96;04.09.2015;2015;09;17;Perjantai;79;94;173;9;9;18
96;04.09.2015;2015;09;18;Perjantai;64;65;129;16;6;22
96;04.09.2015;2015;09;19;Perjantai;61;93;154;3;21;24
96;04.09.2015;2015;09;20;Perjantai;38;75;113;5;18;23
96;04.09.2015;2015;09;21;Perjantai;42;106;148;4;20;24
96;04.09.2015;2015;09;22;Perjantai;25;28;53;7;7;14
96;04.09.2015;2015;09;23;Perjantai;16;21;37;5;2;7
96;05.09.2015;2015;09;00;Lauantai;29;22;51;8;3;11
96;05.09.2015;2015;09;01;Lauantai;56;9;65;15;0;15
96;05.09.2015;2015;09;02;Lauantai;22;2;24;2;0;2
96;05.09.2015;2015;09;03;Lauantai;28;2;30;4;0;4
96;05.09.2015;2015;09;04;Lauantai;15;2;17;2;0;2
96;05.09.2015;2015;09;05;Lauantai;1;0;1;0;2;2
96;05.09.2015;2015;09;06;Lauantai;27;9;36;3;0;3
96;05.09.2015;2015;09;07;Lauantai;8;8;16;1;2;3
96;05.09.2015;2015;09;08;Lauantai;11;42;53;2;4;6
96;05.09.2015;2015;09;09;Lauantai;26;36;62;6;4;10
96;05.09.2015;2015;09;10;Lauantai;34;52;86;8;8;16
96;05.09.2015;2015;09;11;Lauantai;29;73;102;4;9;13
96;05.09.2015;2015;09;12;Lauantai;51;69;120;10;13;23
96;05.09.2015;2015;09;13;Lauantai;55;76;131;5;9;14
96;05.09.2015;2015;09;14;Lauantai;52;50;102;6;10;16
96;05.09.2015;2015;09;15;Lauantai;50;61;111;8;12;20
96;05.09.2015;2015;09;16;Lauantai;47;43;90;10;2;12
96;05.09.2015;2015;09;17;Lauantai;49;43;92;5;7;12
96;05.09.2015;2015;09;18;Lauantai;51;52;103;15;8;23
96;05.09.2015;2015;09;19;Lauantai;39;55;94;7;17;24
96;05.09.2015;2015;09;20;Lauantai;38;31;69;4;9;13
96;05.09.2015;2015;09;21;Lauantai;49;38;87;9;2;11
96;05.09.2015;2015;09;22;Lauantai;19;10;29;4;6;10
96;05.09.2015;2015;09;23;Lauantai;18;18;36;1;0;1
96;06.09.2015;2015;09;00;Sunnuntai;6;4;10;5;1;6
96;06.09.2015;2015;09;01;Sunnuntai;11;7;18;0;0;0
96;06.09.2015;2015;09;02;Sunnuntai;22;3;25;1;0;1
96;06.09.2015;2015;09;03;Sunnuntai;16;5;21;2;0;2
96;06.09.2015;2015;09;04;Sunnuntai;11;2;13;2;0;2
96;06.09.2015;2015;09;05;Sunnuntai;0;2;2;0;0;0
96;06.09.2015;2015;09;06;Sunnuntai;18;4;22;1;0;1
96;06.09.2015;2015;09;07;Sunnuntai;4;9;13;1;1;2
96;06.09.2015;2015;09;08;Sunnuntai;3;10;13;2;0;2
96;06.09.2015;2015;09;09;Sunnuntai;6;16;22;1;5;6
96;06.09.2015;2015;09;10;Sunnuntai;13;13;26;3;3;6
96;06.09.2015;2015;09;11;Sunnuntai;12;14;26;2;3;5
96;06.09.2015;2015;09;12;Sunnuntai;19;21;40;4;5;9
96;06.09.2015;2015;09;13;Sunnuntai;26;46;72;8;7;15
96;06.09.2015;2015;09;14;Sunnuntai;19;32;51;3;12;15
96;06.09.2015;2015;09;15;Sunnuntai;35;41;76;11;3;14
96;06.09.2015;2015;09;16;Sunnuntai;53;36;89;17;5;22
96;06.09.2015;2015;09;17;Sunnuntai;53;30;83;17;9;26
96;06.09.2015;2015;09;18;Sunnuntai;50;43;93;13;23;36
96;06.09.2015;2015;09;19;Sunnuntai;19;53;72;11;15;26
96;06.09.2015;2015;09;20;Sunnuntai;33;36;69;9;14;23
96;06.09.2015;2015;09;21;Sunnuntai;16;23;39;3;1;4
96;06.09.2015;2015;09;22;Sunnuntai;7;11;18;0;1;1
96;06.09.2015;2015;09;23;Sunnuntai;3;7;10;1;4;5
96;07.09.2015;2015;09;00;Maanantai;8;6;14;1;1;2
96;07.09.2015;2015;09;01;Maanantai;1;1;2;1;1;2
96;07.09.2015;2015;09;02;Maanantai;3;2;5;1;0;1
96;07.09.2015;2015;09;03;Maanantai;4;0;4;0;0;0
96;07.09.2015;2015;09;04;Maanantai;3;2;5;0;0;0
96;07.09.2015;2015;09;05;Maanantai;7;10;17;2;0;2
96;07.09.2015;2015;09;06;Maanantai;45;35;80;5;2;7
96;07.09.2015;2015;09;07;Maanantai;140;132;272;20;4;24
96;07.09.2015;2015;09;08;Maanantai;163;149;312;13;6;19
96;07.09.2015;2015;09;09;Maanantai;110;109;219;12;4;16
96;07.09.2015;2015;09;10;Maanantai;96;89;185;8;9;17
96;07.09.2015;2015;09;11;Maanantai;58;92;150;13;23;36
96;07.09.2015;2015;09;12;Maanantai;85;93;178;11;11;22
96;07.09.2015;2015;09;13;Maanantai;93;122;215;8;7;15
96;07.09.2015;2015;09;14;Maanantai;91;182;273;10;14;24
96;07.09.2015;2015;09;15;Maanantai;139;269;408;9;27;36
96;07.09.2015;2015;09;16;Maanantai;121;233;354;13;26;39
96;07.09.2015;2015;09;17;Maanantai;97;108;205;12;8;20
96;07.09.2015;2015;09;18;Maanantai;97;111;208;20;15;35
96;07.09.2015;2015;09;19;Maanantai;73;66;139;15;12;27
96;07.09.2015;2015;09;20;Maanantai;67;48;115;9;11;20
96;07.09.2015;2015;09;21;Maanantai;39;49;88;5;6;11
96;07.09.2015;2015;09;22;Maanantai;10;3;13;1;4;5
96;07.09.2015;2015;09;23;Maanantai;5;0;5;0;2;2
96;08.09.2015;2015;09;00;Tiistai;3;1;4;1;0;1
96;08.09.2015;2015;09;01;Tiistai;1;1;2;0;0;0
96;08.09.2015;2015;09;02;Tiistai;0;0;0;0;0;0
96;08.09.2015;2015;09;03;Tiistai;2;0;2;0;1;1
96;08.09.2015;2015;09;04;Tiistai;4;2;6;0;0;0
96;08.09.2015;2015;09;05;Tiistai;8;8;16;0;1;1
96;08.09.2015;2015;09;06;Tiistai;53;45;98;2;1;3
96;08.09.2015;2015;09;07;Tiistai;149;152;301;19;9;28
96;08.09.2015;2015;09;08;Tiistai;207;157;364;22;11;33
96;08.09.2015;2015;09;09;Tiistai;95;137;232;12;16;28
96;08.09.2015;2015;09;10;Tiistai;66;74;140;7;5;12
96;08.09.2015;2015;09;11;Tiistai;67;102;169;10;9;19
96;08.09.2015;2015;09;12;Tiistai;86;102;188;11;15;26
96;08.09.2015;2015;09;13;Tiistai;70;118;188;10;10;20
96;08.09.2015;2015;09;14;Tiistai;100;184;284;2;20;22
96;08.09.2015;2015;09;15;Tiistai;118;272;390;8;25;33
96;08.09.2015;2015;09;16;Tiistai;183;240;423;10;20;30
96;08.09.2015;2015;09;17;Tiistai;89;111;200;6;15;21
96;08.09.2015;2015;09;18;Tiistai;100;75;175;6;16;22
96;08.09.2015;2015;09;19;Tiistai;91;70;161;16;9;25
96;08.09.2015;2015;09;20;Tiistai;75;60;135;8;13;21
96;08.09.2015;2015;09;21;Tiistai;38;33;71;7;7;14
96;08.09.2015;2015;09;22;Tiistai;8;10;18;4;4;8
96;08.09.2015;2015;09;23;Tiistai;10;3;13;0;0;0
96;09.09.2015;2015;09;00;Keskiviikko;3;0;3;0;1;1
96;09.09.2015;2015;09;01;Keskiviikko;3;0;3;0;0;0
96;09.09.2015;2015;09;02;Keskiviikko;0;0;0;0;0;0
96;09.09.2015;2015;09;03;Keskiviikko;2;3;5;0;0;0
96;09.09.2015;2015;09;04;Keskiviikko;4;2;6;0;0;0
96;09.09.2015;2015;09;05;Keskiviikko;7;5;12;1;2;3
96;09.09.2015;2015;09;06;Keskiviikko;46;45;91;4;3;7
96;09.09.2015;2015;09;07;Keskiviikko;131;160;291;22;9;31
96;09.09.2015;2015;09;08;Keskiviikko;183;154;337;20;9;29
96;09.09.2015;2015;09;09;Keskiviikko;129;108;237;11;7;18
96;09.09.2015;2015;09;10;Keskiviikko;66;84;150;5;5;10
96;09.09.2015;2015;09;11;Keskiviikko;83;109;192;16;11;27
96;09.09.2015;2015;09;12;Keskiviikko;119;122;241;9;15;24
96;09.09.2015;2015;09;13;Keskiviikko;104;121;225;7;12;19
96;09.09.2015;2015;09;14;Keskiviikko;109;201;310;6;24;30
96;09.09.2015;2015;09;15;Keskiviikko;131;283;414;6;17;23
96;09.09.2015;2015;09;16;Keskiviikko;153;218;371;13;22;35
96;09.09.2015;2015;09;17;Keskiviikko;135;133;268;7;6;13
96;09.09.2015;2015;09;18;Keskiviikko;132;106;238;23;10;33
96;09.09.2015;2015;09;19;Keskiviikko;108;85;193;16;17;33
96;09.09.2015;2015;09;20;Keskiviikko;78;110;188;5;14;19
96;09.09.2015;2015;09;21;Keskiviikko;30;83;113;7;16;23
96;09.09.2015;2015;09;22;Keskiviikko;20;43;63;3;7;10
96;09.09.2015;2015;09;23;Keskiviikko;38;16;54;11;2;13
96;10.09.2015;2015;09;00;Torstai;41;12;53;7;2;9
96;10.09.2015;2015;09;01;Torstai;9;12;21;2;2;4
96;10.09.2015;2015;09;02;Torstai;9;2;11;1;0;1
96;10.09.2015;2015;09;03;Torstai;5;0;5;1;0;1
96;10.09.2015;2015;09;04;Torstai;2;4;6;1;0;1
96;10.09.2015;2015;09;05;Torstai;8;6;14;1;1;2
96;10.09.2015;2015;09;06;Torstai;54;31;85;4;1;5
96;10.09.2015;2015;09;07;Torstai;131;147;278;14;8;22
96;10.09.2015;2015;09;08;Torstai;187;239;426;19;16;35
96;10.09.2015;2015;09;09;Torstai;127;110;237;16;5;21
96;10.09.2015;2015;09;10;Torstai;86;72;158;16;7;23
96;10.09.2015;2015;09;11;Torstai;134;129;263;8;12;20
96;10.09.2015;2015;09;12;Torstai;103;125;228;31;10;41
96;10.09.2015;2015;09;13;Torstai;96;142;238;6;7;13
96;10.09.2015;2015;09;14;Torstai;123;215;338;5;12;17
96;10.09.2015;2015;09;15;Torstai;143;242;385;14;22;36
96;10.09.2015;2015;09;16;Torstai;171;208;379;13;19;32
96;10.09.2015;2015;09;17;Torstai;99;119;218;9;9;18
96;10.09.2015;2015;09;18;Torstai;108;104;212;15;12;27
96;10.09.2015;2015;09;19;Torstai;81;58;139;13;5;18
96;10.09.2015;2015;09;20;Torstai;72;53;125;7;8;15
96;10.09.2015;2015;09;21;Torstai;35;42;77;4;3;7
96;10.09.2015;2015;09;22;Torstai;14;10;24;3;3;6
96;10.09.2015;2015;09;23;Torstai;10;7;17;0;2;2
96;11.09.2015;2015;09;00;Perjantai;4;2;6;0;1;1
96;11.09.2015;2015;09;01;Perjantai;3;1;4;0;0;0
96;11.09.2015;2015;09;02;Perjantai;1;0;1;1;0;1
96;11.09.2015;2015;09;03;Perjantai;0;0;0;0;0;0
96;11.09.2015;2015;09;04;Perjantai;3;3;6;0;1;1
96;11.09.2015;2015;09;05;Perjantai;3;7;10;2;0;2
96;11.09.2015;2015;09;06;Perjantai;39;34;73;6;2;8
96;11.09.2015;2015;09;07;Perjantai;137;114;251;12;6;18
96;11.09.2015;2015;09;08;Perjantai;199;130;329;17;4;21
96;11.09.2015;2015;09;09;Perjantai;74;129;203;11;8;19
96;11.09.2015;2015;09;10;Perjantai;77;92;169;13;6;19
96;11.09.2015;2015;09;11;Perjantai;77;103;180;8;19;27
96;11.09.2015;2015;09;12;Perjantai;109;142;251;9;12;21
96;11.09.2015;2015;09;13;Perjantai;97;135;232;8;12;20
96;11.09.2015;2015;09;14;Perjantai;130;193;323;5;20;25
96;11.09.2015;2015;09;15;Perjantai;142;180;322;8;10;18
96;11.09.2015;2015;09;16;Perjantai;133;118;251;8;10;18
96;11.09.2015;2015;09;17;Perjantai;82;79;161;10;8;18
96;11.09.2015;2015;09;18;Perjantai;78;54;132;10;10;20
96;11.09.2015;2015;09;19;Perjantai;64;48;112;7;6;13
96;11.09.2015;2015;09;20;Perjantai;45;41;86;2;5;7
96;11.09.2015;2015;09;21;Perjantai;40;38;78;5;3;8
96;11.09.2015;2015;09;22;Perjantai;30;27;57;1;4;5
96;11.09.2015;2015;09;23;Perjantai;13;17;30;2;1;3
96;12.09.2015;2015;09;00;Lauantai;12;8;20;1;2;3
96;12.09.2015;2015;09;01;Lauantai;11;4;15;0;3;3
96;12.09.2015;2015;09;02;Lauantai;17;1;18;1;0;1
96;12.09.2015;2015;09;03;Lauantai;9;3;12;4;0;4
96;12.09.2015;2015;09;04;Lauantai;3;1;4;1;1;2
96;12.09.2015;2015;09;05;Lauantai;3;4;7;1;1;2
96;12.09.2015;2015;09;06;Lauantai;17;8;25;1;1;2
96;12.09.2015;2015;09;07;Lauantai;3;24;27;2;2;4
96;12.09.2015;2015;09;08;Lauantai;6;26;32;8;5;13
96;12.09.2015;2015;09;09;Lauantai;17;43;60;4;8;12
96;12.09.2015;2015;09;10;Lauantai;30;43;73;7;6;13
96;12.09.2015;2015;09;11;Lauantai;46;62;108;10;13;23
96;12.09.2015;2015;09;12;Lauantai;67;68;135;9;5;14
96;12.09.2015;2015;09;13;Lauantai;69;90;159;10;5;15
96;12.09.2015;2015;09;14;Lauantai;59;61;120;4;11;15
96;12.09.2015;2015;09;15;Lauantai;66;88;154;8;15;23
96;12.09.2015;2015;09;16;Lauantai;61;79;140;13;21;34
96;12.09.2015;2015;09;17;Lauantai;60;53;113;9;8;17
96;12.09.2015;2015;09;18;Lauantai;71;50;121;15;7;22
96;12.09.2015;2015;09;19;Lauantai;78;48;126;18;1;19
96;12.09.2015;2015;09;20;Lauantai;55;42;97;12;6;18
96;12.09.2015;2015;09;21;Lauantai;29;43;72;5;5;10
96;12.09.2015;2015;09;22;Lauantai;11;25;36;4;2;6
96;12.09.2015;2015;09;23;Lauantai;14;17;31;5;4;9
96;13.09.2015;2015;09;00;Sunnuntai;14;5;19;2;1;3
96;13.09.2015;2015;09;01;Sunnuntai;10;3;13;1;6;7
96;13.09.2015;2015;09;02;Sunnuntai;15;0;15;0;0;0
96;13.09.2015;2015;09;03;Sunnuntai;11;0;11;2;0;2
96;13.09.2015;2015;09;04;Sunnuntai;11;1;12;2;0;2
96;13.09.2015;2015;09;05;Sunnuntai;6;2;8;1;1;2
96;13.09.2015;2015;09;06;Sunnuntai;17;6;23;2;1;3
96;13.09.2015;2015;09;07;Sunnuntai;4;20;24;2;2;4
96;13.09.2015;2015;09;08;Sunnuntai;5;7;12;0;2;2
96;13.09.2015;2015;09;09;Sunnuntai;12;22;34;4;9;13
96;13.09.2015;2015;09;10;Sunnuntai;28;52;80;10;8;18
96;13.09.2015;2015;09;11;Sunnuntai;27;47;74;7;9;16
96;13.09.2015;2015;09;12;Sunnuntai;62;52;114;8;4;12
96;13.09.2015;2015;09;13;Sunnuntai;88;71;159;9;9;18
96;13.09.2015;2015;09;14;Sunnuntai;71;68;139;12;9;21
96;13.09.2015;2015;09;15;Sunnuntai;71;79;150;11;6;17
96;13.09.2015;2015;09;16;Sunnuntai;55;74;129;14;8;22
96;13.09.2015;2015;09;17;Sunnuntai;73;63;136;10;12;22
96;13.09.2015;2015;09;18;Sunnuntai;81;65;146;17;24;41
96;13.09.2015;2015;09;19;Sunnuntai;48;43;91;7;15;22
96;13.09.2015;2015;09;20;Sunnuntai;38;48;86;10;13;23
96;13.09.2015;2015;09;21;Sunnuntai;19;36;55;7;9;16
96;13.09.2015;2015;09;22;Sunnuntai;11;10;21;2;3;5
96;13.09.2015;2015;09;23;Sunnuntai;3;3;6;1;2;3
96;14.09.2015;2015;09;00;Maanantai;2;1;3;2;0;2
96;14.09.2015;2015;09;01;Maanantai;6;1;7;0;1;1
96;14.09.2015;2015;09;02;Maanantai;0;0;0;0;0;0
96;14.09.2015;2015;09;03;Maanantai;4;0;4;0;0;0
96;14.09.2015;2015;09;04;Maanantai;3;0;3;0;0;0
96;14.09.2015;2015;09;05;Maanantai;7;7;14;1;1;2
96;14.09.2015;2015;09;06;Maanantai;52;33;85;5;2;7
96;14.09.2015;2015;09;07;Maanantai;138;148;286;11;7;18
96;14.09.2015;2015;09;08;Maanantai;223;188;411;15;8;23
96;14.09.2015;2015;09;09;Maanantai;87;104;191;15;10;25
96;14.09.2015;2015;09;10;Maanantai;94;98;192;13;11;24
96;14.09.2015;2015;09;11;Maanantai;92;101;193;6;9;15
96;14.09.2015;2015;09;12;Maanantai;126;116;242;18;10;28
96;14.09.2015;2015;09;13;Maanantai;109;133;242;14;10;24
96;14.09.2015;2015;09;14;Maanantai;130;196;326;14;16;30
96;14.09.2015;2015;09;15;Maanantai;144;271;415;5;29;34
96;14.09.2015;2015;09;16;Maanantai;184;250;434;7;19;26
96;14.09.2015;2015;09;17;Maanantai;121;121;242;17;19;36
96;14.09.2015;2015;09;18;Maanantai;127;101;228;17;19;36
96;14.09.2015;2015;09;19;Maanantai;80;75;155;6;15;21
96;14.09.2015;2015;09;20;Maanantai;102;85;187;13;16;29
96;14.09.2015;2015;09;21;Maanantai;23;45;68;4;10;14
96;14.09.2015;2015;09;22;Maanantai;6;17;23;0;0;0
96;14.09.2015;2015;09;23;Maanantai;6;3;9;0;2;2
96;15.09.2015;2015;09;00;Tiistai;3;2;5;0;1;1
96;15.09.2015;2015;09;01;Tiistai;1;1;2;0;1;1
96;15.09.2015;2015;09;02;Tiistai;0;0;0;0;0;0
96;15.09.2015;2015;09;03;Tiistai;1;2;3;0;0;0
96;15.09.2015;2015;09;04;Tiistai;1;1;2;0;0;0
96;15.09.2015;2015;09;05;Tiistai;4;13;17;0;0;0
96;15.09.2015;2015;09;06;Tiistai;56;40;96;4;3;7
96;15.09.2015;2015;09;07;Tiistai;143;168;311;16;5;21
96;15.09.2015;2015;09;08;Tiistai;191;180;371;12;7;19
96;15.09.2015;2015;09;09;Tiistai;123;110;233;18;9;27
96;15.09.2015;2015;09;10;Tiistai;67;83;150;16;11;27
96;15.09.2015;2015;09;11;Tiistai;84;112;196;18;15;33
96;15.09.2015;2015;09;12;Tiistai;127;117;244;9;15;24
96;15.09.2015;2015;09;13;Tiistai;109;124;233;8;10;18
96;15.09.2015;2015;09;14;Tiistai;102;188;290;6;17;23
96;15.09.2015;2015;09;15;Tiistai;148;277;425;10;34;44
96;15.09.2015;2015;09;16;Tiistai;171;271;442;14;19;33
96;15.09.2015;2015;09;17;Tiistai;118;144;262;20;14;34
96;15.09.2015;2015;09;18;Tiistai;112;117;229;12;8;20
96;15.09.2015;2015;09;19;Tiistai;82;68;150;4;12;16
96;15.09.2015;2015;09;20;Tiistai;92;63;155;18;14;32
96;15.09.2015;2015;09;21;Tiistai;53;53;106;8;8;16
96;15.09.2015;2015;09;22;Tiistai;10;19;29;6;4;10
96;15.09.2015;2015;09;23;Tiistai;3;4;7;2;0;2
96;16.09.2015;2015;09;00;Keskiviikko;2;0;2;0;0;0
96;16.09.2015;2015;09;01;Keskiviikko;4;0;4;0;0;0
96;16.09.2015;2015;09;02;Keskiviikko;2;2;4;0;0;0
96;16.09.2015;2015;09;03;Keskiviikko;1;2;3;0;0;0
96;16.09.2015;2015;09;04;Keskiviikko;1;2;3;0;0;0
96;16.09.2015;2015;09;05;Keskiviikko;5;9;14;2;0;2
96;16.09.2015;2015;09;06;Keskiviikko;49;46;95;2;1;3
96;16.09.2015;2015;09;07;Keskiviikko;135;137;272;17;7;24
96;16.09.2015;2015;09;08;Keskiviikko;174;150;324;17;10;27
96;16.09.2015;2015;09;09;Keskiviikko;121;105;226;17;5;22
96;16.09.2015;2015;09;10;Keskiviikko;56;63;119;11;7;18
96;16.09.2015;2015;09;11;Keskiviikko;82;72;154;10;9;19
96;16.09.2015;2015;09;12;Keskiviikko;72;101;173;15;19;34
96;16.09.2015;2015;09;13;Keskiviikko;76;109;185;5;6;11
96;16.09.2015;2015;09;14;Keskiviikko;100;177;277;6;30;36
96;16.09.2015;2015;09;15;Keskiviikko;97;241;338;7;21;28
96;16.09.2015;2015;09;16;Keskiviikko;127;234;361;4;18;22
96;16.09.2015;2015;09;17;Keskiviikko;79;104;183;8;7;15
96;16.09.2015;2015;09;18;Keskiviikko;100;80;180;17;11;28
96;16.09.2015;2015;09;19;Keskiviikko;97;59;156;16;10;26
96;16.09.2015;2015;09;20;Keskiviikko;54;59;113;10;16;26
96;16.09.2015;2015;09;21;Keskiviikko;27;45;72;5;4;9
96;16.09.2015;2015;09;22;Keskiviikko;8;15;23;2;1;3
96;16.09.2015;2015;09;23;Keskiviikko;7;9;16;0;0;0
96;17.09.2015;2015;09;00;Torstai;2;3;5;1;0;1
96;17.09.2015;2015;09;01;Torstai;5;3;8;0;0;0
96;17.09.2015;2015;09;02;Torstai;2;0;2;0;0;0
96;17.09.2015;2015;09;03;Torstai;2;0;2;0;0;0
96;17.09.2015;2015;09;04;Torstai;2;3;5;0;0;0
96;17.09.2015;2015;09;05;Torstai;5;9;14;0;0;0
96;17.09.2015;2015;09;06;Torstai;59;38;97;6;3;9
96;17.09.2015;2015;09;07;Torstai;119;143;262;15;5;20
96;17.09.2015;2015;09;08;Torstai;150;178;328;19;8;27
96;17.09.2015;2015;09;09;Torstai;98;119;217;9;5;14
96;17.09.2015;2015;09;10;Torstai;64;73;137;14;6;20
96;17.09.2015;2015;09;11;Torstai;64;96;160;4;12;16
96;17.09.2015;2015;09;12;Torstai;88;98;186;10;7;17
96;17.09.2015;2015;09;13;Torstai;76;142;218;7;10;17
96;17.09.2015;2015;09;14;Torstai;117;207;324;4;16;20
96;17.09.2015;2015;09;15;Torstai;141;246;387;8;23;31
96;17.09.2015;2015;09;16;Torstai;148;213;361;8;17;25
96;17.09.2015;2015;09;17;Torstai;103;118;221;12;15;27
96;17.09.2015;2015;09;18;Torstai;69;112;181;11;10;21
96;17.09.2015;2015;09;19;Torstai;53;71;124;5;8;13
96;17.09.2015;2015;09;20;Torstai;72;42;114;7;4;11
96;17.09.2015;2015;09;21;Torstai;58;41;99;5;9;14
96;17.09.2015;2015;09;22;Torstai;18;12;30;3;1;4
96;17.09.2015;2015;09;23;Torstai;9;2;11;4;2;6
96;18.09.2015;2015;09;00;Perjantai;12;2;14;1;2;3
96;18.09.2015;2015;09;01;Perjantai;10;5;15;2;0;2
96;18.09.2015;2015;09;02;Perjantai;3;2;5;0;0;0
96;18.09.2015;2015;09;03;Perjantai;7;0;7;1;0;1
96;18.09.2015;2015;09;04;Perjantai;4;3;7;0;0;0
96;18.09.2015;2015;09;05;Perjantai;5;3;8;0;0;0
96;18.09.2015;2015;09;06;Perjantai;48;29;77;2;0;2
96;18.09.2015;2015;09;07;Perjantai;94;92;186;15;6;21
96;18.09.2015;2015;09;08;Perjantai;131;103;234;7;3;10
96;18.09.2015;2015;09;09;Perjantai;62;62;124;7;3;10
96;18.09.2015;2015;09;10;Perjantai;45;34;79;2;5;7
96;18.09.2015;2015;09;11;Perjantai;27;45;72;1;7;8
96;18.09.2015;2015;09;12;Perjantai;52;71;123;3;6;9
96;18.09.2015;2015;09;13;Perjantai;49;61;110;3;3;6
96;18.09.2015;2015;09;14;Perjantai;49;91;140;3;8;11
96;18.09.2015;2015;09;15;Perjantai;59;114;173;3;15;18
96;18.09.2015;2015;09;16;Perjantai;51;68;119;4;8;12
96;18.09.2015;2015;09;17;Perjantai;35;35;70;2;3;5
96;18.09.2015;2015;09;18;Perjantai;25;21;46;5;5;10
96;18.09.2015;2015;09;19;Perjantai;32;25;57;5;6;11
96;18.09.2015;2015;09;20;Perjantai;30;16;46;4;2;6
96;18.09.2015;2015;09;21;Perjantai;15;22;37;1;5;6
96;18.09.2015;2015;09;22;Perjantai;12;16;28;0;1;1
96;18.09.2015;2015;09;23;Perjantai;10;9;19;1;0;1
96;19.09.2015;2015;09;00;Lauantai;5;8;13;1;0;1
96;19.09.2015;2015;09;01;Lauantai;5;3;8;0;0;0
96;19.09.2015;2015;09;02;Lauantai;13;0;13;0;0;0
96;19.09.2015;2015;09;03;Lauantai;5;1;6;1;0;1
96;19.09.2015;2015;09;04;Lauantai;7;2;9;0;0;0
96;19.09.2015;2015;09;05;Lauantai;1;1;2;0;0;0
96;19.09.2015;2015;09;06;Lauantai;20;7;27;0;0;0
96;19.09.2015;2015;09;07;Lauantai;4;14;18;2;3;5
96;19.09.2015;2015;09;08;Lauantai;5;10;15;6;3;9
96;19.09.2015;2015;09;09;Lauantai;14;27;41;7;4;11
96;19.09.2015;2015;09;10;Lauantai;19;53;72;6;10;16
96;19.09.2015;2015;09;11;Lauantai;25;57;82;14;14;28
96;19.09.2015;2015;09;12;Lauantai;63;86;149;18;14;32
96;19.09.2015;2015;09;13;Lauantai;60;80;140;6;5;11
96;19.09.2015;2015;09;14;Lauantai;71;52;123;5;11;16
96;19.09.2015;2015;09;15;Lauantai;61;62;123;11;16;27
96;19.09.2015;2015;09;16;Lauantai;47;71;118;9;20;29
96;19.09.2015;2015;09;17;Lauantai;47;34;81;12;10;22
96;19.09.2015;2015;09;18;Lauantai;52;26;78;9;3;12
96;19.09.2015;2015;09;19;Lauantai;45;35;80;16;8;24
96;19.09.2015;2015;09;20;Lauantai;26;24;50;7;5;12
96;19.09.2015;2015;09;21;Lauantai;12;32;44;5;4;9
96;19.09.2015;2015;09;22;Lauantai;18;18;36;1;2;3
96;19.09.2015;2015;09;23;Lauantai;10;8;18;2;0;2
96;20.09.2015;2015;09;00;Sunnuntai;5;2;7;0;1;1
96;20.09.2015;2015;09;01;Sunnuntai;5;10;15;1;0;1
96;20.09.2015;2015;09;02;Sunnuntai;3;4;7;1;0;1
96;20.09.2015;2015;09;03;Sunnuntai;6;2;8;3;1;4
96;20.09.2015;2015;09;04;Sunnuntai;6;1;7;6;3;9
96;20.09.2015;2015;09;05;Sunnuntai;2;3;5;0;0;0
96;20.09.2015;2015;09;06;Sunnuntai;13;6;19;3;1;4
96;20.09.2015;2015;09;07;Sunnuntai;5;4;9;1;3;4
96;20.09.2015;2015;09;08;Sunnuntai;1;17;18;1;2;3
96;20.09.2015;2015;09;09;Sunnuntai;14;19;33;9;3;12
96;20.09.2015;2015;09;10;Sunnuntai;16;36;52;7;18;25
96;20.09.2015;2015;09;11;Sunnuntai;28;53;81;11;6;17
96;20.09.2015;2015;09;12;Sunnuntai;40;64;104;11;12;23
96;20.09.2015;2015;09;13;Sunnuntai;69;68;137;10;15;25
96;20.09.2015;2015;09;14;Sunnuntai;76;65;141;12;4;16
96;20.09.2015;2015;09;15;Sunnuntai;50;58;108;7;15;22
96;20.09.2015;2015;09;16;Sunnuntai;57;44;101;19;6;25
96;20.09.2015;2015;09;17;Sunnuntai;57;44;101;12;9;21
96;20.09.2015;2015;09;18;Sunnuntai;43;25;68;9;14;23
96;20.09.2015;2015;09;19;Sunnuntai;28;36;64;11;12;23
96;20.09.2015;2015;09;20;Sunnuntai;21;29;50;7;10;17
96;20.09.2015;2015;09;21;Sunnuntai;13;25;38;1;4;5
96;20.09.2015;2015;09;22;Sunnuntai;12;10;22;1;0;1
96;20.09.2015;2015;09;23;Sunnuntai;4;4;8;0;0;0
96;21.09.2015;2015;09;00;Maanantai;3;2;5;0;0;0
96;21.09.2015;2015;09;01;Maanantai;5;0;5;1;0;1
96;21.09.2015;2015;09;02;Maanantai;0;0;0;0;0;0
96;21.09.2015;2015;09;03;Maanantai;1;0;1;0;0;0
96;21.09.2015;2015;09;04;Maanantai;1;2;3;0;0;0
96;21.09.2015;2015;09;05;Maanantai;6;6;12;1;0;1
96;21.09.2015;2015;09;06;Maanantai;41;25;66;5;0;5
96;21.09.2015;2015;09;07;Maanantai;115;138;253;13;6;19
96;21.09.2015;2015;09;08;Maanantai;190;158;348;8;8;16
96;21.09.2015;2015;09;09;Maanantai;117;114;231;18;6;24
96;21.09.2015;2015;09;10;Maanantai;79;84;163;5;10;15
96;21.09.2015;2015;09;11;Maanantai;95;104;199;9;12;21
96;21.09.2015;2015;09;12;Maanantai;96;99;195;8;13;21
96;21.09.2015;2015;09;13;Maanantai;96;115;211;6;9;15
96;21.09.2015;2015;09;14;Maanantai;88;194;282;8;17;25
96;21.09.2015;2015;09;15;Maanantai;112;297;409;8;18;26
96;21.09.2015;2015;09;16;Maanantai;134;244;378;8;18;26
96;21.09.2015;2015;09;17;Maanantai;105;124;229;13;12;25
96;21.09.2015;2015;09;18;Maanantai;86;89;175;20;22;42
96;21.09.2015;2015;09;19;Maanantai;82;71;153;14;28;42
96;21.09.2015;2015;09;20;Maanantai;59;62;121;12;9;21
96;21.09.2015;2015;09;21;Maanantai;36;48;84;9;6;15
96;21.09.2015;2015;09;22;Maanantai;10;10;20;1;1;2
96;21.09.2015;2015;09;23;Maanantai;5;0;5;1;1;2
96;22.09.2015;2015;09;00;Tiistai;2;1;3;0;0;0
96;22.09.2015;2015;09;01;Tiistai;2;1;3;0;0;0
96;22.09.2015;2015;09;02;Tiistai;0;0;0;0;0;0
96;22.09.2015;2015;09;03;Tiistai;1;0;1;0;0;0
96;22.09.2015;2015;09;04;Tiistai;1;4;5;1;0;1
96;22.09.2015;2015;09;05;Tiistai;7;9;16;1;1;2
96;22.09.2015;2015;09;06;Tiistai;53;32;85;2;1;3
96;22.09.2015;2015;09;07;Tiistai;113;110;223;15;7;22
96;22.09.2015;2015;09;08;Tiistai;169;146;315;13;7;20
96;22.09.2015;2015;09;09;Tiistai;103;65;168;10;1;11
96;22.09.2015;2015;09;10;Tiistai;72;50;122;5;2;7
96;22.09.2015;2015;09;11;Tiistai;45;82;127;5;4;9
96;22.09.2015;2015;09;12;Tiistai;63;68;131;18;10;28
96;22.09.2015;2015;09;13;Tiistai;74;99;173;11;13;24
96;22.09.2015;2015;09;14;Tiistai;83;149;232;4;20;24
96;22.09.2015;2015;09;15;Tiistai;103;269;372;9;17;26
96;22.09.2015;2015;09;16;Tiistai;113;184;297;15;20;35
96;22.09.2015;2015;09;17;Tiistai;57;52;109;9;14;23
96;22.09.2015;2015;09;18;Tiistai;62;45;107;5;12;17
96;22.09.2015;2015;09;19;Tiistai;47;46;93;7;2;9
96;22.09.2015;2015;09;20;Tiistai;37;31;68;6;6;12
96;22.09.2015;2015;09;21;Tiistai;22;21;43;6;4;10
96;22.09.2015;2015;09;22;Tiistai;15;7;22;0;2;2
96;22.09.2015;2015;09;23;Tiistai;2;3;5;1;0;1
96;23.09.2015;2015;09;00;Keskiviikko;0;2;2;0;1;1
96;23.09.2015;2015;09;01;Keskiviikko;1;0;1;0;0;0
96;23.09.2015;2015;09;02;Keskiviikko;0;1;1;1;0;1
96;23.09.2015;2015;09;03;Keskiviikko;0;1;1;0;0;0
96;23.09.2015;2015;09;04;Keskiviikko;1;2;3;0;0;0
96;23.09.2015;2015;09;05;Keskiviikko;5;10;15;1;0;1
96;23.09.2015;2015;09;06;Keskiviikko;56;40;96;3;1;4
96;23.09.2015;2015;09;07;Keskiviikko;107;125;232;12;12;24
96;23.09.2015;2015;09;08;Keskiviikko;172;159;331;17;6;23
96;23.09.2015;2015;09;09;Keskiviikko;102;98;200;16;7;23
96;23.09.2015;2015;09;10;Keskiviikko;50;66;116;7;9;16
96;23.09.2015;2015;09;11;Keskiviikko;98;82;180;14;11;25
96;23.09.2015;2015;09;12;Keskiviikko;103;83;186;9;13;22
96;23.09.2015;2015;09;13;Keskiviikko;78;109;187;8;9;17
96;23.09.2015;2015;09;14;Keskiviikko;89;158;247;6;15;21
96;23.09.2015;2015;09;15;Keskiviikko;89;216;305;6;22;28
96;23.09.2015;2015;09;16;Keskiviikko;95;171;266;5;16;21
96;23.09.2015;2015;09;17;Keskiviikko;81;90;171;10;20;30
96;23.09.2015;2015;09;18;Keskiviikko;81;66;147;22;14;36
96;23.09.2015;2015;09;19;Keskiviikko;72;52;124;21;16;37
96;23.09.2015;2015;09;20;Keskiviikko;57;72;129;10;18;28
96;23.09.2015;2015;09;21;Keskiviikko;27;22;49;2;6;8
96;23.09.2015;2015;09;22;Keskiviikko;12;6;18;0;2;2
96;23.09.2015;2015;09;23;Keskiviikko;4;5;9;0;1;1
96;24.09.2015;2015;09;00;Torstai;3;3;6;0;0;0
96;24.09.2015;2015;09;01;Torstai;3;1;4;0;0;0
96;24.09.2015;2015;09;02;Torstai;2;2;4;1;0;1
96;24.09.2015;2015;09;03;Torstai;1;0;1;1;0;1
96;24.09.2015;2015;09;04;Torstai;5;4;9;0;0;0
96;24.09.2015;2015;09;05;Torstai;8;7;15;0;1;1
96;24.09.2015;2015;09;06;Torstai;63;35;98;3;1;4
96;24.09.2015;2015;09;07;Torstai;129;121;250;11;4;15
96;24.09.2015;2015;09;08;Torstai;163;154;317;11;4;15
96;24.09.2015;2015;09;09;Torstai;67;92;159;10;5;15
96;24.09.2015;2015;09;10;Torstai;63;74;137;10;13;23
96;24.09.2015;2015;09;11;Torstai;56;87;143;10;18;28
96;24.09.2015;2015;09;12;Torstai;118;80;198;15;11;26
96;24.09.2015;2015;09;13;Torstai;79;121;200;9;8;17
96;24.09.2015;2015;09;14;Torstai;86;166;252;9;20;29
96;24.09.2015;2015;09;15;Torstai;122;252;374;7;10;17
96;24.09.2015;2015;09;16;Torstai;116;176;292;10;15;25
96;24.09.2015;2015;09;17;Torstai;95;91;186;9;10;19
96;24.09.2015;2015;09;18;Torstai;87;76;163;19;17;36
96;24.09.2015;2015;09;19;Torstai;83;65;148;15;17;32
96;24.09.2015;2015;09;20;Torstai;50;51;101;12;9;21
96;24.09.2015;2015;09;21;Torstai;19;41;60;6;8;14
96;24.09.2015;2015;09;22;Torstai;15;19;34;2;4;6
96;24.09.2015;2015;09;23;Torstai;5;5;10;1;0;1
96;25.09.2015;2015;09;00;Perjantai;9;6;15;0;0;0
96;25.09.2015;2015;09;01;Perjantai;4;3;7;0;0;0
96;25.09.2015;2015;09;02;Perjantai;5;2;7;1;0;1
96;25.09.2015;2015;09;03;Perjantai;5;1;6;0;0;0
96;25.09.2015;2015;09;04;Perjantai;4;5;9;0;0;0
96;25.09.2015;2015;09;05;Perjantai;5;6;11;0;0;0
96;25.09.2015;2015;09;06;Perjantai;57;21;78;3;5;8
96;25.09.2015;2015;09;07;Perjantai;108;108;216;11;7;18
96;25.09.2015;2015;09;08;Perjantai;157;146;303;11;3;14
96;25.09.2015;2015;09;09;Perjantai;77;71;148;9;6;15
96;25.09.2015;2015;09;10;Perjantai;81;80;161;7;5;12
96;25.09.2015;2015;09;11;Perjantai;75;93;168;8;10;18
96;25.09.2015;2015;09;12;Perjantai;86;102;188;12;12;24
96;25.09.2015;2015;09;13;Perjantai;96;140;236;4;13;17
96;25.09.2015;2015;09;14;Perjantai;81;181;262;8;10;18
96;25.09.2015;2015;09;15;Perjantai;94;201;295;6;20;26
96;25.09.2015;2015;09;16;Perjantai;81;129;210;11;12;23
96;25.09.2015;2015;09;17;Perjantai;73;52;125;10;11;21
96;25.09.2015;2015;09;18;Perjantai;55;67;122;7;17;24
96;25.09.2015;2015;09;19;Perjantai;42;35;77;12;5;17
96;25.09.2015;2015;09;20;Perjantai;44;32;76;2;7;9
96;25.09.2015;2015;09;21;Perjantai;32;40;72;2;2;4
96;25.09.2015;2015;09;22;Perjantai;18;16;34;3;5;8
96;25.09.2015;2015;09;23;Perjantai;15;13;28;2;1;3
96;26.09.2015;2015;09;00;Lauantai;14;9;23;3;0;3
96;26.09.2015;2015;09;01;Lauantai;9;6;15;0;1;1
96;26.09.2015;2015;09;02;Lauantai;17;1;18;1;1;2
96;26.09.2015;2015;09;03;Lauantai;5;6;11;2;0;2
96;26.09.2015;2015;09;04;Lauantai;7;1;8;0;1;1
96;26.09.2015;2015;09;05;Lauantai;2;5;7;1;0;1
96;26.09.2015;2015;09;06;Lauantai;16;7;23;3;1;4
96;26.09.2015;2015;09;07;Lauantai;7;10;17;0;1;1
96;26.09.2015;2015;09;08;Lauantai;12;27;39;1;2;3
96;26.09.2015;2015;09;09;Lauantai;12;26;38;5;5;10
96;26.09.2015;2015;09;10;Lauantai;23;41;64;5;12;17
96;26.09.2015;2015;09;11;Lauantai;30;56;86;7;10;17
96;26.09.2015;2015;09;12;Lauantai;45;41;86;12;11;23
96;26.09.2015;2015;09;13;Lauantai;38;62;100;10;15;25
96;26.09.2015;2015;09;14;Lauantai;58;66;124;12;9;21
96;26.09.2015;2015;09;15;Lauantai;55;49;104;5;4;9
96;26.09.2015;2015;09;16;Lauantai;53;52;105;11;13;24
96;26.09.2015;2015;09;17;Lauantai;53;60;113;14;7;21
96;26.09.2015;2015;09;18;Lauantai;50;44;94;9;12;21
96;26.09.2015;2015;09;19;Lauantai;36;42;78;13;14;27
96;26.09.2015;2015;09;20;Lauantai;27;27;54;8;5;13
96;26.09.2015;2015;09;21;Lauantai;16;49;65;5;23;28
96;26.09.2015;2015;09;22;Lauantai;13;22;35;0;3;3
96;26.09.2015;2015;09;23;Lauantai;21;8;29;5;2;7
96;27.09.2015;2015;09;00;Sunnuntai;10;18;28;0;0;0
96;27.09.2015;2015;09;01;Sunnuntai;6;8;14;1;0;1
96;27.09.2015;2015;09;02;Sunnuntai;17;1;18;2;1;3
96;27.09.2015;2015;09;03;Sunnuntai;10;1;11;1;0;1
96;27.09.2015;2015;09;04;Sunnuntai;9;5;14;3;1;4
96;27.09.2015;2015;09;05;Sunnuntai;1;2;3;1;2;3
96;27.09.2015;2015;09;06;Sunnuntai;12;6;18;5;1;6
96;27.09.2015;2015;09;07;Sunnuntai;2;6;8;2;0;2
96;27.09.2015;2015;09;08;Sunnuntai;5;7;12;0;1;1
96;27.09.2015;2015;09;09;Sunnuntai;7;10;17;3;3;6
96;27.09.2015;2015;09;10;Sunnuntai;11;18;29;4;6;10
96;27.09.2015;2015;09;11;Sunnuntai;23;37;60;12;20;32
96;27.09.2015;2015;09;12;Sunnuntai;34;45;79;6;13;19
96;27.09.2015;2015;09;13;Sunnuntai;46;47;93;18;10;28
96;27.09.2015;2015;09;14;Sunnuntai;31;35;66;8;5;13
96;27.09.2015;2015;09;15;Sunnuntai;44;54;98;9;6;15
96;27.09.2015;2015;09;16;Sunnuntai;59;39;98;10;8;18
96;27.09.2015;2015;09;17;Sunnuntai;54;41;95;17;8;25
96;27.09.2015;2015;09;18;Sunnuntai;49;43;92;19;17;36
96;27.09.2015;2015;09;19;Sunnuntai;17;37;54;16;8;24
96;27.09.2015;2015;09;20;Sunnuntai;31;32;63;6;10;16
96;27.09.2015;2015;09;21;Sunnuntai;12;19;31;2;3;5
96;27.09.2015;2015;09;22;Sunnuntai;15;5;20;3;1;4
96;27.09.2015;2015;09;23;Sunnuntai;6;6;12;0;0;0
96;28.09.2015;2015;09;00;Maanantai;5;5;10;0;0;0
96;28.09.2015;2015;09;01;Maanantai;4;0;4;1;0;1
96;28.09.2015;2015;09;02;Maanantai;5;0;5;0;0;0
96;28.09.2015;2015;09;03;Maanantai;3;0;3;1;0;1
96;28.09.2015;2015;09;04;Maanantai;2;4;6;0;0;0
96;28.09.2015;2015;09;05;Maanantai;5;10;15;1;0;1
96;28.09.2015;2015;09;06;Maanantai;53;32;85;2;4;6
96;28.09.2015;2015;09;07;Maanantai;111;123;234;19;3;22
96;28.09.2015;2015;09;08;Maanantai;175;166;341;12;6;18
96;28.09.2015;2015;09;09;Maanantai;86;103;189;10;4;14
96;28.09.2015;2015;09;10;Maanantai;83;103;186;14;10;24
96;28.09.2015;2015;09;11;Maanantai;93;62;155;9;10;19
96;28.09.2015;2015;09;12;Maanantai;99;114;213;12;8;20
96;28.09.2015;2015;09;13;Maanantai;77;111;188;11;14;25
96;28.09.2015;2015;09;14;Maanantai;95;198;293;12;14;26
96;28.09.2015;2015;09;15;Maanantai;136;248;384;4;24;28
96;28.09.2015;2015;09;16;Maanantai;111;176;287;7;23;30
96;28.09.2015;2015;09;17;Maanantai;98;123;221;13;8;21
96;28.09.2015;2015;09;18;Maanantai;96;93;189;7;12;19
96;28.09.2015;2015;09;19;Maanantai;62;76;138;10;21;31
96;28.09.2015;2015;09;20;Maanantai;60;70;130;15;15;30
96;28.09.2015;2015;09;21;Maanantai;47;24;71;5;7;12
96;28.09.2015;2015;09;22;Maanantai;7;12;19;1;2;3
96;28.09.2015;2015;09;23;Maanantai;5;4;9;0;0;0
96;29.09.2015;2015;09;00;Tiistai;5;3;8;1;0;1
96;29.09.2015;2015;09;01;Tiistai;0;0;0;0;0;0
96;29.09.2015;2015;09;02;Tiistai;2;1;3;1;0;1
96;29.09.2015;2015;09;03;Tiistai;1;0;1;0;0;0
96;29.09.2015;2015;09;04;Tiistai;1;4;5;0;0;0
96;29.09.2015;2015;09;05;Tiistai;4;7;11;1;0;1
96;29.09.2015;2015;09;06;Tiistai;54;40;94;5;3;8
96;29.09.2015;2015;09;07;Tiistai;135;115;250;20;2;22
96;29.09.2015;2015;09;08;Tiistai;187;168;355;12;12;24
96;29.09.2015;2015;09;09;Tiistai;91;77;168;10;11;21
96;29.09.2015;2015;09;10;Tiistai;62;90;152;10;7;17
96;29.09.2015;2015;09;11;Tiistai;85;103;188;24;12;36
96;29.09.2015;2015;09;12;Tiistai;91;105;196;17;5;22
96;29.09.2015;2015;09;13;Tiistai;71;130;201;6;22;28
96;29.09.2015;2015;09;14;Tiistai;78;166;244;3;17;20
96;29.09.2015;2015;09;15;Tiistai;123;258;381;6;19;25
96;29.09.2015;2015;09;16;Tiistai;150;210;360;14;23;37
96;29.09.2015;2015;09;17;Tiistai;87;100;187;11;18;29
96;29.09.2015;2015;09;18;Tiistai;84;86;170;13;14;27
96;29.09.2015;2015;09;19;Tiistai;65;80;145;15;17;32
96;29.09.2015;2015;09;20;Tiistai;65;48;113;10;11;21
96;29.09.2015;2015;09;21;Tiistai;52;35;87;14;7;21
96;29.09.2015;2015;09;22;Tiistai;10;12;22;1;1;2
96;29.09.2015;2015;09;23;Tiistai;4;2;6;0;0;0
96;30.09.2015;2015;09;00;Keskiviikko;3;1;4;0;0;0
96;30.09.2015;2015;09;01;Keskiviikko;1;4;5;0;0;0
96;30.09.2015;2015;09;02;Keskiviikko;1;1;2;0;0;0
96;30.09.2015;2015;09;03;Keskiviikko;2;0;2;0;0;0
96;30.09.2015;2015;09;04;Keskiviikko;2;1;3;0;0;0
96;30.09.2015;2015;09;05;Keskiviikko;6;10;16;1;0;1
96;30.09.2015;2015;09;06;Keskiviikko;51;39;90;1;2;3
96;30.09.2015;2015;09;07;Keskiviikko;120;119;239;9;3;12
96;30.09.2015;2015;09;08;Keskiviikko;164;161;325;16;5;21
96;30.09.2015;2015;09;09;Keskiviikko;72;89;161;8;8;16
96;30.09.2015;2015;09;10;Keskiviikko;62;83;145;5;15;20
96;30.09.2015;2015;09;11;Keskiviikko;91;94;185;11;11;22
96;30.09.2015;2015;09;12;Keskiviikko;101;98;199;16;6;22
96;30.09.2015;2015;09;13;Keskiviikko;73;126;199;4;6;10
96;30.09.2015;2015;09;14;Keskiviikko;107;210;317;6;14;20
96;30.09.2015;2015;09;15;Keskiviikko;102;220;322;9;18;27
96;30.09.2015;2015;09;16;Keskiviikko;130;189;319;11;25;36
96;30.09.2015;2015;09;17;Keskiviikko;102;107;209;8;9;17
96;30.09.2015;2015;09;18;Keskiviikko;103;81;184;20;12;32
96;30.09.2015;2015;09;19;Keskiviikko;79;81;160;11;13;24
96;30.09.2015;2015;09;20;Keskiviikko;76;67;143;11;14;25
96;30.09.2015;2015;09;21;Keskiviikko;21;39;60;2;8;10
96;30.09.2015;2015;09;22;Keskiviikko;12;14;26;2;0;2
96;30.09.2015;2015;09;23;Keskiviikko;9;3;12;1;1;2
96;01.10.2015;2015;10;00;Torstai;11;3;14;0;1;1
96;01.10.2015;2015;10;01;Torstai;4;2;6;1;0;1
96;01.10.2015;2015;10;02;Torstai;0;1;1;2;0;2
96;01.10.2015;2015;10;03;Torstai;12;2;14;1;1;2
96;01.10.2015;2015;10;04;Torstai;4;4;8;1;0;1
96;01.10.2015;2015;10;05;Torstai;4;10;14;0;1;1
96;01.10.2015;2015;10;06;Torstai;39;35;74;4;2;6
96;01.10.2015;2015;10;07;Torstai;119;121;240;11;4;15
96;01.10.2015;2015;10;08;Torstai;181;152;333;20;7;27
96;01.10.2015;2015;10;09;Torstai;68;75;143;13;5;18
96;01.10.2015;2015;10;10;Torstai;100;132;232;11;10;21
96;01.10.2015;2015;10;11;Torstai;64;114;178;12;11;23
96;01.10.2015;2015;10;12;Torstai;131;94;225;18;6;24
96;01.10.2015;2015;10;13;Torstai;83;104;187;8;13;21
96;01.10.2015;2015;10;14;Torstai;99;167;266;5;23;28
96;01.10.2015;2015;10;15;Torstai;96;205;301;7;16;23
96;01.10.2015;2015;10;16;Torstai;121;170;291;2;12;14
96;01.10.2015;2015;10;17;Torstai;80;111;191;12;9;21
96;01.10.2015;2015;10;18;Torstai;77;66;143;20;7;27
96;01.10.2015;2015;10;19;Torstai;68;53;121;10;11;21
96;01.10.2015;2015;10;20;Torstai;61;53;114;14;10;24
96;01.10.2015;2015;10;21;Torstai;28;32;60;1;3;4
96;01.10.2015;2015;10;22;Torstai;7;8;15;1;2;3
96;01.10.2015;2015;10;23;Torstai;5;2;7;0;0;0
96;02.10.2015;2015;10;00;Perjantai;4;1;5;0;0;0
96;02.10.2015;2015;10;01;Perjantai;2;0;2;0;1;1
96;02.10.2015;2015;10;02;Perjantai;0;0;0;1;0;1
96;02.10.2015;2015;10;03;Perjantai;2;0;2;0;0;0
96;02.10.2015;2015;10;04;Perjantai;1;1;2;0;0;0
96;02.10.2015;2015;10;05;Perjantai;4;3;7;0;0;0
96;02.10.2015;2015;10;06;Perjantai;44;32;76;9;0;9
96;02.10.2015;2015;10;07;Perjantai;104;70;174;8;7;15
96;02.10.2015;2015;10;08;Perjantai;118;63;181;7;2;9
96;02.10.2015;2015;10;09;Perjantai;57;39;96;6;2;8
96;02.10.2015;2015;10;10;Perjantai;51;53;104;4;10;14
96;02.10.2015;2015;10;11;Perjantai;44;68;112;8;8;16
96;02.10.2015;2015;10;12;Perjantai;60;75;135;10;10;20
96;02.10.2015;2015;10;13;Perjantai;57;101;158;5;15;20
96;02.10.2015;2015;10;14;Perjantai;61;118;179;7;21;28
96;02.10.2015;2015;10;15;Perjantai;50;140;190;8;21;29
96;02.10.2015;2015;10;16;Perjantai;44;56;100;8;11;19
96;02.10.2015;2015;10;17;Perjantai;35;49;84;5;5;10
96;02.10.2015;2015;10;18;Perjantai;40;26;66;3;7;10
96;02.10.2015;2015;10;19;Perjantai;31;22;53;6;0;6
96;02.10.2015;2015;10;20;Perjantai;28;14;42;5;3;8
96;02.10.2015;2015;10;21;Perjantai;12;17;29;5;2;7
96;02.10.2015;2015;10;22;Perjantai;6;11;17;1;8;9
96;02.10.2015;2015;10;23;Perjantai;4;5;9;3;5;8
96;03.10.2015;2015;10;00;Lauantai;3;5;8;5;0;5
96;03.10.2015;2015;10;01;Lauantai;7;0;7;1;1;2
96;03.10.2015;2015;10;02;Lauantai;10;2;12;0;0;0
96;03.10.2015;2015;10;03;Lauantai;5;1;6;1;0;1
96;03.10.2015;2015;10;04;Lauantai;6;0;6;3;0;3
96;03.10.2015;2015;10;05;Lauantai;1;3;4;0;0;0
96;03.10.2015;2015;10;06;Lauantai;17;13;30;1;2;3
96;03.10.2015;2015;10;07;Lauantai;6;18;24;0;1;1
96;03.10.2015;2015;10;08;Lauantai;15;18;33;7;6;13
96;03.10.2015;2015;10;09;Lauantai;5;31;36;2;4;6
96;03.10.2015;2015;10;10;Lauantai;20;63;83;15;58;73
96;03.10.2015;2015;10;11;Lauantai;50;88;138;31;42;73
96;03.10.2015;2015;10;12;Lauantai;76;75;151;57;11;68
96;03.10.2015;2015;10;13;Lauantai;59;74;133;25;11;36
96;03.10.2015;2015;10;14;Lauantai;78;78;156;21;16;37
96;03.10.2015;2015;10;15;Lauantai;68;63;131;14;9;23
96;03.10.2015;2015;10;16;Lauantai;56;72;128;23;18;41
96;03.10.2015;2015;10;17;Lauantai;53;41;94;54;11;65
96;03.10.2015;2015;10;18;Lauantai;56;36;92;15;6;21
96;03.10.2015;2015;10;19;Lauantai;63;32;95;26;19;45
96;03.10.2015;2015;10;20;Lauantai;28;28;56;5;11;16
96;03.10.2015;2015;10;21;Lauantai;19;30;49;5;11;16
96;03.10.2015;2015;10;22;Lauantai;13;29;42;1;6;7
96;03.10.2015;2015;10;23;Lauantai;21;13;34;2;0;2
96;04.10.2015;2015;10;00;Sunnuntai;16;3;19;2;0;2
96;04.10.2015;2015;10;01;Sunnuntai;16;1;17;5;0;5
96;04.10.2015;2015;10;02;Sunnuntai;9;1;10;1;0;1
96;04.10.2015;2015;10;03;Sunnuntai;12;0;12;0;0;0
96;04.10.2015;2015;10;04;Sunnuntai;9;1;10;2;1;3
96;04.10.2015;2015;10;05;Sunnuntai;1;1;2;0;1;1
96;04.10.2015;2015;10;06;Sunnuntai;10;4;14;3;0;3
96;04.10.2015;2015;10;07;Sunnuntai;8;11;19;0;1;1
96;04.10.2015;2015;10;08;Sunnuntai;2;17;19;1;2;3
96;04.10.2015;2015;10;09;Sunnuntai;11;15;26;7;7;14
96;04.10.2015;2015;10;10;Sunnuntai;15;24;39;7;7;14
96;04.10.2015;2015;10;11;Sunnuntai;23;27;50;9;9;18
96;04.10.2015;2015;10;12;Sunnuntai;40;52;92;9;13;22
96;04.10.2015;2015;10;13;Sunnuntai;40;60;100;11;8;19
96;04.10.2015;2015;10;14;Sunnuntai;32;49;81;10;14;24
96;04.10.2015;2015;10;15;Sunnuntai;40;47;87;6;8;14
96;04.10.2015;2015;10;16;Sunnuntai;56;31;87;22;8;30
96;04.10.2015;2015;10;17;Sunnuntai;53;36;89;5;9;14
96;04.10.2015;2015;10;18;Sunnuntai;36;50;86;9;18;27
96;04.10.2015;2015;10;19;Sunnuntai;35;34;69;17;7;24
96;04.10.2015;2015;10;20;Sunnuntai;21;47;68;4;12;16
96;04.10.2015;2015;10;21;Sunnuntai;11;18;29;7;5;12
96;04.10.2015;2015;10;22;Sunnuntai;9;9;18;2;1;3
96;04.10.2015;2015;10;23;Sunnuntai;4;6;10;0;2;2
96;05.10.2015;2015;10;00;Maanantai;5;0;5;0;0;0
96;05.10.2015;2015;10;01;Maanantai;1;0;1;0;0;0
96;05.10.2015;2015;10;02;Maanantai;1;0;1;0;0;0
96;05.10.2015;2015;10;03;Maanantai;3;0;3;1;0;1
96;05.10.2015;2015;10;04;Maanantai;4;1;5;0;0;0
96;05.10.2015;2015;10;05;Maanantai;2;7;9;0;0;0
96;05.10.2015;2015;10;06;Maanantai;45;32;77;4;2;6
96;05.10.2015;2015;10;07;Maanantai;99;120;219;18;8;26
96;05.10.2015;2015;10;08;Maanantai;153;131;284;16;2;18
96;05.10.2015;2015;10;09;Maanantai;87;71;158;13;9;22
96;05.10.2015;2015;10;10;Maanantai;84;117;201;8;12;20
96;05.10.2015;2015;10;11;Maanantai;72;84;156;18;6;24
96;05.10.2015;2015;10;12;Maanantai;107;64;171;17;7;24
96;05.10.2015;2015;10;13;Maanantai;83;101;184;11;7;18
96;05.10.2015;2015;10;14;Maanantai;74;146;220;9;17;26
96;05.10.2015;2015;10;15;Maanantai;103;234;337;9;27;36
96;05.10.2015;2015;10;16;Maanantai;155;212;367;11;24;35
96;05.10.2015;2015;10;17;Maanantai;106;93;199;14;7;21
96;05.10.2015;2015;10;18;Maanantai;70;77;147;11;10;21
96;05.10.2015;2015;10;19;Maanantai;55;54;109;13;18;31
96;05.10.2015;2015;10;20;Maanantai;67;50;117;9;13;22
96;05.10.2015;2015;10;21;Maanantai;24;38;62;7;7;14
96;05.10.2015;2015;10;22;Maanantai;5;10;15;2;1;3
96;05.10.2015;2015;10;23;Maanantai;3;2;5;0;0;0
96;06.10.2015;2015;10;00;Tiistai;2;2;4;0;1;1
96;06.10.2015;2015;10;01;Tiistai;0;0;0;0;0;0
96;06.10.2015;2015;10;02;Tiistai;1;0;1;0;0;0
96;06.10.2015;2015;10;03;Tiistai;1;0;1;0;0;0
96;06.10.2015;2015;10;04;Tiistai;1;2;3;0;0;0
96;06.10.2015;2015;10;05;Tiistai;4;5;9;1;0;1
96;06.10.2015;2015;10;06;Tiistai;58;34;92;4;0;4
96;06.10.2015;2015;10;07;Tiistai;111;120;231;20;6;26
96;06.10.2015;2015;10;08;Tiistai;162;142;304;14;5;19
96;06.10.2015;2015;10;09;Tiistai;98;77;175;12;4;16
96;06.10.2015;2015;10;10;Tiistai;69;67;136;12;9;21
96;06.10.2015;2015;10;11;Tiistai;62;61;123;6;12;18
96;06.10.2015;2015;10;12;Tiistai;85;93;178;11;5;16
96;06.10.2015;2015;10;13;Tiistai;53;115;168;4;15;19
96;06.10.2015;2015;10;14;Tiistai;89;160;249;4;15;19
96;06.10.2015;2015;10;15;Tiistai;80;233;313;9;25;34
96;06.10.2015;2015;10;16;Tiistai;112;206;318;8;26;34
96;06.10.2015;2015;10;17;Tiistai;85;91;176;13;13;26
96;06.10.2015;2015;10;18;Tiistai;70;72;142;15;9;24
96;06.10.2015;2015;10;19;Tiistai;55;64;119;10;19;29
96;06.10.2015;2015;10;20;Tiistai;83;37;120;24;3;27
96;06.10.2015;2015;10;21;Tiistai;28;33;61;3;5;8
96;06.10.2015;2015;10;22;Tiistai;10;16;26;0;3;3
96;06.10.2015;2015;10;23;Tiistai;4;3;7;0;1;1
96;07.10.2015;2015;10;00;Keskiviikko;5;5;10;0;0;0
96;07.10.2015;2015;10;01;Keskiviikko;2;1;3;1;0;1
96;07.10.2015;2015;10;02;Keskiviikko;1;0;1;0;0;0
96;07.10.2015;2015;10;03;Keskiviikko;0;0;0;0;0;0
96;07.10.2015;2015;10;04;Keskiviikko;3;3;6;0;0;0
96;07.10.2015;2015;10;05;Keskiviikko;4;3;7;1;1;2
96;07.10.2015;2015;10;06;Keskiviikko;52;38;90;6;2;8
96;07.10.2015;2015;10;07;Keskiviikko;110;127;237;19;8;27
96;07.10.2015;2015;10;08;Keskiviikko;165;139;304;16;13;29
96;07.10.2015;2015;10;09;Keskiviikko;112;87;199;7;14;21
96;07.10.2015;2015;10;10;Keskiviikko;57;63;120;8;8;16
96;07.10.2015;2015;10;11;Keskiviikko;101;89;190;8;14;22
96;07.10.2015;2015;10;12;Keskiviikko;85;152;237;8;20;28
96;07.10.2015;2015;10;13;Keskiviikko;101;120;221;11;10;21
96;07.10.2015;2015;10;14;Keskiviikko;122;192;314;6;18;24
96;07.10.2015;2015;10;15;Keskiviikko;102;199;301;7;29;36
96;07.10.2015;2015;10;16;Keskiviikko;141;184;325;14;27;41
96;07.10.2015;2015;10;17;Keskiviikko;101;95;196;13;11;24
96;07.10.2015;2015;10;18;Keskiviikko;87;60;147;15;16;31
96;07.10.2015;2015;10;19;Keskiviikko;50;55;105;20;8;28
96;07.10.2015;2015;10;20;Keskiviikko;38;56;94;13;12;25
96;07.10.2015;2015;10;21;Keskiviikko;35;41;76;2;5;7
96;07.10.2015;2015;10;22;Keskiviikko;12;11;23;1;4;5
96;07.10.2015;2015;10;23;Keskiviikko;11;3;14;0;1;1
96;08.10.2015;2015;10;00;Torstai;5;1;6;1;1;2
96;08.10.2015;2015;10;01;Torstai;2;0;2;0;0;0
96;08.10.2015;2015;10;02;Torstai;0;0;0;0;0;0
96;08.10.2015;2015;10;03;Torstai;0;0;0;0;0;0
96;08.10.2015;2015;10;04;Torstai;2;0;2;0;0;0
96;08.10.2015;2015;10;05;Torstai;6;7;13;1;0;1
96;08.10.2015;2015;10;06;Torstai;56;35;91;5;1;6
96;08.10.2015;2015;10;07;Torstai;121;120;241;14;7;21
96;08.10.2015;2015;10;08;Torstai;141;129;270;10;7;17
96;08.10.2015;2015;10;09;Torstai;102;97;199;4;9;13
96;08.10.2015;2015;10;10;Torstai;88;68;156;14;17;31
96;08.10.2015;2015;10;11;Torstai;62;100;162;13;11;24
96;08.10.2015;2015;10;12;Torstai;76;100;176;17;11;28
96;08.10.2015;2015;10;13;Torstai;81;120;201;22;18;40
96;08.10.2015;2015;10;14;Torstai;97;190;287;12;29;41
96;08.10.2015;2015;10;15;Torstai;103;212;315;8;25;33
96;08.10.2015;2015;10;16;Torstai;115;190;305;11;16;27
96;08.10.2015;2015;10;17;Torstai;95;75;170;9;5;14
96;08.10.2015;2015;10;18;Torstai;72;64;136;20;8;28
96;08.10.2015;2015;10;19;Torstai;62;55;117;14;18;32
96;08.10.2015;2015;10;20;Torstai;69;35;104;7;12;19
96;08.10.2015;2015;10;21;Torstai;29;46;75;1;9;10
96;08.10.2015;2015;10;22;Torstai;16;7;23;1;0;1
96;08.10.2015;2015;10;23;Torstai;6;6;12;1;1;2
96;09.10.2015;2015;10;00;Perjantai;6;1;7;0;0;0
96;09.10.2015;2015;10;01;Perjantai;4;5;9;0;0;0
96;09.10.2015;2015;10;02;Perjantai;4;3;7;1;0;1
96;09.10.2015;2015;10;03;Perjantai;1;3;4;1;0;1
96;09.10.2015;2015;10;04;Perjantai;2;2;4;0;0;0
96;09.10.2015;2015;10;05;Perjantai;2;4;6;2;0;2
96;09.10.2015;2015;10;06;Perjantai;41;27;68;5;1;6
96;09.10.2015;2015;10;07;Perjantai;90;95;185;15;7;22
96;09.10.2015;2015;10;08;Perjantai;141;130;271;13;4;17
96;09.10.2015;2015;10;09;Perjantai;77;70;147;11;6;17
96;09.10.2015;2015;10;10;Perjantai;43;82;125;4;10;14
96;09.10.2015;2015;10;11;Perjantai;46;82;128;9;19;28
96;09.10.2015;2015;10;12;Perjantai;75;93;168;10;9;19
96;09.10.2015;2015;10;13;Perjantai;87;150;237;9;14;23
96;09.10.2015;2015;10;14;Perjantai;90;153;243;3;21;24
96;09.10.2015;2015;10;15;Perjantai;77;160;237;3;19;22
96;09.10.2015;2015;10;16;Perjantai;84;95;179;9;11;20
96;09.10.2015;2015;10;17;Perjantai;56;64;120;6;12;18
96;09.10.2015;2015;10;18;Perjantai;40;47;87;9;18;27
96;09.10.2015;2015;10;19;Perjantai;46;38;84;9;6;15
96;09.10.2015;2015;10;20;Perjantai;36;27;63;5;5;10
96;09.10.2015;2015;10;21;Perjantai;27;29;56;2;3;5
96;09.10.2015;2015;10;22;Perjantai;18;19;37;2;3;5
96;09.10.2015;2015;10;23;Perjantai;10;5;15;0;2;2
96;10.10.2015;2015;10;00;Lauantai;6;4;10;1;1;2
96;10.10.2015;2015;10;01;Lauantai;4;1;5;0;0;0
96;10.10.2015;2015;10;02;Lauantai;8;0;8;0;0;0
96;10.10.2015;2015;10;03;Lauantai;7;1;8;0;0;0
96;10.10.2015;2015;10;04;Lauantai;4;1;5;2;0;2
96;10.10.2015;2015;10;05;Lauantai;1;5;6;1;0;1
96;10.10.2015;2015;10;06;Lauantai;20;8;28;3;0;3
96;10.10.2015;2015;10;07;Lauantai;7;14;21;1;4;5
96;10.10.2015;2015;10;08;Lauantai;2;28;30;0;2;2
96;10.10.2015;2015;10;09;Lauantai;17;52;69;4;5;9
96;10.10.2015;2015;10;10;Lauantai;30;44;74;4;14;18
96;10.10.2015;2015;10;11;Lauantai;32;73;105;8;40;48
96;10.10.2015;2015;10;12;Lauantai;62;54;116;19;19;38
96;10.10.2015;2015;10;13;Lauantai;68;53;121;38;19;57
96;10.10.2015;2015;10;14;Lauantai;65;61;126;26;12;38
96;10.10.2015;2015;10;15;Lauantai;66;66;132;18;11;29
96;10.10.2015;2015;10;16;Lauantai;33;54;87;9;16;25
96;10.10.2015;2015;10;17;Lauantai;39;46;85;13;3;16
96;10.10.2015;2015;10;18;Lauantai;48;28;76;21;6;27
96;10.10.2015;2015;10;19;Lauantai;63;22;85;19;8;27
96;10.10.2015;2015;10;20;Lauantai;35;33;68;5;10;15
96;10.10.2015;2015;10;21;Lauantai;22;31;53;3;8;11
96;10.10.2015;2015;10;22;Lauantai;13;6;19;1;0;1
96;10.10.2015;2015;10;23;Lauantai;7;5;12;1;1;2
96;11.10.2015;2015;10;00;Sunnuntai;7;1;8;3;0;3
96;11.10.2015;2015;10;01;Sunnuntai;10;2;12;0;1;1
96;11.10.2015;2015;10;02;Sunnuntai;12;0;12;0;0;0
96;11.10.2015;2015;10;03;Sunnuntai;4;1;5;1;0;1
96;11.10.2015;2015;10;04;Sunnuntai;2;0;2;1;2;3
96;11.10.2015;2015;10;05;Sunnuntai;3;1;4;1;1;2
96;11.10.2015;2015;10;06;Sunnuntai;17;4;21;1;0;1
96;11.10.2015;2015;10;07;Sunnuntai;2;7;9;1;2;3
96;11.10.2015;2015;10;08;Sunnuntai;5;7;12;3;3;6
96;11.10.2015;2015;10;09;Sunnuntai;9;12;21;8;8;16
96;11.10.2015;2015;10;10;Sunnuntai;13;34;47;4;14;18
96;11.10.2015;2015;10;11;Sunnuntai;19;45;64;19;69;88
96;11.10.2015;2015;10;12;Sunnuntai;39;66;105;16;27;43
96;11.10.2015;2015;10;13;Sunnuntai;53;66;119;44;16;60
96;11.10.2015;2015;10;14;Sunnuntai;55;59;114;37;9;46
96;11.10.2015;2015;10;15;Sunnuntai;51;65;116;25;7;32
96;11.10.2015;2015;10;16;Sunnuntai;70;36;106;26;8;34
96;11.10.2015;2015;10;17;Sunnuntai;59;41;100;13;11;24
96;11.10.2015;2015;10;18;Sunnuntai;42;51;93;12;24;36
96;11.10.2015;2015;10;19;Sunnuntai;34;26;60;11;14;25
96;11.10.2015;2015;10;20;Sunnuntai;27;46;73;7;13;20
96;11.10.2015;2015;10;21;Sunnuntai;13;23;36;3;4;7
96;11.10.2015;2015;10;22;Sunnuntai;7;7;14;1;1;2
96;11.10.2015;2015;10;23;Sunnuntai;2;3;5;2;0;2
96;12.10.2015;2015;10;00;Maanantai;6;1;7;1;1;2
96;12.10.2015;2015;10;01;Maanantai;0;1;1;0;1;1
96;12.10.2015;2015;10;02;Maanantai;1;0;1;0;0;0
96;12.10.2015;2015;10;03;Maanantai;1;0;1;0;0;0
96;12.10.2015;2015;10;04;Maanantai;2;2;4;0;0;0
96;12.10.2015;2015;10;05;Maanantai;5;5;10;3;1;4
96;12.10.2015;2015;10;06;Maanantai;50;31;81;5;2;7
96;12.10.2015;2015;10;07;Maanantai;105;102;207;22;8;30
96;12.10.2015;2015;10;08;Maanantai;176;136;312;14;7;21
96;12.10.2015;2015;10;09;Maanantai;80;78;158;20;21;41
96;12.10.2015;2015;10;10;Maanantai;83;61;144;15;8;23
96;12.10.2015;2015;10;11;Maanantai;52;80;132;12;15;27
96;12.10.2015;2015;10;12;Maanantai;79;76;155;6;10;16
96;12.10.2015;2015;10;13;Maanantai;59;107;166;9;7;16
96;12.10.2015;2015;10;14;Maanantai;73;126;199;6;22;28
96;12.10.2015;2015;10;15;Maanantai;95;243;338;5;24;29
96;12.10.2015;2015;10;16;Maanantai;139;214;353;10;30;40
96;12.10.2015;2015;10;17;Maanantai;94;82;176;11;14;25
96;12.10.2015;2015;10;18;Maanantai;65;87;152;17;11;28
96;12.10.2015;2015;10;19;Maanantai;56;63;119;18;26;44
96;12.10.2015;2015;10;20;Maanantai;63;60;123;6;9;15
96;12.10.2015;2015;10;21;Maanantai;26;35;61;5;9;14
96;12.10.2015;2015;10;22;Maanantai;8;5;13;3;1;4
96;12.10.2015;2015;10;23;Maanantai;9;4;13;0;0;0
96;13.10.2015;2015;10;00;Tiistai;1;0;1;2;0;2
96;13.10.2015;2015;10;01;Tiistai;1;0;1;0;0;0
96;13.10.2015;2015;10;02;Tiistai;3;0;3;0;0;0
96;13.10.2015;2015;10;03;Tiistai;0;0;0;0;0;0
96;13.10.2015;2015;10;04;Tiistai;4;2;6;0;0;0
96;13.10.2015;2015;10;05;Tiistai;6;6;12;1;0;1
96;13.10.2015;2015;10;06;Tiistai;58;32;90;3;2;5
96;13.10.2015;2015;10;07;Tiistai;122;123;245;13;4;17
96;13.10.2015;2015;10;08;Tiistai;155;130;285;13;7;20
96;13.10.2015;2015;10;09;Tiistai;87;87;174;13;11;24
96;13.10.2015;2015;10;10;Tiistai;75;75;150;11;8;19
96;13.10.2015;2015;10;11;Tiistai;93;78;171;12;10;22
96;13.10.2015;2015;10;12;Tiistai;86;99;185;11;12;23
96;13.10.2015;2015;10;13;Tiistai;75;84;159;9;9;18
96;13.10.2015;2015;10;14;Tiistai;68;144;212;3;14;17
96;13.10.2015;2015;10;15;Tiistai;87;246;333;7;28;35
96;13.10.2015;2015;10;16;Tiistai;117;217;334;9;22;31
96;13.10.2015;2015;10;17;Tiistai;108;91;199;12;10;22
96;13.10.2015;2015;10;18;Tiistai;65;71;136;25;13;38
96;13.10.2015;2015;10;19;Tiistai;71;48;119;13;21;34
96;13.10.2015;2015;10;20;Tiistai;59;53;112;12;4;16
96;13.10.2015;2015;10;21;Tiistai;36;41;77;5;8;13
96;13.10.2015;2015;10;22;Tiistai;15;16;31;0;1;1
96;13.10.2015;2015;10;23;Tiistai;5;8;13;2;0;2
96;14.10.2015;2015;10;00;Keskiviikko;4;2;6;0;0;0
96;14.10.2015;2015;10;01;Keskiviikko;8;0;8;1;0;1
96;14.10.2015;2015;10;02;Keskiviikko;1;1;2;1;0;1
96;14.10.2015;2015;10;03;Keskiviikko;1;0;1;0;0;0
96;14.10.2015;2015;10;04;Keskiviikko;3;1;4;0;0;0
96;14.10.2015;2015;10;05;Keskiviikko;7;7;14;1;0;1
96;14.10.2015;2015;10;06;Keskiviikko;50;45;95;5;1;6
96;14.10.2015;2015;10;07;Keskiviikko;119;121;240;19;7;26
96;14.10.2015;2015;10;08;Keskiviikko;138;129;267;21;8;29
96;14.10.2015;2015;10;09;Keskiviikko;119;78;197;14;10;24
96;14.10.2015;2015;10;10;Keskiviikko;75;51;126;15;8;23
96;14.10.2015;2015;10;11;Keskiviikko;100;81;181;12;17;29
96;14.10.2015;2015;10;12;Keskiviikko;78;106;184;11;10;21
96;14.10.2015;2015;10;13;Keskiviikko;74;105;179;8;21;29
96;14.10.2015;2015;10;14;Keskiviikko;74;169;243;10;10;20
96;14.10.2015;2015;10;15;Keskiviikko;81;218;299;13;28;41
96;14.10.2015;2015;10;16;Keskiviikko;140;214;354;12;28;40
96;14.10.2015;2015;10;17;Keskiviikko;81;96;177;10;13;23
96;14.10.2015;2015;10;18;Keskiviikko;77;69;146;15;12;27
96;14.10.2015;2015;10;19;Keskiviikko;59;69;128;9;18;27
96;14.10.2015;2015;10;20;Keskiviikko;47;39;86;11;10;21
96;14.10.2015;2015;10;21;Keskiviikko;27;35;62;3;1;4
96;14.10.2015;2015;10;22;Keskiviikko;7;5;12;1;2;3
96;14.10.2015;2015;10;23;Keskiviikko;5;2;7;0;0;0
96;15.10.2015;2015;10;00;Torstai;7;2;9;3;0;3
96;15.10.2015;2015;10;01;Torstai;3;1;4;0;1;1
96;15.10.2015;2015;10;02;Torstai;1;0;1;0;0;0
96;15.10.2015;2015;10;03;Torstai;2;1;3;0;0;0
96;15.10.2015;2015;10;04;Torstai;2;2;4;0;0;0
96;15.10.2015;2015;10;05;Torstai;6;8;14;1;1;2
96;15.10.2015;2015;10;06;Torstai;38;24;62;8;0;8
96;15.10.2015;2015;10;07;Torstai;109;107;216;14;3;17
96;15.10.2015;2015;10;08;Torstai;134;139;273;14;6;20
96;15.10.2015;2015;10;09;Torstai;88;83;171;11;3;14
96;15.10.2015;2015;10;10;Torstai;61;59;120;14;13;27
96;15.10.2015;2015;10;11;Torstai;66;67;133;14;8;22
96;15.10.2015;2015;10;12;Torstai;94;111;205;10;13;23
96;15.10.2015;2015;10;13;Torstai;73;119;192;5;19;24
96;15.10.2015;2015;10;14;Torstai;91;161;252;4;28;32
96;15.10.2015;2015;10;15;Torstai;94;177;271;12;35;47
96;15.10.2015;2015;10;16;Torstai;103;196;299;7;32;39
96;15.10.2015;2015;10;17;Torstai;72;98;170;12;8;20
96;15.10.2015;2015;10;18;Torstai;81;59;140;12;14;26
96;15.10.2015;2015;10;19;Torstai;64;65;129;11;15;26
96;15.10.2015;2015;10;20;Torstai;48;47;95;10;18;28
96;15.10.2015;2015;10;21;Torstai;26;37;63;5;5;10
96;15.10.2015;2015;10;22;Torstai;12;19;31;1;2;3
96;15.10.2015;2015;10;23;Torstai;15;5;20;1;0;1
96;16.10.2015;2015;10;00;Perjantai;7;2;9;0;0;0
96;16.10.2015;2015;10;01;Perjantai;5;1;6;0;0;0
96;16.10.2015;2015;10;02;Perjantai;7;2;9;1;0;1
96;16.10.2015;2015;10;03;Perjantai;7;2;9;1;0;1
96;16.10.2015;2015;10;04;Perjantai;5;1;6;0;1;1
96;16.10.2015;2015;10;05;Perjantai;5;5;10;1;1;2
96;16.10.2015;2015;10;06;Perjantai;49;34;83;2;2;4
96;16.10.2015;2015;10;07;Perjantai;104;86;190;16;3;19
96;16.10.2015;2015;10;08;Perjantai;96;112;208;10;5;15
96;16.10.2015;2015;10;09;Perjantai;60;74;134;10;0;10
96;16.10.2015;2015;10;10;Perjantai;74;70;144;10;5;15
96;16.10.2015;2015;10;11;Perjantai;54;82;136;8;10;18
96;16.10.2015;2015;10;12;Perjantai;80;91;171;8;18;26
96;16.10.2015;2015;10;13;Perjantai;78;114;192;8;9;17
96;16.10.2015;2015;10;14;Perjantai;80;158;238;10;16;26
96;16.10.2015;2015;10;15;Perjantai;84;169;253;5;24;29
96;16.10.2015;2015;10;16;Perjantai;81;109;190;18;13;31
96;16.10.2015;2015;10;17;Perjantai;57;73;130;9;15;24
96;16.10.2015;2015;10;18;Perjantai;58;71;129;4;17;21
96;16.10.2015;2015;10;19;Perjantai;26;32;58;6;8;14
96;16.10.2015;2015;10;20;Perjantai;28;22;50;8;4;12
96;16.10.2015;2015;10;21;Perjantai;39;25;64;16;11;27
96;16.10.2015;2015;10;22;Perjantai;12;15;27;0;5;5
96;16.10.2015;2015;10;23;Perjantai;15;8;23;0;3;3
96;17.10.2015;2015;10;00;Lauantai;7;4;11;1;0;1
96;17.10.2015;2015;10;01;Lauantai;8;4;12;0;1;1
96;17.10.2015;2015;10;02;Lauantai;3;0;3;1;0;1
96;17.10.2015;2015;10;03;Lauantai;7;0;7;1;0;1
96;17.10.2015;2015;10;04;Lauantai;2;0;2;1;0;1
96;17.10.2015;2015;10;05;Lauantai;3;3;6;0;2;2
96;17.10.2015;2015;10;06;Lauantai;20;12;32;4;0;4
96;17.10.2015;2015;10;07;Lauantai;6;14;20;1;3;4
96;17.10.2015;2015;10;08;Lauantai;6;21;27;3;3;6
96;17.10.2015;2015;10;09;Lauantai;11;45;56;3;3;6
96;17.10.2015;2015;10;10;Lauantai;26;38;64;5;10;15
96;17.10.2015;2015;10;11;Lauantai;29;47;76;11;4;15
96;17.10.2015;2015;10;12;Lauantai;45;55;100;7;10;17
96;17.10.2015;2015;10;13;Lauantai;37;54;91;2;5;7
96;17.10.2015;2015;10;14;Lauantai;44;59;103;3;11;14
96;17.10.2015;2015;10;15;Lauantai;39;57;96;15;9;24
96;17.10.2015;2015;10;16;Lauantai;51;37;88;11;3;14
96;17.10.2015;2015;10;17;Lauantai;29;39;68;10;6;16
96;17.10.2015;2015;10;18;Lauantai;46;32;78;11;4;15
96;17.10.2015;2015;10;19;Lauantai;20;18;38;4;7;11
96;17.10.2015;2015;10;20;Lauantai;21;36;57;4;9;13
96;17.10.2015;2015;10;21;Lauantai;16;24;40;1;5;6
96;17.10.2015;2015;10;22;Lauantai;7;13;20;1;1;2
96;17.10.2015;2015;10;23;Lauantai;6;10;16;6;3;9
96;18.10.2015;2015;10;00;Sunnuntai;8;7;15;5;3;8
96;18.10.2015;2015;10;01;Sunnuntai;14;5;19;0;0;0
96;18.10.2015;2015;10;02;Sunnuntai;7;1;8;1;1;2
96;18.10.2015;2015;10;03;Sunnuntai;11;1;12;0;0;0
96;18.10.2015;2015;10;04;Sunnuntai;9;0;9;4;1;5
96;18.10.2015;2015;10;05;Sunnuntai;7;1;8;2;1;3
96;18.10.2015;2015;10;06;Sunnuntai;18;4;22;2;1;3
96;18.10.2015;2015;10;07;Sunnuntai;3;11;14;0;3;3
96;18.10.2015;2015;10;08;Sunnuntai;4;6;10;1;3;4
96;18.10.2015;2015;10;09;Sunnuntai;8;11;19;3;1;4
96;18.10.2015;2015;10;10;Sunnuntai;13;8;21;7;8;15
96;18.10.2015;2015;10;11;Sunnuntai;20;32;52;4;6;10
96;18.10.2015;2015;10;12;Sunnuntai;28;33;61;3;5;8
96;18.10.2015;2015;10;13;Sunnuntai;29;41;70;4;10;14
96;18.10.2015;2015;10;14;Sunnuntai;36;38;74;9;5;14
96;18.10.2015;2015;10;15;Sunnuntai;34;56;90;7;7;14
96;18.10.2015;2015;10;16;Sunnuntai;49;39;88;14;14;28
96;18.10.2015;2015;10;17;Sunnuntai;32;31;63;12;19;31
96;18.10.2015;2015;10;18;Sunnuntai;40;34;74;18;21;39
96;18.10.2015;2015;10;19;Sunnuntai;18;24;42;9;13;22
96;18.10.2015;2015;10;20;Sunnuntai;16;18;34;3;12;15
96;18.10.2015;2015;10;21;Sunnuntai;16;15;31;7;3;10
96;18.10.2015;2015;10;22;Sunnuntai;11;5;16;2;1;3
96;18.10.2015;2015;10;23;Sunnuntai;6;3;9;2;0;2
96;19.10.2015;2015;10;00;Maanantai;5;1;6;2;0;2
96;19.10.2015;2015;10;01;Maanantai;10;2;12;0;0;0
96;19.10.2015;2015;10;02;Maanantai;1;3;4;0;0;0
96;19.10.2015;2015;10;03;Maanantai;1;0;1;0;0;0
96;19.10.2015;2015;10;04;Maanantai;4;2;6;0;1;1
96;19.10.2015;2015;10;05;Maanantai;6;3;9;0;1;1
96;19.10.2015;2015;10;06;Maanantai;45;24;69;2;3;5
96;19.10.2015;2015;10;07;Maanantai;63;81;144;19;4;23
96;19.10.2015;2015;10;08;Maanantai;52;69;121;9;6;15
96;19.10.2015;2015;10;09;Maanantai;40;47;87;7;15;22
96;19.10.2015;2015;10;10;Maanantai;29;54;83;4;9;13
96;19.10.2015;2015;10;11;Maanantai;39;70;109;7;11;18
96;19.10.2015;2015;10;12;Maanantai;59;78;137;10;11;21
96;19.10.2015;2015;10;13;Maanantai;52;78;130;11;12;23
96;19.10.2015;2015;10;14;Maanantai;66;85;151;6;12;18
96;19.10.2015;2015;10;15;Maanantai;66;151;217;8;24;32
96;19.10.2015;2015;10;16;Maanantai;105;108;213;10;17;27
96;19.10.2015;2015;10;17;Maanantai;76;66;142;7;11;18
96;19.10.2015;2015;10;18;Maanantai;75;47;122;12;17;29
96;19.10.2015;2015;10;19;Maanantai;44;35;79;22;27;49
96;19.10.2015;2015;10;20;Maanantai;33;19;52;8;13;21
96;19.10.2015;2015;10;21;Maanantai;19;25;44;5;8;13
96;19.10.2015;2015;10;22;Maanantai;7;6;13;2;2;4
96;19.10.2015;2015;10;23;Maanantai;8;7;15;2;0;2
96;20.10.2015;2015;10;00;Tiistai;1;1;2;0;0;0
96;20.10.2015;2015;10;01;Tiistai;1;1;2;0;0;0
96;20.10.2015;2015;10;02;Tiistai;1;0;1;0;0;0
96;20.10.2015;2015;10;03;Tiistai;1;1;2;0;0;0
96;20.10.2015;2015;10;04;Tiistai;2;1;3;0;1;1
96;20.10.2015;2015;10;05;Tiistai;5;3;8;0;0;0
96;20.10.2015;2015;10;06;Tiistai;39;34;73;2;0;2
96;20.10.2015;2015;10;07;Tiistai;72;72;144;16;5;21
96;20.10.2015;2015;10;08;Tiistai;49;67;116;4;5;9
96;20.10.2015;2015;10;09;Tiistai;27;49;76;6;5;11
96;20.10.2015;2015;10;10;Tiistai;45;50;95;6;5;11
96;20.10.2015;2015;10;11;Tiistai;40;59;99;9;11;20
96;20.10.2015;2015;10;12;Tiistai;51;60;111;6;5;11
96;20.10.2015;2015;10;13;Tiistai;39;60;99;8;13;21
96;20.10.2015;2015;10;14;Tiistai;48;61;109;1;2;3
96;20.10.2015;2015;10;15;Tiistai;65;123;188;6;21;27
96;20.10.2015;2015;10;16;Tiistai;69;81;150;7;9;16
96;20.10.2015;2015;10;17;Tiistai;50;29;79;5;11;16
96;20.10.2015;2015;10;18;Tiistai;56;23;79;8;7;15
96;20.10.2015;2015;10;19;Tiistai;16;23;39;6;9;15
96;20.10.2015;2015;10;20;Tiistai;21;25;46;11;4;15
96;20.10.2015;2015;10;21;Tiistai;24;26;50;2;6;8
96;20.10.2015;2015;10;22;Tiistai;7;7;14;0;2;2
96;20.10.2015;2015;10;23;Tiistai;9;0;9;0;0;0
96;21.10.2015;2015;10;00;Keskiviikko;2;1;3;0;1;1
96;21.10.2015;2015;10;01;Keskiviikko;3;2;5;0;0;0
96;21.10.2015;2015;10;02;Keskiviikko;1;2;3;0;1;1
96;21.10.2015;2015;10;03;Keskiviikko;1;0;1;0;0;0
96;21.10.2015;2015;10;04;Keskiviikko;1;1;2;0;0;0
96;21.10.2015;2015;10;05;Keskiviikko;3;4;7;1;1;2
96;21.10.2015;2015;10;06;Keskiviikko;47;27;74;6;0;6
96;21.10.2015;2015;10;07;Keskiviikko;57;60;117;10;6;16
96;21.10.2015;2015;10;08;Keskiviikko;42;61;103;5;10;15
96;21.10.2015;2015;10;09;Keskiviikko;26;33;59;4;6;10
96;21.10.2015;2015;10;10;Keskiviikko;22;33;55;4;4;8
96;21.10.2015;2015;10;11;Keskiviikko;48;43;91;6;8;14
96;21.10.2015;2015;10;12;Keskiviikko;57;50;107;6;7;13
96;21.10.2015;2015;10;13;Keskiviikko;51;66;117;9;10;19
96;21.10.2015;2015;10;14;Keskiviikko;42;67;109;5;6;11
96;21.10.2015;2015;10;15;Keskiviikko;54;105;159;3;24;27
96;21.10.2015;2015;10;16;Keskiviikko;54;74;128;4;11;15
96;21.10.2015;2015;10;17;Keskiviikko;44;33;77;10;7;17
96;21.10.2015;2015;10;18;Keskiviikko;34;20;54;8;16;24
96;21.10.2015;2015;10;19;Keskiviikko;30;23;53;9;17;26
96;21.10.2015;2015;10;20;Keskiviikko;29;27;56;5;8;13
96;21.10.2015;2015;10;21;Keskiviikko;29;22;51;3;1;4
96;21.10.2015;2015;10;22;Keskiviikko;5;12;17;0;4;4
96;21.10.2015;2015;10;23;Keskiviikko;5;5;10;2;2;4
96;22.10.2015;2015;10;00;Torstai;4;2;6;1;0;1
96;22.10.2015;2015;10;01;Torstai;3;0;3;0;0;0
96;22.10.2015;2015;10;02;Torstai;4;1;5;1;0;1
96;22.10.2015;2015;10;03;Torstai;1;0;1;0;0;0
96;22.10.2015;2015;10;04;Torstai;2;0;2;0;0;0
96;22.10.2015;2015;10;05;Torstai;5;3;8;1;0;1
96;22.10.2015;2015;10;06;Torstai;36;26;62;7;0;7
96;22.10.2015;2015;10;07;Torstai;50;70;120;7;6;13
96;22.10.2015;2015;10;08;Torstai;35;63;98;6;3;9
96;22.10.2015;2015;10;09;Torstai;33;43;76;6;7;13
96;22.10.2015;2015;10;10;Torstai;25;45;70;5;10;15
96;22.10.2015;2015;10;11;Torstai;37;47;84;7;18;25
96;22.10.2015;2015;10;12;Torstai;61;47;108;5;4;9
96;22.10.2015;2015;10;13;Torstai;39;56;95;8;11;19
96;22.10.2015;2015;10;14;Torstai;55;60;115;6;4;10
96;22.10.2015;2015;10;15;Torstai;64;108;172;3;23;26
96;22.10.2015;2015;10;16;Torstai;63;77;140;6;8;14
96;22.10.2015;2015;10;17;Torstai;52;39;91;11;12;23
96;22.10.2015;2015;10;18;Torstai;42;36;78;9;11;20
96;22.10.2015;2015;10;19;Torstai;34;20;54;7;6;13
96;22.10.2015;2015;10;20;Torstai;24;12;36;3;7;10
96;22.10.2015;2015;10;21;Torstai;12;18;30;6;6;12
96;22.10.2015;2015;10;22;Torstai;11;7;18;0;0;0
96;22.10.2015;2015;10;23;Torstai;5;1;6;0;0;0
96;23.10.2015;2015;10;00;Perjantai;5;2;7;2;2;4
96;23.10.2015;2015;10;01;Perjantai;2;0;2;0;0;0
96;23.10.2015;2015;10;02;Perjantai;2;0;2;0;0;0
96;23.10.2015;2015;10;03;Perjantai;0;2;2;1;0;1
96;23.10.2015;2015;10;04;Perjantai;5;1;6;1;0;1
96;23.10.2015;2015;10;05;Perjantai;3;4;7;0;0;0
96;23.10.2015;2015;10;06;Perjantai;42;19;61;3;3;6
96;23.10.2015;2015;10;07;Perjantai;48;54;102;3;1;4
96;23.10.2015;2015;10;08;Perjantai;38;48;86;3;4;7
96;23.10.2015;2015;10;09;Perjantai;33;45;78;5;3;8
96;23.10.2015;2015;10;10;Perjantai;19;33;52;0;4;4
96;23.10.2015;2015;10;11;Perjantai;27;36;63;9;6;15
96;23.10.2015;2015;10;12;Perjantai;29;37;66;5;6;11
96;23.10.2015;2015;10;13;Perjantai;37;55;92;9;6;15
96;23.10.2015;2015;10;14;Perjantai;39;52;91;4;10;14
96;23.10.2015;2015;10;15;Perjantai;55;87;142;5;8;13
96;23.10.2015;2015;10;16;Perjantai;53;49;102;5;10;15
96;23.10.2015;2015;10;17;Perjantai;33;43;76;7;1;8
96;23.10.2015;2015;10;18;Perjantai;24;20;44;8;5;13
96;23.10.2015;2015;10;19;Perjantai;22;18;40;6;5;11
96;23.10.2015;2015;10;20;Perjantai;30;28;58;2;4;6
96;23.10.2015;2015;10;21;Perjantai;12;30;42;1;0;1
96;23.10.2015;2015;10;22;Perjantai;11;9;20;4;2;6
96;23.10.2015;2015;10;23;Perjantai;7;7;14;0;2;2
96;24.10.2015;2015;10;00;Lauantai;6;1;7;2;0;2
96;24.10.2015;2015;10;01;Lauantai;4;4;8;0;0;0
96;24.10.2015;2015;10;02;Lauantai;6;3;9;2;0;2
96;24.10.2015;2015;10;03;Lauantai;12;0;12;1;0;1
96;24.10.2015;2015;10;04;Lauantai;9;0;9;1;1;2
96;24.10.2015;2015;10;05;Lauantai;4;2;6;2;1;3
96;24.10.2015;2015;10;06;Lauantai;15;7;22;4;0;4
96;24.10.2015;2015;10;07;Lauantai;2;15;17;0;2;2
96;24.10.2015;2015;10;08;Lauantai;4;13;17;1;4;5
96;24.10.2015;2015;10;09;Lauantai;12;28;40;7;6;13
96;24.10.2015;2015;10;10;Lauantai;14;27;41;3;6;9
96;24.10.2015;2015;10;11;Lauantai;33;23;56;7;16;23
96;24.10.2015;2015;10;12;Lauantai;23;44;67;3;8;11
96;24.10.2015;2015;10;13;Lauantai;33;43;76;5;6;11
96;24.10.2015;2015;10;14;Lauantai;51;51;102;8;12;20
96;24.10.2015;2015;10;15;Lauantai;49;55;104;8;13;21
96;24.10.2015;2015;10;16;Lauantai;41;45;86;6;8;14
96;24.10.2015;2015;10;17;Lauantai;34;30;64;10;7;17
96;24.10.2015;2015;10;18;Lauantai;32;17;49;9;9;18
96;24.10.2015;2015;10;19;Lauantai;35;19;54;5;8;13
96;24.10.2015;2015;10;20;Lauantai;19;18;37;5;7;12
96;24.10.2015;2015;10;21;Lauantai;12;17;29;1;3;4
96;24.10.2015;2015;10;22;Lauantai;9;13;22;0;2;2
96;24.10.2015;2015;10;23;Lauantai;2;11;13;1;1;2
96;25.10.2015;2015;10;00;Sunnuntai;7;2;9;1;0;1
96;25.10.2015;2015;10;01;Sunnuntai;6;2;8;1;0;1
96;25.10.2015;2015;10;02;Sunnuntai;8;0;8;0;0;0
96;25.10.2015;2015;10;03;Sunnuntai;12;2;14;6;1;7
96;25.10.2015;2015;10;04;Sunnuntai;0;0;0;0;0;0
96;25.10.2015;2015;10;05;Sunnuntai;1;3;4;1;0;1
96;25.10.2015;2015;10;06;Sunnuntai;15;3;18;1;1;2
96;25.10.2015;2015;10;07;Sunnuntai;3;8;11;0;3;3
96;25.10.2015;2015;10;08;Sunnuntai;5;9;14;0;3;3
96;25.10.2015;2015;10;09;Sunnuntai;5;10;15;6;4;10
96;25.10.2015;2015;10;10;Sunnuntai;6;13;19;9;7;16
96;25.10.2015;2015;10;11;Sunnuntai;10;17;27;10;4;14
96;25.10.2015;2015;10;12;Sunnuntai;23;18;41;6;7;13
96;25.10.2015;2015;10;13;Sunnuntai;17;10;27;4;6;10
96;25.10.2015;2015;10;14;Sunnuntai;19;19;38;2;3;5
96;25.10.2015;2015;10;15;Sunnuntai;18;32;50;2;2;4
96;25.10.2015;2015;10;16;Sunnuntai;30;22;52;9;4;13
96;25.10.2015;2015;10;17;Sunnuntai;16;9;25;12;4;16
96;25.10.2015;2015;10;18;Sunnuntai;24;22;46;7;18;25
96;25.10.2015;2015;10;19;Sunnuntai;16;24;40;6;14;20
96;25.10.2015;2015;10;20;Sunnuntai;26;18;44;9;10;19
96;25.10.2015;2015;10;21;Sunnuntai;11;13;24;3;0;3
96;25.10.2015;2015;10;22;Sunnuntai;6;5;11;2;3;5
96;25.10.2015;2015;10;23;Sunnuntai;7;3;10;2;0;2
96;26.10.2015;2015;10;00;Maanantai;4;1;5;2;0;2
96;26.10.2015;2015;10;01;Maanantai;0;0;0;0;0;0
96;26.10.2015;2015;10;02;Maanantai;2;3;5;0;0;0
96;26.10.2015;2015;10;03;Maanantai;2;0;2;7;2;9
96;26.10.2015;2015;10;04;Maanantai;2;0;2;0;0;0
96;26.10.2015;2015;10;05;Maanantai;4;8;12;2;1;3
96;26.10.2015;2015;10;06;Maanantai;47;33;80;8;5;13
96;26.10.2015;2015;10;07;Maanantai;104;122;226;28;4;32
96;26.10.2015;2015;10;08;Maanantai;156;126;282;14;5;19
96;26.10.2015;2015;10;09;Maanantai;66;84;150;14;13;27
96;26.10.2015;2015;10;10;Maanantai;81;64;145;19;13;32
96;26.10.2015;2015;10;11;Maanantai;74;69;143;12;7;19
96;26.10.2015;2015;10;12;Maanantai;78;97;175;17;6;23
96;26.10.2015;2015;10;13;Maanantai;63;106;169;8;16;24
96;26.10.2015;2015;10;14;Maanantai;97;150;247;6;19;25
96;26.10.2015;2015;10;15;Maanantai;118;206;324;13;30;43
96;26.10.2015;2015;10;16;Maanantai;109;178;287;5;27;32
96;26.10.2015;2015;10;17;Maanantai;91;82;173;13;10;23
96;26.10.2015;2015;10;18;Maanantai;67;53;120;17;18;35
96;26.10.2015;2015;10;19;Maanantai;62;49;111;17;20;37
96;26.10.2015;2015;10;20;Maanantai;38;46;84;11;13;24
96;26.10.2015;2015;10;21;Maanantai;30;36;66;7;7;14
96;26.10.2015;2015;10;22;Maanantai;10;8;18;1;0;1
96;26.10.2015;2015;10;23;Maanantai;5;7;12;0;1;1
96;27.10.2015;2015;10;00;Tiistai;2;1;3;0;0;0
96;27.10.2015;2015;10;01;Tiistai;0;1;1;1;0;1
96;27.10.2015;2015;10;02;Tiistai;1;0;1;0;0;0
96;27.10.2015;2015;10;03;Tiistai;1;0;1;0;0;0
96;27.10.2015;2015;10;04;Tiistai;1;0;1;0;0;0
96;27.10.2015;2015;10;05;Tiistai;5;6;11;1;1;2
96;27.10.2015;2015;10;06;Tiistai;43;20;63;4;2;6
96;27.10.2015;2015;10;07;Tiistai;115;121;236;14;8;22
96;27.10.2015;2015;10;08;Tiistai;162;118;280;16;11;27
96;27.10.2015;2015;10;09;Tiistai;96;69;165;18;8;26
96;27.10.2015;2015;10;10;Tiistai;63;50;113;11;16;27
96;27.10.2015;2015;10;11;Tiistai;85;67;152;10;10;20
96;27.10.2015;2015;10;12;Tiistai;80;69;149;17;17;34
96;27.10.2015;2015;10;13;Tiistai;59;103;162;4;12;16
96;27.10.2015;2015;10;14;Tiistai;83;158;241;9;16;25
96;27.10.2015;2015;10;15;Tiistai;85;195;280;12;32;44
96;27.10.2015;2015;10;16;Tiistai;109;173;282;11;21;32
96;27.10.2015;2015;10;17;Tiistai;52;80;132;14;20;34
96;27.10.2015;2015;10;18;Tiistai;81;58;139;14;8;22
96;27.10.2015;2015;10;19;Tiistai;48;50;98;12;22;34
96;27.10.2015;2015;10;20;Tiistai;51;34;85;9;3;12
96;27.10.2015;2015;10;21;Tiistai;26;26;52;5;8;13
96;27.10.2015;2015;10;22;Tiistai;7;10;17;1;1;2
96;27.10.2015;2015;10;23;Tiistai;8;1;9;0;1;1
96;28.10.2015;2015;10;00;Keskiviikko;0;3;3;0;0;0
96;28.10.2015;2015;10;01;Keskiviikko;1;1;2;0;0;0
96;28.10.2015;2015;10;02;Keskiviikko;2;2;4;0;0;0
96;28.10.2015;2015;10;03;Keskiviikko;1;0;1;0;0;0
96;28.10.2015;2015;10;04;Keskiviikko;2;0;2;0;0;0
96;28.10.2015;2015;10;05;Keskiviikko;3;6;9;1;1;2
96;28.10.2015;2015;10;06;Keskiviikko;38;36;74;10;0;10
96;28.10.2015;2015;10;07;Keskiviikko;125;106;231;26;13;39
96;28.10.2015;2015;10;08;Keskiviikko;145;127;272;9;6;15
96;28.10.2015;2015;10;09;Keskiviikko;69;65;134;16;8;24
96;28.10.2015;2015;10;10;Keskiviikko;51;55;106;7;11;18
96;28.10.2015;2015;10;11;Keskiviikko;77;64;141;13;12;25
96;28.10.2015;2015;10;12;Keskiviikko;76;76;152;10;11;21
96;28.10.2015;2015;10;13;Keskiviikko;62;130;192;10;9;19
96;28.10.2015;2015;10;14;Keskiviikko;81;154;235;12;20;32
96;28.10.2015;2015;10;15;Keskiviikko;79;203;282;2;28;30
96;28.10.2015;2015;10;16;Keskiviikko;111;183;294;12;26;38
96;28.10.2015;2015;10;17;Keskiviikko;82;78;160;14;13;27
96;28.10.2015;2015;10;18;Keskiviikko;78;59;137;14;15;29
96;28.10.2015;2015;10;19;Keskiviikko;55;42;97;13;19;32
96;28.10.2015;2015;10;20;Keskiviikko;37;47;84;5;15;20
96;28.10.2015;2015;10;21;Keskiviikko;21;49;70;5;4;9
96;28.10.2015;2015;10;22;Keskiviikko;4;5;9;1;3;4
96;28.10.2015;2015;10;23;Keskiviikko;7;1;8;0;2;2
96;29.10.2015;2015;10;00;Torstai;3;2;5;0;0;0
96;29.10.2015;2015;10;01;Torstai;4;0;4;0;0;0
96;29.10.2015;2015;10;02;Torstai;2;3;5;0;0;0
96;29.10.2015;2015;10;03;Torstai;8;1;9;0;0;0
96;29.10.2015;2015;10;04;Torstai;4;1;5;0;0;0
96;29.10.2015;2015;10;05;Torstai;2;7;9;0;1;1
96;29.10.2015;2015;10;06;Torstai;37;26;63;9;2;11
96;29.10.2015;2015;10;07;Torstai;103;96;199;19;7;26
96;29.10.2015;2015;10;08;Torstai;172;111;283;10;3;13
96;29.10.2015;2015;10;09;Torstai;93;76;169;10;6;16
96;29.10.2015;2015;10;10;Torstai;89;57;146;9;4;13
96;29.10.2015;2015;10;11;Torstai;55;59;114;10;8;18
96;29.10.2015;2015;10;12;Torstai;71;76;147;10;15;25
96;29.10.2015;2015;10;13;Torstai;48;102;150;7;12;19
96;29.10.2015;2015;10;14;Torstai;84;129;213;11;22;33
96;29.10.2015;2015;10;15;Torstai;105;196;301;14;32;46
96;29.10.2015;2015;10;16;Torstai;110;167;277;5;19;24
96;29.10.2015;2015;10;17;Torstai;66;77;143;8;9;17
96;29.10.2015;2015;10;18;Torstai;54;57;111;18;15;33
96;29.10.2015;2015;10;19;Torstai;49;44;93;12;8;20
96;29.10.2015;2015;10;20;Torstai;31;36;67;5;10;15
96;29.10.2015;2015;10;21;Torstai;24;34;58;5;11;16
96;29.10.2015;2015;10;22;Torstai;10;4;14;1;2;3
96;29.10.2015;2015;10;23;Torstai;6;6;12;0;0;0
96;30.10.2015;2015;10;00;Perjantai;8;2;10;2;0;2
96;30.10.2015;2015;10;01;Perjantai;7;0;7;0;0;0
96;30.10.2015;2015;10;02;Perjantai;3;0;3;0;1;1
96;30.10.2015;2015;10;03;Perjantai;9;1;10;0;0;0
96;30.10.2015;2015;10;04;Perjantai;3;1;4;0;0;0
96;30.10.2015;2015;10;05;Perjantai;5;6;11;2;1;3
96;30.10.2015;2015;10;06;Perjantai;49;23;72;5;1;6
96;30.10.2015;2015;10;07;Perjantai;83;86;169;17;8;25
96;30.10.2015;2015;10;08;Perjantai;148;105;253;14;10;24
96;30.10.2015;2015;10;09;Perjantai;62;58;120;4;1;5
96;30.10.2015;2015;10;10;Perjantai;47;57;104;12;10;22
96;30.10.2015;2015;10;11;Perjantai;54;68;122;2;7;9
96;30.10.2015;2015;10;12;Perjantai;58;104;162;6;10;16
96;30.10.2015;2015;10;13;Perjantai;56;126;182;6;15;21
96;30.10.2015;2015;10;14;Perjantai;77;174;251;4;15;19
96;30.10.2015;2015;10;15;Perjantai;67;142;209;2;19;21
96;30.10.2015;2015;10;16;Perjantai;75;97;172;4;6;10
96;30.10.2015;2015;10;17;Perjantai;53;53;106;3;6;9
96;30.10.2015;2015;10;18;Perjantai;35;40;75;2;12;14
96;30.10.2015;2015;10;19;Perjantai;30;35;65;3;4;7
96;30.10.2015;2015;10;20;Perjantai;32;32;64;5;2;7
96;30.10.2015;2015;10;21;Perjantai;15;33;48;2;3;5
96;30.10.2015;2015;10;22;Perjantai;12;15;27;2;3;5
96;30.10.2015;2015;10;23;Perjantai;7;16;23;0;1;1
96;31.10.2015;2015;10;00;Lauantai;10;3;13;1;1;2
96;31.10.2015;2015;10;01;Lauantai;11;7;18;1;0;1
96;31.10.2015;2015;10;02;Lauantai;7;2;9;0;0;0
96;31.10.2015;2015;10;03;Lauantai;10;6;16;0;0;0
96;31.10.2015;2015;10;04;Lauantai;11;2;13;1;0;1
96;31.10.2015;2015;10;05;Lauantai;2;0;2;1;0;1
96;31.10.2015;2015;10;06;Lauantai;13;6;19;3;1;4
96;31.10.2015;2015;10;07;Lauantai;2;14;16;2;1;3
96;31.10.2015;2015;10;08;Lauantai;3;4;7;2;3;5
96;31.10.2015;2015;10;09;Lauantai;7;9;16;8;5;13
96;31.10.2015;2015;10;10;Lauantai;10;16;26;16;11;27
96;31.10.2015;2015;10;11;Lauantai;18;22;40;15;10;25
96;31.10.2015;2015;10;12;Lauantai;18;18;36;8;9;17
96;31.10.2015;2015;10;13;Lauantai;25;25;50;10;10;20
96;31.10.2015;2015;10;14;Lauantai;17;33;50;11;14;25
96;31.10.2015;2015;10;15;Lauantai;24;40;64;14;15;29
96;31.10.2015;2015;10;16;Lauantai;26;41;67;18;29;47
96;31.10.2015;2015;10;17;Lauantai;33;35;68;7;8;15
96;31.10.2015;2015;10;18;Lauantai;27;23;50;13;16;29
96;31.10.2015;2015;10;19;Lauantai;37;35;72;13;12;25
96;31.10.2015;2015;10;20;Lauantai;18;24;42;4;7;11
96;31.10.2015;2015;10;21;Lauantai;14;14;28;1;3;4
96;31.10.2015;2015;10;22;Lauantai;5;9;14;2;1;3
96;31.10.2015;2015;10;23;Lauantai;7;7;14;1;1;2
96;01.11.2015;2015;11;00;Sunnuntai;3;3;6;0;0;0
96;01.11.2015;2015;11;01;Sunnuntai;11;5;16;1;0;1
96;01.11.2015;2015;11;02;Sunnuntai;10;1;11;1;0;1
96;01.11.2015;2015;11;03;Sunnuntai;7;0;7;3;0;3
96;01.11.2015;2015;11;04;Sunnuntai;12;2;14;2;0;2
96;01.11.2015;2015;11;05;Sunnuntai;5;1;6;0;0;0
96;01.11.2015;2015;11;06;Sunnuntai;13;6;19;1;0;1
96;01.11.2015;2015;11;07;Sunnuntai;1;7;8;1;1;2
96;01.11.2015;2015;11;08;Sunnuntai;5;4;9;4;2;6
96;01.11.2015;2015;11;09;Sunnuntai;9;6;15;4;3;7
96;01.11.2015;2015;11;10;Sunnuntai;11;9;20;10;6;16
96;01.11.2015;2015;11;11;Sunnuntai;25;28;53;15;10;25
96;01.11.2015;2015;11;12;Sunnuntai;28;36;64;14;17;31
96;01.11.2015;2015;11;13;Sunnuntai;37;53;90;7;9;16
96;01.11.2015;2015;11;14;Sunnuntai;53;54;107;14;9;23
96;01.11.2015;2015;11;15;Sunnuntai;42;44;86;11;5;16
96;01.11.2015;2015;11;16;Sunnuntai;48;18;66;12;7;19
96;01.11.2015;2015;11;17;Sunnuntai;46;32;78;15;13;28
96;01.11.2015;2015;11;18;Sunnuntai;44;36;80;16;20;36
96;01.11.2015;2015;11;19;Sunnuntai;18;36;54;14;12;26
96;01.11.2015;2015;11;20;Sunnuntai;22;33;55;3;7;10
96;01.11.2015;2015;11;21;Sunnuntai;23;14;37;5;5;10
96;01.11.2015;2015;11;22;Sunnuntai;4;6;10;0;2;2
96;01.11.2015;2015;11;23;Sunnuntai;5;1;6;3;0;3
96;02.11.2015;2015;11;00;Maanantai;4;0;4;1;0;1
96;02.11.2015;2015;11;01;Maanantai;5;1;6;1;0;1
96;02.11.2015;2015;11;02;Maanantai;5;1;6;0;0;0
96;02.11.2015;2015;11;03;Maanantai;1;0;1;0;0;0
96;02.11.2015;2015;11;04;Maanantai;2;0;2;0;0;0
96;02.11.2015;2015;11;05;Maanantai;5;4;9;0;0;0
96;02.11.2015;2015;11;06;Maanantai;33;36;69;5;0;5
96;02.11.2015;2015;11;07;Maanantai;100;107;207;18;6;24
96;02.11.2015;2015;11;08;Maanantai;156;139;295;17;8;25
96;02.11.2015;2015;11;09;Maanantai;74;75;149;13;8;21
96;02.11.2015;2015;11;10;Maanantai;73;59;132;13;9;22
96;02.11.2015;2015;11;11;Maanantai;58;66;124;10;10;20
96;02.11.2015;2015;11;12;Maanantai;73;85;158;4;7;11
96;02.11.2015;2015;11;13;Maanantai;72;90;162;3;16;19
96;02.11.2015;2015;11;14;Maanantai;75;149;224;4;9;13
96;02.11.2015;2015;11;15;Maanantai;109;199;308;5;16;21
96;02.11.2015;2015;11;16;Maanantai;135;178;313;14;20;34
96;02.11.2015;2015;11;17;Maanantai;76;83;159;19;10;29
96;02.11.2015;2015;11;18;Maanantai;60;58;118;21;17;38
96;02.11.2015;2015;11;19;Maanantai;52;40;92;12;16;28
96;02.11.2015;2015;11;20;Maanantai;36;41;77;14;4;18
96;02.11.2015;2015;11;21;Maanantai;24;40;64;1;11;12
96;02.11.2015;2015;11;22;Maanantai;15;11;26;2;0;2
96;02.11.2015;2015;11;23;Maanantai;2;0;2;0;0;0
96;03.11.2015;2015;11;00;Tiistai;5;1;6;0;1;1
96;03.11.2015;2015;11;01;Tiistai;0;1;1;0;0;0
96;03.11.2015;2015;11;02;Tiistai;0;0;0;0;0;0
96;03.11.2015;2015;11;03;Tiistai;3;1;4;0;0;0
96;03.11.2015;2015;11;04;Tiistai;2;3;5;0;0;0
96;03.11.2015;2015;11;05;Tiistai;3;6;9;1;1;2
96;03.11.2015;2015;11;06;Tiistai;44;31;75;9;4;13
96;03.11.2015;2015;11;07;Tiistai;117;99;216;17;6;23
96;03.11.2015;2015;11;08;Tiistai;131;138;269;11;7;18
96;03.11.2015;2015;11;09;Tiistai;113;74;187;14;11;25
96;03.11.2015;2015;11;10;Tiistai;69;66;135;7;6;13
96;03.11.2015;2015;11;11;Tiistai;92;88;180;11;10;21
96;03.11.2015;2015;11;12;Tiistai;83;78;161;10;6;16
96;03.11.2015;2015;11;13;Tiistai;58;106;164;11;19;30
96;03.11.2015;2015;11;14;Tiistai;77;123;200;8;18;26
96;03.11.2015;2015;11;15;Tiistai;104;225;329;6;29;35
96;03.11.2015;2015;11;16;Tiistai;125;197;322;18;34;52
96;03.11.2015;2015;11;17;Tiistai;73;97;170;12;14;26
96;03.11.2015;2015;11;18;Tiistai;77;60;137;21;15;36
96;03.11.2015;2015;11;19;Tiistai;65;54;119;17;18;35
96;03.11.2015;2015;11;20;Tiistai;48;41;89;6;14;20
96;03.11.2015;2015;11;21;Tiistai;28;33;61;6;9;15
96;03.11.2015;2015;11;22;Tiistai;8;13;21;1;1;2
96;03.11.2015;2015;11;23;Tiistai;9;3;12;0;2;2
96;04.11.2015;2015;11;00;Keskiviikko;3;4;7;0;0;0
96;04.11.2015;2015;11;01;Keskiviikko;0;1;1;0;0;0
96;04.11.2015;2015;11;02;Keskiviikko;1;1;2;0;0;0
96;04.11.2015;2015;11;03;Keskiviikko;1;0;1;0;0;0
96;04.11.2015;2015;11;04;Keskiviikko;3;0;3;0;0;0
96;04.11.2015;2015;11;05;Keskiviikko;3;8;11;1;1;2
96;04.11.2015;2015;11;06;Keskiviikko;46;30;76;8;0;8
96;04.11.2015;2015;11;07;Keskiviikko;114;114;228;17;11;28
96;04.11.2015;2015;11;08;Keskiviikko;135;128;263;19;7;26
96;04.11.2015;2015;11;09;Keskiviikko;90;84;174;7;6;13
96;04.11.2015;2015;11;10;Keskiviikko;67;62;129;6;4;10
96;04.11.2015;2015;11;11;Keskiviikko;71;87;158;6;8;14
96;04.11.2015;2015;11;12;Keskiviikko;78;75;153;9;15;24
96;04.11.2015;2015;11;13;Keskiviikko;92;108;200;7;9;16
96;04.11.2015;2015;11;14;Keskiviikko;91;130;221;14;13;27
96;04.11.2015;2015;11;15;Keskiviikko;106;225;331;10;26;36
96;04.11.2015;2015;11;16;Keskiviikko;117;193;310;17;25;42
96;04.11.2015;2015;11;17;Keskiviikko;84;89;173;13;12;25
96;04.11.2015;2015;11;18;Keskiviikko;57;59;116;20;11;31
96;04.11.2015;2015;11;19;Keskiviikko;64;52;116;10;13;23
96;04.11.2015;2015;11;20;Keskiviikko;55;37;92;6;11;17
96;04.11.2015;2015;11;21;Keskiviikko;41;34;75;3;6;9
96;04.11.2015;2015;11;22;Keskiviikko;11;14;25;2;0;2
96;04.11.2015;2015;11;23;Keskiviikko;14;3;17;1;1;2
96;05.11.2015;2015;11;00;Torstai;3;5;8;0;0;0
96;05.11.2015;2015;11;01;Torstai;1;0;1;0;0;0
96;05.11.2015;2015;11;02;Torstai;2;0;2;0;0;0
96;05.11.2015;2015;11;03;Torstai;3;0;3;0;0;0
96;05.11.2015;2015;11;04;Torstai;4;2;6;0;0;0
96;05.11.2015;2015;11;05;Torstai;2;9;11;0;0;0
96;05.11.2015;2015;11;06;Torstai;44;26;70;9;1;10
96;05.11.2015;2015;11;07;Torstai;113;89;202;19;7;26
96;05.11.2015;2015;11;08;Torstai;160;108;268;15;5;20
96;05.11.2015;2015;11;09;Torstai;87;85;172;16;9;25
96;05.11.2015;2015;11;10;Torstai;77;75;152;10;16;26
96;05.11.2015;2015;11;11;Torstai;69;71;140;10;7;17
96;05.11.2015;2015;11;12;Torstai;78;61;139;14;11;25
96;05.11.2015;2015;11;13;Torstai;63;88;151;5;11;16
96;05.11.2015;2015;11;14;Torstai;71;139;210;8;20;28
96;05.11.2015;2015;11;15;Torstai;95;219;314;8;41;49
96;05.11.2015;2015;11;16;Torstai;101;164;265;16;18;34
96;05.11.2015;2015;11;17;Torstai;58;82;140;13;11;24
96;05.11.2015;2015;11;18;Torstai;56;60;116;12;19;31
96;05.11.2015;2015;11;19;Torstai;49;47;96;4;15;19
96;05.11.2015;2015;11;20;Torstai;44;29;73;13;10;23
96;05.11.2015;2015;11;21;Torstai;28;27;55;4;2;6
96;05.11.2015;2015;11;22;Torstai;10;10;20;0;4;4
96;05.11.2015;2015;11;23;Torstai;7;4;11;0;0;0
96;06.11.2015;2015;11;00;Perjantai;3;5;8;3;0;3
96;06.11.2015;2015;11;01;Perjantai;7;0;7;0;0;0
96;06.11.2015;2015;11;02;Perjantai;4;0;4;0;0;0
96;06.11.2015;2015;11;03;Perjantai;7;0;7;1;0;1
96;06.11.2015;2015;11;04;Perjantai;2;3;5;0;0;0
96;06.11.2015;2015;11;05;Perjantai;1;10;11;0;0;0
96;06.11.2015;2015;11;06;Perjantai;40;24;64;6;2;8
96;06.11.2015;2015;11;07;Perjantai;102;91;193;10;10;20
96;06.11.2015;2015;11;08;Perjantai;110;105;215;13;6;19
96;06.11.2015;2015;11;09;Perjantai;56;80;136;10;5;15
96;06.11.2015;2015;11;10;Perjantai;58;53;111;8;11;19
96;06.11.2015;2015;11;11;Perjantai;59;81;140;8;8;16
96;06.11.2015;2015;11;12;Perjantai;91;92;183;18;15;33
96;06.11.2015;2015;11;13;Perjantai;78;100;178;4;16;20
96;06.11.2015;2015;11;14;Perjantai;68;154;222;7;16;23
96;06.11.2015;2015;11;15;Perjantai;61;164;225;8;34;42
96;06.11.2015;2015;11;16;Perjantai;69;68;137;10;13;23
96;06.11.2015;2015;11;17;Perjantai;34;58;92;8;11;19
96;06.11.2015;2015;11;18;Perjantai;38;31;69;8;8;16
96;06.11.2015;2015;11;19;Perjantai;32;27;59;6;6;12
96;06.11.2015;2015;11;20;Perjantai;31;20;51;9;6;15
96;06.11.2015;2015;11;21;Perjantai;17;29;46;4;4;8
96;06.11.2015;2015;11;22;Perjantai;9;15;24;1;3;4
96;06.11.2015;2015;11;23;Perjantai;8;12;20;1;1;2
96;07.11.2015;2015;11;00;Lauantai;8;10;18;2;0;2
96;07.11.2015;2015;11;01;Lauantai;3;3;6;0;0;0
96;07.11.2015;2015;11;02;Lauantai;10;1;11;0;0;0
96;07.11.2015;2015;11;03;Lauantai;15;2;17;2;0;2
96;07.11.2015;2015;11;04;Lauantai;5;2;7;2;1;3
96;07.11.2015;2015;11;05;Lauantai;0;1;1;2;0;2
96;07.11.2015;2015;11;06;Lauantai;11;10;21;1;2;3
96;07.11.2015;2015;11;07;Lauantai;7;12;19;2;1;3
96;07.11.2015;2015;11;08;Lauantai;9;16;25;4;1;5
96;07.11.2015;2015;11;09;Lauantai;10;12;22;4;1;5
96;07.11.2015;2015;11;10;Lauantai;17;26;43;1;3;4
96;07.11.2015;2015;11;11;Lauantai;22;20;42;7;3;10
96;07.11.2015;2015;11;12;Lauantai;28;30;58;9;9;18
96;07.11.2015;2015;11;13;Lauantai;35;34;69;7;18;25
96;07.11.2015;2015;11;14;Lauantai;34;45;79;1;5;6
96;07.11.2015;2015;11;15;Lauantai;31;32;63;3;8;11
96;07.11.2015;2015;11;16;Lauantai;31;34;65;11;7;18
96;07.11.2015;2015;11;17;Lauantai;27;30;57;6;8;14
96;07.11.2015;2015;11;18;Lauantai;24;15;39;5;5;10
96;07.11.2015;2015;11;19;Lauantai;16;7;23;4;9;13
96;07.11.2015;2015;11;20;Lauantai;7;11;18;2;7;9
96;07.11.2015;2015;11;21;Lauantai;15;30;45;3;8;11
96;07.11.2015;2015;11;22;Lauantai;8;9;17;1;3;4
96;07.11.2015;2015;11;23;Lauantai;2;5;7;1;1;2
96;08.11.2015;2015;11;00;Sunnuntai;10;5;15;0;1;1
96;08.11.2015;2015;11;01;Sunnuntai;7;4;11;1;0;1
96;08.11.2015;2015;11;02;Sunnuntai;12;0;12;1;0;1
96;08.11.2015;2015;11;03;Sunnuntai;9;0;9;0;0;0
96;08.11.2015;2015;11;04;Sunnuntai;6;1;7;4;0;4
96;08.11.2015;2015;11;05;Sunnuntai;1;2;3;0;0;0
96;08.11.2015;2015;11;06;Sunnuntai;6;4;10;1;0;1
96;08.11.2015;2015;11;07;Sunnuntai;3;10;13;2;2;4
96;08.11.2015;2015;11;08;Sunnuntai;5;8;13;1;3;4
96;08.11.2015;2015;11;09;Sunnuntai;4;7;11;4;6;10
96;08.11.2015;2015;11;10;Sunnuntai;17;7;24;9;4;13
96;08.11.2015;2015;11;11;Sunnuntai;18;17;35;9;7;16
96;08.11.2015;2015;11;12;Sunnuntai;13;17;30;12;15;27
96;08.11.2015;2015;11;13;Sunnuntai;28;25;53;8;6;14
96;08.11.2015;2015;11;14;Sunnuntai;31;34;65;9;4;13
96;08.11.2015;2015;11;15;Sunnuntai;23;15;38;7;7;14
96;08.11.2015;2015;11;16;Sunnuntai;28;18;46;17;9;26
96;08.11.2015;2015;11;17;Sunnuntai;31;20;51;9;8;17
96;08.11.2015;2015;11;18;Sunnuntai;15;21;36;5;9;14
96;08.11.2015;2015;11;19;Sunnuntai;16;22;38;8;16;24
96;08.11.2015;2015;11;20;Sunnuntai;22;12;34;4;9;13
96;08.11.2015;2015;11;21;Sunnuntai;10;12;22;6;2;8
96;08.11.2015;2015;11;22;Sunnuntai;11;2;13;1;1;2
96;08.11.2015;2015;11;23;Sunnuntai;4;2;6;4;2;6
96;09.11.2015;2015;11;00;Maanantai;4;4;8;0;0;0
96;09.11.2015;2015;11;01;Maanantai;3;0;3;0;0;0
96;09.11.2015;2015;11;02;Maanantai;0;1;1;0;0;0
96;09.11.2015;2015;11;03;Maanantai;0;0;0;0;0;0
96;09.11.2015;2015;11;04;Maanantai;2;0;2;0;0;0
96;09.11.2015;2015;11;05;Maanantai;4;5;9;1;0;1
96;09.11.2015;2015;11;06;Maanantai;43;24;67;5;0;5
96;09.11.2015;2015;11;07;Maanantai;93;103;196;19;10;29
96;09.11.2015;2015;11;08;Maanantai;137;136;273;17;5;22
96;09.11.2015;2015;11;09;Maanantai;80;67;147;13;4;17
96;09.11.2015;2015;11;10;Maanantai;55;100;155;11;13;24
96;09.11.2015;2015;11;11;Maanantai;82;83;165;14;7;21
96;09.11.2015;2015;11;12;Maanantai;75;79;154;9;21;30
96;09.11.2015;2015;11;13;Maanantai;70;85;155;8;10;18
96;09.11.2015;2015;11;14;Maanantai;80;125;205;8;22;30
96;09.11.2015;2015;11;15;Maanantai;106;210;316;8;27;35
96;09.11.2015;2015;11;16;Maanantai;99;172;271;14;14;28
96;09.11.2015;2015;11;17;Maanantai;91;72;163;19;16;35
96;09.11.2015;2015;11;18;Maanantai;61;48;109;18;16;34
96;09.11.2015;2015;11;19;Maanantai;42;51;93;9;18;27
96;09.11.2015;2015;11;20;Maanantai;41;34;75;8;7;15
96;09.11.2015;2015;11;21;Maanantai;32;26;58;4;6;10
96;09.11.2015;2015;11;22;Maanantai;5;0;5;5;4;9
96;09.11.2015;2015;11;23;Maanantai;4;3;7;1;0;1
96;10.11.2015;2015;11;00;Tiistai;1;1;2;0;1;1
96;10.11.2015;2015;11;01;Tiistai;1;0;1;0;0;0
96;10.11.2015;2015;11;02;Tiistai;0;0;0;0;0;0
96;10.11.2015;2015;11;03;Tiistai;0;0;0;0;0;0
96;10.11.2015;2015;11;04;Tiistai;2;0;2;0;0;0
96;10.11.2015;2015;11;05;Tiistai;5;3;8;1;2;3
96;10.11.2015;2015;11;06;Tiistai;39;24;63;8;1;9
96;10.11.2015;2015;11;07;Tiistai;93;68;161;8;11;19
96;10.11.2015;2015;11;08;Tiistai;112;113;225;7;2;9
96;10.11.2015;2015;11;09;Tiistai;93;61;154;18;5;23
96;10.11.2015;2015;11;10;Tiistai;42;53;95;3;8;11
96;10.11.2015;2015;11;11;Tiistai;53;47;100;13;8;21
96;10.11.2015;2015;11;12;Tiistai;61;39;100;12;8;20
96;10.11.2015;2015;11;13;Tiistai;39;74;113;5;10;15
96;10.11.2015;2015;11;14;Tiistai;54;103;157;3;14;17
96;10.11.2015;2015;11;15;Tiistai;69;161;230;2;28;30
96;10.11.2015;2015;11;16;Tiistai;72;153;225;10;22;32
96;10.11.2015;2015;11;17;Tiistai;41;64;105;17;16;33
96;10.11.2015;2015;11;18;Tiistai;39;57;96;12;12;24
96;10.11.2015;2015;11;19;Tiistai;30;25;55;4;17;21
96;10.11.2015;2015;11;20;Tiistai;29;27;56;7;2;9
96;10.11.2015;2015;11;21;Tiistai;40;26;66;10;7;17
96;10.11.2015;2015;11;22;Tiistai;3;8;11;2;2;4
96;10.11.2015;2015;11;23;Tiistai;4;4;8;0;0;0
96;11.11.2015;2015;11;00;Keskiviikko;2;3;5;3;0;3
96;11.11.2015;2015;11;01;Keskiviikko;0;0;0;0;0;0
96;11.11.2015;2015;11;02;Keskiviikko;0;0;0;1;0;1
96;11.11.2015;2015;11;03;Keskiviikko;1;0;1;0;1;1
96;11.11.2015;2015;11;04;Keskiviikko;1;1;2;0;0;0
96;11.11.2015;2015;11;05;Keskiviikko;6;6;12;0;0;0
96;11.11.2015;2015;11;06;Keskiviikko;35;29;64;10;1;11
96;11.11.2015;2015;11;07;Keskiviikko;89;85;174;17;5;22
96;11.11.2015;2015;11;08;Keskiviikko;99;101;200;14;13;27
96;11.11.2015;2015;11;09;Keskiviikko;83;61;144;10;5;15
96;11.11.2015;2015;11;10;Keskiviikko;57;41;98;9;5;14
96;11.11.2015;2015;11;11;Keskiviikko;70;56;126;11;10;21
96;11.11.2015;2015;11;12;Keskiviikko;67;70;137;12;12;24
96;11.11.2015;2015;11;13;Keskiviikko;58;84;142;7;8;15
96;11.11.2015;2015;11;14;Keskiviikko;69;144;213;13;14;27
96;11.11.2015;2015;11;15;Keskiviikko;80;155;235;9;41;50
96;11.11.2015;2015;11;16;Keskiviikko;99;164;263;11;24;35
96;11.11.2015;2015;11;17;Keskiviikko;63;63;126;10;28;38
96;11.11.2015;2015;11;18;Keskiviikko;58;65;123;10;13;23
96;11.11.2015;2015;11;19;Keskiviikko;40;37;77;9;16;25
96;11.11.2015;2015;11;20;Keskiviikko;39;33;72;10;9;19
96;11.11.2015;2015;11;21;Keskiviikko;38;40;78;4;10;14
96;11.11.2015;2015;11;22;Keskiviikko;11;11;22;0;0;0
96;11.11.2015;2015;11;23;Keskiviikko;7;5;12;2;0;2
96;12.11.2015;2015;11;00;Torstai;1;0;1;0;0;0
96;12.11.2015;2015;11;01;Torstai;0;1;1;0;0;0
96;12.11.2015;2015;11;02;Torstai;0;0;0;0;0;0
96;12.11.2015;2015;11;03;Torstai;1;0;1;0;0;0
96;12.11.2015;2015;11;04;Torstai;1;2;3;1;0;1
96;12.11.2015;2015;11;05;Torstai;5;5;10;1;0;1
96;12.11.2015;2015;11;06;Torstai;28;26;54;11;3;14
96;12.11.2015;2015;11;07;Torstai;77;88;165;14;7;21
96;12.11.2015;2015;11;08;Torstai;116;121;237;16;9;25
96;12.11.2015;2015;11;09;Torstai;84;88;172;10;4;14
96;12.11.2015;2015;11;10;Torstai;65;57;122;10;8;18
96;12.11.2015;2015;11;11;Torstai;47;68;115;10;12;22
96;12.11.2015;2015;11;12;Torstai;58;62;120;7;16;23
96;12.11.2015;2015;11;13;Torstai;57;72;129;8;11;19
96;12.11.2015;2015;11;14;Torstai;59;133;192;8;19;27
96;12.11.2015;2015;11;15;Torstai;72;180;252;5;21;26
96;12.11.2015;2015;11;16;Torstai;92;154;246;12;24;36
96;12.11.2015;2015;11;17;Torstai;60;75;135;10;17;27
96;12.11.2015;2015;11;18;Torstai;48;50;98;13;11;24
96;12.11.2015;2015;11;19;Torstai;37;39;76;6;7;13
96;12.11.2015;2015;11;20;Torstai;44;26;70;1;11;12
96;12.11.2015;2015;11;21;Torstai;27;24;51;3;5;8
96;12.11.2015;2015;11;22;Torstai;4;6;10;1;1;2
96;12.11.2015;2015;11;23;Torstai;7;5;12;1;2;3
96;13.11.2015;2015;11;00;Perjantai;2;1;3;1;0;1
96;13.11.2015;2015;11;01;Perjantai;1;0;1;0;0;0
96;13.11.2015;2015;11;02;Perjantai;1;2;3;0;1;1
96;13.11.2015;2015;11;03;Perjantai;0;0;0;0;0;0
96;13.11.2015;2015;11;04;Perjantai;3;1;4;0;0;0
96;13.11.2015;2015;11;05;Perjantai;6;7;13;1;0;1
96;13.11.2015;2015;11;06;Perjantai;46;26;72;10;1;11
96;13.11.2015;2015;11;07;Perjantai;89;77;166;14;5;19
96;13.11.2015;2015;11;08;Perjantai;97;94;191;10;10;20
96;13.11.2015;2015;11;09;Perjantai;50;49;99;10;4;14
96;13.11.2015;2015;11;10;Perjantai;49;63;112;8;9;17
96;13.11.2015;2015;11;11;Perjantai;52;67;119;10;13;23
96;13.11.2015;2015;11;12;Perjantai;69;82;151;12;11;23
96;13.11.2015;2015;11;13;Perjantai;65;111;176;10;17;27
96;13.11.2015;2015;11;14;Perjantai;64;141;205;6;21;27
96;13.11.2015;2015;11;15;Perjantai;58;152;210;10;29;39
96;13.11.2015;2015;11;16;Perjantai;51;83;134;5;13;18
96;13.11.2015;2015;11;17;Perjantai;36;50;86;7;8;15
96;13.11.2015;2015;11;18;Perjantai;44;26;70;16;13;29
96;13.11.2015;2015;11;19;Perjantai;22;27;49;9;8;17
96;13.11.2015;2015;11;20;Perjantai;22;25;47;5;5;10
96;13.11.2015;2015;11;21;Perjantai;28;22;50;2;3;5
96;13.11.2015;2015;11;22;Perjantai;11;12;23;1;2;3
96;13.11.2015;2015;11;23;Perjantai;8;11;19;5;3;8
96;14.11.2015;2015;11;00;Lauantai;9;5;14;0;1;1
96;14.11.2015;2015;11;01;Lauantai;2;1;3;3;0;3
96;14.11.2015;2015;11;02;Lauantai;8;2;10;1;0;1
96;14.11.2015;2015;11;03;Lauantai;8;0;8;1;0;1
96;14.11.2015;2015;11;04;Lauantai;4;4;8;4;1;5
96;14.11.2015;2015;11;05;Lauantai;1;1;2;0;1;1
96;14.11.2015;2015;11;06;Lauantai;9;2;11;3;0;3
96;14.11.2015;2015;11;07;Lauantai;6;11;17;0;0;0
96;14.11.2015;2015;11;08;Lauantai;3;11;14;2;3;5
96;14.11.2015;2015;11;09;Lauantai;4;27;31;2;2;4
96;14.11.2015;2015;11;10;Lauantai;16;18;34;8;4;12
96;14.11.2015;2015;11;11;Lauantai;15;27;42;9;13;22
96;14.11.2015;2015;11;12;Lauantai;22;43;65;5;13;18
96;14.11.2015;2015;11;13;Lauantai;25;39;64;6;4;10
96;14.11.2015;2015;11;14;Lauantai;30;26;56;2;6;8
96;14.11.2015;2015;11;15;Lauantai;26;27;53;5;4;9
96;14.11.2015;2015;11;16;Lauantai;26;20;46;6;5;11
96;14.11.2015;2015;11;17;Lauantai;22;29;51;9;4;13
96;14.11.2015;2015;11;18;Lauantai;22;13;35;9;6;15
96;14.11.2015;2015;11;19;Lauantai;26;18;44;6;3;9
96;14.11.2015;2015;11;20;Lauantai;17;6;23;4;7;11
96;14.11.2015;2015;11;21;Lauantai;16;34;50;3;5;8
96;14.11.2015;2015;11;22;Lauantai;5;11;16;3;2;5
96;14.11.2015;2015;11;23;Lauantai;10;0;10;1;2;3
96;15.11.2015;2015;11;00;Sunnuntai;8;7;15;2;1;3
96;15.11.2015;2015;11;01;Sunnuntai;3;8;11;1;0;1
96;15.11.2015;2015;11;02;Sunnuntai;9;4;13;0;0;0
96;15.11.2015;2015;11;03;Sunnuntai;7;3;10;0;0;0
96;15.11.2015;2015;11;04;Sunnuntai;6;1;7;3;0;3
96;15.11.2015;2015;11;05;Sunnuntai;3;2;5;1;0;1
96;15.11.2015;2015;11;06;Sunnuntai;12;5;17;2;1;3
96;15.11.2015;2015;11;07;Sunnuntai;1;9;10;1;4;5
96;15.11.2015;2015;11;08;Sunnuntai;2;4;6;1;3;4
96;15.11.2015;2015;11;09;Sunnuntai;5;10;15;4;5;9
96;15.11.2015;2015;11;10;Sunnuntai;9;12;21;11;9;20
96;15.11.2015;2015;11;11;Sunnuntai;13;23;36;11;10;21
96;15.11.2015;2015;11;12;Sunnuntai;22;40;62;9;10;19
96;15.11.2015;2015;11;13;Sunnuntai;24;24;48;12;14;26
96;15.11.2015;2015;11;14;Sunnuntai;37;29;66;13;11;24
96;15.11.2015;2015;11;15;Sunnuntai;29;24;53;13;13;26
96;15.11.2015;2015;11;16;Sunnuntai;31;25;56;16;8;24
96;15.11.2015;2015;11;17;Sunnuntai;37;20;57;11;7;18
96;15.11.2015;2015;11;18;Sunnuntai;37;23;60;7;13;20
96;15.11.2015;2015;11;19;Sunnuntai;9;25;34;11;14;25
96;15.11.2015;2015;11;20;Sunnuntai;19;35;54;8;9;17
96;15.11.2015;2015;11;21;Sunnuntai;25;25;50;7;11;18
96;15.11.2015;2015;11;22;Sunnuntai;8;7;15;0;2;2
96;15.11.2015;2015;11;23;Sunnuntai;4;2;6;2;1;3
96;16.11.2015;2015;11;00;Maanantai;7;2;9;0;2;2
96;16.11.2015;2015;11;01;Maanantai;3;1;4;0;1;1
96;16.11.2015;2015;11;02;Maanantai;0;0;0;0;0;0
96;16.11.2015;2015;11;03;Maanantai;3;2;5;0;0;0
96;16.11.2015;2015;11;04;Maanantai;1;1;2;0;0;0
96;16.11.2015;2015;11;05;Maanantai;2;9;11;0;1;1
96;16.11.2015;2015;11;06;Maanantai;29;29;58;8;1;9
96;16.11.2015;2015;11;07;Maanantai;84;81;165;15;9;24
96;16.11.2015;2015;11;08;Maanantai;123;105;228;8;5;13
96;16.11.2015;2015;11;09;Maanantai;72;72;144;13;3;16
96;16.11.2015;2015;11;10;Maanantai;74;62;136;12;8;20
96;16.11.2015;2015;11;11;Maanantai;47;62;109;11;13;24
96;16.11.2015;2015;11;12;Maanantai;60;81;141;8;10;18
96;16.11.2015;2015;11;13;Maanantai;54;93;147;14;15;29
96;16.11.2015;2015;11;14;Maanantai;76;110;186;5;13;18
96;16.11.2015;2015;11;15;Maanantai;90;160;250;6;24;30
96;16.11.2015;2015;11;16;Maanantai;76;178;254;13;22;35
96;16.11.2015;2015;11;17;Maanantai;55;79;134;19;31;50
96;16.11.2015;2015;11;18;Maanantai;58;64;122;20;23;43
96;16.11.2015;2015;11;19;Maanantai;38;60;98;14;20;34
96;16.11.2015;2015;11;20;Maanantai;35;46;81;12;11;23
96;16.11.2015;2015;11;21;Maanantai;43;36;79;3;3;6
96;16.11.2015;2015;11;22;Maanantai;7;9;16;0;4;4
96;16.11.2015;2015;11;23;Maanantai;3;2;5;0;2;2
96;17.11.2015;2015;11;00;Tiistai;3;0;3;0;0;0
96;17.11.2015;2015;11;01;Tiistai;2;1;3;0;0;0
96;17.11.2015;2015;11;02;Tiistai;1;1;2;0;0;0
96;17.11.2015;2015;11;03;Tiistai;1;0;1;0;0;0
96;17.11.2015;2015;11;04;Tiistai;1;2;3;0;1;1
96;17.11.2015;2015;11;05;Tiistai;2;2;4;0;0;0
96;17.11.2015;2015;11;06;Tiistai;8;14;22;2;0;2
96;17.11.2015;2015;11;07;Tiistai;58;45;103;17;5;22
96;17.11.2015;2015;11;08;Tiistai;154;128;282;14;8;22
96;17.11.2015;2015;11;09;Tiistai;81;76;157;11;4;15
96;17.11.2015;2015;11;10;Tiistai;75;76;151;17;7;24
96;17.11.2015;2015;11;11;Tiistai;50;63;113;15;23;38
96;17.11.2015;2015;11;12;Tiistai;73;117;190;10;19;29
96;17.11.2015;2015;11;13;Tiistai;66;91;157;3;15;18
96;17.11.2015;2015;11;14;Tiistai;52;95;147;7;19;26
96;17.11.2015;2015;11;15;Tiistai;62;148;210;6;18;24
96;17.11.2015;2015;11;16;Tiistai;83;181;264;5;38;43
96;17.11.2015;2015;11;17;Tiistai;78;102;180;14;8;22
96;17.11.2015;2015;11;18;Tiistai;39;46;85;9;8;17
96;17.11.2015;2015;11;19;Tiistai;39;45;84;7;10;17
96;17.11.2015;2015;11;20;Tiistai;36;22;58;7;15;22
96;17.11.2015;2015;11;21;Tiistai;31;30;61;7;8;15
96;17.11.2015;2015;11;22;Tiistai;19;17;36;5;2;7
96;17.11.2015;2015;11;23;Tiistai;8;13;21;1;1;2
96;18.11.2015;2015;11;00;Keskiviikko;3;1;4;0;1;1
96;18.11.2015;2015;11;01;Keskiviikko;4;0;4;1;0;1
96;18.11.2015;2015;11;02;Keskiviikko;2;0;2;0;0;0
96;18.11.2015;2015;11;03;Keskiviikko;0;0;0;0;0;0
96;18.11.2015;2015;11;04;Keskiviikko;0;1;1;0;0;0
96;18.11.2015;2015;11;05;Keskiviikko;7;6;13;0;0;0
96;18.11.2015;2015;11;06;Keskiviikko;40;33;73;11;3;14
96;18.11.2015;2015;11;07;Keskiviikko;88;95;183;11;11;22
96;18.11.2015;2015;11;08;Keskiviikko;106;105;211;15;7;22
96;18.11.2015;2015;11;09;Keskiviikko;106;74;180;20;8;28
96;18.11.2015;2015;11;10;Keskiviikko;65;53;118;14;8;22
96;18.11.2015;2015;11;11;Keskiviikko;57;66;123;8;17;25
96;18.11.2015;2015;11;12;Keskiviikko;72;75;147;13;15;28
96;18.11.2015;2015;11;13;Keskiviikko;54;109;163;6;12;18
96;18.11.2015;2015;11;14;Keskiviikko;75;142;217;14;18;32
96;18.11.2015;2015;11;15;Keskiviikko;60;182;242;7;26;33
96;18.11.2015;2015;11;16;Keskiviikko;71;150;221;13;21;34
96;18.11.2015;2015;11;17;Keskiviikko;77;69;146;12;12;24
96;18.11.2015;2015;11;18;Keskiviikko;56;63;119;21;18;39
96;18.11.2015;2015;11;19;Keskiviikko;57;41;98;11;15;26
96;18.11.2015;2015;11;20;Keskiviikko;40;37;77;11;10;21
96;18.11.2015;2015;11;21;Keskiviikko;24;33;57;5;8;13
96;18.11.2015;2015;11;22;Keskiviikko;9;17;26;1;2;3
96;18.11.2015;2015;11;23;Keskiviikko;7;6;13;1;0;1
96;19.11.2015;2015;11;00;Torstai;3;1;4;0;1;1
96;19.11.2015;2015;11;01;Torstai;1;0;1;0;0;0
96;19.11.2015;2015;11;02;Torstai;4;0;4;0;1;1
96;19.11.2015;2015;11;03;Torstai;1;0;1;0;1;1
96;19.11.2015;2015;11;04;Torstai;5;2;7;0;0;0
96;19.11.2015;2015;11;05;Torstai;6;6;12;0;1;1
96;19.11.2015;2015;11;06;Torstai;40;22;62;13;1;14
96;19.11.2015;2015;11;07;Torstai;81;93;174;15;11;26
96;19.11.2015;2015;11;08;Torstai;119;90;209;8;1;9
96;19.11.2015;2015;11;09;Torstai;76;70;146;15;11;26
96;19.11.2015;2015;11;10;Torstai;66;52;118;10;6;16
96;19.11.2015;2015;11;11;Torstai;56;73;129;7;8;15
96;19.11.2015;2015;11;12;Torstai;72;62;134;9;7;16
96;19.11.2015;2015;11;13;Torstai;48;86;134;8;13;21
96;19.11.2015;2015;11;14;Torstai;71;144;215;3;20;23
96;19.11.2015;2015;11;15;Torstai;70;194;264;7;22;29
96;19.11.2015;2015;11;16;Torstai;86;131;217;13;33;46
96;19.11.2015;2015;11;17;Torstai;58;66;124;8;17;25
96;19.11.2015;2015;11;18;Torstai;64;53;117;10;6;16
96;19.11.2015;2015;11;19;Torstai;43;28;71;4;12;16
96;19.11.2015;2015;11;20;Torstai;39;37;76;5;6;11
96;19.11.2015;2015;11;21;Torstai;30;34;64;7;9;16
96;19.11.2015;2015;11;22;Torstai;9;12;21;1;4;5
96;19.11.2015;2015;11;23;Torstai;6;2;8;0;0;0
96;20.11.2015;2015;11;00;Perjantai;8;3;11;0;0;0
96;20.11.2015;2015;11;01;Perjantai;4;0;4;0;0;0
96;20.11.2015;2015;11;02;Perjantai;0;0;0;0;0;0
96;20.11.2015;2015;11;03;Perjantai;3;0;3;0;0;0
96;20.11.2015;2015;11;04;Perjantai;2;3;5;0;0;0
96;20.11.2015;2015;11;05;Perjantai;3;6;9;0;0;0
96;20.11.2015;2015;11;06;Perjantai;39;18;57;10;3;13
96;20.11.2015;2015;11;07;Perjantai;72;60;132;26;13;39
96;20.11.2015;2015;11;08;Perjantai;99;83;182;11;2;13
96;20.11.2015;2015;11;09;Perjantai;40;61;101;5;12;17
96;20.11.2015;2015;11;10;Perjantai;54;44;98;14;11;25
96;20.11.2015;2015;11;11;Perjantai;47;54;101;11;19;30
96;20.11.2015;2015;11;12;Perjantai;61;72;133;10;7;17
96;20.11.2015;2015;11;13;Perjantai;45;113;158;7;19;26
96;20.11.2015;2015;11;14;Perjantai;56;141;197;10;21;31
96;20.11.2015;2015;11;15;Perjantai;62;138;200;6;35;41
96;20.11.2015;2015;11;16;Perjantai;70;71;141;10;17;27
96;20.11.2015;2015;11;17;Perjantai;32;48;80;7;14;21
96;20.11.2015;2015;11;18;Perjantai;39;41;80;6;3;9
96;20.11.2015;2015;11;19;Perjantai;44;26;70;5;8;13
96;20.11.2015;2015;11;20;Perjantai;23;20;43;8;3;11
96;20.11.2015;2015;11;21;Perjantai;20;31;51;8;4;12
96;20.11.2015;2015;11;22;Perjantai;13;10;23;2;2;4
96;20.11.2015;2015;11;23;Perjantai;6;15;21;2;3;5
96;21.11.2015;2015;11;00;Lauantai;11;6;17;1;2;3
96;21.11.2015;2015;11;01;Lauantai;7;0;7;2;0;2
96;21.11.2015;2015;11;02;Lauantai;5;0;5;0;0;0
96;21.11.2015;2015;11;03;Lauantai;1;0;1;2;0;2
96;21.11.2015;2015;11;04;Lauantai;7;2;9;2;0;2
96;21.11.2015;2015;11;05;Lauantai;4;0;4;2;0;2
96;21.11.2015;2015;11;06;Lauantai;14;3;17;6;0;6
96;21.11.2015;2015;11;07;Lauantai;4;7;11;6;6;12
96;21.11.2015;2015;11;08;Lauantai;6;14;20;1;3;4
96;21.11.2015;2015;11;09;Lauantai;12;23;35;9;3;12
96;21.11.2015;2015;11;10;Lauantai;7;11;18;6;17;23
96;21.11.2015;2015;11;11;Lauantai;17;20;37;5;7;12
96;21.11.2015;2015;11;12;Lauantai;22;31;53;10;6;16
96;21.11.2015;2015;11;13;Lauantai;26;41;67;17;11;28
96;21.11.2015;2015;11;14;Lauantai;33;37;70;7;16;23
96;21.11.2015;2015;11;15;Lauantai;27;32;59;9;12;21
96;21.11.2015;2015;11;16;Lauantai;27;22;49;13;19;32
96;21.11.2015;2015;11;17;Lauantai;33;23;56;7;5;12
96;21.11.2015;2015;11;18;Lauantai;15;15;30;19;10;29
96;21.11.2015;2015;11;19;Lauantai;12;23;35;10;9;19
96;21.11.2015;2015;11;20;Lauantai;18;13;31;7;8;15
96;21.11.2015;2015;11;21;Lauantai;9;27;36;2;5;7
96;21.11.2015;2015;11;22;Lauantai;6;5;11;0;0;0
96;21.11.2015;2015;11;23;Lauantai;4;3;7;0;0;0
96;22.11.2015;2015;11;00;Sunnuntai;2;3;5;0;0;0
96;22.11.2015;2015;11;01;Sunnuntai;5;0;5;0;0;0
96;22.11.2015;2015;11;02;Sunnuntai;6;0;6;1;0;1
96;22.11.2015;2015;11;03;Sunnuntai;5;0;5;2;0;2
96;22.11.2015;2015;11;04;Sunnuntai;11;0;11;3;1;4
96;22.11.2015;2015;11;05;Sunnuntai;1;0;1;0;1;1
96;22.11.2015;2015;11;06;Sunnuntai;14;8;22;4;2;6
96;22.11.2015;2015;11;07;Sunnuntai;4;7;11;1;3;4
96;22.11.2015;2015;11;08;Sunnuntai;1;10;11;0;6;6
96;22.11.2015;2015;11;09;Sunnuntai;3;11;14;8;6;14
96;22.11.2015;2015;11;10;Sunnuntai;10;7;17;7;5;12
96;22.11.2015;2015;11;11;Sunnuntai;10;9;19;15;11;26
96;22.11.2015;2015;11;12;Sunnuntai;18;23;41;12;13;25
96;22.11.2015;2015;11;13;Sunnuntai;23;24;47;31;13;44
96;22.11.2015;2015;11;14;Sunnuntai;31;30;61;14;29;43
96;22.11.2015;2015;11;15;Sunnuntai;25;34;59;19;12;31
96;22.11.2015;2015;11;16;Sunnuntai;36;14;50;27;9;36
96;22.11.2015;2015;11;17;Sunnuntai;43;29;72;17;6;23
96;22.11.2015;2015;11;18;Sunnuntai;28;17;45;20;25;45
96;22.11.2015;2015;11;19;Sunnuntai;16;24;40;10;6;16
96;22.11.2015;2015;11;20;Sunnuntai;14;19;33;6;12;18
96;22.11.2015;2015;11;21;Sunnuntai;17;19;36;1;3;4
96;22.11.2015;2015;11;22;Sunnuntai;3;4;7;0;2;2
96;22.11.2015;2015;11;23;Sunnuntai;8;1;9;1;0;1
96;23.11.2015;2015;11;00;Maanantai;4;0;4;0;0;0
96;23.11.2015;2015;11;01;Maanantai;2;1;3;0;0;0
96;23.11.2015;2015;11;02;Maanantai;0;0;0;0;0;0
96;23.11.2015;2015;11;03;Maanantai;2;0;2;0;0;0
96;23.11.2015;2015;11;04;Maanantai;0;0;0;0;0;0
96;23.11.2015;2015;11;05;Maanantai;2;4;6;2;0;2
96;23.11.2015;2015;11;06;Maanantai;32;18;50;11;2;13
96;23.11.2015;2015;11;07;Maanantai;75;76;151;27;8;35
96;23.11.2015;2015;11;08;Maanantai;109;94;203;14;11;25
96;23.11.2015;2015;11;09;Maanantai;61;45;106;11;9;20
96;23.11.2015;2015;11;10;Maanantai;72;55;127;26;7;33
96;23.11.2015;2015;11;11;Maanantai;48;52;100;10;11;21
96;23.11.2015;2015;11;12;Maanantai;84;57;141;20;10;30
96;23.11.2015;2015;11;13;Maanantai;59;115;174;7;18;25
96;23.11.2015;2015;11;14;Maanantai;60;106;166;11;23;34
96;23.11.2015;2015;11;15;Maanantai;71;164;235;9;33;42
96;23.11.2015;2015;11;16;Maanantai;95;136;231;12;32;44
96;23.11.2015;2015;11;17;Maanantai;58;56;114;13;12;25
96;23.11.2015;2015;11;18;Maanantai;39;49;88;18;18;36
96;23.11.2015;2015;11;19;Maanantai;38;53;91;16;19;35
96;23.11.2015;2015;11;20;Maanantai;35;26;61;5;13;18
96;23.11.2015;2015;11;21;Maanantai;34;21;55;4;11;15
96;23.11.2015;2015;11;22;Maanantai;6;2;8;1;2;3
96;23.11.2015;2015;11;23;Maanantai;6;2;8;1;1;2
96;24.11.2015;2015;11;00;Tiistai;0;2;2;0;1;1
96;24.11.2015;2015;11;01;Tiistai;3;1;4;1;0;1
96;24.11.2015;2015;11;02;Tiistai;1;1;2;0;0;0
96;24.11.2015;2015;11;03;Tiistai;1;0;1;0;0;0
96;24.11.2015;2015;11;04;Tiistai;0;0;0;0;0;0
96;24.11.2015;2015;11;05;Tiistai;3;3;6;1;1;2
96;24.11.2015;2015;11;06;Tiistai;31;23;54;13;1;14
96;24.11.2015;2015;11;07;Tiistai;79;81;160;23;13;36
96;24.11.2015;2015;11;08;Tiistai;127;105;232;23;8;31
96;24.11.2015;2015;11;09;Tiistai;57;54;111;16;9;25
96;24.11.2015;2015;11;10;Tiistai;48;47;95;14;17;31
96;24.11.2015;2015;11;11;Tiistai;71;52;123;16;13;29
96;24.11.2015;2015;11;12;Tiistai;63;63;126;15;18;33
96;24.11.2015;2015;11;13;Tiistai;49;81;130;3;15;18
96;24.11.2015;2015;11;14;Tiistai;51;123;174;3;24;27
96;24.11.2015;2015;11;15;Tiistai;62;163;225;18;37;55
96;24.11.2015;2015;11;16;Tiistai;89;134;223;17;34;51
96;24.11.2015;2015;11;17;Tiistai;52;44;96;13;13;26
96;24.11.2015;2015;11;18;Tiistai;49;60;109;15;16;31
96;24.11.2015;2015;11;19;Tiistai;48;30;78;8;14;22
96;24.11.2015;2015;11;20;Tiistai;44;21;65;4;7;11
96;24.11.2015;2015;11;21;Tiistai;22;22;44;5;9;14
96;24.11.2015;2015;11;22;Tiistai;12;10;22;1;0;1
96;24.11.2015;2015;11;23;Tiistai;7;3;10;0;1;1
96;25.11.2015;2015;11;00;Keskiviikko;2;0;2;0;0;0
96;25.11.2015;2015;11;01;Keskiviikko;1;0;1;0;0;0
96;25.11.2015;2015;11;02;Keskiviikko;2;0;2;0;0;0
96;25.11.2015;2015;11;03;Keskiviikko;0;0;0;0;0;0
96;25.11.2015;2015;11;04;Keskiviikko;2;0;2;0;0;0
96;25.11.2015;2015;11;05;Keskiviikko;5;3;8;1;1;2
96;25.11.2015;2015;11;06;Keskiviikko;40;23;63;4;5;9
96;25.11.2015;2015;11;07;Keskiviikko;65;67;132;7;7;14
96;25.11.2015;2015;11;08;Keskiviikko;127;103;230;13;7;20
96;25.11.2015;2015;11;09;Keskiviikko;46;40;86;17;10;27
96;25.11.2015;2015;11;10;Keskiviikko;32;43;75;12;16;28
96;25.11.2015;2015;11;11;Keskiviikko;52;55;107;13;12;25
96;25.11.2015;2015;11;12;Keskiviikko;57;64;121;7;7;14
96;25.11.2015;2015;11;13;Keskiviikko;36;74;110;7;9;16
96;25.11.2015;2015;11;14;Keskiviikko;39;119;158;5;15;20
96;25.11.2015;2015;11;15;Keskiviikko;57;121;178;8;26;34
96;25.11.2015;2015;11;16;Keskiviikko;68;100;168;7;25;32
96;25.11.2015;2015;11;17;Keskiviikko;51;65;116;6;7;13
96;25.11.2015;2015;11;18;Keskiviikko;42;38;80;14;13;27
96;25.11.2015;2015;11;19;Keskiviikko;49;23;72;10;8;18
96;25.11.2015;2015;11;20;Keskiviikko;30;35;65;3;12;15
96;25.11.2015;2015;11;21;Keskiviikko;14;23;37;1;5;6
96;25.11.2015;2015;11;22;Keskiviikko;5;15;20;2;2;4
96;25.11.2015;2015;11;23;Keskiviikko;4;3;7;0;0;0
96;26.11.2015;2015;11;00;Torstai;6;0;6;0;1;1
96;26.11.2015;2015;11;01;Torstai;6;1;7;0;0;0
96;26.11.2015;2015;11;02;Torstai;1;2;3;0;0;0
96;26.11.2015;2015;11;03;Torstai;4;0;4;0;0;0
96;26.11.2015;2015;11;04;Torstai;2;1;3;0;0;0
96;26.11.2015;2015;11;05;Torstai;3;5;8;0;0;0
96;26.11.2015;2015;11;06;Torstai;41;28;69;8;3;11
96;26.11.2015;2015;11;07;Torstai;83;77;160;17;6;23
96;26.11.2015;2015;11;08;Torstai;99;100;199;17;6;23
96;26.11.2015;2015;11;09;Torstai;53;61;114;5;5;10
96;26.11.2015;2015;11;10;Torstai;65;48;113;13;9;22
96;26.11.2015;2015;11;11;Torstai;51;48;99;10;12;22
96;26.11.2015;2015;11;12;Torstai;50;63;113;17;9;26
96;26.11.2015;2015;11;13;Torstai;46;104;150;8;18;26
96;26.11.2015;2015;11;14;Torstai;77;125;202;7;24;31
96;26.11.2015;2015;11;15;Torstai;70;159;229;6;34;40
96;26.11.2015;2015;11;16;Torstai;77;104;181;6;25;31
96;26.11.2015;2015;11;17;Torstai;53;49;102;6;11;17
96;26.11.2015;2015;11;18;Torstai;50;45;95;8;9;17
96;26.11.2015;2015;11;19;Torstai;45;29;74;7;12;19
96;26.11.2015;2015;11;20;Torstai;38;29;67;6;8;14
96;26.11.2015;2015;11;21;Torstai;29;21;50;4;6;10
96;26.11.2015;2015;11;22;Torstai;4;8;12;0;1;1
96;26.11.2015;2015;11;23;Torstai;1;2;3;1;1;2
96;27.11.2015;2015;11;00;Perjantai;4;0;4;1;0;1
96;27.11.2015;2015;11;01;Perjantai;2;2;4;0;0;0
96;27.11.2015;2015;11;02;Perjantai;2;0;2;0;0;0
96;27.11.2015;2015;11;03;Perjantai;1;1;2;0;0;0
96;27.11.2015;2015;11;04;Perjantai;1;3;4;0;0;0
96;27.11.2015;2015;11;05;Perjantai;1;2;3;0;0;0
96;27.11.2015;2015;11;06;Perjantai;43;17;60;6;4;10
96;27.11.2015;2015;11;07;Perjantai;68;51;119;15;6;21
96;27.11.2015;2015;11;08;Perjantai;90;91;181;17;2;19
96;27.11.2015;2015;11;09;Perjantai;37;42;79;6;5;11
96;27.11.2015;2015;11;10;Perjantai;51;45;96;5;7;12
96;27.11.2015;2015;11;11;Perjantai;45;86;131;5;13;18
96;27.11.2015;2015;11;12;Perjantai;70;72;142;12;21;33
96;27.11.2015;2015;11;13;Perjantai;73;80;153;8;15;23
96;27.11.2015;2015;11;14;Perjantai;48;123;171;10;22;32
96;27.11.2015;2015;11;15;Perjantai;63;113;176;9;26;35
96;27.11.2015;2015;11;16;Perjantai;58;81;139;6;15;21
96;27.11.2015;2015;11;17;Perjantai;41;40;81;7;9;16
96;27.11.2015;2015;11;18;Perjantai;44;29;73;10;5;15
96;27.11.2015;2015;11;19;Perjantai;28;29;57;9;5;14
96;27.11.2015;2015;11;20;Perjantai;36;16;52;5;4;9
96;27.11.2015;2015;11;21;Perjantai;18;27;45;8;6;14
96;27.11.2015;2015;11;22;Perjantai;10;17;27;0;2;2
96;27.11.2015;2015;11;23;Perjantai;10;5;15;0;1;1
96;28.11.2015;2015;11;00;Lauantai;3;3;6;3;0;3
96;28.11.2015;2015;11;01;Lauantai;3;4;7;1;0;1
96;28.11.2015;2015;11;02;Lauantai;7;1;8;0;2;2
96;28.11.2015;2015;11;03;Lauantai;3;1;4;2;0;2
96;28.11.2015;2015;11;04;Lauantai;5;1;6;1;2;3
96;28.11.2015;2015;11;05;Lauantai;1;4;5;1;1;2
96;28.11.2015;2015;11;06;Lauantai;16;5;21;0;0;0
96;28.11.2015;2015;11;07;Lauantai;3;20;23;2;2;4
96;28.11.2015;2015;11;08;Lauantai;12;15;27;3;3;6
96;28.11.2015;2015;11;09;Lauantai;17;23;40;10;6;16
96;28.11.2015;2015;11;10;Lauantai;19;27;46;8;5;13
96;28.11.2015;2015;11;11;Lauantai;23;14;37;5;4;9
96;28.11.2015;2015;11;12;Lauantai;29;22;51;4;7;11
96;28.11.2015;2015;11;13;Lauantai;25;34;59;3;5;8
96;28.11.2015;2015;11;14;Lauantai;20;31;51;7;8;15
96;28.11.2015;2015;11;15;Lauantai;24;40;64;14;11;25
96;28.11.2015;2015;11;16;Lauantai;19;28;47;10;4;14
96;28.11.2015;2015;11;17;Lauantai;23;23;46;9;5;14
96;28.11.2015;2015;11;18;Lauantai;20;16;36;7;1;8
96;28.11.2015;2015;11;19;Lauantai;34;20;54;6;7;13
96;28.11.2015;2015;11;20;Lauantai;20;13;33;4;2;6
96;28.11.2015;2015;11;21;Lauantai;13;23;36;1;5;6
96;28.11.2015;2015;11;22;Lauantai;5;7;12;1;2;3
96;28.11.2015;2015;11;23;Lauantai;10;4;14;0;2;2
96;29.11.2015;2015;11;00;Sunnuntai;4;4;8;1;0;1
96;29.11.2015;2015;11;01;Sunnuntai;4;0;4;1;0;1
96;29.11.2015;2015;11;02;Sunnuntai;4;1;5;1;0;1
96;29.11.2015;2015;11;03;Sunnuntai;3;2;5;4;0;4
96;29.11.2015;2015;11;04;Sunnuntai;4;0;4;8;0;8
96;29.11.2015;2015;11;05;Sunnuntai;6;1;7;2;0;2
96;29.11.2015;2015;11;06;Sunnuntai;16;7;23;2;2;4
96;29.11.2015;2015;11;07;Sunnuntai;3;12;15;2;4;6
96;29.11.2015;2015;11;08;Sunnuntai;2;8;10;1;2;3
96;29.11.2015;2015;11;09;Sunnuntai;11;9;20;5;3;8
96;29.11.2015;2015;11;10;Sunnuntai;11;10;21;8;9;17
96;29.11.2015;2015;11;11;Sunnuntai;23;26;49;10;12;22
96;29.11.2015;2015;11;12;Sunnuntai;25;36;61;13;13;26
96;29.11.2015;2015;11;13;Sunnuntai;39;44;83;14;19;33
96;29.11.2015;2015;11;14;Sunnuntai;24;51;75;10;19;29
96;29.11.2015;2015;11;15;Sunnuntai;40;37;77;16;19;35
96;29.11.2015;2015;11;16;Sunnuntai;30;28;58;24;11;35
96;29.11.2015;2015;11;17;Sunnuntai;38;13;51;9;7;16
96;29.11.2015;2015;11;18;Sunnuntai;25;18;43;10;24;34
96;29.11.2015;2015;11;19;Sunnuntai;24;29;53;9;12;21
96;29.11.2015;2015;11;20;Sunnuntai;25;22;47;12;8;20
96;29.11.2015;2015;11;21;Sunnuntai;16;14;30;6;3;9
96;29.11.2015;2015;11;22;Sunnuntai;4;8;12;0;3;3
96;29.11.2015;2015;11;23;Sunnuntai;7;2;9;1;0;1
96;30.11.2015;2015;11;00;Maanantai;5;4;9;1;1;2
96;30.11.2015;2015;11;01;Maanantai;1;0;1;0;0;0
96;30.11.2015;2015;11;02;Maanantai;0;0;0;0;0;0
96;30.11.2015;2015;11;03;Maanantai;1;0;1;0;0;0
96;30.11.2015;2015;11;04;Maanantai;1;1;2;0;0;0
96;30.11.2015;2015;11;05;Maanantai;3;5;8;0;0;0
96;30.11.2015;2015;11;06;Maanantai;30;27;57;7;3;10
96;30.11.2015;2015;11;07;Maanantai;68;70;138;22;14;36
96;30.11.2015;2015;11;08;Maanantai;112;85;197;16;5;21
96;30.11.2015;2015;11;09;Maanantai;48;60;108;12;26;38
96;30.11.2015;2015;11;10;Maanantai;65;71;136;23;17;40
96;30.11.2015;2015;11;11;Maanantai;52;71;123;10;12;22
96;30.11.2015;2015;11;12;Maanantai;49;74;123;10;15;25
96;30.11.2015;2015;11;13;Maanantai;61;95;156;10;20;30
96;30.11.2015;2015;11;14;Maanantai;66;115;181;5;16;21
96;30.11.2015;2015;11;15;Maanantai;69;146;215;4;28;32
96;30.11.2015;2015;11;16;Maanantai;61;90;151;11;30;41
96;30.11.2015;2015;11;17;Maanantai;60;54;114;10;7;17
96;30.11.2015;2015;11;18;Maanantai;47;38;85;15;18;33
96;30.11.2015;2015;11;19;Maanantai;41;40;81;12;13;25
96;30.11.2015;2015;11;20;Maanantai;41;25;66;4;3;7
96;30.11.2015;2015;11;21;Maanantai;26;33;59;2;10;12
96;30.11.2015;2015;11;22;Maanantai;15;10;25;1;1;2
96;30.11.2015;2015;11;23;Maanantai;5;2;7;2;1;3
96;01.12.2015;2015;12;00;Tiistai;1;2;3;0;0;0
96;01.12.2015;2015;12;01;Tiistai;2;0;2;0;0;0
96;01.12.2015;2015;12;02;Tiistai;0;0;0;0;0;0
96;01.12.2015;2015;12;03;Tiistai;2;1;3;0;0;0
96;01.12.2015;2015;12;04;Tiistai;1;3;4;0;0;0
96;01.12.2015;2015;12;05;Tiistai;3;5;8;0;1;1
96;01.12.2015;2015;12;06;Tiistai;27;21;48;8;4;12
96;01.12.2015;2015;12;07;Tiistai;81;83;164;15;7;22
96;01.12.2015;2015;12;08;Tiistai;105;90;195;16;4;20
96;01.12.2015;2015;12;09;Tiistai;74;67;141;15;5;20
96;01.12.2015;2015;12;10;Tiistai;57;52;109;8;4;12
96;01.12.2015;2015;12;11;Tiistai;64;51;115;11;15;26
96;01.12.2015;2015;12;12;Tiistai;53;63;116;14;25;39
96;01.12.2015;2015;12;13;Tiistai;51;68;119;9;13;22
96;01.12.2015;2015;12;14;Tiistai;53;92;145;7;16;23
96;01.12.2015;2015;12;15;Tiistai;53;162;215;7;32;39
96;01.12.2015;2015;12;16;Tiistai;94;143;237;9;31;40
96;01.12.2015;2015;12;17;Tiistai;48;63;111;4;10;14
96;01.12.2015;2015;12;18;Tiistai;49;53;102;23;8;31
96;01.12.2015;2015;12;19;Tiistai;39;25;64;20;19;39
96;01.12.2015;2015;12;20;Tiistai;43;24;67;6;6;12
96;01.12.2015;2015;12;21;Tiistai;37;31;68;1;11;12
96;01.12.2015;2015;12;22;Tiistai;5;10;15;1;0;1
96;01.12.2015;2015;12;23;Tiistai;2;2;4;1;3;4
96;02.12.2015;2015;12;00;Keskiviikko;1;0;1;1;0;1
96;02.12.2015;2015;12;01;Keskiviikko;0;3;3;0;0;0
96;02.12.2015;2015;12;02;Keskiviikko;2;0;2;0;0;0
96;02.12.2015;2015;12;03;Keskiviikko;1;0;1;0;0;0
96;02.12.2015;2015;12;04;Keskiviikko;2;2;4;0;0;0
96;02.12.2015;2015;12;05;Keskiviikko;5;8;13;0;1;1
96;02.12.2015;2015;12;06;Keskiviikko;36;19;55;7;1;8
96;02.12.2015;2015;12;07;Keskiviikko;81;73;154;24;8;32
96;02.12.2015;2015;12;08;Keskiviikko;110;97;207;20;29;49
96;02.12.2015;2015;12;09;Keskiviikko;64;66;130;17;14;31
96;02.12.2015;2015;12;10;Keskiviikko;44;53;97;22;18;40
96;02.12.2015;2015;12;11;Keskiviikko;64;59;123;17;16;33
96;02.12.2015;2015;12;12;Keskiviikko;52;59;111;10;23;33
96;02.12.2015;2015;12;13;Keskiviikko;47;70;117;11;14;25
96;02.12.2015;2015;12;14;Keskiviikko;66;111;177;7;17;24
96;02.12.2015;2015;12;15;Keskiviikko;69;152;221;5;29;34
96;02.12.2015;2015;12;16;Keskiviikko;88;155;243;6;35;41
96;02.12.2015;2015;12;17;Keskiviikko;61;64;125;6;14;20
96;02.12.2015;2015;12;18;Keskiviikko;68;40;108;16;13;29
96;02.12.2015;2015;12;19;Keskiviikko;34;30;64;10;14;24
96;02.12.2015;2015;12;20;Keskiviikko;47;35;82;6;7;13
96;02.12.2015;2015;12;21;Keskiviikko;33;24;57;3;8;11
96;02.12.2015;2015;12;22;Keskiviikko;14;9;23;0;2;2
96;02.12.2015;2015;12;23;Keskiviikko;7;0;7;2;1;3
96;03.12.2015;2015;12;00;Torstai;2;1;3;0;0;0
96;03.12.2015;2015;12;01;Torstai;1;3;4;0;0;0
96;03.12.2015;2015;12;02;Torstai;0;1;1;0;0;0
96;03.12.2015;2015;12;03;Torstai;2;0;2;0;0;0
96;03.12.2015;2015;12;04;Torstai;3;0;3;0;0;0
96;03.12.2015;2015;12;05;Torstai;3;3;6;0;0;0
96;03.12.2015;2015;12;06;Torstai;28;24;52;2;1;3
96;03.12.2015;2015;12;07;Torstai;64;83;147;5;0;5
96;03.12.2015;2015;12;08;Torstai;114;118;232;3;5;8
96;03.12.2015;2015;12;09;Torstai;70;47;117;7;7;14
96;03.12.2015;2015;12;10;Torstai;38;34;72;8;3;11
96;03.12.2015;2015;12;11;Torstai;46;47;93;6;10;16
96;03.12.2015;2015;12;12;Torstai;55;63;118;11;7;18
96;03.12.2015;2015;12;13;Torstai;53;65;118;10;6;16
96;03.12.2015;2015;12;14;Torstai;73;114;187;6;12;18
96;03.12.2015;2015;12;15;Torstai;60;138;198;11;24;35
96;03.12.2015;2015;12;16;Torstai;79;135;214;20;26;46
96;03.12.2015;2015;12;17;Torstai;58;54;112;13;12;25
96;03.12.2015;2015;12;18;Torstai;51;48;99;11;10;21
96;03.12.2015;2015;12;19;Torstai;31;21;52;10;14;24
96;03.12.2015;2015;12;20;Torstai;37;28;65;9;2;11
96;03.12.2015;2015;12;21;Torstai;34;32;66;12;8;20
96;03.12.2015;2015;12;22;Torstai;10;12;22;4;3;7
96;03.12.2015;2015;12;23;Torstai;4;6;10;0;3;3
96;04.12.2015;2015;12;00;Perjantai;6;4;10;1;0;1
96;04.12.2015;2015;12;01;Perjantai;9;0;9;1;1;2
96;04.12.2015;2015;12;02;Perjantai;6;0;6;0;0;0
96;04.12.2015;2015;12;03;Perjantai;3;0;3;0;0;0
96;04.12.2015;2015;12;04;Perjantai;3;1;4;1;0;1
96;04.12.2015;2015;12;05;Perjantai;6;7;13;2;0;2
96;04.12.2015;2015;12;06;Perjantai;27;27;54;11;4;15
96;04.12.2015;2015;12;07;Perjantai;62;71;133;23;11;34
96;04.12.2015;2015;12;08;Perjantai;92;85;177;12;5;17
96;04.12.2015;2015;12;09;Perjantai;54;59;113;7;17;24
96;04.12.2015;2015;12;10;Perjantai;45;45;90;21;20;41
96;04.12.2015;2015;12;11;Perjantai;34;70;104;7;12;19
96;04.12.2015;2015;12;12;Perjantai;42;89;131;6;13;19
96;04.12.2015;2015;12;13;Perjantai;50;86;136;8;20;28
96;04.12.2015;2015;12;14;Perjantai;61;106;167;10;30;40
96;04.12.2015;2015;12;15;Perjantai;51;121;172;7;30;37
96;04.12.2015;2015;12;16;Perjantai;66;51;117;10;16;26
96;04.12.2015;2015;12;17;Perjantai;27;31;58;8;10;18
96;04.12.2015;2015;12;18;Perjantai;20;21;41;9;8;17
96;04.12.2015;2015;12;19;Perjantai;26;23;49;11;9;20
96;04.12.2015;2015;12;20;Perjantai;13;15;28;5;4;9
96;04.12.2015;2015;12;21;Perjantai;11;15;26;2;4;6
96;04.12.2015;2015;12;22;Perjantai;7;11;18;2;1;3
96;04.12.2015;2015;12;23;Perjantai;6;4;10;7;3;10
96;05.12.2015;2015;12;00;Lauantai;6;2;8;2;1;3
96;05.12.2015;2015;12;01;Lauantai;4;3;7;1;0;1
96;05.12.2015;2015;12;02;Lauantai;10;2;12;3;0;3
96;05.12.2015;2015;12;03;Lauantai;4;0;4;5;0;5
96;05.12.2015;2015;12;04;Lauantai;10;2;12;3;0;3
96;05.12.2015;2015;12;05;Lauantai;5;3;8;2;3;5
96;05.12.2015;2015;12;06;Lauantai;11;5;16;5;0;5
96;05.12.2015;2015;12;07;Lauantai;3;15;18;2;3;5
96;05.12.2015;2015;12;08;Lauantai;9;13;22;3;2;5
96;05.12.2015;2015;12;09;Lauantai;6;16;22;5;8;13
96;05.12.2015;2015;12;10;Lauantai;8;24;32;4;7;11
96;05.12.2015;2015;12;11;Lauantai;15;18;33;8;13;21
96;05.12.2015;2015;12;12;Lauantai;22;33;55;13;14;27
96;05.12.2015;2015;12;13;Lauantai;17;29;46;10;9;19
96;05.12.2015;2015;12;14;Lauantai;14;32;46;13;7;20
96;05.12.2015;2015;12;15;Lauantai;28;27;55;12;20;32
96;05.12.2015;2015;12;16;Lauantai;20;28;48;7;16;23
96;05.12.2015;2015;12;17;Lauantai;18;21;39;2;4;6
96;05.12.2015;2015;12;18;Lauantai;22;11;33;6;4;10
96;05.12.2015;2015;12;19;Lauantai;24;6;30;8;3;11
96;05.12.2015;2015;12;20;Lauantai;13;10;23;4;2;6
96;05.12.2015;2015;12;21;Lauantai;10;11;21;1;4;5
96;05.12.2015;2015;12;22;Lauantai;6;9;15;0;0;0
96;05.12.2015;2015;12;23;Lauantai;6;3;9;1;0;1
96;06.12.2015;2015;12;00;Sunnuntai;2;2;4;2;0;2
96;06.12.2015;2015;12;01;Sunnuntai;6;1;7;6;0;6
96;06.12.2015;2015;12;02;Sunnuntai;3;1;4;4;0;4
96;06.12.2015;2015;12;03;Sunnuntai;9;3;12;10;0;10
96;06.12.2015;2015;12;04;Sunnuntai;7;2;9;4;1;5
96;06.12.2015;2015;12;05;Sunnuntai;1;0;1;1;0;1
96;06.12.2015;2015;12;06;Sunnuntai;5;2;7;3;0;3
96;06.12.2015;2015;12;07;Sunnuntai;1;10;11;2;1;3
96;06.12.2015;2015;12;08;Sunnuntai;1;4;5;2;1;3
96;06.12.2015;2015;12;09;Sunnuntai;1;5;6;6;5;11
96;06.12.2015;2015;12;10;Sunnuntai;7;8;15;5;12;17
96;06.12.2015;2015;12;11;Sunnuntai;21;7;28;18;14;32
96;06.12.2015;2015;12;12;Sunnuntai;10;15;25;5;11;16
96;06.12.2015;2015;12;13;Sunnuntai;17;16;33;12;6;18
96;06.12.2015;2015;12;14;Sunnuntai;20;4;24;13;13;26
96;06.12.2015;2015;12;15;Sunnuntai;10;10;20;12;11;23
96;06.12.2015;2015;12;16;Sunnuntai;13;8;21;8;5;13
96;06.12.2015;2015;12;17;Sunnuntai;8;12;20;4;11;15
96;06.12.2015;2015;12;18;Sunnuntai;15;4;19;7;5;12
96;06.12.2015;2015;12;19;Sunnuntai;10;4;14;2;3;5
96;06.12.2015;2015;12;20;Sunnuntai;12;4;16;7;2;9
96;06.12.2015;2015;12;21;Sunnuntai;8;9;17;5;3;8
96;06.12.2015;2015;12;22;Sunnuntai;3;4;7;1;1;2
96;06.12.2015;2015;12;23;Sunnuntai;4;2;6;0;0;0
96;07.12.2015;2015;12;00;Maanantai;6;1;7;0;0;0
96;07.12.2015;2015;12;01;Maanantai;0;0;0;0;0;0
96;07.12.2015;2015;12;02;Maanantai;0;0;0;0;0;0
96;07.12.2015;2015;12;03;Maanantai;0;0;0;0;0;0
96;07.12.2015;2015;12;04;Maanantai;2;0;2;0;0;0
96;07.12.2015;2015;12;05;Maanantai;3;1;4;1;2;3
96;07.12.2015;2015;12;06;Maanantai;27;17;44;13;4;17
96;07.12.2015;2015;12;07;Maanantai;73;51;124;34;11;45
96;07.12.2015;2015;12;08;Maanantai;101;72;173;12;6;18
96;07.12.2015;2015;12;09;Maanantai;43;40;83;16;2;18
96;07.12.2015;2015;12;10;Maanantai;51;45;96;24;13;37
96;07.12.2015;2015;12;11;Maanantai;41;58;99;10;22;32
96;07.12.2015;2015;12;12;Maanantai;48;29;77;21;15;36
96;07.12.2015;2015;12;13;Maanantai;49;59;108;17;18;35
96;07.12.2015;2015;12;14;Maanantai;56;64;120;13;19;32
96;07.12.2015;2015;12;15;Maanantai;47;121;168;12;44;56
96;07.12.2015;2015;12;16;Maanantai;80;117;197;10;35;45
96;07.12.2015;2015;12;17;Maanantai;60;44;104;16;11;27
96;07.12.2015;2015;12;18;Maanantai;62;36;98;13;11;24
96;07.12.2015;2015;12;19;Maanantai;29;31;60;11;13;24
96;07.12.2015;2015;12;20;Maanantai;31;32;63;7;8;15
96;07.12.2015;2015;12;21;Maanantai;31;24;55;6;11;17
96;07.12.2015;2015;12;22;Maanantai;10;3;13;4;0;4
96;07.12.2015;2015;12;23;Maanantai;3;3;6;1;1;2
96;08.12.2015;2015;12;00;Tiistai;1;1;2;0;0;0
96;08.12.2015;2015;12;01;Tiistai;2;0;2;0;0;0
96;08.12.2015;2015;12;02;Tiistai;0;0;0;0;0;0
96;08.12.2015;2015;12;03;Tiistai;0;0;0;0;0;0
96;08.12.2015;2015;12;04;Tiistai;1;0;1;0;0;0
96;08.12.2015;2015;12;05;Tiistai;7;2;9;1;1;2
96;08.12.2015;2015;12;06;Tiistai;30;13;43;10;3;13
96;08.12.2015;2015;12;07;Tiistai;77;61;138;33;8;41
96;08.12.2015;2015;12;08;Tiistai;118;83;201;12;4;16
96;08.12.2015;2015;12;09;Tiistai;72;43;115;15;9;24
96;08.12.2015;2015;12;10;Tiistai;41;37;78;13;18;31
96;08.12.2015;2015;12;11;Tiistai;52;42;94;13;11;24
96;08.12.2015;2015;12;12;Tiistai;47;38;85;13;21;34
96;08.12.2015;2015;12;13;Tiistai;54;49;103;16;11;27
96;08.12.2015;2015;12;14;Tiistai;50;73;123;14;21;35
96;08.12.2015;2015;12;15;Tiistai;63;145;208;7;38;45
96;08.12.2015;2015;12;16;Tiistai;68;109;177;19;48;67
96;08.12.2015;2015;12;17;Tiistai;51;55;106;15;20;35
96;08.12.2015;2015;12;18;Tiistai;32;36;68;10;25;35
96;08.12.2015;2015;12;19;Tiistai;33;17;50;23;16;39
96;08.12.2015;2015;12;20;Tiistai;34;14;48;13;6;19
96;08.12.2015;2015;12;21;Tiistai;29;19;48;7;10;17
96;08.12.2015;2015;12;22;Tiistai;7;2;9;3;1;4
96;08.12.2015;2015;12;23;Tiistai;6;2;8;1;2;3
96;09.12.2015;2015;12;00;Keskiviikko;6;1;7;0;0;0
96;09.12.2015;2015;12;01;Keskiviikko;0;1;1;0;0;0
96;09.12.2015;2015;12;02;Keskiviikko;0;0;0;0;0;0
96;09.12.2015;2015;12;03;Keskiviikko;1;0;1;0;0;0
96;09.12.2015;2015;12;04;Keskiviikko;4;0;4;0;1;1
96;09.12.2015;2015;12;05;Keskiviikko;2;3;5;3;3;6
96;09.12.2015;2015;12;06;Keskiviikko;34;11;45;12;3;15
96;09.12.2015;2015;12;07;Keskiviikko;76;75;151;19;12;31
96;09.12.2015;2015;12;08;Keskiviikko;111;78;189;13;11;24
96;09.12.2015;2015;12;09;Keskiviikko;68;56;124;16;7;23
96;09.12.2015;2015;12;10;Keskiviikko;37;36;73;6;12;18
96;09.12.2015;2015;12;11;Keskiviikko;47;38;85;18;10;28
96;09.12.2015;2015;12;12;Keskiviikko;43;32;75;11;9;20
96;09.12.2015;2015;12;13;Keskiviikko;37;52;89;9;11;20
96;09.12.2015;2015;12;14;Keskiviikko;47;79;126;6;20;26
96;09.12.2015;2015;12;15;Keskiviikko;63;105;168;10;36;46
96;09.12.2015;2015;12;16;Keskiviikko;66;106;172;17;26;43
96;09.12.2015;2015;12;17;Keskiviikko;34;29;63;7;9;16
96;09.12.2015;2015;12;18;Keskiviikko;29;36;65;14;11;25
96;09.12.2015;2015;12;19;Keskiviikko;26;18;44;13;7;20
96;09.12.2015;2015;12;20;Keskiviikko;28;30;58;10;7;17
96;09.12.2015;2015;12;21;Keskiviikko;32;16;48;10;9;19
96;09.12.2015;2015;12;22;Keskiviikko;12;11;23;3;1;4
96;09.12.2015;2015;12;23;Keskiviikko;4;4;8;1;1;2
96;10.12.2015;2015;12;00;Torstai;2;1;3;0;0;0
96;10.12.2015;2015;12;01;Torstai;3;0;3;1;0;1
96;10.12.2015;2015;12;02;Torstai;2;0;2;1;0;1
96;10.12.2015;2015;12;03;Torstai;9;0;9;4;1;5
96;10.12.2015;2015;12;04;Torstai;2;1;3;1;0;1
96;10.12.2015;2015;12;05;Torstai;9;7;16;0;2;2
96;10.12.2015;2015;12;06;Torstai;33;14;47;16;5;21
96;10.12.2015;2015;12;07;Torstai;66;51;117;35;15;50
96;10.12.2015;2015;12;08;Torstai;102;51;153;21;7;28
96;10.12.2015;2015;12;09;Torstai;83;38;121;10;11;21
96;10.12.2015;2015;12;10;Torstai;51;37;88;16;10;26
96;10.12.2015;2015;12;11;Torstai;57;53;110;35;30;65
96;10.12.2015;2015;12;12;Torstai;34;35;69;28;23;51
96;10.12.2015;2015;12;13;Torstai;39;48;87;10;18;28
96;10.12.2015;2015;12;14;Torstai;41;76;117;9;27;36
96;10.12.2015;2015;12;15;Torstai;36;96;132;15;49;64
96;10.12.2015;2015;12;16;Torstai;62;92;154;13;34;47
96;10.12.2015;2015;12;17;Torstai;39;43;82;14;15;29
96;10.12.2015;2015;12;18;Torstai;35;28;63;12;18;30
96;10.12.2015;2015;12;19;Torstai;37;21;58;15;12;27
96;10.12.2015;2015;12;20;Torstai;28;18;46;7;4;11
96;10.12.2015;2015;12;21;Torstai;13;12;25;5;10;15
96;10.12.2015;2015;12;22;Torstai;11;13;24;0;2;2
96;10.12.2015;2015;12;23;Torstai;5;3;8;2;0;2
96;11.12.2015;2015;12;00;Perjantai;3;6;9;0;0;0
96;11.12.2015;2015;12;01;Perjantai;4;0;4;1;0;1
96;11.12.2015;2015;12;02;Perjantai;3;0;3;1;0;1
96;11.12.2015;2015;12;03;Perjantai;4;0;4;0;0;0
96;11.12.2015;2015;12;04;Perjantai;5;0;5;2;0;2
96;11.12.2015;2015;12;05;Perjantai;2;0;2;3;3;6
96;11.12.2015;2015;12;06;Perjantai;14;11;25;5;3;8
96;11.12.2015;2015;12;07;Perjantai;54;42;96;23;12;35
96;11.12.2015;2015;12;08;Perjantai;94;60;154;22;7;29
96;11.12.2015;2015;12;09;Perjantai;54;53;107;12;11;23
96;11.12.2015;2015;12;10;Perjantai;40;39;79;9;8;17
96;11.12.2015;2015;12;11;Perjantai;36;54;90;11;14;25
96;11.12.2015;2015;12;12;Perjantai;32;56;88;17;21;38
96;11.12.2015;2015;12;13;Perjantai;58;88;146;14;14;28
96;11.12.2015;2015;12;14;Perjantai;60;103;163;14;24;38
96;11.12.2015;2015;12;15;Perjantai;37;95;132;11;31;42
96;11.12.2015;2015;12;16;Perjantai;32;44;76;6;18;24
96;11.12.2015;2015;12;17;Perjantai;33;30;63;14;15;29
96;11.12.2015;2015;12;18;Perjantai;23;18;41;10;8;18
96;11.12.2015;2015;12;19;Perjantai;26;19;45;8;5;13
96;11.12.2015;2015;12;20;Perjantai;30;15;45;6;5;11
96;11.12.2015;2015;12;21;Perjantai;14;18;32;2;11;13
96;11.12.2015;2015;12;22;Perjantai;9;13;22;2;1;3
96;11.12.2015;2015;12;23;Perjantai;7;12;19;1;0;1
96;12.12.2015;2015;12;00;Lauantai;6;7;13;0;3;3
96;12.12.2015;2015;12;01;Lauantai;8;0;8;1;1;2
96;12.12.2015;2015;12;02;Lauantai;5;4;9;3;1;4
96;12.12.2015;2015;12;03;Lauantai;2;3;5;1;0;1
96;12.12.2015;2015;12;04;Lauantai;1;1;2;4;0;4
96;12.12.2015;2015;12;05;Lauantai;6;1;7;0;1;1
96;12.12.2015;2015;12;06;Lauantai;13;4;17;7;0;7
96;12.12.2015;2015;12;07;Lauantai;3;15;18;2;3;5
96;12.12.2015;2015;12;08;Lauantai;4;14;18;0;4;4
96;12.12.2015;2015;12;09;Lauantai;6;14;20;6;12;18
96;12.12.2015;2015;12;10;Lauantai;13;18;31;9;10;19
96;12.12.2015;2015;12;11;Lauantai;21;30;51;11;15;26
96;12.12.2015;2015;12;12;Lauantai;29;25;54;12;10;22
96;12.12.2015;2015;12;13;Lauantai;19;48;67;12;10;22
96;12.12.2015;2015;12;14;Lauantai;43;51;94;6;10;16
96;12.12.2015;2015;12;15;Lauantai;52;30;82;10;11;21
96;12.12.2015;2015;12;16;Lauantai;28;35;63;8;20;28
96;12.12.2015;2015;12;17;Lauantai;28;20;48;3;7;10
96;12.12.2015;2015;12;18;Lauantai;29;18;47;14;3;17
96;12.12.2015;2015;12;19;Lauantai;30;21;51;14;7;21
96;12.12.2015;2015;12;20;Lauantai;21;14;35;7;12;19
96;12.12.2015;2015;12;21;Lauantai;14;25;39;4;5;9
96;12.12.2015;2015;12;22;Lauantai;6;11;17;3;0;3
96;12.12.2015;2015;12;23;Lauantai;8;7;15;0;0;0
96;13.12.2015;2015;12;00;Sunnuntai;10;8;18;1;5;6
96;13.12.2015;2015;12;01;Sunnuntai;5;8;13;5;0;5
96;13.12.2015;2015;12;02;Sunnuntai;10;2;12;1;1;2
96;13.12.2015;2015;12;03;Sunnuntai;14;3;17;2;0;2
96;13.12.2015;2015;12;04;Sunnuntai;9;1;10;2;0;2
96;13.12.2015;2015;12;05;Sunnuntai;4;2;6;2;0;2
96;13.12.2015;2015;12;06;Sunnuntai;9;3;12;2;1;3
96;13.12.2015;2015;12;07;Sunnuntai;4;7;11;0;4;4
96;13.12.2015;2015;12;08;Sunnuntai;6;7;13;1;3;4
96;13.12.2015;2015;12;09;Sunnuntai;4;6;10;5;3;8
96;13.12.2015;2015;12;10;Sunnuntai;9;8;17;5;13;18
96;13.12.2015;2015;12;11;Sunnuntai;7;20;27;14;8;22
96;13.12.2015;2015;12;12;Sunnuntai;14;22;36;10;17;27
96;13.12.2015;2015;12;13;Sunnuntai;27;19;46;9;11;20
96;13.12.2015;2015;12;14;Sunnuntai;19;26;45;8;12;20
96;13.12.2015;2015;12;15;Sunnuntai;18;26;44;10;8;18
96;13.12.2015;2015;12;16;Sunnuntai;31;9;40;18;7;25
96;13.12.2015;2015;12;17;Sunnuntai;34;9;43;11;8;19
96;13.12.2015;2015;12;18;Sunnuntai;12;10;22;10;14;24
96;13.12.2015;2015;12;19;Sunnuntai;10;25;35;8;17;25
96;13.12.2015;2015;12;20;Sunnuntai;15;13;28;10;9;19
96;13.12.2015;2015;12;21;Sunnuntai;19;14;33;3;1;4
96;13.12.2015;2015;12;22;Sunnuntai;2;8;10;3;0;3
96;13.12.2015;2015;12;23;Sunnuntai;7;0;7;3;2;5
96;14.12.2015;2015;12;00;Maanantai;2;1;3;2;0;2
96;14.12.2015;2015;12;01;Maanantai;4;1;5;0;0;0
96;14.12.2015;2015;12;02;Maanantai;0;0;0;0;0;0
96;14.12.2015;2015;12;03;Maanantai;1;0;1;0;0;0
96;14.12.2015;2015;12;04;Maanantai;2;0;2;0;1;1
96;14.12.2015;2015;12;05;Maanantai;0;1;1;0;2;2
96;14.12.2015;2015;12;06;Maanantai;29;25;54;8;3;11
96;14.12.2015;2015;12;07;Maanantai;63;66;129;27;13;40
96;14.12.2015;2015;12;08;Maanantai;73;81;154;7;15;22
96;14.12.2015;2015;12;09;Maanantai;47;42;89;10;7;17
96;14.12.2015;2015;12;10;Maanantai;43;49;92;12;12;24
96;14.12.2015;2015;12;11;Maanantai;35;36;71;12;7;19
96;14.12.2015;2015;12;12;Maanantai;47;58;105;17;20;37
96;14.12.2015;2015;12;13;Maanantai;28;47;75;11;15;26
96;14.12.2015;2015;12;14;Maanantai;52;97;149;11;23;34
96;14.12.2015;2015;12;15;Maanantai;56;102;158;9;29;38
96;14.12.2015;2015;12;16;Maanantai;66;115;181;12;38;50
96;14.12.2015;2015;12;17;Maanantai;52;49;101;9;6;15
96;14.12.2015;2015;12;18;Maanantai;43;30;73;9;12;21
96;14.12.2015;2015;12;19;Maanantai;22;25;47;11;7;18
96;14.12.2015;2015;12;20;Maanantai;30;21;51;4;8;12
96;14.12.2015;2015;12;21;Maanantai;32;19;51;0;6;6
96;14.12.2015;2015;12;22;Maanantai;9;9;18;4;1;5
96;14.12.2015;2015;12;23;Maanantai;1;2;3;0;1;1
96;15.12.2015;2015;12;00;Tiistai;1;1;2;0;0;0
96;15.12.2015;2015;12;01;Tiistai;1;1;2;0;0;0
96;15.12.2015;2015;12;02;Tiistai;0;0;0;0;0;0
96;15.12.2015;2015;12;03;Tiistai;2;0;2;0;1;1
96;15.12.2015;2015;12;04;Tiistai;0;0;0;0;1;1
96;15.12.2015;2015;12;05;Tiistai;3;2;5;0;2;2
96;15.12.2015;2015;12;06;Tiistai;32;13;45;10;0;10
96;15.12.2015;2015;12;07;Tiistai;63;74;137;18;7;25
96;15.12.2015;2015;12;08;Tiistai;82;77;159;10;8;18
96;15.12.2015;2015;12;09;Tiistai;73;32;105;14;9;23
96;15.12.2015;2015;12;10;Tiistai;46;31;77;6;12;18
96;15.12.2015;2015;12;11;Tiistai;34;33;67;7;8;15
96;15.12.2015;2015;12;12;Tiistai;40;54;94;10;8;18
96;15.12.2015;2015;12;13;Tiistai;40;62;102;8;9;17
96;15.12.2015;2015;12;14;Tiistai;55;88;143;9;28;37
96;15.12.2015;2015;12;15;Tiistai;57;103;160;6;26;32
96;15.12.2015;2015;12;16;Tiistai;66;109;175;15;26;41
96;15.12.2015;2015;12;17;Tiistai;45;44;89;4;6;10
96;15.12.2015;2015;12;18;Tiistai;24;28;52;7;22;29
96;15.12.2015;2015;12;19;Tiistai;45;27;72;10;8;18
96;15.12.2015;2015;12;20;Tiistai;37;26;63;4;6;10
96;15.12.2015;2015;12;21;Tiistai;27;15;42;1;4;5
96;15.12.2015;2015;12;22;Tiistai;8;7;15;1;5;6
96;15.12.2015;2015;12;23;Tiistai;1;2;3;2;0;2
96;16.12.2015;2015;12;00;Keskiviikko;11;1;12;0;0;0
96;16.12.2015;2015;12;01;Keskiviikko;2;1;3;0;0;0
96;16.12.2015;2015;12;02;Keskiviikko;3;1;4;0;0;0
96;16.12.2015;2015;12;03;Keskiviikko;2;0;2;0;0;0
96;16.12.2015;2015;12;04;Keskiviikko;2;2;4;0;0;0
96;16.12.2015;2015;12;05;Keskiviikko;2;2;4;1;1;2
96;16.12.2015;2015;12;06;Keskiviikko;25;18;43;5;5;10
96;16.12.2015;2015;12;07;Keskiviikko;55;60;115;14;8;22
96;16.12.2015;2015;12;08;Keskiviikko;82;61;143;6;6;12
96;16.12.2015;2015;12;09;Keskiviikko;66;34;100;9;6;15
96;16.12.2015;2015;12;10;Keskiviikko;38;40;78;12;8;20
96;16.12.2015;2015;12;11;Keskiviikko;44;51;95;13;20;33
96;16.12.2015;2015;12;12;Keskiviikko;36;46;82;5;13;18
96;16.12.2015;2015;12;13;Keskiviikko;50;71;121;6;13;19
96;16.12.2015;2015;12;14;Keskiviikko;56;76;132;6;15;21
96;16.12.2015;2015;12;15;Keskiviikko;58;104;162;9;38;47
96;16.12.2015;2015;12;16;Keskiviikko;73;104;177;11;21;32
96;16.12.2015;2015;12;17;Keskiviikko;48;42;90;5;16;21
96;16.12.2015;2015;12;18;Keskiviikko;39;22;61;11;7;18
96;16.12.2015;2015;12;19;Keskiviikko;34;25;59;2;8;10
96;16.12.2015;2015;12;20;Keskiviikko;12;20;32;3;7;10
96;16.12.2015;2015;12;21;Keskiviikko;13;24;37;3;10;13
96;16.12.2015;2015;12;22;Keskiviikko;11;7;18;0;1;1
96;16.12.2015;2015;12;23;Keskiviikko;1;3;4;0;0;0
96;17.12.2015;2015;12;00;Torstai;1;0;1;0;0;0
96;17.12.2015;2015;12;01;Torstai;0;0;0;1;0;1
96;17.12.2015;2015;12;02;Torstai;1;0;1;1;0;1
96;17.12.2015;2015;12;03;Torstai;1;0;1;0;0;0
96;17.12.2015;2015;12;04;Torstai;1;0;1;0;0;0
96;17.12.2015;2015;12;05;Torstai;1;3;4;1;0;1
96;17.12.2015;2015;12;06;Torstai;27;17;44;5;4;9
96;17.12.2015;2015;12;07;Torstai;65;59;124;13;10;23
96;17.12.2015;2015;12;08;Torstai;77;66;143;10;11;21
96;17.12.2015;2015;12;09;Torstai;59;47;106;15;10;25
96;17.12.2015;2015;12;10;Torstai;20;22;42;11;7;18
96;17.12.2015;2015;12;11;Torstai;44;54;98;11;15;26
96;17.12.2015;2015;12;12;Torstai;37;60;97;4;6;10
96;17.12.2015;2015;12;13;Torstai;49;47;96;4;21;25
96;17.12.2015;2015;12;14;Torstai;27;69;96;4;16;20
96;17.12.2015;2015;12;15;Torstai;47;103;150;1;36;37
96;17.12.2015;2015;12;16;Torstai;52;80;132;5;34;39
96;17.12.2015;2015;12;17;Torstai;33;46;79;1;6;7
96;17.12.2015;2015;12;18;Torstai;28;22;50;7;7;14
96;17.12.2015;2015;12;19;Torstai;23;23;46;8;12;20
96;17.12.2015;2015;12;20;Torstai;25;18;43;3;3;6
96;17.12.2015;2015;12;21;Torstai;17;23;40;2;3;5
96;17.12.2015;2015;12;22;Torstai;9;8;17;0;5;5
96;17.12.2015;2015;12;23;Torstai;6;4;10;0;0;0
96;18.12.2015;2015;12;00;Perjantai;2;2;4;0;0;0
96;18.12.2015;2015;12;01;Perjantai;4;1;5;0;0;0
96;18.12.2015;2015;12;02;Perjantai;4;0;4;1;0;1
96;18.12.2015;2015;12;03;Perjantai;0;0;0;1;0;1
96;18.12.2015;2015;12;04;Perjantai;4;1;5;0;0;0
96;18.12.2015;2015;12;05;Perjantai;2;3;5;0;2;2
96;18.12.2015;2015;12;06;Perjantai;29;18;47;2;0;2
96;18.12.2015;2015;12;07;Perjantai;49;59;108;6;10;16
96;18.12.2015;2015;12;08;Perjantai;56;71;127;5;2;7
96;18.12.2015;2015;12;09;Perjantai;29;44;73;5;6;11
96;18.12.2015;2015;12;10;Perjantai;30;37;67;1;10;11
96;18.12.2015;2015;12;11;Perjantai;48;159;207;6;27;33
96;18.12.2015;2015;12;12;Perjantai;37;58;95;3;5;8
96;18.12.2015;2015;12;13;Perjantai;51;85;136;3;14;17
96;18.12.2015;2015;12;14;Perjantai;47;80;127;4;14;18
96;18.12.2015;2015;12;15;Perjantai;55;91;146;2;17;19
96;18.12.2015;2015;12;16;Perjantai;42;51;93;1;7;8
96;18.12.2015;2015;12;17;Perjantai;20;29;49;5;10;15
96;18.12.2015;2015;12;18;Perjantai;17;13;30;2;1;3
96;18.12.2015;2015;12;19;Perjantai;11;11;22;1;3;4
96;18.12.2015;2015;12;20;Perjantai;18;5;23;2;2;4
96;18.12.2015;2015;12;21;Perjantai;11;10;21;3;6;9
96;18.12.2015;2015;12;22;Perjantai;11;3;14;1;1;2
96;18.12.2015;2015;12;23;Perjantai;6;2;8;0;0;0
96;19.12.2015;2015;12;00;Lauantai;7;2;9;0;0;0
96;19.12.2015;2015;12;01;Lauantai;2;2;4;1;0;1
96;19.12.2015;2015;12;02;Lauantai;0;0;0;0;0;0
96;19.12.2015;2015;12;03;Lauantai;4;0;4;1;1;2
96;19.12.2015;2015;12;04;Lauantai;0;0;0;3;1;4
96;19.12.2015;2015;12;05;Lauantai;4;1;5;0;0;0
96;19.12.2015;2015;12;06;Lauantai;12;9;21;0;0;0
96;19.12.2015;2015;12;07;Lauantai;4;2;6;0;1;1
96;19.12.2015;2015;12;08;Lauantai;18;22;40;0;0;0
96;19.12.2015;2015;12;09;Lauantai;13;14;27;2;2;4
96;19.12.2015;2015;12;10;Lauantai;13;19;32;1;4;5
96;19.12.2015;2015;12;11;Lauantai;14;20;34;2;3;5
96;19.12.2015;2015;12;12;Lauantai;30;29;59;0;3;3
96;19.12.2015;2015;12;13;Lauantai;25;28;53;1;2;3
96;19.12.2015;2015;12;14;Lauantai;29;27;56;0;3;3
96;19.12.2015;2015;12;15;Lauantai;28;28;56;3;2;5
96;19.12.2015;2015;12;16;Lauantai;23;14;37;1;1;2
96;19.12.2015;2015;12;17;Lauantai;22;15;37;5;2;7
96;19.12.2015;2015;12;18;Lauantai;27;19;46;3;2;5
96;19.12.2015;2015;12;19;Lauantai;20;9;29;4;3;7
96;19.12.2015;2015;12;20;Lauantai;9;12;21;1;2;3
96;19.12.2015;2015;12;21;Lauantai;13;11;24;3;1;4
96;19.12.2015;2015;12;22;Lauantai;7;5;12;0;0;0
96;19.12.2015;2015;12;23;Lauantai;9;7;16;0;2;2
96;20.12.2015;2015;12;00;Sunnuntai;5;2;7;5;3;8
96;20.12.2015;2015;12;01;Sunnuntai;4;2;6;1;0;1
96;20.12.2015;2015;12;02;Sunnuntai;10;1;11;2;0;2
96;20.12.2015;2015;12;03;Sunnuntai;3;2;5;0;0;0
96;20.12.2015;2015;12;04;Sunnuntai;5;1;6;1;1;2
96;20.12.2015;2015;12;05;Sunnuntai;1;0;1;0;0;0
96;20.12.2015;2015;12;06;Sunnuntai;11;8;19;0;0;0
96;20.12.2015;2015;12;07;Sunnuntai;1;2;3;3;1;4
96;20.12.2015;2015;12;08;Sunnuntai;7;4;11;1;1;2
96;20.12.2015;2015;12;09;Sunnuntai;5;6;11;0;2;2
96;20.12.2015;2015;12;10;Sunnuntai;5;2;7;1;2;3
96;20.12.2015;2015;12;11;Sunnuntai;5;10;15;2;4;6
96;20.12.2015;2015;12;12;Sunnuntai;18;17;35;2;11;13
96;20.12.2015;2015;12;13;Sunnuntai;15;18;33;4;7;11
96;20.12.2015;2015;12;14;Sunnuntai;9;12;21;5;8;13
96;20.12.2015;2015;12;15;Sunnuntai;11;18;29;3;6;9
96;20.12.2015;2015;12;16;Sunnuntai;23;11;34;5;8;13
96;20.12.2015;2015;12;17;Sunnuntai;14;14;28;6;5;11
96;20.12.2015;2015;12;18;Sunnuntai;10;9;19;10;19;29
96;20.12.2015;2015;12;19;Sunnuntai;8;16;24;1;7;8
96;20.12.2015;2015;12;20;Sunnuntai;10;8;18;4;2;6
96;20.12.2015;2015;12;21;Sunnuntai;12;8;20;1;4;5
96;20.12.2015;2015;12;22;Sunnuntai;5;2;7;0;1;1
96;20.12.2015;2015;12;23;Sunnuntai;1;3;4;1;0;1
96;21.12.2015;2015;12;00;Maanantai;2;0;2;1;0;1
96;21.12.2015;2015;12;01;Maanantai;3;0;3;0;0;0
96;21.12.2015;2015;12;02;Maanantai;0;1;1;0;0;0
96;21.12.2015;2015;12;03;Maanantai;1;1;2;0;0;0
96;21.12.2015;2015;12;04;Maanantai;2;0;2;0;1;1
96;21.12.2015;2015;12;05;Maanantai;0;2;2;0;1;1
96;21.12.2015;2015;12;06;Maanantai;18;12;30;4;3;7
96;21.12.2015;2015;12;07;Maanantai;35;29;64;18;3;21
96;21.12.2015;2015;12;08;Maanantai;25;33;58;7;5;12
96;21.12.2015;2015;12;09;Maanantai;16;24;40;10;6;16
96;21.12.2015;2015;12;10;Maanantai;14;20;34;6;3;9
96;21.12.2015;2015;12;11;Maanantai;16;28;44;13;5;18
96;21.12.2015;2015;12;12;Maanantai;14;16;30;5;4;9
96;21.12.2015;2015;12;13;Maanantai;37;24;61;11;8;19
96;21.12.2015;2015;12;14;Maanantai;39;37;76;7;10;17
96;21.12.2015;2015;12;15;Maanantai;35;49;84;6;28;34
96;21.12.2015;2015;12;16;Maanantai;28;39;67;14;23;37
96;21.12.2015;2015;12;17;Maanantai;26;26;52;12;4;16
96;21.12.2015;2015;12;18;Maanantai;29;12;41;8;5;13
96;21.12.2015;2015;12;19;Maanantai;17;9;26;8;11;19
96;21.12.2015;2015;12;20;Maanantai;8;10;18;2;5;7
96;21.12.2015;2015;12;21;Maanantai;13;8;21;3;7;10
96;21.12.2015;2015;12;22;Maanantai;5;3;8;0;2;2
96;21.12.2015;2015;12;23;Maanantai;2;3;5;0;0;0
96;22.12.2015;2015;12;00;Tiistai;0;2;2;0;0;0
96;22.12.2015;2015;12;01;Tiistai;0;0;0;0;0;0
96;22.12.2015;2015;12;02;Tiistai;0;0;0;0;0;0
96;22.12.2015;2015;12;03;Tiistai;1;0;1;0;0;0
96;22.12.2015;2015;12;04;Tiistai;1;0;1;1;0;1
96;22.12.2015;2015;12;05;Tiistai;1;2;3;1;1;2
96;22.12.2015;2015;12;06;Tiistai;25;8;33;8;3;11
96;22.12.2015;2015;12;07;Tiistai;30;29;59;25;6;31
96;22.12.2015;2015;12;08;Tiistai;25;33;58;5;10;15
96;22.12.2015;2015;12;09;Tiistai;13;25;38;8;4;12
96;22.12.2015;2015;12;10;Tiistai;17;17;34;4;6;10
96;22.12.2015;2015;12;11;Tiistai;16;15;31;9;10;19
96;22.12.2015;2015;12;12;Tiistai;21;27;48;9;9;18
96;22.12.2015;2015;12;13;Tiistai;20;19;39;2;8;10
96;22.12.2015;2015;12;14;Tiistai;32;31;63;4;14;18
96;22.12.2015;2015;12;15;Tiistai;47;54;101;5;18;23
96;22.12.2015;2015;12;16;Tiistai;31;31;62;7;17;24
96;22.12.2015;2015;12;17;Tiistai;29;21;50;7;10;17
96;22.12.2015;2015;12;18;Tiistai;25;18;43;3;4;7
96;22.12.2015;2015;12;19;Tiistai;22;11;33;5;5;10
96;22.12.2015;2015;12;20;Tiistai;27;10;37;3;2;5
96;22.12.2015;2015;12;21;Tiistai;13;11;24;1;3;4
96;22.12.2015;2015;12;22;Tiistai;5;1;6;5;2;7
96;22.12.2015;2015;12;23;Tiistai;3;1;4;0;1;1
96;23.12.2015;2015;12;00;Keskiviikko;0;1;1;0;0;0
96;23.12.2015;2015;12;01;Keskiviikko;0;0;0;0;0;0
96;23.12.2015;2015;12;02;Keskiviikko;0;0;0;0;0;0
96;23.12.2015;2015;12;03;Keskiviikko;1;0;1;0;0;0
96;23.12.2015;2015;12;04;Keskiviikko;3;0;3;0;0;0
96;23.12.2015;2015;12;05;Keskiviikko;0;3;3;3;1;4
96;23.12.2015;2015;12;06;Keskiviikko;17;8;25;10;4;14
96;23.12.2015;2015;12;07;Keskiviikko;33;24;57;20;4;24
96;23.12.2015;2015;12;08;Keskiviikko;14;24;38;7;4;11
96;23.12.2015;2015;12;09;Keskiviikko;8;12;20;7;7;14
96;23.12.2015;2015;12;10;Keskiviikko;13;15;28;3;7;10
96;23.12.2015;2015;12;11;Keskiviikko;16;16;32;4;4;8
96;23.12.2015;2015;12;12;Keskiviikko;19;18;37;6;6;12
96;23.12.2015;2015;12;13;Keskiviikko;17;23;40;3;7;10
96;23.12.2015;2015;12;14;Keskiviikko;26;54;80;6;26;32
96;23.12.2015;2015;12;15;Keskiviikko;27;30;57;6;20;26
96;23.12.2015;2015;12;16;Keskiviikko;21;21;42;4;10;14
96;23.12.2015;2015;12;17;Keskiviikko;18;10;28;4;2;6
96;23.12.2015;2015;12;18;Keskiviikko;13;6;19;8;3;11
96;23.12.2015;2015;12;19;Keskiviikko;12;8;20;4;5;9
96;23.12.2015;2015;12;20;Keskiviikko;12;3;15;3;2;5
96;23.12.2015;2015;12;21;Keskiviikko;9;14;23;3;2;5
96;23.12.2015;2015;12;22;Keskiviikko;4;3;7;0;0;0
96;23.12.2015;2015;12;23;Keskiviikko;3;1;4;0;0;0
96;24.12.2015;2015;12;00;Torstai;2;2;4;0;0;0
96;24.12.2015;2015;12;01;Torstai;0;3;3;1;0;1
96;24.12.2015;2015;12;02;Torstai;0;3;3;0;0;0
96;24.12.2015;2015;12;03;Torstai;0;0;0;0;0;0
96;24.12.2015;2015;12;04;Torstai;0;1;1;0;0;0
96;24.12.2015;2015;12;05;Torstai;0;3;3;0;0;0
96;24.12.2015;2015;12;06;Torstai;6;1;7;3;2;5
96;24.12.2015;2015;12;07;Torstai;0;11;11;1;4;5
96;24.12.2015;2015;12;08;Torstai;8;3;11;1;6;7
96;24.12.2015;2015;12;09;Torstai;9;4;13;5;4;9
96;24.12.2015;2015;12;10;Torstai;13;7;20;8;6;14
96;24.12.2015;2015;12;11;Torstai;15;16;31;2;2;4
96;24.12.2015;2015;12;12;Torstai;21;10;31;8;6;14
96;24.12.2015;2015;12;13;Torstai;19;4;23;9;6;15
96;24.12.2015;2015;12;14;Torstai;6;3;9;2;3;5
96;24.12.2015;2015;12;15;Torstai;3;3;6;5;5;10
96;24.12.2015;2015;12;16;Torstai;5;4;9;0;0;0
96;24.12.2015;2015;12;17;Torstai;3;5;8;1;2;3
96;24.12.2015;2015;12;18;Torstai;1;1;2;2;3;5
96;24.12.2015;2015;12;19;Torstai;2;2;4;2;1;3
96;24.12.2015;2015;12;20;Torstai;6;5;11;2;0;2
96;24.12.2015;2015;12;21;Torstai;7;12;19;1;1;2
96;24.12.2015;2015;12;22;Torstai;0;3;3;0;2;2
96;24.12.2015;2015;12;23;Torstai;1;3;4;1;2;3
96;25.12.2015;2015;12;00;Perjantai;1;2;3;0;0;0
96;25.12.2015;2015;12;01;Perjantai;2;2;4;0;0;0
96;25.12.2015;2015;12;02;Perjantai;1;1;2;0;1;1
96;25.12.2015;2015;12;03;Perjantai;2;1;3;0;0;0
96;25.12.2015;2015;12;04;Perjantai;0;0;0;0;0;0
96;25.12.2015;2015;12;05;Perjantai;0;0;0;0;0;0
96;25.12.2015;2015;12;06;Perjantai;14;0;14;4;2;6
96;25.12.2015;2015;12;07;Perjantai;2;5;7;2;2;4
96;25.12.2015;2015;12;08;Perjantai;1;1;2;1;2;3
96;25.12.2015;2015;12;09;Perjantai;0;1;1;4;6;10
96;25.12.2015;2015;12;10;Perjantai;1;1;2;2;2;4
96;25.12.2015;2015;12;11;Perjantai;1;0;1;12;7;19
96;25.12.2015;2015;12;12;Perjantai;4;7;11;10;8;18
96;25.12.2015;2015;12;13;Perjantai;13;1;14;9;8;17
96;25.12.2015;2015;12;14;Perjantai;5;15;20;9;6;15
96;25.12.2015;2015;12;15;Perjantai;5;9;14;3;6;9
96;25.12.2015;2015;12;16;Perjantai;3;6;9;4;2;6
96;25.12.2015;2015;12;17;Perjantai;5;3;8;3;3;6
96;25.12.2015;2015;12;18;Perjantai;4;1;5;2;2;4
96;25.12.2015;2015;12;19;Perjantai;5;2;7;1;3;4
96;25.12.2015;2015;12;20;Perjantai;7;1;8;1;1;2
96;25.12.2015;2015;12;21;Perjantai;4;11;15;1;4;5
96;25.12.2015;2015;12;22;Perjantai;3;1;4;1;2;3
96;25.12.2015;2015;12;23;Perjantai;2;3;5;0;0;0
96;26.12.2015;2015;12;00;Lauantai;0;1;1;0;0;0
96;26.12.2015;2015;12;01;Lauantai;3;1;4;0;0;0
96;26.12.2015;2015;12;02;Lauantai;2;0;2;0;0;0
96;26.12.2015;2015;12;03;Lauantai;2;0;2;0;0;0
96;26.12.2015;2015;12;04;Lauantai;1;0;1;0;0;0
96;26.12.2015;2015;12;05;Lauantai;3;0;3;0;0;0
96;26.12.2015;2015;12;06;Lauantai;12;1;13;3;0;3
96;26.12.2015;2015;12;07;Lauantai;2;7;9;2;2;4
96;26.12.2015;2015;12;08;Lauantai;1;0;1;1;3;4
96;26.12.2015;2015;12;09;Lauantai;2;3;5;1;7;8
96;26.12.2015;2015;12;10;Lauantai;4;3;7;7;1;8
96;26.12.2015;2015;12;11;Lauantai;4;4;8;8;9;17
96;26.12.2015;2015;12;12;Lauantai;8;5;13;10;5;15
96;26.12.2015;2015;12;13;Lauantai;13;8;21;10;7;17
96;26.12.2015;2015;12;14;Lauantai;4;18;22;9;11;20
96;26.12.2015;2015;12;15;Lauantai;8;13;21;7;11;18
96;26.12.2015;2015;12;16;Lauantai;7;7;14;3;5;8
96;26.12.2015;2015;12;17;Lauantai;4;5;9;2;4;6
96;26.12.2015;2015;12;18;Lauantai;1;11;12;2;4;6
96;26.12.2015;2015;12;19;Lauantai;8;5;13;9;2;11
96;26.12.2015;2015;12;20;Lauantai;9;5;14;4;3;7
96;26.12.2015;2015;12;21;Lauantai;4;12;16;1;2;3
96;26.12.2015;2015;12;22;Lauantai;2;4;6;2;1;3
96;26.12.2015;2015;12;23;Lauantai;3;2;5;1;0;1
96;27.12.2015;2015;12;00;Sunnuntai;2;2;4;0;2;2
96;27.12.2015;2015;12;01;Sunnuntai;0;1;1;3;1;4
96;27.12.2015;2015;12;02;Sunnuntai;0;0;0;0;1;1
96;27.12.2015;2015;12;03;Sunnuntai;9;0;9;4;2;6
96;27.12.2015;2015;12;04;Sunnuntai;5;0;5;6;0;6
96;27.12.2015;2015;12;05;Sunnuntai;3;0;3;1;0;1
96;27.12.2015;2015;12;06;Sunnuntai;15;2;17;7;6;13
96;27.12.2015;2015;12;07;Sunnuntai;0;7;7;0;0;0
96;27.12.2015;2015;12;08;Sunnuntai;3;3;6;3;3;6
96;27.12.2015;2015;12;09;Sunnuntai;0;2;2;2;3;5
96;27.12.2015;2015;12;10;Sunnuntai;5;6;11;7;4;11
96;27.12.2015;2015;12;11;Sunnuntai;4;8;12;9;7;16
96;27.12.2015;2015;12;12;Sunnuntai;14;7;21;8;10;18
96;27.12.2015;2015;12;13;Sunnuntai;14;7;21;7;9;16
96;27.12.2015;2015;12;14;Sunnuntai;8;15;23;14;20;34
96;27.12.2015;2015;12;15;Sunnuntai;8;13;21;8;5;13
96;27.12.2015;2015;12;16;Sunnuntai;14;8;22;15;6;21
96;27.12.2015;2015;12;17;Sunnuntai;10;11;21;4;1;5
96;27.12.2015;2015;12;18;Sunnuntai;8;8;16;7;12;19
96;27.12.2015;2015;12;19;Sunnuntai;9;11;20;2;11;13
96;27.12.2015;2015;12;20;Sunnuntai;10;5;15;4;5;9
96;27.12.2015;2015;12;21;Sunnuntai;7;11;18;2;4;6
96;27.12.2015;2015;12;22;Sunnuntai;4;1;5;1;0;1
96;27.12.2015;2015;12;23;Sunnuntai;2;5;7;0;1;1
96;28.12.2015;2015;12;00;Maanantai;1;0;1;0;1;1
96;28.12.2015;2015;12;01;Maanantai;0;0;0;0;0;0
96;28.12.2015;2015;12;02;Maanantai;3;0;3;0;0;0
96;28.12.2015;2015;12;03;Maanantai;3;1;4;0;0;0
96;28.12.2015;2015;12;04;Maanantai;1;0;1;0;2;2
96;28.12.2015;2015;12;05;Maanantai;4;2;6;0;0;0
96;28.12.2015;2015;12;06;Maanantai;20;10;30;11;3;14
96;28.12.2015;2015;12;07;Maanantai;28;35;63;17;3;20
96;28.12.2015;2015;12;08;Maanantai;10;29;39;7;7;14
96;28.12.2015;2015;12;09;Maanantai;6;20;26;4;6;10
96;28.12.2015;2015;12;10;Maanantai;22;16;38;6;2;8
96;28.12.2015;2015;12;11;Maanantai;15;16;31;9;13;22
96;28.12.2015;2015;12;12;Maanantai;16;24;40;11;8;19
96;28.12.2015;2015;12;13;Maanantai;22;21;43;12;10;22
96;28.12.2015;2015;12;14;Maanantai;21;22;43;10;13;23
96;28.12.2015;2015;12;15;Maanantai;26;42;68;6;24;30
96;28.12.2015;2015;12;16;Maanantai;29;34;63;5;18;23
96;28.12.2015;2015;12;17;Maanantai;34;19;53;4;4;8
96;28.12.2015;2015;12;18;Maanantai;22;7;29;4;5;9
96;28.12.2015;2015;12;19;Maanantai;12;10;22;8;4;12
96;28.12.2015;2015;12;20;Maanantai;15;2;17;4;7;11
96;28.12.2015;2015;12;21;Maanantai;10;12;22;2;9;11
96;28.12.2015;2015;12;22;Maanantai;4;1;5;1;1;2
96;28.12.2015;2015;12;23;Maanantai;4;2;6;0;2;2
96;29.12.2015;2015;12;00;Tiistai;2;1;3;1;1;2
96;29.12.2015;2015;12;01;Tiistai;3;0;3;1;0;1
96;29.12.2015;2015;12;02;Tiistai;0;0;0;0;0;0
96;29.12.2015;2015;12;03;Tiistai;1;0;1;0;0;0
96;29.12.2015;2015;12;04;Tiistai;1;0;1;0;0;0
96;29.12.2015;2015;12;05;Tiistai;2;1;3;1;0;1
96;29.12.2015;2015;12;06;Tiistai;18;4;22;12;3;15
96;29.12.2015;2015;12;07;Tiistai;26;28;54;18;9;27
96;29.12.2015;2015;12;08;Tiistai;16;26;42;8;4;12
96;29.12.2015;2015;12;09;Tiistai;5;14;19;8;6;14
96;29.12.2015;2015;12;10;Tiistai;8;9;17;10;6;16
96;29.12.2015;2015;12;11;Tiistai;13;8;21;6;10;16
96;29.12.2015;2015;12;12;Tiistai;16;10;26;12;12;24
96;29.12.2015;2015;12;13;Tiistai;14;14;28;7;15;22
96;29.12.2015;2015;12;14;Tiistai;15;21;36;9;13;22
96;29.12.2015;2015;12;15;Tiistai;16;53;69;8;30;38
96;29.12.2015;2015;12;16;Tiistai;28;20;48;14;28;42
96;29.12.2015;2015;12;17;Tiistai;20;11;31;14;16;30
96;29.12.2015;2015;12;18;Tiistai;17;12;29;6;5;11
96;29.12.2015;2015;12;19;Tiistai;17;12;29;8;3;11
96;29.12.2015;2015;12;20;Tiistai;13;5;18;6;8;14
96;29.12.2015;2015;12;21;Tiistai;15;10;25;4;6;10
96;29.12.2015;2015;12;22;Tiistai;3;5;8;1;1;2
96;29.12.2015;2015;12;23;Tiistai;2;2;4;0;1;1
96;30.12.2015;2015;12;00;Keskiviikko;4;2;6;0;1;1
96;30.12.2015;2015;12;01;Keskiviikko;4;1;5;1;0;1
96;30.12.2015;2015;12;02;Keskiviikko;1;0;1;1;1;2
96;30.12.2015;2015;12;03;Keskiviikko;1;0;1;0;0;0
96;30.12.2015;2015;12;04;Keskiviikko;1;0;1;0;0;0
96;30.12.2015;2015;12;05;Keskiviikko;3;3;6;0;0;0
96;30.12.2015;2015;12;06;Keskiviikko;16;10;26;7;1;8
96;30.12.2015;2015;12;07;Keskiviikko;31;31;62;15;8;23
96;30.12.2015;2015;12;08;Keskiviikko;17;19;36;7;6;13
96;30.12.2015;2015;12;09;Keskiviikko;11;19;30;0;5;5
96;30.12.2015;2015;12;10;Keskiviikko;11;18;29;2;10;12
96;30.12.2015;2015;12;11;Keskiviikko;19;23;42;7;8;15
96;30.12.2015;2015;12;12;Keskiviikko;27;20;47;7;4;11
96;30.12.2015;2015;12;13;Keskiviikko;26;23;49;4;7;11
96;30.12.2015;2015;12;14;Keskiviikko;22;24;46;3;5;8
96;30.12.2015;2015;12;15;Keskiviikko;22;69;91;5;28;33
96;30.12.2015;2015;12;16;Keskiviikko;36;30;66;8;10;18
96;30.12.2015;2015;12;17;Keskiviikko;29;18;47;10;7;17
96;30.12.2015;2015;12;18;Keskiviikko;24;12;36;7;7;14
96;30.12.2015;2015;12;19;Keskiviikko;23;6;29;12;6;18
96;30.12.2015;2015;12;20;Keskiviikko;13;11;24;8;6;14
96;30.12.2015;2015;12;21;Keskiviikko;10;9;19;2;5;7
96;30.12.2015;2015;12;22;Keskiviikko;3;3;6;1;3;4
96;30.12.2015;2015;12;23;Keskiviikko;3;3;6;2;0;2
96;31.12.2015;2015;12;00;Torstai;2;1;3;0;0;0
96;31.12.2015;2015;12;01;Torstai;1;0;1;1;0;1
96;31.12.2015;2015;12;02;Torstai;1;0;1;1;0;1
96;31.12.2015;2015;12;03;Torstai;4;0;4;0;0;0
96;31.12.2015;2015;12;04;Torstai;1;0;1;0;0;0
96;31.12.2015;2015;12;05;Torstai;1;5;6;1;0;1
96;31.12.2015;2015;12;06;Torstai;17;6;23;14;3;17
96;31.12.2015;2015;12;07;Torstai;23;23;46;9;2;11
96;31.12.2015;2015;12;08;Torstai;12;21;33;10;4;14
96;31.12.2015;2015;12;09;Torstai;12;23;35;6;4;10
96;31.12.2015;2015;12;10;Torstai;15;20;35;3;13;16
96;31.12.2015;2015;12;11;Torstai;15;24;39;9;11;20
96;31.12.2015;2015;12;12;Torstai;22;22;44;7;8;15
96;31.12.2015;2015;12;13;Torstai;30;28;58;7;14;21
96;31.12.2015;2015;12;14;Torstai;27;38;65;15;14;29
96;31.12.2015;2015;12;15;Torstai;23;37;60;9;24;33
96;31.12.2015;2015;12;16;Torstai;24;12;36;8;7;15
96;31.12.2015;2015;12;17;Torstai;23;17;40;4;6;10
96;31.12.2015;2015;12;18;Torstai;15;10;25;3;4;7
96;31.12.2015;2015;12;19;Torstai;1;21;22;0;6;6
96;31.12.2015;2015;12;20;Torstai;22;11;33;2;6;8
96;31.12.2015;2015;12;21;Torstai;10;15;25;0;4;4
96;31.12.2015;2015;12;22;Torstai;9;12;21;1;6;7
96;31.12.2015;2015;12;23;Torstai;4;10;14;1;2;3
96;01.01.2016;2016;01;00;Perjantai;1;2;3;2;3;5
96;01.01.2016;2016;01;01;Perjantai;3;1;4;5;0;5
96;01.01.2016;2016;01;02;Perjantai;9;2;11;2;1;3
96;01.01.2016;2016;01;03;Perjantai;15;2;17;1;0;1
96;01.01.2016;2016;01;04;Perjantai;5;1;6;2;0;2
96;01.01.2016;2016;01;05;Perjantai;3;1;4;0;0;0
96;01.01.2016;2016;01;06;Perjantai;6;3;9;1;2;3
96;01.01.2016;2016;01;07;Perjantai;2;2;4;1;2;3
96;01.01.2016;2016;01;08;Perjantai;2;2;4;3;0;3
96;01.01.2016;2016;01;09;Perjantai;3;4;7;2;2;4
96;01.01.2016;2016;01;10;Perjantai;1;5;6;3;5;8
96;01.01.2016;2016;01;11;Perjantai;9;6;15;9;7;16
96;01.01.2016;2016;01;12;Perjantai;7;8;15;11;5;16
96;01.01.2016;2016;01;13;Perjantai;9;6;15;6;7;13
96;01.01.2016;2016;01;14;Perjantai;7;7;14;7;14;21
96;01.01.2016;2016;01;15;Perjantai;9;15;24;6;12;18
96;01.01.2016;2016;01;16;Perjantai;7;9;16;15;7;22
96;01.01.2016;2016;01;17;Perjantai;5;3;8;6;12;18
96;01.01.2016;2016;01;18;Perjantai;6;6;12;5;1;6
96;01.01.2016;2016;01;19;Perjantai;2;5;7;7;19;26
96;01.01.2016;2016;01;20;Perjantai;8;3;11;4;4;8
96;01.01.2016;2016;01;21;Perjantai;3;11;14;0;0;0
96;01.01.2016;2016;01;22;Perjantai;2;3;5;0;2;2
96;01.01.2016;2016;01;23;Perjantai;0;2;2;1;2;3
96;02.01.2016;2016;01;00;Lauantai;0;0;0;0;0;0
96;02.01.2016;2016;01;01;Lauantai;3;0;3;0;0;0
96;02.01.2016;2016;01;02;Lauantai;1;1;2;0;1;1
96;02.01.2016;2016;01;03;Lauantai;0;0;0;0;0;0
96;02.01.2016;2016;01;04;Lauantai;1;0;1;0;0;0
96;02.01.2016;2016;01;05;Lauantai;5;2;7;1;1;2
96;02.01.2016;2016;01;06;Lauantai;11;4;15;5;0;5
96;02.01.2016;2016;01;07;Lauantai;1;9;10;2;2;4
96;02.01.2016;2016;01;08;Lauantai;6;13;19;5;3;8
96;02.01.2016;2016;01;09;Lauantai;3;7;10;3;3;6
96;02.01.2016;2016;01;10;Lauantai;6;9;15;3;8;11
96;02.01.2016;2016;01;11;Lauantai;9;6;15;9;11;20
96;02.01.2016;2016;01;12;Lauantai;12;12;24;6;11;17
96;02.01.2016;2016;01;13;Lauantai;20;15;35;11;5;16
96;02.01.2016;2016;01;14;Lauantai;21;27;48;5;13;18
96;02.01.2016;2016;01;15;Lauantai;20;18;38;7;15;22
96;02.01.2016;2016;01;16;Lauantai;17;11;28;4;6;10
96;02.01.2016;2016;01;17;Lauantai;24;4;28;6;1;7
96;02.01.2016;2016;01;18;Lauantai;9;4;13;4;5;9
96;02.01.2016;2016;01;19;Lauantai;3;2;5;4;0;4
96;02.01.2016;2016;01;20;Lauantai;8;6;14;3;4;7
96;02.01.2016;2016;01;21;Lauantai;8;13;21;2;3;5
96;02.01.2016;2016;01;22;Lauantai;4;6;10;0;3;3
96;02.01.2016;2016;01;23;Lauantai;3;2;5;0;0;0
96;03.01.2016;2016;01;00;Sunnuntai;2;0;2;1;0;1
96;03.01.2016;2016;01;01;Sunnuntai;1;0;1;0;0;0
96;03.01.2016;2016;01;02;Sunnuntai;3;0;3;0;1;1
96;03.01.2016;2016;01;03;Sunnuntai;0;0;0;0;1;1
96;03.01.2016;2016;01;04;Sunnuntai;3;0;3;1;0;1
96;03.01.2016;2016;01;05;Sunnuntai;1;1;2;2;0;2
96;03.01.2016;2016;01;06;Sunnuntai;9;2;11;2;1;3
96;03.01.2016;2016;01;07;Sunnuntai;1;4;5;0;1;1
96;03.01.2016;2016;01;08;Sunnuntai;1;4;5;4;7;11
96;03.01.2016;2016;01;09;Sunnuntai;4;3;7;6;4;10
96;03.01.2016;2016;01;10;Sunnuntai;8;14;22;12;6;18
96;03.01.2016;2016;01;11;Sunnuntai;12;11;23;19;8;27
96;03.01.2016;2016;01;12;Sunnuntai;11;10;21;8;14;22
96;03.01.2016;2016;01;13;Sunnuntai;12;14;26;17;9;26
96;03.01.2016;2016;01;14;Sunnuntai;12;13;25;3;8;11
96;03.01.2016;2016;01;15;Sunnuntai;14;9;23;14;16;30
96;03.01.2016;2016;01;16;Sunnuntai;19;15;34;17;16;33
96;03.01.2016;2016;01;17;Sunnuntai;22;11;33;11;8;19
96;03.01.2016;2016;01;18;Sunnuntai;15;17;32;18;14;32
96;03.01.2016;2016;01;19;Sunnuntai;6;15;21;5;7;12
96;03.01.2016;2016;01;20;Sunnuntai;10;19;29;0;9;9
96;03.01.2016;2016;01;21;Sunnuntai;7;8;15;0;5;5
96;03.01.2016;2016;01;22;Sunnuntai;2;4;6;0;2;2
96;03.01.2016;2016;01;23;Sunnuntai;0;2;2;1;0;1
96;04.01.2016;2016;01;00;Maanantai;0;0;0;0;0;0
96;04.01.2016;2016;01;01;Maanantai;4;1;5;0;0;0
96;04.01.2016;2016;01;02;Maanantai;1;0;1;0;0;0
96;04.01.2016;2016;01;03;Maanantai;1;0;1;0;0;0
96;04.01.2016;2016;01;04;Maanantai;1;0;1;0;3;3
96;04.01.2016;2016;01;05;Maanantai;2;1;3;1;1;2
96;04.01.2016;2016;01;06;Maanantai;22;10;32;9;4;13
96;04.01.2016;2016;01;07;Maanantai;33;35;68;22;10;32
96;04.01.2016;2016;01;08;Maanantai;33;35;68;14;9;23
96;04.01.2016;2016;01;09;Maanantai;10;9;19;7;5;12
96;04.01.2016;2016;01;10;Maanantai;7;15;22;6;7;13
96;04.01.2016;2016;01;11;Maanantai;13;19;32;13;13;26
96;04.01.2016;2016;01;12;Maanantai;19;16;35;17;11;28
96;04.01.2016;2016;01;13;Maanantai;24;21;45;7;7;14
96;04.01.2016;2016;01;14;Maanantai;22;32;54;5;12;17
96;04.01.2016;2016;01;15;Maanantai;31;66;97;12;30;42
96;04.01.2016;2016;01;16;Maanantai;37;31;68;10;31;41
96;04.01.2016;2016;01;17;Maanantai;22;10;32;7;9;16
96;04.01.2016;2016;01;18;Maanantai;17;14;31;7;5;12
96;04.01.2016;2016;01;19;Maanantai;11;13;24;6;9;15
96;04.01.2016;2016;01;20;Maanantai;9;9;18;4;6;10
96;04.01.2016;2016;01;21;Maanantai;6;11;17;2;11;13
96;04.01.2016;2016;01;22;Maanantai;5;3;8;1;2;3
96;04.01.2016;2016;01;23;Maanantai;2;1;3;1;0;1
96;05.01.2016;2016;01;00;Tiistai;3;2;5;0;1;1
96;05.01.2016;2016;01;01;Tiistai;1;2;3;0;0;0
96;05.01.2016;2016;01;02;Tiistai;0;0;0;0;0;0
96;05.01.2016;2016;01;03;Tiistai;0;0;0;0;0;0
96;05.01.2016;2016;01;04;Tiistai;1;0;1;0;0;0
96;05.01.2016;2016;01;05;Tiistai;5;1;6;1;1;2
96;05.01.2016;2016;01;06;Tiistai;20;14;34;7;2;9
96;05.01.2016;2016;01;07;Tiistai;38;37;75;28;14;42
96;05.01.2016;2016;01;08;Tiistai;31;35;66;14;7;21
96;05.01.2016;2016;01;09;Tiistai;16;15;31;5;9;14
96;05.01.2016;2016;01;10;Tiistai;15;14;29;5;7;12
96;05.01.2016;2016;01;11;Tiistai;13;19;32;15;15;30
96;05.01.2016;2016;01;12;Tiistai;22;24;46;7;15;22
96;05.01.2016;2016;01;13;Tiistai;24;29;53;7;11;18
96;05.01.2016;2016;01;14;Tiistai;28;38;66;3;15;18
96;05.01.2016;2016;01;15;Tiistai;18;62;80;7;23;30
96;05.01.2016;2016;01;16;Tiistai;31;36;67;7;30;37
96;05.01.2016;2016;01;17;Tiistai;22;14;36;18;26;44
96;05.01.2016;2016;01;18;Tiistai;10;25;35;8;5;13
96;05.01.2016;2016;01;19;Tiistai;18;11;29;6;4;10
96;05.01.2016;2016;01;20;Tiistai;23;4;27;7;6;13
96;05.01.2016;2016;01;21;Tiistai;7;13;20;4;4;8
96;05.01.2016;2016;01;22;Tiistai;3;2;5;0;4;4
96;05.01.2016;2016;01;23;Tiistai;4;2;6;4;1;5
96;06.01.2016;2016;01;00;Keskiviikko;7;4;11;2;0;2
96;06.01.2016;2016;01;01;Keskiviikko;3;1;4;0;1;1
96;06.01.2016;2016;01;02;Keskiviikko;0;0;0;0;0;0
96;06.01.2016;2016;01;03;Keskiviikko;1;0;1;0;0;0
96;06.01.2016;2016;01;04;Keskiviikko;0;1;1;1;0;1
96;06.01.2016;2016;01;05;Keskiviikko;0;0;0;1;0;1
96;06.01.2016;2016;01;06;Keskiviikko;9;3;12;8;2;10
96;06.01.2016;2016;01;07;Keskiviikko;1;4;5;3;6;9
96;06.01.2016;2016;01;08;Keskiviikko;3;6;9;1;1;2
96;06.01.2016;2016;01;09;Keskiviikko;2;2;4;2;2;4
96;06.01.2016;2016;01;10;Keskiviikko;1;4;5;4;6;10
96;06.01.2016;2016;01;11;Keskiviikko;7;5;12;1;4;5
96;06.01.2016;2016;01;12;Keskiviikko;4;8;12;6;2;8
96;06.01.2016;2016;01;13;Keskiviikko;8;7;15;7;6;13
96;06.01.2016;2016;01;14;Keskiviikko;3;7;10;2;11;13
96;06.01.2016;2016;01;15;Keskiviikko;5;11;16;3;13;16
96;06.01.2016;2016;01;16;Keskiviikko;10;5;15;7;4;11
96;06.01.2016;2016;01;17;Keskiviikko;11;8;19;5;3;8
96;06.01.2016;2016;01;18;Keskiviikko;9;7;16;2;6;8
96;06.01.2016;2016;01;19;Keskiviikko;6;4;10;3;5;8
96;06.01.2016;2016;01;20;Keskiviikko;6;4;10;8;5;13
96;06.01.2016;2016;01;21;Keskiviikko;1;5;6;0;5;5
96;06.01.2016;2016;01;22;Keskiviikko;2;1;3;1;1;2
96;06.01.2016;2016;01;23;Keskiviikko;4;2;6;0;1;1
96;07.01.2016;2016;01;00;Torstai;3;0;3;0;0;0
96;07.01.2016;2016;01;01;Torstai;0;0;0;0;0;0
96;07.01.2016;2016;01;02;Torstai;1;0;1;0;0;0
96;07.01.2016;2016;01;03;Torstai;1;0;1;1;0;1
96;07.01.2016;2016;01;04;Torstai;1;1;2;0;0;0
96;07.01.2016;2016;01;05;Torstai;1;6;7;1;0;1
96;07.01.2016;2016;01;06;Torstai;18;4;22;16;5;21
96;07.01.2016;2016;01;07;Torstai;29;24;53;34;14;48
96;07.01.2016;2016;01;08;Torstai;28;15;43;14;10;24
96;07.01.2016;2016;01;09;Torstai;29;13;42;18;8;26
96;07.01.2016;2016;01;10;Torstai;10;8;18;5;5;10
96;07.01.2016;2016;01;11;Torstai;12;15;27;10;8;18
96;07.01.2016;2016;01;12;Torstai;15;9;24;10;17;27
96;07.01.2016;2016;01;13;Torstai;12;12;24;6;19;25
96;07.01.2016;2016;01;14;Torstai;18;38;56;6;22;28
96;07.01.2016;2016;01;15;Torstai;20;36;56;13;38;51
96;07.01.2016;2016;01;16;Torstai;31;42;73;14;35;49
96;07.01.2016;2016;01;17;Torstai;12;13;25;8;18;26
96;07.01.2016;2016;01;18;Torstai;13;5;18;10;6;16
96;07.01.2016;2016;01;19;Torstai;15;7;22;12;6;18
96;07.01.2016;2016;01;20;Torstai;13;14;27;4;5;9
96;07.01.2016;2016;01;21;Torstai;4;7;11;3;7;10
96;07.01.2016;2016;01;22;Torstai;6;4;10;1;2;3
96;07.01.2016;2016;01;23;Torstai;2;0;2;0;0;0
96;08.01.2016;2016;01;00;Perjantai;1;0;1;0;1;1
96;08.01.2016;2016;01;01;Perjantai;0;0;0;0;0;0
96;08.01.2016;2016;01;02;Perjantai;2;0;2;1;0;1
96;08.01.2016;2016;01;03;Perjantai;0;0;0;1;0;1
96;08.01.2016;2016;01;04;Perjantai;1;1;2;0;0;0
96;08.01.2016;2016;01;05;Perjantai;1;1;2;1;1;2
96;08.01.2016;2016;01;06;Perjantai;19;7;26;10;6;16
96;08.01.2016;2016;01;07;Perjantai;29;20;49;23;10;33
96;08.01.2016;2016;01;08;Perjantai;31;24;55;19;15;34
96;08.01.2016;2016;01;09;Perjantai;17;24;41;12;3;15
96;08.01.2016;2016;01;10;Perjantai;20;13;33;8;14;22
96;08.01.2016;2016;01;11;Perjantai;20;15;35;7;10;17
96;08.01.2016;2016;01;12;Perjantai;19;31;50;13;13;26
96;08.01.2016;2016;01;13;Perjantai;27;42;69;10;16;26
96;08.01.2016;2016;01;14;Perjantai;24;65;89;8;29;37
96;08.01.2016;2016;01;15;Perjantai;31;56;87;9;47;56
96;08.01.2016;2016;01;16;Perjantai;18;27;45;11;16;27
96;08.01.2016;2016;01;17;Perjantai;19;20;39;4;12;16
96;08.01.2016;2016;01;18;Perjantai;26;17;43;8;11;19
96;08.01.2016;2016;01;19;Perjantai;13;8;21;5;7;12
96;08.01.2016;2016;01;20;Perjantai;22;8;30;2;1;3
96;08.01.2016;2016;01;21;Perjantai;5;15;20;4;13;17
96;08.01.2016;2016;01;22;Perjantai;9;3;12;0;2;2
96;08.01.2016;2016;01;23;Perjantai;4;3;7;0;3;3
96;09.01.2016;2016;01;00;Lauantai;0;4;4;0;0;0
96;09.01.2016;2016;01;01;Lauantai;1;2;3;1;0;1
96;09.01.2016;2016;01;02;Lauantai;1;0;1;0;0;0
96;09.01.2016;2016;01;03;Lauantai;5;1;6;1;0;1
96;09.01.2016;2016;01;04;Lauantai;2;0;2;1;0;1
96;09.01.2016;2016;01;05;Lauantai;1;0;1;0;1;1
96;09.01.2016;2016;01;06;Lauantai;5;4;9;5;1;6
96;09.01.2016;2016;01;07;Lauantai;2;11;13;4;2;6
96;09.01.2016;2016;01;08;Lauantai;3;7;10;1;1;2
96;09.01.2016;2016;01;09;Lauantai;7;5;12;2;4;6
96;09.01.2016;2016;01;10;Lauantai;5;13;18;5;1;6
96;09.01.2016;2016;01;11;Lauantai;13;11;24;8;7;15
96;09.01.2016;2016;01;12;Lauantai;18;13;31;5;3;8
96;09.01.2016;2016;01;13;Lauantai;21;26;47;11;11;22
96;09.01.2016;2016;01;14;Lauantai;13;19;32;12;10;22
96;09.01.2016;2016;01;15;Lauantai;19;24;43;10;15;25
96;09.01.2016;2016;01;16;Lauantai;13;17;30;6;6;12
96;09.01.2016;2016;01;17;Lauantai;15;10;25;3;4;7
96;09.01.2016;2016;01;18;Lauantai;22;10;32;16;9;25
96;09.01.2016;2016;01;19;Lauantai;10;6;16;11;13;24
96;09.01.2016;2016;01;20;Lauantai;10;11;21;2;5;7
96;09.01.2016;2016;01;21;Lauantai;7;13;20;5;4;9
96;09.01.2016;2016;01;22;Lauantai;3;4;7;2;1;3
96;09.01.2016;2016;01;23;Lauantai;7;6;13;0;0;0
96;10.01.2016;2016;01;00;Sunnuntai;0;3;3;0;0;0
96;10.01.2016;2016;01;01;Sunnuntai;2;1;3;0;1;1
96;10.01.2016;2016;01;02;Sunnuntai;3;0;3;0;1;1
96;10.01.2016;2016;01;03;Sunnuntai;5;1;6;2;0;2
96;10.01.2016;2016;01;04;Sunnuntai;4;0;4;1;1;2
96;10.01.2016;2016;01;05;Sunnuntai;0;0;0;0;0;0
96;10.01.2016;2016;01;06;Sunnuntai;12;4;16;5;0;5
96;10.01.2016;2016;01;07;Sunnuntai;2;4;6;1;4;5
96;10.01.2016;2016;01;08;Sunnuntai;5;5;10;1;1;2
96;10.01.2016;2016;01;09;Sunnuntai;1;1;2;8;9;17
96;10.01.2016;2016;01;10;Sunnuntai;6;12;18;6;7;13
96;10.01.2016;2016;01;11;Sunnuntai;10;14;24;12;12;24
96;10.01.2016;2016;01;12;Sunnuntai;14;14;28;17;11;28
96;10.01.2016;2016;01;13;Sunnuntai;16;29;45;17;17;34
96;10.01.2016;2016;01;14;Sunnuntai;13;19;32;17;21;38
96;10.01.2016;2016;01;15;Sunnuntai;20;19;39;6;17;23
96;10.01.2016;2016;01;16;Sunnuntai;35;12;47;15;6;21
96;10.01.2016;2016;01;17;Sunnuntai;22;14;36;6;6;12
96;10.01.2016;2016;01;18;Sunnuntai;20;12;32;11;11;22
96;10.01.2016;2016;01;19;Sunnuntai;12;13;25;12;19;31
96;10.01.2016;2016;01;20;Sunnuntai;6;20;26;8;6;14
96;10.01.2016;2016;01;21;Sunnuntai;10;3;13;2;7;9
96;10.01.2016;2016;01;22;Sunnuntai;3;3;6;1;0;1
96;10.01.2016;2016;01;23;Sunnuntai;3;1;4;2;0;2
96;11.01.2016;2016;01;00;Maanantai;2;1;3;1;0;1
96;11.01.2016;2016;01;01;Maanantai;0;1;1;0;0;0
96;11.01.2016;2016;01;02;Maanantai;1;1;2;0;0;0
96;11.01.2016;2016;01;03;Maanantai;0;0;0;0;0;0
96;11.01.2016;2016;01;04;Maanantai;2;0;2;0;1;1
96;11.01.2016;2016;01;05;Maanantai;0;5;5;2;1;3
96;11.01.2016;2016;01;06;Maanantai;24;15;39;12;6;18
96;11.01.2016;2016;01;07;Maanantai;66;50;116;20;11;31
96;11.01.2016;2016;01;08;Maanantai;105;62;167;17;10;27
96;11.01.2016;2016;01;09;Maanantai;34;39;73;13;13;26
96;11.01.2016;2016;01;10;Maanantai;34;29;63;13;12;25
96;11.01.2016;2016;01;11;Maanantai;30;18;48;7;13;20
96;11.01.2016;2016;01;12;Maanantai;23;38;61;12;10;22
96;11.01.2016;2016;01;13;Maanantai;35;37;72;12;17;29
96;11.01.2016;2016;01;14;Maanantai;38;80;118;7;30;37
96;11.01.2016;2016;01;15;Maanantai;53;108;161;5;37;42
96;11.01.2016;2016;01;16;Maanantai;43;106;149;9;45;54
96;11.01.2016;2016;01;17;Maanantai;43;41;84;6;11;17
96;11.01.2016;2016;01;18;Maanantai;22;23;45;9;14;23
96;11.01.2016;2016;01;19;Maanantai;26;22;48;10;18;28
96;11.01.2016;2016;01;20;Maanantai;24;9;33;7;13;20
96;11.01.2016;2016;01;21;Maanantai;15;16;31;1;4;5
96;11.01.2016;2016;01;22;Maanantai;0;0;0;1;2;3
96;11.01.2016;2016;01;23;Maanantai;7;2;9;1;1;2
96;12.01.2016;2016;01;00;Tiistai;0;2;2;0;1;1
96;12.01.2016;2016;01;01;Tiistai;0;0;0;0;1;1
96;12.01.2016;2016;01;02;Tiistai;0;0;0;0;0;0
96;12.01.2016;2016;01;03;Tiistai;0;0;0;0;0;0
96;12.01.2016;2016;01;04;Tiistai;1;0;1;0;1;1
96;12.01.2016;2016;01;05;Tiistai;3;3;6;0;0;0
96;12.01.2016;2016;01;06;Tiistai;19;19;38;5;4;9
96;12.01.2016;2016;01;07;Tiistai;61;51;112;6;12;18
96;12.01.2016;2016;01;08;Tiistai;109;78;187;16;6;22
96;12.01.2016;2016;01;09;Tiistai;56;43;99;10;8;18
96;12.01.2016;2016;01;10;Tiistai;38;25;63;2;9;11
96;12.01.2016;2016;01;11;Tiistai;34;29;63;12;11;23
96;12.01.2016;2016;01;12;Tiistai;37;40;77;5;13;18
96;12.01.2016;2016;01;13;Tiistai;31;47;78;1;11;12
96;12.01.2016;2016;01;14;Tiistai;24;73;97;4;24;28
96;12.01.2016;2016;01;15;Tiistai;38;119;157;10;45;55
96;12.01.2016;2016;01;16;Tiistai;67;113;180;8;36;44
96;12.01.2016;2016;01;17;Tiistai;36;47;83;5;12;17
96;12.01.2016;2016;01;18;Tiistai;25;37;62;10;9;19
96;12.01.2016;2016;01;19;Tiistai;29;29;58;2;12;14
96;12.01.2016;2016;01;20;Tiistai;22;23;45;6;8;14
96;12.01.2016;2016;01;21;Tiistai;12;25;37;1;6;7
96;12.01.2016;2016;01;22;Tiistai;5;4;9;2;0;2
96;12.01.2016;2016;01;23;Tiistai;4;1;5;0;0;0
96;13.01.2016;2016;01;00;Keskiviikko;1;1;2;0;0;0
96;13.01.2016;2016;01;01;Keskiviikko;2;0;2;1;0;1
96;13.01.2016;2016;01;02;Keskiviikko;0;2;2;0;0;0
96;13.01.2016;2016;01;03;Keskiviikko;1;1;2;0;0;0
96;13.01.2016;2016;01;04;Keskiviikko;1;0;1;0;0;0
96;13.01.2016;2016;01;05;Keskiviikko;1;3;4;0;1;1
96;13.01.2016;2016;01;06;Keskiviikko;30;18;48;3;4;7
96;13.01.2016;2016;01;07;Keskiviikko;53;50;103;5;10;15
96;13.01.2016;2016;01;08;Keskiviikko;99;66;165;14;13;27
96;13.01.2016;2016;01;09;Keskiviikko;42;40;82;9;10;19
96;13.01.2016;2016;01;10;Keskiviikko;37;22;59;3;11;14
96;13.01.2016;2016;01;11;Keskiviikko;32;35;67;13;12;25
96;13.01.2016;2016;01;12;Keskiviikko;45;40;85;8;14;22
96;13.01.2016;2016;01;13;Keskiviikko;25;45;70;9;9;18
96;13.01.2016;2016;01;14;Keskiviikko;22;107;129;7;15;22
96;13.01.2016;2016;01;15;Keskiviikko;38;96;134;5;36;41
96;13.01.2016;2016;01;16;Keskiviikko;52;100;152;14;31;45
96;13.01.2016;2016;01;17;Keskiviikko;34;36;70;6;9;15
96;13.01.2016;2016;01;18;Keskiviikko;29;21;50;7;13;20
96;13.01.2016;2016;01;19;Keskiviikko;26;33;59;6;10;16
96;13.01.2016;2016;01;20;Keskiviikko;26;26;52;6;7;13
96;13.01.2016;2016;01;21;Keskiviikko;15;21;36;2;8;10
96;13.01.2016;2016;01;22;Keskiviikko;6;10;16;0;3;3
96;13.01.2016;2016;01;23;Keskiviikko;3;2;5;1;1;2
96;14.01.2016;2016;01;00;Torstai;1;0;1;0;0;0
96;14.01.2016;2016;01;01;Torstai;0;0;0;1;0;1
96;14.01.2016;2016;01;02;Torstai;0;1;1;0;0;0
96;14.01.2016;2016;01;03;Torstai;0;0;0;0;0;0
96;14.01.2016;2016;01;04;Torstai;1;0;1;0;0;0
96;14.01.2016;2016;01;05;Torstai;5;2;7;0;1;1
96;14.01.2016;2016;01;06;Torstai;20;18;38;2;6;8
96;14.01.2016;2016;01;07;Torstai;62;55;117;10;10;20
96;14.01.2016;2016;01;08;Torstai;87;67;154;11;13;24
96;14.01.2016;2016;01;09;Torstai;60;38;98;11;5;16
96;14.01.2016;2016;01;10;Torstai;28;35;63;10;13;23
96;14.01.2016;2016;01;11;Torstai;34;38;72;6;12;18
96;14.01.2016;2016;01;12;Torstai;43;47;90;9;4;13
96;14.01.2016;2016;01;13;Torstai;33;51;84;14;17;31
96;14.01.2016;2016;01;14;Torstai;38;64;102;8;21;29
96;14.01.2016;2016;01;15;Torstai;57;112;169;9;36;45
96;14.01.2016;2016;01;16;Torstai;52;97;149;10;29;39
96;14.01.2016;2016;01;17;Torstai;44;37;81;5;14;19
96;14.01.2016;2016;01;18;Torstai;31;26;57;10;13;23
96;14.01.2016;2016;01;19;Torstai;29;23;52;9;17;26
96;14.01.2016;2016;01;20;Torstai;23;22;45;4;8;12
96;14.01.2016;2016;01;21;Torstai;18;19;37;3;4;7
96;14.01.2016;2016;01;22;Torstai;6;7;13;2;4;6
96;14.01.2016;2016;01;23;Torstai;8;4;12;1;0;1
96;15.01.2016;2016;01;00;Perjantai;0;1;1;0;0;0
96;15.01.2016;2016;01;01;Perjantai;0;2;2;1;0;1
96;15.01.2016;2016;01;02;Perjantai;0;0;0;0;0;0
96;15.01.2016;2016;01;03;Perjantai;5;1;6;0;0;0
96;15.01.2016;2016;01;04;Perjantai;4;0;4;0;1;1
96;15.01.2016;2016;01;05;Perjantai;1;3;4;1;0;1
96;15.01.2016;2016;01;06;Perjantai;23;15;38;12;3;15
96;15.01.2016;2016;01;07;Perjantai;48;34;82;13;10;23
96;15.01.2016;2016;01;08;Perjantai;56;53;109;17;2;19
96;15.01.2016;2016;01;09;Perjantai;39;39;78;9;12;21
96;15.01.2016;2016;01;10;Perjantai;33;24;57;7;9;16
96;15.01.2016;2016;01;11;Perjantai;35;25;60;8;4;12
96;15.01.2016;2016;01;12;Perjantai;26;42;68;12;11;23
96;15.01.2016;2016;01;13;Perjantai;39;48;87;11;22;33
96;15.01.2016;2016;01;14;Perjantai;35;78;113;14;31;45
96;15.01.2016;2016;01;15;Perjantai;38;77;115;6;50;56
96;15.01.2016;2016;01;16;Perjantai;46;45;91;16;17;33
96;15.01.2016;2016;01;17;Perjantai;20;28;48;22;17;39
96;15.01.2016;2016;01;18;Perjantai;29;27;56;7;14;21
96;15.01.2016;2016;01;19;Perjantai;15;17;32;6;6;12
96;15.01.2016;2016;01;20;Perjantai;16;16;32;9;5;14
96;15.01.2016;2016;01;21;Perjantai;12;15;27;3;3;6
96;15.01.2016;2016;01;22;Perjantai;7;7;14;1;2;3
96;15.01.2016;2016;01;23;Perjantai;4;6;10;2;2;4
96;16.01.2016;2016;01;00;Lauantai;3;3;6;1;0;1
96;16.01.2016;2016;01;01;Lauantai;1;2;3;3;0;3
96;16.01.2016;2016;01;02;Lauantai;1;1;2;2;1;3
96;16.01.2016;2016;01;03;Lauantai;4;1;5;2;0;2
96;16.01.2016;2016;01;04;Lauantai;1;0;1;0;1;1
96;16.01.2016;2016;01;05;Lauantai;1;1;2;0;1;1
96;16.01.2016;2016;01;06;Lauantai;9;6;15;4;0;4
96;16.01.2016;2016;01;07;Lauantai;2;7;9;1;4;5
96;16.01.2016;2016;01;08;Lauantai;2;12;14;1;5;6
96;16.01.2016;2016;01;09;Lauantai;4;17;21;5;3;8
96;16.01.2016;2016;01;10;Lauantai;8;18;26;7;8;15
96;16.01.2016;2016;01;11;Lauantai;17;23;40;12;13;25
96;16.01.2016;2016;01;12;Lauantai;25;15;40;16;14;30
96;16.01.2016;2016;01;13;Lauantai;28;33;61;13;22;35
96;16.01.2016;2016;01;14;Lauantai;17;24;41;21;20;41
96;16.01.2016;2016;01;15;Lauantai;25;30;55;12;16;28
96;16.01.2016;2016;01;16;Lauantai;15;15;30;11;11;22
96;16.01.2016;2016;01;17;Lauantai;12;11;23;11;10;21
96;16.01.2016;2016;01;18;Lauantai;17;17;34;9;7;16
96;16.01.2016;2016;01;19;Lauantai;19;9;28;7;6;13
96;16.01.2016;2016;01;20;Lauantai;7;11;18;8;12;20
96;16.01.2016;2016;01;21;Lauantai;9;20;29;4;11;15
96;16.01.2016;2016;01;22;Lauantai;2;4;6;2;3;5
96;16.01.2016;2016;01;23;Lauantai;4;5;9;0;2;2
96;17.01.2016;2016;01;00;Sunnuntai;5;1;6;0;0;0
96;17.01.2016;2016;01;01;Sunnuntai;6;3;9;0;2;2
96;17.01.2016;2016;01;02;Sunnuntai;4;1;5;0;0;0
96;17.01.2016;2016;01;03;Sunnuntai;4;0;4;0;0;0
96;17.01.2016;2016;01;04;Sunnuntai;2;0;2;2;1;3
96;17.01.2016;2016;01;05;Sunnuntai;1;1;2;0;0;0
96;17.01.2016;2016;01;06;Sunnuntai;7;3;10;6;1;7
96;17.01.2016;2016;01;07;Sunnuntai;0;5;5;3;3;6
96;17.01.2016;2016;01;08;Sunnuntai;1;1;2;0;3;3
96;17.01.2016;2016;01;09;Sunnuntai;3;2;5;1;3;4
96;17.01.2016;2016;01;10;Sunnuntai;3;4;7;1;1;2
96;17.01.2016;2016;01;11;Sunnuntai;4;5;9;9;3;12
96;17.01.2016;2016;01;12;Sunnuntai;10;11;21;4;12;16
96;17.01.2016;2016;01;13;Sunnuntai;12;12;24;9;11;20
96;17.01.2016;2016;01;14;Sunnuntai;2;6;8;8;6;14
96;17.01.2016;2016;01;15;Sunnuntai;12;10;22;6;6;12
96;17.01.2016;2016;01;16;Sunnuntai;16;5;21;8;4;12
96;17.01.2016;2016;01;17;Sunnuntai;12;5;17;5;5;10
96;17.01.2016;2016;01;18;Sunnuntai;5;6;11;3;2;5
96;17.01.2016;2016;01;19;Sunnuntai;4;7;11;5;9;14
96;17.01.2016;2016;01;20;Sunnuntai;6;12;18;5;6;11
96;17.01.2016;2016;01;21;Sunnuntai;2;7;9;2;7;9
96;17.01.2016;2016;01;22;Sunnuntai;6;4;10;0;1;1
96;17.01.2016;2016;01;23;Sunnuntai;4;0;4;1;1;2
96;18.01.2016;2016;01;00;Maanantai;1;0;1;2;0;2
96;18.01.2016;2016;01;01;Maanantai;0;1;1;1;0;1
96;18.01.2016;2016;01;02;Maanantai;2;0;2;0;0;0
96;18.01.2016;2016;01;03;Maanantai;0;0;0;0;0;0
96;18.01.2016;2016;01;04;Maanantai;1;0;1;0;1;1
96;18.01.2016;2016;01;05;Maanantai;2;3;5;1;0;1
96;18.01.2016;2016;01;06;Maanantai;18;10;28;14;3;17
96;18.01.2016;2016;01;07;Maanantai;70;35;105;35;18;53
96;18.01.2016;2016;01;08;Maanantai;96;43;139;18;13;31
96;18.01.2016;2016;01;09;Maanantai;39;25;64;22;8;30
96;18.01.2016;2016;01;10;Maanantai;32;21;53;17;9;26
96;18.01.2016;2016;01;11;Maanantai;22;20;42;12;10;22
96;18.01.2016;2016;01;12;Maanantai;29;28;57;9;14;23
96;18.01.2016;2016;01;13;Maanantai;17;35;52;11;25;36
96;18.01.2016;2016;01;14;Maanantai;31;72;103;7;18;25
96;18.01.2016;2016;01;15;Maanantai;30;111;141;3;44;47
96;18.01.2016;2016;01;16;Maanantai;50;84;134;13;46;59
96;18.01.2016;2016;01;17;Maanantai;32;48;80;10;14;24
96;18.01.2016;2016;01;18;Maanantai;19;21;40;8;8;16
96;18.01.2016;2016;01;19;Maanantai;13;20;33;6;15;21
96;18.01.2016;2016;01;20;Maanantai;18;17;35;3;8;11
96;18.01.2016;2016;01;21;Maanantai;13;12;25;3;10;13
96;18.01.2016;2016;01;22;Maanantai;4;5;9;1;2;3
96;18.01.2016;2016;01;23;Maanantai;3;0;3;0;0;0
96;19.01.2016;2016;01;00;Tiistai;0;0;0;0;0;0
96;19.01.2016;2016;01;01;Tiistai;0;0;0;0;1;1
96;19.01.2016;2016;01;02;Tiistai;0;0;0;0;0;0
96;19.01.2016;2016;01;03;Tiistai;0;0;0;0;0;0
96;19.01.2016;2016;01;04;Tiistai;1;0;1;0;0;0
96;19.01.2016;2016;01;05;Tiistai;1;1;2;0;0;0
96;19.01.2016;2016;01;06;Tiistai;21;6;27;9;4;13
96;19.01.2016;2016;01;07;Tiistai;47;26;73;21;12;33
96;19.01.2016;2016;01;08;Tiistai;82;26;108;19;8;27
96;19.01.2016;2016;01;09;Tiistai;44;24;68;11;6;17
96;19.01.2016;2016;01;10;Tiistai;21;13;34;13;9;22
96;19.01.2016;2016;01;11;Tiistai;19;23;42;5;11;16
96;19.01.2016;2016;01;12;Tiistai;27;19;46;11;13;24
96;19.01.2016;2016;01;13;Tiistai;20;33;53;3;22;25
96;19.01.2016;2016;01;14;Tiistai;20;50;70;5;19;24
96;19.01.2016;2016;01;15;Tiistai;20;94;114;8;52;60
96;19.01.2016;2016;01;16;Tiistai;24;68;92;5;49;54
96;19.01.2016;2016;01;17;Tiistai;22;49;71;6;22;28
96;19.01.2016;2016;01;18;Tiistai;13;16;29;4;7;11
96;19.01.2016;2016;01;19;Tiistai;27;14;41;3;11;14
96;19.01.2016;2016;01;20;Tiistai;22;14;36;8;6;14
96;19.01.2016;2016;01;21;Tiistai;17;8;25;2;6;8
96;19.01.2016;2016;01;22;Tiistai;4;6;10;1;0;1
96;19.01.2016;2016;01;23;Tiistai;3;0;3;0;0;0
96;20.01.2016;2016;01;00;Keskiviikko;3;1;4;0;0;0
96;20.01.2016;2016;01;01;Keskiviikko;1;0;1;0;0;0
96;20.01.2016;2016;01;02;Keskiviikko;0;1;1;0;0;0
96;20.01.2016;2016;01;03;Keskiviikko;0;0;0;0;0;0
96;20.01.2016;2016;01;04;Keskiviikko;1;0;1;0;0;0
96;20.01.2016;2016;01;05;Keskiviikko;1;2;3;1;0;1
96;20.01.2016;2016;01;06;Keskiviikko;21;9;30;4;7;11
96;20.01.2016;2016;01;07;Keskiviikko;56;30;86;15;7;22
96;20.01.2016;2016;01;08;Keskiviikko;76;37;113;18;8;26
96;20.01.2016;2016;01;09;Keskiviikko;31;26;57;12;5;17
96;20.01.2016;2016;01;10;Keskiviikko;23;17;40;11;7;18
96;20.01.2016;2016;01;11;Keskiviikko;28;30;58;11;7;18
96;20.01.2016;2016;01;12;Keskiviikko;23;20;43;6;11;17
96;20.01.2016;2016;01;13;Keskiviikko;20;26;46;12;19;31
96;20.01.2016;2016;01;14;Keskiviikko;32;54;86;1;32;33
96;20.01.2016;2016;01;15;Keskiviikko;19;81;100;4;44;48
96;20.01.2016;2016;01;16;Keskiviikko;23;80;103;7;37;44
96;20.01.2016;2016;01;17;Keskiviikko;23;39;62;7;19;26
96;20.01.2016;2016;01;18;Keskiviikko;35;14;49;8;16;24
96;20.01.2016;2016;01;19;Keskiviikko;13;12;25;5;12;17
96;20.01.2016;2016;01;20;Keskiviikko;12;20;32;7;4;11
96;20.01.2016;2016;01;21;Keskiviikko;12;15;27;5;9;14
96;20.01.2016;2016;01;22;Keskiviikko;7;3;10;0;4;4
96;20.01.2016;2016;01;23;Keskiviikko;4;3;7;1;0;1
96;21.01.2016;2016;01;00;Torstai;0;2;2;0;0;0
96;21.01.2016;2016;01;01;Torstai;0;0;0;0;0;0
96;21.01.2016;2016;01;02;Torstai;1;0;1;0;0;0
96;21.01.2016;2016;01;03;Torstai;0;0;0;0;0;0
96;21.01.2016;2016;01;04;Torstai;3;1;4;0;0;0
96;21.01.2016;2016;01;05;Torstai;4;2;6;0;1;1
96;21.01.2016;2016;01;06;Torstai;18;7;25;15;6;21
96;21.01.2016;2016;01;07;Torstai;42;25;67;24;8;32
96;21.01.2016;2016;01;08;Torstai;68;22;90;21;10;31
96;21.01.2016;2016;01;09;Torstai;44;22;66;10;11;21
96;21.01.2016;2016;01;10;Torstai;18;15;33;25;16;41
96;21.01.2016;2016;01;11;Torstai;20;14;34;10;7;17
96;21.01.2016;2016;01;12;Torstai;12;20;32;24;15;39
96;21.01.2016;2016;01;13;Torstai;15;22;37;6;16;22
96;21.01.2016;2016;01;14;Torstai;20;54;74;2;30;32
96;21.01.2016;2016;01;15;Torstai;17;71;88;7;52;59
96;21.01.2016;2016;01;16;Torstai;23;61;84;9;39;48
96;21.01.2016;2016;01;17;Torstai;23;22;45;3;13;16
96;21.01.2016;2016;01;18;Torstai;15;19;34;5;8;13
96;21.01.2016;2016;01;19;Torstai;25;4;29;7;9;16
96;21.01.2016;2016;01;20;Torstai;15;17;32;6;4;10
96;21.01.2016;2016;01;21;Torstai;12;11;23;5;12;17
96;21.01.2016;2016;01;22;Torstai;2;8;10;2;1;3
96;21.01.2016;2016;01;23;Torstai;2;0;2;2;0;2
96;22.01.2016;2016;01;00;Perjantai;0;0;0;0;0;0
96;22.01.2016;2016;01;01;Perjantai;0;0;0;0;0;0
96;22.01.2016;2016;01;02;Perjantai;0;0;0;0;0;0
96;22.01.2016;2016;01;03;Perjantai;0;0;0;0;0;0
96;22.01.2016;2016;01;04;Perjantai;4;0;4;0;1;1
96;22.01.2016;2016;01;05;Perjantai;1;2;3;0;1;1
96;22.01.2016;2016;01;06;Perjantai;19;8;27;7;5;12
96;22.01.2016;2016;01;07;Perjantai;47;39;86;15;8;23
96;22.01.2016;2016;01;08;Perjantai;68;45;113;13;6;19
96;22.01.2016;2016;01;09;Perjantai;16;28;44;3;7;10
96;22.01.2016;2016;01;10;Perjantai;30;25;55;8;13;21
96;22.01.2016;2016;01;11;Perjantai;26;36;62;7;12;19
96;22.01.2016;2016;01;12;Perjantai;38;45;83;7;11;18
96;22.01.2016;2016;01;13;Perjantai;37;60;97;6;15;21
96;22.01.2016;2016;01;14;Perjantai;50;71;121;4;36;40
96;22.01.2016;2016;01;15;Perjantai;29;90;119;10;35;45
96;22.01.2016;2016;01;16;Perjantai;35;53;88;5;29;34
96;22.01.2016;2016;01;17;Perjantai;22;19;41;3;13;16
96;22.01.2016;2016;01;18;Perjantai;22;8;30;9;13;22
96;22.01.2016;2016;01;19;Perjantai;15;19;34;7;7;14
96;22.01.2016;2016;01;20;Perjantai;21;16;37;6;5;11
96;22.01.2016;2016;01;21;Perjantai;10;17;27;3;8;11
96;22.01.2016;2016;01;22;Perjantai;7;10;17;2;4;6
96;22.01.2016;2016;01;23;Perjantai;6;2;8;2;0;2
96;23.01.2016;2016;01;00;Lauantai;3;1;4;0;1;1
96;23.01.2016;2016;01;01;Lauantai;2;4;6;2;1;3
96;23.01.2016;2016;01;02;Lauantai;0;2;2;0;1;1
96;23.01.2016;2016;01;03;Lauantai;4;0;4;0;0;0
96;23.01.2016;2016;01;04;Lauantai;1;0;1;0;3;3
96;23.01.2016;2016;01;05;Lauantai;2;1;3;2;0;2
96;23.01.2016;2016;01;06;Lauantai;9;4;13;1;0;1
96;23.01.2016;2016;01;07;Lauantai;2;7;9;0;4;4
96;23.01.2016;2016;01;08;Lauantai;9;14;23;4;5;9
96;23.01.2016;2016;01;09;Lauantai;6;15;21;2;3;5
96;23.01.2016;2016;01;10;Lauantai;8;12;20;3;4;7
96;23.01.2016;2016;01;11;Lauantai;15;17;32;9;10;19
96;23.01.2016;2016;01;12;Lauantai;18;24;42;2;11;13
96;23.01.2016;2016;01;13;Lauantai;12;25;37;7;12;19
96;23.01.2016;2016;01;14;Lauantai;28;32;60;9;12;21
96;23.01.2016;2016;01;15;Lauantai;24;27;51;11;23;34
96;23.01.2016;2016;01;16;Lauantai;18;32;50;4;11;15
96;23.01.2016;2016;01;17;Lauantai;25;12;37;10;7;17
96;23.01.2016;2016;01;18;Lauantai;16;12;28;11;10;21
96;23.01.2016;2016;01;19;Lauantai;17;10;27;10;4;14
96;23.01.2016;2016;01;20;Lauantai;10;12;22;10;7;17
96;23.01.2016;2016;01;21;Lauantai;5;23;28;4;11;15
96;23.01.2016;2016;01;22;Lauantai;7;6;13;1;0;1
96;23.01.2016;2016;01;23;Lauantai;5;7;12;0;3;3
96;24.01.2016;2016;01;00;Sunnuntai;3;2;5;1;1;2
96;24.01.2016;2016;01;01;Sunnuntai;4;1;5;0;0;0
96;24.01.2016;2016;01;02;Sunnuntai;2;1;3;0;0;0
96;24.01.2016;2016;01;03;Sunnuntai;9;1;10;0;0;0
96;24.01.2016;2016;01;04;Sunnuntai;4;0;4;1;1;2
96;24.01.2016;2016;01;05;Sunnuntai;4;1;5;0;2;2
96;24.01.2016;2016;01;06;Sunnuntai;13;4;17;2;0;2
96;24.01.2016;2016;01;07;Sunnuntai;3;5;8;0;4;4
96;24.01.2016;2016;01;08;Sunnuntai;1;2;3;3;4;7
96;24.01.2016;2016;01;09;Sunnuntai;2;5;7;3;3;6
96;24.01.2016;2016;01;10;Sunnuntai;9;9;18;1;8;9
96;24.01.2016;2016;01;11;Sunnuntai;14;13;27;7;9;16
96;24.01.2016;2016;01;12;Sunnuntai;16;13;29;2;10;12
96;24.01.2016;2016;01;13;Sunnuntai;19;20;39;6;10;16
96;24.01.2016;2016;01;14;Sunnuntai;15;22;37;5;11;16
96;24.01.2016;2016;01;15;Sunnuntai;21;37;58;6;8;14
96;24.01.2016;2016;01;16;Sunnuntai;27;9;36;11;11;22
96;24.01.2016;2016;01;17;Sunnuntai;21;18;39;12;8;20
96;24.01.2016;2016;01;18;Sunnuntai;13;16;29;6;11;17
96;24.01.2016;2016;01;19;Sunnuntai;7;12;19;5;13;18
96;24.01.2016;2016;01;20;Sunnuntai;12;14;26;3;5;8
96;24.01.2016;2016;01;21;Sunnuntai;5;10;15;5;7;12
96;24.01.2016;2016;01;22;Sunnuntai;3;4;7;0;1;1
96;24.01.2016;2016;01;23;Sunnuntai;4;3;7;1;0;1
96;25.01.2016;2016;01;00;Maanantai;1;1;2;0;2;2
96;25.01.2016;2016;01;01;Maanantai;2;0;2;0;0;0
96;25.01.2016;2016;01;02;Maanantai;0;0;0;0;0;0
96;25.01.2016;2016;01;03;Maanantai;0;0;0;0;0;0
96;25.01.2016;2016;01;04;Maanantai;3;0;3;2;0;2
96;25.01.2016;2016;01;05;Maanantai;3;4;7;0;0;0
96;25.01.2016;2016;01;06;Maanantai;23;17;40;0;3;3
96;25.01.2016;2016;01;07;Maanantai;67;73;140;11;9;20
96;25.01.2016;2016;01;08;Maanantai;95;85;180;10;6;16
96;25.01.2016;2016;01;09;Maanantai;55;64;119;9;9;18
96;25.01.2016;2016;01;10;Maanantai;40;41;81;13;13;26
96;25.01.2016;2016;01;11;Maanantai;29;44;73;7;19;26
96;25.01.2016;2016;01;12;Maanantai;45;43;88;9;8;17
96;25.01.2016;2016;01;13;Maanantai;34;47;81;4;20;24
96;25.01.2016;2016;01;14;Maanantai;38;83;121;4;25;29
96;25.01.2016;2016;01;15;Maanantai;61;131;192;9;31;40
96;25.01.2016;2016;01;16;Maanantai;65;133;198;6;40;46
96;25.01.2016;2016;01;17;Maanantai;49;48;97;8;22;30
96;25.01.2016;2016;01;18;Maanantai;29;37;66;19;20;39
96;25.01.2016;2016;01;19;Maanantai;41;37;78;10;13;23
96;25.01.2016;2016;01;20;Maanantai;27;23;50;5;11;16
96;25.01.2016;2016;01;21;Maanantai;21;22;43;3;11;14
96;25.01.2016;2016;01;22;Maanantai;9;6;15;1;3;4
96;25.01.2016;2016;01;23;Maanantai;2;1;3;0;0;0
96;26.01.2016;2016;01;00;Tiistai;0;2;2;0;0;0
96;26.01.2016;2016;01;01;Tiistai;0;0;0;0;0;0
96;26.01.2016;2016;01;02;Tiistai;1;0;1;0;0;0
96;26.01.2016;2016;01;03;Tiistai;0;1;1;0;0;0
96;26.01.2016;2016;01;04;Tiistai;3;0;3;0;0;0
96;26.01.2016;2016;01;05;Tiistai;2;5;7;1;0;1
96;26.01.2016;2016;01;06;Tiistai;25;22;47;6;5;11
96;26.01.2016;2016;01;07;Tiistai;70;61;131;7;7;14
96;26.01.2016;2016;01;08;Tiistai;84;69;153;6;5;11
96;26.01.2016;2016;01;09;Tiistai;68;49;117;9;3;12
96;26.01.2016;2016;01;10;Tiistai;38;38;76;13;10;23
96;26.01.2016;2016;01;11;Tiistai;32;33;65;5;8;13
96;26.01.2016;2016;01;12;Tiistai;39;35;74;8;9;17
96;26.01.2016;2016;01;13;Tiistai;29;50;79;9;10;19
96;26.01.2016;2016;01;14;Tiistai;47;50;97;10;11;21
96;26.01.2016;2016;01;15;Tiistai;61;98;159;21;11;32
96;26.01.2016;2016;01;16;Tiistai;73;91;164;18;7;25
96;26.01.2016;2016;01;17;Tiistai;37;37;74;11;1;12
96;26.01.2016;2016;01;18;Tiistai;37;24;61;15;3;18
96;26.01.2016;2016;01;19;Tiistai;37;19;56;13;2;15
96;26.01.2016;2016;01;20;Tiistai;19;23;42;3;0;3
96;26.01.2016;2016;01;21;Tiistai;15;18;33;3;0;3
96;26.01.2016;2016;01;22;Tiistai;9;4;13;1;0;1
96;26.01.2016;2016;01;23;Tiistai;3;3;6;1;1;2
96;27.01.2016;2016;01;00;Keskiviikko;1;0;1;0;0;0
96;27.01.2016;2016;01;01;Keskiviikko;4;1;5;1;0;1
96;27.01.2016;2016;01;02;Keskiviikko;1;0;1;0;0;0
96;27.01.2016;2016;01;03;Keskiviikko;1;0;1;0;0;0
96;27.01.2016;2016;01;04;Keskiviikko;2;2;4;0;0;0
96;27.01.2016;2016;01;05;Keskiviikko;2;5;7;1;0;1
96;27.01.2016;2016;01;06;Keskiviikko;30;18;48;8;4;12
96;27.01.2016;2016;01;07;Keskiviikko;78;59;137;19;6;25
96;27.01.2016;2016;01;08;Keskiviikko;87;75;162;11;0;11
96;27.01.2016;2016;01;09;Keskiviikko;58;39;97;6;6;12
96;27.01.2016;2016;01;10;Keskiviikko;43;30;73;9;6;15
96;27.01.2016;2016;01;11;Keskiviikko;41;34;75;18;5;23
96;27.01.2016;2016;01;12;Keskiviikko;58;38;96;10;8;18
96;27.01.2016;2016;01;13;Keskiviikko;47;43;90;10;7;17
96;27.01.2016;2016;01;14;Keskiviikko;61;73;134;11;6;17
96;27.01.2016;2016;01;15;Keskiviikko;63;120;183;20;7;27
96;27.01.2016;2016;01;16;Keskiviikko;83;87;170;17;8;25
96;27.01.2016;2016;01;17;Keskiviikko;51;46;97;8;8;16
96;27.01.2016;2016;01;18;Keskiviikko;47;41;88;7;14;21
96;27.01.2016;2016;01;19;Keskiviikko;30;32;62;5;8;13
96;27.01.2016;2016;01;20;Keskiviikko;33;30;63;2;7;9
96;27.01.2016;2016;01;21;Keskiviikko;31;33;64;7;6;13
96;27.01.2016;2016;01;22;Keskiviikko;6;4;10;0;3;3
96;27.01.2016;2016;01;23;Keskiviikko;3;0;3;0;0;0
96;28.01.2016;2016;01;00;Torstai;2;0;2;0;0;0
96;28.01.2016;2016;01;01;Torstai;2;0;2;0;0;0
96;28.01.2016;2016;01;02;Torstai;1;0;1;0;0;0
96;28.01.2016;2016;01;03;Torstai;3;0;3;0;0;0
96;28.01.2016;2016;01;04;Torstai;1;0;1;1;0;1
96;28.01.2016;2016;01;05;Torstai;4;4;8;1;0;1
96;28.01.2016;2016;01;06;Torstai;24;19;43;2;2;4
96;28.01.2016;2016;01;07;Torstai;66;55;121;3;5;8
96;28.01.2016;2016;01;08;Torstai;82;87;169;2;7;9
96;28.01.2016;2016;01;09;Torstai;49;56;105;1;3;4
96;28.01.2016;2016;01;10;Torstai;53;53;106;7;14;21
96;28.01.2016;2016;01;11;Torstai;43;47;90;5;5;10
96;28.01.2016;2016;01;12;Torstai;61;57;118;9;5;14
96;28.01.2016;2016;01;13;Torstai;47;42;89;5;16;21
96;28.01.2016;2016;01;14;Torstai;47;78;125;8;12;20
96;28.01.2016;2016;01;15;Torstai;66;96;162;12;11;23
96;28.01.2016;2016;01;16;Torstai;59;93;152;3;8;11
96;28.01.2016;2016;01;17;Torstai;39;46;85;5;5;10
96;28.01.2016;2016;01;18;Torstai;30;25;55;2;9;11
96;28.01.2016;2016;01;19;Torstai;27;19;46;12;15;27
96;28.01.2016;2016;01;20;Torstai;28;23;51;4;3;7
96;28.01.2016;2016;01;21;Torstai;23;22;45;4;6;10
96;28.01.2016;2016;01;22;Torstai;3;6;9;1;0;1
96;28.01.2016;2016;01;23;Torstai;7;4;11;1;2;3
96;29.01.2016;2016;01;00;Perjantai;1;0;1;0;0;0
96;29.01.2016;2016;01;01;Perjantai;1;0;1;0;0;0
96;29.01.2016;2016;01;02;Perjantai;3;0;3;0;0;0
96;29.01.2016;2016;01;03;Perjantai;1;1;2;0;0;0
96;29.01.2016;2016;01;04;Perjantai;1;0;1;0;1;1
96;29.01.2016;2016;01;05;Perjantai;2;2;4;0;0;0
96;29.01.2016;2016;01;06;Perjantai;31;13;44;4;2;6
96;29.01.2016;2016;01;07;Perjantai;58;63;121;9;5;14
96;29.01.2016;2016;01;08;Perjantai;105;67;172;15;11;26
96;29.01.2016;2016;01;09;Perjantai;32;35;67;3;6;9
96;29.01.2016;2016;01;10;Perjantai;38;27;65;8;8;16
96;29.01.2016;2016;01;11;Perjantai;24;45;69;11;31;42
96;29.01.2016;2016;01;12;Perjantai;38;60;98;9;14;23
96;29.01.2016;2016;01;13;Perjantai;35;63;98;7;17;24
96;29.01.2016;2016;01;14;Perjantai;53;122;175;10;17;27
96;29.01.2016;2016;01;15;Perjantai;52;96;148;10;21;31
96;29.01.2016;2016;01;16;Perjantai;42;51;93;5;8;13
96;29.01.2016;2016;01;17;Perjantai;29;28;57;4;13;17
96;29.01.2016;2016;01;18;Perjantai;35;23;58;10;10;20
96;29.01.2016;2016;01;19;Perjantai;20;16;36;7;2;9
96;29.01.2016;2016;01;20;Perjantai;15;13;28;5;2;7
96;29.01.2016;2016;01;21;Perjantai;13;13;26;0;1;1
96;29.01.2016;2016;01;22;Perjantai;6;7;13;0;2;2
96;29.01.2016;2016;01;23;Perjantai;5;4;9;0;0;0
96;30.01.2016;2016;01;00;Lauantai;5;8;13;1;1;2
96;30.01.2016;2016;01;01;Lauantai;2;0;2;0;0;0
96;30.01.2016;2016;01;02;Lauantai;5;3;8;0;0;0
96;30.01.2016;2016;01;03;Lauantai;2;2;4;0;0;0
96;30.01.2016;2016;01;04;Lauantai;4;0;4;1;1;2
96;30.01.2016;2016;01;05;Lauantai;2;3;5;0;0;0
96;30.01.2016;2016;01;06;Lauantai;10;5;15;0;0;0
96;30.01.2016;2016;01;07;Lauantai;6;6;12;0;0;0
96;30.01.2016;2016;01;08;Lauantai;8;11;19;1;0;1
96;30.01.2016;2016;01;09;Lauantai;9;7;16;0;0;0
96;30.01.2016;2016;01;10;Lauantai;14;9;23;2;0;2
96;30.01.2016;2016;01;11;Lauantai;21;13;34;13;4;17
96;30.01.2016;2016;01;12;Lauantai;26;18;44;13;8;21
96;30.01.2016;2016;01;13;Lauantai;18;26;44;10;14;24
96;30.01.2016;2016;01;14;Lauantai;20;33;53;19;16;35
96;30.01.2016;2016;01;15;Lauantai;40;21;61;18;27;45
96;30.01.2016;2016;01;16;Lauantai;19;15;34;11;11;22
96;30.01.2016;2016;01;17;Lauantai;19;12;31;11;6;17
96;30.01.2016;2016;01;18;Lauantai;27;13;40;13;3;16
96;30.01.2016;2016;01;19;Lauantai;22;10;32;15;7;22
96;30.01.2016;2016;01;20;Lauantai;7;14;21;2;3;5
96;30.01.2016;2016;01;21;Lauantai;5;20;25;3;6;9
96;30.01.2016;2016;01;22;Lauantai;2;8;10;2;3;5
96;30.01.2016;2016;01;23;Lauantai;2;6;8;1;2;3
96;31.01.2016;2016;01;00;Sunnuntai;2;12;14;0;0;0
96;31.01.2016;2016;01;01;Sunnuntai;3;0;3;1;1;2
96;31.01.2016;2016;01;02;Sunnuntai;5;2;7;0;0;0
96;31.01.2016;2016;01;03;Sunnuntai;4;0;4;1;0;1
96;31.01.2016;2016;01;04;Sunnuntai;6;0;6;1;1;2
96;31.01.2016;2016;01;05;Sunnuntai;3;1;4;0;0;0
96;31.01.2016;2016;01;06;Sunnuntai;13;2;15;5;0;5
96;31.01.2016;2016;01;07;Sunnuntai;0;4;4;0;4;4
96;31.01.2016;2016;01;08;Sunnuntai;3;6;9;2;2;4
96;31.01.2016;2016;01;09;Sunnuntai;1;7;8;10;5;15
96;31.01.2016;2016;01;10;Sunnuntai;4;7;11;9;10;19
96;31.01.2016;2016;01;11;Sunnuntai;11;8;19;22;12;34
96;31.01.2016;2016;01;12;Sunnuntai;11;19;30;21;21;42
96;31.01.2016;2016;01;13;Sunnuntai;13;18;31;10;22;32
96;31.01.2016;2016;01;14;Sunnuntai;19;23;42;13;15;28
96;31.01.2016;2016;01;15;Sunnuntai;18;26;44;15;14;29
96;31.01.2016;2016;01;16;Sunnuntai;36;9;45;20;8;28
96;31.01.2016;2016;01;17;Sunnuntai;13;17;30;19;5;24
96;31.01.2016;2016;01;18;Sunnuntai;25;13;38;13;22;35
96;31.01.2016;2016;01;19;Sunnuntai;6;16;22;11;14;25
96;31.01.2016;2016;01;20;Sunnuntai;14;20;34;10;10;20
96;31.01.2016;2016;01;21;Sunnuntai;6;11;17;3;7;10
96;31.01.2016;2016;01;22;Sunnuntai;2;1;3;1;1;2
96;31.01.2016;2016;01;23;Sunnuntai;0;0;0;3;2;5
96;01.02.2016;2016;02;00;Maanantai;1;0;1;2;0;2
96;01.02.2016;2016;02;01;Maanantai;1;0;1;0;0;0
96;01.02.2016;2016;02;02;Maanantai;2;0;2;0;0;0
96;01.02.2016;2016;02;03;Maanantai;2;0;2;0;0;0
96;01.02.2016;2016;02;04;Maanantai;1;0;1;1;0;1
96;01.02.2016;2016;02;05;Maanantai;2;6;8;3;4;7
96;01.02.2016;2016;02;06;Maanantai;29;15;44;13;3;16
96;01.02.2016;2016;02;07;Maanantai;94;54;148;33;16;49
96;01.02.2016;2016;02;08;Maanantai;104;89;193;25;8;33
96;01.02.2016;2016;02;09;Maanantai;62;40;102;23;10;33
96;01.02.2016;2016;02;10;Maanantai;46;36;82;28;17;45
96;01.02.2016;2016;02;11;Maanantai;38;33;71;10;13;23
96;01.02.2016;2016;02;12;Maanantai;37;56;93;21;23;44
96;01.02.2016;2016;02;13;Maanantai;42;68;110;18;18;36
96;01.02.2016;2016;02;14;Maanantai;55;83;138;9;25;34
96;01.02.2016;2016;02;15;Maanantai;54;140;194;15;51;66
96;01.02.2016;2016;02;16;Maanantai;62;107;169;17;35;52
96;01.02.2016;2016;02;17;Maanantai;61;55;116;17;15;32
96;01.02.2016;2016;02;18;Maanantai;44;31;75;18;8;26
96;01.02.2016;2016;02;19;Maanantai;33;25;58;13;18;31
96;01.02.2016;2016;02;20;Maanantai;34;19;53;14;11;25
96;01.02.2016;2016;02;21;Maanantai;13;22;35;3;12;15
96;01.02.2016;2016;02;22;Maanantai;5;2;7;2;2;4
96;01.02.2016;2016;02;23;Maanantai;3;1;4;0;1;1
96;02.02.2016;2016;02;00;Tiistai;3;1;4;0;0;0
96;02.02.2016;2016;02;01;Tiistai;1;0;1;0;0;0
96;02.02.2016;2016;02;02;Tiistai;0;0;0;1;0;1
96;02.02.2016;2016;02;03;Tiistai;1;0;1;0;0;0
96;02.02.2016;2016;02;04;Tiistai;1;1;2;0;1;1
96;02.02.2016;2016;02;05;Tiistai;3;3;6;1;1;2
96;02.02.2016;2016;02;06;Tiistai;31;16;47;12;6;18
96;02.02.2016;2016;02;07;Tiistai;83;72;155;26;10;36
96;02.02.2016;2016;02;08;Tiistai;89;81;170;19;11;30
96;02.02.2016;2016;02;09;Tiistai;36;41;77;12;8;20
96;02.02.2016;2016;02;10;Tiistai;24;32;56;7;19;26
96;02.02.2016;2016;02;11;Tiistai;43;28;71;15;16;31
96;02.02.2016;2016;02;12;Tiistai;52;50;102;12;9;21
96;02.02.2016;2016;02;13;Tiistai;36;66;102;10;21;31
96;02.02.2016;2016;02;14;Tiistai;46;62;108;10;24;34
96;02.02.2016;2016;02;15;Tiistai;49;133;182;12;52;64
96;02.02.2016;2016;02;16;Tiistai;62;121;183;17;51;68
96;02.02.2016;2016;02;17;Tiistai;38;50;88;14;17;31
96;02.02.2016;2016;02;18;Tiistai;32;46;78;11;19;30
96;02.02.2016;2016;02;19;Tiistai;37;29;66;13;21;34
96;02.02.2016;2016;02;20;Tiistai;31;23;54;6;13;19
96;02.02.2016;2016;02;21;Tiistai;24;15;39;10;12;22
96;02.02.2016;2016;02;22;Tiistai;4;9;13;1;3;4
96;02.02.2016;2016;02;23;Tiistai;4;4;8;2;1;3
96;03.02.2016;2016;02;00;Keskiviikko;2;0;2;1;0;1
96;03.02.2016;2016;02;01;Keskiviikko;1;0;1;0;0;0
96;03.02.2016;2016;02;02;Keskiviikko;0;0;0;1;0;1
96;03.02.2016;2016;02;03;Keskiviikko;2;0;2;0;0;0
96;03.02.2016;2016;02;04;Keskiviikko;2;0;2;0;1;1
96;03.02.2016;2016;02;05;Keskiviikko;4;5;9;0;0;0
96;03.02.2016;2016;02;06;Keskiviikko;29;13;42;15;5;20
96;03.02.2016;2016;02;07;Keskiviikko;78;73;151;25;7;32
96;03.02.2016;2016;02;08;Keskiviikko;98;74;172;43;19;62
96;03.02.2016;2016;02;09;Keskiviikko;41;51;92;12;10;22
96;03.02.2016;2016;02;10;Keskiviikko;58;45;103;16;11;27
96;03.02.2016;2016;02;11;Keskiviikko;49;33;82;18;13;31
96;03.02.2016;2016;02;12;Keskiviikko;43;38;81;34;25;59
96;03.02.2016;2016;02;13;Keskiviikko;44;64;108;16;24;40
96;03.02.2016;2016;02;14;Keskiviikko;35;97;132;15;24;39
96;03.02.2016;2016;02;15;Keskiviikko;47;134;181;9;36;45
96;03.02.2016;2016;02;16;Keskiviikko;77;113;190;17;33;50
96;03.02.2016;2016;02;17;Keskiviikko;68;52;120;17;11;28
96;03.02.2016;2016;02;18;Keskiviikko;54;35;89;23;20;43
96;03.02.2016;2016;02;19;Keskiviikko;52;30;82;14;16;30
96;03.02.2016;2016;02;20;Keskiviikko;39;33;72;17;16;33
96;03.02.2016;2016;02;21;Keskiviikko;23;25;48;7;11;18
96;03.02.2016;2016;02;22;Keskiviikko;7;6;13;3;7;10
96;03.02.2016;2016;02;23;Keskiviikko;6;5;11;1;1;2
96;04.02.2016;2016;02;00;Torstai;1;0;1;1;0;1
96;04.02.2016;2016;02;01;Torstai;0;0;0;0;0;0
96;04.02.2016;2016;02;02;Torstai;0;0;0;0;1;1
96;04.02.2016;2016;02;03;Torstai;2;0;2;0;0;0
96;04.02.2016;2016;02;04;Torstai;3;0;3;2;1;3
96;04.02.2016;2016;02;05;Torstai;1;5;6;0;1;1
96;04.02.2016;2016;02;06;Torstai;27;17;44;15;4;19
96;04.02.2016;2016;02;07;Torstai;76;86;162;26;8;34
96;04.02.2016;2016;02;08;Torstai;83;64;147;21;20;41
96;04.02.2016;2016;02;09;Torstai;37;59;96;39;36;75
96;04.02.2016;2016;02;10;Torstai;50;45;95;24;23;47
96;04.02.2016;2016;02;11;Torstai;53;38;91;14;20;34
96;04.02.2016;2016;02;12;Torstai;40;47;87;37;52;89
96;04.02.2016;2016;02;13;Torstai;39;66;105;11;23;34
96;04.02.2016;2016;02;14;Torstai;49;84;133;14;26;40
96;04.02.2016;2016;02;15;Torstai;61;117;178;5;33;38
96;04.02.2016;2016;02;16;Torstai;66;108;174;18;43;61
96;04.02.2016;2016;02;17;Torstai;50;57;107;19;17;36
96;04.02.2016;2016;02;18;Torstai;46;36;82;17;18;35
96;04.02.2016;2016;02;19;Torstai;40;27;67;15;18;33
96;04.02.2016;2016;02;20;Torstai;47;21;68;16;12;28
96;04.02.2016;2016;02;21;Torstai;29;28;57;8;12;20
96;04.02.2016;2016;02;22;Torstai;13;17;30;2;9;11
96;04.02.2016;2016;02;23;Torstai;4;4;8;0;1;1
96;05.02.2016;2016;02;00;Perjantai;1;1;2;0;1;1
96;05.02.2016;2016;02;01;Perjantai;4;1;5;1;0;1
96;05.02.2016;2016;02;02;Perjantai;1;0;1;1;0;1
96;05.02.2016;2016;02;03;Perjantai;9;0;9;1;0;1
96;05.02.2016;2016;02;04;Perjantai;9;1;10;2;0;2
96;05.02.2016;2016;02;05;Perjantai;1;3;4;2;0;2
96;05.02.2016;2016;02;06;Perjantai;35;15;50;10;3;13
96;05.02.2016;2016;02;07;Perjantai;67;56;123;30;11;41
96;05.02.2016;2016;02;08;Perjantai;66;67;133;19;8;27
96;05.02.2016;2016;02;09;Perjantai;37;23;60;21;9;30
96;05.02.2016;2016;02;10;Perjantai;40;26;66;19;15;34
96;05.02.2016;2016;02;11;Perjantai;32;42;74;9;13;22
96;05.02.2016;2016;02;12;Perjantai;48;50;98;16;19;35
96;05.02.2016;2016;02;13;Perjantai;31;68;99;11;21;32
96;05.02.2016;2016;02;14;Perjantai;42;84;126;7;22;29
96;05.02.2016;2016;02;15;Perjantai;48;89;137;17;43;60
96;05.02.2016;2016;02;16;Perjantai;35;52;87;8;18;26
96;05.02.2016;2016;02;17;Perjantai;24;49;73;13;11;24
96;05.02.2016;2016;02;18;Perjantai;36;11;47;9;12;21
96;05.02.2016;2016;02;19;Perjantai;29;16;45;12;7;19
96;05.02.2016;2016;02;20;Perjantai;16;8;24;8;6;14
96;05.02.2016;2016;02;21;Perjantai;9;18;27;1;6;7
96;05.02.2016;2016;02;22;Perjantai;11;10;21;2;2;4
96;05.02.2016;2016;02;23;Perjantai;3;5;8;4;1;5
96;06.02.2016;2016;02;00;Lauantai;4;7;11;0;1;1
96;06.02.2016;2016;02;01;Lauantai;2;2;4;0;0;0
96;06.02.2016;2016;02;02;Lauantai;0;0;0;1;1;2
96;06.02.2016;2016;02;03;Lauantai;3;2;5;2;0;2
96;06.02.2016;2016;02;04;Lauantai;2;0;2;2;0;2
96;06.02.2016;2016;02;05;Lauantai;1;1;2;0;0;0
96;06.02.2016;2016;02;06;Lauantai;13;2;15;7;0;7
96;06.02.2016;2016;02;07;Lauantai;2;7;9;4;6;10
96;06.02.2016;2016;02;08;Lauantai;3;9;12;1;4;5
96;06.02.2016;2016;02;09;Lauantai;4;20;24;6;11;17
96;06.02.2016;2016;02;10;Lauantai;10;12;22;10;10;20
96;06.02.2016;2016;02;11;Lauantai;18;15;33;7;12;19
96;06.02.2016;2016;02;12;Lauantai;19;19;38;14;10;24
96;06.02.2016;2016;02;13;Lauantai;23;39;62;7;15;22
96;06.02.2016;2016;02;14;Lauantai;21;46;67;9;11;20
96;06.02.2016;2016;02;15;Lauantai;27;26;53;7;12;19
96;06.02.2016;2016;02;16;Lauantai;24;19;43;8;7;15
96;06.02.2016;2016;02;17;Lauantai;26;9;35;4;6;10
96;06.02.2016;2016;02;18;Lauantai;14;6;20;9;6;15
96;06.02.2016;2016;02;19;Lauantai;21;8;29;8;7;15
96;06.02.2016;2016;02;20;Lauantai;11;9;20;12;6;18
96;06.02.2016;2016;02;21;Lauantai;10;18;28;2;6;8
96;06.02.2016;2016;02;22;Lauantai;4;4;8;0;1;1
96;06.02.2016;2016;02;23;Lauantai;1;3;4;4;2;6
96;07.02.2016;2016;02;00;Sunnuntai;1;4;5;0;0;0
96;07.02.2016;2016;02;01;Sunnuntai;4;0;4;4;0;4
96;07.02.2016;2016;02;02;Sunnuntai;0;0;0;0;0;0
96;07.02.2016;2016;02;03;Sunnuntai;1;1;2;0;0;0
96;07.02.2016;2016;02;04;Sunnuntai;3;2;5;1;0;1
96;07.02.2016;2016;02;05;Sunnuntai;1;2;3;2;0;2
96;07.02.2016;2016;02;06;Sunnuntai;13;1;14;7;3;10
96;07.02.2016;2016;02;07;Sunnuntai;3;2;5;3;4;7
96;07.02.2016;2016;02;08;Sunnuntai;2;4;6;5;1;6
96;07.02.2016;2016;02;09;Sunnuntai;2;3;5;11;2;13
96;07.02.2016;2016;02;10;Sunnuntai;2;10;12;3;1;4
96;07.02.2016;2016;02;11;Sunnuntai;12;8;20;14;4;18
96;07.02.2016;2016;02;12;Sunnuntai;14;20;34;17;7;24
96;07.02.2016;2016;02;13;Sunnuntai;15;23;38;15;7;22
96;07.02.2016;2016;02;14;Sunnuntai;16;10;26;9;12;21
96;07.02.2016;2016;02;15;Sunnuntai;21;22;43;7;10;17
96;07.02.2016;2016;02;16;Sunnuntai;18;11;29;13;6;19
96;07.02.2016;2016;02;17;Sunnuntai;12;12;24;4;3;7
96;07.02.2016;2016;02;18;Sunnuntai;14;21;35;6;15;21
96;07.02.2016;2016;02;19;Sunnuntai;13;10;23;6;9;15
96;07.02.2016;2016;02;20;Sunnuntai;8;15;23;6;6;12
96;07.02.2016;2016;02;21;Sunnuntai;9;6;15;1;2;3
96;07.02.2016;2016;02;22;Sunnuntai;5;3;8;0;2;2
96;07.02.2016;2016;02;23;Sunnuntai;3;3;6;0;1;1
96;08.02.2016;2016;02;00;Maanantai;1;1;2;0;0;0
96;08.02.2016;2016;02;01;Maanantai;0;1;1;0;0;0
96;08.02.2016;2016;02;02;Maanantai;2;0;2;0;0;0
96;08.02.2016;2016;02;03;Maanantai;2;0;2;0;0;0
96;08.02.2016;2016;02;04;Maanantai;4;0;4;0;0;0
96;08.02.2016;2016;02;05;Maanantai;6;3;9;0;1;1
96;08.02.2016;2016;02;06;Maanantai;15;8;23;8;4;12
96;08.02.2016;2016;02;07;Maanantai;55;43;98;15;7;22
96;08.02.2016;2016;02;08;Maanantai;83;54;137;7;6;13
96;08.02.2016;2016;02;09;Maanantai;43;29;72;11;5;16
96;08.02.2016;2016;02;10;Maanantai;43;34;77;17;10;27
96;08.02.2016;2016;02;11;Maanantai;35;14;49;17;16;33
96;08.02.2016;2016;02;12;Maanantai;32;24;56;19;15;34
96;08.02.2016;2016;02;13;Maanantai;31;43;74;12;17;29
96;08.02.2016;2016;02;14;Maanantai;34;37;71;10;23;33
96;08.02.2016;2016;02;15;Maanantai;49;79;128;14;35;49
96;08.02.2016;2016;02;16;Maanantai;60;95;155;16;39;55
96;08.02.2016;2016;02;17;Maanantai;38;32;70;9;13;22
96;08.02.2016;2016;02;18;Maanantai;28;18;46;14;13;27
96;08.02.2016;2016;02;19;Maanantai;17;26;43;5;17;22
96;08.02.2016;2016;02;20;Maanantai;22;14;36;10;9;19
96;08.02.2016;2016;02;21;Maanantai;14;13;27;4;9;13
96;08.02.2016;2016;02;22;Maanantai;6;8;14;2;2;4
96;08.02.2016;2016;02;23;Maanantai;1;2;3;1;0;1
96;09.02.2016;2016;02;00;Tiistai;0;0;0;0;0;0
96;09.02.2016;2016;02;01;Tiistai;0;0;0;0;0;0
96;09.02.2016;2016;02;02;Tiistai;2;1;3;0;0;0
96;09.02.2016;2016;02;03;Tiistai;2;0;2;0;0;0
96;09.02.2016;2016;02;04;Tiistai;2;0;2;0;0;0
96;09.02.2016;2016;02;05;Tiistai;2;3;5;1;1;2
96;09.02.2016;2016;02;06;Tiistai;24;8;32;11;6;17
96;09.02.2016;2016;02;07;Tiistai;59;39;98;39;8;47
96;09.02.2016;2016;02;08;Tiistai;94;55;149;18;6;24
96;09.02.2016;2016;02;09;Tiistai;50;20;70;22;7;29
96;09.02.2016;2016;02;10;Tiistai;35;31;66;11;20;31
96;09.02.2016;2016;02;11;Tiistai;40;19;59;16;13;29
96;09.02.2016;2016;02;12;Tiistai;38;36;74;15;11;26
96;09.02.2016;2016;02;13;Tiistai;29;49;78;10;16;26
96;09.02.2016;2016;02;14;Tiistai;33;41;74;15;25;40
96;09.02.2016;2016;02;15;Tiistai;32;91;123;14;40;54
96;09.02.2016;2016;02;16;Tiistai;45;93;138;15;41;56
96;09.02.2016;2016;02;17;Tiistai;24;46;70;12;17;29
96;09.02.2016;2016;02;18;Tiistai;24;24;48;6;14;20
96;09.02.2016;2016;02;19;Tiistai;27;13;40;6;17;23
96;09.02.2016;2016;02;20;Tiistai;29;9;38;12;7;19
96;09.02.2016;2016;02;21;Tiistai;16;12;28;11;3;14
96;09.02.2016;2016;02;22;Tiistai;8;8;16;3;1;4
96;09.02.2016;2016;02;23;Tiistai;1;0;1;1;0;1
96;10.02.2016;2016;02;00;Keskiviikko;2;0;2;0;0;0
96;10.02.2016;2016;02;01;Keskiviikko;2;1;3;3;4;7
96;10.02.2016;2016;02;02;Keskiviikko;1;0;1;0;0;0
96;10.02.2016;2016;02;03;Keskiviikko;4;0;4;1;0;1
96;10.02.2016;2016;02;04;Keskiviikko;2;1;3;0;0;0
96;10.02.2016;2016;02;05;Keskiviikko;2;2;4;0;1;1
96;10.02.2016;2016;02;06;Keskiviikko;31;13;44;11;6;17
96;10.02.2016;2016;02;07;Keskiviikko;63;55;118;29;12;41
96;10.02.2016;2016;02;08;Keskiviikko;98;55;153;16;10;26
96;10.02.2016;2016;02;09;Keskiviikko;56;40;96;18;5;23
96;10.02.2016;2016;02;10;Keskiviikko;40;19;59;9;6;15
96;10.02.2016;2016;02;11;Keskiviikko;40;42;82;16;5;21
96;10.02.2016;2016;02;12;Keskiviikko;29;33;62;13;10;23
96;10.02.2016;2016;02;13;Keskiviikko;26;36;62;9;12;21
96;10.02.2016;2016;02;14;Keskiviikko;33;78;111;5;21;26
96;10.02.2016;2016;02;15;Keskiviikko;50;116;166;11;39;50
96;10.02.2016;2016;02;16;Keskiviikko;59;91;150;10;29;39
96;10.02.2016;2016;02;17;Keskiviikko;57;38;95;14;14;28
96;10.02.2016;2016;02;18;Keskiviikko;32;26;58;13;14;27
96;10.02.2016;2016;02;19;Keskiviikko;39;27;66;13;12;25
96;10.02.2016;2016;02;20;Keskiviikko;30;16;46;13;9;22
96;10.02.2016;2016;02;21;Keskiviikko;14;17;31;2;15;17
96;10.02.2016;2016;02;22;Keskiviikko;9;3;12;1;4;5
96;10.02.2016;2016;02;23;Keskiviikko;3;2;5;2;1;3
96;11.02.2016;2016;02;00;Torstai;4;2;6;0;0;0
96;11.02.2016;2016;02;01;Torstai;1;0;1;0;0;0
96;11.02.2016;2016;02;02;Torstai;0;0;0;1;0;1
96;11.02.2016;2016;02;03;Torstai;3;0;3;1;0;1
96;11.02.2016;2016;02;04;Torstai;1;1;2;0;0;0
96;11.02.2016;2016;02;05;Torstai;4;4;8;0;1;1
96;11.02.2016;2016;02;06;Torstai;25;11;36;10;4;14
96;11.02.2016;2016;02;07;Torstai;67;64;131;32;10;42
96;11.02.2016;2016;02;08;Torstai;81;65;146;17;7;24
96;11.02.2016;2016;02;09;Torstai;65;38;103;19;5;24
96;11.02.2016;2016;02;10;Torstai;49;40;89;11;12;23
96;11.02.2016;2016;02;11;Torstai;39;26;65;10;16;26
96;11.02.2016;2016;02;12;Torstai;48;43;91;20;6;26
96;11.02.2016;2016;02;13;Torstai;41;67;108;10;24;34
96;11.02.2016;2016;02;14;Torstai;32;85;117;7;20;27
96;11.02.2016;2016;02;15;Torstai;51;85;136;11;41;52
96;11.02.2016;2016;02;16;Torstai;63;101;164;21;25;46
96;11.02.2016;2016;02;17;Torstai;42;48;90;22;19;41
96;11.02.2016;2016;02;18;Torstai;31;34;65;10;11;21
96;11.02.2016;2016;02;19;Torstai;34;20;54;9;12;21
96;11.02.2016;2016;02;20;Torstai;32;13;45;15;8;23
96;11.02.2016;2016;02;21;Torstai;13;16;29;4;8;12
96;11.02.2016;2016;02;22;Torstai;5;6;11;1;4;5
96;11.02.2016;2016;02;23;Torstai;5;4;9;0;0;0
96;12.02.2016;2016;02;00;Perjantai;1;4;5;0;0;0
96;12.02.2016;2016;02;01;Perjantai;0;0;0;1;1;2
96;12.02.2016;2016;02;02;Perjantai;2;1;3;0;0;0
96;12.02.2016;2016;02;03;Perjantai;6;1;7;0;0;0
96;12.02.2016;2016;02;04;Perjantai;1;1;2;0;0;0
96;12.02.2016;2016;02;05;Perjantai;2;4;6;0;1;1
96;12.02.2016;2016;02;06;Perjantai;22;9;31;11;4;15
96;12.02.2016;2016;02;07;Perjantai;32;56;88;35;11;46
96;12.02.2016;2016;02;08;Perjantai;79;55;134;16;11;27
96;12.02.2016;2016;02;09;Perjantai;45;33;78;14;8;22
96;12.02.2016;2016;02;10;Perjantai;54;28;82;11;9;20
96;12.02.2016;2016;02;11;Perjantai;30;30;60;7;9;16
96;12.02.2016;2016;02;12;Perjantai;30;41;71;11;7;18
96;12.02.2016;2016;02;13;Perjantai;28;48;76;11;30;41
96;12.02.2016;2016;02;14;Perjantai;39;79;118;6;26;32
96;12.02.2016;2016;02;15;Perjantai;45;76;121;10;36;46
96;12.02.2016;2016;02;16;Perjantai;42;27;69;6;21;27
96;12.02.2016;2016;02;17;Perjantai;10;24;34;9;11;20
96;12.02.2016;2016;02;18;Perjantai;26;14;40;6;14;20
96;12.02.2016;2016;02;19;Perjantai;15;11;26;10;5;15
96;12.02.2016;2016;02;20;Perjantai;16;10;26;6;6;12
96;12.02.2016;2016;02;21;Perjantai;9;8;17;5;8;13
96;12.02.2016;2016;02;22;Perjantai;2;13;15;0;5;5
96;12.02.2016;2016;02;23;Perjantai;4;2;6;4;0;4
96;13.02.2016;2016;02;00;Lauantai;6;2;8;1;0;1
96;13.02.2016;2016;02;01;Lauantai;2;2;4;2;0;2
96;13.02.2016;2016;02;02;Lauantai;7;1;8;3;1;4
96;13.02.2016;2016;02;03;Lauantai;4;0;4;2;5;7
96;13.02.2016;2016;02;04;Lauantai;3;1;4;1;0;1
96;13.02.2016;2016;02;05;Lauantai;1;1;2;2;0;2
96;13.02.2016;2016;02;06;Lauantai;8;3;11;10;2;12
96;13.02.2016;2016;02;07;Lauantai;1;11;12;3;5;8
96;13.02.2016;2016;02;08;Lauantai;2;10;12;6;8;14
96;13.02.2016;2016;02;09;Lauantai;7;14;21;2;6;8
96;13.02.2016;2016;02;10;Lauantai;6;14;20;3;5;8
96;13.02.2016;2016;02;11;Lauantai;16;22;38;12;12;24
96;13.02.2016;2016;02;12;Lauantai;24;17;41;13;18;31
96;13.02.2016;2016;02;13;Lauantai;31;24;55;7;16;23
96;13.02.2016;2016;02;14;Lauantai;18;22;40;8;8;16
96;13.02.2016;2016;02;15;Lauantai;16;13;29;11;8;19
96;13.02.2016;2016;02;16;Lauantai;11;15;26;8;5;13
96;13.02.2016;2016;02;17;Lauantai;22;14;36;8;9;17
96;13.02.2016;2016;02;18;Lauantai;11;16;27;9;8;17
96;13.02.2016;2016;02;19;Lauantai;14;9;23;7;6;13
96;13.02.2016;2016;02;20;Lauantai;9;11;20;6;13;19
96;13.02.2016;2016;02;21;Lauantai;2;13;15;3;5;8
96;13.02.2016;2016;02;22;Lauantai;2;4;6;1;2;3
96;13.02.2016;2016;02;23;Lauantai;3;3;6;0;0;0
96;14.02.2016;2016;02;00;Sunnuntai;1;2;3;2;1;3
96;14.02.2016;2016;02;01;Sunnuntai;3;0;3;2;0;2
96;14.02.2016;2016;02;02;Sunnuntai;4;1;5;3;1;4
96;14.02.2016;2016;02;03;Sunnuntai;4;0;4;4;0;4
96;14.02.2016;2016;02;04;Sunnuntai;10;0;10;1;1;2
96;14.02.2016;2016;02;05;Sunnuntai;0;0;0;3;1;4
96;14.02.2016;2016;02;06;Sunnuntai;8;4;12;8;1;9
96;14.02.2016;2016;02;07;Sunnuntai;1;5;6;1;6;7
96;14.02.2016;2016;02;08;Sunnuntai;3;4;7;3;2;5
96;14.02.2016;2016;02;09;Sunnuntai;4;5;9;6;2;8
96;14.02.2016;2016;02;10;Sunnuntai;13;7;20;3;6;9
96;14.02.2016;2016;02;11;Sunnuntai;7;12;19;12;14;26
96;14.02.2016;2016;02;12;Sunnuntai;20;21;41;7;11;18
96;14.02.2016;2016;02;13;Sunnuntai;20;9;29;10;8;18
96;14.02.2016;2016;02;14;Sunnuntai;21;24;45;7;18;25
96;14.02.2016;2016;02;15;Sunnuntai;27;16;43;3;12;15
96;14.02.2016;2016;02;16;Sunnuntai;22;13;35;9;3;12
96;14.02.2016;2016;02;17;Sunnuntai;22;11;33;11;6;17
96;14.02.2016;2016;02;18;Sunnuntai;24;23;47;9;16;25
96;14.02.2016;2016;02;19;Sunnuntai;18;15;33;6;15;21
96;14.02.2016;2016;02;20;Sunnuntai;11;12;23;7;9;16
96;14.02.2016;2016;02;21;Sunnuntai;22;16;38;5;3;8
96;14.02.2016;2016;02;22;Sunnuntai;2;6;8;2;0;2
96;14.02.2016;2016;02;23;Sunnuntai;0;1;1;1;1;2
96;15.02.2016;2016;02;00;Maanantai;6;0;6;0;0;0
96;15.02.2016;2016;02;01;Maanantai;1;0;1;0;0;0
96;15.02.2016;2016;02;02;Maanantai;1;0;1;0;0;0
96;15.02.2016;2016;02;03;Maanantai;3;0;3;0;0;0
96;15.02.2016;2016;02;04;Maanantai;2;1;3;0;0;0
96;15.02.2016;2016;02;05;Maanantai;5;3;8;3;2;5
96;15.02.2016;2016;02;06;Maanantai;28;18;46;2;4;6
96;15.02.2016;2016;02;07;Maanantai;76;72;148;11;10;21
96;15.02.2016;2016;02;08;Maanantai;80;85;165;7;15;22
96;15.02.2016;2016;02;09;Maanantai;58;60;118;11;10;21
96;15.02.2016;2016;02;10;Maanantai;56;48;104;11;13;24
96;15.02.2016;2016;02;11;Maanantai;45;43;88;12;11;23
96;15.02.2016;2016;02;12;Maanantai;45;39;84;11;11;22
96;15.02.2016;2016;02;13;Maanantai;44;45;89;13;16;29
96;15.02.2016;2016;02;14;Maanantai;47;79;126;17;22;39
96;15.02.2016;2016;02;15;Maanantai;59;114;173;8;43;51
96;15.02.2016;2016;02;16;Maanantai;65;110;175;14;23;37
96;15.02.2016;2016;02;17;Maanantai;50;58;108;10;9;19
96;15.02.2016;2016;02;18;Maanantai;40;42;82;14;18;32
96;15.02.2016;2016;02;19;Maanantai;36;23;59;17;18;35
96;15.02.2016;2016;02;20;Maanantai;28;19;47;15;16;31
96;15.02.2016;2016;02;21;Maanantai;12;16;28;2;11;13
96;15.02.2016;2016;02;22;Maanantai;5;8;13;1;3;4
96;15.02.2016;2016;02;23;Maanantai;4;3;7;4;2;6
96;16.02.2016;2016;02;00;Tiistai;2;2;4;0;0;0
96;16.02.2016;2016;02;01;Tiistai;0;1;1;0;0;0
96;16.02.2016;2016;02;02;Tiistai;3;0;3;0;1;1
96;16.02.2016;2016;02;03;Tiistai;1;1;2;0;0;0
96;16.02.2016;2016;02;04;Tiistai;2;0;2;0;0;0
96;16.02.2016;2016;02;05;Tiistai;4;4;8;1;1;2
96;16.02.2016;2016;02;06;Tiistai;35;17;52;16;5;21
96;16.02.2016;2016;02;07;Tiistai;82;62;144;40;13;53
96;16.02.2016;2016;02;08;Tiistai;93;61;154;14;10;24
96;16.02.2016;2016;02;09;Tiistai;60;49;109;29;24;53
96;16.02.2016;2016;02;10;Tiistai;31;29;60;13;18;31
96;16.02.2016;2016;02;11;Tiistai;44;36;80;20;18;38
96;16.02.2016;2016;02;12;Tiistai;53;40;93;26;12;38
96;16.02.2016;2016;02;13;Tiistai;55;52;107;14;24;38
96;16.02.2016;2016;02;14;Tiistai;43;62;105;10;39;49
96;16.02.2016;2016;02;15;Tiistai;45;139;184;17;47;64
96;16.02.2016;2016;02;16;Tiistai;56;111;167;18;40;58
96;16.02.2016;2016;02;17;Tiistai;36;43;79;27;23;50
96;16.02.2016;2016;02;18;Tiistai;48;37;85;21;21;42
96;16.02.2016;2016;02;19;Tiistai;45;33;78;12;5;17
96;16.02.2016;2016;02;20;Tiistai;37;23;60;9;10;19
96;16.02.2016;2016;02;21;Tiistai;38;20;58;19;5;24
96;16.02.2016;2016;02;22;Tiistai;11;11;22;0;3;3
96;16.02.2016;2016;02;23;Tiistai;7;1;8;1;3;4
96;17.02.2016;2016;02;00;Keskiviikko;2;0;2;0;0;0
96;17.02.2016;2016;02;01;Keskiviikko;3;0;3;0;0;0
96;17.02.2016;2016;02;02;Keskiviikko;0;1;1;2;0;2
96;17.02.2016;2016;02;03;Keskiviikko;2;0;2;0;0;0
96;17.02.2016;2016;02;04;Keskiviikko;1;0;1;0;0;0
96;17.02.2016;2016;02;05;Keskiviikko;2;3;5;0;2;2
96;17.02.2016;2016;02;06;Keskiviikko;30;22;52;17;2;19
96;17.02.2016;2016;02;07;Keskiviikko;75;54;129;35;12;47
96;17.02.2016;2016;02;08;Keskiviikko;80;78;158;23;21;44
96;17.02.2016;2016;02;09;Keskiviikko;62;42;104;23;17;40
96;17.02.2016;2016;02;10;Keskiviikko;39;31;70;14;14;28
96;17.02.2016;2016;02;11;Keskiviikko;36;42;78;5;13;18
96;17.02.2016;2016;02;12;Keskiviikko;39;79;118;23;48;71
96;17.02.2016;2016;02;13;Keskiviikko;36;51;87;16;17;33
96;17.02.2016;2016;02;14;Keskiviikko;47;69;116;7;17;24
96;17.02.2016;2016;02;15;Keskiviikko;56;119;175;9;39;48
96;17.02.2016;2016;02;16;Keskiviikko;90;102;192;22;43;65
96;17.02.2016;2016;02;17;Keskiviikko;55;50;105;16;19;35
96;17.02.2016;2016;02;18;Keskiviikko;38;24;62;20;20;40
96;17.02.2016;2016;02;19;Keskiviikko;39;36;75;14;21;35
96;17.02.2016;2016;02;20;Keskiviikko;25;23;48;17;17;34
96;17.02.2016;2016;02;21;Keskiviikko;15;19;34;2;13;15
96;17.02.2016;2016;02;22;Keskiviikko;6;8;14;2;2;4
96;17.02.2016;2016;02;23;Keskiviikko;6;2;8;2;1;3
96;18.02.2016;2016;02;00;Torstai;0;1;1;1;2;3
96;18.02.2016;2016;02;01;Torstai;0;1;1;1;0;1
96;18.02.2016;2016;02;02;Torstai;0;1;1;0;0;0
96;18.02.2016;2016;02;03;Torstai;5;0;5;0;0;0
96;18.02.2016;2016;02;04;Torstai;3;0;3;0;0;0
96;18.02.2016;2016;02;05;Torstai;2;1;3;1;1;2
96;18.02.2016;2016;02;06;Torstai;22;15;37;15;7;22
96;18.02.2016;2016;02;07;Torstai;70;83;153;35;11;46
96;18.02.2016;2016;02;08;Torstai;87;69;156;20;19;39
96;18.02.2016;2016;02;09;Torstai;64;32;96;19;15;34
96;18.02.2016;2016;02;10;Torstai;36;50;86;16;14;30
96;18.02.2016;2016;02;11;Torstai;50;37;87;16;19;35
96;18.02.2016;2016;02;12;Torstai;50;49;99;19;15;34
96;18.02.2016;2016;02;13;Torstai;44;63;107;12;24;36
96;18.02.2016;2016;02;14;Torstai;42;70;112;6;30;36
96;18.02.2016;2016;02;15;Torstai;59;109;168;7;40;47
96;18.02.2016;2016;02;16;Torstai;62;115;177;20;33;53
96;18.02.2016;2016;02;17;Torstai;35;62;97;8;24;32
96;18.02.2016;2016;02;18;Torstai;40;40;80;17;19;36
96;18.02.2016;2016;02;19;Torstai;37;31;68;13;11;24
96;18.02.2016;2016;02;20;Torstai;24;30;54;7;8;15
96;18.02.2016;2016;02;21;Torstai;26;28;54;11;13;24
96;18.02.2016;2016;02;22;Torstai;14;6;20;1;5;6
96;18.02.2016;2016;02;23;Torstai;3;1;4;1;3;4
96;19.02.2016;2016;02;00;Perjantai;5;3;8;0;0;0
96;19.02.2016;2016;02;01;Perjantai;3;0;3;1;0;1
96;19.02.2016;2016;02;02;Perjantai;4;0;4;1;1;2
96;19.02.2016;2016;02;03;Perjantai;4;0;4;2;0;2
96;19.02.2016;2016;02;04;Perjantai;3;0;3;3;4;7
96;19.02.2016;2016;02;05;Perjantai;3;2;5;1;2;3
96;19.02.2016;2016;02;06;Perjantai;31;11;42;11;3;14
96;19.02.2016;2016;02;07;Perjantai;70;58;128;34;9;43
96;19.02.2016;2016;02;08;Perjantai;75;72;147;14;11;25
96;19.02.2016;2016;02;09;Perjantai;23;40;63;8;8;16
96;19.02.2016;2016;02;10;Perjantai;46;22;68;5;13;18
96;19.02.2016;2016;02;11;Perjantai;27;36;63;21;17;38
96;19.02.2016;2016;02;12;Perjantai;28;61;89;17;19;36
96;19.02.2016;2016;02;13;Perjantai;33;74;107;8;31;39
96;19.02.2016;2016;02;14;Perjantai;35;86;121;10;67;77
96;19.02.2016;2016;02;15;Perjantai;40;96;136;12;33;45
96;19.02.2016;2016;02;16;Perjantai;70;48;118;45;23;68
96;19.02.2016;2016;02;17;Perjantai;26;27;53;11;9;20
96;19.02.2016;2016;02;18;Perjantai;31;22;53;12;14;26
96;19.02.2016;2016;02;19;Perjantai;23;20;43;5;5;10
96;19.02.2016;2016;02;20;Perjantai;19;12;31;11;11;22
96;19.02.2016;2016;02;21;Perjantai;10;12;22;4;11;15
96;19.02.2016;2016;02;22;Perjantai;6;6;12;2;5;7
96;19.02.2016;2016;02;23;Perjantai;6;3;9;1;1;2
96;20.02.2016;2016;02;00;Lauantai;4;4;8;0;3;3
96;20.02.2016;2016;02;01;Lauantai;2;1;3;0;1;1
96;20.02.2016;2016;02;02;Lauantai;5;0;5;1;0;1
96;20.02.2016;2016;02;03;Lauantai;7;1;8;0;0;0
96;20.02.2016;2016;02;04;Lauantai;3;1;4;5;2;7
96;20.02.2016;2016;02;05;Lauantai;0;1;1;3;0;3
96;20.02.2016;2016;02;06;Lauantai;9;6;15;6;3;9
96;20.02.2016;2016;02;07;Lauantai;2;8;10;2;2;4
96;20.02.2016;2016;02;08;Lauantai;1;9;10;3;4;7
96;20.02.2016;2016;02;09;Lauantai;4;18;22;7;7;14
96;20.02.2016;2016;02;10;Lauantai;16;13;29;6;9;15
96;20.02.2016;2016;02;11;Lauantai;11;18;29;16;17;33
96;20.02.2016;2016;02;12;Lauantai;16;22;38;6;11;17
96;20.02.2016;2016;02;13;Lauantai;19;25;44;12;14;26
96;20.02.2016;2016;02;14;Lauantai;13;28;41;9;7;16
96;20.02.2016;2016;02;15;Lauantai;31;23;54;8;13;21
96;20.02.2016;2016;02;16;Lauantai;19;19;38;12;7;19
96;20.02.2016;2016;02;17;Lauantai;17;25;42;8;9;17
96;20.02.2016;2016;02;18;Lauantai;15;13;28;9;12;21
96;20.02.2016;2016;02;19;Lauantai;18;17;35;8;8;16
96;20.02.2016;2016;02;20;Lauantai;19;9;28;6;9;15
96;20.02.2016;2016;02;21;Lauantai;9;17;26;5;7;12
96;20.02.2016;2016;02;22;Lauantai;8;3;11;5;4;9
96;20.02.2016;2016;02;23;Lauantai;13;4;17;2;2;4
96;21.02.2016;2016;02;00;Sunnuntai;6;12;18;2;2;4
96;21.02.2016;2016;02;01;Sunnuntai;5;3;8;0;0;0
96;21.02.2016;2016;02;02;Sunnuntai;7;1;8;2;0;2
96;21.02.2016;2016;02;03;Sunnuntai;6;0;6;1;0;1
96;21.02.2016;2016;02;04;Sunnuntai;7;0;7;8;5;13
96;21.02.2016;2016;02;05;Sunnuntai;4;3;7;0;1;1
96;21.02.2016;2016;02;06;Sunnuntai;9;2;11;4;0;4
96;21.02.2016;2016;02;07;Sunnuntai;2;5;7;2;4;6
96;21.02.2016;2016;02;08;Sunnuntai;3;3;6;3;3;6
96;21.02.2016;2016;02;09;Sunnuntai;3;2;5;6;4;10
96;21.02.2016;2016;02;10;Sunnuntai;6;9;15;2;6;8
96;21.02.2016;2016;02;11;Sunnuntai;6;13;19;14;2;16
96;21.02.2016;2016;02;12;Sunnuntai;9;10;19;8;16;24
96;21.02.2016;2016;02;13;Sunnuntai;18;15;33;10;16;26
96;21.02.2016;2016;02;14;Sunnuntai;21;17;38;6;8;14
96;21.02.2016;2016;02;15;Sunnuntai;16;21;37;7;6;13
96;21.02.2016;2016;02;16;Sunnuntai;21;16;37;17;10;27
96;21.02.2016;2016;02;17;Sunnuntai;14;17;31;17;14;31
96;21.02.2016;2016;02;18;Sunnuntai;22;17;39;14;20;34
96;21.02.2016;2016;02;19;Sunnuntai;10;9;19;12;16;28
96;21.02.2016;2016;02;20;Sunnuntai;14;16;30;13;17;30
96;21.02.2016;2016;02;21;Sunnuntai;8;6;14;1;8;9
96;21.02.2016;2016;02;22;Sunnuntai;3;4;7;1;2;3
96;21.02.2016;2016;02;23;Sunnuntai;5;2;7;2;0;2
96;22.02.2016;2016;02;00;Maanantai;0;0;0;1;1;2
96;22.02.2016;2016;02;01;Maanantai;1;1;2;0;0;0
96;22.02.2016;2016;02;02;Maanantai;0;0;0;0;0;0
96;22.02.2016;2016;02;03;Maanantai;1;0;1;0;0;0
96;22.02.2016;2016;02;04;Maanantai;2;0;2;0;1;1
96;22.02.2016;2016;02;05;Maanantai;5;5;10;0;1;1
96;22.02.2016;2016;02;06;Maanantai;25;15;40;12;8;20
96;22.02.2016;2016;02;07;Maanantai;74;65;139;26;8;34
96;22.02.2016;2016;02;08;Maanantai;85;73;158;19;16;35
96;22.02.2016;2016;02;09;Maanantai;62;45;107;28;14;42
96;22.02.2016;2016;02;10;Maanantai;50;26;76;8;21;29
96;22.02.2016;2016;02;11;Maanantai;35;32;67;17;12;29
96;22.02.2016;2016;02;12;Maanantai;39;37;76;14;16;30
96;22.02.2016;2016;02;13;Maanantai;48;62;110;8;23;31
96;22.02.2016;2016;02;14;Maanantai;41;58;99;13;24;37
96;22.02.2016;2016;02;15;Maanantai;55;137;192;9;37;46
96;22.02.2016;2016;02;16;Maanantai;69;136;205;10;30;40
96;22.02.2016;2016;02;17;Maanantai;32;55;87;11;18;29
96;22.02.2016;2016;02;18;Maanantai;42;35;77;29;31;60
96;22.02.2016;2016;02;19;Maanantai;42;32;74;11;19;30
96;22.02.2016;2016;02;20;Maanantai;30;17;47;15;18;33
96;22.02.2016;2016;02;21;Maanantai;17;20;37;10;9;19
96;22.02.2016;2016;02;22;Maanantai;9;4;13;2;0;2
96;22.02.2016;2016;02;23;Maanantai;2;0;2;1;0;1
96;23.02.2016;2016;02;00;Tiistai;0;3;3;0;0;0
96;23.02.2016;2016;02;01;Tiistai;0;0;0;1;1;2
96;23.02.2016;2016;02;02;Tiistai;0;1;1;0;1;1
96;23.02.2016;2016;02;03;Tiistai;2;0;2;0;0;0
96;23.02.2016;2016;02;04;Tiistai;1;0;1;1;6;7
96;23.02.2016;2016;02;05;Tiistai;4;4;8;3;1;4
96;23.02.2016;2016;02;06;Tiistai;31;17;48;17;6;23
96;23.02.2016;2016;02;07;Tiistai;92;64;156;35;8;43
96;23.02.2016;2016;02;08;Tiistai;74;60;134;23;16;39
96;23.02.2016;2016;02;09;Tiistai;73;36;109;34;17;51
96;23.02.2016;2016;02;10;Tiistai;39;32;71;16;21;37
96;23.02.2016;2016;02;11;Tiistai;49;27;76;20;20;40
96;23.02.2016;2016;02;12;Tiistai;40;30;70;20;14;34
96;23.02.2016;2016;02;13;Tiistai;39;37;76;18;16;34
96;23.02.2016;2016;02;14;Tiistai;56;81;137;10;33;43
96;23.02.2016;2016;02;15;Tiistai;57;128;185;11;44;55
96;23.02.2016;2016;02;16;Tiistai;54;140;194;15;46;61
96;23.02.2016;2016;02;17;Tiistai;49;48;97;16;14;30
96;23.02.2016;2016;02;18;Tiistai;43;24;67;24;15;39
96;23.02.2016;2016;02;19;Tiistai;30;26;56;21;17;38
96;23.02.2016;2016;02;20;Tiistai;41;7;48;6;10;16
96;23.02.2016;2016;02;21;Tiistai;25;19;44;5;10;15
96;23.02.2016;2016;02;22;Tiistai;7;5;12;1;3;4
96;23.02.2016;2016;02;23;Tiistai;3;1;4;0;0;0
96;24.02.2016;2016;02;00;Keskiviikko;0;0;0;1;0;1
96;24.02.2016;2016;02;01;Keskiviikko;0;3;3;0;0;0
96;24.02.2016;2016;02;02;Keskiviikko;3;1;4;0;0;0
96;24.02.2016;2016;02;03;Keskiviikko;2;0;2;0;0;0
96;24.02.2016;2016;02;04;Keskiviikko;1;0;1;1;0;1
96;24.02.2016;2016;02;05;Keskiviikko;3;5;8;0;3;3
96;24.02.2016;2016;02;06;Keskiviikko;26;20;46;18;4;22
96;24.02.2016;2016;02;07;Keskiviikko;87;62;149;33;10;43
96;24.02.2016;2016;02;08;Keskiviikko;96;70;166;25;20;45
96;24.02.2016;2016;02;09;Keskiviikko;61;41;102;14;9;23
96;24.02.2016;2016;02;10;Keskiviikko;41;31;72;12;13;25
96;24.02.2016;2016;02;11;Keskiviikko;49;43;92;16;14;30
96;24.02.2016;2016;02;12;Keskiviikko;37;46;83;18;14;32
96;24.02.2016;2016;02;13;Keskiviikko;48;47;95;14;10;24
96;24.02.2016;2016;02;14;Keskiviikko;40;103;143;9;26;35
96;24.02.2016;2016;02;15;Keskiviikko;56;127;183;23;36;59
96;24.02.2016;2016;02;16;Keskiviikko;67;105;172;15;38;53
96;24.02.2016;2016;02;17;Keskiviikko;59;45;104;11;19;30
96;24.02.2016;2016;02;18;Keskiviikko;48;42;90;25;16;41
96;24.02.2016;2016;02;19;Keskiviikko;51;31;82;14;12;26
96;24.02.2016;2016;02;20;Keskiviikko;31;27;58;13;12;25
96;24.02.2016;2016;02;21;Keskiviikko;16;20;36;5;8;13
96;24.02.2016;2016;02;22;Keskiviikko;12;7;19;1;1;2
96;24.02.2016;2016;02;23;Keskiviikko;2;4;6;2;0;2
96;25.02.2016;2016;02;00;Torstai;4;1;5;0;0;0
96;25.02.2016;2016;02;01;Torstai;2;0;2;0;0;0
96;25.02.2016;2016;02;02;Torstai;2;0;2;0;0;0
96;25.02.2016;2016;02;03;Torstai;1;0;1;0;0;0
96;25.02.2016;2016;02;04;Torstai;2;1;3;0;0;0
96;25.02.2016;2016;02;05;Torstai;0;3;3;0;0;0
96;25.02.2016;2016;02;06;Torstai;34;15;49;20;6;26
96;25.02.2016;2016;02;07;Torstai;78;65;143;40;14;54
96;25.02.2016;2016;02;08;Torstai;95;55;150;26;19;45
96;25.02.2016;2016;02;09;Torstai;79;38;117;29;11;40
96;25.02.2016;2016;02;10;Torstai;47;38;85;13;9;22
96;25.02.2016;2016;02;11;Torstai;46;46;92;22;15;37
96;25.02.2016;2016;02;12;Torstai;41;60;101;10;12;22
96;25.02.2016;2016;02;13;Torstai;46;48;94;10;22;32
96;25.02.2016;2016;02;14;Torstai;39;94;133;14;34;48
96;25.02.2016;2016;02;15;Torstai;57;102;159;11;44;55
96;25.02.2016;2016;02;16;Torstai;86;107;193;8;33;41
96;25.02.2016;2016;02;17;Torstai;42;46;88;7;12;19
96;25.02.2016;2016;02;18;Torstai;40;32;72;15;18;33
96;25.02.2016;2016;02;19;Torstai;47;24;71;15;20;35
96;25.02.2016;2016;02;20;Torstai;29;18;47;12;12;24
96;25.02.2016;2016;02;21;Torstai;17;16;33;5;9;14
96;25.02.2016;2016;02;22;Torstai;6;6;12;0;1;1
96;25.02.2016;2016;02;23;Torstai;3;0;3;1;0;1
96;26.02.2016;2016;02;00;Perjantai;0;0;0;0;1;1
96;26.02.2016;2016;02;01;Perjantai;0;0;0;0;0;0
96;26.02.2016;2016;02;02;Perjantai;0;0;0;1;0;1
96;26.02.2016;2016;02;03;Perjantai;1;0;1;0;0;0
96;26.02.2016;2016;02;04;Perjantai;1;0;1;0;0;0
96;26.02.2016;2016;02;05;Perjantai;1;2;3;0;0;0
96;26.02.2016;2016;02;06;Perjantai;28;17;45;22;5;27
96;26.02.2016;2016;02;07;Perjantai;60;40;100;34;13;47
96;26.02.2016;2016;02;08;Perjantai;81;63;144;16;7;23
96;26.02.2016;2016;02;09;Perjantai;32;37;69;13;10;23
96;26.02.2016;2016;02;10;Perjantai;42;32;74;8;11;19
96;26.02.2016;2016;02;11;Perjantai;32;26;58;13;16;29
96;26.02.2016;2016;02;12;Perjantai;35;50;85;12;10;22
96;26.02.2016;2016;02;13;Perjantai;36;72;108;16;20;36
96;26.02.2016;2016;02;14;Perjantai;57;81;138;5;29;34
96;26.02.2016;2016;02;15;Perjantai;44;101;145;14;41;55
96;26.02.2016;2016;02;16;Perjantai;42;64;106;13;21;34
96;26.02.2016;2016;02;17;Perjantai;27;43;70;8;20;28
96;26.02.2016;2016;02;18;Perjantai;24;28;52;11;21;32
96;26.02.2016;2016;02;19;Perjantai;29;14;43;10;8;18
96;26.02.2016;2016;02;20;Perjantai;20;20;40;11;13;24
96;26.02.2016;2016;02;21;Perjantai;13;13;26;27;7;34
96;26.02.2016;2016;02;22;Perjantai;13;5;18;2;1;3
96;26.02.2016;2016;02;23;Perjantai;10;6;16;1;0;1
96;27.02.2016;2016;02;00;Lauantai;3;5;8;1;0;1
96;27.02.2016;2016;02;01;Lauantai;1;1;2;0;0;0
96;27.02.2016;2016;02;02;Lauantai;6;1;7;2;1;3
96;27.02.2016;2016;02;03;Lauantai;2;0;2;3;0;3
96;27.02.2016;2016;02;04;Lauantai;8;0;8;4;0;4
96;27.02.2016;2016;02;05;Lauantai;3;1;4;1;1;2
96;27.02.2016;2016;02;06;Lauantai;10;6;16;7;3;10
96;27.02.2016;2016;02;07;Lauantai;3;12;15;4;3;7
96;27.02.2016;2016;02;08;Lauantai;3;18;21;3;5;8
96;27.02.2016;2016;02;09;Lauantai;5;16;21;7;7;14
96;27.02.2016;2016;02;10;Lauantai;9;15;24;6;7;13
96;27.02.2016;2016;02;11;Lauantai;17;19;36;16;18;34
96;27.02.2016;2016;02;12;Lauantai;35;28;63;19;18;37
96;27.02.2016;2016;02;13;Lauantai;33;24;57;12;14;26
96;27.02.2016;2016;02;14;Lauantai;36;22;58;10;16;26
96;27.02.2016;2016;02;15;Lauantai;27;24;51;13;17;30
96;27.02.2016;2016;02;16;Lauantai;22;24;46;14;12;26
96;27.02.2016;2016;02;17;Lauantai;17;17;34;27;11;38
96;27.02.2016;2016;02;18;Lauantai;28;17;45;15;7;22
96;27.02.2016;2016;02;19;Lauantai;20;8;28;5;7;12
96;27.02.2016;2016;02;20;Lauantai;13;8;21;6;2;8
96;27.02.2016;2016;02;21;Lauantai;6;24;30;1;16;17
96;27.02.2016;2016;02;22;Lauantai;8;10;18;0;5;5
96;27.02.2016;2016;02;23;Lauantai;7;8;15;1;0;1
96;28.02.2016;2016;02;00;Sunnuntai;3;0;3;0;0;0
96;28.02.2016;2016;02;01;Sunnuntai;4;0;4;0;0;0
96;28.02.2016;2016;02;02;Sunnuntai;5;1;6;0;0;0
96;28.02.2016;2016;02;03;Sunnuntai;8;0;8;2;0;2
96;28.02.2016;2016;02;04;Sunnuntai;4;1;5;1;0;1
96;28.02.2016;2016;02;05;Sunnuntai;1;2;3;0;1;1
96;28.02.2016;2016;02;06;Sunnuntai;4;3;7;5;1;6
96;28.02.2016;2016;02;07;Sunnuntai;0;11;11;2;5;7
96;28.02.2016;2016;02;08;Sunnuntai;2;5;7;7;2;9
96;28.02.2016;2016;02;09;Sunnuntai;6;6;12;7;5;12
96;28.02.2016;2016;02;10;Sunnuntai;6;17;23;9;11;20
96;28.02.2016;2016;02;11;Sunnuntai;15;7;22;18;16;34
96;28.02.2016;2016;02;12;Sunnuntai;30;31;61;22;22;44
96;28.02.2016;2016;02;13;Sunnuntai;30;26;56;21;12;33
96;28.02.2016;2016;02;14;Sunnuntai;13;17;30;18;20;38
96;28.02.2016;2016;02;15;Sunnuntai;22;21;43;18;22;40
96;28.02.2016;2016;02;16;Sunnuntai;23;23;46;14;18;32
96;28.02.2016;2016;02;17;Sunnuntai;15;15;30;4;5;9
96;28.02.2016;2016;02;18;Sunnuntai;19;15;34;10;14;24
96;28.02.2016;2016;02;19;Sunnuntai;23;18;41;7;8;15
96;28.02.2016;2016;02;20;Sunnuntai;20;8;28;8;2;10
96;28.02.2016;2016;02;21;Sunnuntai;8;18;26;1;16;17
96;28.02.2016;2016;02;22;Sunnuntai;9;3;12;2;0;2
96;28.02.2016;2016;02;23;Sunnuntai;1;2;3;0;0;0
96;29.02.2016;2016;02;00;Maanantai;1;1;2;0;0;0
96;29.02.2016;2016;02;01;Maanantai;0;0;0;0;0;0
96;29.02.2016;2016;02;02;Maanantai;1;0;1;0;0;0
96;29.02.2016;2016;02;03;Maanantai;2;0;2;0;0;0
96;29.02.2016;2016;02;04;Maanantai;2;1;3;0;0;0
96;29.02.2016;2016;02;05;Maanantai;1;3;4;0;0;0
96;29.02.2016;2016;02;06;Maanantai;36;9;45;10;6;16
96;29.02.2016;2016;02;07;Maanantai;80;47;127;37;11;48
96;29.02.2016;2016;02;08;Maanantai;107;53;160;15;10;25
96;29.02.2016;2016;02;09;Maanantai;38;37;75;20;16;36
96;29.02.2016;2016;02;10;Maanantai;42;30;72;12;16;28
96;29.02.2016;2016;02;11;Maanantai;27;36;63;13;16;29
96;29.02.2016;2016;02;12;Maanantai;29;32;61;27;17;44
96;29.02.2016;2016;02;13;Maanantai;34;35;69;18;21;39
96;29.02.2016;2016;02;14;Maanantai;41;77;118;9;25;34
96;29.02.2016;2016;02;15;Maanantai;46;122;168;13;42;55
96;29.02.2016;2016;02;16;Maanantai;65;96;161;16;47;63
96;29.02.2016;2016;02;17;Maanantai;28;39;67;15;19;34
96;29.02.2016;2016;02;18;Maanantai;42;27;69;17;19;36
96;29.02.2016;2016;02;19;Maanantai;37;22;59;17;19;36
96;29.02.2016;2016;02;20;Maanantai;24;23;47;12;9;21
96;29.02.2016;2016;02;21;Maanantai;20;16;36;5;12;17
96;29.02.2016;2016;02;22;Maanantai;10;1;11;1;2;3
96;29.02.2016;2016;02;23;Maanantai;2;4;6;1;2;3
96;01.03.2016;2016;03;00;Tiistai;0;0;0;0;0;0
96;01.03.2016;2016;03;01;Tiistai;0;0;0;0;0;0
96;01.03.2016;2016;03;02;Tiistai;0;0;0;0;0;0
96;01.03.2016;2016;03;03;Tiistai;1;0;1;0;0;0
96;01.03.2016;2016;03;04;Tiistai;2;2;4;0;0;0
96;01.03.2016;2016;03;05;Tiistai;1;5;6;0;1;1
96;01.03.2016;2016;03;06;Tiistai;29;17;46;9;8;17
96;01.03.2016;2016;03;07;Tiistai;91;75;166;34;11;45
96;01.03.2016;2016;03;08;Tiistai;82;84;166;21;11;32
96;01.03.2016;2016;03;09;Tiistai;58;48;106;25;19;44
96;01.03.2016;2016;03;10;Tiistai;32;38;70;12;24;36
96;01.03.2016;2016;03;11;Tiistai;46;33;79;22;22;44
96;01.03.2016;2016;03;12;Tiistai;57;38;95;15;24;39
96;01.03.2016;2016;03;13;Tiistai;53;64;117;27;34;61
96;01.03.2016;2016;03;14;Tiistai;49;80;129;14;40;54
96;01.03.2016;2016;03;15;Tiistai;53;131;184;17;49;66
96;01.03.2016;2016;03;16;Tiistai;69;88;157;23;46;69
96;01.03.2016;2016;03;17;Tiistai;40;39;79;12;19;31
96;01.03.2016;2016;03;18;Tiistai;34;31;65;23;12;35
96;01.03.2016;2016;03;19;Tiistai;52;24;76;27;34;61
96;01.03.2016;2016;03;20;Tiistai;37;18;55;13;11;24
96;01.03.2016;2016;03;21;Tiistai;22;14;36;4;13;17
96;01.03.2016;2016;03;22;Tiistai;7;6;13;0;4;4
96;01.03.2016;2016;03;23;Tiistai;8;3;11;1;1;2
96;02.03.2016;2016;03;00;Keskiviikko;0;0;0;1;0;1
96;02.03.2016;2016;03;01;Keskiviikko;2;0;2;0;0;0
96;02.03.2016;2016;03;02;Keskiviikko;0;0;0;0;1;1
96;02.03.2016;2016;03;03;Keskiviikko;1;0;1;0;0;0
96;02.03.2016;2016;03;04;Keskiviikko;1;1;2;1;0;1
96;02.03.2016;2016;03;05;Keskiviikko;2;5;7;1;0;1
96;02.03.2016;2016;03;06;Keskiviikko;35;20;55;17;9;26
96;02.03.2016;2016;03;07;Keskiviikko;75;72;147;36;15;51
96;02.03.2016;2016;03;08;Keskiviikko;95;68;163;19;12;31
96;02.03.2016;2016;03;09;Keskiviikko;58;59;117;12;13;25
96;02.03.2016;2016;03;10;Keskiviikko;40;26;66;14;19;33
96;02.03.2016;2016;03;11;Keskiviikko;39;43;82;16;13;29
96;02.03.2016;2016;03;12;Keskiviikko;55;43;98;10;30;40
96;02.03.2016;2016;03;13;Keskiviikko;35;54;89;19;44;63
96;02.03.2016;2016;03;14;Keskiviikko;48;80;128;9;40;49
96;02.03.2016;2016;03;15;Keskiviikko;36;106;142;14;58;72
96;02.03.2016;2016;03;16;Keskiviikko;60;95;155;31;50;81
96;02.03.2016;2016;03;17;Keskiviikko;63;65;128;14;29;43
96;02.03.2016;2016;03;18;Keskiviikko;46;54;100;24;18;42
96;02.03.2016;2016;03;19;Keskiviikko;40;27;67;12;10;22
96;02.03.2016;2016;03;20;Keskiviikko;46;20;66;9;11;20
96;02.03.2016;2016;03;21;Keskiviikko;36;18;54;16;12;28
96;02.03.2016;2016;03;22;Keskiviikko;8;6;14;0;6;6
96;02.03.2016;2016;03;23;Keskiviikko;6;2;8;0;1;1
96;03.03.2016;2016;03;00;Torstai;2;1;3;0;0;0
96;03.03.2016;2016;03;01;Torstai;1;0;1;0;0;0
96;03.03.2016;2016;03;02;Torstai;2;1;3;1;0;1
96;03.03.2016;2016;03;03;Torstai;1;1;2;0;0;0
96;03.03.2016;2016;03;04;Torstai;1;1;2;0;0;0
96;03.03.2016;2016;03;05;Torstai;3;5;8;1;1;2
96;03.03.2016;2016;03;06;Torstai;32;17;49;14;8;22
96;03.03.2016;2016;03;07;Torstai;78;66;144;34;7;41
96;03.03.2016;2016;03;08;Torstai;87;75;162;24;20;44
96;03.03.2016;2016;03;09;Torstai;54;32;86;14;16;30
96;03.03.2016;2016;03;10;Torstai;49;33;82;12;16;28
96;03.03.2016;2016;03;11;Torstai;38;35;73;14;28;42
96;03.03.2016;2016;03;12;Torstai;42;53;95;10;26;36
96;03.03.2016;2016;03;13;Torstai;48;61;109;13;37;50
96;03.03.2016;2016;03;14;Torstai;45;81;126;10;25;35
96;03.03.2016;2016;03;15;Torstai;51;91;142;12;46;58
96;03.03.2016;2016;03;16;Torstai;60;87;147;9;44;53
96;03.03.2016;2016;03;17;Torstai;44;49;93;16;12;28
96;03.03.2016;2016;03;18;Torstai;47;33;80;25;19;44
96;03.03.2016;2016;03;19;Torstai;33;18;51;11;17;28
96;03.03.2016;2016;03;20;Torstai;36;10;46;8;11;19
96;03.03.2016;2016;03;21;Torstai;13;18;31;4;4;8
96;03.03.2016;2016;03;22;Torstai;8;11;19;1;1;2
96;03.03.2016;2016;03;23;Torstai;8;3;11;1;2;3
96;04.03.2016;2016;03;00;Perjantai;3;2;5;1;1;2
96;04.03.2016;2016;03;01;Perjantai;2;0;2;0;0;0
96;04.03.2016;2016;03;02;Perjantai;4;0;4;1;0;1
96;04.03.2016;2016;03;03;Perjantai;7;1;8;1;0;1
96;04.03.2016;2016;03;04;Perjantai;6;3;9;1;0;1
96;04.03.2016;2016;03;05;Perjantai;2;2;4;0;0;0
96;04.03.2016;2016;03;06;Perjantai;30;12;42;14;5;19
96;04.03.2016;2016;03;07;Perjantai;62;57;119;26;8;34
96;04.03.2016;2016;03;08;Perjantai;63;52;115;8;10;18
96;04.03.2016;2016;03;09;Perjantai;32;52;84;13;9;22
96;04.03.2016;2016;03;10;Perjantai;40;39;79;11;12;23
96;04.03.2016;2016;03;11;Perjantai;43;31;74;8;19;27
96;04.03.2016;2016;03;12;Perjantai;38;47;85;10;18;28
96;04.03.2016;2016;03;13;Perjantai;41;54;95;14;22;36
96;04.03.2016;2016;03;14;Perjantai;45;91;136;10;22;32
96;04.03.2016;2016;03;15;Perjantai;44;89;133;9;41;50
96;04.03.2016;2016;03;16;Perjantai;44;34;78;8;19;27
96;04.03.2016;2016;03;17;Perjantai;33;37;70;11;12;23
96;04.03.2016;2016;03;18;Perjantai;37;27;64;10;7;17
96;04.03.2016;2016;03;19;Perjantai;21;6;27;7;6;13
96;04.03.2016;2016;03;20;Perjantai;12;18;30;2;3;5
96;04.03.2016;2016;03;21;Perjantai;7;17;24;8;3;11
96;04.03.2016;2016;03;22;Perjantai;9;9;18;0;3;3
96;04.03.2016;2016;03;23;Perjantai;1;9;10;0;0;0
96;05.03.2016;2016;03;00;Lauantai;3;1;4;0;0;0
96;05.03.2016;2016;03;01;Lauantai;3;1;4;0;1;1
96;05.03.2016;2016;03;02;Lauantai;7;0;7;1;0;1
96;05.03.2016;2016;03;03;Lauantai;2;1;3;0;1;1
96;05.03.2016;2016;03;04;Lauantai;10;0;10;3;0;3
96;05.03.2016;2016;03;05;Lauantai;2;1;3;0;0;0
96;05.03.2016;2016;03;06;Lauantai;15;2;17;3;0;3
96;05.03.2016;2016;03;07;Lauantai;1;3;4;0;2;2
96;05.03.2016;2016;03;08;Lauantai;4;16;20;3;8;11
96;05.03.2016;2016;03;09;Lauantai;7;19;26;6;14;20
96;05.03.2016;2016;03;10;Lauantai;9;13;22;7;11;18
96;05.03.2016;2016;03;11;Lauantai;15;11;26;11;11;22
96;05.03.2016;2016;03;12;Lauantai;23;20;43;10;9;19
96;05.03.2016;2016;03;13;Lauantai;27;20;47;11;8;19
96;05.03.2016;2016;03;14;Lauantai;14;29;43;8;9;17
96;05.03.2016;2016;03;15;Lauantai;13;23;36;16;16;32
96;05.03.2016;2016;03;16;Lauantai;18;26;44;10;17;27
96;05.03.2016;2016;03;17;Lauantai;13;11;24;7;5;12
96;05.03.2016;2016;03;18;Lauantai;14;12;26;11;10;21
96;05.03.2016;2016;03;19;Lauantai;18;18;36;13;12;25
96;05.03.2016;2016;03;20;Lauantai;15;7;22;4;16;20
96;05.03.2016;2016;03;21;Lauantai;13;21;34;4;7;11
96;05.03.2016;2016;03;22;Lauantai;4;3;7;1;0;1
96;05.03.2016;2016;03;23;Lauantai;7;1;8;1;0;1
96;06.03.2016;2016;03;00;Sunnuntai;5;5;10;2;0;2
96;06.03.2016;2016;03;01;Sunnuntai;1;3;4;1;0;1
96;06.03.2016;2016;03;02;Sunnuntai;2;0;2;2;1;3
96;06.03.2016;2016;03;03;Sunnuntai;5;0;5;4;0;4
96;06.03.2016;2016;03;04;Sunnuntai;3;0;3;1;0;1
96;06.03.2016;2016;03;05;Sunnuntai;6;1;7;0;2;2
96;06.03.2016;2016;03;06;Sunnuntai;13;7;20;4;0;4
96;06.03.2016;2016;03;07;Sunnuntai;2;2;4;3;9;12
96;06.03.2016;2016;03;08;Sunnuntai;2;4;6;4;6;10
96;06.03.2016;2016;03;09;Sunnuntai;2;6;8;10;8;18
96;06.03.2016;2016;03;10;Sunnuntai;2;8;10;7;5;12
96;06.03.2016;2016;03;11;Sunnuntai;11;12;23;12;15;27
96;06.03.2016;2016;03;12;Sunnuntai;18;18;36;9;15;24
96;06.03.2016;2016;03;13;Sunnuntai;17;24;41;9;13;22
96;06.03.2016;2016;03;14;Sunnuntai;14;10;24;6;15;21
96;06.03.2016;2016;03;15;Sunnuntai;13;13;26;11;9;20
96;06.03.2016;2016;03;16;Sunnuntai;25;6;31;27;8;35
96;06.03.2016;2016;03;17;Sunnuntai;23;16;39;13;7;20
96;06.03.2016;2016;03;18;Sunnuntai;33;11;44;12;8;20
96;06.03.2016;2016;03;19;Sunnuntai;11;12;23;8;13;21
96;06.03.2016;2016;03;20;Sunnuntai;10;22;32;8;8;16
96;06.03.2016;2016;03;21;Sunnuntai;11;18;29;1;4;5
96;06.03.2016;2016;03;22;Sunnuntai;2;2;4;0;4;4
96;06.03.2016;2016;03;23;Sunnuntai;1;2;3;1;0;1
96;07.03.2016;2016;03;00;Maanantai;0;2;2;0;0;0
96;07.03.2016;2016;03;01;Maanantai;1;2;3;0;0;0
96;07.03.2016;2016;03;02;Maanantai;1;0;1;0;0;0
96;07.03.2016;2016;03;03;Maanantai;1;0;1;1;0;1
96;07.03.2016;2016;03;04;Maanantai;2;1;3;0;0;0
96;07.03.2016;2016;03;05;Maanantai;3;3;6;1;3;4
96;07.03.2016;2016;03;06;Maanantai;28;12;40;16;7;23
96;07.03.2016;2016;03;07;Maanantai;47;45;92;25;9;34
96;07.03.2016;2016;03;08;Maanantai;23;34;57;14;15;29
96;07.03.2016;2016;03;09;Maanantai;23;24;47;6;9;15
96;07.03.2016;2016;03;10;Maanantai;19;29;48;4;9;13
96;07.03.2016;2016;03;11;Maanantai;21;29;50;10;9;19
96;07.03.2016;2016;03;12;Maanantai;26;26;52;13;12;25
96;07.03.2016;2016;03;13;Maanantai;40;24;64;13;11;24
96;07.03.2016;2016;03;14;Maanantai;28;36;64;11;12;23
96;07.03.2016;2016;03;15;Maanantai;41;80;121;11;28;39
96;07.03.2016;2016;03;16;Maanantai;41;49;90;13;27;40
96;07.03.2016;2016;03;17;Maanantai;19;31;50;13;13;26
96;07.03.2016;2016;03;18;Maanantai;31;16;47;15;9;24
96;07.03.2016;2016;03;19;Maanantai;25;8;33;9;11;20
96;07.03.2016;2016;03;20;Maanantai;19;8;27;6;7;13
96;07.03.2016;2016;03;21;Maanantai;10;17;27;3;7;10
96;07.03.2016;2016;03;22;Maanantai;2;6;8;4;3;7
96;07.03.2016;2016;03;23;Maanantai;5;1;6;0;0;0
96;08.03.2016;2016;03;00;Tiistai;1;1;2;0;0;0
96;08.03.2016;2016;03;01;Tiistai;0;1;1;0;0;0
96;08.03.2016;2016;03;02;Tiistai;1;0;1;0;0;0
96;08.03.2016;2016;03;03;Tiistai;2;0;2;0;0;0
96;08.03.2016;2016;03;04;Tiistai;1;1;2;1;0;1
96;08.03.2016;2016;03;05;Tiistai;3;4;7;0;1;1
96;08.03.2016;2016;03;06;Tiistai;37;15;52;13;4;17
96;08.03.2016;2016;03;07;Tiistai;41;44;85;29;8;37
96;08.03.2016;2016;03;08;Tiistai;30;45;75;6;5;11
96;08.03.2016;2016;03;09;Tiistai;16;26;42;6;8;14
96;08.03.2016;2016;03;10;Tiistai;22;23;45;7;15;22
96;08.03.2016;2016;03;11;Tiistai;24;31;55;5;26;31
96;08.03.2016;2016;03;12;Tiistai;26;20;46;11;8;19
96;08.03.2016;2016;03;13;Tiistai;34;40;74;13;8;21
96;08.03.2016;2016;03;14;Tiistai;33;45;78;6;20;26
96;08.03.2016;2016;03;15;Tiistai;44;94;138;6;29;35
96;08.03.2016;2016;03;16;Tiistai;57;61;118;27;41;68
96;08.03.2016;2016;03;17;Tiistai;28;28;56;11;12;23
96;08.03.2016;2016;03;18;Tiistai;16;38;54;8;19;27
96;08.03.2016;2016;03;19;Tiistai;25;19;44;6;8;14
96;08.03.2016;2016;03;20;Tiistai;21;14;35;14;9;23
96;08.03.2016;2016;03;21;Tiistai;34;16;50;8;9;17
96;08.03.2016;2016;03;22;Tiistai;7;8;15;1;2;3
96;08.03.2016;2016;03;23;Tiistai;7;5;12;1;0;1
96;09.03.2016;2016;03;00;Keskiviikko;5;2;7;0;2;2
96;09.03.2016;2016;03;01;Keskiviikko;3;0;3;1;0;1
96;09.03.2016;2016;03;02;Keskiviikko;0;0;0;0;0;0
96;09.03.2016;2016;03;03;Keskiviikko;0;0;0;0;0;0
96;09.03.2016;2016;03;04;Keskiviikko;2;2;4;0;0;0
96;09.03.2016;2016;03;05;Keskiviikko;2;3;5;0;1;1
96;09.03.2016;2016;03;06;Keskiviikko;32;10;42;12;6;18
96;09.03.2016;2016;03;07;Keskiviikko;40;41;81;27;14;41
96;09.03.2016;2016;03;08;Keskiviikko;21;52;73;6;13;19
96;09.03.2016;2016;03;09;Keskiviikko;23;22;45;5;13;18
96;09.03.2016;2016;03;10;Keskiviikko;23;39;62;9;12;21
96;09.03.2016;2016;03;11;Keskiviikko;19;20;39;6;15;21
96;09.03.2016;2016;03;12;Keskiviikko;29;27;56;15;11;26
96;09.03.2016;2016;03;13;Keskiviikko;28;28;56;8;11;19
96;09.03.2016;2016;03;14;Keskiviikko;24;36;60;7;9;16
96;09.03.2016;2016;03;15;Keskiviikko;24;65;89;12;41;53
96;09.03.2016;2016;03;16;Keskiviikko;39;30;69;11;36;47
96;09.03.2016;2016;03;17;Keskiviikko;40;15;55;10;18;28
96;09.03.2016;2016;03;18;Keskiviikko;25;13;38;18;18;36
96;09.03.2016;2016;03;19;Keskiviikko;45;7;52;21;21;42
96;09.03.2016;2016;03;20;Keskiviikko;13;5;18;10;32;42
96;09.03.2016;2016;03;21;Keskiviikko;14;13;27;7;25;32
96;09.03.2016;2016;03;22;Keskiviikko;10;3;13;1;11;12
96;09.03.2016;2016;03;23;Keskiviikko;9;1;10;2;1;3
96;10.03.2016;2016;03;00;Torstai;2;0;2;1;0;1
96;10.03.2016;2016;03;01;Torstai;1;0;1;1;0;1
96;10.03.2016;2016;03;02;Torstai;1;0;1;1;0;1
96;10.03.2016;2016;03;03;Torstai;2;0;2;1;0;1
96;10.03.2016;2016;03;04;Torstai;1;0;1;1;0;1
96;10.03.2016;2016;03;05;Torstai;2;1;3;0;2;2
96;10.03.2016;2016;03;06;Torstai;25;10;35;10;2;12
96;10.03.2016;2016;03;07;Torstai;43;33;76;17;15;32
96;10.03.2016;2016;03;08;Torstai;28;40;68;5;16;21
96;10.03.2016;2016;03;09;Torstai;10;22;32;7;7;14
96;10.03.2016;2016;03;10;Torstai;19;32;51;5;8;13
96;10.03.2016;2016;03;11;Torstai;24;29;53;9;12;21
96;10.03.2016;2016;03;12;Torstai;32;19;51;13;17;30
96;10.03.2016;2016;03;13;Torstai;29;22;51;8;12;20
96;10.03.2016;2016;03;14;Torstai;28;40;68;14;12;26
96;10.03.2016;2016;03;15;Torstai;29;56;85;8;43;51
96;10.03.2016;2016;03;16;Torstai;44;49;93;7;28;35
96;10.03.2016;2016;03;17;Torstai;31;26;57;8;11;19
96;10.03.2016;2016;03;18;Torstai;28;13;41;12;13;25
96;10.03.2016;2016;03;19;Torstai;27;5;32;6;14;20
96;10.03.2016;2016;03;20;Torstai;16;8;24;11;15;26
96;10.03.2016;2016;03;21;Torstai;17;10;27;5;8;13
96;10.03.2016;2016;03;22;Torstai;7;2;9;1;5;6
96;10.03.2016;2016;03;23;Torstai;3;1;4;0;1;1
96;11.03.2016;2016;03;00;Perjantai;2;1;3;0;1;1
96;11.03.2016;2016;03;01;Perjantai;2;0;2;1;0;1
96;11.03.2016;2016;03;02;Perjantai;4;0;4;1;0;1
96;11.03.2016;2016;03;03;Perjantai;1;2;3;0;0;0
96;11.03.2016;2016;03;04;Perjantai;1;0;1;0;1;1
96;11.03.2016;2016;03;05;Perjantai;2;2;4;0;1;1
96;11.03.2016;2016;03;06;Perjantai;26;7;33;18;1;19
96;11.03.2016;2016;03;07;Perjantai;31;21;52;21;24;45
96;11.03.2016;2016;03;08;Perjantai;27;34;61;17;13;30
96;11.03.2016;2016;03;09;Perjantai;17;22;39;9;8;17
96;11.03.2016;2016;03;10;Perjantai;16;23;39;4;11;15
96;11.03.2016;2016;03;11;Perjantai;18;24;42;5;11;16
96;11.03.2016;2016;03;12;Perjantai;33;30;63;7;12;19
96;11.03.2016;2016;03;13;Perjantai;25;21;46;11;11;22
96;11.03.2016;2016;03;14;Perjantai;32;43;75;3;18;21
96;11.03.2016;2016;03;15;Perjantai;19;52;71;7;22;29
96;11.03.2016;2016;03;16;Perjantai;28;31;59;4;9;13
96;11.03.2016;2016;03;17;Perjantai;29;12;41;11;8;19
96;11.03.2016;2016;03;18;Perjantai;20;6;26;7;4;11
96;11.03.2016;2016;03;19;Perjantai;19;16;35;7;8;15
96;11.03.2016;2016;03;20;Perjantai;6;12;18;5;5;10
96;11.03.2016;2016;03;21;Perjantai;12;13;25;2;3;5
96;11.03.2016;2016;03;22;Perjantai;3;3;6;2;1;3
96;11.03.2016;2016;03;23;Perjantai;3;2;5;1;1;2
96;12.03.2016;2016;03;00;Lauantai;1;0;1;0;1;1
96;12.03.2016;2016;03;01;Lauantai;5;2;7;1;0;1
96;12.03.2016;2016;03;02;Lauantai;2;0;2;3;0;3
96;12.03.2016;2016;03;03;Lauantai;1;0;1;2;0;2
96;12.03.2016;2016;03;04;Lauantai;4;0;4;1;3;4
96;12.03.2016;2016;03;05;Lauantai;2;2;4;3;0;3
96;12.03.2016;2016;03;06;Lauantai;12;5;17;6;2;8
96;12.03.2016;2016;03;07;Lauantai;1;5;6;1;5;6
96;12.03.2016;2016;03;08;Lauantai;5;9;14;3;4;7
96;12.03.2016;2016;03;09;Lauantai;5;21;26;4;10;14
96;12.03.2016;2016;03;10;Lauantai;8;13;21;5;5;10
96;12.03.2016;2016;03;11;Lauantai;11;15;26;9;7;16
96;12.03.2016;2016;03;12;Lauantai;24;15;39;3;9;12
96;12.03.2016;2016;03;13;Lauantai;25;18;43;6;6;12
96;12.03.2016;2016;03;14;Lauantai;29;27;56;9;6;15
96;12.03.2016;2016;03;15;Lauantai;22;21;43;8;11;19
96;12.03.2016;2016;03;16;Lauantai;11;19;30;11;9;20
96;12.03.2016;2016;03;17;Lauantai;13;15;28;12;6;18
96;12.03.2016;2016;03;18;Lauantai;20;29;49;19;9;28
96;12.03.2016;2016;03;19;Lauantai;11;9;20;3;18;21
96;12.03.2016;2016;03;20;Lauantai;8;8;16;9;5;14
96;12.03.2016;2016;03;21;Lauantai;7;12;19;6;9;15
96;12.03.2016;2016;03;22;Lauantai;5;4;9;2;4;6
96;12.03.2016;2016;03;23;Lauantai;11;0;11;1;1;2
96;13.03.2016;2016;03;00;Sunnuntai;3;5;8;2;2;4
96;13.03.2016;2016;03;01;Sunnuntai;6;1;7;0;0;0
96;13.03.2016;2016;03;02;Sunnuntai;4;0;4;0;0;0
96;13.03.2016;2016;03;03;Sunnuntai;9;0;9;2;0;2
96;13.03.2016;2016;03;04;Sunnuntai;5;0;5;2;0;2
96;13.03.2016;2016;03;05;Sunnuntai;0;1;1;1;0;1
96;13.03.2016;2016;03;06;Sunnuntai;11;4;15;5;0;5
96;13.03.2016;2016;03;07;Sunnuntai;0;7;7;2;1;3
96;13.03.2016;2016;03;08;Sunnuntai;1;6;7;4;6;10
96;13.03.2016;2016;03;09;Sunnuntai;5;10;15;8;5;13
96;13.03.2016;2016;03;10;Sunnuntai;13;12;25;5;9;14
96;13.03.2016;2016;03;11;Sunnuntai;11;16;27;9;4;13
96;13.03.2016;2016;03;12;Sunnuntai;17;25;42;8;7;15
96;13.03.2016;2016;03;13;Sunnuntai;27;16;43;7;17;24
96;13.03.2016;2016;03;14;Sunnuntai;19;19;38;7;15;22
96;13.03.2016;2016;03;15;Sunnuntai;16;21;37;11;11;22
96;13.03.2016;2016;03;16;Sunnuntai;24;19;43;22;10;32
96;13.03.2016;2016;03;17;Sunnuntai;25;14;39;16;10;26
96;13.03.2016;2016;03;18;Sunnuntai;20;17;37;16;12;28
96;13.03.2016;2016;03;19;Sunnuntai;11;6;17;8;13;21
96;13.03.2016;2016;03;20;Sunnuntai;18;17;35;4;6;10
96;13.03.2016;2016;03;21;Sunnuntai;7;14;21;4;7;11
96;13.03.2016;2016;03;22;Sunnuntai;4;7;11;0;0;0
96;13.03.2016;2016;03;23;Sunnuntai;5;0;5;4;1;5
96;14.03.2016;2016;03;00;Maanantai;1;2;3;3;0;3
96;14.03.2016;2016;03;01;Maanantai;0;1;1;0;1;1
96;14.03.2016;2016;03;02;Maanantai;0;0;0;0;0;0
96;14.03.2016;2016;03;03;Maanantai;0;0;0;0;0;0
96;14.03.2016;2016;03;04;Maanantai;1;0;1;0;2;2
96;14.03.2016;2016;03;05;Maanantai;2;6;8;5;3;8
96;14.03.2016;2016;03;06;Maanantai;32;22;54;5;5;10
96;14.03.2016;2016;03;07;Maanantai;100;56;156;37;10;47
96;14.03.2016;2016;03;08;Maanantai;110;70;180;18;9;27
96;14.03.2016;2016;03;09;Maanantai;69;43;112;34;13;47
96;14.03.2016;2016;03;10;Maanantai;68;37;105;24;11;35
96;14.03.2016;2016;03;11;Maanantai;46;45;91;10;20;30
96;14.03.2016;2016;03;12;Maanantai;34;42;76;23;27;50
96;14.03.2016;2016;03;13;Maanantai;49;62;111;15;25;40
96;14.03.2016;2016;03;14;Maanantai;38;72;110;18;28;46
96;14.03.2016;2016;03;15;Maanantai;59;132;191;8;39;47
96;14.03.2016;2016;03;16;Maanantai;67;103;170;11;28;39
96;14.03.2016;2016;03;17;Maanantai;50;52;102;13;13;26
96;14.03.2016;2016;03;18;Maanantai;35;26;61;14;16;30
96;14.03.2016;2016;03;19;Maanantai;37;35;72;17;15;32
96;14.03.2016;2016;03;20;Maanantai;29;16;45;8;14;22
96;14.03.2016;2016;03;21;Maanantai;11;23;34;6;4;10
96;14.03.2016;2016;03;22;Maanantai;4;10;14;2;4;6
96;14.03.2016;2016;03;23;Maanantai;1;3;4;1;1;2
96;15.03.2016;2016;03;00;Tiistai;0;1;1;0;0;0
96;15.03.2016;2016;03;01;Tiistai;0;1;1;0;0;0
96;15.03.2016;2016;03;02;Tiistai;1;0;1;0;0;0
96;15.03.2016;2016;03;03;Tiistai;0;0;0;0;0;0
96;15.03.2016;2016;03;04;Tiistai;1;0;1;0;0;0
96;15.03.2016;2016;03;05;Tiistai;0;4;4;1;0;1
96;15.03.2016;2016;03;06;Tiistai;34;15;49;8;9;17
96;15.03.2016;2016;03;07;Tiistai;87;63;150;38;8;46
96;15.03.2016;2016;03;08;Tiistai;83;90;173;34;19;53
96;15.03.2016;2016;03;09;Tiistai;85;29;114;18;15;33
96;15.03.2016;2016;03;10;Tiistai;45;30;75;21;19;40
96;15.03.2016;2016;03;11;Tiistai;60;40;100;17;29;46
96;15.03.2016;2016;03;12;Tiistai;68;56;124;21;28;49
96;15.03.2016;2016;03;13;Tiistai;36;74;110;9;18;27
96;15.03.2016;2016;03;14;Tiistai;55;89;144;18;33;51
96;15.03.2016;2016;03;15;Tiistai;58;137;195;17;37;54
96;15.03.2016;2016;03;16;Tiistai;84;119;203;14;39;53
96;15.03.2016;2016;03;17;Tiistai;73;59;132;21;24;45
96;15.03.2016;2016;03;18;Tiistai;45;38;83;16;23;39
96;15.03.2016;2016;03;19;Tiistai;51;24;75;13;24;37
96;15.03.2016;2016;03;20;Tiistai;16;20;36;9;7;16
96;15.03.2016;2016;03;21;Tiistai;24;27;51;7;9;16
96;15.03.2016;2016;03;22;Tiistai;7;10;17;1;1;2
96;15.03.2016;2016;03;23;Tiistai;3;2;5;1;1;2
96;16.03.2016;2016;03;00;Keskiviikko;0;0;0;0;0;0
96;16.03.2016;2016;03;01;Keskiviikko;1;1;2;1;0;1
96;16.03.2016;2016;03;02;Keskiviikko;0;0;0;0;0;0
96;16.03.2016;2016;03;03;Keskiviikko;0;0;0;0;0;0
96;16.03.2016;2016;03;04;Keskiviikko;1;0;1;2;0;2
96;16.03.2016;2016;03;05;Keskiviikko;5;2;7;0;0;0
96;16.03.2016;2016;03;06;Keskiviikko;33;14;47;13;4;17
96;16.03.2016;2016;03;07;Keskiviikko;83;53;136;39;11;50
96;16.03.2016;2016;03;08;Keskiviikko;99;84;183;25;10;35
96;16.03.2016;2016;03;09;Keskiviikko;55;52;107;24;24;48
96;16.03.2016;2016;03;10;Keskiviikko;58;33;91;27;6;33
96;16.03.2016;2016;03;11;Keskiviikko;46;54;100;13;14;27
96;16.03.2016;2016;03;12;Keskiviikko;55;39;94;21;20;41
96;16.03.2016;2016;03;13;Keskiviikko;34;59;93;9;25;34
96;16.03.2016;2016;03;14;Keskiviikko;59;106;165;8;18;26
96;16.03.2016;2016;03;15;Keskiviikko;53;140;193;11;43;54
96;16.03.2016;2016;03;16;Keskiviikko;73;92;165;15;31;46
96;16.03.2016;2016;03;17;Keskiviikko;56;53;109;22;19;41
96;16.03.2016;2016;03;18;Keskiviikko;63;33;96;20;17;37
96;16.03.2016;2016;03;19;Keskiviikko;38;21;59;21;17;38
96;16.03.2016;2016;03;20;Keskiviikko;32;34;66;12;7;19
96;16.03.2016;2016;03;21;Keskiviikko;25;31;56;7;14;21
96;16.03.2016;2016;03;22;Keskiviikko;3;4;7;0;1;1
96;16.03.2016;2016;03;23;Keskiviikko;4;1;5;3;0;3
96;17.03.2016;2016;03;00;Torstai;3;3;6;0;0;0
96;17.03.2016;2016;03;01;Torstai;2;0;2;1;2;3
96;17.03.2016;2016;03;02;Torstai;0;1;1;0;1;1
96;17.03.2016;2016;03;03;Torstai;0;0;0;0;0;0
96;17.03.2016;2016;03;04;Torstai;5;1;6;6;4;10
96;17.03.2016;2016;03;05;Torstai;0;2;2;0;0;0
96;17.03.2016;2016;03;06;Torstai;30;19;49;13;4;17
96;17.03.2016;2016;03;07;Torstai;72;55;127;28;12;40
96;17.03.2016;2016;03;08;Torstai;83;76;159;19;5;24
96;17.03.2016;2016;03;09;Torstai;48;29;77;16;9;25
96;17.03.2016;2016;03;10;Torstai;36;37;73;10;11;21
96;17.03.2016;2016;03;11;Torstai;41;32;73;19;19;38
96;17.03.2016;2016;03;12;Torstai;47;36;83;19;14;33
96;17.03.2016;2016;03;13;Torstai;49;57;106;14;17;31
96;17.03.2016;2016;03;14;Torstai;49;66;115;16;34;50
96;17.03.2016;2016;03;15;Torstai;51;110;161;13;37;50
96;17.03.2016;2016;03;16;Torstai;61;113;174;10;29;39
96;17.03.2016;2016;03;17;Torstai;45;50;95;17;19;36
96;17.03.2016;2016;03;18;Torstai;42;39;81;23;10;33
96;17.03.2016;2016;03;19;Torstai;32;28;60;13;18;31
96;17.03.2016;2016;03;20;Torstai;35;23;58;9;8;17
96;17.03.2016;2016;03;21;Torstai;24;17;41;4;12;16
96;17.03.2016;2016;03;22;Torstai;6;3;9;2;5;7
96;17.03.2016;2016;03;23;Torstai;5;1;6;1;0;1
96;18.03.2016;2016;03;00;Perjantai;6;3;9;0;0;0
96;18.03.2016;2016;03;01;Perjantai;3;4;7;1;1;2
96;18.03.2016;2016;03;02;Perjantai;4;0;4;1;0;1
96;18.03.2016;2016;03;03;Perjantai;0;1;1;0;0;0
96;18.03.2016;2016;03;04;Perjantai;1;2;3;0;0;0
96;18.03.2016;2016;03;05;Perjantai;0;2;2;2;0;2
96;18.03.2016;2016;03;06;Perjantai;31;9;40;15;2;17
96;18.03.2016;2016;03;07;Perjantai;60;59;119;21;17;38
96;18.03.2016;2016;03;08;Perjantai;69;62;131;20;6;26
96;18.03.2016;2016;03;09;Perjantai;48;48;96;7;14;21
96;18.03.2016;2016;03;10;Perjantai;53;22;75;21;14;35
96;18.03.2016;2016;03;11;Perjantai;54;47;101;16;18;34
96;18.03.2016;2016;03;12;Perjantai;48;43;91;15;17;32
96;18.03.2016;2016;03;13;Perjantai;31;76;107;15;22;37
96;18.03.2016;2016;03;14;Perjantai;47;84;131;7;32;39
96;18.03.2016;2016;03;15;Perjantai;41;100;141;16;27;43
96;18.03.2016;2016;03;16;Perjantai;46;50;96;12;22;34
96;18.03.2016;2016;03;17;Perjantai;28;39;67;12;21;33
96;18.03.2016;2016;03;18;Perjantai;33;38;71;10;21;31
96;18.03.2016;2016;03;19;Perjantai;18;13;31;11;18;29
96;18.03.2016;2016;03;20;Perjantai;18;13;31;10;4;14
96;18.03.2016;2016;03;21;Perjantai;35;12;47;13;9;22
96;18.03.2016;2016;03;22;Perjantai;8;4;12;5;5;10
96;18.03.2016;2016;03;23;Perjantai;5;2;7;1;0;1
96;19.03.2016;2016;03;00;Lauantai;8;3;11;1;0;1
96;19.03.2016;2016;03;01;Lauantai;4;1;5;0;0;0
96;19.03.2016;2016;03;02;Lauantai;3;2;5;0;1;1
96;19.03.2016;2016;03;03;Lauantai;5;2;7;5;0;5
96;19.03.2016;2016;03;04;Lauantai;5;1;6;0;1;1
96;19.03.2016;2016;03;05;Lauantai;1;0;1;2;2;4
96;19.03.2016;2016;03;06;Lauantai;13;3;16;6;1;7
96;19.03.2016;2016;03;07;Lauantai;2;8;10;2;3;5
96;19.03.2016;2016;03;08;Lauantai;4;20;24;10;8;18
96;19.03.2016;2016;03;09;Lauantai;9;19;28;4;8;12
96;19.03.2016;2016;03;10;Lauantai;15;26;41;6;10;16
96;19.03.2016;2016;03;11;Lauantai;16;24;40;16;12;28
96;19.03.2016;2016;03;12;Lauantai;22;25;47;15;14;29
96;19.03.2016;2016;03;13;Lauantai;24;29;53;21;14;35
96;19.03.2016;2016;03;14;Lauantai;29;29;58;15;21;36
96;19.03.2016;2016;03;15;Lauantai;25;18;43;18;14;32
96;19.03.2016;2016;03;16;Lauantai;27;20;47;8;7;15
96;19.03.2016;2016;03;17;Lauantai;24;23;47;9;9;18
96;19.03.2016;2016;03;18;Lauantai;23;21;44;21;9;30
96;19.03.2016;2016;03;19;Lauantai;21;15;36;5;6;11
96;19.03.2016;2016;03;20;Lauantai;14;9;23;7;4;11
96;19.03.2016;2016;03;21;Lauantai;10;21;31;2;6;8
96;19.03.2016;2016;03;22;Lauantai;5;7;12;3;1;4
96;19.03.2016;2016;03;23;Lauantai;8;3;11;1;0;1
96;20.03.2016;2016;03;00;Sunnuntai;2;5;7;0;0;0
96;20.03.2016;2016;03;01;Sunnuntai;3;1;4;1;0;1
96;20.03.2016;2016;03;02;Sunnuntai;6;0;6;0;0;0
96;20.03.2016;2016;03;03;Sunnuntai;6;1;7;6;0;6
96;20.03.2016;2016;03;04;Sunnuntai;4;1;5;3;0;3
96;20.03.2016;2016;03;05;Sunnuntai;0;0;0;0;0;0
96;20.03.2016;2016;03;06;Sunnuntai;6;4;10;6;0;6
96;20.03.2016;2016;03;07;Sunnuntai;5;11;16;3;4;7
96;20.03.2016;2016;03;08;Sunnuntai;3;7;10;4;7;11
96;20.03.2016;2016;03;09;Sunnuntai;3;7;10;8;7;15
96;20.03.2016;2016;03;10;Sunnuntai;15;10;25;15;15;30
96;20.03.2016;2016;03;11;Sunnuntai;10;14;24;12;17;29
96;20.03.2016;2016;03;12;Sunnuntai;20;17;37;17;16;33
96;20.03.2016;2016;03;13;Sunnuntai;25;17;42;14;20;34
96;20.03.2016;2016;03;14;Sunnuntai;21;30;51;23;13;36
96;20.03.2016;2016;03;15;Sunnuntai;23;21;44;10;18;28
96;20.03.2016;2016;03;16;Sunnuntai;26;19;45;22;16;38
96;20.03.2016;2016;03;17;Sunnuntai;15;19;34;16;10;26
96;20.03.2016;2016;03;18;Sunnuntai;21;23;44;13;20;33
96;20.03.2016;2016;03;19;Sunnuntai;12;13;25;12;9;21
96;20.03.2016;2016;03;20;Sunnuntai;18;15;33;7;15;22
96;20.03.2016;2016;03;21;Sunnuntai;15;19;34;3;2;5
96;20.03.2016;2016;03;22;Sunnuntai;4;4;8;2;0;2
96;20.03.2016;2016;03;23;Sunnuntai;4;1;5;2;0;2
96;21.03.2016;2016;03;00;Maanantai;0;0;0;0;1;1
96;21.03.2016;2016;03;01;Maanantai;1;0;1;0;0;0
96;21.03.2016;2016;03;02;Maanantai;0;0;0;0;0;0
96;21.03.2016;2016;03;03;Maanantai;1;0;1;0;0;0
96;21.03.2016;2016;03;04;Maanantai;1;0;1;0;0;0
96;21.03.2016;2016;03;05;Maanantai;6;4;10;0;1;1
96;21.03.2016;2016;03;06;Maanantai;30;15;45;12;3;15
96;21.03.2016;2016;03;07;Maanantai;71;48;119;34;10;44
96;21.03.2016;2016;03;08;Maanantai;79;67;146;24;15;39
96;21.03.2016;2016;03;09;Maanantai;63;46;109;24;17;41
96;21.03.2016;2016;03;10;Maanantai;43;28;71;16;5;21
96;21.03.2016;2016;03;11;Maanantai;43;47;90;14;22;36
96;21.03.2016;2016;03;12;Maanantai;47;39;86;23;23;46
96;21.03.2016;2016;03;13;Maanantai;39;73;112;11;23;34
96;21.03.2016;2016;03;14;Maanantai;66;74;140;11;21;32
96;21.03.2016;2016;03;15;Maanantai;46;119;165;16;32;48
96;21.03.2016;2016;03;16;Maanantai;56;93;149;19;32;51
96;21.03.2016;2016;03;17;Maanantai;43;38;81;11;15;26
96;21.03.2016;2016;03;18;Maanantai;41;33;74;17;21;38
96;21.03.2016;2016;03;19;Maanantai;40;21;61;8;19;27
96;21.03.2016;2016;03;20;Maanantai;22;15;37;11;7;18
96;21.03.2016;2016;03;21;Maanantai;9;14;23;6;6;12
96;21.03.2016;2016;03;22;Maanantai;11;5;16;4;3;7
96;21.03.2016;2016;03;23;Maanantai;2;3;5;1;0;1
96;22.03.2016;2016;03;00;Tiistai;0;1;1;0;0;0
96;22.03.2016;2016;03;01;Tiistai;0;1;1;0;0;0
96;22.03.2016;2016;03;02;Tiistai;1;0;1;1;0;1
96;22.03.2016;2016;03;03;Tiistai;1;0;1;0;0;0
96;22.03.2016;2016;03;04;Tiistai;1;0;1;1;0;1
96;22.03.2016;2016;03;05;Tiistai;3;5;8;0;1;1
96;22.03.2016;2016;03;06;Tiistai;36;10;46;16;5;21
96;22.03.2016;2016;03;07;Tiistai;85;48;133;24;10;34
96;22.03.2016;2016;03;08;Tiistai;64;81;145;21;12;33
96;22.03.2016;2016;03;09;Tiistai;57;34;91;21;8;29
96;22.03.2016;2016;03;10;Tiistai;44;29;73;16;15;31
96;22.03.2016;2016;03;11;Tiistai;63;56;119;21;20;41
96;22.03.2016;2016;03;12;Tiistai;55;42;97;24;15;39
96;22.03.2016;2016;03;13;Tiistai;28;58;86;9;13;22
96;22.03.2016;2016;03;14;Tiistai;59;93;152;13;29;42
96;22.03.2016;2016;03;15;Tiistai;57;117;174;13;39;52
96;22.03.2016;2016;03;16;Tiistai;57;119;176;37;43;80
96;22.03.2016;2016;03;17;Tiistai;45;54;99;17;29;46
96;22.03.2016;2016;03;18;Tiistai;40;51;91;21;19;40
96;22.03.2016;2016;03;19;Tiistai;35;35;70;14;15;29
96;22.03.2016;2016;03;20;Tiistai;38;22;60;4;6;10
96;22.03.2016;2016;03;21;Tiistai;41;13;54;15;5;20
96;22.03.2016;2016;03;22;Tiistai;12;7;19;4;2;6
96;22.03.2016;2016;03;23;Tiistai;4;3;7;0;1;1
96;23.03.2016;2016;03;00;Keskiviikko;0;2;2;1;0;1
96;23.03.2016;2016;03;01;Keskiviikko;2;1;3;0;0;0
96;23.03.2016;2016;03;02;Keskiviikko;0;0;0;1;0;1
96;23.03.2016;2016;03;03;Keskiviikko;1;0;1;1;0;1
96;23.03.2016;2016;03;04;Keskiviikko;1;0;1;0;0;0
96;23.03.2016;2016;03;05;Keskiviikko;3;4;7;0;1;1
96;23.03.2016;2016;03;06;Keskiviikko;39;16;55;15;3;18
96;23.03.2016;2016;03;07;Keskiviikko;69;57;126;22;5;27
96;23.03.2016;2016;03;08;Keskiviikko;89;77;166;19;11;30
96;23.03.2016;2016;03;09;Keskiviikko;48;50;98;19;10;29
96;23.03.2016;2016;03;10;Keskiviikko;42;39;81;18;19;37
96;23.03.2016;2016;03;11;Keskiviikko;49;43;92;12;17;29
96;23.03.2016;2016;03;12;Keskiviikko;57;38;95;32;9;41
96;23.03.2016;2016;03;13;Keskiviikko;36;64;100;12;21;33
96;23.03.2016;2016;03;14;Keskiviikko;46;74;120;5;18;23
96;23.03.2016;2016;03;15;Keskiviikko;52;107;159;4;33;37
96;23.03.2016;2016;03;16;Keskiviikko;64;89;153;8;23;31
96;23.03.2016;2016;03;17;Keskiviikko;45;49;94;15;11;26
96;23.03.2016;2016;03;18;Keskiviikko;44;27;71;15;9;24
96;23.03.2016;2016;03;19;Keskiviikko;33;22;55;19;22;41
96;23.03.2016;2016;03;20;Keskiviikko;31;23;54;4;3;7
96;23.03.2016;2016;03;21;Keskiviikko;10;28;38;5;12;17
96;23.03.2016;2016;03;22;Keskiviikko;5;5;10;2;0;2
96;23.03.2016;2016;03;23;Keskiviikko;7;1;8;1;1;2
96;24.03.2016;2016;03;00;Torstai;2;1;3;1;1;2
96;24.03.2016;2016;03;01;Torstai;2;0;2;1;0;1
96;24.03.2016;2016;03;02;Torstai;0;0;0;2;0;2
96;24.03.2016;2016;03;03;Torstai;2;0;2;0;1;1
96;24.03.2016;2016;03;04;Torstai;1;0;1;0;0;0
96;24.03.2016;2016;03;05;Torstai;2;5;7;0;2;2
96;24.03.2016;2016;03;06;Torstai;33;13;46;17;2;19
96;24.03.2016;2016;03;07;Torstai;55;39;94;25;11;36
96;24.03.2016;2016;03;08;Torstai;68;52;120;14;10;24
96;24.03.2016;2016;03;09;Torstai;53;47;100;30;9;39
96;24.03.2016;2016;03;10;Torstai;33;26;59;19;11;30
96;24.03.2016;2016;03;11;Torstai;27;54;81;11;18;29
96;24.03.2016;2016;03;12;Torstai;49;44;93;16;6;22
96;24.03.2016;2016;03;13;Torstai;49;57;106;13;11;24
96;24.03.2016;2016;03;14;Torstai;53;100;153;5;17;22
96;24.03.2016;2016;03;15;Torstai;44;83;127;12;30;42
96;24.03.2016;2016;03;16;Torstai;47;55;102;3;19;22
96;24.03.2016;2016;03;17;Torstai;24;18;42;5;7;12
96;24.03.2016;2016;03;18;Torstai;16;17;33;5;12;17
96;24.03.2016;2016;03;19;Torstai;8;8;16;2;7;9
96;24.03.2016;2016;03;20;Torstai;9;7;16;7;9;16
96;24.03.2016;2016;03;21;Torstai;13;18;31;6;18;24
96;24.03.2016;2016;03;22;Torstai;7;8;15;0;1;1
96;24.03.2016;2016;03;23;Torstai;4;3;7;2;1;3
96;25.03.2016;2016;03;00;Perjantai;0;0;0;0;0;0
96;25.03.2016;2016;03;01;Perjantai;5;0;5;1;0;1
96;25.03.2016;2016;03;02;Perjantai;0;0;0;3;0;3
96;25.03.2016;2016;03;03;Perjantai;1;0;1;2;0;2
96;25.03.2016;2016;03;04;Perjantai;1;1;2;1;1;2
96;25.03.2016;2016;03;05;Perjantai;1;0;1;2;4;6
96;25.03.2016;2016;03;06;Perjantai;13;4;17;3;0;3
96;25.03.2016;2016;03;07;Perjantai;0;6;6;1;4;5
96;25.03.2016;2016;03;08;Perjantai;4;7;11;1;1;2
96;25.03.2016;2016;03;09;Perjantai;1;3;4;13;5;18
96;25.03.2016;2016;03;10;Perjantai;4;6;10;5;7;12
96;25.03.2016;2016;03;11;Perjantai;9;10;19;10;15;25
96;25.03.2016;2016;03;12;Perjantai;11;8;19;8;8;16
96;25.03.2016;2016;03;13;Perjantai;10;16;26;12;8;20
96;25.03.2016;2016;03;14;Perjantai;8;12;20;7;5;12
96;25.03.2016;2016;03;15;Perjantai;10;10;20;5;1;6
96;25.03.2016;2016;03;16;Perjantai;15;11;26;4;12;16
96;25.03.2016;2016;03;17;Perjantai;18;10;28;13;10;23
96;25.03.2016;2016;03;18;Perjantai;13;16;29;12;12;24
96;25.03.2016;2016;03;19;Perjantai;9;12;21;6;6;12
96;25.03.2016;2016;03;20;Perjantai;6;9;15;10;9;19
96;25.03.2016;2016;03;21;Perjantai;6;16;22;1;8;9
96;25.03.2016;2016;03;22;Perjantai;4;5;9;0;4;4
96;25.03.2016;2016;03;23;Perjantai;5;2;7;1;0;1
96;26.03.2016;2016;03;00;Lauantai;1;2;3;0;0;0
96;26.03.2016;2016;03;01;Lauantai;4;1;5;2;0;2
96;26.03.2016;2016;03;02;Lauantai;1;0;1;0;1;1
96;26.03.2016;2016;03;03;Lauantai;3;0;3;0;0;0
96;26.03.2016;2016;03;04;Lauantai;6;0;6;1;1;2
96;26.03.2016;2016;03;05;Lauantai;2;1;3;0;0;0
96;26.03.2016;2016;03;06;Lauantai;13;3;16;8;1;9
96;26.03.2016;2016;03;07;Lauantai;2;9;11;1;5;6
96;26.03.2016;2016;03;08;Lauantai;2;9;11;4;5;9
96;26.03.2016;2016;03;09;Lauantai;10;15;25;6;4;10
96;26.03.2016;2016;03;10;Lauantai;13;9;22;4;13;17
96;26.03.2016;2016;03;11;Lauantai;5;16;21;5;10;15
96;26.03.2016;2016;03;12;Lauantai;14;16;30;13;12;25
96;26.03.2016;2016;03;13;Lauantai;28;24;52;13;5;18
96;26.03.2016;2016;03;14;Lauantai;22;27;49;7;7;14
96;26.03.2016;2016;03;15;Lauantai;21;29;50;16;15;31
96;26.03.2016;2016;03;16;Lauantai;15;41;56;6;17;23
96;26.03.2016;2016;03;17;Lauantai;23;8;31;6;6;12
96;26.03.2016;2016;03;18;Lauantai;11;10;21;1;10;11
96;26.03.2016;2016;03;19;Lauantai;32;9;41;16;9;25
96;26.03.2016;2016;03;20;Lauantai;15;15;30;11;8;19
96;26.03.2016;2016;03;21;Lauantai;14;15;29;2;2;4
96;26.03.2016;2016;03;22;Lauantai;3;5;8;0;2;2
96;26.03.2016;2016;03;23;Lauantai;5;4;9;0;0;0
96;27.03.2016;2016;03;00;Sunnuntai;4;10;14;2;2;4
96;27.03.2016;2016;03;01;Sunnuntai;3;2;5;0;0;0
96;27.03.2016;2016;03;02;Sunnuntai;0;0;0;0;0;0
96;27.03.2016;2016;03;03;Sunnuntai;14;2;16;1;0;1
96;27.03.2016;2016;03;04;Sunnuntai;8;0;8;5;0;5
96;27.03.2016;2016;03;05;Sunnuntai;1;3;4;2;0;2
96;27.03.2016;2016;03;06;Sunnuntai;10;2;12;3;0;3
96;27.03.2016;2016;03;07;Sunnuntai;1;5;6;3;5;8
96;27.03.2016;2016;03;08;Sunnuntai;2;3;5;3;1;4
96;27.03.2016;2016;03;09;Sunnuntai;8;3;11;1;6;7
96;27.03.2016;2016;03;10;Sunnuntai;7;9;16;6;10;16
96;27.03.2016;2016;03;11;Sunnuntai;9;10;19;15;14;29
96;27.03.2016;2016;03;12;Sunnuntai;13;21;34;7;12;19
96;27.03.2016;2016;03;13;Sunnuntai;25;24;49;13;10;23
96;27.03.2016;2016;03;14;Sunnuntai;16;21;37;6;11;17
96;27.03.2016;2016;03;15;Sunnuntai;11;25;36;15;8;23
96;27.03.2016;2016;03;16;Sunnuntai;25;11;36;13;8;21
96;27.03.2016;2016;03;17;Sunnuntai;20;18;38;20;8;28
96;27.03.2016;2016;03;18;Sunnuntai;20;25;45;4;13;17
96;27.03.2016;2016;03;19;Sunnuntai;12;22;34;5;14;19
96;27.03.2016;2016;03;20;Sunnuntai;9;12;21;6;9;15
96;27.03.2016;2016;03;21;Sunnuntai;13;10;23;4;5;9
96;27.03.2016;2016;03;22;Sunnuntai;7;7;14;5;3;8
96;27.03.2016;2016;03;23;Sunnuntai;7;1;8;0;0;0
96;28.03.2016;2016;03;00;Maanantai;0;1;1;1;3;4
96;28.03.2016;2016;03;01;Maanantai;2;0;2;2;0;2
96;28.03.2016;2016;03;02;Maanantai;3;1;4;0;2;2
96;28.03.2016;2016;03;03;Maanantai;1;0;1;1;0;1
96;28.03.2016;2016;03;04;Maanantai;2;0;2;0;0;0
96;28.03.2016;2016;03;05;Maanantai;2;0;2;0;0;0
96;28.03.2016;2016;03;06;Maanantai;16;2;18;2;0;2
96;28.03.2016;2016;03;07;Maanantai;3;9;12;4;6;10
96;28.03.2016;2016;03;08;Maanantai;4;11;15;4;2;6
96;28.03.2016;2016;03;09;Maanantai;9;12;21;4;5;9
96;28.03.2016;2016;03;10;Maanantai;15;9;24;4;6;10
96;28.03.2016;2016;03;11;Maanantai;15;20;35;11;16;27
96;28.03.2016;2016;03;12;Maanantai;18;30;48;19;17;36
96;28.03.2016;2016;03;13;Maanantai;25;34;59;20;19;39
96;28.03.2016;2016;03;14;Maanantai;18;32;50;18;14;32
96;28.03.2016;2016;03;15;Maanantai;19;52;71;13;14;27
96;28.03.2016;2016;03;16;Maanantai;32;19;51;22;9;31
96;28.03.2016;2016;03;17;Maanantai;18;33;51;18;16;34
96;28.03.2016;2016;03;18;Maanantai;23;20;43;25;17;42
96;28.03.2016;2016;03;19;Maanantai;23;24;47;10;19;29
96;28.03.2016;2016;03;20;Maanantai;27;20;47;17;10;27
96;28.03.2016;2016;03;21;Maanantai;13;12;25;3;7;10
96;28.03.2016;2016;03;22;Maanantai;3;4;7;3;1;4
96;28.03.2016;2016;03;23;Maanantai;8;2;10;2;4;6
96;29.03.2016;2016;03;00;Tiistai;3;4;7;3;0;3
96;29.03.2016;2016;03;01;Tiistai;0;2;2;0;0;0
96;29.03.2016;2016;03;02;Tiistai;0;0;0;0;0;0
96;29.03.2016;2016;03;03;Tiistai;1;0;1;0;0;0
96;29.03.2016;2016;03;04;Tiistai;1;0;1;0;0;0
96;29.03.2016;2016;03;05;Tiistai;4;8;12;1;0;1
96;29.03.2016;2016;03;06;Tiistai;41;20;61;12;1;13
96;29.03.2016;2016;03;07;Tiistai;61;70;131;22;6;28
96;29.03.2016;2016;03;08;Tiistai;69;78;147;21;12;33
96;29.03.2016;2016;03;09;Tiistai;60;49;109;20;16;36
96;29.03.2016;2016;03;10;Tiistai;42;50;92;18;17;35
96;29.03.2016;2016;03;11;Tiistai;44;50;94;27;25;52
96;29.03.2016;2016;03;12;Tiistai;47;47;94;25;33;58
96;29.03.2016;2016;03;13;Tiistai;51;65;116;20;19;39
96;29.03.2016;2016;03;14;Tiistai;52;102;154;14;19;33
96;29.03.2016;2016;03;15;Tiistai;72;141;213;16;33;49
96;29.03.2016;2016;03;16;Tiistai;65;130;195;11;38;49
96;29.03.2016;2016;03;17;Tiistai;46;64;110;15;20;35
96;29.03.2016;2016;03;18;Tiistai;42;43;85;21;18;39
96;29.03.2016;2016;03;19;Tiistai;46;44;90;27;12;39
96;29.03.2016;2016;03;20;Tiistai;38;36;74;9;21;30
96;29.03.2016;2016;03;21;Tiistai;25;17;42;6;13;19
96;29.03.2016;2016;03;22;Tiistai;12;9;21;4;1;5
96;29.03.2016;2016;03;23;Tiistai;6;1;7;3;3;6
96;30.03.2016;2016;03;00;Keskiviikko;1;2;3;0;0;0
96;30.03.2016;2016;03;01;Keskiviikko;3;0;3;2;0;2
96;30.03.2016;2016;03;02;Keskiviikko;0;0;0;0;0;0
96;30.03.2016;2016;03;03;Keskiviikko;1;0;1;0;0;0
96;30.03.2016;2016;03;04;Keskiviikko;1;0;1;0;1;1
96;30.03.2016;2016;03;05;Keskiviikko;3;6;9;1;1;2
96;30.03.2016;2016;03;06;Keskiviikko;32;16;48;12;1;13
96;30.03.2016;2016;03;07;Keskiviikko;85;65;150;21;9;30
96;30.03.2016;2016;03;08;Keskiviikko;121;83;204;11;12;23
96;30.03.2016;2016;03;09;Keskiviikko;67;44;111;17;11;28
96;30.03.2016;2016;03;10;Keskiviikko;35;43;78;8;11;19
96;30.03.2016;2016;03;11;Keskiviikko;34;49;83;12;15;27
96;30.03.2016;2016;03;12;Keskiviikko;41;58;99;13;8;21
96;30.03.2016;2016;03;13;Keskiviikko;43;61;104;12;7;19
96;30.03.2016;2016;03;14;Keskiviikko;45;104;149;10;30;40
96;30.03.2016;2016;03;15;Keskiviikko;56;135;191;9;39;48
96;30.03.2016;2016;03;16;Keskiviikko;75;120;195;20;31;51
96;30.03.2016;2016;03;17;Keskiviikko;45;45;90;13;20;33
96;30.03.2016;2016;03;18;Keskiviikko;60;41;101;35;19;54
96;30.03.2016;2016;03;19;Keskiviikko;50;26;76;23;15;38
96;30.03.2016;2016;03;20;Keskiviikko;29;28;57;15;17;32
96;30.03.2016;2016;03;21;Keskiviikko;15;29;44;5;13;18
96;30.03.2016;2016;03;22;Keskiviikko;12;7;19;1;2;3
96;30.03.2016;2016;03;23;Keskiviikko;6;3;9;0;0;0
96;31.03.2016;2016;03;00;Torstai;8;3;11;2;0;2
96;31.03.2016;2016;03;01;Torstai;5;0;5;0;0;0
96;31.03.2016;2016;03;02;Torstai;0;0;0;0;0;0
96;31.03.2016;2016;03;03;Torstai;2;0;2;0;0;0
96;31.03.2016;2016;03;04;Torstai;0;1;1;0;1;1
96;31.03.2016;2016;03;05;Torstai;4;2;6;0;1;1
96;31.03.2016;2016;03;06;Torstai;26;16;42;19;2;21
96;31.03.2016;2016;03;07;Torstai;55;62;117;22;8;30
96;31.03.2016;2016;03;08;Torstai;84;86;170;12;6;18
96;31.03.2016;2016;03;09;Torstai;43;60;103;15;4;19
96;31.03.2016;2016;03;10;Torstai;33;58;91;10;11;21
96;31.03.2016;2016;03;11;Torstai;43;46;89;16;7;23
96;31.03.2016;2016;03;12;Torstai;66;44;110;11;14;25
96;31.03.2016;2016;03;13;Torstai;45;64;109;11;17;28
96;31.03.2016;2016;03;14;Torstai;45;108;153;12;29;41
96;31.03.2016;2016;03;15;Torstai;61;144;205;12;46;58
96;31.03.2016;2016;03;16;Torstai;92;99;191;7;28;35
96;31.03.2016;2016;03;17;Torstai;43;81;124;10;19;29
96;31.03.2016;2016;03;18;Torstai;65;41;106;24;17;41
96;31.03.2016;2016;03;19;Torstai;40;30;70;16;30;46
96;31.03.2016;2016;03;20;Torstai;37;23;60;11;14;25
96;31.03.2016;2016;03;21;Torstai;20;24;44;10;9;19
96;31.03.2016;2016;03;22;Torstai;7;11;18;4;3;7
96;31.03.2016;2016;03;23;Torstai;12;4;16;0;1;1
96;01.04.2016;2016;04;00;Perjantai;2;2;4;0;1;1
96;01.04.2016;2016;04;01;Perjantai;0;1;1;1;0;1
96;01.04.2016;2016;04;02;Perjantai;3;0;3;0;0;0
96;01.04.2016;2016;04;03;Perjantai;4;0;4;0;0;0
96;01.04.2016;2016;04;04;Perjantai;4;1;5;1;1;2
96;01.04.2016;2016;04;05;Perjantai;0;2;2;1;1;2
96;01.04.2016;2016;04;06;Perjantai;29;23;52;18;3;21
96;01.04.2016;2016;04;07;Perjantai;64;58;122;15;6;21
96;01.04.2016;2016;04;08;Perjantai;99;91;190;7;8;15
96;01.04.2016;2016;04;09;Perjantai;35;63;98;13;10;23
96;01.04.2016;2016;04;10;Perjantai;63;56;119;16;12;28
96;01.04.2016;2016;04;11;Perjantai;38;61;99;8;16;24
96;01.04.2016;2016;04;12;Perjantai;56;59;115;13;14;27
96;01.04.2016;2016;04;13;Perjantai;61;75;136;15;22;37
96;01.04.2016;2016;04;14;Perjantai;52;107;159;12;28;40
96;01.04.2016;2016;04;15;Perjantai;52;130;182;13;30;43
96;01.04.2016;2016;04;16;Perjantai;64;80;144;18;30;48
96;01.04.2016;2016;04;17;Perjantai;43;55;98;9;16;25
96;01.04.2016;2016;04;18;Perjantai;45;64;109;10;29;39
96;01.04.2016;2016;04;19;Perjantai;41;22;63;10;9;19
96;01.04.2016;2016;04;20;Perjantai;25;13;38;8;4;12
96;01.04.2016;2016;04;21;Perjantai;59;19;78;17;7;24
96;01.04.2016;2016;04;22;Perjantai;16;8;24;2;0;2
96;01.04.2016;2016;04;23;Perjantai;11;4;15;3;5;8
96;02.04.2016;2016;04;00;Lauantai;3;4;7;0;1;1
96;02.04.2016;2016;04;01;Lauantai;6;4;10;0;0;0
96;02.04.2016;2016;04;02;Lauantai;5;1;6;2;0;2
96;02.04.2016;2016;04;03;Lauantai;1;0;1;0;1;1
96;02.04.2016;2016;04;04;Lauantai;6;2;8;1;1;2
96;02.04.2016;2016;04;05;Lauantai;4;1;5;0;0;0
96;02.04.2016;2016;04;06;Lauantai;16;6;22;6;1;7
96;02.04.2016;2016;04;07;Lauantai;2;13;15;5;6;11
96;02.04.2016;2016;04;08;Lauantai;8;17;25;2;6;8
96;02.04.2016;2016;04;09;Lauantai;12;28;40;4;10;14
96;02.04.2016;2016;04;10;Lauantai;15;25;40;9;10;19
96;02.04.2016;2016;04;11;Lauantai;28;25;53;14;8;22
96;02.04.2016;2016;04;12;Lauantai;34;35;69;12;12;24
96;02.04.2016;2016;04;13;Lauantai;38;41;79;10;12;22
96;02.04.2016;2016;04;14;Lauantai;42;45;87;20;18;38
96;02.04.2016;2016;04;15;Lauantai;44;36;80;15;13;28
96;02.04.2016;2016;04;16;Lauantai;36;27;63;16;11;27
96;02.04.2016;2016;04;17;Lauantai;12;31;43;8;9;17
96;02.04.2016;2016;04;18;Lauantai;34;22;56;13;6;19
96;02.04.2016;2016;04;19;Lauantai;16;19;35;14;16;30
96;02.04.2016;2016;04;20;Lauantai;16;19;35;8;9;17
96;02.04.2016;2016;04;21;Lauantai;14;27;41;4;8;12
96;02.04.2016;2016;04;22;Lauantai;2;3;5;2;2;4
96;02.04.2016;2016;04;23;Lauantai;9;4;13;0;1;1
96;03.04.2016;2016;04;00;Sunnuntai;5;3;8;1;0;1
96;03.04.2016;2016;04;01;Sunnuntai;4;4;8;1;1;2
96;03.04.2016;2016;04;02;Sunnuntai;3;1;4;1;0;1
96;03.04.2016;2016;04;03;Sunnuntai;8;0;8;0;0;0
96;03.04.2016;2016;04;04;Sunnuntai;5;0;5;3;1;4
96;03.04.2016;2016;04;05;Sunnuntai;1;1;2;0;0;0
96;03.04.2016;2016;04;06;Sunnuntai;15;4;19;6;0;6
96;03.04.2016;2016;04;07;Sunnuntai;7;10;17;1;3;4
96;03.04.2016;2016;04;08;Sunnuntai;7;6;13;5;7;12
96;03.04.2016;2016;04;09;Sunnuntai;10;13;23;8;7;15
96;03.04.2016;2016;04;10;Sunnuntai;14;19;33;8;11;19
96;03.04.2016;2016;04;11;Sunnuntai;21;26;47;6;20;26
96;03.04.2016;2016;04;12;Sunnuntai;22;30;52;14;16;30
96;03.04.2016;2016;04;13;Sunnuntai;39;48;87;19;14;33
96;03.04.2016;2016;04;14;Sunnuntai;51;42;93;22;15;37
96;03.04.2016;2016;04;15;Sunnuntai;40;49;89;20;33;53
96;03.04.2016;2016;04;16;Sunnuntai;49;30;79;35;19;54
96;03.04.2016;2016;04;17;Sunnuntai;46;35;81;23;17;40
96;03.04.2016;2016;04;18;Sunnuntai;25;41;66;23;28;51
96;03.04.2016;2016;04;19;Sunnuntai;18;30;48;12;24;36
96;03.04.2016;2016;04;20;Sunnuntai;28;30;58;16;14;30
96;03.04.2016;2016;04;21;Sunnuntai;15;28;43;7;4;11
96;03.04.2016;2016;04;22;Sunnuntai;2;6;8;5;0;5
96;03.04.2016;2016;04;23;Sunnuntai;3;2;5;0;2;2
96;04.04.2016;2016;04;00;Maanantai;2;3;5;2;0;2
96;04.04.2016;2016;04;01;Maanantai;1;1;2;0;0;0
96;04.04.2016;2016;04;02;Maanantai;0;0;0;0;0;0
96;04.04.2016;2016;04;03;Maanantai;1;0;1;0;0;0
96;04.04.2016;2016;04;04;Maanantai;1;0;1;1;0;1
96;04.04.2016;2016;04;05;Maanantai;2;5;7;0;0;0
96;04.04.2016;2016;04;06;Maanantai;47;26;73;10;3;13
96;04.04.2016;2016;04;07;Maanantai;106;66;172;22;6;28
96;04.04.2016;2016;04;08;Maanantai;95;89;184;16;13;29
96;04.04.2016;2016;04;09;Maanantai;67;52;119;17;8;25
96;04.04.2016;2016;04;10;Maanantai;59;68;127;17;17;34
96;04.04.2016;2016;04;11;Maanantai;55;46;101;15;9;24
96;04.04.2016;2016;04;12;Maanantai;75;79;154;10;14;24
96;04.04.2016;2016;04;13;Maanantai;64;58;122;11;20;31
96;04.04.2016;2016;04;14;Maanantai;55;147;202;13;22;35
96;04.04.2016;2016;04;15;Maanantai;85;171;256;16;43;59
96;04.04.2016;2016;04;16;Maanantai;96;134;230;22;22;44
96;04.04.2016;2016;04;17;Maanantai;48;85;133;17;15;32
96;04.04.2016;2016;04;18;Maanantai;55;75;130;26;15;41
96;04.04.2016;2016;04;19;Maanantai;49;50;99;15;17;32
96;04.04.2016;2016;04;20;Maanantai;39;30;69;10;12;22
96;04.04.2016;2016;04;21;Maanantai;40;32;72;9;8;17
96;04.04.2016;2016;04;22;Maanantai;9;5;14;2;3;5
96;04.04.2016;2016;04;23;Maanantai;4;1;5;1;0;1
96;05.04.2016;2016;04;00;Tiistai;3;2;5;0;0;0
96;05.04.2016;2016;04;01;Tiistai;1;0;1;0;0;0
96;05.04.2016;2016;04;02;Tiistai;0;0;0;0;0;0
96;05.04.2016;2016;04;03;Tiistai;1;0;1;2;0;2
96;05.04.2016;2016;04;04;Tiistai;2;1;3;0;0;0
96;05.04.2016;2016;04;05;Tiistai;3;4;7;1;0;1
96;05.04.2016;2016;04;06;Tiistai;32;23;55;12;2;14
96;05.04.2016;2016;04;07;Tiistai;90;68;158;22;4;26
96;05.04.2016;2016;04;08;Tiistai;106;86;192;17;7;24
96;05.04.2016;2016;04;09;Tiistai;39;43;82;16;11;27
96;05.04.2016;2016;04;10;Tiistai;53;54;107;17;11;28
96;05.04.2016;2016;04;11;Tiistai;48;51;99;11;8;19
96;05.04.2016;2016;04;12;Tiistai;56;39;95;15;15;30
96;05.04.2016;2016;04;13;Tiistai;39;64;103;14;15;29
96;05.04.2016;2016;04;14;Tiistai;43;82;125;3;14;17
96;05.04.2016;2016;04;15;Tiistai;55;142;197;13;27;40
96;05.04.2016;2016;04;16;Tiistai;85;131;216;9;15;24
96;05.04.2016;2016;04;17;Tiistai;42;67;109;13;21;34
96;05.04.2016;2016;04;18;Tiistai;47;65;112;17;27;44
96;05.04.2016;2016;04;19;Tiistai;44;39;83;20;20;40
96;05.04.2016;2016;04;20;Tiistai;26;25;51;8;9;17
96;05.04.2016;2016;04;21;Tiistai;55;24;79;19;9;28
96;05.04.2016;2016;04;22;Tiistai;9;5;14;3;3;6
96;05.04.2016;2016;04;23;Tiistai;6;6;12;0;0;0
96;06.04.2016;2016;04;00;Keskiviikko;3;4;7;1;0;1
96;06.04.2016;2016;04;01;Keskiviikko;0;0;0;0;1;1
96;06.04.2016;2016;04;02;Keskiviikko;0;0;0;0;0;0
96;06.04.2016;2016;04;03;Keskiviikko;3;1;4;0;0;0
96;06.04.2016;2016;04;04;Keskiviikko;1;0;1;1;0;1
96;06.04.2016;2016;04;05;Keskiviikko;3;4;7;0;0;0
96;06.04.2016;2016;04;06;Keskiviikko;46;21;67;10;5;15
96;06.04.2016;2016;04;07;Keskiviikko;95;78;173;23;12;35
96;06.04.2016;2016;04;08;Keskiviikko;79;75;154;20;9;29
96;06.04.2016;2016;04;09;Keskiviikko;56;64;120;8;9;17
96;06.04.2016;2016;04;10;Keskiviikko;46;47;93;5;7;12
96;06.04.2016;2016;04;11;Keskiviikko;75;105;180;15;24;39
96;06.04.2016;2016;04;12;Keskiviikko;44;54;98;14;8;22
96;06.04.2016;2016;04;13;Keskiviikko;78;88;166;12;21;33
96;06.04.2016;2016;04;14;Keskiviikko;51;100;151;9;18;27
96;06.04.2016;2016;04;15;Keskiviikko;52;154;206;8;29;37
96;06.04.2016;2016;04;16;Keskiviikko;63;99;162;8;19;27
96;06.04.2016;2016;04;17;Keskiviikko;48;62;110;8;10;18
96;06.04.2016;2016;04;18;Keskiviikko;35;35;70;9;13;22
96;06.04.2016;2016;04;19;Keskiviikko;38;20;58;5;8;13
96;06.04.2016;2016;04;20;Keskiviikko;23;21;44;5;7;12
96;06.04.2016;2016;04;21;Keskiviikko;17;20;37;6;5;11
96;06.04.2016;2016;04;22;Keskiviikko;6;5;11;1;2;3
96;06.04.2016;2016;04;23;Keskiviikko;5;1;6;1;2;3
96;07.04.2016;2016;04;00;Torstai;2;0;2;1;0;1
96;07.04.2016;2016;04;01;Torstai;0;0;0;1;0;1
96;07.04.2016;2016;04;02;Torstai;0;0;0;0;0;0
96;07.04.2016;2016;04;03;Torstai;2;1;3;0;0;0
96;07.04.2016;2016;04;04;Torstai;1;0;1;2;0;2
96;07.04.2016;2016;04;05;Torstai;7;3;10;0;0;0
96;07.04.2016;2016;04;06;Torstai;35;15;50;16;4;20
96;07.04.2016;2016;04;07;Torstai;86;66;152;11;8;19
96;07.04.2016;2016;04;08;Torstai;106;104;210;12;7;19
96;07.04.2016;2016;04;09;Torstai;42;58;100;14;5;19
96;07.04.2016;2016;04;10;Torstai;50;58;108;11;11;22
96;07.04.2016;2016;04;11;Torstai;27;38;65;7;7;14
96;07.04.2016;2016;04;12;Torstai;48;45;93;16;8;24
96;07.04.2016;2016;04;13;Torstai;46;77;123;12;14;26
96;07.04.2016;2016;04;14;Torstai;44;108;152;8;13;21
96;07.04.2016;2016;04;15;Torstai;74;165;239;6;29;35
96;07.04.2016;2016;04;16;Torstai;79;137;216;13;23;36
96;07.04.2016;2016;04;17;Torstai;65;76;141;16;10;26
96;07.04.2016;2016;04;18;Torstai;44;53;97;21;17;38
96;07.04.2016;2016;04;19;Torstai;56;37;93;12;26;38
96;07.04.2016;2016;04;20;Torstai;35;27;62;11;14;25
96;07.04.2016;2016;04;21;Torstai;22;21;43;7;7;14
96;07.04.2016;2016;04;22;Torstai;9;8;17;0;1;1
96;07.04.2016;2016;04;23;Torstai;6;0;6;1;0;1
96;08.04.2016;2016;04;00;Perjantai;3;0;3;0;0;0
96;08.04.2016;2016;04;01;Perjantai;1;1;2;0;0;0
96;08.04.2016;2016;04;02;Perjantai;2;1;3;0;0;0
96;08.04.2016;2016;04;03;Perjantai;0;0;0;1;0;1
96;08.04.2016;2016;04;04;Perjantai;3;1;4;1;1;2
96;08.04.2016;2016;04;05;Perjantai;2;6;8;1;3;4
96;08.04.2016;2016;04;06;Perjantai;33;18;51;13;1;14
96;08.04.2016;2016;04;07;Perjantai;76;71;147;13;6;19
96;08.04.2016;2016;04;08;Perjantai;76;101;177;12;5;17
96;08.04.2016;2016;04;09;Perjantai;70;50;120;9;11;20
96;08.04.2016;2016;04;10;Perjantai;55;31;86;15;8;23
96;08.04.2016;2016;04;11;Perjantai;41;61;102;15;17;32
96;08.04.2016;2016;04;12;Perjantai;65;75;140;18;18;36
96;08.04.2016;2016;04;13;Perjantai;52;103;155;12;17;29
96;08.04.2016;2016;04;14;Perjantai;70;119;189;15;21;36
96;08.04.2016;2016;04;15;Perjantai;83;150;233;9;27;36
96;08.04.2016;2016;04;16;Perjantai;78;94;172;15;13;28
96;08.04.2016;2016;04;17;Perjantai;56;51;107;12;12;24
96;08.04.2016;2016;04;18;Perjantai;46;53;99;15;8;23
96;08.04.2016;2016;04;19;Perjantai;38;29;67;5;14;19
96;08.04.2016;2016;04;20;Perjantai;21;20;41;9;12;21
96;08.04.2016;2016;04;21;Perjantai;17;34;51;5;8;13
96;08.04.2016;2016;04;22;Perjantai;13;11;24;2;1;3
96;08.04.2016;2016;04;23;Perjantai;9;8;17;2;1;3
96;09.04.2016;2016;04;00;Lauantai;11;4;15;0;0;0
96;09.04.2016;2016;04;01;Lauantai;9;1;10;1;0;1
96;09.04.2016;2016;04;02;Lauantai;7;0;7;3;0;3
96;09.04.2016;2016;04;03;Lauantai;6;1;7;0;1;1
96;09.04.2016;2016;04;04;Lauantai;10;2;12;0;1;1
96;09.04.2016;2016;04;05;Lauantai;3;1;4;3;0;3
96;09.04.2016;2016;04;06;Lauantai;17;7;24;2;0;2
96;09.04.2016;2016;04;07;Lauantai;4;17;21;0;1;1
96;09.04.2016;2016;04;08;Lauantai;13;19;32;5;4;9
96;09.04.2016;2016;04;09;Lauantai;17;35;52;9;13;22
96;09.04.2016;2016;04;10;Lauantai;22;40;62;13;8;21
96;09.04.2016;2016;04;11;Lauantai;34;62;96;17;17;34
96;09.04.2016;2016;04;12;Lauantai;56;53;109;14;14;28
96;09.04.2016;2016;04;13;Lauantai;55;51;106;11;14;25
96;09.04.2016;2016;04;14;Lauantai;60;64;124;24;18;42
96;09.04.2016;2016;04;15;Lauantai;55;56;111;23;18;41
96;09.04.2016;2016;04;16;Lauantai;60;99;159;15;27;42
96;09.04.2016;2016;04;17;Lauantai;62;33;95;19;16;35
96;09.04.2016;2016;04;18;Lauantai;30;26;56;14;9;23
96;09.04.2016;2016;04;19;Lauantai;33;19;52;13;5;18
96;09.04.2016;2016;04;20;Lauantai;53;21;74;18;13;31
96;09.04.2016;2016;04;21;Lauantai;18;30;48;4;6;10
96;09.04.2016;2016;04;22;Lauantai;8;12;20;1;1;2
96;09.04.2016;2016;04;23;Lauantai;12;2;14;0;1;1
96;10.04.2016;2016;04;00;Sunnuntai;14;13;27;2;1;3
96;10.04.2016;2016;04;01;Sunnuntai;6;6;12;1;0;1
96;10.04.2016;2016;04;02;Sunnuntai;9;1;10;3;1;4
96;10.04.2016;2016;04;03;Sunnuntai;5;1;6;0;0;0
96;10.04.2016;2016;04;04;Sunnuntai;7;0;7;1;2;3
96;10.04.2016;2016;04;05;Sunnuntai;2;0;2;1;0;1
96;10.04.2016;2016;04;06;Sunnuntai;15;8;23;5;1;6
96;10.04.2016;2016;04;07;Sunnuntai;3;5;8;2;0;2
96;10.04.2016;2016;04;08;Sunnuntai;5;9;14;1;3;4
96;10.04.2016;2016;04;09;Sunnuntai;11;12;23;6;6;12
96;10.04.2016;2016;04;10;Sunnuntai;19;24;43;8;14;22
96;10.04.2016;2016;04;11;Sunnuntai;22;23;45;16;13;29
96;10.04.2016;2016;04;12;Sunnuntai;37;46;83;20;16;36
96;10.04.2016;2016;04;13;Sunnuntai;41;47;88;13;17;30
96;10.04.2016;2016;04;14;Sunnuntai;60;44;104;11;18;29
96;10.04.2016;2016;04;15;Sunnuntai;46;55;101;5;18;23
96;10.04.2016;2016;04;16;Sunnuntai;63;46;109;23;8;31
96;10.04.2016;2016;04;17;Sunnuntai;52;40;92;22;17;39
96;10.04.2016;2016;04;18;Sunnuntai;44;45;89;23;10;33
96;10.04.2016;2016;04;19;Sunnuntai;21;41;62;7;16;23
96;10.04.2016;2016;04;20;Sunnuntai;23;29;52;10;11;21
96;10.04.2016;2016;04;21;Sunnuntai;26;23;49;6;2;8
96;10.04.2016;2016;04;22;Sunnuntai;7;6;13;0;4;4
96;10.04.2016;2016;04;23;Sunnuntai;5;1;6;4;1;5
96;11.04.2016;2016;04;00;Maanantai;0;2;2;0;1;1
96;11.04.2016;2016;04;01;Maanantai;2;2;4;0;0;0
96;11.04.2016;2016;04;02;Maanantai;1;0;1;0;0;0
96;11.04.2016;2016;04;03;Maanantai;1;1;2;0;0;0
96;11.04.2016;2016;04;04;Maanantai;1;1;2;0;0;0
96;11.04.2016;2016;04;05;Maanantai;5;9;14;0;0;0
96;11.04.2016;2016;04;06;Maanantai;42;22;64;4;2;6
96;11.04.2016;2016;04;07;Maanantai;114;82;196;18;12;30
96;11.04.2016;2016;04;08;Maanantai;99;115;214;17;6;23
96;11.04.2016;2016;04;09;Maanantai;58;66;124;18;9;27
96;11.04.2016;2016;04;10;Maanantai;59;79;138;12;16;28
96;11.04.2016;2016;04;11;Maanantai;69;66;135;12;15;27
96;11.04.2016;2016;04;12;Maanantai;86;75;161;13;15;28
96;11.04.2016;2016;04;13;Maanantai;81;95;176;11;25;36
96;11.04.2016;2016;04;14;Maanantai;78;111;189;11;25;36
96;11.04.2016;2016;04;15;Maanantai;88;180;268;10;20;30
96;11.04.2016;2016;04;16;Maanantai;102;171;273;16;28;44
96;11.04.2016;2016;04;17;Maanantai;69;114;183;15;19;34
96;11.04.2016;2016;04;18;Maanantai;49;48;97;27;19;46
96;11.04.2016;2016;04;19;Maanantai;67;47;114;14;26;40
96;11.04.2016;2016;04;20;Maanantai;56;25;81;7;8;15
96;11.04.2016;2016;04;21;Maanantai;28;39;67;6;5;11
96;11.04.2016;2016;04;22;Maanantai;10;10;20;2;4;6
96;11.04.2016;2016;04;23;Maanantai;7;4;11;4;2;6
96;12.04.2016;2016;04;00;Tiistai;4;0;4;1;1;2
96;12.04.2016;2016;04;01;Tiistai;1;0;1;0;0;0
96;12.04.2016;2016;04;02;Tiistai;1;0;1;0;0;0
96;12.04.2016;2016;04;03;Tiistai;1;1;2;0;0;0
96;12.04.2016;2016;04;04;Tiistai;2;0;2;0;0;0
96;12.04.2016;2016;04;05;Tiistai;3;5;8;0;1;1
96;12.04.2016;2016;04;06;Tiistai;49;26;75;7;1;8
96;12.04.2016;2016;04;07;Tiistai;104;100;204;14;10;24
96;12.04.2016;2016;04;08;Tiistai;110;118;228;20;8;28
96;12.04.2016;2016;04;09;Tiistai;76;68;144;11;10;21
96;12.04.2016;2016;04;10;Tiistai;50;40;90;18;16;34
96;12.04.2016;2016;04;11;Tiistai;69;57;126;10;13;23
96;12.04.2016;2016;04;12;Tiistai;76;56;132;8;9;17
96;12.04.2016;2016;04;13;Tiistai;57;71;128;11;10;21
96;12.04.2016;2016;04;14;Tiistai;72;107;179;8;9;17
96;12.04.2016;2016;04;15;Tiistai;79;190;269;10;35;45
96;12.04.2016;2016;04;16;Tiistai;110;174;284;18;29;47
96;12.04.2016;2016;04;17;Tiistai;53;118;171;27;35;62
96;12.04.2016;2016;04;18;Tiistai;55;101;156;22;28;50
96;12.04.2016;2016;04;19;Tiistai;48;45;93;17;14;31
96;12.04.2016;2016;04;20;Tiistai;48;37;85;11;8;19
96;12.04.2016;2016;04;21;Tiistai;95;37;132;21;4;25
96;12.04.2016;2016;04;22;Tiistai;20;16;36;3;6;9
96;12.04.2016;2016;04;23;Tiistai;7;3;10;2;0;2
96;13.04.2016;2016;04;00;Keskiviikko;3;3;6;0;3;3
96;13.04.2016;2016;04;01;Keskiviikko;3;0;3;1;0;1
96;13.04.2016;2016;04;02;Keskiviikko;4;0;4;0;0;0
96;13.04.2016;2016;04;03;Keskiviikko;1;0;1;0;1;1
96;13.04.2016;2016;04;04;Keskiviikko;3;0;3;2;0;2
96;13.04.2016;2016;04;05;Keskiviikko;3;5;8;0;0;0
96;13.04.2016;2016;04;06;Keskiviikko;40;36;76;7;3;10
96;13.04.2016;2016;04;07;Keskiviikko;109;109;218;15;5;20
96;13.04.2016;2016;04;08;Keskiviikko;141;107;248;25;14;39
96;13.04.2016;2016;04;09;Keskiviikko;59;64;123;11;12;23
96;13.04.2016;2016;04;10;Keskiviikko;53;49;102;6;8;14
96;13.04.2016;2016;04;11;Keskiviikko;58;66;124;8;10;18
96;13.04.2016;2016;04;12;Keskiviikko;59;62;121;11;11;22
96;13.04.2016;2016;04;13;Keskiviikko;64;85;149;7;16;23
96;13.04.2016;2016;04;14;Keskiviikko;62;121;183;8;12;20
96;13.04.2016;2016;04;15;Keskiviikko;74;180;254;11;22;33
96;13.04.2016;2016;04;16;Keskiviikko;113;171;284;6;28;34
96;13.04.2016;2016;04;17;Keskiviikko;66;80;146;19;16;35
96;13.04.2016;2016;04;18;Keskiviikko;54;60;114;17;22;39
96;13.04.2016;2016;04;19;Keskiviikko;51;39;90;21;18;39
96;13.04.2016;2016;04;20;Keskiviikko;45;30;75;8;18;26
96;13.04.2016;2016;04;21;Keskiviikko;21;46;67;9;14;23
96;13.04.2016;2016;04;22;Keskiviikko;12;10;22;0;2;2
96;13.04.2016;2016;04;23;Keskiviikko;4;6;10;2;0;2
96;14.04.2016;2016;04;00;Torstai;2;3;5;1;0;1
96;14.04.2016;2016;04;01;Torstai;3;0;3;1;0;1
96;14.04.2016;2016;04;02;Torstai;2;0;2;0;0;0
96;14.04.2016;2016;04;03;Torstai;4;0;4;0;1;1
96;14.04.2016;2016;04;04;Torstai;4;1;5;0;0;0
96;14.04.2016;2016;04;05;Torstai;5;2;7;0;0;0
96;14.04.2016;2016;04;06;Torstai;38;26;64;13;3;16
96;14.04.2016;2016;04;07;Torstai;104;78;182;22;5;27
96;14.04.2016;2016;04;08;Torstai;116;91;207;8;11;19
96;14.04.2016;2016;04;09;Torstai;61;70;131;7;6;13
96;14.04.2016;2016;04;10;Torstai;49;63;112;9;10;19
96;14.04.2016;2016;04;11;Torstai;59;63;122;9;10;19
96;14.04.2016;2016;04;12;Torstai;76;103;179;18;14;32
96;14.04.2016;2016;04;13;Torstai;92;137;229;6;20;26
96;14.04.2016;2016;04;14;Torstai;82;121;203;6;24;30
96;14.04.2016;2016;04;15;Torstai;109;175;284;13;26;39
96;14.04.2016;2016;04;16;Torstai;108;153;261;12;26;38
96;14.04.2016;2016;04;17;Torstai;89;73;162;10;26;36
96;14.04.2016;2016;04;18;Torstai;62;47;109;16;21;37
96;14.04.2016;2016;04;19;Torstai;60;51;111;11;17;28
96;14.04.2016;2016;04;20;Torstai;44;33;77;2;14;16
96;14.04.2016;2016;04;21;Torstai;41;37;78;3;9;12
96;14.04.2016;2016;04;22;Torstai;18;8;26;0;2;2
96;14.04.2016;2016;04;23;Torstai;6;2;8;0;1;1
96;15.04.2016;2016;04;00;Perjantai;1;0;1;0;0;0
96;15.04.2016;2016;04;01;Perjantai;2;4;6;1;0;1
96;15.04.2016;2016;04;02;Perjantai;1;0;1;1;0;1
96;15.04.2016;2016;04;03;Perjantai;1;0;1;0;0;0
96;15.04.2016;2016;04;04;Perjantai;5;1;6;0;0;0
96;15.04.2016;2016;04;05;Perjantai;3;2;5;0;0;0
96;15.04.2016;2016;04;06;Perjantai;40;18;58;10;4;14
96;15.04.2016;2016;04;07;Perjantai;87;70;157;18;8;26
96;15.04.2016;2016;04;08;Perjantai;102;89;191;15;12;27
96;15.04.2016;2016;04;09;Perjantai;35;76;111;13;11;24
96;15.04.2016;2016;04;10;Perjantai;64;64;128;15;12;27
96;15.04.2016;2016;04;11;Perjantai;50;72;122;9;10;19
96;15.04.2016;2016;04;12;Perjantai;74;95;169;15;14;29
96;15.04.2016;2016;04;13;Perjantai;78;113;191;9;11;20
96;15.04.2016;2016;04;14;Perjantai;70;140;210;11;17;28
96;15.04.2016;2016;04;15;Perjantai;90;163;253;6;33;39
96;15.04.2016;2016;04;16;Perjantai;86;104;190;14;12;26
96;15.04.2016;2016;04;17;Perjantai;68;71;139;11;16;27
96;15.04.2016;2016;04;18;Perjantai;38;77;115;7;12;19
96;15.04.2016;2016;04;19;Perjantai;40;39;79;10;4;14
96;15.04.2016;2016;04;20;Perjantai;57;18;75;13;7;20
96;15.04.2016;2016;04;21;Perjantai;46;24;70;5;11;16
96;15.04.2016;2016;04;22;Perjantai;13;11;24;1;0;1
96;15.04.2016;2016;04;23;Perjantai;13;11;24;1;3;4
96;16.04.2016;2016;04;00;Lauantai;11;5;16;0;1;1
96;16.04.2016;2016;04;01;Lauantai;7;6;13;0;1;1
96;16.04.2016;2016;04;02;Lauantai;7;1;8;1;1;2
96;16.04.2016;2016;04;03;Lauantai;12;0;12;5;0;5
96;16.04.2016;2016;04;04;Lauantai;6;1;7;2;0;2
96;16.04.2016;2016;04;05;Lauantai;3;2;5;2;1;3
96;16.04.2016;2016;04;06;Lauantai;17;12;29;2;1;3
96;16.04.2016;2016;04;07;Lauantai;4;11;15;2;4;6
96;16.04.2016;2016;04;08;Lauantai;5;21;26;4;8;12
96;16.04.2016;2016;04;09;Lauantai;15;29;44;4;6;10
96;16.04.2016;2016;04;10;Lauantai;15;37;52;4;11;15
96;16.04.2016;2016;04;11;Lauantai;38;48;86;3;13;16
96;16.04.2016;2016;04;12;Lauantai;61;84;145;24;18;42
96;16.04.2016;2016;04;13;Lauantai;61;65;126;17;34;51
96;16.04.2016;2016;04;14;Lauantai;63;86;149;13;22;35
96;16.04.2016;2016;04;15;Lauantai;68;52;120;16;11;27
96;16.04.2016;2016;04;16;Lauantai;58;22;80;10;10;20
96;16.04.2016;2016;04;17;Lauantai;36;21;57;12;3;15
96;16.04.2016;2016;04;18;Lauantai;27;24;51;15;12;27
96;16.04.2016;2016;04;19;Lauantai;15;28;43;13;5;18
96;16.04.2016;2016;04;20;Lauantai;27;12;39;5;4;9
96;16.04.2016;2016;04;21;Lauantai;11;33;44;4;7;11
96;16.04.2016;2016;04;22;Lauantai;8;16;24;4;7;11
96;16.04.2016;2016;04;23;Lauantai;17;10;27;2;0;2
96;17.04.2016;2016;04;00;Sunnuntai;7;4;11;0;1;1
96;17.04.2016;2016;04;01;Sunnuntai;12;9;21;3;0;3
96;17.04.2016;2016;04;02;Sunnuntai;5;0;5;1;0;1
96;17.04.2016;2016;04;03;Sunnuntai;5;0;5;2;0;2
96;17.04.2016;2016;04;04;Sunnuntai;15;2;17;0;1;1
96;17.04.2016;2016;04;05;Sunnuntai;8;1;9;2;1;3
96;17.04.2016;2016;04;06;Sunnuntai;13;5;18;1;1;2
96;17.04.2016;2016;04;07;Sunnuntai;3;8;11;1;2;3
96;17.04.2016;2016;04;08;Sunnuntai;6;7;13;5;4;9
96;17.04.2016;2016;04;09;Sunnuntai;8;12;20;1;4;5
96;17.04.2016;2016;04;10;Sunnuntai;4;15;19;4;8;12
96;17.04.2016;2016;04;11;Sunnuntai;9;29;38;6;13;19
96;17.04.2016;2016;04;12;Sunnuntai;22;26;48;8;17;25
96;17.04.2016;2016;04;13;Sunnuntai;36;29;65;17;16;33
96;17.04.2016;2016;04;14;Sunnuntai;26;54;80;18;10;28
96;17.04.2016;2016;04;15;Sunnuntai;36;37;73;11;7;18
96;17.04.2016;2016;04;16;Sunnuntai;50;35;85;20;2;22
96;17.04.2016;2016;04;17;Sunnuntai;48;31;79;12;14;26
96;17.04.2016;2016;04;18;Sunnuntai;36;29;65;17;17;34
96;17.04.2016;2016;04;19;Sunnuntai;35;22;57;10;8;18
96;17.04.2016;2016;04;20;Sunnuntai;14;18;32;9;8;17
96;17.04.2016;2016;04;21;Sunnuntai;17;35;52;4;7;11
96;17.04.2016;2016;04;22;Sunnuntai;2;9;11;3;5;8
96;17.04.2016;2016;04;23;Sunnuntai;7;2;9;2;1;3
96;18.04.2016;2016;04;00;Maanantai;1;2;3;1;0;1
96;18.04.2016;2016;04;01;Maanantai;0;3;3;0;0;0
96;18.04.2016;2016;04;02;Maanantai;1;0;1;0;0;0
96;18.04.2016;2016;04;03;Maanantai;2;0;2;0;0;0
96;18.04.2016;2016;04;04;Maanantai;1;0;1;0;0;0
96;18.04.2016;2016;04;05;Maanantai;6;5;11;0;0;0
96;18.04.2016;2016;04;06;Maanantai;39;27;66;5;3;8
96;18.04.2016;2016;04;07;Maanantai;103;98;201;16;8;24
96;18.04.2016;2016;04;08;Maanantai;109;101;210;20;6;26
96;18.04.2016;2016;04;09;Maanantai;69;71;140;15;33;48
96;18.04.2016;2016;04;10;Maanantai;52;50;102;13;7;20
96;18.04.2016;2016;04;11;Maanantai;46;53;99;8;10;18
96;18.04.2016;2016;04;12;Maanantai;66;74;140;10;17;27
96;18.04.2016;2016;04;13;Maanantai;72;88;160;19;10;29
96;18.04.2016;2016;04;14;Maanantai;70;124;194;5;16;21
96;18.04.2016;2016;04;15;Maanantai;80;188;268;4;24;28
96;18.04.2016;2016;04;16;Maanantai;86;160;246;6;23;29
96;18.04.2016;2016;04;17;Maanantai;63;100;163;8;18;26
96;18.04.2016;2016;04;18;Maanantai;61;52;113;13;11;24
96;18.04.2016;2016;04;19;Maanantai;48;46;94;19;12;31
96;18.04.2016;2016;04;20;Maanantai;48;31;79;6;11;17
96;18.04.2016;2016;04;21;Maanantai;31;36;67;9;8;17
96;18.04.2016;2016;04;22;Maanantai;5;11;16;1;1;2
96;18.04.2016;2016;04;23;Maanantai;4;5;9;1;0;1
96;19.04.2016;2016;04;00;Tiistai;5;1;6;0;0;0
96;19.04.2016;2016;04;01;Tiistai;2;0;2;0;0;0
96;19.04.2016;2016;04;02;Tiistai;1;1;2;1;0;1
96;19.04.2016;2016;04;03;Tiistai;0;0;0;0;0;0
96;19.04.2016;2016;04;04;Tiistai;2;0;2;0;0;0
96;19.04.2016;2016;04;05;Tiistai;6;5;11;0;0;0
96;19.04.2016;2016;04;06;Tiistai;44;24;68;11;7;18
96;19.04.2016;2016;04;07;Tiistai;116;97;213;20;8;28
96;19.04.2016;2016;04;08;Tiistai;99;99;198;11;4;15
96;19.04.2016;2016;04;09;Tiistai;65;68;133;5;5;10
96;19.04.2016;2016;04;10;Tiistai;59;41;100;10;6;16
96;19.04.2016;2016;04;11;Tiistai;57;52;109;7;7;14
96;19.04.2016;2016;04;12;Tiistai;61;79;140;8;8;16
96;19.04.2016;2016;04;13;Tiistai;50;74;124;17;12;29
96;19.04.2016;2016;04;14;Tiistai;94;109;203;7;14;21
96;19.04.2016;2016;04;15;Tiistai;77;177;254;4;34;38
96;19.04.2016;2016;04;16;Tiistai;88;129;217;15;18;33
96;19.04.2016;2016;04;17;Tiistai;59;68;127;7;16;23
96;19.04.2016;2016;04;18;Tiistai;35;35;70;14;9;23
96;19.04.2016;2016;04;19;Tiistai;45;34;79;10;22;32
96;19.04.2016;2016;04;20;Tiistai;31;30;61;3;5;8
96;19.04.2016;2016;04;21;Tiistai;23;21;44;0;4;4
96;19.04.2016;2016;04;22;Tiistai;9;14;23;1;2;3
96;19.04.2016;2016;04;23;Tiistai;7;4;11;4;0;4
96;20.04.2016;2016;04;00;Keskiviikko;3;1;4;1;1;2
96;20.04.2016;2016;04;01;Keskiviikko;0;1;1;0;0;0
96;20.04.2016;2016;04;02;Keskiviikko;3;2;5;3;5;8
96;20.04.2016;2016;04;03;Keskiviikko;5;2;7;25;15;40
96;20.04.2016;2016;04;04;Keskiviikko;2;2;4;0;0;0
96;20.04.2016;2016;04;05;Keskiviikko;8;1;9;0;0;0
96;20.04.2016;2016;04;06;Keskiviikko;35;29;64;6;2;8
96;20.04.2016;2016;04;07;Keskiviikko;101;80;181;14;7;21
96;20.04.2016;2016;04;08;Keskiviikko;131;100;231;21;11;32
96;20.04.2016;2016;04;09;Keskiviikko;76;85;161;14;9;23
96;20.04.2016;2016;04;10;Keskiviikko;43;55;98;26;21;47
96;20.04.2016;2016;04;11;Keskiviikko;60;60;120;11;8;19
96;20.04.2016;2016;04;12;Keskiviikko;68;67;135;7;13;20
96;20.04.2016;2016;04;13;Keskiviikko;59;93;152;5;14;19
96;20.04.2016;2016;04;14;Keskiviikko;81;113;194;11;13;24
96;20.04.2016;2016;04;15;Keskiviikko;75;192;267;5;21;26
96;20.04.2016;2016;04;16;Keskiviikko;85;167;252;10;21;31
96;20.04.2016;2016;04;17;Keskiviikko;51;68;119;9;9;18
96;20.04.2016;2016;04;18;Keskiviikko;61;61;122;17;10;27
96;20.04.2016;2016;04;19;Keskiviikko;51;48;99;17;12;29
96;20.04.2016;2016;04;20;Keskiviikko;50;24;74;10;7;17
96;20.04.2016;2016;04;21;Keskiviikko;25;37;62;4;11;15
96;20.04.2016;2016;04;22;Keskiviikko;10;7;17;1;4;5
96;20.04.2016;2016;04;23;Keskiviikko;15;7;22;0;0;0
96;21.04.2016;2016;04;00;Torstai;5;7;12;2;0;2
96;21.04.2016;2016;04;01;Torstai;2;2;4;0;0;0
96;21.04.2016;2016;04;02;Torstai;4;0;4;0;0;0
96;21.04.2016;2016;04;03;Torstai;2;0;2;0;0;0
96;21.04.2016;2016;04;04;Torstai;2;1;3;0;0;0
96;21.04.2016;2016;04;05;Torstai;4;4;8;1;1;2
96;21.04.2016;2016;04;06;Torstai;38;29;67;8;1;9
96;21.04.2016;2016;04;07;Torstai;97;85;182;19;4;23
96;21.04.2016;2016;04;08;Torstai;118;102;220;16;4;20
96;21.04.2016;2016;04;09;Torstai;57;61;118;11;5;16
96;21.04.2016;2016;04;10;Torstai;47;55;102;11;8;19
96;21.04.2016;2016;04;11;Torstai;68;46;114;9;4;13
96;21.04.2016;2016;04;12;Torstai;62;71;133;17;9;26
96;21.04.2016;2016;04;13;Torstai;67;114;181;12;29;41
96;21.04.2016;2016;04;14;Torstai;83;146;229;12;27;39
96;21.04.2016;2016;04;15;Torstai;87;172;259;8;22;30
96;21.04.2016;2016;04;16;Torstai;109;155;264;14;21;35
96;21.04.2016;2016;04;17;Torstai;76;96;172;16;18;34
96;21.04.2016;2016;04;18;Torstai;43;86;129;18;16;34
96;21.04.2016;2016;04;19;Torstai;55;39;94;11;18;29
96;21.04.2016;2016;04;20;Torstai;58;44;102;20;13;33
96;21.04.2016;2016;04;21;Torstai;43;39;82;5;4;9
96;21.04.2016;2016;04;22;Torstai;15;13;28;2;3;5
96;21.04.2016;2016;04;23;Torstai;9;5;14;0;1;1
96;22.04.2016;2016;04;00;Perjantai;3;4;7;1;0;1
96;22.04.2016;2016;04;01;Perjantai;1;0;1;0;1;1
96;22.04.2016;2016;04;02;Perjantai;3;3;6;0;0;0
96;22.04.2016;2016;04;03;Perjantai;2;1;3;0;0;0
96;22.04.2016;2016;04;04;Perjantai;3;1;4;0;0;0
96;22.04.2016;2016;04;05;Perjantai;6;6;12;1;0;1
96;22.04.2016;2016;04;06;Perjantai;39;20;59;6;5;11
96;22.04.2016;2016;04;07;Perjantai;108;78;186;12;8;20
96;22.04.2016;2016;04;08;Perjantai;92;101;193;10;11;21
96;22.04.2016;2016;04;09;Perjantai;65;115;180;7;4;11
96;22.04.2016;2016;04;10;Perjantai;51;63;114;8;8;16
96;22.04.2016;2016;04;11;Perjantai;75;91;166;8;20;28
96;22.04.2016;2016;04;12;Perjantai;64;77;141;11;15;26
96;22.04.2016;2016;04;13;Perjantai;58;66;124;6;9;15
96;22.04.2016;2016;04;14;Perjantai;66;110;176;8;22;30
96;22.04.2016;2016;04;15;Perjantai;84;141;225;10;25;35
96;22.04.2016;2016;04;16;Perjantai;71;91;162;4;10;14
96;22.04.2016;2016;04;17;Perjantai;58;37;95;3;10;13
96;22.04.2016;2016;04;18;Perjantai;38;55;93;5;5;10
96;22.04.2016;2016;04;19;Perjantai;51;42;93;8;10;18
96;22.04.2016;2016;04;20;Perjantai;29;34;63;3;8;11
96;22.04.2016;2016;04;21;Perjantai;20;19;39;4;4;8
96;22.04.2016;2016;04;22;Perjantai;21;16;37;1;1;2
96;22.04.2016;2016;04;23;Perjantai;8;15;23;2;0;2
96;23.04.2016;2016;04;00;Lauantai;9;8;17;0;2;2
96;23.04.2016;2016;04;01;Lauantai;8;1;9;0;0;0
96;23.04.2016;2016;04;02;Lauantai;7;1;8;1;1;2
96;23.04.2016;2016;04;03;Lauantai;7;0;7;1;1;2
96;23.04.2016;2016;04;04;Lauantai;10;2;12;0;1;1
96;23.04.2016;2016;04;05;Lauantai;2;3;5;0;1;1
96;23.04.2016;2016;04;06;Lauantai;16;11;27;1;1;2
96;23.04.2016;2016;04;07;Lauantai;7;10;17;0;3;3
96;23.04.2016;2016;04;08;Lauantai;9;22;31;9;5;14
96;23.04.2016;2016;04;09;Lauantai;24;40;64;3;8;11
96;23.04.2016;2016;04;10;Lauantai;25;65;90;7;41;48
96;23.04.2016;2016;04;11;Lauantai;39;66;105;24;22;46
96;23.04.2016;2016;04;12;Lauantai;61;56;117;58;15;73
96;23.04.2016;2016;04;13;Lauantai;62;56;118;22;6;28
96;23.04.2016;2016;04;14;Lauantai;48;34;82;14;11;25
96;23.04.2016;2016;04;15;Lauantai;65;33;98;5;4;9
96;23.04.2016;2016;04;16;Lauantai;39;33;72;4;5;9
96;23.04.2016;2016;04;17;Lauantai;41;34;75;11;5;16
96;23.04.2016;2016;04;18;Lauantai;38;28;66;14;7;21
96;23.04.2016;2016;04;19;Lauantai;31;25;56;9;16;25
96;23.04.2016;2016;04;20;Lauantai;23;15;38;6;8;14
96;23.04.2016;2016;04;21;Lauantai;9;37;46;1;9;10
96;23.04.2016;2016;04;22;Lauantai;4;9;13;2;2;4
96;23.04.2016;2016;04;23;Lauantai;5;5;10;0;0;0
96;24.04.2016;2016;04;00;Sunnuntai;5;6;11;0;0;0
96;24.04.2016;2016;04;01;Sunnuntai;2;4;6;0;0;0
96;24.04.2016;2016;04;02;Sunnuntai;7;0;7;0;0;0
96;24.04.2016;2016;04;03;Sunnuntai;3;1;4;2;0;2
96;24.04.2016;2016;04;04;Sunnuntai;5;0;5;1;0;1
96;24.04.2016;2016;04;05;Sunnuntai;2;0;2;0;0;0
96;24.04.2016;2016;04;06;Sunnuntai;11;8;19;1;1;2
96;24.04.2016;2016;04;07;Sunnuntai;1;10;11;3;4;7
96;24.04.2016;2016;04;08;Sunnuntai;4;11;15;3;3;6
96;24.04.2016;2016;04;09;Sunnuntai;18;6;24;3;4;7
96;24.04.2016;2016;04;10;Sunnuntai;18;23;41;7;6;13
96;24.04.2016;2016;04;11;Sunnuntai;26;44;70;8;14;22
96;24.04.2016;2016;04;12;Sunnuntai;41;43;84;8;7;15
96;24.04.2016;2016;04;13;Sunnuntai;48;34;82;12;12;24
96;24.04.2016;2016;04;14;Sunnuntai;30;41;71;10;14;24
96;24.04.2016;2016;04;15;Sunnuntai;41;32;73;10;8;18
96;24.04.2016;2016;04;16;Sunnuntai;45;35;80;17;7;24
96;24.04.2016;2016;04;17;Sunnuntai;36;23;59;7;8;15
96;24.04.2016;2016;04;18;Sunnuntai;36;38;74;13;11;24
96;24.04.2016;2016;04;19;Sunnuntai;26;26;52;16;14;30
96;24.04.2016;2016;04;20;Sunnuntai;18;37;55;8;17;25
96;24.04.2016;2016;04;21;Sunnuntai;11;29;40;8;8;16
96;24.04.2016;2016;04;22;Sunnuntai;8;11;19;3;1;4
96;24.04.2016;2016;04;23;Sunnuntai;11;4;15;0;1;1
96;25.04.2016;2016;04;00;Maanantai;1;0;1;0;0;0
96;25.04.2016;2016;04;01;Maanantai;4;1;5;0;0;0
96;25.04.2016;2016;04;02;Maanantai;3;1;4;0;0;0
96;25.04.2016;2016;04;03;Maanantai;1;0;1;0;0;0
96;25.04.2016;2016;04;04;Maanantai;1;3;4;0;0;0
96;25.04.2016;2016;04;05;Maanantai;4;4;8;0;0;0
96;25.04.2016;2016;04;06;Maanantai;32;29;61;6;4;10
96;25.04.2016;2016;04;07;Maanantai;100;85;185;16;6;22
96;25.04.2016;2016;04;08;Maanantai;110;122;232;8;6;14
96;25.04.2016;2016;04;09;Maanantai;69;76;145;12;8;20
96;25.04.2016;2016;04;10;Maanantai;52;62;114;11;10;21
96;25.04.2016;2016;04;11;Maanantai;64;61;125;10;14;24
96;25.04.2016;2016;04;12;Maanantai;64;71;135;6;4;10
96;25.04.2016;2016;04;13;Maanantai;54;70;124;4;5;9
96;25.04.2016;2016;04;14;Maanantai;59;105;164;2;4;6
96;25.04.2016;2016;04;15;Maanantai;70;149;219;5;13;18
96;25.04.2016;2016;04;16;Maanantai;64;100;164;3;13;16
96;25.04.2016;2016;04;17;Maanantai;47;55;102;5;4;9
96;25.04.2016;2016;04;18;Maanantai;34;40;74;8;2;10
96;25.04.2016;2016;04;19;Maanantai;35;27;62;5;16;21
96;25.04.2016;2016;04;20;Maanantai;33;29;62;6;8;14
96;25.04.2016;2016;04;21;Maanantai;16;42;58;3;10;13
96;25.04.2016;2016;04;22;Maanantai;9;14;23;2;2;4
96;25.04.2016;2016;04;23;Maanantai;5;4;9;2;1;3
96;26.04.2016;2016;04;00;Tiistai;0;0;0;0;0;0
96;26.04.2016;2016;04;01;Tiistai;2;1;3;0;0;0
96;26.04.2016;2016;04;02;Tiistai;4;0;4;2;1;3
96;26.04.2016;2016;04;03;Tiistai;10;0;10;0;0;0
96;26.04.2016;2016;04;04;Tiistai;3;2;5;0;0;0
96;26.04.2016;2016;04;05;Tiistai;4;5;9;1;0;1
96;26.04.2016;2016;04;06;Tiistai;38;28;66;7;2;9
96;26.04.2016;2016;04;07;Tiistai;98;97;195;27;9;36
96;26.04.2016;2016;04;08;Tiistai;87;99;186;10;11;21
96;26.04.2016;2016;04;09;Tiistai;46;73;119;13;11;24
96;26.04.2016;2016;04;10;Tiistai;49;38;87;9;4;13
96;26.04.2016;2016;04;11;Tiistai;44;48;92;9;12;21
96;26.04.2016;2016;04;12;Tiistai;54;62;116;11;8;19
96;26.04.2016;2016;04;13;Tiistai;39;73;112;15;12;27
96;26.04.2016;2016;04;14;Tiistai;52;92;144;7;6;13
96;26.04.2016;2016;04;15;Tiistai;76;171;247;1;22;23
96;26.04.2016;2016;04;16;Tiistai;91;146;237;16;19;35
96;26.04.2016;2016;04;17;Tiistai;63;60;123;7;9;16
96;26.04.2016;2016;04;18;Tiistai;34;35;69;13;11;24
96;26.04.2016;2016;04;19;Tiistai;56;42;98;15;9;24
96;26.04.2016;2016;04;20;Tiistai;43;27;70;4;9;13
96;26.04.2016;2016;04;21;Tiistai;21;30;51;3;6;9
96;26.04.2016;2016;04;22;Tiistai;8;12;20;0;0;0
96;26.04.2016;2016;04;23;Tiistai;2;6;8;0;0;0
96;27.04.2016;2016;04;00;Keskiviikko;3;5;8;2;2;4
96;27.04.2016;2016;04;01;Keskiviikko;2;1;3;0;1;1
96;27.04.2016;2016;04;02;Keskiviikko;1;2;3;0;0;0
96;27.04.2016;2016;04;03;Keskiviikko;2;0;2;0;0;0
96;27.04.2016;2016;04;04;Keskiviikko;1;1;2;1;2;3
96;27.04.2016;2016;04;05;Keskiviikko;4;7;11;2;2;4
96;27.04.2016;2016;04;06;Keskiviikko;34;22;56;3;1;4
96;27.04.2016;2016;04;07;Keskiviikko;96;96;192;18;9;27
96;27.04.2016;2016;04;08;Keskiviikko;83;107;190;9;9;18
96;27.04.2016;2016;04;09;Keskiviikko;68;89;157;8;4;12
96;27.04.2016;2016;04;10;Keskiviikko;61;62;123;9;8;17
96;27.04.2016;2016;04;11;Keskiviikko;44;55;99;5;8;13
96;27.04.2016;2016;04;12;Keskiviikko;64;62;126;4;10;14
96;27.04.2016;2016;04;13;Keskiviikko;64;88;152;7;13;20
96;27.04.2016;2016;04;14;Keskiviikko;63;120;183;10;19;29
96;27.04.2016;2016;04;15;Keskiviikko;86;182;268;9;16;25
96;27.04.2016;2016;04;16;Keskiviikko;75;147;222;7;18;25
96;27.04.2016;2016;04;17;Keskiviikko;78;59;137;9;11;20
96;27.04.2016;2016;04;18;Keskiviikko;54;41;95;12;9;21
96;27.04.2016;2016;04;19;Keskiviikko;47;43;90;10;7;17
96;27.04.2016;2016;04;20;Keskiviikko;38;44;82;7;7;14
96;27.04.2016;2016;04;21;Keskiviikko;21;35;56;3;7;10
96;27.04.2016;2016;04;22;Keskiviikko;6;17;23;2;2;4
96;27.04.2016;2016;04;23;Keskiviikko;12;4;16;1;1;2
96;28.04.2016;2016;04;00;Torstai;6;6;12;0;0;0
96;28.04.2016;2016;04;01;Torstai;2;3;5;1;0;1
96;28.04.2016;2016;04;02;Torstai;4;1;5;1;0;1
96;28.04.2016;2016;04;03;Torstai;2;0;2;1;1;2
96;28.04.2016;2016;04;04;Torstai;4;2;6;0;0;0
96;28.04.2016;2016;04;05;Torstai;3;7;10;2;0;2
96;28.04.2016;2016;04;06;Torstai;37;26;63;8;1;9
96;28.04.2016;2016;04;07;Torstai;86;98;184;21;8;29
96;28.04.2016;2016;04;08;Torstai;93;118;211;7;8;15
96;28.04.2016;2016;04;09;Torstai;62;86;148;6;3;9
96;28.04.2016;2016;04;10;Torstai;76;64;140;8;10;18
96;28.04.2016;2016;04;11;Torstai;56;88;144;7;12;19
96;28.04.2016;2016;04;12;Torstai;76;58;134;9;6;15
96;28.04.2016;2016;04;13;Torstai;77;80;157;4;11;15
96;28.04.2016;2016;04;14;Torstai;53;125;178;10;17;27
96;28.04.2016;2016;04;15;Torstai;68;171;239;5;14;19
96;28.04.2016;2016;04;16;Torstai;98;185;283;10;26;36
96;28.04.2016;2016;04;17;Torstai;67;87;154;12;17;29
96;28.04.2016;2016;04;18;Torstai;64;58;122;11;11;22
96;28.04.2016;2016;04;19;Torstai;53;60;113;9;16;25
96;28.04.2016;2016;04;20;Torstai;49;48;97;6;8;14
96;28.04.2016;2016;04;21;Torstai;26;39;65;5;8;13
96;28.04.2016;2016;04;22;Torstai;22;23;45;3;2;5
96;28.04.2016;2016;04;23;Torstai;13;9;22;0;2;2
96;29.04.2016;2016;04;00;Perjantai;10;7;17;1;1;2
96;29.04.2016;2016;04;01;Perjantai;4;2;6;1;0;1
96;29.04.2016;2016;04;02;Perjantai;10;2;12;2;0;2
96;29.04.2016;2016;04;03;Perjantai;11;0;11;0;0;0
96;29.04.2016;2016;04;04;Perjantai;6;1;7;0;0;0
96;29.04.2016;2016;04;05;Perjantai;4;6;10;1;0;1
96;29.04.2016;2016;04;06;Perjantai;43;28;71;6;3;9
96;29.04.2016;2016;04;07;Perjantai;86;103;189;13;6;19
96;29.04.2016;2016;04;08;Perjantai;76;94;170;9;6;15
96;29.04.2016;2016;04;09;Perjantai;45;81;126;11;11;22
96;29.04.2016;2016;04;10;Perjantai;59;77;136;7;14;21
96;29.04.2016;2016;04;11;Perjantai;52;67;119;5;9;14
96;29.04.2016;2016;04;12;Perjantai;73;75;148;34;7;41
96;29.04.2016;2016;04;13;Perjantai;83;100;183;11;12;23
96;29.04.2016;2016;04;14;Perjantai;78;114;192;6;17;23
96;29.04.2016;2016;04;15;Perjantai;76;119;195;10;18;28
96;29.04.2016;2016;04;16;Perjantai;52;82;134;8;13;21
96;29.04.2016;2016;04;17;Perjantai;59;53;112;5;4;9
96;29.04.2016;2016;04;18;Perjantai;59;44;103;9;3;12
96;29.04.2016;2016;04;19;Perjantai;39;35;74;3;6;9
96;29.04.2016;2016;04;20;Perjantai;46;29;75;7;7;14
96;29.04.2016;2016;04;21;Perjantai;25;49;74;2;8;10
96;29.04.2016;2016;04;22;Perjantai;28;15;43;2;5;7
96;29.04.2016;2016;04;23;Perjantai;10;10;20;1;1;2
96;30.04.2016;2016;04;00;Lauantai;6;3;9;3;1;4
96;30.04.2016;2016;04;01;Lauantai;14;5;19;2;0;2
96;30.04.2016;2016;04;02;Lauantai;8;3;11;3;0;3
96;30.04.2016;2016;04;03;Lauantai;12;1;13;0;1;1
96;30.04.2016;2016;04;04;Lauantai;4;1;5;1;1;2
96;30.04.2016;2016;04;05;Lauantai;3;3;6;0;0;0
96;30.04.2016;2016;04;06;Lauantai;27;12;39;4;2;6
96;30.04.2016;2016;04;07;Lauantai;7;11;18;0;1;1
96;30.04.2016;2016;04;08;Lauantai;4;15;19;5;3;8
96;30.04.2016;2016;04;09;Lauantai;25;34;59;3;2;5
96;30.04.2016;2016;04;10;Lauantai;24;43;67;9;5;14
96;30.04.2016;2016;04;11;Lauantai;51;81;132;8;9;17
96;30.04.2016;2016;04;12;Lauantai;54;92;146;13;14;27
96;30.04.2016;2016;04;13;Lauantai;102;96;198;7;9;16
96;30.04.2016;2016;04;14;Lauantai;59;76;135;10;12;22
96;30.04.2016;2016;04;15;Lauantai;62;75;137;10;9;19
96;30.04.2016;2016;04;16;Lauantai;82;72;154;6;9;15
96;30.04.2016;2016;04;17;Lauantai;69;49;118;7;3;10
96;30.04.2016;2016;04;18;Lauantai;56;40;96;6;9;15
96;30.04.2016;2016;04;19;Lauantai;44;39;83;8;20;28
96;30.04.2016;2016;04;20;Lauantai;26;46;72;6;9;15
96;30.04.2016;2016;04;21;Lauantai;33;57;90;4;5;9
96;30.04.2016;2016;04;22;Lauantai;14;21;35;1;6;7
96;30.04.2016;2016;04;23;Lauantai;22;23;45;2;2;4
96;01.05.2016;2016;05;00;Sunnuntai;45;14;59;2;1;3
96;01.05.2016;2016;05;01;Sunnuntai;32;7;39;4;2;6
96;01.05.2016;2016;05;02;Sunnuntai;47;6;53;6;0;6
96;01.05.2016;2016;05;03;Sunnuntai;20;10;30;10;0;10
96;01.05.2016;2016;05;04;Sunnuntai;27;1;28;15;0;15
96;01.05.2016;2016;05;05;Sunnuntai;12;2;14;3;2;5
96;01.05.2016;2016;05;06;Sunnuntai;22;12;34;6;1;7
96;01.05.2016;2016;05;07;Sunnuntai;2;8;10;3;1;4
96;01.05.2016;2016;05;08;Sunnuntai;10;8;18;0;3;3
96;01.05.2016;2016;05;09;Sunnuntai;14;16;30;3;4;7
96;01.05.2016;2016;05;10;Sunnuntai;13;47;60;3;9;12
96;01.05.2016;2016;05;11;Sunnuntai;47;83;130;0;3;3
96;01.05.2016;2016;05;12;Sunnuntai;62;117;179;4;6;10
96;01.05.2016;2016;05;13;Sunnuntai;78;94;172;11;6;17
96;01.05.2016;2016;05;14;Sunnuntai;91;110;201;7;12;19
96;01.05.2016;2016;05;15;Sunnuntai;98;72;170;11;7;18
96;01.05.2016;2016;05;16;Sunnuntai;85;51;136;14;8;22
96;01.05.2016;2016;05;17;Sunnuntai;86;38;124;11;4;15
96;01.05.2016;2016;05;18;Sunnuntai;74;44;118;14;12;26
96;01.05.2016;2016;05;19;Sunnuntai;66;40;106;7;20;27
96;01.05.2016;2016;05;20;Sunnuntai;42;38;80;4;8;12
96;01.05.2016;2016;05;21;Sunnuntai;17;27;44;3;3;6
96;01.05.2016;2016;05;22;Sunnuntai;6;4;10;2;1;3
96;01.05.2016;2016;05;23;Sunnuntai;14;5;19;0;2;2
96;02.05.2016;2016;05;00;Maanantai;2;1;3;1;0;1
96;02.05.2016;2016;05;01;Maanantai;0;0;0;0;1;1
96;02.05.2016;2016;05;02;Maanantai;0;0;0;0;0;0
96;02.05.2016;2016;05;03;Maanantai;1;0;1;0;0;0
96;02.05.2016;2016;05;04;Maanantai;2;1;3;1;0;1
96;02.05.2016;2016;05;05;Maanantai;2;6;8;1;0;1
96;02.05.2016;2016;05;06;Maanantai;45;28;73;5;2;7
96;02.05.2016;2016;05;07;Maanantai;122;123;245;21;7;28
96;02.05.2016;2016;05;08;Maanantai;110;147;257;16;6;22
96;02.05.2016;2016;05;09;Maanantai;62;69;131;25;22;47
96;02.05.2016;2016;05;10;Maanantai;56;59;115;7;12;19
96;02.05.2016;2016;05;11;Maanantai;61;56;117;6;16;22
96;02.05.2016;2016;05;12;Maanantai;68;65;133;10;13;23
96;02.05.2016;2016;05;13;Maanantai;61;87;148;9;7;16
96;02.05.2016;2016;05;14;Maanantai;78;106;184;9;11;20
96;02.05.2016;2016;05;15;Maanantai;97;172;269;11;26;37
96;02.05.2016;2016;05;16;Maanantai;122;164;286;10;20;30
96;02.05.2016;2016;05;17;Maanantai;81;97;178;19;21;40
96;02.05.2016;2016;05;18;Maanantai;99;67;166;16;18;34
96;02.05.2016;2016;05;19;Maanantai;61;57;118;13;24;37
96;02.05.2016;2016;05;20;Maanantai;50;47;97;15;19;34
96;02.05.2016;2016;05;21;Maanantai;34;33;67;6;1;7
96;02.05.2016;2016;05;22;Maanantai;12;18;30;1;2;3
96;02.05.2016;2016;05;23;Maanantai;4;8;12;1;0;1
96;03.05.2016;2016;05;00;Tiistai;2;1;3;0;1;1
96;03.05.2016;2016;05;01;Tiistai;2;0;2;0;0;0
96;03.05.2016;2016;05;02;Tiistai;3;0;3;0;0;0
96;03.05.2016;2016;05;03;Tiistai;0;0;0;0;0;0
96;03.05.2016;2016;05;04;Tiistai;1;0;1;1;0;1
96;03.05.2016;2016;05;05;Tiistai;2;5;7;0;0;0
96;03.05.2016;2016;05;06;Tiistai;53;42;95;3;3;6
96;03.05.2016;2016;05;07;Tiistai;117;120;237;13;13;26
96;03.05.2016;2016;05;08;Tiistai;112;162;274;15;6;21
96;03.05.2016;2016;05;09;Tiistai;85;75;160;12;11;23
96;03.05.2016;2016;05;10;Tiistai;57;72;129;10;12;22
96;03.05.2016;2016;05;11;Tiistai;85;86;171;12;16;28
96;03.05.2016;2016;05;12;Tiistai;93;69;162;13;6;19
96;03.05.2016;2016;05;13;Tiistai;78;83;161;15;9;24
96;03.05.2016;2016;05;14;Tiistai;97;126;223;6;19;25
96;03.05.2016;2016;05;15;Tiistai;109;221;330;6;27;33
96;03.05.2016;2016;05;16;Tiistai;156;200;356;24;21;45
96;03.05.2016;2016;05;17;Tiistai;83;85;168;7;9;16
96;03.05.2016;2016;05;18;Tiistai;88;70;158;12;26;38
96;03.05.2016;2016;05;19;Tiistai;71;52;123;11;17;28
96;03.05.2016;2016;05;20;Tiistai;44;43;87;11;12;23
96;03.05.2016;2016;05;21;Tiistai;39;33;72;6;11;17
96;03.05.2016;2016;05;22;Tiistai;18;15;33;0;3;3
96;03.05.2016;2016;05;23;Tiistai;6;1;7;2;0;2
96;04.05.2016;2016;05;00;Keskiviikko;1;2;3;0;0;0
96;04.05.2016;2016;05;01;Keskiviikko;1;1;2;1;0;1
96;04.05.2016;2016;05;02;Keskiviikko;2;0;2;0;1;1
96;04.05.2016;2016;05;03;Keskiviikko;0;1;1;0;0;0
96;04.05.2016;2016;05;04;Keskiviikko;2;2;4;1;0;1
96;04.05.2016;2016;05;05;Keskiviikko;5;8;13;0;0;0
96;04.05.2016;2016;05;06;Keskiviikko;52;35;87;7;1;8
96;04.05.2016;2016;05;07;Keskiviikko;128;102;230;17;12;29
96;04.05.2016;2016;05;08;Keskiviikko;113;142;255;7;9;16
96;04.05.2016;2016;05;09;Keskiviikko;82;72;154;12;10;22
96;04.05.2016;2016;05;10;Keskiviikko;68;69;137;14;8;22
96;04.05.2016;2016;05;11;Keskiviikko;72;88;160;14;11;25
96;04.05.2016;2016;05;12;Keskiviikko;82;85;167;7;8;15
96;04.05.2016;2016;05;13;Keskiviikko;94;102;196;11;9;20
96;04.05.2016;2016;05;14;Keskiviikko;108;146;254;5;17;22
96;04.05.2016;2016;05;15;Keskiviikko;109;199;308;5;20;25
96;04.05.2016;2016;05;16;Keskiviikko;114;150;264;14;20;34
96;04.05.2016;2016;05;17;Keskiviikko;87;118;205;4;26;30
96;04.05.2016;2016;05;18;Keskiviikko;89;77;166;11;7;18
96;04.05.2016;2016;05;19;Keskiviikko;64;49;113;8;14;22
96;04.05.2016;2016;05;20;Keskiviikko;84;69;153;6;11;17
96;04.05.2016;2016;05;21;Keskiviikko;32;41;73;6;4;10
96;04.05.2016;2016;05;22;Keskiviikko;19;19;38;2;1;3
96;04.05.2016;2016;05;23;Keskiviikko;15;9;24;0;0;0
96;05.05.2016;2016;05;00;Torstai;9;8;17;0;2;2
96;05.05.2016;2016;05;01;Torstai;7;6;13;3;0;3
96;05.05.2016;2016;05;02;Torstai;9;3;12;0;0;0
96;05.05.2016;2016;05;03;Torstai;5;0;5;1;0;1
96;05.05.2016;2016;05;04;Torstai;7;2;9;1;0;1
96;05.05.2016;2016;05;05;Torstai;3;3;6;0;1;1
96;05.05.2016;2016;05;06;Torstai;33;12;45;2;1;3
96;05.05.2016;2016;05;07;Torstai;14;12;26;0;0;0
96;05.05.2016;2016;05;08;Torstai;15;8;23;5;2;7
96;05.05.2016;2016;05;09;Torstai;20;19;39;6;3;9
96;05.05.2016;2016;05;10;Torstai;30;33;63;7;11;18
96;05.05.2016;2016;05;11;Torstai;47;46;93;7;5;12
96;05.05.2016;2016;05;12;Torstai;74;68;142;6;13;19
96;05.05.2016;2016;05;13;Torstai;59;44;103;6;10;16
96;05.05.2016;2016;05;14;Torstai;65;81;146;11;10;21
96;05.05.2016;2016;05;15;Torstai;61;88;149;12;13;25
96;05.05.2016;2016;05;16;Torstai;62;54;116;11;6;17
96;05.05.2016;2016;05;17;Torstai;61;46;107;6;6;12
96;05.05.2016;2016;05;18;Torstai;51;44;95;11;13;24
96;05.05.2016;2016;05;19;Torstai;55;75;130;9;9;18
96;05.05.2016;2016;05;20;Torstai;41;32;73;7;11;18
96;05.05.2016;2016;05;21;Torstai;26;40;66;6;3;9
96;05.05.2016;2016;05;22;Torstai;22;18;40;5;4;9
96;05.05.2016;2016;05;23;Torstai;19;7;26;0;0;0
96;06.05.2016;2016;05;00;Perjantai;1;5;6;4;4;8
96;06.05.2016;2016;05;01;Perjantai;4;2;6;2;0;2
96;06.05.2016;2016;05;02;Perjantai;0;0;0;0;0;0
96;06.05.2016;2016;05;03;Perjantai;1;1;2;1;0;1
96;06.05.2016;2016;05;04;Perjantai;3;1;4;0;0;0
96;06.05.2016;2016;05;05;Perjantai;7;3;10;0;0;0
96;06.05.2016;2016;05;06;Perjantai;49;27;76;4;0;4
96;06.05.2016;2016;05;07;Perjantai;62;58;120;9;1;10
96;06.05.2016;2016;05;08;Perjantai;39;65;104;3;7;10
96;06.05.2016;2016;05;09;Perjantai;16;43;59;7;3;10
96;06.05.2016;2016;05;10;Perjantai;38;72;110;4;11;15
96;06.05.2016;2016;05;11;Perjantai;63;65;128;5;9;14
96;06.05.2016;2016;05;12;Perjantai;52;79;131;8;12;20
96;06.05.2016;2016;05;13;Perjantai;92;81;173;5;7;12
96;06.05.2016;2016;05;14;Perjantai;91;123;214;9;12;21
96;06.05.2016;2016;05;15;Perjantai;96;129;225;10;11;21
96;06.05.2016;2016;05;16;Perjantai;76;94;170;10;9;19
96;06.05.2016;2016;05;17;Perjantai;83;52;135;7;12;19
96;06.05.2016;2016;05;18;Perjantai;59;68;127;6;5;11
96;06.05.2016;2016;05;19;Perjantai;73;53;126;9;7;16
96;06.05.2016;2016;05;20;Perjantai;48;38;86;2;7;9
96;06.05.2016;2016;05;21;Perjantai;27;33;60;1;1;2
96;06.05.2016;2016;05;22;Perjantai;23;22;45;0;2;2
96;06.05.2016;2016;05;23;Perjantai;12;11;23;1;1;2
96;07.05.2016;2016;05;00;Lauantai;14;12;26;1;4;5
96;07.05.2016;2016;05;01;Lauantai;8;2;10;1;1;2
96;07.05.2016;2016;05;02;Lauantai;14;0;14;1;0;1
96;07.05.2016;2016;05;03;Lauantai;14;3;17;0;0;0
96;07.05.2016;2016;05;04;Lauantai;6;3;9;4;0;4
96;07.05.2016;2016;05;05;Lauantai;3;1;4;0;2;2
96;07.05.2016;2016;05;06;Lauantai;26;6;32;2;0;2
96;07.05.2016;2016;05;07;Lauantai;12;14;26;2;0;2
96;07.05.2016;2016;05;08;Lauantai;12;23;35;4;5;9
96;07.05.2016;2016;05;09;Lauantai;14;35;49;3;4;7
96;07.05.2016;2016;05;10;Lauantai;21;45;66;3;6;9
96;07.05.2016;2016;05;11;Lauantai;29;67;96;5;6;11
96;07.05.2016;2016;05;12;Lauantai;63;75;138;5;7;12
96;07.05.2016;2016;05;13;Lauantai;82;67;149;5;18;23
96;07.05.2016;2016;05;14;Lauantai;60;72;132;7;4;11
96;07.05.2016;2016;05;15;Lauantai;75;67;142;7;6;13
96;07.05.2016;2016;05;16;Lauantai;71;53;124;7;9;16
96;07.05.2016;2016;05;17;Lauantai;57;67;124;3;6;9
96;07.05.2016;2016;05;18;Lauantai;52;69;121;14;14;28
96;07.05.2016;2016;05;19;Lauantai;38;49;87;10;8;18
96;07.05.2016;2016;05;20;Lauantai;40;57;97;11;18;29
96;07.05.2016;2016;05;21;Lauantai;19;34;53;0;5;5
96;07.05.2016;2016;05;22;Lauantai;22;14;36;5;1;6
96;07.05.2016;2016;05;23;Lauantai;12;17;29;1;0;1
96;08.05.2016;2016;05;00;Sunnuntai;13;6;19;1;1;2
96;08.05.2016;2016;05;01;Sunnuntai;16;4;20;0;0;0
96;08.05.2016;2016;05;02;Sunnuntai;13;2;15;0;0;0
96;08.05.2016;2016;05;03;Sunnuntai;15;2;17;2;1;3
96;08.05.2016;2016;05;04;Sunnuntai;7;1;8;0;1;1
96;08.05.2016;2016;05;05;Sunnuntai;3;2;5;1;0;1
96;08.05.2016;2016;05;06;Sunnuntai;20;4;24;2;0;2
96;08.05.2016;2016;05;07;Sunnuntai;3;11;14;3;1;4
96;08.05.2016;2016;05;08;Sunnuntai;4;14;18;1;4;5
96;08.05.2016;2016;05;09;Sunnuntai;18;25;43;10;7;17
96;08.05.2016;2016;05;10;Sunnuntai;22;21;43;5;4;9
96;08.05.2016;2016;05;11;Sunnuntai;26;47;73;9;3;12
96;08.05.2016;2016;05;12;Sunnuntai;57;48;105;9;3;12
96;08.05.2016;2016;05;13;Sunnuntai;59;72;131;8;15;23
96;08.05.2016;2016;05;14;Sunnuntai;53;65;118;11;4;15
96;08.05.2016;2016;05;15;Sunnuntai;70;74;144;7;6;13
96;08.05.2016;2016;05;16;Sunnuntai;46;78;124;12;10;22
96;08.05.2016;2016;05;17;Sunnuntai;51;55;106;10;11;21
96;08.05.2016;2016;05;18;Sunnuntai;71;35;106;7;9;16
96;08.05.2016;2016;05;19;Sunnuntai;65;61;126;15;7;22
96;08.05.2016;2016;05;20;Sunnuntai;33;38;71;13;13;26
96;08.05.2016;2016;05;21;Sunnuntai;25;40;65;3;5;8
96;08.05.2016;2016;05;22;Sunnuntai;8;13;21;2;3;5
96;08.05.2016;2016;05;23;Sunnuntai;10;3;13;3;0;3
96;09.05.2016;2016;05;00;Maanantai;4;3;7;1;0;1
96;09.05.2016;2016;05;01;Maanantai;3;1;4;1;0;1
96;09.05.2016;2016;05;02;Maanantai;0;2;2;0;0;0
96;09.05.2016;2016;05;03;Maanantai;3;0;3;0;0;0
96;09.05.2016;2016;05;04;Maanantai;1;0;1;0;0;0
96;09.05.2016;2016;05;05;Maanantai;3;6;9;1;0;1
96;09.05.2016;2016;05;06;Maanantai;7;18;25;1;1;2
96;09.05.2016;2016;05;07;Maanantai;84;52;136;13;3;16
96;09.05.2016;2016;05;08;Maanantai;137;197;334;17;10;27
96;09.05.2016;2016;05;09;Maanantai;79;84;163;12;3;15
96;09.05.2016;2016;05;10;Maanantai;91;103;194;23;15;38
96;09.05.2016;2016;05;11;Maanantai;59;73;132;8;8;16
96;09.05.2016;2016;05;12;Maanantai;96;104;200;8;12;20
96;09.05.2016;2016;05;13;Maanantai;89;95;184;4;12;16
96;09.05.2016;2016;05;14;Maanantai;110;83;193;6;13;19
96;09.05.2016;2016;05;15;Maanantai;100;180;280;8;18;26
96;09.05.2016;2016;05;16;Maanantai;151;195;346;11;25;36
96;09.05.2016;2016;05;17;Maanantai;116;113;229;19;19;38
96;09.05.2016;2016;05;18;Maanantai;99;72;171;16;16;32
96;09.05.2016;2016;05;19;Maanantai;83;57;140;18;13;31
96;09.05.2016;2016;05;20;Maanantai;67;40;107;7;21;28
96;09.05.2016;2016;05;21;Maanantai;39;31;70;5;10;15
96;09.05.2016;2016;05;22;Maanantai;16;22;38;0;4;4
96;09.05.2016;2016;05;23;Maanantai;11;8;19;4;1;5
96;10.05.2016;2016;05;00;Tiistai;3;4;7;0;1;1
96;10.05.2016;2016;05;01;Tiistai;1;2;3;0;0;0
96;10.05.2016;2016;05;02;Tiistai;2;1;3;0;0;0
96;10.05.2016;2016;05;03;Tiistai;2;2;4;0;0;0
96;10.05.2016;2016;05;04;Tiistai;0;2;2;0;0;0
96;10.05.2016;2016;05;05;Tiistai;2;1;3;0;0;0
96;10.05.2016;2016;05;06;Tiistai;48;36;84;5;0;5
96;10.05.2016;2016;05;07;Tiistai;100;71;171;16;2;18
96;10.05.2016;2016;05;08;Tiistai;76;70;146;10;4;14
96;10.05.2016;2016;05;09;Tiistai;61;53;114;4;4;8
96;10.05.2016;2016;05;10;Tiistai;36;31;67;8;4;12
96;10.05.2016;2016;05;11;Tiistai;35;36;71;7;7;14
96;10.05.2016;2016;05;12;Tiistai;60;42;102;6;8;14
96;10.05.2016;2016;05;13;Tiistai;50;56;106;4;10;14
96;10.05.2016;2016;05;14;Tiistai;46;84;130;4;13;17
96;10.05.2016;2016;05;15;Tiistai;68;168;236;7;21;28
96;10.05.2016;2016;05;16;Tiistai;69;139;208;11;19;30
96;10.05.2016;2016;05;17;Tiistai;62;74;136;13;14;27
96;10.05.2016;2016;05;18;Tiistai;52;57;109;16;16;32
96;10.05.2016;2016;05;19;Tiistai;50;38;88;13;25;38
96;10.05.2016;2016;05;20;Tiistai;51;28;79;12;8;20
96;10.05.2016;2016;05;21;Tiistai;38;33;71;10;3;13
96;10.05.2016;2016;05;22;Tiistai;12;15;27;2;6;8
96;10.05.2016;2016;05;23;Tiistai;5;1;6;1;0;1
96;11.05.2016;2016;05;00;Keskiviikko;1;3;4;0;0;0
96;11.05.2016;2016;05;01;Keskiviikko;0;2;2;0;0;0
96;11.05.2016;2016;05;02;Keskiviikko;2;0;2;0;0;0
96;11.05.2016;2016;05;03;Keskiviikko;3;0;3;0;0;0
96;11.05.2016;2016;05;04;Keskiviikko;1;1;2;0;0;0
96;11.05.2016;2016;05;05;Keskiviikko;5;4;9;1;0;1
96;11.05.2016;2016;05;06;Keskiviikko;63;42;105;5;2;7
96;11.05.2016;2016;05;07;Keskiviikko;124;127;251;14;8;22
96;11.05.2016;2016;05;08;Keskiviikko;81;140;221;8;9;17
96;11.05.2016;2016;05;09;Keskiviikko;70;75;145;12;13;25
96;11.05.2016;2016;05;10;Keskiviikko;56;64;120;7;5;12
96;11.05.2016;2016;05;11;Keskiviikko;78;74;152;10;15;25
96;11.05.2016;2016;05;12;Keskiviikko;68;91;159;11;17;28
96;11.05.2016;2016;05;13;Keskiviikko;83;89;172;7;10;17
96;11.05.2016;2016;05;14;Keskiviikko;97;126;223;5;15;20
96;11.05.2016;2016;05;15;Keskiviikko;109;212;321;6;22;28
96;11.05.2016;2016;05;16;Keskiviikko;133;171;304;12;24;36
96;11.05.2016;2016;05;17;Keskiviikko;106;65;171;11;24;35
96;11.05.2016;2016;05;18;Keskiviikko;104;65;169;29;21;50
96;11.05.2016;2016;05;19;Keskiviikko;100;55;155;16;21;37
96;11.05.2016;2016;05;20;Keskiviikko;48;56;104;12;13;25
96;11.05.2016;2016;05;21;Keskiviikko;29;36;65;2;8;10
96;11.05.2016;2016;05;22;Keskiviikko;19;27;46;0;2;2
96;11.05.2016;2016;05;23;Keskiviikko;7;9;16;1;0;1
96;12.05.2016;2016;05;00;Torstai;9;5;14;1;0;1
96;12.05.2016;2016;05;01;Torstai;2;0;2;0;0;0
96;12.05.2016;2016;05;02;Torstai;0;0;0;0;1;1
96;12.05.2016;2016;05;03;Torstai;3;0;3;0;0;0
96;12.05.2016;2016;05;04;Torstai;3;1;4;0;0;0
96;12.05.2016;2016;05;05;Torstai;6;2;8;0;1;1
96;12.05.2016;2016;05;06;Torstai;57;35;92;4;0;4
96;12.05.2016;2016;05;07;Torstai;108;124;232;11;8;19
96;12.05.2016;2016;05;08;Torstai;113;139;252;18;12;30
96;12.05.2016;2016;05;09;Torstai;86;82;168;9;6;15
96;12.05.2016;2016;05;10;Torstai;60;74;134;8;10;18
96;12.05.2016;2016;05;11;Torstai;68;59;127;11;9;20
96;12.05.2016;2016;05;12;Torstai;67;66;133;10;13;23
96;12.05.2016;2016;05;13;Torstai;101;86;187;7;8;15
96;12.05.2016;2016;05;14;Torstai;87;110;197;10;11;21
96;12.05.2016;2016;05;15;Torstai;134;192;326;5;24;29
96;12.05.2016;2016;05;16;Torstai;120;188;308;19;33;52
96;12.05.2016;2016;05;17;Torstai;109;106;215;21;8;29
96;12.05.2016;2016;05;18;Torstai;92;94;186;13;14;27
96;12.05.2016;2016;05;19;Torstai;87;64;151;14;13;27
96;12.05.2016;2016;05;20;Torstai;67;45;112;14;22;36
96;12.05.2016;2016;05;21;Torstai;34;40;74;5;8;13
96;12.05.2016;2016;05;22;Torstai;24;22;46;3;4;7
96;12.05.2016;2016;05;23;Torstai;10;10;20;2;0;2
96;13.05.2016;2016;05;00;Perjantai;3;3;6;0;1;1
96;13.05.2016;2016;05;01;Perjantai;5;0;5;1;0;1
96;13.05.2016;2016;05;02;Perjantai;3;0;3;0;0;0
96;13.05.2016;2016;05;03;Perjantai;4;3;7;0;0;0
96;13.05.2016;2016;05;04;Perjantai;2;2;4;0;0;0
96;13.05.2016;2016;05;05;Perjantai;3;10;13;0;0;0
96;13.05.2016;2016;05;06;Perjantai;49;33;82;3;1;4
96;13.05.2016;2016;05;07;Perjantai;110;96;206;10;4;14
96;13.05.2016;2016;05;08;Perjantai;101;100;201;14;9;23
96;13.05.2016;2016;05;09;Perjantai;47;87;134;7;13;20
96;13.05.2016;2016;05;10;Perjantai;64;63;127;7;7;14
96;13.05.2016;2016;05;11;Perjantai;70;86;156;9;12;21
96;13.05.2016;2016;05;12;Perjantai;69;90;159;14;10;24
96;13.05.2016;2016;05;13;Perjantai;96;98;194;11;24;35
96;13.05.2016;2016;05;14;Perjantai;95;138;233;6;17;23
96;13.05.2016;2016;05;15;Perjantai;102;136;238;11;15;26
96;13.05.2016;2016;05;16;Perjantai;71;93;164;9;16;25
96;13.05.2016;2016;05;17;Perjantai;57;69;126;6;5;11
96;13.05.2016;2016;05;18;Perjantai;58;55;113;11;10;21
96;13.05.2016;2016;05;19;Perjantai;52;42;94;2;2;4
96;13.05.2016;2016;05;20;Perjantai;38;35;73;5;4;9
96;13.05.2016;2016;05;21;Perjantai;31;29;60;3;5;8
96;13.05.2016;2016;05;22;Perjantai;17;20;37;0;3;3
96;13.05.2016;2016;05;23;Perjantai;11;11;22;0;0;0
96;14.05.2016;2016;05;00;Lauantai;7;11;18;1;3;4
96;14.05.2016;2016;05;01;Lauantai;13;2;15;3;1;4
96;14.05.2016;2016;05;02;Lauantai;4;3;7;0;1;1
96;14.05.2016;2016;05;03;Lauantai;10;0;10;1;0;1
96;14.05.2016;2016;05;04;Lauantai;3;1;4;3;1;4
96;14.05.2016;2016;05;05;Lauantai;1;3;4;0;0;0
96;14.05.2016;2016;05;06;Lauantai;27;10;37;0;0;0
96;14.05.2016;2016;05;07;Lauantai;6;14;20;2;0;2
96;14.05.2016;2016;05;08;Lauantai;6;30;36;1;0;1
96;14.05.2016;2016;05;09;Lauantai;24;46;70;6;4;10
96;14.05.2016;2016;05;10;Lauantai;47;34;81;10;5;15
96;14.05.2016;2016;05;11;Lauantai;39;51;90;9;16;25
96;14.05.2016;2016;05;12;Lauantai;48;39;87;9;3;12
96;14.05.2016;2016;05;13;Lauantai;28;36;64;6;3;9
96;14.05.2016;2016;05;14;Lauantai;32;59;91;9;12;21
96;14.05.2016;2016;05;15;Lauantai;48;65;113;10;6;16
96;14.05.2016;2016;05;16;Lauantai;46;45;91;3;10;13
96;14.05.2016;2016;05;17;Lauantai;33;37;70;12;7;19
96;14.05.2016;2016;05;18;Lauantai;46;34;80;9;11;20
96;14.05.2016;2016;05;19;Lauantai;45;31;76;12;7;19
96;14.05.2016;2016;05;20;Lauantai;30;19;49;5;10;15
96;14.05.2016;2016;05;21;Lauantai;24;32;56;2;3;5
96;14.05.2016;2016;05;22;Lauantai;9;12;21;1;3;4
96;14.05.2016;2016;05;23;Lauantai;10;7;17;1;0;1
96;15.05.2016;2016;05;00;Sunnuntai;10;6;16;0;1;1
96;15.05.2016;2016;05;01;Sunnuntai;10;4;14;0;1;1
96;15.05.2016;2016;05;02;Sunnuntai;6;5;11;2;1;3
96;15.05.2016;2016;05;03;Sunnuntai;11;2;13;1;0;1
96;15.05.2016;2016;05;04;Sunnuntai;9;0;9;2;0;2
96;15.05.2016;2016;05;05;Sunnuntai;3;5;8;0;4;4
96;15.05.2016;2016;05;06;Sunnuntai;15;11;26;2;0;2
96;15.05.2016;2016;05;07;Sunnuntai;1;12;13;1;2;3
96;15.05.2016;2016;05;08;Sunnuntai;6;7;13;3;4;7
96;15.05.2016;2016;05;09;Sunnuntai;13;9;22;2;3;5
96;15.05.2016;2016;05;10;Sunnuntai;6;25;31;8;3;11
96;15.05.2016;2016;05;11;Sunnuntai;25;32;57;6;7;13
96;15.05.2016;2016;05;12;Sunnuntai;30;24;54;7;17;24
96;15.05.2016;2016;05;13;Sunnuntai;34;46;80;5;9;14
96;15.05.2016;2016;05;14;Sunnuntai;29;43;72;11;7;18
96;15.05.2016;2016;05;15;Sunnuntai;30;35;65;8;12;20
96;15.05.2016;2016;05;16;Sunnuntai;42;33;75;19;4;23
96;15.05.2016;2016;05;17;Sunnuntai;52;31;83;10;6;16
96;15.05.2016;2016;05;18;Sunnuntai;51;31;82;9;8;17
96;15.05.2016;2016;05;19;Sunnuntai;32;20;52;11;13;24
96;15.05.2016;2016;05;20;Sunnuntai;22;41;63;7;9;16
96;15.05.2016;2016;05;21;Sunnuntai;20;20;40;3;2;5
96;15.05.2016;2016;05;22;Sunnuntai;8;11;19;3;2;5
96;15.05.2016;2016;05;23;Sunnuntai;7;5;12;1;1;2
96;16.05.2016;2016;05;00;Maanantai;3;5;8;3;0;3
96;16.05.2016;2016;05;01;Maanantai;0;0;0;0;0;0
96;16.05.2016;2016;05;02;Maanantai;3;1;4;0;0;0
96;16.05.2016;2016;05;03;Maanantai;2;0;2;0;0;0
96;16.05.2016;2016;05;04;Maanantai;2;2;4;0;0;0
96;16.05.2016;2016;05;05;Maanantai;3;6;9;0;0;0
96;16.05.2016;2016;05;06;Maanantai;55;34;89;4;0;4
96;16.05.2016;2016;05;07;Maanantai;127;89;216;15;7;22
96;16.05.2016;2016;05;08;Maanantai;110;134;244;14;7;21
96;16.05.2016;2016;05;09;Maanantai;63;85;148;10;20;30
96;16.05.2016;2016;05;10;Maanantai;52;68;120;14;13;27
96;16.05.2016;2016;05;11;Maanantai;66;85;151;7;6;13
96;16.05.2016;2016;05;12;Maanantai;74;80;154;8;9;17
96;16.05.2016;2016;05;13;Maanantai;84;102;186;13;16;29
96;16.05.2016;2016;05;14;Maanantai;79;128;207;5;15;20
96;16.05.2016;2016;05;15;Maanantai;112;217;329;10;29;39
96;16.05.2016;2016;05;16;Maanantai;126;193;319;16;23;39
96;16.05.2016;2016;05;17;Maanantai;106;98;204;14;9;23
96;16.05.2016;2016;05;18;Maanantai;88;69;157;16;8;24
96;16.05.2016;2016;05;19;Maanantai;113;61;174;8;11;19
96;16.05.2016;2016;05;20;Maanantai;89;50;139;14;13;27
96;16.05.2016;2016;05;21;Maanantai;34;57;91;11;8;19
96;16.05.2016;2016;05;22;Maanantai;19;18;37;0;2;2
96;16.05.2016;2016;05;23;Maanantai;3;5;8;0;4;4
96;17.05.2016;2016;05;00;Tiistai;3;3;6;0;1;1
96;17.05.2016;2016;05;01;Tiistai;3;1;4;1;0;1
96;17.05.2016;2016;05;02;Tiistai;0;0;0;0;0;0
96;17.05.2016;2016;05;03;Tiistai;3;0;3;0;0;0
96;17.05.2016;2016;05;04;Tiistai;1;5;6;0;0;0
96;17.05.2016;2016;05;05;Tiistai;3;7;10;0;1;1
96;17.05.2016;2016;05;06;Tiistai;37;30;67;6;2;8
96;17.05.2016;2016;05;07;Tiistai;86;87;173;13;4;17
96;17.05.2016;2016;05;08;Tiistai;92;104;196;10;5;15
96;17.05.2016;2016;05;09;Tiistai;71;61;132;13;5;18
96;17.05.2016;2016;05;10;Tiistai;31;33;64;4;8;12
96;17.05.2016;2016;05;11;Tiistai;36;45;81;5;8;13
96;17.05.2016;2016;05;12;Tiistai;54;53;107;5;8;13
96;17.05.2016;2016;05;13;Tiistai;42;59;101;4;1;5
96;17.05.2016;2016;05;14;Tiistai;50;63;113;2;6;8
96;17.05.2016;2016;05;15;Tiistai;70;172;242;7;17;24
96;17.05.2016;2016;05;16;Tiistai;79;143;222;8;20;28
96;17.05.2016;2016;05;17;Tiistai;70;59;129;10;16;26
96;17.05.2016;2016;05;18;Tiistai;70;55;125;14;5;19
96;17.05.2016;2016;05;19;Tiistai;73;48;121;8;19;27
96;17.05.2016;2016;05;20;Tiistai;52;39;91;5;3;8
96;17.05.2016;2016;05;21;Tiistai;23;27;50;5;2;7
96;17.05.2016;2016;05;22;Tiistai;13;10;23;2;3;5
96;17.05.2016;2016;05;23;Tiistai;14;13;27;1;0;1
96;18.05.2016;2016;05;00;Keskiviikko;5;4;9;1;0;1
96;18.05.2016;2016;05;01;Keskiviikko;2;0;2;0;0;0
96;18.05.2016;2016;05;02;Keskiviikko;5;0;5;0;0;0
96;18.05.2016;2016;05;03;Keskiviikko;2;1;3;0;0;0
96;18.05.2016;2016;05;04;Keskiviikko;1;3;4;0;0;0
96;18.05.2016;2016;05;05;Keskiviikko;1;6;7;0;0;0
96;18.05.2016;2016;05;06;Keskiviikko;59;37;96;6;0;6
96;18.05.2016;2016;05;07;Keskiviikko;128;102;230;18;11;29
96;18.05.2016;2016;05;08;Keskiviikko;89;150;239;11;17;28
96;18.05.2016;2016;05;09;Keskiviikko;78;102;180;11;15;26
96;18.05.2016;2016;05;10;Keskiviikko;60;68;128;13;9;22
96;18.05.2016;2016;05;11;Keskiviikko;67;87;154;7;7;14
96;18.05.2016;2016;05;12;Keskiviikko;72;75;147;11;2;13
96;18.05.2016;2016;05;13;Keskiviikko;87;84;171;5;12;17
96;18.05.2016;2016;05;14;Keskiviikko;74;119;193;6;14;20
96;18.05.2016;2016;05;15;Keskiviikko;85;195;280;9;18;27
96;18.05.2016;2016;05;16;Keskiviikko;101;116;217;7;10;17
96;18.05.2016;2016;05;17;Keskiviikko;59;48;107;9;19;28
96;18.05.2016;2016;05;18;Keskiviikko;50;38;88;4;6;10
96;18.05.2016;2016;05;19;Keskiviikko;43;27;70;4;13;17
96;18.05.2016;2016;05;20;Keskiviikko;40;26;66;7;3;10
96;18.05.2016;2016;05;21;Keskiviikko;27;20;47;6;4;10
96;18.05.2016;2016;05;22;Keskiviikko;8;9;17;1;0;1
96;18.05.2016;2016;05;23;Keskiviikko;4;12;16;2;3;5
96;19.05.2016;2016;05;00;Torstai;2;2;4;0;0;0
96;19.05.2016;2016;05;01;Torstai;2;0;2;2;0;2
96;19.05.2016;2016;05;02;Torstai;3;1;4;0;0;0
96;19.05.2016;2016;05;03;Torstai;4;1;5;0;0;0
96;19.05.2016;2016;05;04;Torstai;4;1;5;1;0;1
96;19.05.2016;2016;05;05;Torstai;2;8;10;1;1;2
96;19.05.2016;2016;05;06;Torstai;36;30;66;5;1;6
96;19.05.2016;2016;05;07;Torstai;94;88;182;8;2;10
96;19.05.2016;2016;05;08;Torstai;76;108;184;12;7;19
96;19.05.2016;2016;05;09;Torstai;52;54;106;6;5;11
96;19.05.2016;2016;05;10;Torstai;39;44;83;6;3;9
96;19.05.2016;2016;05;11;Torstai;38;47;85;2;8;10
96;19.05.2016;2016;05;12;Torstai;62;60;122;8;5;13
96;19.05.2016;2016;05;13;Torstai;66;69;135;11;11;22
96;19.05.2016;2016;05;14;Torstai;70;108;178;7;16;23
96;19.05.2016;2016;05;15;Torstai;89;174;263;13;17;30
96;19.05.2016;2016;05;16;Torstai;88;153;241;7;23;30
96;19.05.2016;2016;05;17;Torstai;68;57;125;10;9;19
96;19.05.2016;2016;05;18;Torstai;53;34;87;10;8;18
96;19.05.2016;2016;05;19;Torstai;48;56;104;16;18;34
96;19.05.2016;2016;05;20;Torstai;73;24;97;6;26;32
96;19.05.2016;2016;05;21;Torstai;38;43;81;6;4;10
96;19.05.2016;2016;05;22;Torstai;23;17;40;1;2;3
96;19.05.2016;2016;05;23;Torstai;8;6;14;0;1;1
96;20.05.2016;2016;05;00;Perjantai;5;15;20;1;1;2
96;20.05.2016;2016;05;01;Perjantai;8;1;9;0;0;0
96;20.05.2016;2016;05;02;Perjantai;1;0;1;0;0;0
96;20.05.2016;2016;05;03;Perjantai;7;1;8;0;0;0
96;20.05.2016;2016;05;04;Perjantai;7;1;8;0;0;0
96;20.05.2016;2016;05;05;Perjantai;0;3;3;0;0;0
96;20.05.2016;2016;05;06;Perjantai;39;28;67;4;0;4
96;20.05.2016;2016;05;07;Perjantai;112;94;206;8;5;13
96;20.05.2016;2016;05;08;Perjantai;65;146;211;8;10;18
96;20.05.2016;2016;05;09;Perjantai;79;74;153;11;12;23
96;20.05.2016;2016;05;10;Perjantai;59;70;129;8;6;14
96;20.05.2016;2016;05;11;Perjantai;73;88;161;14;4;18
96;20.05.2016;2016;05;12;Perjantai;82;96;178;8;16;24
96;20.05.2016;2016;05;13;Perjantai;88;102;190;11;18;29
96;20.05.2016;2016;05;14;Perjantai;115;124;239;8;12;20
96;20.05.2016;2016;05;15;Perjantai;124;161;285;12;16;28
96;20.05.2016;2016;05;16;Perjantai;92;126;218;8;8;16
96;20.05.2016;2016;05;17;Perjantai;68;69;137;12;19;31
96;20.05.2016;2016;05;18;Perjantai;73;66;139;15;10;25
96;20.05.2016;2016;05;19;Perjantai;61;47;108;7;17;24
96;20.05.2016;2016;05;20;Perjantai;65;37;102;6;4;10
96;20.05.2016;2016;05;21;Perjantai;41;58;99;7;6;13
96;20.05.2016;2016;05;22;Perjantai;16;16;32;3;3;6
96;20.05.2016;2016;05;23;Perjantai;20;13;33;4;0;4
96;21.05.2016;2016;05;00;Lauantai;4;7;11;2;4;6
96;21.05.2016;2016;05;01;Lauantai;20;4;24;0;2;2
96;21.05.2016;2016;05;02;Lauantai;10;2;12;4;1;5
96;21.05.2016;2016;05;03;Lauantai;8;3;11;2;0;2
96;21.05.2016;2016;05;04;Lauantai;13;2;15;2;0;2
96;21.05.2016;2016;05;05;Lauantai;1;0;1;1;0;1
96;21.05.2016;2016;05;06;Lauantai;17;11;28;1;1;2
96;21.05.2016;2016;05;07;Lauantai;9;15;24;3;1;4
96;21.05.2016;2016;05;08;Lauantai;11;28;39;5;3;8
96;21.05.2016;2016;05;09;Lauantai;26;52;78;4;2;6
96;21.05.2016;2016;05;10;Lauantai;30;76;106;4;7;11
96;21.05.2016;2016;05;11;Lauantai;47;77;124;4;9;13
96;21.05.2016;2016;05;12;Lauantai;79;126;205;9;13;22
96;21.05.2016;2016;05;13;Lauantai;59;86;145;3;10;13
96;21.05.2016;2016;05;14;Lauantai;60;86;146;9;8;17
96;21.05.2016;2016;05;15;Lauantai;120;76;196;6;13;19
96;21.05.2016;2016;05;16;Lauantai;51;34;85;4;6;10
96;21.05.2016;2016;05;17;Lauantai;34;32;66;3;5;8
96;21.05.2016;2016;05;18;Lauantai;26;17;43;3;2;5
96;21.05.2016;2016;05;19;Lauantai;40;33;73;13;5;18
96;21.05.2016;2016;05;20;Lauantai;29;37;66;2;7;9
96;21.05.2016;2016;05;21;Lauantai;24;23;47;4;6;10
96;21.05.2016;2016;05;22;Lauantai;6;12;18;0;1;1
96;21.05.2016;2016;05;23;Lauantai;12;14;26;1;0;1
96;22.05.2016;2016;05;00;Sunnuntai;9;5;14;0;0;0
96;22.05.2016;2016;05;01;Sunnuntai;7;5;12;0;1;1
96;22.05.2016;2016;05;02;Sunnuntai;9;0;9;1;0;1
96;22.05.2016;2016;05;03;Sunnuntai;13;1;14;2;0;2
96;22.05.2016;2016;05;04;Sunnuntai;13;3;16;2;0;2
96;22.05.2016;2016;05;05;Sunnuntai;5;0;5;0;0;0
96;22.05.2016;2016;05;06;Sunnuntai;14;4;18;3;0;3
96;22.05.2016;2016;05;07;Sunnuntai;1;12;13;0;0;0
96;22.05.2016;2016;05;08;Sunnuntai;4;11;15;2;2;4
96;22.05.2016;2016;05;09;Sunnuntai;10;15;25;3;4;7
96;22.05.2016;2016;05;10;Sunnuntai;9;26;35;5;5;10
96;22.05.2016;2016;05;11;Sunnuntai;20;41;61;11;11;22
96;22.05.2016;2016;05;12;Sunnuntai;41;62;103;8;9;17
96;22.05.2016;2016;05;13;Sunnuntai;53;61;114;5;5;10
96;22.05.2016;2016;05;14;Sunnuntai;55;71;126;9;7;16
96;22.05.2016;2016;05;15;Sunnuntai;50;76;126;10;9;19
96;22.05.2016;2016;05;16;Sunnuntai;84;50;134;22;11;33
96;22.05.2016;2016;05;17;Sunnuntai;77;47;124;15;8;23
96;22.05.2016;2016;05;18;Sunnuntai;92;54;146;18;11;29
96;22.05.2016;2016;05;19;Sunnuntai;34;54;88;8;9;17
96;22.05.2016;2016;05;20;Sunnuntai;33;57;90;5;19;24
96;22.05.2016;2016;05;21;Sunnuntai;16;11;27;1;4;5
96;22.05.2016;2016;05;22;Sunnuntai;9;9;18;2;0;2
96;22.05.2016;2016;05;23;Sunnuntai;20;12;32;4;4;8
96;23.05.2016;2016;05;00;Maanantai;7;7;14;1;2;3
96;23.05.2016;2016;05;01;Maanantai;8;0;8;0;0;0
96;23.05.2016;2016;05;02;Maanantai;9;2;11;0;0;0
96;23.05.2016;2016;05;03;Maanantai;4;0;4;1;1;2
96;23.05.2016;2016;05;04;Maanantai;7;1;8;2;2;4
96;23.05.2016;2016;05;05;Maanantai;4;9;13;0;1;1
96;23.05.2016;2016;05;06;Maanantai;46;38;84;3;2;5
96;23.05.2016;2016;05;07;Maanantai;120;121;241;17;7;24
96;23.05.2016;2016;05;08;Maanantai;91;163;254;5;8;13
96;23.05.2016;2016;05;09;Maanantai;69;95;164;14;8;22
96;23.05.2016;2016;05;10;Maanantai;56;87;143;10;8;18
96;23.05.2016;2016;05;11;Maanantai;66;109;175;10;13;23
96;23.05.2016;2016;05;12;Maanantai;84;81;165;8;7;15
96;23.05.2016;2016;05;13;Maanantai;86;103;189;5;10;15
96;23.05.2016;2016;05;14;Maanantai;97;133;230;4;11;15
96;23.05.2016;2016;05;15;Maanantai;133;172;305;4;20;24
96;23.05.2016;2016;05;16;Maanantai;165;185;350;25;24;49
96;23.05.2016;2016;05;17;Maanantai;94;101;195;17;21;38
96;23.05.2016;2016;05;18;Maanantai;111;93;204;12;24;36
96;23.05.2016;2016;05;19;Maanantai;101;61;162;10;15;25
96;23.05.2016;2016;05;20;Maanantai;60;46;106;10;9;19
96;23.05.2016;2016;05;21;Maanantai;37;54;91;8;6;14
96;23.05.2016;2016;05;22;Maanantai;17;18;35;4;1;5
96;23.05.2016;2016;05;23;Maanantai;12;7;19;1;0;1
96;24.05.2016;2016;05;00;Tiistai;2;6;8;1;0;1
96;24.05.2016;2016;05;01;Tiistai;2;0;2;0;0;0
96;24.05.2016;2016;05;02;Tiistai;1;0;1;0;0;0
96;24.05.2016;2016;05;03;Tiistai;5;0;5;0;0;0
96;24.05.2016;2016;05;04;Tiistai;1;1;2;0;0;0
96;24.05.2016;2016;05;05;Tiistai;2;11;13;2;0;2
96;24.05.2016;2016;05;06;Tiistai;55;47;102;2;1;3
96;24.05.2016;2016;05;07;Tiistai;125;124;249;15;9;24
96;24.05.2016;2016;05;08;Tiistai;92;148;240;15;10;25
96;24.05.2016;2016;05;09;Tiistai;99;95;194;10;5;15
96;24.05.2016;2016;05;10;Tiistai;56;86;142;8;16;24
96;24.05.2016;2016;05;11;Tiistai;87;96;183;8;15;23
96;24.05.2016;2016;05;12;Tiistai;95;104;199;9;8;17
96;24.05.2016;2016;05;13;Tiistai;99;75;174;10;7;17
96;24.05.2016;2016;05;14;Tiistai;103;121;224;14;8;22
96;24.05.2016;2016;05;15;Tiistai;108;178;286;6;23;29
96;24.05.2016;2016;05;16;Tiistai;130;157;287;3;13;16
96;24.05.2016;2016;05;17;Tiistai;82;61;143;9;12;21
96;24.05.2016;2016;05;18;Tiistai;51;51;102;13;10;23
96;24.05.2016;2016;05;19;Tiistai;52;35;87;5;9;14
96;24.05.2016;2016;05;20;Tiistai;43;24;67;8;7;15
96;24.05.2016;2016;05;21;Tiistai;30;40;70;5;5;10
96;24.05.2016;2016;05;22;Tiistai;7;11;18;0;0;0
96;24.05.2016;2016;05;23;Tiistai;5;4;9;0;1;1
96;25.05.2016;2016;05;00;Keskiviikko;1;1;2;0;1;1
96;25.05.2016;2016;05;01;Keskiviikko;2;2;4;0;0;0
96;25.05.2016;2016;05;02;Keskiviikko;0;2;2;0;0;0
96;25.05.2016;2016;05;03;Keskiviikko;4;2;6;0;0;0
96;25.05.2016;2016;05;04;Keskiviikko;1;0;1;0;1;1
96;25.05.2016;2016;05;05;Keskiviikko;4;9;13;0;0;0
96;25.05.2016;2016;05;06;Keskiviikko;33;34;67;1;0;1
96;25.05.2016;2016;05;07;Keskiviikko;99;97;196;8;4;12
96;25.05.2016;2016;05;08;Keskiviikko;98;124;222;13;14;27
96;25.05.2016;2016;05;09;Keskiviikko;54;94;148;6;27;33
96;25.05.2016;2016;05;10;Keskiviikko;35;59;94;7;20;27
96;25.05.2016;2016;05;11;Keskiviikko;49;83;132;4;11;15
96;25.05.2016;2016;05;12;Keskiviikko;81;63;144;14;14;28
96;25.05.2016;2016;05;13;Keskiviikko;70;77;147;16;9;25
96;25.05.2016;2016;05;14;Keskiviikko;66;97;163;17;14;31
96;25.05.2016;2016;05;15;Keskiviikko;78;135;213;12;14;26
96;25.05.2016;2016;05;16;Keskiviikko;64;135;199;8;12;20
96;25.05.2016;2016;05;17;Keskiviikko;50;68;118;9;7;16
96;25.05.2016;2016;05;18;Keskiviikko;61;42;103;12;8;20
96;25.05.2016;2016;05;19;Keskiviikko;47;41;88;7;0;7
96;25.05.2016;2016;05;20;Keskiviikko;40;40;80;3;16;19
96;25.05.2016;2016;05;21;Keskiviikko;15;35;50;1;3;4
96;25.05.2016;2016;05;22;Keskiviikko;12;11;23;2;4;6
96;25.05.2016;2016;05;23;Keskiviikko;10;6;16;2;5;7
96;26.05.2016;2016;05;00;Torstai;2;2;4;0;0;0
96;26.05.2016;2016;05;01;Torstai;0;1;1;0;0;0
96;26.05.2016;2016;05;02;Torstai;3;0;3;1;0;1
96;26.05.2016;2016;05;03;Torstai;2;0;2;0;1;1
96;26.05.2016;2016;05;04;Torstai;2;1;3;0;0;0
96;26.05.2016;2016;05;05;Torstai;2;8;10;1;0;1
96;26.05.2016;2016;05;06;Torstai;44;40;84;2;1;3
96;26.05.2016;2016;05;07;Torstai;95;114;209;10;6;16
96;26.05.2016;2016;05;08;Torstai;97;156;253;8;5;13
96;26.05.2016;2016;05;09;Torstai;99;136;235;3;12;15
96;26.05.2016;2016;05;10;Torstai;77;107;184;4;19;23
96;26.05.2016;2016;05;11;Torstai;57;93;150;11;16;27
96;26.05.2016;2016;05;12;Torstai;100;85;185;20;10;30
96;26.05.2016;2016;05;13;Torstai;85;89;174;18;12;30
96;26.05.2016;2016;05;14;Torstai;72;123;195;11;12;23
96;26.05.2016;2016;05;15;Torstai;112;198;310;10;11;21
96;26.05.2016;2016;05;16;Torstai;108;150;258;10;17;27
96;26.05.2016;2016;05;17;Torstai;80;86;166;8;16;24
96;26.05.2016;2016;05;18;Torstai;66;63;129;9;11;20
96;26.05.2016;2016;05;19;Torstai;65;50;115;12;11;23
96;26.05.2016;2016;05;20;Torstai;64;37;101;6;11;17
96;26.05.2016;2016;05;21;Torstai;37;38;75;9;9;18
96;26.05.2016;2016;05;22;Torstai;23;24;47;3;10;13
96;26.05.2016;2016;05;23;Torstai;14;6;20;0;0;0
96;27.05.2016;2016;05;00;Perjantai;5;6;11;2;1;3
96;27.05.2016;2016;05;01;Perjantai;1;2;3;0;0;0
96;27.05.2016;2016;05;02;Perjantai;3;1;4;0;0;0
96;27.05.2016;2016;05;03;Perjantai;10;0;10;1;0;1
96;27.05.2016;2016;05;04;Perjantai;4;2;6;0;1;1
96;27.05.2016;2016;05;05;Perjantai;3;4;7;0;1;1
96;27.05.2016;2016;05;06;Perjantai;46;32;78;4;0;4
96;27.05.2016;2016;05;07;Perjantai;93;117;210;11;4;15
96;27.05.2016;2016;05;08;Perjantai;65;143;208;12;10;22
96;27.05.2016;2016;05;09;Perjantai;51;72;123;7;7;14
96;27.05.2016;2016;05;10;Perjantai;50;59;109;5;6;11
96;27.05.2016;2016;05;11;Perjantai;42;88;130;5;10;15
96;27.05.2016;2016;05;12;Perjantai;81;107;188;8;11;19
96;27.05.2016;2016;05;13;Perjantai;91;117;208;6;12;18
96;27.05.2016;2016;05;14;Perjantai;98;178;276;8;16;24
96;27.05.2016;2016;05;15;Perjantai;87;152;239;7;22;29
96;27.05.2016;2016;05;16;Perjantai;124;106;230;17;26;43
96;27.05.2016;2016;05;17;Perjantai;80;68;148;25;14;39
96;27.05.2016;2016;05;18;Perjantai;90;70;160;10;5;15
96;27.05.2016;2016;05;19;Perjantai;82;64;146;9;6;15
96;27.05.2016;2016;05;20;Perjantai;83;45;128;10;7;17
96;27.05.2016;2016;05;21;Perjantai;35;48;83;4;6;10
96;27.05.2016;2016;05;22;Perjantai;34;23;57;3;5;8
96;27.05.2016;2016;05;23;Perjantai;19;19;38;1;0;1
96;28.05.2016;2016;05;00;Lauantai;22;8;30;3;1;4
96;28.05.2016;2016;05;01;Lauantai;25;11;36;0;7;7
96;28.05.2016;2016;05;02;Lauantai;16;2;18;0;1;1
96;28.05.2016;2016;05;03;Lauantai;18;3;21;2;0;2
96;28.05.2016;2016;05;04;Lauantai;8;2;10;2;0;2
96;28.05.2016;2016;05;05;Lauantai;1;2;3;0;0;0
96;28.05.2016;2016;05;06;Lauantai;20;10;30;3;0;3
96;28.05.2016;2016;05;07;Lauantai;5;22;27;2;3;5
96;28.05.2016;2016;05;08;Lauantai;7;25;32;2;5;7
96;28.05.2016;2016;05;09;Lauantai;30;51;81;2;3;5
96;28.05.2016;2016;05;10;Lauantai;25;64;89;4;10;14
96;28.05.2016;2016;05;11;Lauantai;44;65;109;2;8;10
96;28.05.2016;2016;05;12;Lauantai;90;73;163;11;14;25
96;28.05.2016;2016;05;13;Lauantai;73;77;150;6;8;14
96;28.05.2016;2016;05;14;Lauantai;90;85;175;11;11;22
96;28.05.2016;2016;05;15;Lauantai;80;91;171;3;8;11
96;28.05.2016;2016;05;16;Lauantai;69;94;163;8;12;20
96;28.05.2016;2016;05;17;Lauantai;68;91;159;7;10;17
96;28.05.2016;2016;05;18;Lauantai;71;53;124;15;13;28
96;28.05.2016;2016;05;19;Lauantai;60;46;106;12;6;18
96;28.05.2016;2016;05;20;Lauantai;86;63;149;13;6;19
96;28.05.2016;2016;05;21;Lauantai;30;38;68;3;6;9
96;28.05.2016;2016;05;22;Lauantai;18;22;40;0;2;2
96;28.05.2016;2016;05;23;Lauantai;25;18;43;1;2;3
96;29.05.2016;2016;05;00;Sunnuntai;22;13;35;0;3;3
96;29.05.2016;2016;05;01;Sunnuntai;23;4;27;2;2;4
96;29.05.2016;2016;05;02;Sunnuntai;19;5;24;4;2;6
96;29.05.2016;2016;05;03;Sunnuntai;19;2;21;1;0;1
96;29.05.2016;2016;05;04;Sunnuntai;25;9;34;5;0;5
96;29.05.2016;2016;05;05;Sunnuntai;3;3;6;0;2;2
96;29.05.2016;2016;05;06;Sunnuntai;18;7;25;4;1;5
96;29.05.2016;2016;05;07;Sunnuntai;5;8;13;3;1;4
96;29.05.2016;2016;05;08;Sunnuntai;10;15;25;2;2;4
96;29.05.2016;2016;05;09;Sunnuntai;24;43;67;5;5;10
96;29.05.2016;2016;05;10;Sunnuntai;23;34;57;4;3;7
96;29.05.2016;2016;05;11;Sunnuntai;25;41;66;5;7;12
96;29.05.2016;2016;05;12;Sunnuntai;66;92;158;9;5;14
96;29.05.2016;2016;05;13;Sunnuntai;64;64;128;6;6;12
96;29.05.2016;2016;05;14;Sunnuntai;53;80;133;8;9;17
96;29.05.2016;2016;05;15;Sunnuntai;89;76;165;14;16;30
96;29.05.2016;2016;05;16;Sunnuntai;109;55;164;12;11;23
96;29.05.2016;2016;05;17;Sunnuntai;81;62;143;12;9;21
96;29.05.2016;2016;05;18;Sunnuntai;88;85;173;21;19;40
96;29.05.2016;2016;05;19;Sunnuntai;48;62;110;4;15;19
96;29.05.2016;2016;05;20;Sunnuntai;52;51;103;10;6;16
96;29.05.2016;2016;05;21;Sunnuntai;36;42;78;2;5;7
96;29.05.2016;2016;05;22;Sunnuntai;19;16;35;3;0;3
96;29.05.2016;2016;05;23;Sunnuntai;16;4;20;4;1;5
96;30.05.2016;2016;05;00;Maanantai;9;3;12;4;1;5
96;30.05.2016;2016;05;01;Maanantai;5;1;6;0;0;0
96;30.05.2016;2016;05;02;Maanantai;2;2;4;1;1;2
96;30.05.2016;2016;05;03;Maanantai;3;0;3;0;0;0
96;30.05.2016;2016;05;04;Maanantai;4;1;5;3;0;3
96;30.05.2016;2016;05;05;Maanantai;11;4;15;0;0;0
96;30.05.2016;2016;05;06;Maanantai;57;39;96;6;1;7
96;30.05.2016;2016;05;07;Maanantai;121;105;226;6;10;16
96;30.05.2016;2016;05;08;Maanantai;110;161;271;6;11;17
96;30.05.2016;2016;05;09;Maanantai;65;103;168;9;5;14
96;30.05.2016;2016;05;10;Maanantai;71;77;148;5;6;11
96;30.05.2016;2016;05;11;Maanantai;88;88;176;9;7;16
96;30.05.2016;2016;05;12;Maanantai;73;92;165;12;5;17
96;30.05.2016;2016;05;13;Maanantai;107;103;210;7;10;17
96;30.05.2016;2016;05;14;Maanantai;108;129;237;9;11;20
96;30.05.2016;2016;05;15;Maanantai;123;188;311;14;25;39
96;30.05.2016;2016;05;16;Maanantai;179;176;355;13;24;37
96;30.05.2016;2016;05;17;Maanantai;131;97;228;24;17;41
96;30.05.2016;2016;05;18;Maanantai;105;91;196;14;15;29
96;30.05.2016;2016;05;19;Maanantai;94;81;175;22;10;32
96;30.05.2016;2016;05;20;Maanantai;66;50;116;6;8;14
96;30.05.2016;2016;05;21;Maanantai;67;50;117;6;4;10
96;30.05.2016;2016;05;22;Maanantai;13;16;29;3;4;7
96;30.05.2016;2016;05;23;Maanantai;8;10;18;1;1;2
96;31.05.2016;2016;05;00;Tiistai;2;5;7;0;0;0
96;31.05.2016;2016;05;01;Tiistai;10;0;10;0;0;0
96;31.05.2016;2016;05;02;Tiistai;0;1;1;0;0;0
96;31.05.2016;2016;05;03;Tiistai;6;3;9;1;0;1
96;31.05.2016;2016;05;04;Tiistai;1;1;2;0;0;0
96;31.05.2016;2016;05;05;Tiistai;12;9;21;0;1;1
96;31.05.2016;2016;05;06;Tiistai;61;37;98;2;0;2
96;31.05.2016;2016;05;07;Tiistai;140;101;241;10;6;16
96;31.05.2016;2016;05;08;Tiistai;110;155;265;10;7;17
96;31.05.2016;2016;05;09;Tiistai;90;92;182;7;7;14
96;31.05.2016;2016;05;10;Tiistai;65;80;145;5;8;13
96;31.05.2016;2016;05;11;Tiistai;78;76;154;11;7;18
96;31.05.2016;2016;05;12;Tiistai;95;109;204;13;6;19
96;31.05.2016;2016;05;13;Tiistai;107;94;201;9;18;27
96;31.05.2016;2016;05;14;Tiistai;126;121;247;8;14;22
96;31.05.2016;2016;05;15;Tiistai;140;189;329;13;31;44
96;31.05.2016;2016;05;16;Tiistai;173;170;343;14;28;42
96;31.05.2016;2016;05;17;Tiistai;121;95;216;4;7;11
96;31.05.2016;2016;05;18;Tiistai;112;75;187;10;13;23
96;31.05.2016;2016;05;19;Tiistai;119;59;178;14;14;28
96;31.05.2016;2016;05;20;Tiistai;77;55;132;6;14;20
96;31.05.2016;2016;05;21;Tiistai;51;54;105;3;9;12
96;31.05.2016;2016;05;22;Tiistai;29;26;55;2;1;3
96;31.05.2016;2016;05;23;Tiistai;14;9;23;3;0;3
96;01.06.2016;2016;06;00;Keskiviikko;4;6;10;4;2;6
96;01.06.2016;2016;06;01;Keskiviikko;2;1;3;2;2;4
96;01.06.2016;2016;06;02;Keskiviikko;4;0;4;0;0;0
96;01.06.2016;2016;06;03;Keskiviikko;2;0;2;0;0;0
96;01.06.2016;2016;06;04;Keskiviikko;3;1;4;0;0;0
96;01.06.2016;2016;06;05;Keskiviikko;9;6;15;2;1;3
96;01.06.2016;2016;06;06;Keskiviikko;43;40;83;2;1;3
96;01.06.2016;2016;06;07;Keskiviikko;128;113;241;27;1;28
96;01.06.2016;2016;06;08;Keskiviikko;89;155;244;10;8;18
96;01.06.2016;2016;06;09;Keskiviikko;86;152;238;10;7;17
96;01.06.2016;2016;06;10;Keskiviikko;51;61;112;5;4;9
96;01.06.2016;2016;06;11;Keskiviikko;63;65;128;6;7;13
96;01.06.2016;2016;06;12;Keskiviikko;63;89;152;5;15;20
96;01.06.2016;2016;06;13;Keskiviikko;67;90;157;7;6;13
96;01.06.2016;2016;06;14;Keskiviikko;88;91;179;6;9;15
96;01.06.2016;2016;06;15;Keskiviikko;97;172;269;5;31;36
96;01.06.2016;2016;06;16;Keskiviikko;146;165;311;14;23;37
96;01.06.2016;2016;06;17;Keskiviikko;114;82;196;16;12;28
96;01.06.2016;2016;06;18;Keskiviikko;96;67;163;22;21;43
96;01.06.2016;2016;06;19;Keskiviikko;123;61;184;16;7;23
96;01.06.2016;2016;06;20;Keskiviikko;106;50;156;7;12;19
96;01.06.2016;2016;06;21;Keskiviikko;48;45;93;11;11;22
96;01.06.2016;2016;06;22;Keskiviikko;37;16;53;5;6;11
96;01.06.2016;2016;06;23;Keskiviikko;8;4;12;2;2;4
96;02.06.2016;2016;06;00;Torstai;5;5;10;1;3;4
96;02.06.2016;2016;06;01;Torstai;5;2;7;1;2;3
96;02.06.2016;2016;06;02;Torstai;2;3;5;1;0;1
96;02.06.2016;2016;06;03;Torstai;2;0;2;0;0;0
96;02.06.2016;2016;06;04;Torstai;7;2;9;0;1;1
96;02.06.2016;2016;06;05;Torstai;9;12;21;3;0;3
96;02.06.2016;2016;06;06;Torstai;53;30;83;3;2;5
96;02.06.2016;2016;06;07;Torstai;134;121;255;13;4;17
96;02.06.2016;2016;06;08;Torstai;98;149;247;9;9;18
96;02.06.2016;2016;06;09;Torstai;75;92;167;9;9;18
96;02.06.2016;2016;06;10;Torstai;58;111;169;7;14;21
96;02.06.2016;2016;06;11;Torstai;70;102;172;11;9;20
96;02.06.2016;2016;06;12;Torstai;106;96;202;8;6;14
96;02.06.2016;2016;06;13;Torstai;95;116;211;7;15;22
96;02.06.2016;2016;06;14;Torstai;103;110;213;3;10;13
96;02.06.2016;2016;06;15;Torstai;127;200;327;8;18;26
96;02.06.2016;2016;06;16;Torstai;167;189;356;14;20;34
96;02.06.2016;2016;06;17;Torstai;114;90;204;11;12;23
96;02.06.2016;2016;06;18;Torstai;126;70;196;13;12;25
96;02.06.2016;2016;06;19;Torstai;87;64;151;5;18;23
96;02.06.2016;2016;06;20;Torstai;78;51;129;6;12;18
96;02.06.2016;2016;06;21;Torstai;54;39;93;4;6;10
96;02.06.2016;2016;06;22;Torstai;31;15;46;3;3;6
96;02.06.2016;2016;06;23;Torstai;14;10;24;0;0;0
96;03.06.2016;2016;06;00;Perjantai;10;6;16;0;2;2
96;03.06.2016;2016;06;01;Perjantai;9;1;10;1;0;1
96;03.06.2016;2016;06;02;Perjantai;3;1;4;1;0;1
96;03.06.2016;2016;06;03;Perjantai;4;0;4;0;0;0
96;03.06.2016;2016;06;04;Perjantai;6;2;8;0;0;0
96;03.06.2016;2016;06;05;Perjantai;6;6;12;2;1;3
96;03.06.2016;2016;06;06;Perjantai;47;25;72;5;3;8
96;03.06.2016;2016;06;07;Perjantai;88;79;167;14;4;18
96;03.06.2016;2016;06;08;Perjantai;67;124;191;8;9;17
96;03.06.2016;2016;06;09;Perjantai;74;80;154;6;9;15
96;03.06.2016;2016;06;10;Perjantai;47;60;107;3;11;14
96;03.06.2016;2016;06;11;Perjantai;49;120;169;11;13;24
96;03.06.2016;2016;06;12;Perjantai;88;94;182;9;11;20
96;03.06.2016;2016;06;13;Perjantai;80;88;168;7;21;28
96;03.06.2016;2016;06;14;Perjantai;95;108;203;11;21;32
96;03.06.2016;2016;06;15;Perjantai;93;159;252;12;13;25
96;03.06.2016;2016;06;16;Perjantai;136;68;204;8;11;19
96;03.06.2016;2016;06;17;Perjantai;66;50;116;9;8;17
96;03.06.2016;2016;06;18;Perjantai;55;45;100;6;4;10
96;03.06.2016;2016;06;19;Perjantai;68;54;122;4;6;10
96;03.06.2016;2016;06;20;Perjantai;49;45;94;4;5;9
96;03.06.2016;2016;06;21;Perjantai;35;40;75;2;7;9
96;03.06.2016;2016;06;22;Perjantai;9;23;32;3;2;5
96;03.06.2016;2016;06;23;Perjantai;10;13;23;1;3;4
96;04.06.2016;2016;06;00;Lauantai;18;12;30;1;1;2
96;04.06.2016;2016;06;01;Lauantai;3;3;6;0;0;0
96;04.06.2016;2016;06;02;Lauantai;15;2;17;2;1;3
96;04.06.2016;2016;06;03;Lauantai;10;6;16;2;0;2
96;04.06.2016;2016;06;04;Lauantai;11;6;17;0;1;1
96;04.06.2016;2016;06;05;Lauantai;3;1;4;2;0;2
96;04.06.2016;2016;06;06;Lauantai;20;12;32;1;0;1
96;04.06.2016;2016;06;07;Lauantai;20;14;34;1;3;4
96;04.06.2016;2016;06;08;Lauantai;13;25;38;3;5;8
96;04.06.2016;2016;06;09;Lauantai;23;49;72;4;7;11
96;04.06.2016;2016;06;10;Lauantai;35;60;95;2;4;6
96;04.06.2016;2016;06;11;Lauantai;40;38;78;5;5;10
96;04.06.2016;2016;06;12;Lauantai;66;52;118;8;5;13
96;04.06.2016;2016;06;13;Lauantai;61;53;114;10;1;11
96;04.06.2016;2016;06;14;Lauantai;32;61;93;3;6;9
96;04.06.2016;2016;06;15;Lauantai;45;39;84;5;7;12
96;04.06.2016;2016;06;16;Lauantai;44;22;66;4;4;8
96;04.06.2016;2016;06;17;Lauantai;40;30;70;6;5;11
96;04.06.2016;2016;06;18;Lauantai;30;38;68;5;4;9
96;04.06.2016;2016;06;19;Lauantai;35;39;74;6;3;9
96;04.06.2016;2016;06;20;Lauantai;18;53;71;3;7;10
96;04.06.2016;2016;06;21;Lauantai;32;35;67;1;4;5
96;04.06.2016;2016;06;22;Lauantai;10;15;25;3;4;7
96;04.06.2016;2016;06;23;Lauantai;32;14;46;0;4;4
96;05.06.2016;2016;06;00;Sunnuntai;22;7;29;1;2;3
96;05.06.2016;2016;06;01;Sunnuntai;12;5;17;4;0;4
96;05.06.2016;2016;06;02;Sunnuntai;17;3;20;1;0;1
96;05.06.2016;2016;06;03;Sunnuntai;22;2;24;5;0;5
96;05.06.2016;2016;06;04;Sunnuntai;24;0;24;0;1;1
96;05.06.2016;2016;06;05;Sunnuntai;12;1;13;3;0;3
96;05.06.2016;2016;06;06;Sunnuntai;20;8;28;4;1;5
96;05.06.2016;2016;06;07;Sunnuntai;2;12;14;0;6;6
96;05.06.2016;2016;06;08;Sunnuntai;9;14;23;2;1;3
96;05.06.2016;2016;06;09;Sunnuntai;14;15;29;4;3;7
96;05.06.2016;2016;06;10;Sunnuntai;17;20;37;5;5;10
96;05.06.2016;2016;06;11;Sunnuntai;17;22;39;6;14;20
96;05.06.2016;2016;06;12;Sunnuntai;33;38;71;4;8;12
96;05.06.2016;2016;06;13;Sunnuntai;44;39;83;5;4;9
96;05.06.2016;2016;06;14;Sunnuntai;26;46;72;2;3;5
96;05.06.2016;2016;06;15;Sunnuntai;37;43;80;4;4;8
96;05.06.2016;2016;06;16;Sunnuntai;40;40;80;12;5;17
96;05.06.2016;2016;06;17;Sunnuntai;43;48;91;15;4;19
96;05.06.2016;2016;06;18;Sunnuntai;52;38;90;6;9;15
96;05.06.2016;2016;06;19;Sunnuntai;36;32;68;8;5;13
96;05.06.2016;2016;06;20;Sunnuntai;37;30;67;3;6;9
96;05.06.2016;2016;06;21;Sunnuntai;19;17;36;1;5;6
96;05.06.2016;2016;06;22;Sunnuntai;19;17;36;2;1;3
96;05.06.2016;2016;06;23;Sunnuntai;5;9;14;2;3;5
96;06.06.2016;2016;06;00;Maanantai;4;5;9;1;2;3
96;06.06.2016;2016;06;01;Maanantai;4;0;4;0;0;0
96;06.06.2016;2016;06;02;Maanantai;0;2;2;0;0;0
96;06.06.2016;2016;06;03;Maanantai;3;0;3;0;2;2
96;06.06.2016;2016;06;04;Maanantai;3;1;4;0;0;0
96;06.06.2016;2016;06;05;Maanantai;5;12;17;1;1;2
96;06.06.2016;2016;06;06;Maanantai;41;37;78;2;1;3
96;06.06.2016;2016;06;07;Maanantai;107;114;221;12;6;18
96;06.06.2016;2016;06;08;Maanantai;70;100;170;9;3;12
96;06.06.2016;2016;06;09;Maanantai;36;78;114;4;6;10
96;06.06.2016;2016;06;10;Maanantai;40;73;113;1;12;13
96;06.06.2016;2016;06;11;Maanantai;59;51;110;5;12;17
96;06.06.2016;2016;06;12;Maanantai;56;73;129;9;10;19
96;06.06.2016;2016;06;13;Maanantai;71;57;128;12;9;21
96;06.06.2016;2016;06;14;Maanantai;74;81;155;6;9;15
96;06.06.2016;2016;06;15;Maanantai;98;189;287;7;23;30
96;06.06.2016;2016;06;16;Maanantai;158;133;291;6;11;17
96;06.06.2016;2016;06;17;Maanantai;83;73;156;9;9;18
96;06.06.2016;2016;06;18;Maanantai;83;56;139;23;28;51
96;06.06.2016;2016;06;19;Maanantai;76;44;120;8;9;17
96;06.06.2016;2016;06;20;Maanantai;53;47;100;6;7;13
96;06.06.2016;2016;06;21;Maanantai;51;40;91;8;5;13
96;06.06.2016;2016;06;22;Maanantai;24;19;43;4;7;11
96;06.06.2016;2016;06;23;Maanantai;6;6;12;0;0;0
96;07.06.2016;2016;06;00;Tiistai;7;8;15;2;3;5
96;07.06.2016;2016;06;01;Tiistai;4;0;4;0;1;1
96;07.06.2016;2016;06;02;Tiistai;2;0;2;0;0;0
96;07.06.2016;2016;06;03;Tiistai;8;0;8;0;0;0
96;07.06.2016;2016;06;04;Tiistai;2;0;2;0;0;0
96;07.06.2016;2016;06;05;Tiistai;5;9;14;1;0;1
96;07.06.2016;2016;06;06;Tiistai;57;30;87;7;3;10
96;07.06.2016;2016;06;07;Tiistai;107;109;216;21;7;28
96;07.06.2016;2016;06;08;Tiistai;57;120;177;7;6;13
96;07.06.2016;2016;06;09;Tiistai;35;63;98;6;7;13
96;07.06.2016;2016;06;10;Tiistai;40;72;112;6;11;17
96;07.06.2016;2016;06;11;Tiistai;56;71;127;3;9;12
96;07.06.2016;2016;06;12;Tiistai;72;76;148;9;4;13
96;07.06.2016;2016;06;13;Tiistai;75;74;149;3;6;9
96;07.06.2016;2016;06;14;Tiistai;88;98;186;4;9;13
96;07.06.2016;2016;06;15;Tiistai;95;162;257;7;20;27
96;07.06.2016;2016;06;16;Tiistai;119;157;276;6;17;23
96;07.06.2016;2016;06;17;Tiistai;90;65;155;6;15;21
96;07.06.2016;2016;06;18;Tiistai;76;60;136;9;12;21
96;07.06.2016;2016;06;19;Tiistai;73;60;133;8;14;22
96;07.06.2016;2016;06;20;Tiistai;68;35;103;6;13;19
96;07.06.2016;2016;06;21;Tiistai;51;30;81;7;5;12
96;07.06.2016;2016;06;22;Tiistai;25;9;34;3;2;5
96;07.06.2016;2016;06;23;Tiistai;8;6;14;2;1;3
96;08.06.2016;2016;06;00;Keskiviikko;2;2;4;1;0;1
96;08.06.2016;2016;06;01;Keskiviikko;1;0;1;0;0;0
96;08.06.2016;2016;06;02;Keskiviikko;2;0;2;0;0;0
96;08.06.2016;2016;06;03;Keskiviikko;4;0;4;0;0;0
96;08.06.2016;2016;06;04;Keskiviikko;1;2;3;0;0;0
96;08.06.2016;2016;06;05;Keskiviikko;9;5;14;0;1;1
96;08.06.2016;2016;06;06;Keskiviikko;44;12;56;2;2;4
96;08.06.2016;2016;06;07;Keskiviikko;85;62;147;12;4;16
96;08.06.2016;2016;06;08;Keskiviikko;54;71;125;11;6;17
96;08.06.2016;2016;06;09;Keskiviikko;27;54;81;6;6;12
96;08.06.2016;2016;06;10;Keskiviikko;21;27;48;5;18;23
96;08.06.2016;2016;06;11;Keskiviikko;36;18;54;1;3;4
96;08.06.2016;2016;06;12;Keskiviikko;30;30;60;6;3;9
96;08.06.2016;2016;06;13;Keskiviikko;24;38;62;5;7;12
96;08.06.2016;2016;06;14;Keskiviikko;45;44;89;2;2;4
96;08.06.2016;2016;06;15;Keskiviikko;48;87;135;2;11;13
96;08.06.2016;2016;06;16;Keskiviikko;50;60;110;1;8;9
96;08.06.2016;2016;06;17;Keskiviikko;24;33;57;3;4;7
96;08.06.2016;2016;06;18;Keskiviikko;19;20;39;5;8;13
96;08.06.2016;2016;06;19;Keskiviikko;15;17;32;4;3;7
96;08.06.2016;2016;06;20;Keskiviikko;20;10;30;10;7;17
96;08.06.2016;2016;06;21;Keskiviikko;15;20;35;1;3;4
96;08.06.2016;2016;06;22;Keskiviikko;9;7;16;4;6;10
96;08.06.2016;2016;06;23;Keskiviikko;5;9;14;2;2;4
96;09.06.2016;2016;06;00;Torstai;3;6;9;0;0;0
96;09.06.2016;2016;06;01;Torstai;3;0;3;0;0;0
96;09.06.2016;2016;06;02;Torstai;2;0;2;0;0;0
96;09.06.2016;2016;06;03;Torstai;3;0;3;0;0;0
96;09.06.2016;2016;06;04;Torstai;5;0;5;0;1;1
96;09.06.2016;2016;06;05;Torstai;8;5;13;1;0;1
96;09.06.2016;2016;06;06;Torstai;43;23;66;4;1;5
96;09.06.2016;2016;06;07;Torstai;66;93;159;14;6;20
96;09.06.2016;2016;06;08;Torstai;59;80;139;8;4;12
96;09.06.2016;2016;06;09;Torstai;25;41;66;5;8;13
96;09.06.2016;2016;06;10;Torstai;31;49;80;7;8;15
96;09.06.2016;2016;06;11;Torstai;38;45;83;6;8;14
96;09.06.2016;2016;06;12;Torstai;50;52;102;6;9;15
96;09.06.2016;2016;06;13;Torstai;54;67;121;5;3;8
96;09.06.2016;2016;06;14;Torstai;62;67;129;4;9;13
96;09.06.2016;2016;06;15;Torstai;89;144;233;6;11;17
96;09.06.2016;2016;06;16;Torstai;84;124;208;10;12;22
96;09.06.2016;2016;06;17;Torstai;58;62;120;20;5;25
96;09.06.2016;2016;06;18;Torstai;53;47;100;12;15;27
96;09.06.2016;2016;06;19;Torstai;61;43;104;4;10;14
96;09.06.2016;2016;06;20;Torstai;71;35;106;12;12;24
96;09.06.2016;2016;06;21;Torstai;28;28;56;8;9;17
96;09.06.2016;2016;06;22;Torstai;11;24;35;2;4;6
96;09.06.2016;2016;06;23;Torstai;8;3;11;0;3;3
96;10.06.2016;2016;06;00;Perjantai;7;5;12;5;3;8
96;10.06.2016;2016;06;01;Perjantai;7;1;8;2;1;3
96;10.06.2016;2016;06;02;Perjantai;3;0;3;0;0;0
96;10.06.2016;2016;06;03;Perjantai;3;0;3;0;0;0
96;10.06.2016;2016;06;04;Perjantai;3;3;6;1;0;1
96;10.06.2016;2016;06;05;Perjantai;6;3;9;6;1;7
96;10.06.2016;2016;06;06;Perjantai;53;28;81;3;0;3
96;10.06.2016;2016;06;07;Perjantai;80;77;157;10;1;11
96;10.06.2016;2016;06;08;Perjantai;44;89;133;8;7;15
96;10.06.2016;2016;06;09;Perjantai;23;56;79;3;5;8
96;10.06.2016;2016;06;10;Perjantai;19;37;56;3;6;9
96;10.06.2016;2016;06;11;Perjantai;37;44;81;4;14;18
96;10.06.2016;2016;06;12;Perjantai;61;44;105;5;7;12
96;10.06.2016;2016;06;13;Perjantai;57;82;139;13;10;23
96;10.06.2016;2016;06;14;Perjantai;56;89;145;6;9;15
96;10.06.2016;2016;06;15;Perjantai;64;119;183;4;15;19
96;10.06.2016;2016;06;16;Perjantai;76;90;166;6;8;14
96;10.06.2016;2016;06;17;Perjantai;42;51;93;3;4;7
96;10.06.2016;2016;06;18;Perjantai;53;41;94;2;7;9
96;10.06.2016;2016;06;19;Perjantai;34;29;63;7;3;10
96;10.06.2016;2016;06;20;Perjantai;39;31;70;5;11;16
96;10.06.2016;2016;06;21;Perjantai;40;42;82;0;7;7
96;10.06.2016;2016;06;22;Perjantai;18;20;38;1;0;1
96;10.06.2016;2016;06;23;Perjantai;9;15;24;1;0;1
96;11.06.2016;2016;06;00;Lauantai;11;15;26;0;1;1
96;11.06.2016;2016;06;01;Lauantai;7;6;13;0;0;0
96;11.06.2016;2016;06;02;Lauantai;10;1;11;1;0;1
96;11.06.2016;2016;06;03;Lauantai;18;1;19;1;0;1
96;11.06.2016;2016;06;04;Lauantai;9;1;10;3;0;3
96;11.06.2016;2016;06;05;Lauantai;1;2;3;1;1;2
96;11.06.2016;2016;06;06;Lauantai;20;15;35;3;0;3
96;11.06.2016;2016;06;07;Lauantai;9;16;25;0;1;1
96;11.06.2016;2016;06;08;Lauantai;9;24;33;2;5;7
96;11.06.2016;2016;06;09;Lauantai;15;29;44;3;3;6
96;11.06.2016;2016;06;10;Lauantai;21;40;61;5;8;13
96;11.06.2016;2016;06;11;Lauantai;28;30;58;9;14;23
96;11.06.2016;2016;06;12;Lauantai;54;88;142;10;15;25
96;11.06.2016;2016;06;13;Lauantai;67;68;135;23;86;109
96;11.06.2016;2016;06;14;Lauantai;38;84;122;68;168;236
96;11.06.2016;2016;06;15;Lauantai;67;62;129;38;77;115
96;11.06.2016;2016;06;16;Lauantai;52;34;86;3;12;15
96;11.06.2016;2016;06;17;Lauantai;49;41;90;3;7;10
96;11.06.2016;2016;06;18;Lauantai;46;35;81;13;6;19
96;11.06.2016;2016;06;19;Lauantai;32;33;65;10;7;17
96;11.06.2016;2016;06;20;Lauantai;26;30;56;1;4;5
96;11.06.2016;2016;06;21;Lauantai;25;29;54;2;4;6
96;11.06.2016;2016;06;22;Lauantai;15;19;34;6;6;12
96;11.06.2016;2016;06;23;Lauantai;10;14;24;2;1;3
96;12.06.2016;2016;06;00;Sunnuntai;26;13;39;0;0;0
96;12.06.2016;2016;06;01;Sunnuntai;11;8;19;1;0;1
96;12.06.2016;2016;06;02;Sunnuntai;21;6;27;2;0;2
96;12.06.2016;2016;06;03;Sunnuntai;17;3;20;3;1;4
96;12.06.2016;2016;06;04;Sunnuntai;14;3;17;2;3;5
96;12.06.2016;2016;06;05;Sunnuntai;7;3;10;3;2;5
96;12.06.2016;2016;06;06;Sunnuntai;23;4;27;2;0;2
96;12.06.2016;2016;06;07;Sunnuntai;3;11;14;0;1;1
96;12.06.2016;2016;06;08;Sunnuntai;6;11;17;1;1;2
96;12.06.2016;2016;06;09;Sunnuntai;10;19;29;2;2;4
96;12.06.2016;2016;06;10;Sunnuntai;17;19;36;7;6;13
96;12.06.2016;2016;06;11;Sunnuntai;17;40;57;3;8;11
96;12.06.2016;2016;06;12;Sunnuntai;50;57;107;6;6;12
96;12.06.2016;2016;06;13;Sunnuntai;50;51;101;4;11;15
96;12.06.2016;2016;06;14;Sunnuntai;43;58;101;7;13;20
96;12.06.2016;2016;06;15;Sunnuntai;42;65;107;12;8;20
96;12.06.2016;2016;06;16;Sunnuntai;65;34;99;12;13;25
96;12.06.2016;2016;06;17;Sunnuntai;60;40;100;5;6;11
96;12.06.2016;2016;06;18;Sunnuntai;69;44;113;6;13;19
96;12.06.2016;2016;06;19;Sunnuntai;27;54;81;7;7;14
96;12.06.2016;2016;06;20;Sunnuntai;30;39;69;5;3;8
96;12.06.2016;2016;06;21;Sunnuntai;23;31;54;6;8;14
96;12.06.2016;2016;06;22;Sunnuntai;16;10;26;4;4;8
96;12.06.2016;2016;06;23;Sunnuntai;8;4;12;2;3;5
96;13.06.2016;2016;06;00;Maanantai;6;2;8;0;0;0
96;13.06.2016;2016;06;01;Maanantai;2;1;3;1;0;1
96;13.06.2016;2016;06;02;Maanantai;1;1;2;1;1;2
96;13.06.2016;2016;06;03;Maanantai;3;0;3;2;0;2
96;13.06.2016;2016;06;04;Maanantai;1;3;4;0;0;0
96;13.06.2016;2016;06;05;Maanantai;6;6;12;1;0;1
96;13.06.2016;2016;06;06;Maanantai;56;37;93;3;0;3
96;13.06.2016;2016;06;07;Maanantai;97;100;197;13;4;17
96;13.06.2016;2016;06;08;Maanantai;54;124;178;9;9;18
96;13.06.2016;2016;06;09;Maanantai;31;67;98;13;7;20
96;13.06.2016;2016;06;10;Maanantai;40;63;103;3;11;14
96;13.06.2016;2016;06;11;Maanantai;65;62;127;6;7;13
96;13.06.2016;2016;06;12;Maanantai;73;66;139;8;9;17
96;13.06.2016;2016;06;13;Maanantai;70;63;133;5;5;10
96;13.06.2016;2016;06;14;Maanantai;77;84;161;11;15;26
96;13.06.2016;2016;06;15;Maanantai;109;182;291;9;12;21
96;13.06.2016;2016;06;16;Maanantai;147;136;283;4;17;21
96;13.06.2016;2016;06;17;Maanantai;84;74;158;7;10;17
96;13.06.2016;2016;06;18;Maanantai;88;56;144;10;6;16
96;13.06.2016;2016;06;19;Maanantai;83;52;135;9;8;17
96;13.06.2016;2016;06;20;Maanantai;52;26;78;9;6;15
96;13.06.2016;2016;06;21;Maanantai;42;51;93;5;3;8
96;13.06.2016;2016;06;22;Maanantai;31;12;43;2;4;6
96;13.06.2016;2016;06;23;Maanantai;10;6;16;1;3;4
96;14.06.2016;2016;06;00;Tiistai;5;4;9;1;1;2
96;14.06.2016;2016;06;01;Tiistai;1;1;2;1;0;1
96;14.06.2016;2016;06;02;Tiistai;2;0;2;0;0;0
96;14.06.2016;2016;06;03;Tiistai;2;0;2;0;0;0
96;14.06.2016;2016;06;04;Tiistai;2;1;3;0;0;0
96;14.06.2016;2016;06;05;Tiistai;5;7;12;0;0;0
96;14.06.2016;2016;06;06;Tiistai;63;30;93;2;2;4
96;14.06.2016;2016;06;07;Tiistai;86;97;183;18;9;27
96;14.06.2016;2016;06;08;Tiistai;61;115;176;7;7;14
96;14.06.2016;2016;06;09;Tiistai;37;69;106;5;2;7
96;14.06.2016;2016;06;10;Tiistai;39;54;93;8;7;15
96;14.06.2016;2016;06;11;Tiistai;39;57;96;6;5;11
96;14.06.2016;2016;06;12;Tiistai;71;62;133;4;7;11
96;14.06.2016;2016;06;13;Tiistai;80;64;144;5;6;11
96;14.06.2016;2016;06;14;Tiistai;66;82;148;1;9;10
96;14.06.2016;2016;06;15;Tiistai;97;186;283;3;32;35
96;14.06.2016;2016;06;16;Tiistai;116;136;252;12;15;27
96;14.06.2016;2016;06;17;Tiistai;109;82;191;7;6;13
96;14.06.2016;2016;06;18;Tiistai;80;64;144;5;6;11
96;14.06.2016;2016;06;19;Tiistai;81;45;126;4;8;12
96;14.06.2016;2016;06;20;Tiistai;67;36;103;7;6;13
96;14.06.2016;2016;06;21;Tiistai;41;38;79;8;4;12
96;14.06.2016;2016;06;22;Tiistai;17;19;36;3;4;7
96;14.06.2016;2016;06;23;Tiistai;17;9;26;2;2;4
96;15.06.2016;2016;06;00;Keskiviikko;4;4;8;2;1;3
96;15.06.2016;2016;06;01;Keskiviikko;6;0;6;0;0;0
96;15.06.2016;2016;06;02;Keskiviikko;1;0;1;0;2;2
96;15.06.2016;2016;06;03;Keskiviikko;2;0;2;0;0;0
96;15.06.2016;2016;06;04;Keskiviikko;2;2;4;0;0;0
96;15.06.2016;2016;06;05;Keskiviikko;5;4;9;4;1;5
96;15.06.2016;2016;06;06;Keskiviikko;64;24;88;5;1;6
96;15.06.2016;2016;06;07;Keskiviikko;102;101;203;12;6;18
96;15.06.2016;2016;06;08;Keskiviikko;54;107;161;13;14;27
96;15.06.2016;2016;06;09;Keskiviikko;50;68;118;9;6;15
96;15.06.2016;2016;06;10;Keskiviikko;41;54;95;5;8;13
96;15.06.2016;2016;06;11;Keskiviikko;54;56;110;10;17;27
96;15.06.2016;2016;06;12;Keskiviikko;64;62;126;7;10;17
96;15.06.2016;2016;06;13;Keskiviikko;72;60;132;7;6;13
96;15.06.2016;2016;06;14;Keskiviikko;69;98;167;6;11;17
96;15.06.2016;2016;06;15;Keskiviikko;109;179;288;2;15;17
96;15.06.2016;2016;06;16;Keskiviikko;123;146;269;14;13;27
96;15.06.2016;2016;06;17;Keskiviikko;92;104;196;6;9;15
96;15.06.2016;2016;06;18;Keskiviikko;81;70;151;9;6;15
96;15.06.2016;2016;06;19;Keskiviikko;75;45;120;12;10;22
96;15.06.2016;2016;06;20;Keskiviikko;117;47;164;7;7;14
96;15.06.2016;2016;06;21;Keskiviikko;53;34;87;3;6;9
96;15.06.2016;2016;06;22;Keskiviikko;38;19;57;0;5;5
96;15.06.2016;2016;06;23;Keskiviikko;16;13;29;3;2;5
96;16.06.2016;2016;06;00;Torstai;12;5;17;1;2;3
96;16.06.2016;2016;06;01;Torstai;5;3;8;0;0;0
96;16.06.2016;2016;06;02;Torstai;5;0;5;0;0;0
96;16.06.2016;2016;06;03;Torstai;5;0;5;0;0;0
96;16.06.2016;2016;06;04;Torstai;7;3;10;0;0;0
96;16.06.2016;2016;06;05;Torstai;7;4;11;1;0;1
96;16.06.2016;2016;06;06;Torstai;55;26;81;2;3;5
96;16.06.2016;2016;06;07;Torstai;92;89;181;11;2;13
96;16.06.2016;2016;06;08;Torstai;60;116;176;6;13;19
96;16.06.2016;2016;06;09;Torstai;30;61;91;4;4;8
96;16.06.2016;2016;06;10;Torstai;39;64;103;3;10;13
96;16.06.2016;2016;06;11;Torstai;50;61;111;6;7;13
96;16.06.2016;2016;06;12;Torstai;67;64;131;9;7;16
96;16.06.2016;2016;06;13;Torstai;57;63;120;2;7;9
96;16.06.2016;2016;06;14;Torstai;65;55;120;4;10;14
96;16.06.2016;2016;06;15;Torstai;79;101;180;3;5;8
96;16.06.2016;2016;06;16;Torstai;82;87;169;5;5;10
96;16.06.2016;2016;06;17;Torstai;39;30;69;1;1;2
96;16.06.2016;2016;06;18;Torstai;34;26;60;12;4;16
96;16.06.2016;2016;06;19;Torstai;22;15;37;4;1;5
96;16.06.2016;2016;06;20;Torstai;40;23;63;2;1;3
96;16.06.2016;2016;06;21;Torstai;23;34;57;3;2;5
96;16.06.2016;2016;06;22;Torstai;16;14;30;3;3;6
96;16.06.2016;2016;06;23;Torstai;7;2;9;2;1;3
96;17.06.2016;2016;06;00;Perjantai;4;2;6;2;1;3
96;17.06.2016;2016;06;01;Perjantai;3;1;4;0;1;1
96;17.06.2016;2016;06;02;Perjantai;0;3;3;1;0;1
96;17.06.2016;2016;06;03;Perjantai;3;0;3;0;0;0
96;17.06.2016;2016;06;04;Perjantai;1;1;2;1;1;2
96;17.06.2016;2016;06;05;Perjantai;5;5;10;0;0;0
96;17.06.2016;2016;06;06;Perjantai;42;28;70;2;0;2
96;17.06.2016;2016;06;07;Perjantai;50;59;109;6;3;9
96;17.06.2016;2016;06;08;Perjantai;33;36;69;3;2;5
96;17.06.2016;2016;06;09;Perjantai;15;22;37;3;4;7
96;17.06.2016;2016;06;10;Perjantai;17;41;58;1;5;6
96;17.06.2016;2016;06;11;Perjantai;31;43;74;7;9;16
96;17.06.2016;2016;06;12;Perjantai;25;31;56;1;13;14
96;17.06.2016;2016;06;13;Perjantai;31;32;63;2;7;9
96;17.06.2016;2016;06;14;Perjantai;45;64;109;8;6;14
96;17.06.2016;2016;06;15;Perjantai;48;78;126;4;5;9
96;17.06.2016;2016;06;16;Perjantai;50;58;108;5;10;15
96;17.06.2016;2016;06;17;Perjantai;41;55;96;4;5;9
96;17.06.2016;2016;06;18;Perjantai;55;46;101;7;5;12
96;17.06.2016;2016;06;19;Perjantai;38;41;79;4;5;9
96;17.06.2016;2016;06;20;Perjantai;56;38;94;4;9;13
96;17.06.2016;2016;06;21;Perjantai;34;19;53;4;5;9
96;17.06.2016;2016;06;22;Perjantai;17;20;37;2;2;4
96;17.06.2016;2016;06;23;Perjantai;20;11;31;0;2;2
96;18.06.2016;2016;06;00;Lauantai;13;8;21;4;1;5
96;18.06.2016;2016;06;01;Lauantai;9;6;15;2;0;2
96;18.06.2016;2016;06;02;Lauantai;8;4;12;1;0;1
96;18.06.2016;2016;06;03;Lauantai;8;1;9;3;3;6
96;18.06.2016;2016;06;04;Lauantai;4;2;6;2;0;2
96;18.06.2016;2016;06;05;Lauantai;9;3;12;0;2;2
96;18.06.2016;2016;06;06;Lauantai;20;12;32;5;1;6
96;18.06.2016;2016;06;07;Lauantai;12;9;21;1;4;5
96;18.06.2016;2016;06;08;Lauantai;7;24;31;1;1;2
96;18.06.2016;2016;06;09;Lauantai;18;36;54;3;4;7
96;18.06.2016;2016;06;10;Lauantai;33;49;82;2;4;6
96;18.06.2016;2016;06;11;Lauantai;32;29;61;7;10;17
96;18.06.2016;2016;06;12;Lauantai;20;11;31;1;2;3
96;18.06.2016;2016;06;13;Lauantai;22;13;35;3;0;3
96;18.06.2016;2016;06;14;Lauantai;17;32;49;3;6;9
96;18.06.2016;2016;06;15;Lauantai;13;44;57;3;6;9
96;18.06.2016;2016;06;16;Lauantai;23;21;44;2;3;5
96;18.06.2016;2016;06;17;Lauantai;33;19;52;4;1;5
96;18.06.2016;2016;06;18;Lauantai;29;14;43;6;1;7
96;18.06.2016;2016;06;19;Lauantai;20;11;31;4;4;8
96;18.06.2016;2016;06;20;Lauantai;6;15;21;1;4;5
96;18.06.2016;2016;06;21;Lauantai;11;21;32;2;2;4
96;18.06.2016;2016;06;22;Lauantai;12;12;24;3;2;5
96;18.06.2016;2016;06;23;Lauantai;4;6;10;0;1;1
96;19.06.2016;2016;06;00;Sunnuntai;4;5;9;1;0;1
96;19.06.2016;2016;06;01;Sunnuntai;9;3;12;4;0;4
96;19.06.2016;2016;06;02;Sunnuntai;17;5;22;1;0;1
96;19.06.2016;2016;06;03;Sunnuntai;11;0;11;2;0;2
96;19.06.2016;2016;06;04;Sunnuntai;8;2;10;2;0;2
96;19.06.2016;2016;06;05;Sunnuntai;4;1;5;4;1;5
96;19.06.2016;2016;06;06;Sunnuntai;14;4;18;2;1;3
96;19.06.2016;2016;06;07;Sunnuntai;3;6;9;1;1;2
96;19.06.2016;2016;06;08;Sunnuntai;6;15;21;1;2;3
96;19.06.2016;2016;06;09;Sunnuntai;8;12;20;0;1;1
96;19.06.2016;2016;06;10;Sunnuntai;17;22;39;3;6;9
96;19.06.2016;2016;06;11;Sunnuntai;29;38;67;4;7;11
96;19.06.2016;2016;06;12;Sunnuntai;38;54;92;7;10;17
96;19.06.2016;2016;06;13;Sunnuntai;65;58;123;11;5;16
96;19.06.2016;2016;06;14;Sunnuntai;48;57;105;7;4;11
96;19.06.2016;2016;06;15;Sunnuntai;56;49;105;6;9;15
96;19.06.2016;2016;06;16;Sunnuntai;37;27;64;9;4;13
96;19.06.2016;2016;06;17;Sunnuntai;30;22;52;11;3;14
96;19.06.2016;2016;06;18;Sunnuntai;31;23;54;3;11;14
96;19.06.2016;2016;06;19;Sunnuntai;7;13;20;7;2;9
96;19.06.2016;2016;06;20;Sunnuntai;23;18;41;5;8;13
96;19.06.2016;2016;06;21;Sunnuntai;14;21;35;3;3;6
96;19.06.2016;2016;06;22;Sunnuntai;7;7;14;3;3;6
96;19.06.2016;2016;06;23;Sunnuntai;7;2;9;1;3;4
96;20.06.2016;2016;06;00;Maanantai;0;4;4;0;2;2
96;20.06.2016;2016;06;01;Maanantai;2;6;8;2;0;2
96;20.06.2016;2016;06;02;Maanantai;2;2;4;0;0;0
96;20.06.2016;2016;06;03;Maanantai;1;2;3;0;0;0
96;20.06.2016;2016;06;04;Maanantai;2;0;2;1;1;2
96;20.06.2016;2016;06;05;Maanantai;10;6;16;1;0;1
96;20.06.2016;2016;06;06;Maanantai;55;24;79;2;1;3
96;20.06.2016;2016;06;07;Maanantai;76;85;161;7;2;9
96;20.06.2016;2016;06;08;Maanantai;47;91;138;5;7;12
96;20.06.2016;2016;06;09;Maanantai;39;67;106;7;5;12
96;20.06.2016;2016;06;10;Maanantai;32;54;86;6;8;14
96;20.06.2016;2016;06;11;Maanantai;55;58;113;14;4;18
96;20.06.2016;2016;06;12;Maanantai;49;57;106;19;10;29
96;20.06.2016;2016;06;13;Maanantai;66;53;119;11;11;22
96;20.06.2016;2016;06;14;Maanantai;80;97;177;17;11;28
96;20.06.2016;2016;06;15;Maanantai;101;124;225;4;16;20
96;20.06.2016;2016;06;16;Maanantai;118;131;249;21;17;38
96;20.06.2016;2016;06;17;Maanantai;61;78;139;12;12;24
96;20.06.2016;2016;06;18;Maanantai;73;61;134;16;9;25
96;20.06.2016;2016;06;19;Maanantai;78;49;127;10;6;16
96;20.06.2016;2016;06;20;Maanantai;61;26;87;9;13;22
96;20.06.2016;2016;06;21;Maanantai;24;46;70;11;8;19
96;20.06.2016;2016;06;22;Maanantai;15;13;28;3;4;7
96;20.06.2016;2016;06;23;Maanantai;14;9;23;3;4;7
96;21.06.2016;2016;06;00;Tiistai;11;7;18;1;2;3
96;21.06.2016;2016;06;01;Tiistai;5;2;7;0;1;1
96;21.06.2016;2016;06;02;Tiistai;1;0;1;0;0;0
96;21.06.2016;2016;06;03;Tiistai;2;0;2;0;0;0
96;21.06.2016;2016;06;04;Tiistai;1;2;3;0;0;0
96;21.06.2016;2016;06;05;Tiistai;7;10;17;0;0;0
96;21.06.2016;2016;06;06;Tiistai;65;33;98;2;2;4
96;21.06.2016;2016;06;07;Tiistai;84;85;169;9;10;19
96;21.06.2016;2016;06;08;Tiistai;57;117;174;10;6;16
96;21.06.2016;2016;06;09;Tiistai;42;69;111;8;6;14
96;21.06.2016;2016;06;10;Tiistai;32;50;82;4;10;14
96;21.06.2016;2016;06;11;Tiistai;40;34;74;5;8;13
96;21.06.2016;2016;06;12;Tiistai;50;46;96;3;9;12
96;21.06.2016;2016;06;13;Tiistai;55;62;117;8;7;15
96;21.06.2016;2016;06;14;Tiistai;82;90;172;3;6;9
96;21.06.2016;2016;06;15;Tiistai;103;156;259;5;19;24
96;21.06.2016;2016;06;16;Tiistai;112;121;233;7;13;20
96;21.06.2016;2016;06;17;Tiistai;95;77;172;13;4;17
96;21.06.2016;2016;06;18;Tiistai;94;61;155;13;8;21
96;21.06.2016;2016;06;19;Tiistai;80;30;110;12;5;17
96;21.06.2016;2016;06;20;Tiistai;43;39;82;8;10;18
96;21.06.2016;2016;06;21;Tiistai;32;29;61;1;1;2
96;21.06.2016;2016;06;22;Tiistai;23;11;34;1;4;5
96;21.06.2016;2016;06;23;Tiistai;10;8;18;3;4;7
96;22.06.2016;2016;06;00;Keskiviikko;3;4;7;1;1;2
96;22.06.2016;2016;06;01;Keskiviikko;9;3;12;2;0;2
96;22.06.2016;2016;06;02;Keskiviikko;0;1;1;0;0;0
96;22.06.2016;2016;06;03;Keskiviikko;0;0;0;0;0;0
96;22.06.2016;2016;06;04;Keskiviikko;3;2;5;0;0;0
96;22.06.2016;2016;06;05;Keskiviikko;7;10;17;1;0;1
96;22.06.2016;2016;06;06;Keskiviikko;53;38;91;2;0;2
96;22.06.2016;2016;06;07;Keskiviikko;86;81;167;7;1;8
96;22.06.2016;2016;06;08;Keskiviikko;48;105;153;5;7;12
96;22.06.2016;2016;06;09;Keskiviikko;32;58;90;4;3;7
96;22.06.2016;2016;06;10;Keskiviikko;38;64;102;7;7;14
96;22.06.2016;2016;06;11;Keskiviikko;41;62;103;8;4;12
96;22.06.2016;2016;06;12;Keskiviikko;69;60;129;8;8;16
96;22.06.2016;2016;06;13;Keskiviikko;64;65;129;8;6;14
96;22.06.2016;2016;06;14;Keskiviikko;85;86;171;8;7;15
96;22.06.2016;2016;06;15;Keskiviikko;79;158;237;10;27;37
96;22.06.2016;2016;06;16;Keskiviikko;122;123;245;8;14;22
96;22.06.2016;2016;06;17;Keskiviikko;99;58;157;9;8;17
96;22.06.2016;2016;06;18;Keskiviikko;79;47;126;15;10;25
96;22.06.2016;2016;06;19;Keskiviikko;84;45;129;12;9;21
96;22.06.2016;2016;06;20;Keskiviikko;48;38;86;6;5;11
96;22.06.2016;2016;06;21;Keskiviikko;35;44;79;4;9;13
96;22.06.2016;2016;06;22;Keskiviikko;16;21;37;1;6;7
96;22.06.2016;2016;06;23;Keskiviikko;14;12;26;2;3;5
96;23.06.2016;2016;06;00;Torstai;7;1;8;2;3;5
96;23.06.2016;2016;06;01;Torstai;6;3;9;2;0;2
96;23.06.2016;2016;06;02;Torstai;3;1;4;0;0;0
96;23.06.2016;2016;06;03;Torstai;2;1;3;1;0;1
96;23.06.2016;2016;06;04;Torstai;1;1;2;0;2;2
96;23.06.2016;2016;06;05;Torstai;9;6;15;2;0;2
96;23.06.2016;2016;06;06;Torstai;57;33;90;3;4;7
96;23.06.2016;2016;06;07;Torstai;86;63;149;11;8;19
96;23.06.2016;2016;06;08;Torstai;41;87;128;4;6;10
96;23.06.2016;2016;06;09;Torstai;39;52;91;5;4;9
96;23.06.2016;2016;06;10;Torstai;33;36;69;3;11;14
96;23.06.2016;2016;06;11;Torstai;56;56;112;4;6;10
96;23.06.2016;2016;06;12;Torstai;64;61;125;3;3;6
96;23.06.2016;2016;06;13;Torstai;69;84;153;7;7;14
96;23.06.2016;2016;06;14;Torstai;105;128;233;7;20;27
96;23.06.2016;2016;06;15;Torstai;98;109;207;4;18;22
96;23.06.2016;2016;06;16;Torstai;69;81;150;5;7;12
96;23.06.2016;2016;06;17;Torstai;62;55;117;9;9;18
96;23.06.2016;2016;06;18;Torstai;51;50;101;3;4;7
96;23.06.2016;2016;06;19;Torstai;55;80;135;4;5;9
96;23.06.2016;2016;06;20;Torstai;47;24;71;3;5;8
96;23.06.2016;2016;06;21;Torstai;31;24;55;2;4;6
96;23.06.2016;2016;06;22;Torstai;15;28;43;3;1;4
96;23.06.2016;2016;06;23;Torstai;11;6;17;1;0;1
96;24.06.2016;2016;06;00;Perjantai;17;25;42;1;2;3
96;24.06.2016;2016;06;01;Perjantai;12;6;18;0;0;0
96;24.06.2016;2016;06;02;Perjantai;3;2;5;1;2;3
96;24.06.2016;2016;06;03;Perjantai;15;5;20;2;0;2
96;24.06.2016;2016;06;04;Perjantai;5;0;5;1;2;3
96;24.06.2016;2016;06;05;Perjantai;1;4;5;0;0;0
96;24.06.2016;2016;06;06;Perjantai;11;11;22;3;1;4
96;24.06.2016;2016;06;07;Perjantai;4;22;26;0;3;3
96;24.06.2016;2016;06;08;Perjantai;15;20;35;1;4;5
96;24.06.2016;2016;06;09;Perjantai;22;15;37;1;3;4
96;24.06.2016;2016;06;10;Perjantai;18;24;42;2;9;11
96;24.06.2016;2016;06;11;Perjantai;36;42;78;5;6;11
96;24.06.2016;2016;06;12;Perjantai;39;45;84;11;11;22
96;24.06.2016;2016;06;13;Perjantai;55;34;89;5;6;11
96;24.06.2016;2016;06;14;Perjantai;36;46;82;9;2;11
96;24.06.2016;2016;06;15;Perjantai;35;32;67;2;3;5
96;24.06.2016;2016;06;16;Perjantai;38;28;66;1;0;1
96;24.06.2016;2016;06;17;Perjantai;35;20;55;3;2;5
96;24.06.2016;2016;06;18;Perjantai;44;32;76;3;4;7
96;24.06.2016;2016;06;19;Perjantai;35;20;55;6;0;6
96;24.06.2016;2016;06;20;Perjantai;28;29;57;4;3;7
96;24.06.2016;2016;06;21;Perjantai;30;34;64;6;6;12
96;24.06.2016;2016;06;22;Perjantai;19;16;35;7;4;11
96;24.06.2016;2016;06;23;Perjantai;24;15;39;0;0;0
96;25.06.2016;2016;06;00;Lauantai;21;13;34;1;1;2
96;25.06.2016;2016;06;01;Lauantai;13;11;24;1;1;2
96;25.06.2016;2016;06;02;Lauantai;9;6;15;3;1;4
96;25.06.2016;2016;06;03;Lauantai;17;7;24;1;0;1
96;25.06.2016;2016;06;04;Lauantai;23;3;26;1;0;1
96;25.06.2016;2016;06;05;Lauantai;7;1;8;2;2;4
96;25.06.2016;2016;06;06;Lauantai;14;9;23;1;0;1
96;25.06.2016;2016;06;07;Lauantai;2;14;16;4;2;6
96;25.06.2016;2016;06;08;Lauantai;5;7;12;3;4;7
96;25.06.2016;2016;06;09;Lauantai;18;11;29;4;3;7
96;25.06.2016;2016;06;10;Lauantai;12;20;32;1;2;3
96;25.06.2016;2016;06;11;Lauantai;28;21;49;3;4;7
96;25.06.2016;2016;06;12;Lauantai;12;8;20;1;3;4
96;25.06.2016;2016;06;13;Lauantai;11;6;17;0;1;1
96;25.06.2016;2016;06;14;Lauantai;9;8;17;2;1;3
96;25.06.2016;2016;06;15;Lauantai;9;15;24;3;3;6
96;25.06.2016;2016;06;16;Lauantai;8;15;23;5;7;12
96;25.06.2016;2016;06;17;Lauantai;21;22;43;8;3;11
96;25.06.2016;2016;06;18;Lauantai;11;26;37;7;6;13
96;25.06.2016;2016;06;19;Lauantai;28;24;52;4;8;12
96;25.06.2016;2016;06;20;Lauantai;35;22;57;6;3;9
96;25.06.2016;2016;06;21;Lauantai;23;12;35;3;2;5
96;25.06.2016;2016;06;22;Lauantai;23;16;39;4;1;5
96;25.06.2016;2016;06;23;Lauantai;8;19;27;1;1;2
96;26.06.2016;2016;06;00;Sunnuntai;8;7;15;0;2;2
96;26.06.2016;2016;06;01;Sunnuntai;8;2;10;0;2;2
96;26.06.2016;2016;06;02;Sunnuntai;11;3;14;1;0;1
96;26.06.2016;2016;06;03;Sunnuntai;9;1;10;1;0;1
96;26.06.2016;2016;06;04;Sunnuntai;8;1;9;1;0;1
96;26.06.2016;2016;06;05;Sunnuntai;7;1;8;1;1;2
96;26.06.2016;2016;06;06;Sunnuntai;14;5;19;2;1;3
96;26.06.2016;2016;06;07;Sunnuntai;6;15;21;4;5;9
96;26.06.2016;2016;06;08;Sunnuntai;5;12;17;3;4;7
96;26.06.2016;2016;06;09;Sunnuntai;10;12;22;1;1;2
96;26.06.2016;2016;06;10;Sunnuntai;12;14;26;1;2;3
96;26.06.2016;2016;06;11;Sunnuntai;18;16;34;5;5;10
96;26.06.2016;2016;06;12;Sunnuntai;31;48;79;2;5;7
96;26.06.2016;2016;06;13;Sunnuntai;58;44;102;8;7;15
96;26.06.2016;2016;06;14;Sunnuntai;42;43;85;7;10;17
96;26.06.2016;2016;06;15;Sunnuntai;41;45;86;3;4;7
96;26.06.2016;2016;06;16;Sunnuntai;49;45;94;8;4;12
96;26.06.2016;2016;06;17;Sunnuntai;42;36;78;15;10;25
96;26.06.2016;2016;06;18;Sunnuntai;40;41;81;7;8;15
96;26.06.2016;2016;06;19;Sunnuntai;35;54;89;7;7;14
96;26.06.2016;2016;06;20;Sunnuntai;40;32;72;9;13;22
96;26.06.2016;2016;06;21;Sunnuntai;28;29;57;9;6;15
96;26.06.2016;2016;06;22;Sunnuntai;21;20;41;0;5;5
96;26.06.2016;2016;06;23;Sunnuntai;15;7;22;1;1;2
96;27.06.2016;2016;06;00;Maanantai;7;2;9;2;2;4
96;27.06.2016;2016;06;01;Maanantai;1;7;8;1;0;1
96;27.06.2016;2016;06;02;Maanantai;9;3;12;0;0;0
96;27.06.2016;2016;06;03;Maanantai;4;4;8;0;0;0
96;27.06.2016;2016;06;04;Maanantai;3;3;6;0;0;0
96;27.06.2016;2016;06;05;Maanantai;8;2;10;0;0;0
96;27.06.2016;2016;06;06;Maanantai;61;28;89;3;4;7
96;27.06.2016;2016;06;07;Maanantai;92;103;195;12;2;14
96;27.06.2016;2016;06;08;Maanantai;42;91;133;2;4;6
96;27.06.2016;2016;06;09;Maanantai;49;50;99;5;4;9
96;27.06.2016;2016;06;10;Maanantai;28;54;82;4;15;19
96;27.06.2016;2016;06;11;Maanantai;47;51;98;11;4;15
96;27.06.2016;2016;06;12;Maanantai;68;80;148;7;8;15
96;27.06.2016;2016;06;13;Maanantai;70;73;143;6;9;15
96;27.06.2016;2016;06;14;Maanantai;77;100;177;8;10;18
96;27.06.2016;2016;06;15;Maanantai;109;162;271;4;10;14
96;27.06.2016;2016;06;16;Maanantai;115;107;222;8;7;15
96;27.06.2016;2016;06;17;Maanantai;92;54;146;5;5;10
96;27.06.2016;2016;06;18;Maanantai;61;55;116;3;6;9
96;27.06.2016;2016;06;19;Maanantai;51;45;96;6;8;14
96;27.06.2016;2016;06;20;Maanantai;51;18;69;8;6;14
96;27.06.2016;2016;06;21;Maanantai;28;37;65;3;7;10
96;27.06.2016;2016;06;22;Maanantai;14;16;30;3;3;6
96;27.06.2016;2016;06;23;Maanantai;10;8;18;1;2;3
96;28.06.2016;2016;06;00;Tiistai;6;3;9;0;0;0
96;28.06.2016;2016;06;01;Tiistai;2;1;3;1;0;1
96;28.06.2016;2016;06;02;Tiistai;7;3;10;0;0;0
96;28.06.2016;2016;06;03;Tiistai;3;0;3;0;0;0
96;28.06.2016;2016;06;04;Tiistai;2;2;4;0;0;0
96;28.06.2016;2016;06;05;Tiistai;9;9;18;0;2;2
96;28.06.2016;2016;06;06;Tiistai;55;28;83;4;0;4
96;28.06.2016;2016;06;07;Tiistai;85;51;136;8;1;9
96;28.06.2016;2016;06;08;Tiistai;21;36;57;1;2;3
96;28.06.2016;2016;06;09;Tiistai;17;25;42;5;4;9
96;28.06.2016;2016;06;10;Tiistai;13;26;39;2;6;8
96;28.06.2016;2016;06;11;Tiistai;29;32;61;4;5;9
96;28.06.2016;2016;06;12;Tiistai;43;45;88;8;9;17
96;28.06.2016;2016;06;13;Tiistai;38;51;89;6;9;15
96;28.06.2016;2016;06;14;Tiistai;32;82;114;4;7;11
96;28.06.2016;2016;06;15;Tiistai;70;118;188;7;17;24
96;28.06.2016;2016;06;16;Tiistai;62;89;151;8;7;15
96;28.06.2016;2016;06;17;Tiistai;74;57;131;7;2;9
96;28.06.2016;2016;06;18;Tiistai;49;69;118;5;6;11
96;28.06.2016;2016;06;19;Tiistai;57;41;98;6;5;11
96;28.06.2016;2016;06;20;Tiistai;61;35;96;11;7;18
96;28.06.2016;2016;06;21;Tiistai;28;26;54;6;6;12
96;28.06.2016;2016;06;22;Tiistai;9;9;18;0;3;3
96;28.06.2016;2016;06;23;Tiistai;5;9;14;3;3;6
96;29.06.2016;2016;06;00;Keskiviikko;8;9;17;0;0;0
96;29.06.2016;2016;06;01;Keskiviikko;9;2;11;1;0;1
96;29.06.2016;2016;06;02;Keskiviikko;2;1;3;0;0;0
96;29.06.2016;2016;06;03;Keskiviikko;1;2;3;0;0;0
96;29.06.2016;2016;06;04;Keskiviikko;6;1;7;1;0;1
96;29.06.2016;2016;06;05;Keskiviikko;11;10;21;1;2;3
96;29.06.2016;2016;06;06;Keskiviikko;69;37;106;3;0;3
96;29.06.2016;2016;06;07;Keskiviikko;77;102;179;10;9;19
96;29.06.2016;2016;06;08;Keskiviikko;46;72;118;7;8;15
96;29.06.2016;2016;06;09;Keskiviikko;16;50;66;5;8;13
96;29.06.2016;2016;06;10;Keskiviikko;21;61;82;6;8;14
96;29.06.2016;2016;06;11;Keskiviikko;49;62;111;6;8;14
96;29.06.2016;2016;06;12;Keskiviikko;57;56;113;2;2;4
96;29.06.2016;2016;06;13;Keskiviikko;71;89;160;4;2;6
96;29.06.2016;2016;06;14;Keskiviikko;64;106;170;1;10;11
96;29.06.2016;2016;06;15;Keskiviikko;107;172;279;7;16;23
96;29.06.2016;2016;06;16;Keskiviikko;83;72;155;4;9;13
96;29.06.2016;2016;06;17;Keskiviikko;69;37;106;9;4;13
96;29.06.2016;2016;06;18;Keskiviikko;51;43;94;10;6;16
96;29.06.2016;2016;06;19;Keskiviikko;51;31;82;5;4;9
96;29.06.2016;2016;06;20;Keskiviikko;33;27;60;7;8;15
96;29.06.2016;2016;06;21;Keskiviikko;33;39;72;5;8;13
96;29.06.2016;2016;06;22;Keskiviikko;22;15;37;2;0;2
96;29.06.2016;2016;06;23;Keskiviikko;9;13;22;3;2;5
96;30.06.2016;2016;06;00;Torstai;10;3;13;1;2;3
96;30.06.2016;2016;06;01;Torstai;13;0;13;0;0;0
96;30.06.2016;2016;06;02;Torstai;9;5;14;2;0;2
96;30.06.2016;2016;06;03;Torstai;7;0;7;1;0;1
96;30.06.2016;2016;06;04;Torstai;3;2;5;1;0;1
96;30.06.2016;2016;06;05;Torstai;6;10;16;1;0;1
96;30.06.2016;2016;06;06;Torstai;62;37;99;4;1;5
96;30.06.2016;2016;06;07;Torstai;80;75;155;10;2;12
96;30.06.2016;2016;06;08;Torstai;42;63;105;2;5;7
96;30.06.2016;2016;06;09;Torstai;45;39;84;5;6;11
96;30.06.2016;2016;06;10;Torstai;38;57;95;4;8;12
96;30.06.2016;2016;06;11;Torstai;58;58;116;3;5;8
96;30.06.2016;2016;06;12;Torstai;76;54;130;5;7;12
96;30.06.2016;2016;06;13;Torstai;55;61;116;2;10;12
96;30.06.2016;2016;06;14;Torstai;77;101;178;5;12;17
96;30.06.2016;2016;06;15;Torstai;90;100;190;6;12;18
96;30.06.2016;2016;06;16;Torstai;39;40;79;1;7;8
96;30.06.2016;2016;06;17;Torstai;48;33;81;5;3;8
96;30.06.2016;2016;06;18;Torstai;38;31;69;7;6;13
96;30.06.2016;2016;06;19;Torstai;26;27;53;8;3;11
96;30.06.2016;2016;06;20;Torstai;26;26;52;9;10;19
96;30.06.2016;2016;06;21;Torstai;30;42;72;1;6;7
96;30.06.2016;2016;06;22;Torstai;16;9;25;2;1;3
96;30.06.2016;2016;06;23;Torstai;9;7;16;0;0;0
96;01.07.2016;2016;07;00;Perjantai;5;3;8;0;1;1
96;01.07.2016;2016;07;01;Perjantai;9;5;14;0;0;0
96;01.07.2016;2016;07;02;Perjantai;4;2;6;1;0;1
96;01.07.2016;2016;07;03;Perjantai;1;1;2;0;0;0
96;01.07.2016;2016;07;04;Perjantai;4;3;7;0;0;0
96;01.07.2016;2016;07;05;Perjantai;7;9;16;0;0;0
96;01.07.2016;2016;07;06;Perjantai;49;39;88;1;0;1
96;01.07.2016;2016;07;07;Perjantai;63;70;133;9;6;15
96;01.07.2016;2016;07;08;Perjantai;26;50;76;4;3;7
96;01.07.2016;2016;07;09;Perjantai;33;48;81;2;4;6
96;01.07.2016;2016;07;10;Perjantai;28;36;64;2;7;9
96;01.07.2016;2016;07;11;Perjantai;37;37;74;9;2;11
96;01.07.2016;2016;07;12;Perjantai;41;46;87;3;4;7
96;01.07.2016;2016;07;13;Perjantai;55;57;112;1;2;3
96;01.07.2016;2016;07;14;Perjantai;47;74;121;0;5;5
96;01.07.2016;2016;07;15;Perjantai;57;97;154;4;8;12
96;01.07.2016;2016;07;16;Perjantai;47;38;85;5;2;7
96;01.07.2016;2016;07;17;Perjantai;43;32;75;7;4;11
96;01.07.2016;2016;07;18;Perjantai;45;29;74;10;4;14
96;01.07.2016;2016;07;19;Perjantai;33;29;62;5;5;10
96;01.07.2016;2016;07;20;Perjantai;23;46;69;7;5;12
96;01.07.2016;2016;07;21;Perjantai;17;33;50;1;3;4
96;01.07.2016;2016;07;22;Perjantai;17;18;35;3;2;5
96;01.07.2016;2016;07;23;Perjantai;9;12;21;0;3;3
96;02.07.2016;2016;07;00;Lauantai;13;6;19;2;0;2
96;02.07.2016;2016;07;01;Lauantai;9;5;14;1;0;1
96;02.07.2016;2016;07;02;Lauantai;3;3;6;2;0;2
96;02.07.2016;2016;07;03;Lauantai;11;0;11;4;0;4
96;02.07.2016;2016;07;04;Lauantai;5;4;9;3;4;7
96;02.07.2016;2016;07;05;Lauantai;5;2;7;3;1;4
96;02.07.2016;2016;07;06;Lauantai;18;9;27;1;2;3
96;02.07.2016;2016;07;07;Lauantai;3;18;21;1;3;4
96;02.07.2016;2016;07;08;Lauantai;12;12;24;2;2;4
96;02.07.2016;2016;07;09;Lauantai;8;34;42;3;4;7
96;02.07.2016;2016;07;10;Lauantai;29;39;68;2;3;5
96;02.07.2016;2016;07;11;Lauantai;51;49;100;4;4;8
96;02.07.2016;2016;07;12;Lauantai;63;64;127;7;4;11
96;02.07.2016;2016;07;13;Lauantai;67;58;125;5;4;9
96;02.07.2016;2016;07;14;Lauantai;56;62;118;2;2;4
96;02.07.2016;2016;07;15;Lauantai;42;62;104;5;5;10
96;02.07.2016;2016;07;16;Lauantai;53;37;90;5;3;8
96;02.07.2016;2016;07;17;Lauantai;47;34;81;2;6;8
96;02.07.2016;2016;07;18;Lauantai;14;21;35;4;1;5
96;02.07.2016;2016;07;19;Lauantai;31;24;55;5;6;11
96;02.07.2016;2016;07;20;Lauantai;28;40;68;4;3;7
96;02.07.2016;2016;07;21;Lauantai;26;51;77;8;6;14
96;02.07.2016;2016;07;22;Lauantai;17;19;36;3;3;6
96;02.07.2016;2016;07;23;Lauantai;13;9;22;2;3;5
96;03.07.2016;2016;07;00;Sunnuntai;20;13;33;3;4;7
96;03.07.2016;2016;07;01;Sunnuntai;21;12;33;6;5;11
96;03.07.2016;2016;07;02;Sunnuntai;14;4;18;1;0;1
96;03.07.2016;2016;07;03;Sunnuntai;14;6;20;3;1;4
96;03.07.2016;2016;07;04;Sunnuntai;16;2;18;1;1;2
96;03.07.2016;2016;07;05;Sunnuntai;8;0;8;1;0;1
96;03.07.2016;2016;07;06;Sunnuntai;11;10;21;1;0;1
96;03.07.2016;2016;07;07;Sunnuntai;6;13;19;3;3;6
96;03.07.2016;2016;07;08;Sunnuntai;8;9;17;2;1;3
96;03.07.2016;2016;07;09;Sunnuntai;7;4;11;1;1;2
96;03.07.2016;2016;07;10;Sunnuntai;5;6;11;2;7;9
96;03.07.2016;2016;07;11;Sunnuntai;8;15;23;1;5;6
96;03.07.2016;2016;07;12;Sunnuntai;11;15;26;3;3;6
96;03.07.2016;2016;07;13;Sunnuntai;9;21;30;0;2;2
96;03.07.2016;2016;07;14;Sunnuntai;22;26;48;8;6;14
96;03.07.2016;2016;07;15;Sunnuntai;22;39;61;6;1;7
96;03.07.2016;2016;07;16;Sunnuntai;36;37;73;5;5;10
96;03.07.2016;2016;07;17;Sunnuntai;58;29;87;3;4;7
96;03.07.2016;2016;07;18;Sunnuntai;52;41;93;9;3;12
96;03.07.2016;2016;07;19;Sunnuntai;46;37;83;7;3;10
96;03.07.2016;2016;07;20;Sunnuntai;42;29;71;1;5;6
96;03.07.2016;2016;07;21;Sunnuntai;8;26;34;5;7;12
96;03.07.2016;2016;07;22;Sunnuntai;5;6;11;0;1;1
96;03.07.2016;2016;07;23;Sunnuntai;3;5;8;0;1;1
96;04.07.2016;2016;07;00;Maanantai;7;3;10;1;0;1
96;04.07.2016;2016;07;01;Maanantai;3;0;3;0;1;1
96;04.07.2016;2016;07;02;Maanantai;3;5;8;0;0;0
96;04.07.2016;2016;07;03;Maanantai;1;0;1;1;0;1
96;04.07.2016;2016;07;04;Maanantai;4;0;4;0;0;0
96;04.07.2016;2016;07;05;Maanantai;9;8;17;1;0;1
96;04.07.2016;2016;07;06;Maanantai;59;21;80;3;4;7
96;04.07.2016;2016;07;07;Maanantai;64;62;126;5;5;10
96;04.07.2016;2016;07;08;Maanantai;34;49;83;6;2;8
96;04.07.2016;2016;07;09;Maanantai;23;44;67;2;7;9
96;04.07.2016;2016;07;10;Maanantai;18;31;49;3;1;4
96;04.07.2016;2016;07;11;Maanantai;27;34;61;5;4;9
96;04.07.2016;2016;07;12;Maanantai;32;22;54;4;9;13
96;04.07.2016;2016;07;13;Maanantai;33;25;58;4;4;8
96;04.07.2016;2016;07;14;Maanantai;36;54;90;2;4;6
96;04.07.2016;2016;07;15;Maanantai;48;111;159;2;12;14
96;04.07.2016;2016;07;16;Maanantai;46;67;113;1;4;5
96;04.07.2016;2016;07;17;Maanantai;36;33;69;4;2;6
96;04.07.2016;2016;07;18;Maanantai;38;33;71;4;2;6
96;04.07.2016;2016;07;19;Maanantai;41;25;66;11;5;16
96;04.07.2016;2016;07;20;Maanantai;36;17;53;2;8;10
96;04.07.2016;2016;07;21;Maanantai;9;19;28;0;4;4
96;04.07.2016;2016;07;22;Maanantai;7;7;14;1;0;1
96;04.07.2016;2016;07;23;Maanantai;5;2;7;1;0;1
96;05.07.2016;2016;07;00;Tiistai;2;2;4;0;0;0
96;05.07.2016;2016;07;01;Tiistai;0;0;0;0;0;0
96;05.07.2016;2016;07;02;Tiistai;1;0;1;0;0;0
96;05.07.2016;2016;07;03;Tiistai;2;2;4;2;0;2
96;05.07.2016;2016;07;04;Tiistai;3;0;3;0;0;0
96;05.07.2016;2016;07;05;Tiistai;5;5;10;0;0;0
96;05.07.2016;2016;07;06;Tiistai;59;32;91;0;2;2
96;05.07.2016;2016;07;07;Tiistai;65;50;115;9;3;12
96;05.07.2016;2016;07;08;Tiistai;19;43;62;5;1;6
96;05.07.2016;2016;07;09;Tiistai;19;28;47;2;2;4
96;05.07.2016;2016;07;10;Tiistai;18;24;42;2;3;5
96;05.07.2016;2016;07;11;Tiistai;21;26;47;4;4;8
96;05.07.2016;2016;07;12;Tiistai;36;51;87;3;8;11
96;05.07.2016;2016;07;13;Tiistai;41;49;90;10;13;23
96;05.07.2016;2016;07;14;Tiistai;51;83;134;4;7;11
96;05.07.2016;2016;07;15;Tiistai;51;95;146;4;9;13
96;05.07.2016;2016;07;16;Tiistai;30;33;63;3;7;10
96;05.07.2016;2016;07;17;Tiistai;17;14;31;0;1;1
96;05.07.2016;2016;07;18;Tiistai;28;17;45;3;2;5
96;05.07.2016;2016;07;19;Tiistai;20;22;42;1;3;4
96;05.07.2016;2016;07;20;Tiistai;21;27;48;10;6;16
96;05.07.2016;2016;07;21;Tiistai;12;23;35;5;7;12
96;05.07.2016;2016;07;22;Tiistai;5;7;12;0;1;1
96;05.07.2016;2016;07;23;Tiistai;5;3;8;1;3;4
96;06.07.2016;2016;07;00;Keskiviikko;3;2;5;1;0;1
96;06.07.2016;2016;07;01;Keskiviikko;4;2;6;0;0;0
96;06.07.2016;2016;07;02;Keskiviikko;1;0;1;0;0;0
96;06.07.2016;2016;07;03;Keskiviikko;1;0;1;0;0;0
96;06.07.2016;2016;07;04;Keskiviikko;3;2;5;0;1;1
96;06.07.2016;2016;07;05;Keskiviikko;15;4;19;0;0;0
96;06.07.2016;2016;07;06;Keskiviikko;55;31;86;4;0;4
96;06.07.2016;2016;07;07;Keskiviikko;53;26;79;11;6;17
96;06.07.2016;2016;07;08;Keskiviikko;12;29;41;6;2;8
96;06.07.2016;2016;07;09;Keskiviikko;11;16;27;2;2;4
96;06.07.2016;2016;07;10;Keskiviikko;13;28;41;2;5;7
96;06.07.2016;2016;07;11;Keskiviikko;22;34;56;7;4;11
96;06.07.2016;2016;07;12;Keskiviikko;39;50;89;8;3;11
96;06.07.2016;2016;07;13;Keskiviikko;60;59;119;6;7;13
96;06.07.2016;2016;07;14;Keskiviikko;71;74;145;4;17;21
96;06.07.2016;2016;07;15;Keskiviikko;54;68;122;1;9;10
96;06.07.2016;2016;07;16;Keskiviikko;59;70;129;11;11;22
96;06.07.2016;2016;07;17;Keskiviikko;68;42;110;6;7;13
96;06.07.2016;2016;07;18;Keskiviikko;27;11;38;2;2;4
96;06.07.2016;2016;07;19;Keskiviikko;21;19;40;2;2;4
96;06.07.2016;2016;07;20;Keskiviikko;42;15;57;9;15;24
96;06.07.2016;2016;07;21;Keskiviikko;23;40;63;2;7;9
96;06.07.2016;2016;07;22;Keskiviikko;10;10;20;2;3;5
96;06.07.2016;2016;07;23;Keskiviikko;2;8;10;4;3;7
96;07.07.2016;2016;07;00;Torstai;7;2;9;3;0;3
96;07.07.2016;2016;07;01;Torstai;2;6;8;0;3;3
96;07.07.2016;2016;07;02;Torstai;2;3;5;2;1;3
96;07.07.2016;2016;07;03;Torstai;6;3;9;0;0;0
96;07.07.2016;2016;07;04;Torstai;1;2;3;1;1;2
96;07.07.2016;2016;07;05;Torstai;12;6;18;1;0;1
96;07.07.2016;2016;07;06;Torstai;58;30;88;3;1;4
96;07.07.2016;2016;07;07;Torstai;58;75;133;5;2;7
96;07.07.2016;2016;07;08;Torstai;27;54;81;5;3;8
96;07.07.2016;2016;07;09;Torstai;11;16;27;5;7;12
96;07.07.2016;2016;07;10;Torstai;15;33;48;4;4;8
96;07.07.2016;2016;07;11;Torstai;23;17;40;1;0;1
96;07.07.2016;2016;07;12;Torstai;22;19;41;4;6;10
96;07.07.2016;2016;07;13;Torstai;24;49;73;2;3;5
96;07.07.2016;2016;07;14;Torstai;39;73;112;6;8;14
96;07.07.2016;2016;07;15;Torstai;40;104;144;4;13;17
96;07.07.2016;2016;07;16;Torstai;58;44;102;6;9;15
96;07.07.2016;2016;07;17;Torstai;43;40;83;2;2;4
96;07.07.2016;2016;07;18;Torstai;38;35;73;7;6;13
96;07.07.2016;2016;07;19;Torstai;37;23;60;4;4;8
96;07.07.2016;2016;07;20;Torstai;41;26;67;13;3;16
96;07.07.2016;2016;07;21;Torstai;34;29;63;4;5;9
96;07.07.2016;2016;07;22;Torstai;8;7;15;0;3;3
96;07.07.2016;2016;07;23;Torstai;4;10;14;0;2;2
96;08.07.2016;2016;07;00;Perjantai;13;3;16;1;1;2
96;08.07.2016;2016;07;01;Perjantai;4;3;7;1;0;1
96;08.07.2016;2016;07;02;Perjantai;3;2;5;1;0;1
96;08.07.2016;2016;07;03;Perjantai;6;2;8;0;0;0
96;08.07.2016;2016;07;04;Perjantai;1;3;4;0;0;0
96;08.07.2016;2016;07;05;Perjantai;13;6;19;0;0;0
96;08.07.2016;2016;07;06;Perjantai;59;33;92;5;1;6
96;08.07.2016;2016;07;07;Perjantai;49;51;100;5;3;8
96;08.07.2016;2016;07;08;Perjantai;31;42;73;3;6;9
96;08.07.2016;2016;07;09;Perjantai;23;44;67;1;6;7
96;08.07.2016;2016;07;10;Perjantai;28;62;90;4;4;8
96;08.07.2016;2016;07;11;Perjantai;40;37;77;6;5;11
96;08.07.2016;2016;07;12;Perjantai;55;67;122;5;6;11
96;08.07.2016;2016;07;13;Perjantai;66;75;141;6;6;12
96;08.07.2016;2016;07;14;Perjantai;63;113;176;4;5;9
96;08.07.2016;2016;07;15;Perjantai;57;81;138;4;9;13
96;08.07.2016;2016;07;16;Perjantai;61;56;117;13;9;22
96;08.07.2016;2016;07;17;Perjantai;53;57;110;30;11;41
96;08.07.2016;2016;07;18;Perjantai;50;58;108;10;5;15
96;08.07.2016;2016;07;19;Perjantai;53;30;83;10;4;14
96;08.07.2016;2016;07;20;Perjantai;39;36;75;5;6;11
96;08.07.2016;2016;07;21;Perjantai;38;35;73;1;3;4
96;08.07.2016;2016;07;22;Perjantai;18;23;41;0;0;0
96;08.07.2016;2016;07;23;Perjantai;21;15;36;2;4;6
96;09.07.2016;2016;07;00;Lauantai;15;8;23;4;2;6
96;09.07.2016;2016;07;01;Lauantai;13;8;21;4;1;5
96;09.07.2016;2016;07;02;Lauantai;20;2;22;1;0;1
96;09.07.2016;2016;07;03;Lauantai;12;3;15;2;0;2
96;09.07.2016;2016;07;04;Lauantai;19;6;25;4;0;4
96;09.07.2016;2016;07;05;Lauantai;4;4;8;1;1;2
96;09.07.2016;2016;07;06;Lauantai;23;16;39;4;1;5
96;09.07.2016;2016;07;07;Lauantai;7;17;24;3;2;5
96;09.07.2016;2016;07;08;Lauantai;6;14;20;1;2;3
96;09.07.2016;2016;07;09;Lauantai;15;29;44;3;2;5
96;09.07.2016;2016;07;10;Lauantai;14;20;34;1;2;3
96;09.07.2016;2016;07;11;Lauantai;19;47;66;4;6;10
96;09.07.2016;2016;07;12;Lauantai;32;46;78;8;8;16
96;09.07.2016;2016;07;13;Lauantai;58;44;102;4;2;6
96;09.07.2016;2016;07;14;Lauantai;51;66;117;2;4;6
96;09.07.2016;2016;07;15;Lauantai;43;59;102;8;5;13
96;09.07.2016;2016;07;16;Lauantai;34;55;89;6;2;8
96;09.07.2016;2016;07;17;Lauantai;51;26;77;8;5;13
96;09.07.2016;2016;07;18;Lauantai;39;41;80;5;3;8
96;09.07.2016;2016;07;19;Lauantai;31;37;68;1;7;8
96;09.07.2016;2016;07;20;Lauantai;33;27;60;3;2;5
96;09.07.2016;2016;07;21;Lauantai;20;25;45;4;6;10
96;09.07.2016;2016;07;22;Lauantai;9;13;22;0;2;2
96;09.07.2016;2016;07;23;Lauantai;19;21;40;0;0;0
96;10.07.2016;2016;07;00;Sunnuntai;15;6;21;3;1;4
96;10.07.2016;2016;07;01;Sunnuntai;17;4;21;1;0;1
96;10.07.2016;2016;07;02;Sunnuntai;12;4;16;2;0;2
96;10.07.2016;2016;07;03;Sunnuntai;29;3;32;3;1;4
96;10.07.2016;2016;07;04;Sunnuntai;13;0;13;5;0;5
96;10.07.2016;2016;07;05;Sunnuntai;7;2;9;0;1;1
96;10.07.2016;2016;07;06;Sunnuntai;18;5;23;1;1;2
96;10.07.2016;2016;07;07;Sunnuntai;8;14;22;0;0;0
96;10.07.2016;2016;07;08;Sunnuntai;5;7;12;2;3;5
96;10.07.2016;2016;07;09;Sunnuntai;18;20;38;2;2;4
96;10.07.2016;2016;07;10;Sunnuntai;19;25;44;1;5;6
96;10.07.2016;2016;07;11;Sunnuntai;26;54;80;5;6;11
96;10.07.2016;2016;07;12;Sunnuntai;33;29;62;6;5;11
96;10.07.2016;2016;07;13;Sunnuntai;40;46;86;7;6;13
96;10.07.2016;2016;07;14;Sunnuntai;36;54;90;5;16;21
96;10.07.2016;2016;07;15;Sunnuntai;49;62;111;10;8;18
96;10.07.2016;2016;07;16;Sunnuntai;86;76;162;19;11;30
96;10.07.2016;2016;07;17;Sunnuntai;72;41;113;26;13;39
96;10.07.2016;2016;07;18;Sunnuntai;59;46;105;11;12;23
96;10.07.2016;2016;07;19;Sunnuntai;88;47;135;9;13;22
96;10.07.2016;2016;07;20;Sunnuntai;59;33;92;11;9;20
96;10.07.2016;2016;07;21;Sunnuntai;21;30;51;2;4;6
96;10.07.2016;2016;07;22;Sunnuntai;15;10;25;3;3;6
96;10.07.2016;2016;07;23;Sunnuntai;7;4;11;2;3;5
96;11.07.2016;2016;07;00;Maanantai;14;4;18;1;0;1
96;11.07.2016;2016;07;01;Maanantai;12;5;17;1;0;1
96;11.07.2016;2016;07;02;Maanantai;12;1;13;2;0;2
96;11.07.2016;2016;07;03;Maanantai;0;2;2;0;1;1
96;11.07.2016;2016;07;04;Maanantai;5;5;10;0;2;2
96;11.07.2016;2016;07;05;Maanantai;13;4;17;0;2;2
96;11.07.2016;2016;07;06;Maanantai;60;21;81;5;2;7
96;11.07.2016;2016;07;07;Maanantai;66;75;141;12;4;16
96;11.07.2016;2016;07;08;Maanantai;37;53;90;3;5;8
96;11.07.2016;2016;07;09;Maanantai;28;48;76;8;9;17
96;11.07.2016;2016;07;10;Maanantai;37;64;101;3;9;12
96;11.07.2016;2016;07;11;Maanantai;52;55;107;5;8;13
96;11.07.2016;2016;07;12;Maanantai;75;81;156;7;8;15
96;11.07.2016;2016;07;13;Maanantai;73;66;139;7;8;15
96;11.07.2016;2016;07;14;Maanantai;64;106;170;7;14;21
96;11.07.2016;2016;07;15;Maanantai;97;123;220;8;22;30
96;11.07.2016;2016;07;16;Maanantai;113;85;198;12;14;26
96;11.07.2016;2016;07;17;Maanantai;96;67;163;15;5;20
96;11.07.2016;2016;07;18;Maanantai;88;48;136;14;7;21
96;11.07.2016;2016;07;19;Maanantai;71;37;108;10;8;18
96;11.07.2016;2016;07;20;Maanantai;65;48;113;6;3;9
96;11.07.2016;2016;07;21;Maanantai;42;46;88;4;10;14
96;11.07.2016;2016;07;22;Maanantai;13;19;32;0;2;2
96;11.07.2016;2016;07;23;Maanantai;14;5;19;2;3;5
96;12.07.2016;2016;07;00;Tiistai;9;5;14;5;2;7
96;12.07.2016;2016;07;01;Tiistai;8;3;11;0;0;0
96;12.07.2016;2016;07;02;Tiistai;3;4;7;1;0;1
96;12.07.2016;2016;07;03;Tiistai;6;1;7;0;0;0
96;12.07.2016;2016;07;04;Tiistai;2;8;10;1;2;3
96;12.07.2016;2016;07;05;Tiistai;12;7;19;1;0;1
96;12.07.2016;2016;07;06;Tiistai;66;21;87;2;1;3
96;12.07.2016;2016;07;07;Tiistai;63;76;139;10;5;15
96;12.07.2016;2016;07;08;Tiistai;45;59;104;6;10;16
96;12.07.2016;2016;07;09;Tiistai;30;46;76;7;13;20
96;12.07.2016;2016;07;10;Tiistai;43;55;98;6;6;12
96;12.07.2016;2016;07;11;Tiistai;46;62;108;7;9;16
96;12.07.2016;2016;07;12;Tiistai;72;78;150;11;7;18
96;12.07.2016;2016;07;13;Tiistai;90;66;156;11;6;17
96;12.07.2016;2016;07;14;Tiistai;80;114;194;4;12;16
96;12.07.2016;2016;07;15;Tiistai;118;130;248;8;21;29
96;12.07.2016;2016;07;16;Tiistai;94;72;166;5;8;13
96;12.07.2016;2016;07;17;Tiistai;73;55;128;8;1;9
96;12.07.2016;2016;07;18;Tiistai;47;43;90;5;6;11
96;12.07.2016;2016;07;19;Tiistai;66;43;109;13;7;20
96;12.07.2016;2016;07;20;Tiistai;63;39;102;7;15;22
96;12.07.2016;2016;07;21;Tiistai;41;29;70;1;5;6
96;12.07.2016;2016;07;22;Tiistai;21;16;37;0;3;3
96;12.07.2016;2016;07;23;Tiistai;14;8;22;2;3;5
96;13.07.2016;2016;07;00;Keskiviikko;9;3;12;5;2;7
96;13.07.2016;2016;07;01;Keskiviikko;9;2;11;3;0;3
96;13.07.2016;2016;07;02;Keskiviikko;1;3;4;1;1;2
96;13.07.2016;2016;07;03;Keskiviikko;1;1;2;1;0;1
96;13.07.2016;2016;07;04;Keskiviikko;3;6;9;0;1;1
96;13.07.2016;2016;07;05;Keskiviikko;12;12;24;3;0;3
96;13.07.2016;2016;07;06;Keskiviikko;54;30;84;3;3;6
96;13.07.2016;2016;07;07;Keskiviikko;68;74;142;8;3;11
96;13.07.2016;2016;07;08;Keskiviikko;36;53;89;4;5;9
96;13.07.2016;2016;07;09;Keskiviikko;18;49;67;7;4;11
96;13.07.2016;2016;07;10;Keskiviikko;23;28;51;8;6;14
96;13.07.2016;2016;07;11;Keskiviikko;39;53;92;4;9;13
96;13.07.2016;2016;07;12;Keskiviikko;65;61;126;5;9;14
96;13.07.2016;2016;07;13;Keskiviikko;76;76;152;6;15;21
96;13.07.2016;2016;07;14;Keskiviikko;87;100;187;10;17;27
96;13.07.2016;2016;07;15;Keskiviikko;108;126;234;9;25;34
96;13.07.2016;2016;07;16;Keskiviikko;92;105;197;10;11;21
96;13.07.2016;2016;07;17;Keskiviikko;68;78;146;11;11;22
96;13.07.2016;2016;07;18;Keskiviikko;95;61;156;7;7;14
96;13.07.2016;2016;07;19;Keskiviikko;77;62;139;11;3;14
96;13.07.2016;2016;07;20;Keskiviikko;73;40;113;1;6;7
96;13.07.2016;2016;07;21;Keskiviikko;59;50;109;0;5;5
96;13.07.2016;2016;07;22;Keskiviikko;31;19;50;2;1;3
96;13.07.2016;2016;07;23;Keskiviikko;15;7;22;0;1;1
96;14.07.2016;2016;07;00;Torstai;21;6;27;0;1;1
96;14.07.2016;2016;07;01;Torstai;11;10;21;3;1;4
96;14.07.2016;2016;07;02;Torstai;13;2;15;1;0;1
96;14.07.2016;2016;07;03;Torstai;5;6;11;2;0;2
96;14.07.2016;2016;07;04;Torstai;9;2;11;3;2;5
96;14.07.2016;2016;07;05;Torstai;12;10;22;0;1;1
96;14.07.2016;2016;07;06;Torstai;56;30;86;5;2;7
96;14.07.2016;2016;07;07;Torstai;73;62;135;14;6;20
96;14.07.2016;2016;07;08;Torstai;32;67;99;7;4;11
96;14.07.2016;2016;07;09;Torstai;44;45;89;9;6;15
96;14.07.2016;2016;07;10;Torstai;32;55;87;1;4;5
96;14.07.2016;2016;07;11;Torstai;44;70;114;7;11;18
96;14.07.2016;2016;07;12;Torstai;67;64;131;7;7;14
96;14.07.2016;2016;07;13;Torstai;60;84;144;10;7;17
96;14.07.2016;2016;07;14;Torstai;70;109;179;5;15;20
96;14.07.2016;2016;07;15;Torstai;93;126;219;4;11;15
96;14.07.2016;2016;07;16;Torstai;98;95;193;7;7;14
96;14.07.2016;2016;07;17;Torstai;73;68;141;5;5;10
96;14.07.2016;2016;07;18;Torstai;79;66;145;9;8;17
96;14.07.2016;2016;07;19;Torstai;61;50;111;7;5;12
96;14.07.2016;2016;07;20;Torstai;95;36;131;15;10;25
96;14.07.2016;2016;07;21;Torstai;47;33;80;2;6;8
96;14.07.2016;2016;07;22;Torstai;32;19;51;0;3;3
96;14.07.2016;2016;07;23;Torstai;18;12;30;0;1;1
96;15.07.2016;2016;07;00;Perjantai;37;5;42;2;1;3
96;15.07.2016;2016;07;01;Perjantai;16;2;18;2;0;2
96;15.07.2016;2016;07;02;Perjantai;9;5;14;2;0;2
96;15.07.2016;2016;07;03;Perjantai;5;1;6;2;1;3
96;15.07.2016;2016;07;04;Perjantai;9;3;12;0;1;1
96;15.07.2016;2016;07;05;Perjantai;7;6;13;1;0;1
96;15.07.2016;2016;07;06;Perjantai;53;17;70;4;2;6
96;15.07.2016;2016;07;07;Perjantai;57;55;112;8;8;16
96;15.07.2016;2016;07;08;Perjantai;32;55;87;4;3;7
96;15.07.2016;2016;07;09;Perjantai;22;49;71;2;1;3
96;15.07.2016;2016;07;10;Perjantai;30;37;67;1;8;9
96;15.07.2016;2016;07;11;Perjantai;33;50;83;1;3;4
96;15.07.2016;2016;07;12;Perjantai;48;58;106;7;9;16
96;15.07.2016;2016;07;13;Perjantai;72;76;148;9;6;15
96;15.07.2016;2016;07;14;Perjantai;62;87;149;5;6;11
96;15.07.2016;2016;07;15;Perjantai;46;79;125;3;8;11
96;15.07.2016;2016;07;16;Perjantai;54;68;122;2;1;3
96;15.07.2016;2016;07;17;Perjantai;51;66;117;3;4;7
96;15.07.2016;2016;07;18;Perjantai;38;38;76;3;6;9
96;15.07.2016;2016;07;19;Perjantai;40;47;87;7;6;13
96;15.07.2016;2016;07;20;Perjantai;71;59;130;6;4;10
96;15.07.2016;2016;07;21;Perjantai;34;29;63;2;5;7
96;15.07.2016;2016;07;22;Perjantai;27;19;46;0;1;1
96;15.07.2016;2016;07;23;Perjantai;26;9;35;0;0;0
96;16.07.2016;2016;07;00;Lauantai;30;14;44;0;2;2
96;16.07.2016;2016;07;01;Lauantai;9;3;12;1;4;5
96;16.07.2016;2016;07;02;Lauantai;14;8;22;1;1;2
96;16.07.2016;2016;07;03;Lauantai;15;4;19;1;0;1
96;16.07.2016;2016;07;04;Lauantai;15;2;17;2;0;2
96;16.07.2016;2016;07;05;Lauantai;5;1;6;0;0;0
96;16.07.2016;2016;07;06;Lauantai;23;11;34;2;1;3
96;16.07.2016;2016;07;07;Lauantai;6;15;21;1;3;4
96;16.07.2016;2016;07;08;Lauantai;8;9;17;0;1;1
96;16.07.2016;2016;07;09;Lauantai;7;15;22;0;6;6
96;16.07.2016;2016;07;10;Lauantai;12;16;28;1;3;4
96;16.07.2016;2016;07;11;Lauantai;26;27;53;2;6;8
96;16.07.2016;2016;07;12;Lauantai;23;26;49;6;5;11
96;16.07.2016;2016;07;13;Lauantai;24;23;47;4;3;7
96;16.07.2016;2016;07;14;Lauantai;8;27;35;2;1;3
96;16.07.2016;2016;07;15;Lauantai;32;38;70;1;4;5
96;16.07.2016;2016;07;16;Lauantai;28;10;38;3;4;7
96;16.07.2016;2016;07;17;Lauantai;22;30;52;3;7;10
96;16.07.2016;2016;07;18;Lauantai;17;26;43;4;7;11
96;16.07.2016;2016;07;19;Lauantai;25;49;74;8;8;16
96;16.07.2016;2016;07;20;Lauantai;36;40;76;5;7;12
96;16.07.2016;2016;07;21;Lauantai;25;39;64;5;3;8
96;16.07.2016;2016;07;22;Lauantai;16;20;36;3;3;6
96;16.07.2016;2016;07;23;Lauantai;18;19;37;1;3;4
96;17.07.2016;2016;07;00;Sunnuntai;15;16;31;1;0;1
96;17.07.2016;2016;07;01;Sunnuntai;12;13;25;1;4;5
96;17.07.2016;2016;07;02;Sunnuntai;17;3;20;1;3;4
96;17.07.2016;2016;07;03;Sunnuntai;35;2;37;3;0;3
96;17.07.2016;2016;07;04;Sunnuntai;19;5;24;3;1;4
96;17.07.2016;2016;07;05;Sunnuntai;8;3;11;6;1;7
96;17.07.2016;2016;07;06;Sunnuntai;18;6;24;3;0;3
96;17.07.2016;2016;07;07;Sunnuntai;3;7;10;2;5;7
96;17.07.2016;2016;07;08;Sunnuntai;7;4;11;2;3;5
96;17.07.2016;2016;07;09;Sunnuntai;12;16;28;3;6;9
96;17.07.2016;2016;07;10;Sunnuntai;4;13;17;5;4;9
96;17.07.2016;2016;07;11;Sunnuntai;20;33;53;7;5;12
96;17.07.2016;2016;07;12;Sunnuntai;32;36;68;3;8;11
96;17.07.2016;2016;07;13;Sunnuntai;29;26;55;2;5;7
96;17.07.2016;2016;07;14;Sunnuntai;16;39;55;3;4;7
96;17.07.2016;2016;07;15;Sunnuntai;21;21;42;5;3;8
96;17.07.2016;2016;07;16;Sunnuntai;22;13;35;7;5;12
96;17.07.2016;2016;07;17;Sunnuntai;32;24;56;10;6;16
96;17.07.2016;2016;07;18;Sunnuntai;35;37;72;13;3;16
96;17.07.2016;2016;07;19;Sunnuntai;29;40;69;13;11;24
96;17.07.2016;2016;07;20;Sunnuntai;44;34;78;4;5;9
96;17.07.2016;2016;07;21;Sunnuntai;20;31;51;5;1;6
96;17.07.2016;2016;07;22;Sunnuntai;11;18;29;3;2;5
96;17.07.2016;2016;07;23;Sunnuntai;13;14;27;3;3;6
96;18.07.2016;2016;07;00;Maanantai;6;3;9;1;1;2
96;18.07.2016;2016;07;01;Maanantai;5;2;7;2;2;4
96;18.07.2016;2016;07;02;Maanantai;5;5;10;0;0;0
96;18.07.2016;2016;07;03;Maanantai;2;1;3;0;1;1
96;18.07.2016;2016;07;04;Maanantai;6;1;7;2;1;3
96;18.07.2016;2016;07;05;Maanantai;5;7;12;0;0;0
96;18.07.2016;2016;07;06;Maanantai;68;30;98;5;2;7
96;18.07.2016;2016;07;07;Maanantai;70;49;119;10;5;15
96;18.07.2016;2016;07;08;Maanantai;23;51;74;1;9;10
96;18.07.2016;2016;07;09;Maanantai;32;55;87;14;8;22
96;18.07.2016;2016;07;10;Maanantai;40;54;94;10;13;23
96;18.07.2016;2016;07;11;Maanantai;43;61;104;8;12;20
96;18.07.2016;2016;07;12;Maanantai;69;60;129;9;7;16
96;18.07.2016;2016;07;13;Maanantai;84;86;170;7;8;15
96;18.07.2016;2016;07;14;Maanantai;76;104;180;8;8;16
96;18.07.2016;2016;07;15;Maanantai;79;118;197;5;21;26
96;18.07.2016;2016;07;16;Maanantai;100;89;189;14;9;23
96;18.07.2016;2016;07;17;Maanantai;83;63;146;14;7;21
96;18.07.2016;2016;07;18;Maanantai;77;47;124;14;7;21
96;18.07.2016;2016;07;19;Maanantai;64;68;132;19;19;38
96;18.07.2016;2016;07;20;Maanantai;66;49;115;12;13;25
96;18.07.2016;2016;07;21;Maanantai;39;49;88;5;6;11
96;18.07.2016;2016;07;22;Maanantai;18;17;35;4;5;9
96;18.07.2016;2016;07;23;Maanantai;9;8;17;2;0;2
96;19.07.2016;2016;07;00;Tiistai;12;6;18;2;1;3
96;19.07.2016;2016;07;01;Tiistai;9;1;10;1;0;1
96;19.07.2016;2016;07;02;Tiistai;3;2;5;1;3;4
96;19.07.2016;2016;07;03;Tiistai;1;0;1;0;0;0
96;19.07.2016;2016;07;04;Tiistai;1;6;7;0;0;0
96;19.07.2016;2016;07;05;Tiistai;13;6;19;0;0;0
96;19.07.2016;2016;07;06;Tiistai;67;27;94;6;3;9
96;19.07.2016;2016;07;07;Tiistai;68;63;131;13;7;20
96;19.07.2016;2016;07;08;Tiistai;37;60;97;13;11;24
96;19.07.2016;2016;07;09;Tiistai;32;65;97;11;13;24
96;19.07.2016;2016;07;10;Tiistai;32;48;80;9;15;24
96;19.07.2016;2016;07;11;Tiistai;44;53;97;31;23;54
96;19.07.2016;2016;07;12;Tiistai;56;38;94;24;29;53
96;19.07.2016;2016;07;13;Tiistai;58;56;114;29;30;59
96;19.07.2016;2016;07;14;Tiistai;35;33;68;37;104;141
96;19.07.2016;2016;07;15;Tiistai;47;54;101;38;129;167
96;19.07.2016;2016;07;16;Tiistai;101;102;203;7;11;18
96;19.07.2016;2016;07;17;Tiistai;67;61;128;21;14;35
96;19.07.2016;2016;07;18;Tiistai;75;59;134;19;15;34
96;19.07.2016;2016;07;19;Tiistai;66;45;111;17;19;36
96;19.07.2016;2016;07;20;Tiistai;54;35;89;8;8;16
96;19.07.2016;2016;07;21;Tiistai;44;23;67;9;9;18
96;19.07.2016;2016;07;22;Tiistai;30;9;39;4;5;9
96;19.07.2016;2016;07;23;Tiistai;10;6;16;2;2;4
96;20.07.2016;2016;07;00;Keskiviikko;9;4;13;1;3;4
96;20.07.2016;2016;07;01;Keskiviikko;1;2;3;0;0;0
96;20.07.2016;2016;07;02;Keskiviikko;6;4;10;2;0;2
96;20.07.2016;2016;07;03;Keskiviikko;4;2;6;1;0;1
96;20.07.2016;2016;07;04;Keskiviikko;5;4;9;0;1;1
96;20.07.2016;2016;07;05;Keskiviikko;9;12;21;1;0;1
96;20.07.2016;2016;07;06;Keskiviikko;60;35;95;26;5;31
96;20.07.2016;2016;07;07;Keskiviikko;70;62;132;12;6;18
96;20.07.2016;2016;07;08;Keskiviikko;24;57;81;9;9;18
96;20.07.2016;2016;07;09;Keskiviikko;20;33;53;34;29;63
96;20.07.2016;2016;07;10;Keskiviikko;16;10;26;81;121;202
96;20.07.2016;2016;07;11;Keskiviikko;42;50;92;41;46;87
96;20.07.2016;2016;07;12;Keskiviikko;87;77;164;27;32;59
96;20.07.2016;2016;07;13;Keskiviikko;89;74;163;11;36;47
96;20.07.2016;2016;07;14;Keskiviikko;67;106;173;27;148;175
96;20.07.2016;2016;07;15;Keskiviikko;100;158;258;41;204;245
96;20.07.2016;2016;07;16;Keskiviikko;84;108;192;41;80;121
96;20.07.2016;2016;07;17;Keskiviikko;87;76;163;15;29;44
96;20.07.2016;2016;07;18;Keskiviikko;104;57;161;27;35;62
96;20.07.2016;2016;07;19;Keskiviikko;74;55;129;45;51;96
96;20.07.2016;2016;07;20;Keskiviikko;67;48;115;18;31;49
96;20.07.2016;2016;07;21;Keskiviikko;62;34;96;9;10;19
96;20.07.2016;2016;07;22;Keskiviikko;37;19;56;7;3;10
96;20.07.2016;2016;07;23;Keskiviikko;21;13;34;4;1;5
96;21.07.2016;2016;07;00;Torstai;12;8;20;3;2;5
96;21.07.2016;2016;07;01;Torstai;10;0;10;0;0;0
96;21.07.2016;2016;07;02;Torstai;10;2;12;0;0;0
96;21.07.2016;2016;07;03;Torstai;7;1;8;0;1;1
96;21.07.2016;2016;07;04;Torstai;9;2;11;1;2;3
96;21.07.2016;2016;07;05;Torstai;15;9;24;1;1;2
96;21.07.2016;2016;07;06;Torstai;68;30;98;9;5;14
96;21.07.2016;2016;07;07;Torstai;71;60;131;10;4;14
96;21.07.2016;2016;07;08;Torstai;30;59;89;13;15;28
96;21.07.2016;2016;07;09;Torstai;32;35;67;5;18;23
96;21.07.2016;2016;07;10;Torstai;41;69;110;14;29;43
96;21.07.2016;2016;07;11;Torstai;49;63;112;19;29;48
96;21.07.2016;2016;07;12;Torstai;75;78;153;26;41;67
96;21.07.2016;2016;07;13;Torstai;83;74;157;20;33;53
96;21.07.2016;2016;07;14;Torstai;64;87;151;27;51;78
96;21.07.2016;2016;07;15;Torstai;99;125;224;38;45;83
96;21.07.2016;2016;07;16;Torstai;93;89;182;19;31;50
96;21.07.2016;2016;07;17;Torstai;83;68;151;10;11;21
96;21.07.2016;2016;07;18;Torstai;102;85;187;21;18;39
96;21.07.2016;2016;07;19;Torstai;90;63;153;10;13;23
96;21.07.2016;2016;07;20;Torstai;99;48;147;12;13;25
96;21.07.2016;2016;07;21;Torstai;47;49;96;5;7;12
96;21.07.2016;2016;07;22;Torstai;41;26;67;8;7;15
96;21.07.2016;2016;07;23;Torstai;37;8;45;6;2;8
96;22.07.2016;2016;07;00;Perjantai;11;2;13;0;0;0
96;22.07.2016;2016;07;01;Perjantai;21;0;21;1;1;2
96;22.07.2016;2016;07;02;Perjantai;13;0;13;2;0;2
96;22.07.2016;2016;07;03;Perjantai;4;3;7;2;0;2
96;22.07.2016;2016;07;04;Perjantai;4;2;6;1;1;2
96;22.07.2016;2016;07;05;Perjantai;3;9;12;2;1;3
96;22.07.2016;2016;07;06;Perjantai;58;24;82;5;2;7
96;22.07.2016;2016;07;07;Perjantai;58;71;129;7;3;10
96;22.07.2016;2016;07;08;Perjantai;32;56;88;9;7;16
96;22.07.2016;2016;07;09;Perjantai;23;50;73;6;18;24
96;22.07.2016;2016;07;10;Perjantai;34;52;86;5;14;19
96;22.07.2016;2016;07;11;Perjantai;55;65;120;8;14;22
96;22.07.2016;2016;07;12;Perjantai;68;77;145;7;21;28
96;22.07.2016;2016;07;13;Perjantai;63;86;149;7;14;21
96;22.07.2016;2016;07;14;Perjantai;89;121;210;12;18;30
96;22.07.2016;2016;07;15;Perjantai;97;108;205;9;18;27
96;22.07.2016;2016;07;16;Perjantai;86;84;170;13;12;25
96;22.07.2016;2016;07;17;Perjantai;84;67;151;12;9;21
96;22.07.2016;2016;07;18;Perjantai;63;55;118;6;16;22
96;22.07.2016;2016;07;19;Perjantai;49;43;92;9;8;17
96;22.07.2016;2016;07;20;Perjantai;68;48;116;8;7;15
96;22.07.2016;2016;07;21;Perjantai;67;66;133;2;8;10
96;22.07.2016;2016;07;22;Perjantai;39;24;63;4;5;9
96;22.07.2016;2016;07;23;Perjantai;48;17;65;5;0;5
96;23.07.2016;2016;07;00;Lauantai;37;9;46;0;1;1
96;23.07.2016;2016;07;01;Lauantai;22;4;26;1;0;1
96;23.07.2016;2016;07;02;Lauantai;16;4;20;1;0;1
96;23.07.2016;2016;07;03;Lauantai;27;3;30;3;0;3
96;23.07.2016;2016;07;04;Lauantai;26;2;28;4;0;4
96;23.07.2016;2016;07;05;Lauantai;11;5;16;2;0;2
96;23.07.2016;2016;07;06;Lauantai;20;8;28;0;0;0
96;23.07.2016;2016;07;07;Lauantai;8;19;27;1;4;5
96;23.07.2016;2016;07;08;Lauantai;11;21;32;3;6;9
96;23.07.2016;2016;07;09;Lauantai;13;43;56;5;4;9
96;23.07.2016;2016;07;10;Lauantai;22;53;75;7;8;15
96;23.07.2016;2016;07;11;Lauantai;42;77;119;12;5;17
96;23.07.2016;2016;07;12;Lauantai;65;74;139;5;16;21
96;23.07.2016;2016;07;13;Lauantai;66;82;148;6;14;20
96;23.07.2016;2016;07;14;Lauantai;81;79;160;8;11;19
96;23.07.2016;2016;07;15;Lauantai;69;78;147;9;4;13
96;23.07.2016;2016;07;16;Lauantai;67;78;145;6;4;10
96;23.07.2016;2016;07;17;Lauantai;57;50;107;6;7;13
96;23.07.2016;2016;07;18;Lauantai;67;56;123;3;5;8
96;23.07.2016;2016;07;19;Lauantai;36;42;78;5;6;11
96;23.07.2016;2016;07;20;Lauantai;53;46;99;6;2;8
96;23.07.2016;2016;07;21;Lauantai;55;40;95;2;6;8
96;23.07.2016;2016;07;22;Lauantai;31;34;65;3;2;5
96;23.07.2016;2016;07;23;Lauantai;24;14;38;8;4;12
96;24.07.2016;2016;07;00;Sunnuntai;25;14;39;7;4;11
96;24.07.2016;2016;07;01;Sunnuntai;23;3;26;2;0;2
96;24.07.2016;2016;07;02;Sunnuntai;28;6;34;1;1;2
96;24.07.2016;2016;07;03;Sunnuntai;25;4;29;3;0;3
96;24.07.2016;2016;07;04;Sunnuntai;15;1;16;3;2;5
96;24.07.2016;2016;07;05;Sunnuntai;9;1;10;1;0;1
96;24.07.2016;2016;07;06;Sunnuntai;37;8;45;1;3;4
96;24.07.2016;2016;07;07;Sunnuntai;8;10;18;2;3;5
96;24.07.2016;2016;07;08;Sunnuntai;6;20;26;7;4;11
96;24.07.2016;2016;07;09;Sunnuntai;10;16;26;6;10;16
96;24.07.2016;2016;07;10;Sunnuntai;26;41;67;3;10;13
96;24.07.2016;2016;07;11;Sunnuntai;45;57;102;2;8;10
96;24.07.2016;2016;07;12;Sunnuntai;33;48;81;4;3;7
96;24.07.2016;2016;07;13;Sunnuntai;54;66;120;7;13;20
96;24.07.2016;2016;07;14;Sunnuntai;59;56;115;10;38;48
96;24.07.2016;2016;07;15;Sunnuntai;47;63;110;12;8;20
96;24.07.2016;2016;07;16;Sunnuntai;80;48;128;12;11;23
96;24.07.2016;2016;07;17;Sunnuntai;75;63;138;10;12;22
96;24.07.2016;2016;07;18;Sunnuntai;83;102;185;7;13;20
96;24.07.2016;2016;07;19;Sunnuntai;83;57;140;3;7;10
96;24.07.2016;2016;07;20;Sunnuntai;48;40;88;16;8;24
96;24.07.2016;2016;07;21;Sunnuntai;103;40;143;9;9;18
96;24.07.2016;2016;07;22;Sunnuntai;17;29;46;4;5;9
96;24.07.2016;2016;07;23;Sunnuntai;28;7;35;3;1;4
96;25.07.2016;2016;07;00;Maanantai;14;7;21;3;0;3
96;25.07.2016;2016;07;01;Maanantai;8;2;10;3;3;6
96;25.07.2016;2016;07;02;Maanantai;14;4;18;2;1;3
96;25.07.2016;2016;07;03;Maanantai;2;3;5;0;0;0
96;25.07.2016;2016;07;04;Maanantai;12;2;14;0;0;0
96;25.07.2016;2016;07;05;Maanantai;10;9;19;2;0;2
96;25.07.2016;2016;07;06;Maanantai;51;35;86;6;5;11
96;25.07.2016;2016;07;07;Maanantai;77;75;152;7;8;15
96;25.07.2016;2016;07;08;Maanantai;27;32;59;37;28;65
96;25.07.2016;2016;07;09;Maanantai;31;54;85;8;10;18
96;25.07.2016;2016;07;10;Maanantai;37;64;101;7;6;13
96;25.07.2016;2016;07;11;Maanantai;49;66;115;10;17;27
96;25.07.2016;2016;07;12;Maanantai;65;72;137;10;16;26
96;25.07.2016;2016;07;13;Maanantai;68;90;158;10;13;23
96;25.07.2016;2016;07;14;Maanantai;82;111;193;5;16;21
96;25.07.2016;2016;07;15;Maanantai;100;146;246;9;26;35
96;25.07.2016;2016;07;16;Maanantai;125;102;227;11;17;28
96;25.07.2016;2016;07;17;Maanantai;117;85;202;12;7;19
96;25.07.2016;2016;07;18;Maanantai;124;80;204;21;15;36
96;25.07.2016;2016;07;19;Maanantai;88;68;156;23;8;31
96;25.07.2016;2016;07;20;Maanantai;85;45;130;11;12;23
96;25.07.2016;2016;07;21;Maanantai;40;30;70;5;8;13
96;25.07.2016;2016;07;22;Maanantai;46;21;67;5;1;6
96;25.07.2016;2016;07;23;Maanantai;20;14;34;3;0;3
96;26.07.2016;2016;07;00;Tiistai;16;3;19;5;3;8
96;26.07.2016;2016;07;01;Tiistai;10;2;12;3;4;7
96;26.07.2016;2016;07;02;Tiistai;9;3;12;2;2;4
96;26.07.2016;2016;07;03;Tiistai;7;0;7;0;0;0
96;26.07.2016;2016;07;04;Tiistai;3;3;6;0;0;0
96;26.07.2016;2016;07;05;Tiistai;12;8;20;2;0;2
96;26.07.2016;2016;07;06;Tiistai;61;32;93;4;1;5
96;26.07.2016;2016;07;07;Tiistai;79;68;147;13;9;22
96;26.07.2016;2016;07;08;Tiistai;25;59;84;10;15;25
96;26.07.2016;2016;07;09;Tiistai;28;65;93;13;9;22
96;26.07.2016;2016;07;10;Tiistai;46;86;132;20;10;30
96;26.07.2016;2016;07;11;Tiistai;65;88;153;18;17;35
96;26.07.2016;2016;07;12;Tiistai;63;73;136;10;15;25
96;26.07.2016;2016;07;13;Tiistai;82;92;174;3;20;23
96;26.07.2016;2016;07;14;Tiistai;93;104;197;10;45;55
96;26.07.2016;2016;07;15;Tiistai;122;153;275;14;52;66
96;26.07.2016;2016;07;16;Tiistai;122;108;230;13;35;48
96;26.07.2016;2016;07;17;Tiistai;93;67;160;18;19;37
96;26.07.2016;2016;07;18;Tiistai;118;65;183;15;7;22
96;26.07.2016;2016;07;19;Tiistai;87;50;137;12;12;24
96;26.07.2016;2016;07;20;Tiistai;81;42;123;14;9;23
96;26.07.2016;2016;07;21;Tiistai;53;45;98;5;7;12
96;26.07.2016;2016;07;22;Tiistai;27;33;60;2;7;9
96;26.07.2016;2016;07;23;Tiistai;20;10;30;1;1;2
96;27.07.2016;2016;07;00;Keskiviikko;12;9;21;1;2;3
96;27.07.2016;2016;07;01;Keskiviikko;10;0;10;2;1;3
96;27.07.2016;2016;07;02;Keskiviikko;8;3;11;2;2;4
96;27.07.2016;2016;07;03;Keskiviikko;3;1;4;0;1;1
96;27.07.2016;2016;07;04;Keskiviikko;3;4;7;1;0;1
96;27.07.2016;2016;07;05;Keskiviikko;15;10;25;2;0;2
96;27.07.2016;2016;07;06;Keskiviikko;48;23;71;1;1;2
96;27.07.2016;2016;07;07;Keskiviikko;60;65;125;14;7;21
96;27.07.2016;2016;07;08;Keskiviikko;38;62;100;5;11;16
96;27.07.2016;2016;07;09;Keskiviikko;22;20;42;4;1;5
96;27.07.2016;2016;07;10;Keskiviikko;17;24;41;4;6;10
96;27.07.2016;2016;07;11;Keskiviikko;37;52;89;5;13;18
96;27.07.2016;2016;07;12;Keskiviikko;56;68;124;12;8;20
96;27.07.2016;2016;07;13;Keskiviikko;62;62;124;11;14;25
96;27.07.2016;2016;07;14;Keskiviikko;49;86;135;9;11;20
96;27.07.2016;2016;07;15;Keskiviikko;84;123;207;11;34;45
96;27.07.2016;2016;07;16;Keskiviikko;75;100;175;15;34;49
96;27.07.2016;2016;07;17;Keskiviikko;118;74;192;28;17;45
96;27.07.2016;2016;07;18;Keskiviikko;92;63;155;10;20;30
96;27.07.2016;2016;07;19;Keskiviikko;77;65;142;9;9;18
96;27.07.2016;2016;07;20;Keskiviikko;98;56;154;11;12;23
96;27.07.2016;2016;07;21;Keskiviikko;60;44;104;2;7;9
96;27.07.2016;2016;07;22;Keskiviikko;54;28;82;8;5;13
96;27.07.2016;2016;07;23;Keskiviikko;20;18;38;6;6;12
96;28.07.2016;2016;07;00;Torstai;20;3;23;8;2;10
96;28.07.2016;2016;07;01;Torstai;7;5;12;1;1;2
96;28.07.2016;2016;07;02;Torstai;2;0;2;0;1;1
96;28.07.2016;2016;07;03;Torstai;5;1;6;0;1;1
96;28.07.2016;2016;07;04;Torstai;6;2;8;2;0;2
96;28.07.2016;2016;07;05;Torstai;14;7;21;0;0;0
96;28.07.2016;2016;07;06;Torstai;51;26;77;2;3;5
96;28.07.2016;2016;07;07;Torstai;69;65;134;10;2;12
96;28.07.2016;2016;07;08;Torstai;20;63;83;6;2;8
96;28.07.2016;2016;07;09;Torstai;27;72;99;3;10;13
96;28.07.2016;2016;07;10;Torstai;45;54;99;7;11;18
96;28.07.2016;2016;07;11;Torstai;44;62;106;10;5;15
96;28.07.2016;2016;07;12;Torstai;71;77;148;7;9;16
96;28.07.2016;2016;07;13;Torstai;61;89;150;21;16;37
96;28.07.2016;2016;07;14;Torstai;83;113;196;12;12;24
96;28.07.2016;2016;07;15;Torstai;90;142;232;8;33;41
96;28.07.2016;2016;07;16;Torstai;104;97;201;26;24;50
96;28.07.2016;2016;07;17;Torstai;86;80;166;10;15;25
96;28.07.2016;2016;07;18;Torstai;66;62;128;6;8;14
96;28.07.2016;2016;07;19;Torstai;69;61;130;20;12;32
96;28.07.2016;2016;07;20;Torstai;69;36;105;7;10;17
96;28.07.2016;2016;07;21;Torstai;41;57;98;7;10;17
96;28.07.2016;2016;07;22;Torstai;39;20;59;9;2;11
96;28.07.2016;2016;07;23;Torstai;25;7;32;5;1;6
96;29.07.2016;2016;07;00;Perjantai;13;9;22;2;3;5
96;29.07.2016;2016;07;01;Perjantai;1;1;2;2;1;3
96;29.07.2016;2016;07;02;Perjantai;2;0;2;1;0;1
96;29.07.2016;2016;07;03;Perjantai;5;1;6;0;0;0
96;29.07.2016;2016;07;04;Perjantai;9;5;14;0;1;1
96;29.07.2016;2016;07;05;Perjantai;6;7;13;1;0;1
96;29.07.2016;2016;07;06;Perjantai;45;22;67;5;1;6
96;29.07.2016;2016;07;07;Perjantai;48;69;117;5;3;8
96;29.07.2016;2016;07;08;Perjantai;28;66;94;6;7;13
96;29.07.2016;2016;07;09;Perjantai;36;60;96;9;10;19
96;29.07.2016;2016;07;10;Perjantai;40;55;95;7;12;19
96;29.07.2016;2016;07;11;Perjantai;64;70;134;3;9;12
96;29.07.2016;2016;07;12;Perjantai;61;68;129;7;5;12
96;29.07.2016;2016;07;13;Perjantai;69;104;173;3;6;9
96;29.07.2016;2016;07;14;Perjantai;62;140;202;7;11;18
96;29.07.2016;2016;07;15;Perjantai;89;139;228;9;18;27
96;29.07.2016;2016;07;16;Perjantai;106;103;209;6;7;13
96;29.07.2016;2016;07;17;Perjantai;74;66;140;8;12;20
96;29.07.2016;2016;07;18;Perjantai;84;93;177;7;10;17
96;29.07.2016;2016;07;19;Perjantai;48;99;147;10;10;20
96;29.07.2016;2016;07;20;Perjantai;52;82;134;2;9;11
96;29.07.2016;2016;07;21;Perjantai;50;53;103;4;4;8
96;29.07.2016;2016;07;22;Perjantai;27;20;47;2;4;6
96;29.07.2016;2016;07;23;Perjantai;57;19;76;3;6;9
96;30.07.2016;2016;07;00;Lauantai;89;17;106;6;0;6
96;30.07.2016;2016;07;01;Lauantai;97;16;113;11;1;12
96;30.07.2016;2016;07;02;Lauantai;106;6;112;10;0;10
96;30.07.2016;2016;07;03;Lauantai;48;8;56;7;0;7
96;30.07.2016;2016;07;04;Lauantai;51;4;55;20;2;22
96;30.07.2016;2016;07;05;Lauantai;10;6;16;0;1;1
96;30.07.2016;2016;07;06;Lauantai;26;10;36;1;2;3
96;30.07.2016;2016;07;07;Lauantai;7;19;26;2;1;3
96;30.07.2016;2016;07;08;Lauantai;18;23;41;8;4;12
96;30.07.2016;2016;07;09;Lauantai;23;33;56;1;8;9
96;30.07.2016;2016;07;10;Lauantai;38;51;89;4;7;11
96;30.07.2016;2016;07;11;Lauantai;49;95;144;1;7;8
96;30.07.2016;2016;07;12;Lauantai;66;129;195;8;13;21
96;30.07.2016;2016;07;13;Lauantai;89;100;189;4;10;14
96;30.07.2016;2016;07;14;Lauantai;72;101;173;7;10;17
96;30.07.2016;2016;07;15;Lauantai;64;32;96;2;6;8
96;30.07.2016;2016;07;16;Lauantai;36;49;85;4;5;9
96;30.07.2016;2016;07;17;Lauantai;42;66;108;3;6;9
96;30.07.2016;2016;07;18;Lauantai;42;56;98;7;7;14
96;30.07.2016;2016;07;19;Lauantai;36;49;85;4;6;10
96;30.07.2016;2016;07;20;Lauantai;47;57;104;6;6;12
96;30.07.2016;2016;07;21;Lauantai;25;48;73;2;10;12
96;30.07.2016;2016;07;22;Lauantai;43;34;77;3;3;6
96;30.07.2016;2016;07;23;Lauantai;31;13;44;2;3;5
96;31.07.2016;2016;07;00;Sunnuntai;53;20;73;2;2;4
96;31.07.2016;2016;07;01;Sunnuntai;85;12;97;9;1;10
96;31.07.2016;2016;07;02;Sunnuntai;88;13;101;10;0;10
96;31.07.2016;2016;07;03;Sunnuntai;64;1;65;8;0;8
96;31.07.2016;2016;07;04;Sunnuntai;30;3;33;3;1;4
96;31.07.2016;2016;07;05;Sunnuntai;10;1;11;5;0;5
96;31.07.2016;2016;07;06;Sunnuntai;21;6;27;5;1;6
96;31.07.2016;2016;07;07;Sunnuntai;5;8;13;1;2;3
96;31.07.2016;2016;07;08;Sunnuntai;10;8;18;3;2;5
96;31.07.2016;2016;07;09;Sunnuntai;8;14;22;3;6;9
96;31.07.2016;2016;07;10;Sunnuntai;7;18;25;9;11;20
96;31.07.2016;2016;07;11;Sunnuntai;22;30;52;4;11;15
96;31.07.2016;2016;07;12;Sunnuntai;32;29;61;2;3;5
96;31.07.2016;2016;07;13;Sunnuntai;41;25;66;5;3;8
96;31.07.2016;2016;07;14;Sunnuntai;40;62;102;6;9;15
96;31.07.2016;2016;07;15;Sunnuntai;59;50;109;12;10;22
96;31.07.2016;2016;07;16;Sunnuntai;48;29;77;8;6;14
96;31.07.2016;2016;07;17;Sunnuntai;53;31;84;13;8;21
96;31.07.2016;2016;07;18;Sunnuntai;33;7;40;1;3;4
96;31.07.2016;2016;07;19;Sunnuntai;25;30;55;4;2;6
96;31.07.2016;2016;07;20;Sunnuntai;19;10;29;6;8;14
96;31.07.2016;2016;07;21;Sunnuntai;28;32;60;3;5;8
96;31.07.2016;2016;07;22;Sunnuntai;9;17;26;3;0;3
96;31.07.2016;2016;07;23;Sunnuntai;12;10;22;0;1;1
96;01.08.2016;2016;08;00;Maanantai;5;1;6;0;0;0
96;01.08.2016;2016;08;01;Maanantai;5;2;7;2;1;3
96;01.08.2016;2016;08;02;Maanantai;5;2;7;0;0;0
96;01.08.2016;2016;08;03;Maanantai;5;0;5;0;0;0
96;01.08.2016;2016;08;04;Maanantai;5;1;6;1;0;1
96;01.08.2016;2016;08;05;Maanantai;5;6;11;3;0;3
96;01.08.2016;2016;08;06;Maanantai;42;42;84;1;2;3
96;01.08.2016;2016;08;07;Maanantai;76;83;159;10;3;13
96;01.08.2016;2016;08;08;Maanantai;36;75;111;8;7;15
96;01.08.2016;2016;08;09;Maanantai;25;63;88;6;9;15
96;01.08.2016;2016;08;10;Maanantai;46;84;130;12;10;22
96;01.08.2016;2016;08;11;Maanantai;78;64;142;7;6;13
96;01.08.2016;2016;08;12;Maanantai;68;72;140;7;10;17
96;01.08.2016;2016;08;13;Maanantai;76;92;168;8;6;14
96;01.08.2016;2016;08;14;Maanantai;74;100;174;13;18;31
96;01.08.2016;2016;08;15;Maanantai;119;150;269;5;28;33
96;01.08.2016;2016;08;16;Maanantai;119;94;213;13;18;31
96;01.08.2016;2016;08;17;Maanantai;95;72;167;10;13;23
96;01.08.2016;2016;08;18;Maanantai;83;51;134;13;10;23
96;01.08.2016;2016;08;19;Maanantai;83;56;139;9;10;19
96;01.08.2016;2016;08;20;Maanantai;69;41;110;19;8;27
96;01.08.2016;2016;08;21;Maanantai;47;61;108;5;10;15
96;01.08.2016;2016;08;22;Maanantai;26;17;43;5;2;7
96;01.08.2016;2016;08;23;Maanantai;18;11;29;3;4;7
96;02.08.2016;2016;08;00;Tiistai;10;2;12;2;1;3
96;02.08.2016;2016;08;01;Tiistai;14;2;16;3;0;3
96;02.08.2016;2016;08;02;Tiistai;5;1;6;0;1;1
96;02.08.2016;2016;08;03;Tiistai;4;0;4;0;0;0
96;02.08.2016;2016;08;04;Tiistai;4;0;4;0;0;0
96;02.08.2016;2016;08;05;Tiistai;7;9;16;0;0;0
96;02.08.2016;2016;08;06;Tiistai;63;42;105;5;6;11
96;02.08.2016;2016;08;07;Tiistai;67;75;142;13;4;17
96;02.08.2016;2016;08;08;Tiistai;43;47;90;14;6;20
96;02.08.2016;2016;08;09;Tiistai;22;23;45;2;3;5
96;02.08.2016;2016;08;10;Tiistai;25;32;57;7;3;10
96;02.08.2016;2016;08;11;Tiistai;37;52;89;11;8;19
96;02.08.2016;2016;08;12;Tiistai;64;50;114;11;18;29
96;02.08.2016;2016;08;13;Tiistai;57;58;115;10;3;13
96;02.08.2016;2016;08;14;Tiistai;36;46;82;4;6;10
96;02.08.2016;2016;08;15;Tiistai;73;84;157;2;6;8
96;02.08.2016;2016;08;16;Tiistai;64;61;125;6;7;13
96;02.08.2016;2016;08;17;Tiistai;50;64;114;6;9;15
96;02.08.2016;2016;08;18;Tiistai;39;30;69;6;7;13
96;02.08.2016;2016;08;19;Tiistai;34;41;75;11;11;22
96;02.08.2016;2016;08;20;Tiistai;69;35;104;12;11;23
96;02.08.2016;2016;08;21;Tiistai;64;40;104;7;7;14
96;02.08.2016;2016;08;22;Tiistai;18;13;31;5;3;8
96;02.08.2016;2016;08;23;Tiistai;4;15;19;3;2;5
96;03.08.2016;2016;08;00;Keskiviikko;10;4;14;2;1;3
96;03.08.2016;2016;08;01;Keskiviikko;3;2;5;1;0;1
96;03.08.2016;2016;08;02;Keskiviikko;2;1;3;0;0;0
96;03.08.2016;2016;08;03;Keskiviikko;3;1;4;1;0;1
96;03.08.2016;2016;08;04;Keskiviikko;6;0;6;0;1;1
96;03.08.2016;2016;08;05;Keskiviikko;7;7;14;1;0;1
96;03.08.2016;2016;08;06;Keskiviikko;60;38;98;5;1;6
96;03.08.2016;2016;08;07;Keskiviikko;71;84;155;9;5;14
96;03.08.2016;2016;08;08;Keskiviikko;28;74;102;3;11;14
96;03.08.2016;2016;08;09;Keskiviikko;46;58;104;5;13;18
96;03.08.2016;2016;08;10;Keskiviikko;44;76;120;3;8;11
96;03.08.2016;2016;08;11;Keskiviikko;64;66;130;9;7;16
96;03.08.2016;2016;08;12;Keskiviikko;57;80;137;3;8;11
96;03.08.2016;2016;08;13;Keskiviikko;76;90;166;5;10;15
96;03.08.2016;2016;08;14;Keskiviikko;60;81;141;2;3;5
96;03.08.2016;2016;08;15;Keskiviikko;76;102;178;3;7;10
96;03.08.2016;2016;08;16;Keskiviikko;91;78;169;11;13;24
96;03.08.2016;2016;08;17;Keskiviikko;40;39;79;9;5;14
96;03.08.2016;2016;08;18;Keskiviikko;79;40;119;24;10;34
96;03.08.2016;2016;08;19;Keskiviikko;44;36;80;14;15;29
96;03.08.2016;2016;08;20;Keskiviikko;59;53;112;15;9;24
96;03.08.2016;2016;08;21;Keskiviikko;45;40;85;9;16;25
96;03.08.2016;2016;08;22;Keskiviikko;17;16;33;5;5;10
96;03.08.2016;2016;08;23;Keskiviikko;10;19;29;0;1;1
96;04.08.2016;2016;08;00;Torstai;5;4;9;1;0;1
96;04.08.2016;2016;08;01;Torstai;4;1;5;1;0;1
96;04.08.2016;2016;08;02;Torstai;0;1;1;2;0;2
96;04.08.2016;2016;08;03;Torstai;9;4;13;0;0;0
96;04.08.2016;2016;08;04;Torstai;14;2;16;0;2;2
96;04.08.2016;2016;08;05;Torstai;9;5;14;0;0;0
96;04.08.2016;2016;08;06;Torstai;60;35;95;5;1;6
96;04.08.2016;2016;08;07;Torstai;69;86;155;10;6;16
96;04.08.2016;2016;08;08;Torstai;29;73;102;5;6;11
96;04.08.2016;2016;08;09;Torstai;32;58;90;4;14;18
96;04.08.2016;2016;08;10;Torstai;41;64;105;3;5;8
96;04.08.2016;2016;08;11;Torstai;58;78;136;12;7;19
96;04.08.2016;2016;08;12;Torstai;61;75;136;10;10;20
96;04.08.2016;2016;08;13;Torstai;76;106;182;7;13;20
96;04.08.2016;2016;08;14;Torstai;82;102;184;2;8;10
96;04.08.2016;2016;08;15;Torstai;109;140;249;7;18;25
96;04.08.2016;2016;08;16;Torstai;97;85;182;16;22;38
96;04.08.2016;2016;08;17;Torstai;71;52;123;8;8;16
96;04.08.2016;2016;08;18;Torstai;62;46;108;9;6;15
96;04.08.2016;2016;08;19;Torstai;84;43;127;9;15;24
96;04.08.2016;2016;08;20;Torstai;61;42;103;5;5;10
96;04.08.2016;2016;08;21;Torstai;21;42;63;4;2;6
96;04.08.2016;2016;08;22;Torstai;18;12;30;0;1;1
96;04.08.2016;2016;08;23;Torstai;9;9;18;0;0;0
96;05.08.2016;2016;08;00;Perjantai;6;1;7;0;0;0
96;05.08.2016;2016;08;01;Perjantai;4;1;5;1;0;1
96;05.08.2016;2016;08;02;Perjantai;0;1;1;0;0;0
96;05.08.2016;2016;08;03;Perjantai;2;2;4;0;1;1
96;05.08.2016;2016;08;04;Perjantai;1;6;7;0;1;1
96;05.08.2016;2016;08;05;Perjantai;7;5;12;0;0;0
96;05.08.2016;2016;08;06;Perjantai;50;29;79;3;2;5
96;05.08.2016;2016;08;07;Perjantai;59;78;137;5;3;8
96;05.08.2016;2016;08;08;Perjantai;32;65;97;4;7;11
96;05.08.2016;2016;08;09;Perjantai;30;41;71;6;8;14
96;05.08.2016;2016;08;10;Perjantai;23;41;64;4;5;9
96;05.08.2016;2016;08;11;Perjantai;36;34;70;5;4;9
96;05.08.2016;2016;08;12;Perjantai;30;48;78;9;9;18
96;05.08.2016;2016;08;13;Perjantai;62;79;141;6;9;15
96;05.08.2016;2016;08;14;Perjantai;78;101;179;4;12;16
96;05.08.2016;2016;08;15;Perjantai;76;119;195;9;17;26
96;05.08.2016;2016;08;16;Perjantai;97;88;185;3;13;16
96;05.08.2016;2016;08;17;Perjantai;66;56;122;5;6;11
96;05.08.2016;2016;08;18;Perjantai;71;60;131;5;12;17
96;05.08.2016;2016;08;19;Perjantai;68;42;110;10;15;25
96;05.08.2016;2016;08;20;Perjantai;64;31;95;7;8;15
96;05.08.2016;2016;08;21;Perjantai;40;35;75;11;8;19
96;05.08.2016;2016;08;22;Perjantai;33;24;57;7;4;11
96;05.08.2016;2016;08;23;Perjantai;25;11;36;3;2;5
96;06.08.2016;2016;08;00;Lauantai;20;5;25;3;1;4
96;06.08.2016;2016;08;01;Lauantai;18;2;20;4;1;5
96;06.08.2016;2016;08;02;Lauantai;5;6;11;0;0;0
96;06.08.2016;2016;08;03;Lauantai;9;0;9;0;0;0
96;06.08.2016;2016;08;04;Lauantai;3;4;7;1;2;3
96;06.08.2016;2016;08;05;Lauantai;5;0;5;2;1;3
96;06.08.2016;2016;08;06;Lauantai;23;13;36;2;1;3
96;06.08.2016;2016;08;07;Lauantai;5;12;17;2;3;5
96;06.08.2016;2016;08;08;Lauantai;12;26;38;5;7;12
96;06.08.2016;2016;08;09;Lauantai;16;37;53;4;9;13
96;06.08.2016;2016;08;10;Lauantai;29;42;71;12;9;21
96;06.08.2016;2016;08;11;Lauantai;37;69;106;16;16;32
96;06.08.2016;2016;08;12;Lauantai;62;86;148;12;5;17
96;06.08.2016;2016;08;13;Lauantai;65;55;120;11;12;23
96;06.08.2016;2016;08;14;Lauantai;51;72;123;13;9;22
96;06.08.2016;2016;08;15;Lauantai;77;60;137;9;8;17
96;06.08.2016;2016;08;16;Lauantai;60;39;99;5;4;9
96;06.08.2016;2016;08;17;Lauantai;53;53;106;7;4;11
96;06.08.2016;2016;08;18;Lauantai;48;59;107;13;11;24
96;06.08.2016;2016;08;19;Lauantai;51;32;83;4;5;9
96;06.08.2016;2016;08;20;Lauantai;42;33;75;5;10;15
96;06.08.2016;2016;08;21;Lauantai;33;31;64;4;6;10
96;06.08.2016;2016;08;22;Lauantai;24;21;45;3;3;6
96;06.08.2016;2016;08;23;Lauantai;14;13;27;1;3;4
96;07.08.2016;2016;08;00;Sunnuntai;22;12;34;0;2;2
96;07.08.2016;2016;08;01;Sunnuntai;22;4;26;2;2;4
96;07.08.2016;2016;08;02;Sunnuntai;18;3;21;2;0;2
96;07.08.2016;2016;08;03;Sunnuntai;13;0;13;5;1;6
96;07.08.2016;2016;08;04;Sunnuntai;20;3;23;1;1;2
96;07.08.2016;2016;08;05;Sunnuntai;6;2;8;1;1;2
96;07.08.2016;2016;08;06;Sunnuntai;21;4;25;1;0;1
96;07.08.2016;2016;08;07;Sunnuntai;9;11;20;4;1;5
96;07.08.2016;2016;08;08;Sunnuntai;5;15;20;4;6;10
96;07.08.2016;2016;08;09;Sunnuntai;11;17;28;3;1;4
96;07.08.2016;2016;08;10;Sunnuntai;14;26;40;6;13;19
96;07.08.2016;2016;08;11;Sunnuntai;18;30;48;9;7;16
96;07.08.2016;2016;08;12;Sunnuntai;43;28;71;9;3;12
96;07.08.2016;2016;08;13;Sunnuntai;39;34;73;9;14;23
96;07.08.2016;2016;08;14;Sunnuntai;35;41;76;12;5;17
96;07.08.2016;2016;08;15;Sunnuntai;50;46;96;10;10;20
96;07.08.2016;2016;08;16;Sunnuntai;54;31;85;27;7;34
96;07.08.2016;2016;08;17;Sunnuntai;53;42;95;16;16;32
96;07.08.2016;2016;08;18;Sunnuntai;70;58;128;11;15;26
96;07.08.2016;2016;08;19;Sunnuntai;52;45;97;18;15;33
96;07.08.2016;2016;08;20;Sunnuntai;56;48;104;9;11;20
96;07.08.2016;2016;08;21;Sunnuntai;27;26;53;6;15;21
96;07.08.2016;2016;08;22;Sunnuntai;23;17;40;2;3;5
96;07.08.2016;2016;08;23;Sunnuntai;13;8;21;1;0;1
96;08.08.2016;2016;08;00;Maanantai;7;3;10;2;1;3
96;08.08.2016;2016;08;01;Maanantai;3;0;3;0;0;0
96;08.08.2016;2016;08;02;Maanantai;4;3;7;0;0;0
96;08.08.2016;2016;08;03;Maanantai;3;1;4;1;0;1
96;08.08.2016;2016;08;04;Maanantai;8;2;10;0;0;0
96;08.08.2016;2016;08;05;Maanantai;13;11;24;1;0;1
96;08.08.2016;2016;08;06;Maanantai;54;48;102;5;1;6
96;08.08.2016;2016;08;07;Maanantai;85;120;205;15;6;21
96;08.08.2016;2016;08;08;Maanantai;50;95;145;7;5;12
96;08.08.2016;2016;08;09;Maanantai;50;79;129;8;14;22
96;08.08.2016;2016;08;10;Maanantai;49;81;130;13;7;20
96;08.08.2016;2016;08;11;Maanantai;71;87;158;15;13;28
96;08.08.2016;2016;08;12;Maanantai;71;105;176;9;10;19
96;08.08.2016;2016;08;13;Maanantai;77;104;181;8;10;18
96;08.08.2016;2016;08;14;Maanantai;66;124;190;7;18;25
96;08.08.2016;2016;08;15;Maanantai;142;188;330;6;16;22
96;08.08.2016;2016;08;16;Maanantai;136;115;251;10;18;28
96;08.08.2016;2016;08;17;Maanantai;99;92;191;15;16;31
96;08.08.2016;2016;08;18;Maanantai;80;47;127;17;19;36
96;08.08.2016;2016;08;19;Maanantai;85;54;139;10;13;23
96;08.08.2016;2016;08;20;Maanantai;62;27;89;9;9;18
96;08.08.2016;2016;08;21;Maanantai;29;69;98;6;4;10
96;08.08.2016;2016;08;22;Maanantai;19;16;35;2;4;6
96;08.08.2016;2016;08;23;Maanantai;16;7;23;0;1;1
96;09.08.2016;2016;08;00;Tiistai;7;4;11;1;0;1
96;09.08.2016;2016;08;01;Tiistai;6;2;8;1;0;1
96;09.08.2016;2016;08;02;Tiistai;1;5;6;0;0;0
96;09.08.2016;2016;08;03;Tiistai;1;0;1;1;0;1
96;09.08.2016;2016;08;04;Tiistai;5;1;6;0;1;1
96;09.08.2016;2016;08;05;Tiistai;7;12;19;2;0;2
96;09.08.2016;2016;08;06;Tiistai;64;41;105;4;0;4
96;09.08.2016;2016;08;07;Tiistai;82;105;187;13;5;18
96;09.08.2016;2016;08;08;Tiistai;48;88;136;8;7;15
96;09.08.2016;2016;08;09;Tiistai;59;80;139;5;15;20
96;09.08.2016;2016;08;10;Tiistai;44;62;106;13;19;32
96;09.08.2016;2016;08;11;Tiistai;40;43;83;13;4;17
96;09.08.2016;2016;08;12;Tiistai;69;75;144;7;9;16
96;09.08.2016;2016;08;13;Tiistai;47;82;129;12;8;20
96;09.08.2016;2016;08;14;Tiistai;61;64;125;4;5;9
96;09.08.2016;2016;08;15;Tiistai;81;179;260;5;24;29
96;09.08.2016;2016;08;16;Tiistai;115;107;222;5;8;13
96;09.08.2016;2016;08;17;Tiistai;76;60;136;6;5;11
96;09.08.2016;2016;08;18;Tiistai;72;47;119;10;11;21
96;09.08.2016;2016;08;19;Tiistai;65;47;112;11;10;21
96;09.08.2016;2016;08;20;Tiistai;84;27;111;10;17;27
96;09.08.2016;2016;08;21;Tiistai;33;37;70;6;6;12
96;09.08.2016;2016;08;22;Tiistai;17;18;35;1;3;4
96;09.08.2016;2016;08;23;Tiistai;15;10;25;2;3;5
96;10.08.2016;2016;08;00;Keskiviikko;10;3;13;1;1;2
96;10.08.2016;2016;08;01;Keskiviikko;7;1;8;2;1;3
96;10.08.2016;2016;08;02;Keskiviikko;0;0;0;0;0;0
96;10.08.2016;2016;08;03;Keskiviikko;2;0;2;0;0;0
96;10.08.2016;2016;08;04;Keskiviikko;1;2;3;0;1;1
96;10.08.2016;2016;08;05;Keskiviikko;9;6;15;1;1;2
96;10.08.2016;2016;08;06;Keskiviikko;46;31;77;3;0;3
96;10.08.2016;2016;08;07;Keskiviikko;75;56;131;12;6;18
96;10.08.2016;2016;08;08;Keskiviikko;73;78;151;6;2;8
96;10.08.2016;2016;08;09;Keskiviikko;67;91;158;10;6;16
96;10.08.2016;2016;08;10;Keskiviikko;31;55;86;1;9;10
96;10.08.2016;2016;08;11;Keskiviikko;62;70;132;6;10;16
96;10.08.2016;2016;08;12;Keskiviikko;74;132;206;8;11;19
96;10.08.2016;2016;08;13;Keskiviikko;82;98;180;12;14;26
96;10.08.2016;2016;08;14;Keskiviikko;80;131;211;8;11;19
96;10.08.2016;2016;08;15;Keskiviikko;94;139;233;8;11;19
96;10.08.2016;2016;08;16;Keskiviikko;86;73;159;9;9;18
96;10.08.2016;2016;08;17;Keskiviikko;67;61;128;4;11;15
96;10.08.2016;2016;08;18;Keskiviikko;82;46;128;23;11;34
96;10.08.2016;2016;08;19;Keskiviikko;54;29;83;12;7;19
96;10.08.2016;2016;08;20;Keskiviikko;38;41;79;13;11;24
96;10.08.2016;2016;08;21;Keskiviikko;51;32;83;7;9;16
96;10.08.2016;2016;08;22;Keskiviikko;24;11;35;2;5;7
96;10.08.2016;2016;08;23;Keskiviikko;8;5;13;1;1;2
96;11.08.2016;2016;08;00;Torstai;3;3;6;1;0;1
96;11.08.2016;2016;08;01;Torstai;2;2;4;0;0;0
96;11.08.2016;2016;08;02;Torstai;8;1;9;2;1;3
96;11.08.2016;2016;08;03;Torstai;3;0;3;1;0;1
96;11.08.2016;2016;08;04;Torstai;3;0;3;0;1;1
96;11.08.2016;2016;08;05;Torstai;5;9;14;1;0;1
96;11.08.2016;2016;08;06;Torstai;43;34;77;5;0;5
96;11.08.2016;2016;08;07;Torstai;123;139;262;17;5;22
96;11.08.2016;2016;08;08;Torstai;89;92;181;12;13;25
96;11.08.2016;2016;08;09;Torstai;104;87;191;11;9;20
96;11.08.2016;2016;08;10;Torstai;43;81;124;20;19;39
96;11.08.2016;2016;08;11;Torstai;84;93;177;15;12;27
96;11.08.2016;2016;08;12;Torstai;86;100;186;11;24;35
96;11.08.2016;2016;08;13;Torstai;78;115;193;12;16;28
96;11.08.2016;2016;08;14;Torstai;70;145;215;14;33;47
96;11.08.2016;2016;08;15;Torstai;99;221;320;3;29;32
96;11.08.2016;2016;08;16;Torstai;132;118;250;8;11;19
96;11.08.2016;2016;08;17;Torstai;80;67;147;6;13;19
96;11.08.2016;2016;08;18;Torstai;92;54;146;12;8;20
96;11.08.2016;2016;08;19;Torstai;98;50;148;10;16;26
96;11.08.2016;2016;08;20;Torstai;76;41;117;11;10;21
96;11.08.2016;2016;08;21;Torstai;33;47;80;4;6;10
96;11.08.2016;2016;08;22;Torstai;20;16;36;7;3;10
96;11.08.2016;2016;08;23;Torstai;9;7;16;2;2;4
96;12.08.2016;2016;08;00;Perjantai;3;7;10;2;3;5
96;12.08.2016;2016;08;01;Perjantai;4;0;4;1;2;3
96;12.08.2016;2016;08;02;Perjantai;1;1;2;0;0;0
96;12.08.2016;2016;08;03;Perjantai;6;0;6;0;1;1
96;12.08.2016;2016;08;04;Perjantai;3;0;3;0;1;1
96;12.08.2016;2016;08;05;Perjantai;4;9;13;1;0;1
96;12.08.2016;2016;08;06;Perjantai;51;37;88;2;1;3
96;12.08.2016;2016;08;07;Perjantai;111;93;204;10;5;15
96;12.08.2016;2016;08;08;Perjantai;60;64;124;13;7;20
96;12.08.2016;2016;08;09;Perjantai;42;40;82;4;3;7
96;12.08.2016;2016;08;10;Perjantai;31;28;59;5;5;10
96;12.08.2016;2016;08;11;Perjantai;34;63;97;5;7;12
96;12.08.2016;2016;08;12;Perjantai;65;74;139;18;17;35
96;12.08.2016;2016;08;13;Perjantai;60;100;160;8;13;21
96;12.08.2016;2016;08;14;Perjantai;74;152;226;7;25;32
96;12.08.2016;2016;08;15;Perjantai;106;115;221;3;18;21
96;12.08.2016;2016;08;16;Perjantai;87;71;158;10;17;27
96;12.08.2016;2016;08;17;Perjantai;66;43;109;10;8;18
96;12.08.2016;2016;08;18;Perjantai;59;53;112;11;9;20
96;12.08.2016;2016;08;19;Perjantai;48;34;82;11;6;17
96;12.08.2016;2016;08;20;Perjantai;52;31;83;17;10;27
96;12.08.2016;2016;08;21;Perjantai;30;50;80;3;6;9
96;12.08.2016;2016;08;22;Perjantai;10;21;31;2;1;3
96;12.08.2016;2016;08;23;Perjantai;12;5;17;1;1;2
96;13.08.2016;2016;08;00;Lauantai;12;2;14;1;1;2
96;13.08.2016;2016;08;01;Lauantai;11;1;12;0;2;2
96;13.08.2016;2016;08;02;Lauantai;19;1;20;2;0;2
96;13.08.2016;2016;08;03;Lauantai;7;0;7;0;0;0
96;13.08.2016;2016;08;04;Lauantai;6;1;7;2;2;4
96;13.08.2016;2016;08;05;Lauantai;3;3;6;1;1;2
96;13.08.2016;2016;08;06;Lauantai;18;9;27;0;0;0
96;13.08.2016;2016;08;07;Lauantai;11;18;29;3;1;4
96;13.08.2016;2016;08;08;Lauantai;7;28;35;6;2;8
96;13.08.2016;2016;08;09;Lauantai;12;18;30;3;6;9
96;13.08.2016;2016;08;10;Lauantai;12;19;31;3;4;7
96;13.08.2016;2016;08;11;Lauantai;12;21;33;1;3;4
96;13.08.2016;2016;08;12;Lauantai;27;13;40;2;2;4
96;13.08.2016;2016;08;13;Lauantai;28;27;55;4;3;7
96;13.08.2016;2016;08;14;Lauantai;11;18;29;4;3;7
96;13.08.2016;2016;08;15;Lauantai;23;17;40;2;2;4
96;13.08.2016;2016;08;16;Lauantai;21;17;38;3;4;7
96;13.08.2016;2016;08;17;Lauantai;22;21;43;5;5;10
96;13.08.2016;2016;08;18;Lauantai;18;22;40;13;4;17
96;13.08.2016;2016;08;19;Lauantai;25;20;45;4;7;11
96;13.08.2016;2016;08;20;Lauantai;26;24;50;5;5;10
96;13.08.2016;2016;08;21;Lauantai;20;19;39;3;1;4
96;13.08.2016;2016;08;22;Lauantai;6;12;18;2;2;4
96;13.08.2016;2016;08;23;Lauantai;4;6;10;1;2;3
96;14.08.2016;2016;08;00;Sunnuntai;7;6;13;3;2;5
96;14.08.2016;2016;08;01;Sunnuntai;10;2;12;0;0;0
96;14.08.2016;2016;08;02;Sunnuntai;8;5;13;1;0;1
96;14.08.2016;2016;08;03;Sunnuntai;11;0;11;2;1;3
96;14.08.2016;2016;08;04;Sunnuntai;8;1;9;1;1;2
96;14.08.2016;2016;08;05;Sunnuntai;4;0;4;0;1;1
96;14.08.2016;2016;08;06;Sunnuntai;27;4;31;0;0;0
96;14.08.2016;2016;08;07;Sunnuntai;2;4;6;1;2;3
96;14.08.2016;2016;08;08;Sunnuntai;10;14;24;5;5;10
96;14.08.2016;2016;08;09;Sunnuntai;10;12;22;8;5;13
96;14.08.2016;2016;08;10;Sunnuntai;27;19;46;9;13;22
96;14.08.2016;2016;08;11;Sunnuntai;23;43;66;11;10;21
96;14.08.2016;2016;08;12;Sunnuntai;64;55;119;14;14;28
96;14.08.2016;2016;08;13;Sunnuntai;50;64;114;5;7;12
96;14.08.2016;2016;08;14;Sunnuntai;56;53;109;16;13;29
96;14.08.2016;2016;08;15;Sunnuntai;59;55;114;22;17;39
96;14.08.2016;2016;08;16;Sunnuntai;63;73;136;27;17;44
96;14.08.2016;2016;08;17;Sunnuntai;71;55;126;14;28;42
96;14.08.2016;2016;08;18;Sunnuntai;61;55;116;24;30;54
96;14.08.2016;2016;08;19;Sunnuntai;70;54;124;18;14;32
96;14.08.2016;2016;08;20;Sunnuntai;65;42;107;13;20;33
96;14.08.2016;2016;08;21;Sunnuntai;24;23;47;11;9;20
96;14.08.2016;2016;08;22;Sunnuntai;11;12;23;1;3;4
96;14.08.2016;2016;08;23;Sunnuntai;5;4;9;0;0;0
96;15.08.2016;2016;08;00;Maanantai;5;4;9;2;0;2
96;15.08.2016;2016;08;01;Maanantai;3;2;5;0;0;0
96;15.08.2016;2016;08;02;Maanantai;2;0;2;0;1;1
96;15.08.2016;2016;08;03;Maanantai;4;0;4;0;1;1
96;15.08.2016;2016;08;04;Maanantai;2;2;4;1;1;2
96;15.08.2016;2016;08;05;Maanantai;3;8;11;1;1;2
96;15.08.2016;2016;08;06;Maanantai;58;40;98;5;1;6
96;15.08.2016;2016;08;07;Maanantai;152;163;315;23;9;32
96;15.08.2016;2016;08;08;Maanantai;101;122;223;21;6;27
96;15.08.2016;2016;08;09;Maanantai;71;82;153;11;6;17
96;15.08.2016;2016;08;10;Maanantai;45;53;98;8;10;18
96;15.08.2016;2016;08;11;Maanantai;60;107;167;14;13;27
96;15.08.2016;2016;08;12;Maanantai;79;91;170;16;16;32
96;15.08.2016;2016;08;13;Maanantai;72;118;190;9;18;27
96;15.08.2016;2016;08;14;Maanantai;96;147;243;7;25;32
96;15.08.2016;2016;08;15;Maanantai;130;240;370;2;24;26
96;15.08.2016;2016;08;16;Maanantai;173;167;340;11;24;35
96;15.08.2016;2016;08;17;Maanantai;116;88;204;11;14;25
96;15.08.2016;2016;08;18;Maanantai;84;86;170;19;15;34
96;15.08.2016;2016;08;19;Maanantai;74;60;134;14;22;36
96;15.08.2016;2016;08;20;Maanantai;77;49;126;15;17;32
96;15.08.2016;2016;08;21;Maanantai;31;45;76;3;8;11
96;15.08.2016;2016;08;22;Maanantai;14;12;26;4;5;9
96;15.08.2016;2016;08;23;Maanantai;4;3;7;1;2;3
96;16.08.2016;2016;08;00;Tiistai;4;0;4;0;1;1
96;16.08.2016;2016;08;01;Tiistai;9;1;10;0;0;0
96;16.08.2016;2016;08;02;Tiistai;4;1;5;0;0;0
96;16.08.2016;2016;08;03;Tiistai;2;1;3;0;0;0
96;16.08.2016;2016;08;04;Tiistai;1;2;3;1;0;1
96;16.08.2016;2016;08;05;Tiistai;4;6;10;0;0;0
96;16.08.2016;2016;08;06;Tiistai;57;49;106;1;1;2
96;16.08.2016;2016;08;07;Tiistai;161;153;314;17;4;21
96;16.08.2016;2016;08;08;Tiistai;77;111;188;15;8;23
96;16.08.2016;2016;08;09;Tiistai;90;68;158;6;4;10
96;16.08.2016;2016;08;10;Tiistai;53;65;118;13;9;22
96;16.08.2016;2016;08;11;Tiistai;50;75;125;13;12;25
96;16.08.2016;2016;08;12;Tiistai;77;92;169;8;15;23
96;16.08.2016;2016;08;13;Tiistai;72;94;166;6;4;10
96;16.08.2016;2016;08;14;Tiistai;76;139;215;6;26;32
96;16.08.2016;2016;08;15;Tiistai;101;227;328;4;19;23
96;16.08.2016;2016;08;16;Tiistai;113;135;248;4;13;17
96;16.08.2016;2016;08;17;Tiistai;70;70;140;14;7;21
96;16.08.2016;2016;08;18;Tiistai;60;57;117;6;16;22
96;16.08.2016;2016;08;19;Tiistai;48;38;86;9;13;22
96;16.08.2016;2016;08;20;Tiistai;43;30;73;8;11;19
96;16.08.2016;2016;08;21;Tiistai;18;28;46;3;6;9
96;16.08.2016;2016;08;22;Tiistai;5;14;19;2;1;3
96;16.08.2016;2016;08;23;Tiistai;5;5;10;0;0;0
96;17.08.2016;2016;08;00;Keskiviikko;0;0;0;0;0;0
96;17.08.2016;2016;08;01;Keskiviikko;1;1;2;0;0;0
96;17.08.2016;2016;08;02;Keskiviikko;1;0;1;0;0;0
96;17.08.2016;2016;08;03;Keskiviikko;1;0;1;0;0;0
96;17.08.2016;2016;08;04;Keskiviikko;2;2;4;0;1;1
96;17.08.2016;2016;08;05;Keskiviikko;4;10;14;0;0;0
96;17.08.2016;2016;08;06;Keskiviikko;48;45;93;2;0;2
96;17.08.2016;2016;08;07;Keskiviikko;142;159;301;17;10;27
96;17.08.2016;2016;08;08;Keskiviikko;94;115;209;12;5;17
96;17.08.2016;2016;08;09;Keskiviikko;83;82;165;7;5;12
96;17.08.2016;2016;08;10;Keskiviikko;37;46;83;7;4;11
96;17.08.2016;2016;08;11;Keskiviikko;62;89;151;11;16;27
96;17.08.2016;2016;08;12;Keskiviikko;83;76;159;20;13;33
96;17.08.2016;2016;08;13;Keskiviikko;81;101;182;9;15;24
96;17.08.2016;2016;08;14;Keskiviikko;83;184;267;8;16;24
96;17.08.2016;2016;08;15;Keskiviikko;102;234;336;5;22;27
96;17.08.2016;2016;08;16;Keskiviikko;122;175;297;10;30;40
96;17.08.2016;2016;08;17;Keskiviikko;112;67;179;17;9;26
96;17.08.2016;2016;08;18;Keskiviikko;112;71;183;23;8;31
96;17.08.2016;2016;08;19;Keskiviikko;90;51;141;22;24;46
96;17.08.2016;2016;08;20;Keskiviikko;74;93;167;9;18;27
96;17.08.2016;2016;08;21;Keskiviikko;42;44;86;7;16;23
96;17.08.2016;2016;08;22;Keskiviikko;17;7;24;6;2;8
96;17.08.2016;2016;08;23;Keskiviikko;7;3;10;0;1;1
96;18.08.2016;2016;08;00;Torstai;3;4;7;1;0;1
96;18.08.2016;2016;08;01;Torstai;9;1;10;1;0;1
96;18.08.2016;2016;08;02;Torstai;2;0;2;0;0;0
96;18.08.2016;2016;08;03;Torstai;2;1;3;0;0;0
96;18.08.2016;2016;08;04;Torstai;3;0;3;1;0;1
96;18.08.2016;2016;08;05;Torstai;1;8;9;0;0;0
96;18.08.2016;2016;08;06;Torstai;49;40;89;6;2;8
96;18.08.2016;2016;08;07;Torstai;166;151;317;21;11;32
96;18.08.2016;2016;08;08;Torstai;113;121;234;23;20;43
96;18.08.2016;2016;08;09;Torstai;111;94;205;12;16;28
96;18.08.2016;2016;08;10;Torstai;73;65;138;7;13;20
96;18.08.2016;2016;08;11;Torstai;63;105;168;5;14;19
96;18.08.2016;2016;08;12;Torstai;78;103;181;6;18;24
96;18.08.2016;2016;08;13;Torstai;108;118;226;16;23;39
96;18.08.2016;2016;08;14;Torstai;127;137;264;10;14;24
96;18.08.2016;2016;08;15;Torstai;143;259;402;8;16;24
96;18.08.2016;2016;08;16;Torstai;156;164;320;21;24;45
96;18.08.2016;2016;08;17;Torstai;134;126;260;24;30;54
96;18.08.2016;2016;08;18;Torstai;80;135;215;23;18;41
96;18.08.2016;2016;08;19;Torstai;93;58;151;10;19;29
96;18.08.2016;2016;08;20;Torstai;140;54;194;7;6;13
96;18.08.2016;2016;08;21;Torstai;50;47;97;4;4;8
96;18.08.2016;2016;08;22;Torstai;35;14;49;2;4;6
96;18.08.2016;2016;08;23;Torstai;44;10;54;1;1;2
96;19.08.2016;2016;08;00;Perjantai;9;5;14;2;0;2
96;19.08.2016;2016;08;01;Perjantai;17;2;19;0;3;3
96;19.08.2016;2016;08;02;Perjantai;11;3;14;1;0;1
96;19.08.2016;2016;08;03;Perjantai;12;1;13;0;0;0
96;19.08.2016;2016;08;04;Perjantai;6;3;9;0;0;0
96;19.08.2016;2016;08;05;Perjantai;4;9;13;1;0;1
96;19.08.2016;2016;08;06;Perjantai;42;26;68;0;2;2
96;19.08.2016;2016;08;07;Perjantai;103;103;206;9;0;9
96;19.08.2016;2016;08;08;Perjantai;70;53;123;5;5;10
96;19.08.2016;2016;08;09;Perjantai;62;68;130;3;4;7
96;19.08.2016;2016;08;10;Perjantai;24;40;64;5;6;11
96;19.08.2016;2016;08;11;Perjantai;42;72;114;10;18;28
96;19.08.2016;2016;08;12;Perjantai;46;77;123;9;17;26
96;19.08.2016;2016;08;13;Perjantai;61;118;179;11;14;25
96;19.08.2016;2016;08;14;Perjantai;96;166;262;7;18;25
96;19.08.2016;2016;08;15;Perjantai;77;98;175;8;11;19
96;19.08.2016;2016;08;16;Perjantai;61;66;127;5;10;15
96;19.08.2016;2016;08;17;Perjantai;64;65;129;7;6;13
96;19.08.2016;2016;08;18;Perjantai;55;51;106;12;8;20
96;19.08.2016;2016;08;19;Perjantai;50;32;82;5;8;13
96;19.08.2016;2016;08;20;Perjantai;34;43;77;11;4;15
96;19.08.2016;2016;08;21;Perjantai;32;35;67;3;9;12
96;19.08.2016;2016;08;22;Perjantai;15;15;30;1;3;4
96;19.08.2016;2016;08;23;Perjantai;14;12;26;3;2;5
96;20.08.2016;2016;08;00;Lauantai;5;12;17;2;1;3
96;20.08.2016;2016;08;01;Lauantai;12;5;17;0;0;0
96;20.08.2016;2016;08;02;Lauantai;7;3;10;2;1;3
96;20.08.2016;2016;08;03;Lauantai;10;1;11;2;0;2
96;20.08.2016;2016;08;04;Lauantai;7;3;10;3;2;5
96;20.08.2016;2016;08;05;Lauantai;1;0;1;3;1;4
96;20.08.2016;2016;08;06;Lauantai;20;11;31;3;1;4
96;20.08.2016;2016;08;07;Lauantai;6;21;27;1;4;5
96;20.08.2016;2016;08;08;Lauantai;14;26;40;7;5;12
96;20.08.2016;2016;08;09;Lauantai;15;56;71;10;29;39
96;20.08.2016;2016;08;10;Lauantai;32;72;104;7;17;24
96;20.08.2016;2016;08;11;Lauantai;39;88;127;18;36;54
96;20.08.2016;2016;08;12;Lauantai;71;82;153;6;18;24
96;20.08.2016;2016;08;13;Lauantai;61;69;130;21;17;38
96;20.08.2016;2016;08;14;Lauantai;61;83;144;13;11;24
96;20.08.2016;2016;08;15;Lauantai;60;60;120;21;10;31
96;20.08.2016;2016;08;16;Lauantai;74;58;132;12;12;24
96;20.08.2016;2016;08;17;Lauantai;66;54;120;11;9;20
96;20.08.2016;2016;08;18;Lauantai;30;18;48;5;0;5
96;20.08.2016;2016;08;19;Lauantai;25;20;45;5;4;9
96;20.08.2016;2016;08;20;Lauantai;20;19;39;6;7;13
96;20.08.2016;2016;08;21;Lauantai;21;22;43;2;5;7
96;20.08.2016;2016;08;22;Lauantai;9;17;26;0;3;3
96;20.08.2016;2016;08;23;Lauantai;9;7;16;1;0;1
96;21.08.2016;2016;08;00;Sunnuntai;9;7;16;0;5;5
96;21.08.2016;2016;08;01;Sunnuntai;7;3;10;2;0;2
96;21.08.2016;2016;08;02;Sunnuntai;7;4;11;2;0;2
96;21.08.2016;2016;08;03;Sunnuntai;20;0;20;1;1;2
96;21.08.2016;2016;08;04;Sunnuntai;13;2;15;7;1;8
96;21.08.2016;2016;08;05;Sunnuntai;5;3;8;3;0;3
96;21.08.2016;2016;08;06;Sunnuntai;18;8;26;2;0;2
96;21.08.2016;2016;08;07;Sunnuntai;2;10;12;1;2;3
96;21.08.2016;2016;08;08;Sunnuntai;8;7;15;6;5;11
96;21.08.2016;2016;08;09;Sunnuntai;12;17;29;5;7;12
96;21.08.2016;2016;08;10;Sunnuntai;9;54;63;5;13;18
96;21.08.2016;2016;08;11;Sunnuntai;27;60;87;5;20;25
96;21.08.2016;2016;08;12;Sunnuntai;47;73;120;10;22;32
96;21.08.2016;2016;08;13;Sunnuntai;78;65;143;19;5;24
96;21.08.2016;2016;08;14;Sunnuntai;60;65;125;9;10;19
96;21.08.2016;2016;08;15;Sunnuntai;68;57;125;14;9;23
96;21.08.2016;2016;08;16;Sunnuntai;80;78;158;16;15;31
96;21.08.2016;2016;08;17;Sunnuntai;62;54;116;20;13;33
96;21.08.2016;2016;08;18;Sunnuntai;76;52;128;28;26;54
96;21.08.2016;2016;08;19;Sunnuntai;91;62;153;11;21;32
96;21.08.2016;2016;08;20;Sunnuntai;44;48;92;16;16;32
96;21.08.2016;2016;08;21;Sunnuntai;37;20;57;5;10;15
96;21.08.2016;2016;08;22;Sunnuntai;10;6;16;1;1;2
96;21.08.2016;2016;08;23;Sunnuntai;6;4;10;1;1;2
96;22.08.2016;2016;08;00;Maanantai;8;3;11;3;1;4
96;22.08.2016;2016;08;01;Maanantai;3;0;3;0;1;1
96;22.08.2016;2016;08;02;Maanantai;0;0;0;0;0;0
96;22.08.2016;2016;08;03;Maanantai;4;1;5;0;0;0
96;22.08.2016;2016;08;04;Maanantai;2;4;6;1;0;1
96;22.08.2016;2016;08;05;Maanantai;6;10;16;0;0;0
96;22.08.2016;2016;08;06;Maanantai;41;21;62;1;0;1
96;22.08.2016;2016;08;07;Maanantai;132;71;203;16;10;26
96;22.08.2016;2016;08;08;Maanantai;83;51;134;9;4;13
96;22.08.2016;2016;08;09;Maanantai;82;40;122;20;4;24
96;22.08.2016;2016;08;10;Maanantai;31;24;55;6;6;12
96;22.08.2016;2016;08;11;Maanantai;39;60;99;5;4;9
96;22.08.2016;2016;08;12;Maanantai;63;77;140;12;11;23
96;22.08.2016;2016;08;13;Maanantai;54;77;131;5;18;23
96;22.08.2016;2016;08;14;Maanantai;66;109;175;4;18;22
96;22.08.2016;2016;08;15;Maanantai;87;159;246;2;20;22
96;22.08.2016;2016;08;16;Maanantai;84;111;195;11;26;37
96;22.08.2016;2016;08;17;Maanantai;57;42;99;7;11;18
96;22.08.2016;2016;08;18;Maanantai;52;45;97;16;19;35
96;22.08.2016;2016;08;19;Maanantai;46;43;89;15;18;33
96;22.08.2016;2016;08;20;Maanantai;23;32;55;11;10;21
96;22.08.2016;2016;08;21;Maanantai;25;38;63;3;4;7
96;22.08.2016;2016;08;22;Maanantai;3;8;11;0;1;1
96;22.08.2016;2016;08;23;Maanantai;5;4;9;3;1;4
96;23.08.2016;2016;08;00;Tiistai;0;2;2;0;1;1
96;23.08.2016;2016;08;01;Tiistai;2;1;3;1;0;1
96;23.08.2016;2016;08;02;Tiistai;4;0;4;1;0;1
96;23.08.2016;2016;08;03;Tiistai;1;1;2;0;0;0
96;23.08.2016;2016;08;04;Tiistai;1;5;6;0;0;0
96;23.08.2016;2016;08;05;Tiistai;5;7;12;1;0;1
96;23.08.2016;2016;08;06;Tiistai;61;42;103;5;2;7
96;23.08.2016;2016;08;07;Tiistai;180;157;337;16;10;26
96;23.08.2016;2016;08;08;Tiistai;114;144;258;24;11;35
96;23.08.2016;2016;08;09;Tiistai;98;97;195;17;18;35
96;23.08.2016;2016;08;10;Tiistai;62;53;115;16;11;27
96;23.08.2016;2016;08;11;Tiistai;67;90;157;10;14;24
96;23.08.2016;2016;08;12;Tiistai;125;77;202;17;14;31
96;23.08.2016;2016;08;13;Tiistai;94;96;190;10;10;20
96;23.08.2016;2016;08;14;Tiistai;93;174;267;6;26;32
96;23.08.2016;2016;08;15;Tiistai;121;345;466;13;31;44
96;23.08.2016;2016;08;16;Tiistai;169;165;334;13;28;41
96;23.08.2016;2016;08;17;Tiistai;118;110;228;18;16;34
96;23.08.2016;2016;08;18;Tiistai;95;102;197;11;15;26
96;23.08.2016;2016;08;19;Tiistai;97;79;176;19;29;48
96;23.08.2016;2016;08;20;Tiistai;78;51;129;21;16;37
96;23.08.2016;2016;08;21;Tiistai;50;41;91;3;9;12
96;23.08.2016;2016;08;22;Tiistai;22;12;34;4;2;6
96;23.08.2016;2016;08;23;Tiistai;9;7;16;0;0;0
96;24.08.2016;2016;08;00;Keskiviikko;2;1;3;0;2;2
96;24.08.2016;2016;08;01;Keskiviikko;3;0;3;0;0;0
96;24.08.2016;2016;08;02;Keskiviikko;8;3;11;0;0;0
96;24.08.2016;2016;08;03;Keskiviikko;13;0;13;0;0;0
96;24.08.2016;2016;08;04;Keskiviikko;10;4;14;0;0;0
96;24.08.2016;2016;08;05;Keskiviikko;6;10;16;0;1;1
96;24.08.2016;2016;08;06;Keskiviikko;73;44;117;2;4;6
96;24.08.2016;2016;08;07;Keskiviikko;158;164;322;16;6;22
96;24.08.2016;2016;08;08;Keskiviikko;121;146;267;9;12;21
96;24.08.2016;2016;08;09;Keskiviikko;111;88;199;16;12;28
96;24.08.2016;2016;08;10;Keskiviikko;50;68;118;6;4;10
96;24.08.2016;2016;08;11;Keskiviikko;93;96;189;11;10;21
96;24.08.2016;2016;08;12;Keskiviikko;117;71;188;11;7;18
96;24.08.2016;2016;08;13;Keskiviikko;95;117;212;15;13;28
96;24.08.2016;2016;08;14;Keskiviikko;117;207;324;21;26;47
96;24.08.2016;2016;08;15;Keskiviikko;129;273;402;20;30;50
96;24.08.2016;2016;08;16;Keskiviikko;154;171;325;11;36;47
96;24.08.2016;2016;08;17;Keskiviikko;122;121;243;19;12;31
96;24.08.2016;2016;08;18;Keskiviikko;134;94;228;23;15;38
96;24.08.2016;2016;08;19;Keskiviikko;134;69;203;15;10;25
96;24.08.2016;2016;08;20;Keskiviikko;79;93;172;14;18;32
96;24.08.2016;2016;08;21;Keskiviikko;40;39;79;6;10;16
96;24.08.2016;2016;08;22;Keskiviikko;20;6;26;5;2;7
96;24.08.2016;2016;08;23;Keskiviikko;9;5;14;2;1;3
96;25.08.2016;2016;08;00;Torstai;6;3;9;2;0;2
96;25.08.2016;2016;08;01;Torstai;3;2;5;0;0;0
96;25.08.2016;2016;08;02;Torstai;1;1;2;0;1;1
96;25.08.2016;2016;08;03;Torstai;5;0;5;0;0;0
96;25.08.2016;2016;08;04;Torstai;3;3;6;1;0;1
96;25.08.2016;2016;08;05;Torstai;4;5;9;1;0;1
96;25.08.2016;2016;08;06;Torstai;62;36;98;4;1;5
96;25.08.2016;2016;08;07;Torstai;208;132;340;37;25;62
96;25.08.2016;2016;08;08;Torstai;136;106;242;20;11;31
96;25.08.2016;2016;08;09;Torstai;100;55;155;10;11;21
96;25.08.2016;2016;08;10;Torstai;62;45;107;14;14;28
96;25.08.2016;2016;08;11;Torstai;47;54;101;10;10;20
96;25.08.2016;2016;08;12;Torstai;78;61;139;36;48;84
96;25.08.2016;2016;08;13;Torstai;37;76;113;25;41;66
96;25.08.2016;2016;08;14;Torstai;42;107;149;50;114;164
96;25.08.2016;2016;08;15;Torstai;84;207;291;52;103;155
96;25.08.2016;2016;08;16;Torstai;111;135;246;15;22;37
96;25.08.2016;2016;08;17;Torstai;111;59;170;10;15;25
96;25.08.2016;2016;08;18;Torstai;53;60;113;15;12;27
96;25.08.2016;2016;08;19;Torstai;68;46;114;11;11;22
96;25.08.2016;2016;08;20;Torstai;36;39;75;12;17;29
96;25.08.2016;2016;08;21;Torstai;32;31;63;4;5;9
96;25.08.2016;2016;08;22;Torstai;7;10;17;3;3;6
96;25.08.2016;2016;08;23;Torstai;7;7;14;2;1;3
96;26.08.2016;2016;08;00;Perjantai;7;1;8;0;0;0
96;26.08.2016;2016;08;01;Perjantai;1;2;3;0;0;0
96;26.08.2016;2016;08;02;Perjantai;1;0;1;0;0;0
96;26.08.2016;2016;08;03;Perjantai;4;0;4;2;0;2
96;26.08.2016;2016;08;04;Perjantai;5;2;7;0;0;0
96;26.08.2016;2016;08;05;Perjantai;6;9;15;2;0;2
96;26.08.2016;2016;08;06;Perjantai;58;28;86;2;2;4
96;26.08.2016;2016;08;07;Perjantai;144;118;262;16;8;24
96;26.08.2016;2016;08;08;Perjantai;96;115;211;10;6;16
96;26.08.2016;2016;08;09;Perjantai;85;95;180;18;5;23
96;26.08.2016;2016;08;10;Perjantai;63;70;133;9;15;24
96;26.08.2016;2016;08;11;Perjantai;96;117;213;11;18;29
96;26.08.2016;2016;08;12;Perjantai;93;125;218;11;18;29
96;26.08.2016;2016;08;13;Perjantai;102;131;233;5;19;24
96;26.08.2016;2016;08;14;Perjantai;107;213;320;11;28;39
96;26.08.2016;2016;08;15;Perjantai;129;240;369;13;28;41
96;26.08.2016;2016;08;16;Perjantai;115;99;214;20;15;35
96;26.08.2016;2016;08;17;Perjantai;94;73;167;16;27;43
96;26.08.2016;2016;08;18;Perjantai;73;83;156;6;18;24
96;26.08.2016;2016;08;19;Perjantai;70;59;129;9;13;22
96;26.08.2016;2016;08;20;Perjantai;70;50;120;9;14;23
96;26.08.2016;2016;08;21;Perjantai;62;44;106;13;15;28
96;26.08.2016;2016;08;22;Perjantai;43;15;58;1;3;4
96;26.08.2016;2016;08;23;Perjantai;29;5;34;2;0;2
96;27.08.2016;2016;08;00;Lauantai;26;7;33;5;1;6
96;27.08.2016;2016;08;01;Lauantai;16;1;17;0;0;0
96;27.08.2016;2016;08;02;Lauantai;5;0;5;1;0;1
96;27.08.2016;2016;08;03;Lauantai;19;3;22;5;0;5
96;27.08.2016;2016;08;04;Lauantai;7;2;9;2;1;3
96;27.08.2016;2016;08;05;Lauantai;3;4;7;0;0;0
96;27.08.2016;2016;08;06;Lauantai;15;6;21;3;1;4
96;27.08.2016;2016;08;07;Lauantai;6;19;25;0;1;1
96;27.08.2016;2016;08;08;Lauantai;11;13;24;8;5;13
96;27.08.2016;2016;08;09;Lauantai;15;16;31;1;6;7
96;27.08.2016;2016;08;10;Lauantai;23;35;58;5;3;8
96;27.08.2016;2016;08;11;Lauantai;28;34;62;5;6;11
96;27.08.2016;2016;08;12;Lauantai;30;40;70;13;11;24
96;27.08.2016;2016;08;13;Lauantai;49;31;80;9;10;19
96;27.08.2016;2016;08;14;Lauantai;37;20;57;7;3;10
96;27.08.2016;2016;08;15;Lauantai;35;16;51;4;1;5
96;27.08.2016;2016;08;16;Lauantai;29;24;53;3;3;6
96;27.08.2016;2016;08;17;Lauantai;20;15;35;8;7;15
96;27.08.2016;2016;08;18;Lauantai;29;27;56;12;4;16
96;27.08.2016;2016;08;19;Lauantai;20;26;46;8;7;15
96;27.08.2016;2016;08;20;Lauantai;24;26;50;9;4;13
96;27.08.2016;2016;08;21;Lauantai;8;17;25;1;6;7
96;27.08.2016;2016;08;22;Lauantai;8;5;13;3;3;6
96;27.08.2016;2016;08;23;Lauantai;3;6;9;0;0;0
96;28.08.2016;2016;08;00;Sunnuntai;11;10;21;1;1;2
96;28.08.2016;2016;08;01;Sunnuntai;7;2;9;0;0;0
96;28.08.2016;2016;08;02;Sunnuntai;14;1;15;2;0;2
96;28.08.2016;2016;08;03;Sunnuntai;11;1;12;2;0;2
96;28.08.2016;2016;08;04;Sunnuntai;6;0;6;3;0;3
96;28.08.2016;2016;08;05;Sunnuntai;3;2;5;1;1;2
96;28.08.2016;2016;08;06;Sunnuntai;20;4;24;1;0;1
96;28.08.2016;2016;08;07;Sunnuntai;8;9;17;0;2;2
96;28.08.2016;2016;08;08;Sunnuntai;16;8;24;4;4;8
96;28.08.2016;2016;08;09;Sunnuntai;19;17;36;5;12;17
96;28.08.2016;2016;08;10;Sunnuntai;29;36;65;8;16;24
96;28.08.2016;2016;08;11;Sunnuntai;33;56;89;15;13;28
96;28.08.2016;2016;08;12;Sunnuntai;64;84;148;14;18;32
96;28.08.2016;2016;08;13;Sunnuntai;73;93;166;14;10;24
96;28.08.2016;2016;08;14;Sunnuntai;90;47;137;9;11;20
96;28.08.2016;2016;08;15;Sunnuntai;70;49;119;7;17;24
96;28.08.2016;2016;08;16;Sunnuntai;117;49;166;28;9;37
96;28.08.2016;2016;08;17;Sunnuntai;75;43;118;17;23;40
96;28.08.2016;2016;08;18;Sunnuntai;78;55;133;18;25;43
96;28.08.2016;2016;08;19;Sunnuntai;49;42;91;12;23;35
96;28.08.2016;2016;08;20;Sunnuntai;50;28;78;8;12;20
96;28.08.2016;2016;08;21;Sunnuntai;24;24;48;7;8;15
96;28.08.2016;2016;08;22;Sunnuntai;5;6;11;4;3;7
96;28.08.2016;2016;08;23;Sunnuntai;4;1;5;2;0;2
96;29.08.2016;2016;08;00;Maanantai;2;3;5;0;1;1
96;29.08.2016;2016;08;01;Maanantai;1;2;3;0;0;0
96;29.08.2016;2016;08;02;Maanantai;0;1;1;0;0;0
96;29.08.2016;2016;08;03;Maanantai;1;0;1;0;0;0
96;29.08.2016;2016;08;04;Maanantai;5;0;5;0;1;1
96;29.08.2016;2016;08;05;Maanantai;8;7;15;2;0;2
96;29.08.2016;2016;08;06;Maanantai;50;43;93;4;2;6
96;29.08.2016;2016;08;07;Maanantai;217;134;351;40;16;56
96;29.08.2016;2016;08;08;Maanantai;164;124;288;22;26;48
96;29.08.2016;2016;08;09;Maanantai;131;83;214;15;13;28
96;29.08.2016;2016;08;10;Maanantai;74;76;150;14;12;26
96;29.08.2016;2016;08;11;Maanantai;76;87;163;12;10;22
96;29.08.2016;2016;08;12;Maanantai;78;96;174;13;15;28
96;29.08.2016;2016;08;13;Maanantai;111;127;238;16;22;38
96;29.08.2016;2016;08;14;Maanantai;127;139;266;13;21;34
96;29.08.2016;2016;08;15;Maanantai;134;272;406;17;22;39
96;29.08.2016;2016;08;16;Maanantai;133;197;330;25;49;74
96;29.08.2016;2016;08;17;Maanantai;98;87;185;25;27;52
96;29.08.2016;2016;08;18;Maanantai;96;88;184;39;30;69
96;29.08.2016;2016;08;19;Maanantai;97;63;160;17;26;43
96;29.08.2016;2016;08;20;Maanantai;56;40;96;17;13;30
96;29.08.2016;2016;08;21;Maanantai;37;53;90;5;14;19
96;29.08.2016;2016;08;22;Maanantai;16;6;22;5;2;7
96;29.08.2016;2016;08;23;Maanantai;10;5;15;2;3;5
96;30.08.2016;2016;08;00;Tiistai;6;2;8;0;1;1
96;30.08.2016;2016;08;01;Tiistai;4;0;4;1;2;3
96;30.08.2016;2016;08;02;Tiistai;3;0;3;0;0;0
96;30.08.2016;2016;08;03;Tiistai;6;1;7;0;0;0
96;30.08.2016;2016;08;04;Tiistai;1;1;2;0;0;0
96;30.08.2016;2016;08;05;Tiistai;5;8;13;3;1;4
96;30.08.2016;2016;08;06;Tiistai;59;46;105;3;0;3
96;30.08.2016;2016;08;07;Tiistai;181;154;335;24;11;35
96;30.08.2016;2016;08;08;Tiistai;140;118;258;17;11;28
96;30.08.2016;2016;08;09;Tiistai;124;78;202;15;7;22
96;30.08.2016;2016;08;10;Tiistai;78;73;151;10;10;20
96;30.08.2016;2016;08;11;Tiistai;81;80;161;7;7;14
96;30.08.2016;2016;08;12;Tiistai;101;100;201;13;15;28
96;30.08.2016;2016;08;13;Tiistai;84;109;193;10;14;24
96;30.08.2016;2016;08;14;Tiistai;90;172;262;9;17;26
96;30.08.2016;2016;08;15;Tiistai;134;292;426;10;30;40
96;30.08.2016;2016;08;16;Tiistai;156;180;336;8;31;39
96;30.08.2016;2016;08;17;Tiistai;101;98;199;16;13;29
96;30.08.2016;2016;08;18;Tiistai;73;82;155;15;10;25
96;30.08.2016;2016;08;19;Tiistai;78;50;128;12;9;21
96;30.08.2016;2016;08;20;Tiistai;49;33;82;13;11;24
96;30.08.2016;2016;08;21;Tiistai;29;40;69;3;7;10
96;30.08.2016;2016;08;22;Tiistai;9;11;20;0;2;2
96;30.08.2016;2016;08;23;Tiistai;3;2;5;1;0;1
96;31.08.2016;2016;08;00;Keskiviikko;4;2;6;1;0;1
96;31.08.2016;2016;08;01;Keskiviikko;3;0;3;0;0;0
96;31.08.2016;2016;08;02;Keskiviikko;1;0;1;0;0;0
96;31.08.2016;2016;08;03;Keskiviikko;1;3;4;0;0;0
96;31.08.2016;2016;08;04;Keskiviikko;1;1;2;0;0;0
96;31.08.2016;2016;08;05;Keskiviikko;5;7;12;1;0;1
96;31.08.2016;2016;08;06;Keskiviikko;61;37;98;5;1;6
96;31.08.2016;2016;08;07;Keskiviikko;186;278;464;23;20;43
96;31.08.2016;2016;08;08;Keskiviikko;165;205;370;22;21;43
96;31.08.2016;2016;08;09;Keskiviikko;122;88;210;14;8;22
96;31.08.2016;2016;08;10;Keskiviikko;257;66;323;42;16;58
96;31.08.2016;2016;08;11;Keskiviikko;106;41;147;13;8;21
96;31.08.2016;2016;08;12;Keskiviikko;8;9;17;41;35;76
96;31.08.2016;2016;08;13;Keskiviikko;95;123;218;11;9;20
96;31.08.2016;2016;08;14;Keskiviikko;104;193;297;3;24;27
96;31.08.2016;2016;08;15;Keskiviikko;125;276;401;5;24;29
96;31.08.2016;2016;08;16;Keskiviikko;117;163;280;22;34;56
96;31.08.2016;2016;08;17;Keskiviikko;93;88;181;15;12;27
96;31.08.2016;2016;08;18;Keskiviikko;122;81;203;18;16;34
96;31.08.2016;2016;08;19;Keskiviikko;76;61;137;23;22;45
96;31.08.2016;2016;08;20;Keskiviikko;91;52;143;15;16;31
96;31.08.2016;2016;08;21;Keskiviikko;47;42;89;8;10;18
96;31.08.2016;2016;08;22;Keskiviikko;11;14;25;2;2;4
96;31.08.2016;2016;08;23;Keskiviikko;3;2;5;2;0;2
96;01.09.2016;2016;09;00;Torstai;3;2;5;0;1;1
96;01.09.2016;2016;09;01;Torstai;4;0;4;2;0;2
96;01.09.2016;2016;09;02;Torstai;0;0;0;0;0;0
96;01.09.2016;2016;09;03;Torstai;3;0;3;0;0;0
96;01.09.2016;2016;09;04;Torstai;3;2;5;0;0;0
96;01.09.2016;2016;09;05;Torstai;3;9;12;0;0;0
96;01.09.2016;2016;09;06;Torstai;66;38;104;1;1;2
96;01.09.2016;2016;09;07;Torstai;165;120;285;17;9;26
96;01.09.2016;2016;09;08;Torstai;109;99;208;13;7;20
96;01.09.2016;2016;09;09;Torstai;105;83;188;20;4;24
96;01.09.2016;2016;09;10;Torstai;59;34;93;2;15;17
96;01.09.2016;2016;09;11;Torstai;42;62;104;22;7;29
96;01.09.2016;2016;09;12;Torstai;77;95;172;15;9;24
96;01.09.2016;2016;09;13;Torstai;65;87;152;6;14;20
96;01.09.2016;2016;09;14;Torstai;80;153;233;6;17;23
96;01.09.2016;2016;09;15;Torstai;90;260;350;9;26;35
96;01.09.2016;2016;09;16;Torstai;106;153;259;10;21;31
96;01.09.2016;2016;09;17;Torstai;84;93;177;10;16;26
96;01.09.2016;2016;09;18;Torstai;60;67;127;11;15;26
96;01.09.2016;2016;09;19;Torstai;62;42;104;15;15;30
96;01.09.2016;2016;09;20;Torstai;73;47;120;12;10;22
96;01.09.2016;2016;09;21;Torstai;30;49;79;4;8;12
96;01.09.2016;2016;09;22;Torstai;14;23;37;5;2;7
96;01.09.2016;2016;09;23;Torstai;4;2;6;2;2;4
96;02.09.2016;2016;09;00;Perjantai;6;0;6;0;0;0
96;02.09.2016;2016;09;01;Perjantai;10;1;11;0;0;0
96;02.09.2016;2016;09;02;Perjantai;9;2;11;1;0;1
96;02.09.2016;2016;09;03;Perjantai;5;3;8;1;0;1
96;02.09.2016;2016;09;04;Perjantai;3;2;5;1;0;1
96;02.09.2016;2016;09;05;Perjantai;5;6;11;1;0;1
96;02.09.2016;2016;09;06;Perjantai;57;35;92;2;2;4
96;02.09.2016;2016;09;07;Perjantai;139;144;283;16;8;24
96;02.09.2016;2016;09;08;Perjantai;106;95;201;10;4;14
96;02.09.2016;2016;09;09;Perjantai;94;69;163;10;7;17
96;02.09.2016;2016;09;10;Perjantai;42;35;77;4;10;14
96;02.09.2016;2016;09;11;Perjantai;46;58;104;10;6;16
96;02.09.2016;2016;09;12;Perjantai;110;111;221;8;9;17
96;02.09.2016;2016;09;13;Perjantai;84;168;252;9;15;24
96;02.09.2016;2016;09;14;Perjantai;116;203;319;11;26;37
96;02.09.2016;2016;09;15;Perjantai;119;165;284;13;30;43
96;02.09.2016;2016;09;16;Perjantai;84;123;207;5;11;16
96;02.09.2016;2016;09;17;Perjantai;60;52;112;11;6;17
96;02.09.2016;2016;09;18;Perjantai;73;46;119;2;9;11
96;02.09.2016;2016;09;19;Perjantai;71;28;99;7;11;18
96;02.09.2016;2016;09;20;Perjantai;46;21;67;10;9;19
96;02.09.2016;2016;09;21;Perjantai;36;26;62;3;4;7
96;02.09.2016;2016;09;22;Perjantai;15;7;22;0;4;4
96;02.09.2016;2016;09;23;Perjantai;10;8;18;0;2;2
96;03.09.2016;2016;09;00;Lauantai;9;3;12;3;2;5
96;03.09.2016;2016;09;01;Lauantai;11;10;21;1;0;1
96;03.09.2016;2016;09;02;Lauantai;5;0;5;1;1;2
96;03.09.2016;2016;09;03;Lauantai;2;4;6;0;1;1
96;03.09.2016;2016;09;04;Lauantai;6;1;7;0;0;0
96;03.09.2016;2016;09;05;Lauantai;1;3;4;2;0;2
96;03.09.2016;2016;09;06;Lauantai;17;5;22;2;1;3
96;03.09.2016;2016;09;07;Lauantai;10;20;30;4;1;5
96;03.09.2016;2016;09;08;Lauantai;11;36;47;5;6;11
96;03.09.2016;2016;09;09;Lauantai;15;35;50;4;6;10
96;03.09.2016;2016;09;10;Lauantai;34;47;81;7;3;10
96;03.09.2016;2016;09;11;Lauantai;64;43;107;7;8;15
96;03.09.2016;2016;09;12;Lauantai;64;73;137;7;15;22
96;03.09.2016;2016;09;13;Lauantai;78;90;168;12;12;24
96;03.09.2016;2016;09;14;Lauantai;76;105;181;9;11;20
96;03.09.2016;2016;09;15;Lauantai;78;61;139;8;12;20
96;03.09.2016;2016;09;16;Lauantai;75;49;124;12;6;18
96;03.09.2016;2016;09;17;Lauantai;71;42;113;16;13;29
96;03.09.2016;2016;09;18;Lauantai;73;25;98;15;15;30
96;03.09.2016;2016;09;19;Lauantai;42;38;80;16;18;34
96;03.09.2016;2016;09;20;Lauantai;38;38;76;9;11;20
96;03.09.2016;2016;09;21;Lauantai;23;31;54;3;7;10
96;03.09.2016;2016;09;22;Lauantai;16;12;28;0;1;1
96;03.09.2016;2016;09;23;Lauantai;13;12;25;0;2;2
96;04.09.2016;2016;09;00;Sunnuntai;5;6;11;0;0;0
96;04.09.2016;2016;09;01;Sunnuntai;17;7;24;0;0;0
96;04.09.2016;2016;09;02;Sunnuntai;10;3;13;0;0;0
96;04.09.2016;2016;09;03;Sunnuntai;13;5;18;3;1;4
96;04.09.2016;2016;09;04;Sunnuntai;4;0;4;3;0;3
96;04.09.2016;2016;09;05;Sunnuntai;3;3;6;1;0;1
96;04.09.2016;2016;09;06;Sunnuntai;17;4;21;2;0;2
96;04.09.2016;2016;09;07;Sunnuntai;0;13;13;3;2;5
96;04.09.2016;2016;09;08;Sunnuntai;5;11;16;3;7;10
96;04.09.2016;2016;09;09;Sunnuntai;13;18;31;6;6;12
96;04.09.2016;2016;09;10;Sunnuntai;15;41;56;11;11;22
96;04.09.2016;2016;09;11;Sunnuntai;31;42;73;14;16;30
96;04.09.2016;2016;09;12;Sunnuntai;69;52;121;8;11;19
96;04.09.2016;2016;09;13;Sunnuntai;66;66;132;7;15;22
96;04.09.2016;2016;09;14;Sunnuntai;49;63;112;15;15;30
96;04.09.2016;2016;09;15;Sunnuntai;55;53;108;7;12;19
96;04.09.2016;2016;09;16;Sunnuntai;68;46;114;27;8;35
96;04.09.2016;2016;09;17;Sunnuntai;57;52;109;14;14;28
96;04.09.2016;2016;09;18;Sunnuntai;45;59;104;14;20;34
96;04.09.2016;2016;09;19;Sunnuntai;38;55;93;12;19;31
96;04.09.2016;2016;09;20;Sunnuntai;32;42;74;7;13;20
96;04.09.2016;2016;09;21;Sunnuntai;32;31;63;5;2;7
96;04.09.2016;2016;09;22;Sunnuntai;7;9;16;1;0;1
96;04.09.2016;2016;09;23;Sunnuntai;6;5;11;0;0;0
96;05.09.2016;2016;09;00;Maanantai;3;0;3;2;1;3
96;05.09.2016;2016;09;01;Maanantai;2;0;2;0;0;0
96;05.09.2016;2016;09;02;Maanantai;1;0;1;0;0;0
96;05.09.2016;2016;09;03;Maanantai;1;1;2;0;2;2
96;05.09.2016;2016;09;04;Maanantai;1;0;1;0;0;0
96;05.09.2016;2016;09;05;Maanantai;5;8;13;0;0;0
96;05.09.2016;2016;09;06;Maanantai;49;38;87;4;2;6
96;05.09.2016;2016;09;07;Maanantai;181;176;357;22;7;29
96;05.09.2016;2016;09;08;Maanantai;170;169;339;10;15;25
96;05.09.2016;2016;09;09;Maanantai;170;121;291;24;8;32
96;05.09.2016;2016;09;10;Maanantai;110;120;230;7;13;20
96;05.09.2016;2016;09;11;Maanantai;124;124;248;38;26;64
96;05.09.2016;2016;09;12;Maanantai;169;116;285;32;48;80
96;05.09.2016;2016;09;13;Maanantai;104;107;211;13;16;29
96;05.09.2016;2016;09;14;Maanantai;113;189;302;13;22;35
96;05.09.2016;2016;09;15;Maanantai;131;295;426;10;46;56
96;05.09.2016;2016;09;16;Maanantai;175;183;358;9;28;37
96;05.09.2016;2016;09;17;Maanantai;113;90;203;14;15;29
96;05.09.2016;2016;09;18;Maanantai;105;74;179;23;11;34
96;05.09.2016;2016;09;19;Maanantai;100;59;159;23;23;46
96;05.09.2016;2016;09;20;Maanantai;69;42;111;12;22;34
96;05.09.2016;2016;09;21;Maanantai;33;45;78;4;12;16
96;05.09.2016;2016;09;22;Maanantai;16;7;23;1;3;4
96;05.09.2016;2016;09;23;Maanantai;4;4;8;0;0;0
96;06.09.2016;2016;09;00;Tiistai;2;2;4;2;0;2
96;06.09.2016;2016;09;01;Tiistai;0;0;0;0;0;0
96;06.09.2016;2016;09;02;Tiistai;3;1;4;0;0;0
96;06.09.2016;2016;09;03;Tiistai;0;0;0;0;0;0
96;06.09.2016;2016;09;04;Tiistai;2;1;3;0;0;0
96;06.09.2016;2016;09;05;Tiistai;7;8;15;1;0;1
96;06.09.2016;2016;09;06;Tiistai;74;29;103;3;3;6
96;06.09.2016;2016;09;07;Tiistai;220;211;431;24;9;33
96;06.09.2016;2016;09;08;Tiistai;172;168;340;15;5;20
96;06.09.2016;2016;09;09;Tiistai;164;101;265;18;9;27
96;06.09.2016;2016;09;10;Tiistai;118;150;268;10;11;21
96;06.09.2016;2016;09;11;Tiistai;124;136;260;12;30;42
96;06.09.2016;2016;09;12;Tiistai;184;278;462;15;70;85
96;06.09.2016;2016;09;13;Tiistai;129;158;287;20;10;30
96;06.09.2016;2016;09;14;Tiistai;180;182;362;44;17;61
96;06.09.2016;2016;09;15;Tiistai;141;320;461;19;33;52
96;06.09.2016;2016;09;16;Tiistai;158;176;334;21;33;54
96;06.09.2016;2016;09;17;Tiistai;101;108;209;26;23;49
96;06.09.2016;2016;09;18;Tiistai;78;80;158;15;22;37
96;06.09.2016;2016;09;19;Tiistai;91;68;159;12;25;37
96;06.09.2016;2016;09;20;Tiistai;77;50;127;14;22;36
96;06.09.2016;2016;09;21;Tiistai;32;77;109;4;18;22
96;06.09.2016;2016;09;22;Tiistai;16;21;37;0;10;10
96;06.09.2016;2016;09;23;Tiistai;22;3;25;9;0;9
96;07.09.2016;2016;09;00;Keskiviikko;42;6;48;9;2;11
96;07.09.2016;2016;09;01;Keskiviikko;44;3;47;18;0;18
96;07.09.2016;2016;09;02;Keskiviikko;17;0;17;1;0;1
96;07.09.2016;2016;09;03;Keskiviikko;10;0;10;2;0;2
96;07.09.2016;2016;09;04;Keskiviikko;3;3;6;0;0;0
96;07.09.2016;2016;09;05;Keskiviikko;1;1;2;1;0;1
96;07.09.2016;2016;09;06;Keskiviikko;14;19;33;1;0;1
96;07.09.2016;2016;09;07;Keskiviikko;107;66;173;13;3;16
96;07.09.2016;2016;09;08;Keskiviikko;222;207;429;17;13;30
96;07.09.2016;2016;09;09;Keskiviikko;162;139;301;22;13;35
96;07.09.2016;2016;09;10;Keskiviikko;120;107;227;11;10;21
96;07.09.2016;2016;09;11;Keskiviikko;135;127;262;11;24;35
96;07.09.2016;2016;09;12;Keskiviikko;197;115;312;15;18;33
96;07.09.2016;2016;09;13;Keskiviikko;143;110;253;20;22;42
96;07.09.2016;2016;09;14;Keskiviikko;83;163;246;9;24;33
96;07.09.2016;2016;09;15;Keskiviikko;132;189;321;10;21;31
96;07.09.2016;2016;09;16;Keskiviikko;121;277;398;9;27;36
96;07.09.2016;2016;09;17;Keskiviikko;114;121;235;25;14;39
96;07.09.2016;2016;09;18;Keskiviikko;93;80;173;13;15;28
96;07.09.2016;2016;09;19;Keskiviikko;121;62;183;19;7;26
96;07.09.2016;2016;09;20;Keskiviikko;62;52;114;16;19;35
96;07.09.2016;2016;09;21;Keskiviikko;46;96;142;10;23;33
96;07.09.2016;2016;09;22;Keskiviikko;30;54;84;2;4;6
96;07.09.2016;2016;09;23;Keskiviikko;13;5;18;3;0;3
96;08.09.2016;2016;09;00;Torstai;33;5;38;4;1;5
96;08.09.2016;2016;09;01;Torstai;27;8;35;19;12;31
96;08.09.2016;2016;09;02;Torstai;15;3;18;0;1;1
96;08.09.2016;2016;09;03;Torstai;4;1;5;2;1;3
96;08.09.2016;2016;09;04;Torstai;3;2;5;1;0;1
96;08.09.2016;2016;09;05;Torstai;3;2;5;2;0;2
96;08.09.2016;2016;09;06;Torstai;68;41;109;7;0;7
96;08.09.2016;2016;09;07;Torstai;204;178;382;20;11;31
96;08.09.2016;2016;09;08;Torstai;135;155;290;22;20;42
96;08.09.2016;2016;09;09;Torstai;174;120;294;12;10;22
96;08.09.2016;2016;09;10;Torstai;112;139;251;10;20;30
96;08.09.2016;2016;09;11;Torstai;111;117;228;11;21;32
96;08.09.2016;2016;09;12;Torstai;156;130;286;14;31;45
96;08.09.2016;2016;09;13;Torstai;137;150;287;17;9;26
96;08.09.2016;2016;09;14;Torstai;120;188;308;15;17;32
96;08.09.2016;2016;09;15;Torstai;122;277;399;7;25;32
96;08.09.2016;2016;09;16;Torstai;145;177;322;6;20;26
96;08.09.2016;2016;09;17;Torstai;89;92;181;14;14;28
96;08.09.2016;2016;09;18;Torstai;108;69;177;15;17;32
96;08.09.2016;2016;09;19;Torstai;90;39;129;9;8;17
96;08.09.2016;2016;09;20;Torstai;64;39;103;6;19;25
96;08.09.2016;2016;09;21;Torstai;37;48;85;5;7;12
96;08.09.2016;2016;09;22;Torstai;9;8;17;0;1;1
96;08.09.2016;2016;09;23;Torstai;4;5;9;0;1;1
96;09.09.2016;2016;09;00;Perjantai;3;5;8;0;0;0
96;09.09.2016;2016;09;01;Perjantai;6;0;6;0;0;0
96;09.09.2016;2016;09;02;Perjantai;0;0;0;0;0;0
96;09.09.2016;2016;09;03;Perjantai;0;0;0;0;0;0
96;09.09.2016;2016;09;04;Perjantai;3;1;4;0;0;0
96;09.09.2016;2016;09;05;Perjantai;6;8;14;0;1;1
96;09.09.2016;2016;09;06;Perjantai;56;30;86;4;1;5
96;09.09.2016;2016;09;07;Perjantai;204;159;363;16;5;21
96;09.09.2016;2016;09;08;Perjantai;142;118;260;13;9;22
96;09.09.2016;2016;09;09;Perjantai;135;124;259;17;11;28
96;09.09.2016;2016;09;10;Perjantai;103;132;235;9;12;21
96;09.09.2016;2016;09;11;Perjantai;109;118;227;10;24;34
96;09.09.2016;2016;09;12;Perjantai;144;149;293;10;29;39
96;09.09.2016;2016;09;13;Perjantai;86;150;236;12;11;23
96;09.09.2016;2016;09;14;Perjantai;107;213;320;18;23;41
96;09.09.2016;2016;09;15;Perjantai;106;167;273;11;14;25
96;09.09.2016;2016;09;16;Perjantai;104;115;219;17;22;39
96;09.09.2016;2016;09;17;Perjantai;64;61;125;9;9;18
96;09.09.2016;2016;09;18;Perjantai;62;48;110;5;11;16
96;09.09.2016;2016;09;19;Perjantai;45;45;90;8;13;21
96;09.09.2016;2016;09;20;Perjantai;57;24;81;11;3;14
96;09.09.2016;2016;09;21;Perjantai;28;39;67;0;7;7
96;09.09.2016;2016;09;22;Perjantai;15;13;28;2;1;3
96;09.09.2016;2016;09;23;Perjantai;11;8;19;3;1;4
96;10.09.2016;2016;09;00;Lauantai;12;6;18;2;1;3
96;10.09.2016;2016;09;01;Lauantai;8;0;8;3;2;5
96;10.09.2016;2016;09;02;Lauantai;6;2;8;1;0;1
96;10.09.2016;2016;09;03;Lauantai;8;1;9;1;0;1
96;10.09.2016;2016;09;04;Lauantai;9;1;10;0;0;0
96;10.09.2016;2016;09;05;Lauantai;3;2;5;0;0;0
96;10.09.2016;2016;09;06;Lauantai;25;3;28;0;1;1
96;10.09.2016;2016;09;07;Lauantai;9;21;30;1;1;2
96;10.09.2016;2016;09;08;Lauantai;10;22;32;3;6;9
96;10.09.2016;2016;09;09;Lauantai;16;33;49;6;8;14
96;10.09.2016;2016;09;10;Lauantai;22;49;71;5;2;7
96;10.09.2016;2016;09;11;Lauantai;24;50;74;5;7;12
96;10.09.2016;2016;09;12;Lauantai;57;53;110;7;15;22
96;10.09.2016;2016;09;13;Lauantai;38;64;102;11;8;19
96;10.09.2016;2016;09;14;Lauantai;47;60;107;10;17;27
96;10.09.2016;2016;09;15;Lauantai;64;70;134;7;14;21
96;10.09.2016;2016;09;16;Lauantai;45;51;96;19;20;39
96;10.09.2016;2016;09;17;Lauantai;49;27;76;10;12;22
96;10.09.2016;2016;09;18;Lauantai;70;50;120;16;13;29
96;10.09.2016;2016;09;19;Lauantai;29;21;50;11;7;18
96;10.09.2016;2016;09;20;Lauantai;27;52;79;6;16;22
96;10.09.2016;2016;09;21;Lauantai;36;33;69;11;5;16
96;10.09.2016;2016;09;22;Lauantai;12;18;30;2;4;6
96;10.09.2016;2016;09;23;Lauantai;7;13;20;1;0;1
96;11.09.2016;2016;09;00;Sunnuntai;8;6;14;0;0;0
96;11.09.2016;2016;09;01;Sunnuntai;8;0;8;0;3;3
96;11.09.2016;2016;09;02;Sunnuntai;9;1;10;0;0;0
96;11.09.2016;2016;09;03;Sunnuntai;18;2;20;2;0;2
96;11.09.2016;2016;09;04;Sunnuntai;10;2;12;1;3;4
96;11.09.2016;2016;09;05;Sunnuntai;5;1;6;2;1;3
96;11.09.2016;2016;09;06;Sunnuntai;30;2;32;3;0;3
96;11.09.2016;2016;09;07;Sunnuntai;6;12;18;1;2;3
96;11.09.2016;2016;09;08;Sunnuntai;13;15;28;5;8;13
96;11.09.2016;2016;09;09;Sunnuntai;7;22;29;4;5;9
96;11.09.2016;2016;09;10;Sunnuntai;21;22;43;13;7;20
96;11.09.2016;2016;09;11;Sunnuntai;43;50;93;7;16;23
96;11.09.2016;2016;09;12;Sunnuntai;37;44;81;5;11;16
96;11.09.2016;2016;09;13;Sunnuntai;48;52;100;10;16;26
96;11.09.2016;2016;09;14;Sunnuntai;55;67;122;5;13;18
96;11.09.2016;2016;09;15;Sunnuntai;45;77;122;8;11;19
96;11.09.2016;2016;09;16;Sunnuntai;82;47;129;18;20;38
96;11.09.2016;2016;09;17;Sunnuntai;51;30;81;17;15;32
96;11.09.2016;2016;09;18;Sunnuntai;65;62;127;21;28;49
96;11.09.2016;2016;09;19;Sunnuntai;41;24;65;15;22;37
96;11.09.2016;2016;09;20;Sunnuntai;23;32;55;10;9;19
96;11.09.2016;2016;09;21;Sunnuntai;18;30;48;9;1;10
96;11.09.2016;2016;09;22;Sunnuntai;1;4;5;1;1;2
96;11.09.2016;2016;09;23;Sunnuntai;3;0;3;1;1;2
96;12.09.2016;2016;09;00;Maanantai;3;1;4;1;0;1
96;12.09.2016;2016;09;01;Maanantai;1;0;1;0;0;0
96;12.09.2016;2016;09;02;Maanantai;4;1;5;0;0;0
96;12.09.2016;2016;09;03;Maanantai;1;1;2;0;0;0
96;12.09.2016;2016;09;04;Maanantai;3;0;3;0;0;0
96;12.09.2016;2016;09;05;Maanantai;3;9;12;0;0;0
96;12.09.2016;2016;09;06;Maanantai;51;31;82;2;1;3
96;12.09.2016;2016;09;07;Maanantai;175;125;300;30;7;37
96;12.09.2016;2016;09;08;Maanantai;153;111;264;13;13;26
96;12.09.2016;2016;09;09;Maanantai;130;86;216;10;14;24
96;12.09.2016;2016;09;10;Maanantai;56;61;117;9;5;14
96;12.09.2016;2016;09;11;Maanantai;82;80;162;7;9;16
96;12.09.2016;2016;09;12;Maanantai;104;62;166;14;12;26
96;12.09.2016;2016;09;13;Maanantai;72;95;167;5;7;12
96;12.09.2016;2016;09;14;Maanantai;97;168;265;8;23;31
96;12.09.2016;2016;09;15;Maanantai;127;245;372;13;33;46
96;12.09.2016;2016;09;16;Maanantai;116;165;281;13;23;36
96;12.09.2016;2016;09;17;Maanantai;85;94;179;8;13;21
96;12.09.2016;2016;09;18;Maanantai;107;65;172;15;18;33
96;12.09.2016;2016;09;19;Maanantai;66;60;126;21;21;42
96;12.09.2016;2016;09;20;Maanantai;69;41;110;19;15;34
96;12.09.2016;2016;09;21;Maanantai;35;39;74;10;6;16
96;12.09.2016;2016;09;22;Maanantai;9;11;20;3;5;8
96;12.09.2016;2016;09;23;Maanantai;7;3;10;0;2;2
96;13.09.2016;2016;09;00;Tiistai;1;0;1;0;2;2
96;13.09.2016;2016;09;01;Tiistai;1;1;2;0;0;0
96;13.09.2016;2016;09;02;Tiistai;0;0;0;0;0;0
96;13.09.2016;2016;09;03;Tiistai;0;1;1;0;0;0
96;13.09.2016;2016;09;04;Tiistai;4;1;5;1;0;1
96;13.09.2016;2016;09;05;Tiistai;5;7;12;0;0;0
96;13.09.2016;2016;09;06;Tiistai;63;46;109;2;2;4
96;13.09.2016;2016;09;07;Tiistai;200;157;357;20;5;25
96;13.09.2016;2016;09;08;Tiistai;144;146;290;11;8;19
96;13.09.2016;2016;09;09;Tiistai;146;125;271;23;30;53
96;13.09.2016;2016;09;10;Tiistai;105;97;202;22;10;32
96;13.09.2016;2016;09;11;Tiistai;103;114;217;23;18;41
96;13.09.2016;2016;09;12;Tiistai;147;104;251;15;9;24
96;13.09.2016;2016;09;13;Tiistai;117;105;222;25;21;46
96;13.09.2016;2016;09;14;Tiistai;98;192;290;17;18;35
96;13.09.2016;2016;09;15;Tiistai;147;334;481;12;29;41
96;13.09.2016;2016;09;16;Tiistai;179;200;379;14;30;44
96;13.09.2016;2016;09;17;Tiistai;118;116;234;11;15;26
96;13.09.2016;2016;09;18;Tiistai;101;76;177;17;22;39
96;13.09.2016;2016;09;19;Tiistai;83;55;138;13;10;23
96;13.09.2016;2016;09;20;Tiistai;89;45;134;13;13;26
96;13.09.2016;2016;09;21;Tiistai;29;47;76;3;9;12
96;13.09.2016;2016;09;22;Tiistai;10;10;20;3;1;4
96;13.09.2016;2016;09;23;Tiistai;3;1;4;1;1;2
96;14.09.2016;2016;09;00;Keskiviikko;6;3;9;0;2;2
96;14.09.2016;2016;09;01;Keskiviikko;6;2;8;1;0;1
96;14.09.2016;2016;09;02;Keskiviikko;3;1;4;0;0;0
96;14.09.2016;2016;09;03;Keskiviikko;1;1;2;0;0;0
96;14.09.2016;2016;09;04;Keskiviikko;1;2;3;3;0;3
96;14.09.2016;2016;09;05;Keskiviikko;6;7;13;0;1;1
96;14.09.2016;2016;09;06;Keskiviikko;78;37;115;7;2;9
96;14.09.2016;2016;09;07;Keskiviikko;163;153;316;19;9;28
96;14.09.2016;2016;09;08;Keskiviikko;179;131;310;6;5;11
96;14.09.2016;2016;09;09;Keskiviikko;107;111;218;12;6;18
96;14.09.2016;2016;09;10;Keskiviikko;68;70;138;5;7;12
96;14.09.2016;2016;09;11;Keskiviikko;126;93;219;15;14;29
96;14.09.2016;2016;09;12;Keskiviikko;125;130;255;11;13;24
96;14.09.2016;2016;09;13;Keskiviikko;105;104;209;11;17;28
96;14.09.2016;2016;09;14;Keskiviikko;98;198;296;11;19;30
96;14.09.2016;2016;09;15;Keskiviikko;111;275;386;13;27;40
96;14.09.2016;2016;09;16;Keskiviikko;145;203;348;13;22;35
96;14.09.2016;2016;09;17;Keskiviikko;104;94;198;19;18;37
96;14.09.2016;2016;09;18;Keskiviikko;141;68;209;25;9;34
96;14.09.2016;2016;09;19;Keskiviikko;97;58;155;17;25;42
96;14.09.2016;2016;09;20;Keskiviikko;65;79;144;10;16;26
96;14.09.2016;2016;09;21;Keskiviikko;32;44;76;8;6;14
96;14.09.2016;2016;09;22;Keskiviikko;11;13;24;1;1;2
96;14.09.2016;2016;09;23;Keskiviikko;9;3;12;2;0;2
96;15.09.2016;2016;09;00;Torstai;3;3;6;0;0;0
96;15.09.2016;2016;09;01;Torstai;3;1;4;0;0;0
96;15.09.2016;2016;09;02;Torstai;2;0;2;0;0;0
96;15.09.2016;2016;09;03;Torstai;5;0;5;0;1;1
96;15.09.2016;2016;09;04;Torstai;2;2;4;0;0;0
96;15.09.2016;2016;09;05;Torstai;3;5;8;0;0;0
96;15.09.2016;2016;09;06;Torstai;51;40;91;2;4;6
96;15.09.2016;2016;09;07;Torstai;147;150;297;19;6;25
96;15.09.2016;2016;09;08;Torstai;130;139;269;14;12;26
96;15.09.2016;2016;09;09;Torstai;132;86;218;16;10;26
96;15.09.2016;2016;09;10;Torstai;73;68;141;11;8;19
96;15.09.2016;2016;09;11;Torstai;89;84;173;8;10;18
96;15.09.2016;2016;09;12;Torstai;95;98;193;9;13;22
96;15.09.2016;2016;09;13;Torstai;97;93;190;9;18;27
96;15.09.2016;2016;09;14;Torstai;125;182;307;11;13;24
96;15.09.2016;2016;09;15;Torstai;122;284;406;9;20;29
96;15.09.2016;2016;09;16;Torstai;123;175;298;13;23;36
96;15.09.2016;2016;09;17;Torstai;94;102;196;10;14;24
96;15.09.2016;2016;09;18;Torstai;72;75;147;23;26;49
96;15.09.2016;2016;09;19;Torstai;78;64;142;11;15;26
96;15.09.2016;2016;09;20;Torstai;60;44;104;11;5;16
96;15.09.2016;2016;09;21;Torstai;39;40;79;7;6;13
96;15.09.2016;2016;09;22;Torstai;5;13;18;1;1;2
96;15.09.2016;2016;09;23;Torstai;5;2;7;0;0;0
96;16.09.2016;2016;09;00;Perjantai;8;0;8;0;0;0
96;16.09.2016;2016;09;01;Perjantai;5;2;7;0;0;0
96;16.09.2016;2016;09;02;Perjantai;6;3;9;0;0;0
96;16.09.2016;2016;09;03;Perjantai;2;2;4;1;0;1
96;16.09.2016;2016;09;04;Perjantai;3;2;5;0;1;1
96;16.09.2016;2016;09;05;Perjantai;7;12;19;1;0;1
96;16.09.2016;2016;09;06;Perjantai;53;24;77;2;0;2
96;16.09.2016;2016;09;07;Perjantai;167;125;292;14;7;21
96;16.09.2016;2016;09;08;Perjantai;152;103;255;9;6;15
96;16.09.2016;2016;09;09;Perjantai;92;114;206;10;11;21
96;16.09.2016;2016;09;10;Perjantai;73;71;144;13;8;21
96;16.09.2016;2016;09;11;Perjantai;77;102;179;8;8;16
96;16.09.2016;2016;09;12;Perjantai;106;141;247;10;17;27
96;16.09.2016;2016;09;13;Perjantai;105;125;230;22;23;45
96;16.09.2016;2016;09;14;Perjantai;110;188;298;6;24;30
96;16.09.2016;2016;09;15;Perjantai;110;231;341;8;33;41
96;16.09.2016;2016;09;16;Perjantai;107;103;210;14;30;44
96;16.09.2016;2016;09;17;Perjantai;71;75;146;11;13;24
96;16.09.2016;2016;09;18;Perjantai;68;61;129;15;17;32
96;16.09.2016;2016;09;19;Perjantai;68;37;105;6;5;11
96;16.09.2016;2016;09;20;Perjantai;40;28;68;6;6;12
96;16.09.2016;2016;09;21;Perjantai;18;35;53;5;0;5
96;16.09.2016;2016;09;22;Perjantai;17;10;27;1;1;2
96;16.09.2016;2016;09;23;Perjantai;9;12;21;1;2;3
96;17.09.2016;2016;09;00;Lauantai;8;1;9;1;0;1
96;17.09.2016;2016;09;01;Lauantai;16;0;16;0;0;0
96;17.09.2016;2016;09;02;Lauantai;4;2;6;0;1;1
96;17.09.2016;2016;09;03;Lauantai;10;4;14;1;0;1
96;17.09.2016;2016;09;04;Lauantai;3;1;4;2;1;3
96;17.09.2016;2016;09;05;Lauantai;2;2;4;2;0;2
96;17.09.2016;2016;09;06;Lauantai;27;1;28;2;2;4
96;17.09.2016;2016;09;07;Lauantai;6;16;22;2;2;4
96;17.09.2016;2016;09;08;Lauantai;9;17;26;5;3;8
96;17.09.2016;2016;09;09;Lauantai;12;53;65;4;8;12
96;17.09.2016;2016;09;10;Lauantai;17;55;72;6;5;11
96;17.09.2016;2016;09;11;Lauantai;44;53;97;7;14;21
96;17.09.2016;2016;09;12;Lauantai;53;63;116;12;11;23
96;17.09.2016;2016;09;13;Lauantai;74;70;144;11;12;23
96;17.09.2016;2016;09;14;Lauantai;77;65;142;12;16;28
96;17.09.2016;2016;09;15;Lauantai;88;51;139;13;6;19
96;17.09.2016;2016;09;16;Lauantai;52;41;93;10;8;18
96;17.09.2016;2016;09;17;Lauantai;63;45;108;10;6;16
96;17.09.2016;2016;09;18;Lauantai;67;34;101;18;9;27
96;17.09.2016;2016;09;19;Lauantai;37;28;65;9;5;14
96;17.09.2016;2016;09;20;Lauantai;29;39;68;5;10;15
96;17.09.2016;2016;09;21;Lauantai;21;31;52;0;5;5
96;17.09.2016;2016;09;22;Lauantai;11;15;26;2;2;4
96;17.09.2016;2016;09;23;Lauantai;4;9;13;2;7;9
96;18.09.2016;2016;09;00;Sunnuntai;9;5;14;0;0;0
96;18.09.2016;2016;09;01;Sunnuntai;5;1;6;1;0;1
96;18.09.2016;2016;09;02;Sunnuntai;10;2;12;1;0;1
96;18.09.2016;2016;09;03;Sunnuntai;9;0;9;2;0;2
96;18.09.2016;2016;09;04;Sunnuntai;10;0;10;2;4;6
96;18.09.2016;2016;09;05;Sunnuntai;1;1;2;1;0;1
96;18.09.2016;2016;09;06;Sunnuntai;19;4;23;3;1;4
96;18.09.2016;2016;09;07;Sunnuntai;2;8;10;2;4;6
96;18.09.2016;2016;09;08;Sunnuntai;6;9;15;2;2;4
96;18.09.2016;2016;09;09;Sunnuntai;18;24;42;9;8;17
96;18.09.2016;2016;09;10;Sunnuntai;17;30;47;12;14;26
96;18.09.2016;2016;09;11;Sunnuntai;28;71;99;15;23;38
96;18.09.2016;2016;09;12;Sunnuntai;50;73;123;12;11;23
96;18.09.2016;2016;09;13;Sunnuntai;79;54;133;26;11;37
96;18.09.2016;2016;09;14;Sunnuntai;62;87;149;18;16;34
96;18.09.2016;2016;09;15;Sunnuntai;74;45;119;9;14;23
96;18.09.2016;2016;09;16;Sunnuntai;87;43;130;31;10;41
96;18.09.2016;2016;09;17;Sunnuntai;67;46;113;23;20;43
96;18.09.2016;2016;09;18;Sunnuntai;75;55;130;13;35;48
96;18.09.2016;2016;09;19;Sunnuntai;42;31;73;13;14;27
96;18.09.2016;2016;09;20;Sunnuntai;25;40;65;6;12;18
96;18.09.2016;2016;09;21;Sunnuntai;28;22;50;4;4;8
96;18.09.2016;2016;09;22;Sunnuntai;8;4;12;2;2;4
96;18.09.2016;2016;09;23;Sunnuntai;4;1;5;2;0;2
96;19.09.2016;2016;09;00;Maanantai;7;5;12;0;0;0
96;19.09.2016;2016;09;01;Maanantai;2;1;3;0;0;0
96;19.09.2016;2016;09;02;Maanantai;1;0;1;1;0;1
96;19.09.2016;2016;09;03;Maanantai;1;2;3;0;1;1
96;19.09.2016;2016;09;04;Maanantai;2;2;4;0;0;0
96;19.09.2016;2016;09;05;Maanantai;4;7;11;0;1;1
96;19.09.2016;2016;09;06;Maanantai;52;33;85;4;2;6
96;19.09.2016;2016;09;07;Maanantai;147;142;289;22;8;30
96;19.09.2016;2016;09;08;Maanantai;172;113;285;7;11;18
96;19.09.2016;2016;09;09;Maanantai;132;70;202;11;8;19
96;19.09.2016;2016;09;10;Maanantai;66;70;136;9;9;18
96;19.09.2016;2016;09;11;Maanantai;73;101;174;10;15;25
96;19.09.2016;2016;09;12;Maanantai;130;123;253;19;13;32
96;19.09.2016;2016;09;13;Maanantai;91;101;192;8;11;19
96;19.09.2016;2016;09;14;Maanantai;78;173;251;6;15;21
96;19.09.2016;2016;09;15;Maanantai;130;324;454;7;27;34
96;19.09.2016;2016;09;16;Maanantai;140;156;296;13;18;31
96;19.09.2016;2016;09;17;Maanantai;94;104;198;19;16;35
96;19.09.2016;2016;09;18;Maanantai;93;73;166;23;12;35
96;19.09.2016;2016;09;19;Maanantai;71;56;127;17;14;31
96;19.09.2016;2016;09;20;Maanantai;65;34;99;12;16;28
96;19.09.2016;2016;09;21;Maanantai;35;43;78;8;3;11
96;19.09.2016;2016;09;22;Maanantai;10;6;16;1;0;1
96;19.09.2016;2016;09;23;Maanantai;3;4;7;0;0;0
96;20.09.2016;2016;09;00;Tiistai;2;1;3;0;1;1
96;20.09.2016;2016;09;01;Tiistai;0;0;0;0;0;0
96;20.09.2016;2016;09;02;Tiistai;0;0;0;0;0;0
96;20.09.2016;2016;09;03;Tiistai;0;0;0;1;0;1
96;20.09.2016;2016;09;04;Tiistai;2;1;3;0;0;0
96;20.09.2016;2016;09;05;Tiistai;6;6;12;2;0;2
96;20.09.2016;2016;09;06;Tiistai;54;37;91;3;2;5
96;20.09.2016;2016;09;07;Tiistai;211;158;369;26;6;32
96;20.09.2016;2016;09;08;Tiistai;167;128;295;11;12;23
96;20.09.2016;2016;09;09;Tiistai;121;94;215;10;11;21
96;20.09.2016;2016;09;10;Tiistai;63;59;122;20;13;33
96;20.09.2016;2016;09;11;Tiistai;85;98;183;9;10;19
96;20.09.2016;2016;09;12;Tiistai;135;111;246;10;17;27
96;20.09.2016;2016;09;13;Tiistai;78;112;190;8;16;24
96;20.09.2016;2016;09;14;Tiistai;113;179;292;10;20;30
96;20.09.2016;2016;09;15;Tiistai;118;327;445;7;28;35
96;20.09.2016;2016;09;16;Tiistai;123;180;303;18;37;55
96;20.09.2016;2016;09;17;Tiistai;86;107;193;10;20;30
96;20.09.2016;2016;09;18;Tiistai;78;86;164;15;14;29
96;20.09.2016;2016;09;19;Tiistai;76;49;125;6;15;21
96;20.09.2016;2016;09;20;Tiistai;91;37;128;14;8;22
96;20.09.2016;2016;09;21;Tiistai;38;36;74;8;3;11
96;20.09.2016;2016;09;22;Tiistai;7;8;15;1;0;1
96;20.09.2016;2016;09;23;Tiistai;5;6;11;1;0;1
96;21.09.2016;2016;09;00;Keskiviikko;6;3;9;0;0;0
96;21.09.2016;2016;09;01;Keskiviikko;3;1;4;1;0;1
96;21.09.2016;2016;09;02;Keskiviikko;0;1;1;0;0;0
96;21.09.2016;2016;09;03;Keskiviikko;0;1;1;0;0;0
96;21.09.2016;2016;09;04;Keskiviikko;2;1;3;1;1;2
96;21.09.2016;2016;09;05;Keskiviikko;5;10;15;0;0;0
96;21.09.2016;2016;09;06;Keskiviikko;66;35;101;2;0;2
96;21.09.2016;2016;09;07;Keskiviikko;164;156;320;17;7;24
96;21.09.2016;2016;09;08;Keskiviikko;155;140;295;12;14;26
96;21.09.2016;2016;09;09;Keskiviikko;128;100;228;12;11;23
96;21.09.2016;2016;09;10;Keskiviikko;63;86;149;2;10;12
96;21.09.2016;2016;09;11;Keskiviikko;94;84;178;13;7;20
96;21.09.2016;2016;09;12;Keskiviikko;116;101;217;7;15;22
96;21.09.2016;2016;09;13;Keskiviikko;115;129;244;24;23;47
96;21.09.2016;2016;09;14;Keskiviikko;112;217;329;15;26;41
96;21.09.2016;2016;09;15;Keskiviikko;115;249;364;12;24;36
96;21.09.2016;2016;09;16;Keskiviikko;156;190;346;8;25;33
96;21.09.2016;2016;09;17;Keskiviikko;80;85;165;15;22;37
96;21.09.2016;2016;09;18;Keskiviikko;114;53;167;15;21;36
96;21.09.2016;2016;09;19;Keskiviikko;69;52;121;15;20;35
96;21.09.2016;2016;09;20;Keskiviikko;58;75;133;13;19;32
96;21.09.2016;2016;09;21;Keskiviikko;21;41;62;3;7;10
96;21.09.2016;2016;09;22;Keskiviikko;14;7;21;5;1;6
96;21.09.2016;2016;09;23;Keskiviikko;9;3;12;2;0;2
96;22.09.2016;2016;09;00;Torstai;9;4;13;1;1;2
96;22.09.2016;2016;09;01;Torstai;5;0;5;2;0;2
96;22.09.2016;2016;09;02;Torstai;3;0;3;1;0;1
96;22.09.2016;2016;09;03;Torstai;5;0;5;1;0;1
96;22.09.2016;2016;09;04;Torstai;4;0;4;2;0;2
96;22.09.2016;2016;09;05;Torstai;7;7;14;1;0;1
96;22.09.2016;2016;09;06;Torstai;57;35;92;4;2;6
96;22.09.2016;2016;09;07;Torstai;155;150;305;25;6;31
96;22.09.2016;2016;09;08;Torstai;168;155;323;18;13;31
96;22.09.2016;2016;09;09;Torstai;102;84;186;10;6;16
96;22.09.2016;2016;09;10;Torstai;65;85;150;12;15;27
96;22.09.2016;2016;09;11;Torstai;85;76;161;13;10;23
96;22.09.2016;2016;09;12;Torstai;113;105;218;9;10;19
96;22.09.2016;2016;09;13;Torstai;95;155;250;10;18;28
96;22.09.2016;2016;09;14;Torstai;108;163;271;9;19;28
96;22.09.2016;2016;09;15;Torstai;137;273;410;7;32;39
96;22.09.2016;2016;09;16;Torstai;134;152;286;9;17;26
96;22.09.2016;2016;09;17;Torstai;102;59;161;13;17;30
96;22.09.2016;2016;09;18;Torstai;78;52;130;14;14;28
96;22.09.2016;2016;09;19;Torstai;68;38;106;8;12;20
96;22.09.2016;2016;09;20;Torstai;47;32;79;12;8;20
96;22.09.2016;2016;09;21;Torstai;30;41;71;4;5;9
96;22.09.2016;2016;09;22;Torstai;18;11;29;2;3;5
96;22.09.2016;2016;09;23;Torstai;3;3;6;3;2;5
96;23.09.2016;2016;09;00;Perjantai;1;1;2;0;0;0
96;23.09.2016;2016;09;01;Perjantai;3;0;3;1;0;1
96;23.09.2016;2016;09;02;Perjantai;1;0;1;1;0;1
96;23.09.2016;2016;09;03;Perjantai;6;0;6;0;0;0
96;23.09.2016;2016;09;04;Perjantai;3;1;4;1;0;1
96;23.09.2016;2016;09;05;Perjantai;4;9;13;0;0;0
96;23.09.2016;2016;09;06;Perjantai;55;42;97;21;9;30
96;23.09.2016;2016;09;07;Perjantai;156;112;268;15;9;24
96;23.09.2016;2016;09;08;Perjantai;120;121;241;32;29;61
96;23.09.2016;2016;09;09;Perjantai;109;89;198;13;12;25
96;23.09.2016;2016;09;10;Perjantai;58;93;151;5;14;19
96;23.09.2016;2016;09;11;Perjantai;75;127;202;9;14;23
96;23.09.2016;2016;09;12;Perjantai;125;148;273;19;26;45
96;23.09.2016;2016;09;13;Perjantai;83;148;231;12;13;25
96;23.09.2016;2016;09;14;Perjantai;80;178;258;11;31;42
96;23.09.2016;2016;09;15;Perjantai;104;184;288;7;19;26
96;23.09.2016;2016;09;16;Perjantai;102;93;195;10;6;16
96;23.09.2016;2016;09;17;Perjantai;58;67;125;11;12;23
96;23.09.2016;2016;09;18;Perjantai;50;44;94;12;14;26
96;23.09.2016;2016;09;19;Perjantai;51;25;76;7;7;14
96;23.09.2016;2016;09;20;Perjantai;48;27;75;9;6;15
96;23.09.2016;2016;09;21;Perjantai;17;29;46;2;8;10
96;23.09.2016;2016;09;22;Perjantai;13;19;32;2;2;4
96;23.09.2016;2016;09;23;Perjantai;14;10;24;2;3;5
96;24.09.2016;2016;09;00;Lauantai;5;13;18;2;0;2
96;24.09.2016;2016;09;01;Lauantai;12;3;15;2;1;3
96;24.09.2016;2016;09;02;Lauantai;6;0;6;0;0;0
96;24.09.2016;2016;09;03;Lauantai;5;2;7;1;0;1
96;24.09.2016;2016;09;04;Lauantai;1;1;2;4;0;4
96;24.09.2016;2016;09;05;Lauantai;4;4;8;2;0;2
96;24.09.2016;2016;09;06;Lauantai;33;10;43;2;0;2
96;24.09.2016;2016;09;07;Lauantai;9;23;32;0;1;1
96;24.09.2016;2016;09;08;Lauantai;7;18;25;6;9;15
96;24.09.2016;2016;09;09;Lauantai;5;32;37;5;6;11
96;24.09.2016;2016;09;10;Lauantai;20;46;66;8;13;21
96;24.09.2016;2016;09;11;Lauantai;38;58;96;10;14;24
96;24.09.2016;2016;09;12;Lauantai;55;57;112;12;14;26
96;24.09.2016;2016;09;13;Lauantai;52;55;107;14;14;28
96;24.09.2016;2016;09;14;Lauantai;59;85;144;14;10;24
96;24.09.2016;2016;09;15;Lauantai;63;72;135;14;10;24
96;24.09.2016;2016;09;16;Lauantai;50;73;123;11;14;25
96;24.09.2016;2016;09;17;Lauantai;65;53;118;12;3;15
96;24.09.2016;2016;09;18;Lauantai;47;38;85;18;9;27
96;24.09.2016;2016;09;19;Lauantai;72;33;105;17;7;24
96;24.09.2016;2016;09;20;Lauantai;29;30;59;3;4;7
96;24.09.2016;2016;09;21;Lauantai;15;41;56;3;6;9
96;24.09.2016;2016;09;22;Lauantai;9;10;19;3;1;4
96;24.09.2016;2016;09;23;Lauantai;17;13;30;1;3;4
96;25.09.2016;2016;09;00;Sunnuntai;13;16;29;2;1;3
96;25.09.2016;2016;09;01;Sunnuntai;13;6;19;0;0;0
96;25.09.2016;2016;09;02;Sunnuntai;14;5;19;1;0;1
96;25.09.2016;2016;09;03;Sunnuntai;13;1;14;3;0;3
96;25.09.2016;2016;09;04;Sunnuntai;9;1;10;2;1;3
96;25.09.2016;2016;09;05;Sunnuntai;2;0;2;0;0;0
96;25.09.2016;2016;09;06;Sunnuntai;28;6;34;4;0;4
96;25.09.2016;2016;09;07;Sunnuntai;4;13;17;2;2;4
96;25.09.2016;2016;09;08;Sunnuntai;3;11;14;1;4;5
96;25.09.2016;2016;09;09;Sunnuntai;19;20;39;8;5;13
96;25.09.2016;2016;09;10;Sunnuntai;20;34;54;6;7;13
96;25.09.2016;2016;09;11;Sunnuntai;38;48;86;4;19;23
96;25.09.2016;2016;09;12;Sunnuntai;42;55;97;12;12;24
96;25.09.2016;2016;09;13;Sunnuntai;55;67;122;9;12;21
96;25.09.2016;2016;09;14;Sunnuntai;56;57;113;7;9;16
96;25.09.2016;2016;09;15;Sunnuntai;45;59;104;14;14;28
96;25.09.2016;2016;09;16;Sunnuntai;68;47;115;23;19;42
96;25.09.2016;2016;09;17;Sunnuntai;53;34;87;12;10;22
96;25.09.2016;2016;09;18;Sunnuntai;72;56;128;13;18;31
96;25.09.2016;2016;09;19;Sunnuntai;32;55;87;12;13;25
96;25.09.2016;2016;09;20;Sunnuntai;34;29;63;3;10;13
96;25.09.2016;2016;09;21;Sunnuntai;18;27;45;2;5;7
96;25.09.2016;2016;09;22;Sunnuntai;8;6;14;2;1;3
96;25.09.2016;2016;09;23;Sunnuntai;1;1;2;5;1;6
96;26.09.2016;2016;09;00;Maanantai;7;3;10;1;0;1
96;26.09.2016;2016;09;01;Maanantai;2;2;4;1;0;1
96;26.09.2016;2016;09;02;Maanantai;5;0;5;0;0;0
96;26.09.2016;2016;09;03;Maanantai;1;0;1;0;0;0
96;26.09.2016;2016;09;04;Maanantai;0;0;0;0;1;1
96;26.09.2016;2016;09;05;Maanantai;5;7;12;0;1;1
96;26.09.2016;2016;09;06;Maanantai;46;43;89;10;0;10
96;26.09.2016;2016;09;07;Maanantai;142;148;290;18;5;23
96;26.09.2016;2016;09;08;Maanantai;159;140;299;9;6;15
96;26.09.2016;2016;09;09;Maanantai;102;89;191;14;26;40
96;26.09.2016;2016;09;10;Maanantai;59;85;144;11;10;21
96;26.09.2016;2016;09;11;Maanantai;70;79;149;8;8;16
96;26.09.2016;2016;09;12;Maanantai;92;133;225;12;13;25
96;26.09.2016;2016;09;13;Maanantai;75;120;195;8;13;21
96;26.09.2016;2016;09;14;Maanantai;90;168;258;10;15;25
96;26.09.2016;2016;09;15;Maanantai;95;247;342;6;19;25
96;26.09.2016;2016;09;16;Maanantai;150;158;308;11;25;36
96;26.09.2016;2016;09;17;Maanantai;81;100;181;11;14;25
96;26.09.2016;2016;09;18;Maanantai;88;64;152;17;18;35
96;26.09.2016;2016;09;19;Maanantai;66;51;117;5;8;13
96;26.09.2016;2016;09;20;Maanantai;50;47;97;8;17;25
96;26.09.2016;2016;09;21;Maanantai;32;37;69;2;3;5
96;26.09.2016;2016;09;22;Maanantai;8;9;17;0;2;2
96;26.09.2016;2016;09;23;Maanantai;6;2;8;0;0;0
96;27.09.2016;2016;09;00;Tiistai;0;2;2;0;0;0
96;27.09.2016;2016;09;01;Tiistai;4;0;4;0;0;0
96;27.09.2016;2016;09;02;Tiistai;2;0;2;0;0;0
96;27.09.2016;2016;09;03;Tiistai;1;0;1;0;0;0
96;27.09.2016;2016;09;04;Tiistai;1;2;3;0;0;0
96;27.09.2016;2016;09;05;Tiistai;2;9;11;0;0;0
96;27.09.2016;2016;09;06;Tiistai;58;42;100;6;2;8
96;27.09.2016;2016;09;07;Tiistai;175;146;321;20;4;24
96;27.09.2016;2016;09;08;Tiistai;170;137;307;38;40;78
96;27.09.2016;2016;09;09;Tiistai;101;111;212;17;22;39
96;27.09.2016;2016;09;10;Tiistai;79;91;170;17;12;29
96;27.09.2016;2016;09;11;Tiistai;95;102;197;14;18;32
96;27.09.2016;2016;09;12;Tiistai;116;85;201;15;13;28
96;27.09.2016;2016;09;13;Tiistai;95;131;226;8;24;32
96;27.09.2016;2016;09;14;Tiistai;90;189;279;3;22;25
96;27.09.2016;2016;09;15;Tiistai;109;288;397;3;24;27
96;27.09.2016;2016;09;16;Tiistai;132;187;319;12;16;28
96;27.09.2016;2016;09;17;Tiistai;100;102;202;7;14;21
96;27.09.2016;2016;09;18;Tiistai;110;83;193;10;14;24
96;27.09.2016;2016;09;19;Tiistai;89;45;134;16;17;33
96;27.09.2016;2016;09;20;Tiistai;65;54;119;7;8;15
96;27.09.2016;2016;09;21;Tiistai;28;26;54;7;8;15
96;27.09.2016;2016;09;22;Tiistai;8;7;15;1;1;2
96;27.09.2016;2016;09;23;Tiistai;3;2;5;1;1;2
96;28.09.2016;2016;09;00;Keskiviikko;2;0;2;0;0;0
96;28.09.2016;2016;09;01;Keskiviikko;2;3;5;0;0;0
96;28.09.2016;2016;09;02;Keskiviikko;0;0;0;0;0;0
96;28.09.2016;2016;09;03;Keskiviikko;4;0;4;0;0;0
96;28.09.2016;2016;09;04;Keskiviikko;1;0;1;0;0;0
96;28.09.2016;2016;09;05;Keskiviikko;4;9;13;0;0;0
96;28.09.2016;2016;09;06;Keskiviikko;56;42;98;1;2;3
96;28.09.2016;2016;09;07;Keskiviikko;145;141;286;27;11;38
96;28.09.2016;2016;09;08;Keskiviikko;132;132;264;11;7;18
96;28.09.2016;2016;09;09;Keskiviikko;103;115;218;15;12;27
96;28.09.2016;2016;09;10;Keskiviikko;51;83;134;6;15;21
96;28.09.2016;2016;09;11;Keskiviikko;103;118;221;11;8;19
96;28.09.2016;2016;09;12;Keskiviikko;122;118;240;14;15;29
96;28.09.2016;2016;09;13;Keskiviikko;89;88;177;29;45;74
96;28.09.2016;2016;09;14;Keskiviikko;81;200;281;10;19;29
96;28.09.2016;2016;09;15;Keskiviikko;101;205;306;7;18;25
96;28.09.2016;2016;09;16;Keskiviikko;109;117;226;4;13;17
96;28.09.2016;2016;09;17;Keskiviikko;78;50;128;4;9;13
96;28.09.2016;2016;09;18;Keskiviikko;84;43;127;6;1;7
96;28.09.2016;2016;09;19;Keskiviikko;47;46;93;8;9;17
96;28.09.2016;2016;09;20;Keskiviikko;31;32;63;6;7;13
96;28.09.2016;2016;09;21;Keskiviikko;21;26;47;5;6;11
96;28.09.2016;2016;09;22;Keskiviikko;5;7;12;0;0;0
96;28.09.2016;2016;09;23;Keskiviikko;1;1;2;2;0;2
96;29.09.2016;2016;09;00;Torstai;0;2;2;1;0;1
96;29.09.2016;2016;09;01;Torstai;1;0;1;0;0;0
96;29.09.2016;2016;09;02;Torstai;1;0;1;0;0;0
96;29.09.2016;2016;09;03;Torstai;1;0;1;0;0;0
96;29.09.2016;2016;09;04;Torstai;1;0;1;1;0;1
96;29.09.2016;2016;09;05;Torstai;4;6;10;1;0;1
96;29.09.2016;2016;09;06;Torstai;50;38;88;7;3;10
96;29.09.2016;2016;09;07;Torstai;145;121;266;17;1;18
96;29.09.2016;2016;09;08;Torstai;121;132;253;16;20;36
96;29.09.2016;2016;09;09;Torstai;114;89;203;18;30;48
96;29.09.2016;2016;09;10;Torstai;51;80;131;7;15;22
96;29.09.2016;2016;09;11;Torstai;68;90;158;11;13;24
96;29.09.2016;2016;09;12;Torstai;116;111;227;22;13;35
96;29.09.2016;2016;09;13;Torstai;70;117;187;11;15;26
96;29.09.2016;2016;09;14;Torstai;72;183;255;6;25;31
96;29.09.2016;2016;09;15;Torstai;117;230;347;10;24;34
96;29.09.2016;2016;09;16;Torstai;107;150;257;14;13;27
96;29.09.2016;2016;09;17;Torstai;74;84;158;10;25;35
96;29.09.2016;2016;09;18;Torstai;76;76;152;15;11;26
96;29.09.2016;2016;09;19;Torstai;56;25;81;4;16;20
96;29.09.2016;2016;09;20;Torstai;55;37;92;5;2;7
96;29.09.2016;2016;09;21;Torstai;20;25;45;1;5;6
96;29.09.2016;2016;09;22;Torstai;10;8;18;2;1;3
96;29.09.2016;2016;09;23;Torstai;4;2;6;1;0;1
96;30.09.2016;2016;09;00;Perjantai;3;1;4;1;0;1
96;30.09.2016;2016;09;01;Perjantai;2;0;2;0;0;0
96;30.09.2016;2016;09;02;Perjantai;3;1;4;0;0;0
96;30.09.2016;2016;09;03;Perjantai;0;1;1;0;0;0
96;30.09.2016;2016;09;04;Perjantai;2;1;3;0;0;0
96;30.09.2016;2016;09;05;Perjantai;3;7;10;0;0;0
96;30.09.2016;2016;09;06;Perjantai;46;28;74;7;4;11
96;30.09.2016;2016;09;07;Perjantai;126;124;250;17;3;20
96;30.09.2016;2016;09;08;Perjantai;135;104;239;13;7;20
96;30.09.2016;2016;09;09;Perjantai;79;94;173;10;22;32
96;30.09.2016;2016;09;10;Perjantai;59;71;130;14;13;27
96;30.09.2016;2016;09;11;Perjantai;74;82;156;8;9;17
96;30.09.2016;2016;09;12;Perjantai;106;101;207;10;15;25
96;30.09.2016;2016;09;13;Perjantai;70;169;239;6;22;28
96;30.09.2016;2016;09;14;Perjantai;79;198;277;8;16;24
96;30.09.2016;2016;09;15;Perjantai;79;190;269;2;21;23
96;30.09.2016;2016;09;16;Perjantai;94;63;157;10;13;23
96;30.09.2016;2016;09;17;Perjantai;60;62;122;9;8;17
96;30.09.2016;2016;09;18;Perjantai;58;58;116;9;3;12
96;30.09.2016;2016;09;19;Perjantai;49;34;83;3;10;13
96;30.09.2016;2016;09;20;Perjantai;26;28;54;6;7;13
96;30.09.2016;2016;09;21;Perjantai;35;24;59;1;3;4
96;30.09.2016;2016;09;22;Perjantai;8;12;20;4;0;4
96;30.09.2016;2016;09;23;Perjantai;9;3;12;1;1;2
96;01.10.2016;2016;10;00;Lauantai;10;2;12;2;0;2
96;01.10.2016;2016;10;01;Lauantai;10;0;10;1;0;1
96;01.10.2016;2016;10;02;Lauantai;6;0;6;3;0;3
96;01.10.2016;2016;10;03;Lauantai;11;1;12;1;0;1
96;01.10.2016;2016;10;04;Lauantai;3;3;6;1;0;1
96;01.10.2016;2016;10;05;Lauantai;0;5;5;1;4;5
96;01.10.2016;2016;10;06;Lauantai;20;5;25;1;0;1
96;01.10.2016;2016;10;07;Lauantai;7;13;20;7;2;9
96;01.10.2016;2016;10;08;Lauantai;18;22;40;11;4;15
96;01.10.2016;2016;10;09;Lauantai;16;63;79;11;22;33
96;01.10.2016;2016;10;10;Lauantai;25;61;86;9;35;44
96;01.10.2016;2016;10;11;Lauantai;51;45;96;18;28;46
96;01.10.2016;2016;10;12;Lauantai;76;56;132;39;14;53
96;01.10.2016;2016;10;13;Lauantai;81;63;144;24;14;38
96;01.10.2016;2016;10;14;Lauantai;55;60;115;10;13;23
96;01.10.2016;2016;10;15;Lauantai;57;73;130;14;11;25
96;01.10.2016;2016;10;16;Lauantai;42;59;101;13;18;31
96;01.10.2016;2016;10;17;Lauantai;76;45;121;37;17;54
96;01.10.2016;2016;10;18;Lauantai;38;34;72;8;6;14
96;01.10.2016;2016;10;19;Lauantai;31;20;51;14;15;29
96;01.10.2016;2016;10;20;Lauantai;12;25;37;6;11;17
96;01.10.2016;2016;10;21;Lauantai;21;52;73;3;16;19
96;01.10.2016;2016;10;22;Lauantai;9;18;27;3;8;11
96;01.10.2016;2016;10;23;Lauantai;11;8;19;0;1;1
96;02.10.2016;2016;10;00;Sunnuntai;16;9;25;2;0;2
96;02.10.2016;2016;10;01;Sunnuntai;12;15;27;2;0;2
96;02.10.2016;2016;10;02;Sunnuntai;13;3;16;0;0;0
96;02.10.2016;2016;10;03;Sunnuntai;13;0;13;4;1;5
96;02.10.2016;2016;10;04;Sunnuntai;10;3;13;3;0;3
96;02.10.2016;2016;10;05;Sunnuntai;4;1;5;0;0;0
96;02.10.2016;2016;10;06;Sunnuntai;12;3;15;1;0;1
96;02.10.2016;2016;10;07;Sunnuntai;2;13;15;0;0;0
96;02.10.2016;2016;10;08;Sunnuntai;10;13;23;4;9;13
96;02.10.2016;2016;10;09;Sunnuntai;10;19;29;6;5;11
96;02.10.2016;2016;10;10;Sunnuntai;25;26;51;11;15;26
96;02.10.2016;2016;10;11;Sunnuntai;33;39;72;7;16;23
96;02.10.2016;2016;10;12;Sunnuntai;57;46;103;12;10;22
96;02.10.2016;2016;10;13;Sunnuntai;46;60;106;6;9;15
96;02.10.2016;2016;10;14;Sunnuntai;62;61;123;8;24;32
96;02.10.2016;2016;10;15;Sunnuntai;53;54;107;4;16;20
96;02.10.2016;2016;10;16;Sunnuntai;83;44;127;29;10;39
96;02.10.2016;2016;10;17;Sunnuntai;53;48;101;12;13;25
96;02.10.2016;2016;10;18;Sunnuntai;44;40;84;16;25;41
96;02.10.2016;2016;10;19;Sunnuntai;30;28;58;9;12;21
96;02.10.2016;2016;10;20;Sunnuntai;21;52;73;10;16;26
96;02.10.2016;2016;10;21;Sunnuntai;23;17;40;1;6;7
96;02.10.2016;2016;10;22;Sunnuntai;5;6;11;1;1;2
96;02.10.2016;2016;10;23;Sunnuntai;2;5;7;1;1;2
96;03.10.2016;2016;10;00;Maanantai;5;1;6;0;1;1
96;03.10.2016;2016;10;01;Maanantai;2;2;4;0;0;0
96;03.10.2016;2016;10;02;Maanantai;0;0;0;0;2;2
96;03.10.2016;2016;10;03;Maanantai;1;1;2;0;0;0
96;03.10.2016;2016;10;04;Maanantai;0;2;2;1;1;2
96;03.10.2016;2016;10;05;Maanantai;5;5;10;0;2;2
96;03.10.2016;2016;10;06;Maanantai;58;34;92;4;0;4
96;03.10.2016;2016;10;07;Maanantai;156;137;293;21;5;26
96;03.10.2016;2016;10;08;Maanantai;157;118;275;12;4;16
96;03.10.2016;2016;10;09;Maanantai;116;83;199;12;6;18
96;03.10.2016;2016;10;10;Maanantai;69;81;150;9;10;19
96;03.10.2016;2016;10;11;Maanantai;82;113;195;15;16;31
96;03.10.2016;2016;10;12;Maanantai;111;97;208;10;10;20
96;03.10.2016;2016;10;13;Maanantai;85;91;176;5;15;20
96;03.10.2016;2016;10;14;Maanantai;93;167;260;12;24;36
96;03.10.2016;2016;10;15;Maanantai;107;269;376;15;22;37
96;03.10.2016;2016;10;16;Maanantai;165;187;352;16;19;35
96;03.10.2016;2016;10;17;Maanantai;90;104;194;10;13;23
96;03.10.2016;2016;10;18;Maanantai;87;62;149;10;9;19
96;03.10.2016;2016;10;19;Maanantai;64;52;116;10;16;26
96;03.10.2016;2016;10;20;Maanantai;47;34;81;8;10;18
96;03.10.2016;2016;10;21;Maanantai;29;36;65;8;7;15
96;03.10.2016;2016;10;22;Maanantai;5;6;11;0;1;1
96;03.10.2016;2016;10;23;Maanantai;4;3;7;0;1;1
96;04.10.2016;2016;10;00;Tiistai;5;2;7;0;0;0
96;04.10.2016;2016;10;01;Tiistai;2;0;2;0;0;0
96;04.10.2016;2016;10;02;Tiistai;0;0;0;0;0;0
96;04.10.2016;2016;10;03;Tiistai;1;0;1;0;1;1
96;04.10.2016;2016;10;04;Tiistai;2;0;2;0;0;0
96;04.10.2016;2016;10;05;Tiistai;3;6;9;0;1;1
96;04.10.2016;2016;10;06;Tiistai;63;38;101;4;1;5
96;04.10.2016;2016;10;07;Tiistai;178;131;309;22;9;31
96;04.10.2016;2016;10;08;Tiistai;176;116;292;11;14;25
96;04.10.2016;2016;10;09;Tiistai;108;85;193;9;9;18
96;04.10.2016;2016;10;10;Tiistai;68;53;121;9;10;19
96;04.10.2016;2016;10;11;Tiistai;88;104;192;16;10;26
96;04.10.2016;2016;10;12;Tiistai;122;100;222;33;25;58
96;04.10.2016;2016;10;13;Tiistai;98;146;244;48;33;81
96;04.10.2016;2016;10;14;Tiistai;89;165;254;12;26;38
96;04.10.2016;2016;10;15;Tiistai;97;342;439;6;24;30
96;04.10.2016;2016;10;16;Tiistai;147;173;320;11;21;32
96;04.10.2016;2016;10;17;Tiistai;79;103;182;16;13;29
96;04.10.2016;2016;10;18;Tiistai;94;63;157;24;22;46
96;04.10.2016;2016;10;19;Tiistai;70;57;127;9;12;21
96;04.10.2016;2016;10;20;Tiistai;49;43;92;6;7;13
96;04.10.2016;2016;10;21;Tiistai;25;31;56;1;4;5
96;04.10.2016;2016;10;22;Tiistai;10;4;14;3;1;4
96;04.10.2016;2016;10;23;Tiistai;4;1;5;0;0;0
96;05.10.2016;2016;10;00;Keskiviikko;0;2;2;0;0;0
96;05.10.2016;2016;10;01;Keskiviikko;0;0;0;0;0;0
96;05.10.2016;2016;10;02;Keskiviikko;1;4;5;0;0;0
96;05.10.2016;2016;10;03;Keskiviikko;1;0;1;0;0;0
96;05.10.2016;2016;10;04;Keskiviikko;3;1;4;0;0;0
96;05.10.2016;2016;10;05;Keskiviikko;4;7;11;0;0;0
96;05.10.2016;2016;10;06;Keskiviikko;56;34;90;7;0;7
96;05.10.2016;2016;10;07;Keskiviikko;163;130;293;25;9;34
96;05.10.2016;2016;10;08;Keskiviikko;154;166;320;36;36;72
96;05.10.2016;2016;10;09;Keskiviikko;132;121;253;54;31;85
96;05.10.2016;2016;10;10;Keskiviikko;74;80;154;20;16;36
96;05.10.2016;2016;10;11;Keskiviikko;101;126;227;26;36;62
96;05.10.2016;2016;10;12;Keskiviikko;123;126;249;49;40;89
96;05.10.2016;2016;10;13;Keskiviikko;140;169;309;34;54;88
96;05.10.2016;2016;10;14;Keskiviikko;110;197;307;13;20;33
96;05.10.2016;2016;10;15;Keskiviikko;131;275;406;10;28;38
96;05.10.2016;2016;10;16;Keskiviikko;184;175;359;13;25;38
96;05.10.2016;2016;10;17;Keskiviikko;83;72;155;16;11;27
96;05.10.2016;2016;10;18;Keskiviikko;114;45;159;23;14;37
96;05.10.2016;2016;10;19;Keskiviikko;68;37;105;14;15;29
96;05.10.2016;2016;10;20;Keskiviikko;47;69;116;6;18;24
96;05.10.2016;2016;10;21;Keskiviikko;22;54;76;1;9;10
96;05.10.2016;2016;10;22;Keskiviikko;6;13;19;4;2;6
96;05.10.2016;2016;10;23;Keskiviikko;4;7;11;1;0;1
96;06.10.2016;2016;10;00;Torstai;2;1;3;0;0;0
96;06.10.2016;2016;10;01;Torstai;4;1;5;1;0;1
96;06.10.2016;2016;10;02;Torstai;2;0;2;0;0;0
96;06.10.2016;2016;10;03;Torstai;7;1;8;1;0;1
96;06.10.2016;2016;10;04;Torstai;4;0;4;0;0;0
96;06.10.2016;2016;10;05;Torstai;8;7;15;0;0;0
96;06.10.2016;2016;10;06;Torstai;60;28;88;3;3;6
96;06.10.2016;2016;10;07;Torstai;157;130;287;20;14;34
96;06.10.2016;2016;10;08;Torstai;167;138;305;25;22;47
96;06.10.2016;2016;10;09;Torstai;130;86;216;16;7;23
96;06.10.2016;2016;10;10;Torstai;92;104;196;7;13;20
96;06.10.2016;2016;10;11;Torstai;81;80;161;8;10;18
96;06.10.2016;2016;10;12;Torstai;110;108;218;17;10;27
96;06.10.2016;2016;10;13;Torstai;104;143;247;20;21;41
96;06.10.2016;2016;10;14;Torstai;104;172;276;11;16;27
96;06.10.2016;2016;10;15;Torstai;113;306;419;17;25;42
96;06.10.2016;2016;10;16;Torstai;170;153;323;11;20;31
96;06.10.2016;2016;10;17;Torstai;87;114;201;18;26;44
96;06.10.2016;2016;10;18;Torstai;80;84;164;14;21;35
96;06.10.2016;2016;10;19;Torstai;56;33;89;14;12;26
96;06.10.2016;2016;10;20;Torstai;38;46;84;5;7;12
96;06.10.2016;2016;10;21;Torstai;55;34;89;9;4;13
96;06.10.2016;2016;10;22;Torstai;12;10;22;0;0;0
96;06.10.2016;2016;10;23;Torstai;5;3;8;2;0;2
96;07.10.2016;2016;10;00;Perjantai;3;1;4;0;0;0
96;07.10.2016;2016;10;01;Perjantai;7;0;7;0;0;0
96;07.10.2016;2016;10;02;Perjantai;5;2;7;1;0;1
96;07.10.2016;2016;10;03;Perjantai;8;2;10;1;0;1
96;07.10.2016;2016;10;04;Perjantai;5;1;6;0;0;0
96;07.10.2016;2016;10;05;Perjantai;4;7;11;1;0;1
96;07.10.2016;2016;10;06;Perjantai;48;38;86;4;2;6
96;07.10.2016;2016;10;07;Perjantai;155;122;277;16;10;26
96;07.10.2016;2016;10;08;Perjantai;123;77;200;13;11;24
96;07.10.2016;2016;10;09;Perjantai;90;98;188;7;11;18
96;07.10.2016;2016;10;10;Perjantai;77;71;148;8;21;29
96;07.10.2016;2016;10;11;Perjantai;88;100;188;2;15;17
96;07.10.2016;2016;10;12;Perjantai;118;119;237;9;18;27
96;07.10.2016;2016;10;13;Perjantai;70;134;204;2;17;19
96;07.10.2016;2016;10;14;Perjantai;85;186;271;8;19;27
96;07.10.2016;2016;10;15;Perjantai;99;171;270;12;15;27
96;07.10.2016;2016;10;16;Perjantai;97;88;185;6;15;21
96;07.10.2016;2016;10;17;Perjantai;39;72;111;8;8;16
96;07.10.2016;2016;10;18;Perjantai;48;56;104;7;5;12
96;07.10.2016;2016;10;19;Perjantai;36;31;67;11;13;24
96;07.10.2016;2016;10;20;Perjantai;41;28;69;3;6;9
96;07.10.2016;2016;10;21;Perjantai;20;28;48;3;4;7
96;07.10.2016;2016;10;22;Perjantai;19;9;28;0;5;5
96;07.10.2016;2016;10;23;Perjantai;13;8;21;0;1;1
96;08.10.2016;2016;10;00;Lauantai;9;8;17;2;1;3
96;08.10.2016;2016;10;01;Lauantai;10;6;16;2;0;2
96;08.10.2016;2016;10;02;Lauantai;8;1;9;1;1;2
96;08.10.2016;2016;10;03;Lauantai;8;1;9;2;0;2
96;08.10.2016;2016;10;04;Lauantai;5;3;8;1;0;1
96;08.10.2016;2016;10;05;Lauantai;5;4;9;0;0;0
96;08.10.2016;2016;10;06;Lauantai;14;7;21;3;1;4
96;08.10.2016;2016;10;07;Lauantai;4;16;20;0;3;3
96;08.10.2016;2016;10;08;Lauantai;14;18;32;3;6;9
96;08.10.2016;2016;10;09;Lauantai;9;35;44;4;3;7
96;08.10.2016;2016;10;10;Lauantai;13;38;51;1;5;6
96;08.10.2016;2016;10;11;Lauantai;31;49;80;10;9;19
96;08.10.2016;2016;10;12;Lauantai;57;60;117;8;8;16
96;08.10.2016;2016;10;13;Lauantai;39;67;106;5;7;12
96;08.10.2016;2016;10;14;Lauantai;50;52;102;8;8;16
96;08.10.2016;2016;10;15;Lauantai;43;72;115;13;14;27
96;08.10.2016;2016;10;16;Lauantai;50;60;110;9;16;25
96;08.10.2016;2016;10;17;Lauantai;36;37;73;4;9;13
96;08.10.2016;2016;10;18;Lauantai;34;28;62;9;4;13
96;08.10.2016;2016;10;19;Lauantai;65;24;89;8;8;16
96;08.10.2016;2016;10;20;Lauantai;20;31;51;5;1;6
96;08.10.2016;2016;10;21;Lauantai;17;30;47;1;9;10
96;08.10.2016;2016;10;22;Lauantai;16;9;25;1;3;4
96;08.10.2016;2016;10;23;Lauantai;5;24;29;0;2;2
96;09.10.2016;2016;10;00;Sunnuntai;8;11;19;0;0;0
96;09.10.2016;2016;10;01;Sunnuntai;12;1;13;1;1;2
96;09.10.2016;2016;10;02;Sunnuntai;9;0;9;1;0;1
96;09.10.2016;2016;10;03;Sunnuntai;12;0;12;2;1;3
96;09.10.2016;2016;10;04;Sunnuntai;9;0;9;1;2;3
96;09.10.2016;2016;10;05;Sunnuntai;10;2;12;2;0;2
96;09.10.2016;2016;10;06;Sunnuntai;16;6;22;3;0;3
96;09.10.2016;2016;10;07;Sunnuntai;3;11;14;1;4;5
96;09.10.2016;2016;10;08;Sunnuntai;6;11;17;0;4;4
96;09.10.2016;2016;10;09;Sunnuntai;8;15;23;3;1;4
96;09.10.2016;2016;10;10;Sunnuntai;17;26;43;9;5;14
96;09.10.2016;2016;10;11;Sunnuntai;29;23;52;7;7;14
96;09.10.2016;2016;10;12;Sunnuntai;19;53;72;11;6;17
96;09.10.2016;2016;10;13;Sunnuntai;53;58;111;7;11;18
96;09.10.2016;2016;10;14;Sunnuntai;40;55;95;6;12;18
96;09.10.2016;2016;10;15;Sunnuntai;38;37;75;17;12;29
96;09.10.2016;2016;10;16;Sunnuntai;65;43;108;22;5;27
96;09.10.2016;2016;10;17;Sunnuntai;42;39;81;21;11;32
96;09.10.2016;2016;10;18;Sunnuntai;38;46;84;9;19;28
96;09.10.2016;2016;10;19;Sunnuntai;25;34;59;7;12;19
96;09.10.2016;2016;10;20;Sunnuntai;37;29;66;8;16;24
96;09.10.2016;2016;10;21;Sunnuntai;16;24;40;1;5;6
96;09.10.2016;2016;10;22;Sunnuntai;9;6;15;0;0;0
96;09.10.2016;2016;10;23;Sunnuntai;4;3;7;2;0;2
96;10.10.2016;2016;10;00;Maanantai;3;1;4;0;0;0
96;10.10.2016;2016;10;01;Maanantai;1;0;1;0;0;0
96;10.10.2016;2016;10;02;Maanantai;0;1;1;0;0;0
96;10.10.2016;2016;10;03;Maanantai;0;2;2;0;0;0
96;10.10.2016;2016;10;04;Maanantai;1;2;3;1;0;1
96;10.10.2016;2016;10;05;Maanantai;2;12;14;1;0;1
96;10.10.2016;2016;10;06;Maanantai;49;44;93;4;1;5
96;10.10.2016;2016;10;07;Maanantai;138;121;259;20;10;30
96;10.10.2016;2016;10;08;Maanantai;125;100;225;13;9;22
96;10.10.2016;2016;10;09;Maanantai;96;72;168;14;8;22
96;10.10.2016;2016;10;10;Maanantai;63;50;113;8;11;19
96;10.10.2016;2016;10;11;Maanantai;69;95;164;10;5;15
96;10.10.2016;2016;10;12;Maanantai;96;97;193;14;13;27
96;10.10.2016;2016;10;13;Maanantai;76;129;205;14;15;29
96;10.10.2016;2016;10;14;Maanantai;101;120;221;10;15;25
96;10.10.2016;2016;10;15;Maanantai;103;248;351;8;23;31
96;10.10.2016;2016;10;16;Maanantai;121;164;285;14;11;25
96;10.10.2016;2016;10;17;Maanantai;107;100;207;15;9;24
96;10.10.2016;2016;10;18;Maanantai;66;78;144;21;25;46
96;10.10.2016;2016;10;19;Maanantai;55;50;105;12;16;28
96;10.10.2016;2016;10;20;Maanantai;41;46;87;10;9;19
96;10.10.2016;2016;10;21;Maanantai;32;34;66;5;5;10
96;10.10.2016;2016;10;22;Maanantai;11;6;17;0;1;1
96;10.10.2016;2016;10;23;Maanantai;5;1;6;1;0;1
96;11.10.2016;2016;10;00;Tiistai;2;0;2;1;0;1
96;11.10.2016;2016;10;01;Tiistai;3;0;3;0;0;0
96;11.10.2016;2016;10;02;Tiistai;1;0;1;0;0;0
96;11.10.2016;2016;10;03;Tiistai;1;1;2;1;0;1
96;11.10.2016;2016;10;04;Tiistai;1;1;2;1;0;1
96;11.10.2016;2016;10;05;Tiistai;5;7;12;0;1;1
96;11.10.2016;2016;10;06;Tiistai;61;40;101;4;1;5
96;11.10.2016;2016;10;07;Tiistai;158;130;288;16;6;22
96;11.10.2016;2016;10;08;Tiistai;139;120;259;20;12;32
96;11.10.2016;2016;10;09;Tiistai;104;82;186;15;9;24
96;11.10.2016;2016;10;10;Tiistai;78;63;141;6;9;15
96;11.10.2016;2016;10;11;Tiistai;74;72;146;12;10;22
96;11.10.2016;2016;10;12;Tiistai;104;69;173;9;7;16
96;11.10.2016;2016;10;13;Tiistai;85;114;199;8;19;27
96;11.10.2016;2016;10;14;Tiistai;80;152;232;4;14;18
96;11.10.2016;2016;10;15;Tiistai;112;336;448;3;35;38
96;11.10.2016;2016;10;16;Tiistai;124;204;328;7;14;21
96;11.10.2016;2016;10;17;Tiistai;91;95;186;22;23;45
96;11.10.2016;2016;10;18;Tiistai;72;94;166;20;33;53
96;11.10.2016;2016;10;19;Tiistai;83;48;131;16;17;33
96;11.10.2016;2016;10;20;Tiistai;47;45;92;10;9;19
96;11.10.2016;2016;10;21;Tiistai;49;32;81;10;6;16
96;11.10.2016;2016;10;22;Tiistai;16;9;25;2;2;4
96;11.10.2016;2016;10;23;Tiistai;3;2;5;0;2;2
96;12.10.2016;2016;10;00;Keskiviikko;6;4;10;0;0;0
96;12.10.2016;2016;10;01;Keskiviikko;3;0;3;0;0;0
96;12.10.2016;2016;10;02;Keskiviikko;0;1;1;0;0;0
96;12.10.2016;2016;10;03;Keskiviikko;1;1;2;0;0;0
96;12.10.2016;2016;10;04;Keskiviikko;1;1;2;1;0;1
96;12.10.2016;2016;10;05;Keskiviikko;3;4;7;2;0;2
96;12.10.2016;2016;10;06;Keskiviikko;48;50;98;3;0;3
96;12.10.2016;2016;10;07;Keskiviikko;177;139;316;21;5;26
96;12.10.2016;2016;10;08;Keskiviikko;161;135;296;9;7;16
96;12.10.2016;2016;10;09;Keskiviikko;139;101;240;11;10;21
96;12.10.2016;2016;10;10;Keskiviikko;64;84;148;8;16;24
96;12.10.2016;2016;10;11;Keskiviikko;105;94;199;14;10;24
96;12.10.2016;2016;10;12;Keskiviikko;98;84;182;7;15;22
96;12.10.2016;2016;10;13;Keskiviikko;112;109;221;12;12;24
96;12.10.2016;2016;10;14;Keskiviikko;75;201;276;2;26;28
96;12.10.2016;2016;10;15;Keskiviikko;114;246;360;8;25;33
96;12.10.2016;2016;10;16;Keskiviikko;108;157;265;14;16;30
96;12.10.2016;2016;10;17;Keskiviikko;86;74;160;11;12;23
96;12.10.2016;2016;10;18;Keskiviikko;132;68;200;15;18;33
96;12.10.2016;2016;10;19;Keskiviikko;69;52;121;12;17;29
96;12.10.2016;2016;10;20;Keskiviikko;45;63;108;15;12;27
96;12.10.2016;2016;10;21;Keskiviikko;27;51;78;1;4;5
96;12.10.2016;2016;10;22;Keskiviikko;9;7;16;4;5;9
96;12.10.2016;2016;10;23;Keskiviikko;7;5;12;0;0;0
96;13.10.2016;2016;10;00;Torstai;7;3;10;0;0;0
96;13.10.2016;2016;10;01;Torstai;2;0;2;1;1;2
96;13.10.2016;2016;10;02;Torstai;1;0;1;0;0;0
96;13.10.2016;2016;10;03;Torstai;1;1;2;0;0;0
96;13.10.2016;2016;10;04;Torstai;1;1;2;1;0;1
96;13.10.2016;2016;10;05;Torstai;4;4;8;1;0;1
96;13.10.2016;2016;10;06;Torstai;48;47;95;5;3;8
96;13.10.2016;2016;10;07;Torstai;154;112;266;18;7;25
96;13.10.2016;2016;10;08;Torstai;148;139;287;12;4;16
96;13.10.2016;2016;10;09;Torstai;115;108;223;19;8;27
96;13.10.2016;2016;10;10;Torstai;77;73;150;5;9;14
96;13.10.2016;2016;10;11;Torstai;78;79;157;10;6;16
96;13.10.2016;2016;10;12;Torstai;97;104;201;13;9;22
96;13.10.2016;2016;10;13;Torstai;85;128;213;5;19;24
96;13.10.2016;2016;10;14;Torstai;114;218;332;3;22;25
96;13.10.2016;2016;10;15;Torstai;109;280;389;9;24;33
96;13.10.2016;2016;10;16;Torstai;140;167;307;13;21;34
96;13.10.2016;2016;10;17;Torstai;82;77;159;12;12;24
96;13.10.2016;2016;10;18;Torstai;84;78;162;13;19;32
96;13.10.2016;2016;10;19;Torstai;58;41;99;18;15;33
96;13.10.2016;2016;10;20;Torstai;57;57;114;11;7;18
96;13.10.2016;2016;10;21;Torstai;36;38;74;3;6;9
96;13.10.2016;2016;10;22;Torstai;13;13;26;1;0;1
96;13.10.2016;2016;10;23;Torstai;4;11;15;2;1;3
96;14.10.2016;2016;10;00;Perjantai;0;0;0;1;0;1
96;14.10.2016;2016;10;01;Perjantai;8;0;8;0;1;1
96;14.10.2016;2016;10;02;Perjantai;0;2;2;0;0;0
96;14.10.2016;2016;10;03;Perjantai;3;2;5;0;0;0
96;14.10.2016;2016;10;04;Perjantai;1;3;4;1;0;1
96;14.10.2016;2016;10;05;Perjantai;3;5;8;2;1;3
96;14.10.2016;2016;10;06;Perjantai;49;43;92;6;7;13
96;14.10.2016;2016;10;07;Perjantai;151;127;278;24;1;25
96;14.10.2016;2016;10;08;Perjantai;122;107;229;11;7;18
96;14.10.2016;2016;10;09;Perjantai;100;73;173;10;6;16
96;14.10.2016;2016;10;10;Perjantai;61;75;136;7;16;23
96;14.10.2016;2016;10;11;Perjantai;72;98;170;9;8;17
96;14.10.2016;2016;10;12;Perjantai;95;110;205;11;16;27
96;14.10.2016;2016;10;13;Perjantai;93;147;240;7;9;16
96;14.10.2016;2016;10;14;Perjantai;70;226;296;9;32;41
96;14.10.2016;2016;10;15;Perjantai;94;200;294;10;21;31
96;14.10.2016;2016;10;16;Perjantai;86;105;191;5;10;15
96;14.10.2016;2016;10;17;Perjantai;88;69;157;10;12;22
96;14.10.2016;2016;10;18;Perjantai;58;44;102;10;11;21
96;14.10.2016;2016;10;19;Perjantai;45;27;72;11;6;17
96;14.10.2016;2016;10;20;Perjantai;39;25;64;5;3;8
96;14.10.2016;2016;10;21;Perjantai;14;27;41;5;5;10
96;14.10.2016;2016;10;22;Perjantai;10;12;22;0;1;1
96;14.10.2016;2016;10;23;Perjantai;10;5;15;0;0;0
96;15.10.2016;2016;10;00;Lauantai;3;4;7;1;1;2
96;15.10.2016;2016;10;01;Lauantai;12;6;18;0;1;1
96;15.10.2016;2016;10;02;Lauantai;9;0;9;0;0;0
96;15.10.2016;2016;10;03;Lauantai;2;2;4;4;0;4
96;15.10.2016;2016;10;04;Lauantai;5;3;8;1;1;2
96;15.10.2016;2016;10;05;Lauantai;0;3;3;2;0;2
96;15.10.2016;2016;10;06;Lauantai;22;8;30;3;0;3
96;15.10.2016;2016;10;07;Lauantai;4;17;21;3;2;5
96;15.10.2016;2016;10;08;Lauantai;12;22;34;3;7;10
96;15.10.2016;2016;10;09;Lauantai;23;57;80;9;9;18
96;15.10.2016;2016;10;10;Lauantai;20;67;87;13;47;60
96;15.10.2016;2016;10;11;Lauantai;33;59;92;12;46;58
96;15.10.2016;2016;10;12;Lauantai;65;69;134;35;27;62
96;15.10.2016;2016;10;13;Lauantai;63;74;137;62;29;91
96;15.10.2016;2016;10;14;Lauantai;67;73;140;56;5;61
96;15.10.2016;2016;10;15;Lauantai;72;46;118;36;10;46
96;15.10.2016;2016;10;16;Lauantai;67;35;102;15;8;23
96;15.10.2016;2016;10;17;Lauantai;56;29;85;10;9;19
96;15.10.2016;2016;10;18;Lauantai;40;30;70;13;6;19
96;15.10.2016;2016;10;19;Lauantai;22;22;44;9;10;19
96;15.10.2016;2016;10;20;Lauantai;29;15;44;8;12;20
96;15.10.2016;2016;10;21;Lauantai;13;26;39;0;4;4
96;15.10.2016;2016;10;22;Lauantai;6;9;15;0;2;2
96;15.10.2016;2016;10;23;Lauantai;13;11;24;1;1;2
96;16.10.2016;2016;10;00;Sunnuntai;9;6;15;1;0;1
96;16.10.2016;2016;10;01;Sunnuntai;7;3;10;1;0;1
96;16.10.2016;2016;10;02;Sunnuntai;6;1;7;0;0;0
96;16.10.2016;2016;10;03;Sunnuntai;12;0;12;3;0;3
96;16.10.2016;2016;10;04;Sunnuntai;7;1;8;1;0;1
96;16.10.2016;2016;10;05;Sunnuntai;2;2;4;0;0;0
96;16.10.2016;2016;10;06;Sunnuntai;14;6;20;4;0;4
96;16.10.2016;2016;10;07;Sunnuntai;2;5;7;1;2;3
96;16.10.2016;2016;10;08;Sunnuntai;5;8;13;4;2;6
96;16.10.2016;2016;10;09;Sunnuntai;4;8;12;2;8;10
96;16.10.2016;2016;10;10;Sunnuntai;6;33;39;4;26;30
96;16.10.2016;2016;10;11;Sunnuntai;17;38;55;8;37;45
96;16.10.2016;2016;10;12;Sunnuntai;37;39;76;20;21;41
96;16.10.2016;2016;10;13;Sunnuntai;46;39;85;39;20;59
96;16.10.2016;2016;10;14;Sunnuntai;41;47;88;31;12;43
96;16.10.2016;2016;10;15;Sunnuntai;37;45;82;17;15;32
96;16.10.2016;2016;10;16;Sunnuntai;65;27;92;25;8;33
96;16.10.2016;2016;10;17;Sunnuntai;33;44;77;13;9;22
96;16.10.2016;2016;10;18;Sunnuntai;35;28;63;19;20;39
96;16.10.2016;2016;10;19;Sunnuntai;24;25;49;10;17;27
96;16.10.2016;2016;10;20;Sunnuntai;29;26;55;7;10;17
96;16.10.2016;2016;10;21;Sunnuntai;14;29;43;3;1;4
96;16.10.2016;2016;10;22;Sunnuntai;5;6;11;0;0;0
96;16.10.2016;2016;10;23;Sunnuntai;3;1;4;1;0;1
96;17.10.2016;2016;10;00;Maanantai;2;0;2;3;0;3
96;17.10.2016;2016;10;01;Maanantai;0;0;0;1;0;1
96;17.10.2016;2016;10;02;Maanantai;0;1;1;0;0;0
96;17.10.2016;2016;10;03;Maanantai;2;1;3;0;0;0
96;17.10.2016;2016;10;04;Maanantai;3;1;4;1;0;1
96;17.10.2016;2016;10;05;Maanantai;3;8;11;0;0;0
96;17.10.2016;2016;10;06;Maanantai;42;36;78;7;1;8
96;17.10.2016;2016;10;07;Maanantai;140;130;270;18;6;24
96;17.10.2016;2016;10;08;Maanantai;143;105;248;13;5;18
96;17.10.2016;2016;10;09;Maanantai;86;75;161;13;6;19
96;17.10.2016;2016;10;10;Maanantai;62;61;123;6;11;17
96;17.10.2016;2016;10;11;Maanantai;77;73;150;10;10;20
96;17.10.2016;2016;10;12;Maanantai;77;84;161;7;11;18
96;17.10.2016;2016;10;13;Maanantai;73;89;162;8;10;18
96;17.10.2016;2016;10;14;Maanantai;83;166;249;5;16;21
96;17.10.2016;2016;10;15;Maanantai;94;259;353;4;26;30
96;17.10.2016;2016;10;16;Maanantai;128;163;291;14;13;27
96;17.10.2016;2016;10;17;Maanantai;86;93;179;15;13;28
96;17.10.2016;2016;10;18;Maanantai;81;71;152;14;25;39
96;17.10.2016;2016;10;19;Maanantai;51;55;106;21;15;36
96;17.10.2016;2016;10;20;Maanantai;34;48;82;11;11;22
96;17.10.2016;2016;10;21;Maanantai;26;45;71;3;5;8
96;17.10.2016;2016;10;22;Maanantai;9;4;13;1;1;2
96;17.10.2016;2016;10;23;Maanantai;1;0;1;2;0;2
96;18.10.2016;2016;10;00;Tiistai;3;2;5;1;0;1
96;18.10.2016;2016;10;01;Tiistai;0;0;0;0;0;0
96;18.10.2016;2016;10;02;Tiistai;1;1;2;0;0;0
96;18.10.2016;2016;10;03;Tiistai;2;1;3;0;0;0
96;18.10.2016;2016;10;04;Tiistai;2;2;4;0;0;0
96;18.10.2016;2016;10;05;Tiistai;0;5;5;1;1;2
96;18.10.2016;2016;10;06;Tiistai;51;38;89;8;2;10
96;18.10.2016;2016;10;07;Tiistai;166;114;280;23;10;33
96;18.10.2016;2016;10;08;Tiistai;133;109;242;7;10;17
96;18.10.2016;2016;10;09;Tiistai;106;93;199;8;9;17
96;18.10.2016;2016;10;10;Tiistai;66;60;126;13;11;24
96;18.10.2016;2016;10;11;Tiistai;81;76;157;14;19;33
96;18.10.2016;2016;10;12;Tiistai;97;87;184;12;17;29
96;18.10.2016;2016;10;13;Tiistai;81;101;182;10;11;21
96;18.10.2016;2016;10;14;Tiistai;91;174;265;7;19;26
96;18.10.2016;2016;10;15;Tiistai;106;292;398;8;24;32
96;18.10.2016;2016;10;16;Tiistai;116;205;321;7;19;26
96;18.10.2016;2016;10;17;Tiistai;83;94;177;11;12;23
96;18.10.2016;2016;10;18;Tiistai;81;63;144;17;20;37
96;18.10.2016;2016;10;19;Tiistai;82;43;125;14;14;28
96;18.10.2016;2016;10;20;Tiistai;34;34;68;10;7;17
96;18.10.2016;2016;10;21;Tiistai;31;36;67;2;7;9
96;18.10.2016;2016;10;22;Tiistai;21;11;32;0;0;0
96;18.10.2016;2016;10;23;Tiistai;5;4;9;1;1;2
96;19.10.2016;2016;10;00;Keskiviikko;2;4;6;1;0;1
96;19.10.2016;2016;10;01;Keskiviikko;2;2;4;0;0;0
96;19.10.2016;2016;10;02;Keskiviikko;0;1;1;0;0;0
96;19.10.2016;2016;10;03;Keskiviikko;2;1;3;0;0;0
96;19.10.2016;2016;10;04;Keskiviikko;2;1;3;0;0;0
96;19.10.2016;2016;10;05;Keskiviikko;5;8;13;1;0;1
96;19.10.2016;2016;10;06;Keskiviikko;53;35;88;4;0;4
96;19.10.2016;2016;10;07;Keskiviikko;142;125;267;20;8;28
96;19.10.2016;2016;10;08;Keskiviikko;138;125;263;23;9;32
96;19.10.2016;2016;10;09;Keskiviikko;88;89;177;17;18;35
96;19.10.2016;2016;10;10;Keskiviikko;67;60;127;6;13;19
96;19.10.2016;2016;10;11;Keskiviikko;102;80;182;13;15;28
96;19.10.2016;2016;10;12;Keskiviikko;96;84;180;18;12;30
96;19.10.2016;2016;10;13;Keskiviikko;93;108;201;1;16;17
96;19.10.2016;2016;10;14;Keskiviikko;82;168;250;9;25;34
96;19.10.2016;2016;10;15;Keskiviikko;91;249;340;7;22;29
96;19.10.2016;2016;10;16;Keskiviikko;131;174;305;17;25;42
96;19.10.2016;2016;10;17;Keskiviikko;74;88;162;12;15;27
96;19.10.2016;2016;10;18;Keskiviikko;100;73;173;21;12;33
96;19.10.2016;2016;10;19;Keskiviikko;76;36;112;26;23;49
96;19.10.2016;2016;10;20;Keskiviikko;57;62;119;9;17;26
96;19.10.2016;2016;10;21;Keskiviikko;34;49;83;4;8;12
96;19.10.2016;2016;10;22;Keskiviikko;4;10;14;0;4;4
96;19.10.2016;2016;10;23;Keskiviikko;8;1;9;0;0;0
96;20.10.2016;2016;10;00;Torstai;4;2;6;0;0;0
96;20.10.2016;2016;10;01;Torstai;2;0;2;0;0;0
96;20.10.2016;2016;10;02;Torstai;4;1;5;0;1;1
96;20.10.2016;2016;10;03;Torstai;4;1;5;0;0;0
96;20.10.2016;2016;10;04;Torstai;5;0;5;1;0;1
96;20.10.2016;2016;10;05;Torstai;6;6;12;1;2;3
96;20.10.2016;2016;10;06;Torstai;52;26;78;5;3;8
96;20.10.2016;2016;10;07;Torstai;138;124;262;20;13;33
96;20.10.2016;2016;10;08;Torstai;120;99;219;6;7;13
96;20.10.2016;2016;10;09;Torstai;99;86;185;16;7;23
96;20.10.2016;2016;10;10;Torstai;67;73;140;6;19;25
96;20.10.2016;2016;10;11;Torstai;77;88;165;15;11;26
96;20.10.2016;2016;10;12;Torstai;103;90;193;9;9;18
96;20.10.2016;2016;10;13;Torstai;82;112;194;10;16;26
96;20.10.2016;2016;10;14;Torstai;91;168;259;10;21;31
96;20.10.2016;2016;10;15;Torstai;100;235;335;6;25;31
96;20.10.2016;2016;10;16;Torstai;117;157;274;12;18;30
96;20.10.2016;2016;10;17;Torstai;59;90;149;11;22;33
96;20.10.2016;2016;10;18;Torstai;81;72;153;28;18;46
96;20.10.2016;2016;10;19;Torstai;55;47;102;13;15;28
96;20.10.2016;2016;10;20;Torstai;67;40;107;11;11;22
96;20.10.2016;2016;10;21;Torstai;36;42;78;11;9;20
96;20.10.2016;2016;10;22;Torstai;12;21;33;0;4;4
96;20.10.2016;2016;10;23;Torstai;8;4;12;0;0;0
96;21.10.2016;2016;10;00;Perjantai;7;0;7;1;0;1
96;21.10.2016;2016;10;01;Perjantai;4;2;6;0;1;1
96;21.10.2016;2016;10;02;Perjantai;10;0;10;0;0;0
96;21.10.2016;2016;10;03;Perjantai;6;0;6;0;0;0
96;21.10.2016;2016;10;04;Perjantai;5;1;6;0;0;0
96;21.10.2016;2016;10;05;Perjantai;5;8;13;1;1;2
96;21.10.2016;2016;10;06;Perjantai;38;35;73;6;3;9
96;21.10.2016;2016;10;07;Perjantai;111;94;205;21;7;28
96;21.10.2016;2016;10;08;Perjantai;102;88;190;9;10;19
96;21.10.2016;2016;10;09;Perjantai;93;73;166;15;10;25
96;21.10.2016;2016;10;10;Perjantai;51;67;118;11;16;27
96;21.10.2016;2016;10;11;Perjantai;61;92;153;10;16;26
96;21.10.2016;2016;10;12;Perjantai;98;116;214;12;19;31
96;21.10.2016;2016;10;13;Perjantai;70;126;196;10;19;29
96;21.10.2016;2016;10;14;Perjantai;76;179;255;6;18;24
96;21.10.2016;2016;10;15;Perjantai;84;156;240;6;22;28
96;21.10.2016;2016;10;16;Perjantai;86;99;185;9;15;24
96;21.10.2016;2016;10;17;Perjantai;62;61;123;14;23;37
96;21.10.2016;2016;10;18;Perjantai;44;42;86;5;7;12
96;21.10.2016;2016;10;19;Perjantai;34;24;58;9;2;11
96;21.10.2016;2016;10;20;Perjantai;28;25;53;4;1;5
96;21.10.2016;2016;10;21;Perjantai;23;17;40;2;2;4
96;21.10.2016;2016;10;22;Perjantai;16;4;20;2;0;2
96;21.10.2016;2016;10;23;Perjantai;11;2;13;0;1;1
96;22.10.2016;2016;10;00;Lauantai;5;5;10;1;3;4
96;22.10.2016;2016;10;01;Lauantai;5;1;6;1;1;2
96;22.10.2016;2016;10;02;Lauantai;8;3;11;0;0;0
96;22.10.2016;2016;10;03;Lauantai;16;1;17;1;0;1
96;22.10.2016;2016;10;04;Lauantai;5;1;6;1;2;3
96;22.10.2016;2016;10;05;Lauantai;1;1;2;2;0;2
96;22.10.2016;2016;10;06;Lauantai;19;5;24;2;0;2
96;22.10.2016;2016;10;07;Lauantai;7;16;23;2;3;5
96;22.10.2016;2016;10;08;Lauantai;6;27;33;4;4;8
96;22.10.2016;2016;10;09;Lauantai;13;41;54;3;5;8
96;22.10.2016;2016;10;10;Lauantai;17;35;52;1;3;4
96;22.10.2016;2016;10;11;Lauantai;28;45;73;11;10;21
96;22.10.2016;2016;10;12;Lauantai;27;51;78;4;6;10
96;22.10.2016;2016;10;13;Lauantai;32;39;71;7;7;14
96;22.10.2016;2016;10;14;Lauantai;36;61;97;6;7;13
96;22.10.2016;2016;10;15;Lauantai;50;41;91;13;14;27
96;22.10.2016;2016;10;16;Lauantai;39;40;79;10;9;19
96;22.10.2016;2016;10;17;Lauantai;35;25;60;18;7;25
96;22.10.2016;2016;10;18;Lauantai;18;23;41;1;5;6
96;22.10.2016;2016;10;19;Lauantai;32;27;59;13;10;23
96;22.10.2016;2016;10;20;Lauantai;13;20;33;5;19;24
96;22.10.2016;2016;10;21;Lauantai;18;29;47;0;8;8
96;22.10.2016;2016;10;22;Lauantai;10;14;24;0;4;4
96;22.10.2016;2016;10;23;Lauantai;6;8;14;4;1;5
96;23.10.2016;2016;10;00;Sunnuntai;14;4;18;1;0;1
96;23.10.2016;2016;10;01;Sunnuntai;11;4;15;1;0;1
96;23.10.2016;2016;10;02;Sunnuntai;4;1;5;0;0;0
96;23.10.2016;2016;10;03;Sunnuntai;7;0;7;0;1;1
96;23.10.2016;2016;10;04;Sunnuntai;8;0;8;2;0;2
96;23.10.2016;2016;10;05;Sunnuntai;0;1;1;0;0;0
96;23.10.2016;2016;10;06;Sunnuntai;15;7;22;1;1;2
96;23.10.2016;2016;10;07;Sunnuntai;4;5;9;0;1;1
96;23.10.2016;2016;10;08;Sunnuntai;5;6;11;3;5;8
96;23.10.2016;2016;10;09;Sunnuntai;7;10;17;4;3;7
96;23.10.2016;2016;10;10;Sunnuntai;10;14;24;1;9;10
96;23.10.2016;2016;10;11;Sunnuntai;17;34;51;7;9;16
96;23.10.2016;2016;10;12;Sunnuntai;20;44;64;6;2;8
96;23.10.2016;2016;10;13;Sunnuntai;31;40;71;4;12;16
96;23.10.2016;2016;10;14;Sunnuntai;31;41;72;10;7;17
96;23.10.2016;2016;10;15;Sunnuntai;37;35;72;6;6;12
96;23.10.2016;2016;10;16;Sunnuntai;54;28;82;17;9;26
96;23.10.2016;2016;10;17;Sunnuntai;30;32;62;8;13;21
96;23.10.2016;2016;10;18;Sunnuntai;33;33;66;21;13;34
96;23.10.2016;2016;10;19;Sunnuntai;19;26;45;9;11;20
96;23.10.2016;2016;10;20;Sunnuntai;22;16;38;9;14;23
96;23.10.2016;2016;10;21;Sunnuntai;19;18;37;3;7;10
96;23.10.2016;2016;10;22;Sunnuntai;6;9;15;4;1;5
96;23.10.2016;2016;10;23;Sunnuntai;11;2;13;1;0;1
96;24.10.2016;2016;10;00;Maanantai;4;1;5;0;0;0
96;24.10.2016;2016;10;01;Maanantai;1;3;4;0;0;0
96;24.10.2016;2016;10;02;Maanantai;2;0;2;0;0;0
96;24.10.2016;2016;10;03;Maanantai;0;3;3;0;0;0
96;24.10.2016;2016;10;04;Maanantai;4;2;6;0;0;0
96;24.10.2016;2016;10;05;Maanantai;4;6;10;0;0;0
96;24.10.2016;2016;10;06;Maanantai;34;31;65;7;3;10
96;24.10.2016;2016;10;07;Maanantai;74;75;149;11;12;23
96;24.10.2016;2016;10;08;Maanantai;57;54;111;9;9;18
96;24.10.2016;2016;10;09;Maanantai;39;43;82;5;7;12
96;24.10.2016;2016;10;10;Maanantai;37;35;72;5;5;10
96;24.10.2016;2016;10;11;Maanantai;42;44;86;6;7;13
96;24.10.2016;2016;10;12;Maanantai;62;60;122;10;8;18
96;24.10.2016;2016;10;13;Maanantai;61;61;122;8;11;19
96;24.10.2016;2016;10;14;Maanantai;64;60;124;10;8;18
96;24.10.2016;2016;10;15;Maanantai;110;112;222;16;17;33
96;24.10.2016;2016;10;16;Maanantai;92;91;183;14;14;28
96;24.10.2016;2016;10;17;Maanantai;60;62;122;8;10;18
96;24.10.2016;2016;10;18;Maanantai;39;38;77;7;5;12
96;24.10.2016;2016;10;19;Maanantai;34;38;72;4;8;12
96;24.10.2016;2016;10;20;Maanantai;20;20;40;4;1;5
96;24.10.2016;2016;10;21;Maanantai;25;28;53;3;4;7
96;24.10.2016;2016;10;22;Maanantai;4;3;7;1;0;1
96;24.10.2016;2016;10;23;Maanantai;1;3;4;0;0;0
96;25.10.2016;2016;10;00;Tiistai;5;2;7;1;0;1
96;25.10.2016;2016;10;01;Tiistai;1;3;4;0;0;0
96;25.10.2016;2016;10;02;Tiistai;1;0;1;0;0;0
96;25.10.2016;2016;10;03;Tiistai;1;1;2;0;0;0
96;25.10.2016;2016;10;04;Tiistai;2;1;3;0;0;0
96;25.10.2016;2016;10;05;Tiistai;3;6;9;0;2;2
96;25.10.2016;2016;10;06;Tiistai;38;35;73;7;5;12
96;25.10.2016;2016;10;07;Tiistai;78;79;157;11;13;24
96;25.10.2016;2016;10;08;Tiistai;53;49;102;9;7;16
96;25.10.2016;2016;10;09;Tiistai;32;34;66;6;6;12
96;25.10.2016;2016;10;10;Tiistai;40;37;77;7;4;11
96;25.10.2016;2016;10;11;Tiistai;46;49;95;6;8;14
96;25.10.2016;2016;10;12;Tiistai;58;55;113;9;8;17
96;25.10.2016;2016;10;13;Tiistai;61;61;122;8;10;18
96;25.10.2016;2016;10;14;Tiistai;64;63;127;11;9;20
96;25.10.2016;2016;10;15;Tiistai;103;105;208;14;17;31
96;25.10.2016;2016;10;16;Tiistai;90;87;177;14;12;26
96;25.10.2016;2016;10;17;Tiistai;57;60;117;8;10;18
96;25.10.2016;2016;10;18;Tiistai;38;35;73;7;4;11
96;25.10.2016;2016;10;19;Tiistai;29;31;60;3;7;10
96;25.10.2016;2016;10;20;Tiistai;30;27;57;5;4;9
96;25.10.2016;2016;10;21;Tiistai;20;22;42;2;4;6
96;25.10.2016;2016;10;22;Tiistai;8;5;13;2;0;2
96;25.10.2016;2016;10;23;Tiistai;3;5;8;0;0;0
96;26.10.2016;2016;10;00;Keskiviikko;3;2;5;0;0;0
96;26.10.2016;2016;10;01;Keskiviikko;0;2;2;0;0;0
96;26.10.2016;2016;10;02;Keskiviikko;2;1;3;0;0;0
96;26.10.2016;2016;10;03;Keskiviikko;0;2;2;0;0;0
96;26.10.2016;2016;10;04;Keskiviikko;1;1;2;0;0;0
96;26.10.2016;2016;10;05;Keskiviikko;3;7;10;0;1;1
96;26.10.2016;2016;10;06;Keskiviikko;42;41;83;8;4;12
96;26.10.2016;2016;10;07;Keskiviikko;70;74;144;10;12;22
96;26.10.2016;2016;10;08;Keskiviikko;42;39;81;7;6;13
96;26.10.2016;2016;10;09;Keskiviikko;33;35;68;4;7;11
96;26.10.2016;2016;10;10;Keskiviikko;36;32;68;5;4;9
96;26.10.2016;2016;10;11;Keskiviikko;32;33;65;4;5;9
96;26.10.2016;2016;10;12;Keskiviikko;47;47;94;8;7;15
96;26.10.2016;2016;10;13;Keskiviikko;46;46;92;7;8;15
96;26.10.2016;2016;10;14;Keskiviikko;56;54;110;9;6;15
96;26.10.2016;2016;10;15;Keskiviikko;96;96;192;14;16;30
96;26.10.2016;2016;10;16;Keskiviikko;65;62;127;10;8;18
96;26.10.2016;2016;10;17;Keskiviikko;46;49;95;5;9;14
96;26.10.2016;2016;10;18;Keskiviikko;41;38;79;7;4;11
96;26.10.2016;2016;10;19;Keskiviikko;23;25;48;3;4;7
96;26.10.2016;2016;10;20;Keskiviikko;25;24;49;4;4;8
96;26.10.2016;2016;10;21;Keskiviikko;19;20;39;1;4;5
96;26.10.2016;2016;10;22;Keskiviikko;8;7;15;4;0;4
96;26.10.2016;2016;10;23;Keskiviikko;3;3;6;0;0;0
96;27.10.2016;2016;10;00;Torstai;1;0;1;0;0;0
96;27.10.2016;2016;10;01;Torstai;0;1;1;0;0;0
96;27.10.2016;2016;10;02;Torstai;2;1;3;0;0;0
96;27.10.2016;2016;10;03;Torstai;2;3;5;0;0;0
96;27.10.2016;2016;10;04;Torstai;3;2;5;0;0;0
96;27.10.2016;2016;10;05;Torstai;5;7;12;0;2;2
96;27.10.2016;2016;10;06;Torstai;31;28;59;5;3;8
96;27.10.2016;2016;10;07;Torstai;63;64;127;8;10;18
96;27.10.2016;2016;10;08;Torstai;36;34;70;6;5;11
96;27.10.2016;2016;10;09;Torstai;34;36;70;5;6;11
96;27.10.2016;2016;10;10;Torstai;35;34;69;6;4;10
96;27.10.2016;2016;10;11;Torstai;30;32;62;3;6;9
96;27.10.2016;2016;10;12;Torstai;47;43;90;7;7;14
96;27.10.2016;2016;10;13;Torstai;43;45;88;7;7;14
96;27.10.2016;2016;10;14;Torstai;53;52;105;9;7;16
96;27.10.2016;2016;10;15;Torstai;81;84;165;12;13;25
96;27.10.2016;2016;10;16;Torstai;74;73;147;11;10;21
96;27.10.2016;2016;10;17;Torstai;37;39;76;5;7;12
96;27.10.2016;2016;10;18;Torstai;27;25;52;4;4;8
96;27.10.2016;2016;10;19;Torstai;22;24;46;3;4;7
96;27.10.2016;2016;10;20;Torstai;28;27;55;4;3;7
96;27.10.2016;2016;10;21;Torstai;20;21;41;2;4;6
96;27.10.2016;2016;10;22;Torstai;10;6;16;1;0;1
96;27.10.2016;2016;10;23;Torstai;4;6;10;0;0;0
96;28.10.2016;2016;10;00;Perjantai;3;1;4;0;0;0
96;28.10.2016;2016;10;01;Perjantai;0;0;0;0;0;0
96;28.10.2016;2016;10;02;Perjantai;1;0;1;0;0;0
96;28.10.2016;2016;10;03;Perjantai;0;2;2;0;0;0
96;28.10.2016;2016;10;04;Perjantai;2;0;2;0;0;0
96;28.10.2016;2016;10;05;Perjantai;2;5;7;0;1;1
96;28.10.2016;2016;10;06;Perjantai;27;25;52;5;4;9
96;28.10.2016;2016;10;07;Perjantai;49;50;99;6;8;14
96;28.10.2016;2016;10;08;Perjantai;26;26;52;4;4;8
96;28.10.2016;2016;10;09;Perjantai;25;26;51;3;5;8
96;28.10.2016;2016;10;10;Perjantai;34;31;65;6;4;10
96;28.10.2016;2016;10;11;Perjantai;35;38;73;5;6;11
96;28.10.2016;2016;10;12;Perjantai;51;49;100;9;7;16
96;28.10.2016;2016;10;13;Perjantai;43;45;88;6;8;14
96;28.10.2016;2016;10;14;Perjantai;62;62;124;10;9;19
96;28.10.2016;2016;10;15;Perjantai;67;69;136;9;10;19
96;28.10.2016;2016;10;16;Perjantai;52;52;104;9;6;15
96;28.10.2016;2016;10;17;Perjantai;39;41;80;5;7;12
96;28.10.2016;2016;10;18;Perjantai;39;36;75;7;4;11
96;28.10.2016;2016;10;19;Perjantai;25;26;51;4;4;8
96;28.10.2016;2016;10;20;Perjantai;20;17;37;4;1;5
96;28.10.2016;2016;10;21;Perjantai;16;19;35;2;4;6
96;28.10.2016;2016;10;22;Perjantai;11;10;21;4;0;4
96;28.10.2016;2016;10;23;Perjantai;6;8;14;0;2;2
96;29.10.2016;2016;10;00;Lauantai;4;1;5;3;1;4
96;29.10.2016;2016;10;01;Lauantai;3;5;8;2;3;5
96;29.10.2016;2016;10;02;Lauantai;3;1;4;2;1;3
96;29.10.2016;2016;10;03;Lauantai;3;3;6;2;3;5
96;29.10.2016;2016;10;04;Lauantai;3;1;4;1;1;2
96;29.10.2016;2016;10;05;Lauantai;1;4;5;0;3;3
96;29.10.2016;2016;10;06;Lauantai;10;8;18;8;7;15
96;29.10.2016;2016;10;07;Lauantai;3;6;9;2;5;7
96;29.10.2016;2016;10;08;Lauantai;11;9;20;9;9;18
96;29.10.2016;2016;10;09;Lauantai;12;14;26;11;13;24
96;29.10.2016;2016;10;10;Lauantai;17;15;32;16;14;30
96;29.10.2016;2016;10;11;Lauantai;18;21;39;18;19;37
96;29.10.2016;2016;10;12;Lauantai;26;25;51;25;23;48
96;29.10.2016;2016;10;13;Lauantai;25;28;53;24;25;49
96;29.10.2016;2016;10;14;Lauantai;22;20;42;21;19;40
96;29.10.2016;2016;10;15;Lauantai;28;29;57;28;28;56
96;29.10.2016;2016;10;16;Lauantai;32;29;61;32;28;60
96;29.10.2016;2016;10;17;Lauantai;18;21;39;18;18;36
96;29.10.2016;2016;10;18;Lauantai;21;19;40;20;17;37
96;29.10.2016;2016;10;19;Lauantai;18;21;39;17;20;37
96;29.10.2016;2016;10;20;Lauantai;14;12;26;13;10;23
96;29.10.2016;2016;10;21;Lauantai;7;11;18;7;11;18
96;29.10.2016;2016;10;22;Lauantai;8;6;14;7;5;12
96;29.10.2016;2016;10;23;Lauantai;4;7;11;3;6;9
96;30.10.2016;2016;10;00;Sunnuntai;4;3;7;3;2;5
96;30.10.2016;2016;10;01;Sunnuntai;3;4;7;1;4;5
96;30.10.2016;2016;10;02;Sunnuntai;4;1;5;3;1;4
96;30.10.2016;2016;10;03;Sunnuntai;7;9;16;7;8;15
96;30.10.2016;2016;10;04;Sunnuntai;3;1;4;2;0;2
96;30.10.2016;2016;10;05;Sunnuntai;1;3;4;0;2;2
96;30.10.2016;2016;10;06;Sunnuntai;7;5;12;7;5;12
96;30.10.2016;2016;10;07;Sunnuntai;3;5;8;3;3;6
96;30.10.2016;2016;10;08;Sunnuntai;6;5;11;6;4;10
96;30.10.2016;2016;10;09;Sunnuntai;9;10;19;8;9;17
96;30.10.2016;2016;10;10;Sunnuntai;10;9;19;10;9;19
96;30.10.2016;2016;10;11;Sunnuntai;19;20;39;19;20;39
96;30.10.2016;2016;10;12;Sunnuntai;21;19;40;20;17;37
96;30.10.2016;2016;10;13;Sunnuntai;20;22;42;19;21;40
96;30.10.2016;2016;10;14;Sunnuntai;21;18;39;19;18;37
96;30.10.2016;2016;10;15;Sunnuntai;20;23;43;19;22;41
96;30.10.2016;2016;10;16;Sunnuntai;24;23;47;24;23;47
96;30.10.2016;2016;10;17;Sunnuntai;17;19;36;17;19;36
96;30.10.2016;2016;10;18;Sunnuntai;23;20;43;20;19;39
96;30.10.2016;2016;10;19;Sunnuntai;17;19;36;16;17;33
96;30.10.2016;2016;10;20;Sunnuntai;15;12;27;13;12;25
96;30.10.2016;2016;10;21;Sunnuntai;11;13;24;10;13;23
96;30.10.2016;2016;10;22;Sunnuntai;7;4;11;4;3;7
96;30.10.2016;2016;10;23;Sunnuntai;3;4;7;1;4;5
96;31.10.2016;2016;10;00;Maanantai;5;2;7;0;0;0
96;31.10.2016;2016;10;01;Maanantai;0;4;4;0;0;0
96;31.10.2016;2016;10;02;Maanantai;0;0;0;0;0;0
96;31.10.2016;2016;10;03;Maanantai;0;2;2;0;0;0
96;31.10.2016;2016;10;04;Maanantai;4;2;6;0;0;0
96;31.10.2016;2016;10;05;Maanantai;4;6;10;0;1;1
96;31.10.2016;2016;10;06;Maanantai;41;38;79;7;5;12
96;31.10.2016;2016;10;07;Maanantai;126;128;254;18;20;38
96;31.10.2016;2016;10;08;Maanantai;105;101;206;16;14;30
96;31.10.2016;2016;10;09;Maanantai;74;75;149;11;11;22
96;31.10.2016;2016;10;10;Maanantai;57;53;110;9;6;15
96;31.10.2016;2016;10;11;Maanantai;70;72;142;10;12;22
96;31.10.2016;2016;10;12;Maanantai;95;93;188;15;12;27
96;31.10.2016;2016;10;13;Maanantai;72;74;146;9;13;22
96;31.10.2016;2016;10;14;Maanantai;106;104;210;17;14;31
96;31.10.2016;2016;10;15;Maanantai;140;141;281;19;23;42
96;31.10.2016;2016;10;16;Maanantai;135;134;269;21;19;40
96;31.10.2016;2016;10;17;Maanantai;61;64;125;8;10;18
96;31.10.2016;2016;10;18;Maanantai;65;62;127;10;9;19
96;31.10.2016;2016;10;19;Maanantai;40;42;82;5;8;13
96;31.10.2016;2016;10;20;Maanantai;36;35;71;5;4;9
96;31.10.2016;2016;10;21;Maanantai;25;27;52;3;4;7
96;31.10.2016;2016;10;22;Maanantai;7;5;12;2;0;2
96;31.10.2016;2016;10;23;Maanantai;6;9;15;0;1;1
96;01.11.2016;2016;11;00;Tiistai;3;0;3;0;0;0
96;01.11.2016;2016;11;01;Tiistai;2;2;4;0;0;0
96;01.11.2016;2016;11;02;Tiistai;4;2;6;0;0;0
96;01.11.2016;2016;11;03;Tiistai;0;3;3;0;0;0
96;01.11.2016;2016;11;04;Tiistai;3;1;4;0;0;0
96;01.11.2016;2016;11;05;Tiistai;6;9;15;0;3;3
96;01.11.2016;2016;11;06;Tiistai;39;38;77;7;5;12
96;01.11.2016;2016;11;07;Tiistai;128;131;259;18;21;39
96;01.11.2016;2016;11;08;Tiistai;95;92;187;14;14;28
96;01.11.2016;2016;11;09;Tiistai;85;86;171;12;13;25
96;01.11.2016;2016;11;10;Tiistai;55;53;108;9;7;16
96;01.11.2016;2016;11;11;Tiistai;60;61;121;8;10;18
96;01.11.2016;2016;11;12;Tiistai;81;78;159;13;10;23
96;01.11.2016;2016;11;13;Tiistai;72;76;148;10;13;23
96;01.11.2016;2016;11;14;Tiistai;97;95;192;15;13;28
96;01.11.2016;2016;11;15;Tiistai;144;145;289;21;23;44
96;01.11.2016;2016;11;16;Tiistai;120;119;239;19;16;35
96;01.11.2016;2016;11;17;Tiistai;58;61;119;8;10;18
96;01.11.2016;2016;11;18;Tiistai;54;51;105;10;6;16
96;01.11.2016;2016;11;19;Tiistai;34;37;71;4;6;10
96;01.11.2016;2016;11;20;Tiistai;33;29;62;6;4;10
96;01.11.2016;2016;11;21;Tiistai;26;27;53;2;6;8
96;01.11.2016;2016;11;22;Tiistai;8;4;12;1;0;1
96;01.11.2016;2016;11;23;Tiistai;2;6;8;0;1;1
96;02.11.2016;2016;11;00;Keskiviikko;2;1;3;0;0;0
96;02.11.2016;2016;11;01;Keskiviikko;1;4;5;0;0;0
96;02.11.2016;2016;11;02;Keskiviikko;3;1;4;0;0;0
96;02.11.2016;2016;11;03;Keskiviikko;0;1;1;0;0;0
96;02.11.2016;2016;11;04;Keskiviikko;3;0;3;0;0;0
96;02.11.2016;2016;11;05;Keskiviikko;3;6;9;0;2;2
96;02.11.2016;2016;11;06;Keskiviikko;38;36;74;7;5;12
96;02.11.2016;2016;11;07;Keskiviikko;112;113;225;16;17;33
96;02.11.2016;2016;11;08;Keskiviikko;104;103;207;16;14;30
96;02.11.2016;2016;11;09;Keskiviikko;73;75;148;10;12;22
96;02.11.2016;2016;11;10;Keskiviikko;61;57;118;9;9;18
96;02.11.2016;2016;11;11;Keskiviikko;78;79;157;11;12;23
96;02.11.2016;2016;11;12;Keskiviikko;83;80;163;14;12;26
96;02.11.2016;2016;11;13;Keskiviikko;82;84;166;12;12;24
96;02.11.2016;2016;11;14;Keskiviikko;100;97;197;16;13;29
96;02.11.2016;2016;11;15;Keskiviikko;133;135;268;19;21;40
96;02.11.2016;2016;11;16;Keskiviikko;115;113;228;18;16;34
96;02.11.2016;2016;11;17;Keskiviikko;64;66;130;8;11;19
96;02.11.2016;2016;11;18;Keskiviikko;71;70;141;12;9;21
96;02.11.2016;2016;11;19;Keskiviikko;48;50;98;6;9;15
96;02.11.2016;2016;11;20;Keskiviikko;51;48;99;8;7;15
96;02.11.2016;2016;11;21;Keskiviikko;35;37;72;4;6;10
96;02.11.2016;2016;11;22;Keskiviikko;7;5;12;2;0;2
96;02.11.2016;2016;11;23;Keskiviikko;6;8;14;0;3;3
96;03.11.2016;2016;11;00;Torstai;5;2;7;0;0;0
96;03.11.2016;2016;11;01;Torstai;1;2;3;0;0;0
96;03.11.2016;2016;11;02;Torstai;2;0;2;0;0;0
96;03.11.2016;2016;11;03;Torstai;1;1;2;0;0;0
96;03.11.2016;2016;11;04;Torstai;2;1;3;0;0;0
96;03.11.2016;2016;11;05;Torstai;2;5;7;0;0;0
96;03.11.2016;2016;11;06;Torstai;36;33;69;7;3;10
96;03.11.2016;2016;11;07;Torstai;104;106;210;15;17;32
96;03.11.2016;2016;11;08;Torstai;93;91;184;15;13;28
96;03.11.2016;2016;11;09;Torstai;72;76;148;11;12;23
96;03.11.2016;2016;11;10;Torstai;54;53;107;9;8;17
96;03.11.2016;2016;11;11;Torstai;60;61;121;8;11;19
96;03.11.2016;2016;11;12;Torstai;54;52;106;9;7;16
96;03.11.2016;2016;11;13;Torstai;67;70;137;10;11;21
96;03.11.2016;2016;11;14;Torstai;93;91;184;15;12;27
96;03.11.2016;2016;11;15;Torstai;116;117;233;16;18;34
96;03.11.2016;2016;11;16;Torstai;112;109;221;18;15;33
96;03.11.2016;2016;11;17;Torstai;60;63;123;8;11;19
96;03.11.2016;2016;11;18;Torstai;57;54;111;9;7;16
96;03.11.2016;2016;11;19;Torstai;47;48;95;7;9;16
96;03.11.2016;2016;11;20;Torstai;33;32;65;6;4;10
96;03.11.2016;2016;11;21;Torstai;28;31;59;4;5;9
96;03.11.2016;2016;11;22;Torstai;10;9;19;3;0;3
96;03.11.2016;2016;11;23;Torstai;3;4;7;0;1;1
96;04.11.2016;2016;11;00;Perjantai;3;2;5;0;0;0
96;04.11.2016;2016;11;01;Perjantai;2;3;5;0;0;0
96;04.11.2016;2016;11;02;Perjantai;3;1;4;0;0;0
96;04.11.2016;2016;11;03;Perjantai;1;3;4;0;0;0
96;04.11.2016;2016;11;04;Perjantai;2;0;2;0;0;0
96;04.11.2016;2016;11;05;Perjantai;1;4;5;0;0;0
96;04.11.2016;2016;11;06;Perjantai;36;34;70;7;4;11
96;04.11.2016;2016;11;07;Perjantai;107;108;215;15;18;33
96;04.11.2016;2016;11;08;Perjantai;83;82;165;13;11;24
96;04.11.2016;2016;11;09;Perjantai;49;50;99;6;9;15
96;04.11.2016;2016;11;10;Perjantai;47;43;90;8;6;14
96;04.11.2016;2016;11;11;Perjantai;59;60;119;7;10;17
96;04.11.2016;2016;11;12;Perjantai;82;79;161;12;11;23
96;04.11.2016;2016;11;13;Perjantai;86;87;173;12;14;26
96;04.11.2016;2016;11;14;Perjantai;108;105;213;16;15;31
96;04.11.2016;2016;11;15;Perjantai;87;90;177;12;14;26
96;04.11.2016;2016;11;16;Perjantai;62;58;120;11;8;19
96;04.11.2016;2016;11;17;Perjantai;50;50;100;6;9;15
96;04.11.2016;2016;11;18;Perjantai;33;31;64;5;4;9
96;04.11.2016;2016;11;19;Perjantai;25;26;51;4;4;8
96;04.11.2016;2016;11;20;Perjantai;17;15;32;4;1;5
96;04.11.2016;2016;11;21;Perjantai;23;24;47;3;4;7
96;04.11.2016;2016;11;22;Perjantai;10;8;18;3;0;3
96;04.11.2016;2016;11;23;Perjantai;6;8;14;0;4;4
96;05.11.2016;2016;11;00;Lauantai;4;2;6;3;1;4
96;05.11.2016;2016;11;01;Lauantai;3;5;8;1;3;4
96;05.11.2016;2016;11;02;Lauantai;3;1;4;1;0;1
96;05.11.2016;2016;11;03;Lauantai;2;5;7;2;4;6
96;05.11.2016;2016;11;04;Lauantai;3;0;3;1;0;1
96;05.11.2016;2016;11;05;Lauantai;0;2;2;0;1;1
96;05.11.2016;2016;11;06;Lauantai;7;5;12;5;5;10
96;05.11.2016;2016;11;07;Lauantai;3;6;9;2;6;8
96;05.11.2016;2016;11;08;Lauantai;6;5;11;6;3;9
96;05.11.2016;2016;11;09;Lauantai;4;8;12;4;6;10
96;05.11.2016;2016;11;10;Lauantai;14;13;27;14;11;25
96;05.11.2016;2016;11;11;Lauantai;16;19;35;16;17;33
96;05.11.2016;2016;11;12;Lauantai;25;22;47;23;22;45
96;05.11.2016;2016;11;13;Lauantai;20;22;42;19;21;40
96;05.11.2016;2016;11;14;Lauantai;23;21;44;22;19;41
96;05.11.2016;2016;11;15;Lauantai;15;15;30;13;15;28
96;05.11.2016;2016;11;16;Lauantai;19;16;35;17;16;33
96;05.11.2016;2016;11;17;Lauantai;14;15;29;12;14;26
96;05.11.2016;2016;11;18;Lauantai;12;11;23;12;10;22
96;05.11.2016;2016;11;19;Lauantai;12;14;26;11;14;25
96;05.11.2016;2016;11;20;Lauantai;9;6;15;8;5;13
96;05.11.2016;2016;11;21;Lauantai;7;10;17;7;9;16
96;05.11.2016;2016;11;22;Lauantai;4;2;6;3;2;5
96;05.11.2016;2016;11;23;Lauantai;2;5;7;2;4;6
96;06.11.2016;2016;11;00;Sunnuntai;5;1;6;3;1;4
96;06.11.2016;2016;11;01;Sunnuntai;3;4;7;1;4;5
96;06.11.2016;2016;11;02;Sunnuntai;3;1;4;2;0;2
96;06.11.2016;2016;11;03;Sunnuntai;0;4;4;0;1;1
96;06.11.2016;2016;11;04;Sunnuntai;4;3;7;3;1;4
96;06.11.2016;2016;11;05;Sunnuntai;0;3;3;0;0;0
96;06.11.2016;2016;11;06;Sunnuntai;5;4;9;5;2;7
96;06.11.2016;2016;11;07;Sunnuntai;2;4;6;1;3;4
96;06.11.2016;2016;11;08;Sunnuntai;5;2;7;2;2;4
96;06.11.2016;2016;11;09;Sunnuntai;3;7;10;3;5;8
96;06.11.2016;2016;11;10;Sunnuntai;11;10;21;10;8;18
96;06.11.2016;2016;11;11;Sunnuntai;12;15;27;11;14;25
96;06.11.2016;2016;11;12;Sunnuntai;16;13;29;14;13;27
96;06.11.2016;2016;11;13;Sunnuntai;19;22;41;18;20;38
96;06.11.2016;2016;11;14;Sunnuntai;19;15;34;18;15;33
96;06.11.2016;2016;11;15;Sunnuntai;16;18;34;16;16;32
96;06.11.2016;2016;11;16;Sunnuntai;22;19;41;21;19;40
96;06.11.2016;2016;11;17;Sunnuntai;8;11;19;8;10;18
96;06.11.2016;2016;11;18;Sunnuntai;21;20;41;20;19;39
96;06.11.2016;2016;11;19;Sunnuntai;10;12;22;10;10;20
96;06.11.2016;2016;11;20;Sunnuntai;11;9;20;10;9;19
96;06.11.2016;2016;11;21;Sunnuntai;9;10;19;8;10;18
96;06.11.2016;2016;11;22;Sunnuntai;5;1;6;2;1;3
96;06.11.2016;2016;11;23;Sunnuntai;1;3;4;0;1;1
96;07.11.2016;2016;11;00;Maanantai;3;2;5;0;0;0
96;07.11.2016;2016;11;01;Maanantai;0;0;0;0;0;0
96;07.11.2016;2016;11;02;Maanantai;1;0;1;0;0;0
96;07.11.2016;2016;11;03;Maanantai;0;1;1;0;0;0
96;07.11.2016;2016;11;04;Maanantai;2;1;3;0;0;0
96;07.11.2016;2016;11;05;Maanantai;3;6;9;0;1;1
96;07.11.2016;2016;11;06;Maanantai;33;30;63;7;3;10
96;07.11.2016;2016;11;07;Maanantai;100;102;202;14;15;29
96;07.11.2016;2016;11;08;Maanantai;93;92;185;15;13;28
96;07.11.2016;2016;11;09;Maanantai;60;61;121;7;10;17
96;07.11.2016;2016;11;10;Maanantai;45;44;89;8;5;13
96;07.11.2016;2016;11;11;Maanantai;56;58;114;7;10;17
96;07.11.2016;2016;11;12;Maanantai;75;74;149;13;10;23
96;07.11.2016;2016;11;13;Maanantai;60;63;123;8;10;18
96;07.11.2016;2016;11;14;Maanantai;84;83;167;14;12;26
96;07.11.2016;2016;11;15;Maanantai;120;122;242;17;19;36
96;07.11.2016;2016;11;16;Maanantai;111;110;221;17;16;33
96;07.11.2016;2016;11;17;Maanantai;62;65;127;9;10;19
96;07.11.2016;2016;11;18;Maanantai;57;56;113;9;8;17
96;07.11.2016;2016;11;19;Maanantai;40;40;80;4;8;12
96;07.11.2016;2016;11;20;Maanantai;28;28;56;5;4;9
96;07.11.2016;2016;11;21;Maanantai;22;24;46;2;4;6
96;07.11.2016;2016;11;22;Maanantai;11;7;18;2;0;2
96;07.11.2016;2016;11;23;Maanantai;2;6;8;0;1;1
96;08.11.2016;2016;11;00;Tiistai;2;1;3;0;0;0
96;08.11.2016;2016;11;01;Tiistai;0;0;0;0;0;0
96;08.11.2016;2016;11;02;Tiistai;0;0;0;0;0;0
96;08.11.2016;2016;11;03;Tiistai;0;2;2;0;0;0
96;08.11.2016;2016;11;04;Tiistai;1;0;1;0;0;0
96;08.11.2016;2016;11;05;Tiistai;4;6;10;0;1;1
96;08.11.2016;2016;11;06;Tiistai;35;33;68;7;4;11
96;08.11.2016;2016;11;07;Tiistai;111;111;222;16;17;33
96;08.11.2016;2016;11;08;Tiistai;84;84;168;14;11;25
96;08.11.2016;2016;11;09;Tiistai;67;68;135;9;11;20
96;08.11.2016;2016;11;10;Tiistai;52;49;101;8;7;15
96;08.11.2016;2016;11;11;Tiistai;59;59;118;8;10;18
96;08.11.2016;2016;11;12;Tiistai;53;51;104;8;8;16
96;08.11.2016;2016;11;13;Tiistai;68;69;137;9;12;21
96;08.11.2016;2016;11;14;Tiistai;76;74;150;12;11;23
96;08.11.2016;2016;11;15;Tiistai;149;153;302;21;24;45
96;08.11.2016;2016;11;16;Tiistai;106;104;210;16;15;31
96;08.11.2016;2016;11;17;Tiistai;56;58;114;8;9;17
96;08.11.2016;2016;11;18;Tiistai;55;53;108;9;8;17
96;08.11.2016;2016;11;19;Tiistai;44;46;90;5;8;13
96;08.11.2016;2016;11;20;Tiistai;31;29;60;5;4;9
96;08.11.2016;2016;11;21;Tiistai;19;21;40;1;4;5
96;08.11.2016;2016;11;22;Tiistai;7;5;12;1;0;1
96;08.11.2016;2016;11;23;Tiistai;2;3;5;0;0;0
96;09.11.2016;2016;11;00;Keskiviikko;1;0;1;0;0;0
96;09.11.2016;2016;11;01;Keskiviikko;0;0;0;0;0;0
96;09.11.2016;2016;11;02;Keskiviikko;1;0;1;0;0;0
96;09.11.2016;2016;11;03;Keskiviikko;1;2;3;0;0;0
96;09.11.2016;2016;11;04;Keskiviikko;2;0;2;0;0;0
96;09.11.2016;2016;11;05;Keskiviikko;3;5;8;0;1;1
96;09.11.2016;2016;11;06;Keskiviikko;41;39;80;7;6;13
96;09.11.2016;2016;11;07;Keskiviikko;106;109;215;15;18;33
96;09.11.2016;2016;11;08;Keskiviikko;90;86;176;14;12;26
96;09.11.2016;2016;11;09;Keskiviikko;71;72;143;9;13;22
96;09.11.2016;2016;11;10;Keskiviikko;50;48;98;7;7;14
96;09.11.2016;2016;11;11;Keskiviikko;62;63;125;8;10;18
96;09.11.2016;2016;11;12;Keskiviikko;48;46;94;8;6;14
96;09.11.2016;2016;11;13;Keskiviikko;76;79;155;10;13;23
96;09.11.2016;2016;11;14;Keskiviikko;77;76;153;12;10;22
96;09.11.2016;2016;11;15;Keskiviikko;115;118;233;18;18;36
96;09.11.2016;2016;11;16;Keskiviikko;104;102;206;16;14;30
96;09.11.2016;2016;11;17;Keskiviikko;55;58;113;7;10;17
96;09.11.2016;2016;11;18;Keskiviikko;54;51;105;9;7;16
96;09.11.2016;2016;11;19;Keskiviikko;32;35;67;4;6;10
96;09.11.2016;2016;11;20;Keskiviikko;45;42;87;8;5;13
96;09.11.2016;2016;11;21;Keskiviikko;25;27;52;3;4;7
96;09.11.2016;2016;11;22;Keskiviikko;6;5;11;2;0;2
96;09.11.2016;2016;11;23;Keskiviikko;1;5;6;0;0;0
96;10.11.2016;2016;11;00;Torstai;1;0;1;0;0;0
96;10.11.2016;2016;11;01;Torstai;1;1;2;0;0;0
96;10.11.2016;2016;11;02;Torstai;1;0;1;0;0;0
96;10.11.2016;2016;11;03;Torstai;0;2;2;0;0;0
96;10.11.2016;2016;11;04;Torstai;3;0;3;0;0;0
96;10.11.2016;2016;11;05;Torstai;4;6;10;0;1;1
96;10.11.2016;2016;11;06;Torstai;33;31;64;5;3;8
96;10.11.2016;2016;11;07;Torstai;94;97;191;13;16;29
96;10.11.2016;2016;11;08;Torstai;92;88;180;15;12;27
96;10.11.2016;2016;11;09;Torstai;59;60;119;8;9;17
96;10.11.2016;2016;11;10;Torstai;52;50;102;9;6;15
96;10.11.2016;2016;11;11;Torstai;41;44;85;5;8;13
96;10.11.2016;2016;11;12;Torstai;61;59;120;10;8;18
96;10.11.2016;2016;11;13;Torstai;62;64;126;8;11;19
96;10.11.2016;2016;11;14;Torstai;85;84;169;14;11;25
96;10.11.2016;2016;11;15;Torstai;115;117;232;16;18;34
96;10.11.2016;2016;11;16;Torstai;88;88;176;14;13;27
96;10.11.2016;2016;11;17;Torstai;56;59;115;8;9;17
96;10.11.2016;2016;11;18;Torstai;44;43;87;8;5;13
96;10.11.2016;2016;11;19;Torstai;31;33;64;4;6;10
96;10.11.2016;2016;11;20;Torstai;31;30;61;5;4;9
96;10.11.2016;2016;11;21;Torstai;26;28;54;2;5;7
96;10.11.2016;2016;11;22;Torstai;8;5;13;2;0;2
96;10.11.2016;2016;11;23;Torstai;1;4;5;0;0;0
96;11.11.2016;2016;11;00;Perjantai;3;1;4;0;0;0
96;11.11.2016;2016;11;01;Perjantai;1;3;4;0;0;0
96;11.11.2016;2016;11;02;Perjantai;1;1;2;0;0;0
96;11.11.2016;2016;11;03;Perjantai;3;4;7;0;0;0
96;11.11.2016;2016;11;04;Perjantai;5;2;7;0;0;0
96;11.11.2016;2016;11;05;Perjantai;3;4;7;0;1;1
96;11.11.2016;2016;11;06;Perjantai;31;30;61;6;4;10
96;11.11.2016;2016;11;07;Perjantai;82;84;166;12;13;25
96;11.11.2016;2016;11;08;Perjantai;81;78;159;13;11;24
96;11.11.2016;2016;11;09;Perjantai;52;53;105;7;9;16
96;11.11.2016;2016;11;10;Perjantai;49;46;95;7;7;14
96;11.11.2016;2016;11;11;Perjantai;47;48;95;6;8;14
96;11.11.2016;2016;11;12;Perjantai;64;63;127;11;9;20
96;11.11.2016;2016;11;13;Perjantai;71;73;144;11;12;23
96;11.11.2016;2016;11;14;Perjantai;99;98;197;16;13;29
96;11.11.2016;2016;11;15;Perjantai;100;102;202;15;15;30
96;11.11.2016;2016;11;16;Perjantai;57;54;111;9;7;16
96;11.11.2016;2016;11;17;Perjantai;51;54;105;7;9;16
96;11.11.2016;2016;11;18;Perjantai;33;32;65;5;4;9
96;11.11.2016;2016;11;19;Perjantai;27;29;56;3;5;8
96;11.11.2016;2016;11;20;Perjantai;19;17;36;4;2;6
96;11.11.2016;2016;11;21;Perjantai;21;21;42;2;4;6
96;11.11.2016;2016;11;22;Perjantai;9;6;15;2;0;2
96;11.11.2016;2016;11;23;Perjantai;3;7;10;0;0;0
96;12.11.2016;2016;11;00;Lauantai;2;0;2;1;0;1
96;12.11.2016;2016;11;01;Lauantai;2;4;6;1;4;5
96;12.11.2016;2016;11;02;Lauantai;3;1;4;2;0;2
96;12.11.2016;2016;11;03;Lauantai;1;4;5;1;2;3
96;12.11.2016;2016;11;04;Lauantai;4;2;6;3;1;4
96;12.11.2016;2016;11;05;Lauantai;2;3;5;0;2;2
96;12.11.2016;2016;11;06;Lauantai;8;5;13;6;4;10
96;12.11.2016;2016;11;07;Lauantai;5;6;11;3;5;8
96;12.11.2016;2016;11;08;Lauantai;8;7;15;7;6;13
96;12.11.2016;2016;11;09;Lauantai;10;12;22;8;12;20
96;12.11.2016;2016;11;10;Lauantai;16;15;31;16;14;30
96;12.11.2016;2016;11;11;Lauantai;17;19;36;17;18;35
96;12.11.2016;2016;11;12;Lauantai;26;25;51;25;22;47
96;12.11.2016;2016;11;13;Lauantai;29;31;60;27;29;56
96;12.11.2016;2016;11;14;Lauantai;26;24;50;25;23;48
96;12.11.2016;2016;11;15;Lauantai;21;22;43;21;21;42
96;12.11.2016;2016;11;16;Lauantai;20;17;37;19;16;35
96;12.11.2016;2016;11;17;Lauantai;15;16;31;13;16;29
96;12.11.2016;2016;11;18;Lauantai;12;11;23;11;10;21
96;12.11.2016;2016;11;19;Lauantai;13;16;29;12;16;28
96;12.11.2016;2016;11;20;Lauantai;13;11;24;11;9;20
96;12.11.2016;2016;11;21;Lauantai;10;10;20;8;10;18
96;12.11.2016;2016;11;22;Lauantai;5;3;8;4;2;6
96;12.11.2016;2016;11;23;Lauantai;6;7;13;5;6;11
96;13.11.2016;2016;11;00;Sunnuntai;4;1;5;4;1;5
96;13.11.2016;2016;11;01;Sunnuntai;1;4;5;0;2;2
96;13.11.2016;2016;11;02;Sunnuntai;1;0;1;1;0;1
96;13.11.2016;2016;11;03;Sunnuntai;2;3;5;2;2;4
96;13.11.2016;2016;11;04;Sunnuntai;3;1;4;2;0;2
96;13.11.2016;2016;11;05;Sunnuntai;0;2;2;0;0;0
96;13.11.2016;2016;11;06;Sunnuntai;7;4;11;6;3;9
96;13.11.2016;2016;11;07;Sunnuntai;3;5;8;1;5;6
96;13.11.2016;2016;11;08;Sunnuntai;7;4;11;5;4;9
96;13.11.2016;2016;11;09;Sunnuntai;3;5;8;3;5;8
96;13.11.2016;2016;11;10;Sunnuntai;8;7;15;8;6;14
96;13.11.2016;2016;11;11;Sunnuntai;8;9;17;7;9;16
96;13.11.2016;2016;11;12;Sunnuntai;15;15;30;15;13;28
96;13.11.2016;2016;11;13;Sunnuntai;15;17;32;14;16;30
96;13.11.2016;2016;11;14;Sunnuntai;19;18;37;19;16;35
96;13.11.2016;2016;11;15;Sunnuntai;14;16;30;13;16;29
96;13.11.2016;2016;11;16;Sunnuntai;19;16;35;16;16;32
96;13.11.2016;2016;11;17;Sunnuntai;13;14;27;11;13;24
96;13.11.2016;2016;11;18;Sunnuntai;20;17;37;17;16;33
96;13.11.2016;2016;11;19;Sunnuntai;11;12;23;10;12;22
96;13.11.2016;2016;11;20;Sunnuntai;13;9;22;13;9;22
96;13.11.2016;2016;11;21;Sunnuntai;10;14;24;10;13;23
96;13.11.2016;2016;11;22;Sunnuntai;2;2;4;2;2;4
96;13.11.2016;2016;11;23;Sunnuntai;0;3;3;0;3;3
96;14.11.2016;2016;11;00;Maanantai;3;1;4;0;0;0
96;14.11.2016;2016;11;01;Maanantai;0;0;0;0;0;0
96;14.11.2016;2016;11;02;Maanantai;2;0;2;0;0;0
96;14.11.2016;2016;11;03;Maanantai;0;3;3;0;0;0
96;14.11.2016;2016;11;04;Maanantai;2;0;2;0;0;0
96;14.11.2016;2016;11;05;Maanantai;2;5;7;0;1;1
96;14.11.2016;2016;11;06;Maanantai;34;33;67;6;4;10
96;14.11.2016;2016;11;07;Maanantai;103;105;208;15;16;31
96;14.11.2016;2016;11;08;Maanantai;100;98;198;16;14;30
96;14.11.2016;2016;11;09;Maanantai;65;68;133;9;10;19
96;14.11.2016;2016;11;10;Maanantai;55;52;107;8;8;16
96;14.11.2016;2016;11;11;Maanantai;55;57;112;7;10;17
96;14.11.2016;2016;11;12;Maanantai;69;66;135;12;9;21
96;14.11.2016;2016;11;13;Maanantai;64;65;129;9;11;20
96;14.11.2016;2016;11;14;Maanantai;83;81;164;13;11;24
96;14.11.2016;2016;11;15;Maanantai;127;128;255;18;19;37
96;14.11.2016;2016;11;16;Maanantai;117;114;231;19;16;35
96;14.11.2016;2016;11;17;Maanantai;57;59;116;8;10;18
96;14.11.2016;2016;11;18;Maanantai;46;43;89;8;5;13
96;14.11.2016;2016;11;19;Maanantai;35;37;72;4;7;11
96;14.11.2016;2016;11;20;Maanantai;36;33;69;6;4;10
96;14.11.2016;2016;11;21;Maanantai;27;27;54;2;5;7
96;14.11.2016;2016;11;22;Maanantai;8;5;13;1;0;1
96;14.11.2016;2016;11;23;Maanantai;3;5;8;0;1;1
96;15.11.2016;2016;11;00;Tiistai;2;1;3;0;0;0
96;15.11.2016;2016;11;01;Tiistai;0;1;1;0;0;0
96;15.11.2016;2016;11;02;Tiistai;0;0;0;0;0;0
96;15.11.2016;2016;11;03;Tiistai;0;2;2;0;0;0
96;15.11.2016;2016;11;04;Tiistai;1;0;1;0;0;0
96;15.11.2016;2016;11;05;Tiistai;3;7;10;0;2;2
96;15.11.2016;2016;11;06;Tiistai;42;40;82;7;6;13
96;15.11.2016;2016;11;07;Tiistai;108;110;218;16;17;33
96;15.11.2016;2016;11;08;Tiistai;81;78;159;13;11;24
96;15.11.2016;2016;11;09;Tiistai;71;74;145;10;12;22
96;15.11.2016;2016;11;10;Tiistai;40;37;77;7;4;11
96;15.11.2016;2016;11;11;Tiistai;64;66;130;9;11;20
96;15.11.2016;2016;11;12;Tiistai;60;56;116;9;8;17
96;15.11.2016;2016;11;13;Tiistai;60;63;123;8;11;19
96;15.11.2016;2016;11;14;Tiistai;78;76;154;12;11;23
96;15.11.2016;2016;11;15;Tiistai;131;132;263;17;21;38
96;15.11.2016;2016;11;16;Tiistai;103;101;204;16;15;31
96;15.11.2016;2016;11;17;Tiistai;58;59;117;8;10;18
96;15.11.2016;2016;11;18;Tiistai;59;57;116;10;8;18
96;15.11.2016;2016;11;19;Tiistai;43;46;89;6;6;12
96;15.11.2016;2016;11;20;Tiistai;46;43;89;7;6;13
96;15.11.2016;2016;11;21;Tiistai;22;23;45;3;4;7
96;15.11.2016;2016;11;22;Tiistai;8;5;13;1;0;1
96;15.11.2016;2016;11;23;Tiistai;2;4;6;0;0;0
96;16.11.2016;2016;11;00;Keskiviikko;3;1;4;0;0;0
96;16.11.2016;2016;11;01;Keskiviikko;0;1;1;0;0;0
96;16.11.2016;2016;11;02;Keskiviikko;0;0;0;0;0;0
96;16.11.2016;2016;11;03;Keskiviikko;0;1;1;0;0;0
96;16.11.2016;2016;11;04;Keskiviikko;6;3;9;1;0;1
96;16.11.2016;2016;11;05;Keskiviikko;5;5;10;0;2;2
96;16.11.2016;2016;11;06;Keskiviikko;32;30;62;5;4;9
96;16.11.2016;2016;11;07;Keskiviikko;99;100;199;14;15;29
96;16.11.2016;2016;11;08;Keskiviikko;87;84;171;14;12;26
96;16.11.2016;2016;11;09;Keskiviikko;68;71;139;9;11;20
96;16.11.2016;2016;11;10;Keskiviikko;61;57;118;11;7;18
96;16.11.2016;2016;11;11;Keskiviikko;63;64;127;9;11;20
96;16.11.2016;2016;11;12;Keskiviikko;70;67;137;12;9;21
96;16.11.2016;2016;11;13;Keskiviikko;68;69;137;9;12;21
96;16.11.2016;2016;11;14;Keskiviikko;92;91;183;15;13;28
96;16.11.2016;2016;11;15;Keskiviikko;112;112;224;16;17;33
96;16.11.2016;2016;11;16;Keskiviikko;108;105;213;17;14;31
96;16.11.2016;2016;11;17;Keskiviikko;54;57;111;9;9;18
96;16.11.2016;2016;11;18;Keskiviikko;57;55;112;10;7;17
96;16.11.2016;2016;11;19;Keskiviikko;44;48;92;6;8;14
96;16.11.2016;2016;11;20;Keskiviikko;42;40;82;8;4;12
96;16.11.2016;2016;11;21;Keskiviikko;24;27;51;2;5;7
96;16.11.2016;2016;11;22;Keskiviikko;7;5;12;1;0;1
96;16.11.2016;2016;11;23;Keskiviikko;4;7;11;0;1;1
96;17.11.2016;2016;11;00;Torstai;3;0;3;0;0;0
96;17.11.2016;2016;11;01;Torstai;0;2;2;0;0;0
96;17.11.2016;2016;11;02;Torstai;5;2;7;0;0;0
96;17.11.2016;2016;11;03;Torstai;0;2;2;0;0;0
96;17.11.2016;2016;11;04;Torstai;2;0;2;0;0;0
96;17.11.2016;2016;11;05;Torstai;4;7;11;0;1;1
96;17.11.2016;2016;11;06;Torstai;35;33;68;7;4;11
96;17.11.2016;2016;11;07;Torstai;97;100;197;13;16;29
96;17.11.2016;2016;11;08;Torstai;75;73;148;12;10;22
96;17.11.2016;2016;11;09;Torstai;74;77;151;10;12;22
96;17.11.2016;2016;11;10;Torstai;55;54;109;9;8;17
96;17.11.2016;2016;11;11;Torstai;56;58;114;8;8;16
96;17.11.2016;2016;11;12;Torstai;72;69;141;11;9;20
96;17.11.2016;2016;11;13;Torstai;77;80;157;10;13;23
96;17.11.2016;2016;11;14;Torstai;98;96;194;15;14;29
96;17.11.2016;2016;11;15;Torstai;104;108;212;15;17;32
96;17.11.2016;2016;11;16;Torstai;96;95;191;15;13;28
96;17.11.2016;2016;11;17;Torstai;56;59;115;8;9;17
96;17.11.2016;2016;11;18;Torstai;44;42;86;8;5;13
96;17.11.2016;2016;11;19;Torstai;39;41;80;5;8;13
96;17.11.2016;2016;11;20;Torstai;35;32;67;6;4;10
96;17.11.2016;2016;11;21;Torstai;21;23;44;2;4;6
96;17.11.2016;2016;11;22;Torstai;10;7;17;2;0;2
96;17.11.2016;2016;11;23;Torstai;1;2;3;0;0;0
96;18.11.2016;2016;11;00;Perjantai;4;2;6;0;0;0
96;18.11.2016;2016;11;01;Perjantai;1;3;4;0;0;0
96;18.11.2016;2016;11;02;Perjantai;2;1;3;0;0;0
96;18.11.2016;2016;11;03;Perjantai;0;1;1;0;0;0
96;18.11.2016;2016;11;04;Perjantai;2;1;3;0;0;0
96;18.11.2016;2016;11;05;Perjantai;5;7;12;0;2;2
96;18.11.2016;2016;11;06;Perjantai;32;31;63;6;3;9
96;18.11.2016;2016;11;07;Perjantai;79;81;160;10;13;23
96;18.11.2016;2016;11;08;Perjantai;72;70;142;12;10;22
96;18.11.2016;2016;11;09;Perjantai;50;52;102;7;9;16
96;18.11.2016;2016;11;10;Perjantai;43;41;84;6;5;11
96;18.11.2016;2016;11;11;Perjantai;48;51;99;7;9;16
96;18.11.2016;2016;11;12;Perjantai;59;57;116;10;8;18
96;18.11.2016;2016;11;13;Perjantai;61;62;123;9;10;19
96;18.11.2016;2016;11;14;Perjantai;90;89;179;14;13;27
96;18.11.2016;2016;11;15;Perjantai;78;79;157;11;13;24
96;18.11.2016;2016;11;16;Perjantai;60;58;118;10;8;18
96;18.11.2016;2016;11;17;Perjantai;36;39;75;4;8;12
96;18.11.2016;2016;11;18;Perjantai;26;24;50;5;3;8
96;18.11.2016;2016;11;19;Perjantai;25;26;51;3;4;7
96;18.11.2016;2016;11;20;Perjantai;23;21;44;4;2;6
96;18.11.2016;2016;11;21;Perjantai;13;15;28;0;4;4
96;18.11.2016;2016;11;22;Perjantai;5;2;7;1;0;1
96;18.11.2016;2016;11;23;Perjantai;4;6;10;0;1;1
96;19.11.2016;2016;11;00;Lauantai;3;2;5;2;2;4
96;19.11.2016;2016;11;01;Lauantai;0;2;2;0;1;1
96;19.11.2016;2016;11;02;Lauantai;3;0;3;1;0;1
96;19.11.2016;2016;11;03;Lauantai;0;4;4;0;3;3
96;19.11.2016;2016;11;04;Lauantai;4;0;4;1;0;1
96;19.11.2016;2016;11;05;Lauantai;0;3;3;0;1;1
96;19.11.2016;2016;11;06;Lauantai;5;2;7;3;1;4
96;19.11.2016;2016;11;07;Lauantai;4;7;11;4;5;9
96;19.11.2016;2016;11;08;Lauantai;11;8;19;10;7;17
96;19.11.2016;2016;11;09;Lauantai;6;9;15;6;7;13
96;19.11.2016;2016;11;10;Lauantai;13;9;22;13;9;22
96;19.11.2016;2016;11;11;Lauantai;11;14;25;10;13;23
96;19.11.2016;2016;11;12;Lauantai;15;13;28;15;12;27
96;19.11.2016;2016;11;13;Lauantai;17;18;35;15;17;32
96;19.11.2016;2016;11;14;Lauantai;14;12;26;14;11;25
96;19.11.2016;2016;11;15;Lauantai;14;18;32;14;15;29
96;19.11.2016;2016;11;16;Lauantai;17;14;31;16;13;29
96;19.11.2016;2016;11;17;Lauantai;7;9;16;6;8;14
96;19.11.2016;2016;11;18;Lauantai;15;11;26;12;11;23
96;19.11.2016;2016;11;19;Lauantai;9;11;20;9;9;18
96;19.11.2016;2016;11;20;Lauantai;11;8;19;11;7;18
96;19.11.2016;2016;11;21;Lauantai;7;7;14;6;7;13
96;19.11.2016;2016;11;22;Lauantai;5;4;9;5;1;6
96;19.11.2016;2016;11;23;Lauantai;3;6;9;2;4;6
96;20.11.2016;2016;11;00;Sunnuntai;4;0;4;3;0;3
96;20.11.2016;2016;11;01;Sunnuntai;4;6;10;2;5;7
96;20.11.2016;2016;11;02;Sunnuntai;2;1;3;1;1;2
96;20.11.2016;2016;11;03;Sunnuntai;2;5;7;1;3;4
96;20.11.2016;2016;11;04;Sunnuntai;3;2;5;3;1;4
96;20.11.2016;2016;11;05;Sunnuntai;1;4;5;1;1;2
96;20.11.2016;2016;11;06;Sunnuntai;5;5;10;5;3;8
96;20.11.2016;2016;11;07;Sunnuntai;2;6;8;2;3;5
96;20.11.2016;2016;11;08;Sunnuntai;6;4;10;5;4;9
96;20.11.2016;2016;11;09;Sunnuntai;6;7;13;5;6;11
96;20.11.2016;2016;11;10;Sunnuntai;9;8;17;8;6;14
96;20.11.2016;2016;11;11;Sunnuntai;14;16;30;13;14;27
96;20.11.2016;2016;11;12;Sunnuntai;22;21;43;22;19;41
96;20.11.2016;2016;11;13;Sunnuntai;21;22;43;20;22;42
96;20.11.2016;2016;11;14;Sunnuntai;25;22;47;23;22;45
96;20.11.2016;2016;11;15;Sunnuntai;21;23;44;19;21;40
96;20.11.2016;2016;11;16;Sunnuntai;30;29;59;29;27;56
96;20.11.2016;2016;11;17;Sunnuntai;14;15;29;13;14;27
96;20.11.2016;2016;11;18;Sunnuntai;24;22;46;22;21;43
96;20.11.2016;2016;11;19;Sunnuntai;17;18;35;15;18;33
96;20.11.2016;2016;11;20;Sunnuntai;17;15;32;16;15;31
96;20.11.2016;2016;11;21;Sunnuntai;12;15;27;11;14;25
96;20.11.2016;2016;11;22;Sunnuntai;6;4;10;5;3;8
96;20.11.2016;2016;11;23;Sunnuntai;0;4;4;0;3;3
96;21.11.2016;2016;11;00;Maanantai;4;1;5;0;0;0
96;21.11.2016;2016;11;01;Maanantai;0;1;1;0;0;0
96;21.11.2016;2016;11;02;Maanantai;1;1;2;0;0;0
96;21.11.2016;2016;11;03;Maanantai;0;2;2;0;0;0
96;21.11.2016;2016;11;04;Maanantai;2;1;3;0;0;0
96;21.11.2016;2016;11;05;Maanantai;3;4;7;0;2;2
96;21.11.2016;2016;11;06;Maanantai;30;29;59;6;3;9
96;21.11.2016;2016;11;07;Maanantai;103;104;207;14;18;32
96;21.11.2016;2016;11;08;Maanantai;92;89;181;14;13;27
96;21.11.2016;2016;11;09;Maanantai;65;67;132;9;12;21
96;21.11.2016;2016;11;10;Maanantai;58;56;114;9;8;17
96;21.11.2016;2016;11;11;Maanantai;65;68;133;9;11;20
96;21.11.2016;2016;11;12;Maanantai;69;67;136;12;10;22
96;21.11.2016;2016;11;13;Maanantai;64;67;131;9;11;20
96;21.11.2016;2016;11;14;Maanantai;91;89;180;14;13;27
96;21.11.2016;2016;11;15;Maanantai;106;109;215;15;16;31
96;21.11.2016;2016;11;16;Maanantai;93;91;184;15;12;27
96;21.11.2016;2016;11;17;Maanantai;43;47;90;5;7;12
96;21.11.2016;2016;11;18;Maanantai;45;43;88;8;5;13
96;21.11.2016;2016;11;19;Maanantai;33;36;69;4;6;10
96;21.11.2016;2016;11;20;Maanantai;30;29;59;5;4;9
96;21.11.2016;2016;11;21;Maanantai;22;23;45;3;4;7
96;21.11.2016;2016;11;22;Maanantai;7;3;10;2;0;2
96;21.11.2016;2016;11;23;Maanantai;1;4;5;0;0;0
96;22.11.2016;2016;11;00;Tiistai;1;0;1;0;0;0
96;22.11.2016;2016;11;01;Tiistai;2;3;5;0;0;0
96;22.11.2016;2016;11;02;Tiistai;0;0;0;0;0;0
96;22.11.2016;2016;11;03;Tiistai;1;1;2;0;0;0
96;22.11.2016;2016;11;04;Tiistai;1;0;1;0;0;0
96;22.11.2016;2016;11;05;Tiistai;2;6;8;0;2;2
96;22.11.2016;2016;11;06;Tiistai;42;39;81;7;5;12
96;22.11.2016;2016;11;07;Tiistai;112;114;226;16;19;35
96;22.11.2016;2016;11;08;Tiistai;85;83;168;14;12;26
96;22.11.2016;2016;11;09;Tiistai;58;61;119;8;10;18
96;22.11.2016;2016;11;10;Tiistai;55;53;108;8;8;16
96;22.11.2016;2016;11;11;Tiistai;63;66;129;9;10;19
96;22.11.2016;2016;11;12;Tiistai;85;83;168;14;11;25
96;22.11.2016;2016;11;13;Tiistai;70;71;141;9;11;20
96;22.11.2016;2016;11;14;Tiistai;106;103;209;17;14;31
96;22.11.2016;2016;11;15;Tiistai;135;138;273;19;22;41
96;22.11.2016;2016;11;16;Tiistai;100;98;198;16;14;30
96;22.11.2016;2016;11;17;Tiistai;64;66;130;9;11;20
96;22.11.2016;2016;11;18;Tiistai;44;40;84;8;5;13
96;22.11.2016;2016;11;19;Tiistai;34;38;72;5;7;12
96;22.11.2016;2016;11;20;Tiistai;33;32;65;6;4;10
96;22.11.2016;2016;11;21;Tiistai;25;28;53;3;4;7
96;22.11.2016;2016;11;22;Tiistai;7;5;12;2;0;2
96;22.11.2016;2016;11;23;Tiistai;2;4;6;0;0;0
96;23.11.2016;2016;11;00;Keskiviikko;3;1;4;0;0;0
96;23.11.2016;2016;11;01;Keskiviikko;0;0;0;0;0;0
96;23.11.2016;2016;11;02;Keskiviikko;1;0;1;0;0;0
96;23.11.2016;2016;11;03;Keskiviikko;0;0;0;0;0;0
96;23.11.2016;2016;11;04;Keskiviikko;2;0;2;0;0;0
96;23.11.2016;2016;11;05;Keskiviikko;4;6;10;0;1;1
96;23.11.2016;2016;11;06;Keskiviikko;39;37;76;7;4;11
96;23.11.2016;2016;11;07;Keskiviikko;104;106;210;14;16;30
96;23.11.2016;2016;11;08;Keskiviikko;83;79;162;13;11;24
96;23.11.2016;2016;11;09;Keskiviikko;53;55;108;8;10;18
96;23.11.2016;2016;11;10;Keskiviikko;50;47;97;8;7;15
96;23.11.2016;2016;11;11;Keskiviikko;66;68;134;9;10;19
96;23.11.2016;2016;11;12;Keskiviikko;66;63;129;11;8;19
96;23.11.2016;2016;11;13;Keskiviikko;67;70;137;8;11;19
96;23.11.2016;2016;11;14;Keskiviikko;85;82;167;13;11;24
96;23.11.2016;2016;11;15;Keskiviikko;108;110;218;15;17;32
96;23.11.2016;2016;11;16;Keskiviikko;85;83;168;14;11;25
96;23.11.2016;2016;11;17;Keskiviikko;41;43;84;5;7;12
96;23.11.2016;2016;11;18;Keskiviikko;67;65;132;10;9;19
96;23.11.2016;2016;11;19;Keskiviikko;40;42;82;6;7;13
96;23.11.2016;2016;11;20;Keskiviikko;39;37;76;6;5;11
96;23.11.2016;2016;11;21;Keskiviikko;22;24;46;3;5;8
96;23.11.2016;2016;11;22;Keskiviikko;10;7;17;2;0;2
96;23.11.2016;2016;11;23;Keskiviikko;4;5;9;0;0;0
96;24.11.2016;2016;11;00;Torstai;2;0;2;0;0;0
96;24.11.2016;2016;11;01;Torstai;2;3;5;0;0;0
96;24.11.2016;2016;11;02;Torstai;4;1;5;0;0;0
96;24.11.2016;2016;11;03;Torstai;0;2;2;0;0;0
96;24.11.2016;2016;11;04;Torstai;3;0;3;0;0;0
96;24.11.2016;2016;11;05;Torstai;3;5;8;0;1;1
96;24.11.2016;2016;11;06;Torstai;35;32;67;5;5;10
96;24.11.2016;2016;11;07;Torstai;90;92;182;12;14;26
96;24.11.2016;2016;11;08;Torstai;75;71;146;12;10;22
96;24.11.2016;2016;11;09;Torstai;50;51;101;6;9;15
96;24.11.2016;2016;11;10;Torstai;44;43;87;7;6;13
96;24.11.2016;2016;11;11;Torstai;62;63;125;8;9;17
96;24.11.2016;2016;11;12;Torstai;68;65;133;12;9;21
96;24.11.2016;2016;11;13;Torstai;64;64;128;8;11;19
96;24.11.2016;2016;11;14;Torstai;86;84;170;14;11;25
96;24.11.2016;2016;11;15;Torstai;107;109;216;16;17;33
96;24.11.2016;2016;11;16;Torstai;85;84;169;14;12;26
96;24.11.2016;2016;11;17;Torstai;61;61;122;8;9;17
96;24.11.2016;2016;11;18;Torstai;49;48;97;9;6;15
96;24.11.2016;2016;11;19;Torstai;37;38;75;5;7;12
96;24.11.2016;2016;11;20;Torstai;41;39;80;7;5;12
96;24.11.2016;2016;11;21;Torstai;28;29;57;4;6;10
96;24.11.2016;2016;11;22;Torstai;10;6;16;3;0;3
96;24.11.2016;2016;11;23;Torstai;2;2;4;0;0;0
96;25.11.2016;2016;11;00;Perjantai;2;0;2;0;0;0
96;25.11.2016;2016;11;01;Perjantai;1;3;4;0;0;0
96;25.11.2016;2016;11;02;Perjantai;2;0;2;0;0;0
96;25.11.2016;2016;11;03;Perjantai;3;5;8;0;1;1
96;25.11.2016;2016;11;04;Perjantai;5;1;6;0;0;0
96;25.11.2016;2016;11;05;Perjantai;3;6;9;0;1;1
96;25.11.2016;2016;11;06;Perjantai;34;32;66;7;4;11
96;25.11.2016;2016;11;07;Perjantai;95;97;192;14;14;28
96;25.11.2016;2016;11;08;Perjantai;67;65;132;11;9;20
96;25.11.2016;2016;11;09;Perjantai;59;60;119;8;9;17
96;25.11.2016;2016;11;10;Perjantai;53;50;103;8;7;15
96;25.11.2016;2016;11;11;Perjantai;66;68;134;9;11;20
96;25.11.2016;2016;11;12;Perjantai;67;66;133;11;10;21
96;25.11.2016;2016;11;13;Perjantai;66;67;133;8;12;20
96;25.11.2016;2016;11;14;Perjantai;84;82;166;13;12;25
96;25.11.2016;2016;11;15;Perjantai;85;86;171;12;12;24
96;25.11.2016;2016;11;16;Perjantai;58;55;113;9;7;16
96;25.11.2016;2016;11;17;Perjantai;37;39;76;4;7;11
96;25.11.2016;2016;11;18;Perjantai;33;31;64;5;3;8
96;25.11.2016;2016;11;19;Perjantai;22;24;46;1;5;6
96;25.11.2016;2016;11;20;Perjantai;26;24;50;5;3;8
96;25.11.2016;2016;11;21;Perjantai;18;20;38;1;4;5
96;25.11.2016;2016;11;22;Perjantai;9;6;15;3;0;3
96;25.11.2016;2016;11;23;Perjantai;4;7;11;0;3;3
96;26.11.2016;2016;11;00;Lauantai;2;1;3;1;0;1
96;26.11.2016;2016;11;01;Lauantai;1;4;5;1;3;4
96;26.11.2016;2016;11;02;Lauantai;3;1;4;2;1;3
96;26.11.2016;2016;11;03;Lauantai;0;3;3;0;2;2
96;26.11.2016;2016;11;04;Lauantai;5;1;6;2;1;3
96;26.11.2016;2016;11;05;Lauantai;2;4;6;1;4;5
96;26.11.2016;2016;11;06;Lauantai;7;4;11;6;4;10
96;26.11.2016;2016;11;07;Lauantai;5;6;11;4;5;9
96;26.11.2016;2016;11;08;Lauantai;11;9;20;10;8;18
96;26.11.2016;2016;11;09;Lauantai;7;10;17;7;9;16
96;26.11.2016;2016;11;10;Lauantai;10;10;20;10;7;17
96;26.11.2016;2016;11;11;Lauantai;16;17;33;14;17;31
96;26.11.2016;2016;11;12;Lauantai;17;16;33;16;15;31
96;26.11.2016;2016;11;13;Lauantai;15;16;31;14;16;30
96;26.11.2016;2016;11;14;Lauantai;20;17;37;19;17;36
96;26.11.2016;2016;11;15;Lauantai;17;21;38;17;19;36
96;26.11.2016;2016;11;16;Lauantai;20;20;40;20;19;39
96;26.11.2016;2016;11;17;Lauantai;13;16;29;13;13;26
96;26.11.2016;2016;11;18;Lauantai;15;12;27;14;12;26
96;26.11.2016;2016;11;19;Lauantai;17;19;36;17;18;35
96;26.11.2016;2016;11;20;Lauantai;15;14;29;15;12;27
96;26.11.2016;2016;11;21;Lauantai;10;12;22;9;11;20
96;26.11.2016;2016;11;22;Lauantai;6;2;8;4;2;6
96;26.11.2016;2016;11;23;Lauantai;6;6;12;2;6;8
96;27.11.2016;2016;11;00;Sunnuntai;7;6;13;6;5;11
96;27.11.2016;2016;11;01;Sunnuntai;15;16;31;13;16;29
96;27.11.2016;2016;11;02;Sunnuntai;4;3;7;4;2;6
96;27.11.2016;2016;11;03;Sunnuntai;1;3;4;1;1;2
96;27.11.2016;2016;11;04;Sunnuntai;3;1;4;3;1;4
96;27.11.2016;2016;11;05;Sunnuntai;2;3;5;1;2;3
96;27.11.2016;2016;11;06;Sunnuntai;7;6;13;6;5;11
96;27.11.2016;2016;11;07;Sunnuntai;3;4;7;3;3;6
96;27.11.2016;2016;11;08;Sunnuntai;4;2;6;3;2;5
96;27.11.2016;2016;11;09;Sunnuntai;6;9;15;6;7;13
96;27.11.2016;2016;11;10;Sunnuntai;8;7;15;7;5;12
96;27.11.2016;2016;11;11;Sunnuntai;10;12;22;9;11;20
96;27.11.2016;2016;11;12;Sunnuntai;17;16;33;16;13;29
96;27.11.2016;2016;11;13;Sunnuntai;16;17;33;14;16;30
96;27.11.2016;2016;11;14;Sunnuntai;19;17;36;18;16;34
96;27.11.2016;2016;11;15;Sunnuntai;21;23;44;20;22;42
96;27.11.2016;2016;11;16;Sunnuntai;20;18;38;19;18;37
96;27.11.2016;2016;11;17;Sunnuntai;10;13;23;9;12;21
96;27.11.2016;2016;11;18;Sunnuntai;19;17;36;18;17;35
96;27.11.2016;2016;11;19;Sunnuntai;14;17;31;14;15;29
96;27.11.2016;2016;11;20;Sunnuntai;13;11;24;13;10;23
96;27.11.2016;2016;11;21;Sunnuntai;9;9;18;9;9;18
96;27.11.2016;2016;11;22;Sunnuntai;5;1;6;4;1;5
96;27.11.2016;2016;11;23;Sunnuntai;0;3;3;0;2;2
96;28.11.2016;2016;11;00;Maanantai;0;0;0;1;0;1
96;28.11.2016;2016;11;01;Maanantai;4;0;4;0;0;0
96;28.11.2016;2016;11;02;Maanantai;0;0;0;0;0;0
96;28.11.2016;2016;11;03;Maanantai;2;0;2;3;0;3
96;28.11.2016;2016;11;04;Maanantai;1;0;1;1;0;1
96;28.11.2016;2016;11;05;Maanantai;4;7;11;2;0;2
96;28.11.2016;2016;11;06;Maanantai;45;22;67;5;0;5
96;28.11.2016;2016;11;07;Maanantai;81;75;156;21;0;21
96;28.11.2016;2016;11;08;Maanantai;96;63;159;25;0;25
96;28.11.2016;2016;11;09;Maanantai;50;54;104;30;0;30
96;28.11.2016;2016;11;10;Maanantai;38;50;88;12;0;12
96;28.11.2016;2016;11;11;Maanantai;48;46;94;21;0;21
96;28.11.2016;2016;11;12;Maanantai;55;56;111;22;0;22
96;28.11.2016;2016;11;13;Maanantai;57;37;94;13;0;13
96;28.11.2016;2016;11;14;Maanantai;57;89;146;29;0;29
96;28.11.2016;2016;11;15;Maanantai;59;157;216;40;0;40
96;28.11.2016;2016;11;16;Maanantai;73;84;157;53;0;53
96;28.11.2016;2016;11;17;Maanantai;53;51;104;21;0;21
96;28.11.2016;2016;11;18;Maanantai;62;43;105;4;0;4
96;28.11.2016;2016;11;19;Maanantai;46;25;71;5;0;5
96;28.11.2016;2016;11;20;Maanantai;30;33;63;1;0;1
96;28.11.2016;2016;11;21;Maanantai;23;34;57;6;0;6
96;28.11.2016;2016;11;22;Maanantai;6;5;11;0;0;0
96;28.11.2016;2016;11;23;Maanantai;7;0;7;3;0;3
96;29.11.2016;2016;11;00;Tiistai;2;0;2;1;0;1
96;29.11.2016;2016;11;01;Tiistai;3;0;3;0;0;0
96;29.11.2016;2016;11;02;Tiistai;2;0;2;0;0;0
96;29.11.2016;2016;11;03;Tiistai;4;0;4;1;0;1
96;29.11.2016;2016;11;04;Tiistai;5;0;5;1;0;1
96;29.11.2016;2016;11;05;Tiistai;15;0;15;1;0;1
96;29.11.2016;2016;11;06;Tiistai;70;0;70;7;0;7
96;29.11.2016;2016;11;07;Tiistai;180;0;180;16;0;16
96;29.11.2016;2016;11;08;Tiistai;160;0;160;9;0;9
96;29.11.2016;2016;11;09;Tiistai;44;49;93;15;10;25
96;29.11.2016;2016;11;10;Tiistai;46;36;82;8;5;13
96;29.11.2016;2016;11;11;Tiistai;62;45;107;17;5;22
96;29.11.2016;2016;11;12;Tiistai;68;61;129;11;15;26
96;29.11.2016;2016;11;13;Tiistai;45;65;110;11;13;24
96;29.11.2016;2016;11;14;Tiistai;39;99;138;8;24;32
96;29.11.2016;2016;11;15;Tiistai;53;188;241;11;47;58
96;29.11.2016;2016;11;16;Tiistai;71;87;158;11;39;50
96;29.11.2016;2016;11;17;Tiistai;53;76;129;8;16;24
96;29.11.2016;2016;11;18;Tiistai;42;18;60;11;13;24
96;29.11.2016;2016;11;19;Tiistai;29;24;53;12;15;27
96;29.11.2016;2016;11;20;Tiistai;37;17;54;11;9;20
96;29.11.2016;2016;11;21;Tiistai;20;24;44;4;6;10
96;29.11.2016;2016;11;22;Tiistai;8;8;16;3;1;4
96;29.11.2016;2016;11;23;Tiistai;2;0;2;1;1;2
96;30.11.2016;2016;11;00;Keskiviikko;0;0;0;0;0;0
96;30.11.2016;2016;11;01;Keskiviikko;4;0;4;0;1;1
96;30.11.2016;2016;11;02;Keskiviikko;0;0;0;0;0;0
96;30.11.2016;2016;11;03;Keskiviikko;2;0;2;1;0;1
96;30.11.2016;2016;11;04;Keskiviikko;1;0;1;2;4;6
96;30.11.2016;2016;11;05;Keskiviikko;4;7;11;1;1;2
96;30.11.2016;2016;11;06;Keskiviikko;45;22;67;13;2;15
96;30.11.2016;2016;11;07;Keskiviikko;81;75;156;30;12;42
96;30.11.2016;2016;11;08;Keskiviikko;96;63;159;15;12;27
96;30.11.2016;2016;11;09;Keskiviikko;50;54;104;14;8;22
96;30.11.2016;2016;11;10;Keskiviikko;38;50;88;12;17;29
96;30.11.2016;2016;11;11;Keskiviikko;48;46;94;17;18;35
96;30.11.2016;2016;11;12;Keskiviikko;65;66;131;17;13;30
96;30.11.2016;2016;11;13;Keskiviikko;77;67;144;8;23;31
96;30.11.2016;2016;11;14;Keskiviikko;57;89;146;6;22;28
96;30.11.2016;2016;11;15;Keskiviikko;59;157;216;10;39;49
96;30.11.2016;2016;11;16;Keskiviikko;73;84;157;13;34;47
96;30.11.2016;2016;11;17;Keskiviikko;43;31;74;19;17;36
96;30.11.2016;2016;11;18;Keskiviikko;62;43;105;32;16;48
96;30.11.2016;2016;11;19;Keskiviikko;46;25;71;16;14;30
96;30.11.2016;2016;11;20;Keskiviikko;30;33;63;11;14;25
96;30.11.2016;2016;11;21;Keskiviikko;23;34;57;2;5;7
96;30.11.2016;2016;11;22;Keskiviikko;6;10;16;2;0;2
96;30.11.2016;2016;11;23;Keskiviikko;7;0;7;1;2;3
96;01.12.2016;2016;12;00;Torstai;2;1;3;1;1;2
96;01.12.2016;2016;12;01;Torstai;2;0;2;1;0;1
96;01.12.2016;2016;12;02;Torstai;2;0;2;0;0;0
96;01.12.2016;2016;12;03;Torstai;2;0;2;1;1;2
96;01.12.2016;2016;12;04;Torstai;5;0;5;6;2;8
96;01.12.2016;2016;12;05;Torstai;7;3;10;0;3;3
96;01.12.2016;2016;12;06;Torstai;45;23;68;18;3;21
96;01.12.2016;2016;12;07;Torstai;112;90;202;35;11;46
96;01.12.2016;2016;12;08;Torstai;72;86;158;18;12;30
96;01.12.2016;2016;12;09;Torstai;71;62;133;25;11;36
96;01.12.2016;2016;12;10;Torstai;71;41;112;21;22;43
96;01.12.2016;2016;12;11;Torstai;51;45;96;16;12;28
96;01.12.2016;2016;12;12;Torstai;72;55;127;17;23;40
96;01.12.2016;2016;12;13;Torstai;72;77;149;21;30;51
96;01.12.2016;2016;12;14;Torstai;67;107;174;13;23;36
96;01.12.2016;2016;12;15;Torstai;77;144;221;15;34;49
96;01.12.2016;2016;12;16;Torstai;77;122;199;7;31;38
96;01.12.2016;2016;12;17;Torstai;74;48;122;17;16;33
96;01.12.2016;2016;12;18;Torstai;31;43;74;12;19;31
96;01.12.2016;2016;12;19;Torstai;44;22;66;19;10;29
96;01.12.2016;2016;12;20;Torstai;33;23;56;14;10;24
96;01.12.2016;2016;12;21;Torstai;19;24;43;5;9;14
96;01.12.2016;2016;12;22;Torstai;6;11;17;4;2;6
96;01.12.2016;2016;12;23;Torstai;1;2;3;0;1;1
96;02.12.2016;2016;12;00;Perjantai;3;0;3;0;0;0
96;02.12.2016;2016;12;01;Perjantai;3;0;3;0;0;0
96;02.12.2016;2016;12;02;Perjantai;6;0;6;0;0;0
96;02.12.2016;2016;12;03;Perjantai;3;2;5;0;0;0
96;02.12.2016;2016;12;04;Perjantai;1;2;3;0;0;0
96;02.12.2016;2016;12;05;Perjantai;2;4;6;0;1;1
96;02.12.2016;2016;12;06;Perjantai;33;26;59;15;1;16
96;02.12.2016;2016;12;07;Perjantai;90;70;160;35;11;46
96;02.12.2016;2016;12;08;Perjantai;73;61;134;19;7;26
96;02.12.2016;2016;12;09;Perjantai;55;47;102;9;14;23
96;02.12.2016;2016;12;10;Perjantai;39;38;77;11;6;17
96;02.12.2016;2016;12;11;Perjantai;43;48;91;5;15;20
96;02.12.2016;2016;12;12;Perjantai;40;78;118;10;23;33
96;02.12.2016;2016;12;13;Perjantai;42;80;122;13;15;28
96;02.12.2016;2016;12;14;Perjantai;63;99;162;5;31;36
96;02.12.2016;2016;12;15;Perjantai;52;77;129;8;34;42
96;02.12.2016;2016;12;16;Perjantai;46;41;87;5;16;21
96;02.12.2016;2016;12;17;Perjantai;32;32;64;7;9;16
96;02.12.2016;2016;12;18;Perjantai;23;18;41;5;4;9
96;02.12.2016;2016;12;19;Perjantai;19;11;30;7;3;10
96;02.12.2016;2016;12;20;Perjantai;22;16;38;9;7;16
96;02.12.2016;2016;12;21;Perjantai;18;23;41;1;9;10
96;02.12.2016;2016;12;22;Perjantai;10;10;20;3;3;6
96;02.12.2016;2016;12;23;Perjantai;10;8;18;1;2;3
96;03.12.2016;2016;12;00;Lauantai;3;2;5;2;1;3
96;03.12.2016;2016;12;01;Lauantai;5;4;9;0;0;0
96;03.12.2016;2016;12;02;Lauantai;8;2;10;5;1;6
96;03.12.2016;2016;12;03;Lauantai;3;0;3;2;0;2
96;03.12.2016;2016;12;04;Lauantai;8;1;9;1;0;1
96;03.12.2016;2016;12;05;Lauantai;0;5;5;0;2;2
96;03.12.2016;2016;12;06;Lauantai;17;4;21;2;1;3
96;03.12.2016;2016;12;07;Lauantai;0;14;14;1;6;7
96;03.12.2016;2016;12;08;Lauantai;4;12;16;3;3;6
96;03.12.2016;2016;12;09;Lauantai;12;17;29;6;8;14
96;03.12.2016;2016;12;10;Lauantai;15;18;33;7;5;12
96;03.12.2016;2016;12;11;Lauantai;22;19;41;13;8;21
96;03.12.2016;2016;12;12;Lauantai;16;35;51;7;14;21
96;03.12.2016;2016;12;13;Lauantai;28;21;49;18;12;30
96;03.12.2016;2016;12;14;Lauantai;20;24;44;11;11;22
96;03.12.2016;2016;12;15;Lauantai;27;24;51;12;15;27
96;03.12.2016;2016;12;16;Lauantai;23;23;46;4;17;21
96;03.12.2016;2016;12;17;Lauantai;11;10;21;5;2;7
96;03.12.2016;2016;12;18;Lauantai;15;5;20;14;5;19
96;03.12.2016;2016;12;19;Lauantai;18;9;27;10;11;21
96;03.12.2016;2016;12;20;Lauantai;15;8;23;9;5;14
96;03.12.2016;2016;12;21;Lauantai;9;17;26;0;10;10
96;03.12.2016;2016;12;22;Lauantai;5;1;6;2;1;3
96;03.12.2016;2016;12;23;Lauantai;5;6;11;0;1;1
96;04.12.2016;2016;12;00;Sunnuntai;5;2;7;0;0;0
96;04.12.2016;2016;12;01;Sunnuntai;0;5;5;1;1;2
96;04.12.2016;2016;12;02;Sunnuntai;4;1;5;1;0;1
96;04.12.2016;2016;12;03;Sunnuntai;3;1;4;2;0;2
96;04.12.2016;2016;12;04;Sunnuntai;4;0;4;1;0;1
96;04.12.2016;2016;12;05;Sunnuntai;1;3;4;3;0;3
96;04.12.2016;2016;12;06;Sunnuntai;17;2;19;1;0;1
96;04.12.2016;2016;12;07;Sunnuntai;0;7;7;1;6;7
96;04.12.2016;2016;12;08;Sunnuntai;4;3;7;2;2;4
96;04.12.2016;2016;12;09;Sunnuntai;7;9;16;6;3;9
96;04.12.2016;2016;12;10;Sunnuntai;6;6;12;3;5;8
96;04.12.2016;2016;12;11;Sunnuntai;10;15;25;5;11;16
96;04.12.2016;2016;12;12;Sunnuntai;17;32;49;10;10;20
96;04.12.2016;2016;12;13;Sunnuntai;23;17;40;11;8;19
96;04.12.2016;2016;12;14;Sunnuntai;19;21;40;5;5;10
96;04.12.2016;2016;12;15;Sunnuntai;17;25;42;3;11;14
96;04.12.2016;2016;12;16;Sunnuntai;23;9;32;4;2;6
96;04.12.2016;2016;12;17;Sunnuntai;27;7;34;6;0;6
96;04.12.2016;2016;12;18;Sunnuntai;14;0;14;2;0;2
96;04.12.2016;2016;12;19;Sunnuntai;16;0;16;3;0;3
96;04.12.2016;2016;12;20;Sunnuntai;11;2;13;8;0;8
96;04.12.2016;2016;12;21;Sunnuntai;15;1;16;6;0;6
96;04.12.2016;2016;12;22;Sunnuntai;4;1;5;0;0;0
96;04.12.2016;2016;12;23;Sunnuntai;5;0;5;0;0;0
96;05.12.2016;2016;12;00;Maanantai;3;0;3;1;0;1
96;05.12.2016;2016;12;01;Maanantai;4;1;5;0;0;0
96;05.12.2016;2016;12;02;Maanantai;3;0;3;0;0;0
96;05.12.2016;2016;12;03;Maanantai;0;0;0;2;0;2
96;05.12.2016;2016;12;04;Maanantai;1;0;1;0;0;0
96;05.12.2016;2016;12;05;Maanantai;3;1;4;0;0;0
96;05.12.2016;2016;12;06;Maanantai;32;8;40;2;0;2
96;05.12.2016;2016;12;07;Maanantai;62;19;81;9;0;9
96;05.12.2016;2016;12;08;Maanantai;39;13;52;7;0;7
96;05.12.2016;2016;12;09;Maanantai;41;9;50;3;0;3
96;05.12.2016;2016;12;10;Maanantai;49;5;54;5;0;5
96;05.12.2016;2016;12;11;Maanantai;49;4;53;16;0;16
96;05.12.2016;2016;12;12;Maanantai;55;7;62;7;0;7
96;05.12.2016;2016;12;13;Maanantai;55;5;60;9;0;9
96;05.12.2016;2016;12;14;Maanantai;78;11;89;21;0;21
96;05.12.2016;2016;12;15;Maanantai;91;17;108;20;0;20
96;05.12.2016;2016;12;16;Maanantai;80;12;92;19;0;19
96;05.12.2016;2016;12;17;Maanantai;62;2;64;8;0;8
96;05.12.2016;2016;12;18;Maanantai;48;3;51;7;0;7
96;05.12.2016;2016;12;19;Maanantai;33;2;35;7;0;7
96;05.12.2016;2016;12;20;Maanantai;43;3;46;9;0;9
96;05.12.2016;2016;12;21;Maanantai;33;3;36;6;0;6
96;05.12.2016;2016;12;22;Maanantai;9;1;10;1;0;1
96;05.12.2016;2016;12;23;Maanantai;3;0;3;3;1;4
96;06.12.2016;2016;12;00;Tiistai;2;0;2;1;0;1
96;06.12.2016;2016;12;01;Tiistai;2;0;2;1;0;1
96;06.12.2016;2016;12;02;Tiistai;2;0;2;2;0;2
96;06.12.2016;2016;12;03;Tiistai;3;0;3;0;0;0
96;06.12.2016;2016;12;04;Tiistai;2;0;2;2;0;2
96;06.12.2016;2016;12;05;Tiistai;7;0;7;2;0;2
96;06.12.2016;2016;12;06;Tiistai;17;1;18;9;0;9
96;06.12.2016;2016;12;07;Tiistai;16;1;17;4;0;4
96;06.12.2016;2016;12;08;Tiistai;4;1;5;3;0;3
96;06.12.2016;2016;12;09;Tiistai;4;1;5;5;0;5
96;06.12.2016;2016;12;10;Tiistai;9;0;9;5;0;5
96;06.12.2016;2016;12;11;Tiistai;13;0;13;5;0;5
96;06.12.2016;2016;12;12;Tiistai;18;4;22;13;0;13
96;06.12.2016;2016;12;13;Tiistai;28;1;29;8;0;8
96;06.12.2016;2016;12;14;Tiistai;25;4;29;11;0;11
96;06.12.2016;2016;12;15;Tiistai;23;4;27;7;0;7
96;06.12.2016;2016;12;16;Tiistai;14;3;17;5;2;7
96;06.12.2016;2016;12;17;Tiistai;15;0;15;8;0;8
96;06.12.2016;2016;12;18;Tiistai;13;1;14;4;0;4
96;06.12.2016;2016;12;19;Tiistai;7;0;7;5;0;5
96;06.12.2016;2016;12;20;Tiistai;10;2;12;4;0;4
96;06.12.2016;2016;12;21;Tiistai;13;5;18;7;0;7
96;06.12.2016;2016;12;22;Tiistai;6;1;7;0;0;0
96;06.12.2016;2016;12;23;Tiistai;4;0;4;0;0;0
96;07.12.2016;2016;12;00;Keskiviikko;3;1;4;0;0;0
96;07.12.2016;2016;12;01;Keskiviikko;0;0;0;0;0;0
96;07.12.2016;2016;12;02;Keskiviikko;0;0;0;0;0;0
96;07.12.2016;2016;12;03;Keskiviikko;1;0;1;0;0;0
96;07.12.2016;2016;12;04;Keskiviikko;1;0;1;0;0;0
96;07.12.2016;2016;12;05;Keskiviikko;6;3;9;4;0;4
96;07.12.2016;2016;12;06;Keskiviikko;59;3;62;15;0;15
96;07.12.2016;2016;12;07;Keskiviikko;102;73;175;35;12;47
96;07.12.2016;2016;12;08;Keskiviikko;95;53;148;27;12;39
96;07.12.2016;2016;12;09;Keskiviikko;70;55;125;21;8;29
96;07.12.2016;2016;12;10;Keskiviikko;43;38;81;7;8;15
96;07.12.2016;2016;12;11;Keskiviikko;52;54;106;15;13;28
96;07.12.2016;2016;12;12;Keskiviikko;67;53;120;13;12;25
96;07.12.2016;2016;12;13;Keskiviikko;57;84;141;17;31;48
96;07.12.2016;2016;12;14;Keskiviikko;60;124;184;13;31;44
96;07.12.2016;2016;12;15;Keskiviikko;56;154;210;9;39;48
96;07.12.2016;2016;12;16;Keskiviikko;69;120;189;11;39;50
96;07.12.2016;2016;12;17;Keskiviikko;41;44;85;22;21;43
96;07.12.2016;2016;12;18;Keskiviikko;65;35;100;27;12;39
96;07.12.2016;2016;12;19;Keskiviikko;55;39;94;13;17;30
96;07.12.2016;2016;12;20;Keskiviikko;35;38;73;14;20;34
96;07.12.2016;2016;12;21;Keskiviikko;19;38;57;3;10;13
96;07.12.2016;2016;12;22;Keskiviikko;1;10;11;1;2;3
96;07.12.2016;2016;12;23;Keskiviikko;7;1;8;0;0;0
96;08.12.2016;2016;12;00;Torstai;1;0;1;0;1;1
96;08.12.2016;2016;12;01;Torstai;1;0;1;1;0;1
96;08.12.2016;2016;12;02;Torstai;2;0;2;3;0;3
96;08.12.2016;2016;12;03;Torstai;2;0;2;0;0;0
96;08.12.2016;2016;12;04;Torstai;2;0;2;0;1;1
96;08.12.2016;2016;12;05;Torstai;5;7;12;1;1;2
96;08.12.2016;2016;12;06;Torstai;42;23;65;13;6;19
96;08.12.2016;2016;12;07;Torstai;113;96;209;18;14;32
96;08.12.2016;2016;12;08;Torstai;73;70;143;11;6;17
96;08.12.2016;2016;12;09;Torstai;107;48;155;12;7;19
96;08.12.2016;2016;12;10;Torstai;65;55;120;11;22;33
96;08.12.2016;2016;12;11;Torstai;71;58;129;9;9;18
96;08.12.2016;2016;12;12;Torstai;85;68;153;15;14;29
96;08.12.2016;2016;12;13;Torstai;69;97;166;10;21;31
96;08.12.2016;2016;12;14;Torstai;81;116;197;19;25;44
96;08.12.2016;2016;12;15;Torstai;66;145;211;12;28;40
96;08.12.2016;2016;12;16;Torstai;83;112;195;14;28;42
96;08.12.2016;2016;12;17;Torstai;57;45;102;18;15;33
96;08.12.2016;2016;12;18;Torstai;45;44;89;18;13;31
96;08.12.2016;2016;12;19;Torstai;42;36;78;15;11;26
96;08.12.2016;2016;12;20;Torstai;32;30;62;16;13;29
96;08.12.2016;2016;12;21;Torstai;24;32;56;3;4;7
96;08.12.2016;2016;12;22;Torstai;3;8;11;4;1;5
96;08.12.2016;2016;12;23;Torstai;6;2;8;0;0;0
96;09.12.2016;2016;12;00;Perjantai;2;2;4;2;0;2
96;09.12.2016;2016;12;01;Perjantai;1;1;2;0;0;0
96;09.12.2016;2016;12;02;Perjantai;1;0;1;0;0;0
96;09.12.2016;2016;12;03;Perjantai;2;1;3;0;0;0
96;09.12.2016;2016;12;04;Perjantai;4;5;9;1;0;1
96;09.12.2016;2016;12;05;Perjantai;3;7;10;2;2;4
96;09.12.2016;2016;12;06;Perjantai;43;20;63;11;7;18
96;09.12.2016;2016;12;07;Perjantai;118;67;185;27;14;41
96;09.12.2016;2016;12;08;Perjantai;80;61;141;22;10;32
96;09.12.2016;2016;12;09;Perjantai;63;61;124;17;11;28
96;09.12.2016;2016;12;10;Perjantai;39;46;85;5;15;20
96;09.12.2016;2016;12;11;Perjantai;76;62;138;14;13;27
96;09.12.2016;2016;12;12;Perjantai;48;55;103;14;20;34
96;09.12.2016;2016;12;13;Perjantai;54;84;138;21;25;46
96;09.12.2016;2016;12;14;Perjantai;66;114;180;8;46;54
96;09.12.2016;2016;12;15;Perjantai;59;118;177;4;33;37
96;09.12.2016;2016;12;16;Perjantai;62;52;114;14;19;33
96;09.12.2016;2016;12;17;Perjantai;41;31;72;11;20;31
96;09.12.2016;2016;12;18;Perjantai;41;32;73;12;9;21
96;09.12.2016;2016;12;19;Perjantai;22;12;34;11;7;18
96;09.12.2016;2016;12;20;Perjantai;28;20;48;9;8;17
96;09.12.2016;2016;12;21;Perjantai;17;17;34;6;6;12
96;09.12.2016;2016;12;22;Perjantai;16;7;23;1;1;2
96;09.12.2016;2016;12;23;Perjantai;3;2;5;3;1;4
96;10.12.2016;2016;12;00;Lauantai;5;4;9;2;0;2
96;10.12.2016;2016;12;01;Lauantai;4;1;5;1;1;2
96;10.12.2016;2016;12;02;Lauantai;1;1;2;1;1;2
96;10.12.2016;2016;12;03;Lauantai;7;0;7;1;0;1
96;10.12.2016;2016;12;04;Lauantai;5;1;6;2;1;3
96;10.12.2016;2016;12;05;Lauantai;1;2;3;3;1;4
96;10.12.2016;2016;12;06;Lauantai;14;3;17;5;0;5
96;10.12.2016;2016;12;07;Lauantai;7;18;25;4;2;6
96;10.12.2016;2016;12;08;Lauantai;7;9;16;5;5;10
96;10.12.2016;2016;12;09;Lauantai;4;13;17;6;5;11
96;10.12.2016;2016;12;10;Lauantai;14;14;28;6;15;21
96;10.12.2016;2016;12;11;Lauantai;18;20;38;8;8;16
96;10.12.2016;2016;12;12;Lauantai;21;28;49;11;13;24
96;10.12.2016;2016;12;13;Lauantai;22;25;47;14;17;31
96;10.12.2016;2016;12;14;Lauantai;26;36;62;15;16;31
96;10.12.2016;2016;12;15;Lauantai;25;18;43;10;12;22
96;10.12.2016;2016;12;16;Lauantai;26;18;44;6;14;20
96;10.12.2016;2016;12;17;Lauantai;15;11;26;8;10;18
96;10.12.2016;2016;12;18;Lauantai;20;8;28;10;8;18
96;10.12.2016;2016;12;19;Lauantai;24;11;35;9;5;14
96;10.12.2016;2016;12;20;Lauantai;17;11;28;3;9;12
96;10.12.2016;2016;12;21;Lauantai;7;14;21;1;9;10
96;10.12.2016;2016;12;22;Lauantai;4;4;8;4;3;7
96;10.12.2016;2016;12;23;Lauantai;7;11;18;2;2;4
96;11.12.2016;2016;12;00;Sunnuntai;15;5;20;1;0;1
96;11.12.2016;2016;12;01;Sunnuntai;6;1;7;2;0;2
96;11.12.2016;2016;12;02;Sunnuntai;2;2;4;2;0;2
96;11.12.2016;2016;12;03;Sunnuntai;4;0;4;0;0;0
96;11.12.2016;2016;12;04;Sunnuntai;6;0;6;3;1;4
96;11.12.2016;2016;12;05;Sunnuntai;3;1;4;2;0;2
96;11.12.2016;2016;12;06;Sunnuntai;10;2;12;5;0;5
96;11.12.2016;2016;12;07;Sunnuntai;1;9;10;1;2;3
96;11.12.2016;2016;12;08;Sunnuntai;2;4;6;1;4;5
96;11.12.2016;2016;12;09;Sunnuntai;4;4;8;4;2;6
96;11.12.2016;2016;12;10;Sunnuntai;11;5;16;8;2;10
96;11.12.2016;2016;12;11;Sunnuntai;3;9;12;9;10;19
96;11.12.2016;2016;12;12;Sunnuntai;13;14;27;18;12;30
96;11.12.2016;2016;12;13;Sunnuntai;14;22;36;9;19;28
96;11.12.2016;2016;12;14;Sunnuntai;20;14;34;15;13;28
96;11.12.2016;2016;12;15;Sunnuntai;21;19;40;6;9;15
96;11.12.2016;2016;12;16;Sunnuntai;21;14;35;26;9;35
96;11.12.2016;2016;12;17;Sunnuntai;13;6;19;9;6;15
96;11.12.2016;2016;12;18;Sunnuntai;11;16;27;15;20;35
96;11.12.2016;2016;12;19;Sunnuntai;15;9;24;9;9;18
96;11.12.2016;2016;12;20;Sunnuntai;16;6;22;11;14;25
96;11.12.2016;2016;12;21;Sunnuntai;14;13;27;3;4;7
96;11.12.2016;2016;12;22;Sunnuntai;7;7;14;1;1;2
96;11.12.2016;2016;12;23;Sunnuntai;3;2;5;0;0;0
96;12.12.2016;2016;12;00;Maanantai;3;2;5;2;0;2
96;12.12.2016;2016;12;01;Maanantai;0;0;0;0;1;1
96;12.12.2016;2016;12;02;Maanantai;0;0;0;0;0;0
96;12.12.2016;2016;12;03;Maanantai;2;0;2;0;0;0
96;12.12.2016;2016;12;04;Maanantai;2;0;2;0;0;0
96;12.12.2016;2016;12;05;Maanantai;1;7;8;2;0;2
96;12.12.2016;2016;12;06;Maanantai;31;22;53;14;6;20
96;12.12.2016;2016;12;07;Maanantai;105;65;170;40;7;47
96;12.12.2016;2016;12;08;Maanantai;83;50;133;22;12;34
96;12.12.2016;2016;12;09;Maanantai;56;43;99;22;22;44
96;12.12.2016;2016;12;10;Maanantai;30;30;60;10;7;17
96;12.12.2016;2016;12;11;Maanantai;51;55;106;14;14;28
96;12.12.2016;2016;12;12;Maanantai;52;47;99;16;26;42
96;12.12.2016;2016;12;13;Maanantai;53;49;102;22;24;46
96;12.12.2016;2016;12;14;Maanantai;51;99;150;11;27;38
96;12.12.2016;2016;12;15;Maanantai;54;153;207;6;41;47
96;12.12.2016;2016;12;16;Maanantai;66;69;135;13;38;51
96;12.12.2016;2016;12;17;Maanantai;38;45;83;8;12;20
96;12.12.2016;2016;12;18;Maanantai;30;31;61;10;8;18
96;12.12.2016;2016;12;19;Maanantai;25;19;44;12;8;20
96;12.12.2016;2016;12;20;Maanantai;32;19;51;9;6;15
96;12.12.2016;2016;12;21;Maanantai;22;18;40;1;10;11
96;12.12.2016;2016;12;22;Maanantai;7;3;10;3;2;5
96;12.12.2016;2016;12;23;Maanantai;2;0;2;0;0;0
96;13.12.2016;2016;12;00;Tiistai;1;1;2;0;0;0
96;13.12.2016;2016;12;01;Tiistai;1;1;2;1;1;2
96;13.12.2016;2016;12;02;Tiistai;0;0;0;0;0;0
96;13.12.2016;2016;12;03;Tiistai;2;0;2;2;0;2
96;13.12.2016;2016;12;04;Tiistai;1;0;1;0;1;1
96;13.12.2016;2016;12;05;Tiistai;0;6;6;2;0;2
96;13.12.2016;2016;12;06;Tiistai;33;17;50;15;8;23
96;13.12.2016;2016;12;07;Tiistai;100;87;187;31;10;41
96;13.12.2016;2016;12;08;Tiistai;71;44;115;11;17;28
96;13.12.2016;2016;12;09;Tiistai;85;49;134;20;9;29
96;13.12.2016;2016;12;10;Tiistai;44;28;72;13;15;28
96;13.12.2016;2016;12;11;Tiistai;54;49;103;19;9;28
96;13.12.2016;2016;12;12;Tiistai;62;44;106;18;19;37
96;13.12.2016;2016;12;13;Tiistai;51;51;102;11;13;24
96;13.12.2016;2016;12;14;Tiistai;61;108;169;13;33;46
96;13.12.2016;2016;12;15;Tiistai;66;167;233;10;50;60
96;13.12.2016;2016;12;16;Tiistai;79;109;188;12;31;43
96;13.12.2016;2016;12;17;Tiistai;54;38;92;25;14;39
96;13.12.2016;2016;12;18;Tiistai;46;29;75;12;28;40
96;13.12.2016;2016;12;19;Tiistai;40;13;53;18;9;27
96;13.12.2016;2016;12;20;Tiistai;38;27;65;9;13;22
96;13.12.2016;2016;12;21;Tiistai;20;22;42;1;10;11
96;13.12.2016;2016;12;22;Tiistai;6;7;13;2;1;3
96;13.12.2016;2016;12;23;Tiistai;1;0;1;0;2;2
96;14.12.2016;2016;12;00;Keskiviikko;0;0;0;0;0;0
96;14.12.2016;2016;12;01;Keskiviikko;1;1;2;0;0;0
96;14.12.2016;2016;12;02;Keskiviikko;0;0;0;0;0;0
96;14.12.2016;2016;12;03;Keskiviikko;1;0;1;0;0;0
96;14.12.2016;2016;12;04;Keskiviikko;2;0;2;0;0;0
96;14.12.2016;2016;12;05;Keskiviikko;3;9;12;1;1;2
96;14.12.2016;2016;12;06;Keskiviikko;42;21;63;15;3;18
96;14.12.2016;2016;12;07;Keskiviikko;120;76;196;30;12;42
96;14.12.2016;2016;12;08;Keskiviikko;92;52;144;18;15;33
96;14.12.2016;2016;12;09;Keskiviikko;86;54;140;16;7;23
96;14.12.2016;2016;12;10;Keskiviikko;27;47;74;8;8;16
96;14.12.2016;2016;12;11;Keskiviikko;57;50;107;14;11;25
96;14.12.2016;2016;12;12;Keskiviikko;57;52;109;11;17;28
96;14.12.2016;2016;12;13;Keskiviikko;48;73;121;7;21;28
96;14.12.2016;2016;12;14;Keskiviikko;51;100;151;9;24;33
96;14.12.2016;2016;12;15;Keskiviikko;68;150;218;4;45;49
96;14.12.2016;2016;12;16;Keskiviikko;73;106;179;11;19;30
96;14.12.2016;2016;12;17;Keskiviikko;47;49;96;11;14;25
96;14.12.2016;2016;12;18;Keskiviikko;52;29;81;12;15;27
96;14.12.2016;2016;12;19;Keskiviikko;32;20;52;10;12;22
96;14.12.2016;2016;12;20;Keskiviikko;32;23;55;11;9;20
96;14.12.2016;2016;12;21;Keskiviikko;20;18;38;2;6;8
96;14.12.2016;2016;12;22;Keskiviikko;4;4;8;3;2;5
96;14.12.2016;2016;12;23;Keskiviikko;9;1;10;1;0;1
96;15.12.2016;2016;12;00;Torstai;2;0;2;0;0;0
96;15.12.2016;2016;12;01;Torstai;2;0;2;0;0;0
96;15.12.2016;2016;12;02;Torstai;4;1;5;1;0;1
96;15.12.2016;2016;12;03;Torstai;2;0;2;0;0;0
96;15.12.2016;2016;12;04;Torstai;1;0;1;1;0;1
96;15.12.2016;2016;12;05;Torstai;4;4;8;2;2;4
96;15.12.2016;2016;12;06;Torstai;47;20;67;10;3;13
96;15.12.2016;2016;12;07;Torstai;96;73;169;21;12;33
96;15.12.2016;2016;12;08;Torstai;83;60;143;15;15;30
96;15.12.2016;2016;12;09;Torstai;78;36;114;15;7;22
96;15.12.2016;2016;12;10;Torstai;35;41;76;6;15;21
96;15.12.2016;2016;12;11;Torstai;55;55;110;8;14;22
96;15.12.2016;2016;12;12;Torstai;53;63;116;12;9;21
96;15.12.2016;2016;12;13;Torstai;63;52;115;20;14;34
96;15.12.2016;2016;12;14;Torstai;67;102;169;9;30;39
96;15.12.2016;2016;12;15;Torstai;63;136;199;6;35;41
96;15.12.2016;2016;12;16;Torstai;71;119;190;10;25;35
96;15.12.2016;2016;12;17;Torstai;59;53;112;8;8;16
96;15.12.2016;2016;12;18;Torstai;40;35;75;3;13;16
96;15.12.2016;2016;12;19;Torstai;36;33;69;5;6;11
96;15.12.2016;2016;12;20;Torstai;38;23;61;14;10;24
96;15.12.2016;2016;12;21;Torstai;22;21;43;4;3;7
96;15.12.2016;2016;12;22;Torstai;13;8;21;2;2;4
96;15.12.2016;2016;12;23;Torstai;4;0;4;1;1;2
96;16.12.2016;2016;12;00;Perjantai;0;0;0;0;0;0
96;16.12.2016;2016;12;01;Perjantai;3;1;4;0;0;0
96;16.12.2016;2016;12;02;Perjantai;6;0;6;1;0;1
96;16.12.2016;2016;12;03;Perjantai;6;3;9;0;0;0
96;16.12.2016;2016;12;04;Perjantai;4;1;5;1;2;3
96;16.12.2016;2016;12;05;Perjantai;6;7;13;0;0;0
96;16.12.2016;2016;12;06;Perjantai;46;16;62;10;6;16
96;16.12.2016;2016;12;07;Perjantai;86;59;145;19;11;30
96;16.12.2016;2016;12;08;Perjantai;61;52;113;15;7;22
96;16.12.2016;2016;12;09;Perjantai;53;56;109;9;7;16
96;16.12.2016;2016;12;10;Perjantai;35;34;69;4;10;14
96;16.12.2016;2016;12;11;Perjantai;47;62;109;13;15;28
96;16.12.2016;2016;12;12;Perjantai;49;61;110;7;15;22
96;16.12.2016;2016;12;13;Perjantai;46;70;116;8;17;25
96;16.12.2016;2016;12;14;Perjantai;66;129;195;8;32;40
96;16.12.2016;2016;12;15;Perjantai;68;92;160;9;28;37
96;16.12.2016;2016;12;16;Perjantai;56;50;106;9;26;35
96;16.12.2016;2016;12;17;Perjantai;30;41;71;5;9;14
96;16.12.2016;2016;12;18;Perjantai;33;27;60;4;12;16
96;16.12.2016;2016;12;19;Perjantai;26;16;42;9;7;16
96;16.12.2016;2016;12;20;Perjantai;13;13;26;8;7;15
96;16.12.2016;2016;12;21;Perjantai;17;14;31;4;4;8
96;16.12.2016;2016;12;22;Perjantai;10;3;13;0;2;2
96;16.12.2016;2016;12;23;Perjantai;12;5;17;0;2;2
96;17.12.2016;2016;12;00;Lauantai;11;2;13;1;0;1
96;17.12.2016;2016;12;01;Lauantai;10;1;11;0;1;1
96;17.12.2016;2016;12;02;Lauantai;10;3;13;1;0;1
96;17.12.2016;2016;12;03;Lauantai;6;2;8;0;1;1
96;17.12.2016;2016;12;04;Lauantai;2;1;3;0;3;3
96;17.12.2016;2016;12;05;Lauantai;9;5;14;1;0;1
96;17.12.2016;2016;12;06;Lauantai;18;5;23;3;0;3
96;17.12.2016;2016;12;07;Lauantai;7;8;15;5;4;9
96;17.12.2016;2016;12;08;Lauantai;8;5;13;3;7;10
96;17.12.2016;2016;12;09;Lauantai;9;14;23;6;3;9
96;17.12.2016;2016;12;10;Lauantai;18;14;32;13;8;21
96;17.12.2016;2016;12;11;Lauantai;22;20;42;11;6;17
96;17.12.2016;2016;12;12;Lauantai;17;19;36;9;11;20
96;17.12.2016;2016;12;13;Lauantai;32;36;68;7;9;16
96;17.12.2016;2016;12;14;Lauantai;27;25;52;1;5;6
96;17.12.2016;2016;12;15;Lauantai;23;22;45;7;7;14
96;17.12.2016;2016;12;16;Lauantai;26;16;42;7;7;14
96;17.12.2016;2016;12;17;Lauantai;26;16;42;1;6;7
96;17.12.2016;2016;12;18;Lauantai;20;14;34;7;5;12
96;17.12.2016;2016;12;19;Lauantai;16;8;24;2;4;6
96;17.12.2016;2016;12;20;Lauantai;11;14;25;6;7;13
96;17.12.2016;2016;12;21;Lauantai;16;15;31;2;3;5
96;17.12.2016;2016;12;22;Lauantai;8;4;12;1;2;3
96;17.12.2016;2016;12;23;Lauantai;11;4;15;0;0;0
96;18.12.2016;2016;12;00;Sunnuntai;7;3;10;0;0;0
96;18.12.2016;2016;12;01;Sunnuntai;2;2;4;0;0;0
96;18.12.2016;2016;12;02;Sunnuntai;9;2;11;0;0;0
96;18.12.2016;2016;12;03;Sunnuntai;6;3;9;1;0;1
96;18.12.2016;2016;12;04;Sunnuntai;8;2;10;1;2;3
96;18.12.2016;2016;12;05;Sunnuntai;3;2;5;1;0;1
96;18.12.2016;2016;12;06;Sunnuntai;11;2;13;4;0;4
96;18.12.2016;2016;12;07;Sunnuntai;2;5;7;0;3;3
96;18.12.2016;2016;12;08;Sunnuntai;4;3;7;3;3;6
96;18.12.2016;2016;12;09;Sunnuntai;6;6;12;8;2;10
96;18.12.2016;2016;12;10;Sunnuntai;8;14;22;4;6;10
96;18.12.2016;2016;12;11;Sunnuntai;17;14;31;7;6;13
96;18.12.2016;2016;12;12;Sunnuntai;19;14;33;6;7;13
96;18.12.2016;2016;12;13;Sunnuntai;34;20;54;7;16;23
96;18.12.2016;2016;12;14;Sunnuntai;23;19;42;7;8;15
96;18.12.2016;2016;12;15;Sunnuntai;22;19;41;0;6;6
96;18.12.2016;2016;12;16;Sunnuntai;39;11;50;12;2;14
96;18.12.2016;2016;12;17;Sunnuntai;23;13;36;4;10;14
96;18.12.2016;2016;12;18;Sunnuntai;18;21;39;5;14;19
96;18.12.2016;2016;12;19;Sunnuntai;13;11;24;4;8;12
96;18.12.2016;2016;12;20;Sunnuntai;15;10;25;4;0;4
96;18.12.2016;2016;12;21;Sunnuntai;10;12;22;4;4;8
96;18.12.2016;2016;12;22;Sunnuntai;6;4;10;0;0;0
96;18.12.2016;2016;12;23;Sunnuntai;3;2;5;0;0;0
96;19.12.2016;2016;12;00;Maanantai;1;0;1;0;0;0
96;19.12.2016;2016;12;01;Maanantai;2;0;2;0;0;0
96;19.12.2016;2016;12;02;Maanantai;1;0;1;0;0;0
96;19.12.2016;2016;12;03;Maanantai;1;0;1;0;1;1
96;19.12.2016;2016;12;04;Maanantai;2;0;2;0;0;0
96;19.12.2016;2016;12;05;Maanantai;6;9;15;0;0;0
96;19.12.2016;2016;12;06;Maanantai;21;20;41;0;3;3
96;19.12.2016;2016;12;07;Maanantai;76;82;158;5;6;11
96;19.12.2016;2016;12;08;Maanantai;61;62;123;4;9;13
96;19.12.2016;2016;12;09;Maanantai;44;46;90;3;3;6
96;19.12.2016;2016;12;10;Maanantai;40;34;74;2;1;3
96;19.12.2016;2016;12;11;Maanantai;47;41;88;4;5;9
96;19.12.2016;2016;12;12;Maanantai;52;58;110;7;11;18
96;19.12.2016;2016;12;13;Maanantai;67;54;121;8;6;14
96;19.12.2016;2016;12;14;Maanantai;53;74;127;2;18;20
96;19.12.2016;2016;12;15;Maanantai;68;109;177;3;17;20
96;19.12.2016;2016;12;16;Maanantai;68;94;162;4;19;23
96;19.12.2016;2016;12;17;Maanantai;41;59;100;3;6;9
96;19.12.2016;2016;12;18;Maanantai;37;29;66;2;5;7
96;19.12.2016;2016;12;19;Maanantai;34;19;53;6;5;11
96;19.12.2016;2016;12;20;Maanantai;26;19;45;2;5;7
96;19.12.2016;2016;12;21;Maanantai;10;18;28;1;3;4
96;19.12.2016;2016;12;22;Maanantai;7;7;14;0;1;1
96;19.12.2016;2016;12;23;Maanantai;4;4;8;0;2;2
96;20.12.2016;2016;12;00;Tiistai;4;1;5;0;0;0
96;20.12.2016;2016;12;01;Tiistai;0;0;0;0;0;0
96;20.12.2016;2016;12;02;Tiistai;1;0;1;0;1;1
96;20.12.2016;2016;12;03;Tiistai;1;0;1;0;0;0
96;20.12.2016;2016;12;04;Tiistai;2;1;3;1;1;2
96;20.12.2016;2016;12;05;Tiistai;6;11;17;2;1;3
96;20.12.2016;2016;12;06;Tiistai;23;22;45;7;2;9
96;20.12.2016;2016;12;07;Tiistai;76;71;147;24;9;33
96;20.12.2016;2016;12;08;Tiistai;41;57;98;7;4;11
96;20.12.2016;2016;12;09;Tiistai;61;31;92;17;9;26
96;20.12.2016;2016;12;10;Tiistai;18;16;34;5;7;12
96;20.12.2016;2016;12;11;Tiistai;27;47;74;13;10;23
96;20.12.2016;2016;12;12;Tiistai;50;35;85;11;13;24
96;20.12.2016;2016;12;13;Tiistai;35;33;68;12;10;22
96;20.12.2016;2016;12;14;Tiistai;37;69;106;10;26;36
96;20.12.2016;2016;12;15;Tiistai;47;88;135;11;31;42
96;20.12.2016;2016;12;16;Tiistai;53;58;111;15;19;34
96;20.12.2016;2016;12;17;Tiistai;37;31;68;9;16;25
96;20.12.2016;2016;12;18;Tiistai;22;21;43;5;23;28
96;20.12.2016;2016;12;19;Tiistai;22;18;40;13;2;15
96;20.12.2016;2016;12;20;Tiistai;29;15;44;8;6;14
96;20.12.2016;2016;12;21;Tiistai;19;13;32;5;6;11
96;20.12.2016;2016;12;22;Tiistai;6;8;14;0;1;1
96;20.12.2016;2016;12;23;Tiistai;5;0;5;1;0;1
96;21.12.2016;2016;12;00;Keskiviikko;0;1;1;0;0;0
96;21.12.2016;2016;12;01;Keskiviikko;9;0;9;0;0;0
96;21.12.2016;2016;12;02;Keskiviikko;2;0;2;0;0;0
96;21.12.2016;2016;12;03;Keskiviikko;2;0;2;0;0;0
96;21.12.2016;2016;12;04;Keskiviikko;2;0;2;0;2;2
96;21.12.2016;2016;12;05;Keskiviikko;3;6;9;3;1;4
96;21.12.2016;2016;12;06;Keskiviikko;37;21;58;12;5;17
96;21.12.2016;2016;12;07;Keskiviikko;63;47;110;23;10;33
96;21.12.2016;2016;12;08;Keskiviikko;40;51;91;6;4;10
96;21.12.2016;2016;12;09;Keskiviikko;47;29;76;13;3;16
96;21.12.2016;2016;12;10;Keskiviikko;19;38;57;5;7;12
96;21.12.2016;2016;12;11;Keskiviikko;38;122;160;11;22;33
96;21.12.2016;2016;12;12;Keskiviikko;37;62;99;6;15;21
96;21.12.2016;2016;12;13;Keskiviikko;43;32;75;6;11;17
96;21.12.2016;2016;12;14;Keskiviikko;73;55;128;8;13;21
96;21.12.2016;2016;12;15;Keskiviikko;47;95;142;8;27;35
96;21.12.2016;2016;12;16;Keskiviikko;58;57;115;8;17;25
96;21.12.2016;2016;12;17;Keskiviikko;30;23;53;7;5;12
96;21.12.2016;2016;12;18;Keskiviikko;43;29;72;14;5;19
96;21.12.2016;2016;12;19;Keskiviikko;20;20;40;4;4;8
96;21.12.2016;2016;12;20;Keskiviikko;17;12;29;4;14;18
96;21.12.2016;2016;12;21;Keskiviikko;11;16;27;3;5;8
96;21.12.2016;2016;12;22;Keskiviikko;9;4;13;1;0;1
96;21.12.2016;2016;12;23;Keskiviikko;2;3;5;1;3;4
96;22.12.2016;2016;12;00;Torstai;5;1;6;0;0;0
96;22.12.2016;2016;12;01;Torstai;1;0;1;0;0;0
96;22.12.2016;2016;12;02;Torstai;2;0;2;0;0;0
96;22.12.2016;2016;12;03;Torstai;1;0;1;0;0;0
96;22.12.2016;2016;12;04;Torstai;3;2;5;0;1;1
96;22.12.2016;2016;12;05;Torstai;3;5;8;0;1;1
96;22.12.2016;2016;12;06;Torstai;36;14;50;16;3;19
96;22.12.2016;2016;12;07;Torstai;48;31;79;21;4;25
96;22.12.2016;2016;12;08;Torstai;26;38;64;5;9;14
96;22.12.2016;2016;12;09;Torstai;25;30;55;5;9;14
96;22.12.2016;2016;12;10;Torstai;14;26;40;4;10;14
96;22.12.2016;2016;12;11;Torstai;27;23;50;6;9;15
96;22.12.2016;2016;12;12;Torstai;40;32;72;10;8;18
96;22.12.2016;2016;12;13;Torstai;35;20;55;7;16;23
96;22.12.2016;2016;12;14;Torstai;28;44;72;8;20;28
96;22.12.2016;2016;12;15;Torstai;41;67;108;9;24;33
96;22.12.2016;2016;12;16;Torstai;52;35;87;7;16;23
96;22.12.2016;2016;12;17;Torstai;23;18;41;4;10;14
96;22.12.2016;2016;12;18;Torstai;21;23;44;8;12;20
96;22.12.2016;2016;12;19;Torstai;17;14;31;6;2;8
96;22.12.2016;2016;12;20;Torstai;14;3;17;2;7;9
96;22.12.2016;2016;12;21;Torstai;13;14;27;4;6;10
96;22.12.2016;2016;12;22;Torstai;3;3;6;1;1;2
96;22.12.2016;2016;12;23;Torstai;6;1;7;0;1;1
96;23.12.2016;2016;12;00;Perjantai;2;0;2;0;1;1
96;23.12.2016;2016;12;01;Perjantai;0;0;0;2;0;2
96;23.12.2016;2016;12;02;Perjantai;0;1;1;0;0;0
96;23.12.2016;2016;12;03;Perjantai;3;0;3;0;0;0
96;23.12.2016;2016;12;04;Perjantai;2;2;4;3;1;4
96;23.12.2016;2016;12;05;Perjantai;1;5;6;0;1;1
96;23.12.2016;2016;12;06;Perjantai;34;14;48;12;2;14
96;23.12.2016;2016;12;07;Perjantai;27;21;48;15;3;18
96;23.12.2016;2016;12;08;Perjantai;17;25;42;5;6;11
96;23.12.2016;2016;12;09;Perjantai;12;16;28;6;6;12
96;23.12.2016;2016;12;10;Perjantai;11;14;25;3;4;7
96;23.12.2016;2016;12;11;Perjantai;12;25;37;13;15;28
96;23.12.2016;2016;12;12;Perjantai;31;26;57;10;18;28
96;23.12.2016;2016;12;13;Perjantai;46;28;74;12;21;33
96;23.12.2016;2016;12;14;Perjantai;35;46;81;3;16;19
96;23.12.2016;2016;12;15;Perjantai;34;37;71;4;15;19
96;23.12.2016;2016;12;16;Perjantai;21;13;34;8;4;12
96;23.12.2016;2016;12;17;Perjantai;26;9;35;4;6;10
96;23.12.2016;2016;12;18;Perjantai;9;4;13;4;4;8
96;23.12.2016;2016;12;19;Perjantai;9;7;16;2;1;3
96;23.12.2016;2016;12;20;Perjantai;8;8;16;2;1;3
96;23.12.2016;2016;12;21;Perjantai;4;17;21;0;8;8
96;23.12.2016;2016;12;22;Perjantai;4;1;5;0;0;0
96;23.12.2016;2016;12;23;Perjantai;5;1;6;0;1;1
96;24.12.2016;2016;12;00;Lauantai;0;0;0;2;0;2
96;24.12.2016;2016;12;01;Lauantai;1;0;1;0;0;0
96;24.12.2016;2016;12;02;Lauantai;2;1;3;0;0;0
96;24.12.2016;2016;12;03;Lauantai;3;0;3;1;0;1
96;24.12.2016;2016;12;04;Lauantai;0;1;1;0;0;0
96;24.12.2016;2016;12;05;Lauantai;1;0;1;1;0;1
96;24.12.2016;2016;12;06;Lauantai;12;3;15;5;0;5
96;24.12.2016;2016;12;07;Lauantai;1;4;5;1;3;4
96;24.12.2016;2016;12;08;Lauantai;5;3;8;0;9;9
96;24.12.2016;2016;12;09;Lauantai;2;4;6;3;4;7
96;24.12.2016;2016;12;10;Lauantai;7;7;14;5;7;12
96;24.12.2016;2016;12;11;Lauantai;10;8;18;2;2;4
96;24.12.2016;2016;12;12;Lauantai;19;6;25;2;1;3
96;24.12.2016;2016;12;13;Lauantai;18;10;28;3;2;5
96;24.12.2016;2016;12;14;Lauantai;3;9;12;1;4;5
96;24.12.2016;2016;12;15;Lauantai;2;4;6;0;1;1
96;24.12.2016;2016;12;16;Lauantai;5;1;6;0;0;0
96;24.12.2016;2016;12;17;Lauantai;4;0;4;1;0;1
96;24.12.2016;2016;12;18;Lauantai;9;0;9;0;0;0
96;24.12.2016;2016;12;19;Lauantai;5;0;5;3;0;3
96;24.12.2016;2016;12;20;Lauantai;8;0;8;2;0;2
96;24.12.2016;2016;12;21;Lauantai;8;1;9;4;1;5
96;24.12.2016;2016;12;22;Lauantai;2;1;3;2;1;3
96;24.12.2016;2016;12;23;Lauantai;1;0;1;2;0;2
96;25.12.2016;2016;12;00;Sunnuntai;0;0;0;1;0;1
96;25.12.2016;2016;12;01;Sunnuntai;0;0;0;1;0;1
96;25.12.2016;2016;12;02;Sunnuntai;1;0;1;0;0;0
96;25.12.2016;2016;12;03;Sunnuntai;1;0;1;0;0;0
96;25.12.2016;2016;12;04;Sunnuntai;1;0;1;1;0;1
96;25.12.2016;2016;12;05;Sunnuntai;2;0;2;4;2;6
96;25.12.2016;2016;12;06;Sunnuntai;8;0;8;7;0;7
96;25.12.2016;2016;12;07;Sunnuntai;7;1;8;1;1;2
96;25.12.2016;2016;12;08;Sunnuntai;4;0;4;0;0;0
96;25.12.2016;2016;12;09;Sunnuntai;3;0;3;5;2;7
96;25.12.2016;2016;12;10;Sunnuntai;7;0;7;5;5;10
96;25.12.2016;2016;12;11;Sunnuntai;3;2;5;14;3;17
96;25.12.2016;2016;12;12;Sunnuntai;16;4;20;11;0;11
96;25.12.2016;2016;12;13;Sunnuntai;12;5;17;14;4;18
96;25.12.2016;2016;12;14;Sunnuntai;12;11;23;12;8;20
96;25.12.2016;2016;12;15;Sunnuntai;12;5;17;12;0;12
96;25.12.2016;2016;12;16;Sunnuntai;3;4;7;5;1;6
96;25.12.2016;2016;12;17;Sunnuntai;2;6;8;10;2;12
96;25.12.2016;2016;12;18;Sunnuntai;7;5;12;7;3;10
96;25.12.2016;2016;12;19;Sunnuntai;10;3;13;5;0;5
96;25.12.2016;2016;12;20;Sunnuntai;4;3;7;9;0;9
96;25.12.2016;2016;12;21;Sunnuntai;8;8;16;3;1;4
96;25.12.2016;2016;12;22;Sunnuntai;0;4;4;1;0;1
96;25.12.2016;2016;12;23;Sunnuntai;1;4;5;1;1;2
96;26.12.2016;2016;12;00;Maanantai;3;3;6;3;1;4
96;26.12.2016;2016;12;01;Maanantai;0;2;2;2;0;2
96;26.12.2016;2016;12;02;Maanantai;2;0;2;0;0;0
96;26.12.2016;2016;12;03;Maanantai;6;0;6;0;0;0
96;26.12.2016;2016;12;04;Maanantai;1;0;1;1;0;1
96;26.12.2016;2016;12;05;Maanantai;3;0;3;3;0;3
96;26.12.2016;2016;12;06;Maanantai;14;2;16;5;0;5
96;26.12.2016;2016;12;07;Maanantai;0;9;9;2;1;3
96;26.12.2016;2016;12;08;Maanantai;3;5;8;3;2;5
96;26.12.2016;2016;12;09;Maanantai;5;5;10;7;1;8
96;26.12.2016;2016;12;10;Maanantai;5;4;9;10;4;14
96;26.12.2016;2016;12;11;Maanantai;5;5;10;12;1;13
96;26.12.2016;2016;12;12;Maanantai;13;6;19;12;4;16
96;26.12.2016;2016;12;13;Maanantai;20;11;31;7;4;11
96;26.12.2016;2016;12;14;Maanantai;12;16;28;10;7;17
96;26.12.2016;2016;12;15;Maanantai;6;6;12;11;8;19
96;26.12.2016;2016;12;16;Maanantai;5;10;15;11;4;15
96;26.12.2016;2016;12;17;Maanantai;14;3;17;4;1;5
96;26.12.2016;2016;12;18;Maanantai;9;3;12;7;0;7
96;26.12.2016;2016;12;19;Maanantai;10;9;19;17;2;19
96;26.12.2016;2016;12;20;Maanantai;5;3;8;15;0;15
96;26.12.2016;2016;12;21;Maanantai;6;2;8;10;1;11
96;26.12.2016;2016;12;22;Maanantai;2;2;4;2;0;2
96;26.12.2016;2016;12;23;Maanantai;1;1;2;1;0;1
96;27.12.2016;2016;12;00;Tiistai;2;0;2;1;0;1
96;27.12.2016;2016;12;01;Tiistai;2;1;3;0;0;0
96;27.12.2016;2016;12;02;Tiistai;1;0;1;2;0;2
96;27.12.2016;2016;12;03;Tiistai;1;0;1;0;0;0
96;27.12.2016;2016;12;04;Tiistai;3;0;3;0;0;0
96;27.12.2016;2016;12;05;Tiistai;4;4;8;4;3;7
96;27.12.2016;2016;12;06;Tiistai;27;3;30;10;1;11
96;27.12.2016;2016;12;07;Tiistai;41;16;57;18;2;20
96;27.12.2016;2016;12;08;Tiistai;24;7;31;10;5;15
96;27.12.2016;2016;12;09;Tiistai;21;3;24;15;13;28
96;27.12.2016;2016;12;10;Tiistai;26;6;32;15;5;20
96;27.12.2016;2016;12;11;Tiistai;17;8;25;7;1;8
96;27.12.2016;2016;12;12;Tiistai;26;14;40;24;6;30
96;27.12.2016;2016;12;13;Tiistai;27;25;52;14;3;17
96;27.12.2016;2016;12;14;Tiistai;29;36;65;11;6;17
96;27.12.2016;2016;12;15;Tiistai;50;23;73;23;10;33
96;27.12.2016;2016;12;16;Tiistai;41;16;57;17;7;24
96;27.12.2016;2016;12;17;Tiistai;21;11;32;9;3;12
96;27.12.2016;2016;12;18;Tiistai;17;6;23;11;4;15
96;27.12.2016;2016;12;19;Tiistai;17;7;24;12;2;14
96;27.12.2016;2016;12;20;Tiistai;12;3;15;15;2;17
96;27.12.2016;2016;12;21;Tiistai;18;11;29;7;4;11
96;27.12.2016;2016;12;22;Tiistai;5;0;5;0;1;1
96;27.12.2016;2016;12;23;Tiistai;2;1;3;1;0;1
96;28.12.2016;2016;12;00;Keskiviikko;2;0;2;0;1;1
96;28.12.2016;2016;12;01;Keskiviikko;2;0;2;1;1;2
96;28.12.2016;2016;12;02;Keskiviikko;0;0;0;0;0;0
96;28.12.2016;2016;12;03;Keskiviikko;2;1;3;0;0;0
96;28.12.2016;2016;12;04;Keskiviikko;2;0;2;2;0;2
96;28.12.2016;2016;12;05;Keskiviikko;5;2;7;2;0;2
96;28.12.2016;2016;12;06;Keskiviikko;32;5;37;11;0;11
96;28.12.2016;2016;12;07;Keskiviikko;52;19;71;24;0;24
96;28.12.2016;2016;12;08;Keskiviikko;25;11;36;2;1;3
96;28.12.2016;2016;12;09;Keskiviikko;18;6;24;17;6;23
96;28.12.2016;2016;12;10;Keskiviikko;22;10;32;19;0;19
96;28.12.2016;2016;12;11;Keskiviikko;14;5;19;14;0;14
96;28.12.2016;2016;12;12;Keskiviikko;32;10;42;20;5;25
96;28.12.2016;2016;12;13;Keskiviikko;33;6;39;13;1;14
96;28.12.2016;2016;12;14;Keskiviikko;27;27;54;19;7;26
96;28.12.2016;2016;12;15;Keskiviikko;59;37;96;13;12;25
96;28.12.2016;2016;12;16;Keskiviikko;29;25;54;17;7;24
96;28.12.2016;2016;12;17;Keskiviikko;30;12;42;15;9;24
96;28.12.2016;2016;12;18;Keskiviikko;26;15;41;10;8;18
96;28.12.2016;2016;12;19;Keskiviikko;12;9;21;6;3;9
96;28.12.2016;2016;12;20;Keskiviikko;34;6;40;12;5;17
96;28.12.2016;2016;12;21;Keskiviikko;22;8;30;11;1;12
96;28.12.2016;2016;12;22;Keskiviikko;10;1;11;9;0;9
96;28.12.2016;2016;12;23;Keskiviikko;6;0;6;5;0;5
96;29.12.2016;2016;12;00;Torstai;4;0;4;0;0;0
96;29.12.2016;2016;12;01;Torstai;2;0;2;2;0;2
96;29.12.2016;2016;12;02;Torstai;3;0;3;1;0;1
96;29.12.2016;2016;12;03;Torstai;2;0;2;1;0;1
96;29.12.2016;2016;12;04;Torstai;4;0;4;0;0;0
96;29.12.2016;2016;12;05;Torstai;10;0;10;2;0;2
96;29.12.2016;2016;12;06;Torstai;38;2;40;8;0;8
96;29.12.2016;2016;12;07;Torstai;64;8;72;10;0;10
96;29.12.2016;2016;12;08;Torstai;31;2;33;12;0;12
96;29.12.2016;2016;12;09;Torstai;24;1;25;17;0;17
96;29.12.2016;2016;12;10;Torstai;29;1;30;13;3;16
96;29.12.2016;2016;12;11;Torstai;28;4;32;16;1;17
96;29.12.2016;2016;12;12;Torstai;36;4;40;9;1;10
96;29.12.2016;2016;12;13;Torstai;46;6;52;23;2;25
96;29.12.2016;2016;12;14;Torstai;47;15;62;18;8;26
96;29.12.2016;2016;12;15;Torstai;54;26;80;30;4;34
96;29.12.2016;2016;12;16;Torstai;49;19;68;11;3;14
96;29.12.2016;2016;12;17;Torstai;43;6;49;18;0;18
96;29.12.2016;2016;12;18;Torstai;32;12;44;13;4;17
96;29.12.2016;2016;12;19;Torstai;28;9;37;17;6;23
96;29.12.2016;2016;12;20;Torstai;29;2;31;13;1;14
96;29.12.2016;2016;12;21;Torstai;15;4;19;7;3;10
96;29.12.2016;2016;12;22;Torstai;10;1;11;3;0;3
96;29.12.2016;2016;12;23;Torstai;5;0;5;1;1;2
96;30.12.2016;2016;12;00;Perjantai;4;0;4;2;0;2
96;30.12.2016;2016;12;01;Perjantai;0;0;0;0;0;0
96;30.12.2016;2016;12;02;Perjantai;0;0;0;1;0;1
96;30.12.2016;2016;12;03;Perjantai;4;0;4;0;0;0
96;30.12.2016;2016;12;04;Perjantai;1;1;2;2;0;2
96;30.12.2016;2016;12;05;Perjantai;4;2;6;0;0;0
96;30.12.2016;2016;12;06;Perjantai;34;3;37;7;0;7
96;30.12.2016;2016;12;07;Perjantai;59;4;63;8;1;9
96;30.12.2016;2016;12;08;Perjantai;27;6;33;7;0;7
96;30.12.2016;2016;12;09;Perjantai;28;2;30;10;0;10
96;30.12.2016;2016;12;10;Perjantai;36;4;40;9;1;10
96;30.12.2016;2016;12;11;Perjantai;21;4;25;10;0;10
96;30.12.2016;2016;12;12;Perjantai;23;4;27;8;0;8
96;30.12.2016;2016;12;13;Perjantai;28;7;35;6;1;7
96;30.12.2016;2016;12;14;Perjantai;30;46;76;8;12;20
96;30.12.2016;2016;12;15;Perjantai;28;42;70;4;13;17
96;30.12.2016;2016;12;16;Perjantai;30;18;48;8;6;14
96;30.12.2016;2016;12;17;Perjantai;21;6;27;2;3;5
96;30.12.2016;2016;12;18;Perjantai;12;16;28;14;1;15
96;30.12.2016;2016;12;19;Perjantai;6;5;11;2;8;10
96;30.12.2016;2016;12;20;Perjantai;16;7;23;7;2;9
96;30.12.2016;2016;12;21;Perjantai;9;12;21;1;1;2
96;30.12.2016;2016;12;22;Perjantai;3;2;5;0;0;0
96;30.12.2016;2016;12;23;Perjantai;4;3;7;0;2;2
96;31.12.2016;2016;12;00;Lauantai;2;1;3;0;1;1
96;31.12.2016;2016;12;01;Lauantai;2;0;2;0;1;1
96;31.12.2016;2016;12;02;Lauantai;0;1;1;0;0;0
96;31.12.2016;2016;12;03;Lauantai;1;0;1;1;0;1
96;31.12.2016;2016;12;04;Lauantai;1;0;1;1;0;1
96;31.12.2016;2016;12;05;Lauantai;1;1;2;0;0;0
96;31.12.2016;2016;12;06;Lauantai;8;4;12;6;0;6
96;31.12.2016;2016;12;07;Lauantai;0;2;2;1;5;6
96;31.12.2016;2016;12;08;Lauantai;2;8;10;1;3;4
96;31.12.2016;2016;12;09;Lauantai;4;7;11;7;1;8
96;31.12.2016;2016;12;10;Lauantai;2;9;11;7;6;13
96;31.12.2016;2016;12;11;Lauantai;12;8;20;8;5;13
96;31.12.2016;2016;12;12;Lauantai;5;15;20;4;9;13
96;31.12.2016;2016;12;13;Lauantai;14;5;19;6;7;13
96;31.12.2016;2016;12;14;Lauantai;13;9;22;9;6;15
96;31.12.2016;2016;12;15;Lauantai;12;13;25;9;8;17
96;31.12.2016;2016;12;16;Lauantai;9;13;22;2;4;6
96;31.12.2016;2016;12;17;Lauantai;9;8;17;3;5;8
96;31.12.2016;2016;12;18;Lauantai;6;12;18;2;1;3
96;31.12.2016;2016;12;19;Lauantai;4;10;14;3;11;14
96;31.12.2016;2016;12;20;Lauantai;6;5;11;6;4;10
96;31.12.2016;2016;12;21;Lauantai;12;10;22;9;1;10
96;31.12.2016;2016;12;22;Lauantai;5;7;12;4;1;5
96;31.12.2016;2016;12;23;Lauantai;1;6;7;2;1;3
96;01.01.2017;2017;01;00;Sunnuntai;9;2;11;4;0;4
96;01.01.2017;2017;01;01;Sunnuntai;9;2;11;1;0;1
96;01.01.2017;2017;01;02;Sunnuntai;4;2;6;4;0;4
96;01.01.2017;2017;01;03;Sunnuntai;3;0;3;10;0;10
96;01.01.2017;2017;01;04;Sunnuntai;7;0;7;16;1;17
96;01.01.2017;2017;01;05;Sunnuntai;2;2;4;3;0;3
96;01.01.2017;2017;01;06;Sunnuntai;5;0;5;2;2;4
96;01.01.2017;2017;01;07;Sunnuntai;3;6;9;3;3;6
96;01.01.2017;2017;01;08;Sunnuntai;0;1;1;3;2;5
96;01.01.2017;2017;01;09;Sunnuntai;4;0;4;6;1;7
96;01.01.2017;2017;01;10;Sunnuntai;1;5;6;3;3;6
96;01.01.2017;2017;01;11;Sunnuntai;1;5;6;5;5;10
96;01.01.2017;2017;01;12;Sunnuntai;5;4;9;8;6;14
96;01.01.2017;2017;01;13;Sunnuntai;4;6;10;6;3;9
96;01.01.2017;2017;01;14;Sunnuntai;7;3;10;4;12;16
96;01.01.2017;2017;01;15;Sunnuntai;12;9;21;6;8;14
96;01.01.2017;2017;01;16;Sunnuntai;10;5;15;20;8;28
96;01.01.2017;2017;01;17;Sunnuntai;3;2;5;8;5;13
96;01.01.2017;2017;01;18;Sunnuntai;11;2;13;11;9;20
96;01.01.2017;2017;01;19;Sunnuntai;1;9;10;8;12;20
96;01.01.2017;2017;01;20;Sunnuntai;7;3;10;7;3;10
96;01.01.2017;2017;01;21;Sunnuntai;1;9;10;1;7;8
96;01.01.2017;2017;01;22;Sunnuntai;2;4;6;2;1;3
96;01.01.2017;2017;01;23;Sunnuntai;2;0;2;0;0;0
96;02.01.2017;2017;01;00;Maanantai;1;0;1;4;0;4
96;02.01.2017;2017;01;01;Maanantai;0;0;0;0;0;0
96;02.01.2017;2017;01;02;Maanantai;0;0;0;0;0;0
96;02.01.2017;2017;01;03;Maanantai;2;0;2;0;0;0
96;02.01.2017;2017;01;04;Maanantai;1;1;2;0;0;0
96;02.01.2017;2017;01;05;Maanantai;0;5;5;2;1;3
96;02.01.2017;2017;01;06;Maanantai;26;13;39;12;5;17
96;02.01.2017;2017;01;07;Maanantai;40;56;96;32;8;40
96;02.01.2017;2017;01;08;Maanantai;18;41;59;16;11;27
96;02.01.2017;2017;01;09;Maanantai;17;19;36;10;13;23
96;02.01.2017;2017;01;10;Maanantai;17;17;34;6;14;20
96;02.01.2017;2017;01;11;Maanantai;24;23;47;13;7;20
96;02.01.2017;2017;01;12;Maanantai;29;15;44;13;11;24
96;02.01.2017;2017;01;13;Maanantai;23;26;49;9;13;22
96;02.01.2017;2017;01;14;Maanantai;24;34;58;12;20;32
96;02.01.2017;2017;01;15;Maanantai;33;69;102;8;36;44
96;02.01.2017;2017;01;16;Maanantai;40;47;87;9;15;24
96;02.01.2017;2017;01;17;Maanantai;25;21;46;16;8;24
96;02.01.2017;2017;01;18;Maanantai;31;11;42;9;8;17
96;02.01.2017;2017;01;19;Maanantai;19;17;36;7;9;16
96;02.01.2017;2017;01;20;Maanantai;7;4;11;9;9;18
96;02.01.2017;2017;01;21;Maanantai;6;18;24;6;9;15
96;02.01.2017;2017;01;22;Maanantai;6;5;11;2;4;6
96;02.01.2017;2017;01;23;Maanantai;1;0;1;1;1;2
96;03.01.2017;2017;01;00;Tiistai;0;0;0;1;0;1
96;03.01.2017;2017;01;01;Tiistai;0;1;1;1;1;2
96;03.01.2017;2017;01;02;Tiistai;0;0;0;0;0;0
96;03.01.2017;2017;01;03;Tiistai;1;0;1;0;0;0
96;03.01.2017;2017;01;04;Tiistai;1;0;1;1;0;1
96;03.01.2017;2017;01;05;Tiistai;4;6;10;3;1;4
96;03.01.2017;2017;01;06;Tiistai;25;12;37;18;4;22
96;03.01.2017;2017;01;07;Tiistai;40;40;80;35;9;44
96;03.01.2017;2017;01;08;Tiistai;22;42;64;14;3;17
96;03.01.2017;2017;01;09;Tiistai;13;16;29;4;10;14
96;03.01.2017;2017;01;10;Tiistai;11;16;27;3;6;9
96;03.01.2017;2017;01;11;Tiistai;14;14;28;13;9;22
96;03.01.2017;2017;01;12;Tiistai;20;20;40;9;9;18
96;03.01.2017;2017;01;13;Tiistai;16;22;38;8;5;13
96;03.01.2017;2017;01;14;Tiistai;13;27;40;7;18;25
96;03.01.2017;2017;01;15;Tiistai;23;71;94;8;39;47
96;03.01.2017;2017;01;16;Tiistai;36;40;76;6;28;34
96;03.01.2017;2017;01;17;Tiistai;31;15;46;8;8;16
96;03.01.2017;2017;01;18;Tiistai;18;8;26;9;6;15
96;03.01.2017;2017;01;19;Tiistai;11;13;24;14;11;25
96;03.01.2017;2017;01;20;Tiistai;13;11;24;7;9;16
96;03.01.2017;2017;01;21;Tiistai;13;13;26;2;11;13
96;03.01.2017;2017;01;22;Tiistai;2;0;2;2;3;5
96;03.01.2017;2017;01;23;Tiistai;5;0;5;1;0;1
96;04.01.2017;2017;01;00;Keskiviikko;2;2;4;0;1;1
96;04.01.2017;2017;01;01;Keskiviikko;0;0;0;0;0;0
96;04.01.2017;2017;01;02;Keskiviikko;0;0;0;0;0;0
96;04.01.2017;2017;01;03;Keskiviikko;0;0;0;0;1;1
96;04.01.2017;2017;01;04;Keskiviikko;1;0;1;0;1;1
96;04.01.2017;2017;01;05;Keskiviikko;5;5;10;1;1;2
96;04.01.2017;2017;01;06;Keskiviikko;19;12;31;17;3;20
96;04.01.2017;2017;01;07;Keskiviikko;46;27;73;50;19;69
96;04.01.2017;2017;01;08;Keskiviikko;25;34;59;8;11;19
96;04.01.2017;2017;01;09;Keskiviikko;8;12;20;7;9;16
96;04.01.2017;2017;01;10;Keskiviikko;7;8;15;5;9;14
96;04.01.2017;2017;01;11;Keskiviikko;7;9;16;12;7;19
96;04.01.2017;2017;01;12;Keskiviikko;12;9;21;14;8;22
96;04.01.2017;2017;01;13;Keskiviikko;17;27;44;7;9;16
96;04.01.2017;2017;01;14;Keskiviikko;15;20;35;9;15;24
96;04.01.2017;2017;01;15;Keskiviikko;21;54;75;5;52;57
96;04.01.2017;2017;01;16;Keskiviikko;27;25;52;11;34;45
96;04.01.2017;2017;01;17;Keskiviikko;16;10;26;7;1;8
96;04.01.2017;2017;01;18;Keskiviikko;17;10;27;11;5;16
96;04.01.2017;2017;01;19;Keskiviikko;16;4;20;4;1;5
96;04.01.2017;2017;01;20;Keskiviikko;10;8;18;5;4;9
96;04.01.2017;2017;01;21;Keskiviikko;2;5;7;0;11;11
96;04.01.2017;2017;01;22;Keskiviikko;2;5;7;1;0;1
96;04.01.2017;2017;01;23;Keskiviikko;3;0;3;0;1;1
96;05.01.2017;2017;01;00;Torstai;0;2;2;0;0;0
96;05.01.2017;2017;01;01;Torstai;1;0;1;1;1;2
96;05.01.2017;2017;01;02;Torstai;0;0;0;0;0;0
96;05.01.2017;2017;01;03;Torstai;1;0;1;0;0;0
96;05.01.2017;2017;01;04;Torstai;1;0;1;0;2;2
96;05.01.2017;2017;01;05;Torstai;0;3;3;1;1;2
96;05.01.2017;2017;01;06;Torstai;15;10;25;14;4;18
96;05.01.2017;2017;01;07;Torstai;35;20;55;36;10;46
96;05.01.2017;2017;01;08;Torstai;17;22;39;22;3;25
96;05.01.2017;2017;01;09;Torstai;5;9;14;2;4;6
96;05.01.2017;2017;01;10;Torstai;9;4;13;5;9;14
96;05.01.2017;2017;01;11;Torstai;4;9;13;5;9;14
96;05.01.2017;2017;01;12;Torstai;9;8;17;10;8;18
96;05.01.2017;2017;01;13;Torstai;17;12;29;8;9;17
96;05.01.2017;2017;01;14;Torstai;10;24;34;6;19;25
96;05.01.2017;2017;01;15;Torstai;20;35;55;4;36;40
96;05.01.2017;2017;01;16;Torstai;12;15;27;2;22;24
96;05.01.2017;2017;01;17;Torstai;12;18;30;4;3;7
96;05.01.2017;2017;01;18;Torstai;7;13;20;4;5;9
96;05.01.2017;2017;01;19;Torstai;5;6;11;6;4;10
96;05.01.2017;2017;01;20;Torstai;9;5;14;6;1;7
96;05.01.2017;2017;01;21;Torstai;4;5;9;1;4;5
96;05.01.2017;2017;01;22;Torstai;2;1;3;0;1;1
96;05.01.2017;2017;01;23;Torstai;0;1;1;0;1;1
96;06.01.2017;2017;01;00;Perjantai;0;1;1;1;0;1
96;06.01.2017;2017;01;01;Perjantai;1;0;1;0;0;0
96;06.01.2017;2017;01;02;Perjantai;0;0;0;0;0;0
96;06.01.2017;2017;01;03;Perjantai;1;0;1;0;0;0
96;06.01.2017;2017;01;04;Perjantai;0;0;0;0;1;1
96;06.01.2017;2017;01;05;Perjantai;2;3;5;0;0;0
96;06.01.2017;2017;01;06;Perjantai;9;1;10;6;1;7
96;06.01.2017;2017;01;07;Perjantai;1;5;6;4;6;10
96;06.01.2017;2017;01;08;Perjantai;2;12;14;1;2;3
96;06.01.2017;2017;01;09;Perjantai;3;3;6;1;5;6
96;06.01.2017;2017;01;10;Perjantai;2;4;6;3;7;10
96;06.01.2017;2017;01;11;Perjantai;4;3;7;6;5;11
96;06.01.2017;2017;01;12;Perjantai;7;9;16;9;15;24
96;06.01.2017;2017;01;13;Perjantai;16;6;22;11;10;21
96;06.01.2017;2017;01;14;Perjantai;11;12;23;7;12;19
96;06.01.2017;2017;01;15;Perjantai;12;12;24;8;13;21
96;06.01.2017;2017;01;16;Perjantai;9;10;19;9;4;13
96;06.01.2017;2017;01;17;Perjantai;9;3;12;4;3;7
96;06.01.2017;2017;01;18;Perjantai;9;11;20;6;9;15
96;06.01.2017;2017;01;19;Perjantai;8;7;15;7;8;15
96;06.01.2017;2017;01;20;Perjantai;2;1;3;6;7;13
96;06.01.2017;2017;01;21;Perjantai;3;9;12;1;8;9
96;06.01.2017;2017;01;22;Perjantai;0;3;3;1;1;2
96;06.01.2017;2017;01;23;Perjantai;2;5;7;1;2;3
96;07.01.2017;2017;01;00;Lauantai;1;0;1;0;0;0
96;07.01.2017;2017;01;01;Lauantai;1;0;1;0;0;0
96;07.01.2017;2017;01;02;Lauantai;2;1;3;0;0;0
96;07.01.2017;2017;01;03;Lauantai;2;1;3;0;0;0
96;07.01.2017;2017;01;04;Lauantai;1;0;1;1;0;1
96;07.01.2017;2017;01;05;Lauantai;6;0;6;2;0;2
96;07.01.2017;2017;01;06;Lauantai;13;1;14;1;0;1
96;07.01.2017;2017;01;07;Lauantai;6;1;7;1;0;1
96;07.01.2017;2017;01;08;Lauantai;12;0;12;1;0;1
96;07.01.2017;2017;01;09;Lauantai;9;2;11;8;0;8
96;07.01.2017;2017;01;10;Lauantai;18;5;23;8;0;8
96;07.01.2017;2017;01;11;Lauantai;22;7;29;5;0;5
96;07.01.2017;2017;01;12;Lauantai;28;10;38;4;0;4
96;07.01.2017;2017;01;13;Lauantai;48;15;63;13;0;13
96;07.01.2017;2017;01;14;Lauantai;47;17;64;6;0;6
96;07.01.2017;2017;01;15;Lauantai;40;10;50;15;0;15
96;07.01.2017;2017;01;16;Lauantai;43;11;54;10;0;10
96;07.01.2017;2017;01;17;Lauantai;33;4;37;8;0;8
96;07.01.2017;2017;01;18;Lauantai;25;7;32;11;0;11
96;07.01.2017;2017;01;19;Lauantai;20;8;28;6;0;6
96;07.01.2017;2017;01;20;Lauantai;31;6;37;6;0;6
96;07.01.2017;2017;01;21;Lauantai;15;3;18;2;0;2
96;07.01.2017;2017;01;22;Lauantai;5;1;6;1;0;1
96;07.01.2017;2017;01;23;Lauantai;9;1;10;0;0;0
96;08.01.2017;2017;01;00;Sunnuntai;8;2;10;0;0;0
96;08.01.2017;2017;01;01;Sunnuntai;5;1;6;0;0;0
96;08.01.2017;2017;01;02;Sunnuntai;4;0;4;0;0;0
96;08.01.2017;2017;01;03;Sunnuntai;2;1;3;0;0;0
96;08.01.2017;2017;01;04;Sunnuntai;6;1;7;0;0;0
96;08.01.2017;2017;01;05;Sunnuntai;3;1;4;0;0;0
96;08.01.2017;2017;01;06;Sunnuntai;7;4;11;0;0;0
96;08.01.2017;2017;01;07;Sunnuntai;8;1;9;4;0;4
96;08.01.2017;2017;01;08;Sunnuntai;4;2;6;2;0;2
96;08.01.2017;2017;01;09;Sunnuntai;10;3;13;8;0;8
96;08.01.2017;2017;01;10;Sunnuntai;13;3;16;7;0;7
96;08.01.2017;2017;01;11;Sunnuntai;15;7;22;7;0;7
96;08.01.2017;2017;01;12;Sunnuntai;27;10;37;5;0;5
96;08.01.2017;2017;01;13;Sunnuntai;28;17;45;5;0;5
96;08.01.2017;2017;01;14;Sunnuntai;22;8;30;3;0;3
96;08.01.2017;2017;01;15;Sunnuntai;25;12;37;7;0;7
96;08.01.2017;2017;01;16;Sunnuntai;15;9;24;3;0;3
96;08.01.2017;2017;01;17;Sunnuntai;14;10;24;0;0;0
96;08.01.2017;2017;01;18;Sunnuntai;14;13;27;0;0;0
96;08.01.2017;2017;01;19;Sunnuntai;11;7;18;0;0;0
96;08.01.2017;2017;01;20;Sunnuntai;12;10;22;0;0;0
96;08.01.2017;2017;01;21;Sunnuntai;15;10;25;0;0;0
96;08.01.2017;2017;01;22;Sunnuntai;7;2;9;0;0;0
96;08.01.2017;2017;01;23;Sunnuntai;4;0;4;0;0;0
96;09.01.2017;2017;01;00;Maanantai;1;0;1;1;0;1
96;09.01.2017;2017;01;01;Maanantai;0;0;0;0;0;0
96;09.01.2017;2017;01;02;Maanantai;0;0;0;0;0;0
96;09.01.2017;2017;01;03;Maanantai;3;0;3;1;0;1
96;09.01.2017;2017;01;04;Maanantai;1;0;1;0;0;0
96;09.01.2017;2017;01;05;Maanantai;6;1;7;3;0;3
96;09.01.2017;2017;01;06;Maanantai;43;3;46;12;0;12
96;09.01.2017;2017;01;07;Maanantai;158;29;187;48;2;50
96;09.01.2017;2017;01;08;Maanantai;106;25;131;25;2;27
96;09.01.2017;2017;01;09;Maanantai;88;18;106;42;2;44
96;09.01.2017;2017;01;10;Maanantai;62;13;75;19;1;20
96;09.01.2017;2017;01;11;Maanantai;69;11;80;20;5;25
96;09.01.2017;2017;01;12;Maanantai;76;29;105;29;3;32
96;09.01.2017;2017;01;13;Maanantai;68;38;106;27;4;31
96;09.01.2017;2017;01;14;Maanantai;36;108;144;14;37;51
96;09.01.2017;2017;01;15;Maanantai;71;166;237;15;50;65
96;09.01.2017;2017;01;16;Maanantai;75;100;175;16;50;66
96;09.01.2017;2017;01;17;Maanantai;38;53;91;23;21;44
96;09.01.2017;2017;01;18;Maanantai;42;33;75;21;26;47
96;09.01.2017;2017;01;19;Maanantai;42;17;59;18;13;31
96;09.01.2017;2017;01;20;Maanantai;27;18;45;14;12;26
96;09.01.2017;2017;01;21;Maanantai;16;27;43;3;12;15
96;09.01.2017;2017;01;22;Maanantai;8;7;15;1;2;3
96;09.01.2017;2017;01;23;Maanantai;5;1;6;1;0;1
96;10.01.2017;2017;01;00;Tiistai;2;0;2;1;0;1
96;10.01.2017;2017;01;01;Tiistai;0;0;0;1;0;1
96;10.01.2017;2017;01;02;Tiistai;0;1;1;0;0;0
96;10.01.2017;2017;01;03;Tiistai;1;0;1;0;1;1
96;10.01.2017;2017;01;04;Tiistai;1;0;1;2;1;3
96;10.01.2017;2017;01;05;Tiistai;4;10;14;0;2;2
96;10.01.2017;2017;01;06;Tiistai;25;17;42;11;4;15
96;10.01.2017;2017;01;07;Tiistai;106;91;197;41;16;57
96;10.01.2017;2017;01;08;Tiistai;75;79;154;23;18;41
96;10.01.2017;2017;01;09;Tiistai;84;40;124;26;14;40
96;10.01.2017;2017;01;10;Tiistai;31;23;54;10;15;25
96;10.01.2017;2017;01;11;Tiistai;34;40;74;13;17;30
96;10.01.2017;2017;01;12;Tiistai;61;57;118;21;26;47
96;10.01.2017;2017;01;13;Tiistai;44;51;95;13;19;32
96;10.01.2017;2017;01;14;Tiistai;37;87;124;8;21;29
96;10.01.2017;2017;01;15;Tiistai;61;168;229;16;51;67
96;10.01.2017;2017;01;16;Tiistai;49;119;168;12;37;49
96;10.01.2017;2017;01;17;Tiistai;49;59;108;13;13;26
96;10.01.2017;2017;01;18;Tiistai;39;25;64;14;17;31
96;10.01.2017;2017;01;19;Tiistai;30;28;58;18;8;26
96;10.01.2017;2017;01;20;Tiistai;41;13;54;9;13;22
96;10.01.2017;2017;01;21;Tiistai;15;23;38;4;6;10
96;10.01.2017;2017;01;22;Tiistai;13;7;20;2;3;5
96;10.01.2017;2017;01;23;Tiistai;4;1;5;0;0;0
96;11.01.2017;2017;01;00;Keskiviikko;2;1;3;1;0;1
96;11.01.2017;2017;01;01;Keskiviikko;0;1;1;0;0;0
96;11.01.2017;2017;01;02;Keskiviikko;0;0;0;0;0;0
96;11.01.2017;2017;01;03;Keskiviikko;1;0;1;0;0;0
96;11.01.2017;2017;01;04;Keskiviikko;1;0;1;0;1;1
96;11.01.2017;2017;01;05;Keskiviikko;7;4;11;1;1;2
96;11.01.2017;2017;01;06;Keskiviikko;25;14;39;17;4;21
96;11.01.2017;2017;01;07;Keskiviikko;91;76;167;50;19;69
96;11.01.2017;2017;01;08;Keskiviikko;96;59;155;21;10;31
96;11.01.2017;2017;01;09;Keskiviikko;59;31;90;17;8;25
96;11.01.2017;2017;01;10;Keskiviikko;34;35;69;11;14;25
96;11.01.2017;2017;01;11;Keskiviikko;40;37;77;24;10;34
96;11.01.2017;2017;01;12;Keskiviikko;44;41;85;11;10;21
96;11.01.2017;2017;01;13;Keskiviikko;52;61;113;5;19;24
96;11.01.2017;2017;01;14;Keskiviikko;36;106;142;13;35;48
96;11.01.2017;2017;01;15;Keskiviikko;48;154;202;6;42;48
96;11.01.2017;2017;01;16;Keskiviikko;68;87;155;12;39;51
96;11.01.2017;2017;01;17;Keskiviikko;35;36;71;12;21;33
96;11.01.2017;2017;01;18;Keskiviikko;51;33;84;26;22;48
96;11.01.2017;2017;01;19;Keskiviikko;39;22;61;21;19;40
96;11.01.2017;2017;01;20;Keskiviikko;23;38;61;9;20;29
96;11.01.2017;2017;01;21;Keskiviikko;14;28;42;8;14;22
96;11.01.2017;2017;01;22;Keskiviikko;10;10;20;3;5;8
96;11.01.2017;2017;01;23;Keskiviikko;3;4;7;1;1;2
96;12.01.2017;2017;01;00;Torstai;2;0;2;0;0;0
96;12.01.2017;2017;01;01;Torstai;1;0;1;0;0;0
96;12.01.2017;2017;01;02;Torstai;0;0;0;0;0;0
96;12.01.2017;2017;01;03;Torstai;2;0;2;0;0;0
96;12.01.2017;2017;01;04;Torstai;1;0;1;0;0;0
96;12.01.2017;2017;01;05;Torstai;6;7;13;2;1;3
96;12.01.2017;2017;01;06;Torstai;31;20;51;15;5;20
96;12.01.2017;2017;01;07;Torstai;82;82;164;37;17;54
96;12.01.2017;2017;01;08;Torstai;79;63;142;18;10;28
96;12.01.2017;2017;01;09;Torstai;67;41;108;14;10;24
96;12.01.2017;2017;01;10;Torstai;43;35;78;14;9;23
96;12.01.2017;2017;01;11;Torstai;25;33;58;8;10;18
96;12.01.2017;2017;01;12;Torstai;35;41;76;13;9;22
96;12.01.2017;2017;01;13;Torstai;39;37;76;12;14;26
96;12.01.2017;2017;01;14;Torstai;34;104;138;8;31;39
96;12.01.2017;2017;01;15;Torstai;61;150;211;7;48;55
96;12.01.2017;2017;01;16;Torstai;64;84;148;12;24;36
96;12.01.2017;2017;01;17;Torstai;35;44;79;10;17;27
96;12.01.2017;2017;01;18;Torstai;41;43;84;13;15;28
96;12.01.2017;2017;01;19;Torstai;30;16;46;11;9;20
96;12.01.2017;2017;01;20;Torstai;26;22;48;20;8;28
96;12.01.2017;2017;01;21;Torstai;19;16;35;5;9;14
96;12.01.2017;2017;01;22;Torstai;8;4;12;2;2;4
96;12.01.2017;2017;01;23;Torstai;6;0;6;1;3;4
96;13.01.2017;2017;01;00;Perjantai;4;1;5;0;0;0
96;13.01.2017;2017;01;01;Perjantai;2;1;3;0;0;0
96;13.01.2017;2017;01;02;Perjantai;4;0;4;0;0;0
96;13.01.2017;2017;01;03;Perjantai;4;0;4;3;0;3
96;13.01.2017;2017;01;04;Perjantai;3;3;6;0;0;0
96;13.01.2017;2017;01;05;Perjantai;2;5;7;1;0;1
96;13.01.2017;2017;01;06;Perjantai;30;20;50;21;5;26
96;13.01.2017;2017;01;07;Perjantai;75;65;140;33;14;47
96;13.01.2017;2017;01;08;Perjantai;64;63;127;20;10;30
96;13.01.2017;2017;01;09;Perjantai;51;34;85;17;12;29
96;13.01.2017;2017;01;10;Perjantai;42;33;75;13;12;25
96;13.01.2017;2017;01;11;Perjantai;36;41;77;12;16;28
96;13.01.2017;2017;01;12;Perjantai;39;51;90;10;15;25
96;13.01.2017;2017;01;13;Perjantai;41;67;108;9;14;23
96;13.01.2017;2017;01;14;Perjantai;51;121;172;5;40;45
96;13.01.2017;2017;01;15;Perjantai;49;79;128;4;40;44
96;13.01.2017;2017;01;16;Perjantai;47;51;98;14;22;36
96;13.01.2017;2017;01;17;Perjantai;39;25;64;12;12;24
96;13.01.2017;2017;01;18;Perjantai;28;30;58;5;11;16
96;13.01.2017;2017;01;19;Perjantai;19;16;35;5;4;9
96;13.01.2017;2017;01;20;Perjantai;11;10;21;9;5;14
96;13.01.2017;2017;01;21;Perjantai;19;11;30;4;6;10
96;13.01.2017;2017;01;22;Perjantai;7;4;11;1;2;3
96;13.01.2017;2017;01;23;Perjantai;5;6;11;4;1;5
96;14.01.2017;2017;01;00;Lauantai;3;0;3;1;0;1
96;14.01.2017;2017;01;01;Lauantai;1;2;3;1;0;1
96;14.01.2017;2017;01;02;Lauantai;0;1;1;2;1;3
96;14.01.2017;2017;01;03;Lauantai;4;0;4;0;0;0
96;14.01.2017;2017;01;04;Lauantai;4;1;5;0;1;1
96;14.01.2017;2017;01;05;Lauantai;2;1;3;0;0;0
96;14.01.2017;2017;01;06;Lauantai;13;4;17;8;0;8
96;14.01.2017;2017;01;07;Lauantai;4;15;19;2;3;5
96;14.01.2017;2017;01;08;Lauantai;3;12;15;5;3;8
96;14.01.2017;2017;01;09;Lauantai;2;12;14;10;13;23
96;14.01.2017;2017;01;10;Lauantai;6;10;16;9;13;22
96;14.01.2017;2017;01;11;Lauantai;16;11;27;15;12;27
96;14.01.2017;2017;01;12;Lauantai;20;26;46;9;15;24
96;14.01.2017;2017;01;13;Lauantai;15;29;44;9;17;26
96;14.01.2017;2017;01;14;Lauantai;22;35;57;7;7;14
96;14.01.2017;2017;01;15;Lauantai;32;28;60;19;18;37
96;14.01.2017;2017;01;16;Lauantai;25;28;53;8;21;29
96;14.01.2017;2017;01;17;Lauantai;20;20;40;12;6;18
96;14.01.2017;2017;01;18;Lauantai;31;17;48;26;6;32
96;14.01.2017;2017;01;19;Lauantai;26;17;43;12;7;19
96;14.01.2017;2017;01;20;Lauantai;20;19;39;7;9;16
96;14.01.2017;2017;01;21;Lauantai;8;17;25;2;7;9
96;14.01.2017;2017;01;22;Lauantai;3;7;10;2;1;3
96;14.01.2017;2017;01;23;Lauantai;4;6;10;0;0;0
96;15.01.2017;2017;01;00;Sunnuntai;3;5;8;3;0;3
96;15.01.2017;2017;01;01;Sunnuntai;5;1;6;2;0;2
96;15.01.2017;2017;01;02;Sunnuntai;4;3;7;1;0;1
96;15.01.2017;2017;01;03;Sunnuntai;9;0;9;0;0;0
96;15.01.2017;2017;01;04;Sunnuntai;5;0;5;3;1;4
96;15.01.2017;2017;01;05;Sunnuntai;3;1;4;0;0;0
96;15.01.2017;2017;01;06;Sunnuntai;12;3;15;5;2;7
96;15.01.2017;2017;01;07;Sunnuntai;3;14;17;0;4;4
96;15.01.2017;2017;01;08;Sunnuntai;1;3;4;2;4;6
96;15.01.2017;2017;01;09;Sunnuntai;3;13;16;6;3;9
96;15.01.2017;2017;01;10;Sunnuntai;6;11;17;9;4;13
96;15.01.2017;2017;01;11;Sunnuntai;12;7;19;18;10;28
96;15.01.2017;2017;01;12;Sunnuntai;32;15;47;11;11;22
96;15.01.2017;2017;01;13;Sunnuntai;13;11;24;10;13;23
96;15.01.2017;2017;01;14;Sunnuntai;20;25;45;12;10;22
96;15.01.2017;2017;01;15;Sunnuntai;10;14;24;17;11;28
96;15.01.2017;2017;01;16;Sunnuntai;29;23;52;34;10;44
96;15.01.2017;2017;01;17;Sunnuntai;19;13;32;10;12;22
96;15.01.2017;2017;01;18;Sunnuntai;25;15;40;19;29;48
96;15.01.2017;2017;01;19;Sunnuntai;9;18;27;12;21;33
96;15.01.2017;2017;01;20;Sunnuntai;18;17;35;9;15;24
96;15.01.2017;2017;01;21;Sunnuntai;5;14;19;7;6;13
96;15.01.2017;2017;01;22;Sunnuntai;6;5;11;2;1;3
96;15.01.2017;2017;01;23;Sunnuntai;10;1;11;2;1;3
96;16.01.2017;2017;01;00;Maanantai;1;2;3;1;0;1
96;16.01.2017;2017;01;01;Maanantai;0;0;0;1;0;1
96;16.01.2017;2017;01;02;Maanantai;0;0;0;0;0;0
96;16.01.2017;2017;01;03;Maanantai;2;0;2;0;1;1
96;16.01.2017;2017;01;04;Maanantai;1;0;1;2;1;3
96;16.01.2017;2017;01;05;Maanantai;3;4;7;2;1;3
96;16.01.2017;2017;01;06;Maanantai;31;23;54;16;4;20
96;16.01.2017;2017;01;07;Maanantai;89;85;174;42;11;53
96;16.01.2017;2017;01;08;Maanantai;104;62;166;16;12;28
96;16.01.2017;2017;01;09;Maanantai;74;30;104;28;11;39
96;16.01.2017;2017;01;10;Maanantai;30;34;64;11;16;27
96;16.01.2017;2017;01;11;Maanantai;42;33;75;16;6;22
96;16.01.2017;2017;01;12;Maanantai;41;41;82;14;18;32
96;16.01.2017;2017;01;13;Maanantai;39;44;83;12;17;29
96;16.01.2017;2017;01;14;Maanantai;34;100;134;10;21;31
96;16.01.2017;2017;01;15;Maanantai;53;166;219;13;50;63
96;16.01.2017;2017;01;16;Maanantai;77;106;183;7;40;47
96;16.01.2017;2017;01;17;Maanantai;41;47;88;17;25;42
96;16.01.2017;2017;01;18;Maanantai;36;33;69;19;16;35
96;16.01.2017;2017;01;19;Maanantai;35;22;57;14;15;29
96;16.01.2017;2017;01;20;Maanantai;16;21;37;12;8;20
96;16.01.2017;2017;01;21;Maanantai;10;16;26;3;6;9
96;16.01.2017;2017;01;22;Maanantai;2;5;7;1;1;2
96;16.01.2017;2017;01;23;Maanantai;2;1;3;0;0;0
96;17.01.2017;2017;01;00;Tiistai;2;0;2;0;0;0
96;17.01.2017;2017;01;01;Tiistai;0;0;0;0;0;0
96;17.01.2017;2017;01;02;Tiistai;0;0;0;0;1;1
96;17.01.2017;2017;01;03;Tiistai;1;0;1;0;0;0
96;17.01.2017;2017;01;04;Tiistai;1;0;1;1;0;1
96;17.01.2017;2017;01;05;Tiistai;3;9;12;2;0;2
96;17.01.2017;2017;01;06;Tiistai;33;25;58;23;4;27
96;17.01.2017;2017;01;07;Tiistai;119;92;211;38;16;54
96;17.01.2017;2017;01;08;Tiistai;91;74;165;24;13;37
96;17.01.2017;2017;01;09;Tiistai;88;36;124;19;6;25
96;17.01.2017;2017;01;10;Tiistai;36;48;84;12;14;26
96;17.01.2017;2017;01;11;Tiistai;47;39;86;23;20;43
96;17.01.2017;2017;01;12;Tiistai;65;51;116;26;15;41
96;17.01.2017;2017;01;13;Tiistai;38;82;120;14;43;57
96;17.01.2017;2017;01;14;Tiistai;31;113;144;6;30;36
96;17.01.2017;2017;01;15;Tiistai;68;170;238;7;50;57
96;17.01.2017;2017;01;16;Tiistai;70;114;184;16;32;48
96;17.01.2017;2017;01;17;Tiistai;51;60;111;23;19;42
96;17.01.2017;2017;01;18;Tiistai;55;32;87;19;20;39
96;17.01.2017;2017;01;19;Tiistai;37;28;65;24;17;41
96;17.01.2017;2017;01;20;Tiistai;44;18;62;13;15;28
96;17.01.2017;2017;01;21;Tiistai;18;35;53;2;13;15
96;17.01.2017;2017;01;22;Tiistai;3;3;6;4;2;6
96;17.01.2017;2017;01;23;Tiistai;5;2;7;0;0;0
96;18.01.2017;2017;01;00;Keskiviikko;0;1;1;0;0;0
96;18.01.2017;2017;01;01;Keskiviikko;0;0;0;0;0;0
96;18.01.2017;2017;01;02;Keskiviikko;0;0;0;0;0;0
96;18.01.2017;2017;01;03;Keskiviikko;3;0;3;0;1;1
96;18.01.2017;2017;01;04;Keskiviikko;1;0;1;1;1;2
96;18.01.2017;2017;01;05;Keskiviikko;1;7;8;0;1;1
96;18.01.2017;2017;01;06;Keskiviikko;40;25;65;20;7;27
96;18.01.2017;2017;01;07;Keskiviikko;115;73;188;40;5;45
96;18.01.2017;2017;01;08;Keskiviikko;91;68;159;30;15;45
96;18.01.2017;2017;01;09;Keskiviikko;84;50;134;17;10;27
96;18.01.2017;2017;01;10;Keskiviikko;47;37;84;25;19;44
96;18.01.2017;2017;01;11;Keskiviikko;49;44;93;19;13;32
96;18.01.2017;2017;01;12;Keskiviikko;65;43;108;22;22;44
96;18.01.2017;2017;01;13;Keskiviikko;47;52;99;16;21;37
96;18.01.2017;2017;01;14;Keskiviikko;46;111;157;6;43;49
96;18.01.2017;2017;01;15;Keskiviikko;55;157;212;18;57;75
96;18.01.2017;2017;01;16;Keskiviikko;67;125;192;13;34;47
96;18.01.2017;2017;01;17;Keskiviikko;47;51;98;17;13;30
96;18.01.2017;2017;01;18;Keskiviikko;71;28;99;24;15;39
96;18.01.2017;2017;01;19;Keskiviikko;33;25;58;21;29;50
96;18.01.2017;2017;01;20;Keskiviikko;31;35;66;5;28;33
96;18.01.2017;2017;01;21;Keskiviikko;13;23;36;7;11;18
96;18.01.2017;2017;01;22;Keskiviikko;4;5;9;1;4;5
96;18.01.2017;2017;01;23;Keskiviikko;3;2;5;1;0;1
96;19.01.2017;2017;01;00;Torstai;1;2;3;0;0;0
96;19.01.2017;2017;01;01;Torstai;0;0;0;0;0;0
96;19.01.2017;2017;01;02;Torstai;0;0;0;0;0;0
96;19.01.2017;2017;01;03;Torstai;1;0;1;0;0;0
96;19.01.2017;2017;01;04;Torstai;1;0;1;0;1;1
96;19.01.2017;2017;01;05;Torstai;3;5;8;2;1;3
96;19.01.2017;2017;01;06;Torstai;24;22;46;21;6;27
96;19.01.2017;2017;01;07;Torstai;86;76;162;38;10;48
96;19.01.2017;2017;01;08;Torstai;75;58;133;12;7;19
96;19.01.2017;2017;01;09;Torstai;67;35;102;23;8;31
96;19.01.2017;2017;01;10;Torstai;43;42;85;20;14;34
96;19.01.2017;2017;01;11;Torstai;29;44;73;9;13;22
96;19.01.2017;2017;01;12;Torstai;45;38;83;21;16;37
96;19.01.2017;2017;01;13;Torstai;34;75;109;13;20;33
96;19.01.2017;2017;01;14;Torstai;51;89;140;3;22;25
96;19.01.2017;2017;01;15;Torstai;58;127;185;10;37;47
96;19.01.2017;2017;01;16;Torstai;45;80;125;13;33;46
96;19.01.2017;2017;01;17;Torstai;40;31;71;14;8;22
96;19.01.2017;2017;01;18;Torstai;20;23;43;15;20;35
96;19.01.2017;2017;01;19;Torstai;32;17;49;8;6;14
96;19.01.2017;2017;01;20;Torstai;22;16;38;5;10;15
96;19.01.2017;2017;01;21;Torstai;12;21;33;3;6;9
96;19.01.2017;2017;01;22;Torstai;4;9;13;0;0;0
96;19.01.2017;2017;01;23;Torstai;1;4;5;0;0;0
96;20.01.2017;2017;01;00;Perjantai;0;3;3;1;0;1
96;20.01.2017;2017;01;01;Perjantai;1;0;1;0;0;0
96;20.01.2017;2017;01;02;Perjantai;4;0;4;0;0;0
96;20.01.2017;2017;01;03;Perjantai;2;0;2;1;0;1
96;20.01.2017;2017;01;04;Perjantai;3;1;4;0;2;2
96;20.01.2017;2017;01;05;Perjantai;4;4;8;1;1;2
96;20.01.2017;2017;01;06;Perjantai;32;10;42;23;7;30
96;20.01.2017;2017;01;07;Perjantai;76;54;130;33;16;49
96;20.01.2017;2017;01;08;Perjantai;49;47;96;16;11;27
96;20.01.2017;2017;01;09;Perjantai;47;40;87;14;11;25
96;20.01.2017;2017;01;10;Perjantai;51;32;83;11;16;27
96;20.01.2017;2017;01;11;Perjantai;39;34;73;9;11;20
96;20.01.2017;2017;01;12;Perjantai;49;43;92;13;12;25
96;20.01.2017;2017;01;13;Perjantai;50;81;131;23;22;45
96;20.01.2017;2017;01;14;Perjantai;34;98;132;14;41;55
96;20.01.2017;2017;01;15;Perjantai;54;84;138;8;34;42
96;20.01.2017;2017;01;16;Perjantai;41;51;92;16;24;40
96;20.01.2017;2017;01;17;Perjantai;31;33;64;13;16;29
96;20.01.2017;2017;01;18;Perjantai;28;16;44;11;8;19
96;20.01.2017;2017;01;19;Perjantai;16;11;27;11;12;23
96;20.01.2017;2017;01;20;Perjantai;20;6;26;10;11;21
96;20.01.2017;2017;01;21;Perjantai;16;25;41;5;6;11
96;20.01.2017;2017;01;22;Perjantai;5;7;12;0;2;2
96;20.01.2017;2017;01;23;Perjantai;4;4;8;1;1;2
96;21.01.2017;2017;01;00;Lauantai;2;1;3;1;0;1
96;21.01.2017;2017;01;01;Lauantai;3;4;7;3;1;4
96;21.01.2017;2017;01;02;Lauantai;4;0;4;1;0;1
96;21.01.2017;2017;01;03;Lauantai;5;1;6;1;0;1
96;21.01.2017;2017;01;04;Lauantai;4;0;4;1;0;1
96;21.01.2017;2017;01;05;Lauantai;3;2;5;0;0;0
96;21.01.2017;2017;01;06;Lauantai;15;4;19;8;0;8
96;21.01.2017;2017;01;07;Lauantai;5;14;19;2;4;6
96;21.01.2017;2017;01;08;Lauantai;4;13;17;3;4;7
96;21.01.2017;2017;01;09;Lauantai;4;15;19;5;9;14
96;21.01.2017;2017;01;10;Lauantai;13;22;35;8;5;13
96;21.01.2017;2017;01;11;Lauantai;16;25;41;10;13;23
96;21.01.2017;2017;01;12;Lauantai;16;19;35;13;15;28
96;21.01.2017;2017;01;13;Lauantai;26;25;51;20;23;43
96;21.01.2017;2017;01;14;Lauantai;28;25;53;14;24;38
96;21.01.2017;2017;01;15;Lauantai;29;24;53;17;24;41
96;21.01.2017;2017;01;16;Lauantai;16;20;36;14;17;31
96;21.01.2017;2017;01;17;Lauantai;23;13;36;24;4;28
96;21.01.2017;2017;01;18;Lauantai;16;13;29;25;18;43
96;21.01.2017;2017;01;19;Lauantai;18;7;25;8;15;23
96;21.01.2017;2017;01;20;Lauantai;14;11;25;8;7;15
96;21.01.2017;2017;01;21;Lauantai;5;29;34;2;10;12
96;21.01.2017;2017;01;22;Lauantai;5;4;9;1;2;3
96;21.01.2017;2017;01;23;Lauantai;7;4;11;1;0;1
96;22.01.2017;2017;01;00;Sunnuntai;2;2;4;0;0;0
96;22.01.2017;2017;01;01;Sunnuntai;2;3;5;3;1;4
96;22.01.2017;2017;01;02;Sunnuntai;5;3;8;0;0;0
96;22.01.2017;2017;01;03;Sunnuntai;4;1;5;1;0;1
96;22.01.2017;2017;01;04;Sunnuntai;6;0;6;0;0;0
96;22.01.2017;2017;01;05;Sunnuntai;1;3;4;0;0;0
96;22.01.2017;2017;01;06;Sunnuntai;9;4;13;2;0;2
96;22.01.2017;2017;01;07;Sunnuntai;1;5;6;3;6;9
96;22.01.2017;2017;01;08;Sunnuntai;0;4;4;2;5;7
96;22.01.2017;2017;01;09;Sunnuntai;4;6;10;5;5;10
96;22.01.2017;2017;01;10;Sunnuntai;6;9;15;9;7;16
96;22.01.2017;2017;01;11;Sunnuntai;7;12;19;9;16;25
96;22.01.2017;2017;01;12;Sunnuntai;18;18;36;7;17;24
96;22.01.2017;2017;01;13;Sunnuntai;15;24;39;16;13;29
96;22.01.2017;2017;01;14;Sunnuntai;14;20;34;13;14;27
96;22.01.2017;2017;01;15;Sunnuntai;15;22;37;8;19;27
96;22.01.2017;2017;01;16;Sunnuntai;23;11;34;36;8;44
96;22.01.2017;2017;01;17;Sunnuntai;19;7;26;17;13;30
96;22.01.2017;2017;01;18;Sunnuntai;22;21;43;23;32;55
96;22.01.2017;2017;01;19;Sunnuntai;7;18;25;14;13;27
96;22.01.2017;2017;01;20;Sunnuntai;11;19;30;5;10;15
96;22.01.2017;2017;01;21;Sunnuntai;17;11;28;5;8;13
96;22.01.2017;2017;01;22;Sunnuntai;7;4;11;0;1;1
96;22.01.2017;2017;01;23;Sunnuntai;5;1;6;1;0;1
96;23.01.2017;2017;01;00;Maanantai;1;0;1;2;0;2
96;23.01.2017;2017;01;01;Maanantai;0;0;0;1;0;1
96;23.01.2017;2017;01;02;Maanantai;1;0;1;0;0;0
96;23.01.2017;2017;01;03;Maanantai;6;0;6;0;0;0
96;23.01.2017;2017;01;04;Maanantai;2;0;2;0;1;1
96;23.01.2017;2017;01;05;Maanantai;4;7;11;0;1;1
96;23.01.2017;2017;01;06;Maanantai;23;21;44;18;2;20
96;23.01.2017;2017;01;07;Maanantai;94;82;176;48;14;62
96;23.01.2017;2017;01;08;Maanantai;93;57;150;32;8;40
96;23.01.2017;2017;01;09;Maanantai;57;50;107;20;12;32
96;23.01.2017;2017;01;10;Maanantai;36;26;62;15;14;29
96;23.01.2017;2017;01;11;Maanantai;34;46;80;17;12;29
96;23.01.2017;2017;01;12;Maanantai;54;39;93;18;16;34
96;23.01.2017;2017;01;13;Maanantai;40;57;97;10;14;24
96;23.01.2017;2017;01;14;Maanantai;37;90;127;8;38;46
96;23.01.2017;2017;01;15;Maanantai;56;153;209;13;45;58
96;23.01.2017;2017;01;16;Maanantai;69;92;161;17;44;61
96;23.01.2017;2017;01;17;Maanantai;50;40;90;24;23;47
96;23.01.2017;2017;01;18;Maanantai;37;37;74;16;36;52
96;23.01.2017;2017;01;19;Maanantai;19;29;48;12;16;28
96;23.01.2017;2017;01;20;Maanantai;31;21;52;16;15;31
96;23.01.2017;2017;01;21;Maanantai;16;24;40;7;6;13
96;23.01.2017;2017;01;22;Maanantai;14;1;15;2;2;4
96;23.01.2017;2017;01;23;Maanantai;5;1;6;0;0;0
96;24.01.2017;2017;01;00;Tiistai;1;1;2;0;0;0
96;24.01.2017;2017;01;01;Tiistai;2;1;3;1;0;1
96;24.01.2017;2017;01;02;Tiistai;1;0;1;0;0;0
96;24.01.2017;2017;01;03;Tiistai;1;0;1;0;0;0
96;24.01.2017;2017;01;04;Tiistai;2;0;2;1;1;2
96;24.01.2017;2017;01;05;Tiistai;3;7;10;1;0;1
96;24.01.2017;2017;01;06;Tiistai;39;20;59;16;3;19
96;24.01.2017;2017;01;07;Tiistai;109;74;183;57;14;71
96;24.01.2017;2017;01;08;Tiistai;83;54;137;17;11;28
96;24.01.2017;2017;01;09;Tiistai;64;38;102;22;11;33
96;24.01.2017;2017;01;10;Tiistai;40;23;63;10;5;15
96;24.01.2017;2017;01;11;Tiistai;34;39;73;19;25;44
96;24.01.2017;2017;01;12;Tiistai;56;47;103;23;12;35
96;24.01.2017;2017;01;13;Tiistai;41;56;97;8;20;28
96;24.01.2017;2017;01;14;Tiistai;38;91;129;5;26;31
96;24.01.2017;2017;01;15;Tiistai;60;161;221;14;50;64
96;24.01.2017;2017;01;16;Tiistai;68;103;171;22;49;71
96;24.01.2017;2017;01;17;Tiistai;39;49;88;10;19;29
96;24.01.2017;2017;01;18;Tiistai;34;31;65;11;12;23
96;24.01.2017;2017;01;19;Tiistai;28;21;49;8;7;15
96;24.01.2017;2017;01;20;Tiistai;45;16;61;10;8;18
96;24.01.2017;2017;01;21;Tiistai;22;20;42;5;5;10
96;24.01.2017;2017;01;22;Tiistai;4;10;14;5;3;8
96;24.01.2017;2017;01;23;Tiistai;1;0;1;0;0;0
96;25.01.2017;2017;01;00;Keskiviikko;2;0;2;1;0;1
96;25.01.2017;2017;01;01;Keskiviikko;1;0;1;0;0;0
96;25.01.2017;2017;01;02;Keskiviikko;0;1;1;0;0;0
96;25.01.2017;2017;01;03;Keskiviikko;1;0;1;0;0;0
96;25.01.2017;2017;01;04;Keskiviikko;2;3;5;0;1;1
96;25.01.2017;2017;01;05;Keskiviikko;3;4;7;2;2;4
96;25.01.2017;2017;01;06;Keskiviikko;35;18;53;21;5;26
96;25.01.2017;2017;01;07;Keskiviikko;111;77;188;46;11;57
96;25.01.2017;2017;01;08;Keskiviikko;74;55;129;18;12;30
96;25.01.2017;2017;01;09;Keskiviikko;64;48;112;24;15;39
96;25.01.2017;2017;01;10;Keskiviikko;46;41;87;14;15;29
96;25.01.2017;2017;01;11;Keskiviikko;46;38;84;19;16;35
96;25.01.2017;2017;01;12;Keskiviikko;66;43;109;12;10;22
96;25.01.2017;2017;01;13;Keskiviikko;47;55;102;6;17;23
96;25.01.2017;2017;01;14;Keskiviikko;44;96;140;6;31;37
96;25.01.2017;2017;01;15;Keskiviikko;40;129;169;9;50;59
96;25.01.2017;2017;01;16;Keskiviikko;61;100;161;13;36;49
96;25.01.2017;2017;01;17;Keskiviikko;46;50;96;13;10;23
96;25.01.2017;2017;01;18;Keskiviikko;60;29;89;19;10;29
96;25.01.2017;2017;01;19;Keskiviikko;25;19;44;17;13;30
96;25.01.2017;2017;01;20;Keskiviikko;28;36;64;6;9;15
96;25.01.2017;2017;01;21;Keskiviikko;10;33;43;5;12;17
96;25.01.2017;2017;01;22;Keskiviikko;7;8;15;1;1;2
96;25.01.2017;2017;01;23;Keskiviikko;3;1;4;0;0;0
96;26.01.2017;2017;01;00;Torstai;1;0;1;1;0;1
96;26.01.2017;2017;01;01;Torstai;1;0;1;0;0;0
96;26.01.2017;2017;01;02;Torstai;0;0;0;0;0;0
96;26.01.2017;2017;01;03;Torstai;1;0;1;0;0;0
96;26.01.2017;2017;01;04;Torstai;2;0;2;2;6;8
96;26.01.2017;2017;01;05;Torstai;5;4;9;5;2;7
96;26.01.2017;2017;01;06;Torstai;28;10;38;18;8;26
96;26.01.2017;2017;01;07;Torstai;91;71;162;47;15;62
96;26.01.2017;2017;01;08;Torstai;78;74;152;15;16;31
96;26.01.2017;2017;01;09;Torstai;75;42;117;20;13;33
96;26.01.2017;2017;01;10;Torstai;35;42;77;12;25;37
96;26.01.2017;2017;01;11;Torstai;45;47;92;18;19;37
96;26.01.2017;2017;01;12;Torstai;61;42;103;25;21;46
96;26.01.2017;2017;01;13;Torstai;40;50;90;22;29;51
96;26.01.2017;2017;01;14;Torstai;48;117;165;10;35;45
96;26.01.2017;2017;01;15;Torstai;47;150;197;14;43;57
96;26.01.2017;2017;01;16;Torstai;67;91;158;11;32;43
96;26.01.2017;2017;01;17;Torstai;37;44;81;19;14;33
96;26.01.2017;2017;01;18;Torstai;54;20;74;21;13;34
96;26.01.2017;2017;01;19;Torstai;28;22;50;11;25;36
96;26.01.2017;2017;01;20;Torstai;29;27;56;8;13;21
96;26.01.2017;2017;01;21;Torstai;19;27;46;8;10;18
96;26.01.2017;2017;01;22;Torstai;4;8;12;3;2;5
96;26.01.2017;2017;01;23;Torstai;5;2;7;1;0;1
96;27.01.2017;2017;01;00;Perjantai;1;2;3;0;1;1
96;27.01.2017;2017;01;01;Perjantai;0;0;0;0;0;0
96;27.01.2017;2017;01;02;Perjantai;1;1;2;1;0;1
96;27.01.2017;2017;01;03;Perjantai;1;1;2;0;0;0
96;27.01.2017;2017;01;04;Perjantai;2;1;3;1;0;1
96;27.01.2017;2017;01;05;Perjantai;6;7;13;2;0;2
96;27.01.2017;2017;01;06;Perjantai;39;22;61;20;3;23
96;27.01.2017;2017;01;07;Perjantai;81;60;141;28;14;42
96;27.01.2017;2017;01;08;Perjantai;66;59;125;16;12;28
96;27.01.2017;2017;01;09;Perjantai;45;43;88;13;11;24
96;27.01.2017;2017;01;10;Perjantai;53;36;89;17;15;32
96;27.01.2017;2017;01;11;Perjantai;38;56;94;13;16;29
96;27.01.2017;2017;01;12;Perjantai;57;64;121;8;27;35
96;27.01.2017;2017;01;13;Perjantai;49;58;107;9;31;40
96;27.01.2017;2017;01;14;Perjantai;52;118;170;9;32;41
96;27.01.2017;2017;01;15;Perjantai;60;96;156;6;35;41
96;27.01.2017;2017;01;16;Perjantai;55;51;106;10;32;42
96;27.01.2017;2017;01;17;Perjantai;48;31;79;2;9;11
96;27.01.2017;2017;01;18;Perjantai;39;25;64;3;15;18
96;27.01.2017;2017;01;19;Perjantai;23;15;38;10;6;16
96;27.01.2017;2017;01;20;Perjantai;13;19;32;8;8;16
96;27.01.2017;2017;01;21;Perjantai;12;23;35;1;7;8
96;27.01.2017;2017;01;22;Perjantai;12;9;21;1;1;2
96;27.01.2017;2017;01;23;Perjantai;15;4;19;0;2;2
96;28.01.2017;2017;01;00;Lauantai;3;2;5;1;0;1
96;28.01.2017;2017;01;01;Lauantai;5;8;13;1;0;1
96;28.01.2017;2017;01;02;Lauantai;1;5;6;1;0;1
96;28.01.2017;2017;01;03;Lauantai;5;1;6;0;0;0
96;28.01.2017;2017;01;04;Lauantai;1;1;2;1;1;2
96;28.01.2017;2017;01;05;Lauantai;4;4;8;0;1;1
96;28.01.2017;2017;01;06;Lauantai;21;1;22;3;2;5
96;28.01.2017;2017;01;07;Lauantai;4;12;16;2;3;5
96;28.01.2017;2017;01;08;Lauantai;6;12;18;2;3;5
96;28.01.2017;2017;01;09;Lauantai;11;22;33;2;4;6
96;28.01.2017;2017;01;10;Lauantai;11;9;20;7;9;16
96;28.01.2017;2017;01;11;Lauantai;14;24;38;2;5;7
96;28.01.2017;2017;01;12;Lauantai;24;33;57;2;6;8
96;28.01.2017;2017;01;13;Lauantai;29;23;52;3;12;15
96;28.01.2017;2017;01;14;Lauantai;28;31;59;3;12;15
96;28.01.2017;2017;01;15;Lauantai;23;29;52;4;11;15
96;28.01.2017;2017;01;16;Lauantai;23;23;46;4;1;5
96;28.01.2017;2017;01;17;Lauantai;20;13;33;3;6;9
96;28.01.2017;2017;01;18;Lauantai;22;14;36;7;5;12
96;28.01.2017;2017;01;19;Lauantai;14;16;30;3;7;10
96;28.01.2017;2017;01;20;Lauantai;16;7;23;3;12;15
96;28.01.2017;2017;01;21;Lauantai;13;14;27;4;5;9
96;28.01.2017;2017;01;22;Lauantai;3;7;10;2;2;4
96;28.01.2017;2017;01;23;Lauantai;9;4;13;1;0;1
96;29.01.2017;2017;01;00;Sunnuntai;12;4;16;1;1;2
96;29.01.2017;2017;01;01;Sunnuntai;3;2;5;0;1;1
96;29.01.2017;2017;01;02;Sunnuntai;2;1;3;0;0;0
96;29.01.2017;2017;01;03;Sunnuntai;7;4;11;3;1;4
96;29.01.2017;2017;01;04;Sunnuntai;8;2;10;2;0;2
96;29.01.2017;2017;01;05;Sunnuntai;4;2;6;0;0;0
96;29.01.2017;2017;01;06;Sunnuntai;12;6;18;1;1;2
96;29.01.2017;2017;01;07;Sunnuntai;5;5;10;1;3;4
96;29.01.2017;2017;01;08;Sunnuntai;3;2;5;0;3;3
96;29.01.2017;2017;01;09;Sunnuntai;5;10;15;3;4;7
96;29.01.2017;2017;01;10;Sunnuntai;7;16;23;4;7;11
96;29.01.2017;2017;01;11;Sunnuntai;8;8;16;17;15;32
96;29.01.2017;2017;01;12;Sunnuntai;28;17;45;21;17;38
96;29.01.2017;2017;01;13;Sunnuntai;32;18;50;13;21;34
96;29.01.2017;2017;01;14;Sunnuntai;20;24;44;11;27;38
96;29.01.2017;2017;01;15;Sunnuntai;25;20;45;15;11;26
96;29.01.2017;2017;01;16;Sunnuntai;33;4;37;27;9;36
96;29.01.2017;2017;01;17;Sunnuntai;21;18;39;14;8;22
96;29.01.2017;2017;01;18;Sunnuntai;24;21;45;13;24;37
96;29.01.2017;2017;01;19;Sunnuntai;14;20;34;7;19;26
96;29.01.2017;2017;01;20;Sunnuntai;18;9;27;11;12;23
96;29.01.2017;2017;01;21;Sunnuntai;6;14;20;5;2;7
96;29.01.2017;2017;01;22;Sunnuntai;5;5;10;1;1;2
96;29.01.2017;2017;01;23;Sunnuntai;6;2;8;0;0;0
96;30.01.2017;2017;01;00;Maanantai;2;0;2;4;0;4
96;30.01.2017;2017;01;01;Maanantai;1;0;1;0;0;0
96;30.01.2017;2017;01;02;Maanantai;0;0;0;0;0;0
96;30.01.2017;2017;01;03;Maanantai;2;2;4;0;0;0
96;30.01.2017;2017;01;04;Maanantai;1;0;1;0;0;0
96;30.01.2017;2017;01;05;Maanantai;1;5;6;0;1;1
96;30.01.2017;2017;01;06;Maanantai;36;18;54;19;4;23
96;30.01.2017;2017;01;07;Maanantai;106;65;171;37;12;49
96;30.01.2017;2017;01;08;Maanantai;106;61;167;14;14;28
96;30.01.2017;2017;01;09;Maanantai;62;41;103;6;10;16
96;30.01.2017;2017;01;10;Maanantai;39;29;68;14;7;21
96;30.01.2017;2017;01;11;Maanantai;30;30;60;16;17;33
96;30.01.2017;2017;01;12;Maanantai;45;44;89;15;13;28
96;30.01.2017;2017;01;13;Maanantai;49;48;97;18;17;35
96;30.01.2017;2017;01;14;Maanantai;40;90;130;11;33;44
96;30.01.2017;2017;01;15;Maanantai;60;160;220;15;54;69
96;30.01.2017;2017;01;16;Maanantai;73;110;183;13;38;51
96;30.01.2017;2017;01;17;Maanantai;48;53;101;14;24;38
96;30.01.2017;2017;01;18;Maanantai;38;39;77;16;22;38
96;30.01.2017;2017;01;19;Maanantai;38;29;67;14;26;40
96;30.01.2017;2017;01;20;Maanantai;29;18;47;6;13;19
96;30.01.2017;2017;01;21;Maanantai;30;15;45;3;10;13
96;30.01.2017;2017;01;22;Maanantai;8;3;11;3;1;4
96;30.01.2017;2017;01;23;Maanantai;4;2;6;0;0;0
96;31.01.2017;2017;01;00;Tiistai;0;0;0;0;0;0
96;31.01.2017;2017;01;01;Tiistai;1;0;1;1;0;1
96;31.01.2017;2017;01;02;Tiistai;0;0;0;0;0;0
96;31.01.2017;2017;01;03;Tiistai;0;0;0;1;1;2
96;31.01.2017;2017;01;04;Tiistai;2;1;3;0;0;0
96;31.01.2017;2017;01;05;Tiistai;9;9;18;0;0;0
96;31.01.2017;2017;01;06;Tiistai;36;20;56;17;6;23
96;31.01.2017;2017;01;07;Tiistai;106;56;162;42;26;68
96;31.01.2017;2017;01;08;Tiistai;95;76;171;15;14;29
96;31.01.2017;2017;01;09;Tiistai;64;44;108;9;19;28
96;31.01.2017;2017;01;10;Tiistai;39;40;79;15;11;26
96;31.01.2017;2017;01;11;Tiistai;61;22;83;19;28;47
96;31.01.2017;2017;01;12;Tiistai;62;44;106;16;44;60
96;31.01.2017;2017;01;13;Tiistai;39;55;94;17;42;59
96;31.01.2017;2017;01;14;Tiistai;52;79;131;9;45;54
96;31.01.2017;2017;01;15;Tiistai;66;163;229;18;56;74
96;31.01.2017;2017;01;16;Tiistai;69;112;181;29;35;64
96;31.01.2017;2017;01;17;Tiistai;49;56;105;16;24;40
96;31.01.2017;2017;01;18;Tiistai;31;38;69;18;16;34
96;31.01.2017;2017;01;19;Tiistai;45;20;65;17;15;32
96;31.01.2017;2017;01;20;Tiistai;31;15;46;17;16;33
96;31.01.2017;2017;01;21;Tiistai;33;27;60;9;14;23
96;31.01.2017;2017;01;22;Tiistai;8;7;15;2;3;5
96;31.01.2017;2017;01;23;Tiistai;9;2;11;0;0;0
96;01.02.2017;2017;02;00;Keskiviikko;2;0;2;0;0;0
96;01.02.2017;2017;02;01;Keskiviikko;1;0;1;0;0;0
96;01.02.2017;2017;02;02;Keskiviikko;1;0;1;0;0;0
96;01.02.2017;2017;02;03;Keskiviikko;3;0;3;0;0;0
96;01.02.2017;2017;02;04;Keskiviikko;2;0;2;0;0;0
96;01.02.2017;2017;02;05;Keskiviikko;7;5;12;0;3;3
96;01.02.2017;2017;02;06;Keskiviikko;37;18;55;23;6;29
96;01.02.2017;2017;02;07;Keskiviikko;117;77;194;37;21;58
96;01.02.2017;2017;02;08;Keskiviikko;98;58;156;18;20;38
96;01.02.2017;2017;02;09;Keskiviikko;50;44;94;12;19;31
96;01.02.2017;2017;02;10;Keskiviikko;43;30;73;16;31;47
96;01.02.2017;2017;02;11;Keskiviikko;44;36;80;15;22;37
96;01.02.2017;2017;02;12;Keskiviikko;58;38;96;14;21;35
96;01.02.2017;2017;02;13;Keskiviikko;43;65;108;11;32;43
96;01.02.2017;2017;02;14;Keskiviikko;39;115;154;12;38;50
96;01.02.2017;2017;02;15;Keskiviikko;46;128;174;12;46;58
96;01.02.2017;2017;02;16;Keskiviikko;68;86;154;15;40;55
96;01.02.2017;2017;02;17;Keskiviikko;51;35;86;13;25;38
96;01.02.2017;2017;02;18;Keskiviikko;55;34;89;22;21;43
96;01.02.2017;2017;02;19;Keskiviikko;33;13;46;14;14;28
96;01.02.2017;2017;02;20;Keskiviikko;24;23;47;6;15;21
96;01.02.2017;2017;02;21;Keskiviikko;13;30;43;7;14;21
96;01.02.2017;2017;02;22;Keskiviikko;5;6;11;2;1;3
96;01.02.2017;2017;02;23;Keskiviikko;3;2;5;0;0;0
96;02.02.2017;2017;02;00;Torstai;0;0;0;0;1;1
96;02.02.2017;2017;02;01;Torstai;1;0;1;0;0;0
96;02.02.2017;2017;02;02;Torstai;0;0;0;0;0;0
96;02.02.2017;2017;02;03;Torstai;1;1;2;0;0;0
96;02.02.2017;2017;02;04;Torstai;4;0;4;0;0;0
96;02.02.2017;2017;02;05;Torstai;4;8;12;0;1;1
96;02.02.2017;2017;02;06;Torstai;33;22;55;16;4;20
96;02.02.2017;2017;02;07;Torstai;121;66;187;32;14;46
96;02.02.2017;2017;02;08;Torstai;96;69;165;20;17;37
96;02.02.2017;2017;02;09;Torstai;72;41;113;14;7;21
96;02.02.2017;2017;02;10;Torstai;45;48;93;11;11;22
96;02.02.2017;2017;02;11;Torstai;28;35;63;11;11;22
96;02.02.2017;2017;02;12;Torstai;60;67;127;20;13;33
96;02.02.2017;2017;02;13;Torstai;33;88;121;11;25;36
96;02.02.2017;2017;02;14;Torstai;49;93;142;20;36;56
96;02.02.2017;2017;02;15;Torstai;39;136;175;9;42;51
96;02.02.2017;2017;02;16;Torstai;55;69;124;11;35;46
96;02.02.2017;2017;02;17;Torstai;32;38;70;12;14;26
96;02.02.2017;2017;02;18;Torstai;37;19;56;22;10;32
96;02.02.2017;2017;02;19;Torstai;17;24;41;5;16;21
96;02.02.2017;2017;02;20;Torstai;18;17;35;6;14;20
96;02.02.2017;2017;02;21;Torstai;7;13;20;7;8;15
96;02.02.2017;2017;02;22;Torstai;5;5;10;5;2;7
96;02.02.2017;2017;02;23;Torstai;3;4;7;0;1;1
96;03.02.2017;2017;02;00;Perjantai;0;3;3;1;0;1
96;03.02.2017;2017;02;01;Perjantai;5;0;5;0;0;0
96;03.02.2017;2017;02;02;Perjantai;2;0;2;0;0;0
96;03.02.2017;2017;02;03;Perjantai;7;0;7;4;0;4
96;03.02.2017;2017;02;04;Perjantai;4;2;6;1;0;1
96;03.02.2017;2017;02;05;Perjantai;1;2;3;3;3;6
96;03.02.2017;2017;02;06;Perjantai;33;17;50;15;5;20
96;03.02.2017;2017;02;07;Perjantai;80;56;136;24;14;38
96;03.02.2017;2017;02;08;Perjantai;104;53;157;22;14;36
96;03.02.2017;2017;02;09;Perjantai;41;49;90;6;11;17
96;03.02.2017;2017;02;10;Perjantai;44;56;100;17;4;21
96;03.02.2017;2017;02;11;Perjantai;37;50;87;10;21;31
96;03.02.2017;2017;02;12;Perjantai;42;54;96;17;25;42
96;03.02.2017;2017;02;13;Perjantai;42;75;117;13;23;36
96;03.02.2017;2017;02;14;Perjantai;41;100;141;5;35;40
96;03.02.2017;2017;02;15;Perjantai;51;97;148;13;35;48
96;03.02.2017;2017;02;16;Perjantai;54;42;96;13;19;32
96;03.02.2017;2017;02;17;Perjantai;30;38;68;18;13;31
96;03.02.2017;2017;02;18;Perjantai;22;26;48;9;14;23
96;03.02.2017;2017;02;19;Perjantai;31;17;48;16;11;27
96;03.02.2017;2017;02;20;Perjantai;28;12;40;6;6;12
96;03.02.2017;2017;02;21;Perjantai;10;19;29;3;12;15
96;03.02.2017;2017;02;22;Perjantai;7;11;18;1;2;3
96;03.02.2017;2017;02;23;Perjantai;10;3;13;1;2;3
96;04.02.2017;2017;02;00;Lauantai;3;2;5;0;0;0
96;04.02.2017;2017;02;01;Lauantai;2;0;2;1;0;1
96;04.02.2017;2017;02;02;Lauantai;1;1;2;1;0;1
96;04.02.2017;2017;02;03;Lauantai;5;0;5;0;0;0
96;04.02.2017;2017;02;04;Lauantai;5;3;8;2;1;3
96;04.02.2017;2017;02;05;Lauantai;3;2;5;1;0;1
96;04.02.2017;2017;02;06;Lauantai;17;4;21;3;2;5
96;04.02.2017;2017;02;07;Lauantai;4;8;12;1;7;8
96;04.02.2017;2017;02;08;Lauantai;3;18;21;5;8;13
96;04.02.2017;2017;02;09;Lauantai;5;25;30;8;11;19
96;04.02.2017;2017;02;10;Lauantai;16;28;44;11;13;24
96;04.02.2017;2017;02;11;Lauantai;20;21;41;13;11;24
96;04.02.2017;2017;02;12;Lauantai;26;23;49;11;17;28
96;04.02.2017;2017;02;13;Lauantai;23;32;55;19;14;33
96;04.02.2017;2017;02;14;Lauantai;26;31;57;7;17;24
96;04.02.2017;2017;02;15;Lauantai;34;30;64;18;19;37
96;04.02.2017;2017;02;16;Lauantai;27;31;58;16;17;33
96;04.02.2017;2017;02;17;Lauantai;16;13;29;5;9;14
96;04.02.2017;2017;02;18;Lauantai;38;11;49;16;14;30
96;04.02.2017;2017;02;19;Lauantai;23;10;33;14;6;20
96;04.02.2017;2017;02;20;Lauantai;17;14;31;6;15;21
96;04.02.2017;2017;02;21;Lauantai;7;27;34;6;8;14
96;04.02.2017;2017;02;22;Lauantai;3;2;5;3;0;3
96;04.02.2017;2017;02;23;Lauantai;5;2;7;1;1;2
96;05.02.2017;2017;02;00;Sunnuntai;3;1;4;1;2;3
96;05.02.2017;2017;02;01;Sunnuntai;10;3;13;4;1;5
96;05.02.2017;2017;02;02;Sunnuntai;4;0;4;1;0;1
96;05.02.2017;2017;02;03;Sunnuntai;7;0;7;0;0;0
96;05.02.2017;2017;02;04;Sunnuntai;5;1;6;2;2;4
96;05.02.2017;2017;02;05;Sunnuntai;3;1;4;0;1;1
96;05.02.2017;2017;02;06;Sunnuntai;18;2;20;8;0;8
96;05.02.2017;2017;02;07;Sunnuntai;1;7;8;1;3;4
96;05.02.2017;2017;02;08;Sunnuntai;2;6;8;1;6;7
96;05.02.2017;2017;02;09;Sunnuntai;3;15;18;8;6;14
96;05.02.2017;2017;02;10;Sunnuntai;9;14;23;9;16;25
96;05.02.2017;2017;02;11;Sunnuntai;14;11;25;6;16;22
96;05.02.2017;2017;02;12;Sunnuntai;14;15;29;10;11;21
96;05.02.2017;2017;02;13;Sunnuntai;18;13;31;12;14;26
96;05.02.2017;2017;02;14;Sunnuntai;27;23;50;15;14;29
96;05.02.2017;2017;02;15;Sunnuntai;14;19;33;14;13;27
96;05.02.2017;2017;02;16;Sunnuntai;26;14;40;20;17;37
96;05.02.2017;2017;02;17;Sunnuntai;21;15;36;7;15;22
96;05.02.2017;2017;02;18;Sunnuntai;21;13;34;16;23;39
96;05.02.2017;2017;02;19;Sunnuntai;12;4;16;11;13;24
96;05.02.2017;2017;02;20;Sunnuntai;8;17;25;3;13;16
96;05.02.2017;2017;02;21;Sunnuntai;10;17;27;7;8;15
96;05.02.2017;2017;02;22;Sunnuntai;4;1;5;1;0;1
96;05.02.2017;2017;02;23;Sunnuntai;2;6;8;0;0;0
96;06.02.2017;2017;02;00;Maanantai;4;0;4;0;0;0
96;06.02.2017;2017;02;01;Maanantai;0;2;2;0;0;0
96;06.02.2017;2017;02;02;Maanantai;0;0;0;0;0;0
96;06.02.2017;2017;02;03;Maanantai;2;1;3;1;0;1
96;06.02.2017;2017;02;04;Maanantai;1;0;1;0;0;0
96;06.02.2017;2017;02;05;Maanantai;3;11;14;0;0;0
96;06.02.2017;2017;02;06;Maanantai;38;22;60;19;5;24
96;06.02.2017;2017;02;07;Maanantai;107;59;166;44;21;65
96;06.02.2017;2017;02;08;Maanantai;99;68;167;20;24;44
96;06.02.2017;2017;02;09;Maanantai;47;39;86;29;15;44
96;06.02.2017;2017;02;10;Maanantai;44;44;88;13;18;31
96;06.02.2017;2017;02;11;Maanantai;43;30;73;17;17;34
96;06.02.2017;2017;02;12;Maanantai;59;34;93;19;18;37
96;06.02.2017;2017;02;13;Maanantai;38;60;98;10;18;28
96;06.02.2017;2017;02;14;Maanantai;44;93;137;4;29;33
96;06.02.2017;2017;02;15;Maanantai;67;150;217;10;45;55
96;06.02.2017;2017;02;16;Maanantai;79;103;182;16;47;63
96;06.02.2017;2017;02;17;Maanantai;53;54;107;14;25;39
96;06.02.2017;2017;02;18;Maanantai;44;27;71;18;23;41
96;06.02.2017;2017;02;19;Maanantai;39;17;56;12;20;32
96;06.02.2017;2017;02;20;Maanantai;21;18;39;4;7;11
96;06.02.2017;2017;02;21;Maanantai;19;17;36;8;10;18
96;06.02.2017;2017;02;22;Maanantai;6;7;13;0;1;1
96;06.02.2017;2017;02;23;Maanantai;9;1;10;0;0;0
96;07.02.2017;2017;02;00;Tiistai;0;0;0;0;0;0
96;07.02.2017;2017;02;01;Tiistai;1;0;1;0;0;0
96;07.02.2017;2017;02;02;Tiistai;0;0;0;0;0;0
96;07.02.2017;2017;02;03;Tiistai;0;0;0;0;0;0
96;07.02.2017;2017;02;04;Tiistai;1;0;1;0;0;0
96;07.02.2017;2017;02;05;Tiistai;4;6;10;1;3;4
96;07.02.2017;2017;02;06;Tiistai;41;19;60;22;3;25
96;07.02.2017;2017;02;07;Tiistai;104;63;167;38;13;51
96;07.02.2017;2017;02;08;Tiistai;89;50;139;39;32;71
96;07.02.2017;2017;02;09;Tiistai;76;40;116;17;13;30
96;07.02.2017;2017;02;10;Tiistai;37;32;69;10;15;25
96;07.02.2017;2017;02;11;Tiistai;48;33;81;21;14;35
96;07.02.2017;2017;02;12;Tiistai;50;39;89;30;24;54
96;07.02.2017;2017;02;13;Tiistai;42;68;110;15;29;44
96;07.02.2017;2017;02;14;Tiistai;24;96;120;11;27;38
96;07.02.2017;2017;02;15;Tiistai;61;159;220;10;45;55
96;07.02.2017;2017;02;16;Tiistai;64;105;169;16;28;44
96;07.02.2017;2017;02;17;Tiistai;45;47;92;16;14;30
96;07.02.2017;2017;02;18;Tiistai;44;28;72;22;23;45
96;07.02.2017;2017;02;19;Tiistai;32;16;48;11;18;29
96;07.02.2017;2017;02;20;Tiistai;26;19;45;10;12;22
96;07.02.2017;2017;02;21;Tiistai;13;24;37;2;4;6
96;07.02.2017;2017;02;22;Tiistai;4;10;14;1;1;2
96;07.02.2017;2017;02;23;Tiistai;7;1;8;1;1;2
96;08.02.2017;2017;02;00;Keskiviikko;2;0;2;1;0;1
96;08.02.2017;2017;02;01;Keskiviikko;2;0;2;0;0;0
96;08.02.2017;2017;02;02;Keskiviikko;0;0;0;0;0;0
96;08.02.2017;2017;02;03;Keskiviikko;1;0;1;0;1;1
96;08.02.2017;2017;02;04;Keskiviikko;1;0;1;0;0;0
96;08.02.2017;2017;02;05;Keskiviikko;6;5;11;0;3;3
96;08.02.2017;2017;02;06;Keskiviikko;35;14;49;18;3;21
96;08.02.2017;2017;02;07;Keskiviikko;90;62;152;36;12;48
96;08.02.2017;2017;02;08;Keskiviikko;93;52;145;22;6;28
96;08.02.2017;2017;02;09;Keskiviikko;42;23;65;9;12;21
96;08.02.2017;2017;02;10;Keskiviikko;32;23;55;7;9;16
96;08.02.2017;2017;02;11;Keskiviikko;51;26;77;17;24;41
96;08.02.2017;2017;02;12;Keskiviikko;44;35;79;27;34;61
96;08.02.2017;2017;02;13;Keskiviikko;38;57;95;18;25;43
96;08.02.2017;2017;02;14;Keskiviikko;26;105;131;5;43;48
96;08.02.2017;2017;02;15;Keskiviikko;47;104;151;14;44;58
96;08.02.2017;2017;02;16;Keskiviikko;57;89;146;16;31;47
96;08.02.2017;2017;02;17;Keskiviikko;41;30;71;8;18;26
96;08.02.2017;2017;02;18;Keskiviikko;51;24;75;16;12;28
96;08.02.2017;2017;02;19;Keskiviikko;38;15;53;8;16;24
96;08.02.2017;2017;02;20;Keskiviikko;14;17;31;4;8;12
96;08.02.2017;2017;02;21;Keskiviikko;12;43;55;4;13;17
96;08.02.2017;2017;02;22;Keskiviikko;3;8;11;1;2;3
96;08.02.2017;2017;02;23;Keskiviikko;3;4;7;0;0;0
96;09.02.2017;2017;02;00;Torstai;1;0;1;0;0;0
96;09.02.2017;2017;02;01;Torstai;5;0;5;0;0;0
96;09.02.2017;2017;02;02;Torstai;1;0;1;1;0;1
96;09.02.2017;2017;02;03;Torstai;0;0;0;0;0;0
96;09.02.2017;2017;02;04;Torstai;3;0;3;0;2;2
96;09.02.2017;2017;02;05;Torstai;5;6;11;1;0;1
96;09.02.2017;2017;02;06;Torstai;37;7;44;14;5;19
96;09.02.2017;2017;02;07;Torstai;85;50;135;39;11;50
96;09.02.2017;2017;02;08;Torstai;80;42;122;16;10;26
96;09.02.2017;2017;02;09;Torstai;58;36;94;19;9;28
96;09.02.2017;2017;02;10;Torstai;40;35;75;6;13;19
96;09.02.2017;2017;02;11;Torstai;37;24;61;11;12;23
96;09.02.2017;2017;02;12;Torstai;40;49;89;24;13;37
96;09.02.2017;2017;02;13;Torstai;41;60;101;11;24;35
96;09.02.2017;2017;02;14;Torstai;43;90;133;14;40;54
96;09.02.2017;2017;02;15;Torstai;38;103;141;10;47;57
96;09.02.2017;2017;02;16;Torstai;47;84;131;9;36;45
96;09.02.2017;2017;02;17;Torstai;33;35;68;11;12;23
96;09.02.2017;2017;02;18;Torstai;32;17;49;17;14;31
96;09.02.2017;2017;02;19;Torstai;26;22;48;13;12;25
96;09.02.2017;2017;02;20;Torstai;25;21;46;9;6;15
96;09.02.2017;2017;02;21;Torstai;14;18;32;3;9;12
96;09.02.2017;2017;02;22;Torstai;3;1;4;0;2;2
96;09.02.2017;2017;02;23;Torstai;1;4;5;2;0;2
96;10.02.2017;2017;02;00;Perjantai;1;0;1;2;0;2
96;10.02.2017;2017;02;01;Perjantai;2;1;3;0;0;0
96;10.02.2017;2017;02;02;Perjantai;0;0;0;0;0;0
96;10.02.2017;2017;02;03;Perjantai;5;0;5;0;0;0
96;10.02.2017;2017;02;04;Perjantai;2;3;5;1;1;2
96;10.02.2017;2017;02;05;Perjantai;5;5;10;0;0;0
96;10.02.2017;2017;02;06;Perjantai;39;20;59;21;2;23
96;10.02.2017;2017;02;07;Perjantai;90;66;156;33;12;45
96;10.02.2017;2017;02;08;Perjantai;81;47;128;22;10;32
96;10.02.2017;2017;02;09;Perjantai;37;29;66;13;13;26
96;10.02.2017;2017;02;10;Perjantai;33;51;84;6;11;17
96;10.02.2017;2017;02;11;Perjantai;44;47;91;13;15;28
96;10.02.2017;2017;02;12;Perjantai;53;57;110;16;22;38
96;10.02.2017;2017;02;13;Perjantai;38;97;135;13;23;36
96;10.02.2017;2017;02;14;Perjantai;42;136;178;14;48;62
96;10.02.2017;2017;02;15;Perjantai;58;90;148;10;41;51
96;10.02.2017;2017;02;16;Perjantai;50;49;99;10;29;39
96;10.02.2017;2017;02;17;Perjantai;29;47;76;12;17;29
96;10.02.2017;2017;02;18;Perjantai;26;36;62;11;11;22
96;10.02.2017;2017;02;19;Perjantai;16;19;35;5;7;12
96;10.02.2017;2017;02;20;Perjantai;38;11;49;13;9;22
96;10.02.2017;2017;02;21;Perjantai;14;24;38;4;8;12
96;10.02.2017;2017;02;22;Perjantai;7;7;14;1;2;3
96;10.02.2017;2017;02;23;Perjantai;8;2;10;2;1;3
96;11.02.2017;2017;02;00;Lauantai;5;2;7;1;0;1
96;11.02.2017;2017;02;01;Lauantai;4;1;5;1;0;1
96;11.02.2017;2017;02;02;Lauantai;3;0;3;2;0;2
96;11.02.2017;2017;02;03;Lauantai;7;1;8;1;0;1
96;11.02.2017;2017;02;04;Lauantai;3;1;4;3;4;7
96;11.02.2017;2017;02;05;Lauantai;4;4;8;1;1;2
96;11.02.2017;2017;02;06;Lauantai;9;3;12;8;0;8
96;11.02.2017;2017;02;07;Lauantai;4;11;15;1;5;6
96;11.02.2017;2017;02;08;Lauantai;3;7;10;5;5;10
96;11.02.2017;2017;02;09;Lauantai;7;15;22;9;7;16
96;11.02.2017;2017;02;10;Lauantai;18;26;44;12;13;25
96;11.02.2017;2017;02;11;Lauantai;15;20;35;9;19;28
96;11.02.2017;2017;02;12;Lauantai;20;30;50;11;11;22
96;11.02.2017;2017;02;13;Lauantai;32;26;58;15;8;23
96;11.02.2017;2017;02;14;Lauantai;27;28;55;13;13;26
96;11.02.2017;2017;02;15;Lauantai;39;26;65;14;12;26
96;11.02.2017;2017;02;16;Lauantai;25;20;45;2;6;8
96;11.02.2017;2017;02;17;Lauantai;18;17;35;9;11;20
96;11.02.2017;2017;02;18;Lauantai;23;15;38;15;3;18
96;11.02.2017;2017;02;19;Lauantai;15;12;27;8;6;14
96;11.02.2017;2017;02;20;Lauantai;16;15;31;7;8;15
96;11.02.2017;2017;02;21;Lauantai;4;17;21;2;4;6
96;11.02.2017;2017;02;22;Lauantai;5;5;10;1;1;2
96;11.02.2017;2017;02;23;Lauantai;3;2;5;1;0;1
96;12.02.2017;2017;02;00;Sunnuntai;1;1;2;0;0;0
96;12.02.2017;2017;02;01;Sunnuntai;0;2;2;0;0;0
96;12.02.2017;2017;02;02;Sunnuntai;1;0;1;0;0;0
96;12.02.2017;2017;02;03;Sunnuntai;6;0;6;2;0;2
96;12.02.2017;2017;02;04;Sunnuntai;2;2;4;0;0;0
96;12.02.2017;2017;02;05;Sunnuntai;3;1;4;0;0;0
96;12.02.2017;2017;02;06;Sunnuntai;9;3;12;9;6;15
96;12.02.2017;2017;02;07;Sunnuntai;3;8;11;1;4;5
96;12.02.2017;2017;02;08;Sunnuntai;1;5;6;2;3;5
96;12.02.2017;2017;02;09;Sunnuntai;6;10;16;7;3;10
96;12.02.2017;2017;02;10;Sunnuntai;4;14;18;9;11;20
96;12.02.2017;2017;02;11;Sunnuntai;10;10;20;11;7;18
96;12.02.2017;2017;02;12;Sunnuntai;21;13;34;19;11;30
96;12.02.2017;2017;02;13;Sunnuntai;22;18;40;9;12;21
96;12.02.2017;2017;02;14;Sunnuntai;18;23;41;9;14;23
96;12.02.2017;2017;02;15;Sunnuntai;12;16;28;13;20;33
96;12.02.2017;2017;02;16;Sunnuntai;20;15;35;26;7;33
96;12.02.2017;2017;02;17;Sunnuntai;12;16;28;7;12;19
96;12.02.2017;2017;02;18;Sunnuntai;16;19;35;23;14;37
96;12.02.2017;2017;02;19;Sunnuntai;11;13;24;7;14;21
96;12.02.2017;2017;02;20;Sunnuntai;8;11;19;3;9;12
96;12.02.2017;2017;02;21;Sunnuntai;8;12;20;7;3;10
96;12.02.2017;2017;02;22;Sunnuntai;2;5;7;3;1;4
96;12.02.2017;2017;02;23;Sunnuntai;7;2;9;1;1;2
96;13.02.2017;2017;02;00;Maanantai;3;1;4;0;0;0
96;13.02.2017;2017;02;01;Maanantai;1;0;1;0;0;0
96;13.02.2017;2017;02;02;Maanantai;1;0;1;0;0;0
96;13.02.2017;2017;02;03;Maanantai;2;0;2;0;0;0
96;13.02.2017;2017;02;04;Maanantai;2;0;2;1;0;1
96;13.02.2017;2017;02;05;Maanantai;1;8;9;3;1;4
96;13.02.2017;2017;02;06;Maanantai;36;20;56;15;4;19
96;13.02.2017;2017;02;07;Maanantai;86;78;164;40;9;49
96;13.02.2017;2017;02;08;Maanantai;88;82;170;16;17;33
96;13.02.2017;2017;02;09;Maanantai;81;53;134;34;9;43
96;13.02.2017;2017;02;10;Maanantai;54;34;88;11;25;36
96;13.02.2017;2017;02;11;Maanantai;51;39;90;21;13;34
96;13.02.2017;2017;02;12;Maanantai;59;48;107;15;9;24
96;13.02.2017;2017;02;13;Maanantai;42;43;85;16;29;45
96;13.02.2017;2017;02;14;Maanantai;50;91;141;16;32;48
96;13.02.2017;2017;02;15;Maanantai;53;141;194;14;32;46
96;13.02.2017;2017;02;16;Maanantai;80;113;193;18;43;61
96;13.02.2017;2017;02;17;Maanantai;51;53;104;19;20;39
96;13.02.2017;2017;02;18;Maanantai;30;43;73;13;16;29
96;13.02.2017;2017;02;19;Maanantai;29;39;68;13;19;32
96;13.02.2017;2017;02;20;Maanantai;25;16;41;10;8;18
96;13.02.2017;2017;02;21;Maanantai;13;23;36;3;8;11
96;13.02.2017;2017;02;22;Maanantai;6;5;11;4;0;4
96;13.02.2017;2017;02;23;Maanantai;3;0;3;2;1;3
96;14.02.2017;2017;02;00;Tiistai;2;0;2;0;0;0
96;14.02.2017;2017;02;01;Tiistai;0;0;0;0;0;0
96;14.02.2017;2017;02;02;Tiistai;2;0;2;0;0;0
96;14.02.2017;2017;02;03;Tiistai;1;0;1;0;0;0
96;14.02.2017;2017;02;04;Tiistai;2;1;3;0;0;0
96;14.02.2017;2017;02;05;Tiistai;5;8;13;2;0;2
96;14.02.2017;2017;02;06;Tiistai;44;20;64;21;2;23
96;14.02.2017;2017;02;07;Tiistai;81;84;165;46;15;61
96;14.02.2017;2017;02;08;Tiistai;89;73;162;16;7;23
96;14.02.2017;2017;02;09;Tiistai;94;60;154;14;13;27
96;14.02.2017;2017;02;10;Tiistai;38;44;82;15;24;39
96;14.02.2017;2017;02;11;Tiistai;49;41;90;13;13;26
96;14.02.2017;2017;02;12;Tiistai;59;48;107;23;12;35
96;14.02.2017;2017;02;13;Tiistai;44;57;101;15;24;39
96;14.02.2017;2017;02;14;Tiistai;44;73;117;15;14;29
96;14.02.2017;2017;02;15;Tiistai;68;158;226;13;51;64
96;14.02.2017;2017;02;16;Tiistai;68;93;161;9;37;46
96;14.02.2017;2017;02;17;Tiistai;34;46;80;12;15;27
96;14.02.2017;2017;02;18;Tiistai;44;24;68;17;28;45
96;14.02.2017;2017;02;19;Tiistai;42;26;68;14;26;40
96;14.02.2017;2017;02;20;Tiistai;25;10;35;7;8;15
96;14.02.2017;2017;02;21;Tiistai;26;29;55;4;7;11
96;14.02.2017;2017;02;22;Tiistai;5;7;12;0;1;1
96;14.02.2017;2017;02;23;Tiistai;2;1;3;1;0;1
96;15.02.2017;2017;02;00;Keskiviikko;4;0;4;0;0;0
96;15.02.2017;2017;02;01;Keskiviikko;4;2;6;0;0;0
96;15.02.2017;2017;02;02;Keskiviikko;1;1;2;0;1;1
96;15.02.2017;2017;02;03;Keskiviikko;2;0;2;0;0;0
96;15.02.2017;2017;02;04;Keskiviikko;3;1;4;0;0;0
96;15.02.2017;2017;02;05;Keskiviikko;4;3;7;2;0;2
96;15.02.2017;2017;02;06;Keskiviikko;29;20;49;16;4;20
96;15.02.2017;2017;02;07;Keskiviikko;87;84;171;33;12;45
96;15.02.2017;2017;02;08;Keskiviikko;89;62;151;18;7;25
96;15.02.2017;2017;02;09;Keskiviikko;88;36;124;19;12;31
96;15.02.2017;2017;02;10;Keskiviikko;35;43;78;12;11;23
96;15.02.2017;2017;02;11;Keskiviikko;44;37;81;14;27;41
96;15.02.2017;2017;02;12;Keskiviikko;61;92;153;13;40;53
96;15.02.2017;2017;02;13;Keskiviikko;50;61;111;13;15;28
96;15.02.2017;2017;02;14;Keskiviikko;38;85;123;11;28;39
96;15.02.2017;2017;02;15;Keskiviikko;60;146;206;11;41;52
96;15.02.2017;2017;02;16;Keskiviikko;85;83;168;17;30;47
96;15.02.2017;2017;02;17;Keskiviikko;61;39;100;19;14;33
96;15.02.2017;2017;02;18;Keskiviikko;50;35;85;18;20;38
96;15.02.2017;2017;02;19;Keskiviikko;37;20;57;12;7;19
96;15.02.2017;2017;02;20;Keskiviikko;30;20;50;6;17;23
96;15.02.2017;2017;02;21;Keskiviikko;19;43;62;3;10;13
96;15.02.2017;2017;02;22;Keskiviikko;13;5;18;2;2;4
96;15.02.2017;2017;02;23;Keskiviikko;1;3;4;14;4;18
96;16.02.2017;2017;02;00;Torstai;0;2;2;0;0;0
96;16.02.2017;2017;02;01;Torstai;0;0;0;0;1;1
96;16.02.2017;2017;02;02;Torstai;1;0;1;0;0;0
96;16.02.2017;2017;02;03;Torstai;3;1;4;0;0;0
96;16.02.2017;2017;02;04;Torstai;3;0;3;0;0;0
96;16.02.2017;2017;02;05;Torstai;6;8;14;0;1;1
96;16.02.2017;2017;02;06;Torstai;31;19;50;12;2;14
96;16.02.2017;2017;02;07;Torstai;107;70;177;34;11;45
96;16.02.2017;2017;02;08;Torstai;96;63;159;23;28;51
96;16.02.2017;2017;02;09;Torstai;73;36;109;13;9;22
96;16.02.2017;2017;02;10;Torstai;46;43;89;20;12;32
96;16.02.2017;2017;02;11;Torstai;40;36;76;15;19;34
96;16.02.2017;2017;02;12;Torstai;60;78;138;17;18;35
96;16.02.2017;2017;02;13;Torstai;44;82;126;13;14;27
96;16.02.2017;2017;02;14;Torstai;56;118;174;10;27;37
96;16.02.2017;2017;02;15;Torstai;66;119;185;13;39;52
96;16.02.2017;2017;02;16;Torstai;58;91;149;13;37;50
96;16.02.2017;2017;02;17;Torstai;34;50;84;13;15;28
96;16.02.2017;2017;02;18;Torstai;55;25;80;16;23;39
96;16.02.2017;2017;02;19;Torstai;25;29;54;15;13;28
96;16.02.2017;2017;02;20;Torstai;33;18;51;8;11;19
96;16.02.2017;2017;02;21;Torstai;14;26;40;7;9;16
96;16.02.2017;2017;02;22;Torstai;8;12;20;3;4;7
96;16.02.2017;2017;02;23;Torstai;7;1;8;0;1;1
96;17.02.2017;2017;02;00;Perjantai;3;2;5;1;0;1
96;17.02.2017;2017;02;01;Perjantai;1;0;1;0;0;0
96;17.02.2017;2017;02;02;Perjantai;6;1;7;0;0;0
96;17.02.2017;2017;02;03;Perjantai;4;0;4;1;0;1
96;17.02.2017;2017;02;04;Perjantai;6;0;6;0;0;0
96;17.02.2017;2017;02;05;Perjantai;8;4;12;3;0;3
96;17.02.2017;2017;02;06;Perjantai;38;19;57;17;3;20
96;17.02.2017;2017;02;07;Perjantai;94;49;143;34;14;48
96;17.02.2017;2017;02;08;Perjantai;68;63;131;13;36;49
96;17.02.2017;2017;02;09;Perjantai;44;36;80;16;13;29
96;17.02.2017;2017;02;10;Perjantai;38;35;73;17;14;31
96;17.02.2017;2017;02;11;Perjantai;28;38;66;28;17;45
96;17.02.2017;2017;02;12;Perjantai;45;53;98;6;14;20
96;17.02.2017;2017;02;13;Perjantai;38;89;127;8;31;39
96;17.02.2017;2017;02;14;Perjantai;42;137;179;10;125;135
96;17.02.2017;2017;02;15;Perjantai;74;83;157;20;46;66
96;17.02.2017;2017;02;16;Perjantai;96;59;155;78;21;99
96;17.02.2017;2017;02;17;Perjantai;39;30;69;13;17;30
96;17.02.2017;2017;02;18;Perjantai;28;26;54;9;14;23
96;17.02.2017;2017;02;19;Perjantai;12;15;27;6;13;19
96;17.02.2017;2017;02;20;Perjantai;21;12;33;7;2;9
96;17.02.2017;2017;02;21;Perjantai;13;19;32;1;5;6
96;17.02.2017;2017;02;22;Perjantai;6;7;13;1;0;1
96;17.02.2017;2017;02;23;Perjantai;10;2;12;4;1;5
96;18.02.2017;2017;02;00;Lauantai;2;2;4;1;0;1
96;18.02.2017;2017;02;01;Lauantai;6;0;6;0;0;0
96;18.02.2017;2017;02;02;Lauantai;2;3;5;1;0;1
96;18.02.2017;2017;02;03;Lauantai;10;0;10;2;0;2
96;18.02.2017;2017;02;04;Lauantai;7;4;11;1;1;2
96;18.02.2017;2017;02;05;Lauantai;0;3;3;2;0;2
96;18.02.2017;2017;02;06;Lauantai;17;4;21;4;0;4
96;18.02.2017;2017;02;07;Lauantai;4;12;16;1;6;7
96;18.02.2017;2017;02;08;Lauantai;2;9;11;4;1;5
96;18.02.2017;2017;02;09;Lauantai;6;24;30;5;11;16
96;18.02.2017;2017;02;10;Lauantai;17;13;30;12;12;24
96;18.02.2017;2017;02;11;Lauantai;20;22;42;14;19;33
96;18.02.2017;2017;02;12;Lauantai;30;34;64;9;14;23
96;18.02.2017;2017;02;13;Lauantai;29;38;67;21;20;41
96;18.02.2017;2017;02;14;Lauantai;28;28;56;14;18;32
96;18.02.2017;2017;02;15;Lauantai;25;25;50;19;12;31
96;18.02.2017;2017;02;16;Lauantai;25;32;57;8;15;23
96;18.02.2017;2017;02;17;Lauantai;15;14;29;6;6;12
96;18.02.2017;2017;02;18;Lauantai;25;9;34;14;8;22
96;18.02.2017;2017;02;19;Lauantai;25;16;41;11;16;27
96;18.02.2017;2017;02;20;Lauantai;10;14;24;4;8;12
96;18.02.2017;2017;02;21;Lauantai;11;20;31;5;6;11
96;18.02.2017;2017;02;22;Lauantai;3;3;6;1;0;1
96;18.02.2017;2017;02;23;Lauantai;3;4;7;0;0;0
96;19.02.2017;2017;02;00;Sunnuntai;3;1;4;4;1;5
96;19.02.2017;2017;02;01;Sunnuntai;0;2;2;1;2;3
96;19.02.2017;2017;02;02;Sunnuntai;7;0;7;2;4;6
96;19.02.2017;2017;02;03;Sunnuntai;5;0;5;2;1;3
96;19.02.2017;2017;02;04;Sunnuntai;9;1;10;3;0;3
96;19.02.2017;2017;02;05;Sunnuntai;1;1;2;1;0;1
96;19.02.2017;2017;02;06;Sunnuntai;12;2;14;7;0;7
96;19.02.2017;2017;02;07;Sunnuntai;3;10;13;1;1;2
96;19.02.2017;2017;02;08;Sunnuntai;6;5;11;3;3;6
96;19.02.2017;2017;02;09;Sunnuntai;3;6;9;3;9;12
96;19.02.2017;2017;02;10;Sunnuntai;4;11;15;8;14;22
96;19.02.2017;2017;02;11;Sunnuntai;10;14;24;10;14;24
96;19.02.2017;2017;02;12;Sunnuntai;20;16;36;13;6;19
96;19.02.2017;2017;02;13;Sunnuntai;16;25;41;17;24;41
96;19.02.2017;2017;02;14;Sunnuntai;20;21;41;13;17;30
96;19.02.2017;2017;02;15;Sunnuntai;29;26;55;16;14;30
96;19.02.2017;2017;02;16;Sunnuntai;33;12;45;19;10;29
96;19.02.2017;2017;02;17;Sunnuntai;18;18;36;15;9;24
96;19.02.2017;2017;02;18;Sunnuntai;19;16;35;11;17;28
96;19.02.2017;2017;02;19;Sunnuntai;10;14;24;5;12;17
96;19.02.2017;2017;02;20;Sunnuntai;12;14;26;7;6;13
96;19.02.2017;2017;02;21;Sunnuntai;15;18;33;6;5;11
96;19.02.2017;2017;02;22;Sunnuntai;1;2;3;1;1;2
96;19.02.2017;2017;02;23;Sunnuntai;7;1;8;0;0;0
96;20.02.2017;2017;02;00;Maanantai;1;2;3;0;0;0
96;20.02.2017;2017;02;01;Maanantai;0;0;0;1;0;1
96;20.02.2017;2017;02;02;Maanantai;0;0;0;0;1;1
96;20.02.2017;2017;02;03;Maanantai;0;0;0;0;0;0
96;20.02.2017;2017;02;04;Maanantai;1;0;1;0;1;1
96;20.02.2017;2017;02;05;Maanantai;4;3;7;0;1;1
96;20.02.2017;2017;02;06;Maanantai;33;17;50;19;6;25
96;20.02.2017;2017;02;07;Maanantai;95;60;155;44;10;54
96;20.02.2017;2017;02;08;Maanantai;91;64;155;15;16;31
96;20.02.2017;2017;02;09;Maanantai;70;33;103;24;18;42
96;20.02.2017;2017;02;10;Maanantai;42;32;74;10;20;30
96;20.02.2017;2017;02;11;Maanantai;32;44;76;19;27;46
96;20.02.2017;2017;02;12;Maanantai;60;37;97;16;14;30
96;20.02.2017;2017;02;13;Maanantai;51;57;108;15;19;34
96;20.02.2017;2017;02;14;Maanantai;35;75;110;14;27;41
96;20.02.2017;2017;02;15;Maanantai;53;141;194;16;35;51
96;20.02.2017;2017;02;16;Maanantai;63;93;156;19;39;58
96;20.02.2017;2017;02;17;Maanantai;43;55;98;24;22;46
96;20.02.2017;2017;02;18;Maanantai;49;32;81;16;21;37
96;20.02.2017;2017;02;19;Maanantai;44;26;70;20;13;33
96;20.02.2017;2017;02;20;Maanantai;21;16;37;12;10;22
96;20.02.2017;2017;02;21;Maanantai;10;25;35;7;10;17
96;20.02.2017;2017;02;22;Maanantai;6;7;13;3;1;4
96;20.02.2017;2017;02;23;Maanantai;3;0;3;0;1;1
96;21.02.2017;2017;02;00;Tiistai;0;0;0;0;1;1
96;21.02.2017;2017;02;01;Tiistai;0;0;0;0;0;0
96;21.02.2017;2017;02;02;Tiistai;0;0;0;0;0;0
96;21.02.2017;2017;02;03;Tiistai;0;0;0;0;1;1
96;21.02.2017;2017;02;04;Tiistai;1;0;1;1;0;1
96;21.02.2017;2017;02;05;Tiistai;2;2;4;1;4;5
96;21.02.2017;2017;02;06;Tiistai;45;20;65;20;3;23
96;21.02.2017;2017;02;07;Tiistai;106;75;181;44;15;59
96;21.02.2017;2017;02;08;Tiistai;80;65;145;16;5;21
96;21.02.2017;2017;02;09;Tiistai;87;42;129;20;19;39
96;21.02.2017;2017;02;10;Tiistai;45;37;82;14;26;40
96;21.02.2017;2017;02;11;Tiistai;41;28;69;17;22;39
96;21.02.2017;2017;02;12;Tiistai;53;52;105;18;18;36
96;21.02.2017;2017;02;13;Tiistai;40;77;117;19;23;42
96;21.02.2017;2017;02;14;Tiistai;44;84;128;11;26;37
96;21.02.2017;2017;02;15;Tiistai;55;154;209;10;50;60
96;21.02.2017;2017;02;16;Tiistai;71;105;176;17;44;61
96;21.02.2017;2017;02;17;Tiistai;45;48;93;25;19;44
96;21.02.2017;2017;02;18;Tiistai;38;24;62;20;24;44
96;21.02.2017;2017;02;19;Tiistai;41;16;57;11;10;21
96;21.02.2017;2017;02;20;Tiistai;36;10;46;8;7;15
96;21.02.2017;2017;02;21;Tiistai;17;28;45;11;10;21
96;21.02.2017;2017;02;22;Tiistai;2;6;8;1;1;2
96;21.02.2017;2017;02;23;Tiistai;2;3;5;0;0;0
96;22.02.2017;2017;02;00;Keskiviikko;1;0;1;0;0;0
96;22.02.2017;2017;02;01;Keskiviikko;1;0;1;0;1;1
96;22.02.2017;2017;02;02;Keskiviikko;2;0;2;0;0;0
96;22.02.2017;2017;02;03;Keskiviikko;0;0;0;0;0;0
96;22.02.2017;2017;02;04;Keskiviikko;1;0;1;0;0;0
96;22.02.2017;2017;02;05;Keskiviikko;1;4;5;1;2;3
96;22.02.2017;2017;02;06;Keskiviikko;38;14;52;18;1;19
96;22.02.2017;2017;02;07;Keskiviikko;99;83;182;32;11;43
96;22.02.2017;2017;02;08;Keskiviikko;80;60;140;22;16;38
96;22.02.2017;2017;02;09;Keskiviikko;48;46;94;19;12;31
96;22.02.2017;2017;02;10;Keskiviikko;34;31;65;13;17;30
96;22.02.2017;2017;02;11;Keskiviikko;52;38;90;15;15;30
96;22.02.2017;2017;02;12;Keskiviikko;61;41;102;24;23;47
96;22.02.2017;2017;02;13;Keskiviikko;45;75;120;11;38;49
96;22.02.2017;2017;02;14;Keskiviikko;36;115;151;9;28;37
96;22.02.2017;2017;02;15;Keskiviikko;42;154;196;13;44;57
96;22.02.2017;2017;02;16;Keskiviikko;71;106;177;10;40;50
96;22.02.2017;2017;02;17;Keskiviikko;54;38;92;12;17;29
96;22.02.2017;2017;02;18;Keskiviikko;56;31;87;33;15;48
96;22.02.2017;2017;02;19;Keskiviikko;28;22;50;7;12;19
96;22.02.2017;2017;02;20;Keskiviikko;27;33;60;6;15;21
96;22.02.2017;2017;02;21;Keskiviikko;17;39;56;4;12;16
96;22.02.2017;2017;02;22;Keskiviikko;10;4;14;0;0;0
96;22.02.2017;2017;02;23;Keskiviikko;1;1;2;1;1;2
96;23.02.2017;2017;02;00;Torstai;0;1;1;1;0;1
96;23.02.2017;2017;02;01;Torstai;0;0;0;0;0;0
96;23.02.2017;2017;02;02;Torstai;0;0;0;0;0;0
96;23.02.2017;2017;02;03;Torstai;1;0;1;0;0;0
96;23.02.2017;2017;02;04;Torstai;1;0;1;0;0;0
96;23.02.2017;2017;02;05;Torstai;6;2;8;0;1;1
96;23.02.2017;2017;02;06;Torstai;42;20;62;17;3;20
96;23.02.2017;2017;02;07;Torstai;83;64;147;43;15;58
96;23.02.2017;2017;02;08;Torstai;71;54;125;18;10;28
96;23.02.2017;2017;02;09;Torstai;55;37;92;15;12;27
96;23.02.2017;2017;02;10;Torstai;41;50;91;15;31;46
96;23.02.2017;2017;02;11;Torstai;35;39;74;14;13;27
96;23.02.2017;2017;02;12;Torstai;33;42;75;31;9;40
96;23.02.2017;2017;02;13;Torstai;39;63;102;9;21;30
96;23.02.2017;2017;02;14;Torstai;35;104;139;8;25;33
96;23.02.2017;2017;02;15;Torstai;53;125;178;8;23;31
96;23.02.2017;2017;02;16;Torstai;72;96;168;9;31;40
96;23.02.2017;2017;02;17;Torstai;31;43;74;12;13;25
96;23.02.2017;2017;02;18;Torstai;41;32;73;14;15;29
96;23.02.2017;2017;02;19;Torstai;32;18;50;15;9;24
96;23.02.2017;2017;02;20;Torstai;16;24;40;7;4;11
96;23.02.2017;2017;02;21;Torstai;12;35;47;4;6;10
96;23.02.2017;2017;02;22;Torstai;7;4;11;2;1;3
96;23.02.2017;2017;02;23;Torstai;7;1;8;0;0;0
96;24.02.2017;2017;02;00;Perjantai;0;0;0;1;0;1
96;24.02.2017;2017;02;01;Perjantai;2;0;2;0;0;0
96;24.02.2017;2017;02;02;Perjantai;2;2;4;0;0;0
96;24.02.2017;2017;02;03;Perjantai;0;0;0;0;0;0
96;24.02.2017;2017;02;04;Perjantai;2;1;3;0;1;1
96;24.02.2017;2017;02;05;Perjantai;3;3;6;4;5;9
96;24.02.2017;2017;02;06;Perjantai;30;17;47;18;3;21
96;24.02.2017;2017;02;07;Perjantai;95;62;157;28;11;39
96;24.02.2017;2017;02;08;Perjantai;58;76;134;23;10;33
96;24.02.2017;2017;02;09;Perjantai;43;41;84;9;15;24
96;24.02.2017;2017;02;10;Perjantai;34;37;71;7;12;19
96;24.02.2017;2017;02;11;Perjantai;33;46;79;13;20;33
96;24.02.2017;2017;02;12;Perjantai;46;55;101;17;20;37
96;24.02.2017;2017;02;13;Perjantai;38;64;102;5;19;24
96;24.02.2017;2017;02;14;Perjantai;42;123;165;13;33;46
96;24.02.2017;2017;02;15;Perjantai;61;96;157;14;31;45
96;24.02.2017;2017;02;16;Perjantai;63;44;107;27;19;46
96;24.02.2017;2017;02;17;Perjantai;40;42;82;17;22;39
96;24.02.2017;2017;02;18;Perjantai;35;24;59;10;21;31
96;24.02.2017;2017;02;19;Perjantai;24;19;43;15;11;26
96;24.02.2017;2017;02;20;Perjantai;24;12;36;22;8;30
96;24.02.2017;2017;02;21;Perjantai;22;50;72;3;9;12
96;24.02.2017;2017;02;22;Perjantai;9;4;13;2;1;3
96;24.02.2017;2017;02;23;Perjantai;10;4;14;1;2;3
96;25.02.2017;2017;02;00;Lauantai;4;3;7;3;2;5
96;25.02.2017;2017;02;01;Lauantai;3;1;4;0;0;0
96;25.02.2017;2017;02;02;Lauantai;1;1;2;0;0;0
96;25.02.2017;2017;02;03;Lauantai;0;1;1;0;0;0
96;25.02.2017;2017;02;04;Lauantai;5;2;7;0;1;1
96;25.02.2017;2017;02;05;Lauantai;0;1;1;1;4;5
96;25.02.2017;2017;02;06;Lauantai;15;4;19;6;7;13
96;25.02.2017;2017;02;07;Lauantai;2;10;12;2;5;7
96;25.02.2017;2017;02;08;Lauantai;1;12;13;4;4;8
96;25.02.2017;2017;02;09;Lauantai;5;21;26;9;4;13
96;25.02.2017;2017;02;10;Lauantai;14;15;29;18;35;53
96;25.02.2017;2017;02;11;Lauantai;21;22;43;24;46;70
96;25.02.2017;2017;02;12;Lauantai;23;29;52;23;50;73
96;25.02.2017;2017;02;13;Lauantai;26;35;61;44;77;121
96;25.02.2017;2017;02;14;Lauantai;36;23;59;42;63;105
96;25.02.2017;2017;02;15;Lauantai;37;28;65;47;44;91
96;25.02.2017;2017;02;16;Lauantai;38;19;57;38;36;74
96;25.02.2017;2017;02;17;Lauantai;28;13;41;28;24;52
96;25.02.2017;2017;02;18;Lauantai;14;9;23;15;19;34
96;25.02.2017;2017;02;19;Lauantai;7;9;16;14;14;28
96;25.02.2017;2017;02;20;Lauantai;11;11;22;4;7;11
96;25.02.2017;2017;02;21;Lauantai;6;41;47;33;17;50
96;25.02.2017;2017;02;22;Lauantai;7;9;16;2;7;9
96;25.02.2017;2017;02;23;Lauantai;3;3;6;2;1;3
96;26.02.2017;2017;02;00;Sunnuntai;9;0;9;2;1;3
96;26.02.2017;2017;02;01;Sunnuntai;5;0;5;3;0;3
96;26.02.2017;2017;02;02;Sunnuntai;4;3;7;1;0;1
96;26.02.2017;2017;02;03;Sunnuntai;6;0;6;3;0;3
96;26.02.2017;2017;02;04;Sunnuntai;11;0;11;1;1;2
96;26.02.2017;2017;02;05;Sunnuntai;1;2;3;0;1;1
96;26.02.2017;2017;02;06;Sunnuntai;12;2;14;5;0;5
96;26.02.2017;2017;02;07;Sunnuntai;1;6;7;2;3;5
96;26.02.2017;2017;02;08;Sunnuntai;4;6;10;5;4;9
96;26.02.2017;2017;02;09;Sunnuntai;2;9;11;10;9;19
96;26.02.2017;2017;02;10;Sunnuntai;6;15;21;6;8;14
96;26.02.2017;2017;02;11;Sunnuntai;10;12;22;11;13;24
96;26.02.2017;2017;02;12;Sunnuntai;27;15;42;25;12;37
96;26.02.2017;2017;02;13;Sunnuntai;15;19;34;16;17;33
96;26.02.2017;2017;02;14;Sunnuntai;24;19;43;14;28;42
96;26.02.2017;2017;02;15;Sunnuntai;10;38;48;18;26;44
96;26.02.2017;2017;02;16;Sunnuntai;18;5;23;12;18;30
96;26.02.2017;2017;02;17;Sunnuntai;23;17;40;11;7;18
96;26.02.2017;2017;02;18;Sunnuntai;13;8;21;6;13;19
96;26.02.2017;2017;02;19;Sunnuntai;12;6;18;14;7;21
96;26.02.2017;2017;02;20;Sunnuntai;16;11;27;6;6;12
96;26.02.2017;2017;02;21;Sunnuntai;5;18;23;3;5;8
96;26.02.2017;2017;02;22;Sunnuntai;3;3;6;0;0;0
96;26.02.2017;2017;02;23;Sunnuntai;3;3;6;1;0;1
96;27.02.2017;2017;02;00;Maanantai;0;1;1;0;0;0
96;27.02.2017;2017;02;01;Maanantai;0;0;0;0;0;0
96;27.02.2017;2017;02;02;Maanantai;0;0;0;0;0;0
96;27.02.2017;2017;02;03;Maanantai;2;1;3;0;0;0
96;27.02.2017;2017;02;04;Maanantai;2;1;3;0;1;1
96;27.02.2017;2017;02;05;Maanantai;2;2;4;0;4;4
96;27.02.2017;2017;02;06;Maanantai;35;11;46;14;2;16
96;27.02.2017;2017;02;07;Maanantai;83;50;133;45;11;56
96;27.02.2017;2017;02;08;Maanantai;56;36;92;21;8;29
96;27.02.2017;2017;02;09;Maanantai;67;24;91;20;10;30
96;27.02.2017;2017;02;10;Maanantai;31;26;57;11;10;21
96;27.02.2017;2017;02;11;Maanantai;33;38;71;14;13;27
96;27.02.2017;2017;02;12;Maanantai;52;43;95;19;23;42
96;27.02.2017;2017;02;13;Maanantai;46;48;94;9;17;26
96;27.02.2017;2017;02;14;Maanantai;34;82;116;15;29;44
96;27.02.2017;2017;02;15;Maanantai;42;132;174;16;49;65
96;27.02.2017;2017;02;16;Maanantai;64;88;152;20;40;60
96;27.02.2017;2017;02;17;Maanantai;39;44;83;25;22;47
96;27.02.2017;2017;02;18;Maanantai;29;25;54;20;14;34
96;27.02.2017;2017;02;19;Maanantai;29;36;65;11;24;35
96;27.02.2017;2017;02;20;Maanantai;28;22;50;4;12;16
96;27.02.2017;2017;02;21;Maanantai;15;21;36;3;4;7
96;27.02.2017;2017;02;22;Maanantai;6;2;8;2;1;3
96;27.02.2017;2017;02;23;Maanantai;4;0;4;0;0;0
96;28.02.2017;2017;02;00;Tiistai;1;0;1;0;0;0
96;28.02.2017;2017;02;01;Tiistai;0;0;0;0;0;0
96;28.02.2017;2017;02;02;Tiistai;0;0;0;0;1;1
96;28.02.2017;2017;02;03;Tiistai;0;0;0;0;0;0
96;28.02.2017;2017;02;04;Tiistai;1;0;1;1;0;1
96;28.02.2017;2017;02;05;Tiistai;5;6;11;0;2;2
96;28.02.2017;2017;02;06;Tiistai;35;17;52;15;2;17
96;28.02.2017;2017;02;07;Tiistai;105;71;176;39;5;44
96;28.02.2017;2017;02;08;Tiistai;77;60;137;23;12;35
96;28.02.2017;2017;02;09;Tiistai;69;50;119;23;14;37
96;28.02.2017;2017;02;10;Tiistai;41;35;76;18;20;38
96;28.02.2017;2017;02;11;Tiistai;37;50;87;13;19;32
96;28.02.2017;2017;02;12;Tiistai;51;56;107;16;14;30
96;28.02.2017;2017;02;13;Tiistai;50;60;110;14;28;42
96;28.02.2017;2017;02;14;Tiistai;42;85;127;4;35;39
96;28.02.2017;2017;02;15;Tiistai;45;164;209;11;51;62
96;28.02.2017;2017;02;16;Tiistai;62;87;149;23;51;74
96;28.02.2017;2017;02;17;Tiistai;68;56;124;17;17;34
96;28.02.2017;2017;02;18;Tiistai;32;44;76;15;31;46
96;28.02.2017;2017;02;19;Tiistai;40;24;64;13;11;24
96;28.02.2017;2017;02;20;Tiistai;33;19;52;12;7;19
96;28.02.2017;2017;02;21;Tiistai;29;72;101;12;11;23
96;28.02.2017;2017;02;22;Tiistai;6;4;10;1;1;2
96;28.02.2017;2017;02;23;Tiistai;3;3;6;2;0;2
96;01.03.2017;2017;03;00;Keskiviikko;4;0;4;0;0;0
96;01.03.2017;2017;03;01;Keskiviikko;5;0;5;1;0;1
96;01.03.2017;2017;03;02;Keskiviikko;2;0;2;0;0;0
96;01.03.2017;2017;03;03;Keskiviikko;1;0;1;0;0;0
96;01.03.2017;2017;03;04;Keskiviikko;2;0;2;0;0;0
96;01.03.2017;2017;03;05;Keskiviikko;7;5;12;0;5;5
96;01.03.2017;2017;03;06;Keskiviikko;38;19;57;19;5;24
96;01.03.2017;2017;03;07;Keskiviikko;63;80;143;31;10;41
96;01.03.2017;2017;03;08;Keskiviikko;73;51;124;15;12;27
96;01.03.2017;2017;03;09;Keskiviikko;57;42;99;18;15;33
96;01.03.2017;2017;03;10;Keskiviikko;37;33;70;19;15;34
96;01.03.2017;2017;03;11;Keskiviikko;58;48;106;17;14;31
96;01.03.2017;2017;03;12;Keskiviikko;62;32;94;16;19;35
96;01.03.2017;2017;03;13;Keskiviikko;35;57;92;9;10;19
96;01.03.2017;2017;03;14;Keskiviikko;24;74;98;5;21;26
96;01.03.2017;2017;03;15;Keskiviikko;38;130;168;6;27;33
96;01.03.2017;2017;03;16;Keskiviikko;56;65;121;14;30;44
96;01.03.2017;2017;03;17;Keskiviikko;48;41;89;7;10;17
96;01.03.2017;2017;03;18;Keskiviikko;57;27;84;28;17;45
96;01.03.2017;2017;03;19;Keskiviikko;27;16;43;22;22;44
96;01.03.2017;2017;03;20;Keskiviikko;37;25;62;7;11;18
96;01.03.2017;2017;03;21;Keskiviikko;15;62;77;1;13;14
96;01.03.2017;2017;03;22;Keskiviikko;5;11;16;0;2;2
96;01.03.2017;2017;03;23;Keskiviikko;1;3;4;2;0;2
96;02.03.2017;2017;03;00;Torstai;0;2;2;0;0;0
96;02.03.2017;2017;03;01;Torstai;3;1;4;1;0;1
96;02.03.2017;2017;03;02;Torstai;1;0;1;0;0;0
96;02.03.2017;2017;03;03;Torstai;1;0;1;0;0;0
96;02.03.2017;2017;03;04;Torstai;1;0;1;0;1;1
96;02.03.2017;2017;03;05;Torstai;5;3;8;3;6;9
96;02.03.2017;2017;03;06;Torstai;48;14;62;15;3;18
96;02.03.2017;2017;03;07;Torstai;102;72;174;32;15;47
96;02.03.2017;2017;03;08;Torstai;63;52;115;11;6;17
96;02.03.2017;2017;03;09;Torstai;61;25;86;15;6;21
96;02.03.2017;2017;03;10;Torstai;49;51;100;16;21;37
96;02.03.2017;2017;03;11;Torstai;42;35;77;12;8;20
96;02.03.2017;2017;03;12;Torstai;56;41;97;23;15;38
96;02.03.2017;2017;03;13;Torstai;40;57;97;8;12;20
96;02.03.2017;2017;03;14;Torstai;48;71;119;13;31;44
96;02.03.2017;2017;03;15;Torstai;44;117;161;6;37;43
96;02.03.2017;2017;03;16;Torstai;72;108;180;15;25;40
96;02.03.2017;2017;03;17;Torstai;42;48;90;19;14;33
96;02.03.2017;2017;03;18;Torstai;35;28;63;19;24;43
96;02.03.2017;2017;03;19;Torstai;36;22;58;11;8;19
96;02.03.2017;2017;03;20;Torstai;19;19;38;10;5;15
96;02.03.2017;2017;03;21;Torstai;30;33;63;5;4;9
96;02.03.2017;2017;03;22;Torstai;10;14;24;0;0;0
96;02.03.2017;2017;03;23;Torstai;2;1;3;2;2;4
96;03.03.2017;2017;03;00;Perjantai;2;4;6;0;0;0
96;03.03.2017;2017;03;01;Perjantai;0;0;0;1;0;1
96;03.03.2017;2017;03;02;Perjantai;4;0;4;0;1;1
96;03.03.2017;2017;03;03;Perjantai;3;0;3;0;0;0
96;03.03.2017;2017;03;04;Perjantai;5;2;7;0;2;2
96;03.03.2017;2017;03;05;Perjantai;6;2;8;2;6;8
96;03.03.2017;2017;03;06;Perjantai;32;22;54;13;4;17
96;03.03.2017;2017;03;07;Perjantai;73;60;133;34;13;47
96;03.03.2017;2017;03;08;Perjantai;53;52;105;16;11;27
96;03.03.2017;2017;03;09;Perjantai;44;30;74;29;12;41
96;03.03.2017;2017;03;10;Perjantai;44;37;81;13;11;24
96;03.03.2017;2017;03;11;Perjantai;38;47;85;12;13;25
96;03.03.2017;2017;03;12;Perjantai;43;42;85;13;17;30
96;03.03.2017;2017;03;13;Perjantai;54;72;126;12;29;41
96;03.03.2017;2017;03;14;Perjantai;42;77;119;8;35;43
96;03.03.2017;2017;03;15;Perjantai;52;88;140;15;45;60
96;03.03.2017;2017;03;16;Perjantai;48;42;90;16;30;46
96;03.03.2017;2017;03;17;Perjantai;32;28;60;12;12;24
96;03.03.2017;2017;03;18;Perjantai;27;26;53;9;16;25
96;03.03.2017;2017;03;19;Perjantai;19;15;34;9;9;18
96;03.03.2017;2017;03;20;Perjantai;9;14;23;7;8;15
96;03.03.2017;2017;03;21;Perjantai;22;17;39;2;9;11
96;03.03.2017;2017;03;22;Perjantai;8;3;11;0;2;2
96;03.03.2017;2017;03;23;Perjantai;6;1;7;2;0;2
96;04.03.2017;2017;03;00;Lauantai;3;1;4;1;2;3
96;04.03.2017;2017;03;01;Lauantai;6;1;7;2;2;4
96;04.03.2017;2017;03;02;Lauantai;4;1;5;1;0;1
96;04.03.2017;2017;03;03;Lauantai;5;0;5;1;0;1
96;04.03.2017;2017;03;04;Lauantai;4;1;5;0;0;0
96;04.03.2017;2017;03;05;Lauantai;2;1;3;0;0;0
96;04.03.2017;2017;03;06;Lauantai;12;6;18;7;1;8
96;04.03.2017;2017;03;07;Lauantai;2;8;10;1;6;7
96;04.03.2017;2017;03;08;Lauantai;3;12;15;6;6;12
96;04.03.2017;2017;03;09;Lauantai;7;19;26;5;8;13
96;04.03.2017;2017;03;10;Lauantai;12;25;37;5;5;10
96;04.03.2017;2017;03;11;Lauantai;22;18;40;6;13;19
96;04.03.2017;2017;03;12;Lauantai;16;26;42;14;19;33
96;04.03.2017;2017;03;13;Lauantai;24;22;46;15;13;28
96;04.03.2017;2017;03;14;Lauantai;25;28;53;11;6;17
96;04.03.2017;2017;03;15;Lauantai;18;22;40;13;16;29
96;04.03.2017;2017;03;16;Lauantai;12;22;34;6;10;16
96;04.03.2017;2017;03;17;Lauantai;18;13;31;8;11;19
96;04.03.2017;2017;03;18;Lauantai;16;8;24;10;3;13
96;04.03.2017;2017;03;19;Lauantai;22;9;31;13;6;19
96;04.03.2017;2017;03;20;Lauantai;10;15;25;8;11;19
96;04.03.2017;2017;03;21;Lauantai;9;14;23;2;7;9
96;04.03.2017;2017;03;22;Lauantai;2;4;6;1;2;3
96;04.03.2017;2017;03;23;Lauantai;2;5;7;3;1;4
96;05.03.2017;2017;03;00;Sunnuntai;9;1;10;1;3;4
96;05.03.2017;2017;03;01;Sunnuntai;5;0;5;2;1;3
96;05.03.2017;2017;03;02;Sunnuntai;3;0;3;1;1;2
96;05.03.2017;2017;03;03;Sunnuntai;6;0;6;1;0;1
96;05.03.2017;2017;03;04;Sunnuntai;1;0;1;1;0;1
96;05.03.2017;2017;03;05;Sunnuntai;2;0;2;0;0;0
96;05.03.2017;2017;03;06;Sunnuntai;10;1;11;5;0;5
96;05.03.2017;2017;03;07;Sunnuntai;1;8;9;0;5;5
96;05.03.2017;2017;03;08;Sunnuntai;1;2;3;2;3;5
96;05.03.2017;2017;03;09;Sunnuntai;2;9;11;6;5;11
96;05.03.2017;2017;03;10;Sunnuntai;7;8;15;3;3;6
96;05.03.2017;2017;03;11;Sunnuntai;11;9;20;13;10;23
96;05.03.2017;2017;03;12;Sunnuntai;14;19;33;16;15;31
96;05.03.2017;2017;03;13;Sunnuntai;15;8;23;22;23;45
96;05.03.2017;2017;03;14;Sunnuntai;15;16;31;9;8;17
96;05.03.2017;2017;03;15;Sunnuntai;21;17;38;14;15;29
96;05.03.2017;2017;03;16;Sunnuntai;16;7;23;23;7;30
96;05.03.2017;2017;03;17;Sunnuntai;8;9;17;10;11;21
96;05.03.2017;2017;03;18;Sunnuntai;15;14;29;9;7;16
96;05.03.2017;2017;03;19;Sunnuntai;6;12;18;5;12;17
96;05.03.2017;2017;03;20;Sunnuntai;12;14;26;4;9;13
96;05.03.2017;2017;03;21;Sunnuntai;10;14;24;5;3;8
96;05.03.2017;2017;03;22;Sunnuntai;4;4;8;2;1;3
96;05.03.2017;2017;03;23;Sunnuntai;8;0;8;2;0;2
96;06.03.2017;2017;03;00;Maanantai;1;0;1;0;0;0
96;06.03.2017;2017;03;01;Maanantai;2;0;2;0;0;0
96;06.03.2017;2017;03;02;Maanantai;0;1;1;1;0;1
96;06.03.2017;2017;03;03;Maanantai;4;0;4;0;0;0
96;06.03.2017;2017;03;04;Maanantai;1;0;1;0;2;2
96;06.03.2017;2017;03;05;Maanantai;3;2;5;2;2;4
96;06.03.2017;2017;03;06;Maanantai;30;20;50;18;4;22
96;06.03.2017;2017;03;07;Maanantai;49;42;91;19;10;29
96;06.03.2017;2017;03;08;Maanantai;17;33;50;8;8;16
96;06.03.2017;2017;03;09;Maanantai;17;22;39;8;11;19
96;06.03.2017;2017;03;10;Maanantai;22;27;49;7;12;19
96;06.03.2017;2017;03;11;Maanantai;18;18;36;13;16;29
96;06.03.2017;2017;03;12;Maanantai;26;21;47;16;24;40
96;06.03.2017;2017;03;13;Maanantai;31;18;49;16;16;32
96;06.03.2017;2017;03;14;Maanantai;25;43;68;10;14;24
96;06.03.2017;2017;03;15;Maanantai;39;79;118;14;37;51
96;06.03.2017;2017;03;16;Maanantai;36;42;78;10;21;31
96;06.03.2017;2017;03;17;Maanantai;24;29;53;6;7;13
96;06.03.2017;2017;03;18;Maanantai;30;19;49;8;10;18
96;06.03.2017;2017;03;19;Maanantai;17;11;28;5;9;14
96;06.03.2017;2017;03;20;Maanantai;13;7;20;5;5;10
96;06.03.2017;2017;03;21;Maanantai;13;12;25;0;9;9
96;06.03.2017;2017;03;22;Maanantai;5;3;8;4;2;6
96;06.03.2017;2017;03;23;Maanantai;3;0;3;0;0;0
96;07.03.2017;2017;03;00;Tiistai;2;0;2;0;0;0
96;07.03.2017;2017;03;01;Tiistai;2;0;2;0;0;0
96;07.03.2017;2017;03;02;Tiistai;0;0;0;0;0;0
96;07.03.2017;2017;03;03;Tiistai;0;0;0;0;1;1
96;07.03.2017;2017;03;04;Tiistai;1;1;2;0;0;0
96;07.03.2017;2017;03;05;Tiistai;3;2;5;1;0;1
96;07.03.2017;2017;03;06;Tiistai;37;18;55;18;1;19
96;07.03.2017;2017;03;07;Tiistai;57;39;96;29;7;36
96;07.03.2017;2017;03;08;Tiistai;11;27;38;6;7;13
96;07.03.2017;2017;03;09;Tiistai;14;18;32;8;6;14
96;07.03.2017;2017;03;10;Tiistai;11;21;32;7;11;18
96;07.03.2017;2017;03;11;Tiistai;21;17;38;5;11;16
96;07.03.2017;2017;03;12;Tiistai;35;19;54;10;19;29
96;07.03.2017;2017;03;13;Tiistai;23;27;50;12;19;31
96;07.03.2017;2017;03;14;Tiistai;28;44;72;8;17;25
96;07.03.2017;2017;03;15;Tiistai;30;77;107;17;47;64
96;07.03.2017;2017;03;16;Tiistai;35;61;96;22;35;57
96;07.03.2017;2017;03;17;Tiistai;27;21;48;13;8;21
96;07.03.2017;2017;03;18;Tiistai;25;17;42;15;10;25
96;07.03.2017;2017;03;19;Tiistai;15;15;30;6;7;13
96;07.03.2017;2017;03;20;Tiistai;12;7;19;7;7;14
96;07.03.2017;2017;03;21;Tiistai;18;17;35;1;6;7
96;07.03.2017;2017;03;22;Tiistai;5;4;9;2;5;7
96;07.03.2017;2017;03;23;Tiistai;8;1;9;0;0;0
96;08.03.2017;2017;03;00;Keskiviikko;1;0;1;2;0;2
96;08.03.2017;2017;03;01;Keskiviikko;1;0;1;1;0;1
96;08.03.2017;2017;03;02;Keskiviikko;0;0;0;0;0;0
96;08.03.2017;2017;03;03;Keskiviikko;1;0;1;0;0;0
96;08.03.2017;2017;03;04;Keskiviikko;1;0;1;0;0;0
96;08.03.2017;2017;03;05;Keskiviikko;6;2;8;1;0;1
96;08.03.2017;2017;03;06;Keskiviikko;34;18;52;9;5;14
96;08.03.2017;2017;03;07;Keskiviikko;49;40;89;27;7;34
96;08.03.2017;2017;03;08;Keskiviikko;18;34;52;7;7;14
96;08.03.2017;2017;03;09;Keskiviikko;16;24;40;9;10;19
96;08.03.2017;2017;03;10;Keskiviikko;19;31;50;13;8;21
96;08.03.2017;2017;03;11;Keskiviikko;19;23;42;6;11;17
96;08.03.2017;2017;03;12;Keskiviikko;20;28;48;21;16;37
96;08.03.2017;2017;03;13;Keskiviikko;20;23;43;5;11;16
96;08.03.2017;2017;03;14;Keskiviikko;24;39;63;7;16;23
96;08.03.2017;2017;03;15;Keskiviikko;35;68;103;17;28;45
96;08.03.2017;2017;03;16;Keskiviikko;32;46;78;9;21;30
96;08.03.2017;2017;03;17;Keskiviikko;26;18;44;8;5;13
96;08.03.2017;2017;03;18;Keskiviikko;33;13;46;17;15;32
96;08.03.2017;2017;03;19;Keskiviikko;20;9;29;9;6;15
96;08.03.2017;2017;03;20;Keskiviikko;21;26;47;9;8;17
96;08.03.2017;2017;03;21;Keskiviikko;9;24;33;2;8;10
96;08.03.2017;2017;03;22;Keskiviikko;2;2;4;0;3;3
96;08.03.2017;2017;03;23;Keskiviikko;2;2;4;1;0;1
96;09.03.2017;2017;03;00;Torstai;1;2;3;0;0;0
96;09.03.2017;2017;03;01;Torstai;0;0;0;1;0;1
96;09.03.2017;2017;03;02;Torstai;2;0;2;2;0;2
96;09.03.2017;2017;03;03;Torstai;4;0;4;0;0;0
96;09.03.2017;2017;03;04;Torstai;2;0;2;0;1;1
96;09.03.2017;2017;03;05;Torstai;2;2;4;4;1;5
96;09.03.2017;2017;03;06;Torstai;27;18;45;11;5;16
96;09.03.2017;2017;03;07;Torstai;47;40;87;26;14;40
96;09.03.2017;2017;03;08;Torstai;13;31;44;11;9;20
96;09.03.2017;2017;03;09;Torstai;14;15;29;3;15;18
96;09.03.2017;2017;03;10;Torstai;20;22;42;7;11;18
96;09.03.2017;2017;03;11;Torstai;25;15;40;17;13;30
96;09.03.2017;2017;03;12;Torstai;24;17;41;13;15;28
96;09.03.2017;2017;03;13;Torstai;24;25;49;22;12;34
96;09.03.2017;2017;03;14;Torstai;29;33;62;5;9;14
96;09.03.2017;2017;03;15;Torstai;33;71;104;9;25;34
96;09.03.2017;2017;03;16;Torstai;32;30;62;18;20;38
96;09.03.2017;2017;03;17;Torstai;25;25;50;10;17;27
96;09.03.2017;2017;03;18;Torstai;21;28;49;4;14;18
96;09.03.2017;2017;03;19;Torstai;17;10;27;7;8;15
96;09.03.2017;2017;03;20;Torstai;19;5;24;13;10;23
96;09.03.2017;2017;03;21;Torstai;25;19;44;13;13;26
96;09.03.2017;2017;03;22;Torstai;4;5;9;2;2;4
96;09.03.2017;2017;03;23;Torstai;5;3;8;1;0;1
96;10.03.2017;2017;03;00;Perjantai;2;2;4;1;0;1
96;10.03.2017;2017;03;01;Perjantai;4;0;4;1;1;2
96;10.03.2017;2017;03;02;Perjantai;0;0;0;0;0;0
96;10.03.2017;2017;03;03;Perjantai;1;0;1;1;0;1
96;10.03.2017;2017;03;04;Perjantai;5;1;6;2;0;2
96;10.03.2017;2017;03;05;Perjantai;3;0;3;1;1;2
96;10.03.2017;2017;03;06;Perjantai;30;22;52;12;6;18
96;10.03.2017;2017;03;07;Perjantai;43;37;80;25;13;38
96;10.03.2017;2017;03;08;Perjantai;18;41;59;5;7;12
96;10.03.2017;2017;03;09;Perjantai;18;23;41;7;3;10
96;10.03.2017;2017;03;10;Perjantai;14;12;26;6;11;17
96;10.03.2017;2017;03;11;Perjantai;20;14;34;14;15;29
96;10.03.2017;2017;03;12;Perjantai;30;18;48;9;8;17
96;10.03.2017;2017;03;13;Perjantai;29;39;68;7;13;20
96;10.03.2017;2017;03;14;Perjantai;36;49;85;10;22;32
96;10.03.2017;2017;03;15;Perjantai;45;61;106;12;30;42
96;10.03.2017;2017;03;16;Perjantai;29;31;60;8;15;23
96;10.03.2017;2017;03;17;Perjantai;20;16;36;15;8;23
96;10.03.2017;2017;03;18;Perjantai;19;16;35;9;8;17
96;10.03.2017;2017;03;19;Perjantai;22;15;37;11;8;19
96;10.03.2017;2017;03;20;Perjantai;16;13;29;3;5;8
96;10.03.2017;2017;03;21;Perjantai;17;12;29;4;4;8
96;10.03.2017;2017;03;22;Perjantai;3;7;10;1;3;4
96;10.03.2017;2017;03;23;Perjantai;7;1;8;1;7;8
96;11.03.2017;2017;03;00;Lauantai;6;5;11;2;0;2
96;11.03.2017;2017;03;01;Lauantai;7;1;8;0;0;0
96;11.03.2017;2017;03;02;Lauantai;4;0;4;2;2;4
96;11.03.2017;2017;03;03;Lauantai;2;1;3;0;1;1
96;11.03.2017;2017;03;04;Lauantai;7;0;7;0;0;0
96;11.03.2017;2017;03;05;Lauantai;2;3;5;0;2;2
96;11.03.2017;2017;03;06;Lauantai;14;4;18;5;1;6
96;11.03.2017;2017;03;07;Lauantai;2;9;11;2;3;5
96;11.03.2017;2017;03;08;Lauantai;1;10;11;4;5;9
96;11.03.2017;2017;03;09;Lauantai;9;8;17;3;9;12
96;11.03.2017;2017;03;10;Lauantai;9;24;33;12;17;29
96;11.03.2017;2017;03;11;Lauantai;7;19;26;14;15;29
96;11.03.2017;2017;03;12;Lauantai;19;14;33;23;21;44
96;11.03.2017;2017;03;13;Lauantai;24;24;48;13;18;31
96;11.03.2017;2017;03;14;Lauantai;22;24;46;19;10;29
96;11.03.2017;2017;03;15;Lauantai;30;18;48;12;12;24
96;11.03.2017;2017;03;16;Lauantai;18;23;41;8;9;17
96;11.03.2017;2017;03;17;Lauantai;26;15;41;14;10;24
96;11.03.2017;2017;03;18;Lauantai;12;8;20;6;9;15
96;11.03.2017;2017;03;19;Lauantai;17;9;26;6;6;12
96;11.03.2017;2017;03;20;Lauantai;20;8;28;5;10;15
96;11.03.2017;2017;03;21;Lauantai;11;12;23;3;6;9
96;11.03.2017;2017;03;22;Lauantai;5;6;11;1;3;4
96;11.03.2017;2017;03;23;Lauantai;5;10;15;1;0;1
96;12.03.2017;2017;03;00;Sunnuntai;1;5;6;1;0;1
96;12.03.2017;2017;03;01;Sunnuntai;6;10;16;0;1;1
96;12.03.2017;2017;03;02;Sunnuntai;9;0;9;2;0;2
96;12.03.2017;2017;03;03;Sunnuntai;6;0;6;5;0;5
96;12.03.2017;2017;03;04;Sunnuntai;5;0;5;0;0;0
96;12.03.2017;2017;03;05;Sunnuntai;0;1;1;0;0;0
96;12.03.2017;2017;03;06;Sunnuntai;18;2;20;7;0;7
96;12.03.2017;2017;03;07;Sunnuntai;2;19;21;2;4;6
96;12.03.2017;2017;03;08;Sunnuntai;4;3;7;4;4;8
96;12.03.2017;2017;03;09;Sunnuntai;2;7;9;6;6;12
96;12.03.2017;2017;03;10;Sunnuntai;11;6;17;12;6;18
96;12.03.2017;2017;03;11;Sunnuntai;13;16;29;15;16;31
96;12.03.2017;2017;03;12;Sunnuntai;10;17;27;14;8;22
96;12.03.2017;2017;03;13;Sunnuntai;29;17;46;6;16;22
96;12.03.2017;2017;03;14;Sunnuntai;9;27;36;8;12;20
96;12.03.2017;2017;03;15;Sunnuntai;14;29;43;8;18;26
96;12.03.2017;2017;03;16;Sunnuntai;24;7;31;21;8;29
96;12.03.2017;2017;03;17;Sunnuntai;14;11;25;8;7;15
96;12.03.2017;2017;03;18;Sunnuntai;22;18;40;17;17;34
96;12.03.2017;2017;03;19;Sunnuntai;14;12;26;4;16;20
96;12.03.2017;2017;03;20;Sunnuntai;13;14;27;3;8;11
96;12.03.2017;2017;03;21;Sunnuntai;14;8;22;5;5;10
96;12.03.2017;2017;03;22;Sunnuntai;0;5;5;1;2;3
96;12.03.2017;2017;03;23;Sunnuntai;1;1;2;1;0;1
96;13.03.2017;2017;03;00;Maanantai;1;0;1;2;1;3
96;13.03.2017;2017;03;01;Maanantai;0;0;0;0;0;0
96;13.03.2017;2017;03;02;Maanantai;0;0;0;0;0;0
96;13.03.2017;2017;03;03;Maanantai;0;0;0;0;0;0
96;13.03.2017;2017;03;04;Maanantai;1;0;1;0;0;0
96;13.03.2017;2017;03;05;Maanantai;2;5;7;1;3;4
96;13.03.2017;2017;03;06;Maanantai;28;25;53;17;3;20
96;13.03.2017;2017;03;07;Maanantai;113;78;191;34;13;47
96;13.03.2017;2017;03;08;Maanantai;91;58;149;31;19;50
96;13.03.2017;2017;03;09;Maanantai;73;44;117;22;7;29
96;13.03.2017;2017;03;10;Maanantai;57;33;90;15;20;35
96;13.03.2017;2017;03;11;Maanantai;46;39;85;24;31;55
96;13.03.2017;2017;03;12;Maanantai;61;38;99;24;41;65
96;13.03.2017;2017;03;13;Maanantai;53;62;115;21;19;40
96;13.03.2017;2017;03;14;Maanantai;39;88;127;10;47;57
96;13.03.2017;2017;03;15;Maanantai;48;114;162;17;44;61
96;13.03.2017;2017;03;16;Maanantai;79;104;183;12;50;62
96;13.03.2017;2017;03;17;Maanantai;47;58;105;13;24;37
96;13.03.2017;2017;03;18;Maanantai;49;31;80;11;15;26
96;13.03.2017;2017;03;19;Maanantai;35;31;66;12;17;29
96;13.03.2017;2017;03;20;Maanantai;29;22;51;8;14;22
96;13.03.2017;2017;03;21;Maanantai;21;12;33;8;7;15
96;13.03.2017;2017;03;22;Maanantai;6;5;11;2;1;3
96;13.03.2017;2017;03;23;Maanantai;4;3;7;1;0;1
96;14.03.2017;2017;03;00;Tiistai;1;1;2;1;0;1
96;14.03.2017;2017;03;01;Tiistai;0;1;1;0;0;0
96;14.03.2017;2017;03;02;Tiistai;1;0;1;1;0;1
96;14.03.2017;2017;03;03;Tiistai;0;0;0;0;1;1
96;14.03.2017;2017;03;04;Tiistai;0;1;1;1;5;6
96;14.03.2017;2017;03;05;Tiistai;2;7;9;1;2;3
96;14.03.2017;2017;03;06;Tiistai;40;20;60;15;1;16
96;14.03.2017;2017;03;07;Tiistai;107;73;180;45;19;64
96;14.03.2017;2017;03;08;Tiistai;70;48;118;19;23;42
96;14.03.2017;2017;03;09;Tiistai;95;31;126;24;17;41
96;14.03.2017;2017;03;10;Tiistai;53;30;83;18;17;35
96;14.03.2017;2017;03;11;Tiistai;57;34;91;24;14;38
96;14.03.2017;2017;03;12;Tiistai;59;61;120;19;18;37
96;14.03.2017;2017;03;13;Tiistai;53;54;107;16;18;34
96;14.03.2017;2017;03;14;Tiistai;52;72;124;4;29;33
96;14.03.2017;2017;03;15;Tiistai;64;137;201;13;46;59
96;14.03.2017;2017;03;16;Tiistai;57;109;166;15;38;53
96;14.03.2017;2017;03;17;Tiistai;37;40;77;21;13;34
96;14.03.2017;2017;03;18;Tiistai;30;21;51;14;23;37
96;14.03.2017;2017;03;19;Tiistai;37;28;65;10;16;26
96;14.03.2017;2017;03;20;Tiistai;32;12;44;5;11;16
96;14.03.2017;2017;03;21;Tiistai;19;21;40;2;6;8
96;14.03.2017;2017;03;22;Tiistai;7;7;14;0;2;2
96;14.03.2017;2017;03;23;Tiistai;8;0;8;3;0;3
96;15.03.2017;2017;03;00;Keskiviikko;1;1;2;0;0;0
96;15.03.2017;2017;03;01;Keskiviikko;0;0;0;2;0;2
96;15.03.2017;2017;03;02;Keskiviikko;8;0;8;0;0;0
96;15.03.2017;2017;03;03;Keskiviikko;0;0;0;0;1;1
96;15.03.2017;2017;03;04;Keskiviikko;0;0;0;0;0;0
96;15.03.2017;2017;03;05;Keskiviikko;6;0;6;4;3;7
96;15.03.2017;2017;03;06;Keskiviikko;52;22;74;26;5;31
96;15.03.2017;2017;03;07;Keskiviikko;110;82;192;42;13;55
96;15.03.2017;2017;03;08;Keskiviikko;125;42;167;17;6;23
96;15.03.2017;2017;03;09;Keskiviikko;79;28;107;15;9;24
96;15.03.2017;2017;03;10;Keskiviikko;40;33;73;24;16;40
96;15.03.2017;2017;03;11;Keskiviikko;59;46;105;18;25;43
96;15.03.2017;2017;03;12;Keskiviikko;61;34;95;12;12;24
96;15.03.2017;2017;03;13;Keskiviikko;43;77;120;12;24;36
96;15.03.2017;2017;03;14;Keskiviikko;45;85;130;10;25;35
96;15.03.2017;2017;03;15;Keskiviikko;47;141;188;14;52;66
96;15.03.2017;2017;03;16;Keskiviikko;56;94;150;24;35;59
96;15.03.2017;2017;03;17;Keskiviikko;39;36;75;11;24;35
96;15.03.2017;2017;03;18;Keskiviikko;50;29;79;25;10;35
96;15.03.2017;2017;03;19;Keskiviikko;40;21;61;9;17;26
96;15.03.2017;2017;03;20;Keskiviikko;34;24;58;8;12;20
96;15.03.2017;2017;03;21;Keskiviikko;36;28;64;10;12;22
96;15.03.2017;2017;03;22;Keskiviikko;3;2;5;3;0;3
96;15.03.2017;2017;03;23;Keskiviikko;4;6;10;0;0;0
96;16.03.2017;2017;03;00;Torstai;4;1;5;3;1;4
96;16.03.2017;2017;03;01;Torstai;0;1;1;0;0;0
96;16.03.2017;2017;03;02;Torstai;5;0;5;0;0;0
96;16.03.2017;2017;03;03;Torstai;0;0;0;1;0;1
96;16.03.2017;2017;03;04;Torstai;0;0;0;0;0;0
96;16.03.2017;2017;03;05;Torstai;6;3;9;5;2;7
96;16.03.2017;2017;03;06;Torstai;48;14;62;16;2;18
96;16.03.2017;2017;03;07;Torstai;98;62;160;41;12;53
96;16.03.2017;2017;03;08;Torstai;99;56;155;17;13;30
96;16.03.2017;2017;03;09;Torstai;83;33;116;24;24;48
96;16.03.2017;2017;03;10;Torstai;58;24;82;20;15;35
96;16.03.2017;2017;03;11;Torstai;38;35;73;11;21;32
96;16.03.2017;2017;03;12;Torstai;66;44;110;21;21;42
96;16.03.2017;2017;03;13;Torstai;35;71;106;19;28;47
96;16.03.2017;2017;03;14;Torstai;65;94;159;17;43;60
96;16.03.2017;2017;03;15;Torstai;64;120;184;19;54;73
96;16.03.2017;2017;03;16;Torstai;66;83;149;13;44;57
96;16.03.2017;2017;03;17;Torstai;34;51;85;25;26;51
96;16.03.2017;2017;03;18;Torstai;40;23;63;20;19;39
96;16.03.2017;2017;03;19;Torstai;22;13;35;5;13;18
96;16.03.2017;2017;03;20;Torstai;33;26;59;10;6;16
96;16.03.2017;2017;03;21;Torstai;21;23;44;6;11;17
96;16.03.2017;2017;03;22;Torstai;4;4;8;0;1;1
96;16.03.2017;2017;03;23;Torstai;6;3;9;0;0;0
96;17.03.2017;2017;03;00;Perjantai;3;1;4;1;0;1
96;17.03.2017;2017;03;01;Perjantai;2;0;2;1;1;2
96;17.03.2017;2017;03;02;Perjantai;0;2;2;1;0;1
96;17.03.2017;2017;03;03;Perjantai;3;0;3;0;0;0
96;17.03.2017;2017;03;04;Perjantai;1;0;1;0;0;0
96;17.03.2017;2017;03;05;Perjantai;3;0;3;0;0;0
96;17.03.2017;2017;03;06;Perjantai;44;0;44;17;0;17
96;17.03.2017;2017;03;07;Perjantai;107;0;107;57;0;57
96;17.03.2017;2017;03;08;Perjantai;100;0;100;33;0;33
96;17.03.2017;2017;03;09;Perjantai;52;21;73;20;12;32
96;17.03.2017;2017;03;10;Perjantai;26;14;40;4;19;23
96;17.03.2017;2017;03;11;Perjantai;27;22;49;6;21;27
96;17.03.2017;2017;03;12;Perjantai;41;38;79;17;31;48
96;17.03.2017;2017;03;13;Perjantai;35;61;96;10;33;43
96;17.03.2017;2017;03;14;Perjantai;28;101;129;5;17;22
96;17.03.2017;2017;03;15;Perjantai;26;59;85;8;34;42
96;17.03.2017;2017;03;16;Perjantai;49;19;68;4;14;18
96;17.03.2017;2017;03;17;Perjantai;33;13;46;3;9;12
96;17.03.2017;2017;03;18;Perjantai;14;12;26;4;6;10
96;17.03.2017;2017;03;19;Perjantai;11;8;19;5;10;15
96;17.03.2017;2017;03;20;Perjantai;13;7;20;6;8;14
96;17.03.2017;2017;03;21;Perjantai;12;16;28;1;8;9
96;17.03.2017;2017;03;22;Perjantai;4;2;6;0;2;2
96;17.03.2017;2017;03;23;Perjantai;5;5;10;0;0;0
96;18.03.2017;2017;03;00;Lauantai;5;1;6;2;0;2
96;18.03.2017;2017;03;01;Lauantai;1;0;1;1;2;3
96;18.03.2017;2017;03;02;Lauantai;4;1;5;3;0;3
96;18.03.2017;2017;03;03;Lauantai;3;1;4;2;0;2
96;18.03.2017;2017;03;04;Lauantai;4;0;4;2;1;3
96;18.03.2017;2017;03;05;Lauantai;2;3;5;0;4;4
96;18.03.2017;2017;03;06;Lauantai;11;1;12;8;0;8
96;18.03.2017;2017;03;07;Lauantai;2;6;8;2;5;7
96;18.03.2017;2017;03;08;Lauantai;4;6;10;14;13;27
96;18.03.2017;2017;03;09;Lauantai;8;8;16;8;11;19
96;18.03.2017;2017;03;10;Lauantai;17;16;33;6;11;17
96;18.03.2017;2017;03;11;Lauantai;22;16;38;11;17;28
96;18.03.2017;2017;03;12;Lauantai;36;16;52;11;26;37
96;18.03.2017;2017;03;13;Lauantai;35;16;51;9;14;23
96;18.03.2017;2017;03;14;Lauantai;13;11;24;10;20;30
96;18.03.2017;2017;03;15;Lauantai;21;7;28;6;14;20
96;18.03.2017;2017;03;16;Lauantai;16;6;22;11;15;26
96;18.03.2017;2017;03;17;Lauantai;16;5;21;12;13;25
96;18.03.2017;2017;03;18;Lauantai;22;10;32;19;17;36
96;18.03.2017;2017;03;19;Lauantai;8;4;12;6;7;13
96;18.03.2017;2017;03;20;Lauantai;4;2;6;8;13;21
96;18.03.2017;2017;03;21;Lauantai;8;17;25;5;12;17
96;18.03.2017;2017;03;22;Lauantai;8;5;13;1;5;6
96;18.03.2017;2017;03;23;Lauantai;10;5;15;0;3;3
96;19.03.2017;2017;03;00;Sunnuntai;4;1;5;6;3;9
96;19.03.2017;2017;03;01;Sunnuntai;3;1;4;2;1;3
96;19.03.2017;2017;03;02;Sunnuntai;5;2;7;2;0;2
96;19.03.2017;2017;03;03;Sunnuntai;5;1;6;3;0;3
96;19.03.2017;2017;03;04;Sunnuntai;5;0;5;3;1;4
96;19.03.2017;2017;03;05;Sunnuntai;0;0;0;2;1;3
96;19.03.2017;2017;03;06;Sunnuntai;11;1;12;6;0;6
96;19.03.2017;2017;03;07;Sunnuntai;3;1;4;6;9;15
96;19.03.2017;2017;03;08;Sunnuntai;3;1;4;2;5;7
96;19.03.2017;2017;03;09;Sunnuntai;2;6;8;6;7;13
96;19.03.2017;2017;03;10;Sunnuntai;9;4;13;10;19;29
96;19.03.2017;2017;03;11;Sunnuntai;10;8;18;15;24;39
96;19.03.2017;2017;03;12;Sunnuntai;10;13;23;27;30;57
96;19.03.2017;2017;03;13;Sunnuntai;30;4;34;18;20;38
96;19.03.2017;2017;03;14;Sunnuntai;23;12;35;19;40;59
96;19.03.2017;2017;03;15;Sunnuntai;17;5;22;21;19;40
96;19.03.2017;2017;03;16;Sunnuntai;23;7;30;32;26;58
96;19.03.2017;2017;03;17;Sunnuntai;15;7;22;21;19;40
96;19.03.2017;2017;03;18;Sunnuntai;16;12;28;12;20;32
96;19.03.2017;2017;03;19;Sunnuntai;8;7;15;5;12;17
96;19.03.2017;2017;03;20;Sunnuntai;11;8;19;7;14;21
96;19.03.2017;2017;03;21;Sunnuntai;6;9;15;3;9;12
96;19.03.2017;2017;03;22;Sunnuntai;2;3;5;2;2;4
96;19.03.2017;2017;03;23;Sunnuntai;3;0;3;1;0;1
96;20.03.2017;2017;03;00;Maanantai;0;0;0;4;1;5
96;20.03.2017;2017;03;01;Maanantai;0;0;0;0;0;0
96;20.03.2017;2017;03;02;Maanantai;0;0;0;0;0;0
96;20.03.2017;2017;03;03;Maanantai;1;0;1;0;0;0
96;20.03.2017;2017;03;04;Maanantai;2;0;2;3;6;9
96;20.03.2017;2017;03;05;Maanantai;7;1;8;2;0;2
96;20.03.2017;2017;03;06;Maanantai;40;15;55;17;6;23
96;20.03.2017;2017;03;07;Maanantai;92;46;138;43;38;81
96;20.03.2017;2017;03;08;Maanantai;95;30;125;24;42;66
96;20.03.2017;2017;03;09;Maanantai;94;19;113;29;40;69
96;20.03.2017;2017;03;10;Maanantai;62;24;86;26;39;65
96;20.03.2017;2017;03;11;Maanantai;65;18;83;14;42;56
96;20.03.2017;2017;03;12;Maanantai;91;30;121;18;41;59
96;20.03.2017;2017;03;13;Maanantai;69;34;103;23;41;64
96;20.03.2017;2017;03;14;Maanantai;63;66;129;13;54;67
96;20.03.2017;2017;03;15;Maanantai;82;113;195;13;67;80
96;20.03.2017;2017;03;16;Maanantai;86;119;205;13;54;67
96;20.03.2017;2017;03;17;Maanantai;68;55;123;16;33;49
96;20.03.2017;2017;03;18;Maanantai;62;34;96;12;12;24
96;20.03.2017;2017;03;19;Maanantai;46;29;75;19;23;42
96;20.03.2017;2017;03;20;Maanantai;34;25;59;16;15;31
96;20.03.2017;2017;03;21;Maanantai;33;23;56;6;8;14
96;20.03.2017;2017;03;22;Maanantai;8;5;13;2;0;2
96;20.03.2017;2017;03;23;Maanantai;16;1;17;3;0;3
96;21.03.2017;2017;03;00;Tiistai;4;2;6;0;1;1
96;21.03.2017;2017;03;01;Tiistai;2;0;2;0;0;0
96;21.03.2017;2017;03;02;Tiistai;1;0;1;0;0;0
96;21.03.2017;2017;03;03;Tiistai;0;0;0;1;0;1
96;21.03.2017;2017;03;04;Tiistai;2;0;2;2;2;4
96;21.03.2017;2017;03;05;Tiistai;7;4;11;1;1;2
96;21.03.2017;2017;03;06;Tiistai;52;18;70;22;3;25
96;21.03.2017;2017;03;07;Tiistai;150;73;223;46;29;75
96;21.03.2017;2017;03;08;Tiistai;125;58;183;20;23;43
96;21.03.2017;2017;03;09;Tiistai;128;41;169;24;29;53
96;21.03.2017;2017;03;10;Tiistai;77;17;94;20;31;51
96;21.03.2017;2017;03;11;Tiistai;92;42;134;14;25;39
96;21.03.2017;2017;03;12;Tiistai;90;33;123;25;25;50
96;21.03.2017;2017;03;13;Tiistai;49;55;104;12;36;48
96;21.03.2017;2017;03;14;Tiistai;52;98;150;7;37;44
96;21.03.2017;2017;03;15;Tiistai;88;120;208;13;73;86
96;21.03.2017;2017;03;16;Tiistai;98;103;201;20;51;71
96;21.03.2017;2017;03;17;Tiistai;45;38;83;18;28;46
96;21.03.2017;2017;03;18;Tiistai;49;39;88;10;27;37
96;21.03.2017;2017;03;19;Tiistai;61;31;92;16;20;36
96;21.03.2017;2017;03;20;Tiistai;53;16;69;13;13;26
96;21.03.2017;2017;03;21;Tiistai;29;24;53;3;10;13
96;21.03.2017;2017;03;22;Tiistai;8;16;24;2;2;4
96;21.03.2017;2017;03;23;Tiistai;5;3;8;2;0;2
96;22.03.2017;2017;03;00;Keskiviikko;2;0;2;0;1;1
96;22.03.2017;2017;03;01;Keskiviikko;1;0;1;1;0;1
96;22.03.2017;2017;03;02;Keskiviikko;0;0;0;0;0;0
96;22.03.2017;2017;03;03;Keskiviikko;0;0;0;0;0;0
96;22.03.2017;2017;03;04;Keskiviikko;1;0;1;0;0;0
96;22.03.2017;2017;03;05;Keskiviikko;4;3;7;0;0;0
96;22.03.2017;2017;03;06;Keskiviikko;41;14;55;19;2;21
96;22.03.2017;2017;03;07;Keskiviikko;114;79;193;40;19;59
96;22.03.2017;2017;03;08;Keskiviikko;130;51;181;19;15;34
96;22.03.2017;2017;03;09;Keskiviikko;75;24;99;14;28;42
96;22.03.2017;2017;03;10;Keskiviikko;33;33;66;12;28;40
96;22.03.2017;2017;03;11;Keskiviikko;85;42;127;26;32;58
96;22.03.2017;2017;03;12;Keskiviikko;94;31;125;13;41;54
96;22.03.2017;2017;03;13;Keskiviikko;93;63;156;21;36;57
96;22.03.2017;2017;03;14;Keskiviikko;44;93;137;7;44;51
96;22.03.2017;2017;03;15;Keskiviikko;53;154;207;25;50;75
96;22.03.2017;2017;03;16;Keskiviikko;77;101;178;10;41;51
96;22.03.2017;2017;03;17;Keskiviikko;52;32;84;18;13;31
96;22.03.2017;2017;03;18;Keskiviikko;68;42;110;28;11;39
96;22.03.2017;2017;03;19;Keskiviikko;56;25;81;15;19;34
96;22.03.2017;2017;03;20;Keskiviikko;40;27;67;10;12;22
96;22.03.2017;2017;03;21;Keskiviikko;18;38;56;3;11;14
96;22.03.2017;2017;03;22;Keskiviikko;6;5;11;4;2;6
96;22.03.2017;2017;03;23;Keskiviikko;15;3;18;2;0;2
96;23.03.2017;2017;03;00;Torstai;2;0;2;0;0;0
96;23.03.2017;2017;03;01;Torstai;3;1;4;2;0;2
96;23.03.2017;2017;03;02;Torstai;0;0;0;2;0;2
96;23.03.2017;2017;03;03;Torstai;0;1;1;0;0;0
96;23.03.2017;2017;03;04;Torstai;4;0;4;0;1;1
96;23.03.2017;2017;03;05;Torstai;2;3;5;0;4;4
96;23.03.2017;2017;03;06;Torstai;59;9;68;20;10;30
96;23.03.2017;2017;03;07;Torstai;134;56;190;42;40;82
96;23.03.2017;2017;03;08;Torstai;110;51;161;15;17;32
96;23.03.2017;2017;03;09;Torstai;117;43;160;15;20;35
96;23.03.2017;2017;03;10;Torstai;63;31;94;18;24;42
96;23.03.2017;2017;03;11;Torstai;55;28;83;32;26;58
96;23.03.2017;2017;03;12;Torstai;56;60;116;19;45;64
96;23.03.2017;2017;03;13;Torstai;48;64;112;18;31;49
96;23.03.2017;2017;03;14;Torstai;69;96;165;17;34;51
96;23.03.2017;2017;03;15;Torstai;83;121;204;16;27;43
96;23.03.2017;2017;03;16;Torstai;93;97;190;18;28;46
96;23.03.2017;2017;03;17;Torstai;60;46;106;13;25;38
96;23.03.2017;2017;03;18;Torstai;43;34;77;19;23;42
96;23.03.2017;2017;03;19;Torstai;30;24;54;9;8;17
96;23.03.2017;2017;03;20;Torstai;32;16;48;11;10;21
96;23.03.2017;2017;03;21;Torstai;16;22;38;3;10;13
96;23.03.2017;2017;03;22;Torstai;9;1;10;1;1;2
96;23.03.2017;2017;03;23;Torstai;6;2;8;0;1;1
96;24.03.2017;2017;03;00;Perjantai;3;0;3;2;0;2
96;24.03.2017;2017;03;01;Perjantai;0;0;0;0;0;0
96;24.03.2017;2017;03;02;Perjantai;2;0;2;1;0;1
96;24.03.2017;2017;03;03;Perjantai;3;0;3;0;0;0
96;24.03.2017;2017;03;04;Perjantai;4;0;4;1;0;1
96;24.03.2017;2017;03;05;Perjantai;4;1;5;0;0;0
96;24.03.2017;2017;03;06;Perjantai;46;20;66;14;2;16
96;24.03.2017;2017;03;07;Perjantai;113;54;167;43;14;57
96;24.03.2017;2017;03;08;Perjantai;71;51;122;62;7;69
96;24.03.2017;2017;03;09;Perjantai;55;41;96;66;12;78
96;24.03.2017;2017;03;10;Perjantai;48;39;87;16;28;44
96;24.03.2017;2017;03;11;Perjantai;62;37;99;26;26;52
96;24.03.2017;2017;03;12;Perjantai;65;54;119;28;27;55
96;24.03.2017;2017;03;13;Perjantai;37;109;146;13;40;53
96;24.03.2017;2017;03;14;Perjantai;67;99;166;12;56;68
96;24.03.2017;2017;03;15;Perjantai;54;86;140;14;76;90
96;24.03.2017;2017;03;16;Perjantai;63;53;116;12;24;36
96;24.03.2017;2017;03;17;Perjantai;45;36;81;14;58;72
96;24.03.2017;2017;03;18;Perjantai;34;19;53;22;11;33
96;24.03.2017;2017;03;19;Perjantai;25;17;42;8;6;14
96;24.03.2017;2017;03;20;Perjantai;30;13;43;11;10;21
96;24.03.2017;2017;03;21;Perjantai;15;13;28;0;5;5
96;24.03.2017;2017;03;22;Perjantai;5;15;20;2;3;5
96;24.03.2017;2017;03;23;Perjantai;10;3;13;3;1;4
96;25.03.2017;2017;03;00;Lauantai;2;6;8;1;0;1
96;25.03.2017;2017;03;01;Lauantai;4;1;5;2;0;2
96;25.03.2017;2017;03;02;Lauantai;6;1;7;1;1;2
96;25.03.2017;2017;03;03;Lauantai;5;2;7;3;0;3
96;25.03.2017;2017;03;04;Lauantai;6;0;6;1;0;1
96;25.03.2017;2017;03;05;Lauantai;7;0;7;1;1;2
96;25.03.2017;2017;03;06;Lauantai;3;7;10;4;0;4
96;25.03.2017;2017;03;07;Lauantai;11;5;16;9;5;14
96;25.03.2017;2017;03;08;Lauantai;4;10;14;8;5;13
96;25.03.2017;2017;03;09;Lauantai;13;12;25;38;4;42
96;25.03.2017;2017;03;10;Lauantai;12;22;34;16;12;28
96;25.03.2017;2017;03;11;Lauantai;23;24;47;10;24;34
96;25.03.2017;2017;03;12;Lauantai;29;23;52;12;13;25
96;25.03.2017;2017;03;13;Lauantai;46;23;69;18;15;33
96;25.03.2017;2017;03;14;Lauantai;20;25;45;17;27;44
96;25.03.2017;2017;03;15;Lauantai;32;37;69;6;20;26
96;25.03.2017;2017;03;16;Lauantai;34;26;60;17;47;64
96;25.03.2017;2017;03;17;Lauantai;28;24;52;9;13;22
96;25.03.2017;2017;03;18;Lauantai;30;22;52;16;8;24
96;25.03.2017;2017;03;19;Lauantai;37;13;50;17;8;25
96;25.03.2017;2017;03;20;Lauantai;23;11;34;7;11;18
96;25.03.2017;2017;03;21;Lauantai;25;13;38;2;11;13
96;25.03.2017;2017;03;22;Lauantai;5;11;16;1;4;5
96;25.03.2017;2017;03;23;Lauantai;7;2;9;1;1;2
96;26.03.2017;2017;03;00;Sunnuntai;8;6;14;2;1;3
96;26.03.2017;2017;03;01;Sunnuntai;2;5;7;1;0;1
96;26.03.2017;2017;03;02;Sunnuntai;0;0;0;0;0;0
96;26.03.2017;2017;03;03;Sunnuntai;0;1;1;3;1;4
96;26.03.2017;2017;03;04;Sunnuntai;6;1;7;3;2;5
96;26.03.2017;2017;03;05;Sunnuntai;1;1;2;1;1;2
96;26.03.2017;2017;03;06;Sunnuntai;17;3;20;7;1;8
96;26.03.2017;2017;03;07;Sunnuntai;0;8;8;0;2;2
96;26.03.2017;2017;03;08;Sunnuntai;3;4;7;2;5;7
96;26.03.2017;2017;03;09;Sunnuntai;4;10;14;7;11;18
96;26.03.2017;2017;03;10;Sunnuntai;5;11;16;6;4;10
96;26.03.2017;2017;03;11;Sunnuntai;13;10;23;14;12;26
96;26.03.2017;2017;03;12;Sunnuntai;22;12;34;20;16;36
96;26.03.2017;2017;03;13;Sunnuntai;31;33;64;11;17;28
96;26.03.2017;2017;03;14;Sunnuntai;36;24;60;3;20;23
96;26.03.2017;2017;03;15;Sunnuntai;43;21;64;14;12;26
96;26.03.2017;2017;03;16;Sunnuntai;45;12;57;29;9;38
96;26.03.2017;2017;03;17;Sunnuntai;25;7;32;19;11;30
96;26.03.2017;2017;03;18;Sunnuntai;31;25;56;29;24;53
96;26.03.2017;2017;03;19;Sunnuntai;17;17;34;13;13;26
96;26.03.2017;2017;03;20;Sunnuntai;11;18;29;7;11;18
96;26.03.2017;2017;03;21;Sunnuntai;13;10;23;4;4;8
96;26.03.2017;2017;03;22;Sunnuntai;4;6;10;1;0;1
96;26.03.2017;2017;03;23;Sunnuntai;3;0;3;3;0;3
96;27.03.2017;2017;03;00;Maanantai;4;0;4;3;0;3
96;27.03.2017;2017;03;01;Maanantai;1;0;1;1;0;1
96;27.03.2017;2017;03;02;Maanantai;0;0;0;1;0;1
96;27.03.2017;2017;03;03;Maanantai;2;0;2;0;0;0
96;27.03.2017;2017;03;04;Maanantai;4;0;4;0;0;0
96;27.03.2017;2017;03;05;Maanantai;4;5;9;1;0;1
96;27.03.2017;2017;03;06;Maanantai;41;13;54;22;1;23
96;27.03.2017;2017;03;07;Maanantai;131;45;176;30;12;42
96;27.03.2017;2017;03;08;Maanantai;85;45;130;16;18;34
96;27.03.2017;2017;03;09;Maanantai;73;35;108;25;8;33
96;27.03.2017;2017;03;10;Maanantai;47;28;75;11;9;20
96;27.03.2017;2017;03;11;Maanantai;41;45;86;17;25;42
96;27.03.2017;2017;03;12;Maanantai;61;43;104;23;21;44
96;27.03.2017;2017;03;13;Maanantai;56;41;97;13;25;38
96;27.03.2017;2017;03;14;Maanantai;60;59;119;16;22;38
96;27.03.2017;2017;03;15;Maanantai;67;107;174;9;44;53
96;27.03.2017;2017;03;16;Maanantai;69;88;157;6;29;35
96;27.03.2017;2017;03;17;Maanantai;45;34;79;10;16;26
96;27.03.2017;2017;03;18;Maanantai;45;22;67;26;14;40
96;27.03.2017;2017;03;19;Maanantai;27;25;52;16;22;38
96;27.03.2017;2017;03;20;Maanantai;41;24;65;11;12;23
96;27.03.2017;2017;03;21;Maanantai;14;23;37;2;8;10
96;27.03.2017;2017;03;22;Maanantai;6;6;12;1;0;1
96;27.03.2017;2017;03;23;Maanantai;5;1;6;0;0;0
96;28.03.2017;2017;03;00;Tiistai;4;0;4;1;0;1
96;28.03.2017;2017;03;01;Tiistai;2;0;2;1;0;1
96;28.03.2017;2017;03;02;Tiistai;1;0;1;0;0;0
96;28.03.2017;2017;03;03;Tiistai;1;0;1;0;0;0
96;28.03.2017;2017;03;04;Tiistai;1;0;1;0;0;0
96;28.03.2017;2017;03;05;Tiistai;5;5;10;3;4;7
96;28.03.2017;2017;03;06;Tiistai;43;15;58;24;3;27
96;28.03.2017;2017;03;07;Tiistai;133;57;190;23;12;35
96;28.03.2017;2017;03;08;Tiistai;92;65;157;17;18;35
96;28.03.2017;2017;03;09;Tiistai;92;42;134;19;8;27
96;28.03.2017;2017;03;10;Tiistai;39;39;78;17;13;30
96;28.03.2017;2017;03;11;Tiistai;55;44;99;23;22;45
96;28.03.2017;2017;03;12;Tiistai;67;32;99;21;16;37
96;28.03.2017;2017;03;13;Tiistai;45;48;93;18;29;47
96;28.03.2017;2017;03;14;Tiistai;56;102;158;6;25;31
96;28.03.2017;2017;03;15;Tiistai;59;130;189;10;47;57
96;28.03.2017;2017;03;16;Tiistai;89;119;208;19;35;54
96;28.03.2017;2017;03;17;Tiistai;53;48;101;16;11;27
96;28.03.2017;2017;03;18;Tiistai;48;24;72;11;28;39
96;28.03.2017;2017;03;19;Tiistai;51;24;75;12;13;25
96;28.03.2017;2017;03;20;Tiistai;27;14;41;8;15;23
96;28.03.2017;2017;03;21;Tiistai;14;19;33;6;5;11
96;28.03.2017;2017;03;22;Tiistai;5;4;9;0;5;5
96;28.03.2017;2017;03;23;Tiistai;5;1;6;1;0;1
96;29.03.2017;2017;03;00;Keskiviikko;2;3;5;0;0;0
96;29.03.2017;2017;03;01;Keskiviikko;0;0;0;0;1;1
96;29.03.2017;2017;03;02;Keskiviikko;2;0;2;0;0;0
96;29.03.2017;2017;03;03;Keskiviikko;0;0;0;1;1;2
96;29.03.2017;2017;03;04;Keskiviikko;2;1;3;0;0;0
96;29.03.2017;2017;03;05;Keskiviikko;4;4;8;1;0;1
96;29.03.2017;2017;03;06;Keskiviikko;47;14;61;17;2;19
96;29.03.2017;2017;03;07;Keskiviikko;93;69;162;25;6;31
96;29.03.2017;2017;03;08;Keskiviikko;93;50;143;20;5;25
96;29.03.2017;2017;03;09;Keskiviikko;79;38;117;15;14;29
96;29.03.2017;2017;03;10;Keskiviikko;28;38;66;12;15;27
96;29.03.2017;2017;03;11;Keskiviikko;50;83;133;19;35;54
96;29.03.2017;2017;03;12;Keskiviikko;53;51;104;11;24;35
96;29.03.2017;2017;03;13;Keskiviikko;80;57;137;23;24;47
96;29.03.2017;2017;03;14;Keskiviikko;67;61;128;10;27;37
96;29.03.2017;2017;03;15;Keskiviikko;71;96;167;22;46;68
96;29.03.2017;2017;03;16;Keskiviikko;74;102;176;19;30;49
96;29.03.2017;2017;03;17;Keskiviikko;41;39;80;15;14;29
96;29.03.2017;2017;03;18;Keskiviikko;51;29;80;13;22;35
96;29.03.2017;2017;03;19;Keskiviikko;35;22;57;12;13;25
96;29.03.2017;2017;03;20;Keskiviikko;37;33;70;10;13;23
96;29.03.2017;2017;03;21;Keskiviikko;21;28;49;4;12;16
96;29.03.2017;2017;03;22;Keskiviikko;4;12;16;2;5;7
96;29.03.2017;2017;03;23;Keskiviikko;5;1;6;4;0;4
96;30.03.2017;2017;03;00;Torstai;2;1;3;0;0;0
96;30.03.2017;2017;03;01;Torstai;1;0;1;0;0;0
96;30.03.2017;2017;03;02;Torstai;1;0;1;0;0;0
96;30.03.2017;2017;03;03;Torstai;4;0;4;0;0;0
96;30.03.2017;2017;03;04;Torstai;4;1;5;0;1;1
96;30.03.2017;2017;03;05;Torstai;2;2;4;2;1;3
96;30.03.2017;2017;03;06;Torstai;50;12;62;17;3;20
96;30.03.2017;2017;03;07;Torstai;105;50;155;32;12;44
96;30.03.2017;2017;03;08;Torstai;82;62;144;12;14;26
96;30.03.2017;2017;03;09;Torstai;73;46;119;13;15;28
96;30.03.2017;2017;03;10;Torstai;49;37;86;10;18;28
96;30.03.2017;2017;03;11;Torstai;45;35;80;13;17;30
96;30.03.2017;2017;03;12;Torstai;59;52;111;14;16;30
96;30.03.2017;2017;03;13;Torstai;46;64;110;18;28;46
96;30.03.2017;2017;03;14;Torstai;56;78;134;19;37;56
96;30.03.2017;2017;03;15;Torstai;73;115;188;11;47;58
96;30.03.2017;2017;03;16;Torstai;64;83;147;24;24;48
96;30.03.2017;2017;03;17;Torstai;43;53;96;12;21;33
96;30.03.2017;2017;03;18;Torstai;28;34;62;22;22;44
96;30.03.2017;2017;03;19;Torstai;35;20;55;11;18;29
96;30.03.2017;2017;03;20;Torstai;30;26;56;12;10;22
96;30.03.2017;2017;03;21;Torstai;29;19;48;6;8;14
96;30.03.2017;2017;03;22;Torstai;11;9;20;0;2;2
96;30.03.2017;2017;03;23;Torstai;5;1;6;2;0;2
96;31.03.2017;2017;03;00;Perjantai;2;1;3;2;0;2
96;31.03.2017;2017;03;01;Perjantai;2;1;3;0;2;2
96;31.03.2017;2017;03;02;Perjantai;4;1;5;2;0;2
96;31.03.2017;2017;03;03;Perjantai;6;0;6;1;0;1
96;31.03.2017;2017;03;04;Perjantai;4;0;4;0;0;0
96;31.03.2017;2017;03;05;Perjantai;2;4;6;0;0;0
96;31.03.2017;2017;03;06;Perjantai;41;15;56;14;1;15
96;31.03.2017;2017;03;07;Perjantai;123;59;182;33;8;41
96;31.03.2017;2017;03;08;Perjantai;57;59;116;14;14;28
96;31.03.2017;2017;03;09;Perjantai;51;34;85;8;11;19
96;31.03.2017;2017;03;10;Perjantai;33;38;71;18;20;38
96;31.03.2017;2017;03;11;Perjantai;35;50;85;17;10;27
96;31.03.2017;2017;03;12;Perjantai;44;56;100;19;17;36
96;31.03.2017;2017;03;13;Perjantai;48;73;121;0;28;28
96;31.03.2017;2017;03;14;Perjantai;51;105;156;11;31;42
96;31.03.2017;2017;03;15;Perjantai;60;99;159;16;40;56
96;31.03.2017;2017;03;16;Perjantai;59;40;99;14;20;34
96;31.03.2017;2017;03;17;Perjantai;43;40;83;13;20;33
96;31.03.2017;2017;03;18;Perjantai;36;21;57;9;10;19
96;31.03.2017;2017;03;19;Perjantai;36;13;49;12;12;24
96;31.03.2017;2017;03;20;Perjantai;23;9;32;11;8;19
96;31.03.2017;2017;03;21;Perjantai;24;30;54;3;9;12
96;31.03.2017;2017;03;22;Perjantai;1;8;9;1;2;3
96;31.03.2017;2017;03;23;Perjantai;13;2;15;0;1;1
96;01.04.2017;2017;04;00;Lauantai;5;3;8;0;1;1
96;01.04.2017;2017;04;01;Lauantai;4;4;8;0;0;0
96;01.04.2017;2017;04;02;Lauantai;2;0;2;2;0;2
96;01.04.2017;2017;04;03;Lauantai;3;1;4;0;0;0
96;01.04.2017;2017;04;04;Lauantai;6;1;7;5;0;5
96;01.04.2017;2017;04;05;Lauantai;2;4;6;0;0;0
96;01.04.2017;2017;04;06;Lauantai;16;3;19;4;0;4
96;01.04.2017;2017;04;07;Lauantai;6;7;13;2;3;5
96;01.04.2017;2017;04;08;Lauantai;5;14;19;4;4;8
96;01.04.2017;2017;04;09;Lauantai;13;16;29;4;14;18
96;01.04.2017;2017;04;10;Lauantai;15;19;34;8;8;16
96;01.04.2017;2017;04;11;Lauantai;23;28;51;22;15;37
96;01.04.2017;2017;04;12;Lauantai;30;41;71;13;24;37
96;01.04.2017;2017;04;13;Lauantai;30;32;62;13;11;24
96;01.04.2017;2017;04;14;Lauantai;35;21;56;10;11;21
96;01.04.2017;2017;04;15;Lauantai;31;13;44;12;10;22
96;01.04.2017;2017;04;16;Lauantai;13;14;27;7;4;11
96;01.04.2017;2017;04;17;Lauantai;8;10;18;8;4;12
96;01.04.2017;2017;04;18;Lauantai;11;9;20;13;7;20
96;01.04.2017;2017;04;19;Lauantai;15;7;22;11;8;19
96;01.04.2017;2017;04;20;Lauantai;6;8;14;7;8;15
96;01.04.2017;2017;04;21;Lauantai;18;16;34;7;9;16
96;01.04.2017;2017;04;22;Lauantai;6;4;10;1;2;3
96;01.04.2017;2017;04;23;Lauantai;11;7;18;2;1;3
96;02.04.2017;2017;04;00;Sunnuntai;5;6;11;0;6;6
96;02.04.2017;2017;04;01;Sunnuntai;1;0;1;2;0;2
96;02.04.2017;2017;04;02;Sunnuntai;2;0;2;0;0;0
96;02.04.2017;2017;04;03;Sunnuntai;7;1;8;2;0;2
96;02.04.2017;2017;04;04;Sunnuntai;6;1;7;2;0;2
96;02.04.2017;2017;04;05;Sunnuntai;5;1;6;0;2;2
96;02.04.2017;2017;04;06;Sunnuntai;18;2;20;6;1;7
96;02.04.2017;2017;04;07;Sunnuntai;2;3;5;3;4;7
96;02.04.2017;2017;04;08;Sunnuntai;3;4;7;3;6;9
96;02.04.2017;2017;04;09;Sunnuntai;8;4;12;3;5;8
96;02.04.2017;2017;04;10;Sunnuntai;2;12;14;8;15;23
96;02.04.2017;2017;04;11;Sunnuntai;6;25;31;6;6;12
96;02.04.2017;2017;04;12;Sunnuntai;21;13;34;16;11;27
96;02.04.2017;2017;04;13;Sunnuntai;24;26;50;13;21;34
96;02.04.2017;2017;04;14;Sunnuntai;20;21;41;15;22;37
96;02.04.2017;2017;04;15;Sunnuntai;27;18;45;7;14;21
96;02.04.2017;2017;04;16;Sunnuntai;32;14;46;21;12;33
96;02.04.2017;2017;04;17;Sunnuntai;19;13;32;12;16;28
96;02.04.2017;2017;04;18;Sunnuntai;31;20;51;16;21;37
96;02.04.2017;2017;04;19;Sunnuntai;10;10;20;12;24;36
96;02.04.2017;2017;04;20;Sunnuntai;34;15;49;9;13;22
96;02.04.2017;2017;04;21;Sunnuntai;19;12;31;5;9;14
96;02.04.2017;2017;04;22;Sunnuntai;8;4;12;1;0;1
96;02.04.2017;2017;04;23;Sunnuntai;1;1;2;0;1;1
96;03.04.2017;2017;04;00;Maanantai;2;0;2;0;0;0
96;03.04.2017;2017;04;01;Maanantai;1;0;1;0;0;0
96;03.04.2017;2017;04;02;Maanantai;1;1;2;0;0;0
96;03.04.2017;2017;04;03;Maanantai;1;0;1;0;0;0
96;03.04.2017;2017;04;04;Maanantai;1;1;2;0;0;0
96;03.04.2017;2017;04;05;Maanantai;6;3;9;0;1;1
96;03.04.2017;2017;04;06;Maanantai;44;17;61;10;4;14
96;03.04.2017;2017;04;07;Maanantai;126;73;199;39;15;54
96;03.04.2017;2017;04;08;Maanantai;77;68;145;23;21;44
96;03.04.2017;2017;04;09;Maanantai;63;32;95;23;10;33
96;03.04.2017;2017;04;10;Maanantai;50;33;83;10;12;22
96;03.04.2017;2017;04;11;Maanantai;45;29;74;17;24;41
96;03.04.2017;2017;04;12;Maanantai;49;49;98;11;12;23
96;03.04.2017;2017;04;13;Maanantai;41;68;109;10;22;32
96;03.04.2017;2017;04;14;Maanantai;58;73;131;10;23;33
96;03.04.2017;2017;04;15;Maanantai;64;128;192;10;50;60
96;03.04.2017;2017;04;16;Maanantai;84;107;191;19;29;48
96;03.04.2017;2017;04;17;Maanantai;59;55;114;11;12;23
96;03.04.2017;2017;04;18;Maanantai;38;32;70;9;16;25
96;03.04.2017;2017;04;19;Maanantai;33;32;65;17;22;39
96;03.04.2017;2017;04;20;Maanantai;34;21;55;14;13;27
96;03.04.2017;2017;04;21;Maanantai;16;15;31;3;4;7
96;03.04.2017;2017;04;22;Maanantai;12;2;14;3;0;3
96;03.04.2017;2017;04;23;Maanantai;5;1;6;1;0;1
96;04.04.2017;2017;04;00;Tiistai;3;1;4;0;0;0
96;04.04.2017;2017;04;01;Tiistai;3;0;3;1;0;1
96;04.04.2017;2017;04;02;Tiistai;1;0;1;0;0;0
96;04.04.2017;2017;04;03;Tiistai;0;0;0;0;0;0
96;04.04.2017;2017;04;04;Tiistai;1;1;2;1;0;1
96;04.04.2017;2017;04;05;Tiistai;5;4;9;0;0;0
96;04.04.2017;2017;04;06;Tiistai;52;17;69;15;2;17
96;04.04.2017;2017;04;07;Tiistai;124;65;189;38;14;52
96;04.04.2017;2017;04;08;Tiistai;72;72;144;24;10;34
96;04.04.2017;2017;04;09;Tiistai;71;45;116;10;9;19
96;04.04.2017;2017;04;10;Tiistai;54;32;86;13;14;27
96;04.04.2017;2017;04;11;Tiistai;57;48;105;11;17;28
96;04.04.2017;2017;04;12;Tiistai;67;49;116;10;19;29
96;04.04.2017;2017;04;13;Tiistai;53;53;106;9;19;28
96;04.04.2017;2017;04;14;Tiistai;44;104;148;13;27;40
96;04.04.2017;2017;04;15;Tiistai;67;156;223;9;43;52
96;04.04.2017;2017;04;16;Tiistai;86;85;171;12;36;48
96;04.04.2017;2017;04;17;Tiistai;68;46;114;27;28;55
96;04.04.2017;2017;04;18;Tiistai;39;30;69;29;22;51
96;04.04.2017;2017;04;19;Tiistai;60;28;88;14;20;34
96;04.04.2017;2017;04;20;Tiistai;44;15;59;14;19;33
96;04.04.2017;2017;04;21;Tiistai;23;30;53;4;8;12
96;04.04.2017;2017;04;22;Tiistai;6;10;16;4;1;5
96;04.04.2017;2017;04;23;Tiistai;4;0;4;1;1;2
96;05.04.2017;2017;04;00;Keskiviikko;3;0;3;1;1;2
96;05.04.2017;2017;04;01;Keskiviikko;2;1;3;0;0;0
96;05.04.2017;2017;04;02;Keskiviikko;1;0;1;0;0;0
96;05.04.2017;2017;04;03;Keskiviikko;1;0;1;0;0;0
96;05.04.2017;2017;04;04;Keskiviikko;1;1;2;2;0;2
96;05.04.2017;2017;04;05;Keskiviikko;6;3;9;0;0;0
96;05.04.2017;2017;04;06;Keskiviikko;43;19;62;15;2;17
96;05.04.2017;2017;04;07;Keskiviikko;124;77;201;37;13;50
96;05.04.2017;2017;04;08;Keskiviikko;103;68;171;22;5;27
96;05.04.2017;2017;04;09;Keskiviikko;48;43;91;6;15;21
96;05.04.2017;2017;04;10;Keskiviikko;34;50;84;17;17;34
96;05.04.2017;2017;04;11;Keskiviikko;64;46;110;22;9;31
96;05.04.2017;2017;04;12;Keskiviikko;66;67;133;18;21;39
96;05.04.2017;2017;04;13;Keskiviikko;80;66;146;20;25;45
96;05.04.2017;2017;04;14;Keskiviikko;65;116;181;13;32;45
96;05.04.2017;2017;04;15;Keskiviikko;59;131;190;13;45;58
96;05.04.2017;2017;04;16;Keskiviikko;77;120;197;19;31;50
96;05.04.2017;2017;04;17;Keskiviikko;52;65;117;14;19;33
96;05.04.2017;2017;04;18;Keskiviikko;80;29;109;40;15;55
96;05.04.2017;2017;04;19;Keskiviikko;49;36;85;14;12;26
96;05.04.2017;2017;04;20;Keskiviikko;36;30;66;10;10;20
96;05.04.2017;2017;04;21;Keskiviikko;13;34;47;4;10;14
96;05.04.2017;2017;04;22;Keskiviikko;5;7;12;3;3;6
96;05.04.2017;2017;04;23;Keskiviikko;3;1;4;2;0;2
96;06.04.2017;2017;04;00;Torstai;0;0;0;2;0;2
96;06.04.2017;2017;04;01;Torstai;1;2;3;1;0;1
96;06.04.2017;2017;04;02;Torstai;1;0;1;1;0;1
96;06.04.2017;2017;04;03;Torstai;4;0;4;1;0;1
96;06.04.2017;2017;04;04;Torstai;1;1;2;0;0;0
96;06.04.2017;2017;04;05;Torstai;5;5;10;1;1;2
96;06.04.2017;2017;04;06;Torstai;47;21;68;11;1;12
96;06.04.2017;2017;04;07;Torstai;118;70;188;30;13;43
96;06.04.2017;2017;04;08;Torstai;99;84;183;20;11;31
96;06.04.2017;2017;04;09;Torstai;71;30;101;17;9;26
96;06.04.2017;2017;04;10;Torstai;41;39;80;10;11;21
96;06.04.2017;2017;04;11;Torstai;39;42;81;9;12;21
96;06.04.2017;2017;04;12;Torstai;50;56;106;21;13;34
96;06.04.2017;2017;04;13;Torstai;56;72;128;14;21;35
96;06.04.2017;2017;04;14;Torstai;52;100;152;8;25;33
96;06.04.2017;2017;04;15;Torstai;62;143;205;15;34;49
96;06.04.2017;2017;04;16;Torstai;63;97;160;9;19;28
96;06.04.2017;2017;04;17;Torstai;47;44;91;24;13;37
96;06.04.2017;2017;04;18;Torstai;45;46;91;23;21;44
96;06.04.2017;2017;04;19;Torstai;40;28;68;12;15;27
96;06.04.2017;2017;04;20;Torstai;35;24;59;14;11;25
96;06.04.2017;2017;04;21;Torstai;21;24;45;4;11;15
96;06.04.2017;2017;04;22;Torstai;12;7;19;1;3;4
96;06.04.2017;2017;04;23;Torstai;3;5;8;3;2;5
96;07.04.2017;2017;04;00;Perjantai;3;0;3;0;0;0
96;07.04.2017;2017;04;01;Perjantai;3;0;3;0;0;0
96;07.04.2017;2017;04;02;Perjantai;5;0;5;0;0;0
96;07.04.2017;2017;04;03;Perjantai;0;1;1;0;0;0
96;07.04.2017;2017;04;04;Perjantai;3;2;5;1;0;1
96;07.04.2017;2017;04;05;Perjantai;2;4;6;0;0;0
96;07.04.2017;2017;04;06;Perjantai;38;14;52;9;2;11
96;07.04.2017;2017;04;07;Perjantai;120;61;181;30;10;40
96;07.04.2017;2017;04;08;Perjantai;74;57;131;14;7;21
96;07.04.2017;2017;04;09;Perjantai;51;55;106;23;37;60
96;07.04.2017;2017;04;10;Perjantai;39;44;83;9;12;21
96;07.04.2017;2017;04;11;Perjantai;41;57;98;44;6;50
96;07.04.2017;2017;04;12;Perjantai;57;59;116;10;15;25
96;07.04.2017;2017;04;13;Perjantai;50;58;108;8;21;29
96;07.04.2017;2017;04;14;Perjantai;46;125;171;4;30;34
96;07.04.2017;2017;04;15;Perjantai;68;103;171;17;39;56
96;07.04.2017;2017;04;16;Perjantai;67;68;135;8;16;24
96;07.04.2017;2017;04;17;Perjantai;48;30;78;8;11;19
96;07.04.2017;2017;04;18;Perjantai;36;15;51;4;9;13
96;07.04.2017;2017;04;19;Perjantai;28;18;46;6;11;17
96;07.04.2017;2017;04;20;Perjantai;29;20;49;14;10;24
96;07.04.2017;2017;04;21;Perjantai;21;17;38;1;9;10
96;07.04.2017;2017;04;22;Perjantai;7;10;17;2;0;2
96;07.04.2017;2017;04;23;Perjantai;8;2;10;2;0;2
96;08.04.2017;2017;04;00;Lauantai;4;4;8;2;0;2
96;08.04.2017;2017;04;01;Lauantai;2;0;2;0;0;0
96;08.04.2017;2017;04;02;Lauantai;4;0;4;0;0;0
96;08.04.2017;2017;04;03;Lauantai;11;2;13;1;0;1
96;08.04.2017;2017;04;04;Lauantai;3;0;3;0;1;1
96;08.04.2017;2017;04;05;Lauantai;1;1;2;2;0;2
96;08.04.2017;2017;04;06;Lauantai;25;7;32;2;1;3
96;08.04.2017;2017;04;07;Lauantai;1;9;10;2;6;8
96;08.04.2017;2017;04;08;Lauantai;4;20;24;3;7;10
96;08.04.2017;2017;04;09;Lauantai;10;29;39;4;11;15
96;08.04.2017;2017;04;10;Lauantai;20;37;57;11;8;19
96;08.04.2017;2017;04;11;Lauantai;37;30;67;13;18;31
96;08.04.2017;2017;04;12;Lauantai;42;56;98;12;22;34
96;08.04.2017;2017;04;13;Lauantai;50;50;100;23;13;36
96;08.04.2017;2017;04;14;Lauantai;53;50;103;16;10;26
96;08.04.2017;2017;04;15;Lauantai;55;38;93;18;16;34
96;08.04.2017;2017;04;16;Lauantai;46;21;67;10;18;28
96;08.04.2017;2017;04;17;Lauantai;22;13;35;7;14;21
96;08.04.2017;2017;04;18;Lauantai;39;17;56;22;13;35
96;08.04.2017;2017;04;19;Lauantai;15;12;27;8;5;13
96;08.04.2017;2017;04;20;Lauantai;9;21;30;13;9;22
96;08.04.2017;2017;04;21;Lauantai;10;23;33;7;6;13
96;08.04.2017;2017;04;22;Lauantai;5;2;7;2;4;6
96;08.04.2017;2017;04;23;Lauantai;12;10;22;1;0;1
96;09.04.2017;2017;04;00;Sunnuntai;7;4;11;1;0;1
96;09.04.2017;2017;04;01;Sunnuntai;7;5;12;3;0;3
96;09.04.2017;2017;04;02;Sunnuntai;13;0;13;2;0;2
96;09.04.2017;2017;04;03;Sunnuntai;7;0;7;5;0;5
96;09.04.2017;2017;04;04;Sunnuntai;6;1;7;2;1;3
96;09.04.2017;2017;04;05;Sunnuntai;2;1;3;1;0;1
96;09.04.2017;2017;04;06;Sunnuntai;18;4;22;5;0;5
96;09.04.2017;2017;04;07;Sunnuntai;5;5;10;0;6;6
96;09.04.2017;2017;04;08;Sunnuntai;2;6;8;3;3;6
96;09.04.2017;2017;04;09;Sunnuntai;4;11;15;6;6;12
96;09.04.2017;2017;04;10;Sunnuntai;13;21;34;8;10;18
96;09.04.2017;2017;04;11;Sunnuntai;9;31;40;6;11;17
96;09.04.2017;2017;04;12;Sunnuntai;32;27;59;6;13;19
96;09.04.2017;2017;04;13;Sunnuntai;44;23;67;12;16;28
96;09.04.2017;2017;04;14;Sunnuntai;17;25;42;5;13;18
96;09.04.2017;2017;04;15;Sunnuntai;22;40;62;9;8;17
96;09.04.2017;2017;04;16;Sunnuntai;50;15;65;37;11;48
96;09.04.2017;2017;04;17;Sunnuntai;17;24;41;20;9;29
96;09.04.2017;2017;04;18;Sunnuntai;39;28;67;25;16;41
96;09.04.2017;2017;04;19;Sunnuntai;22;23;45;8;18;26
96;09.04.2017;2017;04;20;Sunnuntai;16;22;38;7;12;19
96;09.04.2017;2017;04;21;Sunnuntai;8;16;24;5;4;9
96;09.04.2017;2017;04;22;Sunnuntai;4;9;13;0;1;1
96;09.04.2017;2017;04;23;Sunnuntai;5;0;5;1;0;1
96;10.04.2017;2017;04;00;Maanantai;4;2;6;1;0;1
96;10.04.2017;2017;04;01;Maanantai;0;0;0;0;0;0
96;10.04.2017;2017;04;02;Maanantai;0;0;0;1;0;1
96;10.04.2017;2017;04;03;Maanantai;3;0;3;0;0;0
96;10.04.2017;2017;04;04;Maanantai;1;1;2;0;0;0
96;10.04.2017;2017;04;05;Maanantai;1;4;5;2;1;3
96;10.04.2017;2017;04;06;Maanantai;48;17;65;10;2;12
96;10.04.2017;2017;04;07;Maanantai;120;70;190;23;12;35
96;10.04.2017;2017;04;08;Maanantai;84;85;169;17;12;29
96;10.04.2017;2017;04;09;Maanantai;45;42;87;13;8;21
96;10.04.2017;2017;04;10;Maanantai;37;32;69;9;9;18
96;10.04.2017;2017;04;11;Maanantai;34;44;78;20;14;34
96;10.04.2017;2017;04;12;Maanantai;50;41;91;10;10;20
96;10.04.2017;2017;04;13;Maanantai;36;50;86;9;9;18
96;10.04.2017;2017;04;14;Maanantai;51;87;138;6;25;31
96;10.04.2017;2017;04;15;Maanantai;44;147;191;3;26;29
96;10.04.2017;2017;04;16;Maanantai;67;88;155;10;17;27
96;10.04.2017;2017;04;17;Maanantai;39;45;84;4;2;6
96;10.04.2017;2017;04;18;Maanantai;24;13;37;6;9;15
96;10.04.2017;2017;04;19;Maanantai;28;25;53;8;12;20
96;10.04.2017;2017;04;20;Maanantai;23;21;44;6;6;12
96;10.04.2017;2017;04;21;Maanantai;11;20;31;2;4;6
96;10.04.2017;2017;04;22;Maanantai;0;3;3;1;0;1
96;10.04.2017;2017;04;23;Maanantai;4;1;5;0;0;0
96;11.04.2017;2017;04;00;Tiistai;1;0;1;0;2;2
96;11.04.2017;2017;04;01;Tiistai;1;2;3;0;0;0
96;11.04.2017;2017;04;02;Tiistai;0;0;0;2;1;3
96;11.04.2017;2017;04;03;Tiistai;2;1;3;0;1;1
96;11.04.2017;2017;04;04;Tiistai;1;1;2;0;0;0
96;11.04.2017;2017;04;05;Tiistai;4;3;7;0;0;0
96;11.04.2017;2017;04;06;Tiistai;37;23;60;17;5;22
96;11.04.2017;2017;04;07;Tiistai;67;58;125;21;10;31
96;11.04.2017;2017;04;08;Tiistai;66;50;116;14;6;20
96;11.04.2017;2017;04;09;Tiistai;62;35;97;13;5;18
96;11.04.2017;2017;04;10;Tiistai;36;26;62;11;16;27
96;11.04.2017;2017;04;11;Tiistai;49;23;72;15;12;27
96;11.04.2017;2017;04;12;Tiistai;43;30;73;7;4;11
96;11.04.2017;2017;04;13;Tiistai;29;44;73;8;18;26
96;11.04.2017;2017;04;14;Tiistai;32;80;112;9;17;26
96;11.04.2017;2017;04;15;Tiistai;42;122;164;7;28;35
96;11.04.2017;2017;04;16;Tiistai;51;76;127;6;19;25
96;11.04.2017;2017;04;17;Tiistai;31;53;84;15;17;32
96;11.04.2017;2017;04;18;Tiistai;26;20;46;15;22;37
96;11.04.2017;2017;04;19;Tiistai;31;16;47;7;16;23
96;11.04.2017;2017;04;20;Tiistai;30;19;49;9;12;21
96;11.04.2017;2017;04;21;Tiistai;11;27;38;3;4;7
96;11.04.2017;2017;04;22;Tiistai;6;6;12;1;2;3
96;11.04.2017;2017;04;23;Tiistai;3;2;5;0;1;1
96;12.04.2017;2017;04;00;Keskiviikko;2;3;5;1;1;2
96;12.04.2017;2017;04;01;Keskiviikko;0;0;0;0;0;0
96;12.04.2017;2017;04;02;Keskiviikko;1;0;1;0;0;0
96;12.04.2017;2017;04;03;Keskiviikko;4;0;4;0;0;0
96;12.04.2017;2017;04;04;Keskiviikko;1;1;2;0;1;1
96;12.04.2017;2017;04;05;Keskiviikko;3;5;8;0;0;0
96;12.04.2017;2017;04;06;Keskiviikko;42;17;59;17;2;19
96;12.04.2017;2017;04;07;Keskiviikko;97;82;179;37;10;47
96;12.04.2017;2017;04;08;Keskiviikko;83;59;142;18;11;29
96;12.04.2017;2017;04;09;Keskiviikko;77;40;117;12;13;25
96;12.04.2017;2017;04;10;Keskiviikko;36;60;96;7;12;19
96;12.04.2017;2017;04;11;Keskiviikko;48;54;102;21;26;47
96;12.04.2017;2017;04;12;Keskiviikko;68;43;111;20;11;31
96;12.04.2017;2017;04;13;Keskiviikko;64;73;137;11;25;36
96;12.04.2017;2017;04;14;Keskiviikko;48;92;140;10;18;28
96;12.04.2017;2017;04;15;Keskiviikko;57;135;192;12;35;47
96;12.04.2017;2017;04;16;Keskiviikko;92;124;216;8;24;32
96;12.04.2017;2017;04;17;Keskiviikko;52;52;104;7;16;23
96;12.04.2017;2017;04;18;Keskiviikko;55;39;94;26;14;40
96;12.04.2017;2017;04;19;Keskiviikko;49;24;73;14;14;28
96;12.04.2017;2017;04;20;Keskiviikko;40;23;63;10;7;17
96;12.04.2017;2017;04;21;Keskiviikko;13;35;48;4;5;9
96;12.04.2017;2017;04;22;Keskiviikko;5;8;13;0;1;1
96;12.04.2017;2017;04;23;Keskiviikko;7;0;7;2;1;3
96;13.04.2017;2017;04;00;Torstai;3;0;3;0;0;0
96;13.04.2017;2017;04;01;Torstai;1;0;1;3;1;4
96;13.04.2017;2017;04;02;Torstai;3;0;3;1;0;1
96;13.04.2017;2017;04;03;Torstai;4;0;4;0;0;0
96;13.04.2017;2017;04;04;Torstai;5;1;6;0;1;1
96;13.04.2017;2017;04;05;Torstai;1;4;5;0;1;1
96;13.04.2017;2017;04;06;Torstai;38;14;52;17;3;20
96;13.04.2017;2017;04;07;Torstai;63;66;129;22;14;36
96;13.04.2017;2017;04;08;Torstai;56;48;104;15;3;18
96;13.04.2017;2017;04;09;Torstai;39;35;74;10;9;19
96;13.04.2017;2017;04;10;Torstai;58;36;94;7;11;18
96;13.04.2017;2017;04;11;Torstai;36;46;82;9;16;25
96;13.04.2017;2017;04;12;Torstai;47;51;98;12;11;23
96;13.04.2017;2017;04;13;Torstai;53;64;117;7;18;25
96;13.04.2017;2017;04;14;Torstai;53;93;146;7;28;35
96;13.04.2017;2017;04;15;Torstai;39;87;126;9;30;39
96;13.04.2017;2017;04;16;Torstai;51;64;115;8;11;19
96;13.04.2017;2017;04;17;Torstai;25;29;54;6;10;16
96;13.04.2017;2017;04;18;Torstai;25;19;44;14;8;22
96;13.04.2017;2017;04;19;Torstai;30;17;47;5;11;16
96;13.04.2017;2017;04;20;Torstai;19;11;30;4;4;8
96;13.04.2017;2017;04;21;Torstai;6;15;21;1;5;6
96;13.04.2017;2017;04;22;Torstai;6;9;15;1;3;4
96;13.04.2017;2017;04;23;Torstai;6;2;8;3;1;4
96;14.04.2017;2017;04;00;Perjantai;2;0;2;0;0;0
96;14.04.2017;2017;04;01;Perjantai;3;1;4;1;3;4
96;14.04.2017;2017;04;02;Perjantai;5;0;5;0;0;0
96;14.04.2017;2017;04;03;Perjantai;3;2;5;2;0;2
96;14.04.2017;2017;04;04;Perjantai;5;0;5;3;0;3
96;14.04.2017;2017;04;05;Perjantai;1;1;2;0;1;1
96;14.04.2017;2017;04;06;Perjantai;15;3;18;4;0;4
96;14.04.2017;2017;04;07;Perjantai;2;7;9;1;1;2
96;14.04.2017;2017;04;08;Perjantai;2;5;7;3;5;8
96;14.04.2017;2017;04;09;Perjantai;6;7;13;8;6;14
96;14.04.2017;2017;04;10;Perjantai;8;13;21;10;16;26
96;14.04.2017;2017;04;11;Perjantai;11;16;27;15;15;30
96;14.04.2017;2017;04;12;Perjantai;24;22;46;13;8;21
96;14.04.2017;2017;04;13;Perjantai;20;9;29;7;10;17
96;14.04.2017;2017;04;14;Perjantai;12;26;38;8;8;16
96;14.04.2017;2017;04;15;Perjantai;17;25;42;9;8;17
96;14.04.2017;2017;04;16;Perjantai;19;14;33;7;4;11
96;14.04.2017;2017;04;17;Perjantai;15;13;28;4;4;8
96;14.04.2017;2017;04;18;Perjantai;13;18;31;11;11;22
96;14.04.2017;2017;04;19;Perjantai;7;15;22;5;8;13
96;14.04.2017;2017;04;20;Perjantai;8;12;20;4;4;8
96;14.04.2017;2017;04;21;Perjantai;11;16;27;1;6;7
96;14.04.2017;2017;04;22;Perjantai;5;15;20;0;3;3
96;14.04.2017;2017;04;23;Perjantai;3;8;11;3;3;6
96;15.04.2017;2017;04;00;Lauantai;12;0;12;5;0;5
96;15.04.2017;2017;04;01;Lauantai;2;0;2;2;1;3
96;15.04.2017;2017;04;02;Lauantai;5;1;6;1;0;1
96;15.04.2017;2017;04;03;Lauantai;4;4;8;0;0;0
96;15.04.2017;2017;04;04;Lauantai;5;1;6;0;0;0
96;15.04.2017;2017;04;05;Lauantai;1;1;2;0;0;0
96;15.04.2017;2017;04;06;Lauantai;19;4;23;4;1;5
96;15.04.2017;2017;04;07;Lauantai;3;7;10;3;3;6
96;15.04.2017;2017;04;08;Lauantai;2;6;8;2;5;7
96;15.04.2017;2017;04;09;Lauantai;7;13;20;3;3;6
96;15.04.2017;2017;04;10;Lauantai;10;14;24;2;7;9
96;15.04.2017;2017;04;11;Lauantai;13;17;30;5;6;11
96;15.04.2017;2017;04;12;Lauantai;20;12;32;6;7;13
96;15.04.2017;2017;04;13;Lauantai;21;18;39;4;13;17
96;15.04.2017;2017;04;14;Lauantai;13;32;45;7;9;16
96;15.04.2017;2017;04;15;Lauantai;26;28;54;7;5;12
96;15.04.2017;2017;04;16;Lauantai;18;11;29;7;7;14
96;15.04.2017;2017;04;17;Lauantai;14;17;31;8;8;16
96;15.04.2017;2017;04;18;Lauantai;7;19;26;6;2;8
96;15.04.2017;2017;04;19;Lauantai;21;9;30;6;5;11
96;15.04.2017;2017;04;20;Lauantai;18;14;32;9;6;15
96;15.04.2017;2017;04;21;Lauantai;7;18;25;4;4;8
96;15.04.2017;2017;04;22;Lauantai;6;7;13;3;2;5
96;15.04.2017;2017;04;23;Lauantai;4;12;16;1;0;1
96;16.04.2017;2017;04;00;Sunnuntai;2;6;8;2;0;2
96;16.04.2017;2017;04;01;Sunnuntai;3;1;4;3;1;4
96;16.04.2017;2017;04;02;Sunnuntai;5;1;6;3;0;3
96;16.04.2017;2017;04;03;Sunnuntai;3;0;3;1;0;1
96;16.04.2017;2017;04;04;Sunnuntai;7;1;8;2;0;2
96;16.04.2017;2017;04;05;Sunnuntai;1;1;2;0;0;0
96;16.04.2017;2017;04;06;Sunnuntai;17;1;18;4;0;4
96;16.04.2017;2017;04;07;Sunnuntai;4;4;8;0;1;1
96;16.04.2017;2017;04;08;Sunnuntai;4;4;8;1;3;4
96;16.04.2017;2017;04;09;Sunnuntai;3;1;4;4;3;7
96;16.04.2017;2017;04;10;Sunnuntai;6;14;20;6;12;18
96;16.04.2017;2017;04;11;Sunnuntai;15;20;35;12;8;20
96;16.04.2017;2017;04;12;Sunnuntai;25;20;45;14;25;39
96;16.04.2017;2017;04;13;Sunnuntai;34;34;68;12;17;29
96;16.04.2017;2017;04;14;Sunnuntai;25;29;54;15;17;32
96;16.04.2017;2017;04;15;Sunnuntai;19;27;46;17;10;27
96;16.04.2017;2017;04;16;Sunnuntai;18;16;34;22;6;28
96;16.04.2017;2017;04;17;Sunnuntai;20;21;41;7;6;13
96;16.04.2017;2017;04;18;Sunnuntai;7;16;23;11;9;20
96;16.04.2017;2017;04;19;Sunnuntai;12;21;33;4;13;17
96;16.04.2017;2017;04;20;Sunnuntai;21;22;43;4;2;6
96;16.04.2017;2017;04;21;Sunnuntai;12;19;31;3;3;6
96;16.04.2017;2017;04;22;Sunnuntai;7;5;12;2;1;3
96;16.04.2017;2017;04;23;Sunnuntai;2;5;7;3;2;5
96;17.04.2017;2017;04;00;Maanantai;7;0;7;3;0;3
96;17.04.2017;2017;04;01;Maanantai;1;0;1;1;3;4
96;17.04.2017;2017;04;02;Maanantai;2;0;2;1;0;1
96;17.04.2017;2017;04;03;Maanantai;4;0;4;1;1;2
96;17.04.2017;2017;04;04;Maanantai;3;0;3;0;3;3
96;17.04.2017;2017;04;05;Maanantai;1;1;2;1;0;1
96;17.04.2017;2017;04;06;Maanantai;16;5;21;5;0;5
96;17.04.2017;2017;04;07;Maanantai;2;8;10;1;5;6
96;17.04.2017;2017;04;08;Maanantai;4;9;13;4;2;6
96;17.04.2017;2017;04;09;Maanantai;6;5;11;2;4;6
96;17.04.2017;2017;04;10;Maanantai;19;17;36;11;13;24
96;17.04.2017;2017;04;11;Maanantai;13;18;31;3;9;12
96;17.04.2017;2017;04;12;Maanantai;31;25;56;14;17;31
96;17.04.2017;2017;04;13;Maanantai;34;27;61;17;10;27
96;17.04.2017;2017;04;14;Maanantai;28;58;86;5;14;19
96;17.04.2017;2017;04;15;Maanantai;27;23;50;10;12;22
96;17.04.2017;2017;04;16;Maanantai;32;23;55;17;10;27
96;17.04.2017;2017;04;17;Maanantai;27;28;55;16;9;25
96;17.04.2017;2017;04;18;Maanantai;23;18;41;23;17;40
96;17.04.2017;2017;04;19;Maanantai;26;18;44;12;20;32
96;17.04.2017;2017;04;20;Maanantai;18;12;30;7;6;13
96;17.04.2017;2017;04;21;Maanantai;8;23;31;10;7;17
96;17.04.2017;2017;04;22;Maanantai;1;3;4;1;0;1
96;17.04.2017;2017;04;23;Maanantai;7;3;10;1;0;1
96;18.04.2017;2017;04;00;Tiistai;2;2;4;3;0;3
96;18.04.2017;2017;04;01;Tiistai;2;0;2;0;1;1
96;18.04.2017;2017;04;02;Tiistai;0;1;1;0;0;0
96;18.04.2017;2017;04;03;Tiistai;0;2;2;0;0;0
96;18.04.2017;2017;04;04;Tiistai;1;2;3;0;1;1
96;18.04.2017;2017;04;05;Tiistai;4;6;10;0;0;0
96;18.04.2017;2017;04;06;Tiistai;50;25;75;10;0;10
96;18.04.2017;2017;04;07;Tiistai;97;83;180;29;17;46
96;18.04.2017;2017;04;08;Tiistai;78;79;157;14;14;28
96;18.04.2017;2017;04;09;Tiistai;62;61;123;18;13;31
96;18.04.2017;2017;04;10;Tiistai;57;39;96;9;14;23
96;18.04.2017;2017;04;11;Tiistai;52;60;112;11;22;33
96;18.04.2017;2017;04;12;Tiistai;71;64;135;22;24;46
96;18.04.2017;2017;04;13;Tiistai;55;60;115;13;17;30
96;18.04.2017;2017;04;14;Tiistai;58;114;172;13;22;35
96;18.04.2017;2017;04;15;Tiistai;88;167;255;12;33;45
96;18.04.2017;2017;04;16;Tiistai;97;116;213;16;20;36
96;18.04.2017;2017;04;17;Tiistai;65;64;129;30;13;43
96;18.04.2017;2017;04;18;Tiistai;54;35;89;20;23;43
96;18.04.2017;2017;04;19;Tiistai;65;34;99;18;16;34
96;18.04.2017;2017;04;20;Tiistai;43;25;68;11;17;28
96;18.04.2017;2017;04;21;Tiistai;23;33;56;5;15;20
96;18.04.2017;2017;04;22;Tiistai;5;5;10;1;3;4
96;18.04.2017;2017;04;23;Tiistai;4;0;4;0;1;1
96;19.04.2017;2017;04;00;Keskiviikko;4;2;6;0;0;0
96;19.04.2017;2017;04;01;Keskiviikko;0;0;0;0;0;0
96;19.04.2017;2017;04;02;Keskiviikko;0;0;0;0;0;0
96;19.04.2017;2017;04;03;Keskiviikko;1;0;1;0;0;0
96;19.04.2017;2017;04;04;Keskiviikko;1;1;2;0;1;1
96;19.04.2017;2017;04;05;Keskiviikko;5;7;12;2;1;3
96;19.04.2017;2017;04;06;Keskiviikko;48;22;70;9;3;12
96;19.04.2017;2017;04;07;Keskiviikko;103;103;206;28;11;39
96;19.04.2017;2017;04;08;Keskiviikko;108;74;182;23;13;36
96;19.04.2017;2017;04;09;Keskiviikko;88;88;176;12;11;23
96;19.04.2017;2017;04;10;Keskiviikko;39;57;96;10;15;25
96;19.04.2017;2017;04;11;Keskiviikko;54;51;105;9;21;30
96;19.04.2017;2017;04;12;Keskiviikko;83;55;138;13;10;23
96;19.04.2017;2017;04;13;Keskiviikko;73;84;157;11;20;31
96;19.04.2017;2017;04;14;Keskiviikko;52;120;172;7;15;22
96;19.04.2017;2017;04;15;Keskiviikko;122;160;282;12;38;50
96;19.04.2017;2017;04;16;Keskiviikko;87;112;199;16;18;34
96;19.04.2017;2017;04;17;Keskiviikko;56;55;111;16;18;34
96;19.04.2017;2017;04;18;Keskiviikko;70;37;107;19;18;37
96;19.04.2017;2017;04;19;Keskiviikko;54;27;81;21;14;35
96;19.04.2017;2017;04;20;Keskiviikko;45;28;73;7;27;34
96;19.04.2017;2017;04;21;Keskiviikko;23;37;60;6;5;11
96;19.04.2017;2017;04;22;Keskiviikko;10;7;17;5;6;11
96;19.04.2017;2017;04;23;Keskiviikko;7;5;12;0;2;2
96;20.04.2017;2017;04;00;Torstai;3;2;5;1;0;1
96;20.04.2017;2017;04;01;Torstai;3;0;3;0;0;0
96;20.04.2017;2017;04;02;Torstai;2;0;2;1;0;1
96;20.04.2017;2017;04;03;Torstai;5;0;5;0;1;1
96;20.04.2017;2017;04;04;Torstai;1;1;2;0;0;0
96;20.04.2017;2017;04;05;Torstai;7;8;15;0;1;1
96;20.04.2017;2017;04;06;Torstai;43;24;67;10;4;14
96;20.04.2017;2017;04;07;Torstai;109;94;203;22;18;40
96;20.04.2017;2017;04;08;Torstai;88;95;183;18;10;28
96;20.04.2017;2017;04;09;Torstai;97;55;152;8;8;16
96;20.04.2017;2017;04;10;Torstai;62;36;98;21;13;34
96;20.04.2017;2017;04;11;Torstai;49;51;100;16;14;30
96;20.04.2017;2017;04;12;Torstai;62;74;136;11;19;30
96;20.04.2017;2017;04;13;Torstai;51;78;129;10;16;26
96;20.04.2017;2017;04;14;Torstai;59;115;174;10;18;28
96;20.04.2017;2017;04;15;Torstai;59;149;208;9;14;23
96;20.04.2017;2017;04;16;Torstai;64;69;133;5;15;20
96;20.04.2017;2017;04;17;Torstai;32;50;82;5;8;13
96;20.04.2017;2017;04;18;Torstai;27;16;43;12;2;14
96;20.04.2017;2017;04;19;Torstai;24;18;42;2;7;9
96;20.04.2017;2017;04;20;Torstai;27;19;46;6;6;12
96;20.04.2017;2017;04;21;Torstai;15;21;36;6;4;10
96;20.04.2017;2017;04;22;Torstai;3;5;8;1;5;6
96;20.04.2017;2017;04;23;Torstai;6;3;9;2;0;2
96;21.04.2017;2017;04;00;Perjantai;1;0;1;2;0;2
96;21.04.2017;2017;04;01;Perjantai;0;1;1;1;2;3
96;21.04.2017;2017;04;02;Perjantai;2;2;4;3;0;3
96;21.04.2017;2017;04;03;Perjantai;7;0;7;0;0;0
96;21.04.2017;2017;04;04;Perjantai;1;1;2;0;0;0
96;21.04.2017;2017;04;05;Perjantai;0;5;5;0;0;0
96;21.04.2017;2017;04;06;Perjantai;47;19;66;8;3;11
96;21.04.2017;2017;04;07;Perjantai;110;94;204;22;7;29
96;21.04.2017;2017;04;08;Perjantai;60;69;129;13;7;20
96;21.04.2017;2017;04;09;Perjantai;48;54;102;10;8;18
96;21.04.2017;2017;04;10;Perjantai;38;39;77;11;6;17
96;21.04.2017;2017;04;11;Perjantai;46;53;99;12;12;24
96;21.04.2017;2017;04;12;Perjantai;52;78;130;5;24;29
96;21.04.2017;2017;04;13;Perjantai;63;69;132;14;19;33
96;21.04.2017;2017;04;14;Perjantai;82;107;189;9;29;38
96;21.04.2017;2017;04;15;Perjantai;84;140;224;7;27;34
96;21.04.2017;2017;04;16;Perjantai;80;58;138;10;14;24
96;21.04.2017;2017;04;17;Perjantai;50;46;96;18;24;42
96;21.04.2017;2017;04;18;Perjantai;38;28;66;12;14;26
96;21.04.2017;2017;04;19;Perjantai;27;31;58;3;5;8
96;21.04.2017;2017;04;20;Perjantai;22;22;44;6;3;9
96;21.04.2017;2017;04;21;Perjantai;23;19;42;3;6;9
96;21.04.2017;2017;04;22;Perjantai;5;3;8;0;2;2
96;21.04.2017;2017;04;23;Perjantai;10;4;14;4;3;7
96;22.04.2017;2017;04;00;Lauantai;4;4;8;1;0;1
96;22.04.2017;2017;04;01;Lauantai;7;2;9;2;2;4
96;22.04.2017;2017;04;02;Lauantai;3;0;3;1;0;1
96;22.04.2017;2017;04;03;Lauantai;7;0;7;1;0;1
96;22.04.2017;2017;04;04;Lauantai;6;0;6;1;0;1
96;22.04.2017;2017;04;05;Lauantai;1;3;4;1;0;1
96;22.04.2017;2017;04;06;Lauantai;13;4;17;4;0;4
96;22.04.2017;2017;04;07;Lauantai;2;15;17;2;3;5
96;22.04.2017;2017;04;08;Lauantai;8;21;29;9;4;13
96;22.04.2017;2017;04;09;Lauantai;11;20;31;5;9;14
96;22.04.2017;2017;04;10;Lauantai;18;47;65;10;12;22
96;22.04.2017;2017;04;11;Lauantai;27;43;70;6;11;17
96;22.04.2017;2017;04;12;Lauantai;43;43;86;20;14;34
96;22.04.2017;2017;04;13;Lauantai;53;44;97;15;15;30
96;22.04.2017;2017;04;14;Lauantai;29;42;71;9;13;22
96;22.04.2017;2017;04;15;Lauantai;62;30;92;17;16;33
96;22.04.2017;2017;04;16;Lauantai;44;22;66;11;12;23
96;22.04.2017;2017;04;17;Lauantai;36;21;57;27;9;36
96;22.04.2017;2017;04;18;Lauantai;28;24;52;8;18;26
96;22.04.2017;2017;04;19;Lauantai;31;24;55;12;12;24
96;22.04.2017;2017;04;20;Lauantai;25;18;43;4;5;9
96;22.04.2017;2017;04;21;Lauantai;9;19;28;1;10;11
96;22.04.2017;2017;04;22;Lauantai;4;10;14;4;9;13
96;22.04.2017;2017;04;23;Lauantai;7;4;11;0;1;1
96;23.04.2017;2017;04;00;Sunnuntai;4;11;15;2;1;3
96;23.04.2017;2017;04;01;Sunnuntai;13;1;14;2;0;2
96;23.04.2017;2017;04;02;Sunnuntai;4;5;9;0;0;0
96;23.04.2017;2017;04;03;Sunnuntai;6;0;6;1;0;1
96;23.04.2017;2017;04;04;Sunnuntai;6;3;9;1;0;1
96;23.04.2017;2017;04;05;Sunnuntai;4;0;4;1;0;1
96;23.04.2017;2017;04;06;Sunnuntai;14;4;18;4;1;5
96;23.04.2017;2017;04;07;Sunnuntai;5;13;18;1;2;3
96;23.04.2017;2017;04;08;Sunnuntai;2;4;6;1;4;5
96;23.04.2017;2017;04;09;Sunnuntai;6;15;21;6;7;13
96;23.04.2017;2017;04;10;Sunnuntai;8;11;19;3;8;11
96;23.04.2017;2017;04;11;Sunnuntai;12;23;35;15;10;25
96;23.04.2017;2017;04;12;Sunnuntai;30;42;72;10;24;34
96;23.04.2017;2017;04;13;Sunnuntai;38;28;66;10;14;24
96;23.04.2017;2017;04;14;Sunnuntai;41;31;72;11;11;22
96;23.04.2017;2017;04;15;Sunnuntai;33;41;74;14;13;27
96;23.04.2017;2017;04;16;Sunnuntai;29;16;45;23;6;29
96;23.04.2017;2017;04;17;Sunnuntai;25;15;40;11;9;20
96;23.04.2017;2017;04;18;Sunnuntai;34;21;55;20;20;40
96;23.04.2017;2017;04;19;Sunnuntai;15;13;28;10;23;33
96;23.04.2017;2017;04;20;Sunnuntai;24;14;38;8;7;15
96;23.04.2017;2017;04;21;Sunnuntai;8;15;23;5;6;11
96;23.04.2017;2017;04;22;Sunnuntai;3;2;5;1;0;1
96;23.04.2017;2017;04;23;Sunnuntai;3;4;7;4;1;5
96;24.04.2017;2017;04;00;Maanantai;4;0;4;1;0;1
96;24.04.2017;2017;04;01;Maanantai;2;1;3;0;0;0
96;24.04.2017;2017;04;02;Maanantai;2;0;2;0;0;0
96;24.04.2017;2017;04;03;Maanantai;1;0;1;0;1;1
96;24.04.2017;2017;04;04;Maanantai;3;3;6;0;1;1
96;24.04.2017;2017;04;05;Maanantai;5;6;11;1;0;1
96;24.04.2017;2017;04;06;Maanantai;51;21;72;10;1;11
96;24.04.2017;2017;04;07;Maanantai;117;95;212;21;19;40
96;24.04.2017;2017;04;08;Maanantai;82;96;178;16;8;24
96;24.04.2017;2017;04;09;Maanantai;84;68;152;20;16;36
96;24.04.2017;2017;04;10;Maanantai;57;63;120;9;15;24
96;24.04.2017;2017;04;11;Maanantai;63;50;113;11;21;32
96;24.04.2017;2017;04;12;Maanantai;69;62;131;15;26;41
96;24.04.2017;2017;04;13;Maanantai;71;88;159;19;16;35
96;24.04.2017;2017;04;14;Maanantai;72;112;184;17;27;44
96;24.04.2017;2017;04;15;Maanantai;76;176;252;16;31;47
96;24.04.2017;2017;04;16;Maanantai;107;140;247;17;28;45
96;24.04.2017;2017;04;17;Maanantai;65;74;139;14;10;24
96;24.04.2017;2017;04;18;Maanantai;60;32;92;15;18;33
96;24.04.2017;2017;04;19;Maanantai;46;24;70;10;17;27
96;24.04.2017;2017;04;20;Maanantai;31;26;57;11;12;23
96;24.04.2017;2017;04;21;Maanantai;27;41;68;7;13;20
96;24.04.2017;2017;04;22;Maanantai;5;19;24;1;4;5
96;24.04.2017;2017;04;23;Maanantai;5;8;13;1;0;1
96;25.04.2017;2017;04;00;Tiistai;1;0;1;0;0;0
96;25.04.2017;2017;04;01;Tiistai;5;0;5;0;0;0
96;25.04.2017;2017;04;02;Tiistai;5;3;8;0;0;0
96;25.04.2017;2017;04;03;Tiistai;6;0;6;0;0;0
96;25.04.2017;2017;04;04;Tiistai;3;2;5;0;0;0
96;25.04.2017;2017;04;05;Tiistai;3;6;9;0;0;0
96;25.04.2017;2017;04;06;Tiistai;54;19;73;10;10;20
96;25.04.2017;2017;04;07;Tiistai;132;115;247;22;19;41
96;25.04.2017;2017;04;08;Tiistai;89;77;166;19;15;34
96;25.04.2017;2017;04;09;Tiistai;75;68;143;10;12;22
96;25.04.2017;2017;04;10;Tiistai;58;53;111;13;15;28
96;25.04.2017;2017;04;11;Tiistai;75;63;138;16;25;41
96;25.04.2017;2017;04;12;Tiistai;71;78;149;20;15;35
96;25.04.2017;2017;04;13;Tiistai;83;87;170;29;27;56
96;25.04.2017;2017;04;14;Tiistai;68;115;183;10;23;33
96;25.04.2017;2017;04;15;Tiistai;82;181;263;10;29;39
96;25.04.2017;2017;04;16;Tiistai;101;150;251;15;32;47
96;25.04.2017;2017;04;17;Tiistai;65;86;151;25;20;45
96;25.04.2017;2017;04;18;Tiistai;69;55;124;16;31;47
96;25.04.2017;2017;04;19;Tiistai;83;39;122;8;12;20
96;25.04.2017;2017;04;20;Tiistai;49;26;75;13;8;21
96;25.04.2017;2017;04;21;Tiistai;29;46;75;1;9;10
96;25.04.2017;2017;04;22;Tiistai;11;17;28;5;3;8
96;25.04.2017;2017;04;23;Tiistai;8;1;9;2;2;4
96;26.04.2017;2017;04;00;Keskiviikko;3;0;3;0;0;0
96;26.04.2017;2017;04;01;Keskiviikko;1;0;1;0;1;1
96;26.04.2017;2017;04;02;Keskiviikko;0;0;0;0;0;0
96;26.04.2017;2017;04;03;Keskiviikko;1;0;1;0;0;0
96;26.04.2017;2017;04;04;Keskiviikko;1;0;1;0;2;2
96;26.04.2017;2017;04;05;Keskiviikko;5;9;14;1;0;1
96;26.04.2017;2017;04;06;Keskiviikko;47;20;67;10;4;14
96;26.04.2017;2017;04;07;Keskiviikko;100;101;201;20;10;30
96;26.04.2017;2017;04;08;Keskiviikko;88;70;158;18;11;29
96;26.04.2017;2017;04;09;Keskiviikko;77;37;114;18;1;19
96;26.04.2017;2017;04;10;Keskiviikko;25;19;44;3;9;12
96;26.04.2017;2017;04;11;Keskiviikko;43;38;81;7;8;15
96;26.04.2017;2017;04;12;Keskiviikko;50;37;87;10;8;18
96;26.04.2017;2017;04;13;Keskiviikko;49;60;109;7;7;14
96;26.04.2017;2017;04;14;Keskiviikko;23;86;109;5;19;24
96;26.04.2017;2017;04;15;Keskiviikko;38;136;174;5;23;28
96;26.04.2017;2017;04;16;Keskiviikko;51;108;159;6;18;24
96;26.04.2017;2017;04;17;Keskiviikko;35;46;81;7;5;12
96;26.04.2017;2017;04;18;Keskiviikko;49;27;76;8;1;9
96;26.04.2017;2017;04;19;Keskiviikko;26;20;46;9;8;17
96;26.04.2017;2017;04;20;Keskiviikko;35;20;55;3;7;10
96;26.04.2017;2017;04;21;Keskiviikko;13;36;49;1;8;9
96;26.04.2017;2017;04;22;Keskiviikko;5;3;8;2;1;3
96;26.04.2017;2017;04;23;Keskiviikko;7;1;8;1;1;2
96;27.04.2017;2017;04;00;Torstai;1;2;3;1;0;1
96;27.04.2017;2017;04;01;Torstai;1;0;1;0;0;0
96;27.04.2017;2017;04;02;Torstai;1;0;1;0;0;0
96;27.04.2017;2017;04;03;Torstai;4;0;4;1;0;1
96;27.04.2017;2017;04;04;Torstai;1;1;2;1;0;1
96;27.04.2017;2017;04;05;Torstai;5;2;7;0;0;0
96;27.04.2017;2017;04;06;Torstai;50;14;64;11;3;14
96;27.04.2017;2017;04;07;Torstai;102;79;181;30;7;37
96;27.04.2017;2017;04;08;Torstai;48;84;132;20;7;27
96;27.04.2017;2017;04;09;Torstai;83;37;120;12;2;14
96;27.04.2017;2017;04;10;Torstai;52;50;102;3;6;9
96;27.04.2017;2017;04;11;Torstai;59;40;99;35;10;45
96;27.04.2017;2017;04;12;Torstai;57;51;108;20;9;29
96;27.04.2017;2017;04;13;Torstai;45;49;94;13;9;22
96;27.04.2017;2017;04;14;Torstai;52;136;188;10;43;53
96;27.04.2017;2017;04;15;Torstai;57;140;197;9;35;44
96;27.04.2017;2017;04;16;Torstai;91;96;187;7;13;20
96;27.04.2017;2017;04;17;Torstai;56;66;122;10;20;30
96;27.04.2017;2017;04;18;Torstai;52;52;104;20;14;34
96;27.04.2017;2017;04;19;Torstai;52;34;86;7;14;21
96;27.04.2017;2017;04;20;Torstai;39;22;61;7;5;12
96;27.04.2017;2017;04;21;Torstai;28;27;55;5;5;10
96;27.04.2017;2017;04;22;Torstai;8;11;19;3;0;3
96;27.04.2017;2017;04;23;Torstai;5;4;9;0;0;0
96;28.04.2017;2017;04;00;Perjantai;13;3;16;1;0;1
96;28.04.2017;2017;04;01;Perjantai;12;4;16;1;0;1
96;28.04.2017;2017;04;02;Perjantai;1;0;1;3;0;3
96;28.04.2017;2017;04;03;Perjantai;7;0;7;0;0;0
96;28.04.2017;2017;04;04;Perjantai;3;2;5;0;0;0
96;28.04.2017;2017;04;05;Perjantai;6;5;11;1;0;1
96;28.04.2017;2017;04;06;Perjantai;50;23;73;8;5;13
96;28.04.2017;2017;04;07;Perjantai;104;97;201;19;7;26
96;28.04.2017;2017;04;08;Perjantai;47;76;123;11;14;25
96;28.04.2017;2017;04;09;Perjantai;48;56;104;15;7;22
96;28.04.2017;2017;04;10;Perjantai;43;51;94;5;15;20
96;28.04.2017;2017;04;11;Perjantai;41;62;103;10;9;19
96;28.04.2017;2017;04;12;Perjantai;58;73;131;13;11;24
96;28.04.2017;2017;04;13;Perjantai;59;117;176;9;19;28
96;28.04.2017;2017;04;14;Perjantai;76;137;213;10;12;22
96;28.04.2017;2017;04;15;Perjantai;82;103;185;8;23;31
96;28.04.2017;2017;04;16;Perjantai;83;71;154;9;16;25
96;28.04.2017;2017;04;17;Perjantai;50;47;97;12;11;23
96;28.04.2017;2017;04;18;Perjantai;42;37;79;19;22;41
96;28.04.2017;2017;04;19;Perjantai;29;40;69;11;18;29
96;28.04.2017;2017;04;20;Perjantai;34;17;51;19;6;25
96;28.04.2017;2017;04;21;Perjantai;15;21;36;2;3;5
96;28.04.2017;2017;04;22;Perjantai;6;18;24;2;3;5
96;28.04.2017;2017;04;23;Perjantai;13;6;19;0;1;1
96;29.04.2017;2017;04;00;Lauantai;4;1;5;2;1;3
96;29.04.2017;2017;04;01;Lauantai;4;1;5;2;0;2
96;29.04.2017;2017;04;02;Lauantai;10;1;11;2;0;2
96;29.04.2017;2017;04;03;Lauantai;18;1;19;0;0;0
96;29.04.2017;2017;04;04;Lauantai;3;1;4;0;2;2
96;29.04.2017;2017;04;05;Lauantai;2;6;8;1;0;1
96;29.04.2017;2017;04;06;Lauantai;21;8;29;2;0;2
96;29.04.2017;2017;04;07;Lauantai;3;10;13;1;7;8
96;29.04.2017;2017;04;08;Lauantai;8;23;31;6;3;9
96;29.04.2017;2017;04;09;Lauantai;19;33;52;7;9;16
96;29.04.2017;2017;04;10;Lauantai;22;38;60;9;5;14
96;29.04.2017;2017;04;11;Lauantai;23;61;84;10;12;22
96;29.04.2017;2017;04;12;Lauantai;52;60;112;9;18;27
96;29.04.2017;2017;04;13;Lauantai;70;58;128;15;14;29
96;29.04.2017;2017;04;14;Lauantai;47;48;95;8;12;20
96;29.04.2017;2017;04;15;Lauantai;64;56;120;12;14;26
96;29.04.2017;2017;04;16;Lauantai;41;45;86;7;9;16
96;29.04.2017;2017;04;17;Lauantai;36;42;78;11;8;19
96;29.04.2017;2017;04;18;Lauantai;40;34;74;14;3;17
96;29.04.2017;2017;04;19;Lauantai;40;25;65;7;8;15
96;29.04.2017;2017;04;20;Lauantai;29;38;67;5;13;18
96;29.04.2017;2017;04;21;Lauantai;12;30;42;4;6;10
96;29.04.2017;2017;04;22;Lauantai;9;10;19;1;2;3
96;29.04.2017;2017;04;23;Lauantai;14;13;27;1;1;2
96;30.04.2017;2017;04;00;Sunnuntai;21;6;27;2;1;3
96;30.04.2017;2017;04;01;Sunnuntai;3;3;6;2;0;2
96;30.04.2017;2017;04;02;Sunnuntai;21;1;22;4;2;6
96;30.04.2017;2017;04;03;Sunnuntai;17;0;17;2;0;2
96;30.04.2017;2017;04;04;Sunnuntai;8;0;8;3;1;4
96;30.04.2017;2017;04;05;Sunnuntai;1;1;2;2;0;2
96;30.04.2017;2017;04;06;Sunnuntai;10;10;20;1;0;1
96;30.04.2017;2017;04;07;Sunnuntai;3;6;9;0;6;6
96;30.04.2017;2017;04;08;Sunnuntai;2;7;9;1;0;1
96;30.04.2017;2017;04;09;Sunnuntai;1;10;11;6;6;12
96;30.04.2017;2017;04;10;Sunnuntai;5;13;18;6;10;16
96;30.04.2017;2017;04;11;Sunnuntai;14;27;41;4;13;17
96;30.04.2017;2017;04;12;Sunnuntai;27;26;53;4;8;12
96;30.04.2017;2017;04;13;Sunnuntai;20;30;50;7;8;15
96;30.04.2017;2017;04;14;Sunnuntai;29;35;64;6;7;13
96;30.04.2017;2017;04;15;Sunnuntai;15;23;38;22;20;42
96;30.04.2017;2017;04;16;Sunnuntai;20;21;41;15;1;16
96;30.04.2017;2017;04;17;Sunnuntai;22;8;30;7;7;14
96;30.04.2017;2017;04;18;Sunnuntai;13;23;36;6;11;17
96;30.04.2017;2017;04;19;Sunnuntai;11;15;26;3;6;9
96;30.04.2017;2017;04;20;Sunnuntai;12;16;28;5;7;12
96;30.04.2017;2017;04;21;Sunnuntai;10;30;40;3;2;5
96;30.04.2017;2017;04;22;Sunnuntai;9;13;22;0;1;1
96;30.04.2017;2017;04;23;Sunnuntai;17;6;23;1;1;2
96;01.05.2017;2017;05;00;Maanantai;15;8;23;1;0;1
96;01.05.2017;2017;05;01;Maanantai;13;1;14;1;1;2
96;01.05.2017;2017;05;02;Maanantai;21;5;26;2;0;2
96;01.05.2017;2017;05;03;Maanantai;29;1;30;2;0;2
96;01.05.2017;2017;05;04;Maanantai;14;4;18;6;2;8
96;01.05.2017;2017;05;05;Maanantai;3;1;4;0;2;2
96;01.05.2017;2017;05;06;Maanantai;18;7;25;5;0;5
96;01.05.2017;2017;05;07;Maanantai;4;8;12;1;5;6
96;01.05.2017;2017;05;08;Maanantai;2;6;8;3;4;7
96;01.05.2017;2017;05;09;Maanantai;11;22;33;7;8;15
96;01.05.2017;2017;05;10;Maanantai;14;36;50;9;10;19
96;01.05.2017;2017;05;11;Maanantai;19;66;85;11;13;24
96;01.05.2017;2017;05;12;Maanantai;41;65;106;8;12;20
96;01.05.2017;2017;05;13;Maanantai;83;45;128;7;8;15
96;01.05.2017;2017;05;14;Maanantai;55;47;102;17;15;32
96;01.05.2017;2017;05;15;Maanantai;53;48;101;9;9;18
96;01.05.2017;2017;05;16;Maanantai;52;29;81;3;11;14
96;01.05.2017;2017;05;17;Maanantai;60;18;78;9;6;15
96;01.05.2017;2017;05;18;Maanantai;42;29;71;10;13;23
96;01.05.2017;2017;05;19;Maanantai;25;19;44;9;7;16
96;01.05.2017;2017;05;20;Maanantai;19;22;41;3;3;6
96;01.05.2017;2017;05;21;Maanantai;21;22;43;5;4;9
96;01.05.2017;2017;05;22;Maanantai;2;5;7;3;0;3
96;01.05.2017;2017;05;23;Maanantai;6;3;9;1;1;2
96;02.05.2017;2017;05;00;Tiistai;1;3;4;1;0;1
96;02.05.2017;2017;05;01;Tiistai;3;1;4;0;0;0
96;02.05.2017;2017;05;02;Tiistai;0;0;0;0;0;0
96;02.05.2017;2017;05;03;Tiistai;1;0;1;1;0;1
96;02.05.2017;2017;05;04;Tiistai;1;0;1;1;0;1
96;02.05.2017;2017;05;05;Tiistai;5;8;13;1;1;2
96;02.05.2017;2017;05;06;Tiistai;55;27;82;9;3;12
96;02.05.2017;2017;05;07;Tiistai;119;125;244;19;20;39
96;02.05.2017;2017;05;08;Tiistai;61;88;149;7;12;19
96;02.05.2017;2017;05;09;Tiistai;65;70;135;4;7;11
96;02.05.2017;2017;05;10;Tiistai;48;45;93;12;17;29
96;02.05.2017;2017;05;11;Tiistai;39;64;103;21;20;41
96;02.05.2017;2017;05;12;Tiistai;78;62;140;19;12;31
96;02.05.2017;2017;05;13;Tiistai;72;108;180;40;41;81
96;02.05.2017;2017;05;14;Tiistai;77;129;206;10;22;32
96;02.05.2017;2017;05;15;Tiistai;87;165;252;12;30;42
96;02.05.2017;2017;05;16;Tiistai;137;124;261;7;27;34
96;02.05.2017;2017;05;17;Tiistai;85;85;170;25;16;41
96;02.05.2017;2017;05;18;Tiistai;72;54;126;25;15;40
96;02.05.2017;2017;05;19;Tiistai;74;42;116;20;18;38
96;02.05.2017;2017;05;20;Tiistai;54;32;86;9;18;27
96;02.05.2017;2017;05;21;Tiistai;29;24;53;5;10;15
96;02.05.2017;2017;05;22;Tiistai;6;6;12;2;1;3
96;02.05.2017;2017;05;23;Tiistai;3;3;6;0;2;2
96;03.05.2017;2017;05;00;Keskiviikko;3;1;4;0;0;0
96;03.05.2017;2017;05;01;Keskiviikko;0;1;1;0;0;0
96;03.05.2017;2017;05;02;Keskiviikko;2;0;2;0;0;0
96;03.05.2017;2017;05;03;Keskiviikko;0;1;1;0;0;0
96;03.05.2017;2017;05;04;Keskiviikko;1;3;4;0;1;1
96;03.05.2017;2017;05;05;Keskiviikko;3;8;11;0;0;0
96;03.05.2017;2017;05;06;Keskiviikko;65;30;95;15;8;23
96;03.05.2017;2017;05;07;Keskiviikko;152;123;275;29;13;42
96;03.05.2017;2017;05;08;Keskiviikko;89;102;191;11;11;22
96;03.05.2017;2017;05;09;Keskiviikko;86;78;164;16;6;22
96;03.05.2017;2017;05;10;Keskiviikko;54;76;130;10;18;28
96;03.05.2017;2017;05;11;Keskiviikko;77;83;160;13;18;31
96;03.05.2017;2017;05;12;Keskiviikko;78;81;159;14;13;27
96;03.05.2017;2017;05;13;Keskiviikko;82;83;165;9;12;21
96;03.05.2017;2017;05;14;Keskiviikko;89;147;236;8;16;24
96;03.05.2017;2017;05;15;Keskiviikko;110;202;312;7;22;29
96;03.05.2017;2017;05;16;Keskiviikko;110;146;256;10;28;38
96;03.05.2017;2017;05;17;Keskiviikko;81;62;143;18;13;31
96;03.05.2017;2017;05;18;Keskiviikko;84;52;136;17;13;30
96;03.05.2017;2017;05;19;Keskiviikko;70;37;107;7;13;20
96;03.05.2017;2017;05;20;Keskiviikko;50;37;87;6;17;23
96;03.05.2017;2017;05;21;Keskiviikko;24;32;56;3;6;9
96;03.05.2017;2017;05;22;Keskiviikko;7;9;16;1;2;3
96;03.05.2017;2017;05;23;Keskiviikko;8;3;11;2;3;5
96;04.05.2017;2017;05;00;Torstai;1;2;3;0;1;1
96;04.05.2017;2017;05;01;Torstai;1;2;3;0;0;0
96;04.05.2017;2017;05;02;Torstai;0;0;0;0;0;0
96;04.05.2017;2017;05;03;Torstai;2;0;2;0;0;0
96;04.05.2017;2017;05;04;Torstai;3;1;4;0;0;0
96;04.05.2017;2017;05;05;Torstai;2;8;10;1;2;3
96;04.05.2017;2017;05;06;Torstai;46;24;70;6;2;8
96;04.05.2017;2017;05;07;Torstai;127;136;263;22;11;33
96;04.05.2017;2017;05;08;Torstai;86;116;202;13;10;23
96;04.05.2017;2017;05;09;Torstai;101;68;169;15;15;30
96;04.05.2017;2017;05;10;Torstai;73;59;132;5;15;20
96;04.05.2017;2017;05;11;Torstai;75;69;144;15;12;27
96;04.05.2017;2017;05;12;Torstai;86;90;176;10;8;18
96;04.05.2017;2017;05;13;Torstai;65;89;154;10;19;29
96;04.05.2017;2017;05;14;Torstai;75;156;231;9;27;36
96;04.05.2017;2017;05;15;Torstai;115;206;321;14;29;43
96;04.05.2017;2017;05;16;Torstai;127;154;281;18;21;39
96;04.05.2017;2017;05;17;Torstai;78;69;147;17;20;37
96;04.05.2017;2017;05;18;Torstai;83;55;138;15;22;37
96;04.05.2017;2017;05;19;Torstai;73;40;113;19;14;33
96;04.05.2017;2017;05;20;Torstai;65;51;116;11;15;26
96;04.05.2017;2017;05;21;Torstai;41;37;78;6;4;10
96;04.05.2017;2017;05;22;Torstai;12;9;21;1;3;4
96;04.05.2017;2017;05;23;Torstai;6;4;10;1;1;2
96;05.05.2017;2017;05;00;Perjantai;4;0;4;0;0;0
96;05.05.2017;2017;05;01;Perjantai;0;0;0;1;0;1
96;05.05.2017;2017;05;02;Perjantai;1;0;1;2;0;2
96;05.05.2017;2017;05;03;Perjantai;1;1;2;0;0;0
96;05.05.2017;2017;05;04;Perjantai;3;0;3;0;0;0
96;05.05.2017;2017;05;05;Perjantai;4;9;13;2;2;4
96;05.05.2017;2017;05;06;Perjantai;55;31;86;8;2;10
96;05.05.2017;2017;05;07;Perjantai;127;102;229;20;11;31
96;05.05.2017;2017;05;08;Perjantai;96;91;187;7;6;13
96;05.05.2017;2017;05;09;Perjantai;61;67;128;14;7;21
96;05.05.2017;2017;05;10;Perjantai;46;61;107;6;11;17
96;05.05.2017;2017;05;11;Perjantai;73;79;152;12;13;25
96;05.05.2017;2017;05;12;Perjantai;67;82;149;12;10;22
96;05.05.2017;2017;05;13;Perjantai;94;131;225;18;28;46
96;05.05.2017;2017;05;14;Perjantai;95;147;242;3;26;29
96;05.05.2017;2017;05;15;Perjantai;81;186;267;12;30;42
96;05.05.2017;2017;05;16;Perjantai;106;76;182;11;21;32
96;05.05.2017;2017;05;17;Perjantai;66;51;117;11;15;26
96;05.05.2017;2017;05;18;Perjantai;47;54;101;18;12;30
96;05.05.2017;2017;05;19;Perjantai;55;38;93;8;15;23
96;05.05.2017;2017;05;20;Perjantai;58;33;91;2;8;10
96;05.05.2017;2017;05;21;Perjantai;47;19;66;1;3;4
96;05.05.2017;2017;05;22;Perjantai;18;11;29;3;2;5
96;05.05.2017;2017;05;23;Perjantai;11;9;20;2;5;7
96;06.05.2017;2017;05;00;Lauantai;13;2;15;1;0;1
96;06.05.2017;2017;05;01;Lauantai;13;4;17;2;0;2
96;06.05.2017;2017;05;02;Lauantai;3;0;3;2;0;2
96;06.05.2017;2017;05;03;Lauantai;8;0;8;1;0;1
96;06.05.2017;2017;05;04;Lauantai;6;1;7;4;1;5
96;06.05.2017;2017;05;05;Lauantai;1;3;4;2;1;3
96;06.05.2017;2017;05;06;Lauantai;22;6;28;0;0;0
96;06.05.2017;2017;05;07;Lauantai;5;17;22;1;4;5
96;06.05.2017;2017;05;08;Lauantai;6;31;37;2;1;3
96;06.05.2017;2017;05;09;Lauantai;10;29;39;5;3;8
96;06.05.2017;2017;05;10;Lauantai;22;35;57;4;8;12
96;06.05.2017;2017;05;11;Lauantai;35;37;72;5;12;17
96;06.05.2017;2017;05;12;Lauantai;33;55;88;5;10;15
96;06.05.2017;2017;05;13;Lauantai;50;48;98;11;17;28
96;06.05.2017;2017;05;14;Lauantai;44;55;99;11;6;17
96;06.05.2017;2017;05;15;Lauantai;59;39;98;15;5;20
96;06.05.2017;2017;05;16;Lauantai;54;36;90;14;5;19
96;06.05.2017;2017;05;17;Lauantai;36;25;61;10;7;17
96;06.05.2017;2017;05;18;Lauantai;41;25;66;15;10;25
96;06.05.2017;2017;05;19;Lauantai;42;25;67;13;10;23
96;06.05.2017;2017;05;20;Lauantai;17;29;46;8;8;16
96;06.05.2017;2017;05;21;Lauantai;21;43;64;1;10;11
96;06.05.2017;2017;05;22;Lauantai;10;8;18;2;1;3
96;06.05.2017;2017;05;23;Lauantai;14;11;25;1;3;4
96;07.05.2017;2017;05;00;Sunnuntai;10;6;16;1;1;2
96;07.05.2017;2017;05;01;Sunnuntai;3;1;4;1;2;3
96;07.05.2017;2017;05;02;Sunnuntai;5;3;8;0;0;0
96;07.05.2017;2017;05;03;Sunnuntai;15;1;16;1;1;2
96;07.05.2017;2017;05;04;Sunnuntai;5;3;8;4;0;4
96;07.05.2017;2017;05;05;Sunnuntai;1;1;2;1;0;1
96;07.05.2017;2017;05;06;Sunnuntai;22;3;25;1;1;2
96;07.05.2017;2017;05;07;Sunnuntai;1;13;14;1;5;6
96;07.05.2017;2017;05;08;Sunnuntai;8;7;15;3;6;9
96;07.05.2017;2017;05;09;Sunnuntai;12;14;26;3;5;8
96;07.05.2017;2017;05;10;Sunnuntai;14;23;37;4;5;9
96;07.05.2017;2017;05;11;Sunnuntai;24;39;63;9;10;19
96;07.05.2017;2017;05;12;Sunnuntai;38;47;85;9;11;20
96;07.05.2017;2017;05;13;Sunnuntai;56;55;111;11;13;24
96;07.05.2017;2017;05;14;Sunnuntai;53;53;106;10;12;22
96;07.05.2017;2017;05;15;Sunnuntai;54;58;112;15;17;32
96;07.05.2017;2017;05;16;Sunnuntai;52;30;82;24;13;37
96;07.05.2017;2017;05;17;Sunnuntai;34;31;65;9;6;15
96;07.05.2017;2017;05;18;Sunnuntai;36;35;71;13;15;28
96;07.05.2017;2017;05;19;Sunnuntai;15;28;43;4;8;12
96;07.05.2017;2017;05;20;Sunnuntai;21;18;39;8;5;13
96;07.05.2017;2017;05;21;Sunnuntai;20;26;46;2;2;4
96;07.05.2017;2017;05;22;Sunnuntai;4;8;12;6;3;9
96;07.05.2017;2017;05;23;Sunnuntai;6;1;7;0;1;1
96;08.05.2017;2017;05;00;Maanantai;1;0;1;0;0;0
96;08.05.2017;2017;05;01;Maanantai;1;1;2;0;0;0
96;08.05.2017;2017;05;02;Maanantai;0;1;1;0;0;0
96;08.05.2017;2017;05;03;Maanantai;0;2;2;0;0;0
96;08.05.2017;2017;05;04;Maanantai;1;3;4;2;0;2
96;08.05.2017;2017;05;05;Maanantai;2;6;8;3;1;4
96;08.05.2017;2017;05;06;Maanantai;65;31;96;4;4;8
96;08.05.2017;2017;05;07;Maanantai;142;123;265;18;7;25
96;08.05.2017;2017;05;08;Maanantai;110;109;219;10;2;12
96;08.05.2017;2017;05;09;Maanantai;81;51;132;18;12;30
96;08.05.2017;2017;05;10;Maanantai;43;60;103;9;8;17
96;08.05.2017;2017;05;11;Maanantai;62;70;132;13;13;26
96;08.05.2017;2017;05;12;Maanantai;77;83;160;7;12;19
96;08.05.2017;2017;05;13;Maanantai;65;79;144;10;32;42
96;08.05.2017;2017;05;14;Maanantai;60;124;184;9;15;24
96;08.05.2017;2017;05;15;Maanantai;89;185;274;10;22;32
96;08.05.2017;2017;05;16;Maanantai;125;131;256;11;16;27
96;08.05.2017;2017;05;17;Maanantai;75;64;139;6;13;19
96;08.05.2017;2017;05;18;Maanantai;52;46;98;15;9;24
96;08.05.2017;2017;05;19;Maanantai;59;35;94;16;20;36
96;08.05.2017;2017;05;20;Maanantai;47;27;74;6;4;10
96;08.05.2017;2017;05;21;Maanantai;25;26;51;4;10;14
96;08.05.2017;2017;05;22;Maanantai;6;9;15;4;3;7
96;08.05.2017;2017;05;23;Maanantai;5;9;14;1;0;1
96;09.05.2017;2017;05;00;Tiistai;4;2;6;0;0;0
96;09.05.2017;2017;05;01;Tiistai;0;1;1;0;0;0
96;09.05.2017;2017;05;02;Tiistai;0;2;2;0;0;0
96;09.05.2017;2017;05;03;Tiistai;0;0;0;0;0;0
96;09.05.2017;2017;05;04;Tiistai;2;1;3;0;0;0
96;09.05.2017;2017;05;05;Tiistai;2;6;8;1;0;1
96;09.05.2017;2017;05;06;Tiistai;47;30;77;3;4;7
96;09.05.2017;2017;05;07;Tiistai;123;123;246;28;6;34
96;09.05.2017;2017;05;08;Tiistai;93;103;196;7;7;14
96;09.05.2017;2017;05;09;Tiistai;72;73;145;8;12;20
96;09.05.2017;2017;05;10;Tiistai;45;72;117;9;26;35
96;09.05.2017;2017;05;11;Tiistai;69;58;127;12;13;25
96;09.05.2017;2017;05;12;Tiistai;99;65;164;13;7;20
96;09.05.2017;2017;05;13;Tiistai;68;73;141;5;10;15
96;09.05.2017;2017;05;14;Tiistai;68;125;193;6;12;18
96;09.05.2017;2017;05;15;Tiistai;87;167;254;14;23;37
96;09.05.2017;2017;05;16;Tiistai;116;132;248;5;15;20
96;09.05.2017;2017;05;17;Tiistai;69;64;133;10;10;20
96;09.05.2017;2017;05;18;Tiistai;55;26;81;13;10;23
96;09.05.2017;2017;05;19;Tiistai;53;35;88;10;10;20
96;09.05.2017;2017;05;20;Tiistai;55;35;90;7;10;17
96;09.05.2017;2017;05;21;Tiistai;32;39;71;9;7;16
96;09.05.2017;2017;05;22;Tiistai;6;16;22;2;2;4
96;09.05.2017;2017;05;23;Tiistai;8;1;9;1;3;4
96;10.05.2017;2017;05;00;Keskiviikko;4;1;5;1;0;1
96;10.05.2017;2017;05;01;Keskiviikko;0;0;0;0;0;0
96;10.05.2017;2017;05;02;Keskiviikko;0;0;0;0;0;0
96;10.05.2017;2017;05;03;Keskiviikko;0;0;0;1;0;1
96;10.05.2017;2017;05;04;Keskiviikko;3;1;4;0;0;0
96;10.05.2017;2017;05;05;Keskiviikko;6;4;10;0;1;1
96;10.05.2017;2017;05;06;Keskiviikko;56;32;88;8;3;11
96;10.05.2017;2017;05;07;Keskiviikko;123;129;252;20;10;30
96;10.05.2017;2017;05;08;Keskiviikko;79;106;185;17;11;28
96;10.05.2017;2017;05;09;Keskiviikko;69;76;145;12;16;28
96;10.05.2017;2017;05;10;Keskiviikko;62;62;124;13;6;19
96;10.05.2017;2017;05;11;Keskiviikko;65;69;134;8;17;25
96;10.05.2017;2017;05;12;Keskiviikko;92;63;155;15;4;19
96;10.05.2017;2017;05;13;Keskiviikko;64;65;129;7;7;14
96;10.05.2017;2017;05;14;Keskiviikko;70;125;195;7;13;20
96;10.05.2017;2017;05;15;Keskiviikko;79;173;252;5;21;26
96;10.05.2017;2017;05;16;Keskiviikko;108;118;226;12;20;32
96;10.05.2017;2017;05;17;Keskiviikko;63;61;124;16;11;27
96;10.05.2017;2017;05;18;Keskiviikko;70;36;106;20;7;27
96;10.05.2017;2017;05;19;Keskiviikko;52;23;75;6;7;13
96;10.05.2017;2017;05;20;Keskiviikko;54;34;88;3;11;14
96;10.05.2017;2017;05;21;Keskiviikko;22;28;50;5;6;11
96;10.05.2017;2017;05;22;Keskiviikko;10;11;21;2;1;3
96;10.05.2017;2017;05;23;Keskiviikko;4;0;4;1;1;2
96;11.05.2017;2017;05;00;Torstai;2;1;3;0;0;0
96;11.05.2017;2017;05;01;Torstai;1;1;2;0;0;0
96;11.05.2017;2017;05;02;Torstai;0;0;0;1;0;1
96;11.05.2017;2017;05;03;Torstai;1;0;1;0;0;0
96;11.05.2017;2017;05;04;Torstai;2;2;4;0;0;0
96;11.05.2017;2017;05;05;Torstai;5;9;14;1;1;2
96;11.05.2017;2017;05;06;Torstai;63;24;87;4;3;7
96;11.05.2017;2017;05;07;Torstai;117;122;239;15;11;26
96;11.05.2017;2017;05;08;Torstai;81;101;182;6;9;15
96;11.05.2017;2017;05;09;Torstai;87;98;185;11;4;15
96;11.05.2017;2017;05;10;Torstai;60;44;104;11;12;23
96;11.05.2017;2017;05;11;Torstai;98;55;153;12;9;21
96;11.05.2017;2017;05;12;Torstai;87;67;154;7;7;14
96;11.05.2017;2017;05;13;Torstai;71;99;170;5;12;17
96;11.05.2017;2017;05;14;Torstai;81;114;195;8;23;31
96;11.05.2017;2017;05;15;Torstai;77;203;280;6;25;31
96;11.05.2017;2017;05;16;Torstai;108;117;225;4;16;20
96;11.05.2017;2017;05;17;Torstai;84;55;139;9;16;25
96;11.05.2017;2017;05;18;Torstai;80;42;122;12;14;26
96;11.05.2017;2017;05;19;Torstai;60;43;103;8;11;19
96;11.05.2017;2017;05;20;Torstai;52;29;81;5;19;24
96;11.05.2017;2017;05;21;Torstai;32;35;67;3;5;8
96;11.05.2017;2017;05;22;Torstai;13;9;22;4;2;6
96;11.05.2017;2017;05;23;Torstai;5;6;11;1;2;3
96;12.05.2017;2017;05;00;Perjantai;4;17;21;1;0;1
96;12.05.2017;2017;05;01;Perjantai;2;0;2;0;0;0
96;12.05.2017;2017;05;02;Perjantai;1;1;2;2;0;2
96;12.05.2017;2017;05;03;Perjantai;1;0;1;1;0;1
96;12.05.2017;2017;05;04;Perjantai;2;2;4;0;0;0
96;12.05.2017;2017;05;05;Perjantai;1;5;6;2;0;2
96;12.05.2017;2017;05;06;Perjantai;49;30;79;6;2;8
96;12.05.2017;2017;05;07;Perjantai;108;107;215;24;10;34
96;12.05.2017;2017;05;08;Perjantai;80;88;168;13;5;18
96;12.05.2017;2017;05;09;Perjantai;43;92;135;8;7;15
96;12.05.2017;2017;05;10;Perjantai;42;39;81;10;10;20
96;12.05.2017;2017;05;11;Perjantai;72;71;143;8;5;13
96;12.05.2017;2017;05;12;Perjantai;52;79;131;10;14;24
96;12.05.2017;2017;05;13;Perjantai;93;96;189;9;11;20
96;12.05.2017;2017;05;14;Perjantai;89;120;209;5;23;28
96;12.05.2017;2017;05;15;Perjantai;93;132;225;12;16;28
96;12.05.2017;2017;05;16;Perjantai;84;87;171;9;15;24
96;12.05.2017;2017;05;17;Perjantai;57;60;117;13;14;27
96;12.05.2017;2017;05;18;Perjantai;55;40;95;12;4;16
96;12.05.2017;2017;05;19;Perjantai;50;32;82;10;7;17
96;12.05.2017;2017;05;20;Perjantai;43;25;68;7;13;20
96;12.05.2017;2017;05;21;Perjantai;31;21;52;4;3;7
96;12.05.2017;2017;05;22;Perjantai;15;15;30;3;3;6
96;12.05.2017;2017;05;23;Perjantai;14;12;26;2;2;4
96;13.05.2017;2017;05;00;Lauantai;6;4;10;0;1;1
96;13.05.2017;2017;05;01;Lauantai;5;0;5;1;0;1
96;13.05.2017;2017;05;02;Lauantai;2;0;2;0;0;0
96;13.05.2017;2017;05;03;Lauantai;5;0;5;1;0;1
96;13.05.2017;2017;05;04;Lauantai;9;1;10;4;0;4
96;13.05.2017;2017;05;05;Lauantai;4;2;6;1;2;3
96;13.05.2017;2017;05;06;Lauantai;18;7;25;0;0;0
96;13.05.2017;2017;05;07;Lauantai;6;17;23;2;1;3
96;13.05.2017;2017;05;08;Lauantai;8;22;30;1;3;4
96;13.05.2017;2017;05;09;Lauantai;14;31;45;2;3;5
96;13.05.2017;2017;05;10;Lauantai;23;38;61;16;18;34
96;13.05.2017;2017;05;11;Lauantai;51;37;88;6;9;15
96;13.05.2017;2017;05;12;Lauantai;48;54;102;6;11;17
96;13.05.2017;2017;05;13;Lauantai;77;57;134;10;8;18
96;13.05.2017;2017;05;14;Lauantai;66;53;119;7;8;15
96;13.05.2017;2017;05;15;Lauantai;43;49;92;8;12;20
96;13.05.2017;2017;05;16;Lauantai;54;30;84;7;17;24
96;13.05.2017;2017;05;17;Lauantai;40;34;74;10;8;18
96;13.05.2017;2017;05;18;Lauantai;43;40;83;20;7;27
96;13.05.2017;2017;05;19;Lauantai;43;23;66;10;9;19
96;13.05.2017;2017;05;20;Lauantai;25;30;55;6;9;15
96;13.05.2017;2017;05;21;Lauantai;17;25;42;1;10;11
96;13.05.2017;2017;05;22;Lauantai;16;4;20;0;1;1
96;13.05.2017;2017;05;23;Lauantai;10;8;18;5;1;6
96;14.05.2017;2017;05;00;Sunnuntai;12;3;15;2;1;3
96;14.05.2017;2017;05;01;Sunnuntai;6;0;6;1;0;1
96;14.05.2017;2017;05;02;Sunnuntai;10;0;10;2;1;3
96;14.05.2017;2017;05;03;Sunnuntai;6;2;8;0;0;0
96;14.05.2017;2017;05;04;Sunnuntai;8;2;10;0;0;0
96;14.05.2017;2017;05;05;Sunnuntai;4;1;5;0;0;0
96;14.05.2017;2017;05;06;Sunnuntai;22;6;28;1;1;2
96;14.05.2017;2017;05;07;Sunnuntai;0;9;9;0;5;5
96;14.05.2017;2017;05;08;Sunnuntai;4;8;12;3;6;9
96;14.05.2017;2017;05;09;Sunnuntai;6;7;13;3;7;10
96;14.05.2017;2017;05;10;Sunnuntai;3;11;14;7;9;16
96;14.05.2017;2017;05;11;Sunnuntai;9;13;22;3;6;9
96;14.05.2017;2017;05;12;Sunnuntai;17;10;27;3;3;6
96;14.05.2017;2017;05;13;Sunnuntai;17;18;35;1;8;9
96;14.05.2017;2017;05;14;Sunnuntai;12;18;30;2;4;6
96;14.05.2017;2017;05;15;Sunnuntai;14;11;25;1;1;2
96;14.05.2017;2017;05;16;Sunnuntai;12;7;19;5;6;11
96;14.05.2017;2017;05;17;Sunnuntai;18;17;35;6;6;12
96;14.05.2017;2017;05;18;Sunnuntai;13;10;23;5;4;9
96;14.05.2017;2017;05;19;Sunnuntai;9;14;23;12;8;20
96;14.05.2017;2017;05;20;Sunnuntai;18;11;29;6;6;12
96;14.05.2017;2017;05;21;Sunnuntai;9;15;24;6;1;7
96;14.05.2017;2017;05;22;Sunnuntai;2;3;5;2;1;3
96;14.05.2017;2017;05;23;Sunnuntai;3;5;8;3;1;4
96;15.05.2017;2017;05;00;Maanantai;2;2;4;1;1;2
96;15.05.2017;2017;05;01;Maanantai;0;0;0;0;0;0
96;15.05.2017;2017;05;02;Maanantai;0;1;1;0;0;0
96;15.05.2017;2017;05;03;Maanantai;0;0;0;0;0;0
96;15.05.2017;2017;05;04;Maanantai;2;0;2;0;0;0
96;15.05.2017;2017;05;05;Maanantai;5;8;13;2;0;2
96;15.05.2017;2017;05;06;Maanantai;47;32;79;4;2;6
96;15.05.2017;2017;05;07;Maanantai;124;124;248;16;17;33
96;15.05.2017;2017;05;08;Maanantai;85;111;196;9;1;10
96;15.05.2017;2017;05;09;Maanantai;64;61;125;18;10;28
96;15.05.2017;2017;05;10;Maanantai;50;48;98;11;12;23
96;15.05.2017;2017;05;11;Maanantai;45;60;105;11;7;18
96;15.05.2017;2017;05;12;Maanantai;85;68;153;8;7;15
96;15.05.2017;2017;05;13;Maanantai;52;91;143;7;9;16
96;15.05.2017;2017;05;14;Maanantai;43;142;185;8;27;35
96;15.05.2017;2017;05;15;Maanantai;76;209;285;5;23;28
96;15.05.2017;2017;05;16;Maanantai;117;162;279;4;15;19
96;15.05.2017;2017;05;17;Maanantai;80;86;166;15;21;36
96;15.05.2017;2017;05;18;Maanantai;86;41;127;15;14;29
96;15.05.2017;2017;05;19;Maanantai;80;36;116;12;11;23
96;15.05.2017;2017;05;20;Maanantai;50;40;90;10;12;22
96;15.05.2017;2017;05;21;Maanantai;26;31;57;4;4;8
96;15.05.2017;2017;05;22;Maanantai;17;10;27;1;1;2
96;15.05.2017;2017;05;23;Maanantai;6;4;10;2;0;2
96;16.05.2017;2017;05;00;Tiistai;4;1;5;1;1;2
96;16.05.2017;2017;05;01;Tiistai;3;0;3;0;0;0
96;16.05.2017;2017;05;02;Tiistai;0;0;0;0;0;0
96;16.05.2017;2017;05;03;Tiistai;2;0;2;0;0;0
96;16.05.2017;2017;05;04;Tiistai;1;0;1;0;0;0
96;16.05.2017;2017;05;05;Tiistai;6;13;19;2;0;2
96;16.05.2017;2017;05;06;Tiistai;59;38;97;5;1;6
96;16.05.2017;2017;05;07;Tiistai;136;131;267;24;13;37
96;16.05.2017;2017;05;08;Tiistai;81;110;191;10;6;16
96;16.05.2017;2017;05;09;Tiistai;86;78;164;15;10;25
96;16.05.2017;2017;05;10;Tiistai;53;69;122;6;8;14
96;16.05.2017;2017;05;11;Tiistai;72;82;154;12;16;28
96;16.05.2017;2017;05;12;Tiistai;117;81;198;17;13;30
96;16.05.2017;2017;05;13;Tiistai;80;82;162;11;17;28
96;16.05.2017;2017;05;14;Tiistai;77;119;196;11;18;29
96;16.05.2017;2017;05;15;Tiistai;93;235;328;8;34;42
96;16.05.2017;2017;05;16;Tiistai;109;160;269;13;28;41
96;16.05.2017;2017;05;17;Tiistai;87;94;181;11;10;21
96;16.05.2017;2017;05;18;Tiistai;88;43;131;16;9;25
96;16.05.2017;2017;05;19;Tiistai;73;49;122;22;16;38
96;16.05.2017;2017;05;20;Tiistai;75;33;108;10;13;23
96;16.05.2017;2017;05;21;Tiistai;35;40;75;2;4;6
96;16.05.2017;2017;05;22;Tiistai;9;4;13;3;1;4
96;16.05.2017;2017;05;23;Tiistai;5;4;9;1;1;2
96;17.05.2017;2017;05;00;Keskiviikko;7;6;13;2;0;2
96;17.05.2017;2017;05;01;Keskiviikko;0;0;0;0;0;0
96;17.05.2017;2017;05;02;Keskiviikko;0;1;1;0;0;0
96;17.05.2017;2017;05;03;Keskiviikko;1;0;1;0;0;0
96;17.05.2017;2017;05;04;Keskiviikko;2;3;5;0;0;0
96;17.05.2017;2017;05;05;Keskiviikko;3;6;9;2;0;2
96;17.05.2017;2017;05;06;Keskiviikko;39;35;74;4;2;6
96;17.05.2017;2017;05;07;Keskiviikko;133;109;242;21;6;27
96;17.05.2017;2017;05;08;Keskiviikko;51;92;143;12;4;16
96;17.05.2017;2017;05;09;Keskiviikko;86;67;153;14;13;27
96;17.05.2017;2017;05;10;Keskiviikko;44;61;105;12;11;23
96;17.05.2017;2017;05;11;Keskiviikko;41;51;92;11;13;24
96;17.05.2017;2017;05;12;Keskiviikko;72;57;129;13;10;23
96;17.05.2017;2017;05;13;Keskiviikko;58;56;114;9;15;24
96;17.05.2017;2017;05;14;Keskiviikko;57;76;133;1;9;10
96;17.05.2017;2017;05;15;Keskiviikko;55;138;193;8;16;24
96;17.05.2017;2017;05;16;Keskiviikko;70;117;187;4;14;18
96;17.05.2017;2017;05;17;Keskiviikko;44;39;83;11;9;20
96;17.05.2017;2017;05;18;Keskiviikko;50;31;81;16;7;23
96;17.05.2017;2017;05;19;Keskiviikko;32;32;64;7;5;12
96;17.05.2017;2017;05;20;Keskiviikko;36;22;58;3;5;8
96;17.05.2017;2017;05;21;Keskiviikko;23;30;53;28;16;44
96;17.05.2017;2017;05;22;Keskiviikko;2;10;12;3;1;4
96;17.05.2017;2017;05;23;Keskiviikko;2;9;11;1;2;3
96;18.05.2017;2017;05;00;Torstai;7;1;8;1;2;3
96;18.05.2017;2017;05;01;Torstai;4;1;5;1;0;1
96;18.05.2017;2017;05;02;Torstai;1;0;1;1;0;1
96;18.05.2017;2017;05;03;Torstai;1;0;1;0;0;0
96;18.05.2017;2017;05;04;Torstai;3;1;4;1;0;1
96;18.05.2017;2017;05;05;Torstai;6;7;13;2;1;3
96;18.05.2017;2017;05;06;Torstai;61;41;102;5;4;9
96;18.05.2017;2017;05;07;Torstai;125;125;250;16;4;20
96;18.05.2017;2017;05;08;Torstai;76;88;164;18;5;23
96;18.05.2017;2017;05;09;Torstai;79;69;148;11;7;18
96;18.05.2017;2017;05;10;Torstai;42;56;98;13;14;27
96;18.05.2017;2017;05;11;Torstai;66;55;121;8;13;21
96;18.05.2017;2017;05;12;Torstai;70;85;155;4;5;9
96;18.05.2017;2017;05;13;Torstai;81;77;158;8;7;15
96;18.05.2017;2017;05;14;Torstai;75;124;199;8;19;27
96;18.05.2017;2017;05;15;Torstai;79;154;233;5;21;26
96;18.05.2017;2017;05;16;Torstai;112;139;251;4;13;17
96;18.05.2017;2017;05;17;Torstai;52;69;121;11;8;19
96;18.05.2017;2017;05;18;Torstai;65;39;104;13;7;20
96;18.05.2017;2017;05;19;Torstai;42;42;84;4;3;7
96;18.05.2017;2017;05;20;Torstai;53;44;97;8;20;28
96;18.05.2017;2017;05;21;Torstai;23;32;55;5;5;10
96;18.05.2017;2017;05;22;Torstai;5;10;15;3;0;3
96;18.05.2017;2017;05;23;Torstai;4;0;4;0;1;1
96;19.05.2017;2017;05;00;Perjantai;4;4;8;8;7;15
96;19.05.2017;2017;05;01;Perjantai;5;2;7;0;0;0
96;19.05.2017;2017;05;02;Perjantai;2;2;4;1;0;1
96;19.05.2017;2017;05;03;Perjantai;0;0;0;0;1;1
96;19.05.2017;2017;05;04;Perjantai;3;0;3;0;0;0
96;19.05.2017;2017;05;05;Perjantai;2;3;5;0;0;0
96;19.05.2017;2017;05;06;Perjantai;31;17;48;3;0;3
96;19.05.2017;2017;05;07;Perjantai;91;60;151;14;3;17
96;19.05.2017;2017;05;08;Perjantai;43;46;89;5;4;9
96;19.05.2017;2017;05;09;Perjantai;36;44;80;8;4;12
96;19.05.2017;2017;05;10;Perjantai;22;39;61;3;6;9
96;19.05.2017;2017;05;11;Perjantai;32;44;76;8;6;14
96;19.05.2017;2017;05;12;Perjantai;46;47;93;9;9;18
96;19.05.2017;2017;05;13;Perjantai;52;70;122;7;17;24
96;19.05.2017;2017;05;14;Perjantai;51;85;136;8;14;22
96;19.05.2017;2017;05;15;Perjantai;70;85;155;6;21;27
96;19.05.2017;2017;05;16;Perjantai;56;74;130;8;13;21
96;19.05.2017;2017;05;17;Perjantai;46;42;88;5;11;16
96;19.05.2017;2017;05;18;Perjantai;33;19;52;4;6;10
96;19.05.2017;2017;05;19;Perjantai;31;33;64;6;8;14
96;19.05.2017;2017;05;20;Perjantai;25;23;48;11;5;16
96;19.05.2017;2017;05;21;Perjantai;23;23;46;5;4;9
96;19.05.2017;2017;05;22;Perjantai;7;14;21;0;2;2
96;19.05.2017;2017;05;23;Perjantai;15;8;23;1;0;1
96;20.05.2017;2017;05;00;Lauantai;5;5;10;3;0;3
96;20.05.2017;2017;05;01;Lauantai;6;2;8;0;0;0
96;20.05.2017;2017;05;02;Lauantai;5;1;6;0;0;0
96;20.05.2017;2017;05;03;Lauantai;11;0;11;1;0;1
96;20.05.2017;2017;05;04;Lauantai;5;2;7;3;1;4
96;20.05.2017;2017;05;05;Lauantai;2;3;5;1;0;1
96;20.05.2017;2017;05;06;Lauantai;25;9;34;5;2;7
96;20.05.2017;2017;05;07;Lauantai;4;7;11;0;3;3
96;20.05.2017;2017;05;08;Lauantai;13;21;34;4;1;5
96;20.05.2017;2017;05;09;Lauantai;27;31;58;2;4;6
96;20.05.2017;2017;05;10;Lauantai;32;48;80;5;8;13
96;20.05.2017;2017;05;11;Lauantai;44;63;107;4;8;12
96;20.05.2017;2017;05;12;Lauantai;59;55;114;11;11;22
96;20.05.2017;2017;05;13;Lauantai;56;67;123;8;11;19
96;20.05.2017;2017;05;14;Lauantai;72;69;141;8;16;24
96;20.05.2017;2017;05;15;Lauantai;53;68;121;6;12;18
96;20.05.2017;2017;05;16;Lauantai;65;42;107;5;10;15
96;20.05.2017;2017;05;17;Lauantai;61;45;106;9;10;19
96;20.05.2017;2017;05;18;Lauantai;65;40;105;9;9;18
96;20.05.2017;2017;05;19;Lauantai;37;36;73;7;7;14
96;20.05.2017;2017;05;20;Lauantai;25;27;52;6;5;11
96;20.05.2017;2017;05;21;Lauantai;13;18;31;3;3;6
96;20.05.2017;2017;05;22;Lauantai;8;12;20;5;0;5
96;20.05.2017;2017;05;23;Lauantai;17;23;40;5;3;8
96;21.05.2017;2017;05;00;Sunnuntai;13;7;20;0;1;1
96;21.05.2017;2017;05;01;Sunnuntai;12;5;17;4;0;4
96;21.05.2017;2017;05;02;Sunnuntai;6;0;6;2;0;2
96;21.05.2017;2017;05;03;Sunnuntai;10;0;10;2;0;2
96;21.05.2017;2017;05;04;Sunnuntai;17;0;17;6;0;6
96;21.05.2017;2017;05;05;Sunnuntai;3;1;4;2;1;3
96;21.05.2017;2017;05;06;Sunnuntai;27;2;29;2;0;2
96;21.05.2017;2017;05;07;Sunnuntai;3;6;9;1;4;5
96;21.05.2017;2017;05;08;Sunnuntai;11;13;24;2;1;3
96;21.05.2017;2017;05;09;Sunnuntai;6;10;16;4;6;10
96;21.05.2017;2017;05;10;Sunnuntai;16;25;41;9;9;18
96;21.05.2017;2017;05;11;Sunnuntai;27;50;77;8;9;17
96;21.05.2017;2017;05;12;Sunnuntai;43;62;105;8;10;18
96;21.05.2017;2017;05;13;Sunnuntai;49;65;114;7;11;18
96;21.05.2017;2017;05;14;Sunnuntai;56;55;111;6;11;17
96;21.05.2017;2017;05;15;Sunnuntai;70;60;130;6;14;20
96;21.05.2017;2017;05;16;Sunnuntai;58;42;100;18;13;31
96;21.05.2017;2017;05;17;Sunnuntai;59;45;104;10;8;18
96;21.05.2017;2017;05;18;Sunnuntai;42;24;66;11;7;18
96;21.05.2017;2017;05;19;Sunnuntai;25;27;52;11;11;22
96;21.05.2017;2017;05;20;Sunnuntai;32;35;67;8;9;17
96;21.05.2017;2017;05;21;Sunnuntai;28;21;49;5;3;8
96;21.05.2017;2017;05;22;Sunnuntai;9;7;16;3;4;7
96;21.05.2017;2017;05;23;Sunnuntai;4;5;9;3;0;3
96;22.05.2017;2017;05;00;Maanantai;3;6;9;4;1;5
96;22.05.2017;2017;05;01;Maanantai;5;1;6;0;0;0
96;22.05.2017;2017;05;02;Maanantai;1;0;1;0;0;0
96;22.05.2017;2017;05;03;Maanantai;3;1;4;0;0;0
96;22.05.2017;2017;05;04;Maanantai;1;0;1;4;2;6
96;22.05.2017;2017;05;05;Maanantai;2;11;13;1;0;1
96;22.05.2017;2017;05;06;Maanantai;61;37;98;3;8;11
96;22.05.2017;2017;05;07;Maanantai;135;143;278;17;14;31
96;22.05.2017;2017;05;08;Maanantai;88;140;228;8;3;11
96;22.05.2017;2017;05;09;Maanantai;77;69;146;11;8;19
96;22.05.2017;2017;05;10;Maanantai;59;61;120;8;12;20
96;22.05.2017;2017;05;11;Maanantai;67;87;154;9;11;20
96;22.05.2017;2017;05;12;Maanantai;76;85;161;23;19;42
96;22.05.2017;2017;05;13;Maanantai;69;107;176;11;16;27
96;22.05.2017;2017;05;14;Maanantai;84;149;233;12;22;34
96;22.05.2017;2017;05;15;Maanantai;114;176;290;9;25;34
96;22.05.2017;2017;05;16;Maanantai;146;176;322;8;25;33
96;22.05.2017;2017;05;17;Maanantai;99;61;160;11;15;26
96;22.05.2017;2017;05;18;Maanantai;92;57;149;15;17;32
96;22.05.2017;2017;05;19;Maanantai;78;53;131;17;20;37
96;22.05.2017;2017;05;20;Maanantai;66;47;113;18;8;26
96;22.05.2017;2017;05;21;Maanantai;25;39;64;1;7;8
96;22.05.2017;2017;05;22;Maanantai;6;12;18;4;7;11
96;22.05.2017;2017;05;23;Maanantai;5;1;6;1;1;2
96;23.05.2017;2017;05;00;Tiistai;1;3;4;2;0;2
96;23.05.2017;2017;05;01;Tiistai;2;1;3;0;0;0
96;23.05.2017;2017;05;02;Tiistai;4;0;4;0;0;0
96;23.05.2017;2017;05;03;Tiistai;1;0;1;0;0;0
96;23.05.2017;2017;05;04;Tiistai;3;3;6;4;3;7
96;23.05.2017;2017;05;05;Tiistai;3;9;12;3;2;5
96;23.05.2017;2017;05;06;Tiistai;64;37;101;7;1;8
96;23.05.2017;2017;05;07;Tiistai;159;145;304;34;6;40
96;23.05.2017;2017;05;08;Tiistai;111;131;242;13;7;20
96;23.05.2017;2017;05;09;Tiistai;78;95;173;11;13;24
96;23.05.2017;2017;05;10;Tiistai;66;99;165;3;14;17
96;23.05.2017;2017;05;11;Tiistai;69;81;150;10;13;23
96;23.05.2017;2017;05;12;Tiistai;94;98;192;8;8;16
96;23.05.2017;2017;05;13;Tiistai;92;72;164;9;12;21
96;23.05.2017;2017;05;14;Tiistai;79;140;219;4;23;27
96;23.05.2017;2017;05;15;Tiistai;86;219;305;10;30;40
96;23.05.2017;2017;05;16;Tiistai;123;175;298;13;17;30
96;23.05.2017;2017;05;17;Tiistai;104;84;188;12;17;29
96;23.05.2017;2017;05;18;Tiistai;82;60;142;15;13;28
96;23.05.2017;2017;05;19;Tiistai;87;47;134;17;16;33
96;23.05.2017;2017;05;20;Tiistai;76;31;107;6;10;16
96;23.05.2017;2017;05;21;Tiistai;39;36;75;3;5;8
96;23.05.2017;2017;05;22;Tiistai;11;17;28;4;4;8
96;23.05.2017;2017;05;23;Tiistai;9;8;17;1;5;6
96;24.05.2017;2017;05;00;Keskiviikko;3;1;4;3;1;4
96;24.05.2017;2017;05;01;Keskiviikko;2;0;2;1;0;1
96;24.05.2017;2017;05;02;Keskiviikko;0;0;0;0;0;0
96;24.05.2017;2017;05;03;Keskiviikko;2;0;2;0;0;0
96;24.05.2017;2017;05;04;Keskiviikko;1;1;2;1;0;1
96;24.05.2017;2017;05;05;Keskiviikko;4;12;16;0;1;1
96;24.05.2017;2017;05;06;Keskiviikko;60;30;90;9;0;9
96;24.05.2017;2017;05;07;Keskiviikko;169;121;290;13;6;19
96;24.05.2017;2017;05;08;Keskiviikko;97;118;215;18;10;28
96;24.05.2017;2017;05;09;Keskiviikko;75;94;169;7;14;21
96;24.05.2017;2017;05;10;Keskiviikko;48;97;145;9;14;23
96;24.05.2017;2017;05;11;Keskiviikko;85;80;165;7;10;17
96;24.05.2017;2017;05;12;Keskiviikko;80;98;178;13;16;29
96;24.05.2017;2017;05;13;Keskiviikko;95;123;218;9;16;25
96;24.05.2017;2017;05;14;Keskiviikko;94;147;241;9;12;21
96;24.05.2017;2017;05;15;Keskiviikko;89;183;272;7;25;32
96;24.05.2017;2017;05;16;Keskiviikko;144;149;293;11;20;31
96;24.05.2017;2017;05;17;Keskiviikko;107;91;198;13;25;38
96;24.05.2017;2017;05;18;Keskiviikko;99;56;155;18;12;30
96;24.05.2017;2017;05;19;Keskiviikko;71;58;129;5;10;15
96;24.05.2017;2017;05;20;Keskiviikko;52;47;99;11;9;20
96;24.05.2017;2017;05;21;Keskiviikko;28;41;69;3;4;7
96;24.05.2017;2017;05;22;Keskiviikko;28;16;44;3;1;4
96;24.05.2017;2017;05;23;Keskiviikko;17;14;31;3;6;9
96;25.05.2017;2017;05;00;Torstai;11;2;13;4;1;5
96;25.05.2017;2017;05;01;Torstai;13;1;14;1;0;1
96;25.05.2017;2017;05;02;Torstai;12;2;14;4;0;4
96;25.05.2017;2017;05;03;Torstai;10;0;10;3;0;3
96;25.05.2017;2017;05;04;Torstai;6;1;7;2;0;2
96;25.05.2017;2017;05;05;Torstai;7;1;8;1;0;1
96;25.05.2017;2017;05;06;Torstai;24;10;34;2;0;2
96;25.05.2017;2017;05;07;Torstai;6;17;23;0;3;3
96;25.05.2017;2017;05;08;Torstai;8;30;38;4;4;8
96;25.05.2017;2017;05;09;Torstai;13;54;67;10;100;110
96;25.05.2017;2017;05;10;Torstai;21;70;91;7;105;112
96;25.05.2017;2017;05;11;Torstai;40;63;103;28;147;175
96;25.05.2017;2017;05;12;Torstai;60;61;121;74;85;159
96;25.05.2017;2017;05;13;Torstai;71;40;111;120;27;147
96;25.05.2017;2017;05;14;Torstai;71;62;133;120;41;161
96;25.05.2017;2017;05;15;Torstai;65;68;133;104;17;121
96;25.05.2017;2017;05;16;Torstai;74;67;141;87;23;110
96;25.05.2017;2017;05;17;Torstai;70;46;116;79;14;93
96;25.05.2017;2017;05;18;Torstai;62;32;94;34;14;48
96;25.05.2017;2017;05;19;Torstai;55;50;105;9;20;29
96;25.05.2017;2017;05;20;Torstai;38;28;66;6;5;11
96;25.05.2017;2017;05;21;Torstai;27;38;65;5;5;10
96;25.05.2017;2017;05;22;Torstai;14;20;34;3;4;7
96;25.05.2017;2017;05;23;Torstai;7;3;10;2;6;8
96;26.05.2017;2017;05;00;Perjantai;7;5;12;0;0;0
96;26.05.2017;2017;05;01;Perjantai;1;5;6;0;1;1
96;26.05.2017;2017;05;02;Perjantai;3;1;4;0;0;0
96;26.05.2017;2017;05;03;Perjantai;2;2;4;0;0;0
96;26.05.2017;2017;05;04;Perjantai;1;2;3;1;0;1
96;26.05.2017;2017;05;05;Perjantai;6;9;15;1;1;2
96;26.05.2017;2017;05;06;Perjantai;47;19;66;4;1;5
96;26.05.2017;2017;05;07;Perjantai;88;76;164;5;4;9
96;26.05.2017;2017;05;08;Perjantai;41;91;132;2;5;7
96;26.05.2017;2017;05;09;Perjantai;39;83;122;9;126;135
96;26.05.2017;2017;05;10;Perjantai;55;70;125;205;339;544
96;26.05.2017;2017;05;11;Perjantai;63;108;171;47;115;162
96;26.05.2017;2017;05;12;Perjantai;84;93;177;89;116;205
96;26.05.2017;2017;05;13;Perjantai;90;107;197;134;114;248
96;26.05.2017;2017;05;14;Perjantai;87;114;201;147;118;265
96;26.05.2017;2017;05;15;Perjantai;99;133;232;148;59;207
96;26.05.2017;2017;05;16;Perjantai;98;80;178;91;23;114
96;26.05.2017;2017;05;17;Perjantai;90;43;133;122;10;132
96;26.05.2017;2017;05;18;Perjantai;69;40;109;31;8;39
96;26.05.2017;2017;05;19;Perjantai;49;33;82;7;9;16
96;26.05.2017;2017;05;20;Perjantai;56;28;84;5;4;9
96;26.05.2017;2017;05;21;Perjantai;20;48;68;7;7;14
96;26.05.2017;2017;05;22;Perjantai;11;13;24;1;2;3
96;26.05.2017;2017;05;23;Perjantai;15;6;21;0;1;1
96;27.05.2017;2017;05;00;Lauantai;9;4;13;1;3;4
96;27.05.2017;2017;05;01;Lauantai;9;3;12;1;1;2
96;27.05.2017;2017;05;02;Lauantai;6;1;7;3;1;4
96;27.05.2017;2017;05;03;Lauantai;10;2;12;3;0;3
96;27.05.2017;2017;05;04;Lauantai;3;1;4;1;1;2
96;27.05.2017;2017;05;05;Lauantai;5;2;7;1;0;1
96;27.05.2017;2017;05;06;Lauantai;24;6;30;2;0;2
96;27.05.2017;2017;05;07;Lauantai;11;15;26;1;3;4
96;27.05.2017;2017;05;08;Lauantai;12;32;44;0;5;5
96;27.05.2017;2017;05;09;Lauantai;17;34;51;4;111;115
96;27.05.2017;2017;05;10;Lauantai;10;72;82;15;207;222
96;27.05.2017;2017;05;11;Lauantai;38;87;125;36;179;215
96;27.05.2017;2017;05;12;Lauantai;53;80;133;94;125;219
96;27.05.2017;2017;05;13;Lauantai;70;60;130;119;47;166
96;27.05.2017;2017;05;14;Lauantai;78;71;149;126;32;158
96;27.05.2017;2017;05;15;Lauantai;86;47;133;91;20;111
96;27.05.2017;2017;05;16;Lauantai;45;39;84;76;7;83
96;27.05.2017;2017;05;17;Lauantai;34;29;63;53;4;57
96;27.05.2017;2017;05;18;Lauantai;39;24;63;29;8;37
96;27.05.2017;2017;05;19;Lauantai;53;11;64;3;4;7
96;27.05.2017;2017;05;20;Lauantai;29;15;44;5;4;9
96;27.05.2017;2017;05;21;Lauantai;14;26;40;2;7;9
96;27.05.2017;2017;05;22;Lauantai;11;10;21;6;4;10
96;27.05.2017;2017;05;23;Lauantai;11;8;19;2;4;6
96;28.05.2017;2017;05;00;Sunnuntai;5;16;21;0;1;1
96;28.05.2017;2017;05;01;Sunnuntai;16;2;18;4;0;4
96;28.05.2017;2017;05;02;Sunnuntai;8;5;13;0;0;0
96;28.05.2017;2017;05;03;Sunnuntai;16;0;16;7;0;7
96;28.05.2017;2017;05;04;Sunnuntai;11;2;13;1;2;3
96;28.05.2017;2017;05;05;Sunnuntai;2;2;4;0;2;2
96;28.05.2017;2017;05;06;Sunnuntai;25;6;31;2;0;2
96;28.05.2017;2017;05;07;Sunnuntai;4;14;18;1;2;3
96;28.05.2017;2017;05;08;Sunnuntai;2;5;7;3;3;6
96;28.05.2017;2017;05;09;Sunnuntai;6;21;27;4;89;93
96;28.05.2017;2017;05;10;Sunnuntai;6;20;26;10;115;125
96;28.05.2017;2017;05;11;Sunnuntai;14;15;29;35;46;81
96;28.05.2017;2017;05;12;Sunnuntai;24;15;39;63;65;128
96;28.05.2017;2017;05;13;Sunnuntai;27;19;46;68;25;93
96;28.05.2017;2017;05;14;Sunnuntai;27;35;62;79;14;93
96;28.05.2017;2017;05;15;Sunnuntai;31;32;63;104;5;109
96;28.05.2017;2017;05;16;Sunnuntai;24;17;41;36;5;41
96;28.05.2017;2017;05;17;Sunnuntai;12;18;30;5;11;16
96;28.05.2017;2017;05;18;Sunnuntai;27;12;39;10;10;20
96;28.05.2017;2017;05;19;Sunnuntai;22;20;42;7;17;24
96;28.05.2017;2017;05;20;Sunnuntai;19;14;33;9;8;17
96;28.05.2017;2017;05;21;Sunnuntai;11;19;30;6;3;9
96;28.05.2017;2017;05;22;Sunnuntai;6;7;13;1;1;2
96;28.05.2017;2017;05;23;Sunnuntai;3;1;4;0;0;0
96;29.05.2017;2017;05;00;Maanantai;0;1;1;0;0;0
96;29.05.2017;2017;05;01;Maanantai;1;0;1;0;0;0
96;29.05.2017;2017;05;02;Maanantai;0;0;0;0;0;0
96;29.05.2017;2017;05;03;Maanantai;1;1;2;0;0;0
96;29.05.2017;2017;05;04;Maanantai;2;1;3;1;1;2
96;29.05.2017;2017;05;05;Maanantai;5;5;10;0;2;2
96;29.05.2017;2017;05;06;Maanantai;69;32;101;5;1;6
96;29.05.2017;2017;05;07;Maanantai;138;118;256;20;7;27
96;29.05.2017;2017;05;08;Maanantai;91;124;215;6;10;16
96;29.05.2017;2017;05;09;Maanantai;71;64;135;10;6;16
96;29.05.2017;2017;05;10;Maanantai;60;59;119;10;14;24
96;29.05.2017;2017;05;11;Maanantai;47;64;111;7;12;19
96;29.05.2017;2017;05;12;Maanantai;69;80;149;9;14;23
96;29.05.2017;2017;05;13;Maanantai;89;89;178;13;10;23
96;29.05.2017;2017;05;14;Maanantai;59;107;166;4;17;21
96;29.05.2017;2017;05;15;Maanantai;106;195;301;5;21;26
96;29.05.2017;2017;05;16;Maanantai;106;150;256;7;16;23
96;29.05.2017;2017;05;17;Maanantai;89;78;167;12;13;25
96;29.05.2017;2017;05;18;Maanantai;94;53;147;14;20;34
96;29.05.2017;2017;05;19;Maanantai;70;36;106;21;20;41
96;29.05.2017;2017;05;20;Maanantai;59;34;93;9;12;21
96;29.05.2017;2017;05;21;Maanantai;19;26;45;12;9;21
96;29.05.2017;2017;05;22;Maanantai;14;17;31;1;4;5
96;29.05.2017;2017;05;23;Maanantai;4;4;8;1;1;2
96;30.05.2017;2017;05;00;Tiistai;4;3;7;1;1;2
96;30.05.2017;2017;05;01;Tiistai;1;0;1;0;0;0
96;30.05.2017;2017;05;02;Tiistai;0;0;0;1;0;1
96;30.05.2017;2017;05;03;Tiistai;1;0;1;0;0;0
96;30.05.2017;2017;05;04;Tiistai;2;4;6;2;0;2
96;30.05.2017;2017;05;05;Tiistai;3;15;18;3;1;4
96;30.05.2017;2017;05;06;Tiistai;60;32;92;4;1;5
96;30.05.2017;2017;05;07;Tiistai;142;129;271;25;11;36
96;30.05.2017;2017;05;08;Tiistai;85;134;219;10;9;19
96;30.05.2017;2017;05;09;Tiistai;60;91;151;1;5;6
96;30.05.2017;2017;05;10;Tiistai;64;65;129;6;8;14
96;30.05.2017;2017;05;11;Tiistai;87;87;174;7;13;20
96;30.05.2017;2017;05;12;Tiistai;106;82;188;18;11;29
96;30.05.2017;2017;05;13;Tiistai;94;94;188;7;11;18
96;30.05.2017;2017;05;14;Tiistai;66;121;187;6;20;26
96;30.05.2017;2017;05;15;Tiistai;99;200;299;15;25;40
96;30.05.2017;2017;05;16;Tiistai;137;137;274;14;20;34
96;30.05.2017;2017;05;17;Tiistai;91;79;170;15;9;24
96;30.05.2017;2017;05;18;Tiistai;77;52;129;15;8;23
96;30.05.2017;2017;05;19;Tiistai;77;49;126;14;9;23
96;30.05.2017;2017;05;20;Tiistai;62;27;89;7;8;15
96;30.05.2017;2017;05;21;Tiistai;48;43;91;6;6;12
96;30.05.2017;2017;05;22;Tiistai;11;14;25;1;5;6
96;30.05.2017;2017;05;23;Tiistai;10;5;15;2;1;3
96;31.05.2017;2017;05;00;Keskiviikko;6;0;6;1;2;3
96;31.05.2017;2017;05;01;Keskiviikko;1;1;2;0;0;0
96;31.05.2017;2017;05;02;Keskiviikko;0;0;0;0;0;0
96;31.05.2017;2017;05;03;Keskiviikko;1;0;1;0;1;1
96;31.05.2017;2017;05;04;Keskiviikko;2;2;4;0;1;1
96;31.05.2017;2017;05;05;Keskiviikko;6;9;15;1;1;2
96;31.05.2017;2017;05;06;Keskiviikko;53;34;87;2;0;2
96;31.05.2017;2017;05;07;Keskiviikko;140;99;239;18;11;29
96;31.05.2017;2017;05;08;Keskiviikko;64;120;184;8;2;10
96;31.05.2017;2017;05;09;Keskiviikko;49;52;101;4;4;8
96;31.05.2017;2017;05;10;Keskiviikko;33;39;72;2;2;4
96;31.05.2017;2017;05;11;Keskiviikko;61;57;118;9;10;19
96;31.05.2017;2017;05;12;Keskiviikko;65;92;157;10;9;19
96;31.05.2017;2017;05;13;Keskiviikko;72;75;147;7;9;16
96;31.05.2017;2017;05;14;Keskiviikko;45;80;125;8;9;17
96;31.05.2017;2017;05;15;Keskiviikko;80;156;236;6;21;27
96;31.05.2017;2017;05;16;Keskiviikko;99;136;235;14;15;29
96;31.05.2017;2017;05;17;Keskiviikko;68;69;137;10;15;25
96;31.05.2017;2017;05;18;Keskiviikko;88;47;135;14;8;22
96;31.05.2017;2017;05;19;Keskiviikko;52;35;87;12;9;21
96;31.05.2017;2017;05;20;Keskiviikko;56;32;88;5;21;26
96;31.05.2017;2017;05;21;Keskiviikko;30;38;68;5;5;10
96;31.05.2017;2017;05;22;Keskiviikko;9;10;19;6;8;14
96;31.05.2017;2017;05;23;Keskiviikko;5;9;14;1;1;2
96;01.06.2017;2017;06;00;Torstai;1;2;3;0;0;0
96;01.06.2017;2017;06;01;Torstai;3;2;5;0;0;0
96;01.06.2017;2017;06;02;Torstai;3;1;4;0;0;0
96;01.06.2017;2017;06;03;Torstai;1;0;1;2;0;2
96;01.06.2017;2017;06;04;Torstai;3;1;4;0;0;0
96;01.06.2017;2017;06;05;Torstai;8;12;20;1;0;1
96;01.06.2017;2017;06;06;Torstai;53;38;91;8;1;9
96;01.06.2017;2017;06;07;Torstai;129;110;239;22;5;27
96;01.06.2017;2017;06;08;Torstai;98;118;216;9;9;18
96;01.06.2017;2017;06;09;Torstai;71;77;148;6;7;13
96;01.06.2017;2017;06;10;Torstai;58;83;141;9;14;23
96;01.06.2017;2017;06;11;Torstai;55;72;127;8;15;23
96;01.06.2017;2017;06;12;Torstai;43;65;108;9;16;25
96;01.06.2017;2017;06;13;Torstai;64;62;126;7;7;14
96;01.06.2017;2017;06;14;Torstai;52;77;129;9;9;18
96;01.06.2017;2017;06;15;Torstai;91;157;248;3;12;15
96;01.06.2017;2017;06;16;Torstai;99;118;217;2;12;14
96;01.06.2017;2017;06;17;Torstai;91;58;149;10;9;19
96;01.06.2017;2017;06;18;Torstai;51;29;80;11;11;22
96;01.06.2017;2017;06;19;Torstai;48;41;89;7;11;18
96;01.06.2017;2017;06;20;Torstai;42;24;66;4;5;9
96;01.06.2017;2017;06;21;Torstai;25;32;57;6;2;8
96;01.06.2017;2017;06;22;Torstai;14;11;25;1;4;5
96;01.06.2017;2017;06;23;Torstai;6;2;8;1;1;2
96;02.06.2017;2017;06;00;Perjantai;6;5;11;0;1;1
96;02.06.2017;2017;06;01;Perjantai;5;1;6;0;0;0
96;02.06.2017;2017;06;02;Perjantai;0;0;0;0;0;0
96;02.06.2017;2017;06;03;Perjantai;0;0;0;0;0;0
96;02.06.2017;2017;06;04;Perjantai;4;2;6;0;0;0
96;02.06.2017;2017;06;05;Perjantai;4;6;10;1;1;2
96;02.06.2017;2017;06;06;Perjantai;52;24;76;1;1;2
96;02.06.2017;2017;06;07;Perjantai;94;62;156;13;4;17
96;02.06.2017;2017;06;08;Perjantai;46;86;132;4;4;8
96;02.06.2017;2017;06;09;Perjantai;32;48;80;8;5;13
96;02.06.2017;2017;06;10;Perjantai;51;44;95;3;12;15
96;02.06.2017;2017;06;11;Perjantai;48;59;107;5;11;16
96;02.06.2017;2017;06;12;Perjantai;51;78;129;7;15;22
96;02.06.2017;2017;06;13;Perjantai;52;64;116;3;6;9
96;02.06.2017;2017;06;14;Perjantai;53;101;154;2;11;13
96;02.06.2017;2017;06;15;Perjantai;58;119;177;5;19;24
96;02.06.2017;2017;06;16;Perjantai;52;96;148;7;12;19
96;02.06.2017;2017;06;17;Perjantai;41;44;85;7;7;14
96;02.06.2017;2017;06;18;Perjantai;45;32;77;10;9;19
96;02.06.2017;2017;06;19;Perjantai;36;24;60;5;6;11
96;02.06.2017;2017;06;20;Perjantai;35;15;50;2;2;4
96;02.06.2017;2017;06;21;Perjantai;18;20;38;3;4;7
96;02.06.2017;2017;06;22;Perjantai;5;7;12;3;3;6
96;02.06.2017;2017;06;23;Perjantai;7;12;19;0;1;1
96;03.06.2017;2017;06;00;Lauantai;9;1;10;2;2;4
96;03.06.2017;2017;06;01;Lauantai;0;2;2;0;0;0
96;03.06.2017;2017;06;02;Lauantai;2;0;2;0;0;0
96;03.06.2017;2017;06;03;Lauantai;5;0;5;1;0;1
96;03.06.2017;2017;06;04;Lauantai;3;5;8;1;2;3
96;03.06.2017;2017;06;05;Lauantai;4;3;7;0;0;0
96;03.06.2017;2017;06;06;Lauantai;14;10;24;1;0;1
96;03.06.2017;2017;06;07;Lauantai;12;20;32;3;2;5
96;03.06.2017;2017;06;08;Lauantai;6;23;29;0;2;2
96;03.06.2017;2017;06;09;Lauantai;28;38;66;2;4;6
96;03.06.2017;2017;06;10;Lauantai;27;33;60;6;5;11
96;03.06.2017;2017;06;11;Lauantai;31;22;53;6;4;10
96;03.06.2017;2017;06;12;Lauantai;28;36;64;9;3;12
96;03.06.2017;2017;06;13;Lauantai;34;42;76;8;12;20
96;03.06.2017;2017;06;14;Lauantai;41;43;84;2;7;9
96;03.06.2017;2017;06;15;Lauantai;31;34;65;7;3;10
96;03.06.2017;2017;06;16;Lauantai;29;21;50;5;5;10
96;03.06.2017;2017;06;17;Lauantai;27;26;53;1;3;4
96;03.06.2017;2017;06;18;Lauantai;30;15;45;4;5;9
96;03.06.2017;2017;06;19;Lauantai;14;27;41;8;9;17
96;03.06.2017;2017;06;20;Lauantai;19;30;49;5;5;10
96;03.06.2017;2017;06;21;Lauantai;25;31;56;2;2;4
96;03.06.2017;2017;06;22;Lauantai;11;6;17;2;1;3
96;03.06.2017;2017;06;23;Lauantai;10;9;19;1;1;2
96;04.06.2017;2017;06;00;Sunnuntai;14;13;27;4;1;5
96;04.06.2017;2017;06;01;Sunnuntai;14;3;17;0;0;0
96;04.06.2017;2017;06;02;Sunnuntai;18;1;19;1;0;1
96;04.06.2017;2017;06;03;Sunnuntai;25;2;27;4;0;4
96;04.06.2017;2017;06;04;Sunnuntai;9;0;9;6;2;8
96;04.06.2017;2017;06;05;Sunnuntai;4;1;5;1;0;1
96;04.06.2017;2017;06;06;Sunnuntai;16;4;20;1;0;1
96;04.06.2017;2017;06;07;Sunnuntai;3;14;17;0;2;2
96;04.06.2017;2017;06;08;Sunnuntai;7;10;17;4;3;7
96;04.06.2017;2017;06;09;Sunnuntai;22;23;45;4;3;7
96;04.06.2017;2017;06;10;Sunnuntai;20;15;35;4;5;9
96;04.06.2017;2017;06;11;Sunnuntai;28;43;71;7;5;12
96;04.06.2017;2017;06;12;Sunnuntai;42;36;78;8;5;13
96;04.06.2017;2017;06;13;Sunnuntai;60;57;117;7;4;11
96;04.06.2017;2017;06;14;Sunnuntai;43;47;90;6;5;11
96;04.06.2017;2017;06;15;Sunnuntai;41;56;97;9;5;14
96;04.06.2017;2017;06;16;Sunnuntai;54;37;91;13;6;19
96;04.06.2017;2017;06;17;Sunnuntai;35;27;62;12;6;18
96;04.06.2017;2017;06;18;Sunnuntai;53;25;78;7;12;19
96;04.06.2017;2017;06;19;Sunnuntai;31;26;57;11;9;20
96;04.06.2017;2017;06;20;Sunnuntai;25;30;55;6;6;12
96;04.06.2017;2017;06;21;Sunnuntai;27;25;52;6;1;7
96;04.06.2017;2017;06;22;Sunnuntai;9;1;10;2;0;2
96;04.06.2017;2017;06;23;Sunnuntai;6;4;10;0;0;0
96;05.06.2017;2017;06;00;Maanantai;2;1;3;2;0;2
96;05.06.2017;2017;06;01;Maanantai;1;0;1;0;1;1
96;05.06.2017;2017;06;02;Maanantai;4;0;4;1;0;1
96;05.06.2017;2017;06;03;Maanantai;2;3;5;0;0;0
96;05.06.2017;2017;06;04;Maanantai;2;3;5;1;0;1
96;05.06.2017;2017;06;05;Maanantai;3;9;12;2;0;2
96;05.06.2017;2017;06;06;Maanantai;76;39;115;8;0;8
96;05.06.2017;2017;06;07;Maanantai;141;112;253;17;10;27
96;05.06.2017;2017;06;08;Maanantai;60;96;156;3;3;6
96;05.06.2017;2017;06;09;Maanantai;45;65;110;9;9;18
96;05.06.2017;2017;06;10;Maanantai;50;62;112;3;8;11
96;05.06.2017;2017;06;11;Maanantai;54;77;131;6;12;18
96;05.06.2017;2017;06;12;Maanantai;99;69;168;7;15;22
96;05.06.2017;2017;06;13;Maanantai;73;73;146;8;10;18
96;05.06.2017;2017;06;14;Maanantai;77;107;184;9;8;17
96;05.06.2017;2017;06;15;Maanantai;84;189;273;7;24;31
96;05.06.2017;2017;06;16;Maanantai;106;137;243;9;11;20
96;05.06.2017;2017;06;17;Maanantai;105;72;177;13;9;22
96;05.06.2017;2017;06;18;Maanantai;81;50;131;10;5;15
96;05.06.2017;2017;06;19;Maanantai;57;43;100;8;13;21
96;05.06.2017;2017;06;20;Maanantai;64;39;103;4;13;17
96;05.06.2017;2017;06;21;Maanantai;26;35;61;3;4;7
96;05.06.2017;2017;06;22;Maanantai;9;13;22;0;2;2
96;05.06.2017;2017;06;23;Maanantai;2;4;6;1;0;1
96;06.06.2017;2017;06;00;Tiistai;2;1;3;1;0;1
96;06.06.2017;2017;06;01;Tiistai;5;3;8;0;1;1
96;06.06.2017;2017;06;02;Tiistai;1;0;1;1;0;1
96;06.06.2017;2017;06;03;Tiistai;1;0;1;1;0;1
96;06.06.2017;2017;06;04;Tiistai;1;3;4;0;0;0
96;06.06.2017;2017;06;05;Tiistai;4;6;10;0;1;1
96;06.06.2017;2017;06;06;Tiistai;60;30;90;6;1;7
96;06.06.2017;2017;06;07;Tiistai;111;106;217;13;5;18
96;06.06.2017;2017;06;08;Tiistai;39;74;113;7;4;11
96;06.06.2017;2017;06;09;Tiistai;40;42;82;8;7;15
96;06.06.2017;2017;06;10;Tiistai;32;43;75;4;8;12
96;06.06.2017;2017;06;11;Tiistai;34;61;95;7;9;16
96;06.06.2017;2017;06;12;Tiistai;61;55;116;2;8;10
96;06.06.2017;2017;06;13;Tiistai;62;69;131;5;10;15
96;06.06.2017;2017;06;14;Tiistai;58;83;141;7;13;20
96;06.06.2017;2017;06;15;Tiistai;87;176;263;4;13;17
96;06.06.2017;2017;06;16;Tiistai;113;135;248;9;15;24
96;06.06.2017;2017;06;17;Tiistai;80;79;159;15;11;26
96;06.06.2017;2017;06;18;Tiistai;81;70;151;14;16;30
96;06.06.2017;2017;06;19;Tiistai;80;46;126;12;30;42
96;06.06.2017;2017;06;20;Tiistai;64;34;98;7;12;19
96;06.06.2017;2017;06;21;Tiistai;44;48;92;5;7;12
96;06.06.2017;2017;06;22;Tiistai;11;18;29;2;1;3
96;06.06.2017;2017;06;23;Tiistai;9;12;21;1;1;2
96;07.06.2017;2017;06;00;Keskiviikko;6;7;13;0;2;2
96;07.06.2017;2017;06;01;Keskiviikko;3;0;3;2;0;2
96;07.06.2017;2017;06;02;Keskiviikko;5;1;6;1;0;1
96;07.06.2017;2017;06;03;Keskiviikko;0;1;1;0;0;0
96;07.06.2017;2017;06;04;Keskiviikko;1;2;3;1;1;2
96;07.06.2017;2017;06;05;Keskiviikko;5;8;13;1;0;1
96;07.06.2017;2017;06;06;Keskiviikko;68;41;109;8;3;11
96;07.06.2017;2017;06;07;Keskiviikko;145;140;285;20;6;26
96;07.06.2017;2017;06;08;Keskiviikko;59;128;187;7;6;13
96;07.06.2017;2017;06;09;Keskiviikko;50;72;122;6;8;14
96;07.06.2017;2017;06;10;Keskiviikko;48;71;119;12;14;26
96;07.06.2017;2017;06;11;Keskiviikko;75;81;156;11;12;23
96;07.06.2017;2017;06;12;Keskiviikko;81;85;166;12;10;22
96;07.06.2017;2017;06;13;Keskiviikko;94;78;172;6;12;18
96;07.06.2017;2017;06;14;Keskiviikko;86;122;208;8;9;17
96;07.06.2017;2017;06;15;Keskiviikko;152;187;339;9;13;22
96;07.06.2017;2017;06;16;Keskiviikko;175;177;352;11;18;29
96;07.06.2017;2017;06;17;Keskiviikko;113;94;207;11;9;20
96;07.06.2017;2017;06;18;Keskiviikko;109;63;172;17;12;29
96;07.06.2017;2017;06;19;Keskiviikko;79;56;135;10;13;23
96;07.06.2017;2017;06;20;Keskiviikko;90;59;149;9;19;28
96;07.06.2017;2017;06;21;Keskiviikko;39;35;74;6;9;15
96;07.06.2017;2017;06;22;Keskiviikko;27;18;45;2;0;2
96;07.06.2017;2017;06;23;Keskiviikko;17;14;31;4;1;5
96;08.06.2017;2017;06;00;Torstai;12;4;16;1;1;2
96;08.06.2017;2017;06;01;Torstai;9;2;11;0;0;0
96;08.06.2017;2017;06;02;Torstai;7;0;7;0;0;0
96;08.06.2017;2017;06;03;Torstai;5;0;5;3;0;3
96;08.06.2017;2017;06;04;Torstai;4;3;7;0;1;1
96;08.06.2017;2017;06;05;Torstai;8;10;18;0;0;0
96;08.06.2017;2017;06;06;Torstai;76;37;113;8;4;12
96;08.06.2017;2017;06;07;Torstai;129;149;278;18;3;21
96;08.06.2017;2017;06;08;Torstai;80;108;188;5;5;10
96;08.06.2017;2017;06;09;Torstai;40;80;120;4;8;12
96;08.06.2017;2017;06;10;Torstai;49;75;124;5;14;19
96;08.06.2017;2017;06;11;Torstai;54;61;115;5;8;13
96;08.06.2017;2017;06;12;Torstai;74;81;155;11;8;19
96;08.06.2017;2017;06;13;Torstai;96;77;173;8;11;19
96;08.06.2017;2017;06;14;Torstai;77;129;206;12;22;34
96;08.06.2017;2017;06;15;Torstai;125;196;321;13;23;36
96;08.06.2017;2017;06;16;Torstai;156;149;305;14;25;39
96;08.06.2017;2017;06;17;Torstai;103;125;228;11;19;30
96;08.06.2017;2017;06;18;Torstai;97;64;161;7;6;13
96;08.06.2017;2017;06;19;Torstai;83;71;154;13;9;22
96;08.06.2017;2017;06;20;Torstai;98;37;135;10;7;17
96;08.06.2017;2017;06;21;Torstai;95;58;153;2;4;6
96;08.06.2017;2017;06;22;Torstai;20;15;35;2;2;4
96;08.06.2017;2017;06;23;Torstai;12;3;15;0;0;0
96;09.06.2017;2017;06;00;Perjantai;10;1;11;0;1;1
96;09.06.2017;2017;06;01;Perjantai;3;1;4;0;0;0
96;09.06.2017;2017;06;02;Perjantai;11;0;11;3;2;5
96;09.06.2017;2017;06;03;Perjantai;4;2;6;2;0;2
96;09.06.2017;2017;06;04;Perjantai;3;0;3;0;0;0
96;09.06.2017;2017;06;05;Perjantai;5;7;12;2;0;2
96;09.06.2017;2017;06;06;Perjantai;57;42;99;5;1;6
96;09.06.2017;2017;06;07;Perjantai;116;136;252;16;9;25
96;09.06.2017;2017;06;08;Perjantai;63;106;169;5;5;10
96;09.06.2017;2017;06;09;Perjantai;36;63;99;9;5;14
96;09.06.2017;2017;06;10;Perjantai;30;62;92;10;5;15
96;09.06.2017;2017;06;11;Perjantai;63;90;153;6;6;12
96;09.06.2017;2017;06;12;Perjantai;76;72;148;10;12;22
96;09.06.2017;2017;06;13;Perjantai;110;84;194;12;16;28
96;09.06.2017;2017;06;14;Perjantai;110;121;231;8;15;23
96;09.06.2017;2017;06;15;Perjantai;85;167;252;8;21;29
96;09.06.2017;2017;06;16;Perjantai;130;101;231;8;12;20
96;09.06.2017;2017;06;17;Perjantai;75;71;146;7;12;19
96;09.06.2017;2017;06;18;Perjantai;65;74;139;7;3;10
96;09.06.2017;2017;06;19;Perjantai;64;43;107;9;5;14
96;09.06.2017;2017;06;20;Perjantai;58;42;100;16;18;34
96;09.06.2017;2017;06;21;Perjantai;54;38;92;7;5;12
96;09.06.2017;2017;06;22;Perjantai;24;30;54;1;2;3
96;09.06.2017;2017;06;23;Perjantai;31;16;47;7;5;12
96;10.06.2017;2017;06;00;Lauantai;25;14;39;1;1;2
96;10.06.2017;2017;06;01;Lauantai;27;1;28;0;0;0
96;10.06.2017;2017;06;02;Lauantai;21;2;23;2;0;2
96;10.06.2017;2017;06;03;Lauantai;23;0;23;3;1;4
96;10.06.2017;2017;06;04;Lauantai;20;4;24;4;3;7
96;10.06.2017;2017;06;05;Lauantai;10;4;14;1;0;1
96;10.06.2017;2017;06;06;Lauantai;21;11;32;2;0;2
96;10.06.2017;2017;06;07;Lauantai;4;21;25;1;3;4
96;10.06.2017;2017;06;08;Lauantai;10;28;38;2;7;9
96;10.06.2017;2017;06;09;Lauantai;24;40;64;1;4;5
96;10.06.2017;2017;06;10;Lauantai;32;40;72;2;5;7
96;10.06.2017;2017;06;11;Lauantai;33;63;96;5;6;11
96;10.06.2017;2017;06;12;Lauantai;62;97;159;8;10;18
96;10.06.2017;2017;06;13;Lauantai;62;78;140;23;175;198
96;10.06.2017;2017;06;14;Lauantai;51;101;152;46;406;452
96;10.06.2017;2017;06;15;Lauantai;92;54;146;14;36;50
96;10.06.2017;2017;06;16;Lauantai;57;46;103;4;2;6
96;10.06.2017;2017;06;17;Lauantai;67;58;125;9;4;13
96;10.06.2017;2017;06;18;Lauantai;49;57;106;6;2;8
96;10.06.2017;2017;06;19;Lauantai;54;38;92;4;6;10
96;10.06.2017;2017;06;20;Lauantai;36;36;72;2;8;10
96;10.06.2017;2017;06;21;Lauantai;22;33;55;1;6;7
96;10.06.2017;2017;06;22;Lauantai;29;26;55;2;1;3
96;10.06.2017;2017;06;23;Lauantai;20;20;40;1;1;2
96;11.06.2017;2017;06;00;Sunnuntai;28;14;42;1;5;6
96;11.06.2017;2017;06;01;Sunnuntai;19;8;27;2;2;4
96;11.06.2017;2017;06;02;Sunnuntai;14;0;14;1;0;1
96;11.06.2017;2017;06;03;Sunnuntai;28;1;29;0;0;0
96;11.06.2017;2017;06;04;Sunnuntai;16;0;16;1;1;2
96;11.06.2017;2017;06;05;Sunnuntai;10;2;12;0;1;1
96;11.06.2017;2017;06;06;Sunnuntai;24;8;32;1;0;1
96;11.06.2017;2017;06;07;Sunnuntai;10;11;21;1;2;3
96;11.06.2017;2017;06;08;Sunnuntai;4;16;20;2;3;5
96;11.06.2017;2017;06;09;Sunnuntai;15;18;33;4;2;6
96;11.06.2017;2017;06;10;Sunnuntai;24;34;58;5;4;9
96;11.06.2017;2017;06;11;Sunnuntai;42;45;87;6;6;12
96;11.06.2017;2017;06;12;Sunnuntai;53;70;123;6;5;11
96;11.06.2017;2017;06;13;Sunnuntai;75;74;149;3;4;7
96;11.06.2017;2017;06;14;Sunnuntai;66;67;133;13;6;19
96;11.06.2017;2017;06;15;Sunnuntai;70;78;148;3;12;15
96;11.06.2017;2017;06;16;Sunnuntai;71;88;159;6;9;15
96;11.06.2017;2017;06;17;Sunnuntai;55;41;96;9;7;16
96;11.06.2017;2017;06;18;Sunnuntai;50;51;101;17;13;30
96;11.06.2017;2017;06;19;Sunnuntai;118;36;154;7;11;18
96;11.06.2017;2017;06;20;Sunnuntai;29;25;54;7;7;14
96;11.06.2017;2017;06;21;Sunnuntai;24;23;47;4;6;10
96;11.06.2017;2017;06;22;Sunnuntai;10;12;22;4;1;5
96;11.06.2017;2017;06;23;Sunnuntai;6;14;20;3;1;4
96;12.06.2017;2017;06;00;Maanantai;13;3;16;1;1;2
96;12.06.2017;2017;06;01;Maanantai;3;4;7;1;1;2
96;12.06.2017;2017;06;02;Maanantai;3;0;3;0;0;0
96;12.06.2017;2017;06;03;Maanantai;3;1;4;5;0;5
96;12.06.2017;2017;06;04;Maanantai;3;2;5;0;0;0
96;12.06.2017;2017;06;05;Maanantai;13;11;24;1;1;2
96;12.06.2017;2017;06;06;Maanantai;53;45;98;6;0;6
96;12.06.2017;2017;06;07;Maanantai;121;106;227;17;8;25
96;12.06.2017;2017;06;08;Maanantai;36;73;109;5;4;9
96;12.06.2017;2017;06;09;Maanantai;25;26;51;7;0;7
96;12.06.2017;2017;06;10;Maanantai;16;35;51;1;2;3
96;12.06.2017;2017;06;11;Maanantai;41;41;82;3;4;7
96;12.06.2017;2017;06;12;Maanantai;43;52;95;3;8;11
96;12.06.2017;2017;06;13;Maanantai;54;58;112;4;9;13
96;12.06.2017;2017;06;14;Maanantai;58;82;140;6;8;14
96;12.06.2017;2017;06;15;Maanantai;73;165;238;4;21;25
96;12.06.2017;2017;06;16;Maanantai;88;122;210;10;16;26
96;12.06.2017;2017;06;17;Maanantai;70;60;130;6;3;9
96;12.06.2017;2017;06;18;Maanantai;70;39;109;15;13;28
96;12.06.2017;2017;06;19;Maanantai;53;45;98;7;10;17
96;12.06.2017;2017;06;20;Maanantai;52;38;90;10;5;15
96;12.06.2017;2017;06;21;Maanantai;35;34;69;7;9;16
96;12.06.2017;2017;06;22;Maanantai;11;16;27;1;1;2
96;12.06.2017;2017;06;23;Maanantai;7;4;11;4;2;6
96;13.06.2017;2017;06;00;Tiistai;11;1;12;1;2;3
96;13.06.2017;2017;06;01;Tiistai;2;2;4;0;0;0
96;13.06.2017;2017;06;02;Tiistai;3;2;5;0;2;2
96;13.06.2017;2017;06;03;Tiistai;4;1;5;0;0;0
96;13.06.2017;2017;06;04;Tiistai;0;3;3;1;1;2
96;13.06.2017;2017;06;05;Tiistai;5;9;14;0;0;0
96;13.06.2017;2017;06;06;Tiistai;61;45;106;5;0;5
96;13.06.2017;2017;06;07;Tiistai;134;137;271;19;3;22
96;13.06.2017;2017;06;08;Tiistai;58;116;174;10;12;22
96;13.06.2017;2017;06;09;Tiistai;48;72;120;7;9;16
96;13.06.2017;2017;06;10;Tiistai;53;69;122;8;10;18
96;13.06.2017;2017;06;11;Tiistai;52;86;138;2;11;13
96;13.06.2017;2017;06;12;Tiistai;72;50;122;11;7;18
96;13.06.2017;2017;06;13;Tiistai;65;72;137;8;21;29
96;13.06.2017;2017;06;14;Tiistai;58;98;156;3;11;14
96;13.06.2017;2017;06;15;Tiistai;88;220;308;4;22;26
96;13.06.2017;2017;06;16;Tiistai;135;122;257;8;17;25
96;13.06.2017;2017;06;17;Tiistai;94;80;174;9;15;24
96;13.06.2017;2017;06;18;Tiistai;81;69;150;27;12;39
96;13.06.2017;2017;06;19;Tiistai;87;42;129;12;27;39
96;13.06.2017;2017;06;20;Tiistai;72;31;103;6;5;11
96;13.06.2017;2017;06;21;Tiistai;48;41;89;2;7;9
96;13.06.2017;2017;06;22;Tiistai;21;16;37;0;1;1
96;13.06.2017;2017;06;23;Tiistai;18;8;26;3;2;5
96;14.06.2017;2017;06;00;Keskiviikko;4;6;10;1;1;2
96;14.06.2017;2017;06;01;Keskiviikko;1;2;3;1;0;1
96;14.06.2017;2017;06;02;Keskiviikko;0;0;0;0;0;0
96;14.06.2017;2017;06;03;Keskiviikko;3;3;6;0;0;0
96;14.06.2017;2017;06;04;Keskiviikko;3;2;5;2;0;2
96;14.06.2017;2017;06;05;Keskiviikko;6;9;15;0;0;0
96;14.06.2017;2017;06;06;Keskiviikko;68;37;105;9;0;9
96;14.06.2017;2017;06;07;Keskiviikko;129;144;273;19;2;21
96;14.06.2017;2017;06;08;Keskiviikko;61;116;177;2;6;8
96;14.06.2017;2017;06;09;Keskiviikko;36;75;111;2;4;6
96;14.06.2017;2017;06;10;Keskiviikko;33;70;103;5;7;12
96;14.06.2017;2017;06;11;Keskiviikko;54;63;117;8;18;26
96;14.06.2017;2017;06;12;Keskiviikko;94;72;166;37;44;81
96;14.06.2017;2017;06;13;Keskiviikko;77;68;145;13;14;27
96;14.06.2017;2017;06;14;Keskiviikko;85;95;180;7;11;18
96;14.06.2017;2017;06;15;Keskiviikko;119;180;299;7;32;39
96;14.06.2017;2017;06;16;Keskiviikko;134;168;302;7;20;27
96;14.06.2017;2017;06;17;Keskiviikko;118;78;196;9;6;15
96;14.06.2017;2017;06;18;Keskiviikko;88;59;147;17;18;35
96;14.06.2017;2017;06;19;Keskiviikko;79;48;127;15;16;31
96;14.06.2017;2017;06;20;Keskiviikko;78;51;129;9;10;19
96;14.06.2017;2017;06;21;Keskiviikko;41;51;92;3;1;4
96;14.06.2017;2017;06;22;Keskiviikko;12;20;32;2;1;3
96;14.06.2017;2017;06;23;Keskiviikko;9;4;13;1;1;2
96;15.06.2017;2017;06;00;Torstai;6;3;9;0;2;2
96;15.06.2017;2017;06;01;Torstai;6;3;9;0;1;1
96;15.06.2017;2017;06;02;Torstai;8;2;10;0;0;0
96;15.06.2017;2017;06;03;Torstai;1;0;1;1;1;2
96;15.06.2017;2017;06;04;Torstai;1;3;4;0;1;1
96;15.06.2017;2017;06;05;Torstai;6;4;10;0;2;2
96;15.06.2017;2017;06;06;Torstai;67;37;104;5;1;6
96;15.06.2017;2017;06;07;Torstai;128;118;246;14;12;26
96;15.06.2017;2017;06;08;Torstai;53;113;166;9;7;16
96;15.06.2017;2017;06;09;Torstai;38;71;109;2;8;10
96;15.06.2017;2017;06;10;Torstai;50;62;112;8;15;23
96;15.06.2017;2017;06;11;Torstai;59;78;137;5;4;9
96;15.06.2017;2017;06;12;Torstai;89;75;164;15;5;20
96;15.06.2017;2017;06;13;Torstai;83;62;145;9;14;23
96;15.06.2017;2017;06;14;Torstai;89;120;209;6;23;29
96;15.06.2017;2017;06;15;Torstai;151;179;330;10;39;49
96;15.06.2017;2017;06;16;Torstai;129;150;279;7;12;19
96;15.06.2017;2017;06;17;Torstai;110;102;212;6;9;15
96;15.06.2017;2017;06;18;Torstai;93;64;157;8;11;19
96;15.06.2017;2017;06;19;Torstai;75;53;128;6;5;11
96;15.06.2017;2017;06;20;Torstai;135;45;180;12;4;16
96;15.06.2017;2017;06;21;Torstai;43;52;95;5;7;12
96;15.06.2017;2017;06;22;Torstai;31;12;43;0;3;3
96;15.06.2017;2017;06;23;Torstai;14;12;26;1;3;4
96;16.06.2017;2017;06;00;Perjantai;7;7;14;3;1;4
96;16.06.2017;2017;06;01;Perjantai;3;2;5;1;0;1
96;16.06.2017;2017;06;02;Perjantai;7;2;9;0;0;0
96;16.06.2017;2017;06;03;Perjantai;1;0;1;2;0;2
96;16.06.2017;2017;06;04;Perjantai;4;0;4;1;1;2
96;16.06.2017;2017;06;05;Perjantai;5;7;12;1;0;1
96;16.06.2017;2017;06;06;Perjantai;80;37;117;3;3;6
96;16.06.2017;2017;06;07;Perjantai;110;121;231;17;8;25
96;16.06.2017;2017;06;08;Perjantai;45;82;127;5;5;10
96;16.06.2017;2017;06;09;Perjantai;41;77;118;5;10;15
96;16.06.2017;2017;06;10;Perjantai;47;65;112;5;11;16
96;16.06.2017;2017;06;11;Perjantai;60;86;146;5;11;16
96;16.06.2017;2017;06;12;Perjantai;79;87;166;7;5;12
96;16.06.2017;2017;06;13;Perjantai;82;86;168;2;17;19
96;16.06.2017;2017;06;14;Perjantai;89;153;242;7;21;28
96;16.06.2017;2017;06;15;Perjantai;109;151;260;12;31;43
96;16.06.2017;2017;06;16;Perjantai;123;102;225;11;13;24
96;16.06.2017;2017;06;17;Perjantai;91;70;161;9;10;19
96;16.06.2017;2017;06;18;Perjantai;76;59;135;10;4;14
96;16.06.2017;2017;06;19;Perjantai;49;45;94;6;10;16
96;16.06.2017;2017;06;20;Perjantai;55;42;97;5;10;15
96;16.06.2017;2017;06;21;Perjantai;46;49;95;7;4;11
96;16.06.2017;2017;06;22;Perjantai;25;30;55;3;12;15
96;16.06.2017;2017;06;23;Perjantai;30;7;37;3;3;6
96;17.06.2017;2017;06;00;Lauantai;23;15;38;1;2;3
96;17.06.2017;2017;06;01;Lauantai;25;6;31;0;3;3
96;17.06.2017;2017;06;02;Lauantai;22;7;29;0;0;0
96;17.06.2017;2017;06;03;Lauantai;25;3;28;4;1;5
96;17.06.2017;2017;06;04;Lauantai;12;2;14;2;0;2
96;17.06.2017;2017;06;05;Lauantai;3;2;5;3;0;3
96;17.06.2017;2017;06;06;Lauantai;29;9;38;4;0;4
96;17.06.2017;2017;06;07;Lauantai;10;13;23;1;1;2
96;17.06.2017;2017;06;08;Lauantai;8;25;33;4;5;9
96;17.06.2017;2017;06;09;Lauantai;21;33;54;2;1;3
96;17.06.2017;2017;06;10;Lauantai;32;52;84;5;4;9
96;17.06.2017;2017;06;11;Lauantai;51;66;117;2;5;7
96;17.06.2017;2017;06;12;Lauantai;61;57;118;13;8;21
96;17.06.2017;2017;06;13;Lauantai;77;57;134;4;9;13
96;17.06.2017;2017;06;14;Lauantai;67;75;142;6;6;12
96;17.06.2017;2017;06;15;Lauantai;64;69;133;5;11;16
96;17.06.2017;2017;06;16;Lauantai;62;73;135;6;4;10
96;17.06.2017;2017;06;17;Lauantai;68;47;115;4;10;14
96;17.06.2017;2017;06;18;Lauantai;71;38;109;9;6;15
96;17.06.2017;2017;06;19;Lauantai;54;33;87;11;5;16
96;17.06.2017;2017;06;20;Lauantai;51;38;89;3;7;10
96;17.06.2017;2017;06;21;Lauantai;26;50;76;2;4;6
96;17.06.2017;2017;06;22;Lauantai;25;26;51;3;2;5
96;17.06.2017;2017;06;23;Lauantai;21;16;37;0;1;1
96;18.06.2017;2017;06;00;Sunnuntai;18;22;40;1;1;2
96;18.06.2017;2017;06;01;Sunnuntai;22;3;25;0;1;1
96;18.06.2017;2017;06;02;Sunnuntai;21;4;25;2;2;4
96;18.06.2017;2017;06;03;Sunnuntai;25;2;27;1;0;1
96;18.06.2017;2017;06;04;Sunnuntai;11;0;11;0;1;1
96;18.06.2017;2017;06;05;Sunnuntai;6;2;8;0;0;0
96;18.06.2017;2017;06;06;Sunnuntai;19;6;25;0;1;1
96;18.06.2017;2017;06;07;Sunnuntai;2;8;10;0;2;2
96;18.06.2017;2017;06;08;Sunnuntai;6;8;14;0;0;0
96;18.06.2017;2017;06;09;Sunnuntai;5;4;9;3;2;5
96;18.06.2017;2017;06;10;Sunnuntai;4;8;12;1;6;7
96;18.06.2017;2017;06;11;Sunnuntai;12;16;28;4;1;5
96;18.06.2017;2017;06;12;Sunnuntai;21;35;56;3;4;7
96;18.06.2017;2017;06;13;Sunnuntai;28;53;81;2;5;7
96;18.06.2017;2017;06;14;Sunnuntai;55;45;100;7;6;13
96;18.06.2017;2017;06;15;Sunnuntai;49;40;89;8;2;10
96;18.06.2017;2017;06;16;Sunnuntai;63;37;100;18;7;25
96;18.06.2017;2017;06;17;Sunnuntai;43;37;80;11;11;22
96;18.06.2017;2017;06;18;Sunnuntai;34;38;72;10;15;25
96;18.06.2017;2017;06;19;Sunnuntai;33;31;64;7;22;29
96;18.06.2017;2017;06;20;Sunnuntai;41;27;68;3;6;9
96;18.06.2017;2017;06;21;Sunnuntai;14;23;37;9;1;10
96;18.06.2017;2017;06;22;Sunnuntai;7;8;15;1;1;2
96;18.06.2017;2017;06;23;Sunnuntai;8;6;14;4;4;8
96;19.06.2017;2017;06;00;Maanantai;6;4;10;4;2;6
96;19.06.2017;2017;06;01;Maanantai;3;0;3;0;0;0
96;19.06.2017;2017;06;02;Maanantai;2;0;2;1;0;1
96;19.06.2017;2017;06;03;Maanantai;6;1;7;0;0;0
96;19.06.2017;2017;06;04;Maanantai;2;1;3;1;0;1
96;19.06.2017;2017;06;05;Maanantai;6;9;15;1;1;2
96;19.06.2017;2017;06;06;Maanantai;61;41;102;6;2;8
96;19.06.2017;2017;06;07;Maanantai;131;120;251;14;2;16
96;19.06.2017;2017;06;08;Maanantai;40;116;156;8;6;14
96;19.06.2017;2017;06;09;Maanantai;36;60;96;5;6;11
96;19.06.2017;2017;06;10;Maanantai;52;78;130;6;8;14
96;19.06.2017;2017;06;11;Maanantai;50;76;126;2;7;9
96;19.06.2017;2017;06;12;Maanantai;71;53;124;8;7;15
96;19.06.2017;2017;06;13;Maanantai;74;63;137;7;11;18
96;19.06.2017;2017;06;14;Maanantai;68;86;154;7;24;31
96;19.06.2017;2017;06;15;Maanantai;104;145;249;4;32;36
96;19.06.2017;2017;06;16;Maanantai;120;143;263;9;18;27
96;19.06.2017;2017;06;17;Maanantai;109;82;191;8;10;18
96;19.06.2017;2017;06;18;Maanantai;87;51;138;7;9;16
96;19.06.2017;2017;06;19;Maanantai;79;52;131;16;10;26
96;19.06.2017;2017;06;20;Maanantai;62;27;89;9;6;15
96;19.06.2017;2017;06;21;Maanantai;47;51;98;5;10;15
96;19.06.2017;2017;06;22;Maanantai;15;20;35;4;10;14
96;19.06.2017;2017;06;23;Maanantai;12;6;18;1;5;6
96;20.06.2017;2017;06;00;Tiistai;5;2;7;2;1;3
96;20.06.2017;2017;06;01;Tiistai;1;0;1;2;0;2
96;20.06.2017;2017;06;02;Tiistai;4;0;4;1;1;2
96;20.06.2017;2017;06;03;Tiistai;1;0;1;0;0;0
96;20.06.2017;2017;06;04;Tiistai;5;2;7;0;0;0
96;20.06.2017;2017;06;05;Tiistai;4;8;12;0;1;1
96;20.06.2017;2017;06;06;Tiistai;64;37;101;5;1;6
96;20.06.2017;2017;06;07;Tiistai;138;94;232;14;6;20
96;20.06.2017;2017;06;08;Tiistai;46;123;169;9;4;13
96;20.06.2017;2017;06;09;Tiistai;40;52;92;5;10;15
96;20.06.2017;2017;06;10;Tiistai;53;73;126;6;8;14
96;20.06.2017;2017;06;11;Tiistai;67;66;133;8;11;19
96;20.06.2017;2017;06;12;Tiistai;83;72;155;2;3;5
96;20.06.2017;2017;06;13;Tiistai;83;83;166;13;13;26
96;20.06.2017;2017;06;14;Tiistai;83;91;174;7;27;34
96;20.06.2017;2017;06;15;Tiistai;96;158;254;13;24;37
96;20.06.2017;2017;06;16;Tiistai;120;128;248;6;24;30
96;20.06.2017;2017;06;17;Tiistai;105;62;167;15;16;31
96;20.06.2017;2017;06;18;Tiistai;94;56;150;7;7;14
96;20.06.2017;2017;06;19;Tiistai;73;45;118;12;14;26
96;20.06.2017;2017;06;20;Tiistai;62;23;85;10;6;16
96;20.06.2017;2017;06;21;Tiistai;41;62;103;5;2;7
96;20.06.2017;2017;06;22;Tiistai;13;16;29;3;3;6
96;20.06.2017;2017;06;23;Tiistai;17;9;26;3;1;4
96;21.06.2017;2017;06;00;Keskiviikko;3;3;6;1;1;2
96;21.06.2017;2017;06;01;Keskiviikko;5;1;6;2;3;5
96;21.06.2017;2017;06;02;Keskiviikko;2;0;2;0;0;0
96;21.06.2017;2017;06;03;Keskiviikko;5;2;7;0;0;0
96;21.06.2017;2017;06;04;Keskiviikko;0;1;1;1;0;1
96;21.06.2017;2017;06;05;Keskiviikko;6;9;15;1;0;1
96;21.06.2017;2017;06;06;Keskiviikko;58;32;90;5;1;6
96;21.06.2017;2017;06;07;Keskiviikko;117;101;218;17;7;24
96;21.06.2017;2017;06;08;Keskiviikko;41;91;132;3;7;10
96;21.06.2017;2017;06;09;Keskiviikko;30;64;94;6;4;10
96;21.06.2017;2017;06;10;Keskiviikko;39;41;80;2;5;7
96;21.06.2017;2017;06;11;Keskiviikko;41;78;119;6;8;14
96;21.06.2017;2017;06;12;Keskiviikko;59;54;113;4;3;7
96;21.06.2017;2017;06;13;Keskiviikko;55;55;110;4;6;10
96;21.06.2017;2017;06;14;Keskiviikko;69;66;135;5;13;18
96;21.06.2017;2017;06;15;Keskiviikko;78;135;213;7;11;18
96;21.06.2017;2017;06;16;Keskiviikko;111;104;215;5;11;16
96;21.06.2017;2017;06;17;Keskiviikko;71;63;134;4;7;11
96;21.06.2017;2017;06;18;Keskiviikko;59;40;99;20;5;25
96;21.06.2017;2017;06;19;Keskiviikko;49;36;85;5;13;18
96;21.06.2017;2017;06;20;Keskiviikko;55;33;88;4;7;11
96;21.06.2017;2017;06;21;Keskiviikko;16;34;50;1;6;7
96;21.06.2017;2017;06;22;Keskiviikko;10;11;21;2;2;4
96;21.06.2017;2017;06;23;Keskiviikko;10;4;14;2;2;4
96;22.06.2017;2017;06;00;Torstai;8;3;11;0;0;0
96;22.06.2017;2017;06;01;Torstai;7;2;9;1;0;1
96;22.06.2017;2017;06;02;Torstai;3;0;3;0;1;1
96;22.06.2017;2017;06;03;Torstai;5;0;5;0;0;0
96;22.06.2017;2017;06;04;Torstai;0;0;0;0;1;1
96;22.06.2017;2017;06;05;Torstai;3;8;11;1;1;2
96;22.06.2017;2017;06;06;Torstai;51;20;71;6;0;6
96;22.06.2017;2017;06;07;Torstai;105;83;188;12;3;15
96;22.06.2017;2017;06;08;Torstai;24;66;90;5;3;8
96;22.06.2017;2017;06;09;Torstai;24;46;70;6;5;11
96;22.06.2017;2017;06;10;Torstai;23;42;65;5;4;9
96;22.06.2017;2017;06;11;Torstai;42;42;84;5;7;12
96;22.06.2017;2017;06;12;Torstai;63;61;124;6;5;11
96;22.06.2017;2017;06;13;Torstai;64;54;118;5;8;13
96;22.06.2017;2017;06;14;Torstai;55;72;127;7;10;17
96;22.06.2017;2017;06;15;Torstai;54;104;158;2;15;17
96;22.06.2017;2017;06;16;Torstai;60;60;120;5;0;5
96;22.06.2017;2017;06;17;Torstai;39;26;65;5;10;15
96;22.06.2017;2017;06;18;Torstai;53;33;86;6;9;15
96;22.06.2017;2017;06;19;Torstai;26;33;59;3;4;7
96;22.06.2017;2017;06;20;Torstai;82;28;110;10;10;20
96;22.06.2017;2017;06;21;Torstai;15;34;49;3;8;11
96;22.06.2017;2017;06;22;Torstai;9;14;23;2;4;6
96;22.06.2017;2017;06;23;Torstai;6;12;18;2;1;3
96;23.06.2017;2017;06;00;Perjantai;14;20;34;3;4;7
96;23.06.2017;2017;06;01;Perjantai;8;11;19;2;0;2
96;23.06.2017;2017;06;02;Perjantai;1;3;4;0;1;1
96;23.06.2017;2017;06;03;Perjantai;3;1;4;0;1;1
96;23.06.2017;2017;06;04;Perjantai;2;1;3;2;3;5
96;23.06.2017;2017;06;05;Perjantai;2;5;7;2;0;2
96;23.06.2017;2017;06;06;Perjantai;26;6;32;2;1;3
96;23.06.2017;2017;06;07;Perjantai;2;9;11;1;1;2
96;23.06.2017;2017;06;08;Perjantai;3;7;10;1;1;2
96;23.06.2017;2017;06;09;Perjantai;6;21;27;3;40;43
96;23.06.2017;2017;06;10;Perjantai;17;26;43;4;8;12
96;23.06.2017;2017;06;11;Perjantai;35;37;72;7;11;18
96;23.06.2017;2017;06;12;Perjantai;46;42;88;16;8;24
96;23.06.2017;2017;06;13;Perjantai;50;24;74;8;10;18
96;23.06.2017;2017;06;14;Perjantai;34;35;69;7;5;12
96;23.06.2017;2017;06;15;Perjantai;32;47;79;5;9;14
96;23.06.2017;2017;06;16;Perjantai;26;26;52;5;4;9
96;23.06.2017;2017;06;17;Perjantai;30;26;56;36;4;40
96;23.06.2017;2017;06;18;Perjantai;27;18;45;7;4;11
96;23.06.2017;2017;06;19;Perjantai;23;25;48;6;4;10
96;23.06.2017;2017;06;20;Perjantai;28;17;45;1;11;12
96;23.06.2017;2017;06;21;Perjantai;15;51;66;1;6;7
96;23.06.2017;2017;06;22;Perjantai;12;20;32;1;3;4
96;23.06.2017;2017;06;23;Perjantai;8;14;22;2;1;3
96;24.06.2017;2017;06;00;Lauantai;14;11;25;1;0;1
96;24.06.2017;2017;06;01;Lauantai;13;16;29;5;0;5
96;24.06.2017;2017;06;02;Lauantai;16;6;22;0;0;0
96;24.06.2017;2017;06;03;Lauantai;20;1;21;2;0;2
96;24.06.2017;2017;06;04;Lauantai;12;2;14;0;1;1
96;24.06.2017;2017;06;05;Lauantai;0;1;1;1;1;2
96;24.06.2017;2017;06;06;Lauantai;22;6;28;2;2;4
96;24.06.2017;2017;06;07;Lauantai;5;15;20;2;1;3
96;24.06.2017;2017;06;08;Lauantai;7;5;12;4;7;11
96;24.06.2017;2017;06;09;Lauantai;8;18;26;3;22;25
96;24.06.2017;2017;06;10;Lauantai;12;10;22;3;4;7
96;24.06.2017;2017;06;11;Lauantai;15;19;34;7;9;16
96;24.06.2017;2017;06;12;Lauantai;33;22;55;6;12;18
96;24.06.2017;2017;06;13;Lauantai;40;34;74;10;14;24
96;24.06.2017;2017;06;14;Lauantai;31;53;84;4;14;18
96;24.06.2017;2017;06;15;Lauantai;31;40;71;9;8;17
96;24.06.2017;2017;06;16;Lauantai;25;32;57;9;3;12
96;24.06.2017;2017;06;17;Lauantai;34;35;69;28;10;38
96;24.06.2017;2017;06;18;Lauantai;28;31;59;7;2;9
96;24.06.2017;2017;06;19;Lauantai;25;38;63;2;2;4
96;24.06.2017;2017;06;20;Lauantai;29;26;55;2;6;8
96;24.06.2017;2017;06;21;Lauantai;14;43;57;2;2;4
96;24.06.2017;2017;06;22;Lauantai;15;19;34;1;0;1
96;24.06.2017;2017;06;23;Lauantai;12;15;27;0;4;4
96;25.06.2017;2017;06;00;Sunnuntai;9;8;17;1;1;2
96;25.06.2017;2017;06;01;Sunnuntai;10;7;17;2;0;2
96;25.06.2017;2017;06;02;Sunnuntai;9;3;12;1;0;1
96;25.06.2017;2017;06;03;Sunnuntai;10;1;11;2;1;3
96;25.06.2017;2017;06;04;Sunnuntai;7;1;8;1;0;1
96;25.06.2017;2017;06;05;Sunnuntai;4;1;5;2;0;2
96;25.06.2017;2017;06;06;Sunnuntai;22;7;29;3;2;5
96;25.06.2017;2017;06;07;Sunnuntai;5;13;18;0;0;0
96;25.06.2017;2017;06;08;Sunnuntai;9;10;19;1;1;2
96;25.06.2017;2017;06;09;Sunnuntai;13;14;27;3;29;32
96;25.06.2017;2017;06;10;Sunnuntai;22;12;34;3;7;10
96;25.06.2017;2017;06;11;Sunnuntai;7;13;20;2;4;6
96;25.06.2017;2017;06;12;Sunnuntai;24;10;34;7;2;9
96;25.06.2017;2017;06;13;Sunnuntai;24;20;44;3;6;9
96;25.06.2017;2017;06;14;Sunnuntai;24;20;44;2;3;5
96;25.06.2017;2017;06;15;Sunnuntai;17;23;40;12;3;15
96;25.06.2017;2017;06;16;Sunnuntai;22;15;37;19;4;23
96;25.06.2017;2017;06;17;Sunnuntai;11;10;21;5;3;8
96;25.06.2017;2017;06;18;Sunnuntai;12;24;36;10;10;20
96;25.06.2017;2017;06;19;Sunnuntai;26;15;41;9;5;14
96;25.06.2017;2017;06;20;Sunnuntai;14;13;27;3;8;11
96;25.06.2017;2017;06;21;Sunnuntai;13;29;42;2;0;2
96;25.06.2017;2017;06;22;Sunnuntai;9;12;21;2;2;4
96;25.06.2017;2017;06;23;Sunnuntai;6;11;17;2;0;2
96;26.06.2017;2017;06;00;Maanantai;0;1;1;0;0;0
96;26.06.2017;2017;06;01;Maanantai;5;4;9;1;0;1
96;26.06.2017;2017;06;02;Maanantai;5;2;7;0;1;1
96;26.06.2017;2017;06;03;Maanantai;0;1;1;1;0;1
96;26.06.2017;2017;06;04;Maanantai;2;1;3;1;0;1
96;26.06.2017;2017;06;05;Maanantai;3;6;9;0;0;0
96;26.06.2017;2017;06;06;Maanantai;55;26;81;3;0;3
96;26.06.2017;2017;06;07;Maanantai;77;77;154;11;5;16
96;26.06.2017;2017;06;08;Maanantai;23;57;80;6;6;12
96;26.06.2017;2017;06;09;Maanantai;23;29;52;8;4;12
96;26.06.2017;2017;06;10;Maanantai;24;33;57;3;4;7
96;26.06.2017;2017;06;11;Maanantai;16;27;43;3;3;6
96;26.06.2017;2017;06;12;Maanantai;19;22;41;4;5;9
96;26.06.2017;2017;06;13;Maanantai;40;34;74;9;4;13
96;26.06.2017;2017;06;14;Maanantai;33;74;107;5;12;17
96;26.06.2017;2017;06;15;Maanantai;65;118;183;9;24;33
96;26.06.2017;2017;06;16;Maanantai;85;91;176;10;19;29
96;26.06.2017;2017;06;17;Maanantai;72;63;135;10;14;24
96;26.06.2017;2017;06;18;Maanantai;58;59;117;9;10;19
96;26.06.2017;2017;06;19;Maanantai;62;65;127;8;15;23
96;26.06.2017;2017;06;20;Maanantai;59;20;79;9;8;17
96;26.06.2017;2017;06;21;Maanantai;31;38;69;2;5;7
96;26.06.2017;2017;06;22;Maanantai;13;15;28;5;3;8
96;26.06.2017;2017;06;23;Maanantai;7;2;9;2;5;7
96;27.06.2017;2017;06;00;Tiistai;7;5;12;0;0;0
96;27.06.2017;2017;06;01;Tiistai;4;2;6;0;0;0
96;27.06.2017;2017;06;02;Tiistai;1;1;2;0;0;0
96;27.06.2017;2017;06;03;Tiistai;2;0;2;1;0;1
96;27.06.2017;2017;06;04;Tiistai;1;4;5;0;0;0
96;27.06.2017;2017;06;05;Tiistai;3;5;8;1;1;2
96;27.06.2017;2017;06;06;Tiistai;52;26;78;1;1;2
96;27.06.2017;2017;06;07;Tiistai;105;86;191;13;2;15
96;27.06.2017;2017;06;08;Tiistai;30;81;111;4;3;7
96;27.06.2017;2017;06;09;Tiistai;26;40;66;5;3;8
96;27.06.2017;2017;06;10;Tiistai;40;55;95;7;8;15
96;27.06.2017;2017;06;11;Tiistai;43;47;90;3;7;10
96;27.06.2017;2017;06;12;Tiistai;61;64;125;10;7;17
96;27.06.2017;2017;06;13;Tiistai;58;58;116;4;11;15
96;27.06.2017;2017;06;14;Tiistai;53;85;138;9;10;19
96;27.06.2017;2017;06;15;Tiistai;99;147;246;7;23;30
96;27.06.2017;2017;06;16;Tiistai;120;111;231;13;13;26
96;27.06.2017;2017;06;17;Tiistai;80;80;160;7;15;22
96;27.06.2017;2017;06;18;Tiistai;80;37;117;4;4;8
96;27.06.2017;2017;06;19;Tiistai;73;33;106;4;9;13
96;27.06.2017;2017;06;20;Tiistai;67;17;84;11;7;18
96;27.06.2017;2017;06;21;Tiistai;30;35;65;2;4;6
96;27.06.2017;2017;06;22;Tiistai;20;19;39;4;9;13
96;27.06.2017;2017;06;23;Tiistai;12;9;21;2;1;3
96;28.06.2017;2017;06;00;Keskiviikko;3;5;8;1;0;1
96;28.06.2017;2017;06;01;Keskiviikko;0;0;0;0;1;1
96;28.06.2017;2017;06;02;Keskiviikko;5;1;6;0;0;0
96;28.06.2017;2017;06;03;Keskiviikko;4;1;5;0;0;0
96;28.06.2017;2017;06;04;Keskiviikko;4;1;5;1;2;3
96;28.06.2017;2017;06;05;Keskiviikko;5;10;15;1;0;1
96;28.06.2017;2017;06;06;Keskiviikko;53;31;84;6;0;6
96;28.06.2017;2017;06;07;Keskiviikko;103;90;193;12;4;16
96;28.06.2017;2017;06;08;Keskiviikko;26;79;105;4;5;9
96;28.06.2017;2017;06;09;Keskiviikko;27;48;75;4;4;8
96;28.06.2017;2017;06;10;Keskiviikko;19;30;49;3;2;5
96;28.06.2017;2017;06;11;Keskiviikko;26;23;49;5;2;7
96;28.06.2017;2017;06;12;Keskiviikko;48;35;83;4;3;7
96;28.06.2017;2017;06;13;Keskiviikko;38;27;65;3;2;5
96;28.06.2017;2017;06;14;Keskiviikko;34;54;88;7;6;13
96;28.06.2017;2017;06;15;Keskiviikko;58;119;177;4;14;18
96;28.06.2017;2017;06;16;Keskiviikko;96;105;201;9;5;14
96;28.06.2017;2017;06;17;Keskiviikko;63;54;117;6;12;18
96;28.06.2017;2017;06;18;Keskiviikko;52;41;93;9;3;12
96;28.06.2017;2017;06;19;Keskiviikko;47;36;83;7;12;19
96;28.06.2017;2017;06;20;Keskiviikko;49;47;96;4;7;11
96;28.06.2017;2017;06;21;Keskiviikko;33;47;80;2;9;11
96;28.06.2017;2017;06;22;Keskiviikko;10;7;17;1;2;3
96;28.06.2017;2017;06;23;Keskiviikko;17;3;20;1;1;2
96;29.06.2017;2017;06;00;Torstai;4;3;7;2;0;2
96;29.06.2017;2017;06;01;Torstai;3;2;5;0;0;0
96;29.06.2017;2017;06;02;Torstai;2;3;5;2;0;2
96;29.06.2017;2017;06;03;Torstai;3;0;3;0;0;0
96;29.06.2017;2017;06;04;Torstai;3;2;5;1;0;1
96;29.06.2017;2017;06;05;Torstai;6;4;10;2;0;2
96;29.06.2017;2017;06;06;Torstai;55;23;78;5;1;6
96;29.06.2017;2017;06;07;Torstai;93;81;174;14;7;21
96;29.06.2017;2017;06;08;Torstai;37;92;129;10;8;18
96;29.06.2017;2017;06;09;Torstai;46;68;114;4;8;12
96;29.06.2017;2017;06;10;Torstai;52;61;113;3;12;15
96;29.06.2017;2017;06;11;Torstai;56;71;127;9;3;12
96;29.06.2017;2017;06;12;Torstai;58;68;126;10;10;20
96;29.06.2017;2017;06;13;Torstai;66;67;133;7;11;18
96;29.06.2017;2017;06;14;Torstai;63;74;137;6;11;17
96;29.06.2017;2017;06;15;Torstai;105;143;248;11;23;34
96;29.06.2017;2017;06;16;Torstai;110;132;242;7;18;25
96;29.06.2017;2017;06;17;Torstai;104;84;188;7;8;15
96;29.06.2017;2017;06;18;Torstai;74;53;127;6;6;12
96;29.06.2017;2017;06;19;Torstai;65;53;118;8;17;25
96;29.06.2017;2017;06;20;Torstai;85;28;113;8;10;18
96;29.06.2017;2017;06;21;Torstai;44;38;82;2;7;9
96;29.06.2017;2017;06;22;Torstai;22;24;46;1;3;4
96;29.06.2017;2017;06;23;Torstai;21;8;29;1;1;2
96;30.06.2017;2017;06;00;Perjantai;3;7;10;1;2;3
96;30.06.2017;2017;06;01;Perjantai;8;2;10;2;0;2
96;30.06.2017;2017;06;02;Perjantai;3;0;3;1;0;1
96;30.06.2017;2017;06;03;Perjantai;3;0;3;0;0;0
96;30.06.2017;2017;06;04;Perjantai;1;0;1;0;0;0
96;30.06.2017;2017;06;05;Perjantai;5;3;8;0;2;2
96;30.06.2017;2017;06;06;Perjantai;54;26;80;9;2;11
96;30.06.2017;2017;06;07;Perjantai;102;72;174;11;2;13
96;30.06.2017;2017;06;08;Perjantai;27;67;94;11;6;17
96;30.06.2017;2017;06;09;Perjantai;30;54;84;13;7;20
96;30.06.2017;2017;06;10;Perjantai;34;66;100;1;9;10
96;30.06.2017;2017;06;11;Perjantai;42;79;121;5;11;16
96;30.06.2017;2017;06;12;Perjantai;72;86;158;3;7;10
96;30.06.2017;2017;06;13;Perjantai;77;76;153;7;14;21
96;30.06.2017;2017;06;14;Perjantai;83;97;180;6;16;22
96;30.06.2017;2017;06;15;Perjantai;94;134;228;6;16;22
96;30.06.2017;2017;06;16;Perjantai;92;86;178;7;9;16
96;30.06.2017;2017;06;17;Perjantai;69;57;126;3;9;12
96;30.06.2017;2017;06;18;Perjantai;58;64;122;9;8;17
96;30.06.2017;2017;06;19;Perjantai;52;47;99;5;4;9
96;30.06.2017;2017;06;20;Perjantai;80;27;107;8;4;12
96;30.06.2017;2017;06;21;Perjantai;35;43;78;0;2;2
96;30.06.2017;2017;06;22;Perjantai;17;28;45;1;1;2
96;30.06.2017;2017;06;23;Perjantai;18;17;35;0;2;2
96;01.07.2017;2017;07;00;Lauantai;16;11;27;5;3;8
96;01.07.2017;2017;07;01;Lauantai;20;4;24;3;1;4
96;01.07.2017;2017;07;02;Lauantai;24;2;26;4;1;5
96;01.07.2017;2017;07;03;Lauantai;18;3;21;1;1;2
96;01.07.2017;2017;07;04;Lauantai;9;4;13;2;3;5
96;01.07.2017;2017;07;05;Lauantai;6;3;9;1;0;1
96;01.07.2017;2017;07;06;Lauantai;28;17;45;1;1;2
96;01.07.2017;2017;07;07;Lauantai;3;18;21;1;1;2
96;01.07.2017;2017;07;08;Lauantai;8;20;28;1;3;4
96;01.07.2017;2017;07;09;Lauantai;17;32;49;2;6;8
96;01.07.2017;2017;07;10;Lauantai;21;41;62;5;2;7
96;01.07.2017;2017;07;11;Lauantai;36;64;100;3;8;11
96;01.07.2017;2017;07;12;Lauantai;48;61;109;5;11;16
96;01.07.2017;2017;07;13;Lauantai;54;71;125;5;6;11
96;01.07.2017;2017;07;14;Lauantai;52;74;126;9;11;20
96;01.07.2017;2017;07;15;Lauantai;66;68;134;5;2;7
96;01.07.2017;2017;07;16;Lauantai;40;39;79;1;8;9
96;01.07.2017;2017;07;17;Lauantai;62;54;116;4;11;15
96;01.07.2017;2017;07;18;Lauantai;47;37;84;9;4;13
96;01.07.2017;2017;07;19;Lauantai;38;30;68;5;2;7
96;01.07.2017;2017;07;20;Lauantai;49;29;78;3;2;5
96;01.07.2017;2017;07;21;Lauantai;32;37;69;3;6;9
96;01.07.2017;2017;07;22;Lauantai;20;22;42;2;1;3
96;01.07.2017;2017;07;23;Lauantai;24;22;46;2;2;4
96;02.07.2017;2017;07;00;Sunnuntai;21;18;39;3;1;4
96;02.07.2017;2017;07;01;Sunnuntai;18;10;28;1;0;1
96;02.07.2017;2017;07;02;Sunnuntai;27;5;32;1;0;1
96;02.07.2017;2017;07;03;Sunnuntai;27;5;32;1;1;2
96;02.07.2017;2017;07;04;Sunnuntai;29;6;35;0;0;0
96;02.07.2017;2017;07;05;Sunnuntai;7;1;8;2;1;3
96;02.07.2017;2017;07;06;Sunnuntai;27;11;38;1;0;1
96;02.07.2017;2017;07;07;Sunnuntai;10;13;23;1;3;4
96;02.07.2017;2017;07;08;Sunnuntai;9;12;21;2;2;4
96;02.07.2017;2017;07;09;Sunnuntai;22;11;33;5;2;7
96;02.07.2017;2017;07;10;Sunnuntai;23;30;53;4;6;10
96;02.07.2017;2017;07;11;Sunnuntai;28;44;72;4;2;6
96;02.07.2017;2017;07;12;Sunnuntai;72;55;127;2;6;8
96;02.07.2017;2017;07;13;Sunnuntai;72;49;121;8;11;19
96;02.07.2017;2017;07;14;Sunnuntai;78;47;125;6;5;11
96;02.07.2017;2017;07;15;Sunnuntai;49;52;101;11;14;25
96;02.07.2017;2017;07;16;Sunnuntai;48;52;100;11;2;13
96;02.07.2017;2017;07;17;Sunnuntai;56;56;112;4;1;5
96;02.07.2017;2017;07;18;Sunnuntai;69;50;119;8;5;13
96;02.07.2017;2017;07;19;Sunnuntai;45;37;82;2;2;4
96;02.07.2017;2017;07;20;Sunnuntai;59;30;89;11;4;15
96;02.07.2017;2017;07;21;Sunnuntai;53;20;73;4;6;10
96;02.07.2017;2017;07;22;Sunnuntai;20;9;29;1;1;2
96;02.07.2017;2017;07;23;Sunnuntai;6;16;22;1;3;4
96;03.07.2017;2017;07;00;Maanantai;6;5;11;4;2;6
96;03.07.2017;2017;07;01;Maanantai;10;2;12;0;0;0
96;03.07.2017;2017;07;02;Maanantai;4;0;4;2;1;3
96;03.07.2017;2017;07;03;Maanantai;2;3;5;1;0;1
96;03.07.2017;2017;07;04;Maanantai;2;4;6;1;0;1
96;03.07.2017;2017;07;05;Maanantai;3;5;8;3;0;3
96;03.07.2017;2017;07;06;Maanantai;62;26;88;3;1;4
96;03.07.2017;2017;07;07;Maanantai;101;95;196;9;4;13
96;03.07.2017;2017;07;08;Maanantai;36;80;116;11;5;16
96;03.07.2017;2017;07;09;Maanantai;34;70;104;4;6;10
96;03.07.2017;2017;07;10;Maanantai;45;55;100;3;8;11
96;03.07.2017;2017;07;11;Maanantai;57;59;116;5;8;13
96;03.07.2017;2017;07;12;Maanantai;72;80;152;6;11;17
96;03.07.2017;2017;07;13;Maanantai;74;69;143;8;3;11
96;03.07.2017;2017;07;14;Maanantai;98;102;200;5;9;14
96;03.07.2017;2017;07;15;Maanantai;112;151;263;7;19;26
96;03.07.2017;2017;07;16;Maanantai;133;92;225;7;7;14
96;03.07.2017;2017;07;17;Maanantai;82;72;154;5;15;20
96;03.07.2017;2017;07;18;Maanantai;95;60;155;24;9;33
96;03.07.2017;2017;07;19;Maanantai;75;61;136;5;9;14
96;03.07.2017;2017;07;20;Maanantai;68;32;100;11;9;20
96;03.07.2017;2017;07;21;Maanantai;34;39;73;5;3;8
96;03.07.2017;2017;07;22;Maanantai;16;18;34;4;4;8
96;03.07.2017;2017;07;23;Maanantai;11;7;18;1;3;4
96;04.07.2017;2017;07;00;Tiistai;4;4;8;3;1;4
96;04.07.2017;2017;07;01;Tiistai;1;2;3;0;1;1
96;04.07.2017;2017;07;02;Tiistai;4;3;7;0;0;0
96;04.07.2017;2017;07;03;Tiistai;6;0;6;0;0;0
96;04.07.2017;2017;07;04;Tiistai;4;0;4;1;0;1
96;04.07.2017;2017;07;05;Tiistai;1;8;9;0;3;3
96;04.07.2017;2017;07;06;Tiistai;64;25;89;3;0;3
96;04.07.2017;2017;07;07;Tiistai;89;81;170;7;3;10
96;04.07.2017;2017;07;08;Tiistai;24;58;82;8;6;14
96;04.07.2017;2017;07;09;Tiistai;32;67;99;7;14;21
96;04.07.2017;2017;07;10;Tiistai;41;54;95;3;8;11
96;04.07.2017;2017;07;11;Tiistai;53;55;108;7;4;11
96;04.07.2017;2017;07;12;Tiistai;47;23;70;8;3;11
96;04.07.2017;2017;07;13;Tiistai;47;33;80;5;4;9
96;04.07.2017;2017;07;14;Tiistai;51;65;116;5;12;17
96;04.07.2017;2017;07;15;Tiistai;79;149;228;4;23;27
96;04.07.2017;2017;07;16;Tiistai;85;98;183;7;16;23
96;04.07.2017;2017;07;17;Tiistai;73;48;121;5;8;13
96;04.07.2017;2017;07;18;Tiistai;68;39;107;17;13;30
96;04.07.2017;2017;07;19;Tiistai;63;46;109;17;10;27
96;04.07.2017;2017;07;20;Tiistai;65;33;98;11;8;19
96;04.07.2017;2017;07;21;Tiistai;21;33;54;3;4;7
96;04.07.2017;2017;07;22;Tiistai;14;12;26;3;1;4
96;04.07.2017;2017;07;23;Tiistai;8;16;24;2;2;4
96;05.07.2017;2017;07;00;Keskiviikko;9;4;13;3;0;3
96;05.07.2017;2017;07;01;Keskiviikko;5;4;9;1;0;1
96;05.07.2017;2017;07;02;Keskiviikko;5;4;9;0;0;0
96;05.07.2017;2017;07;03;Keskiviikko;4;1;5;1;0;1
96;05.07.2017;2017;07;04;Keskiviikko;4;1;5;0;0;0
96;05.07.2017;2017;07;05;Keskiviikko;3;6;9;0;4;4
96;05.07.2017;2017;07;06;Keskiviikko;46;24;70;4;0;4
96;05.07.2017;2017;07;07;Keskiviikko;97;71;168;10;6;16
96;05.07.2017;2017;07;08;Keskiviikko;23;55;78;2;3;5
96;05.07.2017;2017;07;09;Keskiviikko;25;36;61;4;4;8
96;05.07.2017;2017;07;10;Keskiviikko;19;41;60;6;6;12
96;05.07.2017;2017;07;11;Keskiviikko;40;57;97;3;4;7
96;05.07.2017;2017;07;12;Keskiviikko;35;47;82;10;3;13
96;05.07.2017;2017;07;13;Keskiviikko;42;80;122;9;9;18
96;05.07.2017;2017;07;14;Keskiviikko;60;74;134;3;12;15
96;05.07.2017;2017;07;15;Keskiviikko;75;131;206;5;11;16
96;05.07.2017;2017;07;16;Keskiviikko;89;90;179;6;5;11
96;05.07.2017;2017;07;17;Keskiviikko;71;51;122;6;16;22
96;05.07.2017;2017;07;18;Keskiviikko;62;29;91;8;7;15
96;05.07.2017;2017;07;19;Keskiviikko;43;23;66;5;2;7
96;05.07.2017;2017;07;20;Keskiviikko;63;30;93;4;2;6
96;05.07.2017;2017;07;21;Keskiviikko;32;37;69;2;3;5
96;05.07.2017;2017;07;22;Keskiviikko;10;8;18;2;1;3
96;05.07.2017;2017;07;23;Keskiviikko;8;6;14;0;0;0
96;06.07.2017;2017;07;00;Torstai;5;3;8;2;1;3
96;06.07.2017;2017;07;01;Torstai;0;3;3;0;0;0
96;06.07.2017;2017;07;02;Torstai;7;1;8;0;0;0
96;06.07.2017;2017;07;03;Torstai;3;5;8;0;0;0
96;06.07.2017;2017;07;04;Torstai;6;2;8;0;0;0
96;06.07.2017;2017;07;05;Torstai;2;2;4;10;0;10
96;06.07.2017;2017;07;06;Torstai;45;22;67;1;0;1
96;06.07.2017;2017;07;07;Torstai;83;62;145;4;2;6
96;06.07.2017;2017;07;08;Torstai;21;31;52;1;0;1
96;06.07.2017;2017;07;09;Torstai;14;34;48;0;3;3
96;06.07.2017;2017;07;10;Torstai;15;24;39;5;2;7
96;06.07.2017;2017;07;11;Torstai;28;13;41;6;5;11
96;06.07.2017;2017;07;12;Torstai;31;33;64;10;7;17
96;06.07.2017;2017;07;13;Torstai;36;39;75;8;4;12
96;06.07.2017;2017;07;14;Torstai;37;64;101;6;7;13
96;06.07.2017;2017;07;15;Torstai;52;98;150;5;8;13
96;06.07.2017;2017;07;16;Torstai;52;62;114;3;2;5
96;06.07.2017;2017;07;17;Torstai;47;41;88;1;3;4
96;06.07.2017;2017;07;18;Torstai;41;37;78;7;5;12
96;06.07.2017;2017;07;19;Torstai;33;30;63;9;6;15
96;06.07.2017;2017;07;20;Torstai;35;18;53;4;2;6
96;06.07.2017;2017;07;21;Torstai;23;29;52;3;8;11
96;06.07.2017;2017;07;22;Torstai;19;10;29;0;4;4
96;06.07.2017;2017;07;23;Torstai;13;6;19;1;2;3
96;07.07.2017;2017;07;00;Perjantai;6;2;8;1;1;2
96;07.07.2017;2017;07;01;Perjantai;5;4;9;1;0;1
96;07.07.2017;2017;07;02;Perjantai;1;1;2;0;0;0
96;07.07.2017;2017;07;03;Perjantai;1;1;2;0;1;1
96;07.07.2017;2017;07;04;Perjantai;3;2;5;0;2;2
96;07.07.2017;2017;07;05;Perjantai;7;5;12;0;0;0
96;07.07.2017;2017;07;06;Perjantai;48;20;68;6;1;7
96;07.07.2017;2017;07;07;Perjantai;85;62;147;9;7;16
96;07.07.2017;2017;07;08;Perjantai;29;54;83;5;5;10
96;07.07.2017;2017;07;09;Perjantai;22;46;68;3;10;13
96;07.07.2017;2017;07;10;Perjantai;32;63;95;4;9;13
96;07.07.2017;2017;07;11;Perjantai;43;56;99;5;13;18
96;07.07.2017;2017;07;12;Perjantai;53;65;118;6;13;19
96;07.07.2017;2017;07;13;Perjantai;69;65;134;11;13;24
96;07.07.2017;2017;07;14;Perjantai;66;122;188;4;19;23
96;07.07.2017;2017;07;15;Perjantai;101;118;219;11;14;25
96;07.07.2017;2017;07;16;Perjantai;98;66;164;4;3;7
96;07.07.2017;2017;07;17;Perjantai;69;67;136;2;7;9
96;07.07.2017;2017;07;18;Perjantai;65;51;116;4;9;13
96;07.07.2017;2017;07;19;Perjantai;54;33;87;6;9;15
96;07.07.2017;2017;07;20;Perjantai;53;42;95;6;6;12
96;07.07.2017;2017;07;21;Perjantai;40;36;76;4;4;8
96;07.07.2017;2017;07;22;Perjantai;31;14;45;4;2;6
96;07.07.2017;2017;07;23;Perjantai;20;8;28;4;2;6
96;08.07.2017;2017;07;00;Lauantai;19;5;24;2;0;2
96;08.07.2017;2017;07;01;Lauantai;18;6;24;2;0;2
96;08.07.2017;2017;07;02;Lauantai;10;0;10;3;0;3
96;08.07.2017;2017;07;03;Lauantai;17;7;24;3;0;3
96;08.07.2017;2017;07;04;Lauantai;11;4;15;3;0;3
96;08.07.2017;2017;07;05;Lauantai;2;5;7;3;1;4
96;08.07.2017;2017;07;06;Lauantai;24;15;39;1;1;2
96;08.07.2017;2017;07;07;Lauantai;8;16;24;4;1;5
96;08.07.2017;2017;07;08;Lauantai;5;19;24;2;2;4
96;08.07.2017;2017;07;09;Lauantai;12;38;50;1;7;8
96;08.07.2017;2017;07;10;Lauantai;22;46;68;4;8;12
96;08.07.2017;2017;07;11;Lauantai;51;59;110;5;9;14
96;08.07.2017;2017;07;12;Lauantai;60;92;152;5;8;13
96;08.07.2017;2017;07;13;Lauantai;69;85;154;11;13;24
96;08.07.2017;2017;07;14;Lauantai;70;72;142;3;7;10
96;08.07.2017;2017;07;15;Lauantai;67;59;126;11;6;17
96;08.07.2017;2017;07;16;Lauantai;76;73;149;5;7;12
96;08.07.2017;2017;07;17;Lauantai;46;55;101;6;6;12
96;08.07.2017;2017;07;18;Lauantai;44;50;94;4;2;6
96;08.07.2017;2017;07;19;Lauantai;44;28;72;1;2;3
96;08.07.2017;2017;07;20;Lauantai;29;29;58;3;1;4
96;08.07.2017;2017;07;21;Lauantai;26;34;60;3;2;5
96;08.07.2017;2017;07;22;Lauantai;22;20;42;1;7;8
96;08.07.2017;2017;07;23;Lauantai;14;15;29;7;15;22
96;09.07.2017;2017;07;00;Sunnuntai;29;7;36;1;0;1
96;09.07.2017;2017;07;01;Sunnuntai;18;10;28;1;2;3
96;09.07.2017;2017;07;02;Sunnuntai;19;4;23;1;1;2
96;09.07.2017;2017;07;03;Sunnuntai;27;6;33;1;1;2
96;09.07.2017;2017;07;04;Sunnuntai;34;3;37;2;0;2
96;09.07.2017;2017;07;05;Sunnuntai;9;2;11;0;0;0
96;09.07.2017;2017;07;06;Sunnuntai;24;7;31;1;2;3
96;09.07.2017;2017;07;07;Sunnuntai;5;10;15;2;0;2
96;09.07.2017;2017;07;08;Sunnuntai;5;11;16;0;3;3
96;09.07.2017;2017;07;09;Sunnuntai;18;21;39;3;2;5
96;09.07.2017;2017;07;10;Sunnuntai;9;25;34;3;6;9
96;09.07.2017;2017;07;11;Sunnuntai;28;47;75;3;9;12
96;09.07.2017;2017;07;12;Sunnuntai;42;73;115;8;10;18
96;09.07.2017;2017;07;13;Sunnuntai;58;48;106;10;10;20
96;09.07.2017;2017;07;14;Sunnuntai;61;63;124;5;6;11
96;09.07.2017;2017;07;15;Sunnuntai;61;70;131;1;9;10
96;09.07.2017;2017;07;16;Sunnuntai;75;51;126;11;8;19
96;09.07.2017;2017;07;17;Sunnuntai;57;49;106;9;3;12
96;09.07.2017;2017;07;18;Sunnuntai;42;38;80;8;9;17
96;09.07.2017;2017;07;19;Sunnuntai;86;42;128;8;11;19
96;09.07.2017;2017;07;20;Sunnuntai;32;32;64;5;9;14
96;09.07.2017;2017;07;21;Sunnuntai;28;37;65;5;6;11
96;09.07.2017;2017;07;22;Sunnuntai;9;7;16;3;2;5
96;09.07.2017;2017;07;23;Sunnuntai;16;11;27;1;1;2
96;10.07.2017;2017;07;00;Maanantai;14;7;21;1;1;2
96;10.07.2017;2017;07;01;Maanantai;6;0;6;0;1;1
96;10.07.2017;2017;07;02;Maanantai;1;1;2;0;0;0
96;10.07.2017;2017;07;03;Maanantai;4;0;4;0;0;0
96;10.07.2017;2017;07;04;Maanantai;5;1;6;1;0;1
96;10.07.2017;2017;07;05;Maanantai;6;6;12;0;0;0
96;10.07.2017;2017;07;06;Maanantai;69;30;99;4;0;4
96;10.07.2017;2017;07;07;Maanantai;87;75;162;8;2;10
96;10.07.2017;2017;07;08;Maanantai;38;60;98;3;6;9
96;10.07.2017;2017;07;09;Maanantai;30;41;71;4;3;7
96;10.07.2017;2017;07;10;Maanantai;25;57;82;8;8;16
96;10.07.2017;2017;07;11;Maanantai;50;69;119;7;7;14
96;10.07.2017;2017;07;12;Maanantai;62;83;145;5;8;13
96;10.07.2017;2017;07;13;Maanantai;64;69;133;5;6;11
96;10.07.2017;2017;07;14;Maanantai;62;92;154;13;15;28
96;10.07.2017;2017;07;15;Maanantai;82;152;234;9;14;23
96;10.07.2017;2017;07;16;Maanantai;113;107;220;6;6;12
96;10.07.2017;2017;07;17;Maanantai;103;64;167;8;4;12
96;10.07.2017;2017;07;18;Maanantai;54;42;96;3;5;8
96;10.07.2017;2017;07;19;Maanantai;33;34;67;7;7;14
96;10.07.2017;2017;07;20;Maanantai;45;21;66;7;5;12
96;10.07.2017;2017;07;21;Maanantai;35;30;65;6;4;10
96;10.07.2017;2017;07;22;Maanantai;11;13;24;0;3;3
96;10.07.2017;2017;07;23;Maanantai;7;1;8;3;0;3
96;11.07.2017;2017;07;00;Tiistai;8;4;12;0;1;1
96;11.07.2017;2017;07;01;Tiistai;2;2;4;1;0;1
96;11.07.2017;2017;07;02;Tiistai;4;2;6;0;1;1
96;11.07.2017;2017;07;03;Tiistai;3;0;3;1;0;1
96;11.07.2017;2017;07;04;Tiistai;2;1;3;2;0;2
96;11.07.2017;2017;07;05;Tiistai;5;3;8;1;1;2
96;11.07.2017;2017;07;06;Tiistai;64;31;95;6;2;8
96;11.07.2017;2017;07;07;Tiistai;79;74;153;6;3;9
96;11.07.2017;2017;07;08;Tiistai;41;52;93;1;2;3
96;11.07.2017;2017;07;09;Tiistai;24;63;87;6;5;11
96;11.07.2017;2017;07;10;Tiistai;33;73;106;6;15;21
96;11.07.2017;2017;07;11;Tiistai;59;72;131;5;9;14
96;11.07.2017;2017;07;12;Tiistai;76;69;145;9;9;18
96;11.07.2017;2017;07;13;Tiistai;80;71;151;5;14;19
96;11.07.2017;2017;07;14;Tiistai;70;76;146;7;9;16
96;11.07.2017;2017;07;15;Tiistai;103;136;239;11;14;25
96;11.07.2017;2017;07;16;Tiistai;94;106;200;9;11;20
96;11.07.2017;2017;07;17;Tiistai;93;86;179;16;14;30
96;11.07.2017;2017;07;18;Tiistai;65;49;114;5;6;11
96;11.07.2017;2017;07;19;Tiistai;51;37;88;9;9;18
96;11.07.2017;2017;07;20;Tiistai;88;39;127;11;9;20
96;11.07.2017;2017;07;21;Tiistai;28;42;70;5;8;13
96;11.07.2017;2017;07;22;Tiistai;16;10;26;3;5;8
96;11.07.2017;2017;07;23;Tiistai;9;6;15;0;3;3
96;12.07.2017;2017;07;00;Keskiviikko;6;0;6;1;0;1
96;12.07.2017;2017;07;01;Keskiviikko;1;0;1;0;0;0
96;12.07.2017;2017;07;02;Keskiviikko;5;3;8;0;0;0
96;12.07.2017;2017;07;03;Keskiviikko;3;1;4;0;2;2
96;12.07.2017;2017;07;04;Keskiviikko;2;1;3;1;0;1
96;12.07.2017;2017;07;05;Keskiviikko;4;0;4;1;0;1
96;12.07.2017;2017;07;06;Keskiviikko;52;25;77;3;2;5
96;12.07.2017;2017;07;07;Keskiviikko;74;45;119;7;3;10
96;12.07.2017;2017;07;08;Keskiviikko;20;22;42;2;1;3
96;12.07.2017;2017;07;09;Keskiviikko;21;24;45;0;5;5
96;12.07.2017;2017;07;10;Keskiviikko;15;33;48;6;4;10
96;12.07.2017;2017;07;11;Keskiviikko;23;30;53;3;12;15
96;12.07.2017;2017;07;12;Keskiviikko;40;35;75;3;3;6
96;12.07.2017;2017;07;13;Keskiviikko;36;43;79;5;5;10
96;12.07.2017;2017;07;14;Keskiviikko;40;49;89;2;5;7
96;12.07.2017;2017;07;15;Keskiviikko;32;89;121;2;7;9
96;12.07.2017;2017;07;16;Keskiviikko;43;53;96;2;7;9
96;12.07.2017;2017;07;17;Keskiviikko;33;30;63;8;2;10
96;12.07.2017;2017;07;18;Keskiviikko;34;16;50;9;5;14
96;12.07.2017;2017;07;19;Keskiviikko;13;19;32;4;6;10
96;12.07.2017;2017;07;20;Keskiviikko;19;12;31;0;3;3
96;12.07.2017;2017;07;21;Keskiviikko;13;22;35;3;4;7
96;12.07.2017;2017;07;22;Keskiviikko;10;6;16;1;2;3
96;12.07.2017;2017;07;23;Keskiviikko;6;5;11;1;1;2
96;13.07.2017;2017;07;00;Torstai;3;1;4;2;0;2
96;13.07.2017;2017;07;01;Torstai;2;0;2;3;1;4
96;13.07.2017;2017;07;02;Torstai;3;0;3;1;0;1
96;13.07.2017;2017;07;03;Torstai;2;1;3;0;0;0
96;13.07.2017;2017;07;04;Torstai;2;3;5;2;1;3
96;13.07.2017;2017;07;05;Torstai;3;2;5;1;1;2
96;13.07.2017;2017;07;06;Torstai;40;32;72;6;1;7
96;13.07.2017;2017;07;07;Torstai;58;58;116;6;5;11
96;13.07.2017;2017;07;08;Torstai;25;37;62;3;4;7
96;13.07.2017;2017;07;09;Torstai;19;46;65;3;6;9
96;13.07.2017;2017;07;10;Torstai;26;35;61;2;6;8
96;13.07.2017;2017;07;11;Torstai;37;58;95;5;3;8
96;13.07.2017;2017;07;12;Torstai;58;45;103;8;4;12
96;13.07.2017;2017;07;13;Torstai;59;62;121;7;6;13
96;13.07.2017;2017;07;14;Torstai;68;84;152;9;11;20
96;13.07.2017;2017;07;15;Torstai;71;121;192;10;13;23
96;13.07.2017;2017;07;16;Torstai;66;82;148;8;5;13
96;13.07.2017;2017;07;17;Torstai;59;36;95;6;7;13
96;13.07.2017;2017;07;18;Torstai;35;35;70;9;5;14
96;13.07.2017;2017;07;19;Torstai;33;32;65;3;5;8
96;13.07.2017;2017;07;20;Torstai;40;29;69;7;4;11
96;13.07.2017;2017;07;21;Torstai;28;48;76;7;4;11
96;13.07.2017;2017;07;22;Torstai;14;13;27;2;4;6
96;13.07.2017;2017;07;23;Torstai;10;10;20;1;1;2
96;14.07.2017;2017;07;00;Perjantai;16;2;18;2;1;3
96;14.07.2017;2017;07;01;Perjantai;2;1;3;0;0;0
96;14.07.2017;2017;07;02;Perjantai;6;2;8;1;2;3
96;14.07.2017;2017;07;03;Perjantai;9;0;9;0;0;0
96;14.07.2017;2017;07;04;Perjantai;4;6;10;1;0;1
96;14.07.2017;2017;07;05;Perjantai;3;2;5;1;1;2
96;14.07.2017;2017;07;06;Perjantai;47;25;72;5;0;5
96;14.07.2017;2017;07;07;Perjantai;56;42;98;2;2;4
96;14.07.2017;2017;07;08;Perjantai;23;24;47;2;3;5
96;14.07.2017;2017;07;09;Perjantai;11;11;22;1;2;3
96;14.07.2017;2017;07;10;Perjantai;10;11;21;0;1;1
96;14.07.2017;2017;07;11;Perjantai;13;12;25;2;5;7
96;14.07.2017;2017;07;12;Perjantai;16;22;38;6;2;8
96;14.07.2017;2017;07;13;Perjantai;30;31;61;3;11;14
96;14.07.2017;2017;07;14;Perjantai;33;71;104;7;6;13
96;14.07.2017;2017;07;15;Perjantai;51;85;136;3;14;17
96;14.07.2017;2017;07;16;Perjantai;48;40;88;5;11;16
96;14.07.2017;2017;07;17;Perjantai;34;39;73;2;6;8
96;14.07.2017;2017;07;18;Perjantai;35;50;85;4;5;9
96;14.07.2017;2017;07;19;Perjantai;32;36;68;4;3;7
96;14.07.2017;2017;07;20;Perjantai;41;35;76;6;5;11
96;14.07.2017;2017;07;21;Perjantai;32;33;65;6;4;10
96;14.07.2017;2017;07;22;Perjantai;18;23;41;3;4;7
96;14.07.2017;2017;07;23;Perjantai;14;9;23;3;1;4
96;15.07.2017;2017;07;00;Lauantai;12;16;28;0;3;3
96;15.07.2017;2017;07;01;Lauantai;14;5;19;1;0;1
96;15.07.2017;2017;07;02;Lauantai;14;0;14;1;0;1
96;15.07.2017;2017;07;03;Lauantai;10;1;11;1;0;1
96;15.07.2017;2017;07;04;Lauantai;12;2;14;2;1;3
96;15.07.2017;2017;07;05;Lauantai;4;3;7;0;1;1
96;15.07.2017;2017;07;06;Lauantai;21;5;26;4;0;4
96;15.07.2017;2017;07;07;Lauantai;10;15;25;2;2;4
96;15.07.2017;2017;07;08;Lauantai;4;17;21;1;1;2
96;15.07.2017;2017;07;09;Lauantai;12;27;39;3;2;5
96;15.07.2017;2017;07;10;Lauantai;27;36;63;2;3;5
96;15.07.2017;2017;07;11;Lauantai;26;55;81;5;6;11
96;15.07.2017;2017;07;12;Lauantai;50;61;111;7;4;11
96;15.07.2017;2017;07;13;Lauantai;55;71;126;6;11;17
96;15.07.2017;2017;07;14;Lauantai;62;67;129;8;16;24
96;15.07.2017;2017;07;15;Lauantai;72;64;136;4;7;11
96;15.07.2017;2017;07;16;Lauantai;60;69;129;8;4;12
96;15.07.2017;2017;07;17;Lauantai;50;67;117;9;5;14
96;15.07.2017;2017;07;18;Lauantai;45;59;104;5;3;8
96;15.07.2017;2017;07;19;Lauantai;80;55;135;7;7;14
96;15.07.2017;2017;07;20;Lauantai;37;33;70;2;5;7
96;15.07.2017;2017;07;21;Lauantai;26;43;69;6;1;7
96;15.07.2017;2017;07;22;Lauantai;15;18;33;4;4;8
96;15.07.2017;2017;07;23;Lauantai;18;18;36;0;1;1
96;16.07.2017;2017;07;00;Sunnuntai;27;5;32;5;0;5
96;16.07.2017;2017;07;01;Sunnuntai;29;2;31;2;1;3
96;16.07.2017;2017;07;02;Sunnuntai;21;2;23;3;0;3
96;16.07.2017;2017;07;03;Sunnuntai;32;1;33;2;1;3
96;16.07.2017;2017;07;04;Sunnuntai;29;2;31;6;0;6
96;16.07.2017;2017;07;05;Sunnuntai;4;2;6;2;1;3
96;16.07.2017;2017;07;06;Sunnuntai;16;6;22;5;1;6
96;16.07.2017;2017;07;07;Sunnuntai;5;11;16;1;1;2
96;16.07.2017;2017;07;08;Sunnuntai;9;5;14;1;1;2
96;16.07.2017;2017;07;09;Sunnuntai;10;19;29;3;5;8
96;16.07.2017;2017;07;10;Sunnuntai;21;19;40;7;9;16
96;16.07.2017;2017;07;11;Sunnuntai;42;43;85;5;5;10
96;16.07.2017;2017;07;12;Sunnuntai;56;57;113;13;5;18
96;16.07.2017;2017;07;13;Sunnuntai;39;75;114;6;7;13
96;16.07.2017;2017;07;14;Sunnuntai;56;47;103;10;13;23
96;16.07.2017;2017;07;15;Sunnuntai;58;58;116;6;10;16
96;16.07.2017;2017;07;16;Sunnuntai;68;44;112;12;6;18
96;16.07.2017;2017;07;17;Sunnuntai;65;48;113;9;8;17
96;16.07.2017;2017;07;18;Sunnuntai;44;43;87;16;9;25
96;16.07.2017;2017;07;19;Sunnuntai;54;44;98;4;12;16
96;16.07.2017;2017;07;20;Sunnuntai;54;29;83;3;2;5
96;16.07.2017;2017;07;21;Sunnuntai;44;33;77;8;7;15
96;16.07.2017;2017;07;22;Sunnuntai;18;15;33;2;3;5
96;16.07.2017;2017;07;23;Sunnuntai;17;8;25;2;4;6
96;17.07.2017;2017;07;00;Maanantai;9;7;16;3;0;3
96;17.07.2017;2017;07;01;Maanantai;4;2;6;1;1;2
96;17.07.2017;2017;07;02;Maanantai;6;3;9;0;0;0
96;17.07.2017;2017;07;03;Maanantai;5;0;5;2;0;2
96;17.07.2017;2017;07;04;Maanantai;1;1;2;0;0;0
96;17.07.2017;2017;07;05;Maanantai;4;5;9;0;2;2
96;17.07.2017;2017;07;06;Maanantai;56;28;84;8;0;8
96;17.07.2017;2017;07;07;Maanantai;79;66;145;7;6;13
96;17.07.2017;2017;07;08;Maanantai;32;72;104;8;4;12
96;17.07.2017;2017;07;09;Maanantai;30;48;78;2;3;5
96;17.07.2017;2017;07;10;Maanantai;36;51;87;5;6;11
96;17.07.2017;2017;07;11;Maanantai;49;57;106;8;9;17
96;17.07.2017;2017;07;12;Maanantai;59;84;143;7;6;13
96;17.07.2017;2017;07;13;Maanantai;73;81;154;2;6;8
96;17.07.2017;2017;07;14;Maanantai;77;74;151;2;6;8
96;17.07.2017;2017;07;15;Maanantai;69;145;214;5;12;17
96;17.07.2017;2017;07;16;Maanantai;88;91;179;6;9;15
96;17.07.2017;2017;07;17;Maanantai;70;59;129;8;13;21
96;17.07.2017;2017;07;18;Maanantai;65;46;111;7;10;17
96;17.07.2017;2017;07;19;Maanantai;55;51;106;8;11;19
96;17.07.2017;2017;07;20;Maanantai;72;33;105;4;5;9
96;17.07.2017;2017;07;21;Maanantai;29;33;62;4;10;14
96;17.07.2017;2017;07;22;Maanantai;13;11;24;4;3;7
96;17.07.2017;2017;07;23;Maanantai;3;2;5;1;2;3
96;18.07.2017;2017;07;00;Tiistai;2;2;4;0;1;1
96;18.07.2017;2017;07;01;Tiistai;3;0;3;0;0;0
96;18.07.2017;2017;07;02;Tiistai;3;0;3;0;0;0
96;18.07.2017;2017;07;03;Tiistai;2;2;4;0;0;0
96;18.07.2017;2017;07;04;Tiistai;2;1;3;1;1;2
96;18.07.2017;2017;07;05;Tiistai;4;4;8;0;0;0
96;18.07.2017;2017;07;06;Tiistai;44;21;65;1;1;2
96;18.07.2017;2017;07;07;Tiistai;53;37;90;7;2;9
96;18.07.2017;2017;07;08;Tiistai;15;21;36;2;1;3
96;18.07.2017;2017;07;09;Tiistai;17;13;30;2;7;9
96;18.07.2017;2017;07;10;Tiistai;8;17;25;3;3;6
96;18.07.2017;2017;07;11;Tiistai;7;23;30;4;11;15
96;18.07.2017;2017;07;12;Tiistai;30;29;59;3;6;9
96;18.07.2017;2017;07;13;Tiistai;37;33;70;3;3;6
96;18.07.2017;2017;07;14;Tiistai;35;32;67;7;10;17
96;18.07.2017;2017;07;15;Tiistai;50;95;145;8;4;12
96;18.07.2017;2017;07;16;Tiistai;35;68;103;10;10;20
96;18.07.2017;2017;07;17;Tiistai;36;54;90;10;18;28
96;18.07.2017;2017;07;18;Tiistai;36;22;58;4;5;9
96;18.07.2017;2017;07;19;Tiistai;27;10;37;3;9;12
96;18.07.2017;2017;07;20;Tiistai;27;20;47;4;1;5
96;18.07.2017;2017;07;21;Tiistai;20;17;37;2;4;6
96;18.07.2017;2017;07;22;Tiistai;5;11;16;6;1;7
96;18.07.2017;2017;07;23;Tiistai;8;0;8;1;2;3
96;19.07.2017;2017;07;00;Keskiviikko;4;2;6;1;1;2
96;19.07.2017;2017;07;01;Keskiviikko;1;0;1;3;0;3
96;19.07.2017;2017;07;02;Keskiviikko;3;2;5;0;1;1
96;19.07.2017;2017;07;03;Keskiviikko;1;0;1;0;1;1
96;19.07.2017;2017;07;04;Keskiviikko;4;3;7;2;0;2
96;19.07.2017;2017;07;05;Keskiviikko;2;6;8;1;0;1
96;19.07.2017;2017;07;06;Keskiviikko;42;30;72;5;0;5
96;19.07.2017;2017;07;07;Keskiviikko;67;48;115;4;2;6
96;19.07.2017;2017;07;08;Keskiviikko;35;49;84;5;1;6
96;19.07.2017;2017;07;09;Keskiviikko;30;43;73;1;8;9
96;19.07.2017;2017;07;10;Keskiviikko;18;31;49;4;6;10
96;19.07.2017;2017;07;11;Keskiviikko;34;65;99;4;6;10
96;19.07.2017;2017;07;12;Keskiviikko;60;40;100;10;5;15
96;19.07.2017;2017;07;13;Keskiviikko;47;55;102;4;8;12
96;19.07.2017;2017;07;14;Keskiviikko;63;65;128;6;8;14
96;19.07.2017;2017;07;15;Keskiviikko;67;121;188;3;5;8
96;19.07.2017;2017;07;16;Keskiviikko;75;81;156;8;8;16
96;19.07.2017;2017;07;17;Keskiviikko;70;66;136;10;10;20
96;19.07.2017;2017;07;18;Keskiviikko;53;40;93;12;5;17
96;19.07.2017;2017;07;19;Keskiviikko;46;28;74;12;5;17
96;19.07.2017;2017;07;20;Keskiviikko;67;35;102;6;7;13
96;19.07.2017;2017;07;21;Keskiviikko;31;31;62;9;7;16
96;19.07.2017;2017;07;22;Keskiviikko;12;12;24;1;4;5
96;19.07.2017;2017;07;23;Keskiviikko;10;6;16;0;6;6
96;20.07.2017;2017;07;00;Torstai;8;7;15;1;0;1
96;20.07.2017;2017;07;01;Torstai;4;5;9;1;1;2
96;20.07.2017;2017;07;02;Torstai;8;1;9;3;3;6
96;20.07.2017;2017;07;03;Torstai;11;2;13;3;1;4
96;20.07.2017;2017;07;04;Torstai;6;1;7;0;0;0
96;20.07.2017;2017;07;05;Torstai;3;2;5;2;0;2
96;20.07.2017;2017;07;06;Torstai;48;26;74;4;1;5
96;20.07.2017;2017;07;07;Torstai;70;56;126;12;2;14
96;20.07.2017;2017;07;08;Torstai;24;42;66;2;1;3
96;20.07.2017;2017;07;09;Torstai;19;48;67;5;8;13
96;20.07.2017;2017;07;10;Torstai;30;56;86;8;8;16
96;20.07.2017;2017;07;11;Torstai;42;59;101;8;4;12
96;20.07.2017;2017;07;12;Torstai;51;44;95;6;5;11
96;20.07.2017;2017;07;13;Torstai;53;48;101;2;5;7
96;20.07.2017;2017;07;14;Torstai;49;73;122;4;12;16
96;20.07.2017;2017;07;15;Torstai;74;108;182;9;17;26
96;20.07.2017;2017;07;16;Torstai;79;93;172;2;5;7
96;20.07.2017;2017;07;17;Torstai;64;57;121;13;13;26
96;20.07.2017;2017;07;18;Torstai;48;35;83;4;6;10
96;20.07.2017;2017;07;19;Torstai;68;35;103;7;5;12
96;20.07.2017;2017;07;20;Torstai;44;40;84;5;7;12
96;20.07.2017;2017;07;21;Torstai;24;34;58;3;7;10
96;20.07.2017;2017;07;22;Torstai;10;15;25;1;1;2
96;20.07.2017;2017;07;23;Torstai;8;5;13;0;4;4
96;21.07.2017;2017;07;00;Perjantai;9;2;11;0;0;0
96;21.07.2017;2017;07;01;Perjantai;2;1;3;0;0;0
96;21.07.2017;2017;07;02;Perjantai;2;6;8;1;2;3
96;21.07.2017;2017;07;03;Perjantai;10;0;10;3;1;4
96;21.07.2017;2017;07;04;Perjantai;6;5;11;1;0;1
96;21.07.2017;2017;07;05;Perjantai;6;7;13;1;1;2
96;21.07.2017;2017;07;06;Perjantai;47;21;68;5;2;7
96;21.07.2017;2017;07;07;Perjantai;67;45;112;8;7;15
96;21.07.2017;2017;07;08;Perjantai;23;43;66;2;0;2
96;21.07.2017;2017;07;09;Perjantai;18;40;58;3;2;5
96;21.07.2017;2017;07;10;Perjantai;35;53;88;2;7;9
96;21.07.2017;2017;07;11;Perjantai;42;60;102;6;8;14
96;21.07.2017;2017;07;12;Perjantai;73;56;129;10;10;20
96;21.07.2017;2017;07;13;Perjantai;55;73;128;6;5;11
96;21.07.2017;2017;07;14;Perjantai;55;86;141;6;12;18
96;21.07.2017;2017;07;15;Perjantai;70;112;182;3;13;16
96;21.07.2017;2017;07;16;Perjantai;62;60;122;5;5;10
96;21.07.2017;2017;07;17;Perjantai;39;35;74;6;3;9
96;21.07.2017;2017;07;18;Perjantai;54;48;102;4;5;9
96;21.07.2017;2017;07;19;Perjantai;51;46;97;2;4;6
96;21.07.2017;2017;07;20;Perjantai;38;29;67;6;1;7
96;21.07.2017;2017;07;21;Perjantai;43;62;105;6;5;11
96;21.07.2017;2017;07;22;Perjantai;28;25;53;1;3;4
96;21.07.2017;2017;07;23;Perjantai;27;17;44;2;1;3
96;22.07.2017;2017;07;00;Lauantai;8;9;17;3;3;6
96;22.07.2017;2017;07;01;Lauantai;13;6;19;0;2;2
96;22.07.2017;2017;07;02;Lauantai;6;2;8;1;0;1
96;22.07.2017;2017;07;03;Lauantai;12;4;16;0;0;0
96;22.07.2017;2017;07;04;Lauantai;7;1;8;0;0;0
96;22.07.2017;2017;07;05;Lauantai;1;3;4;1;0;1
96;22.07.2017;2017;07;06;Lauantai;30;10;40;3;0;3
96;22.07.2017;2017;07;07;Lauantai;4;22;26;2;1;3
96;22.07.2017;2017;07;08;Lauantai;5;20;25;2;4;6
96;22.07.2017;2017;07;09;Lauantai;17;26;43;5;5;10
96;22.07.2017;2017;07;10;Lauantai;31;40;71;0;2;2
96;22.07.2017;2017;07;11;Lauantai;37;42;79;6;6;12
96;22.07.2017;2017;07;12;Lauantai;39;55;94;5;11;16
96;22.07.2017;2017;07;13;Lauantai;61;32;93;5;11;16
96;22.07.2017;2017;07;14;Lauantai;54;53;107;7;8;15
96;22.07.2017;2017;07;15;Lauantai;44;67;111;3;14;17
96;22.07.2017;2017;07;16;Lauantai;54;42;96;5;5;10
96;22.07.2017;2017;07;17;Lauantai;33;34;67;6;2;8
96;22.07.2017;2017;07;18;Lauantai;50;33;83;3;5;8
96;22.07.2017;2017;07;19;Lauantai;34;38;72;9;5;14
96;22.07.2017;2017;07;20;Lauantai;45;28;73;5;2;7
96;22.07.2017;2017;07;21;Lauantai;32;38;70;2;7;9
96;22.07.2017;2017;07;22;Lauantai;18;18;36;2;2;4
96;22.07.2017;2017;07;23;Lauantai;17;6;23;0;1;1
96;23.07.2017;2017;07;00;Sunnuntai;15;8;23;2;1;3
96;23.07.2017;2017;07;01;Sunnuntai;18;15;33;2;2;4
96;23.07.2017;2017;07;02;Sunnuntai;11;2;13;1;0;1
96;23.07.2017;2017;07;03;Sunnuntai;17;6;23;4;1;5
96;23.07.2017;2017;07;04;Sunnuntai;16;1;17;2;0;2
96;23.07.2017;2017;07;05;Sunnuntai;4;1;5;1;0;1
96;23.07.2017;2017;07;06;Sunnuntai;19;5;24;2;0;2
96;23.07.2017;2017;07;07;Sunnuntai;7;11;18;0;5;5
96;23.07.2017;2017;07;08;Sunnuntai;6;7;13;1;3;4
96;23.07.2017;2017;07;09;Sunnuntai;14;13;27;1;3;4
96;23.07.2017;2017;07;10;Sunnuntai;20;27;47;5;1;6
96;23.07.2017;2017;07;11;Sunnuntai;11;49;60;4;12;16
96;23.07.2017;2017;07;12;Sunnuntai;53;51;104;10;11;21
96;23.07.2017;2017;07;13;Sunnuntai;51;47;98;6;2;8
96;23.07.2017;2017;07;14;Sunnuntai;41;35;76;5;6;11
96;23.07.2017;2017;07;15;Sunnuntai;53;35;88;4;7;11
96;23.07.2017;2017;07;16;Sunnuntai;31;19;50;4;6;10
96;23.07.2017;2017;07;17;Sunnuntai;18;12;30;6;2;8
96;23.07.2017;2017;07;18;Sunnuntai;14;16;30;3;8;11
96;23.07.2017;2017;07;19;Sunnuntai;21;26;47;2;4;6
96;23.07.2017;2017;07;20;Sunnuntai;20;20;40;7;6;13
96;23.07.2017;2017;07;21;Sunnuntai;13;24;37;9;4;13
96;23.07.2017;2017;07;22;Sunnuntai;11;11;22;1;0;1
96;23.07.2017;2017;07;23;Sunnuntai;5;2;7;3;1;4
96;24.07.2017;2017;07;00;Maanantai;6;2;8;2;3;5
96;24.07.2017;2017;07;01;Maanantai;2;1;3;4;2;6
96;24.07.2017;2017;07;02;Maanantai;1;1;2;0;1;1
96;24.07.2017;2017;07;03;Maanantai;2;0;2;0;0;0
96;24.07.2017;2017;07;04;Maanantai;1;1;2;0;1;1
96;24.07.2017;2017;07;05;Maanantai;4;10;14;1;1;2
96;24.07.2017;2017;07;06;Maanantai;51;26;77;2;2;4
96;24.07.2017;2017;07;07;Maanantai;72;72;144;8;2;10
96;24.07.2017;2017;07;08;Maanantai;31;67;98;5;6;11
96;24.07.2017;2017;07;09;Maanantai;27;54;81;2;2;4
96;24.07.2017;2017;07;10;Maanantai;32;59;91;4;7;11
96;24.07.2017;2017;07;11;Maanantai;41;55;96;3;5;8
96;24.07.2017;2017;07;12;Maanantai;48;69;117;9;9;18
96;24.07.2017;2017;07;13;Maanantai;68;80;148;7;6;13
96;24.07.2017;2017;07;14;Maanantai;66;84;150;6;10;16
96;24.07.2017;2017;07;15;Maanantai;68;143;211;10;13;23
96;24.07.2017;2017;07;16;Maanantai;105;111;216;7;8;15
96;24.07.2017;2017;07;17;Maanantai;77;72;149;11;5;16
96;24.07.2017;2017;07;18;Maanantai;69;65;134;4;2;6
96;24.07.2017;2017;07;19;Maanantai;61;45;106;11;10;21
96;24.07.2017;2017;07;20;Maanantai;73;28;101;10;7;17
96;24.07.2017;2017;07;21;Maanantai;47;35;82;5;4;9
96;24.07.2017;2017;07;22;Maanantai;19;16;35;7;1;8
96;24.07.2017;2017;07;23;Maanantai;12;4;16;6;2;8
96;25.07.2017;2017;07;00;Tiistai;1;3;4;1;2;3
96;25.07.2017;2017;07;01;Tiistai;7;1;8;0;0;0
96;25.07.2017;2017;07;02;Tiistai;4;0;4;0;1;1
96;25.07.2017;2017;07;03;Tiistai;9;1;10;0;0;0
96;25.07.2017;2017;07;04;Tiistai;3;0;3;0;0;0
96;25.07.2017;2017;07;05;Tiistai;4;10;14;1;1;2
96;25.07.2017;2017;07;06;Tiistai;58;26;84;4;2;6
96;25.07.2017;2017;07;07;Tiistai;80;83;163;12;2;14
96;25.07.2017;2017;07;08;Tiistai;23;63;86;3;9;12
96;25.07.2017;2017;07;09;Tiistai;42;51;93;4;11;15
96;25.07.2017;2017;07;10;Tiistai;34;66;100;5;8;13
96;25.07.2017;2017;07;11;Tiistai;48;73;121;8;7;15
96;25.07.2017;2017;07;12;Tiistai;78;72;150;12;7;19
96;25.07.2017;2017;07;13;Tiistai;64;91;155;5;10;15
96;25.07.2017;2017;07;14;Tiistai;76;90;166;4;8;12
96;25.07.2017;2017;07;15;Tiistai;94;185;279;8;24;32
96;25.07.2017;2017;07;16;Tiistai;129;101;230;12;14;26
96;25.07.2017;2017;07;17;Tiistai;84;58;142;15;11;26
96;25.07.2017;2017;07;18;Tiistai;94;56;150;5;9;14
96;25.07.2017;2017;07;19;Tiistai;84;75;159;13;8;21
96;25.07.2017;2017;07;20;Tiistai;65;23;88;6;8;14
96;25.07.2017;2017;07;21;Tiistai;49;42;91;2;7;9
96;25.07.2017;2017;07;22;Tiistai;21;14;35;4;2;6
96;25.07.2017;2017;07;23;Tiistai;16;6;22;1;1;2
96;26.07.2017;2017;07;00;Keskiviikko;7;4;11;2;0;2
96;26.07.2017;2017;07;01;Keskiviikko;6;4;10;2;1;3
96;26.07.2017;2017;07;02;Keskiviikko;5;4;9;0;0;0
96;26.07.2017;2017;07;03;Keskiviikko;3;0;3;4;0;4
96;26.07.2017;2017;07;04;Keskiviikko;3;1;4;1;0;1
96;26.07.2017;2017;07;05;Keskiviikko;5;11;16;0;0;0
96;26.07.2017;2017;07;06;Keskiviikko;54;21;75;3;1;4
96;26.07.2017;2017;07;07;Keskiviikko;78;74;152;8;2;10
96;26.07.2017;2017;07;08;Keskiviikko;23;63;86;5;3;8
96;26.07.2017;2017;07;09;Keskiviikko;31;64;95;3;6;9
96;26.07.2017;2017;07;10;Keskiviikko;27;50;77;3;5;8
96;26.07.2017;2017;07;11;Keskiviikko;54;90;144;7;8;15
96;26.07.2017;2017;07;12;Keskiviikko;64;83;147;4;12;16
96;26.07.2017;2017;07;13;Keskiviikko;82;96;178;14;10;24
96;26.07.2017;2017;07;14;Keskiviikko;88;88;176;5;7;12
96;26.07.2017;2017;07;15;Keskiviikko;85;162;247;9;28;37
96;26.07.2017;2017;07;16;Keskiviikko;108;117;225;10;15;25
96;26.07.2017;2017;07;17;Keskiviikko;89;90;179;11;11;22
96;26.07.2017;2017;07;18;Keskiviikko;83;72;155;4;13;17
96;26.07.2017;2017;07;19;Keskiviikko;79;54;133;7;6;13
96;26.07.2017;2017;07;20;Keskiviikko;101;61;162;5;6;11
96;26.07.2017;2017;07;21;Keskiviikko;58;48;106;5;4;9
96;26.07.2017;2017;07;22;Keskiviikko;33;24;57;4;7;11
96;26.07.2017;2017;07;23;Keskiviikko;13;8;21;0;1;1
96;27.07.2017;2017;07;00;Torstai;18;10;28;1;2;3
96;27.07.2017;2017;07;01;Torstai;9;2;11;1;0;1
96;27.07.2017;2017;07;02;Torstai;8;0;8;1;0;1
96;27.07.2017;2017;07;03;Torstai;11;3;14;0;2;2
96;27.07.2017;2017;07;04;Torstai;6;3;9;0;0;0
96;27.07.2017;2017;07;05;Torstai;6;6;12;0;1;1
96;27.07.2017;2017;07;06;Torstai;48;23;71;4;1;5
96;27.07.2017;2017;07;07;Torstai;80;77;157;8;1;9
96;27.07.2017;2017;07;08;Torstai;36;72;108;6;5;11
96;27.07.2017;2017;07;09;Torstai;26;51;77;4;9;13
96;27.07.2017;2017;07;10;Torstai;27;56;83;5;8;13
96;27.07.2017;2017;07;11;Torstai;33;53;86;6;7;13
96;27.07.2017;2017;07;12;Torstai;63;72;135;7;8;15
96;27.07.2017;2017;07;13;Torstai;67;84;151;10;15;25
96;27.07.2017;2017;07;14;Torstai;73;101;174;9;8;17
96;27.07.2017;2017;07;15;Torstai;81;134;215;5;22;27
96;27.07.2017;2017;07;16;Torstai;99;111;210;2;20;22
96;27.07.2017;2017;07;17;Torstai;92;116;208;6;14;20
96;27.07.2017;2017;07;18;Torstai;77;58;135;8;7;15
96;27.07.2017;2017;07;19;Torstai;79;47;126;4;4;8
96;27.07.2017;2017;07;20;Torstai;70;40;110;4;6;10
96;27.07.2017;2017;07;21;Torstai;88;47;135;8;8;16
96;27.07.2017;2017;07;22;Torstai;23;25;48;2;4;6
96;27.07.2017;2017;07;23;Torstai;25;15;40;4;1;5
96;28.07.2017;2017;07;00;Perjantai;13;3;16;2;1;3
96;28.07.2017;2017;07;01;Perjantai;8;2;10;0;0;0
96;28.07.2017;2017;07;02;Perjantai;7;2;9;0;0;0
96;28.07.2017;2017;07;03;Perjantai;4;2;6;0;0;0
96;28.07.2017;2017;07;04;Perjantai;9;2;11;0;0;0
96;28.07.2017;2017;07;05;Perjantai;4;13;17;2;0;2
96;28.07.2017;2017;07;06;Perjantai;52;17;69;1;0;1
96;28.07.2017;2017;07;07;Perjantai;58;65;123;9;5;14
96;28.07.2017;2017;07;08;Perjantai;22;54;76;4;5;9
96;28.07.2017;2017;07;09;Perjantai;37;44;81;3;12;15
96;28.07.2017;2017;07;10;Perjantai;36;61;97;10;8;18
96;28.07.2017;2017;07;11;Perjantai;51;83;134;2;8;10
96;28.07.2017;2017;07;12;Perjantai;61;85;146;7;3;10
96;28.07.2017;2017;07;13;Perjantai;65;99;164;6;13;19
96;28.07.2017;2017;07;14;Perjantai;72;161;233;2;22;24
96;28.07.2017;2017;07;15;Perjantai;89;143;232;10;14;24
96;28.07.2017;2017;07;16;Perjantai;83;120;203;4;5;9
96;28.07.2017;2017;07;17;Perjantai;78;97;175;6;16;22
96;28.07.2017;2017;07;18;Perjantai;65;98;163;10;18;28
96;28.07.2017;2017;07;19;Perjantai;51;61;112;6;6;12
96;28.07.2017;2017;07;20;Perjantai;39;46;85;6;4;10
96;28.07.2017;2017;07;21;Perjantai;50;56;106;4;6;10
96;28.07.2017;2017;07;22;Perjantai;50;28;78;1;3;4
96;28.07.2017;2017;07;23;Perjantai;61;21;82;1;1;2
96;29.07.2017;2017;07;00;Lauantai;88;5;93;10;1;11
96;29.07.2017;2017;07;01;Lauantai;120;9;129;13;1;14
96;29.07.2017;2017;07;02;Lauantai;75;4;79;12;2;14
96;29.07.2017;2017;07;03;Lauantai;78;4;82;13;0;13
96;29.07.2017;2017;07;04;Lauantai;30;4;34;7;1;8
96;29.07.2017;2017;07;05;Lauantai;8;4;12;1;0;1
96;29.07.2017;2017;07;06;Lauantai;25;11;36;2;0;2
96;29.07.2017;2017;07;07;Lauantai;10;18;28;2;0;2
96;29.07.2017;2017;07;08;Lauantai;21;10;31;2;0;2
96;29.07.2017;2017;07;09;Lauantai;11;33;44;3;5;8
96;29.07.2017;2017;07;10;Lauantai;9;24;33;5;4;9
96;29.07.2017;2017;07;11;Lauantai;29;58;87;2;4;6
96;29.07.2017;2017;07;12;Lauantai;36;52;88;2;2;4
96;29.07.2017;2017;07;13;Lauantai;32;58;90;2;2;4
96;29.07.2017;2017;07;14;Lauantai;24;75;99;3;8;11
96;29.07.2017;2017;07;15;Lauantai;41;52;93;4;2;6
96;29.07.2017;2017;07;16;Lauantai;39;42;81;6;3;9
96;29.07.2017;2017;07;17;Lauantai;33;63;96;7;9;16
96;29.07.2017;2017;07;18;Lauantai;35;65;100;6;7;13
96;29.07.2017;2017;07;19;Lauantai;34;61;95;6;8;14
96;29.07.2017;2017;07;20;Lauantai;39;47;86;5;6;11
96;29.07.2017;2017;07;21;Lauantai;30;50;80;5;7;12
96;29.07.2017;2017;07;22;Lauantai;23;18;41;2;3;5
96;29.07.2017;2017;07;23;Lauantai;26;7;33;1;0;1
96;30.07.2017;2017;07;00;Sunnuntai;69;6;75;3;1;4
96;30.07.2017;2017;07;01;Sunnuntai;99;5;104;5;1;6
96;30.07.2017;2017;07;02;Sunnuntai;78;4;82;9;2;11
96;30.07.2017;2017;07;03;Sunnuntai;51;0;51;6;0;6
96;30.07.2017;2017;07;04;Sunnuntai;44;1;45;7;0;7
96;30.07.2017;2017;07;05;Sunnuntai;14;4;18;2;1;3
96;30.07.2017;2017;07;06;Sunnuntai;27;6;33;0;0;0
96;30.07.2017;2017;07;07;Sunnuntai;5;11;16;1;2;3
96;30.07.2017;2017;07;08;Sunnuntai;15;9;24;3;3;6
96;30.07.2017;2017;07;09;Sunnuntai;14;26;40;2;2;4
96;30.07.2017;2017;07;10;Sunnuntai;18;29;47;2;6;8
96;30.07.2017;2017;07;11;Sunnuntai;27;48;75;7;7;14
96;30.07.2017;2017;07;12;Sunnuntai;47;61;108;2;8;10
96;30.07.2017;2017;07;13;Sunnuntai;71;85;156;3;10;13
96;30.07.2017;2017;07;14;Sunnuntai;71;75;146;11;13;24
96;30.07.2017;2017;07;15;Sunnuntai;50;64;114;2;10;12
96;30.07.2017;2017;07;16;Sunnuntai;85;37;122;8;10;18
96;30.07.2017;2017;07;17;Sunnuntai;64;45;109;9;11;20
96;30.07.2017;2017;07;18;Sunnuntai;53;55;108;11;5;16
96;30.07.2017;2017;07;19;Sunnuntai;57;39;96;6;9;15
96;30.07.2017;2017;07;20;Sunnuntai;47;33;80;11;9;20
96;30.07.2017;2017;07;21;Sunnuntai;31;37;68;3;4;7
96;30.07.2017;2017;07;22;Sunnuntai;31;8;39;1;1;2
96;30.07.2017;2017;07;23;Sunnuntai;17;7;24;0;1;1
96;31.07.2017;2017;07;00;Maanantai;11;4;15;0;0;0
96;31.07.2017;2017;07;01;Maanantai;9;5;14;0;0;0
96;31.07.2017;2017;07;02;Maanantai;6;1;7;0;0;0
96;31.07.2017;2017;07;03;Maanantai;5;4;9;1;0;1
96;31.07.2017;2017;07;04;Maanantai;3;0;3;1;0;1
96;31.07.2017;2017;07;05;Maanantai;4;10;14;0;0;0
96;31.07.2017;2017;07;06;Maanantai;54;31;85;1;0;1
96;31.07.2017;2017;07;07;Maanantai;81;90;171;10;5;15
96;31.07.2017;2017;07;08;Maanantai;37;77;114;5;5;10
96;31.07.2017;2017;07;09;Maanantai;26;60;86;3;3;6
96;31.07.2017;2017;07;10;Maanantai;31;37;68;9;2;11
96;31.07.2017;2017;07;11;Maanantai;42;71;113;5;14;19
96;31.07.2017;2017;07;12;Maanantai;64;54;118;2;11;13
96;31.07.2017;2017;07;13;Maanantai;76;86;162;10;11;21
96;31.07.2017;2017;07;14;Maanantai;66;90;156;7;7;14
96;31.07.2017;2017;07;15;Maanantai;121;145;266;9;22;31
96;31.07.2017;2017;07;16;Maanantai;124;114;238;11;28;39
96;31.07.2017;2017;07;17;Maanantai;91;84;175;7;17;24
96;31.07.2017;2017;07;18;Maanantai;97;60;157;10;5;15
96;31.07.2017;2017;07;19;Maanantai;78;38;116;10;8;18
96;31.07.2017;2017;07;20;Maanantai;61;17;78;9;5;14
96;31.07.2017;2017;07;21;Maanantai;25;27;52;4;11;15
96;31.07.2017;2017;07;22;Maanantai;18;13;31;2;7;9
96;31.07.2017;2017;07;23;Maanantai;8;3;11;2;2;4
96;01.08.2017;2017;08;00;Tiistai;2;2;4;0;1;1
96;01.08.2017;2017;08;01;Tiistai;1;0;1;0;0;0
96;01.08.2017;2017;08;02;Tiistai;3;0;3;1;1;2
96;01.08.2017;2017;08;03;Tiistai;0;0;0;0;0;0
96;01.08.2017;2017;08;04;Tiistai;4;3;7;1;0;1
96;01.08.2017;2017;08;05;Tiistai;4;5;9;1;0;1
96;01.08.2017;2017;08;06;Tiistai;65;33;98;6;2;8
96;01.08.2017;2017;08;07;Tiistai;86;106;192;4;4;8
96;01.08.2017;2017;08;08;Tiistai;47;95;142;5;9;14
96;01.08.2017;2017;08;09;Tiistai;26;64;90;10;8;18
96;01.08.2017;2017;08;10;Tiistai;41;58;99;3;9;12
96;01.08.2017;2017;08;11;Tiistai;52;56;108;6;12;18
96;01.08.2017;2017;08;12;Tiistai;77;40;117;9;6;15
96;01.08.2017;2017;08;13;Tiistai;70;74;144;5;12;17
96;01.08.2017;2017;08;14;Tiistai;82;113;195;7;15;22
96;01.08.2017;2017;08;15;Tiistai;105;156;261;15;34;49
96;01.08.2017;2017;08;16;Tiistai;130;134;264;8;15;23
96;01.08.2017;2017;08;17;Tiistai;88;98;186;13;25;38
96;01.08.2017;2017;08;18;Tiistai;73;72;145;11;13;24
96;01.08.2017;2017;08;19;Tiistai;80;47;127;15;17;32
96;01.08.2017;2017;08;20;Tiistai;113;25;138;3;7;10
96;01.08.2017;2017;08;21;Tiistai;58;36;94;7;4;11
96;01.08.2017;2017;08;22;Tiistai;15;19;34;2;1;3
96;01.08.2017;2017;08;23;Tiistai;12;7;19;1;2;3
96;02.08.2017;2017;08;00;Keskiviikko;5;5;10;2;3;5
96;02.08.2017;2017;08;01;Keskiviikko;5;4;9;0;0;0
96;02.08.2017;2017;08;02;Keskiviikko;2;1;3;1;1;2
96;02.08.2017;2017;08;03;Keskiviikko;1;0;1;0;0;0
96;02.08.2017;2017;08;04;Keskiviikko;4;2;6;2;0;2
96;02.08.2017;2017;08;05;Keskiviikko;7;12;19;1;0;1
96;02.08.2017;2017;08;06;Keskiviikko;61;22;83;4;0;4
96;02.08.2017;2017;08;07;Keskiviikko;93;109;202;7;1;8
96;02.08.2017;2017;08;08;Keskiviikko;46;94;140;7;6;13
96;02.08.2017;2017;08;09;Keskiviikko;25;63;88;5;5;10
96;02.08.2017;2017;08;10;Keskiviikko;35;61;96;4;12;16
96;02.08.2017;2017;08;11;Keskiviikko;64;77;141;6;6;12
96;02.08.2017;2017;08;12;Keskiviikko;87;77;164;13;11;24
96;02.08.2017;2017;08;13;Keskiviikko;72;103;175;4;7;11
96;02.08.2017;2017;08;14;Keskiviikko;85;109;194;5;10;15
96;02.08.2017;2017;08;15;Keskiviikko;147;162;309;9;30;39
96;02.08.2017;2017;08;16;Keskiviikko;126;124;250;7;13;20
96;02.08.2017;2017;08;17;Keskiviikko;108;101;209;12;18;30
96;02.08.2017;2017;08;18;Keskiviikko;91;62;153;14;8;22
96;02.08.2017;2017;08;19;Keskiviikko;79;52;131;11;9;20
96;02.08.2017;2017;08;20;Keskiviikko;85;36;121;9;11;20
96;02.08.2017;2017;08;21;Keskiviikko;59;32;91;6;7;13
96;02.08.2017;2017;08;22;Keskiviikko;29;11;40;7;2;9
96;02.08.2017;2017;08;23;Keskiviikko;14;9;23;2;1;3
96;03.08.2017;2017;08;00;Torstai;8;5;13;2;0;2
96;03.08.2017;2017;08;01;Torstai;5;2;7;0;0;0
96;03.08.2017;2017;08;02;Torstai;4;2;6;3;0;3
96;03.08.2017;2017;08;03;Torstai;5;3;8;2;1;3
96;03.08.2017;2017;08;04;Torstai;10;1;11;1;0;1
96;03.08.2017;2017;08;05;Torstai;5;10;15;0;1;1
96;03.08.2017;2017;08;06;Torstai;52;24;76;1;1;2
96;03.08.2017;2017;08;07;Torstai;102;80;182;8;5;13
96;03.08.2017;2017;08;08;Torstai;41;89;130;4;7;11
96;03.08.2017;2017;08;09;Torstai;28;63;91;9;10;19
96;03.08.2017;2017;08;10;Torstai;31;55;86;5;8;13
96;03.08.2017;2017;08;11;Torstai;55;61;116;10;7;17
96;03.08.2017;2017;08;12;Torstai;73;56;129;12;6;18
96;03.08.2017;2017;08;13;Torstai;70;74;144;5;8;13
96;03.08.2017;2017;08;14;Torstai;62;107;169;6;17;23
96;03.08.2017;2017;08;15;Torstai;104;147;251;12;27;39
96;03.08.2017;2017;08;16;Torstai;106;127;233;10;20;30
96;03.08.2017;2017;08;17;Torstai;72;69;141;10;10;20
96;03.08.2017;2017;08;18;Torstai;73;53;126;13;11;24
96;03.08.2017;2017;08;19;Torstai;71;47;118;8;13;21
96;03.08.2017;2017;08;20;Torstai;66;41;107;9;10;19
96;03.08.2017;2017;08;21;Torstai;38;33;71;6;5;11
96;03.08.2017;2017;08;22;Torstai;31;9;40;2;2;4
96;03.08.2017;2017;08;23;Torstai;18;8;26;1;0;1
96;04.08.2017;2017;08;00;Perjantai;7;4;11;3;1;4
96;04.08.2017;2017;08;01;Perjantai;8;4;12;0;0;0
96;04.08.2017;2017;08;02;Perjantai;12;1;13;1;0;1
96;04.08.2017;2017;08;03;Perjantai;1;3;4;1;0;1
96;04.08.2017;2017;08;04;Perjantai;4;3;7;0;0;0
96;04.08.2017;2017;08;05;Perjantai;4;6;10;1;0;1
96;04.08.2017;2017;08;06;Perjantai;57;21;78;6;0;6
96;04.08.2017;2017;08;07;Perjantai;82;81;163;11;4;15
96;04.08.2017;2017;08;08;Perjantai;43;89;132;3;3;6
96;04.08.2017;2017;08;09;Perjantai;47;48;95;8;5;13
96;04.08.2017;2017;08;10;Perjantai;36;44;80;6;8;14
96;04.08.2017;2017;08;11;Perjantai;43;105;148;7;9;16
96;04.08.2017;2017;08;12;Perjantai;72;68;140;7;12;19
96;04.08.2017;2017;08;13;Perjantai;59;74;133;2;7;9
96;04.08.2017;2017;08;14;Perjantai;74;104;178;8;16;24
96;04.08.2017;2017;08;15;Perjantai;78;127;205;5;22;27
96;04.08.2017;2017;08;16;Perjantai;91;94;185;5;18;23
96;04.08.2017;2017;08;17;Perjantai;71;71;142;5;9;14
96;04.08.2017;2017;08;18;Perjantai;57;52;109;9;5;14
96;04.08.2017;2017;08;19;Perjantai;34;36;70;6;4;10
96;04.08.2017;2017;08;20;Perjantai;47;32;79;4;6;10
96;04.08.2017;2017;08;21;Perjantai;33;38;71;4;5;9
96;04.08.2017;2017;08;22;Perjantai;23;21;44;1;2;3
96;04.08.2017;2017;08;23;Perjantai;25;12;37;1;4;5
96;05.08.2017;2017;08;00;Lauantai;15;5;20;3;2;5
96;05.08.2017;2017;08;01;Lauantai;18;2;20;0;2;2
96;05.08.2017;2017;08;02;Lauantai;10;0;10;5;0;5
96;05.08.2017;2017;08;03;Lauantai;13;2;15;0;0;0
96;05.08.2017;2017;08;04;Lauantai;10;2;12;1;1;2
96;05.08.2017;2017;08;05;Lauantai;1;2;3;1;0;1
96;05.08.2017;2017;08;06;Lauantai;26;11;37;5;0;5
96;05.08.2017;2017;08;07;Lauantai;6;15;21;0;4;4
96;05.08.2017;2017;08;08;Lauantai;10;19;29;0;1;1
96;05.08.2017;2017;08;09;Lauantai;19;39;58;3;6;9
96;05.08.2017;2017;08;10;Lauantai;31;36;67;7;4;11
96;05.08.2017;2017;08;11;Lauantai;28;36;64;5;5;10
96;05.08.2017;2017;08;12;Lauantai;35;37;72;5;4;9
96;05.08.2017;2017;08;13;Lauantai;32;43;75;4;2;6
96;05.08.2017;2017;08;14;Lauantai;32;44;76;5;6;11
96;05.08.2017;2017;08;15;Lauantai;42;44;86;4;3;7
96;05.08.2017;2017;08;16;Lauantai;30;39;69;6;2;8
96;05.08.2017;2017;08;17;Lauantai;50;37;87;3;1;4
96;05.08.2017;2017;08;18;Lauantai;33;10;43;2;1;3
96;05.08.2017;2017;08;19;Lauantai;23;17;40;0;2;2
96;05.08.2017;2017;08;20;Lauantai;25;16;41;3;5;8
96;05.08.2017;2017;08;21;Lauantai;13;24;37;1;1;2
96;05.08.2017;2017;08;22;Lauantai;6;6;12;0;1;1
96;05.08.2017;2017;08;23;Lauantai;14;8;22;0;2;2
96;06.08.2017;2017;08;00;Sunnuntai;9;11;20;1;1;2
96;06.08.2017;2017;08;01;Sunnuntai;7;5;12;2;2;4
96;06.08.2017;2017;08;02;Sunnuntai;9;0;9;0;1;1
96;06.08.2017;2017;08;03;Sunnuntai;10;0;10;3;0;3
96;06.08.2017;2017;08;04;Sunnuntai;9;0;9;3;0;3
96;06.08.2017;2017;08;05;Sunnuntai;7;1;8;0;0;0
96;06.08.2017;2017;08;06;Sunnuntai;24;7;31;1;1;2
96;06.08.2017;2017;08;07;Sunnuntai;2;13;15;1;2;3
96;06.08.2017;2017;08;08;Sunnuntai;5;5;10;2;5;7
96;06.08.2017;2017;08;09;Sunnuntai;9;18;27;2;3;5
96;06.08.2017;2017;08;10;Sunnuntai;9;17;26;1;5;6
96;06.08.2017;2017;08;11;Sunnuntai;27;35;62;1;5;6
96;06.08.2017;2017;08;12;Sunnuntai;36;43;79;5;12;17
96;06.08.2017;2017;08;13;Sunnuntai;37;44;81;5;4;9
96;06.08.2017;2017;08;14;Sunnuntai;26;54;80;2;1;3
96;06.08.2017;2017;08;15;Sunnuntai;31;36;67;2;6;8
96;06.08.2017;2017;08;16;Sunnuntai;50;37;87;12;3;15
96;06.08.2017;2017;08;17;Sunnuntai;51;35;86;11;6;17
96;06.08.2017;2017;08;18;Sunnuntai;47;26;73;11;13;24
96;06.08.2017;2017;08;19;Sunnuntai;37;31;68;4;10;14
96;06.08.2017;2017;08;20;Sunnuntai;24;23;47;3;7;10
96;06.08.2017;2017;08;21;Sunnuntai;15;31;46;5;4;9
96;06.08.2017;2017;08;22;Sunnuntai;11;5;16;3;1;4
96;06.08.2017;2017;08;23;Sunnuntai;6;7;13;0;3;3
96;07.08.2017;2017;08;00;Maanantai;8;4;12;0;1;1
96;07.08.2017;2017;08;01;Maanantai;1;3;4;0;0;0
96;07.08.2017;2017;08;02;Maanantai;3;0;3;0;0;0
96;07.08.2017;2017;08;03;Maanantai;6;0;6;1;0;1
96;07.08.2017;2017;08;04;Maanantai;3;0;3;0;0;0
96;07.08.2017;2017;08;05;Maanantai;5;9;14;2;0;2
96;07.08.2017;2017;08;06;Maanantai;55;37;92;3;1;4
96;07.08.2017;2017;08;07;Maanantai;95;117;212;12;3;15
96;07.08.2017;2017;08;08;Maanantai;41;100;141;6;8;14
96;07.08.2017;2017;08;09;Maanantai;27;75;102;6;4;10
96;07.08.2017;2017;08;10;Maanantai;44;80;124;4;6;10
96;07.08.2017;2017;08;11;Maanantai;65;68;133;13;8;21
96;07.08.2017;2017;08;12;Maanantai;57;69;126;4;10;14
96;07.08.2017;2017;08;13;Maanantai;81;79;160;3;7;10
96;07.08.2017;2017;08;14;Maanantai;70;86;156;11;15;26
96;07.08.2017;2017;08;15;Maanantai;120;158;278;5;23;28
96;07.08.2017;2017;08;16;Maanantai;146;114;260;8;22;30
96;07.08.2017;2017;08;17;Maanantai;85;66;151;3;16;19
96;07.08.2017;2017;08;18;Maanantai;86;68;154;7;11;18
96;07.08.2017;2017;08;19;Maanantai;77;47;124;20;13;33
96;07.08.2017;2017;08;20;Maanantai;72;20;92;17;11;28
96;07.08.2017;2017;08;21;Maanantai;35;25;60;10;7;17
96;07.08.2017;2017;08;22;Maanantai;11;14;25;2;4;6
96;07.08.2017;2017;08;23;Maanantai;9;3;12;2;0;2
96;08.08.2017;2017;08;00;Tiistai;3;1;4;4;1;5
96;08.08.2017;2017;08;01;Tiistai;1;2;3;0;0;0
96;08.08.2017;2017;08;02;Tiistai;4;10;14;1;1;2
96;08.08.2017;2017;08;03;Tiistai;1;0;1;1;0;1
96;08.08.2017;2017;08;04;Tiistai;3;0;3;1;0;1
96;08.08.2017;2017;08;05;Tiistai;8;6;14;0;0;0
96;08.08.2017;2017;08;06;Tiistai;59;34;93;1;2;3
96;08.08.2017;2017;08;07;Tiistai;102;116;218;15;3;18
96;08.08.2017;2017;08;08;Tiistai;48;109;157;8;11;19
96;08.08.2017;2017;08;09;Tiistai;37;83;120;8;9;17
96;08.08.2017;2017;08;10;Tiistai;34;66;100;4;9;13
96;08.08.2017;2017;08;11;Tiistai;63;79;142;5;5;10
96;08.08.2017;2017;08;12;Tiistai;72;72;144;11;12;23
96;08.08.2017;2017;08;13;Tiistai;84;92;176;6;11;17
96;08.08.2017;2017;08;14;Tiistai;78;115;193;8;17;25
96;08.08.2017;2017;08;15;Tiistai;117;166;283;7;19;26
96;08.08.2017;2017;08;16;Tiistai;157;149;306;16;26;42
96;08.08.2017;2017;08;17;Tiistai;109;106;215;7;7;14
96;08.08.2017;2017;08;18;Tiistai;85;67;152;13;7;20
96;08.08.2017;2017;08;19;Tiistai;66;38;104;4;16;20
96;08.08.2017;2017;08;20;Tiistai;88;18;106;6;4;10
96;08.08.2017;2017;08;21;Tiistai;26;40;66;6;3;9
96;08.08.2017;2017;08;22;Tiistai;12;18;30;5;0;5
96;08.08.2017;2017;08;23;Tiistai;12;4;16;0;1;1
96;09.08.2017;2017;08;00;Keskiviikko;9;5;14;1;1;2
96;09.08.2017;2017;08;01;Keskiviikko;6;0;6;0;0;0
96;09.08.2017;2017;08;02;Keskiviikko;2;2;4;0;0;0
96;09.08.2017;2017;08;03;Keskiviikko;0;1;1;0;0;0
96;09.08.2017;2017;08;04;Keskiviikko;2;3;5;1;0;1
96;09.08.2017;2017;08;05;Keskiviikko;5;10;15;0;0;0
96;09.08.2017;2017;08;06;Keskiviikko;58;29;87;2;2;4
96;09.08.2017;2017;08;07;Keskiviikko;134;113;247;10;0;10
96;09.08.2017;2017;08;08;Keskiviikko;74;105;179;6;4;10
96;09.08.2017;2017;08;09;Keskiviikko;29;70;99;7;9;16
96;09.08.2017;2017;08;10;Keskiviikko;39;71;110;4;12;16
96;09.08.2017;2017;08;11;Keskiviikko;63;91;154;10;4;14
96;09.08.2017;2017;08;12;Keskiviikko;65;88;153;7;6;13
96;09.08.2017;2017;08;13;Keskiviikko;97;78;175;7;12;19
96;09.08.2017;2017;08;14;Keskiviikko;90;122;212;13;20;33
96;09.08.2017;2017;08;15;Keskiviikko;128;192;320;10;31;41
96;09.08.2017;2017;08;16;Keskiviikko;157;148;305;16;26;42
96;09.08.2017;2017;08;17;Keskiviikko;105;97;202;14;13;27
96;09.08.2017;2017;08;18;Keskiviikko;117;63;180;21;17;38
96;09.08.2017;2017;08;19;Keskiviikko;99;42;141;14;18;32
96;09.08.2017;2017;08;20;Keskiviikko;87;57;144;9;21;30
96;09.08.2017;2017;08;21;Keskiviikko;39;48;87;5;3;8
96;09.08.2017;2017;08;22;Keskiviikko;23;12;35;0;4;4
96;09.08.2017;2017;08;23;Keskiviikko;10;3;13;1;0;1
96;10.08.2017;2017;08;00;Torstai;4;6;10;2;4;6
96;10.08.2017;2017;08;01;Torstai;2;1;3;0;0;0
96;10.08.2017;2017;08;02;Torstai;4;0;4;1;0;1
96;10.08.2017;2017;08;03;Torstai;1;1;2;0;0;0
96;10.08.2017;2017;08;04;Torstai;1;0;1;0;2;2
96;10.08.2017;2017;08;05;Torstai;8;7;15;2;0;2
96;10.08.2017;2017;08;06;Torstai;54;28;82;1;1;2
96;10.08.2017;2017;08;07;Torstai;97;113;210;13;6;19
96;10.08.2017;2017;08;08;Torstai;111;140;251;18;9;27
96;10.08.2017;2017;08;09;Torstai;107;104;211;13;5;18
96;10.08.2017;2017;08;10;Torstai;44;63;107;8;6;14
96;10.08.2017;2017;08;11;Torstai;43;64;107;1;4;5
96;10.08.2017;2017;08;12;Torstai;48;70;118;2;7;9
96;10.08.2017;2017;08;13;Torstai;52;41;93;4;4;8
96;10.08.2017;2017;08;14;Torstai;57;85;142;7;18;25
96;10.08.2017;2017;08;15;Torstai;78;157;235;3;15;18
96;10.08.2017;2017;08;16;Torstai;78;87;165;2;7;9
96;10.08.2017;2017;08;17;Torstai;51;72;123;11;8;19
96;10.08.2017;2017;08;18;Torstai;44;47;91;7;14;21
96;10.08.2017;2017;08;19;Torstai;46;38;84;8;10;18
96;10.08.2017;2017;08;20;Torstai;40;30;70;10;7;17
96;10.08.2017;2017;08;21;Torstai;26;24;50;4;10;14
96;10.08.2017;2017;08;22;Torstai;16;13;29;2;2;4
96;10.08.2017;2017;08;23;Torstai;10;3;13;1;0;1
96;11.08.2017;2017;08;00;Perjantai;2;0;2;3;0;3
96;11.08.2017;2017;08;01;Perjantai;4;0;4;1;0;1
96;11.08.2017;2017;08;02;Perjantai;1;1;2;1;0;1
96;11.08.2017;2017;08;03;Perjantai;1;1;2;0;0;0
96;11.08.2017;2017;08;04;Perjantai;4;1;5;2;0;2
96;11.08.2017;2017;08;05;Perjantai;6;10;16;0;1;1
96;11.08.2017;2017;08;06;Perjantai;53;28;81;4;0;4
96;11.08.2017;2017;08;07;Perjantai;103;103;206;16;8;24
96;11.08.2017;2017;08;08;Perjantai;76;143;219;11;8;19
96;11.08.2017;2017;08;09;Perjantai;74;82;156;8;10;18
96;11.08.2017;2017;08;10;Perjantai;80;66;146;2;6;8
96;11.08.2017;2017;08;11;Perjantai;56;79;135;9;13;22
96;11.08.2017;2017;08;12;Perjantai;80;120;200;8;14;22
96;11.08.2017;2017;08;13;Perjantai;95;117;212;8;20;28
96;11.08.2017;2017;08;14;Perjantai;86;190;276;8;21;29
96;11.08.2017;2017;08;15;Perjantai;110;153;263;6;23;29
96;11.08.2017;2017;08;16;Perjantai;113;118;231;10;26;36
96;11.08.2017;2017;08;17;Perjantai;86;124;210;16;30;46
96;11.08.2017;2017;08;18;Perjantai;67;97;164;19;21;40
96;11.08.2017;2017;08;19;Perjantai;71;64;135;16;26;42
96;11.08.2017;2017;08;20;Perjantai;58;63;121;22;21;43
96;11.08.2017;2017;08;21;Perjantai;72;44;116;32;27;59
96;11.08.2017;2017;08;22;Perjantai;33;26;59;26;25;51
96;11.08.2017;2017;08;23;Perjantai;24;18;42;23;29;52
96;12.08.2017;2017;08;00;Lauantai;39;11;50;21;10;31
96;12.08.2017;2017;08;01;Lauantai;24;4;28;6;5;11
96;12.08.2017;2017;08;02;Lauantai;27;3;30;3;1;4
96;12.08.2017;2017;08;03;Lauantai;17;0;17;3;0;3
96;12.08.2017;2017;08;04;Lauantai;9;5;14;4;0;4
96;12.08.2017;2017;08;05;Lauantai;7;4;11;3;1;4
96;12.08.2017;2017;08;06;Lauantai;37;13;50;1;0;1
96;12.08.2017;2017;08;07;Lauantai;11;21;32;0;1;1
96;12.08.2017;2017;08;08;Lauantai;7;19;26;3;4;7
96;12.08.2017;2017;08;09;Lauantai;17;40;57;4;8;12
96;12.08.2017;2017;08;10;Lauantai;32;51;83;10;4;14
96;12.08.2017;2017;08;11;Lauantai;52;85;137;9;17;26
96;12.08.2017;2017;08;12;Lauantai;59;80;139;9;13;22
96;12.08.2017;2017;08;13;Lauantai;91;99;190;14;18;32
96;12.08.2017;2017;08;14;Lauantai;79;119;198;14;21;35
96;12.08.2017;2017;08;15;Lauantai;86;88;174;17;25;42
96;12.08.2017;2017;08;16;Lauantai;74;70;144;18;15;33
96;12.08.2017;2017;08;17;Lauantai;92;73;165;35;37;72
96;12.08.2017;2017;08;18;Lauantai;82;80;162;44;38;82
96;12.08.2017;2017;08;19;Lauantai;57;62;119;22;20;42
96;12.08.2017;2017;08;20;Lauantai;52;65;117;36;44;80
96;12.08.2017;2017;08;21;Lauantai;53;58;111;28;38;66
96;12.08.2017;2017;08;22;Lauantai;20;21;41;35;34;69
96;12.08.2017;2017;08;23;Lauantai;34;22;56;20;15;35
96;13.08.2017;2017;08;00;Sunnuntai;39;15;54;13;4;17
96;13.08.2017;2017;08;01;Sunnuntai;13;9;22;5;2;7
96;13.08.2017;2017;08;02;Sunnuntai;26;1;27;2;1;3
96;13.08.2017;2017;08;03;Sunnuntai;20;1;21;0;1;1
96;13.08.2017;2017;08;04;Sunnuntai;23;1;24;3;0;3
96;13.08.2017;2017;08;05;Sunnuntai;7;2;9;0;0;0
96;13.08.2017;2017;08;06;Sunnuntai;29;5;34;3;4;7
96;13.08.2017;2017;08;07;Sunnuntai;7;8;15;1;1;2
96;13.08.2017;2017;08;08;Sunnuntai;11;8;19;2;6;8
96;13.08.2017;2017;08;09;Sunnuntai;12;9;21;3;6;9
96;13.08.2017;2017;08;10;Sunnuntai;11;18;29;3;2;5
96;13.08.2017;2017;08;11;Sunnuntai;24;29;53;6;5;11
96;13.08.2017;2017;08;12;Sunnuntai;19;21;40;5;2;7
96;13.08.2017;2017;08;13;Sunnuntai;32;20;52;4;3;7
96;13.08.2017;2017;08;14;Sunnuntai;27;23;50;3;7;10
96;13.08.2017;2017;08;15;Sunnuntai;22;33;55;13;6;19
96;13.08.2017;2017;08;16;Sunnuntai;32;21;53;22;8;30
96;13.08.2017;2017;08;17;Sunnuntai;31;20;51;4;9;13
96;13.08.2017;2017;08;18;Sunnuntai;33;19;52;12;12;24
96;13.08.2017;2017;08;19;Sunnuntai;21;26;47;12;14;26
96;13.08.2017;2017;08;20;Sunnuntai;28;26;54;4;11;15
96;13.08.2017;2017;08;21;Sunnuntai;16;31;47;10;8;18
96;13.08.2017;2017;08;22;Sunnuntai;6;7;13;4;2;6
96;13.08.2017;2017;08;23;Sunnuntai;6;3;9;1;2;3
96;14.08.2017;2017;08;00;Maanantai;0;0;0;0;0;0
96;14.08.2017;2017;08;01;Maanantai;3;0;3;0;0;0
96;14.08.2017;2017;08;02;Maanantai;2;0;2;0;1;1
96;14.08.2017;2017;08;03;Maanantai;4;0;4;1;0;1
96;14.08.2017;2017;08;04;Maanantai;1;2;3;0;0;0
96;14.08.2017;2017;08;05;Maanantai;6;7;13;2;0;2
96;14.08.2017;2017;08;06;Maanantai;53;35;88;10;2;12
96;14.08.2017;2017;08;07;Maanantai;157;133;290;18;8;26
96;14.08.2017;2017;08;08;Maanantai;150;163;313;15;9;24
96;14.08.2017;2017;08;09;Maanantai;90;84;174;5;13;18
96;14.08.2017;2017;08;10;Maanantai;56;63;119;3;6;9
96;14.08.2017;2017;08;11;Maanantai;66;76;142;9;10;19
96;14.08.2017;2017;08;12;Maanantai;87;91;178;13;13;26
96;14.08.2017;2017;08;13;Maanantai;74;82;156;9;14;23
96;14.08.2017;2017;08;14;Maanantai;88;156;244;6;23;29
96;14.08.2017;2017;08;15;Maanantai;116;247;363;18;35;53
96;14.08.2017;2017;08;16;Maanantai;158;222;380;14;34;48
96;14.08.2017;2017;08;17;Maanantai;103;104;207;13;26;39
96;14.08.2017;2017;08;18;Maanantai;93;72;165;17;11;28
96;14.08.2017;2017;08;19;Maanantai;77;45;122;12;11;23
96;14.08.2017;2017;08;20;Maanantai;68;46;114;10;15;25
96;14.08.2017;2017;08;21;Maanantai;25;37;62;10;4;14
96;14.08.2017;2017;08;22;Maanantai;14;7;21;3;6;9
96;14.08.2017;2017;08;23;Maanantai;6;4;10;2;0;2
96;15.08.2017;2017;08;00;Tiistai;3;4;7;0;0;0
96;15.08.2017;2017;08;01;Tiistai;2;0;2;0;0;0
96;15.08.2017;2017;08;02;Tiistai;2;0;2;0;0;0
96;15.08.2017;2017;08;03;Tiistai;1;0;1;1;0;1
96;15.08.2017;2017;08;04;Tiistai;1;0;1;0;0;0
96;15.08.2017;2017;08;05;Tiistai;5;10;15;1;2;3
96;15.08.2017;2017;08;06;Tiistai;54;37;91;4;0;4
96;15.08.2017;2017;08;07;Tiistai;184;130;314;15;6;21
96;15.08.2017;2017;08;08;Tiistai;169;139;308;15;8;23
96;15.08.2017;2017;08;09;Tiistai;115;94;209;7;6;13
96;15.08.2017;2017;08;10;Tiistai;61;73;134;6;6;12
96;15.08.2017;2017;08;11;Tiistai;79;93;172;13;7;20
96;15.08.2017;2017;08;12;Tiistai;96;104;200;11;18;29
96;15.08.2017;2017;08;13;Tiistai;88;90;178;5;20;25
96;15.08.2017;2017;08;14;Tiistai;106;165;271;10;12;22
96;15.08.2017;2017;08;15;Tiistai;117;292;409;6;34;40
96;15.08.2017;2017;08;16;Tiistai;185;214;399;12;20;32
96;15.08.2017;2017;08;17;Tiistai;113;77;190;8;4;12
96;15.08.2017;2017;08;18;Tiistai;98;68;166;13;7;20
96;15.08.2017;2017;08;19;Tiistai;97;50;147;10;11;21
96;15.08.2017;2017;08;20;Tiistai;64;52;116;9;12;21
96;15.08.2017;2017;08;21;Tiistai;49;44;93;7;5;12
96;15.08.2017;2017;08;22;Tiistai;12;9;21;4;2;6
96;15.08.2017;2017;08;23;Tiistai;11;3;14;1;2;3
96;16.08.2017;2017;08;00;Keskiviikko;3;2;5;0;0;0
96;16.08.2017;2017;08;01;Keskiviikko;2;0;2;2;0;2
96;16.08.2017;2017;08;02;Keskiviikko;3;0;3;0;0;0
96;16.08.2017;2017;08;03;Keskiviikko;2;1;3;1;0;1
96;16.08.2017;2017;08;04;Keskiviikko;3;0;3;0;0;0
96;16.08.2017;2017;08;05;Keskiviikko;4;9;13;0;1;1
96;16.08.2017;2017;08;06;Keskiviikko;52;35;87;6;0;6
96;16.08.2017;2017;08;07;Keskiviikko;156;163;319;14;3;17
96;16.08.2017;2017;08;08;Keskiviikko;163;154;317;14;8;22
96;16.08.2017;2017;08;09;Keskiviikko;87;80;167;11;8;19
96;16.08.2017;2017;08;10;Keskiviikko;57;60;117;8;12;20
96;16.08.2017;2017;08;11;Keskiviikko;78;96;174;6;9;15
96;16.08.2017;2017;08;12;Keskiviikko;88;85;173;9;11;20
96;16.08.2017;2017;08;13;Keskiviikko;97;126;223;10;20;30
96;16.08.2017;2017;08;14;Keskiviikko;113;179;292;3;20;23
96;16.08.2017;2017;08;15;Keskiviikko;115;243;358;5;32;37
96;16.08.2017;2017;08;16;Keskiviikko;183;220;403;22;30;52
96;16.08.2017;2017;08;17;Keskiviikko;110;86;196;11;15;26
96;16.08.2017;2017;08;18;Keskiviikko;128;72;200;26;11;37
96;16.08.2017;2017;08;19;Keskiviikko;88;60;148;10;7;17
96;16.08.2017;2017;08;20;Keskiviikko;72;64;136;10;23;33
96;16.08.2017;2017;08;21;Keskiviikko;47;46;93;2;10;12
96;16.08.2017;2017;08;22;Keskiviikko;14;15;29;6;0;6
96;16.08.2017;2017;08;23;Keskiviikko;11;5;16;0;0;0
96;17.08.2017;2017;08;00;Torstai;2;0;2;0;0;0
96;17.08.2017;2017;08;01;Torstai;1;1;2;1;1;2
96;17.08.2017;2017;08;02;Torstai;5;1;6;2;1;3
96;17.08.2017;2017;08;03;Torstai;0;0;0;1;0;1
96;17.08.2017;2017;08;04;Torstai;3;4;7;0;0;0
96;17.08.2017;2017;08;05;Torstai;5;10;15;0;0;0
96;17.08.2017;2017;08;06;Torstai;56;36;92;5;3;8
96;17.08.2017;2017;08;07;Torstai;166;154;320;23;3;26
96;17.08.2017;2017;08;08;Torstai;132;142;274;3;3;6
96;17.08.2017;2017;08;09;Torstai;132;95;227;11;15;26
96;17.08.2017;2017;08;10;Torstai;71;63;134;8;3;11
96;17.08.2017;2017;08;11;Torstai;81;87;168;11;15;26
96;17.08.2017;2017;08;12;Torstai;94;106;200;7;13;20
96;17.08.2017;2017;08;13;Torstai;105;96;201;7;10;17
96;17.08.2017;2017;08;14;Torstai;103;177;280;8;27;35
96;17.08.2017;2017;08;15;Torstai;119;262;381;8;23;31
96;17.08.2017;2017;08;16;Torstai;168;229;397;9;32;41
96;17.08.2017;2017;08;17;Torstai;103;158;261;5;25;30
96;17.08.2017;2017;08;18;Torstai;72;96;168;9;15;24
96;17.08.2017;2017;08;19;Torstai;122;73;195;13;18;31
96;17.08.2017;2017;08;20;Torstai;89;42;131;3;5;8
96;17.08.2017;2017;08;21;Torstai;75;38;113;8;2;10
96;17.08.2017;2017;08;22;Torstai;37;11;48;3;0;3
96;17.08.2017;2017;08;23;Torstai;39;5;44;3;2;5
96;18.08.2017;2017;08;00;Perjantai;26;5;31;1;0;1
96;18.08.2017;2017;08;01;Perjantai;18;3;21;2;0;2
96;18.08.2017;2017;08;02;Perjantai;23;1;24;2;0;2
96;18.08.2017;2017;08;03;Perjantai;15;3;18;0;0;0
96;18.08.2017;2017;08;04;Perjantai;8;2;10;3;0;3
96;18.08.2017;2017;08;05;Perjantai;5;8;13;0;1;1
96;18.08.2017;2017;08;06;Perjantai;53;38;91;7;2;9
96;18.08.2017;2017;08;07;Perjantai;140;127;267;17;8;25
96;18.08.2017;2017;08;08;Perjantai;105;135;240;10;6;16
96;18.08.2017;2017;08;09;Perjantai;87;87;174;9;12;21
96;18.08.2017;2017;08;10;Perjantai;79;48;127;10;12;22
96;18.08.2017;2017;08;11;Perjantai;57;89;146;4;16;20
96;18.08.2017;2017;08;12;Perjantai;68;102;170;1;18;19
96;18.08.2017;2017;08;13;Perjantai;83;155;238;8;14;22
96;18.08.2017;2017;08;14;Perjantai;110;187;297;15;22;37
96;18.08.2017;2017;08;15;Perjantai;106;178;284;6;25;31
96;18.08.2017;2017;08;16;Perjantai;104;86;190;16;15;31
96;18.08.2017;2017;08;17;Perjantai;72;66;138;10;9;19
96;18.08.2017;2017;08;18;Perjantai;48;60;108;3;9;12
96;18.08.2017;2017;08;19;Perjantai;25;32;57;3;3;6
96;18.08.2017;2017;08;20;Perjantai;56;26;82;4;0;4
96;18.08.2017;2017;08;21;Perjantai;38;20;58;4;2;6
96;18.08.2017;2017;08;22;Perjantai;18;10;28;2;3;5
96;18.08.2017;2017;08;23;Perjantai;13;14;27;1;1;2
96;19.08.2017;2017;08;00;Lauantai;8;6;14;4;1;5
96;19.08.2017;2017;08;01;Lauantai;2;3;5;0;0;0
96;19.08.2017;2017;08;02;Lauantai;5;0;5;2;0;2
96;19.08.2017;2017;08;03;Lauantai;5;1;6;1;0;1
96;19.08.2017;2017;08;04;Lauantai;11;2;13;0;0;0
96;19.08.2017;2017;08;05;Lauantai;1;1;2;3;0;3
96;19.08.2017;2017;08;06;Lauantai;25;9;34;3;0;3
96;19.08.2017;2017;08;07;Lauantai;6;14;20;1;1;2
96;19.08.2017;2017;08;08;Lauantai;7;16;23;3;2;5
96;19.08.2017;2017;08;09;Lauantai;12;30;42;2;5;7
96;19.08.2017;2017;08;10;Lauantai;15;58;73;6;5;11
96;19.08.2017;2017;08;11;Lauantai;38;44;82;7;6;13
96;19.08.2017;2017;08;12;Lauantai;53;67;120;7;19;26
96;19.08.2017;2017;08;13;Lauantai;64;84;148;9;14;23
96;19.08.2017;2017;08;14;Lauantai;60;61;121;8;13;21
96;19.08.2017;2017;08;15;Lauantai;72;64;136;5;8;13
96;19.08.2017;2017;08;16;Lauantai;53;66;119;9;4;13
96;19.08.2017;2017;08;17;Lauantai;53;30;83;9;5;14
96;19.08.2017;2017;08;18;Lauantai;51;39;90;18;9;27
96;19.08.2017;2017;08;19;Lauantai;34;14;48;5;4;9
96;19.08.2017;2017;08;20;Lauantai;33;20;53;6;5;11
96;19.08.2017;2017;08;21;Lauantai;14;20;34;4;4;8
96;19.08.2017;2017;08;22;Lauantai;6;5;11;2;1;3
96;19.08.2017;2017;08;23;Lauantai;3;5;8;2;2;4
96;20.08.2017;2017;08;00;Sunnuntai;7;6;13;2;1;3
96;20.08.2017;2017;08;01;Sunnuntai;8;2;10;3;0;3
96;20.08.2017;2017;08;02;Sunnuntai;5;0;5;0;0;0
96;20.08.2017;2017;08;03;Sunnuntai;12;3;15;3;0;3
96;20.08.2017;2017;08;04;Sunnuntai;11;3;14;4;0;4
96;20.08.2017;2017;08;05;Sunnuntai;3;2;5;1;1;2
96;20.08.2017;2017;08;06;Sunnuntai;13;1;14;3;0;3
96;20.08.2017;2017;08;07;Sunnuntai;5;12;17;0;2;2
96;20.08.2017;2017;08;08;Sunnuntai;6;4;10;3;3;6
96;20.08.2017;2017;08;09;Sunnuntai;7;23;30;7;5;12
96;20.08.2017;2017;08;10;Sunnuntai;14;34;48;4;10;14
96;20.08.2017;2017;08;11;Sunnuntai;26;40;66;9;7;16
96;20.08.2017;2017;08;12;Sunnuntai;34;46;80;4;4;8
96;20.08.2017;2017;08;13;Sunnuntai;39;56;95;5;5;10
96;20.08.2017;2017;08;14;Sunnuntai;42;41;83;4;4;8
96;20.08.2017;2017;08;15;Sunnuntai;38;47;85;6;10;16
96;20.08.2017;2017;08;16;Sunnuntai;44;31;75;15;14;29
96;20.08.2017;2017;08;17;Sunnuntai;55;37;92;16;15;31
96;20.08.2017;2017;08;18;Sunnuntai;70;29;99;11;15;26
96;20.08.2017;2017;08;19;Sunnuntai;40;35;75;8;11;19
96;20.08.2017;2017;08;20;Sunnuntai;39;47;86;7;13;20
96;20.08.2017;2017;08;21;Sunnuntai;19;29;48;4;2;6
96;20.08.2017;2017;08;22;Sunnuntai;5;6;11;2;3;5
96;20.08.2017;2017;08;23;Sunnuntai;5;3;8;1;2;3
96;21.08.2017;2017;08;00;Maanantai;1;1;2;3;0;3
96;21.08.2017;2017;08;01;Maanantai;3;1;4;2;0;2
96;21.08.2017;2017;08;02;Maanantai;2;2;4;1;0;1
96;21.08.2017;2017;08;03;Maanantai;2;0;2;0;0;0
96;21.08.2017;2017;08;04;Maanantai;1;3;4;1;0;1
96;21.08.2017;2017;08;05;Maanantai;5;12;17;0;0;0
96;21.08.2017;2017;08;06;Maanantai;50;37;87;4;0;4
96;21.08.2017;2017;08;07;Maanantai;177;138;315;20;9;29
96;21.08.2017;2017;08;08;Maanantai;163;154;317;14;3;17
96;21.08.2017;2017;08;09;Maanantai;124;100;224;20;9;29
96;21.08.2017;2017;08;10;Maanantai;70;64;134;2;7;9
96;21.08.2017;2017;08;11;Maanantai;64;71;135;8;3;11
96;21.08.2017;2017;08;12;Maanantai;90;87;177;7;11;18
96;21.08.2017;2017;08;13;Maanantai;79;95;174;8;10;18
96;21.08.2017;2017;08;14;Maanantai;104;163;267;7;18;25
96;21.08.2017;2017;08;15;Maanantai;115;272;387;6;46;52
96;21.08.2017;2017;08;16;Maanantai;166;222;388;15;22;37
96;21.08.2017;2017;08;17;Maanantai;108;81;189;12;8;20
96;21.08.2017;2017;08;18;Maanantai;77;60;137;16;12;28
96;21.08.2017;2017;08;19;Maanantai;74;42;116;13;13;26
96;21.08.2017;2017;08;20;Maanantai;64;31;95;11;8;19
96;21.08.2017;2017;08;21;Maanantai;31;43;74;5;10;15
96;21.08.2017;2017;08;22;Maanantai;7;7;14;0;0;0
96;21.08.2017;2017;08;23;Maanantai;6;5;11;1;0;1
96;22.08.2017;2017;08;00;Tiistai;3;1;4;0;0;0
96;22.08.2017;2017;08;01;Tiistai;0;0;0;0;0;0
96;22.08.2017;2017;08;02;Tiistai;0;0;0;0;1;1
96;22.08.2017;2017;08;03;Tiistai;1;0;1;2;0;2
96;22.08.2017;2017;08;04;Tiistai;2;0;2;1;0;1
96;22.08.2017;2017;08;05;Tiistai;3;10;13;0;0;0
96;22.08.2017;2017;08;06;Tiistai;55;36;91;4;2;6
96;22.08.2017;2017;08;07;Tiistai;197;155;352;22;7;29
96;22.08.2017;2017;08;08;Tiistai;180;123;303;18;7;25
96;22.08.2017;2017;08;09;Tiistai;108;100;208;17;3;20
96;22.08.2017;2017;08;10;Tiistai;52;79;131;7;10;17
96;22.08.2017;2017;08;11;Tiistai;106;82;188;13;6;19
96;22.08.2017;2017;08;12;Tiistai;106;103;209;8;10;18
96;22.08.2017;2017;08;13;Tiistai;71;104;175;10;17;27
96;22.08.2017;2017;08;14;Tiistai;94;159;253;9;16;25
96;22.08.2017;2017;08;15;Tiistai;108;305;413;8;32;40
96;22.08.2017;2017;08;16;Tiistai;161;176;337;8;23;31
96;22.08.2017;2017;08;17;Tiistai;79;90;169;11;16;27
96;22.08.2017;2017;08;18;Tiistai;105;73;178;13;10;23
96;22.08.2017;2017;08;19;Tiistai;48;45;93;15;11;26
96;22.08.2017;2017;08;20;Tiistai;61;31;92;10;11;21
96;22.08.2017;2017;08;21;Tiistai;26;36;62;2;7;9
96;22.08.2017;2017;08;22;Tiistai;11;11;22;2;1;3
96;22.08.2017;2017;08;23;Tiistai;4;1;5;0;1;1
96;23.08.2017;2017;08;00;Keskiviikko;1;3;4;0;0;0
96;23.08.2017;2017;08;01;Keskiviikko;3;0;3;1;0;1
96;23.08.2017;2017;08;02;Keskiviikko;4;0;4;0;0;0
96;23.08.2017;2017;08;03;Keskiviikko;0;1;1;0;0;0
96;23.08.2017;2017;08;04;Keskiviikko;5;1;6;0;0;0
96;23.08.2017;2017;08;05;Keskiviikko;6;12;18;1;1;2
96;23.08.2017;2017;08;06;Keskiviikko;65;40;105;5;0;5
96;23.08.2017;2017;08;07;Keskiviikko;179;138;317;15;6;21
96;23.08.2017;2017;08;08;Keskiviikko;186;164;350;9;6;15
96;23.08.2017;2017;08;09;Keskiviikko;115;96;211;14;8;22
96;23.08.2017;2017;08;10;Keskiviikko;56;54;110;8;4;12
96;23.08.2017;2017;08;11;Keskiviikko;98;92;190;15;8;23
96;23.08.2017;2017;08;12;Keskiviikko;83;111;194;7;18;25
96;23.08.2017;2017;08;13;Keskiviikko;84;90;174;8;16;24
96;23.08.2017;2017;08;14;Keskiviikko;99;188;287;11;31;42
96;23.08.2017;2017;08;15;Keskiviikko;103;256;359;6;22;28
96;23.08.2017;2017;08;16;Keskiviikko;134;215;349;9;24;33
96;23.08.2017;2017;08;17;Keskiviikko;92;94;186;10;13;23
96;23.08.2017;2017;08;18;Keskiviikko;109;84;193;24;18;42
96;23.08.2017;2017;08;19;Keskiviikko;72;52;124;10;13;23
96;23.08.2017;2017;08;20;Keskiviikko;49;59;108;12;11;23
96;23.08.2017;2017;08;21;Keskiviikko;45;49;94;2;8;10
96;23.08.2017;2017;08;22;Keskiviikko;19;12;31;5;2;7
96;23.08.2017;2017;08;23;Keskiviikko;5;4;9;3;0;3
96;24.08.2017;2017;08;00;Torstai;8;1;9;0;0;0
96;24.08.2017;2017;08;01;Torstai;4;0;4;0;0;0
96;24.08.2017;2017;08;02;Torstai;3;2;5;0;0;0
96;24.08.2017;2017;08;03;Torstai;4;2;6;0;0;0
96;24.08.2017;2017;08;04;Torstai;1;2;3;1;0;1
96;24.08.2017;2017;08;05;Torstai;7;9;16;0;0;0
96;24.08.2017;2017;08;06;Torstai;50;30;80;2;0;2
96;24.08.2017;2017;08;07;Torstai;171;147;318;14;5;19
96;24.08.2017;2017;08;08;Torstai;176;150;326;11;4;15
96;24.08.2017;2017;08;09;Torstai;102;100;202;15;7;22
96;24.08.2017;2017;08;10;Torstai;73;82;155;8;7;15
96;24.08.2017;2017;08;11;Torstai;123;74;197;12;15;27
96;24.08.2017;2017;08;12;Torstai;94;121;215;10;13;23
96;24.08.2017;2017;08;13;Torstai;94;100;194;11;23;34
96;24.08.2017;2017;08;14;Torstai;91;182;273;14;23;37
96;24.08.2017;2017;08;15;Torstai;116;282;398;4;26;30
96;24.08.2017;2017;08;16;Torstai;169;194;363;10;18;28
96;24.08.2017;2017;08;17;Torstai;92;123;215;9;9;18
96;24.08.2017;2017;08;18;Torstai;70;68;138;10;4;14
96;24.08.2017;2017;08;19;Torstai;84;34;118;10;13;23
96;24.08.2017;2017;08;20;Torstai;64;41;105;6;10;16
96;24.08.2017;2017;08;21;Torstai;34;30;64;2;5;7
96;24.08.2017;2017;08;22;Torstai;3;20;23;1;1;2
96;24.08.2017;2017;08;23;Torstai;11;2;13;0;1;1
96;25.08.2017;2017;08;00;Perjantai;7;2;9;1;0;1
96;25.08.2017;2017;08;01;Perjantai;4;2;6;0;0;0
96;25.08.2017;2017;08;02;Perjantai;1;0;1;0;0;0
96;25.08.2017;2017;08;03;Perjantai;3;1;4;0;0;0
96;25.08.2017;2017;08;04;Perjantai;3;1;4;1;0;1
96;25.08.2017;2017;08;05;Perjantai;4;11;15;1;0;1
96;25.08.2017;2017;08;06;Perjantai;58;30;88;2;0;2
96;25.08.2017;2017;08;07;Perjantai;119;86;205;22;2;24
96;25.08.2017;2017;08;08;Perjantai;128;81;209;18;7;25
96;25.08.2017;2017;08;09;Perjantai;62;50;112;7;5;12
96;25.08.2017;2017;08;10;Perjantai;55;55;110;6;9;15
96;25.08.2017;2017;08;11;Perjantai;38;62;100;1;8;9
96;25.08.2017;2017;08;12;Perjantai;56;55;111;5;7;12
96;25.08.2017;2017;08;13;Perjantai;54;82;136;3;14;17
96;25.08.2017;2017;08;14;Perjantai;55;161;216;3;23;26
96;25.08.2017;2017;08;15;Perjantai;77;144;221;4;28;32
96;25.08.2017;2017;08;16;Perjantai;65;71;136;4;7;11
96;25.08.2017;2017;08;17;Perjantai;34;63;97;0;7;7
96;25.08.2017;2017;08;18;Perjantai;31;33;64;6;7;13
96;25.08.2017;2017;08;19;Perjantai;33;25;58;8;5;13
96;25.08.2017;2017;08;20;Perjantai;25;13;38;4;2;6
96;25.08.2017;2017;08;21;Perjantai;14;25;39;3;5;8
96;25.08.2017;2017;08;22;Perjantai;10;12;22;1;0;1
96;25.08.2017;2017;08;23;Perjantai;4;7;11;4;0;4
96;26.08.2017;2017;08;00;Lauantai;14;6;20;0;1;1
96;26.08.2017;2017;08;01;Lauantai;9;3;12;1;0;1
96;26.08.2017;2017;08;02;Lauantai;10;0;10;2;1;3
96;26.08.2017;2017;08;03;Lauantai;13;0;13;1;0;1
96;26.08.2017;2017;08;04;Lauantai;7;2;9;1;0;1
96;26.08.2017;2017;08;05;Lauantai;5;0;5;4;0;4
96;26.08.2017;2017;08;06;Lauantai;13;9;22;2;0;2
96;26.08.2017;2017;08;07;Lauantai;5;8;13;0;1;1
96;26.08.2017;2017;08;08;Lauantai;4;9;13;1;2;3
96;26.08.2017;2017;08;09;Lauantai;10;29;39;3;3;6
96;26.08.2017;2017;08;10;Lauantai;14;32;46;6;4;10
96;26.08.2017;2017;08;11;Lauantai;20;60;80;9;9;18
96;26.08.2017;2017;08;12;Lauantai;46;39;85;9;4;13
96;26.08.2017;2017;08;13;Lauantai;43;56;99;9;6;15
96;26.08.2017;2017;08;14;Lauantai;49;60;109;8;8;16
96;26.08.2017;2017;08;15;Lauantai;39;34;73;6;8;14
96;26.08.2017;2017;08;16;Lauantai;45;50;95;11;8;19
96;26.08.2017;2017;08;17;Lauantai;52;60;112;7;6;13
96;26.08.2017;2017;08;18;Lauantai;53;35;88;13;2;15
96;26.08.2017;2017;08;19;Lauantai;47;21;68;11;5;16
96;26.08.2017;2017;08;20;Lauantai;31;40;71;3;8;11
96;26.08.2017;2017;08;21;Lauantai;21;46;67;1;6;7
96;26.08.2017;2017;08;22;Lauantai;15;8;23;5;2;7
96;26.08.2017;2017;08;23;Lauantai;15;5;20;0;0;0
96;27.08.2017;2017;08;00;Sunnuntai;16;12;28;4;1;5
96;27.08.2017;2017;08;01;Sunnuntai;17;5;22;1;0;1
96;27.08.2017;2017;08;02;Sunnuntai;12;4;16;6;1;7
96;27.08.2017;2017;08;03;Sunnuntai;12;1;13;2;2;4
96;27.08.2017;2017;08;04;Sunnuntai;17;2;19;8;0;8
96;27.08.2017;2017;08;05;Sunnuntai;10;0;10;1;0;1
96;27.08.2017;2017;08;06;Sunnuntai;17;8;25;1;1;2
96;27.08.2017;2017;08;07;Sunnuntai;3;9;12;0;1;1
96;27.08.2017;2017;08;08;Sunnuntai;6;9;15;1;1;2
96;27.08.2017;2017;08;09;Sunnuntai;4;14;18;6;5;11
96;27.08.2017;2017;08;10;Sunnuntai;18;21;39;7;8;15
96;27.08.2017;2017;08;11;Sunnuntai;27;34;61;8;12;20
96;27.08.2017;2017;08;12;Sunnuntai;37;56;93;6;6;12
96;27.08.2017;2017;08;13;Sunnuntai;34;43;77;5;9;14
96;27.08.2017;2017;08;14;Sunnuntai;46;70;116;8;10;18
96;27.08.2017;2017;08;15;Sunnuntai;54;41;95;11;5;16
96;27.08.2017;2017;08;16;Sunnuntai;83;37;120;32;20;52
96;27.08.2017;2017;08;17;Sunnuntai;45;28;73;9;19;28
96;27.08.2017;2017;08;18;Sunnuntai;32;49;81;13;16;29
96;27.08.2017;2017;08;19;Sunnuntai;40;40;80;11;12;23
96;27.08.2017;2017;08;20;Sunnuntai;27;27;54;2;14;16
96;27.08.2017;2017;08;21;Sunnuntai;24;21;45;9;5;14
96;27.08.2017;2017;08;22;Sunnuntai;9;9;18;4;2;6
96;27.08.2017;2017;08;23;Sunnuntai;4;7;11;0;1;1
96;28.08.2017;2017;08;00;Maanantai;4;1;5;2;0;2
96;28.08.2017;2017;08;01;Maanantai;0;2;2;0;0;0
96;28.08.2017;2017;08;02;Maanantai;0;0;0;0;0;0
96;28.08.2017;2017;08;03;Maanantai;2;0;2;1;0;1
96;28.08.2017;2017;08;04;Maanantai;2;0;2;0;0;0
96;28.08.2017;2017;08;05;Maanantai;1;15;16;0;0;0
96;28.08.2017;2017;08;06;Maanantai;57;33;90;5;1;6
96;28.08.2017;2017;08;07;Maanantai;150;188;338;22;7;29
96;28.08.2017;2017;08;08;Maanantai;155;185;340;16;9;25
96;28.08.2017;2017;08;09;Maanantai;189;113;302;25;29;54
96;28.08.2017;2017;08;10;Maanantai;113;99;212;15;23;38
96;28.08.2017;2017;08;11;Maanantai;129;122;251;18;22;40
96;28.08.2017;2017;08;12;Maanantai;138;142;280;11;9;20
96;28.08.2017;2017;08;13;Maanantai;94;147;241;4;12;16
96;28.08.2017;2017;08;14;Maanantai;129;152;281;9;17;26
96;28.08.2017;2017;08;15;Maanantai;110;277;387;6;35;41
96;28.08.2017;2017;08;16;Maanantai;166;205;371;8;22;30
96;28.08.2017;2017;08;17;Maanantai;108;94;202;8;10;18
96;28.08.2017;2017;08;18;Maanantai;67;65;132;17;14;31
96;28.08.2017;2017;08;19;Maanantai;67;44;111;4;10;14
96;28.08.2017;2017;08;20;Maanantai;66;24;90;10;10;20
96;28.08.2017;2017;08;21;Maanantai;34;34;68;6;1;7
96;28.08.2017;2017;08;22;Maanantai;10;9;19;3;3;6
96;28.08.2017;2017;08;23;Maanantai;7;0;7;1;0;1
96;29.08.2017;2017;08;00;Tiistai;1;1;2;0;0;0
96;29.08.2017;2017;08;01;Tiistai;1;0;1;1;0;1
96;29.08.2017;2017;08;02;Tiistai;1;0;1;0;0;0
96;29.08.2017;2017;08;03;Tiistai;2;0;2;0;0;0
96;29.08.2017;2017;08;04;Tiistai;1;0;1;1;0;1
96;29.08.2017;2017;08;05;Tiistai;3;13;16;1;1;2
96;29.08.2017;2017;08;06;Tiistai;53;31;84;6;1;7
96;29.08.2017;2017;08;07;Tiistai;183;191;374;22;7;29
96;29.08.2017;2017;08;08;Tiistai;188;170;358;13;1;14
96;29.08.2017;2017;08;09;Tiistai;187;123;310;18;34;52
96;29.08.2017;2017;08;10;Tiistai;103;124;227;16;14;30
96;29.08.2017;2017;08;11;Tiistai;127;160;287;30;38;68
96;29.08.2017;2017;08;12;Tiistai;110;196;306;16;22;38
96;29.08.2017;2017;08;13;Tiistai;80;100;180;7;8;15
96;29.08.2017;2017;08;14;Tiistai;85;166;251;6;17;23
96;29.08.2017;2017;08;15;Tiistai;95;226;321;6;24;30
96;29.08.2017;2017;08;16;Tiistai;120;144;264;5;14;19
96;29.08.2017;2017;08;17;Tiistai;52;71;123;8;5;13
96;29.08.2017;2017;08;18;Tiistai;41;42;83;2;8;10
96;29.08.2017;2017;08;19;Tiistai;35;26;61;6;4;10
96;29.08.2017;2017;08;20;Tiistai;37;25;62;9;0;9
96;29.08.2017;2017;08;21;Tiistai;18;31;49;2;12;14
96;29.08.2017;2017;08;22;Tiistai;6;15;21;4;2;6
96;29.08.2017;2017;08;23;Tiistai;13;3;16;0;0;0
96;30.08.2017;2017;08;00;Keskiviikko;7;1;8;0;0;0
96;30.08.2017;2017;08;01;Keskiviikko;7;2;9;2;0;2
96;30.08.2017;2017;08;02;Keskiviikko;13;1;14;0;0;0
96;30.08.2017;2017;08;03;Keskiviikko;14;0;14;1;0;1
96;30.08.2017;2017;08;04;Keskiviikko;11;2;13;1;0;1
96;30.08.2017;2017;08;05;Keskiviikko;11;5;16;0;0;0
96;30.08.2017;2017;08;06;Keskiviikko;35;24;59;3;0;3
96;30.08.2017;2017;08;07;Keskiviikko;102;158;260;17;11;28
96;30.08.2017;2017;08;08;Keskiviikko;141;130;271;17;8;25
96;30.08.2017;2017;08;09;Keskiviikko;153;80;233;21;31;52
96;30.08.2017;2017;08;10;Keskiviikko;74;60;134;10;10;20
96;30.08.2017;2017;08;11;Keskiviikko;95;84;179;19;14;33
96;30.08.2017;2017;08;12;Keskiviikko;80;114;194;8;11;19
96;30.08.2017;2017;08;13;Keskiviikko;81;56;137;9;8;17
96;30.08.2017;2017;08;14;Keskiviikko;88;164;252;8;27;35
96;30.08.2017;2017;08;15;Keskiviikko;82;183;265;8;29;37
96;30.08.2017;2017;08;16;Keskiviikko;108;195;303;15;31;46
96;30.08.2017;2017;08;17;Keskiviikko;72;93;165;12;15;27
96;30.08.2017;2017;08;18;Keskiviikko;83;72;155;16;15;31
96;30.08.2017;2017;08;19;Keskiviikko;89;39;128;16;13;29
96;30.08.2017;2017;08;20;Keskiviikko;65;54;119;6;15;21
96;30.08.2017;2017;08;21;Keskiviikko;27;47;74;6;10;16
96;30.08.2017;2017;08;22;Keskiviikko;10;10;20;2;2;4
96;30.08.2017;2017;08;23;Keskiviikko;1;1;2;3;2;5
96;31.08.2017;2017;08;00;Torstai;2;2;4;1;1;2
96;31.08.2017;2017;08;01;Torstai;2;5;7;1;0;1
96;31.08.2017;2017;08;02;Torstai;1;0;1;0;0;0
96;31.08.2017;2017;08;03;Torstai;2;0;2;0;0;0
96;31.08.2017;2017;08;04;Torstai;2;1;3;0;0;0
96;31.08.2017;2017;08;05;Torstai;3;9;12;3;0;3
96;31.08.2017;2017;08;06;Torstai;54;40;94;6;1;7
96;31.08.2017;2017;08;07;Torstai;184;186;370;18;1;19
96;31.08.2017;2017;08;08;Torstai;159;186;345;25;10;35
96;31.08.2017;2017;08;09;Torstai;178;127;305;21;31;52
96;31.08.2017;2017;08;10;Torstai;112;114;226;14;17;31
96;31.08.2017;2017;08;11;Torstai;131;165;296;30;24;54
96;31.08.2017;2017;08;12;Torstai;139;152;291;14;15;29
96;31.08.2017;2017;08;13;Torstai;119;124;243;14;13;27
96;31.08.2017;2017;08;14;Torstai;118;197;315;8;24;32
96;31.08.2017;2017;08;15;Torstai;130;269;399;7;35;42
96;31.08.2017;2017;08;16;Torstai;154;222;376;13;24;37
96;31.08.2017;2017;08;17;Torstai;105;92;197;11;13;24
96;31.08.2017;2017;08;18;Torstai;79;81;160;9;6;15
96;31.08.2017;2017;08;19;Torstai;76;37;113;7;10;17
96;31.08.2017;2017;08;20;Torstai;82;40;122;11;6;17
96;31.08.2017;2017;08;21;Torstai;41;30;71;2;6;8
96;31.08.2017;2017;08;22;Torstai;16;22;38;0;0;0
96;31.08.2017;2017;08;23;Torstai;9;2;11;2;1;3
96;01.09.2017;2017;09;00;Perjantai;5;4;9;1;0;1
96;01.09.2017;2017;09;01;Perjantai;2;0;2;1;0;1
96;01.09.2017;2017;09;02;Perjantai;3;0;3;1;0;1
96;01.09.2017;2017;09;03;Perjantai;1;1;2;0;0;0
96;01.09.2017;2017;09;04;Perjantai;2;1;3;1;0;1
96;01.09.2017;2017;09;05;Perjantai;4;5;9;0;0;0
96;01.09.2017;2017;09;06;Perjantai;42;22;64;3;0;3
96;01.09.2017;2017;09;07;Perjantai;127;96;223;16;3;19
96;01.09.2017;2017;09;08;Perjantai;76;60;136;15;4;19
96;01.09.2017;2017;09;09;Perjantai;79;98;177;7;12;19
96;01.09.2017;2017;09;10;Perjantai;82;56;138;7;5;12
96;01.09.2017;2017;09;11;Perjantai;77;83;160;7;22;29
96;01.09.2017;2017;09;12;Perjantai;86;108;194;9;20;29
96;01.09.2017;2017;09;13;Perjantai;41;65;106;4;13;17
96;01.09.2017;2017;09;14;Perjantai;66;115;181;2;21;23
96;01.09.2017;2017;09;15;Perjantai;54;118;172;7;25;32
96;01.09.2017;2017;09;16;Perjantai;39;63;102;5;11;16
96;01.09.2017;2017;09;17;Perjantai;31;29;60;2;9;11
96;01.09.2017;2017;09;18;Perjantai;34;29;63;6;4;10
96;01.09.2017;2017;09;19;Perjantai;26;31;57;9;5;14
96;01.09.2017;2017;09;20;Perjantai;26;19;45;6;2;8
96;01.09.2017;2017;09;21;Perjantai;27;25;52;2;4;6
96;01.09.2017;2017;09;22;Perjantai;13;10;23;2;3;5
96;01.09.2017;2017;09;23;Perjantai;10;12;22;0;2;2
96;02.09.2017;2017;09;00;Lauantai;15;1;16;2;0;2
96;02.09.2017;2017;09;01;Lauantai;9;2;11;0;0;0
96;02.09.2017;2017;09;02;Lauantai;11;3;14;1;1;2
96;02.09.2017;2017;09;03;Lauantai;4;0;4;1;0;1
96;02.09.2017;2017;09;04;Lauantai;4;1;5;1;0;1
96;02.09.2017;2017;09;05;Lauantai;6;1;7;2;0;2
96;02.09.2017;2017;09;06;Lauantai;18;8;26;3;0;3
96;02.09.2017;2017;09;07;Lauantai;3;21;24;0;4;4
96;02.09.2017;2017;09;08;Lauantai;9;25;34;2;3;5
96;02.09.2017;2017;09;09;Lauantai;24;43;67;5;4;9
96;02.09.2017;2017;09;10;Lauantai;22;41;63;8;6;14
96;02.09.2017;2017;09;11;Lauantai;30;40;70;7;10;17
96;02.09.2017;2017;09;12;Lauantai;45;67;112;9;10;19
96;02.09.2017;2017;09;13;Lauantai;47;81;128;5;12;17
96;02.09.2017;2017;09;14;Lauantai;44;76;120;2;6;8
96;02.09.2017;2017;09;15;Lauantai;68;73;141;14;14;28
96;02.09.2017;2017;09;16;Lauantai;70;45;115;9;9;18
96;02.09.2017;2017;09;17;Lauantai;53;68;121;18;9;27
96;02.09.2017;2017;09;18;Lauantai;65;37;102;10;10;20
96;02.09.2017;2017;09;19;Lauantai;51;40;91;6;5;11
96;02.09.2017;2017;09;20;Lauantai;32;35;67;4;7;11
96;02.09.2017;2017;09;21;Lauantai;19;25;44;4;8;12
96;02.09.2017;2017;09;22;Lauantai;21;10;31;2;3;5
96;02.09.2017;2017;09;23;Lauantai;14;8;22;0;1;1
96;03.09.2017;2017;09;00;Sunnuntai;9;8;17;1;0;1
96;03.09.2017;2017;09;01;Sunnuntai;17;3;20;1;2;3
96;03.09.2017;2017;09;02;Sunnuntai;19;2;21;3;0;3
96;03.09.2017;2017;09;03;Sunnuntai;21;1;22;0;0;0
96;03.09.2017;2017;09;04;Sunnuntai;15;0;15;1;0;1
96;03.09.2017;2017;09;05;Sunnuntai;6;1;7;1;0;1
96;03.09.2017;2017;09;06;Sunnuntai;21;5;26;1;0;1
96;03.09.2017;2017;09;07;Sunnuntai;3;10;13;0;1;1
96;03.09.2017;2017;09;08;Sunnuntai;4;13;17;0;2;2
96;03.09.2017;2017;09;09;Sunnuntai;12;18;30;3;4;7
96;03.09.2017;2017;09;10;Sunnuntai;17;33;50;4;4;8
96;03.09.2017;2017;09;11;Sunnuntai;20;34;54;3;9;12
96;03.09.2017;2017;09;12;Sunnuntai;39;43;82;21;8;29
96;03.09.2017;2017;09;13;Sunnuntai;49;72;121;5;16;21
96;03.09.2017;2017;09;14;Sunnuntai;65;64;129;10;11;21
96;03.09.2017;2017;09;15;Sunnuntai;44;59;103;13;12;25
96;03.09.2017;2017;09;16;Sunnuntai;113;55;168;32;14;46
96;03.09.2017;2017;09;17;Sunnuntai;56;50;106;17;28;45
96;03.09.2017;2017;09;18;Sunnuntai;71;66;137;18;28;46
96;03.09.2017;2017;09;19;Sunnuntai;51;38;89;8;11;19
96;03.09.2017;2017;09;20;Sunnuntai;37;41;78;10;18;28
96;03.09.2017;2017;09;21;Sunnuntai;19;18;37;7;7;14
96;03.09.2017;2017;09;22;Sunnuntai;9;10;19;4;1;5
96;03.09.2017;2017;09;23;Sunnuntai;11;2;13;2;0;2
96;04.09.2017;2017;09;00;Maanantai;4;0;4;1;0;1
96;04.09.2017;2017;09;01;Maanantai;1;0;1;0;0;0
96;04.09.2017;2017;09;02;Maanantai;1;0;1;0;0;0
96;04.09.2017;2017;09;03;Maanantai;1;1;2;0;0;0
96;04.09.2017;2017;09;04;Maanantai;1;0;1;1;0;1
96;04.09.2017;2017;09;05;Maanantai;3;7;10;0;1;1
96;04.09.2017;2017;09;06;Maanantai;68;44;112;3;0;3
96;04.09.2017;2017;09;07;Maanantai;180;150;330;22;8;30
96;04.09.2017;2017;09;08;Maanantai;171;161;332;11;12;23
96;04.09.2017;2017;09;09;Maanantai;109;77;186;26;12;38
96;04.09.2017;2017;09;10;Maanantai;99;66;165;9;4;13
96;04.09.2017;2017;09;11;Maanantai;114;86;200;9;6;15
96;04.09.2017;2017;09;12;Maanantai;105;132;237;19;9;28
96;04.09.2017;2017;09;13;Maanantai;83;119;202;12;17;29
96;04.09.2017;2017;09;14;Maanantai;107;176;283;13;27;40
96;04.09.2017;2017;09;15;Maanantai;122;254;376;8;36;44
96;04.09.2017;2017;09;16;Maanantai;164;263;427;9;27;36
96;04.09.2017;2017;09;17;Maanantai;116;101;217;18;25;43
96;04.09.2017;2017;09;18;Maanantai;108;92;200;17;11;28
96;04.09.2017;2017;09;19;Maanantai;71;54;125;13;14;27
96;04.09.2017;2017;09;20;Maanantai;75;46;121;8;12;20
96;04.09.2017;2017;09;21;Maanantai;51;45;96;3;4;7
96;04.09.2017;2017;09;22;Maanantai;9;12;21;2;0;2
96;04.09.2017;2017;09;23;Maanantai;4;1;5;0;0;0
96;05.09.2017;2017;09;00;Tiistai;1;1;2;1;0;1
96;05.09.2017;2017;09;01;Tiistai;4;2;6;0;0;0
96;05.09.2017;2017;09;02;Tiistai;2;1;3;0;0;0
96;05.09.2017;2017;09;03;Tiistai;6;0;6;0;0;0
96;05.09.2017;2017;09;04;Tiistai;1;2;3;0;0;0
96;05.09.2017;2017;09;05;Tiistai;6;9;15;1;1;2
96;05.09.2017;2017;09;06;Tiistai;73;39;112;5;1;6
96;05.09.2017;2017;09;07;Tiistai;181;145;326;21;6;27
96;05.09.2017;2017;09;08;Tiistai;207;136;343;14;4;18
96;05.09.2017;2017;09;09;Tiistai;102;76;178;7;10;17
96;05.09.2017;2017;09;10;Tiistai;67;86;153;13;16;29
96;05.09.2017;2017;09;11;Tiistai;109;107;216;10;20;30
96;05.09.2017;2017;09;12;Tiistai;105;116;221;9;15;24
96;05.09.2017;2017;09;13;Tiistai;100;129;229;7;20;27
96;05.09.2017;2017;09;14;Tiistai;103;193;296;9;17;26
96;05.09.2017;2017;09;15;Tiistai;132;296;428;7;30;37
96;05.09.2017;2017;09;16;Tiistai;190;207;397;22;34;56
96;05.09.2017;2017;09;17;Tiistai;113;93;206;17;13;30
96;05.09.2017;2017;09;18;Tiistai;87;73;160;8;8;16
96;05.09.2017;2017;09;19;Tiistai;80;62;142;5;13;18
96;05.09.2017;2017;09;20;Tiistai;73;52;125;7;5;12
96;05.09.2017;2017;09;21;Tiistai;28;45;73;4;8;12
96;05.09.2017;2017;09;22;Tiistai;6;10;16;3;0;3
96;05.09.2017;2017;09;23;Tiistai;13;6;19;1;1;2
96;06.09.2017;2017;09;00;Keskiviikko;4;2;6;0;0;0
96;06.09.2017;2017;09;01;Keskiviikko;2;0;2;1;0;1
96;06.09.2017;2017;09;02;Keskiviikko;2;0;2;0;0;0
96;06.09.2017;2017;09;03;Keskiviikko;1;0;1;1;0;1
96;06.09.2017;2017;09;04;Keskiviikko;1;1;2;2;0;2
96;06.09.2017;2017;09;05;Keskiviikko;3;9;12;0;0;0
96;06.09.2017;2017;09;06;Keskiviikko;76;35;111;6;1;7
96;06.09.2017;2017;09;07;Keskiviikko;155;223;378;15;5;20
96;06.09.2017;2017;09;08;Keskiviikko;218;201;419;17;14;31
96;06.09.2017;2017;09;09;Keskiviikko;117;91;208;8;11;19
96;06.09.2017;2017;09;10;Keskiviikko;297;75;372;23;11;34
96;06.09.2017;2017;09;11;Keskiviikko;104;84;188;19;13;32
96;06.09.2017;2017;09;12;Keskiviikko;84;134;218;7;13;20
96;06.09.2017;2017;09;13;Keskiviikko;100;136;236;11;14;25
96;06.09.2017;2017;09;14;Keskiviikko;104;184;288;7;22;29
96;06.09.2017;2017;09;15;Keskiviikko;99;294;393;13;31;44
96;06.09.2017;2017;09;16;Keskiviikko;169;199;368;12;27;39
96;06.09.2017;2017;09;17;Keskiviikko;117;79;196;12;17;29
96;06.09.2017;2017;09;18;Keskiviikko;115;78;193;21;37;58
96;06.09.2017;2017;09;19;Keskiviikko;85;54;139;10;7;17
96;06.09.2017;2017;09;20;Keskiviikko;64;57;121;8;11;19
96;06.09.2017;2017;09;21;Keskiviikko;24;36;60;6;11;17
96;06.09.2017;2017;09;22;Keskiviikko;19;8;27;3;5;8
96;06.09.2017;2017;09;23;Keskiviikko;6;7;13;0;0;0
96;07.09.2017;2017;09;00;Torstai;5;3;8;1;0;1
96;07.09.2017;2017;09;01;Torstai;5;2;7;2;0;2
96;07.09.2017;2017;09;02;Torstai;7;0;7;3;0;3
96;07.09.2017;2017;09;03;Torstai;5;0;5;1;0;1
96;07.09.2017;2017;09;04;Torstai;3;0;3;1;0;1
96;07.09.2017;2017;09;05;Torstai;2;5;7;1;0;1
96;07.09.2017;2017;09;06;Torstai;41;20;61;2;0;2
96;07.09.2017;2017;09;07;Torstai;110;99;209;17;1;18
96;07.09.2017;2017;09;08;Torstai;239;168;407;19;3;22
96;07.09.2017;2017;09;09;Torstai;101;85;186;11;10;21
96;07.09.2017;2017;09;10;Torstai;81;68;149;10;14;24
96;07.09.2017;2017;09;11;Torstai;77;89;166;9;5;14
96;07.09.2017;2017;09;12;Torstai;82;150;232;10;20;30
96;07.09.2017;2017;09;13;Torstai;72;181;253;2;36;38
96;07.09.2017;2017;09;14;Torstai;118;166;284;16;22;38
96;07.09.2017;2017;09;15;Torstai;127;242;369;16;28;44
96;07.09.2017;2017;09;16;Torstai;160;245;405;6;20;26
96;07.09.2017;2017;09;17;Torstai;123;98;221;6;6;12
96;07.09.2017;2017;09;18;Torstai;94;76;170;5;9;14
96;07.09.2017;2017;09;19;Torstai;62;73;135;7;6;13
96;07.09.2017;2017;09;20;Torstai;46;59;105;3;26;29
96;07.09.2017;2017;09;21;Torstai;36;73;109;6;8;14
96;07.09.2017;2017;09;22;Torstai;19;68;87;3;10;13
96;07.09.2017;2017;09;23;Torstai;17;13;30;8;4;12
96;08.09.2017;2017;09;00;Perjantai;24;11;35;14;3;17
96;08.09.2017;2017;09;01;Perjantai;36;9;45;12;2;14
96;08.09.2017;2017;09;02;Perjantai;24;1;25;11;1;12
96;08.09.2017;2017;09;03;Perjantai;14;0;14;2;0;2
96;08.09.2017;2017;09;04;Perjantai;10;5;15;0;0;0
96;08.09.2017;2017;09;05;Perjantai;7;7;14;1;1;2
96;08.09.2017;2017;09;06;Perjantai;55;32;87;3;1;4
96;08.09.2017;2017;09;07;Perjantai;129;79;208;13;3;16
96;08.09.2017;2017;09;08;Perjantai;105;70;175;7;2;9
96;08.09.2017;2017;09;09;Perjantai;65;64;129;5;7;12
96;08.09.2017;2017;09;10;Perjantai;42;63;105;9;9;18
96;08.09.2017;2017;09;11;Perjantai;63;90;153;6;11;17
96;08.09.2017;2017;09;12;Perjantai;55;57;112;5;7;12
96;08.09.2017;2017;09;13;Perjantai;59;95;154;6;16;22
96;08.09.2017;2017;09;14;Perjantai;80;170;250;4;14;18
96;08.09.2017;2017;09;15;Perjantai;72;147;219;6;14;20
96;08.09.2017;2017;09;16;Perjantai;70;99;169;5;9;14
96;08.09.2017;2017;09;17;Perjantai;66;62;128;12;7;19
96;08.09.2017;2017;09;18;Perjantai;37;41;78;3;2;5
96;08.09.2017;2017;09;19;Perjantai;33;26;59;8;7;15
96;08.09.2017;2017;09;20;Perjantai;34;38;72;6;4;10
96;08.09.2017;2017;09;21;Perjantai;32;32;64;8;7;15
96;08.09.2017;2017;09;22;Perjantai;10;12;22;2;9;11
96;08.09.2017;2017;09;23;Perjantai;5;5;10;0;1;1
96;09.09.2017;2017;09;00;Lauantai;3;6;9;3;2;5
96;09.09.2017;2017;09;01;Lauantai;5;11;16;0;1;1
96;09.09.2017;2017;09;02;Lauantai;3;0;3;1;0;1
96;09.09.2017;2017;09;03;Lauantai;10;3;13;2;0;2
96;09.09.2017;2017;09;04;Lauantai;6;1;7;0;0;0
96;09.09.2017;2017;09;05;Lauantai;3;3;6;2;2;4
96;09.09.2017;2017;09;06;Lauantai;21;12;33;2;1;3
96;09.09.2017;2017;09;07;Lauantai;0;18;18;1;3;4
96;09.09.2017;2017;09;08;Lauantai;3;14;17;2;2;4
96;09.09.2017;2017;09;09;Lauantai;13;29;42;6;6;12
96;09.09.2017;2017;09;10;Lauantai;21;35;56;8;8;16
96;09.09.2017;2017;09;11;Lauantai;22;50;72;6;15;21
96;09.09.2017;2017;09;12;Lauantai;41;55;96;9;19;28
96;09.09.2017;2017;09;13;Lauantai;35;43;78;9;13;22
96;09.09.2017;2017;09;14;Lauantai;39;53;92;10;9;19
96;09.09.2017;2017;09;15;Lauantai;42;70;112;10;12;22
96;09.09.2017;2017;09;16;Lauantai;37;50;87;11;26;37
96;09.09.2017;2017;09;17;Lauantai;36;42;78;26;7;33
96;09.09.2017;2017;09;18;Lauantai;46;37;83;29;6;35
96;09.09.2017;2017;09;19;Lauantai;58;22;80;22;8;30
96;09.09.2017;2017;09;20;Lauantai;47;22;69;9;13;22
96;09.09.2017;2017;09;21;Lauantai;17;32;49;11;23;34
96;09.09.2017;2017;09;22;Lauantai;16;21;37;3;2;5
96;09.09.2017;2017;09;23;Lauantai;9;13;22;2;1;3
96;10.09.2017;2017;09;00;Sunnuntai;14;11;25;3;2;5
96;10.09.2017;2017;09;01;Sunnuntai;9;8;17;2;0;2
96;10.09.2017;2017;09;02;Sunnuntai;22;0;22;5;0;5
96;10.09.2017;2017;09;03;Sunnuntai;17;0;17;3;0;3
96;10.09.2017;2017;09;04;Sunnuntai;13;1;14;0;2;2
96;10.09.2017;2017;09;05;Sunnuntai;3;0;3;2;0;2
96;10.09.2017;2017;09;06;Sunnuntai;17;4;21;3;1;4
96;10.09.2017;2017;09;07;Sunnuntai;3;12;15;0;1;1
96;10.09.2017;2017;09;08;Sunnuntai;2;9;11;2;2;4
96;10.09.2017;2017;09;09;Sunnuntai;2;7;9;0;2;2
96;10.09.2017;2017;09;10;Sunnuntai;4;7;11;3;2;5
96;10.09.2017;2017;09;11;Sunnuntai;6;13;19;1;0;1
96;10.09.2017;2017;09;12;Sunnuntai;14;5;19;1;4;5
96;10.09.2017;2017;09;13;Sunnuntai;19;9;28;1;7;8
96;10.09.2017;2017;09;14;Sunnuntai;10;17;27;4;3;7
96;10.09.2017;2017;09;15;Sunnuntai;11;21;32;1;9;10
96;10.09.2017;2017;09;16;Sunnuntai;12;20;32;7;2;9
96;10.09.2017;2017;09;17;Sunnuntai;15;17;32;8;2;10
96;10.09.2017;2017;09;18;Sunnuntai;22;19;41;10;10;20
96;10.09.2017;2017;09;19;Sunnuntai;10;20;30;8;9;17
96;10.09.2017;2017;09;20;Sunnuntai;13;21;34;5;7;12
96;10.09.2017;2017;09;21;Sunnuntai;17;10;27;3;3;6
96;10.09.2017;2017;09;22;Sunnuntai;8;7;15;4;3;7
96;10.09.2017;2017;09;23;Sunnuntai;0;0;0;0;0;0
96;11.09.2017;2017;09;00;Maanantai;6;1;7;3;0;3
96;11.09.2017;2017;09;01;Maanantai;5;0;5;1;0;1
96;11.09.2017;2017;09;02;Maanantai;5;0;5;0;0;0
96;11.09.2017;2017;09;03;Maanantai;2;0;2;0;0;0
96;11.09.2017;2017;09;04;Maanantai;1;0;1;1;0;1
96;11.09.2017;2017;09;05;Maanantai;0;8;8;0;1;1
96;11.09.2017;2017;09;06;Maanantai;49;30;79;6;2;8
96;11.09.2017;2017;09;07;Maanantai;143;137;280;16;2;18
96;11.09.2017;2017;09;08;Maanantai;136;162;298;13;7;20
96;11.09.2017;2017;09;09;Maanantai;110;99;209;21;8;29
96;11.09.2017;2017;09;10;Maanantai;72;92;164;8;14;22
96;11.09.2017;2017;09;11;Maanantai;82;122;204;5;9;14
96;11.09.2017;2017;09;12;Maanantai;129;99;228;11;7;18
96;11.09.2017;2017;09;13;Maanantai;86;105;191;5;9;14
96;11.09.2017;2017;09;14;Maanantai;91;138;229;5;21;26
96;11.09.2017;2017;09;15;Maanantai;100;279;379;15;21;36
96;11.09.2017;2017;09;16;Maanantai;137;207;344;7;19;26
96;11.09.2017;2017;09;17;Maanantai;104;157;261;7;17;24
96;11.09.2017;2017;09;18;Maanantai;111;95;206;18;12;30
96;11.09.2017;2017;09;19;Maanantai;87;78;165;11;15;26
96;11.09.2017;2017;09;20;Maanantai;74;36;110;12;10;22
96;11.09.2017;2017;09;21;Maanantai;54;32;86;9;10;19
96;11.09.2017;2017;09;22;Maanantai;10;21;31;4;5;9
96;11.09.2017;2017;09;23;Maanantai;2;1;3;1;0;1
96;12.09.2017;2017;09;00;Tiistai;2;1;3;1;0;1
96;12.09.2017;2017;09;01;Tiistai;2;2;4;0;0;0
96;12.09.2017;2017;09;02;Tiistai;2;0;2;0;0;0
96;12.09.2017;2017;09;03;Tiistai;2;2;4;1;0;1
96;12.09.2017;2017;09;04;Tiistai;4;1;5;1;0;1
96;12.09.2017;2017;09;05;Tiistai;5;8;13;2;0;2
96;12.09.2017;2017;09;06;Tiistai;61;29;90;2;1;3
96;12.09.2017;2017;09;07;Tiistai;180;163;343;24;7;31
96;12.09.2017;2017;09;08;Tiistai;198;178;376;18;16;34
96;12.09.2017;2017;09;09;Tiistai;129;92;221;14;2;16
96;12.09.2017;2017;09;10;Tiistai;84;97;181;15;7;22
96;12.09.2017;2017;09;11;Tiistai;97;115;212;11;19;30
96;12.09.2017;2017;09;12;Tiistai;79;125;204;11;18;29
96;12.09.2017;2017;09;13;Tiistai;72;95;167;3;14;17
96;12.09.2017;2017;09;14;Tiistai;83;172;255;5;15;20
96;12.09.2017;2017;09;15;Tiistai;79;252;331;5;20;25
96;12.09.2017;2017;09;16;Tiistai;100;174;274;7;8;15
96;12.09.2017;2017;09;17;Tiistai;58;64;122;1;9;10
96;12.09.2017;2017;09;18;Tiistai;40;44;84;2;4;6
96;12.09.2017;2017;09;19;Tiistai;45;31;76;15;15;30
96;12.09.2017;2017;09;20;Tiistai;52;30;82;9;7;16
96;12.09.2017;2017;09;21;Tiistai;19;37;56;6;10;16
96;12.09.2017;2017;09;22;Tiistai;3;8;11;1;3;4
96;12.09.2017;2017;09;23;Tiistai;10;3;13;1;0;1
96;13.09.2017;2017;09;00;Keskiviikko;0;0;0;2;0;2
96;13.09.2017;2017;09;01;Keskiviikko;2;0;2;0;0;0
96;13.09.2017;2017;09;02;Keskiviikko;3;1;4;0;0;0
96;13.09.2017;2017;09;03;Keskiviikko;0;0;0;0;0;0
96;13.09.2017;2017;09;04;Keskiviikko;2;0;2;1;0;1
96;13.09.2017;2017;09;05;Keskiviikko;7;9;16;0;0;0
96;13.09.2017;2017;09;06;Keskiviikko;49;36;85;5;0;5
96;13.09.2017;2017;09;07;Keskiviikko;134;135;269;11;8;19
96;13.09.2017;2017;09;08;Keskiviikko;173;144;317;12;8;20
96;13.09.2017;2017;09;09;Keskiviikko;113;118;231;15;14;29
96;13.09.2017;2017;09;10;Keskiviikko;63;71;134;7;12;19
96;13.09.2017;2017;09;11;Keskiviikko;94;100;194;12;13;25
96;13.09.2017;2017;09;12;Keskiviikko;124;117;241;12;7;19
96;13.09.2017;2017;09;13;Keskiviikko;83;101;184;6;10;16
96;13.09.2017;2017;09;14;Keskiviikko;118;205;323;5;13;18
96;13.09.2017;2017;09;15;Keskiviikko;93;258;351;5;22;27
96;13.09.2017;2017;09;16;Keskiviikko;133;215;348;13;22;35
96;13.09.2017;2017;09;17;Keskiviikko;100;103;203;7;12;19
96;13.09.2017;2017;09;18;Keskiviikko;103;86;189;22;23;45
96;13.09.2017;2017;09;19;Keskiviikko;68;75;143;8;18;26
96;13.09.2017;2017;09;20;Keskiviikko;57;68;125;10;20;30
96;13.09.2017;2017;09;21;Keskiviikko;27;48;75;4;5;9
96;13.09.2017;2017;09;22;Keskiviikko;15;16;31;3;0;3
96;13.09.2017;2017;09;23;Keskiviikko;4;6;10;0;2;2
96;14.09.2017;2017;09;00;Torstai;3;3;6;1;2;3
96;14.09.2017;2017;09;01;Torstai;6;0;6;0;0;0
96;14.09.2017;2017;09;02;Torstai;6;2;8;1;0;1
96;14.09.2017;2017;09;03;Torstai;1;0;1;2;0;2
96;14.09.2017;2017;09;04;Torstai;2;0;2;0;0;0
96;14.09.2017;2017;09;05;Torstai;7;7;14;1;2;3
96;14.09.2017;2017;09;06;Torstai;49;32;81;5;0;5
96;14.09.2017;2017;09;07;Torstai;131;143;274;14;5;19
96;14.09.2017;2017;09;08;Torstai;178;175;353;17;7;24
96;14.09.2017;2017;09;09;Torstai;96;109;205;6;7;13
96;14.09.2017;2017;09;10;Torstai;69;73;142;5;5;10
96;14.09.2017;2017;09;11;Torstai;88;90;178;11;11;22
96;14.09.2017;2017;09;12;Torstai;83;104;187;10;11;21
96;14.09.2017;2017;09;13;Torstai;78;117;195;7;13;20
96;14.09.2017;2017;09;14;Torstai;93;162;255;10;23;33
96;14.09.2017;2017;09;15;Torstai;97;240;337;7;15;22
96;14.09.2017;2017;09;16;Torstai;139;202;341;8;20;28
96;14.09.2017;2017;09;17;Torstai;86;124;210;10;14;24
96;14.09.2017;2017;09;18;Torstai;84;91;175;17;26;43
96;14.09.2017;2017;09;19;Torstai;61;56;117;10;13;23
96;14.09.2017;2017;09;20;Torstai;58;42;100;10;9;19
96;14.09.2017;2017;09;21;Torstai;71;37;108;7;7;14
96;14.09.2017;2017;09;22;Torstai;16;12;28;6;1;7
96;14.09.2017;2017;09;23;Torstai;6;6;12;0;1;1
96;15.09.2017;2017;09;00;Perjantai;1;5;6;1;0;1
96;15.09.2017;2017;09;01;Perjantai;7;0;7;1;0;1
96;15.09.2017;2017;09;02;Perjantai;5;1;6;0;0;0
96;15.09.2017;2017;09;03;Perjantai;8;0;8;0;0;0
96;15.09.2017;2017;09;04;Perjantai;2;1;3;2;0;2
96;15.09.2017;2017;09;05;Perjantai;5;6;11;0;1;1
96;15.09.2017;2017;09;06;Perjantai;63;26;89;5;2;7
96;15.09.2017;2017;09;07;Perjantai;111;99;210;20;7;27
96;15.09.2017;2017;09;08;Perjantai;142;93;235;15;3;18
96;15.09.2017;2017;09;09;Perjantai;64;66;130;14;8;22
96;15.09.2017;2017;09;10;Perjantai;67;52;119;12;9;21
96;15.09.2017;2017;09;11;Perjantai;65;96;161;6;9;15
96;15.09.2017;2017;09;12;Perjantai;76;74;150;7;11;18
96;15.09.2017;2017;09;13;Perjantai;77;130;207;9;14;23
96;15.09.2017;2017;09;14;Perjantai;84;228;312;6;17;23
96;15.09.2017;2017;09;15;Perjantai;86;160;246;7;23;30
96;15.09.2017;2017;09;16;Perjantai;94;95;189;4;12;16
96;15.09.2017;2017;09;17;Perjantai;62;56;118;6;11;17
96;15.09.2017;2017;09;18;Perjantai;38;25;63;4;4;8
96;15.09.2017;2017;09;19;Perjantai;28;36;64;3;7;10
96;15.09.2017;2017;09;20;Perjantai;28;35;63;3;5;8
96;15.09.2017;2017;09;21;Perjantai;17;32;49;7;4;11
96;15.09.2017;2017;09;22;Perjantai;14;9;23;1;3;4
96;15.09.2017;2017;09;23;Perjantai;8;12;20;0;1;1
96;16.09.2017;2017;09;00;Lauantai;14;9;23;1;1;2
96;16.09.2017;2017;09;01;Lauantai;3;0;3;1;0;1
96;16.09.2017;2017;09;02;Lauantai;12;1;13;1;0;1
96;16.09.2017;2017;09;03;Lauantai;8;0;8;2;0;2
96;16.09.2017;2017;09;04;Lauantai;6;2;8;2;0;2
96;16.09.2017;2017;09;05;Lauantai;2;2;4;0;1;1
96;16.09.2017;2017;09;06;Lauantai;30;10;40;2;0;2
96;16.09.2017;2017;09;07;Lauantai;6;13;19;4;3;7
96;16.09.2017;2017;09;08;Lauantai;6;28;34;4;3;7
96;16.09.2017;2017;09;09;Lauantai;12;42;54;4;5;9
96;16.09.2017;2017;09;10;Lauantai;21;50;71;5;8;13
96;16.09.2017;2017;09;11;Lauantai;44;52;96;13;11;24
96;16.09.2017;2017;09;12;Lauantai;54;61;115;5;7;12
96;16.09.2017;2017;09;13;Lauantai;46;55;101;6;13;19
96;16.09.2017;2017;09;14;Lauantai;51;47;98;5;14;19
96;16.09.2017;2017;09;15;Lauantai;53;75;128;10;15;25
96;16.09.2017;2017;09;16;Lauantai;51;53;104;9;14;23
96;16.09.2017;2017;09;17;Lauantai;41;50;91;5;6;11
96;16.09.2017;2017;09;18;Lauantai;30;29;59;9;11;20
96;16.09.2017;2017;09;19;Lauantai;51;19;70;9;7;16
96;16.09.2017;2017;09;20;Lauantai;42;20;62;6;11;17
96;16.09.2017;2017;09;21;Lauantai;12;29;41;4;5;9
96;16.09.2017;2017;09;22;Lauantai;7;16;23;2;3;5
96;16.09.2017;2017;09;23;Lauantai;8;4;12;2;1;3
96;17.09.2017;2017;09;00;Sunnuntai;9;11;20;2;0;2
96;17.09.2017;2017;09;01;Sunnuntai;5;2;7;2;0;2
96;17.09.2017;2017;09;02;Sunnuntai;14;3;17;3;0;3
96;17.09.2017;2017;09;03;Sunnuntai;15;1;16;2;0;2
96;17.09.2017;2017;09;04;Sunnuntai;14;0;14;3;0;3
96;17.09.2017;2017;09;05;Sunnuntai;3;0;3;0;0;0
96;17.09.2017;2017;09;06;Sunnuntai;16;3;19;1;0;1
96;17.09.2017;2017;09;07;Sunnuntai;1;10;11;1;1;2
96;17.09.2017;2017;09;08;Sunnuntai;5;11;16;3;2;5
96;17.09.2017;2017;09;09;Sunnuntai;3;6;9;4;6;10
96;17.09.2017;2017;09;10;Sunnuntai;8;27;35;4;8;12
96;17.09.2017;2017;09;11;Sunnuntai;22;34;56;5;5;10
96;17.09.2017;2017;09;12;Sunnuntai;38;40;78;8;15;23
96;17.09.2017;2017;09;13;Sunnuntai;51;50;101;12;13;25
96;17.09.2017;2017;09;14;Sunnuntai;55;46;101;4;12;16
96;17.09.2017;2017;09;15;Sunnuntai;48;49;97;8;16;24
96;17.09.2017;2017;09;16;Sunnuntai;59;27;86;32;3;35
96;17.09.2017;2017;09;17;Sunnuntai;47;36;83;7;16;23
96;17.09.2017;2017;09;18;Sunnuntai;45;52;97;27;14;41
96;17.09.2017;2017;09;19;Sunnuntai;33;30;63;16;12;28
96;17.09.2017;2017;09;20;Sunnuntai;16;39;55;2;18;20
96;17.09.2017;2017;09;21;Sunnuntai;19;27;46;6;7;13
96;17.09.2017;2017;09;22;Sunnuntai;4;10;14;3;7;10
96;17.09.2017;2017;09;23;Sunnuntai;2;4;6;0;0;0
96;18.09.2017;2017;09;00;Maanantai;3;1;4;0;0;0
96;18.09.2017;2017;09;01;Maanantai;9;0;9;0;0;0
96;18.09.2017;2017;09;02;Maanantai;2;0;2;0;0;0
96;18.09.2017;2017;09;03;Maanantai;1;0;1;0;0;0
96;18.09.2017;2017;09;04;Maanantai;1;1;2;1;0;1
96;18.09.2017;2017;09;05;Maanantai;1;4;5;0;0;0
96;18.09.2017;2017;09;06;Maanantai;65;31;96;3;1;4
96;18.09.2017;2017;09;07;Maanantai;136;103;239;22;5;27
96;18.09.2017;2017;09;08;Maanantai;175;126;301;22;10;32
96;18.09.2017;2017;09;09;Maanantai;79;66;145;27;9;36
96;18.09.2017;2017;09;10;Maanantai;74;49;123;9;7;16
96;18.09.2017;2017;09;11;Maanantai;68;70;138;8;12;20
96;18.09.2017;2017;09;12;Maanantai;89;92;181;8;6;14
96;18.09.2017;2017;09;13;Maanantai;84;110;194;9;15;24
96;18.09.2017;2017;09;14;Maanantai;79;138;217;8;21;29
96;18.09.2017;2017;09;15;Maanantai;96;268;364;5;22;27
96;18.09.2017;2017;09;16;Maanantai;135;227;362;10;23;33
96;18.09.2017;2017;09;17;Maanantai;76;82;158;10;13;23
96;18.09.2017;2017;09;18;Maanantai;59;63;122;16;9;25
96;18.09.2017;2017;09;19;Maanantai;52;51;103;9;13;22
96;18.09.2017;2017;09;20;Maanantai;60;35;95;10;16;26
96;18.09.2017;2017;09;21;Maanantai;24;29;53;5;4;9
96;18.09.2017;2017;09;22;Maanantai;9;13;22;1;1;2
96;18.09.2017;2017;09;23;Maanantai;2;1;3;0;0;0
96;19.09.2017;2017;09;00;Tiistai;2;1;3;0;0;0
96;19.09.2017;2017;09;01;Tiistai;1;0;1;0;2;2
96;19.09.2017;2017;09;02;Tiistai;0;1;1;1;0;1
96;19.09.2017;2017;09;03;Tiistai;1;0;1;0;0;0
96;19.09.2017;2017;09;04;Tiistai;1;1;2;1;0;1
96;19.09.2017;2017;09;05;Tiistai;4;7;11;1;0;1
96;19.09.2017;2017;09;06;Tiistai;66;29;95;3;1;4
96;19.09.2017;2017;09;07;Tiistai;164;122;286;23;9;32
96;19.09.2017;2017;09;08;Tiistai;196;139;335;8;12;20
96;19.09.2017;2017;09;09;Tiistai;110;72;182;15;12;27
96;19.09.2017;2017;09;10;Tiistai;73;52;125;10;9;19
96;19.09.2017;2017;09;11;Tiistai;78;57;135;12;8;20
96;19.09.2017;2017;09;12;Tiistai;56;82;138;4;6;10
96;19.09.2017;2017;09;13;Tiistai;39;90;129;7;12;19
96;19.09.2017;2017;09;14;Tiistai;70;145;215;6;16;22
96;19.09.2017;2017;09;15;Tiistai;80;241;321;7;20;27
96;19.09.2017;2017;09;16;Tiistai;112;212;324;9;17;26
96;19.09.2017;2017;09;17;Tiistai;70;65;135;6;11;17
96;19.09.2017;2017;09;18;Tiistai;67;49;116;8;7;15
96;19.09.2017;2017;09;19;Tiistai;52;43;95;17;18;35
96;19.09.2017;2017;09;20;Tiistai;42;31;73;6;11;17
96;19.09.2017;2017;09;21;Tiistai;33;22;55;5;2;7
96;19.09.2017;2017;09;22;Tiistai;7;10;17;0;1;1
96;19.09.2017;2017;09;23;Tiistai;4;3;7;0;1;1
96;20.09.2017;2017;09;00;Keskiviikko;0;1;1;0;0;0
96;20.09.2017;2017;09;01;Keskiviikko;1;1;2;0;0;0
96;20.09.2017;2017;09;02;Keskiviikko;0;0;0;0;0;0
96;20.09.2017;2017;09;03;Keskiviikko;0;0;0;0;0;0
96;20.09.2017;2017;09;04;Keskiviikko;2;0;2;1;1;2
96;20.09.2017;2017;09;05;Keskiviikko;2;6;8;0;0;0
96;20.09.2017;2017;09;06;Keskiviikko;57;38;95;3;1;4
96;20.09.2017;2017;09;07;Keskiviikko;144;141;285;15;6;21
96;20.09.2017;2017;09;08;Keskiviikko;231;131;362;17;5;22
96;20.09.2017;2017;09;09;Keskiviikko;112;80;192;18;3;21
96;20.09.2017;2017;09;10;Keskiviikko;38;64;102;13;14;27
96;20.09.2017;2017;09;11;Keskiviikko;81;93;174;15;17;32
96;20.09.2017;2017;09;12;Keskiviikko;91;120;211;12;7;19
96;20.09.2017;2017;09;13;Keskiviikko;82;96;178;6;7;13
96;20.09.2017;2017;09;14;Keskiviikko;79;172;251;8;28;36
96;20.09.2017;2017;09;15;Keskiviikko;88;264;352;7;24;31
96;20.09.2017;2017;09;16;Keskiviikko;117;177;294;10;18;28
96;20.09.2017;2017;09;17;Keskiviikko;93;85;178;6;9;15
96;20.09.2017;2017;09;18;Keskiviikko;81;69;150;16;11;27
96;20.09.2017;2017;09;19;Keskiviikko;72;53;125;14;10;24
96;20.09.2017;2017;09;20;Keskiviikko;41;50;91;7;22;29
96;20.09.2017;2017;09;21;Keskiviikko;32;46;78;6;6;12
96;20.09.2017;2017;09;22;Keskiviikko;10;8;18;1;3;4
96;20.09.2017;2017;09;23;Keskiviikko;3;5;8;0;0;0
96;21.09.2017;2017;09;00;Torstai;4;4;8;0;0;0
96;21.09.2017;2017;09;01;Torstai;3;0;3;1;0;1
96;21.09.2017;2017;09;02;Torstai;7;0;7;0;0;0
96;21.09.2017;2017;09;03;Torstai;2;0;2;0;0;0
96;21.09.2017;2017;09;04;Torstai;1;0;1;1;0;1
96;21.09.2017;2017;09;05;Torstai;3;11;14;0;0;0
96;21.09.2017;2017;09;06;Torstai;55;37;92;7;2;9
96;21.09.2017;2017;09;07;Torstai;138;118;256;20;3;23
96;21.09.2017;2017;09;08;Torstai;167;140;307;11;4;15
96;21.09.2017;2017;09;09;Torstai;80;70;150;10;9;19
96;21.09.2017;2017;09;10;Torstai;66;102;168;4;7;11
96;21.09.2017;2017;09;11;Torstai;70;77;147;10;4;14
96;21.09.2017;2017;09;12;Torstai;135;106;241;20;10;30
96;21.09.2017;2017;09;13;Torstai;92;111;203;6;16;22
96;21.09.2017;2017;09;14;Torstai;71;192;263;4;19;23
96;21.09.2017;2017;09;15;Torstai;85;244;329;12;23;35
96;21.09.2017;2017;09;16;Torstai;117;180;297;11;20;31
96;21.09.2017;2017;09;17;Torstai;86;102;188;6;9;15
96;21.09.2017;2017;09;18;Torstai;73;54;127;9;7;16
96;21.09.2017;2017;09;19;Torstai;61;42;103;15;7;22
96;21.09.2017;2017;09;20;Torstai;43;28;71;8;6;14
96;21.09.2017;2017;09;21;Torstai;19;35;54;2;5;7
96;21.09.2017;2017;09;22;Torstai;10;13;23;1;1;2
96;21.09.2017;2017;09;23;Torstai;3;2;5;1;0;1
96;22.09.2017;2017;09;00;Perjantai;6;4;10;1;0;1
96;22.09.2017;2017;09;01;Perjantai;6;0;6;0;0;0
96;22.09.2017;2017;09;02;Perjantai;7;1;8;0;0;0
96;22.09.2017;2017;09;03;Perjantai;12;0;12;1;0;1
96;22.09.2017;2017;09;04;Perjantai;5;0;5;1;0;1
96;22.09.2017;2017;09;05;Perjantai;2;13;15;1;1;2
96;22.09.2017;2017;09;06;Perjantai;60;29;89;4;2;6
96;22.09.2017;2017;09;07;Perjantai;165;104;269;19;9;28
96;22.09.2017;2017;09;08;Perjantai;122;103;225;8;1;9
96;22.09.2017;2017;09;09;Perjantai;63;75;138;9;7;16
96;22.09.2017;2017;09;10;Perjantai;72;76;148;5;9;14
96;22.09.2017;2017;09;11;Perjantai;72;116;188;4;10;14
96;22.09.2017;2017;09;12;Perjantai;75;126;201;11;14;25
96;22.09.2017;2017;09;13;Perjantai;80;155;235;8;12;20
96;22.09.2017;2017;09;14;Perjantai;98;207;305;7;30;37
96;22.09.2017;2017;09;15;Perjantai;103;193;296;8;24;32
96;22.09.2017;2017;09;16;Perjantai;109;93;202;9;15;24
96;22.09.2017;2017;09;17;Perjantai;80;67;147;14;11;25
96;22.09.2017;2017;09;18;Perjantai;78;50;128;8;14;22
96;22.09.2017;2017;09;19;Perjantai;59;35;94;9;8;17
96;22.09.2017;2017;09;20;Perjantai;33;37;70;6;8;14
96;22.09.2017;2017;09;21;Perjantai;18;27;45;3;3;6
96;22.09.2017;2017;09;22;Perjantai;13;11;24;2;1;3
96;22.09.2017;2017;09;23;Perjantai;13;15;28;1;3;4
96;23.09.2017;2017;09;00;Lauantai;8;8;16;1;2;3
96;23.09.2017;2017;09;01;Lauantai;7;1;8;0;0;0
96;23.09.2017;2017;09;02;Lauantai;9;1;10;1;0;1
96;23.09.2017;2017;09;03;Lauantai;17;0;17;3;0;3
96;23.09.2017;2017;09;04;Lauantai;5;2;7;0;0;0
96;23.09.2017;2017;09;05;Lauantai;1;0;1;0;0;0
96;23.09.2017;2017;09;06;Lauantai;21;10;31;0;0;0
96;23.09.2017;2017;09;07;Lauantai;2;14;16;2;2;4
96;23.09.2017;2017;09;08;Lauantai;10;17;27;5;3;8
96;23.09.2017;2017;09;09;Lauantai;9;35;44;5;8;13
96;23.09.2017;2017;09;10;Lauantai;21;37;58;2;7;9
96;23.09.2017;2017;09;11;Lauantai;40;53;93;10;2;12
96;23.09.2017;2017;09;12;Lauantai;44;43;87;15;6;21
96;23.09.2017;2017;09;13;Lauantai;48;71;119;5;13;18
96;23.09.2017;2017;09;14;Lauantai;63;52;115;5;4;9
96;23.09.2017;2017;09;15;Lauantai;67;55;122;5;10;15
96;23.09.2017;2017;09;16;Lauantai;43;33;76;5;8;13
96;23.09.2017;2017;09;17;Lauantai;44;45;89;14;10;24
96;23.09.2017;2017;09;18;Lauantai;50;27;77;11;2;13
96;23.09.2017;2017;09;19;Lauantai;34;35;69;10;9;19
96;23.09.2017;2017;09;20;Lauantai;11;26;37;3;9;12
96;23.09.2017;2017;09;21;Lauantai;16;25;41;0;7;7
96;23.09.2017;2017;09;22;Lauantai;11;9;20;2;0;2
96;23.09.2017;2017;09;23;Lauantai;17;13;30;3;6;9
96;24.09.2017;2017;09;00;Sunnuntai;15;11;26;1;0;1
96;24.09.2017;2017;09;01;Sunnuntai;4;3;7;2;0;2
96;24.09.2017;2017;09;02;Sunnuntai;5;2;7;0;0;0
96;24.09.2017;2017;09;03;Sunnuntai;18;0;18;6;0;6
96;24.09.2017;2017;09;04;Sunnuntai;9;2;11;0;2;2
96;24.09.2017;2017;09;05;Sunnuntai;4;0;4;0;1;1
96;24.09.2017;2017;09;06;Sunnuntai;15;7;22;2;0;2
96;24.09.2017;2017;09;07;Sunnuntai;3;9;12;0;3;3
96;24.09.2017;2017;09;08;Sunnuntai;5;5;10;1;3;4
96;24.09.2017;2017;09;09;Sunnuntai;12;14;26;1;4;5
96;24.09.2017;2017;09;10;Sunnuntai;17;17;34;8;1;9
96;24.09.2017;2017;09;11;Sunnuntai;24;52;76;8;4;12
96;24.09.2017;2017;09;12;Sunnuntai;32;57;89;6;11;17
96;24.09.2017;2017;09;13;Sunnuntai;40;71;111;6;7;13
96;24.09.2017;2017;09;14;Sunnuntai;31;49;80;11;9;20
96;24.09.2017;2017;09;15;Sunnuntai;41;46;87;8;9;17
96;24.09.2017;2017;09;16;Sunnuntai;63;58;121;24;26;50
96;24.09.2017;2017;09;17;Sunnuntai;57;34;91;17;13;30
96;24.09.2017;2017;09;18;Sunnuntai;42;46;88;14;22;36
96;24.09.2017;2017;09;19;Sunnuntai;29;28;57;10;12;22
96;24.09.2017;2017;09;20;Sunnuntai;31;34;65;7;12;19
96;24.09.2017;2017;09;21;Sunnuntai;15;21;36;6;1;7
96;24.09.2017;2017;09;22;Sunnuntai;6;11;17;1;1;2
96;24.09.2017;2017;09;23;Sunnuntai;5;5;10;1;0;1
96;25.09.2017;2017;09;00;Maanantai;5;2;7;0;0;0
96;25.09.2017;2017;09;01;Maanantai;3;1;4;0;0;0
96;25.09.2017;2017;09;02;Maanantai;2;0;2;0;0;0
96;25.09.2017;2017;09;03;Maanantai;1;0;1;0;0;0
96;25.09.2017;2017;09;04;Maanantai;1;0;1;0;0;0
96;25.09.2017;2017;09;05;Maanantai;2;9;11;0;0;0
96;25.09.2017;2017;09;06;Maanantai;50;30;80;4;3;7
96;25.09.2017;2017;09;07;Maanantai;150;123;273;19;7;26
96;25.09.2017;2017;09;08;Maanantai;176;139;315;17;9;26
96;25.09.2017;2017;09;09;Maanantai;113;70;183;13;8;21
96;25.09.2017;2017;09;10;Maanantai;52;73;125;6;13;19
96;25.09.2017;2017;09;11;Maanantai;86;69;155;8;11;19
96;25.09.2017;2017;09;12;Maanantai;86;96;182;14;9;23
96;25.09.2017;2017;09;13;Maanantai;58;100;158;5;6;11
96;25.09.2017;2017;09;14;Maanantai;71;135;206;5;20;25
96;25.09.2017;2017;09;15;Maanantai;81;251;332;11;27;38
96;25.09.2017;2017;09;16;Maanantai;152;210;362;7;23;30
96;25.09.2017;2017;09;17;Maanantai;104;116;220;17;26;43
96;25.09.2017;2017;09;18;Maanantai;63;84;147;12;15;27
96;25.09.2017;2017;09;19;Maanantai;61;53;114;12;25;37
96;25.09.2017;2017;09;20;Maanantai;47;51;98;10;11;21
96;25.09.2017;2017;09;21;Maanantai;35;38;73;4;3;7
96;25.09.2017;2017;09;22;Maanantai;7;8;15;3;1;4
96;25.09.2017;2017;09;23;Maanantai;1;6;7;1;0;1
96;26.09.2017;2017;09;00;Tiistai;2;3;5;3;2;5
96;26.09.2017;2017;09;01;Tiistai;0;0;0;0;0;0
96;26.09.2017;2017;09;02;Tiistai;1;1;2;0;0;0
96;26.09.2017;2017;09;03;Tiistai;0;3;3;0;0;0
96;26.09.2017;2017;09;04;Tiistai;4;0;4;0;0;0
96;26.09.2017;2017;09;05;Tiistai;6;9;15;0;1;1
96;26.09.2017;2017;09;06;Tiistai;52;37;89;3;0;3
96;26.09.2017;2017;09;07;Tiistai;156;107;263;23;10;33
96;26.09.2017;2017;09;08;Tiistai;166;153;319;16;12;28
96;26.09.2017;2017;09;09;Tiistai;88;65;153;16;17;33
96;26.09.2017;2017;09;10;Tiistai;64;78;142;13;9;22
96;26.09.2017;2017;09;11;Tiistai;66;93;159;14;7;21
96;26.09.2017;2017;09;12;Tiistai;96;83;179;11;12;23
96;26.09.2017;2017;09;13;Tiistai;73;139;212;10;17;27
96;26.09.2017;2017;09;14;Tiistai;72;157;229;4;13;17
96;26.09.2017;2017;09;15;Tiistai;95;251;346;11;18;29
96;26.09.2017;2017;09;16;Tiistai;136;210;346;4;20;24
96;26.09.2017;2017;09;17;Tiistai;85;90;175;8;13;21
96;26.09.2017;2017;09;18;Tiistai;62;52;114;11;14;25
96;26.09.2017;2017;09;19;Tiistai;64;38;102;13;19;32
96;26.09.2017;2017;09;20;Tiistai;48;37;85;8;10;18
96;26.09.2017;2017;09;21;Tiistai;18;29;47;7;5;12
96;26.09.2017;2017;09;22;Tiistai;5;8;13;1;1;2
96;26.09.2017;2017;09;23;Tiistai;9;2;11;1;0;1
96;27.09.2017;2017;09;00;Keskiviikko;3;2;5;1;0;1
96;27.09.2017;2017;09;01;Keskiviikko;1;0;1;0;0;0
96;27.09.2017;2017;09;02;Keskiviikko;2;1;3;0;0;0
96;27.09.2017;2017;09;03;Keskiviikko;0;0;0;0;0;0
96;27.09.2017;2017;09;04;Keskiviikko;2;1;3;0;0;0
96;27.09.2017;2017;09;05;Keskiviikko;2;12;14;0;0;0
96;27.09.2017;2017;09;06;Keskiviikko;52;35;87;4;0;4
96;27.09.2017;2017;09;07;Keskiviikko;137;121;258;20;8;28
96;27.09.2017;2017;09;08;Keskiviikko;192;157;349;13;8;21
96;27.09.2017;2017;09;09;Keskiviikko;96;80;176;7;5;12
96;27.09.2017;2017;09;10;Keskiviikko;43;66;109;6;5;11
96;27.09.2017;2017;09;11;Keskiviikko;108;98;206;8;9;17
96;27.09.2017;2017;09;12;Keskiviikko;109;98;207;12;9;21
96;27.09.2017;2017;09;13;Keskiviikko;77;123;200;8;9;17
96;27.09.2017;2017;09;14;Keskiviikko;86;169;255;11;23;34
96;27.09.2017;2017;09;15;Keskiviikko;91;230;321;12;21;33
96;27.09.2017;2017;09;16;Keskiviikko;153;195;348;11;20;31
96;27.09.2017;2017;09;17;Keskiviikko;69;84;153;13;13;26
96;27.09.2017;2017;09;18;Keskiviikko;79;64;143;20;9;29
96;27.09.2017;2017;09;19;Keskiviikko;50;69;119;21;13;34
96;27.09.2017;2017;09;20;Keskiviikko;55;51;106;15;18;33
96;27.09.2017;2017;09;21;Keskiviikko;31;29;60;7;7;14
96;27.09.2017;2017;09;22;Keskiviikko;14;17;31;0;4;4
96;27.09.2017;2017;09;23;Keskiviikko;9;2;11;1;0;1
96;28.09.2017;2017;09;00;Torstai;5;1;6;1;0;1
96;28.09.2017;2017;09;01;Torstai;0;2;2;0;0;0
96;28.09.2017;2017;09;02;Torstai;2;0;2;0;0;0
96;28.09.2017;2017;09;03;Torstai;1;0;1;2;1;3
96;28.09.2017;2017;09;04;Torstai;2;1;3;1;1;2
96;28.09.2017;2017;09;05;Torstai;0;11;11;0;0;0
96;28.09.2017;2017;09;06;Torstai;51;29;80;1;1;2
96;28.09.2017;2017;09;07;Torstai;116;112;228;23;5;28
96;28.09.2017;2017;09;08;Torstai;167;160;327;18;5;23
96;28.09.2017;2017;09;09;Torstai;95;78;173;17;10;27
96;28.09.2017;2017;09;10;Torstai;63;102;165;6;15;21
96;28.09.2017;2017;09;11;Torstai;101;62;163;11;11;22
96;28.09.2017;2017;09;12;Torstai;125;100;225;11;16;27
96;28.09.2017;2017;09;13;Torstai;76;107;183;12;18;30
96;28.09.2017;2017;09;14;Torstai;76;190;266;2;19;21
96;28.09.2017;2017;09;15;Torstai;91;222;313;8;32;40
96;28.09.2017;2017;09;16;Torstai;138;163;301;8;19;27
96;28.09.2017;2017;09;17;Torstai;74;104;178;11;18;29
96;28.09.2017;2017;09;18;Torstai;50;69;119;9;14;23
96;28.09.2017;2017;09;19;Torstai;56;36;92;13;18;31
96;28.09.2017;2017;09;20;Torstai;49;41;90;9;8;17
96;28.09.2017;2017;09;21;Torstai;43;38;81;14;5;19
96;28.09.2017;2017;09;22;Torstai;13;16;29;2;4;6
96;28.09.2017;2017;09;23;Torstai;7;1;8;0;1;1
96;29.09.2017;2017;09;00;Perjantai;6;4;10;1;2;3
96;29.09.2017;2017;09;01;Perjantai;9;0;9;0;0;0
96;29.09.2017;2017;09;02;Perjantai;4;0;4;1;0;1
96;29.09.2017;2017;09;03;Perjantai;2;1;3;0;0;0
96;29.09.2017;2017;09;04;Perjantai;3;1;4;1;0;1
96;29.09.2017;2017;09;05;Perjantai;4;10;14;1;1;2
96;29.09.2017;2017;09;06;Perjantai;56;30;86;6;1;7
96;29.09.2017;2017;09;07;Perjantai;122;96;218;18;5;23
96;29.09.2017;2017;09;08;Perjantai;140;111;251;11;3;14
96;29.09.2017;2017;09;09;Perjantai;62;73;135;11;9;20
96;29.09.2017;2017;09;10;Perjantai;61;85;146;11;10;21
96;29.09.2017;2017;09;11;Perjantai;75;131;206;3;17;20
96;29.09.2017;2017;09;12;Perjantai;96;114;210;6;11;17
96;29.09.2017;2017;09;13;Perjantai;82;102;184;6;15;21
96;29.09.2017;2017;09;14;Perjantai;73;187;260;4;15;19
96;29.09.2017;2017;09;15;Perjantai;110;204;314;10;23;33
96;29.09.2017;2017;09;16;Perjantai;105;106;211;5;8;13
96;29.09.2017;2017;09;17;Perjantai;65;51;116;13;8;21
96;29.09.2017;2017;09;18;Perjantai;50;40;90;2;9;11
96;29.09.2017;2017;09;19;Perjantai;31;35;66;12;11;23
96;29.09.2017;2017;09;20;Perjantai;39;22;61;7;19;26
96;29.09.2017;2017;09;21;Perjantai;27;46;73;2;0;2
96;29.09.2017;2017;09;22;Perjantai;4;9;13;3;5;8
96;29.09.2017;2017;09;23;Perjantai;12;6;18;0;2;2
96;30.09.2017;2017;09;00;Lauantai;5;4;9;2;0;2
96;30.09.2017;2017;09;01;Lauantai;9;1;10;2;0;2
96;30.09.2017;2017;09;02;Lauantai;7;2;9;3;1;4
96;30.09.2017;2017;09;03;Lauantai;6;3;9;0;0;0
96;30.09.2017;2017;09;04;Lauantai;11;0;11;0;1;1
96;30.09.2017;2017;09;05;Lauantai;1;4;5;0;1;1
96;30.09.2017;2017;09;06;Lauantai;18;13;31;2;1;3
96;30.09.2017;2017;09;07;Lauantai;6;15;21;0;1;1
96;30.09.2017;2017;09;08;Lauantai;9;23;32;5;3;8
96;30.09.2017;2017;09;09;Lauantai;13;42;55;4;5;9
96;30.09.2017;2017;09;10;Lauantai;17;50;67;1;6;7
96;30.09.2017;2017;09;11;Lauantai;24;46;70;7;9;16
96;30.09.2017;2017;09;12;Lauantai;44;56;100;1;13;14
96;30.09.2017;2017;09;13;Lauantai;61;47;108;9;13;22
96;30.09.2017;2017;09;14;Lauantai;47;56;103;14;15;29
96;30.09.2017;2017;09;15;Lauantai;60;51;111;18;14;32
96;30.09.2017;2017;09;16;Lauantai;56;69;125;21;20;41
96;30.09.2017;2017;09;17;Lauantai;56;45;101;14;19;33
96;30.09.2017;2017;09;18;Lauantai;36;45;81;11;15;26
96;30.09.2017;2017;09;19;Lauantai;81;36;117;37;30;67
96;30.09.2017;2017;09;20;Lauantai;32;16;48;12;8;20
96;30.09.2017;2017;09;21;Lauantai;15;39;54;2;12;14
96;30.09.2017;2017;09;22;Lauantai;10;14;24;1;8;9
96;30.09.2017;2017;09;23;Lauantai;14;7;21;5;1;6
96;01.10.2017;2017;10;00;Sunnuntai;3;7;10;3;0;3
96;01.10.2017;2017;10;01;Sunnuntai;10;4;14;3;0;3
96;01.10.2017;2017;10;02;Sunnuntai;15;4;19;0;0;0
96;01.10.2017;2017;10;03;Sunnuntai;13;1;14;1;0;1
96;01.10.2017;2017;10;04;Sunnuntai;11;0;11;1;0;1
96;01.10.2017;2017;10;05;Sunnuntai;4;2;6;0;0;0
96;01.10.2017;2017;10;06;Sunnuntai;15;3;18;4;0;4
96;01.10.2017;2017;10;07;Sunnuntai;0;11;11;1;1;2
96;01.10.2017;2017;10;08;Sunnuntai;2;7;9;2;2;4
96;01.10.2017;2017;10;09;Sunnuntai;8;19;27;1;3;4
96;01.10.2017;2017;10;10;Sunnuntai;13;23;36;4;6;10
96;01.10.2017;2017;10;11;Sunnuntai;26;55;81;7;16;23
96;01.10.2017;2017;10;12;Sunnuntai;43;49;92;17;10;27
96;01.10.2017;2017;10;13;Sunnuntai;41;38;79;10;10;20
96;01.10.2017;2017;10;14;Sunnuntai;48;54;102;13;16;29
96;01.10.2017;2017;10;15;Sunnuntai;30;41;71;8;18;26
96;01.10.2017;2017;10;16;Sunnuntai;59;23;82;26;15;41
96;01.10.2017;2017;10;17;Sunnuntai;39;39;78;19;15;34
96;01.10.2017;2017;10;18;Sunnuntai;45;32;77;15;27;42
96;01.10.2017;2017;10;19;Sunnuntai;24;34;58;8;3;11
96;01.10.2017;2017;10;20;Sunnuntai;14;34;48;8;18;26
96;01.10.2017;2017;10;21;Sunnuntai;20;20;40;8;8;16
96;01.10.2017;2017;10;22;Sunnuntai;5;5;10;1;1;2
96;01.10.2017;2017;10;23;Sunnuntai;7;6;13;1;2;3
96;02.10.2017;2017;10;00;Maanantai;5;2;7;1;0;1
96;02.10.2017;2017;10;01;Maanantai;0;0;0;0;0;0
96;02.10.2017;2017;10;02;Maanantai;2;0;2;0;0;0
96;02.10.2017;2017;10;03;Maanantai;2;0;2;0;0;0
96;02.10.2017;2017;10;04;Maanantai;2;1;3;0;0;0
96;02.10.2017;2017;10;05;Maanantai;3;5;8;0;0;0
96;02.10.2017;2017;10;06;Maanantai;58;23;81;3;2;5
96;02.10.2017;2017;10;07;Maanantai;136;148;284;18;6;24
96;02.10.2017;2017;10;08;Maanantai;180;139;319;16;3;19
96;02.10.2017;2017;10;09;Maanantai;108;78;186;14;13;27
96;02.10.2017;2017;10;10;Maanantai;82;62;144;11;12;23
96;02.10.2017;2017;10;11;Maanantai;91;96;187;13;21;34
96;02.10.2017;2017;10;12;Maanantai;118;124;242;17;10;27
96;02.10.2017;2017;10;13;Maanantai;77;100;177;10;18;28
96;02.10.2017;2017;10;14;Maanantai;90;177;267;6;22;28
96;02.10.2017;2017;10;15;Maanantai;90;246;336;9;34;43
96;02.10.2017;2017;10;16;Maanantai;150;240;390;9;22;31
96;02.10.2017;2017;10;17;Maanantai;100;101;201;11;31;42
96;02.10.2017;2017;10;18;Maanantai;73;72;145;14;16;30
96;02.10.2017;2017;10;19;Maanantai;68;45;113;14;19;33
96;02.10.2017;2017;10;20;Maanantai;45;32;77;7;17;24
96;02.10.2017;2017;10;21;Maanantai;26;26;52;6;4;10
96;02.10.2017;2017;10;22;Maanantai;8;11;19;1;5;6
96;02.10.2017;2017;10;23;Maanantai;1;1;2;0;0;0
96;03.10.2017;2017;10;00;Tiistai;1;3;4;0;0;0
96;03.10.2017;2017;10;01;Tiistai;2;0;2;2;0;2
96;03.10.2017;2017;10;02;Tiistai;1;0;1;0;0;0
96;03.10.2017;2017;10;03;Tiistai;1;0;1;0;0;0
96;03.10.2017;2017;10;04;Tiistai;1;0;1;1;0;1
96;03.10.2017;2017;10;05;Tiistai;1;9;10;0;0;0
96;03.10.2017;2017;10;06;Tiistai;44;33;77;5;1;6
96;03.10.2017;2017;10;07;Tiistai;174;130;304;15;5;20
96;03.10.2017;2017;10;08;Tiistai;206;123;329;15;5;20
96;03.10.2017;2017;10;09;Tiistai;111;68;179;14;10;24
96;03.10.2017;2017;10;10;Tiistai;67;56;123;10;8;18
96;03.10.2017;2017;10;11;Tiistai;80;93;173;11;12;23
96;03.10.2017;2017;10;12;Tiistai;77;127;204;9;14;23
96;03.10.2017;2017;10;13;Tiistai;59;94;153;5;13;18
96;03.10.2017;2017;10;14;Tiistai;80;158;238;9;26;35
96;03.10.2017;2017;10;15;Tiistai;103;250;353;5;27;32
96;03.10.2017;2017;10;16;Tiistai;102;249;351;5;12;17
96;03.10.2017;2017;10;17;Tiistai;81;85;166;5;11;16
96;03.10.2017;2017;10;18;Tiistai;54;66;120;12;11;23
96;03.10.2017;2017;10;19;Tiistai;65;36;101;12;9;21
96;03.10.2017;2017;10;20;Tiistai;51;30;81;5;13;18
96;03.10.2017;2017;10;21;Tiistai;19;33;52;5;6;11
96;03.10.2017;2017;10;22;Tiistai;5;9;14;1;4;5
96;03.10.2017;2017;10;23;Tiistai;5;5;10;2;0;2
96;04.10.2017;2017;10;00;Keskiviikko;1;3;4;0;0;0
96;04.10.2017;2017;10;01;Keskiviikko;1;0;1;0;0;0
96;04.10.2017;2017;10;02;Keskiviikko;8;1;9;0;0;0
96;04.10.2017;2017;10;03;Keskiviikko;2;1;3;0;0;0
96;04.10.2017;2017;10;04;Keskiviikko;4;0;4;0;0;0
96;04.10.2017;2017;10;05;Keskiviikko;2;8;10;1;0;1
96;04.10.2017;2017;10;06;Keskiviikko;51;30;81;5;0;5
96;04.10.2017;2017;10;07;Keskiviikko;124;127;251;24;8;32
96;04.10.2017;2017;10;08;Keskiviikko;180;125;305;13;6;19
96;04.10.2017;2017;10;09;Keskiviikko;104;77;181;16;9;25
96;04.10.2017;2017;10;10;Keskiviikko;42;66;108;15;18;33
96;04.10.2017;2017;10;11;Keskiviikko;96;78;174;9;9;18
96;04.10.2017;2017;10;12;Keskiviikko;96;93;189;9;11;20
96;04.10.2017;2017;10;13;Keskiviikko;68;108;176;4;9;13
96;04.10.2017;2017;10;14;Keskiviikko;72;154;226;5;16;21
96;04.10.2017;2017;10;15;Keskiviikko;71;228;299;6;28;34
96;04.10.2017;2017;10;16;Keskiviikko;102;204;306;2;22;24
96;04.10.2017;2017;10;17;Keskiviikko;74;87;161;7;19;26
96;04.10.2017;2017;10;18;Keskiviikko;84;59;143;17;15;32
96;04.10.2017;2017;10;19;Keskiviikko;60;46;106;17;20;37
96;04.10.2017;2017;10;20;Keskiviikko;54;55;109;14;9;23
96;04.10.2017;2017;10;21;Keskiviikko;30;47;77;3;4;7
96;04.10.2017;2017;10;22;Keskiviikko;8;11;19;1;3;4
96;04.10.2017;2017;10;23;Keskiviikko;2;3;5;0;1;1
96;05.10.2017;2017;10;00;Torstai;3;2;5;0;0;0
96;05.10.2017;2017;10;01;Torstai;0;0;0;0;0;0
96;05.10.2017;2017;10;02;Torstai;4;1;5;1;1;2
96;05.10.2017;2017;10;03;Torstai;0;0;0;0;0;0
96;05.10.2017;2017;10;04;Torstai;3;0;3;0;0;0
96;05.10.2017;2017;10;05;Torstai;7;9;16;1;0;1
96;05.10.2017;2017;10;06;Torstai;53;30;83;6;1;7
96;05.10.2017;2017;10;07;Torstai;133;104;237;22;4;26
96;05.10.2017;2017;10;08;Torstai;181;115;296;12;4;16
96;05.10.2017;2017;10;09;Torstai;121;79;200;6;6;12
96;05.10.2017;2017;10;10;Torstai;66;93;159;10;12;22
96;05.10.2017;2017;10;11;Torstai;110;102;212;12;9;21
96;05.10.2017;2017;10;12;Torstai;115;144;259;10;9;19
96;05.10.2017;2017;10;13;Torstai;99;98;197;10;22;32
96;05.10.2017;2017;10;14;Torstai;97;183;280;7;25;32
96;05.10.2017;2017;10;15;Torstai;86;214;300;11;24;35
96;05.10.2017;2017;10;16;Torstai;115;200;315;9;22;31
96;05.10.2017;2017;10;17;Torstai;85;105;190;11;20;31
96;05.10.2017;2017;10;18;Torstai;69;54;123;14;15;29
96;05.10.2017;2017;10;19;Torstai;63;48;111;8;29;37
96;05.10.2017;2017;10;20;Torstai;35;41;76;7;7;14
96;05.10.2017;2017;10;21;Torstai;33;58;91;4;5;9
96;05.10.2017;2017;10;22;Torstai;14;18;32;1;3;4
96;05.10.2017;2017;10;23;Torstai;4;4;8;1;2;3
96;06.10.2017;2017;10;00;Perjantai;4;2;6;2;0;2
96;06.10.2017;2017;10;01;Perjantai;5;1;6;1;0;1
96;06.10.2017;2017;10;02;Perjantai;8;0;8;0;0;0
96;06.10.2017;2017;10;03;Perjantai;6;0;6;1;0;1
96;06.10.2017;2017;10;04;Perjantai;3;1;4;2;0;2
96;06.10.2017;2017;10;05;Perjantai;1;6;7;0;1;1
96;06.10.2017;2017;10;06;Perjantai;52;34;86;4;1;5
96;06.10.2017;2017;10;07;Perjantai;125;111;236;14;6;20
96;06.10.2017;2017;10;08;Perjantai;131;120;251;14;2;16
96;06.10.2017;2017;10;09;Perjantai;77;75;152;7;6;13
96;06.10.2017;2017;10;10;Perjantai;74;85;159;8;12;20
96;06.10.2017;2017;10;11;Perjantai;52;113;165;8;12;20
96;06.10.2017;2017;10;12;Perjantai;98;92;190;9;15;24
96;06.10.2017;2017;10;13;Perjantai;95;111;206;10;19;29
96;06.10.2017;2017;10;14;Perjantai;91;223;314;9;21;30
96;06.10.2017;2017;10;15;Perjantai;100;176;276;7;30;37
96;06.10.2017;2017;10;16;Perjantai;85;95;180;5;11;16
96;06.10.2017;2017;10;17;Perjantai;47;49;96;9;9;18
96;06.10.2017;2017;10;18;Perjantai;44;35;79;10;16;26
96;06.10.2017;2017;10;19;Perjantai;52;27;79;11;8;19
96;06.10.2017;2017;10;20;Perjantai;31;21;52;9;5;14
96;06.10.2017;2017;10;21;Perjantai;24;35;59;3;6;9
96;06.10.2017;2017;10;22;Perjantai;5;20;25;2;4;6
96;06.10.2017;2017;10;23;Perjantai;5;11;16;4;1;5
96;07.10.2017;2017;10;00;Lauantai;13;3;16;0;0;0
96;07.10.2017;2017;10;01;Lauantai;10;3;13;1;0;1
96;07.10.2017;2017;10;02;Lauantai;5;0;5;0;1;1
96;07.10.2017;2017;10;03;Lauantai;7;0;7;2;1;3
96;07.10.2017;2017;10;04;Lauantai;7;1;8;0;0;0
96;07.10.2017;2017;10;05;Lauantai;2;2;4;1;0;1
96;07.10.2017;2017;10;06;Lauantai;19;4;23;4;0;4
96;07.10.2017;2017;10;07;Lauantai;8;10;18;1;2;3
96;07.10.2017;2017;10;08;Lauantai;10;21;31;3;5;8
96;07.10.2017;2017;10;09;Lauantai;13;40;53;3;8;11
96;07.10.2017;2017;10;10;Lauantai;13;37;50;4;12;16
96;07.10.2017;2017;10;11;Lauantai;41;45;86;8;7;15
96;07.10.2017;2017;10;12;Lauantai;30;55;85;9;14;23
96;07.10.2017;2017;10;13;Lauantai;48;40;88;12;11;23
96;07.10.2017;2017;10;14;Lauantai;49;68;117;8;8;16
96;07.10.2017;2017;10;15;Lauantai;45;56;101;10;16;26
96;07.10.2017;2017;10;16;Lauantai;53;73;126;7;18;25
96;07.10.2017;2017;10;17;Lauantai;34;34;68;8;7;15
96;07.10.2017;2017;10;18;Lauantai;48;30;78;17;9;26
96;07.10.2017;2017;10;19;Lauantai;65;23;88;9;6;15
96;07.10.2017;2017;10;20;Lauantai;22;31;53;6;20;26
96;07.10.2017;2017;10;21;Lauantai;18;30;48;1;6;7
96;07.10.2017;2017;10;22;Lauantai;15;9;24;2;5;7
96;07.10.2017;2017;10;23;Lauantai;10;5;15;1;1;2
96;08.10.2017;2017;10;00;Sunnuntai;16;3;19;0;0;0
96;08.10.2017;2017;10;01;Sunnuntai;12;6;18;2;0;2
96;08.10.2017;2017;10;02;Sunnuntai;9;2;11;0;0;0
96;08.10.2017;2017;10;03;Sunnuntai;16;1;17;4;0;4
96;08.10.2017;2017;10;04;Sunnuntai;9;0;9;2;0;2
96;08.10.2017;2017;10;05;Sunnuntai;5;1;6;2;3;5
96;08.10.2017;2017;10;06;Sunnuntai;15;6;21;2;0;2
96;08.10.2017;2017;10;07;Sunnuntai;1;9;10;1;2;3
96;08.10.2017;2017;10;08;Sunnuntai;6;7;13;0;4;4
96;08.10.2017;2017;10;09;Sunnuntai;11;14;25;7;3;10
96;08.10.2017;2017;10;10;Sunnuntai;16;29;45;4;8;12
96;08.10.2017;2017;10;11;Sunnuntai;23;38;61;7;12;19
96;08.10.2017;2017;10;12;Sunnuntai;41;35;76;8;4;12
96;08.10.2017;2017;10;13;Sunnuntai;33;51;84;7;5;12
96;08.10.2017;2017;10;14;Sunnuntai;41;56;97;6;7;13
96;08.10.2017;2017;10;15;Sunnuntai;51;35;86;11;19;30
96;08.10.2017;2017;10;16;Sunnuntai;51;32;83;22;4;26
96;08.10.2017;2017;10;17;Sunnuntai;44;28;72;20;17;37
96;08.10.2017;2017;10;18;Sunnuntai;41;38;79;15;20;35
96;08.10.2017;2017;10;19;Sunnuntai;28;26;54;5;14;19
96;08.10.2017;2017;10;20;Sunnuntai;26;35;61;7;10;17
96;08.10.2017;2017;10;21;Sunnuntai;21;15;36;4;4;8
96;08.10.2017;2017;10;22;Sunnuntai;14;10;24;1;2;3
96;08.10.2017;2017;10;23;Sunnuntai;8;3;11;0;0;0
96;09.10.2017;2017;10;00;Maanantai;3;3;6;1;1;2
96;09.10.2017;2017;10;01;Maanantai;1;0;1;0;0;0
96;09.10.2017;2017;10;02;Maanantai;1;0;1;0;0;0
96;09.10.2017;2017;10;03;Maanantai;0;0;0;1;0;1
96;09.10.2017;2017;10;04;Maanantai;1;1;2;0;0;0
96;09.10.2017;2017;10;05;Maanantai;2;8;10;0;0;0
96;09.10.2017;2017;10;06;Maanantai;61;37;98;3;2;5
96;09.10.2017;2017;10;07;Maanantai;122;111;233;18;7;25
96;09.10.2017;2017;10;08;Maanantai;170;148;318;8;7;15
96;09.10.2017;2017;10;09;Maanantai;113;77;190;16;14;30
96;09.10.2017;2017;10;10;Maanantai;72;70;142;10;18;28
96;09.10.2017;2017;10;11;Maanantai;80;95;175;26;11;37
96;09.10.2017;2017;10;12;Maanantai;92;116;208;9;26;35
96;09.10.2017;2017;10;13;Maanantai;72;106;178;12;9;21
96;09.10.2017;2017;10;14;Maanantai;95;164;259;8;11;19
96;09.10.2017;2017;10;15;Maanantai;94;247;341;7;28;35
96;09.10.2017;2017;10;16;Maanantai;102;260;362;16;32;48
96;09.10.2017;2017;10;17;Maanantai;75;99;174;10;23;33
96;09.10.2017;2017;10;18;Maanantai;91;64;155;12;16;28
96;09.10.2017;2017;10;19;Maanantai;54;44;98;19;25;44
96;09.10.2017;2017;10;20;Maanantai;63;27;90;13;16;29
96;09.10.2017;2017;10;21;Maanantai;36;40;76;6;4;10
96;09.10.2017;2017;10;22;Maanantai;5;5;10;1;3;4
96;09.10.2017;2017;10;23;Maanantai;2;3;5;0;2;2
96;10.10.2017;2017;10;00;Tiistai;1;2;3;0;0;0
96;10.10.2017;2017;10;01;Tiistai;0;1;1;1;0;1
96;10.10.2017;2017;10;02;Tiistai;1;0;1;0;0;0
96;10.10.2017;2017;10;03;Tiistai;1;1;2;0;0;0
96;10.10.2017;2017;10;04;Tiistai;1;0;1;0;0;0
96;10.10.2017;2017;10;05;Tiistai;3;6;9;0;0;0
96;10.10.2017;2017;10;06;Tiistai;54;30;84;3;3;6
96;10.10.2017;2017;10;07;Tiistai;119;104;223;15;5;20
96;10.10.2017;2017;10;08;Tiistai;143;104;247;13;8;21
96;10.10.2017;2017;10;09;Tiistai;98;41;139;14;5;19
96;10.10.2017;2017;10;10;Tiistai;51;37;88;7;5;12
96;10.10.2017;2017;10;11;Tiistai;59;42;101;7;14;21
96;10.10.2017;2017;10;12;Tiistai;74;77;151;12;0;12
96;10.10.2017;2017;10;13;Tiistai;56;85;141;4;11;15
96;10.10.2017;2017;10;14;Tiistai;71;132;203;5;19;24
96;10.10.2017;2017;10;15;Tiistai;46;260;306;8;27;35
96;10.10.2017;2017;10;16;Tiistai;64;186;250;8;33;41
96;10.10.2017;2017;10;17;Tiistai;61;90;151;14;11;25
96;10.10.2017;2017;10;18;Tiistai;48;43;91;13;11;24
96;10.10.2017;2017;10;19;Tiistai;53;39;92;12;11;23
96;10.10.2017;2017;10;20;Tiistai;38;37;75;3;5;8
96;10.10.2017;2017;10;21;Tiistai;19;42;61;2;5;7
96;10.10.2017;2017;10;22;Tiistai;8;9;17;0;2;2
96;10.10.2017;2017;10;23;Tiistai;8;3;11;1;0;1
96;11.10.2017;2017;10;00;Keskiviikko;2;0;2;1;0;1
96;11.10.2017;2017;10;01;Keskiviikko;2;1;3;0;0;0
96;11.10.2017;2017;10;02;Keskiviikko;0;0;0;0;0;0
96;11.10.2017;2017;10;03;Keskiviikko;2;1;3;1;0;1
96;11.10.2017;2017;10;04;Keskiviikko;1;0;1;0;1;1
96;11.10.2017;2017;10;05;Keskiviikko;3;7;10;2;0;2
96;11.10.2017;2017;10;06;Keskiviikko;58;29;87;6;2;8
96;11.10.2017;2017;10;07;Keskiviikko;131;117;248;20;14;34
96;11.10.2017;2017;10;08;Keskiviikko;213;148;361;15;11;26
96;11.10.2017;2017;10;09;Keskiviikko;95;83;178;11;11;22
96;11.10.2017;2017;10;10;Keskiviikko;64;71;135;21;43;64
96;11.10.2017;2017;10;11;Keskiviikko;94;87;181;11;9;20
96;11.10.2017;2017;10;12;Keskiviikko;84;125;209;10;14;24
96;11.10.2017;2017;10;13;Keskiviikko;74;90;164;11;20;31
96;11.10.2017;2017;10;14;Keskiviikko;71;169;240;12;18;30
96;11.10.2017;2017;10;15;Keskiviikko;76;236;312;10;30;40
96;11.10.2017;2017;10;16;Keskiviikko;109;218;327;12;20;32
96;11.10.2017;2017;10;17;Keskiviikko;69;93;162;10;16;26
96;11.10.2017;2017;10;18;Keskiviikko;104;90;194;19;20;39
96;11.10.2017;2017;10;19;Keskiviikko;70;60;130;104;19;123
96;11.10.2017;2017;10;20;Keskiviikko;54;58;112;21;17;38
96;11.10.2017;2017;10;21;Keskiviikko;18;45;63;5;4;9
96;11.10.2017;2017;10;22;Keskiviikko;12;11;23;1;2;3
96;11.10.2017;2017;10;23;Keskiviikko;4;5;9;2;0;2
96;12.10.2017;2017;10;00;Torstai;2;1;3;0;0;0
96;12.10.2017;2017;10;01;Torstai;2;0;2;1;1;2
96;12.10.2017;2017;10;02;Torstai;3;0;3;1;2;3
96;12.10.2017;2017;10;03;Torstai;2;0;2;0;0;0
96;12.10.2017;2017;10;04;Torstai;3;0;3;1;0;1
96;12.10.2017;2017;10;05;Torstai;2;5;7;1;0;1
96;12.10.2017;2017;10;06;Torstai;49;21;70;7;3;10
96;12.10.2017;2017;10;07;Torstai;137;117;254;28;7;35
96;12.10.2017;2017;10;08;Torstai;174;114;288;17;9;26
96;12.10.2017;2017;10;09;Torstai;115;83;198;16;8;24
96;12.10.2017;2017;10;10;Torstai;74;101;175;7;12;19
96;12.10.2017;2017;10;11;Torstai;89;92;181;15;13;28
96;12.10.2017;2017;10;12;Torstai;136;103;239;17;21;38
96;12.10.2017;2017;10;13;Torstai;83;119;202;10;14;24
96;12.10.2017;2017;10;14;Torstai;87;180;267;9;25;34
96;12.10.2017;2017;10;15;Torstai;81;261;342;6;28;34
96;12.10.2017;2017;10;16;Torstai;115;196;311;8;21;29
96;12.10.2017;2017;10;17;Torstai;92;91;183;9;14;23
96;12.10.2017;2017;10;18;Torstai;64;59;123;15;12;27
96;12.10.2017;2017;10;19;Torstai;52;38;90;9;12;21
96;12.10.2017;2017;10;20;Torstai;50;42;92;6;10;16
96;12.10.2017;2017;10;21;Torstai;22;55;77;7;6;13
96;12.10.2017;2017;10;22;Torstai;15;21;36;1;1;2
96;12.10.2017;2017;10;23;Torstai;3;12;15;3;0;3
96;13.10.2017;2017;10;00;Perjantai;5;1;6;0;2;2
96;13.10.2017;2017;10;01;Perjantai;3;3;6;0;0;0
96;13.10.2017;2017;10;02;Perjantai;6;2;8;2;0;2
96;13.10.2017;2017;10;03;Perjantai;3;2;5;0;0;0
96;13.10.2017;2017;10;04;Perjantai;2;2;4;0;0;0
96;13.10.2017;2017;10;05;Perjantai;2;7;9;1;0;1
96;13.10.2017;2017;10;06;Perjantai;52;29;81;5;3;8
96;13.10.2017;2017;10;07;Perjantai;131;122;253;18;1;19
96;13.10.2017;2017;10;08;Perjantai;160;118;278;16;4;20
96;13.10.2017;2017;10;09;Perjantai;66;89;155;5;5;10
96;13.10.2017;2017;10;10;Perjantai;84;72;156;16;13;29
96;13.10.2017;2017;10;11;Perjantai;67;115;182;9;15;24
96;13.10.2017;2017;10;12;Perjantai;101;100;201;9;7;16
96;13.10.2017;2017;10;13;Perjantai;80;140;220;6;15;21
96;13.10.2017;2017;10;14;Perjantai;82;243;325;13;22;35
96;13.10.2017;2017;10;15;Perjantai;88;176;264;9;23;32
96;13.10.2017;2017;10;16;Perjantai;90;112;202;5;16;21
96;13.10.2017;2017;10;17;Perjantai;66;63;129;3;10;13
96;13.10.2017;2017;10;18;Perjantai;53;41;94;11;8;19
96;13.10.2017;2017;10;19;Perjantai;31;45;76;8;21;29
96;13.10.2017;2017;10;20;Perjantai;26;37;63;4;4;8
96;13.10.2017;2017;10;21;Perjantai;25;35;60;3;6;9
96;13.10.2017;2017;10;22;Perjantai;12;10;22;4;2;6
96;13.10.2017;2017;10;23;Perjantai;10;4;14;2;1;3
96;14.10.2017;2017;10;00;Lauantai;3;3;6;1;1;2
96;14.10.2017;2017;10;01;Lauantai;19;3;22;3;1;4
96;14.10.2017;2017;10;02;Lauantai;10;0;10;1;1;2
96;14.10.2017;2017;10;03;Lauantai;6;1;7;0;1;1
96;14.10.2017;2017;10;04;Lauantai;7;0;7;1;1;2
96;14.10.2017;2017;10;05;Lauantai;1;0;1;0;0;0
96;14.10.2017;2017;10;06;Lauantai;31;8;39;0;2;2
96;14.10.2017;2017;10;07;Lauantai;6;19;25;3;3;6
96;14.10.2017;2017;10;08;Lauantai;7;16;23;6;5;11
96;14.10.2017;2017;10;09;Lauantai;9;48;57;4;11;15
96;14.10.2017;2017;10;10;Lauantai;16;64;80;9;65;74
96;14.10.2017;2017;10;11;Lauantai;34;48;82;14;42;56
96;14.10.2017;2017;10;12;Lauantai;60;56;116;48;41;89
96;14.10.2017;2017;10;13;Lauantai;54;77;131;73;26;99
96;14.10.2017;2017;10;14;Lauantai;60;70;130;82;7;89
96;14.10.2017;2017;10;15;Lauantai;78;59;137;47;12;59
96;14.10.2017;2017;10;16;Lauantai;53;44;97;30;6;36
96;14.10.2017;2017;10;17;Lauantai;42;16;58;19;2;21
96;14.10.2017;2017;10;18;Lauantai;30;9;39;5;3;8
96;14.10.2017;2017;10;19;Lauantai;28;13;41;11;3;14
96;14.10.2017;2017;10;20;Lauantai;19;14;33;2;8;10
96;14.10.2017;2017;10;21;Lauantai;13;25;38;0;3;3
96;14.10.2017;2017;10;22;Lauantai;14;12;26;0;3;3
96;14.10.2017;2017;10;23;Lauantai;5;4;9;0;0;0
96;15.10.2017;2017;10;00;Sunnuntai;4;6;10;3;0;3
96;15.10.2017;2017;10;01;Sunnuntai;2;7;9;0;2;2
96;15.10.2017;2017;10;02;Sunnuntai;9;4;13;1;0;1
96;15.10.2017;2017;10;03;Sunnuntai;9;1;10;1;0;1
96;15.10.2017;2017;10;04;Sunnuntai;4;1;5;2;0;2
96;15.10.2017;2017;10;05;Sunnuntai;2;3;5;0;0;0
96;15.10.2017;2017;10;06;Sunnuntai;25;3;28;1;0;1
96;15.10.2017;2017;10;07;Sunnuntai;4;8;12;1;0;1
96;15.10.2017;2017;10;08;Sunnuntai;6;12;18;2;5;7
96;15.10.2017;2017;10;09;Sunnuntai;3;22;25;4;4;8
96;15.10.2017;2017;10;10;Sunnuntai;14;29;43;9;16;25
96;15.10.2017;2017;10;11;Sunnuntai;18;50;68;7;109;116
96;15.10.2017;2017;10;12;Sunnuntai;47;51;98;36;22;58
96;15.10.2017;2017;10;13;Sunnuntai;55;54;109;66;27;93
96;15.10.2017;2017;10;14;Sunnuntai;52;69;121;53;19;72
96;15.10.2017;2017;10;15;Sunnuntai;48;49;97;43;14;57
96;15.10.2017;2017;10;16;Sunnuntai;55;23;78;36;12;48
96;15.10.2017;2017;10;17;Sunnuntai;60;27;87;15;17;32
96;15.10.2017;2017;10;18;Sunnuntai;56;46;102;16;19;35
96;15.10.2017;2017;10;19;Sunnuntai;11;28;39;14;17;31
96;15.10.2017;2017;10;20;Sunnuntai;20;30;50;3;7;10
96;15.10.2017;2017;10;21;Sunnuntai;18;26;44;2;3;5
96;15.10.2017;2017;10;22;Sunnuntai;3;3;6;1;2;3
96;15.10.2017;2017;10;23;Sunnuntai;8;1;9;1;0;1
96;16.10.2017;2017;10;00;Maanantai;5;1;6;1;0;1
96;16.10.2017;2017;10;01;Maanantai;0;0;0;0;0;0
96;16.10.2017;2017;10;02;Maanantai;3;0;3;1;0;1
96;16.10.2017;2017;10;03;Maanantai;2;0;2;1;2;3
96;16.10.2017;2017;10;04;Maanantai;2;0;2;0;0;0
96;16.10.2017;2017;10;05;Maanantai;3;4;7;0;0;0
96;16.10.2017;2017;10;06;Maanantai;50;32;82;4;1;5
96;16.10.2017;2017;10;07;Maanantai;122;95;217;18;10;28
96;16.10.2017;2017;10;08;Maanantai;147;98;245;18;13;31
96;16.10.2017;2017;10;09;Maanantai;66;48;114;12;2;14
96;16.10.2017;2017;10;10;Maanantai;58;48;106;4;5;9
96;16.10.2017;2017;10;11;Maanantai;57;53;110;7;7;14
96;16.10.2017;2017;10;12;Maanantai;64;65;129;15;5;20
96;16.10.2017;2017;10;13;Maanantai;36;75;111;2;6;8
96;16.10.2017;2017;10;14;Maanantai;53;118;171;10;16;26
96;16.10.2017;2017;10;15;Maanantai;72;235;307;9;25;34
96;16.10.2017;2017;10;16;Maanantai;93;212;305;13;23;36
96;16.10.2017;2017;10;17;Maanantai;83;96;179;18;17;35
96;16.10.2017;2017;10;18;Maanantai;72;51;123;14;19;33
96;16.10.2017;2017;10;19;Maanantai;64;37;101;13;18;31
96;16.10.2017;2017;10;20;Maanantai;52;36;88;10;11;21
96;16.10.2017;2017;10;21;Maanantai;29;28;57;7;7;14
96;16.10.2017;2017;10;22;Maanantai;8;3;11;2;1;3
96;16.10.2017;2017;10;23;Maanantai;2;3;5;0;0;0
96;17.10.2017;2017;10;00;Tiistai;1;1;2;0;0;0
96;17.10.2017;2017;10;01;Tiistai;1;0;1;0;1;1
96;17.10.2017;2017;10;02;Tiistai;1;1;2;0;0;0
96;17.10.2017;2017;10;03;Tiistai;0;0;0;0;0;0
96;17.10.2017;2017;10;04;Tiistai;0;1;1;1;0;1
96;17.10.2017;2017;10;05;Tiistai;5;4;9;1;0;1
96;17.10.2017;2017;10;06;Tiistai;54;26;80;2;2;4
96;17.10.2017;2017;10;07;Tiistai;134;121;255;24;2;26
96;17.10.2017;2017;10;08;Tiistai;151;153;304;13;11;24
96;17.10.2017;2017;10;09;Tiistai;118;65;183;13;10;23
96;17.10.2017;2017;10;10;Tiistai;67;72;139;14;8;22
96;17.10.2017;2017;10;11;Tiistai;98;66;164;11;20;31
96;17.10.2017;2017;10;12;Tiistai;99;84;183;14;16;30
96;17.10.2017;2017;10;13;Tiistai;69;103;172;17;22;39
96;17.10.2017;2017;10;14;Tiistai;90;165;255;11;21;32
96;17.10.2017;2017;10;15;Tiistai;99;258;357;8;33;41
96;17.10.2017;2017;10;16;Tiistai;113;250;363;15;34;49
96;17.10.2017;2017;10;17;Tiistai;99;104;203;11;17;28
96;17.10.2017;2017;10;18;Tiistai;86;82;168;16;20;36
96;17.10.2017;2017;10;19;Tiistai;71;59;130;8;21;29
96;17.10.2017;2017;10;20;Tiistai;61;44;105;10;9;19
96;17.10.2017;2017;10;21;Tiistai;22;44;66;8;3;11
96;17.10.2017;2017;10;22;Tiistai;16;12;28;3;1;4
96;17.10.2017;2017;10;23;Tiistai;1;6;7;1;0;1
96;18.10.2017;2017;10;00;Keskiviikko;3;3;6;0;1;1
96;18.10.2017;2017;10;01;Keskiviikko;0;2;2;0;0;0
96;18.10.2017;2017;10;02;Keskiviikko;0;1;1;0;0;0
96;18.10.2017;2017;10;03;Keskiviikko;0;0;0;0;0;0
96;18.10.2017;2017;10;04;Keskiviikko;1;0;1;1;1;2
96;18.10.2017;2017;10;05;Keskiviikko;4;5;9;0;0;0
96;18.10.2017;2017;10;06;Keskiviikko;56;29;85;5;1;6
96;18.10.2017;2017;10;07;Keskiviikko;151;115;266;25;6;31
96;18.10.2017;2017;10;08;Keskiviikko;191;132;323;20;8;28
96;18.10.2017;2017;10;09;Keskiviikko;82;90;172;20;17;37
96;18.10.2017;2017;10;10;Keskiviikko;61;55;116;9;15;24
96;18.10.2017;2017;10;11;Keskiviikko;108;93;201;10;13;23
96;18.10.2017;2017;10;12;Keskiviikko;85;99;184;10;16;26
96;18.10.2017;2017;10;13;Keskiviikko;92;92;184;7;15;22
96;18.10.2017;2017;10;14;Keskiviikko;67;167;234;9;28;37
96;18.10.2017;2017;10;15;Keskiviikko;84;214;298;16;27;43
96;18.10.2017;2017;10;16;Keskiviikko;111;217;328;19;20;39
96;18.10.2017;2017;10;17;Keskiviikko;87;88;175;4;15;19
96;18.10.2017;2017;10;18;Keskiviikko;93;92;185;26;20;46
96;18.10.2017;2017;10;19;Keskiviikko;64;48;112;11;18;29
96;18.10.2017;2017;10;20;Keskiviikko;57;54;111;10;15;25
96;18.10.2017;2017;10;21;Keskiviikko;73;48;121;11;5;16
96;18.10.2017;2017;10;22;Keskiviikko;16;21;37;3;3;6
96;18.10.2017;2017;10;23;Keskiviikko;4;7;11;1;6;7
96;19.10.2017;2017;10;00;Torstai;1;6;7;0;2;2
96;19.10.2017;2017;10;01;Torstai;1;2;3;0;0;0
96;19.10.2017;2017;10;02;Torstai;3;13;16;1;2;3
96;19.10.2017;2017;10;03;Torstai;2;0;2;0;0;0
96;19.10.2017;2017;10;04;Torstai;1;1;2;1;0;1
96;19.10.2017;2017;10;05;Torstai;6;10;16;1;0;1
96;19.10.2017;2017;10;06;Torstai;45;22;67;8;4;12
96;19.10.2017;2017;10;07;Torstai;132;114;246;29;6;35
96;19.10.2017;2017;10;08;Torstai;150;111;261;16;7;23
96;19.10.2017;2017;10;09;Torstai;109;74;183;11;12;23
96;19.10.2017;2017;10;10;Torstai;85;59;144;4;8;12
96;19.10.2017;2017;10;11;Torstai;83;68;151;11;17;28
96;19.10.2017;2017;10;12;Torstai;85;121;206;17;21;38
96;19.10.2017;2017;10;13;Torstai;65;127;192;22;30;52
96;19.10.2017;2017;10;14;Torstai;91;160;251;8;15;23
96;19.10.2017;2017;10;15;Torstai;97;223;320;8;24;32
96;19.10.2017;2017;10;16;Torstai;96;194;290;15;39;54
96;19.10.2017;2017;10;17;Torstai;74;88;162;16;12;28
96;19.10.2017;2017;10;18;Torstai;53;70;123;18;22;40
96;19.10.2017;2017;10;19;Torstai;56;48;104;11;14;25
96;19.10.2017;2017;10;20;Torstai;50;36;86;9;9;18
96;19.10.2017;2017;10;21;Torstai;34;41;75;3;4;7
96;19.10.2017;2017;10;22;Torstai;16;7;23;1;5;6
96;19.10.2017;2017;10;23;Torstai;12;10;22;1;3;4
96;20.10.2017;2017;10;00;Perjantai;6;3;9;0;0;0
96;20.10.2017;2017;10;01;Perjantai;9;1;10;2;0;2
96;20.10.2017;2017;10;02;Perjantai;6;0;6;1;0;1
96;20.10.2017;2017;10;03;Perjantai;9;1;10;1;1;2
96;20.10.2017;2017;10;04;Perjantai;4;0;4;1;0;1
96;20.10.2017;2017;10;05;Perjantai;3;7;10;2;0;2
96;20.10.2017;2017;10;06;Perjantai;55;31;86;6;2;8
96;20.10.2017;2017;10;07;Perjantai;111;72;183;17;9;26
96;20.10.2017;2017;10;08;Perjantai;102;122;224;11;7;18
96;20.10.2017;2017;10;09;Perjantai;66;68;134;9;8;17
96;20.10.2017;2017;10;10;Perjantai;52;66;118;6;8;14
96;20.10.2017;2017;10;11;Perjantai;74;76;150;10;14;24
96;20.10.2017;2017;10;12;Perjantai;89;92;181;6;13;19
96;20.10.2017;2017;10;13;Perjantai;60;89;149;6;16;22
96;20.10.2017;2017;10;14;Perjantai;66;171;237;3;22;25
96;20.10.2017;2017;10;15;Perjantai;71;137;208;8;21;29
96;20.10.2017;2017;10;16;Perjantai;74;76;150;7;17;24
96;20.10.2017;2017;10;17;Perjantai;54;51;105;8;14;22
96;20.10.2017;2017;10;18;Perjantai;34;31;65;15;6;21
96;20.10.2017;2017;10;19;Perjantai;21;20;41;3;11;14
96;20.10.2017;2017;10;20;Perjantai;39;18;57;9;5;14
96;20.10.2017;2017;10;21;Perjantai;22;26;48;6;6;12
96;20.10.2017;2017;10;22;Perjantai;10;4;14;2;3;5
96;20.10.2017;2017;10;23;Perjantai;8;3;11;0;1;1
96;21.10.2017;2017;10;00;Lauantai;3;1;4;2;1;3
96;21.10.2017;2017;10;01;Lauantai;6;1;7;1;1;2
96;21.10.2017;2017;10;02;Lauantai;7;0;7;0;0;0
96;21.10.2017;2017;10;03;Lauantai;1;0;1;3;0;3
96;21.10.2017;2017;10;04;Lauantai;4;1;5;2;0;2
96;21.10.2017;2017;10;05;Lauantai;1;2;3;0;1;1
96;21.10.2017;2017;10;06;Lauantai;16;9;25;3;0;3
96;21.10.2017;2017;10;07;Lauantai;2;9;11;1;1;2
96;21.10.2017;2017;10;08;Lauantai;4;9;13;1;3;4
96;21.10.2017;2017;10;09;Lauantai;13;25;38;0;9;9
96;21.10.2017;2017;10;10;Lauantai;15;23;38;6;5;11
96;21.10.2017;2017;10;11;Lauantai;22;22;44;8;8;16
96;21.10.2017;2017;10;12;Lauantai;39;41;80;5;11;16
96;21.10.2017;2017;10;13;Lauantai;30;49;79;14;47;61
96;21.10.2017;2017;10;14;Lauantai;39;42;81;9;59;68
96;21.10.2017;2017;10;15;Lauantai;52;51;103;13;15;28
96;21.10.2017;2017;10;16;Lauantai;28;17;45;7;9;16
96;21.10.2017;2017;10;17;Lauantai;35;18;53;16;5;21
96;21.10.2017;2017;10;18;Lauantai;35;34;69;10;17;27
96;21.10.2017;2017;10;19;Lauantai;26;22;48;5;6;11
96;21.10.2017;2017;10;20;Lauantai;16;25;41;5;7;12
96;21.10.2017;2017;10;21;Lauantai;17;32;49;10;8;18
96;21.10.2017;2017;10;22;Lauantai;12;8;20;1;3;4
96;21.10.2017;2017;10;23;Lauantai;13;4;17;1;1;2
96;22.10.2017;2017;10;00;Sunnuntai;4;4;8;3;1;4
96;22.10.2017;2017;10;01;Sunnuntai;11;0;11;1;1;2
96;22.10.2017;2017;10;02;Sunnuntai;12;0;12;2;0;2
96;22.10.2017;2017;10;03;Sunnuntai;6;0;6;2;0;2
96;22.10.2017;2017;10;04;Sunnuntai;4;1;5;3;0;3
96;22.10.2017;2017;10;05;Sunnuntai;0;3;3;0;1;1
96;22.10.2017;2017;10;06;Sunnuntai;16;5;21;2;0;2
96;22.10.2017;2017;10;07;Sunnuntai;0;8;8;2;3;5
96;22.10.2017;2017;10;08;Sunnuntai;3;10;13;2;1;3
96;22.10.2017;2017;10;09;Sunnuntai;1;8;9;4;2;6
96;22.10.2017;2017;10;10;Sunnuntai;10;12;22;4;7;11
96;22.10.2017;2017;10;11;Sunnuntai;6;30;36;2;7;9
96;22.10.2017;2017;10;12;Sunnuntai;32;38;70;15;11;26
96;22.10.2017;2017;10;13;Sunnuntai;32;39;71;7;7;14
96;22.10.2017;2017;10;14;Sunnuntai;24;29;53;3;12;15
96;22.10.2017;2017;10;15;Sunnuntai;37;39;76;9;12;21
96;22.10.2017;2017;10;16;Sunnuntai;37;21;58;17;10;27
96;22.10.2017;2017;10;17;Sunnuntai;40;26;66;10;12;22
96;22.10.2017;2017;10;18;Sunnuntai;24;30;54;16;25;41
96;22.10.2017;2017;10;19;Sunnuntai;25;26;51;6;15;21
96;22.10.2017;2017;10;20;Sunnuntai;17;18;35;8;5;13
96;22.10.2017;2017;10;21;Sunnuntai;12;21;33;5;4;9
96;22.10.2017;2017;10;22;Sunnuntai;2;6;8;2;2;4
96;22.10.2017;2017;10;23;Sunnuntai;5;6;11;0;0;0
96;23.10.2017;2017;10;00;Maanantai;0;2;2;1;0;1
96;23.10.2017;2017;10;01;Maanantai;1;8;9;0;0;0
96;23.10.2017;2017;10;02;Maanantai;0;0;0;0;0;0
96;23.10.2017;2017;10;03;Maanantai;2;0;2;0;0;0
96;23.10.2017;2017;10;04;Maanantai;4;1;5;0;0;0
96;23.10.2017;2017;10;05;Maanantai;0;5;5;0;0;0
96;23.10.2017;2017;10;06;Maanantai;47;20;67;4;1;5
96;23.10.2017;2017;10;07;Maanantai;80;70;150;22;7;29
96;23.10.2017;2017;10;08;Maanantai;52;55;107;9;10;19
96;23.10.2017;2017;10;09;Maanantai;26;35;61;6;12;18
96;23.10.2017;2017;10;10;Maanantai;26;48;74;3;21;24
96;23.10.2017;2017;10;11;Maanantai;44;54;98;6;11;17
96;23.10.2017;2017;10;12;Maanantai;54;49;103;11;5;16
96;23.10.2017;2017;10;13;Maanantai;51;52;103;11;16;27
96;23.10.2017;2017;10;14;Maanantai;54;71;125;4;19;23
96;23.10.2017;2017;10;15;Maanantai;64;137;201;6;30;36
96;23.10.2017;2017;10;16;Maanantai;60;110;170;11;23;34
96;23.10.2017;2017;10;17;Maanantai;48;40;88;13;12;25
96;23.10.2017;2017;10;18;Maanantai;35;33;68;8;7;15
96;23.10.2017;2017;10;19;Maanantai;21;26;47;9;12;21
96;23.10.2017;2017;10;20;Maanantai;24;11;35;10;13;23
96;23.10.2017;2017;10;21;Maanantai;21;20;41;5;7;12
96;23.10.2017;2017;10;22;Maanantai;5;6;11;1;3;4
96;23.10.2017;2017;10;23;Maanantai;3;1;4;0;0;0
96;24.10.2017;2017;10;00;Tiistai;0;3;3;0;0;0
96;24.10.2017;2017;10;01;Tiistai;1;0;1;1;0;1
96;24.10.2017;2017;10;02;Tiistai;1;0;1;0;0;0
96;24.10.2017;2017;10;03;Tiistai;1;1;2;0;0;0
96;24.10.2017;2017;10;04;Tiistai;1;1;2;0;0;0
96;24.10.2017;2017;10;05;Tiistai;4;6;10;2;1;3
96;24.10.2017;2017;10;06;Tiistai;42;29;71;8;3;11
96;24.10.2017;2017;10;07;Tiistai;75;64;139;21;10;31
96;24.10.2017;2017;10;08;Tiistai;41;53;94;8;6;14
96;24.10.2017;2017;10;09;Tiistai;32;38;70;5;3;8
96;24.10.2017;2017;10;10;Tiistai;43;47;90;6;13;19
96;24.10.2017;2017;10;11;Tiistai;31;37;68;14;17;31
96;24.10.2017;2017;10;12;Tiistai;37;48;85;13;15;28
96;24.10.2017;2017;10;13;Tiistai;51;47;98;9;12;21
96;24.10.2017;2017;10;14;Tiistai;37;59;96;10;18;28
96;24.10.2017;2017;10;15;Tiistai;64;131;195;11;32;43
96;24.10.2017;2017;10;16;Tiistai;64;95;159;13;28;41
96;24.10.2017;2017;10;17;Tiistai;49;56;105;19;10;29
96;24.10.2017;2017;10;18;Tiistai;38;40;78;6;18;24
96;24.10.2017;2017;10;19;Tiistai;30;26;56;13;14;27
96;24.10.2017;2017;10;20;Tiistai;43;18;61;14;2;16
96;24.10.2017;2017;10;21;Tiistai;27;32;59;10;5;15
96;24.10.2017;2017;10;22;Tiistai;15;10;25;2;4;6
96;24.10.2017;2017;10;23;Tiistai;6;5;11;1;4;5
96;25.10.2017;2017;10;00;Keskiviikko;1;0;1;1;0;1
96;25.10.2017;2017;10;01;Keskiviikko;4;0;4;0;0;0
96;25.10.2017;2017;10;02;Keskiviikko;1;0;1;0;0;0
96;25.10.2017;2017;10;03;Keskiviikko;1;0;1;0;0;0
96;25.10.2017;2017;10;04;Keskiviikko;1;1;2;0;0;0
96;25.10.2017;2017;10;05;Keskiviikko;2;7;9;1;2;3
96;25.10.2017;2017;10;06;Keskiviikko;47;24;71;8;2;10
96;25.10.2017;2017;10;07;Keskiviikko;67;80;147;15;10;25
96;25.10.2017;2017;10;08;Keskiviikko;46;55;101;10;5;15
96;25.10.2017;2017;10;09;Keskiviikko;23;44;67;11;12;23
96;25.10.2017;2017;10;10;Keskiviikko;28;39;67;8;8;16
96;25.10.2017;2017;10;11;Keskiviikko;31;45;76;5;6;11
96;25.10.2017;2017;10;12;Keskiviikko;62;48;110;11;10;21
96;25.10.2017;2017;10;13;Keskiviikko;40;39;79;4;12;16
96;25.10.2017;2017;10;14;Keskiviikko;44;73;117;5;20;25
96;25.10.2017;2017;10;15;Keskiviikko;57;136;193;14;26;40
96;25.10.2017;2017;10;16;Keskiviikko;63;96;159;12;12;24
96;25.10.2017;2017;10;17;Keskiviikko;47;41;88;8;6;14
96;25.10.2017;2017;10;18;Keskiviikko;37;31;68;8;12;20
96;25.10.2017;2017;10;19;Keskiviikko;35;15;50;7;11;18
96;25.10.2017;2017;10;20;Keskiviikko;28;11;39;9;6;15
96;25.10.2017;2017;10;21;Keskiviikko;7;28;35;5;3;8
96;25.10.2017;2017;10;22;Keskiviikko;7;7;14;1;0;1
96;25.10.2017;2017;10;23;Keskiviikko;7;1;8;1;0;1
96;26.10.2017;2017;10;00;Torstai;5;0;5;1;0;1
96;26.10.2017;2017;10;01;Torstai;1;4;5;1;0;1
96;26.10.2017;2017;10;02;Torstai;1;0;1;0;0;0
96;26.10.2017;2017;10;03;Torstai;2;0;2;0;0;0
96;26.10.2017;2017;10;04;Torstai;2;0;2;0;0;0
96;26.10.2017;2017;10;05;Torstai;2;7;9;0;1;1
96;26.10.2017;2017;10;06;Torstai;34;24;58;5;4;9
96;26.10.2017;2017;10;07;Torstai;106;66;172;13;5;18
96;26.10.2017;2017;10;08;Torstai;36;47;83;4;1;5
96;26.10.2017;2017;10;09;Torstai;25;50;75;11;7;18
96;26.10.2017;2017;10;10;Torstai;25;49;74;5;10;15
96;26.10.2017;2017;10;11;Torstai;35;54;89;5;4;9
96;26.10.2017;2017;10;12;Torstai;40;38;78;9;6;15
96;26.10.2017;2017;10;13;Torstai;41;56;97;14;6;20
96;26.10.2017;2017;10;14;Torstai;46;39;85;2;10;12
96;26.10.2017;2017;10;15;Torstai;63;105;168;6;9;15
96;26.10.2017;2017;10;16;Torstai;73;96;169;6;19;25
96;26.10.2017;2017;10;17;Torstai;50;55;105;14;15;29
96;26.10.2017;2017;10;18;Torstai;34;40;74;12;16;28
96;26.10.2017;2017;10;19;Torstai;31;25;56;9;10;19
96;26.10.2017;2017;10;20;Torstai;25;15;40;8;10;18
96;26.10.2017;2017;10;21;Torstai;45;21;66;18;13;31
96;26.10.2017;2017;10;22;Torstai;10;9;19;4;5;9
96;26.10.2017;2017;10;23;Torstai;8;1;9;0;0;0
96;27.10.2017;2017;10;00;Perjantai;1;3;4;0;0;0
96;27.10.2017;2017;10;01;Perjantai;3;4;7;0;6;6
96;27.10.2017;2017;10;02;Perjantai;5;0;5;1;0;1
96;27.10.2017;2017;10;03;Perjantai;3;0;3;0;0;0
96;27.10.2017;2017;10;04;Perjantai;1;0;1;0;0;0
96;27.10.2017;2017;10;05;Perjantai;1;4;5;0;2;2
96;27.10.2017;2017;10;06;Perjantai;37;26;63;10;0;10
96;27.10.2017;2017;10;07;Perjantai;84;48;132;18;4;22
96;27.10.2017;2017;10;08;Perjantai;32;41;73;8;8;16
96;27.10.2017;2017;10;09;Perjantai;18;39;57;3;9;12
96;27.10.2017;2017;10;10;Perjantai;26;25;51;4;9;13
96;27.10.2017;2017;10;11;Perjantai;36;52;88;5;9;14
96;27.10.2017;2017;10;12;Perjantai;44;74;118;4;14;18
96;27.10.2017;2017;10;13;Perjantai;50;48;98;4;7;11
96;27.10.2017;2017;10;14;Perjantai;37;75;112;9;21;30
96;27.10.2017;2017;10;15;Perjantai;45;99;144;9;21;30
96;27.10.2017;2017;10;16;Perjantai;55;48;103;6;9;15
96;27.10.2017;2017;10;17;Perjantai;46;38;84;9;10;19
96;27.10.2017;2017;10;18;Perjantai;35;25;60;9;9;18
96;27.10.2017;2017;10;19;Perjantai;21;25;46;6;3;9
96;27.10.2017;2017;10;20;Perjantai;22;14;36;3;5;8
96;27.10.2017;2017;10;21;Perjantai;26;16;42;4;2;6
96;27.10.2017;2017;10;22;Perjantai;11;8;19;1;3;4
96;27.10.2017;2017;10;23;Perjantai;5;5;10;2;2;4
96;28.10.2017;2017;10;00;Lauantai;2;9;11;0;1;1
96;28.10.2017;2017;10;01;Lauantai;3;3;6;0;1;1
96;28.10.2017;2017;10;02;Lauantai;1;1;2;1;1;2
96;28.10.2017;2017;10;03;Lauantai;6;1;7;0;1;1
96;28.10.2017;2017;10;04;Lauantai;2;1;3;2;0;2
96;28.10.2017;2017;10;05;Lauantai;2;1;3;0;0;0
96;28.10.2017;2017;10;06;Lauantai;14;5;19;2;0;2
96;28.10.2017;2017;10;07;Lauantai;3;7;10;2;5;7
96;28.10.2017;2017;10;08;Lauantai;7;10;17;2;1;3
96;28.10.2017;2017;10;09;Lauantai;13;12;25;0;3;3
96;28.10.2017;2017;10;10;Lauantai;17;20;37;2;4;6
96;28.10.2017;2017;10;11;Lauantai;14;14;28;1;6;7
96;28.10.2017;2017;10;12;Lauantai;28;32;60;0;4;4
96;28.10.2017;2017;10;13;Lauantai;19;41;60;9;3;12
96;28.10.2017;2017;10;14;Lauantai;28;22;50;8;8;16
96;28.10.2017;2017;10;15;Lauantai;16;18;34;5;8;13
96;28.10.2017;2017;10;16;Lauantai;16;17;33;6;9;15
96;28.10.2017;2017;10;17;Lauantai;9;11;20;9;1;10
96;28.10.2017;2017;10;18;Lauantai;11;10;21;8;18;26
96;28.10.2017;2017;10;19;Lauantai;22;10;32;8;9;17
96;28.10.2017;2017;10;20;Lauantai;10;16;26;8;12;20
96;28.10.2017;2017;10;21;Lauantai;15;19;34;8;4;12
96;28.10.2017;2017;10;22;Lauantai;8;9;17;18;0;18
96;28.10.2017;2017;10;23;Lauantai;1;3;4;1;1;2
96;29.10.2017;2017;10;00;Sunnuntai;3;3;6;1;2;3
96;29.10.2017;2017;10;01;Sunnuntai;5;2;7;0;0;0
96;29.10.2017;2017;10;02;Sunnuntai;8;0;8;2;2;4
96;29.10.2017;2017;10;03;Sunnuntai;7;1;8;3;0;3
96;29.10.2017;2017;10;04;Sunnuntai;4;0;4;3;0;3
96;29.10.2017;2017;10;05;Sunnuntai;1;2;3;1;0;1
96;29.10.2017;2017;10;06;Sunnuntai;17;1;18;4;2;6
96;29.10.2017;2017;10;07;Sunnuntai;1;7;8;1;5;6
96;29.10.2017;2017;10;08;Sunnuntai;2;5;7;1;1;2
96;29.10.2017;2017;10;09;Sunnuntai;7;4;11;5;6;11
96;29.10.2017;2017;10;10;Sunnuntai;10;8;18;10;2;12
96;29.10.2017;2017;10;11;Sunnuntai;7;23;30;5;12;17
96;29.10.2017;2017;10;12;Sunnuntai;17;14;31;5;9;14
96;29.10.2017;2017;10;13;Sunnuntai;23;14;37;7;14;21
96;29.10.2017;2017;10;14;Sunnuntai;12;15;27;6;6;12
96;29.10.2017;2017;10;15;Sunnuntai;16;22;38;8;13;21
96;29.10.2017;2017;10;16;Sunnuntai;18;14;32;16;4;20
96;29.10.2017;2017;10;17;Sunnuntai;22;10;32;17;7;24
96;29.10.2017;2017;10;18;Sunnuntai;12;16;28;18;11;29
96;29.10.2017;2017;10;19;Sunnuntai;11;13;24;9;11;20
96;29.10.2017;2017;10;20;Sunnuntai;14;14;28;6;9;15
96;29.10.2017;2017;10;21;Sunnuntai;16;13;29;11;2;13
96;29.10.2017;2017;10;22;Sunnuntai;3;3;6;0;0;0
96;29.10.2017;2017;10;23;Sunnuntai;2;1;3;1;0;1
96;30.10.2017;2017;10;00;Maanantai;0;0;0;4;1;5
96;30.10.2017;2017;10;01;Maanantai;1;1;2;0;0;0
96;30.10.2017;2017;10;02;Maanantai;1;0;1;0;1;1
96;30.10.2017;2017;10;03;Maanantai;1;0;1;0;0;0
96;30.10.2017;2017;10;04;Maanantai;0;1;1;0;0;0
96;30.10.2017;2017;10;05;Maanantai;1;6;7;6;1;7
96;30.10.2017;2017;10;06;Maanantai;42;18;60;11;4;15
96;30.10.2017;2017;10;07;Maanantai;102;85;187;33;16;49
96;30.10.2017;2017;10;08;Maanantai;137;84;221;37;11;48
96;30.10.2017;2017;10;09;Maanantai;63;37;100;29;10;39
96;30.10.2017;2017;10;10;Maanantai;47;46;93;18;14;32
96;30.10.2017;2017;10;11;Maanantai;43;38;81;16;14;30
96;30.10.2017;2017;10;12;Maanantai;70;43;113;27;27;54
96;30.10.2017;2017;10;13;Maanantai;52;61;113;14;28;42
96;30.10.2017;2017;10;14;Maanantai;36;98;134;8;33;41
96;30.10.2017;2017;10;15;Maanantai;67;186;253;13;47;60
96;30.10.2017;2017;10;16;Maanantai;74;162;236;13;40;53
96;30.10.2017;2017;10;17;Maanantai;59;68;127;25;26;51
96;30.10.2017;2017;10;18;Maanantai;48;41;89;15;23;38
96;30.10.2017;2017;10;19;Maanantai;32;29;61;13;17;30
96;30.10.2017;2017;10;20;Maanantai;42;30;72;12;14;26
96;30.10.2017;2017;10;21;Maanantai;19;24;43;5;7;12
96;30.10.2017;2017;10;22;Maanantai;4;10;14;0;5;5
96;30.10.2017;2017;10;23;Maanantai;2;3;5;0;2;2
96;31.10.2017;2017;10;00;Tiistai;1;2;3;2;1;3
96;31.10.2017;2017;10;01;Tiistai;2;0;2;0;1;1
96;31.10.2017;2017;10;02;Tiistai;4;2;6;3;0;3
96;31.10.2017;2017;10;03;Tiistai;6;0;6;0;0;0
96;31.10.2017;2017;10;04;Tiistai;5;0;5;1;0;1
96;31.10.2017;2017;10;05;Tiistai;3;3;6;1;1;2
96;31.10.2017;2017;10;06;Tiistai;36;26;62;11;4;15
96;31.10.2017;2017;10;07;Tiistai;117;86;203;51;10;61
96;31.10.2017;2017;10;08;Tiistai;162;84;246;36;9;45
96;31.10.2017;2017;10;09;Tiistai;85;51;136;17;16;33
96;31.10.2017;2017;10;10;Tiistai;38;32;70;9;21;30
96;31.10.2017;2017;10;11;Tiistai;54;56;110;21;23;44
96;31.10.2017;2017;10;12;Tiistai;74;63;137;29;20;49
96;31.10.2017;2017;10;13;Tiistai;39;72;111;15;14;29
96;31.10.2017;2017;10;14;Tiistai;56;98;154;20;41;61
96;31.10.2017;2017;10;15;Tiistai;60;179;239;8;68;76
96;31.10.2017;2017;10;16;Tiistai;79;152;231;13;66;79
96;31.10.2017;2017;10;17;Tiistai;52;75;127;17;16;33
96;31.10.2017;2017;10;18;Tiistai;44;30;74;14;22;36
96;31.10.2017;2017;10;19;Tiistai;51;32;83;17;24;41
96;31.10.2017;2017;10;20;Tiistai;36;23;59;7;11;18
96;31.10.2017;2017;10;21;Tiistai;14;41;55;4;3;7
96;31.10.2017;2017;10;22;Tiistai;3;10;13;2;3;5
96;31.10.2017;2017;10;23;Tiistai;1;3;4;4;0;4
96;01.11.2017;2017;11;00;Keskiviikko;3;1;4;0;0;0
96;01.11.2017;2017;11;01;Keskiviikko;1;1;2;0;0;0
96;01.11.2017;2017;11;02;Keskiviikko;1;0;1;0;1;1
96;01.11.2017;2017;11;03;Keskiviikko;0;0;0;0;0;0
96;01.11.2017;2017;11;04;Keskiviikko;2;1;3;0;0;0
96;01.11.2017;2017;11;05;Keskiviikko;0;9;9;1;2;3
96;01.11.2017;2017;11;06;Keskiviikko;35;16;51;14;1;15
96;01.11.2017;2017;11;07;Keskiviikko;97;83;180;50;13;63
96;01.11.2017;2017;11;08;Keskiviikko;169;72;241;29;7;36
96;01.11.2017;2017;11;09;Keskiviikko;69;38;107;17;13;30
96;01.11.2017;2017;11;10;Keskiviikko;46;38;84;16;16;32
96;01.11.2017;2017;11;11;Keskiviikko;60;42;102;22;26;48
96;01.11.2017;2017;11;12;Keskiviikko;61;90;151;9;16;25
96;01.11.2017;2017;11;13;Keskiviikko;44;80;124;11;25;36
96;01.11.2017;2017;11;14;Keskiviikko;51;94;145;15;36;51
96;01.11.2017;2017;11;15;Keskiviikko;52;155;207;11;43;54
96;01.11.2017;2017;11;16;Keskiviikko;72;152;224;17;57;74
96;01.11.2017;2017;11;17;Keskiviikko;48;56;104;10;18;28
96;01.11.2017;2017;11;18;Keskiviikko;55;43;98;25;10;35
96;01.11.2017;2017;11;19;Keskiviikko;47;33;80;15;13;28
96;01.11.2017;2017;11;20;Keskiviikko;33;31;64;5;20;25
96;01.11.2017;2017;11;21;Keskiviikko;19;24;43;3;4;7
96;01.11.2017;2017;11;22;Keskiviikko;5;10;15;0;4;4
96;01.11.2017;2017;11;23;Keskiviikko;0;3;3;0;0;0
96;02.11.2017;2017;11;00;Torstai;7;0;7;2;0;2
96;02.11.2017;2017;11;01;Torstai;1;5;6;2;0;2
96;02.11.2017;2017;11;02;Torstai;1;0;1;0;0;0
96;02.11.2017;2017;11;03;Torstai;3;0;3;0;0;0
96;02.11.2017;2017;11;04;Torstai;3;0;3;0;0;0
96;02.11.2017;2017;11;05;Torstai;3;9;12;0;2;2
96;02.11.2017;2017;11;06;Torstai;46;32;78;10;8;18
96;02.11.2017;2017;11;07;Torstai;143;89;232;26;10;36
96;02.11.2017;2017;11;08;Torstai;49;63;112;8;2;10
96;02.11.2017;2017;11;09;Torstai;34;68;102;22;14;36
96;02.11.2017;2017;11;10;Torstai;34;66;100;10;20;30
96;02.11.2017;2017;11;11;Torstai;47;73;120;10;8;18
96;02.11.2017;2017;11;12;Torstai;54;51;105;18;12;30
96;02.11.2017;2017;11;13;Torstai;55;76;131;28;12;40
96;02.11.2017;2017;11;14;Torstai;62;53;115;4;20;24
96;02.11.2017;2017;11;15;Torstai;85;142;227;12;18;30
96;02.11.2017;2017;11;16;Torstai;99;130;229;12;38;50
96;02.11.2017;2017;11;17;Torstai;68;74;142;28;30;58
96;02.11.2017;2017;11;18;Torstai;46;54;100;24;32;56
96;02.11.2017;2017;11;19;Torstai;42;34;76;18;20;38
96;02.11.2017;2017;11;20;Torstai;34;20;54;16;20;36
96;02.11.2017;2017;11;21;Torstai;61;28;89;36;26;62
96;02.11.2017;2017;11;22;Torstai;14;12;26;8;10;18
96;02.11.2017;2017;11;23;Torstai;11;1;12;0;0;0
96;03.11.2017;2017;11;00;Perjantai;2;0;2;1;1;2
96;03.11.2017;2017;11;01;Perjantai;4;4;8;3;1;4
96;03.11.2017;2017;11;02;Perjantai;2;0;2;0;0;0
96;03.11.2017;2017;11;03;Perjantai;2;0;2;0;0;0
96;03.11.2017;2017;11;04;Perjantai;2;2;4;0;0;0
96;03.11.2017;2017;11;05;Perjantai;6;6;12;1;3;4
96;03.11.2017;2017;11;06;Perjantai;42;23;65;18;3;21
96;03.11.2017;2017;11;07;Perjantai;102;76;178;33;7;40
96;03.11.2017;2017;11;08;Perjantai;105;81;186;20;13;33
96;03.11.2017;2017;11;09;Perjantai;64;47;111;9;7;16
96;03.11.2017;2017;11;10;Perjantai;46;44;90;10;11;21
96;03.11.2017;2017;11;11;Perjantai;49;67;116;6;7;13
96;03.11.2017;2017;11;12;Perjantai;56;71;127;14;19;33
96;03.11.2017;2017;11;13;Perjantai;54;112;166;9;22;31
96;03.11.2017;2017;11;14;Perjantai;39;167;206;8;45;53
96;03.11.2017;2017;11;15;Perjantai;76;127;203;17;39;56
96;03.11.2017;2017;11;16;Perjantai;68;86;154;12;15;27
96;03.11.2017;2017;11;17;Perjantai;33;46;79;9;17;26
96;03.11.2017;2017;11;18;Perjantai;39;31;70;1;10;11
96;03.11.2017;2017;11;19;Perjantai;26;22;48;8;9;17
96;03.11.2017;2017;11;20;Perjantai;17;15;32;7;4;11
96;03.11.2017;2017;11;21;Perjantai;20;23;43;6;6;12
96;03.11.2017;2017;11;22;Perjantai;10;11;21;1;4;5
96;03.11.2017;2017;11;23;Perjantai;9;1;10;1;0;1
96;04.11.2017;2017;11;00;Lauantai;9;6;15;3;0;3
96;04.11.2017;2017;11;01;Lauantai;0;1;1;0;0;0
96;04.11.2017;2017;11;02;Lauantai;7;1;8;3;1;4
96;04.11.2017;2017;11;03;Lauantai;3;0;3;0;1;1
96;04.11.2017;2017;11;04;Lauantai;1;2;3;0;0;0
96;04.11.2017;2017;11;05;Lauantai;5;1;6;1;0;1
96;04.11.2017;2017;11;06;Lauantai;16;3;19;2;0;2
96;04.11.2017;2017;11;07;Lauantai;1;11;12;1;1;2
96;04.11.2017;2017;11;08;Lauantai;9;11;20;4;4;8
96;04.11.2017;2017;11;09;Lauantai;4;12;16;3;1;4
96;04.11.2017;2017;11;10;Lauantai;14;17;31;5;12;17
96;04.11.2017;2017;11;11;Lauantai;11;21;32;8;10;18
96;04.11.2017;2017;11;12;Lauantai;29;17;46;10;7;17
96;04.11.2017;2017;11;13;Lauantai;31;30;61;20;11;31
96;04.11.2017;2017;11;14;Lauantai;21;30;51;11;8;19
96;04.11.2017;2017;11;15;Lauantai;20;36;56;4;9;13
96;04.11.2017;2017;11;16;Lauantai;13;48;61;15;14;29
96;04.11.2017;2017;11;17;Lauantai;29;22;51;14;4;18
96;04.11.2017;2017;11;18;Lauantai;26;21;47;15;16;31
96;04.11.2017;2017;11;19;Lauantai;43;23;66;10;9;19
96;04.11.2017;2017;11;20;Lauantai;9;10;19;4;9;13
96;04.11.2017;2017;11;21;Lauantai;16;23;39;3;5;8
96;04.11.2017;2017;11;22;Lauantai;5;8;13;2;4;6
96;04.11.2017;2017;11;23;Lauantai;7;4;11;1;1;2
96;05.11.2017;2017;11;00;Sunnuntai;8;6;14;0;2;2
96;05.11.2017;2017;11;01;Sunnuntai;7;0;7;2;0;2
96;05.11.2017;2017;11;02;Sunnuntai;8;0;8;1;0;1
96;05.11.2017;2017;11;03;Sunnuntai;6;0;6;5;1;6
96;05.11.2017;2017;11;04;Sunnuntai;9;0;9;10;3;13
96;05.11.2017;2017;11;05;Sunnuntai;3;1;4;1;0;1
96;05.11.2017;2017;11;06;Sunnuntai;13;4;17;2;0;2
96;05.11.2017;2017;11;07;Sunnuntai;3;8;11;0;3;3
96;05.11.2017;2017;11;08;Sunnuntai;5;7;12;1;2;3
96;05.11.2017;2017;11;09;Sunnuntai;6;9;15;5;7;12
96;05.11.2017;2017;11;10;Sunnuntai;13;7;20;6;9;15
96;05.11.2017;2017;11;11;Sunnuntai;9;19;28;9;17;26
96;05.11.2017;2017;11;12;Sunnuntai;20;23;43;16;20;36
96;05.11.2017;2017;11;13;Sunnuntai;34;16;50;9;14;23
96;05.11.2017;2017;11;14;Sunnuntai;25;23;48;11;11;22
96;05.11.2017;2017;11;15;Sunnuntai;18;22;40;12;19;31
96;05.11.2017;2017;11;16;Sunnuntai;34;11;45;28;7;35
96;05.11.2017;2017;11;17;Sunnuntai;26;18;44;21;16;37
96;05.11.2017;2017;11;18;Sunnuntai;19;28;47;3;29;32
96;05.11.2017;2017;11;19;Sunnuntai;11;27;38;9;12;21
96;05.11.2017;2017;11;20;Sunnuntai;14;3;17;7;6;13
96;05.11.2017;2017;11;21;Sunnuntai;14;24;38;3;3;6
96;05.11.2017;2017;11;22;Sunnuntai;7;5;12;2;1;3
96;05.11.2017;2017;11;23;Sunnuntai;1;3;4;0;0;0
96;06.11.2017;2017;11;00;Maanantai;3;3;6;3;1;4
96;06.11.2017;2017;11;01;Maanantai;1;0;1;1;0;1
96;06.11.2017;2017;11;02;Maanantai;0;0;0;0;0;0
96;06.11.2017;2017;11;03;Maanantai;2;1;3;0;1;1
96;06.11.2017;2017;11;04;Maanantai;1;0;1;0;0;0
96;06.11.2017;2017;11;05;Maanantai;4;2;6;1;0;1
96;06.11.2017;2017;11;06;Maanantai;40;24;64;3;2;5
96;06.11.2017;2017;11;07;Maanantai;99;90;189;22;5;27
96;06.11.2017;2017;11;08;Maanantai;126;98;224;10;5;15
96;06.11.2017;2017;11;09;Maanantai;91;53;144;20;9;29
96;06.11.2017;2017;11;10;Maanantai;50;54;104;12;9;21
96;06.11.2017;2017;11;11;Maanantai;64;60;124;16;8;24
96;06.11.2017;2017;11;12;Maanantai;76;84;160;14;12;26
96;06.11.2017;2017;11;13;Maanantai;50;87;137;13;10;23
96;06.11.2017;2017;11;14;Maanantai;50;117;167;14;22;36
96;06.11.2017;2017;11;15;Maanantai;59;193;252;4;36;40
96;06.11.2017;2017;11;16;Maanantai;88;163;251;15;40;55
96;06.11.2017;2017;11;17;Maanantai;54;81;135;17;23;40
96;06.11.2017;2017;11;18;Maanantai;52;53;105;16;18;34
96;06.11.2017;2017;11;19;Maanantai;53;42;95;11;17;28
96;06.11.2017;2017;11;20;Maanantai;46;35;81;8;10;18
96;06.11.2017;2017;11;21;Maanantai;27;38;65;6;8;14
96;06.11.2017;2017;11;22;Maanantai;10;8;18;2;5;7
96;06.11.2017;2017;11;23;Maanantai;1;2;3;0;0;0
96;07.11.2017;2017;11;00;Tiistai;0;0;0;0;0;0
96;07.11.2017;2017;11;01;Tiistai;1;0;1;0;0;0
96;07.11.2017;2017;11;02;Tiistai;1;0;1;0;0;0
96;07.11.2017;2017;11;03;Tiistai;0;0;0;0;0;0
96;07.11.2017;2017;11;04;Tiistai;1;0;1;0;1;1
96;07.11.2017;2017;11;05;Tiistai;4;6;10;0;0;0
96;07.11.2017;2017;11;06;Tiistai;55;17;72;8;5;13
96;07.11.2017;2017;11;07;Tiistai;139;74;213;30;6;36
96;07.11.2017;2017;11;08;Tiistai;146;103;249;17;7;24
96;07.11.2017;2017;11;09;Tiistai;106;59;165;19;6;25
96;07.11.2017;2017;11;10;Tiistai;51;54;105;7;14;21
96;07.11.2017;2017;11;11;Tiistai;78;70;148;21;14;35
96;07.11.2017;2017;11;12;Tiistai;68;60;128;18;15;33
96;07.11.2017;2017;11;13;Tiistai;75;101;176;12;28;40
96;07.11.2017;2017;11;14;Tiistai;49;133;182;9;23;32
96;07.11.2017;2017;11;15;Tiistai;68;227;295;6;37;43
96;07.11.2017;2017;11;16;Tiistai;74;198;272;12;48;60
96;07.11.2017;2017;11;17;Tiistai;45;81;126;17;25;42
96;07.11.2017;2017;11;18;Tiistai;58;41;99;20;23;43
96;07.11.2017;2017;11;19;Tiistai;48;41;89;15;16;31
96;07.11.2017;2017;11;20;Tiistai;32;30;62;6;13;19
96;07.11.2017;2017;11;21;Tiistai;26;33;59;3;7;10
96;07.11.2017;2017;11;22;Tiistai;7;9;16;1;2;3
96;07.11.2017;2017;11;23;Tiistai;4;2;6;0;1;1
96;08.11.2017;2017;11;00;Keskiviikko;7;0;7;0;0;0
96;08.11.2017;2017;11;01;Keskiviikko;0;0;0;1;0;1
96;08.11.2017;2017;11;02;Keskiviikko;2;0;2;0;1;1
96;08.11.2017;2017;11;03;Keskiviikko;2;0;2;0;0;0
96;08.11.2017;2017;11;04;Keskiviikko;2;2;4;1;0;1
96;08.11.2017;2017;11;05;Keskiviikko;6;7;13;1;0;1
96;08.11.2017;2017;11;06;Keskiviikko;59;23;82;10;4;14
96;08.11.2017;2017;11;07;Keskiviikko;138;80;218;32;6;38
96;08.11.2017;2017;11;08;Keskiviikko;136;97;233;17;10;27
96;08.11.2017;2017;11;09;Keskiviikko;82;46;128;15;12;27
96;08.11.2017;2017;11;10;Keskiviikko;56;64;120;15;12;27
96;08.11.2017;2017;11;11;Keskiviikko;67;53;120;15;9;24
96;08.11.2017;2017;11;12;Keskiviikko;64;79;143;14;14;28
96;08.11.2017;2017;11;13;Keskiviikko;62;96;158;10;18;28
96;08.11.2017;2017;11;14;Keskiviikko;75;146;221;9;22;31
96;08.11.2017;2017;11;15;Keskiviikko;67;206;273;19;36;55
96;08.11.2017;2017;11;16;Keskiviikko;79;162;241;19;37;56
96;08.11.2017;2017;11;17;Keskiviikko;76;63;139;14;14;28
96;08.11.2017;2017;11;18;Keskiviikko;63;53;116;33;26;59
96;08.11.2017;2017;11;19;Keskiviikko;35;38;73;20;27;47
96;08.11.2017;2017;11;20;Keskiviikko;41;47;88;8;19;27
96;08.11.2017;2017;11;21;Keskiviikko;25;32;57;1;8;9
96;08.11.2017;2017;11;22;Keskiviikko;5;9;14;1;1;2
96;08.11.2017;2017;11;23;Keskiviikko;4;5;9;1;1;2
96;09.11.2017;2017;11;00;Torstai;2;1;3;0;1;1
96;09.11.2017;2017;11;01;Torstai;2;1;3;2;1;3
96;09.11.2017;2017;11;02;Torstai;2;0;2;0;0;0
96;09.11.2017;2017;11;03;Torstai;0;0;0;1;0;1
96;09.11.2017;2017;11;04;Torstai;3;0;3;0;1;1
96;09.11.2017;2017;11;05;Torstai;6;7;13;0;0;0
96;09.11.2017;2017;11;06;Torstai;49;25;74;5;2;7
96;09.11.2017;2017;11;07;Torstai;118;77;195;33;7;40
96;09.11.2017;2017;11;08;Torstai;166;101;267;21;9;30
96;09.11.2017;2017;11;09;Torstai;109;64;173;15;6;21
96;09.11.2017;2017;11;10;Torstai;59;53;112;9;8;17
96;09.11.2017;2017;11;11;Torstai;65;62;127;20;15;35
96;09.11.2017;2017;11;12;Torstai;65;78;143;15;13;28
96;09.11.2017;2017;11;13;Torstai;68;101;169;11;21;32
96;09.11.2017;2017;11;14;Torstai;53;176;229;9;22;31
96;09.11.2017;2017;11;15;Torstai;66;202;268;13;29;42
96;09.11.2017;2017;11;16;Torstai;96;158;254;8;34;42
96;09.11.2017;2017;11;17;Torstai;62;77;139;12;16;28
96;09.11.2017;2017;11;18;Torstai;40;31;71;14;16;30
96;09.11.2017;2017;11;19;Torstai;37;44;81;11;17;28
96;09.11.2017;2017;11;20;Torstai;30;35;65;7;7;14
96;09.11.2017;2017;11;21;Torstai;35;42;77;6;10;16
96;09.11.2017;2017;11;22;Torstai;9;9;18;2;2;4
96;09.11.2017;2017;11;23;Torstai;3;2;5;1;0;1
96;10.11.2017;2017;11;00;Perjantai;2;1;3;0;0;0
96;10.11.2017;2017;11;01;Perjantai;9;0;9;1;0;1
96;10.11.2017;2017;11;02;Perjantai;1;1;2;0;0;0
96;10.11.2017;2017;11;03;Perjantai;1;0;1;1;0;1
96;10.11.2017;2017;11;04;Perjantai;5;0;5;0;0;0
96;10.11.2017;2017;11;05;Perjantai;2;5;7;1;0;1
96;10.11.2017;2017;11;06;Perjantai;46;27;73;7;1;8
96;10.11.2017;2017;11;07;Perjantai;101;73;174;24;11;35
96;10.11.2017;2017;11;08;Perjantai;120;77;197;16;10;26
96;10.11.2017;2017;11;09;Perjantai;81;62;143;11;8;19
96;10.11.2017;2017;11;10;Perjantai;52;45;97;13;6;19
96;10.11.2017;2017;11;11;Perjantai;49;58;107;7;16;23
96;10.11.2017;2017;11;12;Perjantai;45;56;101;14;14;28
96;10.11.2017;2017;11;13;Perjantai;51;97;148;7;24;31
96;10.11.2017;2017;11;14;Perjantai;64;193;257;7;27;34
96;10.11.2017;2017;11;15;Perjantai;71;144;215;9;24;33
96;10.11.2017;2017;11;16;Perjantai;74;108;182;11;22;33
96;10.11.2017;2017;11;17;Perjantai;43;38;81;18;10;28
96;10.11.2017;2017;11;18;Perjantai;29;37;66;10;11;21
96;10.11.2017;2017;11;19;Perjantai;23;17;40;5;7;12
96;10.11.2017;2017;11;20;Perjantai;18;22;40;6;5;11
96;10.11.2017;2017;11;21;Perjantai;11;17;28;2;3;5
96;10.11.2017;2017;11;22;Perjantai;13;10;23;2;0;2
96;10.11.2017;2017;11;23;Perjantai;7;7;14;0;2;2
96;11.11.2017;2017;11;00;Lauantai;7;2;9;1;1;2
96;11.11.2017;2017;11;01;Lauantai;5;1;6;0;0;0
96;11.11.2017;2017;11;02;Lauantai;4;0;4;2;0;2
96;11.11.2017;2017;11;03;Lauantai;5;3;8;0;1;1
96;11.11.2017;2017;11;04;Lauantai;1;1;2;5;0;5
96;11.11.2017;2017;11;05;Lauantai;3;3;6;0;1;1
96;11.11.2017;2017;11;06;Lauantai;20;3;23;4;0;4
96;11.11.2017;2017;11;07;Lauantai;3;11;14;1;4;5
96;11.11.2017;2017;11;08;Lauantai;7;16;23;0;4;4
96;11.11.2017;2017;11;09;Lauantai;8;32;40;9;7;16
96;11.11.2017;2017;11;10;Lauantai;17;26;43;5;7;12
96;11.11.2017;2017;11;11;Lauantai;26;42;68;6;9;15
96;11.11.2017;2017;11;12;Lauantai;34;29;63;11;20;31
96;11.11.2017;2017;11;13;Lauantai;42;36;78;5;9;14
96;11.11.2017;2017;11;14;Lauantai;34;41;75;5;12;17
96;11.11.2017;2017;11;15;Lauantai;33;37;70;12;7;19
96;11.11.2017;2017;11;16;Lauantai;29;27;56;2;8;10
96;11.11.2017;2017;11;17;Lauantai;25;23;48;6;4;10
96;11.11.2017;2017;11;18;Lauantai;21;22;43;4;6;10
96;11.11.2017;2017;11;19;Lauantai;18;25;43;7;2;9
96;11.11.2017;2017;11;20;Lauantai;16;12;28;6;10;16
96;11.11.2017;2017;11;21;Lauantai;9;22;31;2;2;4
96;11.11.2017;2017;11;22;Lauantai;1;6;7;1;0;1
96;11.11.2017;2017;11;23;Lauantai;13;5;18;0;0;0
96;12.11.2017;2017;11;00;Sunnuntai;10;5;15;1;0;1
96;12.11.2017;2017;11;01;Sunnuntai;2;1;3;2;1;3
96;12.11.2017;2017;11;02;Sunnuntai;3;1;4;0;0;0
96;12.11.2017;2017;11;03;Sunnuntai;5;0;5;0;0;0
96;12.11.2017;2017;11;04;Sunnuntai;3;0;3;0;1;1
96;12.11.2017;2017;11;05;Sunnuntai;0;2;2;0;0;0
96;12.11.2017;2017;11;06;Sunnuntai;16;6;22;3;0;3
96;12.11.2017;2017;11;07;Sunnuntai;3;9;12;0;4;4
96;12.11.2017;2017;11;08;Sunnuntai;3;2;5;2;3;5
96;12.11.2017;2017;11;09;Sunnuntai;4;11;15;6;6;12
96;12.11.2017;2017;11;10;Sunnuntai;9;13;22;6;9;15
96;12.11.2017;2017;11;11;Sunnuntai;8;15;23;6;7;13
96;12.11.2017;2017;11;12;Sunnuntai;19;32;51;9;7;16
96;12.11.2017;2017;11;13;Sunnuntai;32;18;50;2;7;9
96;12.11.2017;2017;11;14;Sunnuntai;21;28;49;9;7;16
96;12.11.2017;2017;11;15;Sunnuntai;29;30;59;7;10;17
96;12.11.2017;2017;11;16;Sunnuntai;30;17;47;18;12;30
96;12.11.2017;2017;11;17;Sunnuntai;23;18;41;7;10;17
96;12.11.2017;2017;11;18;Sunnuntai;23;17;40;6;12;18
96;12.11.2017;2017;11;19;Sunnuntai;12;12;24;6;15;21
96;12.11.2017;2017;11;20;Sunnuntai;20;24;44;4;15;19
96;12.11.2017;2017;11;21;Sunnuntai;12;29;41;4;6;10
96;12.11.2017;2017;11;22;Sunnuntai;6;4;10;2;1;3
96;12.11.2017;2017;11;23;Sunnuntai;6;2;8;0;1;1
96;13.11.2017;2017;11;00;Maanantai;4;3;7;1;0;1
96;13.11.2017;2017;11;01;Maanantai;1;1;2;2;0;2
96;13.11.2017;2017;11;02;Maanantai;2;1;3;0;0;0
96;13.11.2017;2017;11;03;Maanantai;5;0;5;0;1;1
96;13.11.2017;2017;11;04;Maanantai;1;0;1;0;0;0
96;13.11.2017;2017;11;05;Maanantai;1;5;6;0;2;2
96;13.11.2017;2017;11;06;Maanantai;51;16;67;11;1;12
96;13.11.2017;2017;11;07;Maanantai;122;84;206;28;5;33
96;13.11.2017;2017;11;08;Maanantai;136;106;242;18;9;27
96;13.11.2017;2017;11;09;Maanantai;93;63;156;17;15;32
96;13.11.2017;2017;11;10;Maanantai;60;55;115;11;10;21
96;13.11.2017;2017;11;11;Maanantai;60;65;125;6;14;20
96;13.11.2017;2017;11;12;Maanantai;79;69;148;22;26;48
96;13.11.2017;2017;11;13;Maanantai;59;64;123;9;24;33
96;13.11.2017;2017;11;14;Maanantai;67;118;185;15;16;31
96;13.11.2017;2017;11;15;Maanantai;54;215;269;5;34;39
96;13.11.2017;2017;11;16;Maanantai;87;196;283;16;45;61
96;13.11.2017;2017;11;17;Maanantai;65;82;147;18;36;54
96;13.11.2017;2017;11;18;Maanantai;44;52;96;18;24;42
96;13.11.2017;2017;11;19;Maanantai;40;34;74;13;21;34
96;13.11.2017;2017;11;20;Maanantai;38;24;62;13;10;23
96;13.11.2017;2017;11;21;Maanantai;26;33;59;6;5;11
96;13.11.2017;2017;11;22;Maanantai;4;7;11;2;0;2
96;13.11.2017;2017;11;23;Maanantai;1;0;1;1;1;2
96;14.11.2017;2017;11;00;Tiistai;1;1;2;1;1;2
96;14.11.2017;2017;11;01;Tiistai;0;0;0;1;0;1
96;14.11.2017;2017;11;02;Tiistai;3;0;3;1;0;1
96;14.11.2017;2017;11;03;Tiistai;0;0;0;0;0;0
96;14.11.2017;2017;11;04;Tiistai;1;0;1;0;0;0
96;14.11.2017;2017;11;05;Tiistai;3;7;10;1;1;2
96;14.11.2017;2017;11;06;Tiistai;41;15;56;9;3;12
96;14.11.2017;2017;11;07;Tiistai;131;95;226;34;9;43
96;14.11.2017;2017;11;08;Tiistai;149;122;271;17;15;32
96;14.11.2017;2017;11;09;Tiistai;93;56;149;10;13;23
96;14.11.2017;2017;11;10;Tiistai;43;63;106;15;8;23
96;14.11.2017;2017;11;11;Tiistai;54;54;108;14;20;34
96;14.11.2017;2017;11;12;Tiistai;76;74;150;11;15;26
96;14.11.2017;2017;11;13;Tiistai;72;83;155;16;12;28
96;14.11.2017;2017;11;14;Tiistai;48;114;162;24;30;54
96;14.11.2017;2017;11;15;Tiistai;64;179;243;13;33;46
96;14.11.2017;2017;11;16;Tiistai;88;187;275;12;52;64
96;14.11.2017;2017;11;17;Tiistai;57;59;116;15;20;35
96;14.11.2017;2017;11;18;Tiistai;46;39;85;19;15;34
96;14.11.2017;2017;11;19;Tiistai;40;37;77;17;30;47
96;14.11.2017;2017;11;20;Tiistai;38;32;70;10;14;24
96;14.11.2017;2017;11;21;Tiistai;31;26;57;2;10;12
96;14.11.2017;2017;11;22;Tiistai;7;8;15;4;4;8
96;14.11.2017;2017;11;23;Tiistai;1;5;6;0;1;1
96;15.11.2017;2017;11;00;Keskiviikko;7;0;7;0;0;0
96;15.11.2017;2017;11;01;Keskiviikko;0;0;0;1;0;1
96;15.11.2017;2017;11;02;Keskiviikko;2;0;2;0;1;1
96;15.11.2017;2017;11;03;Keskiviikko;2;0;2;0;0;0
96;15.11.2017;2017;11;04;Keskiviikko;2;2;4;1;0;1
96;15.11.2017;2017;11;05;Keskiviikko;6;7;13;1;0;1
96;15.11.2017;2017;11;06;Keskiviikko;57;22;79;11;4;15
96;15.11.2017;2017;11;07;Keskiviikko;132;77;209;34;6;40
96;15.11.2017;2017;11;08;Keskiviikko;131;93;224;18;11;29
96;15.11.2017;2017;11;09;Keskiviikko;79;44;123;16;13;29
96;15.11.2017;2017;11;10;Keskiviikko;54;61;115;16;13;29
96;15.11.2017;2017;11;11;Keskiviikko;64;51;115;16;9;25
96;15.11.2017;2017;11;12;Keskiviikko;61;76;137;15;15;30
96;15.11.2017;2017;11;13;Keskiviikko;60;92;152;11;19;30
96;15.11.2017;2017;11;14;Keskiviikko;72;140;212;9;23;32
96;15.11.2017;2017;11;15;Keskiviikko;64;198;262;20;38;58
96;15.11.2017;2017;11;16;Keskiviikko;76;156;232;20;39;59
96;15.11.2017;2017;11;17;Keskiviikko;73;60;133;15;15;30
96;15.11.2017;2017;11;18;Keskiviikko;60;51;111;35;27;62
96;15.11.2017;2017;11;19;Keskiviikko;34;36;70;21;28;49
96;15.11.2017;2017;11;20;Keskiviikko;39;45;84;8;20;28
96;15.11.2017;2017;11;21;Keskiviikko;24;31;55;1;8;9
96;15.11.2017;2017;11;22;Keskiviikko;5;9;14;1;1;2
96;15.11.2017;2017;11;23;Keskiviikko;4;5;9;1;1;2
96;16.11.2017;2017;11;00;Torstai;2;1;3;0;1;1
96;16.11.2017;2017;11;01;Torstai;2;1;3;2;1;3
96;16.11.2017;2017;11;02;Torstai;2;0;2;0;0;0
96;16.11.2017;2017;11;03;Torstai;0;0;0;1;0;1
96;16.11.2017;2017;11;04;Torstai;3;0;3;0;1;1
96;16.11.2017;2017;11;05;Torstai;6;6;12;0;0;0
96;16.11.2017;2017;11;06;Torstai;46;23;69;5;2;7
96;16.11.2017;2017;11;07;Torstai;111;72;183;38;8;46
96;16.11.2017;2017;11;08;Torstai;156;95;251;24;10;34
96;16.11.2017;2017;11;09;Torstai;102;60;162;16;7;23
96;16.11.2017;2017;11;10;Torstai;55;50;105;10;9;19
96;16.11.2017;2017;11;11;Torstai;61;58;119;23;16;39
96;16.11.2017;2017;11;12;Torstai;61;73;134;16;14;30
96;16.11.2017;2017;11;13;Torstai;64;95;159;12;24;36
96;16.11.2017;2017;11;14;Torstai;50;165;215;10;26;36
96;16.11.2017;2017;11;15;Torstai;62;190;252;14;34;48
96;16.11.2017;2017;11;16;Torstai;90;148;238;9;39;48
96;16.11.2017;2017;11;17;Torstai;58;72;130;13;18;31
96;16.11.2017;2017;11;18;Torstai;38;30;68;15;18;33
96;16.11.2017;2017;11;19;Torstai;35;41;76;12;20;32
96;16.11.2017;2017;11;20;Torstai;29;33;62;8;8;16
96;16.11.2017;2017;11;21;Torstai;33;40;73;7;11;18
96;16.11.2017;2017;11;22;Torstai;8;8;16;2;2;4
96;16.11.2017;2017;11;23;Torstai;3;2;5;1;0;1
96;17.11.2017;2017;11;00;Perjantai;1;1;2;0;0;0
96;17.11.2017;2017;11;01;Perjantai;2;0;2;3;0;3
96;17.11.2017;2017;11;02;Perjantai;3;0;3;0;0;0
96;17.11.2017;2017;11;03;Perjantai;4;0;4;0;0;0
96;17.11.2017;2017;11;04;Perjantai;2;0;2;1;1;2
96;17.11.2017;2017;11;05;Perjantai;1;8;9;0;2;2
96;17.11.2017;2017;11;06;Perjantai;35;15;50;13;3;16
96;17.11.2017;2017;11;07;Perjantai;73;53;126;18;11;29
96;17.11.2017;2017;11;08;Perjantai;98;72;170;17;6;23
96;17.11.2017;2017;11;09;Perjantai;43;42;85;9;10;19
96;17.11.2017;2017;11;10;Perjantai;36;64;100;7;6;13
96;17.11.2017;2017;11;11;Perjantai;47;51;98;11;10;21
96;17.11.2017;2017;11;12;Perjantai;65;51;116;13;8;21
96;17.11.2017;2017;11;13;Perjantai;40;70;110;8;22;30
96;17.11.2017;2017;11;14;Perjantai;47;106;153;4;30;34
96;17.11.2017;2017;11;15;Perjantai;52;113;165;7;27;34
96;17.11.2017;2017;11;16;Perjantai;50;63;113;4;19;23
96;17.11.2017;2017;11;17;Perjantai;23;37;60;11;12;23
96;17.11.2017;2017;11;18;Perjantai;23;25;48;5;5;10
96;17.11.2017;2017;11;19;Perjantai;20;21;41;4;3;7
96;17.11.2017;2017;11;20;Perjantai;14;11;25;7;3;10
96;17.11.2017;2017;11;21;Perjantai;31;16;47;11;2;13
96;17.11.2017;2017;11;22;Perjantai;6;8;14;1;3;4
96;17.11.2017;2017;11;23;Perjantai;4;5;9;3;0;3
96;18.11.2017;2017;11;00;Lauantai;7;1;8;0;0;0
96;18.11.2017;2017;11;01;Lauantai;1;1;2;1;0;1
96;18.11.2017;2017;11;02;Lauantai;3;2;5;1;0;1
96;18.11.2017;2017;11;03;Lauantai;5;0;5;0;0;0
96;18.11.2017;2017;11;04;Lauantai;3;1;4;2;0;2
96;18.11.2017;2017;11;05;Lauantai;3;2;5;0;0;0
96;18.11.2017;2017;11;06;Lauantai;15;4;19;5;1;6
96;18.11.2017;2017;11;07;Lauantai;0;8;8;3;10;13
96;18.11.2017;2017;11;08;Lauantai;5;14;19;7;4;11
96;18.11.2017;2017;11;09;Lauantai;2;11;13;2;12;14
96;18.11.2017;2017;11;10;Lauantai;10;16;26;5;8;13
96;18.11.2017;2017;11;11;Lauantai;19;20;39;5;15;20
96;18.11.2017;2017;11;12;Lauantai;17;29;46;9;11;20
96;18.11.2017;2017;11;13;Lauantai;22;34;56;10;11;21
96;18.11.2017;2017;11;14;Lauantai;26;27;53;9;19;28
96;18.11.2017;2017;11;15;Lauantai;29;25;54;13;8;21
96;18.11.2017;2017;11;16;Lauantai;28;14;42;6;11;17
96;18.11.2017;2017;11;17;Lauantai;17;32;49;9;8;17
96;18.11.2017;2017;11;18;Lauantai;23;14;37;8;14;22
96;18.11.2017;2017;11;19;Lauantai;16;18;34;9;114;123
96;18.11.2017;2017;11;20;Lauantai;26;17;43;9;16;25
96;18.11.2017;2017;11;21;Lauantai;7;24;31;11;7;18
96;18.11.2017;2017;11;22;Lauantai;11;2;13;29;1;30
96;18.11.2017;2017;11;23;Lauantai;14;4;18;53;3;56
96;19.11.2017;2017;11;00;Sunnuntai;6;8;14;4;1;5
96;19.11.2017;2017;11;01;Sunnuntai;3;2;5;2;1;3
96;19.11.2017;2017;11;02;Sunnuntai;5;1;6;0;0;0
96;19.11.2017;2017;11;03;Sunnuntai;5;2;7;1;0;1
96;19.11.2017;2017;11;04;Sunnuntai;11;1;12;6;2;8
96;19.11.2017;2017;11;05;Sunnuntai;1;0;1;0;0;0
96;19.11.2017;2017;11;06;Sunnuntai;11;4;15;6;0;6
96;19.11.2017;2017;11;07;Sunnuntai;0;6;6;0;3;3
96;19.11.2017;2017;11;08;Sunnuntai;3;4;7;0;1;1
96;19.11.2017;2017;11;09;Sunnuntai;2;2;4;4;5;9
96;19.11.2017;2017;11;10;Sunnuntai;5;5;10;3;5;8
96;19.11.2017;2017;11;11;Sunnuntai;8;9;17;9;9;18
96;19.11.2017;2017;11;12;Sunnuntai;19;19;38;12;16;28
96;19.11.2017;2017;11;13;Sunnuntai;21;12;33;6;15;21
96;19.11.2017;2017;11;14;Sunnuntai;16;26;42;11;15;26
96;19.11.2017;2017;11;15;Sunnuntai;25;26;51;12;12;24
96;19.11.2017;2017;11;16;Sunnuntai;25;23;48;21;16;37
96;19.11.2017;2017;11;17;Sunnuntai;25;15;40;19;4;23
96;19.11.2017;2017;11;18;Sunnuntai;35;22;57;14;21;35
96;19.11.2017;2017;11;19;Sunnuntai;19;16;35;7;15;22
96;19.11.2017;2017;11;20;Sunnuntai;22;24;46;4;16;20
96;19.11.2017;2017;11;21;Sunnuntai;15;12;27;8;2;10
96;19.11.2017;2017;11;22;Sunnuntai;1;2;3;1;5;6
96;19.11.2017;2017;11;23;Sunnuntai;1;1;2;0;0;0
96;20.11.2017;2017;11;00;Maanantai;0;2;2;1;0;1
96;20.11.2017;2017;11;01;Maanantai;0;1;1;0;0;0
96;20.11.2017;2017;11;02;Maanantai;2;2;4;0;0;0
96;20.11.2017;2017;11;03;Maanantai;0;0;0;0;0;0
96;20.11.2017;2017;11;04;Maanantai;3;1;4;2;2;4
96;20.11.2017;2017;11;05;Maanantai;3;8;11;0;0;0
96;20.11.2017;2017;11;06;Maanantai;46;17;63;13;3;16
96;20.11.2017;2017;11;07;Maanantai;111;77;188;35;7;42
96;20.11.2017;2017;11;08;Maanantai;113;73;186;36;10;46
96;20.11.2017;2017;11;09;Maanantai;61;49;110;15;16;31
96;20.11.2017;2017;11;10;Maanantai;45;61;106;17;17;34
96;20.11.2017;2017;11;11;Maanantai;52;49;101;14;10;24
96;20.11.2017;2017;11;12;Maanantai;73;52;125;14;22;36
96;20.11.2017;2017;11;13;Maanantai;42;65;107;10;12;22
96;20.11.2017;2017;11;14;Maanantai;40;97;137;9;29;38
96;20.11.2017;2017;11;15;Maanantai;49;161;210;11;48;59
96;20.11.2017;2017;11;16;Maanantai;75;148;223;8;42;50
96;20.11.2017;2017;11;17;Maanantai;49;53;102;17;24;41
96;20.11.2017;2017;11;18;Maanantai;45;28;73;20;21;41
96;20.11.2017;2017;11;19;Maanantai;32;36;68;12;20;32
96;20.11.2017;2017;11;20;Maanantai;39;20;59;13;5;18
96;20.11.2017;2017;11;21;Maanantai;26;20;46;2;9;11
96;20.11.2017;2017;11;22;Maanantai;7;8;15;1;1;2
96;20.11.2017;2017;11;23;Maanantai;0;2;2;1;2;3
96;21.11.2017;2017;11;00;Tiistai;2;0;2;0;0;0
96;21.11.2017;2017;11;01;Tiistai;0;0;0;0;0;0
96;21.11.2017;2017;11;02;Tiistai;2;0;2;0;0;0
96;21.11.2017;2017;11;03;Tiistai;0;0;0;1;1;2
96;21.11.2017;2017;11;04;Tiistai;2;1;3;0;1;1
96;21.11.2017;2017;11;05;Tiistai;4;7;11;0;0;0
96;21.11.2017;2017;11;06;Tiistai;49;17;66;11;2;13
96;21.11.2017;2017;11;07;Tiistai;120;70;190;37;8;45
96;21.11.2017;2017;11;08;Tiistai;126;91;217;25;14;39
96;21.11.2017;2017;11;09;Tiistai;57;39;96;11;9;20
96;21.11.2017;2017;11;10;Tiistai;54;39;93;10;15;25
96;21.11.2017;2017;11;11;Tiistai;56;53;109;18;24;42
96;21.11.2017;2017;11;12;Tiistai;61;61;122;17;13;30
96;21.11.2017;2017;11;13;Tiistai;59;91;150;18;14;32
96;21.11.2017;2017;11;14;Tiistai;130;20;150;23;13;36
96;21.11.2017;2017;11;15;Tiistai;237;0;237;46;0;46
96;21.11.2017;2017;11;16;Tiistai;234;0;234;63;0;63
96;21.11.2017;2017;11;17;Tiistai;127;0;127;49;0;49
96;21.11.2017;2017;11;18;Tiistai;97;0;97;26;0;26
96;21.11.2017;2017;11;19;Tiistai;79;0;79;27;0;27
96;21.11.2017;2017;11;20;Tiistai;72;0;72;11;0;11
96;21.11.2017;2017;11;21;Tiistai;72;0;72;20;0;20
96;21.11.2017;2017;11;22;Tiistai;18;0;18;5;0;5
96;21.11.2017;2017;11;23;Tiistai;6;0;6;0;0;0
96;22.11.2017;2017;11;00;Keskiviikko;5;0;5;2;0;2
96;22.11.2017;2017;11;01;Keskiviikko;1;0;1;2;0;2
96;22.11.2017;2017;11;02;Keskiviikko;2;0;2;3;0;3
96;22.11.2017;2017;11;03;Keskiviikko;0;0;0;0;0;0
96;22.11.2017;2017;11;04;Keskiviikko;2;0;2;1;0;1
96;22.11.2017;2017;11;05;Keskiviikko;9;0;9;1;0;1
96;22.11.2017;2017;11;06;Keskiviikko;71;0;71;14;0;14
96;22.11.2017;2017;11;07;Keskiviikko;185;0;185;43;0;43
96;22.11.2017;2017;11;08;Keskiviikko;215;0;215;33;0;33
96;22.11.2017;2017;11;09;Keskiviikko;88;0;88;14;0;14
96;22.11.2017;2017;11;10;Keskiviikko;84;0;84;27;0;27
96;22.11.2017;2017;11;11;Keskiviikko;109;0;109;29;0;29
96;22.11.2017;2017;11;12;Keskiviikko;137;0;137;19;0;19
96;22.11.2017;2017;11;13;Keskiviikko;109;0;109;36;0;36
96;22.11.2017;2017;11;14;Keskiviikko;157;0;157;56;0;56
96;22.11.2017;2017;11;15;Keskiviikko;197;0;197;56;0;56
96;22.11.2017;2017;11;16;Keskiviikko;229;0;229;68;0;68
96;22.11.2017;2017;11;17;Keskiviikko;112;0;112;32;0;32
96;22.11.2017;2017;11;18;Keskiviikko;97;0;97;28;0;28
96;22.11.2017;2017;11;19;Keskiviikko;54;0;54;20;0;20
96;22.11.2017;2017;11;20;Keskiviikko;54;0;54;19;0;19
96;22.11.2017;2017;11;21;Keskiviikko;48;0;48;13;0;13
96;22.11.2017;2017;11;22;Keskiviikko;14;0;14;4;0;4
96;22.11.2017;2017;11;23;Keskiviikko;5;0;5;0;0;0
96;23.11.2017;2017;11;00;Torstai;0;0;0;2;0;2
96;23.11.2017;2017;11;01;Torstai;1;0;1;1;0;1
96;23.11.2017;2017;11;02;Torstai;2;0;2;0;0;0
96;23.11.2017;2017;11;03;Torstai;1;0;1;1;0;1
96;23.11.2017;2017;11;04;Torstai;2;0;2;1;0;1
96;23.11.2017;2017;11;05;Torstai;7;0;7;1;0;1
96;23.11.2017;2017;11;06;Torstai;48;0;48;16;0;16
96;23.11.2017;2017;11;07;Torstai;160;0;160;48;0;48
96;23.11.2017;2017;11;08;Torstai;205;0;205;41;0;41
96;23.11.2017;2017;11;09;Torstai;86;0;86;27;0;27
96;23.11.2017;2017;11;10;Torstai;120;0;120;29;0;29
96;23.11.2017;2017;11;11;Torstai;117;0;117;32;0;32
96;23.11.2017;2017;11;12;Torstai;134;0;134;29;0;29
96;23.11.2017;2017;11;13;Torstai;117;1;118;48;0;48
96;23.11.2017;2017;11;14;Torstai;115;1;116;36;0;36
96;23.11.2017;2017;11;15;Torstai;170;0;170;41;0;41
96;23.11.2017;2017;11;16;Torstai;169;0;169;44;0;44
96;23.11.2017;2017;11;17;Torstai;82;0;82;16;0;16
96;23.11.2017;2017;11;18;Torstai;43;8;51;15;0;15
96;23.11.2017;2017;11;19;Torstai;35;10;45;16;0;16
96;23.11.2017;2017;11;20;Torstai;16;13;29;15;0;15
96;23.11.2017;2017;11;21;Torstai;21;21;42;10;0;10
96;23.11.2017;2017;11;22;Torstai;8;6;14;3;0;3
96;23.11.2017;2017;11;23;Torstai;2;2;4;2;0;2
96;24.11.2017;2017;11;00;Perjantai;1;0;1;0;0;0
96;24.11.2017;2017;11;01;Perjantai;2;0;2;0;0;0
96;24.11.2017;2017;11;02;Perjantai;1;0;1;0;0;0
96;24.11.2017;2017;11;03;Perjantai;0;0;0;0;0;0
96;24.11.2017;2017;11;04;Perjantai;3;2;5;4;0;4
96;24.11.2017;2017;11;05;Perjantai;3;0;3;0;0;0
96;24.11.2017;2017;11;06;Perjantai;22;19;41;15;0;15
96;24.11.2017;2017;11;07;Perjantai;65;64;129;40;0;40
96;24.11.2017;2017;11;08;Perjantai;63;61;124;50;0;50
96;24.11.2017;2017;11;09;Perjantai;36;33;69;30;0;30
96;24.11.2017;2017;11;10;Perjantai;44;42;86;33;0;33
96;24.11.2017;2017;11;11;Perjantai;44;43;87;25;0;25
96;24.11.2017;2017;11;12;Perjantai;48;47;95;35;0;35
96;24.11.2017;2017;11;13;Perjantai;53;29;82;10;0;10
96;24.11.2017;2017;11;14;Perjantai;121;1;122;43;0;43
96;24.11.2017;2017;11;15;Perjantai;73;73;146;16;21;37
96;24.11.2017;2017;11;16;Perjantai;43;57;100;6;20;26
96;24.11.2017;2017;11;17;Perjantai;17;26;43;12;12;24
96;24.11.2017;2017;11;18;Perjantai;28;16;44;8;5;13
96;24.11.2017;2017;11;19;Perjantai;24;15;39;7;6;13
96;24.11.2017;2017;11;20;Perjantai;18;19;37;7;4;11
96;24.11.2017;2017;11;21;Perjantai;18;22;40;2;4;6
96;24.11.2017;2017;11;22;Perjantai;7;7;14;2;4;6
96;24.11.2017;2017;11;23;Perjantai;8;4;12;3;1;4
96;25.11.2017;2017;11;00;Lauantai;4;8;12;3;2;5
96;25.11.2017;2017;11;01;Lauantai;7;0;7;0;2;2
96;25.11.2017;2017;11;02;Lauantai;2;0;2;3;0;3
96;25.11.2017;2017;11;03;Lauantai;1;1;2;3;1;4
96;25.11.2017;2017;11;04;Lauantai;4;1;5;5;1;6
96;25.11.2017;2017;11;05;Lauantai;5;3;8;0;1;1
96;25.11.2017;2017;11;06;Lauantai;17;6;23;4;0;4
96;25.11.2017;2017;11;07;Lauantai;1;7;8;2;2;4
96;25.11.2017;2017;11;08;Lauantai;8;10;18;4;7;11
96;25.11.2017;2017;11;09;Lauantai;7;12;19;7;7;14
96;25.11.2017;2017;11;10;Lauantai;11;19;30;10;6;16
96;25.11.2017;2017;11;11;Lauantai;16;20;36;9;11;20
96;25.11.2017;2017;11;12;Lauantai;24;19;43;8;10;18
96;25.11.2017;2017;11;13;Lauantai;32;17;49;9;14;23
96;25.11.2017;2017;11;14;Lauantai;17;26;43;8;8;16
96;25.11.2017;2017;11;15;Lauantai;26;42;68;13;18;31
96;25.11.2017;2017;11;16;Lauantai;23;10;33;7;11;18
96;25.11.2017;2017;11;17;Lauantai;24;14;38;11;4;15
96;25.11.2017;2017;11;18;Lauantai;16;23;39;11;10;21
96;25.11.2017;2017;11;19;Lauantai;18;13;31;8;6;14
96;25.11.2017;2017;11;20;Lauantai;11;9;20;9;4;13
96;25.11.2017;2017;11;21;Lauantai;9;20;29;1;14;15
96;25.11.2017;2017;11;22;Lauantai;7;4;11;4;0;4
96;25.11.2017;2017;11;23;Lauantai;3;7;10;2;0;2
96;26.11.2017;2017;11;00;Sunnuntai;7;8;15;3;1;4
96;26.11.2017;2017;11;01;Sunnuntai;5;5;10;12;2;14
96;26.11.2017;2017;11;02;Sunnuntai;3;2;5;5;1;6
96;26.11.2017;2017;11;03;Sunnuntai;6;0;6;4;0;4
96;26.11.2017;2017;11;04;Sunnuntai;7;0;7;6;0;6
96;26.11.2017;2017;11;05;Sunnuntai;2;1;3;1;0;1
96;26.11.2017;2017;11;06;Sunnuntai;21;2;23;4;1;5
96;26.11.2017;2017;11;07;Sunnuntai;3;7;10;4;2;6
96;26.11.2017;2017;11;08;Sunnuntai;3;5;8;3;2;5
96;26.11.2017;2017;11;09;Sunnuntai;3;5;8;5;7;12
96;26.11.2017;2017;11;10;Sunnuntai;2;15;17;17;13;30
96;26.11.2017;2017;11;11;Sunnuntai;8;10;18;3;11;14
96;26.11.2017;2017;11;12;Sunnuntai;12;15;27;8;12;20
96;26.11.2017;2017;11;13;Sunnuntai;27;20;47;7;5;12
96;26.11.2017;2017;11;14;Sunnuntai;29;24;53;8;4;12
96;26.11.2017;2017;11;15;Sunnuntai;18;28;46;14;13;27
96;26.11.2017;2017;11;16;Sunnuntai;24;15;39;18;3;21
96;26.11.2017;2017;11;17;Sunnuntai;17;19;36;21;8;29
96;26.11.2017;2017;11;18;Sunnuntai;23;15;38;17;19;36
96;26.11.2017;2017;11;19;Sunnuntai;16;13;29;10;15;25
96;26.11.2017;2017;11;20;Sunnuntai;18;17;35;10;16;26
96;26.11.2017;2017;11;21;Sunnuntai;10;9;19;5;3;8
96;26.11.2017;2017;11;22;Sunnuntai;7;3;10;1;1;2
96;26.11.2017;2017;11;23;Sunnuntai;1;0;1;0;1;1
96;27.11.2017;2017;11;00;Maanantai;0;1;1;1;1;2
96;27.11.2017;2017;11;01;Maanantai;0;0;0;1;0;1
96;27.11.2017;2017;11;02;Maanantai;2;1;3;0;0;0
96;27.11.2017;2017;11;03;Maanantai;2;0;2;0;0;0
96;27.11.2017;2017;11;04;Maanantai;1;0;1;0;0;0
96;27.11.2017;2017;11;05;Maanantai;4;4;8;0;1;1
96;27.11.2017;2017;11;06;Maanantai;46;19;65;10;3;13
96;27.11.2017;2017;11;07;Maanantai;115;67;182;49;10;59
96;27.11.2017;2017;11;08;Maanantai;116;77;193;19;16;35
96;27.11.2017;2017;11;09;Maanantai;64;53;117;18;11;29
96;27.11.2017;2017;11;10;Maanantai;55;36;91;10;15;25
96;27.11.2017;2017;11;11;Maanantai;43;37;80;16;16;32
96;27.11.2017;2017;11;12;Maanantai;57;58;115;20;19;39
96;27.11.2017;2017;11;13;Maanantai;58;73;131;16;21;37
96;27.11.2017;2017;11;14;Maanantai;59;89;148;15;29;44
96;27.11.2017;2017;11;15;Maanantai;46;158;204;15;40;55
96;27.11.2017;2017;11;16;Maanantai;78;136;214;19;43;62
96;27.11.2017;2017;11;17;Maanantai;58;56;114;6;19;25
96;27.11.2017;2017;11;18;Maanantai;28;36;64;14;11;25
96;27.11.2017;2017;11;19;Maanantai;37;34;71;6;7;13
96;27.11.2017;2017;11;20;Maanantai;34;21;55;7;7;14
96;27.11.2017;2017;11;21;Maanantai;19;22;41;4;10;14
96;27.11.2017;2017;11;22;Maanantai;7;9;16;0;3;3
96;27.11.2017;2017;11;23;Maanantai;4;1;5;0;1;1
96;28.11.2017;2017;11;00;Tiistai;3;2;5;0;2;2
96;28.11.2017;2017;11;01;Tiistai;4;2;6;0;1;1
96;28.11.2017;2017;11;02;Tiistai;1;0;1;0;0;0
96;28.11.2017;2017;11;03;Tiistai;1;1;2;1;1;2
96;28.11.2017;2017;11;04;Tiistai;2;0;2;0;1;1
96;28.11.2017;2017;11;05;Tiistai;3;5;8;0;2;2
96;28.11.2017;2017;11;06;Tiistai;49;20;69;12;2;14
96;28.11.2017;2017;11;07;Tiistai;129;56;185;42;4;46
96;28.11.2017;2017;11;08;Tiistai;137;74;211;26;8;34
96;28.11.2017;2017;11;09;Tiistai;51;46;97;17;23;40
96;28.11.2017;2017;11;10;Tiistai;40;43;83;13;15;28
96;28.11.2017;2017;11;11;Tiistai;79;55;134;17;20;37
96;28.11.2017;2017;11;12;Tiistai;70;63;133;17;18;35
96;28.11.2017;2017;11;13;Tiistai;47;65;112;23;12;35
96;28.11.2017;2017;11;14;Tiistai;44;85;129;8;25;33
96;28.11.2017;2017;11;15;Tiistai;64;149;213;21;44;65
96;28.11.2017;2017;11;16;Tiistai;59;114;173;9;43;52
96;28.11.2017;2017;11;17;Tiistai;52;72;124;19;23;42
96;28.11.2017;2017;11;18;Tiistai;35;42;77;12;14;26
96;28.11.2017;2017;11;19;Tiistai;26;27;53;17;26;43
96;28.11.2017;2017;11;20;Tiistai;26;24;50;16;9;25
96;28.11.2017;2017;11;21;Tiistai;32;33;65;12;8;20
96;28.11.2017;2017;11;22;Tiistai;2;9;11;0;5;5
96;28.11.2017;2017;11;23;Tiistai;3;4;7;0;2;2
96;29.11.2017;2017;11;00;Keskiviikko;5;1;6;1;2;3
96;29.11.2017;2017;11;01;Keskiviikko;3;2;5;0;1;1
96;29.11.2017;2017;11;02;Keskiviikko;3;2;5;0;0;0
96;29.11.2017;2017;11;03;Keskiviikko;5;1;6;1;0;1
96;29.11.2017;2017;11;04;Keskiviikko;5;0;5;0;0;0
96;29.11.2017;2017;11;05;Keskiviikko;4;7;11;0;0;0
96;29.11.2017;2017;11;06;Keskiviikko;36;20;56;11;3;14
96;29.11.2017;2017;11;07;Keskiviikko;101;93;194;44;10;54
96;29.11.2017;2017;11;08;Keskiviikko;146;75;221;23;7;30
96;29.11.2017;2017;11;09;Keskiviikko;66;46;112;23;18;41
96;29.11.2017;2017;11;10;Keskiviikko;48;43;91;18;15;33
96;29.11.2017;2017;11;11;Keskiviikko;75;67;142;17;21;38
96;29.11.2017;2017;11;12;Keskiviikko;59;72;131;14;18;32
96;29.11.2017;2017;11;13;Keskiviikko;52;82;134;15;25;40
96;29.11.2017;2017;11;14;Keskiviikko;54;117;171;8;35;43
96;29.11.2017;2017;11;15;Keskiviikko;66;142;208;10;43;53
96;29.11.2017;2017;11;16;Keskiviikko;60;160;220;13;38;51
96;29.11.2017;2017;11;17;Keskiviikko;36;48;84;18;20;38
96;29.11.2017;2017;11;18;Keskiviikko;47;28;75;28;17;45
96;29.11.2017;2017;11;19;Keskiviikko;42;28;70;18;16;34
96;29.11.2017;2017;11;20;Keskiviikko;18;35;53;12;11;23
96;29.11.2017;2017;11;21;Keskiviikko;21;34;55;2;12;14
96;29.11.2017;2017;11;22;Keskiviikko;2;7;9;0;3;3
96;29.11.2017;2017;11;23;Keskiviikko;1;4;5;0;0;0
96;30.11.2017;2017;11;00;Torstai;1;3;4;1;0;1
96;30.11.2017;2017;11;01;Torstai;0;0;0;0;0;0
96;30.11.2017;2017;11;02;Torstai;1;1;2;0;0;0
96;30.11.2017;2017;11;03;Torstai;0;1;1;1;3;4
96;30.11.2017;2017;11;04;Torstai;3;0;3;1;1;2
96;30.11.2017;2017;11;05;Torstai;6;7;13;1;1;2
96;30.11.2017;2017;11;06;Torstai;40;21;61;11;4;15
96;30.11.2017;2017;11;07;Torstai;93;80;173;39;16;55
96;30.11.2017;2017;11;08;Torstai;111;90;201;21;7;28
96;30.11.2017;2017;11;09;Torstai;89;31;120;18;16;34
96;30.11.2017;2017;11;10;Torstai;64;39;103;10;15;25
96;30.11.2017;2017;11;11;Torstai;50;52;102;14;18;32
96;30.11.2017;2017;11;12;Torstai;53;70;123;16;25;41
96;30.11.2017;2017;11;13;Torstai;62;66;128;17;23;40
96;30.11.2017;2017;11;14;Torstai;53;105;158;13;34;47
96;30.11.2017;2017;11;15;Torstai;57;149;206;12;43;55
96;30.11.2017;2017;11;16;Torstai;57;153;210;9;39;48
96;30.11.2017;2017;11;17;Torstai;35;56;91;9;20;29
96;30.11.2017;2017;11;18;Torstai;50;44;94;19;17;36
96;30.11.2017;2017;11;19;Torstai;32;23;55;17;27;44
96;30.11.2017;2017;11;20;Torstai;31;31;62;10;14;24
96;30.11.2017;2017;11;21;Torstai;18;36;54;7;6;13
96;30.11.2017;2017;11;22;Torstai;9;8;17;3;4;7
96;30.11.2017;2017;11;23;Torstai;2;7;9;1;0;1
96;01.12.2017;2017;12;00;Perjantai;2;0;2;1;0;1
96;01.12.2017;2017;12;01;Perjantai;5;0;5;0;1;1
96;01.12.2017;2017;12;02;Perjantai;2;0;2;1;2;3
96;01.12.2017;2017;12;03;Perjantai;5;0;5;1;0;1
96;01.12.2017;2017;12;04;Perjantai;4;2;6;3;1;4
96;01.12.2017;2017;12;05;Perjantai;4;6;10;2;0;2
96;01.12.2017;2017;12;06;Perjantai;36;30;66;13;4;17
96;01.12.2017;2017;12;07;Perjantai;101;76;177;35;12;47
96;01.12.2017;2017;12;08;Perjantai;69;82;151;14;8;22
96;01.12.2017;2017;12;09;Perjantai;52;48;100;17;13;30
96;01.12.2017;2017;12;10;Perjantai;39;37;76;15;11;26
96;01.12.2017;2017;12;11;Perjantai;53;62;115;12;15;27
96;01.12.2017;2017;12;12;Perjantai;48;67;115;15;23;38
96;01.12.2017;2017;12;13;Perjantai;45;90;135;6;17;23
96;01.12.2017;2017;12;14;Perjantai;59;119;178;11;26;37
96;01.12.2017;2017;12;15;Perjantai;72;107;179;10;45;55
96;01.12.2017;2017;12;16;Perjantai;58;72;130;6;17;23
96;01.12.2017;2017;12;17;Perjantai;37;40;77;15;11;26
96;01.12.2017;2017;12;18;Perjantai;34;23;57;5;8;13
96;01.12.2017;2017;12;19;Perjantai;21;17;38;6;11;17
96;01.12.2017;2017;12;20;Perjantai;32;20;52;13;8;21
96;01.12.2017;2017;12;21;Perjantai;23;19;42;7;7;14
96;01.12.2017;2017;12;22;Perjantai;8;8;16;2;6;8
96;01.12.2017;2017;12;23;Perjantai;4;3;7;0;0;0
96;02.12.2017;2017;12;00;Lauantai;2;2;4;9;1;10
96;02.12.2017;2017;12;01;Lauantai;5;3;8;1;0;1
96;02.12.2017;2017;12;02;Lauantai;7;1;8;1;1;2
96;02.12.2017;2017;12;03;Lauantai;2;0;2;2;0;2
96;02.12.2017;2017;12;04;Lauantai;3;1;4;2;0;2
96;02.12.2017;2017;12;05;Lauantai;2;1;3;2;0;2
96;02.12.2017;2017;12;06;Lauantai;21;2;23;6;0;6
96;02.12.2017;2017;12;07;Lauantai;4;9;13;0;6;6
96;02.12.2017;2017;12;08;Lauantai;9;16;25;4;4;8
96;02.12.2017;2017;12;09;Lauantai;7;26;33;5;9;14
96;02.12.2017;2017;12;10;Lauantai;20;22;42;13;15;28
96;02.12.2017;2017;12;11;Lauantai;19;20;39;21;25;46
96;02.12.2017;2017;12;12;Lauantai;29;34;63;21;17;38
96;02.12.2017;2017;12;13;Lauantai;34;33;67;13;26;39
96;02.12.2017;2017;12;14;Lauantai;29;46;75;13;18;31
96;02.12.2017;2017;12;15;Lauantai;27;62;89;15;93;108
96;02.12.2017;2017;12;16;Lauantai;25;25;50;11;11;22
96;02.12.2017;2017;12;17;Lauantai;21;22;43;8;10;18
96;02.12.2017;2017;12;18;Lauantai;42;27;69;74;10;84
96;02.12.2017;2017;12;19;Lauantai;23;18;41;16;4;20
96;02.12.2017;2017;12;20;Lauantai;17;12;29;8;11;19
96;02.12.2017;2017;12;21;Lauantai;11;9;20;4;4;8
96;02.12.2017;2017;12;22;Lauantai;11;7;18;4;0;4
96;02.12.2017;2017;12;23;Lauantai;11;14;25;2;1;3
96;03.12.2017;2017;12;00;Sunnuntai;7;8;15;3;3;6
96;03.12.2017;2017;12;01;Sunnuntai;1;5;6;1;0;1
96;03.12.2017;2017;12;02;Sunnuntai;8;0;8;1;0;1
96;03.12.2017;2017;12;03;Sunnuntai;9;1;10;1;2;3
96;03.12.2017;2017;12;04;Sunnuntai;5;0;5;1;0;1
96;03.12.2017;2017;12;05;Sunnuntai;3;0;3;1;0;1
96;03.12.2017;2017;12;06;Sunnuntai;18;3;21;4;0;4
96;03.12.2017;2017;12;07;Sunnuntai;3;7;10;1;4;5
96;03.12.2017;2017;12;08;Sunnuntai;1;2;3;3;1;4
96;03.12.2017;2017;12;09;Sunnuntai;6;12;18;4;8;12
96;03.12.2017;2017;12;10;Sunnuntai;3;12;15;8;14;22
96;03.12.2017;2017;12;11;Sunnuntai;8;24;32;9;14;23
96;03.12.2017;2017;12;12;Sunnuntai;9;19;28;18;20;38
96;03.12.2017;2017;12;13;Sunnuntai;26;26;52;13;15;28
96;03.12.2017;2017;12;14;Sunnuntai;28;21;49;15;13;28
96;03.12.2017;2017;12;15;Sunnuntai;27;26;53;5;12;17
96;03.12.2017;2017;12;16;Sunnuntai;37;13;50;16;5;21
96;03.12.2017;2017;12;17;Sunnuntai;18;11;29;17;8;25
96;03.12.2017;2017;12;18;Sunnuntai;22;17;39;17;23;40
96;03.12.2017;2017;12;19;Sunnuntai;12;17;29;10;16;26
96;03.12.2017;2017;12;20;Sunnuntai;9;18;27;7;11;18
96;03.12.2017;2017;12;21;Sunnuntai;18;9;27;8;7;15
96;03.12.2017;2017;12;22;Sunnuntai;1;4;5;0;5;5
96;03.12.2017;2017;12;23;Sunnuntai;2;1;3;2;2;4
96;04.12.2017;2017;12;00;Maanantai;2;1;3;1;0;1
96;04.12.2017;2017;12;01;Maanantai;2;1;3;3;0;3
96;04.12.2017;2017;12;02;Maanantai;1;0;1;0;0;0
96;04.12.2017;2017;12;03;Maanantai;1;0;1;0;0;0
96;04.12.2017;2017;12;04;Maanantai;2;0;2;0;0;0
96;04.12.2017;2017;12;05;Maanantai;3;7;10;0;2;2
96;04.12.2017;2017;12;06;Maanantai;37;15;52;14;3;17
96;04.12.2017;2017;12;07;Maanantai;104;55;159;36;9;45
96;04.12.2017;2017;12;08;Maanantai;79;83;162;13;7;20
96;04.12.2017;2017;12;09;Maanantai;98;46;144;22;11;33
96;04.12.2017;2017;12;10;Maanantai;58;33;91;9;13;22
96;04.12.2017;2017;12;11;Maanantai;77;74;151;40;33;73
96;04.12.2017;2017;12;12;Maanantai;60;65;125;20;41;61
96;04.12.2017;2017;12;13;Maanantai;54;64;118;13;24;37
96;04.12.2017;2017;12;14;Maanantai;48;84;132;16;25;41
96;04.12.2017;2017;12;15;Maanantai;61;143;204;12;32;44
96;04.12.2017;2017;12;16;Maanantai;75;153;228;12;46;58
96;04.12.2017;2017;12;17;Maanantai;41;46;87;16;20;36
96;04.12.2017;2017;12;18;Maanantai;47;44;91;9;16;25
96;04.12.2017;2017;12;19;Maanantai;17;20;37;13;12;25
96;04.12.2017;2017;12;20;Maanantai;30;27;57;8;8;16
96;04.12.2017;2017;12;21;Maanantai;19;29;48;3;11;14
96;04.12.2017;2017;12;22;Maanantai;9;10;19;0;2;2
96;04.12.2017;2017;12;23;Maanantai;3;4;7;2;2;4
96;05.12.2017;2017;12;00;Tiistai;0;1;1;2;0;2
96;05.12.2017;2017;12;01;Tiistai;1;0;1;0;0;0
96;05.12.2017;2017;12;02;Tiistai;1;1;2;0;0;0
96;05.12.2017;2017;12;03;Tiistai;1;1;2;0;0;0
96;05.12.2017;2017;12;04;Tiistai;2;0;2;1;1;2
96;05.12.2017;2017;12;05;Tiistai;1;5;6;0;0;0
96;05.12.2017;2017;12;06;Tiistai;37;24;61;16;1;17
96;05.12.2017;2017;12;07;Tiistai;100;51;151;45;10;55
96;05.12.2017;2017;12;08;Tiistai;79;76;155;19;8;27
96;05.12.2017;2017;12;09;Tiistai;68;34;102;11;6;17
96;05.12.2017;2017;12;10;Tiistai;47;39;86;10;9;19
96;05.12.2017;2017;12;11;Tiistai;56;55;111;15;9;24
96;05.12.2017;2017;12;12;Tiistai;53;64;117;17;18;35
96;05.12.2017;2017;12;13;Tiistai;48;69;117;6;27;33
96;05.12.2017;2017;12;14;Tiistai;41;84;125;9;38;47
96;05.12.2017;2017;12;15;Tiistai;41;138;179;18;42;60
96;05.12.2017;2017;12;16;Tiistai;59;105;164;11;32;43
96;05.12.2017;2017;12;17;Tiistai;27;41;68;8;14;22
96;05.12.2017;2017;12;18;Tiistai;42;26;68;8;6;14
96;05.12.2017;2017;12;19;Tiistai;20;33;53;7;20;27
96;05.12.2017;2017;12;20;Tiistai;21;15;36;7;8;15
96;05.12.2017;2017;12;21;Tiistai;22;26;48;7;10;17
96;05.12.2017;2017;12;22;Tiistai;5;11;16;5;3;8
96;05.12.2017;2017;12;23;Tiistai;6;8;14;0;0;0
96;06.12.2017;2017;12;00;Keskiviikko;10;6;16;0;6;6
96;06.12.2017;2017;12;01;Keskiviikko;6;1;7;2;0;2
96;06.12.2017;2017;12;02;Keskiviikko;4;0;4;0;0;0
96;06.12.2017;2017;12;03;Keskiviikko;4;0;4;5;0;5
96;06.12.2017;2017;12;04;Keskiviikko;10;0;10;3;0;3
96;06.12.2017;2017;12;05;Keskiviikko;3;3;6;1;0;1
96;06.12.2017;2017;12;06;Keskiviikko;18;3;21;7;1;8
96;06.12.2017;2017;12;07;Keskiviikko;0;8;8;2;0;2
96;06.12.2017;2017;12;08;Keskiviikko;6;8;14;3;2;5
96;06.12.2017;2017;12;09;Keskiviikko;3;8;11;1;4;5
96;06.12.2017;2017;12;10;Keskiviikko;7;6;13;4;11;15
96;06.12.2017;2017;12;11;Keskiviikko;12;24;36;10;11;21
96;06.12.2017;2017;12;12;Keskiviikko;31;21;52;21;12;33
96;06.12.2017;2017;12;13;Keskiviikko;26;11;37;10;10;20
96;06.12.2017;2017;12;14;Keskiviikko;26;29;55;12;14;26
96;06.12.2017;2017;12;15;Keskiviikko;21;29;50;7;10;17
96;06.12.2017;2017;12;16;Keskiviikko;23;17;40;7;12;19
96;06.12.2017;2017;12;17;Keskiviikko;16;15;31;10;16;26
96;06.12.2017;2017;12;18;Keskiviikko;7;8;15;9;7;16
96;06.12.2017;2017;12;19;Keskiviikko;7;6;13;2;3;5
96;06.12.2017;2017;12;20;Keskiviikko;13;7;20;8;1;9
96;06.12.2017;2017;12;21;Keskiviikko;9;17;26;2;3;5
96;06.12.2017;2017;12;22;Keskiviikko;6;7;13;2;1;3
96;06.12.2017;2017;12;23;Keskiviikko;5;1;6;0;0;0
96;07.12.2017;2017;12;00;Torstai;0;1;1;1;0;1
96;07.12.2017;2017;12;01;Torstai;1;0;1;1;0;1
96;07.12.2017;2017;12;02;Torstai;0;0;0;0;0;0
96;07.12.2017;2017;12;03;Torstai;1;0;1;1;0;1
96;07.12.2017;2017;12;04;Torstai;3;0;3;1;0;1
96;07.12.2017;2017;12;05;Torstai;6;5;11;0;0;0
96;07.12.2017;2017;12;06;Torstai;37;19;56;11;1;12
96;07.12.2017;2017;12;07;Torstai;87;62;149;31;6;37
96;07.12.2017;2017;12;08;Torstai;68;95;163;18;13;31
96;07.12.2017;2017;12;09;Torstai;74;37;111;14;5;19
96;07.12.2017;2017;12;10;Torstai;79;38;117;10;17;27
96;07.12.2017;2017;12;11;Torstai;57;40;97;8;14;22
96;07.12.2017;2017;12;12;Torstai;58;63;121;17;8;25
96;07.12.2017;2017;12;13;Torstai;51;61;112;13;17;30
96;07.12.2017;2017;12;14;Torstai;49;108;157;6;38;44
96;07.12.2017;2017;12;15;Torstai;58;141;199;8;39;47
96;07.12.2017;2017;12;16;Torstai;72;138;210;11;32;43
96;07.12.2017;2017;12;17;Torstai;51;62;113;8;13;21
96;07.12.2017;2017;12;18;Torstai;39;39;78;9;5;14
96;07.12.2017;2017;12;19;Torstai;35;29;64;8;17;25
96;07.12.2017;2017;12;20;Torstai;28;10;38;11;8;19
96;07.12.2017;2017;12;21;Torstai;16;38;54;1;8;9
96;07.12.2017;2017;12;22;Torstai;7;11;18;2;3;5
96;07.12.2017;2017;12;23;Torstai;5;1;6;0;1;1
96;08.12.2017;2017;12;00;Perjantai;0;0;0;0;0;0
96;08.12.2017;2017;12;01;Perjantai;2;0;2;1;0;1
96;08.12.2017;2017;12;02;Perjantai;0;2;2;1;0;1
96;08.12.2017;2017;12;03;Perjantai;4;0;4;1;0;1
96;08.12.2017;2017;12;04;Perjantai;1;1;2;0;0;0
96;08.12.2017;2017;12;05;Perjantai;5;4;9;1;0;1
96;08.12.2017;2017;12;06;Perjantai;22;21;43;11;1;12
96;08.12.2017;2017;12;07;Perjantai;71;70;141;31;6;37
96;08.12.2017;2017;12;08;Perjantai;69;67;136;18;12;30
96;08.12.2017;2017;12;09;Perjantai;48;45;93;14;6;20
96;08.12.2017;2017;12;10;Perjantai;37;34;71;10;17;27
96;08.12.2017;2017;12;11;Perjantai;47;44;91;8;14;22
96;08.12.2017;2017;12;12;Perjantai;50;49;99;17;8;25
96;08.12.2017;2017;12;13;Perjantai;66;62;128;13;27;40
96;08.12.2017;2017;12;14;Perjantai;81;79;160;6;38;44
96;08.12.2017;2017;12;15;Perjantai;64;61;125;8;39;47
96;08.12.2017;2017;12;16;Perjantai;51;48;99;11;32;43
96;08.12.2017;2017;12;17;Perjantai;30;26;56;8;12;20
96;08.12.2017;2017;12;18;Perjantai;29;27;56;8;5;13
96;08.12.2017;2017;12;19;Perjantai;18;14;32;8;17;25
96;08.12.2017;2017;12;20;Perjantai;12;12;24;11;8;19
96;08.12.2017;2017;12;21;Perjantai;21;18;39;1;8;9
96;08.12.2017;2017;12;22;Perjantai;11;10;21;2;3;5
96;08.12.2017;2017;12;23;Perjantai;7;4;11;0;1;1
96;09.12.2017;2017;12;00;Lauantai;5;2;7;0;0;0
96;09.12.2017;2017;12;01;Lauantai;5;3;8;0;0;0
96;09.12.2017;2017;12;02;Lauantai;4;2;6;0;0;0
96;09.12.2017;2017;12;03;Lauantai;3;3;6;0;0;0
96;09.12.2017;2017;12;04;Lauantai;4;3;7;0;0;0
96;09.12.2017;2017;12;05;Lauantai;1;1;2;0;0;0
96;09.12.2017;2017;12;06;Lauantai;12;10;22;0;0;0
96;09.12.2017;2017;12;07;Lauantai;7;6;13;0;0;0
96;09.12.2017;2017;12;08;Lauantai;10;3;13;0;0;0
96;09.12.2017;2017;12;09;Lauantai;12;8;20;2;2;4
96;09.12.2017;2017;12;10;Lauantai;12;20;32;5;4;9
96;09.12.2017;2017;12;11;Lauantai;22;28;50;13;16;29
96;09.12.2017;2017;12;12;Lauantai;33;29;62;11;19;30
96;09.12.2017;2017;12;13;Lauantai;28;31;59;14;25;39
96;09.12.2017;2017;12;14;Lauantai;31;36;67;8;14;22
96;09.12.2017;2017;12;15;Lauantai;19;31;50;12;16;28
96;09.12.2017;2017;12;16;Lauantai;17;22;39;7;9;16
96;09.12.2017;2017;12;17;Lauantai;12;15;27;8;2;10
96;09.12.2017;2017;12;18;Lauantai;22;14;36;8;7;15
96;09.12.2017;2017;12;19;Lauantai;21;14;35;8;8;16
96;09.12.2017;2017;12;20;Lauantai;10;7;17;8;4;12
96;09.12.2017;2017;12;21;Lauantai;9;13;22;0;4;4
96;09.12.2017;2017;12;22;Lauantai;6;8;14;4;2;6
96;09.12.2017;2017;12;23;Lauantai;6;3;9;2;2;4
96;10.12.2017;2017;12;00;Sunnuntai;1;5;6;1;0;1
96;10.12.2017;2017;12;01;Sunnuntai;3;1;4;2;0;2
96;10.12.2017;2017;12;02;Sunnuntai;3;0;3;1;0;1
96;10.12.2017;2017;12;03;Sunnuntai;8;0;8;0;0;0
96;10.12.2017;2017;12;04;Sunnuntai;8;0;8;4;0;4
96;10.12.2017;2017;12;05;Sunnuntai;0;0;0;1;0;1
96;10.12.2017;2017;12;06;Sunnuntai;13;3;16;6;1;7
96;10.12.2017;2017;12;07;Sunnuntai;2;3;5;2;2;4
96;10.12.2017;2017;12;08;Sunnuntai;1;6;7;3;1;4
96;10.12.2017;2017;12;09;Sunnuntai;3;11;14;2;6;8
96;10.12.2017;2017;12;10;Sunnuntai;6;7;13;6;8;14
96;10.12.2017;2017;12;11;Sunnuntai;5;20;25;9;10;19
96;10.12.2017;2017;12;12;Sunnuntai;23;18;41;5;15;20
96;10.12.2017;2017;12;13;Sunnuntai;26;17;43;14;14;28
96;10.12.2017;2017;12;14;Sunnuntai;20;27;47;13;12;25
96;10.12.2017;2017;12;15;Sunnuntai;17;15;32;11;17;28
96;10.12.2017;2017;12;16;Sunnuntai;36;9;45;23;9;32
96;10.12.2017;2017;12;17;Sunnuntai;26;7;33;13;10;23
96;10.12.2017;2017;12;18;Sunnuntai;18;16;34;16;20;36
96;10.12.2017;2017;12;19;Sunnuntai;5;11;16;6;13;19
96;10.12.2017;2017;12;20;Sunnuntai;14;17;31;6;7;13
96;10.12.2017;2017;12;21;Sunnuntai;7;7;14;8;3;11
96;10.12.2017;2017;12;22;Sunnuntai;3;5;8;1;3;4
96;10.12.2017;2017;12;23;Sunnuntai;5;2;7;2;1;3
96;11.12.2017;2017;12;00;Maanantai;2;1;3;2;0;2
96;11.12.2017;2017;12;01;Maanantai;2;0;2;0;0;0
96;11.12.2017;2017;12;02;Maanantai;1;0;1;0;0;0
96;11.12.2017;2017;12;03;Maanantai;1;0;1;0;1;1
96;11.12.2017;2017;12;04;Maanantai;1;0;1;1;0;1
96;11.12.2017;2017;12;05;Maanantai;5;6;11;0;1;1
96;11.12.2017;2017;12;06;Maanantai;35;20;55;15;5;20
96;11.12.2017;2017;12;07;Maanantai;89;71;160;35;9;44
96;11.12.2017;2017;12;08;Maanantai;92;87;179;16;8;24
96;11.12.2017;2017;12;09;Maanantai;59;45;104;23;30;53
96;11.12.2017;2017;12;10;Maanantai;47;40;87;22;15;37
96;11.12.2017;2017;12;11;Maanantai;49;35;84;10;5;15
96;11.12.2017;2017;12;12;Maanantai;44;59;103;21;10;31
96;11.12.2017;2017;12;13;Maanantai;49;45;94;13;22;35
96;11.12.2017;2017;12;14;Maanantai;46;64;110;13;17;30
96;11.12.2017;2017;12;15;Maanantai;56;141;197;10;41;51
96;11.12.2017;2017;12;16;Maanantai;83;143;226;14;54;68
96;11.12.2017;2017;12;17;Maanantai;40;67;107;11;26;37
96;11.12.2017;2017;12;18;Maanantai;39;29;68;10;17;27
96;11.12.2017;2017;12;19;Maanantai;26;32;58;14;26;40
96;11.12.2017;2017;12;20;Maanantai;27;16;43;9;11;20
96;11.12.2017;2017;12;21;Maanantai;9;18;27;3;9;12
96;11.12.2017;2017;12;22;Maanantai;4;5;9;0;3;3
96;11.12.2017;2017;12;23;Maanantai;1;1;2;0;2;2
96;12.12.2017;2017;12;00;Tiistai;1;2;3;0;0;0
96;12.12.2017;2017;12;01;Tiistai;1;0;1;1;0;1
96;12.12.2017;2017;12;02;Tiistai;1;0;1;0;0;0
96;12.12.2017;2017;12;03;Tiistai;0;0;0;0;0;0
96;12.12.2017;2017;12;04;Tiistai;2;0;2;0;1;1
96;12.12.2017;2017;12;05;Tiistai;6;6;12;0;1;1
96;12.12.2017;2017;12;06;Tiistai;28;27;55;17;2;19
96;12.12.2017;2017;12;07;Tiistai;87;67;154;42;3;45
96;12.12.2017;2017;12;08;Tiistai;93;103;196;20;10;30
96;12.12.2017;2017;12;09;Tiistai;109;48;157;28;14;42
96;12.12.2017;2017;12;10;Tiistai;41;43;84;13;10;23
96;12.12.2017;2017;12;11;Tiistai;65;47;112;19;23;42
96;12.12.2017;2017;12;12;Tiistai;51;70;121;25;19;44
96;12.12.2017;2017;12;13;Tiistai;52;63;115;12;8;20
96;12.12.2017;2017;12;14;Tiistai;30;85;115;8;31;39
96;12.12.2017;2017;12;15;Tiistai;54;127;181;7;62;69
96;12.12.2017;2017;12;16;Tiistai;56;110;166;12;43;55
96;12.12.2017;2017;12;17;Tiistai;34;45;79;18;32;50
96;12.12.2017;2017;12;18;Tiistai;28;38;66;8;7;15
96;12.12.2017;2017;12;19;Tiistai;31;24;55;10;19;29
96;12.12.2017;2017;12;20;Tiistai;26;25;51;18;8;26
96;12.12.2017;2017;12;21;Tiistai;13;16;29;3;3;6
96;12.12.2017;2017;12;22;Tiistai;8;10;18;3;5;8
96;12.12.2017;2017;12;23;Tiistai;4;2;6;0;1;1
96;13.12.2017;2017;12;00;Keskiviikko;1;0;1;0;0;0
96;13.12.2017;2017;12;01;Keskiviikko;0;2;2;0;2;2
96;13.12.2017;2017;12;02;Keskiviikko;2;0;2;2;0;2
96;13.12.2017;2017;12;03;Keskiviikko;1;0;1;4;0;4
96;13.12.2017;2017;12;04;Keskiviikko;2;0;2;2;2;4
96;13.12.2017;2017;12;05;Keskiviikko;3;4;7;0;2;2
96;13.12.2017;2017;12;06;Keskiviikko;26;19;45;14;2;16
96;13.12.2017;2017;12;07;Keskiviikko;91;64;155;40;9;49
96;13.12.2017;2017;12;08;Keskiviikko;100;68;168;31;6;37
96;13.12.2017;2017;12;09;Keskiviikko;83;41;124;17;9;26
96;13.12.2017;2017;12;10;Keskiviikko;40;33;73;16;13;29
96;13.12.2017;2017;12;11;Keskiviikko;59;59;118;19;19;38
96;13.12.2017;2017;12;12;Keskiviikko;63;56;119;13;12;25
96;13.12.2017;2017;12;13;Keskiviikko;47;62;109;15;11;26
96;13.12.2017;2017;12;14;Keskiviikko;49;96;145;9;36;45
96;13.12.2017;2017;12;15;Keskiviikko;43;116;159;17;33;50
96;13.12.2017;2017;12;16;Keskiviikko;61;113;174;15;55;70
96;13.12.2017;2017;12;17;Keskiviikko;38;47;85;12;12;24
96;13.12.2017;2017;12;18;Keskiviikko;49;32;81;20;9;29
96;13.12.2017;2017;12;19;Keskiviikko;40;21;61;17;15;32
96;13.12.2017;2017;12;20;Keskiviikko;20;27;47;13;15;28
96;13.12.2017;2017;12;21;Keskiviikko;14;28;42;4;17;21
96;13.12.2017;2017;12;22;Keskiviikko;6;7;13;1;5;6
96;13.12.2017;2017;12;23;Keskiviikko;4;4;8;2;2;4
96;14.12.2017;2017;12;00;Torstai;5;1;6;0;0;0
96;14.12.2017;2017;12;01;Torstai;7;0;7;0;0;0
96;14.12.2017;2017;12;02;Torstai;6;0;6;1;0;1
96;14.12.2017;2017;12;03;Torstai;6;0;6;3;0;3
96;14.12.2017;2017;12;04;Torstai;7;1;8;0;1;1
96;14.12.2017;2017;12;05;Torstai;4;8;12;0;1;1
96;14.12.2017;2017;12;06;Torstai;41;15;56;9;5;14
96;14.12.2017;2017;12;07;Torstai;88;58;146;32;8;40
96;14.12.2017;2017;12;08;Torstai;57;84;141;25;10;35
96;14.12.2017;2017;12;09;Torstai;92;41;133;28;37;65
96;14.12.2017;2017;12;10;Torstai;53;26;79;36;9;45
96;14.12.2017;2017;12;11;Torstai;39;56;95;27;20;47
96;14.12.2017;2017;12;12;Torstai;44;53;97;12;9;21
96;14.12.2017;2017;12;13;Torstai;50;52;102;16;20;36
96;14.12.2017;2017;12;14;Torstai;37;110;147;5;36;41
96;14.12.2017;2017;12;15;Torstai;45;143;188;12;41;53
96;14.12.2017;2017;12;16;Torstai;56;112;168;13;39;52
96;14.12.2017;2017;12;17;Torstai;38;55;93;19;26;45
96;14.12.2017;2017;12;18;Torstai;32;35;67;15;20;35
96;14.12.2017;2017;12;19;Torstai;34;31;65;10;11;21
96;14.12.2017;2017;12;20;Torstai;29;19;48;9;12;21
96;14.12.2017;2017;12;21;Torstai;21;23;44;6;10;16
96;14.12.2017;2017;12;22;Torstai;8;4;12;0;2;2
96;14.12.2017;2017;12;23;Torstai;1;1;2;0;0;0
96;15.12.2017;2017;12;00;Perjantai;2;1;3;1;0;1
96;15.12.2017;2017;12;01;Perjantai;4;0;4;0;0;0
96;15.12.2017;2017;12;02;Perjantai;7;2;9;0;1;1
96;15.12.2017;2017;12;03;Perjantai;3;0;3;3;0;3
96;15.12.2017;2017;12;04;Perjantai;3;0;3;1;0;1
96;15.12.2017;2017;12;05;Perjantai;7;7;14;1;1;2
96;15.12.2017;2017;12;06;Perjantai;41;17;58;11;7;18
96;15.12.2017;2017;12;07;Perjantai;110;55;165;37;8;45
96;15.12.2017;2017;12;08;Perjantai;86;66;152;11;7;18
96;15.12.2017;2017;12;09;Perjantai;36;51;87;14;22;36
96;15.12.2017;2017;12;10;Perjantai;39;48;87;31;7;38
96;15.12.2017;2017;12;11;Perjantai;39;60;99;10;11;21
96;15.12.2017;2017;12;12;Perjantai;41;69;110;7;13;20
96;15.12.2017;2017;12;13;Perjantai;45;67;112;8;19;27
96;15.12.2017;2017;12;14;Perjantai;63;105;168;6;42;48
96;15.12.2017;2017;12;15;Perjantai;49;112;161;10;42;52
96;15.12.2017;2017;12;16;Perjantai;45;66;111;12;21;33
96;15.12.2017;2017;12;17;Perjantai;41;44;85;15;11;26
96;15.12.2017;2017;12;18;Perjantai;27;29;56;4;12;16
96;15.12.2017;2017;12;19;Perjantai;22;10;32;12;5;17
96;15.12.2017;2017;12;20;Perjantai;29;13;42;6;8;14
96;15.12.2017;2017;12;21;Perjantai;12;12;24;3;8;11
96;15.12.2017;2017;12;22;Perjantai;8;17;25;1;3;4
96;15.12.2017;2017;12;23;Perjantai;6;4;10;3;0;3
96;16.12.2017;2017;12;00;Lauantai;11;3;14;2;2;4
96;16.12.2017;2017;12;01;Lauantai;3;2;5;0;0;0
96;16.12.2017;2017;12;02;Lauantai;2;0;2;3;0;3
96;16.12.2017;2017;12;03;Lauantai;6;0;6;0;1;1
96;16.12.2017;2017;12;04;Lauantai;3;1;4;2;1;3
96;16.12.2017;2017;12;05;Lauantai;3;1;4;0;1;1
96;16.12.2017;2017;12;06;Lauantai;15;6;21;6;1;7
96;16.12.2017;2017;12;07;Lauantai;4;14;18;2;1;3
96;16.12.2017;2017;12;08;Lauantai;2;8;10;4;4;8
96;16.12.2017;2017;12;09;Lauantai;5;16;21;5;7;12
96;16.12.2017;2017;12;10;Lauantai;13;30;43;5;6;11
96;16.12.2017;2017;12;11;Lauantai;21;18;39;12;13;25
96;16.12.2017;2017;12;12;Lauantai;28;19;47;12;5;17
96;16.12.2017;2017;12;13;Lauantai;25;29;54;13;18;31
96;16.12.2017;2017;12;14;Lauantai;17;35;52;14;11;25
96;16.12.2017;2017;12;15;Lauantai;22;17;39;13;11;24
96;16.12.2017;2017;12;16;Lauantai;21;17;38;6;13;19
96;16.12.2017;2017;12;17;Lauantai;18;13;31;9;7;16
96;16.12.2017;2017;12;18;Lauantai;19;14;33;10;2;12
96;16.12.2017;2017;12;19;Lauantai;10;12;22;4;7;11
96;16.12.2017;2017;12;20;Lauantai;9;13;22;6;5;11
96;16.12.2017;2017;12;21;Lauantai;12;23;35;4;5;9
96;16.12.2017;2017;12;22;Lauantai;2;7;9;1;2;3
96;16.12.2017;2017;12;23;Lauantai;9;6;15;1;0;1
96;17.12.2017;2017;12;00;Sunnuntai;9;3;12;1;0;1
96;17.12.2017;2017;12;01;Sunnuntai;3;1;4;0;0;0
96;17.12.2017;2017;12;02;Sunnuntai;7;0;7;0;0;0
96;17.12.2017;2017;12;03;Sunnuntai;2;0;2;1;1;2
96;17.12.2017;2017;12;04;Sunnuntai;10;0;10;1;1;2
96;17.12.2017;2017;12;05;Sunnuntai;0;1;1;0;1;1
96;17.12.2017;2017;12;06;Sunnuntai;12;4;16;5;0;5
96;17.12.2017;2017;12;07;Sunnuntai;2;4;6;1;6;7
96;17.12.2017;2017;12;08;Sunnuntai;4;3;7;4;0;4
96;17.12.2017;2017;12;09;Sunnuntai;1;6;7;10;7;17
96;17.12.2017;2017;12;10;Sunnuntai;8;13;21;12;6;18
96;17.12.2017;2017;12;11;Sunnuntai;10;18;28;3;11;14
96;17.12.2017;2017;12;12;Sunnuntai;16;19;35;16;15;31
96;17.12.2017;2017;12;13;Sunnuntai;28;16;44;12;7;19
96;17.12.2017;2017;12;14;Sunnuntai;24;25;49;15;9;24
96;17.12.2017;2017;12;15;Sunnuntai;11;15;26;11;13;24
96;17.12.2017;2017;12;16;Sunnuntai;25;14;39;25;8;33
96;17.12.2017;2017;12;17;Sunnuntai;22;11;33;21;10;31
96;17.12.2017;2017;12;18;Sunnuntai;18;15;33;14;17;31
96;17.12.2017;2017;12;19;Sunnuntai;10;13;23;19;11;30
96;17.12.2017;2017;12;20;Sunnuntai;8;32;40;9;16;25
96;17.12.2017;2017;12;21;Sunnuntai;20;14;34;3;8;11
96;17.12.2017;2017;12;22;Sunnuntai;2;9;11;1;2;3
96;17.12.2017;2017;12;23;Sunnuntai;7;4;11;0;1;1
96;18.12.2017;2017;12;00;Maanantai;2;3;5;1;0;1
96;18.12.2017;2017;12;01;Maanantai;1;0;1;0;0;0
96;18.12.2017;2017;12;02;Maanantai;1;0;1;0;0;0
96;18.12.2017;2017;12;03;Maanantai;3;2;5;0;1;1
96;18.12.2017;2017;12;04;Maanantai;2;1;3;0;0;0
96;18.12.2017;2017;12;05;Maanantai;4;8;12;0;0;0
96;18.12.2017;2017;12;06;Maanantai;29;20;49;11;3;14
96;18.12.2017;2017;12;07;Maanantai;94;53;147;36;12;48
96;18.12.2017;2017;12;08;Maanantai;75;92;167;17;8;25
96;18.12.2017;2017;12;09;Maanantai;42;37;79;28;20;48
96;18.12.2017;2017;12;10;Maanantai;41;41;82;15;7;22
96;18.12.2017;2017;12;11;Maanantai;58;53;111;13;10;23
96;18.12.2017;2017;12;12;Maanantai;46;54;100;18;15;33
96;18.12.2017;2017;12;13;Maanantai;49;54;103;12;18;30
96;18.12.2017;2017;12;14;Maanantai;59;75;134;24;28;52
96;18.12.2017;2017;12;15;Maanantai;43;126;169;12;40;52
96;18.12.2017;2017;12;16;Maanantai;76;132;208;15;47;62
96;18.12.2017;2017;12;17;Maanantai;51;52;103;22;24;46
96;18.12.2017;2017;12;18;Maanantai;33;39;72;15;9;24
96;18.12.2017;2017;12;19;Maanantai;32;35;67;10;16;26
96;18.12.2017;2017;12;20;Maanantai;22;7;29;15;12;27
96;18.12.2017;2017;12;21;Maanantai;16;21;37;9;6;15
96;18.12.2017;2017;12;22;Maanantai;3;11;14;1;2;3
96;18.12.2017;2017;12;23;Maanantai;6;1;7;0;0;0
96;19.12.2017;2017;12;00;Tiistai;2;4;6;0;0;0
96;19.12.2017;2017;12;01;Tiistai;0;0;0;0;0;0
96;19.12.2017;2017;12;02;Tiistai;0;0;0;1;0;1
96;19.12.2017;2017;12;03;Tiistai;1;0;1;0;1;1
96;19.12.2017;2017;12;04;Tiistai;1;0;1;0;3;3
96;19.12.2017;2017;12;05;Tiistai;5;7;12;0;1;1
96;19.12.2017;2017;12;06;Tiistai;35;29;64;13;6;19
96;19.12.2017;2017;12;07;Tiistai;93;77;170;37;5;42
96;19.12.2017;2017;12;08;Tiistai;54;92;146;14;12;26
96;19.12.2017;2017;12;09;Tiistai;71;39;110;18;9;27
96;19.12.2017;2017;12;10;Tiistai;38;43;81;20;14;34
96;19.12.2017;2017;12;11;Tiistai;49;40;89;23;23;46
96;19.12.2017;2017;12;12;Tiistai;46;57;103;15;23;38
96;19.12.2017;2017;12;13;Tiistai;43;63;106;15;22;37
96;19.12.2017;2017;12;14;Tiistai;36;89;125;10;33;43
96;19.12.2017;2017;12;15;Tiistai;57;133;190;7;42;49
96;19.12.2017;2017;12;16;Tiistai;81;110;191;14;42;56
96;19.12.2017;2017;12;17;Tiistai;40;39;79;13;27;40
96;19.12.2017;2017;12;18;Tiistai;23;35;58;11;10;21
96;19.12.2017;2017;12;19;Tiistai;19;24;43;16;21;37
96;19.12.2017;2017;12;20;Tiistai;34;16;50;13;14;27
96;19.12.2017;2017;12;21;Tiistai;26;13;39;9;6;15
96;19.12.2017;2017;12;22;Tiistai;8;8;16;2;2;4
96;19.12.2017;2017;12;23;Tiistai;2;1;3;2;1;3
96;20.12.2017;2017;12;00;Keskiviikko;1;2;3;0;1;1
96;20.12.2017;2017;12;01;Keskiviikko;2;0;2;1;0;1
96;20.12.2017;2017;12;02;Keskiviikko;0;0;0;1;0;1
96;20.12.2017;2017;12;03;Keskiviikko;2;0;2;0;0;0
96;20.12.2017;2017;12;04;Keskiviikko;1;0;1;0;2;2
96;20.12.2017;2017;12;05;Keskiviikko;3;8;11;0;2;2
96;20.12.2017;2017;12;06;Keskiviikko;35;19;54;15;0;15
96;20.12.2017;2017;12;07;Keskiviikko;77;70;147;34;9;43
96;20.12.2017;2017;12;08;Keskiviikko;54;60;114;12;9;21
96;20.12.2017;2017;12;09;Keskiviikko;64;39;103;18;12;30
96;20.12.2017;2017;12;10;Keskiviikko;27;34;61;11;10;21
96;20.12.2017;2017;12;11;Keskiviikko;27;25;52;11;9;20
96;20.12.2017;2017;12;12;Keskiviikko;36;53;89;11;7;18
96;20.12.2017;2017;12;13;Keskiviikko;33;33;66;8;14;22
96;20.12.2017;2017;12;14;Keskiviikko;27;55;82;4;15;19
96;20.12.2017;2017;12;15;Keskiviikko;36;87;123;4;20;24
96;20.12.2017;2017;12;16;Keskiviikko;37;88;125;7;31;38
96;20.12.2017;2017;12;17;Keskiviikko;30;18;48;6;11;17
96;20.12.2017;2017;12;18;Keskiviikko;25;11;36;10;9;19
96;20.12.2017;2017;12;19;Keskiviikko;18;11;29;3;5;8
96;20.12.2017;2017;12;20;Keskiviikko;19;11;30;5;9;14
96;20.12.2017;2017;12;21;Keskiviikko;9;7;16;5;2;7
96;20.12.2017;2017;12;22;Keskiviikko;5;7;12;4;4;8
96;20.12.2017;2017;12;23;Keskiviikko;1;1;2;0;1;1
96;21.12.2017;2017;12;00;Torstai;3;1;4;0;0;0
96;21.12.2017;2017;12;01;Torstai;3;0;3;0;0;0
96;21.12.2017;2017;12;02;Torstai;0;0;0;0;0;0
96;21.12.2017;2017;12;03;Torstai;0;1;1;2;1;3
96;21.12.2017;2017;12;04;Torstai;3;0;3;0;1;1
96;21.12.2017;2017;12;05;Torstai;3;1;4;0;2;2
96;21.12.2017;2017;12;06;Torstai;23;15;38;11;3;14
96;21.12.2017;2017;12;07;Torstai;48;53;101;32;7;39
96;21.12.2017;2017;12;08;Torstai;37;61;98;9;4;13
96;21.12.2017;2017;12;09;Torstai;54;55;109;11;13;24
96;21.12.2017;2017;12;10;Torstai;21;22;43;6;6;12
96;21.12.2017;2017;12;11;Torstai;148;38;186;13;14;27
96;21.12.2017;2017;12;12;Torstai;31;55;86;13;15;28
96;21.12.2017;2017;12;13;Torstai;38;39;77;13;17;30
96;21.12.2017;2017;12;14;Torstai;31;44;75;9;25;34
96;21.12.2017;2017;12;15;Torstai;34;79;113;9;27;36
96;21.12.2017;2017;12;16;Torstai;54;64;118;11;26;37
96;21.12.2017;2017;12;17;Torstai;38;30;68;5;7;12
96;21.12.2017;2017;12;18;Torstai;22;19;41;11;8;19
96;21.12.2017;2017;12;19;Torstai;25;20;45;10;11;21
96;21.12.2017;2017;12;20;Torstai;33;12;45;7;7;14
96;21.12.2017;2017;12;21;Torstai;15;19;34;5;6;11
96;21.12.2017;2017;12;22;Torstai;8;5;13;5;5;10
96;21.12.2017;2017;12;23;Torstai;1;2;3;0;0;0
96;22.12.2017;2017;12;00;Perjantai;6;0;6;2;1;3
96;22.12.2017;2017;12;01;Perjantai;3;1;4;0;0;0
96;22.12.2017;2017;12;02;Perjantai;2;0;2;1;1;2
96;22.12.2017;2017;12;03;Perjantai;1;0;1;0;0;0
96;22.12.2017;2017;12;04;Perjantai;0;1;1;0;0;0
96;22.12.2017;2017;12;05;Perjantai;5;7;12;0;1;1
96;22.12.2017;2017;12;06;Perjantai;37;17;54;12;1;13
96;22.12.2017;2017;12;07;Perjantai;59;40;99;20;5;25
96;22.12.2017;2017;12;08;Perjantai;34;32;66;10;5;15
96;22.12.2017;2017;12;09;Perjantai;15;28;43;4;5;9
96;22.12.2017;2017;12;10;Perjantai;11;34;45;4;11;15
96;22.12.2017;2017;12;11;Perjantai;21;34;55;8;7;15
96;22.12.2017;2017;12;12;Perjantai;26;31;57;14;17;31
96;22.12.2017;2017;12;13;Perjantai;35;29;64;13;21;34
96;22.12.2017;2017;12;14;Perjantai;42;55;97;4;20;24
96;22.12.2017;2017;12;15;Perjantai;40;66;106;8;23;31
96;22.12.2017;2017;12;16;Perjantai;32;35;67;8;7;15
96;22.12.2017;2017;12;17;Perjantai;14;15;29;11;15;26
96;22.12.2017;2017;12;18;Perjantai;18;20;38;6;5;11
96;22.12.2017;2017;12;19;Perjantai;20;10;30;4;8;12
96;22.12.2017;2017;12;20;Perjantai;18;4;22;5;2;7
96;22.12.2017;2017;12;21;Perjantai;10;7;17;1;3;4
96;22.12.2017;2017;12;22;Perjantai;5;10;15;3;4;7
96;22.12.2017;2017;12;23;Perjantai;1;4;5;0;2;2
96;23.12.2017;2017;12;00;Lauantai;4;1;5;1;0;1
96;23.12.2017;2017;12;01;Lauantai;3;2;5;0;0;0
96;23.12.2017;2017;12;02;Lauantai;6;0;6;0;1;1
96;23.12.2017;2017;12;03;Lauantai;2;0;2;0;0;0
96;23.12.2017;2017;12;04;Lauantai;2;0;2;2;1;3
96;23.12.2017;2017;12;05;Lauantai;1;1;2;1;0;1
96;23.12.2017;2017;12;06;Lauantai;8;5;13;7;0;7
96;23.12.2017;2017;12;07;Lauantai;2;7;9;0;0;0
96;23.12.2017;2017;12;08;Lauantai;2;8;10;2;3;5
96;23.12.2017;2017;12;09;Lauantai;6;7;13;4;5;9
96;23.12.2017;2017;12;10;Lauantai;6;16;22;6;6;12
96;23.12.2017;2017;12;11;Lauantai;8;4;12;6;1;7
96;23.12.2017;2017;12;12;Lauantai;8;3;11;2;0;2
96;23.12.2017;2017;12;13;Lauantai;14;4;18;3;0;3
96;23.12.2017;2017;12;14;Lauantai;18;7;25;7;0;7
96;23.12.2017;2017;12;15;Lauantai;12;2;14;9;0;9
96;23.12.2017;2017;12;16;Lauantai;11;4;15;4;0;4
96;23.12.2017;2017;12;17;Lauantai;13;4;17;7;0;7
96;23.12.2017;2017;12;18;Lauantai;9;3;12;2;0;2
96;23.12.2017;2017;12;19;Lauantai;4;0;4;1;0;1
96;23.12.2017;2017;12;20;Lauantai;12;1;13;2;0;2
96;23.12.2017;2017;12;21;Lauantai;9;3;12;1;0;1
96;23.12.2017;2017;12;22;Lauantai;2;0;2;0;0;0
96;23.12.2017;2017;12;23;Lauantai;2;0;2;0;0;0
96;24.12.2017;2017;12;00;Sunnuntai;1;0;1;0;0;0
96;24.12.2017;2017;12;01;Sunnuntai;1;0;1;0;0;0
96;24.12.2017;2017;12;02;Sunnuntai;0;0;0;0;0;0
96;24.12.2017;2017;12;03;Sunnuntai;2;0;2;0;0;0
96;24.12.2017;2017;12;04;Sunnuntai;4;0;4;0;0;0
96;24.12.2017;2017;12;05;Sunnuntai;0;0;0;0;0;0
96;24.12.2017;2017;12;06;Sunnuntai;14;1;15;2;0;2
96;24.12.2017;2017;12;07;Sunnuntai;2;0;2;3;0;3
96;24.12.2017;2017;12;08;Sunnuntai;5;0;5;1;0;1
96;24.12.2017;2017;12;09;Sunnuntai;4;2;6;2;0;2
96;24.12.2017;2017;12;10;Sunnuntai;16;1;17;4;0;4
96;24.12.2017;2017;12;11;Sunnuntai;17;2;19;8;0;8
96;24.12.2017;2017;12;12;Sunnuntai;15;1;16;5;0;5
96;24.12.2017;2017;12;13;Sunnuntai;11;1;12;7;0;7
96;24.12.2017;2017;12;14;Sunnuntai;15;0;15;9;0;9
96;24.12.2017;2017;12;15;Sunnuntai;21;1;22;8;0;8
96;24.12.2017;2017;12;16;Sunnuntai;7;0;7;3;0;3
96;24.12.2017;2017;12;17;Sunnuntai;7;1;8;2;0;2
96;24.12.2017;2017;12;18;Sunnuntai;3;0;3;1;0;1
96;24.12.2017;2017;12;19;Sunnuntai;5;0;5;3;0;3
96;24.12.2017;2017;12;20;Sunnuntai;7;1;8;4;0;4
96;24.12.2017;2017;12;21;Sunnuntai;11;3;14;3;0;3
96;24.12.2017;2017;12;22;Sunnuntai;6;0;6;2;0;2
96;24.12.2017;2017;12;23;Sunnuntai;2;0;2;1;0;1
96;25.12.2017;2017;12;00;Maanantai;0;0;0;1;0;1
96;25.12.2017;2017;12;01;Maanantai;0;0;0;0;0;0
96;25.12.2017;2017;12;02;Maanantai;0;0;0;0;0;0
96;25.12.2017;2017;12;03;Maanantai;0;0;0;0;0;0
96;25.12.2017;2017;12;04;Maanantai;1;0;1;1;0;1
96;25.12.2017;2017;12;05;Maanantai;3;0;3;0;0;0
96;25.12.2017;2017;12;06;Maanantai;9;2;11;3;0;3
96;25.12.2017;2017;12;07;Maanantai;4;0;4;2;0;2
96;25.12.2017;2017;12;08;Maanantai;1;0;1;3;0;3
96;25.12.2017;2017;12;09;Maanantai;3;0;3;2;0;2
96;25.12.2017;2017;12;10;Maanantai;5;0;5;5;0;5
96;25.12.2017;2017;12;11;Maanantai;9;2;11;7;0;7
96;25.12.2017;2017;12;12;Maanantai;17;3;20;8;0;8
96;25.12.2017;2017;12;13;Maanantai;13;2;15;5;0;5
96;25.12.2017;2017;12;14;Maanantai;14;4;18;3;0;3
96;25.12.2017;2017;12;15;Maanantai;7;3;10;5;0;5
96;25.12.2017;2017;12;16;Maanantai;9;4;13;5;0;5
96;25.12.2017;2017;12;17;Maanantai;7;1;8;10;0;10
96;25.12.2017;2017;12;18;Maanantai;9;0;9;5;0;5
96;25.12.2017;2017;12;19;Maanantai;7;0;7;5;0;5
96;25.12.2017;2017;12;20;Maanantai;9;2;11;3;0;3
96;25.12.2017;2017;12;21;Maanantai;10;2;12;11;0;11
96;25.12.2017;2017;12;22;Maanantai;5;0;5;4;0;4
96;25.12.2017;2017;12;23;Maanantai;2;0;2;0;0;0
96;26.12.2017;2017;12;00;Tiistai;4;0;4;0;0;0
96;26.12.2017;2017;12;01;Tiistai;2;0;2;0;0;0
96;26.12.2017;2017;12;02;Tiistai;0;0;0;1;0;1
96;26.12.2017;2017;12;03;Tiistai;0;0;0;0;0;0
96;26.12.2017;2017;12;04;Tiistai;2;0;2;0;0;0
96;26.12.2017;2017;12;05;Tiistai;2;0;2;0;0;0
96;26.12.2017;2017;12;06;Tiistai;7;0;7;3;0;3
96;26.12.2017;2017;12;07;Tiistai;5;0;5;2;0;2
96;26.12.2017;2017;12;08;Tiistai;7;1;8;1;0;1
96;26.12.2017;2017;12;09;Tiistai;10;5;15;2;0;2
96;26.12.2017;2017;12;10;Tiistai;8;1;9;10;0;10
96;26.12.2017;2017;12;11;Tiistai;16;0;16;13;0;13
96;26.12.2017;2017;12;12;Tiistai;19;1;20;15;0;15
96;26.12.2017;2017;12;13;Tiistai;20;3;23;12;0;12
96;26.12.2017;2017;12;14;Tiistai;23;3;26;15;0;15
96;26.12.2017;2017;12;15;Tiistai;23;0;23;15;0;15
96;26.12.2017;2017;12;16;Tiistai;24;3;27;11;0;11
96;26.12.2017;2017;12;17;Tiistai;11;1;12;6;0;6
96;26.12.2017;2017;12;18;Tiistai;10;0;10;8;0;8
96;26.12.2017;2017;12;19;Tiistai;10;1;11;2;0;2
96;26.12.2017;2017;12;20;Tiistai;11;0;11;5;0;5
96;26.12.2017;2017;12;21;Tiistai;16;0;16;4;0;4
96;26.12.2017;2017;12;22;Tiistai;2;0;2;1;0;1
96;26.12.2017;2017;12;23;Tiistai;5;0;5;1;0;1
96;27.12.2017;2017;12;00;Keskiviikko;6;0;6;1;0;1
96;27.12.2017;2017;12;01;Keskiviikko;5;0;5;1;0;1
96;27.12.2017;2017;12;02;Keskiviikko;3;0;3;0;0;0
96;27.12.2017;2017;12;03;Keskiviikko;2;1;3;0;0;0
96;27.12.2017;2017;12;04;Keskiviikko;7;1;8;1;0;1
96;27.12.2017;2017;12;05;Keskiviikko;4;0;4;2;0;2
96;27.12.2017;2017;12;06;Keskiviikko;24;6;30;4;0;4
96;27.12.2017;2017;12;07;Keskiviikko;47;10;57;9;0;9
96;27.12.2017;2017;12;08;Keskiviikko;24;6;30;7;0;7
96;27.12.2017;2017;12;09;Keskiviikko;12;1;13;3;0;3
96;27.12.2017;2017;12;10;Keskiviikko;20;5;25;6;0;6
96;27.12.2017;2017;12;11;Keskiviikko;17;7;24;6;0;6
96;27.12.2017;2017;12;12;Keskiviikko;33;9;42;24;0;24
96;27.12.2017;2017;12;13;Keskiviikko;44;9;53;12;0;12
96;27.12.2017;2017;12;14;Keskiviikko;31;4;35;27;0;27
96;27.12.2017;2017;12;15;Keskiviikko;64;9;73;26;0;26
96;27.12.2017;2017;12;16;Keskiviikko;43;9;52;13;0;13
96;27.12.2017;2017;12;17;Keskiviikko;23;8;31;5;0;5
96;27.12.2017;2017;12;18;Keskiviikko;25;2;27;12;0;12
96;27.12.2017;2017;12;19;Keskiviikko;19;3;22;13;0;13
96;27.12.2017;2017;12;20;Keskiviikko;11;3;14;15;0;15
96;27.12.2017;2017;12;21;Keskiviikko;18;1;19;9;0;9
96;27.12.2017;2017;12;22;Keskiviikko;6;0;6;5;0;5
96;27.12.2017;2017;12;23;Keskiviikko;1;0;1;1;0;1
96;28.12.2017;2017;12;00;Torstai;4;0;4;0;0;0
96;28.12.2017;2017;12;01;Torstai;1;0;1;0;0;0
96;28.12.2017;2017;12;02;Torstai;3;0;3;0;0;0
96;28.12.2017;2017;12;03;Torstai;1;0;1;0;0;0
96;28.12.2017;2017;12;04;Torstai;2;1;3;0;0;0
96;28.12.2017;2017;12;05;Torstai;6;1;7;1;0;1
96;28.12.2017;2017;12;06;Torstai;45;8;53;9;0;9
96;28.12.2017;2017;12;07;Torstai;51;8;59;7;0;7
96;28.12.2017;2017;12;08;Torstai;29;7;36;11;0;11
96;28.12.2017;2017;12;09;Torstai;20;5;25;10;0;10
96;28.12.2017;2017;12;10;Torstai;13;14;27;26;17;43
96;28.12.2017;2017;12;11;Torstai;11;18;29;11;9;20
96;28.12.2017;2017;12;12;Torstai;29;15;44;2;19;21
96;28.12.2017;2017;12;13;Torstai;27;29;56;9;9;18
96;28.12.2017;2017;12;14;Torstai;18;29;47;11;13;24
96;28.12.2017;2017;12;15;Torstai;29;56;85;6;19;25
96;28.12.2017;2017;12;16;Torstai;38;40;78;6;26;32
96;28.12.2017;2017;12;17;Torstai;27;20;47;14;14;28
96;28.12.2017;2017;12;18;Torstai;18;31;49;14;21;35
96;28.12.2017;2017;12;19;Torstai;8;10;18;8;3;11
96;28.12.2017;2017;12;20;Torstai;17;8;25;5;9;14
96;28.12.2017;2017;12;21;Torstai;24;15;39;17;9;26
96;28.12.2017;2017;12;22;Torstai;1;7;8;4;2;6
96;28.12.2017;2017;12;23;Torstai;2;1;3;2;1;3
96;29.12.2017;2017;12;00;Perjantai;1;1;2;2;1;3
96;29.12.2017;2017;12;01;Perjantai;3;0;3;2;1;3
96;29.12.2017;2017;12;02;Perjantai;2;0;2;0;1;1
96;29.12.2017;2017;12;03;Perjantai;4;2;6;0;0;0
96;29.12.2017;2017;12;04;Perjantai;4;1;5;1;2;3
96;29.12.2017;2017;12;05;Perjantai;5;3;8;1;0;1
96;29.12.2017;2017;12;06;Perjantai;26;8;34;5;3;8
96;29.12.2017;2017;12;07;Perjantai;30;30;60;11;1;12
96;29.12.2017;2017;12;08;Perjantai;17;13;30;10;3;13
96;29.12.2017;2017;12;09;Perjantai;9;12;21;3;4;7
96;29.12.2017;2017;12;10;Perjantai;18;18;36;11;8;19
96;29.12.2017;2017;12;11;Perjantai;8;11;19;7;9;16
96;29.12.2017;2017;12;12;Perjantai;20;13;33;13;16;29
96;29.12.2017;2017;12;13;Perjantai;19;22;41;6;12;18
96;29.12.2017;2017;12;14;Perjantai;19;30;49;14;27;41
96;29.12.2017;2017;12;15;Perjantai;12;43;55;13;29;42
96;29.12.2017;2017;12;16;Perjantai;21;21;42;8;13;21
96;29.12.2017;2017;12;17;Perjantai;16;10;26;8;4;12
96;29.12.2017;2017;12;18;Perjantai;15;8;23;7;10;17
96;29.12.2017;2017;12;19;Perjantai;5;13;18;8;8;16
96;29.12.2017;2017;12;20;Perjantai;8;9;17;5;9;14
96;29.12.2017;2017;12;21;Perjantai;6;11;17;7;2;9
96;29.12.2017;2017;12;22;Perjantai;1;5;6;1;2;3
96;29.12.2017;2017;12;23;Perjantai;3;1;4;2;2;4
96;30.12.2017;2017;12;00;Lauantai;2;3;5;0;1;1
96;30.12.2017;2017;12;01;Lauantai;0;1;1;1;0;1
96;30.12.2017;2017;12;02;Lauantai;5;1;6;0;0;0
96;30.12.2017;2017;12;03;Lauantai;5;1;6;0;0;0
96;30.12.2017;2017;12;04;Lauantai;2;4;6;0;1;1
96;30.12.2017;2017;12;05;Lauantai;4;0;4;0;2;2
96;30.12.2017;2017;12;06;Lauantai;15;4;19;1;6;7
96;30.12.2017;2017;12;07;Lauantai;3;9;12;0;2;2
96;30.12.2017;2017;12;08;Lauantai;5;2;7;0;2;2
96;30.12.2017;2017;12;09;Lauantai;5;7;12;0;4;4
96;30.12.2017;2017;12;10;Lauantai;10;7;17;2;9;11
96;30.12.2017;2017;12;11;Lauantai;8;11;19;3;6;9
96;30.12.2017;2017;12;12;Lauantai;27;14;41;7;4;11
96;30.12.2017;2017;12;13;Lauantai;13;16;29;4;14;18
96;30.12.2017;2017;12;14;Lauantai;20;20;40;8;6;14
96;30.12.2017;2017;12;15;Lauantai;16;12;28;10;15;25
96;30.12.2017;2017;12;16;Lauantai;26;20;46;12;9;21
96;30.12.2017;2017;12;17;Lauantai;11;7;18;12;10;22
96;30.12.2017;2017;12;18;Lauantai;17;8;25;13;5;18
96;30.12.2017;2017;12;19;Lauantai;17;5;22;9;7;16
96;30.12.2017;2017;12;20;Lauantai;9;4;13;4;7;11
96;30.12.2017;2017;12;21;Lauantai;12;12;24;1;2;3
96;30.12.2017;2017;12;22;Lauantai;5;4;9;3;3;6
96;30.12.2017;2017;12;23;Lauantai;0;2;2;0;1;1
96;31.12.2017;2017;12;00;Sunnuntai;4;4;8;3;0;3
96;31.12.2017;2017;12;01;Sunnuntai;5;0;5;1;0;1
96;31.12.2017;2017;12;02;Sunnuntai;4;1;5;1;1;2
96;31.12.2017;2017;12;03;Sunnuntai;3;0;3;0;0;0
96;31.12.2017;2017;12;04;Sunnuntai;3;0;3;1;2;3
96;31.12.2017;2017;12;05;Sunnuntai;1;1;2;1;0;1
96;31.12.2017;2017;12;06;Sunnuntai;11;0;11;2;0;2
96;31.12.2017;2017;12;07;Sunnuntai;0;5;5;0;5;5
96;31.12.2017;2017;12;08;Sunnuntai;2;2;4;3;2;5
96;31.12.2017;2017;12;09;Sunnuntai;7;7;14;2;4;6
96;31.12.2017;2017;12;10;Sunnuntai;2;2;4;6;4;10
96;31.12.2017;2017;12;11;Sunnuntai;6;14;20;14;12;26
96;31.12.2017;2017;12;12;Sunnuntai;13;18;31;13;12;25
96;31.12.2017;2017;12;13;Sunnuntai;17;11;28;13;18;31
96;31.12.2017;2017;12;14;Sunnuntai;18;22;40;8;10;18
96;31.12.2017;2017;12;15;Sunnuntai;25;18;43;8;8;16
96;31.12.2017;2017;12;16;Sunnuntai;14;12;26;14;10;24
96;31.12.2017;2017;12;17;Sunnuntai;12;12;24;3;8;11
96;31.12.2017;2017;12;18;Sunnuntai;11;12;23;4;4;8
96;31.12.2017;2017;12;19;Sunnuntai;4;35;39;3;13;16
96;31.12.2017;2017;12;20;Sunnuntai;32;9;41;10;13;23
96;31.12.2017;2017;12;21;Sunnuntai;15;17;32;3;3;6
96;31.12.2017;2017;12;22;Sunnuntai;4;5;9;1;5;6
96;31.12.2017;2017;12;23;Sunnuntai;8;5;13;3;8;11
96;01.01.2018;2018;01;00;Maanantai;7;6;13;3;1;4
96;01.01.2018;2018;01;01;Maanantai;6;2;8;3;1;4
96;01.01.2018;2018;01;02;Maanantai;16;1;17;4;8;12
96;01.01.2018;2018;01;03;Maanantai;20;0;20;1;1;2
96;01.01.2018;2018;01;04;Maanantai;14;2;16;20;3;23
96;01.01.2018;2018;01;05;Maanantai;5;0;5;2;0;2
96;01.01.2018;2018;01;06;Maanantai;13;3;16;5;0;5
96;01.01.2018;2018;01;07;Maanantai;0;5;5;1;3;4
96;01.01.2018;2018;01;08;Maanantai;1;2;3;4;4;8
96;01.01.2018;2018;01;09;Maanantai;2;3;5;2;3;5
96;01.01.2018;2018;01;10;Maanantai;3;6;9;2;5;7
96;01.01.2018;2018;01;11;Maanantai;5;7;12;2;8;10
96;01.01.2018;2018;01;12;Maanantai;8;7;15;10;7;17
96;01.01.2018;2018;01;13;Maanantai;23;8;31;15;10;25
96;01.01.2018;2018;01;14;Maanantai;7;9;16;14;12;26
96;01.01.2018;2018;01;15;Maanantai;11;22;33;12;13;25
96;01.01.2018;2018;01;16;Maanantai;13;7;20;9;10;19
96;01.01.2018;2018;01;17;Maanantai;14;9;23;12;8;20
96;01.01.2018;2018;01;18;Maanantai;20;9;29;7;12;19
96;01.01.2018;2018;01;19;Maanantai;7;9;16;8;9;17
96;01.01.2018;2018;01;20;Maanantai;8;9;17;7;9;16
96;01.01.2018;2018;01;21;Maanantai;5;9;14;6;7;13
96;01.01.2018;2018;01;22;Maanantai;1;8;9;6;1;7
96;01.01.2018;2018;01;23;Maanantai;0;0;0;2;1;3
96;02.01.2018;2018;01;00;Tiistai;0;1;1;2;2;4
96;02.01.2018;2018;01;01;Tiistai;1;0;1;0;0;0
96;02.01.2018;2018;01;02;Tiistai;1;0;1;0;0;0
96;02.01.2018;2018;01;03;Tiistai;2;1;3;0;0;0
96;02.01.2018;2018;01;04;Tiistai;1;0;1;0;1;1
96;02.01.2018;2018;01;05;Tiistai;2;8;10;0;0;0
96;02.01.2018;2018;01;06;Tiistai;33;18;51;8;2;10
96;02.01.2018;2018;01;07;Tiistai;55;53;108;26;5;31
96;02.01.2018;2018;01;08;Tiistai;30;41;71;7;10;17
96;02.01.2018;2018;01;09;Tiistai;19;19;38;6;4;10
96;02.01.2018;2018;01;10;Tiistai;17;22;39;10;8;18
96;02.01.2018;2018;01;11;Tiistai;29;32;61;7;15;22
96;02.01.2018;2018;01;12;Tiistai;39;31;70;8;15;23
96;02.01.2018;2018;01;13;Tiistai;48;33;81;17;17;34
96;02.01.2018;2018;01;14;Tiistai;28;49;77;14;27;41
96;02.01.2018;2018;01;15;Tiistai;59;64;123;12;40;52
96;02.01.2018;2018;01;16;Tiistai;71;59;130;9;37;46
96;02.01.2018;2018;01;17;Tiistai;49;29;78;14;11;25
96;02.01.2018;2018;01;18;Tiistai;34;23;57;13;13;26
96;02.01.2018;2018;01;19;Tiistai;14;16;30;13;14;27
96;02.01.2018;2018;01;20;Tiistai;22;12;34;9;15;24
96;02.01.2018;2018;01;21;Tiistai;21;30;51;7;9;16
96;02.01.2018;2018;01;22;Tiistai;9;5;14;2;4;6
96;02.01.2018;2018;01;23;Tiistai;2;2;4;3;2;5
96;03.01.2018;2018;01;00;Keskiviikko;1;0;1;0;0;0
96;03.01.2018;2018;01;01;Keskiviikko;2;1;3;1;0;1
96;03.01.2018;2018;01;02;Keskiviikko;1;0;1;0;0;0
96;03.01.2018;2018;01;03;Keskiviikko;1;0;1;0;0;0
96;03.01.2018;2018;01;04;Keskiviikko;1;0;1;0;1;1
96;03.01.2018;2018;01;05;Keskiviikko;3;4;7;0;0;0
96;03.01.2018;2018;01;06;Keskiviikko;34;19;53;13;3;16
96;03.01.2018;2018;01;07;Keskiviikko;76;67;143;37;9;46
96;03.01.2018;2018;01;08;Keskiviikko;42;35;77;5;11;16
96;03.01.2018;2018;01;09;Keskiviikko;17;30;47;8;6;14
96;03.01.2018;2018;01;10;Keskiviikko;27;26;53;8;7;15
96;03.01.2018;2018;01;11;Keskiviikko;23;30;53;12;10;22
96;03.01.2018;2018;01;12;Keskiviikko;47;23;70;12;15;27
96;03.01.2018;2018;01;13;Keskiviikko;39;37;76;13;16;29
96;03.01.2018;2018;01;14;Keskiviikko;30;36;66;16;18;34
96;03.01.2018;2018;01;15;Keskiviikko;51;66;117;8;48;56
96;03.01.2018;2018;01;16;Keskiviikko;61;66;127;14;45;59
96;03.01.2018;2018;01;17;Keskiviikko;43;22;65;24;26;50
96;03.01.2018;2018;01;18;Keskiviikko;46;7;53;27;18;45
96;03.01.2018;2018;01;19;Keskiviikko;28;12;40;18;18;36
96;03.01.2018;2018;01;20;Keskiviikko;32;19;51;9;32;41
96;03.01.2018;2018;01;21;Keskiviikko;11;16;27;7;9;16
96;03.01.2018;2018;01;22;Keskiviikko;9;10;19;1;5;6
96;03.01.2018;2018;01;23;Keskiviikko;2;1;3;2;3;5
96;04.01.2018;2018;01;00;Torstai;4;0;4;0;0;0
96;04.01.2018;2018;01;01;Torstai;1;0;1;0;0;0
96;04.01.2018;2018;01;02;Torstai;3;0;3;0;0;0
96;04.01.2018;2018;01;03;Torstai;1;0;1;0;0;0
96;04.01.2018;2018;01;04;Torstai;3;0;3;0;0;0
96;04.01.2018;2018;01;05;Torstai;7;0;7;1;0;1
96;04.01.2018;2018;01;06;Torstai;53;0;53;9;0;9
96;04.01.2018;2018;01;07;Torstai;59;0;59;7;0;7
96;04.01.2018;2018;01;08;Torstai;36;0;36;11;0;11
96;04.01.2018;2018;01;09;Torstai;25;0;25;10;0;10
96;04.01.2018;2018;01;10;Torstai;27;0;27;43;0;43
96;04.01.2018;2018;01;11;Torstai;29;0;29;20;0;20
96;04.01.2018;2018;01;12;Torstai;44;0;44;21;0;21
96;04.01.2018;2018;01;13;Torstai;56;0;56;18;0;18
96;04.01.2018;2018;01;14;Torstai;47;0;47;24;0;24
96;04.01.2018;2018;01;15;Torstai;85;0;85;25;0;25
96;04.01.2018;2018;01;16;Torstai;78;0;78;32;0;32
96;04.01.2018;2018;01;17;Torstai;47;0;47;28;0;28
96;04.01.2018;2018;01;18;Torstai;49;0;49;35;0;35
96;04.01.2018;2018;01;19;Torstai;18;0;18;11;0;11
96;04.01.2018;2018;01;20;Torstai;25;0;25;14;0;14
96;04.01.2018;2018;01;21;Torstai;39;0;39;26;0;26
96;04.01.2018;2018;01;22;Torstai;8;0;8;6;0;6
96;04.01.2018;2018;01;23;Torstai;3;0;3;3;0;3
96;05.01.2018;2018;01;00;Perjantai;4;0;4;1;0;1
96;05.01.2018;2018;01;01;Perjantai;1;0;1;0;1;1
96;05.01.2018;2018;01;02;Perjantai;2;0;2;0;1;1
96;05.01.2018;2018;01;03;Perjantai;1;0;1;1;0;1
96;05.01.2018;2018;01;04;Perjantai;2;2;4;0;0;0
96;05.01.2018;2018;01;05;Perjantai;4;4;8;0;0;0
96;05.01.2018;2018;01;06;Perjantai;35;18;53;12;5;17
96;05.01.2018;2018;01;07;Perjantai;58;38;96;31;13;44
96;05.01.2018;2018;01;08;Perjantai;34;42;76;9;10;19
96;05.01.2018;2018;01;09;Perjantai;9;15;24;6;8;14
96;05.01.2018;2018;01;10;Perjantai;21;22;43;5;6;11
96;05.01.2018;2018;01;11;Perjantai;12;12;24;9;15;24
96;05.01.2018;2018;01;12;Perjantai;17;12;29;4;9;13
96;05.01.2018;2018;01;13;Perjantai;28;17;45;2;10;12
96;05.01.2018;2018;01;14;Perjantai;30;35;65;10;23;33
96;05.01.2018;2018;01;15;Perjantai;17;56;73;5;37;42
96;05.01.2018;2018;01;16;Perjantai;32;46;78;4;23;27
96;05.01.2018;2018;01;17;Perjantai;27;19;46;14;13;27
96;05.01.2018;2018;01;18;Perjantai;18;9;27;12;11;23
96;05.01.2018;2018;01;19;Perjantai;10;14;24;2;7;9
96;05.01.2018;2018;01;20;Perjantai;17;6;23;13;9;22
96;05.01.2018;2018;01;21;Perjantai;11;13;24;3;8;11
96;05.01.2018;2018;01;22;Perjantai;3;11;14;4;2;6
96;05.01.2018;2018;01;23;Perjantai;3;2;5;2;1;3
96;06.01.2018;2018;01;00;Lauantai;4;2;6;2;0;2
96;06.01.2018;2018;01;01;Lauantai;2;0;2;0;0;0
96;06.01.2018;2018;01;02;Lauantai;2;3;5;1;0;1
96;06.01.2018;2018;01;03;Lauantai;0;0;0;0;1;1
96;06.01.2018;2018;01;04;Lauantai;1;0;1;1;0;1
96;06.01.2018;2018;01;05;Lauantai;1;1;2;0;0;0
96;06.01.2018;2018;01;06;Lauantai;11;0;11;10;0;10
96;06.01.2018;2018;01;07;Lauantai;1;9;10;3;4;7
96;06.01.2018;2018;01;08;Lauantai;1;6;7;2;2;4
96;06.01.2018;2018;01;09;Lauantai;13;10;23;2;5;7
96;06.01.2018;2018;01;10;Lauantai;13;12;25;6;11;17
96;06.01.2018;2018;01;11;Lauantai;7;14;21;11;15;26
96;06.01.2018;2018;01;12;Lauantai;20;14;34;5;10;15
96;06.01.2018;2018;01;13;Lauantai;29;14;43;11;12;23
96;06.01.2018;2018;01;14;Lauantai;16;22;38;8;8;16
96;06.01.2018;2018;01;15;Lauantai;15;18;33;14;22;36
96;06.01.2018;2018;01;16;Lauantai;20;19;39;15;17;32
96;06.01.2018;2018;01;17;Lauantai;28;8;36;18;15;33
96;06.01.2018;2018;01;18;Lauantai;9;4;13;14;13;27
96;06.01.2018;2018;01;19;Lauantai;17;7;24;15;10;25
96;06.01.2018;2018;01;20;Lauantai;20;18;38;11;12;23
96;06.01.2018;2018;01;21;Lauantai;7;17;24;1;4;5
96;06.01.2018;2018;01;22;Lauantai;2;6;8;2;2;4
96;06.01.2018;2018;01;23;Lauantai;3;3;6;0;0;0
96;07.01.2018;2018;01;00;Sunnuntai;8;0;8;2;0;2
96;07.01.2018;2018;01;01;Sunnuntai;1;0;1;0;1;1
96;07.01.2018;2018;01;02;Sunnuntai;2;2;4;1;0;1
96;07.01.2018;2018;01;03;Sunnuntai;1;0;1;0;0;0
96;07.01.2018;2018;01;04;Sunnuntai;3;1;4;5;3;8
96;07.01.2018;2018;01;05;Sunnuntai;0;0;0;2;0;2
96;07.01.2018;2018;01;06;Sunnuntai;11;4;15;10;0;10
96;07.01.2018;2018;01;07;Sunnuntai;3;4;7;0;1;1
96;07.01.2018;2018;01;08;Sunnuntai;1;8;9;2;0;2
96;07.01.2018;2018;01;09;Sunnuntai;6;10;16;11;9;20
96;07.01.2018;2018;01;10;Sunnuntai;5;7;12;5;10;15
96;07.01.2018;2018;01;11;Sunnuntai;9;10;19;14;12;26
96;07.01.2018;2018;01;12;Sunnuntai;31;18;49;12;16;28
96;07.01.2018;2018;01;13;Sunnuntai;33;16;49;25;23;48
96;07.01.2018;2018;01;14;Sunnuntai;19;23;42;14;20;34
96;07.01.2018;2018;01;15;Sunnuntai;19;13;32;19;14;33
96;07.01.2018;2018;01;16;Sunnuntai;35;11;46;20;8;28
96;07.01.2018;2018;01;17;Sunnuntai;12;11;23;12;16;28
96;07.01.2018;2018;01;18;Sunnuntai;8;12;20;13;19;32
96;07.01.2018;2018;01;19;Sunnuntai;6;21;27;5;18;23
96;07.01.2018;2018;01;20;Sunnuntai;14;13;27;8;11;19
96;07.01.2018;2018;01;21;Sunnuntai;4;14;18;7;2;9
96;07.01.2018;2018;01;22;Sunnuntai;3;5;8;2;2;4
96;07.01.2018;2018;01;23;Sunnuntai;0;2;2;1;0;1
96;08.01.2018;2018;01;00;Maanantai;1;0;1;0;0;0
96;08.01.2018;2018;01;01;Maanantai;0;1;1;1;0;1
96;08.01.2018;2018;01;02;Maanantai;2;0;2;0;0;0
96;08.01.2018;2018;01;03;Maanantai;2;0;2;0;0;0
96;08.01.2018;2018;01;04;Maanantai;1;0;1;0;0;0
96;08.01.2018;2018;01;05;Maanantai;3;4;7;1;2;3
96;08.01.2018;2018;01;06;Maanantai;29;15;44;12;3;15
96;08.01.2018;2018;01;07;Maanantai;95;53;148;53;8;61
96;08.01.2018;2018;01;08;Maanantai;133;55;188;21;18;39
96;08.01.2018;2018;01;09;Maanantai;53;34;87;17;16;33
96;08.01.2018;2018;01;10;Maanantai;47;40;87;10;9;19
96;08.01.2018;2018;01;11;Maanantai;39;24;63;16;16;32
96;08.01.2018;2018;01;12;Maanantai;49;42;91;14;14;28
96;08.01.2018;2018;01;13;Maanantai;30;62;92;9;19;28
96;08.01.2018;2018;01;14;Maanantai;25;79;104;12;34;46
96;08.01.2018;2018;01;15;Maanantai;54;113;167;9;52;61
96;08.01.2018;2018;01;16;Maanantai;70;113;183;29;51;80
96;08.01.2018;2018;01;17;Maanantai;46;56;102;23;23;46
96;08.01.2018;2018;01;18;Maanantai;40;18;58;19;23;42
96;08.01.2018;2018;01;19;Maanantai;23;21;44;20;11;31
96;08.01.2018;2018;01;20;Maanantai;27;14;41;9;11;20
96;08.01.2018;2018;01;21;Maanantai;17;22;39;3;10;13
96;08.01.2018;2018;01;22;Maanantai;3;5;8;0;1;1
96;08.01.2018;2018;01;23;Maanantai;4;1;5;0;0;0
96;09.01.2018;2018;01;00;Tiistai;0;0;0;0;0;0
96;09.01.2018;2018;01;01;Tiistai;0;0;0;0;0;0
96;09.01.2018;2018;01;02;Tiistai;1;1;2;1;0;1
96;09.01.2018;2018;01;03;Tiistai;1;1;2;0;1;1
96;09.01.2018;2018;01;04;Tiistai;2;1;3;1;0;1
96;09.01.2018;2018;01;05;Tiistai;4;6;10;0;1;1
96;09.01.2018;2018;01;06;Tiistai;35;22;57;12;6;18
96;09.01.2018;2018;01;07;Tiistai;116;77;193;48;9;57
96;09.01.2018;2018;01;08;Tiistai;95;78;173;24;12;36
96;09.01.2018;2018;01;09;Tiistai;108;31;139;17;12;29
96;09.01.2018;2018;01;10;Tiistai;59;36;95;12;16;28
96;09.01.2018;2018;01;11;Tiistai;52;38;90;13;24;37
96;09.01.2018;2018;01;12;Tiistai;61;61;122;14;21;35
96;09.01.2018;2018;01;13;Tiistai;48;45;93;16;27;43
96;09.01.2018;2018;01;14;Tiistai;42;93;135;13;21;34
96;09.01.2018;2018;01;15;Tiistai;51;145;196;7;42;49
96;09.01.2018;2018;01;16;Tiistai;81;130;211;17;51;68
96;09.01.2018;2018;01;17;Tiistai;33;49;82;12;23;35
96;09.01.2018;2018;01;18;Tiistai;38;33;71;11;12;23
96;09.01.2018;2018;01;19;Tiistai;33;22;55;22;18;40
96;09.01.2018;2018;01;20;Tiistai;38;17;55;16;12;28
96;09.01.2018;2018;01;21;Tiistai;10;21;31;7;12;19
96;09.01.2018;2018;01;22;Tiistai;7;7;14;2;3;5
96;09.01.2018;2018;01;23;Tiistai;3;3;6;1;1;2
96;10.01.2018;2018;01;00;Keskiviikko;0;0;0;0;0;0
96;10.01.2018;2018;01;01;Keskiviikko;0;1;1;0;0;0
96;10.01.2018;2018;01;02;Keskiviikko;0;1;1;0;0;0
96;10.01.2018;2018;01;03;Keskiviikko;1;0;1;0;1;1
96;10.01.2018;2018;01;04;Keskiviikko;2;0;2;0;0;0
96;10.01.2018;2018;01;05;Keskiviikko;8;8;16;0;3;3
96;10.01.2018;2018;01;06;Keskiviikko;36;26;62;9;2;11
96;10.01.2018;2018;01;07;Keskiviikko;102;83;185;41;12;53
96;10.01.2018;2018;01;08;Keskiviikko;114;87;201;10;13;23
96;10.01.2018;2018;01;09;Keskiviikko;79;37;116;11;12;23
96;10.01.2018;2018;01;10;Keskiviikko;40;42;82;12;15;27
96;10.01.2018;2018;01;11;Keskiviikko;57;24;81;23;15;38
96;10.01.2018;2018;01;12;Keskiviikko;58;37;95;10;19;29
96;10.01.2018;2018;01;13;Keskiviikko;32;63;95;18;22;40
96;10.01.2018;2018;01;14;Keskiviikko;51;113;164;9;24;33
96;10.01.2018;2018;01;15;Keskiviikko;49;133;182;20;40;60
96;10.01.2018;2018;01;16;Keskiviikko;64;135;199;10;41;51
96;10.01.2018;2018;01;17;Keskiviikko;45;47;92;13;17;30
96;10.01.2018;2018;01;18;Keskiviikko;57;22;79;22;25;47
96;10.01.2018;2018;01;19;Keskiviikko;37;34;71;22;17;39
96;10.01.2018;2018;01;20;Keskiviikko;39;29;68;12;12;24
96;10.01.2018;2018;01;21;Keskiviikko;16;22;38;5;12;17
96;10.01.2018;2018;01;22;Keskiviikko;4;14;18;1;4;5
96;10.01.2018;2018;01;23;Keskiviikko;6;3;9;0;3;3
96;11.01.2018;2018;01;00;Torstai;3;0;3;3;0;3
96;11.01.2018;2018;01;01;Torstai;0;1;1;0;0;0
96;11.01.2018;2018;01;02;Torstai;3;0;3;0;0;0
96;11.01.2018;2018;01;03;Torstai;2;0;2;0;0;0
96;11.01.2018;2018;01;04;Torstai;0;0;0;0;1;1
96;11.01.2018;2018;01;05;Torstai;1;0;1;0;0;0
96;11.01.2018;2018;01;06;Torstai;10;10;20;1;2;3
96;11.01.2018;2018;01;07;Torstai;70;28;98;31;6;37
96;11.01.2018;2018;01;08;Torstai;143;100;243;27;9;36
96;11.01.2018;2018;01;09;Torstai;70;35;105;20;10;30
96;11.01.2018;2018;01;10;Torstai;78;38;116;21;29;50
96;11.01.2018;2018;01;11;Torstai;37;30;67;15;20;35
96;11.01.2018;2018;01;12;Torstai;42;31;73;14;16;30
96;11.01.2018;2018;01;13;Torstai;35;58;93;10;14;24
96;11.01.2018;2018;01;14;Torstai;46;61;107;19;20;39
96;11.01.2018;2018;01;15;Torstai;49;130;179;7;39;46
96;11.01.2018;2018;01;16;Torstai;67;122;189;12;52;64
96;11.01.2018;2018;01;17;Torstai;64;75;139;21;34;55
96;11.01.2018;2018;01;18;Torstai;38;40;78;15;15;30
96;11.01.2018;2018;01;19;Torstai;45;31;76;9;24;33
96;11.01.2018;2018;01;20;Torstai;35;21;56;13;11;24
96;11.01.2018;2018;01;21;Torstai;19;32;51;6;14;20
96;11.01.2018;2018;01;22;Torstai;16;22;38;2;6;8
96;11.01.2018;2018;01;23;Torstai;6;6;12;3;2;5
96;12.01.2018;2018;01;00;Perjantai;3;0;3;1;0;1
96;12.01.2018;2018;01;01;Perjantai;7;0;7;1;0;1
96;12.01.2018;2018;01;02;Perjantai;2;0;2;0;0;0
96;12.01.2018;2018;01;03;Perjantai;1;0;1;2;0;2
96;12.01.2018;2018;01;04;Perjantai;6;1;7;1;1;2
96;12.01.2018;2018;01;05;Perjantai;6;6;12;1;1;2
96;12.01.2018;2018;01;06;Perjantai;47;14;61;13;5;18
96;12.01.2018;2018;01;07;Perjantai;80;57;137;35;14;49
96;12.01.2018;2018;01;08;Perjantai;101;61;162;26;7;33
96;12.01.2018;2018;01;09;Perjantai;49;36;85;11;10;21
96;12.01.2018;2018;01;10;Perjantai;44;24;68;7;13;20
96;12.01.2018;2018;01;11;Perjantai;37;44;81;10;12;22
96;12.01.2018;2018;01;12;Perjantai;41;48;89;11;13;24
96;12.01.2018;2018;01;13;Perjantai;42;60;102;9;21;30
96;12.01.2018;2018;01;14;Perjantai;57;104;161;7;37;44
96;12.01.2018;2018;01;15;Perjantai;61;100;161;16;53;69
96;12.01.2018;2018;01;16;Perjantai;62;67;129;12;24;36
96;12.01.2018;2018;01;17;Perjantai;35;39;74;15;19;34
96;12.01.2018;2018;01;18;Perjantai;29;21;50;7;14;21
96;12.01.2018;2018;01;19;Perjantai;24;16;40;9;8;17
96;12.01.2018;2018;01;20;Perjantai;17;11;28;5;5;10
96;12.01.2018;2018;01;21;Perjantai;16;10;26;8;4;12
96;12.01.2018;2018;01;22;Perjantai;8;10;18;4;0;4
96;12.01.2018;2018;01;23;Perjantai;6;3;9;2;3;5
96;13.01.2018;2018;01;00;Lauantai;6;1;7;2;0;2
96;13.01.2018;2018;01;01;Lauantai;1;2;3;0;0;0
96;13.01.2018;2018;01;02;Lauantai;2;0;2;0;1;1
96;13.01.2018;2018;01;03;Lauantai;5;0;5;0;0;0
96;13.01.2018;2018;01;04;Lauantai;6;3;9;2;1;3
96;13.01.2018;2018;01;05;Lauantai;2;1;3;0;0;0
96;13.01.2018;2018;01;06;Lauantai;14;5;19;6;0;6
96;13.01.2018;2018;01;07;Lauantai;1;6;7;2;5;7
96;13.01.2018;2018;01;08;Lauantai;6;7;13;6;4;10
96;13.01.2018;2018;01;09;Lauantai;5;11;16;5;5;10
96;13.01.2018;2018;01;10;Lauantai;12;16;28;5;16;21
96;13.01.2018;2018;01;11;Lauantai;19;21;40;16;18;34
96;13.01.2018;2018;01;12;Lauantai;27;22;49;8;16;24
96;13.01.2018;2018;01;13;Lauantai;25;17;42;16;15;31
96;13.01.2018;2018;01;14;Lauantai;26;31;57;10;10;20
96;13.01.2018;2018;01;15;Lauantai;35;28;63;7;13;20
96;13.01.2018;2018;01;16;Lauantai;33;33;66;11;32;43
96;13.01.2018;2018;01;17;Lauantai;25;16;41;11;7;18
96;13.01.2018;2018;01;18;Lauantai;24;12;36;11;8;19
96;13.01.2018;2018;01;19;Lauantai;33;5;38;25;6;31
96;13.01.2018;2018;01;20;Lauantai;18;22;40;3;7;10
96;13.01.2018;2018;01;21;Lauantai;15;22;37;9;11;20
96;13.01.2018;2018;01;22;Lauantai;4;4;8;1;5;6
96;13.01.2018;2018;01;23;Lauantai;6;4;10;0;1;1
96;14.01.2018;2018;01;00;Sunnuntai;2;3;5;0;1;1
96;14.01.2018;2018;01;01;Sunnuntai;4;4;8;0;1;1
96;14.01.2018;2018;01;02;Sunnuntai;3;0;3;1;0;1
96;14.01.2018;2018;01;03;Sunnuntai;6;0;6;0;0;0
96;14.01.2018;2018;01;04;Sunnuntai;9;1;10;2;1;3
96;14.01.2018;2018;01;05;Sunnuntai;3;1;4;1;1;2
96;14.01.2018;2018;01;06;Sunnuntai;17;3;20;3;0;3
96;14.01.2018;2018;01;07;Sunnuntai;0;10;10;0;1;1
96;14.01.2018;2018;01;08;Sunnuntai;3;3;6;5;0;5
96;14.01.2018;2018;01;09;Sunnuntai;12;5;17;3;5;8
96;14.01.2018;2018;01;10;Sunnuntai;3;8;11;11;9;20
96;14.01.2018;2018;01;11;Sunnuntai;7;13;20;14;12;26
96;14.01.2018;2018;01;12;Sunnuntai;22;21;43;6;10;16
96;14.01.2018;2018;01;13;Sunnuntai;21;21;42;11;17;28
96;14.01.2018;2018;01;14;Sunnuntai;20;25;45;9;16;25
96;14.01.2018;2018;01;15;Sunnuntai;31;26;57;7;14;21
96;14.01.2018;2018;01;16;Sunnuntai;29;9;38;28;13;41
96;14.01.2018;2018;01;17;Sunnuntai;18;19;37;16;17;33
96;14.01.2018;2018;01;18;Sunnuntai;32;20;52;19;23;42
96;14.01.2018;2018;01;19;Sunnuntai;6;10;16;10;20;30
96;14.01.2018;2018;01;20;Sunnuntai;24;18;42;6;8;14
96;14.01.2018;2018;01;21;Sunnuntai;19;12;31;12;9;21
96;14.01.2018;2018;01;22;Sunnuntai;3;3;6;1;0;1
96;14.01.2018;2018;01;23;Sunnuntai;6;1;7;0;1;1
96;15.01.2018;2018;01;00;Maanantai;1;0;1;1;0;1
96;15.01.2018;2018;01;01;Maanantai;0;0;0;1;0;1
96;15.01.2018;2018;01;02;Maanantai;0;0;0;0;0;0
96;15.01.2018;2018;01;03;Maanantai;2;0;2;0;1;1
96;15.01.2018;2018;01;04;Maanantai;1;0;1;0;1;1
96;15.01.2018;2018;01;05;Maanantai;5;8;13;0;1;1
96;15.01.2018;2018;01;06;Maanantai;31;14;45;16;4;20
96;15.01.2018;2018;01;07;Maanantai;107;64;171;49;10;59
96;15.01.2018;2018;01;08;Maanantai;143;79;222;23;20;43
96;15.01.2018;2018;01;09;Maanantai;67;28;95;18;12;30
96;15.01.2018;2018;01;10;Maanantai;49;27;76;14;13;27
96;15.01.2018;2018;01;11;Maanantai;35;40;75;12;23;35
96;15.01.2018;2018;01;12;Maanantai;61;48;109;20;22;42
96;15.01.2018;2018;01;13;Maanantai;32;66;98;10;30;40
96;15.01.2018;2018;01;14;Maanantai;38;75;113;15;25;40
96;15.01.2018;2018;01;15;Maanantai;65;120;185;9;48;57
96;15.01.2018;2018;01;16;Maanantai;68;115;183;20;53;73
96;15.01.2018;2018;01;17;Maanantai;46;55;101;11;26;37
96;15.01.2018;2018;01;18;Maanantai;44;35;79;13;21;34
96;15.01.2018;2018;01;19;Maanantai;35;27;62;11;16;27
96;15.01.2018;2018;01;20;Maanantai;41;19;60;10;18;28
96;15.01.2018;2018;01;21;Maanantai;21;30;51;8;12;20
96;15.01.2018;2018;01;22;Maanantai;4;8;12;1;3;4
96;15.01.2018;2018;01;23;Maanantai;1;1;2;1;0;1
96;16.01.2018;2018;01;00;Tiistai;1;0;1;0;0;0
96;16.01.2018;2018;01;01;Tiistai;0;0;0;0;0;0
96;16.01.2018;2018;01;02;Tiistai;0;0;0;0;0;0
96;16.01.2018;2018;01;03;Tiistai;1;0;1;0;0;0
96;16.01.2018;2018;01;04;Tiistai;2;1;3;0;0;0
96;16.01.2018;2018;01;05;Tiistai;8;4;12;2;1;3
96;16.01.2018;2018;01;06;Tiistai;44;18;62;14;7;21
96;16.01.2018;2018;01;07;Tiistai;78;68;146;44;12;56
96;16.01.2018;2018;01;08;Tiistai;123;60;183;22;14;36
96;16.01.2018;2018;01;09;Tiistai;93;31;124;16;11;27
96;16.01.2018;2018;01;10;Tiistai;46;21;67;5;15;20
96;16.01.2018;2018;01;11;Tiistai;43;40;83;19;14;33
96;16.01.2018;2018;01;12;Tiistai;52;44;96;12;14;26
96;16.01.2018;2018;01;13;Tiistai;56;52;108;14;21;35
96;16.01.2018;2018;01;14;Tiistai;25;78;103;6;22;28
96;16.01.2018;2018;01;15;Tiistai;44;129;173;9;47;56
96;16.01.2018;2018;01;16;Tiistai;69;116;185;13;71;84
96;16.01.2018;2018;01;17;Tiistai;37;54;91;12;32;44
96;16.01.2018;2018;01;18;Tiistai;42;21;63;10;25;35
96;16.01.2018;2018;01;19;Tiistai;37;24;61;12;22;34
96;16.01.2018;2018;01;20;Tiistai;28;19;47;9;15;24
96;16.01.2018;2018;01;21;Tiistai;35;17;52;4;21;25
96;16.01.2018;2018;01;22;Tiistai;8;3;11;3;6;9
96;16.01.2018;2018;01;23;Tiistai;2;1;3;0;1;1
96;17.01.2018;2018;01;00;Keskiviikko;1;0;1;0;0;0
96;17.01.2018;2018;01;01;Keskiviikko;1;0;1;0;0;0
96;17.01.2018;2018;01;02;Keskiviikko;0;0;0;0;0;0
96;17.01.2018;2018;01;03;Keskiviikko;2;0;2;0;0;0
96;17.01.2018;2018;01;04;Keskiviikko;1;0;1;0;0;0
96;17.01.2018;2018;01;05;Keskiviikko;6;2;8;0;2;2
96;17.01.2018;2018;01;06;Keskiviikko;43;16;59;18;8;26
96;17.01.2018;2018;01;07;Keskiviikko;83;59;142;42;16;58
96;17.01.2018;2018;01;08;Keskiviikko;107;53;160;21;24;45
96;17.01.2018;2018;01;09;Keskiviikko;93;33;126;20;15;35
96;17.01.2018;2018;01;10;Keskiviikko;52;26;78;9;16;25
96;17.01.2018;2018;01;11;Keskiviikko;46;30;76;17;17;34
96;17.01.2018;2018;01;12;Keskiviikko;62;39;101;25;25;50
96;17.01.2018;2018;01;13;Keskiviikko;33;66;99;8;31;39
96;17.01.2018;2018;01;14;Keskiviikko;30;74;104;11;19;30
96;17.01.2018;2018;01;15;Keskiviikko;47;115;162;13;54;67
96;17.01.2018;2018;01;16;Keskiviikko;83;110;193;11;52;63
96;17.01.2018;2018;01;17;Keskiviikko;38;41;79;20;29;49
96;17.01.2018;2018;01;18;Keskiviikko;45;27;72;39;35;74
96;17.01.2018;2018;01;19;Keskiviikko;32;22;54;15;20;35
96;17.01.2018;2018;01;20;Keskiviikko;32;27;59;12;19;31
96;17.01.2018;2018;01;21;Keskiviikko;15;22;37;3;9;12
96;17.01.2018;2018;01;22;Keskiviikko;3;9;12;0;6;6
96;17.01.2018;2018;01;23;Keskiviikko;1;1;2;0;0;0
96;18.01.2018;2018;01;00;Torstai;3;1;4;1;0;1
96;18.01.2018;2018;01;01;Torstai;2;0;2;1;2;3
96;18.01.2018;2018;01;02;Torstai;0;0;0;0;0;0
96;18.01.2018;2018;01;03;Torstai;2;0;2;0;0;0
96;18.01.2018;2018;01;04;Torstai;1;0;1;1;1;2
96;18.01.2018;2018;01;05;Torstai;3;2;5;0;1;1
96;18.01.2018;2018;01;06;Torstai;45;17;62;14;3;17
96;18.01.2018;2018;01;07;Torstai;97;68;165;35;12;47
96;18.01.2018;2018;01;08;Torstai;79;64;143;22;12;34
96;18.01.2018;2018;01;09;Torstai;98;43;141;24;12;36
96;18.01.2018;2018;01;10;Torstai;56;53;109;11;14;25
96;18.01.2018;2018;01;11;Torstai;53;42;95;13;8;21
96;18.01.2018;2018;01;12;Torstai;82;68;150;19;14;33
96;18.01.2018;2018;01;13;Torstai;36;67;103;9;23;32
96;18.01.2018;2018;01;14;Torstai;38;87;125;6;31;37
96;18.01.2018;2018;01;15;Torstai;62;118;180;16;42;58
96;18.01.2018;2018;01;16;Torstai;67;110;177;14;44;58
96;18.01.2018;2018;01;17;Torstai;34;57;91;11;23;34
96;18.01.2018;2018;01;18;Torstai;35;41;76;18;21;39
96;18.01.2018;2018;01;19;Torstai;37;25;62;14;20;34
96;18.01.2018;2018;01;20;Torstai;30;25;55;11;12;23
96;18.01.2018;2018;01;21;Torstai;28;24;52;6;7;13
96;18.01.2018;2018;01;22;Torstai;12;5;17;1;2;3
96;18.01.2018;2018;01;23;Torstai;2;0;2;1;1;2
96;19.01.2018;2018;01;00;Perjantai;0;2;2;0;0;0
96;19.01.2018;2018;01;01;Perjantai;0;0;0;0;1;1
96;19.01.2018;2018;01;02;Perjantai;4;1;5;0;1;1
96;19.01.2018;2018;01;03;Perjantai;5;1;6;1;0;1
96;19.01.2018;2018;01;04;Perjantai;5;0;5;0;0;0
96;19.01.2018;2018;01;05;Perjantai;4;0;4;0;1;1
96;19.01.2018;2018;01;06;Perjantai;47;23;70;8;1;9
96;19.01.2018;2018;01;07;Perjantai;84;62;146;37;9;46
96;19.01.2018;2018;01;08;Perjantai;71;70;141;25;12;37
96;19.01.2018;2018;01;09;Perjantai;48;48;96;10;10;20
96;19.01.2018;2018;01;10;Perjantai;45;50;95;7;16;23
96;19.01.2018;2018;01;11;Perjantai;37;59;96;7;20;27
96;19.01.2018;2018;01;12;Perjantai;62;39;101;22;18;40
96;19.01.2018;2018;01;13;Perjantai;36;51;87;8;18;26
96;19.01.2018;2018;01;14;Perjantai;43;115;158;19;53;72
96;19.01.2018;2018;01;15;Perjantai;68;96;164;7;43;50
96;19.01.2018;2018;01;16;Perjantai;47;61;108;11;31;42
96;19.01.2018;2018;01;17;Perjantai;36;31;67;15;14;29
96;19.01.2018;2018;01;18;Perjantai;33;27;60;10;8;18
96;19.01.2018;2018;01;19;Perjantai;14;17;31;13;8;21
96;19.01.2018;2018;01;20;Perjantai;24;11;35;7;7;14
96;19.01.2018;2018;01;21;Perjantai;16;18;34;1;10;11
96;19.01.2018;2018;01;22;Perjantai;11;5;16;5;2;7
96;19.01.2018;2018;01;23;Perjantai;5;3;8;1;2;3
96;20.01.2018;2018;01;00;Lauantai;6;1;7;3;0;3
96;20.01.2018;2018;01;01;Lauantai;2;4;6;1;0;1
96;20.01.2018;2018;01;02;Lauantai;1;0;1;1;1;2
96;20.01.2018;2018;01;03;Lauantai;4;0;4;1;0;1
96;20.01.2018;2018;01;04;Lauantai;1;2;3;1;0;1
96;20.01.2018;2018;01;05;Lauantai;3;2;5;1;0;1
96;20.01.2018;2018;01;06;Lauantai;12;5;17;7;3;10
96;20.01.2018;2018;01;07;Lauantai;1;12;13;3;2;5
96;20.01.2018;2018;01;08;Lauantai;3;13;16;4;4;8
96;20.01.2018;2018;01;09;Lauantai;3;14;17;3;10;13
96;20.01.2018;2018;01;10;Lauantai;15;19;34;7;11;18
96;20.01.2018;2018;01;11;Lauantai;19;13;32;12;8;20
96;20.01.2018;2018;01;12;Lauantai;23;20;43;13;16;29
96;20.01.2018;2018;01;13;Lauantai;22;19;41;12;21;33
96;20.01.2018;2018;01;14;Lauantai;21;26;47;11;15;26
96;20.01.2018;2018;01;15;Lauantai;39;20;59;8;9;17
96;20.01.2018;2018;01;16;Lauantai;19;20;39;11;12;23
96;20.01.2018;2018;01;17;Lauantai;9;13;22;6;7;13
96;20.01.2018;2018;01;18;Lauantai;24;13;37;8;7;15
96;20.01.2018;2018;01;19;Lauantai;32;7;39;11;6;17
96;20.01.2018;2018;01;20;Lauantai;11;16;27;9;10;19
96;20.01.2018;2018;01;21;Lauantai;7;21;28;1;13;14
96;20.01.2018;2018;01;22;Lauantai;2;7;9;0;1;1
96;20.01.2018;2018;01;23;Lauantai;3;0;3;2;1;3
96;21.01.2018;2018;01;00;Sunnuntai;7;7;14;2;1;3
96;21.01.2018;2018;01;01;Sunnuntai;4;0;4;3;2;5
96;21.01.2018;2018;01;02;Sunnuntai;1;1;2;0;0;0
96;21.01.2018;2018;01;03;Sunnuntai;4;0;4;1;0;1
96;21.01.2018;2018;01;04;Sunnuntai;10;1;11;1;0;1
96;21.01.2018;2018;01;05;Sunnuntai;1;0;1;0;0;0
96;21.01.2018;2018;01;06;Sunnuntai;10;5;15;5;1;6
96;21.01.2018;2018;01;07;Sunnuntai;4;4;8;0;5;5
96;21.01.2018;2018;01;08;Sunnuntai;4;4;8;3;4;7
96;21.01.2018;2018;01;09;Sunnuntai;6;6;12;1;7;8
96;21.01.2018;2018;01;10;Sunnuntai;7;9;16;1;3;4
96;21.01.2018;2018;01;11;Sunnuntai;11;12;23;7;10;17
96;21.01.2018;2018;01;12;Sunnuntai;19;11;30;16;12;28
96;21.01.2018;2018;01;13;Sunnuntai;19;8;27;14;8;22
96;21.01.2018;2018;01;14;Sunnuntai;16;33;49;9;11;20
96;21.01.2018;2018;01;15;Sunnuntai;19;15;34;17;16;33
96;21.01.2018;2018;01;16;Sunnuntai;27;14;41;18;6;24
96;21.01.2018;2018;01;17;Sunnuntai;18;13;31;13;15;28
96;21.01.2018;2018;01;18;Sunnuntai;20;5;25;10;14;24
96;21.01.2018;2018;01;19;Sunnuntai;12;14;26;6;9;15
96;21.01.2018;2018;01;20;Sunnuntai;11;23;34;8;10;18
96;21.01.2018;2018;01;21;Sunnuntai;10;11;21;3;8;11
96;21.01.2018;2018;01;22;Sunnuntai;4;2;6;0;3;3
96;21.01.2018;2018;01;23;Sunnuntai;1;4;5;1;2;3
96;22.01.2018;2018;01;00;Maanantai;0;3;3;0;0;0
96;22.01.2018;2018;01;01;Maanantai;1;0;1;0;0;0
96;22.01.2018;2018;01;02;Maanantai;1;0;1;0;0;0
96;22.01.2018;2018;01;03;Maanantai;1;0;1;0;0;0
96;22.01.2018;2018;01;04;Maanantai;2;0;2;0;1;1
96;22.01.2018;2018;01;05;Maanantai;10;4;14;1;1;2
96;22.01.2018;2018;01;06;Maanantai;30;15;45;17;7;24
96;22.01.2018;2018;01;07;Maanantai;78;60;138;36;14;50
96;22.01.2018;2018;01;08;Maanantai;129;56;185;28;8;36
96;22.01.2018;2018;01;09;Maanantai;57;41;98;21;11;32
96;22.01.2018;2018;01;10;Maanantai;45;33;78;6;12;18
96;22.01.2018;2018;01;11;Maanantai;31;24;55;9;8;17
96;22.01.2018;2018;01;12;Maanantai;53;61;114;15;14;29
96;22.01.2018;2018;01;13;Maanantai;27;42;69;11;22;33
96;22.01.2018;2018;01;14;Maanantai;32;69;101;7;23;30
96;22.01.2018;2018;01;15;Maanantai;46;107;153;8;53;61
96;22.01.2018;2018;01;16;Maanantai;73;124;197;8;44;52
96;22.01.2018;2018;01;17;Maanantai;33;47;80;9;18;27
96;22.01.2018;2018;01;18;Maanantai;26;18;44;12;13;25
96;22.01.2018;2018;01;19;Maanantai;22;18;40;5;14;19
96;22.01.2018;2018;01;20;Maanantai;27;10;37;8;11;19
96;22.01.2018;2018;01;21;Maanantai;14;19;33;6;8;14
96;22.01.2018;2018;01;22;Maanantai;9;11;20;2;1;3
96;22.01.2018;2018;01;23;Maanantai;2;1;3;0;0;0
96;23.01.2018;2018;01;00;Tiistai;0;0;0;0;1;1
96;23.01.2018;2018;01;01;Tiistai;0;0;0;0;0;0
96;23.01.2018;2018;01;02;Tiistai;2;0;2;0;0;0
96;23.01.2018;2018;01;03;Tiistai;1;0;1;0;0;0
96;23.01.2018;2018;01;04;Tiistai;1;0;1;0;1;1
96;23.01.2018;2018;01;05;Tiistai;2;4;6;3;1;4
96;23.01.2018;2018;01;06;Tiistai;38;15;53;12;2;14
96;23.01.2018;2018;01;07;Tiistai;82;47;129;52;18;70
96;23.01.2018;2018;01;08;Tiistai;113;48;161;24;19;43
96;23.01.2018;2018;01;09;Tiistai;62;35;97;13;11;24
96;23.01.2018;2018;01;10;Tiistai;24;25;49;9;9;18
96;23.01.2018;2018;01;11;Tiistai;53;27;80;22;18;40
96;23.01.2018;2018;01;12;Tiistai;57;37;94;10;19;29
96;23.01.2018;2018;01;13;Tiistai;35;54;89;10;22;32
96;23.01.2018;2018;01;14;Tiistai;29;53;82;10;22;32
96;23.01.2018;2018;01;15;Tiistai;27;98;125;13;51;64
96;23.01.2018;2018;01;16;Tiistai;44;119;163;9;48;57
96;23.01.2018;2018;01;17;Tiistai;34;45;79;27;17;44
96;23.01.2018;2018;01;18;Tiistai;32;22;54;11;23;34
96;23.01.2018;2018;01;19;Tiistai;30;26;56;9;7;16
96;23.01.2018;2018;01;20;Tiistai;28;14;42;6;6;12
96;23.01.2018;2018;01;21;Tiistai;19;24;43;6;7;13
96;23.01.2018;2018;01;22;Tiistai;5;6;11;1;6;7
96;23.01.2018;2018;01;23;Tiistai;2;4;6;1;0;1
96;24.01.2018;2018;01;00;Keskiviikko;0;0;0;2;0;2
96;24.01.2018;2018;01;01;Keskiviikko;1;0;1;2;0;2
96;24.01.2018;2018;01;02;Keskiviikko;1;0;1;0;0;0
96;24.01.2018;2018;01;03;Keskiviikko;2;1;3;0;0;0
96;24.01.2018;2018;01;04;Keskiviikko;2;0;2;0;0;0
96;24.01.2018;2018;01;05;Keskiviikko;4;6;10;0;1;1
96;24.01.2018;2018;01;06;Keskiviikko;46;18;64;13;6;19
96;24.01.2018;2018;01;07;Keskiviikko;91;68;159;49;14;63
96;24.01.2018;2018;01;08;Keskiviikko;97;66;163;33;16;49
96;24.01.2018;2018;01;09;Keskiviikko;74;32;106;25;10;35
96;24.01.2018;2018;01;10;Keskiviikko;38;35;73;7;12;19
96;24.01.2018;2018;01;11;Keskiviikko;48;37;85;13;17;30
96;24.01.2018;2018;01;12;Keskiviikko;50;46;96;16;35;51
96;24.01.2018;2018;01;13;Keskiviikko;31;78;109;12;26;38
96;24.01.2018;2018;01;14;Keskiviikko;36;105;141;11;28;39
96;24.01.2018;2018;01;15;Keskiviikko;35;103;138;17;44;61
96;24.01.2018;2018;01;16;Keskiviikko;67;110;177;26;25;51
96;24.01.2018;2018;01;17;Keskiviikko;52;9;61;26;1;27
96;24.01.2018;2018;01;18;Keskiviikko;54;2;56;57;0;57
96;24.01.2018;2018;01;19;Keskiviikko;44;0;44;27;0;27
96;24.01.2018;2018;01;20;Keskiviikko;30;0;30;28;0;28
96;24.01.2018;2018;01;21;Keskiviikko;32;3;35;14;0;14
96;24.01.2018;2018;01;22;Keskiviikko;12;0;12;5;0;5
96;24.01.2018;2018;01;23;Keskiviikko;5;0;5;4;0;4
96;25.01.2018;2018;01;00;Torstai;4;0;4;0;0;0
96;25.01.2018;2018;01;01;Torstai;2;0;2;0;0;0
96;25.01.2018;2018;01;02;Torstai;1;0;1;1;0;1
96;25.01.2018;2018;01;03;Torstai;0;0;0;0;0;0
96;25.01.2018;2018;01;04;Torstai;1;0;1;0;0;0
96;25.01.2018;2018;01;05;Torstai;1;1;2;0;0;0
96;25.01.2018;2018;01;06;Torstai;25;21;46;0;0;0
96;25.01.2018;2018;01;07;Torstai;59;56;115;0;0;0
96;25.01.2018;2018;01;08;Torstai;71;69;140;1;0;1
96;25.01.2018;2018;01;09;Torstai;53;38;91;1;0;1
96;25.01.2018;2018;01;10;Torstai;33;31;64;14;13;27
96;25.01.2018;2018;01;11;Torstai;32;22;54;10;13;23
96;25.01.2018;2018;01;12;Torstai;51;46;97;12;13;25
96;25.01.2018;2018;01;13;Torstai;30;41;71;8;15;23
96;25.01.2018;2018;01;14;Torstai;35;76;111;15;23;38
96;25.01.2018;2018;01;15;Torstai;47;78;125;12;28;40
96;25.01.2018;2018;01;16;Torstai;70;73;143;11;29;40
96;25.01.2018;2018;01;17;Torstai;36;27;63;6;15;21
96;25.01.2018;2018;01;18;Torstai;19;25;44;11;12;23
96;25.01.2018;2018;01;19;Torstai;18;21;39;3;11;14
96;25.01.2018;2018;01;20;Torstai;24;6;30;11;8;19
96;25.01.2018;2018;01;21;Torstai;18;19;37;3;5;8
96;25.01.2018;2018;01;22;Torstai;2;6;8;3;2;5
96;25.01.2018;2018;01;23;Torstai;5;2;7;1;0;1
96;26.01.2018;2018;01;00;Perjantai;2;0;2;1;1;2
96;26.01.2018;2018;01;01;Perjantai;1;0;1;1;1;2
96;26.01.2018;2018;01;02;Perjantai;1;0;1;0;1;1
96;26.01.2018;2018;01;03;Perjantai;1;0;1;0;0;0
96;26.01.2018;2018;01;04;Perjantai;3;1;4;4;5;9
96;26.01.2018;2018;01;05;Perjantai;2;3;5;0;0;0
96;26.01.2018;2018;01;06;Perjantai;30;7;37;15;8;23
96;26.01.2018;2018;01;07;Perjantai;58;38;96;23;12;35
96;26.01.2018;2018;01;08;Perjantai;79;38;117;22;34;56
96;26.01.2018;2018;01;09;Perjantai;38;24;62;15;11;26
96;26.01.2018;2018;01;10;Perjantai;37;28;65;28;20;48
96;26.01.2018;2018;01;11;Perjantai;34;32;66;14;13;27
96;26.01.2018;2018;01;12;Perjantai;48;37;85;29;24;53
96;26.01.2018;2018;01;13;Perjantai;40;61;101;18;34;52
96;26.01.2018;2018;01;14;Perjantai;40;68;108;13;40;53
96;26.01.2018;2018;01;15;Perjantai;39;77;116;11;49;60
96;26.01.2018;2018;01;16;Perjantai;43;62;105;17;25;42
96;26.01.2018;2018;01;17;Perjantai;26;22;48;18;17;35
96;26.01.2018;2018;01;18;Perjantai;28;17;45;6;16;22
96;26.01.2018;2018;01;19;Perjantai;19;21;40;10;16;26
96;26.01.2018;2018;01;20;Perjantai;19;13;32;8;8;16
96;26.01.2018;2018;01;21;Perjantai;14;15;29;3;11;14
96;26.01.2018;2018;01;22;Perjantai;5;12;17;1;6;7
96;26.01.2018;2018;01;23;Perjantai;4;3;7;0;0;0
96;27.01.2018;2018;01;00;Lauantai;7;1;8;1;0;1
96;27.01.2018;2018;01;01;Lauantai;1;3;4;0;0;0
96;27.01.2018;2018;01;02;Lauantai;4;0;4;2;0;2
96;27.01.2018;2018;01;03;Lauantai;5;2;7;1;0;1
96;27.01.2018;2018;01;04;Lauantai;3;3;6;2;2;4
96;27.01.2018;2018;01;05;Lauantai;3;0;3;0;0;0
96;27.01.2018;2018;01;06;Lauantai;14;5;19;4;0;4
96;27.01.2018;2018;01;07;Lauantai;4;9;13;1;6;7
96;27.01.2018;2018;01;08;Lauantai;9;14;23;8;1;9
96;27.01.2018;2018;01;09;Lauantai;5;11;16;6;7;13
96;27.01.2018;2018;01;10;Lauantai;10;18;28;6;8;14
96;27.01.2018;2018;01;11;Lauantai;12;22;34;8;14;22
96;27.01.2018;2018;01;12;Lauantai;18;17;35;8;13;21
96;27.01.2018;2018;01;13;Lauantai;31;18;49;14;21;35
96;27.01.2018;2018;01;14;Lauantai;19;23;42;8;9;17
96;27.01.2018;2018;01;15;Lauantai;24;31;55;15;14;29
96;27.01.2018;2018;01;16;Lauantai;21;18;39;15;8;23
96;27.01.2018;2018;01;17;Lauantai;22;13;35;18;13;31
96;27.01.2018;2018;01;18;Lauantai;15;14;29;11;9;20
96;27.01.2018;2018;01;19;Lauantai;21;5;26;5;9;14
96;27.01.2018;2018;01;20;Lauantai;20;9;29;5;8;13
96;27.01.2018;2018;01;21;Lauantai;3;9;12;4;7;11
96;27.01.2018;2018;01;22;Lauantai;3;9;12;2;9;11
96;27.01.2018;2018;01;23;Lauantai;1;5;6;0;2;2
96;28.01.2018;2018;01;00;Sunnuntai;7;3;10;2;1;3
96;28.01.2018;2018;01;01;Sunnuntai;3;2;5;0;0;0
96;28.01.2018;2018;01;02;Sunnuntai;8;0;8;1;0;1
96;28.01.2018;2018;01;03;Sunnuntai;4;1;5;1;0;1
96;28.01.2018;2018;01;04;Sunnuntai;0;0;0;0;1;1
96;28.01.2018;2018;01;05;Sunnuntai;1;1;2;1;0;1
96;28.01.2018;2018;01;06;Sunnuntai;13;4;17;6;0;6
96;28.01.2018;2018;01;07;Sunnuntai;2;11;13;3;3;6
96;28.01.2018;2018;01;08;Sunnuntai;5;3;8;3;2;5
96;28.01.2018;2018;01;09;Sunnuntai;7;2;9;7;9;16
96;28.01.2018;2018;01;10;Sunnuntai;6;10;16;11;14;25
96;28.01.2018;2018;01;11;Sunnuntai;11;20;31;14;19;33
96;28.01.2018;2018;01;12;Sunnuntai;14;22;36;13;13;26
96;28.01.2018;2018;01;13;Sunnuntai;24;17;41;18;16;34
96;28.01.2018;2018;01;14;Sunnuntai;27;31;58;14;19;33
96;28.01.2018;2018;01;15;Sunnuntai;15;23;38;9;16;25
96;28.01.2018;2018;01;16;Sunnuntai;28;23;51;23;13;36
96;28.01.2018;2018;01;17;Sunnuntai;24;15;39;11;15;26
96;28.01.2018;2018;01;18;Sunnuntai;10;13;23;21;20;41
96;28.01.2018;2018;01;19;Sunnuntai;17;17;34;7;14;21
96;28.01.2018;2018;01;20;Sunnuntai;15;7;22;7;9;16
96;28.01.2018;2018;01;21;Sunnuntai;11;14;25;9;7;16
96;28.01.2018;2018;01;22;Sunnuntai;4;5;9;0;3;3
96;28.01.2018;2018;01;23;Sunnuntai;3;0;3;1;2;3
96;29.01.2018;2018;01;00;Maanantai;1;0;1;1;0;1
96;29.01.2018;2018;01;01;Maanantai;1;0;1;1;0;1
96;29.01.2018;2018;01;02;Maanantai;3;0;3;0;0;0
96;29.01.2018;2018;01;03;Maanantai;1;0;1;0;0;0
96;29.01.2018;2018;01;04;Maanantai;1;0;1;1;1;2
96;29.01.2018;2018;01;05;Maanantai;5;8;13;2;4;6
96;29.01.2018;2018;01;06;Maanantai;32;21;53;9;5;14
96;29.01.2018;2018;01;07;Maanantai;116;65;181;32;6;38
96;29.01.2018;2018;01;08;Maanantai;102;70;172;16;11;27
96;29.01.2018;2018;01;09;Maanantai;57;36;93;19;18;37
96;29.01.2018;2018;01;10;Maanantai;52;39;91;12;11;23
96;29.01.2018;2018;01;11;Maanantai;47;40;87;13;10;23
96;29.01.2018;2018;01;12;Maanantai;46;45;91;12;21;33
96;29.01.2018;2018;01;13;Maanantai;44;66;110;16;18;34
96;29.01.2018;2018;01;14;Maanantai;36;67;103;15;21;36
96;29.01.2018;2018;01;15;Maanantai;64;151;215;22;50;72
96;29.01.2018;2018;01;16;Maanantai;72;121;193;17;37;54
96;29.01.2018;2018;01;17;Maanantai;43;47;90;18;24;42
96;29.01.2018;2018;01;18;Maanantai;35;29;64;18;16;34
96;29.01.2018;2018;01;19;Maanantai;33;31;64;15;19;34
96;29.01.2018;2018;01;20;Maanantai;21;22;43;10;13;23
96;29.01.2018;2018;01;21;Maanantai;20;16;36;8;5;13
96;29.01.2018;2018;01;22;Maanantai;4;11;15;1;2;3
96;29.01.2018;2018;01;23;Maanantai;2;0;2;0;2;2
96;30.01.2018;2018;01;00;Tiistai;1;0;1;0;0;0
96;30.01.2018;2018;01;01;Tiistai;1;0;1;0;0;0
96;30.01.2018;2018;01;02;Tiistai;1;0;1;0;0;0
96;30.01.2018;2018;01;03;Tiistai;0;3;3;0;0;0
96;30.01.2018;2018;01;04;Tiistai;2;0;2;0;1;1
96;30.01.2018;2018;01;05;Tiistai;3;5;8;3;0;3
96;30.01.2018;2018;01;06;Tiistai;47;18;65;15;3;18
96;30.01.2018;2018;01;07;Tiistai;90;73;163;36;15;51
96;30.01.2018;2018;01;08;Tiistai;96;64;160;30;9;39
96;30.01.2018;2018;01;09;Tiistai;49;40;89;9;16;25
96;30.01.2018;2018;01;10;Tiistai;54;30;84;17;9;26
96;30.01.2018;2018;01;11;Tiistai;49;31;80;19;26;45
96;30.01.2018;2018;01;12;Tiistai;53;46;99;19;15;34
96;30.01.2018;2018;01;13;Tiistai;42;60;102;10;32;42
96;30.01.2018;2018;01;14;Tiistai;45;81;126;10;23;33
96;30.01.2018;2018;01;15;Tiistai;54;134;188;14;44;58
96;30.01.2018;2018;01;16;Tiistai;58;106;164;9;39;48
96;30.01.2018;2018;01;17;Tiistai;45;67;112;15;27;42
96;30.01.2018;2018;01;18;Tiistai;37;48;85;25;23;48
96;30.01.2018;2018;01;19;Tiistai;23;26;49;15;20;35
96;30.01.2018;2018;01;20;Tiistai;34;14;48;19;30;49
96;30.01.2018;2018;01;21;Tiistai;32;29;61;10;8;18
96;30.01.2018;2018;01;22;Tiistai;10;13;23;0;5;5
96;30.01.2018;2018;01;23;Tiistai;7;0;7;1;0;1
96;31.01.2018;2018;01;00;Keskiviikko;3;0;3;1;0;1
96;31.01.2018;2018;01;01;Keskiviikko;0;0;0;1;0;1
96;31.01.2018;2018;01;02;Keskiviikko;1;0;1;1;0;1
96;31.01.2018;2018;01;03;Keskiviikko;2;0;2;0;0;0
96;31.01.2018;2018;01;04;Keskiviikko;2;0;2;0;0;0
96;31.01.2018;2018;01;05;Keskiviikko;5;3;8;1;2;3
96;31.01.2018;2018;01;06;Keskiviikko;39;26;65;12;1;13
96;31.01.2018;2018;01;07;Keskiviikko;89;60;149;35;15;50
96;31.01.2018;2018;01;08;Keskiviikko;90;71;161;30;13;43
96;31.01.2018;2018;01;09;Keskiviikko;61;39;100;15;15;30
96;31.01.2018;2018;01;10;Keskiviikko;52;45;97;13;11;24
96;31.01.2018;2018;01;11;Keskiviikko;56;47;103;16;21;37
96;31.01.2018;2018;01;12;Keskiviikko;66;37;103;21;36;57
96;31.01.2018;2018;01;13;Keskiviikko;51;54;105;12;28;40
96;31.01.2018;2018;01;14;Keskiviikko;39;82;121;12;50;62
96;31.01.2018;2018;01;15;Keskiviikko;52;125;177;16;45;61
96;31.01.2018;2018;01;16;Keskiviikko;54;122;176;17;49;66
96;31.01.2018;2018;01;17;Keskiviikko;41;52;93;10;16;26
96;31.01.2018;2018;01;18;Keskiviikko;69;32;101;22;17;39
96;31.01.2018;2018;01;19;Keskiviikko;44;18;62;11;14;25
96;31.01.2018;2018;01;20;Keskiviikko;32;41;73;6;22;28
96;31.01.2018;2018;01;21;Keskiviikko;19;27;46;6;6;12
96;31.01.2018;2018;01;22;Keskiviikko;4;12;16;1;2;3
96;31.01.2018;2018;01;23;Keskiviikko;5;3;8;0;1;1
96;01.02.2018;2018;02;00;Torstai;5;0;5;0;0;0
96;01.02.2018;2018;02;01;Torstai;1;1;2;1;0;1
96;01.02.2018;2018;02;02;Torstai;1;1;2;0;0;0
96;01.02.2018;2018;02;03;Torstai;1;0;1;0;0;0
96;01.02.2018;2018;02;04;Torstai;2;0;2;0;0;0
96;01.02.2018;2018;02;05;Torstai;10;3;13;1;2;3
96;01.02.2018;2018;02;06;Torstai;32;16;48;16;1;17
96;01.02.2018;2018;02;07;Torstai;75;53;128;30;12;42
96;01.02.2018;2018;02;08;Torstai;87;58;145;20;10;30
96;01.02.2018;2018;02;09;Torstai;55;31;86;14;13;27
96;01.02.2018;2018;02;10;Torstai;37;33;70;13;15;28
96;01.02.2018;2018;02;11;Torstai;29;37;66;23;11;34
96;01.02.2018;2018;02;12;Torstai;52;43;95;25;19;44
96;01.02.2018;2018;02;13;Torstai;22;39;61;11;21;32
96;01.02.2018;2018;02;14;Torstai;41;69;110;5;29;34
96;01.02.2018;2018;02;15;Torstai;47;82;129;12;45;57
96;01.02.2018;2018;02;16;Torstai;61;99;160;6;59;65
96;01.02.2018;2018;02;17;Torstai;36;56;92;14;25;39
96;01.02.2018;2018;02;18;Torstai;28;39;67;11;17;28
96;01.02.2018;2018;02;19;Torstai;13;17;30;10;14;24
96;01.02.2018;2018;02;20;Torstai;18;14;32;6;6;12
96;01.02.2018;2018;02;21;Torstai;33;26;59;5;14;19
96;01.02.2018;2018;02;22;Torstai;3;16;19;5;1;6
96;01.02.2018;2018;02;23;Torstai;3;4;7;1;1;2
96;02.02.2018;2018;02;00;Perjantai;0;1;1;1;1;2
96;02.02.2018;2018;02;01;Perjantai;6;1;7;0;1;1
96;02.02.2018;2018;02;02;Perjantai;2;0;2;1;0;1
96;02.02.2018;2018;02;03;Perjantai;2;1;3;0;0;0
96;02.02.2018;2018;02;04;Perjantai;3;0;3;0;0;0
96;02.02.2018;2018;02;05;Perjantai;4;4;8;0;0;0
96;02.02.2018;2018;02;06;Perjantai;27;13;40;14;4;18
96;02.02.2018;2018;02;07;Perjantai;73;50;123;66;36;102
96;02.02.2018;2018;02;08;Perjantai;87;45;132;23;13;36
96;02.02.2018;2018;02;09;Perjantai;45;17;62;17;16;33
96;02.02.2018;2018;02;10;Perjantai;51;40;91;12;23;35
96;02.02.2018;2018;02;11;Perjantai;26;39;65;6;28;34
96;02.02.2018;2018;02;12;Perjantai;63;38;101;15;37;52
96;02.02.2018;2018;02;13;Perjantai;49;37;86;13;51;64
96;02.02.2018;2018;02;14;Perjantai;27;51;78;8;55;63
96;02.02.2018;2018;02;15;Perjantai;40;55;95;15;73;88
96;02.02.2018;2018;02;16;Perjantai;36;47;83;11;32;43
96;02.02.2018;2018;02;17;Perjantai;32;19;51;12;17;29
96;02.02.2018;2018;02;18;Perjantai;21;14;35;7;11;18
96;02.02.2018;2018;02;19;Perjantai;14;10;24;6;10;16
96;02.02.2018;2018;02;20;Perjantai;9;11;20;4;12;16
96;02.02.2018;2018;02;21;Perjantai;12;10;22;8;14;22
96;02.02.2018;2018;02;22;Perjantai;4;8;12;5;3;8
96;02.02.2018;2018;02;23;Perjantai;3;1;4;0;1;1
96;03.02.2018;2018;02;00;Lauantai;2;1;3;1;0;1
96;03.02.2018;2018;02;01;Lauantai;3;0;3;0;0;0
96;03.02.2018;2018;02;02;Lauantai;4;0;4;0;0;0
96;03.02.2018;2018;02;03;Lauantai;3;0;3;0;0;0
96;03.02.2018;2018;02;04;Lauantai;3;1;4;1;2;3
96;03.02.2018;2018;02;05;Lauantai;5;1;6;1;0;1
96;03.02.2018;2018;02;06;Lauantai;13;4;17;4;0;4
96;03.02.2018;2018;02;07;Lauantai;5;7;12;1;6;7
96;03.02.2018;2018;02;08;Lauantai;6;6;12;5;7;12
96;03.02.2018;2018;02;09;Lauantai;10;7;17;8;9;17
96;03.02.2018;2018;02;10;Lauantai;9;12;21;5;14;19
96;03.02.2018;2018;02;11;Lauantai;9;10;19;9;12;21
96;03.02.2018;2018;02;12;Lauantai;14;19;33;14;22;36
96;03.02.2018;2018;02;13;Lauantai;18;10;28;17;28;45
96;03.02.2018;2018;02;14;Lauantai;19;9;28;19;31;50
96;03.02.2018;2018;02;15;Lauantai;23;17;40;19;27;46
96;03.02.2018;2018;02;16;Lauantai;14;8;22;12;19;31
96;03.02.2018;2018;02;17;Lauantai;13;12;25;18;18;36
96;03.02.2018;2018;02;18;Lauantai;16;7;23;17;12;29
96;03.02.2018;2018;02;19;Lauantai;16;13;29;13;8;21
96;03.02.2018;2018;02;20;Lauantai;15;5;20;4;14;18
96;03.02.2018;2018;02;21;Lauantai;10;6;16;2;10;12
96;03.02.2018;2018;02;22;Lauantai;10;5;15;1;2;3
96;03.02.2018;2018;02;23;Lauantai;5;4;9;1;3;4
96;04.02.2018;2018;02;00;Sunnuntai;6;2;8;1;1;2
96;04.02.2018;2018;02;01;Sunnuntai;1;0;1;0;1;1
96;04.02.2018;2018;02;02;Sunnuntai;1;1;2;0;0;0
96;04.02.2018;2018;02;03;Sunnuntai;8;0;8;0;2;2
96;04.02.2018;2018;02;04;Sunnuntai;0;1;1;0;1;1
96;04.02.2018;2018;02;05;Sunnuntai;2;1;3;0;0;0
96;04.02.2018;2018;02;06;Sunnuntai;10;2;12;3;0;3
96;04.02.2018;2018;02;07;Sunnuntai;2;1;3;1;7;8
96;04.02.2018;2018;02;08;Sunnuntai;3;4;7;4;4;8
96;04.02.2018;2018;02;09;Sunnuntai;1;2;3;5;5;10
96;04.02.2018;2018;02;10;Sunnuntai;8;9;17;6;9;15
96;04.02.2018;2018;02;11;Sunnuntai;4;7;11;8;9;17
96;04.02.2018;2018;02;12;Sunnuntai;16;8;24;11;21;32
96;04.02.2018;2018;02;13;Sunnuntai;19;6;25;21;14;35
96;04.02.2018;2018;02;14;Sunnuntai;15;8;23;15;15;30
96;04.02.2018;2018;02;15;Sunnuntai;13;12;25;14;16;30
96;04.02.2018;2018;02;16;Sunnuntai;13;8;21;19;7;26
96;04.02.2018;2018;02;17;Sunnuntai;15;7;22;7;7;14
96;04.02.2018;2018;02;18;Sunnuntai;10;9;19;9;19;28
96;04.02.2018;2018;02;19;Sunnuntai;5;10;15;11;16;27
96;04.02.2018;2018;02;20;Sunnuntai;10;7;17;4;9;13
96;04.02.2018;2018;02;21;Sunnuntai;11;5;16;7;16;23
96;04.02.2018;2018;02;22;Sunnuntai;1;2;3;3;5;8
96;04.02.2018;2018;02;23;Sunnuntai;2;1;3;1;0;1
96;05.02.2018;2018;02;00;Maanantai;3;0;3;0;0;0
96;05.02.2018;2018;02;01;Maanantai;1;0;1;0;0;0
96;05.02.2018;2018;02;02;Maanantai;3;0;3;0;0;0
96;05.02.2018;2018;02;03;Maanantai;2;2;4;0;0;0
96;05.02.2018;2018;02;04;Maanantai;1;0;1;1;0;1
96;05.02.2018;2018;02;05;Maanantai;4;0;4;1;1;2
96;05.02.2018;2018;02;06;Maanantai;33;11;44;15;7;22
96;05.02.2018;2018;02;07;Maanantai;59;26;85;41;14;55
96;05.02.2018;2018;02;08;Maanantai;94;34;128;30;34;64
96;05.02.2018;2018;02;09;Maanantai;36;7;43;22;19;41
96;05.02.2018;2018;02;10;Maanantai;35;13;48;15;16;31
96;05.02.2018;2018;02;11;Maanantai;21;15;36;12;22;34
96;05.02.2018;2018;02;12;Maanantai;28;19;47;20;31;51
96;05.02.2018;2018;02;13;Maanantai;29;28;57;18;33;51
96;05.02.2018;2018;02;14;Maanantai;20;32;52;12;45;57
96;05.02.2018;2018;02;15;Maanantai;37;101;138;9;83;92
96;05.02.2018;2018;02;16;Maanantai;31;54;85;10;69;79
96;05.02.2018;2018;02;17;Maanantai;27;25;52;7;29;36
96;05.02.2018;2018;02;18;Maanantai;22;21;43;10;15;25
96;05.02.2018;2018;02;19;Maanantai;16;9;25;2;23;25
96;05.02.2018;2018;02;20;Maanantai;24;4;28;8;13;21
96;05.02.2018;2018;02;21;Maanantai;8;11;19;5;12;17
96;05.02.2018;2018;02;22;Maanantai;3;7;10;0;3;3
96;05.02.2018;2018;02;23;Maanantai;2;1;3;1;1;2
96;06.02.2018;2018;02;00;Tiistai;0;0;0;0;0;0
96;06.02.2018;2018;02;01;Tiistai;0;0;0;0;0;0
96;06.02.2018;2018;02;02;Tiistai;1;0;1;0;0;0
96;06.02.2018;2018;02;03;Tiistai;0;0;0;0;0;0
96;06.02.2018;2018;02;04;Tiistai;2;0;2;0;1;1
96;06.02.2018;2018;02;05;Tiistai;1;3;4;1;1;2
96;06.02.2018;2018;02;06;Tiistai;28;4;32;22;11;33
96;06.02.2018;2018;02;07;Tiistai;69;31;100;45;36;81
96;06.02.2018;2018;02;08;Tiistai;86;28;114;21;30;51
96;06.02.2018;2018;02;09;Tiistai;59;25;84;32;30;62
96;06.02.2018;2018;02;10;Tiistai;38;20;58;23;16;39
96;06.02.2018;2018;02;11;Tiistai;37;14;51;12;41;53
96;06.02.2018;2018;02;12;Tiistai;50;22;72;18;36;54
96;06.02.2018;2018;02;13;Tiistai;21;32;53;10;33;43
96;06.02.2018;2018;02;14;Tiistai;28;45;73;17;39;56
96;06.02.2018;2018;02;15;Tiistai;35;111;146;8;88;96
96;06.02.2018;2018;02;16;Tiistai;35;101;136;16;80;96
96;06.02.2018;2018;02;17;Tiistai;28;28;56;20;34;54
96;06.02.2018;2018;02;18;Tiistai;26;29;55;15;20;35
96;06.02.2018;2018;02;19;Tiistai;33;18;51;12;10;22
96;06.02.2018;2018;02;20;Tiistai;29;21;50;12;11;23
96;06.02.2018;2018;02;21;Tiistai;31;22;53;7;10;17
96;06.02.2018;2018;02;22;Tiistai;11;7;18;3;2;5
96;06.02.2018;2018;02;23;Tiistai;5;4;9;0;2;2
96;07.02.2018;2018;02;00;Keskiviikko;3;3;6;1;0;1
96;07.02.2018;2018;02;01;Keskiviikko;0;0;0;1;2;3
96;07.02.2018;2018;02;02;Keskiviikko;1;0;1;1;0;1
96;07.02.2018;2018;02;03;Keskiviikko;0;0;0;0;0;0
96;07.02.2018;2018;02;04;Keskiviikko;2;1;3;1;1;2
96;07.02.2018;2018;02;05;Keskiviikko;3;2;5;3;5;8
96;07.02.2018;2018;02;06;Keskiviikko;40;11;51;15;2;17
96;07.02.2018;2018;02;07;Keskiviikko;82;52;134;42;24;66
96;07.02.2018;2018;02;08;Keskiviikko;110;42;152;21;21;42
96;07.02.2018;2018;02;09;Keskiviikko;57;25;82;18;26;44
96;07.02.2018;2018;02;10;Keskiviikko;34;26;60;10;20;30
96;07.02.2018;2018;02;11;Keskiviikko;38;22;60;26;16;42
96;07.02.2018;2018;02;12;Keskiviikko;37;24;61;20;33;53
96;07.02.2018;2018;02;13;Keskiviikko;33;24;57;15;26;41
96;07.02.2018;2018;02;14;Keskiviikko;29;63;92;11;64;75
96;07.02.2018;2018;02;15;Keskiviikko;42;74;116;17;72;89
96;07.02.2018;2018;02;16;Keskiviikko;37;116;153;23;63;86
96;07.02.2018;2018;02;17;Keskiviikko;42;32;74;25;33;58
96;07.02.2018;2018;02;18;Keskiviikko;41;20;61;19;18;37
96;07.02.2018;2018;02;19;Keskiviikko;21;17;38;12;23;35
96;07.02.2018;2018;02;20;Keskiviikko;27;20;47;11;22;33
96;07.02.2018;2018;02;21;Keskiviikko;13;27;40;6;14;20
96;07.02.2018;2018;02;22;Keskiviikko;4;11;15;0;5;5
96;07.02.2018;2018;02;23;Keskiviikko;1;1;2;2;1;3
96;08.02.2018;2018;02;00;Torstai;4;0;4;1;1;2
96;08.02.2018;2018;02;01;Torstai;5;0;5;1;0;1
96;08.02.2018;2018;02;02;Torstai;2;1;3;1;0;1
96;08.02.2018;2018;02;03;Torstai;3;0;3;0;0;0
96;08.02.2018;2018;02;04;Torstai;2;0;2;0;1;1
96;08.02.2018;2018;02;05;Torstai;3;5;8;0;1;1
96;08.02.2018;2018;02;06;Torstai;30;13;43;12;4;16
96;08.02.2018;2018;02;07;Torstai;78;55;133;42;10;52
96;08.02.2018;2018;02;08;Torstai;97;60;157;24;37;61
96;08.02.2018;2018;02;09;Torstai;95;27;122;24;16;40
96;08.02.2018;2018;02;10;Torstai;44;37;81;13;22;35
96;08.02.2018;2018;02;11;Torstai;32;37;69;21;17;38
96;08.02.2018;2018;02;12;Torstai;43;53;96;17;14;31
96;08.02.2018;2018;02;13;Torstai;44;39;83;17;25;42
96;08.02.2018;2018;02;14;Torstai;42;68;110;12;35;47
96;08.02.2018;2018;02;15;Torstai;41;111;152;10;54;64
96;08.02.2018;2018;02;16;Torstai;54;103;157;12;50;62
96;08.02.2018;2018;02;17;Torstai;43;30;73;13;34;47
96;08.02.2018;2018;02;18;Torstai;31;26;57;15;18;33
96;08.02.2018;2018;02;19;Torstai;33;20;53;10;9;19
96;08.02.2018;2018;02;20;Torstai;23;15;38;24;23;47
96;08.02.2018;2018;02;21;Torstai;17;31;48;6;13;19
96;08.02.2018;2018;02;22;Torstai;6;5;11;1;2;3
96;08.02.2018;2018;02;23;Torstai;7;2;9;2;2;4
96;09.02.2018;2018;02;00;Perjantai;1;0;1;1;1;2
96;09.02.2018;2018;02;01;Perjantai;7;0;7;2;0;2
96;09.02.2018;2018;02;02;Perjantai;5;2;7;3;0;3
96;09.02.2018;2018;02;03;Perjantai;4;0;4;2;0;2
96;09.02.2018;2018;02;04;Perjantai;4;2;6;0;1;1
96;09.02.2018;2018;02;05;Perjantai;5;5;10;0;1;1
96;09.02.2018;2018;02;06;Perjantai;32;13;45;10;1;11
96;09.02.2018;2018;02;07;Perjantai;75;50;125;31;14;45
96;09.02.2018;2018;02;08;Perjantai;85;57;142;17;13;30
96;09.02.2018;2018;02;09;Perjantai;39;33;72;14;21;35
96;09.02.2018;2018;02;10;Perjantai;42;46;88;10;20;30
96;09.02.2018;2018;02;11;Perjantai;35;47;82;12;28;40
96;09.02.2018;2018;02;12;Perjantai;59;47;106;19;20;39
96;09.02.2018;2018;02;13;Perjantai;40;45;85;15;17;32
96;09.02.2018;2018;02;14;Perjantai;38;80;118;12;27;39
96;09.02.2018;2018;02;15;Perjantai;42;93;135;10;60;70
96;09.02.2018;2018;02;16;Perjantai;48;60;108;10;28;38
96;09.02.2018;2018;02;17;Perjantai;25;33;58;13;22;35
96;09.02.2018;2018;02;18;Perjantai;25;34;59;8;19;27
96;09.02.2018;2018;02;19;Perjantai;19;15;34;4;7;11
96;09.02.2018;2018;02;20;Perjantai;17;10;27;9;9;18
96;09.02.2018;2018;02;21;Perjantai;21;21;42;12;11;23
96;09.02.2018;2018;02;22;Perjantai;5;14;19;0;5;5
96;09.02.2018;2018;02;23;Perjantai;9;1;10;1;1;2
96;10.02.2018;2018;02;00;Lauantai;4;1;5;0;1;1
96;10.02.2018;2018;02;01;Lauantai;5;2;7;0;1;1
96;10.02.2018;2018;02;02;Lauantai;7;1;8;1;1;2
96;10.02.2018;2018;02;03;Lauantai;6;0;6;0;0;0
96;10.02.2018;2018;02;04;Lauantai;4;1;5;2;0;2
96;10.02.2018;2018;02;05;Lauantai;3;1;4;1;0;1
96;10.02.2018;2018;02;06;Lauantai;9;1;10;5;3;8
96;10.02.2018;2018;02;07;Lauantai;2;6;8;1;6;7
96;10.02.2018;2018;02;08;Lauantai;7;8;15;10;6;16
96;10.02.2018;2018;02;09;Lauantai;5;15;20;6;4;10
96;10.02.2018;2018;02;10;Lauantai;3;16;19;9;9;18
96;10.02.2018;2018;02;11;Lauantai;10;15;25;13;8;21
96;10.02.2018;2018;02;12;Lauantai;28;13;41;10;20;30
96;10.02.2018;2018;02;13;Lauantai;20;11;31;19;20;39
96;10.02.2018;2018;02;14;Lauantai;16;25;41;21;26;47
96;10.02.2018;2018;02;15;Lauantai;20;11;31;17;25;42
96;10.02.2018;2018;02;16;Lauantai;24;12;36;9;12;21
96;10.02.2018;2018;02;17;Lauantai;25;9;34;6;12;18
96;10.02.2018;2018;02;18;Lauantai;17;12;29;14;9;23
96;10.02.2018;2018;02;19;Lauantai;12;9;21;9;5;14
96;10.02.2018;2018;02;20;Lauantai;12;16;28;6;14;20
96;10.02.2018;2018;02;21;Lauantai;9;14;23;2;11;13
96;10.02.2018;2018;02;22;Lauantai;2;3;5;6;1;7
96;10.02.2018;2018;02;23;Lauantai;8;3;11;0;2;2
96;11.02.2018;2018;02;00;Sunnuntai;4;1;5;0;2;2
96;11.02.2018;2018;02;01;Sunnuntai;0;0;0;0;0;0
96;11.02.2018;2018;02;02;Sunnuntai;1;0;1;1;0;1
96;11.02.2018;2018;02;03;Sunnuntai;3;0;3;0;0;0
96;11.02.2018;2018;02;04;Sunnuntai;2;0;2;2;0;2
96;11.02.2018;2018;02;05;Sunnuntai;0;1;1;1;1;2
96;11.02.2018;2018;02;06;Sunnuntai;12;1;13;4;0;4
96;11.02.2018;2018;02;07;Sunnuntai;1;8;9;3;6;9
96;11.02.2018;2018;02;08;Sunnuntai;2;4;6;2;3;5
96;11.02.2018;2018;02;09;Sunnuntai;6;4;10;2;2;4
96;11.02.2018;2018;02;10;Sunnuntai;6;4;10;5;3;8
96;11.02.2018;2018;02;11;Sunnuntai;13;6;19;9;17;26
96;11.02.2018;2018;02;12;Sunnuntai;14;8;22;9;15;24
96;11.02.2018;2018;02;13;Sunnuntai;19;12;31;14;17;31
96;11.02.2018;2018;02;14;Sunnuntai;21;12;33;15;13;28
96;11.02.2018;2018;02;15;Sunnuntai;16;17;33;9;25;34
96;11.02.2018;2018;02;16;Sunnuntai;14;11;25;25;16;41
96;11.02.2018;2018;02;17;Sunnuntai;24;13;37;10;18;28
96;11.02.2018;2018;02;18;Sunnuntai;21;11;32;20;21;41
96;11.02.2018;2018;02;19;Sunnuntai;5;8;13;7;16;23
96;11.02.2018;2018;02;20;Sunnuntai;18;15;33;9;12;21
96;11.02.2018;2018;02;21;Sunnuntai;7;12;19;3;11;14
96;11.02.2018;2018;02;22;Sunnuntai;1;1;2;0;4;4
96;11.02.2018;2018;02;23;Sunnuntai;0;1;1;2;0;2
96;12.02.2018;2018;02;00;Maanantai;3;0;3;0;0;0
96;12.02.2018;2018;02;01;Maanantai;3;0;3;1;0;1
96;12.02.2018;2018;02;02;Maanantai;0;0;0;0;0;0
96;12.02.2018;2018;02;03;Maanantai;0;0;0;0;0;0
96;12.02.2018;2018;02;04;Maanantai;1;0;1;0;0;0
96;12.02.2018;2018;02;05;Maanantai;4;6;10;2;0;2
96;12.02.2018;2018;02;06;Maanantai;39;12;51;13;10;23
96;12.02.2018;2018;02;07;Maanantai;75;42;117;41;39;80
96;12.02.2018;2018;02;08;Maanantai;102;33;135;23;41;64
96;12.02.2018;2018;02;09;Maanantai;67;16;83;37;23;60
96;12.02.2018;2018;02;10;Maanantai;52;22;74;12;23;35
96;12.02.2018;2018;02;11;Maanantai;51;18;69;14;15;29
96;12.02.2018;2018;02;12;Maanantai;54;37;91;7;24;31
96;12.02.2018;2018;02;13;Maanantai;48;47;95;12;37;49
96;12.02.2018;2018;02;14;Maanantai;31;53;84;17;44;61
96;12.02.2018;2018;02;15;Maanantai;61;82;143;10;67;77
96;12.02.2018;2018;02;16;Maanantai;64;120;184;15;90;105
96;12.02.2018;2018;02;17;Maanantai;40;34;74;17;41;58
96;12.02.2018;2018;02;18;Maanantai;25;28;53;11;28;39
96;12.02.2018;2018;02;19;Maanantai;35;17;52;13;29;42
96;12.02.2018;2018;02;20;Maanantai;29;12;41;11;23;34
96;12.02.2018;2018;02;21;Maanantai;18;16;34;8;12;20
96;12.02.2018;2018;02;22;Maanantai;3;12;15;0;6;6
96;12.02.2018;2018;02;23;Maanantai;6;0;6;0;0;0
96;13.02.2018;2018;02;00;Tiistai;2;0;2;0;0;0
96;13.02.2018;2018;02;01;Tiistai;0;1;1;2;0;2
96;13.02.2018;2018;02;02;Tiistai;1;0;1;0;0;0
96;13.02.2018;2018;02;03;Tiistai;1;0;1;0;0;0
96;13.02.2018;2018;02;04;Tiistai;3;0;3;0;0;0
96;13.02.2018;2018;02;05;Tiistai;5;8;13;1;1;2
96;13.02.2018;2018;02;06;Tiistai;42;11;53;16;7;23
96;13.02.2018;2018;02;07;Tiistai;80;63;143;47;24;71
96;13.02.2018;2018;02;08;Tiistai;83;64;147;28;18;46
96;13.02.2018;2018;02;09;Tiistai;83;24;107;23;20;43
96;13.02.2018;2018;02;10;Tiistai;36;30;66;18;17;35
96;13.02.2018;2018;02;11;Tiistai;56;19;75;19;21;40
96;13.02.2018;2018;02;12;Tiistai;61;43;104;18;26;44
96;13.02.2018;2018;02;13;Tiistai;43;29;72;13;46;59
96;13.02.2018;2018;02;14;Tiistai;34;51;85;6;49;55
96;13.02.2018;2018;02;15;Tiistai;43;119;162;15;93;108
96;13.02.2018;2018;02;16;Tiistai;70;104;174;14;69;83
96;13.02.2018;2018;02;17;Tiistai;44;34;78;17;40;57
96;13.02.2018;2018;02;18;Tiistai;36;21;57;14;24;38
96;13.02.2018;2018;02;19;Tiistai;24;17;41;19;31;50
96;13.02.2018;2018;02;20;Tiistai;41;14;55;9;9;18
96;13.02.2018;2018;02;21;Tiistai;17;14;31;5;19;24
96;13.02.2018;2018;02;22;Tiistai;7;5;12;1;3;4
96;13.02.2018;2018;02;23;Tiistai;1;3;4;0;2;2
96;14.02.2018;2018;02;00;Keskiviikko;6;0;6;1;0;1
96;14.02.2018;2018;02;01;Keskiviikko;0;0;0;3;0;3
96;14.02.2018;2018;02;02;Keskiviikko;1;0;1;1;0;1
96;14.02.2018;2018;02;03;Keskiviikko;0;0;0;0;0;0
96;14.02.2018;2018;02;04;Keskiviikko;3;0;3;2;0;2
96;14.02.2018;2018;02;05;Keskiviikko;5;0;5;8;0;8
96;14.02.2018;2018;02;06;Keskiviikko;51;0;51;17;0;17
96;14.02.2018;2018;02;07;Keskiviikko;134;0;134;66;0;66
96;14.02.2018;2018;02;08;Keskiviikko;152;0;152;42;0;42
96;14.02.2018;2018;02;09;Keskiviikko;82;0;82;44;0;44
96;14.02.2018;2018;02;10;Keskiviikko;60;0;60;30;0;30
96;14.02.2018;2018;02;11;Keskiviikko;60;0;60;42;0;42
96;14.02.2018;2018;02;12;Keskiviikko;61;0;61;53;0;53
96;14.02.2018;2018;02;13;Keskiviikko;57;0;57;41;0;41
96;14.02.2018;2018;02;14;Keskiviikko;92;0;92;75;0;75
96;14.02.2018;2018;02;15;Keskiviikko;116;0;116;89;0;89
96;14.02.2018;2018;02;16;Keskiviikko;153;0;153;86;0;86
96;14.02.2018;2018;02;17;Keskiviikko;74;0;74;58;0;58
96;14.02.2018;2018;02;18;Keskiviikko;61;0;61;37;0;37
96;14.02.2018;2018;02;19;Keskiviikko;38;0;38;35;0;35
96;14.02.2018;2018;02;20;Keskiviikko;47;0;47;33;0;33
96;14.02.2018;2018;02;21;Keskiviikko;40;0;40;20;0;20
96;14.02.2018;2018;02;22;Keskiviikko;15;0;15;5;0;5
96;14.02.2018;2018;02;23;Keskiviikko;2;0;2;3;0;3
96;15.02.2018;2018;02;00;Torstai;4;0;4;2;0;2
96;15.02.2018;2018;02;01;Torstai;5;0;5;1;0;1
96;15.02.2018;2018;02;02;Torstai;3;0;3;1;0;1
96;15.02.2018;2018;02;03;Torstai;3;0;3;0;0;0
96;15.02.2018;2018;02;04;Torstai;2;0;2;1;0;1
96;15.02.2018;2018;02;05;Torstai;8;0;8;1;0;1
96;15.02.2018;2018;02;06;Torstai;43;0;43;16;0;16
96;15.02.2018;2018;02;07;Torstai;133;0;133;52;0;52
96;15.02.2018;2018;02;08;Torstai;157;0;157;61;0;61
96;15.02.2018;2018;02;09;Torstai;122;0;122;40;0;40
96;15.02.2018;2018;02;10;Torstai;81;0;81;35;0;35
96;15.02.2018;2018;02;11;Torstai;69;0;69;38;0;38
96;15.02.2018;2018;02;12;Torstai;96;0;96;31;0;31
96;15.02.2018;2018;02;13;Torstai;83;0;83;42;0;42
96;15.02.2018;2018;02;14;Torstai;110;0;110;47;0;47
96;15.02.2018;2018;02;15;Torstai;152;0;152;64;0;64
96;15.02.2018;2018;02;16;Torstai;157;0;157;62;0;62
96;15.02.2018;2018;02;17;Torstai;73;0;73;47;0;47
96;15.02.2018;2018;02;18;Torstai;57;0;57;33;0;33
96;15.02.2018;2018;02;19;Torstai;53;0;53;19;0;19
96;15.02.2018;2018;02;20;Torstai;38;0;38;47;0;47
96;15.02.2018;2018;02;21;Torstai;48;0;48;19;0;19
96;15.02.2018;2018;02;22;Torstai;11;0;11;3;0;3
96;15.02.2018;2018;02;23;Torstai;9;0;9;4;0;4
96;16.02.2018;2018;02;00;Perjantai;2;0;2;1;1;2
96;16.02.2018;2018;02;01;Perjantai;1;0;1;0;0;0
96;16.02.2018;2018;02;02;Perjantai;1;0;1;0;0;0
96;16.02.2018;2018;02;03;Perjantai;0;0;0;2;0;2
96;16.02.2018;2018;02;04;Perjantai;2;0;2;0;1;1
96;16.02.2018;2018;02;05;Perjantai;0;4;4;0;2;2
96;16.02.2018;2018;02;06;Perjantai;35;12;47;9;3;12
96;16.02.2018;2018;02;07;Perjantai;84;22;106;39;39;78
96;16.02.2018;2018;02;08;Perjantai;72;23;95;17;45;62
96;16.02.2018;2018;02;09;Perjantai;56;19;75;12;41;53
96;16.02.2018;2018;02;10;Perjantai;34;18;52;10;19;29
96;16.02.2018;2018;02;11;Perjantai;41;40;81;7;34;41
96;16.02.2018;2018;02;12;Perjantai;38;31;69;15;40;55
96;16.02.2018;2018;02;13;Perjantai;45;51;96;15;67;82
96;16.02.2018;2018;02;14;Perjantai;39;93;132;12;126;138
96;16.02.2018;2018;02;15;Perjantai;46;56;102;17;81;98
96;16.02.2018;2018;02;16;Perjantai;55;21;76;104;45;149
96;16.02.2018;2018;02;17;Perjantai;37;27;64;17;24;41
96;16.02.2018;2018;02;18;Perjantai;28;19;47;8;11;19
96;16.02.2018;2018;02;19;Perjantai;19;15;34;4;10;14
96;16.02.2018;2018;02;20;Perjantai;19;10;29;7;7;14
96;16.02.2018;2018;02;21;Perjantai;19;7;26;1;21;22
96;16.02.2018;2018;02;22;Perjantai;5;2;7;2;7;9
96;16.02.2018;2018;02;23;Perjantai;8;3;11;2;2;4
96;17.02.2018;2018;02;00;Lauantai;5;4;9;3;0;3
96;17.02.2018;2018;02;01;Lauantai;1;4;5;1;1;2
96;17.02.2018;2018;02;02;Lauantai;1;2;3;2;0;2
96;17.02.2018;2018;02;03;Lauantai;1;0;1;1;0;1
96;17.02.2018;2018;02;04;Lauantai;3;0;3;1;0;1
96;17.02.2018;2018;02;05;Lauantai;1;0;1;0;0;0
96;17.02.2018;2018;02;06;Lauantai;11;1;12;5;3;8
96;17.02.2018;2018;02;07;Lauantai;5;5;10;1;6;7
96;17.02.2018;2018;02;08;Lauantai;7;4;11;6;9;15
96;17.02.2018;2018;02;09;Lauantai;7;13;20;5;12;17
96;17.02.2018;2018;02;10;Lauantai;5;7;12;3;7;10
96;17.02.2018;2018;02;11;Lauantai;19;8;27;8;27;35
96;17.02.2018;2018;02;12;Lauantai;21;6;27;14;30;44
96;17.02.2018;2018;02;13;Lauantai;29;11;40;8;48;56
96;17.02.2018;2018;02;14;Lauantai;25;13;38;19;41;60
96;17.02.2018;2018;02;15;Lauantai;25;14;39;10;29;39
96;17.02.2018;2018;02;16;Lauantai;30;6;36;11;22;33
96;17.02.2018;2018;02;17;Lauantai;17;8;25;7;12;19
96;17.02.2018;2018;02;18;Lauantai;18;8;26;10;13;23
96;17.02.2018;2018;02;19;Lauantai;15;2;17;13;8;21
96;17.02.2018;2018;02;20;Lauantai;16;8;24;5;19;24
96;17.02.2018;2018;02;21;Lauantai;9;2;11;2;14;16
96;17.02.2018;2018;02;22;Lauantai;3;3;6;1;4;5
96;17.02.2018;2018;02;23;Lauantai;8;5;13;0;2;2
96;18.02.2018;2018;02;00;Sunnuntai;4;2;6;2;1;3
96;18.02.2018;2018;02;01;Sunnuntai;2;1;3;2;0;2
96;18.02.2018;2018;02;02;Sunnuntai;1;1;2;2;2;4
96;18.02.2018;2018;02;03;Sunnuntai;5;0;5;4;0;4
96;18.02.2018;2018;02;04;Sunnuntai;0;0;0;0;0;0
96;18.02.2018;2018;02;05;Sunnuntai;2;0;2;0;0;0
96;18.02.2018;2018;02;06;Sunnuntai;11;0;11;4;2;6
96;18.02.2018;2018;02;07;Sunnuntai;2;5;7;2;4;6
96;18.02.2018;2018;02;08;Sunnuntai;0;4;4;1;2;3
96;18.02.2018;2018;02;09;Sunnuntai;3;4;7;2;6;8
96;18.02.2018;2018;02;10;Sunnuntai;6;5;11;7;6;13
96;18.02.2018;2018;02;11;Sunnuntai;7;5;12;7;18;25
96;18.02.2018;2018;02;12;Sunnuntai;14;4;18;10;29;39
96;18.02.2018;2018;02;13;Sunnuntai;28;3;31;14;16;30
96;18.02.2018;2018;02;14;Sunnuntai;16;7;23;12;22;34
96;18.02.2018;2018;02;15;Sunnuntai;22;5;27;10;21;31
96;18.02.2018;2018;02;16;Sunnuntai;17;7;24;25;11;36
96;18.02.2018;2018;02;17;Sunnuntai;16;5;21;10;18;28
96;18.02.2018;2018;02;18;Sunnuntai;18;7;25;22;32;54
96;18.02.2018;2018;02;19;Sunnuntai;12;2;14;8;10;18
96;18.02.2018;2018;02;20;Sunnuntai;15;5;20;9;27;36
96;18.02.2018;2018;02;21;Sunnuntai;13;3;16;5;17;22
96;18.02.2018;2018;02;22;Sunnuntai;1;2;3;1;4;5
96;18.02.2018;2018;02;23;Sunnuntai;0;0;0;1;0;1
96;19.02.2018;2018;02;00;Maanantai;5;1;6;1;0;1
96;19.02.2018;2018;02;01;Maanantai;1;1;2;0;0;0
96;19.02.2018;2018;02;02;Maanantai;2;0;2;0;0;0
96;19.02.2018;2018;02;03;Maanantai;0;0;0;0;0;0
96;19.02.2018;2018;02;04;Maanantai;2;0;2;0;0;0
96;19.02.2018;2018;02;05;Maanantai;7;1;8;0;1;1
96;19.02.2018;2018;02;06;Maanantai;41;6;47;17;4;21
96;19.02.2018;2018;02;07;Maanantai;94;24;118;36;22;58
96;19.02.2018;2018;02;08;Maanantai;70;26;96;33;24;57
96;19.02.2018;2018;02;09;Maanantai;81;18;99;22;19;41
96;19.02.2018;2018;02;10;Maanantai;29;14;43;16;25;41
96;19.02.2018;2018;02;11;Maanantai;20;20;40;18;32;50
96;19.02.2018;2018;02;12;Maanantai;33;18;51;23;51;74
96;19.02.2018;2018;02;13;Maanantai;36;22;58;18;54;72
96;19.02.2018;2018;02;14;Maanantai;28;37;65;14;69;83
96;19.02.2018;2018;02;15;Maanantai;40;69;109;20;83;103
96;19.02.2018;2018;02;16;Maanantai;38;67;105;19;85;104
96;19.02.2018;2018;02;17;Maanantai;28;18;46;20;35;55
96;19.02.2018;2018;02;18;Maanantai;27;15;42;10;25;35
96;19.02.2018;2018;02;19;Maanantai;19;12;31;12;21;33
96;19.02.2018;2018;02;20;Maanantai;22;15;37;10;13;23
96;19.02.2018;2018;02;21;Maanantai;15;10;25;5;10;15
96;19.02.2018;2018;02;22;Maanantai;3;6;9;0;9;9
96;19.02.2018;2018;02;23;Maanantai;2;0;2;0;0;0
96;20.02.2018;2018;02;00;Tiistai;2;0;2;0;0;0
96;20.02.2018;2018;02;01;Tiistai;0;0;0;0;0;0
96;20.02.2018;2018;02;02;Tiistai;2;0;2;0;0;0
96;20.02.2018;2018;02;03;Tiistai;0;0;0;0;0;0
96;20.02.2018;2018;02;04;Tiistai;2;1;3;0;0;0
96;20.02.2018;2018;02;05;Tiistai;1;0;1;0;1;1
96;20.02.2018;2018;02;06;Tiistai;40;7;47;17;7;24
96;20.02.2018;2018;02;07;Tiistai;65;21;86;48;20;68
96;20.02.2018;2018;02;08;Tiistai;72;24;96;28;28;56
96;20.02.2018;2018;02;09;Tiistai;48;12;60;29;25;54
96;20.02.2018;2018;02;10;Tiistai;31;8;39;8;30;38
96;20.02.2018;2018;02;11;Tiistai;40;14;54;22;25;47
96;20.02.2018;2018;02;12;Tiistai;47;13;60;14;44;58
96;20.02.2018;2018;02;13;Tiistai;29;12;41;14;51;65
96;20.02.2018;2018;02;14;Tiistai;29;32;61;11;61;72
96;20.02.2018;2018;02;15;Tiistai;36;76;112;14;85;99
96;20.02.2018;2018;02;16;Tiistai;33;58;91;17;92;109
96;20.02.2018;2018;02;17;Tiistai;34;24;58;4;38;42
96;20.02.2018;2018;02;18;Tiistai;28;7;35;9;18;27
96;20.02.2018;2018;02;19;Tiistai;25;11;36;15;10;25
96;20.02.2018;2018;02;20;Tiistai;20;8;28;12;10;22
96;20.02.2018;2018;02;21;Tiistai;9;14;23;5;12;17
96;20.02.2018;2018;02;22;Tiistai;5;9;14;0;12;12
96;20.02.2018;2018;02;23;Tiistai;5;0;5;0;0;0
96;21.02.2018;2018;02;00;Keskiviikko;1;0;1;0;1;1
96;21.02.2018;2018;02;01;Keskiviikko;1;0;1;0;0;0
96;21.02.2018;2018;02;02;Keskiviikko;1;0;1;0;1;1
96;21.02.2018;2018;02;03;Keskiviikko;0;0;0;0;0;0
96;21.02.2018;2018;02;04;Keskiviikko;2;0;2;0;0;0
96;21.02.2018;2018;02;05;Keskiviikko;2;1;3;0;1;1
96;21.02.2018;2018;02;06;Keskiviikko;34;8;42;21;7;28
96;21.02.2018;2018;02;07;Keskiviikko;86;29;115;41;30;71
96;21.02.2018;2018;02;08;Keskiviikko;102;34;136;25;31;56
96;21.02.2018;2018;02;09;Keskiviikko;62;10;72;14;27;41
96;21.02.2018;2018;02;10;Keskiviikko;33;5;38;20;38;58
96;21.02.2018;2018;02;11;Keskiviikko;39;8;47;15;50;65
96;21.02.2018;2018;02;12;Keskiviikko;43;9;52;18;53;71
96;21.02.2018;2018;02;13;Keskiviikko;45;5;50;21;57;78
96;21.02.2018;2018;02;14;Keskiviikko;45;35;80;14;98;112
96;21.02.2018;2018;02;15;Keskiviikko;27;22;49;23;125;148
96;21.02.2018;2018;02;16;Keskiviikko;46;46;92;20;114;134
96;21.02.2018;2018;02;17;Keskiviikko;33;8;41;19;56;75
96;21.02.2018;2018;02;18;Keskiviikko;44;7;51;35;42;77
96;21.02.2018;2018;02;19;Keskiviikko;41;4;45;9;27;36
96;21.02.2018;2018;02;20;Keskiviikko;32;12;44;7;22;29
96;21.02.2018;2018;02;21;Keskiviikko;13;4;17;3;24;27
96;21.02.2018;2018;02;22;Keskiviikko;4;10;14;2;20;22
96;21.02.2018;2018;02;23;Keskiviikko;1;1;2;0;0;0
96;22.02.2018;2018;02;00;Torstai;2;0;2;0;0;0
96;22.02.2018;2018;02;01;Torstai;1;0;1;0;0;0
96;22.02.2018;2018;02;02;Torstai;2;0;2;0;0;0
96;22.02.2018;2018;02;03;Torstai;0;1;1;0;0;0
96;22.02.2018;2018;02;04;Torstai;4;0;4;0;1;1
96;22.02.2018;2018;02;05;Torstai;2;1;3;1;1;2
96;22.02.2018;2018;02;06;Torstai;38;5;43;16;9;25
96;22.02.2018;2018;02;07;Torstai;73;31;104;42;23;65
96;22.02.2018;2018;02;08;Torstai;80;35;115;17;35;52
96;22.02.2018;2018;02;09;Torstai;56;14;70;21;32;53
96;22.02.2018;2018;02;10;Torstai;46;22;68;16;26;42
96;22.02.2018;2018;02;11;Torstai;31;15;46;10;37;47
96;22.02.2018;2018;02;12;Torstai;47;21;68;24;45;69
96;22.02.2018;2018;02;13;Torstai;41;6;47;14;48;62
96;22.02.2018;2018;02;14;Torstai;45;25;70;15;78;93
96;22.02.2018;2018;02;15;Torstai;54;24;78;16;127;143
96;22.02.2018;2018;02;16;Torstai;76;43;119;19;96;115
96;22.02.2018;2018;02;17;Torstai;36;19;55;13;42;55
96;22.02.2018;2018;02;18;Torstai;33;13;46;22;24;46
96;22.02.2018;2018;02;19;Torstai;32;10;42;16;31;47
96;22.02.2018;2018;02;20;Torstai;21;11;32;4;12;16
96;22.02.2018;2018;02;21;Torstai;10;21;31;1;22;23
96;22.02.2018;2018;02;22;Torstai;3;10;13;2;5;7
96;22.02.2018;2018;02;23;Torstai;3;0;3;0;0;0
96;23.02.2018;2018;02;00;Perjantai;0;0;0;1;0;1
96;23.02.2018;2018;02;01;Perjantai;4;0;4;0;0;0
96;23.02.2018;2018;02;02;Perjantai;0;1;1;1;1;2
96;23.02.2018;2018;02;03;Perjantai;1;0;1;0;0;0
96;23.02.2018;2018;02;04;Perjantai;3;0;3;0;0;0
96;23.02.2018;2018;02;05;Perjantai;2;3;5;0;0;0
96;23.02.2018;2018;02;06;Perjantai;31;10;41;13;5;18
96;23.02.2018;2018;02;07;Perjantai;74;30;104;41;29;70
96;23.02.2018;2018;02;08;Perjantai;80;22;102;22;31;53
96;23.02.2018;2018;02;09;Perjantai;57;19;76;16;29;45
96;23.02.2018;2018;02;10;Perjantai;41;31;72;11;24;35
96;23.02.2018;2018;02;11;Perjantai;29;18;47;12;49;61
96;23.02.2018;2018;02;12;Perjantai;64;14;78;14;56;70
96;23.02.2018;2018;02;13;Perjantai;30;10;40;14;44;58
96;23.02.2018;2018;02;14;Perjantai;41;37;78;15;99;114
96;23.02.2018;2018;02;15;Perjantai;43;31;74;11;90;101
96;23.02.2018;2018;02;16;Perjantai;41;27;68;17;71;88
96;23.02.2018;2018;02;17;Perjantai;31;17;48;20;28;48
96;23.02.2018;2018;02;18;Perjantai;21;14;35;12;24;36
96;23.02.2018;2018;02;19;Perjantai;14;16;30;9;13;22
96;23.02.2018;2018;02;20;Perjantai;10;11;21;12;10;22
96;23.02.2018;2018;02;21;Perjantai;9;18;27;7;14;21
96;23.02.2018;2018;02;22;Perjantai;12;8;20;3;11;14
96;23.02.2018;2018;02;23;Perjantai;7;4;11;1;2;3
96;24.02.2018;2018;02;00;Lauantai;5;0;5;0;1;1
96;24.02.2018;2018;02;01;Lauantai;5;1;6;0;0;0
96;24.02.2018;2018;02;02;Lauantai;1;0;1;1;0;1
96;24.02.2018;2018;02;03;Lauantai;3;0;3;1;0;1
96;24.02.2018;2018;02;04;Lauantai;2;0;2;0;0;0
96;24.02.2018;2018;02;05;Lauantai;1;0;1;1;0;1
96;24.02.2018;2018;02;06;Lauantai;3;0;3;6;6;12
96;24.02.2018;2018;02;07;Lauantai;4;2;6;4;11;15
96;24.02.2018;2018;02;08;Lauantai;4;5;9;2;2;4
96;24.02.2018;2018;02;09;Lauantai;7;6;13;1;8;9
96;24.02.2018;2018;02;10;Lauantai;8;1;9;6;8;14
96;24.02.2018;2018;02;11;Lauantai;5;4;9;11;16;27
96;24.02.2018;2018;02;12;Lauantai;23;3;26;8;23;31
96;24.02.2018;2018;02;13;Lauantai;23;4;27;21;27;48
96;24.02.2018;2018;02;14;Lauantai;27;9;36;15;26;41
96;24.02.2018;2018;02;15;Lauantai;15;8;23;15;28;43
96;24.02.2018;2018;02;16;Lauantai;27;5;32;11;17;28
96;24.02.2018;2018;02;17;Lauantai;21;6;27;15;14;29
96;24.02.2018;2018;02;18;Lauantai;15;6;21;9;8;17
96;24.02.2018;2018;02;19;Lauantai;14;3;17;9;12;21
96;24.02.2018;2018;02;20;Lauantai;9;9;18;8;14;22
96;24.02.2018;2018;02;21;Lauantai;10;25;35;6;14;20
96;24.02.2018;2018;02;22;Lauantai;0;12;12;1;7;8
96;24.02.2018;2018;02;23;Lauantai;4;1;5;0;1;1
96;25.02.2018;2018;02;00;Sunnuntai;2;0;2;0;1;1
96;25.02.2018;2018;02;01;Sunnuntai;2;1;3;1;0;1
96;25.02.2018;2018;02;02;Sunnuntai;4;0;4;0;0;0
96;25.02.2018;2018;02;03;Sunnuntai;3;1;4;0;0;0
96;25.02.2018;2018;02;04;Sunnuntai;3;0;3;0;0;0
96;25.02.2018;2018;02;05;Sunnuntai;4;2;6;0;0;0
96;25.02.2018;2018;02;06;Sunnuntai;8;2;10;8;1;9
96;25.02.2018;2018;02;07;Sunnuntai;1;5;6;4;8;12
96;25.02.2018;2018;02;08;Sunnuntai;2;0;2;5;1;6
96;25.02.2018;2018;02;09;Sunnuntai;8;2;10;6;2;8
96;25.02.2018;2018;02;10;Sunnuntai;7;1;8;5;6;11
96;25.02.2018;2018;02;11;Sunnuntai;7;6;13;3;9;12
96;25.02.2018;2018;02;12;Sunnuntai;14;3;17;18;16;34
96;25.02.2018;2018;02;13;Sunnuntai;30;8;38;10;20;30
96;25.02.2018;2018;02;14;Sunnuntai;13;10;23;16;19;35
96;25.02.2018;2018;02;15;Sunnuntai;15;10;25;15;21;36
96;25.02.2018;2018;02;16;Sunnuntai;12;9;21;11;16;27
96;25.02.2018;2018;02;17;Sunnuntai;14;6;20;12;17;29
96;25.02.2018;2018;02;18;Sunnuntai;27;6;33;15;11;26
96;25.02.2018;2018;02;19;Sunnuntai;16;6;22;15;10;25
96;25.02.2018;2018;02;20;Sunnuntai;23;9;32;2;13;15
96;25.02.2018;2018;02;21;Sunnuntai;9;10;19;3;7;10
96;25.02.2018;2018;02;22;Sunnuntai;3;2;5;0;5;5
96;25.02.2018;2018;02;23;Sunnuntai;0;0;0;1;0;1
96;26.02.2018;2018;02;00;Maanantai;0;1;1;0;0;0
96;26.02.2018;2018;02;01;Maanantai;0;2;2;0;2;2
96;26.02.2018;2018;02;02;Maanantai;2;0;2;0;0;0
96;26.02.2018;2018;02;03;Maanantai;0;0;0;0;0;0
96;26.02.2018;2018;02;04;Maanantai;1;0;1;1;0;1
96;26.02.2018;2018;02;05;Maanantai;5;3;8;0;4;4
96;26.02.2018;2018;02;06;Maanantai;39;10;49;15;9;24
96;26.02.2018;2018;02;07;Maanantai;70;36;106;47;41;88
96;26.02.2018;2018;02;08;Maanantai;87;52;139;19;29;48
96;26.02.2018;2018;02;09;Maanantai;71;18;89;26;33;59
96;26.02.2018;2018;02;10;Maanantai;47;14;61;21;29;50
96;26.02.2018;2018;02;11;Maanantai;37;12;49;17;40;57
96;26.02.2018;2018;02;12;Maanantai;42;20;62;17;47;64
96;26.02.2018;2018;02;13;Maanantai;35;13;48;10;49;59
96;26.02.2018;2018;02;14;Maanantai;44;32;76;13;77;90
96;26.02.2018;2018;02;15;Maanantai;50;48;98;20;109;129
96;26.02.2018;2018;02;16;Maanantai;54;72;126;11;110;121
96;26.02.2018;2018;02;17;Maanantai;48;29;77;10;46;56
96;26.02.2018;2018;02;18;Maanantai;37;27;64;13;19;32
96;26.02.2018;2018;02;19;Maanantai;30;11;41;12;18;30
96;26.02.2018;2018;02;20;Maanantai;26;9;35;12;15;27
96;26.02.2018;2018;02;21;Maanantai;17;6;23;7;17;24
96;26.02.2018;2018;02;22;Maanantai;8;6;14;0;5;5
96;26.02.2018;2018;02;23;Maanantai;2;2;4;0;0;0
96;27.02.2018;2018;02;00;Tiistai;0;1;1;0;0;0
96;27.02.2018;2018;02;01;Tiistai;1;0;1;0;0;0
96;27.02.2018;2018;02;02;Tiistai;1;0;1;0;0;0
96;27.02.2018;2018;02;03;Tiistai;0;0;0;0;0;0
96;27.02.2018;2018;02;04;Tiistai;0;0;0;0;1;1
96;27.02.2018;2018;02;05;Tiistai;6;3;9;1;0;1
96;27.02.2018;2018;02;06;Tiistai;46;8;54;16;8;24
96;27.02.2018;2018;02;07;Tiistai;94;21;115;44;43;87
96;27.02.2018;2018;02;08;Tiistai;92;26;118;23;33;56
96;27.02.2018;2018;02;09;Tiistai;59;18;77;9;31;40
96;27.02.2018;2018;02;10;Tiistai;33;13;46;7;35;42
96;27.02.2018;2018;02;11;Tiistai;52;5;57;28;41;69
96;27.02.2018;2018;02;12;Tiistai;41;25;66;22;49;71
96;27.02.2018;2018;02;13;Tiistai;32;9;41;10;40;50
96;27.02.2018;2018;02;14;Tiistai;30;17;47;7;64;71
96;27.02.2018;2018;02;15;Tiistai;33;67;100;15;118;133
96;27.02.2018;2018;02;16;Tiistai;56;62;118;12;85;97
96;27.02.2018;2018;02;17;Tiistai;41;16;57;13;51;64
96;27.02.2018;2018;02;18;Tiistai;25;21;46;10;28;38
96;27.02.2018;2018;02;19;Tiistai;25;12;37;10;10;20
96;27.02.2018;2018;02;20;Tiistai;43;11;54;21;8;29
96;27.02.2018;2018;02;21;Tiistai;11;27;38;2;22;24
96;27.02.2018;2018;02;22;Tiistai;12;11;23;0;6;6
96;27.02.2018;2018;02;23;Tiistai;6;1;7;0;0;0
96;28.02.2018;2018;02;00;Keskiviikko;1;0;1;0;1;1
96;28.02.2018;2018;02;01;Keskiviikko;1;0;1;0;0;0
96;28.02.2018;2018;02;02;Keskiviikko;0;0;0;0;0;0
96;28.02.2018;2018;02;03;Keskiviikko;0;0;0;0;0;0
96;28.02.2018;2018;02;04;Keskiviikko;0;0;0;0;1;1
96;28.02.2018;2018;02;05;Keskiviikko;3;2;5;3;1;4
96;28.02.2018;2018;02;06;Keskiviikko;40;4;44;13;9;22
96;28.02.2018;2018;02;07;Keskiviikko;68;14;82;43;27;70
96;28.02.2018;2018;02;08;Keskiviikko;62;16;78;15;31;46
96;28.02.2018;2018;02;09;Keskiviikko;50;12;62;11;23;34
96;28.02.2018;2018;02;10;Keskiviikko;29;15;44;13;23;36
96;28.02.2018;2018;02;11;Keskiviikko;42;15;57;13;35;48
96;28.02.2018;2018;02;12;Keskiviikko;32;11;43;26;34;60
96;28.02.2018;2018;02;13;Keskiviikko;28;16;44;13;55;68
96;28.02.2018;2018;02;14;Keskiviikko;31;19;50;13;77;90
96;28.02.2018;2018;02;15;Keskiviikko;37;46;83;18;108;126
96;28.02.2018;2018;02;16;Keskiviikko;44;46;90;14;111;125
96;28.02.2018;2018;02;17;Keskiviikko;30;11;41;17;42;59
96;28.02.2018;2018;02;18;Keskiviikko;43;16;59;33;51;84
96;28.02.2018;2018;02;19;Keskiviikko;39;14;53;21;16;37
96;28.02.2018;2018;02;20;Keskiviikko;20;8;28;6;20;26
96;28.02.2018;2018;02;21;Keskiviikko;13;14;27;10;22;32
96;28.02.2018;2018;02;22;Keskiviikko;6;15;21;2;13;15
96;28.02.2018;2018;02;23;Keskiviikko;0;2;2;0;0;0
96;01.03.2018;2018;03;00;Torstai;0;1;1;0;0;0
96;01.03.2018;2018;03;01;Torstai;1;0;1;0;0;0
96;01.03.2018;2018;03;02;Torstai;5;0;5;0;0;0
96;01.03.2018;2018;03;03;Torstai;3;0;3;0;0;0
96;01.03.2018;2018;03;04;Torstai;2;0;2;0;1;1
96;01.03.2018;2018;03;05;Torstai;7;0;7;1;2;3
96;01.03.2018;2018;03;06;Torstai;26;5;31;14;9;23
96;01.03.2018;2018;03;07;Torstai;68;15;83;42;36;78
96;01.03.2018;2018;03;08;Torstai;84;18;102;22;41;63
96;01.03.2018;2018;03;09;Torstai;69;11;80;21;32;53
96;01.03.2018;2018;03;10;Torstai;53;10;63;18;33;51
96;01.03.2018;2018;03;11;Torstai;40;11;51;17;29;46
96;01.03.2018;2018;03;12;Torstai;43;23;66;20;59;79
96;01.03.2018;2018;03;13;Torstai;46;19;65;17;50;67
96;01.03.2018;2018;03;14;Torstai;33;41;74;22;77;99
96;01.03.2018;2018;03;15;Torstai;41;52;93;15;104;119
96;01.03.2018;2018;03;16;Torstai;52;49;101;8;83;91
96;01.03.2018;2018;03;17;Torstai;39;18;57;17;47;64
96;01.03.2018;2018;03;18;Torstai;25;16;41;18;28;46
96;01.03.2018;2018;03;19;Torstai;25;12;37;10;23;33
96;01.03.2018;2018;03;20;Torstai;25;12;37;4;20;24
96;01.03.2018;2018;03;21;Torstai;24;22;46;8;15;23
96;01.03.2018;2018;03;22;Torstai;6;9;15;2;6;8
96;01.03.2018;2018;03;23;Torstai;6;2;8;1;0;1
96;02.03.2018;2018;03;00;Perjantai;2;1;3;2;0;2
96;02.03.2018;2018;03;01;Perjantai;4;0;4;1;1;2
96;02.03.2018;2018;03;02;Perjantai;3;0;3;1;0;1
96;02.03.2018;2018;03;03;Perjantai;3;0;3;2;0;2
96;02.03.2018;2018;03;04;Perjantai;0;1;1;0;1;1
96;02.03.2018;2018;03;05;Perjantai;3;2;5;2;4;6
96;02.03.2018;2018;03;06;Perjantai;38;6;44;19;9;28
96;02.03.2018;2018;03;07;Perjantai;75;13;88;40;42;82
96;02.03.2018;2018;03;08;Perjantai;61;27;88;18;39;57
96;02.03.2018;2018;03;09;Perjantai;45;22;67;18;22;40
96;02.03.2018;2018;03;10;Perjantai;30;35;65;13;36;49
96;02.03.2018;2018;03;11;Perjantai;44;22;66;10;33;43
96;02.03.2018;2018;03;12;Perjantai;62;18;80;25;45;70
96;02.03.2018;2018;03;13;Perjantai;42;46;88;13;38;51
96;02.03.2018;2018;03;14;Perjantai;46;78;124;12;48;60
96;02.03.2018;2018;03;15;Perjantai;44;78;122;11;43;54
96;02.03.2018;2018;03;16;Perjantai;59;64;123;13;31;44
96;02.03.2018;2018;03;17;Perjantai;32;26;58;16;11;27
96;02.03.2018;2018;03;18;Perjantai;29;16;45;15;6;21
96;02.03.2018;2018;03;19;Perjantai;14;12;26;7;8;15
96;02.03.2018;2018;03;20;Perjantai;20;6;26;3;4;7
96;02.03.2018;2018;03;21;Perjantai;9;23;32;6;10;16
96;02.03.2018;2018;03;22;Perjantai;7;18;25;2;7;9
96;02.03.2018;2018;03;23;Perjantai;11;2;13;2;3;5
96;03.03.2018;2018;03;00;Lauantai;7;1;8;2;4;6
96;03.03.2018;2018;03;01;Lauantai;4;0;4;1;1;2
96;03.03.2018;2018;03;02;Lauantai;1;2;3;0;0;0
96;03.03.2018;2018;03;03;Lauantai;1;0;1;0;0;0
96;03.03.2018;2018;03;04;Lauantai;2;0;2;2;1;3
96;03.03.2018;2018;03;05;Lauantai;0;0;0;0;3;3
96;03.03.2018;2018;03;06;Lauantai;17;4;21;5;1;6
96;03.03.2018;2018;03;07;Lauantai;2;9;11;4;6;10
96;03.03.2018;2018;03;08;Lauantai;2;10;12;5;7;12
96;03.03.2018;2018;03;09;Lauantai;9;10;19;3;7;10
96;03.03.2018;2018;03;10;Lauantai;6;19;25;9;19;28
96;03.03.2018;2018;03;11;Lauantai;13;19;32;14;31;45
96;03.03.2018;2018;03;12;Lauantai;23;18;41;23;39;62
96;03.03.2018;2018;03;13;Lauantai;25;19;44;17;32;49
96;03.03.2018;2018;03;14;Lauantai;23;24;47;27;32;59
96;03.03.2018;2018;03;15;Lauantai;37;17;54;18;23;41
96;03.03.2018;2018;03;16;Lauantai;14;8;22;18;21;39
96;03.03.2018;2018;03;17;Lauantai;13;5;18;9;18;27
96;03.03.2018;2018;03;18;Lauantai;20;9;29;25;13;38
96;03.03.2018;2018;03;19;Lauantai;24;8;32;14;9;23
96;03.03.2018;2018;03;20;Lauantai;14;15;29;5;18;23
96;03.03.2018;2018;03;21;Lauantai;9;18;27;3;12;15
96;03.03.2018;2018;03;22;Lauantai;7;6;13;0;2;2
96;03.03.2018;2018;03;23;Lauantai;1;1;2;2;0;2
96;04.03.2018;2018;03;00;Sunnuntai;1;4;5;0;0;0
96;04.03.2018;2018;03;01;Sunnuntai;4;4;8;1;2;3
96;04.03.2018;2018;03;02;Sunnuntai;2;0;2;1;0;1
96;04.03.2018;2018;03;03;Sunnuntai;6;0;6;0;0;0
96;04.03.2018;2018;03;04;Sunnuntai;4;1;5;0;1;1
96;04.03.2018;2018;03;05;Sunnuntai;1;1;2;0;0;0
96;04.03.2018;2018;03;06;Sunnuntai;21;2;23;7;0;7
96;04.03.2018;2018;03;07;Sunnuntai;1;2;3;4;4;8
96;04.03.2018;2018;03;08;Sunnuntai;7;4;11;1;3;4
96;04.03.2018;2018;03;09;Sunnuntai;0;5;5;7;8;15
96;04.03.2018;2018;03;10;Sunnuntai;4;5;9;11;12;23
96;04.03.2018;2018;03;11;Sunnuntai;10;10;20;13;15;28
96;04.03.2018;2018;03;12;Sunnuntai;15;15;30;8;17;25
96;04.03.2018;2018;03;13;Sunnuntai;29;8;37;12;26;38
96;04.03.2018;2018;03;14;Sunnuntai;20;13;33;10;19;29
96;04.03.2018;2018;03;15;Sunnuntai;8;19;27;13;24;37
96;04.03.2018;2018;03;16;Sunnuntai;21;5;26;20;10;30
96;04.03.2018;2018;03;17;Sunnuntai;24;7;31;10;13;23
96;04.03.2018;2018;03;18;Sunnuntai;12;16;28;12;8;20
96;04.03.2018;2018;03;19;Sunnuntai;11;13;24;5;15;20
96;04.03.2018;2018;03;20;Sunnuntai;12;6;18;10;14;24
96;04.03.2018;2018;03;21;Sunnuntai;10;9;19;5;6;11
96;04.03.2018;2018;03;22;Sunnuntai;2;4;6;0;2;2
96;04.03.2018;2018;03;23;Sunnuntai;1;0;1;3;3;6
96;05.03.2018;2018;03;00;Maanantai;1;0;1;0;0;0
96;05.03.2018;2018;03;01;Maanantai;0;1;1;0;0;0
96;05.03.2018;2018;03;02;Maanantai;2;0;2;0;0;0
96;05.03.2018;2018;03;03;Maanantai;1;1;2;0;0;0
96;05.03.2018;2018;03;04;Maanantai;2;0;2;0;1;1
96;05.03.2018;2018;03;05;Maanantai;5;4;9;0;1;1
96;05.03.2018;2018;03;06;Maanantai;29;10;39;14;4;18
96;05.03.2018;2018;03;07;Maanantai;65;26;91;36;16;52
96;05.03.2018;2018;03;08;Maanantai;17;25;42;6;10;16
96;05.03.2018;2018;03;09;Maanantai;8;16;24;5;13;18
96;05.03.2018;2018;03;10;Maanantai;20;10;30;4;15;19
96;05.03.2018;2018;03;11;Maanantai;25;10;35;5;21;26
96;05.03.2018;2018;03;12;Maanantai;26;14;40;13;28;41
96;05.03.2018;2018;03;13;Maanantai;27;11;38;17;22;39
96;05.03.2018;2018;03;14;Maanantai;21;20;41;14;17;31
96;05.03.2018;2018;03;15;Maanantai;29;54;83;11;70;81
96;05.03.2018;2018;03;16;Maanantai;63;46;109;14;45;59
96;05.03.2018;2018;03;17;Maanantai;31;14;45;9;23;32
96;05.03.2018;2018;03;18;Maanantai;19;14;33;10;15;25
96;05.03.2018;2018;03;19;Maanantai;13;13;26;6;13;19
96;05.03.2018;2018;03;20;Maanantai;21;7;28;9;10;19
96;05.03.2018;2018;03;21;Maanantai;13;21;34;7;5;12
96;05.03.2018;2018;03;22;Maanantai;5;5;10;3;5;8
96;05.03.2018;2018;03;23;Maanantai;1;1;2;1;0;1
96;06.03.2018;2018;03;00;Tiistai;0;1;1;2;0;2
96;06.03.2018;2018;03;01;Tiistai;2;0;2;2;0;2
96;06.03.2018;2018;03;02;Tiistai;2;0;2;0;0;0
96;06.03.2018;2018;03;03;Tiistai;1;1;2;1;0;1
96;06.03.2018;2018;03;04;Tiistai;1;0;1;0;1;1
96;06.03.2018;2018;03;05;Tiistai;4;4;8;0;0;0
96;06.03.2018;2018;03;06;Tiistai;47;14;61;19;5;24
96;06.03.2018;2018;03;07;Tiistai;50;27;77;31;20;51
96;06.03.2018;2018;03;08;Tiistai;26;25;51;8;18;26
96;06.03.2018;2018;03;09;Tiistai;13;16;29;12;18;30
96;06.03.2018;2018;03;10;Tiistai;18;8;26;8;13;21
96;06.03.2018;2018;03;11;Tiistai;25;9;34;8;25;33
96;06.03.2018;2018;03;12;Tiistai;27;10;37;17;18;35
96;06.03.2018;2018;03;13;Tiistai;30;11;41;17;21;38
96;06.03.2018;2018;03;14;Tiistai;31;26;57;7;27;34
96;06.03.2018;2018;03;15;Tiistai;40;62;102;8;53;61
96;06.03.2018;2018;03;16;Tiistai;38;38;76;19;50;69
96;06.03.2018;2018;03;17;Tiistai;21;21;42;10;19;29
96;06.03.2018;2018;03;18;Tiistai;19;7;26;9;8;17
96;06.03.2018;2018;03;19;Tiistai;23;10;33;6;17;23
96;06.03.2018;2018;03;20;Tiistai;16;3;19;5;12;17
96;06.03.2018;2018;03;21;Tiistai;10;14;24;5;11;16
96;06.03.2018;2018;03;22;Tiistai;7;5;12;3;12;15
96;06.03.2018;2018;03;23;Tiistai;0;2;2;1;0;1
96;07.03.2018;2018;03;00;Keskiviikko;1;0;1;1;0;1
96;07.03.2018;2018;03;01;Keskiviikko;1;0;1;1;1;2
96;07.03.2018;2018;03;02;Keskiviikko;4;2;6;0;0;0
96;07.03.2018;2018;03;03;Keskiviikko;2;0;2;0;0;0
96;07.03.2018;2018;03;04;Keskiviikko;2;0;2;0;0;0
96;07.03.2018;2018;03;05;Keskiviikko;4;4;8;0;2;2
96;07.03.2018;2018;03;06;Keskiviikko;41;14;55;15;10;25
96;07.03.2018;2018;03;07;Keskiviikko;52;33;85;34;15;49
96;07.03.2018;2018;03;08;Keskiviikko;24;20;44;7;17;24
96;07.03.2018;2018;03;09;Keskiviikko;9;21;30;8;14;22
96;07.03.2018;2018;03;10;Keskiviikko;21;11;32;5;22;27
96;07.03.2018;2018;03;11;Keskiviikko;12;15;27;8;22;30
96;07.03.2018;2018;03;12;Keskiviikko;34;9;43;12;24;36
96;07.03.2018;2018;03;13;Keskiviikko;29;18;47;10;30;40
96;07.03.2018;2018;03;14;Keskiviikko;21;23;44;11;25;36
96;07.03.2018;2018;03;15;Keskiviikko;27;53;80;12;39;51
96;07.03.2018;2018;03;16;Keskiviikko;27;32;59;9;40;49
96;07.03.2018;2018;03;17;Keskiviikko;24;21;45;7;20;27
96;07.03.2018;2018;03;18;Keskiviikko;29;7;36;10;20;30
96;07.03.2018;2018;03;19;Keskiviikko;29;5;34;8;8;16
96;07.03.2018;2018;03;20;Keskiviikko;16;14;30;7;16;23
96;07.03.2018;2018;03;21;Keskiviikko;10;13;23;7;16;23
96;07.03.2018;2018;03;22;Keskiviikko;4;5;9;1;5;6
96;07.03.2018;2018;03;23;Keskiviikko;1;2;3;1;1;2
96;08.03.2018;2018;03;00;Torstai;1;2;3;1;0;1
96;08.03.2018;2018;03;01;Torstai;0;0;0;0;0;0
96;08.03.2018;2018;03;02;Torstai;1;1;2;0;0;0
96;08.03.2018;2018;03;03;Torstai;2;1;3;0;0;0
96;08.03.2018;2018;03;04;Torstai;2;0;2;0;0;0
96;08.03.2018;2018;03;05;Torstai;3;4;7;0;1;1
96;08.03.2018;2018;03;06;Torstai;29;6;35;14;3;17
96;08.03.2018;2018;03;07;Torstai;61;25;86;37;28;65
96;08.03.2018;2018;03;08;Torstai;19;16;35;7;20;27
96;08.03.2018;2018;03;09;Torstai;20;16;36;4;22;26
96;08.03.2018;2018;03;10;Torstai;12;14;26;12;27;39
96;08.03.2018;2018;03;11;Torstai;14;14;28;13;7;20
96;08.03.2018;2018;03;12;Torstai;24;10;34;22;35;57
96;08.03.2018;2018;03;13;Torstai;28;7;35;11;24;35
96;08.03.2018;2018;03;14;Torstai;20;24;44;13;35;48
96;08.03.2018;2018;03;15;Torstai;37;51;88;12;62;74
96;08.03.2018;2018;03;16;Torstai;36;25;61;11;46;57
96;08.03.2018;2018;03;17;Torstai;24;13;37;11;29;40
96;08.03.2018;2018;03;18;Torstai;20;10;30;10;19;29
96;08.03.2018;2018;03;19;Torstai;17;9;26;7;14;21
96;08.03.2018;2018;03;20;Torstai;23;9;32;6;10;16
96;08.03.2018;2018;03;21;Torstai;12;7;19;4;13;17
96;08.03.2018;2018;03;22;Torstai;5;5;10;1;5;6
96;08.03.2018;2018;03;23;Torstai;5;1;6;0;0;0
96;09.03.2018;2018;03;00;Perjantai;3;1;4;0;0;0
96;09.03.2018;2018;03;01;Perjantai;1;0;1;3;1;4
96;09.03.2018;2018;03;02;Perjantai;3;1;4;0;0;0
96;09.03.2018;2018;03;03;Perjantai;1;0;1;0;0;0
96;09.03.2018;2018;03;04;Perjantai;1;0;1;0;1;1
96;09.03.2018;2018;03;05;Perjantai;3;3;6;0;1;1
96;09.03.2018;2018;03;06;Perjantai;27;8;35;16;8;24
96;09.03.2018;2018;03;07;Perjantai;52;13;65;33;20;53
96;09.03.2018;2018;03;08;Perjantai;20;17;37;7;22;29
96;09.03.2018;2018;03;09;Perjantai;10;13;23;10;17;27
96;09.03.2018;2018;03;10;Perjantai;7;14;21;5;23;28
96;09.03.2018;2018;03;11;Perjantai;23;14;37;5;19;24
96;09.03.2018;2018;03;12;Perjantai;26;13;39;9;13;22
96;09.03.2018;2018;03;13;Perjantai;35;14;49;10;22;32
96;09.03.2018;2018;03;14;Perjantai;26;29;55;2;34;36
96;09.03.2018;2018;03;15;Perjantai;31;49;80;7;55;62
96;09.03.2018;2018;03;16;Perjantai;34;22;56;9;26;35
96;09.03.2018;2018;03;17;Perjantai;24;16;40;6;25;31
96;09.03.2018;2018;03;18;Perjantai;26;10;36;10;13;23
96;09.03.2018;2018;03;19;Perjantai;10;3;13;8;11;19
96;09.03.2018;2018;03;20;Perjantai;18;8;26;8;4;12
96;09.03.2018;2018;03;21;Perjantai;7;9;16;7;10;17
96;09.03.2018;2018;03;22;Perjantai;6;6;12;1;7;8
96;09.03.2018;2018;03;23;Perjantai;2;4;6;1;0;1
96;10.03.2018;2018;03;00;Lauantai;0;0;0;0;2;2
96;10.03.2018;2018;03;01;Lauantai;0;2;2;0;3;3
96;10.03.2018;2018;03;02;Lauantai;2;1;3;4;3;7
96;10.03.2018;2018;03;03;Lauantai;5;1;6;1;0;1
96;10.03.2018;2018;03;04;Lauantai;1;0;1;1;1;2
96;10.03.2018;2018;03;05;Lauantai;2;1;3;2;0;2
96;10.03.2018;2018;03;06;Lauantai;12;3;15;6;0;6
96;10.03.2018;2018;03;07;Lauantai;0;4;4;5;4;9
96;10.03.2018;2018;03;08;Lauantai;2;9;11;3;4;7
96;10.03.2018;2018;03;09;Lauantai;7;13;20;4;8;12
96;10.03.2018;2018;03;10;Lauantai;5;8;13;6;7;13
96;10.03.2018;2018;03;11;Lauantai;13;12;25;7;10;17
96;10.03.2018;2018;03;12;Lauantai;18;19;37;17;19;36
96;10.03.2018;2018;03;13;Lauantai;22;14;36;7;15;22
96;10.03.2018;2018;03;14;Lauantai;15;26;41;14;15;29
96;10.03.2018;2018;03;15;Lauantai;12;15;27;16;27;43
96;10.03.2018;2018;03;16;Lauantai;24;23;47;11;19;30
96;10.03.2018;2018;03;17;Lauantai;14;7;21;11;11;22
96;10.03.2018;2018;03;18;Lauantai;18;11;29;19;13;32
96;10.03.2018;2018;03;19;Lauantai;20;12;32;10;8;18
96;10.03.2018;2018;03;20;Lauantai;8;4;12;6;5;11
96;10.03.2018;2018;03;21;Lauantai;7;16;23;4;8;12
96;10.03.2018;2018;03;22;Lauantai;4;5;9;0;3;3
96;10.03.2018;2018;03;23;Lauantai;3;3;6;1;0;1
96;11.03.2018;2018;03;00;Sunnuntai;1;4;5;4;0;4
96;11.03.2018;2018;03;01;Sunnuntai;2;3;5;2;1;3
96;11.03.2018;2018;03;02;Sunnuntai;2;0;2;1;1;2
96;11.03.2018;2018;03;03;Sunnuntai;1;0;1;2;0;2
96;11.03.2018;2018;03;04;Sunnuntai;6;0;6;0;1;1
96;11.03.2018;2018;03;05;Sunnuntai;1;0;1;0;0;0
96;11.03.2018;2018;03;06;Sunnuntai;10;3;13;4;0;4
96;11.03.2018;2018;03;07;Sunnuntai;0;5;5;2;4;6
96;11.03.2018;2018;03;08;Sunnuntai;0;2;2;2;4;6
96;11.03.2018;2018;03;09;Sunnuntai;4;5;9;3;8;11
96;11.03.2018;2018;03;10;Sunnuntai;3;3;6;5;7;12
96;11.03.2018;2018;03;11;Sunnuntai;5;9;14;6;10;16
96;11.03.2018;2018;03;12;Sunnuntai;18;14;32;16;12;28
96;11.03.2018;2018;03;13;Sunnuntai;21;11;32;11;9;20
96;11.03.2018;2018;03;14;Sunnuntai;14;12;26;10;3;13
96;11.03.2018;2018;03;15;Sunnuntai;9;17;26;6;10;16
96;11.03.2018;2018;03;16;Sunnuntai;10;8;18;27;9;36
96;11.03.2018;2018;03;17;Sunnuntai;11;13;24;14;7;21
96;11.03.2018;2018;03;18;Sunnuntai;17;14;31;15;10;25
96;11.03.2018;2018;03;19;Sunnuntai;10;6;16;10;19;29
96;11.03.2018;2018;03;20;Sunnuntai;16;8;24;4;9;13
96;11.03.2018;2018;03;21;Sunnuntai;10;9;19;5;8;13
96;11.03.2018;2018;03;22;Sunnuntai;3;5;8;1;1;2
96;11.03.2018;2018;03;23;Sunnuntai;4;1;5;1;0;1
96;12.03.2018;2018;03;00;Maanantai;4;1;5;2;0;2
96;12.03.2018;2018;03;01;Maanantai;3;0;3;1;0;1
96;12.03.2018;2018;03;02;Maanantai;2;1;3;1;0;1
96;12.03.2018;2018;03;03;Maanantai;0;1;1;1;0;1
96;12.03.2018;2018;03;04;Maanantai;1;0;1;1;0;1
96;12.03.2018;2018;03;05;Maanantai;6;5;11;0;1;1
96;12.03.2018;2018;03;06;Maanantai;37;19;56;11;4;15
96;12.03.2018;2018;03;07;Maanantai;88;48;136;30;8;38
96;12.03.2018;2018;03;08;Maanantai;99;81;180;25;22;47
96;12.03.2018;2018;03;09;Maanantai;61;33;94;21;11;32
96;12.03.2018;2018;03;10;Maanantai;33;36;69;21;22;43
96;12.03.2018;2018;03;11;Maanantai;51;42;93;13;20;33
96;12.03.2018;2018;03;12;Maanantai;47;46;93;17;17;34
96;12.03.2018;2018;03;13;Maanantai;29;52;81;15;24;39
96;12.03.2018;2018;03;14;Maanantai;55;72;127;12;35;47
96;12.03.2018;2018;03;15;Maanantai;52;129;181;4;52;56
96;12.03.2018;2018;03;16;Maanantai;58;119;177;18;52;70
96;12.03.2018;2018;03;17;Maanantai;39;48;87;16;31;47
96;12.03.2018;2018;03;18;Maanantai;54;32;86;18;32;50
96;12.03.2018;2018;03;19;Maanantai;32;23;55;20;14;34
96;12.03.2018;2018;03;20;Maanantai;32;14;46;17;12;29
96;12.03.2018;2018;03;21;Maanantai;11;18;29;3;7;10
96;12.03.2018;2018;03;22;Maanantai;2;8;10;1;6;7
96;12.03.2018;2018;03;23;Maanantai;2;2;4;0;2;2
96;13.03.2018;2018;03;00;Tiistai;0;1;1;2;1;3
96;13.03.2018;2018;03;01;Tiistai;0;0;0;2;0;2
96;13.03.2018;2018;03;02;Tiistai;0;1;1;0;0;0
96;13.03.2018;2018;03;03;Tiistai;1;0;1;1;0;1
96;13.03.2018;2018;03;04;Tiistai;1;0;1;1;0;1
96;13.03.2018;2018;03;05;Tiistai;4;2;6;0;0;0
96;13.03.2018;2018;03;06;Tiistai;25;25;50;24;0;24
96;13.03.2018;2018;03;07;Tiistai;68;66;134;51;0;51
96;13.03.2018;2018;03;08;Tiistai;75;74;149;26;0;26
96;13.03.2018;2018;03;09;Tiistai;59;57;116;30;0;30
96;13.03.2018;2018;03;10;Tiistai;34;31;65;21;0;21
96;13.03.2018;2018;03;11;Tiistai;37;36;73;33;0;33
96;13.03.2018;2018;03;12;Tiistai;52;49;101;35;0;35
96;13.03.2018;2018;03;13;Tiistai;40;40;80;38;0;38
96;13.03.2018;2018;03;14;Tiistai;45;44;89;34;0;34
96;13.03.2018;2018;03;15;Tiistai;70;67;137;61;0;61
96;13.03.2018;2018;03;16;Tiistai;74;73;147;69;0;69
96;13.03.2018;2018;03;17;Tiistai;44;44;88;29;0;29
96;13.03.2018;2018;03;18;Tiistai;31;27;58;17;0;17
96;13.03.2018;2018;03;19;Tiistai;32;29;61;23;0;23
96;13.03.2018;2018;03;20;Tiistai;26;25;51;17;0;17
96;13.03.2018;2018;03;21;Tiistai;23;20;43;16;0;16
96;13.03.2018;2018;03;22;Tiistai;10;9;19;15;0;15
96;13.03.2018;2018;03;23;Tiistai;3;1;4;1;0;1
96;14.03.2018;2018;03;00;Keskiviikko;2;1;3;1;0;1
96;14.03.2018;2018;03;01;Keskiviikko;2;1;3;2;0;2
96;14.03.2018;2018;03;02;Keskiviikko;1;0;1;0;0;0
96;14.03.2018;2018;03;03;Keskiviikko;0;0;0;0;0;0
96;14.03.2018;2018;03;04;Keskiviikko;0;0;0;0;0;0
96;14.03.2018;2018;03;05;Keskiviikko;4;3;7;2;0;2
96;14.03.2018;2018;03;06;Keskiviikko;28;27;55;25;0;25
96;14.03.2018;2018;03;07;Keskiviikko;63;62;125;49;0;49
96;14.03.2018;2018;03;08;Keskiviikko;97;95;192;24;0;24
96;14.03.2018;2018;03;09;Keskiviikko;47;44;91;22;0;22
96;14.03.2018;2018;03;10;Keskiviikko;26;24;50;27;0;27
96;14.03.2018;2018;03;11;Keskiviikko;39;37;76;30;0;30
96;14.03.2018;2018;03;12;Keskiviikko;50;48;98;36;0;36
96;14.03.2018;2018;03;13;Keskiviikko;47;44;91;40;0;40
96;14.03.2018;2018;03;14;Keskiviikko;64;63;127;36;0;36
96;14.03.2018;2018;03;15;Keskiviikko;76;76;152;51;0;51
96;14.03.2018;2018;03;16;Keskiviikko;80;78;158;49;0;49
96;14.03.2018;2018;03;17;Keskiviikko;35;34;69;27;0;27
96;14.03.2018;2018;03;18;Keskiviikko;39;37;76;30;0;30
96;14.03.2018;2018;03;19;Keskiviikko;36;34;70;16;0;16
96;14.03.2018;2018;03;20;Keskiviikko;22;20;42;23;0;23
96;14.03.2018;2018;03;21;Keskiviikko;21;19;40;23;0;23
96;14.03.2018;2018;03;22;Keskiviikko;7;5;12;6;0;6
96;14.03.2018;2018;03;23;Keskiviikko;3;1;4;2;0;2
96;15.03.2018;2018;03;00;Torstai;2;0;2;0;0;0
96;15.03.2018;2018;03;01;Torstai;0;0;0;0;1;1
96;15.03.2018;2018;03;02;Torstai;3;0;3;0;0;0
96;15.03.2018;2018;03;03;Torstai;1;0;1;1;0;1
96;15.03.2018;2018;03;04;Torstai;1;0;1;3;0;3
96;15.03.2018;2018;03;05;Torstai;4;3;7;0;1;1
96;15.03.2018;2018;03;06;Torstai;26;24;50;10;4;14
96;15.03.2018;2018;03;07;Torstai;65;63;128;38;11;49
96;15.03.2018;2018;03;08;Torstai;68;64;132;30;10;40
96;15.03.2018;2018;03;09;Torstai;60;23;83;23;15;38
96;15.03.2018;2018;03;10;Torstai;50;35;85;22;24;46
96;15.03.2018;2018;03;11;Torstai;61;44;105;19;32;51
96;15.03.2018;2018;03;12;Torstai;55;43;98;32;29;61
96;15.03.2018;2018;03;13;Torstai;50;36;86;17;25;42
96;15.03.2018;2018;03;14;Torstai;40;69;109;12;58;70
96;15.03.2018;2018;03;15;Torstai;56;92;148;16;46;62
96;15.03.2018;2018;03;16;Torstai;63;90;153;14;55;69
96;15.03.2018;2018;03;17;Torstai;33;67;100;13;21;34
96;15.03.2018;2018;03;18;Torstai;26;23;49;11;21;32
96;15.03.2018;2018;03;19;Torstai;44;18;62;5;10;15
96;15.03.2018;2018;03;20;Torstai;14;12;26;3;3;6
96;15.03.2018;2018;03;21;Torstai;18;28;46;4;5;9
96;15.03.2018;2018;03;22;Torstai;9;10;19;1;3;4
96;15.03.2018;2018;03;23;Torstai;4;2;6;2;0;2
96;16.03.2018;2018;03;00;Perjantai;1;1;2;0;0;0
96;16.03.2018;2018;03;01;Perjantai;2;2;4;0;1;1
96;16.03.2018;2018;03;02;Perjantai;2;1;3;0;0;0
96;16.03.2018;2018;03;03;Perjantai;3;0;3;1;0;1
96;16.03.2018;2018;03;04;Perjantai;0;0;0;3;0;3
96;16.03.2018;2018;03;05;Perjantai;2;2;4;0;1;1
96;16.03.2018;2018;03;06;Perjantai;31;12;43;10;4;14
96;16.03.2018;2018;03;07;Perjantai;76;43;119;38;11;49
96;16.03.2018;2018;03;08;Perjantai;66;52;118;30;10;40
96;16.03.2018;2018;03;09;Perjantai;32;22;54;28;11;39
96;16.03.2018;2018;03;10;Perjantai;54;19;73;11;25;36
96;16.03.2018;2018;03;11;Perjantai;38;43;81;16;26;42
96;16.03.2018;2018;03;12;Perjantai;55;50;105;26;32;58
96;16.03.2018;2018;03;13;Perjantai;45;53;98;12;39;51
96;16.03.2018;2018;03;14;Perjantai;62;64;126;22;52;74
96;16.03.2018;2018;03;15;Perjantai;47;69;116;21;50;71
96;16.03.2018;2018;03;16;Perjantai;52;46;98;13;44;57
96;16.03.2018;2018;03;17;Perjantai;36;31;67;16;20;36
96;16.03.2018;2018;03;18;Perjantai;30;23;53;5;22;27
96;16.03.2018;2018;03;19;Perjantai;19;21;40;5;5;10
96;16.03.2018;2018;03;20;Perjantai;20;9;29;3;7;10
96;16.03.2018;2018;03;21;Perjantai;11;15;26;5;5;10
96;16.03.2018;2018;03;22;Perjantai;8;13;21;2;4;6
96;16.03.2018;2018;03;23;Perjantai;3;3;6;0;0;0
96;17.03.2018;2018;03;00;Lauantai;5;0;5;0;0;0
96;17.03.2018;2018;03;01;Lauantai;2;1;3;1;0;1
96;17.03.2018;2018;03;02;Lauantai;3;0;3;2;0;2
96;17.03.2018;2018;03;03;Lauantai;2;0;2;0;1;1
96;17.03.2018;2018;03;04;Lauantai;0;0;0;0;0;0
96;17.03.2018;2018;03;05;Lauantai;3;1;4;1;0;1
96;17.03.2018;2018;03;06;Lauantai;10;2;12;4;1;5
96;17.03.2018;2018;03;07;Lauantai;2;8;10;4;3;7
96;17.03.2018;2018;03;08;Lauantai;4;12;16;7;9;16
96;17.03.2018;2018;03;09;Lauantai;5;9;14;6;10;16
96;17.03.2018;2018;03;10;Lauantai;12;12;24;5;17;22
96;17.03.2018;2018;03;11;Lauantai;15;12;27;13;19;32
96;17.03.2018;2018;03;12;Lauantai;20;16;36;13;17;30
96;17.03.2018;2018;03;13;Lauantai;16;19;35;12;16;28
96;17.03.2018;2018;03;14;Lauantai;25;19;44;17;26;43
96;17.03.2018;2018;03;15;Lauantai;23;20;43;20;21;41
96;17.03.2018;2018;03;16;Lauantai;24;12;36;9;9;18
96;17.03.2018;2018;03;17;Lauantai;22;12;34;12;12;24
96;17.03.2018;2018;03;18;Lauantai;14;14;28;14;6;20
96;17.03.2018;2018;03;19;Lauantai;10;11;21;11;7;18
96;17.03.2018;2018;03;20;Lauantai;22;14;36;6;7;13
96;17.03.2018;2018;03;21;Lauantai;12;12;24;2;10;12
96;17.03.2018;2018;03;22;Lauantai;1;3;4;4;1;5
96;17.03.2018;2018;03;23;Lauantai;2;6;8;0;2;2
96;18.03.2018;2018;03;00;Sunnuntai;3;10;13;0;1;1
96;18.03.2018;2018;03;01;Sunnuntai;1;3;4;1;0;1
96;18.03.2018;2018;03;02;Sunnuntai;3;2;5;0;1;1
96;18.03.2018;2018;03;03;Sunnuntai;4;0;4;2;0;2
96;18.03.2018;2018;03;04;Sunnuntai;2;0;2;0;0;0
96;18.03.2018;2018;03;05;Sunnuntai;2;0;2;1;0;1
96;18.03.2018;2018;03;06;Sunnuntai;13;3;16;7;1;8
96;18.03.2018;2018;03;07;Sunnuntai;4;9;13;4;3;7
96;18.03.2018;2018;03;08;Sunnuntai;6;7;13;1;9;10
96;18.03.2018;2018;03;09;Sunnuntai;7;9;16;6;7;13
96;18.03.2018;2018;03;10;Sunnuntai;10;13;23;14;11;25
96;18.03.2018;2018;03;11;Sunnuntai;15;23;38;6;13;19
96;18.03.2018;2018;03;12;Sunnuntai;13;13;26;20;16;36
96;18.03.2018;2018;03;13;Sunnuntai;43;16;59;6;8;14
96;18.03.2018;2018;03;14;Sunnuntai;17;15;32;17;16;33
96;18.03.2018;2018;03;15;Sunnuntai;26;16;42;13;18;31
96;18.03.2018;2018;03;16;Sunnuntai;20;12;32;31;22;53
96;18.03.2018;2018;03;17;Sunnuntai;21;9;30;17;12;29
96;18.03.2018;2018;03;18;Sunnuntai;19;14;33;22;20;42
96;18.03.2018;2018;03;19;Sunnuntai;14;6;20;5;11;16
96;18.03.2018;2018;03;20;Sunnuntai;15;11;26;4;13;17
96;18.03.2018;2018;03;21;Sunnuntai;7;15;22;4;10;14
96;18.03.2018;2018;03;22;Sunnuntai;1;4;5;1;2;3
96;18.03.2018;2018;03;23;Sunnuntai;3;1;4;0;1;1
96;19.03.2018;2018;03;00;Maanantai;3;0;3;1;0;1
96;19.03.2018;2018;03;01;Maanantai;1;0;1;0;1;1
96;19.03.2018;2018;03;02;Maanantai;2;0;2;1;0;1
96;19.03.2018;2018;03;03;Maanantai;0;0;0;0;0;0
96;19.03.2018;2018;03;04;Maanantai;1;0;1;0;1;1
96;19.03.2018;2018;03;05;Maanantai;1;4;5;3;0;3
96;19.03.2018;2018;03;06;Maanantai;44;15;59;16;10;26
96;19.03.2018;2018;03;07;Maanantai;92;62;154;42;24;66
96;19.03.2018;2018;03;08;Maanantai;110;63;173;28;21;49
96;19.03.2018;2018;03;09;Maanantai;61;34;95;25;24;49
96;19.03.2018;2018;03;10;Maanantai;39;23;62;18;29;47
96;19.03.2018;2018;03;11;Maanantai;49;34;83;14;34;48
96;19.03.2018;2018;03;12;Maanantai;63;28;91;33;41;74
96;19.03.2018;2018;03;13;Maanantai;42;37;79;16;44;60
96;19.03.2018;2018;03;14;Maanantai;38;56;94;16;50;66
96;19.03.2018;2018;03;15;Maanantai;56;116;172;17;57;74
96;19.03.2018;2018;03;16;Maanantai;74;89;163;21;76;97
96;19.03.2018;2018;03;17;Maanantai;37;51;88;20;27;47
96;19.03.2018;2018;03;18;Maanantai;44;25;69;27;28;55
96;19.03.2018;2018;03;19;Maanantai;21;27;48;21;18;39
96;19.03.2018;2018;03;20;Maanantai;33;16;49;15;13;28
96;19.03.2018;2018;03;21;Maanantai;21;18;39;3;6;9
96;19.03.2018;2018;03;22;Maanantai;9;15;24;1;3;4
96;19.03.2018;2018;03;23;Maanantai;1;0;1;0;0;0
96;20.03.2018;2018;03;00;Tiistai;0;0;0;0;0;0
96;20.03.2018;2018;03;01;Tiistai;0;0;0;1;0;1
96;20.03.2018;2018;03;02;Tiistai;1;0;1;0;0;0
96;20.03.2018;2018;03;03;Tiistai;0;0;0;0;0;0
96;20.03.2018;2018;03;04;Tiistai;0;0;0;0;0;0
96;20.03.2018;2018;03;05;Tiistai;1;2;3;0;0;0
96;20.03.2018;2018;03;06;Tiistai;47;11;58;14;6;20
96;20.03.2018;2018;03;07;Tiistai;82;55;137;39;16;55
96;20.03.2018;2018;03;08;Tiistai;92;69;161;24;17;41
96;20.03.2018;2018;03;09;Tiistai;97;53;150;22;24;46
96;20.03.2018;2018;03;10;Tiistai;51;22;73;26;38;64
96;20.03.2018;2018;03;11;Tiistai;66;25;91;29;31;60
96;20.03.2018;2018;03;12;Tiistai;51;30;81;27;34;61
96;20.03.2018;2018;03;13;Tiistai;39;36;75;17;44;61
96;20.03.2018;2018;03;14;Tiistai;41;41;82;14;54;68
96;20.03.2018;2018;03;15;Tiistai;53;112;165;11;56;67
96;20.03.2018;2018;03;16;Tiistai;61;105;166;19;72;91
96;20.03.2018;2018;03;17;Tiistai;53;49;102;16;31;47
96;20.03.2018;2018;03;18;Tiistai;28;45;73;11;24;35
96;20.03.2018;2018;03;19;Tiistai;24;18;42;20;28;48
96;20.03.2018;2018;03;20;Tiistai;43;13;56;13;13;26
96;20.03.2018;2018;03;21;Tiistai;38;22;60;19;6;25
96;20.03.2018;2018;03;22;Tiistai;13;8;21;3;2;5
96;20.03.2018;2018;03;23;Tiistai;7;2;9;1;0;1
96;21.03.2018;2018;03;00;Keskiviikko;1;0;1;0;1;1
96;21.03.2018;2018;03;01;Keskiviikko;2;0;2;0;0;0
96;21.03.2018;2018;03;02;Keskiviikko;1;0;1;0;0;0
96;21.03.2018;2018;03;03;Keskiviikko;0;0;0;0;0;0
96;21.03.2018;2018;03;04;Keskiviikko;0;0;0;0;0;0
96;21.03.2018;2018;03;05;Keskiviikko;3;4;7;0;0;0
96;21.03.2018;2018;03;06;Keskiviikko;34;14;48;15;3;18
96;21.03.2018;2018;03;07;Keskiviikko;65;65;130;39;10;49
96;21.03.2018;2018;03;08;Keskiviikko;112;58;170;14;14;28
96;21.03.2018;2018;03;09;Keskiviikko;58;30;88;19;10;29
96;21.03.2018;2018;03;10;Keskiviikko;35;26;61;10;12;22
96;21.03.2018;2018;03;11;Keskiviikko;43;39;82;11;21;32
96;21.03.2018;2018;03;12;Keskiviikko;60;44;104;18;26;44
96;21.03.2018;2018;03;13;Keskiviikko;35;47;82;26;10;36
96;21.03.2018;2018;03;14;Keskiviikko;36;104;140;20;40;60
96;21.03.2018;2018;03;15;Keskiviikko;32;99;131;13;60;73
96;21.03.2018;2018;03;16;Keskiviikko;39;93;132;22;67;89
96;21.03.2018;2018;03;17;Keskiviikko;38;40;78;20;37;57
96;21.03.2018;2018;03;18;Keskiviikko;31;42;73;64;35;99
96;21.03.2018;2018;03;19;Keskiviikko;35;16;51;13;37;50
96;21.03.2018;2018;03;20;Keskiviikko;43;15;58;8;19;27
96;21.03.2018;2018;03;21;Keskiviikko;9;19;28;2;10;12
96;21.03.2018;2018;03;22;Keskiviikko;4;8;12;3;2;5
96;21.03.2018;2018;03;23;Keskiviikko;5;1;6;0;0;0
96;22.03.2018;2018;03;00;Torstai;4;0;4;1;0;1
96;22.03.2018;2018;03;01;Torstai;1;1;2;1;0;1
96;22.03.2018;2018;03;02;Torstai;2;1;3;0;1;1
96;22.03.2018;2018;03;03;Torstai;0;0;0;1;0;1
96;22.03.2018;2018;03;04;Torstai;1;1;2;2;3;5
96;22.03.2018;2018;03;05;Torstai;2;3;5;0;1;1
96;22.03.2018;2018;03;06;Torstai;25;23;48;15;5;20
96;22.03.2018;2018;03;07;Torstai;71;54;125;37;17;54
96;22.03.2018;2018;03;08;Torstai;75;55;130;24;8;32
96;22.03.2018;2018;03;09;Torstai;71;32;103;21;14;35
96;22.03.2018;2018;03;10;Torstai;42;28;70;11;13;24
96;22.03.2018;2018;03;11;Torstai;47;36;83;16;10;26
96;22.03.2018;2018;03;12;Torstai;41;54;95;12;14;26
96;22.03.2018;2018;03;13;Torstai;37;42;79;12;25;37
96;22.03.2018;2018;03;14;Torstai;44;91;135;11;33;44
96;22.03.2018;2018;03;15;Torstai;57;102;159;7;48;55
96;22.03.2018;2018;03;16;Torstai;57;97;154;20;39;59
96;22.03.2018;2018;03;17;Torstai;33;57;90;8;26;34
96;22.03.2018;2018;03;18;Torstai;39;20;59;12;8;20
96;22.03.2018;2018;03;19;Torstai;41;25;66;13;12;25
96;22.03.2018;2018;03;20;Torstai;31;16;47;10;13;23
96;22.03.2018;2018;03;21;Torstai;19;26;45;12;10;22
96;22.03.2018;2018;03;22;Torstai;13;8;21;1;4;5
96;22.03.2018;2018;03;23;Torstai;7;1;8;0;0;0
96;23.03.2018;2018;03;00;Perjantai;9;0;9;0;0;0
96;23.03.2018;2018;03;01;Perjantai;4;0;4;0;0;0
96;23.03.2018;2018;03;02;Perjantai;2;0;2;1;0;1
96;23.03.2018;2018;03;03;Perjantai;8;0;8;4;0;4
96;23.03.2018;2018;03;04;Perjantai;3;0;3;0;0;0
96;23.03.2018;2018;03;05;Perjantai;4;3;7;2;3;5
96;23.03.2018;2018;03;06;Perjantai;30;12;42;18;9;27
96;23.03.2018;2018;03;07;Perjantai;65;38;103;35;23;58
96;23.03.2018;2018;03;08;Perjantai;66;49;115;18;15;33
96;23.03.2018;2018;03;09;Perjantai;45;33;78;15;26;41
96;23.03.2018;2018;03;10;Perjantai;34;22;56;13;31;44
96;23.03.2018;2018;03;11;Perjantai;39;45;84;15;48;63
96;23.03.2018;2018;03;12;Perjantai;60;36;96;18;31;49
96;23.03.2018;2018;03;13;Perjantai;45;43;88;18;40;58
96;23.03.2018;2018;03;14;Perjantai;32;47;79;14;47;61
96;23.03.2018;2018;03;15;Perjantai;51;72;123;17;51;68
96;23.03.2018;2018;03;16;Perjantai;33;38;71;17;30;47
96;23.03.2018;2018;03;17;Perjantai;30;26;56;8;12;20
96;23.03.2018;2018;03;18;Perjantai;25;8;33;5;17;22
96;23.03.2018;2018;03;19;Perjantai;24;11;35;10;7;17
96;23.03.2018;2018;03;20;Perjantai;18;16;34;9;4;13
96;23.03.2018;2018;03;21;Perjantai;7;6;13;0;16;16
96;23.03.2018;2018;03;22;Perjantai;8;5;13;3;1;4
96;23.03.2018;2018;03;23;Perjantai;11;8;19;14;6;20
96;24.03.2018;2018;03;00;Lauantai;3;2;5;0;0;0
96;24.03.2018;2018;03;01;Lauantai;1;1;2;3;0;3
96;24.03.2018;2018;03;02;Lauantai;2;0;2;1;0;1
96;24.03.2018;2018;03;03;Lauantai;7;0;7;0;0;0
96;24.03.2018;2018;03;04;Lauantai;1;0;1;0;0;0
96;24.03.2018;2018;03;05;Lauantai;4;1;5;1;0;1
96;24.03.2018;2018;03;06;Lauantai;15;2;17;7;1;8
96;24.03.2018;2018;03;07;Lauantai;1;4;5;3;7;10
96;24.03.2018;2018;03;08;Lauantai;4;11;15;7;10;17
96;24.03.2018;2018;03;09;Lauantai;4;20;24;2;5;7
96;24.03.2018;2018;03;10;Lauantai;7;17;24;8;7;15
96;24.03.2018;2018;03;11;Lauantai;7;19;26;16;14;30
96;24.03.2018;2018;03;12;Lauantai;8;14;22;15;9;24
96;24.03.2018;2018;03;13;Lauantai;30;20;50;5;15;20
96;24.03.2018;2018;03;14;Lauantai;11;17;28;3;6;9
96;24.03.2018;2018;03;15;Lauantai;14;20;34;22;14;36
96;24.03.2018;2018;03;16;Lauantai;12;14;26;11;27;38
96;24.03.2018;2018;03;17;Lauantai;7;7;14;18;13;31
96;24.03.2018;2018;03;18;Lauantai;13;9;22;11;6;17
96;24.03.2018;2018;03;19;Lauantai;21;8;29;24;12;36
96;24.03.2018;2018;03;20;Lauantai;17;5;22;7;11;18
96;24.03.2018;2018;03;21;Lauantai;5;12;17;3;9;12
96;24.03.2018;2018;03;22;Lauantai;1;5;6;3;5;8
96;24.03.2018;2018;03;23;Lauantai;1;4;5;0;1;1
96;25.03.2018;2018;03;00;Sunnuntai;3;2;5;1;2;3
96;25.03.2018;2018;03;01;Sunnuntai;6;3;9;2;1;3
96;25.03.2018;2018;03;02;Sunnuntai;2;0;2;4;0;4
96;25.03.2018;2018;03;03;Sunnuntai;0;0;0;0;0;0
96;25.03.2018;2018;03;04;Sunnuntai;6;0;6;2;1;3
96;25.03.2018;2018;03;05;Sunnuntai;3;0;3;6;1;7
96;25.03.2018;2018;03;06;Sunnuntai;12;2;14;8;0;8
96;25.03.2018;2018;03;07;Sunnuntai;0;9;9;1;5;6
96;25.03.2018;2018;03;08;Sunnuntai;0;2;2;3;2;5
96;25.03.2018;2018;03;09;Sunnuntai;7;9;16;6;5;11
96;25.03.2018;2018;03;10;Sunnuntai;3;12;15;8;9;17
96;25.03.2018;2018;03;11;Sunnuntai;8;13;21;11;18;29
96;25.03.2018;2018;03;12;Sunnuntai;10;17;27;13;19;32
96;25.03.2018;2018;03;13;Sunnuntai;29;23;52;25;18;43
96;25.03.2018;2018;03;14;Sunnuntai;12;20;32;13;23;36
96;25.03.2018;2018;03;15;Sunnuntai;16;19;35;22;18;40
96;25.03.2018;2018;03;16;Sunnuntai;38;12;50;24;8;32
96;25.03.2018;2018;03;17;Sunnuntai;20;9;29;9;15;24
96;25.03.2018;2018;03;18;Sunnuntai;8;21;29;10;19;29
96;25.03.2018;2018;03;19;Sunnuntai;17;11;28;13;23;36
96;25.03.2018;2018;03;20;Sunnuntai;22;10;32;7;8;15
96;25.03.2018;2018;03;21;Sunnuntai;4;11;15;7;7;14
96;25.03.2018;2018;03;22;Sunnuntai;2;9;11;0;2;2
96;25.03.2018;2018;03;23;Sunnuntai;3;0;3;1;0;1
96;26.03.2018;2018;03;00;Maanantai;0;1;1;2;0;2
96;26.03.2018;2018;03;01;Maanantai;0;0;0;2;0;2
96;26.03.2018;2018;03;02;Maanantai;1;0;1;1;0;1
96;26.03.2018;2018;03;03;Maanantai;1;0;1;0;0;0
96;26.03.2018;2018;03;04;Maanantai;0;0;0;0;1;1
96;26.03.2018;2018;03;05;Maanantai;5;3;8;0;2;2
96;26.03.2018;2018;03;06;Maanantai;41;14;55;7;7;14
96;26.03.2018;2018;03;07;Maanantai;97;40;137;41;19;60
96;26.03.2018;2018;03;08;Maanantai;100;57;157;31;26;57
96;26.03.2018;2018;03;09;Maanantai;54;34;88;32;14;46
96;26.03.2018;2018;03;10;Maanantai;42;28;70;23;32;55
96;26.03.2018;2018;03;11;Maanantai;41;43;84;17;28;45
96;26.03.2018;2018;03;12;Maanantai;68;33;101;17;27;44
96;26.03.2018;2018;03;13;Maanantai;50;44;94;16;32;48
96;26.03.2018;2018;03;14;Maanantai;41;65;106;15;31;46
96;26.03.2018;2018;03;15;Maanantai;53;105;158;18;56;74
96;26.03.2018;2018;03;16;Maanantai;66;107;173;17;74;91
96;26.03.2018;2018;03;17;Maanantai;41;55;96;14;29;43
96;26.03.2018;2018;03;18;Maanantai;36;29;65;31;25;56
96;26.03.2018;2018;03;19;Maanantai;40;22;62;11;16;27
96;26.03.2018;2018;03;20;Maanantai;33;15;48;14;13;27
96;26.03.2018;2018;03;21;Maanantai;26;23;49;5;12;17
96;26.03.2018;2018;03;22;Maanantai;5;5;10;3;5;8
96;26.03.2018;2018;03;23;Maanantai;2;4;6;0;1;1
96;27.03.2018;2018;03;00;Tiistai;4;1;5;1;0;1
96;27.03.2018;2018;03;01;Tiistai;2;0;2;0;0;0
96;27.03.2018;2018;03;02;Tiistai;2;1;3;0;0;0
96;27.03.2018;2018;03;03;Tiistai;0;0;0;0;0;0
96;27.03.2018;2018;03;04;Tiistai;0;0;0;0;0;0
96;27.03.2018;2018;03;05;Tiistai;10;3;13;0;2;2
96;27.03.2018;2018;03;06;Tiistai;46;8;54;8;2;10
96;27.03.2018;2018;03;07;Tiistai;101;46;147;42;28;70
96;27.03.2018;2018;03;08;Tiistai;96;54;150;21;20;41
96;27.03.2018;2018;03;09;Tiistai;68;35;103;17;21;38
96;27.03.2018;2018;03;10;Tiistai;46;30;76;15;19;34
96;27.03.2018;2018;03;11;Tiistai;48;32;80;20;28;48
96;27.03.2018;2018;03;12;Tiistai;44;34;78;16;22;38
96;27.03.2018;2018;03;13;Tiistai;50;30;80;21;35;56
96;27.03.2018;2018;03;14;Tiistai;38;69;107;12;27;39
96;27.03.2018;2018;03;15;Tiistai;61;98;159;9;53;62
96;27.03.2018;2018;03;16;Tiistai;46;108;154;15;54;69
96;27.03.2018;2018;03;17;Tiistai;40;39;79;16;22;38
96;27.03.2018;2018;03;18;Tiistai;27;26;53;10;13;23
96;27.03.2018;2018;03;19;Tiistai;32;21;53;12;9;21
96;27.03.2018;2018;03;20;Tiistai;32;11;43;12;11;23
96;27.03.2018;2018;03;21;Tiistai;19;29;48;4;16;20
96;27.03.2018;2018;03;22;Tiistai;6;8;14;2;4;6
96;27.03.2018;2018;03;23;Tiistai;3;0;3;0;2;2
96;28.03.2018;2018;03;00;Keskiviikko;3;3;6;1;0;1
96;28.03.2018;2018;03;01;Keskiviikko;2;1;3;1;0;1
96;28.03.2018;2018;03;02;Keskiviikko;1;0;1;0;0;0
96;28.03.2018;2018;03;03;Keskiviikko;1;0;1;2;0;2
96;28.03.2018;2018;03;04;Keskiviikko;1;0;1;0;2;2
96;28.03.2018;2018;03;05;Keskiviikko;6;3;9;1;1;2
96;28.03.2018;2018;03;06;Keskiviikko;41;8;49;9;5;14
96;28.03.2018;2018;03;07;Keskiviikko;68;48;116;27;15;42
96;28.03.2018;2018;03;08;Keskiviikko;128;59;187;26;22;48
96;28.03.2018;2018;03;09;Keskiviikko;57;27;84;18;17;35
96;28.03.2018;2018;03;10;Keskiviikko;27;42;69;21;26;47
96;28.03.2018;2018;03;11;Keskiviikko;41;41;82;22;24;46
96;28.03.2018;2018;03;12;Keskiviikko;60;32;92;24;23;47
96;28.03.2018;2018;03;13;Keskiviikko;57;43;100;23;27;50
96;28.03.2018;2018;03;14;Keskiviikko;44;68;112;17;44;61
96;28.03.2018;2018;03;15;Keskiviikko;47;94;141;22;53;75
96;28.03.2018;2018;03;16;Keskiviikko;74;94;168;20;56;76
96;28.03.2018;2018;03;17;Keskiviikko;37;47;84;18;30;48
96;28.03.2018;2018;03;18;Keskiviikko;53;39;92;21;29;50
96;28.03.2018;2018;03;19;Keskiviikko;37;22;59;17;18;35
96;28.03.2018;2018;03;20;Keskiviikko;37;22;59;11;18;29
96;28.03.2018;2018;03;21;Keskiviikko;32;17;49;12;12;24
96;28.03.2018;2018;03;22;Keskiviikko;6;11;17;1;5;6
96;28.03.2018;2018;03;23;Keskiviikko;3;4;7;0;0;0
96;29.03.2018;2018;03;00;Torstai;0;1;1;0;0;0
96;29.03.2018;2018;03;01;Torstai;3;0;3;2;0;2
96;29.03.2018;2018;03;02;Torstai;2;0;2;0;0;0
96;29.03.2018;2018;03;03;Torstai;4;0;4;1;0;1
96;29.03.2018;2018;03;04;Torstai;3;0;3;0;0;0
96;29.03.2018;2018;03;05;Torstai;5;3;8;0;4;4
96;29.03.2018;2018;03;06;Torstai;32;5;37;10;7;17
96;29.03.2018;2018;03;07;Torstai;78;34;112;24;11;35
96;29.03.2018;2018;03;08;Torstai;73;43;116;11;18;29
96;29.03.2018;2018;03;09;Torstai;35;34;69;18;23;41
96;29.03.2018;2018;03;10;Torstai;42;20;62;11;19;30
96;29.03.2018;2018;03;11;Torstai;36;42;78;20;32;52
96;29.03.2018;2018;03;12;Torstai;47;41;88;16;38;54
96;29.03.2018;2018;03;13;Torstai;48;32;80;13;37;50
96;29.03.2018;2018;03;14;Torstai;55;61;116;12;41;53
96;29.03.2018;2018;03;15;Torstai;55;75;130;14;66;80
96;29.03.2018;2018;03;16;Torstai;47;60;107;7;37;44
96;29.03.2018;2018;03;17;Torstai;28;18;46;10;22;32
96;29.03.2018;2018;03;18;Torstai;24;13;37;14;18;32
96;29.03.2018;2018;03;19;Torstai;25;16;41;7;11;18
96;29.03.2018;2018;03;20;Torstai;32;15;47;11;11;22
96;29.03.2018;2018;03;21;Torstai;10;16;26;1;10;11
96;29.03.2018;2018;03;22;Torstai;3;11;14;1;3;4
96;29.03.2018;2018;03;23;Torstai;4;1;5;0;1;1
96;30.03.2018;2018;03;00;Perjantai;6;2;8;1;2;3
96;30.03.2018;2018;03;01;Perjantai;5;0;5;1;1;2
96;30.03.2018;2018;03;02;Perjantai;0;0;0;1;0;1
96;30.03.2018;2018;03;03;Perjantai;0;0;0;2;0;2
96;30.03.2018;2018;03;04;Perjantai;4;0;4;3;1;4
96;30.03.2018;2018;03;05;Perjantai;0;2;2;1;3;4
96;30.03.2018;2018;03;06;Perjantai;21;0;21;6;2;8
96;30.03.2018;2018;03;07;Perjantai;1;8;9;0;4;4
96;30.03.2018;2018;03;08;Perjantai;1;3;4;3;3;6
96;30.03.2018;2018;03;09;Perjantai;4;10;14;5;6;11
96;30.03.2018;2018;03;10;Perjantai;10;4;14;6;10;16
96;30.03.2018;2018;03;11;Perjantai;13;6;19;9;13;22
96;30.03.2018;2018;03;12;Perjantai;15;13;28;13;16;29
96;30.03.2018;2018;03;13;Perjantai;22;7;29;12;11;23
96;30.03.2018;2018;03;14;Perjantai;17;16;33;15;27;42
96;30.03.2018;2018;03;15;Perjantai;16;17;33;13;36;49
96;30.03.2018;2018;03;16;Perjantai;24;15;39;11;16;27
96;30.03.2018;2018;03;17;Perjantai;10;9;19;8;11;19
96;30.03.2018;2018;03;18;Perjantai;7;11;18;12;16;28
96;30.03.2018;2018;03;19;Perjantai;14;9;23;3;11;14
96;30.03.2018;2018;03;20;Perjantai;13;4;17;4;9;13
96;30.03.2018;2018;03;21;Perjantai;4;14;18;5;10;15
96;30.03.2018;2018;03;22;Perjantai;6;3;9;1;3;4
96;30.03.2018;2018;03;23;Perjantai;4;3;7;2;0;2
96;31.03.2018;2018;03;00;Lauantai;2;0;2;3;2;5
96;31.03.2018;2018;03;01;Lauantai;3;1;4;1;0;1
96;31.03.2018;2018;03;02;Lauantai;0;0;0;1;0;1
96;31.03.2018;2018;03;03;Lauantai;2;0;2;2;0;2
96;31.03.2018;2018;03;04;Lauantai;1;1;2;0;1;1
96;31.03.2018;2018;03;05;Lauantai;2;0;2;0;1;1
96;31.03.2018;2018;03;06;Lauantai;16;4;20;2;0;2
96;31.03.2018;2018;03;07;Lauantai;2;7;9;3;5;8
96;31.03.2018;2018;03;08;Lauantai;1;7;8;4;4;8
96;31.03.2018;2018;03;09;Lauantai;4;12;16;5;15;20
96;31.03.2018;2018;03;10;Lauantai;13;13;26;3;16;19
96;31.03.2018;2018;03;11;Lauantai;13;18;31;18;31;49
96;31.03.2018;2018;03;12;Lauantai;29;23;52;20;34;54
96;31.03.2018;2018;03;13;Lauantai;31;13;44;17;17;34
96;31.03.2018;2018;03;14;Lauantai;11;17;28;12;17;29
96;31.03.2018;2018;03;15;Lauantai;22;13;35;10;16;26
96;31.03.2018;2018;03;16;Lauantai;18;9;27;11;20;31
96;31.03.2018;2018;03;17;Lauantai;7;11;18;7;9;16
96;31.03.2018;2018;03;18;Lauantai;8;8;16;9;8;17
96;31.03.2018;2018;03;19;Lauantai;17;6;23;3;8;11
96;31.03.2018;2018;03;20;Lauantai;20;4;24;10;5;15
96;31.03.2018;2018;03;21;Lauantai;10;8;18;2;12;14
96;31.03.2018;2018;03;22;Lauantai;1;2;3;3;5;8
96;31.03.2018;2018;03;23;Lauantai;2;1;3;1;3;4
96;01.04.2018;2018;04;00;Sunnuntai;1;1;2;0;0;0
96;01.04.2018;2018;04;01;Sunnuntai;0;1;1;0;1;1
96;01.04.2018;2018;04;02;Sunnuntai;1;0;1;0;0;0
96;01.04.2018;2018;04;03;Sunnuntai;2;0;2;0;0;0
96;01.04.2018;2018;04;04;Sunnuntai;4;0;4;0;2;2
96;01.04.2018;2018;04;05;Sunnuntai;1;0;1;1;0;1
96;01.04.2018;2018;04;06;Sunnuntai;13;2;15;1;1;2
96;01.04.2018;2018;04;07;Sunnuntai;2;5;7;1;6;7
96;01.04.2018;2018;04;08;Sunnuntai;3;4;7;2;4;6
96;01.04.2018;2018;04;09;Sunnuntai;3;2;5;9;5;14
96;01.04.2018;2018;04;10;Sunnuntai;5;7;12;14;12;26
96;01.04.2018;2018;04;11;Sunnuntai;4;7;11;7;12;19
96;01.04.2018;2018;04;12;Sunnuntai;14;9;23;10;24;34
96;01.04.2018;2018;04;13;Sunnuntai;27;9;36;14;25;39
96;01.04.2018;2018;04;14;Sunnuntai;9;14;23;24;19;43
96;01.04.2018;2018;04;15;Sunnuntai;10;13;23;6;18;24
96;01.04.2018;2018;04;16;Sunnuntai;31;3;34;22;8;30
96;01.04.2018;2018;04;17;Sunnuntai;21;17;38;8;17;25
96;01.04.2018;2018;04;18;Sunnuntai;11;7;18;11;18;29
96;01.04.2018;2018;04;19;Sunnuntai;16;10;26;6;10;16
96;01.04.2018;2018;04;20;Sunnuntai;13;10;23;4;8;12
96;01.04.2018;2018;04;21;Sunnuntai;5;16;21;1;7;8
96;01.04.2018;2018;04;22;Sunnuntai;2;7;9;0;3;3
96;01.04.2018;2018;04;23;Sunnuntai;9;4;13;0;2;2
96;02.04.2018;2018;04;00;Maanantai;2;0;2;0;0;0
96;02.04.2018;2018;04;01;Maanantai;1;0;1;2;0;2
96;02.04.2018;2018;04;02;Maanantai;0;1;1;2;1;3
96;02.04.2018;2018;04;03;Maanantai;2;0;2;0;0;0
96;02.04.2018;2018;04;04;Maanantai;1;1;2;0;0;0
96;02.04.2018;2018;04;05;Maanantai;2;2;4;0;0;0
96;02.04.2018;2018;04;06;Maanantai;18;1;19;2;1;3
96;02.04.2018;2018;04;07;Maanantai;2;2;4;1;2;3
96;02.04.2018;2018;04;08;Maanantai;4;6;10;1;3;4
96;02.04.2018;2018;04;09;Maanantai;2;11;13;7;9;16
96;02.04.2018;2018;04;10;Maanantai;7;9;16;3;9;12
96;02.04.2018;2018;04;11;Maanantai;18;15;33;11;16;27
96;02.04.2018;2018;04;12;Maanantai;20;12;32;14;11;25
96;02.04.2018;2018;04;13;Maanantai;28;12;40;13;21;34
96;02.04.2018;2018;04;14;Maanantai;20;20;40;14;11;25
96;02.04.2018;2018;04;15;Maanantai;16;12;28;7;14;21
96;02.04.2018;2018;04;16;Maanantai;11;20;31;18;13;31
96;02.04.2018;2018;04;17;Maanantai;15;13;28;8;10;18
96;02.04.2018;2018;04;18;Maanantai;19;9;28;17;23;40
96;02.04.2018;2018;04;19;Maanantai;25;12;37;14;8;22
96;02.04.2018;2018;04;20;Maanantai;14;13;27;13;5;18
96;02.04.2018;2018;04;21;Maanantai;11;10;21;6;9;15
96;02.04.2018;2018;04;22;Maanantai;1;5;6;1;0;1
96;02.04.2018;2018;04;23;Maanantai;7;1;8;4;1;5
96;03.04.2018;2018;04;00;Tiistai;2;1;3;2;0;2
96;03.04.2018;2018;04;01;Tiistai;2;0;2;0;0;0
96;03.04.2018;2018;04;02;Tiistai;0;0;0;0;0;0
96;03.04.2018;2018;04;03;Tiistai;2;4;6;0;1;1
96;03.04.2018;2018;04;04;Tiistai;0;0;0;3;3;6
96;03.04.2018;2018;04;05;Tiistai;0;7;7;0;0;0
96;03.04.2018;2018;04;06;Tiistai;37;7;44;8;4;12
96;03.04.2018;2018;04;07;Tiistai;64;23;87;33;17;50
96;03.04.2018;2018;04;08;Tiistai;89;49;138;19;15;34
96;03.04.2018;2018;04;09;Tiistai;38;36;74;16;12;28
96;03.04.2018;2018;04;10;Tiistai;24;20;44;17;26;43
96;03.04.2018;2018;04;11;Tiistai;29;18;47;13;21;34
96;03.04.2018;2018;04;12;Tiistai;43;19;62;20;29;49
96;03.04.2018;2018;04;13;Tiistai;24;23;47;8;19;27
96;03.04.2018;2018;04;14;Tiistai;29;81;110;11;33;44
96;03.04.2018;2018;04;15;Tiistai;49;59;108;15;74;89
96;03.04.2018;2018;04;16;Tiistai;43;60;103;12;53;65
96;03.04.2018;2018;04;17;Tiistai;43;28;71;18;31;49
96;03.04.2018;2018;04;18;Tiistai;31;23;54;11;25;36
96;03.04.2018;2018;04;19;Tiistai;31;16;47;5;15;20
96;03.04.2018;2018;04;20;Tiistai;25;6;31;14;10;24
96;03.04.2018;2018;04;21;Tiistai;28;18;46;15;16;31
96;03.04.2018;2018;04;22;Tiistai;9;7;16;4;4;8
96;03.04.2018;2018;04;23;Tiistai;0;3;3;0;0;0
96;04.04.2018;2018;04;00;Keskiviikko;5;0;5;0;0;0
96;04.04.2018;2018;04;01;Keskiviikko;1;0;1;0;0;0
96;04.04.2018;2018;04;02;Keskiviikko;1;0;1;0;0;0
96;04.04.2018;2018;04;03;Keskiviikko;2;0;2;0;0;0
96;04.04.2018;2018;04;04;Keskiviikko;3;0;3;0;0;0
96;04.04.2018;2018;04;05;Keskiviikko;2;3;5;0;4;4
96;04.04.2018;2018;04;06;Keskiviikko;36;16;52;9;10;19
96;04.04.2018;2018;04;07;Keskiviikko;66;40;106;29;34;63
96;04.04.2018;2018;04;08;Keskiviikko;104;59;163;26;37;63
96;04.04.2018;2018;04;09;Keskiviikko;45;28;73;24;22;46
96;04.04.2018;2018;04;10;Keskiviikko;33;26;59;12;29;41
96;04.04.2018;2018;04;11;Keskiviikko;38;24;62;20;30;50
96;04.04.2018;2018;04;12;Keskiviikko;77;25;102;18;26;44
96;04.04.2018;2018;04;13;Keskiviikko;34;47;81;15;31;46
96;04.04.2018;2018;04;14;Keskiviikko;49;59;108;9;41;50
96;04.04.2018;2018;04;15;Keskiviikko;35;85;120;25;78;103
96;04.04.2018;2018;04;16;Keskiviikko;58;75;133;17;55;72
96;04.04.2018;2018;04;17;Keskiviikko;41;30;71;19;24;43
96;04.04.2018;2018;04;18;Keskiviikko;56;26;82;47;26;73
96;04.04.2018;2018;04;19;Keskiviikko;40;23;63;27;32;59
96;04.04.2018;2018;04;20;Keskiviikko;30;26;56;11;25;36
96;04.04.2018;2018;04;21;Keskiviikko;19;24;43;8;16;24
96;04.04.2018;2018;04;22;Keskiviikko;1;7;8;0;2;2
96;04.04.2018;2018;04;23;Keskiviikko;1;0;1;1;0;1
96;05.04.2018;2018;04;00;Torstai;3;1;4;1;1;2
96;05.04.2018;2018;04;01;Torstai;2;0;2;0;0;0
96;05.04.2018;2018;04;02;Torstai;1;0;1;0;0;0
96;05.04.2018;2018;04;03;Torstai;0;0;0;0;0;0
96;05.04.2018;2018;04;04;Torstai;0;1;1;0;1;1
96;05.04.2018;2018;04;05;Torstai;5;5;10;4;0;4
96;05.04.2018;2018;04;06;Torstai;41;10;51;6;4;10
96;05.04.2018;2018;04;07;Torstai;60;40;100;32;13;45
96;05.04.2018;2018;04;08;Torstai;85;66;151;31;14;45
96;05.04.2018;2018;04;09;Torstai;56;30;86;15;12;27
96;05.04.2018;2018;04;10;Torstai;39;28;67;13;20;33
96;05.04.2018;2018;04;11;Torstai;52;47;99;15;24;39
96;05.04.2018;2018;04;12;Torstai;49;32;81;9;21;30
96;05.04.2018;2018;04;13;Torstai;52;29;81;11;31;42
96;05.04.2018;2018;04;14;Torstai;27;76;103;10;45;55
96;05.04.2018;2018;04;15;Torstai;52;93;145;6;54;60
96;05.04.2018;2018;04;16;Torstai;70;79;149;23;49;72
96;05.04.2018;2018;04;17;Torstai;38;39;77;8;19;27
96;05.04.2018;2018;04;18;Torstai;26;33;59;17;13;30
96;05.04.2018;2018;04;19;Torstai;28;24;52;8;13;21
96;05.04.2018;2018;04;20;Torstai;26;16;42;7;5;12
96;05.04.2018;2018;04;21;Torstai;24;26;50;2;11;13
96;05.04.2018;2018;04;22;Torstai;5;7;12;11;10;21
96;05.04.2018;2018;04;23;Torstai;1;0;1;1;1;2
96;06.04.2018;2018;04;00;Perjantai;2;0;2;0;0;0
96;06.04.2018;2018;04;01;Perjantai;2;0;2;1;0;1
96;06.04.2018;2018;04;02;Perjantai;3;0;3;2;0;2
96;06.04.2018;2018;04;03;Perjantai;0;0;0;0;0;0
96;06.04.2018;2018;04;04;Perjantai;3;0;3;1;1;2
96;06.04.2018;2018;04;05;Perjantai;1;2;3;0;0;0
96;06.04.2018;2018;04;06;Perjantai;34;11;45;16;4;20
96;06.04.2018;2018;04;07;Perjantai;70;17;87;21;11;32
96;06.04.2018;2018;04;08;Perjantai;55;31;86;16;14;30
96;06.04.2018;2018;04;09;Perjantai;35;21;56;11;13;24
96;06.04.2018;2018;04;10;Perjantai;19;19;38;9;8;17
96;06.04.2018;2018;04;11;Perjantai;45;24;69;10;13;23
96;06.04.2018;2018;04;12;Perjantai;34;31;65;9;17;26
96;06.04.2018;2018;04;13;Perjantai;29;32;61;7;26;33
96;06.04.2018;2018;04;14;Perjantai;17;29;46;8;62;70
96;06.04.2018;2018;04;15;Perjantai;29;33;62;14;76;90
96;06.04.2018;2018;04;16;Perjantai;28;14;42;3;55;58
96;06.04.2018;2018;04;17;Perjantai;21;9;30;7;29;36
96;06.04.2018;2018;04;18;Perjantai;17;12;29;3;14;17
96;06.04.2018;2018;04;19;Perjantai;6;7;13;10;9;19
96;06.04.2018;2018;04;20;Perjantai;12;5;17;10;10;20
96;06.04.2018;2018;04;21;Perjantai;17;1;18;10;19;29
96;06.04.2018;2018;04;22;Perjantai;0;2;2;5;8;13
96;06.04.2018;2018;04;23;Perjantai;0;0;0;5;7;12
96;07.04.2018;2018;04;00;Lauantai;1;0;1;4;3;7
96;07.04.2018;2018;04;01;Lauantai;0;1;1;3;1;4
96;07.04.2018;2018;04;02;Lauantai;0;0;0;3;2;5
96;07.04.2018;2018;04;03;Lauantai;1;0;1;1;0;1
96;07.04.2018;2018;04;04;Lauantai;0;0;0;4;1;5
96;07.04.2018;2018;04;05;Lauantai;0;0;0;4;0;4
96;07.04.2018;2018;04;06;Lauantai;0;0;0;21;1;22
96;07.04.2018;2018;04;07;Lauantai;0;0;0;3;15;18
96;07.04.2018;2018;04;08;Lauantai;0;1;1;10;14;24
96;07.04.2018;2018;04;09;Lauantai;0;0;0;11;27;38
96;07.04.2018;2018;04;10;Lauantai;0;0;0;33;18;51
96;07.04.2018;2018;04;11;Lauantai;1;2;3;23;36;59
96;07.04.2018;2018;04;12;Lauantai;5;0;5;39;34;73
96;07.04.2018;2018;04;13;Lauantai;11;1;12;22;30;52
96;07.04.2018;2018;04;14;Lauantai;17;4;21;32;46;78
96;07.04.2018;2018;04;15;Lauantai;7;8;15;16;37;53
96;07.04.2018;2018;04;16;Lauantai;6;7;13;13;45;58
96;07.04.2018;2018;04;17;Lauantai;11;5;16;21;9;30
96;07.04.2018;2018;04;18;Lauantai;12;0;12;25;7;32
96;07.04.2018;2018;04;19;Lauantai;18;3;21;40;19;59
96;07.04.2018;2018;04;20;Lauantai;4;7;11;8;10;18
96;07.04.2018;2018;04;21;Lauantai;6;9;15;10;13;23
96;07.04.2018;2018;04;22;Lauantai;2;4;6;2;4;6
96;07.04.2018;2018;04;23;Lauantai;1;0;1;3;1;4
96;08.04.2018;2018;04;00;Sunnuntai;0;3;3;0;0;0
96;08.04.2018;2018;04;01;Sunnuntai;7;2;9;0;0;0
96;08.04.2018;2018;04;02;Sunnuntai;2;0;2;4;0;4
96;08.04.2018;2018;04;03;Sunnuntai;1;1;2;0;0;0
96;08.04.2018;2018;04;04;Sunnuntai;3;1;4;1;0;1
96;08.04.2018;2018;04;05;Sunnuntai;3;1;4;3;0;3
96;08.04.2018;2018;04;06;Sunnuntai;12;0;12;4;0;4
96;08.04.2018;2018;04;07;Sunnuntai;1;7;8;0;4;4
96;08.04.2018;2018;04;08;Sunnuntai;4;2;6;11;4;15
96;08.04.2018;2018;04;09;Sunnuntai;1;4;5;4;10;14
96;08.04.2018;2018;04;10;Sunnuntai;7;7;14;11;12;23
96;08.04.2018;2018;04;11;Sunnuntai;5;6;11;10;16;26
96;08.04.2018;2018;04;12;Sunnuntai;12;7;19;11;22;33
96;08.04.2018;2018;04;13;Sunnuntai;20;8;28;18;21;39
96;08.04.2018;2018;04;14;Sunnuntai;12;10;22;10;18;28
96;08.04.2018;2018;04;15;Sunnuntai;13;10;23;10;19;29
96;08.04.2018;2018;04;16;Sunnuntai;14;8;22;37;22;59
96;08.04.2018;2018;04;17;Sunnuntai;13;5;18;13;18;31
96;08.04.2018;2018;04;18;Sunnuntai;9;7;16;17;31;48
96;08.04.2018;2018;04;19;Sunnuntai;11;4;15;11;20;31
96;08.04.2018;2018;04;20;Sunnuntai;6;11;17;22;37;59
96;08.04.2018;2018;04;21;Sunnuntai;12;6;18;7;10;17
96;08.04.2018;2018;04;22;Sunnuntai;3;4;7;2;2;4
96;08.04.2018;2018;04;23;Sunnuntai;1;0;1;2;1;3
96;09.04.2018;2018;04;00;Maanantai;2;1;3;3;0;3
96;09.04.2018;2018;04;01;Maanantai;1;0;1;0;0;0
96;09.04.2018;2018;04;02;Maanantai;2;0;2;0;0;0
96;09.04.2018;2018;04;03;Maanantai;0;0;0;0;0;0
96;09.04.2018;2018;04;04;Maanantai;0;0;0;0;0;0
96;09.04.2018;2018;04;05;Maanantai;6;3;9;0;1;1
96;09.04.2018;2018;04;06;Maanantai;33;4;37;13;8;21
96;09.04.2018;2018;04;07;Maanantai;81;32;113;37;14;51
96;09.04.2018;2018;04;08;Maanantai;78;40;118;24;10;34
96;09.04.2018;2018;04;09;Maanantai;32;27;59;26;7;33
96;09.04.2018;2018;04;10;Maanantai;27;14;41;14;15;29
96;09.04.2018;2018;04;11;Maanantai;26;26;52;15;14;29
96;09.04.2018;2018;04;12;Maanantai;23;39;62;23;14;37
96;09.04.2018;2018;04;13;Maanantai;34;43;77;19;32;51
96;09.04.2018;2018;04;14;Maanantai;45;29;74;21;49;70
96;09.04.2018;2018;04;15;Maanantai;44;60;104;19;95;114
96;09.04.2018;2018;04;16;Maanantai;42;70;112;18;76;94
96;09.04.2018;2018;04;17;Maanantai;20;31;51;20;31;51
96;09.04.2018;2018;04;18;Maanantai;21;26;47;17;32;49
96;09.04.2018;2018;04;19;Maanantai;22;9;31;21;31;52
96;09.04.2018;2018;04;20;Maanantai;16;2;18;19;23;42
96;09.04.2018;2018;04;21;Maanantai;15;6;21;11;16;27
96;09.04.2018;2018;04;22;Maanantai;2;6;8;3;9;12
96;09.04.2018;2018;04;23;Maanantai;0;0;0;1;1;2
96;10.04.2018;2018;04;00;Tiistai;1;0;1;2;0;2
96;10.04.2018;2018;04;01;Tiistai;0;0;0;0;0;0
96;10.04.2018;2018;04;02;Tiistai;1;0;1;0;0;0
96;10.04.2018;2018;04;03;Tiistai;0;0;0;0;0;0
96;10.04.2018;2018;04;04;Tiistai;0;1;1;0;4;4
96;10.04.2018;2018;04;05;Tiistai;5;1;6;0;2;2
96;10.04.2018;2018;04;06;Tiistai;40;2;42;13;9;22
96;10.04.2018;2018;04;07;Tiistai;82;36;118;48;32;80
96;10.04.2018;2018;04;08;Tiistai;97;44;141;36;48;84
96;10.04.2018;2018;04;09;Tiistai;58;25;83;24;28;52
96;10.04.2018;2018;04;10;Tiistai;31;11;42;31;29;60
96;10.04.2018;2018;04;11;Tiistai;40;15;55;20;31;51
96;10.04.2018;2018;04;12;Tiistai;36;16;52;26;42;68
96;10.04.2018;2018;04;13;Tiistai;42;28;70;23;34;57
96;10.04.2018;2018;04;14;Tiistai;37;67;104;15;36;51
96;10.04.2018;2018;04;15;Tiistai;38;104;142;14;68;82
96;10.04.2018;2018;04;16;Tiistai;53;119;172;14;50;64
96;10.04.2018;2018;04;17;Tiistai;34;43;77;14;22;36
96;10.04.2018;2018;04;18;Tiistai;23;18;41;15;19;34
96;10.04.2018;2018;04;19;Tiistai;43;30;73;21;36;57
96;10.04.2018;2018;04;20;Tiistai;22;16;38;14;12;26
96;10.04.2018;2018;04;21;Tiistai;15;30;45;11;15;26
96;10.04.2018;2018;04;22;Tiistai;13;8;21;1;9;10
96;10.04.2018;2018;04;23;Tiistai;2;0;2;0;0;0
96;11.04.2018;2018;04;00;Keskiviikko;4;0;4;0;0;0
96;11.04.2018;2018;04;01;Keskiviikko;1;0;1;0;0;0
96;11.04.2018;2018;04;02;Keskiviikko;2;0;2;1;1;2
96;11.04.2018;2018;04;03;Keskiviikko;0;0;0;0;0;0
96;11.04.2018;2018;04;04;Keskiviikko;1;0;1;0;1;1
96;11.04.2018;2018;04;05;Keskiviikko;6;6;12;0;2;2
96;11.04.2018;2018;04;06;Keskiviikko;40;8;48;13;3;16
96;11.04.2018;2018;04;07;Keskiviikko;82;53;135;35;9;44
96;11.04.2018;2018;04;08;Keskiviikko;104;67;171;19;10;29
96;11.04.2018;2018;04;09;Keskiviikko;61;33;94;24;13;37
96;11.04.2018;2018;04;10;Keskiviikko;35;23;58;20;17;37
96;11.04.2018;2018;04;11;Keskiviikko;44;39;83;17;24;41
96;11.04.2018;2018;04;12;Keskiviikko;52;46;98;15;18;33
96;11.04.2018;2018;04;13;Keskiviikko;62;56;118;13;22;35
96;11.04.2018;2018;04;14;Keskiviikko;51;66;117;15;25;40
96;11.04.2018;2018;04;15;Keskiviikko;49;123;172;16;54;70
96;11.04.2018;2018;04;16;Keskiviikko;58;111;169;21;44;65
96;11.04.2018;2018;04;17;Keskiviikko;42;50;92;19;28;47
96;11.04.2018;2018;04;18;Keskiviikko;55;36;91;21;26;47
96;11.04.2018;2018;04;19;Keskiviikko;34;26;60;18;9;27
96;11.04.2018;2018;04;20;Keskiviikko;21;18;39;8;17;25
96;11.04.2018;2018;04;21;Keskiviikko;27;28;55;19;13;32
96;11.04.2018;2018;04;22;Keskiviikko;7;11;18;1;3;4
96;11.04.2018;2018;04;23;Keskiviikko;2;1;3;0;0;0
96;12.04.2018;2018;04;00;Torstai;0;2;2;2;0;2
96;12.04.2018;2018;04;01;Torstai;1;1;2;0;0;0
96;12.04.2018;2018;04;02;Torstai;1;1;2;0;1;1
96;12.04.2018;2018;04;03;Torstai;0;0;0;0;0;0
96;12.04.2018;2018;04;04;Torstai;0;1;1;0;0;0
96;12.04.2018;2018;04;05;Torstai;4;2;6;0;0;0
96;12.04.2018;2018;04;06;Torstai;47;14;61;12;2;14
96;12.04.2018;2018;04;07;Torstai;91;57;148;26;8;34
96;12.04.2018;2018;04;08;Torstai;101;50;151;29;13;42
96;12.04.2018;2018;04;09;Torstai;75;37;112;16;13;29
96;12.04.2018;2018;04;10;Torstai;34;31;65;10;13;23
96;12.04.2018;2018;04;11;Torstai;32;42;74;15;17;32
96;12.04.2018;2018;04;12;Torstai;49;55;104;14;23;37
96;12.04.2018;2018;04;13;Torstai;45;67;112;10;11;21
96;12.04.2018;2018;04;14;Torstai;40;95;135;10;29;39
96;12.04.2018;2018;04;15;Torstai;62;120;182;13;51;64
96;12.04.2018;2018;04;16;Torstai;67;98;165;13;29;42
96;12.04.2018;2018;04;17;Torstai;36;51;87;11;22;33
96;12.04.2018;2018;04;18;Torstai;41;27;68;17;10;27
96;12.04.2018;2018;04;19;Torstai;17;16;33;16;16;32
96;12.04.2018;2018;04;20;Torstai;17;12;29;7;12;19
96;12.04.2018;2018;04;21;Torstai;13;24;37;6;3;9
96;12.04.2018;2018;04;22;Torstai;6;9;15;1;1;2
96;12.04.2018;2018;04;23;Torstai;6;1;7;0;4;4
96;13.04.2018;2018;04;00;Perjantai;2;0;2;1;0;1
96;13.04.2018;2018;04;01;Perjantai;4;0;4;0;1;1
96;13.04.2018;2018;04;02;Perjantai;0;0;0;0;0;0
96;13.04.2018;2018;04;03;Perjantai;1;0;1;1;0;1
96;13.04.2018;2018;04;04;Perjantai;1;1;2;1;0;1
96;13.04.2018;2018;04;05;Perjantai;4;1;5;1;1;2
96;13.04.2018;2018;04;06;Perjantai;39;13;52;9;0;9
96;13.04.2018;2018;04;07;Perjantai;102;47;149;30;15;45
96;13.04.2018;2018;04;08;Perjantai;71;52;123;21;7;28
96;13.04.2018;2018;04;09;Perjantai;44;39;83;6;8;14
96;13.04.2018;2018;04;10;Perjantai;34;32;66;17;14;31
96;13.04.2018;2018;04;11;Perjantai;38;45;83;15;11;26
96;13.04.2018;2018;04;12;Perjantai;46;54;100;16;27;43
96;13.04.2018;2018;04;13;Perjantai;36;65;101;15;19;34
96;13.04.2018;2018;04;14;Perjantai;45;84;129;15;34;49
96;13.04.2018;2018;04;15;Perjantai;37;104;141;16;34;50
96;13.04.2018;2018;04;16;Perjantai;68;72;140;16;24;40
96;13.04.2018;2018;04;17;Perjantai;34;41;75;14;11;25
96;13.04.2018;2018;04;18;Perjantai;41;20;61;8;14;22
96;13.04.2018;2018;04;19;Perjantai;24;27;51;11;12;23
96;13.04.2018;2018;04;20;Perjantai;25;19;44;6;5;11
96;13.04.2018;2018;04;21;Perjantai;17;15;32;6;5;11
96;13.04.2018;2018;04;22;Perjantai;10;6;16;4;6;10
96;13.04.2018;2018;04;23;Perjantai;7;0;7;0;0;0
96;14.04.2018;2018;04;00;Lauantai;5;7;12;0;0;0
96;14.04.2018;2018;04;01;Lauantai;1;1;2;1;1;2
96;14.04.2018;2018;04;02;Lauantai;5;0;5;2;0;2
96;14.04.2018;2018;04;03;Lauantai;6;0;6;3;0;3
96;14.04.2018;2018;04;04;Lauantai;3;0;3;2;1;3
96;14.04.2018;2018;04;05;Lauantai;2;2;4;0;1;1
96;14.04.2018;2018;04;06;Lauantai;14;1;15;7;0;7
96;14.04.2018;2018;04;07;Lauantai;2;11;13;3;4;7
96;14.04.2018;2018;04;08;Lauantai;5;8;13;5;3;8
96;14.04.2018;2018;04;09;Lauantai;2;27;29;13;9;22
96;14.04.2018;2018;04;10;Lauantai;12;19;31;5;10;15
96;14.04.2018;2018;04;11;Lauantai;18;29;47;17;14;31
96;14.04.2018;2018;04;12;Lauantai;28;27;55;15;10;25
96;14.04.2018;2018;04;13;Lauantai;37;25;62;18;17;35
96;14.04.2018;2018;04;14;Lauantai;28;38;66;15;15;30
96;14.04.2018;2018;04;15;Lauantai;36;35;71;14;19;33
96;14.04.2018;2018;04;16;Lauantai;32;48;80;17;33;50
96;14.04.2018;2018;04;17;Lauantai;26;22;48;14;16;30
96;14.04.2018;2018;04;18;Lauantai;29;15;44;19;12;31
96;14.04.2018;2018;04;19;Lauantai;39;16;55;35;2;37
96;14.04.2018;2018;04;20;Lauantai;22;11;33;3;16;19
96;14.04.2018;2018;04;21;Lauantai;7;11;18;3;10;13
96;14.04.2018;2018;04;22;Lauantai;15;2;17;0;2;2
96;14.04.2018;2018;04;23;Lauantai;4;0;4;1;2;3
96;15.04.2018;2018;04;00;Sunnuntai;4;3;7;1;1;2
96;15.04.2018;2018;04;01;Sunnuntai;6;1;7;1;0;1
96;15.04.2018;2018;04;02;Sunnuntai;2;0;2;1;1;2
96;15.04.2018;2018;04;03;Sunnuntai;2;1;3;0;0;0
96;15.04.2018;2018;04;04;Sunnuntai;5;0;5;0;0;0
96;15.04.2018;2018;04;05;Sunnuntai;2;1;3;4;1;5
96;15.04.2018;2018;04;06;Sunnuntai;13;0;13;10;1;11
96;15.04.2018;2018;04;07;Sunnuntai;3;7;10;2;2;4
96;15.04.2018;2018;04;08;Sunnuntai;1;2;3;5;1;6
96;15.04.2018;2018;04;09;Sunnuntai;9;8;17;7;6;13
96;15.04.2018;2018;04;10;Sunnuntai;7;16;23;10;10;20
96;15.04.2018;2018;04;11;Sunnuntai;12;23;35;23;18;41
96;15.04.2018;2018;04;12;Sunnuntai;13;37;50;24;16;40
96;15.04.2018;2018;04;13;Sunnuntai;40;42;82;19;27;46
96;15.04.2018;2018;04;14;Sunnuntai;41;40;81;21;27;48
96;15.04.2018;2018;04;15;Sunnuntai;33;39;72;25;18;43
96;15.04.2018;2018;04;16;Sunnuntai;44;26;70;39;17;56
96;15.04.2018;2018;04;17;Sunnuntai;26;29;55;13;14;27
96;15.04.2018;2018;04;18;Sunnuntai;31;30;61;24;32;56
96;15.04.2018;2018;04;19;Sunnuntai;22;18;40;10;19;29
96;15.04.2018;2018;04;20;Sunnuntai;21;19;40;9;15;24
96;15.04.2018;2018;04;21;Sunnuntai;9;16;25;2;7;9
96;15.04.2018;2018;04;22;Sunnuntai;5;6;11;1;0;1
96;15.04.2018;2018;04;23;Sunnuntai;2;3;5;4;0;4
96;16.04.2018;2018;04;00;Maanantai;0;1;1;1;1;2
96;16.04.2018;2018;04;01;Maanantai;1;0;1;1;0;1
96;16.04.2018;2018;04;02;Maanantai;2;0;2;0;0;0
96;16.04.2018;2018;04;03;Maanantai;0;0;0;0;0;0
96;16.04.2018;2018;04;04;Maanantai;2;0;2;0;0;0
96;16.04.2018;2018;04;05;Maanantai;5;8;13;1;0;1
96;16.04.2018;2018;04;06;Maanantai;40;18;58;10;1;11
96;16.04.2018;2018;04;07;Maanantai;122;77;199;28;6;34
96;16.04.2018;2018;04;08;Maanantai;134;106;240;19;7;26
96;16.04.2018;2018;04;09;Maanantai;64;45;109;13;8;21
96;16.04.2018;2018;04;10;Maanantai;85;55;140;15;22;37
96;16.04.2018;2018;04;11;Maanantai;67;59;126;14;21;35
96;16.04.2018;2018;04;12;Maanantai;91;77;168;14;27;41
96;16.04.2018;2018;04;13;Maanantai;71;72;143;12;11;23
96;16.04.2018;2018;04;14;Maanantai;75;92;167;16;24;40
96;16.04.2018;2018;04;15;Maanantai;76;152;228;14;38;52
96;16.04.2018;2018;04;16;Maanantai;123;174;297;17;42;59
96;16.04.2018;2018;04;17;Maanantai;51;71;122;19;32;51
96;16.04.2018;2018;04;18;Maanantai;58;39;97;14;17;31
96;16.04.2018;2018;04;19;Maanantai;51;33;84;15;20;35
96;16.04.2018;2018;04;20;Maanantai;48;27;75;11;18;29
96;16.04.2018;2018;04;21;Maanantai;26;31;57;7;9;16
96;16.04.2018;2018;04;22;Maanantai;5;8;13;2;3;5
96;16.04.2018;2018;04;23;Maanantai;4;1;5;1;0;1
96;17.04.2018;2018;04;00;Tiistai;0;0;0;2;0;2
96;17.04.2018;2018;04;01;Tiistai;1;1;2;0;0;0
96;17.04.2018;2018;04;02;Tiistai;0;0;0;0;0;0
96;17.04.2018;2018;04;03;Tiistai;4;0;4;1;0;1
96;17.04.2018;2018;04;04;Tiistai;0;0;0;0;1;1
96;17.04.2018;2018;04;05;Tiistai;4;6;10;0;0;0
96;17.04.2018;2018;04;06;Tiistai;60;20;80;11;3;14
96;17.04.2018;2018;04;07;Tiistai;157;86;243;24;8;32
96;17.04.2018;2018;04;08;Tiistai;158;96;254;25;13;38
96;17.04.2018;2018;04;09;Tiistai;84;72;156;17;10;27
96;17.04.2018;2018;04;10;Tiistai;67;51;118;12;17;29
96;17.04.2018;2018;04;11;Tiistai;74;45;119;23;16;39
96;17.04.2018;2018;04;12;Tiistai;87;60;147;13;13;26
96;17.04.2018;2018;04;13;Tiistai;67;82;149;22;15;37
96;17.04.2018;2018;04;14;Tiistai;78;92;170;9;29;38
96;17.04.2018;2018;04;15;Tiistai;83;159;242;11;47;58
96;17.04.2018;2018;04;16;Tiistai;126;168;294;9;40;49
96;17.04.2018;2018;04;17;Tiistai;57;94;151;22;24;46
96;17.04.2018;2018;04;18;Tiistai;44;56;100;17;34;51
96;17.04.2018;2018;04;19;Tiistai;54;38;92;16;17;33
96;17.04.2018;2018;04;20;Tiistai;42;26;68;9;4;13
96;17.04.2018;2018;04;21;Tiistai;56;40;96;16;17;33
96;17.04.2018;2018;04;22;Tiistai;14;11;25;3;4;7
96;17.04.2018;2018;04;23;Tiistai;4;1;5;1;1;2
96;18.04.2018;2018;04;00;Keskiviikko;3;0;3;0;0;0
96;18.04.2018;2018;04;01;Keskiviikko;2;1;3;0;0;0
96;18.04.2018;2018;04;02;Keskiviikko;1;0;1;0;0;0
96;18.04.2018;2018;04;03;Keskiviikko;1;0;1;0;0;0
96;18.04.2018;2018;04;04;Keskiviikko;0;0;0;0;1;1
96;18.04.2018;2018;04;05;Keskiviikko;6;8;14;0;0;0
96;18.04.2018;2018;04;06;Keskiviikko;63;21;84;6;1;7
96;18.04.2018;2018;04;07;Keskiviikko;129;89;218;28;9;37
96;18.04.2018;2018;04;08;Keskiviikko;139;95;234;17;12;29
96;18.04.2018;2018;04;09;Keskiviikko;92;58;150;27;19;46
96;18.04.2018;2018;04;10;Keskiviikko;54;55;109;20;11;31
96;18.04.2018;2018;04;11;Keskiviikko;93;60;153;15;13;28
96;18.04.2018;2018;04;12;Keskiviikko;87;74;161;17;13;30
96;18.04.2018;2018;04;13;Keskiviikko;93;92;185;4;25;29
96;18.04.2018;2018;04;14;Keskiviikko;77;114;191;11;17;28
96;18.04.2018;2018;04;15;Keskiviikko;84;186;270;8;30;38
96;18.04.2018;2018;04;16;Keskiviikko;113;148;261;15;40;55
96;18.04.2018;2018;04;17;Keskiviikko;93;65;158;13;15;28
96;18.04.2018;2018;04;18;Keskiviikko;81;42;123;30;23;53
96;18.04.2018;2018;04;19;Keskiviikko;52;34;86;21;22;43
96;18.04.2018;2018;04;20;Keskiviikko;65;32;97;10;16;26
96;18.04.2018;2018;04;21;Keskiviikko;35;36;71;7;8;15
96;18.04.2018;2018;04;22;Keskiviikko;11;14;25;4;4;8
96;18.04.2018;2018;04;23;Keskiviikko;2;4;6;1;2;3
96;19.04.2018;2018;04;00;Torstai;2;0;2;0;0;0
96;19.04.2018;2018;04;01;Torstai;0;1;1;0;0;0
96;19.04.2018;2018;04;02;Torstai;3;0;3;1;0;1
96;19.04.2018;2018;04;03;Torstai;1;1;2;0;0;0
96;19.04.2018;2018;04;04;Torstai;1;0;1;0;1;1
96;19.04.2018;2018;04;05;Torstai;3;8;11;0;0;0
96;19.04.2018;2018;04;06;Torstai;75;20;95;9;2;11
96;19.04.2018;2018;04;07;Torstai;169;85;254;20;7;27
96;19.04.2018;2018;04;08;Torstai;111;111;222;19;10;29
96;19.04.2018;2018;04;09;Torstai;106;76;182;13;12;25
96;19.04.2018;2018;04;10;Torstai;82;61;143;12;10;22
96;19.04.2018;2018;04;11;Torstai;89;74;163;13;11;24
96;19.04.2018;2018;04;12;Torstai;90;102;192;14;20;34
96;19.04.2018;2018;04;13;Torstai;97;75;172;9;22;31
96;19.04.2018;2018;04;14;Torstai;83;133;216;10;17;27
96;19.04.2018;2018;04;15;Torstai;132;162;294;12;33;45
96;19.04.2018;2018;04;16;Torstai;113;141;254;14;66;80
96;19.04.2018;2018;04;17;Torstai;89;77;166;15;77;92
96;19.04.2018;2018;04;18;Torstai;85;67;152;26;65;91
96;19.04.2018;2018;04;19;Torstai;50;33;83;15;16;31
96;19.04.2018;2018;04;20;Torstai;47;28;75;6;14;20
96;19.04.2018;2018;04;21;Torstai;38;32;70;5;3;8
96;19.04.2018;2018;04;22;Torstai;8;16;24;4;5;9
96;19.04.2018;2018;04;23;Torstai;10;0;10;1;1;2
96;20.04.2018;2018;04;00;Perjantai;3;0;3;1;0;1
96;20.04.2018;2018;04;01;Perjantai;10;0;10;0;0;0
96;20.04.2018;2018;04;02;Perjantai;5;1;6;0;0;0
96;20.04.2018;2018;04;03;Perjantai;7;0;7;1;0;1
96;20.04.2018;2018;04;04;Perjantai;8;0;8;2;0;2
96;20.04.2018;2018;04;05;Perjantai;5;5;10;0;0;0
96;20.04.2018;2018;04;06;Perjantai;62;21;83;10;3;13
96;20.04.2018;2018;04;07;Perjantai;120;74;194;17;4;21
96;20.04.2018;2018;04;08;Perjantai;104;63;167;8;9;17
96;20.04.2018;2018;04;09;Perjantai;53;36;89;9;5;14
96;20.04.2018;2018;04;10;Perjantai;42;22;64;9;5;14
96;20.04.2018;2018;04;11;Perjantai;58;39;97;4;11;15
96;20.04.2018;2018;04;12;Perjantai;62;66;128;9;10;19
96;20.04.2018;2018;04;13;Perjantai;58;79;137;9;19;28
96;20.04.2018;2018;04;14;Perjantai;62;99;161;8;24;32
96;20.04.2018;2018;04;15;Perjantai;89;101;190;9;32;41
96;20.04.2018;2018;04;16;Perjantai;73;75;148;12;15;27
96;20.04.2018;2018;04;17;Perjantai;56;38;94;11;7;18
96;20.04.2018;2018;04;18;Perjantai;40;28;68;9;12;21
96;20.04.2018;2018;04;19;Perjantai;29;15;44;4;8;12
96;20.04.2018;2018;04;20;Perjantai;28;20;48;6;7;13
96;20.04.2018;2018;04;21;Perjantai;29;17;46;4;3;7
96;20.04.2018;2018;04;22;Perjantai;9;12;21;1;1;2
96;20.04.2018;2018;04;23;Perjantai;9;3;12;2;2;4
96;21.04.2018;2018;04;00;Lauantai;6;0;6;0;0;0
96;21.04.2018;2018;04;01;Lauantai;4;2;6;2;2;4
96;21.04.2018;2018;04;02;Lauantai;6;2;8;0;1;1
96;21.04.2018;2018;04;03;Lauantai;2;0;2;0;0;0
96;21.04.2018;2018;04;04;Lauantai;6;3;9;2;0;2
96;21.04.2018;2018;04;05;Lauantai;2;2;4;0;0;0
96;21.04.2018;2018;04;06;Lauantai;21;5;26;6;0;6
96;21.04.2018;2018;04;07;Lauantai;6;7;13;4;2;6
96;21.04.2018;2018;04;08;Lauantai;17;15;32;11;4;15
96;21.04.2018;2018;04;09;Lauantai;8;33;41;5;9;14
96;21.04.2018;2018;04;10;Lauantai;9;32;41;10;14;24
96;21.04.2018;2018;04;11;Lauantai;31;57;88;6;44;50
96;21.04.2018;2018;04;12;Lauantai;56;47;103;21;32;53
96;21.04.2018;2018;04;13;Lauantai;81;36;117;48;25;73
96;21.04.2018;2018;04;14;Lauantai;55;36;91;28;12;40
96;21.04.2018;2018;04;15;Lauantai;63;43;106;32;12;44
96;21.04.2018;2018;04;16;Lauantai;43;55;98;15;21;36
96;21.04.2018;2018;04;17;Lauantai;32;23;55;9;9;18
96;21.04.2018;2018;04;18;Lauantai;25;26;51;13;3;16
96;21.04.2018;2018;04;19;Lauantai;29;16;45;14;12;26
96;21.04.2018;2018;04;20;Lauantai;68;14;82;18;10;28
96;21.04.2018;2018;04;21;Lauantai;17;24;41;0;8;8
96;21.04.2018;2018;04;22;Lauantai;16;11;27;0;4;4
96;21.04.2018;2018;04;23;Lauantai;13;6;19;3;1;4
96;22.04.2018;2018;04;00;Sunnuntai;5;6;11;0;0;0
96;22.04.2018;2018;04;01;Sunnuntai;4;3;7;2;1;3
96;22.04.2018;2018;04;02;Sunnuntai;11;0;11;1;0;1
96;22.04.2018;2018;04;03;Sunnuntai;3;0;3;0;0;0
96;22.04.2018;2018;04;04;Sunnuntai;6;1;7;2;0;2
96;22.04.2018;2018;04;05;Sunnuntai;6;4;10;1;1;2
96;22.04.2018;2018;04;06;Sunnuntai;9;3;12;3;0;3
96;22.04.2018;2018;04;07;Sunnuntai;3;6;9;3;4;7
96;22.04.2018;2018;04;08;Sunnuntai;2;7;9;7;5;12
96;22.04.2018;2018;04;09;Sunnuntai;9;23;32;4;6;10
96;22.04.2018;2018;04;10;Sunnuntai;9;35;44;9;17;26
96;22.04.2018;2018;04;11;Sunnuntai;38;50;88;27;44;71
96;22.04.2018;2018;04;12;Sunnuntai;52;72;124;31;37;68
96;22.04.2018;2018;04;13;Sunnuntai;65;57;122;40;14;54
96;22.04.2018;2018;04;14;Sunnuntai;67;50;117;29;13;42
96;22.04.2018;2018;04;15;Sunnuntai;65;29;94;18;13;31
96;22.04.2018;2018;04;16;Sunnuntai;78;28;106;39;18;57
96;22.04.2018;2018;04;17;Sunnuntai;35;29;64;10;7;17
96;22.04.2018;2018;04;18;Sunnuntai;42;20;62;16;30;46
96;22.04.2018;2018;04;19;Sunnuntai;36;24;60;11;20;31
96;22.04.2018;2018;04;20;Sunnuntai;36;17;53;8;14;22
96;22.04.2018;2018;04;21;Sunnuntai;19;21;40;5;6;11
96;22.04.2018;2018;04;22;Sunnuntai;3;9;12;1;6;7
96;22.04.2018;2018;04;23;Sunnuntai;1;1;2;1;2;3
96;23.04.2018;2018;04;00;Maanantai;4;0;4;2;1;3
96;23.04.2018;2018;04;01;Maanantai;0;0;0;0;0;0
96;23.04.2018;2018;04;02;Maanantai;1;0;1;0;0;0
96;23.04.2018;2018;04;03;Maanantai;5;0;5;0;0;0
96;23.04.2018;2018;04;04;Maanantai;0;1;1;0;0;0
96;23.04.2018;2018;04;05;Maanantai;5;8;13;0;1;1
96;23.04.2018;2018;04;06;Maanantai;68;25;93;3;2;5
96;23.04.2018;2018;04;07;Maanantai;131;81;212;21;5;26
96;23.04.2018;2018;04;08;Maanantai;137;121;258;17;4;21
96;23.04.2018;2018;04;09;Maanantai;91;71;162;24;43;67
96;23.04.2018;2018;04;10;Maanantai;117;45;162;13;13;26
96;23.04.2018;2018;04;11;Maanantai;70;56;126;35;22;57
96;23.04.2018;2018;04;12;Maanantai;69;56;125;21;10;31
96;23.04.2018;2018;04;13;Maanantai;80;93;173;12;19;31
96;23.04.2018;2018;04;14;Maanantai;74;132;206;17;24;41
96;23.04.2018;2018;04;15;Maanantai;79;176;255;12;31;43
96;23.04.2018;2018;04;16;Maanantai;116;204;320;9;41;50
96;23.04.2018;2018;04;17;Maanantai;85;91;176;11;19;30
96;23.04.2018;2018;04;18;Maanantai;63;67;130;18;15;33
96;23.04.2018;2018;04;19;Maanantai;73;36;109;12;19;31
96;23.04.2018;2018;04;20;Maanantai;47;26;73;24;13;37
96;23.04.2018;2018;04;21;Maanantai;38;32;70;6;7;13
96;23.04.2018;2018;04;22;Maanantai;10;16;26;2;4;6
96;23.04.2018;2018;04;23;Maanantai;2;5;7;0;0;0
96;24.04.2018;2018;04;00;Tiistai;2;2;4;3;0;3
96;24.04.2018;2018;04;01;Tiistai;4;1;5;0;0;0
96;24.04.2018;2018;04;02;Tiistai;4;0;4;0;0;0
96;24.04.2018;2018;04;03;Tiistai;6;0;6;0;0;0
96;24.04.2018;2018;04;04;Tiistai;1;1;2;0;0;0
96;24.04.2018;2018;04;05;Tiistai;6;8;14;2;2;4
96;24.04.2018;2018;04;06;Tiistai;59;31;90;10;1;11
96;24.04.2018;2018;04;07;Tiistai;150;101;251;24;8;32
96;24.04.2018;2018;04;08;Tiistai;138;102;240;14;8;22
96;24.04.2018;2018;04;09;Tiistai;84;48;132;13;8;21
96;24.04.2018;2018;04;10;Tiistai;65;65;130;15;12;27
96;24.04.2018;2018;04;11;Tiistai;65;59;124;12;15;27
96;24.04.2018;2018;04;12;Tiistai;71;84;155;15;16;31
96;24.04.2018;2018;04;13;Tiistai;67;80;147;6;13;19
96;24.04.2018;2018;04;14;Tiistai;54;109;163;11;14;25
96;24.04.2018;2018;04;15;Tiistai;100;176;276;8;20;28
96;24.04.2018;2018;04;16;Tiistai;93;176;269;13;31;44
96;24.04.2018;2018;04;17;Tiistai;56;83;139;11;31;42
96;24.04.2018;2018;04;18;Tiistai;56;57;113;13;16;29
96;24.04.2018;2018;04;19;Tiistai;57;30;87;5;7;12
96;24.04.2018;2018;04;20;Tiistai;51;30;81;6;4;10
96;24.04.2018;2018;04;21;Tiistai;65;30;95;27;10;37
96;24.04.2018;2018;04;22;Tiistai;8;15;23;0;5;5
96;24.04.2018;2018;04;23;Tiistai;4;3;7;0;0;0
96;25.04.2018;2018;04;00;Keskiviikko;8;1;9;0;0;0
96;25.04.2018;2018;04;01;Keskiviikko;1;0;1;0;0;0
96;25.04.2018;2018;04;02;Keskiviikko;1;1;2;1;0;1
96;25.04.2018;2018;04;03;Keskiviikko;2;0;2;0;0;0
96;25.04.2018;2018;04;04;Keskiviikko;0;0;0;0;1;1
96;25.04.2018;2018;04;05;Keskiviikko;7;7;14;0;1;1
96;25.04.2018;2018;04;06;Keskiviikko;65;20;85;5;2;7
96;25.04.2018;2018;04;07;Keskiviikko;131;89;220;16;8;24
96;25.04.2018;2018;04;08;Keskiviikko;108;90;198;22;7;29
96;25.04.2018;2018;04;09;Keskiviikko;91;54;145;10;7;17
96;25.04.2018;2018;04;10;Keskiviikko;47;62;109;13;14;27
96;25.04.2018;2018;04;11;Keskiviikko;77;68;145;17;10;27
96;25.04.2018;2018;04;12;Keskiviikko;93;109;202;10;14;24
96;25.04.2018;2018;04;13;Keskiviikko;77;65;142;13;12;25
96;25.04.2018;2018;04;14;Keskiviikko;76;117;193;11;24;35
96;25.04.2018;2018;04;15;Keskiviikko;74;169;243;10;34;44
96;25.04.2018;2018;04;16;Keskiviikko;105;157;262;5;33;38
96;25.04.2018;2018;04;17;Keskiviikko;71;68;139;20;16;36
96;25.04.2018;2018;04;18;Keskiviikko;86;64;150;21;24;45
96;25.04.2018;2018;04;19;Keskiviikko;57;38;95;10;14;24
96;25.04.2018;2018;04;20;Keskiviikko;35;36;71;13;8;21
96;25.04.2018;2018;04;21;Keskiviikko;24;32;56;6;12;18
96;25.04.2018;2018;04;22;Keskiviikko;9;8;17;0;5;5
96;25.04.2018;2018;04;23;Keskiviikko;6;8;14;0;2;2
96;26.04.2018;2018;04;00;Torstai;1;0;1;0;0;0
96;26.04.2018;2018;04;01;Torstai;7;0;7;1;0;1
96;26.04.2018;2018;04;02;Torstai;5;2;7;1;0;1
96;26.04.2018;2018;04;03;Torstai;5;0;5;0;0;0
96;26.04.2018;2018;04;04;Torstai;3;2;5;1;0;1
96;26.04.2018;2018;04;05;Torstai;9;5;14;1;1;2
96;26.04.2018;2018;04;06;Torstai;49;20;69;3;1;4
96;26.04.2018;2018;04;07;Torstai;119;89;208;21;4;25
96;26.04.2018;2018;04;08;Torstai;117;107;224;14;8;22
96;26.04.2018;2018;04;09;Torstai;104;67;171;12;6;18
96;26.04.2018;2018;04;10;Torstai;60;47;107;10;10;20
96;26.04.2018;2018;04;11;Torstai;75;76;151;10;11;21
96;26.04.2018;2018;04;12;Torstai;60;67;127;10;9;19
96;26.04.2018;2018;04;13;Torstai;119;78;197;7;12;19
96;26.04.2018;2018;04;14;Torstai;70;158;228;12;16;28
96;26.04.2018;2018;04;15;Torstai;70;124;194;14;27;41
96;26.04.2018;2018;04;16;Torstai;94;145;239;9;30;39
96;26.04.2018;2018;04;17;Torstai;70;63;133;17;14;31
96;26.04.2018;2018;04;18;Torstai;83;52;135;17;22;39
96;26.04.2018;2018;04;19;Torstai;70;33;103;12;11;23
96;26.04.2018;2018;04;20;Torstai;39;40;79;8;8;16
96;26.04.2018;2018;04;21;Torstai;37;40;77;5;9;14
96;26.04.2018;2018;04;22;Torstai;18;23;41;2;2;4
96;26.04.2018;2018;04;23;Torstai;5;6;11;1;1;2
96;27.04.2018;2018;04;00;Perjantai;6;1;7;0;0;0
96;27.04.2018;2018;04;01;Perjantai;8;0;8;1;1;2
96;27.04.2018;2018;04;02;Perjantai;8;0;8;1;0;1
96;27.04.2018;2018;04;03;Perjantai;9;0;9;3;0;3
96;27.04.2018;2018;04;04;Perjantai;1;1;2;1;0;1
96;27.04.2018;2018;04;05;Perjantai;2;6;8;1;1;2
96;27.04.2018;2018;04;06;Perjantai;48;27;75;10;1;11
96;27.04.2018;2018;04;07;Perjantai;121;66;187;16;5;21
96;27.04.2018;2018;04;08;Perjantai;84;85;169;18;6;24
96;27.04.2018;2018;04;09;Perjantai;71;62;133;10;9;19
96;27.04.2018;2018;04;10;Perjantai;53;47;100;13;2;15
96;27.04.2018;2018;04;11;Perjantai;67;69;136;9;10;19
96;27.04.2018;2018;04;12;Perjantai;70;73;143;10;13;23
96;27.04.2018;2018;04;13;Perjantai;68;99;167;16;22;38
96;27.04.2018;2018;04;14;Perjantai;73;122;195;8;22;30
96;27.04.2018;2018;04;15;Perjantai;81;141;222;7;25;32
96;27.04.2018;2018;04;16;Perjantai;98;106;204;6;23;29
96;27.04.2018;2018;04;17;Perjantai;70;57;127;7;18;25
96;27.04.2018;2018;04;18;Perjantai;61;39;100;13;13;26
96;27.04.2018;2018;04;19;Perjantai;51;32;83;7;9;16
96;27.04.2018;2018;04;20;Perjantai;36;34;70;8;4;12
96;27.04.2018;2018;04;21;Perjantai;33;30;63;8;6;14
96;27.04.2018;2018;04;22;Perjantai;12;22;34;2;4;6
96;27.04.2018;2018;04;23;Perjantai;12;16;28;0;4;4
96;28.04.2018;2018;04;00;Lauantai;11;10;21;1;0;1
96;28.04.2018;2018;04;01;Lauantai;10;0;10;1;1;2
96;28.04.2018;2018;04;02;Lauantai;18;1;19;0;0;0
96;28.04.2018;2018;04;03;Lauantai;14;0;14;3;0;3
96;28.04.2018;2018;04;04;Lauantai;9;0;9;1;0;1
96;28.04.2018;2018;04;05;Lauantai;8;2;10;1;0;1
96;28.04.2018;2018;04;06;Lauantai;16;8;24;5;0;5
96;28.04.2018;2018;04;07;Lauantai;4;12;16;0;1;1
96;28.04.2018;2018;04;08;Lauantai;5;16;21;5;6;11
96;28.04.2018;2018;04;09;Lauantai;16;53;69;1;10;11
96;28.04.2018;2018;04;10;Lauantai;18;37;55;5;9;14
96;28.04.2018;2018;04;11;Lauantai;35;56;91;9;4;13
96;28.04.2018;2018;04;12;Lauantai;49;51;100;3;8;11
96;28.04.2018;2018;04;13;Lauantai;52;64;116;4;8;12
96;28.04.2018;2018;04;14;Lauantai;56;54;110;1;7;8
96;28.04.2018;2018;04;15;Lauantai;73;53;126;7;12;19
96;28.04.2018;2018;04;16;Lauantai;57;36;93;7;8;15
96;28.04.2018;2018;04;17;Lauantai;44;54;98;10;6;16
96;28.04.2018;2018;04;18;Lauantai;48;24;72;9;7;16
96;28.04.2018;2018;04;19;Lauantai;37;21;58;13;14;27
96;28.04.2018;2018;04;20;Lauantai;24;27;51;3;6;9
96;28.04.2018;2018;04;21;Lauantai;22;32;54;2;5;7
96;28.04.2018;2018;04;22;Lauantai;17;19;36;2;2;4
96;28.04.2018;2018;04;23;Lauantai;14;21;35;6;3;9
96;29.04.2018;2018;04;00;Sunnuntai;12;12;24;0;1;1
96;29.04.2018;2018;04;01;Sunnuntai;14;9;23;1;1;2
96;29.04.2018;2018;04;02;Sunnuntai;18;1;19;3;0;3
96;29.04.2018;2018;04;03;Sunnuntai;14;0;14;0;1;1
96;29.04.2018;2018;04;04;Sunnuntai;16;0;16;0;0;0
96;29.04.2018;2018;04;05;Sunnuntai;4;1;5;2;0;2
96;29.04.2018;2018;04;06;Sunnuntai;15;2;17;2;1;3
96;29.04.2018;2018;04;07;Sunnuntai;4;10;14;2;2;4
96;29.04.2018;2018;04;08;Sunnuntai;7;12;19;4;6;10
96;29.04.2018;2018;04;09;Sunnuntai;8;17;25;3;3;6
96;29.04.2018;2018;04;10;Sunnuntai;15;19;34;4;6;10
96;29.04.2018;2018;04;11;Sunnuntai;11;48;59;10;7;17
96;29.04.2018;2018;04;12;Sunnuntai;43;38;81;12;5;17
96;29.04.2018;2018;04;13;Sunnuntai;40;43;83;8;8;16
96;29.04.2018;2018;04;14;Sunnuntai;46;47;93;8;4;12
96;29.04.2018;2018;04;15;Sunnuntai;40;61;101;11;16;27
96;29.04.2018;2018;04;16;Sunnuntai;72;40;112;18;9;27
96;29.04.2018;2018;04;17;Sunnuntai;46;45;91;8;18;26
96;29.04.2018;2018;04;18;Sunnuntai;50;33;83;14;16;30
96;29.04.2018;2018;04;19;Sunnuntai;29;36;65;8;16;24
96;29.04.2018;2018;04;20;Sunnuntai;33;32;65;11;5;16
96;29.04.2018;2018;04;21;Sunnuntai;22;39;61;6;12;18
96;29.04.2018;2018;04;22;Sunnuntai;22;5;27;0;0;0
96;29.04.2018;2018;04;23;Sunnuntai;13;5;18;0;0;0
96;30.04.2018;2018;04;00;Maanantai;8;0;8;0;0;0
96;30.04.2018;2018;04;01;Maanantai;6;7;13;1;0;1
96;30.04.2018;2018;04;02;Maanantai;10;0;10;2;0;2
96;30.04.2018;2018;04;03;Maanantai;7;1;8;3;0;3
96;30.04.2018;2018;04;04;Maanantai;7;5;12;0;0;0
96;30.04.2018;2018;04;05;Maanantai;8;7;15;1;1;2
96;30.04.2018;2018;04;06;Maanantai;31;26;57;8;1;9
96;30.04.2018;2018;04;07;Maanantai;63;53;116;6;6;12
96;30.04.2018;2018;04;08;Maanantai;50;59;109;3;6;9
96;30.04.2018;2018;04;09;Maanantai;33;62;95;10;13;23
96;30.04.2018;2018;04;10;Maanantai;38;49;87;10;9;19
96;30.04.2018;2018;04;11;Maanantai;42;66;108;7;14;21
96;30.04.2018;2018;04;12;Maanantai;51;71;122;3;12;15
96;30.04.2018;2018;04;13;Maanantai;66;88;154;8;15;23
96;30.04.2018;2018;04;14;Maanantai;80;96;176;8;12;20
96;30.04.2018;2018;04;15;Maanantai;81;118;199;6;16;22
96;30.04.2018;2018;04;16;Maanantai;90;87;177;8;11;19
96;30.04.2018;2018;04;17;Maanantai;49;64;113;8;10;18
96;30.04.2018;2018;04;18;Maanantai;46;33;79;3;6;9
96;30.04.2018;2018;04;19;Maanantai;33;15;48;2;0;2
96;30.04.2018;2018;04;20;Maanantai;36;16;52;4;3;7
96;30.04.2018;2018;04;21;Maanantai;22;22;44;5;5;10
96;30.04.2018;2018;04;22;Maanantai;6;27;33;1;1;2
96;30.04.2018;2018;04;23;Maanantai;16;13;29;4;0;4
96;01.05.2018;2018;05;00;Tiistai;17;12;29;6;1;7
96;01.05.2018;2018;05;01;Tiistai;15;6;21;4;0;4
96;01.05.2018;2018;05;02;Tiistai;27;3;30;6;0;6
96;01.05.2018;2018;05;03;Tiistai;27;4;31;6;0;6
96;01.05.2018;2018;05;04;Tiistai;16;3;19;11;1;12
96;01.05.2018;2018;05;05;Tiistai;12;2;14;10;0;10
96;01.05.2018;2018;05;06;Tiistai;11;5;16;4;1;5
96;01.05.2018;2018;05;07;Tiistai;5;11;16;4;1;5
96;01.05.2018;2018;05;08;Tiistai;10;10;20;5;3;8
96;01.05.2018;2018;05;09;Tiistai;8;21;29;5;3;8
96;01.05.2018;2018;05;10;Tiistai;13;37;50;2;14;16
96;01.05.2018;2018;05;11;Tiistai;31;56;87;6;12;18
96;01.05.2018;2018;05;12;Tiistai;48;57;105;5;12;17
96;01.05.2018;2018;05;13;Tiistai;71;66;137;11;12;23
96;01.05.2018;2018;05;14;Tiistai;44;95;139;6;12;18
96;01.05.2018;2018;05;15;Tiistai;60;107;167;4;16;20
96;01.05.2018;2018;05;16;Tiistai;58;50;108;6;11;17
96;01.05.2018;2018;05;17;Tiistai;84;30;114;4;7;11
96;01.05.2018;2018;05;18;Tiistai;98;29;127;13;4;17
96;01.05.2018;2018;05;19;Tiistai;50;18;68;3;5;8
96;01.05.2018;2018;05;20;Tiistai;29;14;43;6;8;14
96;01.05.2018;2018;05;21;Tiistai;19;12;31;10;6;16
96;01.05.2018;2018;05;22;Tiistai;12;6;18;3;2;5
96;01.05.2018;2018;05;23;Tiistai;6;0;6;2;1;3
96;02.05.2018;2018;05;00;Keskiviikko;5;1;6;1;0;1
96;02.05.2018;2018;05;01;Keskiviikko;2;0;2;0;0;0
96;02.05.2018;2018;05;02;Keskiviikko;1;0;1;0;0;0
96;02.05.2018;2018;05;03;Keskiviikko;3;2;5;0;0;0
96;02.05.2018;2018;05;04;Keskiviikko;2;1;3;1;0;1
96;02.05.2018;2018;05;05;Keskiviikko;2;13;15;12;0;12
96;02.05.2018;2018;05;06;Keskiviikko;38;19;57;3;0;3
96;02.05.2018;2018;05;07;Keskiviikko;95;95;190;13;7;20
96;02.05.2018;2018;05;08;Keskiviikko;110;95;205;12;7;19
96;02.05.2018;2018;05;09;Keskiviikko;72;61;133;10;7;17
96;02.05.2018;2018;05;10;Keskiviikko;33;42;75;8;7;15
96;02.05.2018;2018;05;11;Keskiviikko;61;59;120;11;6;17
96;02.05.2018;2018;05;12;Keskiviikko;59;61;120;8;5;13
96;02.05.2018;2018;05;13;Keskiviikko;71;56;127;9;6;15
96;02.05.2018;2018;05;14;Keskiviikko;53;79;132;4;15;19
96;02.05.2018;2018;05;15;Keskiviikko;65;132;197;8;15;23
96;02.05.2018;2018;05;16;Keskiviikko;79;133;212;9;20;29
96;02.05.2018;2018;05;17;Keskiviikko;54;46;100;18;22;40
96;02.05.2018;2018;05;18;Keskiviikko;60;35;95;15;16;31
96;02.05.2018;2018;05;19;Keskiviikko;58;41;99;11;13;24
96;02.05.2018;2018;05;20;Keskiviikko;33;40;73;6;10;16
96;02.05.2018;2018;05;21;Keskiviikko;24;38;62;4;9;13
96;02.05.2018;2018;05;22;Keskiviikko;4;12;16;1;3;4
96;02.05.2018;2018;05;23;Keskiviikko;2;3;5;0;0;0
96;03.05.2018;2018;05;00;Torstai;0;3;3;0;0;0
96;03.05.2018;2018;05;01;Torstai;0;0;0;0;0;0
96;03.05.2018;2018;05;02;Torstai;0;0;0;0;0;0
96;03.05.2018;2018;05;03;Torstai;1;0;1;0;0;0
96;03.05.2018;2018;05;04;Torstai;2;1;3;0;0;0
96;03.05.2018;2018;05;05;Torstai;5;12;17;3;0;3
96;03.05.2018;2018;05;06;Torstai;53;32;85;6;0;6
96;03.05.2018;2018;05;07;Torstai;122;108;230;18;6;24
96;03.05.2018;2018;05;08;Torstai;113;101;214;17;8;25
96;03.05.2018;2018;05;09;Torstai;88;49;137;9;2;11
96;03.05.2018;2018;05;10;Torstai;63;66;129;7;9;16
96;03.05.2018;2018;05;11;Torstai;74;59;133;15;12;27
96;03.05.2018;2018;05;12;Torstai;63;90;153;20;14;34
96;03.05.2018;2018;05;13;Torstai;71;72;143;12;11;23
96;03.05.2018;2018;05;14;Torstai;73;123;196;2;26;28
96;03.05.2018;2018;05;15;Torstai;80;166;246;6;23;29
96;03.05.2018;2018;05;16;Torstai;108;185;293;6;26;32
96;03.05.2018;2018;05;17;Torstai;83;68;151;16;12;28
96;03.05.2018;2018;05;18;Torstai;65;48;113;9;11;20
96;03.05.2018;2018;05;19;Torstai;61;47;108;16;24;40
96;03.05.2018;2018;05;20;Torstai;41;40;81;5;8;13
96;03.05.2018;2018;05;21;Torstai;29;49;78;5;9;14
96;03.05.2018;2018;05;22;Torstai;12;12;24;1;5;6
96;03.05.2018;2018;05;23;Torstai;9;4;13;1;0;1
96;04.05.2018;2018;05;00;Perjantai;3;0;3;0;0;0
96;04.05.2018;2018;05;01;Perjantai;1;0;1;0;0;0
96;04.05.2018;2018;05;02;Perjantai;3;2;5;0;0;0
96;04.05.2018;2018;05;03;Perjantai;2;0;2;0;0;0
96;04.05.2018;2018;05;04;Perjantai;2;0;2;0;0;0
96;04.05.2018;2018;05;05;Perjantai;2;10;12;4;0;4
96;04.05.2018;2018;05;06;Perjantai;54;17;71;3;1;4
96;04.05.2018;2018;05;07;Perjantai;83;66;149;13;3;16
96;04.05.2018;2018;05;08;Perjantai;83;73;156;12;9;21
96;04.05.2018;2018;05;09;Perjantai;40;52;92;3;5;8
96;04.05.2018;2018;05;10;Perjantai;43;34;77;7;3;10
96;04.05.2018;2018;05;11;Perjantai;19;30;49;4;5;9
96;04.05.2018;2018;05;12;Perjantai;26;42;68;4;5;9
96;04.05.2018;2018;05;13;Perjantai;36;52;88;9;3;12
96;04.05.2018;2018;05;14;Perjantai;25;91;116;2;10;12
96;04.05.2018;2018;05;15;Perjantai;43;106;149;4;27;31
96;04.05.2018;2018;05;16;Perjantai;53;64;117;10;9;19
96;04.05.2018;2018;05;17;Perjantai;38;35;73;3;6;9
96;04.05.2018;2018;05;18;Perjantai;29;28;57;5;10;15
96;04.05.2018;2018;05;19;Perjantai;20;9;29;5;4;9
96;04.05.2018;2018;05;20;Perjantai;20;13;33;4;6;10
96;04.05.2018;2018;05;21;Perjantai;18;32;50;2;7;9
96;04.05.2018;2018;05;22;Perjantai;10;9;19;1;3;4
96;04.05.2018;2018;05;23;Perjantai;8;6;14;3;2;5
96;05.05.2018;2018;05;00;Lauantai;7;2;9;0;2;2
96;05.05.2018;2018;05;01;Lauantai;6;0;6;0;0;0
96;05.05.2018;2018;05;02;Lauantai;7;0;7;0;0;0
96;05.05.2018;2018;05;03;Lauantai;4;0;4;1;1;2
96;05.05.2018;2018;05;04;Lauantai;5;1;6;3;0;3
96;05.05.2018;2018;05;05;Lauantai;3;4;7;1;0;1
96;05.05.2018;2018;05;06;Lauantai;28;2;30;7;1;8
96;05.05.2018;2018;05;07;Lauantai;4;13;17;4;2;6
96;05.05.2018;2018;05;08;Lauantai;12;25;37;2;3;5
96;05.05.2018;2018;05;09;Lauantai;9;29;38;13;4;17
96;05.05.2018;2018;05;10;Lauantai;32;44;76;10;8;18
96;05.05.2018;2018;05;11;Lauantai;32;47;79;5;8;13
96;05.05.2018;2018;05;12;Lauantai;52;55;107;7;13;20
96;05.05.2018;2018;05;13;Lauantai;57;37;94;16;7;23
96;05.05.2018;2018;05;14;Lauantai;72;73;145;11;15;26
96;05.05.2018;2018;05;15;Lauantai;58;59;117;12;13;25
96;05.05.2018;2018;05;16;Lauantai;68;44;112;30;10;40
96;05.05.2018;2018;05;17;Lauantai;39;33;72;11;12;23
96;05.05.2018;2018;05;18;Lauantai;37;40;77;9;23;32
96;05.05.2018;2018;05;19;Lauantai;36;31;67;10;8;18
96;05.05.2018;2018;05;20;Lauantai;30;30;60;7;10;17
96;05.05.2018;2018;05;21;Lauantai;19;34;53;3;9;12
96;05.05.2018;2018;05;22;Lauantai;11;11;22;0;4;4
96;05.05.2018;2018;05;23;Lauantai;20;7;27;3;4;7
96;06.05.2018;2018;05;00;Sunnuntai;9;2;11;0;0;0
96;06.05.2018;2018;05;01;Sunnuntai;2;4;6;0;1;1
96;06.05.2018;2018;05;02;Sunnuntai;3;0;3;3;0;3
96;06.05.2018;2018;05;03;Sunnuntai;4;0;4;1;0;1
96;06.05.2018;2018;05;04;Sunnuntai;10;1;11;2;0;2
96;06.05.2018;2018;05;05;Sunnuntai;6;1;7;4;0;4
96;06.05.2018;2018;05;06;Sunnuntai;23;4;27;3;0;3
96;06.05.2018;2018;05;07;Sunnuntai;10;12;22;0;3;3
96;06.05.2018;2018;05;08;Sunnuntai;6;8;14;6;4;10
96;06.05.2018;2018;05;09;Sunnuntai;14;21;35;5;5;10
96;06.05.2018;2018;05;10;Sunnuntai;18;29;47;5;12;17
96;06.05.2018;2018;05;11;Sunnuntai;32;51;83;9;8;17
96;06.05.2018;2018;05;12;Sunnuntai;62;84;146;10;9;19
96;06.05.2018;2018;05;13;Sunnuntai;60;54;114;11;9;20
96;06.05.2018;2018;05;14;Sunnuntai;42;46;88;10;11;21
96;06.05.2018;2018;05;15;Sunnuntai;49;57;106;7;4;11
96;06.05.2018;2018;05;16;Sunnuntai;65;46;111;14;15;29
96;06.05.2018;2018;05;17;Sunnuntai;43;35;78;14;18;32
96;06.05.2018;2018;05;18;Sunnuntai;59;44;103;23;17;40
96;06.05.2018;2018;05;19;Sunnuntai;36;22;58;8;19;27
96;06.05.2018;2018;05;20;Sunnuntai;28;36;64;10;21;31
96;06.05.2018;2018;05;21;Sunnuntai;23;25;48;9;4;13
96;06.05.2018;2018;05;22;Sunnuntai;6;15;21;1;4;5
96;06.05.2018;2018;05;23;Sunnuntai;10;3;13;2;0;2
96;07.05.2018;2018;05;00;Maanantai;1;1;2;2;0;2
96;07.05.2018;2018;05;01;Maanantai;5;1;6;0;0;0
96;07.05.2018;2018;05;02;Maanantai;5;0;5;0;0;0
96;07.05.2018;2018;05;03;Maanantai;0;2;2;0;0;0
96;07.05.2018;2018;05;04;Maanantai;4;0;4;0;0;0
96;07.05.2018;2018;05;05;Maanantai;3;8;11;5;0;5
96;07.05.2018;2018;05;06;Maanantai;61;37;98;6;1;7
96;07.05.2018;2018;05;07;Maanantai;135;108;243;14;5;19
96;07.05.2018;2018;05;08;Maanantai;132;114;246;15;8;23
96;07.05.2018;2018;05;09;Maanantai;65;83;148;8;8;16
96;07.05.2018;2018;05;10;Maanantai;55;98;153;6;6;12
96;07.05.2018;2018;05;11;Maanantai;93;76;169;11;14;25
96;07.05.2018;2018;05;12;Maanantai;72;82;154;10;13;23
96;07.05.2018;2018;05;13;Maanantai;53;68;121;11;8;19
96;07.05.2018;2018;05;14;Maanantai;84;108;192;4;17;21
96;07.05.2018;2018;05;15;Maanantai;83;164;247;7;20;27
96;07.05.2018;2018;05;16;Maanantai;91;178;269;10;19;29
96;07.05.2018;2018;05;17;Maanantai;62;59;121;4;8;12
96;07.05.2018;2018;05;18;Maanantai;60;36;96;14;8;22
96;07.05.2018;2018;05;19;Maanantai;44;33;77;10;11;21
96;07.05.2018;2018;05;20;Maanantai;51;32;83;11;9;20
96;07.05.2018;2018;05;21;Maanantai;25;32;57;7;6;13
96;07.05.2018;2018;05;22;Maanantai;9;23;32;2;4;6
96;07.05.2018;2018;05;23;Maanantai;4;1;5;0;0;0
96;08.05.2018;2018;05;00;Tiistai;3;0;3;2;0;2
96;08.05.2018;2018;05;01;Tiistai;1;0;1;0;0;0
96;08.05.2018;2018;05;02;Tiistai;1;1;2;0;0;0
96;08.05.2018;2018;05;03;Tiistai;1;0;1;0;0;0
96;08.05.2018;2018;05;04;Tiistai;3;0;3;0;0;0
96;08.05.2018;2018;05;05;Tiistai;4;11;15;5;0;5
96;08.05.2018;2018;05;06;Tiistai;77;39;116;2;0;2
96;08.05.2018;2018;05;07;Tiistai;132;115;247;25;6;31
96;08.05.2018;2018;05;08;Tiistai;121;155;276;8;6;14
96;08.05.2018;2018;05;09;Tiistai;85;103;188;10;10;20
96;08.05.2018;2018;05;10;Tiistai;80;77;157;12;8;20
96;08.05.2018;2018;05;11;Tiistai;86;62;148;15;18;33
96;08.05.2018;2018;05;12;Tiistai;81;76;157;13;12;25
96;08.05.2018;2018;05;13;Tiistai;84;79;163;14;12;26
96;08.05.2018;2018;05;14;Tiistai;87;136;223;7;14;21
96;08.05.2018;2018;05;15;Tiistai;136;215;351;6;23;29
96;08.05.2018;2018;05;16;Tiistai;157;186;343;10;31;41
96;08.05.2018;2018;05;17;Tiistai;96;75;171;9;14;23
96;08.05.2018;2018;05;18;Tiistai;103;58;161;15;18;33
96;08.05.2018;2018;05;19;Tiistai;88;52;140;13;13;26
96;08.05.2018;2018;05;20;Tiistai;101;57;158;4;10;14
96;08.05.2018;2018;05;21;Tiistai;23;27;50;3;4;7
96;08.05.2018;2018;05;22;Tiistai;18;21;39;2;4;6
96;08.05.2018;2018;05;23;Tiistai;4;5;9;1;2;3
96;09.05.2018;2018;05;00;Keskiviikko;8;1;9;0;1;1
96;09.05.2018;2018;05;01;Keskiviikko;0;0;0;1;0;1
96;09.05.2018;2018;05;02;Keskiviikko;4;0;4;0;0;0
96;09.05.2018;2018;05;03;Keskiviikko;0;3;3;0;0;0
96;09.05.2018;2018;05;04;Keskiviikko;1;4;5;0;0;0
96;09.05.2018;2018;05;05;Keskiviikko;8;10;18;1;0;1
96;09.05.2018;2018;05;06;Keskiviikko;69;29;98;4;1;5
96;09.05.2018;2018;05;07;Keskiviikko;117;123;240;13;2;15
96;09.05.2018;2018;05;08;Keskiviikko;128;147;275;10;7;17
96;09.05.2018;2018;05;09;Keskiviikko;99;99;198;7;11;18
96;09.05.2018;2018;05;10;Keskiviikko;51;51;102;14;9;23
96;09.05.2018;2018;05;11;Keskiviikko;95;61;156;6;9;15
96;09.05.2018;2018;05;12;Keskiviikko;104;126;230;7;11;18
96;09.05.2018;2018;05;13;Keskiviikko;92;98;190;9;10;19
96;09.05.2018;2018;05;14;Keskiviikko;100;142;242;5;17;22
96;09.05.2018;2018;05;15;Keskiviikko;115;209;324;8;21;29
96;09.05.2018;2018;05;16;Keskiviikko;146;153;299;6;22;28
96;09.05.2018;2018;05;17;Keskiviikko;95;92;187;23;14;37
96;09.05.2018;2018;05;18;Keskiviikko;96;54;150;22;15;37
96;09.05.2018;2018;05;19;Keskiviikko;79;58;137;15;9;24
96;09.05.2018;2018;05;20;Keskiviikko;88;48;136;7;10;17
96;09.05.2018;2018;05;21;Keskiviikko;35;37;72;2;5;7
96;09.05.2018;2018;05;22;Keskiviikko;23;19;42;0;2;2
96;09.05.2018;2018;05;23;Keskiviikko;12;5;17;0;1;1
96;10.05.2018;2018;05;00;Torstai;33;27;60;0;3;3
96;10.05.2018;2018;05;01;Torstai;10;8;18;1;0;1
96;10.05.2018;2018;05;02;Torstai;12;0;12;1;0;1
96;10.05.2018;2018;05;03;Torstai;6;0;6;2;0;2
96;10.05.2018;2018;05;04;Torstai;8;1;9;1;0;1
96;10.05.2018;2018;05;05;Torstai;3;5;8;13;0;13
96;10.05.2018;2018;05;06;Torstai;23;7;30;4;1;5
96;10.05.2018;2018;05;07;Torstai;9;22;31;4;1;5
96;10.05.2018;2018;05;08;Torstai;7;19;26;1;9;10
96;10.05.2018;2018;05;09;Torstai;21;29;50;7;4;11
96;10.05.2018;2018;05;10;Torstai;28;36;64;4;2;6
96;10.05.2018;2018;05;11;Torstai;34;44;78;4;3;7
96;10.05.2018;2018;05;12;Torstai;45;67;112;5;16;21
96;10.05.2018;2018;05;13;Torstai;96;95;191;7;9;16
96;10.05.2018;2018;05;14;Torstai;71;92;163;7;17;24
96;10.05.2018;2018;05;15;Torstai;95;76;171;5;10;15
96;10.05.2018;2018;05;16;Torstai;124;110;234;16;12;28
96;10.05.2018;2018;05;17;Torstai;91;90;181;16;18;34
96;10.05.2018;2018;05;18;Torstai;72;42;114;20;21;41
96;10.05.2018;2018;05;19;Torstai;107;54;161;8;10;18
96;10.05.2018;2018;05;20;Torstai;55;45;100;10;6;16
96;10.05.2018;2018;05;21;Torstai;40;26;66;3;4;7
96;10.05.2018;2018;05;22;Torstai;24;14;38;1;2;3
96;10.05.2018;2018;05;23;Torstai;16;6;22;2;3;5
96;11.05.2018;2018;05;00;Perjantai;9;1;10;0;2;2
96;11.05.2018;2018;05;01;Perjantai;2;1;3;2;0;2
96;11.05.2018;2018;05;02;Perjantai;3;0;3;0;0;0
96;11.05.2018;2018;05;03;Perjantai;2;0;2;1;0;1
96;11.05.2018;2018;05;04;Perjantai;0;1;1;0;1;1
96;11.05.2018;2018;05;05;Perjantai;6;7;13;8;0;8
96;11.05.2018;2018;05;06;Perjantai;53;43;96;7;2;9
96;11.05.2018;2018;05;07;Perjantai;86;95;181;9;5;14
96;11.05.2018;2018;05;08;Perjantai;47;86;133;5;9;14
96;11.05.2018;2018;05;09;Perjantai;51;76;127;5;7;12
96;11.05.2018;2018;05;10;Perjantai;60;68;128;9;2;11
96;11.05.2018;2018;05;11;Perjantai;77;82;159;10;10;20
96;11.05.2018;2018;05;12;Perjantai;113;88;201;10;6;16
96;11.05.2018;2018;05;13;Perjantai;100;79;179;2;9;11
96;11.05.2018;2018;05;14;Perjantai;116;118;234;5;12;17
96;11.05.2018;2018;05;15;Perjantai;136;156;292;10;17;27
96;11.05.2018;2018;05;16;Perjantai;132;109;241;16;7;23
96;11.05.2018;2018;05;17;Perjantai;103;60;163;14;12;26
96;11.05.2018;2018;05;18;Perjantai;79;63;142;10;9;19
96;11.05.2018;2018;05;19;Perjantai;81;67;148;11;16;27
96;11.05.2018;2018;05;20;Perjantai;75;38;113;10;12;22
96;11.05.2018;2018;05;21;Perjantai;30;47;77;3;0;3
96;11.05.2018;2018;05;22;Perjantai;33;14;47;3;4;7
96;11.05.2018;2018;05;23;Perjantai;29;5;34;1;2;3
96;12.05.2018;2018;05;00;Lauantai;29;5;34;3;1;4
96;12.05.2018;2018;05;01;Lauantai;9;1;10;2;0;2
96;12.05.2018;2018;05;02;Lauantai;15;2;17;0;0;0
96;12.05.2018;2018;05;03;Lauantai;14;0;14;2;0;2
96;12.05.2018;2018;05;04;Lauantai;8;2;10;5;1;6
96;12.05.2018;2018;05;05;Lauantai;10;5;15;6;0;6
96;12.05.2018;2018;05;06;Lauantai;26;8;34;2;1;3
96;12.05.2018;2018;05;07;Lauantai;9;17;26;2;4;6
96;12.05.2018;2018;05;08;Lauantai;11;29;40;2;4;6
96;12.05.2018;2018;05;09;Lauantai;19;34;53;10;5;15
96;12.05.2018;2018;05;10;Lauantai;40;44;84;8;5;13
96;12.05.2018;2018;05;11;Lauantai;72;63;135;16;5;21
96;12.05.2018;2018;05;12;Lauantai;76;86;162;5;9;14
96;12.05.2018;2018;05;13;Lauantai;86;96;182;13;13;26
96;12.05.2018;2018;05;14;Lauantai;111;114;225;7;13;20
96;12.05.2018;2018;05;15;Lauantai;102;79;181;16;7;23
96;12.05.2018;2018;05;16;Lauantai;104;66;170;17;17;34
96;12.05.2018;2018;05;17;Lauantai;123;62;185;14;4;18
96;12.05.2018;2018;05;18;Lauantai;74;80;154;15;14;29
96;12.05.2018;2018;05;19;Lauantai;66;48;114;16;9;25
96;12.05.2018;2018;05;20;Lauantai;57;48;105;11;9;20
96;12.05.2018;2018;05;21;Lauantai;55;32;87;5;9;14
96;12.05.2018;2018;05;22;Lauantai;22;14;36;1;0;1
96;12.05.2018;2018;05;23;Lauantai;8;7;15;2;1;3
96;13.05.2018;2018;05;00;Sunnuntai;14;8;22;2;0;2
96;13.05.2018;2018;05;01;Sunnuntai;19;3;22;3;1;4
96;13.05.2018;2018;05;02;Sunnuntai;19;6;25;2;1;3
96;13.05.2018;2018;05;03;Sunnuntai;5;4;9;2;0;2
96;13.05.2018;2018;05;04;Sunnuntai;5;2;7;0;0;0
96;13.05.2018;2018;05;05;Sunnuntai;5;1;6;5;0;5
96;13.05.2018;2018;05;06;Sunnuntai;18;5;23;3;0;3
96;13.05.2018;2018;05;07;Sunnuntai;9;15;24;1;7;8
96;13.05.2018;2018;05;08;Sunnuntai;4;10;14;3;3;6
96;13.05.2018;2018;05;09;Sunnuntai;13;14;27;5;7;12
96;13.05.2018;2018;05;10;Sunnuntai;44;32;76;11;8;19
96;13.05.2018;2018;05;11;Sunnuntai;44;53;97;8;7;15
96;13.05.2018;2018;05;12;Sunnuntai;86;81;167;7;11;18
96;13.05.2018;2018;05;13;Sunnuntai;75;65;140;11;9;20
96;13.05.2018;2018;05;14;Sunnuntai;73;64;137;3;6;9
96;13.05.2018;2018;05;15;Sunnuntai;103;61;164;13;13;26
96;13.05.2018;2018;05;16;Sunnuntai;81;50;131;10;8;18
96;13.05.2018;2018;05;17;Sunnuntai;89;46;135;9;9;18
96;13.05.2018;2018;05;18;Sunnuntai;71;65;136;8;8;16
96;13.05.2018;2018;05;19;Sunnuntai;66;47;113;6;6;12
96;13.05.2018;2018;05;20;Sunnuntai;64;43;107;10;6;16
96;13.05.2018;2018;05;21;Sunnuntai;27;30;57;3;3;6
96;13.05.2018;2018;05;22;Sunnuntai;18;9;27;4;3;7
96;13.05.2018;2018;05;23;Sunnuntai;8;3;11;2;2;4
96;14.05.2018;2018;05;00;Maanantai;3;2;5;6;0;6
96;14.05.2018;2018;05;01;Maanantai;3;1;4;0;0;0
96;14.05.2018;2018;05;02;Maanantai;1;0;1;0;0;0
96;14.05.2018;2018;05;03;Maanantai;2;2;4;0;1;1
96;14.05.2018;2018;05;04;Maanantai;3;0;3;4;0;4
96;14.05.2018;2018;05;05;Maanantai;3;9;12;7;0;7
96;14.05.2018;2018;05;06;Maanantai;79;32;111;3;3;6
96;14.05.2018;2018;05;07;Maanantai;168;133;301;14;8;22
96;14.05.2018;2018;05;08;Maanantai;117;178;295;12;11;23
96;14.05.2018;2018;05;09;Maanantai;85;80;165;12;13;25
96;14.05.2018;2018;05;10;Maanantai;84;69;153;9;7;16
96;14.05.2018;2018;05;11;Maanantai;114;75;189;12;21;33
96;14.05.2018;2018;05;12;Maanantai;114;86;200;18;11;29
96;14.05.2018;2018;05;13;Maanantai;97;92;189;6;11;17
96;14.05.2018;2018;05;14;Maanantai;92;155;247;11;28;39
96;14.05.2018;2018;05;15;Maanantai;144;217;361;13;27;40
96;14.05.2018;2018;05;16;Maanantai;190;229;419;11;28;39
96;14.05.2018;2018;05;17;Maanantai;96;109;205;15;18;33
96;14.05.2018;2018;05;18;Maanantai;131;76;207;16;14;30
96;14.05.2018;2018;05;19;Maanantai;94;66;160;20;12;32
96;14.05.2018;2018;05;20;Maanantai;78;47;125;13;15;28
96;14.05.2018;2018;05;21;Maanantai;35;37;72;9;4;13
96;14.05.2018;2018;05;22;Maanantai;12;18;30;2;3;5
96;14.05.2018;2018;05;23;Maanantai;5;5;10;3;4;7
96;15.05.2018;2018;05;00;Tiistai;3;2;5;1;1;2
96;15.05.2018;2018;05;01;Tiistai;2;3;5;0;0;0
96;15.05.2018;2018;05;02;Tiistai;3;1;4;0;0;0
96;15.05.2018;2018;05;03;Tiistai;2;0;2;0;0;0
96;15.05.2018;2018;05;04;Tiistai;2;0;2;1;0;1
96;15.05.2018;2018;05;05;Tiistai;8;13;21;1;0;1
96;15.05.2018;2018;05;06;Tiistai;82;41;123;5;1;6
96;15.05.2018;2018;05;07;Tiistai;165;151;316;17;11;28
96;15.05.2018;2018;05;08;Tiistai;121;175;296;20;7;27
96;15.05.2018;2018;05;09;Tiistai;110;107;217;15;12;27
96;15.05.2018;2018;05;10;Tiistai;92;82;174;9;4;13
96;15.05.2018;2018;05;11;Tiistai;100;85;185;14;20;34
96;15.05.2018;2018;05;12;Tiistai;106;103;209;11;15;26
96;15.05.2018;2018;05;13;Tiistai;97;113;210;6;16;22
96;15.05.2018;2018;05;14;Tiistai;102;173;275;9;27;36
96;15.05.2018;2018;05;15;Tiistai;122;239;361;7;23;30
96;15.05.2018;2018;05;16;Tiistai;187;238;425;11;26;37
96;15.05.2018;2018;05;17;Tiistai;126;83;209;12;11;23
96;15.05.2018;2018;05;18;Tiistai;91;83;174;19;15;34
96;15.05.2018;2018;05;19;Tiistai;108;74;182;16;26;42
96;15.05.2018;2018;05;20;Tiistai;90;47;137;9;11;20
96;15.05.2018;2018;05;21;Tiistai;57;55;112;3;4;7
96;15.05.2018;2018;05;22;Tiistai;10;13;23;0;5;5
96;15.05.2018;2018;05;23;Tiistai;6;4;10;2;1;3
96;16.05.2018;2018;05;00;Keskiviikko;11;2;13;1;0;1
96;16.05.2018;2018;05;01;Keskiviikko;2;1;3;1;0;1
96;16.05.2018;2018;05;02;Keskiviikko;5;0;5;0;0;0
96;16.05.2018;2018;05;03;Keskiviikko;5;0;5;0;1;1
96;16.05.2018;2018;05;04;Keskiviikko;2;1;3;0;1;1
96;16.05.2018;2018;05;05;Keskiviikko;8;9;17;7;2;9
96;16.05.2018;2018;05;06;Keskiviikko;74;54;128;5;1;6
96;16.05.2018;2018;05;07;Keskiviikko;171;151;322;13;5;18
96;16.05.2018;2018;05;08;Keskiviikko;124;190;314;13;10;23
96;16.05.2018;2018;05;09;Keskiviikko;144;120;264;9;6;15
96;16.05.2018;2018;05;10;Keskiviikko;66;59;125;11;10;21
96;16.05.2018;2018;05;11;Keskiviikko;130;166;296;11;18;29
96;16.05.2018;2018;05;12;Keskiviikko;122;120;242;13;15;28
96;16.05.2018;2018;05;13;Keskiviikko;151;106;257;12;18;30
96;16.05.2018;2018;05;14;Keskiviikko;148;146;294;13;18;31
96;16.05.2018;2018;05;15;Keskiviikko;157;201;358;13;27;40
96;16.05.2018;2018;05;16;Keskiviikko;218;212;430;16;41;57
96;16.05.2018;2018;05;17;Keskiviikko;137;71;208;15;13;28
96;16.05.2018;2018;05;18;Keskiviikko;126;85;211;11;10;21
96;16.05.2018;2018;05;19;Keskiviikko;99;72;171;16;18;34
96;16.05.2018;2018;05;20;Keskiviikko;118;55;173;19;15;34
96;16.05.2018;2018;05;21;Keskiviikko;47;47;94;3;8;11
96;16.05.2018;2018;05;22;Keskiviikko;29;11;40;3;4;7
96;16.05.2018;2018;05;23;Keskiviikko;15;7;22;3;1;4
96;17.05.2018;2018;05;00;Torstai;9;3;12;1;1;2
96;17.05.2018;2018;05;01;Torstai;8;2;10;2;0;2
96;17.05.2018;2018;05;02;Torstai;0;1;1;0;0;0
96;17.05.2018;2018;05;03;Torstai;5;0;5;0;0;0
96;17.05.2018;2018;05;04;Torstai;7;2;9;2;1;3
96;17.05.2018;2018;05;05;Torstai;10;9;19;3;0;3
96;17.05.2018;2018;05;06;Torstai;84;38;122;4;0;4
96;17.05.2018;2018;05;07;Torstai;171;135;306;13;6;19
96;17.05.2018;2018;05;08;Torstai;125;139;264;11;4;15
96;17.05.2018;2018;05;09;Torstai;98;97;195;11;9;20
96;17.05.2018;2018;05;10;Torstai;59;59;118;4;6;10
96;17.05.2018;2018;05;11;Torstai;91;178;269;14;20;34
96;17.05.2018;2018;05;12;Torstai;117;222;339;17;45;62
96;17.05.2018;2018;05;13;Torstai;122;107;229;8;17;25
96;17.05.2018;2018;05;14;Torstai;258;146;404;19;28;47
96;17.05.2018;2018;05;15;Torstai;152;250;402;14;24;38
96;17.05.2018;2018;05;16;Torstai;167;203;370;10;34;44
96;17.05.2018;2018;05;17;Torstai;108;93;201;12;9;21
96;17.05.2018;2018;05;18;Torstai;92;69;161;13;21;34
96;17.05.2018;2018;05;19;Torstai;90;44;134;11;13;24
96;17.05.2018;2018;05;20;Torstai;75;56;131;6;13;19
96;17.05.2018;2018;05;21;Torstai;56;42;98;5;11;16
96;17.05.2018;2018;05;22;Torstai;14;15;29;0;4;4
96;17.05.2018;2018;05;23;Torstai;6;5;11;0;0;0
96;18.05.2018;2018;05;00;Perjantai;8;3;11;1;0;1
96;18.05.2018;2018;05;01;Perjantai;8;2;10;2;0;2
96;18.05.2018;2018;05;02;Perjantai;4;0;4;0;0;0
96;18.05.2018;2018;05;03;Perjantai;3;1;4;0;1;1
96;18.05.2018;2018;05;04;Perjantai;3;1;4;0;0;0
96;18.05.2018;2018;05;05;Perjantai;4;9;13;4;2;6
96;18.05.2018;2018;05;06;Perjantai;81;34;115;3;1;4
96;18.05.2018;2018;05;07;Perjantai;140;117;257;11;4;15
96;18.05.2018;2018;05;08;Perjantai;118;114;232;13;16;29
96;18.05.2018;2018;05;09;Perjantai;73;75;148;13;16;29
96;18.05.2018;2018;05;10;Perjantai;49;85;134;6;7;13
96;18.05.2018;2018;05;11;Perjantai;56;84;140;8;6;14
96;18.05.2018;2018;05;12;Perjantai;77;98;175;7;18;25
96;18.05.2018;2018;05;13;Perjantai;95;127;222;10;15;25
96;18.05.2018;2018;05;14;Perjantai;103;146;249;6;20;26
96;18.05.2018;2018;05;15;Perjantai;119;171;290;7;23;30
96;18.05.2018;2018;05;16;Perjantai;110;118;228;9;6;15
96;18.05.2018;2018;05;17;Perjantai;72;73;145;16;10;26
96;18.05.2018;2018;05;18;Perjantai;68;54;122;10;17;27
96;18.05.2018;2018;05;19;Perjantai;70;39;109;6;7;13
96;18.05.2018;2018;05;20;Perjantai;65;34;99;9;6;15
96;18.05.2018;2018;05;21;Perjantai;45;32;77;4;4;8
96;18.05.2018;2018;05;22;Perjantai;23;17;40;2;3;5
96;18.05.2018;2018;05;23;Perjantai;11;6;17;2;3;5
96;19.05.2018;2018;05;00;Lauantai;14;13;27;1;0;1
96;19.05.2018;2018;05;01;Lauantai;10;0;10;0;0;0
96;19.05.2018;2018;05;02;Lauantai;8;0;8;4;0;4
96;19.05.2018;2018;05;03;Lauantai;8;0;8;1;1;2
96;19.05.2018;2018;05;04;Lauantai;6;2;8;2;0;2
96;19.05.2018;2018;05;05;Lauantai;10;2;12;10;0;10
96;19.05.2018;2018;05;06;Lauantai;20;6;26;1;3;4
96;19.05.2018;2018;05;07;Lauantai;3;22;25;3;4;7
96;19.05.2018;2018;05;08;Lauantai;14;18;32;5;3;8
96;19.05.2018;2018;05;09;Lauantai;7;40;47;3;7;10
96;19.05.2018;2018;05;10;Lauantai;30;31;61;5;9;14
96;19.05.2018;2018;05;11;Lauantai;54;59;113;3;2;5
96;19.05.2018;2018;05;12;Lauantai;72;70;142;10;5;15
96;19.05.2018;2018;05;13;Lauantai;62;66;128;8;11;19
96;19.05.2018;2018;05;14;Lauantai;58;56;114;4;8;12
96;19.05.2018;2018;05;15;Lauantai;63;77;140;5;15;20
96;19.05.2018;2018;05;16;Lauantai;58;51;109;8;8;16
96;19.05.2018;2018;05;17;Lauantai;40;49;89;12;14;26
96;19.05.2018;2018;05;18;Lauantai;60;59;119;8;12;20
96;19.05.2018;2018;05;19;Lauantai;48;39;87;11;5;16
96;19.05.2018;2018;05;20;Lauantai;45;34;79;9;10;19
96;19.05.2018;2018;05;21;Lauantai;22;31;53;10;12;22
96;19.05.2018;2018;05;22;Lauantai;33;26;59;6;2;8
96;19.05.2018;2018;05;23;Lauantai;17;9;26;1;0;1
96;20.05.2018;2018;05;00;Sunnuntai;23;16;39;0;1;1
96;20.05.2018;2018;05;01;Sunnuntai;16;2;18;1;0;1
96;20.05.2018;2018;05;02;Sunnuntai;16;0;16;2;0;2
96;20.05.2018;2018;05;03;Sunnuntai;13;2;15;0;0;0
96;20.05.2018;2018;05;04;Sunnuntai;11;1;12;4;0;4
96;20.05.2018;2018;05;05;Sunnuntai;9;1;10;18;0;18
96;20.05.2018;2018;05;06;Sunnuntai;18;5;23;4;0;4
96;20.05.2018;2018;05;07;Sunnuntai;4;9;13;2;4;6
96;20.05.2018;2018;05;08;Sunnuntai;3;8;11;7;1;8
96;20.05.2018;2018;05;09;Sunnuntai;15;19;34;5;5;10
96;20.05.2018;2018;05;10;Sunnuntai;25;34;59;1;9;10
96;20.05.2018;2018;05;11;Sunnuntai;39;45;84;5;7;12
96;20.05.2018;2018;05;12;Sunnuntai;52;55;107;5;4;9
96;20.05.2018;2018;05;13;Sunnuntai;59;70;129;3;9;12
96;20.05.2018;2018;05;14;Sunnuntai;65;53;118;11;11;22
96;20.05.2018;2018;05;15;Sunnuntai;54;60;114;7;11;18
96;20.05.2018;2018;05;16;Sunnuntai;80;45;125;16;4;20
96;20.05.2018;2018;05;17;Sunnuntai;69;43;112;16;6;22
96;20.05.2018;2018;05;18;Sunnuntai;49;51;100;15;16;31
96;20.05.2018;2018;05;19;Sunnuntai;40;46;86;9;16;25
96;20.05.2018;2018;05;20;Sunnuntai;41;41;82;9;19;28
96;20.05.2018;2018;05;21;Sunnuntai;28;27;55;7;10;17
96;20.05.2018;2018;05;22;Sunnuntai;10;12;22;1;3;4
96;20.05.2018;2018;05;23;Sunnuntai;4;7;11;0;1;1
96;21.05.2018;2018;05;00;Maanantai;2;2;4;4;1;5
96;21.05.2018;2018;05;01;Maanantai;2;0;2;0;0;0
96;21.05.2018;2018;05;02;Maanantai;4;1;5;0;1;1
96;21.05.2018;2018;05;03;Maanantai;1;0;1;0;0;0
96;21.05.2018;2018;05;04;Maanantai;6;2;8;0;0;0
96;21.05.2018;2018;05;05;Maanantai;6;14;20;7;0;7
96;21.05.2018;2018;05;06;Maanantai;73;37;110;4;0;4
96;21.05.2018;2018;05;07;Maanantai;167;139;306;11;5;16
96;21.05.2018;2018;05;08;Maanantai;152;147;299;7;9;16
96;21.05.2018;2018;05;09;Maanantai;75;86;161;14;14;28
96;21.05.2018;2018;05;10;Maanantai;73;86;159;10;17;27
96;21.05.2018;2018;05;11;Maanantai;73;87;160;6;10;16
96;21.05.2018;2018;05;12;Maanantai;94;89;183;11;12;23
96;21.05.2018;2018;05;13;Maanantai;101;104;205;6;16;22
96;21.05.2018;2018;05;14;Maanantai;97;139;236;6;23;29
96;21.05.2018;2018;05;15;Maanantai;121;206;327;11;22;33
96;21.05.2018;2018;05;16;Maanantai;159;216;375;12;32;44
96;21.05.2018;2018;05;17;Maanantai;107;107;214;9;19;28
96;21.05.2018;2018;05;18;Maanantai;93;70;163;15;12;27
96;21.05.2018;2018;05;19;Maanantai;124;68;192;12;14;26
96;21.05.2018;2018;05;20;Maanantai;95;44;139;19;11;30
96;21.05.2018;2018;05;21;Maanantai;38;48;86;5;16;21
96;21.05.2018;2018;05;22;Maanantai;13;23;36;2;5;7
96;21.05.2018;2018;05;23;Maanantai;3;6;9;3;0;3
96;22.05.2018;2018;05;00;Tiistai;3;7;10;1;1;2
96;22.05.2018;2018;05;01;Tiistai;4;1;5;0;0;0
96;22.05.2018;2018;05;02;Tiistai;4;1;5;0;0;0
96;22.05.2018;2018;05;03;Tiistai;1;0;1;0;0;0
96;22.05.2018;2018;05;04;Tiistai;3;2;5;0;0;0
96;22.05.2018;2018;05;05;Tiistai;9;8;17;10;3;13
96;22.05.2018;2018;05;06;Tiistai;90;51;141;3;0;3
96;22.05.2018;2018;05;07;Tiistai;160;137;297;13;5;18
96;22.05.2018;2018;05;08;Tiistai;134;187;321;8;18;26
96;22.05.2018;2018;05;09;Tiistai;101;81;182;6;11;17
96;22.05.2018;2018;05;10;Tiistai;70;92;162;16;16;32
96;22.05.2018;2018;05;11;Tiistai;99;116;215;8;14;22
96;22.05.2018;2018;05;12;Tiistai;116;115;231;13;21;34
96;22.05.2018;2018;05;13;Tiistai;106;122;228;14;12;26
96;22.05.2018;2018;05;14;Tiistai;121;136;257;6;16;22
96;22.05.2018;2018;05;15;Tiistai;124;230;354;10;21;31
96;22.05.2018;2018;05;16;Tiistai;173;217;390;13;22;35
96;22.05.2018;2018;05;17;Tiistai;134;99;233;14;12;26
96;22.05.2018;2018;05;18;Tiistai;97;61;158;9;14;23
96;22.05.2018;2018;05;19;Tiistai;98;73;171;7;15;22
96;22.05.2018;2018;05;20;Tiistai;85;31;116;10;13;23
96;22.05.2018;2018;05;21;Tiistai;41;51;92;2;4;6
96;22.05.2018;2018;05;22;Tiistai;21;13;34;4;3;7
96;22.05.2018;2018;05;23;Tiistai;7;1;8;2;3;5
96;23.05.2018;2018;05;00;Keskiviikko;4;2;6;0;0;0
96;23.05.2018;2018;05;01;Keskiviikko;0;2;2;0;0;0
96;23.05.2018;2018;05;02;Keskiviikko;3;0;3;0;0;0
96;23.05.2018;2018;05;03;Keskiviikko;2;2;4;1;0;1
96;23.05.2018;2018;05;04;Keskiviikko;1;1;2;1;1;2
96;23.05.2018;2018;05;05;Keskiviikko;7;11;18;3;1;4
96;23.05.2018;2018;05;06;Keskiviikko;72;38;110;5;2;7
96;23.05.2018;2018;05;07;Keskiviikko;155;124;279;12;11;23
96;23.05.2018;2018;05;08;Keskiviikko;127;147;274;10;14;24
96;23.05.2018;2018;05;09;Keskiviikko;58;105;163;4;26;30
96;23.05.2018;2018;05;10;Keskiviikko;51;86;137;23;31;54
96;23.05.2018;2018;05;11;Keskiviikko;67;102;169;10;25;35
96;23.05.2018;2018;05;12;Keskiviikko;87;74;161;19;16;35
96;23.05.2018;2018;05;13;Keskiviikko;88;89;177;19;17;36
96;23.05.2018;2018;05;14;Keskiviikko;75;112;187;14;21;35
96;23.05.2018;2018;05;15;Keskiviikko;118;214;332;19;45;64
96;23.05.2018;2018;05;16;Keskiviikko;149;166;315;24;26;50
96;23.05.2018;2018;05;17;Keskiviikko;91;85;176;12;9;21
96;23.05.2018;2018;05;18;Keskiviikko;102;63;165;6;10;16
96;23.05.2018;2018;05;19;Keskiviikko;75;46;121;11;9;20
96;23.05.2018;2018;05;20;Keskiviikko;72;44;116;9;7;16
96;23.05.2018;2018;05;21;Keskiviikko;24;28;52;3;5;8
96;23.05.2018;2018;05;22;Keskiviikko;16;22;38;6;12;18
96;23.05.2018;2018;05;23;Keskiviikko;7;15;22;7;9;16
96;24.05.2018;2018;05;00;Torstai;7;1;8;0;0;0
96;24.05.2018;2018;05;01;Torstai;4;1;5;10;3;13
96;24.05.2018;2018;05;02;Torstai;6;1;7;0;0;0
96;24.05.2018;2018;05;03;Torstai;5;0;5;0;0;0
96;24.05.2018;2018;05;04;Torstai;4;5;9;1;0;1
96;24.05.2018;2018;05;05;Torstai;6;12;18;7;0;7
96;24.05.2018;2018;05;06;Torstai;73;30;103;6;1;7
96;24.05.2018;2018;05;07;Torstai;134;128;262;6;2;8
96;24.05.2018;2018;05;08;Torstai;122;153;275;5;5;10
96;24.05.2018;2018;05;09;Torstai;71;90;161;6;16;22
96;24.05.2018;2018;05;10;Torstai;43;83;126;9;21;30
96;24.05.2018;2018;05;11;Torstai;68;102;170;9;20;29
96;24.05.2018;2018;05;12;Torstai;83;77;160;20;15;35
96;24.05.2018;2018;05;13;Torstai;106;109;215;19;24;43
96;24.05.2018;2018;05;14;Torstai;89;116;205;9;12;21
96;24.05.2018;2018;05;15;Torstai;119;197;316;11;29;40
96;24.05.2018;2018;05;16;Torstai;125;162;287;10;18;28
96;24.05.2018;2018;05;17;Torstai;99;86;185;13;15;28
96;24.05.2018;2018;05;18;Torstai;76;66;142;11;2;13
96;24.05.2018;2018;05;19;Torstai;69;60;129;6;9;15
96;24.05.2018;2018;05;20;Torstai;50;34;84;7;10;17
96;24.05.2018;2018;05;21;Torstai;45;37;82;2;6;8
96;24.05.2018;2018;05;22;Torstai;19;19;38;0;2;2
96;24.05.2018;2018;05;23;Torstai;5;6;11;1;1;2
96;25.05.2018;2018;05;00;Perjantai;4;4;8;0;0;0
96;25.05.2018;2018;05;01;Perjantai;2;2;4;0;0;0
96;25.05.2018;2018;05;02;Perjantai;0;1;1;0;0;0
96;25.05.2018;2018;05;03;Perjantai;2;0;2;1;0;1
96;25.05.2018;2018;05;04;Perjantai;2;3;5;0;0;0
96;25.05.2018;2018;05;05;Perjantai;5;7;12;13;2;15
96;25.05.2018;2018;05;06;Perjantai;78;36;114;5;0;5
96;25.05.2018;2018;05;07;Perjantai;149;135;284;10;7;17
96;25.05.2018;2018;05;08;Perjantai;102;127;229;6;5;11
96;25.05.2018;2018;05;09;Perjantai;65;67;132;5;5;10
96;25.05.2018;2018;05;10;Perjantai;56;77;133;10;5;15
96;25.05.2018;2018;05;11;Perjantai;86;120;206;11;10;21
96;25.05.2018;2018;05;12;Perjantai;87;87;174;9;18;27
96;25.05.2018;2018;05;13;Perjantai;99;112;211;9;10;19
96;25.05.2018;2018;05;14;Perjantai;128;161;289;10;25;35
96;25.05.2018;2018;05;15;Perjantai;111;170;281;10;33;43
96;25.05.2018;2018;05;16;Perjantai;108;116;224;8;21;29
96;25.05.2018;2018;05;17;Perjantai;80;66;146;12;11;23
96;25.05.2018;2018;05;18;Perjantai;68;68;136;7;4;11
96;25.05.2018;2018;05;19;Perjantai;78;48;126;11;10;21
96;25.05.2018;2018;05;20;Perjantai;53;49;102;8;10;18
96;25.05.2018;2018;05;21;Perjantai;33;46;79;2;4;6
96;25.05.2018;2018;05;22;Perjantai;30;23;53;5;1;6
96;25.05.2018;2018;05;23;Perjantai;21;6;27;5;2;7
96;26.05.2018;2018;05;00;Lauantai;22;1;23;1;2;3
96;26.05.2018;2018;05;01;Lauantai;13;8;21;3;1;4
96;26.05.2018;2018;05;02;Lauantai;24;3;27;0;0;0
96;26.05.2018;2018;05;03;Lauantai;11;1;12;2;0;2
96;26.05.2018;2018;05;04;Lauantai;9;2;11;3;0;3
96;26.05.2018;2018;05;05;Lauantai;6;2;8;10;0;10
96;26.05.2018;2018;05;06;Lauantai;28;4;32;1;1;2
96;26.05.2018;2018;05;07;Lauantai;10;13;23;1;3;4
96;26.05.2018;2018;05;08;Lauantai;10;14;24;1;5;6
96;26.05.2018;2018;05;09;Lauantai;15;37;52;1;5;6
96;26.05.2018;2018;05;10;Lauantai;20;56;76;3;3;6
96;26.05.2018;2018;05;11;Lauantai;40;46;86;5;4;9
96;26.05.2018;2018;05;12;Lauantai;77;62;139;6;13;19
96;26.05.2018;2018;05;13;Lauantai;68;48;116;9;13;22
96;26.05.2018;2018;05;14;Lauantai;47;77;124;4;14;18
96;26.05.2018;2018;05;15;Lauantai;50;62;112;8;6;14
96;26.05.2018;2018;05;16;Lauantai;57;40;97;9;8;17
96;26.05.2018;2018;05;17;Lauantai;68;48;116;9;6;15
96;26.05.2018;2018;05;18;Lauantai;65;59;124;5;11;16
96;26.05.2018;2018;05;19;Lauantai;33;35;68;8;3;11
96;26.05.2018;2018;05;20;Lauantai;39;31;70;10;7;17
96;26.05.2018;2018;05;21;Lauantai;34;40;74;0;8;8
96;26.05.2018;2018;05;22;Lauantai;14;15;29;2;2;4
96;26.05.2018;2018;05;23;Lauantai;15;8;23;3;3;6
96;27.05.2018;2018;05;00;Sunnuntai;21;10;31;2;0;2
96;27.05.2018;2018;05;01;Sunnuntai;11;6;17;2;0;2
96;27.05.2018;2018;05;02;Sunnuntai;10;1;11;2;2;4
96;27.05.2018;2018;05;03;Sunnuntai;15;0;15;1;0;1
96;27.05.2018;2018;05;04;Sunnuntai;13;1;14;2;0;2
96;27.05.2018;2018;05;05;Sunnuntai;4;0;4;1;0;1
96;27.05.2018;2018;05;06;Sunnuntai;27;3;30;0;0;0
96;27.05.2018;2018;05;07;Sunnuntai;6;9;15;0;1;1
96;27.05.2018;2018;05;08;Sunnuntai;10;10;20;6;1;7
96;27.05.2018;2018;05;09;Sunnuntai;10;18;28;7;5;12
96;27.05.2018;2018;05;10;Sunnuntai;22;32;54;5;11;16
96;27.05.2018;2018;05;11;Sunnuntai;27;48;75;4;3;7
96;27.05.2018;2018;05;12;Sunnuntai;36;61;97;5;12;17
96;27.05.2018;2018;05;13;Sunnuntai;79;50;129;8;16;24
96;27.05.2018;2018;05;14;Sunnuntai;66;63;129;7;11;18
96;27.05.2018;2018;05;15;Sunnuntai;51;43;94;13;11;24
96;27.05.2018;2018;05;16;Sunnuntai;74;29;103;17;10;27
96;27.05.2018;2018;05;17;Sunnuntai;40;57;97;15;13;28
96;27.05.2018;2018;05;18;Sunnuntai;53;43;96;17;15;32
96;27.05.2018;2018;05;19;Sunnuntai;47;47;94;8;7;15
96;27.05.2018;2018;05;20;Sunnuntai;36;49;85;12;20;32
96;27.05.2018;2018;05;21;Sunnuntai;33;22;55;3;7;10
96;27.05.2018;2018;05;22;Sunnuntai;11;14;25;3;1;4
96;27.05.2018;2018;05;23;Sunnuntai;5;4;9;4;1;5
96;28.05.2018;2018;05;00;Maanantai;1;1;2;0;1;1
96;28.05.2018;2018;05;01;Maanantai;2;2;4;0;0;0
96;28.05.2018;2018;05;02;Maanantai;2;0;2;1;0;1
96;28.05.2018;2018;05;03;Maanantai;3;0;3;0;0;0
96;28.05.2018;2018;05;04;Maanantai;3;0;3;0;0;0
96;28.05.2018;2018;05;05;Maanantai;4;14;18;18;0;18
96;28.05.2018;2018;05;06;Maanantai;74;47;121;7;0;7
96;28.05.2018;2018;05;07;Maanantai;166;120;286;13;8;21
96;28.05.2018;2018;05;08;Maanantai;114;153;267;7;8;15
96;28.05.2018;2018;05;09;Maanantai;72;80;152;10;7;17
96;28.05.2018;2018;05;10;Maanantai;57;69;126;9;10;19
96;28.05.2018;2018;05;11;Maanantai;68;93;161;11;20;31
96;28.05.2018;2018;05;12;Maanantai;84;79;163;14;12;26
96;28.05.2018;2018;05;13;Maanantai;88;101;189;10;14;24
96;28.05.2018;2018;05;14;Maanantai;84;136;220;17;27;44
96;28.05.2018;2018;05;15;Maanantai;130;213;343;7;26;33
96;28.05.2018;2018;05;16;Maanantai;162;211;373;8;18;26
96;28.05.2018;2018;05;17;Maanantai;112;93;205;18;24;42
96;28.05.2018;2018;05;18;Maanantai;123;67;190;12;9;21
96;28.05.2018;2018;05;19;Maanantai;96;61;157;14;11;25
96;28.05.2018;2018;05;20;Maanantai;93;53;146;9;11;20
96;28.05.2018;2018;05;21;Maanantai;32;35;67;7;6;13
96;28.05.2018;2018;05;22;Maanantai;10;21;31;3;7;10
96;28.05.2018;2018;05;23;Maanantai;9;3;12;2;4;6
96;29.05.2018;2018;05;00;Tiistai;4;2;6;3;1;4
96;29.05.2018;2018;05;01;Tiistai;2;4;6;0;0;0
96;29.05.2018;2018;05;02;Tiistai;1;2;3;0;1;1
96;29.05.2018;2018;05;03;Tiistai;1;1;2;0;0;0
96;29.05.2018;2018;05;04;Tiistai;1;1;2;0;0;0
96;29.05.2018;2018;05;05;Tiistai;7;12;19;6;1;7
96;29.05.2018;2018;05;06;Tiistai;72;50;122;4;1;5
96;29.05.2018;2018;05;07;Tiistai;169;133;302;12;8;20
96;29.05.2018;2018;05;08;Tiistai;127;168;295;9;8;17
96;29.05.2018;2018;05;09;Tiistai;88;143;231;7;7;14
96;29.05.2018;2018;05;10;Tiistai;60;95;155;5;10;15
96;29.05.2018;2018;05;11;Tiistai;88;131;219;7;12;19
96;29.05.2018;2018;05;12;Tiistai;108;80;188;7;12;19
96;29.05.2018;2018;05;13;Tiistai;133;119;252;10;6;16
96;29.05.2018;2018;05;14;Tiistai;112;128;240;3;17;20
96;29.05.2018;2018;05;15;Tiistai;128;210;338;12;17;29
96;29.05.2018;2018;05;16;Tiistai;153;173;326;10;27;37
96;29.05.2018;2018;05;17;Tiistai;118;92;210;12;12;24
96;29.05.2018;2018;05;18;Tiistai;106;64;170;5;14;19
96;29.05.2018;2018;05;19;Tiistai;76;67;143;9;8;17
96;29.05.2018;2018;05;20;Tiistai;82;36;118;10;7;17
96;29.05.2018;2018;05;21;Tiistai;43;55;98;7;6;13
96;29.05.2018;2018;05;22;Tiistai;10;21;31;5;3;8
96;29.05.2018;2018;05;23;Tiistai;4;3;7;3;3;6
96;30.05.2018;2018;05;00;Keskiviikko;6;4;10;0;0;0
96;30.05.2018;2018;05;01;Keskiviikko;1;1;2;1;1;2
96;30.05.2018;2018;05;02;Keskiviikko;2;1;3;0;0;0
96;30.05.2018;2018;05;03;Keskiviikko;1;0;1;1;0;1
96;30.05.2018;2018;05;04;Keskiviikko;6;0;6;0;1;1
96;30.05.2018;2018;05;05;Keskiviikko;4;9;13;9;0;9
96;30.05.2018;2018;05;06;Keskiviikko;84;47;131;3;1;4
96;30.05.2018;2018;05;07;Keskiviikko;157;121;278;11;7;18
96;30.05.2018;2018;05;08;Keskiviikko;98;152;250;8;7;15
96;30.05.2018;2018;05;09;Keskiviikko;86;97;183;5;6;11
96;30.05.2018;2018;05;10;Keskiviikko;77;64;141;5;9;14
96;30.05.2018;2018;05;11;Keskiviikko;82;83;165;8;23;31
96;30.05.2018;2018;05;12;Keskiviikko;86;114;200;5;10;15
96;30.05.2018;2018;05;13;Keskiviikko;96;123;219;10;16;26
96;30.05.2018;2018;05;14;Keskiviikko;81;117;198;8;10;18
96;30.05.2018;2018;05;15;Keskiviikko;112;221;333;3;34;37
96;30.05.2018;2018;05;16;Keskiviikko;152;196;348;5;15;20
96;30.05.2018;2018;05;17;Keskiviikko;101;86;187;10;18;28
96;30.05.2018;2018;05;18;Keskiviikko;102;49;151;18;15;33
96;30.05.2018;2018;05;19;Keskiviikko;83;52;135;12;5;17
96;30.05.2018;2018;05;20;Keskiviikko;64;33;97;5;19;24
96;30.05.2018;2018;05;21;Keskiviikko;32;45;77;4;7;11
96;30.05.2018;2018;05;22;Keskiviikko;15;11;26;1;3;4
96;30.05.2018;2018;05;23;Keskiviikko;8;4;12;13;10;23
96;31.05.2018;2018;05;00;Torstai;0;2;2;1;1;2
96;31.05.2018;2018;05;01;Torstai;2;1;3;0;0;0
96;31.05.2018;2018;05;02;Torstai;1;1;2;0;0;0
96;31.05.2018;2018;05;03;Torstai;5;0;5;0;0;0
96;31.05.2018;2018;05;04;Torstai;1;1;2;0;0;0
96;31.05.2018;2018;05;05;Torstai;6;12;18;18;0;18
96;31.05.2018;2018;05;06;Torstai;77;31;108;3;0;3
96;31.05.2018;2018;05;07;Torstai;148;152;300;12;4;16
96;31.05.2018;2018;05;08;Torstai;116;156;272;12;12;24
96;31.05.2018;2018;05;09;Torstai;83;77;160;13;8;21
96;31.05.2018;2018;05;10;Torstai;49;107;156;4;11;15
96;31.05.2018;2018;05;11;Torstai;170;141;311;12;15;27
96;31.05.2018;2018;05;12;Torstai;89;93;182;7;19;26
96;31.05.2018;2018;05;13;Torstai;90;85;175;7;9;16
96;31.05.2018;2018;05;14;Torstai;86;100;186;6;25;31
96;31.05.2018;2018;05;15;Torstai;123;189;312;10;18;28
96;31.05.2018;2018;05;16;Torstai;153;173;326;8;30;38
96;31.05.2018;2018;05;17;Torstai;113;122;235;11;13;24
96;31.05.2018;2018;05;18;Torstai;103;57;160;16;12;28
96;31.05.2018;2018;05;19;Torstai;81;61;142;7;10;17
96;31.05.2018;2018;05;20;Torstai;98;38;136;8;4;12
96;31.05.2018;2018;05;21;Torstai;51;45;96;5;4;9
96;31.05.2018;2018;05;22;Torstai;29;18;47;2;1;3
96;31.05.2018;2018;05;23;Torstai;7;1;8;2;0;2
96;01.06.2018;2018;06;00;Perjantai;8;0;8;0;0;0
96;01.06.2018;2018;06;01;Perjantai;4;0;4;0;0;0
96;01.06.2018;2018;06;02;Perjantai;1;0;1;0;0;0
96;01.06.2018;2018;06;03;Perjantai;2;0;2;1;0;1
96;01.06.2018;2018;06;04;Perjantai;5;0;5;0;0;0
96;01.06.2018;2018;06;05;Perjantai;12;0;12;15;0;15
96;01.06.2018;2018;06;06;Perjantai;114;0;114;5;0;5
96;01.06.2018;2018;06;07;Perjantai;284;0;284;17;0;17
96;01.06.2018;2018;06;08;Perjantai;229;0;229;11;0;11
96;01.06.2018;2018;06;09;Perjantai;132;0;132;10;0;10
96;01.06.2018;2018;06;10;Perjantai;133;0;133;15;0;15
96;01.06.2018;2018;06;11;Perjantai;206;0;206;21;0;21
96;01.06.2018;2018;06;12;Perjantai;174;0;174;27;0;27
96;01.06.2018;2018;06;13;Perjantai;211;0;211;19;0;19
96;01.06.2018;2018;06;14;Perjantai;289;0;289;35;0;35
96;01.06.2018;2018;06;15;Perjantai;281;0;281;43;0;43
96;01.06.2018;2018;06;16;Perjantai;224;0;224;29;0;29
96;01.06.2018;2018;06;17;Perjantai;146;0;146;23;0;23
96;01.06.2018;2018;06;18;Perjantai;136;0;136;11;0;11
96;01.06.2018;2018;06;19;Perjantai;126;0;126;21;0;21
96;01.06.2018;2018;06;20;Perjantai;102;0;102;18;0;18
96;01.06.2018;2018;06;21;Perjantai;79;0;79;6;0;6
96;01.06.2018;2018;06;22;Perjantai;53;0;53;6;0;6
96;01.06.2018;2018;06;23;Perjantai;27;0;27;7;0;7
96;02.06.2018;2018;06;00;Lauantai;19;12;31;3;2;5
96;02.06.2018;2018;06;01;Lauantai;16;3;19;0;0;0
96;02.06.2018;2018;06;02;Lauantai;15;4;19;1;0;1
96;02.06.2018;2018;06;03;Lauantai;16;1;17;1;0;1
96;02.06.2018;2018;06;04;Lauantai;8;5;13;1;0;1
96;02.06.2018;2018;06;05;Lauantai;10;5;15;14;0;14
96;02.06.2018;2018;06;06;Lauantai;33;6;39;3;1;4
96;02.06.2018;2018;06;07;Lauantai;13;24;37;1;2;3
96;02.06.2018;2018;06;08;Lauantai;19;26;45;5;1;6
96;02.06.2018;2018;06;09;Lauantai;29;66;95;3;8;11
96;02.06.2018;2018;06;10;Lauantai;55;48;103;16;7;23
96;02.06.2018;2018;06;11;Lauantai;42;57;99;3;4;7
96;02.06.2018;2018;06;12;Lauantai;72;76;148;5;11;16
96;02.06.2018;2018;06;13;Lauantai;67;70;137;8;7;15
96;02.06.2018;2018;06;14;Lauantai;72;89;161;5;24;29
96;02.06.2018;2018;06;15;Lauantai;75;56;131;9;10;19
96;02.06.2018;2018;06;16;Lauantai;71;37;108;7;7;14
96;02.06.2018;2018;06;17;Lauantai;56;53;109;3;9;12
96;02.06.2018;2018;06;18;Lauantai;43;60;103;5;4;9
96;02.06.2018;2018;06;19;Lauantai;45;39;84;7;4;11
96;02.06.2018;2018;06;20;Lauantai;48;58;106;6;6;12
96;02.06.2018;2018;06;21;Lauantai;28;32;60;1;1;2
96;02.06.2018;2018;06;22;Lauantai;36;20;56;2;1;3
96;02.06.2018;2018;06;23;Lauantai;23;22;45;1;3;4
96;03.06.2018;2018;06;00;Sunnuntai;20;15;35;4;2;6
96;03.06.2018;2018;06;01;Sunnuntai;25;3;28;3;1;4
96;03.06.2018;2018;06;02;Sunnuntai;35;3;38;4;0;4
96;03.06.2018;2018;06;03;Sunnuntai;26;3;29;6;1;7
96;03.06.2018;2018;06;04;Sunnuntai;22;4;26;3;0;3
96;03.06.2018;2018;06;05;Sunnuntai;13;1;14;3;0;3
96;03.06.2018;2018;06;06;Sunnuntai;16;5;21;1;0;1
96;03.06.2018;2018;06;07;Sunnuntai;6;10;16;0;3;3
96;03.06.2018;2018;06;08;Sunnuntai;6;9;15;4;1;5
96;03.06.2018;2018;06;09;Sunnuntai;26;38;64;8;6;14
96;03.06.2018;2018;06;10;Sunnuntai;24;31;55;5;6;11
96;03.06.2018;2018;06;11;Sunnuntai;28;43;71;6;6;12
96;03.06.2018;2018;06;12;Sunnuntai;57;39;96;7;5;12
96;03.06.2018;2018;06;13;Sunnuntai;57;69;126;5;10;15
96;03.06.2018;2018;06;14;Sunnuntai;57;65;122;12;15;27
96;03.06.2018;2018;06;15;Sunnuntai;64;67;131;9;6;15
96;03.06.2018;2018;06;16;Sunnuntai;74;57;131;5;2;7
96;03.06.2018;2018;06;17;Sunnuntai;58;34;92;12;4;16
96;03.06.2018;2018;06;18;Sunnuntai;74;35;109;11;16;27
96;03.06.2018;2018;06;19;Sunnuntai;30;34;64;5;9;14
96;03.06.2018;2018;06;20;Sunnuntai;28;34;62;7;5;12
96;03.06.2018;2018;06;21;Sunnuntai;15;29;44;3;3;6
96;03.06.2018;2018;06;22;Sunnuntai;15;11;26;1;2;3
96;03.06.2018;2018;06;23;Sunnuntai;5;2;7;1;1;2
96;04.06.2018;2018;06;00;Maanantai;1;1;2;2;0;2
96;04.06.2018;2018;06;01;Maanantai;2;0;2;1;0;1
96;04.06.2018;2018;06;02;Maanantai;1;0;1;0;0;0
96;04.06.2018;2018;06;03;Maanantai;2;0;2;0;0;0
96;04.06.2018;2018;06;04;Maanantai;0;2;2;0;0;0
96;04.06.2018;2018;06;05;Maanantai;9;17;26;5;0;5
96;04.06.2018;2018;06;06;Maanantai;69;30;99;6;0;6
96;04.06.2018;2018;06;07;Maanantai;119;82;201;16;11;27
96;04.06.2018;2018;06;08;Maanantai;42;90;132;9;7;16
96;04.06.2018;2018;06;09;Maanantai;34;50;84;7;7;14
96;04.06.2018;2018;06;10;Maanantai;33;38;71;5;12;17
96;04.06.2018;2018;06;11;Maanantai;38;48;86;6;7;13
96;04.06.2018;2018;06;12;Maanantai;53;46;99;10;8;18
96;04.06.2018;2018;06;13;Maanantai;50;59;109;6;7;13
96;04.06.2018;2018;06;14;Maanantai;55;70;125;8;4;12
96;04.06.2018;2018;06;15;Maanantai;82;150;232;6;13;19
96;04.06.2018;2018;06;16;Maanantai;96;124;220;4;15;19
96;04.06.2018;2018;06;17;Maanantai;63;48;111;4;5;9
96;04.06.2018;2018;06;18;Maanantai;42;30;72;7;7;14
96;04.06.2018;2018;06;19;Maanantai;33;20;53;6;4;10
96;04.06.2018;2018;06;20;Maanantai;31;17;48;4;6;10
96;04.06.2018;2018;06;21;Maanantai;21;22;43;4;3;7
96;04.06.2018;2018;06;22;Maanantai;4;12;16;1;0;1
96;04.06.2018;2018;06;23;Maanantai;11;3;14;0;0;0
96;05.06.2018;2018;06;00;Tiistai;4;0;4;1;0;1
96;05.06.2018;2018;06;01;Tiistai;1;3;4;0;0;0
96;05.06.2018;2018;06;02;Tiistai;2;1;3;0;0;0
96;05.06.2018;2018;06;03;Tiistai;1;0;1;0;0;0
96;05.06.2018;2018;06;04;Tiistai;0;0;0;0;0;0
96;05.06.2018;2018;06;05;Tiistai;8;10;18;12;0;12
96;05.06.2018;2018;06;06;Tiistai;75;36;111;3;0;3
96;05.06.2018;2018;06;07;Tiistai;124;98;222;20;8;28
96;05.06.2018;2018;06;08;Tiistai;51;93;144;7;6;13
96;05.06.2018;2018;06;09;Tiistai;57;68;125;7;6;13
96;05.06.2018;2018;06;10;Tiistai;43;55;98;5;14;19
96;05.06.2018;2018;06;11;Tiistai;55;82;137;9;15;24
96;05.06.2018;2018;06;12;Tiistai;56;72;128;11;12;23
96;05.06.2018;2018;06;13;Tiistai;55;83;138;5;9;14
96;05.06.2018;2018;06;14;Tiistai;69;70;139;11;10;21
96;05.06.2018;2018;06;15;Tiistai;65;155;220;8;14;22
96;05.06.2018;2018;06;16;Tiistai;107;140;247;12;17;29
96;05.06.2018;2018;06;17;Tiistai;84;59;143;5;4;9
96;05.06.2018;2018;06;18;Tiistai;59;46;105;15;5;20
96;05.06.2018;2018;06;19;Tiistai;48;35;83;10;11;21
96;05.06.2018;2018;06;20;Tiistai;72;38;110;12;7;19
96;05.06.2018;2018;06;21;Tiistai;42;29;71;4;6;10
96;05.06.2018;2018;06;22;Tiistai;13;9;22;2;3;5
96;05.06.2018;2018;06;23;Tiistai;5;6;11;2;2;4
96;06.06.2018;2018;06;00;Keskiviikko;3;0;3;0;1;1
96;06.06.2018;2018;06;01;Keskiviikko;1;2;3;0;0;0
96;06.06.2018;2018;06;02;Keskiviikko;1;0;1;0;0;0
96;06.06.2018;2018;06;03;Keskiviikko;2;1;3;0;3;3
96;06.06.2018;2018;06;04;Keskiviikko;0;1;1;2;0;2
96;06.06.2018;2018;06;05;Keskiviikko;7;14;21;7;0;7
96;06.06.2018;2018;06;06;Keskiviikko;72;44;116;5;0;5
96;06.06.2018;2018;06;07;Keskiviikko;122;104;226;16;6;22
96;06.06.2018;2018;06;08;Keskiviikko;61;115;176;8;5;13
96;06.06.2018;2018;06;09;Keskiviikko;47;58;105;5;7;12
96;06.06.2018;2018;06;10;Keskiviikko;42;65;107;9;5;14
96;06.06.2018;2018;06;11;Keskiviikko;48;59;107;2;10;12
96;06.06.2018;2018;06;12;Keskiviikko;58;44;102;2;8;10
96;06.06.2018;2018;06;13;Keskiviikko;61;68;129;6;10;16
96;06.06.2018;2018;06;14;Keskiviikko;57;66;123;6;8;14
96;06.06.2018;2018;06;15;Keskiviikko;104;182;286;4;14;18
96;06.06.2018;2018;06;16;Keskiviikko;144;151;295;6;15;21
96;06.06.2018;2018;06;17;Keskiviikko;78;65;143;8;10;18
96;06.06.2018;2018;06;18;Keskiviikko;74;43;117;14;7;21
96;06.06.2018;2018;06;19;Keskiviikko;65;30;95;11;11;22
96;06.06.2018;2018;06;20;Keskiviikko;68;28;96;7;11;18
96;06.06.2018;2018;06;21;Keskiviikko;26;35;61;0;2;2
96;06.06.2018;2018;06;22;Keskiviikko;17;14;31;1;1;2
96;06.06.2018;2018;06;23;Keskiviikko;7;3;10;1;2;3
96;07.06.2018;2018;06;00;Torstai;7;6;13;1;0;1
96;07.06.2018;2018;06;01;Torstai;2;5;7;1;0;1
96;07.06.2018;2018;06;02;Torstai;5;4;9;0;0;0
96;07.06.2018;2018;06;03;Torstai;1;0;1;1;0;1
96;07.06.2018;2018;06;04;Torstai;1;1;2;0;0;0
96;07.06.2018;2018;06;05;Torstai;10;13;23;0;0;0
96;07.06.2018;2018;06;06;Torstai;52;24;76;4;3;7
96;07.06.2018;2018;06;07;Torstai;90;72;162;9;6;15
96;07.06.2018;2018;06;08;Torstai;39;62;101;2;4;6
96;07.06.2018;2018;06;09;Torstai;18;19;37;2;0;2
96;07.06.2018;2018;06;10;Torstai;22;24;46;5;8;13
96;07.06.2018;2018;06;11;Torstai;24;21;45;3;3;6
96;07.06.2018;2018;06;12;Torstai;44;31;75;9;5;14
96;07.06.2018;2018;06;13;Torstai;71;36;107;8;3;11
96;07.06.2018;2018;06;14;Torstai;47;65;112;6;12;18
96;07.06.2018;2018;06;15;Torstai;58;130;188;13;20;33
96;07.06.2018;2018;06;16;Torstai;75;94;169;8;13;21
96;07.06.2018;2018;06;17;Torstai;61;65;126;6;10;16
96;07.06.2018;2018;06;18;Torstai;49;40;89;6;9;15
96;07.06.2018;2018;06;19;Torstai;31;33;64;9;7;16
96;07.06.2018;2018;06;20;Torstai;44;26;70;2;9;11
96;07.06.2018;2018;06;21;Torstai;31;31;62;4;4;8
96;07.06.2018;2018;06;22;Torstai;17;24;41;2;3;5
96;07.06.2018;2018;06;23;Torstai;11;0;11;2;1;3
96;08.06.2018;2018;06;00;Perjantai;2;7;9;2;3;5
96;08.06.2018;2018;06;01;Perjantai;4;1;5;1;0;1
96;08.06.2018;2018;06;02;Perjantai;3;0;3;2;0;2
96;08.06.2018;2018;06;03;Perjantai;5;0;5;0;0;0
96;08.06.2018;2018;06;04;Perjantai;1;1;2;0;0;0
96;08.06.2018;2018;06;05;Perjantai;5;11;16;0;1;1
96;08.06.2018;2018;06;06;Perjantai;58;44;102;5;2;7
96;08.06.2018;2018;06;07;Perjantai;112;110;222;10;5;15
96;08.06.2018;2018;06;08;Perjantai;53;100;153;7;5;12
96;08.06.2018;2018;06;09;Perjantai;39;48;87;2;6;8
96;08.06.2018;2018;06;10;Perjantai;40;56;96;4;9;13
96;08.06.2018;2018;06;11;Perjantai;43;71;114;13;3;16
96;08.06.2018;2018;06;12;Perjantai;69;72;141;6;13;19
96;08.06.2018;2018;06;13;Perjantai;72;81;153;6;15;21
96;08.06.2018;2018;06;14;Perjantai;85;108;193;8;13;21
96;08.06.2018;2018;06;15;Perjantai;114;151;265;10;32;42
96;08.06.2018;2018;06;16;Perjantai;113;90;203;10;16;26
96;08.06.2018;2018;06;17;Perjantai;64;66;130;7;3;10
96;08.06.2018;2018;06;18;Perjantai;60;52;112;6;8;14
96;08.06.2018;2018;06;19;Perjantai;62;54;116;7;10;17
96;08.06.2018;2018;06;20;Perjantai;48;37;85;6;4;10
96;08.06.2018;2018;06;21;Perjantai;34;55;89;4;3;7
96;08.06.2018;2018;06;22;Perjantai;18;22;40;7;3;10
96;08.06.2018;2018;06;23;Perjantai;15;8;23;5;4;9
96;09.06.2018;2018;06;00;Lauantai;26;7;33;3;0;3
96;09.06.2018;2018;06;01;Lauantai;17;7;24;0;2;2
96;09.06.2018;2018;06;02;Lauantai;7;2;9;1;0;1
96;09.06.2018;2018;06;03;Lauantai;17;4;21;1;0;1
96;09.06.2018;2018;06;04;Lauantai;9;1;10;2;0;2
96;09.06.2018;2018;06;05;Lauantai;10;3;13;2;0;2
96;09.06.2018;2018;06;06;Lauantai;33;9;42;2;1;3
96;09.06.2018;2018;06;07;Lauantai;9;16;25;4;2;6
96;09.06.2018;2018;06;08;Lauantai;15;20;35;7;4;11
96;09.06.2018;2018;06;09;Lauantai;13;36;49;4;6;10
96;09.06.2018;2018;06;10;Lauantai;16;36;52;2;7;9
96;09.06.2018;2018;06;11;Lauantai;32;57;89;10;5;15
96;09.06.2018;2018;06;12;Lauantai;52;50;102;1;5;6
96;09.06.2018;2018;06;13;Lauantai;57;47;104;2;5;7
96;09.06.2018;2018;06;14;Lauantai;37;66;103;14;10;24
96;09.06.2018;2018;06;15;Lauantai;54;50;104;3;11;14
96;09.06.2018;2018;06;16;Lauantai;40;45;85;6;7;13
96;09.06.2018;2018;06;17;Lauantai;55;27;82;11;5;16
96;09.06.2018;2018;06;18;Lauantai;31;26;57;7;5;12
96;09.06.2018;2018;06;19;Lauantai;38;19;57;4;2;6
96;09.06.2018;2018;06;20;Lauantai;30;14;44;10;2;12
96;09.06.2018;2018;06;21;Lauantai;19;42;61;1;3;4
96;09.06.2018;2018;06;22;Lauantai;11;9;20;3;1;4
96;09.06.2018;2018;06;23;Lauantai;26;9;35;0;2;2
96;10.06.2018;2018;06;00;Sunnuntai;16;23;39;2;2;4
96;10.06.2018;2018;06;01;Sunnuntai;9;3;12;1;0;1
96;10.06.2018;2018;06;02;Sunnuntai;11;3;14;1;0;1
96;10.06.2018;2018;06;03;Sunnuntai;17;1;18;2;0;2
96;10.06.2018;2018;06;04;Sunnuntai;7;0;7;0;0;0
96;10.06.2018;2018;06;05;Sunnuntai;7;1;8;1;0;1
96;10.06.2018;2018;06;06;Sunnuntai;26;6;32;3;0;3
96;10.06.2018;2018;06;07;Sunnuntai;8;4;12;1;1;2
96;10.06.2018;2018;06;08;Sunnuntai;10;12;22;2;3;5
96;10.06.2018;2018;06;09;Sunnuntai;11;17;28;2;4;6
96;10.06.2018;2018;06;10;Sunnuntai;7;18;25;5;10;15
96;10.06.2018;2018;06;11;Sunnuntai;26;36;62;5;7;12
96;10.06.2018;2018;06;12;Sunnuntai;49;53;102;5;7;12
96;10.06.2018;2018;06;13;Sunnuntai;54;61;115;10;5;15
96;10.06.2018;2018;06;14;Sunnuntai;44;58;102;5;11;16
96;10.06.2018;2018;06;15;Sunnuntai;55;62;117;5;6;11
96;10.06.2018;2018;06;16;Sunnuntai;74;44;118;6;7;13
96;10.06.2018;2018;06;17;Sunnuntai;69;43;112;7;2;9
96;10.06.2018;2018;06;18;Sunnuntai;47;44;91;9;11;20
96;10.06.2018;2018;06;19;Sunnuntai;37;52;89;9;13;22
96;10.06.2018;2018;06;20;Sunnuntai;41;50;91;7;7;14
96;10.06.2018;2018;06;21;Sunnuntai;25;40;65;3;5;8
96;10.06.2018;2018;06;22;Sunnuntai;13;12;25;0;2;2
96;10.06.2018;2018;06;23;Sunnuntai;6;5;11;1;1;2
96;11.06.2018;2018;06;00;Maanantai;7;5;12;2;0;2
96;11.06.2018;2018;06;01;Maanantai;5;4;9;4;2;6
96;11.06.2018;2018;06;02;Maanantai;3;2;5;1;0;1
96;11.06.2018;2018;06;03;Maanantai;4;0;4;3;0;3
96;11.06.2018;2018;06;04;Maanantai;2;3;5;0;0;0
96;11.06.2018;2018;06;05;Maanantai;6;14;20;1;1;2
96;11.06.2018;2018;06;06;Maanantai;66;44;110;3;0;3
96;11.06.2018;2018;06;07;Maanantai;120;116;236;10;5;15
96;11.06.2018;2018;06;08;Maanantai;68;111;179;9;10;19
96;11.06.2018;2018;06;09;Maanantai;38;59;97;11;5;16
96;11.06.2018;2018;06;10;Maanantai;43;64;107;7;9;16
96;11.06.2018;2018;06;11;Maanantai;60;60;120;12;9;21
96;11.06.2018;2018;06;12;Maanantai;63;76;139;11;13;24
96;11.06.2018;2018;06;13;Maanantai;78;58;136;5;19;24
96;11.06.2018;2018;06;14;Maanantai;83;85;168;3;5;8
96;11.06.2018;2018;06;15;Maanantai;102;188;290;1;22;23
96;11.06.2018;2018;06;16;Maanantai;159;165;324;15;27;42
96;11.06.2018;2018;06;17;Maanantai;110;79;189;14;13;27
96;11.06.2018;2018;06;18;Maanantai;76;47;123;16;16;32
96;11.06.2018;2018;06;19;Maanantai;71;64;135;11;12;23
96;11.06.2018;2018;06;20;Maanantai;47;37;84;7;8;15
96;11.06.2018;2018;06;21;Maanantai;39;37;76;6;5;11
96;11.06.2018;2018;06;22;Maanantai;11;24;35;1;2;3
96;11.06.2018;2018;06;23;Maanantai;11;9;20;2;1;3
96;12.06.2018;2018;06;00;Tiistai;4;2;6;0;0;0
96;12.06.2018;2018;06;01;Tiistai;0;0;0;1;0;1
96;12.06.2018;2018;06;02;Tiistai;2;0;2;0;0;0
96;12.06.2018;2018;06;03;Tiistai;2;0;2;0;0;0
96;12.06.2018;2018;06;04;Tiistai;0;3;3;0;0;0
96;12.06.2018;2018;06;05;Tiistai;9;13;22;1;0;1
96;12.06.2018;2018;06;06;Tiistai;77;40;117;5;0;5
96;12.06.2018;2018;06;07;Tiistai;120;110;230;11;3;14
96;12.06.2018;2018;06;08;Tiistai;69;98;167;8;9;17
96;12.06.2018;2018;06;09;Tiistai;36;70;106;2;4;6
96;12.06.2018;2018;06;10;Tiistai;58;54;112;11;8;19
96;12.06.2018;2018;06;11;Tiistai;65;72;137;10;17;27
96;12.06.2018;2018;06;12;Tiistai;72;63;135;19;18;37
96;12.06.2018;2018;06;13;Tiistai;89;78;167;10;14;24
96;12.06.2018;2018;06;14;Tiistai;64;87;151;9;10;19
96;12.06.2018;2018;06;15;Tiistai;112;155;267;8;24;32
96;12.06.2018;2018;06;16;Tiistai;114;159;273;12;22;34
96;12.06.2018;2018;06;17;Tiistai;120;74;194;4;12;16
96;12.06.2018;2018;06;18;Tiistai;74;44;118;11;9;20
96;12.06.2018;2018;06;19;Tiistai;51;53;104;7;8;15
96;12.06.2018;2018;06;20;Tiistai;67;27;94;5;3;8
96;12.06.2018;2018;06;21;Tiistai;37;38;75;2;7;9
96;12.06.2018;2018;06;22;Tiistai;13;23;36;2;3;5
96;12.06.2018;2018;06;23;Tiistai;12;2;14;1;2;3
96;13.06.2018;2018;06;00;Keskiviikko;6;2;8;0;0;0
96;13.06.2018;2018;06;01;Keskiviikko;3;4;7;0;0;0
96;13.06.2018;2018;06;02;Keskiviikko;2;1;3;0;0;0
96;13.06.2018;2018;06;03;Keskiviikko;4;0;4;0;0;0
96;13.06.2018;2018;06;04;Keskiviikko;1;0;1;0;2;2
96;13.06.2018;2018;06;05;Keskiviikko;7;14;21;0;0;0
96;13.06.2018;2018;06;06;Keskiviikko;67;42;109;5;0;5
96;13.06.2018;2018;06;07;Keskiviikko;115;108;223;16;5;21
96;13.06.2018;2018;06;08;Keskiviikko;63;97;160;9;8;17
96;13.06.2018;2018;06;09;Keskiviikko;46;78;124;8;8;16
96;13.06.2018;2018;06;10;Keskiviikko;48;55;103;8;5;13
96;13.06.2018;2018;06;11;Keskiviikko;63;67;130;6;8;14
96;13.06.2018;2018;06;12;Keskiviikko;66;70;136;8;10;18
96;13.06.2018;2018;06;13;Keskiviikko;66;81;147;2;13;15
96;13.06.2018;2018;06;14;Keskiviikko;76;85;161;6;8;14
96;13.06.2018;2018;06;15;Keskiviikko;96;175;271;6;16;22
96;13.06.2018;2018;06;16;Keskiviikko;122;128;250;7;26;33
96;13.06.2018;2018;06;17;Keskiviikko;105;96;201;7;16;23
96;13.06.2018;2018;06;18;Keskiviikko;97;71;168;13;4;17
96;13.06.2018;2018;06;19;Keskiviikko;75;42;117;13;15;28
96;13.06.2018;2018;06;20;Keskiviikko;102;45;147;12;12;24
96;13.06.2018;2018;06;21;Keskiviikko;39;42;81;2;4;6
96;13.06.2018;2018;06;22;Keskiviikko;10;13;23;0;3;3
96;13.06.2018;2018;06;23;Keskiviikko;14;4;18;3;2;5
96;14.06.2018;2018;06;00;Torstai;8;5;13;1;0;1
96;14.06.2018;2018;06;01;Torstai;4;2;6;0;0;0
96;14.06.2018;2018;06;02;Torstai;2;0;2;0;0;0
96;14.06.2018;2018;06;03;Torstai;2;0;2;0;0;0
96;14.06.2018;2018;06;04;Torstai;1;0;1;0;2;2
96;14.06.2018;2018;06;05;Torstai;7;10;17;0;0;0
96;14.06.2018;2018;06;06;Torstai;82;31;113;6;1;7
96;14.06.2018;2018;06;07;Torstai;125;99;224;12;8;20
96;14.06.2018;2018;06;08;Torstai;67;114;181;6;13;19
96;14.06.2018;2018;06;09;Torstai;41;68;109;6;18;24
96;14.06.2018;2018;06;10;Torstai;47;65;112;16;7;23
96;14.06.2018;2018;06;11;Torstai;47;79;126;7;5;12
96;14.06.2018;2018;06;12;Torstai;80;66;146;5;7;12
96;14.06.2018;2018;06;13;Torstai;99;91;190;5;11;16
96;14.06.2018;2018;06;14;Torstai;76;98;174;4;8;12
96;14.06.2018;2018;06;15;Torstai;98;188;286;8;23;31
96;14.06.2018;2018;06;16;Torstai;154;159;313;6;13;19
96;14.06.2018;2018;06;17;Torstai;99;93;192;10;12;22
96;14.06.2018;2018;06;18;Torstai;82;66;148;12;12;24
96;14.06.2018;2018;06;19;Torstai;74;54;128;5;10;15
96;14.06.2018;2018;06;20;Torstai;54;44;98;8;6;14
96;14.06.2018;2018;06;21;Torstai;47;40;87;3;5;8
96;14.06.2018;2018;06;22;Torstai;27;13;40;3;6;9
96;14.06.2018;2018;06;23;Torstai;16;10;26;2;2;4
96;15.06.2018;2018;06;00;Perjantai;15;4;19;2;3;5
96;15.06.2018;2018;06;01;Perjantai;5;8;13;1;0;1
96;15.06.2018;2018;06;02;Perjantai;4;2;6;1;0;1
96;15.06.2018;2018;06;03;Perjantai;6;1;7;3;0;3
96;15.06.2018;2018;06;04;Perjantai;9;4;13;0;1;1
96;15.06.2018;2018;06;05;Perjantai;5;20;25;0;0;0
96;15.06.2018;2018;06;06;Perjantai;75;30;105;5;0;5
96;15.06.2018;2018;06;07;Perjantai;106;107;213;11;2;13
96;15.06.2018;2018;06;08;Perjantai;47;100;147;7;5;12
96;15.06.2018;2018;06;09;Perjantai;50;63;113;11;10;21
96;15.06.2018;2018;06;10;Perjantai;32;54;86;6;7;13
96;15.06.2018;2018;06;11;Perjantai;52;72;124;10;12;22
96;15.06.2018;2018;06;12;Perjantai;68;67;135;7;10;17
96;15.06.2018;2018;06;13;Perjantai;75;97;172;3;9;12
96;15.06.2018;2018;06;14;Perjantai;65;110;175;3;11;14
96;15.06.2018;2018;06;15;Perjantai;102;160;262;2;14;16
96;15.06.2018;2018;06;16;Perjantai;107;118;225;7;19;26
96;15.06.2018;2018;06;17;Perjantai;75;93;168;15;23;38
96;15.06.2018;2018;06;18;Perjantai;58;60;118;35;34;69
96;15.06.2018;2018;06;19;Perjantai;54;71;125;68;72;140
96;15.06.2018;2018;06;20;Perjantai;83;57;140;41;55;96
96;15.06.2018;2018;06;21;Perjantai;40;43;83;58;50;108
96;15.06.2018;2018;06;22;Perjantai;30;33;63;37;47;84
96;15.06.2018;2018;06;23;Perjantai;49;31;80;29;33;62
96;16.06.2018;2018;06;00;Lauantai;32;26;58;18;15;33
96;16.06.2018;2018;06;01;Lauantai;27;11;38;13;11;24
96;16.06.2018;2018;06;02;Lauantai;14;2;16;4;0;4
96;16.06.2018;2018;06;03;Lauantai;9;2;11;3;1;4
96;16.06.2018;2018;06;04;Lauantai;11;2;13;3;1;4
96;16.06.2018;2018;06;05;Lauantai;10;3;13;4;1;5
96;16.06.2018;2018;06;06;Lauantai;29;3;32;3;1;4
96;16.06.2018;2018;06;07;Lauantai;4;11;15;0;6;6
96;16.06.2018;2018;06;08;Lauantai;12;23;35;2;4;6
96;16.06.2018;2018;06;09;Lauantai;14;49;63;4;5;9
96;16.06.2018;2018;06;10;Lauantai;28;65;93;4;2;6
96;16.06.2018;2018;06;11;Lauantai;51;93;144;3;10;13
96;16.06.2018;2018;06;12;Lauantai;65;65;130;4;11;15
96;16.06.2018;2018;06;13;Lauantai;61;73;134;6;17;23
96;16.06.2018;2018;06;14;Lauantai;71;71;142;11;14;25
96;16.06.2018;2018;06;15;Lauantai;94;84;178;8;17;25
96;16.06.2018;2018;06;16;Lauantai;81;50;131;19;13;32
96;16.06.2018;2018;06;17;Lauantai;77;51;128;30;34;64
96;16.06.2018;2018;06;18;Lauantai;89;70;159;25;39;64
96;16.06.2018;2018;06;19;Lauantai;34;42;76;44;48;92
96;16.06.2018;2018;06;20;Lauantai;31;49;80;37;52;89
96;16.06.2018;2018;06;21;Lauantai;42;48;90;43;58;101
96;16.06.2018;2018;06;22;Lauantai;26;27;53;22;31;53
96;16.06.2018;2018;06;23;Lauantai;22;12;34;39;32;71
96;17.06.2018;2018;06;00;Sunnuntai;47;10;57;17;8;25
96;17.06.2018;2018;06;01;Sunnuntai;26;16;42;6;2;8
96;17.06.2018;2018;06;02;Sunnuntai;16;3;19;1;0;1
96;17.06.2018;2018;06;03;Sunnuntai;17;2;19;2;1;3
96;17.06.2018;2018;06;04;Sunnuntai;13;3;16;1;0;1
96;17.06.2018;2018;06;05;Sunnuntai;8;2;10;1;1;2
96;17.06.2018;2018;06;06;Sunnuntai;28;6;34;1;0;1
96;17.06.2018;2018;06;07;Sunnuntai;9;10;19;1;5;6
96;17.06.2018;2018;06;08;Sunnuntai;4;10;14;0;4;4
96;17.06.2018;2018;06;09;Sunnuntai;14;23;37;3;4;7
96;17.06.2018;2018;06;10;Sunnuntai;21;37;58;7;7;14
96;17.06.2018;2018;06;11;Sunnuntai;37;59;96;6;4;10
96;17.06.2018;2018;06;12;Sunnuntai;52;60;112;6;5;11
96;17.06.2018;2018;06;13;Sunnuntai;81;77;158;7;10;17
96;17.06.2018;2018;06;14;Sunnuntai;50;73;123;4;16;20
96;17.06.2018;2018;06;15;Sunnuntai;58;65;123;4;12;16
96;17.06.2018;2018;06;16;Sunnuntai;77;57;134;14;14;28
96;17.06.2018;2018;06;17;Sunnuntai;69;57;126;11;5;16
96;17.06.2018;2018;06;18;Sunnuntai;57;51;108;11;9;20
96;17.06.2018;2018;06;19;Sunnuntai;61;53;114;8;8;16
96;17.06.2018;2018;06;20;Sunnuntai;49;35;84;8;6;14
96;17.06.2018;2018;06;21;Sunnuntai;22;48;70;2;10;12
96;17.06.2018;2018;06;22;Sunnuntai;14;21;35;0;4;4
96;17.06.2018;2018;06;23;Sunnuntai;10;6;16;2;1;3
96;18.06.2018;2018;06;00;Maanantai;7;1;8;5;1;6
96;18.06.2018;2018;06;01;Maanantai;7;6;13;0;0;0
96;18.06.2018;2018;06;02;Maanantai;6;2;8;0;0;0
96;18.06.2018;2018;06;03;Maanantai;4;0;4;0;0;0
96;18.06.2018;2018;06;04;Maanantai;0;2;2;0;0;0
96;18.06.2018;2018;06;05;Maanantai;10;14;24;1;0;1
96;18.06.2018;2018;06;06;Maanantai;70;41;111;5;0;5
96;18.06.2018;2018;06;07;Maanantai;121;96;217;7;2;9
96;18.06.2018;2018;06;08;Maanantai;64;99;163;3;7;10
96;18.06.2018;2018;06;09;Maanantai;39;43;82;8;1;9
96;18.06.2018;2018;06;10;Maanantai;29;45;74;4;11;15
96;18.06.2018;2018;06;11;Maanantai;47;40;87;4;4;8
96;18.06.2018;2018;06;12;Maanantai;47;51;98;5;6;11
96;18.06.2018;2018;06;13;Maanantai;42;53;95;12;7;19
96;18.06.2018;2018;06;14;Maanantai;66;68;134;5;11;16
96;18.06.2018;2018;06;15;Maanantai;97;144;241;6;21;27
96;18.06.2018;2018;06;16;Maanantai;101;140;241;6;18;24
96;18.06.2018;2018;06;17;Maanantai;81;76;157;5;7;12
96;18.06.2018;2018;06;18;Maanantai;52;45;97;12;5;17
96;18.06.2018;2018;06;19;Maanantai;44;30;74;6;9;15
96;18.06.2018;2018;06;20;Maanantai;46;21;67;7;5;12
96;18.06.2018;2018;06;21;Maanantai;35;27;62;4;3;7
96;18.06.2018;2018;06;22;Maanantai;10;13;23;1;3;4
96;18.06.2018;2018;06;23;Maanantai;8;9;17;1;1;2
96;19.06.2018;2018;06;00;Tiistai;6;5;11;4;1;5
96;19.06.2018;2018;06;01;Tiistai;1;0;1;0;0;0
96;19.06.2018;2018;06;02;Tiistai;3;5;8;1;1;2
96;19.06.2018;2018;06;03;Tiistai;2;2;4;4;0;4
96;19.06.2018;2018;06;04;Tiistai;1;1;2;0;0;0
96;19.06.2018;2018;06;05;Tiistai;9;11;20;1;0;1
96;19.06.2018;2018;06;06;Tiistai;75;29;104;4;1;5
96;19.06.2018;2018;06;07;Tiistai;121;92;213;14;6;20
96;19.06.2018;2018;06;08;Tiistai;66;74;140;8;5;13
96;19.06.2018;2018;06;09;Tiistai;40;67;107;8;8;16
96;19.06.2018;2018;06;10;Tiistai;31;65;96;8;11;19
96;19.06.2018;2018;06;11;Tiistai;57;42;99;8;7;15
96;19.06.2018;2018;06;12;Tiistai;48;33;81;2;0;2
96;19.06.2018;2018;06;13;Tiistai;49;29;78;3;3;6
96;19.06.2018;2018;06;14;Tiistai;36;53;89;3;3;6
96;19.06.2018;2018;06;15;Tiistai;54;129;183;1;9;10
96;19.06.2018;2018;06;16;Tiistai;56;107;163;3;10;13
96;19.06.2018;2018;06;17;Tiistai;57;55;112;4;3;7
96;19.06.2018;2018;06;18;Tiistai;49;30;79;5;5;10
96;19.06.2018;2018;06;19;Tiistai;43;30;73;9;7;16
96;19.06.2018;2018;06;20;Tiistai;36;25;61;5;4;9
96;19.06.2018;2018;06;21;Tiistai;17;33;50;2;2;4
96;19.06.2018;2018;06;22;Tiistai;8;11;19;1;2;3
96;19.06.2018;2018;06;23;Tiistai;9;6;15;0;0;0
96;20.06.2018;2018;06;00;Keskiviikko;8;4;12;1;0;1
96;20.06.2018;2018;06;01;Keskiviikko;3;3;6;0;0;0
96;20.06.2018;2018;06;02;Keskiviikko;0;1;1;0;0;0
96;20.06.2018;2018;06;03;Keskiviikko;1;1;2;1;1;2
96;20.06.2018;2018;06;04;Keskiviikko;2;0;2;1;0;1
96;20.06.2018;2018;06;05;Keskiviikko;11;10;21;0;2;2
96;20.06.2018;2018;06;06;Keskiviikko;64;27;91;6;1;7
96;20.06.2018;2018;06;07;Keskiviikko;115;88;203;10;5;15
96;20.06.2018;2018;06;08;Keskiviikko;68;99;167;7;4;11
96;20.06.2018;2018;06;09;Keskiviikko;35;65;100;8;13;21
96;20.06.2018;2018;06;10;Keskiviikko;34;57;91;8;5;13
96;20.06.2018;2018;06;11;Keskiviikko;60;58;118;5;10;15
96;20.06.2018;2018;06;12;Keskiviikko;57;67;124;9;8;17
96;20.06.2018;2018;06;13;Keskiviikko;85;75;160;1;7;8
96;20.06.2018;2018;06;14;Keskiviikko;80;69;149;0;9;9
96;20.06.2018;2018;06;15;Keskiviikko;91;167;258;8;26;34
96;20.06.2018;2018;06;16;Keskiviikko;133;148;281;6;17;23
96;20.06.2018;2018;06;17;Keskiviikko;88;81;169;7;5;12
96;20.06.2018;2018;06;18;Keskiviikko;85;53;138;10;5;15
96;20.06.2018;2018;06;19;Keskiviikko;62;45;107;8;7;15
96;20.06.2018;2018;06;20;Keskiviikko;67;39;106;7;8;15
96;20.06.2018;2018;06;21;Keskiviikko;27;47;74;0;3;3
96;20.06.2018;2018;06;22;Keskiviikko;16;19;35;4;3;7
96;20.06.2018;2018;06;23;Keskiviikko;21;11;32;5;1;6
96;21.06.2018;2018;06;00;Torstai;4;7;11;1;1;2
96;21.06.2018;2018;06;01;Torstai;5;1;6;1;0;1
96;21.06.2018;2018;06;02;Torstai;5;4;9;0;0;0
96;21.06.2018;2018;06;03;Torstai;3;1;4;1;0;1
96;21.06.2018;2018;06;04;Torstai;3;1;4;1;0;1
96;21.06.2018;2018;06;05;Torstai;9;8;17;0;1;1
96;21.06.2018;2018;06;06;Torstai;61;23;84;9;1;10
96;21.06.2018;2018;06;07;Torstai;104;105;209;5;5;10
96;21.06.2018;2018;06;08;Torstai;56;97;153;12;5;17
96;21.06.2018;2018;06;09;Torstai;34;74;108;6;5;11
96;21.06.2018;2018;06;10;Torstai;48;77;125;2;6;8
96;21.06.2018;2018;06;11;Torstai;63;66;129;5;4;9
96;21.06.2018;2018;06;12;Torstai;67;68;135;11;16;27
96;21.06.2018;2018;06;13;Torstai;90;99;189;6;8;14
96;21.06.2018;2018;06;14;Torstai;111;124;235;12;15;27
96;21.06.2018;2018;06;15;Torstai;87;115;202;2;24;26
96;21.06.2018;2018;06;16;Torstai;89;91;180;9;3;12
96;21.06.2018;2018;06;17;Torstai;69;68;137;7;12;19
96;21.06.2018;2018;06;18;Torstai;77;51;128;10;8;18
96;21.06.2018;2018;06;19;Torstai;47;36;83;1;4;5
96;21.06.2018;2018;06;20;Torstai;121;38;159;11;10;21
96;21.06.2018;2018;06;21;Torstai;43;35;78;3;7;10
96;21.06.2018;2018;06;22;Torstai;15;21;36;3;0;3
96;21.06.2018;2018;06;23;Torstai;14;22;36;2;1;3
96;22.06.2018;2018;06;00;Perjantai;20;33;53;1;1;2
96;22.06.2018;2018;06;01;Perjantai;20;23;43;2;2;4
96;22.06.2018;2018;06;02;Perjantai;8;2;10;2;1;3
96;22.06.2018;2018;06;03;Perjantai;1;0;1;0;0;0
96;22.06.2018;2018;06;04;Perjantai;10;7;17;1;0;1
96;22.06.2018;2018;06;05;Perjantai;8;4;12;3;1;4
96;22.06.2018;2018;06;06;Perjantai;18;4;22;5;0;5
96;22.06.2018;2018;06;07;Perjantai;7;17;24;0;1;1
96;22.06.2018;2018;06;08;Perjantai;3;12;15;1;1;2
96;22.06.2018;2018;06;09;Perjantai;9;7;16;1;5;6
96;22.06.2018;2018;06;10;Perjantai;8;9;17;0;4;4
96;22.06.2018;2018;06;11;Perjantai;5;5;10;3;3;6
96;22.06.2018;2018;06;12;Perjantai;14;6;20;4;6;10
96;22.06.2018;2018;06;13;Perjantai;16;12;28;2;2;4
96;22.06.2018;2018;06;14;Perjantai;4;16;20;3;3;6
96;22.06.2018;2018;06;15;Perjantai;10;23;33;3;4;7
96;22.06.2018;2018;06;16;Perjantai;15;17;32;3;3;6
96;22.06.2018;2018;06;17;Perjantai;12;9;21;10;1;11
96;22.06.2018;2018;06;18;Perjantai;10;9;19;0;1;1
96;22.06.2018;2018;06;19;Perjantai;13;10;23;0;2;2
96;22.06.2018;2018;06;20;Perjantai;16;9;25;7;0;7
96;22.06.2018;2018;06;21;Perjantai;8;16;24;2;5;7
96;22.06.2018;2018;06;22;Perjantai;5;15;20;3;4;7
96;22.06.2018;2018;06;23;Perjantai;4;9;13;3;1;4
96;23.06.2018;2018;06;00;Lauantai;11;4;15;2;4;6
96;23.06.2018;2018;06;01;Lauantai;6;7;13;0;1;1
96;23.06.2018;2018;06;02;Lauantai;6;2;8;0;0;0
96;23.06.2018;2018;06;03;Lauantai;4;1;5;3;0;3
96;23.06.2018;2018;06;04;Lauantai;7;2;9;1;0;1
96;23.06.2018;2018;06;05;Lauantai;4;3;7;1;0;1
96;23.06.2018;2018;06;06;Lauantai;14;1;15;1;0;1
96;23.06.2018;2018;06;07;Lauantai;1;10;11;1;1;2
96;23.06.2018;2018;06;08;Lauantai;3;2;5;3;4;7
96;23.06.2018;2018;06;09;Lauantai;2;3;5;2;5;7
96;23.06.2018;2018;06;10;Lauantai;7;8;15;0;1;1
96;23.06.2018;2018;06;11;Lauantai;9;7;16;0;0;0
96;23.06.2018;2018;06;12;Lauantai;16;12;28;7;3;10
96;23.06.2018;2018;06;13;Lauantai;19;11;30;8;4;12
96;23.06.2018;2018;06;14;Lauantai;21;8;29;11;7;18
96;23.06.2018;2018;06;15;Lauantai;16;28;44;3;1;4
96;23.06.2018;2018;06;16;Lauantai;22;26;48;9;4;13
96;23.06.2018;2018;06;17;Lauantai;20;18;38;10;1;11
96;23.06.2018;2018;06;18;Lauantai;18;30;48;6;7;13
96;23.06.2018;2018;06;19;Lauantai;18;19;37;3;5;8
96;23.06.2018;2018;06;20;Lauantai;30;25;55;5;6;11
96;23.06.2018;2018;06;21;Lauantai;17;23;40;3;3;6
96;23.06.2018;2018;06;22;Lauantai;11;4;15;2;0;2
96;23.06.2018;2018;06;23;Lauantai;7;13;20;2;4;6
96;24.06.2018;2018;06;00;Sunnuntai;1;1;2;0;0;0
96;24.06.2018;2018;06;01;Sunnuntai;10;8;18;1;3;4
96;24.06.2018;2018;06;02;Sunnuntai;0;2;2;0;1;1
96;24.06.2018;2018;06;03;Sunnuntai;7;5;12;2;0;2
96;24.06.2018;2018;06;04;Sunnuntai;9;1;10;0;0;0
96;24.06.2018;2018;06;05;Sunnuntai;4;2;6;2;0;2
96;24.06.2018;2018;06;06;Sunnuntai;17;4;21;2;0;2
96;24.06.2018;2018;06;07;Sunnuntai;3;12;15;1;2;3
96;24.06.2018;2018;06;08;Sunnuntai;6;5;11;2;1;3
96;24.06.2018;2018;06;09;Sunnuntai;6;19;25;5;18;23
96;24.06.2018;2018;06;10;Sunnuntai;20;24;44;5;4;9
96;24.06.2018;2018;06;11;Sunnuntai;38;30;68;7;7;14
96;24.06.2018;2018;06;12;Sunnuntai;39;42;81;6;5;11
96;24.06.2018;2018;06;13;Sunnuntai;52;47;99;19;15;34
96;24.06.2018;2018;06;14;Sunnuntai;35;45;80;7;6;13
96;24.06.2018;2018;06;15;Sunnuntai;53;62;115;5;11;16
96;24.06.2018;2018;06;16;Sunnuntai;58;39;97;21;6;27
96;24.06.2018;2018;06;17;Sunnuntai;43;37;80;9;4;13
96;24.06.2018;2018;06;18;Sunnuntai;42;24;66;5;9;14
96;24.06.2018;2018;06;19;Sunnuntai;34;45;79;7;5;12
96;24.06.2018;2018;06;20;Sunnuntai;26;40;66;9;12;21
96;24.06.2018;2018;06;21;Sunnuntai;34;28;62;11;3;14
96;24.06.2018;2018;06;22;Sunnuntai;14;18;32;1;3;4
96;24.06.2018;2018;06;23;Sunnuntai;4;8;12;1;0;1
96;25.06.2018;2018;06;00;Maanantai;6;7;13;2;1;3
96;25.06.2018;2018;06;01;Maanantai;8;3;11;0;0;0
96;25.06.2018;2018;06;02;Maanantai;3;1;4;0;1;1
96;25.06.2018;2018;06;03;Maanantai;4;0;4;0;0;0
96;25.06.2018;2018;06;04;Maanantai;2;1;3;0;0;0
96;25.06.2018;2018;06;05;Maanantai;9;13;22;0;1;1
96;25.06.2018;2018;06;06;Maanantai;48;33;81;5;0;5
96;25.06.2018;2018;06;07;Maanantai;119;91;210;10;9;19
96;25.06.2018;2018;06;08;Maanantai;44;100;144;7;3;10
96;25.06.2018;2018;06;09;Maanantai;27;68;95;8;8;16
96;25.06.2018;2018;06;10;Maanantai;35;76;111;9;11;20
96;25.06.2018;2018;06;11;Maanantai;70;70;140;13;12;25
96;25.06.2018;2018;06;12;Maanantai;81;71;152;9;10;19
96;25.06.2018;2018;06;13;Maanantai;105;77;182;4;7;11
96;25.06.2018;2018;06;14;Maanantai;95;92;187;2;14;16
96;25.06.2018;2018;06;15;Maanantai;115;159;274;12;27;39
96;25.06.2018;2018;06;16;Maanantai;128;137;265;8;20;28
96;25.06.2018;2018;06;17;Maanantai;103;72;175;6;18;24
96;25.06.2018;2018;06;18;Maanantai;97;52;149;9;10;19
96;25.06.2018;2018;06;19;Maanantai;85;43;128;7;10;17
96;25.06.2018;2018;06;20;Maanantai;71;36;107;6;10;16
96;25.06.2018;2018;06;21;Maanantai;46;48;94;6;4;10
96;25.06.2018;2018;06;22;Maanantai;11;28;39;3;3;6
96;25.06.2018;2018;06;23;Maanantai;12;5;17;1;0;1
96;26.06.2018;2018;06;00;Tiistai;7;7;14;0;0;0
96;26.06.2018;2018;06;01;Tiistai;2;6;8;0;1;1
96;26.06.2018;2018;06;02;Tiistai;1;4;5;0;0;0
96;26.06.2018;2018;06;03;Tiistai;3;0;3;0;0;0
96;26.06.2018;2018;06;04;Tiistai;1;0;1;3;1;4
96;26.06.2018;2018;06;05;Tiistai;4;13;17;0;0;0
96;26.06.2018;2018;06;06;Tiistai;61;34;95;5;2;7
96;26.06.2018;2018;06;07;Tiistai;119;92;211;15;2;17
96;26.06.2018;2018;06;08;Tiistai;70;103;173;6;4;10
96;26.06.2018;2018;06;09;Tiistai;32;61;93;5;7;12
96;26.06.2018;2018;06;10;Tiistai;32;70;102;4;9;13
96;26.06.2018;2018;06;11;Tiistai;36;56;92;8;7;15
96;26.06.2018;2018;06;12;Tiistai;68;73;141;11;7;18
96;26.06.2018;2018;06;13;Tiistai;83;64;147;5;10;15
96;26.06.2018;2018;06;14;Tiistai;77;84;161;6;6;12
96;26.06.2018;2018;06;15;Tiistai;102;183;285;7;11;18
96;26.06.2018;2018;06;16;Tiistai;135;138;273;6;15;21
96;26.06.2018;2018;06;17;Tiistai;93;87;180;12;15;27
96;26.06.2018;2018;06;18;Tiistai;70;60;130;2;7;9
96;26.06.2018;2018;06;19;Tiistai;65;39;104;8;12;20
96;26.06.2018;2018;06;20;Tiistai;92;30;122;4;4;8
96;26.06.2018;2018;06;21;Tiistai;38;43;81;2;3;5
96;26.06.2018;2018;06;22;Tiistai;14;28;42;4;3;7
96;26.06.2018;2018;06;23;Tiistai;18;13;31;1;1;2
96;27.06.2018;2018;06;00;Keskiviikko;8;11;19;3;2;5
96;27.06.2018;2018;06;01;Keskiviikko;3;5;8;1;1;2
96;27.06.2018;2018;06;02;Keskiviikko;6;1;7;0;0;0
96;27.06.2018;2018;06;03;Keskiviikko;2;3;5;0;0;0
96;27.06.2018;2018;06;04;Keskiviikko;2;2;4;0;0;0
96;27.06.2018;2018;06;05;Keskiviikko;3;11;14;0;0;0
96;27.06.2018;2018;06;06;Keskiviikko;73;39;112;0;1;1
96;27.06.2018;2018;06;07;Keskiviikko;103;88;191;14;5;19
96;27.06.2018;2018;06;08;Keskiviikko;56;95;151;3;2;5
96;27.06.2018;2018;06;09;Keskiviikko;28;59;87;4;2;6
96;27.06.2018;2018;06;10;Keskiviikko;53;55;108;4;2;6
96;27.06.2018;2018;06;11;Keskiviikko;30;64;94;5;5;10
96;27.06.2018;2018;06;12;Keskiviikko;73;64;137;10;11;21
96;27.06.2018;2018;06;13;Keskiviikko;86;59;145;8;4;12
96;27.06.2018;2018;06;14;Keskiviikko;70;78;148;13;13;26
96;27.06.2018;2018;06;15;Keskiviikko;109;169;278;1;21;22
96;27.06.2018;2018;06;16;Keskiviikko;118;149;267;8;22;30
96;27.06.2018;2018;06;17;Keskiviikko;84;64;148;11;8;19
96;27.06.2018;2018;06;18;Keskiviikko;75;41;116;15;12;27
96;27.06.2018;2018;06;19;Keskiviikko;55;44;99;15;21;36
96;27.06.2018;2018;06;20;Keskiviikko;57;40;97;6;11;17
96;27.06.2018;2018;06;21;Keskiviikko;44;29;73;4;5;9
96;27.06.2018;2018;06;22;Keskiviikko;22;30;52;1;4;5
96;27.06.2018;2018;06;23;Keskiviikko;13;9;22;3;2;5
96;28.06.2018;2018;06;00;Torstai;9;5;14;1;0;1
96;28.06.2018;2018;06;01;Torstai;4;3;7;0;0;0
96;28.06.2018;2018;06;02;Torstai;9;2;11;0;1;1
96;28.06.2018;2018;06;03;Torstai;5;1;6;1;0;1
96;28.06.2018;2018;06;04;Torstai;3;2;5;2;1;3
96;28.06.2018;2018;06;05;Torstai;4;13;17;1;0;1
96;28.06.2018;2018;06;06;Torstai;61;23;84;1;1;2
96;28.06.2018;2018;06;07;Torstai;91;64;155;12;3;15
96;28.06.2018;2018;06;08;Torstai;42;50;92;5;2;7
96;28.06.2018;2018;06;09;Torstai;31;31;62;2;5;7
96;28.06.2018;2018;06;10;Torstai;20;17;37;6;8;14
96;28.06.2018;2018;06;11;Torstai;13;18;31;1;2;3
96;28.06.2018;2018;06;12;Torstai;30;20;50;3;3;6
96;28.06.2018;2018;06;13;Torstai;25;26;51;2;4;6
96;28.06.2018;2018;06;14;Torstai;15;42;57;3;2;5
96;28.06.2018;2018;06;15;Torstai;41;98;139;6;5;11
96;28.06.2018;2018;06;16;Torstai;48;83;131;3;5;8
96;28.06.2018;2018;06;17;Torstai;35;35;70;2;4;6
96;28.06.2018;2018;06;18;Torstai;26;18;44;1;5;6
96;28.06.2018;2018;06;19;Torstai;13;18;31;5;3;8
96;28.06.2018;2018;06;20;Torstai;25;9;34;5;3;8
96;28.06.2018;2018;06;21;Torstai;13;17;30;5;6;11
96;28.06.2018;2018;06;22;Torstai;7;13;20;1;3;4
96;28.06.2018;2018;06;23;Torstai;3;4;7;2;0;2
96;29.06.2018;2018;06;00;Perjantai;4;6;10;0;0;0
96;29.06.2018;2018;06;01;Perjantai;1;0;1;2;1;3
96;29.06.2018;2018;06;02;Perjantai;1;7;8;0;3;3
96;29.06.2018;2018;06;03;Perjantai;3;3;6;2;0;2
96;29.06.2018;2018;06;04;Perjantai;3;1;4;0;0;0
96;29.06.2018;2018;06;05;Perjantai;5;10;15;0;0;0
96;29.06.2018;2018;06;06;Perjantai;55;34;89;3;2;5
96;29.06.2018;2018;06;07;Perjantai;81;54;135;11;5;16
96;29.06.2018;2018;06;08;Perjantai;55;78;133;13;11;24
96;29.06.2018;2018;06;09;Perjantai;30;73;103;10;11;21
96;29.06.2018;2018;06;10;Perjantai;32;56;88;4;8;12
96;29.06.2018;2018;06;11;Perjantai;42;39;81;3;2;5
96;29.06.2018;2018;06;12;Perjantai;58;58;116;2;11;13
96;29.06.2018;2018;06;13;Perjantai;52;71;123;3;7;10
96;29.06.2018;2018;06;14;Perjantai;63;83;146;4;8;12
96;29.06.2018;2018;06;15;Perjantai;83;127;210;2;18;20
96;29.06.2018;2018;06;16;Perjantai;68;72;140;7;8;15
96;29.06.2018;2018;06;17;Perjantai;64;30;94;7;7;14
96;29.06.2018;2018;06;18;Perjantai;44;56;100;5;5;10
96;29.06.2018;2018;06;19;Perjantai;21;31;52;3;2;5
96;29.06.2018;2018;06;20;Perjantai;39;38;77;3;6;9
96;29.06.2018;2018;06;21;Perjantai;35;33;68;7;5;12
96;29.06.2018;2018;06;22;Perjantai;15;24;39;3;1;4
96;29.06.2018;2018;06;23;Perjantai;23;10;33;0;4;4
96;30.06.2018;2018;06;00;Lauantai;7;11;18;2;0;2
96;30.06.2018;2018;06;01;Lauantai;13;3;16;2;0;2
96;30.06.2018;2018;06;02;Lauantai;10;3;13;4;1;5
96;30.06.2018;2018;06;03;Lauantai;12;1;13;1;0;1
96;30.06.2018;2018;06;04;Lauantai;7;0;7;1;0;1
96;30.06.2018;2018;06;05;Lauantai;7;4;11;2;0;2
96;30.06.2018;2018;06;06;Lauantai;22;4;26;8;1;9
96;30.06.2018;2018;06;07;Lauantai;7;17;24;1;2;3
96;30.06.2018;2018;06;08;Lauantai;10;11;21;1;4;5
96;30.06.2018;2018;06;09;Lauantai;13;38;51;5;2;7
96;30.06.2018;2018;06;10;Lauantai;22;40;62;5;8;13
96;30.06.2018;2018;06;11;Lauantai;26;38;64;3;5;8
96;30.06.2018;2018;06;12;Lauantai;42;57;99;4;8;12
96;30.06.2018;2018;06;13;Lauantai;43;67;110;3;10;13
96;30.06.2018;2018;06;14;Lauantai;59;49;108;4;7;11
96;30.06.2018;2018;06;15;Lauantai;49;56;105;7;9;16
96;30.06.2018;2018;06;16;Lauantai;37;28;65;4;7;11
96;30.06.2018;2018;06;17;Lauantai;43;46;89;3;4;7
96;30.06.2018;2018;06;18;Lauantai;41;28;69;4;1;5
96;30.06.2018;2018;06;19;Lauantai;35;23;58;2;2;4
96;30.06.2018;2018;06;20;Lauantai;33;34;67;2;3;5
96;30.06.2018;2018;06;21;Lauantai;19;26;45;2;4;6
96;30.06.2018;2018;06;22;Lauantai;9;20;29;3;0;3
96;30.06.2018;2018;06;23;Lauantai;15;13;28;4;2;6
96;01.07.2018;2018;07;00;Sunnuntai;10;7;17;3;0;3
96;01.07.2018;2018;07;01;Sunnuntai;9;6;15;1;1;2
96;01.07.2018;2018;07;02;Sunnuntai;10;1;11;1;0;1
96;01.07.2018;2018;07;03;Sunnuntai;16;1;17;0;0;0
96;01.07.2018;2018;07;04;Sunnuntai;8;4;12;0;0;0
96;01.07.2018;2018;07;05;Sunnuntai;6;2;8;3;0;3
96;01.07.2018;2018;07;06;Sunnuntai;26;5;31;3;0;3
96;01.07.2018;2018;07;07;Sunnuntai;6;19;25;2;6;8
96;01.07.2018;2018;07;08;Sunnuntai;3;5;8;1;2;3
96;01.07.2018;2018;07;09;Sunnuntai;9;21;30;6;3;9
96;01.07.2018;2018;07;10;Sunnuntai;16;24;40;3;4;7
96;01.07.2018;2018;07;11;Sunnuntai;22;38;60;4;5;9
96;01.07.2018;2018;07;12;Sunnuntai;42;41;83;5;4;9
96;01.07.2018;2018;07;13;Sunnuntai;57;70;127;4;8;12
96;01.07.2018;2018;07;14;Sunnuntai;50;62;112;5;10;15
96;01.07.2018;2018;07;15;Sunnuntai;55;62;117;7;13;20
96;01.07.2018;2018;07;16;Sunnuntai;47;41;88;6;16;22
96;01.07.2018;2018;07;17;Sunnuntai;46;30;76;8;7;15
96;01.07.2018;2018;07;18;Sunnuntai;69;27;96;6;6;12
96;01.07.2018;2018;07;19;Sunnuntai;23;32;55;5;8;13
96;01.07.2018;2018;07;20;Sunnuntai;54;32;86;9;9;18
96;01.07.2018;2018;07;21;Sunnuntai;39;25;64;8;5;13
96;01.07.2018;2018;07;22;Sunnuntai;15;16;31;5;3;8
96;01.07.2018;2018;07;23;Sunnuntai;16;4;20;2;2;4
96;02.07.2018;2018;07;00;Maanantai;5;2;7;1;2;3
96;02.07.2018;2018;07;01;Maanantai;6;3;9;2;0;2
96;02.07.2018;2018;07;02;Maanantai;1;3;4;0;0;0
96;02.07.2018;2018;07;03;Maanantai;3;4;7;0;0;0
96;02.07.2018;2018;07;04;Maanantai;6;0;6;0;0;0
96;02.07.2018;2018;07;05;Maanantai;7;9;16;0;0;0
96;02.07.2018;2018;07;06;Maanantai;64;30;94;4;0;4
96;02.07.2018;2018;07;07;Maanantai;92;72;164;9;6;15
96;02.07.2018;2018;07;08;Maanantai;57;99;156;12;9;21
96;02.07.2018;2018;07;09;Maanantai;44;74;118;18;16;34
96;02.07.2018;2018;07;10;Maanantai;36;72;108;10;11;21
96;02.07.2018;2018;07;11;Maanantai;60;61;121;5;9;14
96;02.07.2018;2018;07;12;Maanantai;71;114;185;19;13;32
96;02.07.2018;2018;07;13;Maanantai;69;78;147;8;5;13
96;02.07.2018;2018;07;14;Maanantai;71;86;157;4;12;16
96;02.07.2018;2018;07;15;Maanantai;117;146;263;15;20;35
96;02.07.2018;2018;07;16;Maanantai;147;108;255;14;17;31
96;02.07.2018;2018;07;17;Maanantai;74;81;155;8;11;19
96;02.07.2018;2018;07;18;Maanantai;105;53;158;12;15;27
96;02.07.2018;2018;07;19;Maanantai;90;50;140;5;10;15
96;02.07.2018;2018;07;20;Maanantai;79;43;122;9;8;17
96;02.07.2018;2018;07;21;Maanantai;46;37;83;8;5;13
96;02.07.2018;2018;07;22;Maanantai;14;22;36;2;4;6
96;02.07.2018;2018;07;23;Maanantai;13;8;21;0;2;2
96;03.07.2018;2018;07;00;Tiistai;12;12;24;1;1;2
96;03.07.2018;2018;07;01;Tiistai;3;6;9;1;0;1
96;03.07.2018;2018;07;02;Tiistai;13;2;15;2;0;2
96;03.07.2018;2018;07;03;Tiistai;3;0;3;1;0;1
96;03.07.2018;2018;07;04;Tiistai;4;2;6;2;0;2
96;03.07.2018;2018;07;05;Tiistai;3;13;16;0;0;0
96;03.07.2018;2018;07;06;Tiistai;75;32;107;2;0;2
96;03.07.2018;2018;07;07;Tiistai;98;77;175;15;3;18
96;03.07.2018;2018;07;08;Tiistai;46;91;137;6;10;16
96;03.07.2018;2018;07;09;Tiistai;22;59;81;3;7;10
96;03.07.2018;2018;07;10;Tiistai;29;65;94;1;4;5
96;03.07.2018;2018;07;11;Tiistai;49;78;127;5;4;9
96;03.07.2018;2018;07;12;Tiistai;52;65;117;4;7;11
96;03.07.2018;2018;07;13;Tiistai;72;76;148;7;11;18
96;03.07.2018;2018;07;14;Tiistai;59;72;131;4;11;15
96;03.07.2018;2018;07;15;Tiistai;97;176;273;8;13;21
96;03.07.2018;2018;07;16;Tiistai;86;109;195;6;8;14
96;03.07.2018;2018;07;17;Tiistai;65;48;113;2;10;12
96;03.07.2018;2018;07;18;Tiistai;82;48;130;5;5;10
96;03.07.2018;2018;07;19;Tiistai;55;36;91;10;7;17
96;03.07.2018;2018;07;20;Tiistai;49;42;91;5;5;10
96;03.07.2018;2018;07;21;Tiistai;41;36;77;4;4;8
96;03.07.2018;2018;07;22;Tiistai;11;20;31;0;6;6
96;03.07.2018;2018;07;23;Tiistai;9;3;12;0;0;0
96;04.07.2018;2018;07;00;Keskiviikko;8;14;22;1;0;1
96;04.07.2018;2018;07;01;Keskiviikko;0;1;1;0;0;0
96;04.07.2018;2018;07;02;Keskiviikko;1;0;1;0;0;0
96;04.07.2018;2018;07;03;Keskiviikko;5;1;6;0;0;0
96;04.07.2018;2018;07;04;Keskiviikko;1;0;1;0;0;0
96;04.07.2018;2018;07;05;Keskiviikko;7;8;15;0;1;1
96;04.07.2018;2018;07;06;Keskiviikko;49;28;77;2;0;2
96;04.07.2018;2018;07;07;Keskiviikko;58;38;96;9;3;12
96;04.07.2018;2018;07;08;Keskiviikko;22;37;59;2;0;2
96;04.07.2018;2018;07;09;Keskiviikko;7;24;31;2;2;4
96;04.07.2018;2018;07;10;Keskiviikko;13;31;44;5;5;10
96;04.07.2018;2018;07;11;Keskiviikko;16;13;29;19;13;32
96;04.07.2018;2018;07;12;Keskiviikko;24;10;34;4;4;8
96;04.07.2018;2018;07;13;Keskiviikko;25;32;57;2;4;6
96;04.07.2018;2018;07;14;Keskiviikko;42;40;82;5;6;11
96;04.07.2018;2018;07;15;Keskiviikko;50;109;159;7;7;14
96;04.07.2018;2018;07;16;Keskiviikko;47;75;122;5;15;20
96;04.07.2018;2018;07;17;Keskiviikko;58;77;135;10;11;21
96;04.07.2018;2018;07;18;Keskiviikko;53;48;101;5;5;10
96;04.07.2018;2018;07;19;Keskiviikko;66;50;116;2;4;6
96;04.07.2018;2018;07;20;Keskiviikko;44;38;82;7;6;13
96;04.07.2018;2018;07;21;Keskiviikko;29;41;70;2;5;7
96;04.07.2018;2018;07;22;Keskiviikko;14;28;42;2;3;5
96;04.07.2018;2018;07;23;Keskiviikko;9;11;20;2;1;3
96;05.07.2018;2018;07;00;Torstai;9;12;21;1;0;1
96;05.07.2018;2018;07;01;Torstai;6;3;9;2;2;4
96;05.07.2018;2018;07;02;Torstai;7;2;9;1;0;1
96;05.07.2018;2018;07;03;Torstai;5;1;6;0;0;0
96;05.07.2018;2018;07;04;Torstai;1;1;2;2;0;2
96;05.07.2018;2018;07;05;Torstai;7;10;17;0;0;0
96;05.07.2018;2018;07;06;Torstai;77;27;104;4;1;5
96;05.07.2018;2018;07;07;Torstai;74;87;161;9;9;18
96;05.07.2018;2018;07;08;Torstai;63;97;160;25;14;39
96;05.07.2018;2018;07;09;Torstai;44;83;127;27;7;34
96;05.07.2018;2018;07;10;Torstai;46;67;113;9;8;17
96;05.07.2018;2018;07;11;Torstai;47;73;120;4;10;14
96;05.07.2018;2018;07;12;Torstai;70;72;142;18;21;39
96;05.07.2018;2018;07;13;Torstai;85;76;161;6;10;16
96;05.07.2018;2018;07;14;Torstai;81;91;172;7;5;12
96;05.07.2018;2018;07;15;Torstai;91;172;263;9;9;18
96;05.07.2018;2018;07;16;Torstai;93;111;204;7;11;18
96;05.07.2018;2018;07;17;Torstai;53;79;132;5;6;11
96;05.07.2018;2018;07;18;Torstai;44;53;97;6;8;14
96;05.07.2018;2018;07;19;Torstai;52;33;85;8;6;14
96;05.07.2018;2018;07;20;Torstai;54;26;80;7;6;13
96;05.07.2018;2018;07;21;Torstai;25;34;59;5;9;14
96;05.07.2018;2018;07;22;Torstai;15;13;28;2;4;6
96;05.07.2018;2018;07;23;Torstai;9;10;19;0;3;3
96;06.07.2018;2018;07;00;Perjantai;9;1;10;2;0;2
96;06.07.2018;2018;07;01;Perjantai;5;5;10;2;3;5
96;06.07.2018;2018;07;02;Perjantai;4;2;6;1;0;1
96;06.07.2018;2018;07;03;Perjantai;9;1;10;0;0;0
96;06.07.2018;2018;07;04;Perjantai;4;2;6;0;1;1
96;06.07.2018;2018;07;05;Perjantai;7;9;16;0;0;0
96;06.07.2018;2018;07;06;Perjantai;66;29;95;2;0;2
96;06.07.2018;2018;07;07;Perjantai;67;65;132;8;5;13
96;06.07.2018;2018;07;08;Perjantai;32;66;98;5;4;9
96;06.07.2018;2018;07;09;Perjantai;31;42;73;1;5;6
96;06.07.2018;2018;07;10;Perjantai;27;52;79;10;9;19
96;06.07.2018;2018;07;11;Perjantai;46;60;106;5;10;15
96;06.07.2018;2018;07;12;Perjantai;59;91;150;5;7;12
96;06.07.2018;2018;07;13;Perjantai;64;102;166;9;15;24
96;06.07.2018;2018;07;14;Perjantai;80;111;191;6;15;21
96;06.07.2018;2018;07;15;Perjantai;108;153;261;3;11;14
96;06.07.2018;2018;07;16;Perjantai;88;86;174;9;11;20
96;06.07.2018;2018;07;17;Perjantai;70;77;147;6;5;11
96;06.07.2018;2018;07;18;Perjantai;68;58;126;2;3;5
96;06.07.2018;2018;07;19;Perjantai;45;59;104;5;3;8
96;06.07.2018;2018;07;20;Perjantai;46;47;93;2;7;9
96;06.07.2018;2018;07;21;Perjantai;45;38;83;4;6;10
96;06.07.2018;2018;07;22;Perjantai;33;14;47;5;2;7
96;06.07.2018;2018;07;23;Perjantai;26;19;45;2;5;7
96;07.07.2018;2018;07;00;Lauantai;17;20;37;6;1;7
96;07.07.2018;2018;07;01;Lauantai;19;5;24;1;0;1
96;07.07.2018;2018;07;02;Lauantai;13;6;19;0;0;0
96;07.07.2018;2018;07;03;Lauantai;11;0;11;2;0;2
96;07.07.2018;2018;07;04;Lauantai;13;2;15;1;0;1
96;07.07.2018;2018;07;05;Lauantai;10;1;11;2;2;4
96;07.07.2018;2018;07;06;Lauantai;31;6;37;3;0;3
96;07.07.2018;2018;07;07;Lauantai;10;17;27;2;2;4
96;07.07.2018;2018;07;08;Lauantai;13;17;30;1;3;4
96;07.07.2018;2018;07;09;Lauantai;24;33;57;1;6;7
96;07.07.2018;2018;07;10;Lauantai;29;53;82;4;2;6
96;07.07.2018;2018;07;11;Lauantai;48;69;117;1;4;5
96;07.07.2018;2018;07;12;Lauantai;42;66;108;7;3;10
96;07.07.2018;2018;07;13;Lauantai;60;118;178;2;9;11
96;07.07.2018;2018;07;14;Lauantai;73;66;139;5;6;11
96;07.07.2018;2018;07;15;Lauantai;56;89;145;5;2;7
96;07.07.2018;2018;07;16;Lauantai;72;57;129;7;5;12
96;07.07.2018;2018;07;17;Lauantai;66;56;122;5;2;7
96;07.07.2018;2018;07;18;Lauantai;53;41;94;3;1;4
96;07.07.2018;2018;07;19;Lauantai;39;29;68;7;4;11
96;07.07.2018;2018;07;20;Lauantai;53;43;96;0;1;1
96;07.07.2018;2018;07;21;Lauantai;29;34;63;3;4;7
96;07.07.2018;2018;07;22;Lauantai;10;24;34;2;3;5
96;07.07.2018;2018;07;23;Lauantai;18;11;29;1;1;2
96;08.07.2018;2018;07;00;Sunnuntai;14;19;33;3;0;3
96;08.07.2018;2018;07;01;Sunnuntai;25;11;36;2;0;2
96;08.07.2018;2018;07;02;Sunnuntai;15;3;18;3;1;4
96;08.07.2018;2018;07;03;Sunnuntai;12;3;15;1;1;2
96;08.07.2018;2018;07;04;Sunnuntai;12;2;14;2;0;2
96;08.07.2018;2018;07;05;Sunnuntai;10;3;13;3;0;3
96;08.07.2018;2018;07;06;Sunnuntai;27;6;33;2;0;2
96;08.07.2018;2018;07;07;Sunnuntai;6;9;15;2;0;2
96;08.07.2018;2018;07;08;Sunnuntai;9;6;15;0;2;2
96;08.07.2018;2018;07;09;Sunnuntai;7;16;23;5;2;7
96;08.07.2018;2018;07;10;Sunnuntai;15;28;43;3;8;11
96;08.07.2018;2018;07;11;Sunnuntai;27;43;70;5;6;11
96;08.07.2018;2018;07;12;Sunnuntai;42;60;102;6;3;9
96;08.07.2018;2018;07;13;Sunnuntai;77;67;144;8;14;22
96;08.07.2018;2018;07;14;Sunnuntai;54;70;124;8;16;24
96;08.07.2018;2018;07;15;Sunnuntai;45;61;106;11;11;22
96;08.07.2018;2018;07;16;Sunnuntai;62;38;100;9;6;15
96;08.07.2018;2018;07;17;Sunnuntai;66;32;98;7;7;14
96;08.07.2018;2018;07;18;Sunnuntai;63;57;120;8;7;15
96;08.07.2018;2018;07;19;Sunnuntai;61;67;128;2;8;10
96;08.07.2018;2018;07;20;Sunnuntai;42;38;80;5;10;15
96;08.07.2018;2018;07;21;Sunnuntai;43;39;82;2;8;10
96;08.07.2018;2018;07;22;Sunnuntai;15;13;28;3;3;6
96;08.07.2018;2018;07;23;Sunnuntai;10;6;16;0;1;1
96;09.07.2018;2018;07;00;Maanantai;3;8;11;3;0;3
96;09.07.2018;2018;07;01;Maanantai;8;7;15;1;0;1
96;09.07.2018;2018;07;02;Maanantai;3;3;6;0;0;0
96;09.07.2018;2018;07;03;Maanantai;4;0;4;0;0;0
96;09.07.2018;2018;07;04;Maanantai;5;2;7;1;0;1
96;09.07.2018;2018;07;05;Maanantai;6;15;21;0;1;1
96;09.07.2018;2018;07;06;Maanantai;68;26;94;3;2;5
96;09.07.2018;2018;07;07;Maanantai;81;60;141;6;5;11
96;09.07.2018;2018;07;08;Maanantai;31;82;113;2;5;7
96;09.07.2018;2018;07;09;Maanantai;37;43;80;6;1;7
96;09.07.2018;2018;07;10;Maanantai;40;50;90;5;12;17
96;09.07.2018;2018;07;11;Maanantai;51;60;111;5;9;14
96;09.07.2018;2018;07;12;Maanantai;80;71;151;7;10;17
96;09.07.2018;2018;07;13;Maanantai;86;76;162;9;13;22
96;09.07.2018;2018;07;14;Maanantai;86;82;168;9;19;28
96;09.07.2018;2018;07;15;Maanantai;103;162;265;10;19;29
96;09.07.2018;2018;07;16;Maanantai;113;104;217;7;18;25
96;09.07.2018;2018;07;17;Maanantai;101;71;172;12;14;26
96;09.07.2018;2018;07;18;Maanantai;78;57;135;9;10;19
96;09.07.2018;2018;07;19;Maanantai;85;35;120;14;4;18
96;09.07.2018;2018;07;20;Maanantai;69;39;108;2;8;10
96;09.07.2018;2018;07;21;Maanantai;42;49;91;7;3;10
96;09.07.2018;2018;07;22;Maanantai;20;29;49;1;3;4
96;09.07.2018;2018;07;23;Maanantai;22;3;25;3;2;5
96;10.07.2018;2018;07;00;Tiistai;21;12;33;2;1;3
96;10.07.2018;2018;07;01;Tiistai;15;2;17;1;0;1
96;10.07.2018;2018;07;02;Tiistai;7;5;12;0;0;0
96;10.07.2018;2018;07;03;Tiistai;3;1;4;0;1;1
96;10.07.2018;2018;07;04;Tiistai;6;2;8;0;0;0
96;10.07.2018;2018;07;05;Tiistai;6;10;16;0;0;0
96;10.07.2018;2018;07;06;Tiistai;58;31;89;1;1;2
96;10.07.2018;2018;07;07;Tiistai;93;69;162;14;6;20
96;10.07.2018;2018;07;08;Tiistai;33;82;115;4;5;9
96;10.07.2018;2018;07;09;Tiistai;26;55;81;7;7;14
96;10.07.2018;2018;07;10;Tiistai;39;66;105;6;9;15
96;10.07.2018;2018;07;11;Tiistai;44;75;119;5;10;15
96;10.07.2018;2018;07;12;Tiistai;77;77;154;5;5;10
96;10.07.2018;2018;07;13;Tiistai;81;75;156;5;15;20
96;10.07.2018;2018;07;14;Tiistai;70;100;170;7;14;21
96;10.07.2018;2018;07;15;Tiistai;116;161;277;9;14;23
96;10.07.2018;2018;07;16;Tiistai;108;139;247;8;17;25
96;10.07.2018;2018;07;17;Tiistai;105;79;184;10;4;14
96;10.07.2018;2018;07;18;Tiistai;71;58;129;6;9;15
96;10.07.2018;2018;07;19;Tiistai;82;41;123;7;5;12
96;10.07.2018;2018;07;20;Tiistai;67;40;107;13;5;18
96;10.07.2018;2018;07;21;Tiistai;61;50;111;3;6;9
96;10.07.2018;2018;07;22;Tiistai;21;20;41;4;2;6
96;10.07.2018;2018;07;23;Tiistai;22;16;38;3;4;7
96;11.07.2018;2018;07;00;Keskiviikko;11;3;14;2;1;3
96;11.07.2018;2018;07;01;Keskiviikko;11;2;13;0;0;0
96;11.07.2018;2018;07;02;Keskiviikko;8;3;11;1;0;1
96;11.07.2018;2018;07;03;Keskiviikko;3;2;5;0;1;1
96;11.07.2018;2018;07;04;Keskiviikko;5;3;8;2;0;2
96;11.07.2018;2018;07;05;Keskiviikko;4;11;15;1;0;1
96;11.07.2018;2018;07;06;Keskiviikko;80;26;106;2;0;2
96;11.07.2018;2018;07;07;Keskiviikko;85;72;157;12;5;17
96;11.07.2018;2018;07;08;Keskiviikko;39;69;108;10;4;14
96;11.07.2018;2018;07;09;Keskiviikko;38;59;97;4;11;15
96;11.07.2018;2018;07;10;Keskiviikko;47;49;96;6;9;15
96;11.07.2018;2018;07;11;Keskiviikko;57;66;123;5;8;13
96;11.07.2018;2018;07;12;Keskiviikko;76;74;150;9;15;24
96;11.07.2018;2018;07;13;Keskiviikko;81;72;153;5;17;22
96;11.07.2018;2018;07;14;Keskiviikko;63;102;165;9;14;23
96;11.07.2018;2018;07;15;Keskiviikko;114;165;279;8;16;24
96;11.07.2018;2018;07;16;Keskiviikko;129;117;246;10;21;31
96;11.07.2018;2018;07;17;Keskiviikko;120;56;176;8;7;15
96;11.07.2018;2018;07;18;Keskiviikko;118;59;177;10;8;18
96;11.07.2018;2018;07;19;Keskiviikko;75;44;119;7;4;11
96;11.07.2018;2018;07;20;Keskiviikko;71;51;122;7;8;15
96;11.07.2018;2018;07;21;Keskiviikko;48;39;87;4;7;11
96;11.07.2018;2018;07;22;Keskiviikko;28;31;59;1;1;2
96;11.07.2018;2018;07;23;Keskiviikko;13;8;21;1;2;3
96;12.07.2018;2018;07;00;Torstai;17;9;26;1;0;1
96;12.07.2018;2018;07;01;Torstai;12;1;13;0;1;1
96;12.07.2018;2018;07;02;Torstai;10;1;11;1;0;1
96;12.07.2018;2018;07;03;Torstai;4;4;8;0;0;0
96;12.07.2018;2018;07;04;Torstai;13;1;14;1;0;1
96;12.07.2018;2018;07;05;Torstai;5;8;13;0;1;1
96;12.07.2018;2018;07;06;Torstai;79;24;103;4;1;5
96;12.07.2018;2018;07;07;Torstai;94;56;150;8;7;15
96;12.07.2018;2018;07;08;Torstai;40;66;106;7;1;8
96;12.07.2018;2018;07;09;Torstai;23;57;80;3;6;9
96;12.07.2018;2018;07;10;Torstai;54;61;115;4;6;10
96;12.07.2018;2018;07;11;Torstai;62;52;114;4;6;10
96;12.07.2018;2018;07;12;Torstai;71;62;133;10;8;18
96;12.07.2018;2018;07;13;Torstai;65;76;141;4;10;14
96;12.07.2018;2018;07;14;Torstai;60;87;147;7;17;24
96;12.07.2018;2018;07;15;Torstai;98;158;256;11;21;32
96;12.07.2018;2018;07;16;Torstai;112;89;201;8;12;20
96;12.07.2018;2018;07;17;Torstai;110;58;168;13;10;23
96;12.07.2018;2018;07;18;Torstai;76;53;129;11;6;17
96;12.07.2018;2018;07;19;Torstai;70;39;109;5;5;10
96;12.07.2018;2018;07;20;Torstai;56;33;89;2;4;6
96;12.07.2018;2018;07;21;Torstai;45;37;82;7;4;11
96;12.07.2018;2018;07;22;Torstai;29;37;66;3;5;8
96;12.07.2018;2018;07;23;Torstai;27;8;35;3;2;5
96;13.07.2018;2018;07;00;Perjantai;28;6;34;1;1;2
96;13.07.2018;2018;07;01;Perjantai;12;4;16;2;1;3
96;13.07.2018;2018;07;02;Perjantai;9;5;14;0;0;0
96;13.07.2018;2018;07;03;Perjantai;5;1;6;1;0;1
96;13.07.2018;2018;07;04;Perjantai;9;3;12;0;1;1
96;13.07.2018;2018;07;05;Perjantai;8;9;17;2;0;2
96;13.07.2018;2018;07;06;Perjantai;56;24;80;2;0;2
96;13.07.2018;2018;07;07;Perjantai;68;60;128;6;5;11
96;13.07.2018;2018;07;08;Perjantai;32;59;91;4;5;9
96;13.07.2018;2018;07;09;Perjantai;31;58;89;6;7;13
96;13.07.2018;2018;07;10;Perjantai;48;62;110;3;6;9
96;13.07.2018;2018;07;11;Perjantai;51;48;99;8;7;15
96;13.07.2018;2018;07;12;Perjantai;74;71;145;2;3;5
96;13.07.2018;2018;07;13;Perjantai;70;68;138;2;7;9
96;13.07.2018;2018;07;14;Perjantai;77;94;171;5;15;20
96;13.07.2018;2018;07;15;Perjantai;100;145;245;11;17;28
96;13.07.2018;2018;07;16;Perjantai;105;100;205;9;12;21
96;13.07.2018;2018;07;17;Perjantai;78;49;127;6;7;13
96;13.07.2018;2018;07;18;Perjantai;76;61;137;5;2;7
96;13.07.2018;2018;07;19;Perjantai;70;61;131;3;5;8
96;13.07.2018;2018;07;20;Perjantai;71;52;123;4;4;8
96;13.07.2018;2018;07;21;Perjantai;38;41;79;6;1;7
96;13.07.2018;2018;07;22;Perjantai;36;36;72;4;2;6
96;13.07.2018;2018;07;23;Perjantai;36;17;53;4;2;6
96;14.07.2018;2018;07;00;Lauantai;65;12;77;4;1;5
96;14.07.2018;2018;07;01;Lauantai;40;10;50;10;0;10
96;14.07.2018;2018;07;02;Lauantai;34;8;42;2;0;2
96;14.07.2018;2018;07;03;Lauantai;31;2;33;1;0;1
96;14.07.2018;2018;07;04;Lauantai;18;7;25;1;3;4
96;14.07.2018;2018;07;05;Lauantai;19;2;21;3;0;3
96;14.07.2018;2018;07;06;Lauantai;24;11;35;5;0;5
96;14.07.2018;2018;07;07;Lauantai;8;14;22;2;0;2
96;14.07.2018;2018;07;08;Lauantai;6;14;20;5;2;7
96;14.07.2018;2018;07;09;Lauantai;18;36;54;3;8;11
96;14.07.2018;2018;07;10;Lauantai;23;43;66;3;5;8
96;14.07.2018;2018;07;11;Lauantai;27;48;75;4;6;10
96;14.07.2018;2018;07;12;Lauantai;34;50;84;7;8;15
96;14.07.2018;2018;07;13;Lauantai;38;74;112;7;7;14
96;14.07.2018;2018;07;14;Lauantai;51;56;107;3;7;10
96;14.07.2018;2018;07;15;Lauantai;63;69;132;9;11;20
96;14.07.2018;2018;07;16;Lauantai;56;53;109;7;9;16
96;14.07.2018;2018;07;17;Lauantai;58;51;109;1;9;10
96;14.07.2018;2018;07;18;Lauantai;51;34;85;8;6;14
96;14.07.2018;2018;07;19;Lauantai;37;48;85;2;3;5
96;14.07.2018;2018;07;20;Lauantai;54;44;98;4;1;5
96;14.07.2018;2018;07;21;Lauantai;38;44;82;1;2;3
96;14.07.2018;2018;07;22;Lauantai;22;35;57;4;1;5
96;14.07.2018;2018;07;23;Lauantai;52;35;87;1;4;5
96;15.07.2018;2018;07;00;Sunnuntai;59;22;81;2;0;2
96;15.07.2018;2018;07;01;Sunnuntai;34;8;42;9;1;10
96;15.07.2018;2018;07;02;Sunnuntai;32;3;35;2;0;2
96;15.07.2018;2018;07;03;Sunnuntai;30;3;33;1;0;1
96;15.07.2018;2018;07;04;Sunnuntai;23;8;31;1;0;1
96;15.07.2018;2018;07;05;Sunnuntai;9;6;15;0;0;0
96;15.07.2018;2018;07;06;Sunnuntai;34;17;51;3;1;4
96;15.07.2018;2018;07;07;Sunnuntai;12;12;24;0;2;2
96;15.07.2018;2018;07;08;Sunnuntai;12;15;27;0;2;2
96;15.07.2018;2018;07;09;Sunnuntai;11;17;28;1;3;4
96;15.07.2018;2018;07;10;Sunnuntai;20;33;53;2;5;7
96;15.07.2018;2018;07;11;Sunnuntai;38;59;97;4;2;6
96;15.07.2018;2018;07;12;Sunnuntai;56;51;107;9;9;18
96;15.07.2018;2018;07;13;Sunnuntai;66;72;138;8;7;15
96;15.07.2018;2018;07;14;Sunnuntai;56;71;127;4;7;11
96;15.07.2018;2018;07;15;Sunnuntai;74;58;132;9;6;15
96;15.07.2018;2018;07;16;Sunnuntai;91;52;143;15;7;22
96;15.07.2018;2018;07;17;Sunnuntai;65;45;110;7;8;15
96;15.07.2018;2018;07;18;Sunnuntai;52;41;93;7;9;16
96;15.07.2018;2018;07;19;Sunnuntai;56;27;83;8;7;15
96;15.07.2018;2018;07;20;Sunnuntai;41;33;74;3;5;8
96;15.07.2018;2018;07;21;Sunnuntai;29;45;74;8;2;10
96;15.07.2018;2018;07;22;Sunnuntai;16;23;39;3;1;4
96;15.07.2018;2018;07;23;Sunnuntai;9;6;15;0;2;2
96;16.07.2018;2018;07;00;Maanantai;7;1;8;2;4;6
96;16.07.2018;2018;07;01;Maanantai;6;1;7;0;0;0
96;16.07.2018;2018;07;02;Maanantai;4;3;7;2;1;3
96;16.07.2018;2018;07;03;Maanantai;5;0;5;0;0;0
96;16.07.2018;2018;07;04;Maanantai;4;5;9;1;0;1
96;16.07.2018;2018;07;05;Maanantai;6;8;14;0;0;0
96;16.07.2018;2018;07;06;Maanantai;68;30;98;2;1;3
96;16.07.2018;2018;07;07;Maanantai;93;70;163;7;2;9
96;16.07.2018;2018;07;08;Maanantai;28;68;96;7;5;12
96;16.07.2018;2018;07;09;Maanantai;33;34;67;5;7;12
96;16.07.2018;2018;07;10;Maanantai;54;67;121;8;8;16
96;16.07.2018;2018;07;11;Maanantai;57;53;110;4;5;9
96;16.07.2018;2018;07;12;Maanantai;71;54;125;9;2;11
96;16.07.2018;2018;07;13;Maanantai;73;82;155;5;6;11
96;16.07.2018;2018;07;14;Maanantai;72;101;173;6;10;16
96;16.07.2018;2018;07;15;Maanantai;107;139;246;11;13;24
96;16.07.2018;2018;07;16;Maanantai;108;86;194;1;14;15
96;16.07.2018;2018;07;17;Maanantai;85;52;137;9;4;13
96;16.07.2018;2018;07;18;Maanantai;83;46;129;3;9;12
96;16.07.2018;2018;07;19;Maanantai;67;50;117;7;7;14
96;16.07.2018;2018;07;20;Maanantai;76;35;111;10;5;15
96;16.07.2018;2018;07;21;Maanantai;35;42;77;3;9;12
96;16.07.2018;2018;07;22;Maanantai;25;23;48;3;3;6
96;16.07.2018;2018;07;23;Maanantai;12;13;25;2;1;3
96;17.07.2018;2018;07;00;Tiistai;4;5;9;0;0;0
96;17.07.2018;2018;07;01;Tiistai;5;1;6;0;0;0
96;17.07.2018;2018;07;02;Tiistai;9;1;10;0;0;0
96;17.07.2018;2018;07;03;Tiistai;3;3;6;0;1;1
96;17.07.2018;2018;07;04;Tiistai;2;3;5;0;0;0
96;17.07.2018;2018;07;05;Tiistai;6;14;20;0;1;1
96;17.07.2018;2018;07;06;Tiistai;73;26;99;2;0;2
96;17.07.2018;2018;07;07;Tiistai;83;64;147;9;6;15
96;17.07.2018;2018;07;08;Tiistai;28;69;97;5;4;9
96;17.07.2018;2018;07;09;Tiistai;45;53;98;6;6;12
96;17.07.2018;2018;07;10;Tiistai;77;43;120;4;5;9
96;17.07.2018;2018;07;11;Tiistai;65;39;104;3;2;5
96;17.07.2018;2018;07;12;Tiistai;96;57;153;4;7;11
96;17.07.2018;2018;07;13;Tiistai;94;47;141;7;4;11
96;17.07.2018;2018;07;14;Tiistai;99;57;156;14;9;23
96;17.07.2018;2018;07;15;Tiistai;150;71;221;24;19;43
96;17.07.2018;2018;07;16;Tiistai;139;44;183;5;6;11
96;17.07.2018;2018;07;17;Tiistai;140;29;169;4;4;8
96;17.07.2018;2018;07;18;Tiistai;105;42;147;7;3;10
96;17.07.2018;2018;07;19;Tiistai;85;33;118;3;2;5
96;17.07.2018;2018;07;20;Tiistai;87;30;117;9;3;12
96;17.07.2018;2018;07;21;Tiistai;63;38;101;5;6;11
96;17.07.2018;2018;07;22;Tiistai;37;16;53;4;3;7
96;17.07.2018;2018;07;23;Tiistai;18;11;29;1;2;3
96;18.07.2018;2018;07;00;Keskiviikko;9;2;11;1;0;1
96;18.07.2018;2018;07;01;Keskiviikko;23;6;29;3;0;3
96;18.07.2018;2018;07;02;Keskiviikko;6;2;8;2;0;2
96;18.07.2018;2018;07;03;Keskiviikko;12;0;12;1;0;1
96;18.07.2018;2018;07;04;Keskiviikko;9;2;11;1;0;1
96;18.07.2018;2018;07;05;Keskiviikko;8;12;20;0;0;0
96;18.07.2018;2018;07;06;Keskiviikko;53;37;90;1;1;2
96;18.07.2018;2018;07;07;Keskiviikko;93;82;175;8;3;11
96;18.07.2018;2018;07;08;Keskiviikko;25;69;94;6;7;13
96;18.07.2018;2018;07;09;Keskiviikko;40;59;99;4;8;12
96;18.07.2018;2018;07;10;Keskiviikko;60;39;99;4;1;5
96;18.07.2018;2018;07;11;Keskiviikko;73;46;119;1;4;5
96;18.07.2018;2018;07;12;Keskiviikko;103;44;147;8;4;12
96;18.07.2018;2018;07;13;Keskiviikko;104;43;147;10;6;16
96;18.07.2018;2018;07;14;Keskiviikko;86;63;149;7;8;15
96;18.07.2018;2018;07;15;Keskiviikko;145;102;247;8;19;27
96;18.07.2018;2018;07;16;Keskiviikko;103;44;147;11;7;18
96;18.07.2018;2018;07;17;Keskiviikko;99;29;128;7;3;10
96;18.07.2018;2018;07;18;Keskiviikko;89;21;110;12;2;14
96;18.07.2018;2018;07;19;Keskiviikko;66;33;99;8;5;13
96;18.07.2018;2018;07;20;Keskiviikko;78;42;120;4;5;9
96;18.07.2018;2018;07;21;Keskiviikko;59;59;118;4;5;9
96;18.07.2018;2018;07;22;Keskiviikko;41;16;57;2;0;2
96;18.07.2018;2018;07;23;Keskiviikko;32;8;40;3;2;5
96;19.07.2018;2018;07;00;Torstai;19;3;22;0;1;1
96;19.07.2018;2018;07;01;Torstai;9;4;13;1;1;2
96;19.07.2018;2018;07;02;Torstai;4;3;7;2;0;2
96;19.07.2018;2018;07;03;Torstai;7;1;8;0;0;0
96;19.07.2018;2018;07;04;Torstai;5;6;11;3;1;4
96;19.07.2018;2018;07;05;Torstai;4;11;15;0;0;0
96;19.07.2018;2018;07;06;Torstai;76;26;102;2;2;4
96;19.07.2018;2018;07;07;Torstai;90;50;140;6;1;7
96;19.07.2018;2018;07;08;Torstai;41;70;111;3;4;7
96;19.07.2018;2018;07;09;Torstai;34;39;73;7;5;12
96;19.07.2018;2018;07;10;Torstai;37;39;76;3;4;7
96;19.07.2018;2018;07;11;Torstai;46;52;98;6;3;9
96;19.07.2018;2018;07;12;Torstai;51;50;101;2;4;6
96;19.07.2018;2018;07;13;Torstai;74;57;131;4;7;11
96;19.07.2018;2018;07;14;Torstai;76;62;138;6;9;15
96;19.07.2018;2018;07;15;Torstai;137;99;236;16;11;27
96;19.07.2018;2018;07;16;Torstai;139;61;200;11;12;23
96;19.07.2018;2018;07;17;Torstai;105;33;138;6;2;8
96;19.07.2018;2018;07;18;Torstai;94;33;127;11;3;14
96;19.07.2018;2018;07;19;Torstai;87;36;123;10;3;13
96;19.07.2018;2018;07;20;Torstai;86;41;127;6;7;13
96;19.07.2018;2018;07;21;Torstai;40;31;71;6;1;7
96;19.07.2018;2018;07;22;Torstai;40;30;70;0;4;4
96;19.07.2018;2018;07;23;Torstai;26;12;38;2;0;2
96;20.07.2018;2018;07;00;Perjantai;8;11;19;3;2;5
96;20.07.2018;2018;07;01;Perjantai;26;4;30;2;0;2
96;20.07.2018;2018;07;02;Perjantai;10;4;14;0;0;0
96;20.07.2018;2018;07;03;Perjantai;13;1;14;0;0;0
96;20.07.2018;2018;07;04;Perjantai;16;4;20;0;0;0
96;20.07.2018;2018;07;05;Perjantai;10;5;15;0;1;1
96;20.07.2018;2018;07;06;Perjantai;56;28;84;5;0;5
96;20.07.2018;2018;07;07;Perjantai;79;54;133;7;5;12
96;20.07.2018;2018;07;08;Perjantai;24;56;80;7;4;11
96;20.07.2018;2018;07;09;Perjantai;34;30;64;3;4;7
96;20.07.2018;2018;07;10;Perjantai;47;51;98;3;5;8
96;20.07.2018;2018;07;11;Perjantai;55;54;109;4;3;7
96;20.07.2018;2018;07;12;Perjantai;82;39;121;8;6;14
96;20.07.2018;2018;07;13;Perjantai;76;55;131;4;6;10
96;20.07.2018;2018;07;14;Perjantai;105;68;173;5;13;18
96;20.07.2018;2018;07;15;Perjantai;130;87;217;21;15;36
96;20.07.2018;2018;07;16;Perjantai;92;40;132;4;5;9
96;20.07.2018;2018;07;17;Perjantai;110;40;150;9;5;14
96;20.07.2018;2018;07;18;Perjantai;94;46;140;7;7;14
96;20.07.2018;2018;07;19;Perjantai;59;30;89;2;7;9
96;20.07.2018;2018;07;20;Perjantai;67;47;114;5;1;6
96;20.07.2018;2018;07;21;Perjantai;40;43;83;7;4;11
96;20.07.2018;2018;07;22;Perjantai;39;42;81;1;4;5
96;20.07.2018;2018;07;23;Perjantai;38;27;65;3;3;6
96;21.07.2018;2018;07;00;Lauantai;37;11;48;3;0;3
96;21.07.2018;2018;07;01;Lauantai;28;7;35;2;0;2
96;21.07.2018;2018;07;02;Lauantai;19;1;20;3;0;3
96;21.07.2018;2018;07;03;Lauantai;23;0;23;2;0;2
96;21.07.2018;2018;07;04;Lauantai;23;3;26;1;0;1
96;21.07.2018;2018;07;05;Lauantai;8;5;13;2;0;2
96;21.07.2018;2018;07;06;Lauantai;27;12;39;1;1;2
96;21.07.2018;2018;07;07;Lauantai;9;18;27;1;0;1
96;21.07.2018;2018;07;08;Lauantai;11;26;37;4;5;9
96;21.07.2018;2018;07;09;Lauantai;15;21;36;3;2;5
96;21.07.2018;2018;07;10;Lauantai;27;25;52;1;1;2
96;21.07.2018;2018;07;11;Lauantai;29;46;75;0;0;0
96;21.07.2018;2018;07;12;Lauantai;28;47;75;4;4;8
96;21.07.2018;2018;07;13;Lauantai;21;39;60;3;6;9
96;21.07.2018;2018;07;14;Lauantai;45;78;123;2;1;3
96;21.07.2018;2018;07;15;Lauantai;44;41;85;5;6;11
96;21.07.2018;2018;07;16;Lauantai;40;32;72;3;4;7
96;21.07.2018;2018;07;17;Lauantai;40;39;79;3;2;5
96;21.07.2018;2018;07;18;Lauantai;39;53;92;7;4;11
96;21.07.2018;2018;07;19;Lauantai;40;28;68;4;2;6
96;21.07.2018;2018;07;20;Lauantai;54;50;104;1;2;3
96;21.07.2018;2018;07;21;Lauantai;26;30;56;2;7;9
96;21.07.2018;2018;07;22;Lauantai;19;27;46;4;2;6
96;21.07.2018;2018;07;23;Lauantai;15;38;53;0;2;2
96;22.07.2018;2018;07;00;Sunnuntai;15;18;33;5;2;7
96;22.07.2018;2018;07;01;Sunnuntai;12;12;24;1;1;2
96;22.07.2018;2018;07;02;Sunnuntai;12;4;16;1;0;1
96;22.07.2018;2018;07;03;Sunnuntai;20;5;25;2;0;2
96;22.07.2018;2018;07;04;Sunnuntai;14;2;16;1;0;1
96;22.07.2018;2018;07;05;Sunnuntai;9;4;13;3;1;4
96;22.07.2018;2018;07;06;Sunnuntai;18;10;28;2;0;2
96;22.07.2018;2018;07;07;Sunnuntai;7;16;23;0;0;0
96;22.07.2018;2018;07;08;Sunnuntai;15;6;21;0;0;0
96;22.07.2018;2018;07;09;Sunnuntai;7;8;15;0;1;1
96;22.07.2018;2018;07;10;Sunnuntai;14;25;39;5;2;7
96;22.07.2018;2018;07;11;Sunnuntai;26;28;54;0;3;3
96;22.07.2018;2018;07;12;Sunnuntai;37;37;74;3;8;11
96;22.07.2018;2018;07;13;Sunnuntai;37;31;68;2;4;6
96;22.07.2018;2018;07;14;Sunnuntai;36;25;61;4;5;9
96;22.07.2018;2018;07;15;Sunnuntai;40;39;79;6;4;10
96;22.07.2018;2018;07;16;Sunnuntai;37;20;57;6;1;7
96;22.07.2018;2018;07;17;Sunnuntai;50;41;91;4;3;7
96;22.07.2018;2018;07;18;Sunnuntai;41;30;71;4;9;13
96;22.07.2018;2018;07;19;Sunnuntai;35;23;58;9;5;14
96;22.07.2018;2018;07;20;Sunnuntai;23;27;50;11;4;15
96;22.07.2018;2018;07;21;Sunnuntai;22;35;57;4;2;6
96;22.07.2018;2018;07;22;Sunnuntai;22;9;31;1;3;4
96;22.07.2018;2018;07;23;Sunnuntai;14;12;26;2;0;2
96;23.07.2018;2018;07;00;Maanantai;9;5;14;5;2;7
96;23.07.2018;2018;07;01;Maanantai;1;4;5;1;0;1
96;23.07.2018;2018;07;02;Maanantai;6;2;8;0;0;0
96;23.07.2018;2018;07;03;Maanantai;4;3;7;1;0;1
96;23.07.2018;2018;07;04;Maanantai;5;2;7;0;1;1
96;23.07.2018;2018;07;05;Maanantai;6;6;12;0;0;0
96;23.07.2018;2018;07;06;Maanantai;66;25;91;4;2;6
96;23.07.2018;2018;07;07;Maanantai;71;85;156;3;7;10
96;23.07.2018;2018;07;08;Maanantai;23;63;86;2;5;7
96;23.07.2018;2018;07;09;Maanantai;24;58;82;4;7;11
96;23.07.2018;2018;07;10;Maanantai;41;58;99;1;11;12
96;23.07.2018;2018;07;11;Maanantai;46;67;113;9;2;11
96;23.07.2018;2018;07;12;Maanantai;75;55;130;7;6;13
96;23.07.2018;2018;07;13;Maanantai;86;76;162;11;13;24
96;23.07.2018;2018;07;14;Maanantai;83;99;182;5;12;17
96;23.07.2018;2018;07;15;Maanantai;110;129;239;17;15;32
96;23.07.2018;2018;07;16;Maanantai;101;70;171;12;17;29
96;23.07.2018;2018;07;17;Maanantai;76;67;143;6;10;16
96;23.07.2018;2018;07;18;Maanantai;70;56;126;6;14;20
96;23.07.2018;2018;07;19;Maanantai;74;58;132;5;5;10
96;23.07.2018;2018;07;20;Maanantai;73;40;113;15;12;27
96;23.07.2018;2018;07;21;Maanantai;40;58;98;6;7;13
96;23.07.2018;2018;07;22;Maanantai;15;27;42;2;1;3
96;23.07.2018;2018;07;23;Maanantai;26;10;36;2;2;4
96;24.07.2018;2018;07;00;Tiistai;5;8;13;1;0;1
96;24.07.2018;2018;07;01;Tiistai;7;1;8;0;0;0
96;24.07.2018;2018;07;02;Tiistai;2;2;4;1;0;1
96;24.07.2018;2018;07;03;Tiistai;1;0;1;1;0;1
96;24.07.2018;2018;07;04;Tiistai;2;2;4;0;0;0
96;24.07.2018;2018;07;05;Tiistai;10;6;16;0;1;1
96;24.07.2018;2018;07;06;Tiistai;83;32;115;1;0;1
96;24.07.2018;2018;07;07;Tiistai;90;87;177;8;7;15
96;24.07.2018;2018;07;08;Tiistai;39;85;124;6;6;12
96;24.07.2018;2018;07;09;Tiistai;39;57;96;6;13;19
96;24.07.2018;2018;07;10;Tiistai;41;72;113;7;9;16
96;24.07.2018;2018;07;11;Tiistai;67;86;153;8;6;14
96;24.07.2018;2018;07;12;Tiistai;87;60;147;11;5;16
96;24.07.2018;2018;07;13;Tiistai;65;73;138;2;10;12
96;24.07.2018;2018;07;14;Tiistai;84;81;165;11;10;21
96;24.07.2018;2018;07;15;Tiistai;151;127;278;19;19;38
96;24.07.2018;2018;07;16;Tiistai;154;79;233;10;17;27
96;24.07.2018;2018;07;17;Tiistai;130;76;206;7;4;11
96;24.07.2018;2018;07;18;Tiistai;109;44;153;7;8;15
96;24.07.2018;2018;07;19;Tiistai;96;41;137;7;3;10
96;24.07.2018;2018;07;20;Tiistai;99;37;136;7;7;14
96;24.07.2018;2018;07;21;Tiistai;36;46;82;2;4;6
96;24.07.2018;2018;07;22;Tiistai;25;15;40;1;0;1
96;24.07.2018;2018;07;23;Tiistai;22;14;36;3;2;5
96;25.07.2018;2018;07;00;Keskiviikko;20;7;27;1;0;1
96;25.07.2018;2018;07;01;Keskiviikko;10;2;12;1;0;1
96;25.07.2018;2018;07;02;Keskiviikko;3;3;6;0;0;0
96;25.07.2018;2018;07;03;Keskiviikko;4;1;5;0;1;1
96;25.07.2018;2018;07;04;Keskiviikko;3;4;7;0;0;0
96;25.07.2018;2018;07;05;Keskiviikko;10;11;21;0;0;0
96;25.07.2018;2018;07;06;Keskiviikko;80;30;110;0;0;0
96;25.07.2018;2018;07;07;Keskiviikko;89;71;160;5;5;10
96;25.07.2018;2018;07;08;Keskiviikko;43;86;129;1;8;9
96;25.07.2018;2018;07;09;Keskiviikko;34;56;90;10;20;30
96;25.07.2018;2018;07;10;Keskiviikko;53;46;99;3;3;6
96;25.07.2018;2018;07;11;Keskiviikko;63;40;103;7;0;7
96;25.07.2018;2018;07;12;Keskiviikko;81;87;168;8;4;12
96;25.07.2018;2018;07;13;Keskiviikko;87;72;159;8;10;18
96;25.07.2018;2018;07;14;Keskiviikko;85;74;159;12;14;26
96;25.07.2018;2018;07;15;Keskiviikko;130;115;245;15;19;34
96;25.07.2018;2018;07;16;Keskiviikko;104;86;190;13;16;29
96;25.07.2018;2018;07;17;Keskiviikko;109;44;153;3;7;10
96;25.07.2018;2018;07;18;Keskiviikko;108;52;160;10;8;18
96;25.07.2018;2018;07;19;Keskiviikko;79;44;123;12;2;14
96;25.07.2018;2018;07;20;Keskiviikko;69;46;115;6;2;8
96;25.07.2018;2018;07;21;Keskiviikko;38;56;94;4;10;14
96;25.07.2018;2018;07;22;Keskiviikko;25;22;47;5;3;8
96;25.07.2018;2018;07;23;Keskiviikko;27;6;33;3;2;5
96;26.07.2018;2018;07;00;Torstai;17;12;29;2;1;3
96;26.07.2018;2018;07;01;Torstai;9;8;17;1;1;2
96;26.07.2018;2018;07;02;Torstai;17;4;21;1;1;2
96;26.07.2018;2018;07;03;Torstai;6;2;8;0;2;2
96;26.07.2018;2018;07;04;Torstai;3;3;6;0;0;0
96;26.07.2018;2018;07;05;Torstai;9;9;18;0;0;0
96;26.07.2018;2018;07;06;Torstai;72;31;103;3;1;4
96;26.07.2018;2018;07;07;Torstai;89;86;175;3;3;6
96;26.07.2018;2018;07;08;Torstai;32;63;95;1;7;8
96;26.07.2018;2018;07;09;Torstai;31;43;74;12;3;15
96;26.07.2018;2018;07;10;Torstai;39;58;97;5;6;11
96;26.07.2018;2018;07;11;Torstai;56;84;140;2;6;8
96;26.07.2018;2018;07;12;Torstai;75;74;149;4;12;16
96;26.07.2018;2018;07;13;Torstai;68;70;138;6;8;14
96;26.07.2018;2018;07;14;Torstai;48;93;141;1;4;5
96;26.07.2018;2018;07;15;Torstai;108;143;251;8;14;22
96;26.07.2018;2018;07;16;Torstai;111;84;195;10;9;19
96;26.07.2018;2018;07;17;Torstai;97;62;159;8;12;20
96;26.07.2018;2018;07;18;Torstai;81;72;153;7;4;11
96;26.07.2018;2018;07;19;Torstai;76;50;126;7;6;13
96;26.07.2018;2018;07;20;Torstai;68;46;114;8;3;11
96;26.07.2018;2018;07;21;Torstai;33;51;84;3;4;7
96;26.07.2018;2018;07;22;Torstai;22;27;49;4;4;8
96;26.07.2018;2018;07;23;Torstai;21;7;28;1;0;1
96;27.07.2018;2018;07;00;Perjantai;17;7;24;2;0;2
96;27.07.2018;2018;07;01;Perjantai;10;5;15;1;0;1
96;27.07.2018;2018;07;02;Perjantai;6;7;13;0;1;1
96;27.07.2018;2018;07;03;Perjantai;7;1;8;0;0;0
96;27.07.2018;2018;07;04;Perjantai;4;3;7;0;0;0
96;27.07.2018;2018;07;05;Perjantai;13;9;22;0;0;0
96;27.07.2018;2018;07;06;Perjantai;67;30;97;6;1;7
96;27.07.2018;2018;07;07;Perjantai;64;62;126;3;2;5
96;27.07.2018;2018;07;08;Perjantai;24;63;87;6;5;11
96;27.07.2018;2018;07;09;Perjantai;25;39;64;5;5;10
96;27.07.2018;2018;07;10;Perjantai;40;52;92;4;7;11
96;27.07.2018;2018;07;11;Perjantai;60;86;146;4;4;8
96;27.07.2018;2018;07;12;Perjantai;59;82;141;7;6;13
96;27.07.2018;2018;07;13;Perjantai;76;118;194;1;12;13
96;27.07.2018;2018;07;14;Perjantai;70;146;216;3;9;12
96;27.07.2018;2018;07;15;Perjantai;95;158;253;9;22;31
96;27.07.2018;2018;07;16;Perjantai;67;131;198;7;8;15
96;27.07.2018;2018;07;17;Perjantai;71;115;186;6;18;24
96;27.07.2018;2018;07;18;Perjantai;61;86;147;4;9;13
96;27.07.2018;2018;07;19;Perjantai;43;67;110;3;7;10
96;27.07.2018;2018;07;20;Perjantai;74;69;143;5;3;8
96;27.07.2018;2018;07;21;Perjantai;36;62;98;4;3;7
96;27.07.2018;2018;07;22;Perjantai;55;45;100;4;2;6
96;27.07.2018;2018;07;23;Perjantai;70;17;87;2;2;4
96;28.07.2018;2018;07;00;Lauantai;130;8;138;9;1;10
96;28.07.2018;2018;07;01;Lauantai;89;9;98;5;0;5
96;28.07.2018;2018;07;02;Lauantai;70;13;83;10;1;11
96;28.07.2018;2018;07;03;Lauantai;49;3;52;4;0;4
96;28.07.2018;2018;07;04;Lauantai;33;4;37;4;0;4
96;28.07.2018;2018;07;05;Lauantai;13;4;17;1;0;1
96;28.07.2018;2018;07;06;Lauantai;22;8;30;4;0;4
96;28.07.2018;2018;07;07;Lauantai;6;26;32;2;1;3
96;28.07.2018;2018;07;08;Lauantai;7;19;26;0;2;2
96;28.07.2018;2018;07;09;Lauantai;21;49;70;8;2;10
96;28.07.2018;2018;07;10;Lauantai;29;58;87;3;7;10
96;28.07.2018;2018;07;11;Lauantai;36;69;105;1;4;5
96;28.07.2018;2018;07;12;Lauantai;70;77;147;2;4;6
96;28.07.2018;2018;07;13;Lauantai;72;79;151;5;1;6
96;28.07.2018;2018;07;14;Lauantai;48;91;139;2;10;12
96;28.07.2018;2018;07;15;Lauantai;59;103;162;6;16;22
96;28.07.2018;2018;07;16;Lauantai;80;75;155;3;14;17
96;28.07.2018;2018;07;17;Lauantai;60;62;122;2;3;5
96;28.07.2018;2018;07;18;Lauantai;54;53;107;4;13;17
96;28.07.2018;2018;07;19;Lauantai;34;60;94;8;6;14
96;28.07.2018;2018;07;20;Lauantai;57;70;127;7;3;10
96;28.07.2018;2018;07;21;Lauantai;44;46;90;2;3;5
96;28.07.2018;2018;07;22;Lauantai;27;21;48;0;2;2
96;28.07.2018;2018;07;23;Lauantai;43;15;58;4;0;4
96;29.07.2018;2018;07;00;Sunnuntai;102;9;111;1;0;1
96;29.07.2018;2018;07;01;Sunnuntai;103;10;113;10;2;12
96;29.07.2018;2018;07;02;Sunnuntai;82;5;87;6;1;7
96;29.07.2018;2018;07;03;Sunnuntai;59;5;64;11;0;11
96;29.07.2018;2018;07;04;Sunnuntai;56;3;59;5;0;5
96;29.07.2018;2018;07;05;Sunnuntai;31;6;37;8;1;9
96;29.07.2018;2018;07;06;Sunnuntai;35;3;38;3;2;5
96;29.07.2018;2018;07;07;Sunnuntai;11;20;31;1;1;2
96;29.07.2018;2018;07;08;Sunnuntai;6;12;18;0;2;2
96;29.07.2018;2018;07;09;Sunnuntai;15;13;28;5;2;7
96;29.07.2018;2018;07;10;Sunnuntai;37;25;62;7;6;13
96;29.07.2018;2018;07;11;Sunnuntai;31;34;65;3;7;10
96;29.07.2018;2018;07;12;Sunnuntai;56;50;106;3;5;8
96;29.07.2018;2018;07;13;Sunnuntai;83;41;124;2;6;8
96;29.07.2018;2018;07;14;Sunnuntai;65;62;127;4;9;13
96;29.07.2018;2018;07;15;Sunnuntai;70;54;124;9;9;18
96;29.07.2018;2018;07;16;Sunnuntai;80;45;125;7;12;19
96;29.07.2018;2018;07;17;Sunnuntai;63;29;92;5;7;12
96;29.07.2018;2018;07;18;Sunnuntai;69;29;98;6;8;14
96;29.07.2018;2018;07;19;Sunnuntai;64;51;115;5;11;16
96;29.07.2018;2018;07;20;Sunnuntai;63;25;88;8;5;13
96;29.07.2018;2018;07;21;Sunnuntai;33;35;68;6;5;11
96;29.07.2018;2018;07;22;Sunnuntai;9;19;28;1;5;6
96;29.07.2018;2018;07;23;Sunnuntai;15;8;23;1;1;2
96;30.07.2018;2018;07;00;Maanantai;11;3;14;2;0;2
96;30.07.2018;2018;07;01;Maanantai;5;1;6;0;0;0
96;30.07.2018;2018;07;02;Maanantai;2;4;6;0;0;0
96;30.07.2018;2018;07;03;Maanantai;7;0;7;0;0;0
96;30.07.2018;2018;07;04;Maanantai;4;6;10;0;0;0
96;30.07.2018;2018;07;05;Maanantai;8;15;23;0;1;1
96;30.07.2018;2018;07;06;Maanantai;64;25;89;1;2;3
96;30.07.2018;2018;07;07;Maanantai;103;101;204;8;3;11
96;30.07.2018;2018;07;08;Maanantai;33;99;132;3;11;14
96;30.07.2018;2018;07;09;Maanantai;40;61;101;2;3;5
96;30.07.2018;2018;07;10;Maanantai;42;51;93;3;4;7
96;30.07.2018;2018;07;11;Maanantai;64;68;132;5;6;11
96;30.07.2018;2018;07;12;Maanantai;88;78;166;16;5;21
96;30.07.2018;2018;07;13;Maanantai;94;62;156;8;10;18
96;30.07.2018;2018;07;14;Maanantai;103;68;171;8;5;13
96;30.07.2018;2018;07;15;Maanantai;174;115;289;13;13;26
96;30.07.2018;2018;07;16;Maanantai;152;70;222;17;14;31
96;30.07.2018;2018;07;17;Maanantai;118;31;149;7;3;10
96;30.07.2018;2018;07;18;Maanantai;109;38;147;8;2;10
96;30.07.2018;2018;07;19;Maanantai;93;64;157;4;7;11
96;30.07.2018;2018;07;20;Maanantai;73;39;112;6;2;8
96;30.07.2018;2018;07;21;Maanantai;51;39;90;6;6;12
96;30.07.2018;2018;07;22;Maanantai;37;22;59;3;4;7
96;30.07.2018;2018;07;23;Maanantai;22;13;35;3;1;4
96;31.07.2018;2018;07;00;Tiistai;16;11;27;1;1;2
96;31.07.2018;2018;07;01;Tiistai;13;5;18;2;0;2
96;31.07.2018;2018;07;02;Tiistai;11;7;18;0;0;0
96;31.07.2018;2018;07;03;Tiistai;8;1;9;0;0;0
96;31.07.2018;2018;07;04;Tiistai;3;1;4;1;0;1
96;31.07.2018;2018;07;05;Tiistai;9;11;20;0;2;2
96;31.07.2018;2018;07;06;Tiistai;80;42;122;3;1;4
96;31.07.2018;2018;07;07;Tiistai;88;103;191;6;4;10
96;31.07.2018;2018;07;08;Tiistai;34;108;142;2;7;9
96;31.07.2018;2018;07;09;Tiistai;54;62;116;5;11;16
96;31.07.2018;2018;07;10;Tiistai;56;63;119;1;7;8
96;31.07.2018;2018;07;11;Tiistai;72;58;130;6;3;9
96;31.07.2018;2018;07;12;Tiistai;69;55;124;4;1;5
96;31.07.2018;2018;07;13;Tiistai;91;58;149;7;7;14
96;31.07.2018;2018;07;14;Tiistai;106;85;191;7;7;14
96;31.07.2018;2018;07;15;Tiistai;194;90;284;15;9;24
96;31.07.2018;2018;07;16;Tiistai;123;71;194;8;13;21
96;31.07.2018;2018;07;17;Tiistai;115;48;163;9;6;15
96;31.07.2018;2018;07;18;Tiistai;105;34;139;9;12;21
96;31.07.2018;2018;07;19;Tiistai;77;40;117;17;11;28
96;31.07.2018;2018;07;20;Tiistai;87;36;123;9;7;16
96;31.07.2018;2018;07;21;Tiistai;55;36;91;2;5;7
96;31.07.2018;2018;07;22;Tiistai;22;21;43;4;2;6
96;31.07.2018;2018;07;23;Tiistai;26;7;33;3;3;6
96;01.08.2018;2018;08;00;Keskiviikko;17;7;24;4;2;6
96;01.08.2018;2018;08;01;Keskiviikko;8;2;10;2;1;3
96;01.08.2018;2018;08;02;Keskiviikko;12;1;13;2;0;2
96;01.08.2018;2018;08;03;Keskiviikko;2;2;4;1;0;1
96;01.08.2018;2018;08;04;Keskiviikko;6;3;9;0;0;0
96;01.08.2018;2018;08;05;Keskiviikko;11;9;20;0;1;1
96;01.08.2018;2018;08;06;Keskiviikko;76;34;110;2;0;2
96;01.08.2018;2018;08;07;Keskiviikko;98;118;216;10;3;13
96;01.08.2018;2018;08;08;Keskiviikko;49;73;122;9;12;21
96;01.08.2018;2018;08;09;Keskiviikko;37;70;107;3;7;10
96;01.08.2018;2018;08;10;Keskiviikko;41;54;95;6;5;11
96;01.08.2018;2018;08;11;Keskiviikko;73;67;140;4;3;7
96;01.08.2018;2018;08;12;Keskiviikko;80;50;130;8;5;13
96;01.08.2018;2018;08;13;Keskiviikko;91;63;154;2;10;12
96;01.08.2018;2018;08;14;Keskiviikko;92;73;165;9;11;20
96;01.08.2018;2018;08;15;Keskiviikko;133;128;261;11;23;34
96;01.08.2018;2018;08;16;Keskiviikko;144;76;220;2;12;14
96;01.08.2018;2018;08;17;Keskiviikko;118;44;162;10;3;13
96;01.08.2018;2018;08;18;Keskiviikko;62;53;115;7;11;18
96;01.08.2018;2018;08;19;Keskiviikko;62;30;92;11;11;22
96;01.08.2018;2018;08;20;Keskiviikko;60;45;105;8;3;11
96;01.08.2018;2018;08;21;Keskiviikko;54;37;91;2;5;7
96;01.08.2018;2018;08;22;Keskiviikko;19;25;44;3;3;6
96;01.08.2018;2018;08;23;Keskiviikko;15;12;27;6;2;8
96;02.08.2018;2018;08;00;Torstai;13;5;18;0;0;0
96;02.08.2018;2018;08;01;Torstai;11;4;15;0;0;0
96;02.08.2018;2018;08;02;Torstai;13;1;14;0;0;0
96;02.08.2018;2018;08;03;Torstai;6;0;6;2;1;3
96;02.08.2018;2018;08;04;Torstai;9;2;11;1;1;2
96;02.08.2018;2018;08;05;Torstai;6;10;16;0;1;1
96;02.08.2018;2018;08;06;Torstai;53;31;84;4;2;6
96;02.08.2018;2018;08;07;Torstai;99;107;206;5;4;9
96;02.08.2018;2018;08;08;Torstai;37;85;122;7;6;13
96;02.08.2018;2018;08;09;Torstai;41;39;80;2;8;10
96;02.08.2018;2018;08;10;Torstai;43;50;93;7;5;12
96;02.08.2018;2018;08;11;Torstai;45;54;99;5;6;11
96;02.08.2018;2018;08;12;Torstai;80;56;136;4;5;9
96;02.08.2018;2018;08;13;Torstai;73;51;124;3;8;11
96;02.08.2018;2018;08;14;Torstai;79;97;176;1;8;9
96;02.08.2018;2018;08;15;Torstai;99;139;238;7;17;24
96;02.08.2018;2018;08;16;Torstai;113;76;189;8;10;18
96;02.08.2018;2018;08;17;Torstai;64;66;130;7;6;13
96;02.08.2018;2018;08;18;Torstai;60;54;114;8;5;13
96;02.08.2018;2018;08;19;Torstai;74;48;122;7;5;12
96;02.08.2018;2018;08;20;Torstai;54;34;88;7;5;12
96;02.08.2018;2018;08;21;Torstai;48;31;79;5;6;11
96;02.08.2018;2018;08;22;Torstai;26;17;43;4;4;8
96;02.08.2018;2018;08;23;Torstai;22;9;31;0;1;1
96;03.08.2018;2018;08;00;Perjantai;13;6;19;1;0;1
96;03.08.2018;2018;08;01;Perjantai;9;8;17;0;0;0
96;03.08.2018;2018;08;02;Perjantai;3;1;4;1;0;1
96;03.08.2018;2018;08;03;Perjantai;5;0;5;0;0;0
96;03.08.2018;2018;08;04;Perjantai;8;4;12;0;0;0
96;03.08.2018;2018;08;05;Perjantai;6;8;14;1;1;2
96;03.08.2018;2018;08;06;Perjantai;48;28;76;3;0;3
96;03.08.2018;2018;08;07;Perjantai;41;59;100;5;2;7
96;03.08.2018;2018;08;08;Perjantai;23;67;90;2;6;8
96;03.08.2018;2018;08;09;Perjantai;20;42;62;3;11;14
96;03.08.2018;2018;08;10;Perjantai;11;8;19;1;1;2
96;03.08.2018;2018;08;11;Perjantai;22;12;34;2;0;2
96;03.08.2018;2018;08;12;Perjantai;13;19;32;4;2;6
96;03.08.2018;2018;08;13;Perjantai;35;41;76;4;2;6
96;03.08.2018;2018;08;14;Perjantai;38;77;115;6;14;20
96;03.08.2018;2018;08;15;Perjantai;68;89;157;6;14;20
96;03.08.2018;2018;08;16;Perjantai;68;91;159;9;13;22
96;03.08.2018;2018;08;17;Perjantai;58;64;122;4;7;11
96;03.08.2018;2018;08;18;Perjantai;34;51;85;3;4;7
96;03.08.2018;2018;08;19;Perjantai;59;42;101;11;13;24
96;03.08.2018;2018;08;20;Perjantai;44;36;80;7;4;11
96;03.08.2018;2018;08;21;Perjantai;29;40;69;8;3;11
96;03.08.2018;2018;08;22;Perjantai;30;17;47;4;4;8
96;03.08.2018;2018;08;23;Perjantai;27;22;49;5;6;11
96;04.08.2018;2018;08;00;Lauantai;16;14;30;3;2;5
96;04.08.2018;2018;08;01;Lauantai;13;3;16;0;0;0
96;04.08.2018;2018;08;02;Lauantai;5;0;5;2;1;3
96;04.08.2018;2018;08;03;Lauantai;12;4;16;1;3;4
96;04.08.2018;2018;08;04;Lauantai;7;4;11;5;0;5
96;04.08.2018;2018;08;05;Lauantai;6;2;8;2;0;2
96;04.08.2018;2018;08;06;Lauantai;25;10;35;4;0;4
96;04.08.2018;2018;08;07;Lauantai;5;17;22;1;7;8
96;04.08.2018;2018;08;08;Lauantai;8;15;23;2;5;7
96;04.08.2018;2018;08;09;Lauantai;13;26;39;9;3;12
96;04.08.2018;2018;08;10;Lauantai;40;43;83;1;5;6
96;04.08.2018;2018;08;11;Lauantai;40;53;93;6;5;11
96;04.08.2018;2018;08;12;Lauantai;46;56;102;8;5;13
96;04.08.2018;2018;08;13;Lauantai;74;53;127;8;9;17
96;04.08.2018;2018;08;14;Lauantai;57;75;132;4;11;15
96;04.08.2018;2018;08;15;Lauantai;53;59;112;5;7;12
96;04.08.2018;2018;08;16;Lauantai;55;83;138;6;12;18
96;04.08.2018;2018;08;17;Lauantai;63;65;128;5;5;10
96;04.08.2018;2018;08;18;Lauantai;62;52;114;13;8;21
96;04.08.2018;2018;08;19;Lauantai;59;41;100;4;10;14
96;04.08.2018;2018;08;20;Lauantai;45;53;98;9;6;15
96;04.08.2018;2018;08;21;Lauantai;44;35;79;2;5;7
96;04.08.2018;2018;08;22;Lauantai;24;34;58;0;2;2
96;04.08.2018;2018;08;23;Lauantai;18;19;37;2;1;3
96;05.08.2018;2018;08;00;Sunnuntai;22;11;33;1;0;1
96;05.08.2018;2018;08;01;Sunnuntai;24;9;33;2;2;4
96;05.08.2018;2018;08;02;Sunnuntai;26;2;28;2;1;3
96;05.08.2018;2018;08;03;Sunnuntai;18;7;25;2;1;3
96;05.08.2018;2018;08;04;Sunnuntai;23;5;28;6;1;7
96;05.08.2018;2018;08;05;Sunnuntai;13;5;18;1;0;1
96;05.08.2018;2018;08;06;Sunnuntai;27;11;38;2;1;3
96;05.08.2018;2018;08;07;Sunnuntai;10;17;27;4;2;6
96;05.08.2018;2018;08;08;Sunnuntai;8;7;15;3;4;7
96;05.08.2018;2018;08;09;Sunnuntai;12;10;22;3;3;6
96;05.08.2018;2018;08;10;Sunnuntai;21;18;39;3;10;13
96;05.08.2018;2018;08;11;Sunnuntai;32;28;60;12;7;19
96;05.08.2018;2018;08;12;Sunnuntai;36;41;77;8;4;12
96;05.08.2018;2018;08;13;Sunnuntai;24;19;43;0;1;1
96;05.08.2018;2018;08;14;Sunnuntai;33;45;78;7;7;14
96;05.08.2018;2018;08;15;Sunnuntai;30;69;99;2;8;10
96;05.08.2018;2018;08;16;Sunnuntai;61;40;101;16;7;23
96;05.08.2018;2018;08;17;Sunnuntai;57;51;108;5;11;16
96;05.08.2018;2018;08;18;Sunnuntai;72;43;115;16;15;31
96;05.08.2018;2018;08;19;Sunnuntai;34;58;92;12;11;23
96;05.08.2018;2018;08;20;Sunnuntai;51;26;77;6;12;18
96;05.08.2018;2018;08;21;Sunnuntai;29;29;58;7;4;11
96;05.08.2018;2018;08;22;Sunnuntai;13;8;21;1;6;7
96;05.08.2018;2018;08;23;Sunnuntai;12;11;23;2;1;3
96;06.08.2018;2018;08;00;Maanantai;6;6;12;2;0;2
96;06.08.2018;2018;08;01;Maanantai;4;2;6;0;1;1
96;06.08.2018;2018;08;02;Maanantai;3;0;3;1;0;1
96;06.08.2018;2018;08;03;Maanantai;8;0;8;0;0;0
96;06.08.2018;2018;08;04;Maanantai;6;1;7;0;0;0
96;06.08.2018;2018;08;05;Maanantai;8;9;17;1;0;1
96;06.08.2018;2018;08;06;Maanantai;59;38;97;5;1;6
96;06.08.2018;2018;08;07;Maanantai;92;90;182;8;3;11
96;06.08.2018;2018;08;08;Maanantai;38;79;117;8;9;17
96;06.08.2018;2018;08;09;Maanantai;28;47;75;7;10;17
96;06.08.2018;2018;08;10;Maanantai;29;42;71;3;13;16
96;06.08.2018;2018;08;11;Maanantai;30;26;56;6;3;9
96;06.08.2018;2018;08;12;Maanantai;25;29;54;2;2;4
96;06.08.2018;2018;08;13;Maanantai;35;31;66;2;2;4
96;06.08.2018;2018;08;14;Maanantai;28;51;79;3;1;4
96;06.08.2018;2018;08;15;Maanantai;51;127;178;5;16;21
96;06.08.2018;2018;08;16;Maanantai;81;100;181;9;12;21
96;06.08.2018;2018;08;17;Maanantai;72;51;123;8;4;12
96;06.08.2018;2018;08;18;Maanantai;60;52;112;12;8;20
96;06.08.2018;2018;08;19;Maanantai;55;27;82;4;6;10
96;06.08.2018;2018;08;20;Maanantai;51;26;77;15;6;21
96;06.08.2018;2018;08;21;Maanantai;30;37;67;4;4;8
96;06.08.2018;2018;08;22;Maanantai;10;9;19;0;2;2
96;06.08.2018;2018;08;23;Maanantai;5;8;13;3;2;5
96;07.08.2018;2018;08;00;Tiistai;27;0;27;2;0;2
96;07.08.2018;2018;08;01;Tiistai;18;0;18;2;0;2
96;07.08.2018;2018;08;02;Tiistai;18;0;18;0;0;0
96;07.08.2018;2018;08;03;Tiistai;9;0;9;0;0;0
96;07.08.2018;2018;08;04;Tiistai;4;0;4;1;0;1
96;07.08.2018;2018;08;05;Tiistai;20;0;20;2;0;2
96;07.08.2018;2018;08;06;Tiistai;122;0;122;4;0;4
96;07.08.2018;2018;08;07;Tiistai;191;0;191;10;0;10
96;07.08.2018;2018;08;08;Tiistai;142;0;142;9;0;9
96;07.08.2018;2018;08;09;Tiistai;116;0;116;16;0;16
96;07.08.2018;2018;08;10;Tiistai;119;0;119;8;0;8
96;07.08.2018;2018;08;11;Tiistai;130;0;130;9;0;9
96;07.08.2018;2018;08;12;Tiistai;124;0;124;5;0;5
96;07.08.2018;2018;08;13;Tiistai;149;0;149;14;0;14
96;07.08.2018;2018;08;14;Tiistai;191;0;191;14;0;14
96;07.08.2018;2018;08;15;Tiistai;284;0;284;24;0;24
96;07.08.2018;2018;08;16;Tiistai;194;0;194;21;0;21
96;07.08.2018;2018;08;17;Tiistai;163;0;163;15;0;15
96;07.08.2018;2018;08;18;Tiistai;139;0;139;21;0;21
96;07.08.2018;2018;08;19;Tiistai;117;0;117;28;0;28
96;07.08.2018;2018;08;20;Tiistai;123;0;123;16;0;16
96;07.08.2018;2018;08;21;Tiistai;91;0;91;7;0;7
96;07.08.2018;2018;08;22;Tiistai;43;0;43;6;0;6
96;07.08.2018;2018;08;23;Tiistai;33;0;33;6;0;6
96;08.08.2018;2018;08;00;Keskiviikko;14;5;19;2;0;2
96;08.08.2018;2018;08;01;Keskiviikko;5;1;6;0;0;0
96;08.08.2018;2018;08;02;Keskiviikko;5;0;5;0;0;0
96;08.08.2018;2018;08;03;Keskiviikko;1;1;2;2;0;2
96;08.08.2018;2018;08;04;Keskiviikko;4;2;6;0;0;0
96;08.08.2018;2018;08;05;Keskiviikko;9;14;23;0;2;2
96;08.08.2018;2018;08;06;Keskiviikko;76;33;109;4;2;6
96;08.08.2018;2018;08;07;Keskiviikko;96;130;226;13;12;25
96;08.08.2018;2018;08;08;Keskiviikko;70;112;182;10;7;17
96;08.08.2018;2018;08;09;Keskiviikko;46;89;135;10;3;13
96;08.08.2018;2018;08;10;Keskiviikko;39;63;102;8;3;11
96;08.08.2018;2018;08;11;Keskiviikko;70;72;142;14;18;32
96;08.08.2018;2018;08;12;Keskiviikko;81;89;170;6;12;18
96;08.08.2018;2018;08;13;Keskiviikko;83;120;203;8;24;32
96;08.08.2018;2018;08;14;Keskiviikko;88;118;206;4;23;27
96;08.08.2018;2018;08;15;Keskiviikko;121;179;300;3;27;30
96;08.08.2018;2018;08;16;Keskiviikko;164;126;290;7;20;27
96;08.08.2018;2018;08;17;Keskiviikko;131;105;236;12;8;20
96;08.08.2018;2018;08;18;Keskiviikko;129;91;220;22;14;36
96;08.08.2018;2018;08;19;Keskiviikko;102;53;155;13;14;27
96;08.08.2018;2018;08;20;Keskiviikko;96;63;159;8;15;23
96;08.08.2018;2018;08;21;Keskiviikko;26;64;90;6;8;14
96;08.08.2018;2018;08;22;Keskiviikko;24;20;44;3;4;7
96;08.08.2018;2018;08;23;Keskiviikko;7;10;17;2;2;4
96;09.08.2018;2018;08;00;Torstai;14;6;20;1;3;4
96;09.08.2018;2018;08;01;Torstai;11;2;13;0;0;0
96;09.08.2018;2018;08;02;Torstai;1;1;2;0;0;0
96;09.08.2018;2018;08;03;Torstai;4;0;4;0;0;0
96;09.08.2018;2018;08;04;Torstai;5;5;10;2;0;2
96;09.08.2018;2018;08;05;Torstai;13;14;27;0;0;0
96;09.08.2018;2018;08;06;Torstai;68;37;105;3;4;7
96;09.08.2018;2018;08;07;Torstai;114;109;223;12;6;18
96;09.08.2018;2018;08;08;Torstai;55;98;153;5;6;11
96;09.08.2018;2018;08;09;Torstai;93;85;178;9;4;13
96;09.08.2018;2018;08;10;Torstai;54;68;122;11;2;13
96;09.08.2018;2018;08;11;Torstai;60;94;154;5;4;9
96;09.08.2018;2018;08;12;Torstai;80;91;171;6;12;18
96;09.08.2018;2018;08;13;Torstai;82;108;190;4;21;25
96;09.08.2018;2018;08;14;Torstai;87;105;192;9;12;21
96;09.08.2018;2018;08;15;Torstai;113;167;280;12;23;35
96;09.08.2018;2018;08;16;Torstai;125;114;239;12;11;23
96;09.08.2018;2018;08;17;Torstai;85;86;171;7;12;19
96;09.08.2018;2018;08;18;Torstai;87;77;164;7;13;20
96;09.08.2018;2018;08;19;Torstai;60;43;103;10;4;14
96;09.08.2018;2018;08;20;Torstai;60;34;94;8;7;15
96;09.08.2018;2018;08;21;Torstai;41;29;70;3;6;9
96;09.08.2018;2018;08;22;Torstai;16;14;30;1;6;7
96;09.08.2018;2018;08;23;Torstai;14;11;25;0;1;1
96;10.08.2018;2018;08;00;Perjantai;8;6;14;1;0;1
96;10.08.2018;2018;08;01;Perjantai;2;3;5;1;0;1
96;10.08.2018;2018;08;02;Perjantai;3;3;6;0;1;1
96;10.08.2018;2018;08;03;Perjantai;4;1;5;1;0;1
96;10.08.2018;2018;08;04;Perjantai;4;3;7;0;1;1
96;10.08.2018;2018;08;05;Perjantai;9;8;17;1;1;2
96;10.08.2018;2018;08;06;Perjantai;64;36;100;4;5;9
96;10.08.2018;2018;08;07;Perjantai;130;151;281;12;9;21
96;10.08.2018;2018;08;08;Perjantai;128;126;254;3;7;10
96;10.08.2018;2018;08;09;Perjantai;55;98;153;5;5;10
96;10.08.2018;2018;08;10;Perjantai;55;71;126;8;5;13
96;10.08.2018;2018;08;11;Perjantai;61;121;182;6;10;16
96;10.08.2018;2018;08;12;Perjantai;90;96;186;2;27;29
96;10.08.2018;2018;08;13;Perjantai;102;102;204;7;14;21
96;10.08.2018;2018;08;14;Perjantai;135;173;308;8;20;28
96;10.08.2018;2018;08;15;Perjantai;146;177;323;9;28;37
96;10.08.2018;2018;08;16;Perjantai;117;77;194;16;7;23
96;10.08.2018;2018;08;17;Perjantai;82;97;179;8;6;14
96;10.08.2018;2018;08;18;Perjantai;54;71;125;8;7;15
96;10.08.2018;2018;08;19;Perjantai;43;28;71;8;6;14
96;10.08.2018;2018;08;20;Perjantai;67;29;96;5;2;7
96;10.08.2018;2018;08;21;Perjantai;14;18;32;0;1;1
96;10.08.2018;2018;08;22;Perjantai;23;10;33;1;0;1
96;10.08.2018;2018;08;23;Perjantai;16;11;27;1;1;2
96;11.08.2018;2018;08;00;Lauantai;8;4;12;3;1;4
96;11.08.2018;2018;08;01;Lauantai;15;2;17;3;0;3
96;11.08.2018;2018;08;02;Lauantai;11;4;15;2;0;2
96;11.08.2018;2018;08;03;Lauantai;10;0;10;0;0;0
96;11.08.2018;2018;08;04;Lauantai;12;3;15;1;0;1
96;11.08.2018;2018;08;05;Lauantai;4;9;13;0;2;2
96;11.08.2018;2018;08;06;Lauantai;28;7;35;4;0;4
96;11.08.2018;2018;08;07;Lauantai;5;16;21;2;2;4
96;11.08.2018;2018;08;08;Lauantai;12;31;43;4;2;6
96;11.08.2018;2018;08;09;Lauantai;25;53;78;3;7;10
96;11.08.2018;2018;08;10;Lauantai;28;59;87;5;9;14
96;11.08.2018;2018;08;11;Lauantai;48;61;109;8;5;13
96;11.08.2018;2018;08;12;Lauantai;51;64;115;8;5;13
96;11.08.2018;2018;08;13;Lauantai;54;60;114;6;6;12
96;11.08.2018;2018;08;14;Lauantai;40;53;93;3;6;9
96;11.08.2018;2018;08;15;Lauantai;43;45;88;5;5;10
96;11.08.2018;2018;08;16;Lauantai;65;31;96;5;3;8
96;11.08.2018;2018;08;17;Lauantai;65;22;87;5;4;9
96;11.08.2018;2018;08;18;Lauantai;52;46;98;14;3;17
96;11.08.2018;2018;08;19;Lauantai;29;48;77;6;4;10
96;11.08.2018;2018;08;20;Lauantai;34;46;80;4;5;9
96;11.08.2018;2018;08;21;Lauantai;35;46;81;1;6;7
96;11.08.2018;2018;08;22;Lauantai;32;20;52;1;1;2
96;11.08.2018;2018;08;23;Lauantai;26;13;39;0;2;2
96;12.08.2018;2018;08;00;Sunnuntai;13;12;25;0;2;2
96;12.08.2018;2018;08;01;Sunnuntai;25;7;32;5;0;5
96;12.08.2018;2018;08;02;Sunnuntai;17;3;20;0;0;0
96;12.08.2018;2018;08;03;Sunnuntai;10;3;13;0;0;0
96;12.08.2018;2018;08;04;Sunnuntai;14;3;17;3;0;3
96;12.08.2018;2018;08;05;Sunnuntai;8;5;13;1;0;1
96;12.08.2018;2018;08;06;Sunnuntai;34;6;40;1;1;2
96;12.08.2018;2018;08;07;Sunnuntai;4;11;15;0;1;1
96;12.08.2018;2018;08;08;Sunnuntai;12;9;21;4;3;7
96;12.08.2018;2018;08;09;Sunnuntai;7;27;34;5;6;11
96;12.08.2018;2018;08;10;Sunnuntai;22;26;48;6;2;8
96;12.08.2018;2018;08;11;Sunnuntai;31;46;77;4;6;10
96;12.08.2018;2018;08;12;Sunnuntai;56;58;114;5;4;9
96;12.08.2018;2018;08;13;Sunnuntai;44;65;109;4;5;9
96;12.08.2018;2018;08;14;Sunnuntai;67;68;135;10;7;17
96;12.08.2018;2018;08;15;Sunnuntai;77;52;129;7;6;13
96;12.08.2018;2018;08;16;Sunnuntai;99;38;137;20;9;29
96;12.08.2018;2018;08;17;Sunnuntai;57;58;115;9;13;22
96;12.08.2018;2018;08;18;Sunnuntai;74;49;123;17;17;34
96;12.08.2018;2018;08;19;Sunnuntai;39;49;88;5;9;14
96;12.08.2018;2018;08;20;Sunnuntai;45;31;76;14;9;23
96;12.08.2018;2018;08;21;Sunnuntai;15;32;47;3;4;7
96;12.08.2018;2018;08;22;Sunnuntai;12;14;26;0;4;4
96;12.08.2018;2018;08;23;Sunnuntai;5;9;14;1;1;2
96;13.08.2018;2018;08;00;Maanantai;2;4;6;2;0;2
96;13.08.2018;2018;08;01;Maanantai;1;0;1;0;0;0
96;13.08.2018;2018;08;02;Maanantai;0;2;2;0;0;0
96;13.08.2018;2018;08;03;Maanantai;4;0;4;0;0;0
96;13.08.2018;2018;08;04;Maanantai;3;1;4;0;0;0
96;13.08.2018;2018;08;05;Maanantai;14;6;20;1;0;1
96;13.08.2018;2018;08;06;Maanantai;62;25;87;6;2;8
96;13.08.2018;2018;08;07;Maanantai;150;137;287;10;4;14
96;13.08.2018;2018;08;08;Maanantai;113;122;235;13;6;19
96;13.08.2018;2018;08;09;Maanantai;124;80;204;10;7;17
96;13.08.2018;2018;08;10;Maanantai;49;59;108;8;13;21
96;13.08.2018;2018;08;11;Maanantai;57;68;125;1;7;8
96;13.08.2018;2018;08;12;Maanantai;87;80;167;20;10;30
96;13.08.2018;2018;08;13;Maanantai;75;82;157;7;13;20
96;13.08.2018;2018;08;14;Maanantai;99;116;215;4;16;20
96;13.08.2018;2018;08;15;Maanantai;96;236;332;8;23;31
96;13.08.2018;2018;08;16;Maanantai;107;125;232;13;13;26
96;13.08.2018;2018;08;17;Maanantai;86;70;156;15;7;22
96;13.08.2018;2018;08;18;Maanantai;71;58;129;10;15;25
96;13.08.2018;2018;08;19;Maanantai;54;43;97;10;9;19
96;13.08.2018;2018;08;20;Maanantai;56;33;89;6;7;13
96;13.08.2018;2018;08;21;Maanantai;25;31;56;8;8;16
96;13.08.2018;2018;08;22;Maanantai;12;18;30;2;3;5
96;13.08.2018;2018;08;23;Maanantai;3;5;8;0;1;1
96;14.08.2018;2018;08;00;Tiistai;2;2;4;0;2;2
96;14.08.2018;2018;08;01;Tiistai;5;0;5;0;1;1
96;14.08.2018;2018;08;02;Tiistai;4;2;6;1;1;2
96;14.08.2018;2018;08;03;Tiistai;0;3;3;0;0;0
96;14.08.2018;2018;08;04;Tiistai;2;1;3;2;0;2
96;14.08.2018;2018;08;05;Tiistai;9;13;22;2;0;2
96;14.08.2018;2018;08;06;Tiistai;67;49;116;4;4;8
96;14.08.2018;2018;08;07;Tiistai;213;200;413;11;8;19
96;14.08.2018;2018;08;08;Tiistai;95;138;233;10;8;18
96;14.08.2018;2018;08;09;Tiistai;117;92;209;6;11;17
96;14.08.2018;2018;08;10;Tiistai;66;83;149;8;8;16
96;14.08.2018;2018;08;11;Tiistai;65;96;161;9;9;18
96;14.08.2018;2018;08;12;Tiistai;117;106;223;15;10;25
96;14.08.2018;2018;08;13;Tiistai;96;85;181;5;21;26
96;14.08.2018;2018;08;14;Tiistai;94;198;292;11;11;22
96;14.08.2018;2018;08;15;Tiistai;136;289;425;4;22;26
96;14.08.2018;2018;08;16;Tiistai;187;173;360;15;17;32
96;14.08.2018;2018;08;17;Tiistai;122;96;218;12;17;29
96;14.08.2018;2018;08;18;Tiistai;105;58;163;21;12;33
96;14.08.2018;2018;08;19;Tiistai;70;51;121;9;12;21
96;14.08.2018;2018;08;20;Tiistai;79;41;120;8;9;17
96;14.08.2018;2018;08;21;Tiistai;36;42;78;2;9;11
96;14.08.2018;2018;08;22;Tiistai;14;13;27;2;3;5
96;14.08.2018;2018;08;23;Tiistai;3;4;7;1;3;4
96;15.08.2018;2018;08;00;Keskiviikko;2;1;3;1;0;1
96;15.08.2018;2018;08;01;Keskiviikko;0;1;1;0;0;0
96;15.08.2018;2018;08;02;Keskiviikko;2;2;4;0;0;0
96;15.08.2018;2018;08;03;Keskiviikko;2;2;4;0;1;1
96;15.08.2018;2018;08;04;Keskiviikko;3;0;3;0;0;0
96;15.08.2018;2018;08;05;Keskiviikko;12;11;23;0;1;1
96;15.08.2018;2018;08;06;Keskiviikko;77;36;113;4;4;8
96;15.08.2018;2018;08;07;Keskiviikko;187;225;412;20;12;32
96;15.08.2018;2018;08;08;Keskiviikko;110;110;220;12;8;20
96;15.08.2018;2018;08;09;Keskiviikko;104;86;190;8;4;12
96;15.08.2018;2018;08;10;Keskiviikko;71;64;135;6;13;19
96;15.08.2018;2018;08;11;Keskiviikko;85;84;169;11;10;21
96;15.08.2018;2018;08;12;Keskiviikko;103;99;202;8;13;21
96;15.08.2018;2018;08;13;Keskiviikko;89;123;212;9;19;28
96;15.08.2018;2018;08;14;Keskiviikko;114;181;295;8;21;29
96;15.08.2018;2018;08;15;Keskiviikko;147;306;453;11;36;47
96;15.08.2018;2018;08;16;Keskiviikko;194;195;389;11;19;30
96;15.08.2018;2018;08;17;Keskiviikko;112;93;205;10;17;27
96;15.08.2018;2018;08;18;Keskiviikko;125;68;193;25;10;35
96;15.08.2018;2018;08;19;Keskiviikko;82;51;133;7;15;22
96;15.08.2018;2018;08;20;Keskiviikko;105;88;193;10;16;26
96;15.08.2018;2018;08;21;Keskiviikko;28;48;76;5;16;21
96;15.08.2018;2018;08;22;Keskiviikko;17;15;32;0;1;1
96;15.08.2018;2018;08;23;Keskiviikko;6;3;9;0;1;1
96;16.08.2018;2018;08;00;Torstai;2;2;4;0;0;0
96;16.08.2018;2018;08;01;Torstai;2;1;3;0;0;0
96;16.08.2018;2018;08;02;Torstai;3;2;5;1;0;1
96;16.08.2018;2018;08;03;Torstai;2;2;4;0;0;0
96;16.08.2018;2018;08;04;Torstai;3;4;7;0;0;0
96;16.08.2018;2018;08;05;Torstai;7;12;19;0;2;2
96;16.08.2018;2018;08;06;Torstai;78;47;125;6;3;9
96;16.08.2018;2018;08;07;Torstai;186;221;407;14;8;22
96;16.08.2018;2018;08;08;Torstai;109;112;221;7;8;15
96;16.08.2018;2018;08;09;Torstai;131;76;207;7;12;19
96;16.08.2018;2018;08;10;Torstai;59;72;131;7;3;10
96;16.08.2018;2018;08;11;Torstai;90;92;182;5;10;15
96;16.08.2018;2018;08;12;Torstai;95;101;196;10;14;24
96;16.08.2018;2018;08;13;Torstai;102;113;215;3;12;15
96;16.08.2018;2018;08;14;Torstai;102;184;286;15;12;27
96;16.08.2018;2018;08;15;Torstai;130;295;425;10;25;35
96;16.08.2018;2018;08;16;Torstai;174;185;359;14;8;22
96;16.08.2018;2018;08;17;Torstai;114;105;219;9;19;28
96;16.08.2018;2018;08;18;Torstai;98;143;241;10;20;30
96;16.08.2018;2018;08;19;Torstai;96;94;190;9;11;20
96;16.08.2018;2018;08;20;Torstai;124;54;178;12;7;19
96;16.08.2018;2018;08;21;Torstai;55;58;113;3;6;9
96;16.08.2018;2018;08;22;Torstai;58;13;71;1;0;1
96;16.08.2018;2018;08;23;Torstai;26;16;42;0;1;1
96;17.08.2018;2018;08;00;Perjantai;29;4;33;1;0;1
96;17.08.2018;2018;08;01;Perjantai;18;3;21;1;0;1
96;17.08.2018;2018;08;02;Perjantai;10;2;12;1;0;1
96;17.08.2018;2018;08;03;Perjantai;11;4;15;2;0;2
96;17.08.2018;2018;08;04;Perjantai;17;2;19;1;0;1
96;17.08.2018;2018;08;05;Perjantai;4;11;15;0;1;1
96;17.08.2018;2018;08;06;Perjantai;76;41;117;6;3;9
96;17.08.2018;2018;08;07;Perjantai;146;175;321;14;10;24
96;17.08.2018;2018;08;08;Perjantai;70;112;182;4;15;19
96;17.08.2018;2018;08;09;Perjantai;75;111;186;5;6;11
96;17.08.2018;2018;08;10;Perjantai;47;70;117;5;8;13
96;17.08.2018;2018;08;11;Perjantai;73;90;163;10;10;20
96;17.08.2018;2018;08;12;Perjantai;76;120;196;3;17;20
96;17.08.2018;2018;08;13;Perjantai;71;120;191;9;9;18
96;17.08.2018;2018;08;14;Perjantai;128;212;340;2;12;14
96;17.08.2018;2018;08;15;Perjantai;120;153;273;4;22;26
96;17.08.2018;2018;08;16;Perjantai;98;109;207;1;5;6
96;17.08.2018;2018;08;17;Perjantai;63;83;146;9;3;12
96;17.08.2018;2018;08;18;Perjantai;80;54;134;4;12;16
96;17.08.2018;2018;08;19;Perjantai;58;46;104;3;8;11
96;17.08.2018;2018;08;20;Perjantai;64;32;96;4;3;7
96;17.08.2018;2018;08;21;Perjantai;33;30;63;0;2;2
96;17.08.2018;2018;08;22;Perjantai;11;9;20;2;0;2
96;17.08.2018;2018;08;23;Perjantai;14;4;18;0;1;1
96;18.08.2018;2018;08;00;Lauantai;11;4;15;0;0;0
96;18.08.2018;2018;08;01;Lauantai;4;1;5;2;0;2
96;18.08.2018;2018;08;02;Lauantai;6;1;7;0;0;0
96;18.08.2018;2018;08;03;Lauantai;7;1;8;0;0;0
96;18.08.2018;2018;08;04;Lauantai;6;5;11;1;0;1
96;18.08.2018;2018;08;05;Lauantai;3;1;4;0;1;1
96;18.08.2018;2018;08;06;Lauantai;26;7;33;4;1;5
96;18.08.2018;2018;08;07;Lauantai;5;20;25;1;1;2
96;18.08.2018;2018;08;08;Lauantai;5;22;27;7;8;15
96;18.08.2018;2018;08;09;Lauantai;16;30;46;4;3;7
96;18.08.2018;2018;08;10;Lauantai;36;47;83;2;10;12
96;18.08.2018;2018;08;11;Lauantai;38;59;97;10;11;21
96;18.08.2018;2018;08;12;Lauantai;59;62;121;3;7;10
96;18.08.2018;2018;08;13;Lauantai;50;65;115;6;9;15
96;18.08.2018;2018;08;14;Lauantai;78;61;139;10;8;18
96;18.08.2018;2018;08;15;Lauantai;65;57;122;8;9;17
96;18.08.2018;2018;08;16;Lauantai;55;52;107;5;7;12
96;18.08.2018;2018;08;17;Lauantai;43;81;124;8;10;18
96;18.08.2018;2018;08;18;Lauantai;70;57;127;20;8;28
96;18.08.2018;2018;08;19;Lauantai;60;44;104;2;10;12
96;18.08.2018;2018;08;20;Lauantai;43;40;83;9;16;25
96;18.08.2018;2018;08;21;Lauantai;32;29;61;1;3;4
96;18.08.2018;2018;08;22;Lauantai;33;19;52;0;0;0
96;18.08.2018;2018;08;23;Lauantai;36;16;52;0;0;0
96;19.08.2018;2018;08;00;Sunnuntai;23;3;26;1;0;1
96;19.08.2018;2018;08;01;Sunnuntai;19;2;21;1;0;1
96;19.08.2018;2018;08;02;Sunnuntai;11;3;14;3;0;3
96;19.08.2018;2018;08;03;Sunnuntai;11;2;13;0;0;0
96;19.08.2018;2018;08;04;Sunnuntai;8;1;9;1;0;1
96;19.08.2018;2018;08;05;Sunnuntai;6;0;6;0;0;0
96;19.08.2018;2018;08;06;Sunnuntai;25;4;29;4;1;5
96;19.08.2018;2018;08;07;Sunnuntai;2;14;16;0;3;3
96;19.08.2018;2018;08;08;Sunnuntai;3;10;13;3;4;7
96;19.08.2018;2018;08;09;Sunnuntai;18;14;32;4;3;7
96;19.08.2018;2018;08;10;Sunnuntai;16;29;45;10;5;15
96;19.08.2018;2018;08;11;Sunnuntai;29;32;61;4;10;14
96;19.08.2018;2018;08;12;Sunnuntai;48;46;94;7;7;14
96;19.08.2018;2018;08;13;Sunnuntai;45;53;98;7;10;17
96;19.08.2018;2018;08;14;Sunnuntai;41;52;93;5;12;17
96;19.08.2018;2018;08;15;Sunnuntai;51;55;106;7;13;20
96;19.08.2018;2018;08;16;Sunnuntai;104;35;139;8;5;13
96;19.08.2018;2018;08;17;Sunnuntai;52;42;94;6;6;12
96;19.08.2018;2018;08;18;Sunnuntai;49;41;90;16;5;21
96;19.08.2018;2018;08;19;Sunnuntai;36;48;84;8;17;25
96;19.08.2018;2018;08;20;Sunnuntai;41;41;82;9;9;18
96;19.08.2018;2018;08;21;Sunnuntai;22;30;52;3;4;7
96;19.08.2018;2018;08;22;Sunnuntai;12;9;21;3;2;5
96;19.08.2018;2018;08;23;Sunnuntai;5;3;8;1;1;2
96;20.08.2018;2018;08;00;Maanantai;4;2;6;3;1;4
96;20.08.2018;2018;08;01;Maanantai;1;0;1;0;0;0
96;20.08.2018;2018;08;02;Maanantai;4;0;4;0;0;0
96;20.08.2018;2018;08;03;Maanantai;0;0;0;1;0;1
96;20.08.2018;2018;08;04;Maanantai;2;2;4;0;0;0
96;20.08.2018;2018;08;05;Maanantai;9;10;19;0;2;2
96;20.08.2018;2018;08;06;Maanantai;81;44;125;9;3;12
96;20.08.2018;2018;08;07;Maanantai;214;177;391;17;7;24
96;20.08.2018;2018;08;08;Maanantai;124;128;252;19;5;24
96;20.08.2018;2018;08;09;Maanantai;120;67;187;24;6;30
96;20.08.2018;2018;08;10;Maanantai;66;61;127;4;17;21
96;20.08.2018;2018;08;11;Maanantai;102;97;199;7;12;19
96;20.08.2018;2018;08;12;Maanantai;103;105;208;10;13;23
96;20.08.2018;2018;08;13;Maanantai;108;100;208;9;13;22
96;20.08.2018;2018;08;14;Maanantai;93;175;268;14;25;39
96;20.08.2018;2018;08;15;Maanantai;113;320;433;6;45;51
96;20.08.2018;2018;08;16;Maanantai;177;182;359;10;22;32
96;20.08.2018;2018;08;17;Maanantai;91;87;178;8;17;25
96;20.08.2018;2018;08;18;Maanantai;79;75;154;11;9;20
96;20.08.2018;2018;08;19;Maanantai;76;55;131;11;14;25
96;20.08.2018;2018;08;20;Maanantai;72;43;115;18;11;29
96;20.08.2018;2018;08;21;Maanantai;40;43;83;3;7;10
96;20.08.2018;2018;08;22;Maanantai;9;19;28;2;2;4
96;20.08.2018;2018;08;23;Maanantai;4;3;7;0;1;1
96;21.08.2018;2018;08;00;Tiistai;2;1;3;0;0;0
96;21.08.2018;2018;08;01;Tiistai;0;0;0;0;0;0
96;21.08.2018;2018;08;02;Tiistai;1;2;3;0;0;0
96;21.08.2018;2018;08;03;Tiistai;1;0;1;0;0;0
96;21.08.2018;2018;08;04;Tiistai;4;3;7;1;0;1
96;21.08.2018;2018;08;05;Tiistai;6;14;20;0;1;1
96;21.08.2018;2018;08;06;Tiistai;74;50;124;4;4;8
96;21.08.2018;2018;08;07;Tiistai;256;207;463;16;7;23
96;21.08.2018;2018;08;08;Tiistai;132;132;264;10;4;14
96;21.08.2018;2018;08;09;Tiistai;132;92;224;10;5;15
96;21.08.2018;2018;08;10;Tiistai;64;72;136;7;7;14
96;21.08.2018;2018;08;11;Tiistai;96;90;186;7;9;16
96;21.08.2018;2018;08;12;Tiistai;86;109;195;12;13;25
96;21.08.2018;2018;08;13;Tiistai;114;76;190;12;11;23
96;21.08.2018;2018;08;14;Tiistai;123;166;289;10;26;36
96;21.08.2018;2018;08;15;Tiistai;140;385;525;4;35;39
96;21.08.2018;2018;08;16;Tiistai;177;184;361;7;20;27
96;21.08.2018;2018;08;17;Tiistai;112;98;210;5;12;17
96;21.08.2018;2018;08;18;Tiistai;100;63;163;19;15;34
96;21.08.2018;2018;08;19;Tiistai;70;42;112;10;16;26
96;21.08.2018;2018;08;20;Tiistai;61;43;104;14;5;19
96;21.08.2018;2018;08;21;Tiistai;34;41;75;2;4;6
96;21.08.2018;2018;08;22;Tiistai;11;13;24;4;3;7
96;21.08.2018;2018;08;23;Tiistai;4;6;10;0;2;2
96;22.08.2018;2018;08;00;Keskiviikko;4;1;5;3;0;3
96;22.08.2018;2018;08;01;Keskiviikko;2;3;5;0;0;0
96;22.08.2018;2018;08;02;Keskiviikko;1;2;3;0;0;0
96;22.08.2018;2018;08;03;Keskiviikko;2;0;2;0;0;0
96;22.08.2018;2018;08;04;Keskiviikko;2;2;4;1;0;1
96;22.08.2018;2018;08;05;Keskiviikko;8;14;22;0;1;1
96;22.08.2018;2018;08;06;Keskiviikko;62;45;107;7;1;8
96;22.08.2018;2018;08;07;Keskiviikko;226;196;422;20;10;30
96;22.08.2018;2018;08;08;Keskiviikko;129;138;267;11;13;24
96;22.08.2018;2018;08;09;Keskiviikko;119;83;202;11;8;19
96;22.08.2018;2018;08;10;Keskiviikko;61;71;132;6;5;11
96;22.08.2018;2018;08;11;Keskiviikko;115;105;220;12;12;24
96;22.08.2018;2018;08;12;Keskiviikko;113;96;209;10;12;22
96;22.08.2018;2018;08;13;Keskiviikko;108;109;217;10;11;21
96;22.08.2018;2018;08;14;Keskiviikko;112;210;322;8;18;26
96;22.08.2018;2018;08;15;Keskiviikko;132;296;428;5;29;34
96;22.08.2018;2018;08;16;Keskiviikko;166;176;342;12;11;23
96;22.08.2018;2018;08;17;Keskiviikko;108;80;188;12;13;25
96;22.08.2018;2018;08;18;Keskiviikko;98;51;149;24;11;35
96;22.08.2018;2018;08;19;Keskiviikko;78;40;118;16;15;31
96;22.08.2018;2018;08;20;Keskiviikko;62;55;117;7;5;12
96;22.08.2018;2018;08;21;Keskiviikko;20;39;59;5;16;21
96;22.08.2018;2018;08;22;Keskiviikko;13;12;25;2;5;7
96;22.08.2018;2018;08;23;Keskiviikko;7;5;12;0;0;0
96;23.08.2018;2018;08;00;Torstai;0;1;1;0;0;0
96;23.08.2018;2018;08;01;Torstai;7;2;9;2;0;2
96;23.08.2018;2018;08;02;Torstai;4;0;4;1;0;1
96;23.08.2018;2018;08;03;Torstai;0;1;1;1;0;1
96;23.08.2018;2018;08;04;Torstai;4;7;11;0;1;1
96;23.08.2018;2018;08;05;Torstai;10;6;16;0;1;1
96;23.08.2018;2018;08;06;Torstai;61;35;96;6;0;6
96;23.08.2018;2018;08;07;Torstai;178;134;312;19;6;25
96;23.08.2018;2018;08;08;Torstai;110;82;192;8;4;12
96;23.08.2018;2018;08;09;Torstai;81;39;120;7;3;10
96;23.08.2018;2018;08;10;Torstai;34;30;64;1;1;2
96;23.08.2018;2018;08;11;Torstai;35;53;88;10;1;11
96;23.08.2018;2018;08;12;Torstai;55;84;139;8;10;18
96;23.08.2018;2018;08;13;Torstai;81;87;168;5;14;19
96;23.08.2018;2018;08;14;Torstai;66;168;234;8;15;23
96;23.08.2018;2018;08;15;Torstai;104;272;376;5;31;36
96;23.08.2018;2018;08;16;Torstai;127;140;267;9;24;33
96;23.08.2018;2018;08;17;Torstai;66;80;146;5;12;17
96;23.08.2018;2018;08;18;Torstai;79;75;154;12;11;23
96;23.08.2018;2018;08;19;Torstai;96;53;149;11;13;24
96;23.08.2018;2018;08;20;Torstai;60;43;103;6;4;10
96;23.08.2018;2018;08;21;Torstai;28;43;71;6;11;17
96;23.08.2018;2018;08;22;Torstai;8;27;35;1;0;1
96;23.08.2018;2018;08;23;Torstai;9;7;16;0;1;1
96;24.08.2018;2018;08;00;Perjantai;5;1;6;0;0;0
96;24.08.2018;2018;08;01;Perjantai;2;2;4;0;0;0
96;24.08.2018;2018;08;02;Perjantai;2;2;4;0;0;0
96;24.08.2018;2018;08;03;Perjantai;1;3;4;0;0;0
96;24.08.2018;2018;08;04;Perjantai;1;1;2;0;0;0
96;24.08.2018;2018;08;05;Perjantai;8;11;19;0;0;0
96;24.08.2018;2018;08;06;Perjantai;61;36;97;8;2;10
96;24.08.2018;2018;08;07;Perjantai;144;115;259;10;9;19
96;24.08.2018;2018;08;08;Perjantai;107;98;205;6;6;12
96;24.08.2018;2018;08;09;Perjantai;72;67;139;11;3;14
96;24.08.2018;2018;08;10;Perjantai;33;38;71;6;9;15
96;24.08.2018;2018;08;11;Perjantai;34;78;112;1;12;13
96;24.08.2018;2018;08;12;Perjantai;52;78;130;4;6;10
96;24.08.2018;2018;08;13;Perjantai;54;83;137;10;12;22
96;24.08.2018;2018;08;14;Perjantai;65;169;234;4;17;21
96;24.08.2018;2018;08;15;Perjantai;85;123;208;4;16;20
96;24.08.2018;2018;08;16;Perjantai;71;78;149;6;13;19
96;24.08.2018;2018;08;17;Perjantai;89;56;145;4;6;10
96;24.08.2018;2018;08;18;Perjantai;55;37;92;5;7;12
96;24.08.2018;2018;08;19;Perjantai;47;48;95;7;3;10
96;24.08.2018;2018;08;20;Perjantai;60;31;91;6;3;9
96;24.08.2018;2018;08;21;Perjantai;35;25;60;5;5;10
96;24.08.2018;2018;08;22;Perjantai;11;9;20;4;5;9
96;24.08.2018;2018;08;23;Perjantai;12;2;14;0;1;1
96;25.08.2018;2018;08;00;Lauantai;8;7;15;1;0;1
96;25.08.2018;2018;08;01;Lauantai;6;2;8;2;0;2
96;25.08.2018;2018;08;02;Lauantai;13;4;17;1;1;2
96;25.08.2018;2018;08;03;Lauantai;9;2;11;0;0;0
96;25.08.2018;2018;08;04;Lauantai;4;2;6;2;0;2
96;25.08.2018;2018;08;05;Lauantai;4;1;5;0;0;0
96;25.08.2018;2018;08;06;Lauantai;22;11;33;4;0;4
96;25.08.2018;2018;08;07;Lauantai;4;22;26;1;1;2
96;25.08.2018;2018;08;08;Lauantai;9;23;32;3;5;8
96;25.08.2018;2018;08;09;Lauantai;6;19;25;4;8;12
96;25.08.2018;2018;08;10;Lauantai;15;13;28;1;0;1
96;25.08.2018;2018;08;11;Lauantai;19;36;55;3;12;15
96;25.08.2018;2018;08;12;Lauantai;31;85;116;4;6;10
96;25.08.2018;2018;08;13;Lauantai;56;65;121;7;7;14
96;25.08.2018;2018;08;14;Lauantai;69;72;141;10;14;24
96;25.08.2018;2018;08;15;Lauantai;69;63;132;7;11;18
96;25.08.2018;2018;08;16;Lauantai;57;48;105;7;3;10
96;25.08.2018;2018;08;17;Lauantai;68;46;114;6;7;13
96;25.08.2018;2018;08;18;Lauantai;78;54;132;18;3;21
96;25.08.2018;2018;08;19;Lauantai;35;33;68;7;6;13
96;25.08.2018;2018;08;20;Lauantai;32;41;73;6;9;15
96;25.08.2018;2018;08;21;Lauantai;26;28;54;2;6;8
96;25.08.2018;2018;08;22;Lauantai;19;12;31;0;0;0
96;25.08.2018;2018;08;23;Lauantai;8;8;16;1;0;1
96;26.08.2018;2018;08;00;Sunnuntai;8;8;16;3;2;5
96;26.08.2018;2018;08;01;Sunnuntai;11;2;13;0;0;0
96;26.08.2018;2018;08;02;Sunnuntai;5;1;6;0;0;0
96;26.08.2018;2018;08;03;Sunnuntai;12;1;13;0;1;1
96;26.08.2018;2018;08;04;Sunnuntai;9;3;12;0;0;0
96;26.08.2018;2018;08;05;Sunnuntai;9;2;11;1;0;1
96;26.08.2018;2018;08;06;Sunnuntai;16;5;21;1;0;1
96;26.08.2018;2018;08;07;Sunnuntai;5;17;22;3;4;7
96;26.08.2018;2018;08;08;Sunnuntai;9;13;22;2;4;6
96;26.08.2018;2018;08;09;Sunnuntai;15;18;33;3;6;9
96;26.08.2018;2018;08;10;Sunnuntai;26;27;53;11;4;15
96;26.08.2018;2018;08;11;Sunnuntai;30;51;81;5;19;24
96;26.08.2018;2018;08;12;Sunnuntai;67;71;138;8;6;14
96;26.08.2018;2018;08;13;Sunnuntai;60;56;116;7;9;16
96;26.08.2018;2018;08;14;Sunnuntai;69;64;133;2;1;3
96;26.08.2018;2018;08;15;Sunnuntai;49;45;94;7;1;8
96;26.08.2018;2018;08;16;Sunnuntai;46;7;53;13;5;18
96;26.08.2018;2018;08;17;Sunnuntai;39;20;59;3;7;10
96;26.08.2018;2018;08;18;Sunnuntai;35;25;60;8;26;34
96;26.08.2018;2018;08;19;Sunnuntai;21;30;51;9;16;25
96;26.08.2018;2018;08;20;Sunnuntai;32;19;51;5;4;9
96;26.08.2018;2018;08;21;Sunnuntai;15;21;36;8;6;14
96;26.08.2018;2018;08;22;Sunnuntai;2;6;8;0;0;0
96;26.08.2018;2018;08;23;Sunnuntai;3;1;4;2;1;3
96;27.08.2018;2018;08;00;Maanantai;4;1;5;0;0;0
96;27.08.2018;2018;08;01;Maanantai;2;3;5;1;0;1
96;27.08.2018;2018;08;02;Maanantai;1;3;4;1;0;1
96;27.08.2018;2018;08;03;Maanantai;1;1;2;0;0;0
96;27.08.2018;2018;08;04;Maanantai;3;2;5;1;0;1
96;27.08.2018;2018;08;05;Maanantai;11;14;25;0;0;0
96;27.08.2018;2018;08;06;Maanantai;52;49;101;7;1;8
96;27.08.2018;2018;08;07;Maanantai;191;188;379;18;7;25
96;27.08.2018;2018;08;08;Maanantai;158;159;317;19;5;24
96;27.08.2018;2018;08;09;Maanantai;156;109;265;16;10;26
96;27.08.2018;2018;08;10;Maanantai;102;61;163;12;19;31
96;27.08.2018;2018;08;11;Maanantai;108;114;222;18;33;51
96;27.08.2018;2018;08;12;Maanantai;103;150;253;13;14;27
96;27.08.2018;2018;08;13;Maanantai;126;117;243;15;14;29
96;27.08.2018;2018;08;14;Maanantai;127;163;290;14;23;37
96;27.08.2018;2018;08;15;Maanantai;108;275;383;6;29;35
96;27.08.2018;2018;08;16;Maanantai;132;202;334;8;37;45
96;27.08.2018;2018;08;17;Maanantai;90;88;178;14;13;27
96;27.08.2018;2018;08;18;Maanantai;76;58;134;14;14;28
96;27.08.2018;2018;08;19;Maanantai;78;44;122;9;10;19
96;27.08.2018;2018;08;20;Maanantai;71;30;101;8;14;22
96;27.08.2018;2018;08;21;Maanantai;38;51;89;4;10;14
96;27.08.2018;2018;08;22;Maanantai;8;10;18;2;3;5
96;27.08.2018;2018;08;23;Maanantai;4;4;8;0;3;3
96;28.08.2018;2018;08;00;Tiistai;2;1;3;1;0;1
96;28.08.2018;2018;08;01;Tiistai;1;1;2;0;0;0
96;28.08.2018;2018;08;02;Tiistai;2;1;3;0;0;0
96;28.08.2018;2018;08;03;Tiistai;0;0;0;0;1;1
96;28.08.2018;2018;08;04;Tiistai;1;4;5;1;1;2
96;28.08.2018;2018;08;05;Tiistai;14;11;25;1;2;3
96;28.08.2018;2018;08;06;Tiistai;78;48;126;3;4;7
96;28.08.2018;2018;08;07;Tiistai;266;228;494;14;6;20
96;28.08.2018;2018;08;08;Tiistai;175;163;338;16;9;25
96;28.08.2018;2018;08;09;Tiistai;166;130;296;8;14;22
96;28.08.2018;2018;08;10;Tiistai;106;92;198;13;15;28
96;28.08.2018;2018;08;11;Tiistai;137;122;259;17;23;40
96;28.08.2018;2018;08;12;Tiistai;132;181;313;14;17;31
96;28.08.2018;2018;08;13;Tiistai;147;132;279;14;18;32
96;28.08.2018;2018;08;14;Tiistai;131;186;317;7;17;24
96;28.08.2018;2018;08;15;Tiistai;144;330;474;11;23;34
96;28.08.2018;2018;08;16;Tiistai;165;204;369;18;24;42
96;28.08.2018;2018;08;17;Tiistai;96;99;195;8;19;27
96;28.08.2018;2018;08;18;Tiistai;96;70;166;7;15;22
96;28.08.2018;2018;08;19;Tiistai;77;67;144;10;19;29
96;28.08.2018;2018;08;20;Tiistai;73;52;125;7;9;16
96;28.08.2018;2018;08;21;Tiistai;22;37;59;7;5;12
96;28.08.2018;2018;08;22;Tiistai;17;12;29;1;1;2
96;28.08.2018;2018;08;23;Tiistai;3;1;4;0;0;0
96;29.08.2018;2018;08;00;Keskiviikko;3;2;5;3;0;3
96;29.08.2018;2018;08;01;Keskiviikko;2;0;2;1;0;1
96;29.08.2018;2018;08;02;Keskiviikko;3;1;4;1;0;1
96;29.08.2018;2018;08;03;Keskiviikko;3;0;3;0;0;0
96;29.08.2018;2018;08;04;Keskiviikko;4;4;8;0;0;0
96;29.08.2018;2018;08;05;Keskiviikko;9;16;25;0;2;2
96;29.08.2018;2018;08;06;Keskiviikko;82;40;122;2;2;4
96;29.08.2018;2018;08;07;Keskiviikko;235;209;444;18;9;27
96;29.08.2018;2018;08;08;Keskiviikko;164;268;432;12;14;26
96;29.08.2018;2018;08;09;Keskiviikko;241;125;366;19;16;35
96;29.08.2018;2018;08;10;Keskiviikko;117;93;210;18;20;38
96;29.08.2018;2018;08;11;Keskiviikko;151;158;309;19;23;42
96;29.08.2018;2018;08;12;Keskiviikko;115;190;305;14;17;31
96;29.08.2018;2018;08;13;Keskiviikko;121;146;267;17;41;58
96;29.08.2018;2018;08;14;Keskiviikko;138;201;339;11;24;35
96;29.08.2018;2018;08;15;Keskiviikko;116;305;421;9;34;43
96;29.08.2018;2018;08;16;Keskiviikko;163;181;344;8;24;32
96;29.08.2018;2018;08;17;Keskiviikko;104;90;194;14;18;32
96;29.08.2018;2018;08;18;Keskiviikko;128;65;193;29;10;39
96;29.08.2018;2018;08;19;Keskiviikko;76;78;154;16;9;25
96;29.08.2018;2018;08;20;Keskiviikko;79;66;145;8;12;20
96;29.08.2018;2018;08;21;Keskiviikko;39;44;83;3;6;9
96;29.08.2018;2018;08;22;Keskiviikko;15;11;26;5;5;10
96;29.08.2018;2018;08;23;Keskiviikko;11;6;17;3;0;3
96;30.08.2018;2018;08;00;Torstai;9;3;12;2;2;4
96;30.08.2018;2018;08;01;Torstai;5;2;7;0;0;0
96;30.08.2018;2018;08;02;Torstai;5;2;7;0;0;0
96;30.08.2018;2018;08;03;Torstai;3;0;3;2;0;2
96;30.08.2018;2018;08;04;Torstai;2;4;6;0;0;0
96;30.08.2018;2018;08;05;Torstai;8;9;17;0;1;1
96;30.08.2018;2018;08;06;Torstai;72;42;114;1;2;3
96;30.08.2018;2018;08;07;Torstai;223;204;427;15;11;26
96;30.08.2018;2018;08;08;Torstai;165;163;328;25;26;51
96;30.08.2018;2018;08;09;Torstai;162;134;296;11;15;26
96;30.08.2018;2018;08;10;Torstai;113;109;222;10;27;37
96;30.08.2018;2018;08;11;Torstai;118;163;281;24;22;46
96;30.08.2018;2018;08;12;Torstai;140;173;313;12;21;33
96;30.08.2018;2018;08;13;Torstai;116;146;262;29;18;47
96;30.08.2018;2018;08;14;Torstai;134;241;375;7;18;25
96;30.08.2018;2018;08;15;Torstai;112;279;391;16;27;43
96;30.08.2018;2018;08;16;Torstai;162;206;368;12;15;27
96;30.08.2018;2018;08;17;Torstai;97;97;194;10;10;20
96;30.08.2018;2018;08;18;Torstai;73;70;143;4;8;12
96;30.08.2018;2018;08;19;Torstai;52;40;92;12;12;24
96;30.08.2018;2018;08;20;Torstai;58;33;91;7;10;17
96;30.08.2018;2018;08;21;Torstai;37;50;87;4;5;9
96;30.08.2018;2018;08;22;Torstai;12;17;29;1;1;2
96;30.08.2018;2018;08;23;Torstai;3;3;6;0;2;2
96;31.08.2018;2018;08;00;Perjantai;7;1;8;3;1;4
96;31.08.2018;2018;08;01;Perjantai;3;1;4;3;1;4
96;31.08.2018;2018;08;02;Perjantai;5;1;6;0;0;0
96;31.08.2018;2018;08;03;Perjantai;3;0;3;0;0;0
96;31.08.2018;2018;08;04;Perjantai;4;3;7;0;0;0
96;31.08.2018;2018;08;05;Perjantai;8;11;19;0;2;2
96;31.08.2018;2018;08;06;Perjantai;77;48;125;3;1;4
96;31.08.2018;2018;08;07;Perjantai;204;174;378;34;12;46
96;31.08.2018;2018;08;08;Perjantai;130;130;260;9;18;27
96;31.08.2018;2018;08;09;Perjantai;144;141;285;17;6;23
96;31.08.2018;2018;08;10;Perjantai;91;91;182;10;19;29
96;31.08.2018;2018;08;11;Perjantai;102;140;242;16;31;47
96;31.08.2018;2018;08;12;Perjantai;112;199;311;23;20;43
96;31.08.2018;2018;08;13;Perjantai;116;125;241;20;20;40
96;31.08.2018;2018;08;14;Perjantai;167;236;403;7;15;22
96;31.08.2018;2018;08;15;Perjantai;114;223;337;8;24;32
96;31.08.2018;2018;08;16;Perjantai;130;134;264;5;17;22
96;31.08.2018;2018;08;17;Perjantai;103;81;184;9;14;23
96;31.08.2018;2018;08;18;Perjantai;75;96;171;11;7;18
96;31.08.2018;2018;08;19;Perjantai;59;43;102;5;9;14
96;31.08.2018;2018;08;20;Perjantai;70;35;105;3;6;9
96;31.08.2018;2018;08;21;Perjantai;66;44;110;6;6;12
96;31.08.2018;2018;08;22;Perjantai;16;21;37;2;3;5
96;31.08.2018;2018;08;23;Perjantai;14;7;21;0;0;0
96;01.09.2018;2018;09;00;Lauantai;16;7;23;2;0;2
96;01.09.2018;2018;09;01;Lauantai;12;3;15;1;0;1
96;01.09.2018;2018;09;02;Lauantai;20;2;22;1;0;1
96;01.09.2018;2018;09;03;Lauantai;9;1;10;3;0;3
96;01.09.2018;2018;09;04;Lauantai;10;3;13;1;0;1
96;01.09.2018;2018;09;05;Lauantai;0;3;3;3;1;4
96;01.09.2018;2018;09;06;Lauantai;26;6;32;2;0;2
96;01.09.2018;2018;09;07;Lauantai;6;21;27;4;5;9
96;01.09.2018;2018;09;08;Lauantai;17;31;48;2;5;7
96;01.09.2018;2018;09;09;Lauantai;22;34;56;3;6;9
96;01.09.2018;2018;09;10;Lauantai;28;42;70;3;4;7
96;01.09.2018;2018;09;11;Lauantai;43;65;108;6;6;12
96;01.09.2018;2018;09;12;Lauantai;55;78;133;10;11;21
96;01.09.2018;2018;09;13;Lauantai;74;69;143;10;13;23
96;01.09.2018;2018;09;14;Lauantai;60;80;140;5;11;16
96;01.09.2018;2018;09;15;Lauantai;61;64;125;8;7;15
96;01.09.2018;2018;09;16;Lauantai;62;69;131;11;11;22
96;01.09.2018;2018;09;17;Lauantai;61;56;117;10;6;16
96;01.09.2018;2018;09;18;Lauantai;74;45;119;20;5;25
96;01.09.2018;2018;09;19;Lauantai;55;41;96;6;5;11
96;01.09.2018;2018;09;20;Lauantai;41;41;82;7;12;19
96;01.09.2018;2018;09;21;Lauantai;24;36;60;3;7;10
96;01.09.2018;2018;09;22;Lauantai;23;19;42;5;6;11
96;01.09.2018;2018;09;23;Lauantai;16;9;25;1;0;1
96;02.09.2018;2018;09;00;Sunnuntai;15;7;22;1;0;1
96;02.09.2018;2018;09;01;Sunnuntai;21;3;24;2;0;2
96;02.09.2018;2018;09;02;Sunnuntai;15;0;15;0;0;0
96;02.09.2018;2018;09;03;Sunnuntai;11;0;11;0;0;0
96;02.09.2018;2018;09;04;Sunnuntai;16;4;20;2;0;2
96;02.09.2018;2018;09;05;Sunnuntai;12;1;13;1;0;1
96;02.09.2018;2018;09;06;Sunnuntai;24;4;28;0;2;2
96;02.09.2018;2018;09;07;Sunnuntai;4;12;16;1;2;3
96;02.09.2018;2018;09;08;Sunnuntai;9;7;16;3;3;6
96;02.09.2018;2018;09;09;Sunnuntai;4;22;26;4;3;7
96;02.09.2018;2018;09;10;Sunnuntai;25;41;66;7;8;15
96;02.09.2018;2018;09;11;Sunnuntai;43;57;100;6;12;18
96;02.09.2018;2018;09;12;Sunnuntai;71;58;129;10;12;22
96;02.09.2018;2018;09;13;Sunnuntai;72;71;143;6;13;19
96;02.09.2018;2018;09;14;Sunnuntai;49;72;121;6;12;18
96;02.09.2018;2018;09;15;Sunnuntai;75;89;164;10;8;18
96;02.09.2018;2018;09;16;Sunnuntai;112;57;169;24;16;40
96;02.09.2018;2018;09;17;Sunnuntai;60;57;117;8;20;28
96;02.09.2018;2018;09;18;Sunnuntai;78;85;163;15;18;33
96;02.09.2018;2018;09;19;Sunnuntai;45;60;105;8;11;19
96;02.09.2018;2018;09;20;Sunnuntai;35;38;73;6;7;13
96;02.09.2018;2018;09;21;Sunnuntai;46;24;70;12;7;19
96;02.09.2018;2018;09;22;Sunnuntai;10;3;13;0;2;2
96;02.09.2018;2018;09;23;Sunnuntai;3;2;5;0;0;0
96;03.09.2018;2018;09;00;Maanantai;3;1;4;1;0;1
96;03.09.2018;2018;09;01;Maanantai;2;1;3;0;0;0
96;03.09.2018;2018;09;02;Maanantai;2;2;4;0;0;0
96;03.09.2018;2018;09;03;Maanantai;0;1;1;0;0;0
96;03.09.2018;2018;09;04;Maanantai;6;1;7;0;1;1
96;03.09.2018;2018;09;05;Maanantai;7;15;22;1;2;3
96;03.09.2018;2018;09;06;Maanantai;72;47;119;5;3;8
96;03.09.2018;2018;09;07;Maanantai;242;177;419;19;8;27
96;03.09.2018;2018;09;08;Maanantai;189;133;322;16;5;21
96;03.09.2018;2018;09;09;Maanantai;112;94;206;19;8;27
96;03.09.2018;2018;09;10;Maanantai;87;73;160;6;9;15
96;03.09.2018;2018;09;11;Maanantai;80;114;194;11;15;26
96;03.09.2018;2018;09;12;Maanantai;111;132;243;3;16;19
96;03.09.2018;2018;09;13;Maanantai;89;145;234;8;12;20
96;03.09.2018;2018;09;14;Maanantai;127;208;335;10;33;43
96;03.09.2018;2018;09;15;Maanantai;169;298;467;8;28;36
96;03.09.2018;2018;09;16;Maanantai;191;205;396;26;29;55
96;03.09.2018;2018;09;17;Maanantai;107;125;232;12;17;29
96;03.09.2018;2018;09;18;Maanantai;90;99;189;7;8;15
96;03.09.2018;2018;09;19;Maanantai;98;61;159;16;18;34
96;03.09.2018;2018;09;20;Maanantai;79;43;122;7;6;13
96;03.09.2018;2018;09;21;Maanantai;43;54;97;2;2;4
96;03.09.2018;2018;09;22;Maanantai;12;15;27;1;0;1
96;03.09.2018;2018;09;23;Maanantai;12;8;20;0;0;0
96;04.09.2018;2018;09;00;Tiistai;9;2;11;1;0;1
96;04.09.2018;2018;09;01;Tiistai;3;0;3;0;0;0
96;04.09.2018;2018;09;02;Tiistai;1;0;1;0;0;0
96;04.09.2018;2018;09;03;Tiistai;4;1;5;2;0;2
96;04.09.2018;2018;09;04;Tiistai;1;3;4;0;0;0
96;04.09.2018;2018;09;05;Tiistai;8;14;22;0;1;1
96;04.09.2018;2018;09;06;Tiistai;77;46;123;4;5;9
96;04.09.2018;2018;09;07;Tiistai;268;192;460;14;13;27
96;04.09.2018;2018;09;08;Tiistai;191;137;328;17;6;23
96;04.09.2018;2018;09;09;Tiistai;134;99;233;8;12;20
96;04.09.2018;2018;09;10;Tiistai;83;102;185;6;15;21
96;04.09.2018;2018;09;11;Tiistai;104;94;198;24;2;26
96;04.09.2018;2018;09;12;Tiistai;134;126;260;10;9;19
96;04.09.2018;2018;09;13;Tiistai;108;120;228;14;16;30
96;04.09.2018;2018;09;14;Tiistai;121;220;341;7;23;30
96;04.09.2018;2018;09;15;Tiistai;135;356;491;3;24;27
96;04.09.2018;2018;09;16;Tiistai;182;242;424;6;18;24
96;04.09.2018;2018;09;17;Tiistai;94;119;213;5;15;20
96;04.09.2018;2018;09;18;Tiistai;110;77;187;14;21;35
96;04.09.2018;2018;09;19;Tiistai;105;57;162;5;7;12
96;04.09.2018;2018;09;20;Tiistai;66;59;125;9;16;25
96;04.09.2018;2018;09;21;Tiistai;33;60;93;6;11;17
96;04.09.2018;2018;09;22;Tiistai;12;11;23;1;4;5
96;04.09.2018;2018;09;23;Tiistai;5;3;8;1;1;2
96;05.09.2018;2018;09;00;Keskiviikko;8;0;8;1;0;1
96;05.09.2018;2018;09;01;Keskiviikko;4;1;5;0;0;0
96;05.09.2018;2018;09;02;Keskiviikko;8;1;9;1;0;1
96;05.09.2018;2018;09;03;Keskiviikko;6;1;7;0;0;0
96;05.09.2018;2018;09;04;Keskiviikko;15;3;18;2;0;2
96;05.09.2018;2018;09;05;Keskiviikko;11;8;19;0;1;1
96;05.09.2018;2018;09;06;Keskiviikko;87;38;125;4;2;6
96;05.09.2018;2018;09;07;Keskiviikko;220;296;516;16;10;26
96;05.09.2018;2018;09;08;Keskiviikko;157;175;332;15;15;30
96;05.09.2018;2018;09;09;Keskiviikko;104;103;207;11;7;18
96;05.09.2018;2018;09;10;Keskiviikko;300;78;378;30;15;45
96;05.09.2018;2018;09;11;Keskiviikko;101;104;205;12;5;17
96;05.09.2018;2018;09;12;Keskiviikko;131;117;248;9;6;15
96;05.09.2018;2018;09;13;Keskiviikko;104;143;247;12;18;30
96;05.09.2018;2018;09;14;Keskiviikko;109;234;343;8;18;26
96;05.09.2018;2018;09;15;Keskiviikko;125;293;418;1;20;21
96;05.09.2018;2018;09;16;Keskiviikko;145;212;357;10;15;25
96;05.09.2018;2018;09;17;Keskiviikko;72;105;177;3;6;9
96;05.09.2018;2018;09;18;Keskiviikko;118;73;191;20;5;25
96;05.09.2018;2018;09;19;Keskiviikko;82;51;133;8;16;24
96;05.09.2018;2018;09;20;Keskiviikko;46;88;134;5;9;14
96;05.09.2018;2018;09;21;Keskiviikko;23;42;65;2;7;9
96;05.09.2018;2018;09;22;Keskiviikko;7;12;19;3;1;4
96;05.09.2018;2018;09;23;Keskiviikko;9;5;14;1;3;4
96;06.09.2018;2018;09;00;Torstai;9;1;10;0;0;0
96;06.09.2018;2018;09;01;Torstai;4;0;4;3;0;3
96;06.09.2018;2018;09;02;Torstai;3;1;4;0;0;0
96;06.09.2018;2018;09;03;Torstai;7;0;7;0;0;0
96;06.09.2018;2018;09;04;Torstai;7;2;9;0;1;1
96;06.09.2018;2018;09;05;Torstai;8;9;17;1;1;2
96;06.09.2018;2018;09;06;Torstai;68;38;106;2;0;2
96;06.09.2018;2018;09;07;Torstai;185;170;355;14;13;27
96;06.09.2018;2018;09;08;Torstai;178;138;316;10;12;22
96;06.09.2018;2018;09;09;Torstai;121;88;209;12;8;20
96;06.09.2018;2018;09;10;Torstai;75;82;157;8;16;24
96;06.09.2018;2018;09;11;Torstai;94;120;214;9;14;23
96;06.09.2018;2018;09;12;Torstai;93;219;312;7;39;46
96;06.09.2018;2018;09;13;Torstai;94;172;266;5;21;26
96;06.09.2018;2018;09;14;Torstai;143;167;310;26;28;54
96;06.09.2018;2018;09;15;Torstai;129;268;397;12;24;36
96;06.09.2018;2018;09;16;Torstai;139;206;345;10;19;29
96;06.09.2018;2018;09;17;Torstai;105;80;185;12;6;18
96;06.09.2018;2018;09;18;Torstai;85;74;159;10;13;23
96;06.09.2018;2018;09;19;Torstai;64;72;136;11;13;24
96;06.09.2018;2018;09;20;Torstai;58;79;137;4;16;20
96;06.09.2018;2018;09;21;Torstai;27;105;132;7;15;22
96;06.09.2018;2018;09;22;Torstai;13;44;57;2;6;8
96;06.09.2018;2018;09;23;Torstai;15;4;19;8;4;12
96;07.09.2018;2018;09;00;Perjantai;33;1;34;10;0;10
96;07.09.2018;2018;09;01;Perjantai;26;3;29;6;0;6
96;07.09.2018;2018;09;02;Perjantai;19;4;23;2;1;3
96;07.09.2018;2018;09;03;Perjantai;9;3;12;2;0;2
96;07.09.2018;2018;09;04;Perjantai;10;2;12;0;0;0
96;07.09.2018;2018;09;05;Perjantai;13;10;23;1;2;3
96;07.09.2018;2018;09;06;Perjantai;69;37;106;4;3;7
96;07.09.2018;2018;09;07;Perjantai;207;150;357;17;5;22
96;07.09.2018;2018;09;08;Perjantai;117;95;212;10;4;14
96;07.09.2018;2018;09;09;Perjantai;90;112;202;10;3;13
96;07.09.2018;2018;09;10;Perjantai;63;57;120;9;13;22
96;07.09.2018;2018;09;11;Perjantai;81;112;193;8;15;23
96;07.09.2018;2018;09;12;Perjantai;90;113;203;7;12;19
96;07.09.2018;2018;09;13;Perjantai;101;164;265;17;16;33
96;07.09.2018;2018;09;14;Perjantai;107;224;331;2;25;27
96;07.09.2018;2018;09;15;Perjantai;100;188;288;5;28;33
96;07.09.2018;2018;09;16;Perjantai;102;114;216;8;10;18
96;07.09.2018;2018;09;17;Perjantai;77;93;170;12;12;24
96;07.09.2018;2018;09;18;Perjantai;63;93;156;16;10;26
96;07.09.2018;2018;09;19;Perjantai;51;74;125;11;12;23
96;07.09.2018;2018;09;20;Perjantai;54;36;90;6;8;14
96;07.09.2018;2018;09;21;Perjantai;56;39;95;9;4;13
96;07.09.2018;2018;09;22;Perjantai;20;20;40;2;5;7
96;07.09.2018;2018;09;23;Perjantai;19;7;26;3;1;4
96;08.09.2018;2018;09;00;Lauantai;21;7;28;1;1;2
96;08.09.2018;2018;09;01;Lauantai;8;3;11;0;0;0
96;08.09.2018;2018;09;02;Lauantai;15;1;16;1;1;2
96;08.09.2018;2018;09;03;Lauantai;2;0;2;0;0;0
96;08.09.2018;2018;09;04;Lauantai;3;1;4;0;0;0
96;08.09.2018;2018;09;05;Lauantai;5;3;8;0;1;1
96;08.09.2018;2018;09;06;Lauantai;31;4;35;3;0;3
96;08.09.2018;2018;09;07;Lauantai;3;20;23;0;3;3
96;08.09.2018;2018;09;08;Lauantai;38;28;66;8;5;13
96;08.09.2018;2018;09;09;Lauantai;7;69;76;7;9;16
96;08.09.2018;2018;09;10;Lauantai;43;57;100;4;4;8
96;08.09.2018;2018;09;11;Lauantai;60;65;125;11;10;21
96;08.09.2018;2018;09;12;Lauantai;56;67;123;8;10;18
96;08.09.2018;2018;09;13;Lauantai;61;68;129;4;16;20
96;08.09.2018;2018;09;14;Lauantai;66;77;143;9;10;19
96;08.09.2018;2018;09;15;Lauantai;56;79;135;22;28;50
96;08.09.2018;2018;09;16;Lauantai;59;57;116;11;22;33
96;08.09.2018;2018;09;17;Lauantai;75;50;125;17;16;33
96;08.09.2018;2018;09;18;Lauantai;86;49;135;18;13;31
96;08.09.2018;2018;09;19;Lauantai;26;45;71;9;13;22
96;08.09.2018;2018;09;20;Lauantai;44;53;97;7;14;21
96;08.09.2018;2018;09;21;Lauantai;18;27;45;7;2;9
96;08.09.2018;2018;09;22;Lauantai;10;24;34;12;3;15
96;08.09.2018;2018;09;23;Lauantai;19;17;36;4;11;15
96;09.09.2018;2018;09;00;Sunnuntai;15;8;23;1;0;1
96;09.09.2018;2018;09;01;Sunnuntai;13;10;23;3;0;3
96;09.09.2018;2018;09;02;Sunnuntai;18;2;20;2;0;2
96;09.09.2018;2018;09;03;Sunnuntai;15;0;15;2;0;2
96;09.09.2018;2018;09;04;Sunnuntai;9;3;12;0;0;0
96;09.09.2018;2018;09;05;Sunnuntai;6;2;8;2;0;2
96;09.09.2018;2018;09;06;Sunnuntai;24;3;27;2;0;2
96;09.09.2018;2018;09;07;Sunnuntai;2;22;24;3;0;3
96;09.09.2018;2018;09;08;Sunnuntai;12;10;22;6;11;17
96;09.09.2018;2018;09;09;Sunnuntai;12;18;30;5;4;9
96;09.09.2018;2018;09;10;Sunnuntai;19;28;47;6;11;17
96;09.09.2018;2018;09;11;Sunnuntai;44;43;87;9;7;16
96;09.09.2018;2018;09;12;Sunnuntai;50;57;107;12;12;24
96;09.09.2018;2018;09;13;Sunnuntai;61;56;117;9;15;24
96;09.09.2018;2018;09;14;Sunnuntai;54;74;128;10;5;15
96;09.09.2018;2018;09;15;Sunnuntai;63;65;128;9;14;23
96;09.09.2018;2018;09;16;Sunnuntai;99;52;151;24;17;41
96;09.09.2018;2018;09;17;Sunnuntai;61;59;120;12;15;27
96;09.09.2018;2018;09;18;Sunnuntai;45;64;109;21;20;41
96;09.09.2018;2018;09;19;Sunnuntai;33;59;92;10;15;25
96;09.09.2018;2018;09;20;Sunnuntai;50;39;89;5;13;18
96;09.09.2018;2018;09;21;Sunnuntai;17;41;58;7;3;10
96;09.09.2018;2018;09;22;Sunnuntai;9;14;23;4;1;5
96;09.09.2018;2018;09;23;Sunnuntai;5;2;7;1;0;1
96;10.09.2018;2018;09;00;Maanantai;6;3;9;0;0;0
96;10.09.2018;2018;09;01;Maanantai;3;0;3;0;0;0
96;10.09.2018;2018;09;02;Maanantai;2;0;2;0;0;0
96;10.09.2018;2018;09;03;Maanantai;3;1;4;0;0;0
96;10.09.2018;2018;09;04;Maanantai;4;4;8;0;0;0
96;10.09.2018;2018;09;05;Maanantai;9;14;23;1;1;2
96;10.09.2018;2018;09;06;Maanantai;81;40;121;5;2;7
96;10.09.2018;2018;09;07;Maanantai;210;171;381;21;12;33
96;10.09.2018;2018;09;08;Maanantai;142;126;268;10;9;19
96;10.09.2018;2018;09;09;Maanantai;124;86;210;5;8;13
96;10.09.2018;2018;09;10;Maanantai;77;90;167;9;14;23
96;10.09.2018;2018;09;11;Maanantai;123;99;222;10;9;19
96;10.09.2018;2018;09;12;Maanantai;119;114;233;5;7;12
96;10.09.2018;2018;09;13;Maanantai;89;126;215;4;9;13
96;10.09.2018;2018;09;14;Maanantai;102;240;342;9;23;32
96;10.09.2018;2018;09;15;Maanantai;147;318;465;7;20;27
96;10.09.2018;2018;09;16;Maanantai;149;225;374;5;23;28
96;10.09.2018;2018;09;17;Maanantai;125;109;234;13;18;31
96;10.09.2018;2018;09;18;Maanantai;93;93;186;14;11;25
96;10.09.2018;2018;09;19;Maanantai;93;68;161;19;9;28
96;10.09.2018;2018;09;20;Maanantai;65;55;120;19;13;32
96;10.09.2018;2018;09;21;Maanantai;31;51;82;4;8;12
96;10.09.2018;2018;09;22;Maanantai;12;15;27;1;3;4
96;10.09.2018;2018;09;23;Maanantai;2;3;5;0;0;0
96;11.09.2018;2018;09;00;Tiistai;2;0;2;0;0;0
96;11.09.2018;2018;09;01;Tiistai;2;0;2;0;0;0
96;11.09.2018;2018;09;02;Tiistai;4;1;5;0;0;0
96;11.09.2018;2018;09;03;Tiistai;3;0;3;0;0;0
96;11.09.2018;2018;09;04;Tiistai;2;2;4;0;0;0
96;11.09.2018;2018;09;05;Tiistai;7;13;20;0;1;1
96;11.09.2018;2018;09;06;Tiistai;81;40;121;5;2;7
96;11.09.2018;2018;09;07;Tiistai;219;171;390;20;9;29
96;11.09.2018;2018;09;08;Tiistai;169;131;300;14;9;23
96;11.09.2018;2018;09;09;Tiistai;129;75;204;9;5;14
96;11.09.2018;2018;09;10;Tiistai;66;68;134;9;15;24
96;11.09.2018;2018;09;11;Tiistai;102;102;204;14;6;20
96;11.09.2018;2018;09;12;Tiistai;100;106;206;9;11;20
96;11.09.2018;2018;09;13;Tiistai;76;104;180;5;9;14
96;11.09.2018;2018;09;14;Tiistai;71;200;271;6;18;24
96;11.09.2018;2018;09;15;Tiistai;121;334;455;6;24;30
96;11.09.2018;2018;09;16;Tiistai;126;203;329;8;18;26
96;11.09.2018;2018;09;17;Tiistai;56;48;104;5;4;9
96;11.09.2018;2018;09;18;Tiistai;46;40;86;3;4;7
96;11.09.2018;2018;09;19;Tiistai;68;26;94;8;7;15
96;11.09.2018;2018;09;20;Tiistai;38;33;71;9;8;17
96;11.09.2018;2018;09;21;Tiistai;10;32;42;1;8;9
96;11.09.2018;2018;09;22;Tiistai;6;9;15;3;0;3
96;11.09.2018;2018;09;23;Tiistai;3;3;6;0;0;0
96;12.09.2018;2018;09;00;Keskiviikko;3;1;4;0;0;0
96;12.09.2018;2018;09;01;Keskiviikko;0;1;1;0;0;0
96;12.09.2018;2018;09;02;Keskiviikko;0;1;1;0;0;0
96;12.09.2018;2018;09;03;Keskiviikko;2;0;2;0;0;0
96;12.09.2018;2018;09;04;Keskiviikko;1;3;4;0;0;0
96;12.09.2018;2018;09;05;Keskiviikko;7;9;16;0;1;1
96;12.09.2018;2018;09;06;Keskiviikko;69;38;107;6;1;7
96;12.09.2018;2018;09;07;Keskiviikko;182;139;321;17;8;25
96;12.09.2018;2018;09;08;Keskiviikko;161;105;266;11;2;13
96;12.09.2018;2018;09;09;Keskiviikko;107;78;185;22;8;30
96;12.09.2018;2018;09;10;Keskiviikko;69;64;133;13;12;25
96;12.09.2018;2018;09;11;Keskiviikko;105;88;193;23;8;31
96;12.09.2018;2018;09;12;Keskiviikko;66;80;146;9;12;21
96;12.09.2018;2018;09;13;Keskiviikko;68;89;157;5;7;12
96;12.09.2018;2018;09;14;Keskiviikko;67;157;224;4;19;23
96;12.09.2018;2018;09;15;Keskiviikko;63;244;307;16;20;36
96;12.09.2018;2018;09;16;Keskiviikko;86;134;220;6;10;16
96;12.09.2018;2018;09;17;Keskiviikko;47;67;114;8;7;15
96;12.09.2018;2018;09;18;Keskiviikko;78;48;126;18;11;29
96;12.09.2018;2018;09;19;Keskiviikko;50;37;87;6;12;18
96;12.09.2018;2018;09;20;Keskiviikko;52;58;110;11;11;22
96;12.09.2018;2018;09;21;Keskiviikko;24;39;63;1;5;6
96;12.09.2018;2018;09;22;Keskiviikko;6;7;13;2;2;4
96;12.09.2018;2018;09;23;Keskiviikko;10;3;13;1;1;2
96;13.09.2018;2018;09;00;Torstai;7;2;9;2;0;2
96;13.09.2018;2018;09;01;Torstai;3;1;4;1;1;2
96;13.09.2018;2018;09;02;Torstai;6;1;7;1;0;1
96;13.09.2018;2018;09;03;Torstai;9;4;13;2;0;2
96;13.09.2018;2018;09;04;Torstai;7;3;10;0;0;0
96;13.09.2018;2018;09;05;Torstai;8;11;19;1;1;2
96;13.09.2018;2018;09;06;Torstai;67;43;110;6;3;9
96;13.09.2018;2018;09;07;Torstai;174;164;338;17;7;24
96;13.09.2018;2018;09;08;Torstai;173;134;307;15;10;25
96;13.09.2018;2018;09;09;Torstai;158;105;263;11;5;16
96;13.09.2018;2018;09;10;Torstai;85;77;162;9;10;19
96;13.09.2018;2018;09;11;Torstai;109;102;211;15;14;29
96;13.09.2018;2018;09;12;Torstai;87;134;221;14;12;26
96;13.09.2018;2018;09;13;Torstai;91;101;192;8;15;23
96;13.09.2018;2018;09;14;Torstai;105;185;290;6;25;31
96;13.09.2018;2018;09;15;Torstai;129;270;399;10;29;39
96;13.09.2018;2018;09;16;Torstai;132;205;337;9;21;30
96;13.09.2018;2018;09;17;Torstai;99;91;190;15;12;27
96;13.09.2018;2018;09;18;Torstai;76;94;170;10;12;22
96;13.09.2018;2018;09;19;Torstai;67;57;124;12;14;26
96;13.09.2018;2018;09;20;Torstai;79;31;110;9;9;18
96;13.09.2018;2018;09;21;Torstai;35;42;77;2;6;8
96;13.09.2018;2018;09;22;Torstai;15;11;26;0;3;3
96;13.09.2018;2018;09;23;Torstai;6;3;9;1;1;2
96;14.09.2018;2018;09;00;Perjantai;11;1;12;0;0;0
96;14.09.2018;2018;09;01;Perjantai;13;1;14;1;1;2
96;14.09.2018;2018;09;02;Perjantai;9;1;10;1;0;1
96;14.09.2018;2018;09;03;Perjantai;4;0;4;0;0;0
96;14.09.2018;2018;09;04;Perjantai;1;1;2;0;0;0
96;14.09.2018;2018;09;05;Perjantai;5;9;14;0;2;2
96;14.09.2018;2018;09;06;Perjantai;65;32;97;5;1;6
96;14.09.2018;2018;09;07;Perjantai;172;156;328;15;9;24
96;14.09.2018;2018;09;08;Perjantai;126;117;243;13;15;28
96;14.09.2018;2018;09;09;Perjantai;127;105;232;27;8;35
96;14.09.2018;2018;09;10;Perjantai;86;72;158;6;9;15
96;14.09.2018;2018;09;11;Perjantai;75;107;182;5;11;16
96;14.09.2018;2018;09;12;Perjantai;113;130;243;7;15;22
96;14.09.2018;2018;09;13;Perjantai;106;133;239;12;19;31
96;14.09.2018;2018;09;14;Perjantai;117;212;329;6;25;31
96;14.09.2018;2018;09;15;Perjantai;109;158;267;8;20;28
96;14.09.2018;2018;09;16;Perjantai;91;98;189;6;10;16
96;14.09.2018;2018;09;17;Perjantai;67;61;128;2;9;11
96;14.09.2018;2018;09;18;Perjantai;44;47;91;4;15;19
96;14.09.2018;2018;09;19;Perjantai;38;37;75;10;6;16
96;14.09.2018;2018;09;20;Perjantai;39;30;69;7;4;11
96;14.09.2018;2018;09;21;Perjantai;12;30;42;6;3;9
96;14.09.2018;2018;09;22;Perjantai;4;15;19;0;6;6
96;14.09.2018;2018;09;23;Perjantai;6;6;12;5;0;5
96;15.09.2018;2018;09;00;Lauantai;11;6;17;0;6;6
96;15.09.2018;2018;09;01;Lauantai;8;2;10;3;0;3
96;15.09.2018;2018;09;02;Lauantai;10;1;11;1;0;1
96;15.09.2018;2018;09;03;Lauantai;6;5;11;3;0;3
96;15.09.2018;2018;09;04;Lauantai;9;3;12;0;0;0
96;15.09.2018;2018;09;05;Lauantai;2;1;3;0;0;0
96;15.09.2018;2018;09;06;Lauantai;33;8;41;1;1;2
96;15.09.2018;2018;09;07;Lauantai;1;16;17;1;2;3
96;15.09.2018;2018;09;08;Lauantai;10;35;45;1;1;2
96;15.09.2018;2018;09;09;Lauantai;38;44;82;5;7;12
96;15.09.2018;2018;09;10;Lauantai;20;38;58;9;7;16
96;15.09.2018;2018;09;11;Lauantai;34;78;112;5;7;12
96;15.09.2018;2018;09;12;Lauantai;52;36;88;2;7;9
96;15.09.2018;2018;09;13;Lauantai;45;26;71;3;4;7
96;15.09.2018;2018;09;14;Lauantai;24;35;59;9;4;13
96;15.09.2018;2018;09;15;Lauantai;34;45;79;5;7;12
96;15.09.2018;2018;09;16;Lauantai;39;46;85;7;9;16
96;15.09.2018;2018;09;17;Lauantai;25;29;54;6;1;7
96;15.09.2018;2018;09;18;Lauantai;38;23;61;14;8;22
96;15.09.2018;2018;09;19;Lauantai;35;27;62;7;10;17
96;15.09.2018;2018;09;20;Lauantai;21;25;46;6;9;15
96;15.09.2018;2018;09;21;Lauantai;11;30;41;2;2;4
96;15.09.2018;2018;09;22;Lauantai;8;11;19;2;2;4
96;15.09.2018;2018;09;23;Lauantai;16;12;28;1;0;1
96;16.09.2018;2018;09;00;Sunnuntai;7;11;18;3;1;4
96;16.09.2018;2018;09;01;Sunnuntai;7;3;10;2;1;3
96;16.09.2018;2018;09;02;Sunnuntai;7;1;8;0;0;0
96;16.09.2018;2018;09;03;Sunnuntai;11;1;12;5;0;5
96;16.09.2018;2018;09;04;Sunnuntai;15;1;16;2;0;2
96;16.09.2018;2018;09;05;Sunnuntai;11;4;15;0;0;0
96;16.09.2018;2018;09;06;Sunnuntai;20;5;25;1;0;1
96;16.09.2018;2018;09;07;Sunnuntai;0;12;12;3;1;4
96;16.09.2018;2018;09;08;Sunnuntai;13;17;30;5;6;11
96;16.09.2018;2018;09;09;Sunnuntai;16;30;46;2;7;9
96;16.09.2018;2018;09;10;Sunnuntai;18;45;63;8;7;15
96;16.09.2018;2018;09;11;Sunnuntai;29;70;99;10;8;18
96;16.09.2018;2018;09;12;Sunnuntai;56;59;115;7;15;22
96;16.09.2018;2018;09;13;Sunnuntai;62;33;95;14;8;22
96;16.09.2018;2018;09;14;Sunnuntai;52;55;107;8;4;12
96;16.09.2018;2018;09;15;Sunnuntai;70;49;119;7;8;15
96;16.09.2018;2018;09;16;Sunnuntai;82;30;112;27;6;33
96;16.09.2018;2018;09;17;Sunnuntai;66;35;101;9;13;22
96;16.09.2018;2018;09;18;Sunnuntai;49;47;96;10;17;27
96;16.09.2018;2018;09;19;Sunnuntai;16;33;49;7;16;23
96;16.09.2018;2018;09;20;Sunnuntai;20;39;59;5;13;18
96;16.09.2018;2018;09;21;Sunnuntai;11;26;37;2;3;5
96;16.09.2018;2018;09;22;Sunnuntai;13;4;17;0;2;2
96;16.09.2018;2018;09;23;Sunnuntai;3;3;6;0;1;1
96;17.09.2018;2018;09;00;Maanantai;2;3;5;1;0;1
96;17.09.2018;2018;09;01;Maanantai;2;0;2;1;0;1
96;17.09.2018;2018;09;02;Maanantai;0;1;1;0;0;0
96;17.09.2018;2018;09;03;Maanantai;2;1;3;1;0;1
96;17.09.2018;2018;09;04;Maanantai;5;4;9;0;0;0
96;17.09.2018;2018;09;05;Maanantai;4;11;15;1;2;3
96;17.09.2018;2018;09;06;Maanantai;58;39;97;7;0;7
96;17.09.2018;2018;09;07;Maanantai;216;168;384;14;13;27
96;17.09.2018;2018;09;08;Maanantai;192;111;303;21;5;26
96;17.09.2018;2018;09;09;Maanantai;108;102;210;14;9;23
96;17.09.2018;2018;09;10;Maanantai;67;66;133;9;17;26
96;17.09.2018;2018;09;11;Maanantai;105;97;202;11;12;23
96;17.09.2018;2018;09;12;Maanantai;101;110;211;11;16;27
96;17.09.2018;2018;09;13;Maanantai;106;124;230;12;9;21
96;17.09.2018;2018;09;14;Maanantai;126;215;341;12;25;37
96;17.09.2018;2018;09;15;Maanantai;108;270;378;8;29;37
96;17.09.2018;2018;09;16;Maanantai;165;189;354;17;30;47
96;17.09.2018;2018;09;17;Maanantai;80;123;203;11;21;32
96;17.09.2018;2018;09;18;Maanantai;67;64;131;11;8;19
96;17.09.2018;2018;09;19;Maanantai;69;54;123;10;11;21
96;17.09.2018;2018;09;20;Maanantai;59;42;101;6;8;14
96;17.09.2018;2018;09;21;Maanantai;36;46;82;2;3;5
96;17.09.2018;2018;09;22;Maanantai;6;9;15;0;1;1
96;17.09.2018;2018;09;23;Maanantai;2;0;2;0;0;0
96;18.09.2018;2018;09;00;Tiistai;3;6;9;0;0;0
96;18.09.2018;2018;09;01;Tiistai;2;1;3;0;0;0
96;18.09.2018;2018;09;02;Tiistai;1;0;1;1;0;1
96;18.09.2018;2018;09;03;Tiistai;2;1;3;1;0;1
96;18.09.2018;2018;09;04;Tiistai;2;2;4;0;0;0
96;18.09.2018;2018;09;05;Tiistai;9;13;22;1;1;2
96;18.09.2018;2018;09;06;Tiistai;69;32;101;6;3;9
96;18.09.2018;2018;09;07;Tiistai;214;192;406;17;10;27
96;18.09.2018;2018;09;08;Tiistai;185;121;306;14;9;23
96;18.09.2018;2018;09;09;Tiistai;157;105;262;16;10;26
96;18.09.2018;2018;09;10;Tiistai;84;77;161;9;9;18
96;18.09.2018;2018;09;11;Tiistai;115;83;198;21;10;31
96;18.09.2018;2018;09;12;Tiistai;114;100;214;15;13;28
96;18.09.2018;2018;09;13;Tiistai;92;141;233;11;21;32
96;18.09.2018;2018;09;14;Tiistai;90;201;291;11;13;24
96;18.09.2018;2018;09;15;Tiistai;124;352;476;6;30;36
96;18.09.2018;2018;09;16;Tiistai;141;195;336;9;27;36
96;18.09.2018;2018;09;17;Tiistai;116;118;234;20;22;42
96;18.09.2018;2018;09;18;Tiistai;91;69;160;14;20;34
96;18.09.2018;2018;09;19;Tiistai;97;47;144;12;16;28
96;18.09.2018;2018;09;20;Tiistai;48;36;84;9;9;18
96;18.09.2018;2018;09;21;Tiistai;23;50;73;3;8;11
96;18.09.2018;2018;09;22;Tiistai;9;9;18;2;3;5
96;18.09.2018;2018;09;23;Tiistai;6;4;10;0;0;0
96;19.09.2018;2018;09;00;Keskiviikko;6;3;9;1;0;1
96;19.09.2018;2018;09;01;Keskiviikko;1;1;2;1;0;1
96;19.09.2018;2018;09;02;Keskiviikko;4;0;4;0;0;0
96;19.09.2018;2018;09;03;Keskiviikko;3;1;4;0;0;0
96;19.09.2018;2018;09;04;Keskiviikko;3;4;7;0;0;0
96;19.09.2018;2018;09;05;Keskiviikko;9;9;18;1;3;4
96;19.09.2018;2018;09;06;Keskiviikko;71;39;110;5;3;8
96;19.09.2018;2018;09;07;Keskiviikko;196;184;380;14;5;19
96;19.09.2018;2018;09;08;Keskiviikko;150;118;268;13;6;19
96;19.09.2018;2018;09;09;Keskiviikko;109;72;181;17;10;27
96;19.09.2018;2018;09;10;Keskiviikko;80;72;152;6;10;16
96;19.09.2018;2018;09;11;Keskiviikko;88;79;167;9;6;15
96;19.09.2018;2018;09;12;Keskiviikko;83;100;183;16;23;39
96;19.09.2018;2018;09;13;Keskiviikko;79;84;163;8;8;16
96;19.09.2018;2018;09;14;Keskiviikko;72;209;281;8;16;24
96;19.09.2018;2018;09;15;Keskiviikko;58;266;324;8;33;41
96;19.09.2018;2018;09;16;Keskiviikko;116;171;287;12;21;33
96;19.09.2018;2018;09;17;Keskiviikko;57;84;141;7;11;18
96;19.09.2018;2018;09;18;Keskiviikko;92;54;146;17;13;30
96;19.09.2018;2018;09;19;Keskiviikko;59;42;101;9;7;16
96;19.09.2018;2018;09;20;Keskiviikko;45;61;106;8;14;22
96;19.09.2018;2018;09;21;Keskiviikko;22;47;69;8;7;15
96;19.09.2018;2018;09;22;Keskiviikko;12;9;21;0;0;0
96;19.09.2018;2018;09;23;Keskiviikko;3;10;13;1;1;2
96;20.09.2018;2018;09;00;Torstai;7;5;12;1;0;1
96;20.09.2018;2018;09;01;Torstai;5;0;5;1;1;2
96;20.09.2018;2018;09;02;Torstai;2;2;4;1;0;1
96;20.09.2018;2018;09;03;Torstai;2;0;2;0;1;1
96;20.09.2018;2018;09;04;Torstai;2;3;5;2;0;2
96;20.09.2018;2018;09;05;Torstai;6;11;17;1;1;2
96;20.09.2018;2018;09;06;Torstai;65;38;103;5;1;6
96;20.09.2018;2018;09;07;Torstai;169;169;338;10;4;14
96;20.09.2018;2018;09;08;Torstai;172;128;300;11;10;21
96;20.09.2018;2018;09;09;Torstai;134;74;208;22;7;29
96;20.09.2018;2018;09;10;Torstai;65;95;160;6;15;21
96;20.09.2018;2018;09;11;Torstai;88;77;165;10;7;17
96;20.09.2018;2018;09;12;Torstai;117;128;245;18;9;27
96;20.09.2018;2018;09;13;Torstai;82;166;248;6;10;16
96;20.09.2018;2018;09;14;Torstai;88;200;288;4;18;22
96;20.09.2018;2018;09;15;Torstai;113;272;385;7;17;24
96;20.09.2018;2018;09;16;Torstai;110;162;272;6;21;27
96;20.09.2018;2018;09;17;Torstai;78;66;144;7;6;13
96;20.09.2018;2018;09;18;Torstai;57;88;145;8;9;17
96;20.09.2018;2018;09;19;Torstai;54;55;109;11;12;23
96;20.09.2018;2018;09;20;Torstai;40;20;60;9;12;21
96;20.09.2018;2018;09;21;Torstai;25;29;54;1;4;5
96;20.09.2018;2018;09;22;Torstai;17;14;31;0;0;0
96;20.09.2018;2018;09;23;Torstai;4;4;8;2;0;2
96;21.09.2018;2018;09;00;Perjantai;3;0;3;1;0;1
96;21.09.2018;2018;09;01;Perjantai;2;1;3;0;0;0
96;21.09.2018;2018;09;02;Perjantai;2;0;2;0;0;0
96;21.09.2018;2018;09;03;Perjantai;5;1;6;0;0;0
96;21.09.2018;2018;09;04;Perjantai;4;4;8;1;0;1
96;21.09.2018;2018;09;05;Perjantai;8;6;14;0;2;2
96;21.09.2018;2018;09;06;Perjantai;64;37;101;3;1;4
96;21.09.2018;2018;09;07;Perjantai;161;146;307;15;10;25
96;21.09.2018;2018;09;08;Perjantai;143;114;257;7;3;10
96;21.09.2018;2018;09;09;Perjantai;107;71;178;19;3;22
96;21.09.2018;2018;09;10;Perjantai;68;75;143;6;12;18
96;21.09.2018;2018;09;11;Perjantai;78;110;188;6;9;15
96;21.09.2018;2018;09;12;Perjantai;80;121;201;4;19;23
96;21.09.2018;2018;09;13;Perjantai;76;145;221;4;19;23
96;21.09.2018;2018;09;14;Perjantai;99;196;295;14;17;31
96;21.09.2018;2018;09;15;Perjantai;152;159;311;18;13;31
96;21.09.2018;2018;09;16;Perjantai;134;102;236;8;11;19
96;21.09.2018;2018;09;17;Perjantai;81;37;118;9;12;21
96;21.09.2018;2018;09;18;Perjantai;83;26;109;6;5;11
96;21.09.2018;2018;09;19;Perjantai;60;25;85;4;6;10
96;21.09.2018;2018;09;20;Perjantai;29;15;44;6;1;7
96;21.09.2018;2018;09;21;Perjantai;16;29;45;2;4;6
96;21.09.2018;2018;09;22;Perjantai;13;9;22;2;0;2
96;21.09.2018;2018;09;23;Perjantai;7;5;12;5;2;7
96;22.09.2018;2018;09;00;Lauantai;6;1;7;1;0;1
96;22.09.2018;2018;09;01;Lauantai;6;2;8;4;0;4
96;22.09.2018;2018;09;02;Lauantai;9;1;10;1;1;2
96;22.09.2018;2018;09;03;Lauantai;6;0;6;1;0;1
96;22.09.2018;2018;09;04;Lauantai;3;2;5;2;0;2
96;22.09.2018;2018;09;05;Lauantai;6;1;7;1;0;1
96;22.09.2018;2018;09;06;Lauantai;26;3;29;4;0;4
96;22.09.2018;2018;09;07;Lauantai;11;6;17;4;2;6
96;22.09.2018;2018;09;08;Lauantai;9;12;21;5;3;8
96;22.09.2018;2018;09;09;Lauantai;19;4;23;2;3;5
96;22.09.2018;2018;09;10;Lauantai;22;7;29;4;1;5
96;22.09.2018;2018;09;11;Lauantai;21;19;40;4;1;5
96;22.09.2018;2018;09;12;Lauantai;38;19;57;6;9;15
96;22.09.2018;2018;09;13;Lauantai;43;40;83;9;6;15
96;22.09.2018;2018;09;14;Lauantai;50;46;96;4;7;11
96;22.09.2018;2018;09;15;Lauantai;54;44;98;4;11;15
96;22.09.2018;2018;09;16;Lauantai;43;33;76;8;4;12
96;22.09.2018;2018;09;17;Lauantai;34;18;52;18;4;22
96;22.09.2018;2018;09;18;Lauantai;44;16;60;6;8;14
96;22.09.2018;2018;09;19;Lauantai;33;19;52;5;11;16
96;22.09.2018;2018;09;20;Lauantai;17;21;38;8;6;14
96;22.09.2018;2018;09;21;Lauantai;17;28;45;2;9;11
96;22.09.2018;2018;09;22;Lauantai;6;7;13;0;1;1
96;22.09.2018;2018;09;23;Lauantai;5;8;13;1;1;2
96;23.09.2018;2018;09;00;Sunnuntai;6;4;10;0;1;1
96;23.09.2018;2018;09;01;Sunnuntai;6;2;8;0;0;0
96;23.09.2018;2018;09;02;Sunnuntai;3;1;4;1;0;1
96;23.09.2018;2018;09;03;Sunnuntai;7;1;8;0;0;0
96;23.09.2018;2018;09;04;Sunnuntai;7;0;7;2;0;2
96;23.09.2018;2018;09;05;Sunnuntai;2;2;4;0;1;1
96;23.09.2018;2018;09;06;Sunnuntai;21;2;23;1;0;1
96;23.09.2018;2018;09;07;Sunnuntai;2;14;16;2;6;8
96;23.09.2018;2018;09;08;Sunnuntai;4;8;12;1;3;4
96;23.09.2018;2018;09;09;Sunnuntai;18;16;34;4;3;7
96;23.09.2018;2018;09;10;Sunnuntai;25;28;53;5;5;10
96;23.09.2018;2018;09;11;Sunnuntai;28;35;63;7;5;12
96;23.09.2018;2018;09;12;Sunnuntai;49;60;109;11;12;23
96;23.09.2018;2018;09;13;Sunnuntai;55;45;100;6;13;19
96;23.09.2018;2018;09;14;Sunnuntai;43;67;110;10;15;25
96;23.09.2018;2018;09;15;Sunnuntai;42;47;89;8;11;19
96;23.09.2018;2018;09;16;Sunnuntai;74;34;108;26;13;39
96;23.09.2018;2018;09;17;Sunnuntai;46;30;76;12;8;20
96;23.09.2018;2018;09;18;Sunnuntai;42;33;75;14;13;27
96;23.09.2018;2018;09;19;Sunnuntai;23;33;56;10;23;33
96;23.09.2018;2018;09;20;Sunnuntai;32;24;56;5;10;15
96;23.09.2018;2018;09;21;Sunnuntai;19;20;39;5;5;10
96;23.09.2018;2018;09;22;Sunnuntai;4;10;14;2;4;6
96;23.09.2018;2018;09;23;Sunnuntai;3;3;6;0;0;0
96;24.09.2018;2018;09;00;Maanantai;1;0;1;1;0;1
96;24.09.2018;2018;09;01;Maanantai;6;2;8;1;0;1
96;24.09.2018;2018;09;02;Maanantai;1;3;4;1;0;1
96;24.09.2018;2018;09;03;Maanantai;1;1;2;0;0;0
96;24.09.2018;2018;09;04;Maanantai;2;2;4;1;1;2
96;24.09.2018;2018;09;05;Maanantai;9;10;19;1;2;3
96;24.09.2018;2018;09;06;Maanantai;60;33;93;6;2;8
96;24.09.2018;2018;09;07;Maanantai;188;126;314;20;8;28
96;24.09.2018;2018;09;08;Maanantai;137;119;256;22;8;30
96;24.09.2018;2018;09;09;Maanantai;108;72;180;17;5;22
96;24.09.2018;2018;09;10;Maanantai;62;79;141;5;10;15
96;24.09.2018;2018;09;11;Maanantai;89;66;155;10;7;17
96;24.09.2018;2018;09;12;Maanantai;93;92;185;13;20;33
96;24.09.2018;2018;09;13;Maanantai;89;95;184;8;15;23
96;24.09.2018;2018;09;14;Maanantai;88;176;264;12;11;23
96;24.09.2018;2018;09;15;Maanantai;94;277;371;11;23;34
96;24.09.2018;2018;09;16;Maanantai;124;168;292;4;14;18
96;24.09.2018;2018;09;17;Maanantai;89;76;165;5;14;19
96;24.09.2018;2018;09;18;Maanantai;56;54;110;7;5;12
96;24.09.2018;2018;09;19;Maanantai;54;42;96;10;16;26
96;24.09.2018;2018;09;20;Maanantai;47;36;83;4;8;12
96;24.09.2018;2018;09;21;Maanantai;23;31;54;3;3;6
96;24.09.2018;2018;09;22;Maanantai;4;11;15;1;2;3
96;24.09.2018;2018;09;23;Maanantai;0;4;4;0;0;0
96;25.09.2018;2018;09;00;Tiistai;7;0;7;0;0;0
96;25.09.2018;2018;09;01;Tiistai;2;0;2;0;0;0
96;25.09.2018;2018;09;02;Tiistai;1;0;1;1;0;1
96;25.09.2018;2018;09;03;Tiistai;2;0;2;1;0;1
96;25.09.2018;2018;09;04;Tiistai;3;0;3;0;0;0
96;25.09.2018;2018;09;05;Tiistai;18;0;18;2;0;2
96;25.09.2018;2018;09;06;Tiistai;81;0;81;9;0;9
96;25.09.2018;2018;09;07;Tiistai;325;0;325;27;0;27
96;25.09.2018;2018;09;08;Tiistai;245;0;245;23;0;23
96;25.09.2018;2018;09;09;Tiistai;210;0;210;26;0;26
96;25.09.2018;2018;09;10;Tiistai;129;0;129;18;0;18
96;25.09.2018;2018;09;11;Tiistai;158;0;158;31;0;31
96;25.09.2018;2018;09;12;Tiistai;171;0;171;28;0;28
96;25.09.2018;2018;09;13;Tiistai;186;0;186;32;0;32
96;25.09.2018;2018;09;14;Tiistai;233;0;233;24;0;24
96;25.09.2018;2018;09;15;Tiistai;381;0;381;36;0;36
96;25.09.2018;2018;09;16;Tiistai;269;0;269;36;0;36
96;25.09.2018;2018;09;17;Tiistai;187;0;187;42;0;42
96;25.09.2018;2018;09;18;Tiistai;128;0;128;34;0;34
96;25.09.2018;2018;09;19;Tiistai;115;0;115;28;0;28
96;25.09.2018;2018;09;20;Tiistai;67;0;67;18;0;18
96;25.09.2018;2018;09;21;Tiistai;58;0;58;11;0;11
96;25.09.2018;2018;09;22;Tiistai;14;0;14;5;0;5
96;25.09.2018;2018;09;23;Tiistai;8;0;8;0;0;0
96;26.09.2018;2018;09;00;Keskiviikko;6;2;8;0;0;0
96;26.09.2018;2018;09;01;Keskiviikko;0;1;1;1;1;2
96;26.09.2018;2018;09;02;Keskiviikko;1;1;2;0;0;0
96;26.09.2018;2018;09;03;Keskiviikko;1;2;3;0;0;0
96;26.09.2018;2018;09;04;Keskiviikko;1;3;4;0;1;1
96;26.09.2018;2018;09;05;Keskiviikko;5;6;11;0;0;0
96;26.09.2018;2018;09;06;Keskiviikko;63;32;95;6;1;7
96;26.09.2018;2018;09;07;Keskiviikko;171;108;279;14;6;20
96;26.09.2018;2018;09;08;Keskiviikko;135;92;227;14;8;22
96;26.09.2018;2018;09;09;Keskiviikko;96;44;140;9;5;14
96;26.09.2018;2018;09;10;Keskiviikko;59;87;146;10;4;14
96;26.09.2018;2018;09;11;Keskiviikko;109;92;201;10;13;23
96;26.09.2018;2018;09;12;Keskiviikko;55;60;115;11;6;17
96;26.09.2018;2018;09;13;Keskiviikko;56;79;135;1;10;11
96;26.09.2018;2018;09;14;Keskiviikko;38;142;180;3;15;18
96;26.09.2018;2018;09;15;Keskiviikko;65;183;248;3;17;20
96;26.09.2018;2018;09;16;Keskiviikko;66;101;167;5;8;13
96;26.09.2018;2018;09;17;Keskiviikko;55;67;122;6;3;9
96;26.09.2018;2018;09;18;Keskiviikko;66;51;117;7;9;16
96;26.09.2018;2018;09;19;Keskiviikko;41;37;78;15;11;26
96;26.09.2018;2018;09;20;Keskiviikko;30;56;86;7;20;27
96;26.09.2018;2018;09;21;Keskiviikko;15;23;38;2;2;4
96;26.09.2018;2018;09;22;Keskiviikko;5;9;14;2;1;3
96;26.09.2018;2018;09;23;Keskiviikko;1;3;4;1;2;3
96;27.09.2018;2018;09;00;Torstai;4;2;6;0;0;0
96;27.09.2018;2018;09;01;Torstai;1;0;1;0;0;0
96;27.09.2018;2018;09;02;Torstai;5;2;7;0;0;0
96;27.09.2018;2018;09;03;Torstai;4;0;4;0;0;0
96;27.09.2018;2018;09;04;Torstai;1;4;5;0;1;1
96;27.09.2018;2018;09;05;Torstai;5;5;10;2;0;2
96;27.09.2018;2018;09;06;Torstai;50;26;76;2;3;5
96;27.09.2018;2018;09;07;Torstai;164;88;252;15;5;20
96;27.09.2018;2018;09;08;Torstai;110;100;210;10;4;14
96;27.09.2018;2018;09;09;Torstai;83;53;136;8;2;10
96;27.09.2018;2018;09;10;Torstai;47;70;117;11;15;26
96;27.09.2018;2018;09;11;Torstai;73;64;137;11;8;19
96;27.09.2018;2018;09;12;Torstai;75;79;154;23;13;36
96;27.09.2018;2018;09;13;Torstai;60;129;189;16;11;27
96;27.09.2018;2018;09;14;Torstai;62;186;248;7;20;27
96;27.09.2018;2018;09;15;Torstai;70;191;261;6;13;19
96;27.09.2018;2018;09;16;Torstai;100;122;222;6;17;23
96;27.09.2018;2018;09;17;Torstai;67;70;137;7;9;16
96;27.09.2018;2018;09;18;Torstai;49;79;128;7;5;12
96;27.09.2018;2018;09;19;Torstai;37;43;80;8;7;15
96;27.09.2018;2018;09;20;Torstai;40;31;71;9;12;21
96;27.09.2018;2018;09;21;Torstai;26;35;61;4;5;9
96;27.09.2018;2018;09;22;Torstai;18;13;31;0;1;1
96;27.09.2018;2018;09;23;Torstai;8;5;13;1;0;1
96;28.09.2018;2018;09;00;Perjantai;6;1;7;2;0;2
96;28.09.2018;2018;09;01;Perjantai;5;1;6;0;0;0
96;28.09.2018;2018;09;02;Perjantai;2;1;3;0;0;0
96;28.09.2018;2018;09;03;Perjantai;9;1;10;0;0;0
96;28.09.2018;2018;09;04;Perjantai;4;2;6;1;0;1
96;28.09.2018;2018;09;05;Perjantai;4;7;11;1;1;2
96;28.09.2018;2018;09;06;Perjantai;66;24;90;0;3;3
96;28.09.2018;2018;09;07;Perjantai;153;132;285;15;1;16
96;28.09.2018;2018;09;08;Perjantai;129;88;217;11;3;14
96;28.09.2018;2018;09;09;Perjantai;97;78;175;8;6;14
96;28.09.2018;2018;09;10;Perjantai;68;67;135;9;14;23
96;28.09.2018;2018;09;11;Perjantai;61;99;160;13;11;24
96;28.09.2018;2018;09;12;Perjantai;59;138;197;8;11;19
96;28.09.2018;2018;09;13;Perjantai;78;131;209;7;13;20
96;28.09.2018;2018;09;14;Perjantai;90;177;267;4;20;24
96;28.09.2018;2018;09;15;Perjantai;86;179;265;5;19;24
96;28.09.2018;2018;09;16;Perjantai;91;98;189;6;8;14
96;28.09.2018;2018;09;17;Perjantai;70;53;123;6;13;19
96;28.09.2018;2018;09;18;Perjantai;49;33;82;10;9;19
96;28.09.2018;2018;09;19;Perjantai;29;38;67;4;9;13
96;28.09.2018;2018;09;20;Perjantai;27;20;47;8;5;13
96;28.09.2018;2018;09;21;Perjantai;21;29;50;2;0;2
96;28.09.2018;2018;09;22;Perjantai;11;7;18;1;2;3
96;28.09.2018;2018;09;23;Perjantai;8;8;16;2;2;4
96;29.09.2018;2018;09;00;Lauantai;12;2;14;2;0;2
96;29.09.2018;2018;09;01;Lauantai;12;3;15;2;0;2
96;29.09.2018;2018;09;02;Lauantai;4;3;7;4;0;4
96;29.09.2018;2018;09;03;Lauantai;3;1;4;2;0;2
96;29.09.2018;2018;09;04;Lauantai;3;5;8;0;0;0
96;29.09.2018;2018;09;05;Lauantai;4;3;7;1;1;2
96;29.09.2018;2018;09;06;Lauantai;27;3;30;0;0;0
96;29.09.2018;2018;09;07;Lauantai;3;19;22;1;2;3
96;29.09.2018;2018;09;08;Lauantai;6;12;18;5;1;6
96;29.09.2018;2018;09;09;Lauantai;16;43;59;5;3;8
96;29.09.2018;2018;09;10;Lauantai;28;34;62;5;9;14
96;29.09.2018;2018;09;11;Lauantai;40;54;94;7;16;23
96;29.09.2018;2018;09;12;Lauantai;44;51;95;8;9;17
96;29.09.2018;2018;09;13;Lauantai;47;52;99;4;9;13
96;29.09.2018;2018;09;14;Lauantai;45;55;100;14;6;20
96;29.09.2018;2018;09;15;Lauantai;53;65;118;9;17;26
96;29.09.2018;2018;09;16;Lauantai;53;62;115;4;9;13
96;29.09.2018;2018;09;17;Lauantai;39;25;64;6;5;11
96;29.09.2018;2018;09;18;Lauantai;33;39;72;17;4;21
96;29.09.2018;2018;09;19;Lauantai;52;23;75;9;8;17
96;29.09.2018;2018;09;20;Lauantai;22;34;56;6;10;16
96;29.09.2018;2018;09;21;Lauantai;19;18;37;1;1;2
96;29.09.2018;2018;09;22;Lauantai;8;10;18;1;0;1
96;29.09.2018;2018;09;23;Lauantai;13;4;17;2;1;3
96;30.09.2018;2018;09;00;Sunnuntai;6;10;16;0;1;1
96;30.09.2018;2018;09;01;Sunnuntai;11;4;15;2;1;3
96;30.09.2018;2018;09;02;Sunnuntai;10;5;15;2;0;2
96;30.09.2018;2018;09;03;Sunnuntai;3;0;3;3;0;3
96;30.09.2018;2018;09;04;Sunnuntai;11;2;13;0;0;0
96;30.09.2018;2018;09;05;Sunnuntai;4;4;8;1;0;1
96;30.09.2018;2018;09;06;Sunnuntai;24;3;27;1;0;1
96;30.09.2018;2018;09;07;Sunnuntai;6;16;22;0;1;1
96;30.09.2018;2018;09;08;Sunnuntai;7;9;16;2;2;4
96;30.09.2018;2018;09;09;Sunnuntai;12;11;23;5;4;9
96;30.09.2018;2018;09;10;Sunnuntai;12;27;39;6;9;15
96;30.09.2018;2018;09;11;Sunnuntai;26;26;52;10;8;18
96;30.09.2018;2018;09;12;Sunnuntai;33;54;87;2;13;15
96;30.09.2018;2018;09;13;Sunnuntai;55;32;87;12;6;18
96;30.09.2018;2018;09;14;Sunnuntai;39;39;78;12;9;21
96;30.09.2018;2018;09;15;Sunnuntai;45;50;95;9;6;15
96;30.09.2018;2018;09;16;Sunnuntai;74;31;105;20;9;29
96;30.09.2018;2018;09;17;Sunnuntai;34;48;82;7;10;17
96;30.09.2018;2018;09;18;Sunnuntai;40;47;87;12;25;37
96;30.09.2018;2018;09;19;Sunnuntai;29;44;73;7;10;17
96;30.09.2018;2018;09;20;Sunnuntai;27;29;56;5;15;20
96;30.09.2018;2018;09;21;Sunnuntai;22;22;44;5;4;9
96;30.09.2018;2018;09;22;Sunnuntai;9;6;15;3;2;5
96;30.09.2018;2018;09;23;Sunnuntai;3;3;6;3;2;5