MittausID;Pvm;Vuosi;Kuukausi;Tunti;Viikonpäivä;PP_1;PP_2;PP_YHT;JK_1;JK_2;JK_YHT
293;02.11.2015;2015;11;00;Maanantai;0;0;0;0;0;0
293;02.11.2015;2015;11;01;Maanantai;0;0;0;0;0;0
293;02.11.2015;2015;11;02;Maanantai;0;0;0;0;0;0
293;02.11.2015;2015;11;03;Maanantai;0;0;0;0;0;0
293;02.11.2015;2015;11;04;Maanantai;0;0;0;0;0;0
293;02.11.2015;2015;11;05;Maanantai;4;1;5;0;0;0
293;02.11.2015;2015;11;06;Maanantai;11;2;13;1;0;1
293;02.11.2015;2015;11;07;Maanantai;65;8;73;10;0;10
293;02.11.2015;2015;11;08;Maanantai;93;14;107;8;3;11
293;02.11.2015;2015;11;09;Maanantai;61;6;67;2;1;3
293;02.11.2015;2015;11;10;Maanantai;24;12;36;5;8;13
293;02.11.2015;2015;11;11;Maanantai;17;14;31;7;4;11
293;02.11.2015;2015;11;12;Maanantai;19;20;39;3;3;6
293;02.11.2015;2015;11;13;Maanantai;13;43;56;4;9;13
293;02.11.2015;2015;11;14;Maanantai;14;83;97;4;12;16
293;02.11.2015;2015;11;15;Maanantai;18;86;104;3;8;11
293;02.11.2015;2015;11;16;Maanantai;24;20;44;6;8;14
293;02.11.2015;2015;11;17;Maanantai;13;17;30;6;5;11
293;02.11.2015;2015;11;18;Maanantai;7;14;21;10;8;18
293;02.11.2015;2015;11;19;Maanantai;11;16;27;2;9;11
293;02.11.2015;2015;11;20;Maanantai;1;8;9;3;4;7
293;02.11.2015;2015;11;21;Maanantai;1;7;8;1;0;1
293;02.11.2015;2015;11;22;Maanantai;0;1;1;1;0;1
293;02.11.2015;2015;11;23;Maanantai;0;0;0;0;0;0
293;03.11.2015;2015;11;00;Tiistai;0;0;0;0;1;1
293;03.11.2015;2015;11;01;Tiistai;1;0;1;0;0;0
293;03.11.2015;2015;11;02;Tiistai;0;0;0;0;0;0
293;03.11.2015;2015;11;03;Tiistai;0;0;0;0;0;0
293;03.11.2015;2015;11;04;Tiistai;1;0;1;0;0;0
293;03.11.2015;2015;11;05;Tiistai;5;3;8;0;0;0
293;03.11.2015;2015;11;06;Tiistai;12;2;14;2;0;2
293;03.11.2015;2015;11;07;Tiistai;99;8;107;6;1;7
293;03.11.2015;2015;11;08;Tiistai;62;2;64;6;3;9
293;03.11.2015;2015;11;09;Tiistai;36;6;42;5;3;8
293;03.11.2015;2015;11;10;Tiistai;29;9;38;2;3;5
293;03.11.2015;2015;11;11;Tiistai;13;16;29;4;3;7
293;03.11.2015;2015;11;12;Tiistai;15;15;30;10;5;15
293;03.11.2015;2015;11;13;Tiistai;10;37;47;4;6;10
293;03.11.2015;2015;11;14;Tiistai;26;95;121;9;5;14
293;03.11.2015;2015;11;15;Tiistai;17;95;112;3;12;15
293;03.11.2015;2015;11;16;Tiistai;28;27;55;3;3;6
293;03.11.2015;2015;11;17;Tiistai;16;14;30;6;5;11
293;03.11.2015;2015;11;18;Tiistai;18;17;35;6;9;15
293;03.11.2015;2015;11;19;Tiistai;8;21;29;5;10;15
293;03.11.2015;2015;11;20;Tiistai;2;19;21;3;7;10
293;03.11.2015;2015;11;21;Tiistai;0;5;5;0;2;2
293;03.11.2015;2015;11;22;Tiistai;2;2;4;0;0;0
293;03.11.2015;2015;11;23;Tiistai;0;0;0;0;0;0
293;04.11.2015;2015;11;00;Keskiviikko;0;0;0;0;0;0
293;04.11.2015;2015;11;01;Keskiviikko;0;0;0;0;0;0
293;04.11.2015;2015;11;02;Keskiviikko;0;0;0;0;0;0
293;04.11.2015;2015;11;03;Keskiviikko;0;0;0;0;0;0
293;04.11.2015;2015;11;04;Keskiviikko;0;0;0;0;0;0
293;04.11.2015;2015;11;05;Keskiviikko;5;1;6;0;0;0
293;04.11.2015;2015;11;06;Keskiviikko;7;1;8;5;1;6
293;04.11.2015;2015;11;07;Keskiviikko;116;7;123;6;1;7
293;04.11.2015;2015;11;08;Keskiviikko;64;7;71;4;2;6
293;04.11.2015;2015;11;09;Keskiviikko;32;11;43;4;2;6
293;04.11.2015;2015;11;10;Keskiviikko;22;10;32;1;1;2
293;04.11.2015;2015;11;11;Keskiviikko;14;13;27;5;3;8
293;04.11.2015;2015;11;12;Keskiviikko;11;24;35;4;8;12
293;04.11.2015;2015;11;13;Keskiviikko;9;27;36;7;5;12
293;04.11.2015;2015;11;14;Keskiviikko;22;137;159;4;12;16
293;04.11.2015;2015;11;15;Keskiviikko;20;42;62;5;1;6
293;04.11.2015;2015;11;16;Keskiviikko;24;20;44;4;5;9
293;04.11.2015;2015;11;17;Keskiviikko;14;22;36;4;9;13
293;04.11.2015;2015;11;18;Keskiviikko;12;9;21;13;10;23
293;04.11.2015;2015;11;19;Keskiviikko;4;15;19;4;4;8
293;04.11.2015;2015;11;20;Keskiviikko;6;16;22;5;2;7
293;04.11.2015;2015;11;21;Keskiviikko;1;3;4;0;0;0
293;04.11.2015;2015;11;22;Keskiviikko;0;2;2;0;0;0
293;04.11.2015;2015;11;23;Keskiviikko;0;0;0;0;0;0
293;05.11.2015;2015;11;00;Torstai;0;0;0;0;0;0
293;05.11.2015;2015;11;01;Torstai;0;0;0;0;0;0
293;05.11.2015;2015;11;02;Torstai;0;0;0;0;0;0
293;05.11.2015;2015;11;03;Torstai;0;0;0;0;0;0
293;05.11.2015;2015;11;04;Torstai;0;0;0;0;0;0
293;05.11.2015;2015;11;05;Torstai;3;1;4;0;0;0
293;05.11.2015;2015;11;06;Torstai;7;1;8;2;0;2
293;05.11.2015;2015;11;07;Torstai;67;12;79;10;2;12
293;05.11.2015;2015;11;08;Torstai;78;7;85;1;0;1
293;05.11.2015;2015;11;09;Torstai;55;11;66;2;2;4
293;05.11.2015;2015;11;10;Torstai;17;10;27;4;2;6
293;05.11.2015;2015;11;11;Torstai;11;10;21;3;4;7
293;05.11.2015;2015;11;12;Torstai;17;11;28;5;1;6
293;05.11.2015;2015;11;13;Torstai;6;37;43;4;6;10
293;05.11.2015;2015;11;14;Torstai;15;94;109;6;10;16
293;05.11.2015;2015;11;15;Torstai;12;79;91;3;9;12
293;05.11.2015;2015;11;16;Torstai;16;16;32;6;2;8
293;05.11.2015;2015;11;17;Torstai;9;12;21;15;2;17
293;05.11.2015;2015;11;18;Torstai;11;7;18;3;10;13
293;05.11.2015;2015;11;19;Torstai;7;8;15;4;6;10
293;05.11.2015;2015;11;20;Torstai;2;13;15;2;6;8
293;05.11.2015;2015;11;21;Torstai;1;10;11;0;0;0
293;05.11.2015;2015;11;22;Torstai;0;0;0;0;0;0
293;05.11.2015;2015;11;23;Torstai;0;0;0;0;0;0
293;06.11.2015;2015;11;00;Perjantai;0;0;0;0;0;0
293;06.11.2015;2015;11;01;Perjantai;0;0;0;0;0;0
293;06.11.2015;2015;11;02;Perjantai;0;0;0;0;0;0
293;06.11.2015;2015;11;03;Perjantai;0;0;0;0;0;0
293;06.11.2015;2015;11;04;Perjantai;0;1;1;0;0;0
293;06.11.2015;2015;11;05;Perjantai;1;1;2;0;0;0
293;06.11.2015;2015;11;06;Perjantai;13;2;15;1;0;1
293;06.11.2015;2015;11;07;Perjantai;93;11;104;8;0;8
293;06.11.2015;2015;11;08;Perjantai;71;6;77;5;3;8
293;06.11.2015;2015;11;09;Perjantai;31;17;48;5;1;6
293;06.11.2015;2015;11;10;Perjantai;11;8;19;1;2;3
293;06.11.2015;2015;11;11;Perjantai;14;9;23;3;1;4
293;06.11.2015;2015;11;12;Perjantai;9;35;44;9;5;14
293;06.11.2015;2015;11;13;Perjantai;12;41;53;2;7;9
293;06.11.2015;2015;11;14;Perjantai;15;74;89;9;8;17
293;06.11.2015;2015;11;15;Perjantai;20;56;76;6;2;8
293;06.11.2015;2015;11;16;Perjantai;24;21;45;3;7;10
293;06.11.2015;2015;11;17;Perjantai;12;15;27;1;4;5
293;06.11.2015;2015;11;18;Perjantai;10;14;24;4;2;6
293;06.11.2015;2015;11;19;Perjantai;3;8;11;2;5;7
293;06.11.2015;2015;11;20;Perjantai;0;11;11;2;3;5
293;06.11.2015;2015;11;21;Perjantai;0;3;3;2;0;2
293;06.11.2015;2015;11;22;Perjantai;3;0;3;0;0;0
293;06.11.2015;2015;11;23;Perjantai;0;7;7;0;3;3
293;07.11.2015;2015;11;00;Lauantai;0;1;1;0;0;0
293;07.11.2015;2015;11;01;Lauantai;2;0;2;0;1;1
293;07.11.2015;2015;11;02;Lauantai;0;1;1;0;1;1
293;07.11.2015;2015;11;03;Lauantai;0;0;0;0;0;0
293;07.11.2015;2015;11;04;Lauantai;0;0;0;0;0;0
293;07.11.2015;2015;11;05;Lauantai;1;0;1;0;0;0
293;07.11.2015;2015;11;06;Lauantai;2;0;2;0;0;0
293;07.11.2015;2015;11;07;Lauantai;4;2;6;0;0;0
293;07.11.2015;2015;11;08;Lauantai;7;5;12;1;1;2
293;07.11.2015;2015;11;09;Lauantai;4;8;12;7;4;11
293;07.11.2015;2015;11;10;Lauantai;5;11;16;0;7;7
293;07.11.2015;2015;11;11;Lauantai;14;10;24;3;6;9
293;07.11.2015;2015;11;12;Lauantai;25;16;41;7;5;12
293;07.11.2015;2015;11;13;Lauantai;17;10;27;7;3;10
293;07.11.2015;2015;11;14;Lauantai;9;16;25;7;8;15
293;07.11.2015;2015;11;15;Lauantai;15;16;31;1;1;2
293;07.11.2015;2015;11;16;Lauantai;9;4;13;6;5;11
293;07.11.2015;2015;11;17;Lauantai;10;9;19;4;5;9
293;07.11.2015;2015;11;18;Lauantai;9;2;11;7;4;11
293;07.11.2015;2015;11;19;Lauantai;4;7;11;6;4;10
293;07.11.2015;2015;11;20;Lauantai;3;8;11;1;4;5
293;07.11.2015;2015;11;21;Lauantai;4;1;5;0;0;0
293;07.11.2015;2015;11;22;Lauantai;2;9;11;1;0;1
293;07.11.2015;2015;11;23;Lauantai;3;3;6;0;2;2
293;08.11.2015;2015;11;00;Sunnuntai;1;3;4;1;1;2
293;08.11.2015;2015;11;01;Sunnuntai;0;1;1;0;1;1
293;08.11.2015;2015;11;02;Sunnuntai;0;1;1;0;0;0
293;08.11.2015;2015;11;03;Sunnuntai;0;0;0;0;1;1
293;08.11.2015;2015;11;04;Sunnuntai;0;1;1;0;1;1
293;08.11.2015;2015;11;05;Sunnuntai;0;0;0;0;0;0
293;08.11.2015;2015;11;06;Sunnuntai;2;0;2;0;0;0
293;08.11.2015;2015;11;07;Sunnuntai;0;1;1;1;1;2
293;08.11.2015;2015;11;08;Sunnuntai;2;1;3;1;1;2
293;08.11.2015;2015;11;09;Sunnuntai;12;4;16;2;3;5
293;08.11.2015;2015;11;10;Sunnuntai;8;9;17;7;5;12
293;08.11.2015;2015;11;11;Sunnuntai;12;19;31;14;7;21
293;08.11.2015;2015;11;12;Sunnuntai;8;8;16;8;8;16
293;08.11.2015;2015;11;13;Sunnuntai;13;10;23;5;8;13
293;08.11.2015;2015;11;14;Sunnuntai;14;22;36;4;6;10
293;08.11.2015;2015;11;15;Sunnuntai;11;9;20;5;6;11
293;08.11.2015;2015;11;16;Sunnuntai;8;10;18;4;7;11
293;08.11.2015;2015;11;17;Sunnuntai;3;7;10;6;7;13
293;08.11.2015;2015;11;18;Sunnuntai;7;9;16;5;3;8
293;08.11.2015;2015;11;19;Sunnuntai;8;3;11;0;2;2
293;08.11.2015;2015;11;20;Sunnuntai;2;2;4;4;4;8
293;08.11.2015;2015;11;21;Sunnuntai;2;1;3;0;1;1
293;08.11.2015;2015;11;22;Sunnuntai;0;1;1;0;0;0
293;08.11.2015;2015;11;23;Sunnuntai;0;0;0;0;0;0
293;09.11.2015;2015;11;00;Maanantai;0;0;0;0;0;0
293;09.11.2015;2015;11;01;Maanantai;0;0;0;0;0;0
293;09.11.2015;2015;11;02;Maanantai;0;0;0;0;0;0
293;09.11.2015;2015;11;03;Maanantai;0;0;0;0;0;0
293;09.11.2015;2015;11;04;Maanantai;0;0;0;0;0;0
293;09.11.2015;2015;11;05;Maanantai;5;0;5;1;1;2
293;09.11.2015;2015;11;06;Maanantai;7;2;9;2;0;2
293;09.11.2015;2015;11;07;Maanantai;68;8;76;8;0;8
293;09.11.2015;2015;11;08;Maanantai;82;8;90;3;2;5
293;09.11.2015;2015;11;09;Maanantai;50;6;56;3;2;5
293;09.11.2015;2015;11;10;Maanantai;26;8;34;4;3;7
293;09.11.2015;2015;11;11;Maanantai;13;14;27;6;4;10
293;09.11.2015;2015;11;12;Maanantai;13;20;33;8;3;11
293;09.11.2015;2015;11;13;Maanantai;10;39;49;7;10;17
293;09.11.2015;2015;11;14;Maanantai;14;77;91;11;8;19
293;09.11.2015;2015;11;15;Maanantai;16;81;97;2;6;8
293;09.11.2015;2015;11;16;Maanantai;18;21;39;5;8;13
293;09.11.2015;2015;11;17;Maanantai;6;22;28;6;7;13
293;09.11.2015;2015;11;18;Maanantai;4;7;11;4;6;10
293;09.11.2015;2015;11;19;Maanantai;6;9;15;7;2;9
293;09.11.2015;2015;11;20;Maanantai;3;5;8;0;5;5
293;09.11.2015;2015;11;21;Maanantai;0;4;4;0;3;3
293;09.11.2015;2015;11;22;Maanantai;0;0;0;0;0;0
293;09.11.2015;2015;11;23;Maanantai;0;0;0;1;0;1
293;10.11.2015;2015;11;00;Tiistai;0;0;0;0;0;0
293;10.11.2015;2015;11;01;Tiistai;1;0;1;0;0;0
293;10.11.2015;2015;11;02;Tiistai;0;0;0;0;0;0
293;10.11.2015;2015;11;03;Tiistai;0;0;0;0;0;0
293;10.11.2015;2015;11;04;Tiistai;0;0;0;0;0;0
293;10.11.2015;2015;11;05;Tiistai;0;1;1;0;0;0
293;10.11.2015;2015;11;06;Tiistai;9;3;12;2;0;2
293;10.11.2015;2015;11;07;Tiistai;71;2;73;6;0;6
293;10.11.2015;2015;11;08;Tiistai;53;5;58;4;1;5
293;10.11.2015;2015;11;09;Tiistai;35;4;39;5;3;8
293;10.11.2015;2015;11;10;Tiistai;9;3;12;5;3;8
293;10.11.2015;2015;11;11;Tiistai;4;5;9;0;2;2
293;10.11.2015;2015;11;12;Tiistai;3;5;8;1;1;2
293;10.11.2015;2015;11;13;Tiistai;7;18;25;2;2;4
293;10.11.2015;2015;11;14;Tiistai;5;58;63;1;6;7
293;10.11.2015;2015;11;15;Tiistai;3;83;86;1;9;10
293;10.11.2015;2015;11;16;Tiistai;8;11;19;2;2;4
293;10.11.2015;2015;11;17;Tiistai;5;5;10;2;3;5
293;10.11.2015;2015;11;18;Tiistai;3;7;10;2;2;4
293;10.11.2015;2015;11;19;Tiistai;6;6;12;5;6;11
293;10.11.2015;2015;11;20;Tiistai;4;13;17;3;3;6
293;10.11.2015;2015;11;21;Tiistai;1;2;3;0;4;4
293;10.11.2015;2015;11;22;Tiistai;0;2;2;0;0;0
293;10.11.2015;2015;11;23;Tiistai;0;0;0;0;0;0
293;11.11.2015;2015;11;00;Keskiviikko;0;0;0;0;0;0
293;11.11.2015;2015;11;01;Keskiviikko;0;0;0;0;0;0
293;11.11.2015;2015;11;02;Keskiviikko;0;0;0;0;0;0
293;11.11.2015;2015;11;03;Keskiviikko;0;0;0;0;0;0
293;11.11.2015;2015;11;04;Keskiviikko;0;0;0;0;0;0
293;11.11.2015;2015;11;05;Keskiviikko;1;0;1;0;0;0
293;11.11.2015;2015;11;06;Keskiviikko;9;1;10;4;0;4
293;11.11.2015;2015;11;07;Keskiviikko;90;8;98;7;1;8
293;11.11.2015;2015;11;08;Keskiviikko;60;4;64;5;0;5
293;11.11.2015;2015;11;09;Keskiviikko;17;5;22;3;0;3
293;11.11.2015;2015;11;10;Keskiviikko;12;8;20;4;0;4
293;11.11.2015;2015;11;11;Keskiviikko;5;5;10;7;4;11
293;11.11.2015;2015;11;12;Keskiviikko;9;13;22;4;5;9
293;11.11.2015;2015;11;13;Keskiviikko;11;21;32;3;2;5
293;11.11.2015;2015;11;14;Keskiviikko;13;113;126;3;10;13
293;11.11.2015;2015;11;15;Keskiviikko;27;39;66;5;5;10
293;11.11.2015;2015;11;16;Keskiviikko;20;30;50;3;8;11
293;11.11.2015;2015;11;17;Keskiviikko;8;19;27;7;5;12
293;11.11.2015;2015;11;18;Keskiviikko;5;5;10;3;11;14
293;11.11.2015;2015;11;19;Keskiviikko;5;9;14;9;10;19
293;11.11.2015;2015;11;20;Keskiviikko;2;5;7;3;0;3
293;11.11.2015;2015;11;21;Keskiviikko;3;5;8;0;0;0
293;11.11.2015;2015;11;22;Keskiviikko;0;1;1;0;0;0
293;11.11.2015;2015;11;23;Keskiviikko;0;0;0;0;0;0
293;12.11.2015;2015;11;00;Torstai;0;0;0;0;0;0
293;12.11.2015;2015;11;01;Torstai;0;0;0;0;0;0
293;12.11.2015;2015;11;02;Torstai;0;0;0;0;0;0
293;12.11.2015;2015;11;03;Torstai;0;0;0;0;0;0
293;12.11.2015;2015;11;04;Torstai;0;0;0;0;0;0
293;12.11.2015;2015;11;05;Torstai;3;0;3;1;0;1
293;12.11.2015;2015;11;06;Torstai;9;1;10;1;1;2
293;12.11.2015;2015;11;07;Torstai;73;7;80;4;1;5
293;12.11.2015;2015;11;08;Torstai;66;5;71;4;0;4
293;12.11.2015;2015;11;09;Torstai;45;10;55;4;1;5
293;12.11.2015;2015;11;10;Torstai;19;6;25;2;4;6
293;12.11.2015;2015;11;11;Torstai;5;11;16;5;1;6
293;12.11.2015;2015;11;12;Torstai;11;10;21;5;4;9
293;12.11.2015;2015;11;13;Torstai;10;33;43;3;6;9
293;12.11.2015;2015;11;14;Torstai;11;82;93;4;8;12
293;12.11.2015;2015;11;15;Torstai;6;65;71;4;10;14
293;12.11.2015;2015;11;16;Torstai;12;9;21;1;3;4
293;12.11.2015;2015;11;17;Torstai;16;11;27;4;5;9
293;12.11.2015;2015;11;18;Torstai;4;4;8;2;2;4
293;12.11.2015;2015;11;19;Torstai;3;9;12;4;6;10
293;12.11.2015;2015;11;20;Torstai;0;6;6;1;2;3
293;12.11.2015;2015;11;21;Torstai;1;4;5;1;1;2
293;12.11.2015;2015;11;22;Torstai;0;2;2;1;1;2
293;12.11.2015;2015;11;23;Torstai;0;0;0;0;0;0
293;13.11.2015;2015;11;00;Perjantai;0;0;0;0;0;0
293;13.11.2015;2015;11;01;Perjantai;0;0;0;0;0;0
293;13.11.2015;2015;11;02;Perjantai;0;0;0;0;0;0
293;13.11.2015;2015;11;03;Perjantai;0;1;1;0;0;0
293;13.11.2015;2015;11;04;Perjantai;0;0;0;0;0;0
293;13.11.2015;2015;11;05;Perjantai;3;2;5;1;0;1
293;13.11.2015;2015;11;06;Perjantai;8;1;9;2;1;3
293;13.11.2015;2015;11;07;Perjantai;86;4;90;7;0;7
293;13.11.2015;2015;11;08;Perjantai;76;7;83;4;1;5
293;13.11.2015;2015;11;09;Perjantai;28;3;31;6;3;9
293;13.11.2015;2015;11;10;Perjantai;9;6;15;3;0;3
293;13.11.2015;2015;11;11;Perjantai;9;9;18;2;3;5
293;13.11.2015;2015;11;12;Perjantai;8;35;43;6;7;13
293;13.11.2015;2015;11;13;Perjantai;19;60;79;4;6;10
293;13.11.2015;2015;11;14;Perjantai;10;66;76;2;4;6
293;13.11.2015;2015;11;15;Perjantai;10;49;59;1;4;5
293;13.11.2015;2015;11;16;Perjantai;19;14;33;1;4;5
293;13.11.2015;2015;11;17;Perjantai;5;18;23;6;5;11
293;13.11.2015;2015;11;18;Perjantai;10;12;22;4;2;6
293;13.11.2015;2015;11;19;Perjantai;9;5;14;1;3;4
293;13.11.2015;2015;11;20;Perjantai;3;7;10;4;3;7
293;13.11.2015;2015;11;21;Perjantai;1;6;7;1;2;3
293;13.11.2015;2015;11;22;Perjantai;1;2;3;2;0;2
293;13.11.2015;2015;11;23;Perjantai;0;4;4;2;1;3
293;14.11.2015;2015;11;00;Lauantai;1;1;2;0;0;0
293;14.11.2015;2015;11;01;Lauantai;0;0;0;0;0;0
293;14.11.2015;2015;11;02;Lauantai;0;1;1;0;1;1
293;14.11.2015;2015;11;03;Lauantai;0;0;0;0;0;0
293;14.11.2015;2015;11;04;Lauantai;0;1;1;1;1;2
293;14.11.2015;2015;11;05;Lauantai;0;0;0;0;0;0
293;14.11.2015;2015;11;06;Lauantai;1;1;2;1;0;1
293;14.11.2015;2015;11;07;Lauantai;1;1;2;0;1;1
293;14.11.2015;2015;11;08;Lauantai;6;0;6;1;2;3
293;14.11.2015;2015;11;09;Lauantai;4;4;8;1;0;1
293;14.11.2015;2015;11;10;Lauantai;11;9;20;8;7;15
293;14.11.2015;2015;11;11;Lauantai;9;4;13;8;26;34
293;14.11.2015;2015;11;12;Lauantai;11;11;22;2;5;7
293;14.11.2015;2015;11;13;Lauantai;10;8;18;3;5;8
293;14.11.2015;2015;11;14;Lauantai;5;10;15;1;0;1
293;14.11.2015;2015;11;15;Lauantai;4;3;7;4;1;5
293;14.11.2015;2015;11;16;Lauantai;7;10;17;3;4;7
293;14.11.2015;2015;11;17;Lauantai;9;12;21;1;4;5
293;14.11.2015;2015;11;18;Lauantai;1;2;3;0;0;0
293;14.11.2015;2015;11;19;Lauantai;1;6;7;1;3;4
293;14.11.2015;2015;11;20;Lauantai;0;4;4;0;0;0
293;14.11.2015;2015;11;21;Lauantai;1;1;2;0;0;0
293;14.11.2015;2015;11;22;Lauantai;9;5;14;0;2;2
293;14.11.2015;2015;11;23;Lauantai;0;1;1;0;1;1
293;15.11.2015;2015;11;00;Sunnuntai;2;1;3;1;0;1
293;15.11.2015;2015;11;01;Sunnuntai;0;1;1;0;4;4
293;15.11.2015;2015;11;02;Sunnuntai;1;0;1;0;0;0
293;15.11.2015;2015;11;03;Sunnuntai;0;2;2;0;4;4
293;15.11.2015;2015;11;04;Sunnuntai;0;0;0;0;0;0
293;15.11.2015;2015;11;05;Sunnuntai;0;0;0;0;0;0
293;15.11.2015;2015;11;06;Sunnuntai;2;1;3;0;0;0
293;15.11.2015;2015;11;07;Sunnuntai;0;0;0;0;0;0
293;15.11.2015;2015;11;08;Sunnuntai;5;0;5;2;0;2
293;15.11.2015;2015;11;09;Sunnuntai;7;3;10;3;0;3
293;15.11.2015;2015;11;10;Sunnuntai;3;7;10;4;2;6
293;15.11.2015;2015;11;11;Sunnuntai;7;3;10;6;5;11
293;15.11.2015;2015;11;12;Sunnuntai;10;9;19;6;7;13
293;15.11.2015;2015;11;13;Sunnuntai;14;12;26;4;3;7
293;15.11.2015;2015;11;14;Sunnuntai;7;10;17;3;5;8
293;15.11.2015;2015;11;15;Sunnuntai;11;9;20;3;4;7
293;15.11.2015;2015;11;16;Sunnuntai;10;12;22;3;2;5
293;15.11.2015;2015;11;17;Sunnuntai;14;9;23;6;9;15
293;15.11.2015;2015;11;18;Sunnuntai;4;6;10;1;2;3
293;15.11.2015;2015;11;19;Sunnuntai;3;3;6;5;4;9
293;15.11.2015;2015;11;20;Sunnuntai;1;6;7;0;0;0
293;15.11.2015;2015;11;21;Sunnuntai;1;1;2;0;1;1
293;15.11.2015;2015;11;22;Sunnuntai;0;0;0;0;0;0
293;15.11.2015;2015;11;23;Sunnuntai;0;0;0;0;0;0
293;16.11.2015;2015;11;00;Maanantai;0;0;0;0;0;0
293;16.11.2015;2015;11;01;Maanantai;0;0;0;0;0;0
293;16.11.2015;2015;11;02;Maanantai;0;0;0;0;1;1
293;16.11.2015;2015;11;03;Maanantai;0;0;0;0;0;0
293;16.11.2015;2015;11;04;Maanantai;0;0;0;0;0;0
293;16.11.2015;2015;11;05;Maanantai;2;2;4;0;1;1
293;16.11.2015;2015;11;06;Maanantai;11;1;12;3;2;5
293;16.11.2015;2015;11;07;Maanantai;59;2;61;11;1;12
293;16.11.2015;2015;11;08;Maanantai;73;9;82;5;3;8
293;16.11.2015;2015;11;09;Maanantai;59;4;63;6;0;6
293;16.11.2015;2015;11;10;Maanantai;19;10;29;5;6;11
293;16.11.2015;2015;11;11;Maanantai;14;15;29;1;4;5
293;16.11.2015;2015;11;12;Maanantai;16;11;27;5;2;7
293;16.11.2015;2015;11;13;Maanantai;2;39;41;6;5;11
293;16.11.2015;2015;11;14;Maanantai;9;68;77;4;9;13
293;16.11.2015;2015;11;15;Maanantai;9;77;86;2;8;10
293;16.11.2015;2015;11;16;Maanantai;15;13;28;6;7;13
293;16.11.2015;2015;11;17;Maanantai;9;9;18;5;7;12
293;16.11.2015;2015;11;18;Maanantai;9;14;23;3;5;8
293;16.11.2015;2015;11;19;Maanantai;4;12;16;5;4;9
293;16.11.2015;2015;11;20;Maanantai;4;2;6;1;4;5
293;16.11.2015;2015;11;21;Maanantai;0;2;2;1;1;2
293;16.11.2015;2015;11;22;Maanantai;0;2;2;0;0;0
293;16.11.2015;2015;11;23;Maanantai;0;0;0;0;0;0
293;17.11.2015;2015;11;00;Tiistai;0;0;0;0;0;0
293;17.11.2015;2015;11;01;Tiistai;0;0;0;0;0;0
293;17.11.2015;2015;11;02;Tiistai;0;0;0;0;0;0
293;17.11.2015;2015;11;03;Tiistai;0;0;0;0;0;0
293;17.11.2015;2015;11;04;Tiistai;0;0;0;0;0;0
293;17.11.2015;2015;11;05;Tiistai;4;1;5;1;0;1
293;17.11.2015;2015;11;06;Tiistai;9;1;10;6;2;8
293;17.11.2015;2015;11;07;Tiistai;81;3;84;8;0;8
293;17.11.2015;2015;11;08;Tiistai;68;11;79;4;1;5
293;17.11.2015;2015;11;09;Tiistai;35;10;45;1;2;3
293;17.11.2015;2015;11;10;Tiistai;23;6;29;5;6;11
293;17.11.2015;2015;11;11;Tiistai;5;14;19;2;1;3
293;17.11.2015;2015;11;12;Tiistai;7;7;14;2;2;4
293;17.11.2015;2015;11;13;Tiistai;6;20;26;2;3;5
293;17.11.2015;2015;11;14;Tiistai;10;73;83;5;10;15
293;17.11.2015;2015;11;15;Tiistai;3;81;84;2;5;7
293;17.11.2015;2015;11;16;Tiistai;11;19;30;4;5;9
293;17.11.2015;2015;11;17;Tiistai;9;9;18;3;3;6
293;17.11.2015;2015;11;18;Tiistai;10;8;18;1;6;7
293;17.11.2015;2015;11;19;Tiistai;4;7;11;2;1;3
293;17.11.2015;2015;11;20;Tiistai;2;11;13;1;1;2
293;17.11.2015;2015;11;21;Tiistai;1;4;5;0;0;0
293;17.11.2015;2015;11;22;Tiistai;0;2;2;0;0;0
293;17.11.2015;2015;11;23;Tiistai;0;1;1;0;0;0
293;18.11.2015;2015;11;00;Keskiviikko;1;0;1;0;0;0
293;18.11.2015;2015;11;01;Keskiviikko;0;0;0;0;0;0
293;18.11.2015;2015;11;02;Keskiviikko;0;0;0;0;0;0
293;18.11.2015;2015;11;03;Keskiviikko;0;0;0;0;0;0
293;18.11.2015;2015;11;04;Keskiviikko;0;0;0;0;0;0
293;18.11.2015;2015;11;05;Keskiviikko;1;2;3;1;0;1
293;18.11.2015;2015;11;06;Keskiviikko;11;2;13;3;1;4
293;18.11.2015;2015;11;07;Keskiviikko;113;6;119;12;0;12
293;18.11.2015;2015;11;08;Keskiviikko;64;9;73;12;11;23
293;18.11.2015;2015;11;09;Keskiviikko;24;6;30;5;2;7
293;18.11.2015;2015;11;10;Keskiviikko;10;7;17;2;3;5
293;18.11.2015;2015;11;11;Keskiviikko;14;4;18;7;3;10
293;18.11.2015;2015;11;12;Keskiviikko;5;43;48;9;10;19
293;18.11.2015;2015;11;13;Keskiviikko;19;14;33;3;8;11
293;18.11.2015;2015;11;14;Keskiviikko;11;116;127;5;6;11
293;18.11.2015;2015;11;15;Keskiviikko;24;29;53;17;11;28
293;18.11.2015;2015;11;16;Keskiviikko;13;26;39;3;5;8
293;18.11.2015;2015;11;17;Keskiviikko;12;26;38;5;8;13
293;18.11.2015;2015;11;18;Keskiviikko;15;4;19;13;10;23
293;18.11.2015;2015;11;19;Keskiviikko;6;9;15;8;5;13
293;18.11.2015;2015;11;20;Keskiviikko;3;12;15;4;7;11
293;18.11.2015;2015;11;21;Keskiviikko;1;4;5;1;0;1
293;18.11.2015;2015;11;22;Keskiviikko;0;2;2;0;0;0
293;18.11.2015;2015;11;23;Keskiviikko;1;0;1;0;0;0
293;19.11.2015;2015;11;00;Torstai;0;0;0;0;0;0
293;19.11.2015;2015;11;01;Torstai;0;0;0;0;0;0
293;19.11.2015;2015;11;02;Torstai;0;1;1;0;0;0
293;19.11.2015;2015;11;03;Torstai;0;0;0;0;0;0
293;19.11.2015;2015;11;04;Torstai;0;1;1;0;0;0
293;19.11.2015;2015;11;05;Torstai;1;0;1;0;0;0
293;19.11.2015;2015;11;06;Torstai;12;3;15;3;0;3
293;19.11.2015;2015;11;07;Torstai;77;6;83;7;0;7
293;19.11.2015;2015;11;08;Torstai;61;5;66;4;1;5
293;19.11.2015;2015;11;09;Torstai;53;6;59;5;2;7
293;19.11.2015;2015;11;10;Torstai;21;9;30;1;3;4
293;19.11.2015;2015;11;11;Torstai;10;11;21;3;5;8
293;19.11.2015;2015;11;12;Torstai;7;12;19;8;4;12
293;19.11.2015;2015;11;13;Torstai;6;34;40;2;4;6
293;19.11.2015;2015;11;14;Torstai;11;83;94;3;8;11
293;19.11.2015;2015;11;15;Torstai;13;87;100;8;8;16
293;19.11.2015;2015;11;16;Torstai;10;15;25;2;5;7
293;19.11.2015;2015;11;17;Torstai;7;12;19;6;3;9
293;19.11.2015;2015;11;18;Torstai;10;6;16;6;5;11
293;19.11.2015;2015;11;19;Torstai;4;8;12;4;4;8
293;19.11.2015;2015;11;20;Torstai;6;6;12;1;6;7
293;19.11.2015;2015;11;21;Torstai;1;1;2;0;4;4
293;19.11.2015;2015;11;22;Torstai;0;1;1;0;0;0
293;19.11.2015;2015;11;23;Torstai;0;0;0;0;0;0
293;20.11.2015;2015;11;00;Perjantai;0;2;2;0;0;0
293;20.11.2015;2015;11;01;Perjantai;0;0;0;0;0;0
293;20.11.2015;2015;11;02;Perjantai;0;0;0;0;0;0
293;20.11.2015;2015;11;03;Perjantai;0;1;1;0;0;0
293;20.11.2015;2015;11;04;Perjantai;0;0;0;0;0;0
293;20.11.2015;2015;11;05;Perjantai;3;1;4;1;1;2
293;20.11.2015;2015;11;06;Perjantai;6;1;7;2;1;3
293;20.11.2015;2015;11;07;Perjantai;89;9;98;5;2;7
293;20.11.2015;2015;11;08;Perjantai;75;7;82;2;1;3
293;20.11.2015;2015;11;09;Perjantai;30;6;36;6;1;7
293;20.11.2015;2015;11;10;Perjantai;9;4;13;4;2;6
293;20.11.2015;2015;11;11;Perjantai;11;6;17;4;2;6
293;20.11.2015;2015;11;12;Perjantai;7;37;44;6;6;12
293;20.11.2015;2015;11;13;Perjantai;7;35;42;5;9;14
293;20.11.2015;2015;11;14;Perjantai;8;74;82;4;4;8
293;20.11.2015;2015;11;15;Perjantai;9;42;51;1;7;8
293;20.11.2015;2015;11;16;Perjantai;36;7;43;5;1;6
293;20.11.2015;2015;11;17;Perjantai;44;12;56;14;10;24
293;20.11.2015;2015;11;18;Perjantai;30;8;38;26;10;36
293;20.11.2015;2015;11;19;Perjantai;12;67;79;4;22;26
293;20.11.2015;2015;11;20;Perjantai;4;22;26;0;4;4
293;20.11.2015;2015;11;21;Perjantai;3;12;15;2;0;2
293;20.11.2015;2015;11;22;Perjantai;4;3;7;0;1;1
293;20.11.2015;2015;11;23;Perjantai;1;4;5;2;2;4
293;21.11.2015;2015;11;00;Lauantai;1;0;1;0;0;0
293;21.11.2015;2015;11;01;Lauantai;0;6;6;0;0;0
293;21.11.2015;2015;11;02;Lauantai;1;0;1;0;0;0
293;21.11.2015;2015;11;03;Lauantai;0;0;0;0;0;0
293;21.11.2015;2015;11;04;Lauantai;1;0;1;0;0;0
293;21.11.2015;2015;11;05;Lauantai;3;0;3;0;0;0
293;21.11.2015;2015;11;06;Lauantai;2;0;2;1;1;2
293;21.11.2015;2015;11;07;Lauantai;1;0;1;0;0;0
293;21.11.2015;2015;11;08;Lauantai;3;0;3;2;1;3
293;21.11.2015;2015;11;09;Lauantai;9;5;14;4;3;7
293;21.11.2015;2015;11;10;Lauantai;9;4;13;5;1;6
293;21.11.2015;2015;11;11;Lauantai;9;7;16;6;6;12
293;21.11.2015;2015;11;12;Lauantai;9;10;19;2;3;5
293;21.11.2015;2015;11;13;Lauantai;8;6;14;3;10;13
293;21.11.2015;2015;11;14;Lauantai;13;8;21;5;7;12
293;21.11.2015;2015;11;15;Lauantai;11;10;21;6;5;11
293;21.11.2015;2015;11;16;Lauantai;8;13;21;4;4;8
293;21.11.2015;2015;11;17;Lauantai;3;9;12;7;3;10
293;21.11.2015;2015;11;18;Lauantai;7;14;21;2;2;4
293;21.11.2015;2015;11;19;Lauantai;2;4;6;1;2;3
293;21.11.2015;2015;11;20;Lauantai;4;7;11;1;0;1
293;21.11.2015;2015;11;21;Lauantai;7;5;12;2;2;4
293;21.11.2015;2015;11;22;Lauantai;5;1;6;0;0;0
293;21.11.2015;2015;11;23;Lauantai;1;5;6;1;0;1
293;22.11.2015;2015;11;00;Sunnuntai;0;2;2;0;1;1
293;22.11.2015;2015;11;01;Sunnuntai;3;0;3;0;1;1
293;22.11.2015;2015;11;02;Sunnuntai;0;0;0;0;3;3
293;22.11.2015;2015;11;03;Sunnuntai;0;0;0;0;1;1
293;22.11.2015;2015;11;04;Sunnuntai;0;0;0;0;0;0
293;22.11.2015;2015;11;05;Sunnuntai;0;0;0;0;0;0
293;22.11.2015;2015;11;06;Sunnuntai;0;0;0;0;0;0
293;22.11.2015;2015;11;07;Sunnuntai;0;0;0;0;1;1
293;22.11.2015;2015;11;08;Sunnuntai;0;0;0;2;2;4
293;22.11.2015;2015;11;09;Sunnuntai;5;1;6;3;2;5
293;22.11.2015;2015;11;10;Sunnuntai;2;1;3;2;4;6
293;22.11.2015;2015;11;11;Sunnuntai;4;1;5;5;2;7
293;22.11.2015;2015;11;12;Sunnuntai;8;9;17;5;3;8
293;22.11.2015;2015;11;13;Sunnuntai;6;5;11;5;2;7
293;22.11.2015;2015;11;14;Sunnuntai;1;5;6;11;7;18
293;22.11.2015;2015;11;15;Sunnuntai;8;4;12;4;2;6
293;22.11.2015;2015;11;16;Sunnuntai;12;11;23;3;5;8
293;22.11.2015;2015;11;17;Sunnuntai;4;2;6;4;7;11
293;22.11.2015;2015;11;18;Sunnuntai;8;6;14;5;3;8
293;22.11.2015;2015;11;19;Sunnuntai;5;6;11;2;2;4
293;22.11.2015;2015;11;20;Sunnuntai;1;1;2;0;0;0
293;22.11.2015;2015;11;21;Sunnuntai;1;2;3;0;0;0
293;22.11.2015;2015;11;22;Sunnuntai;0;2;2;0;0;0
293;22.11.2015;2015;11;23;Sunnuntai;0;0;0;0;0;0
293;23.11.2015;2015;11;00;Maanantai;0;1;1;0;0;0
293;23.11.2015;2015;11;01;Maanantai;0;0;0;0;0;0
293;23.11.2015;2015;11;02;Maanantai;0;0;0;0;0;0
293;23.11.2015;2015;11;03;Maanantai;0;0;0;0;0;0
293;23.11.2015;2015;11;04;Maanantai;0;0;0;0;1;1
293;23.11.2015;2015;11;05;Maanantai;4;0;4;0;0;0
293;23.11.2015;2015;11;06;Maanantai;5;4;9;3;0;3
293;23.11.2015;2015;11;07;Maanantai;40;9;49;10;3;13
293;23.11.2015;2015;11;08;Maanantai;109;5;114;9;2;11
293;23.11.2015;2015;11;09;Maanantai;40;1;41;4;2;6
293;23.11.2015;2015;11;10;Maanantai;20;14;34;3;3;6
293;23.11.2015;2015;11;11;Maanantai;7;22;29;2;5;7
293;23.11.2015;2015;11;12;Maanantai;8;13;21;10;6;16
293;23.11.2015;2015;11;13;Maanantai;6;38;44;3;12;15
293;23.11.2015;2015;11;14;Maanantai;6;57;63;2;7;9
293;23.11.2015;2015;11;15;Maanantai;10;65;75;4;12;16
293;23.11.2015;2015;11;16;Maanantai;17;12;29;6;8;14
293;23.11.2015;2015;11;17;Maanantai;10;22;32;9;5;14
293;23.11.2015;2015;11;18;Maanantai;7;8;15;7;14;21
293;23.11.2015;2015;11;19;Maanantai;4;5;9;6;5;11
293;23.11.2015;2015;11;20;Maanantai;3;10;13;2;3;5
293;23.11.2015;2015;11;21;Maanantai;2;3;5;0;1;1
293;23.11.2015;2015;11;22;Maanantai;0;1;1;0;0;0
293;23.11.2015;2015;11;23;Maanantai;0;2;2;0;0;0
293;24.11.2015;2015;11;00;Tiistai;0;0;0;0;0;0
293;24.11.2015;2015;11;01;Tiistai;0;1;1;0;0;0
293;24.11.2015;2015;11;02;Tiistai;0;0;0;0;0;0
293;24.11.2015;2015;11;03;Tiistai;0;0;0;0;0;0
293;24.11.2015;2015;11;04;Tiistai;0;0;0;0;0;0
293;24.11.2015;2015;11;05;Tiistai;2;3;5;1;1;2
293;24.11.2015;2015;11;06;Tiistai;9;4;13;4;2;6
293;24.11.2015;2015;11;07;Tiistai;63;3;66;10;1;11
293;24.11.2015;2015;11;08;Tiistai;92;4;96;10;2;12
293;24.11.2015;2015;11;09;Tiistai;32;4;36;7;4;11
293;24.11.2015;2015;11;10;Tiistai;12;14;26;1;3;4
293;24.11.2015;2015;11;11;Tiistai;4;23;27;5;3;8
293;24.11.2015;2015;11;12;Tiistai;4;5;9;4;12;16
293;24.11.2015;2015;11;13;Tiistai;5;32;37;6;9;15
293;24.11.2015;2015;11;14;Tiistai;8;58;66;2;8;10
293;24.11.2015;2015;11;15;Tiistai;9;70;79;2;8;10
293;24.11.2015;2015;11;16;Tiistai;8;11;19;9;10;19
293;24.11.2015;2015;11;17;Tiistai;8;19;27;2;7;9
293;24.11.2015;2015;11;18;Tiistai;9;6;15;8;9;17
293;24.11.2015;2015;11;19;Tiistai;9;9;18;6;6;12
293;24.11.2015;2015;11;20;Tiistai;3;2;5;1;3;4
293;24.11.2015;2015;11;21;Tiistai;1;2;3;1;2;3
293;24.11.2015;2015;11;22;Tiistai;0;2;2;0;0;0
293;24.11.2015;2015;11;23;Tiistai;0;0;0;0;0;0
293;25.11.2015;2015;11;00;Keskiviikko;0;0;0;0;0;0
293;25.11.2015;2015;11;01;Keskiviikko;0;0;0;0;0;0
293;25.11.2015;2015;11;02;Keskiviikko;0;0;0;0;0;0
293;25.11.2015;2015;11;03;Keskiviikko;0;0;0;0;0;0
293;25.11.2015;2015;11;04;Keskiviikko;0;0;0;0;0;0
293;25.11.2015;2015;11;05;Keskiviikko;0;2;2;1;0;1
293;25.11.2015;2015;11;06;Keskiviikko;7;4;11;0;2;2
293;25.11.2015;2015;11;07;Keskiviikko;67;4;71;6;1;7
293;25.11.2015;2015;11;08;Keskiviikko;103;3;106;5;1;6
293;25.11.2015;2015;11;09;Keskiviikko;14;2;16;3;1;4
293;25.11.2015;2015;11;10;Keskiviikko;15;9;24;1;2;3
293;25.11.2015;2015;11;11;Keskiviikko;2;13;15;3;2;5
293;25.11.2015;2015;11;12;Keskiviikko;1;22;23;0;3;3
293;25.11.2015;2015;11;13;Keskiviikko;6;24;30;0;2;2
293;25.11.2015;2015;11;14;Keskiviikko;3;87;90;1;6;7
293;25.11.2015;2015;11;15;Keskiviikko;16;17;33;2;6;8
293;25.11.2015;2015;11;16;Keskiviikko;8;14;22;4;7;11
293;25.11.2015;2015;11;17;Keskiviikko;8;12;20;4;6;10
293;25.11.2015;2015;11;18;Keskiviikko;6;8;14;0;4;4
293;25.11.2015;2015;11;19;Keskiviikko;7;6;13;1;2;3
293;25.11.2015;2015;11;20;Keskiviikko;2;7;9;2;3;5
293;25.11.2015;2015;11;21;Keskiviikko;0;2;2;0;0;0
293;25.11.2015;2015;11;22;Keskiviikko;0;1;1;0;0;0
293;25.11.2015;2015;11;23;Keskiviikko;0;0;0;0;0;0
293;26.11.2015;2015;11;00;Torstai;0;0;0;0;0;0
293;26.11.2015;2015;11;01;Torstai;0;0;0;0;0;0
293;26.11.2015;2015;11;02;Torstai;0;0;0;0;0;0
293;26.11.2015;2015;11;03;Torstai;0;0;0;0;0;0
293;26.11.2015;2015;11;04;Torstai;0;0;0;0;0;0
293;26.11.2015;2015;11;05;Torstai;0;1;1;2;1;3
293;26.11.2015;2015;11;06;Torstai;7;2;9;1;2;3
293;26.11.2015;2015;11;07;Torstai;58;9;67;5;1;6
293;26.11.2015;2015;11;08;Torstai;88;3;91;10;1;11
293;26.11.2015;2015;11;09;Torstai;27;8;35;4;0;4
293;26.11.2015;2015;11;10;Torstai;17;17;34;3;3;6
293;26.11.2015;2015;11;11;Torstai;5;14;19;5;6;11
293;26.11.2015;2015;11;12;Torstai;13;13;26;5;9;14
293;26.11.2015;2015;11;13;Torstai;14;37;51;7;9;16
293;26.11.2015;2015;11;14;Torstai;10;79;89;2;7;9
293;26.11.2015;2015;11;15;Torstai;13;57;70;1;6;7
293;26.11.2015;2015;11;16;Torstai;12;13;25;5;4;9
293;26.11.2015;2015;11;17;Torstai;15;9;24;4;3;7
293;26.11.2015;2015;11;18;Torstai;7;15;22;7;15;22
293;26.11.2015;2015;11;19;Torstai;3;4;7;2;1;3
293;26.11.2015;2015;11;20;Torstai;1;5;6;1;1;2
293;26.11.2015;2015;11;21;Torstai;1;4;5;1;2;3
293;26.11.2015;2015;11;22;Torstai;1;2;3;0;0;0
293;26.11.2015;2015;11;23;Torstai;0;0;0;0;0;0
293;27.11.2015;2015;11;00;Perjantai;0;0;0;2;0;2
293;27.11.2015;2015;11;01;Perjantai;0;0;0;0;0;0
293;27.11.2015;2015;11;02;Perjantai;0;1;1;0;0;0
293;27.11.2015;2015;11;03;Perjantai;0;1;1;0;0;0
293;27.11.2015;2015;11;04;Perjantai;0;1;1;0;0;0
293;27.11.2015;2015;11;05;Perjantai;0;0;0;0;0;0
293;27.11.2015;2015;11;06;Perjantai;4;1;5;0;2;2
293;27.11.2015;2015;11;07;Perjantai;52;4;56;3;1;4
293;27.11.2015;2015;11;08;Perjantai;90;9;99;4;1;5
293;27.11.2015;2015;11;09;Perjantai;19;2;21;2;3;5
293;27.11.2015;2015;11;10;Perjantai;14;9;23;4;0;4
293;27.11.2015;2015;11;11;Perjantai;4;19;23;4;1;5
293;27.11.2015;2015;11;12;Perjantai;8;20;28;2;6;8
293;27.11.2015;2015;11;13;Perjantai;8;41;49;4;9;13
293;27.11.2015;2015;11;14;Perjantai;8;55;63;4;1;5
293;27.11.2015;2015;11;15;Perjantai;8;36;44;4;1;5
293;27.11.2015;2015;11;16;Perjantai;10;6;16;2;4;6
293;27.11.2015;2015;11;17;Perjantai;12;11;23;2;3;5
293;27.11.2015;2015;11;18;Perjantai;10;8;18;5;4;9
293;27.11.2015;2015;11;19;Perjantai;0;4;4;4;3;7
293;27.11.2015;2015;11;20;Perjantai;4;11;15;1;6;7
293;27.11.2015;2015;11;21;Perjantai;5;1;6;4;1;5
293;27.11.2015;2015;11;22;Perjantai;2;1;3;0;1;1
293;27.11.2015;2015;11;23;Perjantai;2;4;6;0;3;3
293;28.11.2015;2015;11;00;Lauantai;4;2;6;0;1;1
293;28.11.2015;2015;11;01;Lauantai;0;0;0;0;0;0
293;28.11.2015;2015;11;02;Lauantai;0;0;0;0;0;0
293;28.11.2015;2015;11;03;Lauantai;0;0;0;0;1;1
293;28.11.2015;2015;11;04;Lauantai;0;0;0;0;1;1
293;28.11.2015;2015;11;05;Lauantai;0;0;0;0;0;0
293;28.11.2015;2015;11;06;Lauantai;1;0;1;0;0;0
293;28.11.2015;2015;11;07;Lauantai;2;1;3;1;1;2
293;28.11.2015;2015;11;08;Lauantai;4;0;4;2;1;3
293;28.11.2015;2015;11;09;Lauantai;5;4;9;2;1;3
293;28.11.2015;2015;11;10;Lauantai;4;3;7;1;0;1
293;28.11.2015;2015;11;11;Lauantai;7;9;16;3;1;4
293;28.11.2015;2015;11;12;Lauantai;3;9;12;2;3;5
293;28.11.2015;2015;11;13;Lauantai;7;6;13;4;3;7
293;28.11.2015;2015;11;14;Lauantai;5;7;12;2;2;4
293;28.11.2015;2015;11;15;Lauantai;4;4;8;0;1;1
293;28.11.2015;2015;11;16;Lauantai;8;6;14;3;1;4
293;28.11.2015;2015;11;17;Lauantai;2;8;10;5;4;9
293;28.11.2015;2015;11;18;Lauantai;1;8;9;0;3;3
293;28.11.2015;2015;11;19;Lauantai;0;4;4;0;1;1
293;28.11.2015;2015;11;20;Lauantai;7;3;10;0;0;0
293;28.11.2015;2015;11;21;Lauantai;1;0;1;0;0;0
293;28.11.2015;2015;11;22;Lauantai;1;2;3;1;1;2
293;28.11.2015;2015;11;23;Lauantai;0;0;0;0;0;0
293;29.11.2015;2015;11;00;Sunnuntai;2;1;3;0;0;0
293;29.11.2015;2015;11;01;Sunnuntai;0;0;0;0;1;1
293;29.11.2015;2015;11;02;Sunnuntai;0;0;0;0;0;0
293;29.11.2015;2015;11;03;Sunnuntai;1;0;1;0;0;0
293;29.11.2015;2015;11;04;Sunnuntai;0;0;0;0;0;0
293;29.11.2015;2015;11;05;Sunnuntai;0;0;0;0;2;2
293;29.11.2015;2015;11;06;Sunnuntai;0;0;0;0;0;0
293;29.11.2015;2015;11;07;Sunnuntai;1;2;3;0;0;0
293;29.11.2015;2015;11;08;Sunnuntai;0;0;0;2;0;2
293;29.11.2015;2015;11;09;Sunnuntai;9;1;10;3;5;8
293;29.11.2015;2015;11;10;Sunnuntai;6;6;12;4;2;6
293;29.11.2015;2015;11;11;Sunnuntai;4;9;13;4;1;5
293;29.11.2015;2015;11;12;Sunnuntai;11;7;18;8;3;11
293;29.11.2015;2015;11;13;Sunnuntai;22;10;32;5;10;15
293;29.11.2015;2015;11;14;Sunnuntai;5;13;18;2;6;8
293;29.11.2015;2015;11;15;Sunnuntai;8;9;17;6;6;12
293;29.11.2015;2015;11;16;Sunnuntai;8;4;12;3;5;8
293;29.11.2015;2015;11;17;Sunnuntai;6;3;9;3;3;6
293;29.11.2015;2015;11;18;Sunnuntai;3;3;6;3;6;9
293;29.11.2015;2015;11;19;Sunnuntai;2;2;4;4;2;6
293;29.11.2015;2015;11;20;Sunnuntai;2;3;5;1;1;2
293;29.11.2015;2015;11;21;Sunnuntai;1;0;1;0;0;0
293;29.11.2015;2015;11;22;Sunnuntai;0;2;2;0;0;0
293;29.11.2015;2015;11;23;Sunnuntai;0;1;1;0;0;0
293;30.11.2015;2015;11;00;Maanantai;0;0;0;0;0;0
293;30.11.2015;2015;11;01;Maanantai;0;1;1;0;0;0
293;30.11.2015;2015;11;02;Maanantai;1;0;1;1;0;1
293;30.11.2015;2015;11;03;Maanantai;0;0;0;0;0;0
293;30.11.2015;2015;11;04;Maanantai;0;0;0;0;0;0
293;30.11.2015;2015;11;05;Maanantai;3;2;5;2;0;2
293;30.11.2015;2015;11;06;Maanantai;6;1;7;3;1;4
293;30.11.2015;2015;11;07;Maanantai;51;9;60;6;3;9
293;30.11.2015;2015;11;08;Maanantai;81;7;88;5;3;8
293;30.11.2015;2015;11;09;Maanantai;35;8;43;19;15;34
293;30.11.2015;2015;11;10;Maanantai;14;7;21;7;2;9
293;30.11.2015;2015;11;11;Maanantai;4;20;24;4;5;9
293;30.11.2015;2015;11;12;Maanantai;6;15;21;6;4;10
293;30.11.2015;2015;11;13;Maanantai;11;36;47;4;3;7
293;30.11.2015;2015;11;14;Maanantai;7;61;68;5;6;11
293;30.11.2015;2015;11;15;Maanantai;11;65;76;3;6;9
293;30.11.2015;2015;11;16;Maanantai;10;9;19;4;5;9
293;30.11.2015;2015;11;17;Maanantai;10;8;18;5;6;11
293;30.11.2015;2015;11;18;Maanantai;6;6;12;4;5;9
293;30.11.2015;2015;11;19;Maanantai;3;7;10;5;6;11
293;30.11.2015;2015;11;20;Maanantai;2;5;7;6;4;10
293;30.11.2015;2015;11;21;Maanantai;0;2;2;0;0;0
293;30.11.2015;2015;11;22;Maanantai;0;3;3;0;0;0
293;30.11.2015;2015;11;23;Maanantai;0;0;0;0;0;0
293;01.12.2015;2015;12;00;Tiistai;0;0;0;0;0;0
293;01.12.2015;2015;12;01;Tiistai;0;0;0;0;0;0
293;01.12.2015;2015;12;02;Tiistai;0;0;0;0;0;0
293;01.12.2015;2015;12;03;Tiistai;0;0;0;0;0;0
293;01.12.2015;2015;12;04;Tiistai;1;1;2;0;0;0
293;01.12.2015;2015;12;05;Tiistai;1;0;1;1;0;1
293;01.12.2015;2015;12;06;Tiistai;8;2;10;2;1;3
293;01.12.2015;2015;12;07;Tiistai;72;4;76;7;2;9
293;01.12.2015;2015;12;08;Tiistai;71;5;76;1;1;2
293;01.12.2015;2015;12;09;Tiistai;28;4;32;2;3;5
293;01.12.2015;2015;12;10;Tiistai;23;5;28;7;4;11
293;01.12.2015;2015;12;11;Tiistai;2;9;11;6;4;10
293;01.12.2015;2015;12;12;Tiistai;3;6;9;4;6;10
293;01.12.2015;2015;12;13;Tiistai;6;24;30;6;4;10
293;01.12.2015;2015;12;14;Tiistai;16;75;91;2;13;15
293;01.12.2015;2015;12;15;Tiistai;4;83;87;4;5;9
293;01.12.2015;2015;12;16;Tiistai;6;9;15;3;1;4
293;01.12.2015;2015;12;17;Tiistai;8;6;14;2;4;6
293;01.12.2015;2015;12;18;Tiistai;7;7;14;4;1;5
293;01.12.2015;2015;12;19;Tiistai;8;7;15;3;2;5
293;01.12.2015;2015;12;20;Tiistai;6;5;11;4;4;8
293;01.12.2015;2015;12;21;Tiistai;4;2;6;0;0;0
293;01.12.2015;2015;12;22;Tiistai;0;0;0;0;0;0
293;01.12.2015;2015;12;23;Tiistai;0;0;0;0;0;0
293;02.12.2015;2015;12;00;Keskiviikko;0;0;0;0;0;0
293;02.12.2015;2015;12;01;Keskiviikko;0;0;0;0;0;0
293;02.12.2015;2015;12;02;Keskiviikko;0;0;0;0;0;0
293;02.12.2015;2015;12;03;Keskiviikko;0;0;0;0;0;0
293;02.12.2015;2015;12;04;Keskiviikko;0;0;0;0;0;0
293;02.12.2015;2015;12;05;Keskiviikko;3;0;3;0;0;0
293;02.12.2015;2015;12;06;Keskiviikko;7;0;7;2;0;2
293;02.12.2015;2015;12;07;Keskiviikko;96;2;98;8;2;10
293;02.12.2015;2015;12;08;Keskiviikko;64;5;69;4;3;7
293;02.12.2015;2015;12;09;Keskiviikko;18;4;22;4;3;7
293;02.12.2015;2015;12;10;Keskiviikko;16;5;21;5;3;8
293;02.12.2015;2015;12;11;Keskiviikko;2;7;9;7;4;11
293;02.12.2015;2015;12;12;Keskiviikko;6;24;30;10;13;23
293;02.12.2015;2015;12;13;Keskiviikko;6;24;30;3;11;14
293;02.12.2015;2015;12;14;Keskiviikko;24;100;124;3;8;11
293;02.12.2015;2015;12;15;Keskiviikko;4;36;40;5;10;15
293;02.12.2015;2015;12;16;Keskiviikko;6;30;36;2;8;10
293;02.12.2015;2015;12;17;Keskiviikko;10;12;22;7;9;16
293;02.12.2015;2015;12;18;Keskiviikko;7;8;15;5;6;11
293;02.12.2015;2015;12;19;Keskiviikko;6;5;11;3;3;6
293;02.12.2015;2015;12;20;Keskiviikko;7;8;15;4;5;9
293;02.12.2015;2015;12;21;Keskiviikko;4;4;8;1;2;3
293;02.12.2015;2015;12;22;Keskiviikko;0;0;0;1;0;1
293;02.12.2015;2015;12;23;Keskiviikko;0;0;0;0;0;0
293;03.12.2015;2015;12;00;Torstai;0;0;0;0;0;0
293;03.12.2015;2015;12;01;Torstai;0;0;0;0;0;0
293;03.12.2015;2015;12;02;Torstai;0;0;0;0;0;0
293;03.12.2015;2015;12;03;Torstai;0;0;0;0;0;0
293;03.12.2015;2015;12;04;Torstai;0;0;0;0;0;0
293;03.12.2015;2015;12;05;Torstai;4;0;4;0;0;0
293;03.12.2015;2015;12;06;Torstai;9;0;9;3;0;3
293;03.12.2015;2015;12;07;Torstai;64;8;72;7;0;7
293;03.12.2015;2015;12;08;Torstai;56;4;60;6;1;7
293;03.12.2015;2015;12;09;Torstai;43;4;47;5;0;5
293;03.12.2015;2015;12;10;Torstai;12;0;12;4;4;8
293;03.12.2015;2015;12;11;Torstai;5;7;12;3;2;5
293;03.12.2015;2015;12;12;Torstai;5;9;14;4;3;7
293;03.12.2015;2015;12;13;Torstai;4;25;29;4;9;13
293;03.12.2015;2015;12;14;Torstai;6;80;86;5;8;13
293;03.12.2015;2015;12;15;Torstai;13;80;93;3;9;12
293;03.12.2015;2015;12;16;Torstai;7;8;15;4;4;8
293;03.12.2015;2015;12;17;Torstai;15;8;23;1;8;9
293;03.12.2015;2015;12;18;Torstai;6;14;20;7;3;10
293;03.12.2015;2015;12;19;Torstai;1;5;6;7;5;12
293;03.12.2015;2015;12;20;Torstai;4;4;8;2;2;4
293;03.12.2015;2015;12;21;Torstai;2;3;5;0;4;4
293;03.12.2015;2015;12;22;Torstai;0;1;1;0;0;0
293;03.12.2015;2015;12;23;Torstai;0;0;0;0;0;0
293;04.12.2015;2015;12;00;Perjantai;0;0;0;0;0;0
293;04.12.2015;2015;12;01;Perjantai;0;0;0;0;0;0
293;04.12.2015;2015;12;02;Perjantai;0;0;0;1;0;1
293;04.12.2015;2015;12;03;Perjantai;0;0;0;0;0;0
293;04.12.2015;2015;12;04;Perjantai;0;0;0;0;0;0
293;04.12.2015;2015;12;05;Perjantai;0;1;1;0;0;0
293;04.12.2015;2015;12;06;Perjantai;9;2;11;2;0;2
293;04.12.2015;2015;12;07;Perjantai;76;4;80;9;2;11
293;04.12.2015;2015;12;08;Perjantai;81;4;85;4;3;7
293;04.12.2015;2015;12;09;Perjantai;19;7;26;4;2;6
293;04.12.2015;2015;12;10;Perjantai;9;5;14;4;5;9
293;04.12.2015;2015;12;11;Perjantai;4;5;9;5;3;8
293;04.12.2015;2015;12;12;Perjantai;7;26;33;4;4;8
293;04.12.2015;2015;12;13;Perjantai;3;35;38;5;12;17
293;04.12.2015;2015;12;14;Perjantai;13;59;72;3;11;14
293;04.12.2015;2015;12;15;Perjantai;12;60;72;2;8;10
293;04.12.2015;2015;12;16;Perjantai;5;11;16;1;2;3
293;04.12.2015;2015;12;17;Perjantai;8;9;17;0;2;2
293;04.12.2015;2015;12;18;Perjantai;6;3;9;1;2;3
293;04.12.2015;2015;12;19;Perjantai;6;5;11;0;0;0
293;04.12.2015;2015;12;20;Perjantai;4;3;7;0;0;0
293;04.12.2015;2015;12;21;Perjantai;4;3;7;0;0;0
293;04.12.2015;2015;12;22;Perjantai;3;3;6;0;0;0
293;04.12.2015;2015;12;23;Perjantai;0;0;0;0;0;0
293;05.12.2015;2015;12;00;Lauantai;1;1;2;0;0;0
293;05.12.2015;2015;12;01;Lauantai;0;0;0;0;0;0
293;05.12.2015;2015;12;02;Lauantai;0;0;0;0;0;0
293;05.12.2015;2015;12;03;Lauantai;1;1;2;0;0;0
293;05.12.2015;2015;12;04;Lauantai;0;0;0;0;0;0
293;05.12.2015;2015;12;05;Lauantai;0;0;0;0;0;0
293;05.12.2015;2015;12;06;Lauantai;0;0;0;0;0;0
293;05.12.2015;2015;12;07;Lauantai;2;1;3;0;0;0
293;05.12.2015;2015;12;08;Lauantai;2;2;4;0;0;0
293;05.12.2015;2015;12;09;Lauantai;2;1;3;0;0;0
293;05.12.2015;2015;12;10;Lauantai;4;3;7;0;0;0
293;05.12.2015;2015;12;11;Lauantai;3;3;6;4;2;6
293;05.12.2015;2015;12;12;Lauantai;7;5;12;10;8;18
293;05.12.2015;2015;12;13;Lauantai;4;2;6;11;4;15
293;05.12.2015;2015;12;14;Lauantai;7;7;14;4;15;19
293;05.12.2015;2015;12;15;Lauantai;8;9;17;7;1;8
293;05.12.2015;2015;12;16;Lauantai;2;12;14;0;2;2
293;05.12.2015;2015;12;17;Lauantai;8;5;13;6;4;10
293;05.12.2015;2015;12;18;Lauantai;3;2;5;1;1;2
293;05.12.2015;2015;12;19;Lauantai;6;2;8;2;1;3
293;05.12.2015;2015;12;20;Lauantai;0;5;5;1;4;5
293;05.12.2015;2015;12;21;Lauantai;2;3;5;1;0;1
293;05.12.2015;2015;12;22;Lauantai;0;1;1;0;0;0
293;05.12.2015;2015;12;23;Lauantai;1;4;5;0;0;0
293;06.12.2015;2015;12;00;Sunnuntai;1;1;2;1;0;1
293;06.12.2015;2015;12;01;Sunnuntai;0;1;1;2;2;4
293;06.12.2015;2015;12;02;Sunnuntai;0;1;1;13;2;15
293;06.12.2015;2015;12;03;Sunnuntai;0;0;0;0;4;4
293;06.12.2015;2015;12;04;Sunnuntai;0;0;0;0;0;0
293;06.12.2015;2015;12;05;Sunnuntai;0;0;0;0;0;0
293;06.12.2015;2015;12;06;Sunnuntai;1;0;1;0;0;0
293;06.12.2015;2015;12;07;Sunnuntai;0;0;0;0;0;0
293;06.12.2015;2015;12;08;Sunnuntai;1;0;1;2;2;4
293;06.12.2015;2015;12;09;Sunnuntai;2;1;3;4;3;7
293;06.12.2015;2015;12;10;Sunnuntai;2;1;3;9;5;14
293;06.12.2015;2015;12;11;Sunnuntai;1;1;2;6;9;15
293;06.12.2015;2015;12;12;Sunnuntai;8;2;10;12;5;17
293;06.12.2015;2015;12;13;Sunnuntai;2;5;7;7;5;12
293;06.12.2015;2015;12;14;Sunnuntai;5;4;9;4;3;7
293;06.12.2015;2015;12;15;Sunnuntai;8;6;14;4;8;12
293;06.12.2015;2015;12;16;Sunnuntai;7;6;13;4;3;7
293;06.12.2015;2015;12;17;Sunnuntai;2;2;4;5;6;11
293;06.12.2015;2015;12;18;Sunnuntai;0;5;5;2;5;7
293;06.12.2015;2015;12;19;Sunnuntai;2;1;3;4;2;6
293;06.12.2015;2015;12;20;Sunnuntai;1;0;1;2;2;4
293;06.12.2015;2015;12;21;Sunnuntai;0;2;2;6;5;11
293;06.12.2015;2015;12;22;Sunnuntai;0;0;0;0;0;0
293;06.12.2015;2015;12;23;Sunnuntai;0;0;0;0;0;0
293;07.12.2015;2015;12;00;Maanantai;0;0;0;0;0;0
293;07.12.2015;2015;12;01;Maanantai;0;0;0;0;0;0
293;07.12.2015;2015;12;02;Maanantai;0;0;0;0;0;0
293;07.12.2015;2015;12;03;Maanantai;0;0;0;0;0;0
293;07.12.2015;2015;12;04;Maanantai;0;0;0;0;0;0
293;07.12.2015;2015;12;05;Maanantai;2;1;3;0;0;0
293;07.12.2015;2015;12;06;Maanantai;4;0;4;2;0;2
293;07.12.2015;2015;12;07;Maanantai;62;1;63;4;1;5
293;07.12.2015;2015;12;08;Maanantai;56;3;59;4;1;5
293;07.12.2015;2015;12;09;Maanantai;43;2;45;5;1;6
293;07.12.2015;2015;12;10;Maanantai;9;3;12;6;1;7
293;07.12.2015;2015;12;11;Maanantai;3;2;5;5;2;7
293;07.12.2015;2015;12;12;Maanantai;6;7;13;7;5;12
293;07.12.2015;2015;12;13;Maanantai;1;26;27;5;9;14
293;07.12.2015;2015;12;14;Maanantai;1;64;65;1;13;14
293;07.12.2015;2015;12;15;Maanantai;9;59;68;7;13;20
293;07.12.2015;2015;12;16;Maanantai;8;12;20;3;5;8
293;07.12.2015;2015;12;17;Maanantai;2;6;8;5;7;12
293;07.12.2015;2015;12;18;Maanantai;2;4;6;2;2;4
293;07.12.2015;2015;12;19;Maanantai;0;7;7;2;4;6
293;07.12.2015;2015;12;20;Maanantai;2;4;6;1;3;4
293;07.12.2015;2015;12;21;Maanantai;0;2;2;1;0;1
293;07.12.2015;2015;12;22;Maanantai;0;0;0;0;0;0
293;07.12.2015;2015;12;23;Maanantai;0;0;0;0;0;0
293;08.12.2015;2015;12;00;Tiistai;0;0;0;0;0;0
293;08.12.2015;2015;12;01;Tiistai;0;0;0;0;0;0
293;08.12.2015;2015;12;02;Tiistai;0;0;0;0;0;0
293;08.12.2015;2015;12;03;Tiistai;0;0;0;0;0;0
293;08.12.2015;2015;12;04;Tiistai;0;0;0;0;0;0
293;08.12.2015;2015;12;05;Tiistai;1;1;2;2;0;2
293;08.12.2015;2015;12;06;Tiistai;5;2;7;3;0;3
293;08.12.2015;2015;12;07;Tiistai;66;3;69;12;0;12
293;08.12.2015;2015;12;08;Tiistai;66;1;67;6;1;7
293;08.12.2015;2015;12;09;Tiistai;18;2;20;5;2;7
293;08.12.2015;2015;12;10;Tiistai;20;2;22;2;2;4
293;08.12.2015;2015;12;11;Tiistai;4;3;7;5;4;9
293;08.12.2015;2015;12;12;Tiistai;5;5;10;2;2;4
293;08.12.2015;2015;12;13;Tiistai;3;18;21;2;6;8
293;08.12.2015;2015;12;14;Tiistai;7;72;79;4;10;14
293;08.12.2015;2015;12;15;Tiistai;6;67;73;3;18;21
293;08.12.2015;2015;12;16;Tiistai;4;8;12;4;11;15
293;08.12.2015;2015;12;17;Tiistai;4;6;10;6;4;10
293;08.12.2015;2015;12;18;Tiistai;7;7;14;5;9;14
293;08.12.2015;2015;12;19;Tiistai;3;4;7;4;5;9
293;08.12.2015;2015;12;20;Tiistai;0;3;3;4;2;6
293;08.12.2015;2015;12;21;Tiistai;0;4;4;0;1;1
293;08.12.2015;2015;12;22;Tiistai;0;1;1;0;0;0
293;08.12.2015;2015;12;23;Tiistai;0;0;0;0;0;0
293;09.12.2015;2015;12;00;Keskiviikko;0;0;0;1;0;1
293;09.12.2015;2015;12;01;Keskiviikko;0;0;0;0;0;0
293;09.12.2015;2015;12;02;Keskiviikko;0;0;0;0;0;0
293;09.12.2015;2015;12;03;Keskiviikko;0;0;0;0;0;0
293;09.12.2015;2015;12;04;Keskiviikko;0;0;0;0;0;0
293;09.12.2015;2015;12;05;Keskiviikko;2;0;2;0;0;0
293;09.12.2015;2015;12;06;Keskiviikko;4;1;5;2;0;2
293;09.12.2015;2015;12;07;Keskiviikko;80;5;85;15;3;18
293;09.12.2015;2015;12;08;Keskiviikko;50;0;50;6;1;7
293;09.12.2015;2015;12;09;Keskiviikko;15;3;18;5;0;5
293;09.12.2015;2015;12;10;Keskiviikko;10;1;11;9;2;11
293;09.12.2015;2015;12;11;Keskiviikko;4;5;9;2;5;7
293;09.12.2015;2015;12;12;Keskiviikko;1;14;15;2;5;7
293;09.12.2015;2015;12;13;Keskiviikko;3;17;20;6;4;10
293;09.12.2015;2015;12;14;Keskiviikko;3;93;96;3;21;24
293;09.12.2015;2015;12;15;Keskiviikko;11;28;39;2;2;4
293;09.12.2015;2015;12;16;Keskiviikko;3;10;13;1;3;4
293;09.12.2015;2015;12;17;Keskiviikko;5;3;8;3;4;7
293;09.12.2015;2015;12;18;Keskiviikko;4;1;5;7;9;16
293;09.12.2015;2015;12;19;Keskiviikko;1;3;4;2;2;4
293;09.12.2015;2015;12;20;Keskiviikko;0;3;3;2;1;3
293;09.12.2015;2015;12;21;Keskiviikko;0;5;5;0;1;1
293;09.12.2015;2015;12;22;Keskiviikko;0;0;0;0;0;0
293;09.12.2015;2015;12;23;Keskiviikko;0;0;0;0;0;0
293;10.12.2015;2015;12;00;Torstai;0;0;0;0;0;0
293;10.12.2015;2015;12;01;Torstai;0;0;0;0;0;0
293;10.12.2015;2015;12;02;Torstai;0;0;0;0;0;0
293;10.12.2015;2015;12;03;Torstai;0;1;1;0;0;0
293;10.12.2015;2015;12;04;Torstai;0;0;0;0;0;0
293;10.12.2015;2015;12;05;Torstai;1;0;1;0;0;0
293;10.12.2015;2015;12;06;Torstai;2;1;3;4;0;4
293;10.12.2015;2015;12;07;Torstai;51;0;51;15;1;16
293;10.12.2015;2015;12;08;Torstai;46;0;46;8;2;10
293;10.12.2015;2015;12;09;Torstai;36;6;42;5;6;11
293;10.12.2015;2015;12;10;Torstai;9;2;11;3;1;4
293;10.12.2015;2015;12;11;Torstai;4;2;6;4;3;7
293;10.12.2015;2015;12;12;Torstai;1;6;7;3;4;7
293;10.12.2015;2015;12;13;Torstai;2;22;24;2;5;7
293;10.12.2015;2015;12;14;Torstai;2;57;59;8;6;14
293;10.12.2015;2015;12;15;Torstai;4;59;63;3;12;15
293;10.12.2015;2015;12;16;Torstai;5;5;10;4;6;10
293;10.12.2015;2015;12;17;Torstai;4;3;7;5;5;10
293;10.12.2015;2015;12;18;Torstai;6;4;10;2;4;6
293;10.12.2015;2015;12;19;Torstai;1;5;6;3;5;8
293;10.12.2015;2015;12;20;Torstai;2;7;9;3;6;9
293;10.12.2015;2015;12;21;Torstai;2;2;4;0;2;2
293;10.12.2015;2015;12;22;Torstai;0;2;2;0;0;0
293;10.12.2015;2015;12;23;Torstai;0;0;0;0;0;0
293;11.12.2015;2015;12;00;Perjantai;0;0;0;0;0;0
293;11.12.2015;2015;12;01;Perjantai;0;0;0;0;0;0
293;11.12.2015;2015;12;02;Perjantai;0;0;0;0;0;0
293;11.12.2015;2015;12;03;Perjantai;0;0;0;0;0;0
293;11.12.2015;2015;12;04;Perjantai;0;0;0;0;0;0
293;11.12.2015;2015;12;05;Perjantai;0;0;0;0;0;0
293;11.12.2015;2015;12;06;Perjantai;3;1;4;4;0;4
293;11.12.2015;2015;12;07;Perjantai;77;5;82;9;1;10
293;11.12.2015;2015;12;08;Perjantai;50;4;54;6;1;7
293;11.12.2015;2015;12;09;Perjantai;23;3;26;5;3;8
293;11.12.2015;2015;12;10;Perjantai;5;3;8;0;1;1
293;11.12.2015;2015;12;11;Perjantai;1;4;5;5;2;7
293;11.12.2015;2015;12;12;Perjantai;8;45;53;9;6;15
293;11.12.2015;2015;12;13;Perjantai;9;67;76;7;16;23
293;11.12.2015;2015;12;14;Perjantai;10;33;43;6;11;17
293;11.12.2015;2015;12;15;Perjantai;7;8;15;10;12;22
293;11.12.2015;2015;12;16;Perjantai;6;9;15;5;6;11
293;11.12.2015;2015;12;17;Perjantai;8;5;13;2;8;10
293;11.12.2015;2015;12;18;Perjantai;11;9;20;4;0;4
293;11.12.2015;2015;12;19;Perjantai;6;8;14;5;6;11
293;11.12.2015;2015;12;20;Perjantai;3;12;15;3;5;8
293;11.12.2015;2015;12;21;Perjantai;9;6;15;0;3;3
293;11.12.2015;2015;12;22;Perjantai;0;7;7;0;1;1
293;11.12.2015;2015;12;23;Perjantai;1;5;6;1;0;1
293;12.12.2015;2015;12;00;Lauantai;2;0;2;0;0;0
293;12.12.2015;2015;12;01;Lauantai;0;1;1;1;0;1
293;12.12.2015;2015;12;02;Lauantai;1;0;1;1;1;2
293;12.12.2015;2015;12;03;Lauantai;0;0;0;0;4;4
293;12.12.2015;2015;12;04;Lauantai;0;0;0;0;0;0
293;12.12.2015;2015;12;05;Lauantai;0;0;0;0;0;0
293;12.12.2015;2015;12;06;Lauantai;1;1;2;0;0;0
293;12.12.2015;2015;12;07;Lauantai;1;0;1;0;0;0
293;12.12.2015;2015;12;08;Lauantai;4;1;5;2;1;3
293;12.12.2015;2015;12;09;Lauantai;6;4;10;2;7;9
293;12.12.2015;2015;12;10;Lauantai;1;5;6;3;3;6
293;12.12.2015;2015;12;11;Lauantai;6;5;11;8;4;12
293;12.12.2015;2015;12;12;Lauantai;2;5;7;4;6;10
293;12.12.2015;2015;12;13;Lauantai;10;9;19;13;6;19
293;12.12.2015;2015;12;14;Lauantai;7;10;17;6;6;12
293;12.12.2015;2015;12;15;Lauantai;8;6;14;2;10;12
293;12.12.2015;2015;12;16;Lauantai;8;10;18;0;5;5
293;12.12.2015;2015;12;17;Lauantai;2;4;6;1;2;3
293;12.12.2015;2015;12;18;Lauantai;1;5;6;2;1;3
293;12.12.2015;2015;12;19;Lauantai;1;5;6;3;3;6
293;12.12.2015;2015;12;20;Lauantai;2;5;7;3;1;4
293;12.12.2015;2015;12;21;Lauantai;7;4;11;2;3;5
293;12.12.2015;2015;12;22;Lauantai;2;1;3;1;1;2
293;12.12.2015;2015;12;23;Lauantai;0;0;0;1;2;3
293;13.12.2015;2015;12;00;Sunnuntai;1;1;2;0;1;1
293;13.12.2015;2015;12;01;Sunnuntai;0;0;0;0;0;0
293;13.12.2015;2015;12;02;Sunnuntai;1;0;1;1;1;2
293;13.12.2015;2015;12;03;Sunnuntai;0;1;1;0;0;0
293;13.12.2015;2015;12;04;Sunnuntai;2;0;2;0;0;0
293;13.12.2015;2015;12;05;Sunnuntai;0;0;0;0;0;0
293;13.12.2015;2015;12;06;Sunnuntai;0;0;0;1;0;1
293;13.12.2015;2015;12;07;Sunnuntai;0;0;0;0;0;0
293;13.12.2015;2015;12;08;Sunnuntai;0;0;0;2;2;4
293;13.12.2015;2015;12;09;Sunnuntai;2;2;4;3;3;6
293;13.12.2015;2015;12;10;Sunnuntai;2;8;10;2;2;4
293;13.12.2015;2015;12;11;Sunnuntai;5;1;6;12;6;18
293;13.12.2015;2015;12;12;Sunnuntai;5;4;9;8;11;19
293;13.12.2015;2015;12;13;Sunnuntai;5;6;11;8;5;13
293;13.12.2015;2015;12;14;Sunnuntai;1;1;2;4;13;17
293;13.12.2015;2015;12;15;Sunnuntai;6;2;8;4;6;10
293;13.12.2015;2015;12;16;Sunnuntai;5;4;9;9;3;12
293;13.12.2015;2015;12;17;Sunnuntai;2;4;6;4;9;13
293;13.12.2015;2015;12;18;Sunnuntai;3;5;8;5;7;12
293;13.12.2015;2015;12;19;Sunnuntai;4;5;9;0;1;1
293;13.12.2015;2015;12;20;Sunnuntai;1;2;3;2;3;5
293;13.12.2015;2015;12;21;Sunnuntai;2;1;3;0;1;1
293;13.12.2015;2015;12;22;Sunnuntai;0;0;0;0;0;0
293;13.12.2015;2015;12;23;Sunnuntai;0;0;0;0;0;0
293;14.12.2015;2015;12;00;Maanantai;0;0;0;0;0;0
293;14.12.2015;2015;12;01;Maanantai;0;0;0;0;0;0
293;14.12.2015;2015;12;02;Maanantai;0;0;0;0;0;0
293;14.12.2015;2015;12;03;Maanantai;0;0;0;0;0;0
293;14.12.2015;2015;12;04;Maanantai;0;0;0;0;0;0
293;14.12.2015;2015;12;05;Maanantai;3;1;4;0;0;0
293;14.12.2015;2015;12;06;Maanantai;5;1;6;3;1;4
293;14.12.2015;2015;12;07;Maanantai;40;3;43;9;1;10
293;14.12.2015;2015;12;08;Maanantai;83;5;88;15;2;17
293;14.12.2015;2015;12;09;Maanantai;35;5;40;3;8;11
293;14.12.2015;2015;12;10;Maanantai;15;1;16;2;5;7
293;14.12.2015;2015;12;11;Maanantai;7;4;11;3;3;6
293;14.12.2015;2015;12;12;Maanantai;4;12;16;6;8;14
293;14.12.2015;2015;12;13;Maanantai;5;30;35;9;9;18
293;14.12.2015;2015;12;14;Maanantai;3;65;68;4;11;15
293;14.12.2015;2015;12;15;Maanantai;4;57;61;9;16;25
293;14.12.2015;2015;12;16;Maanantai;12;9;21;4;8;12
293;14.12.2015;2015;12;17;Maanantai;4;6;10;7;10;17
293;14.12.2015;2015;12;18;Maanantai;0;4;4;4;6;10
293;14.12.2015;2015;12;19;Maanantai;2;3;5;5;2;7
293;14.12.2015;2015;12;20;Maanantai;2;1;3;1;3;4
293;14.12.2015;2015;12;21;Maanantai;1;3;4;3;4;7
293;14.12.2015;2015;12;22;Maanantai;0;1;1;0;0;0
293;14.12.2015;2015;12;23;Maanantai;0;0;0;0;0;0
293;15.12.2015;2015;12;00;Tiistai;0;0;0;0;0;0
293;15.12.2015;2015;12;01;Tiistai;0;0;0;0;0;0
293;15.12.2015;2015;12;02;Tiistai;0;0;0;0;0;0
293;15.12.2015;2015;12;03;Tiistai;0;0;0;0;0;0
293;15.12.2015;2015;12;04;Tiistai;0;0;0;0;0;0
293;15.12.2015;2015;12;05;Tiistai;2;2;4;0;0;0
293;15.12.2015;2015;12;06;Tiistai;8;2;10;3;0;3
293;15.12.2015;2015;12;07;Tiistai;67;0;67;10;2;12
293;15.12.2015;2015;12;08;Tiistai;58;7;65;5;3;8
293;15.12.2015;2015;12;09;Tiistai;29;2;31;6;2;8
293;15.12.2015;2015;12;10;Tiistai;14;1;15;6;1;7
293;15.12.2015;2015;12;11;Tiistai;5;7;12;4;3;7
293;15.12.2015;2015;12;12;Tiistai;5;7;12;5;10;15
293;15.12.2015;2015;12;13;Tiistai;3;25;28;6;7;13
293;15.12.2015;2015;12;14;Tiistai;6;122;128;4;16;20
293;15.12.2015;2015;12;15;Tiistai;9;18;27;7;9;16
293;15.12.2015;2015;12;16;Tiistai;11;7;18;4;13;17
293;15.12.2015;2015;12;17;Tiistai;10;13;23;3;7;10
293;15.12.2015;2015;12;18;Tiistai;3;6;9;7;6;13
293;15.12.2015;2015;12;19;Tiistai;2;9;11;6;5;11
293;15.12.2015;2015;12;20;Tiistai;5;10;15;3;3;6
293;15.12.2015;2015;12;21;Tiistai;2;3;5;1;0;1
293;15.12.2015;2015;12;22;Tiistai;0;0;0;2;0;2
293;15.12.2015;2015;12;23;Tiistai;0;0;0;0;0;0
293;16.12.2015;2015;12;00;Keskiviikko;0;0;0;0;0;0
293;16.12.2015;2015;12;01;Keskiviikko;0;0;0;0;0;0
293;16.12.2015;2015;12;02;Keskiviikko;0;0;0;0;0;0
293;16.12.2015;2015;12;03;Keskiviikko;0;0;0;0;0;0
293;16.12.2015;2015;12;04;Keskiviikko;0;0;0;0;0;0
293;16.12.2015;2015;12;05;Keskiviikko;2;1;3;0;0;0
293;16.12.2015;2015;12;06;Keskiviikko;8;2;10;2;1;3
293;16.12.2015;2015;12;07;Keskiviikko;77;3;80;15;3;18
293;16.12.2015;2015;12;08;Keskiviikko;73;7;80;12;4;16
293;16.12.2015;2015;12;09;Keskiviikko;16;2;18;9;1;10
293;16.12.2015;2015;12;10;Keskiviikko;13;4;17;3;9;12
293;16.12.2015;2015;12;11;Keskiviikko;4;6;10;5;2;7
293;16.12.2015;2015;12;12;Keskiviikko;6;12;18;4;8;12
293;16.12.2015;2015;12;13;Keskiviikko;10;24;34;6;5;11
293;16.12.2015;2015;12;14;Keskiviikko;5;110;115;5;21;26
293;16.12.2015;2015;12;15;Keskiviikko;6;20;26;4;6;10
293;16.12.2015;2015;12;16;Keskiviikko;10;18;28;2;7;9
293;16.12.2015;2015;12;17;Keskiviikko;4;3;7;5;5;10
293;16.12.2015;2015;12;18;Keskiviikko;3;3;6;4;3;7
293;16.12.2015;2015;12;19;Keskiviikko;2;7;9;5;2;7
293;16.12.2015;2015;12;20;Keskiviikko;1;8;9;2;0;2
293;16.12.2015;2015;12;21;Keskiviikko;1;1;2;1;3;4
293;16.12.2015;2015;12;22;Keskiviikko;0;0;0;0;1;1
293;16.12.2015;2015;12;23;Keskiviikko;0;0;0;0;0;0
293;17.12.2015;2015;12;00;Torstai;0;0;0;0;0;0
293;17.12.2015;2015;12;01;Torstai;0;0;0;0;0;0
293;17.12.2015;2015;12;02;Torstai;0;0;0;0;0;0
293;17.12.2015;2015;12;03;Torstai;0;0;0;0;0;0
293;17.12.2015;2015;12;04;Torstai;0;0;0;0;0;0
293;17.12.2015;2015;12;05;Torstai;1;0;1;0;0;0
293;17.12.2015;2015;12;06;Torstai;4;2;6;2;1;3
293;17.12.2015;2015;12;07;Torstai;62;5;67;12;1;13
293;17.12.2015;2015;12;08;Torstai;62;5;67;11;5;16
293;17.12.2015;2015;12;09;Torstai;29;2;31;4;2;6
293;17.12.2015;2015;12;10;Torstai;4;1;5;6;4;10
293;17.12.2015;2015;12;11;Torstai;2;6;8;4;3;7
293;17.12.2015;2015;12;12;Torstai;5;48;53;4;3;7
293;17.12.2015;2015;12;13;Torstai;6;20;26;9;6;15
293;17.12.2015;2015;12;14;Torstai;5;53;58;3;10;13
293;17.12.2015;2015;12;15;Torstai;14;53;67;2;11;13
293;17.12.2015;2015;12;16;Torstai;4;17;21;2;2;4
293;17.12.2015;2015;12;17;Torstai;19;4;23;7;6;13
293;17.12.2015;2015;12;18;Torstai;3;4;7;2;4;6
293;17.12.2015;2015;12;19;Torstai;6;18;24;4;6;10
293;17.12.2015;2015;12;20;Torstai;3;5;8;5;5;10
293;17.12.2015;2015;12;21;Torstai;1;2;3;0;4;4
293;17.12.2015;2015;12;22;Torstai;0;0;0;0;0;0
293;17.12.2015;2015;12;23;Torstai;0;0;0;0;0;0
293;18.12.2015;2015;12;00;Perjantai;0;0;0;0;0;0
293;18.12.2015;2015;12;01;Perjantai;0;0;0;0;0;0
293;18.12.2015;2015;12;02;Perjantai;0;0;0;0;0;0
293;18.12.2015;2015;12;03;Perjantai;0;0;0;0;0;0
293;18.12.2015;2015;12;04;Perjantai;0;0;0;0;0;0
293;18.12.2015;2015;12;05;Perjantai;2;0;2;1;2;3
293;18.12.2015;2015;12;06;Perjantai;6;1;7;3;1;4
293;18.12.2015;2015;12;07;Perjantai;116;3;119;11;0;11
293;18.12.2015;2015;12;08;Perjantai;21;3;24;55;3;58
293;18.12.2015;2015;12;09;Perjantai;10;2;12;4;2;6
293;18.12.2015;2015;12;10;Perjantai;6;3;9;0;30;30
293;18.12.2015;2015;12;11;Perjantai;3;5;8;1;3;4
293;18.12.2015;2015;12;12;Perjantai;11;60;71;8;5;13
293;18.12.2015;2015;12;13;Perjantai;8;73;81;6;16;22
293;18.12.2015;2015;12;14;Perjantai;12;17;29;4;4;8
293;18.12.2015;2015;12;15;Perjantai;4;16;20;9;8;17
293;18.12.2015;2015;12;16;Perjantai;7;6;13;4;5;9
293;18.12.2015;2015;12;17;Perjantai;8;2;10;3;4;7
293;18.12.2015;2015;12;18;Perjantai;1;3;4;2;1;3
293;18.12.2015;2015;12;19;Perjantai;4;3;7;2;1;3
293;18.12.2015;2015;12;20;Perjantai;2;2;4;0;2;2
293;18.12.2015;2015;12;21;Perjantai;1;2;3;1;2;3
293;18.12.2015;2015;12;22;Perjantai;0;2;2;2;0;2
293;18.12.2015;2015;12;23;Perjantai;0;0;0;1;0;1
293;19.12.2015;2015;12;00;Lauantai;0;1;1;0;0;0
293;19.12.2015;2015;12;01;Lauantai;1;0;1;1;0;1
293;19.12.2015;2015;12;02;Lauantai;0;0;0;0;1;1
293;19.12.2015;2015;12;03;Lauantai;0;1;1;0;1;1
293;19.12.2015;2015;12;04;Lauantai;1;0;1;0;2;2
293;19.12.2015;2015;12;05;Lauantai;0;0;0;0;0;0
293;19.12.2015;2015;12;06;Lauantai;0;0;0;3;0;3
293;19.12.2015;2015;12;07;Lauantai;1;0;1;2;1;3
293;19.12.2015;2015;12;08;Lauantai;56;0;56;5;0;5
293;19.12.2015;2015;12;09;Lauantai;5;32;37;6;6;12
293;19.12.2015;2015;12;10;Lauantai;4;25;29;2;4;6
293;19.12.2015;2015;12;11;Lauantai;2;9;11;7;6;13
293;19.12.2015;2015;12;12;Lauantai;3;5;8;6;4;10
293;19.12.2015;2015;12;13;Lauantai;2;3;5;4;9;13
293;19.12.2015;2015;12;14;Lauantai;5;4;9;4;6;10
293;19.12.2015;2015;12;15;Lauantai;3;3;6;9;3;12
293;19.12.2015;2015;12;16;Lauantai;11;7;18;5;6;11
293;19.12.2015;2015;12;17;Lauantai;4;13;17;7;6;13
293;19.12.2015;2015;12;18;Lauantai;9;5;14;3;8;11
293;19.12.2015;2015;12;19;Lauantai;2;4;6;3;1;4
293;19.12.2015;2015;12;20;Lauantai;5;6;11;0;4;4
293;19.12.2015;2015;12;21;Lauantai;0;1;1;1;1;2
293;19.12.2015;2015;12;22;Lauantai;1;1;2;0;1;1
293;19.12.2015;2015;12;23;Lauantai;2;0;2;0;0;0
293;20.12.2015;2015;12;00;Sunnuntai;0;1;1;0;2;2
293;20.12.2015;2015;12;01;Sunnuntai;2;0;2;0;0;0
293;20.12.2015;2015;12;02;Sunnuntai;1;0;1;0;2;2
293;20.12.2015;2015;12;03;Sunnuntai;0;0;0;0;1;1
293;20.12.2015;2015;12;04;Sunnuntai;0;0;0;1;1;2
293;20.12.2015;2015;12;05;Sunnuntai;0;0;0;0;1;1
293;20.12.2015;2015;12;06;Sunnuntai;0;0;0;0;0;0
293;20.12.2015;2015;12;07;Sunnuntai;1;2;3;0;0;0
293;20.12.2015;2015;12;08;Sunnuntai;0;0;0;1;1;2
293;20.12.2015;2015;12;09;Sunnuntai;5;1;6;3;3;6
293;20.12.2015;2015;12;10;Sunnuntai;3;1;4;5;1;6
293;20.12.2015;2015;12;11;Sunnuntai;0;0;0;4;5;9
293;20.12.2015;2015;12;12;Sunnuntai;3;6;9;6;4;10
293;20.12.2015;2015;12;13;Sunnuntai;0;5;5;4;5;9
293;20.12.2015;2015;12;14;Sunnuntai;3;3;6;3;10;13
293;20.12.2015;2015;12;15;Sunnuntai;5;5;10;3;4;7
293;20.12.2015;2015;12;16;Sunnuntai;1;1;2;5;5;10
293;20.12.2015;2015;12;17;Sunnuntai;3;2;5;2;5;7
293;20.12.2015;2015;12;18;Sunnuntai;7;1;8;2;7;9
293;20.12.2015;2015;12;19;Sunnuntai;2;1;3;1;3;4
293;20.12.2015;2015;12;20;Sunnuntai;0;8;8;6;1;7
293;20.12.2015;2015;12;21;Sunnuntai;0;0;0;0;0;0
293;20.12.2015;2015;12;22;Sunnuntai;0;2;2;0;0;0
293;20.12.2015;2015;12;23;Sunnuntai;2;1;3;1;1;2
293;21.12.2015;2015;12;00;Maanantai;0;0;0;0;0;0
293;21.12.2015;2015;12;01;Maanantai;1;1;2;4;2;6
293;21.12.2015;2015;12;02;Maanantai;0;0;0;0;0;0
293;21.12.2015;2015;12;03;Maanantai;0;0;0;0;0;0
293;21.12.2015;2015;12;04;Maanantai;0;0;0;0;0;0
293;21.12.2015;2015;12;05;Maanantai;0;1;1;0;0;0
293;21.12.2015;2015;12;06;Maanantai;4;1;5;2;0;2
293;21.12.2015;2015;12;07;Maanantai;3;2;5;4;1;5
293;21.12.2015;2015;12;08;Maanantai;3;0;3;4;0;4
293;21.12.2015;2015;12;09;Maanantai;9;2;11;3;1;4
293;21.12.2015;2015;12;10;Maanantai;2;4;6;1;3;4
293;21.12.2015;2015;12;11;Maanantai;4;3;7;5;4;9
293;21.12.2015;2015;12;12;Maanantai;12;4;16;5;3;8
293;21.12.2015;2015;12;13;Maanantai;8;7;15;6;4;10
293;21.12.2015;2015;12;14;Maanantai;5;16;21;6;6;12
293;21.12.2015;2015;12;15;Maanantai;3;7;10;5;5;10
293;21.12.2015;2015;12;16;Maanantai;9;10;19;7;7;14
293;21.12.2015;2015;12;17;Maanantai;14;4;18;5;6;11
293;21.12.2015;2015;12;18;Maanantai;5;7;12;3;4;7
293;21.12.2015;2015;12;19;Maanantai;3;11;14;3;2;5
293;21.12.2015;2015;12;20;Maanantai;1;6;7;2;2;4
293;21.12.2015;2015;12;21;Maanantai;1;3;4;2;3;5
293;21.12.2015;2015;12;22;Maanantai;0;1;1;1;1;2
293;21.12.2015;2015;12;23;Maanantai;0;0;0;0;0;0
293;22.12.2015;2015;12;00;Tiistai;0;0;0;0;0;0
293;22.12.2015;2015;12;01;Tiistai;0;0;0;0;0;0
293;22.12.2015;2015;12;02;Tiistai;0;0;0;0;0;0
293;22.12.2015;2015;12;03;Tiistai;0;0;0;0;0;0
293;22.12.2015;2015;12;04;Tiistai;0;0;0;0;0;0
293;22.12.2015;2015;12;05;Tiistai;0;0;0;0;0;0
293;22.12.2015;2015;12;06;Tiistai;3;2;5;2;0;2
293;22.12.2015;2015;12;07;Tiistai;3;0;3;3;1;4
293;22.12.2015;2015;12;08;Tiistai;0;2;2;3;1;4
293;22.12.2015;2015;12;09;Tiistai;3;2;5;1;1;2
293;22.12.2015;2015;12;10;Tiistai;4;0;4;2;2;4
293;22.12.2015;2015;12;11;Tiistai;4;3;7;2;0;2
293;22.12.2015;2015;12;12;Tiistai;6;5;11;3;4;7
293;22.12.2015;2015;12;13;Tiistai;6;3;9;5;3;8
293;22.12.2015;2015;12;14;Tiistai;4;2;6;5;5;10
293;22.12.2015;2015;12;15;Tiistai;4;9;13;2;2;4
293;22.12.2015;2015;12;16;Tiistai;8;7;15;3;6;9
293;22.12.2015;2015;12;17;Tiistai;13;3;16;10;2;12
293;22.12.2015;2015;12;18;Tiistai;3;5;8;7;4;11
293;22.12.2015;2015;12;19;Tiistai;7;8;15;1;7;8
293;22.12.2015;2015;12;20;Tiistai;2;8;10;1;3;4
293;22.12.2015;2015;12;21;Tiistai;1;2;3;1;1;2
293;22.12.2015;2015;12;22;Tiistai;0;0;0;2;1;3
293;22.12.2015;2015;12;23;Tiistai;1;1;2;0;0;0
293;23.12.2015;2015;12;00;Keskiviikko;0;2;2;0;0;0
293;23.12.2015;2015;12;01;Keskiviikko;0;0;0;0;0;0
293;23.12.2015;2015;12;02;Keskiviikko;0;0;0;0;0;0
293;23.12.2015;2015;12;03;Keskiviikko;0;0;0;0;0;0
293;23.12.2015;2015;12;04;Keskiviikko;0;0;0;0;0;0
293;23.12.2015;2015;12;05;Keskiviikko;0;0;0;0;0;0
293;23.12.2015;2015;12;06;Keskiviikko;3;1;4;2;0;2
293;23.12.2015;2015;12;07;Keskiviikko;3;0;3;2;1;3
293;23.12.2015;2015;12;08;Keskiviikko;3;1;4;2;2;4
293;23.12.2015;2015;12;09;Keskiviikko;2;2;4;6;2;8
293;23.12.2015;2015;12;10;Keskiviikko;5;3;8;2;2;4
293;23.12.2015;2015;12;11;Keskiviikko;5;5;10;4;4;8
293;23.12.2015;2015;12;12;Keskiviikko;4;5;9;3;4;7
293;23.12.2015;2015;12;13;Keskiviikko;3;1;4;6;2;8
293;23.12.2015;2015;12;14;Keskiviikko;2;6;8;6;11;17
293;23.12.2015;2015;12;15;Keskiviikko;7;2;9;3;5;8
293;23.12.2015;2015;12;16;Keskiviikko;5;8;13;5;6;11
293;23.12.2015;2015;12;17;Keskiviikko;3;5;8;9;8;17
293;23.12.2015;2015;12;18;Keskiviikko;2;2;4;7;8;15
293;23.12.2015;2015;12;19;Keskiviikko;2;2;4;2;4;6
293;23.12.2015;2015;12;20;Keskiviikko;2;2;4;2;3;5
293;23.12.2015;2015;12;21;Keskiviikko;1;0;1;2;3;5
293;23.12.2015;2015;12;22;Keskiviikko;0;0;0;0;0;0
293;23.12.2015;2015;12;23;Keskiviikko;0;2;2;0;0;0
293;24.12.2015;2015;12;00;Torstai;0;0;0;0;1;1
293;24.12.2015;2015;12;01;Torstai;0;0;0;0;3;3
293;24.12.2015;2015;12;02;Torstai;0;0;0;0;0;0
293;24.12.2015;2015;12;03;Torstai;0;0;0;0;0;0
293;24.12.2015;2015;12;04;Torstai;0;0;0;0;0;0
293;24.12.2015;2015;12;05;Torstai;0;0;0;0;0;0
293;24.12.2015;2015;12;06;Torstai;0;0;0;0;0;0
293;24.12.2015;2015;12;07;Torstai;1;0;1;0;2;2
293;24.12.2015;2015;12;08;Torstai;2;0;2;2;0;2
293;24.12.2015;2015;12;09;Torstai;1;1;2;5;2;7
293;24.12.2015;2015;12;10;Torstai;1;3;4;6;1;7
293;24.12.2015;2015;12;11;Torstai;2;1;3;7;9;16
293;24.12.2015;2015;12;12;Torstai;2;1;3;0;3;3
293;24.12.2015;2015;12;13;Torstai;0;3;3;13;8;21
293;24.12.2015;2015;12;14;Torstai;1;1;2;8;7;15
293;24.12.2015;2015;12;15;Torstai;1;0;1;13;8;21
293;24.12.2015;2015;12;16;Torstai;0;0;0;2;6;8
293;24.12.2015;2015;12;17;Torstai;1;0;1;4;6;10
293;24.12.2015;2015;12;18;Torstai;3;5;8;5;5;10
293;24.12.2015;2015;12;19;Torstai;1;1;2;5;5;10
293;24.12.2015;2015;12;20;Torstai;0;0;0;3;3;6
293;24.12.2015;2015;12;21;Torstai;0;0;0;3;3;6
293;24.12.2015;2015;12;22;Torstai;0;0;0;6;2;8
293;24.12.2015;2015;12;23;Torstai;0;0;0;0;1;1
293;25.12.2015;2015;12;00;Perjantai;0;0;0;3;2;5
293;25.12.2015;2015;12;01;Perjantai;0;0;0;0;0;0
293;25.12.2015;2015;12;02;Perjantai;0;0;0;0;2;2
293;25.12.2015;2015;12;03;Perjantai;0;0;0;0;3;3
293;25.12.2015;2015;12;04;Perjantai;0;0;0;0;0;0
293;25.12.2015;2015;12;05;Perjantai;0;0;0;0;0;0
293;25.12.2015;2015;12;06;Perjantai;0;0;0;2;0;2
293;25.12.2015;2015;12;07;Perjantai;0;0;0;0;1;1
293;25.12.2015;2015;12;08;Perjantai;0;0;0;1;1;2
293;25.12.2015;2015;12;09;Perjantai;0;0;0;0;1;1
293;25.12.2015;2015;12;10;Perjantai;1;0;1;8;4;12
293;25.12.2015;2015;12;11;Perjantai;2;3;5;4;4;8
293;25.12.2015;2015;12;12;Perjantai;0;1;1;2;3;5
293;25.12.2015;2015;12;13;Perjantai;1;0;1;5;1;6
293;25.12.2015;2015;12;14;Perjantai;3;3;6;7;6;13
293;25.12.2015;2015;12;15;Perjantai;1;1;2;6;9;15
293;25.12.2015;2015;12;16;Perjantai;0;0;0;4;4;8
293;25.12.2015;2015;12;17;Perjantai;1;4;5;4;4;8
293;25.12.2015;2015;12;18;Perjantai;6;3;9;4;7;11
293;25.12.2015;2015;12;19;Perjantai;7;2;9;1;1;2
293;25.12.2015;2015;12;20;Perjantai;0;1;1;1;1;2
293;25.12.2015;2015;12;21;Perjantai;0;1;1;0;0;0
293;25.12.2015;2015;12;22;Perjantai;0;0;0;1;0;1
293;25.12.2015;2015;12;23;Perjantai;0;0;0;0;6;6
293;26.12.2015;2015;12;00;Lauantai;0;0;0;2;0;2
293;26.12.2015;2015;12;01;Lauantai;0;2;2;0;0;0
293;26.12.2015;2015;12;02;Lauantai;0;0;0;0;0;0
293;26.12.2015;2015;12;03;Lauantai;0;0;0;0;0;0
293;26.12.2015;2015;12;04;Lauantai;0;0;0;0;0;0
293;26.12.2015;2015;12;05;Lauantai;0;0;0;1;1;2
293;26.12.2015;2015;12;06;Lauantai;1;1;2;1;0;1
293;26.12.2015;2015;12;07;Lauantai;0;0;0;1;0;1
293;26.12.2015;2015;12;08;Lauantai;0;0;0;2;3;5
293;26.12.2015;2015;12;09;Lauantai;0;0;0;2;2;4
293;26.12.2015;2015;12;10;Lauantai;1;4;5;8;4;12
293;26.12.2015;2015;12;11;Lauantai;3;2;5;9;10;19
293;26.12.2015;2015;12;12;Lauantai;8;2;10;12;10;22
293;26.12.2015;2015;12;13;Lauantai;2;2;4;5;9;14
293;26.12.2015;2015;12;14;Lauantai;3;3;6;5;4;9
293;26.12.2015;2015;12;15;Lauantai;1;2;3;4;5;9
293;26.12.2015;2015;12;16;Lauantai;3;1;4;1;1;2
293;26.12.2015;2015;12;17;Lauantai;0;0;0;4;3;7
293;26.12.2015;2015;12;18;Lauantai;1;3;4;5;2;7
293;26.12.2015;2015;12;19;Lauantai;0;1;1;3;3;6
293;26.12.2015;2015;12;20;Lauantai;1;1;2;3;1;4
293;26.12.2015;2015;12;21;Lauantai;0;2;2;1;2;3
293;26.12.2015;2015;12;22;Lauantai;0;1;1;2;0;2
293;26.12.2015;2015;12;23;Lauantai;0;0;0;0;0;0
293;27.12.2015;2015;12;00;Sunnuntai;2;0;2;0;0;0
293;27.12.2015;2015;12;01;Sunnuntai;1;0;1;0;1;1
293;27.12.2015;2015;12;02;Sunnuntai;0;0;0;0;1;1
293;27.12.2015;2015;12;03;Sunnuntai;0;0;0;0;3;3
293;27.12.2015;2015;12;04;Sunnuntai;0;1;1;0;1;1
293;27.12.2015;2015;12;05;Sunnuntai;0;0;0;1;0;1
293;27.12.2015;2015;12;06;Sunnuntai;0;0;0;2;1;3
293;27.12.2015;2015;12;07;Sunnuntai;0;0;0;1;1;2
293;27.12.2015;2015;12;08;Sunnuntai;0;0;0;0;0;0
293;27.12.2015;2015;12;09;Sunnuntai;0;0;0;5;2;7
293;27.12.2015;2015;12;10;Sunnuntai;2;2;4;3;2;5
293;27.12.2015;2015;12;11;Sunnuntai;2;2;4;13;7;20
293;27.12.2015;2015;12;12;Sunnuntai;3;2;5;13;9;22
293;27.12.2015;2015;12;13;Sunnuntai;5;1;6;7;16;23
293;27.12.2015;2015;12;14;Sunnuntai;6;4;10;10;9;19
293;27.12.2015;2015;12;15;Sunnuntai;2;6;8;11;9;20
293;27.12.2015;2015;12;16;Sunnuntai;8;5;13;6;5;11
293;27.12.2015;2015;12;17;Sunnuntai;4;8;12;7;5;12
293;27.12.2015;2015;12;18;Sunnuntai;2;4;6;5;7;12
293;27.12.2015;2015;12;19;Sunnuntai;5;3;8;5;2;7
293;27.12.2015;2015;12;20;Sunnuntai;5;5;10;5;2;7
293;27.12.2015;2015;12;21;Sunnuntai;1;1;2;2;1;3
293;27.12.2015;2015;12;22;Sunnuntai;2;3;5;0;2;2
293;27.12.2015;2015;12;23;Sunnuntai;0;0;0;0;1;1
293;28.12.2015;2015;12;00;Maanantai;0;1;1;2;0;2
293;28.12.2015;2015;12;01;Maanantai;0;0;0;1;0;1
293;28.12.2015;2015;12;02;Maanantai;0;0;0;0;0;0
293;28.12.2015;2015;12;03;Maanantai;0;0;0;0;0;0
293;28.12.2015;2015;12;04;Maanantai;0;0;0;0;0;0
293;28.12.2015;2015;12;05;Maanantai;3;0;3;0;0;0
293;28.12.2015;2015;12;06;Maanantai;1;0;1;2;0;2
293;28.12.2015;2015;12;07;Maanantai;1;0;1;3;1;4
293;28.12.2015;2015;12;08;Maanantai;4;0;4;1;2;3
293;28.12.2015;2015;12;09;Maanantai;0;1;1;3;2;5
293;28.12.2015;2015;12;10;Maanantai;1;2;3;5;3;8
293;28.12.2015;2015;12;11;Maanantai;2;4;6;8;2;10
293;28.12.2015;2015;12;12;Maanantai;13;2;15;6;9;15
293;28.12.2015;2015;12;13;Maanantai;3;4;7;13;7;20
293;28.12.2015;2015;12;14;Maanantai;2;7;9;1;5;6
293;28.12.2015;2015;12;15;Maanantai;3;5;8;3;4;7
293;28.12.2015;2015;12;16;Maanantai;4;4;8;3;7;10
293;28.12.2015;2015;12;17;Maanantai;3;0;3;7;13;20
293;28.12.2015;2015;12;18;Maanantai;2;3;5;9;8;17
293;28.12.2015;2015;12;19;Maanantai;2;1;3;2;7;9
293;28.12.2015;2015;12;20;Maanantai;3;6;9;0;2;2
293;28.12.2015;2015;12;21;Maanantai;0;0;0;2;2;4
293;28.12.2015;2015;12;22;Maanantai;0;0;0;1;1;2
293;28.12.2015;2015;12;23;Maanantai;1;1;2;1;0;1
293;29.12.2015;2015;12;00;Tiistai;0;3;3;1;1;2
293;29.12.2015;2015;12;01;Tiistai;0;0;0;0;0;0
293;29.12.2015;2015;12;02;Tiistai;0;0;0;0;0;0
293;29.12.2015;2015;12;03;Tiistai;0;0;0;0;0;0
293;29.12.2015;2015;12;04;Tiistai;0;0;0;0;0;0
293;29.12.2015;2015;12;05;Tiistai;1;0;1;1;0;1
293;29.12.2015;2015;12;06;Tiistai;3;0;3;2;0;2
293;29.12.2015;2015;12;07;Tiistai;1;0;1;3;1;4
293;29.12.2015;2015;12;08;Tiistai;1;0;1;1;1;2
293;29.12.2015;2015;12;09;Tiistai;2;2;4;2;4;6
293;29.12.2015;2015;12;10;Tiistai;0;1;1;4;4;8
293;29.12.2015;2015;12;11;Tiistai;3;2;5;9;3;12
293;29.12.2015;2015;12;12;Tiistai;3;1;4;8;6;14
293;29.12.2015;2015;12;13;Tiistai;3;6;9;8;8;16
293;29.12.2015;2015;12;14;Tiistai;1;4;5;2;5;7
293;29.12.2015;2015;12;15;Tiistai;3;6;9;6;8;14
293;29.12.2015;2015;12;16;Tiistai;3;0;3;6;7;13
293;29.12.2015;2015;12;17;Tiistai;7;3;10;3;6;9
293;29.12.2015;2015;12;18;Tiistai;2;4;6;5;6;11
293;29.12.2015;2015;12;19;Tiistai;3;4;7;4;6;10
293;29.12.2015;2015;12;20;Tiistai;3;0;3;2;1;3
293;29.12.2015;2015;12;21;Tiistai;2;6;8;2;3;5
293;29.12.2015;2015;12;22;Tiistai;2;4;6;0;1;1
293;29.12.2015;2015;12;23;Tiistai;4;1;5;1;0;1
293;30.12.2015;2015;12;00;Keskiviikko;0;0;0;0;1;1
293;30.12.2015;2015;12;01;Keskiviikko;0;1;1;0;0;0
293;30.12.2015;2015;12;02;Keskiviikko;0;0;0;0;0;0
293;30.12.2015;2015;12;03;Keskiviikko;0;0;0;0;0;0
293;30.12.2015;2015;12;04;Keskiviikko;0;0;0;0;0;0
293;30.12.2015;2015;12;05;Keskiviikko;3;0;3;1;0;1
293;30.12.2015;2015;12;06;Keskiviikko;0;1;1;3;0;3
293;30.12.2015;2015;12;07;Keskiviikko;0;2;2;4;1;5
293;30.12.2015;2015;12;08;Keskiviikko;3;0;3;0;2;2
293;30.12.2015;2015;12;09;Keskiviikko;1;2;3;4;2;6
293;30.12.2015;2015;12;10;Keskiviikko;3;2;5;8;5;13
293;30.12.2015;2015;12;11;Keskiviikko;3;4;7;4;7;11
293;30.12.2015;2015;12;12;Keskiviikko;4;5;9;6;8;14
293;30.12.2015;2015;12;13;Keskiviikko;11;2;13;5;3;8
293;30.12.2015;2015;12;14;Keskiviikko;6;9;15;2;8;10
293;30.12.2015;2015;12;15;Keskiviikko;3;7;10;10;7;17
293;30.12.2015;2015;12;16;Keskiviikko;10;9;19;4;9;13
293;30.12.2015;2015;12;17;Keskiviikko;17;9;26;4;8;12
293;30.12.2015;2015;12;18;Keskiviikko;4;7;11;3;2;5
293;30.12.2015;2015;12;19;Keskiviikko;2;5;7;2;3;5
293;30.12.2015;2015;12;20;Keskiviikko;0;1;1;3;2;5
293;30.12.2015;2015;12;21;Keskiviikko;2;4;6;2;2;4
293;30.12.2015;2015;12;22;Keskiviikko;1;2;3;0;0;0
293;30.12.2015;2015;12;23;Keskiviikko;0;1;1;0;0;0
293;31.12.2015;2015;12;00;Torstai;1;0;1;0;1;1
293;31.12.2015;2015;12;01;Torstai;0;1;1;0;0;0
293;31.12.2015;2015;12;02;Torstai;0;0;0;0;2;2
293;31.12.2015;2015;12;03;Torstai;0;0;0;0;0;0
293;31.12.2015;2015;12;04;Torstai;0;0;0;0;0;0
293;31.12.2015;2015;12;05;Torstai;1;0;1;0;0;0
293;31.12.2015;2015;12;06;Torstai;4;0;4;4;0;4
293;31.12.2015;2015;12;07;Torstai;1;4;5;2;0;2
293;31.12.2015;2015;12;08;Torstai;2;1;3;2;2;4
293;31.12.2015;2015;12;09;Torstai;2;4;6;2;1;3
293;31.12.2015;2015;12;10;Torstai;4;3;7;8;3;11
293;31.12.2015;2015;12;11;Torstai;2;1;3;4;3;7
293;31.12.2015;2015;12;12;Torstai;8;9;17;7;8;15
293;31.12.2015;2015;12;13;Torstai;8;6;14;15;8;23
293;31.12.2015;2015;12;14;Torstai;7;7;14;12;12;24
293;31.12.2015;2015;12;15;Torstai;2;7;9;6;10;16
293;31.12.2015;2015;12;16;Torstai;6;3;9;4;4;8
293;31.12.2015;2015;12;17;Torstai;4;9;13;5;8;13
293;31.12.2015;2015;12;18;Torstai;5;5;10;1;2;3
293;31.12.2015;2015;12;19;Torstai;2;4;6;0;1;1
293;31.12.2015;2015;12;20;Torstai;2;4;6;2;1;3
293;31.12.2015;2015;12;21;Torstai;5;5;10;0;2;2
293;31.12.2015;2015;12;22;Torstai;0;2;2;2;1;3
293;31.12.2015;2015;12;23;Torstai;0;2;2;7;16;23
293;01.01.2016;2016;01;00;Perjantai;6;1;7;6;4;10
293;01.01.2016;2016;01;01;Perjantai;3;5;8;6;4;10
293;01.01.2016;2016;01;02;Perjantai;6;1;7;2;1;3
293;01.01.2016;2016;01;03;Perjantai;0;1;1;2;8;10
293;01.01.2016;2016;01;04;Perjantai;1;0;1;4;5;9
293;01.01.2016;2016;01;05;Perjantai;0;2;2;3;2;5
293;01.01.2016;2016;01;06;Perjantai;1;1;2;2;0;2
293;01.01.2016;2016;01;07;Perjantai;0;0;0;0;0;0
293;01.01.2016;2016;01;08;Perjantai;0;0;0;2;2;4
293;01.01.2016;2016;01;09;Perjantai;2;1;3;3;1;4
293;01.01.2016;2016;01;10;Perjantai;1;1;2;1;6;7
293;01.01.2016;2016;01;11;Perjantai;1;3;4;6;1;7
293;01.01.2016;2016;01;12;Perjantai;1;2;3;7;6;13
293;01.01.2016;2016;01;13;Perjantai;3;4;7;3;6;9
293;01.01.2016;2016;01;14;Perjantai;3;2;5;2;10;12
293;01.01.2016;2016;01;15;Perjantai;1;3;4;5;9;14
293;01.01.2016;2016;01;16;Perjantai;2;7;9;3;7;10
293;01.01.2016;2016;01;17;Perjantai;3;5;8;6;1;7
293;01.01.2016;2016;01;18;Perjantai;6;5;11;5;3;8
293;01.01.2016;2016;01;19;Perjantai;9;2;11;3;0;3
293;01.01.2016;2016;01;20;Perjantai;3;7;10;4;4;8
293;01.01.2016;2016;01;21;Perjantai;2;4;6;2;2;4
293;01.01.2016;2016;01;22;Perjantai;0;4;4;0;0;0
293;01.01.2016;2016;01;23;Perjantai;4;2;6;0;0;0
293;02.01.2016;2016;01;00;Lauantai;0;0;0;0;1;1
293;02.01.2016;2016;01;01;Lauantai;0;0;0;0;0;0
293;02.01.2016;2016;01;02;Lauantai;0;0;0;0;0;0
293;02.01.2016;2016;01;03;Lauantai;2;0;2;0;0;0
293;02.01.2016;2016;01;04;Lauantai;0;0;0;0;0;0
293;02.01.2016;2016;01;05;Lauantai;1;0;1;0;0;0
293;02.01.2016;2016;01;06;Lauantai;0;0;0;0;1;1
293;02.01.2016;2016;01;07;Lauantai;0;0;0;0;0;0
293;02.01.2016;2016;01;08;Lauantai;3;0;3;2;0;2
293;02.01.2016;2016;01;09;Lauantai;1;3;4;0;3;3
293;02.01.2016;2016;01;10;Lauantai;2;3;5;2;1;3
293;02.01.2016;2016;01;11;Lauantai;2;3;5;4;6;10
293;02.01.2016;2016;01;12;Lauantai;0;0;0;9;2;11
293;02.01.2016;2016;01;13;Lauantai;2;3;5;7;12;19
293;02.01.2016;2016;01;14;Lauantai;2;1;3;5;3;8
293;02.01.2016;2016;01;15;Lauantai;4;5;9;2;5;7
293;02.01.2016;2016;01;16;Lauantai;3;0;3;4;3;7
293;02.01.2016;2016;01;17;Lauantai;1;4;5;4;7;11
293;02.01.2016;2016;01;18;Lauantai;2;2;4;0;0;0
293;02.01.2016;2016;01;19;Lauantai;1;2;3;2;1;3
293;02.01.2016;2016;01;20;Lauantai;3;7;10;0;0;0
293;02.01.2016;2016;01;21;Lauantai;2;0;2;1;2;3
293;02.01.2016;2016;01;22;Lauantai;0;0;0;1;1;2
293;02.01.2016;2016;01;23;Lauantai;2;1;3;0;0;0
293;03.01.2016;2016;01;00;Sunnuntai;0;1;1;0;0;0
293;03.01.2016;2016;01;01;Sunnuntai;0;0;0;0;0;0
293;03.01.2016;2016;01;02;Sunnuntai;1;0;1;0;1;1
293;03.01.2016;2016;01;03;Sunnuntai;0;0;0;0;0;0
293;03.01.2016;2016;01;04;Sunnuntai;0;0;0;0;0;0
293;03.01.2016;2016;01;05;Sunnuntai;0;0;0;1;1;2
293;03.01.2016;2016;01;06;Sunnuntai;0;0;0;0;0;0
293;03.01.2016;2016;01;07;Sunnuntai;0;0;0;0;0;0
293;03.01.2016;2016;01;08;Sunnuntai;0;0;0;1;1;2
293;03.01.2016;2016;01;09;Sunnuntai;3;0;3;3;3;6
293;03.01.2016;2016;01;10;Sunnuntai;0;7;7;3;3;6
293;03.01.2016;2016;01;11;Sunnuntai;13;4;17;4;5;9
293;03.01.2016;2016;01;12;Sunnuntai;5;2;7;4;5;9
293;03.01.2016;2016;01;13;Sunnuntai;6;10;16;14;8;22
293;03.01.2016;2016;01;14;Sunnuntai;10;4;14;10;12;22
293;03.01.2016;2016;01;15;Sunnuntai;8;7;15;10;4;14
293;03.01.2016;2016;01;16;Sunnuntai;7;3;10;3;6;9
293;03.01.2016;2016;01;17;Sunnuntai;4;3;7;6;6;12
293;03.01.2016;2016;01;18;Sunnuntai;1;1;2;1;4;5
293;03.01.2016;2016;01;19;Sunnuntai;3;1;4;7;8;15
293;03.01.2016;2016;01;20;Sunnuntai;0;7;7;2;2;4
293;03.01.2016;2016;01;21;Sunnuntai;0;2;2;0;2;2
293;03.01.2016;2016;01;22;Sunnuntai;0;0;0;0;2;2
293;03.01.2016;2016;01;23;Sunnuntai;0;1;1;0;0;0
293;04.01.2016;2016;01;00;Maanantai;0;0;0;0;0;0
293;04.01.2016;2016;01;01;Maanantai;0;0;0;0;0;0
293;04.01.2016;2016;01;02;Maanantai;0;0;0;0;0;0
293;04.01.2016;2016;01;03;Maanantai;0;0;0;0;0;0
293;04.01.2016;2016;01;04;Maanantai;0;0;0;0;0;0
293;04.01.2016;2016;01;05;Maanantai;1;0;1;0;0;0
293;04.01.2016;2016;01;06;Maanantai;2;2;4;3;0;3
293;04.01.2016;2016;01;07;Maanantai;4;1;5;4;2;6
293;04.01.2016;2016;01;08;Maanantai;4;1;5;5;1;6
293;04.01.2016;2016;01;09;Maanantai;1;2;3;4;6;10
293;04.01.2016;2016;01;10;Maanantai;1;2;3;7;5;12
293;04.01.2016;2016;01;11;Maanantai;2;2;4;4;2;6
293;04.01.2016;2016;01;12;Maanantai;1;3;4;7;6;13
293;04.01.2016;2016;01;13;Maanantai;6;0;6;3;3;6
293;04.01.2016;2016;01;14;Maanantai;5;6;11;4;7;11
293;04.01.2016;2016;01;15;Maanantai;4;7;11;3;5;8
293;04.01.2016;2016;01;16;Maanantai;2;4;6;6;4;10
293;04.01.2016;2016;01;17;Maanantai;6;4;10;3;6;9
293;04.01.2016;2016;01;18;Maanantai;1;4;5;3;3;6
293;04.01.2016;2016;01;19;Maanantai;0;2;2;4;5;9
293;04.01.2016;2016;01;20;Maanantai;0;5;5;3;1;4
293;04.01.2016;2016;01;21;Maanantai;1;1;2;0;0;0
293;04.01.2016;2016;01;22;Maanantai;0;0;0;0;0;0
293;04.01.2016;2016;01;23;Maanantai;0;0;0;0;1;1
293;05.01.2016;2016;01;00;Tiistai;0;0;0;0;0;0
293;05.01.2016;2016;01;01;Tiistai;1;0;1;0;0;0
293;05.01.2016;2016;01;02;Tiistai;1;0;1;0;0;0
293;05.01.2016;2016;01;03;Tiistai;0;0;0;0;0;0
293;05.01.2016;2016;01;04;Tiistai;0;0;0;0;0;0
293;05.01.2016;2016;01;05;Tiistai;2;0;2;0;0;0
293;05.01.2016;2016;01;06;Tiistai;6;2;8;1;0;1
293;05.01.2016;2016;01;07;Tiistai;3;2;5;6;1;7
293;05.01.2016;2016;01;08;Tiistai;1;1;2;3;2;5
293;05.01.2016;2016;01;09;Tiistai;3;1;4;4;3;7
293;05.01.2016;2016;01;10;Tiistai;2;3;5;2;1;3
293;05.01.2016;2016;01;11;Tiistai;2;3;5;1;1;2
293;05.01.2016;2016;01;12;Tiistai;5;4;9;4;3;7
293;05.01.2016;2016;01;13;Tiistai;2;3;5;2;4;6
293;05.01.2016;2016;01;14;Tiistai;4;10;14;5;6;11
293;05.01.2016;2016;01;15;Tiistai;4;1;5;0;7;7
293;05.01.2016;2016;01;16;Tiistai;5;3;8;3;4;7
293;05.01.2016;2016;01;17;Tiistai;0;1;1;1;1;2
293;05.01.2016;2016;01;18;Tiistai;0;3;3;0;1;1
293;05.01.2016;2016;01;19;Tiistai;4;4;8;2;2;4
293;05.01.2016;2016;01;20;Tiistai;1;0;1;0;0;0
293;05.01.2016;2016;01;21;Tiistai;1;3;4;0;1;1
293;05.01.2016;2016;01;22;Tiistai;0;0;0;0;0;0
293;05.01.2016;2016;01;23;Tiistai;0;0;0;1;0;1
293;06.01.2016;2016;01;00;Keskiviikko;0;0;0;0;0;0
293;06.01.2016;2016;01;01;Keskiviikko;0;1;1;0;0;0
293;06.01.2016;2016;01;02;Keskiviikko;0;0;0;0;0;0
293;06.01.2016;2016;01;03;Keskiviikko;0;0;0;0;2;2
293;06.01.2016;2016;01;04;Keskiviikko;0;0;0;0;1;1
293;06.01.2016;2016;01;05;Keskiviikko;0;0;0;1;0;1
293;06.01.2016;2016;01;06;Keskiviikko;0;0;0;0;1;1
293;06.01.2016;2016;01;07;Keskiviikko;0;0;0;0;0;0
293;06.01.2016;2016;01;08;Keskiviikko;1;0;1;0;0;0
293;06.01.2016;2016;01;09;Keskiviikko;3;0;3;3;1;4
293;06.01.2016;2016;01;10;Keskiviikko;2;1;3;1;1;2
293;06.01.2016;2016;01;11;Keskiviikko;0;2;2;0;0;0
293;06.01.2016;2016;01;12;Keskiviikko;0;2;2;5;3;8
293;06.01.2016;2016;01;13;Keskiviikko;1;1;2;2;2;4
293;06.01.2016;2016;01;14;Keskiviikko;2;1;3;1;2;3
293;06.01.2016;2016;01;15;Keskiviikko;3;2;5;7;1;8
293;06.01.2016;2016;01;16;Keskiviikko;0;1;1;3;7;10
293;06.01.2016;2016;01;17;Keskiviikko;2;1;3;0;7;7
293;06.01.2016;2016;01;18;Keskiviikko;0;0;0;0;2;2
293;06.01.2016;2016;01;19;Keskiviikko;0;1;1;0;0;0
293;06.01.2016;2016;01;20;Keskiviikko;0;1;1;1;0;1
293;06.01.2016;2016;01;21;Keskiviikko;0;0;0;0;1;1
293;06.01.2016;2016;01;22;Keskiviikko;0;1;1;1;0;1
293;06.01.2016;2016;01;23;Keskiviikko;0;0;0;0;0;0
293;07.01.2016;2016;01;00;Torstai;0;0;0;0;0;0
293;07.01.2016;2016;01;01;Torstai;0;0;0;0;0;0
293;07.01.2016;2016;01;02;Torstai;0;0;0;0;0;0
293;07.01.2016;2016;01;03;Torstai;0;0;0;0;0;0
293;07.01.2016;2016;01;04;Torstai;0;0;0;0;0;0
293;07.01.2016;2016;01;05;Torstai;1;0;1;0;0;0
293;07.01.2016;2016;01;06;Torstai;1;1;2;2;0;2
293;07.01.2016;2016;01;07;Torstai;28;0;28;17;1;18
293;07.01.2016;2016;01;08;Torstai;25;2;27;11;2;13
293;07.01.2016;2016;01;09;Torstai;13;3;16;6;3;9
293;07.01.2016;2016;01;10;Torstai;1;0;1;5;1;6
293;07.01.2016;2016;01;11;Torstai;1;1;2;0;2;2
293;07.01.2016;2016;01;12;Torstai;0;1;1;3;2;5
293;07.01.2016;2016;01;13;Torstai;2;8;10;4;5;9
293;07.01.2016;2016;01;14;Torstai;2;26;28;5;13;18
293;07.01.2016;2016;01;15;Torstai;2;28;30;2;17;19
293;07.01.2016;2016;01;16;Torstai;1;3;4;2;7;9
293;07.01.2016;2016;01;17;Torstai;2;0;2;1;5;6
293;07.01.2016;2016;01;18;Torstai;1;1;2;3;4;7
293;07.01.2016;2016;01;19;Torstai;0;0;0;1;4;5
293;07.01.2016;2016;01;20;Torstai;0;1;1;0;1;1
293;07.01.2016;2016;01;21;Torstai;0;0;0;0;1;1
293;07.01.2016;2016;01;22;Torstai;0;0;0;0;0;0
293;07.01.2016;2016;01;23;Torstai;0;0;0;0;0;0
293;08.01.2016;2016;01;00;Perjantai;0;0;0;0;0;0
293;08.01.2016;2016;01;01;Perjantai;0;0;0;0;0;0
293;08.01.2016;2016;01;02;Perjantai;0;0;0;0;0;0
293;08.01.2016;2016;01;03;Perjantai;0;0;0;0;0;0
293;08.01.2016;2016;01;04;Perjantai;0;0;0;0;0;0
293;08.01.2016;2016;01;05;Perjantai;1;0;1;3;0;3
293;08.01.2016;2016;01;06;Perjantai;2;1;3;6;1;7
293;08.01.2016;2016;01;07;Perjantai;29;3;32;19;1;20
293;08.01.2016;2016;01;08;Perjantai;23;2;25;11;1;12
293;08.01.2016;2016;01;09;Perjantai;11;1;12;9;1;10
293;08.01.2016;2016;01;10;Perjantai;3;3;6;3;1;4
293;08.01.2016;2016;01;11;Perjantai;3;3;6;3;3;6
293;08.01.2016;2016;01;12;Perjantai;1;7;8;2;8;10
293;08.01.2016;2016;01;13;Perjantai;3;12;15;5;7;12
293;08.01.2016;2016;01;14;Perjantai;1;25;26;5;10;15
293;08.01.2016;2016;01;15;Perjantai;4;18;22;5;13;18
293;08.01.2016;2016;01;16;Perjantai;4;5;9;2;6;8
293;08.01.2016;2016;01;17;Perjantai;4;1;5;6;4;10
293;08.01.2016;2016;01;18;Perjantai;2;5;7;3;5;8
293;08.01.2016;2016;01;19;Perjantai;2;0;2;4;3;7
293;08.01.2016;2016;01;20;Perjantai;7;2;9;0;4;4
293;08.01.2016;2016;01;21;Perjantai;0;6;6;0;1;1
293;08.01.2016;2016;01;22;Perjantai;0;0;0;1;2;3
293;08.01.2016;2016;01;23;Perjantai;1;2;3;0;0;0
293;09.01.2016;2016;01;00;Lauantai;0;0;0;0;0;0
293;09.01.2016;2016;01;01;Lauantai;0;1;1;0;0;0
293;09.01.2016;2016;01;02;Lauantai;0;0;0;0;1;1
293;09.01.2016;2016;01;03;Lauantai;0;0;0;0;0;0
293;09.01.2016;2016;01;04;Lauantai;0;0;0;0;0;0
293;09.01.2016;2016;01;05;Lauantai;0;0;0;0;0;0
293;09.01.2016;2016;01;06;Lauantai;0;0;0;0;0;0
293;09.01.2016;2016;01;07;Lauantai;0;0;0;0;0;0
293;09.01.2016;2016;01;08;Lauantai;2;0;2;1;2;3
293;09.01.2016;2016;01;09;Lauantai;0;2;2;1;1;2
293;09.01.2016;2016;01;10;Lauantai;2;1;3;4;2;6
293;09.01.2016;2016;01;11;Lauantai;3;1;4;3;4;7
293;09.01.2016;2016;01;12;Lauantai;5;4;9;8;5;13
293;09.01.2016;2016;01;13;Lauantai;5;1;6;4;7;11
293;09.01.2016;2016;01;14;Lauantai;3;3;6;7;8;15
293;09.01.2016;2016;01;15;Lauantai;1;4;5;7;10;17
293;09.01.2016;2016;01;16;Lauantai;3;5;8;2;8;10
293;09.01.2016;2016;01;17;Lauantai;3;2;5;2;5;7
293;09.01.2016;2016;01;18;Lauantai;0;1;1;4;11;15
293;09.01.2016;2016;01;19;Lauantai;1;1;2;1;1;2
293;09.01.2016;2016;01;20;Lauantai;0;0;0;2;2;4
293;09.01.2016;2016;01;21;Lauantai;0;3;3;2;1;3
293;09.01.2016;2016;01;22;Lauantai;1;1;2;0;2;2
293;09.01.2016;2016;01;23;Lauantai;0;0;0;0;0;0
293;10.01.2016;2016;01;00;Sunnuntai;0;0;0;1;1;2
293;10.01.2016;2016;01;01;Sunnuntai;0;0;0;0;1;1
293;10.01.2016;2016;01;02;Sunnuntai;0;0;0;0;1;1
293;10.01.2016;2016;01;03;Sunnuntai;0;0;0;0;0;0
293;10.01.2016;2016;01;04;Sunnuntai;0;0;0;0;1;1
293;10.01.2016;2016;01;05;Sunnuntai;0;0;0;0;0;0
293;10.01.2016;2016;01;06;Sunnuntai;0;0;0;0;0;0
293;10.01.2016;2016;01;07;Sunnuntai;0;0;0;0;0;0
293;10.01.2016;2016;01;08;Sunnuntai;0;0;0;2;1;3
293;10.01.2016;2016;01;09;Sunnuntai;1;1;2;1;2;3
293;10.01.2016;2016;01;10;Sunnuntai;4;0;4;3;0;3
293;10.01.2016;2016;01;11;Sunnuntai;3;0;3;1;3;4
293;10.01.2016;2016;01;12;Sunnuntai;1;4;5;7;6;13
293;10.01.2016;2016;01;13;Sunnuntai;4;2;6;5;4;9
293;10.01.2016;2016;01;14;Sunnuntai;1;1;2;9;14;23
293;10.01.2016;2016;01;15;Sunnuntai;0;3;3;9;6;15
293;10.01.2016;2016;01;16;Sunnuntai;4;2;6;7;12;19
293;10.01.2016;2016;01;17;Sunnuntai;2;2;4;4;6;10
293;10.01.2016;2016;01;18;Sunnuntai;4;2;6;5;5;10
293;10.01.2016;2016;01;19;Sunnuntai;3;0;3;2;5;7
293;10.01.2016;2016;01;20;Sunnuntai;2;2;4;4;3;7
293;10.01.2016;2016;01;21;Sunnuntai;0;2;2;0;0;0
293;10.01.2016;2016;01;22;Sunnuntai;0;0;0;0;0;0
293;10.01.2016;2016;01;23;Sunnuntai;0;0;0;1;1;2
293;11.01.2016;2016;01;00;Maanantai;0;0;0;0;0;0
293;11.01.2016;2016;01;01;Maanantai;0;0;0;0;0;0
293;11.01.2016;2016;01;02;Maanantai;0;0;0;0;0;0
293;11.01.2016;2016;01;03;Maanantai;0;0;0;1;0;1
293;11.01.2016;2016;01;04;Maanantai;0;0;0;0;0;0
293;11.01.2016;2016;01;05;Maanantai;2;0;2;0;0;0
293;11.01.2016;2016;01;06;Maanantai;2;2;4;0;0;0
293;11.01.2016;2016;01;07;Maanantai;35;3;38;15;1;16
293;11.01.2016;2016;01;08;Maanantai;45;3;48;7;6;13
293;11.01.2016;2016;01;09;Maanantai;39;1;40;6;1;7
293;11.01.2016;2016;01;10;Maanantai;15;1;16;5;3;8
293;11.01.2016;2016;01;11;Maanantai;3;5;8;4;3;7
293;11.01.2016;2016;01;12;Maanantai;3;7;10;5;3;8
293;11.01.2016;2016;01;13;Maanantai;2;29;31;6;5;11
293;11.01.2016;2016;01;14;Maanantai;4;38;42;4;17;21
293;11.01.2016;2016;01;15;Maanantai;3;46;49;2;11;13
293;11.01.2016;2016;01;16;Maanantai;6;11;17;4;12;16
293;11.01.2016;2016;01;17;Maanantai;2;6;8;8;2;10
293;11.01.2016;2016;01;18;Maanantai;1;4;5;6;5;11
293;11.01.2016;2016;01;19;Maanantai;5;3;8;2;5;7
293;11.01.2016;2016;01;20;Maanantai;2;2;4;2;2;4
293;11.01.2016;2016;01;21;Maanantai;1;2;3;1;0;1
293;11.01.2016;2016;01;22;Maanantai;0;0;0;0;2;2
293;11.01.2016;2016;01;23;Maanantai;0;0;0;0;0;0
293;12.01.2016;2016;01;00;Tiistai;0;0;0;0;0;0
293;12.01.2016;2016;01;01;Tiistai;0;0;0;0;0;0
293;12.01.2016;2016;01;02;Tiistai;0;0;0;0;1;1
293;12.01.2016;2016;01;03;Tiistai;0;0;0;0;0;0
293;12.01.2016;2016;01;04;Tiistai;0;0;0;0;0;0
293;12.01.2016;2016;01;05;Tiistai;2;1;3;0;0;0
293;12.01.2016;2016;01;06;Tiistai;3;2;5;3;1;4
293;12.01.2016;2016;01;07;Tiistai;65;2;67;10;2;12
293;12.01.2016;2016;01;08;Tiistai;39;2;41;14;2;16
293;12.01.2016;2016;01;09;Tiistai;15;2;17;5;0;5
293;12.01.2016;2016;01;10;Tiistai;12;3;15;6;5;11
293;12.01.2016;2016;01;11;Tiistai;4;1;5;2;7;9
293;12.01.2016;2016;01;12;Tiistai;4;2;6;1;5;6
293;12.01.2016;2016;01;13;Tiistai;2;18;20;7;6;13
293;12.01.2016;2016;01;14;Tiistai;4;51;55;2;11;13
293;12.01.2016;2016;01;15;Tiistai;4;61;65;6;17;23
293;12.01.2016;2016;01;16;Tiistai;3;8;11;2;7;9
293;12.01.2016;2016;01;17;Tiistai;2;5;7;5;5;10
293;12.01.2016;2016;01;18;Tiistai;0;5;5;2;10;12
293;12.01.2016;2016;01;19;Tiistai;1;0;1;2;3;5
293;12.01.2016;2016;01;20;Tiistai;0;2;2;1;4;5
293;12.01.2016;2016;01;21;Tiistai;0;0;0;0;2;2
293;12.01.2016;2016;01;22;Tiistai;0;1;1;0;0;0
293;12.01.2016;2016;01;23;Tiistai;0;0;0;0;0;0
293;13.01.2016;2016;01;00;Keskiviikko;0;0;0;0;0;0
293;13.01.2016;2016;01;01;Keskiviikko;0;0;0;0;0;0
293;13.01.2016;2016;01;02;Keskiviikko;0;0;0;0;0;0
293;13.01.2016;2016;01;03;Keskiviikko;0;0;0;0;0;0
293;13.01.2016;2016;01;04;Keskiviikko;0;0;0;0;0;0
293;13.01.2016;2016;01;05;Keskiviikko;1;1;2;0;0;0
293;13.01.2016;2016;01;06;Keskiviikko;4;2;6;1;0;1
293;13.01.2016;2016;01;07;Keskiviikko;61;2;63;9;3;12
293;13.01.2016;2016;01;08;Keskiviikko;37;4;41;7;2;9
293;13.01.2016;2016;01;09;Keskiviikko;11;1;12;3;3;6
293;13.01.2016;2016;01;10;Keskiviikko;10;1;11;3;5;8
293;13.01.2016;2016;01;11;Keskiviikko;1;2;3;2;2;4
293;13.01.2016;2016;01;12;Keskiviikko;5;14;19;4;4;8
293;13.01.2016;2016;01;13;Keskiviikko;2;7;9;1;3;4
293;13.01.2016;2016;01;14;Keskiviikko;3;64;67;4;12;16
293;13.01.2016;2016;01;15;Keskiviikko;7;23;30;3;9;12
293;13.01.2016;2016;01;16;Keskiviikko;4;8;12;3;6;9
293;13.01.2016;2016;01;17;Keskiviikko;4;4;8;0;5;5
293;13.01.2016;2016;01;18;Keskiviikko;3;3;6;7;2;9
293;13.01.2016;2016;01;19;Keskiviikko;3;4;7;1;4;5
293;13.01.2016;2016;01;20;Keskiviikko;1;4;5;4;5;9
293;13.01.2016;2016;01;21;Keskiviikko;0;1;1;0;0;0
293;13.01.2016;2016;01;22;Keskiviikko;1;1;2;0;2;2
293;13.01.2016;2016;01;23;Keskiviikko;0;0;0;0;0;0
293;14.01.2016;2016;01;00;Torstai;0;0;0;0;0;0
293;14.01.2016;2016;01;01;Torstai;0;0;0;0;0;0
293;14.01.2016;2016;01;02;Torstai;0;0;0;0;0;0
293;14.01.2016;2016;01;03;Torstai;0;0;0;0;0;0
293;14.01.2016;2016;01;04;Torstai;0;1;1;0;0;0
293;14.01.2016;2016;01;05;Torstai;2;1;3;0;0;0
293;14.01.2016;2016;01;06;Torstai;4;2;6;3;1;4
293;14.01.2016;2016;01;07;Torstai;59;2;61;14;2;16
293;14.01.2016;2016;01;08;Torstai;36;4;40;7;4;11
293;14.01.2016;2016;01;09;Torstai;36;1;37;5;0;5
293;14.01.2016;2016;01;10;Torstai;10;4;14;3;4;7
293;14.01.2016;2016;01;11;Torstai;6;5;11;5;4;9
293;14.01.2016;2016;01;12;Torstai;6;5;11;6;1;7
293;14.01.2016;2016;01;13;Torstai;4;18;22;6;3;9
293;14.01.2016;2016;01;14;Torstai;5;53;58;8;12;20
293;14.01.2016;2016;01;15;Torstai;4;70;74;4;9;13
293;14.01.2016;2016;01;16;Torstai;9;11;20;5;7;12
293;14.01.2016;2016;01;17;Torstai;5;3;8;5;5;10
293;14.01.2016;2016;01;18;Torstai;3;7;10;6;5;11
293;14.01.2016;2016;01;19;Torstai;3;12;15;2;4;6
293;14.01.2016;2016;01;20;Torstai;1;2;3;1;5;6
293;14.01.2016;2016;01;21;Torstai;0;1;1;0;0;0
293;14.01.2016;2016;01;22;Torstai;0;2;2;0;0;0
293;14.01.2016;2016;01;23;Torstai;1;0;1;0;0;0
293;15.01.2016;2016;01;00;Perjantai;0;0;0;0;0;0
293;15.01.2016;2016;01;01;Perjantai;0;0;0;0;0;0
293;15.01.2016;2016;01;02;Perjantai;0;0;0;0;0;0
293;15.01.2016;2016;01;03;Perjantai;0;0;0;0;0;0
293;15.01.2016;2016;01;04;Perjantai;0;0;0;0;0;0
293;15.01.2016;2016;01;05;Perjantai;2;0;2;0;0;0
293;15.01.2016;2016;01;06;Perjantai;2;1;3;2;0;2
293;15.01.2016;2016;01;07;Perjantai;41;3;44;9;2;11
293;15.01.2016;2016;01;08;Perjantai;44;2;46;8;2;10
293;15.01.2016;2016;01;09;Perjantai;15;3;18;4;3;7
293;15.01.2016;2016;01;10;Perjantai;7;4;11;1;2;3
293;15.01.2016;2016;01;11;Perjantai;0;4;4;3;1;4
293;15.01.2016;2016;01;12;Perjantai;4;6;10;6;7;13
293;15.01.2016;2016;01;13;Perjantai;8;25;33;3;11;14
293;15.01.2016;2016;01;14;Perjantai;3;45;48;5;15;20
293;15.01.2016;2016;01;15;Perjantai;5;33;38;7;12;19
293;15.01.2016;2016;01;16;Perjantai;5;3;8;1;5;6
293;15.01.2016;2016;01;17;Perjantai;4;2;6;2;4;6
293;15.01.2016;2016;01;18;Perjantai;4;4;8;2;3;5
293;15.01.2016;2016;01;19;Perjantai;0;3;3;2;4;6
293;15.01.2016;2016;01;20;Perjantai;0;1;1;0;1;1
293;15.01.2016;2016;01;21;Perjantai;0;1;1;0;1;1
293;15.01.2016;2016;01;22;Perjantai;0;0;0;0;1;1
293;15.01.2016;2016;01;23;Perjantai;2;0;2;0;1;1
293;16.01.2016;2016;01;00;Lauantai;0;0;0;0;1;1
293;16.01.2016;2016;01;01;Lauantai;0;0;0;0;0;0
293;16.01.2016;2016;01;02;Lauantai;0;0;0;0;0;0
293;16.01.2016;2016;01;03;Lauantai;0;0;0;0;0;0
293;16.01.2016;2016;01;04;Lauantai;0;0;0;0;0;0
293;16.01.2016;2016;01;05;Lauantai;0;0;0;0;0;0
293;16.01.2016;2016;01;06;Lauantai;0;1;1;1;0;1
293;16.01.2016;2016;01;07;Lauantai;2;0;2;1;0;1
293;16.01.2016;2016;01;08;Lauantai;1;1;2;2;1;3
293;16.01.2016;2016;01;09;Lauantai;3;2;5;4;3;7
293;16.01.2016;2016;01;10;Lauantai;7;4;11;2;4;6
293;16.01.2016;2016;01;11;Lauantai;5;2;7;7;21;28
293;16.01.2016;2016;01;12;Lauantai;4;10;14;12;5;17
293;16.01.2016;2016;01;13;Lauantai;4;5;9;4;7;11
293;16.01.2016;2016;01;14;Lauantai;4;5;9;8;3;11
293;16.01.2016;2016;01;15;Lauantai;4;3;7;7;7;14
293;16.01.2016;2016;01;16;Lauantai;6;4;10;2;4;6
293;16.01.2016;2016;01;17;Lauantai;2;4;6;9;7;16
293;16.01.2016;2016;01;18;Lauantai;0;3;3;2;3;5
293;16.01.2016;2016;01;19;Lauantai;3;1;4;3;5;8
293;16.01.2016;2016;01;20;Lauantai;1;1;2;0;2;2
293;16.01.2016;2016;01;21;Lauantai;0;1;1;1;0;1
293;16.01.2016;2016;01;22;Lauantai;0;0;0;0;0;0
293;16.01.2016;2016;01;23;Lauantai;4;3;7;0;1;1
293;17.01.2016;2016;01;00;Sunnuntai;0;0;0;0;0;0
293;17.01.2016;2016;01;01;Sunnuntai;1;0;1;0;1;1
293;17.01.2016;2016;01;02;Sunnuntai;0;1;1;0;0;0
293;17.01.2016;2016;01;03;Sunnuntai;0;1;1;0;2;2
293;17.01.2016;2016;01;04;Sunnuntai;0;0;0;0;2;2
293;17.01.2016;2016;01;05;Sunnuntai;0;0;0;0;0;0
293;17.01.2016;2016;01;06;Sunnuntai;0;0;0;2;1;3
293;17.01.2016;2016;01;07;Sunnuntai;0;0;0;0;2;2
293;17.01.2016;2016;01;08;Sunnuntai;0;1;1;3;0;3
293;17.01.2016;2016;01;09;Sunnuntai;1;1;2;2;0;2
293;17.01.2016;2016;01;10;Sunnuntai;1;1;2;0;2;2
293;17.01.2016;2016;01;11;Sunnuntai;0;1;1;1;2;3
293;17.01.2016;2016;01;12;Sunnuntai;3;0;3;2;3;5
293;17.01.2016;2016;01;13;Sunnuntai;1;1;2;3;2;5
293;17.01.2016;2016;01;14;Sunnuntai;4;2;6;4;4;8
293;17.01.2016;2016;01;15;Sunnuntai;1;3;4;2;3;5
293;17.01.2016;2016;01;16;Sunnuntai;0;4;4;2;4;6
293;17.01.2016;2016;01;17;Sunnuntai;0;0;0;2;6;8
293;17.01.2016;2016;01;18;Sunnuntai;0;1;1;2;0;2
293;17.01.2016;2016;01;19;Sunnuntai;1;0;1;1;2;3
293;17.01.2016;2016;01;20;Sunnuntai;0;0;0;0;1;1
293;17.01.2016;2016;01;21;Sunnuntai;0;0;0;0;1;1
293;17.01.2016;2016;01;22;Sunnuntai;0;0;0;0;0;0
293;17.01.2016;2016;01;23;Sunnuntai;0;1;1;0;0;0
293;18.01.2016;2016;01;00;Maanantai;0;0;0;0;0;0
293;18.01.2016;2016;01;01;Maanantai;0;0;0;0;0;0
293;18.01.2016;2016;01;02;Maanantai;0;0;0;0;0;0
293;18.01.2016;2016;01;03;Maanantai;0;0;0;0;0;0
293;18.01.2016;2016;01;04;Maanantai;0;0;0;0;0;0
293;18.01.2016;2016;01;05;Maanantai;1;1;2;0;0;0
293;18.01.2016;2016;01;06;Maanantai;2;2;4;3;0;3
293;18.01.2016;2016;01;07;Maanantai;25;1;26;15;0;15
293;18.01.2016;2016;01;08;Maanantai;37;1;38;8;3;11
293;18.01.2016;2016;01;09;Maanantai;32;0;32;6;3;9
293;18.01.2016;2016;01;10;Maanantai;11;1;12;3;3;6
293;18.01.2016;2016;01;11;Maanantai;0;1;1;1;3;4
293;18.01.2016;2016;01;12;Maanantai;3;6;9;5;3;8
293;18.01.2016;2016;01;13;Maanantai;1;24;25;3;8;11
293;18.01.2016;2016;01;14;Maanantai;2;22;24;3;12;15
293;18.01.2016;2016;01;15;Maanantai;2;42;44;4;12;16
293;18.01.2016;2016;01;16;Maanantai;3;6;9;0;7;7
293;18.01.2016;2016;01;17;Maanantai;1;1;2;7;5;12
293;18.01.2016;2016;01;18;Maanantai;2;1;3;3;1;4
293;18.01.2016;2016;01;19;Maanantai;1;2;3;2;4;6
293;18.01.2016;2016;01;20;Maanantai;0;1;1;0;2;2
293;18.01.2016;2016;01;21;Maanantai;0;0;0;0;1;1
293;18.01.2016;2016;01;22;Maanantai;0;0;0;0;0;0
293;18.01.2016;2016;01;23;Maanantai;0;0;0;0;0;0
293;19.01.2016;2016;01;00;Tiistai;0;0;0;0;0;0
293;19.01.2016;2016;01;01;Tiistai;0;0;0;0;0;0
293;19.01.2016;2016;01;02;Tiistai;0;0;0;0;0;0
293;19.01.2016;2016;01;03;Tiistai;0;0;0;0;0;0
293;19.01.2016;2016;01;04;Tiistai;0;0;0;0;0;0
293;19.01.2016;2016;01;05;Tiistai;1;2;3;0;0;0
293;19.01.2016;2016;01;06;Tiistai;1;1;2;2;0;2
293;19.01.2016;2016;01;07;Tiistai;30;0;30;20;0;20
293;19.01.2016;2016;01;08;Tiistai;23;1;24;9;2;11
293;19.01.2016;2016;01;09;Tiistai;11;0;11;5;4;9
293;19.01.2016;2016;01;10;Tiistai;12;3;15;2;1;3
293;19.01.2016;2016;01;11;Tiistai;2;1;3;3;1;4
293;19.01.2016;2016;01;12;Tiistai;2;2;4;1;5;6
293;19.01.2016;2016;01;13;Tiistai;1;8;9;2;4;6
293;19.01.2016;2016;01;14;Tiistai;1;35;36;3;12;15
293;19.01.2016;2016;01;15;Tiistai;3;37;40;3;13;16
293;19.01.2016;2016;01;16;Tiistai;4;4;8;0;8;8
293;19.01.2016;2016;01;17;Tiistai;3;2;5;4;4;8
293;19.01.2016;2016;01;18;Tiistai;0;3;3;2;3;5
293;19.01.2016;2016;01;19;Tiistai;0;0;0;1;4;5
293;19.01.2016;2016;01;20;Tiistai;1;0;1;0;1;1
293;19.01.2016;2016;01;21;Tiistai;0;0;0;1;1;2
293;19.01.2016;2016;01;22;Tiistai;0;0;0;0;0;0
293;19.01.2016;2016;01;23;Tiistai;0;0;0;0;0;0
293;20.01.2016;2016;01;00;Keskiviikko;0;0;0;0;0;0
293;20.01.2016;2016;01;01;Keskiviikko;0;0;0;0;0;0
293;20.01.2016;2016;01;02;Keskiviikko;0;0;0;0;0;0
293;20.01.2016;2016;01;03;Keskiviikko;0;0;0;0;0;0
293;20.01.2016;2016;01;04;Keskiviikko;0;0;0;0;0;0
293;20.01.2016;2016;01;05;Keskiviikko;1;1;2;0;0;0
293;20.01.2016;2016;01;06;Keskiviikko;1;1;2;2;1;3
293;20.01.2016;2016;01;07;Keskiviikko;38;3;41;18;2;20
293;20.01.2016;2016;01;08;Keskiviikko;25;1;26;7;1;8
293;20.01.2016;2016;01;09;Keskiviikko;4;0;4;9;2;11
293;20.01.2016;2016;01;10;Keskiviikko;8;0;8;4;0;4
293;20.01.2016;2016;01;11;Keskiviikko;1;5;6;4;1;5
293;20.01.2016;2016;01;12;Keskiviikko;4;12;16;3;2;5
293;20.01.2016;2016;01;13;Keskiviikko;2;7;9;4;5;9
293;20.01.2016;2016;01;14;Keskiviikko;4;50;54;2;18;20
293;20.01.2016;2016;01;15;Keskiviikko;6;5;11;2;4;6
293;20.01.2016;2016;01;16;Keskiviikko;4;8;12;3;5;8
293;20.01.2016;2016;01;17;Keskiviikko;7;4;11;3;6;9
293;20.01.2016;2016;01;18;Keskiviikko;2;2;4;1;1;2
293;20.01.2016;2016;01;19;Keskiviikko;1;2;3;0;0;0
293;20.01.2016;2016;01;20;Keskiviikko;0;4;4;0;1;1
293;20.01.2016;2016;01;21;Keskiviikko;0;0;0;0;0;0
293;20.01.2016;2016;01;22;Keskiviikko;0;0;0;0;0;0
293;20.01.2016;2016;01;23;Keskiviikko;0;0;0;0;0;0
293;21.01.2016;2016;01;00;Torstai;0;0;0;0;0;0
293;21.01.2016;2016;01;01;Torstai;0;0;0;0;0;0
293;21.01.2016;2016;01;02;Torstai;0;0;0;0;0;0
293;21.01.2016;2016;01;03;Torstai;0;0;0;0;0;0
293;21.01.2016;2016;01;04;Torstai;0;0;0;0;0;0
293;21.01.2016;2016;01;05;Torstai;1;0;1;0;0;0
293;21.01.2016;2016;01;06;Torstai;1;1;2;1;0;1
293;21.01.2016;2016;01;07;Torstai;21;0;21;14;2;16
293;21.01.2016;2016;01;08;Torstai;22;2;24;14;3;17
293;21.01.2016;2016;01;09;Torstai;14;0;14;6;2;8
293;21.01.2016;2016;01;10;Torstai;8;1;9;3;2;5
293;21.01.2016;2016;01;11;Torstai;1;5;6;1;1;2
293;21.01.2016;2016;01;12;Torstai;2;2;4;5;6;11
293;21.01.2016;2016;01;13;Torstai;1;6;7;3;9;12
293;21.01.2016;2016;01;14;Torstai;0;18;18;6;9;15
293;21.01.2016;2016;01;15;Torstai;0;30;30;2;13;15
293;21.01.2016;2016;01;16;Torstai;2;2;4;0;7;7
293;21.01.2016;2016;01;17;Torstai;0;1;1;2;2;4
293;21.01.2016;2016;01;18;Torstai;0;1;1;2;3;5
293;21.01.2016;2016;01;19;Torstai;1;1;2;0;5;5
293;21.01.2016;2016;01;20;Torstai;0;1;1;1;1;2
293;21.01.2016;2016;01;21;Torstai;0;0;0;0;0;0
293;21.01.2016;2016;01;22;Torstai;0;0;0;0;1;1
293;21.01.2016;2016;01;23;Torstai;0;0;0;0;0;0
293;22.01.2016;2016;01;00;Perjantai;0;0;0;0;0;0
293;22.01.2016;2016;01;01;Perjantai;0;0;0;0;0;0
293;22.01.2016;2016;01;02;Perjantai;0;0;0;0;0;0
293;22.01.2016;2016;01;03;Perjantai;0;0;0;0;0;0
293;22.01.2016;2016;01;04;Perjantai;0;0;0;0;0;0
293;22.01.2016;2016;01;05;Perjantai;1;2;3;0;0;0
293;22.01.2016;2016;01;06;Perjantai;4;2;6;2;0;2
293;22.01.2016;2016;01;07;Perjantai;35;2;37;15;1;16
293;22.01.2016;2016;01;08;Perjantai;40;1;41;7;2;9
293;22.01.2016;2016;01;09;Perjantai;14;5;19;5;1;6
293;22.01.2016;2016;01;10;Perjantai;9;2;11;5;7;12
293;22.01.2016;2016;01;11;Perjantai;0;6;6;5;3;8
293;22.01.2016;2016;01;12;Perjantai;5;10;15;7;12;19
293;22.01.2016;2016;01;13;Perjantai;5;22;27;1;8;9
293;22.01.2016;2016;01;14;Perjantai;4;31;35;4;7;11
293;22.01.2016;2016;01;15;Perjantai;7;31;38;2;13;15
293;22.01.2016;2016;01;16;Perjantai;8;3;11;4;4;8
293;22.01.2016;2016;01;17;Perjantai;6;2;8;4;9;13
293;22.01.2016;2016;01;18;Perjantai;4;4;8;7;4;11
293;22.01.2016;2016;01;19;Perjantai;1;9;10;2;5;7
293;22.01.2016;2016;01;20;Perjantai;0;1;1;2;2;4
293;22.01.2016;2016;01;21;Perjantai;1;2;3;1;4;5
293;22.01.2016;2016;01;22;Perjantai;2;3;5;0;3;3
293;22.01.2016;2016;01;23;Perjantai;1;0;1;1;0;1
293;23.01.2016;2016;01;00;Lauantai;0;1;1;0;1;1
293;23.01.2016;2016;01;01;Lauantai;0;0;0;0;0;0
293;23.01.2016;2016;01;02;Lauantai;0;0;0;0;0;0
293;23.01.2016;2016;01;03;Lauantai;0;0;0;0;1;1
293;23.01.2016;2016;01;04;Lauantai;0;0;0;0;0;0
293;23.01.2016;2016;01;05;Lauantai;0;0;0;0;1;1
293;23.01.2016;2016;01;06;Lauantai;2;0;2;0;0;0
293;23.01.2016;2016;01;07;Lauantai;2;0;2;0;0;0
293;23.01.2016;2016;01;08;Lauantai;2;0;2;3;1;4
293;23.01.2016;2016;01;09;Lauantai;6;1;7;5;7;12
293;23.01.2016;2016;01;10;Lauantai;4;7;11;6;8;14
293;23.01.2016;2016;01;11;Lauantai;6;2;8;11;7;18
293;23.01.2016;2016;01;12;Lauantai;9;10;19;4;5;9
293;23.01.2016;2016;01;13;Lauantai;5;4;9;10;8;18
293;23.01.2016;2016;01;14;Lauantai;6;5;11;7;9;16
293;23.01.2016;2016;01;15;Lauantai;8;8;16;5;5;10
293;23.01.2016;2016;01;16;Lauantai;2;5;7;5;4;9
293;23.01.2016;2016;01;17;Lauantai;3;7;10;3;3;6
293;23.01.2016;2016;01;18;Lauantai;8;2;10;3;5;8
293;23.01.2016;2016;01;19;Lauantai;0;1;1;1;1;2
293;23.01.2016;2016;01;20;Lauantai;3;7;10;1;2;3
293;23.01.2016;2016;01;21;Lauantai;0;2;2;0;2;2
293;23.01.2016;2016;01;22;Lauantai;2;1;3;1;0;1
293;23.01.2016;2016;01;23;Lauantai;2;0;2;2;0;2
293;24.01.2016;2016;01;00;Sunnuntai;5;6;11;1;0;1
293;24.01.2016;2016;01;01;Sunnuntai;1;0;1;0;1;1
293;24.01.2016;2016;01;02;Sunnuntai;0;0;0;0;2;2
293;24.01.2016;2016;01;03;Sunnuntai;1;1;2;0;0;0
293;24.01.2016;2016;01;04;Sunnuntai;0;0;0;0;0;0
293;24.01.2016;2016;01;05;Sunnuntai;0;0;0;0;1;1
293;24.01.2016;2016;01;06;Sunnuntai;0;0;0;3;0;3
293;24.01.2016;2016;01;07;Sunnuntai;0;0;0;0;2;2
293;24.01.2016;2016;01;08;Sunnuntai;0;1;1;2;1;3
293;24.01.2016;2016;01;09;Sunnuntai;3;1;4;4;0;4
293;24.01.2016;2016;01;10;Sunnuntai;1;3;4;2;3;5
293;24.01.2016;2016;01;11;Sunnuntai;1;1;2;6;5;11
293;24.01.2016;2016;01;12;Sunnuntai;6;4;10;14;4;18
293;24.01.2016;2016;01;13;Sunnuntai;1;3;4;6;7;13
293;24.01.2016;2016;01;14;Sunnuntai;6;8;14;10;17;27
293;24.01.2016;2016;01;15;Sunnuntai;4;2;6;4;8;12
293;24.01.2016;2016;01;16;Sunnuntai;3;5;8;7;5;12
293;24.01.2016;2016;01;17;Sunnuntai;4;2;6;5;5;10
293;24.01.2016;2016;01;18;Sunnuntai;3;5;8;4;7;11
293;24.01.2016;2016;01;19;Sunnuntai;1;1;2;0;2;2
293;24.01.2016;2016;01;20;Sunnuntai;0;0;0;2;4;6
293;24.01.2016;2016;01;21;Sunnuntai;1;2;3;1;0;1
293;24.01.2016;2016;01;22;Sunnuntai;0;0;0;0;0;0
293;24.01.2016;2016;01;23;Sunnuntai;0;1;1;0;0;0
293;25.01.2016;2016;01;00;Maanantai;0;0;0;0;0;0
293;25.01.2016;2016;01;01;Maanantai;0;0;0;0;0;0
293;25.01.2016;2016;01;02;Maanantai;0;0;0;0;0;0
293;25.01.2016;2016;01;03;Maanantai;0;0;0;0;0;0
293;25.01.2016;2016;01;04;Maanantai;0;0;0;0;0;0
293;25.01.2016;2016;01;05;Maanantai;1;0;1;0;0;0
293;25.01.2016;2016;01;06;Maanantai;8;4;12;3;1;4
293;25.01.2016;2016;01;07;Maanantai;57;1;58;7;1;8
293;25.01.2016;2016;01;08;Maanantai;47;9;56;8;4;12
293;25.01.2016;2016;01;09;Maanantai;38;2;40;6;3;9
293;25.01.2016;2016;01;10;Maanantai;16;5;21;7;5;12
293;25.01.2016;2016;01;11;Maanantai;3;3;6;3;6;9
293;25.01.2016;2016;01;12;Maanantai;3;7;10;7;2;9
293;25.01.2016;2016;01;13;Maanantai;3;26;29;8;19;27
293;25.01.2016;2016;01;14;Maanantai;3;33;36;4;9;13
293;25.01.2016;2016;01;15;Maanantai;10;53;63;7;17;24
293;25.01.2016;2016;01;16;Maanantai;7;9;16;3;4;7
293;25.01.2016;2016;01;17;Maanantai;8;7;15;6;9;15
293;25.01.2016;2016;01;18;Maanantai;4;3;7;7;5;12
293;25.01.2016;2016;01;19;Maanantai;1;7;8;5;8;13
293;25.01.2016;2016;01;20;Maanantai;2;5;7;2;4;6
293;25.01.2016;2016;01;21;Maanantai;1;1;2;2;2;4
293;25.01.2016;2016;01;22;Maanantai;0;2;2;0;0;0
293;25.01.2016;2016;01;23;Maanantai;1;1;2;0;0;0
293;26.01.2016;2016;01;00;Tiistai;0;0;0;0;0;0
293;26.01.2016;2016;01;01;Tiistai;0;0;0;0;0;0
293;26.01.2016;2016;01;02;Tiistai;0;0;0;0;0;0
293;26.01.2016;2016;01;03;Tiistai;0;0;0;0;0;0
293;26.01.2016;2016;01;04;Tiistai;0;0;0;0;0;0
293;26.01.2016;2016;01;05;Tiistai;0;3;3;0;0;0
293;26.01.2016;2016;01;06;Tiistai;11;2;13;3;1;4
293;26.01.2016;2016;01;07;Tiistai;51;4;55;8;1;9
293;26.01.2016;2016;01;08;Tiistai;51;4;55;5;0;5
293;26.01.2016;2016;01;09;Tiistai;10;3;13;1;1;2
293;26.01.2016;2016;01;10;Tiistai;17;4;21;7;5;12
293;26.01.2016;2016;01;11;Tiistai;2;1;3;3;3;6
293;26.01.2016;2016;01;12;Tiistai;1;1;2;5;5;10
293;26.01.2016;2016;01;13;Tiistai;3;14;17;7;9;16
293;26.01.2016;2016;01;14;Tiistai;7;53;60;0;10;10
293;26.01.2016;2016;01;15;Tiistai;5;53;58;1;13;14
293;26.01.2016;2016;01;16;Tiistai;6;8;14;4;2;6
293;26.01.2016;2016;01;17;Tiistai;5;5;10;5;3;8
293;26.01.2016;2016;01;18;Tiistai;2;0;2;4;3;7
293;26.01.2016;2016;01;19;Tiistai;0;0;0;2;5;7
293;26.01.2016;2016;01;20;Tiistai;0;3;3;1;1;2
293;26.01.2016;2016;01;21;Tiistai;0;0;0;1;2;3
293;26.01.2016;2016;01;22;Tiistai;0;0;0;0;0;0
293;26.01.2016;2016;01;23;Tiistai;0;0;0;0;0;0
293;27.01.2016;2016;01;00;Keskiviikko;0;0;0;0;0;0
293;27.01.2016;2016;01;01;Keskiviikko;0;0;0;0;0;0
293;27.01.2016;2016;01;02;Keskiviikko;0;0;0;0;0;0
293;27.01.2016;2016;01;03;Keskiviikko;0;0;0;0;0;0
293;27.01.2016;2016;01;04;Keskiviikko;0;0;0;0;0;0
293;27.01.2016;2016;01;05;Keskiviikko;1;1;2;0;1;1
293;27.01.2016;2016;01;06;Keskiviikko;6;2;8;1;0;1
293;27.01.2016;2016;01;07;Keskiviikko;63;7;70;4;0;4
293;27.01.2016;2016;01;08;Keskiviikko;39;12;51;5;0;5
293;27.01.2016;2016;01;09;Keskiviikko;11;5;16;7;0;7
293;27.01.2016;2016;01;10;Keskiviikko;12;5;17;6;0;6
293;27.01.2016;2016;01;11;Keskiviikko;7;5;12;4;2;6
293;27.01.2016;2016;01;12;Keskiviikko;5;8;13;4;3;7
293;27.01.2016;2016;01;13;Keskiviikko;5;7;12;3;3;6
293;27.01.2016;2016;01;14;Keskiviikko;6;83;89;3;15;18
293;27.01.2016;2016;01;15;Keskiviikko;7;23;30;5;8;13
293;27.01.2016;2016;01;16;Keskiviikko;5;14;19;1;7;8
293;27.01.2016;2016;01;17;Keskiviikko;9;8;17;1;3;4
293;27.01.2016;2016;01;18;Keskiviikko;8;4;12;4;6;10
293;27.01.2016;2016;01;19;Keskiviikko;0;3;3;2;0;2
293;27.01.2016;2016;01;20;Keskiviikko;1;9;10;0;2;2
293;27.01.2016;2016;01;21;Keskiviikko;0;0;0;2;3;5
293;27.01.2016;2016;01;22;Keskiviikko;1;0;1;0;0;0
293;27.01.2016;2016;01;23;Keskiviikko;0;0;0;0;0;0
293;28.01.2016;2016;01;00;Torstai;0;0;0;0;0;0
293;28.01.2016;2016;01;01;Torstai;0;0;0;0;0;0
293;28.01.2016;2016;01;02;Torstai;0;0;0;0;0;0
293;28.01.2016;2016;01;03;Torstai;0;0;0;0;0;0
293;28.01.2016;2016;01;04;Torstai;0;0;0;0;0;0
293;28.01.2016;2016;01;05;Torstai;1;1;2;0;0;0
293;28.01.2016;2016;01;06;Torstai;8;1;9;1;1;2
293;28.01.2016;2016;01;07;Torstai;58;3;61;8;3;11
293;28.01.2016;2016;01;08;Torstai;56;2;58;9;2;11
293;28.01.2016;2016;01;09;Torstai;30;4;34;8;0;8
293;28.01.2016;2016;01;10;Torstai;8;3;11;6;7;13
293;28.01.2016;2016;01;11;Torstai;3;16;19;5;6;11
293;28.01.2016;2016;01;12;Torstai;5;4;9;8;2;10
293;28.01.2016;2016;01;13;Torstai;6;20;26;6;4;10
293;28.01.2016;2016;01;14;Torstai;3;62;65;6;16;22
293;28.01.2016;2016;01;15;Torstai;6;55;61;2;10;12
293;28.01.2016;2016;01;16;Torstai;4;11;15;2;6;8
293;28.01.2016;2016;01;17;Torstai;6;2;8;4;5;9
293;28.01.2016;2016;01;18;Torstai;1;4;5;2;1;3
293;28.01.2016;2016;01;19;Torstai;3;3;6;4;6;10
293;28.01.2016;2016;01;20;Torstai;1;2;3;1;2;3
293;28.01.2016;2016;01;21;Torstai;0;2;2;2;1;3
293;28.01.2016;2016;01;22;Torstai;0;1;1;1;0;1
293;28.01.2016;2016;01;23;Torstai;0;0;0;0;0;0
293;29.01.2016;2016;01;00;Perjantai;0;0;0;0;0;0
293;29.01.2016;2016;01;01;Perjantai;0;0;0;0;0;0
293;29.01.2016;2016;01;02;Perjantai;0;0;0;0;0;0
293;29.01.2016;2016;01;03;Perjantai;0;0;0;0;0;0
293;29.01.2016;2016;01;04;Perjantai;0;0;0;0;0;0
293;29.01.2016;2016;01;05;Perjantai;1;0;1;1;0;1
293;29.01.2016;2016;01;06;Perjantai;5;3;8;0;0;0
293;29.01.2016;2016;01;07;Perjantai;45;5;50;5;2;7
293;29.01.2016;2016;01;08;Perjantai;66;5;71;8;0;8
293;29.01.2016;2016;01;09;Perjantai;19;1;20;3;2;5
293;29.01.2016;2016;01;10;Perjantai;2;4;6;3;3;6
293;29.01.2016;2016;01;11;Perjantai;3;12;15;4;5;9
293;29.01.2016;2016;01;12;Perjantai;7;8;15;6;8;14
293;29.01.2016;2016;01;13;Perjantai;5;33;38;4;6;10
293;29.01.2016;2016;01;14;Perjantai;6;40;46;5;17;22
293;29.01.2016;2016;01;15;Perjantai;6;39;45;2;7;9
293;29.01.2016;2016;01;16;Perjantai;11;6;17;6;5;11
293;29.01.2016;2016;01;17;Perjantai;7;5;12;3;2;5
293;29.01.2016;2016;01;18;Perjantai;3;6;9;4;3;7
293;29.01.2016;2016;01;19;Perjantai;4;7;11;1;3;4
293;29.01.2016;2016;01;20;Perjantai;4;6;10;2;4;6
293;29.01.2016;2016;01;21;Perjantai;2;2;4;0;4;4
293;29.01.2016;2016;01;22;Perjantai;1;1;2;0;0;0
293;29.01.2016;2016;01;23;Perjantai;0;2;2;1;0;1
293;30.01.2016;2016;01;00;Lauantai;0;0;0;2;0;2
293;30.01.2016;2016;01;01;Lauantai;0;0;0;0;0;0
293;30.01.2016;2016;01;02;Lauantai;0;0;0;0;0;0
293;30.01.2016;2016;01;03;Lauantai;0;0;0;3;0;3
293;30.01.2016;2016;01;04;Lauantai;0;0;0;0;0;0
293;30.01.2016;2016;01;05;Lauantai;1;0;1;0;0;0
293;30.01.2016;2016;01;06;Lauantai;0;0;0;0;0;0
293;30.01.2016;2016;01;07;Lauantai;1;0;1;3;1;4
293;30.01.2016;2016;01;08;Lauantai;4;0;4;1;3;4
293;30.01.2016;2016;01;09;Lauantai;1;2;3;4;3;7
293;30.01.2016;2016;01;10;Lauantai;2;4;6;6;3;9
293;30.01.2016;2016;01;11;Lauantai;2;4;6;4;6;10
293;30.01.2016;2016;01;12;Lauantai;5;4;9;7;10;17
293;30.01.2016;2016;01;13;Lauantai;4;6;10;5;3;8
293;30.01.2016;2016;01;14;Lauantai;5;3;8;7;6;13
293;30.01.2016;2016;01;15;Lauantai;4;4;8;8;6;14
293;30.01.2016;2016;01;16;Lauantai;3;3;6;2;3;5
293;30.01.2016;2016;01;17;Lauantai;2;4;6;4;6;10
293;30.01.2016;2016;01;18;Lauantai;0;3;3;2;4;6
293;30.01.2016;2016;01;19;Lauantai;5;0;5;3;2;5
293;30.01.2016;2016;01;20;Lauantai;5;0;5;2;1;3
293;30.01.2016;2016;01;21;Lauantai;1;9;10;0;4;4
293;30.01.2016;2016;01;22;Lauantai;2;4;6;1;0;1
293;30.01.2016;2016;01;23;Lauantai;0;0;0;0;0;0
293;31.01.2016;2016;01;00;Sunnuntai;0;0;0;0;0;0
293;31.01.2016;2016;01;01;Sunnuntai;1;1;2;3;3;6
293;31.01.2016;2016;01;02;Sunnuntai;1;0;1;0;1;1
293;31.01.2016;2016;01;03;Sunnuntai;0;0;0;0;1;1
293;31.01.2016;2016;01;04;Sunnuntai;0;0;0;0;0;0
293;31.01.2016;2016;01;05;Sunnuntai;0;0;0;0;1;1
293;31.01.2016;2016;01;06;Sunnuntai;0;0;0;1;0;1
293;31.01.2016;2016;01;07;Sunnuntai;1;0;1;2;1;3
293;31.01.2016;2016;01;08;Sunnuntai;0;0;0;1;0;1
293;31.01.2016;2016;01;09;Sunnuntai;10;1;11;4;3;7
293;31.01.2016;2016;01;10;Sunnuntai;2;3;5;10;4;14
293;31.01.2016;2016;01;11;Sunnuntai;1;3;4;5;6;11
293;31.01.2016;2016;01;12;Sunnuntai;1;2;3;11;10;21
293;31.01.2016;2016;01;13;Sunnuntai;5;8;13;11;6;17
293;31.01.2016;2016;01;14;Sunnuntai;3;6;9;10;12;22
293;31.01.2016;2016;01;15;Sunnuntai;8;0;8;8;12;20
293;31.01.2016;2016;01;16;Sunnuntai;2;9;11;1;7;8
293;31.01.2016;2016;01;17;Sunnuntai;8;2;10;1;4;5
293;31.01.2016;2016;01;18;Sunnuntai;4;2;6;3;5;8
293;31.01.2016;2016;01;19;Sunnuntai;2;0;2;5;7;12
293;31.01.2016;2016;01;20;Sunnuntai;0;4;4;1;3;4
293;31.01.2016;2016;01;21;Sunnuntai;1;0;1;0;2;2
293;31.01.2016;2016;01;22;Sunnuntai;0;0;0;0;0;0
293;31.01.2016;2016;01;23;Sunnuntai;0;0;0;0;0;0
293;01.02.2016;2016;02;00;Maanantai;0;0;0;0;0;0
293;01.02.2016;2016;02;01;Maanantai;0;0;0;0;0;0
293;01.02.2016;2016;02;02;Maanantai;0;0;0;0;0;0
293;01.02.2016;2016;02;03;Maanantai;0;0;0;0;0;0
293;01.02.2016;2016;02;04;Maanantai;0;0;0;1;0;1
293;01.02.2016;2016;02;05;Maanantai;3;0;3;0;0;0
293;01.02.2016;2016;02;06;Maanantai;5;2;7;2;0;2
293;01.02.2016;2016;02;07;Maanantai;44;3;47;9;2;11
293;01.02.2016;2016;02;08;Maanantai;65;5;70;9;1;10
293;01.02.2016;2016;02;09;Maanantai;27;1;28;6;4;10
293;01.02.2016;2016;02;10;Maanantai;16;11;27;8;5;13
293;01.02.2016;2016;02;11;Maanantai;4;8;12;6;7;13
293;01.02.2016;2016;02;12;Maanantai;9;9;18;10;5;15
293;01.02.2016;2016;02;13;Maanantai;4;47;51;6;9;15
293;01.02.2016;2016;02;14;Maanantai;3;31;34;4;10;14
293;01.02.2016;2016;02;15;Maanantai;6;54;60;8;12;20
293;01.02.2016;2016;02;16;Maanantai;7;6;13;2;9;11
293;01.02.2016;2016;02;17;Maanantai;5;12;17;11;5;16
293;01.02.2016;2016;02;18;Maanantai;4;3;7;5;8;13
293;01.02.2016;2016;02;19;Maanantai;6;3;9;2;5;7
293;01.02.2016;2016;02;20;Maanantai;1;3;4;1;9;10
293;01.02.2016;2016;02;21;Maanantai;1;2;3;3;3;6
293;01.02.2016;2016;02;22;Maanantai;0;1;1;0;0;0
293;01.02.2016;2016;02;23;Maanantai;0;0;0;0;0;0
293;02.02.2016;2016;02;00;Tiistai;0;0;0;0;0;0
293;02.02.2016;2016;02;01;Tiistai;0;0;0;0;0;0
293;02.02.2016;2016;02;02;Tiistai;0;1;1;0;0;0
293;02.02.2016;2016;02;03;Tiistai;0;0;0;0;0;0
293;02.02.2016;2016;02;04;Tiistai;0;0;0;0;0;0
293;02.02.2016;2016;02;05;Tiistai;0;1;1;1;1;2
293;02.02.2016;2016;02;06;Tiistai;8;2;10;2;0;2
293;02.02.2016;2016;02;07;Tiistai;48;4;52;12;1;13
293;02.02.2016;2016;02;08;Tiistai;75;4;79;8;2;10
293;02.02.2016;2016;02;09;Tiistai;19;4;23;4;2;6
293;02.02.2016;2016;02;10;Tiistai;15;5;20;3;3;6
293;02.02.2016;2016;02;11;Tiistai;3;12;15;4;7;11
293;02.02.2016;2016;02;12;Tiistai;3;6;9;6;4;10
293;02.02.2016;2016;02;13;Tiistai;11;14;25;9;15;24
293;02.02.2016;2016;02;14;Tiistai;4;41;45;4;8;12
293;02.02.2016;2016;02;15;Tiistai;9;68;77;2;18;20
293;02.02.2016;2016;02;16;Tiistai;9;12;21;4;10;14
293;02.02.2016;2016;02;17;Tiistai;9;8;17;5;16;21
293;02.02.2016;2016;02;18;Tiistai;4;7;11;6;5;11
293;02.02.2016;2016;02;19;Tiistai;1;3;4;4;5;9
293;02.02.2016;2016;02;20;Tiistai;0;5;5;3;2;5
293;02.02.2016;2016;02;21;Tiistai;1;1;2;1;2;3
293;02.02.2016;2016;02;22;Tiistai;0;0;0;0;0;0
293;02.02.2016;2016;02;23;Tiistai;0;0;0;0;0;0
293;03.02.2016;2016;02;00;Keskiviikko;0;0;0;0;0;0
293;03.02.2016;2016;02;01;Keskiviikko;0;0;0;0;0;0
293;03.02.2016;2016;02;02;Keskiviikko;0;0;0;0;0;0
293;03.02.2016;2016;02;03;Keskiviikko;0;0;0;0;0;0
293;03.02.2016;2016;02;04;Keskiviikko;0;0;0;0;0;0
293;03.02.2016;2016;02;05;Keskiviikko;0;1;1;1;0;1
293;03.02.2016;2016;02;06;Keskiviikko;9;2;11;1;0;1
293;03.02.2016;2016;02;07;Keskiviikko;58;1;59;11;1;12
293;03.02.2016;2016;02;08;Keskiviikko;73;6;79;8;1;9
293;03.02.2016;2016;02;09;Keskiviikko;12;5;17;6;2;8
293;03.02.2016;2016;02;10;Keskiviikko;13;3;16;13;5;18
293;03.02.2016;2016;02;11;Keskiviikko;6;18;24;8;6;14
293;03.02.2016;2016;02;12;Keskiviikko;10;13;23;5;8;13
293;03.02.2016;2016;02;13;Keskiviikko;5;14;19;6;15;21
293;03.02.2016;2016;02;14;Keskiviikko;7;88;95;2;12;14
293;03.02.2016;2016;02;15;Keskiviikko;5;15;20;3;8;11
293;03.02.2016;2016;02;16;Keskiviikko;7;9;16;2;9;11
293;03.02.2016;2016;02;17;Keskiviikko;6;9;15;3;3;6
293;03.02.2016;2016;02;18;Keskiviikko;4;3;7;2;8;10
293;03.02.2016;2016;02;19;Keskiviikko;1;4;5;6;6;12
293;03.02.2016;2016;02;20;Keskiviikko;0;9;9;2;4;6
293;03.02.2016;2016;02;21;Keskiviikko;0;4;4;0;0;0
293;03.02.2016;2016;02;22;Keskiviikko;0;0;0;0;0;0
293;03.02.2016;2016;02;23;Keskiviikko;0;0;0;1;0;1
293;04.02.2016;2016;02;00;Torstai;0;0;0;0;0;0
293;04.02.2016;2016;02;01;Torstai;0;0;0;0;1;1
293;04.02.2016;2016;02;02;Torstai;0;0;0;0;0;0
293;04.02.2016;2016;02;03;Torstai;0;0;0;0;0;0
293;04.02.2016;2016;02;04;Torstai;0;0;0;0;0;0
293;04.02.2016;2016;02;05;Torstai;1;0;1;0;0;0
293;04.02.2016;2016;02;06;Torstai;5;2;7;1;2;3
293;04.02.2016;2016;02;07;Torstai;58;2;60;13;0;13
293;04.02.2016;2016;02;08;Torstai;49;4;53;17;2;19
293;04.02.2016;2016;02;09;Torstai;19;3;22;6;3;9
293;04.02.2016;2016;02;10;Torstai;10;5;15;5;3;8
293;04.02.2016;2016;02;11;Torstai;0;9;9;4;5;9
293;04.02.2016;2016;02;12;Torstai;3;10;13;8;6;14
293;04.02.2016;2016;02;13;Torstai;6;20;26;3;9;12
293;04.02.2016;2016;02;14;Torstai;5;66;71;8;11;19
293;04.02.2016;2016;02;15;Torstai;4;41;45;6;15;21
293;04.02.2016;2016;02;16;Torstai;4;10;14;0;7;7
293;04.02.2016;2016;02;17;Torstai;4;5;9;7;10;17
293;04.02.2016;2016;02;18;Torstai;4;6;10;6;6;12
293;04.02.2016;2016;02;19;Torstai;2;6;8;2;9;11
293;04.02.2016;2016;02;20;Torstai;0;2;2;2;2;4
293;04.02.2016;2016;02;21;Torstai;0;2;2;1;0;1
293;04.02.2016;2016;02;22;Torstai;0;0;0;0;0;0
293;04.02.2016;2016;02;23;Torstai;0;0;0;0;0;0
293;05.02.2016;2016;02;00;Perjantai;0;0;0;0;0;0
293;05.02.2016;2016;02;01;Perjantai;0;0;0;0;0;0
293;05.02.2016;2016;02;02;Perjantai;0;0;0;0;0;0
293;05.02.2016;2016;02;03;Perjantai;0;0;0;0;0;0
293;05.02.2016;2016;02;04;Perjantai;1;0;1;0;1;1
293;05.02.2016;2016;02;05;Perjantai;0;0;0;0;0;0
293;05.02.2016;2016;02;06;Perjantai;3;2;5;3;0;3
293;05.02.2016;2016;02;07;Perjantai;51;4;55;17;1;18
293;05.02.2016;2016;02;08;Perjantai;64;2;66;6;2;8
293;05.02.2016;2016;02;09;Perjantai;17;3;20;6;0;6
293;05.02.2016;2016;02;10;Perjantai;7;4;11;3;2;5
293;05.02.2016;2016;02;11;Perjantai;4;5;9;3;3;6
293;05.02.2016;2016;02;12;Perjantai;5;16;21;3;3;6
293;05.02.2016;2016;02;13;Perjantai;10;34;44;7;6;13
293;05.02.2016;2016;02;14;Perjantai;5;45;50;4;13;17
293;05.02.2016;2016;02;15;Perjantai;8;52;60;6;9;15
293;05.02.2016;2016;02;16;Perjantai;9;7;16;3;7;10
293;05.02.2016;2016;02;17;Perjantai;6;10;16;7;5;12
293;05.02.2016;2016;02;18;Perjantai;5;2;7;5;7;12
293;05.02.2016;2016;02;19;Perjantai;3;6;9;3;10;13
293;05.02.2016;2016;02;20;Perjantai;1;6;7;3;2;5
293;05.02.2016;2016;02;21;Perjantai;7;6;13;0;1;1
293;05.02.2016;2016;02;22;Perjantai;0;4;4;0;0;0
293;05.02.2016;2016;02;23;Perjantai;0;1;1;0;0;0
293;06.02.2016;2016;02;00;Lauantai;0;0;0;1;1;2
293;06.02.2016;2016;02;01;Lauantai;1;0;1;0;1;1
293;06.02.2016;2016;02;02;Lauantai;0;0;0;0;0;0
293;06.02.2016;2016;02;03;Lauantai;0;0;0;1;2;3
293;06.02.2016;2016;02;04;Lauantai;0;0;0;0;0;0
293;06.02.2016;2016;02;05;Lauantai;0;0;0;1;1;2
293;06.02.2016;2016;02;06;Lauantai;1;0;1;2;1;3
293;06.02.2016;2016;02;07;Lauantai;1;0;1;1;0;1
293;06.02.2016;2016;02;08;Lauantai;2;0;2;1;4;5
293;06.02.2016;2016;02;09;Lauantai;10;4;14;6;1;7
293;06.02.2016;2016;02;10;Lauantai;7;2;9;4;7;11
293;06.02.2016;2016;02;11;Lauantai;5;7;12;6;6;12
293;06.02.2016;2016;02;12;Lauantai;4;6;10;9;4;13
293;06.02.2016;2016;02;13;Lauantai;4;8;12;5;7;12
293;06.02.2016;2016;02;14;Lauantai;8;5;13;8;9;17
293;06.02.2016;2016;02;15;Lauantai;3;6;9;4;9;13
293;06.02.2016;2016;02;16;Lauantai;5;6;11;5;7;12
293;06.02.2016;2016;02;17;Lauantai;3;6;9;3;5;8
293;06.02.2016;2016;02;18;Lauantai;8;5;13;1;0;1
293;06.02.2016;2016;02;19;Lauantai;1;7;8;0;1;1
293;06.02.2016;2016;02;20;Lauantai;0;1;1;0;0;0
293;06.02.2016;2016;02;21;Lauantai;2;2;4;1;0;1
293;06.02.2016;2016;02;22;Lauantai;1;0;1;0;0;0
293;06.02.2016;2016;02;23;Lauantai;0;0;0;0;0;0
293;07.02.2016;2016;02;00;Sunnuntai;0;0;0;0;0;0
293;07.02.2016;2016;02;01;Sunnuntai;0;0;0;0;0;0
293;07.02.2016;2016;02;02;Sunnuntai;1;0;1;0;0;0
293;07.02.2016;2016;02;03;Sunnuntai;0;0;0;0;0;0
293;07.02.2016;2016;02;04;Sunnuntai;0;0;0;0;0;0
293;07.02.2016;2016;02;05;Sunnuntai;0;0;0;0;0;0
293;07.02.2016;2016;02;06;Sunnuntai;1;0;1;0;0;0
293;07.02.2016;2016;02;07;Sunnuntai;0;0;0;0;0;0
293;07.02.2016;2016;02;08;Sunnuntai;0;0;0;0;0;0
293;07.02.2016;2016;02;09;Sunnuntai;3;3;6;0;0;0
293;07.02.2016;2016;02;10;Sunnuntai;1;1;2;0;0;0
293;07.02.2016;2016;02;11;Sunnuntai;3;3;6;0;0;0
293;07.02.2016;2016;02;12;Sunnuntai;7;4;11;8;10;18
293;07.02.2016;2016;02;13;Sunnuntai;4;5;9;5;5;10
293;07.02.2016;2016;02;14;Sunnuntai;0;3;3;10;7;17
293;07.02.2016;2016;02;15;Sunnuntai;4;3;7;9;5;14
293;07.02.2016;2016;02;16;Sunnuntai;1;1;2;2;6;8
293;07.02.2016;2016;02;17;Sunnuntai;4;0;4;5;5;10
293;07.02.2016;2016;02;18;Sunnuntai;0;2;2;3;4;7
293;07.02.2016;2016;02;19;Sunnuntai;0;0;0;1;2;3
293;07.02.2016;2016;02;20;Sunnuntai;0;1;1;0;1;1
293;07.02.2016;2016;02;21;Sunnuntai;0;1;1;1;0;1
293;07.02.2016;2016;02;22;Sunnuntai;0;0;0;0;0;0
293;07.02.2016;2016;02;23;Sunnuntai;0;0;0;1;0;1
293;08.02.2016;2016;02;00;Maanantai;0;0;0;0;0;0
293;08.02.2016;2016;02;01;Maanantai;0;0;0;0;0;0
293;08.02.2016;2016;02;02;Maanantai;0;0;0;0;0;0
293;08.02.2016;2016;02;03;Maanantai;0;0;0;0;0;0
293;08.02.2016;2016;02;04;Maanantai;0;0;0;4;2;6
293;08.02.2016;2016;02;05;Maanantai;0;0;0;1;0;1
293;08.02.2016;2016;02;06;Maanantai;5;2;7;1;3;4
293;08.02.2016;2016;02;07;Maanantai;32;0;32;13;0;13
293;08.02.2016;2016;02;08;Maanantai;56;2;58;8;8;16
293;08.02.2016;2016;02;09;Maanantai;26;0;26;7;1;8
293;08.02.2016;2016;02;10;Maanantai;10;1;11;4;3;7
293;08.02.2016;2016;02;11;Maanantai;12;2;14;2;1;3
293;08.02.2016;2016;02;12;Maanantai;4;7;11;1;1;2
293;08.02.2016;2016;02;13;Maanantai;7;26;33;7;12;19
293;08.02.2016;2016;02;14;Maanantai;3;38;41;2;5;7
293;08.02.2016;2016;02;15;Maanantai;2;51;53;3;10;13
293;08.02.2016;2016;02;16;Maanantai;3;6;9;2;10;12
293;08.02.2016;2016;02;17;Maanantai;8;4;12;8;7;15
293;08.02.2016;2016;02;18;Maanantai;0;2;2;3;7;10
293;08.02.2016;2016;02;19;Maanantai;2;0;2;3;6;9
293;08.02.2016;2016;02;20;Maanantai;0;3;3;3;4;7
293;08.02.2016;2016;02;21;Maanantai;0;4;4;1;0;1
293;08.02.2016;2016;02;22;Maanantai;0;0;0;0;1;1
293;08.02.2016;2016;02;23;Maanantai;0;0;0;0;0;0
293;09.02.2016;2016;02;00;Tiistai;0;0;0;0;0;0
293;09.02.2016;2016;02;01;Tiistai;0;0;0;0;0;0
293;09.02.2016;2016;02;02;Tiistai;0;0;0;0;0;0
293;09.02.2016;2016;02;03;Tiistai;0;2;2;0;0;0
293;09.02.2016;2016;02;04;Tiistai;0;1;1;4;2;6
293;09.02.2016;2016;02;05;Tiistai;0;1;1;0;0;0
293;09.02.2016;2016;02;06;Tiistai;3;2;5;1;0;1
293;09.02.2016;2016;02;07;Tiistai;35;0;35;18;0;18
293;09.02.2016;2016;02;08;Tiistai;40;0;40;13;1;14
293;09.02.2016;2016;02;09;Tiistai;19;2;21;5;3;8
293;09.02.2016;2016;02;10;Tiistai;6;4;10;3;1;4
293;09.02.2016;2016;02;11;Tiistai;3;1;4;2;3;5
293;09.02.2016;2016;02;12;Tiistai;1;7;8;4;2;6
293;09.02.2016;2016;02;13;Tiistai;1;13;14;3;9;12
293;09.02.2016;2016;02;14;Tiistai;3;38;41;3;15;18
293;09.02.2016;2016;02;15;Tiistai;1;38;39;3;11;14
293;09.02.2016;2016;02;16;Tiistai;4;8;12;3;5;8
293;09.02.2016;2016;02;17;Tiistai;1;1;2;2;6;8
293;09.02.2016;2016;02;18;Tiistai;0;2;2;2;2;4
293;09.02.2016;2016;02;19;Tiistai;3;0;3;2;2;4
293;09.02.2016;2016;02;20;Tiistai;0;3;3;1;1;2
293;09.02.2016;2016;02;21;Tiistai;0;1;1;1;1;2
293;09.02.2016;2016;02;22;Tiistai;0;0;0;0;0;0
293;09.02.2016;2016;02;23;Tiistai;0;0;0;0;0;0
293;10.02.2016;2016;02;00;Keskiviikko;0;0;0;4;2;6
293;10.02.2016;2016;02;01;Keskiviikko;0;0;0;0;0;0
293;10.02.2016;2016;02;02;Keskiviikko;0;0;0;0;0;0
293;10.02.2016;2016;02;03;Keskiviikko;0;0;0;0;0;0
293;10.02.2016;2016;02;04;Keskiviikko;0;0;0;0;0;0
293;10.02.2016;2016;02;05;Keskiviikko;2;0;2;0;0;0
293;10.02.2016;2016;02;06;Keskiviikko;2;2;4;5;0;5
293;10.02.2016;2016;02;07;Keskiviikko;57;3;60;13;1;14
293;10.02.2016;2016;02;08;Keskiviikko;41;2;43;6;1;7
293;10.02.2016;2016;02;09;Keskiviikko;9;2;11;4;2;6
293;10.02.2016;2016;02;10;Keskiviikko;10;1;11;1;0;1
293;10.02.2016;2016;02;11;Keskiviikko;3;1;4;6;1;7
293;10.02.2016;2016;02;12;Keskiviikko;1;8;9;1;3;4
293;10.02.2016;2016;02;13;Keskiviikko;2;11;13;5;5;10
293;10.02.2016;2016;02;14;Keskiviikko;4;77;81;3;13;16
293;10.02.2016;2016;02;15;Keskiviikko;6;17;23;2;13;15
293;10.02.2016;2016;02;16;Keskiviikko;6;2;8;4;7;11
293;10.02.2016;2016;02;17;Keskiviikko;1;5;6;4;6;10
293;10.02.2016;2016;02;18;Keskiviikko;2;2;4;5;7;12
293;10.02.2016;2016;02;19;Keskiviikko;4;7;11;2;6;8
293;10.02.2016;2016;02;20;Keskiviikko;0;1;1;2;10;12
293;10.02.2016;2016;02;21;Keskiviikko;0;2;2;0;2;2
293;10.02.2016;2016;02;22;Keskiviikko;0;1;1;1;0;1
293;10.02.2016;2016;02;23;Keskiviikko;0;0;0;0;0;0
293;11.02.2016;2016;02;00;Torstai;0;0;0;0;0;0
293;11.02.2016;2016;02;01;Torstai;0;0;0;0;0;0
293;11.02.2016;2016;02;02;Torstai;0;0;0;0;0;0
293;11.02.2016;2016;02;03;Torstai;0;0;0;0;0;0
293;11.02.2016;2016;02;04;Torstai;0;0;0;0;0;0
293;11.02.2016;2016;02;05;Torstai;1;2;3;1;0;1
293;11.02.2016;2016;02;06;Torstai;2;1;3;1;0;1
293;11.02.2016;2016;02;07;Torstai;46;2;48;14;1;15
293;11.02.2016;2016;02;08;Torstai;34;2;36;12;5;17
293;11.02.2016;2016;02;09;Torstai;26;3;29;6;3;9
293;11.02.2016;2016;02;10;Torstai;6;3;9;6;3;9
293;11.02.2016;2016;02;11;Torstai;4;3;7;4;2;6
293;11.02.2016;2016;02;12;Torstai;4;2;6;3;2;5
293;11.02.2016;2016;02;13;Torstai;3;16;19;4;8;12
293;11.02.2016;2016;02;14;Torstai;4;51;55;4;14;18
293;11.02.2016;2016;02;15;Torstai;4;46;50;5;10;15
293;11.02.2016;2016;02;16;Torstai;7;3;10;0;0;0
293;11.02.2016;2016;02;17;Torstai;3;5;8;3;4;7
293;11.02.2016;2016;02;18;Torstai;4;5;9;7;7;14
293;11.02.2016;2016;02;19;Torstai;0;3;3;2;3;5
293;11.02.2016;2016;02;20;Torstai;2;7;9;2;1;3
293;11.02.2016;2016;02;21;Torstai;1;0;1;0;2;2
293;11.02.2016;2016;02;22;Torstai;0;0;0;0;1;1
293;11.02.2016;2016;02;23;Torstai;0;0;0;0;0;0
293;12.02.2016;2016;02;00;Perjantai;0;0;0;0;0;0
293;12.02.2016;2016;02;01;Perjantai;0;0;0;0;0;0
293;12.02.2016;2016;02;02;Perjantai;0;0;0;0;0;0
293;12.02.2016;2016;02;03;Perjantai;0;0;0;0;0;0
293;12.02.2016;2016;02;04;Perjantai;0;0;0;0;0;0
293;12.02.2016;2016;02;05;Perjantai;1;1;2;0;0;0
293;12.02.2016;2016;02;06;Perjantai;1;1;2;3;0;3
293;12.02.2016;2016;02;07;Perjantai;52;5;57;9;1;10
293;12.02.2016;2016;02;08;Perjantai;32;13;45;3;0;3
293;12.02.2016;2016;02;09;Perjantai;9;8;17;0;0;0
293;12.02.2016;2016;02;10;Perjantai;2;1;3;0;0;0
293;12.02.2016;2016;02;11;Perjantai;2;2;4;1;0;1
293;12.02.2016;2016;02;12;Perjantai;4;15;19;7;7;14
293;12.02.2016;2016;02;13;Perjantai;1;17;18;4;4;8
293;12.02.2016;2016;02;14;Perjantai;1;38;39;5;15;20
293;12.02.2016;2016;02;15;Perjantai;6;34;40;5;10;15
293;12.02.2016;2016;02;16;Perjantai;4;3;7;1;1;2
293;12.02.2016;2016;02;17;Perjantai;1;1;2;0;0;0
293;12.02.2016;2016;02;18;Perjantai;3;2;5;0;0;0
293;12.02.2016;2016;02;19;Perjantai;3;2;5;0;0;0
293;12.02.2016;2016;02;20;Perjantai;3;3;6;0;0;0
293;12.02.2016;2016;02;21;Perjantai;1;0;1;0;0;0
293;12.02.2016;2016;02;22;Perjantai;1;0;1;0;0;0
293;12.02.2016;2016;02;23;Perjantai;0;0;0;0;0;0
293;13.02.2016;2016;02;00;Lauantai;0;0;0;0;0;0
293;13.02.2016;2016;02;01;Lauantai;0;0;0;0;0;0
293;13.02.2016;2016;02;02;Lauantai;0;0;0;0;0;0
293;13.02.2016;2016;02;03;Lauantai;0;0;0;0;0;0
293;13.02.2016;2016;02;04;Lauantai;0;0;0;0;0;0
293;13.02.2016;2016;02;05;Lauantai;0;0;0;0;0;0
293;13.02.2016;2016;02;06;Lauantai;0;0;0;0;0;0
293;13.02.2016;2016;02;07;Lauantai;0;0;0;0;0;0
293;13.02.2016;2016;02;08;Lauantai;0;0;0;0;0;0
293;13.02.2016;2016;02;09;Lauantai;1;1;2;0;0;0
293;13.02.2016;2016;02;10;Lauantai;2;2;4;0;0;0
293;13.02.2016;2016;02;11;Lauantai;2;2;4;0;0;0
293;13.02.2016;2016;02;12;Lauantai;6;4;10;8;5;13
293;13.02.2016;2016;02;13;Lauantai;3;3;6;9;12;21
293;13.02.2016;2016;02;14;Lauantai;3;3;6;7;8;15
293;13.02.2016;2016;02;15;Lauantai;3;4;7;9;5;14
293;13.02.2016;2016;02;16;Lauantai;0;7;7;4;4;8
293;13.02.2016;2016;02;17;Lauantai;8;0;8;4;7;11
293;13.02.2016;2016;02;18;Lauantai;6;8;14;2;2;4
293;13.02.2016;2016;02;19;Lauantai;0;2;2;2;2;4
293;13.02.2016;2016;02;20;Lauantai;4;3;7;1;1;2
293;13.02.2016;2016;02;21;Lauantai;1;1;2;2;1;3
293;13.02.2016;2016;02;22;Lauantai;0;0;0;2;1;3
293;13.02.2016;2016;02;23;Lauantai;0;1;1;1;0;1
293;14.02.2016;2016;02;00;Sunnuntai;0;0;0;0;0;0
293;14.02.2016;2016;02;01;Sunnuntai;1;0;1;0;1;1
293;14.02.2016;2016;02;02;Sunnuntai;0;1;1;0;0;0
293;14.02.2016;2016;02;03;Sunnuntai;0;0;0;0;5;5
293;14.02.2016;2016;02;04;Sunnuntai;0;0;0;0;0;0
293;14.02.2016;2016;02;05;Sunnuntai;0;0;0;2;0;2
293;14.02.2016;2016;02;06;Sunnuntai;1;0;1;2;0;2
293;14.02.2016;2016;02;07;Sunnuntai;0;0;0;0;0;0
293;14.02.2016;2016;02;08;Sunnuntai;1;0;1;3;1;4
293;14.02.2016;2016;02;09;Sunnuntai;5;0;5;8;4;12
293;14.02.2016;2016;02;10;Sunnuntai;3;2;5;7;2;9
293;14.02.2016;2016;02;11;Sunnuntai;4;4;8;5;5;10
293;14.02.2016;2016;02;12;Sunnuntai;2;3;5;10;7;17
293;14.02.2016;2016;02;13;Sunnuntai;2;3;5;5;19;24
293;14.02.2016;2016;02;14;Sunnuntai;5;1;6;5;6;11
293;14.02.2016;2016;02;15;Sunnuntai;4;6;10;4;4;8
293;14.02.2016;2016;02;16;Sunnuntai;4;7;11;1;4;5
293;14.02.2016;2016;02;17;Sunnuntai;1;1;2;2;3;5
293;14.02.2016;2016;02;18;Sunnuntai;1;1;2;2;2;4
293;14.02.2016;2016;02;19;Sunnuntai;0;0;0;4;3;7
293;14.02.2016;2016;02;20;Sunnuntai;3;3;6;0;1;1
293;14.02.2016;2016;02;21;Sunnuntai;0;0;0;0;0;0
293;14.02.2016;2016;02;22;Sunnuntai;0;0;0;0;0;0
293;14.02.2016;2016;02;23;Sunnuntai;0;0;0;0;0;0
293;15.02.2016;2016;02;00;Maanantai;0;0;0;0;0;0
293;15.02.2016;2016;02;01;Maanantai;0;0;0;0;0;0
293;15.02.2016;2016;02;02;Maanantai;0;0;0;0;0;0
293;15.02.2016;2016;02;03;Maanantai;0;1;1;0;0;0
293;15.02.2016;2016;02;04;Maanantai;0;0;0;0;0;0
293;15.02.2016;2016;02;05;Maanantai;0;0;0;0;0;0
293;15.02.2016;2016;02;06;Maanantai;6;1;7;0;1;1
293;15.02.2016;2016;02;07;Maanantai;48;5;53;11;0;11
293;15.02.2016;2016;02;08;Maanantai;48;5;53;9;1;10
293;15.02.2016;2016;02;09;Maanantai;40;2;42;3;4;7
293;15.02.2016;2016;02;10;Maanantai;16;1;17;9;3;12
293;15.02.2016;2016;02;11;Maanantai;4;3;7;7;9;16
293;15.02.2016;2016;02;12;Maanantai;2;4;6;6;4;10
293;15.02.2016;2016;02;13;Maanantai;3;32;35;7;10;17
293;15.02.2016;2016;02;14;Maanantai;7;36;43;4;15;19
293;15.02.2016;2016;02;15;Maanantai;9;59;68;5;11;16
293;15.02.2016;2016;02;16;Maanantai;8;13;21;5;5;10
293;15.02.2016;2016;02;17;Maanantai;5;5;10;4;5;9
293;15.02.2016;2016;02;18;Maanantai;4;12;16;7;5;12
293;15.02.2016;2016;02;19;Maanantai;2;7;9;2;3;5
293;15.02.2016;2016;02;20;Maanantai;1;2;3;1;6;7
293;15.02.2016;2016;02;21;Maanantai;3;1;4;1;1;2
293;15.02.2016;2016;02;22;Maanantai;0;0;0;0;0;0
293;15.02.2016;2016;02;23;Maanantai;0;0;0;0;0;0
293;16.02.2016;2016;02;00;Tiistai;0;0;0;0;0;0
293;16.02.2016;2016;02;01;Tiistai;0;0;0;0;0;0
293;16.02.2016;2016;02;02;Tiistai;0;0;0;0;0;0
293;16.02.2016;2016;02;03;Tiistai;0;0;0;0;0;0
293;16.02.2016;2016;02;04;Tiistai;0;1;1;0;0;0
293;16.02.2016;2016;02;05;Tiistai;1;2;3;0;0;0
293;16.02.2016;2016;02;06;Tiistai;6;3;9;0;1;1
293;16.02.2016;2016;02;07;Tiistai;55;4;59;11;2;13
293;16.02.2016;2016;02;08;Tiistai;45;2;47;5;3;8
293;16.02.2016;2016;02;09;Tiistai;22;6;28;5;4;9
293;16.02.2016;2016;02;10;Tiistai;17;2;19;7;2;9
293;16.02.2016;2016;02;11;Tiistai;6;5;11;4;7;11
293;16.02.2016;2016;02;12;Tiistai;6;3;9;10;4;14
293;16.02.2016;2016;02;13;Tiistai;6;10;16;11;12;23
293;16.02.2016;2016;02;14;Tiistai;3;48;51;4;16;20
293;16.02.2016;2016;02;15;Tiistai;3;68;71;5;16;21
293;16.02.2016;2016;02;16;Tiistai;8;12;20;7;7;14
293;16.02.2016;2016;02;17;Tiistai;8;5;13;5;13;18
293;16.02.2016;2016;02;18;Tiistai;5;5;10;5;6;11
293;16.02.2016;2016;02;19;Tiistai;4;3;7;3;5;8
293;16.02.2016;2016;02;20;Tiistai;1;10;11;2;3;5
293;16.02.2016;2016;02;21;Tiistai;0;2;2;0;2;2
293;16.02.2016;2016;02;22;Tiistai;0;0;0;0;0;0
293;16.02.2016;2016;02;23;Tiistai;0;0;0;0;0;0
293;17.02.2016;2016;02;00;Keskiviikko;0;0;0;0;0;0
293;17.02.2016;2016;02;01;Keskiviikko;0;0;0;0;0;0
293;17.02.2016;2016;02;02;Keskiviikko;0;0;0;0;0;0
293;17.02.2016;2016;02;03;Keskiviikko;0;0;0;0;0;0
293;17.02.2016;2016;02;04;Keskiviikko;0;0;0;0;0;0
293;17.02.2016;2016;02;05;Keskiviikko;2;1;3;0;0;0
293;17.02.2016;2016;02;06;Keskiviikko;8;1;9;1;1;2
293;17.02.2016;2016;02;07;Keskiviikko;66;3;69;11;1;12
293;17.02.2016;2016;02;08;Keskiviikko;51;6;57;7;4;11
293;17.02.2016;2016;02;09;Keskiviikko;10;1;11;9;0;9
293;17.02.2016;2016;02;10;Keskiviikko;16;2;18;3;6;9
293;17.02.2016;2016;02;11;Keskiviikko;6;5;11;6;4;10
293;17.02.2016;2016;02;12;Keskiviikko;6;16;22;4;8;12
293;17.02.2016;2016;02;13;Keskiviikko;3;7;10;7;9;16
293;17.02.2016;2016;02;14;Keskiviikko;5;88;93;4;21;25
293;17.02.2016;2016;02;15;Keskiviikko;10;15;25;0;4;4
293;17.02.2016;2016;02;16;Keskiviikko;11;22;33;1;6;7
293;17.02.2016;2016;02;17;Keskiviikko;7;6;13;8;8;16
293;17.02.2016;2016;02;18;Keskiviikko;3;7;10;4;12;16
293;17.02.2016;2016;02;19;Keskiviikko;2;10;12;5;4;9
293;17.02.2016;2016;02;20;Keskiviikko;2;2;4;2;1;3
293;17.02.2016;2016;02;21;Keskiviikko;1;4;5;2;2;4
293;17.02.2016;2016;02;22;Keskiviikko;0;0;0;1;1;2
293;17.02.2016;2016;02;23;Keskiviikko;0;0;0;0;0;0
293;18.02.2016;2016;02;00;Torstai;0;0;0;0;0;0
293;18.02.2016;2016;02;01;Torstai;0;1;1;0;0;0
293;18.02.2016;2016;02;02;Torstai;0;0;0;0;0;0
293;18.02.2016;2016;02;03;Torstai;0;0;0;0;0;0
293;18.02.2016;2016;02;04;Torstai;0;0;0;0;0;0
293;18.02.2016;2016;02;05;Torstai;3;0;3;0;0;0
293;18.02.2016;2016;02;06;Torstai;8;3;11;2;0;2
293;18.02.2016;2016;02;07;Torstai;49;1;50;9;3;12
293;18.02.2016;2016;02;08;Torstai;54;3;57;8;3;11
293;18.02.2016;2016;02;09;Torstai;30;5;35;8;5;13
293;18.02.2016;2016;02;10;Torstai;12;1;13;4;5;9
293;18.02.2016;2016;02;11;Torstai;4;7;11;7;1;8
293;18.02.2016;2016;02;12;Torstai;8;12;20;3;6;9
293;18.02.2016;2016;02;13;Torstai;4;19;23;5;2;7
293;18.02.2016;2016;02;14;Torstai;5;57;62;6;14;20
293;18.02.2016;2016;02;15;Torstai;9;47;56;3;15;18
293;18.02.2016;2016;02;16;Torstai;6;10;16;4;3;7
293;18.02.2016;2016;02;17;Torstai;3;5;8;4;10;14
293;18.02.2016;2016;02;18;Torstai;7;4;11;6;4;10
293;18.02.2016;2016;02;19;Torstai;0;3;3;2;5;7
293;18.02.2016;2016;02;20;Torstai;2;6;8;2;3;5
293;18.02.2016;2016;02;21;Torstai;0;4;4;0;1;1
293;18.02.2016;2016;02;22;Torstai;0;0;0;0;0;0
293;18.02.2016;2016;02;23;Torstai;0;0;0;0;0;0
293;19.02.2016;2016;02;00;Perjantai;0;0;0;0;1;1
293;19.02.2016;2016;02;01;Perjantai;0;0;0;0;0;0
293;19.02.2016;2016;02;02;Perjantai;0;0;0;0;0;0
293;19.02.2016;2016;02;03;Perjantai;0;0;0;0;0;0
293;19.02.2016;2016;02;04;Perjantai;0;0;0;0;0;0
293;19.02.2016;2016;02;05;Perjantai;0;0;0;0;0;0
293;19.02.2016;2016;02;06;Perjantai;2;2;4;2;1;3
293;19.02.2016;2016;02;07;Perjantai;58;4;62;12;1;13
293;19.02.2016;2016;02;08;Perjantai;51;5;56;6;3;9
293;19.02.2016;2016;02;09;Perjantai;19;1;20;5;3;8
293;19.02.2016;2016;02;10;Perjantai;4;3;7;12;3;15
293;19.02.2016;2016;02;11;Perjantai;2;3;5;3;4;7
293;19.02.2016;2016;02;12;Perjantai;4;26;30;11;25;36
293;19.02.2016;2016;02;13;Perjantai;3;13;16;8;11;19
293;19.02.2016;2016;02;14;Perjantai;7;35;42;5;17;22
293;19.02.2016;2016;02;15;Perjantai;11;34;45;3;11;14
293;19.02.2016;2016;02;16;Perjantai;6;2;8;7;6;13
293;19.02.2016;2016;02;17;Perjantai;7;4;11;7;5;12
293;19.02.2016;2016;02;18;Perjantai;8;9;17;7;7;14
293;19.02.2016;2016;02;19;Perjantai;0;8;8;5;5;10
293;19.02.2016;2016;02;20;Perjantai;4;5;9;3;10;13
293;19.02.2016;2016;02;21;Perjantai;3;6;9;2;1;3
293;19.02.2016;2016;02;22;Perjantai;1;3;4;1;0;1
293;19.02.2016;2016;02;23;Perjantai;1;2;3;1;2;3
293;20.02.2016;2016;02;00;Lauantai;0;0;0;0;0;0
293;20.02.2016;2016;02;01;Lauantai;0;0;0;0;0;0
293;20.02.2016;2016;02;02;Lauantai;0;0;0;0;0;0
293;20.02.2016;2016;02;03;Lauantai;1;0;1;0;2;2
293;20.02.2016;2016;02;04;Lauantai;0;0;0;0;1;1
293;20.02.2016;2016;02;05;Lauantai;0;0;0;0;0;0
293;20.02.2016;2016;02;06;Lauantai;1;0;1;1;1;2
293;20.02.2016;2016;02;07;Lauantai;0;0;0;2;0;2
293;20.02.2016;2016;02;08;Lauantai;4;2;6;0;1;1
293;20.02.2016;2016;02;09;Lauantai;4;3;7;6;3;9
293;20.02.2016;2016;02;10;Lauantai;6;0;6;9;5;14
293;20.02.2016;2016;02;11;Lauantai;5;7;12;12;10;22
293;20.02.2016;2016;02;12;Lauantai;5;4;9;8;8;16
293;20.02.2016;2016;02;13;Lauantai;6;4;10;5;7;12
293;20.02.2016;2016;02;14;Lauantai;10;7;17;2;4;6
293;20.02.2016;2016;02;15;Lauantai;7;2;9;4;8;12
293;20.02.2016;2016;02;16;Lauantai;2;6;8;4;6;10
293;20.02.2016;2016;02;17;Lauantai;7;5;12;10;11;21
293;20.02.2016;2016;02;18;Lauantai;5;4;9;2;7;9
293;20.02.2016;2016;02;19;Lauantai;2;2;4;0;2;2
293;20.02.2016;2016;02;20;Lauantai;6;3;9;0;2;2
293;20.02.2016;2016;02;21;Lauantai;1;8;9;0;3;3
293;20.02.2016;2016;02;22;Lauantai;0;1;1;0;0;0
293;20.02.2016;2016;02;23;Lauantai;1;1;2;0;3;3
293;21.02.2016;2016;02;00;Sunnuntai;0;0;0;1;1;2
293;21.02.2016;2016;02;01;Sunnuntai;0;2;2;0;0;0
293;21.02.2016;2016;02;02;Sunnuntai;0;0;0;1;0;1
293;21.02.2016;2016;02;03;Sunnuntai;0;0;0;4;0;4
293;21.02.2016;2016;02;04;Sunnuntai;0;0;0;0;0;0
293;21.02.2016;2016;02;05;Sunnuntai;0;0;0;0;0;0
293;21.02.2016;2016;02;06;Sunnuntai;0;0;0;1;0;1
293;21.02.2016;2016;02;07;Sunnuntai;0;0;0;0;0;0
293;21.02.2016;2016;02;08;Sunnuntai;0;0;0;1;1;2
293;21.02.2016;2016;02;09;Sunnuntai;4;0;4;1;1;2
293;21.02.2016;2016;02;10;Sunnuntai;2;1;3;3;4;7
293;21.02.2016;2016;02;11;Sunnuntai;1;4;5;5;5;10
293;21.02.2016;2016;02;12;Sunnuntai;3;1;4;3;8;11
293;21.02.2016;2016;02;13;Sunnuntai;2;2;4;5;4;9
293;21.02.2016;2016;02;14;Sunnuntai;4;2;6;5;4;9
293;21.02.2016;2016;02;15;Sunnuntai;5;2;7;5;3;8
293;21.02.2016;2016;02;16;Sunnuntai;2;4;6;1;4;5
293;21.02.2016;2016;02;17;Sunnuntai;6;5;11;4;5;9
293;21.02.2016;2016;02;18;Sunnuntai;7;4;11;4;9;13
293;21.02.2016;2016;02;19;Sunnuntai;2;6;8;4;1;5
293;21.02.2016;2016;02;20;Sunnuntai;2;5;7;1;2;3
293;21.02.2016;2016;02;21;Sunnuntai;1;1;2;0;0;0
293;21.02.2016;2016;02;22;Sunnuntai;0;0;0;0;0;0
293;21.02.2016;2016;02;23;Sunnuntai;0;0;0;0;0;0
293;22.02.2016;2016;02;00;Maanantai;0;0;0;0;0;0
293;22.02.2016;2016;02;01;Maanantai;0;0;0;0;0;0
293;22.02.2016;2016;02;02;Maanantai;0;0;0;0;0;0
293;22.02.2016;2016;02;03;Maanantai;0;0;0;0;0;0
293;22.02.2016;2016;02;04;Maanantai;0;0;0;0;0;0
293;22.02.2016;2016;02;05;Maanantai;1;0;1;1;0;1
293;22.02.2016;2016;02;06;Maanantai;2;4;6;2;1;3
293;22.02.2016;2016;02;07;Maanantai;51;4;55;18;3;21
293;22.02.2016;2016;02;08;Maanantai;45;4;49;14;4;18
293;22.02.2016;2016;02;09;Maanantai;25;2;27;7;2;9
293;22.02.2016;2016;02;10;Maanantai;15;0;15;8;4;12
293;22.02.2016;2016;02;11;Maanantai;2;3;5;5;5;10
293;22.02.2016;2016;02;12;Maanantai;3;7;10;9;3;12
293;22.02.2016;2016;02;13;Maanantai;4;27;31;9;13;22
293;22.02.2016;2016;02;14;Maanantai;4;32;36;7;15;22
293;22.02.2016;2016;02;15;Maanantai;5;46;51;4;14;18
293;22.02.2016;2016;02;16;Maanantai;8;11;19;4;5;9
293;22.02.2016;2016;02;17;Maanantai;2;8;10;8;5;13
293;22.02.2016;2016;02;18;Maanantai;3;4;7;4;2;6
293;22.02.2016;2016;02;19;Maanantai;2;1;3;2;3;5
293;22.02.2016;2016;02;20;Maanantai;2;4;6;3;2;5
293;22.02.2016;2016;02;21;Maanantai;1;6;7;2;1;3
293;22.02.2016;2016;02;22;Maanantai;1;0;1;0;0;0
293;22.02.2016;2016;02;23;Maanantai;1;0;1;0;0;0
293;23.02.2016;2016;02;00;Tiistai;2;0;2;0;0;0
293;23.02.2016;2016;02;01;Tiistai;1;0;1;3;0;3
293;23.02.2016;2016;02;02;Tiistai;0;0;0;0;0;0
293;23.02.2016;2016;02;03;Tiistai;0;0;0;0;0;0
293;23.02.2016;2016;02;04;Tiistai;0;0;0;5;1;6
293;23.02.2016;2016;02;05;Tiistai;3;0;3;1;0;1
293;23.02.2016;2016;02;06;Tiistai;10;2;12;3;0;3
293;23.02.2016;2016;02;07;Tiistai;52;4;56;12;1;13
293;23.02.2016;2016;02;08;Tiistai;43;4;47;7;0;7
293;23.02.2016;2016;02;09;Tiistai;22;5;27;10;3;13
293;23.02.2016;2016;02;10;Tiistai;16;4;20;6;3;9
293;23.02.2016;2016;02;11;Tiistai;5;5;10;7;3;10
293;23.02.2016;2016;02;12;Tiistai;6;6;12;3;2;5
293;23.02.2016;2016;02;13;Tiistai;4;7;11;3;8;11
293;23.02.2016;2016;02;14;Tiistai;5;60;65;2;18;20
293;23.02.2016;2016;02;15;Tiistai;6;64;70;4;10;14
293;23.02.2016;2016;02;16;Tiistai;7;9;16;7;10;17
293;23.02.2016;2016;02;17;Tiistai;5;5;10;6;6;12
293;23.02.2016;2016;02;18;Tiistai;0;5;5;7;5;12
293;23.02.2016;2016;02;19;Tiistai;2;4;6;0;5;5
293;23.02.2016;2016;02;20;Tiistai;1;12;13;3;1;4
293;23.02.2016;2016;02;21;Tiistai;0;1;1;1;0;1
293;23.02.2016;2016;02;22;Tiistai;0;0;0;0;0;0
293;23.02.2016;2016;02;23;Tiistai;0;0;0;1;0;1
293;24.02.2016;2016;02;00;Keskiviikko;0;0;0;0;0;0
293;24.02.2016;2016;02;01;Keskiviikko;0;0;0;0;0;0
293;24.02.2016;2016;02;02;Keskiviikko;0;0;0;0;0;0
293;24.02.2016;2016;02;03;Keskiviikko;0;0;0;0;0;0
293;24.02.2016;2016;02;04;Keskiviikko;0;0;0;0;0;0
293;24.02.2016;2016;02;05;Keskiviikko;1;0;1;0;0;0
293;24.02.2016;2016;02;06;Keskiviikko;5;2;7;3;1;4
293;24.02.2016;2016;02;07;Keskiviikko;74;6;80;9;0;9
293;24.02.2016;2016;02;08;Keskiviikko;49;9;58;8;4;12
293;24.02.2016;2016;02;09;Keskiviikko;14;1;15;8;3;11
293;24.02.2016;2016;02;10;Keskiviikko;10;3;13;4;5;9
293;24.02.2016;2016;02;11;Keskiviikko;6;6;12;7;4;11
293;24.02.2016;2016;02;12;Keskiviikko;3;8;11;5;10;15
293;24.02.2016;2016;02;13;Keskiviikko;3;13;16;5;7;12
293;24.02.2016;2016;02;14;Keskiviikko;2;89;91;2;9;11
293;24.02.2016;2016;02;15;Keskiviikko;13;20;33;3;5;8
293;24.02.2016;2016;02;16;Keskiviikko;6;17;23;4;9;13
293;24.02.2016;2016;02;17;Keskiviikko;5;8;13;2;8;10
293;24.02.2016;2016;02;18;Keskiviikko;2;4;6;6;5;11
293;24.02.2016;2016;02;19;Keskiviikko;1;4;5;3;8;11
293;24.02.2016;2016;02;20;Keskiviikko;0;4;4;2;4;6
293;24.02.2016;2016;02;21;Keskiviikko;1;2;3;2;1;3
293;24.02.2016;2016;02;22;Keskiviikko;0;0;0;0;1;1
293;24.02.2016;2016;02;23;Keskiviikko;0;0;0;0;0;0
293;25.02.2016;2016;02;00;Torstai;0;1;1;0;0;0
293;25.02.2016;2016;02;01;Torstai;0;0;0;0;0;0
293;25.02.2016;2016;02;02;Torstai;0;0;0;0;0;0
293;25.02.2016;2016;02;03;Torstai;0;0;0;0;0;0
293;25.02.2016;2016;02;04;Torstai;1;0;1;0;0;0
293;25.02.2016;2016;02;05;Torstai;1;0;1;0;0;0
293;25.02.2016;2016;02;06;Torstai;4;4;8;2;0;2
293;25.02.2016;2016;02;07;Torstai;31;30;61;9;3;12
293;25.02.2016;2016;02;08;Torstai;32;31;63;8;3;11
293;25.02.2016;2016;02;09;Torstai;16;16;32;8;5;13
293;25.02.2016;2016;02;10;Torstai;6;6;12;4;5;9
293;25.02.2016;2016;02;11;Torstai;6;5;11;7;1;8
293;25.02.2016;2016;02;12;Torstai;4;4;8;3;6;9
293;25.02.2016;2016;02;13;Torstai;11;11;22;5;2;7
293;25.02.2016;2016;02;14;Torstai;29;28;57;6;14;20
293;25.02.2016;2016;02;15;Torstai;37;37;74;3;15;18
293;25.02.2016;2016;02;16;Torstai;10;9;19;4;3;7
293;25.02.2016;2016;02;17;Torstai;4;4;8;4;10;14
293;25.02.2016;2016;02;18;Torstai;2;4;6;6;4;10
293;25.02.2016;2016;02;19;Torstai;1;2;3;2;5;7
293;25.02.2016;2016;02;20;Torstai;2;1;3;2;3;5
293;25.02.2016;2016;02;21;Torstai;2;2;4;0;1;1
293;25.02.2016;2016;02;22;Torstai;0;0;0;0;0;0
293;25.02.2016;2016;02;23;Torstai;1;0;1;0;0;0
293;26.02.2016;2016;02;00;Perjantai;0;0;0;0;0;0
293;26.02.2016;2016;02;01;Perjantai;0;0;0;0;0;0
293;26.02.2016;2016;02;02;Perjantai;0;0;0;0;0;0
293;26.02.2016;2016;02;03;Perjantai;0;0;0;0;0;0
293;26.02.2016;2016;02;04;Perjantai;0;0;0;0;0;0
293;26.02.2016;2016;02;05;Perjantai;1;0;1;0;0;0
293;26.02.2016;2016;02;06;Perjantai;4;3;7;0;0;0
293;26.02.2016;2016;02;07;Perjantai;45;21;66;2;0;2
293;26.02.2016;2016;02;08;Perjantai;36;15;51;0;0;0
293;26.02.2016;2016;02;09;Perjantai;13;10;23;2;0;2
293;26.02.2016;2016;02;10;Perjantai;7;6;13;3;0;3
293;26.02.2016;2016;02;11;Perjantai;2;6;8;6;6;12
293;26.02.2016;2016;02;12;Perjantai;4;23;27;4;4;8
293;26.02.2016;2016;02;13;Perjantai;7;27;34;3;10;13
293;26.02.2016;2016;02;14;Perjantai;5;39;44;2;5;7
293;26.02.2016;2016;02;15;Perjantai;6;46;52;1;12;13
293;26.02.2016;2016;02;16;Perjantai;10;10;20;8;2;10
293;26.02.2016;2016;02;17;Perjantai;13;3;16;11;5;16
293;26.02.2016;2016;02;18;Perjantai;2;5;7;5;4;9
293;26.02.2016;2016;02;19;Perjantai;3;1;4;1;8;9
293;26.02.2016;2016;02;20;Perjantai;0;5;5;0;5;5
293;26.02.2016;2016;02;21;Perjantai;1;2;3;0;1;1
293;26.02.2016;2016;02;22;Perjantai;0;8;8;5;5;10
293;26.02.2016;2016;02;23;Perjantai;0;0;0;0;0;0
293;27.02.2016;2016;02;00;Lauantai;0;1;1;0;0;0
293;27.02.2016;2016;02;01;Lauantai;0;0;0;0;0;0
293;27.02.2016;2016;02;02;Lauantai;0;0;0;0;0;0
293;27.02.2016;2016;02;03;Lauantai;0;0;0;0;0;0
293;27.02.2016;2016;02;04;Lauantai;0;0;0;0;0;0
293;27.02.2016;2016;02;05;Lauantai;0;0;0;0;0;0
293;27.02.2016;2016;02;06;Lauantai;1;0;1;1;0;1
293;27.02.2016;2016;02;07;Lauantai;0;1;1;0;2;2
293;27.02.2016;2016;02;08;Lauantai;4;1;5;4;2;6
293;27.02.2016;2016;02;09;Lauantai;3;4;7;4;5;9
293;27.02.2016;2016;02;10;Lauantai;1;6;7;13;6;19
293;27.02.2016;2016;02;11;Lauantai;4;3;7;4;9;13
293;27.02.2016;2016;02;12;Lauantai;6;6;12;6;4;10
293;27.02.2016;2016;02;13;Lauantai;6;3;9;13;7;20
293;27.02.2016;2016;02;14;Lauantai;4;5;9;3;10;13
293;27.02.2016;2016;02;15;Lauantai;11;4;15;6;5;11
293;27.02.2016;2016;02;16;Lauantai;6;5;11;7;10;17
293;27.02.2016;2016;02;17;Lauantai;6;4;10;1;2;3
293;27.02.2016;2016;02;18;Lauantai;1;8;9;9;6;15
293;27.02.2016;2016;02;19;Lauantai;3;5;8;4;6;10
293;27.02.2016;2016;02;20;Lauantai;5;5;10;1;3;4
293;27.02.2016;2016;02;21;Lauantai;1;0;1;0;3;3
293;27.02.2016;2016;02;22;Lauantai;0;2;2;0;2;2
293;27.02.2016;2016;02;23;Lauantai;0;0;0;0;0;0
293;28.02.2016;2016;02;00;Sunnuntai;1;0;1;0;3;3
293;28.02.2016;2016;02;01;Sunnuntai;2;0;2;0;0;0
293;28.02.2016;2016;02;02;Sunnuntai;0;0;0;0;1;1
293;28.02.2016;2016;02;03;Sunnuntai;0;0;0;0;1;1
293;28.02.2016;2016;02;04;Sunnuntai;0;0;0;0;0;0
293;28.02.2016;2016;02;05;Sunnuntai;0;0;0;0;0;0
293;28.02.2016;2016;02;06;Sunnuntai;0;0;0;0;0;0
293;28.02.2016;2016;02;07;Sunnuntai;1;0;1;1;0;1
293;28.02.2016;2016;02;08;Sunnuntai;1;0;1;0;0;0
293;28.02.2016;2016;02;09;Sunnuntai;4;1;5;8;1;9
293;28.02.2016;2016;02;10;Sunnuntai;5;2;7;9;12;21
293;28.02.2016;2016;02;11;Sunnuntai;5;3;8;9;8;17
293;28.02.2016;2016;02;12;Sunnuntai;2;8;10;14;8;22
293;28.02.2016;2016;02;13;Sunnuntai;5;5;10;14;9;23
293;28.02.2016;2016;02;14;Sunnuntai;5;5;10;6;8;14
293;28.02.2016;2016;02;15;Sunnuntai;5;2;7;7;7;14
293;28.02.2016;2016;02;16;Sunnuntai;8;4;12;3;7;10
293;28.02.2016;2016;02;17;Sunnuntai;3;3;6;3;3;6
293;28.02.2016;2016;02;18;Sunnuntai;3;7;10;1;0;1
293;28.02.2016;2016;02;19;Sunnuntai;0;2;2;1;3;4
293;28.02.2016;2016;02;20;Sunnuntai;2;2;4;0;2;2
293;28.02.2016;2016;02;21;Sunnuntai;1;0;1;2;0;2
293;28.02.2016;2016;02;22;Sunnuntai;0;0;0;1;1;2
293;28.02.2016;2016;02;23;Sunnuntai;0;0;0;0;0;0
293;29.02.2016;2016;02;00;Maanantai;0;0;0;0;0;0
293;29.02.2016;2016;02;01;Maanantai;0;0;0;0;0;0
293;29.02.2016;2016;02;02;Maanantai;0;0;0;0;0;0
293;29.02.2016;2016;02;03;Maanantai;0;0;0;0;0;0
293;29.02.2016;2016;02;04;Maanantai;0;0;0;0;0;0
293;29.02.2016;2016;02;05;Maanantai;1;1;2;0;1;1
293;29.02.2016;2016;02;06;Maanantai;7;2;9;1;0;1
293;29.02.2016;2016;02;07;Maanantai;40;5;45;9;3;12
293;29.02.2016;2016;02;08;Maanantai;81;4;85;9;1;10
293;29.02.2016;2016;02;09;Maanantai;22;0;22;6;2;8
293;29.02.2016;2016;02;10;Maanantai;5;4;9;6;2;8
293;29.02.2016;2016;02;11;Maanantai;1;4;5;4;2;6
293;29.02.2016;2016;02;12;Maanantai;4;5;9;10;3;13
293;29.02.2016;2016;02;13;Maanantai;8;29;37;6;11;17
293;29.02.2016;2016;02;14;Maanantai;4;44;48;3;13;16
293;29.02.2016;2016;02;15;Maanantai;7;58;65;6;9;15
293;29.02.2016;2016;02;16;Maanantai;9;10;19;4;7;11
293;29.02.2016;2016;02;17;Maanantai;5;7;12;6;5;11
293;29.02.2016;2016;02;18;Maanantai;1;4;5;7;6;13
293;29.02.2016;2016;02;19;Maanantai;4;3;7;1;4;5
293;29.02.2016;2016;02;20;Maanantai;1;2;3;1;2;3
293;29.02.2016;2016;02;21;Maanantai;1;4;5;1;1;2
293;29.02.2016;2016;02;22;Maanantai;0;0;0;0;0;0
293;29.02.2016;2016;02;23;Maanantai;0;0;0;0;0;0
293;01.03.2016;2016;03;00;Tiistai;0;0;0;0;0;0
293;01.03.2016;2016;03;01;Tiistai;0;0;0;0;0;0
293;01.03.2016;2016;03;02;Tiistai;0;0;0;0;0;0
293;01.03.2016;2016;03;03;Tiistai;0;0;0;0;0;0
293;01.03.2016;2016;03;04;Tiistai;0;0;0;0;0;0
293;01.03.2016;2016;03;05;Tiistai;2;0;2;0;0;0
293;01.03.2016;2016;03;06;Tiistai;9;3;12;3;0;3
293;01.03.2016;2016;03;07;Tiistai;61;3;64;12;0;12
293;01.03.2016;2016;03;08;Tiistai;52;2;54;7;2;9
293;01.03.2016;2016;03;09;Tiistai;29;5;34;9;3;12
293;01.03.2016;2016;03;10;Tiistai;17;8;25;6;5;11
293;01.03.2016;2016;03;11;Tiistai;5;5;10;7;7;14
293;01.03.2016;2016;03;12;Tiistai;3;2;5;6;6;12
293;01.03.2016;2016;03;13;Tiistai;4;14;18;9;13;22
293;01.03.2016;2016;03;14;Tiistai;5;52;57;9;18;27
293;01.03.2016;2016;03;15;Tiistai;15;65;80;3;12;15
293;01.03.2016;2016;03;16;Tiistai;11;14;25;6;9;15
293;01.03.2016;2016;03;17;Tiistai;4;12;16;7;11;18
293;01.03.2016;2016;03;18;Tiistai;6;4;10;3;8;11
293;01.03.2016;2016;03;19;Tiistai;5;3;8;2;4;6
293;01.03.2016;2016;03;20;Tiistai;2;12;14;4;3;7
293;01.03.2016;2016;03;21;Tiistai;2;1;3;0;1;1
293;01.03.2016;2016;03;22;Tiistai;0;0;0;1;1;2
293;01.03.2016;2016;03;23;Tiistai;0;0;0;0;0;0
293;02.03.2016;2016;03;00;Keskiviikko;0;0;0;0;0;0
293;02.03.2016;2016;03;01;Keskiviikko;0;0;0;0;0;0
293;02.03.2016;2016;03;02;Keskiviikko;0;0;0;0;0;0
293;02.03.2016;2016;03;03;Keskiviikko;0;0;0;0;0;0
293;02.03.2016;2016;03;04;Keskiviikko;0;0;0;0;0;0
293;02.03.2016;2016;03;05;Keskiviikko;2;1;3;0;0;0
293;02.03.2016;2016;03;06;Keskiviikko;12;0;12;2;1;3
293;02.03.2016;2016;03;07;Keskiviikko;76;3;79;14;3;17
293;02.03.2016;2016;03;08;Keskiviikko;54;4;58;4;6;10
293;02.03.2016;2016;03;09;Keskiviikko;19;2;21;8;1;9
293;02.03.2016;2016;03;10;Keskiviikko;11;4;15;6;1;7
293;02.03.2016;2016;03;11;Keskiviikko;5;4;9;4;6;10
293;02.03.2016;2016;03;12;Keskiviikko;3;14;17;5;12;17
293;02.03.2016;2016;03;13;Keskiviikko;7;94;101;7;23;30
293;02.03.2016;2016;03;14;Keskiviikko;8;21;29;5;7;12
293;02.03.2016;2016;03;15;Keskiviikko;14;24;38;5;10;15
293;02.03.2016;2016;03;16;Keskiviikko;16;14;30;9;10;19
293;02.03.2016;2016;03;17;Keskiviikko;6;6;12;5;8;13
293;02.03.2016;2016;03;18;Keskiviikko;8;4;12;4;6;10
293;02.03.2016;2016;03;19;Keskiviikko;1;3;4;3;8;11
293;02.03.2016;2016;03;20;Keskiviikko;0;14;14;2;1;3
293;02.03.2016;2016;03;21;Keskiviikko;0;4;4;0;1;1
293;02.03.2016;2016;03;22;Keskiviikko;0;0;0;0;0;0
293;02.03.2016;2016;03;23;Keskiviikko;0;0;0;0;0;0
293;03.03.2016;2016;03;00;Torstai;0;0;0;0;0;0
293;03.03.2016;2016;03;01;Torstai;0;1;1;0;0;0
293;03.03.2016;2016;03;02;Torstai;1;0;1;0;0;0
293;03.03.2016;2016;03;03;Torstai;0;0;0;0;0;0
293;03.03.2016;2016;03;04;Torstai;0;0;0;0;0;0
293;03.03.2016;2016;03;05;Torstai;2;0;2;0;0;0
293;03.03.2016;2016;03;06;Torstai;7;2;9;1;0;1
293;03.03.2016;2016;03;07;Torstai;60;4;64;10;0;10
293;03.03.2016;2016;03;08;Torstai;52;4;56;10;2;12
293;03.03.2016;2016;03;09;Torstai;25;3;28;3;5;8
293;03.03.2016;2016;03;10;Torstai;13;4;17;5;3;8
293;03.03.2016;2016;03;11;Torstai;6;5;11;6;4;10
293;03.03.2016;2016;03;12;Torstai;3;5;8;2;8;10
293;03.03.2016;2016;03;13;Torstai;3;16;19;6;5;11
293;03.03.2016;2016;03;14;Torstai;11;65;76;6;10;16
293;03.03.2016;2016;03;15;Torstai;9;55;64;5;10;15
293;03.03.2016;2016;03;16;Torstai;8;15;23;5;3;8
293;03.03.2016;2016;03;17;Torstai;14;7;21;4;5;9
293;03.03.2016;2016;03;18;Torstai;4;6;10;6;7;13
293;03.03.2016;2016;03;19;Torstai;6;9;15;2;4;6
293;03.03.2016;2016;03;20;Torstai;1;10;11;1;7;8
293;03.03.2016;2016;03;21;Torstai;1;4;5;2;1;3
293;03.03.2016;2016;03;22;Torstai;1;0;1;1;0;1
293;03.03.2016;2016;03;23;Torstai;0;0;0;0;0;0
293;04.03.2016;2016;03;00;Perjantai;0;0;0;0;0;0
293;04.03.2016;2016;03;01;Perjantai;0;0;0;0;0;0
293;04.03.2016;2016;03;02;Perjantai;0;0;0;0;0;0
293;04.03.2016;2016;03;03;Perjantai;0;0;0;0;0;0
293;04.03.2016;2016;03;04;Perjantai;0;0;0;0;0;0
293;04.03.2016;2016;03;05;Perjantai;0;1;1;0;0;0
293;04.03.2016;2016;03;06;Perjantai;10;2;12;1;1;2
293;04.03.2016;2016;03;07;Perjantai;74;1;75;15;1;16
293;04.03.2016;2016;03;08;Perjantai;51;6;57;7;1;8
293;04.03.2016;2016;03;09;Perjantai;18;5;23;4;0;4
293;04.03.2016;2016;03;10;Perjantai;7;1;8;1;1;2
293;04.03.2016;2016;03;11;Perjantai;2;7;9;8;7;15
293;04.03.2016;2016;03;12;Perjantai;3;22;25;5;9;14
293;04.03.2016;2016;03;13;Perjantai;9;66;75;8;20;28
293;04.03.2016;2016;03;14;Perjantai;5;38;43;3;9;12
293;04.03.2016;2016;03;15;Perjantai;6;15;21;5;8;13
293;04.03.2016;2016;03;16;Perjantai;1;3;4;2;4;6
293;04.03.2016;2016;03;17;Perjantai;8;5;13;4;2;6
293;04.03.2016;2016;03;18;Perjantai;10;5;15;4;3;7
293;04.03.2016;2016;03;19;Perjantai;3;8;11;1;2;3
293;04.03.2016;2016;03;20;Perjantai;2;11;13;0;3;3
293;04.03.2016;2016;03;21;Perjantai;1;6;7;1;2;3
293;04.03.2016;2016;03;22;Perjantai;0;2;2;1;0;1
293;04.03.2016;2016;03;23;Perjantai;0;0;0;2;0;2
293;05.03.2016;2016;03;00;Lauantai;0;0;0;0;1;1
293;05.03.2016;2016;03;01;Lauantai;0;0;0;0;0;0
293;05.03.2016;2016;03;02;Lauantai;0;0;0;0;0;0
293;05.03.2016;2016;03;03;Lauantai;0;0;0;1;6;7
293;05.03.2016;2016;03;04;Lauantai;0;0;0;0;0;0
293;05.03.2016;2016;03;05;Lauantai;1;0;1;0;0;0
293;05.03.2016;2016;03;06;Lauantai;0;0;0;1;0;1
293;05.03.2016;2016;03;07;Lauantai;1;0;1;0;0;0
293;05.03.2016;2016;03;08;Lauantai;3;1;4;7;4;11
293;05.03.2016;2016;03;09;Lauantai;3;1;4;3;3;6
293;05.03.2016;2016;03;10;Lauantai;3;5;8;7;8;15
293;05.03.2016;2016;03;11;Lauantai;6;5;11;5;7;12
293;05.03.2016;2016;03;12;Lauantai;7;3;10;7;6;13
293;05.03.2016;2016;03;13;Lauantai;3;3;6;3;3;6
293;05.03.2016;2016;03;14;Lauantai;2;6;8;4;7;11
293;05.03.2016;2016;03;15;Lauantai;3;4;7;4;4;8
293;05.03.2016;2016;03;16;Lauantai;3;4;7;6;4;10
293;05.03.2016;2016;03;17;Lauantai;2;3;5;2;2;4
293;05.03.2016;2016;03;18;Lauantai;6;3;9;4;2;6
293;05.03.2016;2016;03;19;Lauantai;0;4;4;2;3;5
293;05.03.2016;2016;03;20;Lauantai;0;1;1;0;1;1
293;05.03.2016;2016;03;21;Lauantai;2;4;6;1;0;1
293;05.03.2016;2016;03;22;Lauantai;3;2;5;2;0;2
293;05.03.2016;2016;03;23;Lauantai;1;0;1;1;0;1
293;06.03.2016;2016;03;00;Sunnuntai;0;0;0;0;1;1
293;06.03.2016;2016;03;01;Sunnuntai;0;1;1;0;1;1
293;06.03.2016;2016;03;02;Sunnuntai;0;0;0;0;3;3
293;06.03.2016;2016;03;03;Sunnuntai;0;0;0;0;1;1
293;06.03.2016;2016;03;04;Sunnuntai;0;0;0;1;2;3
293;06.03.2016;2016;03;05;Sunnuntai;2;0;2;0;0;0
293;06.03.2016;2016;03;06;Sunnuntai;0;0;0;1;0;1
293;06.03.2016;2016;03;07;Sunnuntai;0;0;0;0;0;0
293;06.03.2016;2016;03;08;Sunnuntai;0;1;1;0;0;0
293;06.03.2016;2016;03;09;Sunnuntai;5;10;15;8;4;12
293;06.03.2016;2016;03;10;Sunnuntai;2;1;3;7;9;16
293;06.03.2016;2016;03;11;Sunnuntai;7;2;9;6;10;16
293;06.03.2016;2016;03;12;Sunnuntai;6;3;9;10;10;20
293;06.03.2016;2016;03;13;Sunnuntai;3;3;6;7;9;16
293;06.03.2016;2016;03;14;Sunnuntai;4;2;6;6;7;13
293;06.03.2016;2016;03;15;Sunnuntai;6;3;9;5;11;16
293;06.03.2016;2016;03;16;Sunnuntai;2;7;9;9;7;16
293;06.03.2016;2016;03;17;Sunnuntai;0;3;3;7;6;13
293;06.03.2016;2016;03;18;Sunnuntai;3;2;5;1;2;3
293;06.03.2016;2016;03;19;Sunnuntai;1;5;6;1;3;4
293;06.03.2016;2016;03;20;Sunnuntai;3;0;3;0;4;4
293;06.03.2016;2016;03;21;Sunnuntai;0;0;0;1;2;3
293;06.03.2016;2016;03;22;Sunnuntai;0;0;0;1;1;2
293;06.03.2016;2016;03;23;Sunnuntai;1;0;1;0;2;2
293;07.03.2016;2016;03;00;Maanantai;0;1;1;0;0;0
293;07.03.2016;2016;03;01;Maanantai;0;1;1;0;1;1
293;07.03.2016;2016;03;02;Maanantai;0;0;0;0;0;0
293;07.03.2016;2016;03;03;Maanantai;1;0;1;0;0;0
293;07.03.2016;2016;03;04;Maanantai;0;0;0;0;0;0
293;07.03.2016;2016;03;05;Maanantai;2;0;2;0;0;0
293;07.03.2016;2016;03;06;Maanantai;4;1;5;1;2;3
293;07.03.2016;2016;03;07;Maanantai;8;3;11;4;1;5
293;07.03.2016;2016;03;08;Maanantai;4;2;6;0;3;3
293;07.03.2016;2016;03;09;Maanantai;6;4;10;3;3;6
293;07.03.2016;2016;03;10;Maanantai;4;9;13;4;4;8
293;07.03.2016;2016;03;11;Maanantai;9;6;15;8;1;9
293;07.03.2016;2016;03;12;Maanantai;11;2;13;8;3;11
293;07.03.2016;2016;03;13;Maanantai;8;10;18;6;7;13
293;07.03.2016;2016;03;14;Maanantai;0;8;8;5;6;11
293;07.03.2016;2016;03;15;Maanantai;4;9;13;3;2;5
293;07.03.2016;2016;03;16;Maanantai;2;3;5;2;3;5
293;07.03.2016;2016;03;17;Maanantai;5;5;10;5;9;14
293;07.03.2016;2016;03;18;Maanantai;4;8;12;4;5;9
293;07.03.2016;2016;03;19;Maanantai;3;1;4;2;2;4
293;07.03.2016;2016;03;20;Maanantai;1;1;2;0;4;4
293;07.03.2016;2016;03;21;Maanantai;2;2;4;0;2;2
293;07.03.2016;2016;03;22;Maanantai;0;0;0;0;0;0
293;07.03.2016;2016;03;23;Maanantai;0;0;0;0;1;1
293;08.03.2016;2016;03;00;Tiistai;0;0;0;1;0;1
293;08.03.2016;2016;03;01;Tiistai;0;0;0;0;0;0
293;08.03.2016;2016;03;02;Tiistai;0;0;0;0;0;0
293;08.03.2016;2016;03;03;Tiistai;0;0;0;0;0;0
293;08.03.2016;2016;03;04;Tiistai;1;0;1;0;0;0
293;08.03.2016;2016;03;05;Tiistai;2;0;2;0;0;0
293;08.03.2016;2016;03;06;Tiistai;7;1;8;2;0;2
293;08.03.2016;2016;03;07;Tiistai;5;2;7;3;1;4
293;08.03.2016;2016;03;08;Tiistai;5;2;7;2;1;3
293;08.03.2016;2016;03;09;Tiistai;6;5;11;0;3;3
293;08.03.2016;2016;03;10;Tiistai;3;6;9;5;4;9
293;08.03.2016;2016;03;11;Tiistai;4;5;9;9;4;13
293;08.03.2016;2016;03;12;Tiistai;6;5;11;3;4;7
293;08.03.2016;2016;03;13;Tiistai;9;8;17;6;5;11
293;08.03.2016;2016;03;14;Tiistai;4;14;18;8;7;15
293;08.03.2016;2016;03;15;Tiistai;5;5;10;8;8;16
293;08.03.2016;2016;03;16;Tiistai;1;6;7;4;6;10
293;08.03.2016;2016;03;17;Tiistai;0;2;2;6;6;12
293;08.03.2016;2016;03;18;Tiistai;1;1;2;5;6;11
293;08.03.2016;2016;03;19;Tiistai;0;8;8;3;5;8
293;08.03.2016;2016;03;20;Tiistai;0;1;1;1;1;2
293;08.03.2016;2016;03;21;Tiistai;0;2;2;0;1;1
293;08.03.2016;2016;03;22;Tiistai;0;2;2;0;1;1
293;08.03.2016;2016;03;23;Tiistai;0;0;0;0;0;0
293;09.03.2016;2016;03;00;Keskiviikko;0;0;0;0;0;0
293;09.03.2016;2016;03;01;Keskiviikko;0;0;0;0;0;0
293;09.03.2016;2016;03;02;Keskiviikko;0;0;0;0;0;0
293;09.03.2016;2016;03;03;Keskiviikko;0;0;0;0;0;0
293;09.03.2016;2016;03;04;Keskiviikko;0;0;0;0;0;0
293;09.03.2016;2016;03;05;Keskiviikko;1;0;1;1;0;1
293;09.03.2016;2016;03;06;Keskiviikko;5;1;6;1;0;1
293;09.03.2016;2016;03;07;Keskiviikko;7;1;8;3;0;3
293;09.03.2016;2016;03;08;Keskiviikko;2;1;3;1;1;2
293;09.03.2016;2016;03;09;Keskiviikko;3;3;6;2;1;3
293;09.03.2016;2016;03;10;Keskiviikko;6;6;12;3;1;4
293;09.03.2016;2016;03;11;Keskiviikko;4;4;8;6;5;11
293;09.03.2016;2016;03;12;Keskiviikko;3;4;7;7;2;9
293;09.03.2016;2016;03;13;Keskiviikko;6;10;16;4;11;15
293;09.03.2016;2016;03;14;Keskiviikko;4;9;13;2;4;6
293;09.03.2016;2016;03;15;Keskiviikko;9;10;19;4;8;12
293;09.03.2016;2016;03;16;Keskiviikko;2;4;6;3;8;11
293;09.03.2016;2016;03;17;Keskiviikko;3;3;6;4;3;7
293;09.03.2016;2016;03;18;Keskiviikko;4;6;10;1;2;3
293;09.03.2016;2016;03;19;Keskiviikko;0;1;1;1;6;7
293;09.03.2016;2016;03;20;Keskiviikko;0;4;4;1;2;3
293;09.03.2016;2016;03;21;Keskiviikko;0;4;4;0;1;1
293;09.03.2016;2016;03;22;Keskiviikko;2;0;2;0;0;0
293;09.03.2016;2016;03;23;Keskiviikko;0;0;0;0;0;0
293;10.03.2016;2016;03;00;Torstai;0;0;0;0;0;0
293;10.03.2016;2016;03;01;Torstai;0;0;0;0;0;0
293;10.03.2016;2016;03;02;Torstai;0;0;0;0;0;0
293;10.03.2016;2016;03;03;Torstai;0;0;0;0;0;0
293;10.03.2016;2016;03;04;Torstai;0;1;1;0;0;0
293;10.03.2016;2016;03;05;Torstai;3;0;3;0;0;0
293;10.03.2016;2016;03;06;Torstai;4;2;6;2;0;2
293;10.03.2016;2016;03;07;Torstai;4;2;6;2;0;2
293;10.03.2016;2016;03;08;Torstai;3;1;4;3;2;5
293;10.03.2016;2016;03;09;Torstai;2;4;6;2;6;8
293;10.03.2016;2016;03;10;Torstai;2;3;5;7;6;13
293;10.03.2016;2016;03;11;Torstai;4;3;7;2;3;5
293;10.03.2016;2016;03;12;Torstai;4;3;7;8;5;13
293;10.03.2016;2016;03;13;Torstai;6;5;11;4;5;9
293;10.03.2016;2016;03;14;Torstai;4;7;11;8;8;16
293;10.03.2016;2016;03;15;Torstai;5;8;13;3;8;11
293;10.03.2016;2016;03;16;Torstai;8;3;11;3;4;7
293;10.03.2016;2016;03;17;Torstai;6;4;10;4;4;8
293;10.03.2016;2016;03;18;Torstai;2;2;4;1;2;3
293;10.03.2016;2016;03;19;Torstai;3;7;10;3;4;7
293;10.03.2016;2016;03;20;Torstai;3;3;6;0;1;1
293;10.03.2016;2016;03;21;Torstai;0;1;1;0;3;3
293;10.03.2016;2016;03;22;Torstai;0;0;0;0;0;0
293;10.03.2016;2016;03;23;Torstai;0;0;0;0;0;0
293;11.03.2016;2016;03;00;Perjantai;0;0;0;0;0;0
293;11.03.2016;2016;03;01;Perjantai;0;0;0;0;0;0
293;11.03.2016;2016;03;02;Perjantai;0;1;1;0;0;0
293;11.03.2016;2016;03;03;Perjantai;0;1;1;0;0;0
293;11.03.2016;2016;03;04;Perjantai;1;0;1;0;2;2
293;11.03.2016;2016;03;05;Perjantai;1;0;1;0;0;0
293;11.03.2016;2016;03;06;Perjantai;4;2;6;1;0;1
293;11.03.2016;2016;03;07;Perjantai;6;1;7;2;1;3
293;11.03.2016;2016;03;08;Perjantai;1;1;2;0;1;1
293;11.03.2016;2016;03;09;Perjantai;8;5;13;2;1;3
293;11.03.2016;2016;03;10;Perjantai;4;6;10;4;1;5
293;11.03.2016;2016;03;11;Perjantai;1;2;3;5;3;8
293;11.03.2016;2016;03;12;Perjantai;2;2;4;3;4;7
293;11.03.2016;2016;03;13;Perjantai;1;3;4;5;5;10
293;11.03.2016;2016;03;14;Perjantai;4;8;12;9;4;13
293;11.03.2016;2016;03;15;Perjantai;7;15;22;5;6;11
293;11.03.2016;2016;03;16;Perjantai;2;2;4;6;6;12
293;11.03.2016;2016;03;17;Perjantai;3;3;6;1;7;8
293;11.03.2016;2016;03;18;Perjantai;2;4;6;1;7;8
293;11.03.2016;2016;03;19;Perjantai;2;5;7;3;3;6
293;11.03.2016;2016;03;20;Perjantai;2;5;7;2;3;5
293;11.03.2016;2016;03;21;Perjantai;0;2;2;0;2;2
293;11.03.2016;2016;03;22;Perjantai;3;1;4;1;0;1
293;11.03.2016;2016;03;23;Perjantai;1;0;1;1;0;1
293;12.03.2016;2016;03;00;Lauantai;0;0;0;0;0;0
293;12.03.2016;2016;03;01;Lauantai;1;1;2;0;0;0
293;12.03.2016;2016;03;02;Lauantai;0;0;0;0;1;1
293;12.03.2016;2016;03;03;Lauantai;0;0;0;0;3;3
293;12.03.2016;2016;03;04;Lauantai;2;0;2;0;0;0
293;12.03.2016;2016;03;05;Lauantai;0;0;0;1;0;1
293;12.03.2016;2016;03;06;Lauantai;1;1;2;1;1;2
293;12.03.2016;2016;03;07;Lauantai;0;0;0;1;0;1
293;12.03.2016;2016;03;08;Lauantai;3;0;3;1;1;2
293;12.03.2016;2016;03;09;Lauantai;2;2;4;1;4;5
293;12.03.2016;2016;03;10;Lauantai;3;2;5;6;4;10
293;12.03.2016;2016;03;11;Lauantai;3;7;10;9;22;31
293;12.03.2016;2016;03;12;Lauantai;1;1;2;3;3;6
293;12.03.2016;2016;03;13;Lauantai;5;1;6;7;5;12
293;12.03.2016;2016;03;14;Lauantai;2;3;5;6;10;16
293;12.03.2016;2016;03;15;Lauantai;4;4;8;5;6;11
293;12.03.2016;2016;03;16;Lauantai;7;7;14;4;8;12
293;12.03.2016;2016;03;17;Lauantai;2;0;2;3;3;6
293;12.03.2016;2016;03;18;Lauantai;2;1;3;5;2;7
293;12.03.2016;2016;03;19;Lauantai;3;2;5;3;6;9
293;12.03.2016;2016;03;20;Lauantai;7;2;9;3;4;7
293;12.03.2016;2016;03;21;Lauantai;0;2;2;0;1;1
293;12.03.2016;2016;03;22;Lauantai;0;3;3;0;1;1
293;12.03.2016;2016;03;23;Lauantai;0;4;4;0;0;0
293;13.03.2016;2016;03;00;Sunnuntai;0;0;0;1;0;1
293;13.03.2016;2016;03;01;Sunnuntai;0;0;0;0;1;1
293;13.03.2016;2016;03;02;Sunnuntai;0;2;2;0;4;4
293;13.03.2016;2016;03;03;Sunnuntai;2;0;2;0;0;0
293;13.03.2016;2016;03;04;Sunnuntai;0;0;0;0;0;0
293;13.03.2016;2016;03;05;Sunnuntai;0;0;0;0;0;0
293;13.03.2016;2016;03;06;Sunnuntai;0;0;0;1;0;1
293;13.03.2016;2016;03;07;Sunnuntai;0;0;0;0;0;0
293;13.03.2016;2016;03;08;Sunnuntai;0;0;0;1;0;1
293;13.03.2016;2016;03;09;Sunnuntai;1;1;2;4;1;5
293;13.03.2016;2016;03;10;Sunnuntai;3;2;5;10;7;17
293;13.03.2016;2016;03;11;Sunnuntai;5;3;8;3;6;9
293;13.03.2016;2016;03;12;Sunnuntai;6;4;10;4;13;17
293;13.03.2016;2016;03;13;Sunnuntai;3;5;8;9;8;17
293;13.03.2016;2016;03;14;Sunnuntai;4;1;5;5;6;11
293;13.03.2016;2016;03;15;Sunnuntai;9;4;13;4;1;5
293;13.03.2016;2016;03;16;Sunnuntai;1;7;8;4;4;8
293;13.03.2016;2016;03;17;Sunnuntai;4;3;7;8;7;15
293;13.03.2016;2016;03;18;Sunnuntai;0;4;4;2;4;6
293;13.03.2016;2016;03;19;Sunnuntai;2;3;5;1;2;3
293;13.03.2016;2016;03;20;Sunnuntai;0;1;1;1;3;4
293;13.03.2016;2016;03;21;Sunnuntai;0;1;1;0;0;0
293;13.03.2016;2016;03;22;Sunnuntai;0;0;0;1;0;1
293;13.03.2016;2016;03;23;Sunnuntai;0;0;0;0;0;0
293;14.03.2016;2016;03;00;Maanantai;0;0;0;0;0;0
293;14.03.2016;2016;03;01;Maanantai;0;0;0;0;0;0
293;14.03.2016;2016;03;02;Maanantai;0;0;0;0;0;0
293;14.03.2016;2016;03;03;Maanantai;0;1;1;0;0;0
293;14.03.2016;2016;03;04;Maanantai;0;0;0;0;0;0
293;14.03.2016;2016;03;05;Maanantai;2;0;2;0;0;0
293;14.03.2016;2016;03;06;Maanantai;6;3;9;4;0;4
293;14.03.2016;2016;03;07;Maanantai;46;1;47;15;3;18
293;14.03.2016;2016;03;08;Maanantai;49;3;52;7;9;16
293;14.03.2016;2016;03;09;Maanantai;44;3;47;10;8;18
293;14.03.2016;2016;03;10;Maanantai;16;2;18;6;2;8
293;14.03.2016;2016;03;11;Maanantai;6;6;12;5;7;12
293;14.03.2016;2016;03;12;Maanantai;6;8;14;10;11;21
293;14.03.2016;2016;03;13;Maanantai;5;30;35;2;9;11
293;14.03.2016;2016;03;14;Maanantai;4;32;36;2;11;13
293;14.03.2016;2016;03;15;Maanantai;10;63;73;2;16;18
293;14.03.2016;2016;03;16;Maanantai;15;16;31;5;4;9
293;14.03.2016;2016;03;17;Maanantai;4;7;11;6;11;17
293;14.03.2016;2016;03;18;Maanantai;3;11;14;9;14;23
293;14.03.2016;2016;03;19;Maanantai;4;2;6;4;5;9
293;14.03.2016;2016;03;20;Maanantai;2;3;5;0;4;4
293;14.03.2016;2016;03;21;Maanantai;0;3;3;1;0;1
293;14.03.2016;2016;03;22;Maanantai;1;1;2;0;0;0
293;14.03.2016;2016;03;23;Maanantai;1;0;1;0;0;0
293;15.03.2016;2016;03;00;Tiistai;0;0;0;0;0;0
293;15.03.2016;2016;03;01;Tiistai;0;0;0;0;0;0
293;15.03.2016;2016;03;02;Tiistai;0;0;0;0;0;0
293;15.03.2016;2016;03;03;Tiistai;0;1;1;0;0;0
293;15.03.2016;2016;03;04;Tiistai;0;0;0;0;0;0
293;15.03.2016;2016;03;05;Tiistai;1;1;2;1;0;1
293;15.03.2016;2016;03;06;Tiistai;11;1;12;1;0;1
293;15.03.2016;2016;03;07;Tiistai;65;3;68;14;2;16
293;15.03.2016;2016;03;08;Tiistai;54;3;57;6;4;10
293;15.03.2016;2016;03;09;Tiistai;28;4;32;5;2;7
293;15.03.2016;2016;03;10;Tiistai;10;4;14;9;3;12
293;15.03.2016;2016;03;11;Tiistai;8;4;12;8;7;15
293;15.03.2016;2016;03;12;Tiistai;4;3;7;12;12;24
293;15.03.2016;2016;03;13;Tiistai;7;16;23;8;15;23
293;15.03.2016;2016;03;14;Tiistai;2;43;45;5;24;29
293;15.03.2016;2016;03;15;Tiistai;8;76;84;0;23;23
293;15.03.2016;2016;03;16;Tiistai;10;15;25;7;11;18
293;15.03.2016;2016;03;17;Tiistai;6;15;21;11;4;15
293;15.03.2016;2016;03;18;Tiistai;7;9;16;8;14;22
293;15.03.2016;2016;03;19;Tiistai;3;2;5;6;8;14
293;15.03.2016;2016;03;20;Tiistai;0;5;5;1;5;6
293;15.03.2016;2016;03;21;Tiistai;1;3;4;2;0;2
293;15.03.2016;2016;03;22;Tiistai;0;0;0;0;0;0
293;15.03.2016;2016;03;23;Tiistai;0;0;0;0;0;0
293;16.03.2016;2016;03;00;Keskiviikko;0;0;0;0;0;0
293;16.03.2016;2016;03;01;Keskiviikko;0;0;0;0;0;0
293;16.03.2016;2016;03;02;Keskiviikko;0;0;0;0;0;0
293;16.03.2016;2016;03;03;Keskiviikko;0;0;0;0;0;0
293;16.03.2016;2016;03;04;Keskiviikko;0;0;0;0;0;0
293;16.03.2016;2016;03;05;Keskiviikko;0;0;0;0;0;0
293;16.03.2016;2016;03;06;Keskiviikko;7;1;8;2;0;2
293;16.03.2016;2016;03;07;Keskiviikko;70;2;72;13;1;14
293;16.03.2016;2016;03;08;Keskiviikko;58;3;61;10;4;14
293;16.03.2016;2016;03;09;Keskiviikko;12;3;15;7;4;11
293;16.03.2016;2016;03;10;Keskiviikko;10;4;14;6;9;15
293;16.03.2016;2016;03;11;Keskiviikko;1;1;2;3;4;7
293;16.03.2016;2016;03;12;Keskiviikko;3;10;13;11;11;22
293;16.03.2016;2016;03;13;Keskiviikko;0;7;7;8;8;16
293;16.03.2016;2016;03;14;Keskiviikko;10;87;97;8;16;24
293;16.03.2016;2016;03;15;Keskiviikko;6;24;30;2;14;16
293;16.03.2016;2016;03;16;Keskiviikko;9;11;20;5;10;15
293;16.03.2016;2016;03;17;Keskiviikko;5;4;9;4;4;8
293;16.03.2016;2016;03;18;Keskiviikko;1;7;8;1;1;2
293;16.03.2016;2016;03;19;Keskiviikko;2;1;3;1;3;4
293;16.03.2016;2016;03;20;Keskiviikko;2;6;8;2;1;3
293;16.03.2016;2016;03;21;Keskiviikko;2;4;6;0;0;0
293;16.03.2016;2016;03;22;Keskiviikko;0;0;0;0;0;0
293;16.03.2016;2016;03;23;Keskiviikko;0;0;0;0;0;0
293;17.03.2016;2016;03;00;Torstai;0;0;0;0;0;0
293;17.03.2016;2016;03;01;Torstai;0;0;0;0;0;0
293;17.03.2016;2016;03;02;Torstai;0;0;0;0;0;0
293;17.03.2016;2016;03;03;Torstai;0;1;1;0;0;0
293;17.03.2016;2016;03;04;Torstai;0;0;0;0;0;0
293;17.03.2016;2016;03;05;Torstai;2;0;2;1;0;1
293;17.03.2016;2016;03;06;Torstai;6;1;7;0;0;0
293;17.03.2016;2016;03;07;Torstai;51;4;55;13;0;13
293;17.03.2016;2016;03;08;Torstai;46;3;49;11;3;14
293;17.03.2016;2016;03;09;Torstai;30;4;34;9;1;10
293;17.03.2016;2016;03;10;Torstai;8;4;12;4;7;11
293;17.03.2016;2016;03;11;Torstai;4;4;8;3;6;9
293;17.03.2016;2016;03;12;Torstai;7;6;13;6;7;13
293;17.03.2016;2016;03;13;Torstai;4;18;22;3;9;12
293;17.03.2016;2016;03;14;Torstai;5;45;50;5;16;21
293;17.03.2016;2016;03;15;Torstai;3;58;61;6;17;23
293;17.03.2016;2016;03;16;Torstai;5;7;12;3;4;7
293;17.03.2016;2016;03;17;Torstai;4;4;8;7;1;8
293;17.03.2016;2016;03;18;Torstai;4;2;6;5;9;14
293;17.03.2016;2016;03;19;Torstai;3;1;4;2;5;7
293;17.03.2016;2016;03;20;Torstai;1;4;5;2;3;5
293;17.03.2016;2016;03;21;Torstai;1;3;4;2;0;2
293;17.03.2016;2016;03;22;Torstai;0;0;0;0;0;0
293;17.03.2016;2016;03;23;Torstai;0;0;0;0;0;0
293;18.03.2016;2016;03;00;Perjantai;1;0;1;0;0;0
293;18.03.2016;2016;03;01;Perjantai;0;0;0;0;0;0
293;18.03.2016;2016;03;02;Perjantai;0;0;0;0;0;0
293;18.03.2016;2016;03;03;Perjantai;0;0;0;0;1;1
293;18.03.2016;2016;03;04;Perjantai;0;1;1;0;0;0
293;18.03.2016;2016;03;05;Perjantai;1;0;1;0;0;0
293;18.03.2016;2016;03;06;Perjantai;3;1;4;0;0;0
293;18.03.2016;2016;03;07;Perjantai;71;4;75;11;1;12
293;18.03.2016;2016;03;08;Perjantai;37;3;40;13;0;13
293;18.03.2016;2016;03;09;Perjantai;14;3;17;6;0;6
293;18.03.2016;2016;03;10;Perjantai;4;1;5;8;2;10
293;18.03.2016;2016;03;11;Perjantai;1;2;3;4;4;8
293;18.03.2016;2016;03;12;Perjantai;5;21;26;3;6;9
293;18.03.2016;2016;03;13;Perjantai;3;19;22;4;12;16
293;18.03.2016;2016;03;14;Perjantai;7;53;60;4;13;17
293;18.03.2016;2016;03;15;Perjantai;3;35;38;6;7;13
293;18.03.2016;2016;03;16;Perjantai;2;7;9;3;3;6
293;18.03.2016;2016;03;17;Perjantai;6;4;10;6;3;9
293;18.03.2016;2016;03;18;Perjantai;5;5;10;7;5;12
293;18.03.2016;2016;03;19;Perjantai;4;7;11;4;8;12
293;18.03.2016;2016;03;20;Perjantai;2;7;9;0;3;3
293;18.03.2016;2016;03;21;Perjantai;1;3;4;1;1;2
293;18.03.2016;2016;03;22;Perjantai;0;0;0;1;2;3
293;18.03.2016;2016;03;23;Perjantai;0;0;0;0;0;0
293;19.03.2016;2016;03;00;Lauantai;0;0;0;0;0;0
293;19.03.2016;2016;03;01;Lauantai;0;1;1;0;0;0
293;19.03.2016;2016;03;02;Lauantai;0;0;0;1;0;1
293;19.03.2016;2016;03;03;Lauantai;0;0;0;0;1;1
293;19.03.2016;2016;03;04;Lauantai;0;0;0;0;1;1
293;19.03.2016;2016;03;05;Lauantai;0;0;0;0;0;0
293;19.03.2016;2016;03;06;Lauantai;1;0;1;0;0;0
293;19.03.2016;2016;03;07;Lauantai;2;0;2;1;1;2
293;19.03.2016;2016;03;08;Lauantai;1;0;1;1;0;1
293;19.03.2016;2016;03;09;Lauantai;5;2;7;2;3;5
293;19.03.2016;2016;03;10;Lauantai;2;1;3;12;3;15
293;19.03.2016;2016;03;11;Lauantai;5;2;7;10;5;15
293;19.03.2016;2016;03;12;Lauantai;3;3;6;1;4;5
293;19.03.2016;2016;03;13;Lauantai;3;6;9;2;3;5
293;19.03.2016;2016;03;14;Lauantai;4;5;9;8;8;16
293;19.03.2016;2016;03;15;Lauantai;3;5;8;7;7;14
293;19.03.2016;2016;03;16;Lauantai;4;10;14;5;7;12
293;19.03.2016;2016;03;17;Lauantai;2;1;3;3;7;10
293;19.03.2016;2016;03;18;Lauantai;4;4;8;6;5;11
293;19.03.2016;2016;03;19;Lauantai;1;0;1;3;3;6
293;19.03.2016;2016;03;20;Lauantai;0;0;0;1;3;4
293;19.03.2016;2016;03;21;Lauantai;0;1;1;0;1;1
293;19.03.2016;2016;03;22;Lauantai;0;0;0;1;0;1
293;19.03.2016;2016;03;23;Lauantai;0;2;2;0;0;0
293;20.03.2016;2016;03;00;Sunnuntai;2;1;3;0;1;1
293;20.03.2016;2016;03;01;Sunnuntai;0;0;0;0;0;0
293;20.03.2016;2016;03;02;Sunnuntai;0;0;0;0;0;0
293;20.03.2016;2016;03;03;Sunnuntai;0;0;0;0;1;1
293;20.03.2016;2016;03;04;Sunnuntai;0;0;0;1;0;1
293;20.03.2016;2016;03;05;Sunnuntai;0;0;0;0;0;0
293;20.03.2016;2016;03;06;Sunnuntai;0;0;0;0;0;0
293;20.03.2016;2016;03;07;Sunnuntai;0;1;1;1;0;1
293;20.03.2016;2016;03;08;Sunnuntai;1;0;1;1;3;4
293;20.03.2016;2016;03;09;Sunnuntai;6;0;6;9;4;13
293;20.03.2016;2016;03;10;Sunnuntai;1;0;1;11;11;22
293;20.03.2016;2016;03;11;Sunnuntai;2;1;3;4;1;5
293;20.03.2016;2016;03;12;Sunnuntai;6;2;8;3;8;11
293;20.03.2016;2016;03;13;Sunnuntai;4;12;16;7;9;16
293;20.03.2016;2016;03;14;Sunnuntai;5;9;14;5;6;11
293;20.03.2016;2016;03;15;Sunnuntai;0;2;2;4;2;6
293;20.03.2016;2016;03;16;Sunnuntai;13;3;16;11;5;16
293;20.03.2016;2016;03;17;Sunnuntai;2;2;4;6;10;16
293;20.03.2016;2016;03;18;Sunnuntai;4;1;5;4;4;8
293;20.03.2016;2016;03;19;Sunnuntai;2;4;6;2;1;3
293;20.03.2016;2016;03;20;Sunnuntai;0;7;7;1;1;2
293;20.03.2016;2016;03;21;Sunnuntai;0;3;3;0;0;0
293;20.03.2016;2016;03;22;Sunnuntai;0;0;0;0;1;1
293;20.03.2016;2016;03;23;Sunnuntai;0;0;0;0;0;0
293;21.03.2016;2016;03;00;Maanantai;0;0;0;0;0;0
293;21.03.2016;2016;03;01;Maanantai;0;0;0;0;0;0
293;21.03.2016;2016;03;02;Maanantai;0;0;0;0;0;0
293;21.03.2016;2016;03;03;Maanantai;0;0;0;0;0;0
293;21.03.2016;2016;03;04;Maanantai;0;0;0;0;0;0
293;21.03.2016;2016;03;05;Maanantai;0;0;0;0;0;0
293;21.03.2016;2016;03;06;Maanantai;8;3;11;0;1;1
293;21.03.2016;2016;03;07;Maanantai;39;1;40;10;1;11
293;21.03.2016;2016;03;08;Maanantai;44;5;49;7;1;8
293;21.03.2016;2016;03;09;Maanantai;29;0;29;6;3;9
293;21.03.2016;2016;03;10;Maanantai;18;2;20;4;6;10
293;21.03.2016;2016;03;11;Maanantai;4;5;9;5;1;6
293;21.03.2016;2016;03;12;Maanantai;3;9;12;8;3;11
293;21.03.2016;2016;03;13;Maanantai;2;23;25;5;14;19
293;21.03.2016;2016;03;14;Maanantai;2;29;31;2;10;12
293;21.03.2016;2016;03;15;Maanantai;4;61;65;6;13;19
293;21.03.2016;2016;03;16;Maanantai;7;14;21;4;8;12
293;21.03.2016;2016;03;17;Maanantai;9;5;14;9;8;17
293;21.03.2016;2016;03;18;Maanantai;3;4;7;8;6;14
293;21.03.2016;2016;03;19;Maanantai;2;10;12;2;2;4
293;21.03.2016;2016;03;20;Maanantai;4;1;5;0;4;4
293;21.03.2016;2016;03;21;Maanantai;0;3;3;0;1;1
293;21.03.2016;2016;03;22;Maanantai;0;0;0;0;0;0
293;21.03.2016;2016;03;23;Maanantai;0;0;0;0;0;0
293;22.03.2016;2016;03;00;Tiistai;0;0;0;0;1;1
293;22.03.2016;2016;03;01;Tiistai;0;0;0;0;0;0
293;22.03.2016;2016;03;02;Tiistai;0;0;0;0;0;0
293;22.03.2016;2016;03;03;Tiistai;0;0;0;0;0;0
293;22.03.2016;2016;03;04;Tiistai;0;0;0;0;0;0
293;22.03.2016;2016;03;05;Tiistai;1;0;1;0;0;0
293;22.03.2016;2016;03;06;Tiistai;7;1;8;1;0;1
293;22.03.2016;2016;03;07;Tiistai;43;1;44;12;1;13
293;22.03.2016;2016;03;08;Tiistai;45;1;46;12;1;13
293;22.03.2016;2016;03;09;Tiistai;18;1;19;6;1;7
293;22.03.2016;2016;03;10;Tiistai;14;1;15;2;2;4
293;22.03.2016;2016;03;11;Tiistai;7;5;12;2;4;6
293;22.03.2016;2016;03;12;Tiistai;2;6;8;6;6;12
293;22.03.2016;2016;03;13;Tiistai;2;13;15;7;7;14
293;22.03.2016;2016;03;14;Tiistai;1;49;50;5;15;20
293;22.03.2016;2016;03;15;Tiistai;6;63;69;3;15;18
293;22.03.2016;2016;03;16;Tiistai;5;13;18;3;5;8
293;22.03.2016;2016;03;17;Tiistai;1;4;5;5;5;10
293;22.03.2016;2016;03;18;Tiistai;3;4;7;7;5;12
293;22.03.2016;2016;03;19;Tiistai;4;5;9;1;10;11
293;22.03.2016;2016;03;20;Tiistai;3;3;6;1;3;4
293;22.03.2016;2016;03;21;Tiistai;0;0;0;0;0;0
293;22.03.2016;2016;03;22;Tiistai;0;0;0;0;0;0
293;22.03.2016;2016;03;23;Tiistai;0;0;0;0;0;0
293;23.03.2016;2016;03;00;Keskiviikko;0;0;0;0;0;0
293;23.03.2016;2016;03;01;Keskiviikko;0;0;0;0;0;0
293;23.03.2016;2016;03;02;Keskiviikko;0;0;0;0;0;0
293;23.03.2016;2016;03;03;Keskiviikko;0;0;0;0;0;0
293;23.03.2016;2016;03;04;Keskiviikko;0;0;0;0;0;0
293;23.03.2016;2016;03;05;Keskiviikko;0;0;0;0;0;0
293;23.03.2016;2016;03;06;Keskiviikko;4;1;5;2;0;2
293;23.03.2016;2016;03;07;Keskiviikko;58;1;59;16;1;17
293;23.03.2016;2016;03;08;Keskiviikko;44;3;47;6;2;8
293;23.03.2016;2016;03;09;Keskiviikko;11;3;14;5;2;7
293;23.03.2016;2016;03;10;Keskiviikko;5;1;6;6;1;7
293;23.03.2016;2016;03;11;Keskiviikko;1;3;4;4;1;5
293;23.03.2016;2016;03;12;Keskiviikko;1;15;16;1;6;7
293;23.03.2016;2016;03;13;Keskiviikko;4;11;15;5;4;9
293;23.03.2016;2016;03;14;Keskiviikko;3;74;77;5;18;23
293;23.03.2016;2016;03;15;Keskiviikko;6;19;25;3;6;9
293;23.03.2016;2016;03;16;Keskiviikko;3;4;7;4;10;14
293;23.03.2016;2016;03;17;Keskiviikko;2;4;6;5;7;12
293;23.03.2016;2016;03;18;Keskiviikko;4;5;9;7;7;14
293;23.03.2016;2016;03;19;Keskiviikko;1;5;6;8;4;12
293;23.03.2016;2016;03;20;Keskiviikko;1;3;4;4;3;7
293;23.03.2016;2016;03;21;Keskiviikko;1;0;1;0;3;3
293;23.03.2016;2016;03;22;Keskiviikko;0;1;1;0;0;0
293;23.03.2016;2016;03;23;Keskiviikko;2;0;2;1;0;1
293;24.03.2016;2016;03;00;Torstai;0;0;0;0;0;0
293;24.03.2016;2016;03;01;Torstai;0;0;0;0;0;0
293;24.03.2016;2016;03;02;Torstai;1;0;1;0;0;0
293;24.03.2016;2016;03;03;Torstai;0;0;0;0;0;0
293;24.03.2016;2016;03;04;Torstai;0;0;0;0;0;0
293;24.03.2016;2016;03;05;Torstai;1;0;1;0;0;0
293;24.03.2016;2016;03;06;Torstai;6;2;8;3;0;3
293;24.03.2016;2016;03;07;Torstai;50;1;51;8;2;10
293;24.03.2016;2016;03;08;Torstai;41;2;43;8;0;8
293;24.03.2016;2016;03;09;Torstai;30;2;32;6;4;10
293;24.03.2016;2016;03;10;Torstai;6;6;12;4;1;5
293;24.03.2016;2016;03;11;Torstai;2;4;6;5;2;7
293;24.03.2016;2016;03;12;Torstai;7;6;13;6;1;7
293;24.03.2016;2016;03;13;Torstai;3;36;39;4;9;13
293;24.03.2016;2016;03;14;Torstai;6;40;46;2;13;15
293;24.03.2016;2016;03;15;Torstai;2;37;39;1;6;7
293;24.03.2016;2016;03;16;Torstai;3;7;10;1;6;7
293;24.03.2016;2016;03;17;Torstai;3;6;9;10;3;13
293;24.03.2016;2016;03;18;Torstai;4;4;8;1;4;5
293;24.03.2016;2016;03;19;Torstai;5;5;10;2;3;5
293;24.03.2016;2016;03;20;Torstai;3;2;5;1;4;5
293;24.03.2016;2016;03;21;Torstai;0;1;1;0;3;3
293;24.03.2016;2016;03;22;Torstai;0;1;1;0;0;0
293;24.03.2016;2016;03;23;Torstai;0;1;1;1;0;1
293;25.03.2016;2016;03;00;Perjantai;0;1;1;1;0;1
293;25.03.2016;2016;03;01;Perjantai;0;0;0;0;0;0
293;25.03.2016;2016;03;02;Perjantai;2;0;2;0;3;3
293;25.03.2016;2016;03;03;Perjantai;0;0;0;1;2;3
293;25.03.2016;2016;03;04;Perjantai;0;0;0;0;0;0
293;25.03.2016;2016;03;05;Perjantai;0;0;0;0;0;0
293;25.03.2016;2016;03;06;Perjantai;2;0;2;0;0;0
293;25.03.2016;2016;03;07;Perjantai;0;0;0;1;0;1
293;25.03.2016;2016;03;08;Perjantai;0;0;0;0;1;1
293;25.03.2016;2016;03;09;Perjantai;1;0;1;2;2;4
293;25.03.2016;2016;03;10;Perjantai;2;0;2;0;1;1
293;25.03.2016;2016;03;11;Perjantai;0;1;1;6;5;11
293;25.03.2016;2016;03;12;Perjantai;2;2;4;3;5;8
293;25.03.2016;2016;03;13;Perjantai;2;0;2;3;4;7
293;25.03.2016;2016;03;14;Perjantai;2;4;6;8;7;15
293;25.03.2016;2016;03;15;Perjantai;6;5;11;9;5;14
293;25.03.2016;2016;03;16;Perjantai;0;1;1;3;5;8
293;25.03.2016;2016;03;17;Perjantai;1;0;1;5;4;9
293;25.03.2016;2016;03;18;Perjantai;2;7;9;5;2;7
293;25.03.2016;2016;03;19;Perjantai;5;3;8;8;7;15
293;25.03.2016;2016;03;20;Perjantai;0;1;1;1;1;2
293;25.03.2016;2016;03;21;Perjantai;4;4;8;0;1;1
293;25.03.2016;2016;03;22;Perjantai;2;0;2;5;1;6
293;25.03.2016;2016;03;23;Perjantai;0;0;0;1;0;1
293;26.03.2016;2016;03;00;Lauantai;0;0;0;1;2;3
293;26.03.2016;2016;03;01;Lauantai;0;2;2;0;0;0
293;26.03.2016;2016;03;02;Lauantai;0;0;0;0;4;4
293;26.03.2016;2016;03;03;Lauantai;0;0;0;0;2;2
293;26.03.2016;2016;03;04;Lauantai;0;1;1;1;2;3
293;26.03.2016;2016;03;05;Lauantai;1;0;1;0;1;1
293;26.03.2016;2016;03;06;Lauantai;2;0;2;1;1;2
293;26.03.2016;2016;03;07;Lauantai;1;0;1;0;2;2
293;26.03.2016;2016;03;08;Lauantai;6;1;7;2;2;4
293;26.03.2016;2016;03;09;Lauantai;2;1;3;4;3;7
293;26.03.2016;2016;03;10;Lauantai;0;0;0;3;3;6
293;26.03.2016;2016;03;11;Lauantai;0;4;4;9;2;11
293;26.03.2016;2016;03;12;Lauantai;1;3;4;9;7;16
293;26.03.2016;2016;03;13;Lauantai;5;0;5;4;6;10
293;26.03.2016;2016;03;14;Lauantai;3;2;5;5;9;14
293;26.03.2016;2016;03;15;Lauantai;4;4;8;5;5;10
293;26.03.2016;2016;03;16;Lauantai;1;4;5;4;3;7
293;26.03.2016;2016;03;17;Lauantai;3;1;4;3;7;10
293;26.03.2016;2016;03;18;Lauantai;1;3;4;2;2;4
293;26.03.2016;2016;03;19;Lauantai;3;0;3;7;4;11
293;26.03.2016;2016;03;20;Lauantai;2;2;4;6;0;6
293;26.03.2016;2016;03;21;Lauantai;2;2;4;0;2;2
293;26.03.2016;2016;03;22;Lauantai;0;5;5;0;1;1
293;26.03.2016;2016;03;23;Lauantai;0;1;1;1;0;1
293;27.03.2016;2016;03;00;Sunnuntai;0;0;0;0;0;0
293;27.03.2016;2016;03;01;Sunnuntai;0;0;0;1;0;1
293;27.03.2016;2016;03;02;Sunnuntai;0;0;0;0;0;0
293;27.03.2016;2016;03;03;Sunnuntai;0;0;0;0;0;0
293;27.03.2016;2016;03;04;Sunnuntai;0;0;0;0;4;4
293;27.03.2016;2016;03;05;Sunnuntai;0;0;0;0;0;0
293;27.03.2016;2016;03;06;Sunnuntai;2;0;2;0;0;0
293;27.03.2016;2016;03;07;Sunnuntai;0;0;0;1;0;1
293;27.03.2016;2016;03;08;Sunnuntai;0;1;1;0;0;0
293;27.03.2016;2016;03;09;Sunnuntai;2;0;2;2;1;3
293;27.03.2016;2016;03;10;Sunnuntai;2;2;4;4;4;8
293;27.03.2016;2016;03;11;Sunnuntai;2;6;8;7;9;16
293;27.03.2016;2016;03;12;Sunnuntai;7;1;8;10;3;13
293;27.03.2016;2016;03;13;Sunnuntai;3;2;5;10;12;22
293;27.03.2016;2016;03;14;Sunnuntai;5;4;9;8;6;14
293;27.03.2016;2016;03;15;Sunnuntai;2;5;7;8;6;14
293;27.03.2016;2016;03;16;Sunnuntai;3;5;8;4;7;11
293;27.03.2016;2016;03;17;Sunnuntai;1;5;6;10;7;17
293;27.03.2016;2016;03;18;Sunnuntai;3;2;5;8;3;11
293;27.03.2016;2016;03;19;Sunnuntai;5;6;11;7;8;15
293;27.03.2016;2016;03;20;Sunnuntai;8;2;10;4;2;6
293;27.03.2016;2016;03;21;Sunnuntai;0;2;2;2;9;11
293;27.03.2016;2016;03;22;Sunnuntai;2;1;3;2;2;4
293;27.03.2016;2016;03;23;Sunnuntai;0;0;0;0;0;0
293;28.03.2016;2016;03;00;Maanantai;0;0;0;0;0;0
293;28.03.2016;2016;03;01;Maanantai;0;0;0;0;0;0
293;28.03.2016;2016;03;02;Maanantai;0;0;0;0;0;0
293;28.03.2016;2016;03;03;Maanantai;0;0;0;0;3;3
293;28.03.2016;2016;03;04;Maanantai;0;0;0;0;0;0
293;28.03.2016;2016;03;05;Maanantai;0;0;0;0;0;0
293;28.03.2016;2016;03;06;Maanantai;1;0;1;0;0;0
293;28.03.2016;2016;03;07;Maanantai;1;0;1;1;0;1
293;28.03.2016;2016;03;08;Maanantai;0;0;0;0;0;0
293;28.03.2016;2016;03;09;Maanantai;0;0;0;1;3;4
293;28.03.2016;2016;03;10;Maanantai;2;1;3;10;6;16
293;28.03.2016;2016;03;11;Maanantai;3;6;9;8;7;15
293;28.03.2016;2016;03;12;Maanantai;1;3;4;16;9;25
293;28.03.2016;2016;03;13;Maanantai;5;2;7;17;9;26
293;28.03.2016;2016;03;14;Maanantai;6;6;12;9;13;22
293;28.03.2016;2016;03;15;Maanantai;12;12;24;15;12;27
293;28.03.2016;2016;03;16;Maanantai;9;4;13;5;19;24
293;28.03.2016;2016;03;17;Maanantai;9;14;23;10;2;12
293;28.03.2016;2016;03;18;Maanantai;8;2;10;6;1;7
293;28.03.2016;2016;03;19;Maanantai;9;11;20;0;6;6
293;28.03.2016;2016;03;20;Maanantai;8;4;12;3;9;12
293;28.03.2016;2016;03;21;Maanantai;0;4;4;3;1;4
293;28.03.2016;2016;03;22;Maanantai;1;2;3;2;0;2
293;28.03.2016;2016;03;23;Maanantai;0;0;0;0;0;0
293;29.03.2016;2016;03;00;Tiistai;0;0;0;0;0;0
293;29.03.2016;2016;03;01;Tiistai;0;0;0;0;0;0
293;29.03.2016;2016;03;02;Tiistai;0;0;0;0;0;0
293;29.03.2016;2016;03;03;Tiistai;0;0;0;0;0;0
293;29.03.2016;2016;03;04;Tiistai;0;1;1;0;0;0
293;29.03.2016;2016;03;05;Tiistai;1;1;2;0;0;0
293;29.03.2016;2016;03;06;Tiistai;7;1;8;2;1;3
293;29.03.2016;2016;03;07;Tiistai;48;5;53;13;0;13
293;29.03.2016;2016;03;08;Tiistai;54;5;59;11;5;16
293;29.03.2016;2016;03;09;Tiistai;11;3;14;5;1;6
293;29.03.2016;2016;03;10;Tiistai;9;4;13;10;2;12
293;29.03.2016;2016;03;11;Tiistai;3;3;6;7;6;13
293;29.03.2016;2016;03;12;Tiistai;5;5;10;9;6;15
293;29.03.2016;2016;03;13;Tiistai;3;20;23;4;11;15
293;29.03.2016;2016;03;14;Tiistai;8;47;55;7;17;24
293;29.03.2016;2016;03;15;Tiistai;7;44;51;9;20;29
293;29.03.2016;2016;03;16;Tiistai;11;12;23;17;24;41
293;29.03.2016;2016;03;17;Tiistai;23;12;35;20;11;31
293;29.03.2016;2016;03;18;Tiistai;8;15;23;15;17;32
293;29.03.2016;2016;03;19;Tiistai;4;6;10;5;4;9
293;29.03.2016;2016;03;20;Tiistai;3;11;14;4;6;10
293;29.03.2016;2016;03;21;Tiistai;5;4;9;6;3;9
293;29.03.2016;2016;03;22;Tiistai;0;1;1;0;0;0
293;29.03.2016;2016;03;23;Tiistai;0;0;0;2;0;2
293;30.03.2016;2016;03;00;Keskiviikko;0;0;0;0;0;0
293;30.03.2016;2016;03;01;Keskiviikko;0;2;2;0;0;0
293;30.03.2016;2016;03;02;Keskiviikko;0;1;1;0;0;0
293;30.03.2016;2016;03;03;Keskiviikko;1;0;1;0;0;0
293;30.03.2016;2016;03;04;Keskiviikko;0;1;1;0;0;0
293;30.03.2016;2016;03;05;Keskiviikko;2;0;2;0;0;0
293;30.03.2016;2016;03;06;Keskiviikko;9;1;10;2;0;2
293;30.03.2016;2016;03;07;Keskiviikko;65;8;73;16;1;17
293;30.03.2016;2016;03;08;Keskiviikko;41;6;47;3;1;4
293;30.03.2016;2016;03;09;Keskiviikko;21;2;23;4;1;5
293;30.03.2016;2016;03;10;Keskiviikko;7;2;9;10;1;11
293;30.03.2016;2016;03;11;Keskiviikko;4;5;9;2;4;6
293;30.03.2016;2016;03;12;Keskiviikko;8;17;25;7;7;14
293;30.03.2016;2016;03;13;Keskiviikko;7;16;23;4;5;9
293;30.03.2016;2016;03;14;Keskiviikko;10;74;84;4;13;17
293;30.03.2016;2016;03;15;Keskiviikko;5;23;28;3;8;11
293;30.03.2016;2016;03;16;Keskiviikko;16;17;33;14;15;29
293;30.03.2016;2016;03;17;Keskiviikko;10;10;20;12;12;24
293;30.03.2016;2016;03;18;Keskiviikko;15;12;27;9;4;13
293;30.03.2016;2016;03;19;Keskiviikko;7;11;18;7;7;14
293;30.03.2016;2016;03;20;Keskiviikko;2;10;12;3;9;12
293;30.03.2016;2016;03;21;Keskiviikko;1;0;1;0;0;0
293;30.03.2016;2016;03;22;Keskiviikko;0;1;1;0;0;0
293;30.03.2016;2016;03;23;Keskiviikko;0;2;2;0;1;1
293;31.03.2016;2016;03;00;Torstai;0;0;0;0;0;0
293;31.03.2016;2016;03;01;Torstai;0;0;0;0;0;0
293;31.03.2016;2016;03;02;Torstai;0;0;0;0;0;0
293;31.03.2016;2016;03;03;Torstai;0;0;0;0;0;0
293;31.03.2016;2016;03;04;Torstai;0;1;1;0;0;0
293;31.03.2016;2016;03;05;Torstai;5;0;5;0;0;0
293;31.03.2016;2016;03;06;Torstai;13;1;14;1;0;1
293;31.03.2016;2016;03;07;Torstai;40;4;44;10;1;11
293;31.03.2016;2016;03;08;Torstai;37;5;42;11;4;15
293;31.03.2016;2016;03;09;Torstai;24;10;34;3;4;7
293;31.03.2016;2016;03;10;Torstai;4;7;11;3;5;8
293;31.03.2016;2016;03;11;Torstai;10;7;17;3;2;5
293;31.03.2016;2016;03;12;Torstai;11;21;32;2;7;9
293;31.03.2016;2016;03;13;Torstai;3;30;33;3;10;13
293;31.03.2016;2016;03;14;Torstai;12;21;33;5;8;13
293;31.03.2016;2016;03;15;Torstai;10;39;49;4;9;13
293;31.03.2016;2016;03;16;Torstai;17;11;28;4;6;10
293;31.03.2016;2016;03;17;Torstai;11;17;28;9;7;16
293;31.03.2016;2016;03;18;Torstai;14;8;22;10;10;20
293;31.03.2016;2016;03;19;Torstai;10;15;25;8;7;15
293;31.03.2016;2016;03;20;Torstai;2;5;7;1;7;8
293;31.03.2016;2016;03;21;Torstai;2;4;6;0;0;0
293;31.03.2016;2016;03;22;Torstai;0;2;2;0;0;0
293;31.03.2016;2016;03;23;Torstai;0;0;0;0;0;0
293;01.04.2016;2016;04;00;Perjantai;0;0;0;0;0;0
293;01.04.2016;2016;04;01;Perjantai;0;0;0;0;0;0
293;01.04.2016;2016;04;02;Perjantai;0;0;0;0;0;0
293;01.04.2016;2016;04;03;Perjantai;0;0;0;0;0;0
293;01.04.2016;2016;04;04;Perjantai;0;0;0;0;0;0
293;01.04.2016;2016;04;05;Perjantai;0;0;0;0;0;0
293;01.04.2016;2016;04;06;Perjantai;7;3;10;1;2;3
293;01.04.2016;2016;04;07;Perjantai;46;3;49;7;2;9
293;01.04.2016;2016;04;08;Perjantai;59;6;65;7;1;8
293;01.04.2016;2016;04;09;Perjantai;36;2;38;6;4;10
293;01.04.2016;2016;04;10;Perjantai;14;2;16;3;6;9
293;01.04.2016;2016;04;11;Perjantai;4;13;17;3;1;4
293;01.04.2016;2016;04;12;Perjantai;16;31;47;3;7;10
293;01.04.2016;2016;04;13;Perjantai;18;23;41;10;12;22
293;01.04.2016;2016;04;14;Perjantai;11;55;66;4;13;17
293;01.04.2016;2016;04;15;Perjantai;24;47;71;7;9;16
293;01.04.2016;2016;04;16;Perjantai;13;13;26;7;7;14
293;01.04.2016;2016;04;17;Perjantai;13;10;23;11;9;20
293;01.04.2016;2016;04;18;Perjantai;15;24;39;6;10;16
293;01.04.2016;2016;04;19;Perjantai;13;19;32;6;7;13
293;01.04.2016;2016;04;20;Perjantai;4;7;11;5;5;10
293;01.04.2016;2016;04;21;Perjantai;1;9;10;2;3;5
293;01.04.2016;2016;04;22;Perjantai;5;3;8;5;2;7
293;01.04.2016;2016;04;23;Perjantai;1;1;2;1;2;3
293;02.04.2016;2016;04;00;Lauantai;0;1;1;0;0;0
293;02.04.2016;2016;04;01;Lauantai;0;1;1;3;3;6
293;02.04.2016;2016;04;02;Lauantai;0;0;0;0;1;1
293;02.04.2016;2016;04;03;Lauantai;1;0;1;0;2;2
293;02.04.2016;2016;04;04;Lauantai;0;0;0;0;1;1
293;02.04.2016;2016;04;05;Lauantai;0;0;0;1;1;2
293;02.04.2016;2016;04;06;Lauantai;1;0;1;1;2;3
293;02.04.2016;2016;04;07;Lauantai;0;1;1;0;0;0
293;02.04.2016;2016;04;08;Lauantai;7;1;8;2;3;5
293;02.04.2016;2016;04;09;Lauantai;5;3;8;6;3;9
293;02.04.2016;2016;04;10;Lauantai;3;7;10;5;3;8
293;02.04.2016;2016;04;11;Lauantai;18;10;28;6;4;10
293;02.04.2016;2016;04;12;Lauantai;13;14;27;7;9;16
293;02.04.2016;2016;04;13;Lauantai;15;12;27;4;5;9
293;02.04.2016;2016;04;14;Lauantai;20;21;41;11;6;17
293;02.04.2016;2016;04;15;Lauantai;11;11;22;11;7;18
293;02.04.2016;2016;04;16;Lauantai;18;20;38;9;10;19
293;02.04.2016;2016;04;17;Lauantai;13;8;21;6;7;13
293;02.04.2016;2016;04;18;Lauantai;8;9;17;4;3;7
293;02.04.2016;2016;04;19;Lauantai;8;13;21;5;5;10
293;02.04.2016;2016;04;20;Lauantai;12;13;25;8;4;12
293;02.04.2016;2016;04;21;Lauantai;8;6;14;1;2;3
293;02.04.2016;2016;04;22;Lauantai;0;1;1;2;1;3
293;02.04.2016;2016;04;23;Lauantai;1;1;2;1;1;2
293;03.04.2016;2016;04;00;Sunnuntai;1;1;2;0;0;0
293;03.04.2016;2016;04;01;Sunnuntai;2;2;4;0;0;0
293;03.04.2016;2016;04;02;Sunnuntai;0;0;0;0;1;1
293;03.04.2016;2016;04;03;Sunnuntai;0;0;0;1;2;3
293;03.04.2016;2016;04;04;Sunnuntai;0;1;1;1;3;4
293;03.04.2016;2016;04;05;Sunnuntai;0;0;0;1;0;1
293;03.04.2016;2016;04;06;Sunnuntai;2;0;2;0;1;1
293;03.04.2016;2016;04;07;Sunnuntai;1;1;2;0;0;0
293;03.04.2016;2016;04;08;Sunnuntai;1;0;1;0;3;3
293;03.04.2016;2016;04;09;Sunnuntai;10;8;18;8;3;11
293;03.04.2016;2016;04;10;Sunnuntai;7;5;12;5;5;10
293;03.04.2016;2016;04;11;Sunnuntai;10;15;25;9;5;14
293;03.04.2016;2016;04;12;Sunnuntai;19;12;31;10;8;18
293;03.04.2016;2016;04;13;Sunnuntai;26;26;52;10;6;16
293;03.04.2016;2016;04;14;Sunnuntai;18;15;33;14;10;24
293;03.04.2016;2016;04;15;Sunnuntai;25;8;33;5;4;9
293;03.04.2016;2016;04;16;Sunnuntai;17;19;36;9;11;20
293;03.04.2016;2016;04;17;Sunnuntai;25;25;50;16;14;30
293;03.04.2016;2016;04;18;Sunnuntai;12;11;23;5;7;12
293;03.04.2016;2016;04;19;Sunnuntai;10;17;27;5;8;13
293;03.04.2016;2016;04;20;Sunnuntai;4;8;12;4;5;9
293;03.04.2016;2016;04;21;Sunnuntai;3;1;4;1;0;1
293;03.04.2016;2016;04;22;Sunnuntai;1;1;2;0;0;0
293;03.04.2016;2016;04;23;Sunnuntai;0;0;0;0;0;0
293;04.04.2016;2016;04;00;Maanantai;0;0;0;0;0;0
293;04.04.2016;2016;04;01;Maanantai;0;0;0;1;0;1
293;04.04.2016;2016;04;02;Maanantai;0;0;0;0;0;0
293;04.04.2016;2016;04;03;Maanantai;0;0;0;0;0;0
293;04.04.2016;2016;04;04;Maanantai;0;0;0;0;0;0
293;04.04.2016;2016;04;05;Maanantai;3;0;3;0;0;0
293;04.04.2016;2016;04;06;Maanantai;11;1;12;2;1;3
293;04.04.2016;2016;04;07;Maanantai;51;5;56;6;2;8
293;04.04.2016;2016;04;08;Maanantai;73;9;82;12;1;13
293;04.04.2016;2016;04;09;Maanantai;33;6;39;4;3;7
293;04.04.2016;2016;04;10;Maanantai;19;6;25;9;6;15
293;04.04.2016;2016;04;11;Maanantai;6;11;17;4;3;7
293;04.04.2016;2016;04;12;Maanantai;11;21;32;6;6;12
293;04.04.2016;2016;04;13;Maanantai;9;53;62;3;5;8
293;04.04.2016;2016;04;14;Maanantai;11;42;53;9;9;18
293;04.04.2016;2016;04;15;Maanantai;14;67;81;4;13;17
293;04.04.2016;2016;04;16;Maanantai;24;24;48;8;6;14
293;04.04.2016;2016;04;17;Maanantai;6;14;20;5;11;16
293;04.04.2016;2016;04;18;Maanantai;14;8;22;6;9;15
293;04.04.2016;2016;04;19;Maanantai;11;18;29;2;4;6
293;04.04.2016;2016;04;20;Maanantai;4;6;10;3;5;8
293;04.04.2016;2016;04;21;Maanantai;2;4;6;0;1;1
293;04.04.2016;2016;04;22;Maanantai;0;1;1;1;0;1
293;04.04.2016;2016;04;23;Maanantai;0;0;0;0;0;0
293;05.04.2016;2016;04;00;Tiistai;0;0;0;0;0;0
293;05.04.2016;2016;04;01;Tiistai;0;0;0;0;0;0
293;05.04.2016;2016;04;02;Tiistai;0;0;0;0;0;0
293;05.04.2016;2016;04;03;Tiistai;0;0;0;0;0;0
293;05.04.2016;2016;04;04;Tiistai;0;0;0;0;0;0
293;05.04.2016;2016;04;05;Tiistai;2;1;3;0;0;0
293;05.04.2016;2016;04;06;Tiistai;8;1;9;1;0;1
293;05.04.2016;2016;04;07;Tiistai;45;5;50;6;0;6
293;05.04.2016;2016;04;08;Tiistai;55;6;61;10;2;12
293;05.04.2016;2016;04;09;Tiistai;23;3;26;3;1;4
293;05.04.2016;2016;04;10;Tiistai;13;3;16;6;3;9
293;05.04.2016;2016;04;11;Tiistai;5;5;10;1;1;2
293;05.04.2016;2016;04;12;Tiistai;5;12;17;3;8;11
293;05.04.2016;2016;04;13;Tiistai;9;20;29;2;6;8
293;05.04.2016;2016;04;14;Tiistai;8;53;61;3;4;7
293;05.04.2016;2016;04;15;Tiistai;11;53;64;3;9;12
293;05.04.2016;2016;04;16;Tiistai;10;13;23;4;8;12
293;05.04.2016;2016;04;17;Tiistai;7;14;21;10;6;16
293;05.04.2016;2016;04;18;Tiistai;8;16;24;12;12;24
293;05.04.2016;2016;04;19;Tiistai;2;3;5;2;5;7
293;05.04.2016;2016;04;20;Tiistai;6;10;16;3;3;6
293;05.04.2016;2016;04;21;Tiistai;2;3;5;2;0;2
293;05.04.2016;2016;04;22;Tiistai;0;0;0;0;1;1
293;05.04.2016;2016;04;23;Tiistai;0;1;1;0;0;0
293;06.04.2016;2016;04;00;Keskiviikko;0;0;0;0;0;0
293;06.04.2016;2016;04;01;Keskiviikko;0;0;0;0;0;0
293;06.04.2016;2016;04;02;Keskiviikko;0;0;0;0;0;0
293;06.04.2016;2016;04;03;Keskiviikko;0;0;0;0;0;0
293;06.04.2016;2016;04;04;Keskiviikko;0;0;0;0;0;0
293;06.04.2016;2016;04;05;Keskiviikko;0;0;0;0;0;0
293;06.04.2016;2016;04;06;Keskiviikko;8;3;11;1;0;1
293;06.04.2016;2016;04;07;Keskiviikko;81;5;86;11;0;11
293;06.04.2016;2016;04;08;Keskiviikko;59;5;64;13;2;15
293;06.04.2016;2016;04;09;Keskiviikko;18;6;24;3;4;7
293;06.04.2016;2016;04;10;Keskiviikko;14;4;18;4;3;7
293;06.04.2016;2016;04;11;Keskiviikko;11;8;19;5;4;9
293;06.04.2016;2016;04;12;Keskiviikko;10;22;32;4;8;12
293;06.04.2016;2016;04;13;Keskiviikko;9;38;47;1;5;6
293;06.04.2016;2016;04;14;Keskiviikko;11;95;106;4;10;14
293;06.04.2016;2016;04;15;Keskiviikko;8;20;28;0;4;4
293;06.04.2016;2016;04;16;Keskiviikko;21;13;34;4;4;8
293;06.04.2016;2016;04;17;Keskiviikko;2;5;7;1;7;8
293;06.04.2016;2016;04;18;Keskiviikko;0;6;6;3;3;6
293;06.04.2016;2016;04;19;Keskiviikko;3;3;6;0;1;1
293;06.04.2016;2016;04;20;Keskiviikko;2;1;3;2;2;4
293;06.04.2016;2016;04;21;Keskiviikko;0;2;2;0;0;0
293;06.04.2016;2016;04;22;Keskiviikko;0;0;0;0;1;1
293;06.04.2016;2016;04;23;Keskiviikko;0;0;0;0;0;0
293;07.04.2016;2016;04;00;Torstai;0;0;0;0;0;0
293;07.04.2016;2016;04;01;Torstai;0;0;0;0;0;0
293;07.04.2016;2016;04;02;Torstai;0;0;0;0;0;0
293;07.04.2016;2016;04;03;Torstai;0;0;0;0;0;0
293;07.04.2016;2016;04;04;Torstai;0;0;0;0;0;0
293;07.04.2016;2016;04;05;Torstai;2;0;2;0;0;0
293;07.04.2016;2016;04;06;Torstai;7;2;9;0;0;0
293;07.04.2016;2016;04;07;Torstai;65;4;69;5;2;7
293;07.04.2016;2016;04;08;Torstai;68;5;73;6;1;7
293;07.04.2016;2016;04;09;Torstai;26;8;34;2;2;4
293;07.04.2016;2016;04;10;Torstai;17;12;29;6;6;12
293;07.04.2016;2016;04;11;Torstai;3;13;16;3;1;4
293;07.04.2016;2016;04;12;Torstai;8;6;14;4;1;5
293;07.04.2016;2016;04;13;Torstai;8;37;45;10;6;16
293;07.04.2016;2016;04;14;Torstai;11;84;95;7;11;18
293;07.04.2016;2016;04;15;Torstai;9;49;58;1;11;12
293;07.04.2016;2016;04;16;Torstai;11;6;17;4;8;12
293;07.04.2016;2016;04;17;Torstai;9;14;23;9;5;14
293;07.04.2016;2016;04;18;Torstai;10;12;22;7;10;17
293;07.04.2016;2016;04;19;Torstai;7;7;14;8;10;18
293;07.04.2016;2016;04;20;Torstai;6;4;10;0;4;4
293;07.04.2016;2016;04;21;Torstai;1;4;5;0;1;1
293;07.04.2016;2016;04;22;Torstai;1;1;2;0;1;1
293;07.04.2016;2016;04;23;Torstai;0;1;1;0;1;1
293;08.04.2016;2016;04;00;Perjantai;0;0;0;0;0;0
293;08.04.2016;2016;04;01;Perjantai;0;0;0;0;0;0
293;08.04.2016;2016;04;02;Perjantai;0;0;0;0;1;1
293;08.04.2016;2016;04;03;Perjantai;0;0;0;0;0;0
293;08.04.2016;2016;04;04;Perjantai;0;0;0;0;0;0
293;08.04.2016;2016;04;05;Perjantai;2;1;3;0;0;0
293;08.04.2016;2016;04;06;Perjantai;6;0;6;0;0;0
293;08.04.2016;2016;04;07;Perjantai;63;4;67;9;0;9
293;08.04.2016;2016;04;08;Perjantai;64;9;73;6;2;8
293;08.04.2016;2016;04;09;Perjantai;27;4;31;3;9;12
293;08.04.2016;2016;04;10;Perjantai;8;8;16;5;1;6
293;08.04.2016;2016;04;11;Perjantai;4;7;11;2;1;3
293;08.04.2016;2016;04;12;Perjantai;11;24;35;3;5;8
293;08.04.2016;2016;04;13;Perjantai;9;34;43;4;4;8
293;08.04.2016;2016;04;14;Perjantai;13;59;72;3;12;15
293;08.04.2016;2016;04;15;Perjantai;8;49;57;3;6;9
293;08.04.2016;2016;04;16;Perjantai;18;15;33;4;2;6
293;08.04.2016;2016;04;17;Perjantai;20;18;38;5;6;11
293;08.04.2016;2016;04;18;Perjantai;19;18;37;7;6;13
293;08.04.2016;2016;04;19;Perjantai;3;19;22;6;3;9
293;08.04.2016;2016;04;20;Perjantai;17;8;25;3;3;6
293;08.04.2016;2016;04;21;Perjantai;5;11;16;1;3;4
293;08.04.2016;2016;04;22;Perjantai;1;1;2;0;1;1
293;08.04.2016;2016;04;23;Perjantai;2;3;5;2;2;4
293;09.04.2016;2016;04;00;Lauantai;2;0;2;0;0;0
293;09.04.2016;2016;04;01;Lauantai;0;0;0;0;1;1
293;09.04.2016;2016;04;02;Lauantai;0;1;1;0;0;0
293;09.04.2016;2016;04;03;Lauantai;0;0;0;0;2;2
293;09.04.2016;2016;04;04;Lauantai;0;1;1;0;0;0
293;09.04.2016;2016;04;05;Lauantai;1;2;3;0;0;0
293;09.04.2016;2016;04;06;Lauantai;2;1;3;1;0;1
293;09.04.2016;2016;04;07;Lauantai;1;0;1;0;1;1
293;09.04.2016;2016;04;08;Lauantai;5;0;5;0;4;4
293;09.04.2016;2016;04;09;Lauantai;15;14;29;6;5;11
293;09.04.2016;2016;04;10;Lauantai;21;21;42;4;8;12
293;09.04.2016;2016;04;11;Lauantai;24;25;49;13;9;22
293;09.04.2016;2016;04;12;Lauantai;33;30;63;16;11;27
293;09.04.2016;2016;04;13;Lauantai;31;31;62;4;10;14
293;09.04.2016;2016;04;14;Lauantai;34;22;56;18;9;27
293;09.04.2016;2016;04;15;Lauantai;26;29;55;11;6;17
293;09.04.2016;2016;04;16;Lauantai;29;35;64;11;14;25
293;09.04.2016;2016;04;17;Lauantai;23;16;39;5;9;14
293;09.04.2016;2016;04;18;Lauantai;13;21;34;5;7;12
293;09.04.2016;2016;04;19;Lauantai;11;15;26;7;5;12
293;09.04.2016;2016;04;20;Lauantai;9;13;22;1;1;2
293;09.04.2016;2016;04;21;Lauantai;11;10;21;2;0;2
293;09.04.2016;2016;04;22;Lauantai;4;2;6;3;0;3
293;09.04.2016;2016;04;23;Lauantai;1;2;3;0;0;0
293;10.04.2016;2016;04;00;Sunnuntai;1;3;4;0;1;1
293;10.04.2016;2016;04;01;Sunnuntai;0;1;1;0;1;1
293;10.04.2016;2016;04;02;Sunnuntai;0;0;0;0;0;0
293;10.04.2016;2016;04;03;Sunnuntai;0;2;2;0;1;1
293;10.04.2016;2016;04;04;Sunnuntai;0;1;1;0;2;2
293;10.04.2016;2016;04;05;Sunnuntai;1;0;1;0;1;1
293;10.04.2016;2016;04;06;Sunnuntai;1;1;2;2;0;2
293;10.04.2016;2016;04;07;Sunnuntai;0;2;2;2;4;6
293;10.04.2016;2016;04;08;Sunnuntai;7;1;8;3;0;3
293;10.04.2016;2016;04;09;Sunnuntai;16;3;19;5;7;12
293;10.04.2016;2016;04;10;Sunnuntai;14;11;25;10;8;18
293;10.04.2016;2016;04;11;Sunnuntai;31;25;56;10;9;19
293;10.04.2016;2016;04;12;Sunnuntai;30;35;65;14;7;21
293;10.04.2016;2016;04;13;Sunnuntai;22;27;49;4;14;18
293;10.04.2016;2016;04;14;Sunnuntai;39;34;73;12;6;18
293;10.04.2016;2016;04;15;Sunnuntai;33;36;69;7;11;18
293;10.04.2016;2016;04;16;Sunnuntai;49;35;84;9;15;24
293;10.04.2016;2016;04;17;Sunnuntai;33;27;60;10;10;20
293;10.04.2016;2016;04;18;Sunnuntai;43;35;78;12;18;30
293;10.04.2016;2016;04;19;Sunnuntai;19;22;41;10;7;17
293;10.04.2016;2016;04;20;Sunnuntai;8;10;18;4;4;8
293;10.04.2016;2016;04;21;Sunnuntai;2;1;3;2;6;8
293;10.04.2016;2016;04;22;Sunnuntai;0;0;0;0;0;0
293;10.04.2016;2016;04;23;Sunnuntai;1;0;1;1;1;2
293;11.04.2016;2016;04;00;Maanantai;0;0;0;0;0;0
293;11.04.2016;2016;04;01;Maanantai;0;0;0;0;1;1
293;11.04.2016;2016;04;02;Maanantai;0;1;1;0;0;0
293;11.04.2016;2016;04;03;Maanantai;0;0;0;0;0;0
293;11.04.2016;2016;04;04;Maanantai;0;0;0;0;0;0
293;11.04.2016;2016;04;05;Maanantai;2;0;2;0;0;0
293;11.04.2016;2016;04;06;Maanantai;13;3;16;0;1;1
293;11.04.2016;2016;04;07;Maanantai;75;11;86;4;1;5
293;11.04.2016;2016;04;08;Maanantai;59;12;71;10;0;10
293;11.04.2016;2016;04;09;Maanantai;43;15;58;5;7;12
293;11.04.2016;2016;04;10;Maanantai;32;20;52;6;4;10
293;11.04.2016;2016;04;11;Maanantai;12;18;30;5;5;10
293;11.04.2016;2016;04;12;Maanantai;17;18;35;5;6;11
293;11.04.2016;2016;04;13;Maanantai;26;45;71;9;9;18
293;11.04.2016;2016;04;14;Maanantai;18;61;79;6;14;20
293;11.04.2016;2016;04;15;Maanantai;28;93;121;6;11;17
293;11.04.2016;2016;04;16;Maanantai;26;39;65;6;8;14
293;11.04.2016;2016;04;17;Maanantai;36;24;60;14;11;25
293;11.04.2016;2016;04;18;Maanantai;23;29;52;12;13;25
293;11.04.2016;2016;04;19;Maanantai;23;19;42;2;9;11
293;11.04.2016;2016;04;20;Maanantai;4;14;18;3;6;9
293;11.04.2016;2016;04;21;Maanantai;6;7;13;1;2;3
293;11.04.2016;2016;04;22;Maanantai;2;0;2;0;0;0
293;11.04.2016;2016;04;23;Maanantai;0;0;0;0;0;0
293;12.04.2016;2016;04;00;Tiistai;0;0;0;1;0;1
293;12.04.2016;2016;04;01;Tiistai;0;0;0;0;0;0
293;12.04.2016;2016;04;02;Tiistai;0;0;0;0;0;0
293;12.04.2016;2016;04;03;Tiistai;0;0;0;0;0;0
293;12.04.2016;2016;04;04;Tiistai;0;0;0;0;0;0
293;12.04.2016;2016;04;05;Tiistai;3;1;4;0;1;1
293;12.04.2016;2016;04;06;Tiistai;13;1;14;0;0;0
293;12.04.2016;2016;04;07;Tiistai;83;8;91;4;0;4
293;12.04.2016;2016;04;08;Tiistai;68;10;78;1;1;2
293;12.04.2016;2016;04;09;Tiistai;47;15;62;10;4;14
293;12.04.2016;2016;04;10;Tiistai;19;10;29;6;4;10
293;12.04.2016;2016;04;11;Tiistai;13;15;28;6;7;13
293;12.04.2016;2016;04;12;Tiistai;15;10;25;9;4;13
293;12.04.2016;2016;04;13;Tiistai;12;33;45;4;10;14
293;12.04.2016;2016;04;14;Tiistai;13;74;87;4;5;9
293;12.04.2016;2016;04;15;Tiistai;24;96;120;4;8;12
293;12.04.2016;2016;04;16;Tiistai;19;34;53;6;5;11
293;12.04.2016;2016;04;17;Tiistai;26;22;48;6;7;13
293;12.04.2016;2016;04;18;Tiistai;23;37;60;12;8;20
293;12.04.2016;2016;04;19;Tiistai;21;12;33;5;14;19
293;12.04.2016;2016;04;20;Tiistai;6;12;18;3;4;7
293;12.04.2016;2016;04;21;Tiistai;4;4;8;0;0;0
293;12.04.2016;2016;04;22;Tiistai;2;0;2;0;1;1
293;12.04.2016;2016;04;23;Tiistai;0;0;0;0;0;0
293;13.04.2016;2016;04;00;Keskiviikko;1;0;1;0;0;0
293;13.04.2016;2016;04;01;Keskiviikko;0;1;1;0;0;0
293;13.04.2016;2016;04;02;Keskiviikko;0;1;1;0;0;0
293;13.04.2016;2016;04;03;Keskiviikko;0;0;0;0;0;0
293;13.04.2016;2016;04;04;Keskiviikko;0;0;0;0;0;0
293;13.04.2016;2016;04;05;Keskiviikko;2;0;2;0;1;1
293;13.04.2016;2016;04;06;Keskiviikko;15;3;18;1;0;1
293;13.04.2016;2016;04;07;Keskiviikko;95;9;104;7;2;9
293;13.04.2016;2016;04;08;Keskiviikko;51;9;60;8;5;13
293;13.04.2016;2016;04;09;Keskiviikko;28;8;36;8;5;13
293;13.04.2016;2016;04;10;Keskiviikko;15;9;24;7;3;10
293;13.04.2016;2016;04;11;Keskiviikko;3;8;11;2;3;5
293;13.04.2016;2016;04;12;Keskiviikko;6;20;26;3;4;7
293;13.04.2016;2016;04;13;Keskiviikko;5;22;27;4;7;11
293;13.04.2016;2016;04;14;Keskiviikko;8;108;116;3;7;10
293;13.04.2016;2016;04;15;Keskiviikko;14;27;41;1;6;7
293;13.04.2016;2016;04;16;Keskiviikko;17;23;40;4;4;8
293;13.04.2016;2016;04;17;Keskiviikko;15;25;40;5;8;13
293;13.04.2016;2016;04;18;Keskiviikko;15;15;30;5;9;14
293;13.04.2016;2016;04;19;Keskiviikko;13;18;31;11;7;18
293;13.04.2016;2016;04;20;Keskiviikko;4;8;12;2;5;7
293;13.04.2016;2016;04;21;Keskiviikko;5;9;14;2;1;3
293;13.04.2016;2016;04;22;Keskiviikko;1;1;2;0;0;0
293;13.04.2016;2016;04;23;Keskiviikko;0;0;0;0;0;0
293;14.04.2016;2016;04;00;Torstai;0;0;0;0;0;0
293;14.04.2016;2016;04;01;Torstai;0;0;0;0;0;0
293;14.04.2016;2016;04;02;Torstai;0;0;0;0;0;0
293;14.04.2016;2016;04;03;Torstai;0;0;0;0;0;0
293;14.04.2016;2016;04;04;Torstai;0;0;0;0;0;0
293;14.04.2016;2016;04;05;Torstai;2;1;3;0;1;1
293;14.04.2016;2016;04;06;Torstai;10;1;11;1;0;1
293;14.04.2016;2016;04;07;Torstai;78;4;82;5;0;5
293;14.04.2016;2016;04;08;Torstai;50;7;57;5;3;8
293;14.04.2016;2016;04;09;Torstai;47;12;59;4;3;7
293;14.04.2016;2016;04;10;Torstai;16;10;26;4;7;11
293;14.04.2016;2016;04;11;Torstai;13;8;21;8;9;17
293;14.04.2016;2016;04;12;Torstai;20;24;44;8;9;17
293;14.04.2016;2016;04;13;Torstai;7;35;42;3;7;10
293;14.04.2016;2016;04;14;Torstai;12;85;97;10;8;18
293;14.04.2016;2016;04;15;Torstai;23;54;77;3;7;10
293;14.04.2016;2016;04;16;Torstai;33;25;58;2;7;9
293;14.04.2016;2016;04;17;Torstai;16;22;38;11;7;18
293;14.04.2016;2016;04;18;Torstai;12;16;28;7;9;16
293;14.04.2016;2016;04;19;Torstai;12;17;29;4;6;10
293;14.04.2016;2016;04;20;Torstai;3;14;17;1;4;5
293;14.04.2016;2016;04;21;Torstai;8;4;12;0;1;1
293;14.04.2016;2016;04;22;Torstai;5;3;8;0;1;1
293;14.04.2016;2016;04;23;Torstai;0;0;0;0;0;0
293;15.04.2016;2016;04;00;Perjantai;0;0;0;0;0;0
293;15.04.2016;2016;04;01;Perjantai;0;0;0;0;0;0
293;15.04.2016;2016;04;02;Perjantai;1;0;1;0;0;0
293;15.04.2016;2016;04;03;Perjantai;0;0;0;0;0;0
293;15.04.2016;2016;04;04;Perjantai;0;0;0;0;0;0
293;15.04.2016;2016;04;05;Perjantai;1;1;2;0;0;0
293;15.04.2016;2016;04;06;Perjantai;7;2;9;0;1;1
293;15.04.2016;2016;04;07;Perjantai;60;7;67;10;0;10
293;15.04.2016;2016;04;08;Perjantai;55;7;62;6;2;8
293;15.04.2016;2016;04;09;Perjantai;90;10;100;6;4;10
293;15.04.2016;2016;04;10;Perjantai;13;11;24;5;2;7
293;15.04.2016;2016;04;11;Perjantai;10;52;62;6;10;16
293;15.04.2016;2016;04;12;Perjantai;17;34;51;7;7;14
293;15.04.2016;2016;04;13;Perjantai;29;58;87;9;7;16
293;15.04.2016;2016;04;14;Perjantai;15;62;77;8;11;19
293;15.04.2016;2016;04;15;Perjantai;15;47;62;4;4;8
293;15.04.2016;2016;04;16;Perjantai;14;17;31;5;4;9
293;15.04.2016;2016;04;17;Perjantai;32;21;53;3;6;9
293;15.04.2016;2016;04;18;Perjantai;25;29;54;9;10;19
293;15.04.2016;2016;04;19;Perjantai;23;22;45;5;7;12
293;15.04.2016;2016;04;20;Perjantai;13;15;28;1;3;4
293;15.04.2016;2016;04;21;Perjantai;7;14;21;0;3;3
293;15.04.2016;2016;04;22;Perjantai;5;8;13;1;0;1
293;15.04.2016;2016;04;23;Perjantai;2;2;4;0;0;0
293;16.04.2016;2016;04;00;Lauantai;2;0;2;5;0;5
293;16.04.2016;2016;04;01;Lauantai;1;1;2;0;1;1
293;16.04.2016;2016;04;02;Lauantai;1;1;2;1;3;4
293;16.04.2016;2016;04;03;Lauantai;1;1;2;0;2;2
293;16.04.2016;2016;04;04;Lauantai;0;0;0;0;0;0
293;16.04.2016;2016;04;05;Lauantai;1;0;1;0;0;0
293;16.04.2016;2016;04;06;Lauantai;1;3;4;0;0;0
293;16.04.2016;2016;04;07;Lauantai;2;0;2;1;1;2
293;16.04.2016;2016;04;08;Lauantai;12;8;20;1;1;2
293;16.04.2016;2016;04;09;Lauantai;18;8;26;4;4;8
293;16.04.2016;2016;04;10;Lauantai;11;11;22;8;10;18
293;16.04.2016;2016;04;11;Lauantai;16;23;39;11;19;30
293;16.04.2016;2016;04;12;Lauantai;28;24;52;12;13;25
293;16.04.2016;2016;04;13;Lauantai;22;21;43;3;7;10
293;16.04.2016;2016;04;14;Lauantai;25;22;47;4;4;8
293;16.04.2016;2016;04;15;Lauantai;19;27;46;8;3;11
293;16.04.2016;2016;04;16;Lauantai;14;19;33;6;4;10
293;16.04.2016;2016;04;17;Lauantai;14;20;34;0;7;7
293;16.04.2016;2016;04;18;Lauantai;10;8;18;8;7;15
293;16.04.2016;2016;04;19;Lauantai;10;10;20;2;2;4
293;16.04.2016;2016;04;20;Lauantai;5;11;16;1;5;6
293;16.04.2016;2016;04;21;Lauantai;6;6;12;1;3;4
293;16.04.2016;2016;04;22;Lauantai;4;5;9;2;2;4
293;16.04.2016;2016;04;23;Lauantai;3;1;4;5;0;5
293;17.04.2016;2016;04;00;Sunnuntai;1;3;4;4;1;5
293;17.04.2016;2016;04;01;Sunnuntai;4;0;4;8;0;8
293;17.04.2016;2016;04;02;Sunnuntai;0;3;3;0;3;3
293;17.04.2016;2016;04;03;Sunnuntai;0;0;0;0;3;3
293;17.04.2016;2016;04;04;Sunnuntai;1;0;1;0;1;1
293;17.04.2016;2016;04;05;Sunnuntai;0;0;0;2;0;2
293;17.04.2016;2016;04;06;Sunnuntai;2;3;5;3;1;4
293;17.04.2016;2016;04;07;Sunnuntai;1;1;2;0;0;0
293;17.04.2016;2016;04;08;Sunnuntai;0;0;0;0;0;0
293;17.04.2016;2016;04;09;Sunnuntai;5;4;9;2;1;3
293;17.04.2016;2016;04;10;Sunnuntai;3;2;5;1;1;2
293;17.04.2016;2016;04;11;Sunnuntai;11;4;15;8;11;19
293;17.04.2016;2016;04;12;Sunnuntai;15;21;36;13;5;18
293;17.04.2016;2016;04;13;Sunnuntai;19;15;34;5;10;15
293;17.04.2016;2016;04;14;Sunnuntai;22;19;41;9;3;12
293;17.04.2016;2016;04;15;Sunnuntai;15;23;38;4;5;9
293;17.04.2016;2016;04;16;Sunnuntai;9;14;23;3;3;6
293;17.04.2016;2016;04;17;Sunnuntai;17;11;28;5;2;7
293;17.04.2016;2016;04;18;Sunnuntai;5;5;10;4;3;7
293;17.04.2016;2016;04;19;Sunnuntai;7;4;11;1;2;3
293;17.04.2016;2016;04;20;Sunnuntai;2;5;7;3;2;5
293;17.04.2016;2016;04;21;Sunnuntai;2;1;3;0;0;0
293;17.04.2016;2016;04;22;Sunnuntai;0;0;0;0;1;1
293;17.04.2016;2016;04;23;Sunnuntai;0;0;0;0;0;0
293;18.04.2016;2016;04;00;Maanantai;0;0;0;0;0;0
293;18.04.2016;2016;04;01;Maanantai;2;0;2;0;0;0
293;18.04.2016;2016;04;02;Maanantai;0;0;0;0;0;0
293;18.04.2016;2016;04;03;Maanantai;0;1;1;0;0;0
293;18.04.2016;2016;04;04;Maanantai;0;0;0;0;0;0
293;18.04.2016;2016;04;05;Maanantai;3;0;3;0;0;0
293;18.04.2016;2016;04;06;Maanantai;7;3;10;0;1;1
293;18.04.2016;2016;04;07;Maanantai;73;7;80;5;1;6
293;18.04.2016;2016;04;08;Maanantai;57;13;70;6;2;8
293;18.04.2016;2016;04;09;Maanantai;38;10;48;6;8;14
293;18.04.2016;2016;04;10;Maanantai;32;13;45;4;2;6
293;18.04.2016;2016;04;11;Maanantai;13;14;27;6;6;12
293;18.04.2016;2016;04;12;Maanantai;17;18;35;11;5;16
293;18.04.2016;2016;04;13;Maanantai;24;49;73;10;7;17
293;18.04.2016;2016;04;14;Maanantai;15;61;76;5;12;17
293;18.04.2016;2016;04;15;Maanantai;14;82;96;8;7;15
293;18.04.2016;2016;04;16;Maanantai;24;23;47;3;5;8
293;18.04.2016;2016;04;17;Maanantai;16;18;34;7;6;13
293;18.04.2016;2016;04;18;Maanantai;14;14;28;5;6;11
293;18.04.2016;2016;04;19;Maanantai;9;18;27;5;8;13
293;18.04.2016;2016;04;20;Maanantai;8;10;18;6;2;8
293;18.04.2016;2016;04;21;Maanantai;2;9;11;2;0;2
293;18.04.2016;2016;04;22;Maanantai;0;3;3;0;0;0
293;18.04.2016;2016;04;23;Maanantai;0;1;1;0;0;0
293;19.04.2016;2016;04;00;Tiistai;0;0;0;0;1;1
293;19.04.2016;2016;04;01;Tiistai;0;0;0;0;0;0
293;19.04.2016;2016;04;02;Tiistai;0;0;0;0;0;0
293;19.04.2016;2016;04;03;Tiistai;0;1;1;0;0;0
293;19.04.2016;2016;04;04;Tiistai;0;1;1;0;0;0
293;19.04.2016;2016;04;05;Tiistai;4;2;6;0;0;0
293;19.04.2016;2016;04;06;Tiistai;13;1;14;1;0;1
293;19.04.2016;2016;04;07;Tiistai;81;9;90;2;0;2
293;19.04.2016;2016;04;08;Tiistai;59;7;66;6;1;7
293;19.04.2016;2016;04;09;Tiistai;35;9;44;3;5;8
293;19.04.2016;2016;04;10;Tiistai;22;11;33;7;0;7
293;19.04.2016;2016;04;11;Tiistai;7;8;15;7;4;11
293;19.04.2016;2016;04;12;Tiistai;10;15;25;6;6;12
293;19.04.2016;2016;04;13;Tiistai;8;26;34;3;5;8
293;19.04.2016;2016;04;14;Tiistai;18;79;97;5;5;10
293;19.04.2016;2016;04;15;Tiistai;15;62;77;5;10;15
293;19.04.2016;2016;04;16;Tiistai;17;19;36;4;6;10
293;19.04.2016;2016;04;17;Tiistai;10;25;35;7;4;11
293;19.04.2016;2016;04;18;Tiistai;6;17;23;4;7;11
293;19.04.2016;2016;04;19;Tiistai;8;6;14;2;7;9
293;19.04.2016;2016;04;20;Tiistai;2;3;5;2;3;5
293;19.04.2016;2016;04;21;Tiistai;4;6;10;0;1;1
293;19.04.2016;2016;04;22;Tiistai;0;2;2;0;1;1
293;19.04.2016;2016;04;23;Tiistai;2;0;2;1;0;1
293;20.04.2016;2016;04;00;Keskiviikko;0;0;0;0;0;0
293;20.04.2016;2016;04;01;Keskiviikko;0;0;0;0;0;0
293;20.04.2016;2016;04;02;Keskiviikko;0;0;0;0;0;0
293;20.04.2016;2016;04;03;Keskiviikko;0;1;1;0;0;0
293;20.04.2016;2016;04;04;Keskiviikko;0;0;0;0;0;0
293;20.04.2016;2016;04;05;Keskiviikko;4;0;4;0;0;0
293;20.04.2016;2016;04;06;Keskiviikko;7;3;10;1;0;1
293;20.04.2016;2016;04;07;Keskiviikko;95;3;98;7;0;7
293;20.04.2016;2016;04;08;Keskiviikko;51;8;59;3;1;4
293;20.04.2016;2016;04;09;Keskiviikko;18;4;22;4;1;5
293;20.04.2016;2016;04;10;Keskiviikko;16;7;23;3;0;3
293;20.04.2016;2016;04;11;Keskiviikko;5;9;14;2;2;4
293;20.04.2016;2016;04;12;Keskiviikko;14;20;34;2;4;6
293;20.04.2016;2016;04;13;Keskiviikko;8;28;36;1;5;6
293;20.04.2016;2016;04;14;Keskiviikko;14;88;102;3;12;15
293;20.04.2016;2016;04;15;Keskiviikko;15;35;50;7;1;8
293;20.04.2016;2016;04;16;Keskiviikko;18;28;46;4;4;8
293;20.04.2016;2016;04;17;Keskiviikko;9;14;23;3;8;11
293;20.04.2016;2016;04;18;Keskiviikko;8;11;19;9;9;18
293;20.04.2016;2016;04;19;Keskiviikko;12;12;24;8;11;19
293;20.04.2016;2016;04;20;Keskiviikko;1;7;8;2;4;6
293;20.04.2016;2016;04;21;Keskiviikko;0;4;4;1;2;3
293;20.04.2016;2016;04;22;Keskiviikko;0;1;1;0;1;1
293;20.04.2016;2016;04;23;Keskiviikko;1;1;2;0;0;0
293;21.04.2016;2016;04;00;Torstai;0;0;0;0;0;0
293;21.04.2016;2016;04;01;Torstai;0;0;0;0;0;0
293;21.04.2016;2016;04;02;Torstai;0;0;0;0;0;0
293;21.04.2016;2016;04;03;Torstai;0;1;1;0;0;0
293;21.04.2016;2016;04;04;Torstai;0;1;1;0;0;0
293;21.04.2016;2016;04;05;Torstai;7;1;8;0;0;0
293;21.04.2016;2016;04;06;Torstai;12;1;13;1;1;2
293;21.04.2016;2016;04;07;Torstai;80;9;89;8;1;9
293;21.04.2016;2016;04;08;Torstai;74;33;107;4;11;15
293;21.04.2016;2016;04;09;Torstai;43;24;67;22;11;33
293;21.04.2016;2016;04;10;Torstai;16;14;30;13;7;20
293;21.04.2016;2016;04;11;Torstai;12;12;24;7;6;13
293;21.04.2016;2016;04;12;Torstai;9;8;17;8;5;13
293;21.04.2016;2016;04;13;Torstai;8;29;37;11;6;17
293;21.04.2016;2016;04;14;Torstai;8;96;104;6;9;15
293;21.04.2016;2016;04;15;Torstai;20;60;80;6;13;19
293;21.04.2016;2016;04;16;Torstai;27;32;59;3;7;10
293;21.04.2016;2016;04;17;Torstai;28;18;46;7;4;11
293;21.04.2016;2016;04;18;Torstai;18;20;38;6;11;17
293;21.04.2016;2016;04;19;Torstai;13;18;31;5;1;6
293;21.04.2016;2016;04;20;Torstai;9;15;24;0;2;2
293;21.04.2016;2016;04;21;Torstai;7;9;16;2;1;3
293;21.04.2016;2016;04;22;Torstai;2;2;4;0;1;1
293;21.04.2016;2016;04;23;Torstai;0;4;4;0;0;0
293;22.04.2016;2016;04;00;Perjantai;0;0;0;0;0;0
293;22.04.2016;2016;04;01;Perjantai;0;1;1;0;0;0
293;22.04.2016;2016;04;02;Perjantai;0;0;0;0;0;0
293;22.04.2016;2016;04;03;Perjantai;0;1;1;0;0;0
293;22.04.2016;2016;04;04;Perjantai;0;0;0;0;0;0
293;22.04.2016;2016;04;05;Perjantai;3;0;3;0;1;1
293;22.04.2016;2016;04;06;Perjantai;8;4;12;0;0;0
293;22.04.2016;2016;04;07;Perjantai;74;5;79;7;1;8
293;22.04.2016;2016;04;08;Perjantai;62;11;73;4;2;6
293;22.04.2016;2016;04;09;Perjantai;39;8;47;8;4;12
293;22.04.2016;2016;04;10;Perjantai;17;7;24;5;3;8
293;22.04.2016;2016;04;11;Perjantai;10;14;24;5;1;6
293;22.04.2016;2016;04;12;Perjantai;18;45;63;8;8;16
293;22.04.2016;2016;04;13;Perjantai;18;53;71;3;12;15
293;22.04.2016;2016;04;14;Perjantai;13;67;80;4;11;15
293;22.04.2016;2016;04;15;Perjantai;20;64;84;1;9;10
293;22.04.2016;2016;04;16;Perjantai;31;18;49;4;5;9
293;22.04.2016;2016;04;17;Perjantai;21;25;46;5;4;9
293;22.04.2016;2016;04;18;Perjantai;22;30;52;1;12;13
293;22.04.2016;2016;04;19;Perjantai;20;28;48;8;7;15
293;22.04.2016;2016;04;20;Perjantai;7;18;25;5;2;7
293;22.04.2016;2016;04;21;Perjantai;3;7;10;2;1;3
293;22.04.2016;2016;04;22;Perjantai;8;2;10;0;0;0
293;22.04.2016;2016;04;23;Perjantai;2;2;4;0;1;1
293;23.04.2016;2016;04;00;Lauantai;2;1;3;0;0;0
293;23.04.2016;2016;04;01;Lauantai;0;0;0;1;0;1
293;23.04.2016;2016;04;02;Lauantai;0;2;2;0;0;0
293;23.04.2016;2016;04;03;Lauantai;0;0;0;0;1;1
293;23.04.2016;2016;04;04;Lauantai;1;0;1;0;1;1
293;23.04.2016;2016;04;05;Lauantai;0;1;1;0;0;0
293;23.04.2016;2016;04;06;Lauantai;1;1;2;0;1;1
293;23.04.2016;2016;04;07;Lauantai;1;3;4;1;0;1
293;23.04.2016;2016;04;08;Lauantai;6;1;7;5;2;7
293;23.04.2016;2016;04;09;Lauantai;10;17;27;4;6;10
293;23.04.2016;2016;04;10;Lauantai;22;20;42;10;6;16
293;23.04.2016;2016;04;11;Lauantai;15;27;42;11;10;21
293;23.04.2016;2016;04;12;Lauantai;34;13;47;11;8;19
293;23.04.2016;2016;04;13;Lauantai;29;21;50;4;10;14
293;23.04.2016;2016;04;14;Lauantai;22;27;49;10;6;16
293;23.04.2016;2016;04;15;Lauantai;18;19;37;7;1;8
293;23.04.2016;2016;04;16;Lauantai;15;19;34;4;9;13
293;23.04.2016;2016;04;17;Lauantai;23;16;39;5;4;9
293;23.04.2016;2016;04;18;Lauantai;10;21;31;3;3;6
293;23.04.2016;2016;04;19;Lauantai;6;15;21;2;2;4
293;23.04.2016;2016;04;20;Lauantai;11;6;17;1;4;5
293;23.04.2016;2016;04;21;Lauantai;5;6;11;3;2;5
293;23.04.2016;2016;04;22;Lauantai;0;2;2;0;0;0
293;23.04.2016;2016;04;23;Lauantai;1;1;2;0;2;2
293;24.04.2016;2016;04;00;Sunnuntai;1;0;1;0;0;0
293;24.04.2016;2016;04;01;Sunnuntai;0;0;0;0;0;0
293;24.04.2016;2016;04;02;Sunnuntai;0;2;2;1;0;1
293;24.04.2016;2016;04;03;Sunnuntai;0;0;0;0;1;1
293;24.04.2016;2016;04;04;Sunnuntai;0;0;0;0;0;0
293;24.04.2016;2016;04;05;Sunnuntai;0;0;0;0;1;1
293;24.04.2016;2016;04;06;Sunnuntai;1;1;2;0;2;2
293;24.04.2016;2016;04;07;Sunnuntai;2;4;6;0;0;0
293;24.04.2016;2016;04;08;Sunnuntai;6;3;9;3;4;7
293;24.04.2016;2016;04;09;Sunnuntai;15;13;28;6;5;11
293;24.04.2016;2016;04;10;Sunnuntai;30;9;39;7;10;17
293;24.04.2016;2016;04;11;Sunnuntai;25;26;51;6;9;15
293;24.04.2016;2016;04;12;Sunnuntai;21;27;48;10;6;16
293;24.04.2016;2016;04;13;Sunnuntai;33;21;54;5;7;12
293;24.04.2016;2016;04;14;Sunnuntai;20;21;41;9;5;14
293;24.04.2016;2016;04;15;Sunnuntai;17;17;34;3;6;9
293;24.04.2016;2016;04;16;Sunnuntai;28;26;54;6;7;13
293;24.04.2016;2016;04;17;Sunnuntai;17;16;33;6;11;17
293;24.04.2016;2016;04;18;Sunnuntai;16;22;38;2;4;6
293;24.04.2016;2016;04;19;Sunnuntai;14;13;27;2;2;4
293;24.04.2016;2016;04;20;Sunnuntai;3;16;19;1;5;6
293;24.04.2016;2016;04;21;Sunnuntai;2;1;3;2;0;2
293;24.04.2016;2016;04;22;Sunnuntai;0;0;0;0;0;0
293;24.04.2016;2016;04;23;Sunnuntai;0;1;1;0;0;0
293;25.04.2016;2016;04;00;Maanantai;0;0;0;1;1;2
293;25.04.2016;2016;04;01;Maanantai;1;1;2;0;0;0
293;25.04.2016;2016;04;02;Maanantai;0;0;0;0;0;0
293;25.04.2016;2016;04;03;Maanantai;0;0;0;0;0;0
293;25.04.2016;2016;04;04;Maanantai;0;0;0;0;0;0
293;25.04.2016;2016;04;05;Maanantai;2;1;3;0;0;0
293;25.04.2016;2016;04;06;Maanantai;11;2;13;0;1;1
293;25.04.2016;2016;04;07;Maanantai;64;10;74;3;3;6
293;25.04.2016;2016;04;08;Maanantai;70;10;80;4;5;9
293;25.04.2016;2016;04;09;Maanantai;44;5;49;9;3;12
293;25.04.2016;2016;04;10;Maanantai;21;9;30;2;5;7
293;25.04.2016;2016;04;11;Maanantai;11;10;21;5;3;8
293;25.04.2016;2016;04;12;Maanantai;11;15;26;1;0;1
293;25.04.2016;2016;04;13;Maanantai;11;45;56;5;3;8
293;25.04.2016;2016;04;14;Maanantai;11;44;55;3;5;8
293;25.04.2016;2016;04;15;Maanantai;11;73;84;3;4;7
293;25.04.2016;2016;04;16;Maanantai;7;8;15;1;2;3
293;25.04.2016;2016;04;17;Maanantai;7;4;11;1;0;1
293;25.04.2016;2016;04;18;Maanantai;5;6;11;5;4;9
293;25.04.2016;2016;04;19;Maanantai;3;4;7;2;4;6
293;25.04.2016;2016;04;20;Maanantai;0;3;3;1;3;4
293;25.04.2016;2016;04;21;Maanantai;0;2;2;2;0;2
293;25.04.2016;2016;04;22;Maanantai;0;1;1;0;1;1
293;25.04.2016;2016;04;23;Maanantai;0;0;0;0;0;0
293;26.04.2016;2016;04;00;Tiistai;0;0;0;0;0;0
293;26.04.2016;2016;04;01;Tiistai;0;0;0;0;0;0
293;26.04.2016;2016;04;02;Tiistai;0;0;0;0;0;0
293;26.04.2016;2016;04;03;Tiistai;0;0;0;0;0;0
293;26.04.2016;2016;04;04;Tiistai;0;1;1;0;0;0
293;26.04.2016;2016;04;05;Tiistai;2;2;4;1;0;1
293;26.04.2016;2016;04;06;Tiistai;10;0;10;0;0;0
293;26.04.2016;2016;04;07;Tiistai;74;13;87;2;0;2
293;26.04.2016;2016;04;08;Tiistai;55;9;64;8;17;25
293;26.04.2016;2016;04;09;Tiistai;25;9;34;4;3;7
293;26.04.2016;2016;04;10;Tiistai;18;7;25;2;3;5
293;26.04.2016;2016;04;11;Tiistai;12;11;23;5;0;5
293;26.04.2016;2016;04;12;Tiistai;6;8;14;2;3;5
293;26.04.2016;2016;04;13;Tiistai;8;32;40;1;1;2
293;26.04.2016;2016;04;14;Tiistai;17;71;88;4;7;11
293;26.04.2016;2016;04;15;Tiistai;12;50;62;0;7;7
293;26.04.2016;2016;04;16;Tiistai;22;19;41;3;7;10
293;26.04.2016;2016;04;17;Tiistai;14;27;41;2;4;6
293;26.04.2016;2016;04;18;Tiistai;10;12;22;1;3;4
293;26.04.2016;2016;04;19;Tiistai;13;16;29;0;1;1
293;26.04.2016;2016;04;20;Tiistai;8;5;13;6;6;12
293;26.04.2016;2016;04;21;Tiistai;1;6;7;3;2;5
293;26.04.2016;2016;04;22;Tiistai;0;1;1;0;0;0
293;26.04.2016;2016;04;23;Tiistai;0;0;0;0;0;0
293;27.04.2016;2016;04;00;Keskiviikko;0;0;0;0;0;0
293;27.04.2016;2016;04;01;Keskiviikko;0;0;0;0;0;0
293;27.04.2016;2016;04;02;Keskiviikko;0;0;0;0;0;0
293;27.04.2016;2016;04;03;Keskiviikko;1;0;1;0;0;0
293;27.04.2016;2016;04;04;Keskiviikko;0;0;0;0;0;0
293;27.04.2016;2016;04;05;Keskiviikko;5;1;6;0;0;0
293;27.04.2016;2016;04;06;Keskiviikko;8;1;9;0;1;1
293;27.04.2016;2016;04;07;Keskiviikko;88;13;101;8;2;10
293;27.04.2016;2016;04;08;Keskiviikko;57;11;68;4;2;6
293;27.04.2016;2016;04;09;Keskiviikko;28;9;37;1;1;2
293;27.04.2016;2016;04;10;Keskiviikko;22;11;33;4;5;9
293;27.04.2016;2016;04;11;Keskiviikko;1;8;9;2;2;4
293;27.04.2016;2016;04;12;Keskiviikko;13;29;42;2;2;4
293;27.04.2016;2016;04;13;Keskiviikko;12;25;37;4;2;6
293;27.04.2016;2016;04;14;Keskiviikko;15;93;108;1;9;10
293;27.04.2016;2016;04;15;Keskiviikko;23;32;55;5;1;6
293;27.04.2016;2016;04;16;Keskiviikko;19;29;48;4;3;7
293;27.04.2016;2016;04;17;Keskiviikko;10;17;27;6;8;14
293;27.04.2016;2016;04;18;Keskiviikko;12;13;25;4;5;9
293;27.04.2016;2016;04;19;Keskiviikko;8;14;22;5;3;8
293;27.04.2016;2016;04;20;Keskiviikko;4;6;10;0;4;4
293;27.04.2016;2016;04;21;Keskiviikko;0;5;5;0;0;0
293;27.04.2016;2016;04;22;Keskiviikko;0;0;0;0;0;0
293;27.04.2016;2016;04;23;Keskiviikko;0;0;0;0;1;1
293;28.04.2016;2016;04;00;Torstai;0;0;0;0;0;0
293;28.04.2016;2016;04;01;Torstai;0;0;0;0;0;0
293;28.04.2016;2016;04;02;Torstai;0;0;0;0;0;0
293;28.04.2016;2016;04;03;Torstai;0;0;0;0;0;0
293;28.04.2016;2016;04;04;Torstai;0;1;1;0;0;0
293;28.04.2016;2016;04;05;Torstai;5;1;6;2;0;2
293;28.04.2016;2016;04;06;Torstai;10;2;12;0;0;0
293;28.04.2016;2016;04;07;Torstai;76;8;84;5;1;6
293;28.04.2016;2016;04;08;Torstai;59;11;70;6;1;7
293;28.04.2016;2016;04;09;Torstai;43;13;56;3;2;5
293;28.04.2016;2016;04;10;Torstai;43;31;74;4;7;11
293;28.04.2016;2016;04;11;Torstai;13;12;25;10;3;13
293;28.04.2016;2016;04;12;Torstai;12;20;32;6;9;15
293;28.04.2016;2016;04;13;Torstai;17;31;48;4;4;8
293;28.04.2016;2016;04;14;Torstai;21;90;111;7;10;17
293;28.04.2016;2016;04;15;Torstai;18;85;103;2;8;10
293;28.04.2016;2016;04;16;Torstai;30;24;54;2;4;6
293;28.04.2016;2016;04;17;Torstai;25;22;47;7;4;11
293;28.04.2016;2016;04;18;Torstai;30;28;58;6;8;14
293;28.04.2016;2016;04;19;Torstai;22;23;45;3;6;9
293;28.04.2016;2016;04;20;Torstai;9;26;35;1;0;1
293;28.04.2016;2016;04;21;Torstai;5;9;14;1;2;3
293;28.04.2016;2016;04;22;Torstai;2;0;2;0;0;0
293;28.04.2016;2016;04;23;Torstai;0;0;0;0;0;0
293;29.04.2016;2016;04;00;Perjantai;0;2;2;0;0;0
293;29.04.2016;2016;04;01;Perjantai;0;0;0;0;0;0
293;29.04.2016;2016;04;02;Perjantai;0;0;0;0;0;0
293;29.04.2016;2016;04;03;Perjantai;0;0;0;0;0;0
293;29.04.2016;2016;04;04;Perjantai;1;0;1;0;0;0
293;29.04.2016;2016;04;05;Perjantai;5;1;6;0;0;0
293;29.04.2016;2016;04;06;Perjantai;10;1;11;0;0;0
293;29.04.2016;2016;04;07;Perjantai;96;10;106;8;0;8
293;29.04.2016;2016;04;08;Perjantai;61;13;74;6;10;16
293;29.04.2016;2016;04;09;Perjantai;23;14;37;8;1;9
293;29.04.2016;2016;04;10;Perjantai;26;10;36;2;4;6
293;29.04.2016;2016;04;11;Perjantai;13;14;27;5;5;10
293;29.04.2016;2016;04;12;Perjantai;12;30;42;4;3;7
293;29.04.2016;2016;04;13;Perjantai;16;44;60;6;7;13
293;29.04.2016;2016;04;14;Perjantai;10;71;81;3;7;10
293;29.04.2016;2016;04;15;Perjantai;15;61;76;1;3;4
293;29.04.2016;2016;04;16;Perjantai;16;12;28;5;4;9
293;29.04.2016;2016;04;17;Perjantai;28;22;50;8;7;15
293;29.04.2016;2016;04;18;Perjantai;13;18;31;2;8;10
293;29.04.2016;2016;04;19;Perjantai;13;16;29;5;6;11
293;29.04.2016;2016;04;20;Perjantai;7;23;30;3;14;17
293;29.04.2016;2016;04;21;Perjantai;9;8;17;3;4;7
293;29.04.2016;2016;04;22;Perjantai;11;2;13;2;1;3
293;29.04.2016;2016;04;23;Perjantai;0;1;1;2;1;3
293;30.04.2016;2016;04;00;Lauantai;0;0;0;0;0;0
293;30.04.2016;2016;04;01;Lauantai;0;0;0;0;1;1
293;30.04.2016;2016;04;02;Lauantai;0;2;2;0;1;1
293;30.04.2016;2016;04;03;Lauantai;0;1;1;0;0;0
293;30.04.2016;2016;04;04;Lauantai;0;1;1;1;0;1
293;30.04.2016;2016;04;05;Lauantai;0;0;0;0;0;0
293;30.04.2016;2016;04;06;Lauantai;2;2;4;0;0;0
293;30.04.2016;2016;04;07;Lauantai;1;0;1;0;0;0
293;30.04.2016;2016;04;08;Lauantai;11;3;14;4;1;5
293;30.04.2016;2016;04;09;Lauantai;18;17;35;5;4;9
293;30.04.2016;2016;04;10;Lauantai;17;20;37;10;5;15
293;30.04.2016;2016;04;11;Lauantai;23;29;52;5;14;19
293;30.04.2016;2016;04;12;Lauantai;44;24;68;7;4;11
293;30.04.2016;2016;04;13;Lauantai;24;37;61;7;6;13
293;30.04.2016;2016;04;14;Lauantai;33;35;68;10;8;18
293;30.04.2016;2016;04;15;Lauantai;21;20;41;0;5;5
293;30.04.2016;2016;04;16;Lauantai;19;28;47;7;6;13
293;30.04.2016;2016;04;17;Lauantai;17;22;39;5;2;7
293;30.04.2016;2016;04;18;Lauantai;19;22;41;7;4;11
293;30.04.2016;2016;04;19;Lauantai;15;18;33;0;1;1
293;30.04.2016;2016;04;20;Lauantai;12;21;33;1;4;5
293;30.04.2016;2016;04;21;Lauantai;17;10;27;3;2;5
293;30.04.2016;2016;04;22;Lauantai;10;8;18;2;1;3
293;30.04.2016;2016;04;23;Lauantai;12;4;16;1;1;2
293;01.05.2016;2016;05;00;Sunnuntai;3;5;8;1;1;2
293;01.05.2016;2016;05;01;Sunnuntai;2;3;5;1;2;3
293;01.05.2016;2016;05;02;Sunnuntai;4;2;6;0;0;0
293;01.05.2016;2016;05;03;Sunnuntai;0;3;3;1;3;4
293;01.05.2016;2016;05;04;Sunnuntai;0;1;1;0;1;1
293;01.05.2016;2016;05;05;Sunnuntai;1;1;2;0;0;0
293;01.05.2016;2016;05;06;Sunnuntai;0;1;1;0;0;0
293;01.05.2016;2016;05;07;Sunnuntai;2;1;3;0;0;0
293;01.05.2016;2016;05;08;Sunnuntai;9;0;9;5;4;9
293;01.05.2016;2016;05;09;Sunnuntai;8;7;15;8;6;14
293;01.05.2016;2016;05;10;Sunnuntai;36;14;50;8;7;15
293;01.05.2016;2016;05;11;Sunnuntai;146;45;191;38;13;51
293;01.05.2016;2016;05;12;Sunnuntai;94;84;178;20;16;36
293;01.05.2016;2016;05;13;Sunnuntai;54;107;161;13;28;41
293;01.05.2016;2016;05;14;Sunnuntai;34;74;108;12;16;28
293;01.05.2016;2016;05;15;Sunnuntai;33;33;66;4;5;9
293;01.05.2016;2016;05;16;Sunnuntai;46;34;80;13;1;14
293;01.05.2016;2016;05;17;Sunnuntai;27;54;81;7;6;13
293;01.05.2016;2016;05;18;Sunnuntai;40;20;60;3;7;10
293;01.05.2016;2016;05;19;Sunnuntai;21;32;53;10;6;16
293;01.05.2016;2016;05;20;Sunnuntai;15;16;31;2;3;5
293;01.05.2016;2016;05;21;Sunnuntai;5;2;7;0;1;1
293;01.05.2016;2016;05;22;Sunnuntai;1;2;3;0;0;0
293;01.05.2016;2016;05;23;Sunnuntai;0;0;0;0;0;0
293;02.05.2016;2016;05;00;Maanantai;0;0;0;0;0;0
293;02.05.2016;2016;05;01;Maanantai;0;2;2;0;0;0
293;02.05.2016;2016;05;02;Maanantai;0;0;0;0;0;0
293;02.05.2016;2016;05;03;Maanantai;0;0;0;0;0;0
293;02.05.2016;2016;05;04;Maanantai;0;0;0;0;0;0
293;02.05.2016;2016;05;05;Maanantai;7;1;8;0;0;0
293;02.05.2016;2016;05;06;Maanantai;15;3;18;2;0;2
293;02.05.2016;2016;05;07;Maanantai;75;9;84;3;2;5
293;02.05.2016;2016;05;08;Maanantai;77;29;106;5;12;17
293;02.05.2016;2016;05;09;Maanantai;62;10;72;7;2;9
293;02.05.2016;2016;05;10;Maanantai;35;11;46;2;2;4
293;02.05.2016;2016;05;11;Maanantai;2;11;13;3;1;4
293;02.05.2016;2016;05;12;Maanantai;12;13;25;0;3;3
293;02.05.2016;2016;05;13;Maanantai;17;45;62;1;2;3
293;02.05.2016;2016;05;14;Maanantai;21;73;94;4;9;13
293;02.05.2016;2016;05;15;Maanantai;33;87;120;3;9;12
293;02.05.2016;2016;05;16;Maanantai;28;32;60;3;4;7
293;02.05.2016;2016;05;17;Maanantai;32;33;65;7;3;10
293;02.05.2016;2016;05;18;Maanantai;38;27;65;3;2;5
293;02.05.2016;2016;05;19;Maanantai;30;49;79;4;5;9
293;02.05.2016;2016;05;20;Maanantai;13;23;36;4;7;11
293;02.05.2016;2016;05;21;Maanantai;4;7;11;1;2;3
293;02.05.2016;2016;05;22;Maanantai;0;2;2;0;1;1
293;02.05.2016;2016;05;23;Maanantai;0;1;1;0;0;0
293;03.05.2016;2016;05;00;Tiistai;0;1;1;0;0;0
293;03.05.2016;2016;05;01;Tiistai;0;0;0;0;0;0
293;03.05.2016;2016;05;02;Tiistai;0;0;0;0;0;0
293;03.05.2016;2016;05;03;Tiistai;0;0;0;0;1;1
293;03.05.2016;2016;05;04;Tiistai;0;0;0;0;0;0
293;03.05.2016;2016;05;05;Tiistai;5;1;6;0;0;0
293;03.05.2016;2016;05;06;Tiistai;16;4;20;1;0;1
293;03.05.2016;2016;05;07;Tiistai;123;9;132;3;0;3
293;03.05.2016;2016;05;08;Tiistai;73;9;82;5;4;9
293;03.05.2016;2016;05;09;Tiistai;28;15;43;1;2;3
293;03.05.2016;2016;05;10;Tiistai;11;18;29;3;2;5
293;03.05.2016;2016;05;11;Tiistai;18;12;30;2;4;6
293;03.05.2016;2016;05;12;Tiistai;16;17;33;4;3;7
293;03.05.2016;2016;05;13;Tiistai;13;42;55;3;5;8
293;03.05.2016;2016;05;14;Tiistai;22;87;109;3;7;10
293;03.05.2016;2016;05;15;Tiistai;28;78;106;1;6;7
293;03.05.2016;2016;05;16;Tiistai;31;35;66;1;10;11
293;03.05.2016;2016;05;17;Tiistai;27;32;59;4;3;7
293;03.05.2016;2016;05;18;Tiistai;34;46;80;8;6;14
293;03.05.2016;2016;05;19;Tiistai;26;34;60;8;8;16
293;03.05.2016;2016;05;20;Tiistai;9;27;36;2;4;6
293;03.05.2016;2016;05;21;Tiistai;1;6;7;1;1;2
293;03.05.2016;2016;05;22;Tiistai;0;2;2;1;2;3
293;03.05.2016;2016;05;23;Tiistai;0;2;2;0;0;0
293;04.05.2016;2016;05;00;Keskiviikko;0;0;0;0;0;0
293;04.05.2016;2016;05;01;Keskiviikko;0;0;0;0;0;0
293;04.05.2016;2016;05;02;Keskiviikko;0;0;0;0;0;0
293;04.05.2016;2016;05;03;Keskiviikko;0;0;0;0;0;0
293;04.05.2016;2016;05;04;Keskiviikko;2;0;2;0;0;0
293;04.05.2016;2016;05;05;Keskiviikko;4;1;5;0;0;0
293;04.05.2016;2016;05;06;Keskiviikko;15;6;21;0;0;0
293;04.05.2016;2016;05;07;Keskiviikko;117;11;128;8;0;8
293;04.05.2016;2016;05;08;Keskiviikko;76;14;90;7;0;7
293;04.05.2016;2016;05;09;Keskiviikko;39;16;55;4;1;5
293;04.05.2016;2016;05;10;Keskiviikko;28;17;45;4;5;9
293;04.05.2016;2016;05;11;Keskiviikko;18;18;36;10;2;12
293;04.05.2016;2016;05;12;Keskiviikko;25;39;64;3;8;11
293;04.05.2016;2016;05;13;Keskiviikko;13;43;56;3;6;9
293;04.05.2016;2016;05;14;Keskiviikko;29;131;160;8;9;17
293;04.05.2016;2016;05;15;Keskiviikko;29;52;81;1;4;5
293;04.05.2016;2016;05;16;Keskiviikko;38;50;88;2;1;3
293;04.05.2016;2016;05;17;Keskiviikko;42;42;84;10;9;19
293;04.05.2016;2016;05;18;Keskiviikko;35;27;62;7;6;13
293;04.05.2016;2016;05;19;Keskiviikko;25;43;68;2;9;11
293;04.05.2016;2016;05;20;Keskiviikko;14;30;44;4;6;10
293;04.05.2016;2016;05;21;Keskiviikko;3;16;19;3;2;5
293;04.05.2016;2016;05;22;Keskiviikko;1;3;4;2;0;2
293;04.05.2016;2016;05;23;Keskiviikko;0;3;3;0;0;0
293;05.05.2016;2016;05;00;Torstai;0;0;0;0;0;0
293;05.05.2016;2016;05;01;Torstai;0;0;0;0;1;1
293;05.05.2016;2016;05;02;Torstai;1;0;1;0;1;1
293;05.05.2016;2016;05;03;Torstai;0;0;0;0;0;0
293;05.05.2016;2016;05;04;Torstai;0;0;0;0;0;0
293;05.05.2016;2016;05;05;Torstai;0;2;2;0;0;0
293;05.05.2016;2016;05;06;Torstai;0;1;1;0;0;0
293;05.05.2016;2016;05;07;Torstai;4;2;6;0;0;0
293;05.05.2016;2016;05;08;Torstai;7;7;14;4;2;6
293;05.05.2016;2016;05;09;Torstai;18;22;40;0;5;5
293;05.05.2016;2016;05;10;Torstai;26;15;41;10;4;14
293;05.05.2016;2016;05;11;Torstai;30;29;59;10;5;15
293;05.05.2016;2016;05;12;Torstai;41;37;78;7;6;13
293;05.05.2016;2016;05;13;Torstai;25;16;41;5;6;11
293;05.05.2016;2016;05;14;Torstai;36;41;77;7;5;12
293;05.05.2016;2016;05;15;Torstai;43;31;74;5;4;9
293;05.05.2016;2016;05;16;Torstai;26;22;48;9;5;14
293;05.05.2016;2016;05;17;Torstai;27;27;54;5;4;9
293;05.05.2016;2016;05;18;Torstai;37;23;60;3;2;5
293;05.05.2016;2016;05;19;Torstai;14;34;48;2;7;9
293;05.05.2016;2016;05;20;Torstai;13;24;37;4;3;7
293;05.05.2016;2016;05;21;Torstai;9;9;18;1;0;1
293;05.05.2016;2016;05;22;Torstai;1;2;3;0;2;2
293;05.05.2016;2016;05;23;Torstai;1;6;7;0;1;1
293;06.05.2016;2016;05;00;Perjantai;0;0;0;1;0;1
293;06.05.2016;2016;05;01;Perjantai;0;0;0;0;0;0
293;06.05.2016;2016;05;02;Perjantai;0;1;1;0;1;1
293;06.05.2016;2016;05;03;Perjantai;0;0;0;0;0;0
293;06.05.2016;2016;05;04;Perjantai;0;0;0;0;0;0
293;06.05.2016;2016;05;05;Perjantai;1;0;1;0;1;1
293;06.05.2016;2016;05;06;Perjantai;10;4;14;2;1;3
293;06.05.2016;2016;05;07;Perjantai;14;3;17;0;0;0
293;06.05.2016;2016;05;08;Perjantai;9;8;17;3;3;6
293;06.05.2016;2016;05;09;Perjantai;21;8;29;0;1;1
293;06.05.2016;2016;05;10;Perjantai;23;18;41;2;1;3
293;06.05.2016;2016;05;11;Perjantai;26;16;42;4;1;5
293;06.05.2016;2016;05;12;Perjantai;40;27;67;7;3;10
293;06.05.2016;2016;05;13;Perjantai;30;28;58;3;3;6
293;06.05.2016;2016;05;14;Perjantai;35;39;74;6;4;10
293;06.05.2016;2016;05;15;Perjantai;16;43;59;5;4;9
293;06.05.2016;2016;05;16;Perjantai;26;42;68;8;4;12
293;06.05.2016;2016;05;17;Perjantai;29;27;56;6;6;12
293;06.05.2016;2016;05;18;Perjantai;33;32;65;3;4;7
293;06.05.2016;2016;05;19;Perjantai;17;33;50;3;5;8
293;06.05.2016;2016;05;20;Perjantai;11;17;28;1;2;3
293;06.05.2016;2016;05;21;Perjantai;7;4;11;4;2;6
293;06.05.2016;2016;05;22;Perjantai;3;6;9;0;1;1
293;06.05.2016;2016;05;23;Perjantai;4;4;8;3;0;3
293;07.05.2016;2016;05;00;Lauantai;2;1;3;1;0;1
293;07.05.2016;2016;05;01;Lauantai;0;0;0;0;1;1
293;07.05.2016;2016;05;02;Lauantai;0;2;2;0;1;1
293;07.05.2016;2016;05;03;Lauantai;0;2;2;0;1;1
293;07.05.2016;2016;05;04;Lauantai;0;0;0;0;0;0
293;07.05.2016;2016;05;05;Lauantai;1;1;2;1;0;1
293;07.05.2016;2016;05;06;Lauantai;3;1;4;0;0;0
293;07.05.2016;2016;05;07;Lauantai;2;3;5;2;0;2
293;07.05.2016;2016;05;08;Lauantai;9;6;15;1;2;3
293;07.05.2016;2016;05;09;Lauantai;11;9;20;1;0;1
293;07.05.2016;2016;05;10;Lauantai;16;21;37;6;3;9
293;07.05.2016;2016;05;11;Lauantai;18;11;29;3;2;5
293;07.05.2016;2016;05;12;Lauantai;35;26;61;7;5;12
293;07.05.2016;2016;05;13;Lauantai;30;25;55;2;5;7
293;07.05.2016;2016;05;14;Lauantai;28;36;64;8;4;12
293;07.05.2016;2016;05;15;Lauantai;37;27;64;9;1;10
293;07.05.2016;2016;05;16;Lauantai;36;33;69;4;7;11
293;07.05.2016;2016;05;17;Lauantai;40;29;69;8;1;9
293;07.05.2016;2016;05;18;Lauantai;36;35;71;6;8;14
293;07.05.2016;2016;05;19;Lauantai;20;24;44;2;5;7
293;07.05.2016;2016;05;20;Lauantai;18;31;49;1;1;2
293;07.05.2016;2016;05;21;Lauantai;10;11;21;2;1;3
293;07.05.2016;2016;05;22;Lauantai;2;7;9;0;2;2
293;07.05.2016;2016;05;23;Lauantai;6;8;14;1;0;1
293;08.05.2016;2016;05;00;Sunnuntai;2;3;5;0;0;0
293;08.05.2016;2016;05;01;Sunnuntai;0;0;0;0;3;3
293;08.05.2016;2016;05;02;Sunnuntai;0;0;0;0;1;1
293;08.05.2016;2016;05;03;Sunnuntai;1;0;1;0;1;1
293;08.05.2016;2016;05;04;Sunnuntai;0;1;1;0;1;1
293;08.05.2016;2016;05;05;Sunnuntai;3;0;3;0;0;0
293;08.05.2016;2016;05;06;Sunnuntai;2;2;4;0;0;0
293;08.05.2016;2016;05;07;Sunnuntai;1;2;3;1;0;1
293;08.05.2016;2016;05;08;Sunnuntai;5;2;7;2;2;4
293;08.05.2016;2016;05;09;Sunnuntai;21;8;29;7;3;10
293;08.05.2016;2016;05;10;Sunnuntai;24;17;41;6;4;10
293;08.05.2016;2016;05;11;Sunnuntai;29;27;56;10;12;22
293;08.05.2016;2016;05;12;Sunnuntai;27;26;53;9;13;22
293;08.05.2016;2016;05;13;Sunnuntai;30;21;51;7;3;10
293;08.05.2016;2016;05;14;Sunnuntai;34;25;59;10;8;18
293;08.05.2016;2016;05;15;Sunnuntai;31;49;80;9;6;15
293;08.05.2016;2016;05;16;Sunnuntai;27;18;45;4;5;9
293;08.05.2016;2016;05;17;Sunnuntai;15;18;33;2;4;6
293;08.05.2016;2016;05;18;Sunnuntai;22;13;35;2;5;7
293;08.05.2016;2016;05;19;Sunnuntai;28;31;59;7;3;10
293;08.05.2016;2016;05;20;Sunnuntai;17;10;27;5;4;9
293;08.05.2016;2016;05;21;Sunnuntai;8;7;15;3;3;6
293;08.05.2016;2016;05;22;Sunnuntai;0;0;0;0;1;1
293;08.05.2016;2016;05;23;Sunnuntai;1;3;4;0;0;0
293;09.05.2016;2016;05;00;Maanantai;3;1;4;0;0;0
293;09.05.2016;2016;05;01;Maanantai;0;0;0;1;0;1
293;09.05.2016;2016;05;02;Maanantai;0;0;0;0;0;0
293;09.05.2016;2016;05;03;Maanantai;0;0;0;0;0;0
293;09.05.2016;2016;05;04;Maanantai;0;0;0;0;0;0
293;09.05.2016;2016;05;05;Maanantai;6;1;7;2;0;2
293;09.05.2016;2016;05;06;Maanantai;17;4;21;0;0;0
293;09.05.2016;2016;05;07;Maanantai;86;15;101;4;0;4
293;09.05.2016;2016;05;08;Maanantai;82;24;106;3;3;6
293;09.05.2016;2016;05;09;Maanantai;55;7;62;2;1;3
293;09.05.2016;2016;05;10;Maanantai;27;15;42;3;4;7
293;09.05.2016;2016;05;11;Maanantai;17;16;33;7;3;10
293;09.05.2016;2016;05;12;Maanantai;24;15;39;6;4;10
293;09.05.2016;2016;05;13;Maanantai;20;59;79;5;25;30
293;09.05.2016;2016;05;14;Maanantai;26;79;105;14;13;27
293;09.05.2016;2016;05;15;Maanantai;30;90;120;7;9;16
293;09.05.2016;2016;05;16;Maanantai;32;41;73;7;4;11
293;09.05.2016;2016;05;17;Maanantai;31;27;58;8;7;15
293;09.05.2016;2016;05;18;Maanantai;23;25;48;5;8;13
293;09.05.2016;2016;05;19;Maanantai;23;35;58;4;4;8
293;09.05.2016;2016;05;20;Maanantai;7;13;20;0;1;1
293;09.05.2016;2016;05;21;Maanantai;2;13;15;0;0;0
293;09.05.2016;2016;05;22;Maanantai;1;6;7;0;0;0
293;09.05.2016;2016;05;23;Maanantai;0;0;0;0;0;0
293;10.05.2016;2016;05;00;Tiistai;0;0;0;0;0;0
293;10.05.2016;2016;05;01;Tiistai;0;0;0;0;0;0
293;10.05.2016;2016;05;02;Tiistai;0;0;0;0;0;0
293;10.05.2016;2016;05;03;Tiistai;0;0;0;0;0;0
293;10.05.2016;2016;05;04;Tiistai;1;0;1;0;0;0
293;10.05.2016;2016;05;05;Tiistai;1;1;2;1;1;2
293;10.05.2016;2016;05;06;Tiistai;6;2;8;4;1;5
293;10.05.2016;2016;05;07;Tiistai;58;2;60;5;0;5
293;10.05.2016;2016;05;08;Tiistai;47;5;52;4;0;4
293;10.05.2016;2016;05;09;Tiistai;35;3;38;0;0;0
293;10.05.2016;2016;05;10;Tiistai;5;6;11;0;2;2
293;10.05.2016;2016;05;11;Tiistai;14;1;15;1;1;2
293;10.05.2016;2016;05;12;Tiistai;5;12;17;2;1;3
293;10.05.2016;2016;05;13;Tiistai;13;18;31;2;0;2
293;10.05.2016;2016;05;14;Tiistai;9;68;77;1;4;5
293;10.05.2016;2016;05;15;Tiistai;13;55;68;3;12;15
293;10.05.2016;2016;05;16;Tiistai;16;16;32;2;1;3
293;10.05.2016;2016;05;17;Tiistai;17;23;40;5;6;11
293;10.05.2016;2016;05;18;Tiistai;11;10;21;9;7;16
293;10.05.2016;2016;05;19;Tiistai;12;20;32;5;7;12
293;10.05.2016;2016;05;20;Tiistai;9;9;18;0;7;7
293;10.05.2016;2016;05;21;Tiistai;1;6;7;1;0;1
293;10.05.2016;2016;05;22;Tiistai;0;4;4;1;1;2
293;10.05.2016;2016;05;23;Tiistai;1;1;2;0;0;0
293;11.05.2016;2016;05;00;Keskiviikko;0;0;0;0;0;0
293;11.05.2016;2016;05;01;Keskiviikko;0;0;0;0;0;0
293;11.05.2016;2016;05;02;Keskiviikko;0;0;0;0;0;0
293;11.05.2016;2016;05;03;Keskiviikko;0;0;0;0;0;0
293;11.05.2016;2016;05;04;Keskiviikko;1;0;1;0;0;0
293;11.05.2016;2016;05;05;Keskiviikko;6;0;6;0;0;0
293;11.05.2016;2016;05;06;Keskiviikko;17;5;22;0;0;0
293;11.05.2016;2016;05;07;Keskiviikko;115;9;124;7;1;8
293;11.05.2016;2016;05;08;Keskiviikko;99;15;114;4;1;5
293;11.05.2016;2016;05;09;Keskiviikko;31;17;48;0;2;2
293;11.05.2016;2016;05;10;Keskiviikko;25;52;77;3;1;4
293;11.05.2016;2016;05;11;Keskiviikko;15;13;28;4;1;5
293;11.05.2016;2016;05;12;Keskiviikko;18;29;47;6;5;11
293;11.05.2016;2016;05;13;Keskiviikko;22;26;48;4;0;4
293;11.05.2016;2016;05;14;Keskiviikko;20;115;135;5;7;12
293;11.05.2016;2016;05;15;Keskiviikko;26;51;77;2;2;4
293;11.05.2016;2016;05;16;Keskiviikko;25;41;66;7;10;17
293;11.05.2016;2016;05;17;Keskiviikko;31;34;65;7;1;8
293;11.05.2016;2016;05;18;Keskiviikko;26;30;56;4;10;14
293;11.05.2016;2016;05;19;Keskiviikko;26;35;61;4;8;12
293;11.05.2016;2016;05;20;Keskiviikko;5;14;19;2;1;3
293;11.05.2016;2016;05;21;Keskiviikko;1;13;14;0;1;1
293;11.05.2016;2016;05;22;Keskiviikko;2;0;2;3;2;5
293;11.05.2016;2016;05;23;Keskiviikko;0;0;0;0;0;0
293;12.05.2016;2016;05;00;Torstai;0;0;0;0;0;0
293;12.05.2016;2016;05;01;Torstai;0;0;0;0;0;0
293;12.05.2016;2016;05;02;Torstai;0;0;0;0;0;0
293;12.05.2016;2016;05;03;Torstai;0;0;0;0;0;0
293;12.05.2016;2016;05;04;Torstai;1;0;1;0;0;0
293;12.05.2016;2016;05;05;Torstai;5;1;6;0;0;0
293;12.05.2016;2016;05;06;Torstai;17;4;21;1;0;1
293;12.05.2016;2016;05;07;Torstai;114;11;125;5;0;5
293;12.05.2016;2016;05;08;Torstai;62;15;77;4;4;8
293;12.05.2016;2016;05;09;Torstai;43;11;54;4;2;6
293;12.05.2016;2016;05;10;Torstai;47;12;59;1;2;3
293;12.05.2016;2016;05;11;Torstai;18;16;34;4;4;8
293;12.05.2016;2016;05;12;Torstai;16;14;30;3;0;3
293;12.05.2016;2016;05;13;Torstai;19;41;60;6;4;10
293;12.05.2016;2016;05;14;Torstai;23;92;115;5;5;10
293;12.05.2016;2016;05;15;Torstai;25;98;123;4;5;9
293;12.05.2016;2016;05;16;Torstai;33;28;61;8;4;12
293;12.05.2016;2016;05;17;Torstai;33;34;67;4;9;13
293;12.05.2016;2016;05;18;Torstai;12;30;42;5;2;7
293;12.05.2016;2016;05;19;Torstai;18;33;51;2;2;4
293;12.05.2016;2016;05;20;Torstai;7;25;32;2;4;6
293;12.05.2016;2016;05;21;Torstai;9;8;17;1;1;2
293;12.05.2016;2016;05;22;Torstai;3;5;8;0;1;1
293;12.05.2016;2016;05;23;Torstai;2;0;2;0;0;0
293;13.05.2016;2016;05;00;Perjantai;0;1;1;0;0;0
293;13.05.2016;2016;05;01;Perjantai;0;0;0;0;0;0
293;13.05.2016;2016;05;02;Perjantai;0;0;0;0;0;0
293;13.05.2016;2016;05;03;Perjantai;1;0;1;0;0;0
293;13.05.2016;2016;05;04;Perjantai;0;0;0;0;0;0
293;13.05.2016;2016;05;05;Perjantai;4;0;4;0;0;0
293;13.05.2016;2016;05;06;Perjantai;11;7;18;0;0;0
293;13.05.2016;2016;05;07;Perjantai;89;8;97;2;1;3
293;13.05.2016;2016;05;08;Perjantai;76;19;95;5;1;6
293;13.05.2016;2016;05;09;Perjantai;53;12;65;3;0;3
293;13.05.2016;2016;05;10;Perjantai;14;7;21;2;2;4
293;13.05.2016;2016;05;11;Perjantai;14;15;29;6;6;12
293;13.05.2016;2016;05;12;Perjantai;19;55;74;1;5;6
293;13.05.2016;2016;05;13;Perjantai;18;51;69;5;5;10
293;13.05.2016;2016;05;14;Perjantai;25;78;103;1;7;8
293;13.05.2016;2016;05;15;Perjantai;25;53;78;0;5;5
293;13.05.2016;2016;05;16;Perjantai;24;21;45;4;3;7
293;13.05.2016;2016;05;17;Perjantai;15;18;33;4;6;10
293;13.05.2016;2016;05;18;Perjantai;23;28;51;1;5;6
293;13.05.2016;2016;05;19;Perjantai;15;26;41;13;9;22
293;13.05.2016;2016;05;20;Perjantai;4;18;22;0;3;3
293;13.05.2016;2016;05;21;Perjantai;5;10;15;0;1;1
293;13.05.2016;2016;05;22;Perjantai;14;4;18;1;0;1
293;13.05.2016;2016;05;23;Perjantai;1;4;5;0;0;0
293;14.05.2016;2016;05;00;Lauantai;0;0;0;0;1;1
293;14.05.2016;2016;05;01;Lauantai;1;0;1;0;1;1
293;14.05.2016;2016;05;02;Lauantai;0;0;0;0;1;1
293;14.05.2016;2016;05;03;Lauantai;0;2;2;0;1;1
293;14.05.2016;2016;05;04;Lauantai;0;0;0;0;0;0
293;14.05.2016;2016;05;05;Lauantai;0;0;0;0;0;0
293;14.05.2016;2016;05;06;Lauantai;1;2;3;0;1;1
293;14.05.2016;2016;05;07;Lauantai;1;3;4;0;0;0
293;14.05.2016;2016;05;08;Lauantai;11;5;16;2;2;4
293;14.05.2016;2016;05;09;Lauantai;11;15;26;2;2;4
293;14.05.2016;2016;05;10;Lauantai;16;15;31;6;0;6
293;14.05.2016;2016;05;11;Lauantai;19;18;37;6;4;10
293;14.05.2016;2016;05;12;Lauantai;18;17;35;3;3;6
293;14.05.2016;2016;05;13;Lauantai;16;17;33;2;3;5
293;14.05.2016;2016;05;14;Lauantai;16;10;26;1;2;3
293;14.05.2016;2016;05;15;Lauantai;20;25;45;1;0;1
293;14.05.2016;2016;05;16;Lauantai;17;20;37;4;1;5
293;14.05.2016;2016;05;17;Lauantai;11;17;28;5;7;12
293;14.05.2016;2016;05;18;Lauantai;5;13;18;2;2;4
293;14.05.2016;2016;05;19;Lauantai;14;8;22;1;2;3
293;14.05.2016;2016;05;20;Lauantai;7;8;15;0;3;3
293;14.05.2016;2016;05;21;Lauantai;8;6;14;2;1;3
293;14.05.2016;2016;05;22;Lauantai;9;4;13;1;0;1
293;14.05.2016;2016;05;23;Lauantai;3;6;9;0;0;0
293;15.05.2016;2016;05;00;Sunnuntai;0;4;4;1;2;3
293;15.05.2016;2016;05;01;Sunnuntai;0;1;1;0;0;0
293;15.05.2016;2016;05;02;Sunnuntai;2;0;2;0;0;0
293;15.05.2016;2016;05;03;Sunnuntai;0;0;0;1;0;1
293;15.05.2016;2016;05;04;Sunnuntai;0;0;0;0;0;0
293;15.05.2016;2016;05;05;Sunnuntai;1;1;2;0;0;0
293;15.05.2016;2016;05;06;Sunnuntai;4;1;5;0;0;0
293;15.05.2016;2016;05;07;Sunnuntai;5;4;9;0;0;0
293;15.05.2016;2016;05;08;Sunnuntai;2;1;3;1;3;4
293;15.05.2016;2016;05;09;Sunnuntai;11;1;12;2;1;3
293;15.05.2016;2016;05;10;Sunnuntai;12;10;22;4;3;7
293;15.05.2016;2016;05;11;Sunnuntai;13;20;33;2;9;11
293;15.05.2016;2016;05;12;Sunnuntai;27;15;42;7;4;11
293;15.05.2016;2016;05;13;Sunnuntai;14;23;37;10;5;15
293;15.05.2016;2016;05;14;Sunnuntai;15;18;33;3;10;13
293;15.05.2016;2016;05;15;Sunnuntai;20;28;48;1;3;4
293;15.05.2016;2016;05;16;Sunnuntai;24;25;49;2;3;5
293;15.05.2016;2016;05;17;Sunnuntai;28;20;48;7;5;12
293;15.05.2016;2016;05;18;Sunnuntai;17;22;39;12;2;14
293;15.05.2016;2016;05;19;Sunnuntai;5;10;15;2;4;6
293;15.05.2016;2016;05;20;Sunnuntai;2;6;8;0;1;1
293;15.05.2016;2016;05;21;Sunnuntai;0;1;1;0;0;0
293;15.05.2016;2016;05;22;Sunnuntai;0;0;0;0;0;0
293;15.05.2016;2016;05;23;Sunnuntai;1;2;3;1;1;2
293;16.05.2016;2016;05;00;Maanantai;0;0;0;0;0;0
293;16.05.2016;2016;05;01;Maanantai;0;0;0;0;0;0
293;16.05.2016;2016;05;02;Maanantai;0;0;0;0;0;0
293;16.05.2016;2016;05;03;Maanantai;0;0;0;0;0;0
293;16.05.2016;2016;05;04;Maanantai;0;0;0;0;0;0
293;16.05.2016;2016;05;05;Maanantai;4;0;4;1;0;1
293;16.05.2016;2016;05;06;Maanantai;17;5;22;1;2;3
293;16.05.2016;2016;05;07;Maanantai;77;9;86;2;1;3
293;16.05.2016;2016;05;08;Maanantai;73;22;95;2;1;3
293;16.05.2016;2016;05;09;Maanantai;45;8;53;3;2;5
293;16.05.2016;2016;05;10;Maanantai;21;7;28;3;4;7
293;16.05.2016;2016;05;11;Maanantai;24;13;37;2;2;4
293;16.05.2016;2016;05;12;Maanantai;26;24;50;7;0;7
293;16.05.2016;2016;05;13;Maanantai;26;48;74;2;11;13
293;16.05.2016;2016;05;14;Maanantai;19;92;111;4;7;11
293;16.05.2016;2016;05;15;Maanantai;32;79;111;8;9;17
293;16.05.2016;2016;05;16;Maanantai;36;37;73;8;2;10
293;16.05.2016;2016;05;17;Maanantai;38;38;76;3;6;9
293;16.05.2016;2016;05;18;Maanantai;37;25;62;10;7;17
293;16.05.2016;2016;05;19;Maanantai;32;47;79;5;7;12
293;16.05.2016;2016;05;20;Maanantai;7;22;29;3;4;7
293;16.05.2016;2016;05;21;Maanantai;6;9;15;0;3;3
293;16.05.2016;2016;05;22;Maanantai;1;2;3;1;1;2
293;16.05.2016;2016;05;23;Maanantai;1;1;2;0;0;0
293;17.05.2016;2016;05;00;Tiistai;0;1;1;0;0;0
293;17.05.2016;2016;05;01;Tiistai;0;0;0;0;0;0
293;17.05.2016;2016;05;02;Tiistai;0;0;0;0;0;0
293;17.05.2016;2016;05;03;Tiistai;0;1;1;0;0;0
293;17.05.2016;2016;05;04;Tiistai;1;0;1;0;0;0
293;17.05.2016;2016;05;05;Tiistai;6;0;6;0;0;0
293;17.05.2016;2016;05;06;Tiistai;9;1;10;1;0;1
293;17.05.2016;2016;05;07;Tiistai;73;5;78;4;2;6
293;17.05.2016;2016;05;08;Tiistai;40;7;47;1;0;1
293;17.05.2016;2016;05;09;Tiistai;23;6;29;3;0;3
293;17.05.2016;2016;05;10;Tiistai;19;3;22;6;2;8
293;17.05.2016;2016;05;11;Tiistai;4;2;6;1;3;4
293;17.05.2016;2016;05;12;Tiistai;5;9;14;2;1;3
293;17.05.2016;2016;05;13;Tiistai;5;23;28;0;3;3
293;17.05.2016;2016;05;14;Tiistai;15;70;85;2;11;13
293;17.05.2016;2016;05;15;Tiistai;13;58;71;1;7;8
293;17.05.2016;2016;05;16;Tiistai;15;26;41;3;4;7
293;17.05.2016;2016;05;17;Tiistai;13;19;32;3;1;4
293;17.05.2016;2016;05;18;Tiistai;27;35;62;7;4;11
293;17.05.2016;2016;05;19;Tiistai;14;21;35;6;6;12
293;17.05.2016;2016;05;20;Tiistai;9;14;23;1;4;5
293;17.05.2016;2016;05;21;Tiistai;3;8;11;1;3;4
293;17.05.2016;2016;05;22;Tiistai;1;1;2;0;0;0
293;17.05.2016;2016;05;23;Tiistai;0;0;0;0;1;1
293;18.05.2016;2016;05;00;Keskiviikko;0;0;0;0;0;0
293;18.05.2016;2016;05;01;Keskiviikko;0;0;0;0;0;0
293;18.05.2016;2016;05;02;Keskiviikko;0;1;1;0;0;0
293;18.05.2016;2016;05;03;Keskiviikko;0;0;0;0;0;0
293;18.05.2016;2016;05;04;Keskiviikko;1;0;1;0;0;0
293;18.05.2016;2016;05;05;Keskiviikko;7;0;7;0;0;0
293;18.05.2016;2016;05;06;Keskiviikko;17;4;21;1;0;1
293;18.05.2016;2016;05;07;Keskiviikko;108;8;116;7;2;9
293;18.05.2016;2016;05;08;Keskiviikko;65;19;84;4;13;17
293;18.05.2016;2016;05;09;Keskiviikko;28;15;43;5;1;6
293;18.05.2016;2016;05;10;Keskiviikko;31;15;46;5;2;7
293;18.05.2016;2016;05;11;Keskiviikko;19;17;36;5;2;7
293;18.05.2016;2016;05;12;Keskiviikko;14;47;61;2;2;4
293;18.05.2016;2016;05;13;Keskiviikko;22;42;64;4;5;9
293;18.05.2016;2016;05;14;Keskiviikko;17;110;127;4;7;11
293;18.05.2016;2016;05;15;Keskiviikko;13;33;46;0;4;4
293;18.05.2016;2016;05;16;Keskiviikko;13;18;31;0;1;1
293;18.05.2016;2016;05;17;Keskiviikko;10;9;19;1;0;1
293;18.05.2016;2016;05;18;Keskiviikko;4;15;19;3;2;5
293;18.05.2016;2016;05;19;Keskiviikko;4;6;10;0;1;1
293;18.05.2016;2016;05;20;Keskiviikko;1;5;6;2;2;4
293;18.05.2016;2016;05;21;Keskiviikko;1;5;6;0;1;1
293;18.05.2016;2016;05;22;Keskiviikko;0;0;0;0;0;0
293;18.05.2016;2016;05;23;Keskiviikko;0;0;0;0;1;1
293;19.05.2016;2016;05;00;Torstai;0;0;0;0;0;0
293;19.05.2016;2016;05;01;Torstai;0;0;0;0;0;0
293;19.05.2016;2016;05;02;Torstai;0;0;0;0;0;0
293;19.05.2016;2016;05;03;Torstai;2;0;2;0;0;0
293;19.05.2016;2016;05;04;Torstai;0;1;1;0;0;0
293;19.05.2016;2016;05;05;Torstai;2;0;2;0;0;0
293;19.05.2016;2016;05;06;Torstai;14;2;16;0;0;0
293;19.05.2016;2016;05;07;Torstai;82;6;88;3;0;3
293;19.05.2016;2016;05;08;Torstai;60;5;65;3;0;3
293;19.05.2016;2016;05;09;Torstai;32;7;39;2;2;4
293;19.05.2016;2016;05;10;Torstai;9;4;13;4;5;9
293;19.05.2016;2016;05;11;Torstai;4;5;9;4;0;4
293;19.05.2016;2016;05;12;Torstai;5;8;13;4;3;7
293;19.05.2016;2016;05;13;Torstai;11;30;41;1;3;4
293;19.05.2016;2016;05;14;Torstai;18;85;103;6;7;13
293;19.05.2016;2016;05;15;Torstai;16;60;76;2;5;7
293;19.05.2016;2016;05;16;Torstai;18;37;55;2;0;2
293;19.05.2016;2016;05;17;Torstai;6;13;19;6;2;8
293;19.05.2016;2016;05;18;Torstai;13;14;27;3;3;6
293;19.05.2016;2016;05;19;Torstai;10;10;20;4;4;8
293;19.05.2016;2016;05;20;Torstai;2;12;14;1;4;5
293;19.05.2016;2016;05;21;Torstai;2;4;6;0;1;1
293;19.05.2016;2016;05;22;Torstai;0;0;0;0;1;1
293;19.05.2016;2016;05;23;Torstai;0;0;0;0;0;0
293;20.05.2016;2016;05;00;Perjantai;0;0;0;0;0;0
293;20.05.2016;2016;05;01;Perjantai;0;1;1;0;0;0
293;20.05.2016;2016;05;02;Perjantai;0;0;0;0;0;0
293;20.05.2016;2016;05;03;Perjantai;1;0;1;0;0;0
293;20.05.2016;2016;05;04;Perjantai;0;1;1;0;0;0
293;20.05.2016;2016;05;05;Perjantai;4;0;4;1;0;1
293;20.05.2016;2016;05;06;Perjantai;15;2;17;1;0;1
293;20.05.2016;2016;05;07;Perjantai;86;8;94;6;1;7
293;20.05.2016;2016;05;08;Perjantai;69;15;84;6;2;8
293;20.05.2016;2016;05;09;Perjantai;42;29;71;3;2;5
293;20.05.2016;2016;05;10;Perjantai;15;20;35;4;3;7
293;20.05.2016;2016;05;11;Perjantai;19;54;73;7;6;13
293;20.05.2016;2016;05;12;Perjantai;25;94;119;3;8;11
293;20.05.2016;2016;05;13;Perjantai;30;40;70;9;5;14
293;20.05.2016;2016;05;14;Perjantai;21;44;65;7;2;9
293;20.05.2016;2016;05;15;Perjantai;24;28;52;1;5;6
293;20.05.2016;2016;05;16;Perjantai;30;31;61;3;4;7
293;20.05.2016;2016;05;17;Perjantai;30;16;46;5;1;6
293;20.05.2016;2016;05;18;Perjantai;24;29;53;5;6;11
293;20.05.2016;2016;05;19;Perjantai;21;45;66;1;6;7
293;20.05.2016;2016;05;20;Perjantai;30;32;62;8;4;12
293;20.05.2016;2016;05;21;Perjantai;15;24;39;2;3;5
293;20.05.2016;2016;05;22;Perjantai;3;17;20;1;1;2
293;20.05.2016;2016;05;23;Perjantai;5;1;6;2;1;3
293;21.05.2016;2016;05;00;Lauantai;1;6;7;0;0;0
293;21.05.2016;2016;05;01;Lauantai;1;0;1;0;0;0
293;21.05.2016;2016;05;02;Lauantai;0;3;3;0;1;1
293;21.05.2016;2016;05;03;Lauantai;0;0;0;0;0;0
293;21.05.2016;2016;05;04;Lauantai;1;0;1;0;0;0
293;21.05.2016;2016;05;05;Lauantai;0;2;2;0;0;0
293;21.05.2016;2016;05;06;Lauantai;2;1;3;1;0;1
293;21.05.2016;2016;05;07;Lauantai;4;4;8;0;1;1
293;21.05.2016;2016;05;08;Lauantai;12;9;21;2;3;5
293;21.05.2016;2016;05;09;Lauantai;17;16;33;2;3;5
293;21.05.2016;2016;05;10;Lauantai;19;14;33;8;2;10
293;21.05.2016;2016;05;11;Lauantai;31;37;68;5;6;11
293;21.05.2016;2016;05;12;Lauantai;30;26;56;8;5;13
293;21.05.2016;2016;05;13;Lauantai;39;43;82;9;3;12
293;21.05.2016;2016;05;14;Lauantai;24;18;42;9;2;11
293;21.05.2016;2016;05;15;Lauantai;27;23;50;1;8;9
293;21.05.2016;2016;05;16;Lauantai;16;26;42;0;2;2
293;21.05.2016;2016;05;17;Lauantai;21;21;42;3;3;6
293;21.05.2016;2016;05;18;Lauantai;15;23;38;2;8;10
293;21.05.2016;2016;05;19;Lauantai;30;15;45;4;4;8
293;21.05.2016;2016;05;20;Lauantai;12;12;24;1;0;1
293;21.05.2016;2016;05;21;Lauantai;4;4;8;2;1;3
293;21.05.2016;2016;05;22;Lauantai;6;4;10;0;2;2
293;21.05.2016;2016;05;23;Lauantai;2;0;2;0;0;0
293;22.05.2016;2016;05;00;Sunnuntai;1;2;3;0;0;0
293;22.05.2016;2016;05;01;Sunnuntai;1;0;1;5;1;6
293;22.05.2016;2016;05;02;Sunnuntai;1;4;5;0;1;1
293;22.05.2016;2016;05;03;Sunnuntai;0;1;1;0;2;2
293;22.05.2016;2016;05;04;Sunnuntai;0;1;1;0;0;0
293;22.05.2016;2016;05;05;Sunnuntai;0;0;0;0;1;1
293;22.05.2016;2016;05;06;Sunnuntai;0;1;1;1;0;1
293;22.05.2016;2016;05;07;Sunnuntai;0;2;2;1;0;1
293;22.05.2016;2016;05;08;Sunnuntai;1;4;5;1;1;2
293;22.05.2016;2016;05;09;Sunnuntai;6;3;9;3;0;3
293;22.05.2016;2016;05;10;Sunnuntai;10;8;18;4;4;8
293;22.05.2016;2016;05;11;Sunnuntai;13;10;23;7;6;13
293;22.05.2016;2016;05;12;Sunnuntai;33;17;50;4;11;15
293;22.05.2016;2016;05;13;Sunnuntai;30;32;62;2;6;8
293;22.05.2016;2016;05;14;Sunnuntai;40;43;83;8;10;18
293;22.05.2016;2016;05;15;Sunnuntai;45;45;90;6;1;7
293;22.05.2016;2016;05;16;Sunnuntai;61;43;104;15;4;19
293;22.05.2016;2016;05;17;Sunnuntai;39;50;89;4;5;9
293;22.05.2016;2016;05;18;Sunnuntai;32;26;58;9;8;17
293;22.05.2016;2016;05;19;Sunnuntai;26;27;53;4;5;9
293;22.05.2016;2016;05;20;Sunnuntai;16;20;36;1;3;4
293;22.05.2016;2016;05;21;Sunnuntai;0;5;5;0;1;1
293;22.05.2016;2016;05;22;Sunnuntai;3;2;5;0;0;0
293;22.05.2016;2016;05;23;Sunnuntai;0;5;5;0;3;3
293;23.05.2016;2016;05;00;Maanantai;1;0;1;0;0;0
293;23.05.2016;2016;05;01;Maanantai;0;0;0;0;0;0
293;23.05.2016;2016;05;02;Maanantai;0;0;0;0;0;0
293;23.05.2016;2016;05;03;Maanantai;0;2;2;0;0;0
293;23.05.2016;2016;05;04;Maanantai;1;0;1;0;0;0
293;23.05.2016;2016;05;05;Maanantai;6;1;7;1;0;1
293;23.05.2016;2016;05;06;Maanantai;22;8;30;0;1;1
293;23.05.2016;2016;05;07;Maanantai;77;8;85;4;1;5
293;23.05.2016;2016;05;08;Maanantai;86;17;103;9;0;9
293;23.05.2016;2016;05;09;Maanantai;67;15;82;8;7;15
293;23.05.2016;2016;05;10;Maanantai;25;23;48;10;4;14
293;23.05.2016;2016;05;11;Maanantai;22;10;32;3;7;10
293;23.05.2016;2016;05;12;Maanantai;22;32;54;1;2;3
293;23.05.2016;2016;05;13;Maanantai;19;60;79;7;10;17
293;23.05.2016;2016;05;14;Maanantai;30;67;97;9;8;17
293;23.05.2016;2016;05;15;Maanantai;26;107;133;6;9;15
293;23.05.2016;2016;05;16;Maanantai;29;44;73;6;9;15
293;23.05.2016;2016;05;17;Maanantai;36;39;75;8;3;11
293;23.05.2016;2016;05;18;Maanantai;52;48;100;7;9;16
293;23.05.2016;2016;05;19;Maanantai;28;46;74;5;9;14
293;23.05.2016;2016;05;20;Maanantai;16;32;48;3;2;5
293;23.05.2016;2016;05;21;Maanantai;5;9;14;0;1;1
293;23.05.2016;2016;05;22;Maanantai;1;3;4;0;0;0
293;23.05.2016;2016;05;23;Maanantai;1;0;1;0;0;0
293;24.05.2016;2016;05;00;Tiistai;0;0;0;0;0;0
293;24.05.2016;2016;05;01;Tiistai;0;1;1;0;0;0
293;24.05.2016;2016;05;02;Tiistai;0;0;0;0;0;0
293;24.05.2016;2016;05;03;Tiistai;1;1;2;0;0;0
293;24.05.2016;2016;05;04;Tiistai;2;0;2;0;0;0
293;24.05.2016;2016;05;05;Tiistai;7;1;8;0;0;0
293;24.05.2016;2016;05;06;Tiistai;17;4;21;1;1;2
293;24.05.2016;2016;05;07;Tiistai;100;10;110;6;0;6
293;24.05.2016;2016;05;08;Tiistai;78;21;99;8;1;9
293;24.05.2016;2016;05;09;Tiistai;32;20;52;3;4;7
293;24.05.2016;2016;05;10;Tiistai;32;16;48;5;2;7
293;24.05.2016;2016;05;11;Tiistai;22;18;40;5;4;9
293;24.05.2016;2016;05;12;Tiistai;17;20;37;7;5;12
293;24.05.2016;2016;05;13;Tiistai;15;39;54;4;2;6
293;24.05.2016;2016;05;14;Tiistai;19;123;142;3;4;7
293;24.05.2016;2016;05;15;Tiistai;16;43;59;0;3;3
293;24.05.2016;2016;05;16;Tiistai;6;22;28;3;0;3
293;24.05.2016;2016;05;17;Tiistai;10;16;26;0;2;2
293;24.05.2016;2016;05;18;Tiistai;14;14;28;5;5;10
293;24.05.2016;2016;05;19;Tiistai;6;12;18;2;3;5
293;24.05.2016;2016;05;20;Tiistai;4;6;10;2;1;3
293;24.05.2016;2016;05;21;Tiistai;0;6;6;0;0;0
293;24.05.2016;2016;05;22;Tiistai;2;1;3;1;1;2
293;24.05.2016;2016;05;23;Tiistai;1;1;2;0;0;0
293;25.05.2016;2016;05;00;Keskiviikko;0;0;0;0;0;0
293;25.05.2016;2016;05;01;Keskiviikko;0;0;0;0;0;0
293;25.05.2016;2016;05;02;Keskiviikko;0;1;1;0;0;0
293;25.05.2016;2016;05;03;Keskiviikko;1;1;2;0;0;0
293;25.05.2016;2016;05;04;Keskiviikko;1;0;1;0;0;0
293;25.05.2016;2016;05;05;Keskiviikko;6;2;8;0;0;0
293;25.05.2016;2016;05;06;Keskiviikko;11;2;13;1;1;2
293;25.05.2016;2016;05;07;Keskiviikko;48;9;57;6;2;8
293;25.05.2016;2016;05;08;Keskiviikko;103;12;115;4;3;7
293;25.05.2016;2016;05;09;Keskiviikko;26;9;35;2;2;4
293;25.05.2016;2016;05;10;Keskiviikko;19;12;31;3;1;4
293;25.05.2016;2016;05;11;Keskiviikko;7;11;18;2;1;3
293;25.05.2016;2016;05;12;Keskiviikko;18;38;56;3;3;6
293;25.05.2016;2016;05;13;Keskiviikko;15;27;42;0;2;2
293;25.05.2016;2016;05;14;Keskiviikko;16;82;98;2;4;6
293;25.05.2016;2016;05;15;Keskiviikko;19;29;48;1;3;4
293;25.05.2016;2016;05;16;Keskiviikko;18;26;44;1;2;3
293;25.05.2016;2016;05;17;Keskiviikko;17;25;42;4;3;7
293;25.05.2016;2016;05;18;Keskiviikko;12;20;32;4;4;8
293;25.05.2016;2016;05;19;Keskiviikko;22;18;40;5;7;12
293;25.05.2016;2016;05;20;Keskiviikko;9;23;32;4;6;10
293;25.05.2016;2016;05;21;Keskiviikko;3;4;7;3;3;6
293;25.05.2016;2016;05;22;Keskiviikko;2;6;8;1;0;1
293;25.05.2016;2016;05;23;Keskiviikko;0;1;1;0;0;0
293;26.05.2016;2016;05;00;Torstai;0;0;0;0;0;0
293;26.05.2016;2016;05;01;Torstai;0;0;0;0;0;0
293;26.05.2016;2016;05;02;Torstai;0;0;0;0;0;0
293;26.05.2016;2016;05;03;Torstai;1;1;2;0;0;0
293;26.05.2016;2016;05;04;Torstai;1;0;1;0;0;0
293;26.05.2016;2016;05;05;Torstai;7;0;7;1;0;1
293;26.05.2016;2016;05;06;Torstai;20;2;22;1;2;3
293;26.05.2016;2016;05;07;Torstai;91;12;103;7;1;8
293;26.05.2016;2016;05;08;Torstai;78;11;89;5;0;5
293;26.05.2016;2016;05;09;Torstai;47;20;67;2;1;3
293;26.05.2016;2016;05;10;Torstai;19;26;45;3;3;6
293;26.05.2016;2016;05;11;Torstai;8;23;31;3;5;8
293;26.05.2016;2016;05;12;Torstai;19;21;40;7;3;10
293;26.05.2016;2016;05;13;Torstai;14;40;54;3;7;10
293;26.05.2016;2016;05;14;Torstai;28;100;128;0;7;7
293;26.05.2016;2016;05;15;Torstai;28;57;85;4;3;7
293;26.05.2016;2016;05;16;Torstai;29;35;64;9;3;12
293;26.05.2016;2016;05;17;Torstai;17;28;45;4;4;8
293;26.05.2016;2016;05;18;Torstai;35;42;77;8;11;19
293;26.05.2016;2016;05;19;Torstai;19;15;34;2;5;7
293;26.05.2016;2016;05;20;Torstai;14;20;34;5;6;11
293;26.05.2016;2016;05;21;Torstai;8;10;18;2;1;3
293;26.05.2016;2016;05;22;Torstai;6;6;12;1;2;3
293;26.05.2016;2016;05;23;Torstai;0;2;2;2;0;2
293;27.05.2016;2016;05;00;Perjantai;2;0;2;0;2;2
293;27.05.2016;2016;05;01;Perjantai;0;0;0;0;0;0
293;27.05.2016;2016;05;02;Perjantai;1;1;2;0;1;1
293;27.05.2016;2016;05;03;Perjantai;0;1;1;0;0;0
293;27.05.2016;2016;05;04;Perjantai;1;0;1;0;0;0
293;27.05.2016;2016;05;05;Perjantai;4;0;4;1;0;1
293;27.05.2016;2016;05;06;Perjantai;19;2;21;1;1;2
293;27.05.2016;2016;05;07;Perjantai;69;18;87;4;2;6
293;27.05.2016;2016;05;08;Perjantai;85;22;107;5;1;6
293;27.05.2016;2016;05;09;Perjantai;41;8;49;4;2;6
293;27.05.2016;2016;05;10;Perjantai;24;17;41;10;1;11
293;27.05.2016;2016;05;11;Perjantai;26;37;63;1;7;8
293;27.05.2016;2016;05;12;Perjantai;18;38;56;4;5;9
293;27.05.2016;2016;05;13;Perjantai;37;40;77;2;5;7
293;27.05.2016;2016;05;14;Perjantai;27;71;98;4;9;13
293;27.05.2016;2016;05;15;Perjantai;27;73;100;3;5;8
293;27.05.2016;2016;05;16;Perjantai;34;43;77;4;5;9
293;27.05.2016;2016;05;17;Perjantai;51;59;110;15;13;28
293;27.05.2016;2016;05;18;Perjantai;32;42;74;8;7;15
293;27.05.2016;2016;05;19;Perjantai;32;25;57;11;4;15
293;27.05.2016;2016;05;20;Perjantai;24;42;66;14;7;21
293;27.05.2016;2016;05;21;Perjantai;15;28;43;4;1;5
293;27.05.2016;2016;05;22;Perjantai;15;4;19;0;3;3
293;27.05.2016;2016;05;23;Perjantai;3;5;8;2;2;4
293;28.05.2016;2016;05;00;Lauantai;8;11;19;3;4;7
293;28.05.2016;2016;05;01;Lauantai;0;2;2;0;0;0
293;28.05.2016;2016;05;02;Lauantai;1;0;1;1;0;1
293;28.05.2016;2016;05;03;Lauantai;0;1;1;0;3;3
293;28.05.2016;2016;05;04;Lauantai;2;3;5;0;1;1
293;28.05.2016;2016;05;05;Lauantai;3;2;5;0;0;0
293;28.05.2016;2016;05;06;Lauantai;1;1;2;0;0;0
293;28.05.2016;2016;05;07;Lauantai;6;5;11;0;2;2
293;28.05.2016;2016;05;08;Lauantai;19;6;25;5;1;6
293;28.05.2016;2016;05;09;Lauantai;20;10;30;3;2;5
293;28.05.2016;2016;05;10;Lauantai;14;18;32;3;6;9
293;28.05.2016;2016;05;11;Lauantai;33;29;62;4;4;8
293;28.05.2016;2016;05;12;Lauantai;33;28;61;5;3;8
293;28.05.2016;2016;05;13;Lauantai;18;29;47;4;3;7
293;28.05.2016;2016;05;14;Lauantai;48;47;95;3;12;15
293;28.05.2016;2016;05;15;Lauantai;36;44;80;6;8;14
293;28.05.2016;2016;05;16;Lauantai;28;32;60;13;3;16
293;28.05.2016;2016;05;17;Lauantai;39;28;67;6;5;11
293;28.05.2016;2016;05;18;Lauantai;25;34;59;6;9;15
293;28.05.2016;2016;05;19;Lauantai;28;32;60;7;10;17
293;28.05.2016;2016;05;20;Lauantai;31;36;67;6;3;9
293;28.05.2016;2016;05;21;Lauantai;19;15;34;5;1;6
293;28.05.2016;2016;05;22;Lauantai;14;21;35;4;2;6
293;28.05.2016;2016;05;23;Lauantai;7;2;9;7;3;10
293;29.05.2016;2016;05;00;Sunnuntai;7;2;9;8;1;9
293;29.05.2016;2016;05;01;Sunnuntai;3;5;8;7;0;7
293;29.05.2016;2016;05;02;Sunnuntai;2;8;10;0;2;2
293;29.05.2016;2016;05;03;Sunnuntai;0;1;1;0;3;3
293;29.05.2016;2016;05;04;Sunnuntai;0;0;0;0;2;2
293;29.05.2016;2016;05;05;Sunnuntai;3;4;7;0;1;1
293;29.05.2016;2016;05;06;Sunnuntai;6;3;9;0;0;0
293;29.05.2016;2016;05;07;Sunnuntai;4;5;9;1;1;2
293;29.05.2016;2016;05;08;Sunnuntai;6;9;15;2;4;6
293;29.05.2016;2016;05;09;Sunnuntai;13;9;22;3;4;7
293;29.05.2016;2016;05;10;Sunnuntai;27;19;46;7;3;10
293;29.05.2016;2016;05;11;Sunnuntai;43;38;81;2;7;9
293;29.05.2016;2016;05;12;Sunnuntai;40;40;80;8;11;19
293;29.05.2016;2016;05;13;Sunnuntai;51;36;87;18;8;26
293;29.05.2016;2016;05;14;Sunnuntai;34;39;73;8;7;15
293;29.05.2016;2016;05;15;Sunnuntai;47;52;99;6;4;10
293;29.05.2016;2016;05;16;Sunnuntai;37;52;89;3;3;6
293;29.05.2016;2016;05;17;Sunnuntai;57;52;109;7;4;11
293;29.05.2016;2016;05;18;Sunnuntai;49;46;95;12;10;22
293;29.05.2016;2016;05;19;Sunnuntai;33;45;78;5;7;12
293;29.05.2016;2016;05;20;Sunnuntai;26;22;48;3;3;6
293;29.05.2016;2016;05;21;Sunnuntai;11;17;28;1;1;2
293;29.05.2016;2016;05;22;Sunnuntai;3;3;6;1;1;2
293;29.05.2016;2016;05;23;Sunnuntai;0;2;2;0;0;0
293;30.05.2016;2016;05;00;Maanantai;0;0;0;0;0;0
293;30.05.2016;2016;05;01;Maanantai;0;0;0;0;1;1
293;30.05.2016;2016;05;02;Maanantai;0;1;1;1;0;1
293;30.05.2016;2016;05;03;Maanantai;0;1;1;0;0;0
293;30.05.2016;2016;05;04;Maanantai;2;0;2;0;0;0
293;30.05.2016;2016;05;05;Maanantai;7;1;8;0;0;0
293;30.05.2016;2016;05;06;Maanantai;24;4;28;5;0;5
293;30.05.2016;2016;05;07;Maanantai;68;13;81;4;0;4
293;30.05.2016;2016;05;08;Maanantai;109;27;136;5;2;7
293;30.05.2016;2016;05;09;Maanantai;103;23;126;9;2;11
293;30.05.2016;2016;05;10;Maanantai;25;20;45;2;3;5
293;30.05.2016;2016;05;11;Maanantai;37;30;67;6;5;11
293;30.05.2016;2016;05;12;Maanantai;19;27;46;3;4;7
293;30.05.2016;2016;05;13;Maanantai;26;88;114;6;10;16
293;30.05.2016;2016;05;14;Maanantai;36;111;147;4;12;16
293;30.05.2016;2016;05;15;Maanantai;45;78;123;7;7;14
293;30.05.2016;2016;05;16;Maanantai;55;67;122;10;8;18
293;30.05.2016;2016;05;17;Maanantai;54;66;120;9;10;19
293;30.05.2016;2016;05;18;Maanantai;54;57;111;10;14;24
293;30.05.2016;2016;05;19;Maanantai;66;66;132;4;5;9
293;30.05.2016;2016;05;20;Maanantai;17;27;44;2;4;6
293;30.05.2016;2016;05;21;Maanantai;5;19;24;3;4;7
293;30.05.2016;2016;05;22;Maanantai;1;2;3;1;1;2
293;30.05.2016;2016;05;23;Maanantai;5;0;5;0;1;1
293;31.05.2016;2016;05;00;Tiistai;2;1;3;0;0;0
293;31.05.2016;2016;05;01;Tiistai;0;2;2;0;0;0
293;31.05.2016;2016;05;02;Tiistai;0;0;0;0;0;0
293;31.05.2016;2016;05;03;Tiistai;1;0;1;0;0;0
293;31.05.2016;2016;05;04;Tiistai;0;0;0;0;0;0
293;31.05.2016;2016;05;05;Tiistai;3;1;4;0;0;0
293;31.05.2016;2016;05;06;Tiistai;19;6;25;0;0;0
293;31.05.2016;2016;05;07;Tiistai;83;4;87;4;2;6
293;31.05.2016;2016;05;08;Tiistai;121;23;144;15;3;18
293;31.05.2016;2016;05;09;Tiistai;51;17;68;6;2;8
293;31.05.2016;2016;05;10;Tiistai;52;62;114;3;5;8
293;31.05.2016;2016;05;11;Tiistai;16;32;48;4;3;7
293;31.05.2016;2016;05;12;Tiistai;39;56;95;4;8;12
293;31.05.2016;2016;05;13;Tiistai;32;63;95;6;10;16
293;31.05.2016;2016;05;14;Tiistai;41;155;196;7;11;18
293;31.05.2016;2016;05;15;Tiistai;52;79;131;11;9;20
293;31.05.2016;2016;05;16;Tiistai;67;75;142;9;12;21
293;31.05.2016;2016;05;17;Tiistai;60;72;132;7;9;16
293;31.05.2016;2016;05;18;Tiistai;51;61;112;10;9;19
293;31.05.2016;2016;05;19;Tiistai;47;54;101;6;6;12
293;31.05.2016;2016;05;20;Tiistai;32;30;62;6;2;8
293;31.05.2016;2016;05;21;Tiistai;12;14;26;2;1;3
293;31.05.2016;2016;05;22;Tiistai;1;4;5;1;2;3
293;31.05.2016;2016;05;23;Tiistai;0;0;0;0;0;0
293;01.06.2016;2016;06;00;Keskiviikko;1;0;1;1;1;2
293;01.06.2016;2016;06;01;Keskiviikko;0;2;2;0;0;0
293;01.06.2016;2016;06;02;Keskiviikko;0;0;0;0;0;0
293;01.06.2016;2016;06;03;Keskiviikko;1;0;1;0;0;0
293;01.06.2016;2016;06;04;Keskiviikko;0;0;0;0;1;1
293;01.06.2016;2016;06;05;Keskiviikko;5;0;5;0;0;0
293;01.06.2016;2016;06;06;Keskiviikko;21;5;26;0;1;1
293;01.06.2016;2016;06;07;Keskiviikko;88;5;93;4;2;6
293;01.06.2016;2016;06;08;Keskiviikko;99;24;123;7;2;9
293;01.06.2016;2016;06;09;Keskiviikko;27;9;36;2;0;2
293;01.06.2016;2016;06;10;Keskiviikko;11;4;15;0;0;0
293;01.06.2016;2016;06;11;Keskiviikko;8;12;20;2;1;3
293;01.06.2016;2016;06;12;Keskiviikko;15;40;55;4;1;5
293;01.06.2016;2016;06;13;Keskiviikko;19;124;143;2;6;8
293;01.06.2016;2016;06;14;Keskiviikko;33;40;73;3;5;8
293;01.06.2016;2016;06;15;Keskiviikko;18;50;68;5;6;11
293;01.06.2016;2016;06;16;Keskiviikko;48;51;99;9;8;17
293;01.06.2016;2016;06;17;Keskiviikko;36;51;87;9;11;20
293;01.06.2016;2016;06;18;Keskiviikko;37;41;78;8;15;23
293;01.06.2016;2016;06;19;Keskiviikko;45;45;90;8;14;22
293;01.06.2016;2016;06;20;Keskiviikko;25;33;58;4;4;8
293;01.06.2016;2016;06;21;Keskiviikko;15;10;25;4;4;8
293;01.06.2016;2016;06;22;Keskiviikko;6;6;12;1;0;1
293;01.06.2016;2016;06;23;Keskiviikko;0;3;3;1;1;2
293;02.06.2016;2016;06;00;Torstai;0;0;0;0;0;0
293;02.06.2016;2016;06;01;Torstai;1;1;2;0;0;0
293;02.06.2016;2016;06;02;Torstai;0;2;2;0;0;0
293;02.06.2016;2016;06;03;Torstai;1;0;1;0;0;0
293;02.06.2016;2016;06;04;Torstai;0;0;0;0;0;0
293;02.06.2016;2016;06;05;Torstai;6;1;7;0;0;0
293;02.06.2016;2016;06;06;Torstai;18;4;22;2;0;2
293;02.06.2016;2016;06;07;Torstai;45;12;57;3;0;3
293;02.06.2016;2016;06;08;Torstai;117;18;135;9;3;12
293;02.06.2016;2016;06;09;Torstai;37;20;57;2;33;35
293;02.06.2016;2016;06;10;Torstai;30;21;51;37;6;43
293;02.06.2016;2016;06;11;Torstai;14;32;46;1;3;4
293;02.06.2016;2016;06;12;Torstai;27;27;54;2;7;9
293;02.06.2016;2016;06;13;Torstai;33;156;189;7;21;28
293;02.06.2016;2016;06;14;Torstai;51;59;110;15;10;25
293;02.06.2016;2016;06;15;Torstai;59;49;108;19;19;38
293;02.06.2016;2016;06;16;Torstai;36;46;82;7;10;17
293;02.06.2016;2016;06;17;Torstai;53;62;115;5;2;7
293;02.06.2016;2016;06;18;Torstai;38;46;84;9;16;25
293;02.06.2016;2016;06;19;Torstai;53;57;110;14;16;30
293;02.06.2016;2016;06;20;Torstai;43;33;76;11;3;14
293;02.06.2016;2016;06;21;Torstai;19;26;45;1;5;6
293;02.06.2016;2016;06;22;Torstai;10;9;19;5;1;6
293;02.06.2016;2016;06;23;Torstai;2;0;2;1;0;1
293;03.06.2016;2016;06;00;Perjantai;0;1;1;0;1;1
293;03.06.2016;2016;06;01;Perjantai;0;3;3;1;0;1
293;03.06.2016;2016;06;02;Perjantai;0;0;0;0;1;1
293;03.06.2016;2016;06;03;Perjantai;1;0;1;0;0;0
293;03.06.2016;2016;06;04;Perjantai;1;0;1;0;0;0
293;03.06.2016;2016;06;05;Perjantai;0;0;0;1;0;1
293;03.06.2016;2016;06;06;Perjantai;3;1;4;0;0;0
293;03.06.2016;2016;06;07;Perjantai;63;5;68;7;0;7
293;03.06.2016;2016;06;08;Perjantai;143;9;152;12;3;15
293;03.06.2016;2016;06;09;Perjantai;65;78;143;8;8;16
293;03.06.2016;2016;06;10;Perjantai;16;7;23;2;2;4
293;03.06.2016;2016;06;11;Perjantai;12;57;69;0;4;4
293;03.06.2016;2016;06;12;Perjantai;18;74;92;0;5;5
293;03.06.2016;2016;06;13;Perjantai;31;86;117;5;4;9
293;03.06.2016;2016;06;14;Perjantai;40;30;70;10;6;16
293;03.06.2016;2016;06;15;Perjantai;33;42;75;8;4;12
293;03.06.2016;2016;06;16;Perjantai;29;37;66;10;8;18
293;03.06.2016;2016;06;17;Perjantai;22;33;55;2;7;9
293;03.06.2016;2016;06;18;Perjantai;27;27;54;2;6;8
293;03.06.2016;2016;06;19;Perjantai;22;25;47;3;0;3
293;03.06.2016;2016;06;20;Perjantai;13;15;28;5;2;7
293;03.06.2016;2016;06;21;Perjantai;5;7;12;1;1;2
293;03.06.2016;2016;06;22;Perjantai;2;3;5;2;1;3
293;03.06.2016;2016;06;23;Perjantai;4;1;5;0;0;0
293;04.06.2016;2016;06;00;Lauantai;1;4;5;0;2;2
293;04.06.2016;2016;06;01;Lauantai;2;2;4;0;2;2
293;04.06.2016;2016;06;02;Lauantai;0;1;1;0;1;1
293;04.06.2016;2016;06;03;Lauantai;0;1;1;0;3;3
293;04.06.2016;2016;06;04;Lauantai;1;1;2;0;0;0
293;04.06.2016;2016;06;05;Lauantai;1;1;2;0;0;0
293;04.06.2016;2016;06;06;Lauantai;4;1;5;0;0;0
293;04.06.2016;2016;06;07;Lauantai;31;3;34;2;0;2
293;04.06.2016;2016;06;08;Lauantai;57;15;72;5;4;9
293;04.06.2016;2016;06;09;Lauantai;11;51;62;3;3;6
293;04.06.2016;2016;06;10;Lauantai;17;27;44;2;6;8
293;04.06.2016;2016;06;11;Lauantai;16;15;31;4;4;8
293;04.06.2016;2016;06;12;Lauantai;30;8;38;3;2;5
293;04.06.2016;2016;06;13;Lauantai;16;26;42;3;4;7
293;04.06.2016;2016;06;14;Lauantai;10;29;39;9;8;17
293;04.06.2016;2016;06;15;Lauantai;14;26;40;8;12;20
293;04.06.2016;2016;06;16;Lauantai;26;15;41;1;3;4
293;04.06.2016;2016;06;17;Lauantai;29;35;64;2;4;6
293;04.06.2016;2016;06;18;Lauantai;23;23;46;2;2;4
293;04.06.2016;2016;06;19;Lauantai;19;23;42;4;2;6
293;04.06.2016;2016;06;20;Lauantai;13;10;23;0;2;2
293;04.06.2016;2016;06;21;Lauantai;1;16;17;2;5;7
293;04.06.2016;2016;06;22;Lauantai;17;12;29;0;2;2
293;04.06.2016;2016;06;23;Lauantai;2;2;4;1;1;2
293;05.06.2016;2016;06;00;Sunnuntai;7;5;12;0;1;1
293;05.06.2016;2016;06;01;Sunnuntai;9;3;12;10;4;14
293;05.06.2016;2016;06;02;Sunnuntai;2;5;7;4;1;5
293;05.06.2016;2016;06;03;Sunnuntai;0;10;10;0;8;8
293;05.06.2016;2016;06;04;Sunnuntai;3;3;6;0;8;8
293;05.06.2016;2016;06;05;Sunnuntai;2;1;3;1;1;2
293;05.06.2016;2016;06;06;Sunnuntai;6;2;8;2;1;3
293;05.06.2016;2016;06;07;Sunnuntai;2;2;4;0;2;2
293;05.06.2016;2016;06;08;Sunnuntai;5;2;7;2;2;4
293;05.06.2016;2016;06;09;Sunnuntai;12;5;17;3;1;4
293;05.06.2016;2016;06;10;Sunnuntai;15;17;32;1;4;5
293;05.06.2016;2016;06;11;Sunnuntai;12;21;33;4;4;8
293;05.06.2016;2016;06;12;Sunnuntai;28;12;40;6;3;9
293;05.06.2016;2016;06;13;Sunnuntai;24;19;43;5;3;8
293;05.06.2016;2016;06;14;Sunnuntai;21;16;37;4;0;4
293;05.06.2016;2016;06;15;Sunnuntai;23;33;56;4;9;13
293;05.06.2016;2016;06;16;Sunnuntai;16;21;37;2;3;5
293;05.06.2016;2016;06;17;Sunnuntai;17;21;38;5;4;9
293;05.06.2016;2016;06;18;Sunnuntai;12;16;28;7;4;11
293;05.06.2016;2016;06;19;Sunnuntai;18;12;30;3;6;9
293;05.06.2016;2016;06;20;Sunnuntai;5;8;13;1;1;2
293;05.06.2016;2016;06;21;Sunnuntai;2;26;28;0;0;0
293;05.06.2016;2016;06;22;Sunnuntai;9;2;11;0;0;0
293;05.06.2016;2016;06;23;Sunnuntai;0;1;1;0;1;1
293;06.06.2016;2016;06;00;Maanantai;0;1;1;0;0;0
293;06.06.2016;2016;06;01;Maanantai;1;3;4;0;0;0
293;06.06.2016;2016;06;02;Maanantai;0;0;0;0;0;0
293;06.06.2016;2016;06;03;Maanantai;0;0;0;0;0;0
293;06.06.2016;2016;06;04;Maanantai;1;0;1;0;0;0
293;06.06.2016;2016;06;05;Maanantai;4;3;7;0;0;0
293;06.06.2016;2016;06;06;Maanantai;20;5;25;2;1;3
293;06.06.2016;2016;06;07;Maanantai;20;10;30;1;1;2
293;06.06.2016;2016;06;08;Maanantai;24;16;40;6;3;9
293;06.06.2016;2016;06;09;Maanantai;28;12;40;2;2;4
293;06.06.2016;2016;06;10;Maanantai;20;11;31;1;1;2
293;06.06.2016;2016;06;11;Maanantai;24;17;41;3;3;6
293;06.06.2016;2016;06;12;Maanantai;28;30;58;8;2;10
293;06.06.2016;2016;06;13;Maanantai;32;24;56;5;7;12
293;06.06.2016;2016;06;14;Maanantai;32;43;75;6;5;11
293;06.06.2016;2016;06;15;Maanantai;34;41;75;1;1;2
293;06.06.2016;2016;06;16;Maanantai;32;37;69;6;3;9
293;06.06.2016;2016;06;17;Maanantai;31;32;63;5;8;13
293;06.06.2016;2016;06;18;Maanantai;34;37;71;8;9;17
293;06.06.2016;2016;06;19;Maanantai;15;32;47;7;7;14
293;06.06.2016;2016;06;20;Maanantai;15;30;45;1;8;9
293;06.06.2016;2016;06;21;Maanantai;7;25;32;2;1;3
293;06.06.2016;2016;06;22;Maanantai;3;5;8;0;0;0
293;06.06.2016;2016;06;23;Maanantai;2;0;2;0;0;0
293;07.06.2016;2016;06;00;Tiistai;1;0;1;0;0;0
293;07.06.2016;2016;06;01;Tiistai;0;1;1;0;0;0
293;07.06.2016;2016;06;02;Tiistai;0;0;0;0;0;0
293;07.06.2016;2016;06;03;Tiistai;1;0;1;0;0;0
293;07.06.2016;2016;06;04;Tiistai;0;1;1;0;0;0
293;07.06.2016;2016;06;05;Tiistai;4;2;6;0;0;0
293;07.06.2016;2016;06;06;Tiistai;17;2;19;4;1;5
293;07.06.2016;2016;06;07;Tiistai;33;6;39;1;1;2
293;07.06.2016;2016;06;08;Tiistai;20;12;32;4;2;6
293;07.06.2016;2016;06;09;Tiistai;26;14;40;2;1;3
293;07.06.2016;2016;06;10;Tiistai;19;13;32;5;0;5
293;07.06.2016;2016;06;11;Tiistai;22;22;44;5;4;9
293;07.06.2016;2016;06;12;Tiistai;39;20;59;4;6;10
293;07.06.2016;2016;06;13;Tiistai;29;36;65;2;5;7
293;07.06.2016;2016;06;14;Tiistai;27;45;72;7;7;14
293;07.06.2016;2016;06;15;Tiistai;29;41;70;4;3;7
293;07.06.2016;2016;06;16;Tiistai;31;33;64;2;2;4
293;07.06.2016;2016;06;17;Tiistai;26;33;59;7;6;13
293;07.06.2016;2016;06;18;Tiistai;36;43;79;7;5;12
293;07.06.2016;2016;06;19;Tiistai;18;37;55;7;6;13
293;07.06.2016;2016;06;20;Tiistai;7;18;25;0;1;1
293;07.06.2016;2016;06;21;Tiistai;14;23;37;4;3;7
293;07.06.2016;2016;06;22;Tiistai;0;5;5;0;0;0
293;07.06.2016;2016;06;23;Tiistai;1;3;4;0;0;0
293;08.06.2016;2016;06;00;Keskiviikko;0;0;0;0;0;0
293;08.06.2016;2016;06;01;Keskiviikko;0;0;0;0;0;0
293;08.06.2016;2016;06;02;Keskiviikko;1;0;1;0;0;0
293;08.06.2016;2016;06;03;Keskiviikko;0;0;0;0;0;0
293;08.06.2016;2016;06;04;Keskiviikko;0;0;0;0;0;0
293;08.06.2016;2016;06;05;Keskiviikko;2;0;2;0;0;0
293;08.06.2016;2016;06;06;Keskiviikko;4;3;7;0;0;0
293;08.06.2016;2016;06;07;Keskiviikko;14;2;16;0;0;0
293;08.06.2016;2016;06;08;Keskiviikko;8;7;15;3;1;4
293;08.06.2016;2016;06;09;Keskiviikko;13;5;18;2;2;4
293;08.06.2016;2016;06;10;Keskiviikko;3;6;9;0;0;0
293;08.06.2016;2016;06;11;Keskiviikko;3;4;7;1;0;1
293;08.06.2016;2016;06;12;Keskiviikko;11;3;14;1;0;1
293;08.06.2016;2016;06;13;Keskiviikko;8;10;18;2;2;4
293;08.06.2016;2016;06;14;Keskiviikko;9;10;19;1;0;1
293;08.06.2016;2016;06;15;Keskiviikko;6;10;16;2;1;3
293;08.06.2016;2016;06;16;Keskiviikko;4;8;12;1;1;2
293;08.06.2016;2016;06;17;Keskiviikko;10;13;23;0;1;1
293;08.06.2016;2016;06;18;Keskiviikko;2;4;6;0;1;1
293;08.06.2016;2016;06;19;Keskiviikko;3;7;10;3;1;4
293;08.06.2016;2016;06;20;Keskiviikko;8;7;15;0;0;0
293;08.06.2016;2016;06;21;Keskiviikko;2;13;15;1;1;2
293;08.06.2016;2016;06;22;Keskiviikko;2;0;2;0;1;1
293;08.06.2016;2016;06;23;Keskiviikko;1;1;2;1;0;1
293;09.06.2016;2016;06;00;Torstai;0;0;0;0;0;0
293;09.06.2016;2016;06;01;Torstai;0;1;1;0;0;0
293;09.06.2016;2016;06;02;Torstai;0;0;0;0;0;0
293;09.06.2016;2016;06;03;Torstai;0;0;0;0;0;0
293;09.06.2016;2016;06;04;Torstai;0;1;1;0;0;0
293;09.06.2016;2016;06;05;Torstai;0;0;0;1;0;1
293;09.06.2016;2016;06;06;Torstai;4;2;6;0;0;0
293;09.06.2016;2016;06;07;Torstai;17;3;20;2;1;3
293;09.06.2016;2016;06;08;Torstai;14;9;23;3;0;3
293;09.06.2016;2016;06;09;Torstai;25;8;33;0;2;2
293;09.06.2016;2016;06;10;Torstai;11;7;18;0;0;0
293;09.06.2016;2016;06;11;Torstai;16;10;26;0;0;0
293;09.06.2016;2016;06;12;Torstai;12;9;21;8;3;11
293;09.06.2016;2016;06;13;Torstai;19;16;35;3;2;5
293;09.06.2016;2016;06;14;Torstai;20;26;46;4;3;7
293;09.06.2016;2016;06;15;Torstai;16;30;46;4;7;11
293;09.06.2016;2016;06;16;Torstai;31;27;58;1;4;5
293;09.06.2016;2016;06;17;Torstai;16;25;41;2;4;6
293;09.06.2016;2016;06;18;Torstai;20;16;36;8;8;16
293;09.06.2016;2016;06;19;Torstai;17;22;39;1;4;5
293;09.06.2016;2016;06;20;Torstai;6;12;18;2;5;7
293;09.06.2016;2016;06;21;Torstai;4;17;21;1;3;4
293;09.06.2016;2016;06;22;Torstai;4;4;8;1;0;1
293;09.06.2016;2016;06;23;Torstai;5;8;13;0;0;0
293;10.06.2016;2016;06;00;Perjantai;2;0;2;0;0;0
293;10.06.2016;2016;06;01;Perjantai;1;3;4;0;1;1
293;10.06.2016;2016;06;02;Perjantai;0;1;1;1;0;1
293;10.06.2016;2016;06;03;Perjantai;1;0;1;0;0;0
293;10.06.2016;2016;06;04;Perjantai;0;0;0;0;0;0
293;10.06.2016;2016;06;05;Perjantai;2;1;3;0;0;0
293;10.06.2016;2016;06;06;Perjantai;7;3;10;2;0;2
293;10.06.2016;2016;06;07;Perjantai;12;6;18;0;0;0
293;10.06.2016;2016;06;08;Perjantai;18;5;23;3;2;5
293;10.06.2016;2016;06;09;Perjantai;13;12;25;1;1;2
293;10.06.2016;2016;06;10;Perjantai;9;9;18;2;2;4
293;10.06.2016;2016;06;11;Perjantai;11;3;14;2;1;3
293;10.06.2016;2016;06;12;Perjantai;22;15;37;4;0;4
293;10.06.2016;2016;06;13;Perjantai;14;10;24;4;1;5
293;10.06.2016;2016;06;14;Perjantai;21;28;49;4;6;10
293;10.06.2016;2016;06;15;Perjantai;22;26;48;2;2;4
293;10.06.2016;2016;06;16;Perjantai;13;19;32;3;4;7
293;10.06.2016;2016;06;17;Perjantai;17;13;30;3;7;10
293;10.06.2016;2016;06;18;Perjantai;17;22;39;3;4;7
293;10.06.2016;2016;06;19;Perjantai;10;19;29;3;7;10
293;10.06.2016;2016;06;20;Perjantai;11;25;36;0;5;5
293;10.06.2016;2016;06;21;Perjantai;11;18;29;0;4;4
293;10.06.2016;2016;06;22;Perjantai;7;1;8;1;1;2
293;10.06.2016;2016;06;23;Perjantai;5;2;7;1;0;1
293;11.06.2016;2016;06;00;Lauantai;2;5;7;3;0;3
293;11.06.2016;2016;06;01;Lauantai;1;0;1;0;2;2
293;11.06.2016;2016;06;02;Lauantai;1;3;4;0;0;0
293;11.06.2016;2016;06;03;Lauantai;1;1;2;0;0;0
293;11.06.2016;2016;06;04;Lauantai;2;0;2;0;0;0
293;11.06.2016;2016;06;05;Lauantai;0;2;2;0;0;0
293;11.06.2016;2016;06;06;Lauantai;2;3;5;0;0;0
293;11.06.2016;2016;06;07;Lauantai;3;1;4;1;0;1
293;11.06.2016;2016;06;08;Lauantai;6;3;9;0;0;0
293;11.06.2016;2016;06;09;Lauantai;8;4;12;2;1;3
293;11.06.2016;2016;06;10;Lauantai;14;24;38;4;4;8
293;11.06.2016;2016;06;11;Lauantai;11;19;30;3;5;8
293;11.06.2016;2016;06;12;Lauantai;30;14;44;7;6;13
293;11.06.2016;2016;06;13;Lauantai;22;25;47;3;3;6
293;11.06.2016;2016;06;14;Lauantai;25;16;41;8;2;10
293;11.06.2016;2016;06;15;Lauantai;12;24;36;5;2;7
293;11.06.2016;2016;06;16;Lauantai;14;22;36;5;7;12
293;11.06.2016;2016;06;17;Lauantai;19;25;44;5;4;9
293;11.06.2016;2016;06;18;Lauantai;13;23;36;2;5;7
293;11.06.2016;2016;06;19;Lauantai;9;15;24;3;3;6
293;11.06.2016;2016;06;20;Lauantai;9;17;26;3;0;3
293;11.06.2016;2016;06;21;Lauantai;6;7;13;0;3;3
293;11.06.2016;2016;06;22;Lauantai;5;3;8;1;1;2
293;11.06.2016;2016;06;23;Lauantai;12;2;14;1;0;1
293;12.06.2016;2016;06;00;Sunnuntai;10;4;14;6;2;8
293;12.06.2016;2016;06;01;Sunnuntai;6;3;9;0;1;1
293;12.06.2016;2016;06;02;Sunnuntai;3;0;3;0;1;1
293;12.06.2016;2016;06;03;Sunnuntai;1;6;7;0;7;7
293;12.06.2016;2016;06;04;Sunnuntai;5;0;5;0;2;2
293;12.06.2016;2016;06;05;Sunnuntai;0;2;2;0;0;0
293;12.06.2016;2016;06;06;Sunnuntai;6;1;7;3;0;3
293;12.06.2016;2016;06;07;Sunnuntai;5;1;6;0;0;0
293;12.06.2016;2016;06;08;Sunnuntai;9;7;16;2;2;4
293;12.06.2016;2016;06;09;Sunnuntai;7;14;21;2;4;6
293;12.06.2016;2016;06;10;Sunnuntai;24;14;38;9;3;12
293;12.06.2016;2016;06;11;Sunnuntai;23;23;46;6;3;9
293;12.06.2016;2016;06;12;Sunnuntai;36;28;64;13;4;17
293;12.06.2016;2016;06;13;Sunnuntai;41;43;84;10;5;15
293;12.06.2016;2016;06;14;Sunnuntai;25;30;55;10;1;11
293;12.06.2016;2016;06;15;Sunnuntai;29;32;61;1;6;7
293;12.06.2016;2016;06;16;Sunnuntai;23;31;54;2;5;7
293;12.06.2016;2016;06;17;Sunnuntai;30;25;55;10;5;15
293;12.06.2016;2016;06;18;Sunnuntai;21;34;55;2;7;9
293;12.06.2016;2016;06;19;Sunnuntai;35;14;49;2;4;6
293;12.06.2016;2016;06;20;Sunnuntai;16;21;37;5;3;8
293;12.06.2016;2016;06;21;Sunnuntai;8;12;20;1;3;4
293;12.06.2016;2016;06;22;Sunnuntai;4;1;5;0;2;2
293;12.06.2016;2016;06;23;Sunnuntai;0;2;2;1;0;1
293;13.06.2016;2016;06;00;Maanantai;3;0;3;0;0;0
293;13.06.2016;2016;06;01;Maanantai;1;1;2;0;0;0
293;13.06.2016;2016;06;02;Maanantai;0;1;1;0;0;0
293;13.06.2016;2016;06;03;Maanantai;0;0;0;0;0;0
293;13.06.2016;2016;06;04;Maanantai;2;0;2;0;0;0
293;13.06.2016;2016;06;05;Maanantai;3;0;3;1;0;1
293;13.06.2016;2016;06;06;Maanantai;21;3;24;0;0;0
293;13.06.2016;2016;06;07;Maanantai;28;8;36;0;0;0
293;13.06.2016;2016;06;08;Maanantai;26;13;39;3;1;4
293;13.06.2016;2016;06;09;Maanantai;27;17;44;5;1;6
293;13.06.2016;2016;06;10;Maanantai;18;15;33;6;1;7
293;13.06.2016;2016;06;11;Maanantai;21;21;42;3;4;7
293;13.06.2016;2016;06;12;Maanantai;15;16;31;6;6;12
293;13.06.2016;2016;06;13;Maanantai;31;23;54;6;8;14
293;13.06.2016;2016;06;14;Maanantai;43;36;79;9;1;10
293;13.06.2016;2016;06;15;Maanantai;38;49;87;3;1;4
293;13.06.2016;2016;06;16;Maanantai;19;48;67;3;7;10
293;13.06.2016;2016;06;17;Maanantai;38;31;69;5;5;10
293;13.06.2016;2016;06;18;Maanantai;38;45;83;4;6;10
293;13.06.2016;2016;06;19;Maanantai;16;45;61;5;8;13
293;13.06.2016;2016;06;20;Maanantai;11;35;46;5;2;7
293;13.06.2016;2016;06;21;Maanantai;10;13;23;2;0;2
293;13.06.2016;2016;06;22;Maanantai;2;5;7;0;3;3
293;13.06.2016;2016;06;23;Maanantai;2;1;3;3;1;4
293;14.06.2016;2016;06;00;Tiistai;1;0;1;0;0;0
293;14.06.2016;2016;06;01;Tiistai;1;0;1;0;0;0
293;14.06.2016;2016;06;02;Tiistai;0;0;0;0;0;0
293;14.06.2016;2016;06;03;Tiistai;0;0;0;0;0;0
293;14.06.2016;2016;06;04;Tiistai;2;0;2;0;0;0
293;14.06.2016;2016;06;05;Tiistai;4;2;6;0;1;1
293;14.06.2016;2016;06;06;Tiistai;24;5;29;0;0;0
293;14.06.2016;2016;06;07;Tiistai;24;8;32;2;0;2
293;14.06.2016;2016;06;08;Tiistai;23;4;27;3;1;4
293;14.06.2016;2016;06;09;Tiistai;16;18;34;1;3;4
293;14.06.2016;2016;06;10;Tiistai;26;14;40;6;1;7
293;14.06.2016;2016;06;11;Tiistai;24;22;46;3;1;4
293;14.06.2016;2016;06;12;Tiistai;29;32;61;5;4;9
293;14.06.2016;2016;06;13;Tiistai;27;36;63;4;5;9
293;14.06.2016;2016;06;14;Tiistai;28;30;58;3;3;6
293;14.06.2016;2016;06;15;Tiistai;45;56;101;1;4;5
293;14.06.2016;2016;06;16;Tiistai;38;44;82;4;9;13
293;14.06.2016;2016;06;17;Tiistai;30;37;67;11;8;19
293;14.06.2016;2016;06;18;Tiistai;35;53;88;7;6;13
293;14.06.2016;2016;06;19;Tiistai;29;43;72;10;5;15
293;14.06.2016;2016;06;20;Tiistai;16;23;39;2;5;7
293;14.06.2016;2016;06;21;Tiistai;8;16;24;1;1;2
293;14.06.2016;2016;06;22;Tiistai;6;12;18;0;1;1
293;14.06.2016;2016;06;23;Tiistai;0;2;2;0;1;1
293;15.06.2016;2016;06;00;Keskiviikko;4;1;5;0;0;0
293;15.06.2016;2016;06;01;Keskiviikko;0;1;1;0;0;0
293;15.06.2016;2016;06;02;Keskiviikko;0;2;2;0;0;0
293;15.06.2016;2016;06;03;Keskiviikko;0;0;0;0;0;0
293;15.06.2016;2016;06;04;Keskiviikko;0;0;0;0;0;0
293;15.06.2016;2016;06;05;Keskiviikko;6;1;7;1;0;1
293;15.06.2016;2016;06;06;Keskiviikko;23;3;26;4;1;5
293;15.06.2016;2016;06;07;Keskiviikko;21;8;29;2;0;2
293;15.06.2016;2016;06;08;Keskiviikko;26;10;36;3;2;5
293;15.06.2016;2016;06;09;Keskiviikko;30;17;47;3;6;9
293;15.06.2016;2016;06;10;Keskiviikko;23;19;42;4;3;7
293;15.06.2016;2016;06;11;Keskiviikko;29;21;50;4;2;6
293;15.06.2016;2016;06;12;Keskiviikko;30;21;51;5;3;8
293;15.06.2016;2016;06;13;Keskiviikko;33;25;58;7;3;10
293;15.06.2016;2016;06;14;Keskiviikko;36;36;72;1;5;6
293;15.06.2016;2016;06;15;Keskiviikko;30;51;81;0;3;3
293;15.06.2016;2016;06;16;Keskiviikko;43;49;92;11;3;14
293;15.06.2016;2016;06;17;Keskiviikko;28;35;63;5;5;10
293;15.06.2016;2016;06;18;Keskiviikko;32;33;65;8;15;23
293;15.06.2016;2016;06;19;Keskiviikko;26;40;66;13;5;18
293;15.06.2016;2016;06;20;Keskiviikko;17;30;47;4;4;8
293;15.06.2016;2016;06;21;Keskiviikko;12;30;42;1;4;5
293;15.06.2016;2016;06;22;Keskiviikko;8;10;18;0;1;1
293;15.06.2016;2016;06;23;Keskiviikko;1;4;5;0;0;0
293;16.06.2016;2016;06;00;Torstai;0;2;2;0;0;0
293;16.06.2016;2016;06;01;Torstai;3;1;4;0;0;0
293;16.06.2016;2016;06;02;Torstai;1;0;1;0;0;0
293;16.06.2016;2016;06;03;Torstai;0;3;3;0;0;0
293;16.06.2016;2016;06;04;Torstai;0;0;0;0;0;0
293;16.06.2016;2016;06;05;Torstai;2;1;3;1;0;1
293;16.06.2016;2016;06;06;Torstai;18;5;23;3;0;3
293;16.06.2016;2016;06;07;Torstai;23;6;29;3;0;3
293;16.06.2016;2016;06;08;Torstai;31;16;47;3;2;5
293;16.06.2016;2016;06;09;Torstai;25;31;56;2;1;3
293;16.06.2016;2016;06;10;Torstai;17;15;32;5;3;8
293;16.06.2016;2016;06;11;Torstai;22;22;44;3;1;4
293;16.06.2016;2016;06;12;Torstai;37;15;52;5;3;8
293;16.06.2016;2016;06;13;Torstai;16;31;47;3;4;7
293;16.06.2016;2016;06;14;Torstai;24;37;61;3;5;8
293;16.06.2016;2016;06;15;Torstai;18;27;45;2;2;4
293;16.06.2016;2016;06;16;Torstai;15;25;40;0;3;3
293;16.06.2016;2016;06;17;Torstai;7;10;17;1;1;2
293;16.06.2016;2016;06;18;Torstai;10;19;29;2;1;3
293;16.06.2016;2016;06;19;Torstai;19;2;21;6;4;10
293;16.06.2016;2016;06;20;Torstai;3;7;10;1;4;5
293;16.06.2016;2016;06;21;Torstai;3;16;19;1;1;2
293;16.06.2016;2016;06;22;Torstai;0;3;3;0;0;0
293;16.06.2016;2016;06;23;Torstai;2;0;2;0;0;0
293;17.06.2016;2016;06;00;Perjantai;1;2;3;1;0;1
293;17.06.2016;2016;06;01;Perjantai;0;0;0;0;0;0
293;17.06.2016;2016;06;02;Perjantai;0;0;0;0;0;0
293;17.06.2016;2016;06;03;Perjantai;0;1;1;0;0;0
293;17.06.2016;2016;06;04;Perjantai;1;0;1;0;0;0
293;17.06.2016;2016;06;05;Perjantai;2;0;2;0;1;1
293;17.06.2016;2016;06;06;Perjantai;4;1;5;0;0;0
293;17.06.2016;2016;06;07;Perjantai;12;0;12;1;0;1
293;17.06.2016;2016;06;08;Perjantai;7;2;9;2;0;2
293;17.06.2016;2016;06;09;Perjantai;12;8;20;1;0;1
293;17.06.2016;2016;06;10;Perjantai;6;11;17;1;1;2
293;17.06.2016;2016;06;11;Perjantai;15;14;29;3;1;4
293;17.06.2016;2016;06;12;Perjantai;9;4;13;1;2;3
293;17.06.2016;2016;06;13;Perjantai;15;16;31;1;1;2
293;17.06.2016;2016;06;14;Perjantai;5;13;18;1;2;3
293;17.06.2016;2016;06;15;Perjantai;10;21;31;0;0;0
293;17.06.2016;2016;06;16;Perjantai;13;11;24;2;2;4
293;17.06.2016;2016;06;17;Perjantai;24;22;46;4;3;7
293;17.06.2016;2016;06;18;Perjantai;23;17;40;2;5;7
293;17.06.2016;2016;06;19;Perjantai;18;14;32;2;2;4
293;17.06.2016;2016;06;20;Perjantai;21;25;46;4;2;6
293;17.06.2016;2016;06;21;Perjantai;6;15;21;0;2;2
293;17.06.2016;2016;06;22;Perjantai;2;1;3;2;3;5
293;17.06.2016;2016;06;23;Perjantai;7;3;10;6;0;6
293;18.06.2016;2016;06;00;Lauantai;2;1;3;1;0;1
293;18.06.2016;2016;06;01;Lauantai;3;2;5;2;0;2
293;18.06.2016;2016;06;02;Lauantai;0;0;0;0;2;2
293;18.06.2016;2016;06;03;Lauantai;0;2;2;0;1;1
293;18.06.2016;2016;06;04;Lauantai;2;0;2;0;0;0
293;18.06.2016;2016;06;05;Lauantai;2;3;5;0;0;0
293;18.06.2016;2016;06;06;Lauantai;4;0;4;0;1;1
293;18.06.2016;2016;06;07;Lauantai;4;2;6;1;0;1
293;18.06.2016;2016;06;08;Lauantai;10;5;15;4;1;5
293;18.06.2016;2016;06;09;Lauantai;24;20;44;5;3;8
293;18.06.2016;2016;06;10;Lauantai;21;16;37;8;6;14
293;18.06.2016;2016;06;11;Lauantai;16;18;34;6;4;10
293;18.06.2016;2016;06;12;Lauantai;10;13;23;0;2;2
293;18.06.2016;2016;06;13;Lauantai;3;4;7;1;1;2
293;18.06.2016;2016;06;14;Lauantai;6;4;10;1;3;4
293;18.06.2016;2016;06;15;Lauantai;6;8;14;3;2;5
293;18.06.2016;2016;06;16;Lauantai;18;8;26;4;2;6
293;18.06.2016;2016;06;17;Lauantai;16;19;35;7;5;12
293;18.06.2016;2016;06;18;Lauantai;17;25;42;2;3;5
293;18.06.2016;2016;06;19;Lauantai;5;7;12;1;2;3
293;18.06.2016;2016;06;20;Lauantai;10;4;14;1;1;2
293;18.06.2016;2016;06;21;Lauantai;4;5;9;0;1;1
293;18.06.2016;2016;06;22;Lauantai;1;2;3;0;1;1
293;18.06.2016;2016;06;23;Lauantai;2;3;5;1;1;2
293;19.06.2016;2016;06;00;Sunnuntai;5;4;9;0;0;0
293;19.06.2016;2016;06;01;Sunnuntai;3;0;3;0;0;0
293;19.06.2016;2016;06;02;Sunnuntai;1;1;2;0;2;2
293;19.06.2016;2016;06;03;Sunnuntai;2;5;7;0;3;3
293;19.06.2016;2016;06;04;Sunnuntai;0;3;3;0;1;1
293;19.06.2016;2016;06;05;Sunnuntai;0;2;2;0;2;2
293;19.06.2016;2016;06;06;Sunnuntai;7;2;9;2;2;4
293;19.06.2016;2016;06;07;Sunnuntai;7;1;8;1;0;1
293;19.06.2016;2016;06;08;Sunnuntai;7;6;13;1;1;2
293;19.06.2016;2016;06;09;Sunnuntai;20;7;27;5;1;6
293;19.06.2016;2016;06;10;Sunnuntai;12;16;28;3;2;5
293;19.06.2016;2016;06;11;Sunnuntai;26;28;54;15;8;23
293;19.06.2016;2016;06;12;Sunnuntai;32;33;65;4;11;15
293;19.06.2016;2016;06;13;Sunnuntai;32;28;60;1;7;8
293;19.06.2016;2016;06;14;Sunnuntai;23;30;53;7;5;12
293;19.06.2016;2016;06;15;Sunnuntai;26;32;58;4;2;6
293;19.06.2016;2016;06;16;Sunnuntai;22;21;43;8;4;12
293;19.06.2016;2016;06;17;Sunnuntai;19;14;33;1;1;2
293;19.06.2016;2016;06;18;Sunnuntai;10;6;16;1;1;2
293;19.06.2016;2016;06;19;Sunnuntai;8;9;17;2;4;6
293;19.06.2016;2016;06;20;Sunnuntai;9;4;13;2;2;4
293;19.06.2016;2016;06;21;Sunnuntai;4;11;15;1;0;1
293;19.06.2016;2016;06;22;Sunnuntai;2;2;4;1;0;1
293;19.06.2016;2016;06;23;Sunnuntai;2;0;2;0;0;0
293;20.06.2016;2016;06;00;Maanantai;0;1;1;0;0;0
293;20.06.2016;2016;06;01;Maanantai;0;0;0;1;0;1
293;20.06.2016;2016;06;02;Maanantai;0;0;0;0;0;0
293;20.06.2016;2016;06;03;Maanantai;0;0;0;0;0;0
293;20.06.2016;2016;06;04;Maanantai;0;0;0;0;0;0
293;20.06.2016;2016;06;05;Maanantai;6;1;7;0;0;0
293;20.06.2016;2016;06;06;Maanantai;17;3;20;1;0;1
293;20.06.2016;2016;06;07;Maanantai;19;5;24;0;0;0
293;20.06.2016;2016;06;08;Maanantai;16;16;32;4;5;9
293;20.06.2016;2016;06;09;Maanantai;19;14;33;4;1;5
293;20.06.2016;2016;06;10;Maanantai;19;20;39;11;7;18
293;20.06.2016;2016;06;11;Maanantai;26;29;55;8;7;15
293;20.06.2016;2016;06;12;Maanantai;32;20;52;12;7;19
293;20.06.2016;2016;06;13;Maanantai;22;19;41;7;4;11
293;20.06.2016;2016;06;14;Maanantai;37;44;81;3;5;8
293;20.06.2016;2016;06;15;Maanantai;30;40;70;5;4;9
293;20.06.2016;2016;06;16;Maanantai;17;29;46;6;6;12
293;20.06.2016;2016;06;17;Maanantai;31;29;60;12;5;17
293;20.06.2016;2016;06;18;Maanantai;26;38;64;11;13;24
293;20.06.2016;2016;06;19;Maanantai;32;37;69;5;5;10
293;20.06.2016;2016;06;20;Maanantai;7;14;21;2;1;3
293;20.06.2016;2016;06;21;Maanantai;5;18;23;1;1;2
293;20.06.2016;2016;06;22;Maanantai;5;3;8;1;2;3
293;20.06.2016;2016;06;23;Maanantai;5;2;7;1;0;1
293;21.06.2016;2016;06;00;Tiistai;1;0;1;0;0;0
293;21.06.2016;2016;06;01;Tiistai;1;0;1;0;0;0
293;21.06.2016;2016;06;02;Tiistai;0;1;1;0;0;0
293;21.06.2016;2016;06;03;Tiistai;0;0;0;0;0;0
293;21.06.2016;2016;06;04;Tiistai;1;1;2;0;0;0
293;21.06.2016;2016;06;05;Tiistai;5;1;6;1;0;1
293;21.06.2016;2016;06;06;Tiistai;19;2;21;1;0;1
293;21.06.2016;2016;06;07;Tiistai;24;10;34;1;1;2
293;21.06.2016;2016;06;08;Tiistai;18;10;28;3;2;5
293;21.06.2016;2016;06;09;Tiistai;24;20;44;1;0;1
293;21.06.2016;2016;06;10;Tiistai;27;16;43;5;4;9
293;21.06.2016;2016;06;11;Tiistai;32;39;71;5;4;9
293;21.06.2016;2016;06;12;Tiistai;41;22;63;8;4;12
293;21.06.2016;2016;06;13;Tiistai;22;30;52;3;7;10
293;21.06.2016;2016;06;14;Tiistai;42;38;80;4;3;7
293;21.06.2016;2016;06;15;Tiistai;33;42;75;10;1;11
293;21.06.2016;2016;06;16;Tiistai;28;38;66;11;8;19
293;21.06.2016;2016;06;17;Tiistai;41;36;77;4;3;7
293;21.06.2016;2016;06;18;Tiistai;41;40;81;4;6;10
293;21.06.2016;2016;06;19;Tiistai;30;44;74;5;4;9
293;21.06.2016;2016;06;20;Tiistai;10;23;33;1;6;7
293;21.06.2016;2016;06;21;Tiistai;10;21;31;1;3;4
293;21.06.2016;2016;06;22;Tiistai;3;3;6;1;0;1
293;21.06.2016;2016;06;23;Tiistai;0;2;2;6;1;7
293;22.06.2016;2016;06;00;Keskiviikko;0;0;0;0;0;0
293;22.06.2016;2016;06;01;Keskiviikko;0;0;0;0;0;0
293;22.06.2016;2016;06;02;Keskiviikko;0;0;0;0;0;0
293;22.06.2016;2016;06;03;Keskiviikko;0;0;0;0;0;0
293;22.06.2016;2016;06;04;Keskiviikko;0;0;0;0;0;0
293;22.06.2016;2016;06;05;Keskiviikko;5;0;5;0;1;1
293;22.06.2016;2016;06;06;Keskiviikko;15;5;20;1;0;1
293;22.06.2016;2016;06;07;Keskiviikko;20;5;25;2;1;3
293;22.06.2016;2016;06;08;Keskiviikko;19;13;32;0;1;1
293;22.06.2016;2016;06;09;Keskiviikko;24;14;38;3;1;4
293;22.06.2016;2016;06;10;Keskiviikko;15;17;32;1;3;4
293;22.06.2016;2016;06;11;Keskiviikko;31;25;56;4;4;8
293;22.06.2016;2016;06;12;Keskiviikko;33;27;60;10;4;14
293;22.06.2016;2016;06;13;Keskiviikko;33;30;63;6;2;8
293;22.06.2016;2016;06;14;Keskiviikko;29;29;58;3;4;7
293;22.06.2016;2016;06;15;Keskiviikko;28;43;71;5;2;7
293;22.06.2016;2016;06;16;Keskiviikko;26;37;63;5;5;10
293;22.06.2016;2016;06;17;Keskiviikko;36;41;77;6;4;10
293;22.06.2016;2016;06;18;Keskiviikko;34;35;69;7;8;15
293;22.06.2016;2016;06;19;Keskiviikko;22;23;45;3;5;8
293;22.06.2016;2016;06;20;Keskiviikko;12;28;40;4;2;6
293;22.06.2016;2016;06;21;Keskiviikko;13;14;27;3;3;6
293;22.06.2016;2016;06;22;Keskiviikko;5;4;9;1;2;3
293;22.06.2016;2016;06;23;Keskiviikko;6;5;11;1;0;1
293;23.06.2016;2016;06;00;Torstai;0;0;0;0;0;0
293;23.06.2016;2016;06;01;Torstai;1;2;3;1;2;3
293;23.06.2016;2016;06;02;Torstai;2;2;4;0;0;0
293;23.06.2016;2016;06;03;Torstai;0;0;0;0;0;0
293;23.06.2016;2016;06;04;Torstai;2;3;5;0;0;0
293;23.06.2016;2016;06;05;Torstai;4;0;4;1;0;1
293;23.06.2016;2016;06;06;Torstai;11;1;12;0;1;1
293;23.06.2016;2016;06;07;Torstai;17;10;27;1;0;1
293;23.06.2016;2016;06;08;Torstai;14;16;30;2;1;3
293;23.06.2016;2016;06;09;Torstai;21;9;30;1;4;5
293;23.06.2016;2016;06;10;Torstai;27;22;49;2;0;2
293;23.06.2016;2016;06;11;Torstai;36;26;62;4;2;6
293;23.06.2016;2016;06;12;Torstai;30;38;68;6;4;10
293;23.06.2016;2016;06;13;Torstai;29;25;54;6;5;11
293;23.06.2016;2016;06;14;Torstai;32;37;69;6;2;8
293;23.06.2016;2016;06;15;Torstai;39;41;80;5;6;11
293;23.06.2016;2016;06;16;Torstai;37;38;75;4;5;9
293;23.06.2016;2016;06;17;Torstai;36;36;72;7;3;10
293;23.06.2016;2016;06;18;Torstai;23;31;54;4;9;13
293;23.06.2016;2016;06;19;Torstai;13;18;31;7;9;16
293;23.06.2016;2016;06;20;Torstai;23;19;42;1;4;5
293;23.06.2016;2016;06;21;Torstai;3;19;22;1;4;5
293;23.06.2016;2016;06;22;Torstai;10;10;20;0;0;0
293;23.06.2016;2016;06;23;Torstai;7;5;12;1;0;1
293;24.06.2016;2016;06;00;Perjantai;0;4;4;0;0;0
293;24.06.2016;2016;06;01;Perjantai;0;2;2;0;0;0
293;24.06.2016;2016;06;02;Perjantai;4;2;6;0;0;0
293;24.06.2016;2016;06;03;Perjantai;0;1;1;0;0;0
293;24.06.2016;2016;06;04;Perjantai;3;0;3;0;1;1
293;24.06.2016;2016;06;05;Perjantai;0;4;4;0;0;0
293;24.06.2016;2016;06;06;Perjantai;3;2;5;0;1;1
293;24.06.2016;2016;06;07;Perjantai;2;1;3;0;1;1
293;24.06.2016;2016;06;08;Perjantai;11;5;16;1;1;2
293;24.06.2016;2016;06;09;Perjantai;19;18;37;2;2;4
293;24.06.2016;2016;06;10;Perjantai;20;21;41;4;3;7
293;24.06.2016;2016;06;11;Perjantai;27;37;64;4;7;11
293;24.06.2016;2016;06;12;Perjantai;32;44;76;5;2;7
293;24.06.2016;2016;06;13;Perjantai;32;24;56;7;3;10
293;24.06.2016;2016;06;14;Perjantai;33;38;71;9;2;11
293;24.06.2016;2016;06;15;Perjantai;16;24;40;2;6;8
293;24.06.2016;2016;06;16;Perjantai;27;34;61;2;3;5
293;24.06.2016;2016;06;17;Perjantai;21;22;43;2;3;5
293;24.06.2016;2016;06;18;Perjantai;24;13;37;2;8;10
293;24.06.2016;2016;06;19;Perjantai;23;14;37;7;4;11
293;24.06.2016;2016;06;20;Perjantai;32;39;71;5;7;12
293;24.06.2016;2016;06;21;Perjantai;25;24;49;4;1;5
293;24.06.2016;2016;06;22;Perjantai;25;25;50;2;4;6
293;24.06.2016;2016;06;23;Perjantai;12;19;31;6;3;9
293;25.06.2016;2016;06;00;Lauantai;20;20;40;2;1;3
293;25.06.2016;2016;06;01;Lauantai;12;10;22;0;3;3
293;25.06.2016;2016;06;02;Lauantai;11;6;17;2;3;5
293;25.06.2016;2016;06;03;Lauantai;5;16;21;2;7;9
293;25.06.2016;2016;06;04;Lauantai;6;5;11;1;0;1
293;25.06.2016;2016;06;05;Lauantai;1;0;1;3;0;3
293;25.06.2016;2016;06;06;Lauantai;1;4;5;1;0;1
293;25.06.2016;2016;06;07;Lauantai;3;2;5;0;0;0
293;25.06.2016;2016;06;08;Lauantai;3;3;6;1;5;6
293;25.06.2016;2016;06;09;Lauantai;16;5;21;4;3;7
293;25.06.2016;2016;06;10;Lauantai;17;18;35;3;3;6
293;25.06.2016;2016;06;11;Lauantai;13;20;33;1;0;1
293;25.06.2016;2016;06;12;Lauantai;3;7;10;1;1;2
293;25.06.2016;2016;06;13;Lauantai;2;3;5;0;0;0
293;25.06.2016;2016;06;14;Lauantai;4;2;6;4;1;5
293;25.06.2016;2016;06;15;Lauantai;14;8;22;3;2;5
293;25.06.2016;2016;06;16;Lauantai;28;16;44;8;1;9
293;25.06.2016;2016;06;17;Lauantai;29;25;54;9;4;13
293;25.06.2016;2016;06;18;Lauantai;21;22;43;8;3;11
293;25.06.2016;2016;06;19;Lauantai;14;23;37;1;3;4
293;25.06.2016;2016;06;20;Lauantai;9;19;28;3;2;5
293;25.06.2016;2016;06;21;Lauantai;10;10;20;0;1;1
293;25.06.2016;2016;06;22;Lauantai;9;4;13;0;0;0
293;25.06.2016;2016;06;23;Lauantai;6;6;12;0;0;0
293;26.06.2016;2016;06;00;Sunnuntai;13;1;14;0;0;0
293;26.06.2016;2016;06;01;Sunnuntai;4;2;6;0;0;0
293;26.06.2016;2016;06;02;Sunnuntai;2;0;2;0;0;0
293;26.06.2016;2016;06;03;Sunnuntai;2;7;9;0;0;0
293;26.06.2016;2016;06;04;Sunnuntai;1;1;2;0;0;0
293;26.06.2016;2016;06;05;Sunnuntai;1;2;3;0;0;0
293;26.06.2016;2016;06;06;Sunnuntai;1;1;2;0;0;0
293;26.06.2016;2016;06;07;Sunnuntai;3;0;3;0;0;0
293;26.06.2016;2016;06;08;Sunnuntai;12;6;18;1;0;1
293;26.06.2016;2016;06;09;Sunnuntai;13;8;21;3;2;5
293;26.06.2016;2016;06;10;Sunnuntai;12;7;19;4;3;7
293;26.06.2016;2016;06;11;Sunnuntai;20;21;41;9;1;10
293;26.06.2016;2016;06;12;Sunnuntai;32;23;55;3;7;10
293;26.06.2016;2016;06;13;Sunnuntai;29;31;60;7;4;11
293;26.06.2016;2016;06;14;Sunnuntai;31;35;66;8;8;16
293;26.06.2016;2016;06;15;Sunnuntai;54;36;90;14;3;17
293;26.06.2016;2016;06;16;Sunnuntai;46;28;74;3;8;11
293;26.06.2016;2016;06;17;Sunnuntai;34;27;61;14;9;23
293;26.06.2016;2016;06;18;Sunnuntai;48;42;90;6;7;13
293;26.06.2016;2016;06;19;Sunnuntai;37;58;95;6;4;10
293;26.06.2016;2016;06;20;Sunnuntai;20;29;49;13;2;15
293;26.06.2016;2016;06;21;Sunnuntai;16;21;37;3;2;5
293;26.06.2016;2016;06;22;Sunnuntai;8;7;15;1;3;4
293;26.06.2016;2016;06;23;Sunnuntai;5;2;7;0;1;1
293;27.06.2016;2016;06;00;Maanantai;6;1;7;1;0;1
293;27.06.2016;2016;06;01;Maanantai;0;1;1;0;1;1
293;27.06.2016;2016;06;02;Maanantai;1;0;1;0;0;0
293;27.06.2016;2016;06;03;Maanantai;0;0;0;0;0;0
293;27.06.2016;2016;06;04;Maanantai;1;1;2;0;0;0
293;27.06.2016;2016;06;05;Maanantai;5;0;5;0;0;0
293;27.06.2016;2016;06;06;Maanantai;16;2;18;0;0;0
293;27.06.2016;2016;06;07;Maanantai;11;4;15;0;0;0
293;27.06.2016;2016;06;08;Maanantai;15;9;24;1;2;3
293;27.06.2016;2016;06;09;Maanantai;20;18;38;1;4;5
293;27.06.2016;2016;06;10;Maanantai;19;20;39;1;1;2
293;27.06.2016;2016;06;11;Maanantai;26;18;44;2;1;3
293;27.06.2016;2016;06;12;Maanantai;26;38;64;3;10;13
293;27.06.2016;2016;06;13;Maanantai;37;33;70;9;3;12
293;27.06.2016;2016;06;14;Maanantai;32;31;63;5;3;8
293;27.06.2016;2016;06;15;Maanantai;49;40;89;5;6;11
293;27.06.2016;2016;06;16;Maanantai;42;55;97;5;2;7
293;27.06.2016;2016;06;17;Maanantai;26;27;53;4;4;8
293;27.06.2016;2016;06;18;Maanantai;23;35;58;6;4;10
293;27.06.2016;2016;06;19;Maanantai;31;33;64;5;3;8
293;27.06.2016;2016;06;20;Maanantai;14;17;31;6;5;11
293;27.06.2016;2016;06;21;Maanantai;3;18;21;2;2;4
293;27.06.2016;2016;06;22;Maanantai;2;2;4;0;2;2
293;27.06.2016;2016;06;23;Maanantai;0;1;1;1;1;2
293;28.06.2016;2016;06;00;Tiistai;1;0;1;0;0;0
293;28.06.2016;2016;06;01;Tiistai;0;1;1;0;0;0
293;28.06.2016;2016;06;02;Tiistai;1;2;3;0;0;0
293;28.06.2016;2016;06;03;Tiistai;0;0;0;0;0;0
293;28.06.2016;2016;06;04;Tiistai;0;0;0;0;0;0
293;28.06.2016;2016;06;05;Tiistai;5;0;5;0;0;0
293;28.06.2016;2016;06;06;Tiistai;3;1;4;2;0;2
293;28.06.2016;2016;06;07;Tiistai;8;0;8;0;0;0
293;28.06.2016;2016;06;08;Tiistai;7;3;10;1;0;1
293;28.06.2016;2016;06;09;Tiistai;2;6;8;3;2;5
293;28.06.2016;2016;06;10;Tiistai;15;9;24;1;3;4
293;28.06.2016;2016;06;11;Tiistai;11;7;18;5;0;5
293;28.06.2016;2016;06;12;Tiistai;7;14;21;1;3;4
293;28.06.2016;2016;06;13;Tiistai;15;16;31;1;1;2
293;28.06.2016;2016;06;14;Tiistai;21;13;34;4;2;6
293;28.06.2016;2016;06;15;Tiistai;23;21;44;5;6;11
293;28.06.2016;2016;06;16;Tiistai;34;26;60;2;6;8
293;28.06.2016;2016;06;17;Tiistai;21;32;53;8;5;13
293;28.06.2016;2016;06;18;Tiistai;34;35;69;9;7;16
293;28.06.2016;2016;06;19;Tiistai;29;22;51;5;5;10
293;28.06.2016;2016;06;20;Tiistai;20;19;39;3;5;8
293;28.06.2016;2016;06;21;Tiistai;9;13;22;1;0;1
293;28.06.2016;2016;06;22;Tiistai;3;10;13;0;1;1
293;28.06.2016;2016;06;23;Tiistai;1;6;7;1;0;1
293;29.06.2016;2016;06;00;Keskiviikko;0;2;2;0;1;1
293;29.06.2016;2016;06;01;Keskiviikko;0;0;0;0;0;0
293;29.06.2016;2016;06;02;Keskiviikko;0;0;0;0;0;0
293;29.06.2016;2016;06;03;Keskiviikko;1;0;1;0;0;0
293;29.06.2016;2016;06;04;Keskiviikko;1;1;2;0;0;0
293;29.06.2016;2016;06;05;Keskiviikko;7;1;8;0;0;0
293;29.06.2016;2016;06;06;Keskiviikko;13;3;16;1;0;1
293;29.06.2016;2016;06;07;Keskiviikko;15;3;18;1;1;2
293;29.06.2016;2016;06;08;Keskiviikko;11;5;16;2;2;4
293;29.06.2016;2016;06;09;Keskiviikko;34;17;51;4;3;7
293;29.06.2016;2016;06;10;Keskiviikko;23;23;46;5;3;8
293;29.06.2016;2016;06;11;Keskiviikko;17;28;45;4;6;10
293;29.06.2016;2016;06;12;Keskiviikko;31;32;63;13;3;16
293;29.06.2016;2016;06;13;Keskiviikko;17;26;43;2;13;15
293;29.06.2016;2016;06;14;Keskiviikko;12;24;36;5;5;10
293;29.06.2016;2016;06;15;Keskiviikko;10;12;22;3;1;4
293;29.06.2016;2016;06;16;Keskiviikko;3;14;17;0;0;0
293;29.06.2016;2016;06;17;Keskiviikko;10;11;21;0;0;0
293;29.06.2016;2016;06;18;Keskiviikko;11;13;24;2;4;6
293;29.06.2016;2016;06;19;Keskiviikko;23;21;44;1;3;4
293;29.06.2016;2016;06;20;Keskiviikko;17;35;52;5;5;10
293;29.06.2016;2016;06;21;Keskiviikko;12;13;25;0;2;2
293;29.06.2016;2016;06;22;Keskiviikko;4;3;7;1;0;1
293;29.06.2016;2016;06;23;Keskiviikko;4;2;6;0;1;1
293;30.06.2016;2016;06;00;Torstai;1;0;1;1;0;1
293;30.06.2016;2016;06;01;Torstai;0;0;0;0;0;0
293;30.06.2016;2016;06;02;Torstai;0;1;1;0;0;0
293;30.06.2016;2016;06;03;Torstai;2;0;2;0;0;0
293;30.06.2016;2016;06;04;Torstai;0;0;0;0;0;0
293;30.06.2016;2016;06;05;Torstai;3;0;3;1;1;2
293;30.06.2016;2016;06;06;Torstai;11;4;15;2;1;3
293;30.06.2016;2016;06;07;Torstai;10;4;14;0;2;2
293;30.06.2016;2016;06;08;Torstai;13;8;21;1;2;3
293;30.06.2016;2016;06;09;Torstai;28;16;44;1;2;3
293;30.06.2016;2016;06;10;Torstai;28;29;57;11;3;14
293;30.06.2016;2016;06;11;Torstai;18;26;44;2;5;7
293;30.06.2016;2016;06;12;Torstai;31;35;66;7;7;14
293;30.06.2016;2016;06;13;Torstai;22;28;50;6;8;14
293;30.06.2016;2016;06;14;Torstai;30;22;52;5;3;8
293;30.06.2016;2016;06;15;Torstai;32;42;74;2;5;7
293;30.06.2016;2016;06;16;Torstai;11;20;31;0;2;2
293;30.06.2016;2016;06;17;Torstai;5;8;13;1;4;5
293;30.06.2016;2016;06;18;Torstai;15;10;25;3;1;4
293;30.06.2016;2016;06;19;Torstai;33;26;59;2;4;6
293;30.06.2016;2016;06;20;Torstai;10;18;28;2;6;8
293;30.06.2016;2016;06;21;Torstai;14;13;27;4;5;9
293;30.06.2016;2016;06;22;Torstai;4;5;9;3;1;4
293;30.06.2016;2016;06;23;Torstai;3;5;8;1;0;1
293;01.07.2016;2016;07;00;Perjantai;0;0;0;1;1;2
293;01.07.2016;2016;07;01;Perjantai;0;0;0;1;2;3
293;01.07.2016;2016;07;02;Perjantai;0;3;3;0;1;1
293;01.07.2016;2016;07;03;Perjantai;1;0;1;0;0;0
293;01.07.2016;2016;07;04;Perjantai;1;0;1;0;0;0
293;01.07.2016;2016;07;05;Perjantai;6;0;6;0;0;0
293;01.07.2016;2016;07;06;Perjantai;8;3;11;0;0;0
293;01.07.2016;2016;07;07;Perjantai;13;4;17;0;0;0
293;01.07.2016;2016;07;08;Perjantai;8;6;14;1;2;3
293;01.07.2016;2016;07;09;Perjantai;12;14;26;4;1;5
293;01.07.2016;2016;07;10;Perjantai;6;11;17;2;2;4
293;01.07.2016;2016;07;11;Perjantai;23;16;39;4;1;5
293;01.07.2016;2016;07;12;Perjantai;23;24;47;4;3;7
293;01.07.2016;2016;07;13;Perjantai;26;28;54;3;7;10
293;01.07.2016;2016;07;14;Perjantai;16;28;44;6;2;8
293;01.07.2016;2016;07;15;Perjantai;37;24;61;11;5;16
293;01.07.2016;2016;07;16;Perjantai;21;19;40;0;3;3
293;01.07.2016;2016;07;17;Perjantai;20;29;49;5;2;7
293;01.07.2016;2016;07;18;Perjantai;22;12;34;4;4;8
293;01.07.2016;2016;07;19;Perjantai;25;37;62;6;4;10
293;01.07.2016;2016;07;20;Perjantai;16;22;38;3;3;6
293;01.07.2016;2016;07;21;Perjantai;17;14;31;1;0;1
293;01.07.2016;2016;07;22;Perjantai;6;6;12;0;1;1
293;01.07.2016;2016;07;23;Perjantai;4;10;14;0;0;0
293;02.07.2016;2016;07;00;Lauantai;6;2;8;0;2;2
293;02.07.2016;2016;07;01;Lauantai;7;3;10;2;0;2
293;02.07.2016;2016;07;02;Lauantai;2;10;12;0;4;4
293;02.07.2016;2016;07;03;Lauantai;1;5;6;1;0;1
293;02.07.2016;2016;07;04;Lauantai;1;0;1;0;1;1
293;02.07.2016;2016;07;05;Lauantai;2;1;3;0;0;0
293;02.07.2016;2016;07;06;Lauantai;1;2;3;0;0;0
293;02.07.2016;2016;07;07;Lauantai;6;2;8;0;0;0
293;02.07.2016;2016;07;08;Lauantai;8;2;10;1;1;2
293;02.07.2016;2016;07;09;Lauantai;7;12;19;2;0;2
293;02.07.2016;2016;07;10;Lauantai;18;13;31;3;6;9
293;02.07.2016;2016;07;11;Lauantai;20;19;39;9;6;15
293;02.07.2016;2016;07;12;Lauantai;30;42;72;4;6;10
293;02.07.2016;2016;07;13;Lauantai;28;21;49;5;2;7
293;02.07.2016;2016;07;14;Lauantai;32;23;55;3;1;4
293;02.07.2016;2016;07;15;Lauantai;31;25;56;2;2;4
293;02.07.2016;2016;07;16;Lauantai;19;27;46;3;4;7
293;02.07.2016;2016;07;17;Lauantai;17;23;40;1;6;7
293;02.07.2016;2016;07;18;Lauantai;28;18;46;2;5;7
293;02.07.2016;2016;07;19;Lauantai;25;19;44;1;5;6
293;02.07.2016;2016;07;20;Lauantai;28;15;43;3;5;8
293;02.07.2016;2016;07;21;Lauantai;12;8;20;2;4;6
293;02.07.2016;2016;07;22;Lauantai;8;8;16;2;1;3
293;02.07.2016;2016;07;23;Lauantai;7;7;14;0;0;0
293;03.07.2016;2016;07;00;Sunnuntai;8;5;13;0;0;0
293;03.07.2016;2016;07;01;Sunnuntai;10;23;33;1;1;2
293;03.07.2016;2016;07;02;Sunnuntai;1;8;9;0;3;3
293;03.07.2016;2016;07;03;Sunnuntai;5;4;9;0;0;0
293;03.07.2016;2016;07;04;Sunnuntai;1;2;3;0;0;0
293;03.07.2016;2016;07;05;Sunnuntai;3;2;5;0;0;0
293;03.07.2016;2016;07;06;Sunnuntai;0;3;3;0;0;0
293;03.07.2016;2016;07;07;Sunnuntai;5;2;7;0;0;0
293;03.07.2016;2016;07;08;Sunnuntai;6;6;12;2;2;4
293;03.07.2016;2016;07;09;Sunnuntai;13;7;20;3;2;5
293;03.07.2016;2016;07;10;Sunnuntai;3;7;10;0;1;1
293;03.07.2016;2016;07;11;Sunnuntai;4;12;16;2;1;3
293;03.07.2016;2016;07;12;Sunnuntai;8;4;12;4;2;6
293;03.07.2016;2016;07;13;Sunnuntai;9;7;16;4;3;7
293;03.07.2016;2016;07;14;Sunnuntai;4;6;10;3;2;5
293;03.07.2016;2016;07;15;Sunnuntai;23;10;33;3;1;4
293;03.07.2016;2016;07;16;Sunnuntai;29;23;52;6;3;9
293;03.07.2016;2016;07;17;Sunnuntai;48;34;82;11;6;17
293;03.07.2016;2016;07;18;Sunnuntai;32;36;68;3;8;11
293;03.07.2016;2016;07;19;Sunnuntai;20;17;37;9;5;14
293;03.07.2016;2016;07;20;Sunnuntai;8;24;32;6;5;11
293;03.07.2016;2016;07;21;Sunnuntai;10;10;20;1;2;3
293;03.07.2016;2016;07;22;Sunnuntai;6;2;8;0;1;1
293;03.07.2016;2016;07;23;Sunnuntai;2;2;4;2;0;2
293;04.07.2016;2016;07;00;Maanantai;0;0;0;0;0;0
293;04.07.2016;2016;07;01;Maanantai;0;0;0;0;0;0
293;04.07.2016;2016;07;02;Maanantai;3;1;4;0;0;0
293;04.07.2016;2016;07;03;Maanantai;0;0;0;0;0;0
293;04.07.2016;2016;07;04;Maanantai;1;0;1;0;0;0
293;04.07.2016;2016;07;05;Maanantai;5;2;7;0;0;0
293;04.07.2016;2016;07;06;Maanantai;12;4;16;0;0;0
293;04.07.2016;2016;07;07;Maanantai;15;3;18;0;0;0
293;04.07.2016;2016;07;08;Maanantai;12;2;14;1;1;2
293;04.07.2016;2016;07;09;Maanantai;23;5;28;2;4;6
293;04.07.2016;2016;07;10;Maanantai;8;18;26;3;1;4
293;04.07.2016;2016;07;11;Maanantai;5;5;10;0;1;1
293;04.07.2016;2016;07;12;Maanantai;11;16;27;2;4;6
293;04.07.2016;2016;07;13;Maanantai;5;11;16;1;2;3
293;04.07.2016;2016;07;14;Maanantai;19;13;32;3;0;3
293;04.07.2016;2016;07;15;Maanantai;21;27;48;3;3;6
293;04.07.2016;2016;07;16;Maanantai;11;9;20;2;3;5
293;04.07.2016;2016;07;17;Maanantai;19;18;37;3;4;7
293;04.07.2016;2016;07;18;Maanantai;18;15;33;2;2;4
293;04.07.2016;2016;07;19;Maanantai;31;21;52;6;3;9
293;04.07.2016;2016;07;20;Maanantai;21;19;40;2;6;8
293;04.07.2016;2016;07;21;Maanantai;2;8;10;1;1;2
293;04.07.2016;2016;07;22;Maanantai;1;7;8;0;0;0
293;04.07.2016;2016;07;23;Maanantai;5;2;7;0;1;1
293;05.07.2016;2016;07;00;Tiistai;0;2;2;0;0;0
293;05.07.2016;2016;07;01;Tiistai;0;0;0;0;0;0
293;05.07.2016;2016;07;02;Tiistai;0;1;1;0;2;2
293;05.07.2016;2016;07;03;Tiistai;2;0;2;2;0;2
293;05.07.2016;2016;07;04;Tiistai;0;0;0;0;0;0
293;05.07.2016;2016;07;05;Tiistai;5;1;6;0;0;0
293;05.07.2016;2016;07;06;Tiistai;8;1;9;0;0;0
293;05.07.2016;2016;07;07;Tiistai;7;3;10;3;0;3
293;05.07.2016;2016;07;08;Tiistai;10;5;15;1;1;2
293;05.07.2016;2016;07;09;Tiistai;16;1;17;0;2;2
293;05.07.2016;2016;07;10;Tiistai;6;7;13;6;2;8
293;05.07.2016;2016;07;11;Tiistai;12;12;24;3;4;7
293;05.07.2016;2016;07;12;Tiistai;24;20;44;4;2;6
293;05.07.2016;2016;07;13;Tiistai;21;18;39;2;5;7
293;05.07.2016;2016;07;14;Tiistai;22;38;60;5;4;9
293;05.07.2016;2016;07;15;Tiistai;8;19;27;1;4;5
293;05.07.2016;2016;07;16;Tiistai;5;7;12;1;2;3
293;05.07.2016;2016;07;17;Tiistai;3;4;7;0;1;1
293;05.07.2016;2016;07;18;Tiistai;6;3;9;1;2;3
293;05.07.2016;2016;07;19;Tiistai;9;9;18;3;3;6
293;05.07.2016;2016;07;20;Tiistai;6;6;12;6;3;9
293;05.07.2016;2016;07;21;Tiistai;2;8;10;0;2;2
293;05.07.2016;2016;07;22;Tiistai;3;0;3;1;1;2
293;05.07.2016;2016;07;23;Tiistai;0;0;0;4;0;4
293;06.07.2016;2016;07;00;Keskiviikko;0;0;0;0;0;0
293;06.07.2016;2016;07;01;Keskiviikko;0;0;0;0;0;0
293;06.07.2016;2016;07;02;Keskiviikko;0;1;1;0;0;0
293;06.07.2016;2016;07;03;Keskiviikko;1;0;1;0;1;1
293;06.07.2016;2016;07;04;Keskiviikko;0;0;0;0;0;0
293;06.07.2016;2016;07;05;Keskiviikko;5;0;5;2;0;2
293;06.07.2016;2016;07;06;Keskiviikko;5;0;5;0;0;0
293;06.07.2016;2016;07;07;Keskiviikko;7;4;11;0;0;0
293;06.07.2016;2016;07;08;Keskiviikko;6;0;6;0;0;0
293;06.07.2016;2016;07;09;Keskiviikko;11;5;16;1;0;1
293;06.07.2016;2016;07;10;Keskiviikko;19;9;28;8;3;11
293;06.07.2016;2016;07;11;Keskiviikko;18;21;39;12;2;14
293;06.07.2016;2016;07;12;Keskiviikko;41;19;60;8;16;24
293;06.07.2016;2016;07;13;Keskiviikko;34;32;66;7;5;12
293;06.07.2016;2016;07;14;Keskiviikko;24;33;57;1;5;6
293;06.07.2016;2016;07;15;Keskiviikko;30;41;71;2;5;7
293;06.07.2016;2016;07;16;Keskiviikko;42;33;75;4;6;10
293;06.07.2016;2016;07;17;Keskiviikko;42;32;74;4;3;7
293;06.07.2016;2016;07;18;Keskiviikko;17;16;33;3;6;9
293;06.07.2016;2016;07;19;Keskiviikko;9;24;33;1;0;1
293;06.07.2016;2016;07;20;Keskiviikko;17;16;33;2;5;7
293;06.07.2016;2016;07;21;Keskiviikko;12;24;36;4;10;14
293;06.07.2016;2016;07;22;Keskiviikko;6;14;20;2;2;4
293;06.07.2016;2016;07;23;Keskiviikko;1;3;4;2;2;4
293;07.07.2016;2016;07;00;Torstai;3;3;6;1;0;1
293;07.07.2016;2016;07;01;Torstai;2;3;5;0;0;0
293;07.07.2016;2016;07;02;Torstai;2;0;2;1;0;1
293;07.07.2016;2016;07;03;Torstai;2;0;2;0;0;0
293;07.07.2016;2016;07;04;Torstai;2;2;4;2;0;2
293;07.07.2016;2016;07;05;Torstai;8;0;8;0;3;3
293;07.07.2016;2016;07;06;Torstai;9;1;10;0;0;0
293;07.07.2016;2016;07;07;Torstai;16;4;20;1;0;1
293;07.07.2016;2016;07;08;Torstai;13;6;19;1;1;2
293;07.07.2016;2016;07;09;Torstai;11;1;12;3;0;3
293;07.07.2016;2016;07;10;Torstai;5;6;11;4;4;8
293;07.07.2016;2016;07;11;Torstai;10;10;20;3;2;5
293;07.07.2016;2016;07;12;Torstai;10;8;18;1;1;2
293;07.07.2016;2016;07;13;Torstai;9;6;15;1;1;2
293;07.07.2016;2016;07;14;Torstai;9;14;23;2;0;2
293;07.07.2016;2016;07;15;Torstai;12;21;33;0;0;0
293;07.07.2016;2016;07;16;Torstai;20;24;44;3;3;6
293;07.07.2016;2016;07;17;Torstai;20;23;43;5;4;9
293;07.07.2016;2016;07;18;Torstai;27;26;53;1;7;8
293;07.07.2016;2016;07;19;Torstai;24;26;50;5;2;7
293;07.07.2016;2016;07;20;Torstai;12;20;32;4;5;9
293;07.07.2016;2016;07;21;Torstai;10;16;26;4;3;7
293;07.07.2016;2016;07;22;Torstai;6;2;8;1;2;3
293;07.07.2016;2016;07;23;Torstai;0;2;2;2;3;5
293;08.07.2016;2016;07;00;Perjantai;8;4;12;0;0;0
293;08.07.2016;2016;07;01;Perjantai;3;2;5;0;0;0
293;08.07.2016;2016;07;02;Perjantai;0;4;4;0;0;0
293;08.07.2016;2016;07;03;Perjantai;0;1;1;0;0;0
293;08.07.2016;2016;07;04;Perjantai;1;3;4;0;0;0
293;08.07.2016;2016;07;05;Perjantai;4;1;5;0;0;0
293;08.07.2016;2016;07;06;Perjantai;10;2;12;0;2;2
293;08.07.2016;2016;07;07;Perjantai;15;4;19;3;0;3
293;08.07.2016;2016;07;08;Perjantai;11;8;19;2;2;4
293;08.07.2016;2016;07;09;Perjantai;16;3;19;2;3;5
293;08.07.2016;2016;07;10;Perjantai;22;13;35;6;4;10
293;08.07.2016;2016;07;11;Perjantai;35;8;43;6;4;10
293;08.07.2016;2016;07;12;Perjantai;32;42;74;3;6;9
293;08.07.2016;2016;07;13;Perjantai;18;31;49;3;5;8
293;08.07.2016;2016;07;14;Perjantai;23;23;46;4;3;7
293;08.07.2016;2016;07;15;Perjantai;23;30;53;8;6;14
293;08.07.2016;2016;07;16;Perjantai;39;37;76;5;3;8
293;08.07.2016;2016;07;17;Perjantai;34;26;60;1;6;7
293;08.07.2016;2016;07;18;Perjantai;30;31;61;13;12;25
293;08.07.2016;2016;07;19;Perjantai;19;38;57;4;2;6
293;08.07.2016;2016;07;20;Perjantai;13;24;37;1;2;3
293;08.07.2016;2016;07;21;Perjantai;20;14;34;5;4;9
293;08.07.2016;2016;07;22;Perjantai;6;5;11;0;0;0
293;08.07.2016;2016;07;23;Perjantai;10;19;29;6;2;8
293;09.07.2016;2016;07;00;Lauantai;2;5;7;0;0;0
293;09.07.2016;2016;07;01;Lauantai;5;7;12;3;0;3
293;09.07.2016;2016;07;02;Lauantai;0;6;6;0;2;2
293;09.07.2016;2016;07;03;Lauantai;1;2;3;0;1;1
293;09.07.2016;2016;07;04;Lauantai;1;1;2;0;1;1
293;09.07.2016;2016;07;05;Lauantai;1;0;1;1;0;1
293;09.07.2016;2016;07;06;Lauantai;4;1;5;0;0;0
293;09.07.2016;2016;07;07;Lauantai;5;1;6;0;1;1
293;09.07.2016;2016;07;08;Lauantai;6;6;12;2;0;2
293;09.07.2016;2016;07;09;Lauantai;16;9;25;3;0;3
293;09.07.2016;2016;07;10;Lauantai;17;13;30;3;2;5
293;09.07.2016;2016;07;11;Lauantai;14;17;31;4;2;6
293;09.07.2016;2016;07;12;Lauantai;22;23;45;3;7;10
293;09.07.2016;2016;07;13;Lauantai;31;14;45;4;3;7
293;09.07.2016;2016;07;14;Lauantai;20;22;42;3;1;4
293;09.07.2016;2016;07;15;Lauantai;18;27;45;7;3;10
293;09.07.2016;2016;07;16;Lauantai;24;24;48;4;2;6
293;09.07.2016;2016;07;17;Lauantai;18;23;41;1;4;5
293;09.07.2016;2016;07;18;Lauantai;15;24;39;5;3;8
293;09.07.2016;2016;07;19;Lauantai;12;24;36;4;5;9
293;09.07.2016;2016;07;20;Lauantai;10;11;21;0;2;2
293;09.07.2016;2016;07;21;Lauantai;5;12;17;0;0;0
293;09.07.2016;2016;07;22;Lauantai;5;3;8;1;1;2
293;09.07.2016;2016;07;23;Lauantai;9;8;17;1;1;2
293;10.07.2016;2016;07;00;Sunnuntai;4;3;7;0;1;1
293;10.07.2016;2016;07;01;Sunnuntai;10;14;24;0;1;1
293;10.07.2016;2016;07;02;Sunnuntai;5;4;9;0;0;0
293;10.07.2016;2016;07;03;Sunnuntai;1;0;1;0;4;4
293;10.07.2016;2016;07;04;Sunnuntai;0;3;3;0;0;0
293;10.07.2016;2016;07;05;Sunnuntai;1;2;3;3;0;3
293;10.07.2016;2016;07;06;Sunnuntai;3;2;5;4;1;5
293;10.07.2016;2016;07;07;Sunnuntai;7;0;7;0;0;0
293;10.07.2016;2016;07;08;Sunnuntai;6;5;11;0;1;1
293;10.07.2016;2016;07;09;Sunnuntai;11;2;13;4;6;10
293;10.07.2016;2016;07;10;Sunnuntai;16;10;26;4;1;5
293;10.07.2016;2016;07;11;Sunnuntai;10;29;39;3;2;5
293;10.07.2016;2016;07;12;Sunnuntai;22;24;46;1;6;7
293;10.07.2016;2016;07;13;Sunnuntai;30;27;57;10;3;13
293;10.07.2016;2016;07;14;Sunnuntai;37;26;63;8;6;14
293;10.07.2016;2016;07;15;Sunnuntai;30;24;54;7;3;10
293;10.07.2016;2016;07;16;Sunnuntai;40;34;74;7;6;13
293;10.07.2016;2016;07;17;Sunnuntai;38;32;70;2;2;4
293;10.07.2016;2016;07;18;Sunnuntai;33;35;68;5;6;11
293;10.07.2016;2016;07;19;Sunnuntai;36;45;81;4;5;9
293;10.07.2016;2016;07;20;Sunnuntai;23;28;51;7;0;7
293;10.07.2016;2016;07;21;Sunnuntai;12;14;26;1;4;5
293;10.07.2016;2016;07;22;Sunnuntai;11;17;28;0;0;0
293;10.07.2016;2016;07;23;Sunnuntai;2;5;7;0;1;1
293;11.07.2016;2016;07;00;Maanantai;5;2;7;0;0;0
293;11.07.2016;2016;07;01;Maanantai;2;3;5;0;0;0
293;11.07.2016;2016;07;02;Maanantai;0;0;0;0;0;0
293;11.07.2016;2016;07;03;Maanantai;2;1;3;0;0;0
293;11.07.2016;2016;07;04;Maanantai;2;1;3;0;0;0
293;11.07.2016;2016;07;05;Maanantai;6;1;7;0;0;0
293;11.07.2016;2016;07;06;Maanantai;9;2;11;3;1;4
293;11.07.2016;2016;07;07;Maanantai;18;8;26;2;1;3
293;11.07.2016;2016;07;08;Maanantai;20;5;25;2;0;2
293;11.07.2016;2016;07;09;Maanantai;31;18;49;3;1;4
293;11.07.2016;2016;07;10;Maanantai;22;26;48;4;2;6
293;11.07.2016;2016;07;11;Maanantai;34;29;63;10;4;14
293;11.07.2016;2016;07;12;Maanantai;26;24;50;5;5;10
293;11.07.2016;2016;07;13;Maanantai;36;47;83;4;4;8
293;11.07.2016;2016;07;14;Maanantai;52;48;100;4;6;10
293;11.07.2016;2016;07;15;Maanantai;37;63;100;13;6;19
293;11.07.2016;2016;07;16;Maanantai;59;44;103;8;9;17
293;11.07.2016;2016;07;17;Maanantai;49;59;108;6;7;13
293;11.07.2016;2016;07;18;Maanantai;45;56;101;7;7;14
293;11.07.2016;2016;07;19;Maanantai;32;53;85;7;11;18
293;11.07.2016;2016;07;20;Maanantai;23;51;74;6;9;15
293;11.07.2016;2016;07;21;Maanantai;11;23;34;0;5;5
293;11.07.2016;2016;07;22;Maanantai;23;13;36;0;2;2
293;11.07.2016;2016;07;23;Maanantai;3;1;4;0;2;2
293;12.07.2016;2016;07;00;Tiistai;0;1;1;1;5;6
293;12.07.2016;2016;07;01;Tiistai;1;2;3;0;0;0
293;12.07.2016;2016;07;02;Tiistai;1;2;3;2;0;2
293;12.07.2016;2016;07;03;Tiistai;2;4;6;0;0;0
293;12.07.2016;2016;07;04;Tiistai;3;2;5;1;0;1
293;12.07.2016;2016;07;05;Tiistai;7;2;9;0;0;0
293;12.07.2016;2016;07;06;Tiistai;15;2;17;0;0;0
293;12.07.2016;2016;07;07;Tiistai;22;6;28;0;1;1
293;12.07.2016;2016;07;08;Tiistai;17;8;25;1;2;3
293;12.07.2016;2016;07;09;Tiistai;24;14;38;9;3;12
293;12.07.2016;2016;07;10;Tiistai;25;18;43;11;3;14
293;12.07.2016;2016;07;11;Tiistai;30;25;55;5;7;12
293;12.07.2016;2016;07;12;Tiistai;35;35;70;1;7;8
293;12.07.2016;2016;07;13;Tiistai;44;30;74;5;4;9
293;12.07.2016;2016;07;14;Tiistai;40;51;91;6;8;14
293;12.07.2016;2016;07;15;Tiistai;50;59;109;6;4;10
293;12.07.2016;2016;07;16;Tiistai;35;65;100;5;3;8
293;12.07.2016;2016;07;17;Tiistai;33;35;68;4;8;12
293;12.07.2016;2016;07;18;Tiistai;27;40;67;13;5;18
293;12.07.2016;2016;07;19;Tiistai;33;46;79;12;8;20
293;12.07.2016;2016;07;20;Tiistai;39;42;81;10;3;13
293;12.07.2016;2016;07;21;Tiistai;25;19;44;4;4;8
293;12.07.2016;2016;07;22;Tiistai;1;9;10;0;3;3
293;12.07.2016;2016;07;23;Tiistai;4;6;10;1;1;2
293;13.07.2016;2016;07;00;Keskiviikko;0;4;4;1;0;1
293;13.07.2016;2016;07;01;Keskiviikko;2;3;5;3;2;5
293;13.07.2016;2016;07;02;Keskiviikko;2;1;3;0;2;2
293;13.07.2016;2016;07;03;Keskiviikko;2;0;2;0;0;0
293;13.07.2016;2016;07;04;Keskiviikko;0;0;0;0;0;0
293;13.07.2016;2016;07;05;Keskiviikko;3;0;3;0;0;0
293;13.07.2016;2016;07;06;Keskiviikko;13;1;14;0;2;2
293;13.07.2016;2016;07;07;Keskiviikko;16;9;25;0;0;0
293;13.07.2016;2016;07;08;Keskiviikko;11;5;16;1;1;2
293;13.07.2016;2016;07;09;Keskiviikko;17;8;25;0;2;2
293;13.07.2016;2016;07;10;Keskiviikko;33;22;55;6;1;7
293;13.07.2016;2016;07;11;Keskiviikko;20;29;49;9;4;13
293;13.07.2016;2016;07;12;Keskiviikko;41;33;74;9;7;16
293;13.07.2016;2016;07;13;Keskiviikko;30;35;65;14;7;21
293;13.07.2016;2016;07;14;Keskiviikko;34;43;77;3;4;7
293;13.07.2016;2016;07;15;Keskiviikko;36;44;80;5;4;9
293;13.07.2016;2016;07;16;Keskiviikko;48;31;79;4;5;9
293;13.07.2016;2016;07;17;Keskiviikko;46;41;87;8;10;18
293;13.07.2016;2016;07;18;Keskiviikko;51;47;98;7;6;13
293;13.07.2016;2016;07;19;Keskiviikko;43;40;83;8;11;19
293;13.07.2016;2016;07;20;Keskiviikko;30;48;78;7;6;13
293;13.07.2016;2016;07;21;Keskiviikko;23;16;39;3;4;7
293;13.07.2016;2016;07;22;Keskiviikko;2;12;14;3;4;7
293;13.07.2016;2016;07;23;Keskiviikko;15;11;26;7;3;10
293;14.07.2016;2016;07;00;Torstai;3;3;6;1;2;3
293;14.07.2016;2016;07;01;Torstai;2;0;2;1;0;1
293;14.07.2016;2016;07;02;Torstai;1;1;2;0;0;0
293;14.07.2016;2016;07;03;Torstai;0;2;2;0;0;0
293;14.07.2016;2016;07;04;Torstai;0;0;0;1;0;1
293;14.07.2016;2016;07;05;Torstai;4;3;7;0;0;0
293;14.07.2016;2016;07;06;Torstai;16;3;19;0;0;0
293;14.07.2016;2016;07;07;Torstai;22;6;28;1;1;2
293;14.07.2016;2016;07;08;Torstai;23;11;34;2;1;3
293;14.07.2016;2016;07;09;Torstai;29;21;50;3;2;5
293;14.07.2016;2016;07;10;Torstai;30;21;51;3;3;6
293;14.07.2016;2016;07;11;Torstai;19;25;44;3;1;4
293;14.07.2016;2016;07;12;Torstai;39;36;75;8;2;10
293;14.07.2016;2016;07;13;Torstai;29;39;68;2;7;9
293;14.07.2016;2016;07;14;Torstai;33;55;88;9;6;15
293;14.07.2016;2016;07;15;Torstai;37;53;90;8;5;13
293;14.07.2016;2016;07;16;Torstai;53;32;85;5;5;10
293;14.07.2016;2016;07;17;Torstai;42;50;92;8;1;9
293;14.07.2016;2016;07;18;Torstai;41;52;93;3;7;10
293;14.07.2016;2016;07;19;Torstai;23;35;58;3;5;8
293;14.07.2016;2016;07;20;Torstai;31;37;68;5;3;8
293;14.07.2016;2016;07;21;Torstai;9;20;29;8;4;12
293;14.07.2016;2016;07;22;Torstai;4;12;16;4;1;5
293;14.07.2016;2016;07;23;Torstai;7;6;13;1;0;1
293;15.07.2016;2016;07;00;Perjantai;1;5;6;0;1;1
293;15.07.2016;2016;07;01;Perjantai;2;2;4;1;0;1
293;15.07.2016;2016;07;02;Perjantai;2;6;8;1;0;1
293;15.07.2016;2016;07;03;Perjantai;4;0;4;1;2;3
293;15.07.2016;2016;07;04;Perjantai;2;1;3;0;0;0
293;15.07.2016;2016;07;05;Perjantai;4;0;4;0;0;0
293;15.07.2016;2016;07;06;Perjantai;7;1;8;1;0;1
293;15.07.2016;2016;07;07;Perjantai;9;5;14;1;1;2
293;15.07.2016;2016;07;08;Perjantai;8;3;11;0;0;0
293;15.07.2016;2016;07;09;Perjantai;22;9;31;0;2;2
293;15.07.2016;2016;07;10;Perjantai;21;19;40;1;1;2
293;15.07.2016;2016;07;11;Perjantai;16;14;30;4;2;6
293;15.07.2016;2016;07;12;Perjantai;30;30;60;2;2;4
293;15.07.2016;2016;07;13;Perjantai;30;27;57;3;2;5
293;15.07.2016;2016;07;14;Perjantai;40;47;87;8;3;11
293;15.07.2016;2016;07;15;Perjantai;28;43;71;5;4;9
293;15.07.2016;2016;07;16;Perjantai;12;20;32;0;3;3
293;15.07.2016;2016;07;17;Perjantai;19;19;38;2;0;2
293;15.07.2016;2016;07;18;Perjantai;20;19;39;7;4;11
293;15.07.2016;2016;07;19;Perjantai;33;18;51;0;6;6
293;15.07.2016;2016;07;20;Perjantai;13;24;37;4;3;7
293;15.07.2016;2016;07;21;Perjantai;22;23;45;5;1;6
293;15.07.2016;2016;07;22;Perjantai;8;10;18;0;3;3
293;15.07.2016;2016;07;23;Perjantai;4;6;10;3;2;5
293;16.07.2016;2016;07;00;Lauantai;3;4;7;1;0;1
293;16.07.2016;2016;07;01;Lauantai;0;3;3;0;2;2
293;16.07.2016;2016;07;02;Lauantai;0;3;3;2;2;4
293;16.07.2016;2016;07;03;Lauantai;0;2;2;0;0;0
293;16.07.2016;2016;07;04;Lauantai;0;0;0;1;3;4
293;16.07.2016;2016;07;05;Lauantai;1;1;2;0;0;0
293;16.07.2016;2016;07;06;Lauantai;5;0;5;0;0;0
293;16.07.2016;2016;07;07;Lauantai;0;0;0;0;1;1
293;16.07.2016;2016;07;08;Lauantai;5;0;5;0;2;2
293;16.07.2016;2016;07;09;Lauantai;3;8;11;0;0;0
293;16.07.2016;2016;07;10;Lauantai;10;7;17;4;0;4
293;16.07.2016;2016;07;11;Lauantai;10;7;17;0;2;2
293;16.07.2016;2016;07;12;Lauantai;18;14;32;4;2;6
293;16.07.2016;2016;07;13;Lauantai;17;17;34;3;4;7
293;16.07.2016;2016;07;14;Lauantai;19;14;33;9;4;13
293;16.07.2016;2016;07;15;Lauantai;18;17;35;3;7;10
293;16.07.2016;2016;07;16;Lauantai;16;20;36;3;4;7
293;16.07.2016;2016;07;17;Lauantai;20;18;38;1;0;1
293;16.07.2016;2016;07;18;Lauantai;25;22;47;7;3;10
293;16.07.2016;2016;07;19;Lauantai;17;20;37;0;4;4
293;16.07.2016;2016;07;20;Lauantai;13;17;30;6;6;12
293;16.07.2016;2016;07;21;Lauantai;12;15;27;2;1;3
293;16.07.2016;2016;07;22;Lauantai;20;8;28;1;1;2
293;16.07.2016;2016;07;23;Lauantai;10;15;25;1;1;2
293;17.07.2016;2016;07;00;Sunnuntai;0;4;4;0;1;1
293;17.07.2016;2016;07;01;Sunnuntai;0;3;3;1;1;2
293;17.07.2016;2016;07;02;Sunnuntai;1;4;5;1;1;2
293;17.07.2016;2016;07;03;Sunnuntai;3;2;5;0;6;6
293;17.07.2016;2016;07;04;Sunnuntai;0;0;0;0;0;0
293;17.07.2016;2016;07;05;Sunnuntai;1;2;3;0;0;0
293;17.07.2016;2016;07;06;Sunnuntai;1;1;2;1;2;3
293;17.07.2016;2016;07;07;Sunnuntai;3;2;5;1;1;2
293;17.07.2016;2016;07;08;Sunnuntai;3;6;9;2;4;6
293;17.07.2016;2016;07;09;Sunnuntai;10;2;12;0;2;2
293;17.07.2016;2016;07;10;Sunnuntai;5;3;8;2;4;6
293;17.07.2016;2016;07;11;Sunnuntai;6;12;18;4;3;7
293;17.07.2016;2016;07;12;Sunnuntai;14;11;25;4;4;8
293;17.07.2016;2016;07;13;Sunnuntai;8;11;19;4;2;6
293;17.07.2016;2016;07;14;Sunnuntai;15;7;22;1;3;4
293;17.07.2016;2016;07;15;Sunnuntai;3;3;6;1;1;2
293;17.07.2016;2016;07;16;Sunnuntai;1;5;6;0;0;0
293;17.07.2016;2016;07;17;Sunnuntai;15;6;21;4;3;7
293;17.07.2016;2016;07;18;Sunnuntai;20;15;35;4;3;7
293;17.07.2016;2016;07;19;Sunnuntai;44;36;80;10;10;20
293;17.07.2016;2016;07;20;Sunnuntai;24;31;55;1;6;7
293;17.07.2016;2016;07;21;Sunnuntai;14;14;28;1;2;3
293;17.07.2016;2016;07;22;Sunnuntai;10;18;28;0;1;1
293;17.07.2016;2016;07;23;Sunnuntai;8;8;16;0;2;2
293;18.07.2016;2016;07;00;Maanantai;1;8;9;3;2;5
293;18.07.2016;2016;07;01;Maanantai;1;1;2;1;1;2
293;18.07.2016;2016;07;02;Maanantai;0;3;3;0;0;0
293;18.07.2016;2016;07;03;Maanantai;0;3;3;0;0;0
293;18.07.2016;2016;07;04;Maanantai;1;1;2;0;0;0
293;18.07.2016;2016;07;05;Maanantai;7;1;8;0;0;0
293;18.07.2016;2016;07;06;Maanantai;8;2;10;1;0;1
293;18.07.2016;2016;07;07;Maanantai;8;3;11;1;0;1
293;18.07.2016;2016;07;08;Maanantai;15;6;21;0;2;2
293;18.07.2016;2016;07;09;Maanantai;17;11;28;2;2;4
293;18.07.2016;2016;07;10;Maanantai;23;20;43;4;5;9
293;18.07.2016;2016;07;11;Maanantai;29;25;54;3;1;4
293;18.07.2016;2016;07;12;Maanantai;48;25;73;1;4;5
293;18.07.2016;2016;07;13;Maanantai;29;39;68;19;6;25
293;18.07.2016;2016;07;14;Maanantai;38;38;76;10;4;14
293;18.07.2016;2016;07;15;Maanantai;40;44;84;6;3;9
293;18.07.2016;2016;07;16;Maanantai;34;40;74;5;11;16
293;18.07.2016;2016;07;17;Maanantai;41;48;89;8;12;20
293;18.07.2016;2016;07;18;Maanantai;50;42;92;16;12;28
293;18.07.2016;2016;07;19;Maanantai;55;40;95;15;14;29
293;18.07.2016;2016;07;20;Maanantai;35;60;95;3;8;11
293;18.07.2016;2016;07;21;Maanantai;29;21;50;5;7;12
293;18.07.2016;2016;07;22;Maanantai;9;13;22;2;2;4
293;18.07.2016;2016;07;23;Maanantai;6;7;13;2;2;4
293;19.07.2016;2016;07;00;Tiistai;5;2;7;0;0;0
293;19.07.2016;2016;07;01;Tiistai;0;3;3;0;0;0
293;19.07.2016;2016;07;02;Tiistai;1;2;3;1;0;1
293;19.07.2016;2016;07;03;Tiistai;1;1;2;1;2;3
293;19.07.2016;2016;07;04;Tiistai;0;1;1;1;1;2
293;19.07.2016;2016;07;05;Tiistai;2;0;2;0;1;1
293;19.07.2016;2016;07;06;Tiistai;16;2;18;0;1;1
293;19.07.2016;2016;07;07;Tiistai;17;4;21;1;3;4
293;19.07.2016;2016;07;08;Tiistai;17;7;24;1;1;2
293;19.07.2016;2016;07;09;Tiistai;18;18;36;8;1;9
293;19.07.2016;2016;07;10;Tiistai;29;19;48;10;5;15
293;19.07.2016;2016;07;11;Tiistai;25;30;55;4;7;11
293;19.07.2016;2016;07;12;Tiistai;28;38;66;12;4;16
293;19.07.2016;2016;07;13;Tiistai;27;21;48;10;6;16
293;19.07.2016;2016;07;14;Tiistai;40;47;87;14;5;19
293;19.07.2016;2016;07;15;Tiistai;32;40;72;5;5;10
293;19.07.2016;2016;07;16;Tiistai;37;35;72;10;4;14
293;19.07.2016;2016;07;17;Tiistai;35;44;79;2;10;12
293;19.07.2016;2016;07;18;Tiistai;52;48;100;7;5;12
293;19.07.2016;2016;07;19;Tiistai;44;47;91;5;10;15
293;19.07.2016;2016;07;20;Tiistai;36;35;71;5;6;11
293;19.07.2016;2016;07;21;Tiistai;9;33;42;4;1;5
293;19.07.2016;2016;07;22;Tiistai;16;13;29;1;3;4
293;19.07.2016;2016;07;23;Tiistai;3;3;6;0;1;1
293;20.07.2016;2016;07;00;Keskiviikko;3;7;10;0;0;0
293;20.07.2016;2016;07;01;Keskiviikko;0;1;1;0;0;0
293;20.07.2016;2016;07;02;Keskiviikko;0;2;2;0;0;0
293;20.07.2016;2016;07;03;Keskiviikko;1;2;3;0;1;1
293;20.07.2016;2016;07;04;Keskiviikko;0;0;0;0;0;0
293;20.07.2016;2016;07;05;Keskiviikko;3;0;3;0;0;0
293;20.07.2016;2016;07;06;Keskiviikko;11;4;15;3;0;3
293;20.07.2016;2016;07;07;Keskiviikko;19;6;25;1;0;1
293;20.07.2016;2016;07;08;Keskiviikko;19;4;23;0;1;1
293;20.07.2016;2016;07;09;Keskiviikko;20;27;47;5;3;8
293;20.07.2016;2016;07;10;Keskiviikko;26;19;45;5;1;6
293;20.07.2016;2016;07;11;Keskiviikko;34;35;69;13;10;23
293;20.07.2016;2016;07;12;Keskiviikko;57;38;95;12;9;21
293;20.07.2016;2016;07;13;Keskiviikko;44;65;109;13;7;20
293;20.07.2016;2016;07;14;Keskiviikko;47;39;86;10;12;22
293;20.07.2016;2016;07;15;Keskiviikko;52;57;109;12;9;21
293;20.07.2016;2016;07;16;Keskiviikko;48;49;97;8;4;12
293;20.07.2016;2016;07;17;Keskiviikko;38;55;93;13;9;22
293;20.07.2016;2016;07;18;Keskiviikko;47;39;86;5;4;9
293;20.07.2016;2016;07;19;Keskiviikko;25;60;85;6;7;13
293;20.07.2016;2016;07;20;Keskiviikko;42;32;74;6;10;16
293;20.07.2016;2016;07;21;Keskiviikko;27;18;45;3;0;3
293;20.07.2016;2016;07;22;Keskiviikko;6;20;26;2;1;3
293;20.07.2016;2016;07;23;Keskiviikko;9;3;12;1;1;2
293;21.07.2016;2016;07;00;Torstai;0;0;0;0;0;0
293;21.07.2016;2016;07;01;Torstai;1;1;2;0;0;0
293;21.07.2016;2016;07;02;Torstai;1;3;4;0;0;0
293;21.07.2016;2016;07;03;Torstai;1;1;2;0;1;1
293;21.07.2016;2016;07;04;Torstai;2;2;4;0;0;0
293;21.07.2016;2016;07;05;Torstai;2;0;2;0;0;0
293;21.07.2016;2016;07;06;Torstai;15;3;18;2;0;2
293;21.07.2016;2016;07;07;Torstai;16;4;20;1;0;1
293;21.07.2016;2016;07;08;Torstai;17;5;22;3;2;5
293;21.07.2016;2016;07;09;Torstai;17;14;31;7;3;10
293;21.07.2016;2016;07;10;Torstai;21;25;46;6;6;12
293;21.07.2016;2016;07;11;Torstai;50;26;76;3;6;9
293;21.07.2016;2016;07;12;Torstai;39;49;88;1;6;7
293;21.07.2016;2016;07;13;Torstai;48;44;92;8;4;12
293;21.07.2016;2016;07;14;Torstai;34;42;76;8;3;11
293;21.07.2016;2016;07;15;Torstai;47;50;97;9;9;18
293;21.07.2016;2016;07;16;Torstai;51;42;93;3;12;15
293;21.07.2016;2016;07;17;Torstai;35;44;79;8;4;12
293;21.07.2016;2016;07;18;Torstai;39;50;89;12;6;18
293;21.07.2016;2016;07;19;Torstai;64;48;112;10;8;18
293;21.07.2016;2016;07;20;Torstai;35;56;91;4;7;11
293;21.07.2016;2016;07;21;Torstai;18;30;48;6;3;9
293;21.07.2016;2016;07;22;Torstai;11;16;27;2;4;6
293;21.07.2016;2016;07;23;Torstai;4;5;9;1;1;2
293;22.07.2016;2016;07;00;Perjantai;2;7;9;1;2;3
293;22.07.2016;2016;07;01;Perjantai;3;1;4;0;0;0
293;22.07.2016;2016;07;02;Perjantai;2;1;3;0;0;0
293;22.07.2016;2016;07;03;Perjantai;1;2;3;0;0;0
293;22.07.2016;2016;07;04;Perjantai;1;0;1;0;0;0
293;22.07.2016;2016;07;05;Perjantai;6;3;9;1;0;1
293;22.07.2016;2016;07;06;Perjantai;16;0;16;1;0;1
293;22.07.2016;2016;07;07;Perjantai;13;5;18;0;3;3
293;22.07.2016;2016;07;08;Perjantai;16;6;22;5;1;6
293;22.07.2016;2016;07;09;Perjantai;18;18;36;2;1;3
293;22.07.2016;2016;07;10;Perjantai;26;31;57;10;0;10
293;22.07.2016;2016;07;11;Perjantai;25;32;57;8;6;14
293;22.07.2016;2016;07;12;Perjantai;44;42;86;5;3;8
293;22.07.2016;2016;07;13;Perjantai;39;32;71;2;6;8
293;22.07.2016;2016;07;14;Perjantai;48;60;108;12;3;15
293;22.07.2016;2016;07;15;Perjantai;46;58;104;4;5;9
293;22.07.2016;2016;07;16;Perjantai;54;36;90;6;3;9
293;22.07.2016;2016;07;17;Perjantai;63;47;110;5;7;12
293;22.07.2016;2016;07;18;Perjantai;35;47;82;8;8;16
293;22.07.2016;2016;07;19;Perjantai;37;32;69;5;2;7
293;22.07.2016;2016;07;20;Perjantai;33;35;68;14;9;23
293;22.07.2016;2016;07;21;Perjantai;15;35;50;8;10;18
293;22.07.2016;2016;07;22;Perjantai;26;32;58;7;4;11
293;22.07.2016;2016;07;23;Perjantai;25;12;37;6;1;7
293;23.07.2016;2016;07;00;Lauantai;6;17;23;1;0;1
293;23.07.2016;2016;07;01;Lauantai;6;6;12;0;2;2
293;23.07.2016;2016;07;02;Lauantai;1;11;12;1;1;2
293;23.07.2016;2016;07;03;Lauantai;1;6;7;0;0;0
293;23.07.2016;2016;07;04;Lauantai;3;2;5;0;0;0
293;23.07.2016;2016;07;05;Lauantai;1;1;2;2;7;9
293;23.07.2016;2016;07;06;Lauantai;5;3;8;0;2;2
293;23.07.2016;2016;07;07;Lauantai;9;3;12;1;1;2
293;23.07.2016;2016;07;08;Lauantai;10;9;19;3;3;6
293;23.07.2016;2016;07;09;Lauantai;18;15;33;3;1;4
293;23.07.2016;2016;07;10;Lauantai;23;28;51;7;1;8
293;23.07.2016;2016;07;11;Lauantai;31;17;48;2;3;5
293;23.07.2016;2016;07;12;Lauantai;26;40;66;5;2;7
293;23.07.2016;2016;07;13;Lauantai;35;29;64;7;3;10
293;23.07.2016;2016;07;14;Lauantai;43;37;80;7;7;14
293;23.07.2016;2016;07;15;Lauantai;41;43;84;2;2;4
293;23.07.2016;2016;07;16;Lauantai;42;40;82;3;5;8
293;23.07.2016;2016;07;17;Lauantai;47;50;97;7;3;10
293;23.07.2016;2016;07;18;Lauantai;34;42;76;12;7;19
293;23.07.2016;2016;07;19;Lauantai;55;50;105;8;7;15
293;23.07.2016;2016;07;20;Lauantai;54;34;88;3;3;6
293;23.07.2016;2016;07;21;Lauantai;21;34;55;5;2;7
293;23.07.2016;2016;07;22;Lauantai;18;22;40;5;2;7
293;23.07.2016;2016;07;23;Lauantai;22;24;46;0;2;2
293;24.07.2016;2016;07;00;Sunnuntai;5;9;14;4;2;6
293;24.07.2016;2016;07;01;Sunnuntai;3;5;8;1;0;1
293;24.07.2016;2016;07;02;Sunnuntai;2;8;10;0;2;2
293;24.07.2016;2016;07;03;Sunnuntai;5;7;12;0;0;0
293;24.07.2016;2016;07;04;Sunnuntai;7;1;8;1;4;5
293;24.07.2016;2016;07;05;Sunnuntai;2;1;3;0;1;1
293;24.07.2016;2016;07;06;Sunnuntai;3;3;6;1;0;1
293;24.07.2016;2016;07;07;Sunnuntai;7;3;10;0;1;1
293;24.07.2016;2016;07;08;Sunnuntai;7;5;12;0;1;1
293;24.07.2016;2016;07;09;Sunnuntai;12;18;30;7;1;8
293;24.07.2016;2016;07;10;Sunnuntai;30;24;54;5;1;6
293;24.07.2016;2016;07;11;Sunnuntai;34;32;66;4;3;7
293;24.07.2016;2016;07;12;Sunnuntai;35;51;86;11;4;15
293;24.07.2016;2016;07;13;Sunnuntai;31;38;69;7;7;14
293;24.07.2016;2016;07;14;Sunnuntai;43;29;72;6;5;11
293;24.07.2016;2016;07;15;Sunnuntai;39;52;91;11;3;14
293;24.07.2016;2016;07;16;Sunnuntai;42;36;78;2;3;5
293;24.07.2016;2016;07;17;Sunnuntai;62;45;107;4;6;10
293;24.07.2016;2016;07;18;Sunnuntai;53;35;88;6;3;9
293;24.07.2016;2016;07;19;Sunnuntai;35;50;85;6;10;16
293;24.07.2016;2016;07;20;Sunnuntai;28;38;66;4;3;7
293;24.07.2016;2016;07;21;Sunnuntai;28;21;49;3;0;3
293;24.07.2016;2016;07;22;Sunnuntai;11;12;23;0;3;3
293;24.07.2016;2016;07;23;Sunnuntai;4;8;12;2;5;7
293;25.07.2016;2016;07;00;Maanantai;1;4;5;2;2;4
293;25.07.2016;2016;07;01;Maanantai;3;6;9;0;1;1
293;25.07.2016;2016;07;02;Maanantai;1;0;1;0;0;0
293;25.07.2016;2016;07;03;Maanantai;0;3;3;0;0;0
293;25.07.2016;2016;07;04;Maanantai;1;1;2;0;0;0
293;25.07.2016;2016;07;05;Maanantai;6;1;7;0;1;1
293;25.07.2016;2016;07;06;Maanantai;16;5;21;1;0;1
293;25.07.2016;2016;07;07;Maanantai;14;9;23;1;0;1
293;25.07.2016;2016;07;08;Maanantai;14;6;20;4;0;4
293;25.07.2016;2016;07;09;Maanantai;16;10;26;6;0;6
293;25.07.2016;2016;07;10;Maanantai;16;18;34;7;4;11
293;25.07.2016;2016;07;11;Maanantai;28;11;39;2;3;5
293;25.07.2016;2016;07;12;Maanantai;26;41;67;5;2;7
293;25.07.2016;2016;07;13;Maanantai;39;36;75;11;7;18
293;25.07.2016;2016;07;14;Maanantai;38;62;100;7;7;14
293;25.07.2016;2016;07;15;Maanantai;49;57;106;5;4;9
293;25.07.2016;2016;07;16;Maanantai;72;49;121;12;11;23
293;25.07.2016;2016;07;17;Maanantai;37;58;95;15;8;23
293;25.07.2016;2016;07;18;Maanantai;69;62;131;7;7;14
293;25.07.2016;2016;07;19;Maanantai;45;63;108;9;3;12
293;25.07.2016;2016;07;20;Maanantai;42;44;86;5;4;9
293;25.07.2016;2016;07;21;Maanantai;14;36;50;5;3;8
293;25.07.2016;2016;07;22;Maanantai;27;14;41;2;1;3
293;25.07.2016;2016;07;23;Maanantai;11;8;19;0;4;4
293;26.07.2016;2016;07;00;Tiistai;1;6;7;2;1;3
293;26.07.2016;2016;07;01;Tiistai;0;0;0;0;0;0
293;26.07.2016;2016;07;02;Tiistai;0;4;4;0;2;2
293;26.07.2016;2016;07;03;Tiistai;5;2;7;1;0;1
293;26.07.2016;2016;07;04;Tiistai;0;0;0;0;0;0
293;26.07.2016;2016;07;05;Tiistai;5;1;6;0;0;0
293;26.07.2016;2016;07;06;Tiistai;19;3;22;1;0;1
293;26.07.2016;2016;07;07;Tiistai;10;6;16;1;0;1
293;26.07.2016;2016;07;08;Tiistai;17;9;26;3;2;5
293;26.07.2016;2016;07;09;Tiistai;28;18;46;4;4;8
293;26.07.2016;2016;07;10;Tiistai;30;31;61;3;2;5
293;26.07.2016;2016;07;11;Tiistai;44;38;82;7;5;12
293;26.07.2016;2016;07;12;Tiistai;34;36;70;12;3;15
293;26.07.2016;2016;07;13;Tiistai;48;52;100;7;4;11
293;26.07.2016;2016;07;14;Tiistai;34;48;82;5;4;9
293;26.07.2016;2016;07;15;Tiistai;54;63;117;7;6;13
293;26.07.2016;2016;07;16;Tiistai;34;78;112;7;4;11
293;26.07.2016;2016;07;17;Tiistai;66;39;105;3;4;7
293;26.07.2016;2016;07;18;Tiistai;60;53;113;8;12;20
293;26.07.2016;2016;07;19;Tiistai;66;54;120;3;5;8
293;26.07.2016;2016;07;20;Tiistai;36;42;78;10;4;14
293;26.07.2016;2016;07;21;Tiistai;25;34;59;5;3;8
293;26.07.2016;2016;07;22;Tiistai;16;21;37;3;4;7
293;26.07.2016;2016;07;23;Tiistai;12;16;28;2;2;4
293;27.07.2016;2016;07;00;Keskiviikko;7;4;11;2;1;3
293;27.07.2016;2016;07;01;Keskiviikko;0;3;3;0;0;0
293;27.07.2016;2016;07;02;Keskiviikko;0;5;5;0;0;0
293;27.07.2016;2016;07;03;Keskiviikko;2;2;4;0;0;0
293;27.07.2016;2016;07;04;Keskiviikko;0;1;1;0;0;0
293;27.07.2016;2016;07;05;Keskiviikko;6;3;9;0;0;0
293;27.07.2016;2016;07;06;Keskiviikko;2;1;3;0;0;0
293;27.07.2016;2016;07;07;Keskiviikko;8;2;10;0;1;1
293;27.07.2016;2016;07;08;Keskiviikko;2;2;4;0;0;0
293;27.07.2016;2016;07;09;Keskiviikko;2;2;4;0;0;0
293;27.07.2016;2016;07;10;Keskiviikko;8;6;14;4;1;5
293;27.07.2016;2016;07;11;Keskiviikko;27;23;50;2;2;4
293;27.07.2016;2016;07;12;Keskiviikko;44;36;80;12;5;17
293;27.07.2016;2016;07;13;Keskiviikko;39;32;71;8;8;16
293;27.07.2016;2016;07;14;Keskiviikko;33;40;73;4;9;13
293;27.07.2016;2016;07;15;Keskiviikko;35;34;69;9;9;18
293;27.07.2016;2016;07;16;Keskiviikko;47;46;93;4;5;9
293;27.07.2016;2016;07;17;Keskiviikko;39;47;86;8;9;17
293;27.07.2016;2016;07;18;Keskiviikko;49;57;106;8;10;18
293;27.07.2016;2016;07;19;Keskiviikko;47;65;112;20;12;32
293;27.07.2016;2016;07;20;Keskiviikko;51;42;93;9;11;20
293;27.07.2016;2016;07;21;Keskiviikko;27;25;52;2;4;6
293;27.07.2016;2016;07;22;Keskiviikko;14;22;36;0;3;3
293;27.07.2016;2016;07;23;Keskiviikko;6;2;8;0;4;4
293;28.07.2016;2016;07;00;Torstai;3;7;10;0;1;1
293;28.07.2016;2016;07;01;Torstai;1;1;2;0;0;0
293;28.07.2016;2016;07;02;Torstai;1;2;3;0;1;1
293;28.07.2016;2016;07;03;Torstai;0;2;2;0;0;0
293;28.07.2016;2016;07;04;Torstai;0;0;0;0;0;0
293;28.07.2016;2016;07;05;Torstai;3;3;6;0;0;0
293;28.07.2016;2016;07;06;Torstai;16;0;16;1;0;1
293;28.07.2016;2016;07;07;Torstai;10;5;15;0;1;1
293;28.07.2016;2016;07;08;Torstai;24;3;27;2;0;2
293;28.07.2016;2016;07;09;Torstai;18;14;32;0;1;1
293;28.07.2016;2016;07;10;Torstai;20;18;38;11;4;15
293;28.07.2016;2016;07;11;Torstai;33;18;51;4;7;11
293;28.07.2016;2016;07;12;Torstai;36;45;81;16;11;27
293;28.07.2016;2016;07;13;Torstai;52;54;106;6;4;10
293;28.07.2016;2016;07;14;Torstai;45;40;85;10;6;16
293;28.07.2016;2016;07;15;Torstai;33;45;78;8;5;13
293;28.07.2016;2016;07;16;Torstai;38;51;89;6;4;10
293;28.07.2016;2016;07;17;Torstai;38;48;86;9;4;13
293;28.07.2016;2016;07;18;Torstai;65;46;111;10;6;16
293;28.07.2016;2016;07;19;Torstai;31;52;83;7;8;15
293;28.07.2016;2016;07;20;Torstai;45;31;76;3;5;8
293;28.07.2016;2016;07;21;Torstai;25;36;61;2;2;4
293;28.07.2016;2016;07;22;Torstai;16;28;44;0;3;3
293;28.07.2016;2016;07;23;Torstai;5;6;11;1;0;1
293;29.07.2016;2016;07;00;Perjantai;1;3;4;0;0;0
293;29.07.2016;2016;07;01;Perjantai;1;2;3;0;0;0
293;29.07.2016;2016;07;02;Perjantai;3;2;5;0;0;0
293;29.07.2016;2016;07;03;Perjantai;0;1;1;0;0;0
293;29.07.2016;2016;07;04;Perjantai;0;0;0;0;0;0
293;29.07.2016;2016;07;05;Perjantai;3;1;4;1;0;1
293;29.07.2016;2016;07;06;Perjantai;12;1;13;0;0;0
293;29.07.2016;2016;07;07;Perjantai;15;6;21;0;0;0
293;29.07.2016;2016;07;08;Perjantai;14;6;20;1;0;1
293;29.07.2016;2016;07;09;Perjantai;17;8;25;1;1;2
293;29.07.2016;2016;07;10;Perjantai;22;24;46;6;0;6
293;29.07.2016;2016;07;11;Perjantai;25;26;51;5;2;7
293;29.07.2016;2016;07;12;Perjantai;24;37;61;3;3;6
293;29.07.2016;2016;07;13;Perjantai;33;29;62;8;3;11
293;29.07.2016;2016;07;14;Perjantai;37;31;68;5;1;6
293;29.07.2016;2016;07;15;Perjantai;48;51;99;8;7;15
293;29.07.2016;2016;07;16;Perjantai;28;32;60;7;2;9
293;29.07.2016;2016;07;17;Perjantai;30;42;72;3;5;8
293;29.07.2016;2016;07;18;Perjantai;51;32;83;5;2;7
293;29.07.2016;2016;07;19;Perjantai;34;33;67;3;3;6
293;29.07.2016;2016;07;20;Perjantai;20;33;53;5;5;10
293;29.07.2016;2016;07;21;Perjantai;17;23;40;7;3;10
293;29.07.2016;2016;07;22;Perjantai;7;10;17;3;2;5
293;29.07.2016;2016;07;23;Perjantai;8;12;20;2;2;4
293;30.07.2016;2016;07;00;Lauantai;7;6;13;0;1;1
293;30.07.2016;2016;07;01;Lauantai;3;7;10;0;1;1
293;30.07.2016;2016;07;02;Lauantai;0;7;7;0;0;0
293;30.07.2016;2016;07;03;Lauantai;2;2;4;0;2;2
293;30.07.2016;2016;07;04;Lauantai;1;1;2;0;0;0
293;30.07.2016;2016;07;05;Lauantai;0;1;1;1;0;1
293;30.07.2016;2016;07;06;Lauantai;3;1;4;0;0;0
293;30.07.2016;2016;07;07;Lauantai;2;1;3;0;0;0
293;30.07.2016;2016;07;08;Lauantai;5;4;9;0;1;1
293;30.07.2016;2016;07;09;Lauantai;16;15;31;4;5;9
293;30.07.2016;2016;07;10;Lauantai;22;19;41;5;2;7
293;30.07.2016;2016;07;11;Lauantai;23;29;52;2;2;4
293;30.07.2016;2016;07;12;Lauantai;31;34;65;6;6;12
293;30.07.2016;2016;07;13;Lauantai;40;46;86;9;2;11
293;30.07.2016;2016;07;14;Lauantai;38;53;91;8;2;10
293;30.07.2016;2016;07;15;Lauantai;40;35;75;4;6;10
293;30.07.2016;2016;07;16;Lauantai;9;4;13;0;1;1
293;30.07.2016;2016;07;17;Lauantai;17;16;33;1;3;4
293;30.07.2016;2016;07;18;Lauantai;18;20;38;3;3;6
293;30.07.2016;2016;07;19;Lauantai;31;19;50;10;5;15
293;30.07.2016;2016;07;20;Lauantai;23;11;34;3;10;13
293;30.07.2016;2016;07;21;Lauantai;13;22;35;4;4;8
293;30.07.2016;2016;07;22;Lauantai;14;10;24;0;2;2
293;30.07.2016;2016;07;23;Lauantai;7;4;11;0;1;1
293;31.07.2016;2016;07;00;Sunnuntai;3;1;4;1;0;1
293;31.07.2016;2016;07;01;Sunnuntai;2;3;5;1;0;1
293;31.07.2016;2016;07;02;Sunnuntai;1;7;8;2;5;7
293;31.07.2016;2016;07;03;Sunnuntai;0;6;6;0;1;1
293;31.07.2016;2016;07;04;Sunnuntai;2;2;4;0;0;0
293;31.07.2016;2016;07;05;Sunnuntai;2;2;4;0;0;0
293;31.07.2016;2016;07;06;Sunnuntai;2;2;4;0;0;0
293;31.07.2016;2016;07;07;Sunnuntai;4;5;9;0;0;0
293;31.07.2016;2016;07;08;Sunnuntai;8;4;12;1;1;2
293;31.07.2016;2016;07;09;Sunnuntai;9;5;14;1;1;2
293;31.07.2016;2016;07;10;Sunnuntai;22;6;28;0;4;4
293;31.07.2016;2016;07;11;Sunnuntai;7;11;18;4;0;4
293;31.07.2016;2016;07;12;Sunnuntai;11;13;24;0;3;3
293;31.07.2016;2016;07;13;Sunnuntai;14;22;36;7;2;9
293;31.07.2016;2016;07;14;Sunnuntai;36;30;66;5;10;15
293;31.07.2016;2016;07;15;Sunnuntai;33;41;74;4;6;10
293;31.07.2016;2016;07;16;Sunnuntai;37;29;66;11;9;20
293;31.07.2016;2016;07;17;Sunnuntai;13;20;33;2;3;5
293;31.07.2016;2016;07;18;Sunnuntai;46;18;64;6;7;13
293;31.07.2016;2016;07;19;Sunnuntai;19;27;46;1;2;3
293;31.07.2016;2016;07;20;Sunnuntai;5;9;14;4;2;6
293;31.07.2016;2016;07;21;Sunnuntai;7;9;16;1;1;2
293;31.07.2016;2016;07;22;Sunnuntai;11;5;16;1;1;2
293;31.07.2016;2016;07;23;Sunnuntai;6;6;12;1;0;1
293;01.08.2016;2016;08;00;Maanantai;0;2;2;0;0;0
293;01.08.2016;2016;08;01;Maanantai;0;0;0;0;0;0
293;01.08.2016;2016;08;02;Maanantai;0;0;0;0;0;0
293;01.08.2016;2016;08;03;Maanantai;1;1;2;0;0;0
293;01.08.2016;2016;08;04;Maanantai;0;0;0;0;0;0
293;01.08.2016;2016;08;05;Maanantai;5;0;5;0;0;0
293;01.08.2016;2016;08;06;Maanantai;15;8;23;1;1;2
293;01.08.2016;2016;08;07;Maanantai;14;4;18;0;1;1
293;01.08.2016;2016;08;08;Maanantai;18;9;27;1;1;2
293;01.08.2016;2016;08;09;Maanantai;15;13;28;3;4;7
293;01.08.2016;2016;08;10;Maanantai;19;17;36;2;1;3
293;01.08.2016;2016;08;11;Maanantai;32;17;49;6;6;12
293;01.08.2016;2016;08;12;Maanantai;37;31;68;11;10;21
293;01.08.2016;2016;08;13;Maanantai;49;32;81;14;7;21
293;01.08.2016;2016;08;14;Maanantai;48;47;95;8;4;12
293;01.08.2016;2016;08;15;Maanantai;51;47;98;11;4;15
293;01.08.2016;2016;08;16;Maanantai;62;58;120;11;8;19
293;01.08.2016;2016;08;17;Maanantai;46;31;77;11;12;23
293;01.08.2016;2016;08;18;Maanantai;47;62;109;9;5;14
293;01.08.2016;2016;08;19;Maanantai;50;72;122;7;18;25
293;01.08.2016;2016;08;20;Maanantai;30;34;64;9;10;19
293;01.08.2016;2016;08;21;Maanantai;17;28;45;1;4;5
293;01.08.2016;2016;08;22;Maanantai;5;18;23;2;1;3
293;01.08.2016;2016;08;23;Maanantai;6;2;8;0;4;4
293;02.08.2016;2016;08;00;Tiistai;2;2;4;1;0;1
293;02.08.2016;2016;08;01;Tiistai;2;0;2;0;0;0
293;02.08.2016;2016;08;02;Tiistai;2;0;2;1;1;2
293;02.08.2016;2016;08;03;Tiistai;0;4;4;0;1;1
293;02.08.2016;2016;08;04;Tiistai;0;1;1;0;0;0
293;02.08.2016;2016;08;05;Tiistai;4;1;5;0;0;0
293;02.08.2016;2016;08;06;Tiistai;18;3;21;0;0;0
293;02.08.2016;2016;08;07;Tiistai;19;4;23;0;0;0
293;02.08.2016;2016;08;08;Tiistai;10;15;25;2;1;3
293;02.08.2016;2016;08;09;Tiistai;14;11;25;0;0;0
293;02.08.2016;2016;08;10;Tiistai;21;22;43;6;2;8
293;02.08.2016;2016;08;11;Tiistai;29;18;47;1;2;3
293;02.08.2016;2016;08;12;Tiistai;34;28;62;10;7;17
293;02.08.2016;2016;08;13;Tiistai;32;32;64;3;4;7
293;02.08.2016;2016;08;14;Tiistai;22;14;36;2;1;3
293;02.08.2016;2016;08;15;Tiistai;18;28;46;2;2;4
293;02.08.2016;2016;08;16;Tiistai;12;16;28;0;1;1
293;02.08.2016;2016;08;17;Tiistai;20;21;41;3;4;7
293;02.08.2016;2016;08;18;Tiistai;26;34;60;7;9;16
293;02.08.2016;2016;08;19;Tiistai;39;21;60;7;4;11
293;02.08.2016;2016;08;20;Tiistai;26;34;60;7;6;13
293;02.08.2016;2016;08;21;Tiistai;15;26;41;3;5;8
293;02.08.2016;2016;08;22;Tiistai;6;18;24;4;1;5
293;02.08.2016;2016;08;23;Tiistai;1;2;3;0;0;0
293;03.08.2016;2016;08;00;Keskiviikko;0;1;1;0;0;0
293;03.08.2016;2016;08;01;Keskiviikko;3;0;3;0;0;0
293;03.08.2016;2016;08;02;Keskiviikko;0;0;0;0;0;0
293;03.08.2016;2016;08;03;Keskiviikko;2;1;3;0;0;0
293;03.08.2016;2016;08;04;Keskiviikko;0;0;0;0;0;0
293;03.08.2016;2016;08;05;Keskiviikko;4;0;4;0;0;0
293;03.08.2016;2016;08;06;Keskiviikko;12;7;19;0;0;0
293;03.08.2016;2016;08;07;Keskiviikko;15;9;24;3;1;4
293;03.08.2016;2016;08;08;Keskiviikko;12;8;20;0;2;2
293;03.08.2016;2016;08;09;Keskiviikko;19;8;27;3;0;3
293;03.08.2016;2016;08;10;Keskiviikko;18;19;37;6;2;8
293;03.08.2016;2016;08;11;Keskiviikko;28;28;56;0;5;5
293;03.08.2016;2016;08;12;Keskiviikko;37;24;61;10;5;15
293;03.08.2016;2016;08;13;Keskiviikko;34;41;75;3;5;8
293;03.08.2016;2016;08;14;Keskiviikko;42;38;80;10;5;15
293;03.08.2016;2016;08;15;Keskiviikko;7;22;29;2;1;3
293;03.08.2016;2016;08;16;Keskiviikko;13;17;30;2;2;4
293;03.08.2016;2016;08;17;Keskiviikko;16;8;24;2;3;5
293;03.08.2016;2016;08;18;Keskiviikko;23;9;32;4;2;6
293;03.08.2016;2016;08;19;Keskiviikko;33;35;68;3;9;12
293;03.08.2016;2016;08;20;Keskiviikko;19;49;68;5;0;5
293;03.08.2016;2016;08;21;Keskiviikko;18;34;52;1;5;6
293;03.08.2016;2016;08;22;Keskiviikko;11;12;23;6;5;11
293;03.08.2016;2016;08;23;Keskiviikko;4;2;6;0;0;0
293;04.08.2016;2016;08;00;Torstai;2;3;5;0;2;2
293;04.08.2016;2016;08;01;Torstai;4;0;4;2;0;2
293;04.08.2016;2016;08;02;Torstai;4;1;5;0;0;0
293;04.08.2016;2016;08;03;Torstai;3;0;3;0;0;0
293;04.08.2016;2016;08;04;Torstai;0;0;0;0;0;0
293;04.08.2016;2016;08;05;Torstai;4;0;4;0;1;1
293;04.08.2016;2016;08;06;Torstai;18;1;19;0;0;0
293;04.08.2016;2016;08;07;Torstai;17;6;23;1;0;1
293;04.08.2016;2016;08;08;Torstai;7;9;16;1;0;1
293;04.08.2016;2016;08;09;Torstai;29;7;36;2;1;3
293;04.08.2016;2016;08;10;Torstai;19;18;37;6;2;8
293;04.08.2016;2016;08;11;Torstai;36;30;66;6;4;10
293;04.08.2016;2016;08;12;Torstai;43;25;68;8;5;13
293;04.08.2016;2016;08;13;Torstai;46;56;102;8;3;11
293;04.08.2016;2016;08;14;Torstai;55;43;98;7;8;15
293;04.08.2016;2016;08;15;Torstai;38;51;89;1;1;2
293;04.08.2016;2016;08;16;Torstai;29;47;76;2;7;9
293;04.08.2016;2016;08;17;Torstai;38;35;73;6;5;11
293;04.08.2016;2016;08;18;Torstai;22;20;42;4;4;8
293;04.08.2016;2016;08;19;Torstai;29;24;53;8;5;13
293;04.08.2016;2016;08;20;Torstai;20;41;61;5;3;8
293;04.08.2016;2016;08;21;Torstai;9;22;31;4;3;7
293;04.08.2016;2016;08;22;Torstai;19;10;29;3;5;8
293;04.08.2016;2016;08;23;Torstai;1;10;11;1;4;5
293;05.08.2016;2016;08;00;Perjantai;0;0;0;0;1;1
293;05.08.2016;2016;08;01;Perjantai;4;1;5;0;1;1
293;05.08.2016;2016;08;02;Perjantai;1;0;1;0;0;0
293;05.08.2016;2016;08;03;Perjantai;0;0;0;0;0;0
293;05.08.2016;2016;08;04;Perjantai;0;0;0;0;0;0
293;05.08.2016;2016;08;05;Perjantai;1;0;1;0;0;0
293;05.08.2016;2016;08;06;Perjantai;9;2;11;0;0;0
293;05.08.2016;2016;08;07;Perjantai;8;3;11;0;0;0
293;05.08.2016;2016;08;08;Perjantai;6;6;12;3;1;4
293;05.08.2016;2016;08;09;Perjantai;16;8;24;3;1;4
293;05.08.2016;2016;08;10;Perjantai;13;7;20;4;1;5
293;05.08.2016;2016;08;11;Perjantai;10;16;26;3;3;6
293;05.08.2016;2016;08;12;Perjantai;33;22;55;4;2;6
293;05.08.2016;2016;08;13;Perjantai;43;27;70;9;6;15
293;05.08.2016;2016;08;14;Perjantai;31;29;60;10;3;13
293;05.08.2016;2016;08;15;Perjantai;25;31;56;8;5;13
293;05.08.2016;2016;08;16;Perjantai;27;25;52;10;9;19
293;05.08.2016;2016;08;17;Perjantai;45;32;77;8;3;11
293;05.08.2016;2016;08;18;Perjantai;34;42;76;8;10;18
293;05.08.2016;2016;08;19;Perjantai;29;44;73;3;8;11
293;05.08.2016;2016;08;20;Perjantai;20;37;57;4;13;17
293;05.08.2016;2016;08;21;Perjantai;17;25;42;5;3;8
293;05.08.2016;2016;08;22;Perjantai;12;12;24;2;1;3
293;05.08.2016;2016;08;23;Perjantai;11;4;15;1;0;1
293;06.08.2016;2016;08;00;Lauantai;7;7;14;1;0;1
293;06.08.2016;2016;08;01;Lauantai;2;4;6;11;5;16
293;06.08.2016;2016;08;02;Lauantai;0;3;3;2;0;2
293;06.08.2016;2016;08;03;Lauantai;0;9;9;0;2;2
293;06.08.2016;2016;08;04;Lauantai;1;1;2;1;1;2
293;06.08.2016;2016;08;05;Lauantai;1;2;3;0;0;0
293;06.08.2016;2016;08;06;Lauantai;4;2;6;0;0;0
293;06.08.2016;2016;08;07;Lauantai;8;0;8;0;0;0
293;06.08.2016;2016;08;08;Lauantai;9;6;15;2;2;4
293;06.08.2016;2016;08;09;Lauantai;14;16;30;4;2;6
293;06.08.2016;2016;08;10;Lauantai;24;17;41;11;4;15
293;06.08.2016;2016;08;11;Lauantai;32;26;58;5;8;13
293;06.08.2016;2016;08;12;Lauantai;35;25;60;6;5;11
293;06.08.2016;2016;08;13;Lauantai;30;30;60;3;6;9
293;06.08.2016;2016;08;14;Lauantai;37;38;75;4;3;7
293;06.08.2016;2016;08;15;Lauantai;40;25;65;1;3;4
293;06.08.2016;2016;08;16;Lauantai;21;33;54;8;5;13
293;06.08.2016;2016;08;17;Lauantai;33;39;72;6;4;10
293;06.08.2016;2016;08;18;Lauantai;37;54;91;4;5;9
293;06.08.2016;2016;08;19;Lauantai;31;41;72;5;9;14
293;06.08.2016;2016;08;20;Lauantai;38;44;82;3;6;9
293;06.08.2016;2016;08;21;Lauantai;24;18;42;3;4;7
293;06.08.2016;2016;08;22;Lauantai;18;13;31;0;0;0
293;06.08.2016;2016;08;23;Lauantai;7;14;21;2;3;5
293;07.08.2016;2016;08;00;Sunnuntai;3;9;12;1;0;1
293;07.08.2016;2016;08;01;Sunnuntai;4;2;6;0;0;0
293;07.08.2016;2016;08;02;Sunnuntai;1;4;5;0;1;1
293;07.08.2016;2016;08;03;Sunnuntai;0;3;3;4;5;9
293;07.08.2016;2016;08;04;Sunnuntai;3;1;4;0;0;0
293;07.08.2016;2016;08;05;Sunnuntai;0;5;5;0;0;0
293;07.08.2016;2016;08;06;Sunnuntai;3;2;5;0;0;0
293;07.08.2016;2016;08;07;Sunnuntai;5;6;11;0;1;1
293;07.08.2016;2016;08;08;Sunnuntai;7;2;9;1;1;2
293;07.08.2016;2016;08;09;Sunnuntai;22;13;35;7;2;9
293;07.08.2016;2016;08;10;Sunnuntai;23;15;38;3;9;12
293;07.08.2016;2016;08;11;Sunnuntai;33;27;60;6;5;11
293;07.08.2016;2016;08;12;Sunnuntai;34;28;62;10;4;14
293;07.08.2016;2016;08;13;Sunnuntai;31;34;65;6;4;10
293;07.08.2016;2016;08;14;Sunnuntai;44;24;68;4;4;8
293;07.08.2016;2016;08;15;Sunnuntai;27;40;67;3;6;9
293;07.08.2016;2016;08;16;Sunnuntai;19;43;62;3;5;8
293;07.08.2016;2016;08;17;Sunnuntai;33;31;64;10;5;15
293;07.08.2016;2016;08;18;Sunnuntai;35;41;76;6;8;14
293;07.08.2016;2016;08;19;Sunnuntai;30;40;70;13;6;19
293;07.08.2016;2016;08;20;Sunnuntai;38;27;65;5;12;17
293;07.08.2016;2016;08;21;Sunnuntai;15;13;28;3;4;7
293;07.08.2016;2016;08;22;Sunnuntai;7;10;17;0;0;0
293;07.08.2016;2016;08;23;Sunnuntai;2;5;7;0;0;0
293;08.08.2016;2016;08;00;Maanantai;1;0;1;0;0;0
293;08.08.2016;2016;08;01;Maanantai;0;2;2;0;0;0
293;08.08.2016;2016;08;02;Maanantai;0;0;0;0;0;0
293;08.08.2016;2016;08;03;Maanantai;0;0;0;0;0;0
293;08.08.2016;2016;08;04;Maanantai;0;0;0;0;0;0
293;08.08.2016;2016;08;05;Maanantai;5;0;5;4;0;4
293;08.08.2016;2016;08;06;Maanantai;26;5;31;1;1;2
293;08.08.2016;2016;08;07;Maanantai;19;11;30;1;1;2
293;08.08.2016;2016;08;08;Maanantai;26;19;45;1;1;2
293;08.08.2016;2016;08;09;Maanantai;18;17;35;3;4;7
293;08.08.2016;2016;08;10;Maanantai;31;17;48;7;3;10
293;08.08.2016;2016;08;11;Maanantai;41;36;77;3;3;6
293;08.08.2016;2016;08;12;Maanantai;29;30;59;9;6;15
293;08.08.2016;2016;08;13;Maanantai;54;58;112;9;3;12
293;08.08.2016;2016;08;14;Maanantai;42;42;84;12;4;16
293;08.08.2016;2016;08;15;Maanantai;51;50;101;8;7;15
293;08.08.2016;2016;08;16;Maanantai;40;56;96;7;8;15
293;08.08.2016;2016;08;17;Maanantai;32;35;67;3;3;6
293;08.08.2016;2016;08;18;Maanantai;23;30;53;2;4;6
293;08.08.2016;2016;08;19;Maanantai;27;28;55;3;3;6
293;08.08.2016;2016;08;20;Maanantai;26;46;72;2;6;8
293;08.08.2016;2016;08;21;Maanantai;15;19;34;4;3;7
293;08.08.2016;2016;08;22;Maanantai;17;8;25;1;1;2
293;08.08.2016;2016;08;23;Maanantai;5;4;9;0;1;1
293;09.08.2016;2016;08;00;Tiistai;2;3;5;1;0;1
293;09.08.2016;2016;08;01;Tiistai;1;0;1;0;0;0
293;09.08.2016;2016;08;02;Tiistai;2;1;3;0;1;1
293;09.08.2016;2016;08;03;Tiistai;0;0;0;0;0;0
293;09.08.2016;2016;08;04;Tiistai;0;0;0;0;0;0
293;09.08.2016;2016;08;05;Tiistai;3;1;4;1;0;1
293;09.08.2016;2016;08;06;Tiistai;17;3;20;1;0;1
293;09.08.2016;2016;08;07;Tiistai;23;10;33;0;1;1
293;09.08.2016;2016;08;08;Tiistai;16;17;33;0;1;1
293;09.08.2016;2016;08;09;Tiistai;19;11;30;4;0;4
293;09.08.2016;2016;08;10;Tiistai;19;17;36;3;5;8
293;09.08.2016;2016;08;11;Tiistai;21;14;35;2;2;4
293;09.08.2016;2016;08;12;Tiistai;24;23;47;4;1;5
293;09.08.2016;2016;08;13;Tiistai;25;5;30;4;2;6
293;09.08.2016;2016;08;14;Tiistai;29;42;71;5;2;7
293;09.08.2016;2016;08;15;Tiistai;28;30;58;3;1;4
293;09.08.2016;2016;08;16;Tiistai;20;34;54;3;4;7
293;09.08.2016;2016;08;17;Tiistai;32;23;55;2;3;5
293;09.08.2016;2016;08;18;Tiistai;10;17;27;2;4;6
293;09.08.2016;2016;08;19;Tiistai;15;26;41;2;3;5
293;09.08.2016;2016;08;20;Tiistai;11;16;27;2;4;6
293;09.08.2016;2016;08;21;Tiistai;7;14;21;1;0;1
293;09.08.2016;2016;08;22;Tiistai;2;2;4;0;1;1
293;09.08.2016;2016;08;23;Tiistai;1;0;1;0;0;0
293;10.08.2016;2016;08;00;Keskiviikko;0;0;0;0;0;0
293;10.08.2016;2016;08;01;Keskiviikko;0;0;0;0;0;0
293;10.08.2016;2016;08;02;Keskiviikko;2;1;3;0;0;0
293;10.08.2016;2016;08;03;Keskiviikko;0;1;1;0;0;0
293;10.08.2016;2016;08;04;Keskiviikko;0;0;0;0;0;0
293;10.08.2016;2016;08;05;Keskiviikko;4;1;5;0;0;0
293;10.08.2016;2016;08;06;Keskiviikko;9;4;13;0;1;1
293;10.08.2016;2016;08;07;Keskiviikko;15;5;20;0;0;0
293;10.08.2016;2016;08;08;Keskiviikko;171;10;181;4;0;4
293;10.08.2016;2016;08;09;Keskiviikko;14;4;18;1;0;1
293;10.08.2016;2016;08;10;Keskiviikko;42;10;52;4;5;9
293;10.08.2016;2016;08;11;Keskiviikko;14;12;26;2;4;6
293;10.08.2016;2016;08;12;Keskiviikko;28;83;111;5;7;12
293;10.08.2016;2016;08;13;Keskiviikko;25;135;160;5;4;9
293;10.08.2016;2016;08;14;Keskiviikko;41;32;73;4;4;8
293;10.08.2016;2016;08;15;Keskiviikko;32;47;79;4;4;8
293;10.08.2016;2016;08;16;Keskiviikko;33;49;82;4;2;6
293;10.08.2016;2016;08;17;Keskiviikko;24;20;44;2;4;6
293;10.08.2016;2016;08;18;Keskiviikko;33;30;63;11;6;17
293;10.08.2016;2016;08;19;Keskiviikko;10;27;37;2;4;6
293;10.08.2016;2016;08;20;Keskiviikko;10;15;25;4;3;7
293;10.08.2016;2016;08;21;Keskiviikko;3;11;14;5;1;6
293;10.08.2016;2016;08;22;Keskiviikko;0;2;2;0;3;3
293;10.08.2016;2016;08;23;Keskiviikko;2;1;3;0;0;0
293;11.08.2016;2016;08;00;Torstai;1;0;1;0;0;0
293;11.08.2016;2016;08;01;Torstai;0;0;0;0;0;0
293;11.08.2016;2016;08;02;Torstai;0;1;1;0;0;0
293;11.08.2016;2016;08;03;Torstai;0;1;1;0;0;0
293;11.08.2016;2016;08;04;Torstai;0;2;2;0;0;0
293;11.08.2016;2016;08;05;Torstai;10;1;11;0;0;0
293;11.08.2016;2016;08;06;Torstai;18;2;20;0;0;0
293;11.08.2016;2016;08;07;Torstai;52;7;59;5;0;5
293;11.08.2016;2016;08;08;Torstai;157;11;168;10;0;10
293;11.08.2016;2016;08;09;Torstai;30;15;45;4;6;10
293;11.08.2016;2016;08;10;Torstai;23;17;40;1;2;3
293;11.08.2016;2016;08;11;Torstai;12;12;24;8;2;10
293;11.08.2016;2016;08;12;Torstai;16;17;33;2;7;9
293;11.08.2016;2016;08;13;Torstai;14;162;176;2;10;12
293;11.08.2016;2016;08;14;Torstai;37;45;82;5;3;8
293;11.08.2016;2016;08;15;Torstai;41;85;126;4;9;13
293;11.08.2016;2016;08;16;Torstai;13;32;45;2;4;6
293;11.08.2016;2016;08;17;Torstai;12;22;34;1;1;2
293;11.08.2016;2016;08;18;Torstai;9;18;27;2;2;4
293;11.08.2016;2016;08;19;Torstai;13;15;28;9;4;13
293;11.08.2016;2016;08;20;Torstai;10;8;18;4;7;11
293;11.08.2016;2016;08;21;Torstai;9;18;27;1;1;2
293;11.08.2016;2016;08;22;Torstai;0;2;2;0;0;0
293;11.08.2016;2016;08;23;Torstai;2;1;3;1;0;1
293;12.08.2016;2016;08;00;Perjantai;0;3;3;0;0;0
293;12.08.2016;2016;08;01;Perjantai;0;1;1;0;0;0
293;12.08.2016;2016;08;02;Perjantai;0;0;0;0;1;1
293;12.08.2016;2016;08;03;Perjantai;0;0;0;0;0;0
293;12.08.2016;2016;08;04;Perjantai;0;0;0;0;0;0
293;12.08.2016;2016;08;05;Perjantai;4;1;5;1;0;1
293;12.08.2016;2016;08;06;Perjantai;12;2;14;1;0;1
293;12.08.2016;2016;08;07;Perjantai;88;6;94;4;0;4
293;12.08.2016;2016;08;08;Perjantai;88;12;100;8;0;8
293;12.08.2016;2016;08;09;Perjantai;29;4;33;3;1;4
293;12.08.2016;2016;08;10;Perjantai;15;4;19;1;2;3
293;12.08.2016;2016;08;11;Perjantai;10;4;14;3;0;3
293;12.08.2016;2016;08;12;Perjantai;10;16;26;3;3;6
293;12.08.2016;2016;08;13;Perjantai;17;80;97;6;13;19
293;12.08.2016;2016;08;14;Perjantai;11;81;92;3;5;8
293;12.08.2016;2016;08;15;Perjantai;10;48;58;2;3;5
293;12.08.2016;2016;08;16;Perjantai;18;22;40;5;0;5
293;12.08.2016;2016;08;17;Perjantai;12;14;26;7;4;11
293;12.08.2016;2016;08;18;Perjantai;27;24;51;4;10;14
293;12.08.2016;2016;08;19;Perjantai;26;30;56;8;4;12
293;12.08.2016;2016;08;20;Perjantai;14;30;44;4;5;9
293;12.08.2016;2016;08;21;Perjantai;6;15;21;3;4;7
293;12.08.2016;2016;08;22;Perjantai;15;11;26;3;0;3
293;12.08.2016;2016;08;23;Perjantai;4;1;5;0;4;4
293;13.08.2016;2016;08;00;Lauantai;3;2;5;1;1;2
293;13.08.2016;2016;08;01;Lauantai;2;0;2;1;0;1
293;13.08.2016;2016;08;02;Lauantai;1;4;5;0;0;0
293;13.08.2016;2016;08;03;Lauantai;0;1;1;0;0;0
293;13.08.2016;2016;08;04;Lauantai;0;1;1;0;0;0
293;13.08.2016;2016;08;05;Lauantai;0;3;3;0;0;0
293;13.08.2016;2016;08;06;Lauantai;4;4;8;1;1;2
293;13.08.2016;2016;08;07;Lauantai;2;1;3;0;1;1
293;13.08.2016;2016;08;08;Lauantai;8;2;10;1;2;3
293;13.08.2016;2016;08;09;Lauantai;13;12;25;2;4;6
293;13.08.2016;2016;08;10;Lauantai;3;9;12;1;1;2
293;13.08.2016;2016;08;11;Lauantai;12;12;24;2;2;4
293;13.08.2016;2016;08;12;Lauantai;3;11;14;2;0;2
293;13.08.2016;2016;08;13;Lauantai;8;7;15;2;1;3
293;13.08.2016;2016;08;14;Lauantai;1;7;8;0;1;1
293;13.08.2016;2016;08;15;Lauantai;7;4;11;1;0;1
293;13.08.2016;2016;08;16;Lauantai;8;4;12;1;1;2
293;13.08.2016;2016;08;17;Lauantai;7;2;9;2;3;5
293;13.08.2016;2016;08;18;Lauantai;7;6;13;7;2;9
293;13.08.2016;2016;08;19;Lauantai;12;11;23;0;7;7
293;13.08.2016;2016;08;20;Lauantai;10;7;17;2;1;3
293;13.08.2016;2016;08;21;Lauantai;6;13;19;2;2;4
293;13.08.2016;2016;08;22;Lauantai;2;3;5;0;1;1
293;13.08.2016;2016;08;23;Lauantai;2;3;5;3;1;4
293;14.08.2016;2016;08;00;Sunnuntai;1;0;1;2;1;3
293;14.08.2016;2016;08;01;Sunnuntai;0;0;0;0;0;0
293;14.08.2016;2016;08;02;Sunnuntai;1;1;2;1;2;3
293;14.08.2016;2016;08;03;Sunnuntai;2;2;4;3;1;4
293;14.08.2016;2016;08;04;Sunnuntai;0;3;3;1;0;1
293;14.08.2016;2016;08;05;Sunnuntai;1;1;2;0;0;0
293;14.08.2016;2016;08;06;Sunnuntai;2;0;2;0;0;0
293;14.08.2016;2016;08;07;Sunnuntai;0;1;1;0;1;1
293;14.08.2016;2016;08;08;Sunnuntai;6;1;7;0;1;1
293;14.08.2016;2016;08;09;Sunnuntai;14;4;18;3;2;5
293;14.08.2016;2016;08;10;Sunnuntai;18;12;30;3;4;7
293;14.08.2016;2016;08;11;Sunnuntai;24;23;47;5;3;8
293;14.08.2016;2016;08;12;Sunnuntai;31;26;57;14;7;21
293;14.08.2016;2016;08;13;Sunnuntai;43;41;84;9;5;14
293;14.08.2016;2016;08;14;Sunnuntai;21;29;50;6;6;12
293;14.08.2016;2016;08;15;Sunnuntai;30;21;51;6;2;8
293;14.08.2016;2016;08;16;Sunnuntai;36;18;54;11;5;16
293;14.08.2016;2016;08;17;Sunnuntai;32;45;77;17;11;28
293;14.08.2016;2016;08;18;Sunnuntai;58;39;97;3;8;11
293;14.08.2016;2016;08;19;Sunnuntai;39;53;92;5;8;13
293;14.08.2016;2016;08;20;Sunnuntai;31;20;51;2;3;5
293;14.08.2016;2016;08;21;Sunnuntai;4;24;28;4;2;6
293;14.08.2016;2016;08;22;Sunnuntai;2;3;5;0;1;1
293;14.08.2016;2016;08;23;Sunnuntai;3;3;6;0;0;0
293;15.08.2016;2016;08;00;Maanantai;0;0;0;0;0;0
293;15.08.2016;2016;08;01;Maanantai;0;0;0;0;0;0
293;15.08.2016;2016;08;02;Maanantai;0;0;0;0;0;0
293;15.08.2016;2016;08;03;Maanantai;0;0;0;0;0;0
293;15.08.2016;2016;08;04;Maanantai;0;0;0;0;0;0
293;15.08.2016;2016;08;05;Maanantai;7;0;7;0;0;0
293;15.08.2016;2016;08;06;Maanantai;19;1;20;0;1;1
293;15.08.2016;2016;08;07;Maanantai;147;7;154;4;0;4
293;15.08.2016;2016;08;08;Maanantai;61;15;76;2;0;2
293;15.08.2016;2016;08;09;Maanantai;25;14;39;5;3;8
293;15.08.2016;2016;08;10;Maanantai;21;10;31;7;2;9
293;15.08.2016;2016;08;11;Maanantai;20;15;35;4;2;6
293;15.08.2016;2016;08;12;Maanantai;20;14;34;3;2;5
293;15.08.2016;2016;08;13;Maanantai;15;56;71;2;5;7
293;15.08.2016;2016;08;14;Maanantai;25;92;117;4;1;5
293;15.08.2016;2016;08;15;Maanantai;22;116;138;6;8;14
293;15.08.2016;2016;08;16;Maanantai;32;55;87;6;6;12
293;15.08.2016;2016;08;17;Maanantai;56;40;96;8;11;19
293;15.08.2016;2016;08;18;Maanantai;39;36;75;14;15;29
293;15.08.2016;2016;08;19;Maanantai;37;59;96;6;15;21
293;15.08.2016;2016;08;20;Maanantai;18;37;55;5;7;12
293;15.08.2016;2016;08;21;Maanantai;6;11;17;1;1;2
293;15.08.2016;2016;08;22;Maanantai;4;3;7;0;1;1
293;15.08.2016;2016;08;23;Maanantai;1;0;1;0;0;0
293;16.08.2016;2016;08;00;Tiistai;0;0;0;0;0;0
293;16.08.2016;2016;08;01;Tiistai;0;0;0;0;0;0
293;16.08.2016;2016;08;02;Tiistai;2;1;3;0;0;0
293;16.08.2016;2016;08;03;Tiistai;0;0;0;0;0;0
293;16.08.2016;2016;08;04;Tiistai;0;0;0;0;0;0
293;16.08.2016;2016;08;05;Tiistai;3;1;4;1;0;1
293;16.08.2016;2016;08;06;Tiistai;25;2;27;1;0;1
293;16.08.2016;2016;08;07;Tiistai;99;7;106;1;0;1
293;16.08.2016;2016;08;08;Tiistai;61;13;74;4;0;4
293;16.08.2016;2016;08;09;Tiistai;69;13;82;1;1;2
293;16.08.2016;2016;08;10;Tiistai;22;7;29;5;3;8
293;16.08.2016;2016;08;11;Tiistai;17;9;26;5;2;7
293;16.08.2016;2016;08;12;Tiistai;11;17;28;1;5;6
293;16.08.2016;2016;08;13;Tiistai;11;20;31;6;3;9
293;16.08.2016;2016;08;14;Tiistai;10;70;80;1;2;3
293;16.08.2016;2016;08;15;Tiistai;15;142;157;1;2;3
293;16.08.2016;2016;08;16;Tiistai;20;18;38;2;2;4
293;16.08.2016;2016;08;17;Tiistai;18;15;33;6;5;11
293;16.08.2016;2016;08;18;Tiistai;19;13;32;7;8;15
293;16.08.2016;2016;08;19;Tiistai;12;21;33;5;12;17
293;16.08.2016;2016;08;20;Tiistai;8;24;32;5;4;9
293;16.08.2016;2016;08;21;Tiistai;6;9;15;2;2;4
293;16.08.2016;2016;08;22;Tiistai;3;3;6;2;0;2
293;16.08.2016;2016;08;23;Tiistai;1;0;1;0;1;1
293;17.08.2016;2016;08;00;Keskiviikko;0;0;0;0;0;0
293;17.08.2016;2016;08;01;Keskiviikko;0;1;1;0;0;0
293;17.08.2016;2016;08;02;Keskiviikko;1;0;1;0;0;0
293;17.08.2016;2016;08;03;Keskiviikko;0;0;0;0;0;0
293;17.08.2016;2016;08;04;Keskiviikko;0;0;0;2;0;2
293;17.08.2016;2016;08;05;Keskiviikko;5;0;5;1;0;1
293;17.08.2016;2016;08;06;Keskiviikko;15;2;17;0;2;2
293;17.08.2016;2016;08;07;Keskiviikko;137;10;147;14;0;14
293;17.08.2016;2016;08;08;Keskiviikko;72;12;84;3;1;4
293;17.08.2016;2016;08;09;Keskiviikko;19;8;27;5;0;5
293;17.08.2016;2016;08;10;Keskiviikko;10;8;18;2;2;4
293;17.08.2016;2016;08;11;Keskiviikko;9;10;19;2;2;4
293;17.08.2016;2016;08;12;Keskiviikko;24;23;47;4;1;5
293;17.08.2016;2016;08;13;Keskiviikko;17;38;55;8;3;11
293;17.08.2016;2016;08;14;Keskiviikko;23;164;187;2;18;20
293;17.08.2016;2016;08;15;Keskiviikko;32;57;89;6;7;13
293;17.08.2016;2016;08;16;Keskiviikko;34;31;65;4;7;11
293;17.08.2016;2016;08;17;Keskiviikko;55;42;97;3;7;10
293;17.08.2016;2016;08;18;Keskiviikko;37;45;82;8;6;14
293;17.08.2016;2016;08;19;Keskiviikko;25;50;75;7;6;13
293;17.08.2016;2016;08;20;Keskiviikko;12;30;42;8;10;18
293;17.08.2016;2016;08;21;Keskiviikko;8;10;18;1;1;2
293;17.08.2016;2016;08;22;Keskiviikko;3;4;7;1;0;1
293;17.08.2016;2016;08;23;Keskiviikko;0;0;0;1;0;1
293;18.08.2016;2016;08;00;Torstai;0;0;0;0;1;1
293;18.08.2016;2016;08;01;Torstai;0;2;2;0;0;0
293;18.08.2016;2016;08;02;Torstai;1;0;1;0;0;0
293;18.08.2016;2016;08;03;Torstai;0;1;1;0;0;0
293;18.08.2016;2016;08;04;Torstai;0;0;0;0;1;1
293;18.08.2016;2016;08;05;Torstai;5;0;5;2;0;2
293;18.08.2016;2016;08;06;Torstai;20;1;21;0;0;0
293;18.08.2016;2016;08;07;Torstai;122;11;133;3;0;3
293;18.08.2016;2016;08;08;Torstai;91;11;102;5;4;9
293;18.08.2016;2016;08;09;Torstai;47;15;62;5;3;8
293;18.08.2016;2016;08;10;Torstai;13;16;29;4;1;5
293;18.08.2016;2016;08;11;Torstai;26;19;45;4;5;9
293;18.08.2016;2016;08;12;Torstai;19;27;46;10;3;13
293;18.08.2016;2016;08;13;Torstai;18;55;73;3;9;12
293;18.08.2016;2016;08;14;Torstai;26;126;152;4;5;9
293;18.08.2016;2016;08;15;Torstai;28;90;118;1;9;10
293;18.08.2016;2016;08;16;Torstai;44;44;88;4;3;7
293;18.08.2016;2016;08;17;Torstai;29;37;66;6;7;13
293;18.08.2016;2016;08;18;Torstai;28;35;63;9;7;16
293;18.08.2016;2016;08;19;Torstai;40;47;87;4;12;16
293;18.08.2016;2016;08;20;Torstai;21;33;54;2;3;5
293;18.08.2016;2016;08;21;Torstai;8;19;27;1;2;3
293;18.08.2016;2016;08;22;Torstai;1;5;6;1;1;2
293;18.08.2016;2016;08;23;Torstai;1;2;3;0;0;0
293;19.08.2016;2016;08;00;Perjantai;0;2;2;0;0;0
293;19.08.2016;2016;08;01;Perjantai;0;1;1;0;0;0
293;19.08.2016;2016;08;02;Perjantai;0;0;0;0;0;0
293;19.08.2016;2016;08;03;Perjantai;0;0;0;0;0;0
293;19.08.2016;2016;08;04;Perjantai;0;0;0;0;0;0
293;19.08.2016;2016;08;05;Perjantai;5;2;7;0;1;1
293;19.08.2016;2016;08;06;Perjantai;21;3;24;1;0;1
293;19.08.2016;2016;08;07;Perjantai;82;5;87;2;1;3
293;19.08.2016;2016;08;08;Perjantai;52;2;54;1;1;2
293;19.08.2016;2016;08;09;Perjantai;40;6;46;1;1;2
293;19.08.2016;2016;08;10;Perjantai;18;9;27;0;0;0
293;19.08.2016;2016;08;11;Perjantai;24;12;36;5;0;5
293;19.08.2016;2016;08;12;Perjantai;26;30;56;5;5;10
293;19.08.2016;2016;08;13;Perjantai;20;56;76;2;5;7
293;19.08.2016;2016;08;14;Perjantai;24;84;108;2;7;9
293;19.08.2016;2016;08;15;Perjantai;20;60;80;5;5;10
293;19.08.2016;2016;08;16;Perjantai;12;28;40;1;4;5
293;19.08.2016;2016;08;17;Perjantai;21;13;34;1;3;4
293;19.08.2016;2016;08;18;Perjantai;28;25;53;2;6;8
293;19.08.2016;2016;08;19;Perjantai;20;28;48;7;3;10
293;19.08.2016;2016;08;20;Perjantai;23;31;54;4;3;7
293;19.08.2016;2016;08;21;Perjantai;11;22;33;1;1;2
293;19.08.2016;2016;08;22;Perjantai;15;7;22;1;1;2
293;19.08.2016;2016;08;23;Perjantai;10;2;12;0;1;1
293;20.08.2016;2016;08;00;Lauantai;2;3;5;2;0;2
293;20.08.2016;2016;08;01;Lauantai;4;2;6;0;0;0
293;20.08.2016;2016;08;02;Lauantai;0;4;4;0;3;3
293;20.08.2016;2016;08;03;Lauantai;0;0;0;0;2;2
293;20.08.2016;2016;08;04;Lauantai;0;2;2;0;2;2
293;20.08.2016;2016;08;05;Lauantai;4;4;8;0;0;0
293;20.08.2016;2016;08;06;Lauantai;4;0;4;0;0;0
293;20.08.2016;2016;08;07;Lauantai;2;1;3;0;1;1
293;20.08.2016;2016;08;08;Lauantai;12;1;13;0;0;0
293;20.08.2016;2016;08;09;Lauantai;18;14;32;5;2;7
293;20.08.2016;2016;08;10;Lauantai;33;18;51;7;7;14
293;20.08.2016;2016;08;11;Lauantai;21;25;46;10;6;16
293;20.08.2016;2016;08;12;Lauantai;24;32;56;2;1;3
293;20.08.2016;2016;08;13;Lauantai;29;34;63;6;4;10
293;20.08.2016;2016;08;14;Lauantai;44;35;79;9;3;12
293;20.08.2016;2016;08;15;Lauantai;34;33;67;5;8;13
293;20.08.2016;2016;08;16;Lauantai;19;27;46;0;7;7
293;20.08.2016;2016;08;17;Lauantai;32;31;63;6;1;7
293;20.08.2016;2016;08;18;Lauantai;14;12;26;1;5;6
293;20.08.2016;2016;08;19;Lauantai;13;18;31;3;3;6
293;20.08.2016;2016;08;20;Lauantai;8;12;20;0;4;4
293;20.08.2016;2016;08;21;Lauantai;3;11;14;0;1;1
293;20.08.2016;2016;08;22;Lauantai;6;3;9;1;2;3
293;20.08.2016;2016;08;23;Lauantai;6;2;8;2;0;2
293;21.08.2016;2016;08;00;Sunnuntai;4;0;4;0;0;0
293;21.08.2016;2016;08;01;Sunnuntai;0;11;11;1;0;1
293;21.08.2016;2016;08;02;Sunnuntai;0;3;3;0;0;0
293;21.08.2016;2016;08;03;Sunnuntai;0;0;0;0;0;0
293;21.08.2016;2016;08;04;Sunnuntai;1;1;2;1;1;2
293;21.08.2016;2016;08;05;Sunnuntai;0;2;2;0;1;1
293;21.08.2016;2016;08;06;Sunnuntai;7;0;7;0;0;0
293;21.08.2016;2016;08;07;Sunnuntai;1;1;2;1;0;1
293;21.08.2016;2016;08;08;Sunnuntai;2;1;3;0;1;1
293;21.08.2016;2016;08;09;Sunnuntai;4;7;11;2;2;4
293;21.08.2016;2016;08;10;Sunnuntai;11;11;22;2;2;4
293;21.08.2016;2016;08;11;Sunnuntai;13;11;24;3;1;4
293;21.08.2016;2016;08;12;Sunnuntai;28;20;48;5;4;9
293;21.08.2016;2016;08;13;Sunnuntai;22;24;46;6;1;7
293;21.08.2016;2016;08;14;Sunnuntai;30;26;56;4;4;8
293;21.08.2016;2016;08;15;Sunnuntai;26;29;55;4;2;6
293;21.08.2016;2016;08;16;Sunnuntai;36;40;76;12;7;19
293;21.08.2016;2016;08;17;Sunnuntai;25;36;61;8;3;11
293;21.08.2016;2016;08;18;Sunnuntai;25;36;61;4;4;8
293;21.08.2016;2016;08;19;Sunnuntai;21;22;43;5;3;8
293;21.08.2016;2016;08;20;Sunnuntai;26;23;49;3;7;10
293;21.08.2016;2016;08;21;Sunnuntai;8;15;23;2;2;4
293;21.08.2016;2016;08;22;Sunnuntai;3;1;4;1;1;2
293;21.08.2016;2016;08;23;Sunnuntai;0;2;2;0;1;1
293;22.08.2016;2016;08;00;Maanantai;0;0;0;0;0;0
293;22.08.2016;2016;08;01;Maanantai;2;1;3;0;0;0
293;22.08.2016;2016;08;02;Maanantai;0;0;0;0;0;0
293;22.08.2016;2016;08;03;Maanantai;0;0;0;0;0;0
293;22.08.2016;2016;08;04;Maanantai;0;0;0;0;0;0
293;22.08.2016;2016;08;05;Maanantai;1;1;2;0;0;0
293;22.08.2016;2016;08;06;Maanantai;10;4;14;0;0;0
293;22.08.2016;2016;08;07;Maanantai;63;12;75;4;0;4
293;22.08.2016;2016;08;08;Maanantai;41;10;51;2;0;2
293;22.08.2016;2016;08;09;Maanantai;15;5;20;6;2;8
293;22.08.2016;2016;08;10;Maanantai;10;4;14;0;1;1
293;22.08.2016;2016;08;11;Maanantai;6;2;8;0;1;1
293;22.08.2016;2016;08;12;Maanantai;12;7;19;1;1;2
293;22.08.2016;2016;08;13;Maanantai;8;38;46;0;2;2
293;22.08.2016;2016;08;14;Maanantai;10;59;69;3;8;11
293;22.08.2016;2016;08;15;Maanantai;14;50;64;0;2;2
293;22.08.2016;2016;08;16;Maanantai;18;21;39;1;6;7
293;22.08.2016;2016;08;17;Maanantai;10;10;20;2;1;3
293;22.08.2016;2016;08;18;Maanantai;11;12;23;2;5;7
293;22.08.2016;2016;08;19;Maanantai;6;13;19;5;2;7
293;22.08.2016;2016;08;20;Maanantai;6;5;11;4;2;6
293;22.08.2016;2016;08;21;Maanantai;2;4;6;2;4;6
293;22.08.2016;2016;08;22;Maanantai;2;1;3;1;1;2
293;22.08.2016;2016;08;23;Maanantai;0;0;0;0;0;0
293;23.08.2016;2016;08;00;Tiistai;0;0;0;0;0;0
293;23.08.2016;2016;08;01;Tiistai;0;1;1;0;0;0
293;23.08.2016;2016;08;02;Tiistai;1;0;1;0;0;0
293;23.08.2016;2016;08;03;Tiistai;0;0;0;0;0;0
293;23.08.2016;2016;08;04;Tiistai;0;0;0;0;0;0
293;23.08.2016;2016;08;05;Tiistai;4;2;6;0;0;0
293;23.08.2016;2016;08;06;Tiistai;17;1;18;0;1;1
293;23.08.2016;2016;08;07;Tiistai;79;5;84;2;0;2
293;23.08.2016;2016;08;08;Tiistai;85;14;99;5;1;6
293;23.08.2016;2016;08;09;Tiistai;70;5;75;4;3;7
293;23.08.2016;2016;08;10;Tiistai;15;10;25;6;1;7
293;23.08.2016;2016;08;11;Tiistai;18;12;30;2;1;3
293;23.08.2016;2016;08;12;Tiistai;22;14;36;2;5;7
293;23.08.2016;2016;08;13;Tiistai;16;45;61;6;7;13
293;23.08.2016;2016;08;14;Tiistai;18;71;89;8;10;18
293;23.08.2016;2016;08;15;Tiistai;20;112;132;9;7;16
293;23.08.2016;2016;08;16;Tiistai;36;43;79;5;8;13
293;23.08.2016;2016;08;17;Tiistai;47;42;89;8;5;13
293;23.08.2016;2016;08;18;Tiistai;41;43;84;6;7;13
293;23.08.2016;2016;08;19;Tiistai;17;32;49;8;4;12
293;23.08.2016;2016;08;20;Tiistai;19;32;51;7;8;15
293;23.08.2016;2016;08;21;Tiistai;6;20;26;5;1;6
293;23.08.2016;2016;08;22;Tiistai;2;6;8;0;1;1
293;23.08.2016;2016;08;23;Tiistai;1;1;2;0;0;0
293;24.08.2016;2016;08;00;Keskiviikko;1;1;2;0;0;0
293;24.08.2016;2016;08;01;Keskiviikko;0;0;0;0;0;0
293;24.08.2016;2016;08;02;Keskiviikko;0;1;1;0;0;0
293;24.08.2016;2016;08;03;Keskiviikko;0;0;0;0;0;0
293;24.08.2016;2016;08;04;Keskiviikko;0;0;0;0;0;0
293;24.08.2016;2016;08;05;Keskiviikko;5;1;6;0;0;0
293;24.08.2016;2016;08;06;Keskiviikko;18;5;23;0;0;0
293;24.08.2016;2016;08;07;Keskiviikko;136;7;143;6;3;9
293;24.08.2016;2016;08;08;Keskiviikko;91;12;103;4;1;5
293;24.08.2016;2016;08;09;Keskiviikko;22;12;34;4;2;6
293;24.08.2016;2016;08;10;Keskiviikko;15;7;22;8;3;11
293;24.08.2016;2016;08;11;Keskiviikko;18;22;40;7;5;12
293;24.08.2016;2016;08;12;Keskiviikko;8;25;33;4;2;6
293;24.08.2016;2016;08;13;Keskiviikko;16;57;73;3;4;7
293;24.08.2016;2016;08;14;Keskiviikko;24;133;157;5;4;9
293;24.08.2016;2016;08;15;Keskiviikko;33;44;77;6;7;13
293;24.08.2016;2016;08;16;Keskiviikko;28;23;51;6;4;10
293;24.08.2016;2016;08;17;Keskiviikko;51;45;96;7;11;18
293;24.08.2016;2016;08;18;Keskiviikko;35;30;65;5;11;16
293;24.08.2016;2016;08;19;Keskiviikko;26;53;79;0;3;3
293;24.08.2016;2016;08;20;Keskiviikko;16;26;42;5;7;12
293;24.08.2016;2016;08;21;Keskiviikko;8;12;20;0;3;3
293;24.08.2016;2016;08;22;Keskiviikko;0;2;2;0;0;0
293;24.08.2016;2016;08;23;Keskiviikko;0;0;0;0;0;0
293;25.08.2016;2016;08;00;Torstai;0;0;0;0;0;0
293;25.08.2016;2016;08;01;Torstai;0;0;0;0;0;0
293;25.08.2016;2016;08;02;Torstai;0;0;0;0;0;0
293;25.08.2016;2016;08;03;Torstai;0;0;0;0;0;0
293;25.08.2016;2016;08;04;Torstai;0;0;0;0;0;0
293;25.08.2016;2016;08;05;Torstai;4;1;5;0;0;0
293;25.08.2016;2016;08;06;Torstai;17;1;18;1;0;1
293;25.08.2016;2016;08;07;Torstai;107;4;111;5;1;6
293;25.08.2016;2016;08;08;Torstai;88;5;93;4;0;4
293;25.08.2016;2016;08;09;Torstai;25;8;33;2;3;5
293;25.08.2016;2016;08;10;Torstai;6;5;11;0;0;0
293;25.08.2016;2016;08;11;Torstai;3;3;6;3;3;6
293;25.08.2016;2016;08;12;Torstai;11;10;21;0;1;1
293;25.08.2016;2016;08;13;Torstai;10;31;41;3;4;7
293;25.08.2016;2016;08;14;Torstai;14;116;130;3;6;9
293;25.08.2016;2016;08;15;Torstai;21;74;95;0;4;4
293;25.08.2016;2016;08;16;Torstai;15;23;38;2;4;6
293;25.08.2016;2016;08;17;Torstai;16;25;41;3;6;9
293;25.08.2016;2016;08;18;Torstai;18;18;36;2;5;7
293;25.08.2016;2016;08;19;Torstai;18;28;46;8;11;19
293;25.08.2016;2016;08;20;Torstai;15;16;31;2;1;3
293;25.08.2016;2016;08;21;Torstai;6;12;18;0;1;1
293;25.08.2016;2016;08;22;Torstai;1;5;6;0;0;0
293;25.08.2016;2016;08;23;Torstai;0;1;1;0;0;0
293;26.08.2016;2016;08;00;Perjantai;1;0;1;0;0;0
293;26.08.2016;2016;08;01;Perjantai;0;2;2;0;0;0
293;26.08.2016;2016;08;02;Perjantai;0;0;0;0;0;0
293;26.08.2016;2016;08;03;Perjantai;0;0;0;0;0;0
293;26.08.2016;2016;08;04;Perjantai;0;0;0;0;0;0
293;26.08.2016;2016;08;05;Perjantai;6;1;7;0;0;0
293;26.08.2016;2016;08;06;Perjantai;18;1;19;2;0;2
293;26.08.2016;2016;08;07;Perjantai;111;2;113;8;0;8
293;26.08.2016;2016;08;08;Perjantai;50;8;58;6;1;7
293;26.08.2016;2016;08;09;Perjantai;48;12;60;1;3;4
293;26.08.2016;2016;08;10;Perjantai;30;10;40;4;2;6
293;26.08.2016;2016;08;11;Perjantai;17;16;33;7;1;8
293;26.08.2016;2016;08;12;Perjantai;14;30;44;7;5;12
293;26.08.2016;2016;08;13;Perjantai;35;75;110;4;0;4
293;26.08.2016;2016;08;14;Perjantai;35;102;137;6;2;8
293;26.08.2016;2016;08;15;Perjantai;39;75;114;7;7;14
293;26.08.2016;2016;08;16;Perjantai;40;33;73;12;5;17
293;26.08.2016;2016;08;17;Perjantai;39;44;83;5;10;15
293;26.08.2016;2016;08;18;Perjantai;29;36;65;10;9;19
293;26.08.2016;2016;08;19;Perjantai;22;47;69;5;7;12
293;26.08.2016;2016;08;20;Perjantai;16;38;54;2;2;4
293;26.08.2016;2016;08;21;Perjantai;12;17;29;6;4;10
293;26.08.2016;2016;08;22;Perjantai;8;5;13;0;3;3
293;26.08.2016;2016;08;23;Perjantai;3;9;12;3;1;4
293;27.08.2016;2016;08;00;Lauantai;2;3;5;1;1;2
293;27.08.2016;2016;08;01;Lauantai;0;3;3;0;1;1
293;27.08.2016;2016;08;02;Lauantai;1;1;2;0;0;0
293;27.08.2016;2016;08;03;Lauantai;0;2;2;0;3;3
293;27.08.2016;2016;08;04;Lauantai;0;2;2;0;0;0
293;27.08.2016;2016;08;05;Lauantai;2;0;2;0;0;0
293;27.08.2016;2016;08;06;Lauantai;2;0;2;0;0;0
293;27.08.2016;2016;08;07;Lauantai;2;1;3;0;0;0
293;27.08.2016;2016;08;08;Lauantai;6;1;7;2;0;2
293;27.08.2016;2016;08;09;Lauantai;9;2;11;2;3;5
293;27.08.2016;2016;08;10;Lauantai;8;8;16;3;0;3
293;27.08.2016;2016;08;11;Lauantai;7;5;12;6;0;6
293;27.08.2016;2016;08;12;Lauantai;18;10;28;5;4;9
293;27.08.2016;2016;08;13;Lauantai;9;18;27;4;7;11
293;27.08.2016;2016;08;14;Lauantai;12;5;17;4;2;6
293;27.08.2016;2016;08;15;Lauantai;13;8;21;1;3;4
293;27.08.2016;2016;08;16;Lauantai;19;17;36;3;3;6
293;27.08.2016;2016;08;17;Lauantai;34;17;51;2;3;5
293;27.08.2016;2016;08;18;Lauantai;17;22;39;4;1;5
293;27.08.2016;2016;08;19;Lauantai;9;10;19;3;2;5
293;27.08.2016;2016;08;20;Lauantai;9;13;22;1;7;8
293;27.08.2016;2016;08;21;Lauantai;1;5;6;1;2;3
293;27.08.2016;2016;08;22;Lauantai;3;6;9;0;0;0
293;27.08.2016;2016;08;23;Lauantai;1;5;6;0;0;0
293;28.08.2016;2016;08;00;Sunnuntai;0;4;4;1;0;1
293;28.08.2016;2016;08;01;Sunnuntai;0;2;2;1;0;1
293;28.08.2016;2016;08;02;Sunnuntai;0;0;0;0;0;0
293;28.08.2016;2016;08;03;Sunnuntai;2;0;2;0;2;2
293;28.08.2016;2016;08;04;Sunnuntai;0;1;1;0;1;1
293;28.08.2016;2016;08;05;Sunnuntai;0;0;0;0;0;0
293;28.08.2016;2016;08;06;Sunnuntai;4;0;4;0;0;0
293;28.08.2016;2016;08;07;Sunnuntai;1;2;3;1;0;1
293;28.08.2016;2016;08;08;Sunnuntai;2;3;5;1;2;3
293;28.08.2016;2016;08;09;Sunnuntai;22;5;27;5;1;6
293;28.08.2016;2016;08;10;Sunnuntai;22;15;37;10;4;14
293;28.08.2016;2016;08;11;Sunnuntai;27;29;56;11;15;26
293;28.08.2016;2016;08;12;Sunnuntai;31;35;66;5;10;15
293;28.08.2016;2016;08;13;Sunnuntai;46;22;68;11;4;15
293;28.08.2016;2016;08;14;Sunnuntai;40;24;64;13;8;21
293;28.08.2016;2016;08;15;Sunnuntai;15;28;43;7;6;13
293;28.08.2016;2016;08;16;Sunnuntai;26;31;57;3;3;6
293;28.08.2016;2016;08;17;Sunnuntai;28;33;61;7;2;9
293;28.08.2016;2016;08;18;Sunnuntai;29;23;52;9;5;14
293;28.08.2016;2016;08;19;Sunnuntai;22;33;55;4;4;8
293;28.08.2016;2016;08;20;Sunnuntai;10;17;27;5;5;10
293;28.08.2016;2016;08;21;Sunnuntai;6;17;23;1;1;2
293;28.08.2016;2016;08;22;Sunnuntai;5;2;7;0;0;0
293;28.08.2016;2016;08;23;Sunnuntai;0;0;0;0;0;0
293;29.08.2016;2016;08;00;Maanantai;0;1;1;0;0;0
293;29.08.2016;2016;08;01;Maanantai;0;0;0;0;0;0
293;29.08.2016;2016;08;02;Maanantai;0;1;1;0;0;0
293;29.08.2016;2016;08;03;Maanantai;0;0;0;0;0;0
293;29.08.2016;2016;08;04;Maanantai;0;0;0;0;0;0
293;29.08.2016;2016;08;05;Maanantai;4;1;5;1;0;1
293;29.08.2016;2016;08;06;Maanantai;21;3;24;0;0;0
293;29.08.2016;2016;08;07;Maanantai;116;10;126;4;0;4
293;29.08.2016;2016;08;08;Maanantai;84;15;99;6;1;7
293;29.08.2016;2016;08;09;Maanantai;26;13;39;2;5;7
293;29.08.2016;2016;08;10;Maanantai;27;15;42;4;1;5
293;29.08.2016;2016;08;11;Maanantai;14;15;29;3;8;11
293;29.08.2016;2016;08;12;Maanantai;19;13;32;8;1;9
293;29.08.2016;2016;08;13;Maanantai;18;46;64;3;7;10
293;29.08.2016;2016;08;14;Maanantai;27;79;106;2;5;7
293;29.08.2016;2016;08;15;Maanantai;24;112;136;7;11;18
293;29.08.2016;2016;08;16;Maanantai;40;39;79;3;3;6
293;29.08.2016;2016;08;17;Maanantai;35;40;75;10;8;18
293;29.08.2016;2016;08;18;Maanantai;42;49;91;9;4;13
293;29.08.2016;2016;08;19;Maanantai;25;37;62;8;10;18
293;29.08.2016;2016;08;20;Maanantai;8;35;43;1;0;1
293;29.08.2016;2016;08;21;Maanantai;4;9;13;0;4;4
293;29.08.2016;2016;08;22;Maanantai;0;0;0;1;1;2
293;29.08.2016;2016;08;23;Maanantai;0;0;0;0;0;0
293;30.08.2016;2016;08;00;Tiistai;0;0;0;0;0;0
293;30.08.2016;2016;08;01;Tiistai;0;0;0;0;0;0
293;30.08.2016;2016;08;02;Tiistai;1;0;1;0;0;0
293;30.08.2016;2016;08;03;Tiistai;0;0;0;0;0;0
293;30.08.2016;2016;08;04;Tiistai;0;0;0;0;0;0
293;30.08.2016;2016;08;05;Tiistai;5;1;6;1;0;1
293;30.08.2016;2016;08;06;Tiistai;25;2;27;0;0;0
293;30.08.2016;2016;08;07;Tiistai;79;8;87;3;1;4
293;30.08.2016;2016;08;08;Tiistai;73;10;83;6;0;6
293;30.08.2016;2016;08;09;Tiistai;69;8;77;7;2;9
293;30.08.2016;2016;08;10;Tiistai;17;17;34;16;1;17
293;30.08.2016;2016;08;11;Tiistai;79;18;97;8;6;14
293;30.08.2016;2016;08;12;Tiistai;25;20;45;5;3;8
293;30.08.2016;2016;08;13;Tiistai;21;81;102;11;7;18
293;30.08.2016;2016;08;14;Tiistai;15;67;82;4;3;7
293;30.08.2016;2016;08;15;Tiistai;20;145;165;1;9;10
293;30.08.2016;2016;08;16;Tiistai;27;39;66;3;2;5
293;30.08.2016;2016;08;17;Tiistai;21;26;47;6;4;10
293;30.08.2016;2016;08;18;Tiistai;25;31;56;8;8;16
293;30.08.2016;2016;08;19;Tiistai;30;29;59;5;10;15
293;30.08.2016;2016;08;20;Tiistai;11;28;39;2;5;7
293;30.08.2016;2016;08;21;Tiistai;2;12;14;3;2;5
293;30.08.2016;2016;08;22;Tiistai;2;1;3;0;0;0
293;30.08.2016;2016;08;23;Tiistai;0;1;1;0;0;0
293;31.08.2016;2016;08;00;Keskiviikko;0;0;0;0;0;0
293;31.08.2016;2016;08;01;Keskiviikko;0;0;0;0;0;0
293;31.08.2016;2016;08;02;Keskiviikko;1;1;2;0;0;0
293;31.08.2016;2016;08;03;Keskiviikko;0;0;0;0;0;0
293;31.08.2016;2016;08;04;Keskiviikko;0;0;0;0;0;0
293;31.08.2016;2016;08;05;Keskiviikko;6;0;6;0;0;0
293;31.08.2016;2016;08;06;Keskiviikko;21;4;25;2;1;3
293;31.08.2016;2016;08;07;Keskiviikko;116;11;127;8;1;9
293;31.08.2016;2016;08;08;Keskiviikko;95;15;110;1;2;3
293;31.08.2016;2016;08;09;Keskiviikko;23;14;37;6;1;7
293;31.08.2016;2016;08;10;Keskiviikko;19;11;30;7;4;11
293;31.08.2016;2016;08;11;Keskiviikko;23;11;34;2;2;4
293;31.08.2016;2016;08;12;Keskiviikko;20;25;45;7;9;16
293;31.08.2016;2016;08;13;Keskiviikko;25;39;64;4;0;4
293;31.08.2016;2016;08;14;Keskiviikko;41;169;210;2;12;14
293;31.08.2016;2016;08;15;Keskiviikko;31;50;81;6;7;13
293;31.08.2016;2016;08;16;Keskiviikko;38;45;83;5;4;9
293;31.08.2016;2016;08;17;Keskiviikko;41;32;73;8;8;16
293;31.08.2016;2016;08;18;Keskiviikko;27;49;76;3;10;13
293;31.08.2016;2016;08;19;Keskiviikko;30;51;81;5;6;11
293;31.08.2016;2016;08;20;Keskiviikko;12;16;28;2;5;7
293;31.08.2016;2016;08;21;Keskiviikko;1;7;8;1;1;2
293;31.08.2016;2016;08;22;Keskiviikko;1;6;7;1;1;2
293;31.08.2016;2016;08;23;Keskiviikko;2;1;3;0;0;0
293;01.09.2016;2016;09;00;Torstai;0;0;0;0;0;0
293;01.09.2016;2016;09;01;Torstai;0;1;1;0;0;0
293;01.09.2016;2016;09;02;Torstai;1;0;1;0;0;0
293;01.09.2016;2016;09;03;Torstai;0;0;0;0;0;0
293;01.09.2016;2016;09;04;Torstai;0;0;0;0;0;0
293;01.09.2016;2016;09;05;Torstai;6;0;6;1;0;1
293;01.09.2016;2016;09;06;Torstai;17;6;23;0;0;0
293;01.09.2016;2016;09;07;Torstai;77;6;83;4;0;4
293;01.09.2016;2016;09;08;Torstai;79;7;86;7;0;7
293;01.09.2016;2016;09;09;Torstai;14;6;20;1;0;1
293;01.09.2016;2016;09;10;Torstai;9;9;18;1;0;1
293;01.09.2016;2016;09;11;Torstai;9;5;14;0;0;0
293;01.09.2016;2016;09;12;Torstai;11;9;20;4;1;5
293;01.09.2016;2016;09;13;Torstai;8;33;41;1;4;5
293;01.09.2016;2016;09;14;Torstai;13;69;82;3;7;10
293;01.09.2016;2016;09;15;Torstai;26;74;100;4;7;11
293;01.09.2016;2016;09;16;Torstai;29;37;66;3;5;8
293;01.09.2016;2016;09;17;Torstai;30;22;52;5;3;8
293;01.09.2016;2016;09;18;Torstai;31;27;58;5;8;13
293;01.09.2016;2016;09;19;Torstai;23;30;53;4;9;13
293;01.09.2016;2016;09;20;Torstai;14;39;53;2;5;7
293;01.09.2016;2016;09;21;Torstai;6;10;16;0;1;1
293;01.09.2016;2016;09;22;Torstai;1;4;5;0;1;1
293;01.09.2016;2016;09;23;Torstai;0;2;2;0;0;0
293;02.09.2016;2016;09;00;Perjantai;0;0;0;0;0;0
293;02.09.2016;2016;09;01;Perjantai;0;0;0;0;0;0
293;02.09.2016;2016;09;02;Perjantai;0;0;0;0;0;0
293;02.09.2016;2016;09;03;Perjantai;0;0;0;0;0;0
293;02.09.2016;2016;09;04;Perjantai;0;0;0;0;0;0
293;02.09.2016;2016;09;05;Perjantai;6;0;6;0;0;0
293;02.09.2016;2016;09;06;Perjantai;19;5;24;2;0;2
293;02.09.2016;2016;09;07;Perjantai;40;11;51;2;1;3
293;02.09.2016;2016;09;08;Perjantai;127;15;142;9;3;12
293;02.09.2016;2016;09;09;Perjantai;42;15;57;3;1;4
293;02.09.2016;2016;09;10;Perjantai;10;8;18;0;1;1
293;02.09.2016;2016;09;11;Perjantai;9;6;15;2;0;2
293;02.09.2016;2016;09;12;Perjantai;14;26;40;6;3;9
293;02.09.2016;2016;09;13;Perjantai;26;122;148;5;9;14
293;02.09.2016;2016;09;14;Perjantai;33;57;90;10;1;11
293;02.09.2016;2016;09;15;Perjantai;21;39;60;4;7;11
293;02.09.2016;2016;09;16;Perjantai;33;29;62;2;4;6
293;02.09.2016;2016;09;17;Perjantai;38;34;72;4;4;8
293;02.09.2016;2016;09;18;Perjantai;24;24;48;3;3;6
293;02.09.2016;2016;09;19;Perjantai;24;24;48;3;3;6
293;02.09.2016;2016;09;20;Perjantai;14;32;46;2;1;3
293;02.09.2016;2016;09;21;Perjantai;7;16;23;1;4;5
293;02.09.2016;2016;09;22;Perjantai;10;7;17;0;0;0
293;02.09.2016;2016;09;23;Perjantai;2;3;5;0;1;1
293;03.09.2016;2016;09;00;Lauantai;2;4;6;0;0;0
293;03.09.2016;2016;09;01;Lauantai;0;1;1;0;1;1
293;03.09.2016;2016;09;02;Lauantai;0;0;0;0;2;2
293;03.09.2016;2016;09;03;Lauantai;0;3;3;0;1;1
293;03.09.2016;2016;09;04;Lauantai;0;0;0;0;0;0
293;03.09.2016;2016;09;05;Lauantai;0;0;0;0;0;0
293;03.09.2016;2016;09;06;Lauantai;3;1;4;0;0;0
293;03.09.2016;2016;09;07;Lauantai;4;3;7;2;2;4
293;03.09.2016;2016;09;08;Lauantai;12;2;14;2;0;2
293;03.09.2016;2016;09;09;Lauantai;12;14;26;6;2;8
293;03.09.2016;2016;09;10;Lauantai;15;15;30;3;4;7
293;03.09.2016;2016;09;11;Lauantai;32;14;46;8;4;12
293;03.09.2016;2016;09;12;Lauantai;36;19;55;7;5;12
293;03.09.2016;2016;09;13;Lauantai;38;28;66;6;9;15
293;03.09.2016;2016;09;14;Lauantai;20;32;52;6;4;10
293;03.09.2016;2016;09;15;Lauantai;26;37;63;2;3;5
293;03.09.2016;2016;09;16;Lauantai;18;27;45;7;5;12
293;03.09.2016;2016;09;17;Lauantai;28;34;62;6;3;9
293;03.09.2016;2016;09;18;Lauantai;15;43;58;2;4;6
293;03.09.2016;2016;09;19;Lauantai;28;24;52;5;6;11
293;03.09.2016;2016;09;20;Lauantai;11;23;34;1;0;1
293;03.09.2016;2016;09;21;Lauantai;8;17;25;1;2;3
293;03.09.2016;2016;09;22;Lauantai;2;3;5;1;0;1
293;03.09.2016;2016;09;23;Lauantai;1;2;3;3;0;3
293;04.09.2016;2016;09;00;Sunnuntai;5;4;9;0;0;0
293;04.09.2016;2016;09;01;Sunnuntai;1;0;1;0;0;0
293;04.09.2016;2016;09;02;Sunnuntai;6;1;7;2;1;3
293;04.09.2016;2016;09;03;Sunnuntai;0;4;4;1;0;1
293;04.09.2016;2016;09;04;Sunnuntai;2;0;2;0;1;1
293;04.09.2016;2016;09;05;Sunnuntai;3;1;4;1;0;1
293;04.09.2016;2016;09;06;Sunnuntai;2;1;3;0;0;0
293;04.09.2016;2016;09;07;Sunnuntai;0;1;1;0;0;0
293;04.09.2016;2016;09;08;Sunnuntai;2;1;3;3;2;5
293;04.09.2016;2016;09;09;Sunnuntai;24;5;29;4;0;4
293;04.09.2016;2016;09;10;Sunnuntai;15;13;28;5;4;9
293;04.09.2016;2016;09;11;Sunnuntai;17;32;49;2;8;10
293;04.09.2016;2016;09;12;Sunnuntai;32;23;55;10;10;20
293;04.09.2016;2016;09;13;Sunnuntai;43;20;63;7;5;12
293;04.09.2016;2016;09;14;Sunnuntai;46;24;70;5;3;8
293;04.09.2016;2016;09;15;Sunnuntai;27;31;58;8;5;13
293;04.09.2016;2016;09;16;Sunnuntai;18;23;41;7;5;12
293;04.09.2016;2016;09;17;Sunnuntai;46;42;88;10;7;17
293;04.09.2016;2016;09;18;Sunnuntai;30;50;80;4;5;9
293;04.09.2016;2016;09;19;Sunnuntai;25;30;55;3;5;8
293;04.09.2016;2016;09;20;Sunnuntai;18;21;39;1;2;3
293;04.09.2016;2016;09;21;Sunnuntai;2;5;7;0;0;0
293;04.09.2016;2016;09;22;Sunnuntai;2;4;6;0;0;0
293;04.09.2016;2016;09;23;Sunnuntai;1;0;1;0;1;1
293;05.09.2016;2016;09;00;Maanantai;0;0;0;2;1;3
293;05.09.2016;2016;09;01;Maanantai;0;0;0;0;0;0
293;05.09.2016;2016;09;02;Maanantai;0;0;0;0;1;1
293;05.09.2016;2016;09;03;Maanantai;0;0;0;0;0;0
293;05.09.2016;2016;09;04;Maanantai;0;0;0;0;0;0
293;05.09.2016;2016;09;05;Maanantai;3;0;3;0;0;0
293;05.09.2016;2016;09;06;Maanantai;15;1;16;2;0;2
293;05.09.2016;2016;09;07;Maanantai;119;6;125;12;0;12
293;05.09.2016;2016;09;08;Maanantai;82;20;102;6;2;8
293;05.09.2016;2016;09;09;Maanantai;31;13;44;4;2;6
293;05.09.2016;2016;09;10;Maanantai;20;7;27;6;7;13
293;05.09.2016;2016;09;11;Maanantai;20;15;35;4;2;6
293;05.09.2016;2016;09;12;Maanantai;14;18;32;3;3;6
293;05.09.2016;2016;09;13;Maanantai;14;44;58;3;5;8
293;05.09.2016;2016;09;14;Maanantai;19;91;110;4;6;10
293;05.09.2016;2016;09;15;Maanantai;26;92;118;4;6;10
293;05.09.2016;2016;09;16;Maanantai;32;39;71;7;5;12
293;05.09.2016;2016;09;17;Maanantai;41;37;78;6;3;9
293;05.09.2016;2016;09;18;Maanantai;24;31;55;12;5;17
293;05.09.2016;2016;09;19;Maanantai;19;25;44;3;6;9
293;05.09.2016;2016;09;20;Maanantai;10;29;39;5;14;19
293;05.09.2016;2016;09;21;Maanantai;5;6;11;3;1;4
293;05.09.2016;2016;09;22;Maanantai;0;1;1;1;1;2
293;05.09.2016;2016;09;23;Maanantai;0;0;0;0;0;0
293;06.09.2016;2016;09;00;Tiistai;0;0;0;0;0;0
293;06.09.2016;2016;09;01;Tiistai;0;0;0;1;0;1
293;06.09.2016;2016;09;02;Tiistai;1;0;1;0;0;0
293;06.09.2016;2016;09;03;Tiistai;0;0;0;0;0;0
293;06.09.2016;2016;09;04;Tiistai;0;1;1;0;0;0
293;06.09.2016;2016;09;05;Tiistai;5;1;6;0;0;0
293;06.09.2016;2016;09;06;Tiistai;26;3;29;0;0;0
293;06.09.2016;2016;09;07;Tiistai;79;5;84;7;1;8
293;06.09.2016;2016;09;08;Tiistai;73;11;84;5;1;6
293;06.09.2016;2016;09;09;Tiistai;75;6;81;5;2;7
293;06.09.2016;2016;09;10;Tiistai;21;14;35;7;1;8
293;06.09.2016;2016;09;11;Tiistai;13;15;28;2;2;4
293;06.09.2016;2016;09;12;Tiistai;15;18;33;3;7;10
293;06.09.2016;2016;09;13;Tiistai;10;20;30;2;3;5
293;06.09.2016;2016;09;14;Tiistai;23;75;98;6;5;11
293;06.09.2016;2016;09;15;Tiistai;23;140;163;0;8;8
293;06.09.2016;2016;09;16;Tiistai;27;33;60;2;3;5
293;06.09.2016;2016;09;17;Tiistai;24;36;60;3;3;6
293;06.09.2016;2016;09;18;Tiistai;24;23;47;5;5;10
293;06.09.2016;2016;09;19;Tiistai;15;34;49;3;3;6
293;06.09.2016;2016;09;20;Tiistai;13;17;30;0;0;0
293;06.09.2016;2016;09;21;Tiistai;3;10;13;0;4;4
293;06.09.2016;2016;09;22;Tiistai;1;0;1;1;1;2
293;06.09.2016;2016;09;23;Tiistai;1;1;2;0;0;0
293;07.09.2016;2016;09;00;Keskiviikko;0;0;0;0;0;0
293;07.09.2016;2016;09;01;Keskiviikko;0;0;0;0;0;0
293;07.09.2016;2016;09;02;Keskiviikko;1;0;1;0;0;0
293;07.09.2016;2016;09;03;Keskiviikko;0;0;0;0;0;0
293;07.09.2016;2016;09;04;Keskiviikko;0;0;0;0;0;0
293;07.09.2016;2016;09;05;Keskiviikko;5;1;6;0;0;0
293;07.09.2016;2016;09;06;Keskiviikko;18;3;21;0;0;0
293;07.09.2016;2016;09;07;Keskiviikko;115;5;120;5;1;6
293;07.09.2016;2016;09;08;Keskiviikko;81;10;91;8;1;9
293;07.09.2016;2016;09;09;Keskiviikko;22;13;35;9;1;10
293;07.09.2016;2016;09;10;Keskiviikko;14;13;27;1;0;1
293;07.09.2016;2016;09;11;Keskiviikko;15;14;29;7;4;11
293;07.09.2016;2016;09;12;Keskiviikko;14;18;32;7;6;13
293;07.09.2016;2016;09;13;Keskiviikko;15;37;52;4;3;7
293;07.09.2016;2016;09;14;Keskiviikko;25;155;180;5;8;13
293;07.09.2016;2016;09;15;Keskiviikko;28;34;62;4;3;7
293;07.09.2016;2016;09;16;Keskiviikko;32;25;57;7;7;14
293;07.09.2016;2016;09;17;Keskiviikko;39;29;68;5;1;6
293;07.09.2016;2016;09;18;Keskiviikko;17;40;57;5;6;11
293;07.09.2016;2016;09;19;Keskiviikko;19;47;66;4;10;14
293;07.09.2016;2016;09;20;Keskiviikko;7;21;28;0;0;0
293;07.09.2016;2016;09;21;Keskiviikko;3;16;19;0;1;1
293;07.09.2016;2016;09;22;Keskiviikko;3;2;5;0;1;1
293;07.09.2016;2016;09;23;Keskiviikko;0;0;0;0;0;0
293;08.09.2016;2016;09;00;Torstai;0;0;0;0;0;0
293;08.09.2016;2016;09;01;Torstai;1;0;1;0;0;0
293;08.09.2016;2016;09;02;Torstai;0;0;0;0;0;0
293;08.09.2016;2016;09;03;Torstai;0;0;0;0;0;0
293;08.09.2016;2016;09;04;Torstai;0;0;0;0;0;0
293;08.09.2016;2016;09;05;Torstai;3;1;4;0;0;0
293;08.09.2016;2016;09;06;Torstai;16;2;18;0;0;0
293;08.09.2016;2016;09;07;Torstai;101;10;111;5;1;6
293;08.09.2016;2016;09;08;Torstai;95;9;104;4;2;6
293;08.09.2016;2016;09;09;Torstai;57;13;70;3;1;4
293;08.09.2016;2016;09;10;Torstai;5;9;14;6;4;10
293;08.09.2016;2016;09;11;Torstai;16;11;27;3;1;4
293;08.09.2016;2016;09;12;Torstai;17;15;32;4;2;6
293;08.09.2016;2016;09;13;Torstai;18;64;82;4;7;11
293;08.09.2016;2016;09;14;Torstai;20;106;126;3;6;9
293;08.09.2016;2016;09;15;Torstai;27;85;112;4;6;10
293;08.09.2016;2016;09;16;Torstai;39;33;72;4;2;6
293;08.09.2016;2016;09;17;Torstai;38;40;78;8;3;11
293;08.09.2016;2016;09;18;Torstai;26;39;65;4;4;8
293;08.09.2016;2016;09;19;Torstai;23;27;50;4;6;10
293;08.09.2016;2016;09;20;Torstai;6;22;28;1;5;6
293;08.09.2016;2016;09;21;Torstai;1;11;12;1;4;5
293;08.09.2016;2016;09;22;Torstai;1;4;5;1;1;2
293;08.09.2016;2016;09;23;Torstai;1;0;1;0;0;0
293;09.09.2016;2016;09;00;Perjantai;0;0;0;0;0;0
293;09.09.2016;2016;09;01;Perjantai;0;0;0;0;0;0
293;09.09.2016;2016;09;02;Perjantai;0;0;0;1;0;1
293;09.09.2016;2016;09;03;Perjantai;0;0;0;0;0;0
293;09.09.2016;2016;09;04;Perjantai;0;0;0;0;0;0
293;09.09.2016;2016;09;05;Perjantai;3;1;4;0;0;0
293;09.09.2016;2016;09;06;Perjantai;17;1;18;0;0;0
293;09.09.2016;2016;09;07;Perjantai;101;8;109;2;0;2
293;09.09.2016;2016;09;08;Perjantai;71;7;78;4;2;6
293;09.09.2016;2016;09;09;Perjantai;41;11;52;5;3;8
293;09.09.2016;2016;09;10;Perjantai;23;10;33;5;0;5
293;09.09.2016;2016;09;11;Perjantai;24;19;43;0;7;7
293;09.09.2016;2016;09;12;Perjantai;23;43;66;5;2;7
293;09.09.2016;2016;09;13;Perjantai;21;59;80;2;8;10
293;09.09.2016;2016;09;14;Perjantai;20;109;129;4;4;8
293;09.09.2016;2016;09;15;Perjantai;19;60;79;2;5;7
293;09.09.2016;2016;09;16;Perjantai;25;45;70;6;8;14
293;09.09.2016;2016;09;17;Perjantai;21;24;45;2;1;3
293;09.09.2016;2016;09;18;Perjantai;26;37;63;3;8;11
293;09.09.2016;2016;09;19;Perjantai;20;21;41;5;7;12
293;09.09.2016;2016;09;20;Perjantai;30;27;57;4;6;10
293;09.09.2016;2016;09;21;Perjantai;7;9;16;4;3;7
293;09.09.2016;2016;09;22;Perjantai;9;11;20;0;0;0
293;09.09.2016;2016;09;23;Perjantai;2;7;9;0;0;0
293;10.09.2016;2016;09;00;Lauantai;1;0;1;2;0;2
293;10.09.2016;2016;09;01;Lauantai;0;1;1;0;0;0
293;10.09.2016;2016;09;02;Lauantai;0;1;1;0;0;0
293;10.09.2016;2016;09;03;Lauantai;0;0;0;1;2;3
293;10.09.2016;2016;09;04;Lauantai;0;0;0;0;0;0
293;10.09.2016;2016;09;05;Lauantai;2;0;2;0;0;0
293;10.09.2016;2016;09;06;Lauantai;3;0;3;0;0;0
293;10.09.2016;2016;09;07;Lauantai;2;1;3;1;1;2
293;10.09.2016;2016;09;08;Lauantai;6;1;7;0;1;1
293;10.09.2016;2016;09;09;Lauantai;13;11;24;5;3;8
293;10.09.2016;2016;09;10;Lauantai;8;4;12;5;3;8
293;10.09.2016;2016;09;11;Lauantai;16;14;30;13;9;22
293;10.09.2016;2016;09;12;Lauantai;34;16;50;14;10;24
293;10.09.2016;2016;09;13;Lauantai;30;30;60;5;5;10
293;10.09.2016;2016;09;14;Lauantai;20;19;39;8;4;12
293;10.09.2016;2016;09;15;Lauantai;18;35;53;4;9;13
293;10.09.2016;2016;09;16;Lauantai;22;23;45;5;1;6
293;10.09.2016;2016;09;17;Lauantai;28;18;46;5;5;10
293;10.09.2016;2016;09;18;Lauantai;28;24;52;11;10;21
293;10.09.2016;2016;09;19;Lauantai;12;17;29;3;2;5
293;10.09.2016;2016;09;20;Lauantai;9;20;29;6;2;8
293;10.09.2016;2016;09;21;Lauantai;7;11;18;1;1;2
293;10.09.2016;2016;09;22;Lauantai;2;13;15;1;2;3
293;10.09.2016;2016;09;23;Lauantai;2;3;5;6;1;7
293;11.09.2016;2016;09;00;Sunnuntai;3;1;4;0;2;2
293;11.09.2016;2016;09;01;Sunnuntai;0;4;4;3;3;6
293;11.09.2016;2016;09;02;Sunnuntai;0;2;2;1;0;1
293;11.09.2016;2016;09;03;Sunnuntai;3;0;3;0;4;4
293;11.09.2016;2016;09;04;Sunnuntai;1;0;1;0;1;1
293;11.09.2016;2016;09;05;Sunnuntai;1;2;3;2;0;2
293;11.09.2016;2016;09;06;Sunnuntai;5;2;7;1;1;2
293;11.09.2016;2016;09;07;Sunnuntai;1;0;1;0;0;0
293;11.09.2016;2016;09;08;Sunnuntai;1;2;3;4;3;7
293;11.09.2016;2016;09;09;Sunnuntai;21;7;28;0;1;1
293;11.09.2016;2016;09;10;Sunnuntai;14;12;26;2;3;5
293;11.09.2016;2016;09;11;Sunnuntai;15;27;42;5;2;7
293;11.09.2016;2016;09;12;Sunnuntai;22;17;39;10;11;21
293;11.09.2016;2016;09;13;Sunnuntai;32;21;53;11;5;16
293;11.09.2016;2016;09;14;Sunnuntai;20;33;53;3;8;11
293;11.09.2016;2016;09;15;Sunnuntai;30;37;67;4;4;8
293;11.09.2016;2016;09;16;Sunnuntai;19;16;35;2;2;4
293;11.09.2016;2016;09;17;Sunnuntai;22;27;49;3;6;9
293;11.09.2016;2016;09;18;Sunnuntai;27;26;53;3;7;10
293;11.09.2016;2016;09;19;Sunnuntai;13;16;29;1;2;3
293;11.09.2016;2016;09;20;Sunnuntai;11;5;16;1;3;4
293;11.09.2016;2016;09;21;Sunnuntai;3;3;6;0;1;1
293;11.09.2016;2016;09;22;Sunnuntai;1;0;1;0;0;0
293;11.09.2016;2016;09;23;Sunnuntai;0;1;1;0;0;0
293;12.09.2016;2016;09;00;Maanantai;0;0;0;0;0;0
293;12.09.2016;2016;09;01;Maanantai;0;0;0;0;0;0
293;12.09.2016;2016;09;02;Maanantai;0;0;0;0;0;0
293;12.09.2016;2016;09;03;Maanantai;0;0;0;0;0;0
293;12.09.2016;2016;09;04;Maanantai;0;0;0;0;0;0
293;12.09.2016;2016;09;05;Maanantai;1;0;1;1;0;1
293;12.09.2016;2016;09;06;Maanantai;15;1;16;0;0;0
293;12.09.2016;2016;09;07;Maanantai;110;8;118;4;0;4
293;12.09.2016;2016;09;08;Maanantai;79;8;87;2;0;2
293;12.09.2016;2016;09;09;Maanantai;25;6;31;3;1;4
293;12.09.2016;2016;09;10;Maanantai;16;7;23;4;1;5
293;12.09.2016;2016;09;11;Maanantai;7;7;14;2;1;3
293;12.09.2016;2016;09;12;Maanantai;7;13;20;4;1;5
293;12.09.2016;2016;09;13;Maanantai;14;36;50;1;4;5
293;12.09.2016;2016;09;14;Maanantai;7;76;83;2;10;12
293;12.09.2016;2016;09;15;Maanantai;23;104;127;4;7;11
293;12.09.2016;2016;09;16;Maanantai;42;29;71;4;3;7
293;12.09.2016;2016;09;17;Maanantai;33;41;74;4;7;11
293;12.09.2016;2016;09;18;Maanantai;39;29;68;12;5;17
293;12.09.2016;2016;09;19;Maanantai;17;27;44;9;3;12
293;12.09.2016;2016;09;20;Maanantai;10;36;46;2;6;8
293;12.09.2016;2016;09;21;Maanantai;5;7;12;0;0;0
293;12.09.2016;2016;09;22;Maanantai;0;3;3;0;1;1
293;12.09.2016;2016;09;23;Maanantai;0;0;0;0;0;0
293;13.09.2016;2016;09;00;Tiistai;0;0;0;0;0;0
293;13.09.2016;2016;09;01;Tiistai;0;0;0;0;0;0
293;13.09.2016;2016;09;02;Tiistai;1;0;1;0;0;0
293;13.09.2016;2016;09;03;Tiistai;0;0;0;0;0;0
293;13.09.2016;2016;09;04;Tiistai;0;0;0;0;0;0
293;13.09.2016;2016;09;05;Tiistai;2;1;3;1;0;1
293;13.09.2016;2016;09;06;Tiistai;19;2;21;0;0;0
293;13.09.2016;2016;09;07;Tiistai;86;5;91;4;0;4
293;13.09.2016;2016;09;08;Tiistai;80;16;96;5;2;7
293;13.09.2016;2016;09;09;Tiistai;68;16;84;5;1;6
293;13.09.2016;2016;09;10;Tiistai;24;10;34;0;3;3
293;13.09.2016;2016;09;11;Tiistai;11;12;23;8;2;10
293;13.09.2016;2016;09;12;Tiistai;20;13;33;3;4;7
293;13.09.2016;2016;09;13;Tiistai;12;24;36;3;4;7
293;13.09.2016;2016;09;14;Tiistai;19;82;101;3;9;12
293;13.09.2016;2016;09;15;Tiistai;20;125;145;2;11;13
293;13.09.2016;2016;09;16;Tiistai;35;46;81;5;5;10
293;13.09.2016;2016;09;17;Tiistai;36;36;72;10;10;20
293;13.09.2016;2016;09;18;Tiistai;38;28;66;8;5;13
293;13.09.2016;2016;09;19;Tiistai;20;36;56;5;8;13
293;13.09.2016;2016;09;20;Tiistai;12;26;38;0;7;7
293;13.09.2016;2016;09;21;Tiistai;3;13;16;1;1;2
293;13.09.2016;2016;09;22;Tiistai;2;1;3;0;0;0
293;13.09.2016;2016;09;23;Tiistai;0;0;0;0;0;0
293;14.09.2016;2016;09;00;Keskiviikko;0;0;0;1;0;1
293;14.09.2016;2016;09;01;Keskiviikko;0;0;0;0;0;0
293;14.09.2016;2016;09;02;Keskiviikko;1;1;2;0;0;0
293;14.09.2016;2016;09;03;Keskiviikko;0;0;0;0;0;0
293;14.09.2016;2016;09;04;Keskiviikko;0;0;0;0;0;0
293;14.09.2016;2016;09;05;Keskiviikko;7;0;7;0;1;1
293;14.09.2016;2016;09;06;Keskiviikko;17;3;20;1;0;1
293;14.09.2016;2016;09;07;Keskiviikko;124;7;131;6;0;6
293;14.09.2016;2016;09;08;Keskiviikko;80;5;85;7;1;8
293;14.09.2016;2016;09;09;Keskiviikko;21;13;34;5;1;6
293;14.09.2016;2016;09;10;Keskiviikko;14;11;25;1;2;3
293;14.09.2016;2016;09;11;Keskiviikko;12;7;19;4;2;6
293;14.09.2016;2016;09;12;Keskiviikko;7;24;31;1;1;2
293;14.09.2016;2016;09;13;Keskiviikko;14;37;51;7;1;8
293;14.09.2016;2016;09;14;Keskiviikko;21;148;169;10;21;31
293;14.09.2016;2016;09;15;Keskiviikko;28;61;89;3;5;8
293;14.09.2016;2016;09;16;Keskiviikko;30;26;56;3;2;5
293;14.09.2016;2016;09;17;Keskiviikko;48;23;71;9;2;11
293;14.09.2016;2016;09;18;Keskiviikko;26;35;61;3;9;12
293;14.09.2016;2016;09;19;Keskiviikko;16;45;61;2;5;7
293;14.09.2016;2016;09;20;Keskiviikko;6;30;36;3;3;6
293;14.09.2016;2016;09;21;Keskiviikko;2;7;9;0;1;1
293;14.09.2016;2016;09;22;Keskiviikko;1;1;2;0;0;0
293;14.09.2016;2016;09;23;Keskiviikko;2;0;2;1;0;1
293;15.09.2016;2016;09;00;Torstai;0;0;0;0;1;1
293;15.09.2016;2016;09;01;Torstai;0;1;1;0;0;0
293;15.09.2016;2016;09;02;Torstai;1;0;1;0;1;1
293;15.09.2016;2016;09;03;Torstai;0;1;1;0;0;0
293;15.09.2016;2016;09;04;Torstai;0;0;0;0;0;0
293;15.09.2016;2016;09;05;Torstai;5;0;5;0;0;0
293;15.09.2016;2016;09;06;Torstai;14;2;16;0;0;0
293;15.09.2016;2016;09;07;Torstai;102;6;108;4;0;4
293;15.09.2016;2016;09;08;Torstai;96;11;107;4;0;4
293;15.09.2016;2016;09;09;Torstai;40;14;54;1;1;2
293;15.09.2016;2016;09;10;Torstai;11;14;25;3;2;5
293;15.09.2016;2016;09;11;Torstai;17;17;34;5;6;11
293;15.09.2016;2016;09;12;Torstai;16;13;29;3;1;4
293;15.09.2016;2016;09;13;Torstai;11;45;56;6;2;8
293;15.09.2016;2016;09;14;Torstai;14;94;108;4;3;7
293;15.09.2016;2016;09;15;Torstai;20;94;114;4;6;10
293;15.09.2016;2016;09;16;Torstai;28;29;57;1;2;3
293;15.09.2016;2016;09;17;Torstai;35;19;54;7;5;12
293;15.09.2016;2016;09;18;Torstai;35;34;69;6;6;12
293;15.09.2016;2016;09;19;Torstai;12;41;53;3;4;7
293;15.09.2016;2016;09;20;Torstai;5;21;26;0;4;4
293;15.09.2016;2016;09;21;Torstai;1;5;6;2;3;5
293;15.09.2016;2016;09;22;Torstai;1;1;2;1;1;2
293;15.09.2016;2016;09;23;Torstai;0;0;0;0;0;0
293;16.09.2016;2016;09;00;Perjantai;0;0;0;0;0;0
293;16.09.2016;2016;09;01;Perjantai;0;1;1;0;0;0
293;16.09.2016;2016;09;02;Perjantai;0;0;0;1;0;1
293;16.09.2016;2016;09;03;Perjantai;0;0;0;0;0;0
293;16.09.2016;2016;09;04;Perjantai;0;0;0;0;0;0
293;16.09.2016;2016;09;05;Perjantai;3;1;4;1;0;1
293;16.09.2016;2016;09;06;Perjantai;15;7;22;0;0;0
293;16.09.2016;2016;09;07;Perjantai;93;7;100;1;1;2
293;16.09.2016;2016;09;08;Perjantai;75;9;84;9;5;14
293;16.09.2016;2016;09;09;Perjantai;50;10;60;6;2;8
293;16.09.2016;2016;09;10;Perjantai;22;14;36;5;4;9
293;16.09.2016;2016;09;11;Perjantai;20;17;37;1;3;4
293;16.09.2016;2016;09;12;Perjantai;21;42;63;5;3;8
293;16.09.2016;2016;09;13;Perjantai;15;56;71;1;4;5
293;16.09.2016;2016;09;14;Perjantai;38;100;138;5;8;13
293;16.09.2016;2016;09;15;Perjantai;13;72;85;4;4;8
293;16.09.2016;2016;09;16;Perjantai;35;37;72;2;2;4
293;16.09.2016;2016;09;17;Perjantai;40;35;75;4;8;12
293;16.09.2016;2016;09;18;Perjantai;20;44;64;6;7;13
293;16.09.2016;2016;09;19;Perjantai;49;29;78;4;1;5
293;16.09.2016;2016;09;20;Perjantai;19;28;47;3;3;6
293;16.09.2016;2016;09;21;Perjantai;5;10;15;1;1;2
293;16.09.2016;2016;09;22;Perjantai;5;8;13;3;4;7
293;16.09.2016;2016;09;23;Perjantai;5;13;18;2;0;2
293;17.09.2016;2016;09;00;Lauantai;0;2;2;0;1;1
293;17.09.2016;2016;09;01;Lauantai;2;0;2;1;2;3
293;17.09.2016;2016;09;02;Lauantai;0;0;0;0;0;0
293;17.09.2016;2016;09;03;Lauantai;2;1;3;0;0;0
293;17.09.2016;2016;09;04;Lauantai;0;0;0;0;0;0
293;17.09.2016;2016;09;05;Lauantai;0;2;2;0;0;0
293;17.09.2016;2016;09;06;Lauantai;2;1;3;0;0;0
293;17.09.2016;2016;09;07;Lauantai;0;1;1;0;0;0
293;17.09.2016;2016;09;08;Lauantai;5;3;8;1;0;1
293;17.09.2016;2016;09;09;Lauantai;10;7;17;2;1;3
293;17.09.2016;2016;09;10;Lauantai;19;5;24;3;0;3
293;17.09.2016;2016;09;11;Lauantai;26;14;40;3;4;7
293;17.09.2016;2016;09;12;Lauantai;19;15;34;7;4;11
293;17.09.2016;2016;09;13;Lauantai;22;26;48;8;6;14
293;17.09.2016;2016;09;14;Lauantai;28;39;67;2;6;8
293;17.09.2016;2016;09;15;Lauantai;19;26;45;7;3;10
293;17.09.2016;2016;09;16;Lauantai;23;36;59;1;2;3
293;17.09.2016;2016;09;17;Lauantai;19;25;44;5;5;10
293;17.09.2016;2016;09;18;Lauantai;27;20;47;4;5;9
293;17.09.2016;2016;09;19;Lauantai;21;12;33;11;9;20
293;17.09.2016;2016;09;20;Lauantai;15;21;36;4;6;10
293;17.09.2016;2016;09;21;Lauantai;3;11;14;3;3;6
293;17.09.2016;2016;09;22;Lauantai;2;3;5;0;1;1
293;17.09.2016;2016;09;23;Lauantai;1;3;4;0;1;1
293;18.09.2016;2016;09;00;Sunnuntai;1;0;1;2;0;2
293;18.09.2016;2016;09;01;Sunnuntai;0;3;3;0;0;0
293;18.09.2016;2016;09;02;Sunnuntai;0;1;1;0;3;3
293;18.09.2016;2016;09;03;Sunnuntai;3;0;3;2;0;2
293;18.09.2016;2016;09;04;Sunnuntai;0;0;0;0;1;1
293;18.09.2016;2016;09;05;Sunnuntai;0;0;0;0;0;0
293;18.09.2016;2016;09;06;Sunnuntai;3;0;3;0;1;1
293;18.09.2016;2016;09;07;Sunnuntai;1;1;2;0;0;0
293;18.09.2016;2016;09;08;Sunnuntai;1;2;3;2;0;2
293;18.09.2016;2016;09;09;Sunnuntai;12;4;16;4;3;7
293;18.09.2016;2016;09;10;Sunnuntai;11;7;18;3;4;7
293;18.09.2016;2016;09;11;Sunnuntai;26;24;50;10;4;14
293;18.09.2016;2016;09;12;Sunnuntai;44;26;70;15;8;23
293;18.09.2016;2016;09;13;Sunnuntai;21;37;58;12;9;21
293;18.09.2016;2016;09;14;Sunnuntai;26;31;57;5;4;9
293;18.09.2016;2016;09;15;Sunnuntai;16;34;50;6;2;8
293;18.09.2016;2016;09;16;Sunnuntai;17;17;34;4;5;9
293;18.09.2016;2016;09;17;Sunnuntai;29;31;60;10;7;17
293;18.09.2016;2016;09;18;Sunnuntai;36;26;62;12;9;21
293;18.09.2016;2016;09;19;Sunnuntai;19;24;43;3;4;7
293;18.09.2016;2016;09;20;Sunnuntai;7;17;24;1;3;4
293;18.09.2016;2016;09;21;Sunnuntai;1;3;4;1;1;2
293;18.09.2016;2016;09;22;Sunnuntai;2;1;3;0;0;0
293;18.09.2016;2016;09;23;Sunnuntai;1;1;2;1;0;1
293;19.09.2016;2016;09;00;Maanantai;0;0;0;0;0;0
293;19.09.2016;2016;09;01;Maanantai;0;0;0;0;0;0
293;19.09.2016;2016;09;02;Maanantai;0;0;0;0;1;1
293;19.09.2016;2016;09;03;Maanantai;0;0;0;0;0;0
293;19.09.2016;2016;09;04;Maanantai;0;0;0;0;0;0
293;19.09.2016;2016;09;05;Maanantai;5;2;7;0;0;0
293;19.09.2016;2016;09;06;Maanantai;16;1;17;0;0;0
293;19.09.2016;2016;09;07;Maanantai;106;7;113;5;1;6
293;19.09.2016;2016;09;08;Maanantai;94;18;112;6;0;6
293;19.09.2016;2016;09;09;Maanantai;27;8;35;3;2;5
293;19.09.2016;2016;09;10;Maanantai;23;34;57;5;1;6
293;19.09.2016;2016;09;11;Maanantai;15;12;27;3;5;8
293;19.09.2016;2016;09;12;Maanantai;31;22;53;6;3;9
293;19.09.2016;2016;09;13;Maanantai;15;54;69;3;5;8
293;19.09.2016;2016;09;14;Maanantai;21;86;107;4;8;12
293;19.09.2016;2016;09;15;Maanantai;13;100;113;3;7;10
293;19.09.2016;2016;09;16;Maanantai;31;34;65;1;1;2
293;19.09.2016;2016;09;17;Maanantai;30;24;54;5;6;11
293;19.09.2016;2016;09;18;Maanantai;30;30;60;7;10;17
293;19.09.2016;2016;09;19;Maanantai;17;32;49;8;5;13
293;19.09.2016;2016;09;20;Maanantai;9;21;30;5;5;10
293;19.09.2016;2016;09;21;Maanantai;2;6;8;0;1;1
293;19.09.2016;2016;09;22;Maanantai;0;4;4;1;1;2
293;19.09.2016;2016;09;23;Maanantai;0;0;0;1;0;1
293;20.09.2016;2016;09;00;Tiistai;0;0;0;0;0;0
293;20.09.2016;2016;09;01;Tiistai;0;0;0;0;0;0
293;20.09.2016;2016;09;02;Tiistai;1;0;1;0;0;0
293;20.09.2016;2016;09;03;Tiistai;0;0;0;0;0;0
293;20.09.2016;2016;09;04;Tiistai;0;0;0;0;0;0
293;20.09.2016;2016;09;05;Tiistai;2;2;4;0;0;0
293;20.09.2016;2016;09;06;Tiistai;18;3;21;2;0;2
293;20.09.2016;2016;09;07;Tiistai;78;7;85;3;1;4
293;20.09.2016;2016;09;08;Tiistai;92;10;102;1;3;4
293;20.09.2016;2016;09;09;Tiistai;66;6;72;4;1;5
293;20.09.2016;2016;09;10;Tiistai;24;11;35;5;2;7
293;20.09.2016;2016;09;11;Tiistai;14;13;27;6;4;10
293;20.09.2016;2016;09;12;Tiistai;23;16;39;2;2;4
293;20.09.2016;2016;09;13;Tiistai;9;20;29;6;4;10
293;20.09.2016;2016;09;14;Tiistai;26;68;94;7;6;13
293;20.09.2016;2016;09;15;Tiistai;20;152;172;1;7;8
293;20.09.2016;2016;09;16;Tiistai;24;39;63;4;5;9
293;20.09.2016;2016;09;17;Tiistai;22;28;50;3;5;8
293;20.09.2016;2016;09;18;Tiistai;24;20;44;12;14;26
293;20.09.2016;2016;09;19;Tiistai;15;45;60;2;4;6
293;20.09.2016;2016;09;20;Tiistai;9;16;25;1;1;2
293;20.09.2016;2016;09;21;Tiistai;3;8;11;0;1;1
293;20.09.2016;2016;09;22;Tiistai;1;3;4;1;1;2
293;20.09.2016;2016;09;23;Tiistai;0;0;0;0;0;0
293;21.09.2016;2016;09;00;Keskiviikko;0;0;0;0;0;0
293;21.09.2016;2016;09;01;Keskiviikko;0;0;0;0;0;0
293;21.09.2016;2016;09;02;Keskiviikko;1;1;2;1;0;1
293;21.09.2016;2016;09;03;Keskiviikko;0;0;0;0;0;0
293;21.09.2016;2016;09;04;Keskiviikko;0;0;0;0;0;0
293;21.09.2016;2016;09;05;Keskiviikko;4;1;5;0;0;0
293;21.09.2016;2016;09;06;Keskiviikko;19;2;21;0;0;0
293;21.09.2016;2016;09;07;Keskiviikko;118;6;124;3;1;4
293;21.09.2016;2016;09;08;Keskiviikko;101;10;111;3;1;4
293;21.09.2016;2016;09;09;Keskiviikko;31;10;41;9;2;11
293;21.09.2016;2016;09;10;Keskiviikko;22;10;32;3;4;7
293;21.09.2016;2016;09;11;Keskiviikko;15;18;33;6;4;10
293;21.09.2016;2016;09;12;Keskiviikko;11;28;39;3;6;9
293;21.09.2016;2016;09;13;Keskiviikko;16;53;69;6;4;10
293;21.09.2016;2016;09;14;Keskiviikko;25;137;162;4;9;13
293;21.09.2016;2016;09;15;Keskiviikko;28;39;67;4;5;9
293;21.09.2016;2016;09;16;Keskiviikko;25;35;60;4;5;9
293;21.09.2016;2016;09;17;Keskiviikko;39;20;59;4;4;8
293;21.09.2016;2016;09;18;Keskiviikko;22;36;58;4;6;10
293;21.09.2016;2016;09;19;Keskiviikko;29;40;69;8;5;13
293;21.09.2016;2016;09;20;Keskiviikko;4;21;25;2;2;4
293;21.09.2016;2016;09;21;Keskiviikko;2;10;12;0;2;2
293;21.09.2016;2016;09;22;Keskiviikko;0;2;2;0;0;0
293;21.09.2016;2016;09;23;Keskiviikko;0;0;0;1;1;2
293;22.09.2016;2016;09;00;Torstai;0;0;0;0;0;0
293;22.09.2016;2016;09;01;Torstai;0;0;0;0;1;1
293;22.09.2016;2016;09;02;Torstai;1;0;1;0;0;0
293;22.09.2016;2016;09;03;Torstai;0;0;0;0;0;0
293;22.09.2016;2016;09;04;Torstai;1;0;1;0;0;0
293;22.09.2016;2016;09;05;Torstai;4;1;5;0;0;0
293;22.09.2016;2016;09;06;Torstai;14;1;15;0;0;0
293;22.09.2016;2016;09;07;Torstai;100;4;104;2;1;3
293;22.09.2016;2016;09;08;Torstai;98;7;105;7;3;10
293;22.09.2016;2016;09;09;Torstai;19;8;27;3;1;4
293;22.09.2016;2016;09;10;Torstai;12;29;41;6;6;12
293;22.09.2016;2016;09;11;Torstai;15;17;32;7;3;10
293;22.09.2016;2016;09;12;Torstai;41;21;62;1;3;4
293;22.09.2016;2016;09;13;Torstai;11;66;77;2;6;8
293;22.09.2016;2016;09;14;Torstai;17;88;105;1;4;5
293;22.09.2016;2016;09;15;Torstai;29;63;92;5;3;8
293;22.09.2016;2016;09;16;Torstai;23;21;44;3;3;6
293;22.09.2016;2016;09;17;Torstai;18;29;47;4;4;8
293;22.09.2016;2016;09;18;Torstai;15;26;41;3;5;8
293;22.09.2016;2016;09;19;Torstai;21;25;46;6;3;9
293;22.09.2016;2016;09;20;Torstai;8;14;22;0;1;1
293;22.09.2016;2016;09;21;Torstai;4;3;7;0;1;1
293;22.09.2016;2016;09;22;Torstai;0;2;2;3;6;9
293;22.09.2016;2016;09;23;Torstai;0;1;1;1;0;1
293;23.09.2016;2016;09;00;Perjantai;0;0;0;0;0;0
293;23.09.2016;2016;09;01;Perjantai;0;0;0;0;1;1
293;23.09.2016;2016;09;02;Perjantai;0;0;0;0;0;0
293;23.09.2016;2016;09;03;Perjantai;0;0;0;0;0;0
293;23.09.2016;2016;09;04;Perjantai;0;0;0;1;0;1
293;23.09.2016;2016;09;05;Perjantai;2;1;3;0;0;0
293;23.09.2016;2016;09;06;Perjantai;11;1;12;0;1;1
293;23.09.2016;2016;09;07;Perjantai;52;4;56;2;0;2
293;23.09.2016;2016;09;08;Perjantai;79;11;90;4;1;5
293;23.09.2016;2016;09;09;Perjantai;13;8;21;2;0;2
293;23.09.2016;2016;09;10;Perjantai;18;9;27;1;1;2
293;23.09.2016;2016;09;11;Perjantai;12;19;31;1;2;3
293;23.09.2016;2016;09;12;Perjantai;20;59;79;2;1;3
293;23.09.2016;2016;09;13;Perjantai;17;59;76;1;3;4
293;23.09.2016;2016;09;14;Perjantai;28;36;64;1;4;5
293;23.09.2016;2016;09;15;Perjantai;25;48;73;1;2;3
293;23.09.2016;2016;09;16;Perjantai;29;33;62;3;3;6
293;23.09.2016;2016;09;17;Perjantai;21;30;51;2;4;6
293;23.09.2016;2016;09;18;Perjantai;14;29;43;3;5;8
293;23.09.2016;2016;09;19;Perjantai;28;19;47;1;0;1
293;23.09.2016;2016;09;20;Perjantai;15;17;32;2;5;7
293;23.09.2016;2016;09;21;Perjantai;4;9;13;0;1;1
293;23.09.2016;2016;09;22;Perjantai;2;8;10;0;0;0
293;23.09.2016;2016;09;23;Perjantai;5;6;11;4;1;5
293;24.09.2016;2016;09;00;Lauantai;2;0;2;2;0;2
293;24.09.2016;2016;09;01;Lauantai;2;0;2;1;0;1
293;24.09.2016;2016;09;02;Lauantai;0;1;1;0;3;3
293;24.09.2016;2016;09;03;Lauantai;0;1;1;0;0;0
293;24.09.2016;2016;09;04;Lauantai;0;4;4;0;0;0
293;24.09.2016;2016;09;05;Lauantai;0;0;0;0;1;1
293;24.09.2016;2016;09;06;Lauantai;4;2;6;0;0;0
293;24.09.2016;2016;09;07;Lauantai;4;0;4;0;0;0
293;24.09.2016;2016;09;08;Lauantai;9;2;11;0;2;2
293;24.09.2016;2016;09;09;Lauantai;5;6;11;0;1;1
293;24.09.2016;2016;09;10;Lauantai;18;12;30;4;1;5
293;24.09.2016;2016;09;11;Lauantai;16;16;32;3;4;7
293;24.09.2016;2016;09;12;Lauantai;15;15;30;1;2;3
293;24.09.2016;2016;09;13;Lauantai;27;27;54;6;6;12
293;24.09.2016;2016;09;14;Lauantai;13;14;27;7;3;10
293;24.09.2016;2016;09;15;Lauantai;12;17;29;3;4;7
293;24.09.2016;2016;09;16;Lauantai;10;22;32;6;5;11
293;24.09.2016;2016;09;17;Lauantai;13;9;22;4;4;8
293;24.09.2016;2016;09;18;Lauantai;17;17;34;3;4;7
293;24.09.2016;2016;09;19;Lauantai;11;19;30;4;3;7
293;24.09.2016;2016;09;20;Lauantai;13;12;25;3;0;3
293;24.09.2016;2016;09;21;Lauantai;11;7;18;1;3;4
293;24.09.2016;2016;09;22;Lauantai;0;3;3;0;0;0
293;24.09.2016;2016;09;23;Lauantai;6;3;9;0;1;1
293;25.09.2016;2016;09;00;Sunnuntai;1;1;2;1;0;1
293;25.09.2016;2016;09;01;Sunnuntai;1;1;2;1;0;1
293;25.09.2016;2016;09;02;Sunnuntai;1;3;4;0;0;0
293;25.09.2016;2016;09;03;Sunnuntai;0;2;2;0;4;4
293;25.09.2016;2016;09;04;Sunnuntai;0;1;1;25;21;46
293;25.09.2016;2016;09;05;Sunnuntai;0;0;0;0;0;0
293;25.09.2016;2016;09;06;Sunnuntai;4;0;4;0;0;0
293;25.09.2016;2016;09;07;Sunnuntai;1;1;2;0;0;0
293;25.09.2016;2016;09;08;Sunnuntai;4;2;6;1;0;1
293;25.09.2016;2016;09;09;Sunnuntai;11;4;15;3;4;7
293;25.09.2016;2016;09;10;Sunnuntai;18;13;31;5;6;11
293;25.09.2016;2016;09;11;Sunnuntai;14;21;35;1;7;8
293;25.09.2016;2016;09;12;Sunnuntai;17;13;30;7;5;12
293;25.09.2016;2016;09;13;Sunnuntai;25;15;40;10;3;13
293;25.09.2016;2016;09;14;Sunnuntai;26;20;46;2;2;4
293;25.09.2016;2016;09;15;Sunnuntai;20;38;58;3;6;9
293;25.09.2016;2016;09;16;Sunnuntai;29;26;55;2;5;7
293;25.09.2016;2016;09;17;Sunnuntai;25;29;54;4;5;9
293;25.09.2016;2016;09;18;Sunnuntai;27;29;56;7;3;10
293;25.09.2016;2016;09;19;Sunnuntai;9;20;29;5;6;11
293;25.09.2016;2016;09;20;Sunnuntai;7;13;20;0;7;7
293;25.09.2016;2016;09;21;Sunnuntai;2;5;7;0;0;0
293;25.09.2016;2016;09;22;Sunnuntai;1;1;2;0;0;0
293;25.09.2016;2016;09;23;Sunnuntai;1;1;2;0;0;0
293;26.09.2016;2016;09;00;Maanantai;0;1;1;0;0;0
293;26.09.2016;2016;09;01;Maanantai;0;0;0;0;0;0
293;26.09.2016;2016;09;02;Maanantai;0;0;0;0;0;0
293;26.09.2016;2016;09;03;Maanantai;0;0;0;0;0;0
293;26.09.2016;2016;09;04;Maanantai;0;0;0;0;0;0
293;26.09.2016;2016;09;05;Maanantai;6;1;7;0;0;0
293;26.09.2016;2016;09;06;Maanantai;13;2;15;0;0;0
293;26.09.2016;2016;09;07;Maanantai;73;7;80;1;2;3
293;26.09.2016;2016;09;08;Maanantai;109;16;125;6;2;8
293;26.09.2016;2016;09;09;Maanantai;28;6;34;3;3;6
293;26.09.2016;2016;09;10;Maanantai;19;6;25;7;1;8
293;26.09.2016;2016;09;11;Maanantai;10;15;25;3;3;6
293;26.09.2016;2016;09;12;Maanantai;20;26;46;4;5;9
293;26.09.2016;2016;09;13;Maanantai;17;56;73;1;8;9
293;26.09.2016;2016;09;14;Maanantai;24;77;101;5;4;9
293;26.09.2016;2016;09;15;Maanantai;24;86;110;2;4;6
293;26.09.2016;2016;09;16;Maanantai;33;38;71;6;3;9
293;26.09.2016;2016;09;17;Maanantai;38;28;66;4;3;7
293;26.09.2016;2016;09;18;Maanantai;22;35;57;14;12;26
293;26.09.2016;2016;09;19;Maanantai;18;26;44;4;10;14
293;26.09.2016;2016;09;20;Maanantai;2;20;22;1;4;5
293;26.09.2016;2016;09;21;Maanantai;2;6;8;2;0;2
293;26.09.2016;2016;09;22;Maanantai;0;2;2;0;1;1
293;26.09.2016;2016;09;23;Maanantai;0;0;0;0;0;0
293;27.09.2016;2016;09;00;Tiistai;1;0;1;0;0;0
293;27.09.2016;2016;09;01;Tiistai;0;0;0;0;0;0
293;27.09.2016;2016;09;02;Tiistai;1;0;1;0;0;0
293;27.09.2016;2016;09;03;Tiistai;0;1;1;0;0;0
293;27.09.2016;2016;09;04;Tiistai;0;0;0;0;0;0
293;27.09.2016;2016;09;05;Tiistai;5;2;7;0;0;0
293;27.09.2016;2016;09;06;Tiistai;19;2;21;0;0;0
293;27.09.2016;2016;09;07;Tiistai;66;5;71;3;1;4
293;27.09.2016;2016;09;08;Tiistai;113;16;129;3;2;5
293;27.09.2016;2016;09;09;Tiistai;41;8;49;4;0;4
293;27.09.2016;2016;09;10;Tiistai;23;10;33;3;1;4
293;27.09.2016;2016;09;11;Tiistai;14;18;32;2;2;4
293;27.09.2016;2016;09;12;Tiistai;13;29;42;3;3;6
293;27.09.2016;2016;09;13;Tiistai;22;27;49;4;12;16
293;27.09.2016;2016;09;14;Tiistai;29;67;96;4;5;9
293;27.09.2016;2016;09;15;Tiistai;29;119;148;2;11;13
293;27.09.2016;2016;09;16;Tiistai;33;43;76;6;4;10
293;27.09.2016;2016;09;17;Tiistai;23;25;48;5;4;9
293;27.09.2016;2016;09;18;Tiistai;19;35;54;6;6;12
293;27.09.2016;2016;09;19;Tiistai;12;15;27;4;2;6
293;27.09.2016;2016;09;20;Tiistai;7;18;25;3;4;7
293;27.09.2016;2016;09;21;Tiistai;2;12;14;0;0;0
293;27.09.2016;2016;09;22;Tiistai;0;2;2;0;1;1
293;27.09.2016;2016;09;23;Tiistai;0;0;0;0;0;0
293;28.09.2016;2016;09;00;Keskiviikko;0;0;0;0;0;0
293;28.09.2016;2016;09;01;Keskiviikko;0;0;0;1;0;1
293;28.09.2016;2016;09;02;Keskiviikko;1;0;1;0;0;0
293;28.09.2016;2016;09;03;Keskiviikko;0;0;0;0;0;0
293;28.09.2016;2016;09;04;Keskiviikko;0;0;0;0;0;0
293;28.09.2016;2016;09;05;Keskiviikko;5;0;5;0;0;0
293;28.09.2016;2016;09;06;Keskiviikko;15;3;18;0;0;0
293;28.09.2016;2016;09;07;Keskiviikko;95;7;102;5;2;7
293;28.09.2016;2016;09;08;Keskiviikko;103;11;114;9;3;12
293;28.09.2016;2016;09;09;Keskiviikko;27;10;37;2;1;3
293;28.09.2016;2016;09;10;Keskiviikko;16;12;28;3;5;8
293;28.09.2016;2016;09;11;Keskiviikko;16;14;30;5;6;11
293;28.09.2016;2016;09;12;Keskiviikko;13;28;41;1;2;3
293;28.09.2016;2016;09;13;Keskiviikko;7;54;61;0;2;2
293;28.09.2016;2016;09;14;Keskiviikko;27;125;152;2;6;8
293;28.09.2016;2016;09;15;Keskiviikko;28;37;65;2;2;4
293;28.09.2016;2016;09;16;Keskiviikko;17;23;40;2;4;6
293;28.09.2016;2016;09;17;Keskiviikko;14;22;36;1;1;2
293;28.09.2016;2016;09;18;Keskiviikko;10;4;14;0;4;4
293;28.09.2016;2016;09;19;Keskiviikko;5;14;19;1;1;2
293;28.09.2016;2016;09;20;Keskiviikko;3;8;11;0;0;0
293;28.09.2016;2016;09;21;Keskiviikko;2;1;3;0;0;0
293;28.09.2016;2016;09;22;Keskiviikko;0;0;0;0;0;0
293;28.09.2016;2016;09;23;Keskiviikko;1;0;1;1;0;1
293;29.09.2016;2016;09;00;Torstai;0;0;0;0;1;1
293;29.09.2016;2016;09;01;Torstai;0;0;0;0;0;0
293;29.09.2016;2016;09;02;Torstai;1;0;1;0;0;0
293;29.09.2016;2016;09;03;Torstai;1;0;1;0;0;0
293;29.09.2016;2016;09;04;Torstai;0;0;0;0;0;0
293;29.09.2016;2016;09;05;Torstai;4;1;5;0;0;0
293;29.09.2016;2016;09;06;Torstai;8;0;8;1;0;1
293;29.09.2016;2016;09;07;Torstai;87;8;95;0;0;0
293;29.09.2016;2016;09;08;Torstai;107;7;114;6;1;7
293;29.09.2016;2016;09;09;Torstai;23;9;32;1;1;2
293;29.09.2016;2016;09;10;Torstai;14;14;28;2;6;8
293;29.09.2016;2016;09;11;Torstai;14;16;30;2;4;6
293;29.09.2016;2016;09;12;Torstai;16;26;42;2;3;5
293;29.09.2016;2016;09;13;Torstai;27;160;187;3;10;13
293;29.09.2016;2016;09;14;Torstai;19;27;46;8;6;14
293;29.09.2016;2016;09;15;Torstai;34;32;66;3;6;9
293;29.09.2016;2016;09;16;Torstai;28;35;63;6;2;8
293;29.09.2016;2016;09;17;Torstai;23;29;52;4;11;15
293;29.09.2016;2016;09;18;Torstai;15;22;37;6;6;12
293;29.09.2016;2016;09;19;Torstai;8;13;21;1;3;4
293;29.09.2016;2016;09;20;Torstai;2;7;9;1;0;1
293;29.09.2016;2016;09;21;Torstai;2;2;4;0;1;1
293;29.09.2016;2016;09;22;Torstai;0;3;3;0;1;1
293;29.09.2016;2016;09;23;Torstai;1;2;3;0;0;0
293;30.09.2016;2016;09;00;Perjantai;0;0;0;0;0;0
293;30.09.2016;2016;09;01;Perjantai;0;0;0;0;0;0
293;30.09.2016;2016;09;02;Perjantai;0;0;0;0;0;0
293;30.09.2016;2016;09;03;Perjantai;0;0;0;0;0;0
293;30.09.2016;2016;09;04;Perjantai;0;0;0;0;0;0
293;30.09.2016;2016;09;05;Perjantai;3;2;5;0;0;0
293;30.09.2016;2016;09;06;Perjantai;6;0;6;0;0;0
293;30.09.2016;2016;09;07;Perjantai;82;6;88;2;0;2
293;30.09.2016;2016;09;08;Perjantai;88;9;97;7;0;7
293;30.09.2016;2016;09;09;Perjantai;25;9;34;0;0;0
293;30.09.2016;2016;09;10;Perjantai;15;7;22;1;0;1
293;30.09.2016;2016;09;11;Perjantai;12;12;24;2;2;4
293;30.09.2016;2016;09;12;Perjantai;14;44;58;3;2;5
293;30.09.2016;2016;09;13;Perjantai;13;54;67;1;3;4
293;30.09.2016;2016;09;14;Perjantai;20;71;91;3;4;7
293;30.09.2016;2016;09;15;Perjantai;11;66;77;1;4;5
293;30.09.2016;2016;09;16;Perjantai;23;15;38;6;3;9
293;30.09.2016;2016;09;17;Perjantai;29;19;48;2;2;4
293;30.09.2016;2016;09;18;Perjantai;12;21;33;2;4;6
293;30.09.2016;2016;09;19;Perjantai;12;23;35;0;1;1
293;30.09.2016;2016;09;20;Perjantai;5;22;27;0;2;2
293;30.09.2016;2016;09;21;Perjantai;3;8;11;1;2;3
293;30.09.2016;2016;09;22;Perjantai;3;2;5;1;1;2
293;30.09.2016;2016;09;23;Perjantai;2;1;3;0;0;0
293;01.10.2016;2016;10;00;Lauantai;0;2;2;0;0;0
293;01.10.2016;2016;10;01;Lauantai;0;0;0;0;0;0
293;01.10.2016;2016;10;02;Lauantai;0;0;0;0;0;0
293;01.10.2016;2016;10;03;Lauantai;0;0;0;1;0;1
293;01.10.2016;2016;10;04;Lauantai;0;0;0;0;1;1
293;01.10.2016;2016;10;05;Lauantai;0;0;0;0;0;0
293;01.10.2016;2016;10;06;Lauantai;1;0;1;0;0;0
293;01.10.2016;2016;10;07;Lauantai;0;0;0;0;0;0
293;01.10.2016;2016;10;08;Lauantai;4;3;7;1;2;3
293;01.10.2016;2016;10;09;Lauantai;10;5;15;4;2;6
293;01.10.2016;2016;10;10;Lauantai;24;9;33;6;5;11
293;01.10.2016;2016;10;11;Lauantai;23;16;39;6;3;9
293;01.10.2016;2016;10;12;Lauantai;29;12;41;3;1;4
293;01.10.2016;2016;10;13;Lauantai;17;26;43;4;6;10
293;01.10.2016;2016;10;14;Lauantai;22;18;40;3;2;5
293;01.10.2016;2016;10;15;Lauantai;19;20;39;5;3;8
293;01.10.2016;2016;10;16;Lauantai;22;20;42;2;7;9
293;01.10.2016;2016;10;17;Lauantai;18;16;34;2;2;4
293;01.10.2016;2016;10;18;Lauantai;15;24;39;6;7;13
293;01.10.2016;2016;10;19;Lauantai;16;22;38;2;6;8
293;01.10.2016;2016;10;20;Lauantai;16;15;31;3;2;5
293;01.10.2016;2016;10;21;Lauantai;5;14;19;2;2;4
293;01.10.2016;2016;10;22;Lauantai;7;10;17;1;1;2
293;01.10.2016;2016;10;23;Lauantai;3;3;6;0;0;0
293;02.10.2016;2016;10;00;Sunnuntai;1;2;3;0;5;5
293;02.10.2016;2016;10;01;Sunnuntai;4;2;6;3;2;5
293;02.10.2016;2016;10;02;Sunnuntai;1;1;2;1;2;3
293;02.10.2016;2016;10;03;Sunnuntai;1;2;3;0;1;1
293;02.10.2016;2016;10;04;Sunnuntai;1;2;3;0;2;2
293;02.10.2016;2016;10;05;Sunnuntai;0;0;0;0;0;0
293;02.10.2016;2016;10;06;Sunnuntai;2;0;2;0;0;0
293;02.10.2016;2016;10;07;Sunnuntai;3;0;3;0;0;0
293;02.10.2016;2016;10;08;Sunnuntai;3;2;5;1;2;3
293;02.10.2016;2016;10;09;Sunnuntai;24;7;31;12;4;16
293;02.10.2016;2016;10;10;Sunnuntai;12;10;22;2;4;6
293;02.10.2016;2016;10;11;Sunnuntai;11;33;44;4;7;11
293;02.10.2016;2016;10;12;Sunnuntai;30;18;48;12;7;19
293;02.10.2016;2016;10;13;Sunnuntai;30;13;43;5;2;7
293;02.10.2016;2016;10;14;Sunnuntai;25;38;63;6;5;11
293;02.10.2016;2016;10;15;Sunnuntai;30;26;56;8;5;13
293;02.10.2016;2016;10;16;Sunnuntai;15;27;42;4;2;6
293;02.10.2016;2016;10;17;Sunnuntai;18;14;32;5;4;9
293;02.10.2016;2016;10;18;Sunnuntai;22;21;43;6;5;11
293;02.10.2016;2016;10;19;Sunnuntai;14;10;24;3;1;4
293;02.10.2016;2016;10;20;Sunnuntai;6;11;17;1;2;3
293;02.10.2016;2016;10;21;Sunnuntai;2;9;11;0;0;0
293;02.10.2016;2016;10;22;Sunnuntai;1;2;3;0;0;0
293;02.10.2016;2016;10;23;Sunnuntai;0;1;1;0;0;0
293;03.10.2016;2016;10;00;Maanantai;0;0;0;0;0;0
293;03.10.2016;2016;10;01;Maanantai;0;1;1;0;0;0
293;03.10.2016;2016;10;02;Maanantai;0;0;0;0;0;0
293;03.10.2016;2016;10;03;Maanantai;0;0;0;0;0;0
293;03.10.2016;2016;10;04;Maanantai;0;0;0;0;0;0
293;03.10.2016;2016;10;05;Maanantai;4;1;5;0;0;0
293;03.10.2016;2016;10;06;Maanantai;13;3;16;0;0;0
293;03.10.2016;2016;10;07;Maanantai;105;7;112;3;0;3
293;03.10.2016;2016;10;08;Maanantai;82;7;89;3;2;5
293;03.10.2016;2016;10;09;Maanantai;29;5;34;0;0;0
293;03.10.2016;2016;10;10;Maanantai;21;5;26;3;3;6
293;03.10.2016;2016;10;11;Maanantai;9;17;26;4;3;7
293;03.10.2016;2016;10;12;Maanantai;23;21;44;4;2;6
293;03.10.2016;2016;10;13;Maanantai;15;42;57;5;5;10
293;03.10.2016;2016;10;14;Maanantai;13;85;98;6;9;15
293;03.10.2016;2016;10;15;Maanantai;17;99;116;2;10;12
293;03.10.2016;2016;10;16;Maanantai;26;29;55;5;2;7
293;03.10.2016;2016;10;17;Maanantai;36;24;60;5;4;9
293;03.10.2016;2016;10;18;Maanantai;21;35;56;8;6;14
293;03.10.2016;2016;10;19;Maanantai;9;18;27;1;4;5
293;03.10.2016;2016;10;20;Maanantai;6;15;21;6;4;10
293;03.10.2016;2016;10;21;Maanantai;2;6;8;3;2;5
293;03.10.2016;2016;10;22;Maanantai;1;2;3;0;0;0
293;03.10.2016;2016;10;23;Maanantai;0;0;0;0;0;0
293;04.10.2016;2016;10;00;Tiistai;0;0;0;0;0;0
293;04.10.2016;2016;10;01;Tiistai;0;0;0;1;0;1
293;04.10.2016;2016;10;02;Tiistai;0;1;1;0;0;0
293;04.10.2016;2016;10;03;Tiistai;0;0;0;0;0;0
293;04.10.2016;2016;10;04;Tiistai;0;0;0;0;0;0
293;04.10.2016;2016;10;05;Tiistai;4;1;5;0;0;0
293;04.10.2016;2016;10;06;Tiistai;15;4;19;0;0;0
293;04.10.2016;2016;10;07;Tiistai;64;4;68;2;0;2
293;04.10.2016;2016;10;08;Tiistai;80;4;84;3;0;3
293;04.10.2016;2016;10;09;Tiistai;71;6;77;8;1;9
293;04.10.2016;2016;10;10;Tiistai;30;12;42;5;2;7
293;04.10.2016;2016;10;11;Tiistai;15;13;28;4;2;6
293;04.10.2016;2016;10;12;Tiistai;14;16;30;1;4;5
293;04.10.2016;2016;10;13;Tiistai;11;20;31;2;7;9
293;04.10.2016;2016;10;14;Tiistai;40;64;104;5;3;8
293;04.10.2016;2016;10;15;Tiistai;25;163;188;4;5;9
293;04.10.2016;2016;10;16;Tiistai;37;41;78;6;7;13
293;04.10.2016;2016;10;17;Tiistai;22;25;47;9;4;13
293;04.10.2016;2016;10;18;Tiistai;21;21;42;4;7;11
293;04.10.2016;2016;10;19;Tiistai;18;25;43;8;8;16
293;04.10.2016;2016;10;20;Tiistai;5;12;17;2;2;4
293;04.10.2016;2016;10;21;Tiistai;2;9;11;1;3;4
293;04.10.2016;2016;10;22;Tiistai;1;1;2;1;0;1
293;04.10.2016;2016;10;23;Tiistai;0;0;0;0;0;0
293;05.10.2016;2016;10;00;Keskiviikko;0;0;0;0;0;0
293;05.10.2016;2016;10;01;Keskiviikko;0;0;0;1;0;1
293;05.10.2016;2016;10;02;Keskiviikko;0;1;1;0;0;0
293;05.10.2016;2016;10;03;Keskiviikko;0;0;0;0;0;0
293;05.10.2016;2016;10;04;Keskiviikko;0;0;0;0;0;0
293;05.10.2016;2016;10;05;Keskiviikko;5;0;5;0;0;0
293;05.10.2016;2016;10;06;Keskiviikko;13;3;16;0;0;0
293;05.10.2016;2016;10;07;Keskiviikko;94;5;99;7;0;7
293;05.10.2016;2016;10;08;Keskiviikko;93;6;99;5;1;6
293;05.10.2016;2016;10;09;Keskiviikko;27;9;36;2;0;2
293;05.10.2016;2016;10;10;Keskiviikko;11;11;22;3;2;5
293;05.10.2016;2016;10;11;Keskiviikko;15;13;28;2;1;3
293;05.10.2016;2016;10;12;Keskiviikko;10;31;41;2;4;6
293;05.10.2016;2016;10;13;Keskiviikko;15;43;58;3;4;7
293;05.10.2016;2016;10;14;Keskiviikko;16;131;147;5;14;19
293;05.10.2016;2016;10;15;Keskiviikko;18;45;63;4;3;7
293;05.10.2016;2016;10;16;Keskiviikko;25;16;41;17;16;33
293;05.10.2016;2016;10;17;Keskiviikko;29;26;55;3;6;9
293;05.10.2016;2016;10;18;Keskiviikko;14;28;42;5;8;13
293;05.10.2016;2016;10;19;Keskiviikko;21;23;44;2;5;7
293;05.10.2016;2016;10;20;Keskiviikko;5;14;19;3;5;8
293;05.10.2016;2016;10;21;Keskiviikko;4;11;15;1;0;1
293;05.10.2016;2016;10;22;Keskiviikko;1;3;4;0;0;0
293;05.10.2016;2016;10;23;Keskiviikko;0;0;0;0;0;0
293;06.10.2016;2016;10;00;Torstai;0;0;0;0;0;0
293;06.10.2016;2016;10;01;Torstai;0;2;2;0;0;0
293;06.10.2016;2016;10;02;Torstai;1;0;1;0;0;0
293;06.10.2016;2016;10;03;Torstai;0;0;0;0;0;0
293;06.10.2016;2016;10;04;Torstai;0;0;0;0;0;0
293;06.10.2016;2016;10;05;Torstai;2;0;2;0;0;0
293;06.10.2016;2016;10;06;Torstai;11;2;13;0;0;0
293;06.10.2016;2016;10;07;Torstai;97;9;106;2;0;2
293;06.10.2016;2016;10;08;Torstai;95;2;97;4;1;5
293;06.10.2016;2016;10;09;Torstai;25;7;32;0;1;1
293;06.10.2016;2016;10;10;Torstai;15;4;19;1;2;3
293;06.10.2016;2016;10;11;Torstai;31;12;43;7;4;11
293;06.10.2016;2016;10;12;Torstai;10;36;46;2;5;7
293;06.10.2016;2016;10;13;Torstai;10;56;66;3;3;6
293;06.10.2016;2016;10;14;Torstai;16;78;94;2;4;6
293;06.10.2016;2016;10;15;Torstai;13;87;100;3;9;12
293;06.10.2016;2016;10;16;Torstai;23;26;49;4;2;6
293;06.10.2016;2016;10;17;Torstai;19;24;43;4;7;11
293;06.10.2016;2016;10;18;Torstai;19;19;38;3;4;7
293;06.10.2016;2016;10;19;Torstai;13;23;36;2;3;5
293;06.10.2016;2016;10;20;Torstai;6;9;15;1;3;4
293;06.10.2016;2016;10;21;Torstai;0;5;5;0;0;0
293;06.10.2016;2016;10;22;Torstai;0;2;2;0;0;0
293;06.10.2016;2016;10;23;Torstai;0;0;0;0;0;0
293;07.10.2016;2016;10;00;Perjantai;0;1;1;0;0;0
293;07.10.2016;2016;10;01;Perjantai;0;0;0;0;0;0
293;07.10.2016;2016;10;02;Perjantai;0;0;0;0;0;0
293;07.10.2016;2016;10;03;Perjantai;1;0;1;0;0;0
293;07.10.2016;2016;10;04;Perjantai;0;0;0;0;0;0
293;07.10.2016;2016;10;05;Perjantai;1;0;1;0;0;0
293;07.10.2016;2016;10;06;Perjantai;8;1;9;1;0;1
293;07.10.2016;2016;10;07;Perjantai;77;9;86;4;0;4
293;07.10.2016;2016;10;08;Perjantai;80;9;89;4;1;5
293;07.10.2016;2016;10;09;Perjantai;36;9;45;7;1;8
293;07.10.2016;2016;10;10;Perjantai;25;12;37;2;3;5
293;07.10.2016;2016;10;11;Perjantai;25;15;40;5;0;5
293;07.10.2016;2016;10;12;Perjantai;28;46;74;6;6;12
293;07.10.2016;2016;10;13;Perjantai;23;49;72;3;4;7
293;07.10.2016;2016;10;14;Perjantai;26;116;142;2;8;10
293;07.10.2016;2016;10;15;Perjantai;25;53;78;9;6;15
293;07.10.2016;2016;10;16;Perjantai;15;20;35;5;3;8
293;07.10.2016;2016;10;17;Perjantai;14;24;38;6;2;8
293;07.10.2016;2016;10;18;Perjantai;20;29;49;7;2;9
293;07.10.2016;2016;10;19;Perjantai;27;16;43;5;9;14
293;07.10.2016;2016;10;20;Perjantai;39;18;57;7;2;9
293;07.10.2016;2016;10;21;Perjantai;4;22;26;2;5;7
293;07.10.2016;2016;10;22;Perjantai;3;5;8;2;0;2
293;07.10.2016;2016;10;23;Perjantai;0;1;1;0;0;0
293;08.10.2016;2016;10;00;Lauantai;3;3;6;0;0;0
293;08.10.2016;2016;10;01;Lauantai;0;0;0;0;0;0
293;08.10.2016;2016;10;02;Lauantai;0;3;3;0;0;0
293;08.10.2016;2016;10;03;Lauantai;0;0;0;0;0;0
293;08.10.2016;2016;10;04;Lauantai;0;0;0;0;1;1
293;08.10.2016;2016;10;05;Lauantai;1;0;1;1;1;2
293;08.10.2016;2016;10;06;Lauantai;2;0;2;1;0;1
293;08.10.2016;2016;10;07;Lauantai;2;2;4;0;0;0
293;08.10.2016;2016;10;08;Lauantai;4;2;6;1;0;1
293;08.10.2016;2016;10;09;Lauantai;9;7;16;7;4;11
293;08.10.2016;2016;10;10;Lauantai;11;11;22;2;5;7
293;08.10.2016;2016;10;11;Lauantai;20;8;28;7;4;11
293;08.10.2016;2016;10;12;Lauantai;16;20;36;7;9;16
293;08.10.2016;2016;10;13;Lauantai;22;23;45;9;3;12
293;08.10.2016;2016;10;14;Lauantai;18;20;38;3;8;11
293;08.10.2016;2016;10;15;Lauantai;30;19;49;3;6;9
293;08.10.2016;2016;10;16;Lauantai;19;23;42;6;3;9
293;08.10.2016;2016;10;17;Lauantai;24;9;33;6;6;12
293;08.10.2016;2016;10;18;Lauantai;20;15;35;4;7;11
293;08.10.2016;2016;10;19;Lauantai;6;17;23;0;3;3
293;08.10.2016;2016;10;20;Lauantai;6;17;23;1;0;1
293;08.10.2016;2016;10;21;Lauantai;0;6;6;0;0;0
293;08.10.2016;2016;10;22;Lauantai;0;2;2;0;2;2
293;08.10.2016;2016;10;23;Lauantai;1;0;1;1;0;1
293;09.10.2016;2016;10;00;Sunnuntai;0;1;1;0;1;1
293;09.10.2016;2016;10;01;Sunnuntai;0;1;1;1;0;1
293;09.10.2016;2016;10;02;Sunnuntai;0;1;1;0;1;1
293;09.10.2016;2016;10;03;Sunnuntai;0;2;2;0;1;1
293;09.10.2016;2016;10;04;Sunnuntai;1;0;1;0;0;0
293;09.10.2016;2016;10;05;Sunnuntai;0;0;0;0;1;1
293;09.10.2016;2016;10;06;Sunnuntai;3;0;3;0;0;0
293;09.10.2016;2016;10;07;Sunnuntai;0;0;0;0;0;0
293;09.10.2016;2016;10;08;Sunnuntai;1;2;3;2;2;4
293;09.10.2016;2016;10;09;Sunnuntai;15;4;19;5;3;8
293;09.10.2016;2016;10;10;Sunnuntai;8;7;15;6;7;13
293;09.10.2016;2016;10;11;Sunnuntai;13;10;23;10;5;15
293;09.10.2016;2016;10;12;Sunnuntai;18;23;41;7;8;15
293;09.10.2016;2016;10;13;Sunnuntai;19;22;41;7;5;12
293;09.10.2016;2016;10;14;Sunnuntai;24;12;36;5;11;16
293;09.10.2016;2016;10;15;Sunnuntai;21;16;37;14;5;19
293;09.10.2016;2016;10;16;Sunnuntai;19;19;38;6;9;15
293;09.10.2016;2016;10;17;Sunnuntai;10;12;22;11;3;14
293;09.10.2016;2016;10;18;Sunnuntai;25;17;42;6;3;9
293;09.10.2016;2016;10;19;Sunnuntai;8;11;19;2;4;6
293;09.10.2016;2016;10;20;Sunnuntai;3;7;10;1;0;1
293;09.10.2016;2016;10;21;Sunnuntai;3;6;9;2;0;2
293;09.10.2016;2016;10;22;Sunnuntai;0;0;0;0;0;0
293;09.10.2016;2016;10;23;Sunnuntai;0;0;0;0;0;0
293;10.10.2016;2016;10;00;Maanantai;0;0;0;0;0;0
293;10.10.2016;2016;10;01;Maanantai;0;0;0;0;0;0
293;10.10.2016;2016;10;02;Maanantai;0;0;0;0;0;0
293;10.10.2016;2016;10;03;Maanantai;0;0;0;0;0;0
293;10.10.2016;2016;10;04;Maanantai;0;0;0;0;0;0
293;10.10.2016;2016;10;05;Maanantai;5;1;6;1;1;2
293;10.10.2016;2016;10;06;Maanantai;12;1;13;0;0;0
293;10.10.2016;2016;10;07;Maanantai;101;9;110;5;0;5
293;10.10.2016;2016;10;08;Maanantai;95;6;101;4;0;4
293;10.10.2016;2016;10;09;Maanantai;21;7;28;1;1;2
293;10.10.2016;2016;10;10;Maanantai;22;12;34;2;3;5
293;10.10.2016;2016;10;11;Maanantai;10;12;22;4;1;5
293;10.10.2016;2016;10;12;Maanantai;16;20;36;4;3;7
293;10.10.2016;2016;10;13;Maanantai;18;47;65;4;5;9
293;10.10.2016;2016;10;14;Maanantai;15;83;98;3;2;5
293;10.10.2016;2016;10;15;Maanantai;17;100;117;8;6;14
293;10.10.2016;2016;10;16;Maanantai;29;34;63;4;6;10
293;10.10.2016;2016;10;17;Maanantai;24;23;47;10;3;13
293;10.10.2016;2016;10;18;Maanantai;28;18;46;10;5;15
293;10.10.2016;2016;10;19;Maanantai;13;24;37;5;7;12
293;10.10.2016;2016;10;20;Maanantai;4;16;20;5;5;10
293;10.10.2016;2016;10;21;Maanantai;3;7;10;0;1;1
293;10.10.2016;2016;10;22;Maanantai;2;0;2;0;0;0
293;10.10.2016;2016;10;23;Maanantai;0;0;0;0;0;0
293;11.10.2016;2016;10;00;Tiistai;0;0;0;0;0;0
293;11.10.2016;2016;10;01;Tiistai;0;0;0;0;0;0
293;11.10.2016;2016;10;02;Tiistai;0;0;0;0;0;0
293;11.10.2016;2016;10;03;Tiistai;0;1;1;0;0;0
293;11.10.2016;2016;10;04;Tiistai;0;0;0;0;0;0
293;11.10.2016;2016;10;05;Tiistai;6;2;8;0;0;0
293;11.10.2016;2016;10;06;Tiistai;17;3;20;0;0;0
293;11.10.2016;2016;10;07;Tiistai;66;4;70;3;1;4
293;11.10.2016;2016;10;08;Tiistai;73;6;79;4;2;6
293;11.10.2016;2016;10;09;Tiistai;68;10;78;6;1;7
293;11.10.2016;2016;10;10;Tiistai;26;16;42;6;4;10
293;11.10.2016;2016;10;11;Tiistai;12;10;22;5;0;5
293;11.10.2016;2016;10;12;Tiistai;19;11;30;3;4;7
293;11.10.2016;2016;10;13;Tiistai;5;23;28;4;6;10
293;11.10.2016;2016;10;14;Tiistai;17;62;79;4;12;16
293;11.10.2016;2016;10;15;Tiistai;18;144;162;2;5;7
293;11.10.2016;2016;10;16;Tiistai;27;44;71;5;4;9
293;11.10.2016;2016;10;17;Tiistai;19;21;40;9;5;14
293;11.10.2016;2016;10;18;Tiistai;24;30;54;10;13;23
293;11.10.2016;2016;10;19;Tiistai;6;18;24;3;3;6
293;11.10.2016;2016;10;20;Tiistai;9;10;19;1;0;1
293;11.10.2016;2016;10;21;Tiistai;2;5;7;1;0;1
293;11.10.2016;2016;10;22;Tiistai;3;3;6;0;0;0
293;11.10.2016;2016;10;23;Tiistai;0;0;0;0;0;0
293;12.10.2016;2016;10;00;Keskiviikko;0;0;0;1;1;2
293;12.10.2016;2016;10;01;Keskiviikko;0;0;0;0;0;0
293;12.10.2016;2016;10;02;Keskiviikko;0;1;1;0;0;0
293;12.10.2016;2016;10;03;Keskiviikko;0;0;0;0;0;0
293;12.10.2016;2016;10;04;Keskiviikko;0;0;0;0;0;0
293;12.10.2016;2016;10;05;Keskiviikko;4;1;5;0;0;0
293;12.10.2016;2016;10;06;Keskiviikko;9;2;11;0;0;0
293;12.10.2016;2016;10;07;Keskiviikko;94;10;104;1;1;2
293;12.10.2016;2016;10;08;Keskiviikko;82;3;85;9;0;9
293;12.10.2016;2016;10;09;Keskiviikko;36;11;47;3;2;5
293;12.10.2016;2016;10;10;Keskiviikko;11;14;25;3;2;5
293;12.10.2016;2016;10;11;Keskiviikko;11;63;74;1;6;7
293;12.10.2016;2016;10;12;Keskiviikko;67;28;95;11;2;13
293;12.10.2016;2016;10;13;Keskiviikko;4;30;34;4;10;14
293;12.10.2016;2016;10;14;Keskiviikko;18;125;143;5;9;14
293;12.10.2016;2016;10;15;Keskiviikko;24;35;59;5;7;12
293;12.10.2016;2016;10;16;Keskiviikko;18;14;32;5;3;8
293;12.10.2016;2016;10;17;Keskiviikko;21;28;49;6;4;10
293;12.10.2016;2016;10;18;Keskiviikko;17;18;35;6;5;11
293;12.10.2016;2016;10;19;Keskiviikko;11;27;38;2;3;5
293;12.10.2016;2016;10;20;Keskiviikko;3;15;18;2;4;6
293;12.10.2016;2016;10;21;Keskiviikko;5;6;11;1;0;1
293;12.10.2016;2016;10;22;Keskiviikko;0;0;0;0;0;0
293;12.10.2016;2016;10;23;Keskiviikko;0;0;0;0;0;0
293;13.10.2016;2016;10;00;Torstai;0;0;0;0;0;0
293;13.10.2016;2016;10;01;Torstai;0;0;0;0;0;0
293;13.10.2016;2016;10;02;Torstai;0;0;0;0;0;0
293;13.10.2016;2016;10;03;Torstai;0;0;0;0;0;0
293;13.10.2016;2016;10;04;Torstai;0;0;0;0;0;0
293;13.10.2016;2016;10;05;Torstai;3;0;3;0;0;0
293;13.10.2016;2016;10;06;Torstai;14;4;18;0;0;0
293;13.10.2016;2016;10;07;Torstai;96;5;101;2;1;3
293;13.10.2016;2016;10;08;Torstai;98;9;107;3;2;5
293;13.10.2016;2016;10;09;Torstai;26;12;38;1;0;1
293;13.10.2016;2016;10;10;Torstai;13;13;26;2;1;3
293;13.10.2016;2016;10;11;Torstai;17;13;30;3;3;6
293;13.10.2016;2016;10;12;Torstai;15;23;38;5;4;9
293;13.10.2016;2016;10;13;Torstai;10;36;46;2;4;6
293;13.10.2016;2016;10;14;Torstai;22;107;129;7;8;15
293;13.10.2016;2016;10;15;Torstai;26;83;109;2;3;5
293;13.10.2016;2016;10;16;Torstai;22;24;46;6;3;9
293;13.10.2016;2016;10;17;Torstai;32;28;60;1;10;11
293;13.10.2016;2016;10;18;Torstai;20;17;37;10;5;15
293;13.10.2016;2016;10;19;Torstai;9;22;31;3;6;9
293;13.10.2016;2016;10;20;Torstai;5;14;19;0;3;3
293;13.10.2016;2016;10;21;Torstai;5;5;10;0;2;2
293;13.10.2016;2016;10;22;Torstai;1;4;5;0;0;0
293;13.10.2016;2016;10;23;Torstai;0;0;0;0;0;0
293;14.10.2016;2016;10;00;Perjantai;2;0;2;0;0;0
293;14.10.2016;2016;10;01;Perjantai;0;0;0;0;0;0
293;14.10.2016;2016;10;02;Perjantai;0;0;0;0;0;0
293;14.10.2016;2016;10;03;Perjantai;0;1;1;0;0;0
293;14.10.2016;2016;10;04;Perjantai;0;0;0;0;0;0
293;14.10.2016;2016;10;05;Perjantai;2;3;5;0;0;0
293;14.10.2016;2016;10;06;Perjantai;10;3;13;0;0;0
293;14.10.2016;2016;10;07;Perjantai;71;7;78;2;0;2
293;14.10.2016;2016;10;08;Perjantai;82;8;90;4;3;7
293;14.10.2016;2016;10;09;Perjantai;29;7;36;3;3;6
293;14.10.2016;2016;10;10;Perjantai;25;12;37;2;2;4
293;14.10.2016;2016;10;11;Perjantai;14;9;23;5;3;8
293;14.10.2016;2016;10;12;Perjantai;19;31;50;3;5;8
293;14.10.2016;2016;10;13;Perjantai;23;53;76;8;9;17
293;14.10.2016;2016;10;14;Perjantai;14;100;114;9;4;13
293;14.10.2016;2016;10;15;Perjantai;23;67;90;1;5;6
293;14.10.2016;2016;10;16;Perjantai;20;26;46;11;6;17
293;14.10.2016;2016;10;17;Perjantai;21;23;44;4;9;13
293;14.10.2016;2016;10;18;Perjantai;21;26;47;3;6;9
293;14.10.2016;2016;10;19;Perjantai;9;10;19;2;4;6
293;14.10.2016;2016;10;20;Perjantai;16;11;27;4;2;6
293;14.10.2016;2016;10;21;Perjantai;7;15;22;0;2;2
293;14.10.2016;2016;10;22;Perjantai;5;5;10;1;0;1
293;14.10.2016;2016;10;23;Perjantai;8;5;13;1;1;2
293;15.10.2016;2016;10;00;Lauantai;3;6;9;1;0;1
293;15.10.2016;2016;10;01;Lauantai;0;4;4;0;0;0
293;15.10.2016;2016;10;02;Lauantai;1;0;1;0;0;0
293;15.10.2016;2016;10;03;Lauantai;3;1;4;0;0;0
293;15.10.2016;2016;10;04;Lauantai;0;0;0;0;0;0
293;15.10.2016;2016;10;05;Lauantai;2;0;2;0;1;1
293;15.10.2016;2016;10;06;Lauantai;0;1;1;0;1;1
293;15.10.2016;2016;10;07;Lauantai;3;1;4;1;1;2
293;15.10.2016;2016;10;08;Lauantai;6;4;10;0;0;0
293;15.10.2016;2016;10;09;Lauantai;5;7;12;2;0;2
293;15.10.2016;2016;10;10;Lauantai;14;9;23;6;8;14
293;15.10.2016;2016;10;11;Lauantai;15;9;24;6;23;29
293;15.10.2016;2016;10;12;Lauantai;18;21;39;2;3;5
293;15.10.2016;2016;10;13;Lauantai;11;21;32;6;2;8
293;15.10.2016;2016;10;14;Lauantai;30;16;46;5;5;10
293;15.10.2016;2016;10;15;Lauantai;9;6;15;4;7;11
293;15.10.2016;2016;10;16;Lauantai;12;17;29;5;6;11
293;15.10.2016;2016;10;17;Lauantai;10;18;28;6;7;13
293;15.10.2016;2016;10;18;Lauantai;9;9;18;4;5;9
293;15.10.2016;2016;10;19;Lauantai;19;11;30;5;6;11
293;15.10.2016;2016;10;20;Lauantai;1;5;6;1;1;2
293;15.10.2016;2016;10;21;Lauantai;4;9;13;0;0;0
293;15.10.2016;2016;10;22;Lauantai;2;0;2;0;0;0
293;15.10.2016;2016;10;23;Lauantai;1;0;1;0;0;0
293;16.10.2016;2016;10;00;Sunnuntai;6;2;8;6;2;8
293;16.10.2016;2016;10;01;Sunnuntai;3;3;6;0;0;0
293;16.10.2016;2016;10;02;Sunnuntai;0;3;3;0;0;0
293;16.10.2016;2016;10;03;Sunnuntai;0;0;0;0;4;4
293;16.10.2016;2016;10;04;Sunnuntai;0;0;0;0;1;1
293;16.10.2016;2016;10;05;Sunnuntai;0;0;0;0;0;0
293;16.10.2016;2016;10;06;Sunnuntai;2;0;2;0;0;0
293;16.10.2016;2016;10;07;Sunnuntai;1;0;1;0;1;1
293;16.10.2016;2016;10;08;Sunnuntai;0;1;1;0;0;0
293;16.10.2016;2016;10;09;Sunnuntai;13;0;13;1;1;2
293;16.10.2016;2016;10;10;Sunnuntai;10;10;20;3;4;7
293;16.10.2016;2016;10;11;Sunnuntai;15;16;31;6;7;13
293;16.10.2016;2016;10;12;Sunnuntai;14;6;20;9;5;14
293;16.10.2016;2016;10;13;Sunnuntai;9;15;24;3;2;5
293;16.10.2016;2016;10;14;Sunnuntai;15;13;28;7;4;11
293;16.10.2016;2016;10;15;Sunnuntai;11;13;24;1;0;1
293;16.10.2016;2016;10;16;Sunnuntai;8;11;19;3;2;5
293;16.10.2016;2016;10;17;Sunnuntai;19;17;36;7;2;9
293;16.10.2016;2016;10;18;Sunnuntai;13;16;29;2;5;7
293;16.10.2016;2016;10;19;Sunnuntai;5;13;18;4;6;10
293;16.10.2016;2016;10;20;Sunnuntai;4;7;11;0;3;3
293;16.10.2016;2016;10;21;Sunnuntai;4;2;6;1;0;1
293;16.10.2016;2016;10;22;Sunnuntai;3;0;3;1;2;3
293;16.10.2016;2016;10;23;Sunnuntai;0;0;0;1;1;2
293;17.10.2016;2016;10;00;Maanantai;0;1;1;0;0;0
293;17.10.2016;2016;10;01;Maanantai;0;0;0;0;0;0
293;17.10.2016;2016;10;02;Maanantai;0;0;0;0;0;0
293;17.10.2016;2016;10;03;Maanantai;0;0;0;0;0;0
293;17.10.2016;2016;10;04;Maanantai;0;0;0;0;0;0
293;17.10.2016;2016;10;05;Maanantai;3;0;3;0;1;1
293;17.10.2016;2016;10;06;Maanantai;14;1;15;0;0;0
293;17.10.2016;2016;10;07;Maanantai;128;5;133;5;1;6
293;17.10.2016;2016;10;08;Maanantai;80;10;90;8;2;10
293;17.10.2016;2016;10;09;Maanantai;18;10;28;5;2;7
293;17.10.2016;2016;10;10;Maanantai;15;13;28;3;0;3
293;17.10.2016;2016;10;11;Maanantai;12;10;22;3;1;4
293;17.10.2016;2016;10;12;Maanantai;10;11;21;2;1;3
293;17.10.2016;2016;10;13;Maanantai;16;41;57;0;4;4
293;17.10.2016;2016;10;14;Maanantai;14;140;154;2;8;10
293;17.10.2016;2016;10;15;Maanantai;23;54;77;2;7;9
293;17.10.2016;2016;10;16;Maanantai;22;26;48;0;3;3
293;17.10.2016;2016;10;17;Maanantai;24;16;40;3;2;5
293;17.10.2016;2016;10;18;Maanantai;9;13;22;7;7;14
293;17.10.2016;2016;10;19;Maanantai;4;15;19;2;5;7
293;17.10.2016;2016;10;20;Maanantai;2;11;13;3;8;11
293;17.10.2016;2016;10;21;Maanantai;2;4;6;0;1;1
293;17.10.2016;2016;10;22;Maanantai;3;3;6;0;0;0
293;17.10.2016;2016;10;23;Maanantai;0;0;0;0;0;0
293;18.10.2016;2016;10;00;Tiistai;0;0;0;0;0;0
293;18.10.2016;2016;10;01;Tiistai;0;0;0;0;1;1
293;18.10.2016;2016;10;02;Tiistai;0;1;1;0;0;0
293;18.10.2016;2016;10;03;Tiistai;1;0;1;0;0;0
293;18.10.2016;2016;10;04;Tiistai;0;0;0;0;0;0
293;18.10.2016;2016;10;05;Tiistai;5;1;6;1;2;3
293;18.10.2016;2016;10;06;Tiistai;20;3;23;1;0;1
293;18.10.2016;2016;10;07;Tiistai;75;6;81;4;0;4
293;18.10.2016;2016;10;08;Tiistai;82;7;89;4;1;5
293;18.10.2016;2016;10;09;Tiistai;50;12;62;3;6;9
293;18.10.2016;2016;10;10;Tiistai;27;7;34;1;1;2
293;18.10.2016;2016;10;11;Tiistai;9;8;17;3;2;5
293;18.10.2016;2016;10;12;Tiistai;8;12;20;5;4;9
293;18.10.2016;2016;10;13;Tiistai;13;18;31;3;1;4
293;18.10.2016;2016;10;14;Tiistai;15;69;84;1;4;5
293;18.10.2016;2016;10;15;Tiistai;14;130;144;2;7;9
293;18.10.2016;2016;10;16;Tiistai;23;36;59;3;3;6
293;18.10.2016;2016;10;17;Tiistai;15;20;35;2;5;7
293;18.10.2016;2016;10;18;Tiistai;12;38;50;6;2;8
293;18.10.2016;2016;10;19;Tiistai;13;19;32;10;8;18
293;18.10.2016;2016;10;20;Tiistai;9;9;18;5;7;12
293;18.10.2016;2016;10;21;Tiistai;0;5;5;0;0;0
293;18.10.2016;2016;10;22;Tiistai;1;3;4;0;1;1
293;18.10.2016;2016;10;23;Tiistai;0;1;1;0;0;0
293;19.10.2016;2016;10;00;Keskiviikko;0;1;1;0;0;0
293;19.10.2016;2016;10;01;Keskiviikko;0;0;0;0;0;0
293;19.10.2016;2016;10;02;Keskiviikko;0;0;0;0;0;0
293;19.10.2016;2016;10;03;Keskiviikko;1;1;2;0;0;0
293;19.10.2016;2016;10;04;Keskiviikko;0;0;0;0;0;0
293;19.10.2016;2016;10;05;Keskiviikko;4;0;4;0;0;0
293;19.10.2016;2016;10;06;Keskiviikko;14;3;17;0;0;0
293;19.10.2016;2016;10;07;Keskiviikko;132;6;138;3;0;3
293;19.10.2016;2016;10;08;Keskiviikko;67;6;73;5;1;6
293;19.10.2016;2016;10;09;Keskiviikko;24;13;37;4;1;5
293;19.10.2016;2016;10;10;Keskiviikko;19;9;28;5;3;8
293;19.10.2016;2016;10;11;Keskiviikko;12;14;26;1;5;6
293;19.10.2016;2016;10;12;Keskiviikko;12;31;43;2;3;5
293;19.10.2016;2016;10;13;Keskiviikko;15;24;39;3;2;5
293;19.10.2016;2016;10;14;Keskiviikko;18;150;168;4;9;13
293;19.10.2016;2016;10;15;Keskiviikko;14;39;53;3;2;5
293;19.10.2016;2016;10;16;Keskiviikko;26;27;53;9;9;18
293;19.10.2016;2016;10;17;Keskiviikko;19;38;57;5;5;10
293;19.10.2016;2016;10;18;Keskiviikko;16;19;35;2;3;5
293;19.10.2016;2016;10;19;Keskiviikko;11;19;30;4;7;11
293;19.10.2016;2016;10;20;Keskiviikko;5;19;24;1;2;3
293;19.10.2016;2016;10;21;Keskiviikko;1;5;6;0;1;1
293;19.10.2016;2016;10;22;Keskiviikko;1;1;2;0;0;0
293;19.10.2016;2016;10;23;Keskiviikko;1;1;2;0;0;0
293;20.10.2016;2016;10;00;Torstai;0;0;0;0;0;0
293;20.10.2016;2016;10;01;Torstai;0;0;0;0;0;0
293;20.10.2016;2016;10;02;Torstai;0;1;1;0;0;0
293;20.10.2016;2016;10;03;Torstai;1;0;1;0;0;0
293;20.10.2016;2016;10;04;Torstai;0;0;0;0;0;0
293;20.10.2016;2016;10;05;Torstai;4;0;4;0;1;1
293;20.10.2016;2016;10;06;Torstai;9;2;11;0;2;2
293;20.10.2016;2016;10;07;Torstai;107;5;112;7;0;7
293;20.10.2016;2016;10;08;Torstai;88;8;96;7;1;8
293;20.10.2016;2016;10;09;Torstai;26;7;33;1;3;4
293;20.10.2016;2016;10;10;Torstai;12;9;21;0;0;0
293;20.10.2016;2016;10;11;Torstai;10;9;19;2;1;3
293;20.10.2016;2016;10;12;Torstai;22;11;33;3;2;5
293;20.10.2016;2016;10;13;Torstai;11;39;50;2;3;5
293;20.10.2016;2016;10;14;Torstai;11;134;145;6;8;14
293;20.10.2016;2016;10;15;Torstai;18;63;81;6;7;13
293;20.10.2016;2016;10;16;Torstai;26;27;53;3;3;6
293;20.10.2016;2016;10;17;Torstai;18;27;45;2;1;3
293;20.10.2016;2016;10;18;Torstai;16;8;24;2;1;3
293;20.10.2016;2016;10;19;Torstai;10;19;29;4;5;9
293;20.10.2016;2016;10;20;Torstai;1;15;16;1;1;2
293;20.10.2016;2016;10;21;Torstai;0;12;12;0;4;4
293;20.10.2016;2016;10;22;Torstai;5;6;11;1;0;1
293;20.10.2016;2016;10;23;Torstai;0;1;1;0;1;1
293;21.10.2016;2016;10;00;Perjantai;0;2;2;0;0;0
293;21.10.2016;2016;10;01;Perjantai;0;0;0;0;0;0
293;21.10.2016;2016;10;02;Perjantai;0;0;0;0;0;0
293;21.10.2016;2016;10;03;Perjantai;0;0;0;0;0;0
293;21.10.2016;2016;10;04;Perjantai;0;0;0;0;0;0
293;21.10.2016;2016;10;05;Perjantai;3;1;4;0;1;1
293;21.10.2016;2016;10;06;Perjantai;13;1;14;1;0;1
293;21.10.2016;2016;10;07;Perjantai;91;8;99;2;0;2
293;21.10.2016;2016;10;08;Perjantai;73;8;81;3;0;3
293;21.10.2016;2016;10;09;Perjantai;17;4;21;2;2;4
293;21.10.2016;2016;10;10;Perjantai;20;10;30;8;3;11
293;21.10.2016;2016;10;11;Perjantai;10;14;24;6;7;13
293;21.10.2016;2016;10;12;Perjantai;12;50;62;6;9;15
293;21.10.2016;2016;10;13;Perjantai;18;120;138;2;4;6
293;21.10.2016;2016;10;14;Perjantai;26;33;59;2;3;5
293;21.10.2016;2016;10;15;Perjantai;15;37;52;4;3;7
293;21.10.2016;2016;10;16;Perjantai;14;13;27;4;1;5
293;21.10.2016;2016;10;17;Perjantai;13;10;23;5;9;14
293;21.10.2016;2016;10;18;Perjantai;13;13;26;6;7;13
293;21.10.2016;2016;10;19;Perjantai;12;6;18;4;5;9
293;21.10.2016;2016;10;20;Perjantai;9;11;20;0;2;2
293;21.10.2016;2016;10;21;Perjantai;1;16;17;5;3;8
293;21.10.2016;2016;10;22;Perjantai;3;0;3;0;1;1
293;21.10.2016;2016;10;23;Perjantai;0;1;1;0;0;0
293;22.10.2016;2016;10;00;Lauantai;3;2;5;0;1;1
293;22.10.2016;2016;10;01;Lauantai;1;0;1;0;0;0
293;22.10.2016;2016;10;02;Lauantai;2;1;3;0;2;2
293;22.10.2016;2016;10;03;Lauantai;0;0;0;0;1;1
293;22.10.2016;2016;10;04;Lauantai;0;3;3;0;1;1
293;22.10.2016;2016;10;05;Lauantai;1;0;1;1;1;2
293;22.10.2016;2016;10;06;Lauantai;1;0;1;0;0;0
293;22.10.2016;2016;10;07;Lauantai;2;1;3;1;1;2
293;22.10.2016;2016;10;08;Lauantai;4;1;5;1;0;1
293;22.10.2016;2016;10;09;Lauantai;17;5;22;3;1;4
293;22.10.2016;2016;10;10;Lauantai;12;14;26;2;1;3
293;22.10.2016;2016;10;11;Lauantai;12;9;21;12;6;18
293;22.10.2016;2016;10;12;Lauantai;19;17;36;9;8;17
293;22.10.2016;2016;10;13;Lauantai;17;22;39;5;6;11
293;22.10.2016;2016;10;14;Lauantai;15;21;36;6;6;12
293;22.10.2016;2016;10;15;Lauantai;16;20;36;1;4;5
293;22.10.2016;2016;10;16;Lauantai;15;12;27;6;2;8
293;22.10.2016;2016;10;17;Lauantai;15;10;25;5;5;10
293;22.10.2016;2016;10;18;Lauantai;9;9;18;5;6;11
293;22.10.2016;2016;10;19;Lauantai;14;14;28;4;6;10
293;22.10.2016;2016;10;20;Lauantai;7;11;18;1;0;1
293;22.10.2016;2016;10;21;Lauantai;4;14;18;2;5;7
293;22.10.2016;2016;10;22;Lauantai;1;6;7;3;0;3
293;22.10.2016;2016;10;23;Lauantai;1;2;3;0;1;1
293;23.10.2016;2016;10;00;Sunnuntai;0;1;1;1;1;2
293;23.10.2016;2016;10;01;Sunnuntai;5;0;5;3;0;3
293;23.10.2016;2016;10;02;Sunnuntai;0;0;0;1;1;2
293;23.10.2016;2016;10;03;Sunnuntai;3;0;3;1;5;6
293;23.10.2016;2016;10;04;Sunnuntai;0;2;2;0;0;0
293;23.10.2016;2016;10;05;Sunnuntai;0;0;0;0;0;0
293;23.10.2016;2016;10;06;Sunnuntai;2;0;2;0;0;0
293;23.10.2016;2016;10;07;Sunnuntai;0;1;1;0;0;0
293;23.10.2016;2016;10;08;Sunnuntai;0;0;0;0;3;3
293;23.10.2016;2016;10;09;Sunnuntai;13;2;15;5;1;6
293;23.10.2016;2016;10;10;Sunnuntai;13;7;20;2;3;5
293;23.10.2016;2016;10;11;Sunnuntai;10;14;24;6;10;16
293;23.10.2016;2016;10;12;Sunnuntai;9;9;18;4;2;6
293;23.10.2016;2016;10;13;Sunnuntai;22;14;36;11;7;18
293;23.10.2016;2016;10;14;Sunnuntai;17;22;39;5;8;13
293;23.10.2016;2016;10;15;Sunnuntai;10;13;23;0;3;3
293;23.10.2016;2016;10;16;Sunnuntai;17;15;32;1;4;5
293;23.10.2016;2016;10;17;Sunnuntai;14;15;29;3;5;8
293;23.10.2016;2016;10;18;Sunnuntai;5;12;17;3;1;4
293;23.10.2016;2016;10;19;Sunnuntai;9;14;23;3;6;9
293;23.10.2016;2016;10;20;Sunnuntai;3;12;15;0;2;2
293;23.10.2016;2016;10;21;Sunnuntai;2;10;12;2;0;2
293;23.10.2016;2016;10;22;Sunnuntai;2;2;4;0;0;0
293;23.10.2016;2016;10;23;Sunnuntai;2;1;3;0;0;0
293;24.10.2016;2016;10;00;Maanantai;1;0;1;0;0;0
293;24.10.2016;2016;10;01;Maanantai;0;2;2;0;0;0
293;24.10.2016;2016;10;02;Maanantai;1;0;1;0;0;0
293;24.10.2016;2016;10;03;Maanantai;0;1;1;0;0;0
293;24.10.2016;2016;10;04;Maanantai;0;0;0;0;0;0
293;24.10.2016;2016;10;05;Maanantai;4;0;4;1;1;2
293;24.10.2016;2016;10;06;Maanantai;8;1;9;0;0;0
293;24.10.2016;2016;10;07;Maanantai;10;4;14;2;1;3
293;24.10.2016;2016;10;08;Maanantai;6;4;10;2;2;4
293;24.10.2016;2016;10;09;Maanantai;13;4;17;5;1;6
293;24.10.2016;2016;10;10;Maanantai;14;12;26;4;2;6
293;24.10.2016;2016;10;11;Maanantai;8;12;20;4;6;10
293;24.10.2016;2016;10;12;Maanantai;18;11;29;1;1;2
293;24.10.2016;2016;10;13;Maanantai;19;11;30;2;3;5
293;24.10.2016;2016;10;14;Maanantai;14;17;31;5;2;7
293;24.10.2016;2016;10;15;Maanantai;9;24;33;3;1;4
293;24.10.2016;2016;10;16;Maanantai;12;23;35;3;4;7
293;24.10.2016;2016;10;17;Maanantai;14;29;43;3;5;8
293;24.10.2016;2016;10;18;Maanantai;7;8;15;9;3;12
293;24.10.2016;2016;10;19;Maanantai;8;10;18;4;5;9
293;24.10.2016;2016;10;20;Maanantai;1;6;7;1;3;4
293;24.10.2016;2016;10;21;Maanantai;1;3;4;0;1;1
293;24.10.2016;2016;10;22;Maanantai;0;0;0;0;0;0
293;24.10.2016;2016;10;23;Maanantai;1;3;4;0;0;0
293;25.10.2016;2016;10;00;Tiistai;0;0;0;0;0;0
293;25.10.2016;2016;10;01;Tiistai;0;0;0;0;0;0
293;25.10.2016;2016;10;02;Tiistai;0;0;0;0;0;0
293;25.10.2016;2016;10;03;Tiistai;0;1;1;0;0;0
293;25.10.2016;2016;10;04;Tiistai;1;0;1;0;0;0
293;25.10.2016;2016;10;05;Tiistai;6;0;6;0;1;1
293;25.10.2016;2016;10;06;Tiistai;15;1;16;0;0;0
293;25.10.2016;2016;10;07;Tiistai;15;2;17;0;1;1
293;25.10.2016;2016;10;08;Tiistai;6;5;11;1;1;2
293;25.10.2016;2016;10;09;Tiistai;10;12;22;2;2;4
293;25.10.2016;2016;10;10;Tiistai;8;3;11;3;1;4
293;25.10.2016;2016;10;11;Tiistai;17;9;26;4;2;6
293;25.10.2016;2016;10;12;Tiistai;18;17;35;6;1;7
293;25.10.2016;2016;10;13;Tiistai;15;18;33;3;1;4
293;25.10.2016;2016;10;14;Tiistai;12;26;38;5;4;9
293;25.10.2016;2016;10;15;Tiistai;8;13;21;2;4;6
293;25.10.2016;2016;10;16;Tiistai;6;27;33;1;4;5
293;25.10.2016;2016;10;17;Tiistai;10;11;21;7;3;10
293;25.10.2016;2016;10;18;Tiistai;5;10;15;5;8;13
293;25.10.2016;2016;10;19;Tiistai;4;8;12;3;6;9
293;25.10.2016;2016;10;20;Tiistai;4;4;8;5;9;14
293;25.10.2016;2016;10;21;Tiistai;1;4;5;2;0;2
293;25.10.2016;2016;10;22;Tiistai;2;1;3;0;0;0
293;25.10.2016;2016;10;23;Tiistai;0;2;2;0;0;0
293;26.10.2016;2016;10;00;Keskiviikko;0;1;1;0;0;0
293;26.10.2016;2016;10;01;Keskiviikko;0;0;0;0;1;1
293;26.10.2016;2016;10;02;Keskiviikko;0;0;0;0;0;0
293;26.10.2016;2016;10;03;Keskiviikko;0;0;0;0;0;0
293;26.10.2016;2016;10;04;Keskiviikko;0;0;0;0;0;0
293;26.10.2016;2016;10;05;Keskiviikko;5;0;5;2;0;2
293;26.10.2016;2016;10;06;Keskiviikko;9;2;11;0;1;1
293;26.10.2016;2016;10;07;Keskiviikko;7;2;9;1;0;1
293;26.10.2016;2016;10;08;Keskiviikko;6;2;8;2;1;3
293;26.10.2016;2016;10;09;Keskiviikko;14;5;19;2;3;5
293;26.10.2016;2016;10;10;Keskiviikko;7;8;15;2;1;3
293;26.10.2016;2016;10;11;Keskiviikko;8;10;18;8;5;13
293;26.10.2016;2016;10;12;Keskiviikko;9;12;21;5;6;11
293;26.10.2016;2016;10;13;Keskiviikko;13;6;19;5;3;8
293;26.10.2016;2016;10;14;Keskiviikko;11;17;28;7;4;11
293;26.10.2016;2016;10;15;Keskiviikko;9;12;21;4;3;7
293;26.10.2016;2016;10;16;Keskiviikko;4;10;14;2;5;7
293;26.10.2016;2016;10;17;Keskiviikko;12;8;20;2;1;3
293;26.10.2016;2016;10;18;Keskiviikko;3;4;7;2;4;6
293;26.10.2016;2016;10;19;Keskiviikko;3;3;6;2;2;4
293;26.10.2016;2016;10;20;Keskiviikko;5;4;9;1;5;6
293;26.10.2016;2016;10;21;Keskiviikko;0;12;12;1;0;1
293;26.10.2016;2016;10;22;Keskiviikko;2;3;5;0;0;0
293;26.10.2016;2016;10;23;Keskiviikko;2;3;5;1;0;1
293;27.10.2016;2016;10;00;Torstai;0;0;0;0;0;0
293;27.10.2016;2016;10;01;Torstai;3;1;4;0;0;0
293;27.10.2016;2016;10;02;Torstai;0;0;0;0;0;0
293;27.10.2016;2016;10;03;Torstai;0;0;0;0;0;0
293;27.10.2016;2016;10;04;Torstai;1;0;1;0;0;0
293;27.10.2016;2016;10;05;Torstai;3;0;3;0;0;0
293;27.10.2016;2016;10;06;Torstai;9;1;10;2;0;2
293;27.10.2016;2016;10;07;Torstai;8;1;9;5;1;6
293;27.10.2016;2016;10;08;Torstai;4;2;6;1;1;2
293;27.10.2016;2016;10;09;Torstai;5;4;9;0;4;4
293;27.10.2016;2016;10;10;Torstai;6;3;9;3;0;3
293;27.10.2016;2016;10;11;Torstai;11;9;20;4;2;6
293;27.10.2016;2016;10;12;Torstai;6;11;17;3;4;7
293;27.10.2016;2016;10;13;Torstai;10;4;14;3;2;5
293;27.10.2016;2016;10;14;Torstai;5;15;20;8;3;11
293;27.10.2016;2016;10;15;Torstai;11;28;39;1;6;7
293;27.10.2016;2016;10;16;Torstai;5;9;14;3;7;10
293;27.10.2016;2016;10;17;Torstai;6;17;23;4;1;5
293;27.10.2016;2016;10;18;Torstai;5;4;9;3;6;9
293;27.10.2016;2016;10;19;Torstai;4;5;9;3;5;8
293;27.10.2016;2016;10;20;Torstai;4;2;6;2;0;2
293;27.10.2016;2016;10;21;Torstai;2;5;7;0;0;0
293;27.10.2016;2016;10;22;Torstai;0;0;0;0;0;0
293;27.10.2016;2016;10;23;Torstai;0;1;1;0;1;1
293;28.10.2016;2016;10;00;Perjantai;1;0;1;0;0;0
293;28.10.2016;2016;10;01;Perjantai;0;1;1;0;0;0
293;28.10.2016;2016;10;02;Perjantai;0;0;0;0;0;0
293;28.10.2016;2016;10;03;Perjantai;0;0;0;0;0;0
293;28.10.2016;2016;10;04;Perjantai;0;0;0;0;0;0
293;28.10.2016;2016;10;05;Perjantai;1;0;1;0;0;0
293;28.10.2016;2016;10;06;Perjantai;1;1;2;0;0;0
293;28.10.2016;2016;10;07;Perjantai;6;1;7;0;0;0
293;28.10.2016;2016;10;08;Perjantai;2;0;2;0;1;1
293;28.10.2016;2016;10;09;Perjantai;4;1;5;0;3;3
293;28.10.2016;2016;10;10;Perjantai;5;5;10;0;0;0
293;28.10.2016;2016;10;11;Perjantai;6;3;9;2;1;3
293;28.10.2016;2016;10;12;Perjantai;20;8;28;5;6;11
293;28.10.2016;2016;10;13;Perjantai;8;8;16;5;4;9
293;28.10.2016;2016;10;14;Perjantai;8;16;24;5;3;8
293;28.10.2016;2016;10;15;Perjantai;10;9;19;3;3;6
293;28.10.2016;2016;10;16;Perjantai;13;9;22;4;5;9
293;28.10.2016;2016;10;17;Perjantai;7;8;15;4;3;7
293;28.10.2016;2016;10;18;Perjantai;10;8;18;4;5;9
293;28.10.2016;2016;10;19;Perjantai;3;4;7;2;5;7
293;28.10.2016;2016;10;20;Perjantai;4;5;9;1;2;3
293;28.10.2016;2016;10;21;Perjantai;0;11;11;0;0;0
293;28.10.2016;2016;10;22;Perjantai;6;3;9;1;0;1
293;28.10.2016;2016;10;23;Perjantai;1;2;3;3;0;3
293;29.10.2016;2016;10;00;Lauantai;0;2;2;1;0;1
293;29.10.2016;2016;10;01;Lauantai;0;0;0;1;2;3
293;29.10.2016;2016;10;02;Lauantai;0;1;1;0;1;1
293;29.10.2016;2016;10;03;Lauantai;0;0;0;0;0;0
293;29.10.2016;2016;10;04;Lauantai;0;0;0;0;2;2
293;29.10.2016;2016;10;05;Lauantai;0;0;0;0;0;0
293;29.10.2016;2016;10;06;Lauantai;1;0;1;0;1;1
293;29.10.2016;2016;10;07;Lauantai;2;0;2;1;1;2
293;29.10.2016;2016;10;08;Lauantai;3;2;5;0;1;1
293;29.10.2016;2016;10;09;Lauantai;8;7;15;3;3;6
293;29.10.2016;2016;10;10;Lauantai;10;5;15;4;1;5
293;29.10.2016;2016;10;11;Lauantai;7;17;24;3;3;6
293;29.10.2016;2016;10;12;Lauantai;12;7;19;8;7;15
293;29.10.2016;2016;10;13;Lauantai;16;5;21;5;7;12
293;29.10.2016;2016;10;14;Lauantai;19;19;38;8;7;15
293;29.10.2016;2016;10;15;Lauantai;10;17;27;10;7;17
293;29.10.2016;2016;10;16;Lauantai;15;10;25;4;7;11
293;29.10.2016;2016;10;17;Lauantai;6;15;21;1;5;6
293;29.10.2016;2016;10;18;Lauantai;10;9;19;5;2;7
293;29.10.2016;2016;10;19;Lauantai;2;2;4;1;6;7
293;29.10.2016;2016;10;20;Lauantai;2;6;8;4;2;6
293;29.10.2016;2016;10;21;Lauantai;1;2;3;0;0;0
293;29.10.2016;2016;10;22;Lauantai;5;0;5;0;0;0
293;29.10.2016;2016;10;23;Lauantai;1;1;2;2;2;4
293;30.10.2016;2016;10;00;Sunnuntai;2;0;2;10;0;10
293;30.10.2016;2016;10;01;Sunnuntai;1;1;2;0;2;2
293;30.10.2016;2016;10;02;Sunnuntai;0;1;1;0;1;1
293;30.10.2016;2016;10;03;Sunnuntai;2;0;2;0;1;1
293;30.10.2016;2016;10;04;Sunnuntai;0;0;0;0;0;0
293;30.10.2016;2016;10;05;Sunnuntai;0;3;3;0;1;1
293;30.10.2016;2016;10;06;Sunnuntai;2;0;2;0;0;0
293;30.10.2016;2016;10;07;Sunnuntai;0;0;0;0;0;0
293;30.10.2016;2016;10;08;Sunnuntai;1;3;4;0;2;2
293;30.10.2016;2016;10;09;Sunnuntai;12;2;14;4;4;8
293;30.10.2016;2016;10;10;Sunnuntai;3;13;16;6;5;11
293;30.10.2016;2016;10;11;Sunnuntai;12;16;28;10;6;16
293;30.10.2016;2016;10;12;Sunnuntai;5;4;9;8;7;15
293;30.10.2016;2016;10;13;Sunnuntai;13;11;24;7;8;15
293;30.10.2016;2016;10;14;Sunnuntai;10;14;24;4;2;6
293;30.10.2016;2016;10;15;Sunnuntai;11;15;26;2;2;4
293;30.10.2016;2016;10;16;Sunnuntai;6;7;13;3;4;7
293;30.10.2016;2016;10;17;Sunnuntai;8;11;19;4;2;6
293;30.10.2016;2016;10;18;Sunnuntai;15;11;26;4;7;11
293;30.10.2016;2016;10;19;Sunnuntai;6;7;13;1;1;2
293;30.10.2016;2016;10;20;Sunnuntai;3;4;7;2;1;3
293;30.10.2016;2016;10;21;Sunnuntai;1;1;2;0;0;0
293;30.10.2016;2016;10;22;Sunnuntai;0;1;1;0;0;0
293;30.10.2016;2016;10;23;Sunnuntai;0;0;0;0;0;0
293;31.10.2016;2016;10;00;Maanantai;0;0;0;0;0;0
293;31.10.2016;2016;10;01;Maanantai;0;0;0;0;0;0
293;31.10.2016;2016;10;02;Maanantai;0;0;0;0;0;0
293;31.10.2016;2016;10;03;Maanantai;0;0;0;0;0;0
293;31.10.2016;2016;10;04;Maanantai;0;1;1;0;0;0
293;31.10.2016;2016;10;05;Maanantai;4;0;4;0;0;0
293;31.10.2016;2016;10;06;Maanantai;13;2;15;2;0;2
293;31.10.2016;2016;10;07;Maanantai;102;8;110;7;0;7
293;31.10.2016;2016;10;08;Maanantai;74;6;80;4;3;7
293;31.10.2016;2016;10;09;Maanantai;29;12;41;0;0;0
293;31.10.2016;2016;10;10;Maanantai;16;3;19;9;3;12
293;31.10.2016;2016;10;11;Maanantai;9;11;20;3;5;8
293;31.10.2016;2016;10;12;Maanantai;12;11;23;1;3;4
293;31.10.2016;2016;10;13;Maanantai;13;38;51;5;6;11
293;31.10.2016;2016;10;14;Maanantai;10;97;107;4;6;10
293;31.10.2016;2016;10;15;Maanantai;17;97;114;0;4;4
293;31.10.2016;2016;10;16;Maanantai;31;19;50;4;5;9
293;31.10.2016;2016;10;17;Maanantai;12;25;37;3;3;6
293;31.10.2016;2016;10;18;Maanantai;8;18;26;5;3;8
293;31.10.2016;2016;10;19;Maanantai;6;12;18;4;4;8
293;31.10.2016;2016;10;20;Maanantai;2;8;10;2;3;5
293;31.10.2016;2016;10;21;Maanantai;1;4;5;1;1;2
293;31.10.2016;2016;10;22;Maanantai;0;0;0;1;0;1
293;31.10.2016;2016;10;23;Maanantai;0;0;0;0;0;0
293;01.11.2016;2016;11;00;Tiistai;0;0;0;0;0;0
293;01.11.2016;2016;11;01;Tiistai;0;0;0;0;0;0
293;01.11.2016;2016;11;02;Tiistai;0;0;0;0;0;0
293;01.11.2016;2016;11;03;Tiistai;1;0;1;0;0;0
293;01.11.2016;2016;11;04;Tiistai;0;1;1;0;0;0
293;01.11.2016;2016;11;05;Tiistai;5;1;6;0;1;1
293;01.11.2016;2016;11;06;Tiistai;12;2;14;1;2;3
293;01.11.2016;2016;11;07;Tiistai;67;4;71;2;0;2
293;01.11.2016;2016;11;08;Tiistai;69;6;75;8;5;13
293;01.11.2016;2016;11;09;Tiistai;70;8;78;5;0;5
293;01.11.2016;2016;11;10;Tiistai;33;10;43;3;2;5
293;01.11.2016;2016;11;11;Tiistai;9;11;20;3;1;4
293;01.11.2016;2016;11;12;Tiistai;12;9;21;8;5;13
293;01.11.2016;2016;11;13;Tiistai;12;25;37;1;4;5
293;01.11.2016;2016;11;14;Tiistai;11;66;77;2;5;7
293;01.11.2016;2016;11;15;Tiistai;11;135;146;3;8;11
293;01.11.2016;2016;11;16;Tiistai;15;24;39;5;6;11
293;01.11.2016;2016;11;17;Tiistai;10;9;19;2;4;6
293;01.11.2016;2016;11;18;Tiistai;16;17;33;6;6;12
293;01.11.2016;2016;11;19;Tiistai;3;15;18;3;1;4
293;01.11.2016;2016;11;20;Tiistai;1;5;6;2;1;3
293;01.11.2016;2016;11;21;Tiistai;2;5;7;3;2;5
293;01.11.2016;2016;11;22;Tiistai;0;0;0;0;0;0
293;01.11.2016;2016;11;23;Tiistai;0;0;0;0;0;0
293;02.11.2016;2016;11;00;Keskiviikko;0;0;0;0;0;0
293;02.11.2016;2016;11;01;Keskiviikko;0;0;0;0;0;0
293;02.11.2016;2016;11;02;Keskiviikko;0;0;0;0;0;0
293;02.11.2016;2016;11;03;Keskiviikko;1;0;1;0;0;0
293;02.11.2016;2016;11;04;Keskiviikko;0;0;0;0;0;0
293;02.11.2016;2016;11;05;Keskiviikko;3;1;4;0;0;0
293;02.11.2016;2016;11;06;Keskiviikko;9;1;10;1;0;1
293;02.11.2016;2016;11;07;Keskiviikko;104;7;111;5;1;6
293;02.11.2016;2016;11;08;Keskiviikko;92;6;98;9;1;10
293;02.11.2016;2016;11;09;Keskiviikko;19;6;25;3;0;3
293;02.11.2016;2016;11;10;Keskiviikko;12;9;21;2;0;2
293;02.11.2016;2016;11;11;Keskiviikko;10;7;17;4;2;6
293;02.11.2016;2016;11;12;Keskiviikko;7;19;26;4;2;6
293;02.11.2016;2016;11;13;Keskiviikko;11;36;47;1;6;7
293;02.11.2016;2016;11;14;Keskiviikko;17;143;160;4;12;16
293;02.11.2016;2016;11;15;Keskiviikko;15;37;52;5;5;10
293;02.11.2016;2016;11;16;Keskiviikko;15;15;30;4;1;5
293;02.11.2016;2016;11;17;Keskiviikko;16;18;34;4;7;11
293;02.11.2016;2016;11;18;Keskiviikko;6;9;15;6;11;17
293;02.11.2016;2016;11;19;Keskiviikko;4;13;17;4;5;9
293;02.11.2016;2016;11;20;Keskiviikko;0;7;7;1;4;5
293;02.11.2016;2016;11;21;Keskiviikko;2;2;4;1;1;2
293;02.11.2016;2016;11;22;Keskiviikko;0;0;0;0;0;0
293;02.11.2016;2016;11;23;Keskiviikko;0;0;0;0;0;0
293;03.11.2016;2016;11;00;Torstai;0;0;0;0;0;0
293;03.11.2016;2016;11;01;Torstai;0;0;0;0;0;0
293;03.11.2016;2016;11;02;Torstai;0;0;0;0;0;0
293;03.11.2016;2016;11;03;Torstai;1;1;2;0;0;0
293;03.11.2016;2016;11;04;Torstai;0;0;0;0;0;0
293;03.11.2016;2016;11;05;Torstai;4;0;4;0;0;0
293;03.11.2016;2016;11;06;Torstai;11;1;12;1;0;1
293;03.11.2016;2016;11;07;Torstai;44;6;50;5;0;5
293;03.11.2016;2016;11;08;Torstai;10;3;13;3;1;4
293;03.11.2016;2016;11;09;Torstai;99;4;103;3;0;3
293;03.11.2016;2016;11;10;Torstai;74;4;78;6;4;10
293;03.11.2016;2016;11;11;Torstai;7;7;14;1;2;3
293;03.11.2016;2016;11;12;Torstai;7;13;20;4;5;9
293;03.11.2016;2016;11;13;Torstai;9;39;48;1;2;3
293;03.11.2016;2016;11;14;Torstai;10;96;106;1;10;11
293;03.11.2016;2016;11;15;Torstai;13;84;97;4;5;9
293;03.11.2016;2016;11;16;Torstai;10;20;30;2;6;8
293;03.11.2016;2016;11;17;Torstai;26;20;46;2;3;5
293;03.11.2016;2016;11;18;Torstai;7;4;11;9;3;12
293;03.11.2016;2016;11;19;Torstai;7;17;24;0;2;2
293;03.11.2016;2016;11;20;Torstai;2;2;4;1;5;6
293;03.11.2016;2016;11;21;Torstai;1;5;6;1;2;3
293;03.11.2016;2016;11;22;Torstai;0;3;3;2;0;2
293;03.11.2016;2016;11;23;Torstai;0;0;0;0;0;0
293;04.11.2016;2016;11;00;Perjantai;0;0;0;0;0;0
293;04.11.2016;2016;11;01;Perjantai;0;0;0;0;0;0
293;04.11.2016;2016;11;02;Perjantai;0;0;0;0;0;0
293;04.11.2016;2016;11;03;Perjantai;0;0;0;0;0;0
293;04.11.2016;2016;11;04;Perjantai;0;0;0;1;1;2
293;04.11.2016;2016;11;05;Perjantai;1;0;1;0;0;0
293;04.11.2016;2016;11;06;Perjantai;6;4;10;1;0;1
293;04.11.2016;2016;11;07;Perjantai;83;5;88;6;1;7
293;04.11.2016;2016;11;08;Perjantai;63;3;66;4;4;8
293;04.11.2016;2016;11;09;Perjantai;52;6;58;3;2;5
293;04.11.2016;2016;11;10;Perjantai;24;6;30;5;2;7
293;04.11.2016;2016;11;11;Perjantai;19;12;31;7;2;9
293;04.11.2016;2016;11;12;Perjantai;10;38;48;0;3;3
293;04.11.2016;2016;11;13;Perjantai;13;48;61;5;6;11
293;04.11.2016;2016;11;14;Perjantai;19;100;119;3;9;12
293;04.11.2016;2016;11;15;Perjantai;9;63;72;2;5;7
293;04.11.2016;2016;11;16;Perjantai;20;17;37;2;5;7
293;04.11.2016;2016;11;17;Perjantai;13;12;25;2;1;3
293;04.11.2016;2016;11;18;Perjantai;13;17;30;3;3;6
293;04.11.2016;2016;11;19;Perjantai;5;5;10;1;4;5
293;04.11.2016;2016;11;20;Perjantai;2;6;8;1;2;3
293;04.11.2016;2016;11;21;Perjantai;0;2;2;2;0;2
293;04.11.2016;2016;11;22;Perjantai;1;3;4;0;0;0
293;04.11.2016;2016;11;23;Perjantai;1;3;4;1;0;1
293;05.11.2016;2016;11;00;Lauantai;1;1;2;0;2;2
293;05.11.2016;2016;11;01;Lauantai;0;1;1;1;1;2
293;05.11.2016;2016;11;02;Lauantai;0;0;0;0;0;0
293;05.11.2016;2016;11;03;Lauantai;0;0;0;0;3;3
293;05.11.2016;2016;11;04;Lauantai;0;1;1;0;0;0
293;05.11.2016;2016;11;05;Lauantai;0;0;0;0;0;0
293;05.11.2016;2016;11;06;Lauantai;0;0;0;0;0;0
293;05.11.2016;2016;11;07;Lauantai;1;0;1;0;1;1
293;05.11.2016;2016;11;08;Lauantai;3;0;3;0;0;0
293;05.11.2016;2016;11;09;Lauantai;4;2;6;2;3;5
293;05.11.2016;2016;11;10;Lauantai;6;5;11;6;2;8
293;05.11.2016;2016;11;11;Lauantai;9;9;18;4;4;8
293;05.11.2016;2016;11;12;Lauantai;8;11;19;6;6;12
293;05.11.2016;2016;11;13;Lauantai;11;7;18;10;6;16
293;05.11.2016;2016;11;14;Lauantai;3;9;12;2;6;8
293;05.11.2016;2016;11;15;Lauantai;15;8;23;10;5;15
293;05.11.2016;2016;11;16;Lauantai;13;8;21;5;9;14
293;05.11.2016;2016;11;17;Lauantai;6;5;11;7;7;14
293;05.11.2016;2016;11;18;Lauantai;4;7;11;3;4;7
293;05.11.2016;2016;11;19;Lauantai;7;7;14;1;4;5
293;05.11.2016;2016;11;20;Lauantai;7;6;13;1;3;4
293;05.11.2016;2016;11;21;Lauantai;1;5;6;0;1;1
293;05.11.2016;2016;11;22;Lauantai;0;0;0;0;0;0
293;05.11.2016;2016;11;23;Lauantai;0;4;4;0;0;0
293;06.11.2016;2016;11;00;Sunnuntai;1;0;1;1;0;1
293;06.11.2016;2016;11;01;Sunnuntai;0;1;1;0;0;0
293;06.11.2016;2016;11;02;Sunnuntai;0;1;1;0;1;1
293;06.11.2016;2016;11;03;Sunnuntai;0;0;0;0;0;0
293;06.11.2016;2016;11;04;Sunnuntai;0;1;1;0;1;1
293;06.11.2016;2016;11;05;Sunnuntai;0;0;0;1;2;3
293;06.11.2016;2016;11;06;Sunnuntai;1;0;1;0;1;1
293;06.11.2016;2016;11;07;Sunnuntai;0;1;1;0;0;0
293;06.11.2016;2016;11;08;Sunnuntai;0;0;0;1;1;2
293;06.11.2016;2016;11;09;Sunnuntai;7;3;10;2;3;5
293;06.11.2016;2016;11;10;Sunnuntai;2;0;2;5;3;8
293;06.11.2016;2016;11;11;Sunnuntai;7;10;17;13;7;20
293;06.11.2016;2016;11;12;Sunnuntai;10;8;18;4;12;16
293;06.11.2016;2016;11;13;Sunnuntai;8;4;12;9;3;12
293;06.11.2016;2016;11;14;Sunnuntai;13;4;17;7;4;11
293;06.11.2016;2016;11;15;Sunnuntai;9;12;21;7;9;16
293;06.11.2016;2016;11;16;Sunnuntai;8;6;14;6;6;12
293;06.11.2016;2016;11;17;Sunnuntai;5;4;9;5;5;10
293;06.11.2016;2016;11;18;Sunnuntai;1;10;11;1;2;3
293;06.11.2016;2016;11;19;Sunnuntai;4;8;12;3;2;5
293;06.11.2016;2016;11;20;Sunnuntai;2;5;7;2;2;4
293;06.11.2016;2016;11;21;Sunnuntai;0;1;1;0;0;0
293;06.11.2016;2016;11;22;Sunnuntai;0;0;0;0;0;0
293;06.11.2016;2016;11;23;Sunnuntai;0;0;0;0;0;0
293;07.11.2016;2016;11;00;Maanantai;0;0;0;0;0;0
293;07.11.2016;2016;11;01;Maanantai;0;0;0;0;0;0
293;07.11.2016;2016;11;02;Maanantai;0;0;0;0;0;0
293;07.11.2016;2016;11;03;Maanantai;0;0;0;0;0;0
293;07.11.2016;2016;11;04;Maanantai;0;0;0;0;0;0
293;07.11.2016;2016;11;05;Maanantai;3;0;3;0;0;0
293;07.11.2016;2016;11;06;Maanantai;5;2;7;0;0;0
293;07.11.2016;2016;11;07;Maanantai;84;5;89;6;0;6
293;07.11.2016;2016;11;08;Maanantai;91;7;98;7;4;11
293;07.11.2016;2016;11;09;Maanantai;30;6;36;3;1;4
293;07.11.2016;2016;11;10;Maanantai;18;4;22;0;1;1
293;07.11.2016;2016;11;11;Maanantai;4;4;8;2;0;2
293;07.11.2016;2016;11;12;Maanantai;5;11;16;5;4;9
293;07.11.2016;2016;11;13;Maanantai;9;26;35;2;5;7
293;07.11.2016;2016;11;14;Maanantai;8;91;99;3;4;7
293;07.11.2016;2016;11;15;Maanantai;8;91;99;2;5;7
293;07.11.2016;2016;11;16;Maanantai;9;15;24;4;3;7
293;07.11.2016;2016;11;17;Maanantai;10;19;29;2;6;8
293;07.11.2016;2016;11;18;Maanantai;5;13;18;3;2;5
293;07.11.2016;2016;11;19;Maanantai;4;2;6;1;4;5
293;07.11.2016;2016;11;20;Maanantai;1;4;5;2;4;6
293;07.11.2016;2016;11;21;Maanantai;1;4;5;1;0;1
293;07.11.2016;2016;11;22;Maanantai;0;0;0;0;0;0
293;07.11.2016;2016;11;23;Maanantai;0;0;0;0;0;0
293;08.11.2016;2016;11;00;Tiistai;0;0;0;0;1;1
293;08.11.2016;2016;11;01;Tiistai;0;0;0;0;0;0
293;08.11.2016;2016;11;02;Tiistai;0;0;0;0;0;0
293;08.11.2016;2016;11;03;Tiistai;1;0;1;0;0;0
293;08.11.2016;2016;11;04;Tiistai;0;0;0;0;0;0
293;08.11.2016;2016;11;05;Tiistai;1;2;3;0;1;1
293;08.11.2016;2016;11;06;Tiistai;11;1;12;1;0;1
293;08.11.2016;2016;11;07;Tiistai;56;3;59;4;0;4
293;08.11.2016;2016;11;08;Tiistai;105;9;114;4;1;5
293;08.11.2016;2016;11;09;Tiistai;42;5;47;7;1;8
293;08.11.2016;2016;11;10;Tiistai;15;3;18;5;2;7
293;08.11.2016;2016;11;11;Tiistai;6;4;10;5;6;11
293;08.11.2016;2016;11;12;Tiistai;8;12;20;5;4;9
293;08.11.2016;2016;11;13;Tiistai;4;17;21;5;4;9
293;08.11.2016;2016;11;14;Tiistai;11;72;83;4;7;11
293;08.11.2016;2016;11;15;Tiistai;4;106;110;3;17;20
293;08.11.2016;2016;11;16;Tiistai;16;15;31;7;6;13
293;08.11.2016;2016;11;17;Tiistai;12;13;25;3;5;8
293;08.11.2016;2016;11;18;Tiistai;4;11;15;8;8;16
293;08.11.2016;2016;11;19;Tiistai;6;7;13;4;6;10
293;08.11.2016;2016;11;20;Tiistai;1;3;4;3;4;7
293;08.11.2016;2016;11;21;Tiistai;2;2;4;2;0;2
293;08.11.2016;2016;11;22;Tiistai;1;1;2;1;1;2
293;08.11.2016;2016;11;23;Tiistai;0;0;0;0;0;0
293;09.11.2016;2016;11;00;Keskiviikko;0;0;0;0;0;0
293;09.11.2016;2016;11;01;Keskiviikko;0;0;0;0;0;0
293;09.11.2016;2016;11;02;Keskiviikko;0;0;0;0;1;1
293;09.11.2016;2016;11;03;Keskiviikko;1;0;1;0;0;0
293;09.11.2016;2016;11;04;Keskiviikko;0;0;0;0;0;0
293;09.11.2016;2016;11;05;Keskiviikko;2;1;3;1;0;1
293;09.11.2016;2016;11;06;Keskiviikko;10;2;12;2;0;2
293;09.11.2016;2016;11;07;Keskiviikko;77;4;81;5;1;6
293;09.11.2016;2016;11;08;Keskiviikko;108;5;113;4;1;5
293;09.11.2016;2016;11;09;Keskiviikko;20;12;32;7;0;7
293;09.11.2016;2016;11;10;Keskiviikko;6;8;14;6;4;10
293;09.11.2016;2016;11;11;Keskiviikko;1;2;3;6;4;10
293;09.11.2016;2016;11;12;Keskiviikko;4;7;11;1;3;4
293;09.11.2016;2016;11;13;Keskiviikko;4;22;26;3;5;8
293;09.11.2016;2016;11;14;Keskiviikko;6;135;141;5;12;17
293;09.11.2016;2016;11;15;Keskiviikko;17;33;50;2;9;11
293;09.11.2016;2016;11;16;Keskiviikko;10;13;23;9;7;16
293;09.11.2016;2016;11;17;Keskiviikko;14;11;25;4;5;9
293;09.11.2016;2016;11;18;Keskiviikko;4;13;17;2;7;9
293;09.11.2016;2016;11;19;Keskiviikko;8;10;18;5;10;15
293;09.11.2016;2016;11;20;Keskiviikko;3;5;8;1;2;3
293;09.11.2016;2016;11;21;Keskiviikko;1;6;7;0;1;1
293;09.11.2016;2016;11;22;Keskiviikko;1;0;1;0;0;0
293;09.11.2016;2016;11;23;Keskiviikko;0;0;0;0;0;0
293;10.11.2016;2016;11;00;Torstai;0;0;0;0;0;0
293;10.11.2016;2016;11;01;Torstai;0;0;0;0;0;0
293;10.11.2016;2016;11;02;Torstai;0;1;1;0;0;0
293;10.11.2016;2016;11;03;Torstai;1;0;1;0;0;0
293;10.11.2016;2016;11;04;Torstai;0;0;0;0;0;0
293;10.11.2016;2016;11;05;Torstai;2;0;2;0;0;0
293;10.11.2016;2016;11;06;Torstai;4;2;6;2;0;2
293;10.11.2016;2016;11;07;Torstai;87;3;90;10;0;10
293;10.11.2016;2016;11;08;Torstai;98;6;104;11;5;16
293;10.11.2016;2016;11;09;Torstai;18;2;20;4;1;5
293;10.11.2016;2016;11;10;Torstai;4;1;5;1;5;6
293;10.11.2016;2016;11;11;Torstai;4;6;10;4;2;6
293;10.11.2016;2016;11;12;Torstai;4;11;15;3;1;4
293;10.11.2016;2016;11;13;Torstai;6;37;43;6;3;9
293;10.11.2016;2016;11;14;Torstai;8;77;85;2;8;10
293;10.11.2016;2016;11;15;Torstai;10;102;112;2;5;7
293;10.11.2016;2016;11;16;Torstai;14;17;31;1;3;4
293;10.11.2016;2016;11;17;Torstai;4;10;14;8;4;12
293;10.11.2016;2016;11;18;Torstai;3;4;7;8;3;11
293;10.11.2016;2016;11;19;Torstai;2;4;6;4;5;9
293;10.11.2016;2016;11;20;Torstai;0;2;2;0;2;2
293;10.11.2016;2016;11;21;Torstai;0;3;3;0;1;1
293;10.11.2016;2016;11;22;Torstai;0;2;2;1;0;1
293;10.11.2016;2016;11;23;Torstai;0;0;0;0;1;1
293;11.11.2016;2016;11;00;Perjantai;0;0;0;0;0;0
293;11.11.2016;2016;11;01;Perjantai;0;0;0;0;0;0
293;11.11.2016;2016;11;02;Perjantai;0;0;0;0;0;0
293;11.11.2016;2016;11;03;Perjantai;0;0;0;0;0;0
293;11.11.2016;2016;11;04;Perjantai;0;0;0;0;0;0
293;11.11.2016;2016;11;05;Perjantai;1;1;2;0;1;1
293;11.11.2016;2016;11;06;Perjantai;4;1;5;2;0;2
293;11.11.2016;2016;11;07;Perjantai;84;4;88;9;1;10
293;11.11.2016;2016;11;08;Perjantai;73;2;75;5;2;7
293;11.11.2016;2016;11;09;Perjantai;27;5;32;3;3;6
293;11.11.2016;2016;11;10;Perjantai;18;6;24;4;5;9
293;11.11.2016;2016;11;11;Perjantai;15;8;23;8;6;14
293;11.11.2016;2016;11;12;Perjantai;4;24;28;8;4;12
293;11.11.2016;2016;11;13;Perjantai;2;36;38;1;9;10
293;11.11.2016;2016;11;14;Perjantai;10;87;97;7;10;17
293;11.11.2016;2016;11;15;Perjantai;10;32;42;3;9;12
293;11.11.2016;2016;11;16;Perjantai;3;9;12;4;5;9
293;11.11.2016;2016;11;17;Perjantai;7;11;18;6;4;10
293;11.11.2016;2016;11;18;Perjantai;12;6;18;2;5;7
293;11.11.2016;2016;11;19;Perjantai;1;5;6;4;2;6
293;11.11.2016;2016;11;20;Perjantai;9;12;21;3;3;6
293;11.11.2016;2016;11;21;Perjantai;0;8;8;0;5;5
293;11.11.2016;2016;11;22;Perjantai;3;5;8;4;2;6
293;11.11.2016;2016;11;23;Perjantai;1;2;3;0;3;3
293;12.11.2016;2016;11;00;Lauantai;5;0;5;0;0;0
293;12.11.2016;2016;11;01;Lauantai;0;0;0;0;1;1
293;12.11.2016;2016;11;02;Lauantai;0;1;1;0;0;0
293;12.11.2016;2016;11;03;Lauantai;0;0;0;0;0;0
293;12.11.2016;2016;11;04;Lauantai;0;0;0;0;0;0
293;12.11.2016;2016;11;05;Lauantai;1;0;1;0;0;0
293;12.11.2016;2016;11;06;Lauantai;1;1;2;0;1;1
293;12.11.2016;2016;11;07;Lauantai;1;0;1;0;0;0
293;12.11.2016;2016;11;08;Lauantai;3;0;3;2;1;3
293;12.11.2016;2016;11;09;Lauantai;1;4;5;1;1;2
293;12.11.2016;2016;11;10;Lauantai;4;4;8;9;8;17
293;12.11.2016;2016;11;11;Lauantai;5;6;11;13;32;45
293;12.11.2016;2016;11;12;Lauantai;14;2;16;8;4;12
293;12.11.2016;2016;11;13;Lauantai;10;6;16;5;7;12
293;12.11.2016;2016;11;14;Lauantai;2;14;16;7;3;10
293;12.11.2016;2016;11;15;Lauantai;4;7;11;3;4;7
293;12.11.2016;2016;11;16;Lauantai;5;5;10;2;5;7
293;12.11.2016;2016;11;17;Lauantai;11;5;16;1;3;4
293;12.11.2016;2016;11;18;Lauantai;4;7;11;5;2;7
293;12.11.2016;2016;11;19;Lauantai;6;3;9;1;2;3
293;12.11.2016;2016;11;20;Lauantai;4;3;7;0;1;1
293;12.11.2016;2016;11;21;Lauantai;3;6;9;2;0;2
293;12.11.2016;2016;11;22;Lauantai;3;1;4;0;2;2
293;12.11.2016;2016;11;23;Lauantai;0;0;0;0;0;0
293;13.11.2016;2016;11;00;Sunnuntai;0;2;2;0;0;0
293;13.11.2016;2016;11;01;Sunnuntai;0;0;0;0;0;0
293;13.11.2016;2016;11;02;Sunnuntai;0;0;0;0;0;0
293;13.11.2016;2016;11;03;Sunnuntai;0;1;1;0;0;0
293;13.11.2016;2016;11;04;Sunnuntai;0;0;0;0;0;0
293;13.11.2016;2016;11;05;Sunnuntai;0;0;0;0;0;0
293;13.11.2016;2016;11;06;Sunnuntai;2;0;2;0;0;0
293;13.11.2016;2016;11;07;Sunnuntai;0;0;0;1;1;2
293;13.11.2016;2016;11;08;Sunnuntai;1;0;1;2;1;3
293;13.11.2016;2016;11;09;Sunnuntai;4;0;4;4;2;6
293;13.11.2016;2016;11;10;Sunnuntai;4;6;10;8;9;17
293;13.11.2016;2016;11;11;Sunnuntai;8;3;11;6;8;14
293;13.11.2016;2016;11;12;Sunnuntai;1;5;6;7;4;11
293;13.11.2016;2016;11;13;Sunnuntai;9;5;14;10;4;14
293;13.11.2016;2016;11;14;Sunnuntai;3;7;10;10;9;19
293;13.11.2016;2016;11;15;Sunnuntai;4;0;4;1;5;6
293;13.11.2016;2016;11;16;Sunnuntai;5;5;10;2;1;3
293;13.11.2016;2016;11;17;Sunnuntai;13;9;22;3;4;7
293;13.11.2016;2016;11;18;Sunnuntai;4;3;7;5;6;11
293;13.11.2016;2016;11;19;Sunnuntai;2;4;6;2;4;6
293;13.11.2016;2016;11;20;Sunnuntai;2;7;9;1;3;4
293;13.11.2016;2016;11;21;Sunnuntai;0;5;5;0;0;0
293;13.11.2016;2016;11;22;Sunnuntai;1;0;1;0;0;0
293;13.11.2016;2016;11;23;Sunnuntai;0;0;0;0;0;0
293;14.11.2016;2016;11;00;Maanantai;0;0;0;0;0;0
293;14.11.2016;2016;11;01;Maanantai;0;0;0;0;0;0
293;14.11.2016;2016;11;02;Maanantai;0;2;2;0;0;0
293;14.11.2016;2016;11;03;Maanantai;0;0;0;0;0;0
293;14.11.2016;2016;11;04;Maanantai;0;0;0;0;0;0
293;14.11.2016;2016;11;05;Maanantai;1;1;2;0;0;0
293;14.11.2016;2016;11;06;Maanantai;7;1;8;2;0;2
293;14.11.2016;2016;11;07;Maanantai;84;4;88;7;0;7
293;14.11.2016;2016;11;08;Maanantai;81;4;85;7;3;10
293;14.11.2016;2016;11;09;Maanantai;26;4;30;5;1;6
293;14.11.2016;2016;11;10;Maanantai;17;2;19;4;5;9
293;14.11.2016;2016;11;11;Maanantai;5;4;9;2;2;4
293;14.11.2016;2016;11;12;Maanantai;7;7;14;5;9;14
293;14.11.2016;2016;11;13;Maanantai;2;33;35;3;6;9
293;14.11.2016;2016;11;14;Maanantai;8;77;85;9;7;16
293;14.11.2016;2016;11;15;Maanantai;6;81;87;3;15;18
293;14.11.2016;2016;11;16;Maanantai;11;13;24;2;5;7
293;14.11.2016;2016;11;17;Maanantai;5;7;12;10;5;15
293;14.11.2016;2016;11;18;Maanantai;3;14;17;4;4;8
293;14.11.2016;2016;11;19;Maanantai;2;7;9;2;6;8
293;14.11.2016;2016;11;20;Maanantai;4;3;7;3;3;6
293;14.11.2016;2016;11;21;Maanantai;1;5;6;1;0;1
293;14.11.2016;2016;11;22;Maanantai;0;0;0;0;0;0
293;14.11.2016;2016;11;23;Maanantai;0;0;0;0;0;0
293;15.11.2016;2016;11;00;Tiistai;0;0;0;0;0;0
293;15.11.2016;2016;11;01;Tiistai;0;0;0;0;0;0
293;15.11.2016;2016;11;02;Tiistai;0;0;0;0;0;0
293;15.11.2016;2016;11;03;Tiistai;1;0;1;0;0;0
293;15.11.2016;2016;11;04;Tiistai;0;0;0;0;0;0
293;15.11.2016;2016;11;05;Tiistai;1;1;2;1;0;1
293;15.11.2016;2016;11;06;Tiistai;9;3;12;3;1;4
293;15.11.2016;2016;11;07;Tiistai;47;5;52;5;0;5
293;15.11.2016;2016;11;08;Tiistai;72;5;77;8;3;11
293;15.11.2016;2016;11;09;Tiistai;56;5;61;7;2;9
293;15.11.2016;2016;11;10;Tiistai;31;7;38;0;1;1
293;15.11.2016;2016;11;11;Tiistai;5;2;7;6;5;11
293;15.11.2016;2016;11;12;Tiistai;6;10;16;5;3;8
293;15.11.2016;2016;11;13;Tiistai;6;17;23;0;5;5
293;15.11.2016;2016;11;14;Tiistai;5;42;47;2;5;7
293;15.11.2016;2016;11;15;Tiistai;8;114;122;5;11;16
293;15.11.2016;2016;11;16;Tiistai;7;27;34;1;6;7
293;15.11.2016;2016;11;17;Tiistai;6;9;15;3;7;10
293;15.11.2016;2016;11;18;Tiistai;6;7;13;3;1;4
293;15.11.2016;2016;11;19;Tiistai;7;7;14;2;3;5
293;15.11.2016;2016;11;20;Tiistai;1;3;4;2;4;6
293;15.11.2016;2016;11;21;Tiistai;2;3;5;1;2;3
293;15.11.2016;2016;11;22;Tiistai;0;1;1;0;0;0
293;15.11.2016;2016;11;23;Tiistai;1;1;2;0;0;0
293;16.11.2016;2016;11;00;Keskiviikko;0;0;0;0;0;0
293;16.11.2016;2016;11;01;Keskiviikko;0;0;0;0;0;0
293;16.11.2016;2016;11;02;Keskiviikko;0;0;0;0;0;0
293;16.11.2016;2016;11;03;Keskiviikko;1;0;1;0;0;0
293;16.11.2016;2016;11;04;Keskiviikko;0;1;1;0;0;0
293;16.11.2016;2016;11;05;Keskiviikko;1;1;2;0;0;0
293;16.11.2016;2016;11;06;Keskiviikko;7;1;8;2;0;2
293;16.11.2016;2016;11;07;Keskiviikko;89;6;95;8;3;11
293;16.11.2016;2016;11;08;Keskiviikko;92;3;95;3;3;6
293;16.11.2016;2016;11;09;Keskiviikko;19;4;23;6;3;9
293;16.11.2016;2016;11;10;Keskiviikko;9;4;13;2;3;5
293;16.11.2016;2016;11;11;Keskiviikko;6;5;11;6;3;9
293;16.11.2016;2016;11;12;Keskiviikko;3;19;22;2;3;5
293;16.11.2016;2016;11;13;Keskiviikko;3;31;34;4;6;10
293;16.11.2016;2016;11;14;Keskiviikko;9;115;124;5;18;23
293;16.11.2016;2016;11;15;Keskiviikko;9;20;29;4;6;10
293;16.11.2016;2016;11;16;Keskiviikko;3;5;8;6;4;10
293;16.11.2016;2016;11;17;Keskiviikko;13;14;27;6;8;14
293;16.11.2016;2016;11;18;Keskiviikko;5;7;12;3;6;9
293;16.11.2016;2016;11;19;Keskiviikko;5;9;14;4;3;7
293;16.11.2016;2016;11;20;Keskiviikko;4;3;7;4;2;6
293;16.11.2016;2016;11;21;Keskiviikko;2;4;6;1;2;3
293;16.11.2016;2016;11;22;Keskiviikko;2;0;2;0;0;0
293;16.11.2016;2016;11;23;Keskiviikko;1;1;2;0;0;0
293;17.11.2016;2016;11;00;Torstai;0;1;1;0;1;1
293;17.11.2016;2016;11;01;Torstai;0;0;0;0;0;0
293;17.11.2016;2016;11;02;Torstai;0;0;0;0;0;0
293;17.11.2016;2016;11;03;Torstai;1;0;1;0;0;0
293;17.11.2016;2016;11;04;Torstai;0;1;1;0;0;0
293;17.11.2016;2016;11;05;Torstai;2;0;2;0;0;0
293;17.11.2016;2016;11;06;Torstai;3;1;4;3;0;3
293;17.11.2016;2016;11;07;Torstai;87;6;93;9;0;9
293;17.11.2016;2016;11;08;Torstai;97;1;98;27;3;30
293;17.11.2016;2016;11;09;Torstai;17;5;22;5;6;11
293;17.11.2016;2016;11;10;Torstai;7;3;10;8;23;31
293;17.11.2016;2016;11;11;Torstai;4;9;13;2;0;2
293;17.11.2016;2016;11;12;Torstai;5;8;13;10;5;15
293;17.11.2016;2016;11;13;Torstai;4;27;31;2;5;7
293;17.11.2016;2016;11;14;Torstai;7;68;75;6;4;10
293;17.11.2016;2016;11;15;Torstai;5;85;90;2;14;16
293;17.11.2016;2016;11;16;Torstai;8;12;20;0;8;8
293;17.11.2016;2016;11;17;Torstai;7;11;18;1;2;3
293;17.11.2016;2016;11;18;Torstai;7;6;13;3;3;6
293;17.11.2016;2016;11;19;Torstai;4;5;9;2;5;7
293;17.11.2016;2016;11;20;Torstai;2;3;5;1;3;4
293;17.11.2016;2016;11;21;Torstai;2;7;9;1;0;1
293;17.11.2016;2016;11;22;Torstai;0;1;1;0;0;0
293;17.11.2016;2016;11;23;Torstai;0;1;1;0;0;0
293;18.11.2016;2016;11;00;Perjantai;0;0;0;0;0;0
293;18.11.2016;2016;11;01;Perjantai;0;0;0;0;0;0
293;18.11.2016;2016;11;02;Perjantai;0;0;0;0;0;0
293;18.11.2016;2016;11;03;Perjantai;0;0;0;0;0;0
293;18.11.2016;2016;11;04;Perjantai;1;1;2;0;0;0
293;18.11.2016;2016;11;05;Perjantai;1;0;1;0;0;0
293;18.11.2016;2016;11;06;Perjantai;2;2;4;3;0;3
293;18.11.2016;2016;11;07;Perjantai;56;4;60;11;0;11
293;18.11.2016;2016;11;08;Perjantai;79;4;83;7;1;8
293;18.11.2016;2016;11;09;Perjantai;32;4;36;9;8;17
293;18.11.2016;2016;11;10;Perjantai;15;4;19;5;4;9
293;18.11.2016;2016;11;11;Perjantai;10;5;15;5;3;8
293;18.11.2016;2016;11;12;Perjantai;2;6;8;5;4;9
293;18.11.2016;2016;11;13;Perjantai;5;20;25;4;7;11
293;18.11.2016;2016;11;14;Perjantai;6;90;96;4;11;15
293;18.11.2016;2016;11;15;Perjantai;7;59;66;2;8;10
293;18.11.2016;2016;11;16;Perjantai;20;8;28;11;10;21
293;18.11.2016;2016;11;17;Perjantai;44;11;55;11;5;16
293;18.11.2016;2016;11;18;Perjantai;33;18;51;23;15;38
293;18.11.2016;2016;11;19;Perjantai;14;45;59;2;15;17
293;18.11.2016;2016;11;20;Perjantai;1;13;14;1;6;7
293;18.11.2016;2016;11;21;Perjantai;0;5;5;0;2;2
293;18.11.2016;2016;11;22;Perjantai;1;0;1;0;2;2
293;18.11.2016;2016;11;23;Perjantai;2;2;4;0;0;0
293;19.11.2016;2016;11;00;Lauantai;0;0;0;0;0;0
293;19.11.2016;2016;11;01;Lauantai;0;0;0;0;0;0
293;19.11.2016;2016;11;02;Lauantai;0;0;0;0;0;0
293;19.11.2016;2016;11;03;Lauantai;0;0;0;0;0;0
293;19.11.2016;2016;11;04;Lauantai;0;0;0;0;0;0
293;19.11.2016;2016;11;05;Lauantai;0;0;0;0;0;0
293;19.11.2016;2016;11;06;Lauantai;1;0;1;0;0;0
293;19.11.2016;2016;11;07;Lauantai;1;0;1;0;0;0
293;19.11.2016;2016;11;08;Lauantai;1;0;1;0;0;0
293;19.11.2016;2016;11;09;Lauantai;2;0;2;3;0;3
293;19.11.2016;2016;11;10;Lauantai;5;4;9;1;1;2
293;19.11.2016;2016;11;11;Lauantai;6;2;8;2;2;4
293;19.11.2016;2016;11;12;Lauantai;6;7;13;2;1;3
293;19.11.2016;2016;11;13;Lauantai;3;6;9;1;3;4
293;19.11.2016;2016;11;14;Lauantai;2;7;9;0;2;2
293;19.11.2016;2016;11;15;Lauantai;5;6;11;0;1;1
293;19.11.2016;2016;11;16;Lauantai;4;1;5;1;3;4
293;19.11.2016;2016;11;17;Lauantai;12;8;20;2;3;5
293;19.11.2016;2016;11;18;Lauantai;6;3;9;1;1;2
293;19.11.2016;2016;11;19;Lauantai;0;2;2;1;4;5
293;19.11.2016;2016;11;20;Lauantai;4;0;4;1;1;2
293;19.11.2016;2016;11;21;Lauantai;0;6;6;2;0;2
293;19.11.2016;2016;11;22;Lauantai;2;1;3;0;1;1
293;19.11.2016;2016;11;23;Lauantai;0;2;2;0;0;0
293;20.11.2016;2016;11;00;Sunnuntai;1;0;1;2;0;2
293;20.11.2016;2016;11;01;Sunnuntai;0;1;1;0;2;2
293;20.11.2016;2016;11;02;Sunnuntai;0;0;0;0;5;5
293;20.11.2016;2016;11;03;Sunnuntai;0;0;0;0;2;2
293;20.11.2016;2016;11;04;Sunnuntai;0;0;0;0;0;0
293;20.11.2016;2016;11;05;Sunnuntai;0;0;0;0;0;0
293;20.11.2016;2016;11;06;Sunnuntai;1;1;2;3;1;4
293;20.11.2016;2016;11;07;Sunnuntai;0;0;0;0;0;0
293;20.11.2016;2016;11;08;Sunnuntai;0;1;1;1;1;2
293;20.11.2016;2016;11;09;Sunnuntai;6;0;6;0;3;3
293;20.11.2016;2016;11;10;Sunnuntai;4;1;5;3;3;6
293;20.11.2016;2016;11;11;Sunnuntai;4;12;16;7;3;10
293;20.11.2016;2016;11;12;Sunnuntai;10;6;16;9;9;18
293;20.11.2016;2016;11;13;Sunnuntai;9;5;14;5;9;14
293;20.11.2016;2016;11;14;Sunnuntai;8;6;14;10;8;18
293;20.11.2016;2016;11;15;Sunnuntai;16;17;33;5;4;9
293;20.11.2016;2016;11;16;Sunnuntai;4;9;13;1;7;8
293;20.11.2016;2016;11;17;Sunnuntai;10;3;13;7;3;10
293;20.11.2016;2016;11;18;Sunnuntai;4;14;18;5;6;11
293;20.11.2016;2016;11;19;Sunnuntai;2;7;9;1;3;4
293;20.11.2016;2016;11;20;Sunnuntai;2;3;5;2;1;3
293;20.11.2016;2016;11;21;Sunnuntai;0;1;1;3;1;4
293;20.11.2016;2016;11;22;Sunnuntai;0;0;0;0;1;1
293;20.11.2016;2016;11;23;Sunnuntai;0;0;0;0;0;0
293;21.11.2016;2016;11;00;Maanantai;0;0;0;0;0;0
293;21.11.2016;2016;11;01;Maanantai;0;0;0;0;0;0
293;21.11.2016;2016;11;02;Maanantai;0;0;0;0;1;1
293;21.11.2016;2016;11;03;Maanantai;0;0;0;0;0;0
293;21.11.2016;2016;11;04;Maanantai;0;0;0;0;0;0
293;21.11.2016;2016;11;05;Maanantai;3;1;4;0;0;0
293;21.11.2016;2016;11;06;Maanantai;6;1;7;3;0;3
293;21.11.2016;2016;11;07;Maanantai;88;4;92;6;0;6
293;21.11.2016;2016;11;08;Maanantai;74;6;80;8;2;10
293;21.11.2016;2016;11;09;Maanantai;24;3;27;6;4;10
293;21.11.2016;2016;11;10;Maanantai;20;5;25;5;4;9
293;21.11.2016;2016;11;11;Maanantai;4;10;14;1;2;3
293;21.11.2016;2016;11;12;Maanantai;10;8;18;3;0;3
293;21.11.2016;2016;11;13;Maanantai;8;40;48;3;5;8
293;21.11.2016;2016;11;14;Maanantai;12;59;71;6;10;16
293;21.11.2016;2016;11;15;Maanantai;8;78;86;1;9;10
293;21.11.2016;2016;11;16;Maanantai;4;14;18;6;9;15
293;21.11.2016;2016;11;17;Maanantai;5;5;10;3;3;6
293;21.11.2016;2016;11;18;Maanantai;3;5;8;1;2;3
293;21.11.2016;2016;11;19;Maanantai;4;2;6;0;1;1
293;21.11.2016;2016;11;20;Maanantai;0;3;3;1;2;3
293;21.11.2016;2016;11;21;Maanantai;0;3;3;0;1;1
293;21.11.2016;2016;11;22;Maanantai;0;0;0;0;0;0
293;21.11.2016;2016;11;23;Maanantai;0;0;0;0;0;0
293;22.11.2016;2016;11;00;Tiistai;0;0;0;0;0;0
293;22.11.2016;2016;11;01;Tiistai;0;0;0;0;0;0
293;22.11.2016;2016;11;02;Tiistai;0;0;0;0;0;0
293;22.11.2016;2016;11;03;Tiistai;1;1;2;0;0;0
293;22.11.2016;2016;11;04;Tiistai;0;0;0;0;1;1
293;22.11.2016;2016;11;05;Tiistai;3;2;5;1;0;1
293;22.11.2016;2016;11;06;Tiistai;5;1;6;1;0;1
293;22.11.2016;2016;11;07;Tiistai;44;3;47;6;0;6
293;22.11.2016;2016;11;08;Tiistai;80;5;85;9;3;12
293;22.11.2016;2016;11;09;Tiistai;56;5;61;5;5;10
293;22.11.2016;2016;11;10;Tiistai;10;8;18;5;4;9
293;22.11.2016;2016;11;11;Tiistai;11;5;16;5;1;6
293;22.11.2016;2016;11;12;Tiistai;10;5;15;6;3;9
293;22.11.2016;2016;11;13;Tiistai;13;23;36;5;6;11
293;22.11.2016;2016;11;14;Tiistai;6;47;53;4;15;19
293;22.11.2016;2016;11;15;Tiistai;8;93;101;1;16;17
293;22.11.2016;2016;11;16;Tiistai;14;18;32;3;4;7
293;22.11.2016;2016;11;17;Tiistai;10;9;19;1;6;7
293;22.11.2016;2016;11;18;Tiistai;7;8;15;1;1;2
293;22.11.2016;2016;11;19;Tiistai;5;9;14;3;2;5
293;22.11.2016;2016;11;20;Tiistai;6;6;12;1;0;1
293;22.11.2016;2016;11;21;Tiistai;0;1;1;0;1;1
293;22.11.2016;2016;11;22;Tiistai;1;0;1;0;0;0
293;22.11.2016;2016;11;23;Tiistai;0;0;0;0;0;0
293;23.11.2016;2016;11;00;Keskiviikko;0;0;0;0;0;0
293;23.11.2016;2016;11;01;Keskiviikko;0;0;0;0;0;0
293;23.11.2016;2016;11;02;Keskiviikko;1;0;1;0;0;0
293;23.11.2016;2016;11;03;Keskiviikko;0;2;2;0;0;0
293;23.11.2016;2016;11;04;Keskiviikko;0;0;0;0;0;0
293;23.11.2016;2016;11;05;Keskiviikko;1;0;1;0;0;0
293;23.11.2016;2016;11;06;Keskiviikko;6;2;8;4;0;4
293;23.11.2016;2016;11;07;Keskiviikko;82;4;86;6;1;7
293;23.11.2016;2016;11;08;Keskiviikko;102;6;108;7;3;10
293;23.11.2016;2016;11;09;Keskiviikko;16;4;20;6;2;8
293;23.11.2016;2016;11;10;Keskiviikko;8;7;15;7;5;12
293;23.11.2016;2016;11;11;Keskiviikko;8;12;20;4;4;8
293;23.11.2016;2016;11;12;Keskiviikko;3;19;22;4;8;12
293;23.11.2016;2016;11;13;Keskiviikko;6;41;47;3;5;8
293;23.11.2016;2016;11;14;Keskiviikko;10;112;122;6;7;13
293;23.11.2016;2016;11;15;Keskiviikko;9;12;21;1;5;6
293;23.11.2016;2016;11;16;Keskiviikko;10;17;27;3;3;6
293;23.11.2016;2016;11;17;Keskiviikko;15;11;26;1;2;3
293;23.11.2016;2016;11;18;Keskiviikko;10;6;16;1;3;4
293;23.11.2016;2016;11;19;Keskiviikko;4;11;15;0;7;7
293;23.11.2016;2016;11;20;Keskiviikko;2;5;7;1;3;4
293;23.11.2016;2016;11;21;Keskiviikko;1;6;7;2;1;3
293;23.11.2016;2016;11;22;Keskiviikko;0;0;0;0;0;0
293;23.11.2016;2016;11;23;Keskiviikko;0;0;0;0;0;0
293;24.11.2016;2016;11;00;Torstai;0;0;0;0;0;0
293;24.11.2016;2016;11;01;Torstai;0;0;0;0;0;0
293;24.11.2016;2016;11;02;Torstai;1;0;1;0;0;0
293;24.11.2016;2016;11;03;Torstai;0;1;1;0;0;0
293;24.11.2016;2016;11;04;Torstai;0;0;0;0;0;0
293;24.11.2016;2016;11;05;Torstai;3;0;3;1;0;1
293;24.11.2016;2016;11;06;Torstai;2;2;4;1;0;1
293;24.11.2016;2016;11;07;Torstai;66;5;71;6;1;7
293;24.11.2016;2016;11;08;Torstai;114;4;118;6;3;9
293;24.11.2016;2016;11;09;Torstai;8;4;12;6;3;9
293;24.11.2016;2016;11;10;Torstai;7;4;11;3;3;6
293;24.11.2016;2016;11;11;Torstai;5;15;20;0;0;0
293;24.11.2016;2016;11;12;Torstai;7;15;22;7;1;8
293;24.11.2016;2016;11;13;Torstai;4;39;43;4;5;9
293;24.11.2016;2016;11;14;Torstai;8;71;79;3;9;12
293;24.11.2016;2016;11;15;Torstai;7;53;60;3;10;13
293;24.11.2016;2016;11;16;Torstai;15;16;31;3;5;8
293;24.11.2016;2016;11;17;Torstai;4;11;15;4;4;8
293;24.11.2016;2016;11;18;Torstai;3;4;7;5;7;12
293;24.11.2016;2016;11;19;Torstai;6;4;10;5;6;11
293;24.11.2016;2016;11;20;Torstai;1;9;10;2;3;5
293;24.11.2016;2016;11;21;Torstai;0;3;3;0;1;1
293;24.11.2016;2016;11;22;Torstai;0;0;0;0;1;1
293;24.11.2016;2016;11;23;Torstai;0;0;0;0;0;0
293;25.11.2016;2016;11;00;Perjantai;0;0;0;0;0;0
293;25.11.2016;2016;11;01;Perjantai;0;0;0;0;0;0
293;25.11.2016;2016;11;02;Perjantai;0;0;0;0;0;0
293;25.11.2016;2016;11;03;Perjantai;0;0;0;0;0;0
293;25.11.2016;2016;11;04;Perjantai;0;0;0;0;0;0
293;25.11.2016;2016;11;05;Perjantai;1;1;2;0;0;0
293;25.11.2016;2016;11;06;Perjantai;2;1;3;4;1;5
293;25.11.2016;2016;11;07;Perjantai;62;5;67;7;1;8
293;25.11.2016;2016;11;08;Perjantai;82;2;84;5;0;5
293;25.11.2016;2016;11;09;Perjantai;30;6;36;7;2;9
293;25.11.2016;2016;11;10;Perjantai;20;5;25;6;5;11
293;25.11.2016;2016;11;11;Perjantai;2;12;14;5;3;8
293;25.11.2016;2016;11;12;Perjantai;8;41;49;6;5;11
293;25.11.2016;2016;11;13;Perjantai;10;38;48;3;9;12
293;25.11.2016;2016;11;14;Perjantai;5;77;82;3;10;13
293;25.11.2016;2016;11;15;Perjantai;8;35;43;4;5;9
293;25.11.2016;2016;11;16;Perjantai;10;6;16;2;4;6
293;25.11.2016;2016;11;17;Perjantai;17;9;26;3;1;4
293;25.11.2016;2016;11;18;Perjantai;9;6;15;1;7;8
293;25.11.2016;2016;11;19;Perjantai;6;11;17;2;2;4
293;25.11.2016;2016;11;20;Perjantai;0;12;12;1;1;2
293;25.11.2016;2016;11;21;Perjantai;1;4;5;0;0;0
293;25.11.2016;2016;11;22;Perjantai;1;5;6;0;0;0
293;25.11.2016;2016;11;23;Perjantai;3;7;10;0;0;0
293;26.11.2016;2016;11;00;Lauantai;2;2;4;0;0;0
293;26.11.2016;2016;11;01;Lauantai;2;2;4;0;0;0
293;26.11.2016;2016;11;02;Lauantai;1;1;2;0;0;0
293;26.11.2016;2016;11;03;Lauantai;0;0;0;0;0;0
293;26.11.2016;2016;11;04;Lauantai;0;0;0;0;0;0
293;26.11.2016;2016;11;05;Lauantai;0;0;0;0;0;0
293;26.11.2016;2016;11;06;Lauantai;1;0;1;0;0;0
293;26.11.2016;2016;11;07;Lauantai;0;0;0;0;0;0
293;26.11.2016;2016;11;08;Lauantai;1;1;2;0;0;0
293;26.11.2016;2016;11;09;Lauantai;4;4;8;3;0;3
293;26.11.2016;2016;11;10;Lauantai;3;2;5;1;1;2
293;26.11.2016;2016;11;11;Lauantai;8;8;16;2;2;4
293;26.11.2016;2016;11;12;Lauantai;8;8;16;2;1;3
293;26.11.2016;2016;11;13;Lauantai;10;9;19;1;3;4
293;26.11.2016;2016;11;14;Lauantai;12;11;23;0;2;2
293;26.11.2016;2016;11;15;Lauantai;9;9;18;0;1;1
293;26.11.2016;2016;11;16;Lauantai;13;12;25;1;3;4
293;26.11.2016;2016;11;17;Lauantai;11;10;21;2;3;5
293;26.11.2016;2016;11;18;Lauantai;8;7;15;1;1;2
293;26.11.2016;2016;11;19;Lauantai;12;11;23;1;4;5
293;26.11.2016;2016;11;20;Lauantai;5;5;10;1;1;2
293;26.11.2016;2016;11;21;Lauantai;4;3;7;2;0;2
293;26.11.2016;2016;11;22;Lauantai;1;1;2;0;1;1
293;26.11.2016;2016;11;23;Lauantai;3;3;6;0;0;0
293;27.11.2016;2016;11;00;Sunnuntai;3;3;6;1;0;1
293;27.11.2016;2016;11;01;Sunnuntai;0;0;0;0;0;0
293;27.11.2016;2016;11;02;Sunnuntai;1;0;1;0;0;0
293;27.11.2016;2016;11;03;Sunnuntai;0;0;0;0;1;1
293;27.11.2016;2016;11;04;Sunnuntai;0;0;0;0;0;0
293;27.11.2016;2016;11;05;Sunnuntai;0;0;0;0;0;0
293;27.11.2016;2016;11;06;Sunnuntai;0;0;0;0;0;0
293;27.11.2016;2016;11;07;Sunnuntai;1;0;1;1;0;1
293;27.11.2016;2016;11;08;Sunnuntai;1;0;1;0;0;0
293;27.11.2016;2016;11;09;Sunnuntai;7;1;8;3;0;3
293;27.11.2016;2016;11;10;Sunnuntai;6;7;13;2;0;2
293;27.11.2016;2016;11;11;Sunnuntai;12;1;13;2;1;3
293;27.11.2016;2016;11;12;Sunnuntai;7;3;10;3;2;5
293;27.11.2016;2016;11;13;Sunnuntai;5;5;10;0;1;1
293;27.11.2016;2016;11;14;Sunnuntai;12;8;20;5;3;8
293;27.11.2016;2016;11;15;Sunnuntai;5;3;8;5;2;7
293;27.11.2016;2016;11;16;Sunnuntai;9;8;17;6;3;9
293;27.11.2016;2016;11;17;Sunnuntai;2;4;6;1;2;3
293;27.11.2016;2016;11;18;Sunnuntai;3;4;7;2;1;3
293;27.11.2016;2016;11;19;Sunnuntai;5;8;13;3;4;7
293;27.11.2016;2016;11;20;Sunnuntai;2;2;4;0;1;1
293;27.11.2016;2016;11;21;Sunnuntai;1;0;1;1;1;2
293;27.11.2016;2016;11;22;Sunnuntai;0;0;0;0;0;0
293;27.11.2016;2016;11;23;Sunnuntai;0;0;0;0;0;0
293;28.11.2016;2016;11;00;Maanantai;0;0;0;0;0;0
293;28.11.2016;2016;11;01;Maanantai;0;0;0;0;0;0
293;28.11.2016;2016;11;02;Maanantai;1;0;1;0;0;0
293;28.11.2016;2016;11;03;Maanantai;0;0;0;0;0;0
293;28.11.2016;2016;11;04;Maanantai;0;0;0;0;0;0
293;28.11.2016;2016;11;05;Maanantai;1;0;1;0;0;0
293;28.11.2016;2016;11;06;Maanantai;6;0;6;2;0;2
293;28.11.2016;2016;11;07;Maanantai;65;9;74;6;0;6
293;28.11.2016;2016;11;08;Maanantai;88;7;95;3;2;5
293;28.11.2016;2016;11;09;Maanantai;13;4;17;0;1;1
293;28.11.2016;2016;11;10;Maanantai;9;6;15;0;0;0
293;28.11.2016;2016;11;11;Maanantai;6;6;12;2;3;5
293;28.11.2016;2016;11;12;Maanantai;5;5;10;4;4;8
293;28.11.2016;2016;11;13;Maanantai;4;34;38;2;4;6
293;28.11.2016;2016;11;14;Maanantai;6;59;65;4;3;7
293;28.11.2016;2016;11;15;Maanantai;6;69;75;1;8;9
293;28.11.2016;2016;11;16;Maanantai;10;14;24;3;2;5
293;28.11.2016;2016;11;17;Maanantai;7;10;17;2;2;4
293;28.11.2016;2016;11;18;Maanantai;10;9;19;5;2;7
293;28.11.2016;2016;11;19;Maanantai;8;8;16;2;2;4
293;28.11.2016;2016;11;20;Maanantai;0;5;5;2;3;5
293;28.11.2016;2016;11;21;Maanantai;1;2;3;1;0;1
293;28.11.2016;2016;11;22;Maanantai;0;0;0;0;0;0
293;28.11.2016;2016;11;23;Maanantai;0;0;0;0;0;0
293;29.11.2016;2016;11;00;Tiistai;0;0;0;0;0;0
293;29.11.2016;2016;11;01;Tiistai;0;0;0;0;0;0
293;29.11.2016;2016;11;02;Tiistai;0;0;0;0;0;0
293;29.11.2016;2016;11;03;Tiistai;1;0;1;0;0;0
293;29.11.2016;2016;11;04;Tiistai;0;0;0;0;0;0
293;29.11.2016;2016;11;05;Tiistai;4;0;4;0;0;0
293;29.11.2016;2016;11;06;Tiistai;5;2;7;3;1;4
293;29.11.2016;2016;11;07;Tiistai;35;3;38;9;1;10
293;29.11.2016;2016;11;08;Tiistai;91;2;93;3;0;3
293;29.11.2016;2016;11;09;Tiistai;40;2;42;4;2;6
293;29.11.2016;2016;11;10;Tiistai;21;8;29;4;3;7
293;29.11.2016;2016;11;11;Tiistai;6;12;18;3;2;5
293;29.11.2016;2016;11;12;Tiistai;2;13;15;3;3;6
293;29.11.2016;2016;11;13;Tiistai;5;13;18;1;2;3
293;29.11.2016;2016;11;14;Tiistai;4;44;48;3;5;8
293;29.11.2016;2016;11;15;Tiistai;6;90;96;2;11;13
293;29.11.2016;2016;11;16;Tiistai;6;17;23;4;5;9
293;29.11.2016;2016;11;17;Tiistai;3;4;7;3;5;8
293;29.11.2016;2016;11;18;Tiistai;9;3;12;5;5;10
293;29.11.2016;2016;11;19;Tiistai;3;12;15;1;6;7
293;29.11.2016;2016;11;20;Tiistai;5;7;12;2;3;5
293;29.11.2016;2016;11;21;Tiistai;0;0;0;1;1;2
293;29.11.2016;2016;11;22;Tiistai;0;0;0;0;0;0
293;29.11.2016;2016;11;23;Tiistai;0;1;1;0;0;0
293;30.11.2016;2016;11;00;Keskiviikko;0;0;0;0;0;0
293;30.11.2016;2016;11;01;Keskiviikko;0;0;0;0;0;0
293;30.11.2016;2016;11;02;Keskiviikko;0;0;0;0;0;0
293;30.11.2016;2016;11;03;Keskiviikko;1;0;1;0;0;0
293;30.11.2016;2016;11;04;Keskiviikko;0;0;0;0;0;0
293;30.11.2016;2016;11;05;Keskiviikko;1;0;1;0;0;0
293;30.11.2016;2016;11;06;Keskiviikko;1;2;3;3;0;3
293;30.11.2016;2016;11;07;Keskiviikko;66;5;71;11;0;11
293;30.11.2016;2016;11;08;Keskiviikko;111;1;112;6;3;9
293;30.11.2016;2016;11;09;Keskiviikko;11;4;15;3;3;6
293;30.11.2016;2016;11;10;Keskiviikko;9;3;12;6;4;10
293;30.11.2016;2016;11;11;Keskiviikko;4;14;18;6;6;12
293;30.11.2016;2016;11;12;Keskiviikko;3;19;22;2;4;6
293;30.11.2016;2016;11;13;Keskiviikko;1;25;26;1;2;3
293;30.11.2016;2016;11;14;Keskiviikko;9;112;121;3;13;16
293;30.11.2016;2016;11;15;Keskiviikko;6;20;26;4;9;13
293;30.11.2016;2016;11;16;Keskiviikko;8;10;18;4;5;9
293;30.11.2016;2016;11;17;Keskiviikko;12;8;20;5;5;10
293;30.11.2016;2016;11;18;Keskiviikko;10;3;13;3;5;8
293;30.11.2016;2016;11;19;Keskiviikko;4;8;12;3;3;6
293;30.11.2016;2016;11;20;Keskiviikko;2;9;11;3;2;5
293;30.11.2016;2016;11;21;Keskiviikko;1;4;5;1;1;2
293;30.11.2016;2016;11;22;Keskiviikko;2;4;6;1;2;3
293;30.11.2016;2016;11;23;Keskiviikko;0;0;0;0;0;0
293;01.12.2016;2016;12;00;Torstai;0;0;0;0;1;1
293;01.12.2016;2016;12;01;Torstai;0;0;0;0;0;0
293;01.12.2016;2016;12;02;Torstai;1;0;1;0;0;0
293;01.12.2016;2016;12;03;Torstai;0;0;0;0;0;0
293;01.12.2016;2016;12;04;Torstai;0;0;0;0;0;0
293;01.12.2016;2016;12;05;Torstai;2;0;2;0;0;0
293;01.12.2016;2016;12;06;Torstai;2;1;3;2;0;2
293;01.12.2016;2016;12;07;Torstai;80;3;83;6;1;7
293;01.12.2016;2016;12;08;Torstai;98;6;104;8;1;9
293;01.12.2016;2016;12;09;Torstai;22;2;24;5;3;8
293;01.12.2016;2016;12;10;Torstai;6;7;13;3;5;8
293;01.12.2016;2016;12;11;Torstai;5;8;13;1;4;5
293;01.12.2016;2016;12;12;Torstai;9;5;14;7;7;14
293;01.12.2016;2016;12;13;Torstai;4;47;51;2;2;4
293;01.12.2016;2016;12;14;Torstai;2;69;71;5;15;20
293;01.12.2016;2016;12;15;Torstai;6;61;67;4;6;10
293;01.12.2016;2016;12;16;Torstai;3;8;11;3;6;9
293;01.12.2016;2016;12;17;Torstai;6;12;18;2;7;9
293;01.12.2016;2016;12;18;Torstai;3;2;5;6;6;12
293;01.12.2016;2016;12;19;Torstai;9;7;16;1;6;7
293;01.12.2016;2016;12;20;Torstai;2;3;5;3;1;4
293;01.12.2016;2016;12;21;Torstai;2;5;7;1;0;1
293;01.12.2016;2016;12;22;Torstai;0;0;0;0;2;2
293;01.12.2016;2016;12;23;Torstai;0;1;1;0;0;0
293;02.12.2016;2016;12;00;Perjantai;0;0;0;0;0;0
293;02.12.2016;2016;12;01;Perjantai;0;0;0;0;0;0
293;02.12.2016;2016;12;02;Perjantai;0;0;0;0;0;0
293;02.12.2016;2016;12;03;Perjantai;0;0;0;0;0;0
293;02.12.2016;2016;12;04;Perjantai;0;0;0;0;0;0
293;02.12.2016;2016;12;05;Perjantai;1;0;1;0;0;0
293;02.12.2016;2016;12;06;Perjantai;4;1;5;2;1;3
293;02.12.2016;2016;12;07;Perjantai;62;4;66;4;0;4
293;02.12.2016;2016;12;08;Perjantai;72;3;75;2;2;4
293;02.12.2016;2016;12;09;Perjantai;25;8;33;4;1;5
293;02.12.2016;2016;12;10;Perjantai;9;3;12;2;2;4
293;02.12.2016;2016;12;11;Perjantai;12;7;19;10;6;16
293;02.12.2016;2016;12;12;Perjantai;2;23;25;5;6;11
293;02.12.2016;2016;12;13;Perjantai;5;36;41;4;5;9
293;02.12.2016;2016;12;14;Perjantai;8;63;71;5;9;14
293;02.12.2016;2016;12;15;Perjantai;7;34;41;1;7;8
293;02.12.2016;2016;12;16;Perjantai;8;6;14;4;1;5
293;02.12.2016;2016;12;17;Perjantai;9;6;15;5;3;8
293;02.12.2016;2016;12;18;Perjantai;7;11;18;0;4;4
293;02.12.2016;2016;12;19;Perjantai;3;7;10;4;1;5
293;02.12.2016;2016;12;20;Perjantai;5;8;13;0;5;5
293;02.12.2016;2016;12;21;Perjantai;2;5;7;0;2;2
293;02.12.2016;2016;12;22;Perjantai;3;0;3;0;0;0
293;02.12.2016;2016;12;23;Perjantai;2;1;3;0;0;0
293;03.12.2016;2016;12;00;Lauantai;1;1;2;0;0;0
293;03.12.2016;2016;12;01;Lauantai;1;1;2;1;0;1
293;03.12.2016;2016;12;02;Lauantai;0;2;2;0;1;1
293;03.12.2016;2016;12;03;Lauantai;0;0;0;0;0;0
293;03.12.2016;2016;12;04;Lauantai;0;0;0;0;1;1
293;03.12.2016;2016;12;05;Lauantai;0;0;0;1;2;3
293;03.12.2016;2016;12;06;Lauantai;1;0;1;0;1;1
293;03.12.2016;2016;12;07;Lauantai;3;0;3;1;1;2
293;03.12.2016;2016;12;08;Lauantai;2;0;2;2;0;2
293;03.12.2016;2016;12;09;Lauantai;6;1;7;2;5;7
293;03.12.2016;2016;12;10;Lauantai;4;2;6;2;1;3
293;03.12.2016;2016;12;11;Lauantai;1;1;2;7;17;24
293;03.12.2016;2016;12;12;Lauantai;0;5;5;13;4;17
293;03.12.2016;2016;12;13;Lauantai;6;4;10;5;5;10
293;03.12.2016;2016;12;14;Lauantai;4;7;11;6;3;9
293;03.12.2016;2016;12;15;Lauantai;6;4;10;1;4;5
293;03.12.2016;2016;12;16;Lauantai;2;11;13;2;5;7
293;03.12.2016;2016;12;17;Lauantai;5;2;7;2;4;6
293;03.12.2016;2016;12;18;Lauantai;6;4;10;3;6;9
293;03.12.2016;2016;12;19;Lauantai;0;0;0;2;2;4
293;03.12.2016;2016;12;20;Lauantai;2;3;5;3;2;5
293;03.12.2016;2016;12;21;Lauantai;1;2;3;0;2;2
293;03.12.2016;2016;12;22;Lauantai;3;2;5;0;0;0
293;03.12.2016;2016;12;23;Lauantai;0;0;0;1;0;1
293;04.12.2016;2016;12;00;Sunnuntai;2;0;2;0;0;0
293;04.12.2016;2016;12;01;Sunnuntai;0;1;1;0;0;0
293;04.12.2016;2016;12;02;Sunnuntai;0;0;0;0;3;3
293;04.12.2016;2016;12;03;Sunnuntai;0;0;0;0;1;1
293;04.12.2016;2016;12;04;Sunnuntai;0;0;0;0;0;0
293;04.12.2016;2016;12;05;Sunnuntai;0;0;0;0;0;0
293;04.12.2016;2016;12;06;Sunnuntai;0;0;0;2;0;2
293;04.12.2016;2016;12;07;Sunnuntai;0;0;0;0;1;1
293;04.12.2016;2016;12;08;Sunnuntai;1;0;1;3;1;4
293;04.12.2016;2016;12;09;Sunnuntai;4;0;4;1;2;3
293;04.12.2016;2016;12;10;Sunnuntai;1;2;3;2;2;4
293;04.12.2016;2016;12;11;Sunnuntai;2;5;7;7;6;13
293;04.12.2016;2016;12;12;Sunnuntai;3;3;6;7;5;12
293;04.12.2016;2016;12;13;Sunnuntai;5;2;7;3;3;6
293;04.12.2016;2016;12;14;Sunnuntai;0;3;3;7;2;9
293;04.12.2016;2016;12;15;Sunnuntai;6;3;9;1;4;5
293;04.12.2016;2016;12;16;Sunnuntai;5;3;8;0;1;1
293;04.12.2016;2016;12;17;Sunnuntai;4;3;7;2;2;4
293;04.12.2016;2016;12;18;Sunnuntai;4;2;6;2;2;4
293;04.12.2016;2016;12;19;Sunnuntai;3;5;8;4;4;8
293;04.12.2016;2016;12;20;Sunnuntai;1;3;4;0;2;2
293;04.12.2016;2016;12;21;Sunnuntai;0;4;4;1;2;3
293;04.12.2016;2016;12;22;Sunnuntai;1;1;2;0;0;0
293;04.12.2016;2016;12;23;Sunnuntai;2;0;2;0;1;1
293;05.12.2016;2016;12;00;Maanantai;0;0;0;0;0;0
293;05.12.2016;2016;12;01;Maanantai;0;0;0;0;0;0
293;05.12.2016;2016;12;02;Maanantai;0;0;0;0;0;0
293;05.12.2016;2016;12;03;Maanantai;0;0;0;0;0;0
293;05.12.2016;2016;12;04;Maanantai;0;0;0;0;0;0
293;05.12.2016;2016;12;05;Maanantai;0;0;0;0;0;0
293;05.12.2016;2016;12;06;Maanantai;5;0;5;3;0;3
293;05.12.2016;2016;12;07;Maanantai;6;0;6;2;1;3
293;05.12.2016;2016;12;08;Maanantai;3;1;4;0;1;1
293;05.12.2016;2016;12;09;Maanantai;3;1;4;1;1;2
293;05.12.2016;2016;12;10;Maanantai;3;1;4;4;0;4
293;05.12.2016;2016;12;11;Maanantai;4;0;4;7;6;13
293;05.12.2016;2016;12;12;Maanantai;10;8;18;7;1;8
293;05.12.2016;2016;12;13;Maanantai;11;5;16;5;2;7
293;05.12.2016;2016;12;14;Maanantai;5;4;9;4;3;7
293;05.12.2016;2016;12;15;Maanantai;3;7;10;4;3;7
293;05.12.2016;2016;12;16;Maanantai;7;6;13;5;4;9
293;05.12.2016;2016;12;17;Maanantai;6;7;13;2;2;4
293;05.12.2016;2016;12;18;Maanantai;2;7;9;5;5;10
293;05.12.2016;2016;12;19;Maanantai;2;0;2;5;1;6
293;05.12.2016;2016;12;20;Maanantai;6;5;11;3;2;5
293;05.12.2016;2016;12;21;Maanantai;3;1;4;0;3;3
293;05.12.2016;2016;12;22;Maanantai;1;4;5;0;0;0
293;05.12.2016;2016;12;23;Maanantai;2;3;5;0;0;0
293;06.12.2016;2016;12;00;Tiistai;2;2;4;0;1;1
293;06.12.2016;2016;12;01;Tiistai;2;0;2;0;0;0
293;06.12.2016;2016;12;02;Tiistai;0;0;0;0;0;0
293;06.12.2016;2016;12;03;Tiistai;0;1;1;0;0;0
293;06.12.2016;2016;12;04;Tiistai;0;0;0;0;0;0
293;06.12.2016;2016;12;05;Tiistai;0;0;0;0;0;0
293;06.12.2016;2016;12;06;Tiistai;0;1;1;0;0;0
293;06.12.2016;2016;12;07;Tiistai;0;0;0;0;0;0
293;06.12.2016;2016;12;08;Tiistai;0;0;0;2;2;4
293;06.12.2016;2016;12;09;Tiistai;0;0;0;3;0;3
293;06.12.2016;2016;12;10;Tiistai;1;0;1;2;2;4
293;06.12.2016;2016;12;11;Tiistai;1;2;3;6;3;9
293;06.12.2016;2016;12;12;Tiistai;1;1;2;10;3;13
293;06.12.2016;2016;12;13;Tiistai;3;1;4;1;6;7
293;06.12.2016;2016;12;14;Tiistai;0;1;1;8;4;12
293;06.12.2016;2016;12;15;Tiistai;0;0;0;2;2;4
293;06.12.2016;2016;12;16;Tiistai;3;0;3;1;1;2
293;06.12.2016;2016;12;17;Tiistai;1;3;4;3;5;8
293;06.12.2016;2016;12;18;Tiistai;1;1;2;2;2;4
293;06.12.2016;2016;12;19;Tiistai;2;2;4;1;0;1
293;06.12.2016;2016;12;20;Tiistai;0;1;1;2;1;3
293;06.12.2016;2016;12;21;Tiistai;0;0;0;0;1;1
293;06.12.2016;2016;12;22;Tiistai;1;0;1;0;1;1
293;06.12.2016;2016;12;23;Tiistai;0;0;0;0;0;0
293;07.12.2016;2016;12;00;Keskiviikko;0;0;0;0;0;0
293;07.12.2016;2016;12;01;Keskiviikko;0;0;0;0;0;0
293;07.12.2016;2016;12;02;Keskiviikko;0;0;0;0;0;0
293;07.12.2016;2016;12;03;Keskiviikko;1;0;1;0;0;0
293;07.12.2016;2016;12;04;Keskiviikko;0;0;0;0;0;0
293;07.12.2016;2016;12;05;Keskiviikko;1;0;1;0;0;0
293;07.12.2016;2016;12;06;Keskiviikko;4;1;5;2;0;2
293;07.12.2016;2016;12;07;Keskiviikko;81;3;84;5;2;7
293;07.12.2016;2016;12;08;Keskiviikko;90;1;91;7;3;10
293;07.12.2016;2016;12;09;Keskiviikko;19;4;23;7;2;9
293;07.12.2016;2016;12;10;Keskiviikko;9;4;13;5;7;12
293;07.12.2016;2016;12;11;Keskiviikko;12;2;14;3;4;7
293;07.12.2016;2016;12;12;Keskiviikko;4;13;17;2;3;5
293;07.12.2016;2016;12;13;Keskiviikko;4;24;28;3;6;9
293;07.12.2016;2016;12;14;Keskiviikko;6;121;127;6;12;18
293;07.12.2016;2016;12;15;Keskiviikko;6;20;26;4;12;16
293;07.12.2016;2016;12;16;Keskiviikko;8;13;21;6;7;13
293;07.12.2016;2016;12;17;Keskiviikko;8;8;16;4;10;14
293;07.12.2016;2016;12;18;Keskiviikko;4;1;5;7;8;15
293;07.12.2016;2016;12;19;Keskiviikko;3;7;10;3;7;10
293;07.12.2016;2016;12;20;Keskiviikko;5;8;13;4;5;9
293;07.12.2016;2016;12;21;Keskiviikko;0;6;6;3;4;7
293;07.12.2016;2016;12;22;Keskiviikko;0;1;1;0;0;0
293;07.12.2016;2016;12;23;Keskiviikko;0;0;0;0;1;1
293;08.12.2016;2016;12;00;Torstai;0;0;0;0;0;0
293;08.12.2016;2016;12;01;Torstai;0;0;0;0;0;0
293;08.12.2016;2016;12;02;Torstai;1;0;1;0;0;0
293;08.12.2016;2016;12;03;Torstai;0;0;0;0;0;0
293;08.12.2016;2016;12;04;Torstai;0;0;0;0;0;0
293;08.12.2016;2016;12;05;Torstai;3;0;3;0;0;0
293;08.12.2016;2016;12;06;Torstai;5;2;7;2;1;3
293;08.12.2016;2016;12;07;Torstai;87;5;92;9;2;11
293;08.12.2016;2016;12;08;Torstai;79;3;82;14;1;15
293;08.12.2016;2016;12;09;Torstai;20;5;25;5;4;9
293;08.12.2016;2016;12;10;Torstai;5;3;8;3;4;7
293;08.12.2016;2016;12;11;Torstai;8;2;10;4;3;7
293;08.12.2016;2016;12;12;Torstai;5;5;10;6;1;7
293;08.12.2016;2016;12;13;Torstai;4;29;33;6;4;10
293;08.12.2016;2016;12;14;Torstai;9;89;98;6;13;19
293;08.12.2016;2016;12;15;Torstai;8;65;73;4;14;18
293;08.12.2016;2016;12;16;Torstai;8;9;17;2;8;10
293;08.12.2016;2016;12;17;Torstai;0;5;5;3;1;4
293;08.12.2016;2016;12;18;Torstai;9;4;13;9;7;16
293;08.12.2016;2016;12;19;Torstai;1;2;3;7;4;11
293;08.12.2016;2016;12;20;Torstai;1;7;8;2;7;9
293;08.12.2016;2016;12;21;Torstai;2;3;5;0;2;2
293;08.12.2016;2016;12;22;Torstai;0;0;0;1;0;1
293;08.12.2016;2016;12;23;Torstai;0;0;0;1;2;3
293;09.12.2016;2016;12;00;Perjantai;0;0;0;0;0;0
293;09.12.2016;2016;12;01;Perjantai;0;0;0;0;0;0
293;09.12.2016;2016;12;02;Perjantai;0;0;0;0;0;0
293;09.12.2016;2016;12;03;Perjantai;0;0;0;0;0;0
293;09.12.2016;2016;12;04;Perjantai;0;0;0;0;0;0
293;09.12.2016;2016;12;05;Perjantai;1;2;3;0;0;0
293;09.12.2016;2016;12;06;Perjantai;4;1;5;2;0;2
293;09.12.2016;2016;12;07;Perjantai;58;2;60;7;0;7
293;09.12.2016;2016;12;08;Perjantai;59;3;62;8;1;9
293;09.12.2016;2016;12;09;Perjantai;37;1;38;4;3;7
293;09.12.2016;2016;12;10;Perjantai;17;2;19;5;6;11
293;09.12.2016;2016;12;11;Perjantai;16;3;19;9;4;13
293;09.12.2016;2016;12;12;Perjantai;7;23;30;5;2;7
293;09.12.2016;2016;12;13;Perjantai;6;35;41;6;2;8
293;09.12.2016;2016;12;14;Perjantai;7;76;83;7;16;23
293;09.12.2016;2016;12;15;Perjantai;8;50;58;5;9;14
293;09.12.2016;2016;12;16;Perjantai;3;6;9;5;10;15
293;09.12.2016;2016;12;17;Perjantai;5;12;17;2;3;5
293;09.12.2016;2016;12;18;Perjantai;6;5;11;2;1;3
293;09.12.2016;2016;12;19;Perjantai;5;5;10;3;4;7
293;09.12.2016;2016;12;20;Perjantai;1;8;9;4;6;10
293;09.12.2016;2016;12;21;Perjantai;6;6;12;1;1;2
293;09.12.2016;2016;12;22;Perjantai;0;2;2;0;0;0
293;09.12.2016;2016;12;23;Perjantai;5;3;8;0;0;0
293;10.12.2016;2016;12;00;Lauantai;3;0;3;1;0;1
293;10.12.2016;2016;12;01;Lauantai;1;0;1;1;1;2
293;10.12.2016;2016;12;02;Lauantai;0;0;0;0;1;1
293;10.12.2016;2016;12;03;Lauantai;0;0;0;0;1;1
293;10.12.2016;2016;12;04;Lauantai;0;0;0;0;0;0
293;10.12.2016;2016;12;05;Lauantai;0;0;0;0;0;0
293;10.12.2016;2016;12;06;Lauantai;1;0;1;0;0;0
293;10.12.2016;2016;12;07;Lauantai;0;0;0;1;1;2
293;10.12.2016;2016;12;08;Lauantai;3;0;3;1;1;2
293;10.12.2016;2016;12;09;Lauantai;4;2;6;1;0;1
293;10.12.2016;2016;12;10;Lauantai;3;3;6;2;3;5
293;10.12.2016;2016;12;11;Lauantai;7;4;11;3;1;4
293;10.12.2016;2016;12;12;Lauantai;6;4;10;9;2;11
293;10.12.2016;2016;12;13;Lauantai;6;3;9;7;3;10
293;10.12.2016;2016;12;14;Lauantai;6;4;10;4;5;9
293;10.12.2016;2016;12;15;Lauantai;6;5;11;3;4;7
293;10.12.2016;2016;12;16;Lauantai;3;11;14;3;6;9
293;10.12.2016;2016;12;17;Lauantai;7;7;14;1;0;1
293;10.12.2016;2016;12;18;Lauantai;2;6;8;1;2;3
293;10.12.2016;2016;12;19;Lauantai;5;3;8;3;0;3
293;10.12.2016;2016;12;20;Lauantai;5;6;11;2;2;4
293;10.12.2016;2016;12;21;Lauantai;0;2;2;0;2;2
293;10.12.2016;2016;12;22;Lauantai;1;4;5;2;0;2
293;10.12.2016;2016;12;23;Lauantai;1;0;1;0;1;1
293;11.12.2016;2016;12;00;Sunnuntai;0;1;1;2;1;3
293;11.12.2016;2016;12;01;Sunnuntai;0;0;0;3;1;4
293;11.12.2016;2016;12;02;Sunnuntai;2;0;2;2;3;5
293;11.12.2016;2016;12;03;Sunnuntai;0;0;0;0;2;2
293;11.12.2016;2016;12;04;Sunnuntai;0;0;0;0;1;1
293;11.12.2016;2016;12;05;Sunnuntai;0;0;0;1;0;1
293;11.12.2016;2016;12;06;Sunnuntai;0;0;0;0;0;0
293;11.12.2016;2016;12;07;Sunnuntai;0;0;0;0;0;0
293;11.12.2016;2016;12;08;Sunnuntai;1;0;1;0;1;1
293;11.12.2016;2016;12;09;Sunnuntai;6;0;6;5;2;7
293;11.12.2016;2016;12;10;Sunnuntai;2;1;3;3;3;6
293;11.12.2016;2016;12;11;Sunnuntai;3;5;8;3;4;7
293;11.12.2016;2016;12;12;Sunnuntai;1;4;5;6;3;9
293;11.12.2016;2016;12;13;Sunnuntai;8;5;13;10;7;17
293;11.12.2016;2016;12;14;Sunnuntai;2;6;8;8;11;19
293;11.12.2016;2016;12;15;Sunnuntai;3;1;4;2;2;4
293;11.12.2016;2016;12;16;Sunnuntai;7;8;15;3;2;5
293;11.12.2016;2016;12;17;Sunnuntai;1;1;2;6;8;14
293;11.12.2016;2016;12;18;Sunnuntai;2;9;11;2;1;3
293;11.12.2016;2016;12;19;Sunnuntai;1;2;3;0;1;1
293;11.12.2016;2016;12;20;Sunnuntai;1;0;1;1;1;2
293;11.12.2016;2016;12;21;Sunnuntai;0;1;1;1;0;1
293;11.12.2016;2016;12;22;Sunnuntai;0;1;1;0;0;0
293;11.12.2016;2016;12;23;Sunnuntai;0;0;0;0;0;0
293;12.12.2016;2016;12;00;Maanantai;0;0;0;0;0;0
293;12.12.2016;2016;12;01;Maanantai;0;0;0;0;0;0
293;12.12.2016;2016;12;02;Maanantai;0;0;0;0;0;0
293;12.12.2016;2016;12;03;Maanantai;0;0;0;0;0;0
293;12.12.2016;2016;12;04;Maanantai;0;0;0;0;0;0
293;12.12.2016;2016;12;05;Maanantai;3;1;4;0;0;0
293;12.12.2016;2016;12;06;Maanantai;4;1;5;2;0;2
293;12.12.2016;2016;12;07;Maanantai;80;2;82;10;0;10
293;12.12.2016;2016;12;08;Maanantai;71;7;78;9;2;11
293;12.12.2016;2016;12;09;Maanantai;15;3;18;8;2;10
293;12.12.2016;2016;12;10;Maanantai;15;5;20;2;6;8
293;12.12.2016;2016;12;11;Maanantai;4;7;11;3;1;4
293;12.12.2016;2016;12;12;Maanantai;6;5;11;3;3;6
293;12.12.2016;2016;12;13;Maanantai;9;29;38;4;7;11
293;12.12.2016;2016;12;14;Maanantai;6;59;65;5;7;12
293;12.12.2016;2016;12;15;Maanantai;2;74;76;1;11;12
293;12.12.2016;2016;12;16;Maanantai;5;12;17;3;8;11
293;12.12.2016;2016;12;17;Maanantai;7;8;15;4;6;10
293;12.12.2016;2016;12;18;Maanantai;0;9;9;4;4;8
293;12.12.2016;2016;12;19;Maanantai;6;3;9;2;3;5
293;12.12.2016;2016;12;20;Maanantai;2;3;5;3;3;6
293;12.12.2016;2016;12;21;Maanantai;1;0;1;0;1;1
293;12.12.2016;2016;12;22;Maanantai;0;1;1;0;1;1
293;12.12.2016;2016;12;23;Maanantai;0;0;0;0;1;1
293;13.12.2016;2016;12;00;Tiistai;0;0;0;0;0;0
293;13.12.2016;2016;12;01;Tiistai;0;0;0;0;0;0
293;13.12.2016;2016;12;02;Tiistai;0;0;0;0;0;0
293;13.12.2016;2016;12;03;Tiistai;1;0;1;0;0;0
293;13.12.2016;2016;12;04;Tiistai;0;0;0;0;0;0
293;13.12.2016;2016;12;05;Tiistai;1;1;2;0;0;0
293;13.12.2016;2016;12;06;Tiistai;5;2;7;3;0;3
293;13.12.2016;2016;12;07;Tiistai;60;4;64;10;4;14
293;13.12.2016;2016;12;08;Tiistai;67;1;68;7;5;12
293;13.12.2016;2016;12;09;Tiistai;46;3;49;6;1;7
293;13.12.2016;2016;12;10;Tiistai;13;3;16;6;10;16
293;13.12.2016;2016;12;11;Tiistai;5;5;10;2;2;4
293;13.12.2016;2016;12;12;Tiistai;2;5;7;8;3;11
293;13.12.2016;2016;12;13;Tiistai;5;11;16;2;7;9
293;13.12.2016;2016;12;14;Tiistai;3;49;52;6;6;12
293;13.12.2016;2016;12;15;Tiistai;4;114;118;1;14;15
293;13.12.2016;2016;12;16;Tiistai;3;17;20;5;5;10
293;13.12.2016;2016;12;17;Tiistai;7;9;16;15;8;23
293;13.12.2016;2016;12;18;Tiistai;4;2;6;4;10;14
293;13.12.2016;2016;12;19;Tiistai;2;4;6;4;6;10
293;13.12.2016;2016;12;20;Tiistai;1;4;5;3;2;5
293;13.12.2016;2016;12;21;Tiistai;0;3;3;2;0;2
293;13.12.2016;2016;12;22;Tiistai;1;0;1;0;0;0
293;13.12.2016;2016;12;23;Tiistai;0;0;0;0;0;0
293;14.12.2016;2016;12;00;Keskiviikko;0;0;0;0;0;0
293;14.12.2016;2016;12;01;Keskiviikko;0;0;0;0;0;0
293;14.12.2016;2016;12;02;Keskiviikko;1;1;2;0;0;0
293;14.12.2016;2016;12;03;Keskiviikko;0;0;0;0;0;0
293;14.12.2016;2016;12;04;Keskiviikko;0;0;0;0;0;0
293;14.12.2016;2016;12;05;Keskiviikko;3;0;3;0;0;0
293;14.12.2016;2016;12;06;Keskiviikko;2;1;3;3;1;4
293;14.12.2016;2016;12;07;Keskiviikko;81;3;84;9;2;11
293;14.12.2016;2016;12;08;Keskiviikko;82;4;86;3;2;5
293;14.12.2016;2016;12;09;Keskiviikko;12;2;14;4;5;9
293;14.12.2016;2016;12;10;Keskiviikko;8;2;10;5;3;8
293;14.12.2016;2016;12;11;Keskiviikko;6;1;7;3;2;5
293;14.12.2016;2016;12;12;Keskiviikko;2;10;12;0;4;4
293;14.12.2016;2016;12;13;Keskiviikko;5;16;21;4;6;10
293;14.12.2016;2016;12;14;Keskiviikko;4;137;141;8;15;23
293;14.12.2016;2016;12;15;Keskiviikko;4;24;28;6;11;17
293;14.12.2016;2016;12;16;Keskiviikko;9;12;21;0;5;5
293;14.12.2016;2016;12;17;Keskiviikko;5;9;14;8;5;13
293;14.12.2016;2016;12;18;Keskiviikko;2;3;5;2;6;8
293;14.12.2016;2016;12;19;Keskiviikko;3;7;10;2;1;3
293;14.12.2016;2016;12;20;Keskiviikko;2;2;4;1;5;6
293;14.12.2016;2016;12;21;Keskiviikko;0;3;3;0;1;1
293;14.12.2016;2016;12;22;Keskiviikko;0;0;0;0;0;0
293;14.12.2016;2016;12;23;Keskiviikko;0;1;1;0;0;0
293;15.12.2016;2016;12;00;Torstai;0;0;0;0;0;0
293;15.12.2016;2016;12;01;Torstai;0;0;0;0;0;0
293;15.12.2016;2016;12;02;Torstai;1;0;1;0;0;0
293;15.12.2016;2016;12;03;Torstai;0;0;0;0;0;0
293;15.12.2016;2016;12;04;Torstai;0;1;1;0;0;0
293;15.12.2016;2016;12;05;Torstai;3;0;3;0;1;1
293;15.12.2016;2016;12;06;Torstai;3;2;5;2;0;2
293;15.12.2016;2016;12;07;Torstai;79;3;82;4;3;7
293;15.12.2016;2016;12;08;Torstai;93;2;95;8;3;11
293;15.12.2016;2016;12;09;Torstai;16;6;22;3;1;4
293;15.12.2016;2016;12;10;Torstai;12;9;21;1;3;4
293;15.12.2016;2016;12;11;Torstai;6;2;8;3;2;5
293;15.12.2016;2016;12;12;Torstai;9;7;16;2;2;4
293;15.12.2016;2016;12;13;Torstai;6;61;67;3;6;9
293;15.12.2016;2016;12;14;Torstai;4;69;73;12;10;22
293;15.12.2016;2016;12;15;Torstai;4;48;52;4;13;17
293;15.12.2016;2016;12;16;Torstai;4;6;10;4;9;13
293;15.12.2016;2016;12;17;Torstai;11;9;20;7;5;12
293;15.12.2016;2016;12;18;Torstai;1;2;3;8;5;13
293;15.12.2016;2016;12;19;Torstai;3;16;19;5;5;10
293;15.12.2016;2016;12;20;Torstai;1;4;5;5;9;14
293;15.12.2016;2016;12;21;Torstai;1;3;4;1;1;2
293;15.12.2016;2016;12;22;Torstai;0;0;0;0;0;0
293;15.12.2016;2016;12;23;Torstai;0;0;0;0;0;0
293;16.12.2016;2016;12;00;Perjantai;0;0;0;0;0;0
293;16.12.2016;2016;12;01;Perjantai;0;0;0;0;0;0
293;16.12.2016;2016;12;02;Perjantai;0;0;0;0;0;0
293;16.12.2016;2016;12;03;Perjantai;0;0;0;0;0;0
293;16.12.2016;2016;12;04;Perjantai;0;0;0;0;0;0
293;16.12.2016;2016;12;05;Perjantai;0;0;0;0;0;0
293;16.12.2016;2016;12;06;Perjantai;5;2;7;4;1;5
293;16.12.2016;2016;12;07;Perjantai;58;4;62;5;1;6
293;16.12.2016;2016;12;08;Perjantai;83;4;87;3;2;5
293;16.12.2016;2016;12;09;Perjantai;48;7;55;5;1;6
293;16.12.2016;2016;12;10;Perjantai;8;4;12;8;1;9
293;16.12.2016;2016;12;11;Perjantai;10;5;15;1;4;5
293;16.12.2016;2016;12;12;Perjantai;5;23;28;6;6;12
293;16.12.2016;2016;12;13;Perjantai;6;34;40;4;7;11
293;16.12.2016;2016;12;14;Perjantai;6;89;95;4;8;12
293;16.12.2016;2016;12;15;Perjantai;10;38;48;2;6;8
293;16.12.2016;2016;12;16;Perjantai;6;17;23;5;4;9
293;16.12.2016;2016;12;17;Perjantai;16;7;23;5;4;9
293;16.12.2016;2016;12;18;Perjantai;8;4;12;2;6;8
293;16.12.2016;2016;12;19;Perjantai;3;10;13;5;6;11
293;16.12.2016;2016;12;20;Perjantai;12;16;28;1;4;5
293;16.12.2016;2016;12;21;Perjantai;0;4;4;1;2;3
293;16.12.2016;2016;12;22;Perjantai;1;4;5;3;0;3
293;16.12.2016;2016;12;23;Perjantai;2;0;2;1;0;1
293;17.12.2016;2016;12;00;Lauantai;1;0;1;0;0;0
293;17.12.2016;2016;12;01;Lauantai;0;2;2;0;2;2
293;17.12.2016;2016;12;02;Lauantai;0;0;0;0;2;2
293;17.12.2016;2016;12;03;Lauantai;0;1;1;1;0;1
293;17.12.2016;2016;12;04;Lauantai;0;1;1;0;1;1
293;17.12.2016;2016;12;05;Lauantai;0;0;0;0;0;0
293;17.12.2016;2016;12;06;Lauantai;0;0;0;0;0;0
293;17.12.2016;2016;12;07;Lauantai;2;0;2;1;2;3
293;17.12.2016;2016;12;08;Lauantai;3;1;4;3;1;4
293;17.12.2016;2016;12;09;Lauantai;3;3;6;4;2;6
293;17.12.2016;2016;12;10;Lauantai;8;4;12;1;7;8
293;17.12.2016;2016;12;11;Lauantai;3;6;9;7;1;8
293;17.12.2016;2016;12;12;Lauantai;4;3;7;6;4;10
293;17.12.2016;2016;12;13;Lauantai;4;5;9;8;7;15
293;17.12.2016;2016;12;14;Lauantai;8;6;14;5;7;12
293;17.12.2016;2016;12;15;Lauantai;2;9;11;5;4;9
293;17.12.2016;2016;12;16;Lauantai;3;2;5;6;5;11
293;17.12.2016;2016;12;17;Lauantai;3;2;5;4;5;9
293;17.12.2016;2016;12;18;Lauantai;7;3;10;3;5;8
293;17.12.2016;2016;12;19;Lauantai;6;9;15;4;2;6
293;17.12.2016;2016;12;20;Lauantai;2;4;6;0;3;3
293;17.12.2016;2016;12;21;Lauantai;0;0;0;3;2;5
293;17.12.2016;2016;12;22;Lauantai;3;0;3;1;1;2
293;17.12.2016;2016;12;23;Lauantai;2;2;4;0;2;2
293;18.12.2016;2016;12;00;Sunnuntai;2;0;2;0;0;0
293;18.12.2016;2016;12;01;Sunnuntai;0;0;0;0;0;0
293;18.12.2016;2016;12;02;Sunnuntai;0;0;0;0;1;1
293;18.12.2016;2016;12;03;Sunnuntai;1;1;2;0;1;1
293;18.12.2016;2016;12;04;Sunnuntai;0;0;0;0;0;0
293;18.12.2016;2016;12;05;Sunnuntai;0;0;0;0;0;0
293;18.12.2016;2016;12;06;Sunnuntai;2;0;2;3;2;5
293;18.12.2016;2016;12;07;Sunnuntai;1;0;1;0;2;2
293;18.12.2016;2016;12;08;Sunnuntai;0;1;1;3;2;5
293;18.12.2016;2016;12;09;Sunnuntai;2;0;2;5;1;6
293;18.12.2016;2016;12;10;Sunnuntai;4;3;7;2;2;4
293;18.12.2016;2016;12;11;Sunnuntai;5;6;11;2;2;4
293;18.12.2016;2016;12;12;Sunnuntai;4;7;11;6;5;11
293;18.12.2016;2016;12;13;Sunnuntai;7;5;12;4;2;6
293;18.12.2016;2016;12;14;Sunnuntai;3;3;6;8;5;13
293;18.12.2016;2016;12;15;Sunnuntai;3;3;6;3;7;10
293;18.12.2016;2016;12;16;Sunnuntai;9;6;15;8;1;9
293;18.12.2016;2016;12;17;Sunnuntai;8;1;9;2;1;3
293;18.12.2016;2016;12;18;Sunnuntai;10;4;14;12;7;19
293;18.12.2016;2016;12;19;Sunnuntai;0;4;4;4;5;9
293;18.12.2016;2016;12;20;Sunnuntai;0;10;10;2;10;12
293;18.12.2016;2016;12;21;Sunnuntai;0;2;2;1;0;1
293;18.12.2016;2016;12;22;Sunnuntai;1;0;1;0;0;0
293;18.12.2016;2016;12;23;Sunnuntai;0;0;0;0;0;0
293;19.12.2016;2016;12;00;Maanantai;0;0;0;1;0;1
293;19.12.2016;2016;12;01;Maanantai;0;0;0;0;1;1
293;19.12.2016;2016;12;02;Maanantai;0;0;0;0;0;0
293;19.12.2016;2016;12;03;Maanantai;0;0;0;0;0;0
293;19.12.2016;2016;12;04;Maanantai;0;0;0;0;0;0
293;19.12.2016;2016;12;05;Maanantai;1;0;1;1;1;2
293;19.12.2016;2016;12;06;Maanantai;3;1;4;2;0;2
293;19.12.2016;2016;12;07;Maanantai;45;6;51;7;0;7
293;19.12.2016;2016;12;08;Maanantai;107;0;107;8;3;11
293;19.12.2016;2016;12;09;Maanantai;16;6;22;4;7;11
293;19.12.2016;2016;12;10;Maanantai;2;4;6;2;0;2
293;19.12.2016;2016;12;11;Maanantai;5;4;9;46;7;53
293;19.12.2016;2016;12;12;Maanantai;2;10;12;4;4;8
293;19.12.2016;2016;12;13;Maanantai;7;107;114;10;29;39
293;19.12.2016;2016;12;14;Maanantai;6;33;39;7;5;12
293;19.12.2016;2016;12;15;Maanantai;8;23;31;3;11;14
293;19.12.2016;2016;12;16;Maanantai;5;10;15;2;4;6
293;19.12.2016;2016;12;17;Maanantai;3;8;11;2;3;5
293;19.12.2016;2016;12;18;Maanantai;8;7;15;4;3;7
293;19.12.2016;2016;12;19;Maanantai;10;4;14;3;6;9
293;19.12.2016;2016;12;20;Maanantai;2;7;9;3;3;6
293;19.12.2016;2016;12;21;Maanantai;0;1;1;1;1;2
293;19.12.2016;2016;12;22;Maanantai;0;0;0;1;1;2
293;19.12.2016;2016;12;23;Maanantai;0;0;0;0;0;0
293;20.12.2016;2016;12;00;Tiistai;0;0;0;1;1;2
293;20.12.2016;2016;12;01;Tiistai;0;0;0;0;0;0
293;20.12.2016;2016;12;02;Tiistai;1;0;1;0;0;0
293;20.12.2016;2016;12;03;Tiistai;0;0;0;0;0;0
293;20.12.2016;2016;12;04;Tiistai;0;0;0;0;0;0
293;20.12.2016;2016;12;05;Tiistai;1;0;1;0;0;0
293;20.12.2016;2016;12;06;Tiistai;3;1;4;1;1;2
293;20.12.2016;2016;12;07;Tiistai;31;1;32;1;0;1
293;20.12.2016;2016;12;08;Tiistai;39;3;42;4;0;4
293;20.12.2016;2016;12;09;Tiistai;29;1;30;3;1;4
293;20.12.2016;2016;12;10;Tiistai;10;2;12;1;2;3
293;20.12.2016;2016;12;11;Tiistai;6;2;8;31;6;37
293;20.12.2016;2016;12;12;Tiistai;2;0;2;5;3;8
293;20.12.2016;2016;12;13;Tiistai;6;86;92;3;44;47
293;20.12.2016;2016;12;14;Tiistai;6;8;14;2;4;6
293;20.12.2016;2016;12;15;Tiistai;1;16;17;1;5;6
293;20.12.2016;2016;12;16;Tiistai;4;5;9;2;1;3
293;20.12.2016;2016;12;17;Tiistai;4;10;14;0;4;4
293;20.12.2016;2016;12;18;Tiistai;1;2;3;5;3;8
293;20.12.2016;2016;12;19;Tiistai;5;0;5;4;3;7
293;20.12.2016;2016;12;20;Tiistai;0;3;3;2;5;7
293;20.12.2016;2016;12;21;Tiistai;0;5;5;2;1;3
293;20.12.2016;2016;12;22;Tiistai;0;0;0;1;1;2
293;20.12.2016;2016;12;23;Tiistai;0;0;0;0;1;1
293;21.12.2016;2016;12;00;Keskiviikko;0;0;0;0;0;0
293;21.12.2016;2016;12;01;Keskiviikko;0;0;0;0;0;0
293;21.12.2016;2016;12;02;Keskiviikko;0;0;0;0;0;0
293;21.12.2016;2016;12;03;Keskiviikko;0;0;0;0;0;0
293;21.12.2016;2016;12;04;Keskiviikko;0;0;0;0;0;0
293;21.12.2016;2016;12;05;Keskiviikko;0;0;0;0;0;0
293;21.12.2016;2016;12;06;Keskiviikko;1;1;2;1;0;1
293;21.12.2016;2016;12;07;Keskiviikko;29;0;29;8;0;8
293;21.12.2016;2016;12;08;Keskiviikko;65;1;66;8;1;9
293;21.12.2016;2016;12;09;Keskiviikko;8;1;9;18;1;19
293;21.12.2016;2016;12;10;Keskiviikko;5;1;6;1;3;4
293;21.12.2016;2016;12;11;Keskiviikko;3;2;5;2;2;4
293;21.12.2016;2016;12;12;Keskiviikko;0;8;8;5;2;7
293;21.12.2016;2016;12;13;Keskiviikko;4;78;82;5;22;27
293;21.12.2016;2016;12;14;Keskiviikko;5;12;17;7;6;13
293;21.12.2016;2016;12;15;Keskiviikko;3;9;12;4;8;12
293;21.12.2016;2016;12;16;Keskiviikko;1;6;7;3;7;10
293;21.12.2016;2016;12;17;Keskiviikko;4;3;7;6;2;8
293;21.12.2016;2016;12;18;Keskiviikko;1;1;2;5;4;9
293;21.12.2016;2016;12;19;Keskiviikko;1;5;6;1;1;2
293;21.12.2016;2016;12;20;Keskiviikko;0;2;2;0;2;2
293;21.12.2016;2016;12;21;Keskiviikko;2;0;2;0;0;0
293;21.12.2016;2016;12;22;Keskiviikko;0;0;0;0;0;0
293;21.12.2016;2016;12;23;Keskiviikko;0;0;0;0;0;0
293;22.12.2016;2016;12;00;Torstai;0;0;0;0;0;0
293;22.12.2016;2016;12;01;Torstai;0;0;0;1;1;2
293;22.12.2016;2016;12;02;Torstai;0;1;1;1;0;1
293;22.12.2016;2016;12;03;Torstai;0;0;0;0;0;0
293;22.12.2016;2016;12;04;Torstai;0;0;0;0;0;0
293;22.12.2016;2016;12;05;Torstai;0;0;0;0;0;0
293;22.12.2016;2016;12;06;Torstai;1;1;2;2;0;2
293;22.12.2016;2016;12;07;Torstai;45;0;45;6;1;7
293;22.12.2016;2016;12;08;Torstai;20;4;24;3;1;4
293;22.12.2016;2016;12;09;Torstai;3;54;57;1;8;9
293;22.12.2016;2016;12;10;Torstai;5;10;15;2;5;7
293;22.12.2016;2016;12;11;Torstai;7;6;13;3;5;8
293;22.12.2016;2016;12;12;Torstai;7;3;10;3;3;6
293;22.12.2016;2016;12;13;Torstai;2;4;6;1;7;8
293;22.12.2016;2016;12;14;Torstai;7;4;11;3;4;7
293;22.12.2016;2016;12;15;Torstai;2;4;6;1;4;5
293;22.12.2016;2016;12;16;Torstai;4;7;11;4;3;7
293;22.12.2016;2016;12;17;Torstai;6;3;9;4;1;5
293;22.12.2016;2016;12;18;Torstai;6;6;12;2;7;9
293;22.12.2016;2016;12;19;Torstai;3;10;13;6;3;9
293;22.12.2016;2016;12;20;Torstai;1;3;4;2;1;3
293;22.12.2016;2016;12;21;Torstai;0;3;3;3;1;4
293;22.12.2016;2016;12;22;Torstai;2;0;2;0;2;2
293;22.12.2016;2016;12;23;Torstai;0;1;1;1;1;2
293;23.12.2016;2016;12;00;Perjantai;2;1;3;0;0;0
293;23.12.2016;2016;12;01;Perjantai;0;0;0;1;0;1
293;23.12.2016;2016;12;02;Perjantai;0;0;0;0;1;1
293;23.12.2016;2016;12;03;Perjantai;0;0;0;1;0;1
293;23.12.2016;2016;12;04;Perjantai;0;0;0;0;0;0
293;23.12.2016;2016;12;05;Perjantai;1;0;1;0;0;0
293;23.12.2016;2016;12;06;Perjantai;0;1;1;3;0;3
293;23.12.2016;2016;12;07;Perjantai;1;0;1;1;0;1
293;23.12.2016;2016;12;08;Perjantai;1;0;1;3;2;5
293;23.12.2016;2016;12;09;Perjantai;4;3;7;3;2;5
293;23.12.2016;2016;12;10;Perjantai;0;0;0;5;4;9
293;23.12.2016;2016;12;11;Perjantai;7;3;10;4;4;8
293;23.12.2016;2016;12;12;Perjantai;2;2;4;9;8;17
293;23.12.2016;2016;12;13;Perjantai;4;4;8;6;8;14
293;23.12.2016;2016;12;14;Perjantai;4;1;5;5;4;9
293;23.12.2016;2016;12;15;Perjantai;2;4;6;2;4;6
293;23.12.2016;2016;12;16;Perjantai;1;1;2;4;2;6
293;23.12.2016;2016;12;17;Perjantai;2;1;3;5;8;13
293;23.12.2016;2016;12;18;Perjantai;0;0;0;5;5;10
293;23.12.2016;2016;12;19;Perjantai;4;4;8;3;4;7
293;23.12.2016;2016;12;20;Perjantai;0;3;3;2;1;3
293;23.12.2016;2016;12;21;Perjantai;2;1;3;0;0;0
293;23.12.2016;2016;12;22;Perjantai;0;1;1;1;1;2
293;23.12.2016;2016;12;23;Perjantai;0;0;0;1;1;2
293;24.12.2016;2016;12;00;Lauantai;0;0;0;0;0;0
293;24.12.2016;2016;12;01;Lauantai;0;0;0;0;0;0
293;24.12.2016;2016;12;02;Lauantai;0;0;0;0;0;0
293;24.12.2016;2016;12;03;Lauantai;0;0;0;0;0;0
293;24.12.2016;2016;12;04;Lauantai;0;0;0;0;0;0
293;24.12.2016;2016;12;05;Lauantai;0;0;0;0;0;0
293;24.12.2016;2016;12;06;Lauantai;0;0;0;0;1;1
293;24.12.2016;2016;12;07;Lauantai;1;1;2;1;0;1
293;24.12.2016;2016;12;08;Lauantai;0;1;1;3;2;5
293;24.12.2016;2016;12;09;Lauantai;2;0;2;4;2;6
293;24.12.2016;2016;12;10;Lauantai;0;0;0;2;6;8
293;24.12.2016;2016;12;11;Lauantai;0;2;2;1;5;6
293;24.12.2016;2016;12;12;Lauantai;1;0;1;5;1;6
293;24.12.2016;2016;12;13;Lauantai;2;0;2;2;1;3
293;24.12.2016;2016;12;14;Lauantai;0;0;0;0;0;0
293;24.12.2016;2016;12;15;Lauantai;1;0;1;0;0;0
293;24.12.2016;2016;12;16;Lauantai;0;0;0;0;0;0
293;24.12.2016;2016;12;17;Lauantai;0;0;0;0;0;0
293;24.12.2016;2016;12;18;Lauantai;0;0;0;0;0;0
293;24.12.2016;2016;12;19;Lauantai;0;0;0;0;0;0
293;24.12.2016;2016;12;20;Lauantai;0;0;0;0;0;0
293;24.12.2016;2016;12;21;Lauantai;1;1;2;1;0;1
293;24.12.2016;2016;12;22;Lauantai;1;0;1;0;1;1
293;24.12.2016;2016;12;23;Lauantai;0;0;0;0;0;0
293;25.12.2016;2016;12;00;Sunnuntai;0;0;0;0;0;0
293;25.12.2016;2016;12;01;Sunnuntai;0;0;0;0;0;0
293;25.12.2016;2016;12;02;Sunnuntai;0;1;1;0;1;1
293;25.12.2016;2016;12;03;Sunnuntai;0;0;0;0;1;1
293;25.12.2016;2016;12;04;Sunnuntai;0;0;0;0;1;1
293;25.12.2016;2016;12;05;Sunnuntai;0;0;0;0;0;0
293;25.12.2016;2016;12;06;Sunnuntai;0;0;0;1;0;1
293;25.12.2016;2016;12;07;Sunnuntai;0;0;0;1;0;1
293;25.12.2016;2016;12;08;Sunnuntai;0;1;1;0;1;1
293;25.12.2016;2016;12;09;Sunnuntai;1;0;1;4;3;7
293;25.12.2016;2016;12;10;Sunnuntai;0;0;0;3;1;4
293;25.12.2016;2016;12;11;Sunnuntai;3;0;3;3;5;8
293;25.12.2016;2016;12;12;Sunnuntai;2;2;4;11;6;17
293;25.12.2016;2016;12;13;Sunnuntai;4;4;8;7;7;14
293;25.12.2016;2016;12;14;Sunnuntai;7;3;10;11;5;16
293;25.12.2016;2016;12;15;Sunnuntai;2;3;5;4;9;13
293;25.12.2016;2016;12;16;Sunnuntai;1;1;2;5;7;12
293;25.12.2016;2016;12;17;Sunnuntai;2;3;5;5;4;9
293;25.12.2016;2016;12;18;Sunnuntai;4;3;7;8;6;14
293;25.12.2016;2016;12;19;Sunnuntai;0;1;1;2;2;4
293;25.12.2016;2016;12;20;Sunnuntai;4;3;7;5;4;9
293;25.12.2016;2016;12;21;Sunnuntai;2;1;3;4;2;6
293;25.12.2016;2016;12;22;Sunnuntai;1;1;2;0;2;2
293;25.12.2016;2016;12;23;Sunnuntai;2;1;3;0;0;0
293;26.12.2016;2016;12;00;Maanantai;2;2;4;1;0;1
293;26.12.2016;2016;12;01;Maanantai;0;0;0;0;0;0
293;26.12.2016;2016;12;02;Maanantai;0;0;0;0;0;0
293;26.12.2016;2016;12;03;Maanantai;0;2;2;1;2;3
293;26.12.2016;2016;12;04;Maanantai;0;0;0;0;0;0
293;26.12.2016;2016;12;05;Maanantai;0;0;0;0;0;0
293;26.12.2016;2016;12;06;Maanantai;0;0;0;0;0;0
293;26.12.2016;2016;12;07;Maanantai;0;0;0;2;0;2
293;26.12.2016;2016;12;08;Maanantai;1;0;1;2;1;3
293;26.12.2016;2016;12;09;Maanantai;0;0;0;8;4;12
293;26.12.2016;2016;12;10;Maanantai;3;1;4;8;7;15
293;26.12.2016;2016;12;11;Maanantai;0;3;3;5;3;8
293;26.12.2016;2016;12;12;Maanantai;1;0;1;10;7;17
293;26.12.2016;2016;12;13;Maanantai;6;6;12;6;3;9
293;26.12.2016;2016;12;14;Maanantai;0;1;1;8;8;16
293;26.12.2016;2016;12;15;Maanantai;0;1;1;6;8;14
293;26.12.2016;2016;12;16;Maanantai;5;9;14;6;2;8
293;26.12.2016;2016;12;17;Maanantai;2;4;6;2;2;4
293;26.12.2016;2016;12;18;Maanantai;0;0;0;10;5;15
293;26.12.2016;2016;12;19;Maanantai;1;2;3;5;3;8
293;26.12.2016;2016;12;20;Maanantai;3;1;4;2;3;5
293;26.12.2016;2016;12;21;Maanantai;1;0;1;1;1;2
293;26.12.2016;2016;12;22;Maanantai;0;0;0;0;0;0
293;26.12.2016;2016;12;23;Maanantai;0;0;0;0;0;0
293;27.12.2016;2016;12;00;Tiistai;0;1;1;0;2;2
293;27.12.2016;2016;12;01;Tiistai;0;0;0;0;0;0
293;27.12.2016;2016;12;02;Tiistai;0;0;0;0;0;0
293;27.12.2016;2016;12;03;Tiistai;1;0;1;0;0;0
293;27.12.2016;2016;12;04;Tiistai;0;0;0;0;0;0
293;27.12.2016;2016;12;05;Tiistai;1;0;1;0;0;0
293;27.12.2016;2016;12;06;Tiistai;3;1;4;1;0;1
293;27.12.2016;2016;12;07;Tiistai;2;1;3;3;0;3
293;27.12.2016;2016;12;08;Tiistai;1;1;2;2;2;4
293;27.12.2016;2016;12;09;Tiistai;5;3;8;4;1;5
293;27.12.2016;2016;12;10;Tiistai;1;0;1;7;6;13
293;27.12.2016;2016;12;11;Tiistai;1;0;1;9;6;15
293;27.12.2016;2016;12;12;Tiistai;2;2;4;2;8;10
293;27.12.2016;2016;12;13;Tiistai;1;1;2;8;4;12
293;27.12.2016;2016;12;14;Tiistai;2;4;6;4;4;8
293;27.12.2016;2016;12;15;Tiistai;3;4;7;3;3;6
293;27.12.2016;2016;12;16;Tiistai;2;3;5;6;3;9
293;27.12.2016;2016;12;17;Tiistai;6;10;16;10;4;14
293;27.12.2016;2016;12;18;Tiistai;5;1;6;2;6;8
293;27.12.2016;2016;12;19;Tiistai;0;2;2;4;6;10
293;27.12.2016;2016;12;20;Tiistai;2;0;2;5;5;10
293;27.12.2016;2016;12;21;Tiistai;2;6;8;1;1;2
293;27.12.2016;2016;12;22;Tiistai;3;1;4;2;2;4
293;27.12.2016;2016;12;23;Tiistai;0;0;0;0;0;0
293;28.12.2016;2016;12;00;Keskiviikko;0;0;0;0;0;0
293;28.12.2016;2016;12;01;Keskiviikko;0;0;0;0;0;0
293;28.12.2016;2016;12;02;Keskiviikko;0;0;0;0;0;0
293;28.12.2016;2016;12;03;Keskiviikko;1;0;1;0;0;0
293;28.12.2016;2016;12;04;Keskiviikko;0;0;0;0;0;0
293;28.12.2016;2016;12;05;Keskiviikko;1;0;1;0;0;0
293;28.12.2016;2016;12;06;Keskiviikko;4;1;5;1;0;1
293;28.12.2016;2016;12;07;Keskiviikko;3;2;5;1;1;2
293;28.12.2016;2016;12;08;Keskiviikko;2;0;2;3;2;5
293;28.12.2016;2016;12;09;Keskiviikko;6;1;7;2;1;3
293;28.12.2016;2016;12;10;Keskiviikko;8;3;11;6;3;9
293;28.12.2016;2016;12;11;Keskiviikko;2;5;7;2;4;6
293;28.12.2016;2016;12;12;Keskiviikko;2;4;6;4;2;6
293;28.12.2016;2016;12;13;Keskiviikko;6;3;9;4;3;7
293;28.12.2016;2016;12;14;Keskiviikko;2;4;6;3;5;8
293;28.12.2016;2016;12;15;Keskiviikko;3;6;9;1;2;3
293;28.12.2016;2016;12;16;Keskiviikko;5;5;10;1;1;2
293;28.12.2016;2016;12;17;Keskiviikko;5;7;12;4;5;9
293;28.12.2016;2016;12;18;Keskiviikko;3;1;4;4;12;16
293;28.12.2016;2016;12;19;Keskiviikko;1;4;5;3;3;6
293;28.12.2016;2016;12;20;Keskiviikko;3;2;5;4;1;5
293;28.12.2016;2016;12;21;Keskiviikko;1;7;8;1;3;4
293;28.12.2016;2016;12;22;Keskiviikko;0;0;0;0;2;2
293;28.12.2016;2016;12;23;Keskiviikko;0;1;1;0;0;0
293;29.12.2016;2016;12;00;Torstai;2;0;2;0;0;0
293;29.12.2016;2016;12;01;Torstai;1;0;1;0;1;1
293;29.12.2016;2016;12;02;Torstai;0;0;0;0;0;0
293;29.12.2016;2016;12;03;Torstai;0;1;1;0;0;0
293;29.12.2016;2016;12;04;Torstai;0;0;0;0;0;0
293;29.12.2016;2016;12;05;Torstai;1;0;1;0;0;0
293;29.12.2016;2016;12;06;Torstai;3;1;4;0;0;0
293;29.12.2016;2016;12;07;Torstai;3;0;3;2;1;3
293;29.12.2016;2016;12;08;Torstai;1;0;1;0;0;0
293;29.12.2016;2016;12;09;Torstai;6;1;7;2;1;3
293;29.12.2016;2016;12;10;Torstai;6;2;8;5;3;8
293;29.12.2016;2016;12;11;Torstai;6;4;10;10;3;13
293;29.12.2016;2016;12;12;Torstai;5;6;11;8;11;19
293;29.12.2016;2016;12;13;Torstai;5;1;6;7;10;17
293;29.12.2016;2016;12;14;Torstai;5;10;15;5;8;13
293;29.12.2016;2016;12;15;Torstai;13;7;20;6;5;11
293;29.12.2016;2016;12;16;Torstai;1;10;11;3;4;7
293;29.12.2016;2016;12;17;Torstai;3;3;6;5;6;11
293;29.12.2016;2016;12;18;Torstai;5;5;10;5;4;9
293;29.12.2016;2016;12;19;Torstai;0;1;1;2;6;8
293;29.12.2016;2016;12;20;Torstai;2;2;4;0;2;2
293;29.12.2016;2016;12;21;Torstai;1;3;4;0;1;1
293;29.12.2016;2016;12;22;Torstai;0;0;0;4;3;7
293;29.12.2016;2016;12;23;Torstai;1;0;1;0;0;0
293;30.12.2016;2016;12;00;Perjantai;0;0;0;0;0;0
293;30.12.2016;2016;12;01;Perjantai;0;0;0;0;0;0
293;30.12.2016;2016;12;02;Perjantai;0;0;0;0;0;0
293;30.12.2016;2016;12;03;Perjantai;0;0;0;0;0;0
293;30.12.2016;2016;12;04;Perjantai;0;0;0;0;0;0
293;30.12.2016;2016;12;05;Perjantai;1;0;1;0;0;0
293;30.12.2016;2016;12;06;Perjantai;2;2;4;2;0;2
293;30.12.2016;2016;12;07;Perjantai;4;1;5;1;0;1
293;30.12.2016;2016;12;08;Perjantai;0;0;0;1;1;2
293;30.12.2016;2016;12;09;Perjantai;4;1;5;1;2;3
293;30.12.2016;2016;12;10;Perjantai;4;1;5;3;2;5
293;30.12.2016;2016;12;11;Perjantai;3;6;9;4;3;7
293;30.12.2016;2016;12;12;Perjantai;1;3;4;4;5;9
293;30.12.2016;2016;12;13;Perjantai;7;2;9;4;4;8
293;30.12.2016;2016;12;14;Perjantai;2;7;9;6;1;7
293;30.12.2016;2016;12;15;Perjantai;0;6;6;0;1;1
293;30.12.2016;2016;12;16;Perjantai;3;0;3;1;1;2
293;30.12.2016;2016;12;17;Perjantai;4;6;10;4;1;5
293;30.12.2016;2016;12;18;Perjantai;1;5;6;6;5;11
293;30.12.2016;2016;12;19;Perjantai;4;4;8;4;4;8
293;30.12.2016;2016;12;20;Perjantai;1;0;1;1;2;3
293;30.12.2016;2016;12;21;Perjantai;1;4;5;0;1;1
293;30.12.2016;2016;12;22;Perjantai;2;1;3;0;2;2
293;30.12.2016;2016;12;23;Perjantai;3;0;3;0;0;0
293;31.12.2016;2016;12;00;Lauantai;0;0;0;0;0;0
293;31.12.2016;2016;12;01;Lauantai;0;0;0;0;0;0
293;31.12.2016;2016;12;02;Lauantai;0;1;1;0;0;0
293;31.12.2016;2016;12;03;Lauantai;0;0;0;0;0;0
293;31.12.2016;2016;12;04;Lauantai;0;0;0;0;0;0
293;31.12.2016;2016;12;05;Lauantai;0;0;0;0;0;0
293;31.12.2016;2016;12;06;Lauantai;0;0;0;0;0;0
293;31.12.2016;2016;12;07;Lauantai;0;0;0;1;0;1
293;31.12.2016;2016;12;08;Lauantai;1;0;1;0;0;0
293;31.12.2016;2016;12;09;Lauantai;0;2;2;1;1;2
293;31.12.2016;2016;12;10;Lauantai;2;0;2;6;3;9
293;31.12.2016;2016;12;11;Lauantai;4;3;7;6;6;12
293;31.12.2016;2016;12;12;Lauantai;4;0;4;7;6;13
293;31.12.2016;2016;12;13;Lauantai;4;0;4;10;9;19
293;31.12.2016;2016;12;14;Lauantai;3;2;5;4;5;9
293;31.12.2016;2016;12;15;Lauantai;0;2;2;4;5;9
293;31.12.2016;2016;12;16;Lauantai;2;1;3;2;5;7
293;31.12.2016;2016;12;17;Lauantai;5;4;9;4;9;13
293;31.12.2016;2016;12;18;Lauantai;4;4;8;2;5;7
293;31.12.2016;2016;12;19;Lauantai;3;1;4;3;9;12
293;31.12.2016;2016;12;20;Lauantai;7;2;9;7;1;8
293;31.12.2016;2016;12;21;Lauantai;0;0;0;0;2;2
293;31.12.2016;2016;12;22;Lauantai;0;1;1;2;4;6
293;31.12.2016;2016;12;23;Lauantai;1;1;2;6;4;10
293;01.01.2017;2017;01;00;Sunnuntai;3;3;6;8;4;12
293;01.01.2017;2017;01;01;Sunnuntai;0;3;3;3;3;6
293;01.01.2017;2017;01;02;Sunnuntai;1;0;1;2;6;8
293;01.01.2017;2017;01;03;Sunnuntai;0;0;0;1;2;3
293;01.01.2017;2017;01;04;Sunnuntai;0;0;0;1;5;6
293;01.01.2017;2017;01;05;Sunnuntai;0;0;0;2;0;2
293;01.01.2017;2017;01;06;Sunnuntai;1;1;2;0;0;0
293;01.01.2017;2017;01;07;Sunnuntai;0;0;0;0;1;1
293;01.01.2017;2017;01;08;Sunnuntai;0;0;0;0;1;1
293;01.01.2017;2017;01;09;Sunnuntai;3;0;3;3;0;3
293;01.01.2017;2017;01;10;Sunnuntai;0;1;1;2;1;3
293;01.01.2017;2017;01;11;Sunnuntai;2;4;6;4;5;9
293;01.01.2017;2017;01;12;Sunnuntai;1;0;1;7;7;14
293;01.01.2017;2017;01;13;Sunnuntai;4;1;5;10;3;13
293;01.01.2017;2017;01;14;Sunnuntai;6;6;12;10;5;15
293;01.01.2017;2017;01;15;Sunnuntai;2;5;7;4;3;7
293;01.01.2017;2017;01;16;Sunnuntai;5;7;12;8;3;11
293;01.01.2017;2017;01;17;Sunnuntai;3;1;4;4;2;6
293;01.01.2017;2017;01;18;Sunnuntai;4;1;5;7;11;18
293;01.01.2017;2017;01;19;Sunnuntai;3;5;8;3;6;9
293;01.01.2017;2017;01;20;Sunnuntai;0;2;2;0;0;0
293;01.01.2017;2017;01;21;Sunnuntai;0;0;0;2;1;3
293;01.01.2017;2017;01;22;Sunnuntai;0;0;0;0;0;0
293;01.01.2017;2017;01;23;Sunnuntai;0;0;0;0;0;0
293;02.01.2017;2017;01;00;Maanantai;0;0;0;0;0;0
293;02.01.2017;2017;01;01;Maanantai;0;0;0;0;0;0
293;02.01.2017;2017;01;02;Maanantai;0;0;0;0;1;1
293;02.01.2017;2017;01;03;Maanantai;0;1;1;0;0;0
293;02.01.2017;2017;01;04;Maanantai;0;0;0;0;0;0
293;02.01.2017;2017;01;05;Maanantai;1;1;2;0;0;0
293;02.01.2017;2017;01;06;Maanantai;5;3;8;1;0;1
293;02.01.2017;2017;01;07;Maanantai;3;0;3;4;0;4
293;02.01.2017;2017;01;08;Maanantai;3;1;4;3;4;7
293;02.01.2017;2017;01;09;Maanantai;5;1;6;1;2;3
293;02.01.2017;2017;01;10;Maanantai;3;2;5;4;3;7
293;02.01.2017;2017;01;11;Maanantai;1;4;5;5;3;8
293;02.01.2017;2017;01;12;Maanantai;5;3;8;6;6;12
293;02.01.2017;2017;01;13;Maanantai;3;2;5;9;5;14
293;02.01.2017;2017;01;14;Maanantai;6;4;10;3;7;10
293;02.01.2017;2017;01;15;Maanantai;4;8;12;2;4;6
293;02.01.2017;2017;01;16;Maanantai;2;9;11;2;9;11
293;02.01.2017;2017;01;17;Maanantai;8;6;14;3;3;6
293;02.01.2017;2017;01;18;Maanantai;2;4;6;6;7;13
293;02.01.2017;2017;01;19;Maanantai;2;5;7;6;7;13
293;02.01.2017;2017;01;20;Maanantai;3;1;4;2;4;6
293;02.01.2017;2017;01;21;Maanantai;0;3;3;1;2;3
293;02.01.2017;2017;01;22;Maanantai;0;0;0;1;0;1
293;02.01.2017;2017;01;23;Maanantai;0;2;2;0;0;0
293;03.01.2017;2017;01;00;Tiistai;0;0;0;0;0;0
293;03.01.2017;2017;01;01;Tiistai;3;0;3;1;0;1
293;03.01.2017;2017;01;02;Tiistai;0;0;0;0;0;0
293;03.01.2017;2017;01;03;Tiistai;0;0;0;0;0;0
293;03.01.2017;2017;01;04;Tiistai;0;1;1;0;1;1
293;03.01.2017;2017;01;05;Tiistai;1;0;1;0;0;0
293;03.01.2017;2017;01;06;Tiistai;3;1;4;1;0;1
293;03.01.2017;2017;01;07;Tiistai;3;1;4;6;0;6
293;03.01.2017;2017;01;08;Tiistai;2;1;3;1;2;3
293;03.01.2017;2017;01;09;Tiistai;4;1;5;3;3;6
293;03.01.2017;2017;01;10;Tiistai;1;1;2;2;3;5
293;03.01.2017;2017;01;11;Tiistai;1;3;4;6;4;10
293;03.01.2017;2017;01;12;Tiistai;4;5;9;7;4;11
293;03.01.2017;2017;01;13;Tiistai;6;1;7;2;3;5
293;03.01.2017;2017;01;14;Tiistai;4;5;9;4;4;8
293;03.01.2017;2017;01;15;Tiistai;4;5;9;3;8;11
293;03.01.2017;2017;01;16;Tiistai;3;3;6;2;5;7
293;03.01.2017;2017;01;17;Tiistai;4;5;9;3;3;6
293;03.01.2017;2017;01;18;Tiistai;2;3;5;4;4;8
293;03.01.2017;2017;01;19;Tiistai;1;3;4;2;2;4
293;03.01.2017;2017;01;20;Tiistai;1;2;3;3;1;4
293;03.01.2017;2017;01;21;Tiistai;0;2;2;0;0;0
293;03.01.2017;2017;01;22;Tiistai;1;0;1;0;0;0
293;03.01.2017;2017;01;23;Tiistai;2;0;2;0;0;0
293;04.01.2017;2017;01;00;Keskiviikko;0;0;0;0;0;0
293;04.01.2017;2017;01;01;Keskiviikko;0;0;0;0;0;0
293;04.01.2017;2017;01;02;Keskiviikko;0;1;1;0;1;1
293;04.01.2017;2017;01;03;Keskiviikko;1;0;1;0;0;0
293;04.01.2017;2017;01;04;Keskiviikko;0;0;0;0;0;0
293;04.01.2017;2017;01;05;Keskiviikko;1;0;1;0;0;0
293;04.01.2017;2017;01;06;Keskiviikko;2;2;4;1;0;1
293;04.01.2017;2017;01;07;Keskiviikko;0;0;0;4;1;5
293;04.01.2017;2017;01;08;Keskiviikko;1;0;1;2;0;2
293;04.01.2017;2017;01;09;Keskiviikko;1;2;3;3;2;5
293;04.01.2017;2017;01;10;Keskiviikko;1;0;1;2;1;3
293;04.01.2017;2017;01;11;Keskiviikko;3;2;5;2;2;4
293;04.01.2017;2017;01;12;Keskiviikko;2;2;4;1;4;5
293;04.01.2017;2017;01;13;Keskiviikko;3;2;5;4;3;7
293;04.01.2017;2017;01;14;Keskiviikko;1;1;2;6;3;9
293;04.01.2017;2017;01;15;Keskiviikko;7;5;12;1;3;4
293;04.01.2017;2017;01;16;Keskiviikko;3;1;4;2;5;7
293;04.01.2017;2017;01;17;Keskiviikko;0;3;3;4;6;10
293;04.01.2017;2017;01;18;Keskiviikko;2;0;2;2;2;4
293;04.01.2017;2017;01;19;Keskiviikko;2;2;4;1;1;2
293;04.01.2017;2017;01;20;Keskiviikko;0;0;0;1;1;2
293;04.01.2017;2017;01;21;Keskiviikko;0;1;1;0;0;0
293;04.01.2017;2017;01;22;Keskiviikko;0;0;0;1;0;1
293;04.01.2017;2017;01;23;Keskiviikko;0;0;0;0;1;1
293;05.01.2017;2017;01;00;Torstai;0;0;0;0;0;0
293;05.01.2017;2017;01;01;Torstai;0;0;0;0;0;0
293;05.01.2017;2017;01;02;Torstai;0;0;0;0;0;0
293;05.01.2017;2017;01;03;Torstai;0;0;0;0;0;0
293;05.01.2017;2017;01;04;Torstai;0;0;0;0;0;0
293;05.01.2017;2017;01;05;Torstai;1;1;2;0;0;0
293;05.01.2017;2017;01;06;Torstai;1;1;2;1;0;1
293;05.01.2017;2017;01;07;Torstai;1;1;2;3;1;4
293;05.01.2017;2017;01;08;Torstai;2;0;2;4;1;5
293;05.01.2017;2017;01;09;Torstai;0;0;0;1;1;2
293;05.01.2017;2017;01;10;Torstai;1;1;2;2;1;3
293;05.01.2017;2017;01;11;Torstai;0;1;1;2;1;3
293;05.01.2017;2017;01;12;Torstai;0;0;0;2;2;4
293;05.01.2017;2017;01;13;Torstai;0;1;1;2;2;4
293;05.01.2017;2017;01;14;Torstai;3;0;3;2;4;6
293;05.01.2017;2017;01;15;Torstai;2;2;4;0;6;6
293;05.01.2017;2017;01;16;Torstai;1;3;4;2;3;5
293;05.01.2017;2017;01;17;Torstai;1;0;1;6;1;7
293;05.01.2017;2017;01;18;Torstai;1;0;1;1;3;4
293;05.01.2017;2017;01;19;Torstai;0;0;0;1;1;2
293;05.01.2017;2017;01;20;Torstai;1;0;1;1;1;2
293;05.01.2017;2017;01;21;Torstai;0;1;1;0;1;1
293;05.01.2017;2017;01;22;Torstai;0;0;0;0;0;0
293;05.01.2017;2017;01;23;Torstai;0;0;0;0;0;0
293;06.01.2017;2017;01;00;Perjantai;0;0;0;0;0;0
293;06.01.2017;2017;01;01;Perjantai;0;0;0;0;0;0
293;06.01.2017;2017;01;02;Perjantai;0;0;0;0;0;0
293;06.01.2017;2017;01;03;Perjantai;0;0;0;0;0;0
293;06.01.2017;2017;01;04;Perjantai;0;0;0;0;0;0
293;06.01.2017;2017;01;05;Perjantai;0;0;0;0;0;0
293;06.01.2017;2017;01;06;Perjantai;1;0;1;0;0;0
293;06.01.2017;2017;01;07;Perjantai;0;0;0;1;0;1
293;06.01.2017;2017;01;08;Perjantai;0;0;0;3;2;5
293;06.01.2017;2017;01;09;Perjantai;0;0;0;2;1;3
293;06.01.2017;2017;01;10;Perjantai;3;0;3;3;0;3
293;06.01.2017;2017;01;11;Perjantai;0;3;3;2;2;4
293;06.01.2017;2017;01;12;Perjantai;3;1;4;7;5;12
293;06.01.2017;2017;01;13;Perjantai;1;1;2;8;3;11
293;06.01.2017;2017;01;14;Perjantai;1;1;2;6;4;10
293;06.01.2017;2017;01;15;Perjantai;4;0;4;7;11;18
293;06.01.2017;2017;01;16;Perjantai;2;4;6;7;7;14
293;06.01.2017;2017;01;17;Perjantai;3;4;7;6;12;18
293;06.01.2017;2017;01;18;Perjantai;10;3;13;1;3;4
293;06.01.2017;2017;01;19;Perjantai;2;1;3;1;3;4
293;06.01.2017;2017;01;20;Perjantai;1;3;4;4;2;6
293;06.01.2017;2017;01;21;Perjantai;1;4;5;0;0;0
293;06.01.2017;2017;01;22;Perjantai;0;3;3;1;2;3
293;06.01.2017;2017;01;23;Perjantai;0;0;0;1;0;1
293;07.01.2017;2017;01;00;Lauantai;0;0;0;1;0;1
293;07.01.2017;2017;01;01;Lauantai;1;1;2;2;1;3
293;07.01.2017;2017;01;02;Lauantai;0;3;3;0;2;2
293;07.01.2017;2017;01;03;Lauantai;0;0;0;1;1;2
293;07.01.2017;2017;01;04;Lauantai;0;0;0;0;0;0
293;07.01.2017;2017;01;05;Lauantai;0;0;0;0;0;0
293;07.01.2017;2017;01;06;Lauantai;0;0;0;0;0;0
293;07.01.2017;2017;01;07;Lauantai;0;0;0;0;1;1
293;07.01.2017;2017;01;08;Lauantai;0;0;0;1;0;1
293;07.01.2017;2017;01;09;Lauantai;2;1;3;1;3;4
293;07.01.2017;2017;01;10;Lauantai;5;2;7;6;5;11
293;07.01.2017;2017;01;11;Lauantai;3;6;9;9;30;39
293;07.01.2017;2017;01;12;Lauantai;6;2;8;7;8;15
293;07.01.2017;2017;01;13;Lauantai;5;1;6;8;6;14
293;07.01.2017;2017;01;14;Lauantai;1;4;5;5;7;12
293;07.01.2017;2017;01;15;Lauantai;3;4;7;7;9;16
293;07.01.2017;2017;01;16;Lauantai;1;1;2;2;4;6
293;07.01.2017;2017;01;17;Lauantai;5;4;9;2;2;4
293;07.01.2017;2017;01;18;Lauantai;6;5;11;3;3;6
293;07.01.2017;2017;01;19;Lauantai;1;6;7;2;1;3
293;07.01.2017;2017;01;20;Lauantai;2;1;3;1;0;1
293;07.01.2017;2017;01;21;Lauantai;0;3;3;1;0;1
293;07.01.2017;2017;01;22;Lauantai;0;1;1;0;2;2
293;07.01.2017;2017;01;23;Lauantai;2;2;4;2;1;3
293;08.01.2017;2017;01;00;Sunnuntai;0;0;0;1;0;1
293;08.01.2017;2017;01;01;Sunnuntai;0;0;0;0;0;0
293;08.01.2017;2017;01;02;Sunnuntai;1;0;1;0;0;0
293;08.01.2017;2017;01;03;Sunnuntai;0;0;0;0;0;0
293;08.01.2017;2017;01;04;Sunnuntai;0;0;0;0;0;0
293;08.01.2017;2017;01;05;Sunnuntai;0;0;0;2;0;2
293;08.01.2017;2017;01;06;Sunnuntai;0;0;0;0;1;1
293;08.01.2017;2017;01;07;Sunnuntai;0;0;0;1;1;2
293;08.01.2017;2017;01;08;Sunnuntai;0;0;0;2;3;5
293;08.01.2017;2017;01;09;Sunnuntai;4;0;4;2;4;6
293;08.01.2017;2017;01;10;Sunnuntai;2;2;4;4;2;6
293;08.01.2017;2017;01;11;Sunnuntai;4;5;9;11;9;20
293;08.01.2017;2017;01;12;Sunnuntai;4;4;8;9;11;20
293;08.01.2017;2017;01;13;Sunnuntai;5;3;8;7;5;12
293;08.01.2017;2017;01;14;Sunnuntai;6;6;12;1;7;8
293;08.01.2017;2017;01;15;Sunnuntai;3;10;13;4;5;9
293;08.01.2017;2017;01;16;Sunnuntai;4;3;7;2;2;4
293;08.01.2017;2017;01;17;Sunnuntai;3;4;7;2;1;3
293;08.01.2017;2017;01;18;Sunnuntai;1;3;4;1;2;3
293;08.01.2017;2017;01;19;Sunnuntai;2;5;7;0;4;4
293;08.01.2017;2017;01;20;Sunnuntai;3;1;4;4;1;5
293;08.01.2017;2017;01;21;Sunnuntai;0;0;0;1;1;2
293;08.01.2017;2017;01;22;Sunnuntai;0;0;0;0;0;0
293;08.01.2017;2017;01;23;Sunnuntai;0;0;0;0;0;0
293;09.01.2017;2017;01;00;Maanantai;0;0;0;0;0;0
293;09.01.2017;2017;01;01;Maanantai;0;0;0;0;0;0
293;09.01.2017;2017;01;02;Maanantai;0;0;0;0;0;0
293;09.01.2017;2017;01;03;Maanantai;0;0;0;0;0;0
293;09.01.2017;2017;01;04;Maanantai;0;0;0;0;0;0
293;09.01.2017;2017;01;05;Maanantai;0;0;0;0;0;0
293;09.01.2017;2017;01;06;Maanantai;5;1;6;1;0;1
293;09.01.2017;2017;01;07;Maanantai;91;6;97;8;0;8
293;09.01.2017;2017;01;08;Maanantai;63;5;68;8;4;12
293;09.01.2017;2017;01;09;Maanantai;15;3;18;5;6;11
293;09.01.2017;2017;01;10;Maanantai;12;6;18;6;1;7
293;09.01.2017;2017;01;11;Maanantai;7;2;9;2;1;3
293;09.01.2017;2017;01;12;Maanantai;10;9;19;8;4;12
293;09.01.2017;2017;01;13;Maanantai;3;29;32;1;10;11
293;09.01.2017;2017;01;14;Maanantai;6;52;58;7;8;15
293;09.01.2017;2017;01;15;Maanantai;7;81;88;4;12;16
293;09.01.2017;2017;01;16;Maanantai;12;13;25;3;4;7
293;09.01.2017;2017;01;17;Maanantai;4;9;13;4;3;7
293;09.01.2017;2017;01;18;Maanantai;5;6;11;9;8;17
293;09.01.2017;2017;01;19;Maanantai;7;4;11;5;9;14
293;09.01.2017;2017;01;20;Maanantai;3;4;7;1;4;5
293;09.01.2017;2017;01;21;Maanantai;1;4;5;1;1;2
293;09.01.2017;2017;01;22;Maanantai;0;0;0;0;0;0
293;09.01.2017;2017;01;23;Maanantai;0;0;0;0;0;0
293;10.01.2017;2017;01;00;Tiistai;0;0;0;0;0;0
293;10.01.2017;2017;01;01;Tiistai;0;0;0;0;0;0
293;10.01.2017;2017;01;02;Tiistai;0;0;0;0;0;0
293;10.01.2017;2017;01;03;Tiistai;0;0;0;0;0;0
293;10.01.2017;2017;01;04;Tiistai;0;0;0;0;0;0
293;10.01.2017;2017;01;05;Tiistai;0;1;1;0;0;0
293;10.01.2017;2017;01;06;Tiistai;11;2;13;2;0;2
293;10.01.2017;2017;01;07;Tiistai;52;2;54;13;1;14
293;10.01.2017;2017;01;08;Tiistai;64;4;68;7;4;11
293;10.01.2017;2017;01;09;Tiistai;41;1;42;4;3;7
293;10.01.2017;2017;01;10;Tiistai;23;0;23;6;1;7
293;10.01.2017;2017;01;11;Tiistai;5;4;9;6;4;10
293;10.01.2017;2017;01;12;Tiistai;5;3;8;4;4;8
293;10.01.2017;2017;01;13;Tiistai;1;15;16;4;8;12
293;10.01.2017;2017;01;14;Tiistai;3;57;60;5;11;16
293;10.01.2017;2017;01;15;Tiistai;5;87;92;1;16;17
293;10.01.2017;2017;01;16;Tiistai;6;14;20;3;9;12
293;10.01.2017;2017;01;17;Tiistai;5;8;13;6;3;9
293;10.01.2017;2017;01;18;Tiistai;4;8;12;8;5;13
293;10.01.2017;2017;01;19;Tiistai;1;3;4;3;5;8
293;10.01.2017;2017;01;20;Tiistai;3;3;6;1;1;2
293;10.01.2017;2017;01;21;Tiistai;0;2;2;0;2;2
293;10.01.2017;2017;01;22;Tiistai;0;1;1;0;0;0
293;10.01.2017;2017;01;23;Tiistai;0;0;0;0;0;0
293;11.01.2017;2017;01;00;Keskiviikko;0;0;0;0;0;0
293;11.01.2017;2017;01;01;Keskiviikko;0;0;0;0;0;0
293;11.01.2017;2017;01;02;Keskiviikko;0;0;0;0;0;0
293;11.01.2017;2017;01;03;Keskiviikko;0;0;0;0;0;0
293;11.01.2017;2017;01;04;Keskiviikko;0;0;0;0;0;0
293;11.01.2017;2017;01;05;Keskiviikko;0;0;0;0;0;0
293;11.01.2017;2017;01;06;Keskiviikko;6;0;6;3;1;4
293;11.01.2017;2017;01;07;Keskiviikko;85;4;89;9;0;9
293;11.01.2017;2017;01;08;Keskiviikko;63;4;67;2;2;4
293;11.01.2017;2017;01;09;Keskiviikko;16;3;19;4;1;5
293;11.01.2017;2017;01;10;Keskiviikko;7;2;9;5;6;11
293;11.01.2017;2017;01;11;Keskiviikko;8;2;10;4;7;11
293;11.01.2017;2017;01;12;Keskiviikko;2;10;12;3;3;6
293;11.01.2017;2017;01;13;Keskiviikko;3;23;26;4;10;14
293;11.01.2017;2017;01;14;Keskiviikko;4;100;104;6;15;21
293;11.01.2017;2017;01;15;Keskiviikko;5;21;26;2;11;13
293;11.01.2017;2017;01;16;Keskiviikko;8;10;18;6;4;10
293;11.01.2017;2017;01;17;Keskiviikko;13;11;24;4;5;9
293;11.01.2017;2017;01;18;Keskiviikko;6;10;16;6;5;11
293;11.01.2017;2017;01;19;Keskiviikko;7;7;14;1;6;7
293;11.01.2017;2017;01;20;Keskiviikko;5;4;9;2;1;3
293;11.01.2017;2017;01;21;Keskiviikko;2;4;6;0;1;1
293;11.01.2017;2017;01;22;Keskiviikko;0;1;1;0;0;0
293;11.01.2017;2017;01;23;Keskiviikko;0;0;0;0;0;0
293;12.01.2017;2017;01;00;Torstai;0;0;0;0;0;0
293;12.01.2017;2017;01;01;Torstai;0;0;0;0;0;0
293;12.01.2017;2017;01;02;Torstai;0;0;0;0;0;0
293;12.01.2017;2017;01;03;Torstai;0;0;0;0;0;0
293;12.01.2017;2017;01;04;Torstai;0;0;0;0;0;0
293;12.01.2017;2017;01;05;Torstai;1;0;1;0;0;0
293;12.01.2017;2017;01;06;Torstai;7;1;8;1;0;1
293;12.01.2017;2017;01;07;Torstai;80;3;83;7;3;10
293;12.01.2017;2017;01;08;Torstai;69;2;71;3;2;5
293;12.01.2017;2017;01;09;Torstai;18;5;23;3;1;4
293;12.01.2017;2017;01;10;Torstai;6;1;7;1;3;4
293;12.01.2017;2017;01;11;Torstai;1;3;4;4;2;6
293;12.01.2017;2017;01;12;Torstai;3;3;6;2;2;4
293;12.01.2017;2017;01;13;Torstai;2;23;25;3;3;6
293;12.01.2017;2017;01;14;Torstai;4;88;92;4;14;18
293;12.01.2017;2017;01;15;Torstai;6;48;54;3;10;13
293;12.01.2017;2017;01;16;Torstai;9;7;16;2;4;6
293;12.01.2017;2017;01;17;Torstai;4;6;10;7;4;11
293;12.01.2017;2017;01;18;Torstai;7;11;18;6;4;10
293;12.01.2017;2017;01;19;Torstai;3;2;5;1;3;4
293;12.01.2017;2017;01;20;Torstai;2;7;9;2;0;2
293;12.01.2017;2017;01;21;Torstai;3;2;5;3;3;6
293;12.01.2017;2017;01;22;Torstai;0;1;1;1;1;2
293;12.01.2017;2017;01;23;Torstai;1;0;1;0;0;0
293;13.01.2017;2017;01;00;Perjantai;0;0;0;0;0;0
293;13.01.2017;2017;01;01;Perjantai;0;0;0;0;0;0
293;13.01.2017;2017;01;02;Perjantai;0;0;0;0;0;0
293;13.01.2017;2017;01;03;Perjantai;0;0;0;0;0;0
293;13.01.2017;2017;01;04;Perjantai;0;0;0;0;0;0
293;13.01.2017;2017;01;05;Perjantai;2;0;2;0;0;0
293;13.01.2017;2017;01;06;Perjantai;6;0;6;2;0;2
293;13.01.2017;2017;01;07;Perjantai;51;4;55;12;1;13
293;13.01.2017;2017;01;08;Perjantai;58;1;59;11;2;13
293;13.01.2017;2017;01;09;Perjantai;24;2;26;6;1;7
293;13.01.2017;2017;01;10;Perjantai;21;2;23;10;3;13
293;13.01.2017;2017;01;11;Perjantai;7;7;14;6;3;9
293;13.01.2017;2017;01;12;Perjantai;3;17;20;3;8;11
293;13.01.2017;2017;01;13;Perjantai;3;22;25;3;3;6
293;13.01.2017;2017;01;14;Perjantai;2;76;78;4;14;18
293;13.01.2017;2017;01;15;Perjantai;7;35;42;1;11;12
293;13.01.2017;2017;01;16;Perjantai;1;10;11;2;5;7
293;13.01.2017;2017;01;17;Perjantai;2;11;13;7;4;11
293;13.01.2017;2017;01;18;Perjantai;1;3;4;4;5;9
293;13.01.2017;2017;01;19;Perjantai;11;4;15;4;6;10
293;13.01.2017;2017;01;20;Perjantai;5;6;11;1;1;2
293;13.01.2017;2017;01;21;Perjantai;1;0;1;1;0;1
293;13.01.2017;2017;01;22;Perjantai;0;3;3;0;2;2
293;13.01.2017;2017;01;23;Perjantai;0;0;0;0;1;1
293;14.01.2017;2017;01;00;Lauantai;0;0;0;0;1;1
293;14.01.2017;2017;01;01;Lauantai;2;0;2;0;0;0
293;14.01.2017;2017;01;02;Lauantai;0;0;0;0;0;0
293;14.01.2017;2017;01;03;Lauantai;0;1;1;0;1;1
293;14.01.2017;2017;01;04;Lauantai;0;1;1;0;0;0
293;14.01.2017;2017;01;05;Lauantai;0;0;0;0;0;0
293;14.01.2017;2017;01;06;Lauantai;1;1;2;0;0;0
293;14.01.2017;2017;01;07;Lauantai;3;0;3;0;0;0
293;14.01.2017;2017;01;08;Lauantai;1;1;2;2;0;2
293;14.01.2017;2017;01;09;Lauantai;3;3;6;2;1;3
293;14.01.2017;2017;01;10;Lauantai;6;0;6;4;1;5
293;14.01.2017;2017;01;11;Lauantai;1;4;5;9;7;16
293;14.01.2017;2017;01;12;Lauantai;4;3;7;7;3;10
293;14.01.2017;2017;01;13;Lauantai;3;1;4;6;11;17
293;14.01.2017;2017;01;14;Lauantai;5;7;12;13;8;21
293;14.01.2017;2017;01;15;Lauantai;4;2;6;3;6;9
293;14.01.2017;2017;01;16;Lauantai;3;4;7;3;6;9
293;14.01.2017;2017;01;17;Lauantai;5;2;7;9;9;18
293;14.01.2017;2017;01;18;Lauantai;3;4;7;1;7;8
293;14.01.2017;2017;01;19;Lauantai;2;2;4;10;3;13
293;14.01.2017;2017;01;20;Lauantai;0;2;2;0;2;2
293;14.01.2017;2017;01;21;Lauantai;1;3;4;2;4;6
293;14.01.2017;2017;01;22;Lauantai;1;0;1;0;1;1
293;14.01.2017;2017;01;23;Lauantai;2;1;3;0;4;4
293;15.01.2017;2017;01;00;Sunnuntai;0;1;1;0;0;0
293;15.01.2017;2017;01;01;Sunnuntai;0;0;0;0;0;0
293;15.01.2017;2017;01;02;Sunnuntai;0;0;0;0;0;0
293;15.01.2017;2017;01;03;Sunnuntai;0;0;0;1;1;2
293;15.01.2017;2017;01;04;Sunnuntai;0;0;0;0;1;1
293;15.01.2017;2017;01;05;Sunnuntai;0;0;0;0;0;0
293;15.01.2017;2017;01;06;Sunnuntai;0;0;0;0;0;0
293;15.01.2017;2017;01;07;Sunnuntai;0;0;0;0;1;1
293;15.01.2017;2017;01;08;Sunnuntai;0;0;0;2;0;2
293;15.01.2017;2017;01;09;Sunnuntai;4;7;11;3;5;8
293;15.01.2017;2017;01;10;Sunnuntai;1;0;1;6;7;13
293;15.01.2017;2017;01;11;Sunnuntai;10;6;16;3;4;7
293;15.01.2017;2017;01;12;Sunnuntai;3;3;6;10;5;15
293;15.01.2017;2017;01;13;Sunnuntai;7;4;11;10;7;17
293;15.01.2017;2017;01;14;Sunnuntai;4;3;7;5;8;13
293;15.01.2017;2017;01;15;Sunnuntai;2;5;7;4;4;8
293;15.01.2017;2017;01;16;Sunnuntai;5;5;10;4;6;10
293;15.01.2017;2017;01;17;Sunnuntai;8;1;9;4;4;8
293;15.01.2017;2017;01;18;Sunnuntai;4;6;10;4;4;8
293;15.01.2017;2017;01;19;Sunnuntai;2;2;4;1;1;2
293;15.01.2017;2017;01;20;Sunnuntai;1;3;4;2;2;4
293;15.01.2017;2017;01;21;Sunnuntai;0;2;2;0;0;0
293;15.01.2017;2017;01;22;Sunnuntai;0;0;0;0;1;1
293;15.01.2017;2017;01;23;Sunnuntai;2;0;2;1;1;2
293;16.01.2017;2017;01;00;Maanantai;0;0;0;0;0;0
293;16.01.2017;2017;01;01;Maanantai;0;0;0;0;0;0
293;16.01.2017;2017;01;02;Maanantai;0;0;0;0;0;0
293;16.01.2017;2017;01;03;Maanantai;0;0;0;0;0;0
293;16.01.2017;2017;01;04;Maanantai;0;0;0;0;0;0
293;16.01.2017;2017;01;05;Maanantai;1;0;1;1;0;1
293;16.01.2017;2017;01;06;Maanantai;8;1;9;3;0;3
293;16.01.2017;2017;01;07;Maanantai;70;2;72;9;0;9
293;16.01.2017;2017;01;08;Maanantai;66;6;72;6;4;10
293;16.01.2017;2017;01;09;Maanantai;16;5;21;5;1;6
293;16.01.2017;2017;01;10;Maanantai;14;5;19;2;1;3
293;16.01.2017;2017;01;11;Maanantai;4;3;7;3;1;4
293;16.01.2017;2017;01;12;Maanantai;3;9;12;4;5;9
293;16.01.2017;2017;01;13;Maanantai;3;29;32;5;7;12
293;16.01.2017;2017;01;14;Maanantai;6;47;53;5;4;9
293;16.01.2017;2017;01;15;Maanantai;1;76;77;1;11;12
293;16.01.2017;2017;01;16;Maanantai;9;11;20;2;5;7
293;16.01.2017;2017;01;17;Maanantai;8;7;15;6;7;13
293;16.01.2017;2017;01;18;Maanantai;5;8;13;4;1;5
293;16.01.2017;2017;01;19;Maanantai;5;5;10;6;4;10
293;16.01.2017;2017;01;20;Maanantai;0;4;4;0;3;3
293;16.01.2017;2017;01;21;Maanantai;0;4;4;1;0;1
293;16.01.2017;2017;01;22;Maanantai;0;0;0;0;1;1
293;16.01.2017;2017;01;23;Maanantai;0;0;0;0;0;0
293;17.01.2017;2017;01;00;Tiistai;0;0;0;0;0;0
293;17.01.2017;2017;01;01;Tiistai;0;0;0;0;0;0
293;17.01.2017;2017;01;02;Tiistai;0;0;0;0;0;0
293;17.01.2017;2017;01;03;Tiistai;1;0;1;0;0;0
293;17.01.2017;2017;01;04;Tiistai;0;0;0;0;0;0
293;17.01.2017;2017;01;05;Tiistai;1;0;1;0;0;0
293;17.01.2017;2017;01;06;Tiistai;7;2;9;3;1;4
293;17.01.2017;2017;01;07;Tiistai;59;2;61;3;0;3
293;17.01.2017;2017;01;08;Tiistai;58;4;62;8;2;10
293;17.01.2017;2017;01;09;Tiistai;48;3;51;8;3;11
293;17.01.2017;2017;01;10;Tiistai;13;2;15;3;4;7
293;17.01.2017;2017;01;11;Tiistai;5;2;7;7;6;13
293;17.01.2017;2017;01;12;Tiistai;3;5;8;4;3;7
293;17.01.2017;2017;01;13;Tiistai;4;17;21;2;4;6
293;17.01.2017;2017;01;14;Tiistai;4;48;52;5;3;8
293;17.01.2017;2017;01;15;Tiistai;4;83;87;3;15;18
293;17.01.2017;2017;01;16;Tiistai;11;18;29;3;6;9
293;17.01.2017;2017;01;17;Tiistai;3;11;14;9;5;14
293;17.01.2017;2017;01;18;Tiistai;2;4;6;2;7;9
293;17.01.2017;2017;01;19;Tiistai;4;9;13;1;2;3
293;17.01.2017;2017;01;20;Tiistai;1;3;4;3;4;7
293;17.01.2017;2017;01;21;Tiistai;0;2;2;1;0;1
293;17.01.2017;2017;01;22;Tiistai;0;0;0;0;0;0
293;17.01.2017;2017;01;23;Tiistai;0;0;0;0;0;0
293;18.01.2017;2017;01;00;Keskiviikko;0;0;0;0;0;0
293;18.01.2017;2017;01;01;Keskiviikko;0;0;0;0;0;0
293;18.01.2017;2017;01;02;Keskiviikko;0;0;0;0;0;0
293;18.01.2017;2017;01;03;Keskiviikko;1;0;1;0;0;0
293;18.01.2017;2017;01;04;Keskiviikko;0;0;0;0;0;0
293;18.01.2017;2017;01;05;Keskiviikko;2;0;2;0;0;0
293;18.01.2017;2017;01;06;Keskiviikko;5;1;6;0;0;0
293;18.01.2017;2017;01;07;Keskiviikko;74;7;81;7;0;7
293;18.01.2017;2017;01;08;Keskiviikko;60;0;60;9;4;13
293;18.01.2017;2017;01;09;Keskiviikko;21;6;27;7;3;10
293;18.01.2017;2017;01;10;Keskiviikko;7;3;10;5;4;9
293;18.01.2017;2017;01;11;Keskiviikko;5;7;12;4;7;11
293;18.01.2017;2017;01;12;Keskiviikko;7;14;21;4;6;10
293;18.01.2017;2017;01;13;Keskiviikko;1;24;25;3;3;6
293;18.01.2017;2017;01;14;Keskiviikko;5;82;87;6;21;27
293;18.01.2017;2017;01;15;Keskiviikko;6;19;25;2;3;5
293;18.01.2017;2017;01;16;Keskiviikko;11;8;19;8;4;12
293;18.01.2017;2017;01;17;Keskiviikko;3;11;14;2;8;10
293;18.01.2017;2017;01;18;Keskiviikko;4;7;11;7;6;13
293;18.01.2017;2017;01;19;Keskiviikko;3;6;9;3;4;7
293;18.01.2017;2017;01;20;Keskiviikko;4;7;11;3;2;5
293;18.01.2017;2017;01;21;Keskiviikko;0;3;3;1;0;1
293;18.01.2017;2017;01;22;Keskiviikko;0;1;1;0;0;0
293;18.01.2017;2017;01;23;Keskiviikko;0;0;0;0;0;0
293;19.01.2017;2017;01;00;Torstai;0;0;0;0;0;0
293;19.01.2017;2017;01;01;Torstai;0;0;0;0;0;0
293;19.01.2017;2017;01;02;Torstai;0;0;0;0;0;0
293;19.01.2017;2017;01;03;Torstai;1;0;1;0;0;0
293;19.01.2017;2017;01;04;Torstai;0;0;0;0;0;0
293;19.01.2017;2017;01;05;Torstai;0;0;0;0;0;0
293;19.01.2017;2017;01;06;Torstai;6;1;7;2;0;2
293;19.01.2017;2017;01;07;Torstai;76;2;78;5;1;6
293;19.01.2017;2017;01;08;Torstai;70;5;75;9;5;14
293;19.01.2017;2017;01;09;Torstai;7;7;14;7;4;11
293;19.01.2017;2017;01;10;Torstai;8;2;10;5;2;7
293;19.01.2017;2017;01;11;Torstai;7;4;11;3;3;6
293;19.01.2017;2017;01;12;Torstai;3;6;9;1;3;4
293;19.01.2017;2017;01;13;Torstai;5;24;29;1;5;6
293;19.01.2017;2017;01;14;Torstai;2;49;51;3;13;16
293;19.01.2017;2017;01;15;Torstai;7;62;69;0;5;5
293;19.01.2017;2017;01;16;Torstai;6;9;15;9;7;16
293;19.01.2017;2017;01;17;Torstai;6;9;15;3;4;7
293;19.01.2017;2017;01;18;Torstai;6;5;11;2;2;4
293;19.01.2017;2017;01;19;Torstai;7;5;12;3;3;6
293;19.01.2017;2017;01;20;Torstai;3;1;4;2;2;4
293;19.01.2017;2017;01;21;Torstai;0;4;4;1;1;2
293;19.01.2017;2017;01;22;Torstai;0;0;0;0;0;0
293;19.01.2017;2017;01;23;Torstai;0;0;0;0;0;0
293;20.01.2017;2017;01;00;Perjantai;1;0;1;0;0;0
293;20.01.2017;2017;01;01;Perjantai;0;0;0;0;0;0
293;20.01.2017;2017;01;02;Perjantai;0;0;0;0;0;0
293;20.01.2017;2017;01;03;Perjantai;0;0;0;0;0;0
293;20.01.2017;2017;01;04;Perjantai;0;0;0;0;0;0
293;20.01.2017;2017;01;05;Perjantai;0;0;0;0;0;0
293;20.01.2017;2017;01;06;Perjantai;2;1;3;1;2;3
293;20.01.2017;2017;01;07;Perjantai;50;2;52;8;1;9
293;20.01.2017;2017;01;08;Perjantai;54;3;57;7;0;7
293;20.01.2017;2017;01;09;Perjantai;20;1;21;4;3;7
293;20.01.2017;2017;01;10;Perjantai;11;2;13;7;1;8
293;20.01.2017;2017;01;11;Perjantai;11;8;19;5;1;6
293;20.01.2017;2017;01;12;Perjantai;8;20;28;2;0;2
293;20.01.2017;2017;01;13;Perjantai;4;33;37;0;4;4
293;20.01.2017;2017;01;14;Perjantai;5;66;71;5;10;15
293;20.01.2017;2017;01;15;Perjantai;4;26;30;2;9;11
293;20.01.2017;2017;01;16;Perjantai;9;6;15;3;4;7
293;20.01.2017;2017;01;17;Perjantai;7;5;12;9;7;16
293;20.01.2017;2017;01;18;Perjantai;2;1;3;3;3;6
293;20.01.2017;2017;01;19;Perjantai;6;2;8;5;5;10
293;20.01.2017;2017;01;20;Perjantai;6;11;17;1;0;1
293;20.01.2017;2017;01;21;Perjantai;1;4;5;0;3;3
293;20.01.2017;2017;01;22;Perjantai;0;2;2;0;0;0
293;20.01.2017;2017;01;23;Perjantai;0;0;0;1;0;1
293;21.01.2017;2017;01;00;Lauantai;2;0;2;0;0;0
293;21.01.2017;2017;01;01;Lauantai;0;0;0;4;0;4
293;21.01.2017;2017;01;02;Lauantai;0;0;0;0;1;1
293;21.01.2017;2017;01;03;Lauantai;0;0;0;0;0;0
293;21.01.2017;2017;01;04;Lauantai;2;0;2;0;0;0
293;21.01.2017;2017;01;05;Lauantai;0;1;1;0;0;0
293;21.01.2017;2017;01;06;Lauantai;0;0;0;1;0;1
293;21.01.2017;2017;01;07;Lauantai;2;0;2;2;0;2
293;21.01.2017;2017;01;08;Lauantai;5;0;5;2;0;2
293;21.01.2017;2017;01;09;Lauantai;5;2;7;5;1;6
293;21.01.2017;2017;01;10;Lauantai;1;3;4;7;6;13
293;21.01.2017;2017;01;11;Lauantai;2;1;3;4;4;8
293;21.01.2017;2017;01;12;Lauantai;2;2;4;6;5;11
293;21.01.2017;2017;01;13;Lauantai;4;4;8;11;6;17
293;21.01.2017;2017;01;14;Lauantai;2;2;4;6;7;13
293;21.01.2017;2017;01;15;Lauantai;6;4;10;4;6;10
293;21.01.2017;2017;01;16;Lauantai;3;4;7;2;1;3
293;21.01.2017;2017;01;17;Lauantai;7;6;13;1;2;3
293;21.01.2017;2017;01;18;Lauantai;4;9;13;7;2;9
293;21.01.2017;2017;01;19;Lauantai;2;1;3;1;6;7
293;21.01.2017;2017;01;20;Lauantai;0;1;1;1;1;2
293;21.01.2017;2017;01;21;Lauantai;2;0;2;0;1;1
293;21.01.2017;2017;01;22;Lauantai;1;0;1;0;1;1
293;21.01.2017;2017;01;23;Lauantai;0;0;0;0;0;0
293;22.01.2017;2017;01;00;Sunnuntai;0;1;1;0;0;0
293;22.01.2017;2017;01;01;Sunnuntai;0;0;0;1;0;1
293;22.01.2017;2017;01;02;Sunnuntai;0;0;0;0;0;0
293;22.01.2017;2017;01;03;Sunnuntai;0;1;1;0;0;0
293;22.01.2017;2017;01;04;Sunnuntai;0;0;0;0;1;1
293;22.01.2017;2017;01;05;Sunnuntai;0;0;0;0;0;0
293;22.01.2017;2017;01;06;Sunnuntai;1;0;1;0;0;0
293;22.01.2017;2017;01;07;Sunnuntai;0;0;0;0;0;0
293;22.01.2017;2017;01;08;Sunnuntai;0;0;0;3;0;3
293;22.01.2017;2017;01;09;Sunnuntai;7;1;8;4;3;7
293;22.01.2017;2017;01;10;Sunnuntai;6;2;8;6;2;8
293;22.01.2017;2017;01;11;Sunnuntai;2;8;10;3;6;9
293;22.01.2017;2017;01;12;Sunnuntai;6;1;7;3;5;8
293;22.01.2017;2017;01;13;Sunnuntai;2;2;4;2;5;7
293;22.01.2017;2017;01;14;Sunnuntai;0;8;8;4;4;8
293;22.01.2017;2017;01;15;Sunnuntai;1;4;5;3;2;5
293;22.01.2017;2017;01;16;Sunnuntai;2;3;5;4;3;7
293;22.01.2017;2017;01;17;Sunnuntai;1;4;5;0;4;4
293;22.01.2017;2017;01;18;Sunnuntai;3;4;7;2;1;3
293;22.01.2017;2017;01;19;Sunnuntai;1;1;2;1;1;2
293;22.01.2017;2017;01;20;Sunnuntai;4;1;5;0;3;3
293;22.01.2017;2017;01;21;Sunnuntai;1;1;2;0;1;1
293;22.01.2017;2017;01;22;Sunnuntai;2;1;3;0;0;0
293;22.01.2017;2017;01;23;Sunnuntai;0;0;0;0;0;0
293;23.01.2017;2017;01;00;Maanantai;0;0;0;0;0;0
293;23.01.2017;2017;01;01;Maanantai;0;0;0;0;0;0
293;23.01.2017;2017;01;02;Maanantai;0;0;0;0;0;0
293;23.01.2017;2017;01;03;Maanantai;0;0;0;0;0;0
293;23.01.2017;2017;01;04;Maanantai;0;0;0;0;0;0
293;23.01.2017;2017;01;05;Maanantai;0;1;1;0;0;0
293;23.01.2017;2017;01;06;Maanantai;9;0;9;2;0;2
293;23.01.2017;2017;01;07;Maanantai;85;1;86;14;1;15
293;23.01.2017;2017;01;08;Maanantai;74;5;79;9;3;12
293;23.01.2017;2017;01;09;Maanantai;17;3;20;3;2;5
293;23.01.2017;2017;01;10;Maanantai;9;2;11;5;3;8
293;23.01.2017;2017;01;11;Maanantai;6;2;8;3;5;8
293;23.01.2017;2017;01;12;Maanantai;2;10;12;3;8;11
293;23.01.2017;2017;01;13;Maanantai;5;33;38;3;6;9
293;23.01.2017;2017;01;14;Maanantai;8;55;63;2;9;11
293;23.01.2017;2017;01;15;Maanantai;5;85;90;3;11;14
293;23.01.2017;2017;01;16;Maanantai;2;14;16;4;4;8
293;23.01.2017;2017;01;17;Maanantai;2;7;9;3;3;6
293;23.01.2017;2017;01;18;Maanantai;3;2;5;5;2;7
293;23.01.2017;2017;01;19;Maanantai;4;3;7;4;3;7
293;23.01.2017;2017;01;20;Maanantai;0;2;2;2;5;7
293;23.01.2017;2017;01;21;Maanantai;3;3;6;0;0;0
293;23.01.2017;2017;01;22;Maanantai;0;0;0;1;1;2
293;23.01.2017;2017;01;23;Maanantai;1;0;1;0;0;0
293;24.01.2017;2017;01;00;Tiistai;0;0;0;0;0;0
293;24.01.2017;2017;01;01;Tiistai;0;0;0;0;0;0
293;24.01.2017;2017;01;02;Tiistai;0;0;0;0;0;0
293;24.01.2017;2017;01;03;Tiistai;1;0;1;0;0;0
293;24.01.2017;2017;01;04;Tiistai;0;0;0;0;0;0
293;24.01.2017;2017;01;05;Tiistai;2;1;3;0;0;0
293;24.01.2017;2017;01;06;Tiistai;4;1;5;3;1;4
293;24.01.2017;2017;01;07;Tiistai;45;4;49;8;1;9
293;24.01.2017;2017;01;08;Tiistai;61;2;63;6;1;7
293;24.01.2017;2017;01;09;Tiistai;49;1;50;3;2;5
293;24.01.2017;2017;01;10;Tiistai;17;1;18;3;3;6
293;24.01.2017;2017;01;11;Tiistai;6;3;9;3;1;4
293;24.01.2017;2017;01;12;Tiistai;1;4;5;5;7;12
293;24.01.2017;2017;01;13;Tiistai;2;15;17;1;3;4
293;24.01.2017;2017;01;14;Tiistai;6;49;55;7;8;15
293;24.01.2017;2017;01;15;Tiistai;3;78;81;2;14;16
293;24.01.2017;2017;01;16;Tiistai;4;14;18;2;1;3
293;24.01.2017;2017;01;17;Tiistai;0;7;7;7;3;10
293;24.01.2017;2017;01;18;Tiistai;1;2;3;2;5;7
293;24.01.2017;2017;01;19;Tiistai;1;2;3;2;3;5
293;24.01.2017;2017;01;20;Tiistai;1;1;2;0;1;1
293;24.01.2017;2017;01;21;Tiistai;0;1;1;0;0;0
293;24.01.2017;2017;01;22;Tiistai;0;0;0;0;0;0
293;24.01.2017;2017;01;23;Tiistai;0;0;0;0;0;0
293;25.01.2017;2017;01;00;Keskiviikko;0;0;0;0;0;0
293;25.01.2017;2017;01;01;Keskiviikko;0;0;0;0;0;0
293;25.01.2017;2017;01;02;Keskiviikko;1;0;1;0;0;0
293;25.01.2017;2017;01;03;Keskiviikko;0;0;0;0;0;0
293;25.01.2017;2017;01;04;Keskiviikko;0;0;0;0;0;0
293;25.01.2017;2017;01;05;Keskiviikko;1;0;1;0;0;0
293;25.01.2017;2017;01;06;Keskiviikko;5;2;7;1;1;2
293;25.01.2017;2017;01;07;Keskiviikko;79;3;82;10;2;12
293;25.01.2017;2017;01;08;Keskiviikko;72;2;74;4;1;5
293;25.01.2017;2017;01;09;Keskiviikko;20;4;24;9;1;10
293;25.01.2017;2017;01;10;Keskiviikko;8;0;8;3;3;6
293;25.01.2017;2017;01;11;Keskiviikko;4;3;7;7;2;9
293;25.01.2017;2017;01;12;Keskiviikko;0;11;11;5;8;13
293;25.01.2017;2017;01;13;Keskiviikko;2;18;20;4;6;10
293;25.01.2017;2017;01;14;Keskiviikko;4;109;113;2;18;20
293;25.01.2017;2017;01;15;Keskiviikko;8;22;30;2;5;7
293;25.01.2017;2017;01;16;Keskiviikko;2;12;14;3;4;7
293;25.01.2017;2017;01;17;Keskiviikko;2;5;7;7;1;8
293;25.01.2017;2017;01;18;Keskiviikko;4;4;8;0;4;4
293;25.01.2017;2017;01;19;Keskiviikko;4;4;8;2;3;5
293;25.01.2017;2017;01;20;Keskiviikko;0;1;1;2;2;4
293;25.01.2017;2017;01;21;Keskiviikko;0;3;3;0;1;1
293;25.01.2017;2017;01;22;Keskiviikko;2;0;2;0;0;0
293;25.01.2017;2017;01;23;Keskiviikko;0;2;2;0;0;0
293;26.01.2017;2017;01;00;Torstai;0;0;0;0;0;0
293;26.01.2017;2017;01;01;Torstai;0;0;0;0;0;0
293;26.01.2017;2017;01;02;Torstai;0;0;0;0;0;0
293;26.01.2017;2017;01;03;Torstai;1;0;1;0;0;0
293;26.01.2017;2017;01;04;Torstai;0;0;0;0;0;0
293;26.01.2017;2017;01;05;Torstai;0;0;0;0;0;0
293;26.01.2017;2017;01;06;Torstai;10;2;12;1;0;1
293;26.01.2017;2017;01;07;Torstai;87;4;91;10;1;11
293;26.01.2017;2017;01;08;Torstai;65;3;68;7;2;9
293;26.01.2017;2017;01;09;Torstai;15;6;21;9;0;9
293;26.01.2017;2017;01;10;Torstai;10;2;12;5;3;8
293;26.01.2017;2017;01;11;Torstai;2;7;9;1;6;7
293;26.01.2017;2017;01;12;Torstai;5;6;11;5;8;13
293;26.01.2017;2017;01;13;Torstai;1;30;31;3;3;6
293;26.01.2017;2017;01;14;Torstai;7;73;80;3;16;19
293;26.01.2017;2017;01;15;Torstai;8;55;63;1;7;8
293;26.01.2017;2017;01;16;Torstai;3;11;14;9;3;12
293;26.01.2017;2017;01;17;Torstai;6;5;11;4;4;8
293;26.01.2017;2017;01;18;Torstai;4;2;6;6;9;15
293;26.01.2017;2017;01;19;Torstai;6;6;12;2;3;5
293;26.01.2017;2017;01;20;Torstai;2;7;9;0;3;3
293;26.01.2017;2017;01;21;Torstai;1;1;2;0;0;0
293;26.01.2017;2017;01;22;Torstai;0;0;0;3;0;3
293;26.01.2017;2017;01;23;Torstai;0;0;0;0;1;1
293;27.01.2017;2017;01;00;Perjantai;0;0;0;0;0;0
293;27.01.2017;2017;01;01;Perjantai;0;0;0;0;0;0
293;27.01.2017;2017;01;02;Perjantai;0;0;0;0;0;0
293;27.01.2017;2017;01;03;Perjantai;0;0;0;0;0;0
293;27.01.2017;2017;01;04;Perjantai;0;1;1;0;0;0
293;27.01.2017;2017;01;05;Perjantai;1;0;1;0;0;0
293;27.01.2017;2017;01;06;Perjantai;6;1;7;2;0;2
293;27.01.2017;2017;01;07;Perjantai;51;2;53;12;1;13
293;27.01.2017;2017;01;08;Perjantai;66;5;71;6;0;6
293;27.01.2017;2017;01;09;Perjantai;25;3;28;7;0;7
293;27.01.2017;2017;01;10;Perjantai;18;3;21;5;3;8
293;27.01.2017;2017;01;11;Perjantai;16;4;20;6;1;7
293;27.01.2017;2017;01;12;Perjantai;8;17;25;7;10;17
293;27.01.2017;2017;01;13;Perjantai;7;33;40;3;5;8
293;27.01.2017;2017;01;14;Perjantai;5;103;108;6;11;17
293;27.01.2017;2017;01;15;Perjantai;4;26;30;2;6;8
293;27.01.2017;2017;01;16;Perjantai;7;4;11;3;1;4
293;27.01.2017;2017;01;17;Perjantai;9;5;14;5;2;7
293;27.01.2017;2017;01;18;Perjantai;4;3;7;4;3;7
293;27.01.2017;2017;01;19;Perjantai;0;10;10;2;2;4
293;27.01.2017;2017;01;20;Perjantai;0;10;10;7;5;12
293;27.01.2017;2017;01;21;Perjantai;1;3;4;4;2;6
293;27.01.2017;2017;01;22;Perjantai;0;0;0;1;0;1
293;27.01.2017;2017;01;23;Perjantai;0;0;0;0;2;2
293;28.01.2017;2017;01;00;Lauantai;0;0;0;1;0;1
293;28.01.2017;2017;01;01;Lauantai;0;1;1;0;0;0
293;28.01.2017;2017;01;02;Lauantai;1;0;1;0;0;0
293;28.01.2017;2017;01;03;Lauantai;0;0;0;0;1;1
293;28.01.2017;2017;01;04;Lauantai;0;0;0;0;0;0
293;28.01.2017;2017;01;05;Lauantai;0;1;1;1;1;2
293;28.01.2017;2017;01;06;Lauantai;2;0;2;1;0;1
293;28.01.2017;2017;01;07;Lauantai;1;0;1;1;0;1
293;28.01.2017;2017;01;08;Lauantai;3;1;4;2;2;4
293;28.01.2017;2017;01;09;Lauantai;2;4;6;6;3;9
293;28.01.2017;2017;01;10;Lauantai;10;4;14;5;4;9
293;28.01.2017;2017;01;11;Lauantai;4;2;6;9;6;15
293;28.01.2017;2017;01;12;Lauantai;4;4;8;10;7;17
293;28.01.2017;2017;01;13;Lauantai;7;7;14;3;10;13
293;28.01.2017;2017;01;14;Lauantai;6;7;13;6;4;10
293;28.01.2017;2017;01;15;Lauantai;10;7;17;6;1;7
293;28.01.2017;2017;01;16;Lauantai;4;5;9;6;4;10
293;28.01.2017;2017;01;17;Lauantai;9;5;14;4;6;10
293;28.01.2017;2017;01;18;Lauantai;5;4;9;1;2;3
293;28.01.2017;2017;01;19;Lauantai;0;3;3;2;5;7
293;28.01.2017;2017;01;20;Lauantai;3;4;7;2;2;4
293;28.01.2017;2017;01;21;Lauantai;0;1;1;2;0;2
293;28.01.2017;2017;01;22;Lauantai;0;0;0;0;0;0
293;28.01.2017;2017;01;23;Lauantai;0;0;0;0;0;0
293;29.01.2017;2017;01;00;Sunnuntai;0;1;1;0;2;2
293;29.01.2017;2017;01;01;Sunnuntai;0;0;0;0;1;1
293;29.01.2017;2017;01;02;Sunnuntai;0;1;1;0;2;2
293;29.01.2017;2017;01;03;Sunnuntai;0;0;0;0;7;7
293;29.01.2017;2017;01;04;Sunnuntai;0;0;0;0;0;0
293;29.01.2017;2017;01;05;Sunnuntai;0;0;0;2;1;3
293;29.01.2017;2017;01;06;Sunnuntai;1;0;1;0;1;1
293;29.01.2017;2017;01;07;Sunnuntai;1;0;1;1;2;3
293;29.01.2017;2017;01;08;Sunnuntai;2;0;2;2;0;2
293;29.01.2017;2017;01;09;Sunnuntai;9;0;9;10;3;13
293;29.01.2017;2017;01;10;Sunnuntai;2;3;5;6;10;16
293;29.01.2017;2017;01;11;Sunnuntai;2;10;12;2;7;9
293;29.01.2017;2017;01;12;Sunnuntai;7;6;13;4;4;8
293;29.01.2017;2017;01;13;Sunnuntai;4;5;9;17;5;22
293;29.01.2017;2017;01;14;Sunnuntai;5;6;11;6;8;14
293;29.01.2017;2017;01;15;Sunnuntai;1;3;4;6;10;16
293;29.01.2017;2017;01;16;Sunnuntai;3;5;8;2;5;7
293;29.01.2017;2017;01;17;Sunnuntai;4;2;6;5;1;6
293;29.01.2017;2017;01;18;Sunnuntai;1;4;5;2;5;7
293;29.01.2017;2017;01;19;Sunnuntai;3;4;7;4;2;6
293;29.01.2017;2017;01;20;Sunnuntai;0;1;1;1;5;6
293;29.01.2017;2017;01;21;Sunnuntai;0;0;0;0;0;0
293;29.01.2017;2017;01;22;Sunnuntai;0;0;0;0;0;0
293;29.01.2017;2017;01;23;Sunnuntai;0;0;0;0;0;0
293;30.01.2017;2017;01;00;Maanantai;0;0;0;0;0;0
293;30.01.2017;2017;01;01;Maanantai;0;0;0;0;0;0
293;30.01.2017;2017;01;02;Maanantai;0;0;0;0;0;0
293;30.01.2017;2017;01;03;Maanantai;0;0;0;0;0;0
293;30.01.2017;2017;01;04;Maanantai;0;0;0;0;0;0
293;30.01.2017;2017;01;05;Maanantai;1;0;1;0;0;0
293;30.01.2017;2017;01;06;Maanantai;3;2;5;1;0;1
293;30.01.2017;2017;01;07;Maanantai;72;4;76;9;2;11
293;30.01.2017;2017;01;08;Maanantai;56;7;63;9;1;10
293;30.01.2017;2017;01;09;Maanantai;15;2;17;3;0;3
293;30.01.2017;2017;01;10;Maanantai;8;0;8;5;1;6
293;30.01.2017;2017;01;11;Maanantai;4;2;6;1;0;1
293;30.01.2017;2017;01;12;Maanantai;3;7;10;10;0;10
293;30.01.2017;2017;01;13;Maanantai;4;32;36;3;7;10
293;30.01.2017;2017;01;14;Maanantai;2;46;48;6;8;14
293;30.01.2017;2017;01;15;Maanantai;5;54;59;3;11;14
293;30.01.2017;2017;01;16;Maanantai;7;8;15;2;5;7
293;30.01.2017;2017;01;17;Maanantai;4;11;15;8;10;18
293;30.01.2017;2017;01;18;Maanantai;3;2;5;3;6;9
293;30.01.2017;2017;01;19;Maanantai;5;5;10;2;2;4
293;30.01.2017;2017;01;20;Maanantai;2;7;9;2;3;5
293;30.01.2017;2017;01;21;Maanantai;0;3;3;2;4;6
293;30.01.2017;2017;01;22;Maanantai;0;0;0;0;0;0
293;30.01.2017;2017;01;23;Maanantai;2;0;2;4;0;4
293;31.01.2017;2017;01;00;Tiistai;0;0;0;0;0;0
293;31.01.2017;2017;01;01;Tiistai;0;0;0;0;0;0
293;31.01.2017;2017;01;02;Tiistai;0;0;0;0;0;0
293;31.01.2017;2017;01;03;Tiistai;0;0;0;0;0;0
293;31.01.2017;2017;01;04;Tiistai;0;0;0;0;0;0
293;31.01.2017;2017;01;05;Tiistai;2;1;3;0;1;1
293;31.01.2017;2017;01;06;Tiistai;8;2;10;3;1;4
293;31.01.2017;2017;01;07;Tiistai;45;2;47;9;0;9
293;31.01.2017;2017;01;08;Tiistai;71;6;77;7;3;10
293;31.01.2017;2017;01;09;Tiistai;32;3;35;5;4;9
293;31.01.2017;2017;01;10;Tiistai;18;2;20;5;5;10
293;31.01.2017;2017;01;11;Tiistai;3;9;12;3;3;6
293;31.01.2017;2017;01;12;Tiistai;8;4;12;10;5;15
293;31.01.2017;2017;01;13;Tiistai;6;18;24;6;11;17
293;31.01.2017;2017;01;14;Tiistai;3;40;43;4;9;13
293;31.01.2017;2017;01;15;Tiistai;11;75;86;5;16;21
293;31.01.2017;2017;01;16;Tiistai;12;10;22;2;6;8
293;31.01.2017;2017;01;17;Tiistai;4;12;16;5;6;11
293;31.01.2017;2017;01;18;Tiistai;0;3;3;6;3;9
293;31.01.2017;2017;01;19;Tiistai;5;4;9;3;7;10
293;31.01.2017;2017;01;20;Tiistai;4;6;10;0;3;3
293;31.01.2017;2017;01;21;Tiistai;1;3;4;0;0;0
293;31.01.2017;2017;01;22;Tiistai;0;1;1;1;1;2
293;31.01.2017;2017;01;23;Tiistai;0;0;0;1;0;1
293;01.02.2017;2017;02;00;Keskiviikko;2;0;2;0;0;0
293;01.02.2017;2017;02;01;Keskiviikko;0;0;0;0;0;0
293;01.02.2017;2017;02;02;Keskiviikko;0;0;0;0;0;0
293;01.02.2017;2017;02;03;Keskiviikko;0;0;0;0;0;0
293;01.02.2017;2017;02;04;Keskiviikko;0;0;0;0;0;0
293;01.02.2017;2017;02;05;Keskiviikko;0;0;0;0;0;0
293;01.02.2017;2017;02;06;Keskiviikko;8;2;10;3;0;3
293;01.02.2017;2017;02;07;Keskiviikko;70;5;75;6;0;6
293;01.02.2017;2017;02;08;Keskiviikko;75;2;77;7;3;10
293;01.02.2017;2017;02;09;Keskiviikko;21;7;28;5;1;6
293;01.02.2017;2017;02;10;Keskiviikko;8;2;10;5;1;6
293;01.02.2017;2017;02;11;Keskiviikko;1;8;9;6;1;7
293;01.02.2017;2017;02;12;Keskiviikko;2;13;15;2;2;4
293;01.02.2017;2017;02;13;Keskiviikko;4;21;25;8;7;15
293;01.02.2017;2017;02;14;Keskiviikko;5;102;107;2;15;17
293;01.02.2017;2017;02;15;Keskiviikko;5;14;19;3;8;11
293;01.02.2017;2017;02;16;Keskiviikko;5;12;17;9;5;14
293;01.02.2017;2017;02;17;Keskiviikko;1;8;9;3;6;9
293;01.02.2017;2017;02;18;Keskiviikko;5;6;11;4;5;9
293;01.02.2017;2017;02;19;Keskiviikko;6;2;8;8;16;24
293;01.02.2017;2017;02;20;Keskiviikko;3;5;8;1;1;2
293;01.02.2017;2017;02;21;Keskiviikko;0;6;6;1;2;3
293;01.02.2017;2017;02;22;Keskiviikko;3;1;4;0;0;0
293;01.02.2017;2017;02;23;Keskiviikko;0;0;0;0;0;0
293;02.02.2017;2017;02;00;Torstai;0;0;0;0;0;0
293;02.02.2017;2017;02;01;Torstai;0;0;0;0;0;0
293;02.02.2017;2017;02;02;Torstai;0;0;0;0;0;0
293;02.02.2017;2017;02;03;Torstai;0;0;0;0;0;0
293;02.02.2017;2017;02;04;Torstai;0;1;1;0;0;0
293;02.02.2017;2017;02;05;Torstai;0;0;0;1;0;1
293;02.02.2017;2017;02;06;Torstai;8;3;11;2;0;2
293;02.02.2017;2017;02;07;Torstai;81;3;84;6;2;8
293;02.02.2017;2017;02;08;Torstai;77;4;81;4;1;5
293;02.02.2017;2017;02;09;Torstai;10;2;12;7;2;9
293;02.02.2017;2017;02;10;Torstai;4;3;7;2;3;5
293;02.02.2017;2017;02;11;Torstai;0;6;6;5;2;7
293;02.02.2017;2017;02;12;Torstai;1;11;12;2;10;12
293;02.02.2017;2017;02;13;Torstai;4;31;35;0;7;7
293;02.02.2017;2017;02;14;Torstai;5;50;55;4;15;19
293;02.02.2017;2017;02;15;Torstai;4;53;57;3;7;10
293;02.02.2017;2017;02;16;Torstai;3;9;12;5;2;7
293;02.02.2017;2017;02;17;Torstai;1;7;8;8;5;13
293;02.02.2017;2017;02;18;Torstai;3;2;5;4;1;5
293;02.02.2017;2017;02;19;Torstai;1;1;2;6;1;7
293;02.02.2017;2017;02;20;Torstai;5;3;8;0;3;3
293;02.02.2017;2017;02;21;Torstai;0;2;2;1;1;2
293;02.02.2017;2017;02;22;Torstai;0;0;0;4;0;4
293;02.02.2017;2017;02;23;Torstai;0;0;0;1;1;2
293;03.02.2017;2017;02;00;Perjantai;0;0;0;0;0;0
293;03.02.2017;2017;02;01;Perjantai;0;0;0;0;0;0
293;03.02.2017;2017;02;02;Perjantai;0;0;0;0;0;0
293;03.02.2017;2017;02;03;Perjantai;0;0;0;0;0;0
293;03.02.2017;2017;02;04;Perjantai;0;0;0;0;0;0
293;03.02.2017;2017;02;05;Perjantai;1;0;1;0;0;0
293;03.02.2017;2017;02;06;Perjantai;5;1;6;1;0;1
293;03.02.2017;2017;02;07;Perjantai;53;3;56;10;3;13
293;03.02.2017;2017;02;08;Perjantai;79;4;83;2;0;2
293;03.02.2017;2017;02;09;Perjantai;18;2;20;9;1;10
293;03.02.2017;2017;02;10;Perjantai;14;2;16;4;1;5
293;03.02.2017;2017;02;11;Perjantai;1;5;6;7;5;12
293;03.02.2017;2017;02;12;Perjantai;4;23;27;1;5;6
293;03.02.2017;2017;02;13;Perjantai;3;34;37;8;4;12
293;03.02.2017;2017;02;14;Perjantai;9;50;59;4;6;10
293;03.02.2017;2017;02;15;Perjantai;8;39;47;3;14;17
293;03.02.2017;2017;02;16;Perjantai;6;9;15;8;5;13
293;03.02.2017;2017;02;17;Perjantai;4;6;10;5;8;13
293;03.02.2017;2017;02;18;Perjantai;3;11;14;6;8;14
293;03.02.2017;2017;02;19;Perjantai;6;11;17;2;1;3
293;03.02.2017;2017;02;20;Perjantai;6;5;11;3;1;4
293;03.02.2017;2017;02;21;Perjantai;2;4;6;2;4;6
293;03.02.2017;2017;02;22;Perjantai;0;0;0;0;0;0
293;03.02.2017;2017;02;23;Perjantai;8;1;9;0;1;1
293;04.02.2017;2017;02;00;Lauantai;2;1;3;0;0;0
293;04.02.2017;2017;02;01;Lauantai;0;1;1;0;2;2
293;04.02.2017;2017;02;02;Lauantai;0;0;0;0;1;1
293;04.02.2017;2017;02;03;Lauantai;1;0;1;1;0;1
293;04.02.2017;2017;02;04;Lauantai;0;0;0;1;0;1
293;04.02.2017;2017;02;05;Lauantai;0;1;1;0;0;0
293;04.02.2017;2017;02;06;Lauantai;2;0;2;2;1;3
293;04.02.2017;2017;02;07;Lauantai;1;0;1;1;2;3
293;04.02.2017;2017;02;08;Lauantai;4;0;4;3;1;4
293;04.02.2017;2017;02;09;Lauantai;3;3;6;7;1;8
293;04.02.2017;2017;02;10;Lauantai;3;3;6;8;5;13
293;04.02.2017;2017;02;11;Lauantai;5;2;7;4;8;12
293;04.02.2017;2017;02;12;Lauantai;5;4;9;5;5;10
293;04.02.2017;2017;02;13;Lauantai;8;3;11;8;1;9
293;04.02.2017;2017;02;14;Lauantai;8;7;15;6;7;13
293;04.02.2017;2017;02;15;Lauantai;5;4;9;2;4;6
293;04.02.2017;2017;02;16;Lauantai;2;4;6;3;3;6
293;04.02.2017;2017;02;17;Lauantai;3;8;11;4;6;10
293;04.02.2017;2017;02;18;Lauantai;0;9;9;1;5;6
293;04.02.2017;2017;02;19;Lauantai;10;1;11;2;0;2
293;04.02.2017;2017;02;20;Lauantai;3;6;9;1;2;3
293;04.02.2017;2017;02;21;Lauantai;0;3;3;0;1;1
293;04.02.2017;2017;02;22;Lauantai;1;0;1;0;0;0
293;04.02.2017;2017;02;23;Lauantai;2;0;2;0;0;0
293;05.02.2017;2017;02;00;Sunnuntai;1;2;3;0;2;2
293;05.02.2017;2017;02;01;Sunnuntai;0;0;0;0;1;1
293;05.02.2017;2017;02;02;Sunnuntai;0;1;1;0;1;1
293;05.02.2017;2017;02;03;Sunnuntai;0;0;0;0;0;0
293;05.02.2017;2017;02;04;Sunnuntai;0;0;0;0;0;0
293;05.02.2017;2017;02;05;Sunnuntai;0;0;0;1;0;1
293;05.02.2017;2017;02;06;Sunnuntai;0;0;0;0;0;0
293;05.02.2017;2017;02;07;Sunnuntai;1;0;1;0;1;1
293;05.02.2017;2017;02;08;Sunnuntai;0;0;0;2;2;4
293;05.02.2017;2017;02;09;Sunnuntai;11;1;12;5;5;10
293;05.02.2017;2017;02;10;Sunnuntai;6;1;7;5;3;8
293;05.02.2017;2017;02;11;Sunnuntai;1;10;11;4;9;13
293;05.02.2017;2017;02;12;Sunnuntai;3;8;11;6;7;13
293;05.02.2017;2017;02;13;Sunnuntai;3;5;8;6;6;12
293;05.02.2017;2017;02;14;Sunnuntai;8;5;13;8;7;15
293;05.02.2017;2017;02;15;Sunnuntai;5;7;12;2;6;8
293;05.02.2017;2017;02;16;Sunnuntai;1;2;3;4;4;8
293;05.02.2017;2017;02;17;Sunnuntai;0;1;1;2;3;5
293;05.02.2017;2017;02;18;Sunnuntai;7;4;11;5;5;10
293;05.02.2017;2017;02;19;Sunnuntai;0;4;4;3;1;4
293;05.02.2017;2017;02;20;Sunnuntai;3;2;5;0;3;3
293;05.02.2017;2017;02;21;Sunnuntai;1;1;2;1;2;3
293;05.02.2017;2017;02;22;Sunnuntai;0;0;0;0;1;1
293;05.02.2017;2017;02;23;Sunnuntai;1;0;1;0;0;0
293;06.02.2017;2017;02;00;Maanantai;0;0;0;0;0;0
293;06.02.2017;2017;02;01;Maanantai;0;0;0;0;0;0
293;06.02.2017;2017;02;02;Maanantai;0;0;0;0;0;0
293;06.02.2017;2017;02;03;Maanantai;0;1;1;0;0;0
293;06.02.2017;2017;02;04;Maanantai;0;0;0;0;0;0
293;06.02.2017;2017;02;05;Maanantai;2;1;3;0;0;0
293;06.02.2017;2017;02;06;Maanantai;7;1;8;3;0;3
293;06.02.2017;2017;02;07;Maanantai;62;1;63;6;1;7
293;06.02.2017;2017;02;08;Maanantai;80;6;86;6;4;10
293;06.02.2017;2017;02;09;Maanantai;20;2;22;6;0;6
293;06.02.2017;2017;02;10;Maanantai;13;11;24;5;5;10
293;06.02.2017;2017;02;11;Maanantai;1;13;14;3;5;8
293;06.02.2017;2017;02;12;Maanantai;5;5;10;12;8;20
293;06.02.2017;2017;02;13;Maanantai;4;36;40;4;15;19
293;06.02.2017;2017;02;14;Maanantai;3;36;39;9;8;17
293;06.02.2017;2017;02;15;Maanantai;7;69;76;3;20;23
293;06.02.2017;2017;02;16;Maanantai;7;10;17;3;3;6
293;06.02.2017;2017;02;17;Maanantai;3;5;8;7;5;12
293;06.02.2017;2017;02;18;Maanantai;4;3;7;6;3;9
293;06.02.2017;2017;02;19;Maanantai;1;3;4;4;4;8
293;06.02.2017;2017;02;20;Maanantai;2;3;5;2;4;6
293;06.02.2017;2017;02;21;Maanantai;1;1;2;0;1;1
293;06.02.2017;2017;02;22;Maanantai;2;0;2;0;0;0
293;06.02.2017;2017;02;23;Maanantai;0;0;0;0;0;0
293;07.02.2017;2017;02;00;Tiistai;0;0;0;0;0;0
293;07.02.2017;2017;02;01;Tiistai;0;0;0;0;0;0
293;07.02.2017;2017;02;02;Tiistai;0;0;0;0;0;0
293;07.02.2017;2017;02;03;Tiistai;1;0;1;0;0;0
293;07.02.2017;2017;02;04;Tiistai;0;0;0;0;0;0
293;07.02.2017;2017;02;05;Tiistai;1;1;2;0;0;0
293;07.02.2017;2017;02;06;Tiistai;7;3;10;0;0;0
293;07.02.2017;2017;02;07;Tiistai;55;2;57;9;0;9
293;07.02.2017;2017;02;08;Tiistai;75;6;81;6;2;8
293;07.02.2017;2017;02;09;Tiistai;42;6;48;5;3;8
293;07.02.2017;2017;02;10;Tiistai;14;2;16;3;5;8
293;07.02.2017;2017;02;11;Tiistai;7;12;19;9;4;13
293;07.02.2017;2017;02;12;Tiistai;0;7;7;3;5;8
293;07.02.2017;2017;02;13;Tiistai;2;25;27;6;6;12
293;07.02.2017;2017;02;14;Tiistai;3;44;47;7;7;14
293;07.02.2017;2017;02;15;Tiistai;12;80;92;7;18;25
293;07.02.2017;2017;02;16;Tiistai;7;14;21;3;7;10
293;07.02.2017;2017;02;17;Tiistai;4;12;16;8;8;16
293;07.02.2017;2017;02;18;Tiistai;4;2;6;5;5;10
293;07.02.2017;2017;02;19;Tiistai;1;1;2;3;5;8
293;07.02.2017;2017;02;20;Tiistai;0;1;1;4;4;8
293;07.02.2017;2017;02;21;Tiistai;0;3;3;0;1;1
293;07.02.2017;2017;02;22;Tiistai;0;0;0;0;0;0
293;07.02.2017;2017;02;23;Tiistai;0;0;0;0;0;0
293;08.02.2017;2017;02;00;Keskiviikko;1;0;1;0;0;0
293;08.02.2017;2017;02;01;Keskiviikko;0;0;0;0;0;0
293;08.02.2017;2017;02;02;Keskiviikko;0;0;0;0;0;0
293;08.02.2017;2017;02;03;Keskiviikko;0;0;0;0;0;0
293;08.02.2017;2017;02;04;Keskiviikko;0;0;0;0;0;0
293;08.02.2017;2017;02;05;Keskiviikko;1;0;1;0;0;0
293;08.02.2017;2017;02;06;Keskiviikko;4;1;5;0;0;0
293;08.02.2017;2017;02;07;Keskiviikko;48;4;52;10;0;10
293;08.02.2017;2017;02;08;Keskiviikko;65;2;67;6;2;8
293;08.02.2017;2017;02;09;Keskiviikko;13;1;14;3;1;4
293;08.02.2017;2017;02;10;Keskiviikko;9;3;12;8;0;8
293;08.02.2017;2017;02;11;Keskiviikko;2;5;7;5;6;11
293;08.02.2017;2017;02;12;Keskiviikko;1;5;6;5;8;13
293;08.02.2017;2017;02;13;Keskiviikko;11;22;33;6;6;12
293;08.02.2017;2017;02;14;Keskiviikko;5;70;75;4;13;17
293;08.02.2017;2017;02;15;Keskiviikko;2;14;16;7;5;12
293;08.02.2017;2017;02;16;Keskiviikko;4;15;19;6;3;9
293;08.02.2017;2017;02;17;Keskiviikko;4;4;8;4;2;6
293;08.02.2017;2017;02;18;Keskiviikko;3;6;9;1;5;6
293;08.02.2017;2017;02;19;Keskiviikko;2;4;6;0;5;5
293;08.02.2017;2017;02;20;Keskiviikko;2;3;5;1;0;1
293;08.02.2017;2017;02;21;Keskiviikko;1;2;3;0;2;2
293;08.02.2017;2017;02;22;Keskiviikko;0;0;0;1;0;1
293;08.02.2017;2017;02;23;Keskiviikko;2;0;2;0;0;0
293;09.02.2017;2017;02;00;Torstai;0;0;0;0;0;0
293;09.02.2017;2017;02;01;Torstai;0;0;0;0;0;0
293;09.02.2017;2017;02;02;Torstai;0;0;0;0;0;0
293;09.02.2017;2017;02;03;Torstai;0;0;0;0;0;0
293;09.02.2017;2017;02;04;Torstai;0;0;0;0;0;0
293;09.02.2017;2017;02;05;Torstai;1;0;1;0;0;0
293;09.02.2017;2017;02;06;Torstai;3;3;6;1;1;2
293;09.02.2017;2017;02;07;Torstai;45;3;48;4;0;4
293;09.02.2017;2017;02;08;Torstai;63;1;64;7;0;7
293;09.02.2017;2017;02;09;Torstai;10;1;11;7;6;13
293;09.02.2017;2017;02;10;Torstai;7;3;10;2;2;4
293;09.02.2017;2017;02;11;Torstai;5;6;11;9;6;15
293;09.02.2017;2017;02;12;Torstai;6;3;9;7;6;13
293;09.02.2017;2017;02;13;Torstai;3;30;33;3;8;11
293;09.02.2017;2017;02;14;Torstai;3;41;44;3;7;10
293;09.02.2017;2017;02;15;Torstai;7;46;53;7;6;13
293;09.02.2017;2017;02;16;Torstai;2;12;14;2;6;8
293;09.02.2017;2017;02;17;Torstai;1;3;4;4;9;13
293;09.02.2017;2017;02;18;Torstai;6;5;11;2;4;6
293;09.02.2017;2017;02;19;Torstai;5;6;11;4;4;8
293;09.02.2017;2017;02;20;Torstai;1;5;6;2;1;3
293;09.02.2017;2017;02;21;Torstai;1;0;1;0;1;1
293;09.02.2017;2017;02;22;Torstai;1;0;1;0;0;0
293;09.02.2017;2017;02;23;Torstai;0;0;0;0;0;0
293;10.02.2017;2017;02;00;Perjantai;0;0;0;0;0;0
293;10.02.2017;2017;02;01;Perjantai;0;0;0;0;0;0
293;10.02.2017;2017;02;02;Perjantai;0;0;0;0;0;0
293;10.02.2017;2017;02;03;Perjantai;0;0;0;0;0;0
293;10.02.2017;2017;02;04;Perjantai;0;0;0;0;0;0
293;10.02.2017;2017;02;05;Perjantai;2;0;2;0;0;0
293;10.02.2017;2017;02;06;Perjantai;3;1;4;0;0;0
293;10.02.2017;2017;02;07;Perjantai;67;4;71;10;1;11
293;10.02.2017;2017;02;08;Perjantai;68;3;71;5;1;6
293;10.02.2017;2017;02;09;Perjantai;33;2;35;5;2;7
293;10.02.2017;2017;02;10;Perjantai;13;3;16;6;2;8
293;10.02.2017;2017;02;11;Perjantai;4;5;9;7;5;12
293;10.02.2017;2017;02;12;Perjantai;8;18;26;7;9;16
293;10.02.2017;2017;02;13;Perjantai;2;35;37;3;12;15
293;10.02.2017;2017;02;14;Perjantai;2;79;81;2;7;9
293;10.02.2017;2017;02;15;Perjantai;3;33;36;7;8;15
293;10.02.2017;2017;02;16;Perjantai;7;8;15;3;7;10
293;10.02.2017;2017;02;17;Perjantai;4;6;10;4;4;8
293;10.02.2017;2017;02;18;Perjantai;9;4;13;6;3;9
293;10.02.2017;2017;02;19;Perjantai;2;7;9;0;8;8
293;10.02.2017;2017;02;20;Perjantai;3;5;8;1;1;2
293;10.02.2017;2017;02;21;Perjantai;1;1;2;0;1;1
293;10.02.2017;2017;02;22;Perjantai;2;2;4;0;1;1
293;10.02.2017;2017;02;23;Perjantai;1;1;2;0;1;1
293;11.02.2017;2017;02;00;Lauantai;0;0;0;1;0;1
293;11.02.2017;2017;02;01;Lauantai;0;0;0;1;0;1
293;11.02.2017;2017;02;02;Lauantai;0;0;0;0;0;0
293;11.02.2017;2017;02;03;Lauantai;0;0;0;1;0;1
293;11.02.2017;2017;02;04;Lauantai;0;0;0;0;0;0
293;11.02.2017;2017;02;05;Lauantai;0;0;0;2;0;2
293;11.02.2017;2017;02;06;Lauantai;0;0;0;0;2;2
293;11.02.2017;2017;02;07;Lauantai;2;0;2;0;0;0
293;11.02.2017;2017;02;08;Lauantai;2;1;3;1;0;1
293;11.02.2017;2017;02;09;Lauantai;11;3;14;5;4;9
293;11.02.2017;2017;02;10;Lauantai;8;5;13;10;9;19
293;11.02.2017;2017;02;11;Lauantai;3;5;8;8;34;42
293;11.02.2017;2017;02;12;Lauantai;4;4;8;10;8;18
293;11.02.2017;2017;02;13;Lauantai;14;5;19;8;11;19
293;11.02.2017;2017;02;14;Lauantai;7;4;11;4;8;12
293;11.02.2017;2017;02;15;Lauantai;8;11;19;3;5;8
293;11.02.2017;2017;02;16;Lauantai;2;4;6;2;5;7
293;11.02.2017;2017;02;17;Lauantai;12;3;15;8;5;13
293;11.02.2017;2017;02;18;Lauantai;4;7;11;3;8;11
293;11.02.2017;2017;02;19;Lauantai;3;5;8;3;1;4
293;11.02.2017;2017;02;20;Lauantai;3;4;7;0;3;3
293;11.02.2017;2017;02;21;Lauantai;2;4;6;0;1;1
293;11.02.2017;2017;02;22;Lauantai;2;2;4;1;0;1
293;11.02.2017;2017;02;23;Lauantai;0;0;0;2;1;3
293;12.02.2017;2017;02;00;Sunnuntai;0;1;1;0;2;2
293;12.02.2017;2017;02;01;Sunnuntai;0;1;1;1;2;3
293;12.02.2017;2017;02;02;Sunnuntai;0;0;0;0;1;1
293;12.02.2017;2017;02;03;Sunnuntai;1;1;2;0;0;0
293;12.02.2017;2017;02;04;Sunnuntai;0;0;0;0;0;0
293;12.02.2017;2017;02;05;Sunnuntai;0;0;0;0;0;0
293;12.02.2017;2017;02;06;Sunnuntai;0;0;0;0;0;0
293;12.02.2017;2017;02;07;Sunnuntai;1;0;1;0;0;0
293;12.02.2017;2017;02;08;Sunnuntai;2;0;2;2;1;3
293;12.02.2017;2017;02;09;Sunnuntai;8;9;17;2;1;3
293;12.02.2017;2017;02;10;Sunnuntai;13;3;16;5;2;7
293;12.02.2017;2017;02;11;Sunnuntai;5;8;13;4;6;10
293;12.02.2017;2017;02;12;Sunnuntai;1;4;5;5;6;11
293;12.02.2017;2017;02;13;Sunnuntai;6;7;13;10;5;15
293;12.02.2017;2017;02;14;Sunnuntai;4;6;10;1;8;9
293;12.02.2017;2017;02;15;Sunnuntai;2;2;4;4;6;10
293;12.02.2017;2017;02;16;Sunnuntai;6;4;10;2;2;4
293;12.02.2017;2017;02;17;Sunnuntai;1;4;5;6;5;11
293;12.02.2017;2017;02;18;Sunnuntai;4;1;5;3;3;6
293;12.02.2017;2017;02;19;Sunnuntai;3;4;7;1;4;5
293;12.02.2017;2017;02;20;Sunnuntai;1;0;1;0;4;4
293;12.02.2017;2017;02;21;Sunnuntai;0;0;0;1;3;4
293;12.02.2017;2017;02;22;Sunnuntai;0;0;0;1;2;3
293;12.02.2017;2017;02;23;Sunnuntai;0;0;0;0;0;0
293;13.02.2017;2017;02;00;Maanantai;0;0;0;0;0;0
293;13.02.2017;2017;02;01;Maanantai;0;0;0;0;0;0
293;13.02.2017;2017;02;02;Maanantai;0;0;0;0;0;0
293;13.02.2017;2017;02;03;Maanantai;0;0;0;0;0;0
293;13.02.2017;2017;02;04;Maanantai;0;0;0;0;0;0
293;13.02.2017;2017;02;05;Maanantai;0;1;1;0;0;0
293;13.02.2017;2017;02;06;Maanantai;5;1;6;1;1;2
293;13.02.2017;2017;02;07;Maanantai;76;3;79;9;1;10
293;13.02.2017;2017;02;08;Maanantai;62;6;68;3;2;5
293;13.02.2017;2017;02;09;Maanantai;21;6;27;3;4;7
293;13.02.2017;2017;02;10;Maanantai;5;4;9;3;0;3
293;13.02.2017;2017;02;11;Maanantai;5;4;9;11;9;20
293;13.02.2017;2017;02;12;Maanantai;12;1;13;6;11;17
293;13.02.2017;2017;02;13;Maanantai;7;35;42;8;8;16
293;13.02.2017;2017;02;14;Maanantai;6;38;44;6;9;15
293;13.02.2017;2017;02;15;Maanantai;10;71;81;2;13;15
293;13.02.2017;2017;02;16;Maanantai;4;12;16;6;5;11
293;13.02.2017;2017;02;17;Maanantai;3;3;6;8;7;15
293;13.02.2017;2017;02;18;Maanantai;4;5;9;7;6;13
293;13.02.2017;2017;02;19;Maanantai;2;5;7;7;3;10
293;13.02.2017;2017;02;20;Maanantai;1;2;3;2;3;5
293;13.02.2017;2017;02;21;Maanantai;1;3;4;0;1;1
293;13.02.2017;2017;02;22;Maanantai;1;1;2;2;2;4
293;13.02.2017;2017;02;23;Maanantai;0;0;0;0;0;0
293;14.02.2017;2017;02;00;Tiistai;0;0;0;0;0;0
293;14.02.2017;2017;02;01;Tiistai;0;0;0;0;0;0
293;14.02.2017;2017;02;02;Tiistai;0;0;0;0;0;0
293;14.02.2017;2017;02;03;Tiistai;0;0;0;0;0;0
293;14.02.2017;2017;02;04;Tiistai;0;0;0;0;0;0
293;14.02.2017;2017;02;05;Tiistai;0;0;0;4;2;6
293;14.02.2017;2017;02;06;Tiistai;6;3;9;1;0;1
293;14.02.2017;2017;02;07;Tiistai;57;2;59;7;1;8
293;14.02.2017;2017;02;08;Tiistai;58;4;62;2;1;3
293;14.02.2017;2017;02;09;Tiistai;57;9;66;4;2;6
293;14.02.2017;2017;02;10;Tiistai;22;3;25;6;3;9
293;14.02.2017;2017;02;11;Tiistai;6;2;8;6;3;9
293;14.02.2017;2017;02;12;Tiistai;3;2;5;6;3;9
293;14.02.2017;2017;02;13;Tiistai;3;15;18;5;5;10
293;14.02.2017;2017;02;14;Tiistai;8;41;49;3;4;7
293;14.02.2017;2017;02;15;Tiistai;6;99;105;0;5;5
293;14.02.2017;2017;02;16;Tiistai;13;27;40;4;5;9
293;14.02.2017;2017;02;17;Tiistai;9;11;20;0;3;3
293;14.02.2017;2017;02;18;Tiistai;3;6;9;6;7;13
293;14.02.2017;2017;02;19;Tiistai;8;2;10;0;5;5
293;14.02.2017;2017;02;20;Tiistai;4;2;6;3;1;4
293;14.02.2017;2017;02;21;Tiistai;0;1;1;1;2;3
293;14.02.2017;2017;02;22;Tiistai;0;0;0;0;0;0
293;14.02.2017;2017;02;23;Tiistai;0;0;0;0;0;0
293;15.02.2017;2017;02;00;Keskiviikko;0;0;0;1;0;1
293;15.02.2017;2017;02;01;Keskiviikko;0;0;0;0;0;0
293;15.02.2017;2017;02;02;Keskiviikko;0;0;0;0;0;0
293;15.02.2017;2017;02;03;Keskiviikko;0;0;0;0;0;0
293;15.02.2017;2017;02;04;Keskiviikko;0;0;0;0;0;0
293;15.02.2017;2017;02;05;Keskiviikko;2;0;2;0;0;0
293;15.02.2017;2017;02;06;Keskiviikko;5;1;6;2;0;2
293;15.02.2017;2017;02;07;Keskiviikko;81;5;86;4;3;7
293;15.02.2017;2017;02;08;Keskiviikko;59;4;63;6;3;9
293;15.02.2017;2017;02;09;Keskiviikko;11;3;14;2;3;5
293;15.02.2017;2017;02;10;Keskiviikko;6;3;9;4;1;5
293;15.02.2017;2017;02;11;Keskiviikko;1;6;7;10;9;19
293;15.02.2017;2017;02;12;Keskiviikko;5;9;14;8;5;13
293;15.02.2017;2017;02;13;Keskiviikko;5;31;36;4;5;9
293;15.02.2017;2017;02;14;Keskiviikko;9;89;98;5;15;20
293;15.02.2017;2017;02;15;Keskiviikko;10;28;38;3;6;9
293;15.02.2017;2017;02;16;Keskiviikko;6;9;15;4;9;13
293;15.02.2017;2017;02;17;Keskiviikko;12;7;19;3;7;10
293;15.02.2017;2017;02;18;Keskiviikko;8;8;16;6;4;10
293;15.02.2017;2017;02;19;Keskiviikko;5;6;11;5;5;10
293;15.02.2017;2017;02;20;Keskiviikko;0;2;2;1;5;6
293;15.02.2017;2017;02;21;Keskiviikko;1;3;4;3;1;4
293;15.02.2017;2017;02;22;Keskiviikko;0;0;0;0;1;1
293;15.02.2017;2017;02;23;Keskiviikko;0;0;0;0;0;0
293;16.02.2017;2017;02;00;Torstai;0;0;0;0;0;0
293;16.02.2017;2017;02;01;Torstai;0;0;0;0;1;1
293;16.02.2017;2017;02;02;Torstai;0;0;0;0;0;0
293;16.02.2017;2017;02;03;Torstai;0;0;0;0;0;0
293;16.02.2017;2017;02;04;Torstai;1;0;1;0;0;0
293;16.02.2017;2017;02;05;Torstai;1;0;1;0;0;0
293;16.02.2017;2017;02;06;Torstai;5;2;7;2;0;2
293;16.02.2017;2017;02;07;Torstai;83;4;87;10;0;10
293;16.02.2017;2017;02;08;Torstai;70;2;72;3;3;6
293;16.02.2017;2017;02;09;Torstai;17;4;21;3;4;7
293;16.02.2017;2017;02;10;Torstai;6;3;9;3;4;7
293;16.02.2017;2017;02;11;Torstai;1;7;8;4;7;11
293;16.02.2017;2017;02;12;Torstai;5;9;14;11;8;19
293;16.02.2017;2017;02;13;Torstai;4;34;38;7;6;13
293;16.02.2017;2017;02;14;Torstai;14;61;75;6;14;20
293;16.02.2017;2017;02;15;Torstai;6;45;51;2;12;14
293;16.02.2017;2017;02;16;Torstai;4;15;19;6;4;10
293;16.02.2017;2017;02;17;Torstai;7;7;14;7;7;14
293;16.02.2017;2017;02;18;Torstai;6;7;13;2;8;10
293;16.02.2017;2017;02;19;Torstai;3;9;12;5;5;10
293;16.02.2017;2017;02;20;Torstai;3;9;12;2;2;4
293;16.02.2017;2017;02;21;Torstai;0;2;2;1;0;1
293;16.02.2017;2017;02;22;Torstai;2;0;2;0;0;0
293;16.02.2017;2017;02;23;Torstai;0;0;0;0;2;2
293;17.02.2017;2017;02;00;Perjantai;0;1;1;0;2;2
293;17.02.2017;2017;02;01;Perjantai;0;0;0;0;0;0
293;17.02.2017;2017;02;02;Perjantai;0;0;0;0;0;0
293;17.02.2017;2017;02;03;Perjantai;0;0;0;0;0;0
293;17.02.2017;2017;02;04;Perjantai;0;1;1;0;0;0
293;17.02.2017;2017;02;05;Perjantai;0;0;0;0;0;0
293;17.02.2017;2017;02;06;Perjantai;3;2;5;1;2;3
293;17.02.2017;2017;02;07;Perjantai;71;4;75;8;0;8
293;17.02.2017;2017;02;08;Perjantai;62;5;67;6;1;7
293;17.02.2017;2017;02;09;Perjantai;32;2;34;5;1;6
293;17.02.2017;2017;02;10;Perjantai;9;7;16;6;4;10
293;17.02.2017;2017;02;11;Perjantai;4;6;10;7;6;13
293;17.02.2017;2017;02;12;Perjantai;6;16;22;5;5;10
293;17.02.2017;2017;02;13;Perjantai;11;44;55;2;7;9
293;17.02.2017;2017;02;14;Perjantai;10;49;59;4;14;18
293;17.02.2017;2017;02;15;Perjantai;10;22;32;4;8;12
293;17.02.2017;2017;02;16;Perjantai;9;11;20;7;5;12
293;17.02.2017;2017;02;17;Perjantai;5;4;9;4;1;5
293;17.02.2017;2017;02;18;Perjantai;5;7;12;1;3;4
293;17.02.2017;2017;02;19;Perjantai;5;9;14;2;3;5
293;17.02.2017;2017;02;20;Perjantai;3;9;12;1;1;2
293;17.02.2017;2017;02;21;Perjantai;4;3;7;1;0;1
293;17.02.2017;2017;02;22;Perjantai;0;0;0;0;1;1
293;17.02.2017;2017;02;23;Perjantai;2;2;4;0;1;1
293;18.02.2017;2017;02;00;Lauantai;3;1;4;1;0;1
293;18.02.2017;2017;02;01;Lauantai;0;0;0;0;0;0
293;18.02.2017;2017;02;02;Lauantai;0;0;0;1;1;2
293;18.02.2017;2017;02;03;Lauantai;0;0;0;0;2;2
293;18.02.2017;2017;02;04;Lauantai;0;0;0;0;0;0
293;18.02.2017;2017;02;05;Lauantai;0;0;0;0;0;0
293;18.02.2017;2017;02;06;Lauantai;1;0;1;1;2;3
293;18.02.2017;2017;02;07;Lauantai;0;0;0;1;0;1
293;18.02.2017;2017;02;08;Lauantai;5;0;5;1;1;2
293;18.02.2017;2017;02;09;Lauantai;7;4;11;1;2;3
293;18.02.2017;2017;02;10;Lauantai;7;0;7;7;2;9
293;18.02.2017;2017;02;11;Lauantai;4;6;10;5;6;11
293;18.02.2017;2017;02;12;Lauantai;3;1;4;7;6;13
293;18.02.2017;2017;02;13;Lauantai;7;8;15;4;6;10
293;18.02.2017;2017;02;14;Lauantai;9;6;15;9;9;18
293;18.02.2017;2017;02;15;Lauantai;4;2;6;8;6;14
293;18.02.2017;2017;02;16;Lauantai;8;9;17;5;2;7
293;18.02.2017;2017;02;17;Lauantai;7;13;20;3;6;9
293;18.02.2017;2017;02;18;Lauantai;5;1;6;1;2;3
293;18.02.2017;2017;02;19;Lauantai;10;8;18;1;1;2
293;18.02.2017;2017;02;20;Lauantai;0;4;4;3;1;4
293;18.02.2017;2017;02;21;Lauantai;2;3;5;5;3;8
293;18.02.2017;2017;02;22;Lauantai;0;2;2;1;2;3
293;18.02.2017;2017;02;23;Lauantai;0;0;0;0;0;0
293;19.02.2017;2017;02;00;Sunnuntai;3;0;3;2;0;2
293;19.02.2017;2017;02;01;Sunnuntai;0;0;0;0;0;0
293;19.02.2017;2017;02;02;Sunnuntai;1;1;2;0;2;2
293;19.02.2017;2017;02;03;Sunnuntai;0;0;0;0;1;1
293;19.02.2017;2017;02;04;Sunnuntai;0;0;0;0;0;0
293;19.02.2017;2017;02;05;Sunnuntai;0;0;0;0;0;0
293;19.02.2017;2017;02;06;Sunnuntai;1;0;1;0;0;0
293;19.02.2017;2017;02;07;Sunnuntai;1;0;1;0;1;1
293;19.02.2017;2017;02;08;Sunnuntai;1;0;1;1;0;1
293;19.02.2017;2017;02;09;Sunnuntai;1;1;2;4;3;7
293;19.02.2017;2017;02;10;Sunnuntai;7;1;8;3;6;9
293;19.02.2017;2017;02;11;Sunnuntai;1;0;1;6;5;11
293;19.02.2017;2017;02;12;Sunnuntai;6;9;15;5;9;14
293;19.02.2017;2017;02;13;Sunnuntai;7;1;8;11;4;15
293;19.02.2017;2017;02;14;Sunnuntai;8;11;19;3;5;8
293;19.02.2017;2017;02;15;Sunnuntai;4;7;11;6;9;15
293;19.02.2017;2017;02;16;Sunnuntai;4;6;10;4;5;9
293;19.02.2017;2017;02;17;Sunnuntai;5;2;7;2;0;2
293;19.02.2017;2017;02;18;Sunnuntai;3;4;7;3;3;6
293;19.02.2017;2017;02;19;Sunnuntai;1;2;3;4;3;7
293;19.02.2017;2017;02;20;Sunnuntai;3;3;6;0;0;0
293;19.02.2017;2017;02;21;Sunnuntai;0;0;0;0;0;0
293;19.02.2017;2017;02;22;Sunnuntai;0;0;0;0;0;0
293;19.02.2017;2017;02;23;Sunnuntai;0;0;0;0;0;0
293;20.02.2017;2017;02;00;Maanantai;0;0;0;0;0;0
293;20.02.2017;2017;02;01;Maanantai;0;0;0;0;0;0
293;20.02.2017;2017;02;02;Maanantai;0;0;0;0;0;0
293;20.02.2017;2017;02;03;Maanantai;0;0;0;0;0;0
293;20.02.2017;2017;02;04;Maanantai;0;0;0;0;0;0
293;20.02.2017;2017;02;05;Maanantai;1;0;1;0;0;0
293;20.02.2017;2017;02;06;Maanantai;4;4;8;0;0;0
293;20.02.2017;2017;02;07;Maanantai;37;37;74;0;0;0
293;20.02.2017;2017;02;08;Maanantai;34;34;68;0;0;0
293;20.02.2017;2017;02;09;Maanantai;10;9;19;0;0;0
293;20.02.2017;2017;02;10;Maanantai;5;4;9;0;0;0
293;20.02.2017;2017;02;11;Maanantai;3;3;6;0;0;0
293;20.02.2017;2017;02;12;Maanantai;5;2;7;2;0;2
293;20.02.2017;2017;02;13;Maanantai;21;4;25;2;0;2
293;20.02.2017;2017;02;14;Maanantai;44;4;48;4;0;4
293;20.02.2017;2017;02;15;Maanantai;68;6;74;5;0;5
293;20.02.2017;2017;02;16;Maanantai;9;4;13;3;0;3
293;20.02.2017;2017;02;17;Maanantai;11;2;13;5;0;5
293;20.02.2017;2017;02;18;Maanantai;8;0;8;8;0;8
293;20.02.2017;2017;02;19;Maanantai;6;1;7;5;0;5
293;20.02.2017;2017;02;20;Maanantai;4;2;6;3;0;3
293;20.02.2017;2017;02;21;Maanantai;0;2;2;1;0;1
293;20.02.2017;2017;02;22;Maanantai;0;0;0;4;0;4
293;20.02.2017;2017;02;23;Maanantai;0;0;0;0;0;0
293;21.02.2017;2017;02;00;Tiistai;0;0;0;0;0;0
293;21.02.2017;2017;02;01;Tiistai;0;0;0;0;0;0
293;21.02.2017;2017;02;02;Tiistai;0;0;0;0;0;0
293;21.02.2017;2017;02;03;Tiistai;0;0;0;0;0;0
293;21.02.2017;2017;02;04;Tiistai;0;0;0;0;0;0
293;21.02.2017;2017;02;05;Tiistai;2;0;2;0;0;0
293;21.02.2017;2017;02;06;Tiistai;7;2;9;1;0;1
293;21.02.2017;2017;02;07;Tiistai;56;3;59;7;0;7
293;21.02.2017;2017;02;08;Tiistai;58;4;62;5;1;6
293;21.02.2017;2017;02;09;Tiistai;37;2;39;4;1;5
293;21.02.2017;2017;02;10;Tiistai;16;2;18;6;0;6
293;21.02.2017;2017;02;11;Tiistai;2;2;4;1;0;1
293;21.02.2017;2017;02;12;Tiistai;10;7;17;1;4;5
293;21.02.2017;2017;02;13;Tiistai;7;12;19;4;2;6
293;21.02.2017;2017;02;14;Tiistai;4;49;53;5;10;15
293;21.02.2017;2017;02;15;Tiistai;8;98;106;6;9;15
293;21.02.2017;2017;02;16;Tiistai;5;13;18;2;4;6
293;21.02.2017;2017;02;17;Tiistai;6;7;13;2;3;5
293;21.02.2017;2017;02;18;Tiistai;2;3;5;6;3;9
293;21.02.2017;2017;02;19;Tiistai;1;1;2;3;5;8
293;21.02.2017;2017;02;20;Tiistai;0;4;4;1;4;5
293;21.02.2017;2017;02;21;Tiistai;0;2;2;1;0;1
293;21.02.2017;2017;02;22;Tiistai;1;0;1;0;0;0
293;21.02.2017;2017;02;23;Tiistai;0;0;0;0;0;0
293;22.02.2017;2017;02;00;Keskiviikko;1;0;1;0;0;0
293;22.02.2017;2017;02;01;Keskiviikko;0;0;0;0;0;0
293;22.02.2017;2017;02;02;Keskiviikko;0;0;0;0;1;1
293;22.02.2017;2017;02;03;Keskiviikko;0;0;0;0;0;0
293;22.02.2017;2017;02;04;Keskiviikko;0;0;0;0;0;0
293;22.02.2017;2017;02;05;Keskiviikko;1;1;2;0;0;0
293;22.02.2017;2017;02;06;Keskiviikko;5;1;6;2;1;3
293;22.02.2017;2017;02;07;Keskiviikko;79;2;81;6;1;7
293;22.02.2017;2017;02;08;Keskiviikko;83;2;85;6;0;6
293;22.02.2017;2017;02;09;Keskiviikko;15;4;19;4;3;7
293;22.02.2017;2017;02;10;Keskiviikko;7;3;10;3;2;5
293;22.02.2017;2017;02;11;Keskiviikko;4;8;12;16;4;20
293;22.02.2017;2017;02;12;Keskiviikko;4;24;28;1;6;7
293;22.02.2017;2017;02;13;Keskiviikko;5;31;36;8;9;17
293;22.02.2017;2017;02;14;Keskiviikko;5;74;79;4;13;17
293;22.02.2017;2017;02;15;Keskiviikko;7;37;44;2;7;9
293;22.02.2017;2017;02;16;Keskiviikko;5;5;10;6;7;13
293;22.02.2017;2017;02;17;Keskiviikko;5;8;13;5;6;11
293;22.02.2017;2017;02;18;Keskiviikko;3;6;9;4;6;10
293;22.02.2017;2017;02;19;Keskiviikko;5;8;13;2;4;6
293;22.02.2017;2017;02;20;Keskiviikko;2;2;4;1;2;3
293;22.02.2017;2017;02;21;Keskiviikko;0;1;1;0;4;4
293;22.02.2017;2017;02;22;Keskiviikko;0;0;0;0;0;0
293;22.02.2017;2017;02;23;Keskiviikko;0;0;0;0;0;0
293;23.02.2017;2017;02;00;Torstai;0;0;0;0;0;0
293;23.02.2017;2017;02;01;Torstai;0;0;0;0;0;0
293;23.02.2017;2017;02;02;Torstai;0;0;0;0;0;0
293;23.02.2017;2017;02;03;Torstai;1;0;1;0;0;0
293;23.02.2017;2017;02;04;Torstai;0;0;0;0;0;0
293;23.02.2017;2017;02;05;Torstai;0;0;0;0;0;0
293;23.02.2017;2017;02;06;Torstai;6;1;7;2;0;2
293;23.02.2017;2017;02;07;Torstai;60;24;84;1;0;1
293;23.02.2017;2017;02;08;Torstai;34;28;62;1;0;1
293;23.02.2017;2017;02;09;Torstai;9;7;16;0;0;0
293;23.02.2017;2017;02;10;Torstai;5;3;8;0;0;0
293;23.02.2017;2017;02;11;Torstai;4;3;7;0;0;0
293;23.02.2017;2017;02;12;Torstai;3;2;5;0;0;0
293;23.02.2017;2017;02;13;Torstai;8;20;28;2;0;2
293;23.02.2017;2017;02;14;Torstai;2;73;75;4;7;11
293;23.02.2017;2017;02;15;Torstai;6;50;56;1;9;10
293;23.02.2017;2017;02;16;Torstai;0;12;12;6;2;8
293;23.02.2017;2017;02;17;Torstai;7;2;9;3;1;4
293;23.02.2017;2017;02;18;Torstai;4;3;7;0;0;0
293;23.02.2017;2017;02;19;Torstai;3;2;5;0;0;0
293;23.02.2017;2017;02;20;Torstai;3;2;5;0;0;0
293;23.02.2017;2017;02;21;Torstai;0;0;0;0;0;0
293;23.02.2017;2017;02;22;Torstai;1;0;1;0;0;0
293;23.02.2017;2017;02;23;Torstai;0;0;0;0;0;0
293;24.02.2017;2017;02;00;Perjantai;0;0;0;0;0;0
293;24.02.2017;2017;02;01;Perjantai;0;0;0;2;0;2
293;24.02.2017;2017;02;02;Perjantai;0;0;0;0;0;0
293;24.02.2017;2017;02;03;Perjantai;0;0;0;0;0;0
293;24.02.2017;2017;02;04;Perjantai;0;0;0;0;0;0
293;24.02.2017;2017;02;05;Perjantai;0;0;0;0;0;0
293;24.02.2017;2017;02;06;Perjantai;4;1;5;0;0;0
293;24.02.2017;2017;02;07;Perjantai;53;10;63;3;0;3
293;24.02.2017;2017;02;08;Perjantai;60;10;70;2;1;3
293;24.02.2017;2017;02;09;Perjantai;25;3;28;5;1;6
293;24.02.2017;2017;02;10;Perjantai;6;2;8;2;3;5
293;24.02.2017;2017;02;11;Perjantai;6;6;12;4;1;5
293;24.02.2017;2017;02;12;Perjantai;7;21;28;5;0;5
293;24.02.2017;2017;02;13;Perjantai;9;36;45;3;4;7
293;24.02.2017;2017;02;14;Perjantai;6;69;75;3;6;9
293;24.02.2017;2017;02;15;Perjantai;5;31;36;2;5;7
293;24.02.2017;2017;02;16;Perjantai;6;10;16;7;2;9
293;24.02.2017;2017;02;17;Perjantai;5;8;13;2;6;8
293;24.02.2017;2017;02;18;Perjantai;7;4;11;1;5;6
293;24.02.2017;2017;02;19;Perjantai;1;5;6;0;1;1
293;24.02.2017;2017;02;20;Perjantai;2;8;10;1;0;1
293;24.02.2017;2017;02;21;Perjantai;2;1;3;3;4;7
293;24.02.2017;2017;02;22;Perjantai;1;0;1;0;0;0
293;24.02.2017;2017;02;23;Perjantai;0;0;0;0;0;0
293;25.02.2017;2017;02;00;Lauantai;0;2;2;0;1;1
293;25.02.2017;2017;02;01;Lauantai;0;0;0;0;0;0
293;25.02.2017;2017;02;02;Lauantai;0;0;0;0;0;0
293;25.02.2017;2017;02;03;Lauantai;0;0;0;0;2;2
293;25.02.2017;2017;02;04;Lauantai;0;0;0;0;0;0
293;25.02.2017;2017;02;05;Lauantai;0;0;0;0;0;0
293;25.02.2017;2017;02;06;Lauantai;0;0;0;0;0;0
293;25.02.2017;2017;02;07;Lauantai;0;0;0;0;0;0
293;25.02.2017;2017;02;08;Lauantai;3;1;4;1;1;2
293;25.02.2017;2017;02;09;Lauantai;5;2;7;8;1;9
293;25.02.2017;2017;02;10;Lauantai;5;2;7;3;6;9
293;25.02.2017;2017;02;11;Lauantai;5;6;11;4;6;10
293;25.02.2017;2017;02;12;Lauantai;8;6;14;6;6;12
293;25.02.2017;2017;02;13;Lauantai;12;7;19;4;5;9
293;25.02.2017;2017;02;14;Lauantai;12;9;21;4;4;8
293;25.02.2017;2017;02;15;Lauantai;3;7;10;9;5;14
293;25.02.2017;2017;02;16;Lauantai;3;7;10;4;7;11
293;25.02.2017;2017;02;17;Lauantai;5;8;13;2;5;7
293;25.02.2017;2017;02;18;Lauantai;7;5;12;1;1;2
293;25.02.2017;2017;02;19;Lauantai;4;8;12;5;1;6
293;25.02.2017;2017;02;20;Lauantai;1;6;7;1;0;1
293;25.02.2017;2017;02;21;Lauantai;0;2;2;0;1;1
293;25.02.2017;2017;02;22;Lauantai;1;0;1;1;0;1
293;25.02.2017;2017;02;23;Lauantai;0;0;0;0;1;1
293;26.02.2017;2017;02;00;Sunnuntai;1;0;1;1;1;2
293;26.02.2017;2017;02;01;Sunnuntai;0;0;0;0;3;3
293;26.02.2017;2017;02;02;Sunnuntai;0;0;0;0;5;5
293;26.02.2017;2017;02;03;Sunnuntai;0;0;0;0;0;0
293;26.02.2017;2017;02;04;Sunnuntai;0;0;0;0;0;0
293;26.02.2017;2017;02;05;Sunnuntai;0;0;0;1;0;1
293;26.02.2017;2017;02;06;Sunnuntai;1;0;1;0;0;0
293;26.02.2017;2017;02;07;Sunnuntai;0;0;0;1;0;1
293;26.02.2017;2017;02;08;Sunnuntai;2;0;2;0;1;1
293;26.02.2017;2017;02;09;Sunnuntai;6;1;7;3;1;4
293;26.02.2017;2017;02;10;Sunnuntai;3;1;4;5;4;9
293;26.02.2017;2017;02;11;Sunnuntai;4;5;9;4;7;11
293;26.02.2017;2017;02;12;Sunnuntai;5;2;7;4;4;8
293;26.02.2017;2017;02;13;Sunnuntai;8;8;16;3;5;8
293;26.02.2017;2017;02;14;Sunnuntai;6;6;12;7;5;12
293;26.02.2017;2017;02;15;Sunnuntai;4;0;4;3;3;6
293;26.02.2017;2017;02;16;Sunnuntai;5;8;13;4;5;9
293;26.02.2017;2017;02;17;Sunnuntai;8;7;15;6;2;8
293;26.02.2017;2017;02;18;Sunnuntai;4;3;7;1;2;3
293;26.02.2017;2017;02;19;Sunnuntai;1;1;2;1;1;2
293;26.02.2017;2017;02;20;Sunnuntai;3;5;8;0;1;1
293;26.02.2017;2017;02;21;Sunnuntai;1;1;2;0;0;0
293;26.02.2017;2017;02;22;Sunnuntai;1;0;1;1;0;1
293;26.02.2017;2017;02;23;Sunnuntai;0;1;1;0;1;1
293;27.02.2017;2017;02;00;Maanantai;0;0;0;0;0;0
293;27.02.2017;2017;02;01;Maanantai;0;0;0;1;0;1
293;27.02.2017;2017;02;02;Maanantai;0;0;0;0;0;0
293;27.02.2017;2017;02;03;Maanantai;0;0;0;0;0;0
293;27.02.2017;2017;02;04;Maanantai;0;0;0;0;0;0
293;27.02.2017;2017;02;05;Maanantai;1;0;1;0;0;0
293;27.02.2017;2017;02;06;Maanantai;4;1;5;2;0;2
293;27.02.2017;2017;02;07;Maanantai;56;2;58;7;1;8
293;27.02.2017;2017;02;08;Maanantai;49;4;53;2;2;4
293;27.02.2017;2017;02;09;Maanantai;15;2;17;1;3;4
293;27.02.2017;2017;02;10;Maanantai;6;0;6;4;1;5
293;27.02.2017;2017;02;11;Maanantai;3;3;6;1;2;3
293;27.02.2017;2017;02;12;Maanantai;1;2;3;6;5;11
293;27.02.2017;2017;02;13;Maanantai;4;24;28;3;6;9
293;27.02.2017;2017;02;14;Maanantai;3;43;46;2;8;10
293;27.02.2017;2017;02;15;Maanantai;7;50;57;2;8;10
293;27.02.2017;2017;02;16;Maanantai;4;11;15;5;3;8
293;27.02.2017;2017;02;17;Maanantai;2;7;9;7;6;13
293;27.02.2017;2017;02;18;Maanantai;1;4;5;7;5;12
293;27.02.2017;2017;02;19;Maanantai;5;3;8;0;4;4
293;27.02.2017;2017;02;20;Maanantai;1;1;2;3;5;8
293;27.02.2017;2017;02;21;Maanantai;0;1;1;0;2;2
293;27.02.2017;2017;02;22;Maanantai;1;0;1;1;1;2
293;27.02.2017;2017;02;23;Maanantai;0;0;0;0;0;0
293;28.02.2017;2017;02;00;Tiistai;0;0;0;0;0;0
293;28.02.2017;2017;02;01;Tiistai;0;0;0;0;0;0
293;28.02.2017;2017;02;02;Tiistai;0;0;0;0;0;0
293;28.02.2017;2017;02;03;Tiistai;0;0;0;0;0;0
293;28.02.2017;2017;02;04;Tiistai;0;0;0;0;1;1
293;28.02.2017;2017;02;05;Tiistai;1;0;1;0;0;0
293;28.02.2017;2017;02;06;Tiistai;3;2;5;2;0;2
293;28.02.2017;2017;02;07;Tiistai;60;4;64;4;1;5
293;28.02.2017;2017;02;08;Tiistai;87;2;89;8;4;12
293;28.02.2017;2017;02;09;Tiistai;32;3;35;4;2;6
293;28.02.2017;2017;02;10;Tiistai;6;2;8;2;3;5
293;28.02.2017;2017;02;11;Tiistai;3;4;7;4;6;10
293;28.02.2017;2017;02;12;Tiistai;5;7;12;2;2;4
293;28.02.2017;2017;02;13;Tiistai;5;108;113;0;9;9
293;28.02.2017;2017;02;14;Tiistai;3;16;19;4;2;6
293;28.02.2017;2017;02;15;Tiistai;9;29;38;3;0;3
293;28.02.2017;2017;02;16;Tiistai;11;13;24;2;4;6
293;28.02.2017;2017;02;17;Tiistai;8;8;16;7;2;9
293;28.02.2017;2017;02;18;Tiistai;2;10;12;2;7;9
293;28.02.2017;2017;02;19;Tiistai;3;9;12;4;2;6
293;28.02.2017;2017;02;20;Tiistai;3;3;6;2;3;5
293;28.02.2017;2017;02;21;Tiistai;0;1;1;1;1;2
293;28.02.2017;2017;02;22;Tiistai;0;0;0;0;0;0
293;28.02.2017;2017;02;23;Tiistai;0;0;0;0;0;0
293;01.03.2017;2017;03;00;Keskiviikko;0;0;0;0;0;0
293;01.03.2017;2017;03;01;Keskiviikko;0;0;0;0;0;0
293;01.03.2017;2017;03;02;Keskiviikko;0;0;0;0;0;0
293;01.03.2017;2017;03;03;Keskiviikko;0;0;0;0;0;0
293;01.03.2017;2017;03;04;Keskiviikko;0;0;0;0;0;0
293;01.03.2017;2017;03;05;Keskiviikko;2;0;2;0;0;0
293;01.03.2017;2017;03;06;Keskiviikko;4;2;6;2;0;2
293;01.03.2017;2017;03;07;Keskiviikko;42;41;83;0;0;0
293;01.03.2017;2017;03;08;Keskiviikko;28;28;56;0;0;0
293;01.03.2017;2017;03;09;Keskiviikko;10;9;19;0;0;0
293;01.03.2017;2017;03;10;Keskiviikko;3;3;6;0;0;0
293;01.03.2017;2017;03;11;Keskiviikko;0;1;1;0;0;0
293;01.03.2017;2017;03;12;Keskiviikko;3;8;11;5;1;6
293;01.03.2017;2017;03;13;Keskiviikko;3;19;22;2;4;6
293;01.03.2017;2017;03;14;Keskiviikko;4;99;103;5;9;14
293;01.03.2017;2017;03;15;Keskiviikko;3;15;18;1;4;5
293;01.03.2017;2017;03;16;Keskiviikko;4;8;12;2;5;7
293;01.03.2017;2017;03;17;Keskiviikko;8;6;14;2;0;2
293;01.03.2017;2017;03;18;Keskiviikko;3;0;3;4;6;10
293;01.03.2017;2017;03;19;Keskiviikko;2;11;13;4;5;9
293;01.03.2017;2017;03;20;Keskiviikko;0;1;1;1;0;1
293;01.03.2017;2017;03;21;Keskiviikko;0;5;5;0;1;1
293;01.03.2017;2017;03;22;Keskiviikko;1;0;1;0;0;0
293;01.03.2017;2017;03;23;Keskiviikko;0;0;0;0;0;0
293;02.03.2017;2017;03;00;Torstai;0;0;0;0;0;0
293;02.03.2017;2017;03;01;Torstai;0;0;0;0;0;0
293;02.03.2017;2017;03;02;Torstai;0;0;0;0;0;0
293;02.03.2017;2017;03;03;Torstai;0;0;0;0;0;0
293;02.03.2017;2017;03;04;Torstai;1;0;1;0;0;0
293;02.03.2017;2017;03;05;Torstai;2;0;2;0;0;0
293;02.03.2017;2017;03;06;Torstai;9;2;11;2;0;2
293;02.03.2017;2017;03;07;Torstai;71;1;72;11;3;14
293;02.03.2017;2017;03;08;Torstai;59;6;65;8;2;10
293;02.03.2017;2017;03;09;Torstai;13;3;16;14;2;16
293;02.03.2017;2017;03;10;Torstai;2;3;5;6;8;14
293;02.03.2017;2017;03;11;Torstai;1;4;5;3;7;10
293;02.03.2017;2017;03;12;Torstai;1;4;5;5;5;10
293;02.03.2017;2017;03;13;Torstai;4;22;26;5;5;10
293;02.03.2017;2017;03;14;Torstai;3;63;66;5;10;15
293;02.03.2017;2017;03;15;Torstai;8;44;52;0;12;12
293;02.03.2017;2017;03;16;Torstai;8;11;19;3;2;5
293;02.03.2017;2017;03;17;Torstai;3;6;9;4;5;9
293;02.03.2017;2017;03;18;Torstai;8;8;16;4;5;9
293;02.03.2017;2017;03;19;Torstai;4;4;8;3;4;7
293;02.03.2017;2017;03;20;Torstai;1;9;10;1;2;3
293;02.03.2017;2017;03;21;Torstai;0;1;1;1;1;2
293;02.03.2017;2017;03;22;Torstai;0;0;0;0;2;2
293;02.03.2017;2017;03;23;Torstai;0;0;0;0;0;0
293;03.03.2017;2017;03;00;Perjantai;0;0;0;0;0;0
293;03.03.2017;2017;03;01;Perjantai;0;0;0;0;0;0
293;03.03.2017;2017;03;02;Perjantai;0;0;0;0;0;0
293;03.03.2017;2017;03;03;Perjantai;0;0;0;0;0;0
293;03.03.2017;2017;03;04;Perjantai;0;0;0;0;0;0
293;03.03.2017;2017;03;05;Perjantai;0;0;0;0;0;0
293;03.03.2017;2017;03;06;Perjantai;5;1;6;1;1;2
293;03.03.2017;2017;03;07;Perjantai;61;2;63;6;0;6
293;03.03.2017;2017;03;08;Perjantai;56;4;60;5;2;7
293;03.03.2017;2017;03;09;Perjantai;30;1;31;8;1;9
293;03.03.2017;2017;03;10;Perjantai;9;5;14;5;3;8
293;03.03.2017;2017;03;11;Perjantai;7;4;11;6;3;9
293;03.03.2017;2017;03;12;Perjantai;7;19;26;6;15;21
293;03.03.2017;2017;03;13;Perjantai;3;30;33;6;12;18
293;03.03.2017;2017;03;14;Perjantai;5;89;94;5;15;20
293;03.03.2017;2017;03;15;Perjantai;2;6;8;7;12;19
293;03.03.2017;2017;03;16;Perjantai;5;9;14;2;4;6
293;03.03.2017;2017;03;17;Perjantai;9;2;11;1;6;7
293;03.03.2017;2017;03;18;Perjantai;1;7;8;3;3;6
293;03.03.2017;2017;03;19;Perjantai;4;12;16;1;4;5
293;03.03.2017;2017;03;20;Perjantai;0;4;4;1;0;1
293;03.03.2017;2017;03;21;Perjantai;0;2;2;0;1;1
293;03.03.2017;2017;03;22;Perjantai;0;2;2;0;1;1
293;03.03.2017;2017;03;23;Perjantai;2;0;2;0;0;0
293;04.03.2017;2017;03;00;Lauantai;0;0;0;0;0;0
293;04.03.2017;2017;03;01;Lauantai;0;0;0;0;0;0
293;04.03.2017;2017;03;02;Lauantai;0;0;0;0;1;1
293;04.03.2017;2017;03;03;Lauantai;0;0;0;0;0;0
293;04.03.2017;2017;03;04;Lauantai;0;0;0;1;0;1
293;04.03.2017;2017;03;05;Lauantai;0;0;0;0;0;0
293;04.03.2017;2017;03;06;Lauantai;1;0;1;1;0;1
293;04.03.2017;2017;03;07;Lauantai;0;0;0;1;0;1
293;04.03.2017;2017;03;08;Lauantai;4;0;4;1;1;2
293;04.03.2017;2017;03;09;Lauantai;1;3;4;6;4;10
293;04.03.2017;2017;03;10;Lauantai;2;2;4;5;4;9
293;04.03.2017;2017;03;11;Lauantai;8;1;9;7;4;11
293;04.03.2017;2017;03;12;Lauantai;6;12;18;8;6;14
293;04.03.2017;2017;03;13;Lauantai;3;2;5;2;7;9
293;04.03.2017;2017;03;14;Lauantai;14;7;21;7;5;12
293;04.03.2017;2017;03;15;Lauantai;2;5;7;5;0;5
293;04.03.2017;2017;03;16;Lauantai;1;0;1;6;7;13
293;04.03.2017;2017;03;17;Lauantai;1;5;6;1;3;4
293;04.03.2017;2017;03;18;Lauantai;2;4;6;2;7;9
293;04.03.2017;2017;03;19;Lauantai;6;2;8;2;1;3
293;04.03.2017;2017;03;20;Lauantai;0;3;3;0;2;2
293;04.03.2017;2017;03;21;Lauantai;3;3;6;1;2;3
293;04.03.2017;2017;03;22;Lauantai;1;0;1;1;0;1
293;04.03.2017;2017;03;23;Lauantai;0;0;0;0;1;1
293;05.03.2017;2017;03;00;Sunnuntai;0;4;4;1;0;1
293;05.03.2017;2017;03;01;Sunnuntai;3;0;3;0;0;0
293;05.03.2017;2017;03;02;Sunnuntai;0;3;3;0;0;0
293;05.03.2017;2017;03;03;Sunnuntai;0;0;0;0;1;1
293;05.03.2017;2017;03;04;Sunnuntai;1;0;1;0;2;2
293;05.03.2017;2017;03;05;Sunnuntai;0;0;0;1;0;1
293;05.03.2017;2017;03;06;Sunnuntai;0;0;0;1;1;2
293;05.03.2017;2017;03;07;Sunnuntai;0;0;0;0;0;0
293;05.03.2017;2017;03;08;Sunnuntai;0;0;0;1;1;2
293;05.03.2017;2017;03;09;Sunnuntai;1;4;5;2;1;3
293;05.03.2017;2017;03;10;Sunnuntai;2;4;6;8;3;11
293;05.03.2017;2017;03;11;Sunnuntai;6;1;7;5;6;11
293;05.03.2017;2017;03;12;Sunnuntai;2;2;4;9;4;13
293;05.03.2017;2017;03;13;Sunnuntai;3;2;5;4;6;10
293;05.03.2017;2017;03;14;Sunnuntai;1;1;2;9;4;13
293;05.03.2017;2017;03;15;Sunnuntai;2;3;5;6;2;8
293;05.03.2017;2017;03;16;Sunnuntai;1;5;6;8;8;16
293;05.03.2017;2017;03;17;Sunnuntai;1;1;2;5;7;12
293;05.03.2017;2017;03;18;Sunnuntai;1;3;4;2;2;4
293;05.03.2017;2017;03;19;Sunnuntai;1;0;1;1;3;4
293;05.03.2017;2017;03;20;Sunnuntai;0;0;0;2;2;4
293;05.03.2017;2017;03;21;Sunnuntai;1;0;1;0;1;1
293;05.03.2017;2017;03;22;Sunnuntai;0;0;0;0;0;0
293;05.03.2017;2017;03;23;Sunnuntai;0;0;0;0;0;0
293;06.03.2017;2017;03;00;Maanantai;0;0;0;1;0;1
293;06.03.2017;2017;03;01;Maanantai;0;0;0;0;0;0
293;06.03.2017;2017;03;02;Maanantai;0;0;0;0;0;0
293;06.03.2017;2017;03;03;Maanantai;0;0;0;1;0;1
293;06.03.2017;2017;03;04;Maanantai;0;0;0;1;2;3
293;06.03.2017;2017;03;05;Maanantai;1;0;1;0;1;1
293;06.03.2017;2017;03;06;Maanantai;3;1;4;1;0;1
293;06.03.2017;2017;03;07;Maanantai;7;1;8;2;0;2
293;06.03.2017;2017;03;08;Maanantai;3;2;5;0;0;0
293;06.03.2017;2017;03;09;Maanantai;3;1;4;3;1;4
293;06.03.2017;2017;03;10;Maanantai;6;1;7;3;3;6
293;06.03.2017;2017;03;11;Maanantai;3;1;4;9;6;15
293;06.03.2017;2017;03;12;Maanantai;6;3;9;8;7;15
293;06.03.2017;2017;03;13;Maanantai;6;6;12;6;6;12
293;06.03.2017;2017;03;14;Maanantai;6;5;11;4;8;12
293;06.03.2017;2017;03;15;Maanantai;7;12;19;1;7;8
293;06.03.2017;2017;03;16;Maanantai;3;8;11;1;2;3
293;06.03.2017;2017;03;17;Maanantai;0;2;2;0;1;1
293;06.03.2017;2017;03;18;Maanantai;1;0;1;5;1;6
293;06.03.2017;2017;03;19;Maanantai;2;2;4;2;1;3
293;06.03.2017;2017;03;20;Maanantai;1;2;3;1;1;2
293;06.03.2017;2017;03;21;Maanantai;2;1;3;0;2;2
293;06.03.2017;2017;03;22;Maanantai;0;1;1;1;2;3
293;06.03.2017;2017;03;23;Maanantai;0;0;0;0;0;0
293;07.03.2017;2017;03;00;Tiistai;0;0;0;0;0;0
293;07.03.2017;2017;03;01;Tiistai;0;0;0;0;1;1
293;07.03.2017;2017;03;02;Tiistai;0;0;0;0;0;0
293;07.03.2017;2017;03;03;Tiistai;0;0;0;0;0;0
293;07.03.2017;2017;03;04;Tiistai;0;0;0;0;0;0
293;07.03.2017;2017;03;05;Tiistai;1;0;1;0;0;0
293;07.03.2017;2017;03;06;Tiistai;6;2;8;1;0;1
293;07.03.2017;2017;03;07;Tiistai;6;2;8;3;1;4
293;07.03.2017;2017;03;08;Tiistai;2;0;2;3;1;4
293;07.03.2017;2017;03;09;Tiistai;8;1;9;3;1;4
293;07.03.2017;2017;03;10;Tiistai;0;3;3;2;4;6
293;07.03.2017;2017;03;11;Tiistai;1;3;4;7;4;11
293;07.03.2017;2017;03;12;Tiistai;1;7;8;2;8;10
293;07.03.2017;2017;03;13;Tiistai;4;3;7;6;6;12
293;07.03.2017;2017;03;14;Tiistai;4;10;14;5;5;10
293;07.03.2017;2017;03;15;Tiistai;2;8;10;4;3;7
293;07.03.2017;2017;03;16;Tiistai;4;5;9;1;0;1
293;07.03.2017;2017;03;17;Tiistai;1;1;2;1;2;3
293;07.03.2017;2017;03;18;Tiistai;4;3;7;1;0;1
293;07.03.2017;2017;03;19;Tiistai;4;1;5;2;0;2
293;07.03.2017;2017;03;20;Tiistai;2;3;5;2;0;2
293;07.03.2017;2017;03;21;Tiistai;1;1;2;0;0;0
293;07.03.2017;2017;03;22;Tiistai;0;0;0;0;0;0
293;07.03.2017;2017;03;23;Tiistai;1;1;2;0;0;0
293;08.03.2017;2017;03;00;Keskiviikko;0;0;0;0;0;0
293;08.03.2017;2017;03;01;Keskiviikko;0;0;0;0;0;0
293;08.03.2017;2017;03;02;Keskiviikko;0;0;0;0;0;0
293;08.03.2017;2017;03;03;Keskiviikko;0;0;0;0;0;0
293;08.03.2017;2017;03;04;Keskiviikko;0;0;0;1;0;1
293;08.03.2017;2017;03;05;Keskiviikko;0;0;0;0;0;0
293;08.03.2017;2017;03;06;Keskiviikko;3;3;6;0;0;0
293;08.03.2017;2017;03;07;Keskiviikko;5;4;9;0;0;0
293;08.03.2017;2017;03;08;Keskiviikko;2;2;4;0;0;0
293;08.03.2017;2017;03;09;Keskiviikko;4;3;7;0;0;0
293;08.03.2017;2017;03;10;Keskiviikko;2;1;3;0;0;0
293;08.03.2017;2017;03;11;Keskiviikko;2;2;4;0;1;1
293;08.03.2017;2017;03;12;Keskiviikko;5;3;8;6;1;7
293;08.03.2017;2017;03;13;Keskiviikko;5;4;9;3;6;9
293;08.03.2017;2017;03;14;Keskiviikko;2;5;7;5;5;10
293;08.03.2017;2017;03;15;Keskiviikko;5;8;13;3;4;7
293;08.03.2017;2017;03;16;Keskiviikko;2;4;6;1;2;3
293;08.03.2017;2017;03;17;Keskiviikko;3;7;10;1;4;5
293;08.03.2017;2017;03;18;Keskiviikko;0;4;4;0;1;1
293;08.03.2017;2017;03;19;Keskiviikko;3;3;6;0;0;0
293;08.03.2017;2017;03;20;Keskiviikko;1;2;3;0;1;1
293;08.03.2017;2017;03;21;Keskiviikko;1;0;1;0;1;1
293;08.03.2017;2017;03;22;Keskiviikko;0;1;1;0;0;0
293;08.03.2017;2017;03;23;Keskiviikko;0;0;0;0;0;0
293;09.03.2017;2017;03;00;Torstai;1;0;1;0;0;0
293;09.03.2017;2017;03;01;Torstai;1;1;2;0;1;1
293;09.03.2017;2017;03;02;Torstai;0;0;0;0;0;0
293;09.03.2017;2017;03;03;Torstai;0;1;1;0;0;0
293;09.03.2017;2017;03;04;Torstai;0;0;0;0;0;0
293;09.03.2017;2017;03;05;Torstai;0;0;0;0;0;0
293;09.03.2017;2017;03;06;Torstai;3;2;5;2;0;2
293;09.03.2017;2017;03;07;Torstai;7;0;7;2;1;3
293;09.03.2017;2017;03;08;Torstai;6;4;10;3;1;4
293;09.03.2017;2017;03;09;Torstai;3;2;5;4;4;8
293;09.03.2017;2017;03;10;Torstai;2;0;2;5;5;10
293;09.03.2017;2017;03;11;Torstai;1;4;5;4;4;8
293;09.03.2017;2017;03;12;Torstai;4;1;5;7;1;8
293;09.03.2017;2017;03;13;Torstai;3;1;4;2;5;7
293;09.03.2017;2017;03;14;Torstai;0;5;5;2;3;5
293;09.03.2017;2017;03;15;Torstai;3;6;9;1;2;3
293;09.03.2017;2017;03;16;Torstai;1;2;3;1;2;3
293;09.03.2017;2017;03;17;Torstai;1;2;3;5;1;6
293;09.03.2017;2017;03;18;Torstai;1;1;2;1;2;3
293;09.03.2017;2017;03;19;Torstai;2;0;2;2;1;3
293;09.03.2017;2017;03;20;Torstai;3;2;5;1;1;2
293;09.03.2017;2017;03;21;Torstai;0;0;0;0;2;2
293;09.03.2017;2017;03;22;Torstai;0;0;0;0;0;0
293;09.03.2017;2017;03;23;Torstai;0;1;1;0;0;0
293;10.03.2017;2017;03;00;Perjantai;1;1;2;0;0;0
293;10.03.2017;2017;03;01;Perjantai;0;0;0;0;0;0
293;10.03.2017;2017;03;02;Perjantai;0;0;0;0;0;0
293;10.03.2017;2017;03;03;Perjantai;0;0;0;0;0;0
293;10.03.2017;2017;03;04;Perjantai;0;0;0;0;0;0
293;10.03.2017;2017;03;05;Perjantai;0;0;0;0;0;0
293;10.03.2017;2017;03;06;Perjantai;3;1;4;1;0;1
293;10.03.2017;2017;03;07;Perjantai;7;0;7;1;1;2
293;10.03.2017;2017;03;08;Perjantai;4;1;5;1;1;2
293;10.03.2017;2017;03;09;Perjantai;6;4;10;3;0;3
293;10.03.2017;2017;03;10;Perjantai;3;2;5;3;1;4
293;10.03.2017;2017;03;11;Perjantai;8;2;10;3;1;4
293;10.03.2017;2017;03;12;Perjantai;2;2;4;3;4;7
293;10.03.2017;2017;03;13;Perjantai;7;7;14;3;3;6
293;10.03.2017;2017;03;14;Perjantai;4;11;15;5;5;10
293;10.03.2017;2017;03;15;Perjantai;1;7;8;7;6;13
293;10.03.2017;2017;03;16;Perjantai;1;2;3;2;1;3
293;10.03.2017;2017;03;17;Perjantai;5;0;5;0;0;0
293;10.03.2017;2017;03;18;Perjantai;3;3;6;3;0;3
293;10.03.2017;2017;03;19;Perjantai;3;1;4;0;0;0
293;10.03.2017;2017;03;20;Perjantai;1;4;5;1;0;1
293;10.03.2017;2017;03;21;Perjantai;2;0;2;2;0;2
293;10.03.2017;2017;03;22;Perjantai;0;0;0;0;0;0
293;10.03.2017;2017;03;23;Perjantai;0;1;1;0;0;0
293;11.03.2017;2017;03;00;Lauantai;0;0;0;0;0;0
293;11.03.2017;2017;03;01;Lauantai;0;0;0;0;1;1
293;11.03.2017;2017;03;02;Lauantai;2;0;2;2;0;2
293;11.03.2017;2017;03;03;Lauantai;0;0;0;0;0;0
293;11.03.2017;2017;03;04;Lauantai;0;0;0;0;0;0
293;11.03.2017;2017;03;05;Lauantai;0;0;0;1;0;1
293;11.03.2017;2017;03;06;Lauantai;0;0;0;0;0;0
293;11.03.2017;2017;03;07;Lauantai;1;0;1;0;1;1
293;11.03.2017;2017;03;08;Lauantai;2;0;2;4;2;6
293;11.03.2017;2017;03;09;Lauantai;3;3;6;1;3;4
293;11.03.2017;2017;03;10;Lauantai;2;3;5;3;3;6
293;11.03.2017;2017;03;11;Lauantai;4;2;6;3;5;8
293;11.03.2017;2017;03;12;Lauantai;6;6;12;7;3;10
293;11.03.2017;2017;03;13;Lauantai;4;5;9;7;5;12
293;11.03.2017;2017;03;14;Lauantai;7;3;10;2;0;2
293;11.03.2017;2017;03;15;Lauantai;5;4;9;5;2;7
293;11.03.2017;2017;03;16;Lauantai;7;8;15;2;2;4
293;11.03.2017;2017;03;17;Lauantai;5;13;18;2;3;5
293;11.03.2017;2017;03;18;Lauantai;7;6;13;5;1;6
293;11.03.2017;2017;03;19;Lauantai;9;0;9;0;0;0
293;11.03.2017;2017;03;20;Lauantai;3;2;5;0;0;0
293;11.03.2017;2017;03;21;Lauantai;3;4;7;1;0;1
293;11.03.2017;2017;03;22;Lauantai;0;1;1;0;0;0
293;11.03.2017;2017;03;23;Lauantai;0;1;1;0;0;0
293;12.03.2017;2017;03;00;Sunnuntai;0;1;1;1;1;2
293;12.03.2017;2017;03;01;Sunnuntai;2;0;2;0;0;0
293;12.03.2017;2017;03;02;Sunnuntai;0;0;0;0;0;0
293;12.03.2017;2017;03;03;Sunnuntai;0;2;2;0;1;1
293;12.03.2017;2017;03;04;Sunnuntai;0;0;0;0;0;0
293;12.03.2017;2017;03;05;Sunnuntai;0;0;0;0;0;0
293;12.03.2017;2017;03;06;Sunnuntai;0;0;0;0;0;0
293;12.03.2017;2017;03;07;Sunnuntai;1;0;1;1;0;1
293;12.03.2017;2017;03;08;Sunnuntai;1;1;2;3;0;3
293;12.03.2017;2017;03;09;Sunnuntai;4;1;5;0;0;0
293;12.03.2017;2017;03;10;Sunnuntai;2;2;4;0;2;2
293;12.03.2017;2017;03;11;Sunnuntai;5;5;10;5;5;10
293;12.03.2017;2017;03;12;Sunnuntai;5;6;11;3;3;6
293;12.03.2017;2017;03;13;Sunnuntai;1;4;5;5;1;6
293;12.03.2017;2017;03;14;Sunnuntai;4;5;9;4;3;7
293;12.03.2017;2017;03;15;Sunnuntai;8;7;15;2;2;4
293;12.03.2017;2017;03;16;Sunnuntai;3;2;5;3;2;5
293;12.03.2017;2017;03;17;Sunnuntai;4;7;11;2;4;6
293;12.03.2017;2017;03;18;Sunnuntai;1;1;2;3;2;5
293;12.03.2017;2017;03;19;Sunnuntai;2;4;6;0;1;1
293;12.03.2017;2017;03;20;Sunnuntai;1;0;1;1;0;1
293;12.03.2017;2017;03;21;Sunnuntai;0;3;3;0;0;0
293;12.03.2017;2017;03;22;Sunnuntai;0;0;0;1;0;1
293;12.03.2017;2017;03;23;Sunnuntai;0;0;0;0;1;1
293;13.03.2017;2017;03;00;Maanantai;0;0;0;0;0;0
293;13.03.2017;2017;03;01;Maanantai;0;0;0;0;0;0
293;13.03.2017;2017;03;02;Maanantai;0;0;0;0;1;1
293;13.03.2017;2017;03;03;Maanantai;0;0;0;0;0;0
293;13.03.2017;2017;03;04;Maanantai;0;0;0;0;0;0
293;13.03.2017;2017;03;05;Maanantai;3;0;3;0;0;0
293;13.03.2017;2017;03;06;Maanantai;6;1;7;3;0;3
293;13.03.2017;2017;03;07;Maanantai;89;8;97;5;1;6
293;13.03.2017;2017;03;08;Maanantai;64;6;70;3;2;5
293;13.03.2017;2017;03;09;Maanantai;28;4;32;4;1;5
293;13.03.2017;2017;03;10;Maanantai;9;3;12;5;0;5
293;13.03.2017;2017;03;11;Maanantai;3;1;4;4;1;5
293;13.03.2017;2017;03;12;Maanantai;5;3;8;6;7;13
293;13.03.2017;2017;03;13;Maanantai;2;38;40;2;3;5
293;13.03.2017;2017;03;14;Maanantai;7;65;72;4;4;8
293;13.03.2017;2017;03;15;Maanantai;13;77;90;3;10;13
293;13.03.2017;2017;03;16;Maanantai;4;7;11;2;1;3
293;13.03.2017;2017;03;17;Maanantai;8;8;16;2;0;2
293;13.03.2017;2017;03;18;Maanantai;6;8;14;3;1;4
293;13.03.2017;2017;03;19;Maanantai;7;8;15;4;1;5
293;13.03.2017;2017;03;20;Maanantai;1;1;2;0;0;0
293;13.03.2017;2017;03;21;Maanantai;2;1;3;0;0;0
293;13.03.2017;2017;03;22;Maanantai;1;0;1;0;0;0
293;13.03.2017;2017;03;23;Maanantai;0;0;0;0;0;0
293;14.03.2017;2017;03;00;Tiistai;0;0;0;0;0;0
293;14.03.2017;2017;03;01;Tiistai;0;0;0;0;0;0
293;14.03.2017;2017;03;02;Tiistai;0;0;0;0;0;0
293;14.03.2017;2017;03;03;Tiistai;0;0;0;0;0;0
293;14.03.2017;2017;03;04;Tiistai;0;0;0;0;0;0
293;14.03.2017;2017;03;05;Tiistai;1;0;1;0;0;0
293;14.03.2017;2017;03;06;Tiistai;3;4;7;2;0;2
293;14.03.2017;2017;03;07;Tiistai;39;14;53;1;0;1
293;14.03.2017;2017;03;08;Tiistai;42;17;59;1;0;1
293;14.03.2017;2017;03;09;Tiistai;30;12;42;2;1;3
293;14.03.2017;2017;03;10;Tiistai;11;6;17;1;0;1
293;14.03.2017;2017;03;11;Tiistai;7;4;11;0;0;0
293;14.03.2017;2017;03;12;Tiistai;6;5;11;0;1;1
293;14.03.2017;2017;03;13;Tiistai;6;8;14;1;0;1
293;14.03.2017;2017;03;14;Tiistai;10;32;42;1;1;2
293;14.03.2017;2017;03;15;Tiistai;11;77;88;2;3;5
293;14.03.2017;2017;03;16;Tiistai;11;17;28;1;0;1
293;14.03.2017;2017;03;17;Tiistai;4;5;9;3;1;4
293;14.03.2017;2017;03;18;Tiistai;4;6;10;1;0;1
293;14.03.2017;2017;03;19;Tiistai;1;1;2;1;0;1
293;14.03.2017;2017;03;20;Tiistai;3;3;6;1;0;1
293;14.03.2017;2017;03;21;Tiistai;0;0;0;0;0;0
293;14.03.2017;2017;03;22;Tiistai;0;0;0;0;0;0
293;14.03.2017;2017;03;23;Tiistai;0;0;0;0;0;0
293;15.03.2017;2017;03;00;Keskiviikko;0;0;0;0;0;0
293;15.03.2017;2017;03;01;Keskiviikko;0;0;0;0;0;0
293;15.03.2017;2017;03;02;Keskiviikko;0;0;0;0;0;0
293;15.03.2017;2017;03;03;Keskiviikko;0;0;0;0;0;0
293;15.03.2017;2017;03;04;Keskiviikko;0;0;0;0;0;0
293;15.03.2017;2017;03;05;Keskiviikko;0;0;0;0;0;0
293;15.03.2017;2017;03;06;Keskiviikko;4;3;7;0;0;0
293;15.03.2017;2017;03;07;Keskiviikko;69;14;83;5;0;5
293;15.03.2017;2017;03;08;Keskiviikko;51;10;61;3;1;4
293;15.03.2017;2017;03;09;Keskiviikko;15;5;20;4;3;7
293;15.03.2017;2017;03;10;Keskiviikko;3;2;5;4;2;6
293;15.03.2017;2017;03;11;Keskiviikko;2;4;6;5;0;5
293;15.03.2017;2017;03;12;Keskiviikko;7;14;21;2;4;6
293;15.03.2017;2017;03;13;Keskiviikko;1;25;26;0;3;3
293;15.03.2017;2017;03;14;Keskiviikko;4;84;88;5;16;21
293;15.03.2017;2017;03;15;Keskiviikko;3;21;24;1;4;5
293;15.03.2017;2017;03;16;Keskiviikko;5;8;13;4;4;8
293;15.03.2017;2017;03;17;Keskiviikko;6;5;11;3;2;5
293;15.03.2017;2017;03;18;Keskiviikko;2;2;4;2;2;4
293;15.03.2017;2017;03;19;Keskiviikko;1;3;4;0;1;1
293;15.03.2017;2017;03;20;Keskiviikko;1;3;4;0;0;0
293;15.03.2017;2017;03;21;Keskiviikko;1;2;3;0;0;0
293;15.03.2017;2017;03;22;Keskiviikko;0;1;1;0;0;0
293;15.03.2017;2017;03;23;Keskiviikko;1;2;3;8;9;17
293;16.03.2017;2017;03;00;Torstai;0;0;0;0;0;0
293;16.03.2017;2017;03;01;Torstai;0;0;0;0;0;0
293;16.03.2017;2017;03;02;Torstai;0;0;0;0;0;0
293;16.03.2017;2017;03;03;Torstai;0;0;0;0;0;0
293;16.03.2017;2017;03;04;Torstai;0;0;0;0;0;0
293;16.03.2017;2017;03;05;Torstai;0;0;0;0;0;0
293;16.03.2017;2017;03;06;Torstai;5;3;8;1;0;1
293;16.03.2017;2017;03;07;Torstai;68;8;76;7;0;7
293;16.03.2017;2017;03;08;Torstai;62;8;70;5;0;5
293;16.03.2017;2017;03;09;Torstai;10;4;14;5;0;5
293;16.03.2017;2017;03;10;Torstai;5;3;8;3;1;4
293;16.03.2017;2017;03;11;Torstai;2;2;4;3;4;7
293;16.03.2017;2017;03;12;Torstai;4;2;6;7;3;10
293;16.03.2017;2017;03;13;Torstai;4;20;24;9;11;20
293;16.03.2017;2017;03;14;Torstai;3;65;68;9;14;23
293;16.03.2017;2017;03;15;Torstai;9;52;61;0;13;13
293;16.03.2017;2017;03;16;Torstai;10;8;18;3;4;7
293;16.03.2017;2017;03;17;Torstai;12;5;17;2;1;3
293;16.03.2017;2017;03;18;Torstai;5;6;11;1;3;4
293;16.03.2017;2017;03;19;Torstai;7;9;16;2;2;4
293;16.03.2017;2017;03;20;Torstai;4;3;7;1;1;2
293;16.03.2017;2017;03;21;Torstai;2;6;8;1;1;2
293;16.03.2017;2017;03;22;Torstai;0;0;0;0;0;0
293;16.03.2017;2017;03;23;Torstai;0;0;0;0;0;0
293;17.03.2017;2017;03;00;Perjantai;0;0;0;0;0;0
293;17.03.2017;2017;03;01;Perjantai;0;0;0;0;0;0
293;17.03.2017;2017;03;02;Perjantai;0;0;0;0;0;0
293;17.03.2017;2017;03;03;Perjantai;0;0;0;0;0;0
293;17.03.2017;2017;03;04;Perjantai;0;0;0;0;0;0
293;17.03.2017;2017;03;05;Perjantai;1;0;1;0;0;0
293;17.03.2017;2017;03;06;Perjantai;0;0;0;0;0;0
293;17.03.2017;2017;03;07;Perjantai;22;14;36;0;0;0
293;17.03.2017;2017;03;08;Perjantai;28;15;43;2;0;2
293;17.03.2017;2017;03;09;Perjantai;14;7;21;1;0;1
293;17.03.2017;2017;03;10;Perjantai;9;5;14;1;1;2
293;17.03.2017;2017;03;11;Perjantai;4;3;7;0;0;0
293;17.03.2017;2017;03;12;Perjantai;6;16;22;0;2;2
293;17.03.2017;2017;03;13;Perjantai;8;13;21;2;2;4
293;17.03.2017;2017;03;14;Perjantai;9;45;54;0;0;0
293;17.03.2017;2017;03;15;Perjantai;6;20;26;1;4;5
293;17.03.2017;2017;03;16;Perjantai;1;1;2;1;1;2
293;17.03.2017;2017;03;17;Perjantai;1;1;2;1;1;2
293;17.03.2017;2017;03;18;Perjantai;2;0;2;0;2;2
293;17.03.2017;2017;03;19;Perjantai;3;3;6;0;1;1
293;17.03.2017;2017;03;20;Perjantai;1;2;3;2;0;2
293;17.03.2017;2017;03;21;Perjantai;1;1;2;4;1;5
293;17.03.2017;2017;03;22;Perjantai;1;1;2;0;0;0
293;17.03.2017;2017;03;23;Perjantai;5;0;5;1;1;2
293;18.03.2017;2017;03;00;Lauantai;0;0;0;0;0;0
293;18.03.2017;2017;03;01;Lauantai;0;0;0;1;0;1
293;18.03.2017;2017;03;02;Lauantai;1;0;1;0;0;0
293;18.03.2017;2017;03;03;Lauantai;0;0;0;0;1;1
293;18.03.2017;2017;03;04;Lauantai;0;0;0;0;0;0
293;18.03.2017;2017;03;05;Lauantai;0;0;0;0;0;0
293;18.03.2017;2017;03;06;Lauantai;0;0;0;2;0;2
293;18.03.2017;2017;03;07;Lauantai;0;0;0;0;0;0
293;18.03.2017;2017;03;08;Lauantai;0;0;0;2;1;3
293;18.03.2017;2017;03;09;Lauantai;2;1;3;1;0;1
293;18.03.2017;2017;03;10;Lauantai;5;2;7;1;0;1
293;18.03.2017;2017;03;11;Lauantai;3;4;7;5;23;28
293;18.03.2017;2017;03;12;Lauantai;1;1;2;2;7;9
293;18.03.2017;2017;03;13;Lauantai;2;7;9;2;1;3
293;18.03.2017;2017;03;14;Lauantai;2;2;4;3;0;3
293;18.03.2017;2017;03;15;Lauantai;14;9;23;6;3;9
293;18.03.2017;2017;03;16;Lauantai;1;7;8;3;6;9
293;18.03.2017;2017;03;17;Lauantai;2;3;5;5;5;10
293;18.03.2017;2017;03;18;Lauantai;6;3;9;3;2;5
293;18.03.2017;2017;03;19;Lauantai;6;6;12;2;0;2
293;18.03.2017;2017;03;20;Lauantai;4;1;5;1;3;4
293;18.03.2017;2017;03;21;Lauantai;1;4;5;3;1;4
293;18.03.2017;2017;03;22;Lauantai;3;1;4;0;0;0
293;18.03.2017;2017;03;23;Lauantai;3;0;3;0;1;1
293;19.03.2017;2017;03;00;Sunnuntai;0;0;0;1;1;2
293;19.03.2017;2017;03;01;Sunnuntai;0;0;0;0;0;0
293;19.03.2017;2017;03;02;Sunnuntai;0;0;0;0;0;0
293;19.03.2017;2017;03;03;Sunnuntai;0;0;0;2;3;5
293;19.03.2017;2017;03;04;Sunnuntai;0;0;0;0;0;0
293;19.03.2017;2017;03;05;Sunnuntai;0;0;0;1;1;2
293;19.03.2017;2017;03;06;Sunnuntai;0;0;0;1;1;2
293;19.03.2017;2017;03;07;Sunnuntai;0;0;0;1;2;3
293;19.03.2017;2017;03;08;Sunnuntai;3;0;3;3;0;3
293;19.03.2017;2017;03;09;Sunnuntai;9;0;9;0;2;2
293;19.03.2017;2017;03;10;Sunnuntai;3;2;5;4;2;6
293;19.03.2017;2017;03;11;Sunnuntai;2;11;13;4;2;6
293;19.03.2017;2017;03;12;Sunnuntai;3;3;6;6;5;11
293;19.03.2017;2017;03;13;Sunnuntai;3;1;4;8;2;10
293;19.03.2017;2017;03;14;Sunnuntai;6;6;12;6;5;11
293;19.03.2017;2017;03;15;Sunnuntai;2;3;5;5;4;9
293;19.03.2017;2017;03;16;Sunnuntai;1;3;4;4;3;7
293;19.03.2017;2017;03;17;Sunnuntai;2;3;5;4;0;4
293;19.03.2017;2017;03;18;Sunnuntai;2;2;4;3;3;6
293;19.03.2017;2017;03;19;Sunnuntai;5;5;10;0;0;0
293;19.03.2017;2017;03;20;Sunnuntai;1;4;5;0;1;1
293;19.03.2017;2017;03;21;Sunnuntai;1;0;1;4;0;4
293;19.03.2017;2017;03;22;Sunnuntai;0;0;0;0;0;0
293;19.03.2017;2017;03;23;Sunnuntai;0;0;0;0;0;0
293;20.03.2017;2017;03;00;Maanantai;0;0;0;0;0;0
293;20.03.2017;2017;03;01;Maanantai;0;0;0;0;0;0
293;20.03.2017;2017;03;02;Maanantai;0;0;0;0;0;0
293;20.03.2017;2017;03;03;Maanantai;0;0;0;0;0;0
293;20.03.2017;2017;03;04;Maanantai;0;0;0;0;0;0
293;20.03.2017;2017;03;05;Maanantai;1;0;1;0;0;0
293;20.03.2017;2017;03;06;Maanantai;3;0;3;5;0;5
293;20.03.2017;2017;03;07;Maanantai;58;4;62;12;3;15
293;20.03.2017;2017;03;08;Maanantai;66;9;75;10;3;13
293;20.03.2017;2017;03;09;Maanantai;11;4;15;4;5;9
293;20.03.2017;2017;03;10;Maanantai;12;5;17;9;3;12
293;20.03.2017;2017;03;11;Maanantai;2;1;3;4;8;12
293;20.03.2017;2017;03;12;Maanantai;2;1;3;3;2;5
293;20.03.2017;2017;03;13;Maanantai;4;22;26;5;15;20
293;20.03.2017;2017;03;14;Maanantai;3;41;44;4;16;20
293;20.03.2017;2017;03;15;Maanantai;7;74;81;2;21;23
293;20.03.2017;2017;03;16;Maanantai;6;11;17;6;4;10
293;20.03.2017;2017;03;17;Maanantai;6;9;15;4;5;9
293;20.03.2017;2017;03;18;Maanantai;4;9;13;4;1;5
293;20.03.2017;2017;03;19;Maanantai;4;3;7;3;1;4
293;20.03.2017;2017;03;20;Maanantai;1;1;2;3;2;5
293;20.03.2017;2017;03;21;Maanantai;0;0;0;0;0;0
293;20.03.2017;2017;03;22;Maanantai;0;0;0;0;0;0
293;20.03.2017;2017;03;23;Maanantai;0;0;0;0;0;0
293;21.03.2017;2017;03;00;Tiistai;0;0;0;0;0;0
293;21.03.2017;2017;03;01;Tiistai;0;0;0;0;0;0
293;21.03.2017;2017;03;02;Tiistai;0;0;0;0;0;0
293;21.03.2017;2017;03;03;Tiistai;0;0;0;4;0;4
293;21.03.2017;2017;03;04;Tiistai;0;0;0;0;0;0
293;21.03.2017;2017;03;05;Tiistai;0;0;0;0;0;0
293;21.03.2017;2017;03;06;Tiistai;6;1;7;1;0;1
293;21.03.2017;2017;03;07;Tiistai;18;5;23;3;0;3
293;21.03.2017;2017;03;08;Tiistai;41;9;50;7;0;7
293;21.03.2017;2017;03;09;Tiistai;32;6;38;10;2;12
293;21.03.2017;2017;03;10;Tiistai;18;5;23;3;3;6
293;21.03.2017;2017;03;11;Tiistai;3;1;4;2;1;3
293;21.03.2017;2017;03;12;Tiistai;4;11;15;2;8;10
293;21.03.2017;2017;03;13;Tiistai;4;28;32;3;2;5
293;21.03.2017;2017;03;14;Tiistai;9;18;27;3;2;5
293;21.03.2017;2017;03;15;Tiistai;5;39;44;4;6;10
293;21.03.2017;2017;03;16;Tiistai;6;9;15;2;1;3
293;21.03.2017;2017;03;17;Tiistai;4;4;8;0;4;4
293;21.03.2017;2017;03;18;Tiistai;6;5;11;4;3;7
293;21.03.2017;2017;03;19;Tiistai;2;6;8;5;5;10
293;21.03.2017;2017;03;20;Tiistai;3;5;8;0;2;2
293;21.03.2017;2017;03;21;Tiistai;0;2;2;0;0;0
293;21.03.2017;2017;03;22;Tiistai;1;0;1;0;0;0
293;21.03.2017;2017;03;23;Tiistai;0;0;0;0;0;0
293;22.03.2017;2017;03;00;Keskiviikko;0;0;0;0;0;0
293;22.03.2017;2017;03;01;Keskiviikko;0;0;0;0;0;0
293;22.03.2017;2017;03;02;Keskiviikko;0;0;0;0;0;0
293;22.03.2017;2017;03;03;Keskiviikko;0;0;0;0;0;0
293;22.03.2017;2017;03;04;Keskiviikko;0;0;0;0;0;0
293;22.03.2017;2017;03;05;Keskiviikko;0;0;0;0;0;0
293;22.03.2017;2017;03;06;Keskiviikko;4;0;4;0;0;0
293;22.03.2017;2017;03;07;Keskiviikko;63;9;72;12;1;13
293;22.03.2017;2017;03;08;Keskiviikko;58;8;66;4;1;5
293;22.03.2017;2017;03;09;Keskiviikko;10;3;13;4;1;5
293;22.03.2017;2017;03;10;Keskiviikko;7;6;13;20;1;21
293;22.03.2017;2017;03;11;Keskiviikko;5;3;8;1;1;2
293;22.03.2017;2017;03;12;Keskiviikko;3;5;8;4;4;8
293;22.03.2017;2017;03;13;Keskiviikko;6;28;34;3;7;10
293;22.03.2017;2017;03;14;Keskiviikko;9;87;96;1;12;13
293;22.03.2017;2017;03;15;Keskiviikko;6;24;30;4;7;11
293;22.03.2017;2017;03;16;Keskiviikko;7;8;15;1;3;4
293;22.03.2017;2017;03;17;Keskiviikko;7;6;13;2;3;5
293;22.03.2017;2017;03;18;Keskiviikko;5;3;8;5;5;10
293;22.03.2017;2017;03;19;Keskiviikko;3;6;9;3;1;4
293;22.03.2017;2017;03;20;Keskiviikko;0;8;8;3;3;6
293;22.03.2017;2017;03;21;Keskiviikko;1;3;4;0;0;0
293;22.03.2017;2017;03;22;Keskiviikko;0;0;0;0;0;0
293;22.03.2017;2017;03;23;Keskiviikko;0;0;0;0;0;0
293;23.03.2017;2017;03;00;Torstai;0;0;0;0;0;0
293;23.03.2017;2017;03;01;Torstai;0;0;0;0;0;0
293;23.03.2017;2017;03;02;Torstai;0;0;0;0;0;0
293;23.03.2017;2017;03;03;Torstai;1;0;1;0;0;0
293;23.03.2017;2017;03;04;Torstai;0;0;0;0;0;0
293;23.03.2017;2017;03;05;Torstai;0;0;0;0;0;0
293;23.03.2017;2017;03;06;Torstai;3;3;6;0;0;0
293;23.03.2017;2017;03;07;Torstai;68;8;76;9;1;10
293;23.03.2017;2017;03;08;Torstai;58;3;61;8;1;9
293;23.03.2017;2017;03;09;Torstai;8;1;9;6;1;7
293;23.03.2017;2017;03;10;Torstai;6;3;9;5;2;7
293;23.03.2017;2017;03;11;Torstai;2;2;4;1;1;2
293;23.03.2017;2017;03;12;Torstai;6;4;10;7;2;9
293;23.03.2017;2017;03;13;Torstai;3;25;28;6;6;12
293;23.03.2017;2017;03;14;Torstai;5;64;69;6;6;12
293;23.03.2017;2017;03;15;Torstai;5;63;68;0;9;9
293;23.03.2017;2017;03;16;Torstai;7;7;14;3;5;8
293;23.03.2017;2017;03;17;Torstai;7;10;17;4;2;6
293;23.03.2017;2017;03;18;Torstai;7;7;14;6;5;11
293;23.03.2017;2017;03;19;Torstai;3;8;11;3;1;4
293;23.03.2017;2017;03;20;Torstai;6;6;12;1;4;5
293;23.03.2017;2017;03;21;Torstai;0;0;0;1;1;2
293;23.03.2017;2017;03;22;Torstai;2;0;2;1;0;1
293;23.03.2017;2017;03;23;Torstai;1;1;2;0;0;0
293;24.03.2017;2017;03;00;Perjantai;0;0;0;0;0;0
293;24.03.2017;2017;03;01;Perjantai;0;1;1;0;0;0
293;24.03.2017;2017;03;02;Perjantai;0;0;0;0;0;0
293;24.03.2017;2017;03;03;Perjantai;0;0;0;0;0;0
293;24.03.2017;2017;03;04;Perjantai;1;0;1;0;0;0
293;24.03.2017;2017;03;05;Perjantai;0;0;0;0;0;0
293;24.03.2017;2017;03;06;Perjantai;2;0;2;1;0;1
293;24.03.2017;2017;03;07;Perjantai;53;1;54;11;1;12
293;24.03.2017;2017;03;08;Perjantai;49;3;52;13;1;14
293;24.03.2017;2017;03;09;Perjantai;24;8;32;8;3;11
293;24.03.2017;2017;03;10;Perjantai;10;2;12;6;1;7
293;24.03.2017;2017;03;11;Perjantai;5;7;12;4;4;8
293;24.03.2017;2017;03;12;Perjantai;4;10;14;6;4;10
293;24.03.2017;2017;03;13;Perjantai;5;37;42;4;6;10
293;24.03.2017;2017;03;14;Perjantai;2;66;68;15;17;32
293;24.03.2017;2017;03;15;Perjantai;5;34;39;11;7;18
293;24.03.2017;2017;03;16;Perjantai;2;8;10;1;7;8
293;24.03.2017;2017;03;17;Perjantai;8;6;14;8;6;14
293;24.03.2017;2017;03;18;Perjantai;5;6;11;6;4;10
293;24.03.2017;2017;03;19;Perjantai;7;12;19;2;3;5
293;24.03.2017;2017;03;20;Perjantai;5;2;7;1;1;2
293;24.03.2017;2017;03;21;Perjantai;1;0;1;0;0;0
293;24.03.2017;2017;03;22;Perjantai;3;1;4;1;0;1
293;24.03.2017;2017;03;23;Perjantai;0;0;0;0;0;0
293;25.03.2017;2017;03;00;Lauantai;0;1;1;4;1;5
293;25.03.2017;2017;03;01;Lauantai;0;0;0;0;0;0
293;25.03.2017;2017;03;02;Lauantai;0;0;0;0;1;1
293;25.03.2017;2017;03;03;Lauantai;0;0;0;0;0;0
293;25.03.2017;2017;03;04;Lauantai;0;0;0;0;0;0
293;25.03.2017;2017;03;05;Lauantai;0;0;0;0;0;0
293;25.03.2017;2017;03;06;Lauantai;2;0;2;3;0;3
293;25.03.2017;2017;03;07;Lauantai;1;0;1;2;1;3
293;25.03.2017;2017;03;08;Lauantai;1;0;1;3;1;4
293;25.03.2017;2017;03;09;Lauantai;2;1;3;7;3;10
293;25.03.2017;2017;03;10;Lauantai;4;0;4;8;0;8
293;25.03.2017;2017;03;11;Lauantai;4;2;6;2;3;5
293;25.03.2017;2017;03;12;Lauantai;9;3;12;6;0;6
293;25.03.2017;2017;03;13;Lauantai;4;4;8;7;2;9
293;25.03.2017;2017;03;14;Lauantai;3;4;7;3;4;7
293;25.03.2017;2017;03;15;Lauantai;6;2;8;7;4;11
293;25.03.2017;2017;03;16;Lauantai;2;7;9;4;3;7
293;25.03.2017;2017;03;17;Lauantai;3;4;7;5;3;8
293;25.03.2017;2017;03;18;Lauantai;2;5;7;1;0;1
293;25.03.2017;2017;03;19;Lauantai;3;1;4;2;1;3
293;25.03.2017;2017;03;20;Lauantai;3;2;5;0;1;1
293;25.03.2017;2017;03;21;Lauantai;2;2;4;1;1;2
293;25.03.2017;2017;03;22;Lauantai;2;1;3;0;0;0
293;25.03.2017;2017;03;23;Lauantai;0;0;0;6;2;8
293;26.03.2017;2017;03;00;Sunnuntai;0;0;0;1;0;1
293;26.03.2017;2017;03;01;Sunnuntai;0;0;0;3;3;6
293;26.03.2017;2017;03;02;Sunnuntai;0;0;0;0;0;0
293;26.03.2017;2017;03;03;Sunnuntai;0;0;0;0;0;0
293;26.03.2017;2017;03;04;Sunnuntai;0;1;1;0;3;3
293;26.03.2017;2017;03;05;Sunnuntai;0;0;0;0;0;0
293;26.03.2017;2017;03;06;Sunnuntai;1;0;1;0;0;0
293;26.03.2017;2017;03;07;Sunnuntai;0;0;0;0;0;0
293;26.03.2017;2017;03;08;Sunnuntai;2;0;2;0;1;1
293;26.03.2017;2017;03;09;Sunnuntai;8;1;9;1;1;2
293;26.03.2017;2017;03;10;Sunnuntai;1;1;2;4;1;5
293;26.03.2017;2017;03;11;Sunnuntai;3;9;12;5;1;6
293;26.03.2017;2017;03;12;Sunnuntai;9;6;15;4;6;10
293;26.03.2017;2017;03;13;Sunnuntai;3;5;8;12;2;14
293;26.03.2017;2017;03;14;Sunnuntai;4;11;15;5;4;9
293;26.03.2017;2017;03;15;Sunnuntai;6;4;10;3;2;5
293;26.03.2017;2017;03;16;Sunnuntai;6;1;7;3;1;4
293;26.03.2017;2017;03;17;Sunnuntai;6;5;11;8;3;11
293;26.03.2017;2017;03;18;Sunnuntai;1;2;3;2;4;6
293;26.03.2017;2017;03;19;Sunnuntai;9;7;16;3;0;3
293;26.03.2017;2017;03;20;Sunnuntai;3;1;4;5;3;8
293;26.03.2017;2017;03;21;Sunnuntai;0;0;0;1;0;1
293;26.03.2017;2017;03;22;Sunnuntai;0;0;0;0;0;0
293;26.03.2017;2017;03;23;Sunnuntai;0;0;0;0;0;0
293;27.03.2017;2017;03;00;Maanantai;0;0;0;0;0;0
293;27.03.2017;2017;03;01;Maanantai;0;0;0;0;0;0
293;27.03.2017;2017;03;02;Maanantai;0;0;0;0;0;0
293;27.03.2017;2017;03;03;Maanantai;0;1;1;0;2;2
293;27.03.2017;2017;03;04;Maanantai;0;0;0;0;0;0
293;27.03.2017;2017;03;05;Maanantai;0;0;0;0;0;0
293;27.03.2017;2017;03;06;Maanantai;3;1;4;4;0;4
293;27.03.2017;2017;03;07;Maanantai;53;12;65;15;0;15
293;27.03.2017;2017;03;08;Maanantai;54;6;60;6;0;6
293;27.03.2017;2017;03;09;Maanantai;10;0;10;5;0;5
293;27.03.2017;2017;03;10;Maanantai;9;2;11;1;0;1
293;27.03.2017;2017;03;11;Maanantai;2;1;3;1;0;1
293;27.03.2017;2017;03;12;Maanantai;2;4;6;3;3;6
293;27.03.2017;2017;03;13;Maanantai;2;22;24;3;4;7
293;27.03.2017;2017;03;14;Maanantai;9;42;51;3;3;6
293;27.03.2017;2017;03;15;Maanantai;11;52;63;0;7;7
293;27.03.2017;2017;03;16;Maanantai;4;5;9;4;3;7
293;27.03.2017;2017;03;17;Maanantai;5;4;9;2;3;5
293;27.03.2017;2017;03;18;Maanantai;5;5;10;3;0;3
293;27.03.2017;2017;03;19;Maanantai;4;4;8;2;3;5
293;27.03.2017;2017;03;20;Maanantai;2;2;4;2;1;3
293;27.03.2017;2017;03;21;Maanantai;1;1;2;1;1;2
293;27.03.2017;2017;03;22;Maanantai;0;0;0;0;0;0
293;27.03.2017;2017;03;23;Maanantai;0;0;0;0;0;0
293;28.03.2017;2017;03;00;Tiistai;0;0;0;0;0;0
293;28.03.2017;2017;03;01;Tiistai;0;0;0;0;0;0
293;28.03.2017;2017;03;02;Tiistai;0;0;0;0;0;0
293;28.03.2017;2017;03;03;Tiistai;0;0;0;0;0;0
293;28.03.2017;2017;03;04;Tiistai;0;0;0;0;0;0
293;28.03.2017;2017;03;05;Tiistai;1;1;2;0;0;0
293;28.03.2017;2017;03;06;Tiistai;3;2;5;2;0;2
293;28.03.2017;2017;03;07;Tiistai;34;6;40;9;0;9
293;28.03.2017;2017;03;08;Tiistai;48;12;60;7;0;7
293;28.03.2017;2017;03;09;Tiistai;28;4;32;10;1;11
293;28.03.2017;2017;03;10;Tiistai;19;3;22;5;0;5
293;28.03.2017;2017;03;11;Tiistai;3;0;3;1;0;1
293;28.03.2017;2017;03;12;Tiistai;3;6;9;4;2;6
293;28.03.2017;2017;03;13;Tiistai;4;9;13;2;1;3
293;28.03.2017;2017;03;14;Tiistai;7;33;40;7;3;10
293;28.03.2017;2017;03;15;Tiistai;15;76;91;3;8;11
293;28.03.2017;2017;03;16;Tiistai;8;4;12;6;1;7
293;28.03.2017;2017;03;17;Tiistai;7;7;14;6;1;7
293;28.03.2017;2017;03;18;Tiistai;6;10;16;1;2;3
293;28.03.2017;2017;03;19;Tiistai;3;6;9;7;0;7
293;28.03.2017;2017;03;20;Tiistai;2;7;9;6;1;7
293;28.03.2017;2017;03;21;Tiistai;2;3;5;1;3;4
293;28.03.2017;2017;03;22;Tiistai;0;0;0;0;0;0
293;28.03.2017;2017;03;23;Tiistai;0;0;0;0;0;0
293;29.03.2017;2017;03;00;Keskiviikko;0;0;0;0;0;0
293;29.03.2017;2017;03;01;Keskiviikko;0;0;0;0;0;0
293;29.03.2017;2017;03;02;Keskiviikko;0;0;0;0;0;0
293;29.03.2017;2017;03;03;Keskiviikko;0;0;0;0;0;0
293;29.03.2017;2017;03;04;Keskiviikko;0;0;0;0;0;0
293;29.03.2017;2017;03;05;Keskiviikko;0;0;0;1;0;1
293;29.03.2017;2017;03;06;Keskiviikko;1;0;1;1;0;1
293;29.03.2017;2017;03;07;Keskiviikko;41;5;46;11;3;14
293;29.03.2017;2017;03;08;Keskiviikko;43;5;48;9;1;10
293;29.03.2017;2017;03;09;Keskiviikko;11;4;15;6;5;11
293;29.03.2017;2017;03;10;Keskiviikko;3;2;5;3;3;6
293;29.03.2017;2017;03;11;Keskiviikko;2;3;5;3;5;8
293;29.03.2017;2017;03;12;Keskiviikko;4;3;7;3;3;6
293;29.03.2017;2017;03;13;Keskiviikko;5;26;31;3;5;8
293;29.03.2017;2017;03;14;Keskiviikko;20;64;84;4;11;15
293;29.03.2017;2017;03;15;Keskiviikko;8;19;27;5;6;11
293;29.03.2017;2017;03;16;Keskiviikko;10;16;26;11;5;16
293;29.03.2017;2017;03;17;Keskiviikko;10;10;20;7;5;12
293;29.03.2017;2017;03;18;Keskiviikko;5;10;15;3;4;7
293;29.03.2017;2017;03;19;Keskiviikko;7;6;13;3;2;5
293;29.03.2017;2017;03;20;Keskiviikko;3;4;7;1;1;2
293;29.03.2017;2017;03;21;Keskiviikko;5;3;8;1;1;2
293;29.03.2017;2017;03;22;Keskiviikko;0;0;0;0;1;1
293;29.03.2017;2017;03;23;Keskiviikko;0;0;0;0;0;0
293;30.03.2017;2017;03;00;Torstai;0;0;0;0;0;0
293;30.03.2017;2017;03;01;Torstai;0;0;0;0;0;0
293;30.03.2017;2017;03;02;Torstai;0;0;0;0;0;0
293;30.03.2017;2017;03;03;Torstai;0;0;0;0;0;0
293;30.03.2017;2017;03;04;Torstai;0;0;0;0;0;0
293;30.03.2017;2017;03;05;Torstai;0;0;0;1;0;1
293;30.03.2017;2017;03;06;Torstai;4;0;4;1;0;1
293;30.03.2017;2017;03;07;Torstai;40;0;40;8;3;11
293;30.03.2017;2017;03;08;Torstai;80;0;80;9;4;13
293;30.03.2017;2017;03;09;Torstai;10;3;13;6;2;8
293;30.03.2017;2017;03;10;Torstai;6;3;9;5;3;8
293;30.03.2017;2017;03;11;Torstai;5;5;10;1;2;3
293;30.03.2017;2017;03;12;Torstai;4;10;14;3;6;9
293;30.03.2017;2017;03;13;Torstai;4;25;29;3;6;9
293;30.03.2017;2017;03;14;Torstai;4;74;78;4;11;15
293;30.03.2017;2017;03;15;Torstai;6;40;46;2;6;8
293;30.03.2017;2017;03;16;Torstai;6;10;16;3;6;9
293;30.03.2017;2017;03;17;Torstai;6;10;16;6;6;12
293;30.03.2017;2017;03;18;Torstai;6;10;16;3;1;4
293;30.03.2017;2017;03;19;Torstai;4;4;8;1;1;2
293;30.03.2017;2017;03;20;Torstai;5;5;10;1;1;2
293;30.03.2017;2017;03;21;Torstai;0;3;3;1;1;2
293;30.03.2017;2017;03;22;Torstai;0;0;0;0;1;1
293;30.03.2017;2017;03;23;Torstai;3;0;3;1;0;1
293;31.03.2017;2017;03;00;Perjantai;0;0;0;0;0;0
293;31.03.2017;2017;03;01;Perjantai;0;0;0;0;0;0
293;31.03.2017;2017;03;02;Perjantai;0;0;0;0;0;0
293;31.03.2017;2017;03;03;Perjantai;0;0;0;0;0;0
293;31.03.2017;2017;03;04;Perjantai;0;0;0;0;0;0
293;31.03.2017;2017;03;05;Perjantai;0;0;0;1;0;1
293;31.03.2017;2017;03;06;Perjantai;2;0;2;1;0;1
293;31.03.2017;2017;03;07;Perjantai;60;2;62;7;1;8
293;31.03.2017;2017;03;08;Perjantai;60;5;65;3;1;4
293;31.03.2017;2017;03;09;Perjantai;20;2;22;8;1;9
293;31.03.2017;2017;03;10;Perjantai;8;1;9;3;1;4
293;31.03.2017;2017;03;11;Perjantai;36;10;46;4;2;6
293;31.03.2017;2017;03;12;Perjantai;8;30;38;3;4;7
293;31.03.2017;2017;03;13;Perjantai;10;50;60;3;4;7
293;31.03.2017;2017;03;14;Perjantai;4;50;54;1;1;2
293;31.03.2017;2017;03;15;Perjantai;5;36;41;2;3;5
293;31.03.2017;2017;03;16;Perjantai;10;9;19;7;5;12
293;31.03.2017;2017;03;17;Perjantai;11;10;21;6;5;11
293;31.03.2017;2017;03;18;Perjantai;4;9;13;4;7;11
293;31.03.2017;2017;03;19;Perjantai;3;5;8;10;1;11
293;31.03.2017;2017;03;20;Perjantai;5;3;8;5;5;10
293;31.03.2017;2017;03;21;Perjantai;3;7;10;7;0;7
293;31.03.2017;2017;03;22;Perjantai;0;0;0;2;3;5
293;31.03.2017;2017;03;23;Perjantai;0;0;0;3;3;6
293;01.04.2017;2017;04;00;Lauantai;0;0;0;0;2;2
293;01.04.2017;2017;04;01;Lauantai;0;0;0;0;0;0
293;01.04.2017;2017;04;02;Lauantai;0;0;0;1;0;1
293;01.04.2017;2017;04;03;Lauantai;0;0;0;0;0;0
293;01.04.2017;2017;04;04;Lauantai;0;0;0;0;0;0
293;01.04.2017;2017;04;05;Lauantai;0;0;0;0;0;0
293;01.04.2017;2017;04;06;Lauantai;0;0;0;0;0;0
293;01.04.2017;2017;04;07;Lauantai;0;0;0;0;0;0
293;01.04.2017;2017;04;08;Lauantai;0;0;0;1;0;1
293;01.04.2017;2017;04;09;Lauantai;5;2;7;4;2;6
293;01.04.2017;2017;04;10;Lauantai;6;4;10;4;3;7
293;01.04.2017;2017;04;11;Lauantai;9;8;17;6;6;12
293;01.04.2017;2017;04;12;Lauantai;3;5;8;4;4;8
293;01.04.2017;2017;04;13;Lauantai;9;5;14;6;3;9
293;01.04.2017;2017;04;14;Lauantai;8;6;14;5;4;9
293;01.04.2017;2017;04;15;Lauantai;2;10;12;2;8;10
293;01.04.2017;2017;04;16;Lauantai;1;1;2;1;2;3
293;01.04.2017;2017;04;17;Lauantai;2;4;6;2;3;5
293;01.04.2017;2017;04;18;Lauantai;2;3;5;1;3;4
293;01.04.2017;2017;04;19;Lauantai;2;2;4;3;2;5
293;01.04.2017;2017;04;20;Lauantai;4;6;10;2;5;7
293;01.04.2017;2017;04;21;Lauantai;1;2;3;1;1;2
293;01.04.2017;2017;04;22;Lauantai;0;0;0;0;1;1
293;01.04.2017;2017;04;23;Lauantai;1;1;2;1;1;2
293;02.04.2017;2017;04;00;Sunnuntai;2;0;2;0;0;0
293;02.04.2017;2017;04;01;Sunnuntai;1;0;1;1;1;2
293;02.04.2017;2017;04;02;Sunnuntai;0;1;1;0;1;1
293;02.04.2017;2017;04;03;Sunnuntai;0;0;0;0;1;1
293;02.04.2017;2017;04;04;Sunnuntai;0;0;0;0;1;1
293;02.04.2017;2017;04;05;Sunnuntai;0;0;0;0;0;0
293;02.04.2017;2017;04;06;Sunnuntai;0;0;0;0;0;0
293;02.04.2017;2017;04;07;Sunnuntai;0;0;0;1;1;2
293;02.04.2017;2017;04;08;Sunnuntai;1;0;1;0;0;0
293;02.04.2017;2017;04;09;Sunnuntai;5;4;9;3;2;5
293;02.04.2017;2017;04;10;Sunnuntai;4;5;9;4;2;6
293;02.04.2017;2017;04;11;Sunnuntai;5;8;13;4;4;8
293;02.04.2017;2017;04;12;Sunnuntai;3;3;6;2;3;5
293;02.04.2017;2017;04;13;Sunnuntai;5;5;10;3;2;5
293;02.04.2017;2017;04;14;Sunnuntai;4;6;10;3;3;6
293;02.04.2017;2017;04;15;Sunnuntai;7;3;10;4;2;6
293;02.04.2017;2017;04;16;Sunnuntai;8;4;12;5;3;8
293;02.04.2017;2017;04;17;Sunnuntai;5;8;13;3;4;7
293;02.04.2017;2017;04;18;Sunnuntai;3;7;10;1;4;5
293;02.04.2017;2017;04;19;Sunnuntai;2;5;7;2;4;6
293;02.04.2017;2017;04;20;Sunnuntai;1;2;3;1;2;3
293;02.04.2017;2017;04;21;Sunnuntai;3;1;4;1;1;2
293;02.04.2017;2017;04;22;Sunnuntai;0;0;0;0;0;0
293;02.04.2017;2017;04;23;Sunnuntai;0;0;0;0;0;0
293;03.04.2017;2017;04;00;Maanantai;1;1;2;0;0;0
293;03.04.2017;2017;04;01;Maanantai;0;0;0;0;0;0
293;03.04.2017;2017;04;02;Maanantai;0;0;0;0;0;0
293;03.04.2017;2017;04;03;Maanantai;0;0;0;0;0;0
293;03.04.2017;2017;04;04;Maanantai;0;0;0;0;0;0
293;03.04.2017;2017;04;05;Maanantai;0;0;0;0;0;0
293;03.04.2017;2017;04;06;Maanantai;4;4;8;0;0;0
293;03.04.2017;2017;04;07;Maanantai;25;25;50;4;8;12
293;03.04.2017;2017;04;08;Maanantai;43;42;85;9;8;17
293;03.04.2017;2017;04;09;Maanantai;6;10;16;0;4;4
293;03.04.2017;2017;04;10;Maanantai;6;6;12;4;0;4
293;03.04.2017;2017;04;11;Maanantai;3;6;9;0;1;1
293;03.04.2017;2017;04;12;Maanantai;6;6;12;4;0;4
293;03.04.2017;2017;04;13;Maanantai;29;29;58;4;8;12
293;03.04.2017;2017;04;14;Maanantai;21;18;39;5;4;9
293;03.04.2017;2017;04;15;Maanantai;29;32;61;5;8;13
293;03.04.2017;2017;04;16;Maanantai;13;10;23;4;1;5
293;03.04.2017;2017;04;17;Maanantai;6;9;15;0;4;4
293;03.04.2017;2017;04;18;Maanantai;7;6;13;4;1;5
293;03.04.2017;2017;04;19;Maanantai;6;6;12;0;1;1
293;03.04.2017;2017;04;20;Maanantai;6;5;11;1;0;1
293;03.04.2017;2017;04;21;Maanantai;2;3;5;0;1;1
293;03.04.2017;2017;04;22;Maanantai;1;0;1;0;0;0
293;03.04.2017;2017;04;23;Maanantai;0;1;1;0;0;0
293;04.04.2017;2017;04;00;Tiistai;0;0;0;0;0;0
293;04.04.2017;2017;04;01;Tiistai;0;0;0;0;0;0
293;04.04.2017;2017;04;02;Tiistai;0;0;0;0;0;0
293;04.04.2017;2017;04;03;Tiistai;0;0;0;0;0;0
293;04.04.2017;2017;04;04;Tiistai;0;0;0;0;0;0
293;04.04.2017;2017;04;05;Tiistai;0;0;0;0;0;0
293;04.04.2017;2017;04;06;Tiistai;1;1;2;1;0;1
293;04.04.2017;2017;04;07;Tiistai;14;18;32;4;4;8
293;04.04.2017;2017;04;08;Tiistai;32;32;64;8;4;12
293;04.04.2017;2017;04;09;Tiistai;9;13;22;0;4;4
293;04.04.2017;2017;04;10;Tiistai;9;8;17;4;0;4
293;04.04.2017;2017;04;11;Tiistai;8;8;16;0;4;4
293;04.04.2017;2017;04;12;Tiistai;13;12;25;4;0;4
293;04.04.2017;2017;04;13;Tiistai;10;10;20;1;4;5
293;04.04.2017;2017;04;14;Tiistai;26;22;48;5;4;9
293;04.04.2017;2017;04;15;Tiistai;29;33;62;5;8;13
293;04.04.2017;2017;04;16;Tiistai;12;8;20;5;1;6
293;04.04.2017;2017;04;17;Tiistai;11;12;23;1;5;6
293;04.04.2017;2017;04;18;Tiistai;9;6;15;4;0;4
293;04.04.2017;2017;04;19;Tiistai;4;5;9;1;1;2
293;04.04.2017;2017;04;20;Tiistai;3;2;5;1;0;1
293;04.04.2017;2017;04;21;Tiistai;3;4;7;1;1;2
293;04.04.2017;2017;04;22;Tiistai;1;1;2;1;0;1
293;04.04.2017;2017;04;23;Tiistai;0;0;0;0;0;0
293;05.04.2017;2017;04;00;Keskiviikko;0;0;0;0;0;0
293;05.04.2017;2017;04;01;Keskiviikko;0;0;0;0;0;0
293;05.04.2017;2017;04;02;Keskiviikko;0;0;0;0;0;0
293;05.04.2017;2017;04;03;Keskiviikko;0;0;0;0;0;0
293;05.04.2017;2017;04;04;Keskiviikko;0;0;0;0;0;0
293;05.04.2017;2017;04;05;Keskiviikko;0;0;0;0;0;0
293;05.04.2017;2017;04;06;Keskiviikko;4;0;4;0;0;0
293;05.04.2017;2017;04;07;Keskiviikko;17;18;35;4;5;9
293;05.04.2017;2017;04;08;Keskiviikko;29;29;58;8;5;13
293;05.04.2017;2017;04;09;Keskiviikko;7;10;17;1;4;5
293;05.04.2017;2017;04;10;Keskiviikko;5;1;6;1;0;1
293;05.04.2017;2017;04;11;Keskiviikko;3;6;9;0;1;1
293;05.04.2017;2017;04;12;Keskiviikko;5;5;10;4;0;4
293;05.04.2017;2017;04;13;Keskiviikko;12;13;25;0;4;4
293;05.04.2017;2017;04;14;Keskiviikko;38;37;75;8;8;16
293;05.04.2017;2017;04;15;Keskiviikko;12;13;25;1;4;5
293;05.04.2017;2017;04;16;Keskiviikko;14;14;28;4;1;5
293;05.04.2017;2017;04;17;Keskiviikko;6;9;15;0;4;4
293;05.04.2017;2017;04;18;Keskiviikko;10;10;20;4;1;5
293;05.04.2017;2017;04;19;Keskiviikko;9;10;19;1;4;5
293;05.04.2017;2017;04;20;Keskiviikko;6;5;11;4;0;4
293;05.04.2017;2017;04;21;Keskiviikko;0;1;1;0;0;0
293;05.04.2017;2017;04;22;Keskiviikko;1;0;1;0;0;0
293;05.04.2017;2017;04;23;Keskiviikko;0;0;0;0;0;0
293;06.04.2017;2017;04;00;Torstai;0;0;0;0;0;0
293;06.04.2017;2017;04;01;Torstai;0;0;0;0;0;0
293;06.04.2017;2017;04;02;Torstai;0;0;0;0;0;0
293;06.04.2017;2017;04;03;Torstai;0;0;0;0;0;0
293;06.04.2017;2017;04;04;Torstai;0;0;0;0;0;0
293;06.04.2017;2017;04;05;Torstai;0;0;0;0;0;0
293;06.04.2017;2017;04;06;Torstai;1;1;2;0;0;0
293;06.04.2017;2017;04;07;Torstai;17;21;38;4;4;8
293;06.04.2017;2017;04;08;Torstai;30;30;60;8;5;13
293;06.04.2017;2017;04;09;Torstai;5;5;10;0;1;1
293;06.04.2017;2017;04;10;Torstai;5;5;10;1;0;1
293;06.04.2017;2017;04;11;Torstai;2;3;5;0;1;1
293;06.04.2017;2017;04;12;Torstai;6;5;11;1;0;1
293;06.04.2017;2017;04;13;Torstai;12;16;28;1;4;5
293;06.04.2017;2017;04;14;Torstai;17;13;30;4;1;5
293;06.04.2017;2017;04;15;Torstai;12;12;24;0;4;4
293;06.04.2017;2017;04;16;Torstai;6;5;11;1;0;1
293;06.04.2017;2017;04;17;Torstai;4;4;8;0;4;4
293;06.04.2017;2017;04;18;Torstai;5;2;7;1;0;1
293;06.04.2017;2017;04;19;Torstai;1;5;6;0;1;1
293;06.04.2017;2017;04;20;Torstai;2;1;3;1;0;1
293;06.04.2017;2017;04;21;Torstai;0;4;4;0;0;0
293;06.04.2017;2017;04;22;Torstai;1;0;1;0;0;0
293;06.04.2017;2017;04;23;Torstai;0;1;1;0;0;0
293;07.04.2017;2017;04;00;Perjantai;0;0;0;0;0;0
293;07.04.2017;2017;04;01;Perjantai;0;0;0;0;0;0
293;07.04.2017;2017;04;02;Perjantai;0;0;0;0;0;0
293;07.04.2017;2017;04;03;Perjantai;0;0;0;0;0;0
293;07.04.2017;2017;04;04;Perjantai;0;0;0;0;0;0
293;07.04.2017;2017;04;05;Perjantai;0;0;0;0;0;0
293;07.04.2017;2017;04;06;Perjantai;0;0;0;0;0;0
293;07.04.2017;2017;04;07;Perjantai;17;21;38;4;5;9
293;07.04.2017;2017;04;08;Perjantai;23;22;45;5;4;9
293;07.04.2017;2017;04;09;Perjantai;6;10;16;0;4;4
293;07.04.2017;2017;04;10;Perjantai;12;9;21;4;0;4
293;07.04.2017;2017;04;11;Perjantai;5;5;10;0;1;1
293;07.04.2017;2017;04;12;Perjantai;10;6;16;4;0;4
293;07.04.2017;2017;04;13;Perjantai;14;18;32;4;5;9
293;07.04.2017;2017;04;14;Perjantai;17;13;30;4;1;5
293;07.04.2017;2017;04;15;Perjantai;5;5;10;0;1;1
293;07.04.2017;2017;04;16;Perjantai;5;4;9;1;0;1
293;07.04.2017;2017;04;17;Perjantai;4;5;9;0;4;4
293;07.04.2017;2017;04;18;Perjantai;6;5;11;4;0;4
293;07.04.2017;2017;04;19;Perjantai;2;5;7;0;1;1
293;07.04.2017;2017;04;20;Perjantai;5;4;9;4;0;4
293;07.04.2017;2017;04;21;Perjantai;5;5;10;0;4;4
293;07.04.2017;2017;04;22;Perjantai;6;3;9;1;0;1
293;07.04.2017;2017;04;23;Perjantai;0;0;0;0;0;0
293;08.04.2017;2017;04;00;Lauantai;1;0;1;1;0;1
293;08.04.2017;2017;04;01;Lauantai;0;0;0;0;0;0
293;08.04.2017;2017;04;02;Lauantai;0;0;0;0;0;0
293;08.04.2017;2017;04;03;Lauantai;0;0;0;0;0;0
293;08.04.2017;2017;04;04;Lauantai;0;0;0;0;0;0
293;08.04.2017;2017;04;05;Lauantai;1;4;5;0;1;1
293;08.04.2017;2017;04;06;Lauantai;0;0;0;0;0;0
293;08.04.2017;2017;04;07;Lauantai;0;0;0;0;0;0
293;08.04.2017;2017;04;08;Lauantai;1;0;1;0;0;0
293;08.04.2017;2017;04;09;Lauantai;1;4;5;0;1;1
293;08.04.2017;2017;04;10;Lauantai;4;4;8;4;1;5
293;08.04.2017;2017;04;11;Lauantai;9;9;18;8;9;17
293;08.04.2017;2017;04;12;Lauantai;5;2;7;5;1;6
293;08.04.2017;2017;04;13;Lauantai;1;5;6;1;5;6
293;08.04.2017;2017;04;14;Lauantai;5;4;9;4;1;5
293;08.04.2017;2017;04;15;Lauantai;2;5;7;1;5;6
293;08.04.2017;2017;04;16;Lauantai;5;1;6;5;1;6
293;08.04.2017;2017;04;17;Lauantai;4;4;8;1;4;5
293;08.04.2017;2017;04;18;Lauantai;5;2;7;5;1;6
293;08.04.2017;2017;04;19;Lauantai;1;5;6;1;5;6
293;08.04.2017;2017;04;20;Lauantai;5;5;10;5;4;9
293;08.04.2017;2017;04;21;Lauantai;1;5;6;1;4;5
293;08.04.2017;2017;04;22;Lauantai;5;1;6;1;1;2
293;08.04.2017;2017;04;23;Lauantai;0;0;0;0;0;0
293;09.04.2017;2017;04;00;Sunnuntai;0;0;0;0;0;0
293;09.04.2017;2017;04;01;Sunnuntai;0;4;4;0;4;4
293;09.04.2017;2017;04;02;Sunnuntai;0;0;0;0;0;0
293;09.04.2017;2017;04;03;Sunnuntai;0;0;0;0;0;0
293;09.04.2017;2017;04;04;Sunnuntai;0;0;0;0;0;0
293;09.04.2017;2017;04;05;Sunnuntai;0;0;0;0;0;0
293;09.04.2017;2017;04;06;Sunnuntai;0;0;0;0;0;0
293;09.04.2017;2017;04;07;Sunnuntai;0;1;1;0;1;1
293;09.04.2017;2017;04;08;Sunnuntai;0;0;0;0;0;0
293;09.04.2017;2017;04;09;Sunnuntai;5;5;10;1;5;6
293;09.04.2017;2017;04;10;Sunnuntai;4;1;5;4;1;5
293;09.04.2017;2017;04;11;Sunnuntai;5;8;13;4;8;12
293;09.04.2017;2017;04;12;Sunnuntai;9;6;15;9;5;14
293;09.04.2017;2017;04;13;Sunnuntai;5;5;10;5;5;10
293;09.04.2017;2017;04;14;Sunnuntai;5;4;9;5;4;9
293;09.04.2017;2017;04;15;Sunnuntai;1;5;6;1;5;6
293;09.04.2017;2017;04;16;Sunnuntai;5;4;9;4;1;5
293;09.04.2017;2017;04;17;Sunnuntai;6;9;15;5;9;14
293;09.04.2017;2017;04;18;Sunnuntai;5;4;9;4;4;8
293;09.04.2017;2017;04;19;Sunnuntai;5;5;10;4;5;9
293;09.04.2017;2017;04;20;Sunnuntai;1;1;2;1;0;1
293;09.04.2017;2017;04;21;Sunnuntai;1;4;5;1;1;2
293;09.04.2017;2017;04;22;Sunnuntai;0;0;0;0;0;0
293;09.04.2017;2017;04;23;Sunnuntai;0;0;0;0;0;0
293;10.04.2017;2017;04;00;Maanantai;0;0;0;0;0;0
293;10.04.2017;2017;04;01;Maanantai;0;0;0;0;0;0
293;10.04.2017;2017;04;02;Maanantai;0;0;0;0;0;0
293;10.04.2017;2017;04;03;Maanantai;0;0;0;0;0;0
293;10.04.2017;2017;04;04;Maanantai;0;0;0;0;0;0
293;10.04.2017;2017;04;05;Maanantai;0;1;1;0;0;0
293;10.04.2017;2017;04;06;Maanantai;1;0;1;0;0;0
293;10.04.2017;2017;04;07;Maanantai;24;24;48;4;8;12
293;10.04.2017;2017;04;08;Maanantai;21;21;42;5;4;9
293;10.04.2017;2017;04;09;Maanantai;4;5;9;0;1;1
293;10.04.2017;2017;04;10;Maanantai;5;1;6;1;0;1
293;10.04.2017;2017;04;11;Maanantai;1;4;5;0;1;1
293;10.04.2017;2017;04;12;Maanantai;4;4;8;0;0;0
293;10.04.2017;2017;04;13;Maanantai;9;13;22;0;4;4
293;10.04.2017;2017;04;14;Maanantai;21;17;38;5;4;9
293;10.04.2017;2017;04;15;Maanantai;17;20;37;4;4;8
293;10.04.2017;2017;04;16;Maanantai;18;17;35;4;4;8
293;10.04.2017;2017;04;17;Maanantai;5;6;11;0;1;1
293;10.04.2017;2017;04;18;Maanantai;4;4;8;0;0;0
293;10.04.2017;2017;04;19;Maanantai;2;2;4;0;1;1
293;10.04.2017;2017;04;20;Maanantai;0;0;0;0;0;0
293;10.04.2017;2017;04;21;Maanantai;0;0;0;0;0;0
293;10.04.2017;2017;04;22;Maanantai;0;0;0;0;0;0
293;10.04.2017;2017;04;23;Maanantai;0;0;0;0;0;0
293;11.04.2017;2017;04;00;Tiistai;0;0;0;0;0;0
293;11.04.2017;2017;04;01;Tiistai;0;0;0;0;0;0
293;11.04.2017;2017;04;02;Tiistai;0;0;0;0;0;0
293;11.04.2017;2017;04;03;Tiistai;0;0;0;0;0;0
293;11.04.2017;2017;04;04;Tiistai;0;0;0;0;0;0
293;11.04.2017;2017;04;05;Tiistai;0;0;0;0;0;0
293;11.04.2017;2017;04;06;Tiistai;0;0;0;0;0;0
293;11.04.2017;2017;04;07;Tiistai;0;0;0;0;0;0
293;11.04.2017;2017;04;08;Tiistai;0;0;0;0;0;0
293;11.04.2017;2017;04;09;Tiistai;0;0;0;0;0;0
293;11.04.2017;2017;04;10;Tiistai;26;22;48;8;4;12
293;11.04.2017;2017;04;11;Tiistai;0;0;0;0;0;0
293;11.04.2017;2017;04;12;Tiistai;1;0;1;0;0;0
293;11.04.2017;2017;04;13;Tiistai;5;6;11;0;1;1
293;11.04.2017;2017;04;14;Tiistai;13;9;22;4;0;4
293;11.04.2017;2017;04;15;Tiistai;23;26;49;5;8;13
293;11.04.2017;2017;04;16;Tiistai;9;9;18;4;0;4
293;11.04.2017;2017;04;17;Tiistai;5;5;10;0;4;4
293;11.04.2017;2017;04;18;Tiistai;6;5;11;4;0;4
293;11.04.2017;2017;04;19;Tiistai;6;7;13;0;1;1
293;11.04.2017;2017;04;20;Tiistai;5;5;10;4;0;4
293;11.04.2017;2017;04;21;Tiistai;0;1;1;0;0;0
293;11.04.2017;2017;04;22;Tiistai;0;0;0;0;0;0
293;11.04.2017;2017;04;23;Tiistai;0;4;4;0;0;0
293;12.04.2017;2017;04;00;Keskiviikko;0;0;0;0;0;0
293;12.04.2017;2017;04;01;Keskiviikko;0;0;0;0;0;0
293;12.04.2017;2017;04;02;Keskiviikko;0;0;0;0;0;0
293;12.04.2017;2017;04;03;Keskiviikko;0;0;0;0;0;0
293;12.04.2017;2017;04;04;Keskiviikko;0;0;0;0;0;0
293;12.04.2017;2017;04;05;Keskiviikko;0;0;0;0;0;0
293;12.04.2017;2017;04;06;Keskiviikko;1;1;2;1;0;1
293;12.04.2017;2017;04;07;Keskiviikko;30;33;63;5;8;13
293;12.04.2017;2017;04;08;Keskiviikko;31;30;61;8;5;13
293;12.04.2017;2017;04;09;Keskiviikko;6;9;15;0;4;4
293;12.04.2017;2017;04;10;Keskiviikko;6;2;8;1;0;1
293;12.04.2017;2017;04;11;Keskiviikko;4;8;12;0;4;4
293;12.04.2017;2017;04;12;Keskiviikko;8;4;12;4;0;4
293;12.04.2017;2017;04;13;Keskiviikko;10;13;23;1;4;5
293;12.04.2017;2017;04;14;Keskiviikko;46;42;88;12;9;21
293;12.04.2017;2017;04;15;Keskiviikko;9;13;22;1;4;5
293;12.04.2017;2017;04;16;Keskiviikko;12;9;21;4;0;4
293;12.04.2017;2017;04;17;Keskiviikko;6;7;13;0;4;4
293;12.04.2017;2017;04;18;Keskiviikko;7;6;13;1;0;1
293;12.04.2017;2017;04;19;Keskiviikko;6;7;13;0;4;4
293;12.04.2017;2017;04;20;Keskiviikko;5;1;6;1;0;1
293;12.04.2017;2017;04;21;Keskiviikko;1;2;3;0;1;1
293;12.04.2017;2017;04;22;Keskiviikko;0;0;0;0;0;0
293;12.04.2017;2017;04;23;Keskiviikko;0;0;0;0;0;0
293;13.04.2017;2017;04;00;Torstai;0;0;0;0;0;0
293;13.04.2017;2017;04;01;Torstai;0;0;0;0;0;0
293;13.04.2017;2017;04;02;Torstai;4;0;4;0;0;0
293;13.04.2017;2017;04;03;Torstai;0;0;0;0;0;0
293;13.04.2017;2017;04;04;Torstai;0;0;0;0;0;0
293;13.04.2017;2017;04;05;Torstai;0;0;0;0;0;0
293;13.04.2017;2017;04;06;Torstai;1;0;1;0;0;0
293;13.04.2017;2017;04;07;Torstai;21;25;46;4;5;9
293;13.04.2017;2017;04;08;Torstai;29;26;55;8;5;13
293;13.04.2017;2017;04;09;Torstai;1;5;6;0;1;1
293;13.04.2017;2017;04;10;Torstai;5;5;10;1;0;1
293;13.04.2017;2017;04;11;Torstai;1;4;5;0;1;1
293;13.04.2017;2017;04;12;Torstai;5;5;10;1;0;1
293;13.04.2017;2017;04;13;Torstai;30;30;60;5;8;13
293;13.04.2017;2017;04;14;Torstai;10;9;19;4;1;5
293;13.04.2017;2017;04;15;Torstai;9;10;19;0;4;4
293;13.04.2017;2017;04;16;Torstai;5;4;9;4;0;4
293;13.04.2017;2017;04;17;Torstai;5;6;11;0;1;1
293;13.04.2017;2017;04;18;Torstai;5;4;9;1;0;1
293;13.04.2017;2017;04;19;Torstai;1;1;2;0;0;0
293;13.04.2017;2017;04;20;Torstai;2;1;3;1;0;1
293;13.04.2017;2017;04;21;Torstai;0;0;0;0;0;0
293;13.04.2017;2017;04;22;Torstai;4;1;5;0;0;0
293;13.04.2017;2017;04;23;Torstai;0;1;1;0;0;0
293;14.04.2017;2017;04;00;Perjantai;1;0;1;0;0;0
293;14.04.2017;2017;04;01;Perjantai;0;0;0;0;0;0
293;14.04.2017;2017;04;02;Perjantai;0;0;0;0;0;0
293;14.04.2017;2017;04;03;Perjantai;0;0;0;0;0;0
293;14.04.2017;2017;04;04;Perjantai;0;0;0;0;0;0
293;14.04.2017;2017;04;05;Perjantai;0;0;0;0;0;0
293;14.04.2017;2017;04;06;Perjantai;0;0;0;0;0;0
293;14.04.2017;2017;04;07;Perjantai;0;0;0;0;0;0
293;14.04.2017;2017;04;08;Perjantai;1;1;2;1;0;1
293;14.04.2017;2017;04;09;Perjantai;1;4;5;0;0;0
293;14.04.2017;2017;04;10;Perjantai;1;1;2;1;0;1
293;14.04.2017;2017;04;11;Perjantai;3;6;9;0;1;1
293;14.04.2017;2017;04;12;Perjantai;9;6;15;4;0;4
293;14.04.2017;2017;04;13;Perjantai;6;7;13;0;4;4
293;14.04.2017;2017;04;14;Perjantai;6;5;11;4;0;4
293;14.04.2017;2017;04;15;Perjantai;5;5;10;0;1;1
293;14.04.2017;2017;04;16;Perjantai;7;6;13;4;1;5
293;14.04.2017;2017;04;17;Perjantai;5;6;11;0;1;1
293;14.04.2017;2017;04;18;Perjantai;5;4;9;1;0;1
293;14.04.2017;2017;04;19;Perjantai;6;6;12;0;4;4
293;14.04.2017;2017;04;20;Perjantai;4;1;5;0;0;0
293;14.04.2017;2017;04;21;Perjantai;1;1;2;0;0;0
293;14.04.2017;2017;04;22;Perjantai;1;0;1;0;0;0
293;14.04.2017;2017;04;23;Perjantai;1;4;5;0;0;0
293;15.04.2017;2017;04;00;Lauantai;0;0;0;0;0;0
293;15.04.2017;2017;04;01;Lauantai;0;0;0;0;0;0
293;15.04.2017;2017;04;02;Lauantai;0;0;0;0;0;0
293;15.04.2017;2017;04;03;Lauantai;0;0;0;0;0;0
293;15.04.2017;2017;04;04;Lauantai;0;0;0;0;0;0
293;15.04.2017;2017;04;05;Lauantai;0;0;0;0;0;0
293;15.04.2017;2017;04;06;Lauantai;0;0;0;0;0;0
293;15.04.2017;2017;04;07;Lauantai;1;1;2;0;1;1
293;15.04.2017;2017;04;08;Lauantai;4;1;5;1;0;1
293;15.04.2017;2017;04;09;Lauantai;1;1;2;1;1;2
293;15.04.2017;2017;04;10;Lauantai;5;1;6;1;1;2
293;15.04.2017;2017;04;11;Lauantai;1;4;5;1;1;2
293;15.04.2017;2017;04;12;Lauantai;5;2;7;2;1;3
293;15.04.2017;2017;04;13;Lauantai;1;4;5;1;1;2
293;15.04.2017;2017;04;14;Lauantai;5;5;10;5;4;9
293;15.04.2017;2017;04;15;Lauantai;1;5;6;1;5;6
293;15.04.2017;2017;04;16;Lauantai;5;4;9;5;1;6
293;15.04.2017;2017;04;17;Lauantai;1;5;6;1;2;3
293;15.04.2017;2017;04;18;Lauantai;4;4;8;4;0;4
293;15.04.2017;2017;04;19;Lauantai;1;4;5;1;1;2
293;15.04.2017;2017;04;20;Lauantai;1;1;2;1;1;2
293;15.04.2017;2017;04;21;Lauantai;0;1;1;0;0;0
293;15.04.2017;2017;04;22;Lauantai;1;1;2;1;0;1
293;15.04.2017;2017;04;23;Lauantai;1;4;5;0;1;1
293;16.04.2017;2017;04;00;Sunnuntai;1;0;1;0;0;0
293;16.04.2017;2017;04;01;Sunnuntai;1;1;2;0;1;1
293;16.04.2017;2017;04;02;Sunnuntai;1;1;2;1;0;1
293;16.04.2017;2017;04;03;Sunnuntai;0;1;1;0;1;1
293;16.04.2017;2017;04;04;Sunnuntai;0;0;0;0;0;0
293;16.04.2017;2017;04;05;Sunnuntai;0;0;0;0;0;0
293;16.04.2017;2017;04;06;Sunnuntai;0;0;0;0;0;0
293;16.04.2017;2017;04;07;Sunnuntai;0;1;1;0;0;0
293;16.04.2017;2017;04;08;Sunnuntai;1;0;1;0;0;0
293;16.04.2017;2017;04;09;Sunnuntai;1;5;6;1;4;5
293;16.04.2017;2017;04;10;Sunnuntai;5;2;7;5;1;6
293;16.04.2017;2017;04;11;Sunnuntai;4;8;12;4;5;9
293;16.04.2017;2017;04;12;Sunnuntai;4;0;4;4;0;4
293;16.04.2017;2017;04;13;Sunnuntai;5;5;10;5;5;10
293;16.04.2017;2017;04;14;Sunnuntai;8;8;16;8;4;12
293;16.04.2017;2017;04;15;Sunnuntai;4;4;8;4;4;8
293;16.04.2017;2017;04;16;Sunnuntai;5;4;9;5;1;6
293;16.04.2017;2017;04;17;Sunnuntai;0;4;4;0;4;4
293;16.04.2017;2017;04;18;Sunnuntai;5;1;6;4;1;5
293;16.04.2017;2017;04;19;Sunnuntai;0;1;1;0;1;1
293;16.04.2017;2017;04;20;Sunnuntai;4;1;5;1;0;1
293;16.04.2017;2017;04;21;Sunnuntai;0;1;1;0;0;0
293;16.04.2017;2017;04;22;Sunnuntai;0;0;0;0;0;0
293;16.04.2017;2017;04;23;Sunnuntai;0;0;0;0;0;0
293;17.04.2017;2017;04;00;Maanantai;0;0;0;0;0;0
293;17.04.2017;2017;04;01;Maanantai;0;0;0;0;0;0
293;17.04.2017;2017;04;02;Maanantai;4;1;5;1;0;1
293;17.04.2017;2017;04;03;Maanantai;0;0;0;0;0;0
293;17.04.2017;2017;04;04;Maanantai;0;0;0;0;0;0
293;17.04.2017;2017;04;05;Maanantai;0;0;0;0;0;0
293;17.04.2017;2017;04;06;Maanantai;0;0;0;0;0;0
293;17.04.2017;2017;04;07;Maanantai;0;0;0;0;0;0
293;17.04.2017;2017;04;08;Maanantai;1;1;2;0;0;0
293;17.04.2017;2017;04;09;Maanantai;1;1;2;0;1;1
293;17.04.2017;2017;04;10;Maanantai;1;1;2;1;0;1
293;17.04.2017;2017;04;11;Maanantai;2;5;7;0;1;1
293;17.04.2017;2017;04;12;Maanantai;5;4;9;1;0;1
293;17.04.2017;2017;04;13;Maanantai;6;10;16;1;4;5
293;17.04.2017;2017;04;14;Maanantai;5;1;6;1;0;1
293;17.04.2017;2017;04;15;Maanantai;5;5;10;0;1;1
293;17.04.2017;2017;04;16;Maanantai;9;5;14;4;0;4
293;17.04.2017;2017;04;17;Maanantai;6;6;12;0;4;4
293;17.04.2017;2017;04;18;Maanantai;9;9;18;4;0;4
293;17.04.2017;2017;04;19;Maanantai;4;5;9;0;1;1
293;17.04.2017;2017;04;20;Maanantai;1;1;2;1;0;1
293;17.04.2017;2017;04;21;Maanantai;0;1;1;0;0;0
293;17.04.2017;2017;04;22;Maanantai;1;0;1;0;0;0
293;17.04.2017;2017;04;23;Maanantai;0;0;0;0;0;0
293;18.04.2017;2017;04;00;Tiistai;4;1;5;1;0;1
293;18.04.2017;2017;04;01;Tiistai;0;0;0;0;0;0
293;18.04.2017;2017;04;02;Tiistai;0;0;0;0;0;0
293;18.04.2017;2017;04;03;Tiistai;0;0;0;0;0;0
293;18.04.2017;2017;04;04;Tiistai;0;0;0;0;0;0
293;18.04.2017;2017;04;05;Tiistai;0;1;1;0;0;0
293;18.04.2017;2017;04;06;Tiistai;2;1;3;1;0;1
293;18.04.2017;2017;04;07;Tiistai;18;21;39;4;4;8
293;18.04.2017;2017;04;08;Tiistai;26;26;52;8;4;12
293;18.04.2017;2017;04;09;Tiistai;18;21;39;4;5;9
293;18.04.2017;2017;04;10;Tiistai;13;9;22;4;1;5
293;18.04.2017;2017;04;11;Tiistai;1;5;6;0;1;1
293;18.04.2017;2017;04;12;Tiistai;5;1;6;1;0;1
293;18.04.2017;2017;04;13;Tiistai;6;10;16;0;4;4
293;18.04.2017;2017;04;14;Tiistai;16;12;28;4;1;5
293;18.04.2017;2017;04;15;Tiistai;32;36;68;4;8;12
293;18.04.2017;2017;04;16;Tiistai;13;9;22;4;1;5
293;18.04.2017;2017;04;17;Tiistai;9;9;18;0;4;4
293;18.04.2017;2017;04;18;Tiistai;16;13;29;4;1;5
293;18.04.2017;2017;04;19;Tiistai;9;13;22;1;4;5
293;18.04.2017;2017;04;20;Tiistai;5;2;7;1;0;1
293;18.04.2017;2017;04;21;Tiistai;1;1;2;0;0;0
293;18.04.2017;2017;04;22;Tiistai;0;0;0;0;0;0
293;18.04.2017;2017;04;23;Tiistai;0;0;0;0;0;0
293;19.04.2017;2017;04;00;Keskiviikko;0;0;0;0;0;0
293;19.04.2017;2017;04;01;Keskiviikko;0;0;0;0;0;0
293;19.04.2017;2017;04;02;Keskiviikko;4;4;8;1;0;1
293;19.04.2017;2017;04;03;Keskiviikko;0;0;0;0;0;0
293;19.04.2017;2017;04;04;Keskiviikko;0;0;0;0;0;0
293;19.04.2017;2017;04;05;Keskiviikko;0;0;0;0;0;0
293;19.04.2017;2017;04;06;Keskiviikko;4;1;5;0;0;0
293;19.04.2017;2017;04;07;Keskiviikko;20;21;41;4;4;8
293;19.04.2017;2017;04;08;Keskiviikko;22;21;43;5;4;9
293;19.04.2017;2017;04;09;Keskiviikko;9;13;22;1;4;5
293;19.04.2017;2017;04;10;Keskiviikko;12;9;21;4;0;4
293;19.04.2017;2017;04;11;Keskiviikko;1;1;2;0;1;1
293;19.04.2017;2017;04;12;Keskiviikko;5;5;10;1;0;1
293;19.04.2017;2017;04;13;Keskiviikko;9;9;18;0;4;4
293;19.04.2017;2017;04;14;Keskiviikko;29;29;58;8;4;12
293;19.04.2017;2017;04;15;Keskiviikko;5;5;10;0;4;4
293;19.04.2017;2017;04;16;Keskiviikko;5;4;9;4;0;4
293;19.04.2017;2017;04;17;Keskiviikko;5;9;14;0;4;4
293;19.04.2017;2017;04;18;Keskiviikko;6;5;11;4;0;4
293;19.04.2017;2017;04;19;Keskiviikko;5;5;10;0;4;4
293;19.04.2017;2017;04;20;Keskiviikko;6;3;9;1;0;1
293;19.04.2017;2017;04;21;Keskiviikko;1;5;6;0;1;1
293;19.04.2017;2017;04;22;Keskiviikko;0;0;0;0;0;0
293;19.04.2017;2017;04;23;Keskiviikko;0;1;1;0;0;0
293;20.04.2017;2017;04;00;Torstai;0;0;0;0;0;0
293;20.04.2017;2017;04;01;Torstai;0;0;0;0;0;0
293;20.04.2017;2017;04;02;Torstai;0;0;0;0;0;0
293;20.04.2017;2017;04;03;Torstai;0;0;0;0;0;0
293;20.04.2017;2017;04;04;Torstai;0;0;0;0;0;0
293;20.04.2017;2017;04;05;Torstai;0;1;1;0;0;0
293;20.04.2017;2017;04;06;Torstai;1;1;2;0;0;0
293;20.04.2017;2017;04;07;Torstai;17;21;38;4;4;8
293;20.04.2017;2017;04;08;Torstai;18;18;36;4;4;8
293;20.04.2017;2017;04;09;Torstai;1;5;6;0;1;1
293;20.04.2017;2017;04;10;Torstai;2;2;4;1;0;1
293;20.04.2017;2017;04;11;Torstai;1;1;2;0;1;1
293;20.04.2017;2017;04;12;Torstai;5;4;9;1;0;1
293;20.04.2017;2017;04;13;Torstai;2;5;7;0;1;1
293;20.04.2017;2017;04;14;Torstai;16;12;28;4;1;5
293;20.04.2017;2017;04;15;Torstai;10;13;23;1;4;5
293;20.04.2017;2017;04;16;Torstai;4;4;8;1;0;1
293;20.04.2017;2017;04;17;Torstai;1;1;2;0;1;1
293;20.04.2017;2017;04;18;Torstai;2;2;4;1;0;1
293;20.04.2017;2017;04;19;Torstai;1;5;6;0;1;1
293;20.04.2017;2017;04;20;Torstai;2;1;3;1;0;1
293;20.04.2017;2017;04;21;Torstai;0;1;1;0;0;0
293;20.04.2017;2017;04;22;Torstai;0;0;0;0;0;0
293;20.04.2017;2017;04;23;Torstai;0;1;1;0;0;0
293;21.04.2017;2017;04;00;Perjantai;0;0;0;0;0;0
293;21.04.2017;2017;04;01;Perjantai;0;0;0;0;0;0
293;21.04.2017;2017;04;02;Perjantai;0;0;0;0;0;0
293;21.04.2017;2017;04;03;Perjantai;0;0;0;0;0;0
293;21.04.2017;2017;04;04;Perjantai;0;0;0;0;0;0
293;21.04.2017;2017;04;05;Perjantai;0;1;1;0;0;0
293;21.04.2017;2017;04;06;Perjantai;1;0;1;0;0;0
293;21.04.2017;2017;04;07;Perjantai;12;16;28;1;4;5
293;21.04.2017;2017;04;08;Perjantai;21;18;39;4;4;8
293;21.04.2017;2017;04;09;Perjantai;6;9;15;0;4;4
293;21.04.2017;2017;04;10;Perjantai;6;6;12;4;0;4
293;21.04.2017;2017;04;11;Perjantai;4;5;9;0;1;1
293;21.04.2017;2017;04;12;Perjantai;9;6;15;4;0;4
293;21.04.2017;2017;04;13;Perjantai;13;13;26;1;4;5
293;21.04.2017;2017;04;14;Perjantai;24;21;45;4;4;8
293;21.04.2017;2017;04;15;Perjantai;14;17;31;1;4;5
293;21.04.2017;2017;04;16;Perjantai;15;14;29;4;1;5
293;21.04.2017;2017;04;17;Perjantai;5;6;11;0;4;4
293;21.04.2017;2017;04;18;Perjantai;6;5;11;4;0;4
293;21.04.2017;2017;04;19;Perjantai;1;5;6;0;1;1
293;21.04.2017;2017;04;20;Perjantai;5;2;7;1;0;1
293;21.04.2017;2017;04;21;Perjantai;1;4;5;0;0;0
293;21.04.2017;2017;04;22;Perjantai;1;0;1;0;0;0
293;21.04.2017;2017;04;23;Perjantai;0;0;0;0;0;0
293;22.04.2017;2017;04;00;Lauantai;0;0;0;0;0;0
293;22.04.2017;2017;04;01;Lauantai;0;0;0;0;0;0
293;22.04.2017;2017;04;02;Lauantai;0;0;0;0;0;0
293;22.04.2017;2017;04;03;Lauantai;0;0;0;0;0;0
293;22.04.2017;2017;04;04;Lauantai;0;0;0;0;0;0
293;22.04.2017;2017;04;05;Lauantai;0;0;0;0;0;0
293;22.04.2017;2017;04;06;Lauantai;0;0;0;0;0;0
293;22.04.2017;2017;04;07;Lauantai;0;0;0;0;0;0
293;22.04.2017;2017;04;08;Lauantai;0;0;0;0;0;0
293;22.04.2017;2017;04;09;Lauantai;1;1;2;0;0;0
293;22.04.2017;2017;04;10;Lauantai;2;2;4;1;0;1
293;22.04.2017;2017;04;11;Lauantai;1;1;2;0;0;0
293;22.04.2017;2017;04;12;Lauantai;4;4;8;1;0;1
293;22.04.2017;2017;04;13;Lauantai;4;4;8;0;1;1
293;22.04.2017;2017;04;14;Lauantai;4;1;5;1;0;1
293;22.04.2017;2017;04;15;Lauantai;1;4;5;0;0;0
293;22.04.2017;2017;04;16;Lauantai;5;5;10;1;0;1
293;22.04.2017;2017;04;17;Lauantai;2;3;5;0;1;1
293;22.04.2017;2017;04;18;Lauantai;6;5;11;1;0;1
293;22.04.2017;2017;04;19;Lauantai;1;4;5;0;1;1
293;22.04.2017;2017;04;20;Lauantai;1;0;1;0;0;0
293;22.04.2017;2017;04;21;Lauantai;0;0;0;0;0;0
293;22.04.2017;2017;04;22;Lauantai;1;1;2;0;0;0
293;22.04.2017;2017;04;23;Lauantai;0;0;0;0;0;0
293;23.04.2017;2017;04;00;Sunnuntai;1;0;1;0;0;0
293;23.04.2017;2017;04;01;Sunnuntai;0;0;0;0;0;0
293;23.04.2017;2017;04;02;Sunnuntai;0;0;0;0;0;0
293;23.04.2017;2017;04;03;Sunnuntai;0;0;0;0;0;0
293;23.04.2017;2017;04;04;Sunnuntai;0;0;0;0;0;0
293;23.04.2017;2017;04;05;Sunnuntai;0;0;0;0;0;0
293;23.04.2017;2017;04;06;Sunnuntai;0;0;0;0;0;0
293;23.04.2017;2017;04;07;Sunnuntai;0;0;0;0;0;0
293;23.04.2017;2017;04;08;Sunnuntai;0;0;0;0;0;0
293;23.04.2017;2017;04;09;Sunnuntai;0;0;0;0;0;0
293;23.04.2017;2017;04;10;Sunnuntai;0;0;0;0;0;0
293;23.04.2017;2017;04;11;Sunnuntai;1;1;2;0;0;0
293;23.04.2017;2017;04;12;Sunnuntai;9;5;14;4;0;4
293;23.04.2017;2017;04;13;Sunnuntai;1;5;6;0;1;1
293;23.04.2017;2017;04;14;Sunnuntai;10;9;19;4;0;4
293;23.04.2017;2017;04;15;Sunnuntai;6;6;12;0;1;1
293;23.04.2017;2017;04;16;Sunnuntai;12;9;21;4;0;4
293;23.04.2017;2017;04;17;Sunnuntai;1;5;6;0;1;1
293;23.04.2017;2017;04;18;Sunnuntai;5;2;7;1;0;1
293;23.04.2017;2017;04;19;Sunnuntai;0;1;1;0;0;0
293;23.04.2017;2017;04;20;Sunnuntai;4;1;5;1;0;1
293;23.04.2017;2017;04;21;Sunnuntai;2;3;5;0;1;1
293;23.04.2017;2017;04;22;Sunnuntai;0;0;0;0;0;0
293;23.04.2017;2017;04;23;Sunnuntai;0;1;1;0;0;0
293;15.05.2017;2017;05;00;Maanantai;0;0;0;0;0;0
293;15.05.2017;2017;05;01;Maanantai;0;0;0;0;0;0
293;15.05.2017;2017;05;02;Maanantai;0;0;0;0;0;0
293;15.05.2017;2017;05;03;Maanantai;0;0;0;0;0;0
293;15.05.2017;2017;05;04;Maanantai;0;0;0;0;0;0
293;15.05.2017;2017;05;05;Maanantai;1;1;2;0;0;0
293;15.05.2017;2017;05;06;Maanantai;4;0;4;0;0;0
293;15.05.2017;2017;05;07;Maanantai;24;28;52;4;4;8
293;15.05.2017;2017;05;08;Maanantai;30;29;59;5;4;9
293;15.05.2017;2017;05;09;Maanantai;13;13;26;0;4;4
293;15.05.2017;2017;05;10;Maanantai;22;21;43;4;4;8
293;15.05.2017;2017;05;11;Maanantai;5;6;11;0;1;1
293;15.05.2017;2017;05;12;Maanantai;13;10;23;4;0;4
293;15.05.2017;2017;05;13;Maanantai;15;19;34;1;4;5
293;15.05.2017;2017;05;14;Maanantai;30;26;56;5;4;9
293;15.05.2017;2017;05;15;Maanantai;31;34;65;4;8;12
293;15.05.2017;2017;05;16;Maanantai;25;22;47;4;4;8
293;15.05.2017;2017;05;17;Maanantai;17;21;38;4;4;8
293;15.05.2017;2017;05;18;Maanantai;14;14;28;4;1;5
293;15.05.2017;2017;05;19;Maanantai;9;9;18;0;4;4
293;15.05.2017;2017;05;20;Maanantai;12;9;21;4;0;4
293;15.05.2017;2017;05;21;Maanantai;2;3;5;0;1;1
293;15.05.2017;2017;05;22;Maanantai;1;0;1;0;0;0
293;15.05.2017;2017;05;23;Maanantai;0;1;1;0;0;0
293;16.05.2017;2017;05;00;Tiistai;0;0;0;0;0;0
293;16.05.2017;2017;05;01;Tiistai;0;0;0;0;0;0
293;16.05.2017;2017;05;02;Tiistai;1;0;1;0;0;0
293;16.05.2017;2017;05;03;Tiistai;0;0;0;0;0;0
293;16.05.2017;2017;05;04;Tiistai;0;0;0;0;0;0
293;16.05.2017;2017;05;05;Tiistai;1;2;3;0;1;1
293;16.05.2017;2017;05;06;Tiistai;5;2;7;1;0;1
293;16.05.2017;2017;05;07;Tiistai;20;21;41;4;4;8
293;16.05.2017;2017;05;08;Tiistai;22;22;44;4;4;8
293;16.05.2017;2017;05;09;Tiistai;17;17;34;1;4;5
293;16.05.2017;2017;05;10;Tiistai;5;1;6;1;0;1
293;16.05.2017;2017;05;11;Tiistai;14;14;28;1;4;5
293;16.05.2017;2017;05;12;Tiistai;14;10;24;4;1;5
293;16.05.2017;2017;05;13;Tiistai;21;25;46;4;4;8
293;16.05.2017;2017;05;14;Tiistai;47;47;94;9;8;17
293;16.05.2017;2017;05;15;Tiistai;62;66;128;9;12;21
293;16.05.2017;2017;05;16;Tiistai;39;39;78;8;5;13
293;16.05.2017;2017;05;17;Tiistai;31;35;66;5;8;13
293;16.05.2017;2017;05;18;Tiistai;38;35;73;8;5;13
293;16.05.2017;2017;05;19;Tiistai;43;44;87;5;9;14
293;16.05.2017;2017;05;20;Tiistai;18;17;35;4;1;5
293;16.05.2017;2017;05;21;Tiistai;7;10;17;0;4;4
293;16.05.2017;2017;05;22;Tiistai;1;0;1;0;0;0
293;16.05.2017;2017;05;23;Tiistai;0;0;0;0;0;0
293;17.05.2017;2017;05;00;Keskiviikko;0;0;0;0;0;0
293;17.05.2017;2017;05;01;Keskiviikko;0;0;0;0;0;0
293;17.05.2017;2017;05;02;Keskiviikko;0;0;0;0;0;0
293;17.05.2017;2017;05;03;Keskiviikko;0;1;1;0;0;0
293;17.05.2017;2017;05;04;Keskiviikko;1;0;1;0;0;0
293;17.05.2017;2017;05;05;Keskiviikko;1;1;2;0;0;0
293;17.05.2017;2017;05;06;Keskiviikko;6;3;9;1;0;1
293;17.05.2017;2017;05;07;Keskiviikko;43;46;89;8;8;16
293;17.05.2017;2017;05;08;Keskiviikko;42;42;84;8;5;13
293;17.05.2017;2017;05;09;Keskiviikko;12;13;25;0;4;4
293;17.05.2017;2017;05;10;Keskiviikko;6;2;8;1;0;1
293;17.05.2017;2017;05;11;Keskiviikko;2;5;7;0;1;1
293;17.05.2017;2017;05;12;Keskiviikko;14;14;28;4;1;5
293;17.05.2017;2017;05;13;Keskiviikko;25;25;50;4;4;8
293;17.05.2017;2017;05;14;Keskiviikko;58;55;113;12;8;20
293;17.05.2017;2017;05;15;Keskiviikko;18;21;39;4;4;8
293;17.05.2017;2017;05;16;Keskiviikko;6;6;12;1;0;1
293;17.05.2017;2017;05;17;Keskiviikko;5;6;11;0;1;1
293;17.05.2017;2017;05;18;Keskiviikko;11;7;18;4;1;5
293;17.05.2017;2017;05;19;Keskiviikko;6;6;12;0;1;1
293;17.05.2017;2017;05;20;Keskiviikko;2;2;4;1;0;1
293;17.05.2017;2017;05;21;Keskiviikko;2;6;8;0;1;1
293;17.05.2017;2017;05;22;Keskiviikko;1;1;2;0;0;0
293;17.05.2017;2017;05;23;Keskiviikko;1;1;2;0;0;0
293;18.05.2017;2017;05;00;Torstai;0;0;0;0;0;0
293;18.05.2017;2017;05;01;Torstai;0;0;0;0;0;0
293;18.05.2017;2017;05;02;Torstai;1;0;1;0;0;0
293;18.05.2017;2017;05;03;Torstai;0;1;1;0;0;0
293;18.05.2017;2017;05;04;Torstai;1;0;1;0;0;0
293;18.05.2017;2017;05;05;Torstai;1;5;6;0;1;1
293;18.05.2017;2017;05;06;Torstai;8;5;13;4;0;4
293;18.05.2017;2017;05;07;Torstai;43;46;89;8;8;16
293;18.05.2017;2017;05;08;Torstai;49;45;94;8;8;16
293;18.05.2017;2017;05;09;Torstai;23;24;47;4;5;9
293;18.05.2017;2017;05;10;Torstai;14;14;28;4;1;5
293;18.05.2017;2017;05;11;Torstai;15;15;30;1;4;5
293;18.05.2017;2017;05;12;Torstai;15;15;30;4;1;5
293;18.05.2017;2017;05;13;Torstai;20;21;41;4;4;8
293;18.05.2017;2017;05;14;Torstai;62;62;124;12;9;21
293;18.05.2017;2017;05;15;Torstai;44;45;89;5;9;14
293;18.05.2017;2017;05;16;Torstai;23;22;45;5;4;9
293;18.05.2017;2017;05;17;Torstai;16;19;35;1;4;5
293;18.05.2017;2017;05;18;Torstai;16;15;31;4;1;5
293;18.05.2017;2017;05;19;Torstai;22;26;48;4;5;9
293;18.05.2017;2017;05;20;Torstai;16;15;31;4;1;5
293;18.05.2017;2017;05;21;Torstai;10;10;20;0;4;4
293;18.05.2017;2017;05;22;Torstai;2;1;3;1;0;1
293;18.05.2017;2017;05;23;Torstai;0;1;1;0;0;0
293;19.05.2017;2017;05;00;Perjantai;0;0;0;0;0;0
293;19.05.2017;2017;05;01;Perjantai;0;0;0;0;0;0
293;19.05.2017;2017;05;02;Perjantai;0;0;0;0;0;0
293;19.05.2017;2017;05;03;Perjantai;0;0;0;0;0;0
293;19.05.2017;2017;05;04;Perjantai;0;0;0;0;0;0
293;19.05.2017;2017;05;05;Perjantai;0;0;0;0;0;0
293;19.05.2017;2017;05;06;Perjantai;1;0;1;0;0;0
293;19.05.2017;2017;05;07;Perjantai;19;19;38;1;4;5
293;19.05.2017;2017;05;08;Perjantai;35;34;69;8;5;13
293;19.05.2017;2017;05;09;Perjantai;11;11;22;1;4;5
293;19.05.2017;2017;05;10;Perjantai;9;8;17;4;0;4
293;19.05.2017;2017;05;11;Perjantai;9;9;18;0;4;4
293;19.05.2017;2017;05;12;Perjantai;18;18;36;4;1;5
293;19.05.2017;2017;05;13;Perjantai;30;31;61;4;5;9
293;19.05.2017;2017;05;14;Perjantai;35;34;69;8;5;13
293;19.05.2017;2017;05;15;Perjantai;27;28;55;4;5;9
293;19.05.2017;2017;05;16;Perjantai;16;15;31;4;1;5
293;19.05.2017;2017;05;17;Perjantai;15;16;31;1;4;5
293;19.05.2017;2017;05;18;Perjantai;18;14;32;4;1;5
293;19.05.2017;2017;05;19;Perjantai;12;13;25;1;4;5
293;19.05.2017;2017;05;20;Perjantai;19;15;34;4;1;5
293;19.05.2017;2017;05;21;Perjantai;9;10;19;0;4;4
293;19.05.2017;2017;05;22;Perjantai;6;3;9;1;0;1
293;19.05.2017;2017;05;23;Perjantai;2;3;5;0;1;1
293;20.05.2017;2017;05;00;Lauantai;1;1;2;0;0;0
293;20.05.2017;2017;05;01;Lauantai;0;1;1;0;0;0
293;20.05.2017;2017;05;02;Lauantai;0;0;0;0;0;0
293;20.05.2017;2017;05;03;Lauantai;0;0;0;0;0;0
293;20.05.2017;2017;05;04;Lauantai;1;0;1;0;0;0
293;20.05.2017;2017;05;05;Lauantai;0;1;1;0;0;0
293;20.05.2017;2017;05;06;Lauantai;1;1;2;0;0;0
293;20.05.2017;2017;05;07;Lauantai;0;1;1;0;0;0
293;20.05.2017;2017;05;08;Lauantai;10;9;19;4;0;4
293;20.05.2017;2017;05;09;Lauantai;14;15;29;1;4;5
293;20.05.2017;2017;05;10;Lauantai;23;22;45;5;4;9
293;20.05.2017;2017;05;11;Lauantai;25;29;54;4;5;9
293;20.05.2017;2017;05;12;Lauantai;39;35;74;8;5;13
293;20.05.2017;2017;05;13;Lauantai;35;36;71;5;8;13
293;20.05.2017;2017;05;14;Lauantai;43;42;85;8;5;13
293;20.05.2017;2017;05;15;Lauantai;31;35;66;5;8;13
293;20.05.2017;2017;05;16;Lauantai;35;32;67;8;5;13
293;20.05.2017;2017;05;17;Lauantai;26;26;52;4;5;9
293;20.05.2017;2017;05;18;Lauantai;24;23;47;5;4;9
293;20.05.2017;2017;05;19;Lauantai;17;18;35;1;4;5
293;20.05.2017;2017;05;20;Lauantai;10;10;20;4;0;4
293;20.05.2017;2017;05;21;Lauantai;5;5;10;0;1;1
293;20.05.2017;2017;05;22;Lauantai;6;2;8;1;0;1
293;20.05.2017;2017;05;23;Lauantai;3;3;6;0;1;1
293;21.05.2017;2017;05;00;Sunnuntai;4;4;8;0;0;0
293;21.05.2017;2017;05;01;Sunnuntai;0;1;1;0;0;0
293;21.05.2017;2017;05;02;Sunnuntai;2;1;3;1;0;1
293;21.05.2017;2017;05;03;Sunnuntai;1;4;5;0;0;0
293;21.05.2017;2017;05;04;Sunnuntai;1;1;2;0;0;0
293;21.05.2017;2017;05;05;Sunnuntai;1;1;2;0;0;0
293;21.05.2017;2017;05;06;Sunnuntai;3;2;5;1;0;1
293;21.05.2017;2017;05;07;Sunnuntai;0;1;1;0;0;0
293;21.05.2017;2017;05;08;Sunnuntai;5;5;10;1;0;1
293;21.05.2017;2017;05;09;Sunnuntai;9;13;22;0;4;4
293;21.05.2017;2017;05;10;Sunnuntai;22;18;40;4;4;8
293;21.05.2017;2017;05;11;Sunnuntai;29;30;59;4;5;9
293;21.05.2017;2017;05;12;Sunnuntai;20;17;37;4;4;8
293;21.05.2017;2017;05;13;Sunnuntai;26;26;52;4;5;9
293;21.05.2017;2017;05;14;Sunnuntai;37;34;71;8;4;12
293;21.05.2017;2017;05;15;Sunnuntai;39;42;81;5;8;13
293;21.05.2017;2017;05;16;Sunnuntai;38;35;73;8;5;13
293;21.05.2017;2017;05;17;Sunnuntai;35;35;70;5;8;13
293;21.05.2017;2017;05;18;Sunnuntai;31;27;58;5;4;9
293;21.05.2017;2017;05;19;Sunnuntai;21;25;46;4;4;8
293;21.05.2017;2017;05;20;Sunnuntai;18;14;32;4;1;5
293;21.05.2017;2017;05;21;Sunnuntai;5;9;14;0;4;4
293;21.05.2017;2017;05;22;Sunnuntai;2;2;4;1;0;1
293;21.05.2017;2017;05;23;Sunnuntai;0;1;1;0;0;0
293;22.05.2017;2017;05;00;Maanantai;1;0;1;0;0;0
293;22.05.2017;2017;05;01;Maanantai;0;0;0;0;0;0
293;22.05.2017;2017;05;02;Maanantai;0;0;0;0;0;0
293;22.05.2017;2017;05;03;Maanantai;0;1;1;0;0;0
293;22.05.2017;2017;05;04;Maanantai;2;1;3;1;0;1
293;22.05.2017;2017;05;05;Maanantai;2;2;4;0;1;1
293;22.05.2017;2017;05;06;Maanantai;12;9;21;4;0;4
293;22.05.2017;2017;05;07;Maanantai;45;49;94;8;8;16
293;22.05.2017;2017;05;08;Maanantai;63;62;125;12;9;21
293;22.05.2017;2017;05;09;Maanantai;18;18;36;1;4;5
293;22.05.2017;2017;05;10;Maanantai;21;17;38;4;4;8
293;22.05.2017;2017;05;11;Maanantai;18;22;40;4;4;8
293;22.05.2017;2017;05;12;Maanantai;26;26;52;5;4;9
293;22.05.2017;2017;05;13;Maanantai;36;37;73;4;8;12
293;22.05.2017;2017;05;14;Maanantai;67;66;133;12;9;21
293;22.05.2017;2017;05;15;Maanantai;26;27;53;4;5;9
293;22.05.2017;2017;05;16;Maanantai;36;32;68;8;5;13
293;22.05.2017;2017;05;17;Maanantai;46;47;93;8;9;17
293;22.05.2017;2017;05;18;Maanantai;43;39;82;8;5;13
293;22.05.2017;2017;05;19;Maanantai;34;38;72;5;8;13
293;22.05.2017;2017;05;20;Maanantai;17;17;34;4;1;5
293;22.05.2017;2017;05;21;Maanantai;4;5;9;0;1;1
293;22.05.2017;2017;05;22;Maanantai;5;2;7;1;0;1
293;22.05.2017;2017;05;23;Maanantai;1;1;2;0;0;0
293;23.05.2017;2017;05;00;Tiistai;0;0;0;0;0;0
293;23.05.2017;2017;05;01;Tiistai;0;0;0;0;0;0
293;23.05.2017;2017;05;02;Tiistai;0;0;0;0;0;0
293;23.05.2017;2017;05;03;Tiistai;1;1;2;0;0;0
293;23.05.2017;2017;05;04;Tiistai;0;0;0;0;0;0
293;23.05.2017;2017;05;05;Tiistai;2;2;4;0;1;1
293;23.05.2017;2017;05;06;Tiistai;14;14;28;4;1;5
293;23.05.2017;2017;05;07;Tiistai;39;39;78;5;8;13
293;23.05.2017;2017;05;08;Tiistai;55;55;110;9;8;17
293;23.05.2017;2017;05;09;Tiistai;46;49;95;8;8;16
293;23.05.2017;2017;05;10;Tiistai;24;23;47;5;4;9
293;23.05.2017;2017;05;11;Tiistai;31;31;62;4;5;9
293;23.05.2017;2017;05;12;Tiistai;16;13;29;4;0;4
293;23.05.2017;2017;05;13;Tiistai;29;30;59;4;5;9
293;23.05.2017;2017;05;14;Tiistai;59;55;114;12;9;21
293;23.05.2017;2017;05;15;Tiistai;51;54;105;8;9;17
293;23.05.2017;2017;05;16;Tiistai;29;25;54;5;4;9
293;23.05.2017;2017;05;17;Tiistai;32;32;64;4;8;12
293;23.05.2017;2017;05;18;Tiistai;37;33;70;8;4;12
293;23.05.2017;2017;05;19;Tiistai;27;27;54;4;5;9
293;23.05.2017;2017;05;20;Tiistai;17;14;31;4;1;5
293;23.05.2017;2017;05;21;Tiistai;5;5;10;0;1;1
293;23.05.2017;2017;05;22;Tiistai;2;1;3;1;0;1
293;23.05.2017;2017;05;23;Tiistai;1;1;2;0;0;0
293;24.05.2017;2017;05;00;Keskiviikko;0;0;0;0;0;0
293;24.05.2017;2017;05;01;Keskiviikko;0;0;0;0;0;0
293;24.05.2017;2017;05;02;Keskiviikko;0;0;0;0;0;0
293;24.05.2017;2017;05;03;Keskiviikko;0;1;1;0;0;0
293;24.05.2017;2017;05;04;Keskiviikko;1;0;1;0;0;0
293;24.05.2017;2017;05;05;Keskiviikko;1;1;2;0;0;0
293;24.05.2017;2017;05;06;Keskiviikko;10;9;19;4;0;4
293;24.05.2017;2017;05;07;Keskiviikko;35;36;71;5;8;13
293;24.05.2017;2017;05;08;Keskiviikko;71;67;138;13;12;25
293;24.05.2017;2017;05;09;Keskiviikko;18;22;40;4;4;8
293;24.05.2017;2017;05;10;Keskiviikko;21;17;38;4;4;8
293;24.05.2017;2017;05;11;Keskiviikko;23;23;46;4;5;9
293;24.05.2017;2017;05;12;Keskiviikko;26;22;48;5;4;9
293;24.05.2017;2017;05;13;Keskiviikko;82;82;164;12;16;28
293;24.05.2017;2017;05;14;Keskiviikko;25;24;49;4;4;8
293;24.05.2017;2017;05;15;Keskiviikko;39;39;78;5;8;13
293;24.05.2017;2017;05;16;Keskiviikko;39;38;77;8;5;13
293;24.05.2017;2017;05;17;Keskiviikko;40;41;81;5;9;14
293;24.05.2017;2017;05;18;Keskiviikko;44;40;84;9;5;14
293;24.05.2017;2017;05;19;Keskiviikko;33;37;70;4;8;12
293;24.05.2017;2017;05;20;Keskiviikko;28;25;53;4;4;8
293;24.05.2017;2017;05;21;Keskiviikko;13;16;29;0;4;4
293;24.05.2017;2017;05;22;Keskiviikko;10;10;20;4;0;4
293;24.05.2017;2017;05;23;Keskiviikko;5;5;10;0;1;1
293;25.05.2017;2017;05;00;Torstai;3;2;5;1;0;1
293;25.05.2017;2017;05;01;Torstai;0;0;0;0;0;0
293;25.05.2017;2017;05;02;Torstai;1;0;1;0;0;0
293;25.05.2017;2017;05;03;Torstai;1;1;2;0;0;0
293;25.05.2017;2017;05;04;Torstai;1;0;1;0;0;0
293;25.05.2017;2017;05;05;Torstai;0;0;0;0;0;0
293;25.05.2017;2017;05;06;Torstai;6;2;8;1;0;1
293;25.05.2017;2017;05;07;Torstai;2;2;4;0;1;1
293;25.05.2017;2017;05;08;Torstai;11;7;18;4;1;5
293;25.05.2017;2017;05;09;Torstai;5;5;10;0;1;1
293;25.05.2017;2017;05;10;Torstai;15;14;29;4;1;5
293;25.05.2017;2017;05;11;Torstai;10;14;24;1;4;5
293;25.05.2017;2017;05;12;Torstai;26;23;49;5;4;9
293;25.05.2017;2017;05;13;Torstai;18;22;40;4;4;8
293;25.05.2017;2017;05;14;Torstai;28;25;53;4;4;8
293;25.05.2017;2017;05;15;Torstai;38;41;79;5;8;13
293;25.05.2017;2017;05;16;Torstai;34;31;65;8;4;12
293;25.05.2017;2017;05;17;Torstai;20;23;43;4;5;9
293;25.05.2017;2017;05;18;Torstai;39;36;75;8;5;13
293;25.05.2017;2017;05;19;Torstai;21;22;43;4;4;8
293;25.05.2017;2017;05;20;Torstai;21;21;42;4;4;8
293;25.05.2017;2017;05;21;Torstai;8;11;19;1;4;5
293;25.05.2017;2017;05;22;Torstai;1;1;2;0;0;0
293;25.05.2017;2017;05;23;Torstai;0;0;0;0;0;0
293;26.05.2017;2017;05;00;Perjantai;0;0;0;0;0;0
293;26.05.2017;2017;05;01;Perjantai;0;0;0;0;0;0
293;26.05.2017;2017;05;02;Perjantai;0;0;0;0;0;0
293;26.05.2017;2017;05;03;Perjantai;1;1;2;0;0;0
293;26.05.2017;2017;05;04;Perjantai;1;1;2;0;0;0
293;26.05.2017;2017;05;05;Perjantai;1;1;2;0;0;0
293;26.05.2017;2017;05;06;Perjantai;6;6;12;1;0;1
293;26.05.2017;2017;05;07;Perjantai;22;22;44;4;4;8
293;26.05.2017;2017;05;08;Perjantai;74;73;147;13;12;25
293;26.05.2017;2017;05;09;Perjantai;9;13;22;0;4;4
293;26.05.2017;2017;05;10;Perjantai;21;18;39;4;4;8
293;26.05.2017;2017;05;11;Perjantai;22;22;44;4;4;8
293;26.05.2017;2017;05;12;Perjantai;33;30;63;8;4;12
293;26.05.2017;2017;05;13;Perjantai;61;61;122;8;12;20
293;26.05.2017;2017;05;14;Perjantai;30;30;60;5;4;9
293;26.05.2017;2017;05;15;Perjantai;26;29;55;4;5;9
293;26.05.2017;2017;05;16;Perjantai;26;22;48;5;4;9
293;26.05.2017;2017;05;17;Perjantai;17;21;38;4;4;8
293;26.05.2017;2017;05;18;Perjantai;27;24;51;5;4;9
293;26.05.2017;2017;05;19;Perjantai;19;23;42;4;5;9
293;26.05.2017;2017;05;20;Perjantai;16;16;32;4;1;5
293;26.05.2017;2017;05;21;Perjantai;2;6;8;0;1;1
293;26.05.2017;2017;05;22;Perjantai;6;2;8;1;0;1
293;26.05.2017;2017;05;23;Perjantai;2;3;5;0;1;1
293;27.05.2017;2017;05;00;Lauantai;2;2;4;1;0;1
293;27.05.2017;2017;05;01;Lauantai;0;1;1;0;0;0
293;27.05.2017;2017;05;02;Lauantai;0;0;0;0;0;0
293;27.05.2017;2017;05;03;Lauantai;0;0;0;0;0;0
293;27.05.2017;2017;05;04;Lauantai;0;0;0;0;0;0
293;27.05.2017;2017;05;05;Lauantai;1;2;3;0;1;1
293;27.05.2017;2017;05;06;Lauantai;1;1;2;0;0;0
293;27.05.2017;2017;05;07;Lauantai;2;3;5;0;1;1
293;27.05.2017;2017;05;08;Lauantai;5;5;10;1;0;1
293;27.05.2017;2017;05;09;Lauantai;11;11;22;1;4;5
293;27.05.2017;2017;05;10;Lauantai;13;12;25;4;0;4
293;27.05.2017;2017;05;11;Lauantai;18;18;36;1;4;5
293;27.05.2017;2017;05;12;Lauantai;22;19;41;4;4;8
293;27.05.2017;2017;05;13;Lauantai;16;17;33;1;4;5
293;27.05.2017;2017;05;14;Lauantai;28;27;55;5;4;9
293;27.05.2017;2017;05;15;Lauantai;21;25;46;4;4;8
293;27.05.2017;2017;05;16;Lauantai;22;22;44;4;4;8
293;27.05.2017;2017;05;17;Lauantai;11;15;26;1;4;5
293;27.05.2017;2017;05;18;Lauantai;14;13;27;4;1;5
293;27.05.2017;2017;05;19;Lauantai;14;18;32;1;4;5
293;27.05.2017;2017;05;20;Lauantai;6;5;11;1;0;1
293;27.05.2017;2017;05;21;Lauantai;10;11;21;1;4;5
293;27.05.2017;2017;05;22;Lauantai;7;6;13;1;0;1
293;27.05.2017;2017;05;23;Lauantai;3;6;9;0;1;1
293;28.05.2017;2017;05;00;Sunnuntai;1;1;2;0;0;0
293;28.05.2017;2017;05;01;Sunnuntai;1;2;3;0;1;1
293;28.05.2017;2017;05;02;Sunnuntai;1;0;1;0;0;0
293;28.05.2017;2017;05;03;Sunnuntai;1;1;2;0;0;0
293;28.05.2017;2017;05;04;Sunnuntai;1;0;1;0;0;0
293;28.05.2017;2017;05;05;Sunnuntai;0;1;1;0;0;0
293;28.05.2017;2017;05;06;Sunnuntai;1;1;2;0;0;0
293;28.05.2017;2017;05;07;Sunnuntai;3;3;6;0;1;1
293;28.05.2017;2017;05;08;Sunnuntai;5;4;9;1;0;1
293;28.05.2017;2017;05;09;Sunnuntai;2;5;7;0;1;1
293;28.05.2017;2017;05;10;Sunnuntai;5;5;10;1;0;1
293;28.05.2017;2017;05;11;Sunnuntai;4;4;8;0;0;0
293;28.05.2017;2017;05;12;Sunnuntai;3;3;6;1;0;1
293;28.05.2017;2017;05;13;Sunnuntai;4;5;9;0;1;1
293;28.05.2017;2017;05;14;Sunnuntai;5;2;7;1;0;1
293;28.05.2017;2017;05;15;Sunnuntai;9;12;21;0;4;4
293;28.05.2017;2017;05;16;Sunnuntai;5;4;9;1;0;1
293;28.05.2017;2017;05;17;Sunnuntai;8;8;16;1;1;2
293;28.05.2017;2017;05;18;Sunnuntai;9;6;15;4;0;4
293;28.05.2017;2017;05;19;Sunnuntai;7;10;17;0;4;4
293;28.05.2017;2017;05;20;Sunnuntai;3;2;5;1;0;1
293;28.05.2017;2017;05;21;Sunnuntai;1;1;2;0;0;0
293;28.05.2017;2017;05;22;Sunnuntai;1;1;2;0;0;0
293;28.05.2017;2017;05;23;Sunnuntai;0;0;0;0;0;0
293;29.05.2017;2017;05;00;Maanantai;0;0;0;0;0;0
293;29.05.2017;2017;05;01;Maanantai;0;1;1;0;0;0
293;29.05.2017;2017;05;02;Maanantai;0;0;0;0;0;0
293;29.05.2017;2017;05;03;Maanantai;0;1;1;0;0;0
293;29.05.2017;2017;05;04;Maanantai;1;1;2;0;0;0
293;29.05.2017;2017;05;05;Maanantai;1;2;3;0;1;1
293;29.05.2017;2017;05;06;Maanantai;6;6;12;1;0;1
293;29.05.2017;2017;05;07;Maanantai;31;34;65;4;8;12
293;29.05.2017;2017;05;08;Maanantai;71;67;138;13;12;25
293;29.05.2017;2017;05;09;Maanantai;32;35;67;5;8;13
293;29.05.2017;2017;05;10;Maanantai;25;22;47;4;4;8
293;29.05.2017;2017;05;11;Maanantai;17;18;35;1;4;5
293;29.05.2017;2017;05;12;Maanantai;39;38;77;8;5;13
293;29.05.2017;2017;05;13;Maanantai;31;31;62;4;5;9
293;29.05.2017;2017;05;14;Maanantai;61;60;121;12;8;20
293;29.05.2017;2017;05;15;Maanantai;54;55;109;8;9;17
293;29.05.2017;2017;05;16;Maanantai;27;27;54;5;4;9
293;29.05.2017;2017;05;17;Maanantai;25;26;51;4;5;9
293;29.05.2017;2017;05;18;Maanantai;24;21;45;4;4;8
293;29.05.2017;2017;05;19;Maanantai;25;26;51;4;5;9
293;29.05.2017;2017;05;20;Maanantai;19;16;35;4;1;5
293;29.05.2017;2017;05;21;Maanantai;6;10;16;0;4;4
293;29.05.2017;2017;05;22;Maanantai;2;1;3;1;0;1
293;29.05.2017;2017;05;23;Maanantai;0;1;1;0;0;0
293;30.05.2017;2017;05;00;Tiistai;1;0;1;0;0;0
293;30.05.2017;2017;05;01;Tiistai;0;0;0;0;0;0
293;30.05.2017;2017;05;02;Tiistai;2;1;3;1;0;1
293;30.05.2017;2017;05;03;Tiistai;0;1;1;0;0;0
293;30.05.2017;2017;05;04;Tiistai;1;1;2;0;0;0
293;30.05.2017;2017;05;05;Tiistai;1;2;3;0;1;1
293;30.05.2017;2017;05;06;Tiistai;13;9;22;4;0;4
293;30.05.2017;2017;05;07;Tiistai;34;34;68;4;8;12
293;30.05.2017;2017;05;08;Tiistai;80;76;156;16;12;28
293;30.05.2017;2017;05;09;Tiistai;13;14;27;1;4;5
293;30.05.2017;2017;05;10;Tiistai;17;17;34;4;1;5
293;30.05.2017;2017;05;11;Tiistai;46;49;95;8;8;16
293;30.05.2017;2017;05;12;Tiistai;23;22;45;5;4;9
293;30.05.2017;2017;05;13;Tiistai;27;27;54;4;5;9
293;30.05.2017;2017;05;14;Tiistai;69;66;135;12;12;24
293;30.05.2017;2017;05;15;Tiistai;38;42;80;5;8;13
293;30.05.2017;2017;05;16;Tiistai;30;29;59;5;4;9
293;30.05.2017;2017;05;17;Tiistai;31;34;65;4;8;12
293;30.05.2017;2017;05;18;Tiistai;32;28;60;5;5;10
293;30.05.2017;2017;05;19;Tiistai;37;40;77;4;8;12
293;30.05.2017;2017;05;20;Tiistai;20;17;37;5;1;6
293;30.05.2017;2017;05;21;Tiistai;11;12;23;1;4;5
293;30.05.2017;2017;05;22;Tiistai;6;3;9;1;0;1
293;30.05.2017;2017;05;23;Tiistai;0;1;1;0;0;0
293;31.05.2017;2017;05;00;Keskiviikko;0;0;0;0;0;0
293;31.05.2017;2017;05;01;Keskiviikko;0;0;0;0;0;0
293;31.05.2017;2017;05;02;Keskiviikko;0;0;0;0;0;0
293;31.05.2017;2017;05;03;Keskiviikko;0;1;1;0;0;0
293;31.05.2017;2017;05;04;Keskiviikko;1;0;1;0;0;0
293;31.05.2017;2017;05;05;Keskiviikko;1;2;3;0;1;1
293;31.05.2017;2017;05;06;Keskiviikko;8;5;13;4;0;4
293;31.05.2017;2017;05;07;Keskiviikko;22;23;45;4;5;9
293;31.05.2017;2017;05;08;Keskiviikko;48;48;96;9;8;17
293;31.05.2017;2017;05;09;Keskiviikko;15;15;30;1;4;5
293;31.05.2017;2017;05;10;Keskiviikko;11;8;19;4;1;5
293;31.05.2017;2017;05;11;Keskiviikko;5;9;14;0;4;4
293;31.05.2017;2017;05;12;Keskiviikko;12;12;24;4;1;5
293;31.05.2017;2017;05;13;Keskiviikko;59;63;122;9;12;21
293;31.05.2017;2017;05;14;Keskiviikko;18;18;36;4;1;5
293;31.05.2017;2017;05;15;Keskiviikko;23;27;50;4;5;9
293;31.05.2017;2017;05;16;Keskiviikko;25;21;46;5;4;9
293;31.05.2017;2017;05;17;Keskiviikko;20;24;44;4;5;9
293;31.05.2017;2017;05;18;Keskiviikko;29;29;58;5;5;10
293;31.05.2017;2017;05;19;Keskiviikko;13;16;29;0;4;4
293;31.05.2017;2017;05;20;Keskiviikko;14;13;27;5;1;6
293;31.05.2017;2017;05;21;Keskiviikko;8;8;16;1;1;2
293;31.05.2017;2017;05;22;Keskiviikko;4;4;8;0;0;0
293;31.05.2017;2017;05;23;Keskiviikko;0;1;1;0;0;0
293;01.06.2017;2017;06;00;Torstai;4;1;5;0;0;0
293;01.06.2017;2017;06;01;Torstai;0;0;0;0;0;0
293;01.06.2017;2017;06;02;Torstai;1;1;2;0;0;0
293;01.06.2017;2017;06;03;Torstai;0;0;0;0;0;0
293;01.06.2017;2017;06;04;Torstai;1;0;1;0;0;0
293;01.06.2017;2017;06;05;Torstai;1;1;2;0;0;0
293;01.06.2017;2017;06;06;Torstai;7;6;13;1;0;1
293;01.06.2017;2017;06;07;Torstai;13;14;27;1;4;5
293;01.06.2017;2017;06;08;Torstai;78;78;156;13;12;25
293;01.06.2017;2017;06;09;Torstai;123;127;250;20;21;41
293;01.06.2017;2017;06;10;Torstai;106;105;211;20;16;36
293;01.06.2017;2017;06;11;Torstai;17;18;35;1;4;5
293;01.06.2017;2017;06;12;Torstai;14;11;25;4;1;5
293;01.06.2017;2017;06;13;Torstai;71;72;143;12;13;25
293;01.06.2017;2017;06;14;Torstai;26;23;49;5;4;9
293;01.06.2017;2017;06;15;Torstai;30;30;60;4;5;9
293;01.06.2017;2017;06;16;Torstai;17;17;34;4;1;5
293;01.06.2017;2017;06;17;Torstai;23;23;46;4;5;9
293;01.06.2017;2017;06;18;Torstai;19;19;38;4;1;5
293;01.06.2017;2017;06;19;Torstai;18;22;40;4;4;8
293;01.06.2017;2017;06;20;Torstai;14;14;28;4;1;5
293;01.06.2017;2017;06;21;Torstai;6;6;12;0;1;1
293;01.06.2017;2017;06;22;Torstai;2;2;4;1;0;1
293;01.06.2017;2017;06;23;Torstai;0;0;0;0;0;0
293;02.06.2017;2017;06;00;Perjantai;0;0;0;0;0;0
293;02.06.2017;2017;06;01;Perjantai;0;0;0;0;0;0
293;02.06.2017;2017;06;02;Perjantai;0;0;0;0;0;0
293;02.06.2017;2017;06;03;Perjantai;1;1;2;0;0;0
293;02.06.2017;2017;06;04;Perjantai;0;0;0;0;0;0
293;02.06.2017;2017;06;05;Perjantai;0;1;1;0;0;0
293;02.06.2017;2017;06;06;Perjantai;2;1;3;1;0;1
293;02.06.2017;2017;06;07;Perjantai;26;29;55;4;5;9
293;02.06.2017;2017;06;08;Perjantai;84;81;165;16;13;29
293;02.06.2017;2017;06;09;Perjantai;49;52;101;8;8;16
293;02.06.2017;2017;06;10;Perjantai;7;4;11;1;0;1
293;02.06.2017;2017;06;11;Perjantai;15;18;33;1;4;5
293;02.06.2017;2017;06;12;Perjantai;46;43;89;8;8;16
293;02.06.2017;2017;06;13;Perjantai;34;37;71;4;8;12
293;02.06.2017;2017;06;14;Perjantai;15;14;29;4;1;5
293;02.06.2017;2017;06;15;Perjantai;16;17;33;1;4;5
293;02.06.2017;2017;06;16;Perjantai;17;16;33;4;1;5
293;02.06.2017;2017;06;17;Perjantai;14;18;32;1;4;5
293;02.06.2017;2017;06;18;Perjantai;13;9;22;4;0;4
293;02.06.2017;2017;06;19;Perjantai;14;14;28;1;4;5
293;02.06.2017;2017;06;20;Perjantai;9;9;18;4;0;4
293;02.06.2017;2017;06;21;Perjantai;5;5;10;0;1;1
293;02.06.2017;2017;06;22;Perjantai;2;2;4;1;0;1
293;02.06.2017;2017;06;23;Perjantai;2;2;4;0;1;1
293;03.06.2017;2017;06;00;Lauantai;0;0;0;0;0;0
293;03.06.2017;2017;06;01;Lauantai;0;0;0;0;0;0
293;03.06.2017;2017;06;02;Lauantai;2;1;3;1;0;1
293;03.06.2017;2017;06;03;Lauantai;0;0;0;0;0;0
293;03.06.2017;2017;06;04;Lauantai;1;0;1;0;0;0
293;03.06.2017;2017;06;05;Lauantai;1;2;3;0;1;1
293;03.06.2017;2017;06;06;Lauantai;0;0;0;0;0;0
293;03.06.2017;2017;06;07;Lauantai;10;13;23;0;4;4
293;03.06.2017;2017;06;08;Lauantai;34;33;67;8;4;12
293;03.06.2017;2017;06;09;Lauantai;39;39;78;5;8;13
293;03.06.2017;2017;06;10;Lauantai;15;15;30;4;1;5
293;03.06.2017;2017;06;11;Lauantai;15;15;30;1;4;5
293;03.06.2017;2017;06;12;Lauantai;20;17;37;5;1;6
293;03.06.2017;2017;06;13;Lauantai;21;22;43;4;4;8
293;03.06.2017;2017;06;14;Lauantai;15;14;29;4;1;5
293;03.06.2017;2017;06;15;Lauantai;17;17;34;1;4;5
293;03.06.2017;2017;06;16;Lauantai;14;11;25;4;1;5
293;03.06.2017;2017;06;17;Lauantai;11;15;26;1;4;5
293;03.06.2017;2017;06;18;Lauantai;18;14;32;4;1;5
293;03.06.2017;2017;06;19;Lauantai;14;18;32;1;4;5
293;03.06.2017;2017;06;20;Lauantai;14;13;27;4;1;5
293;03.06.2017;2017;06;21;Lauantai;11;11;22;1;4;5
293;03.06.2017;2017;06;22;Lauantai;9;8;17;4;0;4
293;03.06.2017;2017;06;23;Lauantai;4;5;9;0;1;1
293;04.06.2017;2017;06;00;Sunnuntai;7;3;10;1;0;1
293;04.06.2017;2017;06;01;Sunnuntai;6;6;12;0;1;1
293;04.06.2017;2017;06;02;Sunnuntai;7;7;14;1;0;1
293;04.06.2017;2017;06;03;Sunnuntai;1;4;5;0;0;0
293;04.06.2017;2017;06;04;Sunnuntai;1;1;2;0;0;0
293;04.06.2017;2017;06;05;Sunnuntai;1;2;3;0;1;1
293;04.06.2017;2017;06;06;Sunnuntai;3;2;5;1;0;1
293;04.06.2017;2017;06;07;Sunnuntai;2;5;7;0;1;1
293;04.06.2017;2017;06;08;Sunnuntai;6;6;12;1;0;1
293;04.06.2017;2017;06;09;Sunnuntai;9;10;19;0;4;4
293;04.06.2017;2017;06;10;Sunnuntai;21;17;38;4;4;8
293;04.06.2017;2017;06;11;Sunnuntai;26;30;56;4;5;9
293;04.06.2017;2017;06;12;Sunnuntai;19;15;34;4;1;5
293;04.06.2017;2017;06;13;Sunnuntai;28;32;60;5;5;10
293;04.06.2017;2017;06;14;Sunnuntai;34;31;65;8;4;12
293;04.06.2017;2017;06;15;Sunnuntai;21;21;42;4;4;8
293;04.06.2017;2017;06;16;Sunnuntai;26;25;51;5;4;9
293;04.06.2017;2017;06;17;Sunnuntai;19;23;42;4;5;9
293;04.06.2017;2017;06;18;Sunnuntai;23;19;42;5;4;9
293;04.06.2017;2017;06;19;Sunnuntai;19;19;38;1;4;5
293;04.06.2017;2017;06;20;Sunnuntai;18;18;36;4;1;5
293;04.06.2017;2017;06;21;Sunnuntai;7;10;17;0;4;4
293;04.06.2017;2017;06;22;Sunnuntai;4;1;5;0;0;0
293;04.06.2017;2017;06;23;Sunnuntai;2;3;5;0;1;1
293;14.08.2017;2017;08;00;Maanantai;0;0;0;0;0;0
293;14.08.2017;2017;08;01;Maanantai;0;1;1;0;0;0
293;14.08.2017;2017;08;02;Maanantai;0;0;0;0;0;0
293;14.08.2017;2017;08;03;Maanantai;0;0;0;0;0;0
293;14.08.2017;2017;08;04;Maanantai;0;0;0;0;0;0
293;14.08.2017;2017;08;05;Maanantai;2;1;3;0;0;0
293;14.08.2017;2017;08;06;Maanantai;25;5;30;0;1;1
293;14.08.2017;2017;08;07;Maanantai;101;7;108;1;2;3
293;14.08.2017;2017;08;08;Maanantai;110;20;130;2;5;7
293;14.08.2017;2017;08;09;Maanantai;44;9;53;2;0;2
293;14.08.2017;2017;08;10;Maanantai;17;8;25;1;1;2
293;14.08.2017;2017;08;11;Maanantai;10;16;26;3;0;3
293;14.08.2017;2017;08;12;Maanantai;15;12;27;3;1;4
293;14.08.2017;2017;08;13;Maanantai;15;33;48;1;2;3
293;14.08.2017;2017;08;14;Maanantai;17;90;107;5;6;11
293;14.08.2017;2017;08;15;Maanantai;32;138;170;5;4;9
293;14.08.2017;2017;08;16;Maanantai;38;55;93;3;6;9
293;14.08.2017;2017;08;17;Maanantai;35;23;58;7;4;11
293;14.08.2017;2017;08;18;Maanantai;45;37;82;8;8;16
293;14.08.2017;2017;08;19;Maanantai;16;51;67;7;7;14
293;14.08.2017;2017;08;20;Maanantai;7;24;31;3;5;8
293;14.08.2017;2017;08;21;Maanantai;3;9;12;2;0;2
293;14.08.2017;2017;08;22;Maanantai;0;2;2;0;1;1
293;14.08.2017;2017;08;23;Maanantai;0;0;0;0;0;0
293;15.08.2017;2017;08;00;Tiistai;0;0;0;0;0;0
293;15.08.2017;2017;08;01;Tiistai;0;0;0;0;0;0
293;15.08.2017;2017;08;02;Tiistai;0;0;0;0;0;0
293;15.08.2017;2017;08;03;Tiistai;0;0;0;0;0;0
293;15.08.2017;2017;08;04;Tiistai;0;0;0;0;0;0
293;15.08.2017;2017;08;05;Tiistai;1;1;2;0;0;0
293;15.08.2017;2017;08;06;Tiistai;15;3;18;0;0;0
293;15.08.2017;2017;08;07;Tiistai;100;5;105;0;0;0
293;15.08.2017;2017;08;08;Tiistai;110;15;125;0;0;0
293;15.08.2017;2017;08;09;Tiistai;21;4;25;2;2;4
293;15.08.2017;2017;08;10;Tiistai;20;16;36;3;2;5
293;15.08.2017;2017;08;11;Tiistai;17;12;29;3;3;6
293;15.08.2017;2017;08;12;Tiistai;10;10;20;8;3;11
293;15.08.2017;2017;08;13;Tiistai;10;45;55;0;2;2
293;15.08.2017;2017;08;14;Tiistai;24;85;109;3;4;7
293;15.08.2017;2017;08;15;Tiistai;24;106;130;5;4;9
293;15.08.2017;2017;08;16;Tiistai;24;34;58;5;2;7
293;15.08.2017;2017;08;17;Tiistai;45;25;70;2;7;9
293;15.08.2017;2017;08;18;Tiistai;32;46;78;9;9;18
293;15.08.2017;2017;08;19;Tiistai;27;46;73;5;3;8
293;15.08.2017;2017;08;20;Tiistai;12;31;43;2;2;4
293;15.08.2017;2017;08;21;Tiistai;4;10;14;0;2;2
293;15.08.2017;2017;08;22;Tiistai;0;2;2;0;1;1
293;15.08.2017;2017;08;23;Tiistai;0;0;0;0;0;0
293;16.08.2017;2017;08;00;Keskiviikko;0;1;1;1;0;1
293;16.08.2017;2017;08;01;Keskiviikko;0;1;1;0;0;0
293;16.08.2017;2017;08;02;Keskiviikko;1;1;2;0;0;0
293;16.08.2017;2017;08;03;Keskiviikko;1;0;1;0;1;1
293;16.08.2017;2017;08;04;Keskiviikko;0;0;0;0;0;0
293;16.08.2017;2017;08;05;Keskiviikko;3;1;4;0;1;1
293;16.08.2017;2017;08;06;Keskiviikko;20;4;24;0;0;0
293;16.08.2017;2017;08;07;Keskiviikko;131;10;141;6;0;6
293;16.08.2017;2017;08;08;Keskiviikko;80;14;94;3;1;4
293;16.08.2017;2017;08;09;Keskiviikko;31;4;35;2;2;4
293;16.08.2017;2017;08;10;Keskiviikko;12;16;28;4;2;6
293;16.08.2017;2017;08;11;Keskiviikko;8;15;23;8;5;13
293;16.08.2017;2017;08;12;Keskiviikko;16;10;26;0;7;7
293;16.08.2017;2017;08;13;Keskiviikko;8;57;65;2;2;4
293;16.08.2017;2017;08;14;Keskiviikko;31;123;154;3;12;15
293;16.08.2017;2017;08;15;Keskiviikko;35;58;93;2;8;10
293;16.08.2017;2017;08;16;Keskiviikko;31;48;79;9;4;13
293;16.08.2017;2017;08;17;Keskiviikko;51;45;96;13;4;17
293;16.08.2017;2017;08;18;Keskiviikko;30;53;83;7;7;14
293;16.08.2017;2017;08;19;Keskiviikko;33;38;71;4;9;13
293;16.08.2017;2017;08;20;Keskiviikko;13;26;39;5;8;13
293;16.08.2017;2017;08;21;Keskiviikko;4;5;9;2;4;6
293;16.08.2017;2017;08;22;Keskiviikko;0;3;3;1;0;1
293;16.08.2017;2017;08;23;Keskiviikko;0;1;1;0;0;0
293;17.08.2017;2017;08;00;Torstai;0;0;0;0;0;0
293;17.08.2017;2017;08;01;Torstai;0;0;0;0;0;0
293;17.08.2017;2017;08;02;Torstai;0;0;0;0;0;0
293;17.08.2017;2017;08;03;Torstai;0;1;1;0;0;0
293;17.08.2017;2017;08;04;Torstai;0;0;0;0;0;0
293;17.08.2017;2017;08;05;Torstai;3;0;3;0;0;0
293;17.08.2017;2017;08;06;Torstai;19;2;21;2;0;2
293;17.08.2017;2017;08;07;Torstai;137;5;142;4;1;5
293;17.08.2017;2017;08;08;Torstai;70;17;87;5;1;6
293;17.08.2017;2017;08;09;Torstai;41;5;46;1;0;1
293;17.08.2017;2017;08;10;Torstai;17;16;33;6;4;10
293;17.08.2017;2017;08;11;Torstai;11;10;21;2;5;7
293;17.08.2017;2017;08;12;Torstai;16;11;27;4;3;7
293;17.08.2017;2017;08;13;Torstai;18;48;66;5;5;10
293;17.08.2017;2017;08;14;Torstai;15;96;111;4;11;15
293;17.08.2017;2017;08;15;Torstai;22;117;139;1;3;4
293;17.08.2017;2017;08;16;Torstai;38;47;85;4;4;8
293;17.08.2017;2017;08;17;Torstai;38;38;76;6;4;10
293;17.08.2017;2017;08;18;Torstai;45;40;85;4;6;10
293;17.08.2017;2017;08;19;Torstai;15;48;63;5;6;11
293;17.08.2017;2017;08;20;Torstai;12;16;28;4;5;9
293;17.08.2017;2017;08;21;Torstai;4;13;17;2;2;4
293;17.08.2017;2017;08;22;Torstai;1;3;4;0;2;2
293;17.08.2017;2017;08;23;Torstai;1;1;2;0;0;0
293;18.08.2017;2017;08;00;Perjantai;0;1;1;0;0;0
293;18.08.2017;2017;08;01;Perjantai;0;1;1;0;0;0
293;18.08.2017;2017;08;02;Perjantai;0;0;0;0;0;0
293;18.08.2017;2017;08;03;Perjantai;0;0;0;0;0;0
293;18.08.2017;2017;08;04;Perjantai;1;0;1;0;0;0
293;18.08.2017;2017;08;05;Perjantai;2;0;2;0;0;0
293;18.08.2017;2017;08;06;Perjantai;17;2;19;0;0;0
293;18.08.2017;2017;08;07;Perjantai;116;6;122;9;0;9
293;18.08.2017;2017;08;08;Perjantai;72;19;91;3;1;4
293;18.08.2017;2017;08;09;Perjantai;87;13;100;3;1;4
293;18.08.2017;2017;08;10;Perjantai;20;17;37;4;1;5
293;18.08.2017;2017;08;11;Perjantai;20;19;39;4;1;5
293;18.08.2017;2017;08;12;Perjantai;17;27;44;1;1;2
293;18.08.2017;2017;08;13;Perjantai;21;68;89;3;6;9
293;18.08.2017;2017;08;14;Perjantai;23;151;174;4;8;12
293;18.08.2017;2017;08;15;Perjantai;26;49;75;0;2;2
293;18.08.2017;2017;08;16;Perjantai;33;30;63;4;3;7
293;18.08.2017;2017;08;17;Perjantai;26;34;60;5;1;6
293;18.08.2017;2017;08;18;Perjantai;30;26;56;3;3;6
293;18.08.2017;2017;08;19;Perjantai;20;29;49;4;3;7
293;18.08.2017;2017;08;20;Perjantai;21;28;49;4;9;13
293;18.08.2017;2017;08;21;Perjantai;9;20;29;3;2;5
293;18.08.2017;2017;08;22;Perjantai;3;4;7;0;1;1
293;18.08.2017;2017;08;23;Perjantai;2;10;12;0;0;0
293;19.08.2017;2017;08;00;Lauantai;4;2;6;0;0;0
293;19.08.2017;2017;08;01;Lauantai;0;2;2;0;0;0
293;19.08.2017;2017;08;02;Lauantai;4;1;5;0;0;0
293;19.08.2017;2017;08;03;Lauantai;0;0;0;0;0;0
293;19.08.2017;2017;08;04;Lauantai;0;0;0;0;1;1
293;19.08.2017;2017;08;05;Lauantai;1;0;1;0;0;0
293;19.08.2017;2017;08;06;Lauantai;1;0;1;0;1;1
293;19.08.2017;2017;08;07;Lauantai;2;1;3;3;2;5
293;19.08.2017;2017;08;08;Lauantai;6;2;8;1;3;4
293;19.08.2017;2017;08;09;Lauantai;12;7;19;1;2;3
293;19.08.2017;2017;08;10;Lauantai;18;16;34;6;3;9
293;19.08.2017;2017;08;11;Lauantai;15;16;31;6;7;13
293;19.08.2017;2017;08;12;Lauantai;29;23;52;1;6;7
293;19.08.2017;2017;08;13;Lauantai;27;21;48;5;2;7
293;19.08.2017;2017;08;14;Lauantai;39;28;67;4;5;9
293;19.08.2017;2017;08;15;Lauantai;30;22;52;5;3;8
293;19.08.2017;2017;08;16;Lauantai;49;53;102;8;11;19
293;19.08.2017;2017;08;17;Lauantai;35;31;66;11;12;23
293;19.08.2017;2017;08;18;Lauantai;21;24;45;2;5;7
293;19.08.2017;2017;08;19;Lauantai;4;19;23;4;1;5
293;19.08.2017;2017;08;20;Lauantai;16;16;32;1;4;5
293;19.08.2017;2017;08;21;Lauantai;2;14;16;3;2;5
293;19.08.2017;2017;08;22;Lauantai;3;5;8;0;0;0
293;19.08.2017;2017;08;23;Lauantai;3;0;3;3;1;4
293;20.08.2017;2017;08;00;Sunnuntai;3;0;3;1;0;1
293;20.08.2017;2017;08;01;Sunnuntai;2;1;3;0;2;2
293;20.08.2017;2017;08;02;Sunnuntai;0;4;4;1;0;1
293;20.08.2017;2017;08;03;Sunnuntai;2;3;5;0;3;3
293;20.08.2017;2017;08;04;Sunnuntai;0;0;0;0;4;4
293;20.08.2017;2017;08;05;Sunnuntai;1;0;1;0;0;0
293;20.08.2017;2017;08;06;Sunnuntai;2;0;2;0;0;0
293;20.08.2017;2017;08;07;Sunnuntai;3;1;4;2;2;4
293;20.08.2017;2017;08;08;Sunnuntai;2;3;5;1;3;4
293;20.08.2017;2017;08;09;Sunnuntai;14;5;19;5;2;7
293;20.08.2017;2017;08;10;Sunnuntai;6;6;12;6;1;7
293;20.08.2017;2017;08;11;Sunnuntai;22;25;47;3;5;8
293;20.08.2017;2017;08;12;Sunnuntai;44;25;69;10;7;17
293;20.08.2017;2017;08;13;Sunnuntai;21;27;48;3;2;5
293;20.08.2017;2017;08;14;Sunnuntai;29;23;52;2;5;7
293;20.08.2017;2017;08;15;Sunnuntai;45;34;79;4;2;6
293;20.08.2017;2017;08;16;Sunnuntai;26;22;48;4;5;9
293;20.08.2017;2017;08;17;Sunnuntai;24;29;53;4;8;12
293;20.08.2017;2017;08;18;Sunnuntai;29;22;51;2;3;5
293;20.08.2017;2017;08;19;Sunnuntai;17;23;40;3;4;7
293;20.08.2017;2017;08;20;Sunnuntai;7;27;34;5;3;8
293;20.08.2017;2017;08;21;Sunnuntai;5;11;16;0;0;0
293;20.08.2017;2017;08;22;Sunnuntai;1;3;4;1;0;1
293;20.08.2017;2017;08;23;Sunnuntai;1;0;1;0;0;0
293;21.08.2017;2017;08;00;Maanantai;0;0;0;0;0;0
293;21.08.2017;2017;08;01;Maanantai;0;1;1;0;0;0
293;21.08.2017;2017;08;02;Maanantai;0;0;0;0;0;0
293;21.08.2017;2017;08;03;Maanantai;0;0;0;0;0;0
293;21.08.2017;2017;08;04;Maanantai;0;0;0;0;0;0
293;21.08.2017;2017;08;05;Maanantai;2;1;3;0;0;0
293;21.08.2017;2017;08;06;Maanantai;25;5;30;0;1;1
293;21.08.2017;2017;08;07;Maanantai;101;7;108;1;2;3
293;21.08.2017;2017;08;08;Maanantai;110;20;130;2;5;7
293;21.08.2017;2017;08;09;Maanantai;44;9;53;2;0;2
293;21.08.2017;2017;08;10;Maanantai;17;8;25;1;1;2
293;21.08.2017;2017;08;11;Maanantai;10;16;26;3;0;3
293;21.08.2017;2017;08;12;Maanantai;15;12;27;3;1;4
293;21.08.2017;2017;08;13;Maanantai;15;33;48;1;2;3
293;21.08.2017;2017;08;14;Maanantai;17;90;107;5;6;11
293;21.08.2017;2017;08;15;Maanantai;32;138;170;5;4;9
293;21.08.2017;2017;08;16;Maanantai;38;55;93;3;6;9
293;21.08.2017;2017;08;17;Maanantai;35;23;58;7;4;11
293;21.08.2017;2017;08;18;Maanantai;45;37;82;8;8;16
293;21.08.2017;2017;08;19;Maanantai;16;51;67;7;7;14
293;21.08.2017;2017;08;20;Maanantai;7;24;31;3;5;8
293;21.08.2017;2017;08;21;Maanantai;3;9;12;2;0;2
293;21.08.2017;2017;08;22;Maanantai;0;2;2;0;1;1
293;21.08.2017;2017;08;23;Maanantai;0;0;0;0;0;0
293;22.08.2017;2017;08;00;Tiistai;0;0;0;0;0;0
293;22.08.2017;2017;08;01;Tiistai;0;0;0;0;0;0
293;22.08.2017;2017;08;02;Tiistai;0;1;1;0;0;0
293;22.08.2017;2017;08;03;Tiistai;0;0;0;0;0;0
293;22.08.2017;2017;08;04;Tiistai;0;0;0;0;0;0
293;22.08.2017;2017;08;05;Tiistai;5;1;6;0;0;0
293;22.08.2017;2017;08;06;Tiistai;23;2;25;1;0;1
293;22.08.2017;2017;08;07;Tiistai;111;8;119;3;1;4
293;22.08.2017;2017;08;08;Tiistai;72;16;88;4;1;5
293;22.08.2017;2017;08;09;Tiistai;41;8;49;2;3;5
293;22.08.2017;2017;08;10;Tiistai;13;16;29;0;1;1
293;22.08.2017;2017;08;11;Tiistai;14;12;26;3;2;5
293;22.08.2017;2017;08;12;Tiistai;15;11;26;8;5;13
293;22.08.2017;2017;08;13;Tiistai;15;51;66;4;2;6
293;22.08.2017;2017;08;14;Tiistai;22;95;117;4;7;11
293;22.08.2017;2017;08;15;Tiistai;30;112;142;9;7;16
293;22.08.2017;2017;08;16;Tiistai;29;26;55;4;5;9
293;22.08.2017;2017;08;17;Tiistai;30;31;61;5;7;12
293;22.08.2017;2017;08;18;Tiistai;38;32;70;8;7;15
293;22.08.2017;2017;08;19;Tiistai;17;31;48;7;8;15
293;22.08.2017;2017;08;20;Tiistai;6;26;32;1;1;2
293;22.08.2017;2017;08;21;Tiistai;2;12;14;1;2;3
293;22.08.2017;2017;08;22;Tiistai;0;1;1;0;0;0
293;22.08.2017;2017;08;23;Tiistai;0;0;0;0;0;0
293;23.08.2017;2017;08;00;Keskiviikko;0;0;0;0;0;0
293;23.08.2017;2017;08;01;Keskiviikko;0;0;0;0;0;0
293;23.08.2017;2017;08;02;Keskiviikko;0;0;0;0;0;0
293;23.08.2017;2017;08;03;Keskiviikko;0;0;0;0;0;0
293;23.08.2017;2017;08;04;Keskiviikko;0;0;0;0;0;0
293;23.08.2017;2017;08;05;Keskiviikko;5;0;5;0;0;0
293;23.08.2017;2017;08;06;Keskiviikko;20;3;23;1;0;1
293;23.08.2017;2017;08;07;Keskiviikko;111;7;118;1;1;2
293;23.08.2017;2017;08;08;Keskiviikko;101;18;119;4;3;7
293;23.08.2017;2017;08;09;Keskiviikko;32;9;41;3;3;6
293;23.08.2017;2017;08;10;Keskiviikko;9;9;18;2;5;7
293;23.08.2017;2017;08;11;Keskiviikko;8;13;21;3;2;5
293;23.08.2017;2017;08;12;Keskiviikko;13;14;27;2;2;4
293;23.08.2017;2017;08;13;Keskiviikko;11;54;65;2;3;5
293;23.08.2017;2017;08;14;Keskiviikko;19;139;158;3;7;10
293;23.08.2017;2017;08;15;Keskiviikko;20;46;66;3;6;9
293;23.08.2017;2017;08;16;Keskiviikko;26;31;57;1;2;3
293;23.08.2017;2017;08;17;Keskiviikko;14;26;40;4;0;4
293;23.08.2017;2017;08;18;Keskiviikko;26;18;44;7;7;14
293;23.08.2017;2017;08;19;Keskiviikko;27;25;52;4;2;6
293;23.08.2017;2017;08;20;Keskiviikko;14;33;47;2;2;4
293;23.08.2017;2017;08;21;Keskiviikko;3;9;12;0;2;2
293;23.08.2017;2017;08;22;Keskiviikko;0;2;2;0;0;0
293;23.08.2017;2017;08;23;Keskiviikko;0;0;0;0;1;1
293;24.08.2017;2017;08;00;Torstai;0;0;0;0;0;0
293;24.08.2017;2017;08;01;Torstai;0;1;1;0;0;0
293;24.08.2017;2017;08;02;Torstai;0;0;0;0;0;0
293;24.08.2017;2017;08;03;Torstai;0;0;0;0;0;0
293;24.08.2017;2017;08;04;Torstai;0;0;0;0;0;0
293;24.08.2017;2017;08;05;Torstai;6;0;6;0;0;0
293;24.08.2017;2017;08;06;Torstai;16;3;19;0;0;0
293;24.08.2017;2017;08;07;Torstai;120;6;126;9;2;11
293;24.08.2017;2017;08;08;Torstai;77;16;93;5;1;6
293;24.08.2017;2017;08;09;Torstai;29;10;39;0;3;3
293;24.08.2017;2017;08;10;Torstai;9;7;16;1;1;2
293;24.08.2017;2017;08;11;Torstai;9;4;13;2;3;5
293;24.08.2017;2017;08;12;Torstai;15;15;30;1;2;3
293;24.08.2017;2017;08;13;Torstai;29;59;88;1;5;6
293;24.08.2017;2017;08;14;Torstai;20;87;107;3;5;8
293;24.08.2017;2017;08;15;Torstai;18;107;125;1;4;5
293;24.08.2017;2017;08;16;Torstai;24;38;62;4;5;9
293;24.08.2017;2017;08;17;Torstai;36;26;62;2;6;8
293;24.08.2017;2017;08;18;Torstai;11;20;31;3;2;5
293;24.08.2017;2017;08;19;Torstai;14;28;42;5;9;14
293;24.08.2017;2017;08;20;Torstai;11;18;29;0;3;3
293;24.08.2017;2017;08;21;Torstai;4;7;11;0;1;1
293;24.08.2017;2017;08;22;Torstai;2;3;5;0;0;0
293;24.08.2017;2017;08;23;Torstai;0;1;1;0;0;0
293;25.08.2017;2017;08;00;Perjantai;0;0;0;0;0;0
293;25.08.2017;2017;08;01;Perjantai;1;0;1;0;0;0
293;25.08.2017;2017;08;02;Perjantai;0;1;1;0;0;0
293;25.08.2017;2017;08;03;Perjantai;1;0;1;0;0;0
293;25.08.2017;2017;08;04;Perjantai;0;1;1;0;0;0
293;25.08.2017;2017;08;05;Perjantai;2;0;2;0;0;0
293;25.08.2017;2017;08;06;Perjantai;10;1;11;0;0;0
293;25.08.2017;2017;08;07;Perjantai;53;6;59;2;2;4
293;25.08.2017;2017;08;08;Perjantai;121;17;138;6;1;7
293;25.08.2017;2017;08;09;Perjantai;45;8;53;0;1;1
293;25.08.2017;2017;08;10;Perjantai;11;9;20;0;0;0
293;25.08.2017;2017;08;11;Perjantai;8;12;20;1;1;2
293;25.08.2017;2017;08;12;Perjantai;14;40;54;7;2;9
293;25.08.2017;2017;08;13;Perjantai;18;109;127;3;15;18
293;25.08.2017;2017;08;14;Perjantai;19;56;75;2;9;11
293;25.08.2017;2017;08;15;Perjantai;21;39;60;5;2;7
293;25.08.2017;2017;08;16;Perjantai;21;12;33;1;1;2
293;25.08.2017;2017;08;17;Perjantai;29;12;41;1;2;3
293;25.08.2017;2017;08;18;Perjantai;5;10;15;1;2;3
293;25.08.2017;2017;08;19;Perjantai;6;22;28;0;5;5
293;25.08.2017;2017;08;20;Perjantai;7;27;34;1;4;5
293;25.08.2017;2017;08;21;Perjantai;7;6;13;0;1;1
293;25.08.2017;2017;08;22;Perjantai;1;4;5;0;1;1
293;25.08.2017;2017;08;23;Perjantai;1;1;2;0;0;0
293;26.08.2017;2017;08;00;Lauantai;0;3;3;0;0;0
293;26.08.2017;2017;08;01;Lauantai;0;1;1;0;0;0
293;26.08.2017;2017;08;02;Lauantai;0;0;0;0;2;2
293;26.08.2017;2017;08;03;Lauantai;0;2;2;1;3;4
293;26.08.2017;2017;08;04;Lauantai;0;0;0;0;1;1
293;26.08.2017;2017;08;05;Lauantai;0;0;0;0;0;0
293;26.08.2017;2017;08;06;Lauantai;1;0;1;0;0;0
293;26.08.2017;2017;08;07;Lauantai;4;0;4;1;0;1
293;26.08.2017;2017;08;08;Lauantai;4;0;4;1;1;2
293;26.08.2017;2017;08;09;Lauantai;9;9;18;7;1;8
293;26.08.2017;2017;08;10;Lauantai;14;8;22;5;4;9
293;26.08.2017;2017;08;11;Lauantai;26;12;38;5;6;11
293;26.08.2017;2017;08;12;Lauantai;22;15;37;3;5;8
293;26.08.2017;2017;08;13;Lauantai;20;16;36;3;6;9
293;26.08.2017;2017;08;14;Lauantai;17;18;35;2;3;5
293;26.08.2017;2017;08;15;Lauantai;18;25;43;5;2;7
293;26.08.2017;2017;08;16;Lauantai;19;18;37;1;5;6
293;26.08.2017;2017;08;17;Lauantai;13;16;29;4;6;10
293;26.08.2017;2017;08;18;Lauantai;11;20;31;2;3;5
293;26.08.2017;2017;08;19;Lauantai;25;16;41;5;5;10
293;26.08.2017;2017;08;20;Lauantai;9;23;32;0;2;2
293;26.08.2017;2017;08;21;Lauantai;4;15;19;1;2;3
293;26.08.2017;2017;08;22;Lauantai;9;7;16;1;0;1
293;26.08.2017;2017;08;23;Lauantai;2;4;6;0;2;2
293;27.08.2017;2017;08;00;Sunnuntai;8;1;9;1;1;2
293;27.08.2017;2017;08;01;Sunnuntai;0;5;5;0;1;1
293;27.08.2017;2017;08;02;Sunnuntai;3;2;5;0;1;1
293;27.08.2017;2017;08;03;Sunnuntai;5;7;12;1;1;2
293;27.08.2017;2017;08;04;Sunnuntai;1;0;1;0;0;0
293;27.08.2017;2017;08;05;Sunnuntai;0;1;1;0;0;0
293;27.08.2017;2017;08;06;Sunnuntai;1;0;1;0;0;0
293;27.08.2017;2017;08;07;Sunnuntai;4;0;4;1;0;1
293;27.08.2017;2017;08;08;Sunnuntai;2;3;5;3;4;7
293;27.08.2017;2017;08;09;Sunnuntai;11;7;18;1;4;5
293;27.08.2017;2017;08;10;Sunnuntai;10;10;20;3;1;4
293;27.08.2017;2017;08;11;Sunnuntai;15;16;31;4;8;12
293;27.08.2017;2017;08;12;Sunnuntai;21;21;42;9;3;12
293;27.08.2017;2017;08;13;Sunnuntai;14;18;32;6;10;16
293;27.08.2017;2017;08;14;Sunnuntai;30;9;39;6;3;9
293;27.08.2017;2017;08;15;Sunnuntai;7;21;28;2;6;8
293;27.08.2017;2017;08;16;Sunnuntai;20;10;30;0;1;1
293;27.08.2017;2017;08;17;Sunnuntai;23;25;48;2;7;9
293;27.08.2017;2017;08;18;Sunnuntai;23;17;40;8;8;16
293;27.08.2017;2017;08;19;Sunnuntai;9;28;37;3;4;7
293;27.08.2017;2017;08;20;Sunnuntai;7;13;20;1;3;4
293;27.08.2017;2017;08;21;Sunnuntai;3;13;16;0;0;0
293;27.08.2017;2017;08;22;Sunnuntai;1;1;2;0;0;0
293;27.08.2017;2017;08;23;Sunnuntai;0;0;0;0;0;0
293;28.08.2017;2017;08;00;Maanantai;1;1;2;1;2;3
293;28.08.2017;2017;08;01;Maanantai;0;1;1;1;0;1
293;28.08.2017;2017;08;02;Maanantai;0;0;0;0;0;0
293;28.08.2017;2017;08;03;Maanantai;0;0;0;0;0;0
293;28.08.2017;2017;08;04;Maanantai;0;0;0;0;0;0
293;28.08.2017;2017;08;05;Maanantai;5;1;6;0;0;0
293;28.08.2017;2017;08;06;Maanantai;15;5;20;0;0;0
293;28.08.2017;2017;08;07;Maanantai;95;5;100;6;0;6
293;28.08.2017;2017;08;08;Maanantai;107;18;125;4;1;5
293;28.08.2017;2017;08;09;Maanantai;33;11;44;6;2;8
293;28.08.2017;2017;08;10;Maanantai;14;15;29;1;1;2
293;28.08.2017;2017;08;11;Maanantai;22;17;39;5;2;7
293;28.08.2017;2017;08;12;Maanantai;19;11;30;14;10;24
293;28.08.2017;2017;08;13;Maanantai;17;42;59;2;4;6
293;28.08.2017;2017;08;14;Maanantai;29;101;130;7;7;14
293;28.08.2017;2017;08;15;Maanantai;19;119;138;4;3;7
293;28.08.2017;2017;08;16;Maanantai;28;37;65;8;7;15
293;28.08.2017;2017;08;17;Maanantai;39;34;73;4;4;8
293;28.08.2017;2017;08;18;Maanantai;43;31;74;4;4;8
293;28.08.2017;2017;08;19;Maanantai;28;42;70;4;8;12
293;28.08.2017;2017;08;20;Maanantai;3;34;37;1;3;4
293;28.08.2017;2017;08;21;Maanantai;6;10;16;0;1;1
293;28.08.2017;2017;08;22;Maanantai;0;1;1;0;0;0
293;28.08.2017;2017;08;23;Maanantai;0;0;0;0;0;0
293;29.08.2017;2017;08;00;Tiistai;0;0;0;0;0;0
293;29.08.2017;2017;08;01;Tiistai;0;0;0;0;0;0
293;29.08.2017;2017;08;02;Tiistai;0;1;1;0;0;0
293;29.08.2017;2017;08;03;Tiistai;0;0;0;0;1;1
293;29.08.2017;2017;08;04;Tiistai;0;0;0;0;0;0
293;29.08.2017;2017;08;05;Tiistai;6;0;6;1;0;1
293;29.08.2017;2017;08;06;Tiistai;23;4;27;0;0;0
293;29.08.2017;2017;08;07;Tiistai;115;5;120;4;0;4
293;29.08.2017;2017;08;08;Tiistai;76;15;91;5;4;9
293;29.08.2017;2017;08;09;Tiistai;22;7;29;5;2;7
293;29.08.2017;2017;08;10;Tiistai;9;11;20;1;1;2
293;29.08.2017;2017;08;11;Tiistai;10;8;18;6;6;12
293;29.08.2017;2017;08;12;Tiistai;9;12;21;2;1;3
293;29.08.2017;2017;08;13;Tiistai;15;71;86;2;7;9
293;29.08.2017;2017;08;14;Tiistai;13;74;87;1;6;7
293;29.08.2017;2017;08;15;Tiistai;12;84;96;2;6;8
293;29.08.2017;2017;08;16;Tiistai;15;15;30;2;3;5
293;29.08.2017;2017;08;17;Tiistai;17;9;26;1;0;1
293;29.08.2017;2017;08;18;Tiistai;6;10;16;1;3;4
293;29.08.2017;2017;08;19;Tiistai;5;11;16;6;4;10
293;29.08.2017;2017;08;20;Tiistai;4;18;22;1;2;3
293;29.08.2017;2017;08;21;Tiistai;0;3;3;1;1;2
293;29.08.2017;2017;08;22;Tiistai;2;1;3;0;0;0
293;29.08.2017;2017;08;23;Tiistai;1;0;1;0;0;0
293;30.08.2017;2017;08;00;Keskiviikko;0;0;0;0;0;0
293;30.08.2017;2017;08;01;Keskiviikko;0;0;0;0;0;0
293;30.08.2017;2017;08;02;Keskiviikko;0;0;0;0;0;0
293;30.08.2017;2017;08;03;Keskiviikko;0;0;0;0;0;0
293;30.08.2017;2017;08;04;Keskiviikko;0;0;0;0;0;0
293;30.08.2017;2017;08;05;Keskiviikko;2;0;2;0;0;0
293;30.08.2017;2017;08;06;Keskiviikko;12;2;14;0;0;0
293;30.08.2017;2017;08;07;Keskiviikko;90;3;93;9;2;11
293;30.08.2017;2017;08;08;Keskiviikko;84;10;94;11;0;11
293;30.08.2017;2017;08;09;Keskiviikko;10;5;15;1;0;1
293;30.08.2017;2017;08;10;Keskiviikko;4;8;12;1;0;1
293;30.08.2017;2017;08;11;Keskiviikko;2;4;6;1;0;1
293;30.08.2017;2017;08;12;Keskiviikko;10;11;21;0;1;1
293;30.08.2017;2017;08;13;Keskiviikko;14;67;81;3;9;12
293;30.08.2017;2017;08;14;Keskiviikko;16;97;113;2;7;9
293;30.08.2017;2017;08;15;Keskiviikko;19;30;49;3;1;4
293;30.08.2017;2017;08;16;Keskiviikko;38;36;74;5;2;7
293;30.08.2017;2017;08;17;Keskiviikko;23;22;45;6;4;10
293;30.08.2017;2017;08;18;Keskiviikko;41;27;68;2;4;6
293;30.08.2017;2017;08;19;Keskiviikko;21;52;73;5;6;11
293;30.08.2017;2017;08;20;Keskiviikko;9;17;26;1;5;6
293;30.08.2017;2017;08;21;Keskiviikko;5;6;11;2;2;4
293;30.08.2017;2017;08;22;Keskiviikko;1;3;4;0;0;0
293;30.08.2017;2017;08;23;Keskiviikko;0;1;1;0;1;1
293;31.08.2017;2017;08;00;Torstai;0;1;1;0;0;0
293;31.08.2017;2017;08;01;Torstai;0;0;0;0;0;0
293;31.08.2017;2017;08;02;Torstai;0;0;0;1;0;1
293;31.08.2017;2017;08;03;Torstai;0;0;0;0;0;0
293;31.08.2017;2017;08;04;Torstai;0;0;0;0;0;0
293;31.08.2017;2017;08;05;Torstai;6;0;6;0;0;0
293;31.08.2017;2017;08;06;Torstai;14;3;17;2;0;2
293;31.08.2017;2017;08;07;Torstai;116;7;123;5;1;6
293;31.08.2017;2017;08;08;Torstai;81;9;90;2;2;4
293;31.08.2017;2017;08;09;Torstai;47;13;60;2;2;4
293;31.08.2017;2017;08;10;Torstai;13;22;35;5;0;5
293;31.08.2017;2017;08;11;Torstai;11;6;17;2;3;5
293;31.08.2017;2017;08;12;Torstai;18;15;33;2;2;4
293;31.08.2017;2017;08;13;Torstai;16;34;50;0;1;1
293;31.08.2017;2017;08;14;Torstai;20;119;139;0;5;5
293;31.08.2017;2017;08;15;Torstai;20;98;118;5;2;7
293;31.08.2017;2017;08;16;Torstai;39;38;77;3;3;6
293;31.08.2017;2017;08;17;Torstai;25;31;56;4;5;9
293;31.08.2017;2017;08;18;Torstai;34;27;61;3;3;6
293;31.08.2017;2017;08;19;Torstai;18;36;54;2;5;7
293;31.08.2017;2017;08;20;Torstai;12;30;42;1;3;4
293;31.08.2017;2017;08;21;Torstai;2;13;15;0;2;2
293;31.08.2017;2017;08;22;Torstai;0;1;1;0;0;0
293;31.08.2017;2017;08;23;Torstai;0;0;0;0;0;0
293;01.09.2017;2017;09;00;Perjantai;0;0;0;0;0;0
293;01.09.2017;2017;09;01;Perjantai;0;0;0;0;0;0
293;01.09.2017;2017;09;02;Perjantai;0;0;0;0;0;0
293;01.09.2017;2017;09;03;Perjantai;1;0;1;0;0;0
293;01.09.2017;2017;09;04;Perjantai;0;0;0;0;0;0
293;01.09.2017;2017;09;05;Perjantai;1;0;1;0;0;0
293;01.09.2017;2017;09;06;Perjantai;8;3;11;2;0;2
293;01.09.2017;2017;09;07;Perjantai;55;3;58;1;2;3
293;01.09.2017;2017;09;08;Perjantai;18;0;18;4;0;4
293;01.09.2017;2017;09;09;Perjantai;12;0;12;5;0;5
293;01.09.2017;2017;09;10;Perjantai;5;3;8;1;0;1
293;01.09.2017;2017;09;11;Perjantai;6;3;9;1;0;1
293;01.09.2017;2017;09;12;Perjantai;3;15;18;0;2;2
293;01.09.2017;2017;09;13;Perjantai;10;23;33;1;6;7
293;01.09.2017;2017;09;14;Perjantai;8;56;64;0;12;12
293;01.09.2017;2017;09;15;Perjantai;5;22;27;3;8;11
293;01.09.2017;2017;09;16;Perjantai;8;9;17;1;3;4
293;01.09.2017;2017;09;17;Perjantai;5;9;14;3;4;7
293;01.09.2017;2017;09;18;Perjantai;7;10;17;1;0;1
293;01.09.2017;2017;09;19;Perjantai;14;10;24;1;1;2
293;01.09.2017;2017;09;20;Perjantai;11;12;23;4;4;8
293;01.09.2017;2017;09;21;Perjantai;7;10;17;2;1;3
293;01.09.2017;2017;09;22;Perjantai;2;5;7;0;0;0
293;01.09.2017;2017;09;23;Perjantai;4;8;12;2;2;4
293;02.09.2017;2017;09;00;Lauantai;3;0;3;0;0;0
293;02.09.2017;2017;09;01;Lauantai;0;0;0;0;0;0
293;02.09.2017;2017;09;02;Lauantai;0;3;3;0;1;1
293;02.09.2017;2017;09;03;Lauantai;0;0;0;0;0;0
293;02.09.2017;2017;09;04;Lauantai;0;0;0;0;1;1
293;02.09.2017;2017;09;05;Lauantai;1;1;2;1;0;1
293;02.09.2017;2017;09;06;Lauantai;1;0;1;1;1;2
293;02.09.2017;2017;09;07;Lauantai;3;1;4;2;4;6
293;02.09.2017;2017;09;08;Lauantai;5;4;9;2;0;2
293;02.09.2017;2017;09;09;Lauantai;9;7;16;0;2;2
293;02.09.2017;2017;09;10;Lauantai;13;9;22;5;2;7
293;02.09.2017;2017;09;11;Lauantai;24;13;37;7;4;11
293;02.09.2017;2017;09;12;Lauantai;27;15;42;4;3;7
293;02.09.2017;2017;09;13;Lauantai;40;20;60;11;3;14
293;02.09.2017;2017;09;14;Lauantai;38;20;58;6;5;11
293;02.09.2017;2017;09;15;Lauantai;22;38;60;4;9;13
293;02.09.2017;2017;09;16;Lauantai;29;45;74;7;9;16
293;02.09.2017;2017;09;17;Lauantai;39;49;88;6;6;12
293;02.09.2017;2017;09;18;Lauantai;43;14;57;6;9;15
293;02.09.2017;2017;09;19;Lauantai;19;31;50;9;3;12
293;02.09.2017;2017;09;20;Lauantai;17;30;47;3;5;8
293;02.09.2017;2017;09;21;Lauantai;8;16;24;1;2;3
293;02.09.2017;2017;09;22;Lauantai;11;4;15;2;1;3
293;02.09.2017;2017;09;23;Lauantai;7;3;10;0;2;2
293;03.09.2017;2017;09;00;Sunnuntai;3;2;5;1;1;2
293;03.09.2017;2017;09;01;Sunnuntai;0;5;5;1;0;1
293;03.09.2017;2017;09;02;Sunnuntai;0;3;3;1;1;2
293;03.09.2017;2017;09;03;Sunnuntai;0;1;1;0;1;1
293;03.09.2017;2017;09;04;Sunnuntai;0;0;0;1;0;1
293;03.09.2017;2017;09;05;Sunnuntai;1;0;1;0;0;0
293;03.09.2017;2017;09;06;Sunnuntai;1;0;1;1;0;1
293;03.09.2017;2017;09;07;Sunnuntai;3;1;4;2;1;3
293;03.09.2017;2017;09;08;Sunnuntai;3;2;5;2;2;4
293;03.09.2017;2017;09;09;Sunnuntai;9;4;13;2;0;2
293;03.09.2017;2017;09;10;Sunnuntai;17;11;28;2;5;7
293;03.09.2017;2017;09;11;Sunnuntai;12;14;26;5;2;7
293;03.09.2017;2017;09;12;Sunnuntai;23;29;52;3;1;4
293;03.09.2017;2017;09;13;Sunnuntai;27;21;48;2;3;5
293;03.09.2017;2017;09;14;Sunnuntai;39;26;65;4;5;9
293;03.09.2017;2017;09;15;Sunnuntai;32;31;63;10;6;16
293;03.09.2017;2017;09;16;Sunnuntai;38;29;67;8;3;11
293;03.09.2017;2017;09;17;Sunnuntai;21;19;40;9;8;17
293;03.09.2017;2017;09;18;Sunnuntai;31;41;72;7;8;15
293;03.09.2017;2017;09;19;Sunnuntai;26;29;55;4;1;5
293;03.09.2017;2017;09;20;Sunnuntai;13;28;41;2;3;5
293;03.09.2017;2017;09;21;Sunnuntai;3;10;13;3;2;5
293;03.09.2017;2017;09;22;Sunnuntai;1;0;1;0;0;0
293;03.09.2017;2017;09;23;Sunnuntai;0;1;1;0;0;0
293;04.09.2017;2017;09;00;Maanantai;1;0;1;0;0;0
293;04.09.2017;2017;09;01;Maanantai;0;1;1;0;0;0
293;04.09.2017;2017;09;02;Maanantai;0;0;0;0;0;0
293;04.09.2017;2017;09;03;Maanantai;0;1;1;0;0;0
293;04.09.2017;2017;09;04;Maanantai;0;0;0;0;0;0
293;04.09.2017;2017;09;05;Maanantai;5;0;5;0;0;0
293;04.09.2017;2017;09;06;Maanantai;16;3;19;1;0;1
293;04.09.2017;2017;09;07;Maanantai;99;8;107;3;2;5
293;04.09.2017;2017;09;08;Maanantai;115;22;137;4;0;4
293;04.09.2017;2017;09;09;Maanantai;40;15;55;6;1;7
293;04.09.2017;2017;09;10;Maanantai;22;13;35;4;2;6
293;04.09.2017;2017;09;11;Maanantai;18;17;35;2;0;2
293;04.09.2017;2017;09;12;Maanantai;12;19;31;4;3;7
293;04.09.2017;2017;09;13;Maanantai;20;35;55;1;3;4
293;04.09.2017;2017;09;14;Maanantai;25;84;109;3;3;6
293;04.09.2017;2017;09;15;Maanantai;24;140;164;6;6;12
293;04.09.2017;2017;09;16;Maanantai;33;40;73;5;9;14
293;04.09.2017;2017;09;17;Maanantai;38;36;74;7;4;11
293;04.09.2017;2017;09;18;Maanantai;34;39;73;14;5;19
293;04.09.2017;2017;09;19;Maanantai;23;38;61;0;4;4
293;04.09.2017;2017;09;20;Maanantai;8;26;34;0;4;4
293;04.09.2017;2017;09;21;Maanantai;0;12;12;2;0;2
293;04.09.2017;2017;09;22;Maanantai;0;2;2;0;0;0
293;04.09.2017;2017;09;23;Maanantai;0;0;0;0;0;0
293;05.09.2017;2017;09;00;Tiistai;2;0;2;0;0;0
293;05.09.2017;2017;09;01;Tiistai;0;0;0;0;1;1
293;05.09.2017;2017;09;02;Tiistai;0;1;1;0;0;0
293;05.09.2017;2017;09;03;Tiistai;0;0;0;0;0;0
293;05.09.2017;2017;09;04;Tiistai;0;0;0;0;0;0
293;05.09.2017;2017;09;05;Tiistai;4;0;4;0;0;0
293;05.09.2017;2017;09;06;Tiistai;17;4;21;1;0;1
293;05.09.2017;2017;09;07;Tiistai;91;8;99;7;2;9
293;05.09.2017;2017;09;08;Tiistai;95;11;106;4;2;6
293;05.09.2017;2017;09;09;Tiistai;42;10;52;7;3;10
293;05.09.2017;2017;09;10;Tiistai;20;14;34;2;4;6
293;05.09.2017;2017;09;11;Tiistai;11;14;25;3;2;5
293;05.09.2017;2017;09;12;Tiistai;12;14;26;2;1;3
293;05.09.2017;2017;09;13;Tiistai;16;53;69;1;4;5
293;05.09.2017;2017;09;14;Tiistai;32;97;129;2;8;10
293;05.09.2017;2017;09;15;Tiistai;24;87;111;8;6;14
293;05.09.2017;2017;09;16;Tiistai;30;46;76;3;7;10
293;05.09.2017;2017;09;17;Tiistai;35;25;60;5;10;15
293;05.09.2017;2017;09;18;Tiistai;34;26;60;12;2;14
293;05.09.2017;2017;09;19;Tiistai;31;45;76;2;4;6
293;05.09.2017;2017;09;20;Tiistai;8;30;38;3;7;10
293;05.09.2017;2017;09;21;Tiistai;1;16;17;0;1;1
293;05.09.2017;2017;09;22;Tiistai;0;1;1;0;1;1
293;05.09.2017;2017;09;23;Tiistai;0;0;0;0;0;0
293;06.09.2017;2017;09;00;Keskiviikko;0;1;1;0;0;0
293;06.09.2017;2017;09;01;Keskiviikko;0;0;0;0;0;0
293;06.09.2017;2017;09;02;Keskiviikko;0;1;1;0;0;0
293;06.09.2017;2017;09;03;Keskiviikko;0;0;0;1;0;1
293;06.09.2017;2017;09;04;Keskiviikko;0;0;0;0;0;0
293;06.09.2017;2017;09;05;Keskiviikko;2;0;2;0;0;0
293;06.09.2017;2017;09;06;Keskiviikko;24;2;26;1;0;1
293;06.09.2017;2017;09;07;Keskiviikko;101;10;111;4;1;5
293;06.09.2017;2017;09;08;Keskiviikko;101;16;117;8;1;9
293;06.09.2017;2017;09;09;Keskiviikko;32;5;37;3;4;7
293;06.09.2017;2017;09;10;Keskiviikko;12;21;33;1;2;3
293;06.09.2017;2017;09;11;Keskiviikko;14;17;31;3;2;5
293;06.09.2017;2017;09;12;Keskiviikko;17;23;40;4;4;8
293;06.09.2017;2017;09;13;Keskiviikko;25;58;83;0;1;1
293;06.09.2017;2017;09;14;Keskiviikko;27;130;157;3;17;20
293;06.09.2017;2017;09;15;Keskiviikko;26;49;75;2;5;7
293;06.09.2017;2017;09;16;Keskiviikko;27;42;69;5;4;9
293;06.09.2017;2017;09;17;Keskiviikko;47;28;75;6;7;13
293;06.09.2017;2017;09;18;Keskiviikko;34;43;77;3;11;14
293;06.09.2017;2017;09;19;Keskiviikko;38;41;79;9;6;15
293;06.09.2017;2017;09;20;Keskiviikko;6;33;39;3;4;7
293;06.09.2017;2017;09;21;Keskiviikko;3;8;11;2;0;2
293;06.09.2017;2017;09;22;Keskiviikko;0;1;1;0;0;0
293;06.09.2017;2017;09;23;Keskiviikko;0;0;0;0;0;0
293;07.09.2017;2017;09;00;Torstai;0;0;0;0;0;0
293;07.09.2017;2017;09;01;Torstai;0;0;0;0;1;1
293;07.09.2017;2017;09;02;Torstai;0;0;0;0;0;0
293;07.09.2017;2017;09;03;Torstai;0;0;0;0;0;0
293;07.09.2017;2017;09;04;Torstai;0;0;0;0;0;0
293;07.09.2017;2017;09;05;Torstai;3;0;3;0;0;0
293;07.09.2017;2017;09;06;Torstai;15;2;17;0;0;0
293;07.09.2017;2017;09;07;Torstai;118;7;125;8;3;11
293;07.09.2017;2017;09;08;Torstai;78;10;88;4;0;4
293;07.09.2017;2017;09;09;Torstai;21;7;28;4;4;8
293;07.09.2017;2017;09;10;Torstai;23;18;41;3;4;7
293;07.09.2017;2017;09;11;Torstai;10;12;22;5;4;9
293;07.09.2017;2017;09;12;Torstai;13;13;26;3;1;4
293;07.09.2017;2017;09;13;Torstai;4;38;42;3;7;10
293;07.09.2017;2017;09;14;Torstai;13;83;96;5;7;12
293;07.09.2017;2017;09;15;Torstai;26;107;133;2;7;9
293;07.09.2017;2017;09;16;Torstai;39;35;74;6;5;11
293;07.09.2017;2017;09;17;Torstai;24;29;53;5;5;10
293;07.09.2017;2017;09;18;Torstai;31;23;54;6;2;8
293;07.09.2017;2017;09;19;Torstai;6;38;44;2;3;5
293;07.09.2017;2017;09;20;Torstai;10;21;31;0;5;5
293;07.09.2017;2017;09;21;Torstai;7;5;12;1;0;1
293;07.09.2017;2017;09;22;Torstai;1;1;2;0;0;0
293;07.09.2017;2017;09;23;Torstai;0;1;1;0;0;0
293;08.09.2017;2017;09;00;Perjantai;0;1;1;0;0;0
293;08.09.2017;2017;09;01;Perjantai;0;0;0;0;0;0
293;08.09.2017;2017;09;02;Perjantai;1;0;1;0;0;0
293;08.09.2017;2017;09;03;Perjantai;0;0;0;0;0;0
293;08.09.2017;2017;09;04;Perjantai;0;1;1;0;0;0
293;08.09.2017;2017;09;05;Perjantai;3;0;3;0;0;0
293;08.09.2017;2017;09;06;Perjantai;9;2;11;1;0;1
293;08.09.2017;2017;09;07;Perjantai;85;5;90;4;2;6
293;08.09.2017;2017;09;08;Perjantai;62;6;68;4;1;5
293;08.09.2017;2017;09;09;Perjantai;35;8;43;4;1;5
293;08.09.2017;2017;09;10;Perjantai;16;5;21;0;1;1
293;08.09.2017;2017;09;11;Perjantai;5;6;11;1;3;4
293;08.09.2017;2017;09;12;Perjantai;9;11;20;3;2;5
293;08.09.2017;2017;09;13;Perjantai;9;44;53;1;3;4
293;08.09.2017;2017;09;14;Perjantai;9;106;115;4;3;7
293;08.09.2017;2017;09;15;Perjantai;12;45;57;4;7;11
293;08.09.2017;2017;09;16;Perjantai;13;18;31;3;1;4
293;08.09.2017;2017;09;17;Perjantai;21;19;40;3;1;4
293;08.09.2017;2017;09;18;Perjantai;22;16;38;2;1;3
293;08.09.2017;2017;09;19;Perjantai;17;10;27;6;2;8
293;08.09.2017;2017;09;20;Perjantai;13;28;41;2;2;4
293;08.09.2017;2017;09;21;Perjantai;11;16;27;4;4;8
293;08.09.2017;2017;09;22;Perjantai;5;11;16;2;0;2
293;08.09.2017;2017;09;23;Perjantai;1;6;7;0;2;2
293;09.09.2017;2017;09;00;Lauantai;0;1;1;0;0;0
293;09.09.2017;2017;09;01;Lauantai;0;1;1;0;0;0
293;09.09.2017;2017;09;02;Lauantai;2;1;3;0;3;3
293;09.09.2017;2017;09;03;Lauantai;0;0;0;0;0;0
293;09.09.2017;2017;09;04;Lauantai;0;0;0;2;4;6
293;09.09.2017;2017;09;05;Lauantai;1;0;1;0;0;0
293;09.09.2017;2017;09;06;Lauantai;1;1;2;0;0;0
293;09.09.2017;2017;09;07;Lauantai;0;0;0;0;2;2
293;09.09.2017;2017;09;08;Lauantai;2;0;2;3;3;6
293;09.09.2017;2017;09;09;Lauantai;15;6;21;5;1;6
293;09.09.2017;2017;09;10;Lauantai;7;10;17;4;1;5
293;09.09.2017;2017;09;11;Lauantai;11;13;24;2;0;2
293;09.09.2017;2017;09;12;Lauantai;14;20;34;2;2;4
293;09.09.2017;2017;09;13;Lauantai;23;11;34;3;5;8
293;09.09.2017;2017;09;14;Lauantai;15;16;31;5;3;8
293;09.09.2017;2017;09;15;Lauantai;18;18;36;5;7;12
293;09.09.2017;2017;09;16;Lauantai;20;21;41;1;4;5
293;09.09.2017;2017;09;17;Lauantai;18;16;34;7;4;11
293;09.09.2017;2017;09;18;Lauantai;20;10;30;1;2;3
293;09.09.2017;2017;09;19;Lauantai;11;19;30;3;2;5
293;09.09.2017;2017;09;20;Lauantai;12;27;39;1;2;3
293;09.09.2017;2017;09;21;Lauantai;9;15;24;0;2;2
293;09.09.2017;2017;09;22;Lauantai;7;3;10;2;2;4
293;09.09.2017;2017;09;23;Lauantai;1;3;4;1;0;1
293;10.09.2017;2017;09;00;Sunnuntai;0;2;2;0;1;1
293;10.09.2017;2017;09;01;Sunnuntai;2;3;5;0;1;1
293;10.09.2017;2017;09;02;Sunnuntai;0;2;2;1;1;2
293;10.09.2017;2017;09;03;Sunnuntai;0;0;0;0;2;2
293;10.09.2017;2017;09;04;Sunnuntai;0;0;0;0;1;1
293;10.09.2017;2017;09;05;Sunnuntai;0;0;0;1;0;1
293;10.09.2017;2017;09;06;Sunnuntai;2;1;3;0;0;0
293;10.09.2017;2017;09;07;Sunnuntai;1;0;1;1;1;2
293;10.09.2017;2017;09;08;Sunnuntai;0;0;0;4;1;5
293;10.09.2017;2017;09;09;Sunnuntai;1;0;1;0;2;2
293;10.09.2017;2017;09;10;Sunnuntai;3;0;3;1;0;1
293;10.09.2017;2017;09;11;Sunnuntai;0;2;2;1;0;1
293;10.09.2017;2017;09;12;Sunnuntai;5;5;10;2;2;4
293;10.09.2017;2017;09;13;Sunnuntai;5;2;7;0;0;0
293;10.09.2017;2017;09;14;Sunnuntai;7;7;14;3;1;4
293;10.09.2017;2017;09;15;Sunnuntai;3;4;7;0;0;0
293;10.09.2017;2017;09;16;Sunnuntai;3;5;8;1;1;2
293;10.09.2017;2017;09;17;Sunnuntai;7;3;10;1;1;2
293;10.09.2017;2017;09;18;Sunnuntai;7;4;11;0;1;1
293;10.09.2017;2017;09;19;Sunnuntai;2;5;7;3;2;5
293;10.09.2017;2017;09;20;Sunnuntai;4;4;8;2;4;6
293;10.09.2017;2017;09;21;Sunnuntai;1;4;5;0;2;2
293;10.09.2017;2017;09;22;Sunnuntai;0;0;0;1;0;1
293;10.09.2017;2017;09;23;Sunnuntai;0;0;0;0;0;0
293;11.09.2017;2017;09;00;Maanantai;0;0;0;0;0;0
293;11.09.2017;2017;09;01;Maanantai;0;1;1;0;0;0
293;11.09.2017;2017;09;02;Maanantai;0;0;0;0;0;0
293;11.09.2017;2017;09;03;Maanantai;0;0;0;0;0;0
293;11.09.2017;2017;09;04;Maanantai;0;0;0;0;0;0
293;11.09.2017;2017;09;05;Maanantai;3;1;4;1;0;1
293;11.09.2017;2017;09;06;Maanantai;20;4;24;0;0;0
293;11.09.2017;2017;09;07;Maanantai;95;3;98;1;0;1
293;11.09.2017;2017;09;08;Maanantai;93;19;112;5;0;5
293;11.09.2017;2017;09;09;Maanantai;32;2;34;4;1;5
293;11.09.2017;2017;09;10;Maanantai;24;12;36;3;2;5
293;11.09.2017;2017;09;11;Maanantai;12;14;26;1;4;5
293;11.09.2017;2017;09;12;Maanantai;12;13;25;2;2;4
293;11.09.2017;2017;09;13;Maanantai;12;34;46;1;1;2
293;11.09.2017;2017;09;14;Maanantai;17;78;95;5;1;6
293;11.09.2017;2017;09;15;Maanantai;13;123;136;1;7;8
293;11.09.2017;2017;09;16;Maanantai;24;35;59;3;3;6
293;11.09.2017;2017;09;17;Maanantai;25;18;43;7;2;9
293;11.09.2017;2017;09;18;Maanantai;42;34;76;5;8;13
293;11.09.2017;2017;09;19;Maanantai;7;34;41;5;8;13
293;11.09.2017;2017;09;20;Maanantai;14;20;34;1;3;4
293;11.09.2017;2017;09;21;Maanantai;1;7;8;1;0;1
293;11.09.2017;2017;09;22;Maanantai;0;0;0;1;2;3
293;11.09.2017;2017;09;23;Maanantai;1;0;1;0;0;0
293;12.09.2017;2017;09;00;Tiistai;0;0;0;1;0;1
293;12.09.2017;2017;09;01;Tiistai;0;0;0;0;0;0
293;12.09.2017;2017;09;02;Tiistai;0;0;0;0;0;0
293;12.09.2017;2017;09;03;Tiistai;0;0;0;0;0;0
293;12.09.2017;2017;09;04;Tiistai;0;0;0;0;0;0
293;12.09.2017;2017;09;05;Tiistai;6;0;6;0;0;0
293;12.09.2017;2017;09;06;Tiistai;16;3;19;1;0;1
293;12.09.2017;2017;09;07;Tiistai;92;10;102;7;2;9
293;12.09.2017;2017;09;08;Tiistai;82;10;92;5;1;6
293;12.09.2017;2017;09;09;Tiistai;35;7;42;4;4;8
293;12.09.2017;2017;09;10;Tiistai;21;16;37;2;5;7
293;12.09.2017;2017;09;11;Tiistai;10;15;25;1;2;3
293;12.09.2017;2017;09;12;Tiistai;15;17;32;4;4;8
293;12.09.2017;2017;09;13;Tiistai;13;49;62;2;2;4
293;12.09.2017;2017;09;14;Tiistai;21;79;100;3;10;13
293;12.09.2017;2017;09;15;Tiistai;14;80;94;1;4;5
293;12.09.2017;2017;09;16;Tiistai;8;15;23;1;2;3
293;12.09.2017;2017;09;17;Tiistai;11;17;28;2;1;3
293;12.09.2017;2017;09;18;Tiistai;5;12;17;5;4;9
293;12.09.2017;2017;09;19;Tiistai;6;8;14;1;5;6
293;12.09.2017;2017;09;20;Tiistai;3;9;12;1;3;4
293;12.09.2017;2017;09;21;Tiistai;1;0;1;1;1;2
293;12.09.2017;2017;09;22;Tiistai;1;0;1;0;1;1
293;12.09.2017;2017;09;23;Tiistai;1;1;2;0;0;0
293;13.09.2017;2017;09;00;Keskiviikko;0;0;0;0;0;0
293;13.09.2017;2017;09;01;Keskiviikko;0;0;0;0;0;0
293;13.09.2017;2017;09;02;Keskiviikko;0;1;1;0;0;0
293;13.09.2017;2017;09;03;Keskiviikko;0;1;1;0;0;0
293;13.09.2017;2017;09;04;Keskiviikko;1;0;1;0;0;0
293;13.09.2017;2017;09;05;Keskiviikko;2;0;2;0;0;0
293;13.09.2017;2017;09;06;Keskiviikko;14;2;16;0;0;0
293;13.09.2017;2017;09;07;Keskiviikko;94;4;98;4;1;5
293;13.09.2017;2017;09;08;Keskiviikko;91;15;106;10;2;12
293;13.09.2017;2017;09;09;Keskiviikko;28;6;34;2;0;2
293;13.09.2017;2017;09;10;Keskiviikko;11;13;24;4;1;5
293;13.09.2017;2017;09;11;Keskiviikko;3;12;15;2;1;3
293;13.09.2017;2017;09;12;Keskiviikko;6;5;11;1;2;3
293;13.09.2017;2017;09;13;Keskiviikko;15;57;72;4;9;13
293;13.09.2017;2017;09;14;Keskiviikko;15;117;132;3;7;10
293;13.09.2017;2017;09;15;Keskiviikko;25;60;85;2;3;5
293;13.09.2017;2017;09;16;Keskiviikko;29;34;63;3;0;3
293;13.09.2017;2017;09;17;Keskiviikko;24;9;33;2;9;11
293;13.09.2017;2017;09;18;Keskiviikko;32;25;57;3;6;9
293;13.09.2017;2017;09;19;Keskiviikko;19;24;43;8;5;13
293;13.09.2017;2017;09;20;Keskiviikko;12;34;46;4;4;8
293;13.09.2017;2017;09;21;Keskiviikko;2;3;5;0;2;2
293;13.09.2017;2017;09;22;Keskiviikko;1;4;5;0;0;0
293;13.09.2017;2017;09;23;Keskiviikko;0;0;0;0;0;0
293;14.09.2017;2017;09;00;Torstai;0;0;0;0;0;0
293;14.09.2017;2017;09;01;Torstai;0;0;0;0;0;0
293;14.09.2017;2017;09;02;Torstai;0;1;1;0;0;0
293;14.09.2017;2017;09;03;Torstai;0;0;0;0;0;0
293;14.09.2017;2017;09;04;Torstai;1;0;1;0;0;0
293;14.09.2017;2017;09;05;Torstai;3;0;3;0;1;1
293;14.09.2017;2017;09;06;Torstai;17;4;21;0;0;0
293;14.09.2017;2017;09;07;Torstai;97;6;103;6;1;7
293;14.09.2017;2017;09;08;Torstai;70;8;78;16;0;16
293;14.09.2017;2017;09;09;Torstai;26;7;33;4;1;5
293;14.09.2017;2017;09;10;Torstai;14;12;26;1;0;1
293;14.09.2017;2017;09;11;Torstai;5;12;17;4;7;11
293;14.09.2017;2017;09;12;Torstai;15;11;26;3;0;3
293;14.09.2017;2017;09;13;Torstai;11;44;55;1;4;5
293;14.09.2017;2017;09;14;Torstai;13;80;93;2;4;6
293;14.09.2017;2017;09;15;Torstai;13;105;118;5;6;11
293;14.09.2017;2017;09;16;Torstai;24;36;60;4;4;8
293;14.09.2017;2017;09;17;Torstai;34;15;49;3;3;6
293;14.09.2017;2017;09;18;Torstai;35;30;65;14;6;20
293;14.09.2017;2017;09;19;Torstai;25;33;58;4;10;14
293;14.09.2017;2017;09;20;Torstai;11;27;38;6;6;12
293;14.09.2017;2017;09;21;Torstai;4;12;16;1;2;3
293;14.09.2017;2017;09;22;Torstai;0;0;0;0;0;0
293;14.09.2017;2017;09;23;Torstai;0;0;0;0;0;0
293;15.09.2017;2017;09;00;Perjantai;0;0;0;0;0;0
293;15.09.2017;2017;09;01;Perjantai;0;0;0;0;0;0
293;15.09.2017;2017;09;02;Perjantai;1;0;1;0;0;0
293;15.09.2017;2017;09;03;Perjantai;0;1;1;0;0;0
293;15.09.2017;2017;09;04;Perjantai;0;1;1;0;0;0
293;15.09.2017;2017;09;05;Perjantai;3;1;4;0;0;0
293;15.09.2017;2017;09;06;Perjantai;9;3;12;0;0;0
293;15.09.2017;2017;09;07;Perjantai;93;8;101;6;0;6
293;15.09.2017;2017;09;08;Perjantai;59;10;69;3;0;3
293;15.09.2017;2017;09;09;Perjantai;47;4;51;3;1;4
293;15.09.2017;2017;09;10;Perjantai;19;6;25;7;2;9
293;15.09.2017;2017;09;11;Perjantai;9;9;18;3;1;4
293;15.09.2017;2017;09;12;Perjantai;12;22;34;2;1;3
293;15.09.2017;2017;09;13;Perjantai;5;42;47;1;3;4
293;15.09.2017;2017;09;14;Perjantai;12;106;118;2;7;9
293;15.09.2017;2017;09;15;Perjantai;13;40;53;1;2;3
293;15.09.2017;2017;09;16;Perjantai;26;21;47;3;5;8
293;15.09.2017;2017;09;17;Perjantai;19;17;36;9;7;16
293;15.09.2017;2017;09;18;Perjantai;27;38;65;8;3;11
293;15.09.2017;2017;09;19;Perjantai;11;22;33;4;6;10
293;15.09.2017;2017;09;20;Perjantai;16;21;37;0;5;5
293;15.09.2017;2017;09;21;Perjantai;5;15;20;1;4;5
293;15.09.2017;2017;09;22;Perjantai;1;1;2;0;0;0
293;15.09.2017;2017;09;23;Perjantai;2;0;2;1;0;1
293;16.09.2017;2017;09;00;Lauantai;0;0;0;1;0;1
293;16.09.2017;2017;09;01;Lauantai;0;0;0;0;0;0
293;16.09.2017;2017;09;02;Lauantai;2;0;2;0;0;0
293;16.09.2017;2017;09;03;Lauantai;0;1;1;0;1;1
293;16.09.2017;2017;09;04;Lauantai;0;0;0;0;1;1
293;16.09.2017;2017;09;05;Lauantai;0;0;0;1;0;1
293;16.09.2017;2017;09;06;Lauantai;1;1;2;1;1;2
293;16.09.2017;2017;09;07;Lauantai;2;1;3;4;2;6
293;16.09.2017;2017;09;08;Lauantai;2;6;8;1;1;2
293;16.09.2017;2017;09;09;Lauantai;11;1;12;3;3;6
293;16.09.2017;2017;09;10;Lauantai;12;12;24;2;1;3
293;16.09.2017;2017;09;11;Lauantai;11;10;21;4;6;10
293;16.09.2017;2017;09;12;Lauantai;9;7;16;5;4;9
293;16.09.2017;2017;09;13;Lauantai;25;7;32;7;1;8
293;16.09.2017;2017;09;14;Lauantai;21;28;49;3;5;8
293;16.09.2017;2017;09;15;Lauantai;16;18;34;2;4;6
293;16.09.2017;2017;09;16;Lauantai;22;21;43;5;4;9
293;16.09.2017;2017;09;17;Lauantai;19;21;40;8;6;14
293;16.09.2017;2017;09;18;Lauantai;20;21;41;7;9;16
293;16.09.2017;2017;09;19;Lauantai;25;26;51;4;9;13
293;16.09.2017;2017;09;20;Lauantai;11;18;29;1;2;3
293;16.09.2017;2017;09;21;Lauantai;9;18;27;3;2;5
293;16.09.2017;2017;09;22;Lauantai;6;7;13;3;1;4
293;16.09.2017;2017;09;23;Lauantai;3;3;6;0;1;1
293;17.09.2017;2017;09;00;Sunnuntai;0;1;1;1;2;3
293;17.09.2017;2017;09;01;Sunnuntai;0;1;1;1;1;2
293;17.09.2017;2017;09;02;Sunnuntai;1;7;8;0;4;4
293;17.09.2017;2017;09;03;Sunnuntai;0;1;1;0;1;1
293;17.09.2017;2017;09;04;Sunnuntai;0;0;0;0;1;1
293;17.09.2017;2017;09;05;Sunnuntai;0;0;0;0;0;0
293;17.09.2017;2017;09;06;Sunnuntai;1;0;1;0;0;0
293;17.09.2017;2017;09;07;Sunnuntai;2;1;3;0;1;1
293;17.09.2017;2017;09;08;Sunnuntai;0;1;1;3;0;3
293;17.09.2017;2017;09;09;Sunnuntai;2;1;3;2;1;3
293;17.09.2017;2017;09;10;Sunnuntai;15;8;23;8;6;14
293;17.09.2017;2017;09;11;Sunnuntai;10;15;25;5;4;9
293;17.09.2017;2017;09;12;Sunnuntai;19;22;41;5;1;6
293;17.09.2017;2017;09;13;Sunnuntai;18;14;32;8;4;12
293;17.09.2017;2017;09;14;Sunnuntai;35;20;55;8;4;12
293;17.09.2017;2017;09;15;Sunnuntai;15;24;39;2;2;4
293;17.09.2017;2017;09;16;Sunnuntai;22;13;35;4;3;7
293;17.09.2017;2017;09;17;Sunnuntai;37;17;54;2;5;7
293;17.09.2017;2017;09;18;Sunnuntai;19;20;39;4;5;9
293;17.09.2017;2017;09;19;Sunnuntai;12;24;36;0;6;6
293;17.09.2017;2017;09;20;Sunnuntai;9;16;25;3;4;7
293;17.09.2017;2017;09;21;Sunnuntai;1;7;8;0;0;0
293;17.09.2017;2017;09;22;Sunnuntai;1;0;1;1;0;1
293;17.09.2017;2017;09;23;Sunnuntai;1;1;2;0;0;0
293;18.09.2017;2017;09;00;Maanantai;1;0;1;0;0;0
293;18.09.2017;2017;09;01;Maanantai;0;0;0;0;0;0
293;18.09.2017;2017;09;02;Maanantai;0;0;0;0;0;0
293;18.09.2017;2017;09;03;Maanantai;0;0;0;0;0;0
293;18.09.2017;2017;09;04;Maanantai;0;0;0;0;0;0
293;18.09.2017;2017;09;05;Maanantai;3;0;3;1;0;1
293;18.09.2017;2017;09;06;Maanantai;13;1;14;0;0;0
293;18.09.2017;2017;09;07;Maanantai;53;2;55;1;0;1
293;18.09.2017;2017;09;08;Maanantai;53;14;67;5;0;5
293;18.09.2017;2017;09;09;Maanantai;15;5;20;3;1;4
293;18.09.2017;2017;09;10;Maanantai;16;9;25;2;2;4
293;18.09.2017;2017;09;11;Maanantai;11;12;23;0;0;0
293;18.09.2017;2017;09;12;Maanantai;9;10;19;2;3;5
293;18.09.2017;2017;09;13;Maanantai;16;23;39;5;3;8
293;18.09.2017;2017;09;14;Maanantai;18;45;63;2;10;12
293;18.09.2017;2017;09;15;Maanantai;30;73;103;4;5;9
293;18.09.2017;2017;09;16;Maanantai;31;35;66;2;8;10
293;18.09.2017;2017;09;17;Maanantai;25;31;56;5;2;7
293;18.09.2017;2017;09;18;Maanantai;18;28;46;6;9;15
293;18.09.2017;2017;09;19;Maanantai;17;22;39;6;6;12
293;18.09.2017;2017;09;20;Maanantai;5;14;19;4;11;15
293;18.09.2017;2017;09;21;Maanantai;4;7;11;1;1;2
293;18.09.2017;2017;09;22;Maanantai;0;2;2;0;0;0
293;18.09.2017;2017;09;23;Maanantai;2;0;2;0;0;0
293;19.09.2017;2017;09;00;Tiistai;0;1;1;0;0;0
293;19.09.2017;2017;09;01;Tiistai;0;0;0;0;0;0
293;19.09.2017;2017;09;02;Tiistai;0;0;0;0;0;0
293;19.09.2017;2017;09;03;Tiistai;0;1;1;0;0;0
293;19.09.2017;2017;09;04;Tiistai;1;0;1;0;0;0
293;19.09.2017;2017;09;05;Tiistai;3;1;4;0;0;0
293;19.09.2017;2017;09;06;Tiistai;15;2;17;2;0;2
293;19.09.2017;2017;09;07;Tiistai;104;7;111;4;0;4
293;19.09.2017;2017;09;08;Tiistai;70;17;87;3;2;5
293;19.09.2017;2017;09;09;Tiistai;31;9;40;1;2;3
293;19.09.2017;2017;09;10;Tiistai;13;5;18;2;1;3
293;19.09.2017;2017;09;11;Tiistai;2;6;8;1;2;3
293;19.09.2017;2017;09;12;Tiistai;5;6;11;1;0;1
293;19.09.2017;2017;09;13;Tiistai;6;36;42;2;2;4
293;19.09.2017;2017;09;14;Tiistai;18;76;94;2;8;10
293;19.09.2017;2017;09;15;Tiistai;16;77;93;3;7;10
293;19.09.2017;2017;09;16;Tiistai;27;27;54;6;8;14
293;19.09.2017;2017;09;17;Tiistai;24;22;46;2;3;5
293;19.09.2017;2017;09;18;Tiistai;13;21;34;4;2;6
293;19.09.2017;2017;09;19;Tiistai;13;18;31;2;4;6
293;19.09.2017;2017;09;20;Tiistai;4;26;30;5;3;8
293;19.09.2017;2017;09;21;Tiistai;1;6;7;1;3;4
293;19.09.2017;2017;09;22;Tiistai;0;0;0;3;0;3
293;19.09.2017;2017;09;23;Tiistai;0;1;1;0;0;0
293;20.09.2017;2017;09;00;Keskiviikko;0;0;0;0;0;0
293;20.09.2017;2017;09;01;Keskiviikko;0;0;0;0;0;0
293;20.09.2017;2017;09;02;Keskiviikko;0;0;0;0;0;0
293;20.09.2017;2017;09;03;Keskiviikko;0;0;0;0;0;0
293;20.09.2017;2017;09;04;Keskiviikko;2;0;2;0;0;0
293;20.09.2017;2017;09;05;Keskiviikko;1;0;1;0;0;0
293;20.09.2017;2017;09;06;Keskiviikko;14;3;17;1;0;1
293;20.09.2017;2017;09;07;Keskiviikko;88;6;94;4;1;5
293;20.09.2017;2017;09;08;Keskiviikko;92;11;103;5;3;8
293;20.09.2017;2017;09;09;Keskiviikko;27;8;35;2;2;4
293;20.09.2017;2017;09;10;Keskiviikko;10;7;17;2;2;4
293;20.09.2017;2017;09;11;Keskiviikko;10;6;16;3;1;4
293;20.09.2017;2017;09;12;Keskiviikko;6;13;19;0;2;2
293;20.09.2017;2017;09;13;Keskiviikko;10;48;58;1;1;2
293;20.09.2017;2017;09;14;Keskiviikko;21;107;128;6;12;18
293;20.09.2017;2017;09;15;Keskiviikko;19;40;59;3;6;9
293;20.09.2017;2017;09;16;Keskiviikko;22;31;53;5;2;7
293;20.09.2017;2017;09;17;Keskiviikko;24;23;47;3;3;6
293;20.09.2017;2017;09;18;Keskiviikko;15;18;33;2;7;9
293;20.09.2017;2017;09;19;Keskiviikko;11;17;28;4;5;9
293;20.09.2017;2017;09;20;Keskiviikko;5;17;22;2;3;5
293;20.09.2017;2017;09;21;Keskiviikko;2;12;14;0;0;0
293;20.09.2017;2017;09;22;Keskiviikko;0;2;2;0;0;0
293;20.09.2017;2017;09;23;Keskiviikko;1;0;1;0;0;0
293;21.09.2017;2017;09;00;Torstai;0;0;0;0;0;0
293;21.09.2017;2017;09;01;Torstai;1;0;1;0;0;0
293;21.09.2017;2017;09;02;Torstai;0;0;0;0;0;0
293;21.09.2017;2017;09;03;Torstai;0;1;1;0;0;0
293;21.09.2017;2017;09;04;Torstai;1;0;1;0;0;0
293;21.09.2017;2017;09;05;Torstai;3;0;3;0;0;0
293;21.09.2017;2017;09;06;Torstai;16;1;17;0;0;0
293;21.09.2017;2017;09;07;Torstai;106;4;110;6;2;8
293;21.09.2017;2017;09;08;Torstai;80;11;91;4;0;4
293;21.09.2017;2017;09;09;Torstai;20;10;30;2;0;2
293;21.09.2017;2017;09;10;Torstai;14;18;32;0;1;1
293;21.09.2017;2017;09;11;Torstai;5;7;12;3;2;5
293;21.09.2017;2017;09;12;Torstai;10;17;27;2;4;6
293;21.09.2017;2017;09;13;Torstai;10;49;59;4;4;8
293;21.09.2017;2017;09;14;Torstai;11;73;84;1;7;8
293;21.09.2017;2017;09;15;Torstai;16;68;84;4;6;10
293;21.09.2017;2017;09;16;Torstai;29;19;48;4;1;5
293;21.09.2017;2017;09;17;Torstai;28;27;55;5;7;12
293;21.09.2017;2017;09;18;Torstai;15;39;54;3;7;10
293;21.09.2017;2017;09;19;Torstai;23;26;49;2;8;10
293;21.09.2017;2017;09;20;Torstai;5;22;27;1;4;5
293;21.09.2017;2017;09;21;Torstai;4;5;9;3;0;3
293;21.09.2017;2017;09;22;Torstai;2;1;3;0;1;1
293;21.09.2017;2017;09;23;Torstai;1;0;1;0;0;0
293;22.09.2017;2017;09;00;Perjantai;0;0;0;0;0;0
293;22.09.2017;2017;09;01;Perjantai;0;0;0;0;1;1
293;22.09.2017;2017;09;02;Perjantai;1;0;1;1;0;1
293;22.09.2017;2017;09;03;Perjantai;0;0;0;0;0;0
293;22.09.2017;2017;09;04;Perjantai;0;0;0;0;0;0
293;22.09.2017;2017;09;05;Perjantai;2;1;3;1;0;1
293;22.09.2017;2017;09;06;Perjantai;9;3;12;0;0;0
293;22.09.2017;2017;09;07;Perjantai;86;10;96;1;0;1
293;22.09.2017;2017;09;08;Perjantai;82;7;89;7;3;10
293;22.09.2017;2017;09;09;Perjantai;26;5;31;2;0;2
293;22.09.2017;2017;09;10;Perjantai;18;8;26;3;1;4
293;22.09.2017;2017;09;11;Perjantai;12;14;26;2;2;4
293;22.09.2017;2017;09;12;Perjantai;13;38;51;5;4;9
293;22.09.2017;2017;09;13;Perjantai;22;49;71;4;4;8
293;22.09.2017;2017;09;14;Perjantai;16;75;91;3;8;11
293;22.09.2017;2017;09;15;Perjantai;21;71;92;3;5;8
293;22.09.2017;2017;09;16;Perjantai;30;33;63;4;7;11
293;22.09.2017;2017;09;17;Perjantai;33;43;76;7;2;9
293;22.09.2017;2017;09;18;Perjantai;28;22;50;0;4;4
293;22.09.2017;2017;09;19;Perjantai;41;23;64;8;4;12
293;22.09.2017;2017;09;20;Perjantai;17;24;41;3;6;9
293;22.09.2017;2017;09;21;Perjantai;9;28;37;3;3;6
293;22.09.2017;2017;09;22;Perjantai;2;5;7;0;0;0
293;22.09.2017;2017;09;23;Perjantai;1;1;2;1;0;1
293;23.09.2017;2017;09;00;Lauantai;3;2;5;1;1;2
293;23.09.2017;2017;09;01;Lauantai;2;1;3;0;1;1
293;23.09.2017;2017;09;02;Lauantai;0;1;1;1;2;3
293;23.09.2017;2017;09;03;Lauantai;0;2;2;0;2;2
293;23.09.2017;2017;09;04;Lauantai;0;0;0;1;0;1
293;23.09.2017;2017;09;05;Lauantai;2;0;2;1;1;2
293;23.09.2017;2017;09;06;Lauantai;2;0;2;0;0;0
293;23.09.2017;2017;09;07;Lauantai;2;1;3;1;1;2
293;23.09.2017;2017;09;08;Lauantai;4;5;9;1;1;2
293;23.09.2017;2017;09;09;Lauantai;12;2;14;0;2;2
293;23.09.2017;2017;09;10;Lauantai;11;14;25;5;2;7
293;23.09.2017;2017;09;11;Lauantai;18;9;27;6;5;11
293;23.09.2017;2017;09;12;Lauantai;20;16;36;5;2;7
293;23.09.2017;2017;09;13;Lauantai;18;22;40;11;6;17
293;23.09.2017;2017;09;14;Lauantai;34;29;63;7;2;9
293;23.09.2017;2017;09;15;Lauantai;14;34;48;1;2;3
293;23.09.2017;2017;09;16;Lauantai;12;13;25;5;6;11
293;23.09.2017;2017;09;17;Lauantai;18;22;40;3;4;7
293;23.09.2017;2017;09;18;Lauantai;38;22;60;7;6;13
293;23.09.2017;2017;09;19;Lauantai;21;17;38;2;5;7
293;23.09.2017;2017;09;20;Lauantai;22;25;47;6;6;12
293;23.09.2017;2017;09;21;Lauantai;6;15;21;1;2;3
293;23.09.2017;2017;09;22;Lauantai;3;3;6;0;1;1
293;23.09.2017;2017;09;23;Lauantai;2;6;8;0;0;0
293;24.09.2017;2017;09;00;Sunnuntai;1;2;3;0;1;1
293;24.09.2017;2017;09;01;Sunnuntai;0;0;0;2;2;4
293;24.09.2017;2017;09;02;Sunnuntai;0;3;3;1;2;3
293;24.09.2017;2017;09;03;Sunnuntai;0;2;2;0;2;2
293;24.09.2017;2017;09;04;Sunnuntai;1;0;1;0;0;0
293;24.09.2017;2017;09;05;Sunnuntai;1;1;2;0;0;0
293;24.09.2017;2017;09;06;Sunnuntai;1;1;2;0;0;0
293;24.09.2017;2017;09;07;Sunnuntai;0;1;1;1;1;2
293;24.09.2017;2017;09;08;Sunnuntai;5;0;5;1;2;3
293;24.09.2017;2017;09;09;Sunnuntai;4;1;5;2;2;4
293;24.09.2017;2017;09;10;Sunnuntai;13;11;24;5;2;7
293;24.09.2017;2017;09;11;Sunnuntai;18;16;34;11;6;17
293;24.09.2017;2017;09;12;Sunnuntai;20;27;47;5;4;9
293;24.09.2017;2017;09;13;Sunnuntai;29;16;45;2;6;8
293;24.09.2017;2017;09;14;Sunnuntai;35;26;61;6;4;10
293;24.09.2017;2017;09;15;Sunnuntai;30;18;48;3;1;4
293;24.09.2017;2017;09;16;Sunnuntai;12;18;30;3;3;6
293;24.09.2017;2017;09;17;Sunnuntai;16;22;38;4;4;8
293;24.09.2017;2017;09;18;Sunnuntai;22;21;43;5;5;10
293;24.09.2017;2017;09;19;Sunnuntai;13;19;32;3;11;14
293;24.09.2017;2017;09;20;Sunnuntai;10;11;21;3;4;7
293;24.09.2017;2017;09;21;Sunnuntai;2;7;9;0;0;0
293;24.09.2017;2017;09;22;Sunnuntai;0;0;0;0;1;1
293;24.09.2017;2017;09;23;Sunnuntai;0;0;0;0;0;0
293;25.09.2017;2017;09;00;Maanantai;0;0;0;0;0;0
293;25.09.2017;2017;09;01;Maanantai;0;1;1;0;0;0
293;25.09.2017;2017;09;02;Maanantai;0;1;1;0;0;0
293;25.09.2017;2017;09;03;Maanantai;0;0;0;0;0;0
293;25.09.2017;2017;09;04;Maanantai;0;0;0;0;0;0
293;25.09.2017;2017;09;05;Maanantai;4;0;4;0;0;0
293;25.09.2017;2017;09;06;Maanantai;14;1;15;1;1;2
293;25.09.2017;2017;09;07;Maanantai;62;3;65;2;1;3
293;25.09.2017;2017;09;08;Maanantai;107;15;122;8;3;11
293;25.09.2017;2017;09;09;Maanantai;29;5;34;2;0;2
293;25.09.2017;2017;09;10;Maanantai;35;12;47;1;0;1
293;25.09.2017;2017;09;11;Maanantai;12;14;26;1;1;2
293;25.09.2017;2017;09;12;Maanantai;11;29;40;1;1;2
293;25.09.2017;2017;09;13;Maanantai;10;41;51;7;5;12
293;25.09.2017;2017;09;14;Maanantai;18;75;93;3;10;13
293;25.09.2017;2017;09;15;Maanantai;23;102;125;1;4;5
293;25.09.2017;2017;09;16;Maanantai;32;29;61;6;1;7
293;25.09.2017;2017;09;17;Maanantai;37;25;62;14;16;30
293;25.09.2017;2017;09;18;Maanantai;27;36;63;8;9;17
293;25.09.2017;2017;09;19;Maanantai;23;31;54;2;5;7
293;25.09.2017;2017;09;20;Maanantai;12;21;33;1;5;6
293;25.09.2017;2017;09;21;Maanantai;4;4;8;0;0;0
293;25.09.2017;2017;09;22;Maanantai;0;1;1;0;0;0
293;25.09.2017;2017;09;23;Maanantai;0;2;2;0;0;0
293;26.09.2017;2017;09;00;Tiistai;0;1;1;0;0;0
293;26.09.2017;2017;09;01;Tiistai;2;0;2;0;0;0
293;26.09.2017;2017;09;02;Tiistai;0;0;0;0;0;0
293;26.09.2017;2017;09;03;Tiistai;0;1;1;0;0;0
293;26.09.2017;2017;09;04;Tiistai;1;0;1;0;0;0
293;26.09.2017;2017;09;05;Tiistai;3;0;3;0;0;0
293;26.09.2017;2017;09;06;Tiistai;12;1;13;0;0;0
293;26.09.2017;2017;09;07;Tiistai;84;6;90;5;1;6
293;26.09.2017;2017;09;08;Tiistai;93;18;111;6;1;7
293;26.09.2017;2017;09;09;Tiistai;30;5;35;3;1;4
293;26.09.2017;2017;09;10;Tiistai;13;14;27;2;1;3
293;26.09.2017;2017;09;11;Tiistai;5;13;18;2;3;5
293;26.09.2017;2017;09;12;Tiistai;15;19;34;1;3;4
293;26.09.2017;2017;09;13;Tiistai;9;44;53;5;4;9
293;26.09.2017;2017;09;14;Tiistai;18;81;99;6;6;12
293;26.09.2017;2017;09;15;Tiistai;8;66;74;2;3;5
293;26.09.2017;2017;09;16;Tiistai;24;26;50;6;7;13
293;26.09.2017;2017;09;17;Tiistai;26;18;44;2;4;6
293;26.09.2017;2017;09;18;Tiistai;22;26;48;5;10;15
293;26.09.2017;2017;09;19;Tiistai;12;18;30;5;7;12
293;26.09.2017;2017;09;20;Tiistai;3;21;24;5;5;10
293;26.09.2017;2017;09;21;Tiistai;2;3;5;1;1;2
293;26.09.2017;2017;09;22;Tiistai;0;2;2;0;1;1
293;26.09.2017;2017;09;23;Tiistai;1;0;1;0;0;0
293;27.09.2017;2017;09;00;Keskiviikko;0;0;0;0;0;0
293;27.09.2017;2017;09;01;Keskiviikko;0;0;0;0;0;0
293;27.09.2017;2017;09;02;Keskiviikko;0;0;0;0;0;0
293;27.09.2017;2017;09;03;Keskiviikko;0;0;0;0;0;0
293;27.09.2017;2017;09;04;Keskiviikko;1;0;1;0;0;0
293;27.09.2017;2017;09;05;Keskiviikko;3;0;3;0;0;0
293;27.09.2017;2017;09;06;Keskiviikko;17;1;18;2;0;2
293;27.09.2017;2017;09;07;Keskiviikko;82;5;87;5;2;7
293;27.09.2017;2017;09;08;Keskiviikko;101;12;113;13;1;14
293;27.09.2017;2017;09;09;Keskiviikko;19;5;24;3;1;4
293;27.09.2017;2017;09;10;Keskiviikko;9;8;17;0;2;2
293;27.09.2017;2017;09;11;Keskiviikko;8;13;21;6;6;12
293;27.09.2017;2017;09;12;Keskiviikko;8;18;26;4;3;7
293;27.09.2017;2017;09;13;Keskiviikko;12;63;75;3;7;10
293;27.09.2017;2017;09;14;Keskiviikko;8;106;114;1;9;10
293;27.09.2017;2017;09;15;Keskiviikko;23;47;70;4;1;5
293;27.09.2017;2017;09;16;Keskiviikko;24;34;58;5;4;9
293;27.09.2017;2017;09;17;Keskiviikko;26;13;39;8;3;11
293;27.09.2017;2017;09;18;Keskiviikko;12;34;46;3;8;11
293;27.09.2017;2017;09;19;Keskiviikko;12;17;29;1;5;6
293;27.09.2017;2017;09;20;Keskiviikko;5;19;24;3;2;5
293;27.09.2017;2017;09;21;Keskiviikko;1;7;8;0;1;1
293;27.09.2017;2017;09;22;Keskiviikko;1;0;1;0;0;0
293;27.09.2017;2017;09;23;Keskiviikko;2;1;3;0;0;0
293;28.09.2017;2017;09;00;Torstai;1;0;1;0;0;0
293;28.09.2017;2017;09;01;Torstai;1;0;1;0;0;0
293;28.09.2017;2017;09;02;Torstai;0;0;0;0;0;0
293;28.09.2017;2017;09;03;Torstai;0;0;0;0;0;0
293;28.09.2017;2017;09;04;Torstai;2;0;2;0;0;0
293;28.09.2017;2017;09;05;Torstai;4;0;4;0;0;0
293;28.09.2017;2017;09;06;Torstai;14;0;14;2;0;2
293;28.09.2017;2017;09;07;Torstai;80;6;86;1;1;2
293;28.09.2017;2017;09;08;Torstai;95;10;105;8;2;10
293;28.09.2017;2017;09;09;Torstai;18;7;25;5;2;7
293;28.09.2017;2017;09;10;Torstai;11;8;19;2;3;5
293;28.09.2017;2017;09;11;Torstai;20;11;31;1;0;1
293;28.09.2017;2017;09;12;Torstai;15;14;29;4;4;8
293;28.09.2017;2017;09;13;Torstai;3;43;46;3;4;7
293;28.09.2017;2017;09;14;Torstai;10;94;104;4;6;10
293;28.09.2017;2017;09;15;Torstai;11;70;81;3;7;10
293;28.09.2017;2017;09;16;Torstai;27;31;58;4;2;6
293;28.09.2017;2017;09;17;Torstai;30;9;39;9;8;17
293;28.09.2017;2017;09;18;Torstai;21;33;54;2;5;7
293;28.09.2017;2017;09;19;Torstai;10;28;38;5;4;9
293;28.09.2017;2017;09;20;Torstai;5;18;23;4;6;10
293;28.09.2017;2017;09;21;Torstai;1;3;4;0;0;0
293;28.09.2017;2017;09;22;Torstai;0;0;0;0;0;0
293;28.09.2017;2017;09;23;Torstai;1;1;2;0;0;0
293;29.09.2017;2017;09;00;Perjantai;0;0;0;0;0;0
293;29.09.2017;2017;09;01;Perjantai;1;0;1;0;0;0
293;29.09.2017;2017;09;02;Perjantai;1;0;1;0;0;0
293;29.09.2017;2017;09;03;Perjantai;0;0;0;0;0;0
293;29.09.2017;2017;09;04;Perjantai;0;0;0;0;0;0
293;29.09.2017;2017;09;05;Perjantai;1;0;1;0;0;0
293;29.09.2017;2017;09;06;Perjantai;7;1;8;0;0;0
293;29.09.2017;2017;09;07;Perjantai;83;5;88;1;1;2
293;29.09.2017;2017;09;08;Perjantai;92;9;101;5;0;5
293;29.09.2017;2017;09;09;Perjantai;20;4;24;4;0;4
293;29.09.2017;2017;09;10;Perjantai;8;12;20;3;3;6
293;29.09.2017;2017;09;11;Perjantai;12;11;23;1;1;2
293;29.09.2017;2017;09;12;Perjantai;6;23;29;1;2;3
293;29.09.2017;2017;09;13;Perjantai;14;53;67;2;4;6
293;29.09.2017;2017;09;14;Perjantai;16;106;122;5;6;11
293;29.09.2017;2017;09;15;Perjantai;20;48;68;0;3;3
293;29.09.2017;2017;09;16;Perjantai;16;22;38;8;1;9
293;29.09.2017;2017;09;17;Perjantai;26;29;55;8;2;10
293;29.09.2017;2017;09;18;Perjantai;24;21;45;3;5;8
293;29.09.2017;2017;09;19;Perjantai;38;30;68;11;18;29
293;29.09.2017;2017;09;20;Perjantai;9;19;28;9;5;14
293;29.09.2017;2017;09;21;Perjantai;6;6;12;2;2;4
293;29.09.2017;2017;09;22;Perjantai;2;5;7;2;1;3
293;29.09.2017;2017;09;23;Perjantai;3;7;10;1;0;1
293;30.09.2017;2017;09;00;Lauantai;2;2;4;0;1;1
293;30.09.2017;2017;09;01;Lauantai;0;0;0;4;3;7
293;30.09.2017;2017;09;02;Lauantai;0;1;1;1;1;2
293;30.09.2017;2017;09;03;Lauantai;0;0;0;0;1;1
293;30.09.2017;2017;09;04;Lauantai;1;0;1;0;2;2
293;30.09.2017;2017;09;05;Lauantai;0;1;1;0;1;1
293;30.09.2017;2017;09;06;Lauantai;1;0;1;0;0;0
293;30.09.2017;2017;09;07;Lauantai;5;2;7;1;2;3
293;30.09.2017;2017;09;08;Lauantai;2;2;4;1;0;1
293;30.09.2017;2017;09;09;Lauantai;12;10;22;3;3;6
293;30.09.2017;2017;09;10;Lauantai;9;11;20;4;2;6
293;30.09.2017;2017;09;11;Lauantai;15;13;28;5;4;9
293;30.09.2017;2017;09;12;Lauantai;18;18;36;2;5;7
293;30.09.2017;2017;09;13;Lauantai;29;15;44;1;1;2
293;30.09.2017;2017;09;14;Lauantai;33;24;57;8;7;15
293;30.09.2017;2017;09;15;Lauantai;26;27;53;6;4;10
293;30.09.2017;2017;09;16;Lauantai;14;23;37;2;5;7
293;30.09.2017;2017;09;17;Lauantai;27;18;45;10;5;15
293;30.09.2017;2017;09;18;Lauantai;11;17;28;4;8;12
293;30.09.2017;2017;09;19;Lauantai;13;28;41;0;3;3
293;30.09.2017;2017;09;20;Lauantai;10;10;20;4;4;8
293;30.09.2017;2017;09;21;Lauantai;8;12;20;6;8;14
293;30.09.2017;2017;09;22;Lauantai;4;6;10;1;2;3
293;30.09.2017;2017;09;23;Lauantai;4;2;6;1;2;3
293;01.10.2017;2017;10;00;Sunnuntai;2;0;2;1;2;3
293;01.10.2017;2017;10;01;Sunnuntai;1;0;1;0;1;1
293;01.10.2017;2017;10;02;Sunnuntai;0;3;3;0;0;0
293;01.10.2017;2017;10;03;Sunnuntai;0;1;1;0;5;5
293;01.10.2017;2017;10;04;Sunnuntai;0;1;1;0;0;0
293;01.10.2017;2017;10;05;Sunnuntai;0;0;0;0;0;0
293;01.10.2017;2017;10;06;Sunnuntai;3;0;3;0;0;0
293;01.10.2017;2017;10;07;Sunnuntai;2;0;2;0;0;0
293;01.10.2017;2017;10;08;Sunnuntai;3;2;5;2;2;4
293;01.10.2017;2017;10;09;Sunnuntai;11;4;15;2;0;2
293;01.10.2017;2017;10;10;Sunnuntai;6;4;10;4;4;8
293;01.10.2017;2017;10;11;Sunnuntai;9;7;16;12;6;18
293;01.10.2017;2017;10;12;Sunnuntai;21;16;37;7;10;17
293;01.10.2017;2017;10;13;Sunnuntai;19;11;30;9;9;18
293;01.10.2017;2017;10;14;Sunnuntai;10;8;18;8;5;13
293;01.10.2017;2017;10;15;Sunnuntai;17;17;34;2;6;8
293;01.10.2017;2017;10;16;Sunnuntai;21;12;33;3;3;6
293;01.10.2017;2017;10;17;Sunnuntai;16;27;43;7;4;11
293;01.10.2017;2017;10;18;Sunnuntai;15;14;29;4;3;7
293;01.10.2017;2017;10;19;Sunnuntai;13;14;27;5;6;11
293;01.10.2017;2017;10;20;Sunnuntai;2;10;12;4;3;7
293;01.10.2017;2017;10;21;Sunnuntai;3;10;13;0;1;1
293;01.10.2017;2017;10;22;Sunnuntai;1;0;1;0;0;0
293;01.10.2017;2017;10;23;Sunnuntai;0;0;0;0;0;0
293;02.10.2017;2017;10;00;Maanantai;0;0;0;0;0;0
293;02.10.2017;2017;10;01;Maanantai;0;0;0;0;0;0
293;02.10.2017;2017;10;02;Maanantai;0;2;2;0;0;0
293;02.10.2017;2017;10;03;Maanantai;0;0;0;0;0;0
293;02.10.2017;2017;10;04;Maanantai;0;0;0;0;0;0
293;02.10.2017;2017;10;05;Maanantai;3;0;3;0;0;0
293;02.10.2017;2017;10;06;Maanantai;11;2;13;0;0;0
293;02.10.2017;2017;10;07;Maanantai;83;3;86;9;1;10
293;02.10.2017;2017;10;08;Maanantai;95;15;110;0;1;1
293;02.10.2017;2017;10;09;Maanantai;33;5;38;4;6;10
293;02.10.2017;2017;10;10;Maanantai;21;7;28;1;1;2
293;02.10.2017;2017;10;11;Maanantai;10;14;24;4;4;8
293;02.10.2017;2017;10;12;Maanantai;7;9;16;2;1;3
293;02.10.2017;2017;10;13;Maanantai;14;28;42;3;4;7
293;02.10.2017;2017;10;14;Maanantai;18;72;90;1;7;8
293;02.10.2017;2017;10;15;Maanantai;18;114;132;0;7;7
293;02.10.2017;2017;10;16;Maanantai;27;29;56;7;0;7
293;02.10.2017;2017;10;17;Maanantai;18;23;41;4;8;12
293;02.10.2017;2017;10;18;Maanantai;31;36;67;3;5;8
293;02.10.2017;2017;10;19;Maanantai;25;29;54;7;8;15
293;02.10.2017;2017;10;20;Maanantai;6;18;24;3;6;9
293;02.10.2017;2017;10;21;Maanantai;3;9;12;1;2;3
293;02.10.2017;2017;10;22;Maanantai;1;0;1;0;0;0
293;02.10.2017;2017;10;23;Maanantai;0;0;0;0;0;0
293;03.10.2017;2017;10;00;Tiistai;0;0;0;0;0;0
293;03.10.2017;2017;10;01;Tiistai;0;0;0;0;1;1
293;03.10.2017;2017;10;02;Tiistai;0;1;1;0;0;0
293;03.10.2017;2017;10;03;Tiistai;0;1;1;0;0;0
293;03.10.2017;2017;10;04;Tiistai;1;0;1;0;0;0
293;03.10.2017;2017;10;05;Tiistai;1;0;1;0;0;0
293;03.10.2017;2017;10;06;Tiistai;15;1;16;1;0;1
293;03.10.2017;2017;10;07;Tiistai;79;4;83;7;2;9
293;03.10.2017;2017;10;08;Tiistai;79;13;92;7;1;8
293;03.10.2017;2017;10;09;Tiistai;29;8;37;4;2;6
293;03.10.2017;2017;10;10;Tiistai;10;7;17;3;3;6
293;03.10.2017;2017;10;11;Tiistai;8;11;19;21;1;22
293;03.10.2017;2017;10;12;Tiistai;4;5;9;2;24;26
293;03.10.2017;2017;10;13;Tiistai;6;33;39;0;2;2
293;03.10.2017;2017;10;14;Tiistai;19;69;88;4;3;7
293;03.10.2017;2017;10;15;Tiistai;13;81;94;1;2;3
293;03.10.2017;2017;10;16;Tiistai;13;21;34;2;2;4
293;03.10.2017;2017;10;17;Tiistai;13;15;28;3;8;11
293;03.10.2017;2017;10;18;Tiistai;12;12;24;5;3;8
293;03.10.2017;2017;10;19;Tiistai;2;13;15;3;3;6
293;03.10.2017;2017;10;20;Tiistai;2;11;13;2;4;6
293;03.10.2017;2017;10;21;Tiistai;0;5;5;0;0;0
293;03.10.2017;2017;10;22;Tiistai;1;3;4;0;0;0
293;03.10.2017;2017;10;23;Tiistai;0;0;0;0;2;2
293;04.10.2017;2017;10;00;Keskiviikko;0;0;0;0;0;0
293;04.10.2017;2017;10;01;Keskiviikko;0;0;0;0;0;0
293;04.10.2017;2017;10;02;Keskiviikko;0;0;0;0;0;0
293;04.10.2017;2017;10;03;Keskiviikko;0;0;0;0;0;0
293;04.10.2017;2017;10;04;Keskiviikko;1;0;1;0;0;0
293;04.10.2017;2017;10;05;Keskiviikko;1;0;1;0;0;0
293;04.10.2017;2017;10;06;Keskiviikko;7;1;8;0;1;1
293;04.10.2017;2017;10;07;Keskiviikko;52;5;57;6;0;6
293;04.10.2017;2017;10;08;Keskiviikko;124;10;134;6;2;8
293;04.10.2017;2017;10;09;Keskiviikko;19;5;24;1;3;4
293;04.10.2017;2017;10;10;Keskiviikko;12;8;20;1;3;4
293;04.10.2017;2017;10;11;Keskiviikko;5;11;16;2;2;4
293;04.10.2017;2017;10;12;Keskiviikko;12;22;34;5;6;11
293;04.10.2017;2017;10;13;Keskiviikko;8;111;119;2;8;10
293;04.10.2017;2017;10;14;Keskiviikko;14;41;55;2;6;8
293;04.10.2017;2017;10;15;Keskiviikko;14;29;43;2;1;3
293;04.10.2017;2017;10;16;Keskiviikko;11;27;38;5;6;11
293;04.10.2017;2017;10;17;Keskiviikko;10;13;23;7;7;14
293;04.10.2017;2017;10;18;Keskiviikko;15;13;28;6;6;12
293;04.10.2017;2017;10;19;Keskiviikko;15;25;40;6;8;14
293;04.10.2017;2017;10;20;Keskiviikko;0;14;14;4;4;8
293;04.10.2017;2017;10;21;Keskiviikko;0;1;1;0;0;0
293;04.10.2017;2017;10;22;Keskiviikko;1;1;2;0;1;1
293;04.10.2017;2017;10;23;Keskiviikko;1;0;1;0;0;0
293;05.10.2017;2017;10;00;Torstai;0;0;0;0;0;0
293;05.10.2017;2017;10;01;Torstai;0;1;1;0;0;0
293;05.10.2017;2017;10;02;Torstai;0;0;0;0;0;0
293;05.10.2017;2017;10;03;Torstai;0;0;0;0;0;0
293;05.10.2017;2017;10;04;Torstai;1;0;1;0;0;0
293;05.10.2017;2017;10;05;Torstai;1;0;1;0;0;0
293;05.10.2017;2017;10;06;Torstai;8;0;8;0;1;1
293;05.10.2017;2017;10;07;Torstai;101;6;107;8;1;9
293;05.10.2017;2017;10;08;Torstai;76;7;83;7;2;9
293;05.10.2017;2017;10;09;Torstai;25;8;33;3;0;3
293;05.10.2017;2017;10;10;Torstai;9;10;19;1;0;1
293;05.10.2017;2017;10;11;Torstai;12;13;25;1;4;5
293;05.10.2017;2017;10;12;Torstai;20;15;35;6;3;9
293;05.10.2017;2017;10;13;Torstai;13;38;51;0;5;5
293;05.10.2017;2017;10;14;Torstai;16;78;94;1;6;7
293;05.10.2017;2017;10;15;Torstai;13;102;115;2;5;7
293;05.10.2017;2017;10;16;Torstai;32;23;55;5;1;6
293;05.10.2017;2017;10;17;Torstai;26;18;44;5;7;12
293;05.10.2017;2017;10;18;Torstai;21;27;48;6;4;10
293;05.10.2017;2017;10;19;Torstai;15;14;29;3;4;7
293;05.10.2017;2017;10;20;Torstai;12;26;38;3;6;9
293;05.10.2017;2017;10;21;Torstai;0;5;5;0;0;0
293;05.10.2017;2017;10;22;Torstai;0;0;0;0;0;0
293;05.10.2017;2017;10;23;Torstai;2;0;2;0;0;0
293;06.10.2017;2017;10;00;Perjantai;0;0;0;0;0;0
293;06.10.2017;2017;10;01;Perjantai;0;1;1;0;0;0
293;06.10.2017;2017;10;02;Perjantai;1;0;1;0;0;0
293;06.10.2017;2017;10;03;Perjantai;0;1;1;0;0;0
293;06.10.2017;2017;10;04;Perjantai;0;0;0;0;0;0
293;06.10.2017;2017;10;05;Perjantai;2;0;2;0;0;0
293;06.10.2017;2017;10;06;Perjantai;5;2;7;0;0;0
293;06.10.2017;2017;10;07;Perjantai;92;4;96;4;3;7
293;06.10.2017;2017;10;08;Perjantai;69;7;76;4;1;5
293;06.10.2017;2017;10;09;Perjantai;39;9;48;7;0;7
293;06.10.2017;2017;10;10;Perjantai;19;11;30;5;2;7
293;06.10.2017;2017;10;11;Perjantai;10;12;22;5;4;9
293;06.10.2017;2017;10;12;Perjantai;10;20;30;2;1;3
293;06.10.2017;2017;10;13;Perjantai;23;56;79;1;7;8
293;06.10.2017;2017;10;14;Perjantai;18;105;123;4;6;10
293;06.10.2017;2017;10;15;Perjantai;20;64;84;6;7;13
293;06.10.2017;2017;10;16;Perjantai;15;21;36;3;3;6
293;06.10.2017;2017;10;17;Perjantai;21;18;39;1;2;3
293;06.10.2017;2017;10;18;Perjantai;18;22;40;10;2;12
293;06.10.2017;2017;10;19;Perjantai;13;16;29;2;2;4
293;06.10.2017;2017;10;20;Perjantai;9;11;20;1;6;7
293;06.10.2017;2017;10;21;Perjantai;7;12;19;3;1;4
293;06.10.2017;2017;10;22;Perjantai;6;12;18;0;1;1
293;06.10.2017;2017;10;23;Perjantai;2;3;5;2;1;3
293;07.10.2017;2017;10;00;Lauantai;0;0;0;0;0;0
293;07.10.2017;2017;10;01;Lauantai;0;4;4;0;0;0
293;07.10.2017;2017;10;02;Lauantai;0;0;0;0;1;1
293;07.10.2017;2017;10;03;Lauantai;1;0;1;0;0;0
293;07.10.2017;2017;10;04;Lauantai;1;0;1;0;1;1
293;07.10.2017;2017;10;05;Lauantai;0;1;1;0;0;0
293;07.10.2017;2017;10;06;Lauantai;1;0;1;1;0;1
293;07.10.2017;2017;10;07;Lauantai;3;1;4;1;0;1
293;07.10.2017;2017;10;08;Lauantai;7;0;7;2;2;4
293;07.10.2017;2017;10;09;Lauantai;9;5;14;6;5;11
293;07.10.2017;2017;10;10;Lauantai;10;7;17;9;4;13
293;07.10.2017;2017;10;11;Lauantai;16;13;29;3;2;5
293;07.10.2017;2017;10;12;Lauantai;20;17;37;7;1;8
293;07.10.2017;2017;10;13;Lauantai;17;14;31;7;1;8
293;07.10.2017;2017;10;14;Lauantai;25;20;45;3;6;9
293;07.10.2017;2017;10;15;Lauantai;17;26;43;3;3;6
293;07.10.2017;2017;10;16;Lauantai;13;19;32;2;2;4
293;07.10.2017;2017;10;17;Lauantai;10;11;21;7;8;15
293;07.10.2017;2017;10;18;Lauantai;14;7;21;2;5;7
293;07.10.2017;2017;10;19;Lauantai;17;16;33;4;4;8
293;07.10.2017;2017;10;20;Lauantai;14;18;32;2;2;4
293;07.10.2017;2017;10;21;Lauantai;1;7;8;2;0;2
293;07.10.2017;2017;10;22;Lauantai;9;8;17;0;1;1
293;07.10.2017;2017;10;23;Lauantai;3;7;10;0;0;0
293;08.10.2017;2017;10;00;Sunnuntai;2;2;4;0;0;0
293;08.10.2017;2017;10;01;Sunnuntai;0;2;2;0;3;3
293;08.10.2017;2017;10;02;Sunnuntai;0;4;4;0;1;1
293;08.10.2017;2017;10;03;Sunnuntai;0;1;1;0;1;1
293;08.10.2017;2017;10;04;Sunnuntai;0;0;0;0;0;0
293;08.10.2017;2017;10;05;Sunnuntai;0;1;1;0;0;0
293;08.10.2017;2017;10;06;Sunnuntai;0;0;0;0;0;0
293;08.10.2017;2017;10;07;Sunnuntai;1;1;2;1;1;2
293;08.10.2017;2017;10;08;Sunnuntai;7;3;10;5;2;7
293;08.10.2017;2017;10;09;Sunnuntai;15;4;19;3;1;4
293;08.10.2017;2017;10;10;Sunnuntai;14;11;25;3;5;8
293;08.10.2017;2017;10;11;Sunnuntai;18;15;33;3;6;9
293;08.10.2017;2017;10;12;Sunnuntai;13;31;44;6;4;10
293;08.10.2017;2017;10;13;Sunnuntai;20;14;34;5;3;8
293;08.10.2017;2017;10;14;Sunnuntai;19;16;35;7;4;11
293;08.10.2017;2017;10;15;Sunnuntai;13;15;28;4;6;10
293;08.10.2017;2017;10;16;Sunnuntai;15;30;45;4;2;6
293;08.10.2017;2017;10;17;Sunnuntai;20;13;33;5;8;13
293;08.10.2017;2017;10;18;Sunnuntai;19;12;31;1;5;6
293;08.10.2017;2017;10;19;Sunnuntai;10;14;24;6;6;12
293;08.10.2017;2017;10;20;Sunnuntai;2;14;16;3;3;6
293;08.10.2017;2017;10;21;Sunnuntai;3;7;10;0;0;0
293;08.10.2017;2017;10;22;Sunnuntai;0;1;1;0;0;0
293;08.10.2017;2017;10;23;Sunnuntai;0;0;0;0;0;0
293;09.10.2017;2017;10;00;Maanantai;0;0;0;0;0;0
293;09.10.2017;2017;10;01;Maanantai;0;0;0;0;0;0
293;09.10.2017;2017;10;02;Maanantai;0;0;0;0;0;0
293;09.10.2017;2017;10;03;Maanantai;0;0;0;0;0;0
293;09.10.2017;2017;10;04;Maanantai;0;0;0;0;0;0
293;09.10.2017;2017;10;05;Maanantai;2;0;2;0;0;0
293;09.10.2017;2017;10;06;Maanantai;16;1;17;0;0;0
293;09.10.2017;2017;10;07;Maanantai;71;5;76;5;1;6
293;09.10.2017;2017;10;08;Maanantai;100;15;115;5;2;7
293;09.10.2017;2017;10;09;Maanantai;27;5;32;6;4;10
293;09.10.2017;2017;10;10;Maanantai;13;7;20;7;5;12
293;09.10.2017;2017;10;11;Maanantai;13;8;21;4;2;6
293;09.10.2017;2017;10;12;Maanantai;13;17;30;3;2;5
293;09.10.2017;2017;10;13;Maanantai;8;23;31;4;0;4
293;09.10.2017;2017;10;14;Maanantai;15;60;75;2;10;12
293;09.10.2017;2017;10;15;Maanantai;15;125;140;5;10;15
293;09.10.2017;2017;10;16;Maanantai;18;34;52;5;4;9
293;09.10.2017;2017;10;17;Maanantai;34;19;53;6;8;14
293;09.10.2017;2017;10;18;Maanantai;29;32;61;5;5;10
293;09.10.2017;2017;10;19;Maanantai;17;30;47;1;6;7
293;09.10.2017;2017;10;20;Maanantai;12;19;31;2;4;6
293;09.10.2017;2017;10;21;Maanantai;0;10;10;1;0;1
293;09.10.2017;2017;10;22;Maanantai;0;2;2;0;0;0
293;09.10.2017;2017;10;23;Maanantai;1;0;1;0;0;0
293;10.10.2017;2017;10;00;Tiistai;0;0;0;0;0;0
293;10.10.2017;2017;10;01;Tiistai;0;0;0;0;0;0
293;10.10.2017;2017;10;02;Tiistai;0;0;0;0;0;0
293;10.10.2017;2017;10;03;Tiistai;0;0;0;0;0;0
293;10.10.2017;2017;10;04;Tiistai;1;0;1;0;0;0
293;10.10.2017;2017;10;05;Tiistai;2;1;3;0;0;0
293;10.10.2017;2017;10;06;Tiistai;9;1;10;0;0;0
293;10.10.2017;2017;10;07;Tiistai;71;4;75;3;2;5
293;10.10.2017;2017;10;08;Tiistai;62;8;70;1;0;1
293;10.10.2017;2017;10;09;Tiistai;27;2;29;1;0;1
293;10.10.2017;2017;10;10;Tiistai;11;5;16;0;2;2
293;10.10.2017;2017;10;11;Tiistai;2;4;6;4;0;4
293;10.10.2017;2017;10;12;Tiistai;2;6;8;0;4;4
293;10.10.2017;2017;10;13;Tiistai;7;38;45;0;3;3
293;10.10.2017;2017;10;14;Tiistai;12;70;82;3;4;7
293;10.10.2017;2017;10;15;Tiistai;18;64;82;1;5;6
293;10.10.2017;2017;10;16;Tiistai;12;19;31;6;6;12
293;10.10.2017;2017;10;17;Tiistai;15;18;33;9;5;14
293;10.10.2017;2017;10;18;Tiistai;9;21;30;7;4;11
293;10.10.2017;2017;10;19;Tiistai;11;21;32;2;6;8
293;10.10.2017;2017;10;20;Tiistai;5;11;16;4;6;10
293;10.10.2017;2017;10;21;Tiistai;4;1;5;3;2;5
293;10.10.2017;2017;10;22;Tiistai;0;0;0;0;0;0
293;10.10.2017;2017;10;23;Tiistai;0;0;0;0;0;0
293;11.10.2017;2017;10;00;Keskiviikko;0;0;0;0;0;0
293;11.10.2017;2017;10;01;Keskiviikko;0;0;0;0;0;0
293;11.10.2017;2017;10;02;Keskiviikko;0;0;0;0;0;0
293;11.10.2017;2017;10;03;Keskiviikko;0;0;0;0;0;0
293;11.10.2017;2017;10;04;Keskiviikko;0;0;0;1;0;1
293;11.10.2017;2017;10;05;Keskiviikko;2;1;3;0;0;0
293;11.10.2017;2017;10;06;Keskiviikko;16;1;17;0;0;0
293;11.10.2017;2017;10;07;Keskiviikko;102;6;108;8;0;8
293;11.10.2017;2017;10;08;Keskiviikko;84;12;96;5;2;7
293;11.10.2017;2017;10;09;Keskiviikko;13;5;18;6;0;6
293;11.10.2017;2017;10;10;Keskiviikko;10;9;19;3;1;4
293;11.10.2017;2017;10;11;Keskiviikko;7;11;18;1;2;3
293;11.10.2017;2017;10;12;Keskiviikko;9;21;30;3;3;6
293;11.10.2017;2017;10;13;Keskiviikko;12;42;54;5;4;9
293;11.10.2017;2017;10;14;Keskiviikko;22;115;137;3;7;10
293;11.10.2017;2017;10;15;Keskiviikko;12;58;70;2;5;7
293;11.10.2017;2017;10;16;Keskiviikko;21;23;44;9;3;12
293;11.10.2017;2017;10;17;Keskiviikko;21;20;41;4;8;12
293;11.10.2017;2017;10;18;Keskiviikko;13;13;26;2;5;7
293;11.10.2017;2017;10;19;Keskiviikko;9;21;30;1;2;3
293;11.10.2017;2017;10;20;Keskiviikko;4;13;17;1;4;5
293;11.10.2017;2017;10;21;Keskiviikko;1;7;8;1;0;1
293;11.10.2017;2017;10;22;Keskiviikko;0;2;2;1;0;1
293;11.10.2017;2017;10;23;Keskiviikko;0;1;1;0;0;0
293;12.10.2017;2017;10;00;Torstai;0;0;0;0;0;0
293;12.10.2017;2017;10;01;Torstai;0;0;0;0;1;1
293;12.10.2017;2017;10;02;Torstai;0;0;0;0;0;0
293;12.10.2017;2017;10;03;Torstai;0;0;0;0;0;0
293;12.10.2017;2017;10;04;Torstai;1;0;1;0;0;0
293;12.10.2017;2017;10;05;Torstai;1;1;2;0;0;0
293;12.10.2017;2017;10;06;Torstai;12;1;13;0;1;1
293;12.10.2017;2017;10;07;Torstai;111;5;116;5;2;7
293;12.10.2017;2017;10;08;Torstai;75;8;83;2;0;2
293;12.10.2017;2017;10;09;Torstai;17;12;29;4;1;5
293;12.10.2017;2017;10;10;Torstai;20;5;25;2;3;5
293;12.10.2017;2017;10;11;Torstai;20;12;32;8;4;12
293;12.10.2017;2017;10;12;Torstai;14;24;38;6;2;8
293;12.10.2017;2017;10;13;Torstai;12;41;53;2;8;10
293;12.10.2017;2017;10;14;Torstai;11;65;76;2;4;6
293;12.10.2017;2017;10;15;Torstai;20;102;122;2;10;12
293;12.10.2017;2017;10;16;Torstai;21;35;56;1;9;10
293;12.10.2017;2017;10;17;Torstai;17;14;31;6;6;12
293;12.10.2017;2017;10;18;Torstai;17;15;32;4;7;11
293;12.10.2017;2017;10;19;Torstai;8;14;22;7;4;11
293;12.10.2017;2017;10;20;Torstai;12;29;41;3;3;6
293;12.10.2017;2017;10;21;Torstai;3;4;7;0;2;2
293;12.10.2017;2017;10;22;Torstai;0;0;0;0;0;0
293;12.10.2017;2017;10;23;Torstai;0;0;0;0;0;0
293;13.10.2017;2017;10;00;Perjantai;0;0;0;0;0;0
293;13.10.2017;2017;10;01;Perjantai;0;0;0;0;0;0
293;13.10.2017;2017;10;02;Perjantai;1;1;2;0;1;1
293;13.10.2017;2017;10;03;Perjantai;0;0;0;0;0;0
293;13.10.2017;2017;10;04;Perjantai;0;0;0;0;0;0
293;13.10.2017;2017;10;05;Perjantai;0;0;0;0;0;0
293;13.10.2017;2017;10;06;Perjantai;10;4;14;0;1;1
293;13.10.2017;2017;10;07;Perjantai;86;4;90;8;2;10
293;13.10.2017;2017;10;08;Perjantai;75;7;82;3;0;3
293;13.10.2017;2017;10;09;Perjantai;35;5;40;7;2;9
293;13.10.2017;2017;10;10;Perjantai;22;51;73;4;1;5
293;13.10.2017;2017;10;11;Perjantai;12;13;25;0;3;3
293;13.10.2017;2017;10;12;Perjantai;7;27;34;3;2;5
293;13.10.2017;2017;10;13;Perjantai;59;42;101;7;2;9
293;13.10.2017;2017;10;14;Perjantai;8;93;101;4;11;15
293;13.10.2017;2017;10;15;Perjantai;13;60;73;4;7;11
293;13.10.2017;2017;10;16;Perjantai;19;20;39;8;2;10
293;13.10.2017;2017;10;17;Perjantai;20;29;49;9;3;12
293;13.10.2017;2017;10;18;Perjantai;25;30;55;8;3;11
293;13.10.2017;2017;10;19;Perjantai;11;13;24;6;5;11
293;13.10.2017;2017;10;20;Perjantai;20;15;35;2;7;9
293;13.10.2017;2017;10;21;Perjantai;9;18;27;3;5;8
293;13.10.2017;2017;10;22;Perjantai;3;7;10;1;1;2
293;13.10.2017;2017;10;23;Perjantai;1;8;9;0;0;0
293;14.10.2017;2017;10;00;Lauantai;0;0;0;0;0;0
293;14.10.2017;2017;10;01;Lauantai;2;0;2;1;1;2
293;14.10.2017;2017;10;02;Lauantai;0;0;0;0;1;1
293;14.10.2017;2017;10;03;Lauantai;0;1;1;0;2;2
293;14.10.2017;2017;10;04;Lauantai;0;0;0;0;1;1
293;14.10.2017;2017;10;05;Lauantai;0;0;0;0;1;1
293;14.10.2017;2017;10;06;Lauantai;0;0;0;0;0;0
293;14.10.2017;2017;10;07;Lauantai;0;0;0;0;0;0
293;14.10.2017;2017;10;08;Lauantai;1;0;1;2;1;3
293;14.10.2017;2017;10;09;Lauantai;12;4;16;3;1;4
293;14.10.2017;2017;10;10;Lauantai;14;10;24;3;4;7
293;14.10.2017;2017;10;11;Lauantai;8;8;16;11;1;12
293;14.10.2017;2017;10;12;Lauantai;15;12;27;8;3;11
293;14.10.2017;2017;10;13;Lauantai;16;9;25;2;8;10
293;14.10.2017;2017;10;14;Lauantai;17;13;30;6;2;8
293;14.10.2017;2017;10;15;Lauantai;9;11;20;4;2;6
293;14.10.2017;2017;10;16;Lauantai;7;16;23;1;6;7
293;14.10.2017;2017;10;17;Lauantai;8;5;13;5;3;8
293;14.10.2017;2017;10;18;Lauantai;8;5;13;4;2;6
293;14.10.2017;2017;10;19;Lauantai;10;13;23;2;2;4
293;14.10.2017;2017;10;20;Lauantai;5;7;12;0;1;1
293;14.10.2017;2017;10;21;Lauantai;8;11;19;1;0;1
293;14.10.2017;2017;10;22;Lauantai;3;3;6;0;1;1
293;14.10.2017;2017;10;23;Lauantai;1;1;2;0;1;1
293;15.10.2017;2017;10;00;Sunnuntai;1;3;4;0;1;1
293;15.10.2017;2017;10;01;Sunnuntai;2;1;3;0;0;0
293;15.10.2017;2017;10;02;Sunnuntai;0;0;0;0;0;0
293;15.10.2017;2017;10;03;Sunnuntai;0;0;0;0;0;0
293;15.10.2017;2017;10;04;Sunnuntai;0;0;0;0;1;1
293;15.10.2017;2017;10;05;Sunnuntai;0;0;0;0;0;0
293;15.10.2017;2017;10;06;Sunnuntai;2;0;2;0;0;0
293;15.10.2017;2017;10;07;Sunnuntai;0;0;0;1;1;2
293;15.10.2017;2017;10;08;Sunnuntai;2;1;3;2;3;5
293;15.10.2017;2017;10;09;Sunnuntai;8;2;10;7;1;8
293;15.10.2017;2017;10;10;Sunnuntai;10;7;17;5;5;10
293;15.10.2017;2017;10;11;Sunnuntai;10;15;25;6;9;15
293;15.10.2017;2017;10;12;Sunnuntai;15;22;37;9;7;16
293;15.10.2017;2017;10;13;Sunnuntai;15;14;29;4;1;5
293;15.10.2017;2017;10;14;Sunnuntai;20;19;39;5;3;8
293;15.10.2017;2017;10;15;Sunnuntai;18;21;39;11;2;13
293;15.10.2017;2017;10;16;Sunnuntai;23;12;35;7;5;12
293;15.10.2017;2017;10;17;Sunnuntai;18;17;35;5;6;11
293;15.10.2017;2017;10;18;Sunnuntai;12;17;29;5;5;10
293;15.10.2017;2017;10;19;Sunnuntai;6;13;19;2;2;4
293;15.10.2017;2017;10;20;Sunnuntai;9;14;23;1;3;4
293;15.10.2017;2017;10;21;Sunnuntai;0;5;5;1;0;1
293;15.10.2017;2017;10;22;Sunnuntai;0;0;0;1;1;2
293;15.10.2017;2017;10;23;Sunnuntai;0;1;1;0;0;0
293;16.10.2017;2017;10;00;Maanantai;0;0;0;0;0;0
293;16.10.2017;2017;10;01;Maanantai;0;0;0;0;0;0
293;16.10.2017;2017;10;02;Maanantai;0;1;1;0;1;1
293;16.10.2017;2017;10;03;Maanantai;1;0;1;0;0;0
293;16.10.2017;2017;10;04;Maanantai;0;0;0;0;0;0
293;16.10.2017;2017;10;05;Maanantai;3;0;3;0;0;0
293;16.10.2017;2017;10;06;Maanantai;12;3;15;0;0;0
293;16.10.2017;2017;10;07;Maanantai;70;2;72;5;1;6
293;16.10.2017;2017;10;08;Maanantai;79;17;96;5;0;5
293;16.10.2017;2017;10;09;Maanantai;24;4;28;2;0;2
293;16.10.2017;2017;10;10;Maanantai;15;4;19;0;4;4
293;16.10.2017;2017;10;11;Maanantai;5;6;11;1;1;2
293;16.10.2017;2017;10;12;Maanantai;5;5;10;1;2;3
293;16.10.2017;2017;10;13;Maanantai;6;14;20;1;4;5
293;16.10.2017;2017;10;14;Maanantai;7;45;52;2;4;6
293;16.10.2017;2017;10;15;Maanantai;13;109;122;5;9;14
293;16.10.2017;2017;10;16;Maanantai;21;28;49;8;6;14
293;16.10.2017;2017;10;17;Maanantai;21;19;40;3;6;9
293;16.10.2017;2017;10;18;Maanantai;18;13;31;5;2;7
293;16.10.2017;2017;10;19;Maanantai;8;20;28;6;10;16
293;16.10.2017;2017;10;20;Maanantai;4;8;12;2;2;4
293;16.10.2017;2017;10;21;Maanantai;2;3;5;1;1;2
293;16.10.2017;2017;10;22;Maanantai;0;0;0;0;0;0
293;16.10.2017;2017;10;23;Maanantai;0;0;0;0;0;0
293;17.10.2017;2017;10;00;Tiistai;0;0;0;0;0;0
293;17.10.2017;2017;10;01;Tiistai;0;0;0;0;0;0
293;17.10.2017;2017;10;02;Tiistai;0;1;1;0;0;0
293;17.10.2017;2017;10;03;Tiistai;1;0;1;0;1;1
293;17.10.2017;2017;10;04;Tiistai;0;0;0;0;0;0
293;17.10.2017;2017;10;05;Tiistai;1;0;1;0;0;0
293;17.10.2017;2017;10;06;Tiistai;15;1;16;0;0;0
293;17.10.2017;2017;10;07;Tiistai;89;2;91;7;1;8
293;17.10.2017;2017;10;08;Tiistai;74;13;87;4;3;7
293;17.10.2017;2017;10;09;Tiistai;38;9;47;2;1;3
293;17.10.2017;2017;10;10;Tiistai;18;12;30;5;2;7
293;17.10.2017;2017;10;11;Tiistai;11;6;17;2;3;5
293;17.10.2017;2017;10;12;Tiistai;8;11;19;4;0;4
293;17.10.2017;2017;10;13;Tiistai;20;57;77;6;10;16
293;17.10.2017;2017;10;14;Tiistai;18;95;113;13;11;24
293;17.10.2017;2017;10;15;Tiistai;19;75;94;7;4;11
293;17.10.2017;2017;10;16;Tiistai;28;32;60;3;5;8
293;17.10.2017;2017;10;17;Tiistai;25;23;48;5;7;12
293;17.10.2017;2017;10;18;Tiistai;15;18;33;4;6;10
293;17.10.2017;2017;10;19;Tiistai;12;20;32;10;7;17
293;17.10.2017;2017;10;20;Tiistai;7;16;23;1;4;5
293;17.10.2017;2017;10;21;Tiistai;2;5;7;1;1;2
293;17.10.2017;2017;10;22;Tiistai;0;0;0;0;0;0
293;17.10.2017;2017;10;23;Tiistai;0;0;0;0;0;0
293;18.10.2017;2017;10;00;Keskiviikko;0;0;0;0;0;0
293;18.10.2017;2017;10;01;Keskiviikko;0;0;0;0;0;0
293;18.10.2017;2017;10;02;Keskiviikko;0;0;0;0;0;0
293;18.10.2017;2017;10;03;Keskiviikko;0;0;0;1;0;1
293;18.10.2017;2017;10;04;Keskiviikko;0;0;0;0;0;0
293;18.10.2017;2017;10;05;Keskiviikko;3;0;3;1;0;1
293;18.10.2017;2017;10;06;Keskiviikko;12;2;14;0;1;1
293;18.10.2017;2017;10;07;Keskiviikko;88;5;93;8;2;10
293;18.10.2017;2017;10;08;Keskiviikko;99;11;110;4;2;6
293;18.10.2017;2017;10;09;Keskiviikko;15;4;19;2;1;3
293;18.10.2017;2017;10;10;Keskiviikko;17;65;82;8;6;14
293;18.10.2017;2017;10;11;Keskiviikko;8;10;18;0;1;1
293;18.10.2017;2017;10;12;Keskiviikko;76;12;88;5;1;6
293;18.10.2017;2017;10;13;Keskiviikko;9;41;50;1;2;3
293;18.10.2017;2017;10;14;Keskiviikko;13;119;132;6;8;14
293;18.10.2017;2017;10;15;Keskiviikko;9;31;40;5;6;11
293;18.10.2017;2017;10;16;Keskiviikko;21;30;51;4;6;10
293;18.10.2017;2017;10;17;Keskiviikko;19;20;39;6;4;10
293;18.10.2017;2017;10;18;Keskiviikko;14;15;29;0;3;3
293;18.10.2017;2017;10;19;Keskiviikko;10;16;26;4;8;12
293;18.10.2017;2017;10;20;Keskiviikko;5;14;19;1;1;2
293;18.10.2017;2017;10;21;Keskiviikko;1;1;2;0;0;0
293;18.10.2017;2017;10;22;Keskiviikko;0;1;1;0;0;0
293;18.10.2017;2017;10;23;Keskiviikko;0;0;0;1;1;2
293;19.10.2017;2017;10;00;Torstai;0;0;0;0;0;0
293;19.10.2017;2017;10;01;Torstai;0;0;0;0;0;0
293;19.10.2017;2017;10;02;Torstai;0;0;0;0;0;0
293;19.10.2017;2017;10;03;Torstai;1;0;1;0;0;0
293;19.10.2017;2017;10;04;Torstai;0;0;0;0;0;0
293;19.10.2017;2017;10;05;Torstai;3;0;3;0;0;0
293;19.10.2017;2017;10;06;Torstai;8;3;11;0;1;1
293;19.10.2017;2017;10;07;Torstai;93;3;96;3;3;6
293;19.10.2017;2017;10;08;Torstai;79;7;86;8;1;9
293;19.10.2017;2017;10;09;Torstai;22;6;28;2;1;3
293;19.10.2017;2017;10;10;Torstai;15;10;25;2;0;2
293;19.10.2017;2017;10;11;Torstai;6;9;15;4;5;9
293;19.10.2017;2017;10;12;Torstai;11;5;16;2;4;6
293;19.10.2017;2017;10;13;Torstai;11;41;52;7;2;9
293;19.10.2017;2017;10;14;Torstai;11;79;90;3;4;7
293;19.10.2017;2017;10;15;Torstai;16;84;100;2;7;9
293;19.10.2017;2017;10;16;Torstai;28;13;41;6;6;12
293;19.10.2017;2017;10;17;Torstai;26;21;47;4;5;9
293;19.10.2017;2017;10;18;Torstai;18;40;58;4;8;12
293;19.10.2017;2017;10;19;Torstai;9;17;26;6;4;10
293;19.10.2017;2017;10;20;Torstai;2;17;19;0;2;2
293;19.10.2017;2017;10;21;Torstai;1;2;3;0;2;2
293;19.10.2017;2017;10;22;Torstai;3;0;3;2;1;3
293;19.10.2017;2017;10;23;Torstai;0;0;0;0;1;1
293;20.10.2017;2017;10;00;Perjantai;0;0;0;1;0;1
293;20.10.2017;2017;10;01;Perjantai;0;0;0;0;0;0
293;20.10.2017;2017;10;02;Perjantai;1;1;2;0;0;0
293;20.10.2017;2017;10;03;Perjantai;0;0;0;0;0;0
293;20.10.2017;2017;10;04;Perjantai;0;0;0;0;0;0
293;20.10.2017;2017;10;05;Perjantai;1;0;1;0;0;0
293;20.10.2017;2017;10;06;Perjantai;7;1;8;2;1;3
293;20.10.2017;2017;10;07;Perjantai;74;5;79;3;0;3
293;20.10.2017;2017;10;08;Perjantai;78;7;85;4;3;7
293;20.10.2017;2017;10;09;Perjantai;32;2;34;6;1;7
293;20.10.2017;2017;10;10;Perjantai;10;7;17;6;4;10
293;20.10.2017;2017;10;11;Perjantai;7;10;17;0;2;2
293;20.10.2017;2017;10;12;Perjantai;7;25;32;1;0;1
293;20.10.2017;2017;10;13;Perjantai;6;59;65;5;4;9
293;20.10.2017;2017;10;14;Perjantai;15;84;99;2;5;7
293;20.10.2017;2017;10;15;Perjantai;21;19;40;4;4;8
293;20.10.2017;2017;10;16;Perjantai;17;25;42;5;3;8
293;20.10.2017;2017;10;17;Perjantai;13;19;32;6;5;11
293;20.10.2017;2017;10;18;Perjantai;20;31;51;9;10;19
293;20.10.2017;2017;10;19;Perjantai;10;12;22;2;3;5
293;20.10.2017;2017;10;20;Perjantai;11;16;27;3;5;8
293;20.10.2017;2017;10;21;Perjantai;11;2;13;1;5;6
293;20.10.2017;2017;10;22;Perjantai;7;2;9;2;0;2
293;20.10.2017;2017;10;23;Perjantai;3;1;4;1;0;1
293;21.10.2017;2017;10;00;Lauantai;0;2;2;0;0;0
293;21.10.2017;2017;10;01;Lauantai;0;0;0;0;0;0
293;21.10.2017;2017;10;02;Lauantai;0;0;0;0;1;1
293;21.10.2017;2017;10;03;Lauantai;0;0;0;0;2;2
293;21.10.2017;2017;10;04;Lauantai;1;0;1;0;0;0
293;21.10.2017;2017;10;05;Lauantai;0;0;0;0;0;0
293;21.10.2017;2017;10;06;Lauantai;1;0;1;0;0;0
293;21.10.2017;2017;10;07;Lauantai;0;0;0;1;1;2
293;21.10.2017;2017;10;08;Lauantai;2;1;3;0;1;1
293;21.10.2017;2017;10;09;Lauantai;7;3;10;0;1;1
293;21.10.2017;2017;10;10;Lauantai;5;2;7;4;2;6
293;21.10.2017;2017;10;11;Lauantai;13;13;26;7;4;11
293;21.10.2017;2017;10;12;Lauantai;7;6;13;1;2;3
293;21.10.2017;2017;10;13;Lauantai;12;6;18;4;0;4
293;21.10.2017;2017;10;14;Lauantai;6;8;14;3;3;6
293;21.10.2017;2017;10;15;Lauantai;3;11;14;2;2;4
293;21.10.2017;2017;10;16;Lauantai;5;3;8;3;9;12
293;21.10.2017;2017;10;17;Lauantai;10;8;18;8;1;9
293;21.10.2017;2017;10;18;Lauantai;4;5;9;3;6;9
293;21.10.2017;2017;10;19;Lauantai;12;8;20;1;2;3
293;21.10.2017;2017;10;20;Lauantai;1;7;8;0;0;0
293;21.10.2017;2017;10;21;Lauantai;1;9;10;1;3;4
293;21.10.2017;2017;10;22;Lauantai;2;3;5;0;1;1
293;21.10.2017;2017;10;23;Lauantai;3;3;6;1;2;3
293;22.10.2017;2017;10;00;Sunnuntai;2;0;2;1;0;1
293;22.10.2017;2017;10;01;Sunnuntai;0;1;1;0;1;1
293;22.10.2017;2017;10;02;Sunnuntai;0;2;2;0;2;2
293;22.10.2017;2017;10;03;Sunnuntai;0;1;1;0;3;3
293;22.10.2017;2017;10;04;Sunnuntai;2;0;2;2;2;4
293;22.10.2017;2017;10;05;Sunnuntai;0;0;0;1;0;1
293;22.10.2017;2017;10;06;Sunnuntai;0;0;0;0;0;0
293;22.10.2017;2017;10;07;Sunnuntai;1;0;1;0;0;0
293;22.10.2017;2017;10;08;Sunnuntai;0;0;0;1;0;1
293;22.10.2017;2017;10;09;Sunnuntai;0;0;0;4;1;5
293;22.10.2017;2017;10;10;Sunnuntai;8;1;9;7;6;13
293;22.10.2017;2017;10;11;Sunnuntai;10;9;19;5;6;11
293;22.10.2017;2017;10;12;Sunnuntai;12;6;18;2;5;7
293;22.10.2017;2017;10;13;Sunnuntai;11;10;21;4;3;7
293;22.10.2017;2017;10;14;Sunnuntai;7;8;15;4;6;10
293;22.10.2017;2017;10;15;Sunnuntai;13;15;28;5;5;10
293;22.10.2017;2017;10;16;Sunnuntai;9;10;19;4;5;9
293;22.10.2017;2017;10;17;Sunnuntai;12;5;17;2;6;8
293;22.10.2017;2017;10;18;Sunnuntai;15;15;30;4;8;12
293;22.10.2017;2017;10;19;Sunnuntai;7;5;12;2;2;4
293;22.10.2017;2017;10;20;Sunnuntai;3;7;10;1;3;4
293;22.10.2017;2017;10;21;Sunnuntai;1;6;7;2;0;2
293;22.10.2017;2017;10;22;Sunnuntai;2;1;3;0;1;1
293;22.10.2017;2017;10;23;Sunnuntai;2;2;4;0;0;0
293;23.10.2017;2017;10;00;Maanantai;1;0;1;0;0;0
293;23.10.2017;2017;10;01;Maanantai;0;0;0;0;0;0
293;23.10.2017;2017;10;02;Maanantai;0;0;0;0;0;0
293;23.10.2017;2017;10;03;Maanantai;0;0;0;0;0;0
293;23.10.2017;2017;10;04;Maanantai;0;0;0;0;0;0
293;23.10.2017;2017;10;05;Maanantai;3;0;3;1;1;2
293;23.10.2017;2017;10;06;Maanantai;9;1;10;2;0;2
293;23.10.2017;2017;10;07;Maanantai;8;0;8;0;1;1
293;23.10.2017;2017;10;08;Maanantai;3;4;7;4;2;6
293;23.10.2017;2017;10;09;Maanantai;5;4;9;4;4;8
293;23.10.2017;2017;10;10;Maanantai;6;3;9;7;3;10
293;23.10.2017;2017;10;11;Maanantai;4;6;10;5;4;9
293;23.10.2017;2017;10;12;Maanantai;12;4;16;8;8;16
293;23.10.2017;2017;10;13;Maanantai;5;6;11;7;4;11
293;23.10.2017;2017;10;14;Maanantai;6;15;21;5;2;7
293;23.10.2017;2017;10;15;Maanantai;8;11;19;4;7;11
293;23.10.2017;2017;10;16;Maanantai;9;8;17;3;3;6
293;23.10.2017;2017;10;17;Maanantai;7;15;22;4;4;8
293;23.10.2017;2017;10;18;Maanantai;4;7;11;4;4;8
293;23.10.2017;2017;10;19;Maanantai;4;7;11;3;2;5
293;23.10.2017;2017;10;20;Maanantai;9;5;14;1;4;5
293;23.10.2017;2017;10;21;Maanantai;1;3;4;0;1;1
293;23.10.2017;2017;10;22;Maanantai;0;0;0;0;0;0
293;23.10.2017;2017;10;23;Maanantai;1;3;4;0;0;0
293;24.10.2017;2017;10;00;Tiistai;0;0;0;0;0;0
293;24.10.2017;2017;10;01;Tiistai;0;1;1;0;0;0
293;24.10.2017;2017;10;02;Tiistai;0;0;0;0;0;0
293;24.10.2017;2017;10;03;Tiistai;0;0;0;0;0;0
293;24.10.2017;2017;10;04;Tiistai;0;0;0;1;0;1
293;24.10.2017;2017;10;05;Tiistai;3;0;3;0;0;0
293;24.10.2017;2017;10;06;Tiistai;4;1;5;2;0;2
293;24.10.2017;2017;10;07;Tiistai;9;0;9;2;2;4
293;24.10.2017;2017;10;08;Tiistai;7;7;14;5;2;7
293;24.10.2017;2017;10;09;Tiistai;10;0;10;3;3;6
293;24.10.2017;2017;10;10;Tiistai;3;11;14;6;3;9
293;24.10.2017;2017;10;11;Tiistai;11;5;16;7;5;12
293;24.10.2017;2017;10;12;Tiistai;11;12;23;8;8;16
293;24.10.2017;2017;10;13;Tiistai;6;10;16;3;6;9
293;24.10.2017;2017;10;14;Tiistai;10;15;25;4;4;8
293;24.10.2017;2017;10;15;Tiistai;6;16;22;2;3;5
293;24.10.2017;2017;10;16;Tiistai;9;13;22;4;9;13
293;24.10.2017;2017;10;17;Tiistai;6;11;17;3;4;7
293;24.10.2017;2017;10;18;Tiistai;10;7;17;7;4;11
293;24.10.2017;2017;10;19;Tiistai;3;7;10;4;7;11
293;24.10.2017;2017;10;20;Tiistai;0;4;4;2;2;4
293;24.10.2017;2017;10;21;Tiistai;1;4;5;1;0;1
293;24.10.2017;2017;10;22;Tiistai;1;0;1;1;2;3
293;24.10.2017;2017;10;23;Tiistai;1;2;3;1;0;1
293;25.10.2017;2017;10;00;Keskiviikko;1;0;1;0;0;0
293;25.10.2017;2017;10;01;Keskiviikko;0;0;0;0;1;1
293;25.10.2017;2017;10;02;Keskiviikko;0;0;0;0;0;0
293;25.10.2017;2017;10;03;Keskiviikko;1;0;1;0;0;0
293;25.10.2017;2017;10;04;Keskiviikko;0;0;0;0;0;0
293;25.10.2017;2017;10;05;Keskiviikko;1;1;2;0;0;0
293;25.10.2017;2017;10;06;Keskiviikko;5;1;6;2;0;2
293;25.10.2017;2017;10;07;Keskiviikko;6;0;6;5;2;7
293;25.10.2017;2017;10;08;Keskiviikko;6;5;11;2;0;2
293;25.10.2017;2017;10;09;Keskiviikko;12;2;14;1;3;4
293;25.10.2017;2017;10;10;Keskiviikko;5;8;13;1;0;1
293;25.10.2017;2017;10;11;Keskiviikko;10;5;15;12;5;17
293;25.10.2017;2017;10;12;Keskiviikko;5;8;13;2;6;8
293;25.10.2017;2017;10;13;Keskiviikko;10;8;18;4;5;9
293;25.10.2017;2017;10;14;Keskiviikko;3;5;8;2;3;5
293;25.10.2017;2017;10;15;Keskiviikko;9;18;27;4;4;8
293;25.10.2017;2017;10;16;Keskiviikko;8;5;13;4;5;9
293;25.10.2017;2017;10;17;Keskiviikko;11;15;26;4;6;10
293;25.10.2017;2017;10;18;Keskiviikko;11;8;19;7;6;13
293;25.10.2017;2017;10;19;Keskiviikko;3;11;14;4;5;9
293;25.10.2017;2017;10;20;Keskiviikko;0;3;3;1;3;4
293;25.10.2017;2017;10;21;Keskiviikko;3;1;4;0;0;0
293;25.10.2017;2017;10;22;Keskiviikko;0;3;3;0;0;0
293;25.10.2017;2017;10;23;Keskiviikko;2;4;6;1;0;1
293;26.10.2017;2017;10;00;Torstai;0;0;0;1;0;1
293;26.10.2017;2017;10;01;Torstai;0;0;0;0;0;0
293;26.10.2017;2017;10;02;Torstai;0;0;0;0;0;0
293;26.10.2017;2017;10;03;Torstai;0;0;0;0;0;0
293;26.10.2017;2017;10;04;Torstai;1;0;1;0;0;0
293;26.10.2017;2017;10;05;Torstai;3;0;3;0;0;0
293;26.10.2017;2017;10;06;Torstai;7;1;8;2;0;2
293;26.10.2017;2017;10;07;Torstai;9;0;9;0;1;1
293;26.10.2017;2017;10;08;Torstai;7;3;10;4;1;5
293;26.10.2017;2017;10;09;Torstai;5;4;9;3;0;3
293;26.10.2017;2017;10;10;Torstai;6;6;12;2;5;7
293;26.10.2017;2017;10;11;Torstai;11;6;17;9;3;12
293;26.10.2017;2017;10;12;Torstai;15;11;26;3;3;6
293;26.10.2017;2017;10;13;Torstai;13;3;16;2;3;5
293;26.10.2017;2017;10;14;Torstai;8;16;24;6;5;11
293;26.10.2017;2017;10;15;Torstai;11;23;34;3;4;7
293;26.10.2017;2017;10;16;Torstai;6;10;16;3;4;7
293;26.10.2017;2017;10;17;Torstai;6;10;16;7;2;9
293;26.10.2017;2017;10;18;Torstai;4;5;9;5;6;11
293;26.10.2017;2017;10;19;Torstai;6;7;13;1;3;4
293;26.10.2017;2017;10;20;Torstai;4;4;8;1;2;3
293;26.10.2017;2017;10;21;Torstai;2;3;5;1;0;1
293;26.10.2017;2017;10;22;Torstai;3;2;5;0;1;1
293;26.10.2017;2017;10;23;Torstai;2;0;2;0;0;0
293;27.10.2017;2017;10;00;Perjantai;0;0;0;0;0;0
293;27.10.2017;2017;10;01;Perjantai;0;0;0;0;0;0
293;27.10.2017;2017;10;02;Perjantai;1;0;1;0;0;0
293;27.10.2017;2017;10;03;Perjantai;0;0;0;0;0;0
293;27.10.2017;2017;10;04;Perjantai;0;0;0;0;0;0
293;27.10.2017;2017;10;05;Perjantai;2;0;2;0;0;0
293;27.10.2017;2017;10;06;Perjantai;6;2;8;4;0;4
293;27.10.2017;2017;10;07;Perjantai;6;0;6;2;3;5
293;27.10.2017;2017;10;08;Perjantai;10;2;12;0;3;3
293;27.10.2017;2017;10;09;Perjantai;4;4;8;1;1;2
293;27.10.2017;2017;10;10;Perjantai;6;5;11;4;4;8
293;27.10.2017;2017;10;11;Perjantai;6;4;10;0;1;1
293;27.10.2017;2017;10;12;Perjantai;16;14;30;5;0;5
293;27.10.2017;2017;10;13;Perjantai;5;11;16;5;8;13
293;27.10.2017;2017;10;14;Perjantai;10;14;24;3;4;7
293;27.10.2017;2017;10;15;Perjantai;13;16;29;2;4;6
293;27.10.2017;2017;10;16;Perjantai;7;9;16;3;2;5
293;27.10.2017;2017;10;17;Perjantai;8;8;16;1;2;3
293;27.10.2017;2017;10;18;Perjantai;5;10;15;5;1;6
293;27.10.2017;2017;10;19;Perjantai;14;4;18;3;2;5
293;27.10.2017;2017;10;20;Perjantai;2;10;12;3;5;8
293;27.10.2017;2017;10;21;Perjantai;2;5;7;0;1;1
293;27.10.2017;2017;10;22;Perjantai;1;4;5;0;0;0
293;27.10.2017;2017;10;23;Perjantai;1;0;1;4;0;4
293;28.10.2017;2017;10;00;Lauantai;1;2;3;1;2;3
293;28.10.2017;2017;10;01;Lauantai;0;0;0;0;1;1
293;28.10.2017;2017;10;02;Lauantai;0;0;0;0;1;1
293;28.10.2017;2017;10;03;Lauantai;0;0;0;0;1;1
293;28.10.2017;2017;10;04;Lauantai;0;0;0;0;0;0
293;28.10.2017;2017;10;05;Lauantai;0;0;0;0;0;0
293;28.10.2017;2017;10;06;Lauantai;0;0;0;0;0;0
293;28.10.2017;2017;10;07;Lauantai;0;0;0;1;0;1
293;28.10.2017;2017;10;08;Lauantai;2;1;3;2;0;2
293;28.10.2017;2017;10;09;Lauantai;4;3;7;3;4;7
293;28.10.2017;2017;10;10;Lauantai;5;2;7;2;2;4
293;28.10.2017;2017;10;11;Lauantai;5;7;12;4;2;6
293;28.10.2017;2017;10;12;Lauantai;2;1;3;3;5;8
293;28.10.2017;2017;10;13;Lauantai;12;4;16;1;5;6
293;28.10.2017;2017;10;14;Lauantai;3;4;7;3;3;6
293;28.10.2017;2017;10;15;Lauantai;4;5;9;2;3;5
293;28.10.2017;2017;10;16;Lauantai;4;4;8;3;2;5
293;28.10.2017;2017;10;17;Lauantai;2;4;6;1;2;3
293;28.10.2017;2017;10;18;Lauantai;9;4;13;4;2;6
293;28.10.2017;2017;10;19;Lauantai;6;1;7;2;2;4
293;28.10.2017;2017;10;20;Lauantai;4;15;19;2;2;4
293;28.10.2017;2017;10;21;Lauantai;2;3;5;1;1;2
293;28.10.2017;2017;10;22;Lauantai;0;2;2;3;0;3
293;28.10.2017;2017;10;23;Lauantai;0;0;0;1;0;1
293;29.10.2017;2017;10;00;Sunnuntai;0;0;0;0;0;0
293;29.10.2017;2017;10;01;Sunnuntai;2;0;2;0;0;0
293;29.10.2017;2017;10;02;Sunnuntai;0;0;0;0;1;1
293;29.10.2017;2017;10;03;Sunnuntai;1;3;4;0;1;1
293;29.10.2017;2017;10;04;Sunnuntai;0;0;0;0;0;0
293;29.10.2017;2017;10;05;Sunnuntai;1;0;1;0;1;1
293;29.10.2017;2017;10;06;Sunnuntai;0;0;0;0;0;0
293;29.10.2017;2017;10;07;Sunnuntai;1;0;1;5;1;6
293;29.10.2017;2017;10;08;Sunnuntai;0;1;1;1;1;2
293;29.10.2017;2017;10;09;Sunnuntai;2;1;3;5;2;7
293;29.10.2017;2017;10;10;Sunnuntai;1;4;5;8;4;12
293;29.10.2017;2017;10;11;Sunnuntai;6;3;9;6;5;11
293;29.10.2017;2017;10;12;Sunnuntai;6;0;6;3;3;6
293;29.10.2017;2017;10;13;Sunnuntai;5;6;11;7;3;10
293;29.10.2017;2017;10;14;Sunnuntai;5;6;11;3;7;10
293;29.10.2017;2017;10;15;Sunnuntai;3;2;5;2;0;2
293;29.10.2017;2017;10;16;Sunnuntai;7;2;9;4;3;7
293;29.10.2017;2017;10;17;Sunnuntai;8;6;14;5;4;9
293;29.10.2017;2017;10;18;Sunnuntai;5;5;10;4;7;11
293;29.10.2017;2017;10;19;Sunnuntai;4;5;9;1;6;7
293;29.10.2017;2017;10;20;Sunnuntai;3;5;8;2;4;6
293;29.10.2017;2017;10;21;Sunnuntai;0;3;3;0;0;0
293;29.10.2017;2017;10;22;Sunnuntai;0;2;2;0;0;0
293;29.10.2017;2017;10;23;Sunnuntai;0;0;0;0;0;0
293;30.10.2017;2017;10;00;Maanantai;0;0;0;0;0;0
293;30.10.2017;2017;10;01;Maanantai;0;0;0;0;0;0
293;30.10.2017;2017;10;02;Maanantai;0;0;0;0;0;0
293;30.10.2017;2017;10;03;Maanantai;0;0;0;0;0;0
293;30.10.2017;2017;10;04;Maanantai;0;0;0;0;0;0
293;30.10.2017;2017;10;05;Maanantai;0;0;0;0;0;0
293;30.10.2017;2017;10;06;Maanantai;6;0;6;1;2;3
293;30.10.2017;2017;10;07;Maanantai;82;2;84;4;0;4
293;30.10.2017;2017;10;08;Maanantai;84;4;88;6;1;7
293;30.10.2017;2017;10;09;Maanantai;27;6;33;3;2;5
293;30.10.2017;2017;10;10;Maanantai;17;7;24;3;0;3
293;30.10.2017;2017;10;11;Maanantai;2;3;5;6;4;10
293;30.10.2017;2017;10;12;Maanantai;2;6;8;10;4;14
293;30.10.2017;2017;10;13;Maanantai;2;18;20;6;6;12
293;30.10.2017;2017;10;14;Maanantai;3;39;42;2;15;17
293;30.10.2017;2017;10;15;Maanantai;5;110;115;1;15;16
293;30.10.2017;2017;10;16;Maanantai;17;14;31;14;8;22
293;30.10.2017;2017;10;17;Maanantai;9;11;20;6;8;14
293;30.10.2017;2017;10;18;Maanantai;7;9;16;5;6;11
293;30.10.2017;2017;10;19;Maanantai;6;11;17;9;5;14
293;30.10.2017;2017;10;20;Maanantai;3;9;12;3;3;6
293;30.10.2017;2017;10;21;Maanantai;1;4;5;0;0;0
293;30.10.2017;2017;10;22;Maanantai;2;0;2;1;1;2
293;30.10.2017;2017;10;23;Maanantai;0;0;0;0;0;0
293;31.10.2017;2017;10;00;Tiistai;0;0;0;0;0;0
293;31.10.2017;2017;10;01;Tiistai;0;0;0;0;0;0
293;31.10.2017;2017;10;02;Tiistai;0;1;1;0;0;0
293;31.10.2017;2017;10;03;Tiistai;0;0;0;0;0;0
293;31.10.2017;2017;10;04;Tiistai;2;0;2;0;0;0
293;31.10.2017;2017;10;05;Tiistai;1;0;1;0;1;1
293;31.10.2017;2017;10;06;Tiistai;6;2;8;1;1;2
293;31.10.2017;2017;10;07;Tiistai;71;2;73;8;0;8
293;31.10.2017;2017;10;08;Tiistai;76;5;81;4;3;7
293;31.10.2017;2017;10;09;Tiistai;35;5;40;8;2;10
293;31.10.2017;2017;10;10;Tiistai;9;2;11;11;2;13
293;31.10.2017;2017;10;11;Tiistai;2;6;8;9;9;18
293;31.10.2017;2017;10;12;Tiistai;5;5;10;4;6;10
293;31.10.2017;2017;10;13;Tiistai;8;43;51;8;4;12
293;31.10.2017;2017;10;14;Tiistai;4;65;69;3;14;17
293;31.10.2017;2017;10;15;Tiistai;10;77;87;3;11;14
293;31.10.2017;2017;10;16;Tiistai;10;12;22;1;9;10
293;31.10.2017;2017;10;17;Tiistai;8;9;17;4;6;10
293;31.10.2017;2017;10;18;Tiistai;5;6;11;3;1;4
293;31.10.2017;2017;10;19;Tiistai;2;6;8;2;3;5
293;31.10.2017;2017;10;20;Tiistai;2;6;8;2;5;7
293;31.10.2017;2017;10;21;Tiistai;0;3;3;0;1;1
293;31.10.2017;2017;10;22;Tiistai;0;1;1;0;0;0
293;31.10.2017;2017;10;23;Tiistai;0;0;0;0;0;0
293;01.11.2017;2017;11;00;Keskiviikko;0;0;0;0;0;0
293;01.11.2017;2017;11;01;Keskiviikko;0;0;0;0;0;0
293;01.11.2017;2017;11;02;Keskiviikko;0;1;1;0;0;0
293;01.11.2017;2017;11;03;Keskiviikko;0;0;0;0;0;0
293;01.11.2017;2017;11;04;Keskiviikko;2;0;2;0;0;0
293;01.11.2017;2017;11;05;Keskiviikko;1;0;1;0;0;0
293;01.11.2017;2017;11;06;Keskiviikko;6;1;7;3;0;3
293;01.11.2017;2017;11;07;Keskiviikko;81;3;84;9;3;12
293;01.11.2017;2017;11;08;Keskiviikko;93;5;98;6;1;7
293;01.11.2017;2017;11;09;Keskiviikko;14;12;26;6;3;9
293;01.11.2017;2017;11;10;Keskiviikko;2;1;3;1;2;3
293;01.11.2017;2017;11;11;Keskiviikko;1;3;4;6;3;9
293;01.11.2017;2017;11;12;Keskiviikko;6;5;11;2;4;6
293;01.11.2017;2017;11;13;Keskiviikko;3;32;35;5;4;9
293;01.11.2017;2017;11;14;Keskiviikko;5;97;102;3;12;15
293;01.11.2017;2017;11;15;Keskiviikko;11;33;44;5;7;12
293;01.11.2017;2017;11;16;Keskiviikko;9;19;28;3;9;12
293;01.11.2017;2017;11;17;Keskiviikko;10;6;16;3;4;7
293;01.11.2017;2017;11;18;Keskiviikko;8;6;14;3;5;8
293;01.11.2017;2017;11;19;Keskiviikko;8;6;14;5;3;8
293;01.11.2017;2017;11;20;Keskiviikko;4;10;14;0;1;1
293;01.11.2017;2017;11;21;Keskiviikko;0;4;4;0;0;0
293;01.11.2017;2017;11;22;Keskiviikko;1;1;2;0;0;0
293;01.11.2017;2017;11;23;Keskiviikko;0;0;0;0;0;0
293;02.11.2017;2017;11;00;Torstai;0;0;0;1;0;1
293;02.11.2017;2017;11;01;Torstai;0;0;0;0;0;0
293;02.11.2017;2017;11;02;Torstai;0;0;0;0;0;0
293;02.11.2017;2017;11;03;Torstai;0;0;0;0;0;0
293;02.11.2017;2017;11;04;Torstai;2;0;2;0;0;0
293;02.11.2017;2017;11;05;Torstai;6;0;6;0;0;0
293;02.11.2017;2017;11;06;Torstai;13;2;15;2;0;2
293;02.11.2017;2017;11;07;Torstai;17;0;17;0;1;1
293;02.11.2017;2017;11;08;Torstai;13;6;19;4;1;5
293;02.11.2017;2017;11;09;Torstai;11;9;20;3;0;3
293;02.11.2017;2017;11;10;Torstai;11;11;22;2;6;8
293;02.11.2017;2017;11;11;Torstai;22;11;33;10;3;13
293;02.11.2017;2017;11;12;Torstai;31;22;53;3;3;6
293;02.11.2017;2017;11;13;Torstai;27;6;33;2;3;5
293;02.11.2017;2017;11;14;Torstai;15;32;47;7;6;13
293;02.11.2017;2017;11;15;Torstai;22;46;68;3;4;7
293;02.11.2017;2017;11;16;Torstai;11;20;31;3;4;7
293;02.11.2017;2017;11;17;Torstai;11;20;31;8;2;10
293;02.11.2017;2017;11;18;Torstai;9;11;20;6;7;13
293;02.11.2017;2017;11;19;Torstai;11;13;24;1;3;4
293;02.11.2017;2017;11;20;Torstai;9;9;18;1;2;3
293;02.11.2017;2017;11;21;Torstai;4;6;10;1;0;1
293;02.11.2017;2017;11;22;Torstai;6;4;10;0;1;1
293;02.11.2017;2017;11;23;Torstai;4;0;4;0;0;0
293;03.11.2017;2017;11;00;Perjantai;0;0;0;0;0;0
293;03.11.2017;2017;11;01;Perjantai;0;0;0;0;0;0
293;03.11.2017;2017;11;02;Perjantai;1;0;1;0;0;0
293;03.11.2017;2017;11;03;Perjantai;0;1;1;0;0;0
293;03.11.2017;2017;11;04;Perjantai;0;0;0;0;1;1
293;03.11.2017;2017;11;05;Perjantai;1;0;1;0;0;0
293;03.11.2017;2017;11;06;Perjantai;4;2;6;3;0;3
293;03.11.2017;2017;11;07;Perjantai;72;5;77;4;1;5
293;03.11.2017;2017;11;08;Perjantai;63;0;63;5;5;10
293;03.11.2017;2017;11;09;Perjantai;31;5;36;5;3;8
293;03.11.2017;2017;11;10;Perjantai;9;3;12;5;1;6
293;03.11.2017;2017;11;11;Perjantai;11;3;14;4;5;9
293;03.11.2017;2017;11;12;Perjantai;8;11;19;6;5;11
293;03.11.2017;2017;11;13;Perjantai;7;26;33;6;10;16
293;03.11.2017;2017;11;14;Perjantai;6;99;105;4;8;12
293;03.11.2017;2017;11;15;Perjantai;7;46;53;2;8;10
293;03.11.2017;2017;11;16;Perjantai;12;8;20;4;7;11
293;03.11.2017;2017;11;17;Perjantai;14;18;32;4;3;7
293;03.11.2017;2017;11;18;Perjantai;15;7;22;4;6;10
293;03.11.2017;2017;11;19;Perjantai;12;10;22;0;5;5
293;03.11.2017;2017;11;20;Perjantai;4;15;19;2;2;4
293;03.11.2017;2017;11;21;Perjantai;5;15;20;1;9;10
293;03.11.2017;2017;11;22;Perjantai;1;2;3;1;2;3
293;03.11.2017;2017;11;23;Perjantai;3;2;5;2;0;2
293;04.11.2017;2017;11;00;Lauantai;1;0;1;1;0;1
293;04.11.2017;2017;11;01;Lauantai;0;0;0;0;0;0
293;04.11.2017;2017;11;02;Lauantai;0;1;1;0;1;1
293;04.11.2017;2017;11;03;Lauantai;0;0;0;0;2;2
293;04.11.2017;2017;11;04;Lauantai;0;0;0;0;0;0
293;04.11.2017;2017;11;05;Lauantai;0;0;0;0;0;0
293;04.11.2017;2017;11;06;Lauantai;1;0;1;0;0;0
293;04.11.2017;2017;11;07;Lauantai;0;0;0;1;1;2
293;04.11.2017;2017;11;08;Lauantai;0;0;0;2;1;3
293;04.11.2017;2017;11;09;Lauantai;0;1;1;2;2;4
293;04.11.2017;2017;11;10;Lauantai;3;0;3;5;0;5
293;04.11.2017;2017;11;11;Lauantai;3;1;4;11;6;17
293;04.11.2017;2017;11;12;Lauantai;5;2;7;6;11;17
293;04.11.2017;2017;11;13;Lauantai;12;5;17;8;3;11
293;04.11.2017;2017;11;14;Lauantai;8;3;11;9;5;14
293;04.11.2017;2017;11;15;Lauantai;8;7;15;8;10;18
293;04.11.2017;2017;11;16;Lauantai;6;3;9;4;2;6
293;04.11.2017;2017;11;17;Lauantai;4;11;15;3;5;8
293;04.11.2017;2017;11;18;Lauantai;6;8;14;1;1;2
293;04.11.2017;2017;11;19;Lauantai;4;1;5;1;6;7
293;04.11.2017;2017;11;20;Lauantai;2;6;8;3;5;8
293;04.11.2017;2017;11;21;Lauantai;5;4;9;2;0;2
293;04.11.2017;2017;11;22;Lauantai;5;4;9;1;1;2
293;04.11.2017;2017;11;23;Lauantai;2;0;2;2;2;4
293;05.11.2017;2017;11;00;Sunnuntai;1;0;1;0;0;0
293;05.11.2017;2017;11;01;Sunnuntai;0;3;3;0;3;3
293;05.11.2017;2017;11;02;Sunnuntai;0;0;0;0;1;1
293;05.11.2017;2017;11;03;Sunnuntai;0;0;0;0;0;0
293;05.11.2017;2017;11;04;Sunnuntai;0;0;0;0;2;2
293;05.11.2017;2017;11;05;Sunnuntai;0;0;0;0;0;0
293;05.11.2017;2017;11;06;Sunnuntai;1;0;1;0;1;1
293;05.11.2017;2017;11;07;Sunnuntai;0;0;0;3;2;5
293;05.11.2017;2017;11;08;Sunnuntai;1;0;1;4;4;8
293;05.11.2017;2017;11;09;Sunnuntai;1;1;2;3;1;4
293;05.11.2017;2017;11;10;Sunnuntai;4;4;8;5;9;14
293;05.11.2017;2017;11;11;Sunnuntai;4;1;5;14;3;17
293;05.11.2017;2017;11;12;Sunnuntai;7;11;18;9;16;25
293;05.11.2017;2017;11;13;Sunnuntai;5;6;11;13;6;19
293;05.11.2017;2017;11;14;Sunnuntai;9;3;12;5;6;11
293;05.11.2017;2017;11;15;Sunnuntai;6;9;15;1;5;6
293;05.11.2017;2017;11;16;Sunnuntai;13;6;19;8;1;9
293;05.11.2017;2017;11;17;Sunnuntai;6;4;10;4;8;12
293;05.11.2017;2017;11;18;Sunnuntai;14;15;29;2;9;11
293;05.11.2017;2017;11;19;Sunnuntai;2;2;4;0;0;0
293;05.11.2017;2017;11;20;Sunnuntai;3;5;8;1;1;2
293;05.11.2017;2017;11;21;Sunnuntai;1;0;1;1;1;2
293;05.11.2017;2017;11;22;Sunnuntai;0;0;0;0;0;0
293;05.11.2017;2017;11;23;Sunnuntai;0;0;0;0;0;0
293;06.11.2017;2017;11;00;Maanantai;0;0;0;0;0;0
293;06.11.2017;2017;11;01;Maanantai;0;1;1;0;0;0
293;06.11.2017;2017;11;02;Maanantai;0;0;0;0;0;0
293;06.11.2017;2017;11;03;Maanantai;0;0;0;0;0;0
293;06.11.2017;2017;11;04;Maanantai;0;0;0;0;0;0
293;06.11.2017;2017;11;05;Maanantai;1;0;1;0;0;0
293;06.11.2017;2017;11;06;Maanantai;7;1;8;2;0;2
293;06.11.2017;2017;11;07;Maanantai;71;3;74;6;3;9
293;06.11.2017;2017;11;08;Maanantai;79;7;86;12;3;15
293;06.11.2017;2017;11;09;Maanantai;27;5;32;6;2;8
293;06.11.2017;2017;11;10;Maanantai;11;5;16;1;2;3
293;06.11.2017;2017;11;11;Maanantai;13;8;21;4;6;10
293;06.11.2017;2017;11;12;Maanantai;6;11;17;3;6;9
293;06.11.2017;2017;11;13;Maanantai;9;26;35;3;6;9
293;06.11.2017;2017;11;14;Maanantai;8;50;58;2;6;8
293;06.11.2017;2017;11;15;Maanantai;6;100;106;3;10;13
293;06.11.2017;2017;11;16;Maanantai;13;14;27;9;8;17
293;06.11.2017;2017;11;17;Maanantai;12;13;25;6;9;15
293;06.11.2017;2017;11;18;Maanantai;7;14;21;9;8;17
293;06.11.2017;2017;11;19;Maanantai;7;14;21;2;5;7
293;06.11.2017;2017;11;20;Maanantai;4;5;9;1;2;3
293;06.11.2017;2017;11;21;Maanantai;1;6;7;0;0;0
293;06.11.2017;2017;11;22;Maanantai;0;0;0;0;0;0
293;06.11.2017;2017;11;23;Maanantai;0;0;0;0;0;0
293;07.11.2017;2017;11;00;Tiistai;0;0;0;0;0;0
293;07.11.2017;2017;11;01;Tiistai;0;1;1;0;0;0
293;07.11.2017;2017;11;02;Tiistai;0;0;0;0;0;0
293;07.11.2017;2017;11;03;Tiistai;0;0;0;0;0;0
293;07.11.2017;2017;11;04;Tiistai;0;0;0;1;0;1
293;07.11.2017;2017;11;05;Tiistai;2;0;2;0;0;0
293;07.11.2017;2017;11;06;Tiistai;7;1;8;3;0;3
293;07.11.2017;2017;11;07;Tiistai;85;5;90;7;2;9
293;07.11.2017;2017;11;08;Tiistai;72;6;78;5;2;7
293;07.11.2017;2017;11;09;Tiistai;38;8;46;2;0;2
293;07.11.2017;2017;11;10;Tiistai;20;6;26;6;2;8
293;07.11.2017;2017;11;11;Tiistai;11;12;23;4;4;8
293;07.11.2017;2017;11;12;Tiistai;6;7;13;7;6;13
293;07.11.2017;2017;11;13;Tiistai;7;46;53;4;8;12
293;07.11.2017;2017;11;14;Tiistai;11;67;78;2;9;11
293;07.11.2017;2017;11;15;Tiistai;9;72;81;4;10;14
293;07.11.2017;2017;11;16;Tiistai;17;26;43;3;4;7
293;07.11.2017;2017;11;17;Tiistai;15;24;39;12;9;21
293;07.11.2017;2017;11;18;Tiistai;3;19;22;4;6;10
293;07.11.2017;2017;11;19;Tiistai;15;7;22;7;7;14
293;07.11.2017;2017;11;20;Tiistai;3;8;11;1;5;6
293;07.11.2017;2017;11;21;Tiistai;2;5;7;1;1;2
293;07.11.2017;2017;11;22;Tiistai;0;1;1;0;0;0
293;07.11.2017;2017;11;23;Tiistai;0;0;0;0;0;0
293;08.11.2017;2017;11;00;Keskiviikko;1;0;1;0;0;0
293;08.11.2017;2017;11;01;Keskiviikko;0;0;0;0;0;0
293;08.11.2017;2017;11;02;Keskiviikko;0;0;0;0;0;0
293;08.11.2017;2017;11;03;Keskiviikko;0;0;0;0;0;0
293;08.11.2017;2017;11;04;Keskiviikko;1;0;1;0;0;0
293;08.11.2017;2017;11;05;Keskiviikko;3;0;3;0;0;0
293;08.11.2017;2017;11;06;Keskiviikko;6;2;8;4;0;4
293;08.11.2017;2017;11;07;Keskiviikko;92;5;97;3;2;5
293;08.11.2017;2017;11;08;Keskiviikko;88;6;94;9;0;9
293;08.11.2017;2017;11;09;Keskiviikko;11;4;15;4;1;5
293;08.11.2017;2017;11;10;Keskiviikko;4;8;12;6;4;10
293;08.11.2017;2017;11;11;Keskiviikko;8;9;17;1;3;4
293;08.11.2017;2017;11;12;Keskiviikko;8;11;19;4;3;7
293;08.11.2017;2017;11;13;Keskiviikko;16;121;137;4;10;14
293;08.11.2017;2017;11;14;Keskiviikko;10;29;39;3;6;9
293;08.11.2017;2017;11;15;Keskiviikko;8;29;37;4;7;11
293;08.11.2017;2017;11;16;Keskiviikko;23;24;47;11;2;13
293;08.11.2017;2017;11;17;Keskiviikko;10;8;18;4;8;12
293;08.11.2017;2017;11;18;Keskiviikko;12;10;22;8;13;21
293;08.11.2017;2017;11;19;Keskiviikko;6;18;24;2;6;8
293;08.11.2017;2017;11;20;Keskiviikko;0;10;10;1;4;5
293;08.11.2017;2017;11;21;Keskiviikko;1;4;5;2;0;2
293;08.11.2017;2017;11;22;Keskiviikko;0;0;0;0;0;0
293;08.11.2017;2017;11;23;Keskiviikko;0;0;0;0;0;0
293;09.11.2017;2017;11;00;Torstai;0;0;0;1;1;2
293;09.11.2017;2017;11;01;Torstai;0;0;0;0;0;0
293;09.11.2017;2017;11;02;Torstai;0;0;0;0;0;0
293;09.11.2017;2017;11;03;Torstai;0;0;0;0;0;0
293;09.11.2017;2017;11;04;Torstai;1;0;1;0;0;0
293;09.11.2017;2017;11;05;Torstai;1;0;1;1;0;1
293;09.11.2017;2017;11;06;Torstai;6;1;7;2;0;2
293;09.11.2017;2017;11;07;Torstai;84;5;89;3;0;3
293;09.11.2017;2017;11;08;Torstai;82;7;89;7;2;9
293;09.11.2017;2017;11;09;Torstai;20;4;24;2;3;5
293;09.11.2017;2017;11;10;Torstai;15;9;24;3;4;7
293;09.11.2017;2017;11;11;Torstai;9;13;22;4;3;7
293;09.11.2017;2017;11;12;Torstai;10;8;18;5;2;7
293;09.11.2017;2017;11;13;Torstai;2;29;31;4;7;11
293;09.11.2017;2017;11;14;Torstai;11;72;83;2;6;8
293;09.11.2017;2017;11;15;Torstai;14;93;107;3;5;8
293;09.11.2017;2017;11;16;Torstai;15;20;35;2;4;6
293;09.11.2017;2017;11;17;Torstai;22;8;30;3;3;6
293;09.11.2017;2017;11;18;Torstai;5;15;20;6;5;11
293;09.11.2017;2017;11;19;Torstai;3;10;13;9;6;15
293;09.11.2017;2017;11;20;Torstai;6;6;12;0;3;3
293;09.11.2017;2017;11;21;Torstai;0;0;0;0;0;0
293;09.11.2017;2017;11;22;Torstai;0;1;1;0;0;0
293;09.11.2017;2017;11;23;Torstai;0;0;0;0;0;0
293;10.11.2017;2017;11;00;Perjantai;0;0;0;0;0;0
293;10.11.2017;2017;11;01;Perjantai;0;0;0;0;0;0
293;10.11.2017;2017;11;02;Perjantai;1;0;1;0;0;0
293;10.11.2017;2017;11;03;Perjantai;0;0;0;1;0;1
293;10.11.2017;2017;11;04;Perjantai;0;0;0;0;0;0
293;10.11.2017;2017;11;05;Perjantai;1;1;2;0;0;0
293;10.11.2017;2017;11;06;Perjantai;7;2;9;1;0;1
293;10.11.2017;2017;11;07;Perjantai;82;4;86;2;1;3
293;10.11.2017;2017;11;08;Perjantai;60;3;63;8;3;11
293;10.11.2017;2017;11;09;Perjantai;29;9;38;2;2;4
293;10.11.2017;2017;11;10;Perjantai;16;3;19;3;2;5
293;10.11.2017;2017;11;11;Perjantai;10;8;18;1;4;5
293;10.11.2017;2017;11;12;Perjantai;6;11;17;2;1;3
293;10.11.2017;2017;11;13;Perjantai;7;41;48;6;5;11
293;10.11.2017;2017;11;14;Perjantai;13;95;108;4;6;10
293;10.11.2017;2017;11;15;Perjantai;15;40;55;4;8;12
293;10.11.2017;2017;11;16;Perjantai;13;17;30;6;10;16
293;10.11.2017;2017;11;17;Perjantai;14;12;26;4;2;6
293;10.11.2017;2017;11;18;Perjantai;13;18;31;6;9;15
293;10.11.2017;2017;11;19;Perjantai;12;13;25;1;1;2
293;10.11.2017;2017;11;20;Perjantai;9;7;16;7;1;8
293;10.11.2017;2017;11;21;Perjantai;5;10;15;1;2;3
293;10.11.2017;2017;11;22;Perjantai;2;7;9;0;2;2
293;10.11.2017;2017;11;23;Perjantai;0;5;5;1;2;3
293;11.11.2017;2017;11;00;Lauantai;0;7;7;1;2;3
293;11.11.2017;2017;11;01;Lauantai;0;1;1;0;1;1
293;11.11.2017;2017;11;02;Lauantai;0;0;0;1;0;1
293;11.11.2017;2017;11;03;Lauantai;0;0;0;0;0;0
293;11.11.2017;2017;11;04;Lauantai;0;0;0;0;1;1
293;11.11.2017;2017;11;05;Lauantai;0;0;0;0;0;0
293;11.11.2017;2017;11;06;Lauantai;2;0;2;0;0;0
293;11.11.2017;2017;11;07;Lauantai;0;0;0;1;3;4
293;11.11.2017;2017;11;08;Lauantai;3;0;3;2;3;5
293;11.11.2017;2017;11;09;Lauantai;8;2;10;3;7;10
293;11.11.2017;2017;11;10;Lauantai;5;9;14;3;2;5
293;11.11.2017;2017;11;11;Lauantai;12;3;15;7;0;7
293;11.11.2017;2017;11;12;Lauantai;17;13;30;10;9;19
293;11.11.2017;2017;11;13;Lauantai;17;21;38;12;7;19
293;11.11.2017;2017;11;14;Lauantai;14;14;28;9;10;19
293;11.11.2017;2017;11;15;Lauantai;21;17;38;11;11;22
293;11.11.2017;2017;11;16;Lauantai;11;11;22;5;7;12
293;11.11.2017;2017;11;17;Lauantai;11;7;18;4;4;8
293;11.11.2017;2017;11;18;Lauantai;5;17;22;7;3;10
293;11.11.2017;2017;11;19;Lauantai;3;14;17;0;3;3
293;11.11.2017;2017;11;20;Lauantai;0;5;5;1;2;3
293;11.11.2017;2017;11;21;Lauantai;7;5;12;0;0;0
293;11.11.2017;2017;11;22;Lauantai;3;4;7;2;0;2
293;11.11.2017;2017;11;23;Lauantai;1;0;1;2;0;2
293;12.11.2017;2017;11;00;Sunnuntai;1;0;1;0;0;0
293;12.11.2017;2017;11;01;Sunnuntai;1;0;1;1;0;1
293;12.11.2017;2017;11;02;Sunnuntai;0;0;0;0;3;3
293;12.11.2017;2017;11;03;Sunnuntai;1;0;1;0;2;2
293;12.11.2017;2017;11;04;Sunnuntai;0;0;0;0;0;0
293;12.11.2017;2017;11;05;Sunnuntai;0;0;0;0;0;0
293;12.11.2017;2017;11;06;Sunnuntai;2;0;2;1;1;2
293;12.11.2017;2017;11;07;Sunnuntai;0;0;0;0;0;0
293;12.11.2017;2017;11;08;Sunnuntai;1;0;1;2;1;3
293;12.11.2017;2017;11;09;Sunnuntai;3;2;5;2;1;3
293;12.11.2017;2017;11;10;Sunnuntai;8;6;14;8;3;11
293;12.11.2017;2017;11;11;Sunnuntai;11;17;28;4;12;16
293;12.11.2017;2017;11;12;Sunnuntai;9;1;10;5;3;8
293;12.11.2017;2017;11;13;Sunnuntai;10;14;24;6;10;16
293;12.11.2017;2017;11;14;Sunnuntai;4;7;11;3;2;5
293;12.11.2017;2017;11;15;Sunnuntai;8;17;25;3;1;4
293;12.11.2017;2017;11;16;Sunnuntai;5;5;10;8;10;18
293;12.11.2017;2017;11;17;Sunnuntai;13;7;20;0;3;3
293;12.11.2017;2017;11;18;Sunnuntai;8;5;13;4;2;6
293;12.11.2017;2017;11;19;Sunnuntai;4;8;12;6;6;12
293;12.11.2017;2017;11;20;Sunnuntai;8;9;17;0;0;0
293;12.11.2017;2017;11;21;Sunnuntai;2;0;2;0;0;0
293;12.11.2017;2017;11;22;Sunnuntai;0;1;1;1;1;2
293;12.11.2017;2017;11;23;Sunnuntai;0;0;0;0;0;0
293;13.11.2017;2017;11;00;Maanantai;0;0;0;0;0;0
293;13.11.2017;2017;11;01;Maanantai;0;0;0;0;0;0
293;13.11.2017;2017;11;02;Maanantai;0;0;0;0;0;0
293;13.11.2017;2017;11;03;Maanantai;0;0;0;0;0;0
293;13.11.2017;2017;11;04;Maanantai;0;0;0;0;0;0
293;13.11.2017;2017;11;05;Maanantai;2;0;2;0;0;0
293;13.11.2017;2017;11;06;Maanantai;11;3;14;4;0;4
293;13.11.2017;2017;11;07;Maanantai;68;4;72;7;1;8
293;13.11.2017;2017;11;08;Maanantai;88;6;94;11;3;14
293;13.11.2017;2017;11;09;Maanantai;20;0;20;5;2;7
293;13.11.2017;2017;11;10;Maanantai;14;2;16;3;1;4
293;13.11.2017;2017;11;11;Maanantai;7;5;12;2;7;9
293;13.11.2017;2017;11;12;Maanantai;6;9;15;9;3;12
293;13.11.2017;2017;11;13;Maanantai;8;17;25;6;11;17
293;13.11.2017;2017;11;14;Maanantai;5;65;70;6;9;15
293;13.11.2017;2017;11;15;Maanantai;5;98;103;4;13;17
293;13.11.2017;2017;11;16;Maanantai;15;17;32;2;7;9
293;13.11.2017;2017;11;17;Maanantai;4;8;12;8;6;14
293;13.11.2017;2017;11;18;Maanantai;9;11;20;15;7;22
293;13.11.2017;2017;11;19;Maanantai;5;9;14;7;11;18
293;13.11.2017;2017;11;20;Maanantai;3;11;14;0;4;4
293;13.11.2017;2017;11;21;Maanantai;3;4;7;2;0;2
293;13.11.2017;2017;11;22;Maanantai;0;0;0;0;1;1
293;13.11.2017;2017;11;23;Maanantai;0;0;0;0;0;0
293;14.11.2017;2017;11;00;Tiistai;0;0;0;0;0;0
293;14.11.2017;2017;11;01;Tiistai;0;0;0;0;0;0
293;14.11.2017;2017;11;02;Tiistai;0;0;0;0;0;0
293;14.11.2017;2017;11;03;Tiistai;0;1;1;0;0;0
293;14.11.2017;2017;11;04;Tiistai;1;1;2;0;0;0
293;14.11.2017;2017;11;05;Tiistai;2;0;2;0;0;0
293;14.11.2017;2017;11;06;Tiistai;12;1;13;2;0;2
293;14.11.2017;2017;11;07;Tiistai;77;2;79;6;1;7
293;14.11.2017;2017;11;08;Tiistai;78;7;85;6;3;9
293;14.11.2017;2017;11;09;Tiistai;35;3;38;7;3;10
293;14.11.2017;2017;11;10;Tiistai;12;7;19;5;1;6
293;14.11.2017;2017;11;11;Tiistai;4;2;6;1;4;5
293;14.11.2017;2017;11;12;Tiistai;6;7;13;8;2;10
293;14.11.2017;2017;11;13;Tiistai;7;35;42;2;13;15
293;14.11.2017;2017;11;14;Tiistai;8;58;66;1;6;7
293;14.11.2017;2017;11;15;Tiistai;8;88;96;0;11;11
293;14.11.2017;2017;11;16;Tiistai;14;19;33;4;5;9
293;14.11.2017;2017;11;17;Tiistai;10;12;22;5;4;9
293;14.11.2017;2017;11;18;Tiistai;11;13;24;5;5;10
293;14.11.2017;2017;11;19;Tiistai;6;8;14;7;9;16
293;14.11.2017;2017;11;20;Tiistai;3;13;16;3;5;8
293;14.11.2017;2017;11;21;Tiistai;1;0;1;3;4;7
293;14.11.2017;2017;11;22;Tiistai;0;3;3;0;1;1
293;14.11.2017;2017;11;23;Tiistai;0;0;0;1;0;1
293;15.11.2017;2017;11;00;Keskiviikko;1;0;1;0;0;0
293;15.11.2017;2017;11;01;Keskiviikko;0;0;0;0;0;0
293;15.11.2017;2017;11;02;Keskiviikko;0;0;0;0;0;0
293;15.11.2017;2017;11;03;Keskiviikko;0;0;0;0;0;0
293;15.11.2017;2017;11;04;Keskiviikko;1;0;1;0;0;0
293;15.11.2017;2017;11;05;Keskiviikko;3;0;3;0;0;0
293;15.11.2017;2017;11;06;Keskiviikko;6;2;8;4;0;4
293;15.11.2017;2017;11;07;Keskiviikko;83;5;88;3;2;5
293;15.11.2017;2017;11;08;Keskiviikko;80;6;86;9;0;9
293;15.11.2017;2017;11;09;Keskiviikko;10;4;14;4;1;5
293;15.11.2017;2017;11;10;Keskiviikko;4;8;12;6;4;10
293;15.11.2017;2017;11;11;Keskiviikko;8;9;17;1;3;4
293;15.11.2017;2017;11;12;Keskiviikko;8;10;18;4;3;7
293;15.11.2017;2017;11;13;Keskiviikko;14;109;123;4;10;14
293;15.11.2017;2017;11;14;Keskiviikko;10;27;37;3;6;9
293;15.11.2017;2017;11;15;Keskiviikko;8;27;35;4;7;11
293;15.11.2017;2017;11;16;Keskiviikko;21;22;43;11;2;13
293;15.11.2017;2017;11;17;Keskiviikko;10;8;18;4;8;12
293;15.11.2017;2017;11;18;Keskiviikko;10;10;20;8;13;21
293;15.11.2017;2017;11;19;Keskiviikko;6;16;22;2;6;8
293;15.11.2017;2017;11;20;Keskiviikko;0;10;10;1;4;5
293;15.11.2017;2017;11;21;Keskiviikko;1;4;5;2;0;2
293;15.11.2017;2017;11;22;Keskiviikko;0;0;0;0;0;0
293;15.11.2017;2017;11;23;Keskiviikko;0;0;0;0;0;0
293;16.11.2017;2017;11;00;Torstai;0;0;0;2;2;4
293;16.11.2017;2017;11;01;Torstai;0;0;0;0;0;0
293;16.11.2017;2017;11;02;Torstai;0;0;0;0;0;0
293;16.11.2017;2017;11;03;Torstai;0;0;0;0;0;0
293;16.11.2017;2017;11;04;Torstai;1;0;1;0;0;0
293;16.11.2017;2017;11;05;Torstai;1;0;1;2;0;2
293;16.11.2017;2017;11;06;Torstai;6;1;7;3;0;3
293;16.11.2017;2017;11;07;Torstai;80;5;85;5;0;5
293;16.11.2017;2017;11;08;Torstai;78;7;85;9;3;12
293;16.11.2017;2017;11;09;Torstai;20;4;24;3;5;8
293;16.11.2017;2017;11;10;Torstai;15;9;24;5;6;11
293;16.11.2017;2017;11;11;Torstai;9;13;22;6;5;11
293;16.11.2017;2017;11;12;Torstai;10;8;18;7;3;10
293;16.11.2017;2017;11;13;Torstai;2;27;29;6;9;15
293;16.11.2017;2017;11;14;Torstai;11;70;81;3;8;11
293;16.11.2017;2017;11;15;Torstai;14;89;103;5;7;12
293;16.11.2017;2017;11;16;Torstai;15;20;35;3;6;9
293;16.11.2017;2017;11;17;Torstai;22;8;30;5;5;10
293;16.11.2017;2017;11;18;Torstai;5;15;20;8;7;15
293;16.11.2017;2017;11;19;Torstai;3;10;13;11;8;19
293;16.11.2017;2017;11;20;Torstai;6;6;12;0;5;5
293;16.11.2017;2017;11;21;Torstai;0;0;0;0;0;0
293;16.11.2017;2017;11;22;Torstai;0;1;1;0;0;0
293;16.11.2017;2017;11;23;Torstai;0;0;0;0;0;0
293;17.11.2017;2017;11;00;Perjantai;0;0;0;0;0;0
293;17.11.2017;2017;11;01;Perjantai;0;0;0;0;0;0
293;17.11.2017;2017;11;02;Perjantai;0;0;0;0;0;0
293;17.11.2017;2017;11;03;Perjantai;1;0;1;0;1;1
293;17.11.2017;2017;11;04;Perjantai;0;0;0;0;0;0
293;17.11.2017;2017;11;05;Perjantai;1;0;1;0;0;0
293;17.11.2017;2017;11;06;Perjantai;5;2;7;1;0;1
293;17.11.2017;2017;11;07;Perjantai;68;3;71;5;2;7
293;17.11.2017;2017;11;08;Perjantai;65;5;70;7;3;10
293;17.11.2017;2017;11;09;Perjantai;21;3;24;3;0;3
293;17.11.2017;2017;11;10;Perjantai;15;4;19;1;5;6
293;17.11.2017;2017;11;11;Perjantai;8;2;10;4;5;9
293;17.11.2017;2017;11;12;Perjantai;8;11;19;2;2;4
293;17.11.2017;2017;11;13;Perjantai;3;33;36;5;10;15
293;17.11.2017;2017;11;14;Perjantai;8;82;90;4;11;15
293;17.11.2017;2017;11;15;Perjantai;3;45;48;2;6;8
293;17.11.2017;2017;11;16;Perjantai;11;6;17;7;2;9
293;17.11.2017;2017;11;17;Perjantai;21;9;30;10;3;13
293;17.11.2017;2017;11;18;Perjantai;14;16;30;12;10;22
293;17.11.2017;2017;11;19;Perjantai;5;14;19;1;13;14
293;17.11.2017;2017;11;20;Perjantai;4;18;22;1;6;7
293;17.11.2017;2017;11;21;Perjantai;4;8;12;0;2;2
293;17.11.2017;2017;11;22;Perjantai;3;6;9;0;1;1
293;17.11.2017;2017;11;23;Perjantai;0;2;2;1;1;2
293;18.11.2017;2017;11;00;Lauantai;0;1;1;5;0;5
293;18.11.2017;2017;11;01;Lauantai;1;0;1;0;0;0
293;18.11.2017;2017;11;02;Lauantai;1;0;1;0;2;2
293;18.11.2017;2017;11;03;Lauantai;1;0;1;0;2;2
293;18.11.2017;2017;11;04;Lauantai;0;0;0;0;1;1
293;18.11.2017;2017;11;05;Lauantai;0;0;0;0;0;0
293;18.11.2017;2017;11;06;Lauantai;1;0;1;0;0;0
293;18.11.2017;2017;11;07;Lauantai;0;0;0;1;1;2
293;18.11.2017;2017;11;08;Lauantai;2;0;2;3;0;3
293;18.11.2017;2017;11;09;Lauantai;12;2;14;6;2;8
293;18.11.2017;2017;11;10;Lauantai;0;1;1;8;4;12
293;18.11.2017;2017;11;11;Lauantai;4;5;9;11;22;33
293;18.11.2017;2017;11;12;Lauantai;7;14;21;6;4;10
293;18.11.2017;2017;11;13;Lauantai;7;6;13;6;7;13
293;18.11.2017;2017;11;14;Lauantai;7;10;17;5;6;11
293;18.11.2017;2017;11;15;Lauantai;9;10;19;4;9;13
293;18.11.2017;2017;11;16;Lauantai;4;7;11;2;1;3
293;18.11.2017;2017;11;17;Lauantai;8;4;12;5;4;9
293;18.11.2017;2017;11;18;Lauantai;11;9;20;2;8;10
293;18.11.2017;2017;11;19;Lauantai;18;10;28;4;3;7
293;18.11.2017;2017;11;20;Lauantai;5;7;12;2;3;5
293;18.11.2017;2017;11;21;Lauantai;0;19;19;2;3;5
293;18.11.2017;2017;11;22;Lauantai;1;2;3;0;1;1
293;18.11.2017;2017;11;23;Lauantai;3;3;6;1;0;1
293;19.11.2017;2017;11;00;Sunnuntai;0;0;0;0;2;2
293;19.11.2017;2017;11;01;Sunnuntai;2;0;2;0;0;0
293;19.11.2017;2017;11;02;Sunnuntai;1;1;2;0;0;0
293;19.11.2017;2017;11;03;Sunnuntai;0;0;0;0;0;0
293;19.11.2017;2017;11;04;Sunnuntai;0;1;1;1;0;1
293;19.11.2017;2017;11;05;Sunnuntai;0;0;0;0;0;0
293;19.11.2017;2017;11;06;Sunnuntai;1;1;2;2;1;3
293;19.11.2017;2017;11;07;Sunnuntai;0;0;0;0;1;1
293;19.11.2017;2017;11;08;Sunnuntai;1;0;1;3;0;3
293;19.11.2017;2017;11;09;Sunnuntai;1;0;1;4;2;6
293;19.11.2017;2017;11;10;Sunnuntai;6;1;7;6;4;10
293;19.11.2017;2017;11;11;Sunnuntai;8;5;13;5;11;16
293;19.11.2017;2017;11;12;Sunnuntai;2;6;8;5;2;7
293;19.11.2017;2017;11;13;Sunnuntai;11;5;16;9;5;14
293;19.11.2017;2017;11;14;Sunnuntai;9;11;20;6;7;13
293;19.11.2017;2017;11;15;Sunnuntai;17;8;25;3;3;6
293;19.11.2017;2017;11;16;Sunnuntai;11;10;21;4;3;7
293;19.11.2017;2017;11;17;Sunnuntai;7;7;14;5;5;10
293;19.11.2017;2017;11;18;Sunnuntai;4;4;8;4;6;10
293;19.11.2017;2017;11;19;Sunnuntai;3;7;10;2;1;3
293;19.11.2017;2017;11;20;Sunnuntai;3;6;9;3;6;9
293;19.11.2017;2017;11;21;Sunnuntai;0;1;1;1;3;4
293;19.11.2017;2017;11;22;Sunnuntai;0;0;0;0;0;0
293;19.11.2017;2017;11;23;Sunnuntai;0;0;0;0;0;0
293;20.11.2017;2017;11;00;Maanantai;1;1;2;0;1;1
293;20.11.2017;2017;11;01;Maanantai;0;0;0;0;0;0
293;20.11.2017;2017;11;02;Maanantai;0;0;0;0;0;0
293;20.11.2017;2017;11;03;Maanantai;0;0;0;0;0;0
293;20.11.2017;2017;11;04;Maanantai;1;0;1;0;0;0
293;20.11.2017;2017;11;05;Maanantai;0;0;0;1;0;1
293;20.11.2017;2017;11;06;Maanantai;7;1;8;1;0;1
293;20.11.2017;2017;11;07;Maanantai;48;3;51;6;0;6
293;20.11.2017;2017;11;08;Maanantai;105;7;112;18;5;23
293;20.11.2017;2017;11;09;Maanantai;25;3;28;3;1;4
293;20.11.2017;2017;11;10;Maanantai;12;7;19;3;8;11
293;20.11.2017;2017;11;11;Maanantai;0;3;3;10;5;15
293;20.11.2017;2017;11;12;Maanantai;5;13;18;2;5;7
293;20.11.2017;2017;11;13;Maanantai;6;25;31;5;5;10
293;20.11.2017;2017;11;14;Maanantai;5;41;46;6;13;19
293;20.11.2017;2017;11;15;Maanantai;9;100;109;2;15;17
293;20.11.2017;2017;11;16;Maanantai;6;15;21;4;5;9
293;20.11.2017;2017;11;17;Maanantai;4;2;6;6;10;16
293;20.11.2017;2017;11;18;Maanantai;7;8;15;7;3;10
293;20.11.2017;2017;11;19;Maanantai;8;8;16;2;6;8
293;20.11.2017;2017;11;20;Maanantai;0;8;8;2;3;5
293;20.11.2017;2017;11;21;Maanantai;0;7;7;4;3;7
293;20.11.2017;2017;11;22;Maanantai;0;0;0;0;0;0
293;20.11.2017;2017;11;23;Maanantai;0;0;0;0;0;0
293;21.11.2017;2017;11;00;Tiistai;0;0;0;0;0;0
293;21.11.2017;2017;11;01;Tiistai;0;0;0;0;0;0
293;21.11.2017;2017;11;02;Tiistai;0;0;0;0;0;0
293;21.11.2017;2017;11;03;Tiistai;1;0;1;0;0;0
293;21.11.2017;2017;11;04;Tiistai;0;0;0;0;0;0
293;21.11.2017;2017;11;05;Tiistai;2;0;2;0;0;0
293;21.11.2017;2017;11;06;Tiistai;6;2;8;3;0;3
293;21.11.2017;2017;11;07;Tiistai;53;3;56;4;0;4
293;21.11.2017;2017;11;08;Tiistai;84;7;91;4;2;6
293;21.11.2017;2017;11;09;Tiistai;26;6;32;4;1;5
293;21.11.2017;2017;11;10;Tiistai;10;4;14;3;3;6
293;21.11.2017;2017;11;11;Tiistai;3;7;10;6;8;14
293;21.11.2017;2017;11;12;Tiistai;10;7;17;9;3;12
293;21.11.2017;2017;11;13;Tiistai;3;44;47;8;10;18
293;21.11.2017;2017;11;14;Tiistai;6;57;63;2;10;12
293;21.11.2017;2017;11;15;Tiistai;7;53;60;0;9;9
293;21.11.2017;2017;11;16;Tiistai;12;16;28;3;5;8
293;21.11.2017;2017;11;17;Tiistai;6;12;18;7;5;12
293;21.11.2017;2017;11;18;Tiistai;9;7;16;5;5;10
293;21.11.2017;2017;11;19;Tiistai;5;7;12;4;2;6
293;21.11.2017;2017;11;20;Tiistai;2;9;11;3;4;7
293;21.11.2017;2017;11;21;Tiistai;2;3;5;3;2;5
293;21.11.2017;2017;11;22;Tiistai;0;0;0;0;0;0
293;21.11.2017;2017;11;23;Tiistai;0;0;0;1;1;2
293;22.11.2017;2017;11;00;Keskiviikko;0;0;0;0;1;1
293;22.11.2017;2017;11;01;Keskiviikko;0;0;0;0;0;0
293;22.11.2017;2017;11;02;Keskiviikko;0;0;0;0;0;0
293;22.11.2017;2017;11;03;Keskiviikko;1;0;1;0;0;0
293;22.11.2017;2017;11;04;Keskiviikko;0;0;0;0;0;0
293;22.11.2017;2017;11;05;Keskiviikko;2;0;2;0;0;0
293;22.11.2017;2017;11;06;Keskiviikko;9;1;10;2;0;2
293;22.11.2017;2017;11;07;Keskiviikko;55;2;57;5;2;7
293;22.11.2017;2017;11;08;Keskiviikko;113;7;120;12;1;13
293;22.11.2017;2017;11;09;Keskiviikko;12;2;14;3;1;4
293;22.11.2017;2017;11;10;Keskiviikko;5;5;10;5;1;6
293;22.11.2017;2017;11;11;Keskiviikko;0;7;7;4;4;8
293;22.11.2017;2017;11;12;Keskiviikko;1;12;13;8;7;15
293;22.11.2017;2017;11;13;Keskiviikko;3;42;45;4;4;8
293;22.11.2017;2017;11;14;Keskiviikko;10;89;99;1;15;16
293;22.11.2017;2017;11;15;Keskiviikko;2;25;27;7;6;13
293;22.11.2017;2017;11;16;Keskiviikko;8;12;20;6;5;11
293;22.11.2017;2017;11;17;Keskiviikko;6;8;14;2;5;7
293;22.11.2017;2017;11;18;Keskiviikko;7;6;13;3;7;10
293;22.11.2017;2017;11;19;Keskiviikko;5;2;7;4;5;9
293;22.11.2017;2017;11;20;Keskiviikko;3;14;17;4;4;8
293;22.11.2017;2017;11;21;Keskiviikko;2;1;3;0;3;3
293;22.11.2017;2017;11;22;Keskiviikko;0;0;0;0;0;0
293;22.11.2017;2017;11;23;Keskiviikko;0;0;0;0;0;0
293;23.11.2017;2017;11;00;Torstai;0;0;0;0;0;0
293;23.11.2017;2017;11;01;Torstai;0;0;0;0;0;0
293;23.11.2017;2017;11;02;Torstai;0;0;0;0;0;0
293;23.11.2017;2017;11;03;Torstai;1;0;1;0;0;0
293;23.11.2017;2017;11;04;Torstai;1;0;1;0;0;0
293;23.11.2017;2017;11;05;Torstai;0;0;0;1;1;2
293;23.11.2017;2017;11;06;Torstai;8;1;9;2;0;2
293;23.11.2017;2017;11;07;Torstai;63;1;64;4;4;8
293;23.11.2017;2017;11;08;Torstai;89;10;99;6;4;10
293;23.11.2017;2017;11;09;Torstai;15;2;17;2;1;3
293;23.11.2017;2017;11;10;Torstai;8;5;13;5;5;10
293;23.11.2017;2017;11;11;Torstai;3;7;10;3;2;5
293;23.11.2017;2017;11;12;Torstai;7;10;17;4;8;12
293;23.11.2017;2017;11;13;Torstai;3;27;30;1;8;9
293;23.11.2017;2017;11;14;Torstai;8;65;73;2;10;12
293;23.11.2017;2017;11;15;Torstai;4;50;54;2;13;15
293;23.11.2017;2017;11;16;Torstai;5;14;19;2;4;6
293;23.11.2017;2017;11;17;Torstai;6;3;9;2;2;4
293;23.11.2017;2017;11;18;Torstai;3;5;8;3;4;7
293;23.11.2017;2017;11;19;Torstai;1;7;8;3;4;7
293;23.11.2017;2017;11;20;Torstai;6;0;6;3;2;5
293;23.11.2017;2017;11;21;Torstai;1;0;1;0;0;0
293;23.11.2017;2017;11;22;Torstai;0;0;0;0;0;0
293;23.11.2017;2017;11;23;Torstai;0;0;0;0;0;0
293;24.11.2017;2017;11;00;Perjantai;0;0;0;0;0;0
293;24.11.2017;2017;11;01;Perjantai;0;0;0;0;0;0
293;24.11.2017;2017;11;02;Perjantai;0;0;0;0;0;0
293;24.11.2017;2017;11;03;Perjantai;1;0;1;0;0;0
293;24.11.2017;2017;11;04;Perjantai;0;0;0;0;0;0
293;24.11.2017;2017;11;05;Perjantai;1;0;1;0;0;0
293;24.11.2017;2017;11;06;Perjantai;2;1;3;0;0;0
293;24.11.2017;2017;11;07;Perjantai;27;27;54;0;0;0
293;24.11.2017;2017;11;08;Perjantai;29;29;58;0;0;0
293;24.11.2017;2017;11;09;Perjantai;7;6;13;0;0;0
293;24.11.2017;2017;11;10;Perjantai;5;4;9;0;0;0
293;24.11.2017;2017;11;11;Perjantai;2;8;10;0;1;1
293;24.11.2017;2017;11;12;Perjantai;2;16;18;1;3;4
293;24.11.2017;2017;11;13;Perjantai;1;26;27;1;11;12
293;24.11.2017;2017;11;14;Perjantai;5;45;50;4;14;18
293;24.11.2017;2017;11;15;Perjantai;6;29;35;1;17;18
293;24.11.2017;2017;11;16;Perjantai;5;13;18;2;5;7
293;24.11.2017;2017;11;17;Perjantai;11;9;20;3;1;4
293;24.11.2017;2017;11;18;Perjantai;8;9;17;6;6;12
293;24.11.2017;2017;11;19;Perjantai;3;1;4;0;8;8
293;24.11.2017;2017;11;20;Perjantai;12;6;18;6;7;13
293;24.11.2017;2017;11;21;Perjantai;2;6;8;2;6;8
293;24.11.2017;2017;11;22;Perjantai;5;2;7;3;0;3
293;24.11.2017;2017;11;23;Perjantai;1;1;2;0;2;2
293;25.11.2017;2017;11;00;Lauantai;0;1;1;0;0;0
293;25.11.2017;2017;11;01;Lauantai;0;0;0;0;0;0
293;25.11.2017;2017;11;02;Lauantai;0;0;0;0;0;0
293;25.11.2017;2017;11;03;Lauantai;0;0;0;0;1;1
293;25.11.2017;2017;11;04;Lauantai;0;0;0;0;0;0
293;25.11.2017;2017;11;05;Lauantai;0;0;0;0;0;0
293;25.11.2017;2017;11;06;Lauantai;0;0;0;1;0;1
293;25.11.2017;2017;11;07;Lauantai;1;0;1;0;0;0
293;25.11.2017;2017;11;08;Lauantai;1;1;2;1;2;3
293;25.11.2017;2017;11;09;Lauantai;2;0;2;6;2;8
293;25.11.2017;2017;11;10;Lauantai;4;1;5;9;7;16
293;25.11.2017;2017;11;11;Lauantai;3;4;7;4;5;9
293;25.11.2017;2017;11;12;Lauantai;2;0;2;6;7;13
293;25.11.2017;2017;11;13;Lauantai;2;6;8;6;1;7
293;25.11.2017;2017;11;14;Lauantai;4;2;6;5;8;13
293;25.11.2017;2017;11;15;Lauantai;10;3;13;5;6;11
293;25.11.2017;2017;11;16;Lauantai;3;8;11;17;6;23
293;25.11.2017;2017;11;17;Lauantai;3;7;10;3;8;11
293;25.11.2017;2017;11;18;Lauantai;3;3;6;3;7;10
293;25.11.2017;2017;11;19;Lauantai;3;4;7;5;3;8
293;25.11.2017;2017;11;20;Lauantai;1;6;7;0;5;5
293;25.11.2017;2017;11;21;Lauantai;2;1;3;0;1;1
293;25.11.2017;2017;11;22;Lauantai;0;0;0;0;1;1
293;25.11.2017;2017;11;23;Lauantai;2;1;3;2;0;2
293;26.11.2017;2017;11;00;Sunnuntai;1;1;2;1;0;1
293;26.11.2017;2017;11;01;Sunnuntai;0;2;2;4;1;5
293;26.11.2017;2017;11;02;Sunnuntai;0;0;0;0;1;1
293;26.11.2017;2017;11;03;Sunnuntai;0;0;0;0;0;0
293;26.11.2017;2017;11;04;Sunnuntai;0;0;0;0;0;0
293;26.11.2017;2017;11;05;Sunnuntai;0;0;0;0;0;0
293;26.11.2017;2017;11;06;Sunnuntai;1;0;1;0;0;0
293;26.11.2017;2017;11;07;Sunnuntai;0;0;0;1;1;2
293;26.11.2017;2017;11;08;Sunnuntai;0;0;0;0;0;0
293;26.11.2017;2017;11;09;Sunnuntai;0;0;0;5;7;12
293;26.11.2017;2017;11;10;Sunnuntai;8;7;15;7;3;10
293;26.11.2017;2017;11;11;Sunnuntai;7;1;8;13;8;21
293;26.11.2017;2017;11;12;Sunnuntai;7;13;20;7;10;17
293;26.11.2017;2017;11;13;Sunnuntai;5;1;6;5;1;6
293;26.11.2017;2017;11;14;Sunnuntai;3;6;9;2;4;6
293;26.11.2017;2017;11;15;Sunnuntai;6;6;12;2;1;3
293;26.11.2017;2017;11;16;Sunnuntai;6;3;9;5;4;9
293;26.11.2017;2017;11;17;Sunnuntai;9;9;18;4;4;8
293;26.11.2017;2017;11;18;Sunnuntai;8;3;11;4;6;10
293;26.11.2017;2017;11;19;Sunnuntai;1;3;4;1;3;4
293;26.11.2017;2017;11;20;Sunnuntai;2;10;12;1;3;4
293;26.11.2017;2017;11;21;Sunnuntai;1;1;2;1;1;2
293;26.11.2017;2017;11;22;Sunnuntai;0;0;0;0;0;0
293;26.11.2017;2017;11;23;Sunnuntai;1;0;1;0;0;0
293;27.11.2017;2017;11;00;Maanantai;0;0;0;0;0;0
293;27.11.2017;2017;11;01;Maanantai;0;1;1;0;0;0
293;27.11.2017;2017;11;02;Maanantai;0;0;0;0;1;1
293;27.11.2017;2017;11;03;Maanantai;0;1;1;0;0;0
293;27.11.2017;2017;11;04;Maanantai;0;0;0;0;0;0
293;27.11.2017;2017;11;05;Maanantai;1;0;1;0;0;0
293;27.11.2017;2017;11;06;Maanantai;8;1;9;3;0;3
293;27.11.2017;2017;11;07;Maanantai;47;3;50;3;1;4
293;27.11.2017;2017;11;08;Maanantai;107;6;113;9;2;11
293;27.11.2017;2017;11;09;Maanantai;26;2;28;2;2;4
293;27.11.2017;2017;11;10;Maanantai;7;7;14;2;1;3
293;27.11.2017;2017;11;11;Maanantai;8;10;18;4;4;8
293;27.11.2017;2017;11;12;Maanantai;7;14;21;4;7;11
293;27.11.2017;2017;11;13;Maanantai;4;24;28;5;6;11
293;27.11.2017;2017;11;14;Maanantai;2;47;49;4;10;14
293;27.11.2017;2017;11;15;Maanantai;10;101;111;1;12;13
293;27.11.2017;2017;11;16;Maanantai;0;15;15;4;6;10
293;27.11.2017;2017;11;17;Maanantai;2;5;7;8;6;14
293;27.11.2017;2017;11;18;Maanantai;6;4;10;7;8;15
293;27.11.2017;2017;11;19;Maanantai;8;7;15;2;4;6
293;27.11.2017;2017;11;20;Maanantai;2;2;4;0;6;6
293;27.11.2017;2017;11;21;Maanantai;2;5;7;0;0;0
293;27.11.2017;2017;11;22;Maanantai;0;0;0;0;0;0
293;27.11.2017;2017;11;23;Maanantai;0;0;0;0;0;0
293;28.11.2017;2017;11;00;Tiistai;0;0;0;0;0;0
293;28.11.2017;2017;11;01;Tiistai;0;0;0;0;0;0
293;28.11.2017;2017;11;02;Tiistai;0;0;0;0;0;0
293;28.11.2017;2017;11;03;Tiistai;1;1;2;0;0;0
293;28.11.2017;2017;11;04;Tiistai;0;0;0;0;0;0
293;28.11.2017;2017;11;05;Tiistai;0;0;0;1;0;1
293;28.11.2017;2017;11;06;Tiistai;6;2;8;4;0;4
293;28.11.2017;2017;11;07;Tiistai;47;1;48;9;3;12
293;28.11.2017;2017;11;08;Tiistai;95;5;100;12;3;15
293;28.11.2017;2017;11;09;Tiistai;19;1;20;4;2;6
293;28.11.2017;2017;11;10;Tiistai;17;4;21;5;7;12
293;28.11.2017;2017;11;11;Tiistai;3;9;12;7;4;11
293;28.11.2017;2017;11;12;Tiistai;4;13;17;3;5;8
293;28.11.2017;2017;11;13;Tiistai;3;45;48;4;9;13
293;28.11.2017;2017;11;14;Tiistai;4;56;60;3;8;11
293;28.11.2017;2017;11;15;Tiistai;3;48;51;3;9;12
293;28.11.2017;2017;11;16;Tiistai;7;20;27;2;8;10
293;28.11.2017;2017;11;17;Tiistai;11;10;21;8;8;16
293;28.11.2017;2017;11;18;Tiistai;5;8;13;4;4;8
293;28.11.2017;2017;11;19;Tiistai;7;12;19;2;5;7
293;28.11.2017;2017;11;20;Tiistai;3;6;9;2;3;5
293;28.11.2017;2017;11;21;Tiistai;5;3;8;4;3;7
293;28.11.2017;2017;11;22;Tiistai;0;1;1;1;1;2
293;28.11.2017;2017;11;23;Tiistai;0;0;0;1;1;2
293;29.11.2017;2017;11;00;Keskiviikko;0;0;0;0;0;0
293;29.11.2017;2017;11;01;Keskiviikko;0;0;0;0;0;0
293;29.11.2017;2017;11;02;Keskiviikko;0;0;0;0;0;0
293;29.11.2017;2017;11;03;Keskiviikko;1;1;2;0;1;1
293;29.11.2017;2017;11;04;Keskiviikko;1;0;1;0;0;0
293;29.11.2017;2017;11;05;Keskiviikko;1;0;1;0;0;0
293;29.11.2017;2017;11;06;Keskiviikko;8;2;10;1;0;1
293;29.11.2017;2017;11;07;Keskiviikko;108;2;110;13;2;15
293;29.11.2017;2017;11;08;Keskiviikko;48;3;51;7;1;8
293;29.11.2017;2017;11;09;Keskiviikko;14;1;15;10;1;11
293;29.11.2017;2017;11;10;Keskiviikko;4;1;5;3;4;7
293;29.11.2017;2017;11;11;Keskiviikko;2;1;3;4;8;12
293;29.11.2017;2017;11;12;Keskiviikko;4;8;12;4;3;7
293;29.11.2017;2017;11;13;Keskiviikko;6;31;37;3;13;16
293;29.11.2017;2017;11;14;Keskiviikko;4;60;64;4;7;11
293;29.11.2017;2017;11;15;Keskiviikko;7;73;80;6;15;21
293;29.11.2017;2017;11;16;Keskiviikko;6;13;19;7;7;14
293;29.11.2017;2017;11;17;Keskiviikko;7;11;18;3;7;10
293;29.11.2017;2017;11;18;Keskiviikko;8;9;17;4;4;8
293;29.11.2017;2017;11;19;Keskiviikko;4;10;14;3;8;11
293;29.11.2017;2017;11;20;Keskiviikko;1;5;6;2;1;3
293;29.11.2017;2017;11;21;Keskiviikko;1;2;3;3;1;4
293;29.11.2017;2017;11;22;Keskiviikko;0;0;0;2;1;3
293;29.11.2017;2017;11;23;Keskiviikko;0;0;0;0;1;1
293;30.11.2017;2017;11;00;Torstai;0;0;0;0;0;0
293;30.11.2017;2017;11;01;Torstai;0;0;0;0;0;0
293;30.11.2017;2017;11;02;Torstai;0;0;0;0;0;0
293;30.11.2017;2017;11;03;Torstai;1;0;1;0;0;0
293;30.11.2017;2017;11;04;Torstai;0;0;0;0;0;0
293;30.11.2017;2017;11;05;Torstai;1;0;1;0;0;0
293;30.11.2017;2017;11;06;Torstai;6;1;7;1;0;1
293;30.11.2017;2017;11;07;Torstai;103;2;105;17;3;20
293;30.11.2017;2017;11;08;Torstai;57;6;63;9;6;15
293;30.11.2017;2017;11;09;Torstai;13;5;18;6;2;8
293;30.11.2017;2017;11;10;Torstai;5;3;8;2;2;4
293;30.11.2017;2017;11;11;Torstai;3;2;5;5;4;9
293;30.11.2017;2017;11;12;Torstai;6;4;10;8;1;9
293;30.11.2017;2017;11;13;Torstai;2;25;27;6;13;19
293;30.11.2017;2017;11;14;Torstai;8;57;65;2;11;13
293;30.11.2017;2017;11;15;Torstai;3;78;81;3;17;20
293;30.11.2017;2017;11;16;Torstai;6;15;21;3;2;5
293;30.11.2017;2017;11;17;Torstai;4;7;11;12;4;16
293;30.11.2017;2017;11;18;Torstai;6;6;12;3;6;9
293;30.11.2017;2017;11;19;Torstai;3;4;7;3;7;10
293;30.11.2017;2017;11;20;Torstai;8;6;14;5;5;10
293;30.11.2017;2017;11;21;Torstai;1;2;3;0;2;2
293;30.11.2017;2017;11;22;Torstai;0;0;0;1;0;1
293;30.11.2017;2017;11;23;Torstai;0;0;0;0;0;0
293;01.12.2017;2017;12;00;Perjantai;0;0;0;0;0;0
293;01.12.2017;2017;12;01;Perjantai;0;0;0;0;0;0
293;01.12.2017;2017;12;02;Perjantai;0;0;0;0;0;0
293;01.12.2017;2017;12;03;Perjantai;1;1;2;0;0;0
293;01.12.2017;2017;12;04;Perjantai;0;0;0;0;0;0
293;01.12.2017;2017;12;05;Perjantai;1;0;1;0;1;1
293;01.12.2017;2017;12;06;Perjantai;3;1;4;2;0;2
293;01.12.2017;2017;12;07;Perjantai;93;5;98;4;1;5
293;01.12.2017;2017;12;08;Perjantai;64;4;68;16;1;17
293;01.12.2017;2017;12;09;Perjantai;22;2;24;4;1;5
293;01.12.2017;2017;12;10;Perjantai;10;6;16;2;2;4
293;01.12.2017;2017;12;11;Perjantai;3;3;6;4;3;7
293;01.12.2017;2017;12;12;Perjantai;8;17;25;6;6;12
293;01.12.2017;2017;12;13;Perjantai;7;56;63;1;9;10
293;01.12.2017;2017;12;14;Perjantai;6;81;87;4;10;14
293;01.12.2017;2017;12;15;Perjantai;7;20;27;4;3;7
293;01.12.2017;2017;12;16;Perjantai;7;14;21;9;9;18
293;01.12.2017;2017;12;17;Perjantai;5;8;13;6;6;12
293;01.12.2017;2017;12;18;Perjantai;7;6;13;2;7;9
293;01.12.2017;2017;12;19;Perjantai;5;4;9;2;2;4
293;01.12.2017;2017;12;20;Perjantai;2;10;12;3;1;4
293;01.12.2017;2017;12;21;Perjantai;5;3;8;1;5;6
293;01.12.2017;2017;12;22;Perjantai;1;4;5;2;0;2
293;01.12.2017;2017;12;23;Perjantai;0;0;0;0;1;1
293;02.12.2017;2017;12;00;Lauantai;0;0;0;0;1;1
293;02.12.2017;2017;12;01;Lauantai;0;0;0;0;0;0
293;02.12.2017;2017;12;02;Lauantai;0;0;0;0;0;0
293;02.12.2017;2017;12;03;Lauantai;0;0;0;0;0;0
293;02.12.2017;2017;12;04;Lauantai;0;0;0;0;2;2
293;02.12.2017;2017;12;05;Lauantai;0;0;0;0;1;1
293;02.12.2017;2017;12;06;Lauantai;1;0;1;0;0;0
293;02.12.2017;2017;12;07;Lauantai;15;0;15;1;0;1
293;02.12.2017;2017;12;08;Lauantai;47;1;48;9;1;10
293;02.12.2017;2017;12;09;Lauantai;3;3;6;10;3;13
293;02.12.2017;2017;12;10;Lauantai;7;3;10;10;6;16
293;02.12.2017;2017;12;11;Lauantai;2;3;5;12;29;41
293;02.12.2017;2017;12;12;Lauantai;1;10;11;4;9;13
293;02.12.2017;2017;12;13;Lauantai;4;41;45;5;11;16
293;02.12.2017;2017;12;14;Lauantai;7;10;17;2;7;9
293;02.12.2017;2017;12;15;Lauantai;9;12;21;3;4;7
293;02.12.2017;2017;12;16;Lauantai;4;2;6;1;1;2
293;02.12.2017;2017;12;17;Lauantai;3;5;8;4;3;7
293;02.12.2017;2017;12;18;Lauantai;4;5;9;1;2;3
293;02.12.2017;2017;12;19;Lauantai;2;3;5;3;4;7
293;02.12.2017;2017;12;20;Lauantai;0;6;6;2;4;6
293;02.12.2017;2017;12;21;Lauantai;4;6;10;0;2;2
293;02.12.2017;2017;12;22;Lauantai;2;2;4;3;1;4
293;02.12.2017;2017;12;23;Lauantai;5;1;6;1;1;2
293;03.12.2017;2017;12;00;Sunnuntai;0;0;0;0;0;0
293;03.12.2017;2017;12;01;Sunnuntai;1;0;1;0;1;1
293;03.12.2017;2017;12;02;Sunnuntai;0;1;1;0;0;0
293;03.12.2017;2017;12;03;Sunnuntai;0;1;1;0;1;1
293;03.12.2017;2017;12;04;Sunnuntai;0;0;0;0;0;0
293;03.12.2017;2017;12;05;Sunnuntai;0;0;0;0;0;0
293;03.12.2017;2017;12;06;Sunnuntai;2;1;3;2;0;2
293;03.12.2017;2017;12;07;Sunnuntai;0;1;1;0;0;0
293;03.12.2017;2017;12;08;Sunnuntai;0;0;0;0;1;1
293;03.12.2017;2017;12;09;Sunnuntai;4;1;5;1;0;1
293;03.12.2017;2017;12;10;Sunnuntai;3;1;4;1;3;4
293;03.12.2017;2017;12;11;Sunnuntai;3;2;5;3;4;7
293;03.12.2017;2017;12;12;Sunnuntai;6;4;10;6;0;6
293;03.12.2017;2017;12;13;Sunnuntai;5;2;7;5;9;14
293;03.12.2017;2017;12;14;Sunnuntai;0;4;4;5;5;10
293;03.12.2017;2017;12;15;Sunnuntai;7;5;12;5;1;6
293;03.12.2017;2017;12;16;Sunnuntai;8;4;12;1;5;6
293;03.12.2017;2017;12;17;Sunnuntai;5;2;7;3;4;7
293;03.12.2017;2017;12;18;Sunnuntai;8;7;15;4;1;5
293;03.12.2017;2017;12;19;Sunnuntai;5;7;12;8;4;12
293;03.12.2017;2017;12;20;Sunnuntai;2;5;7;0;5;5
293;03.12.2017;2017;12;21;Sunnuntai;6;2;8;0;0;0
293;03.12.2017;2017;12;22;Sunnuntai;0;1;1;1;0;1
293;03.12.2017;2017;12;23;Sunnuntai;0;0;0;0;1;1
293;04.12.2017;2017;12;00;Maanantai;0;0;0;0;0;0
293;04.12.2017;2017;12;01;Maanantai;0;0;0;0;0;0
293;04.12.2017;2017;12;02;Maanantai;0;0;0;0;0;0
293;04.12.2017;2017;12;03;Maanantai;1;0;1;0;0;0
293;04.12.2017;2017;12;04;Maanantai;0;0;0;0;0;0
293;04.12.2017;2017;12;05;Maanantai;1;0;1;0;0;0
293;04.12.2017;2017;12;06;Maanantai;7;1;8;4;0;4
293;04.12.2017;2017;12;07;Maanantai;44;4;48;3;0;3
293;04.12.2017;2017;12;08;Maanantai;102;6;108;12;2;14
293;04.12.2017;2017;12;09;Maanantai;21;3;24;3;2;5
293;04.12.2017;2017;12;10;Maanantai;4;5;9;2;3;5
293;04.12.2017;2017;12;11;Maanantai;1;2;3;0;7;7
293;04.12.2017;2017;12;12;Maanantai;5;38;43;2;8;10
293;04.12.2017;2017;12;13;Maanantai;4;75;79;4;20;24
293;04.12.2017;2017;12;14;Maanantai;8;31;39;5;14;19
293;04.12.2017;2017;12;15;Maanantai;6;15;21;3;8;11
293;04.12.2017;2017;12;16;Maanantai;3;14;17;6;7;13
293;04.12.2017;2017;12;17;Maanantai;5;4;9;4;8;12
293;04.12.2017;2017;12;18;Maanantai;4;9;13;3;6;9
293;04.12.2017;2017;12;19;Maanantai;2;6;8;5;5;10
293;04.12.2017;2017;12;20;Maanantai;3;3;6;0;4;4
293;04.12.2017;2017;12;21;Maanantai;0;0;0;1;1;2
293;04.12.2017;2017;12;22;Maanantai;0;0;0;0;0;0
293;04.12.2017;2017;12;23;Maanantai;0;0;0;0;0;0
293;05.12.2017;2017;12;00;Tiistai;0;0;0;0;0;0
293;05.12.2017;2017;12;01;Tiistai;0;0;0;0;0;0
293;05.12.2017;2017;12;02;Tiistai;0;0;0;0;0;0
293;05.12.2017;2017;12;03;Tiistai;1;0;1;0;1;1
293;05.12.2017;2017;12;04;Tiistai;0;0;0;0;0;0
293;05.12.2017;2017;12;05;Tiistai;1;0;1;0;0;0
293;05.12.2017;2017;12;06;Tiistai;3;0;3;2;0;2
293;05.12.2017;2017;12;07;Tiistai;37;2;39;6;1;7
293;05.12.2017;2017;12;08;Tiistai;92;5;97;13;4;17
293;05.12.2017;2017;12;09;Tiistai;17;2;19;4;3;7
293;05.12.2017;2017;12;10;Tiistai;4;5;9;2;2;4
293;05.12.2017;2017;12;11;Tiistai;4;9;13;2;3;5
293;05.12.2017;2017;12;12;Tiistai;5;4;9;4;5;9
293;05.12.2017;2017;12;13;Tiistai;2;105;107;9;23;32
293;05.12.2017;2017;12;14;Tiistai;8;11;19;4;14;18
293;05.12.2017;2017;12;15;Tiistai;2;8;10;1;7;8
293;05.12.2017;2017;12;16;Tiistai;3;19;22;5;7;12
293;05.12.2017;2017;12;17;Tiistai;2;1;3;3;4;7
293;05.12.2017;2017;12;18;Tiistai;6;3;9;9;7;16
293;05.12.2017;2017;12;19;Tiistai;11;6;17;3;3;6
293;05.12.2017;2017;12;20;Tiistai;5;11;16;3;5;8
293;05.12.2017;2017;12;21;Tiistai;3;9;12;0;3;3
293;05.12.2017;2017;12;22;Tiistai;3;3;6;1;1;2
293;05.12.2017;2017;12;23;Tiistai;2;2;4;1;0;1
293;06.12.2017;2017;12;00;Keskiviikko;3;0;3;1;0;1
293;06.12.2017;2017;12;01;Keskiviikko;0;0;0;0;0;0
293;06.12.2017;2017;12;02;Keskiviikko;0;1;1;0;1;1
293;06.12.2017;2017;12;03;Keskiviikko;1;0;1;0;4;4
293;06.12.2017;2017;12;04;Keskiviikko;0;0;0;0;0;0
293;06.12.2017;2017;12;05;Keskiviikko;0;0;0;0;0;0
293;06.12.2017;2017;12;06;Keskiviikko;0;0;0;0;0;0
293;06.12.2017;2017;12;07;Keskiviikko;1;0;1;3;1;4
293;06.12.2017;2017;12;08;Keskiviikko;0;0;0;1;4;5
293;06.12.2017;2017;12;09;Keskiviikko;2;1;3;4;3;7
293;06.12.2017;2017;12;10;Keskiviikko;7;3;10;13;10;23
293;06.12.2017;2017;12;11;Keskiviikko;1;4;5;9;9;18
293;06.12.2017;2017;12;12;Keskiviikko;2;3;5;5;10;15
293;06.12.2017;2017;12;13;Keskiviikko;2;1;3;9;10;19
293;06.12.2017;2017;12;14;Keskiviikko;3;4;7;7;7;14
293;06.12.2017;2017;12;15;Keskiviikko;0;2;2;9;2;11
293;06.12.2017;2017;12;16;Keskiviikko;5;1;6;6;9;15
293;06.12.2017;2017;12;17;Keskiviikko;7;3;10;1;4;5
293;06.12.2017;2017;12;18;Keskiviikko;2;7;9;3;2;5
293;06.12.2017;2017;12;19;Keskiviikko;3;2;5;0;2;2
293;06.12.2017;2017;12;20;Keskiviikko;2;3;5;0;0;0
293;06.12.2017;2017;12;21;Keskiviikko;0;0;0;0;1;1
293;06.12.2017;2017;12;22;Keskiviikko;0;0;0;0;0;0
293;06.12.2017;2017;12;23;Keskiviikko;0;0;0;0;0;0
293;07.12.2017;2017;12;00;Torstai;0;0;0;0;0;0
293;07.12.2017;2017;12;01;Torstai;0;0;0;0;0;0
293;07.12.2017;2017;12;02;Torstai;0;0;0;0;0;0
293;07.12.2017;2017;12;03;Torstai;1;0;1;0;0;0
293;07.12.2017;2017;12;04;Torstai;0;0;0;0;0;0
293;07.12.2017;2017;12;05;Torstai;1;0;1;1;1;2
293;07.12.2017;2017;12;06;Torstai;4;2;6;2;0;2
293;07.12.2017;2017;12;07;Torstai;79;3;82;11;0;11
293;07.12.2017;2017;12;08;Torstai;75;3;78;13;4;17
293;07.12.2017;2017;12;09;Torstai;14;7;21;4;5;9
293;07.12.2017;2017;12;10;Torstai;5;4;9;4;1;5
293;07.12.2017;2017;12;11;Torstai;7;4;11;2;4;6
293;07.12.2017;2017;12;12;Torstai;8;3;11;7;5;12
293;07.12.2017;2017;12;13;Torstai;4;19;23;5;12;17
293;07.12.2017;2017;12;14;Torstai;5;57;62;10;14;24
293;07.12.2017;2017;12;15;Torstai;6;74;80;7;12;19
293;07.12.2017;2017;12;16;Torstai;8;18;26;4;8;12
293;07.12.2017;2017;12;17;Torstai;5;7;12;3;5;8
293;07.12.2017;2017;12;18;Torstai;4;4;8;1;2;3
293;07.12.2017;2017;12;19;Torstai;3;7;10;4;5;9
293;07.12.2017;2017;12;20;Torstai;3;5;8;2;3;5
293;07.12.2017;2017;12;21;Torstai;0;1;1;0;1;1
293;07.12.2017;2017;12;22;Torstai;0;0;0;0;0;0
293;07.12.2017;2017;12;23;Torstai;0;0;0;0;0;0
293;08.12.2017;2017;12;00;Perjantai;0;0;0;0;0;0
293;08.12.2017;2017;12;01;Perjantai;0;0;0;0;0;0
293;08.12.2017;2017;12;02;Perjantai;0;0;0;0;0;0
293;08.12.2017;2017;12;03;Perjantai;1;0;1;0;0;0
293;08.12.2017;2017;12;04;Perjantai;0;0;0;0;0;0
293;08.12.2017;2017;12;05;Perjantai;0;0;0;1;0;1
293;08.12.2017;2017;12;06;Perjantai;3;2;5;2;0;2
293;08.12.2017;2017;12;07;Perjantai;19;19;38;5;0;5
293;08.12.2017;2017;12;08;Perjantai;25;24;49;17;0;17
293;08.12.2017;2017;12;09;Perjantai;11;10;21;5;0;5
293;08.12.2017;2017;12;10;Perjantai;8;8;16;4;0;4
293;08.12.2017;2017;12;11;Perjantai;3;2;5;7;0;7
293;08.12.2017;2017;12;12;Perjantai;4;3;7;12;0;12
293;08.12.2017;2017;12;13;Perjantai;12;11;23;10;0;10
293;08.12.2017;2017;12;14;Perjantai;28;28;56;14;0;14
293;08.12.2017;2017;12;15;Perjantai;13;13;26;7;0;7
293;08.12.2017;2017;12;16;Perjantai;4;4;8;18;0;18
293;08.12.2017;2017;12;17;Perjantai;5;4;9;12;0;12
293;08.12.2017;2017;12;18;Perjantai;3;2;5;9;0;9
293;08.12.2017;2017;12;19;Perjantai;6;6;12;4;0;4
293;08.12.2017;2017;12;20;Perjantai;2;6;8;4;0;4
293;08.12.2017;2017;12;21;Perjantai;3;2;5;6;1;7
293;08.12.2017;2017;12;22;Perjantai;3;2;5;2;0;2
293;08.12.2017;2017;12;23;Perjantai;2;0;2;1;2;3
293;09.12.2017;2017;12;00;Lauantai;0;1;1;1;0;1
293;09.12.2017;2017;12;01;Lauantai;2;0;2;3;0;3
293;09.12.2017;2017;12;02;Lauantai;0;0;0;0;0;0
293;09.12.2017;2017;12;03;Lauantai;0;0;0;0;0;0
293;09.12.2017;2017;12;04;Lauantai;0;0;0;0;0;0
293;09.12.2017;2017;12;05;Lauantai;0;0;0;0;0;0
293;09.12.2017;2017;12;06;Lauantai;0;0;0;0;0;0
293;09.12.2017;2017;12;07;Lauantai;4;0;4;0;1;1
293;09.12.2017;2017;12;08;Lauantai;0;1;1;5;2;7
293;09.12.2017;2017;12;09;Lauantai;2;1;3;8;3;11
293;09.12.2017;2017;12;10;Lauantai;3;1;4;9;2;11
293;09.12.2017;2017;12;11;Lauantai;1;2;3;5;4;9
293;09.12.2017;2017;12;12;Lauantai;3;3;6;5;5;10
293;09.12.2017;2017;12;13;Lauantai;3;4;7;6;5;11
293;09.12.2017;2017;12;14;Lauantai;8;6;14;9;8;17
293;09.12.2017;2017;12;15;Lauantai;1;3;4;4;6;10
293;09.12.2017;2017;12;16;Lauantai;3;6;9;2;4;6
293;09.12.2017;2017;12;17;Lauantai;2;1;3;0;1;1
293;09.12.2017;2017;12;18;Lauantai;1;3;4;3;1;4
293;09.12.2017;2017;12;19;Lauantai;4;2;6;1;1;2
293;09.12.2017;2017;12;20;Lauantai;3;4;7;2;2;4
293;09.12.2017;2017;12;21;Lauantai;1;2;3;0;2;2
293;09.12.2017;2017;12;22;Lauantai;0;3;3;0;0;0
293;09.12.2017;2017;12;23;Lauantai;0;1;1;0;0;0
293;10.12.2017;2017;12;00;Sunnuntai;1;0;1;0;0;0
293;10.12.2017;2017;12;01;Sunnuntai;0;0;0;1;0;1
293;10.12.2017;2017;12;02;Sunnuntai;0;0;0;0;2;2
293;10.12.2017;2017;12;03;Sunnuntai;0;0;0;0;1;1
293;10.12.2017;2017;12;04;Sunnuntai;0;0;0;0;1;1
293;10.12.2017;2017;12;05;Sunnuntai;0;0;0;4;1;5
293;10.12.2017;2017;12;06;Sunnuntai;0;0;0;0;0;0
293;10.12.2017;2017;12;07;Sunnuntai;2;0;2;0;1;1
293;10.12.2017;2017;12;08;Sunnuntai;0;1;1;5;1;6
293;10.12.2017;2017;12;09;Sunnuntai;1;0;1;5;2;7
293;10.12.2017;2017;12;10;Sunnuntai;0;0;0;5;6;11
293;10.12.2017;2017;12;11;Sunnuntai;2;1;3;4;5;9
293;10.12.2017;2017;12;12;Sunnuntai;2;2;4;9;1;10
293;10.12.2017;2017;12;13;Sunnuntai;1;4;5;8;7;15
293;10.12.2017;2017;12;14;Sunnuntai;5;3;8;14;9;23
293;10.12.2017;2017;12;15;Sunnuntai;1;3;4;6;2;8
293;10.12.2017;2017;12;16;Sunnuntai;6;5;11;1;4;5
293;10.12.2017;2017;12;17;Sunnuntai;3;2;5;1;5;6
293;10.12.2017;2017;12;18;Sunnuntai;3;3;6;2;2;4
293;10.12.2017;2017;12;19;Sunnuntai;1;3;4;2;3;5
293;10.12.2017;2017;12;20;Sunnuntai;2;1;3;3;2;5
293;10.12.2017;2017;12;21;Sunnuntai;2;0;2;0;0;0
293;10.12.2017;2017;12;22;Sunnuntai;1;0;1;1;0;1
293;10.12.2017;2017;12;23;Sunnuntai;0;0;0;0;0;0
293;11.12.2017;2017;12;00;Maanantai;0;0;0;0;0;0
293;11.12.2017;2017;12;01;Maanantai;0;0;0;0;0;0
293;11.12.2017;2017;12;02;Maanantai;0;0;0;0;0;0
293;11.12.2017;2017;12;03;Maanantai;1;0;1;0;0;0
293;11.12.2017;2017;12;04;Maanantai;0;0;0;0;0;0
293;11.12.2017;2017;12;05;Maanantai;1;0;1;0;0;0
293;11.12.2017;2017;12;06;Maanantai;6;0;6;6;0;6
293;11.12.2017;2017;12;07;Maanantai;55;0;55;8;0;8
293;11.12.2017;2017;12;08;Maanantai;80;0;80;13;0;13
293;11.12.2017;2017;12;09;Maanantai;27;0;27;5;0;5
293;11.12.2017;2017;12;10;Maanantai;8;0;8;7;0;7
293;11.12.2017;2017;12;11;Maanantai;7;0;7;5;0;5
293;11.12.2017;2017;12;12;Maanantai;9;0;9;8;0;8
293;11.12.2017;2017;12;13;Maanantai;16;3;19;13;2;15
293;11.12.2017;2017;12;14;Maanantai;11;31;42;6;8;14
293;11.12.2017;2017;12;15;Maanantai;6;79;85;3;19;22
293;11.12.2017;2017;12;16;Maanantai;6;10;16;4;2;6
293;11.12.2017;2017;12;17;Maanantai;3;5;8;7;7;14
293;11.12.2017;2017;12;18;Maanantai;5;1;6;4;10;14
293;11.12.2017;2017;12;19;Maanantai;5;4;9;3;7;10
293;11.12.2017;2017;12;20;Maanantai;1;3;4;3;4;7
293;11.12.2017;2017;12;21;Maanantai;0;3;3;1;1;2
293;11.12.2017;2017;12;22;Maanantai;0;1;1;0;1;1
293;11.12.2017;2017;12;23;Maanantai;0;0;0;0;0;0
293;12.12.2017;2017;12;00;Tiistai;0;0;0;0;0;0
293;12.12.2017;2017;12;01;Tiistai;0;0;0;0;0;0
293;12.12.2017;2017;12;02;Tiistai;0;0;0;0;0;0
293;12.12.2017;2017;12;03;Tiistai;1;1;2;0;0;0
293;12.12.2017;2017;12;04;Tiistai;0;0;0;0;0;0
293;12.12.2017;2017;12;05;Tiistai;1;0;1;0;1;1
293;12.12.2017;2017;12;06;Tiistai;6;3;9;3;0;3
293;12.12.2017;2017;12;07;Tiistai;68;0;68;13;1;14
293;12.12.2017;2017;12;08;Tiistai;63;4;67;10;2;12
293;12.12.2017;2017;12;09;Tiistai;25;1;26;3;3;6
293;12.12.2017;2017;12;10;Tiistai;6;1;7;3;4;7
293;12.12.2017;2017;12;11;Tiistai;7;1;8;3;2;5
293;12.12.2017;2017;12;12;Tiistai;3;6;9;5;6;11
293;12.12.2017;2017;12;13;Tiistai;2;32;34;5;9;14
293;12.12.2017;2017;12;14;Tiistai;4;59;63;3;13;16
293;12.12.2017;2017;12;15;Tiistai;3;53;56;3;14;17
293;12.12.2017;2017;12;16;Tiistai;3;9;12;2;1;3
293;12.12.2017;2017;12;17;Tiistai;2;9;11;6;1;7
293;12.12.2017;2017;12;18;Tiistai;4;1;5;4;3;7
293;12.12.2017;2017;12;19;Tiistai;1;5;6;7;5;12
293;12.12.2017;2017;12;20;Tiistai;1;4;5;2;2;4
293;12.12.2017;2017;12;21;Tiistai;1;1;2;0;0;0
293;12.12.2017;2017;12;22;Tiistai;0;0;0;0;0;0
293;12.12.2017;2017;12;23;Tiistai;0;0;0;0;0;0
293;13.12.2017;2017;12;00;Keskiviikko;0;0;0;0;0;0
293;13.12.2017;2017;12;01;Keskiviikko;0;0;0;0;0;0
293;13.12.2017;2017;12;02;Keskiviikko;0;0;0;0;0;0
293;13.12.2017;2017;12;03;Keskiviikko;0;0;0;0;0;0
293;13.12.2017;2017;12;04;Keskiviikko;0;0;0;0;0;0
293;13.12.2017;2017;12;05;Keskiviikko;0;0;0;0;0;0
293;13.12.2017;2017;12;06;Keskiviikko;5;4;9;1;0;1
293;13.12.2017;2017;12;07;Keskiviikko;42;15;57;9;0;9
293;13.12.2017;2017;12;08;Keskiviikko;54;22;76;11;0;11
293;13.12.2017;2017;12;09;Keskiviikko;12;6;18;1;1;2
293;13.12.2017;2017;12;10;Keskiviikko;2;1;3;3;1;4
293;13.12.2017;2017;12;11;Keskiviikko;1;0;1;1;2;3
293;13.12.2017;2017;12;12;Keskiviikko;7;8;15;1;4;5
293;13.12.2017;2017;12;13;Keskiviikko;8;10;18;0;0;0
293;13.12.2017;2017;12;14;Keskiviikko;27;75;102;1;2;3
293;13.12.2017;2017;12;15;Keskiviikko;7;9;16;2;0;2
293;13.12.2017;2017;12;16;Keskiviikko;12;8;20;1;1;2
293;13.12.2017;2017;12;17;Keskiviikko;4;6;10;1;0;1
293;13.12.2017;2017;12;18;Keskiviikko;6;4;10;2;2;4
293;13.12.2017;2017;12;19;Keskiviikko;3;2;5;0;3;3
293;13.12.2017;2017;12;20;Keskiviikko;2;5;7;0;0;0
293;13.12.2017;2017;12;21;Keskiviikko;1;1;2;0;1;1
293;13.12.2017;2017;12;22;Keskiviikko;0;0;0;0;0;0
293;13.12.2017;2017;12;23;Keskiviikko;0;0;0;0;0;0
293;14.12.2017;2017;12;00;Torstai;0;0;0;0;0;0
293;14.12.2017;2017;12;01;Torstai;0;0;0;1;0;1
293;14.12.2017;2017;12;02;Torstai;0;0;0;0;0;0
293;14.12.2017;2017;12;03;Torstai;1;0;1;0;0;0
293;14.12.2017;2017;12;04;Torstai;0;0;0;0;0;0
293;14.12.2017;2017;12;05;Torstai;1;0;1;0;0;0
293;14.12.2017;2017;12;06;Torstai;3;3;6;1;0;1
293;14.12.2017;2017;12;07;Torstai;51;24;75;3;1;4
293;14.12.2017;2017;12;08;Torstai;50;21;71;8;1;9
293;14.12.2017;2017;12;09;Torstai;12;8;20;2;1;3
293;14.12.2017;2017;12;10;Torstai;6;7;13;2;0;2
293;14.12.2017;2017;12;11;Torstai;3;3;6;1;4;5
293;14.12.2017;2017;12;12;Torstai;2;2;4;2;2;4
293;14.12.2017;2017;12;13;Torstai;4;20;24;2;7;9
293;14.12.2017;2017;12;14;Torstai;6;59;65;5;7;12
293;14.12.2017;2017;12;15;Torstai;3;68;71;1;14;15
293;14.12.2017;2017;12;16;Torstai;2;16;18;2;5;7
293;14.12.2017;2017;12;17;Torstai;4;7;11;2;5;7
293;14.12.2017;2017;12;18;Torstai;1;3;4;6;0;6
293;14.12.2017;2017;12;19;Torstai;3;6;9;3;4;7
293;14.12.2017;2017;12;20;Torstai;5;3;8;3;6;9
293;14.12.2017;2017;12;21;Torstai;2;1;3;0;2;2
293;14.12.2017;2017;12;22;Torstai;0;2;2;0;0;0
293;14.12.2017;2017;12;23;Torstai;0;0;0;0;0;0
293;15.12.2017;2017;12;00;Perjantai;0;1;1;0;0;0
293;15.12.2017;2017;12;01;Perjantai;0;0;0;0;0;0
293;15.12.2017;2017;12;02;Perjantai;0;0;0;0;0;0
293;15.12.2017;2017;12;03;Perjantai;1;0;1;0;0;0
293;15.12.2017;2017;12;04;Perjantai;1;0;1;0;0;0
293;15.12.2017;2017;12;05;Perjantai;0;0;0;0;0;0
293;15.12.2017;2017;12;06;Perjantai;7;4;11;1;2;3
293;15.12.2017;2017;12;07;Perjantai;56;3;59;10;2;12
293;15.12.2017;2017;12;08;Perjantai;57;2;59;11;0;11
293;15.12.2017;2017;12;09;Perjantai;22;3;25;13;2;15
293;15.12.2017;2017;12;10;Perjantai;18;2;20;4;4;8
293;15.12.2017;2017;12;11;Perjantai;6;4;10;3;1;4
293;15.12.2017;2017;12;12;Perjantai;6;13;19;6;6;12
293;15.12.2017;2017;12;13;Perjantai;6;29;35;1;12;13
293;15.12.2017;2017;12;14;Perjantai;5;88;93;4;18;22
293;15.12.2017;2017;12;15;Perjantai;3;31;34;2;10;12
293;15.12.2017;2017;12;16;Perjantai;7;7;14;4;6;10
293;15.12.2017;2017;12;17;Perjantai;8;10;18;7;4;11
293;15.12.2017;2017;12;18;Perjantai;12;14;26;6;12;18
293;15.12.2017;2017;12;19;Perjantai;2;4;6;2;8;10
293;15.12.2017;2017;12;20;Perjantai;10;4;14;1;3;4
293;15.12.2017;2017;12;21;Perjantai;1;10;11;1;2;3
293;15.12.2017;2017;12;22;Perjantai;2;1;3;1;1;2
293;15.12.2017;2017;12;23;Perjantai;2;0;2;0;2;2
293;16.12.2017;2017;12;00;Lauantai;0;0;0;1;1;2
293;16.12.2017;2017;12;01;Lauantai;1;0;1;0;0;0
293;16.12.2017;2017;12;02;Lauantai;0;0;0;0;2;2
293;16.12.2017;2017;12;03;Lauantai;0;0;0;0;1;1
293;16.12.2017;2017;12;04;Lauantai;0;0;0;0;0;0
293;16.12.2017;2017;12;05;Lauantai;0;0;0;0;0;0
293;16.12.2017;2017;12;06;Lauantai;1;0;1;0;0;0
293;16.12.2017;2017;12;07;Lauantai;0;1;1;0;0;0
293;16.12.2017;2017;12;08;Lauantai;2;0;2;2;1;3
293;16.12.2017;2017;12;09;Lauantai;2;0;2;4;1;5
293;16.12.2017;2017;12;10;Lauantai;1;2;3;7;6;13
293;16.12.2017;2017;12;11;Lauantai;1;2;3;5;4;9
293;16.12.2017;2017;12;12;Lauantai;7;2;9;6;3;9
293;16.12.2017;2017;12;13;Lauantai;8;6;14;5;9;14
293;16.12.2017;2017;12;14;Lauantai;4;5;9;8;8;16
293;16.12.2017;2017;12;15;Lauantai;7;2;9;6;8;14
293;16.12.2017;2017;12;16;Lauantai;2;6;8;5;5;10
293;16.12.2017;2017;12;17;Lauantai;4;6;10;9;4;13
293;16.12.2017;2017;12;18;Lauantai;6;6;12;2;4;6
293;16.12.2017;2017;12;19;Lauantai;2;5;7;4;4;8
293;16.12.2017;2017;12;20;Lauantai;0;4;4;0;1;1
293;16.12.2017;2017;12;21;Lauantai;2;2;4;0;0;0
293;16.12.2017;2017;12;22;Lauantai;3;2;5;4;0;4
293;16.12.2017;2017;12;23;Lauantai;1;2;3;0;0;0
293;17.12.2017;2017;12;00;Sunnuntai;1;1;2;0;1;1
293;17.12.2017;2017;12;01;Sunnuntai;0;3;3;4;2;6
293;17.12.2017;2017;12;02;Sunnuntai;0;0;0;0;2;2
293;17.12.2017;2017;12;03;Sunnuntai;0;1;1;0;1;1
293;17.12.2017;2017;12;04;Sunnuntai;0;0;0;0;1;1
293;17.12.2017;2017;12;05;Sunnuntai;3;1;4;2;0;2
293;17.12.2017;2017;12;06;Sunnuntai;0;0;0;0;0;0
293;17.12.2017;2017;12;07;Sunnuntai;0;0;0;1;2;3
293;17.12.2017;2017;12;08;Sunnuntai;1;0;1;0;2;2
293;17.12.2017;2017;12;09;Sunnuntai;1;1;2;5;0;5
293;17.12.2017;2017;12;10;Sunnuntai;10;1;11;9;4;13
293;17.12.2017;2017;12;11;Sunnuntai;1;3;4;6;7;13
293;17.12.2017;2017;12;12;Sunnuntai;2;4;6;5;5;10
293;17.12.2017;2017;12;13;Sunnuntai;3;0;3;6;7;13
293;17.12.2017;2017;12;14;Sunnuntai;4;5;9;3;7;10
293;17.12.2017;2017;12;15;Sunnuntai;3;2;5;8;11;19
293;17.12.2017;2017;12;16;Sunnuntai;8;8;16;6;8;14
293;17.12.2017;2017;12;17;Sunnuntai;2;3;5;6;3;9
293;17.12.2017;2017;12;18;Sunnuntai;7;3;10;10;12;22
293;17.12.2017;2017;12;19;Sunnuntai;1;5;6;4;7;11
293;17.12.2017;2017;12;20;Sunnuntai;1;5;6;3;3;6
293;17.12.2017;2017;12;21;Sunnuntai;4;1;5;1;1;2
293;17.12.2017;2017;12;22;Sunnuntai;0;1;1;1;0;1
293;17.12.2017;2017;12;23;Sunnuntai;0;0;0;0;0;0
293;18.12.2017;2017;12;00;Maanantai;0;0;0;0;1;1
293;18.12.2017;2017;12;01;Maanantai;0;0;0;0;0;0
293;18.12.2017;2017;12;02;Maanantai;0;0;0;0;0;0
293;18.12.2017;2017;12;03;Maanantai;1;0;1;0;0;0
293;18.12.2017;2017;12;04;Maanantai;0;0;0;0;0;0
293;18.12.2017;2017;12;05;Maanantai;2;0;2;0;0;0
293;18.12.2017;2017;12;06;Maanantai;9;1;10;3;0;3
293;18.12.2017;2017;12;07;Maanantai;59;2;61;7;1;8
293;18.12.2017;2017;12;08;Maanantai;84;7;91;8;4;12
293;18.12.2017;2017;12;09;Maanantai;30;1;31;7;1;8
293;18.12.2017;2017;12;10;Maanantai;13;7;20;3;2;5
293;18.12.2017;2017;12;11;Maanantai;3;2;5;2;7;9
293;18.12.2017;2017;12;12;Maanantai;8;8;16;6;2;8
293;18.12.2017;2017;12;13;Maanantai;4;28;32;5;12;17
293;18.12.2017;2017;12;14;Maanantai;6;102;108;6;16;22
293;18.12.2017;2017;12;15;Maanantai;3;46;49;7;8;15
293;18.12.2017;2017;12;16;Maanantai;8;9;17;1;10;11
293;18.12.2017;2017;12;17;Maanantai;4;6;10;6;6;12
293;18.12.2017;2017;12;18;Maanantai;5;9;14;3;6;9
293;18.12.2017;2017;12;19;Maanantai;3;7;10;2;5;7
293;18.12.2017;2017;12;20;Maanantai;2;9;11;2;1;3
293;18.12.2017;2017;12;21;Maanantai;1;6;7;0;4;4
293;18.12.2017;2017;12;22;Maanantai;1;0;1;0;0;0
293;18.12.2017;2017;12;23;Maanantai;0;0;0;0;0;0
293;19.12.2017;2017;12;00;Tiistai;0;0;0;0;0;0
293;19.12.2017;2017;12;01;Tiistai;0;0;0;0;0;0
293;19.12.2017;2017;12;02;Tiistai;0;1;1;0;0;0
293;19.12.2017;2017;12;03;Tiistai;1;0;1;0;0;0
293;19.12.2017;2017;12;04;Tiistai;0;0;0;0;0;0
293;19.12.2017;2017;12;05;Tiistai;1;0;1;0;0;0
293;19.12.2017;2017;12;06;Tiistai;6;2;8;3;0;3
293;19.12.2017;2017;12;07;Tiistai;74;4;78;9;1;10
293;19.12.2017;2017;12;08;Tiistai;64;4;68;23;10;33
293;19.12.2017;2017;12;09;Tiistai;26;4;30;12;6;18
293;19.12.2017;2017;12;10;Tiistai;10;2;12;8;2;10
293;19.12.2017;2017;12;11;Tiistai;2;1;3;1;6;7
293;19.12.2017;2017;12;12;Tiistai;8;5;13;6;6;12
293;19.12.2017;2017;12;13;Tiistai;6;83;89;5;11;16
293;19.12.2017;2017;12;14;Tiistai;4;46;50;8;12;20
293;19.12.2017;2017;12;15;Tiistai;12;34;46;3;10;13
293;19.12.2017;2017;12;16;Tiistai;5;19;24;2;8;10
293;19.12.2017;2017;12;17;Tiistai;2;7;9;4;2;6
293;19.12.2017;2017;12;18;Tiistai;4;6;10;0;4;4
293;19.12.2017;2017;12;19;Tiistai;4;3;7;7;5;12
293;19.12.2017;2017;12;20;Tiistai;1;5;6;1;3;4
293;19.12.2017;2017;12;21;Tiistai;1;3;4;1;2;3
293;19.12.2017;2017;12;22;Tiistai;1;0;1;0;1;1
293;19.12.2017;2017;12;23;Tiistai;1;0;1;0;0;0
293;20.12.2017;2017;12;00;Keskiviikko;0;0;0;0;0;0
293;20.12.2017;2017;12;01;Keskiviikko;0;0;0;0;0;0
293;20.12.2017;2017;12;02;Keskiviikko;0;0;0;0;0;0
293;20.12.2017;2017;12;03;Keskiviikko;1;0;1;0;0;0
293;20.12.2017;2017;12;04;Keskiviikko;0;0;0;0;0;0
293;20.12.2017;2017;12;05;Keskiviikko;1;0;1;0;0;0
293;20.12.2017;2017;12;06;Keskiviikko;3;1;4;1;0;1
293;20.12.2017;2017;12;07;Keskiviikko;66;3;69;8;2;10
293;20.12.2017;2017;12;08;Keskiviikko;76;2;78;11;3;14
293;20.12.2017;2017;12;09;Keskiviikko;14;1;15;7;1;8
293;20.12.2017;2017;12;10;Keskiviikko;2;5;7;2;3;5
293;20.12.2017;2017;12;11;Keskiviikko;1;2;3;2;2;4
293;20.12.2017;2017;12;12;Keskiviikko;1;8;9;2;2;4
293;20.12.2017;2017;12;13;Keskiviikko;1;29;30;3;7;10
293;20.12.2017;2017;12;14;Keskiviikko;4;96;100;3;9;12
293;20.12.2017;2017;12;15;Keskiviikko;4;11;15;3;2;5
293;20.12.2017;2017;12;16;Keskiviikko;3;7;10;2;6;8
293;20.12.2017;2017;12;17;Keskiviikko;2;5;7;0;2;2
293;20.12.2017;2017;12;18;Keskiviikko;3;2;5;3;3;6
293;20.12.2017;2017;12;19;Keskiviikko;0;1;1;3;1;4
293;20.12.2017;2017;12;20;Keskiviikko;2;1;3;1;3;4
293;20.12.2017;2017;12;21;Keskiviikko;0;1;1;0;2;2
293;20.12.2017;2017;12;22;Keskiviikko;0;0;0;1;1;2
293;20.12.2017;2017;12;23;Keskiviikko;0;0;0;0;0;0
293;21.12.2017;2017;12;00;Torstai;0;0;0;0;0;0
293;21.12.2017;2017;12;01;Torstai;0;0;0;0;0;0
293;21.12.2017;2017;12;02;Torstai;0;0;0;0;0;0
293;21.12.2017;2017;12;03;Torstai;1;0;1;0;0;0
293;21.12.2017;2017;12;04;Torstai;0;0;0;0;0;0
293;21.12.2017;2017;12;05;Torstai;0;0;0;1;0;1
293;21.12.2017;2017;12;06;Torstai;6;1;7;1;1;2
293;21.12.2017;2017;12;07;Torstai;76;3;79;15;3;18
293;21.12.2017;2017;12;08;Torstai;53;3;56;46;3;49
293;21.12.2017;2017;12;09;Torstai;4;6;10;4;37;41
293;21.12.2017;2017;12;10;Torstai;2;1;3;3;2;5
293;21.12.2017;2017;12;11;Torstai;5;0;5;2;3;5
293;21.12.2017;2017;12;12;Torstai;3;14;17;5;6;11
293;21.12.2017;2017;12;13;Torstai;4;89;93;5;25;30
293;21.12.2017;2017;12;14;Torstai;6;13;19;7;8;15
293;21.12.2017;2017;12;15;Torstai;5;27;32;2;7;9
293;21.12.2017;2017;12;16;Torstai;7;11;18;5;6;11
293;21.12.2017;2017;12;17;Torstai;5;9;14;5;7;12
293;21.12.2017;2017;12;18;Torstai;6;4;10;3;2;5
293;21.12.2017;2017;12;19;Torstai;4;9;13;3;4;7
293;21.12.2017;2017;12;20;Torstai;3;5;8;1;1;2
293;21.12.2017;2017;12;21;Torstai;1;1;2;0;2;2
293;21.12.2017;2017;12;22;Torstai;1;1;2;0;0;0
293;21.12.2017;2017;12;23;Torstai;0;0;0;0;0;0
293;22.12.2017;2017;12;00;Perjantai;0;3;3;0;0;0
293;22.12.2017;2017;12;01;Perjantai;0;0;0;1;0;1
293;22.12.2017;2017;12;02;Perjantai;0;0;0;1;0;1
293;22.12.2017;2017;12;03;Perjantai;0;0;0;0;0;0
293;22.12.2017;2017;12;04;Perjantai;0;0;0;0;0;0
293;22.12.2017;2017;12;05;Perjantai;0;0;0;1;1;2
293;22.12.2017;2017;12;06;Perjantai;3;1;4;1;0;1
293;22.12.2017;2017;12;07;Perjantai;4;1;5;4;0;4
293;22.12.2017;2017;12;08;Perjantai;99;3;102;11;2;13
293;22.12.2017;2017;12;09;Perjantai;6;1;7;4;3;7
293;22.12.2017;2017;12;10;Perjantai;1;0;1;3;4;7
293;22.12.2017;2017;12;11;Perjantai;2;4;6;1;5;6
293;22.12.2017;2017;12;12;Perjantai;5;93;98;6;16;22
293;22.12.2017;2017;12;13;Perjantai;3;7;10;5;10;15
293;22.12.2017;2017;12;14;Perjantai;5;11;16;10;8;18
293;22.12.2017;2017;12;15;Perjantai;5;5;10;3;8;11
293;22.12.2017;2017;12;16;Perjantai;7;6;13;5;2;7
293;22.12.2017;2017;12;17;Perjantai;0;4;4;3;6;9
293;22.12.2017;2017;12;18;Perjantai;4;3;7;3;9;12
293;22.12.2017;2017;12;19;Perjantai;6;5;11;1;1;2
293;22.12.2017;2017;12;20;Perjantai;3;4;7;5;2;7
293;22.12.2017;2017;12;21;Perjantai;3;2;5;0;1;1
293;22.12.2017;2017;12;22;Perjantai;1;7;8;0;0;0
293;22.12.2017;2017;12;23;Perjantai;0;0;0;0;0;0
293;23.12.2017;2017;12;00;Lauantai;2;3;5;2;0;2
293;23.12.2017;2017;12;01;Lauantai;0;0;0;0;0;0
293;23.12.2017;2017;12;02;Lauantai;0;0;0;2;0;2
293;23.12.2017;2017;12;03;Lauantai;0;0;0;1;1;2
293;23.12.2017;2017;12;04;Lauantai;1;0;1;0;0;0
293;23.12.2017;2017;12;05;Lauantai;0;0;0;0;0;0
293;23.12.2017;2017;12;06;Lauantai;0;0;0;0;0;0
293;23.12.2017;2017;12;07;Lauantai;2;0;2;0;0;0
293;23.12.2017;2017;12;08;Lauantai;1;2;3;3;0;3
293;23.12.2017;2017;12;09;Lauantai;1;1;2;5;1;6
293;23.12.2017;2017;12;10;Lauantai;0;0;0;13;0;13
293;23.12.2017;2017;12;11;Lauantai;1;0;1;9;0;9
293;23.12.2017;2017;12;12;Lauantai;0;0;0;9;0;9
293;23.12.2017;2017;12;13;Lauantai;1;1;2;14;0;14
293;23.12.2017;2017;12;14;Lauantai;0;0;0;16;0;16
293;23.12.2017;2017;12;15;Lauantai;1;0;1;14;0;14
293;23.12.2017;2017;12;16;Lauantai;0;0;0;10;0;10
293;23.12.2017;2017;12;17;Lauantai;3;2;5;13;0;13
293;23.12.2017;2017;12;18;Lauantai;2;1;3;6;0;6
293;23.12.2017;2017;12;19;Lauantai;2;2;4;8;0;8
293;23.12.2017;2017;12;20;Lauantai;0;0;0;1;0;1
293;23.12.2017;2017;12;21;Lauantai;0;0;0;0;0;0
293;23.12.2017;2017;12;22;Lauantai;2;1;3;4;0;4
293;23.12.2017;2017;12;23;Lauantai;0;0;0;0;0;0
293;24.12.2017;2017;12;00;Sunnuntai;0;0;0;1;0;1
293;24.12.2017;2017;12;01;Sunnuntai;0;0;0;0;0;0
293;24.12.2017;2017;12;02;Sunnuntai;0;0;0;0;0;0
293;24.12.2017;2017;12;03;Sunnuntai;0;0;0;0;0;0
293;24.12.2017;2017;12;04;Sunnuntai;0;0;0;0;0;0
293;24.12.2017;2017;12;05;Sunnuntai;0;0;0;0;0;0
293;24.12.2017;2017;12;06;Sunnuntai;0;0;0;0;0;0
293;24.12.2017;2017;12;07;Sunnuntai;1;1;2;3;0;3
293;24.12.2017;2017;12;08;Sunnuntai;2;1;3;1;0;1
293;24.12.2017;2017;12;09;Sunnuntai;3;2;5;4;0;4
293;24.12.2017;2017;12;10;Sunnuntai;1;0;1;13;0;13
293;24.12.2017;2017;12;11;Sunnuntai;3;2;5;9;0;9
293;24.12.2017;2017;12;12;Sunnuntai;3;3;6;5;0;5
293;24.12.2017;2017;12;13;Sunnuntai;0;0;0;9;0;9
293;24.12.2017;2017;12;14;Sunnuntai;2;1;3;7;0;7
293;24.12.2017;2017;12;15;Sunnuntai;3;3;6;9;0;9
293;24.12.2017;2017;12;16;Sunnuntai;1;0;1;6;0;6
293;24.12.2017;2017;12;17;Sunnuntai;1;0;1;1;0;1
293;24.12.2017;2017;12;18;Sunnuntai;0;0;0;3;0;3
293;24.12.2017;2017;12;19;Sunnuntai;0;0;0;0;0;0
293;24.12.2017;2017;12;20;Sunnuntai;1;0;1;0;0;0
293;24.12.2017;2017;12;21;Sunnuntai;1;0;1;0;0;0
293;24.12.2017;2017;12;22;Sunnuntai;0;0;0;0;0;0
293;24.12.2017;2017;12;23;Sunnuntai;1;0;1;0;0;0
293;25.12.2017;2017;12;00;Maanantai;2;1;3;1;0;1
293;25.12.2017;2017;12;01;Maanantai;0;0;0;0;0;0
293;25.12.2017;2017;12;02;Maanantai;0;0;0;0;0;0
293;25.12.2017;2017;12;03;Maanantai;2;1;3;0;0;0
293;25.12.2017;2017;12;04;Maanantai;0;0;0;0;0;0
293;25.12.2017;2017;12;05;Maanantai;0;0;0;0;0;0
293;25.12.2017;2017;12;06;Maanantai;0;0;0;0;0;0
293;25.12.2017;2017;12;07;Maanantai;1;1;2;3;0;3
293;25.12.2017;2017;12;08;Maanantai;1;1;2;1;0;1
293;25.12.2017;2017;12;09;Maanantai;1;0;1;4;0;4
293;25.12.2017;2017;12;10;Maanantai;0;0;0;13;0;13
293;25.12.2017;2017;12;11;Maanantai;1;0;1;9;0;9
293;25.12.2017;2017;12;12;Maanantai;2;2;4;5;0;5
293;25.12.2017;2017;12;13;Maanantai;2;1;3;9;0;9
293;25.12.2017;2017;12;14;Maanantai;3;3;6;7;0;7
293;25.12.2017;2017;12;15;Maanantai;3;2;5;9;0;9
293;25.12.2017;2017;12;16;Maanantai;0;0;0;6;0;6
293;25.12.2017;2017;12;17;Maanantai;1;1;2;1;0;1
293;25.12.2017;2017;12;18;Maanantai;1;1;2;3;0;3
293;25.12.2017;2017;12;19;Maanantai;3;3;6;0;0;0
293;25.12.2017;2017;12;20;Maanantai;1;1;2;0;0;0
293;25.12.2017;2017;12;21;Maanantai;1;1;2;0;0;0
293;25.12.2017;2017;12;22;Maanantai;2;1;3;0;0;0
293;25.12.2017;2017;12;23;Maanantai;1;0;1;0;0;0
293;26.12.2017;2017;12;00;Tiistai;0;0;0;1;0;1
293;26.12.2017;2017;12;01;Tiistai;0;0;0;0;0;0
293;26.12.2017;2017;12;02;Tiistai;0;0;0;0;0;0
293;26.12.2017;2017;12;03;Tiistai;0;0;0;0;0;0
293;26.12.2017;2017;12;04;Tiistai;0;0;0;0;0;0
293;26.12.2017;2017;12;05;Tiistai;0;0;0;0;0;0
293;26.12.2017;2017;12;06;Tiistai;0;0;0;0;0;0
293;26.12.2017;2017;12;07;Tiistai;1;0;1;3;0;3
293;26.12.2017;2017;12;08;Tiistai;1;1;2;1;0;1
293;26.12.2017;2017;12;09;Tiistai;1;0;1;4;0;4
293;26.12.2017;2017;12;10;Tiistai;0;0;0;13;0;13
293;26.12.2017;2017;12;11;Tiistai;1;0;1;9;0;9
293;26.12.2017;2017;12;12;Tiistai;1;0;1;5;0;5
293;26.12.2017;2017;12;13;Tiistai;2;2;4;9;0;9
293;26.12.2017;2017;12;14;Tiistai;1;1;2;7;0;7
293;26.12.2017;2017;12;15;Tiistai;2;1;3;9;0;9
293;26.12.2017;2017;12;16;Tiistai;2;2;4;6;0;6
293;26.12.2017;2017;12;17;Tiistai;2;1;3;1;0;1
293;26.12.2017;2017;12;18;Tiistai;1;0;1;3;0;3
293;26.12.2017;2017;12;19;Tiistai;5;5;10;0;0;0
293;26.12.2017;2017;12;20;Tiistai;3;2;5;0;0;0
293;26.12.2017;2017;12;21;Tiistai;0;0;0;0;0;0
293;26.12.2017;2017;12;22;Tiistai;2;1;3;0;0;0
293;26.12.2017;2017;12;23;Tiistai;0;0;0;0;0;0
293;27.12.2017;2017;12;00;Keskiviikko;0;0;0;0;0;0
293;27.12.2017;2017;12;01;Keskiviikko;0;0;0;0;0;0
293;27.12.2017;2017;12;02;Keskiviikko;0;0;0;0;0;0
293;27.12.2017;2017;12;03;Keskiviikko;1;0;1;0;0;0
293;27.12.2017;2017;12;04;Keskiviikko;0;0;0;0;0;0
293;27.12.2017;2017;12;05;Keskiviikko;0;0;0;0;0;0
293;27.12.2017;2017;12;06;Keskiviikko;1;1;2;1;0;1
293;27.12.2017;2017;12;07;Keskiviikko;2;1;3;10;0;10
293;27.12.2017;2017;12;08;Keskiviikko;2;1;3;14;0;14
293;27.12.2017;2017;12;09;Keskiviikko;3;3;6;8;0;8
293;27.12.2017;2017;12;10;Keskiviikko;2;1;3;5;0;5
293;27.12.2017;2017;12;11;Keskiviikko;1;0;1;4;0;4
293;27.12.2017;2017;12;12;Keskiviikko;1;1;2;4;0;4
293;27.12.2017;2017;12;13;Keskiviikko;2;1;3;10;0;10
293;27.12.2017;2017;12;14;Keskiviikko;6;5;11;12;0;12
293;27.12.2017;2017;12;15;Keskiviikko;1;0;1;5;0;5
293;27.12.2017;2017;12;16;Keskiviikko;4;4;8;8;0;8
293;27.12.2017;2017;12;17;Keskiviikko;3;2;5;2;0;2
293;27.12.2017;2017;12;18;Keskiviikko;4;3;7;6;0;6
293;27.12.2017;2017;12;19;Keskiviikko;4;4;8;4;0;4
293;27.12.2017;2017;12;20;Keskiviikko;1;1;2;4;0;4
293;27.12.2017;2017;12;21;Keskiviikko;5;4;9;2;0;2
293;27.12.2017;2017;12;22;Keskiviikko;0;0;0;2;0;2
293;27.12.2017;2017;12;23;Keskiviikko;1;1;2;0;0;0
293;28.12.2017;2017;12;00;Torstai;0;0;0;0;0;0
293;28.12.2017;2017;12;01;Torstai;1;0;1;0;0;0
293;28.12.2017;2017;12;02;Torstai;0;0;0;0;0;0
293;28.12.2017;2017;12;03;Torstai;1;0;1;0;0;0
293;28.12.2017;2017;12;04;Torstai;0;0;0;0;0;0
293;28.12.2017;2017;12;05;Torstai;1;0;1;0;0;0
293;28.12.2017;2017;12;06;Torstai;3;2;5;0;0;0
293;28.12.2017;2017;12;07;Torstai;1;2;3;2;0;2
293;28.12.2017;2017;12;08;Torstai;4;2;6;1;2;3
293;28.12.2017;2017;12;09;Torstai;2;1;3;2;0;2
293;28.12.2017;2017;12;10;Torstai;1;1;2;3;0;3
293;28.12.2017;2017;12;11;Torstai;5;4;9;4;1;5
293;28.12.2017;2017;12;12;Torstai;4;5;9;1;3;4
293;28.12.2017;2017;12;13;Torstai;3;1;4;4;1;5
293;28.12.2017;2017;12;14;Torstai;11;4;15;2;1;3
293;28.12.2017;2017;12;15;Torstai;5;3;8;5;1;6
293;28.12.2017;2017;12;16;Torstai;5;7;12;3;0;3
293;28.12.2017;2017;12;17;Torstai;5;3;8;2;1;3
293;28.12.2017;2017;12;18;Torstai;3;0;3;3;0;3
293;28.12.2017;2017;12;19;Torstai;4;4;8;1;0;1
293;28.12.2017;2017;12;20;Torstai;3;2;5;1;2;3
293;28.12.2017;2017;12;21;Torstai;1;1;2;1;1;2
293;28.12.2017;2017;12;22;Torstai;2;0;2;0;0;0
293;28.12.2017;2017;12;23;Torstai;0;0;0;0;0;0
293;29.12.2017;2017;12;00;Perjantai;0;0;0;0;0;0
293;29.12.2017;2017;12;01;Perjantai;0;0;0;1;1;2
293;29.12.2017;2017;12;02;Perjantai;0;0;0;1;0;1
293;29.12.2017;2017;12;03;Perjantai;1;0;1;0;0;0
293;29.12.2017;2017;12;04;Perjantai;0;0;0;0;0;0
293;29.12.2017;2017;12;05;Perjantai;2;1;3;2;0;2
293;29.12.2017;2017;12;06;Perjantai;1;1;2;1;0;1
293;29.12.2017;2017;12;07;Perjantai;1;1;2;4;0;4
293;29.12.2017;2017;12;08;Perjantai;1;1;2;13;0;13
293;29.12.2017;2017;12;09;Perjantai;2;2;4;7;0;7
293;29.12.2017;2017;12;10;Perjantai;0;0;0;7;0;7
293;29.12.2017;2017;12;11;Perjantai;3;2;5;6;0;6
293;29.12.2017;2017;12;12;Perjantai;1;1;2;22;0;22
293;29.12.2017;2017;12;13;Perjantai;3;3;6;15;0;15
293;29.12.2017;2017;12;14;Perjantai;3;3;6;18;0;18
293;29.12.2017;2017;12;15;Perjantai;5;4;9;11;0;11
293;29.12.2017;2017;12;16;Perjantai;5;5;10;7;0;7
293;29.12.2017;2017;12;17;Perjantai;3;3;6;9;0;9
293;29.12.2017;2017;12;18;Perjantai;3;3;6;12;0;12
293;29.12.2017;2017;12;19;Perjantai;5;4;9;2;0;2
293;29.12.2017;2017;12;20;Perjantai;0;8;8;2;5;7
293;29.12.2017;2017;12;21;Perjantai;4;1;5;5;5;10
293;29.12.2017;2017;12;22;Perjantai;3;3;6;1;3;4
293;29.12.2017;2017;12;23;Perjantai;0;0;0;0;0;0
293;30.12.2017;2017;12;00;Lauantai;0;1;1;1;1;2
293;30.12.2017;2017;12;01;Lauantai;0;0;0;0;0;0
293;30.12.2017;2017;12;02;Lauantai;0;0;0;0;1;1
293;30.12.2017;2017;12;03;Lauantai;0;0;0;0;0;0
293;30.12.2017;2017;12;04;Lauantai;0;0;0;0;0;0
293;30.12.2017;2017;12;05;Lauantai;1;1;2;0;0;0
293;30.12.2017;2017;12;06;Lauantai;0;0;0;0;0;0
293;30.12.2017;2017;12;07;Lauantai;1;0;1;0;0;0
293;30.12.2017;2017;12;08;Lauantai;2;3;5;0;0;0
293;30.12.2017;2017;12;09;Lauantai;2;3;5;6;0;6
293;30.12.2017;2017;12;10;Lauantai;5;6;11;7;5;12
293;30.12.2017;2017;12;11;Lauantai;2;1;3;7;5;12
293;30.12.2017;2017;12;12;Lauantai;4;5;9;1;3;4
293;30.12.2017;2017;12;13;Lauantai;5;4;9;9;4;13
293;30.12.2017;2017;12;14;Lauantai;2;2;4;6;4;10
293;30.12.2017;2017;12;15;Lauantai;0;3;3;3;9;12
293;30.12.2017;2017;12;16;Lauantai;2;4;6;4;6;10
293;30.12.2017;2017;12;17;Lauantai;3;2;5;0;2;2
293;30.12.2017;2017;12;18;Lauantai;0;4;4;4;2;6
293;30.12.2017;2017;12;19;Lauantai;1;1;2;6;10;16
293;30.12.2017;2017;12;20;Lauantai;2;3;5;2;1;3
293;30.12.2017;2017;12;21;Lauantai;1;1;2;2;1;3
293;30.12.2017;2017;12;22;Lauantai;3;0;3;2;0;2
293;30.12.2017;2017;12;23;Lauantai;0;1;1;0;1;1
293;31.12.2017;2017;12;00;Sunnuntai;1;0;1;2;0;2
293;31.12.2017;2017;12;01;Sunnuntai;0;0;0;0;0;0
293;31.12.2017;2017;12;02;Sunnuntai;2;0;2;0;1;1
293;31.12.2017;2017;12;03;Sunnuntai;0;0;0;3;1;4
293;31.12.2017;2017;12;04;Sunnuntai;0;0;0;0;0;0
293;31.12.2017;2017;12;05;Sunnuntai;0;0;0;1;0;1
293;31.12.2017;2017;12;06;Sunnuntai;0;0;0;1;1;2
293;31.12.2017;2017;12;07;Sunnuntai;0;0;0;1;2;3
293;31.12.2017;2017;12;08;Sunnuntai;0;0;0;1;0;1
293;31.12.2017;2017;12;09;Sunnuntai;4;1;5;2;0;2
293;31.12.2017;2017;12;10;Sunnuntai;1;1;2;4;3;7
293;31.12.2017;2017;12;11;Sunnuntai;7;4;11;9;1;10
293;31.12.2017;2017;12;12;Sunnuntai;5;1;6;3;13;16
293;31.12.2017;2017;12;13;Sunnuntai;5;6;11;12;4;16
293;31.12.2017;2017;12;14;Sunnuntai;3;5;8;7;9;16
293;31.12.2017;2017;12;15;Sunnuntai;7;6;13;3;7;10
293;31.12.2017;2017;12;16;Sunnuntai;6;5;11;6;7;13
293;31.12.2017;2017;12;17;Sunnuntai;7;6;13;5;4;9
293;31.12.2017;2017;12;18;Sunnuntai;1;3;4;5;3;8
293;31.12.2017;2017;12;19;Sunnuntai;1;10;11;7;4;11
293;31.12.2017;2017;12;20;Sunnuntai;6;6;12;3;5;8
293;31.12.2017;2017;12;21;Sunnuntai;8;4;12;4;3;7
293;31.12.2017;2017;12;22;Sunnuntai;0;5;5;6;2;8
293;31.12.2017;2017;12;23;Sunnuntai;3;3;6;11;3;14
293;01.01.2018;2018;01;00;Maanantai;2;0;2;12;5;17
293;01.01.2018;2018;01;01;Maanantai;2;1;3;1;3;4
293;01.01.2018;2018;01;02;Maanantai;1;0;1;2;7;9
293;01.01.2018;2018;01;03;Maanantai;2;0;2;1;1;2
293;01.01.2018;2018;01;04;Maanantai;0;2;2;0;1;1
293;01.01.2018;2018;01;05;Maanantai;0;0;0;1;0;1
293;01.01.2018;2018;01;06;Maanantai;1;0;1;0;1;1
293;01.01.2018;2018;01;07;Maanantai;0;0;0;0;0;0
293;01.01.2018;2018;01;08;Maanantai;1;0;1;0;0;0
293;01.01.2018;2018;01;09;Maanantai;0;0;0;0;0;0
293;01.01.2018;2018;01;10;Maanantai;3;0;3;4;0;4
293;01.01.2018;2018;01;11;Maanantai;3;5;8;3;9;12
293;01.01.2018;2018;01;12;Maanantai;4;2;6;8;5;13
293;01.01.2018;2018;01;13;Maanantai;7;5;12;5;9;14
293;01.01.2018;2018;01;14;Maanantai;5;2;7;9;3;12
293;01.01.2018;2018;01;15;Maanantai;7;8;15;7;4;11
293;01.01.2018;2018;01;16;Maanantai;6;7;13;4;4;8
293;01.01.2018;2018;01;17;Maanantai;3;3;6;5;6;11
293;01.01.2018;2018;01;18;Maanantai;1;5;6;1;1;2
293;01.01.2018;2018;01;19;Maanantai;6;1;7;5;1;6
293;01.01.2018;2018;01;20;Maanantai;5;5;10;0;6;6
293;01.01.2018;2018;01;21;Maanantai;1;1;2;3;1;4
293;01.01.2018;2018;01;22;Maanantai;3;0;3;0;0;0
293;01.01.2018;2018;01;23;Maanantai;1;0;1;0;0;0
293;02.01.2018;2018;01;00;Tiistai;0;0;0;0;0;0
293;02.01.2018;2018;01;01;Tiistai;0;0;0;0;0;0
293;02.01.2018;2018;01;02;Tiistai;0;0;0;0;0;0
293;02.01.2018;2018;01;03;Tiistai;1;0;1;0;0;0
293;02.01.2018;2018;01;04;Tiistai;0;0;0;0;0;0
293;02.01.2018;2018;01;05;Tiistai;1;0;1;1;0;1
293;02.01.2018;2018;01;06;Tiistai;6;1;7;0;0;0
293;02.01.2018;2018;01;07;Tiistai;6;3;9;1;0;1
293;02.01.2018;2018;01;08;Tiistai;9;2;11;4;0;4
293;02.01.2018;2018;01;09;Tiistai;3;3;6;3;1;4
293;02.01.2018;2018;01;10;Tiistai;2;2;4;1;3;4
293;02.01.2018;2018;01;11;Tiistai;4;3;7;4;3;7
293;02.01.2018;2018;01;12;Tiistai;8;4;12;10;7;17
293;02.01.2018;2018;01;13;Tiistai;7;8;15;4;5;9
293;02.01.2018;2018;01;14;Tiistai;8;11;19;7;13;20
293;02.01.2018;2018;01;15;Tiistai;8;10;18;2;7;9
293;02.01.2018;2018;01;16;Tiistai;8;8;16;6;7;13
293;02.01.2018;2018;01;17;Tiistai;7;9;16;15;13;28
293;02.01.2018;2018;01;18;Tiistai;5;5;10;4;12;16
293;02.01.2018;2018;01;19;Tiistai;3;5;8;6;3;9
293;02.01.2018;2018;01;20;Tiistai;2;5;7;3;3;6
293;02.01.2018;2018;01;21;Tiistai;2;3;5;1;1;2
293;02.01.2018;2018;01;22;Tiistai;2;0;2;0;0;0
293;02.01.2018;2018;01;23;Tiistai;0;0;0;0;0;0
293;03.01.2018;2018;01;00;Keskiviikko;0;0;0;0;0;0
293;03.01.2018;2018;01;01;Keskiviikko;0;1;1;0;0;0
293;03.01.2018;2018;01;02;Keskiviikko;0;0;0;0;0;0
293;03.01.2018;2018;01;03;Keskiviikko;1;0;1;0;0;0
293;03.01.2018;2018;01;04;Keskiviikko;0;0;0;0;0;0
293;03.01.2018;2018;01;05;Keskiviikko;1;0;1;0;0;0
293;03.01.2018;2018;01;06;Keskiviikko;5;1;6;3;0;3
293;03.01.2018;2018;01;07;Keskiviikko;9;2;11;5;0;5
293;03.01.2018;2018;01;08;Keskiviikko;3;0;3;4;1;5
293;03.01.2018;2018;01;09;Keskiviikko;5;0;5;1;4;5
293;03.01.2018;2018;01;10;Keskiviikko;0;1;1;3;5;8
293;03.01.2018;2018;01;11;Keskiviikko;1;0;1;2;5;7
293;03.01.2018;2018;01;12;Keskiviikko;3;4;7;0;1;1
293;03.01.2018;2018;01;13;Keskiviikko;4;3;7;7;2;9
293;03.01.2018;2018;01;14;Keskiviikko;4;7;11;5;6;11
293;03.01.2018;2018;01;15;Keskiviikko;7;10;17;2;6;8
293;03.01.2018;2018;01;16;Keskiviikko;2;9;11;4;4;8
293;03.01.2018;2018;01;17;Keskiviikko;9;8;17;7;5;12
293;03.01.2018;2018;01;18;Keskiviikko;6;6;12;6;6;12
293;03.01.2018;2018;01;19;Keskiviikko;4;5;9;2;8;10
293;03.01.2018;2018;01;20;Keskiviikko;3;5;8;1;0;1
293;03.01.2018;2018;01;21;Keskiviikko;4;8;12;2;1;3
293;03.01.2018;2018;01;22;Keskiviikko;0;1;1;0;1;1
293;03.01.2018;2018;01;23;Keskiviikko;1;0;1;0;0;0
293;04.01.2018;2018;01;00;Torstai;0;0;0;0;0;0
293;04.01.2018;2018;01;01;Torstai;1;0;1;0;0;0
293;04.01.2018;2018;01;02;Torstai;0;0;0;0;0;0
293;04.01.2018;2018;01;03;Torstai;1;0;1;0;0;0
293;04.01.2018;2018;01;04;Torstai;0;0;0;0;0;0
293;04.01.2018;2018;01;05;Torstai;1;0;1;0;0;0
293;04.01.2018;2018;01;06;Torstai;5;0;5;0;0;0
293;04.01.2018;2018;01;07;Torstai;3;0;3;2;0;2
293;04.01.2018;2018;01;08;Torstai;6;0;6;3;0;3
293;04.01.2018;2018;01;09;Torstai;3;0;3;2;0;2
293;04.01.2018;2018;01;10;Torstai;2;0;2;3;0;3
293;04.01.2018;2018;01;11;Torstai;9;0;9;5;0;5
293;04.01.2018;2018;01;12;Torstai;9;0;9;4;0;4
293;04.01.2018;2018;01;13;Torstai;4;0;4;5;0;5
293;04.01.2018;2018;01;14;Torstai;15;0;15;3;0;3
293;04.01.2018;2018;01;15;Torstai;8;0;8;6;0;6
293;04.01.2018;2018;01;16;Torstai;12;0;12;3;0;3
293;04.01.2018;2018;01;17;Torstai;8;0;8;3;0;3
293;04.01.2018;2018;01;18;Torstai;3;0;3;3;0;3
293;04.01.2018;2018;01;19;Torstai;8;0;8;1;0;1
293;04.01.2018;2018;01;20;Torstai;5;0;5;3;0;3
293;04.01.2018;2018;01;21;Torstai;2;0;2;2;0;2
293;04.01.2018;2018;01;22;Torstai;2;0;2;0;0;0
293;04.01.2018;2018;01;23;Torstai;0;0;0;0;0;0
293;05.01.2018;2018;01;00;Perjantai;0;0;0;0;0;0
293;05.01.2018;2018;01;01;Perjantai;0;0;0;0;0;0
293;05.01.2018;2018;01;02;Perjantai;0;0;0;0;0;0
293;05.01.2018;2018;01;03;Perjantai;1;0;1;0;0;0
293;05.01.2018;2018;01;04;Perjantai;0;0;0;0;0;0
293;05.01.2018;2018;01;05;Perjantai;1;0;1;0;0;0
293;05.01.2018;2018;01;06;Perjantai;3;1;4;1;0;1
293;05.01.2018;2018;01;07;Perjantai;9;0;9;3;0;3
293;05.01.2018;2018;01;08;Perjantai;1;2;3;5;0;5
293;05.01.2018;2018;01;09;Perjantai;3;1;4;1;2;3
293;05.01.2018;2018;01;10;Perjantai;3;2;5;3;4;7
293;05.01.2018;2018;01;11;Perjantai;4;4;8;2;0;2
293;05.01.2018;2018;01;12;Perjantai;2;1;3;2;2;4
293;05.01.2018;2018;01;13;Perjantai;1;3;4;10;9;19
293;05.01.2018;2018;01;14;Perjantai;3;5;8;7;9;16
293;05.01.2018;2018;01;15;Perjantai;3;3;6;5;9;14
293;05.01.2018;2018;01;16;Perjantai;0;6;6;7;4;11
293;05.01.2018;2018;01;17;Perjantai;3;3;6;0;0;0
293;05.01.2018;2018;01;18;Perjantai;6;6;12;0;0;0
293;05.01.2018;2018;01;19;Perjantai;10;10;20;0;0;0
293;05.01.2018;2018;01;20;Perjantai;2;2;4;0;0;0
293;05.01.2018;2018;01;21;Perjantai;2;2;4;0;0;0
293;05.01.2018;2018;01;22;Perjantai;1;1;2;0;0;0
293;05.01.2018;2018;01;23;Perjantai;0;0;0;0;0;0
293;06.01.2018;2018;01;00;Lauantai;0;0;0;2;0;2
293;06.01.2018;2018;01;01;Lauantai;1;0;1;0;0;0
293;06.01.2018;2018;01;02;Lauantai;0;0;0;1;0;1
293;06.01.2018;2018;01;03;Lauantai;0;0;0;0;0;0
293;06.01.2018;2018;01;04;Lauantai;1;0;1;0;0;0
293;06.01.2018;2018;01;05;Lauantai;1;0;1;0;0;0
293;06.01.2018;2018;01;06;Lauantai;0;0;0;0;0;0
293;06.01.2018;2018;01;07;Lauantai;0;0;0;0;0;0
293;06.01.2018;2018;01;08;Lauantai;0;0;0;0;0;0
293;06.01.2018;2018;01;09;Lauantai;2;1;3;6;0;6
293;06.01.2018;2018;01;10;Lauantai;1;0;1;12;0;12
293;06.01.2018;2018;01;11;Lauantai;3;2;5;12;0;12
293;06.01.2018;2018;01;12;Lauantai;3;2;5;4;0;4
293;06.01.2018;2018;01;13;Lauantai;4;3;7;13;0;13
293;06.01.2018;2018;01;14;Lauantai;3;2;5;10;0;10
293;06.01.2018;2018;01;15;Lauantai;2;1;3;12;0;12
293;06.01.2018;2018;01;16;Lauantai;4;4;8;10;0;10
293;06.01.2018;2018;01;17;Lauantai;2;1;3;2;0;2
293;06.01.2018;2018;01;18;Lauantai;3;2;5;6;0;6
293;06.01.2018;2018;01;19;Lauantai;2;2;4;16;0;16
293;06.01.2018;2018;01;20;Lauantai;2;1;3;3;0;3
293;06.01.2018;2018;01;21;Lauantai;1;0;1;3;0;3
293;06.01.2018;2018;01;22;Lauantai;1;1;2;2;0;2
293;06.01.2018;2018;01;23;Lauantai;0;0;0;1;0;1
293;07.01.2018;2018;01;00;Sunnuntai;1;1;2;2;0;2
293;07.01.2018;2018;01;01;Sunnuntai;1;0;1;0;0;0
293;07.01.2018;2018;01;02;Sunnuntai;0;0;0;1;0;1
293;07.01.2018;2018;01;03;Sunnuntai;1;0;1;4;0;4
293;07.01.2018;2018;01;04;Sunnuntai;1;0;1;0;0;0
293;07.01.2018;2018;01;05;Sunnuntai;0;0;0;1;0;1
293;07.01.2018;2018;01;06;Sunnuntai;0;0;0;2;0;2
293;07.01.2018;2018;01;07;Sunnuntai;0;0;0;3;0;3
293;07.01.2018;2018;01;08;Sunnuntai;1;0;1;1;0;1
293;07.01.2018;2018;01;09;Sunnuntai;3;2;5;2;0;2
293;07.01.2018;2018;01;10;Sunnuntai;2;2;4;7;0;7
293;07.01.2018;2018;01;11;Sunnuntai;2;1;3;10;0;10
293;07.01.2018;2018;01;12;Sunnuntai;3;2;5;16;0;16
293;07.01.2018;2018;01;13;Sunnuntai;1;1;2;16;0;16
293;07.01.2018;2018;01;14;Sunnuntai;4;3;7;16;0;16
293;07.01.2018;2018;01;15;Sunnuntai;2;2;4;10;0;10
293;07.01.2018;2018;01;16;Sunnuntai;5;4;9;13;0;13
293;07.01.2018;2018;01;17;Sunnuntai;4;4;8;9;0;9
293;07.01.2018;2018;01;18;Sunnuntai;5;4;9;8;0;8
293;07.01.2018;2018;01;19;Sunnuntai;4;4;8;11;0;11
293;07.01.2018;2018;01;20;Sunnuntai;2;2;4;8;0;8
293;07.01.2018;2018;01;21;Sunnuntai;2;2;4;7;0;7
293;07.01.2018;2018;01;22;Sunnuntai;0;0;0;8;0;8
293;07.01.2018;2018;01;23;Sunnuntai;0;0;0;14;0;14
293;08.01.2018;2018;01;00;Maanantai;0;0;0;17;0;17
293;08.01.2018;2018;01;01;Maanantai;0;0;0;4;0;4
293;08.01.2018;2018;01;02;Maanantai;0;0;0;9;0;9
293;08.01.2018;2018;01;03;Maanantai;1;0;1;2;0;2
293;08.01.2018;2018;01;04;Maanantai;1;0;1;1;0;1
293;08.01.2018;2018;01;05;Maanantai;1;1;2;1;0;1
293;08.01.2018;2018;01;06;Maanantai;5;5;10;1;0;1
293;08.01.2018;2018;01;07;Maanantai;31;31;62;0;0;0
293;08.01.2018;2018;01;08;Maanantai;32;31;63;0;0;0
293;08.01.2018;2018;01;09;Maanantai;12;12;24;0;0;0
293;08.01.2018;2018;01;10;Maanantai;5;4;9;4;0;4
293;08.01.2018;2018;01;11;Maanantai;2;2;4;12;0;12
293;08.01.2018;2018;01;12;Maanantai;4;4;8;13;1;14
293;08.01.2018;2018;01;13;Maanantai;9;8;17;14;0;14
293;08.01.2018;2018;01;14;Maanantai;18;17;35;12;0;12
293;08.01.2018;2018;01;15;Maanantai;42;42;84;11;0;11
293;08.01.2018;2018;01;16;Maanantai;8;7;15;8;0;8
293;08.01.2018;2018;01;17;Maanantai;4;3;7;11;0;11
293;08.01.2018;2018;01;18;Maanantai;1;1;2;2;0;2
293;08.01.2018;2018;01;19;Maanantai;4;3;7;6;0;6
293;08.01.2018;2018;01;20;Maanantai;2;1;3;6;0;6
293;08.01.2018;2018;01;21;Maanantai;2;2;4;4;0;4
293;08.01.2018;2018;01;22;Maanantai;0;0;0;0;0;0
293;08.01.2018;2018;01;23;Maanantai;1;0;1;0;0;0
293;09.01.2018;2018;01;00;Tiistai;1;0;1;0;0;0
293;09.01.2018;2018;01;01;Tiistai;0;0;0;0;0;0
293;09.01.2018;2018;01;02;Tiistai;0;0;0;0;0;0
293;09.01.2018;2018;01;03;Tiistai;1;1;2;0;0;0
293;09.01.2018;2018;01;04;Tiistai;0;0;0;0;0;0
293;09.01.2018;2018;01;05;Tiistai;1;0;1;1;0;1
293;09.01.2018;2018;01;06;Tiistai;4;3;7;0;0;0
293;09.01.2018;2018;01;07;Tiistai;45;44;89;1;0;1
293;09.01.2018;2018;01;08;Tiistai;27;27;54;4;0;4
293;09.01.2018;2018;01;09;Tiistai;14;13;27;4;0;4
293;09.01.2018;2018;01;10;Tiistai;6;6;12;4;0;4
293;09.01.2018;2018;01;11;Tiistai;2;1;3;7;0;7
293;09.01.2018;2018;01;12;Tiistai;5;4;9;17;0;17
293;09.01.2018;2018;01;13;Tiistai;17;17;34;9;0;9
293;09.01.2018;2018;01;14;Tiistai;28;27;55;20;0;20
293;09.01.2018;2018;01;15;Tiistai;37;36;73;9;0;9
293;09.01.2018;2018;01;16;Tiistai;13;13;26;13;0;13
293;09.01.2018;2018;01;17;Tiistai;9;9;18;28;0;28
293;09.01.2018;2018;01;18;Tiistai;7;6;13;16;0;16
293;09.01.2018;2018;01;19;Tiistai;7;6;13;9;0;9
293;09.01.2018;2018;01;20;Tiistai;6;5;11;6;0;6
293;09.01.2018;2018;01;21;Tiistai;1;1;2;2;0;2
293;09.01.2018;2018;01;22;Tiistai;1;1;2;0;0;0
293;09.01.2018;2018;01;23;Tiistai;1;1;2;0;0;0
293;10.01.2018;2018;01;00;Keskiviikko;0;0;0;0;0;0
293;10.01.2018;2018;01;01;Keskiviikko;0;0;0;0;0;0
293;10.01.2018;2018;01;02;Keskiviikko;0;0;0;0;0;0
293;10.01.2018;2018;01;03;Keskiviikko;1;0;1;0;0;0
293;10.01.2018;2018;01;04;Keskiviikko;1;0;1;0;0;0
293;10.01.2018;2018;01;05;Keskiviikko;1;0;1;0;0;0
293;10.01.2018;2018;01;06;Keskiviikko;4;3;7;3;0;3
293;10.01.2018;2018;01;07;Keskiviikko;42;42;84;5;0;5
293;10.01.2018;2018;01;08;Keskiviikko;36;35;71;5;0;5
293;10.01.2018;2018;01;09;Keskiviikko;10;10;20;5;0;5
293;10.01.2018;2018;01;10;Keskiviikko;1;1;2;8;0;8
293;10.01.2018;2018;01;11;Keskiviikko;3;2;5;7;0;7
293;10.01.2018;2018;01;12;Keskiviikko;5;4;9;1;0;1
293;10.01.2018;2018;01;13;Keskiviikko;19;18;37;9;0;9
293;10.01.2018;2018;01;14;Keskiviikko;51;50;101;11;0;11
293;10.01.2018;2018;01;15;Keskiviikko;11;10;21;8;0;8
293;10.01.2018;2018;01;16;Keskiviikko;8;8;16;8;0;8
293;10.01.2018;2018;01;17;Keskiviikko;3;3;6;12;0;12
293;10.01.2018;2018;01;18;Keskiviikko;8;7;15;12;0;12
293;10.01.2018;2018;01;19;Keskiviikko;5;4;9;10;0;10
293;10.01.2018;2018;01;20;Keskiviikko;5;4;9;1;0;1
293;10.01.2018;2018;01;21;Keskiviikko;4;3;7;3;0;3
293;10.01.2018;2018;01;22;Keskiviikko;1;1;2;1;0;1
293;10.01.2018;2018;01;23;Keskiviikko;0;0;0;0;0;0
293;11.01.2018;2018;01;00;Torstai;0;0;0;0;0;0
293;11.01.2018;2018;01;01;Torstai;0;0;0;0;0;0
293;11.01.2018;2018;01;02;Torstai;0;0;0;0;0;0
293;11.01.2018;2018;01;03;Torstai;1;0;1;0;0;0
293;11.01.2018;2018;01;04;Torstai;0;0;0;0;0;0
293;11.01.2018;2018;01;05;Torstai;1;0;1;0;0;0
293;11.01.2018;2018;01;06;Torstai;3;3;6;0;0;0
293;11.01.2018;2018;01;07;Torstai;42;41;83;2;0;2
293;11.01.2018;2018;01;08;Torstai;33;32;65;3;0;3
293;11.01.2018;2018;01;09;Torstai;9;8;17;2;0;2
293;11.01.2018;2018;01;10;Torstai;4;4;8;3;0;3
293;11.01.2018;2018;01;11;Torstai;4;4;8;5;0;5
293;11.01.2018;2018;01;12;Torstai;3;2;5;4;0;4
293;11.01.2018;2018;01;13;Torstai;13;12;25;5;0;5
293;11.01.2018;2018;01;14;Torstai;38;37;75;3;0;3
293;11.01.2018;2018;01;15;Torstai;32;32;64;6;0;6
293;11.01.2018;2018;01;16;Torstai;10;10;20;3;0;3
293;11.01.2018;2018;01;17;Torstai;8;7;15;3;0;3
293;11.01.2018;2018;01;18;Torstai;4;4;8;3;0;3
293;11.01.2018;2018;01;19;Torstai;10;9;19;1;0;1
293;11.01.2018;2018;01;20;Torstai;4;3;7;3;0;3
293;11.01.2018;2018;01;21;Torstai;2;1;3;2;0;2
293;11.01.2018;2018;01;22;Torstai;1;1;2;0;0;0
293;11.01.2018;2018;01;23;Torstai;0;0;0;0;0;0
293;12.01.2018;2018;01;00;Perjantai;3;3;6;0;0;0
293;12.01.2018;2018;01;01;Perjantai;0;0;0;0;0;0
293;12.01.2018;2018;01;02;Perjantai;0;0;0;0;0;0
293;12.01.2018;2018;01;03;Perjantai;1;0;1;0;0;0
293;12.01.2018;2018;01;04;Perjantai;0;0;0;0;0;0
293;12.01.2018;2018;01;05;Perjantai;1;0;1;0;0;0
293;12.01.2018;2018;01;06;Perjantai;5;4;9;13;4;17
293;12.01.2018;2018;01;07;Perjantai;38;28;66;6;0;6
293;12.01.2018;2018;01;08;Perjantai;23;22;45;2;0;2
293;12.01.2018;2018;01;09;Perjantai;8;8;16;2;1;3
293;12.01.2018;2018;01;10;Perjantai;10;9;19;0;0;0
293;12.01.2018;2018;01;11;Perjantai;2;2;4;1;0;1
293;12.01.2018;2018;01;12;Perjantai;6;5;11;0;1;1
293;12.01.2018;2018;01;13;Perjantai;14;14;28;1;1;2
293;12.01.2018;2018;01;14;Perjantai;34;40;74;0;1;1
293;12.01.2018;2018;01;15;Perjantai;17;20;37;1;0;1
293;12.01.2018;2018;01;16;Perjantai;7;6;13;1;1;2
293;12.01.2018;2018;01;17;Perjantai;7;6;13;3;1;4
293;12.01.2018;2018;01;18;Perjantai;9;8;17;2;1;3
293;12.01.2018;2018;01;19;Perjantai;8;9;17;3;0;3
293;12.01.2018;2018;01;20;Perjantai;16;14;30;1;0;1
293;12.01.2018;2018;01;21;Perjantai;6;7;13;0;0;0
293;12.01.2018;2018;01;22;Perjantai;2;2;4;0;0;0
293;12.01.2018;2018;01;23;Perjantai;1;1;2;3;0;3
293;13.01.2018;2018;01;00;Lauantai;0;0;0;0;0;0
293;13.01.2018;2018;01;01;Lauantai;1;1;2;0;2;2
293;13.01.2018;2018;01;02;Lauantai;1;0;1;0;1;1
293;13.01.2018;2018;01;03;Lauantai;0;0;0;0;0;0
293;13.01.2018;2018;01;04;Lauantai;0;0;0;0;0;0
293;13.01.2018;2018;01;05;Lauantai;0;0;0;0;0;0
293;13.01.2018;2018;01;06;Lauantai;1;0;1;0;0;0
293;13.01.2018;2018;01;07;Lauantai;0;0;0;1;0;1
293;13.01.2018;2018;01;08;Lauantai;2;1;3;0;1;1
293;13.01.2018;2018;01;09;Lauantai;5;3;8;2;0;2
293;13.01.2018;2018;01;10;Lauantai;3;2;5;0;0;0
293;13.01.2018;2018;01;11;Lauantai;3;2;5;1;0;1
293;13.01.2018;2018;01;12;Lauantai;5;3;8;1;0;1
293;13.01.2018;2018;01;13;Lauantai;6;6;12;3;1;4
293;13.01.2018;2018;01;14;Lauantai;6;4;10;4;1;5
293;13.01.2018;2018;01;15;Lauantai;8;6;14;0;0;0
293;13.01.2018;2018;01;16;Lauantai;6;6;12;3;1;4
293;13.01.2018;2018;01;17;Lauantai;5;4;9;1;0;1
293;13.01.2018;2018;01;18;Lauantai;4;4;8;0;2;2
293;13.01.2018;2018;01;19;Lauantai;5;4;9;1;1;2
293;13.01.2018;2018;01;20;Lauantai;2;2;4;1;2;3
293;13.01.2018;2018;01;21;Lauantai;2;3;5;0;1;1
293;13.01.2018;2018;01;22;Lauantai;2;1;3;0;0;0
293;13.01.2018;2018;01;23;Lauantai;2;1;3;1;0;1
293;14.01.2018;2018;01;00;Sunnuntai;0;0;0;1;0;1
293;14.01.2018;2018;01;01;Sunnuntai;0;0;0;0;0;0
293;14.01.2018;2018;01;02;Sunnuntai;1;0;1;0;2;2
293;14.01.2018;2018;01;03;Sunnuntai;0;2;2;0;0;0
293;14.01.2018;2018;01;04;Sunnuntai;0;0;0;0;0;0
293;14.01.2018;2018;01;05;Sunnuntai;0;0;0;0;0;0
293;14.01.2018;2018;01;06;Sunnuntai;1;0;1;1;0;1
293;14.01.2018;2018;01;07;Sunnuntai;1;0;1;0;0;0
293;14.01.2018;2018;01;08;Sunnuntai;1;1;2;0;0;0
293;14.01.2018;2018;01;09;Sunnuntai;12;12;24;0;0;0
293;14.01.2018;2018;01;10;Sunnuntai;4;3;7;0;1;1
293;14.01.2018;2018;01;11;Sunnuntai;8;7;15;3;0;3
293;14.01.2018;2018;01;12;Sunnuntai;7;7;14;2;2;4
293;14.01.2018;2018;01;13;Sunnuntai;3;6;9;1;1;2
293;14.01.2018;2018;01;14;Sunnuntai;5;4;9;2;2;4
293;14.01.2018;2018;01;15;Sunnuntai;4;3;7;3;1;4
293;14.01.2018;2018;01;16;Sunnuntai;4;3;7;2;0;2
293;14.01.2018;2018;01;17;Sunnuntai;6;5;11;3;2;5
293;14.01.2018;2018;01;18;Sunnuntai;5;5;10;0;1;1
293;14.01.2018;2018;01;19;Sunnuntai;3;2;5;1;1;2
293;14.01.2018;2018;01;20;Sunnuntai;3;3;6;1;1;2
293;14.01.2018;2018;01;21;Sunnuntai;0;0;0;0;0;0
293;14.01.2018;2018;01;22;Sunnuntai;1;0;1;0;0;0
293;14.01.2018;2018;01;23;Sunnuntai;0;0;0;1;0;1
293;15.01.2018;2018;01;00;Maanantai;0;0;0;0;0;0
293;15.01.2018;2018;01;01;Maanantai;0;0;0;0;0;0
293;15.01.2018;2018;01;02;Maanantai;0;0;0;0;0;0
293;15.01.2018;2018;01;03;Maanantai;0;0;0;0;0;0
293;15.01.2018;2018;01;04;Maanantai;0;0;0;0;0;0
293;15.01.2018;2018;01;05;Maanantai;1;0;1;0;0;0
293;15.01.2018;2018;01;06;Maanantai;5;4;9;0;1;1
293;15.01.2018;2018;01;07;Maanantai;32;23;55;4;1;5
293;15.01.2018;2018;01;08;Maanantai;55;40;95;5;0;5
293;15.01.2018;2018;01;09;Maanantai;13;11;24;4;1;5
293;15.01.2018;2018;01;10;Maanantai;6;3;9;4;1;5
293;15.01.2018;2018;01;11;Maanantai;4;4;8;1;0;1
293;15.01.2018;2018;01;12;Maanantai;7;6;13;0;1;1
293;15.01.2018;2018;01;13;Maanantai;8;10;18;0;0;0
293;15.01.2018;2018;01;14;Maanantai;34;27;61;4;1;5
293;15.01.2018;2018;01;15;Maanantai;33;50;83;4;0;4
293;15.01.2018;2018;01;16;Maanantai;12;9;21;1;0;1
293;15.01.2018;2018;01;17;Maanantai;5;4;9;4;3;7
293;15.01.2018;2018;01;18;Maanantai;7;5;12;3;1;4
293;15.01.2018;2018;01;19;Maanantai;4;4;8;1;1;2
293;15.01.2018;2018;01;20;Maanantai;4;3;7;0;0;0
293;15.01.2018;2018;01;21;Maanantai;1;2;3;0;0;0
293;15.01.2018;2018;01;22;Maanantai;0;0;0;0;0;0
293;15.01.2018;2018;01;23;Maanantai;0;0;0;1;1;2
293;16.01.2018;2018;01;00;Tiistai;0;0;0;0;0;0
293;16.01.2018;2018;01;01;Tiistai;0;0;0;0;0;0
293;16.01.2018;2018;01;02;Tiistai;0;0;0;0;0;0
293;16.01.2018;2018;01;03;Tiistai;1;0;1;0;0;0
293;16.01.2018;2018;01;04;Tiistai;0;0;0;0;0;0
293;16.01.2018;2018;01;05;Tiistai;1;0;1;0;0;0
293;16.01.2018;2018;01;06;Tiistai;4;3;7;1;0;1
293;16.01.2018;2018;01;07;Tiistai;55;17;72;5;1;6
293;16.01.2018;2018;01;08;Tiistai;68;11;79;4;1;5
293;16.01.2018;2018;01;09;Tiistai;22;6;28;0;1;1
293;16.01.2018;2018;01;10;Tiistai;3;4;7;3;1;4
293;16.01.2018;2018;01;11;Tiistai;2;2;4;0;0;0
293;16.01.2018;2018;01;12;Tiistai;7;9;16;0;1;1
293;16.01.2018;2018;01;13;Tiistai;5;20;25;6;6;12
293;16.01.2018;2018;01;14;Tiistai;8;44;52;2;15;17
293;16.01.2018;2018;01;15;Tiistai;13;50;63;3;9;12
293;16.01.2018;2018;01;16;Tiistai;8;11;19;3;4;7
293;16.01.2018;2018;01;17;Tiistai;5;4;9;4;5;9
293;16.01.2018;2018;01;18;Tiistai;5;12;17;7;6;13
293;16.01.2018;2018;01;19;Tiistai;4;2;6;3;4;7
293;16.01.2018;2018;01;20;Tiistai;3;4;7;1;1;2
293;16.01.2018;2018;01;21;Tiistai;2;1;3;0;0;0
293;16.01.2018;2018;01;22;Tiistai;0;0;0;0;0;0
293;16.01.2018;2018;01;23;Tiistai;0;0;0;0;0;0
293;17.01.2018;2018;01;00;Keskiviikko;0;0;0;0;0;0
293;17.01.2018;2018;01;01;Keskiviikko;0;0;0;0;0;0
293;17.01.2018;2018;01;02;Keskiviikko;0;0;0;0;0;0
293;17.01.2018;2018;01;03;Keskiviikko;1;0;1;0;0;0
293;17.01.2018;2018;01;04;Keskiviikko;0;1;1;0;0;0
293;17.01.2018;2018;01;05;Keskiviikko;1;0;1;0;1;1
293;17.01.2018;2018;01;06;Keskiviikko;2;3;5;0;0;0
293;17.01.2018;2018;01;07;Keskiviikko;70;7;77;9;2;11
293;17.01.2018;2018;01;08;Keskiviikko;57;9;66;11;0;11
293;17.01.2018;2018;01;09;Keskiviikko;18;0;18;2;0;2
293;17.01.2018;2018;01;10;Keskiviikko;4;1;5;1;3;4
293;17.01.2018;2018;01;11;Keskiviikko;5;3;8;5;3;8
293;17.01.2018;2018;01;12;Keskiviikko;5;9;14;5;3;8
293;17.01.2018;2018;01;13;Keskiviikko;6;26;32;9;8;17
293;17.01.2018;2018;01;14;Keskiviikko;10;71;81;3;20;23
293;17.01.2018;2018;01;15;Keskiviikko;9;14;23;3;13;16
293;17.01.2018;2018;01;16;Keskiviikko;6;18;24;3;2;5
293;17.01.2018;2018;01;17;Keskiviikko;7;6;13;10;3;13
293;17.01.2018;2018;01;18;Keskiviikko;1;5;6;5;4;9
293;17.01.2018;2018;01;19;Keskiviikko;3;6;9;4;6;10
293;17.01.2018;2018;01;20;Keskiviikko;1;4;5;0;3;3
293;17.01.2018;2018;01;21;Keskiviikko;1;2;3;1;2;3
293;17.01.2018;2018;01;22;Keskiviikko;0;1;1;0;0;0
293;17.01.2018;2018;01;23;Keskiviikko;0;0;0;0;0;0
293;18.01.2018;2018;01;00;Torstai;0;0;0;0;0;0
293;18.01.2018;2018;01;01;Torstai;0;0;0;0;0;0
293;18.01.2018;2018;01;02;Torstai;0;0;0;0;0;0
293;18.01.2018;2018;01;03;Torstai;1;0;1;0;0;0
293;18.01.2018;2018;01;04;Torstai;0;0;0;0;0;0
293;18.01.2018;2018;01;05;Torstai;1;0;1;0;0;0
293;18.01.2018;2018;01;06;Torstai;5;1;6;1;0;1
293;18.01.2018;2018;01;07;Torstai;68;7;75;7;3;10
293;18.01.2018;2018;01;08;Torstai;74;2;76;7;1;8
293;18.01.2018;2018;01;09;Torstai;17;2;19;7;3;10
293;18.01.2018;2018;01;10;Torstai;8;6;14;5;4;9
293;18.01.2018;2018;01;11;Torstai;5;6;11;4;4;8
293;18.01.2018;2018;01;12;Torstai;4;5;9;5;4;9
293;18.01.2018;2018;01;13;Torstai;3;20;23;2;7;9
293;18.01.2018;2018;01;14;Torstai;7;48;55;4;11;15
293;18.01.2018;2018;01;15;Torstai;7;58;65;3;12;15
293;18.01.2018;2018;01;16;Torstai;8;16;24;2;6;8
293;18.01.2018;2018;01;17;Torstai;2;6;8;3;8;11
293;18.01.2018;2018;01;18;Torstai;5;9;14;5;9;14
293;18.01.2018;2018;01;19;Torstai;2;8;10;4;3;7
293;18.01.2018;2018;01;20;Torstai;2;2;4;0;2;2
293;18.01.2018;2018;01;21;Torstai;2;1;3;1;3;4
293;18.01.2018;2018;01;22;Torstai;0;5;5;0;0;0
293;18.01.2018;2018;01;23;Torstai;1;0;1;0;0;0
293;19.01.2018;2018;01;00;Perjantai;0;0;0;0;0;0
293;19.01.2018;2018;01;01;Perjantai;1;1;2;0;0;0
293;19.01.2018;2018;01;02;Perjantai;0;0;0;0;0;0
293;19.01.2018;2018;01;03;Perjantai;1;0;1;0;0;0
293;19.01.2018;2018;01;04;Perjantai;0;0;0;0;0;0
293;19.01.2018;2018;01;05;Perjantai;1;0;1;0;0;0
293;19.01.2018;2018;01;06;Perjantai;5;1;6;1;0;1
293;19.01.2018;2018;01;07;Perjantai;70;3;73;6;2;8
293;19.01.2018;2018;01;08;Perjantai;44;2;46;7;1;8
293;19.01.2018;2018;01;09;Perjantai;28;3;31;7;0;7
293;19.01.2018;2018;01;10;Perjantai;12;3;15;8;2;10
293;19.01.2018;2018;01;11;Perjantai;1;3;4;2;6;8
293;19.01.2018;2018;01;12;Perjantai;5;12;17;5;4;9
293;19.01.2018;2018;01;13;Perjantai;2;39;41;4;11;15
293;19.01.2018;2018;01;14;Perjantai;6;72;78;2;12;14
293;19.01.2018;2018;01;15;Perjantai;2;24;26;1;10;11
293;19.01.2018;2018;01;16;Perjantai;2;12;14;1;4;5
293;19.01.2018;2018;01;17;Perjantai;6;2;8;2;5;7
293;19.01.2018;2018;01;18;Perjantai;1;2;3;1;4;5
293;19.01.2018;2018;01;19;Perjantai;1;5;6;3;3;6
293;19.01.2018;2018;01;20;Perjantai;4;0;4;1;2;3
293;19.01.2018;2018;01;21;Perjantai;3;4;7;0;0;0
293;19.01.2018;2018;01;22;Perjantai;0;1;1;0;0;0
293;19.01.2018;2018;01;23;Perjantai;0;1;1;0;0;0
293;20.01.2018;2018;01;00;Lauantai;0;0;0;0;0;0
293;20.01.2018;2018;01;01;Lauantai;0;0;0;1;0;1
293;20.01.2018;2018;01;02;Lauantai;0;0;0;0;1;1
293;20.01.2018;2018;01;03;Lauantai;0;0;0;0;1;1
293;20.01.2018;2018;01;04;Lauantai;0;0;0;0;0;0
293;20.01.2018;2018;01;05;Lauantai;0;0;0;1;0;1
293;20.01.2018;2018;01;06;Lauantai;0;0;0;0;1;1
293;20.01.2018;2018;01;07;Lauantai;0;0;0;0;1;1
293;20.01.2018;2018;01;08;Lauantai;1;0;1;1;0;1
293;20.01.2018;2018;01;09;Lauantai;3;1;4;8;4;12
293;20.01.2018;2018;01;10;Lauantai;2;4;6;7;5;12
293;20.01.2018;2018;01;11;Lauantai;0;3;3;9;29;38
293;20.01.2018;2018;01;12;Lauantai;2;0;2;8;11;19
293;20.01.2018;2018;01;13;Lauantai;6;0;6;9;11;20
293;20.01.2018;2018;01;14;Lauantai;2;4;6;1;4;5
293;20.01.2018;2018;01;15;Lauantai;3;4;7;2;5;7
293;20.01.2018;2018;01;16;Lauantai;2;6;8;6;4;10
293;20.01.2018;2018;01;17;Lauantai;3;3;6;11;10;21
293;20.01.2018;2018;01;18;Lauantai;4;6;10;2;4;6
293;20.01.2018;2018;01;19;Lauantai;4;5;9;6;7;13
293;20.01.2018;2018;01;20;Lauantai;2;4;6;2;1;3
293;20.01.2018;2018;01;21;Lauantai;6;3;9;2;1;3
293;20.01.2018;2018;01;22;Lauantai;0;0;0;0;0;0
293;20.01.2018;2018;01;23;Lauantai;0;1;1;0;0;0
293;21.01.2018;2018;01;00;Sunnuntai;0;0;0;0;0;0
293;21.01.2018;2018;01;01;Sunnuntai;0;0;0;0;1;1
293;21.01.2018;2018;01;02;Sunnuntai;1;0;1;0;0;0
293;21.01.2018;2018;01;03;Sunnuntai;0;0;0;0;1;1
293;21.01.2018;2018;01;04;Sunnuntai;0;0;0;0;0;0
293;21.01.2018;2018;01;05;Sunnuntai;0;0;0;0;0;0
293;21.01.2018;2018;01;06;Sunnuntai;3;0;3;1;0;1
293;21.01.2018;2018;01;07;Sunnuntai;0;0;0;0;2;2
293;21.01.2018;2018;01;08;Sunnuntai;0;0;0;1;1;2
293;21.01.2018;2018;01;09;Sunnuntai;8;1;9;5;1;6
293;21.01.2018;2018;01;10;Sunnuntai;2;1;3;3;1;4
293;21.01.2018;2018;01;11;Sunnuntai;2;6;8;6;7;13
293;21.01.2018;2018;01;12;Sunnuntai;4;9;13;13;11;24
293;21.01.2018;2018;01;13;Sunnuntai;1;1;2;7;6;13
293;21.01.2018;2018;01;14;Sunnuntai;1;4;5;3;5;8
293;21.01.2018;2018;01;15;Sunnuntai;2;5;7;5;5;10
293;21.01.2018;2018;01;16;Sunnuntai;1;2;3;5;3;8
293;21.01.2018;2018;01;17;Sunnuntai;0;2;2;1;0;1
293;21.01.2018;2018;01;18;Sunnuntai;3;1;4;9;5;14
293;21.01.2018;2018;01;19;Sunnuntai;1;0;1;1;5;6
293;21.01.2018;2018;01;20;Sunnuntai;5;3;8;1;5;6
293;21.01.2018;2018;01;21;Sunnuntai;1;0;1;1;1;2
293;21.01.2018;2018;01;22;Sunnuntai;0;0;0;0;0;0
293;21.01.2018;2018;01;23;Sunnuntai;0;0;0;0;0;0
293;22.01.2018;2018;01;00;Maanantai;0;0;0;0;0;0
293;22.01.2018;2018;01;01;Maanantai;0;0;0;0;0;0
293;22.01.2018;2018;01;02;Maanantai;0;0;0;0;0;0
293;22.01.2018;2018;01;03;Maanantai;0;1;1;0;0;0
293;22.01.2018;2018;01;04;Maanantai;0;0;0;0;0;0
293;22.01.2018;2018;01;05;Maanantai;2;0;2;0;0;0
293;22.01.2018;2018;01;06;Maanantai;3;1;4;2;0;2
293;22.01.2018;2018;01;07;Maanantai;49;1;50;9;1;10
293;22.01.2018;2018;01;08;Maanantai;67;3;70;8;0;8
293;22.01.2018;2018;01;09;Maanantai;17;2;19;4;4;8
293;22.01.2018;2018;01;10;Maanantai;8;0;8;4;0;4
293;22.01.2018;2018;01;11;Maanantai;4;3;7;3;0;3
293;22.01.2018;2018;01;12;Maanantai;2;7;9;3;3;6
293;22.01.2018;2018;01;13;Maanantai;0;13;13;5;3;8
293;22.01.2018;2018;01;14;Maanantai;2;38;40;7;11;18
293;22.01.2018;2018;01;15;Maanantai;2;63;65;1;16;17
293;22.01.2018;2018;01;16;Maanantai;3;10;13;2;6;8
293;22.01.2018;2018;01;17;Maanantai;1;6;7;3;2;5
293;22.01.2018;2018;01;18;Maanantai;2;1;3;3;3;6
293;22.01.2018;2018;01;19;Maanantai;3;2;5;1;2;3
293;22.01.2018;2018;01;20;Maanantai;0;1;1;2;3;5
293;22.01.2018;2018;01;21;Maanantai;0;0;0;2;3;5
293;22.01.2018;2018;01;22;Maanantai;0;0;0;0;1;1
293;22.01.2018;2018;01;23;Maanantai;0;0;0;0;0;0
293;23.01.2018;2018;01;00;Tiistai;0;0;0;0;0;0
293;23.01.2018;2018;01;01;Tiistai;0;0;0;0;0;0
293;23.01.2018;2018;01;02;Tiistai;0;0;0;0;0;0
293;23.01.2018;2018;01;03;Tiistai;1;1;2;0;0;0
293;23.01.2018;2018;01;04;Tiistai;0;0;0;0;0;0
293;23.01.2018;2018;01;05;Tiistai;1;0;1;1;0;1
293;23.01.2018;2018;01;06;Tiistai;3;2;5;2;0;2
293;23.01.2018;2018;01;07;Tiistai;47;1;48;11;0;11
293;23.01.2018;2018;01;08;Tiistai;40;3;43;12;2;14
293;23.01.2018;2018;01;09;Tiistai;22;1;23;4;3;7
293;23.01.2018;2018;01;10;Tiistai;10;0;10;0;2;2
293;23.01.2018;2018;01;11;Tiistai;1;2;3;7;4;11
293;23.01.2018;2018;01;12;Tiistai;3;4;7;3;3;6
293;23.01.2018;2018;01;13;Tiistai;2;19;21;6;12;18
293;23.01.2018;2018;01;14;Tiistai;1;41;42;2;13;15
293;23.01.2018;2018;01;15;Tiistai;3;48;51;5;20;25
293;23.01.2018;2018;01;16;Tiistai;3;9;12;5;7;12
293;23.01.2018;2018;01;17;Tiistai;4;1;5;5;6;11
293;23.01.2018;2018;01;18;Tiistai;4;5;9;2;4;6
293;23.01.2018;2018;01;19;Tiistai;2;3;5;3;7;10
293;23.01.2018;2018;01;20;Tiistai;0;2;2;2;2;4
293;23.01.2018;2018;01;21;Tiistai;1;1;2;0;0;0
293;23.01.2018;2018;01;22;Tiistai;1;0;1;0;0;0
293;23.01.2018;2018;01;23;Tiistai;0;0;0;0;0;0
293;24.01.2018;2018;01;00;Keskiviikko;0;0;0;0;0;0
293;24.01.2018;2018;01;01;Keskiviikko;0;0;0;0;0;0
293;24.01.2018;2018;01;02;Keskiviikko;0;0;0;0;0;0
293;24.01.2018;2018;01;03;Keskiviikko;0;1;1;0;0;0
293;24.01.2018;2018;01;04;Keskiviikko;1;0;1;0;0;0
293;24.01.2018;2018;01;05;Keskiviikko;1;0;1;0;0;0
293;24.01.2018;2018;01;06;Keskiviikko;4;1;5;1;0;1
293;24.01.2018;2018;01;07;Keskiviikko;75;1;76;9;1;10
293;24.01.2018;2018;01;08;Keskiviikko;79;4;83;10;1;11
293;24.01.2018;2018;01;09;Keskiviikko;15;2;17;3;1;4
293;24.01.2018;2018;01;10;Keskiviikko;3;1;4;2;5;7
293;24.01.2018;2018;01;11;Keskiviikko;2;1;3;3;5;8
293;24.01.2018;2018;01;12;Keskiviikko;9;0;9;5;1;6
293;24.01.2018;2018;01;13;Keskiviikko;29;2;31;11;0;11
293;24.01.2018;2018;01;14;Keskiviikko;97;1;98;21;0;21
293;24.01.2018;2018;01;15;Keskiviikko;10;4;14;8;0;8
293;24.01.2018;2018;01;16;Keskiviikko;11;10;21;8;0;8
293;24.01.2018;2018;01;17;Keskiviikko;7;6;13;5;0;5
293;24.01.2018;2018;01;18;Keskiviikko;6;5;11;6;0;6
293;24.01.2018;2018;01;19;Keskiviikko;4;4;8;3;0;3
293;24.01.2018;2018;01;20;Keskiviikko;2;1;3;5;0;5
293;24.01.2018;2018;01;21;Keskiviikko;1;1;2;5;0;5
293;24.01.2018;2018;01;22;Keskiviikko;0;0;0;1;0;1
293;24.01.2018;2018;01;23;Keskiviikko;0;0;0;0;0;0
293;25.01.2018;2018;01;00;Torstai;0;0;0;0;0;0
293;25.01.2018;2018;01;01;Torstai;0;0;0;0;0;0
293;25.01.2018;2018;01;02;Torstai;0;0;0;0;0;0
293;25.01.2018;2018;01;03;Torstai;1;0;1;0;0;0
293;25.01.2018;2018;01;04;Torstai;1;0;1;0;0;0
293;25.01.2018;2018;01;05;Torstai;0;0;0;0;0;0
293;25.01.2018;2018;01;06;Torstai;1;1;2;2;0;2
293;25.01.2018;2018;01;07;Torstai;28;27;55;10;0;10
293;25.01.2018;2018;01;08;Torstai;28;27;55;8;0;8
293;25.01.2018;2018;01;09;Torstai;9;8;17;8;0;8
293;25.01.2018;2018;01;10;Torstai;6;5;11;4;0;4
293;25.01.2018;2018;01;11;Torstai;3;2;5;3;0;3
293;25.01.2018;2018;01;12;Torstai;3;2;5;6;0;6
293;25.01.2018;2018;01;13;Torstai;4;17;21;3;4;7
293;25.01.2018;2018;01;14;Torstai;5;51;56;4;7;11
293;25.01.2018;2018;01;15;Torstai;3;42;45;3;9;12
293;25.01.2018;2018;01;16;Torstai;4;6;10;4;3;7
293;25.01.2018;2018;01;17;Torstai;2;2;4;2;1;3
293;25.01.2018;2018;01;18;Torstai;1;1;2;2;1;3
293;25.01.2018;2018;01;19;Torstai;1;3;4;2;2;4
293;25.01.2018;2018;01;20;Torstai;2;1;3;0;1;1
293;25.01.2018;2018;01;21;Torstai;1;1;2;0;0;0
293;25.01.2018;2018;01;22;Torstai;0;0;0;0;0;0
293;25.01.2018;2018;01;23;Torstai;0;0;0;0;0;0
293;26.01.2018;2018;01;00;Perjantai;0;0;0;0;0;0
293;26.01.2018;2018;01;01;Perjantai;0;0;0;0;1;1
293;26.01.2018;2018;01;02;Perjantai;0;0;0;0;0;0
293;26.01.2018;2018;01;03;Perjantai;1;0;1;0;0;0
293;26.01.2018;2018;01;04;Perjantai;0;0;0;0;0;0
293;26.01.2018;2018;01;05;Perjantai;1;0;1;0;0;0
293;26.01.2018;2018;01;06;Perjantai;2;1;3;1;0;1
293;26.01.2018;2018;01;07;Perjantai;44;9;53;12;0;12
293;26.01.2018;2018;01;08;Perjantai;51;2;53;8;2;10
293;26.01.2018;2018;01;09;Perjantai;10;1;11;7;1;8
293;26.01.2018;2018;01;10;Perjantai;11;0;11;2;1;3
293;26.01.2018;2018;01;11;Perjantai;0;7;7;6;5;11
293;26.01.2018;2018;01;12;Perjantai;5;13;18;3;3;6
293;26.01.2018;2018;01;13;Perjantai;6;30;36;2;12;14
293;26.01.2018;2018;01;14;Perjantai;3;49;52;7;16;23
293;26.01.2018;2018;01;15;Perjantai;3;25;28;14;23;37
293;26.01.2018;2018;01;16;Perjantai;3;8;11;0;4;4
293;26.01.2018;2018;01;17;Perjantai;8;4;12;4;5;9
293;26.01.2018;2018;01;18;Perjantai;3;9;12;5;3;8
293;26.01.2018;2018;01;19;Perjantai;7;5;12;3;6;9
293;26.01.2018;2018;01;20;Perjantai;1;6;7;0;1;1
293;26.01.2018;2018;01;21;Perjantai;1;0;1;0;4;4
293;26.01.2018;2018;01;22;Perjantai;5;0;5;2;2;4
293;26.01.2018;2018;01;23;Perjantai;0;1;1;1;0;1
293;27.01.2018;2018;01;00;Lauantai;0;0;0;1;1;2
293;27.01.2018;2018;01;01;Lauantai;0;0;0;1;1;2
293;27.01.2018;2018;01;02;Lauantai;0;0;0;0;0;0
293;27.01.2018;2018;01;03;Lauantai;0;0;0;0;0;0
293;27.01.2018;2018;01;04;Lauantai;1;0;1;0;1;1
293;27.01.2018;2018;01;05;Lauantai;0;0;0;0;0;0
293;27.01.2018;2018;01;06;Lauantai;1;0;1;0;0;0
293;27.01.2018;2018;01;07;Lauantai;1;0;1;0;0;0
293;27.01.2018;2018;01;08;Lauantai;2;0;2;2;0;2
293;27.01.2018;2018;01;09;Lauantai;3;5;8;4;6;10
293;27.01.2018;2018;01;10;Lauantai;2;0;2;6;4;10
293;27.01.2018;2018;01;11;Lauantai;1;1;2;7;8;15
293;27.01.2018;2018;01;12;Lauantai;2;2;4;8;4;12
293;27.01.2018;2018;01;13;Lauantai;3;3;6;10;12;22
293;27.01.2018;2018;01;14;Lauantai;5;4;9;9;5;14
293;27.01.2018;2018;01;15;Lauantai;0;1;1;9;7;16
293;27.01.2018;2018;01;16;Lauantai;1;7;8;5;6;11
293;27.01.2018;2018;01;17;Lauantai;8;3;11;7;4;11
293;27.01.2018;2018;01;18;Lauantai;6;2;8;3;11;14
293;27.01.2018;2018;01;19;Lauantai;3;6;9;4;2;6
293;27.01.2018;2018;01;20;Lauantai;1;4;5;0;3;3
293;27.01.2018;2018;01;21;Lauantai;1;0;1;0;1;1
293;27.01.2018;2018;01;22;Lauantai;2;3;5;0;1;1
293;27.01.2018;2018;01;23;Lauantai;2;0;2;3;0;3
293;28.01.2018;2018;01;00;Sunnuntai;0;0;0;1;0;1
293;28.01.2018;2018;01;01;Sunnuntai;1;0;1;0;3;3
293;28.01.2018;2018;01;02;Sunnuntai;0;0;0;0;0;0
293;28.01.2018;2018;01;03;Sunnuntai;0;0;0;5;1;6
293;28.01.2018;2018;01;04;Sunnuntai;0;0;0;1;1;2
293;28.01.2018;2018;01;05;Sunnuntai;0;0;0;0;1;1
293;28.01.2018;2018;01;06;Sunnuntai;0;0;0;0;0;0
293;28.01.2018;2018;01;07;Sunnuntai;0;0;0;0;0;0
293;28.01.2018;2018;01;08;Sunnuntai;1;0;1;2;1;3
293;28.01.2018;2018;01;09;Sunnuntai;9;0;9;8;6;14
293;28.01.2018;2018;01;10;Sunnuntai;4;1;5;9;7;16
293;28.01.2018;2018;01;11;Sunnuntai;5;5;10;7;11;18
293;28.01.2018;2018;01;12;Sunnuntai;3;11;14;10;6;16
293;28.01.2018;2018;01;13;Sunnuntai;4;2;6;13;9;22
293;28.01.2018;2018;01;14;Sunnuntai;4;5;9;10;17;27
293;28.01.2018;2018;01;15;Sunnuntai;2;5;7;8;7;15
293;28.01.2018;2018;01;16;Sunnuntai;5;2;7;6;6;12
293;28.01.2018;2018;01;17;Sunnuntai;1;2;3;10;5;15
293;28.01.2018;2018;01;18;Sunnuntai;5;3;8;3;1;4
293;28.01.2018;2018;01;19;Sunnuntai;1;4;5;1;0;1
293;28.01.2018;2018;01;20;Sunnuntai;0;1;1;0;2;2
293;28.01.2018;2018;01;21;Sunnuntai;1;0;1;2;0;2
293;28.01.2018;2018;01;22;Sunnuntai;0;0;0;0;0;0
293;28.01.2018;2018;01;23;Sunnuntai;0;0;0;0;0;0
293;29.01.2018;2018;01;00;Maanantai;0;0;0;0;0;0
293;29.01.2018;2018;01;01;Maanantai;0;0;0;0;0;0
293;29.01.2018;2018;01;02;Maanantai;0;0;0;0;0;0
293;29.01.2018;2018;01;03;Maanantai;0;1;1;0;0;0
293;29.01.2018;2018;01;04;Maanantai;0;0;0;0;0;0
293;29.01.2018;2018;01;05;Maanantai;1;0;1;0;0;0
293;29.01.2018;2018;01;06;Maanantai;6;1;7;1;0;1
293;29.01.2018;2018;01;07;Maanantai;42;2;44;10;4;14
293;29.01.2018;2018;01;08;Maanantai;100;5;105;12;2;14
293;29.01.2018;2018;01;09;Maanantai;19;3;22;5;3;8
293;29.01.2018;2018;01;10;Maanantai;8;1;9;1;4;5
293;29.01.2018;2018;01;11;Maanantai;1;11;12;1;5;6
293;29.01.2018;2018;01;12;Maanantai;6;5;11;1;6;7
293;29.01.2018;2018;01;13;Maanantai;0;14;14;4;9;13
293;29.01.2018;2018;01;14;Maanantai;7;38;45;7;10;17
293;29.01.2018;2018;01;15;Maanantai;4;78;82;4;17;21
293;29.01.2018;2018;01;16;Maanantai;5;16;21;5;5;10
293;29.01.2018;2018;01;17;Maanantai;5;7;12;11;8;19
293;29.01.2018;2018;01;18;Maanantai;4;4;8;8;12;20
293;29.01.2018;2018;01;19;Maanantai;7;5;12;1;7;8
293;29.01.2018;2018;01;20;Maanantai;2;3;5;4;6;10
293;29.01.2018;2018;01;21;Maanantai;0;3;3;1;0;1
293;29.01.2018;2018;01;22;Maanantai;0;0;0;0;0;0
293;29.01.2018;2018;01;23;Maanantai;0;0;0;1;2;3
293;30.01.2018;2018;01;00;Tiistai;0;0;0;0;0;0
293;30.01.2018;2018;01;01;Tiistai;0;0;0;0;0;0
293;30.01.2018;2018;01;02;Tiistai;0;0;0;0;0;0
293;30.01.2018;2018;01;03;Tiistai;1;0;1;0;1;1
293;30.01.2018;2018;01;04;Tiistai;0;0;0;0;0;0
293;30.01.2018;2018;01;05;Tiistai;1;0;1;0;0;0
293;30.01.2018;2018;01;06;Tiistai;5;1;6;2;0;2
293;30.01.2018;2018;01;07;Tiistai;61;4;65;12;1;13
293;30.01.2018;2018;01;08;Tiistai;80;5;85;12;3;15
293;30.01.2018;2018;01;09;Tiistai;21;4;25;3;6;9
293;30.01.2018;2018;01;10;Tiistai;6;4;10;10;3;13
293;30.01.2018;2018;01;11;Tiistai;3;7;10;6;13;19
293;30.01.2018;2018;01;12;Tiistai;2;11;13;5;2;7
293;30.01.2018;2018;01;13;Tiistai;2;23;25;7;13;20
293;30.01.2018;2018;01;14;Tiistai;5;57;62;2;17;19
293;30.01.2018;2018;01;15;Tiistai;5;51;56;1;13;14
293;30.01.2018;2018;01;16;Tiistai;8;9;17;5;11;16
293;30.01.2018;2018;01;17;Tiistai;3;7;10;9;8;17
293;30.01.2018;2018;01;18;Tiistai;3;6;9;4;3;7
293;30.01.2018;2018;01;19;Tiistai;3;2;5;3;8;11
293;30.01.2018;2018;01;20;Tiistai;0;1;1;1;2;3
293;30.01.2018;2018;01;21;Tiistai;1;2;3;0;2;2
293;30.01.2018;2018;01;22;Tiistai;0;0;0;0;0;0
293;30.01.2018;2018;01;23;Tiistai;0;0;0;0;0;0
293;31.01.2018;2018;01;00;Keskiviikko;0;0;0;0;0;0
293;31.01.2018;2018;01;01;Keskiviikko;0;0;0;0;0;0
293;31.01.2018;2018;01;02;Keskiviikko;0;0;0;0;0;0
293;31.01.2018;2018;01;03;Keskiviikko;1;0;1;0;0;0
293;31.01.2018;2018;01;04;Keskiviikko;0;0;0;0;0;0
293;31.01.2018;2018;01;05;Keskiviikko;2;0;2;0;0;0
293;31.01.2018;2018;01;06;Keskiviikko;6;1;7;0;0;0
293;31.01.2018;2018;01;07;Keskiviikko;68;6;74;10;1;11
293;31.01.2018;2018;01;08;Keskiviikko;90;2;92;8;2;10
293;31.01.2018;2018;01;09;Keskiviikko;6;3;9;3;2;5
293;31.01.2018;2018;01;10;Keskiviikko;4;2;6;4;3;7
293;31.01.2018;2018;01;11;Keskiviikko;1;1;2;5;4;9
293;31.01.2018;2018;01;12;Keskiviikko;1;12;13;7;6;13
293;31.01.2018;2018;01;13;Keskiviikko;3;30;33;1;10;11
293;31.01.2018;2018;01;14;Keskiviikko;6;93;99;10;15;25
293;31.01.2018;2018;01;15;Keskiviikko;4;18;22;3;12;15
293;31.01.2018;2018;01;16;Keskiviikko;7;13;20;5;9;14
293;31.01.2018;2018;01;17;Keskiviikko;5;8;13;9;7;16
293;31.01.2018;2018;01;18;Keskiviikko;4;3;7;3;10;13
293;31.01.2018;2018;01;19;Keskiviikko;3;4;7;3;7;10
293;31.01.2018;2018;01;20;Keskiviikko;2;10;12;0;3;3
293;31.01.2018;2018;01;21;Keskiviikko;1;3;4;1;0;1
293;31.01.2018;2018;01;22;Keskiviikko;0;0;0;0;1;1
293;31.01.2018;2018;01;23;Keskiviikko;0;0;0;0;0;0
293;01.02.2018;2018;02;00;Torstai;0;0;0;0;0;0
293;01.02.2018;2018;02;01;Torstai;0;0;0;0;0;0
293;01.02.2018;2018;02;02;Torstai;0;0;0;0;0;0
293;01.02.2018;2018;02;03;Torstai;1;0;1;0;0;0
293;01.02.2018;2018;02;04;Torstai;0;0;0;0;0;0
293;01.02.2018;2018;02;05;Torstai;1;0;1;0;0;0
293;01.02.2018;2018;02;06;Torstai;8;0;8;0;0;0
293;01.02.2018;2018;02;07;Torstai;51;2;53;7;3;10
293;01.02.2018;2018;02;08;Torstai;76;2;78;11;1;12
293;01.02.2018;2018;02;09;Torstai;10;0;10;1;2;3
293;01.02.2018;2018;02;10;Torstai;7;3;10;3;2;5
293;01.02.2018;2018;02;11;Torstai;2;9;11;3;3;6
293;01.02.2018;2018;02;12;Torstai;0;3;3;5;2;7
293;01.02.2018;2018;02;13;Torstai;0;23;23;2;5;7
293;01.02.2018;2018;02;14;Torstai;3;60;63;3;10;13
293;01.02.2018;2018;02;15;Torstai;5;39;44;2;14;16
293;01.02.2018;2018;02;16;Torstai;5;5;10;2;3;5
293;01.02.2018;2018;02;17;Torstai;2;7;9;1;4;5
293;01.02.2018;2018;02;18;Torstai;1;2;3;7;4;11
293;01.02.2018;2018;02;19;Torstai;0;4;4;4;5;9
293;01.02.2018;2018;02;20;Torstai;7;2;9;0;4;4
293;01.02.2018;2018;02;21;Torstai;1;1;2;0;1;1
293;01.02.2018;2018;02;22;Torstai;0;1;1;0;0;0
293;01.02.2018;2018;02;23;Torstai;0;0;0;0;0;0
293;02.02.2018;2018;02;00;Perjantai;1;0;1;0;0;0
293;02.02.2018;2018;02;01;Perjantai;0;0;0;0;0;0
293;02.02.2018;2018;02;02;Perjantai;0;1;1;0;0;0
293;02.02.2018;2018;02;03;Perjantai;1;0;1;0;0;0
293;02.02.2018;2018;02;04;Perjantai;0;0;0;0;0;0
293;02.02.2018;2018;02;05;Perjantai;0;0;0;0;0;0
293;02.02.2018;2018;02;06;Perjantai;8;0;8;0;0;0
293;02.02.2018;2018;02;07;Perjantai;54;2;56;12;2;14
293;02.02.2018;2018;02;08;Perjantai;67;3;70;5;0;5
293;02.02.2018;2018;02;09;Perjantai;14;1;15;4;1;5
293;02.02.2018;2018;02;10;Perjantai;8;6;14;1;2;3
293;02.02.2018;2018;02;11;Perjantai;1;4;5;2;6;8
293;02.02.2018;2018;02;12;Perjantai;3;9;12;6;1;7
293;02.02.2018;2018;02;13;Perjantai;6;19;25;7;14;21
293;02.02.2018;2018;02;14;Perjantai;1;67;68;3;17;20
293;02.02.2018;2018;02;15;Perjantai;4;26;30;2;10;12
293;02.02.2018;2018;02;16;Perjantai;4;6;10;2;3;5
293;02.02.2018;2018;02;17;Perjantai;2;8;10;6;3;9
293;02.02.2018;2018;02;18;Perjantai;3;4;7;4;3;7
293;02.02.2018;2018;02;19;Perjantai;6;6;12;0;5;5
293;02.02.2018;2018;02;20;Perjantai;0;3;3;0;0;0
293;02.02.2018;2018;02;21;Perjantai;0;1;1;0;1;1
293;02.02.2018;2018;02;22;Perjantai;3;0;3;1;0;1
293;02.02.2018;2018;02;23;Perjantai;3;1;4;0;0;0
293;03.02.2018;2018;02;00;Lauantai;0;2;2;0;0;0
293;03.02.2018;2018;02;01;Lauantai;0;0;0;0;0;0
293;03.02.2018;2018;02;02;Lauantai;0;0;0;0;0;0
293;03.02.2018;2018;02;03;Lauantai;0;0;0;0;0;0
293;03.02.2018;2018;02;04;Lauantai;0;0;0;0;0;0
293;03.02.2018;2018;02;05;Lauantai;0;0;0;1;0;1
293;03.02.2018;2018;02;06;Lauantai;2;0;2;0;0;0
293;03.02.2018;2018;02;07;Lauantai;0;0;0;0;0;0
293;03.02.2018;2018;02;08;Lauantai;1;0;1;4;0;4
293;03.02.2018;2018;02;09;Lauantai;2;2;4;4;4;8
293;03.02.2018;2018;02;10;Lauantai;1;1;2;9;3;12
293;03.02.2018;2018;02;11;Lauantai;0;0;0;3;11;14
293;03.02.2018;2018;02;12;Lauantai;3;1;4;8;8;16
293;03.02.2018;2018;02;13;Lauantai;6;4;10;7;4;11
293;03.02.2018;2018;02;14;Lauantai;6;2;8;9;11;20
293;03.02.2018;2018;02;15;Lauantai;0;5;5;2;4;6
293;03.02.2018;2018;02;16;Lauantai;3;4;7;4;7;11
293;03.02.2018;2018;02;17;Lauantai;1;1;2;1;2;3
293;03.02.2018;2018;02;18;Lauantai;4;3;7;1;3;4
293;03.02.2018;2018;02;19;Lauantai;2;4;6;0;2;2
293;03.02.2018;2018;02;20;Lauantai;2;3;5;2;1;3
293;03.02.2018;2018;02;21;Lauantai;4;1;5;1;1;2
293;03.02.2018;2018;02;22;Lauantai;2;3;5;0;1;1
293;03.02.2018;2018;02;23;Lauantai;1;0;1;1;0;1
293;04.02.2018;2018;02;00;Sunnuntai;0;0;0;0;0;0
293;04.02.2018;2018;02;01;Sunnuntai;0;0;0;0;0;0
293;04.02.2018;2018;02;02;Sunnuntai;0;1;1;0;0;0
293;04.02.2018;2018;02;03;Sunnuntai;0;0;0;0;0;0
293;04.02.2018;2018;02;04;Sunnuntai;0;0;0;0;0;0
293;04.02.2018;2018;02;05;Sunnuntai;0;1;1;0;0;0
293;04.02.2018;2018;02;06;Sunnuntai;1;0;1;0;0;0
293;04.02.2018;2018;02;07;Sunnuntai;0;0;0;1;0;1
293;04.02.2018;2018;02;08;Sunnuntai;1;0;1;0;0;0
293;04.02.2018;2018;02;09;Sunnuntai;5;1;6;3;0;3
293;04.02.2018;2018;02;10;Sunnuntai;1;0;1;0;2;2
293;04.02.2018;2018;02;11;Sunnuntai;0;6;6;3;3;6
293;04.02.2018;2018;02;12;Sunnuntai;1;2;3;2;2;4
293;04.02.2018;2018;02;13;Sunnuntai;1;1;2;6;6;12
293;04.02.2018;2018;02;14;Sunnuntai;2;0;2;10;1;11
293;04.02.2018;2018;02;15;Sunnuntai;2;4;6;2;2;4
293;04.02.2018;2018;02;16;Sunnuntai;0;0;0;7;3;10
293;04.02.2018;2018;02;17;Sunnuntai;2;0;2;2;1;3
293;04.02.2018;2018;02;18;Sunnuntai;0;3;3;0;2;2
293;04.02.2018;2018;02;19;Sunnuntai;3;0;3;1;4;5
293;04.02.2018;2018;02;20;Sunnuntai;0;0;0;1;2;3
293;04.02.2018;2018;02;21;Sunnuntai;1;1;2;0;0;0
293;04.02.2018;2018;02;22;Sunnuntai;0;0;0;1;0;1
293;04.02.2018;2018;02;23;Sunnuntai;0;0;0;0;0;0
293;05.02.2018;2018;02;00;Maanantai;0;0;0;0;0;0
293;05.02.2018;2018;02;01;Maanantai;0;0;0;0;0;0
293;05.02.2018;2018;02;02;Maanantai;0;0;0;0;0;0
293;05.02.2018;2018;02;03;Maanantai;0;0;0;0;0;0
293;05.02.2018;2018;02;04;Maanantai;0;0;0;0;0;0
293;05.02.2018;2018;02;05;Maanantai;1;0;1;0;0;0
293;05.02.2018;2018;02;06;Maanantai;2;2;4;4;0;4
293;05.02.2018;2018;02;07;Maanantai;24;1;25;7;3;10
293;05.02.2018;2018;02;08;Maanantai;59;1;60;7;5;12
293;05.02.2018;2018;02;09;Maanantai;17;1;18;6;0;6
293;05.02.2018;2018;02;10;Maanantai;5;0;5;2;1;3
293;05.02.2018;2018;02;11;Maanantai;1;4;5;5;7;12
293;05.02.2018;2018;02;12;Maanantai;6;5;11;5;4;9
293;05.02.2018;2018;02;13;Maanantai;4;16;20;6;13;19
293;05.02.2018;2018;02;14;Maanantai;0;23;23;5;8;13
293;05.02.2018;2018;02;15;Maanantai;2;47;49;0;12;12
293;05.02.2018;2018;02;16;Maanantai;4;7;11;7;6;13
293;05.02.2018;2018;02;17;Maanantai;5;7;12;3;3;6
293;05.02.2018;2018;02;18;Maanantai;1;1;2;0;3;3
293;05.02.2018;2018;02;19;Maanantai;5;2;7;3;5;8
293;05.02.2018;2018;02;20;Maanantai;2;1;3;0;1;1
293;05.02.2018;2018;02;21;Maanantai;1;3;4;0;0;0
293;05.02.2018;2018;02;22;Maanantai;1;0;1;0;0;0
293;05.02.2018;2018;02;23;Maanantai;0;0;0;0;0;0
293;06.02.2018;2018;02;00;Tiistai;0;0;0;0;0;0
293;06.02.2018;2018;02;01;Tiistai;0;0;0;0;0;0
293;06.02.2018;2018;02;02;Tiistai;0;0;0;0;0;0
293;06.02.2018;2018;02;03;Tiistai;1;0;1;0;0;0
293;06.02.2018;2018;02;04;Tiistai;0;0;0;0;0;0
293;06.02.2018;2018;02;05;Tiistai;1;0;1;0;0;0
293;06.02.2018;2018;02;06;Tiistai;7;1;8;5;0;5
293;06.02.2018;2018;02;07;Tiistai;55;2;57;10;3;13
293;06.02.2018;2018;02;08;Tiistai;45;3;48;7;1;8
293;06.02.2018;2018;02;09;Tiistai;26;0;26;3;1;4
293;06.02.2018;2018;02;10;Tiistai;6;2;8;4;1;5
293;06.02.2018;2018;02;11;Tiistai;0;1;1;1;7;8
293;06.02.2018;2018;02;12;Tiistai;2;7;9;4;3;7
293;06.02.2018;2018;02;13;Tiistai;0;20;20;3;10;13
293;06.02.2018;2018;02;14;Tiistai;1;42;43;2;17;19
293;06.02.2018;2018;02;15;Tiistai;2;45;47;4;14;18
293;06.02.2018;2018;02;16;Tiistai;6;7;13;2;6;8
293;06.02.2018;2018;02;17;Tiistai;8;6;14;7;5;12
293;06.02.2018;2018;02;18;Tiistai;4;8;12;7;6;13
293;06.02.2018;2018;02;19;Tiistai;1;3;4;5;5;10
293;06.02.2018;2018;02;20;Tiistai;2;1;3;1;5;6
293;06.02.2018;2018;02;21;Tiistai;0;0;0;1;1;2
293;06.02.2018;2018;02;22;Tiistai;0;0;0;0;0;0
293;06.02.2018;2018;02;23;Tiistai;1;0;1;0;0;0
293;07.02.2018;2018;02;00;Keskiviikko;0;0;0;0;0;0
293;07.02.2018;2018;02;01;Keskiviikko;0;0;0;0;0;0
293;07.02.2018;2018;02;02;Keskiviikko;0;0;0;0;0;0
293;07.02.2018;2018;02;03;Keskiviikko;1;0;1;0;0;0
293;07.02.2018;2018;02;04;Keskiviikko;0;0;0;0;0;0
293;07.02.2018;2018;02;05;Keskiviikko;0;0;0;0;0;0
293;07.02.2018;2018;02;06;Keskiviikko;3;2;5;0;0;0
293;07.02.2018;2018;02;07;Keskiviikko;39;39;78;11;0;11
293;07.02.2018;2018;02;08;Keskiviikko;34;33;67;10;0;10
293;07.02.2018;2018;02;09;Keskiviikko;4;3;7;5;0;5
293;07.02.2018;2018;02;10;Keskiviikko;1;1;2;7;0;7
293;07.02.2018;2018;02;11;Keskiviikko;2;2;4;9;0;9
293;07.02.2018;2018;02;12;Keskiviikko;3;2;5;13;0;13
293;07.02.2018;2018;02;13;Keskiviikko;15;15;30;11;0;11
293;07.02.2018;2018;02;14;Keskiviikko;41;41;82;25;0;25
293;07.02.2018;2018;02;15;Keskiviikko;10;10;20;15;0;15
293;07.02.2018;2018;02;16;Keskiviikko;7;7;14;14;0;14
293;07.02.2018;2018;02;17;Keskiviikko;7;6;13;16;0;16
293;07.02.2018;2018;02;18;Keskiviikko;4;4;8;13;0;13
293;07.02.2018;2018;02;19;Keskiviikko;3;2;5;10;0;10
293;07.02.2018;2018;02;20;Keskiviikko;3;3;6;3;0;3
293;07.02.2018;2018;02;21;Keskiviikko;1;1;2;1;0;1
293;07.02.2018;2018;02;22;Keskiviikko;1;0;1;1;0;1
293;07.02.2018;2018;02;23;Keskiviikko;0;0;0;0;0;0
293;08.02.2018;2018;02;00;Torstai;0;0;0;0;0;0
293;08.02.2018;2018;02;01;Torstai;0;0;0;0;0;0
293;08.02.2018;2018;02;02;Torstai;1;0;1;0;0;0
293;08.02.2018;2018;02;03;Torstai;0;0;0;0;0;0
293;08.02.2018;2018;02;04;Torstai;0;0;0;0;0;0
293;08.02.2018;2018;02;05;Torstai;1;0;1;0;0;0
293;08.02.2018;2018;02;06;Torstai;2;2;4;0;0;0
293;08.02.2018;2018;02;07;Torstai;28;28;56;10;0;10
293;08.02.2018;2018;02;08;Torstai;32;31;63;12;0;12
293;08.02.2018;2018;02;09;Torstai;8;7;15;3;0;3
293;08.02.2018;2018;02;10;Torstai;3;2;5;5;0;5
293;08.02.2018;2018;02;11;Torstai;2;2;4;6;0;6
293;08.02.2018;2018;02;12;Torstai;2;2;4;7;0;7
293;08.02.2018;2018;02;13;Torstai;12;11;23;7;0;7
293;08.02.2018;2018;02;14;Torstai;24;23;47;13;0;13
293;08.02.2018;2018;02;15;Torstai;26;26;52;16;0;16
293;08.02.2018;2018;02;16;Torstai;8;7;15;5;0;5
293;08.02.2018;2018;02;17;Torstai;8;8;16;5;0;5
293;08.02.2018;2018;02;18;Torstai;6;5;11;11;0;11
293;08.02.2018;2018;02;19;Torstai;3;3;6;9;0;9
293;08.02.2018;2018;02;20;Torstai;4;4;8;4;0;4
293;08.02.2018;2018;02;21;Torstai;2;1;3;1;0;1
293;08.02.2018;2018;02;22;Torstai;0;0;0;0;0;0
293;08.02.2018;2018;02;23;Torstai;0;0;0;0;0;0
293;09.02.2018;2018;02;00;Perjantai;0;0;0;0;0;0
293;09.02.2018;2018;02;01;Perjantai;0;0;0;0;0;0
293;09.02.2018;2018;02;02;Perjantai;1;0;1;0;0;0
293;09.02.2018;2018;02;03;Perjantai;0;0;0;0;0;0
293;09.02.2018;2018;02;04;Perjantai;0;0;0;0;0;0
293;09.02.2018;2018;02;05;Perjantai;1;0;1;0;0;0
293;09.02.2018;2018;02;06;Perjantai;4;4;8;1;1;2
293;09.02.2018;2018;02;07;Perjantai;36;35;71;2;2;4
293;09.02.2018;2018;02;08;Perjantai;12;3;15;6;6;12
293;09.02.2018;2018;02;09;Perjantai;14;3;17;5;1;6
293;09.02.2018;2018;02;10;Perjantai;25;0;25;7;4;11
293;09.02.2018;2018;02;11;Perjantai;4;4;8;4;5;9
293;09.02.2018;2018;02;12;Perjantai;4;9;13;2;8;10
293;09.02.2018;2018;02;13;Perjantai;2;23;25;2;14;16
293;09.02.2018;2018;02;14;Perjantai;5;70;75;6;21;27
293;09.02.2018;2018;02;15;Perjantai;8;17;25;1;17;18
293;09.02.2018;2018;02;16;Perjantai;11;15;26;6;11;17
293;09.02.2018;2018;02;17;Perjantai;6;2;8;5;7;12
293;09.02.2018;2018;02;18;Perjantai;5;5;10;5;4;9
293;09.02.2018;2018;02;19;Perjantai;4;7;11;3;4;7
293;09.02.2018;2018;02;20;Perjantai;2;6;8;1;2;3
293;09.02.2018;2018;02;21;Perjantai;0;2;2;0;2;2
293;09.02.2018;2018;02;22;Perjantai;3;1;4;0;0;0
293;09.02.2018;2018;02;23;Perjantai;0;2;2;0;0;0
293;10.02.2018;2018;02;00;Lauantai;0;0;0;1;0;1
293;10.02.2018;2018;02;01;Lauantai;0;0;0;0;0;0
293;10.02.2018;2018;02;02;Lauantai;0;0;0;1;0;1
293;10.02.2018;2018;02;03;Lauantai;0;0;0;0;2;2
293;10.02.2018;2018;02;04;Lauantai;0;0;0;1;0;1
293;10.02.2018;2018;02;05;Lauantai;0;0;0;0;2;2
293;10.02.2018;2018;02;06;Lauantai;1;0;1;0;0;0
293;10.02.2018;2018;02;07;Lauantai;3;0;3;1;0;1
293;10.02.2018;2018;02;08;Lauantai;1;2;3;3;1;4
293;10.02.2018;2018;02;09;Lauantai;2;1;3;3;2;5
293;10.02.2018;2018;02;10;Lauantai;4;2;6;4;6;10
293;10.02.2018;2018;02;11;Lauantai;3;6;9;5;3;8
293;10.02.2018;2018;02;12;Lauantai;6;3;9;8;13;21
293;10.02.2018;2018;02;13;Lauantai;5;5;10;6;3;9
293;10.02.2018;2018;02;14;Lauantai;8;6;14;3;8;11
293;10.02.2018;2018;02;15;Lauantai;4;5;9;14;9;23
293;10.02.2018;2018;02;16;Lauantai;9;9;18;7;8;15
293;10.02.2018;2018;02;17;Lauantai;5;5;10;3;3;6
293;10.02.2018;2018;02;18;Lauantai;5;3;8;5;3;8
293;10.02.2018;2018;02;19;Lauantai;3;3;6;1;1;2
293;10.02.2018;2018;02;20;Lauantai;3;3;6;1;0;1
293;10.02.2018;2018;02;21;Lauantai;1;4;5;2;3;5
293;10.02.2018;2018;02;22;Lauantai;1;2;3;2;1;3
293;10.02.2018;2018;02;23;Lauantai;1;0;1;0;0;0
293;11.02.2018;2018;02;00;Sunnuntai;0;0;0;0;0;0
293;11.02.2018;2018;02;01;Sunnuntai;1;0;1;0;1;1
293;11.02.2018;2018;02;02;Sunnuntai;0;1;1;0;0;0
293;11.02.2018;2018;02;03;Sunnuntai;0;1;1;0;1;1
293;11.02.2018;2018;02;04;Sunnuntai;0;0;0;0;0;0
293;11.02.2018;2018;02;05;Sunnuntai;0;0;0;0;0;0
293;11.02.2018;2018;02;06;Sunnuntai;0;0;0;0;0;0
293;11.02.2018;2018;02;07;Sunnuntai;1;0;1;0;2;2
293;11.02.2018;2018;02;08;Sunnuntai;0;0;0;2;0;2
293;11.02.2018;2018;02;09;Sunnuntai;5;0;5;4;1;5
293;11.02.2018;2018;02;10;Sunnuntai;6;1;7;5;4;9
293;11.02.2018;2018;02;11;Sunnuntai;2;7;9;6;5;11
293;11.02.2018;2018;02;12;Sunnuntai;5;1;6;5;4;9
293;11.02.2018;2018;02;13;Sunnuntai;2;5;7;9;7;16
293;11.02.2018;2018;02;14;Sunnuntai;1;6;7;8;2;10
293;11.02.2018;2018;02;15;Sunnuntai;4;6;10;2;5;7
293;11.02.2018;2018;02;16;Sunnuntai;2;1;3;8;1;9
293;11.02.2018;2018;02;17;Sunnuntai;4;3;7;1;4;5
293;11.02.2018;2018;02;18;Sunnuntai;8;1;9;4;4;8
293;11.02.2018;2018;02;19;Sunnuntai;0;4;4;2;2;4
293;11.02.2018;2018;02;20;Sunnuntai;2;7;9;2;2;4
293;11.02.2018;2018;02;21;Sunnuntai;2;0;2;0;0;0
293;11.02.2018;2018;02;22;Sunnuntai;0;1;1;0;0;0
293;11.02.2018;2018;02;23;Sunnuntai;0;0;0;0;0;0
293;12.02.2018;2018;02;00;Maanantai;0;0;0;0;0;0
293;12.02.2018;2018;02;01;Maanantai;0;0;0;0;0;0
293;12.02.2018;2018;02;02;Maanantai;0;0;0;0;0;0
293;12.02.2018;2018;02;03;Maanantai;0;0;0;0;0;0
293;12.02.2018;2018;02;04;Maanantai;0;0;0;0;0;0
293;12.02.2018;2018;02;05;Maanantai;2;0;2;0;0;0
293;12.02.2018;2018;02;06;Maanantai;6;1;7;1;0;1
293;12.02.2018;2018;02;07;Maanantai;66;3;69;12;1;13
293;12.02.2018;2018;02;08;Maanantai;72;2;74;9;3;12
293;12.02.2018;2018;02;09;Maanantai;22;2;24;6;2;8
293;12.02.2018;2018;02;10;Maanantai;7;2;9;4;5;9
293;12.02.2018;2018;02;11;Maanantai;1;2;3;1;6;7
293;12.02.2018;2018;02;12;Maanantai;1;4;5;2;1;3
293;12.02.2018;2018;02;13;Maanantai;5;18;23;4;7;11
293;12.02.2018;2018;02;14;Maanantai;1;40;41;9;13;22
293;12.02.2018;2018;02;15;Maanantai;8;83;91;5;19;24
293;12.02.2018;2018;02;16;Maanantai;6;19;25;4;12;16
293;12.02.2018;2018;02;17;Maanantai;5;5;10;7;7;14
293;12.02.2018;2018;02;18;Maanantai;5;6;11;8;7;15
293;12.02.2018;2018;02;19;Maanantai;7;6;13;2;3;5
293;12.02.2018;2018;02;20;Maanantai;2;3;5;4;3;7
293;12.02.2018;2018;02;21;Maanantai;2;3;5;0;1;1
293;12.02.2018;2018;02;22;Maanantai;1;0;1;0;0;0
293;12.02.2018;2018;02;23;Maanantai;0;0;0;0;0;0
293;13.02.2018;2018;02;00;Tiistai;0;0;0;0;0;0
293;13.02.2018;2018;02;01;Tiistai;0;0;0;0;0;0
293;13.02.2018;2018;02;02;Tiistai;0;0;0;0;0;0
293;13.02.2018;2018;02;03;Tiistai;1;0;1;0;0;0
293;13.02.2018;2018;02;04;Tiistai;0;0;0;0;0;0
293;13.02.2018;2018;02;05;Tiistai;1;0;1;0;0;0
293;13.02.2018;2018;02;06;Tiistai;4;2;6;2;0;2
293;13.02.2018;2018;02;07;Tiistai;64;4;68;5;2;7
293;13.02.2018;2018;02;08;Tiistai;54;3;57;6;1;7
293;13.02.2018;2018;02;09;Tiistai;24;5;29;5;5;10
293;13.02.2018;2018;02;10;Tiistai;6;4;10;2;2;4
293;13.02.2018;2018;02;11;Tiistai;2;2;4;1;2;3
293;13.02.2018;2018;02;12;Tiistai;3;8;11;3;2;5
293;13.02.2018;2018;02;13;Tiistai;3;22;25;7;12;19
293;13.02.2018;2018;02;14;Tiistai;4;46;50;4;11;15
293;13.02.2018;2018;02;15;Tiistai;4;52;56;5;9;14
293;13.02.2018;2018;02;16;Tiistai;8;9;17;4;10;14
293;13.02.2018;2018;02;17;Tiistai;4;9;13;6;6;12
293;13.02.2018;2018;02;18;Tiistai;1;8;9;3;2;5
293;13.02.2018;2018;02;19;Tiistai;3;2;5;6;9;15
293;13.02.2018;2018;02;20;Tiistai;0;3;3;1;0;1
293;13.02.2018;2018;02;21;Tiistai;2;2;4;0;1;1
293;13.02.2018;2018;02;22;Tiistai;0;0;0;1;0;1
293;13.02.2018;2018;02;23;Tiistai;0;0;0;0;0;0
293;14.02.2018;2018;02;00;Keskiviikko;0;0;0;0;0;0
293;14.02.2018;2018;02;01;Keskiviikko;0;0;0;0;0;0
293;14.02.2018;2018;02;02;Keskiviikko;0;0;0;0;0;0
293;14.02.2018;2018;02;03;Keskiviikko;1;0;1;0;0;0
293;14.02.2018;2018;02;04;Keskiviikko;0;0;0;0;0;0
293;14.02.2018;2018;02;05;Keskiviikko;0;0;0;0;0;0
293;14.02.2018;2018;02;06;Keskiviikko;5;0;5;0;0;0
293;14.02.2018;2018;02;07;Keskiviikko;78;0;78;11;0;11
293;14.02.2018;2018;02;08;Keskiviikko;67;0;67;10;0;10
293;14.02.2018;2018;02;09;Keskiviikko;7;0;7;5;0;5
293;14.02.2018;2018;02;10;Keskiviikko;2;0;2;7;0;7
293;14.02.2018;2018;02;11;Keskiviikko;4;0;4;9;0;9
293;14.02.2018;2018;02;12;Keskiviikko;5;0;5;13;0;13
293;14.02.2018;2018;02;13;Keskiviikko;30;0;30;11;0;11
293;14.02.2018;2018;02;14;Keskiviikko;82;0;82;25;0;25
293;14.02.2018;2018;02;15;Keskiviikko;20;0;20;15;0;15
293;14.02.2018;2018;02;16;Keskiviikko;14;0;14;14;0;14
293;14.02.2018;2018;02;17;Keskiviikko;13;0;13;16;0;16
293;14.02.2018;2018;02;18;Keskiviikko;8;0;8;13;0;13
293;14.02.2018;2018;02;19;Keskiviikko;5;0;5;10;0;10
293;14.02.2018;2018;02;20;Keskiviikko;6;0;6;3;0;3
293;14.02.2018;2018;02;21;Keskiviikko;2;0;2;1;0;1
293;14.02.2018;2018;02;22;Keskiviikko;1;0;1;1;0;1
293;14.02.2018;2018;02;23;Keskiviikko;0;0;0;0;0;0
293;15.02.2018;2018;02;00;Torstai;0;0;0;0;0;0
293;15.02.2018;2018;02;01;Torstai;0;0;0;0;0;0
293;15.02.2018;2018;02;02;Torstai;1;0;1;0;0;0
293;15.02.2018;2018;02;03;Torstai;0;0;0;0;0;0
293;15.02.2018;2018;02;04;Torstai;0;0;0;0;0;0
293;15.02.2018;2018;02;05;Torstai;1;0;1;0;0;0
293;15.02.2018;2018;02;06;Torstai;4;0;4;0;0;0
293;15.02.2018;2018;02;07;Torstai;56;0;56;10;0;10
293;15.02.2018;2018;02;08;Torstai;63;0;63;12;0;12
293;15.02.2018;2018;02;09;Torstai;15;0;15;3;0;3
293;15.02.2018;2018;02;10;Torstai;5;0;5;5;0;5
293;15.02.2018;2018;02;11;Torstai;4;0;4;6;0;6
293;15.02.2018;2018;02;12;Torstai;4;0;4;7;0;7
293;15.02.2018;2018;02;13;Torstai;23;0;23;7;0;7
293;15.02.2018;2018;02;14;Torstai;47;0;47;13;0;13
293;15.02.2018;2018;02;15;Torstai;52;0;52;16;0;16
293;15.02.2018;2018;02;16;Torstai;15;0;15;5;0;5
293;15.02.2018;2018;02;17;Torstai;16;0;16;5;0;5
293;15.02.2018;2018;02;18;Torstai;11;0;11;11;0;11
293;15.02.2018;2018;02;19;Torstai;6;0;6;9;0;9
293;15.02.2018;2018;02;20;Torstai;8;0;8;4;0;4
293;15.02.2018;2018;02;21;Torstai;3;0;3;1;0;1
293;15.02.2018;2018;02;22;Torstai;0;0;0;0;0;0
293;15.02.2018;2018;02;23;Torstai;0;0;0;0;0;0
293;16.02.2018;2018;02;00;Perjantai;0;0;0;0;0;0
293;16.02.2018;2018;02;01;Perjantai;0;0;0;0;1;1
293;16.02.2018;2018;02;02;Perjantai;1;0;1;0;0;0
293;16.02.2018;2018;02;03;Perjantai;0;0;0;0;0;0
293;16.02.2018;2018;02;04;Perjantai;0;0;0;0;0;0
293;16.02.2018;2018;02;05;Perjantai;1;1;2;0;0;0
293;16.02.2018;2018;02;06;Perjantai;3;3;6;2;0;2
293;16.02.2018;2018;02;07;Perjantai;76;4;80;5;1;6
293;16.02.2018;2018;02;08;Perjantai;51;1;52;7;2;9
293;16.02.2018;2018;02;09;Perjantai;21;2;23;7;0;7
293;16.02.2018;2018;02;10;Perjantai;8;6;14;6;2;8
293;16.02.2018;2018;02;11;Perjantai;6;3;9;4;3;7
293;16.02.2018;2018;02;12;Perjantai;4;10;14;5;9;14
293;16.02.2018;2018;02;13;Perjantai;6;24;30;3;8;11
293;16.02.2018;2018;02;14;Perjantai;2;63;65;1;19;20
293;16.02.2018;2018;02;15;Perjantai;6;34;40;1;4;5
293;16.02.2018;2018;02;16;Perjantai;10;8;18;7;4;11
293;16.02.2018;2018;02;17;Perjantai;5;5;10;2;6;8
293;16.02.2018;2018;02;18;Perjantai;4;6;10;4;1;5
293;16.02.2018;2018;02;19;Perjantai;3;8;11;1;5;6
293;16.02.2018;2018;02;20;Perjantai;3;7;10;0;0;0
293;16.02.2018;2018;02;21;Perjantai;0;4;4;1;2;3
293;16.02.2018;2018;02;22;Perjantai;0;3;3;1;2;3
293;16.02.2018;2018;02;23;Perjantai;0;0;0;1;0;1
293;17.02.2018;2018;02;00;Lauantai;0;0;0;0;0;0
293;17.02.2018;2018;02;01;Lauantai;0;2;2;0;0;0
293;17.02.2018;2018;02;02;Lauantai;0;0;0;1;1;2
293;17.02.2018;2018;02;03;Lauantai;0;0;0;0;1;1
293;17.02.2018;2018;02;04;Lauantai;0;0;0;0;0;0
293;17.02.2018;2018;02;05;Lauantai;0;0;0;0;0;0
293;17.02.2018;2018;02;06;Lauantai;0;0;0;0;0;0
293;17.02.2018;2018;02;07;Lauantai;1;0;1;0;0;0
293;17.02.2018;2018;02;08;Lauantai;2;1;3;1;0;1
293;17.02.2018;2018;02;09;Lauantai;3;2;5;3;1;4
293;17.02.2018;2018;02;10;Lauantai;0;2;2;8;10;18
293;17.02.2018;2018;02;11;Lauantai;4;0;4;6;20;26
293;17.02.2018;2018;02;12;Lauantai;2;0;2;5;2;7
293;17.02.2018;2018;02;13;Lauantai;3;2;5;6;6;12
293;17.02.2018;2018;02;14;Lauantai;6;5;11;7;6;13
293;17.02.2018;2018;02;15;Lauantai;5;3;8;1;1;2
293;17.02.2018;2018;02;16;Lauantai;1;4;5;5;3;8
293;17.02.2018;2018;02;17;Lauantai;3;4;7;4;4;8
293;17.02.2018;2018;02;18;Lauantai;3;6;9;0;8;8
293;17.02.2018;2018;02;19;Lauantai;5;7;12;1;1;2
293;17.02.2018;2018;02;20;Lauantai;2;3;5;0;2;2
293;17.02.2018;2018;02;21;Lauantai;1;1;2;1;1;2
293;17.02.2018;2018;02;22;Lauantai;0;0;0;0;0;0
293;17.02.2018;2018;02;23;Lauantai;0;1;1;1;0;1
293;18.02.2018;2018;02;00;Sunnuntai;1;1;2;0;1;1
293;18.02.2018;2018;02;01;Sunnuntai;0;0;0;0;0;0
293;18.02.2018;2018;02;02;Sunnuntai;0;0;0;0;0;0
293;18.02.2018;2018;02;03;Sunnuntai;0;0;0;0;0;0
293;18.02.2018;2018;02;04;Sunnuntai;0;0;0;0;0;0
293;18.02.2018;2018;02;05;Sunnuntai;0;0;0;0;0;0
293;18.02.2018;2018;02;06;Sunnuntai;0;0;0;1;0;1
293;18.02.2018;2018;02;07;Sunnuntai;0;0;0;0;0;0
293;18.02.2018;2018;02;08;Sunnuntai;0;0;0;1;0;1
293;18.02.2018;2018;02;09;Sunnuntai;8;0;8;1;0;1
293;18.02.2018;2018;02;10;Sunnuntai;9;4;13;2;3;5
293;18.02.2018;2018;02;11;Sunnuntai;2;9;11;7;1;8
293;18.02.2018;2018;02;12;Sunnuntai;5;5;10;3;6;9
293;18.02.2018;2018;02;13;Sunnuntai;3;5;8;7;9;16
293;18.02.2018;2018;02;14;Sunnuntai;2;2;4;10;3;13
293;18.02.2018;2018;02;15;Sunnuntai;2;7;9;4;5;9
293;18.02.2018;2018;02;16;Sunnuntai;0;0;0;3;3;6
293;18.02.2018;2018;02;17;Sunnuntai;4;1;5;2;6;8
293;18.02.2018;2018;02;18;Sunnuntai;2;4;6;3;7;10
293;18.02.2018;2018;02;19;Sunnuntai;6;1;7;1;4;5
293;18.02.2018;2018;02;20;Sunnuntai;0;3;3;0;1;1
293;18.02.2018;2018;02;21;Sunnuntai;1;0;1;0;1;1
293;18.02.2018;2018;02;22;Sunnuntai;0;0;0;0;0;0
293;18.02.2018;2018;02;23;Sunnuntai;0;1;1;0;0;0
293;19.02.2018;2018;02;00;Maanantai;0;0;0;0;0;0
293;19.02.2018;2018;02;01;Maanantai;0;0;0;0;0;0
293;19.02.2018;2018;02;02;Maanantai;0;0;0;0;0;0
293;19.02.2018;2018;02;03;Maanantai;0;0;0;0;0;0
293;19.02.2018;2018;02;04;Maanantai;0;0;0;0;0;0
293;19.02.2018;2018;02;05;Maanantai;2;0;2;0;0;0
293;19.02.2018;2018;02;06;Maanantai;5;1;6;1;0;1
293;19.02.2018;2018;02;07;Maanantai;38;2;40;8;2;10
293;19.02.2018;2018;02;08;Maanantai;57;0;57;10;2;12
293;19.02.2018;2018;02;09;Maanantai;13;2;15;6;0;6
293;19.02.2018;2018;02;10;Maanantai;8;1;9;2;4;6
293;19.02.2018;2018;02;11;Maanantai;0;0;0;0;3;3
293;19.02.2018;2018;02;12;Maanantai;4;4;8;3;2;5
293;19.02.2018;2018;02;13;Maanantai;0;10;10;3;5;8
293;19.02.2018;2018;02;14;Maanantai;2;36;38;6;8;14
293;19.02.2018;2018;02;15;Maanantai;4;50;54;3;23;26
293;19.02.2018;2018;02;16;Maanantai;3;14;17;3;8;11
293;19.02.2018;2018;02;17;Maanantai;5;8;13;6;5;11
293;19.02.2018;2018;02;18;Maanantai;1;4;5;3;3;6
293;19.02.2018;2018;02;19;Maanantai;6;4;10;3;2;5
293;19.02.2018;2018;02;20;Maanantai;1;1;2;0;2;2
293;19.02.2018;2018;02;21;Maanantai;0;5;5;0;0;0
293;19.02.2018;2018;02;22;Maanantai;0;0;0;0;0;0
293;19.02.2018;2018;02;23;Maanantai;0;0;0;0;0;0
293;20.02.2018;2018;02;00;Tiistai;0;0;0;0;0;0
293;20.02.2018;2018;02;01;Tiistai;0;0;0;0;0;0
293;20.02.2018;2018;02;02;Tiistai;0;0;0;0;0;0
293;20.02.2018;2018;02;03;Tiistai;1;0;1;0;0;0
293;20.02.2018;2018;02;04;Tiistai;0;0;0;0;0;0
293;20.02.2018;2018;02;05;Tiistai;1;0;1;0;0;0
293;20.02.2018;2018;02;06;Tiistai;5;1;6;5;0;5
293;20.02.2018;2018;02;07;Tiistai;39;1;40;13;2;15
293;20.02.2018;2018;02;08;Tiistai;49;1;50;6;3;9
293;20.02.2018;2018;02;09;Tiistai;24;1;25;0;0;0
293;20.02.2018;2018;02;10;Tiistai;8;1;9;4;2;6
293;20.02.2018;2018;02;11;Tiistai;1;1;2;3;4;7
293;20.02.2018;2018;02;12;Tiistai;2;3;5;4;5;9
293;20.02.2018;2018;02;13;Tiistai;2;20;22;4;8;12
293;20.02.2018;2018;02;14;Tiistai;2;48;50;2;9;11
293;20.02.2018;2018;02;15;Tiistai;1;50;51;3;12;15
293;20.02.2018;2018;02;16;Tiistai;4;10;14;5;9;14
293;20.02.2018;2018;02;17;Tiistai;3;0;3;3;5;8
293;20.02.2018;2018;02;18;Tiistai;4;5;9;4;2;6
293;20.02.2018;2018;02;19;Tiistai;0;5;5;4;2;6
293;20.02.2018;2018;02;20;Tiistai;0;2;2;1;2;3
293;20.02.2018;2018;02;21;Tiistai;0;0;0;1;0;1
293;20.02.2018;2018;02;22;Tiistai;0;0;0;1;0;1
293;20.02.2018;2018;02;23;Tiistai;0;0;0;0;0;0
293;21.02.2018;2018;02;00;Keskiviikko;0;0;0;0;0;0
293;21.02.2018;2018;02;01;Keskiviikko;0;0;0;0;0;0
293;21.02.2018;2018;02;02;Keskiviikko;0;0;0;0;0;0
293;21.02.2018;2018;02;03;Keskiviikko;1;0;1;0;0;0
293;21.02.2018;2018;02;04;Keskiviikko;0;0;0;0;0;0
293;21.02.2018;2018;02;05;Keskiviikko;1;0;1;0;0;0
293;21.02.2018;2018;02;06;Keskiviikko;2;2;4;0;0;0
293;21.02.2018;2018;02;07;Keskiviikko;68;3;71;12;1;13
293;21.02.2018;2018;02;08;Keskiviikko;59;1;60;8;2;10
293;21.02.2018;2018;02;09;Keskiviikko;7;3;10;2;0;2
293;21.02.2018;2018;02;10;Keskiviikko;0;2;2;1;1;2
293;21.02.2018;2018;02;11;Keskiviikko;2;3;5;3;3;6
293;21.02.2018;2018;02;12;Keskiviikko;2;1;3;4;2;6
293;21.02.2018;2018;02;13;Keskiviikko;1;25;26;5;10;15
293;21.02.2018;2018;02;14;Keskiviikko;4;86;90;4;17;21
293;21.02.2018;2018;02;15;Keskiviikko;6;11;17;3;7;10
293;21.02.2018;2018;02;16;Keskiviikko;6;10;16;8;9;17
293;21.02.2018;2018;02;17;Keskiviikko;2;1;3;7;6;13
293;21.02.2018;2018;02;18;Keskiviikko;3;8;11;1;6;7
293;21.02.2018;2018;02;19;Keskiviikko;0;5;5;6;6;12
293;21.02.2018;2018;02;20;Keskiviikko;0;5;5;1;2;3
293;21.02.2018;2018;02;21;Keskiviikko;1;1;2;0;1;1
293;21.02.2018;2018;02;22;Keskiviikko;0;0;0;0;0;0
293;21.02.2018;2018;02;23;Keskiviikko;0;0;0;1;0;1
293;22.02.2018;2018;02;00;Torstai;0;0;0;0;0;0
293;22.02.2018;2018;02;01;Torstai;0;0;0;0;0;0
293;22.02.2018;2018;02;02;Torstai;0;0;0;0;0;0
293;22.02.2018;2018;02;03;Torstai;1;0;1;0;0;0
293;22.02.2018;2018;02;04;Torstai;0;0;0;0;0;0
293;22.02.2018;2018;02;05;Torstai;2;0;2;0;0;0
293;22.02.2018;2018;02;06;Torstai;2;1;3;2;0;2
293;22.02.2018;2018;02;07;Torstai;59;3;62;10;1;11
293;22.02.2018;2018;02;08;Torstai;59;1;60;4;3;7
293;22.02.2018;2018;02;09;Torstai;13;1;14;2;1;3
293;22.02.2018;2018;02;10;Torstai;7;2;9;4;2;6
293;22.02.2018;2018;02;11;Torstai;3;3;6;3;3;6
293;22.02.2018;2018;02;12;Torstai;4;6;10;3;4;7
293;22.02.2018;2018;02;13;Torstai;1;17;18;4;6;10
293;22.02.2018;2018;02;14;Torstai;3;51;54;5;16;21
293;22.02.2018;2018;02;15;Torstai;4;45;49;3;9;12
293;22.02.2018;2018;02;16;Torstai;4;5;9;1;6;7
293;22.02.2018;2018;02;17;Torstai;5;3;8;4;2;6
293;22.02.2018;2018;02;18;Torstai;1;3;4;4;3;7
293;22.02.2018;2018;02;19;Torstai;1;7;8;4;4;8
293;22.02.2018;2018;02;20;Torstai;2;3;5;0;3;3
293;22.02.2018;2018;02;21;Torstai;2;1;3;2;0;2
293;22.02.2018;2018;02;22;Torstai;0;0;0;0;0;0
293;22.02.2018;2018;02;23;Torstai;0;1;1;0;0;0
293;23.02.2018;2018;02;00;Perjantai;2;0;2;0;0;0
293;23.02.2018;2018;02;01;Perjantai;0;0;0;1;1;2
293;23.02.2018;2018;02;02;Perjantai;0;0;0;0;0;0
293;23.02.2018;2018;02;03;Perjantai;1;0;1;0;0;0
293;23.02.2018;2018;02;04;Perjantai;0;0;0;0;0;0
293;23.02.2018;2018;02;05;Perjantai;1;0;1;0;0;0
293;23.02.2018;2018;02;06;Perjantai;4;1;5;1;0;1
293;23.02.2018;2018;02;07;Perjantai;66;3;69;7;1;8
293;23.02.2018;2018;02;08;Perjantai;39;2;41;8;5;13
293;23.02.2018;2018;02;09;Perjantai;15;1;16;5;1;6
293;23.02.2018;2018;02;10;Perjantai;11;1;12;6;4;10
293;23.02.2018;2018;02;11;Perjantai;3;2;5;11;9;20
293;23.02.2018;2018;02;12;Perjantai;4;7;11;7;7;14
293;23.02.2018;2018;02;13;Perjantai;7;21;28;2;13;15
293;23.02.2018;2018;02;14;Perjantai;5;64;69;6;22;28
293;23.02.2018;2018;02;15;Perjantai;5;33;38;2;4;6
293;23.02.2018;2018;02;16;Perjantai;4;5;9;10;6;16
293;23.02.2018;2018;02;17;Perjantai;6;6;12;5;8;13
293;23.02.2018;2018;02;18;Perjantai;5;5;10;4;4;8
293;23.02.2018;2018;02;19;Perjantai;5;8;13;1;7;8
293;23.02.2018;2018;02;20;Perjantai;3;6;9;0;1;1
293;23.02.2018;2018;02;21;Perjantai;1;0;1;3;1;4
293;23.02.2018;2018;02;22;Perjantai;1;0;1;0;1;1
293;23.02.2018;2018;02;23;Perjantai;0;5;5;1;0;1
293;24.02.2018;2018;02;00;Lauantai;0;1;1;0;0;0
293;24.02.2018;2018;02;01;Lauantai;0;1;1;0;1;1
293;24.02.2018;2018;02;02;Lauantai;0;1;1;0;0;0
293;24.02.2018;2018;02;03;Lauantai;0;0;0;0;0;0
293;24.02.2018;2018;02;04;Lauantai;0;0;0;1;0;1
293;24.02.2018;2018;02;05;Lauantai;0;0;0;1;0;1
293;24.02.2018;2018;02;06;Lauantai;1;0;1;0;0;0
293;24.02.2018;2018;02;07;Lauantai;1;0;1;1;1;2
293;24.02.2018;2018;02;08;Lauantai;0;1;1;2;1;3
293;24.02.2018;2018;02;09;Lauantai;7;1;8;0;2;2
293;24.02.2018;2018;02;10;Lauantai;1;2;3;2;1;3
293;24.02.2018;2018;02;11;Lauantai;2;0;2;3;3;6
293;24.02.2018;2018;02;12;Lauantai;2;1;3;15;3;18
293;24.02.2018;2018;02;13;Lauantai;6;6;12;4;10;14
293;24.02.2018;2018;02;14;Lauantai;0;10;10;5;8;13
293;24.02.2018;2018;02;15;Lauantai;6;2;8;6;6;12
293;24.02.2018;2018;02;16;Lauantai;4;2;6;5;7;12
293;24.02.2018;2018;02;17;Lauantai;0;2;2;3;3;6
293;24.02.2018;2018;02;18;Lauantai;0;2;2;1;3;4
293;24.02.2018;2018;02;19;Lauantai;2;2;4;0;0;0
293;24.02.2018;2018;02;20;Lauantai;2;2;4;0;1;1
293;24.02.2018;2018;02;21;Lauantai;2;0;2;0;1;1
293;24.02.2018;2018;02;22;Lauantai;1;1;2;0;0;0
293;24.02.2018;2018;02;23;Lauantai;0;4;4;0;0;0
293;25.02.2018;2018;02;00;Sunnuntai;1;0;1;0;0;0
293;25.02.2018;2018;02;01;Sunnuntai;1;0;1;0;0;0
293;25.02.2018;2018;02;02;Sunnuntai;0;0;0;0;0;0
293;25.02.2018;2018;02;03;Sunnuntai;0;1;1;0;2;2
293;25.02.2018;2018;02;04;Sunnuntai;1;0;1;0;0;0
293;25.02.2018;2018;02;05;Sunnuntai;0;0;0;0;0;0
293;25.02.2018;2018;02;06;Sunnuntai;1;0;1;0;0;0
293;25.02.2018;2018;02;07;Sunnuntai;0;0;0;0;1;1
293;25.02.2018;2018;02;08;Sunnuntai;0;0;0;1;0;1
293;25.02.2018;2018;02;09;Sunnuntai;3;0;3;2;0;2
293;25.02.2018;2018;02;10;Sunnuntai;1;4;5;1;8;9
293;25.02.2018;2018;02;11;Sunnuntai;3;3;6;6;4;10
293;25.02.2018;2018;02;12;Sunnuntai;3;4;7;6;3;9
293;25.02.2018;2018;02;13;Sunnuntai;6;2;8;6;1;7
293;25.02.2018;2018;02;14;Sunnuntai;7;5;12;7;5;12
293;25.02.2018;2018;02;15;Sunnuntai;5;2;7;2;4;6
293;25.02.2018;2018;02;16;Sunnuntai;1;5;6;2;6;8
293;25.02.2018;2018;02;17;Sunnuntai;5;10;15;0;1;1
293;25.02.2018;2018;02;18;Sunnuntai;5;3;8;1;5;6
293;25.02.2018;2018;02;19;Sunnuntai;2;3;5;0;1;1
293;25.02.2018;2018;02;20;Sunnuntai;1;2;3;0;0;0
293;25.02.2018;2018;02;21;Sunnuntai;0;0;0;2;1;3
293;25.02.2018;2018;02;22;Sunnuntai;0;0;0;0;1;1
293;25.02.2018;2018;02;23;Sunnuntai;0;0;0;0;0;0
293;26.02.2018;2018;02;00;Maanantai;0;0;0;0;0;0
293;26.02.2018;2018;02;01;Maanantai;0;0;0;0;0;0
293;26.02.2018;2018;02;02;Maanantai;0;0;0;0;0;0
293;26.02.2018;2018;02;03;Maanantai;0;0;0;0;0;0
293;26.02.2018;2018;02;04;Maanantai;0;0;0;0;0;0
293;26.02.2018;2018;02;05;Maanantai;2;0;2;0;0;0
293;26.02.2018;2018;02;06;Maanantai;5;0;5;2;0;2
293;26.02.2018;2018;02;07;Maanantai;47;2;49;7;1;8
293;26.02.2018;2018;02;08;Maanantai;80;1;81;9;1;10
293;26.02.2018;2018;02;09;Maanantai;21;2;23;9;1;10
293;26.02.2018;2018;02;10;Maanantai;8;4;12;0;2;2
293;26.02.2018;2018;02;11;Maanantai;6;5;11;9;5;14
293;26.02.2018;2018;02;12;Maanantai;5;5;10;4;7;11
293;26.02.2018;2018;02;13;Maanantai;4;23;27;3;5;8
293;26.02.2018;2018;02;14;Maanantai;4;40;44;5;14;19
293;26.02.2018;2018;02;15;Maanantai;4;71;75;2;9;11
293;26.02.2018;2018;02;16;Maanantai;5;16;21;7;8;15
293;26.02.2018;2018;02;17;Maanantai;3;6;9;4;8;12
293;26.02.2018;2018;02;18;Maanantai;7;5;12;13;7;20
293;26.02.2018;2018;02;19;Maanantai;5;4;9;1;2;3
293;26.02.2018;2018;02;20;Maanantai;0;4;4;0;3;3
293;26.02.2018;2018;02;21;Maanantai;0;5;5;0;0;0
293;26.02.2018;2018;02;22;Maanantai;0;1;1;0;0;0
293;26.02.2018;2018;02;23;Maanantai;0;0;0;0;1;1
293;27.02.2018;2018;02;00;Tiistai;0;0;0;0;0;0
293;27.02.2018;2018;02;01;Tiistai;0;0;0;0;0;0
293;27.02.2018;2018;02;02;Tiistai;0;0;0;0;0;0
293;27.02.2018;2018;02;03;Tiistai;1;0;1;0;0;0
293;27.02.2018;2018;02;04;Tiistai;0;0;0;0;0;0
293;27.02.2018;2018;02;05;Tiistai;3;0;3;0;0;0
293;27.02.2018;2018;02;06;Tiistai;4;0;4;3;1;4
293;27.02.2018;2018;02;07;Tiistai;47;3;50;9;0;9
293;27.02.2018;2018;02;08;Tiistai;48;2;50;5;1;6
293;27.02.2018;2018;02;09;Tiistai;23;1;24;3;2;5
293;27.02.2018;2018;02;10;Tiistai;13;1;14;2;1;3
293;27.02.2018;2018;02;11;Tiistai;1;1;2;1;6;7
293;27.02.2018;2018;02;12;Tiistai;1;7;8;2;3;5
293;27.02.2018;2018;02;13;Tiistai;2;22;24;5;6;11
293;27.02.2018;2018;02;14;Tiistai;6;40;46;3;10;13
293;27.02.2018;2018;02;15;Tiistai;3;50;53;4;15;19
293;27.02.2018;2018;02;16;Tiistai;6;9;15;7;9;16
293;27.02.2018;2018;02;17;Tiistai;5;10;15;1;0;1
293;27.02.2018;2018;02;18;Tiistai;8;7;15;4;6;10
293;27.02.2018;2018;02;19;Tiistai;0;8;8;3;7;10
293;27.02.2018;2018;02;20;Tiistai;3;2;5;1;1;2
293;27.02.2018;2018;02;21;Tiistai;1;0;1;0;0;0
293;27.02.2018;2018;02;22;Tiistai;0;0;0;0;0;0
293;27.02.2018;2018;02;23;Tiistai;0;0;0;0;0;0
293;28.02.2018;2018;02;00;Keskiviikko;0;0;0;0;0;0
293;28.02.2018;2018;02;01;Keskiviikko;0;0;0;0;0;0
293;28.02.2018;2018;02;02;Keskiviikko;0;0;0;0;0;0
293;28.02.2018;2018;02;03;Keskiviikko;1;0;1;0;0;0
293;28.02.2018;2018;02;04;Keskiviikko;0;0;0;0;0;0
293;28.02.2018;2018;02;05;Keskiviikko;1;0;1;0;0;0
293;28.02.2018;2018;02;06;Keskiviikko;2;0;2;1;0;1
293;28.02.2018;2018;02;07;Keskiviikko;46;2;48;15;0;15
293;28.02.2018;2018;02;08;Keskiviikko;46;2;48;9;0;9
293;28.02.2018;2018;02;09;Keskiviikko;5;2;7;0;1;1
293;28.02.2018;2018;02;10;Keskiviikko;4;1;5;4;5;9
293;28.02.2018;2018;02;11;Keskiviikko;2;5;7;1;3;4
293;28.02.2018;2018;02;12;Keskiviikko;4;3;7;6;2;8
293;28.02.2018;2018;02;13;Keskiviikko;2;28;30;4;8;12
293;28.02.2018;2018;02;14;Keskiviikko;4;50;54;3;17;20
293;28.02.2018;2018;02;15;Keskiviikko;2;15;17;4;4;8
293;28.02.2018;2018;02;16;Keskiviikko;10;7;17;5;10;15
293;28.02.2018;2018;02;17;Keskiviikko;4;4;8;9;4;13
293;28.02.2018;2018;02;18;Keskiviikko;1;7;8;6;6;12
293;28.02.2018;2018;02;19;Keskiviikko;2;3;5;3;7;10
293;28.02.2018;2018;02;20;Keskiviikko;3;4;7;1;1;2
293;28.02.2018;2018;02;21;Keskiviikko;0;3;3;0;1;1
293;28.02.2018;2018;02;22;Keskiviikko;0;0;0;0;0;0
293;28.02.2018;2018;02;23;Keskiviikko;0;0;0;0;0;0
293;01.03.2018;2018;03;00;Torstai;0;0;0;0;0;0
293;01.03.2018;2018;03;01;Torstai;0;0;0;0;0;0
293;01.03.2018;2018;03;02;Torstai;0;0;0;0;0;0
293;01.03.2018;2018;03;03;Torstai;1;0;1;0;0;0
293;01.03.2018;2018;03;04;Torstai;0;0;0;0;0;0
293;01.03.2018;2018;03;05;Torstai;2;0;2;0;0;0
293;01.03.2018;2018;03;06;Torstai;4;1;5;2;0;2
293;01.03.2018;2018;03;07;Torstai;52;2;54;9;1;10
293;01.03.2018;2018;03;08;Torstai;65;2;67;2;2;4
293;01.03.2018;2018;03;09;Torstai;16;2;18;4;4;8
293;01.03.2018;2018;03;10;Torstai;12;4;16;3;1;4
293;01.03.2018;2018;03;11;Torstai;0;1;1;5;9;14
293;01.03.2018;2018;03;12;Torstai;5;4;9;9;2;11
293;01.03.2018;2018;03;13;Torstai;1;19;20;4;14;18
293;01.03.2018;2018;03;14;Torstai;3;58;61;2;12;14
293;01.03.2018;2018;03;15;Torstai;8;48;56;2;6;8
293;01.03.2018;2018;03;16;Torstai;3;13;16;5;7;12
293;01.03.2018;2018;03;17;Torstai;3;12;15;6;4;10
293;01.03.2018;2018;03;18;Torstai;1;1;2;5;6;11
293;01.03.2018;2018;03;19;Torstai;2;8;10;2;1;3
293;01.03.2018;2018;03;20;Torstai;2;1;3;3;3;6
293;01.03.2018;2018;03;21;Torstai;1;1;2;0;2;2
293;01.03.2018;2018;03;22;Torstai;0;0;0;0;0;0
293;01.03.2018;2018;03;23;Torstai;0;0;0;0;0;0
293;02.03.2018;2018;03;00;Perjantai;0;0;0;0;0;0
293;02.03.2018;2018;03;01;Perjantai;0;1;1;0;0;0
293;02.03.2018;2018;03;02;Perjantai;0;0;0;0;0;0
293;02.03.2018;2018;03;03;Perjantai;1;0;1;0;0;0
293;02.03.2018;2018;03;04;Perjantai;0;0;0;0;0;0
293;02.03.2018;2018;03;05;Perjantai;1;0;1;0;0;0
293;02.03.2018;2018;03;06;Perjantai;8;1;9;2;0;2
293;02.03.2018;2018;03;07;Perjantai;82;2;84;9;2;11
293;02.03.2018;2018;03;08;Perjantai;48;1;49;5;0;5
293;02.03.2018;2018;03;09;Perjantai;16;6;22;8;2;10
293;02.03.2018;2018;03;10;Perjantai;12;18;30;3;8;11
293;02.03.2018;2018;03;11;Perjantai;3;5;8;9;5;14
293;02.03.2018;2018;03;12;Perjantai;3;13;16;1;11;12
293;02.03.2018;2018;03;13;Perjantai;6;57;63;6;8;14
293;02.03.2018;2018;03;14;Perjantai;5;56;61;3;11;14
293;02.03.2018;2018;03;15;Perjantai;3;10;13;4;2;6
293;02.03.2018;2018;03;16;Perjantai;7;8;15;4;6;10
293;02.03.2018;2018;03;17;Perjantai;10;8;18;0;8;8
293;02.03.2018;2018;03;18;Perjantai;2;3;5;2;5;7
293;02.03.2018;2018;03;19;Perjantai;2;7;9;5;8;13
293;02.03.2018;2018;03;20;Perjantai;2;5;7;0;0;0
293;02.03.2018;2018;03;21;Perjantai;0;1;1;2;0;2
293;02.03.2018;2018;03;22;Perjantai;0;0;0;0;0;0
293;02.03.2018;2018;03;23;Perjantai;1;0;1;1;0;1
293;03.03.2018;2018;03;00;Lauantai;1;0;1;0;2;2
293;03.03.2018;2018;03;01;Lauantai;0;0;0;3;0;3
293;03.03.2018;2018;03;02;Lauantai;0;1;1;0;1;1
293;03.03.2018;2018;03;03;Lauantai;0;0;0;0;0;0
293;03.03.2018;2018;03;04;Lauantai;0;0;0;0;1;1
293;03.03.2018;2018;03;05;Lauantai;0;0;0;0;0;0
293;03.03.2018;2018;03;06;Lauantai;1;0;1;0;0;0
293;03.03.2018;2018;03;07;Lauantai;1;0;1;2;0;2
293;03.03.2018;2018;03;08;Lauantai;2;1;3;4;1;5
293;03.03.2018;2018;03;09;Lauantai;4;4;8;3;6;9
293;03.03.2018;2018;03;10;Lauantai;1;1;2;8;2;10
293;03.03.2018;2018;03;11;Lauantai;2;3;5;4;7;11
293;03.03.2018;2018;03;12;Lauantai;4;1;5;6;8;14
293;03.03.2018;2018;03;13;Lauantai;5;3;8;6;7;13
293;03.03.2018;2018;03;14;Lauantai;4;4;8;3;3;6
293;03.03.2018;2018;03;15;Lauantai;2;0;2;2;9;11
293;03.03.2018;2018;03;16;Lauantai;0;6;6;5;2;7
293;03.03.2018;2018;03;17;Lauantai;6;6;12;3;4;7
293;03.03.2018;2018;03;18;Lauantai;8;1;9;2;4;6
293;03.03.2018;2018;03;19;Lauantai;6;9;15;2;5;7
293;03.03.2018;2018;03;20;Lauantai;3;8;11;0;3;3
293;03.03.2018;2018;03;21;Lauantai;0;3;3;0;0;0
293;03.03.2018;2018;03;22;Lauantai;1;0;1;1;0;1
293;03.03.2018;2018;03;23;Lauantai;1;0;1;1;1;2
293;04.03.2018;2018;03;00;Sunnuntai;0;0;0;0;0;0
293;04.03.2018;2018;03;01;Sunnuntai;0;0;0;0;1;1
293;04.03.2018;2018;03;02;Sunnuntai;0;0;0;0;1;1
293;04.03.2018;2018;03;03;Sunnuntai;0;0;0;0;0;0
293;04.03.2018;2018;03;04;Sunnuntai;0;0;0;1;0;1
293;04.03.2018;2018;03;05;Sunnuntai;0;0;0;0;0;0
293;04.03.2018;2018;03;06;Sunnuntai;1;0;1;0;0;0
293;04.03.2018;2018;03;07;Sunnuntai;0;0;0;0;0;0
293;04.03.2018;2018;03;08;Sunnuntai;0;0;0;0;0;0
293;04.03.2018;2018;03;09;Sunnuntai;7;1;8;6;4;10
293;04.03.2018;2018;03;10;Sunnuntai;9;5;14;5;4;9
293;04.03.2018;2018;03;11;Sunnuntai;2;4;6;1;4;5
293;04.03.2018;2018;03;12;Sunnuntai;2;2;4;2;3;5
293;04.03.2018;2018;03;13;Sunnuntai;0;4;4;4;7;11
293;04.03.2018;2018;03;14;Sunnuntai;9;2;11;5;3;8
293;04.03.2018;2018;03;15;Sunnuntai;4;9;13;1;6;7
293;04.03.2018;2018;03;16;Sunnuntai;4;3;7;3;3;6
293;04.03.2018;2018;03;17;Sunnuntai;2;4;6;4;2;6
293;04.03.2018;2018;03;18;Sunnuntai;0;2;2;2;0;2
293;04.03.2018;2018;03;19;Sunnuntai;2;3;5;0;5;5
293;04.03.2018;2018;03;20;Sunnuntai;2;3;5;1;1;2
293;04.03.2018;2018;03;21;Sunnuntai;1;2;3;0;0;0
293;04.03.2018;2018;03;22;Sunnuntai;1;0;1;0;0;0
293;04.03.2018;2018;03;23;Sunnuntai;0;0;0;0;1;1
293;05.03.2018;2018;03;00;Maanantai;0;0;0;0;0;0
293;05.03.2018;2018;03;01;Maanantai;0;0;0;0;0;0
293;05.03.2018;2018;03;02;Maanantai;0;0;0;0;0;0
293;05.03.2018;2018;03;03;Maanantai;0;0;0;0;0;0
293;05.03.2018;2018;03;04;Maanantai;0;0;0;0;0;0
293;05.03.2018;2018;03;05;Maanantai;2;0;2;0;0;0
293;05.03.2018;2018;03;06;Maanantai;1;2;3;2;0;2
293;05.03.2018;2018;03;07;Maanantai;3;1;4;2;2;4
293;05.03.2018;2018;03;08;Maanantai;1;1;2;3;0;3
293;05.03.2018;2018;03;09;Maanantai;5;4;9;3;1;4
293;05.03.2018;2018;03;10;Maanantai;3;2;5;3;6;9
293;05.03.2018;2018;03;11;Maanantai;2;6;8;5;3;8
293;05.03.2018;2018;03;12;Maanantai;6;4;10;4;4;8
293;05.03.2018;2018;03;13;Maanantai;4;4;8;6;0;6
293;05.03.2018;2018;03;14;Maanantai;2;6;8;13;6;19
293;05.03.2018;2018;03;15;Maanantai;4;5;9;4;6;10
293;05.03.2018;2018;03;16;Maanantai;2;5;7;4;10;14
293;05.03.2018;2018;03;17;Maanantai;3;3;6;3;4;7
293;05.03.2018;2018;03;18;Maanantai;0;2;2;2;5;7
293;05.03.2018;2018;03;19;Maanantai;1;2;3;2;1;3
293;05.03.2018;2018;03;20;Maanantai;1;1;2;1;1;2
293;05.03.2018;2018;03;21;Maanantai;2;4;6;1;0;1
293;05.03.2018;2018;03;22;Maanantai;1;1;2;0;0;0
293;05.03.2018;2018;03;23;Maanantai;0;0;0;0;0;0
293;06.03.2018;2018;03;00;Tiistai;0;0;0;0;0;0
293;06.03.2018;2018;03;01;Tiistai;0;0;0;0;0;0
293;06.03.2018;2018;03;02;Tiistai;1;0;1;0;0;0
293;06.03.2018;2018;03;03;Tiistai;0;1;1;0;0;0
293;06.03.2018;2018;03;04;Tiistai;0;0;0;0;0;0
293;06.03.2018;2018;03;05;Tiistai;1;0;1;0;0;0
293;06.03.2018;2018;03;06;Tiistai;1;2;3;1;0;1
293;06.03.2018;2018;03;07;Tiistai;6;1;7;1;0;1
293;06.03.2018;2018;03;08;Tiistai;6;1;7;3;0;3
293;06.03.2018;2018;03;09;Tiistai;5;1;6;2;1;3
293;06.03.2018;2018;03;10;Tiistai;1;2;3;9;8;17
293;06.03.2018;2018;03;11;Tiistai;1;2;3;3;5;8
293;06.03.2018;2018;03;12;Tiistai;5;7;12;3;5;8
293;06.03.2018;2018;03;13;Tiistai;3;0;3;5;2;7
293;06.03.2018;2018;03;14;Tiistai;4;4;8;3;3;6
293;06.03.2018;2018;03;15;Tiistai;8;6;14;4;3;7
293;06.03.2018;2018;03;16;Tiistai;0;5;5;0;5;5
293;06.03.2018;2018;03;17;Tiistai;4;3;7;4;9;13
293;06.03.2018;2018;03;18;Tiistai;2;6;8;3;3;6
293;06.03.2018;2018;03;19;Tiistai;4;9;13;3;2;5
293;06.03.2018;2018;03;20;Tiistai;1;1;2;0;1;1
293;06.03.2018;2018;03;21;Tiistai;1;3;4;0;0;0
293;06.03.2018;2018;03;22;Tiistai;2;0;2;2;0;2
293;06.03.2018;2018;03;23;Tiistai;0;0;0;0;0;0
293;07.03.2018;2018;03;00;Keskiviikko;0;0;0;0;0;0
293;07.03.2018;2018;03;01;Keskiviikko;0;0;0;0;1;1
293;07.03.2018;2018;03;02;Keskiviikko;0;0;0;0;0;0
293;07.03.2018;2018;03;03;Keskiviikko;1;0;1;0;0;0
293;07.03.2018;2018;03;04;Keskiviikko;0;0;0;0;0;0
293;07.03.2018;2018;03;05;Keskiviikko;2;0;2;0;0;0
293;07.03.2018;2018;03;06;Keskiviikko;1;2;3;3;0;3
293;07.03.2018;2018;03;07;Keskiviikko;8;1;9;2;0;2
293;07.03.2018;2018;03;08;Keskiviikko;2;2;4;3;2;5
293;07.03.2018;2018;03;09;Keskiviikko;1;2;3;2;3;5
293;07.03.2018;2018;03;10;Keskiviikko;4;0;4;0;4;4
293;07.03.2018;2018;03;11;Keskiviikko;4;5;9;3;5;8
293;07.03.2018;2018;03;12;Keskiviikko;2;2;4;4;2;6
293;07.03.2018;2018;03;13;Keskiviikko;5;3;8;4;3;7
293;07.03.2018;2018;03;14;Keskiviikko;4;6;10;3;6;9
293;07.03.2018;2018;03;15;Keskiviikko;6;2;8;7;5;12
293;07.03.2018;2018;03;16;Keskiviikko;5;9;14;2;5;7
293;07.03.2018;2018;03;17;Keskiviikko;3;6;9;4;3;7
293;07.03.2018;2018;03;18;Keskiviikko;2;6;8;1;4;5
293;07.03.2018;2018;03;19;Keskiviikko;5;3;8;2;2;4
293;07.03.2018;2018;03;20;Keskiviikko;3;5;8;0;5;5
293;07.03.2018;2018;03;21;Keskiviikko;0;0;0;1;1;2
293;07.03.2018;2018;03;22;Keskiviikko;0;2;2;0;0;0
293;07.03.2018;2018;03;23;Keskiviikko;0;1;1;0;0;0
293;08.03.2018;2018;03;00;Torstai;0;0;0;0;0;0
293;08.03.2018;2018;03;01;Torstai;0;0;0;0;0;0
293;08.03.2018;2018;03;02;Torstai;1;0;1;0;0;0
293;08.03.2018;2018;03;03;Torstai;0;0;0;0;0;0
293;08.03.2018;2018;03;04;Torstai;0;0;0;0;0;0
293;08.03.2018;2018;03;05;Torstai;2;0;2;0;0;0
293;08.03.2018;2018;03;06;Torstai;3;2;5;2;0;2
293;08.03.2018;2018;03;07;Torstai;4;0;4;2;1;3
293;08.03.2018;2018;03;08;Torstai;3;0;3;2;1;3
293;08.03.2018;2018;03;09;Torstai;5;4;9;2;3;5
293;08.03.2018;2018;03;10;Torstai;4;4;8;1;3;4
293;08.03.2018;2018;03;11;Torstai;0;1;1;8;4;12
293;08.03.2018;2018;03;12;Torstai;3;3;6;7;5;12
293;08.03.2018;2018;03;13;Torstai;5;2;7;8;8;16
293;08.03.2018;2018;03;14;Torstai;4;4;8;5;5;10
293;08.03.2018;2018;03;15;Torstai;2;10;12;1;3;4
293;08.03.2018;2018;03;16;Torstai;1;2;3;4;5;9
293;08.03.2018;2018;03;17;Torstai;4;3;7;6;4;10
293;08.03.2018;2018;03;18;Torstai;3;0;3;3;2;5
293;08.03.2018;2018;03;19;Torstai;6;5;11;2;0;2
293;08.03.2018;2018;03;20;Torstai;0;3;3;0;1;1
293;08.03.2018;2018;03;21;Torstai;1;3;4;0;0;0
293;08.03.2018;2018;03;22;Torstai;1;1;2;0;1;1
293;08.03.2018;2018;03;23;Torstai;0;1;1;0;0;0
293;09.03.2018;2018;03;00;Perjantai;0;0;0;0;0;0
293;09.03.2018;2018;03;01;Perjantai;0;0;0;0;0;0
293;09.03.2018;2018;03;02;Perjantai;0;0;0;0;0;0
293;09.03.2018;2018;03;03;Perjantai;1;0;1;0;0;0
293;09.03.2018;2018;03;04;Perjantai;0;0;0;0;0;0
293;09.03.2018;2018;03;05;Perjantai;1;0;1;0;0;0
293;09.03.2018;2018;03;06;Perjantai;2;1;3;2;0;2
293;09.03.2018;2018;03;07;Perjantai;1;0;1;2;0;2
293;09.03.2018;2018;03;08;Perjantai;5;1;6;4;2;6
293;09.03.2018;2018;03;09;Perjantai;3;6;9;1;2;3
293;09.03.2018;2018;03;10;Perjantai;2;3;5;7;4;11
293;09.03.2018;2018;03;11;Perjantai;2;3;5;2;2;4
293;09.03.2018;2018;03;12;Perjantai;3;3;6;2;3;5
293;09.03.2018;2018;03;13;Perjantai;6;3;9;5;5;10
293;09.03.2018;2018;03;14;Perjantai;4;4;8;4;10;14
293;09.03.2018;2018;03;15;Perjantai;3;3;6;7;2;9
293;09.03.2018;2018;03;16;Perjantai;0;0;0;4;5;9
293;09.03.2018;2018;03;17;Perjantai;1;5;6;3;9;12
293;09.03.2018;2018;03;18;Perjantai;1;2;3;4;5;9
293;09.03.2018;2018;03;19;Perjantai;3;2;5;0;3;3
293;09.03.2018;2018;03;20;Perjantai;1;2;3;0;0;0
293;09.03.2018;2018;03;21;Perjantai;2;3;5;0;1;1
293;09.03.2018;2018;03;22;Perjantai;0;1;1;0;0;0
293;09.03.2018;2018;03;23;Perjantai;0;0;0;1;0;1
293;10.03.2018;2018;03;00;Lauantai;0;0;0;0;0;0
293;10.03.2018;2018;03;01;Lauantai;1;0;1;0;0;0
293;10.03.2018;2018;03;02;Lauantai;0;0;0;0;0;0
293;10.03.2018;2018;03;03;Lauantai;0;1;1;0;1;1
293;10.03.2018;2018;03;04;Lauantai;0;0;0;0;0;0
293;10.03.2018;2018;03;05;Lauantai;0;0;0;0;0;0
293;10.03.2018;2018;03;06;Lauantai;1;0;1;0;1;1
293;10.03.2018;2018;03;07;Lauantai;1;1;2;0;0;0
293;10.03.2018;2018;03;08;Lauantai;1;0;1;3;1;4
293;10.03.2018;2018;03;09;Lauantai;2;2;4;2;3;5
293;10.03.2018;2018;03;10;Lauantai;1;2;3;6;3;9
293;10.03.2018;2018;03;11;Lauantai;1;0;1;9;2;11
293;10.03.2018;2018;03;12;Lauantai;2;2;4;6;2;8
293;10.03.2018;2018;03;13;Lauantai;3;1;4;11;4;15
293;10.03.2018;2018;03;14;Lauantai;1;4;5;6;3;9
293;10.03.2018;2018;03;15;Lauantai;6;1;7;3;5;8
293;10.03.2018;2018;03;16;Lauantai;6;5;11;11;11;22
293;10.03.2018;2018;03;17;Lauantai;4;6;10;2;8;10
293;10.03.2018;2018;03;18;Lauantai;5;4;9;4;1;5
293;10.03.2018;2018;03;19;Lauantai;2;4;6;5;9;14
293;10.03.2018;2018;03;20;Lauantai;5;4;9;0;2;2
293;10.03.2018;2018;03;21;Lauantai;3;5;8;0;1;1
293;10.03.2018;2018;03;22;Lauantai;2;2;4;0;1;1
293;10.03.2018;2018;03;23;Lauantai;0;0;0;0;0;0
293;11.03.2018;2018;03;00;Sunnuntai;0;2;2;0;2;2
293;11.03.2018;2018;03;01;Sunnuntai;0;0;0;0;0;0
293;11.03.2018;2018;03;02;Sunnuntai;0;0;0;0;0;0
293;11.03.2018;2018;03;03;Sunnuntai;0;0;0;0;0;0
293;11.03.2018;2018;03;04;Sunnuntai;0;0;0;1;2;3
293;11.03.2018;2018;03;05;Sunnuntai;0;0;0;1;0;1
293;11.03.2018;2018;03;06;Sunnuntai;0;1;1;0;0;0
293;11.03.2018;2018;03;07;Sunnuntai;0;0;0;0;0;0
293;11.03.2018;2018;03;08;Sunnuntai;0;0;0;3;0;3
293;11.03.2018;2018;03;09;Sunnuntai;1;1;2;0;2;2
293;11.03.2018;2018;03;10;Sunnuntai;4;0;4;3;3;6
293;11.03.2018;2018;03;11;Sunnuntai;3;3;6;0;0;0
293;11.03.2018;2018;03;12;Sunnuntai;5;5;10;0;0;0
293;11.03.2018;2018;03;13;Sunnuntai;3;3;6;0;0;0
293;11.03.2018;2018;03;14;Sunnuntai;2;3;5;0;3;3
293;11.03.2018;2018;03;15;Sunnuntai;1;3;4;2;3;5
293;11.03.2018;2018;03;16;Sunnuntai;4;3;7;2;2;4
293;11.03.2018;2018;03;17;Sunnuntai;3;5;8;1;3;4
293;11.03.2018;2018;03;18;Sunnuntai;5;0;5;3;4;7
293;11.03.2018;2018;03;19;Sunnuntai;3;1;4;1;1;2
293;11.03.2018;2018;03;20;Sunnuntai;2;3;5;1;3;4
293;11.03.2018;2018;03;21;Sunnuntai;3;2;5;1;0;1
293;11.03.2018;2018;03;22;Sunnuntai;0;0;0;0;0;0
293;11.03.2018;2018;03;23;Sunnuntai;0;0;0;0;0;0
293;12.03.2018;2018;03;00;Maanantai;0;0;0;0;0;0
293;12.03.2018;2018;03;01;Maanantai;0;0;0;0;0;0
293;12.03.2018;2018;03;02;Maanantai;0;0;0;0;0;0
293;12.03.2018;2018;03;03;Maanantai;0;0;0;0;0;0
293;12.03.2018;2018;03;04;Maanantai;0;0;0;0;0;0
293;12.03.2018;2018;03;05;Maanantai;2;0;2;0;0;0
293;12.03.2018;2018;03;06;Maanantai;4;1;5;2;0;2
293;12.03.2018;2018;03;07;Maanantai;63;2;65;6;3;9
293;12.03.2018;2018;03;08;Maanantai;79;6;85;12;2;14
293;12.03.2018;2018;03;09;Maanantai;22;3;25;2;1;3
293;12.03.2018;2018;03;10;Maanantai;10;2;12;5;5;10
293;12.03.2018;2018;03;11;Maanantai;0;4;4;3;5;8
293;12.03.2018;2018;03;12;Maanantai;4;6;10;3;6;9
293;12.03.2018;2018;03;13;Maanantai;2;17;19;7;12;19
293;12.03.2018;2018;03;14;Maanantai;3;36;39;3;8;11
293;12.03.2018;2018;03;15;Maanantai;15;104;119;2;17;19
293;12.03.2018;2018;03;16;Maanantai;5;12;17;5;7;12
293;12.03.2018;2018;03;17;Maanantai;8;4;12;3;7;10
293;12.03.2018;2018;03;18;Maanantai;3;3;6;2;0;2
293;12.03.2018;2018;03;19;Maanantai;5;5;10;0;0;0
293;12.03.2018;2018;03;20;Maanantai;1;1;2;0;0;0
293;12.03.2018;2018;03;21;Maanantai;2;1;3;0;0;0
293;12.03.2018;2018;03;22;Maanantai;0;0;0;0;0;0
293;12.03.2018;2018;03;23;Maanantai;0;0;0;0;0;0
293;13.03.2018;2018;03;00;Tiistai;0;0;0;0;0;0
293;13.03.2018;2018;03;01;Tiistai;0;0;0;0;0;0
293;13.03.2018;2018;03;02;Tiistai;0;0;0;0;0;0
293;13.03.2018;2018;03;03;Tiistai;1;0;1;0;0;0
293;13.03.2018;2018;03;04;Tiistai;0;0;0;0;0;0
293;13.03.2018;2018;03;05;Tiistai;0;0;0;0;0;0
293;13.03.2018;2018;03;06;Tiistai;6;5;11;1;0;1
293;13.03.2018;2018;03;07;Tiistai;26;26;52;1;0;1
293;13.03.2018;2018;03;08;Tiistai;26;26;52;3;0;3
293;13.03.2018;2018;03;09;Tiistai;12;12;24;3;0;3
293;13.03.2018;2018;03;10;Tiistai;4;3;7;17;0;17
293;13.03.2018;2018;03;11;Tiistai;1;0;1;8;0;8
293;13.03.2018;2018;03;12;Tiistai;8;7;15;8;0;8
293;13.03.2018;2018;03;13;Tiistai;12;11;23;7;0;7
293;13.03.2018;2018;03;14;Tiistai;23;23;46;6;0;6
293;13.03.2018;2018;03;15;Tiistai;33;32;65;7;0;7
293;13.03.2018;2018;03;16;Tiistai;8;8;16;5;0;5
293;13.03.2018;2018;03;17;Tiistai;4;4;8;13;0;13
293;13.03.2018;2018;03;18;Tiistai;7;6;13;6;0;6
293;13.03.2018;2018;03;19;Tiistai;5;5;10;5;0;5
293;13.03.2018;2018;03;20;Tiistai;1;1;2;1;0;1
293;13.03.2018;2018;03;21;Tiistai;1;0;1;0;0;0
293;13.03.2018;2018;03;22;Tiistai;0;0;0;2;0;2
293;13.03.2018;2018;03;23;Tiistai;0;0;0;0;0;0
293;14.03.2018;2018;03;00;Keskiviikko;0;0;0;0;0;0
293;14.03.2018;2018;03;01;Keskiviikko;0;0;0;1;0;1
293;14.03.2018;2018;03;02;Keskiviikko;0;0;0;0;0;0
293;14.03.2018;2018;03;03;Keskiviikko;1;0;1;0;0;0
293;14.03.2018;2018;03;04;Keskiviikko;0;0;0;0;0;0
293;14.03.2018;2018;03;05;Keskiviikko;0;0;0;0;0;0
293;14.03.2018;2018;03;06;Keskiviikko;4;3;7;3;0;3
293;14.03.2018;2018;03;07;Keskiviikko;40;39;79;2;0;2
293;14.03.2018;2018;03;08;Keskiviikko;25;25;50;5;0;5
293;14.03.2018;2018;03;09;Keskiviikko;4;4;8;5;0;5
293;14.03.2018;2018;03;10;Keskiviikko;3;2;5;4;0;4
293;14.03.2018;2018;03;11;Keskiviikko;2;2;4;8;0;8
293;14.03.2018;2018;03;12;Keskiviikko;5;4;9;6;0;6
293;14.03.2018;2018;03;13;Keskiviikko;10;9;19;7;0;7
293;14.03.2018;2018;03;14;Keskiviikko;42;42;84;9;0;9
293;14.03.2018;2018;03;15;Keskiviikko;14;14;28;12;0;12
293;14.03.2018;2018;03;16;Keskiviikko;9;9;18;7;0;7
293;14.03.2018;2018;03;17;Keskiviikko;5;5;10;7;0;7
293;14.03.2018;2018;03;18;Keskiviikko;7;6;13;5;0;5
293;14.03.2018;2018;03;19;Keskiviikko;9;9;18;4;0;4
293;14.03.2018;2018;03;20;Keskiviikko;6;5;11;5;0;5
293;14.03.2018;2018;03;21;Keskiviikko;2;1;3;2;0;2
293;14.03.2018;2018;03;22;Keskiviikko;0;0;0;0;0;0
293;14.03.2018;2018;03;23;Keskiviikko;0;0;0;0;0;0
293;15.03.2018;2018;03;00;Torstai;0;0;0;0;0;0
293;15.03.2018;2018;03;01;Torstai;0;0;0;0;0;0
293;15.03.2018;2018;03;02;Torstai;0;0;0;0;0;0
293;15.03.2018;2018;03;03;Torstai;1;0;1;0;0;0
293;15.03.2018;2018;03;04;Torstai;0;0;0;0;0;0
293;15.03.2018;2018;03;05;Torstai;1;1;2;0;0;0
293;15.03.2018;2018;03;06;Torstai;4;3;7;0;0;0
293;15.03.2018;2018;03;07;Torstai;19;19;38;2;2;4
293;15.03.2018;2018;03;08;Torstai;38;22;60;4;4;8
293;15.03.2018;2018;03;09;Torstai;20;1;21;4;5;9
293;15.03.2018;2018;03;10;Torstai;8;5;13;3;4;7
293;15.03.2018;2018;03;11;Torstai;3;2;5;9;4;13
293;15.03.2018;2018;03;12;Torstai;3;17;20;2;15;17
293;15.03.2018;2018;03;13;Torstai;3;28;31;13;10;23
293;15.03.2018;2018;03;14;Torstai;1;14;15;3;10;13
293;15.03.2018;2018;03;15;Torstai;4;42;46;4;7;11
293;15.03.2018;2018;03;16;Torstai;5;4;9;9;9;18
293;15.03.2018;2018;03;17;Torstai;6;9;15;3;7;10
293;15.03.2018;2018;03;18;Torstai;1;5;6;12;6;18
293;15.03.2018;2018;03;19;Torstai;1;4;5;3;2;5
293;15.03.2018;2018;03;20;Torstai;1;2;3;1;2;3
293;15.03.2018;2018;03;21;Torstai;0;1;1;2;0;2
293;15.03.2018;2018;03;22;Torstai;0;1;1;1;0;1
293;15.03.2018;2018;03;23;Torstai;0;0;0;0;0;0
293;16.03.2018;2018;03;00;Perjantai;0;0;0;0;0;0
293;16.03.2018;2018;03;01;Perjantai;0;0;0;0;0;0
293;16.03.2018;2018;03;02;Perjantai;0;0;0;0;0;0
293;16.03.2018;2018;03;03;Perjantai;1;0;1;0;0;0
293;16.03.2018;2018;03;04;Perjantai;0;0;0;0;0;0
293;16.03.2018;2018;03;05;Perjantai;1;0;1;0;0;0
293;16.03.2018;2018;03;06;Perjantai;3;2;5;3;0;3
293;16.03.2018;2018;03;07;Perjantai;59;2;61;11;1;12
293;16.03.2018;2018;03;08;Perjantai;54;1;55;9;0;9
293;16.03.2018;2018;03;09;Perjantai;12;2;14;6;2;8
293;16.03.2018;2018;03;10;Perjantai;18;3;21;2;2;4
293;16.03.2018;2018;03;11;Perjantai;6;3;9;5;2;7
293;16.03.2018;2018;03;12;Perjantai;4;14;18;3;11;14
293;16.03.2018;2018;03;13;Perjantai;3;26;29;9;14;23
293;16.03.2018;2018;03;14;Perjantai;5;66;71;9;15;24
293;16.03.2018;2018;03;15;Perjantai;4;30;34;0;15;15
293;16.03.2018;2018;03;16;Perjantai;6;7;13;1;4;5
293;16.03.2018;2018;03;17;Perjantai;9;8;17;7;4;11
293;16.03.2018;2018;03;18;Perjantai;2;6;8;2;3;5
293;16.03.2018;2018;03;19;Perjantai;4;8;12;3;4;7
293;16.03.2018;2018;03;20;Perjantai;6;11;17;2;1;3
293;16.03.2018;2018;03;21;Perjantai;2;2;4;1;1;2
293;16.03.2018;2018;03;22;Perjantai;1;0;1;1;0;1
293;16.03.2018;2018;03;23;Perjantai;0;0;0;0;0;0
293;17.03.2018;2018;03;00;Lauantai;0;1;1;0;0;0
293;17.03.2018;2018;03;01;Lauantai;0;0;0;0;1;1
293;17.03.2018;2018;03;02;Lauantai;0;0;0;0;0;0
293;17.03.2018;2018;03;03;Lauantai;0;0;0;0;0;0
293;17.03.2018;2018;03;04;Lauantai;0;0;0;1;0;1
293;17.03.2018;2018;03;05;Lauantai;0;0;0;1;1;2
293;17.03.2018;2018;03;06;Lauantai;0;0;0;0;0;0
293;17.03.2018;2018;03;07;Lauantai;2;1;3;0;0;0
293;17.03.2018;2018;03;08;Lauantai;1;0;1;1;1;2
293;17.03.2018;2018;03;09;Lauantai;3;3;6;1;1;2
293;17.03.2018;2018;03;10;Lauantai;5;0;5;11;3;14
293;17.03.2018;2018;03;11;Lauantai;5;4;9;8;34;42
293;17.03.2018;2018;03;12;Lauantai;5;5;10;5;7;12
293;17.03.2018;2018;03;13;Lauantai;8;4;12;6;4;10
293;17.03.2018;2018;03;14;Lauantai;2;4;6;3;6;9
293;17.03.2018;2018;03;15;Lauantai;5;5;10;5;3;8
293;17.03.2018;2018;03;16;Lauantai;2;3;5;5;4;9
293;17.03.2018;2018;03;17;Lauantai;10;8;18;2;4;6
293;17.03.2018;2018;03;18;Lauantai;2;8;10;2;6;8
293;17.03.2018;2018;03;19;Lauantai;10;8;18;0;4;4
293;17.03.2018;2018;03;20;Lauantai;2;6;8;2;3;5
293;17.03.2018;2018;03;21;Lauantai;0;5;5;1;4;5
293;17.03.2018;2018;03;22;Lauantai;0;2;2;1;0;1
293;17.03.2018;2018;03;23;Lauantai;3;0;3;0;0;0
293;18.03.2018;2018;03;00;Sunnuntai;6;0;6;1;1;2
293;18.03.2018;2018;03;01;Sunnuntai;1;0;1;3;1;4
293;18.03.2018;2018;03;02;Sunnuntai;0;1;1;0;0;0
293;18.03.2018;2018;03;03;Sunnuntai;0;0;0;0;1;1
293;18.03.2018;2018;03;04;Sunnuntai;0;0;0;0;0;0
293;18.03.2018;2018;03;05;Sunnuntai;0;0;0;0;0;0
293;18.03.2018;2018;03;06;Sunnuntai;0;0;0;0;0;0
293;18.03.2018;2018;03;07;Sunnuntai;0;0;0;0;0;0
293;18.03.2018;2018;03;08;Sunnuntai;0;0;0;1;1;2
293;18.03.2018;2018;03;09;Sunnuntai;5;0;5;5;3;8
293;18.03.2018;2018;03;10;Sunnuntai;13;4;17;8;6;14
293;18.03.2018;2018;03;11;Sunnuntai;0;7;7;10;14;24
293;18.03.2018;2018;03;12;Sunnuntai;5;8;13;4;0;4
293;18.03.2018;2018;03;13;Sunnuntai;7;1;8;7;5;12
293;18.03.2018;2018;03;14;Sunnuntai;3;4;7;6;4;10
293;18.03.2018;2018;03;15;Sunnuntai;5;3;8;2;2;4
293;18.03.2018;2018;03;16;Sunnuntai;3;1;4;2;3;5
293;18.03.2018;2018;03;17;Sunnuntai;5;1;6;4;4;8
293;18.03.2018;2018;03;18;Sunnuntai;5;7;12;5;2;7
293;18.03.2018;2018;03;19;Sunnuntai;1;2;3;1;6;7
293;18.03.2018;2018;03;20;Sunnuntai;3;8;11;0;2;2
293;18.03.2018;2018;03;21;Sunnuntai;0;2;2;0;0;0
293;18.03.2018;2018;03;22;Sunnuntai;1;0;1;1;0;1
293;18.03.2018;2018;03;23;Sunnuntai;0;0;0;0;0;0
293;19.03.2018;2018;03;00;Maanantai;0;0;0;0;0;0
293;19.03.2018;2018;03;01;Maanantai;0;0;0;0;0;0
293;19.03.2018;2018;03;02;Maanantai;0;1;1;0;0;0
293;19.03.2018;2018;03;03;Maanantai;0;0;0;0;0;0
293;19.03.2018;2018;03;04;Maanantai;0;0;0;0;0;0
293;19.03.2018;2018;03;05;Maanantai;1;0;1;0;0;0
293;19.03.2018;2018;03;06;Maanantai;8;1;9;3;0;3
293;19.03.2018;2018;03;07;Maanantai;55;2;57;6;0;6
293;19.03.2018;2018;03;08;Maanantai;69;3;72;10;2;12
293;19.03.2018;2018;03;09;Maanantai;18;2;20;6;5;11
293;19.03.2018;2018;03;10;Maanantai;6;2;8;3;3;6
293;19.03.2018;2018;03;11;Maanantai;0;1;1;5;6;11
293;19.03.2018;2018;03;12;Maanantai;3;5;8;5;3;8
293;19.03.2018;2018;03;13;Maanantai;5;12;17;5;14;19
293;19.03.2018;2018;03;14;Maanantai;5;39;44;2;11;13
293;19.03.2018;2018;03;15;Maanantai;6;87;93;0;17;17
293;19.03.2018;2018;03;16;Maanantai;14;13;27;10;11;21
293;19.03.2018;2018;03;17;Maanantai;3;11;14;3;5;8
293;19.03.2018;2018;03;18;Maanantai;8;10;18;4;7;11
293;19.03.2018;2018;03;19;Maanantai;7;7;14;6;9;15
293;19.03.2018;2018;03;20;Maanantai;0;3;3;1;4;5
293;19.03.2018;2018;03;21;Maanantai;1;1;2;1;4;5
293;19.03.2018;2018;03;22;Maanantai;0;0;0;0;0;0
293;19.03.2018;2018;03;23;Maanantai;0;0;0;0;0;0
293;20.03.2018;2018;03;00;Tiistai;0;0;0;0;0;0
293;20.03.2018;2018;03;01;Tiistai;0;0;0;0;0;0
293;20.03.2018;2018;03;02;Tiistai;0;0;0;0;0;0
293;20.03.2018;2018;03;03;Tiistai;1;0;1;0;0;0
293;20.03.2018;2018;03;04;Tiistai;0;0;0;0;0;0
293;20.03.2018;2018;03;05;Tiistai;1;0;1;0;0;0
293;20.03.2018;2018;03;06;Tiistai;8;1;9;2;1;3
293;20.03.2018;2018;03;07;Tiistai;64;2;66;13;2;15
293;20.03.2018;2018;03;08;Tiistai;66;4;70;6;0;6
293;20.03.2018;2018;03;09;Tiistai;31;3;34;4;1;5
293;20.03.2018;2018;03;10;Tiistai;11;5;16;7;4;11
293;20.03.2018;2018;03;11;Tiistai;3;6;9;5;2;7
293;20.03.2018;2018;03;12;Tiistai;3;8;11;6;10;16
293;20.03.2018;2018;03;13;Tiistai;6;27;33;5;9;14
293;20.03.2018;2018;03;14;Tiistai;6;48;54;6;9;15
293;20.03.2018;2018;03;15;Tiistai;4;65;69;5;22;27
293;20.03.2018;2018;03;16;Tiistai;7;15;22;9;15;24
293;20.03.2018;2018;03;17;Tiistai;12;10;22;5;7;12
293;20.03.2018;2018;03;18;Tiistai;4;6;10;6;4;10
293;20.03.2018;2018;03;19;Tiistai;3;8;11;1;3;4
293;20.03.2018;2018;03;20;Tiistai;3;3;6;1;1;2
293;20.03.2018;2018;03;21;Tiistai;2;4;6;1;2;3
293;20.03.2018;2018;03;22;Tiistai;0;3;3;0;0;0
293;20.03.2018;2018;03;23;Tiistai;0;0;0;0;0;0
293;21.03.2018;2018;03;00;Keskiviikko;0;0;0;0;0;0
293;21.03.2018;2018;03;01;Keskiviikko;0;0;0;0;0;0
293;21.03.2018;2018;03;02;Keskiviikko;0;0;0;0;0;0
293;21.03.2018;2018;03;03;Keskiviikko;1;0;1;0;0;0
293;21.03.2018;2018;03;04;Keskiviikko;0;0;0;0;0;0
293;21.03.2018;2018;03;05;Keskiviikko;2;0;2;0;0;0
293;21.03.2018;2018;03;06;Keskiviikko;4;0;4;4;0;4
293;21.03.2018;2018;03;07;Keskiviikko;79;2;81;13;1;14
293;21.03.2018;2018;03;08;Keskiviikko;63;2;65;7;1;8
293;21.03.2018;2018;03;09;Keskiviikko;3;2;5;4;1;5
293;21.03.2018;2018;03;10;Keskiviikko;3;1;4;1;1;2
293;21.03.2018;2018;03;11;Keskiviikko;1;4;5;1;1;2
293;21.03.2018;2018;03;12;Keskiviikko;3;6;9;3;6;9
293;21.03.2018;2018;03;13;Keskiviikko;2;49;51;2;17;19
293;21.03.2018;2018;03;14;Keskiviikko;6;57;63;6;15;21
293;21.03.2018;2018;03;15;Keskiviikko;4;17;21;7;13;20
293;21.03.2018;2018;03;16;Keskiviikko;3;15;18;4;6;10
293;21.03.2018;2018;03;17;Keskiviikko;9;5;14;4;3;7
293;21.03.2018;2018;03;18;Keskiviikko;2;6;8;2;4;6
293;21.03.2018;2018;03;19;Keskiviikko;3;8;11;4;8;12
293;21.03.2018;2018;03;20;Keskiviikko;1;8;9;1;5;6
293;21.03.2018;2018;03;21;Keskiviikko;1;0;1;0;2;2
293;21.03.2018;2018;03;22;Keskiviikko;0;0;0;0;0;0
293;21.03.2018;2018;03;23;Keskiviikko;0;0;0;0;0;0
293;22.03.2018;2018;03;00;Torstai;0;0;0;0;0;0
293;22.03.2018;2018;03;01;Torstai;0;0;0;0;0;0
293;22.03.2018;2018;03;02;Torstai;0;0;0;0;0;0
293;22.03.2018;2018;03;03;Torstai;1;0;1;0;0;0
293;22.03.2018;2018;03;04;Torstai;0;0;0;0;0;0
293;22.03.2018;2018;03;05;Torstai;0;0;0;0;0;0
293;22.03.2018;2018;03;06;Torstai;5;1;6;2;1;3
293;22.03.2018;2018;03;07;Torstai;65;3;68;7;0;7
293;22.03.2018;2018;03;08;Torstai;57;2;59;9;3;12
293;22.03.2018;2018;03;09;Torstai;19;2;21;3;4;7
293;22.03.2018;2018;03;10;Torstai;5;6;11;1;3;4
293;22.03.2018;2018;03;11;Torstai;1;2;3;8;5;13
293;22.03.2018;2018;03;12;Torstai;5;5;10;13;4;17
293;22.03.2018;2018;03;13;Torstai;2;20;22;5;9;14
293;22.03.2018;2018;03;14;Torstai;3;55;58;4;20;24
293;22.03.2018;2018;03;15;Torstai;10;41;51;8;20;28
293;22.03.2018;2018;03;16;Torstai;8;18;26;3;6;9
293;22.03.2018;2018;03;17;Torstai;12;6;18;8;3;11
293;22.03.2018;2018;03;18;Torstai;4;4;8;7;8;15
293;22.03.2018;2018;03;19;Torstai;3;8;11;4;6;10
293;22.03.2018;2018;03;20;Torstai;2;3;5;0;3;3
293;22.03.2018;2018;03;21;Torstai;1;3;4;1;1;2
293;22.03.2018;2018;03;22;Torstai;0;0;0;0;0;0
293;22.03.2018;2018;03;23;Torstai;0;0;0;0;0;0
293;23.03.2018;2018;03;00;Perjantai;0;0;0;0;0;0
293;23.03.2018;2018;03;01;Perjantai;0;0;0;0;0;0
293;23.03.2018;2018;03;02;Perjantai;0;0;0;0;0;0
293;23.03.2018;2018;03;03;Perjantai;1;1;2;0;0;0
293;23.03.2018;2018;03;04;Perjantai;0;0;0;0;0;0
293;23.03.2018;2018;03;05;Perjantai;0;0;0;0;0;0
293;23.03.2018;2018;03;06;Perjantai;4;0;4;1;2;3
293;23.03.2018;2018;03;07;Perjantai;69;2;71;8;2;10
293;23.03.2018;2018;03;08;Perjantai;50;2;52;12;1;13
293;23.03.2018;2018;03;09;Perjantai;14;6;20;5;2;7
293;23.03.2018;2018;03;10;Perjantai;16;3;19;6;2;8
293;23.03.2018;2018;03;11;Perjantai;7;2;9;3;2;5
293;23.03.2018;2018;03;12;Perjantai;3;14;17;5;12;17
293;23.03.2018;2018;03;13;Perjantai;2;27;29;2;8;10
293;23.03.2018;2018;03;14;Perjantai;9;61;70;8;15;23
293;23.03.2018;2018;03;15;Perjantai;5;39;44;3;10;13
293;23.03.2018;2018;03;16;Perjantai;12;8;20;5;6;11
293;23.03.2018;2018;03;17;Perjantai;14;10;24;6;9;15
293;23.03.2018;2018;03;18;Perjantai;6;8;14;2;4;6
293;23.03.2018;2018;03;19;Perjantai;1;7;8;2;4;6
293;23.03.2018;2018;03;20;Perjantai;5;8;13;0;0;0
293;23.03.2018;2018;03;21;Perjantai;1;5;6;1;1;2
293;23.03.2018;2018;03;22;Perjantai;1;0;1;1;2;3
293;23.03.2018;2018;03;23;Perjantai;0;1;1;0;0;0
293;24.03.2018;2018;03;00;Lauantai;0;1;1;0;0;0
293;24.03.2018;2018;03;01;Lauantai;0;0;0;0;0;0
293;24.03.2018;2018;03;02;Lauantai;0;0;0;0;0;0
293;24.03.2018;2018;03;03;Lauantai;0;0;0;1;2;3
293;24.03.2018;2018;03;04;Lauantai;0;0;0;0;0;0
293;24.03.2018;2018;03;05;Lauantai;0;0;0;0;0;0
293;24.03.2018;2018;03;06;Lauantai;0;0;0;0;0;0
293;24.03.2018;2018;03;07;Lauantai;3;1;4;0;0;0
293;24.03.2018;2018;03;08;Lauantai;1;1;2;3;0;3
293;24.03.2018;2018;03;09;Lauantai;5;3;8;3;0;3
293;24.03.2018;2018;03;10;Lauantai;2;3;5;14;6;20
293;24.03.2018;2018;03;11;Lauantai;4;4;8;6;4;10
293;24.03.2018;2018;03;12;Lauantai;2;2;4;5;6;11
293;24.03.2018;2018;03;13;Lauantai;6;2;8;10;5;15
293;24.03.2018;2018;03;14;Lauantai;1;5;6;7;5;12
293;24.03.2018;2018;03;15;Lauantai;1;1;2;7;8;15
293;24.03.2018;2018;03;16;Lauantai;6;1;7;7;9;16
293;24.03.2018;2018;03;17;Lauantai;3;6;9;1;5;6
293;24.03.2018;2018;03;18;Lauantai;3;2;5;3;2;5
293;24.03.2018;2018;03;19;Lauantai;3;3;6;1;5;6
293;24.03.2018;2018;03;20;Lauantai;3;4;7;4;0;4
293;24.03.2018;2018;03;21;Lauantai;0;1;1;0;2;2
293;24.03.2018;2018;03;22;Lauantai;0;0;0;1;0;1
293;24.03.2018;2018;03;23;Lauantai;0;0;0;0;1;1
293;25.03.2018;2018;03;00;Sunnuntai;0;0;0;2;1;3
293;25.03.2018;2018;03;01;Sunnuntai;0;0;0;0;0;0
293;25.03.2018;2018;03;02;Sunnuntai;0;0;0;0;1;1
293;25.03.2018;2018;03;03;Sunnuntai;0;0;0;0;0;0
293;25.03.2018;2018;03;04;Sunnuntai;0;0;0;1;3;4
293;25.03.2018;2018;03;05;Sunnuntai;0;0;0;0;0;0
293;25.03.2018;2018;03;06;Sunnuntai;1;0;1;1;1;2
293;25.03.2018;2018;03;07;Sunnuntai;1;0;1;0;0;0
293;25.03.2018;2018;03;08;Sunnuntai;0;0;0;1;1;2
293;25.03.2018;2018;03;09;Sunnuntai;1;1;2;1;2;3
293;25.03.2018;2018;03;10;Sunnuntai;7;0;7;3;3;6
293;25.03.2018;2018;03;11;Sunnuntai;8;1;9;10;4;14
293;25.03.2018;2018;03;12;Sunnuntai;5;5;10;9;7;16
293;25.03.2018;2018;03;13;Sunnuntai;3;5;8;9;15;24
293;25.03.2018;2018;03;14;Sunnuntai;6;5;11;14;7;21
293;25.03.2018;2018;03;15;Sunnuntai;4;7;11;6;9;15
293;25.03.2018;2018;03;16;Sunnuntai;10;7;17;3;8;11
293;25.03.2018;2018;03;17;Sunnuntai;5;11;16;1;6;7
293;25.03.2018;2018;03;18;Sunnuntai;5;2;7;1;8;9
293;25.03.2018;2018;03;19;Sunnuntai;4;3;7;3;3;6
293;25.03.2018;2018;03;20;Sunnuntai;2;3;5;2;3;5
293;25.03.2018;2018;03;21;Sunnuntai;0;1;1;0;0;0
293;25.03.2018;2018;03;22;Sunnuntai;0;0;0;0;0;0
293;25.03.2018;2018;03;23;Sunnuntai;0;0;0;0;0;0
293;26.03.2018;2018;03;00;Maanantai;0;0;0;0;0;0
293;26.03.2018;2018;03;01;Maanantai;0;0;0;0;0;0
293;26.03.2018;2018;03;02;Maanantai;0;0;0;0;0;0
293;26.03.2018;2018;03;03;Maanantai;1;0;1;0;0;0
293;26.03.2018;2018;03;04;Maanantai;0;0;0;0;0;0
293;26.03.2018;2018;03;05;Maanantai;2;0;2;0;0;0
293;26.03.2018;2018;03;06;Maanantai;5;2;7;0;0;0
293;26.03.2018;2018;03;07;Maanantai;49;2;51;6;0;6
293;26.03.2018;2018;03;08;Maanantai;81;6;87;16;6;22
293;26.03.2018;2018;03;09;Maanantai;18;3;21;11;1;12
293;26.03.2018;2018;03;10;Maanantai;8;2;10;3;1;4
293;26.03.2018;2018;03;11;Maanantai;1;4;5;4;7;11
293;26.03.2018;2018;03;12;Maanantai;3;4;7;1;5;6
293;26.03.2018;2018;03;13;Maanantai;2;16;18;6;5;11
293;26.03.2018;2018;03;14;Maanantai;4;40;44;6;15;21
293;26.03.2018;2018;03;15;Maanantai;10;79;89;7;14;21
293;26.03.2018;2018;03;16;Maanantai;6;19;25;4;11;15
293;26.03.2018;2018;03;17;Maanantai;5;12;17;7;6;13
293;26.03.2018;2018;03;18;Maanantai;4;8;12;7;10;17
293;26.03.2018;2018;03;19;Maanantai;7;7;14;1;4;5
293;26.03.2018;2018;03;20;Maanantai;2;6;8;1;3;4
293;26.03.2018;2018;03;21;Maanantai;3;4;7;1;1;2
293;26.03.2018;2018;03;22;Maanantai;0;0;0;0;0;0
293;26.03.2018;2018;03;23;Maanantai;0;0;0;0;0;0
293;27.03.2018;2018;03;00;Tiistai;0;0;0;0;0;0
293;27.03.2018;2018;03;01;Tiistai;0;0;0;0;0;0
293;27.03.2018;2018;03;02;Tiistai;0;0;0;0;0;0
293;27.03.2018;2018;03;03;Tiistai;1;0;1;0;0;0
293;27.03.2018;2018;03;04;Tiistai;0;0;0;1;0;1
293;27.03.2018;2018;03;05;Tiistai;1;0;1;0;0;0
293;27.03.2018;2018;03;06;Tiistai;5;2;7;3;0;3
293;27.03.2018;2018;03;07;Tiistai;46;1;47;9;1;10
293;27.03.2018;2018;03;08;Tiistai;62;2;64;5;1;6
293;27.03.2018;2018;03;09;Tiistai;21;1;22;4;3;7
293;27.03.2018;2018;03;10;Tiistai;15;3;18;5;2;7
293;27.03.2018;2018;03;11;Tiistai;3;3;6;6;8;14
293;27.03.2018;2018;03;12;Tiistai;3;9;12;6;7;13
293;27.03.2018;2018;03;13;Tiistai;3;21;24;8;11;19
293;27.03.2018;2018;03;14;Tiistai;8;47;55;4;14;18
293;27.03.2018;2018;03;15;Tiistai;3;53;56;2;15;17
293;27.03.2018;2018;03;16;Tiistai;10;6;16;2;6;8
293;27.03.2018;2018;03;17;Tiistai;8;15;23;10;2;12
293;27.03.2018;2018;03;18;Tiistai;7;7;14;10;13;23
293;27.03.2018;2018;03;19;Tiistai;2;11;13;3;6;9
293;27.03.2018;2018;03;20;Tiistai;1;7;8;1;2;3
293;27.03.2018;2018;03;21;Tiistai;1;0;1;1;1;2
293;27.03.2018;2018;03;22;Tiistai;0;0;0;0;0;0
293;27.03.2018;2018;03;23;Tiistai;0;0;0;0;0;0
293;28.03.2018;2018;03;00;Keskiviikko;0;0;0;0;0;0
293;28.03.2018;2018;03;01;Keskiviikko;0;0;0;0;0;0
293;28.03.2018;2018;03;02;Keskiviikko;0;0;0;0;0;0
293;28.03.2018;2018;03;03;Keskiviikko;1;0;1;0;0;0
293;28.03.2018;2018;03;04;Keskiviikko;0;0;0;1;0;1
293;28.03.2018;2018;03;05;Keskiviikko;1;0;1;0;1;1
293;28.03.2018;2018;03;06;Keskiviikko;7;1;8;1;0;1
293;28.03.2018;2018;03;07;Keskiviikko;56;1;57;14;2;16
293;28.03.2018;2018;03;08;Keskiviikko;72;4;76;10;2;12
293;28.03.2018;2018;03;09;Keskiviikko;8;0;8;2;3;5
293;28.03.2018;2018;03;10;Keskiviikko;7;3;10;6;5;11
293;28.03.2018;2018;03;11;Keskiviikko;2;6;8;6;6;12
293;28.03.2018;2018;03;12;Keskiviikko;1;5;6;3;4;7
293;28.03.2018;2018;03;13;Keskiviikko;6;38;44;5;9;14
293;28.03.2018;2018;03;14;Keskiviikko;6;73;79;5;16;21
293;28.03.2018;2018;03;15;Keskiviikko;9;12;21;2;10;12
293;28.03.2018;2018;03;16;Keskiviikko;6;13;19;4;9;13
293;28.03.2018;2018;03;17;Keskiviikko;5;4;9;3;5;8
293;28.03.2018;2018;03;18;Keskiviikko;2;8;10;8;7;15
293;28.03.2018;2018;03;19;Keskiviikko;7;3;10;2;5;7
293;28.03.2018;2018;03;20;Keskiviikko;0;4;4;1;2;3
293;28.03.2018;2018;03;21;Keskiviikko;1;1;2;0;0;0
293;28.03.2018;2018;03;22;Keskiviikko;0;0;0;0;0;0
293;28.03.2018;2018;03;23;Keskiviikko;0;0;0;1;0;1
293;29.03.2018;2018;03;00;Torstai;0;0;0;0;0;0
293;29.03.2018;2018;03;01;Torstai;0;0;0;0;0;0
293;29.03.2018;2018;03;02;Torstai;0;0;0;0;0;0
293;29.03.2018;2018;03;03;Torstai;1;0;1;0;0;0
293;29.03.2018;2018;03;04;Torstai;0;0;0;0;0;0
293;29.03.2018;2018;03;05;Torstai;0;0;0;0;0;0
293;29.03.2018;2018;03;06;Torstai;4;1;5;1;1;2
293;29.03.2018;2018;03;07;Torstai;35;0;35;9;1;10
293;29.03.2018;2018;03;08;Torstai;89;3;92;13;0;13
293;29.03.2018;2018;03;09;Torstai;9;3;12;7;4;11
293;29.03.2018;2018;03;10;Torstai;6;4;10;1;3;4
293;29.03.2018;2018;03;11;Torstai;1;5;6;5;7;12
293;29.03.2018;2018;03;12;Torstai;6;9;15;11;6;17
293;29.03.2018;2018;03;13;Torstai;4;47;51;3;7;10
293;29.03.2018;2018;03;14;Torstai;7;50;57;5;14;19
293;29.03.2018;2018;03;15;Torstai;1;24;25;2;2;4
293;29.03.2018;2018;03;16;Torstai;11;16;27;7;9;16
293;29.03.2018;2018;03;17;Torstai;6;5;11;2;7;9
293;29.03.2018;2018;03;18;Torstai;13;7;20;6;1;7
293;29.03.2018;2018;03;19;Torstai;8;11;19;2;6;8
293;29.03.2018;2018;03;20;Torstai;1;6;7;3;0;3
293;29.03.2018;2018;03;21;Torstai;3;3;6;3;4;7
293;29.03.2018;2018;03;22;Torstai;0;3;3;1;1;2
293;29.03.2018;2018;03;23;Torstai;0;1;1;0;2;2
293;30.03.2018;2018;03;00;Perjantai;0;1;1;0;1;1
293;30.03.2018;2018;03;01;Perjantai;0;0;0;0;0;0
293;30.03.2018;2018;03;02;Perjantai;0;0;0;0;0;0
293;30.03.2018;2018;03;03;Perjantai;0;0;0;0;0;0
293;30.03.2018;2018;03;04;Perjantai;0;0;0;0;0;0
293;30.03.2018;2018;03;05;Perjantai;0;0;0;0;0;0
293;30.03.2018;2018;03;06;Perjantai;1;0;1;0;0;0
293;30.03.2018;2018;03;07;Perjantai;2;0;2;1;0;1
293;30.03.2018;2018;03;08;Perjantai;2;1;3;4;4;8
293;30.03.2018;2018;03;09;Perjantai;0;3;3;3;2;5
293;30.03.2018;2018;03;10;Perjantai;4;1;5;4;5;9
293;30.03.2018;2018;03;11;Perjantai;9;5;14;14;4;18
293;30.03.2018;2018;03;12;Perjantai;4;7;11;7;12;19
293;30.03.2018;2018;03;13;Perjantai;8;5;13;3;8;11
293;30.03.2018;2018;03;14;Perjantai;8;5;13;5;6;11
293;30.03.2018;2018;03;15;Perjantai;6;1;7;4;4;8
293;30.03.2018;2018;03;16;Perjantai;3;12;15;6;5;11
293;30.03.2018;2018;03;17;Perjantai;7;5;12;6;12;18
293;30.03.2018;2018;03;18;Perjantai;4;4;8;28;27;55
293;30.03.2018;2018;03;19;Perjantai;5;5;10;1;4;5
293;30.03.2018;2018;03;20;Perjantai;1;4;5;1;0;1
293;30.03.2018;2018;03;21;Perjantai;2;0;2;0;1;1
293;30.03.2018;2018;03;22;Perjantai;0;0;0;1;0;1
293;30.03.2018;2018;03;23;Perjantai;0;0;0;2;2;4
293;31.03.2018;2018;03;00;Lauantai;0;0;0;0;0;0
293;31.03.2018;2018;03;01;Lauantai;1;1;2;0;0;0
293;31.03.2018;2018;03;02;Lauantai;0;0;0;0;1;1
293;31.03.2018;2018;03;03;Lauantai;0;1;1;0;0;0
293;31.03.2018;2018;03;04;Lauantai;0;0;0;0;0;0
293;31.03.2018;2018;03;05;Lauantai;0;0;0;0;0;0
293;31.03.2018;2018;03;06;Lauantai;1;0;1;0;0;0
293;31.03.2018;2018;03;07;Lauantai;0;0;0;2;0;2
293;31.03.2018;2018;03;08;Lauantai;0;1;1;3;1;4
293;31.03.2018;2018;03;09;Lauantai;1;0;1;2;5;7
293;31.03.2018;2018;03;10;Lauantai;5;3;8;4;0;4
293;31.03.2018;2018;03;11;Lauantai;7;4;11;8;1;9
293;31.03.2018;2018;03;12;Lauantai;0;3;3;12;8;20
293;31.03.2018;2018;03;13;Lauantai;2;2;4;6;9;15
293;31.03.2018;2018;03;14;Lauantai;6;0;6;11;7;18
293;31.03.2018;2018;03;15;Lauantai;1;4;5;6;12;18
293;31.03.2018;2018;03;16;Lauantai;4;1;5;1;2;3
293;31.03.2018;2018;03;17;Lauantai;2;4;6;3;8;11
293;31.03.2018;2018;03;18;Lauantai;5;2;7;2;5;7
293;31.03.2018;2018;03;19;Lauantai;2;3;5;6;2;8
293;31.03.2018;2018;03;20;Lauantai;3;3;6;4;2;6
293;31.03.2018;2018;03;21;Lauantai;1;2;3;4;0;4
293;31.03.2018;2018;03;22;Lauantai;3;0;3;1;5;6
293;31.03.2018;2018;03;23;Lauantai;0;1;1;1;1;2
293;01.04.2018;2018;04;00;Sunnuntai;0;2;2;2;1;3
293;01.04.2018;2018;04;01;Sunnuntai;1;2;3;0;1;1
293;01.04.2018;2018;04;02;Sunnuntai;0;0;0;0;0;0
293;01.04.2018;2018;04;03;Sunnuntai;0;0;0;0;2;2
293;01.04.2018;2018;04;04;Sunnuntai;0;0;0;1;0;1
293;01.04.2018;2018;04;05;Sunnuntai;0;0;0;0;0;0
293;01.04.2018;2018;04;06;Sunnuntai;1;0;1;0;0;0
293;01.04.2018;2018;04;07;Sunnuntai;1;0;1;0;0;0
293;01.04.2018;2018;04;08;Sunnuntai;0;0;0;5;3;8
293;01.04.2018;2018;04;09;Sunnuntai;2;3;5;2;5;7
293;01.04.2018;2018;04;10;Sunnuntai;7;3;10;18;7;25
293;01.04.2018;2018;04;11;Sunnuntai;6;4;10;6;3;9
293;01.04.2018;2018;04;12;Sunnuntai;3;1;4;9;13;22
293;01.04.2018;2018;04;13;Sunnuntai;5;4;9;5;9;14
293;01.04.2018;2018;04;14;Sunnuntai;11;3;14;5;5;10
293;01.04.2018;2018;04;15;Sunnuntai;3;7;10;1;3;4
293;01.04.2018;2018;04;16;Sunnuntai;1;11;12;8;4;12
293;01.04.2018;2018;04;17;Sunnuntai;0;5;5;2;2;4
293;01.04.2018;2018;04;18;Sunnuntai;5;3;8;2;7;9
293;01.04.2018;2018;04;19;Sunnuntai;6;4;10;5;5;10
293;01.04.2018;2018;04;20;Sunnuntai;3;4;7;4;2;6
293;01.04.2018;2018;04;21;Sunnuntai;3;1;4;0;1;1
293;01.04.2018;2018;04;22;Sunnuntai;0;6;6;0;0;0
293;01.04.2018;2018;04;23;Sunnuntai;0;0;0;0;0;0
293;02.04.2018;2018;04;00;Maanantai;0;0;0;0;1;1
293;02.04.2018;2018;04;01;Maanantai;0;0;0;0;0;0
293;02.04.2018;2018;04;02;Maanantai;0;0;0;0;0;0
293;02.04.2018;2018;04;03;Maanantai;0;0;0;0;1;1
293;02.04.2018;2018;04;04;Maanantai;0;0;0;0;0;0
293;02.04.2018;2018;04;05;Maanantai;0;0;0;0;0;0
293;02.04.2018;2018;04;06;Maanantai;1;0;1;0;0;0
293;02.04.2018;2018;04;07;Maanantai;1;0;1;0;0;0
293;02.04.2018;2018;04;08;Maanantai;0;1;1;2;0;2
293;02.04.2018;2018;04;09;Maanantai;2;0;2;4;3;7
293;02.04.2018;2018;04;10;Maanantai;5;0;5;4;7;11
293;02.04.2018;2018;04;11;Maanantai;1;11;12;4;1;5
293;02.04.2018;2018;04;12;Maanantai;2;3;5;8;9;17
293;02.04.2018;2018;04;13;Maanantai;6;1;7;2;4;6
293;02.04.2018;2018;04;14;Maanantai;4;5;9;6;5;11
293;02.04.2018;2018;04;15;Maanantai;5;3;8;4;1;5
293;02.04.2018;2018;04;16;Maanantai;3;2;5;5;10;15
293;02.04.2018;2018;04;17;Maanantai;6;6;12;6;9;15
293;02.04.2018;2018;04;18;Maanantai;6;4;10;0;6;6
293;02.04.2018;2018;04;19;Maanantai;2;6;8;3;13;16
293;02.04.2018;2018;04;20;Maanantai;5;3;8;1;4;5
293;02.04.2018;2018;04;21;Maanantai;0;0;0;0;1;1
293;02.04.2018;2018;04;22;Maanantai;1;0;1;0;0;0
293;02.04.2018;2018;04;23;Maanantai;0;0;0;0;0;0
293;03.04.2018;2018;04;00;Tiistai;0;0;0;0;0;0
293;03.04.2018;2018;04;01;Tiistai;0;0;0;0;0;0
293;03.04.2018;2018;04;02;Tiistai;0;0;0;0;0;0
293;03.04.2018;2018;04;03;Tiistai;1;0;1;0;0;0
293;03.04.2018;2018;04;04;Tiistai;0;0;0;0;0;0
293;03.04.2018;2018;04;05;Tiistai;0;0;0;0;0;0
293;03.04.2018;2018;04;06;Tiistai;5;2;7;1;0;1
293;03.04.2018;2018;04;07;Tiistai;48;1;49;23;0;23
293;03.04.2018;2018;04;08;Tiistai;64;6;70;14;2;16
293;03.04.2018;2018;04;09;Tiistai;15;0;15;5;2;7
293;03.04.2018;2018;04;10;Tiistai;5;4;9;1;1;2
293;03.04.2018;2018;04;11;Tiistai;3;10;13;3;3;6
293;03.04.2018;2018;04;12;Tiistai;1;9;10;5;2;7
293;03.04.2018;2018;04;13;Tiistai;3;25;28;1;8;9
293;03.04.2018;2018;04;14;Tiistai;2;41;43;3;15;18
293;03.04.2018;2018;04;15;Tiistai;4;36;40;1;14;15
293;03.04.2018;2018;04;16;Tiistai;2;9;11;3;7;10
293;03.04.2018;2018;04;17;Tiistai;6;5;11;4;8;12
293;03.04.2018;2018;04;18;Tiistai;3;4;7;3;6;9
293;03.04.2018;2018;04;19;Tiistai;2;3;5;5;6;11
293;03.04.2018;2018;04;20;Tiistai;1;3;4;1;2;3
293;03.04.2018;2018;04;21;Tiistai;1;1;2;3;4;7
293;03.04.2018;2018;04;22;Tiistai;0;1;1;0;0;0
293;03.04.2018;2018;04;23;Tiistai;0;0;0;0;0;0
293;04.04.2018;2018;04;00;Keskiviikko;0;0;0;0;0;0
293;04.04.2018;2018;04;01;Keskiviikko;0;0;0;0;0;0
293;04.04.2018;2018;04;02;Keskiviikko;0;0;0;0;0;0
293;04.04.2018;2018;04;03;Keskiviikko;1;0;1;0;0;0
293;04.04.2018;2018;04;04;Keskiviikko;0;0;0;0;1;1
293;04.04.2018;2018;04;05;Keskiviikko;1;0;1;1;0;1
293;04.04.2018;2018;04;06;Keskiviikko;4;1;5;3;0;3
293;04.04.2018;2018;04;07;Keskiviikko;68;2;70;19;3;22
293;04.04.2018;2018;04;08;Keskiviikko;78;2;80;6;6;12
293;04.04.2018;2018;04;09;Keskiviikko;8;1;9;3;4;7
293;04.04.2018;2018;04;10;Keskiviikko;2;5;7;9;5;14
293;04.04.2018;2018;04;11;Keskiviikko;2;10;12;10;13;23
293;04.04.2018;2018;04;12;Keskiviikko;2;1;3;11;8;19
293;04.04.2018;2018;04;13;Keskiviikko;4;33;37;7;15;22
293;04.04.2018;2018;04;14;Keskiviikko;3;77;80;3;18;21
293;04.04.2018;2018;04;15;Keskiviikko;6;21;27;3;9;12
293;04.04.2018;2018;04;16;Keskiviikko;4;6;10;10;9;19
293;04.04.2018;2018;04;17;Keskiviikko;9;6;15;3;6;9
293;04.04.2018;2018;04;18;Keskiviikko;3;7;10;2;3;5
293;04.04.2018;2018;04;19;Keskiviikko;5;4;9;6;10;16
293;04.04.2018;2018;04;20;Keskiviikko;1;6;7;1;3;4
293;04.04.2018;2018;04;21;Keskiviikko;0;1;1;3;3;6
293;04.04.2018;2018;04;22;Keskiviikko;0;0;0;0;0;0
293;04.04.2018;2018;04;23;Keskiviikko;0;0;0;2;2;4
293;05.04.2018;2018;04;00;Torstai;0;0;0;0;0;0
293;05.04.2018;2018;04;01;Torstai;0;0;0;0;0;0
293;05.04.2018;2018;04;02;Torstai;0;0;0;0;0;0
293;05.04.2018;2018;04;03;Torstai;0;0;0;0;0;0
293;05.04.2018;2018;04;04;Torstai;0;0;0;0;0;0
293;05.04.2018;2018;04;05;Torstai;0;0;0;0;0;0
293;05.04.2018;2018;04;06;Torstai;4;4;8;0;0;0
293;05.04.2018;2018;04;07;Torstai;46;3;49;9;1;10
293;05.04.2018;2018;04;08;Torstai;71;4;75;18;5;23
293;05.04.2018;2018;04;09;Torstai;8;2;10;5;2;7
293;05.04.2018;2018;04;10;Torstai;5;3;8;5;0;5
293;05.04.2018;2018;04;11;Torstai;5;4;9;3;4;7
293;05.04.2018;2018;04;12;Torstai;5;7;12;2;5;7
293;05.04.2018;2018;04;13;Torstai;4;30;34;7;7;14
293;05.04.2018;2018;04;14;Torstai;1;56;57;1;15;16
293;05.04.2018;2018;04;15;Torstai;5;40;45;4;9;13
293;05.04.2018;2018;04;16;Torstai;1;3;4;6;4;10
293;05.04.2018;2018;04;17;Torstai;7;5;12;2;8;10
293;05.04.2018;2018;04;18;Torstai;4;7;11;4;5;9
293;05.04.2018;2018;04;19;Torstai;5;11;16;2;3;5
293;05.04.2018;2018;04;20;Torstai;2;2;4;0;0;0
293;05.04.2018;2018;04;21;Torstai;0;1;1;0;0;0
293;05.04.2018;2018;04;22;Torstai;0;0;0;0;0;0
293;05.04.2018;2018;04;23;Torstai;0;0;0;0;0;0
293;06.04.2018;2018;04;00;Perjantai;0;0;0;0;0;0
293;06.04.2018;2018;04;01;Perjantai;0;0;0;0;0;0
293;06.04.2018;2018;04;02;Perjantai;0;0;0;0;0;0
293;06.04.2018;2018;04;03;Perjantai;0;0;0;0;0;0
293;06.04.2018;2018;04;04;Perjantai;0;0;0;0;0;0
293;06.04.2018;2018;04;05;Perjantai;0;0;0;0;0;0
293;06.04.2018;2018;04;06;Perjantai;1;0;1;1;0;1
293;06.04.2018;2018;04;07;Perjantai;39;0;39;13;1;14
293;06.04.2018;2018;04;08;Perjantai;52;0;52;14;3;17
293;06.04.2018;2018;04;09;Perjantai;10;1;11;7;3;10
293;06.04.2018;2018;04;10;Perjantai;5;1;6;3;2;5
293;06.04.2018;2018;04;11;Perjantai;2;3;5;3;0;3
293;06.04.2018;2018;04;12;Perjantai;2;10;12;6;7;13
293;06.04.2018;2018;04;13;Perjantai;2;26;28;0;12;12
293;06.04.2018;2018;04;14;Perjantai;3;44;47;3;16;19
293;06.04.2018;2018;04;15;Perjantai;1;18;19;3;7;10
293;06.04.2018;2018;04;16;Perjantai;9;6;15;1;8;9
293;06.04.2018;2018;04;17;Perjantai;5;6;11;9;5;14
293;06.04.2018;2018;04;18;Perjantai;5;6;11;1;6;7
293;06.04.2018;2018;04;19;Perjantai;1;5;6;3;0;3
293;06.04.2018;2018;04;20;Perjantai;7;12;19;0;6;6
293;06.04.2018;2018;04;21;Perjantai;3;4;7;1;3;4
293;06.04.2018;2018;04;22;Perjantai;0;1;1;0;0;0
293;06.04.2018;2018;04;23;Perjantai;1;1;2;0;0;0
293;07.04.2018;2018;04;00;Lauantai;0;0;0;1;0;1
293;07.04.2018;2018;04;01;Lauantai;0;0;0;0;0;0
293;07.04.2018;2018;04;02;Lauantai;0;0;0;0;1;1
293;07.04.2018;2018;04;03;Lauantai;0;0;0;0;0;0
293;07.04.2018;2018;04;04;Lauantai;0;2;2;0;1;1
293;07.04.2018;2018;04;05;Lauantai;0;0;0;1;1;2
293;07.04.2018;2018;04;06;Lauantai;3;0;3;1;1;2
293;07.04.2018;2018;04;07;Lauantai;0;0;0;1;0;1
293;07.04.2018;2018;04;08;Lauantai;2;1;3;3;1;4
293;07.04.2018;2018;04;09;Lauantai;0;4;4;5;2;7
293;07.04.2018;2018;04;10;Lauantai;1;0;1;8;4;12
293;07.04.2018;2018;04;11;Lauantai;2;3;5;11;6;17
293;07.04.2018;2018;04;12;Lauantai;6;3;9;8;6;14
293;07.04.2018;2018;04;13;Lauantai;3;2;5;4;2;6
293;07.04.2018;2018;04;14;Lauantai;6;8;14;3;4;7
293;07.04.2018;2018;04;15;Lauantai;6;2;8;8;6;14
293;07.04.2018;2018;04;16;Lauantai;4;4;8;7;10;17
293;07.04.2018;2018;04;17;Lauantai;2;2;4;10;9;19
293;07.04.2018;2018;04;18;Lauantai;6;3;9;2;4;6
293;07.04.2018;2018;04;19;Lauantai;4;5;9;6;7;13
293;07.04.2018;2018;04;20;Lauantai;6;4;10;3;6;9
293;07.04.2018;2018;04;21;Lauantai;1;4;5;1;4;5
293;07.04.2018;2018;04;22;Lauantai;1;3;4;0;2;2
293;07.04.2018;2018;04;23;Lauantai;2;1;3;0;0;0
293;08.04.2018;2018;04;00;Sunnuntai;0;1;1;0;1;1
293;08.04.2018;2018;04;01;Sunnuntai;1;0;1;0;0;0
293;08.04.2018;2018;04;02;Sunnuntai;0;0;0;0;0;0
293;08.04.2018;2018;04;03;Sunnuntai;0;0;0;0;1;1
293;08.04.2018;2018;04;04;Sunnuntai;0;1;1;0;0;0
293;08.04.2018;2018;04;05;Sunnuntai;0;0;0;0;0;0
293;08.04.2018;2018;04;06;Sunnuntai;2;0;2;0;0;0
293;08.04.2018;2018;04;07;Sunnuntai;0;0;0;0;0;0
293;08.04.2018;2018;04;08;Sunnuntai;0;0;0;0;0;0
293;08.04.2018;2018;04;09;Sunnuntai;9;1;10;8;1;9
293;08.04.2018;2018;04;10;Sunnuntai;1;2;3;7;4;11
293;08.04.2018;2018;04;11;Sunnuntai;4;9;13;6;12;18
293;08.04.2018;2018;04;12;Sunnuntai;2;3;5;17;12;29
293;08.04.2018;2018;04;13;Sunnuntai;3;2;5;10;22;32
293;08.04.2018;2018;04;14;Sunnuntai;5;6;11;4;2;6
293;08.04.2018;2018;04;15;Sunnuntai;5;7;12;3;9;12
293;08.04.2018;2018;04;16;Sunnuntai;5;4;9;5;10;15
293;08.04.2018;2018;04;17;Sunnuntai;3;4;7;1;6;7
293;08.04.2018;2018;04;18;Sunnuntai;5;4;9;6;6;12
293;08.04.2018;2018;04;19;Sunnuntai;2;2;4;5;2;7
293;08.04.2018;2018;04;20;Sunnuntai;4;4;8;2;3;5
293;08.04.2018;2018;04;21;Sunnuntai;1;2;3;2;1;3
293;08.04.2018;2018;04;22;Sunnuntai;0;0;0;0;0;0
293;08.04.2018;2018;04;23;Sunnuntai;0;1;1;0;1;1
293;09.04.2018;2018;04;00;Maanantai;0;0;0;0;0;0
293;09.04.2018;2018;04;01;Maanantai;0;0;0;0;0;0
293;09.04.2018;2018;04;02;Maanantai;0;0;0;0;0;0
293;09.04.2018;2018;04;03;Maanantai;0;0;0;0;0;0
293;09.04.2018;2018;04;04;Maanantai;0;0;0;0;0;0
293;09.04.2018;2018;04;05;Maanantai;0;0;0;1;1;2
293;09.04.2018;2018;04;06;Maanantai;5;2;7;3;2;5
293;09.04.2018;2018;04;07;Maanantai;31;1;32;10;1;11
293;09.04.2018;2018;04;08;Maanantai;81;2;83;12;4;16
293;09.04.2018;2018;04;09;Maanantai;14;3;17;5;4;9
293;09.04.2018;2018;04;10;Maanantai;9;2;11;4;2;6
293;09.04.2018;2018;04;11;Maanantai;1;4;5;0;1;1
293;09.04.2018;2018;04;12;Maanantai;3;7;10;9;2;11
293;09.04.2018;2018;04;13;Maanantai;1;14;15;5;4;9
293;09.04.2018;2018;04;14;Maanantai;4;30;34;6;7;13
293;09.04.2018;2018;04;15;Maanantai;8;70;78;3;12;15
293;09.04.2018;2018;04;16;Maanantai;4;10;14;7;10;17
293;09.04.2018;2018;04;17;Maanantai;2;8;10;11;7;18
293;09.04.2018;2018;04;18;Maanantai;4;9;13;10;11;21
293;09.04.2018;2018;04;19;Maanantai;8;1;9;3;8;11
293;09.04.2018;2018;04;20;Maanantai;1;5;6;2;5;7
293;09.04.2018;2018;04;21;Maanantai;2;7;9;1;3;4
293;09.04.2018;2018;04;22;Maanantai;0;0;0;0;1;1
293;09.04.2018;2018;04;23;Maanantai;0;0;0;0;0;0
293;10.04.2018;2018;04;00;Tiistai;0;0;0;0;0;0
293;10.04.2018;2018;04;01;Tiistai;0;0;0;0;0;0
293;10.04.2018;2018;04;02;Tiistai;0;0;0;0;0;0
293;10.04.2018;2018;04;03;Tiistai;1;0;1;0;0;0
293;10.04.2018;2018;04;04;Tiistai;0;0;0;1;0;1
293;10.04.2018;2018;04;05;Tiistai;0;0;0;1;0;1
293;10.04.2018;2018;04;06;Tiistai;3;1;4;1;0;1
293;10.04.2018;2018;04;07;Tiistai;52;2;54;10;1;11
293;10.04.2018;2018;04;08;Tiistai;64;4;68;9;3;12
293;10.04.2018;2018;04;09;Tiistai;20;5;25;5;4;9
293;10.04.2018;2018;04;10;Tiistai;8;2;10;8;3;11
293;10.04.2018;2018;04;11;Tiistai;3;2;5;7;4;11
293;10.04.2018;2018;04;12;Tiistai;5;5;10;8;6;14
293;10.04.2018;2018;04;13;Tiistai;4;27;31;5;16;21
293;10.04.2018;2018;04;14;Tiistai;7;42;49;1;12;13
293;10.04.2018;2018;04;15;Tiistai;6;61;67;1;16;17
293;10.04.2018;2018;04;16;Tiistai;16;15;31;1;9;10
293;10.04.2018;2018;04;17;Tiistai;8;14;22;15;3;18
293;10.04.2018;2018;04;18;Tiistai;5;6;11;8;8;16
293;10.04.2018;2018;04;19;Tiistai;4;9;13;9;16;25
293;10.04.2018;2018;04;20;Tiistai;1;4;5;6;3;9
293;10.04.2018;2018;04;21;Tiistai;0;3;3;0;0;0
293;10.04.2018;2018;04;22;Tiistai;0;0;0;0;0;0
293;10.04.2018;2018;04;23;Tiistai;0;0;0;0;1;1
293;11.04.2018;2018;04;00;Keskiviikko;0;0;0;1;0;1
293;11.04.2018;2018;04;01;Keskiviikko;0;0;0;0;0;0
293;11.04.2018;2018;04;02;Keskiviikko;0;0;0;0;0;0
293;11.04.2018;2018;04;03;Keskiviikko;1;0;1;0;0;0
293;11.04.2018;2018;04;04;Keskiviikko;0;0;0;0;0;0
293;11.04.2018;2018;04;05;Keskiviikko;0;0;0;0;0;0
293;11.04.2018;2018;04;06;Keskiviikko;1;1;2;2;1;3
293;11.04.2018;2018;04;07;Keskiviikko;68;2;70;11;1;12
293;11.04.2018;2018;04;08;Keskiviikko;63;1;64;20;9;29
293;11.04.2018;2018;04;09;Keskiviikko;11;3;14;5;4;9
293;11.04.2018;2018;04;10;Keskiviikko;7;8;15;2;2;4
293;11.04.2018;2018;04;11;Keskiviikko;5;3;8;4;6;10
293;11.04.2018;2018;04;12;Keskiviikko;4;8;12;10;3;13
293;11.04.2018;2018;04;13;Keskiviikko;4;36;40;6;18;24
293;11.04.2018;2018;04;14;Keskiviikko;7;86;93;10;30;40
293;11.04.2018;2018;04;15;Keskiviikko;3;12;15;2;9;11
293;11.04.2018;2018;04;16;Keskiviikko;8;4;12;10;11;21
293;11.04.2018;2018;04;17;Keskiviikko;5;12;17;6;4;10
293;11.04.2018;2018;04;18;Keskiviikko;3;7;10;7;2;9
293;11.04.2018;2018;04;19;Keskiviikko;6;10;16;12;12;24
293;11.04.2018;2018;04;20;Keskiviikko;1;14;15;1;3;4
293;11.04.2018;2018;04;21;Keskiviikko;1;4;5;1;2;3
293;11.04.2018;2018;04;22;Keskiviikko;0;1;1;0;1;1
293;11.04.2018;2018;04;23;Keskiviikko;0;0;0;1;0;1
293;12.04.2018;2018;04;00;Torstai;0;0;0;0;0;0
293;12.04.2018;2018;04;01;Torstai;0;0;0;0;0;0
293;12.04.2018;2018;04;02;Torstai;0;0;0;0;0;0
293;12.04.2018;2018;04;03;Torstai;1;0;1;1;0;1
293;12.04.2018;2018;04;04;Torstai;0;0;0;0;0;0
293;12.04.2018;2018;04;05;Torstai;0;0;0;0;0;0
293;12.04.2018;2018;04;06;Torstai;2;2;4;2;0;2
293;12.04.2018;2018;04;07;Torstai;53;8;61;19;1;20
293;12.04.2018;2018;04;08;Torstai;75;1;76;9;2;11
293;12.04.2018;2018;04;09;Torstai;16;9;25;14;6;20
293;12.04.2018;2018;04;10;Torstai;9;6;15;6;1;7
293;12.04.2018;2018;04;11;Torstai;2;8;10;7;4;11
293;12.04.2018;2018;04;12;Torstai;4;2;6;13;8;21
293;12.04.2018;2018;04;13;Torstai;10;24;34;9;16;25
293;12.04.2018;2018;04;14;Torstai;3;60;63;8;19;27
293;12.04.2018;2018;04;15;Torstai;2;54;56;5;28;33
293;12.04.2018;2018;04;16;Torstai;5;8;13;3;4;7
293;12.04.2018;2018;04;17;Torstai;5;8;13;10;17;27
293;12.04.2018;2018;04;18;Torstai;5;4;9;10;6;16
293;12.04.2018;2018;04;19;Torstai;3;7;10;3;7;10
293;12.04.2018;2018;04;20;Torstai;4;3;7;2;7;9
293;12.04.2018;2018;04;21;Torstai;0;3;3;0;0;0
293;12.04.2018;2018;04;22;Torstai;0;0;0;0;0;0
293;12.04.2018;2018;04;23;Torstai;0;1;1;0;0;0
293;13.04.2018;2018;04;00;Perjantai;0;0;0;0;0;0
293;13.04.2018;2018;04;01;Perjantai;0;0;0;0;0;0
293;13.04.2018;2018;04;02;Perjantai;0;0;0;0;0;0
293;13.04.2018;2018;04;03;Perjantai;1;0;1;0;0;0
293;13.04.2018;2018;04;04;Perjantai;0;0;0;0;0;0
293;13.04.2018;2018;04;05;Perjantai;0;0;0;0;0;0
293;13.04.2018;2018;04;06;Perjantai;5;1;6;1;4;5
293;13.04.2018;2018;04;07;Perjantai;57;1;58;20;3;23
293;13.04.2018;2018;04;08;Perjantai;39;2;41;25;3;28
293;13.04.2018;2018;04;09;Perjantai;22;6;28;16;9;25
293;13.04.2018;2018;04;10;Perjantai;10;2;12;10;6;16
293;13.04.2018;2018;04;11;Perjantai;8;1;9;9;3;12
293;13.04.2018;2018;04;12;Perjantai;8;15;23;4;18;22
293;13.04.2018;2018;04;13;Perjantai;3;36;39;2;16;18
293;13.04.2018;2018;04;14;Perjantai;5;64;69;14;27;41
293;13.04.2018;2018;04;15;Perjantai;7;28;35;7;19;26
293;13.04.2018;2018;04;16;Perjantai;10;11;21;8;9;17
293;13.04.2018;2018;04;17;Perjantai;10;6;16;5;15;20
293;13.04.2018;2018;04;18;Perjantai;11;12;23;11;9;20
293;13.04.2018;2018;04;19;Perjantai;7;6;13;9;1;10
293;13.04.2018;2018;04;20;Perjantai;2;4;6;4;4;8
293;13.04.2018;2018;04;21;Perjantai;3;9;12;3;2;5
293;13.04.2018;2018;04;22;Perjantai;1;2;3;0;3;3
293;13.04.2018;2018;04;23;Perjantai;0;0;0;0;0;0
293;14.04.2018;2018;04;00;Lauantai;0;0;0;0;1;1
293;14.04.2018;2018;04;01;Lauantai;0;0;0;0;0;0
293;14.04.2018;2018;04;02;Lauantai;0;0;0;0;1;1
293;14.04.2018;2018;04;03;Lauantai;0;0;0;0;0;0
293;14.04.2018;2018;04;04;Lauantai;0;0;0;0;0;0
293;14.04.2018;2018;04;05;Lauantai;0;0;0;0;0;0
293;14.04.2018;2018;04;06;Lauantai;2;0;2;0;0;0
293;14.04.2018;2018;04;07;Lauantai;1;0;1;2;0;2
293;14.04.2018;2018;04;08;Lauantai;0;1;1;6;2;8
293;14.04.2018;2018;04;09;Lauantai;2;2;4;5;6;11
293;14.04.2018;2018;04;10;Lauantai;6;2;8;13;4;17
293;14.04.2018;2018;04;11;Lauantai;3;10;13;7;5;12
293;14.04.2018;2018;04;12;Lauantai;9;3;12;13;7;20
293;14.04.2018;2018;04;13;Lauantai;7;8;15;9;14;23
293;14.04.2018;2018;04;14;Lauantai;6;13;19;12;15;27
293;14.04.2018;2018;04;15;Lauantai;9;4;13;8;6;14
293;14.04.2018;2018;04;16;Lauantai;7;15;22;13;10;23
293;14.04.2018;2018;04;17;Lauantai;13;4;17;8;7;15
293;14.04.2018;2018;04;18;Lauantai;12;11;23;8;12;20
293;14.04.2018;2018;04;19;Lauantai;3;8;11;11;7;18
293;14.04.2018;2018;04;20;Lauantai;3;1;4;4;2;6
293;14.04.2018;2018;04;21;Lauantai;3;4;7;2;2;4
293;14.04.2018;2018;04;22;Lauantai;0;2;2;1;0;1
293;14.04.2018;2018;04;23;Lauantai;0;0;0;0;1;1
293;15.04.2018;2018;04;00;Sunnuntai;0;0;0;1;0;1
293;15.04.2018;2018;04;01;Sunnuntai;0;0;0;0;0;0
293;15.04.2018;2018;04;02;Sunnuntai;0;0;0;0;3;3
293;15.04.2018;2018;04;03;Sunnuntai;1;0;1;0;1;1
293;15.04.2018;2018;04;04;Sunnuntai;0;0;0;0;1;1
293;15.04.2018;2018;04;05;Sunnuntai;0;0;0;1;0;1
293;15.04.2018;2018;04;06;Sunnuntai;0;0;0;0;0;0
293;15.04.2018;2018;04;07;Sunnuntai;0;0;0;0;1;1
293;15.04.2018;2018;04;08;Sunnuntai;1;0;1;3;2;5
293;15.04.2018;2018;04;09;Sunnuntai;11;0;11;12;7;19
293;15.04.2018;2018;04;10;Sunnuntai;3;4;7;10;14;24
293;15.04.2018;2018;04;11;Sunnuntai;9;9;18;22;19;41
293;15.04.2018;2018;04;12;Sunnuntai;11;10;21;14;20;34
293;15.04.2018;2018;04;13;Sunnuntai;15;14;29;26;32;58
293;15.04.2018;2018;04;14;Sunnuntai;20;14;34;17;13;30
293;15.04.2018;2018;04;15;Sunnuntai;17;13;30;10;10;20
293;15.04.2018;2018;04;16;Sunnuntai;11;14;25;9;22;31
293;15.04.2018;2018;04;17;Sunnuntai;7;18;25;16;11;27
293;15.04.2018;2018;04;18;Sunnuntai;9;3;12;15;11;26
293;15.04.2018;2018;04;19;Sunnuntai;9;10;19;10;10;20
293;15.04.2018;2018;04;20;Sunnuntai;0;3;3;5;3;8
293;15.04.2018;2018;04;21;Sunnuntai;1;0;1;0;1;1
293;15.04.2018;2018;04;22;Sunnuntai;1;0;1;1;0;1
293;15.04.2018;2018;04;23;Sunnuntai;0;0;0;0;0;0
293;16.04.2018;2018;04;00;Maanantai;0;1;1;0;1;1
293;16.04.2018;2018;04;01;Maanantai;0;0;0;0;0;0
293;16.04.2018;2018;04;02;Maanantai;0;0;0;0;0;0
293;16.04.2018;2018;04;03;Maanantai;0;0;0;0;0;0
293;16.04.2018;2018;04;04;Maanantai;0;0;0;0;0;0
293;16.04.2018;2018;04;05;Maanantai;0;0;0;0;0;0
293;16.04.2018;2018;04;06;Maanantai;6;0;6;3;2;5
293;16.04.2018;2018;04;07;Maanantai;39;5;44;24;4;28
293;16.04.2018;2018;04;08;Maanantai;56;5;61;38;6;44
293;16.04.2018;2018;04;09;Maanantai;15;5;20;17;11;28
293;16.04.2018;2018;04;10;Maanantai;11;2;13;24;5;29
293;16.04.2018;2018;04;11;Maanantai;3;5;8;7;18;25
293;16.04.2018;2018;04;12;Maanantai;6;5;11;14;10;24
293;16.04.2018;2018;04;13;Maanantai;6;23;29;15;28;43
293;16.04.2018;2018;04;14;Maanantai;7;47;54;7;32;39
293;16.04.2018;2018;04;15;Maanantai;11;62;73;3;34;37
293;16.04.2018;2018;04;16;Maanantai;27;24;51;11;10;21
293;16.04.2018;2018;04;17;Maanantai;16;19;35;9;8;17
293;16.04.2018;2018;04;18;Maanantai;21;26;47;10;16;26
293;16.04.2018;2018;04;19;Maanantai;11;11;22;4;2;6
293;16.04.2018;2018;04;20;Maanantai;3;12;15;1;8;9
293;16.04.2018;2018;04;21;Maanantai;3;7;10;0;1;1
293;16.04.2018;2018;04;22;Maanantai;1;2;3;0;0;0
293;16.04.2018;2018;04;23;Maanantai;0;0;0;0;0;0
293;17.04.2018;2018;04;00;Tiistai;0;0;0;0;0;0
293;17.04.2018;2018;04;01;Tiistai;0;0;0;0;0;0
293;17.04.2018;2018;04;02;Tiistai;0;0;0;0;0;0
293;17.04.2018;2018;04;03;Tiistai;1;0;1;0;1;1
293;17.04.2018;2018;04;04;Tiistai;0;0;0;0;0;0
293;17.04.2018;2018;04;05;Tiistai;1;0;1;0;0;0
293;17.04.2018;2018;04;06;Tiistai;8;2;10;4;0;4
293;17.04.2018;2018;04;07;Tiistai;56;3;59;6;1;7
293;17.04.2018;2018;04;08;Tiistai;62;8;70;4;2;6
293;17.04.2018;2018;04;09;Tiistai;35;4;39;3;10;13
293;17.04.2018;2018;04;10;Tiistai;15;2;17;12;4;16
293;17.04.2018;2018;04;11;Tiistai;10;8;18;1;4;5
293;17.04.2018;2018;04;12;Tiistai;11;15;26;10;6;16
293;17.04.2018;2018;04;13;Tiistai;6;20;26;10;12;22
293;17.04.2018;2018;04;14;Tiistai;14;70;84;6;11;17
293;17.04.2018;2018;04;15;Tiistai;7;72;79;2;20;22
293;17.04.2018;2018;04;16;Tiistai;17;15;32;7;9;16
293;17.04.2018;2018;04;17;Tiistai;21;24;45;10;9;19
293;17.04.2018;2018;04;18;Tiistai;21;14;35;16;17;33
293;17.04.2018;2018;04;19;Tiistai;21;20;41;7;16;23
293;17.04.2018;2018;04;20;Tiistai;7;17;24;2;3;5
293;17.04.2018;2018;04;21;Tiistai;3;5;8;0;0;0
293;17.04.2018;2018;04;22;Tiistai;0;2;2;1;0;1
293;17.04.2018;2018;04;23;Tiistai;1;1;2;0;0;0
293;18.04.2018;2018;04;00;Keskiviikko;0;0;0;0;0;0
293;18.04.2018;2018;04;01;Keskiviikko;0;0;0;0;0;0
293;18.04.2018;2018;04;02;Keskiviikko;0;0;0;0;0;0
293;18.04.2018;2018;04;03;Keskiviikko;0;0;0;0;0;0
293;18.04.2018;2018;04;04;Keskiviikko;0;0;0;0;0;0
293;18.04.2018;2018;04;05;Keskiviikko;1;0;1;0;0;0
293;18.04.2018;2018;04;06;Keskiviikko;11;1;12;3;0;3
293;18.04.2018;2018;04;07;Keskiviikko;86;1;87;6;1;7
293;18.04.2018;2018;04;08;Keskiviikko;69;10;79;9;3;12
293;18.04.2018;2018;04;09;Keskiviikko;19;6;25;7;4;11
293;18.04.2018;2018;04;10;Keskiviikko;13;4;17;8;9;17
293;18.04.2018;2018;04;11;Keskiviikko;6;14;20;6;7;13
293;18.04.2018;2018;04;12;Keskiviikko;8;11;19;6;3;9
293;18.04.2018;2018;04;13;Keskiviikko;16;37;53;7;8;15
293;18.04.2018;2018;04;14;Keskiviikko;15;97;112;5;9;14
293;18.04.2018;2018;04;15;Keskiviikko;13;39;52;3;9;12
293;18.04.2018;2018;04;16;Keskiviikko;16;14;30;6;10;16
293;18.04.2018;2018;04;17;Keskiviikko;19;18;37;13;9;22
293;18.04.2018;2018;04;18;Keskiviikko;28;34;62;9;18;27
293;18.04.2018;2018;04;19;Keskiviikko;13;15;28;11;11;22
293;18.04.2018;2018;04;20;Keskiviikko;9;19;28;5;7;12
293;18.04.2018;2018;04;21;Keskiviikko;1;4;5;1;3;4
293;18.04.2018;2018;04;22;Keskiviikko;0;3;3;0;0;0
293;18.04.2018;2018;04;23;Keskiviikko;0;0;0;0;0;0
293;19.04.2018;2018;04;00;Torstai;0;0;0;0;0;0
293;19.04.2018;2018;04;01;Torstai;0;0;0;0;0;0
293;19.04.2018;2018;04;02;Torstai;0;0;0;0;0;0
293;19.04.2018;2018;04;03;Torstai;1;0;1;0;0;0
293;19.04.2018;2018;04;04;Torstai;0;0;0;0;0;0
293;19.04.2018;2018;04;05;Torstai;3;0;3;0;0;0
293;19.04.2018;2018;04;06;Torstai;8;1;9;2;0;2
293;19.04.2018;2018;04;07;Torstai;77;5;82;2;1;3
293;19.04.2018;2018;04;08;Torstai;75;10;85;7;3;10
293;19.04.2018;2018;04;09;Torstai;25;8;33;8;4;12
293;19.04.2018;2018;04;10;Torstai;17;6;23;5;3;8
293;19.04.2018;2018;04;11;Torstai;3;12;15;6;4;10
293;19.04.2018;2018;04;12;Torstai;23;20;43;8;7;15
293;19.04.2018;2018;04;13;Torstai;6;40;46;4;11;15
293;19.04.2018;2018;04;14;Torstai;16;56;72;2;8;10
293;19.04.2018;2018;04;15;Torstai;21;65;86;6;14;20
293;19.04.2018;2018;04;16;Torstai;15;31;46;6;5;11
293;19.04.2018;2018;04;17;Torstai;26;18;44;11;11;22
293;19.04.2018;2018;04;18;Torstai;24;20;44;12;11;23
293;19.04.2018;2018;04;19;Torstai;7;22;29;7;17;24
293;19.04.2018;2018;04;20;Torstai;6;17;23;6;6;12
293;19.04.2018;2018;04;21;Torstai;2;6;8;0;4;4
293;19.04.2018;2018;04;22;Torstai;1;0;1;0;0;0
293;19.04.2018;2018;04;23;Torstai;0;0;0;0;0;0
293;20.04.2018;2018;04;00;Perjantai;0;0;0;0;0;0
293;20.04.2018;2018;04;01;Perjantai;0;0;0;0;0;0
293;20.04.2018;2018;04;02;Perjantai;1;0;1;0;0;0
293;20.04.2018;2018;04;03;Perjantai;0;0;0;0;0;0
293;20.04.2018;2018;04;04;Perjantai;0;0;0;0;0;0
293;20.04.2018;2018;04;05;Perjantai;3;0;3;0;0;0
293;20.04.2018;2018;04;06;Perjantai;4;2;6;1;1;2
293;20.04.2018;2018;04;07;Perjantai;69;2;71;7;1;8
293;20.04.2018;2018;04;08;Perjantai;34;2;36;6;0;6
293;20.04.2018;2018;04;09;Perjantai;20;7;27;3;0;3
293;20.04.2018;2018;04;10;Perjantai;16;2;18;1;0;1
293;20.04.2018;2018;04;11;Perjantai;2;2;4;3;0;3
293;20.04.2018;2018;04;12;Perjantai;9;8;17;3;1;4
293;20.04.2018;2018;04;13;Perjantai;7;43;50;1;3;4
293;20.04.2018;2018;04;14;Perjantai;8;36;44;6;10;16
293;20.04.2018;2018;04;15;Perjantai;19;38;57;1;9;10
293;20.04.2018;2018;04;16;Perjantai;6;23;29;1;5;6
293;20.04.2018;2018;04;17;Perjantai;5;16;21;3;6;9
293;20.04.2018;2018;04;18;Perjantai;11;8;19;4;8;12
293;20.04.2018;2018;04;19;Perjantai;14;7;21;6;2;8
293;20.04.2018;2018;04;20;Perjantai;5;9;14;3;4;7
293;20.04.2018;2018;04;21;Perjantai;1;5;6;0;0;0
293;20.04.2018;2018;04;22;Perjantai;3;3;6;0;1;1
293;20.04.2018;2018;04;23;Perjantai;5;8;13;1;1;2
293;21.04.2018;2018;04;00;Lauantai;0;0;0;0;1;1
293;21.04.2018;2018;04;01;Lauantai;0;0;0;0;0;0
293;21.04.2018;2018;04;02;Lauantai;0;0;0;0;0;0
293;21.04.2018;2018;04;03;Lauantai;0;0;0;0;0;0
293;21.04.2018;2018;04;04;Lauantai;0;0;0;0;1;1
293;21.04.2018;2018;04;05;Lauantai;0;0;0;0;1;1
293;21.04.2018;2018;04;06;Lauantai;1;0;1;0;0;0
293;21.04.2018;2018;04;07;Lauantai;0;0;0;0;0;0
293;21.04.2018;2018;04;08;Lauantai;5;3;8;2;0;2
293;21.04.2018;2018;04;09;Lauantai;9;5;14;8;3;11
293;21.04.2018;2018;04;10;Lauantai;7;4;11;8;7;15
293;21.04.2018;2018;04;11;Lauantai;15;13;28;8;34;42
293;21.04.2018;2018;04;12;Lauantai;16;10;26;7;6;13
293;21.04.2018;2018;04;13;Lauantai;15;21;36;4;6;10
293;21.04.2018;2018;04;14;Lauantai;30;16;46;6;2;8
293;21.04.2018;2018;04;15;Lauantai;16;18;34;7;4;11
293;21.04.2018;2018;04;16;Lauantai;18;21;39;8;12;20
293;21.04.2018;2018;04;17;Lauantai;27;6;33;5;2;7
293;21.04.2018;2018;04;18;Lauantai;12;30;42;2;3;5
293;21.04.2018;2018;04;19;Lauantai;13;12;25;0;6;6
293;21.04.2018;2018;04;20;Lauantai;9;16;25;8;7;15
293;21.04.2018;2018;04;21;Lauantai;4;4;8;3;0;3
293;21.04.2018;2018;04;22;Lauantai;1;4;5;3;2;5
293;21.04.2018;2018;04;23;Lauantai;3;1;4;0;0;0
293;22.04.2018;2018;04;00;Sunnuntai;2;4;6;1;0;1
293;22.04.2018;2018;04;01;Sunnuntai;1;0;1;2;2;4
293;22.04.2018;2018;04;02;Sunnuntai;0;1;1;0;0;0
293;22.04.2018;2018;04;03;Sunnuntai;0;0;0;0;0;0
293;22.04.2018;2018;04;04;Sunnuntai;0;0;0;0;2;2
293;22.04.2018;2018;04;05;Sunnuntai;0;0;0;0;0;0
293;22.04.2018;2018;04;06;Sunnuntai;1;0;1;0;0;0
293;22.04.2018;2018;04;07;Sunnuntai;2;2;4;1;0;1
293;22.04.2018;2018;04;08;Sunnuntai;5;1;6;5;1;6
293;22.04.2018;2018;04;09;Sunnuntai;21;5;26;9;5;14
293;22.04.2018;2018;04;10;Sunnuntai;19;15;34;8;12;20
293;22.04.2018;2018;04;11;Sunnuntai;15;18;33;13;13;26
293;22.04.2018;2018;04;12;Sunnuntai;17;28;45;7;7;14
293;22.04.2018;2018;04;13;Sunnuntai;24;19;43;9;7;16
293;22.04.2018;2018;04;14;Sunnuntai;38;26;64;12;9;21
293;22.04.2018;2018;04;15;Sunnuntai;21;36;57;4;6;10
293;22.04.2018;2018;04;16;Sunnuntai;28;23;51;9;16;25
293;22.04.2018;2018;04;17;Sunnuntai;29;22;51;6;11;17
293;22.04.2018;2018;04;18;Sunnuntai;9;18;27;10;5;15
293;22.04.2018;2018;04;19;Sunnuntai;12;10;22;5;9;14
293;22.04.2018;2018;04;20;Sunnuntai;3;14;17;2;3;5
293;22.04.2018;2018;04;21;Sunnuntai;8;6;14;1;0;1
293;22.04.2018;2018;04;22;Sunnuntai;3;0;3;0;1;1
293;22.04.2018;2018;04;23;Sunnuntai;0;0;0;0;0;0
293;23.04.2018;2018;04;00;Maanantai;0;0;0;0;0;0
293;23.04.2018;2018;04;01;Maanantai;0;0;0;0;0;0
293;23.04.2018;2018;04;02;Maanantai;0;0;0;0;0;0
293;23.04.2018;2018;04;03;Maanantai;0;0;0;0;0;0
293;23.04.2018;2018;04;04;Maanantai;0;0;0;0;0;0
293;23.04.2018;2018;04;05;Maanantai;3;0;3;0;0;0
293;23.04.2018;2018;04;06;Maanantai;7;1;8;0;0;0
293;23.04.2018;2018;04;07;Maanantai;61;6;67;8;2;10
293;23.04.2018;2018;04;08;Maanantai;92;1;93;6;3;9
293;23.04.2018;2018;04;09;Maanantai;29;11;40;6;3;9
293;23.04.2018;2018;04;10;Maanantai;24;6;30;4;5;9
293;23.04.2018;2018;04;11;Maanantai;13;12;25;6;3;9
293;23.04.2018;2018;04;12;Maanantai;12;14;26;1;3;4
293;23.04.2018;2018;04;13;Maanantai;17;29;46;7;2;9
293;23.04.2018;2018;04;14;Maanantai;10;53;63;4;9;13
293;23.04.2018;2018;04;15;Maanantai;27;111;138;9;11;20
293;23.04.2018;2018;04;16;Maanantai;28;35;63;8;11;19
293;23.04.2018;2018;04;17;Maanantai;42;29;71;12;8;20
293;23.04.2018;2018;04;18;Maanantai;32;40;72;9;11;20
293;23.04.2018;2018;04;19;Maanantai;21;27;48;7;14;21
293;23.04.2018;2018;04;20;Maanantai;12;22;34;0;7;7
293;23.04.2018;2018;04;21;Maanantai;4;6;10;0;4;4
293;23.04.2018;2018;04;22;Maanantai;0;2;2;0;0;0
293;23.04.2018;2018;04;23;Maanantai;0;0;0;0;0;0
293;24.04.2018;2018;04;00;Tiistai;0;0;0;0;0;0
293;24.04.2018;2018;04;01;Tiistai;0;0;0;0;0;0
293;24.04.2018;2018;04;02;Tiistai;0;0;0;0;0;0
293;24.04.2018;2018;04;03;Tiistai;1;0;1;0;0;0
293;24.04.2018;2018;04;04;Tiistai;0;0;0;0;0;0
293;24.04.2018;2018;04;05;Tiistai;2;0;2;0;0;0
293;24.04.2018;2018;04;06;Tiistai;7;1;8;1;0;1
293;24.04.2018;2018;04;07;Tiistai;73;6;79;6;1;7
293;24.04.2018;2018;04;08;Tiistai;73;7;80;3;0;3
293;24.04.2018;2018;04;09;Tiistai;34;6;40;8;5;13
293;24.04.2018;2018;04;10;Tiistai;17;6;23;3;6;9
293;24.04.2018;2018;04;11;Tiistai;9;8;17;3;0;3
293;24.04.2018;2018;04;12;Tiistai;9;7;16;4;2;6
293;24.04.2018;2018;04;13;Tiistai;7;30;37;2;6;8
293;24.04.2018;2018;04;14;Tiistai;9;61;70;3;3;6
293;24.04.2018;2018;04;15;Tiistai;16;73;89;2;11;13
293;24.04.2018;2018;04;16;Tiistai;11;32;43;2;8;10
293;24.04.2018;2018;04;17;Tiistai;12;14;26;5;5;10
293;24.04.2018;2018;04;18;Tiistai;7;10;17;1;0;1
293;24.04.2018;2018;04;19;Tiistai;5;12;17;3;6;9
293;24.04.2018;2018;04;20;Tiistai;3;5;8;0;1;1
293;24.04.2018;2018;04;21;Tiistai;1;6;7;0;1;1
293;24.04.2018;2018;04;22;Tiistai;0;1;1;0;0;0
293;24.04.2018;2018;04;23;Tiistai;0;0;0;0;0;0
293;25.04.2018;2018;04;00;Keskiviikko;0;0;0;0;0;0
293;25.04.2018;2018;04;01;Keskiviikko;0;0;0;0;0;0
293;25.04.2018;2018;04;02;Keskiviikko;0;0;0;0;0;0
293;25.04.2018;2018;04;03;Keskiviikko;1;0;1;0;0;0
293;25.04.2018;2018;04;04;Keskiviikko;0;0;0;0;0;0
293;25.04.2018;2018;04;05;Keskiviikko;3;0;3;0;0;0
293;25.04.2018;2018;04;06;Keskiviikko;13;3;16;3;0;3
293;25.04.2018;2018;04;07;Keskiviikko;95;5;100;7;1;8
293;25.04.2018;2018;04;08;Keskiviikko;67;7;74;9;0;9
293;25.04.2018;2018;04;09;Keskiviikko;27;5;32;3;6;9
293;25.04.2018;2018;04;10;Keskiviikko;16;13;29;7;8;15
293;25.04.2018;2018;04;11;Keskiviikko;12;11;23;2;2;4
293;25.04.2018;2018;04;12;Keskiviikko;12;24;36;6;8;14
293;25.04.2018;2018;04;13;Keskiviikko;10;34;44;1;8;9
293;25.04.2018;2018;04;14;Keskiviikko;12;127;139;4;3;7
293;25.04.2018;2018;04;15;Keskiviikko;14;33;47;10;9;19
293;25.04.2018;2018;04;16;Keskiviikko;34;37;71;5;6;11
293;25.04.2018;2018;04;17;Keskiviikko;31;19;50;12;14;26
293;25.04.2018;2018;04;18;Keskiviikko;17;41;58;5;10;15
293;25.04.2018;2018;04;19;Keskiviikko;24;26;50;3;5;8
293;25.04.2018;2018;04;20;Keskiviikko;8;15;23;2;5;7
293;25.04.2018;2018;04;21;Keskiviikko;4;11;15;0;1;1
293;25.04.2018;2018;04;22;Keskiviikko;2;0;2;0;0;0
293;25.04.2018;2018;04;23;Keskiviikko;0;0;0;0;0;0
293;26.04.2018;2018;04;00;Torstai;0;0;0;0;0;0
293;26.04.2018;2018;04;01;Torstai;0;1;1;0;0;0
293;26.04.2018;2018;04;02;Torstai;0;0;0;0;0;0
293;26.04.2018;2018;04;03;Torstai;0;0;0;1;0;1
293;26.04.2018;2018;04;04;Torstai;0;0;0;0;0;0
293;26.04.2018;2018;04;05;Torstai;2;0;2;0;0;0
293;26.04.2018;2018;04;06;Torstai;12;1;13;1;0;1
293;26.04.2018;2018;04;07;Torstai;86;9;95;5;1;6
293;26.04.2018;2018;04;08;Torstai;70;9;79;6;0;6
293;26.04.2018;2018;04;09;Torstai;34;7;41;6;2;8
293;26.04.2018;2018;04;10;Torstai;14;18;32;7;6;13
293;26.04.2018;2018;04;11;Torstai;5;18;23;7;1;8
293;26.04.2018;2018;04;12;Torstai;14;8;22;4;6;10
293;26.04.2018;2018;04;13;Torstai;13;30;43;1;5;6
293;26.04.2018;2018;04;14;Torstai;14;81;95;2;5;7
293;26.04.2018;2018;04;15;Torstai;16;78;94;5;6;11
293;26.04.2018;2018;04;16;Torstai;21;33;54;3;4;7
293;26.04.2018;2018;04;17;Torstai;30;30;60;3;6;9
293;26.04.2018;2018;04;18;Torstai;31;30;61;30;22;52
293;26.04.2018;2018;04;19;Torstai;10;27;37;11;8;19
293;26.04.2018;2018;04;20;Torstai;6;11;17;3;1;4
293;26.04.2018;2018;04;21;Torstai;4;7;11;1;2;3
293;26.04.2018;2018;04;22;Torstai;2;4;6;1;2;3
293;26.04.2018;2018;04;23;Torstai;0;0;0;0;0;0
293;27.04.2018;2018;04;00;Perjantai;1;0;1;0;0;0
293;27.04.2018;2018;04;01;Perjantai;0;1;1;0;0;0
293;27.04.2018;2018;04;02;Perjantai;0;0;0;0;0;0
293;27.04.2018;2018;04;03;Perjantai;1;0;1;0;1;1
293;27.04.2018;2018;04;04;Perjantai;0;0;0;0;0;0
293;27.04.2018;2018;04;05;Perjantai;3;0;3;0;0;0
293;27.04.2018;2018;04;06;Perjantai;6;3;9;3;0;3
293;27.04.2018;2018;04;07;Perjantai;85;4;89;6;0;6
293;27.04.2018;2018;04;08;Perjantai;57;7;64;1;4;5
293;27.04.2018;2018;04;09;Perjantai;36;7;43;9;2;11
293;27.04.2018;2018;04;10;Perjantai;25;10;35;18;7;25
293;27.04.2018;2018;04;11;Perjantai;13;15;28;11;13;24
293;27.04.2018;2018;04;12;Perjantai;17;27;44;6;8;14
293;27.04.2018;2018;04;13;Perjantai;24;55;79;4;6;10
293;27.04.2018;2018;04;14;Perjantai;25;86;111;6;10;16
293;27.04.2018;2018;04;15;Perjantai;16;59;75;7;19;26
293;27.04.2018;2018;04;16;Perjantai;25;29;54;10;6;16
293;27.04.2018;2018;04;17;Perjantai;51;39;90;11;13;24
293;27.04.2018;2018;04;18;Perjantai;28;41;69;7;11;18
293;27.04.2018;2018;04;19;Perjantai;38;33;71;12;7;19
293;27.04.2018;2018;04;20;Perjantai;17;37;54;2;9;11
293;27.04.2018;2018;04;21;Perjantai;6;14;20;3;2;5
293;27.04.2018;2018;04;22;Perjantai;0;5;5;0;0;0
293;27.04.2018;2018;04;23;Perjantai;2;0;2;0;0;0
293;28.04.2018;2018;04;00;Lauantai;3;0;3;0;0;0
293;28.04.2018;2018;04;01;Lauantai;3;0;3;1;0;1
293;28.04.2018;2018;04;02;Lauantai;2;2;4;1;0;1
293;28.04.2018;2018;04;03;Lauantai;0;0;0;0;0;0
293;28.04.2018;2018;04;04;Lauantai;1;0;1;0;3;3
293;28.04.2018;2018;04;05;Lauantai;1;1;2;0;0;0
293;28.04.2018;2018;04;06;Lauantai;3;0;3;0;0;0
293;28.04.2018;2018;04;07;Lauantai;0;1;1;3;3;6
293;28.04.2018;2018;04;08;Lauantai;5;5;10;4;0;4
293;28.04.2018;2018;04;09;Lauantai;17;9;26;4;4;8
293;28.04.2018;2018;04;10;Lauantai;23;19;42;11;9;20
293;28.04.2018;2018;04;11;Lauantai;28;24;52;14;9;23
293;28.04.2018;2018;04;12;Lauantai;28;26;54;8;4;12
293;28.04.2018;2018;04;13;Lauantai;16;26;42;8;8;16
293;28.04.2018;2018;04;14;Lauantai;34;26;60;11;8;19
293;28.04.2018;2018;04;15;Lauantai;31;39;70;9;12;21
293;28.04.2018;2018;04;16;Lauantai;30;23;53;10;8;18
293;28.04.2018;2018;04;17;Lauantai;30;38;68;4;10;14
293;28.04.2018;2018;04;18;Lauantai;46;43;89;9;9;18
293;28.04.2018;2018;04;19;Lauantai;24;30;54;8;6;14
293;28.04.2018;2018;04;20;Lauantai;23;31;54;6;8;14
293;28.04.2018;2018;04;21;Lauantai;2;8;10;2;2;4
293;28.04.2018;2018;04;22;Lauantai;4;5;9;2;4;6
293;28.04.2018;2018;04;23;Lauantai;4;8;12;1;0;1
293;29.04.2018;2018;04;00;Sunnuntai;1;4;5;3;2;5
293;29.04.2018;2018;04;01;Sunnuntai;0;2;2;0;0;0
293;29.04.2018;2018;04;02;Sunnuntai;0;0;0;0;1;1
293;29.04.2018;2018;04;03;Sunnuntai;0;0;0;0;0;0
293;29.04.2018;2018;04;04;Sunnuntai;0;0;0;1;1;2
293;29.04.2018;2018;04;05;Sunnuntai;1;1;2;0;0;0
293;29.04.2018;2018;04;06;Sunnuntai;1;1;2;0;0;0
293;29.04.2018;2018;04;07;Sunnuntai;4;0;4;2;1;3
293;29.04.2018;2018;04;08;Sunnuntai;5;3;8;7;7;14
293;29.04.2018;2018;04;09;Sunnuntai;19;5;24;8;2;10
293;29.04.2018;2018;04;10;Sunnuntai;27;22;49;16;16;32
293;29.04.2018;2018;04;11;Sunnuntai;15;32;47;13;11;24
293;29.04.2018;2018;04;12;Sunnuntai;35;23;58;8;12;20
293;29.04.2018;2018;04;13;Sunnuntai;35;35;70;18;7;25
293;29.04.2018;2018;04;14;Sunnuntai;38;29;67;5;13;18
293;29.04.2018;2018;04;15;Sunnuntai;25;30;55;7;7;14
293;29.04.2018;2018;04;16;Sunnuntai;26;26;52;7;10;17
293;29.04.2018;2018;04;17;Sunnuntai;24;29;53;10;4;14
293;29.04.2018;2018;04;18;Sunnuntai;27;34;61;6;13;19
293;29.04.2018;2018;04;19;Sunnuntai;21;31;52;6;6;12
293;29.04.2018;2018;04;20;Sunnuntai;21;22;43;5;6;11
293;29.04.2018;2018;04;21;Sunnuntai;6;14;20;2;4;6
293;29.04.2018;2018;04;22;Sunnuntai;1;6;7;1;2;3
293;29.04.2018;2018;04;23;Sunnuntai;4;1;5;0;0;0
293;30.04.2018;2018;04;00;Maanantai;2;0;2;1;0;1
293;30.04.2018;2018;04;01;Maanantai;1;0;1;0;0;0
293;30.04.2018;2018;04;02;Maanantai;0;0;0;0;0;0
293;30.04.2018;2018;04;03;Maanantai;0;0;0;0;0;0
293;30.04.2018;2018;04;04;Maanantai;0;0;0;0;0;0
293;30.04.2018;2018;04;05;Maanantai;1;0;1;0;0;0
293;30.04.2018;2018;04;06;Maanantai;15;2;17;1;0;1
293;30.04.2018;2018;04;07;Maanantai;12;6;18;4;3;7
293;30.04.2018;2018;04;08;Maanantai;15;4;19;2;3;5
293;30.04.2018;2018;04;09;Maanantai;16;6;22;3;5;8
293;30.04.2018;2018;04;10;Maanantai;13;17;30;6;5;11
293;30.04.2018;2018;04;11;Maanantai;28;16;44;10;9;19
293;30.04.2018;2018;04;12;Maanantai;26;25;51;6;11;17
293;30.04.2018;2018;04;13;Maanantai;33;35;68;9;1;10
293;30.04.2018;2018;04;14;Maanantai;32;47;79;6;9;15
293;30.04.2018;2018;04;15;Maanantai;40;37;77;3;3;6
293;30.04.2018;2018;04;16;Maanantai;16;34;50;6;8;14
293;30.04.2018;2018;04;17;Maanantai;38;30;68;6;4;10
293;30.04.2018;2018;04;18;Maanantai;17;15;32;4;4;8
293;30.04.2018;2018;04;19;Maanantai;26;27;53;2;5;7
293;30.04.2018;2018;04;20;Maanantai;15;22;37;3;3;6
293;30.04.2018;2018;04;21;Maanantai;5;5;10;0;3;3
293;30.04.2018;2018;04;22;Maanantai;3;8;11;2;1;3
293;30.04.2018;2018;04;23;Maanantai;4;4;8;2;1;3
293;01.05.2018;2018;05;00;Tiistai;1;2;3;2;0;2
293;01.05.2018;2018;05;01;Tiistai;3;7;10;0;2;2
293;01.05.2018;2018;05;02;Tiistai;0;2;2;0;3;3
293;01.05.2018;2018;05;03;Tiistai;0;2;2;0;3;3
293;01.05.2018;2018;05;04;Tiistai;0;0;0;0;0;0
293;01.05.2018;2018;05;05;Tiistai;0;0;0;1;0;1
293;01.05.2018;2018;05;06;Tiistai;2;0;2;0;1;1
293;01.05.2018;2018;05;07;Tiistai;2;1;3;0;0;0
293;01.05.2018;2018;05;08;Tiistai;7;5;12;4;3;7
293;01.05.2018;2018;05;09;Tiistai;7;10;17;5;4;9
293;01.05.2018;2018;05;10;Tiistai;33;9;42;13;6;19
293;01.05.2018;2018;05;11;Tiistai;92;18;110;46;14;60
293;01.05.2018;2018;05;12;Tiistai;52;82;134;29;33;62
293;01.05.2018;2018;05;13;Tiistai;35;51;86;7;25;32
293;01.05.2018;2018;05;14;Tiistai;15;23;38;2;4;6
293;01.05.2018;2018;05;15;Tiistai;40;31;71;6;4;10
293;01.05.2018;2018;05;16;Tiistai;17;42;59;45;34;79
293;01.05.2018;2018;05;17;Tiistai;17;20;37;10;8;18
293;01.05.2018;2018;05;18;Tiistai;20;15;35;3;4;7
293;01.05.2018;2018;05;19;Tiistai;21;14;35;7;4;11
293;01.05.2018;2018;05;20;Tiistai;5;13;18;5;2;7
293;01.05.2018;2018;05;21;Tiistai;4;5;9;1;1;2
293;01.05.2018;2018;05;22;Tiistai;0;2;2;1;1;2
293;01.05.2018;2018;05;23;Tiistai;0;0;0;0;0;0
293;02.05.2018;2018;05;00;Keskiviikko;0;2;2;0;0;0
293;02.05.2018;2018;05;01;Keskiviikko;0;0;0;0;0;0
293;02.05.2018;2018;05;02;Keskiviikko;0;0;0;0;0;0
293;02.05.2018;2018;05;03;Keskiviikko;1;0;1;1;0;1
293;02.05.2018;2018;05;04;Keskiviikko;0;0;0;0;0;0
293;02.05.2018;2018;05;05;Keskiviikko;2;0;2;0;0;0
293;02.05.2018;2018;05;06;Keskiviikko;7;2;9;1;0;1
293;02.05.2018;2018;05;07;Keskiviikko;85;3;88;7;0;7
293;02.05.2018;2018;05;08;Keskiviikko;75;6;81;3;1;4
293;02.05.2018;2018;05;09;Keskiviikko;18;4;22;3;4;7
293;02.05.2018;2018;05;10;Keskiviikko;10;11;21;1;2;3
293;02.05.2018;2018;05;11;Keskiviikko;2;5;7;2;4;6
293;02.05.2018;2018;05;12;Keskiviikko;4;9;13;4;2;6
293;02.05.2018;2018;05;13;Keskiviikko;6;36;42;3;6;9
293;02.05.2018;2018;05;14;Keskiviikko;6;103;109;4;5;9
293;02.05.2018;2018;05;15;Keskiviikko;13;35;48;5;4;9
293;02.05.2018;2018;05;16;Keskiviikko;12;11;23;1;3;4
293;02.05.2018;2018;05;17;Keskiviikko;12;11;23;2;3;5
293;02.05.2018;2018;05;18;Keskiviikko;10;13;23;5;1;6
293;02.05.2018;2018;05;19;Keskiviikko;11;13;24;3;3;6
293;02.05.2018;2018;05;20;Keskiviikko;6;14;20;2;4;6
293;02.05.2018;2018;05;21;Keskiviikko;1;10;11;2;3;5
293;02.05.2018;2018;05;22;Keskiviikko;1;0;1;0;0;0
293;02.05.2018;2018;05;23;Keskiviikko;0;0;0;0;0;0
293;03.05.2018;2018;05;00;Torstai;0;1;1;0;0;0
293;03.05.2018;2018;05;01;Torstai;0;0;0;0;0;0
293;03.05.2018;2018;05;02;Torstai;0;0;0;0;0;0
293;03.05.2018;2018;05;03;Torstai;1;0;1;0;0;0
293;03.05.2018;2018;05;04;Torstai;0;0;0;0;0;0
293;03.05.2018;2018;05;05;Torstai;2;0;2;0;0;0
293;03.05.2018;2018;05;06;Torstai;16;1;17;0;0;0
293;03.05.2018;2018;05;07;Torstai;87;4;91;3;0;3
293;03.05.2018;2018;05;08;Torstai;75;11;86;1;1;2
293;03.05.2018;2018;05;09;Torstai;27;6;33;1;3;4
293;03.05.2018;2018;05;10;Torstai;15;17;32;2;3;5
293;03.05.2018;2018;05;11;Torstai;10;12;22;6;0;6
293;03.05.2018;2018;05;12;Torstai;16;10;26;4;5;9
293;03.05.2018;2018;05;13;Torstai;11;34;45;3;16;19
293;03.05.2018;2018;05;14;Torstai;13;83;96;5;1;6
293;03.05.2018;2018;05;15;Torstai;13;86;99;0;8;8
293;03.05.2018;2018;05;16;Torstai;15;25;40;2;1;3
293;03.05.2018;2018;05;17;Torstai;15;15;30;4;2;6
293;03.05.2018;2018;05;18;Torstai;8;22;30;6;3;9
293;03.05.2018;2018;05;19;Torstai;15;12;27;3;7;10
293;03.05.2018;2018;05;20;Torstai;9;14;23;2;2;4
293;03.05.2018;2018;05;21;Torstai;3;4;7;0;2;2
293;03.05.2018;2018;05;22;Torstai;0;2;2;0;0;0
293;03.05.2018;2018;05;23;Torstai;0;2;2;1;0;1
293;04.05.2018;2018;05;00;Perjantai;0;0;0;0;0;0
293;04.05.2018;2018;05;01;Perjantai;0;0;0;0;0;0
293;04.05.2018;2018;05;02;Perjantai;0;0;0;0;0;0
293;04.05.2018;2018;05;03;Perjantai;1;0;1;0;0;0
293;04.05.2018;2018;05;04;Perjantai;0;0;0;0;0;0
293;04.05.2018;2018;05;05;Perjantai;3;0;3;0;0;0
293;04.05.2018;2018;05;06;Perjantai;6;1;7;0;0;0
293;04.05.2018;2018;05;07;Perjantai;72;3;75;1;0;1
293;04.05.2018;2018;05;08;Perjantai;53;5;58;3;0;3
293;04.05.2018;2018;05;09;Perjantai;20;7;27;6;0;6
293;04.05.2018;2018;05;10;Perjantai;14;1;15;0;0;0
293;04.05.2018;2018;05;11;Perjantai;3;3;6;2;1;3
293;04.05.2018;2018;05;12;Perjantai;2;14;16;3;1;4
293;04.05.2018;2018;05;13;Perjantai;1;27;28;0;3;3
293;04.05.2018;2018;05;14;Perjantai;2;85;87;1;6;7
293;04.05.2018;2018;05;15;Perjantai;2;24;26;0;4;4
293;04.05.2018;2018;05;16;Perjantai;3;12;15;1;2;3
293;04.05.2018;2018;05;17;Perjantai;6;4;10;2;0;2
293;04.05.2018;2018;05;18;Perjantai;12;7;19;2;1;3
293;04.05.2018;2018;05;19;Perjantai;4;8;12;2;2;4
293;04.05.2018;2018;05;20;Perjantai;4;7;11;0;3;3
293;04.05.2018;2018;05;21;Perjantai;6;4;10;3;1;4
293;04.05.2018;2018;05;22;Perjantai;3;0;3;0;1;1
293;04.05.2018;2018;05;23;Perjantai;5;7;12;0;2;2
293;05.05.2018;2018;05;00;Lauantai;2;9;11;0;1;1
293;05.05.2018;2018;05;01;Lauantai;0;0;0;0;0;0
293;05.05.2018;2018;05;02;Lauantai;0;0;0;0;1;1
293;05.05.2018;2018;05;03;Lauantai;0;0;0;0;0;0
293;05.05.2018;2018;05;04;Lauantai;0;0;0;0;2;2
293;05.05.2018;2018;05;05;Lauantai;2;0;2;0;0;0
293;05.05.2018;2018;05;06;Lauantai;1;2;3;0;0;0
293;05.05.2018;2018;05;07;Lauantai;3;1;4;0;0;0
293;05.05.2018;2018;05;08;Lauantai;9;3;12;2;0;2
293;05.05.2018;2018;05;09;Lauantai;5;9;14;3;4;7
293;05.05.2018;2018;05;10;Lauantai;14;7;21;7;5;12
293;05.05.2018;2018;05;11;Lauantai;20;18;38;6;6;12
293;05.05.2018;2018;05;12;Lauantai;24;15;39;5;1;6
293;05.05.2018;2018;05;13;Lauantai;27;24;51;12;2;14
293;05.05.2018;2018;05;14;Lauantai;34;21;55;2;8;10
293;05.05.2018;2018;05;15;Lauantai;21;28;49;4;1;5
293;05.05.2018;2018;05;16;Lauantai;21;22;43;9;3;12
293;05.05.2018;2018;05;17;Lauantai;17;15;32;5;3;8
293;05.05.2018;2018;05;18;Lauantai;30;34;64;3;7;10
293;05.05.2018;2018;05;19;Lauantai;16;17;33;4;5;9
293;05.05.2018;2018;05;20;Lauantai;16;25;41;3;1;4
293;05.05.2018;2018;05;21;Lauantai;13;8;21;0;5;5
293;05.05.2018;2018;05;22;Lauantai;5;12;17;3;1;4
293;05.05.2018;2018;05;23;Lauantai;1;6;7;1;2;3
293;06.05.2018;2018;05;00;Sunnuntai;0;0;0;1;0;1
293;06.05.2018;2018;05;01;Sunnuntai;1;1;2;0;1;1
293;06.05.2018;2018;05;02;Sunnuntai;0;0;0;0;1;1
293;06.05.2018;2018;05;03;Sunnuntai;0;0;0;0;1;1
293;06.05.2018;2018;05;04;Sunnuntai;1;1;2;0;1;1
293;06.05.2018;2018;05;05;Sunnuntai;1;0;1;0;0;0
293;06.05.2018;2018;05;06;Sunnuntai;1;0;1;0;0;0
293;06.05.2018;2018;05;07;Sunnuntai;2;2;4;1;2;3
293;06.05.2018;2018;05;08;Sunnuntai;4;9;13;9;1;10
293;06.05.2018;2018;05;09;Sunnuntai;31;6;37;4;4;8
293;06.05.2018;2018;05;10;Sunnuntai;21;21;42;7;10;17
293;06.05.2018;2018;05;11;Sunnuntai;29;25;54;6;5;11
293;06.05.2018;2018;05;12;Sunnuntai;36;36;72;4;3;7
293;06.05.2018;2018;05;13;Sunnuntai;16;18;34;3;1;4
293;06.05.2018;2018;05;14;Sunnuntai;11;16;27;7;3;10
293;06.05.2018;2018;05;15;Sunnuntai;24;28;52;8;4;12
293;06.05.2018;2018;05;16;Sunnuntai;28;15;43;11;7;18
293;06.05.2018;2018;05;17;Sunnuntai;42;35;77;8;6;14
293;06.05.2018;2018;05;18;Sunnuntai;28;28;56;3;4;7
293;06.05.2018;2018;05;19;Sunnuntai;9;26;35;4;4;8
293;06.05.2018;2018;05;20;Sunnuntai;4;7;11;1;1;2
293;06.05.2018;2018;05;21;Sunnuntai;2;4;6;0;1;1
293;06.05.2018;2018;05;22;Sunnuntai;2;2;4;0;1;1
293;06.05.2018;2018;05;23;Sunnuntai;0;0;0;0;0;0
293;07.05.2018;2018;05;00;Maanantai;0;1;1;0;0;0
293;07.05.2018;2018;05;01;Maanantai;0;0;0;1;1;2
293;07.05.2018;2018;05;02;Maanantai;0;0;0;0;0;0
293;07.05.2018;2018;05;03;Maanantai;0;0;0;0;0;0
293;07.05.2018;2018;05;04;Maanantai;1;0;1;0;0;0
293;07.05.2018;2018;05;05;Maanantai;4;0;4;1;1;2
293;07.05.2018;2018;05;06;Maanantai;19;2;21;1;0;1
293;07.05.2018;2018;05;07;Maanantai;66;7;73;5;0;5
293;07.05.2018;2018;05;08;Maanantai;102;20;122;3;1;4
293;07.05.2018;2018;05;09;Maanantai;32;14;46;6;4;10
293;07.05.2018;2018;05;10;Maanantai;13;12;25;0;1;1
293;07.05.2018;2018;05;11;Maanantai;9;8;17;1;0;1
293;07.05.2018;2018;05;12;Maanantai;14;11;25;2;0;2
293;07.05.2018;2018;05;13;Maanantai;11;30;41;1;17;18
293;07.05.2018;2018;05;14;Maanantai;15;64;79;3;7;10
293;07.05.2018;2018;05;15;Maanantai;9;99;108;1;5;6
293;07.05.2018;2018;05;16;Maanantai;3;15;18;4;4;8
293;07.05.2018;2018;05;17;Maanantai;8;8;16;2;3;5
293;07.05.2018;2018;05;18;Maanantai;9;11;20;8;3;11
293;07.05.2018;2018;05;19;Maanantai;11;14;25;3;8;11
293;07.05.2018;2018;05;20;Maanantai;7;11;18;9;9;18
293;07.05.2018;2018;05;21;Maanantai;3;3;6;1;2;3
293;07.05.2018;2018;05;22;Maanantai;1;2;3;0;0;0
293;07.05.2018;2018;05;23;Maanantai;0;1;1;0;0;0
293;08.05.2018;2018;05;00;Tiistai;0;0;0;0;0;0
293;08.05.2018;2018;05;01;Tiistai;0;0;0;0;0;0
293;08.05.2018;2018;05;02;Tiistai;1;0;1;0;0;0
293;08.05.2018;2018;05;03;Tiistai;0;0;0;0;0;0
293;08.05.2018;2018;05;04;Tiistai;0;0;0;0;0;0
293;08.05.2018;2018;05;05;Tiistai;3;0;3;0;0;0
293;08.05.2018;2018;05;06;Tiistai;20;3;23;0;0;0
293;08.05.2018;2018;05;07;Tiistai;76;8;84;6;1;7
293;08.05.2018;2018;05;08;Tiistai;85;17;102;3;0;3
293;08.05.2018;2018;05;09;Tiistai;38;14;52;3;2;5
293;08.05.2018;2018;05;10;Tiistai;28;19;47;7;2;9
293;08.05.2018;2018;05;11;Tiistai;20;16;36;6;5;11
293;08.05.2018;2018;05;12;Tiistai;25;28;53;6;5;11
293;08.05.2018;2018;05;13;Tiistai;15;42;57;1;5;6
293;08.05.2018;2018;05;14;Tiistai;24;95;119;8;6;14
293;08.05.2018;2018;05;15;Tiistai;32;82;114;4;10;14
293;08.05.2018;2018;05;16;Tiistai;11;32;43;3;6;9
293;08.05.2018;2018;05;17;Tiistai;38;30;68;8;6;14
293;08.05.2018;2018;05;18;Tiistai;28;33;61;1;7;8
293;08.05.2018;2018;05;19;Tiistai;25;39;64;5;10;15
293;08.05.2018;2018;05;20;Tiistai;10;26;36;4;9;13
293;08.05.2018;2018;05;21;Tiistai;1;5;6;0;2;2
293;08.05.2018;2018;05;22;Tiistai;1;2;3;0;1;1
293;08.05.2018;2018;05;23;Tiistai;0;0;0;0;0;0
293;09.05.2018;2018;05;00;Keskiviikko;0;0;0;0;0;0
293;09.05.2018;2018;05;01;Keskiviikko;0;0;0;0;0;0
293;09.05.2018;2018;05;02;Keskiviikko;0;0;0;0;0;0
293;09.05.2018;2018;05;03;Keskiviikko;1;1;2;0;0;0
293;09.05.2018;2018;05;04;Keskiviikko;0;0;0;0;0;0
293;09.05.2018;2018;05;05;Keskiviikko;3;0;3;0;0;0
293;09.05.2018;2018;05;06;Keskiviikko;22;1;23;1;0;1
293;09.05.2018;2018;05;07;Keskiviikko;96;6;102;6;2;8
293;09.05.2018;2018;05;08;Keskiviikko;133;11;144;5;5;10
293;09.05.2018;2018;05;09;Keskiviikko;24;7;31;3;3;6
293;09.05.2018;2018;05;10;Keskiviikko;30;6;36;2;1;3
293;09.05.2018;2018;05;11;Keskiviikko;16;64;80;4;3;7
293;09.05.2018;2018;05;12;Keskiviikko;15;22;37;7;6;13
293;09.05.2018;2018;05;13;Keskiviikko;34;143;177;0;10;10
293;09.05.2018;2018;05;14;Keskiviikko;32;35;67;8;4;12
293;09.05.2018;2018;05;15;Keskiviikko;43;44;87;1;3;4
293;09.05.2018;2018;05;16;Keskiviikko;45;64;109;6;4;10
293;09.05.2018;2018;05;17;Keskiviikko;45;44;89;7;6;13
293;09.05.2018;2018;05;18;Keskiviikko;40;49;89;5;1;6
293;09.05.2018;2018;05;19;Keskiviikko;35;47;82;3;3;6
293;09.05.2018;2018;05;20;Keskiviikko;20;42;62;5;3;8
293;09.05.2018;2018;05;21;Keskiviikko;15;22;37;9;15;24
293;09.05.2018;2018;05;22;Keskiviikko;8;15;23;2;1;3
293;09.05.2018;2018;05;23;Keskiviikko;1;2;3;2;1;3
293;10.05.2018;2018;05;00;Torstai;6;4;10;0;0;0
293;10.05.2018;2018;05;01;Torstai;1;2;3;0;0;0
293;10.05.2018;2018;05;02;Torstai;0;0;0;0;0;0
293;10.05.2018;2018;05;03;Torstai;0;1;1;0;0;0
293;10.05.2018;2018;05;04;Torstai;0;0;0;0;0;0
293;10.05.2018;2018;05;05;Torstai;0;0;0;0;0;0
293;10.05.2018;2018;05;06;Torstai;3;0;3;0;0;0
293;10.05.2018;2018;05;07;Torstai;3;1;4;3;0;3
293;10.05.2018;2018;05;08;Torstai;10;5;15;3;2;5
293;10.05.2018;2018;05;09;Torstai;18;14;32;7;4;11
293;10.05.2018;2018;05;10;Torstai;15;27;42;9;7;16
293;10.05.2018;2018;05;11;Torstai;36;33;69;2;6;8
293;10.05.2018;2018;05;12;Torstai;55;55;110;11;2;13
293;10.05.2018;2018;05;13;Torstai;49;44;93;7;4;11
293;10.05.2018;2018;05;14;Torstai;71;54;125;9;5;14
293;10.05.2018;2018;05;15;Torstai;71;56;127;10;14;24
293;10.05.2018;2018;05;16;Torstai;45;45;90;14;7;21
293;10.05.2018;2018;05;17;Torstai;50;72;122;11;4;15
293;10.05.2018;2018;05;18;Torstai;55;45;100;7;7;14
293;10.05.2018;2018;05;19;Torstai;31;52;83;7;6;13
293;10.05.2018;2018;05;20;Torstai;14;33;47;4;6;10
293;10.05.2018;2018;05;21;Torstai;11;8;19;1;0;1
293;10.05.2018;2018;05;22;Torstai;1;3;4;0;0;0
293;10.05.2018;2018;05;23;Torstai;1;0;1;0;1;1
293;11.05.2018;2018;05;00;Perjantai;0;1;1;1;1;2
293;11.05.2018;2018;05;01;Perjantai;1;1;2;0;0;0
293;11.05.2018;2018;05;02;Perjantai;0;0;0;0;0;0
293;11.05.2018;2018;05;03;Perjantai;0;1;1;0;0;0
293;11.05.2018;2018;05;04;Perjantai;0;0;0;0;0;0
293;11.05.2018;2018;05;05;Perjantai;1;0;1;0;0;0
293;11.05.2018;2018;05;06;Perjantai;12;3;15;1;0;1
293;11.05.2018;2018;05;07;Perjantai;91;3;94;5;1;6
293;11.05.2018;2018;05;08;Perjantai;75;13;88;4;0;4
293;11.05.2018;2018;05;09;Perjantai;47;13;60;7;1;8
293;11.05.2018;2018;05;10;Perjantai;26;17;43;9;5;14
293;11.05.2018;2018;05;11;Perjantai;18;14;32;4;5;9
293;11.05.2018;2018;05;12;Perjantai;41;38;79;3;4;7
293;11.05.2018;2018;05;13;Perjantai;26;84;110;1;7;8
293;11.05.2018;2018;05;14;Perjantai;30;102;132;6;3;9
293;11.05.2018;2018;05;15;Perjantai;36;62;98;3;10;13
293;11.05.2018;2018;05;16;Perjantai;59;58;117;6;9;15
293;11.05.2018;2018;05;17;Perjantai;45;35;80;14;7;21
293;11.05.2018;2018;05;18;Perjantai;39;49;88;6;6;12
293;11.05.2018;2018;05;19;Perjantai;44;76;120;7;6;13
293;11.05.2018;2018;05;20;Perjantai;23;35;58;8;6;14
293;11.05.2018;2018;05;21;Perjantai;15;27;42;8;5;13
293;11.05.2018;2018;05;22;Perjantai;10;13;23;3;0;3
293;11.05.2018;2018;05;23;Perjantai;9;13;22;0;3;3
293;12.05.2018;2018;05;00;Lauantai;7;0;7;5;2;7
293;12.05.2018;2018;05;01;Lauantai;1;1;2;0;5;5
293;12.05.2018;2018;05;02;Lauantai;0;1;1;1;0;1
293;12.05.2018;2018;05;03;Lauantai;0;0;0;0;1;1
293;12.05.2018;2018;05;04;Lauantai;1;0;1;2;0;2
293;12.05.2018;2018;05;05;Lauantai;0;1;1;0;0;0
293;12.05.2018;2018;05;06;Lauantai;4;1;5;0;0;0
293;12.05.2018;2018;05;07;Lauantai;7;6;13;5;0;5
293;12.05.2018;2018;05;08;Lauantai;11;3;14;2;5;7
293;12.05.2018;2018;05;09;Lauantai;25;12;37;3;6;9
293;12.05.2018;2018;05;10;Lauantai;27;18;45;5;2;7
293;12.05.2018;2018;05;11;Lauantai;32;38;70;9;4;13
293;12.05.2018;2018;05;12;Lauantai;48;40;88;2;4;6
293;12.05.2018;2018;05;13;Lauantai;57;53;110;6;7;13
293;12.05.2018;2018;05;14;Lauantai;39;50;89;9;8;17
293;12.05.2018;2018;05;15;Lauantai;56;53;109;11;7;18
293;12.05.2018;2018;05;16;Lauantai;63;64;127;2;6;8
293;12.05.2018;2018;05;17;Lauantai;34;49;83;8;2;10
293;12.05.2018;2018;05;18;Lauantai;45;54;99;10;11;21
293;12.05.2018;2018;05;19;Lauantai;41;30;71;10;5;15
293;12.05.2018;2018;05;20;Lauantai;27;44;71;4;2;6
293;12.05.2018;2018;05;21;Lauantai;12;19;31;4;3;7
293;12.05.2018;2018;05;22;Lauantai;3;7;10;2;1;3
293;12.05.2018;2018;05;23;Lauantai;3;3;6;1;0;1
293;13.05.2018;2018;05;00;Sunnuntai;1;6;7;0;0;0
293;13.05.2018;2018;05;01;Sunnuntai;1;0;1;1;3;4
293;13.05.2018;2018;05;02;Sunnuntai;0;0;0;0;1;1
293;13.05.2018;2018;05;03;Sunnuntai;2;2;4;0;0;0
293;13.05.2018;2018;05;04;Sunnuntai;0;0;0;0;0;0
293;13.05.2018;2018;05;05;Sunnuntai;0;0;0;0;0;0
293;13.05.2018;2018;05;06;Sunnuntai;2;3;5;0;0;0
293;13.05.2018;2018;05;07;Sunnuntai;0;0;0;1;0;1
293;13.05.2018;2018;05;08;Sunnuntai;2;4;6;3;0;3
293;13.05.2018;2018;05;09;Sunnuntai;25;16;41;3;2;5
293;13.05.2018;2018;05;10;Sunnuntai;27;33;60;6;5;11
293;13.05.2018;2018;05;11;Sunnuntai;35;49;84;9;7;16
293;13.05.2018;2018;05;12;Sunnuntai;44;37;81;10;5;15
293;13.05.2018;2018;05;13;Sunnuntai;32;23;55;4;7;11
293;13.05.2018;2018;05;14;Sunnuntai;55;45;100;14;9;23
293;13.05.2018;2018;05;15;Sunnuntai;40;27;67;6;7;13
293;13.05.2018;2018;05;16;Sunnuntai;62;41;103;6;3;9
293;13.05.2018;2018;05;17;Sunnuntai;52;60;112;10;10;20
293;13.05.2018;2018;05;18;Sunnuntai;64;52;116;9;8;17
293;13.05.2018;2018;05;19;Sunnuntai;34;36;70;14;11;25
293;13.05.2018;2018;05;20;Sunnuntai;17;27;44;4;4;8
293;13.05.2018;2018;05;21;Sunnuntai;6;10;16;0;2;2
293;13.05.2018;2018;05;22;Sunnuntai;1;1;2;0;1;1
293;13.05.2018;2018;05;23;Sunnuntai;0;1;1;0;0;0
293;14.05.2018;2018;05;00;Maanantai;0;0;0;0;0;0
293;14.05.2018;2018;05;01;Maanantai;0;0;0;0;0;0
293;14.05.2018;2018;05;02;Maanantai;0;0;0;0;0;0
293;14.05.2018;2018;05;03;Maanantai;0;0;0;0;0;0
293;14.05.2018;2018;05;04;Maanantai;0;0;0;0;0;0
293;14.05.2018;2018;05;05;Maanantai;5;0;5;0;0;0
293;14.05.2018;2018;05;06;Maanantai;16;1;17;1;1;2
293;14.05.2018;2018;05;07;Maanantai;81;10;91;6;2;8
293;14.05.2018;2018;05;08;Maanantai;106;28;134;5;3;8
293;14.05.2018;2018;05;09;Maanantai;43;21;64;5;2;7
293;14.05.2018;2018;05;10;Maanantai;16;16;32;7;4;11
293;14.05.2018;2018;05;11;Maanantai;14;17;31;4;4;8
293;14.05.2018;2018;05;12;Maanantai;17;15;32;4;7;11
293;14.05.2018;2018;05;13;Maanantai;26;53;79;4;2;6
293;14.05.2018;2018;05;14;Maanantai;40;100;140;4;7;11
293;14.05.2018;2018;05;15;Maanantai;29;105;134;6;11;17
293;14.05.2018;2018;05;16;Maanantai;54;58;112;9;5;14
293;14.05.2018;2018;05;17;Maanantai;54;40;94;10;3;13
293;14.05.2018;2018;05;18;Maanantai;49;42;91;8;16;24
293;14.05.2018;2018;05;19;Maanantai;31;46;77;5;10;15
293;14.05.2018;2018;05;20;Maanantai;17;35;52;4;4;8
293;14.05.2018;2018;05;21;Maanantai;5;10;15;3;1;4
293;14.05.2018;2018;05;22;Maanantai;1;2;3;0;1;1
293;14.05.2018;2018;05;23;Maanantai;0;1;1;1;0;1
293;15.05.2018;2018;05;00;Tiistai;0;0;0;0;0;0
293;15.05.2018;2018;05;01;Tiistai;0;0;0;0;0;0
293;15.05.2018;2018;05;02;Tiistai;0;0;0;0;0;0
293;15.05.2018;2018;05;03;Tiistai;1;0;1;1;1;2
293;15.05.2018;2018;05;04;Tiistai;0;0;0;0;0;0
293;15.05.2018;2018;05;05;Tiistai;4;0;4;0;0;0
293;15.05.2018;2018;05;06;Tiistai;20;5;25;1;0;1
293;15.05.2018;2018;05;07;Tiistai;96;10;106;5;2;7
293;15.05.2018;2018;05;08;Tiistai;80;14;94;7;1;8
293;15.05.2018;2018;05;09;Tiistai;41;14;55;2;1;3
293;15.05.2018;2018;05;10;Tiistai;32;10;42;3;2;5
293;15.05.2018;2018;05;11;Tiistai;23;9;32;4;2;6
293;15.05.2018;2018;05;12;Tiistai;14;26;40;9;5;14
293;15.05.2018;2018;05;13;Tiistai;10;50;60;2;8;10
293;15.05.2018;2018;05;14;Tiistai;27;102;129;4;7;11
293;15.05.2018;2018;05;15;Tiistai;26;81;107;1;4;5
293;15.05.2018;2018;05;16;Tiistai;51;65;116;4;7;11
293;15.05.2018;2018;05;17;Tiistai;38;57;95;6;5;11
293;15.05.2018;2018;05;18;Tiistai;53;48;101;14;10;24
293;15.05.2018;2018;05;19;Tiistai;34;39;73;4;9;13
293;15.05.2018;2018;05;20;Tiistai;22;22;44;4;2;6
293;15.05.2018;2018;05;21;Tiistai;1;15;16;1;3;4
293;15.05.2018;2018;05;22;Tiistai;3;5;8;1;1;2
293;15.05.2018;2018;05;23;Tiistai;2;0;2;0;0;0
293;16.05.2018;2018;05;00;Keskiviikko;0;0;0;0;0;0
293;16.05.2018;2018;05;01;Keskiviikko;0;0;0;0;0;0
293;16.05.2018;2018;05;02;Keskiviikko;0;0;0;0;0;0
293;16.05.2018;2018;05;03;Keskiviikko;1;0;1;0;0;0
293;16.05.2018;2018;05;04;Keskiviikko;0;0;0;1;0;1
293;16.05.2018;2018;05;05;Keskiviikko;3;0;3;0;1;1
293;16.05.2018;2018;05;06;Keskiviikko;25;3;28;4;0;4
293;16.05.2018;2018;05;07;Keskiviikko;111;11;122;7;1;8
293;16.05.2018;2018;05;08;Keskiviikko;105;20;125;6;2;8
293;16.05.2018;2018;05;09;Keskiviikko;31;16;47;3;2;5
293;16.05.2018;2018;05;10;Keskiviikko;20;11;31;3;1;4
293;16.05.2018;2018;05;11;Keskiviikko;20;19;39;4;5;9
293;16.05.2018;2018;05;12;Keskiviikko;29;32;61;1;2;3
293;16.05.2018;2018;05;13;Keskiviikko;25;72;97;5;5;10
293;16.05.2018;2018;05;14;Keskiviikko;33;147;180;2;11;13
293;16.05.2018;2018;05;15;Keskiviikko;44;49;93;11;4;15
293;16.05.2018;2018;05;16;Keskiviikko;30;64;94;3;3;6
293;16.05.2018;2018;05;17;Keskiviikko;64;59;123;10;5;15
293;16.05.2018;2018;05;18;Keskiviikko;40;59;99;14;9;23
293;16.05.2018;2018;05;19;Keskiviikko;46;43;89;9;7;16
293;16.05.2018;2018;05;20;Keskiviikko;18;30;48;7;7;14
293;16.05.2018;2018;05;21;Keskiviikko;6;24;30;2;2;4
293;16.05.2018;2018;05;22;Keskiviikko;1;4;5;0;1;1
293;16.05.2018;2018;05;23;Keskiviikko;1;0;1;1;1;2
293;17.05.2018;2018;05;00;Torstai;0;0;0;0;0;0
293;17.05.2018;2018;05;01;Torstai;0;0;0;0;0;0
293;17.05.2018;2018;05;02;Torstai;0;0;0;0;0;0
293;17.05.2018;2018;05;03;Torstai;1;0;1;0;0;0
293;17.05.2018;2018;05;04;Torstai;1;0;1;0;0;0
293;17.05.2018;2018;05;05;Torstai;6;0;6;0;0;0
293;17.05.2018;2018;05;06;Torstai;22;3;25;1;0;1
293;17.05.2018;2018;05;07;Torstai;110;11;121;3;4;7
293;17.05.2018;2018;05;08;Torstai;88;17;105;4;24;28
293;17.05.2018;2018;05;09;Torstai;31;13;44;3;2;5
293;17.05.2018;2018;05;10;Torstai;23;15;38;3;2;5
293;17.05.2018;2018;05;11;Torstai;16;20;36;5;6;11
293;17.05.2018;2018;05;12;Torstai;20;18;38;7;3;10
293;17.05.2018;2018;05;13;Torstai;15;46;61;4;28;32
293;17.05.2018;2018;05;14;Torstai;21;104;125;2;6;8
293;17.05.2018;2018;05;15;Torstai;18;82;100;1;4;5
293;17.05.2018;2018;05;16;Torstai;32;38;70;6;3;9
293;17.05.2018;2018;05;17;Torstai;23;20;43;7;4;11
293;17.05.2018;2018;05;18;Torstai;30;22;52;6;10;16
293;17.05.2018;2018;05;19;Torstai;27;38;65;6;4;10
293;17.05.2018;2018;05;20;Torstai;5;26;31;2;4;6
293;17.05.2018;2018;05;21;Torstai;6;6;12;0;0;0
293;17.05.2018;2018;05;22;Torstai;0;3;3;0;0;0
293;17.05.2018;2018;05;23;Torstai;1;1;2;0;0;0
293;18.05.2018;2018;05;00;Perjantai;0;0;0;0;0;0
293;18.05.2018;2018;05;01;Perjantai;0;1;1;0;0;0
293;18.05.2018;2018;05;02;Perjantai;0;0;0;0;0;0
293;18.05.2018;2018;05;03;Perjantai;1;1;2;0;0;0
293;18.05.2018;2018;05;04;Perjantai;0;0;0;0;0;0
293;18.05.2018;2018;05;05;Perjantai;4;0;4;0;0;0
293;18.05.2018;2018;05;06;Perjantai;14;2;16;0;0;0
293;18.05.2018;2018;05;07;Perjantai;82;7;89;3;1;4
293;18.05.2018;2018;05;08;Perjantai;67;10;77;4;1;5
293;18.05.2018;2018;05;09;Perjantai;39;12;51;3;2;5
293;18.05.2018;2018;05;10;Perjantai;22;15;37;4;0;4
293;18.05.2018;2018;05;11;Perjantai;6;10;16;1;3;4
293;18.05.2018;2018;05;12;Perjantai;22;22;44;1;1;2
293;18.05.2018;2018;05;13;Perjantai;22;61;83;2;7;9
293;18.05.2018;2018;05;14;Perjantai;20;104;124;2;11;13
293;18.05.2018;2018;05;15;Perjantai;25;59;84;3;5;8
293;18.05.2018;2018;05;16;Perjantai;23;32;55;11;4;15
293;18.05.2018;2018;05;17;Perjantai;16;22;38;3;4;7
293;18.05.2018;2018;05;18;Perjantai;39;36;75;6;7;13
293;18.05.2018;2018;05;19;Perjantai;26;22;48;3;4;7
293;18.05.2018;2018;05;20;Perjantai;21;36;57;2;6;8
293;18.05.2018;2018;05;21;Perjantai;15;20;35;2;9;11
293;18.05.2018;2018;05;22;Perjantai;5;7;12;6;1;7
293;18.05.2018;2018;05;23;Perjantai;1;12;13;3;0;3
293;19.05.2018;2018;05;00;Lauantai;3;4;7;2;2;4
293;19.05.2018;2018;05;01;Lauantai;0;0;0;1;0;1
293;19.05.2018;2018;05;02;Lauantai;0;0;0;0;0;0
293;19.05.2018;2018;05;03;Lauantai;1;3;4;0;0;0
293;19.05.2018;2018;05;04;Lauantai;0;0;0;0;0;0
293;19.05.2018;2018;05;05;Lauantai;0;0;0;0;0;0
293;19.05.2018;2018;05;06;Lauantai;1;0;1;0;0;0
293;19.05.2018;2018;05;07;Lauantai;3;1;4;1;1;2
293;19.05.2018;2018;05;08;Lauantai;10;8;18;1;0;1
293;19.05.2018;2018;05;09;Lauantai;18;16;34;4;3;7
293;19.05.2018;2018;05;10;Lauantai;21;12;33;4;6;10
293;19.05.2018;2018;05;11;Lauantai;26;36;62;3;2;5
293;19.05.2018;2018;05;12;Lauantai;30;25;55;9;8;17
293;19.05.2018;2018;05;13;Lauantai;27;31;58;7;6;13
293;19.05.2018;2018;05;14;Lauantai;48;27;75;11;9;20
293;19.05.2018;2018;05;15;Lauantai;44;35;79;6;9;15
293;19.05.2018;2018;05;16;Lauantai;42;43;85;7;5;12
293;19.05.2018;2018;05;17;Lauantai;22;29;51;6;4;10
293;19.05.2018;2018;05;18;Lauantai;28;37;65;5;8;13
293;19.05.2018;2018;05;19;Lauantai;29;41;70;3;4;7
293;19.05.2018;2018;05;20;Lauantai;36;24;60;3;3;6
293;19.05.2018;2018;05;21;Lauantai;15;9;24;5;2;7
293;19.05.2018;2018;05;22;Lauantai;10;9;19;1;2;3
293;19.05.2018;2018;05;23;Lauantai;3;4;7;2;0;2
293;20.05.2018;2018;05;00;Sunnuntai;0;1;1;0;0;0
293;20.05.2018;2018;05;01;Sunnuntai;2;4;6;0;1;1
293;20.05.2018;2018;05;02;Sunnuntai;2;3;5;0;1;1
293;20.05.2018;2018;05;03;Sunnuntai;0;1;1;0;0;0
293;20.05.2018;2018;05;04;Sunnuntai;1;0;1;0;0;0
293;20.05.2018;2018;05;05;Sunnuntai;0;1;1;1;1;2
293;20.05.2018;2018;05;06;Sunnuntai;2;1;3;0;0;0
293;20.05.2018;2018;05;07;Sunnuntai;1;0;1;2;0;2
293;20.05.2018;2018;05;08;Sunnuntai;4;2;6;0;1;1
293;20.05.2018;2018;05;09;Sunnuntai;14;5;19;3;4;7
293;20.05.2018;2018;05;10;Sunnuntai;24;8;32;4;4;8
293;20.05.2018;2018;05;11;Sunnuntai;32;27;59;7;9;16
293;20.05.2018;2018;05;12;Sunnuntai;31;35;66;5;6;11
293;20.05.2018;2018;05;13;Sunnuntai;33;44;77;12;5;17
293;20.05.2018;2018;05;14;Sunnuntai;26;35;61;4;6;10
293;20.05.2018;2018;05;15;Sunnuntai;47;40;87;8;7;15
293;20.05.2018;2018;05;16;Sunnuntai;35;35;70;3;2;5
293;20.05.2018;2018;05;17;Sunnuntai;50;40;90;8;8;16
293;20.05.2018;2018;05;18;Sunnuntai;44;26;70;4;6;10
293;20.05.2018;2018;05;19;Sunnuntai;24;40;64;15;4;19
293;20.05.2018;2018;05;20;Sunnuntai;13;26;39;0;4;4
293;20.05.2018;2018;05;21;Sunnuntai;2;6;8;0;0;0
293;20.05.2018;2018;05;22;Sunnuntai;0;0;0;2;1;3
293;20.05.2018;2018;05;23;Sunnuntai;0;0;0;0;0;0
293;21.05.2018;2018;05;00;Maanantai;1;0;1;0;0;0
293;21.05.2018;2018;05;01;Maanantai;0;0;0;0;0;0
293;21.05.2018;2018;05;02;Maanantai;0;0;0;0;0;0
293;21.05.2018;2018;05;03;Maanantai;0;0;0;0;0;0
293;21.05.2018;2018;05;04;Maanantai;0;0;0;0;0;0
293;21.05.2018;2018;05;05;Maanantai;5;0;5;0;0;0
293;21.05.2018;2018;05;06;Maanantai;17;4;21;3;0;3
293;21.05.2018;2018;05;07;Maanantai;94;11;105;3;0;3
293;21.05.2018;2018;05;08;Maanantai;113;18;131;8;0;8
293;21.05.2018;2018;05;09;Maanantai;29;17;46;2;1;3
293;21.05.2018;2018;05;10;Maanantai;16;7;23;3;0;3
293;21.05.2018;2018;05;11;Maanantai;21;16;37;4;3;7
293;21.05.2018;2018;05;12;Maanantai;17;9;26;3;1;4
293;21.05.2018;2018;05;13;Maanantai;13;34;47;1;4;5
293;21.05.2018;2018;05;14;Maanantai;27;95;122;5;4;9
293;21.05.2018;2018;05;15;Maanantai;29;111;140;3;6;9
293;21.05.2018;2018;05;16;Maanantai;35;44;79;3;9;12
293;21.05.2018;2018;05;17;Maanantai;45;44;89;5;7;12
293;21.05.2018;2018;05;18;Maanantai;51;46;97;7;4;11
293;21.05.2018;2018;05;19;Maanantai;33;50;83;7;7;14
293;21.05.2018;2018;05;20;Maanantai;20;23;43;5;6;11
293;21.05.2018;2018;05;21;Maanantai;8;14;22;0;1;1
293;21.05.2018;2018;05;22;Maanantai;1;5;6;0;0;0
293;21.05.2018;2018;05;23;Maanantai;0;1;1;1;1;2
293;22.05.2018;2018;05;00;Tiistai;0;0;0;0;0;0
293;22.05.2018;2018;05;01;Tiistai;0;0;0;0;0;0
293;22.05.2018;2018;05;02;Tiistai;0;0;0;0;0;0
293;22.05.2018;2018;05;03;Tiistai;1;1;2;0;0;0
293;22.05.2018;2018;05;04;Tiistai;1;0;1;0;0;0
293;22.05.2018;2018;05;05;Tiistai;5;0;5;0;0;0
293;22.05.2018;2018;05;06;Tiistai;16;1;17;2;0;2
293;22.05.2018;2018;05;07;Tiistai;69;14;83;5;0;5
293;22.05.2018;2018;05;08;Tiistai;109;26;135;9;0;9
293;22.05.2018;2018;05;09;Tiistai;38;15;53;5;5;10
293;22.05.2018;2018;05;10;Tiistai;32;17;49;7;5;12
293;22.05.2018;2018;05;11;Tiistai;21;13;34;15;5;20
293;22.05.2018;2018;05;12;Tiistai;33;24;57;3;5;8
293;22.05.2018;2018;05;13;Tiistai;24;68;92;6;6;12
293;22.05.2018;2018;05;14;Tiistai;21;119;140;4;4;8
293;22.05.2018;2018;05;15;Tiistai;43;79;122;4;5;9
293;22.05.2018;2018;05;16;Tiistai;50;79;129;5;8;13
293;22.05.2018;2018;05;17;Tiistai;57;50;107;9;11;20
293;22.05.2018;2018;05;18;Tiistai;46;39;85;6;1;7
293;22.05.2018;2018;05;19;Tiistai;44;43;87;10;8;18
293;22.05.2018;2018;05;20;Tiistai;15;43;58;6;6;12
293;22.05.2018;2018;05;21;Tiistai;5;9;14;2;0;2
293;22.05.2018;2018;05;22;Tiistai;3;1;4;2;0;2
293;22.05.2018;2018;05;23;Tiistai;0;0;0;0;1;1
293;23.05.2018;2018;05;00;Keskiviikko;0;0;0;0;0;0
293;23.05.2018;2018;05;01;Keskiviikko;0;0;0;0;0;0
293;23.05.2018;2018;05;02;Keskiviikko;0;0;0;0;0;0
293;23.05.2018;2018;05;03;Keskiviikko;1;0;1;0;0;0
293;23.05.2018;2018;05;04;Keskiviikko;0;0;0;0;0;0
293;23.05.2018;2018;05;05;Keskiviikko;4;1;5;0;0;0
293;23.05.2018;2018;05;06;Keskiviikko;18;6;24;2;1;3
293;23.05.2018;2018;05;07;Keskiviikko;80;5;85;2;0;2
293;23.05.2018;2018;05;08;Keskiviikko;112;35;147;9;0;9
293;23.05.2018;2018;05;09;Keskiviikko;29;7;36;2;1;3
293;23.05.2018;2018;05;10;Keskiviikko;14;10;24;5;1;6
293;23.05.2018;2018;05;11;Keskiviikko;11;20;31;2;4;6
293;23.05.2018;2018;05;12;Keskiviikko;15;20;35;2;2;4
293;23.05.2018;2018;05;13;Keskiviikko;15;58;73;6;4;10
293;23.05.2018;2018;05;14;Keskiviikko;26;114;140;5;10;15
293;23.05.2018;2018;05;15;Keskiviikko;27;42;69;5;6;11
293;23.05.2018;2018;05;16;Keskiviikko;39;50;89;4;2;6
293;23.05.2018;2018;05;17;Keskiviikko;19;25;44;7;5;12
293;23.05.2018;2018;05;18;Keskiviikko;24;28;52;10;6;16
293;23.05.2018;2018;05;19;Keskiviikko;27;33;60;7;8;15
293;23.05.2018;2018;05;20;Keskiviikko;20;24;44;5;7;12
293;23.05.2018;2018;05;21;Keskiviikko;3;17;20;2;1;3
293;23.05.2018;2018;05;22;Keskiviikko;5;5;10;2;1;3
293;23.05.2018;2018;05;23;Keskiviikko;1;1;2;0;1;1
293;24.05.2018;2018;05;00;Torstai;0;0;0;0;0;0
293;24.05.2018;2018;05;01;Torstai;0;1;1;0;0;0
293;24.05.2018;2018;05;02;Torstai;0;0;0;0;0;0
293;24.05.2018;2018;05;03;Torstai;1;0;1;0;0;0
293;24.05.2018;2018;05;04;Torstai;0;0;0;1;0;1
293;24.05.2018;2018;05;05;Torstai;5;1;6;0;1;1
293;24.05.2018;2018;05;06;Torstai;13;3;16;1;0;1
293;24.05.2018;2018;05;07;Torstai;56;5;61;1;0;1
293;24.05.2018;2018;05;08;Torstai;126;15;141;4;0;4
293;24.05.2018;2018;05;09;Torstai;26;14;40;3;2;5
293;24.05.2018;2018;05;10;Torstai;16;16;32;5;1;6
293;24.05.2018;2018;05;11;Torstai;11;17;28;6;5;11
293;24.05.2018;2018;05;12;Torstai;15;16;31;3;0;3
293;24.05.2018;2018;05;13;Torstai;11;50;61;4;2;6
293;24.05.2018;2018;05;14;Torstai;15;78;93;6;8;14
293;24.05.2018;2018;05;15;Torstai;12;60;72;3;6;9
293;24.05.2018;2018;05;16;Torstai;26;41;67;2;5;7
293;24.05.2018;2018;05;17;Torstai;36;35;71;5;2;7
293;24.05.2018;2018;05;18;Torstai;30;40;70;4;1;5
293;24.05.2018;2018;05;19;Torstai;15;25;40;4;10;14
293;24.05.2018;2018;05;20;Torstai;23;18;41;3;2;5
293;24.05.2018;2018;05;21;Torstai;10;12;22;0;1;1
293;24.05.2018;2018;05;22;Torstai;0;2;2;1;0;1
293;24.05.2018;2018;05;23;Torstai;0;0;0;1;1;2
293;25.05.2018;2018;05;00;Perjantai;1;0;1;0;0;0
293;25.05.2018;2018;05;01;Perjantai;0;1;1;0;0;0
293;25.05.2018;2018;05;02;Perjantai;0;1;1;1;1;2
293;25.05.2018;2018;05;03;Perjantai;1;0;1;0;0;0
293;25.05.2018;2018;05;04;Perjantai;3;1;4;0;0;0
293;25.05.2018;2018;05;05;Perjantai;3;1;4;0;0;0
293;25.05.2018;2018;05;06;Perjantai;14;4;18;0;0;0
293;25.05.2018;2018;05;07;Perjantai;41;13;54;3;0;3
293;25.05.2018;2018;05;08;Perjantai;159;15;174;4;1;5
293;25.05.2018;2018;05;09;Perjantai;34;20;54;4;4;8
293;25.05.2018;2018;05;10;Perjantai;19;17;36;5;4;9
293;25.05.2018;2018;05;11;Perjantai;12;26;38;3;2;5
293;25.05.2018;2018;05;12;Perjantai;11;40;51;5;4;9
293;25.05.2018;2018;05;13;Perjantai;26;129;155;6;6;12
293;25.05.2018;2018;05;14;Perjantai;30;42;72;10;2;12
293;25.05.2018;2018;05;15;Perjantai;30;46;76;5;6;11
293;25.05.2018;2018;05;16;Perjantai;28;41;69;3;5;8
293;25.05.2018;2018;05;17;Perjantai;37;45;82;5;4;9
293;25.05.2018;2018;05;18;Perjantai;43;28;71;6;8;14
293;25.05.2018;2018;05;19;Perjantai;25;42;67;4;11;15
293;25.05.2018;2018;05;20;Perjantai;27;21;48;6;3;9
293;25.05.2018;2018;05;21;Perjantai;9;17;26;4;5;9
293;25.05.2018;2018;05;22;Perjantai;7;11;18;2;3;5
293;25.05.2018;2018;05;23;Perjantai;4;8;12;0;1;1
293;26.05.2018;2018;05;00;Lauantai;3;4;7;0;2;2
293;26.05.2018;2018;05;01;Lauantai;0;4;4;0;0;0
293;26.05.2018;2018;05;02;Lauantai;0;1;1;0;0;0
293;26.05.2018;2018;05;03;Lauantai;0;0;0;0;0;0
293;26.05.2018;2018;05;04;Lauantai;1;2;3;0;0;0
293;26.05.2018;2018;05;05;Lauantai;1;1;2;0;0;0
293;26.05.2018;2018;05;06;Lauantai;3;1;4;0;0;0
293;26.05.2018;2018;05;07;Lauantai;8;2;10;1;0;1
293;26.05.2018;2018;05;08;Lauantai;6;9;15;0;2;2
293;26.05.2018;2018;05;09;Lauantai;9;12;21;3;3;6
293;26.05.2018;2018;05;10;Lauantai;22;14;36;1;1;2
293;26.05.2018;2018;05;11;Lauantai;24;22;46;7;7;14
293;26.05.2018;2018;05;12;Lauantai;18;28;46;5;5;10
293;26.05.2018;2018;05;13;Lauantai;45;28;73;9;7;16
293;26.05.2018;2018;05;14;Lauantai;34;35;69;9;2;11
293;26.05.2018;2018;05;15;Lauantai;27;39;66;2;1;3
293;26.05.2018;2018;05;16;Lauantai;30;25;55;4;6;10
293;26.05.2018;2018;05;17;Lauantai;26;25;51;2;4;6
293;26.05.2018;2018;05;18;Lauantai;22;26;48;5;8;13
293;26.05.2018;2018;05;19;Lauantai;32;27;59;4;1;5
293;26.05.2018;2018;05;20;Lauantai;20;20;40;3;4;7
293;26.05.2018;2018;05;21;Lauantai;7;17;24;2;2;4
293;26.05.2018;2018;05;22;Lauantai;8;8;16;3;1;4
293;26.05.2018;2018;05;23;Lauantai;11;7;18;2;1;3
293;27.05.2018;2018;05;00;Sunnuntai;0;5;5;2;3;5
293;27.05.2018;2018;05;01;Sunnuntai;1;3;4;0;2;2
293;27.05.2018;2018;05;02;Sunnuntai;5;7;12;0;3;3
293;27.05.2018;2018;05;03;Sunnuntai;0;2;2;2;2;4
293;27.05.2018;2018;05;04;Sunnuntai;0;2;2;0;1;1
293;27.05.2018;2018;05;05;Sunnuntai;1;1;2;3;1;4
293;27.05.2018;2018;05;06;Sunnuntai;1;0;1;0;1;1
293;27.05.2018;2018;05;07;Sunnuntai;3;0;3;0;0;0
293;27.05.2018;2018;05;08;Sunnuntai;6;5;11;5;2;7
293;27.05.2018;2018;05;09;Sunnuntai;14;3;17;4;1;5
293;27.05.2018;2018;05;10;Sunnuntai;20;15;35;3;3;6
293;27.05.2018;2018;05;11;Sunnuntai;28;33;61;5;4;9
293;27.05.2018;2018;05;12;Sunnuntai;33;31;64;5;6;11
293;27.05.2018;2018;05;13;Sunnuntai;36;27;63;1;2;3
293;27.05.2018;2018;05;14;Sunnuntai;23;37;60;4;3;7
293;27.05.2018;2018;05;15;Sunnuntai;22;23;45;3;2;5
293;27.05.2018;2018;05;16;Sunnuntai;26;20;46;2;7;9
293;27.05.2018;2018;05;17;Sunnuntai;38;20;58;4;1;5
293;27.05.2018;2018;05;18;Sunnuntai;32;18;50;5;10;15
293;27.05.2018;2018;05;19;Sunnuntai;25;30;55;3;7;10
293;27.05.2018;2018;05;20;Sunnuntai;11;20;31;8;4;12
293;27.05.2018;2018;05;21;Sunnuntai;4;17;21;0;4;4
293;27.05.2018;2018;05;22;Sunnuntai;3;1;4;2;2;4
293;27.05.2018;2018;05;23;Sunnuntai;0;2;2;0;0;0
293;28.05.2018;2018;05;00;Maanantai;0;0;0;0;1;1
293;28.05.2018;2018;05;01;Maanantai;0;0;0;0;0;0
293;28.05.2018;2018;05;02;Maanantai;0;0;0;0;0;0
293;28.05.2018;2018;05;03;Maanantai;1;0;1;0;0;0
293;28.05.2018;2018;05;04;Maanantai;0;0;0;0;0;0
293;28.05.2018;2018;05;05;Maanantai;6;0;6;0;0;0
293;28.05.2018;2018;05;06;Maanantai;15;2;17;1;0;1
293;28.05.2018;2018;05;07;Maanantai;50;8;58;1;1;2
293;28.05.2018;2018;05;08;Maanantai;150;25;175;10;0;10
293;28.05.2018;2018;05;09;Maanantai;32;16;48;2;3;5
293;28.05.2018;2018;05;10;Maanantai;18;16;34;5;3;8
293;28.05.2018;2018;05;11;Maanantai;20;22;42;2;4;6
293;28.05.2018;2018;05;12;Maanantai;20;21;41;8;3;11
293;28.05.2018;2018;05;13;Maanantai;19;49;68;3;1;4
293;28.05.2018;2018;05;14;Maanantai;23;77;100;10;8;18
293;28.05.2018;2018;05;15;Maanantai;20;99;119;8;7;15
293;28.05.2018;2018;05;16;Maanantai;29;40;69;6;4;10
293;28.05.2018;2018;05;17;Maanantai;32;29;61;2;9;11
293;28.05.2018;2018;05;18;Maanantai;38;34;72;8;3;11
293;28.05.2018;2018;05;19;Maanantai;37;35;72;8;7;15
293;28.05.2018;2018;05;20;Maanantai;11;28;39;3;3;6
293;28.05.2018;2018;05;21;Maanantai;7;17;24;1;2;3
293;28.05.2018;2018;05;22;Maanantai;1;6;7;0;0;0
293;28.05.2018;2018;05;23;Maanantai;1;1;2;1;0;1
293;29.05.2018;2018;05;00;Tiistai;1;0;1;0;0;0
293;29.05.2018;2018;05;01;Tiistai;0;0;0;0;0;0
293;29.05.2018;2018;05;02;Tiistai;0;0;0;0;0;0
293;29.05.2018;2018;05;03;Tiistai;1;0;1;0;0;0
293;29.05.2018;2018;05;04;Tiistai;0;0;0;0;0;0
293;29.05.2018;2018;05;05;Tiistai;4;0;4;0;0;0
293;29.05.2018;2018;05;06;Tiistai;24;5;29;2;1;3
293;29.05.2018;2018;05;07;Tiistai;59;10;69;2;2;4
293;29.05.2018;2018;05;08;Tiistai;122;12;134;3;1;4
293;29.05.2018;2018;05;09;Tiistai;29;10;39;6;3;9
293;29.05.2018;2018;05;10;Tiistai;24;18;42;3;2;5
293;29.05.2018;2018;05;11;Tiistai;15;24;39;2;8;10
293;29.05.2018;2018;05;12;Tiistai;18;16;34;8;0;8
293;29.05.2018;2018;05;13;Tiistai;22;74;96;6;5;11
293;29.05.2018;2018;05;14;Tiistai;28;92;120;5;5;10
293;29.05.2018;2018;05;15;Tiistai;14;57;71;4;3;7
293;29.05.2018;2018;05;16;Tiistai;30;41;71;5;3;8
293;29.05.2018;2018;05;17;Tiistai;34;39;73;10;8;18
293;29.05.2018;2018;05;18;Tiistai;31;33;64;9;5;14
293;29.05.2018;2018;05;19;Tiistai;35;36;71;9;12;21
293;29.05.2018;2018;05;20;Tiistai;21;28;49;1;4;5
293;29.05.2018;2018;05;21;Tiistai;6;17;23;5;5;10
293;29.05.2018;2018;05;22;Tiistai;1;6;7;2;1;3
293;29.05.2018;2018;05;23;Tiistai;1;0;1;1;1;2
293;30.05.2018;2018;05;00;Keskiviikko;0;0;0;0;0;0
293;30.05.2018;2018;05;01;Keskiviikko;0;1;1;0;0;0
293;30.05.2018;2018;05;02;Keskiviikko;1;5;6;0;0;0
293;30.05.2018;2018;05;03;Keskiviikko;1;0;1;0;0;0
293;30.05.2018;2018;05;04;Keskiviikko;1;0;1;0;0;0
293;30.05.2018;2018;05;05;Keskiviikko;5;0;5;0;0;0
293;30.05.2018;2018;05;06;Keskiviikko;19;2;21;0;0;0
293;30.05.2018;2018;05;07;Keskiviikko;27;10;37;0;0;0
293;30.05.2018;2018;05;08;Keskiviikko;181;20;201;9;1;10
293;30.05.2018;2018;05;09;Keskiviikko;18;33;51;1;4;5
293;30.05.2018;2018;05;10;Keskiviikko;30;12;42;8;5;13
293;30.05.2018;2018;05;11;Keskiviikko;9;15;24;3;4;7
293;30.05.2018;2018;05;12;Keskiviikko;11;91;102;4;7;11
293;30.05.2018;2018;05;13;Keskiviikko;27;90;117;7;5;12
293;30.05.2018;2018;05;14;Keskiviikko;31;34;65;2;8;10
293;30.05.2018;2018;05;15;Keskiviikko;29;46;75;1;0;1
293;30.05.2018;2018;05;16;Keskiviikko;33;35;68;4;0;4
293;30.05.2018;2018;05;17;Keskiviikko;33;42;75;7;4;11
293;30.05.2018;2018;05;18;Keskiviikko;30;42;72;4;6;10
293;30.05.2018;2018;05;19;Keskiviikko;30;40;70;4;6;10
293;30.05.2018;2018;05;20;Keskiviikko;28;19;47;4;4;8
293;30.05.2018;2018;05;21;Keskiviikko;9;18;27;2;1;3
293;30.05.2018;2018;05;22;Keskiviikko;0;2;2;0;1;1
293;30.05.2018;2018;05;23;Keskiviikko;1;0;1;1;0;1
293;31.05.2018;2018;05;00;Torstai;1;0;1;0;0;0
293;31.05.2018;2018;05;01;Torstai;1;0;1;0;1;1
293;31.05.2018;2018;05;02;Torstai;0;1;1;0;0;0
293;31.05.2018;2018;05;03;Torstai;1;0;1;0;0;0
293;31.05.2018;2018;05;04;Torstai;0;0;0;2;0;2
293;31.05.2018;2018;05;05;Torstai;4;1;5;0;0;0
293;31.05.2018;2018;05;06;Torstai;20;2;22;0;0;0
293;31.05.2018;2018;05;07;Torstai;88;7;95;8;1;9
293;31.05.2018;2018;05;08;Torstai;168;11;179;14;1;15
293;31.05.2018;2018;05;09;Torstai;16;54;70;0;9;9
293;31.05.2018;2018;05;10;Torstai;23;11;34;0;1;1
293;31.05.2018;2018;05;11;Torstai;14;24;38;3;2;5
293;31.05.2018;2018;05;12;Torstai;21;81;102;3;3;6
293;31.05.2018;2018;05;13;Torstai;18;137;155;1;5;6
293;31.05.2018;2018;05;14;Torstai;24;42;66;2;3;5
293;31.05.2018;2018;05;15;Torstai;25;36;61;3;7;10
293;31.05.2018;2018;05;16;Torstai;33;42;75;3;2;5
293;31.05.2018;2018;05;17;Torstai;31;36;67;9;3;12
293;31.05.2018;2018;05;18;Torstai;45;36;81;12;7;19
293;31.05.2018;2018;05;19;Torstai;23;21;44;0;12;12
293;31.05.2018;2018;05;20;Torstai;13;21;34;6;6;12
293;31.05.2018;2018;05;21;Torstai;5;11;16;3;4;7
293;31.05.2018;2018;05;22;Torstai;3;1;4;0;0;0
293;31.05.2018;2018;05;23;Torstai;1;0;1;0;0;0
293;01.06.2018;2018;06;00;Perjantai;1;0;1;0;0;0
293;01.06.2018;2018;06;01;Perjantai;1;0;1;0;0;0
293;01.06.2018;2018;06;02;Perjantai;1;0;1;2;0;2
293;01.06.2018;2018;06;03;Perjantai;1;0;1;0;0;0
293;01.06.2018;2018;06;04;Perjantai;4;0;4;0;0;0
293;01.06.2018;2018;06;05;Perjantai;4;0;4;0;0;0
293;01.06.2018;2018;06;06;Perjantai;18;0;18;0;0;0
293;01.06.2018;2018;06;07;Perjantai;54;0;54;3;0;3
293;01.06.2018;2018;06;08;Perjantai;174;0;174;5;0;5
293;01.06.2018;2018;06;09;Perjantai;54;0;54;8;0;8
293;01.06.2018;2018;06;10;Perjantai;36;0;36;9;0;9
293;01.06.2018;2018;06;11;Perjantai;38;0;38;5;0;5
293;01.06.2018;2018;06;12;Perjantai;51;0;51;9;0;9
293;01.06.2018;2018;06;13;Perjantai;155;0;155;12;0;12
293;01.06.2018;2018;06;14;Perjantai;72;0;72;12;0;12
293;01.06.2018;2018;06;15;Perjantai;76;0;76;11;0;11
293;01.06.2018;2018;06;16;Perjantai;69;0;69;8;0;8
293;01.06.2018;2018;06;17;Perjantai;82;0;82;9;0;9
293;01.06.2018;2018;06;18;Perjantai;71;0;71;14;0;14
293;01.06.2018;2018;06;19;Perjantai;67;0;67;15;0;15
293;01.06.2018;2018;06;20;Perjantai;48;0;48;9;0;9
293;01.06.2018;2018;06;21;Perjantai;26;0;26;9;0;9
293;01.06.2018;2018;06;22;Perjantai;18;0;18;5;0;5
293;01.06.2018;2018;06;23;Perjantai;12;0;12;1;0;1
293;02.06.2018;2018;06;00;Lauantai;0;3;3;0;0;0
293;02.06.2018;2018;06;01;Lauantai;2;5;7;0;1;1
293;02.06.2018;2018;06;02;Lauantai;0;0;0;1;0;1
293;02.06.2018;2018;06;03;Lauantai;0;0;0;2;0;2
293;02.06.2018;2018;06;04;Lauantai;0;0;0;0;1;1
293;02.06.2018;2018;06;05;Lauantai;0;0;0;0;0;0
293;02.06.2018;2018;06;06;Lauantai;2;0;2;0;0;0
293;02.06.2018;2018;06;07;Lauantai;29;1;30;0;1;1
293;02.06.2018;2018;06;08;Lauantai;60;10;70;7;3;10
293;02.06.2018;2018;06;09;Lauantai;18;83;101;6;5;11
293;02.06.2018;2018;06;10;Lauantai;26;20;46;8;2;10
293;02.06.2018;2018;06;11;Lauantai;28;30;58;7;9;16
293;02.06.2018;2018;06;12;Lauantai;34;37;71;7;5;12
293;02.06.2018;2018;06;13;Lauantai;27;41;68;4;5;9
293;02.06.2018;2018;06;14;Lauantai;31;43;74;8;5;13
293;02.06.2018;2018;06;15;Lauantai;29;37;66;3;2;5
293;02.06.2018;2018;06;16;Lauantai;35;57;92;5;3;8
293;02.06.2018;2018;06;17;Lauantai;62;40;102;12;7;19
293;02.06.2018;2018;06;18;Lauantai;48;37;85;7;2;9
293;02.06.2018;2018;06;19;Lauantai;55;45;100;5;8;13
293;02.06.2018;2018;06;20;Lauantai;27;32;59;9;1;10
293;02.06.2018;2018;06;21;Lauantai;38;34;72;6;5;11
293;02.06.2018;2018;06;22;Lauantai;27;25;52;5;5;10
293;02.06.2018;2018;06;23;Lauantai;11;15;26;1;0;1
293;03.06.2018;2018;06;00;Sunnuntai;12;14;26;0;5;5
293;03.06.2018;2018;06;01;Sunnuntai;3;9;12;3;1;4
293;03.06.2018;2018;06;02;Sunnuntai;0;14;14;0;4;4
293;03.06.2018;2018;06;03;Sunnuntai;0;5;5;0;7;7
293;03.06.2018;2018;06;04;Sunnuntai;0;1;1;0;13;13
293;03.06.2018;2018;06;05;Sunnuntai;1;0;1;6;1;7
293;03.06.2018;2018;06;06;Sunnuntai;2;0;2;2;0;2
293;03.06.2018;2018;06;07;Sunnuntai;4;1;5;0;0;0
293;03.06.2018;2018;06;08;Sunnuntai;7;5;12;4;2;6
293;03.06.2018;2018;06;09;Sunnuntai;19;13;32;6;0;6
293;03.06.2018;2018;06;10;Sunnuntai;15;20;35;6;3;9
293;03.06.2018;2018;06;11;Sunnuntai;23;20;43;6;2;8
293;03.06.2018;2018;06;12;Sunnuntai;27;32;59;2;4;6
293;03.06.2018;2018;06;13;Sunnuntai;45;36;81;5;7;12
293;03.06.2018;2018;06;14;Sunnuntai;27;39;66;8;4;12
293;03.06.2018;2018;06;15;Sunnuntai;18;39;57;5;7;12
293;03.06.2018;2018;06;16;Sunnuntai;23;8;31;3;4;7
293;03.06.2018;2018;06;17;Sunnuntai;29;31;60;4;1;5
293;03.06.2018;2018;06;18;Sunnuntai;26;35;61;5;8;13
293;03.06.2018;2018;06;19;Sunnuntai;15;15;30;3;0;3
293;03.06.2018;2018;06;20;Sunnuntai;8;16;24;0;0;0
293;03.06.2018;2018;06;21;Sunnuntai;7;16;23;0;2;2
293;03.06.2018;2018;06;22;Sunnuntai;6;7;13;0;1;1
293;03.06.2018;2018;06;23;Sunnuntai;2;0;2;1;1;2
293;04.06.2018;2018;06;00;Maanantai;0;2;2;0;0;0
293;04.06.2018;2018;06;01;Maanantai;4;0;4;0;0;0
293;04.06.2018;2018;06;02;Maanantai;0;0;0;0;0;0
293;04.06.2018;2018;06;03;Maanantai;0;0;0;0;0;0
293;04.06.2018;2018;06;04;Maanantai;0;0;0;0;0;0
293;04.06.2018;2018;06;05;Maanantai;3;0;3;0;0;0
293;04.06.2018;2018;06;06;Maanantai;17;2;19;0;0;0
293;04.06.2018;2018;06;07;Maanantai;15;2;17;1;0;1
293;04.06.2018;2018;06;08;Maanantai;16;26;42;2;4;6
293;04.06.2018;2018;06;09;Maanantai;17;12;29;2;0;2
293;04.06.2018;2018;06;10;Maanantai;7;5;12;0;0;0
293;04.06.2018;2018;06;11;Maanantai;18;10;28;1;1;2
293;04.06.2018;2018;06;12;Maanantai;14;5;19;2;1;3
293;04.06.2018;2018;06;13;Maanantai;11;15;26;4;0;4
293;04.06.2018;2018;06;14;Maanantai;14;24;38;6;2;8
293;04.06.2018;2018;06;15;Maanantai;35;40;75;4;6;10
293;04.06.2018;2018;06;16;Maanantai;24;35;59;3;7;10
293;04.06.2018;2018;06;17;Maanantai;23;16;39;1;2;3
293;04.06.2018;2018;06;18;Maanantai;7;13;20;2;2;4
293;04.06.2018;2018;06;19;Maanantai;6;11;17;5;6;11
293;04.06.2018;2018;06;20;Maanantai;2;13;15;1;2;3
293;04.06.2018;2018;06;21;Maanantai;5;10;15;0;1;1
293;04.06.2018;2018;06;22;Maanantai;4;5;9;0;0;0
293;04.06.2018;2018;06;23;Maanantai;0;2;2;2;4;6
293;05.06.2018;2018;06;00;Tiistai;0;0;0;0;1;1
293;05.06.2018;2018;06;01;Tiistai;2;2;4;0;0;0
293;05.06.2018;2018;06;02;Tiistai;0;0;0;0;0;0
293;05.06.2018;2018;06;03;Tiistai;0;0;0;0;0;0
293;05.06.2018;2018;06;04;Tiistai;0;0;0;0;1;1
293;05.06.2018;2018;06;05;Tiistai;2;0;2;0;0;0
293;05.06.2018;2018;06;06;Tiistai;13;2;15;0;0;0
293;05.06.2018;2018;06;07;Tiistai;15;9;24;0;0;0
293;05.06.2018;2018;06;08;Tiistai;17;18;35;1;1;2
293;05.06.2018;2018;06;09;Tiistai;22;8;30;2;2;4
293;05.06.2018;2018;06;10;Tiistai;12;15;27;7;2;9
293;05.06.2018;2018;06;11;Tiistai;19;15;34;3;1;4
293;05.06.2018;2018;06;12;Tiistai;21;24;45;6;3;9
293;05.06.2018;2018;06;13;Tiistai;21;17;38;1;0;1
293;05.06.2018;2018;06;14;Tiistai;13;29;42;11;6;17
293;05.06.2018;2018;06;15;Tiistai;28;37;65;2;4;6
293;05.06.2018;2018;06;16;Tiistai;21;23;44;6;5;11
293;05.06.2018;2018;06;17;Tiistai;17;19;36;3;2;5
293;05.06.2018;2018;06;18;Tiistai;25;26;51;11;8;19
293;05.06.2018;2018;06;19;Tiistai;14;29;43;0;4;4
293;05.06.2018;2018;06;20;Tiistai;18;17;35;4;4;8
293;05.06.2018;2018;06;21;Tiistai;2;6;8;1;6;7
293;05.06.2018;2018;06;22;Tiistai;5;8;13;1;0;1
293;05.06.2018;2018;06;23;Tiistai;0;2;2;2;2;4
293;06.06.2018;2018;06;00;Keskiviikko;3;0;3;0;0;0
293;06.06.2018;2018;06;01;Keskiviikko;0;0;0;0;0;0
293;06.06.2018;2018;06;02;Keskiviikko;3;0;3;0;0;0
293;06.06.2018;2018;06;03;Keskiviikko;1;0;1;0;0;0
293;06.06.2018;2018;06;04;Keskiviikko;1;0;1;0;0;0
293;06.06.2018;2018;06;05;Keskiviikko;3;1;4;0;0;0
293;06.06.2018;2018;06;06;Keskiviikko;18;3;21;0;0;0
293;06.06.2018;2018;06;07;Keskiviikko;18;4;22;3;0;3
293;06.06.2018;2018;06;08;Keskiviikko;15;22;37;2;2;4
293;06.06.2018;2018;06;09;Keskiviikko;13;6;19;3;0;3
293;06.06.2018;2018;06;10;Keskiviikko;14;4;18;2;3;5
293;06.06.2018;2018;06;11;Keskiviikko;11;11;22;2;1;3
293;06.06.2018;2018;06;12;Keskiviikko;18;14;32;5;1;6
293;06.06.2018;2018;06;13;Keskiviikko;28;27;55;5;4;9
293;06.06.2018;2018;06;14;Keskiviikko;16;27;43;6;2;8
293;06.06.2018;2018;06;15;Keskiviikko;23;39;62;4;10;14
293;06.06.2018;2018;06;16;Keskiviikko;23;24;47;2;4;6
293;06.06.2018;2018;06;17;Keskiviikko;21;23;44;4;4;8
293;06.06.2018;2018;06;18;Keskiviikko;28;16;44;10;6;16
293;06.06.2018;2018;06;19;Keskiviikko;14;19;33;5;3;8
293;06.06.2018;2018;06;20;Keskiviikko;10;15;25;2;6;8
293;06.06.2018;2018;06;21;Keskiviikko;5;14;19;2;4;6
293;06.06.2018;2018;06;22;Keskiviikko;2;7;9;1;0;1
293;06.06.2018;2018;06;23;Keskiviikko;3;3;6;0;0;0
293;07.06.2018;2018;06;00;Torstai;1;0;1;0;0;0
293;07.06.2018;2018;06;01;Torstai;0;0;0;2;1;3
293;07.06.2018;2018;06;02;Torstai;1;3;4;0;0;0
293;07.06.2018;2018;06;03;Torstai;0;0;0;0;2;2
293;07.06.2018;2018;06;04;Torstai;0;0;0;0;0;0
293;07.06.2018;2018;06;05;Torstai;3;1;4;0;0;0
293;07.06.2018;2018;06;06;Torstai;4;4;8;1;0;1
293;07.06.2018;2018;06;07;Torstai;10;5;15;1;0;1
293;07.06.2018;2018;06;08;Torstai;14;11;25;1;0;1
293;07.06.2018;2018;06;09;Torstai;6;3;9;1;1;2
293;07.06.2018;2018;06;10;Torstai;9;3;12;1;1;2
293;07.06.2018;2018;06;11;Torstai;8;8;16;1;0;1
293;07.06.2018;2018;06;12;Torstai;10;8;18;1;1;2
293;07.06.2018;2018;06;13;Torstai;16;11;27;7;4;11
293;07.06.2018;2018;06;14;Torstai;15;18;33;3;3;6
293;07.06.2018;2018;06;15;Torstai;19;20;39;4;3;7
293;07.06.2018;2018;06;16;Torstai;7;26;33;2;3;5
293;07.06.2018;2018;06;17;Torstai;14;14;28;3;0;3
293;07.06.2018;2018;06;18;Torstai;22;20;42;5;8;13
293;07.06.2018;2018;06;19;Torstai;14;22;36;4;4;8
293;07.06.2018;2018;06;20;Torstai;22;18;40;1;2;3
293;07.06.2018;2018;06;21;Torstai;8;15;23;1;3;4
293;07.06.2018;2018;06;22;Torstai;2;4;6;4;2;6
293;07.06.2018;2018;06;23;Torstai;2;3;5;0;1;1
293;08.06.2018;2018;06;00;Perjantai;0;2;2;2;0;2
293;08.06.2018;2018;06;01;Perjantai;0;3;3;0;0;0
293;08.06.2018;2018;06;02;Perjantai;1;0;1;2;0;2
293;08.06.2018;2018;06;03;Perjantai;0;0;0;0;1;1
293;08.06.2018;2018;06;04;Perjantai;0;0;0;0;0;0
293;08.06.2018;2018;06;05;Perjantai;2;0;2;0;0;0
293;08.06.2018;2018;06;06;Perjantai;13;4;17;0;0;0
293;08.06.2018;2018;06;07;Perjantai;16;4;20;1;0;1
293;08.06.2018;2018;06;08;Perjantai;16;17;33;3;1;4
293;08.06.2018;2018;06;09;Perjantai;19;9;28;0;0;0
293;08.06.2018;2018;06;10;Perjantai;14;14;28;7;3;10
293;08.06.2018;2018;06;11;Perjantai;21;9;30;3;6;9
293;08.06.2018;2018;06;12;Perjantai;18;19;37;5;1;6
293;08.06.2018;2018;06;13;Perjantai;17;27;44;9;4;13
293;08.06.2018;2018;06;14;Perjantai;22;39;61;5;1;6
293;08.06.2018;2018;06;15;Perjantai;37;41;78;5;9;14
293;08.06.2018;2018;06;16;Perjantai;30;27;57;8;4;12
293;08.06.2018;2018;06;17;Perjantai;20;21;41;5;5;10
293;08.06.2018;2018;06;18;Perjantai;17;15;32;4;2;6
293;08.06.2018;2018;06;19;Perjantai;22;33;55;7;3;10
293;08.06.2018;2018;06;20;Perjantai;18;26;44;1;1;2
293;08.06.2018;2018;06;21;Perjantai;8;11;19;0;0;0
293;08.06.2018;2018;06;22;Perjantai;7;8;15;0;1;1
293;08.06.2018;2018;06;23;Perjantai;2;4;6;0;0;0
293;09.06.2018;2018;06;00;Lauantai;4;3;7;1;1;2
293;09.06.2018;2018;06;01;Lauantai;1;3;4;0;1;1
293;09.06.2018;2018;06;02;Lauantai;1;3;4;1;0;1
293;09.06.2018;2018;06;03;Lauantai;0;0;0;0;0;0
293;09.06.2018;2018;06;04;Lauantai;0;0;0;0;0;0
293;09.06.2018;2018;06;05;Lauantai;0;1;1;1;0;1
293;09.06.2018;2018;06;06;Lauantai;2;0;2;7;3;10
293;09.06.2018;2018;06;07;Lauantai;6;2;8;0;0;0
293;09.06.2018;2018;06;08;Lauantai;7;5;12;4;1;5
293;09.06.2018;2018;06;09;Lauantai;6;9;15;0;1;1
293;09.06.2018;2018;06;10;Lauantai;15;14;29;1;2;3
293;09.06.2018;2018;06;11;Lauantai;10;9;19;9;2;11
293;09.06.2018;2018;06;12;Lauantai;26;16;42;4;7;11
293;09.06.2018;2018;06;13;Lauantai;18;14;32;1;2;3
293;09.06.2018;2018;06;14;Lauantai;14;16;30;3;0;3
293;09.06.2018;2018;06;15;Lauantai;16;24;40;4;0;4
293;09.06.2018;2018;06;16;Lauantai;21;26;47;4;3;7
293;09.06.2018;2018;06;17;Lauantai;26;27;53;2;4;6
293;09.06.2018;2018;06;18;Lauantai;11;27;38;4;5;9
293;09.06.2018;2018;06;19;Lauantai;16;24;40;2;0;2
293;09.06.2018;2018;06;20;Lauantai;13;26;39;1;4;5
293;09.06.2018;2018;06;21;Lauantai;9;6;15;2;0;2
293;09.06.2018;2018;06;22;Lauantai;4;2;6;2;2;4
293;09.06.2018;2018;06;23;Lauantai;20;5;25;3;1;4
293;10.06.2018;2018;06;00;Sunnuntai;9;3;12;5;2;7
293;10.06.2018;2018;06;01;Sunnuntai;4;5;9;1;1;2
293;10.06.2018;2018;06;02;Sunnuntai;2;7;9;1;2;3
293;10.06.2018;2018;06;03;Sunnuntai;4;1;5;0;4;4
293;10.06.2018;2018;06;04;Sunnuntai;1;2;3;0;3;3
293;10.06.2018;2018;06;05;Sunnuntai;1;0;1;0;0;0
293;10.06.2018;2018;06;06;Sunnuntai;1;0;1;1;2;3
293;10.06.2018;2018;06;07;Sunnuntai;2;2;4;0;0;0
293;10.06.2018;2018;06;08;Sunnuntai;7;0;7;0;0;0
293;10.06.2018;2018;06;09;Sunnuntai;4;10;14;0;0;0
293;10.06.2018;2018;06;10;Sunnuntai;3;8;11;1;4;5
293;10.06.2018;2018;06;11;Sunnuntai;14;10;24;4;1;5
293;10.06.2018;2018;06;12;Sunnuntai;24;11;35;7;1;8
293;10.06.2018;2018;06;13;Sunnuntai;25;24;49;8;6;14
293;10.06.2018;2018;06;14;Sunnuntai;30;31;61;12;7;19
293;10.06.2018;2018;06;15;Sunnuntai;28;21;49;2;0;2
293;10.06.2018;2018;06;16;Sunnuntai;14;24;38;9;5;14
293;10.06.2018;2018;06;17;Sunnuntai;32;25;57;5;2;7
293;10.06.2018;2018;06;18;Sunnuntai;21;27;48;1;4;5
293;10.06.2018;2018;06;19;Sunnuntai;21;18;39;3;5;8
293;10.06.2018;2018;06;20;Sunnuntai;19;30;49;4;4;8
293;10.06.2018;2018;06;21;Sunnuntai;12;22;34;2;1;3
293;10.06.2018;2018;06;22;Sunnuntai;5;3;8;0;1;1
293;10.06.2018;2018;06;23;Sunnuntai;4;2;6;0;1;1
293;11.06.2018;2018;06;00;Maanantai;0;0;0;1;0;1
293;11.06.2018;2018;06;01;Maanantai;0;0;0;0;1;1
293;11.06.2018;2018;06;02;Maanantai;0;1;1;0;0;0
293;11.06.2018;2018;06;03;Maanantai;0;0;0;0;0;0
293;11.06.2018;2018;06;04;Maanantai;0;0;0;0;0;0
293;11.06.2018;2018;06;05;Maanantai;4;0;4;0;0;0
293;11.06.2018;2018;06;06;Maanantai;17;2;19;1;0;1
293;11.06.2018;2018;06;07;Maanantai;16;8;24;1;1;2
293;11.06.2018;2018;06;08;Maanantai;33;26;59;7;1;8
293;11.06.2018;2018;06;09;Maanantai;28;11;39;0;4;4
293;11.06.2018;2018;06;10;Maanantai;12;16;28;2;0;2
293;11.06.2018;2018;06;11;Maanantai;17;18;35;9;4;13
293;11.06.2018;2018;06;12;Maanantai;26;20;46;2;4;6
293;11.06.2018;2018;06;13;Maanantai;28;28;56;1;2;3
293;11.06.2018;2018;06;14;Maanantai;28;48;76;10;4;14
293;11.06.2018;2018;06;15;Maanantai;40;46;86;10;9;19
293;11.06.2018;2018;06;16;Maanantai;40;45;85;6;4;10
293;11.06.2018;2018;06;17;Maanantai;33;30;63;7;5;12
293;11.06.2018;2018;06;18;Maanantai;33;48;81;5;6;11
293;11.06.2018;2018;06;19;Maanantai;36;42;78;5;4;9
293;11.06.2018;2018;06;20;Maanantai;17;37;54;8;5;13
293;11.06.2018;2018;06;21;Maanantai;8;21;29;3;2;5
293;11.06.2018;2018;06;22;Maanantai;13;7;20;0;0;0
293;11.06.2018;2018;06;23;Maanantai;2;2;4;0;1;1
293;12.06.2018;2018;06;00;Tiistai;5;0;5;1;0;1
293;12.06.2018;2018;06;01;Tiistai;1;0;1;0;1;1
293;12.06.2018;2018;06;02;Tiistai;0;0;0;0;0;0
293;12.06.2018;2018;06;03;Tiistai;0;0;0;0;0;0
293;12.06.2018;2018;06;04;Tiistai;1;1;2;0;0;0
293;12.06.2018;2018;06;05;Tiistai;1;0;1;0;0;0
293;12.06.2018;2018;06;06;Tiistai;19;5;24;0;0;0
293;12.06.2018;2018;06;07;Tiistai;25;12;37;1;0;1
293;12.06.2018;2018;06;08;Tiistai;17;18;35;5;1;6
293;12.06.2018;2018;06;09;Tiistai;26;6;32;0;2;2
293;12.06.2018;2018;06;10;Tiistai;15;9;24;0;1;1
293;12.06.2018;2018;06;11;Tiistai;21;17;38;4;2;6
293;12.06.2018;2018;06;12;Tiistai;20;24;44;4;2;6
293;12.06.2018;2018;06;13;Tiistai;29;23;52;0;1;1
293;12.06.2018;2018;06;14;Tiistai;35;27;62;4;3;7
293;12.06.2018;2018;06;15;Tiistai;22;37;59;4;1;5
293;12.06.2018;2018;06;16;Tiistai;32;48;80;5;9;14
293;12.06.2018;2018;06;17;Tiistai;32;32;64;4;5;9
293;12.06.2018;2018;06;18;Tiistai;41;33;74;6;4;10
293;12.06.2018;2018;06;19;Tiistai;19;26;45;6;9;15
293;12.06.2018;2018;06;20;Tiistai;16;32;48;7;10;17
293;12.06.2018;2018;06;21;Tiistai;5;17;22;1;4;5
293;12.06.2018;2018;06;22;Tiistai;7;6;13;2;1;3
293;12.06.2018;2018;06;23;Tiistai;3;3;6;0;1;1
293;13.06.2018;2018;06;00;Keskiviikko;4;3;7;0;0;0
293;13.06.2018;2018;06;01;Keskiviikko;0;0;0;0;0;0
293;13.06.2018;2018;06;02;Keskiviikko;0;1;1;0;0;0
293;13.06.2018;2018;06;03;Keskiviikko;0;0;0;0;0;0
293;13.06.2018;2018;06;04;Keskiviikko;0;0;0;0;0;0
293;13.06.2018;2018;06;05;Keskiviikko;3;0;3;0;0;0
293;13.06.2018;2018;06;06;Keskiviikko;11;2;13;0;0;0
293;13.06.2018;2018;06;07;Keskiviikko;20;6;26;1;0;1
293;13.06.2018;2018;06;08;Keskiviikko;25;14;39;2;2;4
293;13.06.2018;2018;06;09;Keskiviikko;23;6;29;3;0;3
293;13.06.2018;2018;06;10;Keskiviikko;12;13;25;2;6;8
293;13.06.2018;2018;06;11;Keskiviikko;16;13;29;4;3;7
293;13.06.2018;2018;06;12;Keskiviikko;31;18;49;1;2;3
293;13.06.2018;2018;06;13;Keskiviikko;21;15;36;1;0;1
293;13.06.2018;2018;06;14;Keskiviikko;29;29;58;3;1;4
293;13.06.2018;2018;06;15;Keskiviikko;24;47;71;5;5;10
293;13.06.2018;2018;06;16;Keskiviikko;28;24;52;4;1;5
293;13.06.2018;2018;06;17;Keskiviikko;17;34;51;5;5;10
293;13.06.2018;2018;06;18;Keskiviikko;39;32;71;4;7;11
293;13.06.2018;2018;06;19;Keskiviikko;15;27;42;7;9;16
293;13.06.2018;2018;06;20;Keskiviikko;6;17;23;7;9;16
293;13.06.2018;2018;06;21;Keskiviikko;2;17;19;0;2;2
293;13.06.2018;2018;06;22;Keskiviikko;5;4;9;1;1;2
293;13.06.2018;2018;06;23;Keskiviikko;0;1;1;1;2;3
293;14.06.2018;2018;06;00;Torstai;0;0;0;0;0;0
293;14.06.2018;2018;06;01;Torstai;2;0;2;0;0;0
293;14.06.2018;2018;06;02;Torstai;0;0;0;0;0;0
293;14.06.2018;2018;06;03;Torstai;0;2;2;0;0;0
293;14.06.2018;2018;06;04;Torstai;1;0;1;0;0;0
293;14.06.2018;2018;06;05;Torstai;2;0;2;0;0;0
293;14.06.2018;2018;06;06;Torstai;17;5;22;0;0;0
293;14.06.2018;2018;06;07;Torstai;16;5;21;2;0;2
293;14.06.2018;2018;06;08;Torstai;26;13;39;5;1;6
293;14.06.2018;2018;06;09;Torstai;18;6;24;4;1;5
293;14.06.2018;2018;06;10;Torstai;28;9;37;0;2;2
293;14.06.2018;2018;06;11;Torstai;18;22;40;4;2;6
293;14.06.2018;2018;06;12;Torstai;13;20;33;2;5;7
293;14.06.2018;2018;06;13;Torstai;32;22;54;1;3;4
293;14.06.2018;2018;06;14;Torstai;27;39;66;5;4;9
293;14.06.2018;2018;06;15;Torstai;32;63;95;8;7;15
293;14.06.2018;2018;06;16;Torstai;41;45;86;7;3;10
293;14.06.2018;2018;06;17;Torstai;45;30;75;12;8;20
293;14.06.2018;2018;06;18;Torstai;31;31;62;9;9;18
293;14.06.2018;2018;06;19;Torstai;18;35;53;6;7;13
293;14.06.2018;2018;06;20;Torstai;20;28;48;2;5;7
293;14.06.2018;2018;06;21;Torstai;12;29;41;2;3;5
293;14.06.2018;2018;06;22;Torstai;6;10;16;1;0;1
293;14.06.2018;2018;06;23;Torstai;6;3;9;0;0;0
293;15.06.2018;2018;06;00;Perjantai;0;1;1;0;0;0
293;15.06.2018;2018;06;01;Perjantai;2;0;2;1;0;1
293;15.06.2018;2018;06;02;Perjantai;2;0;2;0;0;0
293;15.06.2018;2018;06;03;Perjantai;0;0;0;0;0;0
293;15.06.2018;2018;06;04;Perjantai;0;1;1;0;0;0
293;15.06.2018;2018;06;05;Perjantai;2;2;4;0;0;0
293;15.06.2018;2018;06;06;Perjantai;11;5;16;1;0;1
293;15.06.2018;2018;06;07;Perjantai;13;3;16;3;0;3
293;15.06.2018;2018;06;08;Perjantai;20;13;33;2;2;4
293;15.06.2018;2018;06;09;Perjantai;20;8;28;2;1;3
293;15.06.2018;2018;06;10;Perjantai;13;8;21;6;4;10
293;15.06.2018;2018;06;11;Perjantai;24;17;41;5;1;6
293;15.06.2018;2018;06;12;Perjantai;25;20;45;5;2;7
293;15.06.2018;2018;06;13;Perjantai;28;24;52;10;5;15
293;15.06.2018;2018;06;14;Perjantai;24;35;59;2;4;6
293;15.06.2018;2018;06;15;Perjantai;23;38;61;4;5;9
293;15.06.2018;2018;06;16;Perjantai;21;22;43;3;3;6
293;15.06.2018;2018;06;17;Perjantai;24;18;42;8;8;16
293;15.06.2018;2018;06;18;Perjantai;21;40;61;9;1;10
293;15.06.2018;2018;06;19;Perjantai;11;21;32;5;7;12
293;15.06.2018;2018;06;20;Perjantai;12;21;33;6;10;16
293;15.06.2018;2018;06;21;Perjantai;14;19;33;3;6;9
293;15.06.2018;2018;06;22;Perjantai;6;6;12;2;0;2
293;15.06.2018;2018;06;23;Perjantai;15;12;27;0;0;0
293;16.06.2018;2018;06;00;Lauantai;1;2;3;0;0;0
293;16.06.2018;2018;06;01;Lauantai;2;2;4;1;1;2
293;16.06.2018;2018;06;02;Lauantai;0;1;1;0;2;2
293;16.06.2018;2018;06;03;Lauantai;0;2;2;0;0;0
293;16.06.2018;2018;06;04;Lauantai;0;2;2;0;2;2
293;16.06.2018;2018;06;05;Lauantai;0;0;0;0;0;0
293;16.06.2018;2018;06;06;Lauantai;4;1;5;1;0;1
293;16.06.2018;2018;06;07;Lauantai;7;4;11;1;0;1
293;16.06.2018;2018;06;08;Lauantai;7;4;11;2;0;2
293;16.06.2018;2018;06;09;Lauantai;11;14;25;1;2;3
293;16.06.2018;2018;06;10;Lauantai;22;25;47;3;0;3
293;16.06.2018;2018;06;11;Lauantai;23;23;46;3;3;6
293;16.06.2018;2018;06;12;Lauantai;20;20;40;4;5;9
293;16.06.2018;2018;06;13;Lauantai;26;27;53;5;3;8
293;16.06.2018;2018;06;14;Lauantai;35;33;68;6;1;7
293;16.06.2018;2018;06;15;Lauantai;27;27;54;5;5;10
293;16.06.2018;2018;06;16;Lauantai;27;31;58;6;4;10
293;16.06.2018;2018;06;17;Lauantai;25;22;47;5;2;7
293;16.06.2018;2018;06;18;Lauantai;40;30;70;4;4;8
293;16.06.2018;2018;06;19;Lauantai;22;30;52;8;1;9
293;16.06.2018;2018;06;20;Lauantai;18;22;40;5;4;9
293;16.06.2018;2018;06;21;Lauantai;10;24;34;1;3;4
293;16.06.2018;2018;06;22;Lauantai;18;13;31;5;2;7
293;16.06.2018;2018;06;23;Lauantai;11;5;16;1;3;4
293;17.06.2018;2018;06;00;Sunnuntai;3;1;4;6;0;6
293;17.06.2018;2018;06;01;Sunnuntai;3;3;6;0;2;2
293;17.06.2018;2018;06;02;Sunnuntai;2;6;8;0;1;1
293;17.06.2018;2018;06;03;Sunnuntai;0;2;2;0;4;4
293;17.06.2018;2018;06;04;Sunnuntai;0;4;4;0;2;2
293;17.06.2018;2018;06;05;Sunnuntai;0;3;3;0;0;0
293;17.06.2018;2018;06;06;Sunnuntai;4;3;7;0;0;0
293;17.06.2018;2018;06;07;Sunnuntai;4;1;5;0;0;0
293;17.06.2018;2018;06;08;Sunnuntai;7;6;13;7;4;11
293;17.06.2018;2018;06;09;Sunnuntai;13;11;24;4;3;7
293;17.06.2018;2018;06;10;Sunnuntai;22;16;38;4;1;5
293;17.06.2018;2018;06;11;Sunnuntai;25;21;46;5;3;8
293;17.06.2018;2018;06;12;Sunnuntai;36;31;67;4;5;9
293;17.06.2018;2018;06;13;Sunnuntai;38;43;81;8;8;16
293;17.06.2018;2018;06;14;Sunnuntai;31;16;47;9;5;14
293;17.06.2018;2018;06;15;Sunnuntai;30;56;86;6;11;17
293;17.06.2018;2018;06;16;Sunnuntai;38;45;83;10;4;14
293;17.06.2018;2018;06;17;Sunnuntai;64;27;91;9;1;10
293;17.06.2018;2018;06;18;Sunnuntai;39;57;96;9;14;23
293;17.06.2018;2018;06;19;Sunnuntai;46;37;83;12;10;22
293;17.06.2018;2018;06;20;Sunnuntai;26;28;54;10;6;16
293;17.06.2018;2018;06;21;Sunnuntai;18;26;44;0;3;3
293;17.06.2018;2018;06;22;Sunnuntai;14;16;30;3;3;6
293;17.06.2018;2018;06;23;Sunnuntai;2;0;2;1;0;1
293;18.06.2018;2018;06;00;Maanantai;0;0;0;0;0;0
293;18.06.2018;2018;06;01;Maanantai;1;0;1;0;0;0
293;18.06.2018;2018;06;02;Maanantai;0;0;0;0;1;1
293;18.06.2018;2018;06;03;Maanantai;0;0;0;0;0;0
293;18.06.2018;2018;06;04;Maanantai;0;0;0;0;0;0
293;18.06.2018;2018;06;05;Maanantai;0;0;0;0;0;0
293;18.06.2018;2018;06;06;Maanantai;15;1;16;0;0;0
293;18.06.2018;2018;06;07;Maanantai;18;7;25;0;0;0
293;18.06.2018;2018;06;08;Maanantai;14;13;27;1;0;1
293;18.06.2018;2018;06;09;Maanantai;15;6;21;3;0;3
293;18.06.2018;2018;06;10;Maanantai;6;10;16;1;3;4
293;18.06.2018;2018;06;11;Maanantai;16;6;22;0;1;1
293;18.06.2018;2018;06;12;Maanantai;14;16;30;2;2;4
293;18.06.2018;2018;06;13;Maanantai;18;18;36;5;2;7
293;18.06.2018;2018;06;14;Maanantai;25;34;59;3;3;6
293;18.06.2018;2018;06;15;Maanantai;29;38;67;4;4;8
293;18.06.2018;2018;06;16;Maanantai;31;38;69;7;7;14
293;18.06.2018;2018;06;17;Maanantai;24;9;33;2;5;7
293;18.06.2018;2018;06;18;Maanantai;13;18;31;10;6;16
293;18.06.2018;2018;06;19;Maanantai;19;24;43;5;6;11
293;18.06.2018;2018;06;20;Maanantai;28;26;54;5;9;14
293;18.06.2018;2018;06;21;Maanantai;8;11;19;1;1;2
293;18.06.2018;2018;06;22;Maanantai;2;7;9;2;2;4
293;18.06.2018;2018;06;23;Maanantai;5;6;11;0;1;1
293;19.06.2018;2018;06;00;Tiistai;3;1;4;0;0;0
293;19.06.2018;2018;06;01;Tiistai;1;0;1;0;0;0
293;19.06.2018;2018;06;02;Tiistai;0;0;0;0;0;0
293;19.06.2018;2018;06;03;Tiistai;0;0;0;0;0;0
293;19.06.2018;2018;06;04;Tiistai;0;0;0;0;0;0
293;19.06.2018;2018;06;05;Tiistai;3;0;3;0;0;0
293;19.06.2018;2018;06;06;Tiistai;12;2;14;0;0;0
293;19.06.2018;2018;06;07;Tiistai;11;0;11;1;1;2
293;19.06.2018;2018;06;08;Tiistai;15;13;28;2;0;2
293;19.06.2018;2018;06;09;Tiistai;12;11;23;2;2;4
293;19.06.2018;2018;06;10;Tiistai;11;11;22;2;3;5
293;19.06.2018;2018;06;11;Tiistai;18;11;29;4;2;6
293;19.06.2018;2018;06;12;Tiistai;4;9;13;0;2;2
293;19.06.2018;2018;06;13;Tiistai;10;9;19;0;0;0
293;19.06.2018;2018;06;14;Tiistai;5;9;14;0;2;2
293;19.06.2018;2018;06;15;Tiistai;7;16;23;4;2;6
293;19.06.2018;2018;06;16;Tiistai;3;5;8;2;0;2
293;19.06.2018;2018;06;17;Tiistai;10;6;16;3;4;7
293;19.06.2018;2018;06;18;Tiistai;13;11;24;3;2;5
293;19.06.2018;2018;06;19;Tiistai;10;10;20;4;3;7
293;19.06.2018;2018;06;20;Tiistai;8;7;15;3;6;9
293;19.06.2018;2018;06;21;Tiistai;9;13;22;0;3;3
293;19.06.2018;2018;06;22;Tiistai;0;3;3;1;0;1
293;19.06.2018;2018;06;23;Tiistai;1;3;4;0;1;1
293;20.06.2018;2018;06;00;Keskiviikko;0;0;0;0;1;1
293;20.06.2018;2018;06;01;Keskiviikko;0;1;1;0;0;0
293;20.06.2018;2018;06;02;Keskiviikko;0;1;1;0;0;0
293;20.06.2018;2018;06;03;Keskiviikko;0;0;0;0;0;0
293;20.06.2018;2018;06;04;Keskiviikko;0;0;0;0;0;0
293;20.06.2018;2018;06;05;Keskiviikko;2;0;2;0;0;0
293;20.06.2018;2018;06;06;Keskiviikko;13;1;14;0;0;0
293;20.06.2018;2018;06;07;Keskiviikko;14;2;16;1;0;1
293;20.06.2018;2018;06;08;Keskiviikko;14;16;30;4;1;5
293;20.06.2018;2018;06;09;Keskiviikko;22;5;27;8;0;8
293;20.06.2018;2018;06;10;Keskiviikko;13;18;31;6;2;8
293;20.06.2018;2018;06;11;Keskiviikko;17;20;37;5;6;11
293;20.06.2018;2018;06;12;Keskiviikko;28;21;49;2;2;4
293;20.06.2018;2018;06;13;Keskiviikko;20;34;54;3;3;6
293;20.06.2018;2018;06;14;Keskiviikko;26;24;50;8;2;10
293;20.06.2018;2018;06;15;Keskiviikko;25;38;63;5;2;7
293;20.06.2018;2018;06;16;Keskiviikko;39;41;80;3;3;6
293;20.06.2018;2018;06;17;Keskiviikko;39;40;79;2;8;10
293;20.06.2018;2018;06;18;Keskiviikko;24;24;48;3;6;9
293;20.06.2018;2018;06;19;Keskiviikko;16;36;52;8;4;12
293;20.06.2018;2018;06;20;Keskiviikko;20;27;47;2;3;5
293;20.06.2018;2018;06;21;Keskiviikko;20;11;31;4;8;12
293;20.06.2018;2018;06;22;Keskiviikko;2;10;12;4;1;5
293;20.06.2018;2018;06;23;Keskiviikko;2;1;3;1;0;1
293;21.06.2018;2018;06;00;Torstai;0;3;3;0;1;1
293;21.06.2018;2018;06;01;Torstai;5;5;10;0;1;1
293;21.06.2018;2018;06;02;Torstai;1;0;1;1;0;1
293;21.06.2018;2018;06;03;Torstai;0;0;0;0;0;0
293;21.06.2018;2018;06;04;Torstai;1;0;1;0;0;0
293;21.06.2018;2018;06;05;Torstai;2;0;2;0;0;0
293;21.06.2018;2018;06;06;Torstai;12;4;16;2;0;2
293;21.06.2018;2018;06;07;Torstai;18;2;20;1;1;2
293;21.06.2018;2018;06;08;Torstai;12;13;25;5;0;5
293;21.06.2018;2018;06;09;Torstai;15;11;26;0;1;1
293;21.06.2018;2018;06;10;Torstai;15;14;29;3;1;4
293;21.06.2018;2018;06;11;Torstai;21;15;36;3;5;8
293;21.06.2018;2018;06;12;Torstai;27;20;47;8;5;13
293;21.06.2018;2018;06;13;Torstai;26;33;59;3;5;8
293;21.06.2018;2018;06;14;Torstai;26;37;63;4;4;8
293;21.06.2018;2018;06;15;Torstai;28;37;65;4;4;8
293;21.06.2018;2018;06;16;Torstai;25;39;64;5;3;8
293;21.06.2018;2018;06;17;Torstai;29;25;54;5;8;13
293;21.06.2018;2018;06;18;Torstai;23;21;44;12;3;15
293;21.06.2018;2018;06;19;Torstai;21;22;43;7;1;8
293;21.06.2018;2018;06;20;Torstai;14;21;35;4;4;8
293;21.06.2018;2018;06;21;Torstai;10;24;34;3;5;8
293;21.06.2018;2018;06;22;Torstai;11;14;25;2;4;6
293;21.06.2018;2018;06;23;Torstai;4;2;6;0;0;0
293;22.06.2018;2018;06;00;Perjantai;3;6;9;1;1;2
293;22.06.2018;2018;06;01;Perjantai;2;2;4;0;0;0
293;22.06.2018;2018;06;02;Perjantai;0;1;1;0;0;0
293;22.06.2018;2018;06;03;Perjantai;0;0;0;0;0;0
293;22.06.2018;2018;06;04;Perjantai;0;0;0;2;0;2
293;22.06.2018;2018;06;05;Perjantai;2;2;4;0;0;0
293;22.06.2018;2018;06;06;Perjantai;1;2;3;0;1;1
293;22.06.2018;2018;06;07;Perjantai;3;0;3;0;1;1
293;22.06.2018;2018;06;08;Perjantai;2;2;4;3;0;3
293;22.06.2018;2018;06;09;Perjantai;1;1;2;1;0;1
293;22.06.2018;2018;06;10;Perjantai;1;1;2;1;0;1
293;22.06.2018;2018;06;11;Perjantai;4;2;6;2;2;4
293;22.06.2018;2018;06;12;Perjantai;0;5;5;0;0;0
293;22.06.2018;2018;06;13;Perjantai;2;0;2;0;0;0
293;22.06.2018;2018;06;14;Perjantai;4;3;7;2;3;5
293;22.06.2018;2018;06;15;Perjantai;1;2;3;4;2;6
293;22.06.2018;2018;06;16;Perjantai;2;1;3;2;5;7
293;22.06.2018;2018;06;17;Perjantai;1;7;8;1;0;1
293;22.06.2018;2018;06;18;Perjantai;3;8;11;1;0;1
293;22.06.2018;2018;06;19;Perjantai;7;12;19;1;7;8
293;22.06.2018;2018;06;20;Perjantai;6;6;12;3;0;3
293;22.06.2018;2018;06;21;Perjantai;8;3;11;1;1;2
293;22.06.2018;2018;06;22;Perjantai;3;2;5;1;1;2
293;22.06.2018;2018;06;23;Perjantai;1;3;4;3;0;3
293;23.06.2018;2018;06;00;Lauantai;0;1;1;0;2;2
293;23.06.2018;2018;06;01;Lauantai;0;5;5;1;4;5
293;23.06.2018;2018;06;02;Lauantai;1;0;1;1;3;4
293;23.06.2018;2018;06;03;Lauantai;0;0;0;2;2;4
293;23.06.2018;2018;06;04;Lauantai;0;2;2;2;1;3
293;23.06.2018;2018;06;05;Lauantai;2;0;2;0;0;0
293;23.06.2018;2018;06;06;Lauantai;1;2;3;0;0;0
293;23.06.2018;2018;06;07;Lauantai;2;1;3;1;0;1
293;23.06.2018;2018;06;08;Lauantai;4;3;7;2;3;5
293;23.06.2018;2018;06;09;Lauantai;2;4;6;1;0;1
293;23.06.2018;2018;06;10;Lauantai;14;5;19;7;3;10
293;23.06.2018;2018;06;11;Lauantai;13;15;28;1;3;4
293;23.06.2018;2018;06;12;Lauantai;20;8;28;5;2;7
293;23.06.2018;2018;06;13;Lauantai;16;17;33;3;3;6
293;23.06.2018;2018;06;14;Lauantai;15;26;41;5;1;6
293;23.06.2018;2018;06;15;Lauantai;9;9;18;1;3;4
293;23.06.2018;2018;06;16;Lauantai;9;10;19;1;4;5
293;23.06.2018;2018;06;17;Lauantai;12;17;29;4;5;9
293;23.06.2018;2018;06;18;Lauantai;5;9;14;0;2;2
293;23.06.2018;2018;06;19;Lauantai;11;5;16;1;2;3
293;23.06.2018;2018;06;20;Lauantai;16;14;30;1;3;4
293;23.06.2018;2018;06;21;Lauantai;3;7;10;3;2;5
293;23.06.2018;2018;06;22;Lauantai;4;1;5;1;0;1
293;23.06.2018;2018;06;23;Lauantai;6;5;11;0;1;1
293;24.06.2018;2018;06;00;Sunnuntai;2;1;3;0;1;1
293;24.06.2018;2018;06;01;Sunnuntai;1;1;2;1;0;1
293;24.06.2018;2018;06;02;Sunnuntai;1;0;1;0;0;0
293;24.06.2018;2018;06;03;Sunnuntai;1;7;8;0;0;0
293;24.06.2018;2018;06;04;Sunnuntai;6;3;9;1;2;3
293;24.06.2018;2018;06;05;Sunnuntai;0;1;1;0;0;0
293;24.06.2018;2018;06;06;Sunnuntai;2;0;2;0;0;0
293;24.06.2018;2018;06;07;Sunnuntai;0;0;0;0;0;0
293;24.06.2018;2018;06;08;Sunnuntai;5;3;8;3;1;4
293;24.06.2018;2018;06;09;Sunnuntai;13;9;22;7;2;9
293;24.06.2018;2018;06;10;Sunnuntai;17;14;31;3;8;11
293;24.06.2018;2018;06;11;Sunnuntai;28;28;56;5;8;13
293;24.06.2018;2018;06;12;Sunnuntai;31;32;63;8;5;13
293;24.06.2018;2018;06;13;Sunnuntai;32;16;48;5;2;7
293;24.06.2018;2018;06;14;Sunnuntai;40;33;73;3;3;6
293;24.06.2018;2018;06;15;Sunnuntai;30;28;58;5;4;9
293;24.06.2018;2018;06;16;Sunnuntai;34;32;66;10;7;17
293;24.06.2018;2018;06;17;Sunnuntai;32;22;54;6;7;13
293;24.06.2018;2018;06;18;Sunnuntai;39;34;73;9;5;14
293;24.06.2018;2018;06;19;Sunnuntai;40;39;79;10;6;16
293;24.06.2018;2018;06;20;Sunnuntai;22;24;46;2;3;5
293;24.06.2018;2018;06;21;Sunnuntai;17;19;36;4;3;7
293;24.06.2018;2018;06;22;Sunnuntai;8;10;18;1;5;6
293;24.06.2018;2018;06;23;Sunnuntai;9;3;12;0;1;1
293;25.06.2018;2018;06;00;Maanantai;1;4;5;0;0;0
293;25.06.2018;2018;06;01;Maanantai;2;2;4;0;0;0
293;25.06.2018;2018;06;02;Maanantai;0;0;0;0;0;0
293;25.06.2018;2018;06;03;Maanantai;0;0;0;0;0;0
293;25.06.2018;2018;06;04;Maanantai;1;0;1;0;0;0
293;25.06.2018;2018;06;05;Maanantai;2;0;2;1;0;1
293;25.06.2018;2018;06;06;Maanantai;15;1;16;1;0;1
293;25.06.2018;2018;06;07;Maanantai;14;7;21;0;0;0
293;25.06.2018;2018;06;08;Maanantai;18;17;35;3;0;3
293;25.06.2018;2018;06;09;Maanantai;37;20;57;6;2;8
293;25.06.2018;2018;06;10;Maanantai;22;30;52;2;3;5
293;25.06.2018;2018;06;11;Maanantai;25;27;52;4;1;5
293;25.06.2018;2018;06;12;Maanantai;33;27;60;4;3;7
293;25.06.2018;2018;06;13;Maanantai;45;42;87;4;5;9
293;25.06.2018;2018;06;14;Maanantai;38;39;77;7;3;10
293;25.06.2018;2018;06;15;Maanantai;38;57;95;4;6;10
293;25.06.2018;2018;06;16;Maanantai;62;59;121;9;13;22
293;25.06.2018;2018;06;17;Maanantai;41;56;97;4;5;9
293;25.06.2018;2018;06;18;Maanantai;50;59;109;9;8;17
293;25.06.2018;2018;06;19;Maanantai;45;48;93;7;6;13
293;25.06.2018;2018;06;20;Maanantai;22;41;63;5;10;15
293;25.06.2018;2018;06;21;Maanantai;17;17;34;1;0;1
293;25.06.2018;2018;06;22;Maanantai;10;15;25;2;3;5
293;25.06.2018;2018;06;23;Maanantai;0;0;0;0;0;0
293;26.06.2018;2018;06;00;Tiistai;1;5;6;0;1;1
293;26.06.2018;2018;06;01;Tiistai;0;0;0;0;0;0
293;26.06.2018;2018;06;02;Tiistai;0;0;0;0;0;0
293;26.06.2018;2018;06;03;Tiistai;0;1;1;0;0;0
293;26.06.2018;2018;06;04;Tiistai;1;1;2;0;0;0
293;26.06.2018;2018;06;05;Tiistai;2;1;3;0;1;1
293;26.06.2018;2018;06;06;Tiistai;18;4;22;0;0;0
293;26.06.2018;2018;06;07;Tiistai;14;1;15;1;0;1
293;26.06.2018;2018;06;08;Tiistai;15;22;37;1;2;3
293;26.06.2018;2018;06;09;Tiistai;12;9;21;0;2;2
293;26.06.2018;2018;06;10;Tiistai;29;16;45;4;2;6
293;26.06.2018;2018;06;11;Tiistai;15;20;35;5;4;9
293;26.06.2018;2018;06;12;Tiistai;36;22;58;4;3;7
293;26.06.2018;2018;06;13;Tiistai;38;35;73;8;4;12
293;26.06.2018;2018;06;14;Tiistai;34;33;67;3;4;7
293;26.06.2018;2018;06;15;Tiistai;28;34;62;4;2;6
293;26.06.2018;2018;06;16;Tiistai;24;46;70;4;4;8
293;26.06.2018;2018;06;17;Tiistai;36;33;69;4;7;11
293;26.06.2018;2018;06;18;Tiistai;41;31;72;5;5;10
293;26.06.2018;2018;06;19;Tiistai;26;43;69;9;8;17
293;26.06.2018;2018;06;20;Tiistai;26;18;44;1;3;4
293;26.06.2018;2018;06;21;Tiistai;12;13;25;5;4;9
293;26.06.2018;2018;06;22;Tiistai;3;15;18;2;3;5
293;26.06.2018;2018;06;23;Tiistai;0;4;4;4;2;6
293;27.06.2018;2018;06;00;Keskiviikko;3;2;5;2;0;2
293;27.06.2018;2018;06;01;Keskiviikko;2;0;2;0;0;0
293;27.06.2018;2018;06;02;Keskiviikko;0;0;0;0;0;0
293;27.06.2018;2018;06;03;Keskiviikko;0;1;1;0;0;0
293;27.06.2018;2018;06;04;Keskiviikko;1;0;1;0;0;0
293;27.06.2018;2018;06;05;Keskiviikko;1;2;3;0;0;0
293;27.06.2018;2018;06;06;Keskiviikko;21;1;22;1;0;1
293;27.06.2018;2018;06;07;Keskiviikko;17;3;20;1;0;1
293;27.06.2018;2018;06;08;Keskiviikko;13;17;30;0;1;1
293;27.06.2018;2018;06;09;Keskiviikko;21;4;25;5;5;10
293;27.06.2018;2018;06;10;Keskiviikko;17;27;44;3;2;5
293;27.06.2018;2018;06;11;Keskiviikko;17;28;45;0;3;3
293;27.06.2018;2018;06;12;Keskiviikko;20;21;41;8;1;9
293;27.06.2018;2018;06;13;Keskiviikko;23;24;47;4;5;9
293;27.06.2018;2018;06;14;Keskiviikko;23;20;43;3;1;4
293;27.06.2018;2018;06;15;Keskiviikko;39;38;77;5;6;11
293;27.06.2018;2018;06;16;Keskiviikko;28;33;61;3;3;6
293;27.06.2018;2018;06;17;Keskiviikko;20;24;44;10;10;20
293;27.06.2018;2018;06;18;Keskiviikko;23;17;40;6;2;8
293;27.06.2018;2018;06;19;Keskiviikko;22;28;50;7;10;17
293;27.06.2018;2018;06;20;Keskiviikko;22;27;49;3;2;5
293;27.06.2018;2018;06;21;Keskiviikko;16;23;39;4;2;6
293;27.06.2018;2018;06;22;Keskiviikko;7;14;21;2;2;4
293;27.06.2018;2018;06;23;Keskiviikko;2;1;3;0;1;1
293;28.06.2018;2018;06;00;Torstai;1;3;4;0;0;0
293;28.06.2018;2018;06;01;Torstai;1;0;1;0;0;0
293;28.06.2018;2018;06;02;Torstai;0;1;1;0;0;0
293;28.06.2018;2018;06;03;Torstai;0;1;1;0;0;0
293;28.06.2018;2018;06;04;Torstai;1;0;1;0;0;0
293;28.06.2018;2018;06;05;Torstai;1;1;2;0;0;0
293;28.06.2018;2018;06;06;Torstai;11;1;12;0;0;0
293;28.06.2018;2018;06;07;Torstai;12;3;15;1;1;2
293;28.06.2018;2018;06;08;Torstai;9;12;21;0;1;1
293;28.06.2018;2018;06;09;Torstai;11;3;14;2;2;4
293;28.06.2018;2018;06;10;Torstai;1;2;3;0;1;1
293;28.06.2018;2018;06;11;Torstai;2;3;5;2;1;3
293;28.06.2018;2018;06;12;Torstai;4;3;7;3;1;4
293;28.06.2018;2018;06;13;Torstai;3;8;11;2;2;4
293;28.06.2018;2018;06;14;Torstai;3;8;11;2;2;4
293;28.06.2018;2018;06;15;Torstai;12;17;29;4;1;5
293;28.06.2018;2018;06;16;Torstai;3;9;12;6;6;12
293;28.06.2018;2018;06;17;Torstai;7;6;13;0;4;4
293;28.06.2018;2018;06;18;Torstai;12;14;26;2;1;3
293;28.06.2018;2018;06;19;Torstai;9;3;12;6;2;8
293;28.06.2018;2018;06;20;Torstai;4;6;10;1;6;7
293;28.06.2018;2018;06;21;Torstai;3;6;9;0;2;2
293;28.06.2018;2018;06;22;Torstai;2;4;6;2;1;3
293;28.06.2018;2018;06;23;Torstai;0;1;1;3;0;3
293;29.06.2018;2018;06;00;Perjantai;0;5;5;0;0;0
293;29.06.2018;2018;06;01;Perjantai;2;3;5;0;0;0
293;29.06.2018;2018;06;02;Perjantai;6;1;7;0;0;0
293;29.06.2018;2018;06;03;Perjantai;0;1;1;0;0;0
293;29.06.2018;2018;06;04;Perjantai;0;0;0;0;0;0
293;29.06.2018;2018;06;05;Perjantai;1;0;1;0;1;1
293;29.06.2018;2018;06;06;Perjantai;7;2;9;1;1;2
293;29.06.2018;2018;06;07;Perjantai;14;4;18;0;0;0
293;29.06.2018;2018;06;08;Perjantai;10;14;24;1;3;4
293;29.06.2018;2018;06;09;Perjantai;12;8;20;5;1;6
293;29.06.2018;2018;06;10;Perjantai;11;13;24;2;3;5
293;29.06.2018;2018;06;11;Perjantai;10;12;22;0;2;2
293;29.06.2018;2018;06;12;Perjantai;22;12;34;2;2;4
293;29.06.2018;2018;06;13;Perjantai;14;14;28;5;6;11
293;29.06.2018;2018;06;14;Perjantai;18;24;42;2;0;2
293;29.06.2018;2018;06;15;Perjantai;23;18;41;3;2;5
293;29.06.2018;2018;06;16;Perjantai;12;22;34;3;2;5
293;29.06.2018;2018;06;17;Perjantai;18;13;31;2;0;2
293;29.06.2018;2018;06;18;Perjantai;17;14;31;2;3;5
293;29.06.2018;2018;06;19;Perjantai;9;23;32;4;2;6
293;29.06.2018;2018;06;20;Perjantai;25;19;44;3;1;4
293;29.06.2018;2018;06;21;Perjantai;8;10;18;3;0;3
293;29.06.2018;2018;06;22;Perjantai;12;10;22;1;2;3
293;29.06.2018;2018;06;23;Perjantai;7;3;10;1;2;3
293;30.06.2018;2018;06;00;Lauantai;1;7;8;0;2;2
293;30.06.2018;2018;06;01;Lauantai;1;10;11;0;4;4
293;30.06.2018;2018;06;02;Lauantai;3;4;7;0;3;3
293;30.06.2018;2018;06;03;Lauantai;2;3;5;1;1;2
293;30.06.2018;2018;06;04;Lauantai;1;1;2;0;0;0
293;30.06.2018;2018;06;05;Lauantai;0;1;1;0;0;0
293;30.06.2018;2018;06;06;Lauantai;1;0;1;0;0;0
293;30.06.2018;2018;06;07;Lauantai;3;2;5;1;0;1
293;30.06.2018;2018;06;08;Lauantai;4;6;10;4;2;6
293;30.06.2018;2018;06;09;Lauantai;13;9;22;7;6;13
293;30.06.2018;2018;06;10;Lauantai;9;12;21;6;2;8
293;30.06.2018;2018;06;11;Lauantai;13;18;31;1;5;6
293;30.06.2018;2018;06;12;Lauantai;15;10;25;3;1;4
293;30.06.2018;2018;06;13;Lauantai;29;13;42;7;5;12
293;30.06.2018;2018;06;14;Lauantai;18;18;36;6;2;8
293;30.06.2018;2018;06;15;Lauantai;14;23;37;1;5;6
293;30.06.2018;2018;06;16;Lauantai;26;28;54;7;3;10
293;30.06.2018;2018;06;17;Lauantai;22;20;42;4;4;8
293;30.06.2018;2018;06;18;Lauantai;18;16;34;2;2;4
293;30.06.2018;2018;06;19;Lauantai;23;6;29;2;2;4
293;30.06.2018;2018;06;20;Lauantai;9;18;27;2;2;4
293;30.06.2018;2018;06;21;Lauantai;10;12;22;4;1;5
293;30.06.2018;2018;06;22;Lauantai;14;8;22;0;2;2
293;30.06.2018;2018;06;23;Lauantai;4;6;10;3;0;3
293;01.07.2018;2018;07;00;Sunnuntai;2;5;7;0;1;1
293;01.07.2018;2018;07;01;Sunnuntai;1;3;4;0;1;1
293;01.07.2018;2018;07;02;Sunnuntai;0;6;6;3;0;3
293;01.07.2018;2018;07;03;Sunnuntai;1;2;3;1;1;2
293;01.07.2018;2018;07;04;Sunnuntai;1;1;2;0;0;0
293;01.07.2018;2018;07;05;Sunnuntai;0;0;0;0;1;1
293;01.07.2018;2018;07;06;Sunnuntai;2;0;2;2;0;2
293;01.07.2018;2018;07;07;Sunnuntai;1;1;2;2;3;5
293;01.07.2018;2018;07;08;Sunnuntai;4;4;8;2;3;5
293;01.07.2018;2018;07;09;Sunnuntai;20;8;28;6;2;8
293;01.07.2018;2018;07;10;Sunnuntai;26;12;38;2;6;8
293;01.07.2018;2018;07;11;Sunnuntai;13;20;33;10;6;16
293;01.07.2018;2018;07;12;Sunnuntai;59;37;96;14;7;21
293;01.07.2018;2018;07;13;Sunnuntai;40;35;75;9;4;13
293;01.07.2018;2018;07;14;Sunnuntai;28;42;70;14;3;17
293;01.07.2018;2018;07;15;Sunnuntai;22;42;64;3;9;12
293;01.07.2018;2018;07;16;Sunnuntai;17;29;46;6;5;11
293;01.07.2018;2018;07;17;Sunnuntai;26;28;54;3;5;8
293;01.07.2018;2018;07;18;Sunnuntai;33;35;68;6;2;8
293;01.07.2018;2018;07;19;Sunnuntai;28;32;60;4;6;10
293;01.07.2018;2018;07;20;Sunnuntai;33;30;63;4;4;8
293;01.07.2018;2018;07;21;Sunnuntai;20;24;44;1;2;3
293;01.07.2018;2018;07;22;Sunnuntai;5;10;15;1;1;2
293;01.07.2018;2018;07;23;Sunnuntai;6;1;7;2;0;2
293;02.07.2018;2018;07;00;Maanantai;2;2;4;0;1;1
293;02.07.2018;2018;07;01;Maanantai;1;2;3;0;0;0
293;02.07.2018;2018;07;02;Maanantai;3;1;4;0;0;0
293;02.07.2018;2018;07;03;Maanantai;0;0;0;0;0;0
293;02.07.2018;2018;07;04;Maanantai;1;0;1;0;0;0
293;02.07.2018;2018;07;05;Maanantai;3;0;3;0;0;0
293;02.07.2018;2018;07;06;Maanantai;17;1;18;1;1;2
293;02.07.2018;2018;07;07;Maanantai;12;3;15;2;0;2
293;02.07.2018;2018;07;08;Maanantai;12;4;16;1;1;2
293;02.07.2018;2018;07;09;Maanantai;15;11;26;2;2;4
293;02.07.2018;2018;07;10;Maanantai;17;9;26;3;6;9
293;02.07.2018;2018;07;11;Maanantai;26;24;50;6;4;10
293;02.07.2018;2018;07;12;Maanantai;20;27;47;5;6;11
293;02.07.2018;2018;07;13;Maanantai;44;40;84;2;4;6
293;02.07.2018;2018;07;14;Maanantai;33;28;61;4;5;9
293;02.07.2018;2018;07;15;Maanantai;17;47;64;5;3;8
293;02.07.2018;2018;07;16;Maanantai;48;39;87;6;4;10
293;02.07.2018;2018;07;17;Maanantai;51;56;107;2;3;5
293;02.07.2018;2018;07;18;Maanantai;54;47;101;8;3;11
293;02.07.2018;2018;07;19;Maanantai;55;61;116;11;7;18
293;02.07.2018;2018;07;20;Maanantai;36;44;80;9;11;20
293;02.07.2018;2018;07;21;Maanantai;21;24;45;7;4;11
293;02.07.2018;2018;07;22;Maanantai;20;7;27;4;2;6
293;02.07.2018;2018;07;23;Maanantai;2;7;9;0;1;1
293;03.07.2018;2018;07;00;Tiistai;1;3;4;1;0;1
293;03.07.2018;2018;07;01;Tiistai;6;0;6;0;0;0
293;03.07.2018;2018;07;02;Tiistai;0;2;2;1;0;1
293;03.07.2018;2018;07;03;Tiistai;0;0;0;0;2;2
293;03.07.2018;2018;07;04;Tiistai;0;0;0;0;0;0
293;03.07.2018;2018;07;05;Tiistai;4;1;5;0;1;1
293;03.07.2018;2018;07;06;Tiistai;13;2;15;1;1;2
293;03.07.2018;2018;07;07;Tiistai;12;3;15;3;1;4
293;03.07.2018;2018;07;08;Tiistai;17;7;24;1;0;1
293;03.07.2018;2018;07;09;Tiistai;25;10;35;2;4;6
293;03.07.2018;2018;07;10;Tiistai;14;29;43;4;2;6
293;03.07.2018;2018;07;11;Tiistai;24;20;44;4;3;7
293;03.07.2018;2018;07;12;Tiistai;26;17;43;4;1;5
293;03.07.2018;2018;07;13;Tiistai;22;16;38;3;1;4
293;03.07.2018;2018;07;14;Tiistai;17;32;49;3;5;8
293;03.07.2018;2018;07;15;Tiistai;25;33;58;4;2;6
293;03.07.2018;2018;07;16;Tiistai;21;27;48;2;2;4
293;03.07.2018;2018;07;17;Tiistai;21;29;50;4;2;6
293;03.07.2018;2018;07;18;Tiistai;25;29;54;7;5;12
293;03.07.2018;2018;07;19;Tiistai;34;28;62;7;3;10
293;03.07.2018;2018;07;20;Tiistai;21;29;50;5;8;13
293;03.07.2018;2018;07;21;Tiistai;16;19;35;3;2;5
293;03.07.2018;2018;07;22;Tiistai;7;7;14;0;2;2
293;03.07.2018;2018;07;23;Tiistai;3;2;5;0;0;0
293;04.07.2018;2018;07;00;Keskiviikko;2;4;6;1;1;2
293;04.07.2018;2018;07;01;Keskiviikko;0;2;2;0;0;0
293;04.07.2018;2018;07;02;Keskiviikko;0;0;0;0;0;0
293;04.07.2018;2018;07;03;Keskiviikko;0;0;0;0;0;0
293;04.07.2018;2018;07;04;Keskiviikko;0;0;0;0;0;0
293;04.07.2018;2018;07;05;Keskiviikko;2;0;2;0;0;0
293;04.07.2018;2018;07;06;Keskiviikko;2;2;4;0;0;0
293;04.07.2018;2018;07;07;Keskiviikko;3;3;6;0;0;0
293;04.07.2018;2018;07;08;Keskiviikko;4;2;6;0;1;1
293;04.07.2018;2018;07;09;Keskiviikko;7;2;9;1;1;2
293;04.07.2018;2018;07;10;Keskiviikko;3;3;6;0;3;3
293;04.07.2018;2018;07;11;Keskiviikko;5;6;11;1;1;2
293;04.07.2018;2018;07;12;Keskiviikko;5;3;8;4;0;4
293;04.07.2018;2018;07;13;Keskiviikko;6;3;9;3;3;6
293;04.07.2018;2018;07;14;Keskiviikko;7;10;17;1;3;4
293;04.07.2018;2018;07;15;Keskiviikko;12;13;25;0;0;0
293;04.07.2018;2018;07;16;Keskiviikko;13;13;26;6;4;10
293;04.07.2018;2018;07;17;Keskiviikko;28;40;68;3;6;9
293;04.07.2018;2018;07;18;Keskiviikko;31;30;61;4;4;8
293;04.07.2018;2018;07;19;Keskiviikko;39;29;68;9;8;17
293;04.07.2018;2018;07;20;Keskiviikko;41;25;66;2;5;7
293;04.07.2018;2018;07;21;Keskiviikko;14;35;49;2;1;3
293;04.07.2018;2018;07;22;Keskiviikko;12;12;24;0;4;4
293;04.07.2018;2018;07;23;Keskiviikko;8;3;11;3;3;6
293;05.07.2018;2018;07;00;Torstai;1;0;1;0;0;0
293;05.07.2018;2018;07;01;Torstai;1;3;4;0;1;1
293;05.07.2018;2018;07;02;Torstai;0;0;0;0;0;0
293;05.07.2018;2018;07;03;Torstai;0;0;0;0;0;0
293;05.07.2018;2018;07;04;Torstai;2;0;2;0;0;0
293;05.07.2018;2018;07;05;Torstai;5;0;5;0;0;0
293;05.07.2018;2018;07;06;Torstai;14;2;16;2;0;2
293;05.07.2018;2018;07;07;Torstai;10;6;16;3;1;4
293;05.07.2018;2018;07;08;Torstai;13;3;16;5;1;6
293;05.07.2018;2018;07;09;Torstai;18;11;29;4;6;10
293;05.07.2018;2018;07;10;Torstai;18;22;40;1;4;5
293;05.07.2018;2018;07;11;Torstai;24;32;56;4;6;10
293;05.07.2018;2018;07;12;Torstai;40;31;71;44;24;68
293;05.07.2018;2018;07;13;Torstai;28;36;64;5;6;11
293;05.07.2018;2018;07;14;Torstai;26;45;71;10;5;15
293;05.07.2018;2018;07;15;Torstai;30;38;68;8;1;9
293;05.07.2018;2018;07;16;Torstai;19;24;43;5;4;9
293;05.07.2018;2018;07;17;Torstai;32;30;62;10;8;18
293;05.07.2018;2018;07;18;Torstai;24;9;33;3;5;8
293;05.07.2018;2018;07;19;Torstai;35;16;51;4;3;7
293;05.07.2018;2018;07;20;Torstai;17;32;49;3;1;4
293;05.07.2018;2018;07;21;Torstai;9;17;26;1;2;3
293;05.07.2018;2018;07;22;Torstai;0;9;9;1;3;4
293;05.07.2018;2018;07;23;Torstai;7;1;8;2;0;2
293;06.07.2018;2018;07;00;Perjantai;0;1;1;0;1;1
293;06.07.2018;2018;07;01;Perjantai;1;3;4;0;0;0
293;06.07.2018;2018;07;02;Perjantai;2;0;2;0;0;0
293;06.07.2018;2018;07;03;Perjantai;0;0;0;0;0;0
293;06.07.2018;2018;07;04;Perjantai;0;0;0;0;0;0
293;06.07.2018;2018;07;05;Perjantai;0;1;1;0;0;0
293;06.07.2018;2018;07;06;Perjantai;8;1;9;2;0;2
293;06.07.2018;2018;07;07;Perjantai;12;6;18;2;0;2
293;06.07.2018;2018;07;08;Perjantai;20;5;25;4;2;6
293;06.07.2018;2018;07;09;Perjantai;18;12;30;2;2;4
293;06.07.2018;2018;07;10;Perjantai;25;18;43;7;2;9
293;06.07.2018;2018;07;11;Perjantai;19;21;40;4;2;6
293;06.07.2018;2018;07;12;Perjantai;29;15;44;5;4;9
293;06.07.2018;2018;07;13;Perjantai;27;38;65;1;5;6
293;06.07.2018;2018;07;14;Perjantai;21;38;59;3;2;5
293;06.07.2018;2018;07;15;Perjantai;35;27;62;8;1;9
293;06.07.2018;2018;07;16;Perjantai;42;53;95;10;6;16
293;06.07.2018;2018;07;17;Perjantai;37;38;75;7;5;12
293;06.07.2018;2018;07;18;Perjantai;27;50;77;3;5;8
293;06.07.2018;2018;07;19;Perjantai;40;48;88;6;6;12
293;06.07.2018;2018;07;20;Perjantai;34;35;69;2;3;5
293;06.07.2018;2018;07;21;Perjantai;16;31;47;11;3;14
293;06.07.2018;2018;07;22;Perjantai;24;8;32;5;1;6
293;06.07.2018;2018;07;23;Perjantai;9;7;16;1;1;2
293;07.07.2018;2018;07;00;Lauantai;4;4;8;2;1;3
293;07.07.2018;2018;07;01;Lauantai;2;2;4;0;0;0
293;07.07.2018;2018;07;02;Lauantai;1;2;3;0;0;0
293;07.07.2018;2018;07;03;Lauantai;0;6;6;0;0;0
293;07.07.2018;2018;07;04;Lauantai;3;3;6;0;1;1
293;07.07.2018;2018;07;05;Lauantai;0;1;1;0;0;0
293;07.07.2018;2018;07;06;Lauantai;1;1;2;0;0;0
293;07.07.2018;2018;07;07;Lauantai;0;1;1;1;0;1
293;07.07.2018;2018;07;08;Lauantai;9;2;11;1;0;1
293;07.07.2018;2018;07;09;Lauantai;14;15;29;6;2;8
293;07.07.2018;2018;07;10;Lauantai;21;20;41;4;2;6
293;07.07.2018;2018;07;11;Lauantai;26;27;53;7;4;11
293;07.07.2018;2018;07;12;Lauantai;35;30;65;3;6;9
293;07.07.2018;2018;07;13;Lauantai;25;29;54;15;2;17
293;07.07.2018;2018;07;14;Lauantai;21;20;41;12;5;17
293;07.07.2018;2018;07;15;Lauantai;26;34;60;4;7;11
293;07.07.2018;2018;07;16;Lauantai;27;25;52;3;1;4
293;07.07.2018;2018;07;17;Lauantai;42;31;73;3;3;6
293;07.07.2018;2018;07;18;Lauantai;26;26;52;1;1;2
293;07.07.2018;2018;07;19;Lauantai;30;23;53;3;5;8
293;07.07.2018;2018;07;20;Lauantai;19;24;43;5;3;8
293;07.07.2018;2018;07;21;Lauantai;24;20;44;3;4;7
293;07.07.2018;2018;07;22;Lauantai;19;10;29;0;4;4
293;07.07.2018;2018;07;23;Lauantai;5;7;12;0;0;0
293;08.07.2018;2018;07;00;Sunnuntai;8;3;11;1;2;3
293;08.07.2018;2018;07;01;Sunnuntai;5;12;17;1;2;3
293;08.07.2018;2018;07;02;Sunnuntai;1;4;5;0;2;2
293;08.07.2018;2018;07;03;Sunnuntai;2;1;3;0;1;1
293;08.07.2018;2018;07;04;Sunnuntai;1;3;4;0;1;1
293;08.07.2018;2018;07;05;Sunnuntai;0;1;1;0;0;0
293;08.07.2018;2018;07;06;Sunnuntai;4;0;4;1;0;1
293;08.07.2018;2018;07;07;Sunnuntai;2;2;4;1;0;1
293;08.07.2018;2018;07;08;Sunnuntai;2;4;6;1;1;2
293;08.07.2018;2018;07;09;Sunnuntai;16;8;24;3;1;4
293;08.07.2018;2018;07;10;Sunnuntai;13;20;33;3;4;7
293;08.07.2018;2018;07;11;Sunnuntai;18;37;55;4;3;7
293;08.07.2018;2018;07;12;Sunnuntai;32;44;76;5;5;10
293;08.07.2018;2018;07;13;Sunnuntai;36;36;72;7;5;12
293;08.07.2018;2018;07;14;Sunnuntai;31;24;55;10;5;15
293;08.07.2018;2018;07;15;Sunnuntai;47;30;77;5;10;15
293;08.07.2018;2018;07;16;Sunnuntai;39;36;75;2;2;4
293;08.07.2018;2018;07;17;Sunnuntai;45;41;86;2;4;6
293;08.07.2018;2018;07;18;Sunnuntai;41;47;88;4;3;7
293;08.07.2018;2018;07;19;Sunnuntai;38;49;87;10;2;12
293;08.07.2018;2018;07;20;Sunnuntai;46;46;92;6;8;14
293;08.07.2018;2018;07;21;Sunnuntai;24;28;52;4;2;6
293;08.07.2018;2018;07;22;Sunnuntai;6;15;21;0;0;0
293;08.07.2018;2018;07;23;Sunnuntai;4;1;5;1;0;1
293;09.07.2018;2018;07;00;Maanantai;1;2;3;0;1;1
293;09.07.2018;2018;07;01;Maanantai;1;4;5;3;1;4
293;09.07.2018;2018;07;02;Maanantai;0;0;0;0;0;0
293;09.07.2018;2018;07;03;Maanantai;0;1;1;0;0;0
293;09.07.2018;2018;07;04;Maanantai;0;0;0;1;2;3
293;09.07.2018;2018;07;05;Maanantai;1;0;1;0;0;0
293;09.07.2018;2018;07;06;Maanantai;9;3;12;2;1;3
293;09.07.2018;2018;07;07;Maanantai;13;2;15;1;1;2
293;09.07.2018;2018;07;08;Maanantai;19;12;31;3;0;3
293;09.07.2018;2018;07;09;Maanantai;23;28;51;3;3;6
293;09.07.2018;2018;07;10;Maanantai;32;28;60;9;5;14
293;09.07.2018;2018;07;11;Maanantai;30;37;67;4;1;5
293;09.07.2018;2018;07;12;Maanantai;47;30;77;7;9;16
293;09.07.2018;2018;07;13;Maanantai;36;47;83;9;3;12
293;09.07.2018;2018;07;14;Maanantai;33;45;78;5;3;8
293;09.07.2018;2018;07;15;Maanantai;47;51;98;4;9;13
293;09.07.2018;2018;07;16;Maanantai;37;41;78;7;7;14
293;09.07.2018;2018;07;17;Maanantai;48;40;88;5;9;14
293;09.07.2018;2018;07;18;Maanantai;50;54;104;9;11;20
293;09.07.2018;2018;07;19;Maanantai;47;56;103;10;5;15
293;09.07.2018;2018;07;20;Maanantai;46;41;87;5;12;17
293;09.07.2018;2018;07;21;Maanantai;16;21;37;4;2;6
293;09.07.2018;2018;07;22;Maanantai;11;10;21;0;1;1
293;09.07.2018;2018;07;23;Maanantai;1;6;7;0;0;0
293;10.07.2018;2018;07;00;Tiistai;2;0;2;0;0;0
293;10.07.2018;2018;07;01;Tiistai;0;1;1;0;1;1
293;10.07.2018;2018;07;02;Tiistai;1;0;1;0;0;0
293;10.07.2018;2018;07;03;Tiistai;0;2;2;0;0;0
293;10.07.2018;2018;07;04;Tiistai;0;0;0;0;0;0
293;10.07.2018;2018;07;05;Tiistai;5;1;6;0;0;0
293;10.07.2018;2018;07;06;Tiistai;11;2;13;3;0;3
293;10.07.2018;2018;07;07;Tiistai;13;4;17;2;3;5
293;10.07.2018;2018;07;08;Tiistai;23;9;32;3;3;6
293;10.07.2018;2018;07;09;Tiistai;23;12;35;4;2;6
293;10.07.2018;2018;07;10;Tiistai;26;22;48;6;2;8
293;10.07.2018;2018;07;11;Tiistai;30;29;59;5;5;10
293;10.07.2018;2018;07;12;Tiistai;21;39;60;3;3;6
293;10.07.2018;2018;07;13;Tiistai;38;35;73;6;9;15
293;10.07.2018;2018;07;14;Tiistai;35;50;85;5;5;10
293;10.07.2018;2018;07;15;Tiistai;42;43;85;10;3;13
293;10.07.2018;2018;07;16;Tiistai;37;58;95;7;4;11
293;10.07.2018;2018;07;17;Tiistai;38;32;70;8;7;15
293;10.07.2018;2018;07;18;Tiistai;46;44;90;10;10;20
293;10.07.2018;2018;07;19;Tiistai;38;42;80;14;4;18
293;10.07.2018;2018;07;20;Tiistai;39;49;88;6;8;14
293;10.07.2018;2018;07;21;Tiistai;20;23;43;7;4;11
293;10.07.2018;2018;07;22;Tiistai;16;8;24;4;0;4
293;10.07.2018;2018;07;23;Tiistai;4;10;14;1;2;3
293;11.07.2018;2018;07;00;Keskiviikko;1;2;3;2;1;3
293;11.07.2018;2018;07;01;Keskiviikko;0;0;0;1;3;4
293;11.07.2018;2018;07;02;Keskiviikko;1;2;3;3;2;5
293;11.07.2018;2018;07;03;Keskiviikko;0;0;0;0;0;0
293;11.07.2018;2018;07;04;Keskiviikko;0;0;0;0;0;0
293;11.07.2018;2018;07;05;Keskiviikko;2;1;3;0;0;0
293;11.07.2018;2018;07;06;Keskiviikko;12;2;14;1;1;2
293;11.07.2018;2018;07;07;Keskiviikko;15;5;20;2;1;3
293;11.07.2018;2018;07;08;Keskiviikko;20;10;30;1;1;2
293;11.07.2018;2018;07;09;Keskiviikko;22;16;38;3;1;4
293;11.07.2018;2018;07;10;Keskiviikko;31;30;61;8;2;10
293;11.07.2018;2018;07;11;Keskiviikko;31;27;58;6;10;16
293;11.07.2018;2018;07;12;Keskiviikko;34;36;70;7;1;8
293;11.07.2018;2018;07;13;Keskiviikko;33;39;72;6;3;9
293;11.07.2018;2018;07;14;Keskiviikko;38;36;74;7;8;15
293;11.07.2018;2018;07;15;Keskiviikko;50;51;101;13;9;22
293;11.07.2018;2018;07;16;Keskiviikko;40;39;79;12;5;17
293;11.07.2018;2018;07;17;Keskiviikko;40;63;103;6;2;8
293;11.07.2018;2018;07;18;Keskiviikko;78;84;162;8;6;14
293;11.07.2018;2018;07;19;Keskiviikko;45;40;85;8;10;18
293;11.07.2018;2018;07;20;Keskiviikko;49;45;94;14;11;25
293;11.07.2018;2018;07;21;Keskiviikko;35;27;62;5;9;14
293;11.07.2018;2018;07;22;Keskiviikko;11;19;30;1;0;1
293;11.07.2018;2018;07;23;Keskiviikko;18;10;28;0;2;2
293;12.07.2018;2018;07;00;Torstai;3;1;4;1;1;2
293;12.07.2018;2018;07;01;Torstai;1;1;2;0;0;0
293;12.07.2018;2018;07;02;Torstai;0;1;1;0;2;2
293;12.07.2018;2018;07;03;Torstai;1;1;2;0;0;0
293;12.07.2018;2018;07;04;Torstai;0;0;0;0;0;0
293;12.07.2018;2018;07;05;Torstai;1;1;2;1;0;1
293;12.07.2018;2018;07;06;Torstai;12;1;13;4;0;4
293;12.07.2018;2018;07;07;Torstai;10;3;13;0;1;1
293;12.07.2018;2018;07;08;Torstai;20;8;28;4;4;8
293;12.07.2018;2018;07;09;Torstai;20;20;40;2;3;5
293;12.07.2018;2018;07;10;Torstai;19;28;47;3;1;4
293;12.07.2018;2018;07;11;Torstai;27;27;54;4;2;6
293;12.07.2018;2018;07;12;Torstai;40;35;75;6;3;9
293;12.07.2018;2018;07;13;Torstai;48;30;78;7;4;11
293;12.07.2018;2018;07;14;Torstai;30;37;67;1;3;4
293;12.07.2018;2018;07;15;Torstai;25;42;67;9;5;14
293;12.07.2018;2018;07;16;Torstai;52;55;107;4;0;4
293;12.07.2018;2018;07;17;Torstai;48;56;104;3;3;6
293;12.07.2018;2018;07;18;Torstai;59;40;99;5;16;21
293;12.07.2018;2018;07;19;Torstai;50;56;106;14;8;22
293;12.07.2018;2018;07;20;Torstai;49;33;82;14;6;20
293;12.07.2018;2018;07;21;Torstai;16;22;38;0;4;4
293;12.07.2018;2018;07;22;Torstai;6;30;36;3;3;6
293;12.07.2018;2018;07;23;Torstai;12;4;16;2;3;5
293;13.07.2018;2018;07;00;Perjantai;8;2;10;0;0;0
293;13.07.2018;2018;07;01;Perjantai;3;3;6;0;0;0
293;13.07.2018;2018;07;02;Perjantai;2;3;5;0;0;0
293;13.07.2018;2018;07;03;Perjantai;0;0;0;0;0;0
293;13.07.2018;2018;07;04;Perjantai;1;0;1;0;0;0
293;13.07.2018;2018;07;05;Perjantai;1;0;1;1;1;2
293;13.07.2018;2018;07;06;Perjantai;8;4;12;1;1;2
293;13.07.2018;2018;07;07;Perjantai;15;3;18;3;0;3
293;13.07.2018;2018;07;08;Perjantai;15;12;27;4;5;9
293;13.07.2018;2018;07;09;Perjantai;16;14;30;2;2;4
293;13.07.2018;2018;07;10;Perjantai;22;22;44;2;3;5
293;13.07.2018;2018;07;11;Perjantai;26;28;54;1;4;5
293;13.07.2018;2018;07;12;Perjantai;27;24;51;4;0;4
293;13.07.2018;2018;07;13;Perjantai;49;38;87;2;2;4
293;13.07.2018;2018;07;14;Perjantai;36;49;85;7;3;10
293;13.07.2018;2018;07;15;Perjantai;23;44;67;7;4;11
293;13.07.2018;2018;07;16;Perjantai;40;39;79;6;7;13
293;13.07.2018;2018;07;17;Perjantai;38;42;80;1;4;5
293;13.07.2018;2018;07;18;Perjantai;49;25;74;8;4;12
293;13.07.2018;2018;07;19;Perjantai;39;38;77;4;4;8
293;13.07.2018;2018;07;20;Perjantai;25;41;66;7;4;11
293;13.07.2018;2018;07;21;Perjantai;29;11;40;2;4;6
293;13.07.2018;2018;07;22;Perjantai;12;17;29;2;5;7
293;13.07.2018;2018;07;23;Perjantai;13;14;27;5;5;10
293;14.07.2018;2018;07;00;Lauantai;6;10;16;5;0;5
293;14.07.2018;2018;07;01;Lauantai;1;1;2;0;1;1
293;14.07.2018;2018;07;02;Lauantai;0;2;2;0;0;0
293;14.07.2018;2018;07;03;Lauantai;1;5;6;2;1;3
293;14.07.2018;2018;07;04;Lauantai;2;3;5;1;2;3
293;14.07.2018;2018;07;05;Lauantai;2;1;3;0;1;1
293;14.07.2018;2018;07;06;Lauantai;0;0;0;0;0;0
293;14.07.2018;2018;07;07;Lauantai;4;0;4;1;0;1
293;14.07.2018;2018;07;08;Lauantai;6;3;9;2;1;3
293;14.07.2018;2018;07;09;Lauantai;7;7;14;1;1;2
293;14.07.2018;2018;07;10;Lauantai;17;10;27;2;3;5
293;14.07.2018;2018;07;11;Lauantai;25;28;53;6;1;7
293;14.07.2018;2018;07;12;Lauantai;14;13;27;2;2;4
293;14.07.2018;2018;07;13;Lauantai;10;15;25;3;2;5
293;14.07.2018;2018;07;14;Lauantai;17;23;40;1;1;2
293;14.07.2018;2018;07;15;Lauantai;19;21;40;4;6;10
293;14.07.2018;2018;07;16;Lauantai;32;31;63;2;3;5
293;14.07.2018;2018;07;17;Lauantai;38;36;74;9;9;18
293;14.07.2018;2018;07;18;Lauantai;30;50;80;5;8;13
293;14.07.2018;2018;07;19;Lauantai;36;24;60;8;3;11
293;14.07.2018;2018;07;20;Lauantai;25;18;43;8;2;10
293;14.07.2018;2018;07;21;Lauantai;20;8;28;2;2;4
293;14.07.2018;2018;07;22;Lauantai;11;9;20;0;3;3
293;14.07.2018;2018;07;23;Lauantai;10;11;21;4;3;7
293;15.07.2018;2018;07;00;Sunnuntai;8;6;14;2;4;6
293;15.07.2018;2018;07;01;Sunnuntai;4;9;13;1;3;4
293;15.07.2018;2018;07;02;Sunnuntai;7;7;14;1;0;1
293;15.07.2018;2018;07;03;Sunnuntai;1;4;5;0;3;3
293;15.07.2018;2018;07;04;Sunnuntai;0;2;2;4;2;6
293;15.07.2018;2018;07;05;Sunnuntai;2;2;4;1;0;1
293;15.07.2018;2018;07;06;Sunnuntai;2;1;3;0;0;0
293;15.07.2018;2018;07;07;Sunnuntai;3;5;8;0;0;0
293;15.07.2018;2018;07;08;Sunnuntai;13;8;21;2;3;5
293;15.07.2018;2018;07;09;Sunnuntai;13;14;27;6;2;8
293;15.07.2018;2018;07;10;Sunnuntai;27;22;49;4;3;7
293;15.07.2018;2018;07;11;Sunnuntai;25;19;44;9;4;13
293;15.07.2018;2018;07;12;Sunnuntai;26;30;56;5;4;9
293;15.07.2018;2018;07;13;Sunnuntai;34;51;85;9;7;16
293;15.07.2018;2018;07;14;Sunnuntai;45;30;75;5;4;9
293;15.07.2018;2018;07;15;Sunnuntai;50;47;97;10;3;13
293;15.07.2018;2018;07;16;Sunnuntai;30;36;66;5;3;8
293;15.07.2018;2018;07;17;Sunnuntai;40;51;91;12;4;16
293;15.07.2018;2018;07;18;Sunnuntai;43;27;70;12;3;15
293;15.07.2018;2018;07;19;Sunnuntai;30;29;59;6;4;10
293;15.07.2018;2018;07;20;Sunnuntai;36;42;78;4;10;14
293;15.07.2018;2018;07;21;Sunnuntai;27;27;54;2;2;4
293;15.07.2018;2018;07;22;Sunnuntai;23;19;42;6;3;9
293;15.07.2018;2018;07;23;Sunnuntai;10;0;10;1;1;2
293;16.07.2018;2018;07;00;Maanantai;4;2;6;1;1;2
293;16.07.2018;2018;07;01;Maanantai;0;0;0;0;0;0
293;16.07.2018;2018;07;02;Maanantai;0;0;0;1;1;2
293;16.07.2018;2018;07;03;Maanantai;2;2;4;1;1;2
293;16.07.2018;2018;07;04;Maanantai;1;0;1;0;0;0
293;16.07.2018;2018;07;05;Maanantai;3;0;3;0;1;1
293;16.07.2018;2018;07;06;Maanantai;10;3;13;0;0;0
293;16.07.2018;2018;07;07;Maanantai;16;4;20;4;0;4
293;16.07.2018;2018;07;08;Maanantai;12;14;26;2;1;3
293;16.07.2018;2018;07;09;Maanantai;23;12;35;0;2;2
293;16.07.2018;2018;07;10;Maanantai;23;30;53;5;2;7
293;16.07.2018;2018;07;11;Maanantai;26;24;50;7;5;12
293;16.07.2018;2018;07;12;Maanantai;32;33;65;6;2;8
293;16.07.2018;2018;07;13;Maanantai;40;41;81;11;4;15
293;16.07.2018;2018;07;14;Maanantai;38;46;84;9;4;13
293;16.07.2018;2018;07;15;Maanantai;45;36;81;8;8;16
293;16.07.2018;2018;07;16;Maanantai;42;75;117;6;3;9
293;16.07.2018;2018;07;17;Maanantai;47;48;95;3;4;7
293;16.07.2018;2018;07;18;Maanantai;58;45;103;4;4;8
293;16.07.2018;2018;07;19;Maanantai;62;51;113;15;3;18
293;16.07.2018;2018;07;20;Maanantai;46;58;104;5;5;10
293;16.07.2018;2018;07;21;Maanantai;34;20;54;2;11;13
293;16.07.2018;2018;07;22;Maanantai;9;10;19;6;8;14
293;16.07.2018;2018;07;23;Maanantai;6;4;10;8;2;10
293;17.07.2018;2018;07;00;Tiistai;6;8;14;0;3;3
293;17.07.2018;2018;07;01;Tiistai;1;0;1;2;1;3
293;17.07.2018;2018;07;02;Tiistai;0;1;1;0;0;0
293;17.07.2018;2018;07;03;Tiistai;0;1;1;0;0;0
293;17.07.2018;2018;07;04;Tiistai;1;0;1;0;0;0
293;17.07.2018;2018;07;05;Tiistai;2;0;2;0;0;0
293;17.07.2018;2018;07;06;Tiistai;11;3;14;3;2;5
293;17.07.2018;2018;07;07;Tiistai;17;1;18;4;1;5
293;17.07.2018;2018;07;08;Tiistai;20;17;37;3;1;4
293;17.07.2018;2018;07;09;Tiistai;26;19;45;3;3;6
293;17.07.2018;2018;07;10;Tiistai;29;20;49;5;6;11
293;17.07.2018;2018;07;11;Tiistai;22;43;65;12;5;17
293;17.07.2018;2018;07;12;Tiistai;36;47;83;5;3;8
293;17.07.2018;2018;07;13;Tiistai;33;36;69;2;2;4
293;17.07.2018;2018;07;14;Tiistai;46;50;96;6;4;10
293;17.07.2018;2018;07;15;Tiistai;34;31;65;3;3;6
293;17.07.2018;2018;07;16;Tiistai;32;60;92;6;7;13
293;17.07.2018;2018;07;17;Tiistai;47;35;82;18;5;23
293;17.07.2018;2018;07;18;Tiistai;28;42;70;7;9;16
293;17.07.2018;2018;07;19;Tiistai;50;46;96;14;4;18
293;17.07.2018;2018;07;20;Tiistai;41;37;78;11;6;17
293;17.07.2018;2018;07;21;Tiistai;33;29;62;3;9;12
293;17.07.2018;2018;07;22;Tiistai;21;8;29;4;3;7
293;17.07.2018;2018;07;23;Tiistai;8;8;16;6;3;9
293;18.07.2018;2018;07;00;Keskiviikko;4;9;13;3;2;5
293;18.07.2018;2018;07;01;Keskiviikko;1;0;1;0;2;2
293;18.07.2018;2018;07;02;Keskiviikko;0;0;0;0;1;1
293;18.07.2018;2018;07;03;Keskiviikko;0;0;0;0;0;0
293;18.07.2018;2018;07;04;Keskiviikko;2;2;4;0;0;0
293;18.07.2018;2018;07;05;Keskiviikko;1;0;1;0;0;0
293;18.07.2018;2018;07;06;Keskiviikko;14;5;19;1;0;1
293;18.07.2018;2018;07;07;Keskiviikko;11;7;18;2;0;2
293;18.07.2018;2018;07;08;Keskiviikko;20;9;29;3;2;5
293;18.07.2018;2018;07;09;Keskiviikko;24;15;39;6;0;6
293;18.07.2018;2018;07;10;Keskiviikko;18;20;38;4;3;7
293;18.07.2018;2018;07;11;Keskiviikko;30;30;60;7;9;16
293;18.07.2018;2018;07;12;Keskiviikko;21;32;53;5;3;8
293;18.07.2018;2018;07;13;Keskiviikko;48;36;84;6;3;9
293;18.07.2018;2018;07;14;Keskiviikko;41;54;95;3;5;8
293;18.07.2018;2018;07;15;Keskiviikko;46;49;95;3;7;10
293;18.07.2018;2018;07;16;Keskiviikko;52;44;96;10;9;19
293;18.07.2018;2018;07;17;Keskiviikko;36;38;74;2;4;6
293;18.07.2018;2018;07;18;Keskiviikko;23;53;76;4;2;6
293;18.07.2018;2018;07;19;Keskiviikko;47;43;90;20;5;25
293;18.07.2018;2018;07;20;Keskiviikko;31;37;68;4;5;9
293;18.07.2018;2018;07;21;Keskiviikko;26;22;48;14;5;19
293;18.07.2018;2018;07;22;Keskiviikko;17;13;30;0;1;1
293;18.07.2018;2018;07;23;Keskiviikko;8;7;15;2;3;5
293;19.07.2018;2018;07;00;Torstai;10;5;15;1;1;2
293;19.07.2018;2018;07;01;Torstai;3;4;7;4;1;5
293;19.07.2018;2018;07;02;Torstai;2;3;5;3;3;6
293;19.07.2018;2018;07;03;Torstai;0;0;0;0;1;1
293;19.07.2018;2018;07;04;Torstai;1;0;1;0;0;0
293;19.07.2018;2018;07;05;Torstai;2;0;2;0;1;1
293;19.07.2018;2018;07;06;Torstai;8;2;10;1;1;2
293;19.07.2018;2018;07;07;Torstai;18;5;23;1;1;2
293;19.07.2018;2018;07;08;Torstai;17;12;29;2;2;4
293;19.07.2018;2018;07;09;Torstai;33;17;50;4;3;7
293;19.07.2018;2018;07;10;Torstai;28;35;63;4;5;9
293;19.07.2018;2018;07;11;Torstai;27;20;47;5;1;6
293;19.07.2018;2018;07;12;Torstai;18;36;54;2;2;4
293;19.07.2018;2018;07;13;Torstai;23;26;49;3;3;6
293;19.07.2018;2018;07;14;Torstai;35;30;65;6;1;7
293;19.07.2018;2018;07;15;Torstai;25;53;78;5;2;7
293;19.07.2018;2018;07;16;Torstai;37;38;75;6;5;11
293;19.07.2018;2018;07;17;Torstai;40;47;87;9;6;15
293;19.07.2018;2018;07;18;Torstai;55;52;107;16;4;20
293;19.07.2018;2018;07;19;Torstai;55;59;114;16;11;27
293;19.07.2018;2018;07;20;Torstai;54;44;98;6;2;8
293;19.07.2018;2018;07;21;Torstai;48;31;79;2;7;9
293;19.07.2018;2018;07;22;Torstai;8;16;24;6;3;9
293;19.07.2018;2018;07;23;Torstai;10;19;29;6;3;9
293;20.07.2018;2018;07;00;Perjantai;13;2;15;4;0;4
293;20.07.2018;2018;07;01;Perjantai;0;6;6;0;1;1
293;20.07.2018;2018;07;02;Perjantai;2;1;3;0;0;0
293;20.07.2018;2018;07;03;Perjantai;0;0;0;0;0;0
293;20.07.2018;2018;07;04;Perjantai;1;0;1;0;0;0
293;20.07.2018;2018;07;05;Perjantai;0;0;0;0;0;0
293;20.07.2018;2018;07;06;Perjantai;11;4;15;2;2;4
293;20.07.2018;2018;07;07;Perjantai;12;5;17;3;0;3
293;20.07.2018;2018;07;08;Perjantai;21;10;31;2;2;4
293;20.07.2018;2018;07;09;Perjantai;24;29;53;2;0;2
293;20.07.2018;2018;07;10;Perjantai;25;26;51;7;5;12
293;20.07.2018;2018;07;11;Perjantai;35;29;64;10;4;14
293;20.07.2018;2018;07;12;Perjantai;32;38;70;1;4;5
293;20.07.2018;2018;07;13;Perjantai;36;27;63;8;1;9
293;20.07.2018;2018;07;14;Perjantai;34;59;93;10;14;24
293;20.07.2018;2018;07;15;Perjantai;44;37;81;9;3;12
293;20.07.2018;2018;07;16;Perjantai;44;39;83;10;3;13
293;20.07.2018;2018;07;17;Perjantai;28;49;77;8;6;14
293;20.07.2018;2018;07;18;Perjantai;45;37;82;2;1;3
293;20.07.2018;2018;07;19;Perjantai;55;56;111;9;5;14
293;20.07.2018;2018;07;20;Perjantai;26;51;77;2;7;9
293;20.07.2018;2018;07;21;Perjantai;48;31;79;8;10;18
293;20.07.2018;2018;07;22;Perjantai;31;22;53;2;5;7
293;20.07.2018;2018;07;23;Perjantai;9;14;23;3;2;5
293;21.07.2018;2018;07;00;Lauantai;4;8;12;1;0;1
293;21.07.2018;2018;07;01;Lauantai;16;2;18;3;1;4
293;21.07.2018;2018;07;02;Lauantai;1;9;10;1;2;3
293;21.07.2018;2018;07;03;Lauantai;2;6;8;0;0;0
293;21.07.2018;2018;07;04;Lauantai;2;1;3;0;2;2
293;21.07.2018;2018;07;05;Lauantai;3;0;3;1;0;1
293;21.07.2018;2018;07;06;Lauantai;2;0;2;0;0;0
293;21.07.2018;2018;07;07;Lauantai;5;1;6;2;1;3
293;21.07.2018;2018;07;08;Lauantai;13;10;23;4;1;5
293;21.07.2018;2018;07;09;Lauantai;8;13;21;2;3;5
293;21.07.2018;2018;07;10;Lauantai;22;12;34;6;3;9
293;21.07.2018;2018;07;11;Lauantai;28;23;51;3;3;6
293;21.07.2018;2018;07;12;Lauantai;25;29;54;4;4;8
293;21.07.2018;2018;07;13;Lauantai;31;19;50;5;3;8
293;21.07.2018;2018;07;14;Lauantai;21;16;37;0;0;0
293;21.07.2018;2018;07;15;Lauantai;24;30;54;5;5;10
293;21.07.2018;2018;07;16;Lauantai;31;17;48;4;4;8
293;21.07.2018;2018;07;17;Lauantai;34;36;70;3;3;6
293;21.07.2018;2018;07;18;Lauantai;36;35;71;7;6;13
293;21.07.2018;2018;07;19;Lauantai;34;33;67;5;5;10
293;21.07.2018;2018;07;20;Lauantai;42;29;71;2;7;9
293;21.07.2018;2018;07;21;Lauantai;18;24;42;1;0;1
293;21.07.2018;2018;07;22;Lauantai;13;20;33;4;1;5
293;21.07.2018;2018;07;23;Lauantai;7;5;12;1;2;3
293;22.07.2018;2018;07;00;Sunnuntai;8;14;22;2;1;3
293;22.07.2018;2018;07;01;Sunnuntai;4;5;9;0;3;3
293;22.07.2018;2018;07;02;Sunnuntai;1;2;3;1;0;1
293;22.07.2018;2018;07;03;Sunnuntai;0;1;1;0;5;5
293;22.07.2018;2018;07;04;Sunnuntai;2;3;5;1;3;4
293;22.07.2018;2018;07;05;Sunnuntai;1;1;2;1;0;1
293;22.07.2018;2018;07;06;Sunnuntai;1;0;1;0;0;0
293;22.07.2018;2018;07;07;Sunnuntai;3;0;3;0;0;0
293;22.07.2018;2018;07;08;Sunnuntai;5;1;6;1;1;2
293;22.07.2018;2018;07;09;Sunnuntai;6;7;13;2;0;2
293;22.07.2018;2018;07;10;Sunnuntai;23;5;28;4;4;8
293;22.07.2018;2018;07;11;Sunnuntai;20;28;48;9;5;14
293;22.07.2018;2018;07;12;Sunnuntai;30;28;58;11;8;19
293;22.07.2018;2018;07;13;Sunnuntai;21;27;48;1;1;2
293;22.07.2018;2018;07;14;Sunnuntai;17;20;37;0;4;4
293;22.07.2018;2018;07;15;Sunnuntai;16;19;35;3;3;6
293;22.07.2018;2018;07;16;Sunnuntai;31;27;58;2;1;3
293;22.07.2018;2018;07;17;Sunnuntai;27;27;54;5;4;9
293;22.07.2018;2018;07;18;Sunnuntai;32;41;73;2;0;2
293;22.07.2018;2018;07;19;Sunnuntai;31;38;69;8;3;11
293;22.07.2018;2018;07;20;Sunnuntai;22;18;40;3;1;4
293;22.07.2018;2018;07;21;Sunnuntai;14;15;29;5;2;7
293;22.07.2018;2018;07;22;Sunnuntai;19;18;37;2;1;3
293;22.07.2018;2018;07;23;Sunnuntai;9;11;20;1;1;2
293;23.07.2018;2018;07;00;Maanantai;12;11;23;0;1;1
293;23.07.2018;2018;07;01;Maanantai;9;4;13;3;1;4
293;23.07.2018;2018;07;02;Maanantai;1;1;2;0;0;0
293;23.07.2018;2018;07;03;Maanantai;0;1;1;0;0;0
293;23.07.2018;2018;07;04;Maanantai;0;0;0;0;0;0
293;23.07.2018;2018;07;05;Maanantai;1;0;1;0;1;1
293;23.07.2018;2018;07;06;Maanantai;7;2;9;0;0;0
293;23.07.2018;2018;07;07;Maanantai;9;1;10;2;1;3
293;23.07.2018;2018;07;08;Maanantai;7;4;11;0;1;1
293;23.07.2018;2018;07;09;Maanantai;16;8;24;1;0;1
293;23.07.2018;2018;07;10;Maanantai;16;12;28;6;2;8
293;23.07.2018;2018;07;11;Maanantai;20;29;49;2;3;5
293;23.07.2018;2018;07;12;Maanantai;25;23;48;3;4;7
293;23.07.2018;2018;07;13;Maanantai;25;37;62;4;1;5
293;23.07.2018;2018;07;14;Maanantai;45;34;79;7;2;9
293;23.07.2018;2018;07;15;Maanantai;37;28;65;9;2;11
293;23.07.2018;2018;07;16;Maanantai;44;51;95;3;2;5
293;23.07.2018;2018;07;17;Maanantai;47;45;92;6;5;11
293;23.07.2018;2018;07;18;Maanantai;62;58;120;8;4;12
293;23.07.2018;2018;07;19;Maanantai;50;69;119;5;1;6
293;23.07.2018;2018;07;20;Maanantai;59;59;118;5;5;10
293;23.07.2018;2018;07;21;Maanantai;37;40;77;1;7;8
293;23.07.2018;2018;07;22;Maanantai;27;27;54;2;1;3
293;23.07.2018;2018;07;23;Maanantai;11;11;22;0;0;0
293;24.07.2018;2018;07;00;Tiistai;4;1;5;0;1;1
293;24.07.2018;2018;07;01;Tiistai;1;1;2;0;0;0
293;24.07.2018;2018;07;02;Tiistai;0;3;3;0;0;0
293;24.07.2018;2018;07;03;Tiistai;0;2;2;0;0;0
293;24.07.2018;2018;07;04;Tiistai;0;1;1;0;0;0
293;24.07.2018;2018;07;05;Tiistai;4;0;4;0;0;0
293;24.07.2018;2018;07;06;Tiistai;12;4;16;4;1;5
293;24.07.2018;2018;07;07;Tiistai;15;7;22;3;1;4
293;24.07.2018;2018;07;08;Tiistai;22;10;32;1;2;3
293;24.07.2018;2018;07;09;Tiistai;22;22;44;3;5;8
293;24.07.2018;2018;07;10;Tiistai;28;21;49;2;5;7
293;24.07.2018;2018;07;11;Tiistai;31;29;60;10;4;14
293;24.07.2018;2018;07;12;Tiistai;35;53;88;8;4;12
293;24.07.2018;2018;07;13;Tiistai;40;68;108;3;12;15
293;24.07.2018;2018;07;14;Tiistai;47;36;83;10;3;13
293;24.07.2018;2018;07;15;Tiistai;46;44;90;13;4;17
293;24.07.2018;2018;07;16;Tiistai;48;55;103;10;0;10
293;24.07.2018;2018;07;17;Tiistai;36;45;81;11;15;26
293;24.07.2018;2018;07;18;Tiistai;60;51;111;9;5;14
293;24.07.2018;2018;07;19;Tiistai;59;53;112;10;7;17
293;24.07.2018;2018;07;20;Tiistai;52;40;92;8;5;13
293;24.07.2018;2018;07;21;Tiistai;21;23;44;4;4;8
293;24.07.2018;2018;07;22;Tiistai;19;18;37;3;3;6
293;24.07.2018;2018;07;23;Tiistai;7;12;19;1;1;2
293;25.07.2018;2018;07;00;Keskiviikko;8;7;15;1;0;1
293;25.07.2018;2018;07;01;Keskiviikko;1;0;1;1;0;1
293;25.07.2018;2018;07;02;Keskiviikko;0;0;0;0;0;0
293;25.07.2018;2018;07;03;Keskiviikko;0;2;2;0;0;0
293;25.07.2018;2018;07;04;Keskiviikko;1;1;2;0;0;0
293;25.07.2018;2018;07;05;Keskiviikko;3;0;3;0;0;0
293;25.07.2018;2018;07;06;Keskiviikko;8;2;10;1;1;2
293;25.07.2018;2018;07;07;Keskiviikko;13;7;20;1;1;2
293;25.07.2018;2018;07;08;Keskiviikko;20;5;25;2;0;2
293;25.07.2018;2018;07;09;Keskiviikko;25;20;45;1;1;2
293;25.07.2018;2018;07;10;Keskiviikko;24;28;52;0;2;2
293;25.07.2018;2018;07;11;Keskiviikko;18;24;42;2;1;3
293;25.07.2018;2018;07;12;Keskiviikko;33;28;61;10;0;10
293;25.07.2018;2018;07;13;Keskiviikko;32;36;68;2;10;12
293;25.07.2018;2018;07;14;Keskiviikko;23;36;59;9;5;14
293;25.07.2018;2018;07;15;Keskiviikko;36;40;76;10;2;12
293;25.07.2018;2018;07;16;Keskiviikko;54;64;118;8;4;12
293;25.07.2018;2018;07;17;Keskiviikko;50;54;104;5;5;10
293;25.07.2018;2018;07;18;Keskiviikko;62;49;111;12;8;20
293;25.07.2018;2018;07;19;Keskiviikko;48;76;124;22;12;34
293;25.07.2018;2018;07;20;Keskiviikko;46;36;82;11;7;18
293;25.07.2018;2018;07;21;Keskiviikko;28;36;64;9;5;14
293;25.07.2018;2018;07;22;Keskiviikko;16;12;28;3;3;6
293;25.07.2018;2018;07;23;Keskiviikko;3;6;9;4;1;5
293;26.07.2018;2018;07;00;Torstai;6;1;7;0;0;0
293;26.07.2018;2018;07;01;Torstai;2;0;2;0;0;0
293;26.07.2018;2018;07;02;Torstai;3;7;10;1;0;1
293;26.07.2018;2018;07;03;Torstai;1;1;2;0;0;0
293;26.07.2018;2018;07;04;Torstai;0;2;2;1;0;1
293;26.07.2018;2018;07;05;Torstai;4;0;4;2;0;2
293;26.07.2018;2018;07;06;Torstai;12;2;14;1;0;1
293;26.07.2018;2018;07;07;Torstai;13;4;17;1;1;2
293;26.07.2018;2018;07;08;Torstai;18;6;24;6;1;7
293;26.07.2018;2018;07;09;Torstai;17;16;33;2;2;4
293;26.07.2018;2018;07;10;Torstai;24;24;48;7;2;9
293;26.07.2018;2018;07;11;Torstai;26;31;57;9;3;12
293;26.07.2018;2018;07;12;Torstai;31;38;69;5;10;15
293;26.07.2018;2018;07;13;Torstai;28;50;78;2;3;5
293;26.07.2018;2018;07;14;Torstai;27;28;55;5;4;9
293;26.07.2018;2018;07;15;Torstai;23;36;59;7;0;7
293;26.07.2018;2018;07;16;Torstai;43;41;84;4;4;8
293;26.07.2018;2018;07;17;Torstai;47;36;83;6;7;13
293;26.07.2018;2018;07;18;Torstai;48;53;101;3;9;12
293;26.07.2018;2018;07;19;Torstai;43;37;80;9;8;17
293;26.07.2018;2018;07;20;Torstai;35;51;86;5;6;11
293;26.07.2018;2018;07;21;Torstai;18;41;59;4;2;6
293;26.07.2018;2018;07;22;Torstai;20;13;33;2;0;2
293;26.07.2018;2018;07;23;Torstai;6;3;9;0;0;0
293;27.07.2018;2018;07;00;Perjantai;2;4;6;1;0;1
293;27.07.2018;2018;07;01;Perjantai;2;6;8;0;0;0
293;27.07.2018;2018;07;02;Perjantai;0;3;3;0;0;0
293;27.07.2018;2018;07;03;Perjantai;0;0;0;0;0;0
293;27.07.2018;2018;07;04;Perjantai;0;0;0;0;0;0
293;27.07.2018;2018;07;05;Perjantai;3;2;5;0;0;0
293;27.07.2018;2018;07;06;Perjantai;6;1;7;0;0;0
293;27.07.2018;2018;07;07;Perjantai;13;4;17;0;1;1
293;27.07.2018;2018;07;08;Perjantai;13;12;25;2;1;3
293;27.07.2018;2018;07;09;Perjantai;24;14;38;2;1;3
293;27.07.2018;2018;07;10;Perjantai;27;22;49;7;2;9
293;27.07.2018;2018;07;11;Perjantai;17;21;38;2;6;8
293;27.07.2018;2018;07;12;Perjantai;41;23;64;7;4;11
293;27.07.2018;2018;07;13;Perjantai;41;37;78;4;1;5
293;27.07.2018;2018;07;14;Perjantai;34;39;73;5;3;8
293;27.07.2018;2018;07;15;Perjantai;37;41;78;2;7;9
293;27.07.2018;2018;07;16;Perjantai;22;31;53;5;2;7
293;27.07.2018;2018;07;17;Perjantai;44;29;73;4;7;11
293;27.07.2018;2018;07;18;Perjantai;33;39;72;7;7;14
293;27.07.2018;2018;07;19;Perjantai;40;54;94;5;7;12
293;27.07.2018;2018;07;20;Perjantai;36;35;71;4;0;4
293;27.07.2018;2018;07;21;Perjantai;17;24;41;3;3;6
293;27.07.2018;2018;07;22;Perjantai;12;12;24;5;2;7
293;27.07.2018;2018;07;23;Perjantai;15;14;29;6;3;9
293;28.07.2018;2018;07;00;Lauantai;8;4;12;1;0;1
293;28.07.2018;2018;07;01;Lauantai;2;7;9;2;0;2
293;28.07.2018;2018;07;02;Lauantai;0;4;4;0;3;3
293;28.07.2018;2018;07;03;Lauantai;1;1;2;0;0;0
293;28.07.2018;2018;07;04;Lauantai;2;4;6;0;0;0
293;28.07.2018;2018;07;05;Lauantai;2;1;3;0;1;1
293;28.07.2018;2018;07;06;Lauantai;3;6;9;0;0;0
293;28.07.2018;2018;07;07;Lauantai;4;0;4;0;2;2
293;28.07.2018;2018;07;08;Lauantai;4;1;5;1;3;4
293;28.07.2018;2018;07;09;Lauantai;12;8;20;1;1;2
293;28.07.2018;2018;07;10;Lauantai;18;14;32;3;2;5
293;28.07.2018;2018;07;11;Lauantai;19;25;44;8;4;12
293;28.07.2018;2018;07;12;Lauantai;32;29;61;2;4;6
293;28.07.2018;2018;07;13;Lauantai;37;19;56;8;15;23
293;28.07.2018;2018;07;14;Lauantai;32;37;69;6;14;20
293;28.07.2018;2018;07;15;Lauantai;35;38;73;7;2;9
293;28.07.2018;2018;07;16;Lauantai;43;45;88;2;3;5
293;28.07.2018;2018;07;17;Lauantai;42;36;78;7;4;11
293;28.07.2018;2018;07;18;Lauantai;29;41;70;5;4;9
293;28.07.2018;2018;07;19;Lauantai;35;31;66;10;4;14
293;28.07.2018;2018;07;20;Lauantai;20;42;62;1;2;3
293;28.07.2018;2018;07;21;Lauantai;31;18;49;2;3;5
293;28.07.2018;2018;07;22;Lauantai;11;11;22;0;1;1
293;28.07.2018;2018;07;23;Lauantai;19;10;29;0;1;1
293;29.07.2018;2018;07;00;Sunnuntai;10;6;16;1;1;2
293;29.07.2018;2018;07;01;Sunnuntai;5;3;8;2;0;2
293;29.07.2018;2018;07;02;Sunnuntai;5;6;11;2;1;3
293;29.07.2018;2018;07;03;Sunnuntai;1;3;4;1;4;5
293;29.07.2018;2018;07;04;Sunnuntai;1;0;1;1;0;1
293;29.07.2018;2018;07;05;Sunnuntai;3;0;3;0;2;2
293;29.07.2018;2018;07;06;Sunnuntai;3;2;5;0;0;0
293;29.07.2018;2018;07;07;Sunnuntai;0;0;0;0;2;2
293;29.07.2018;2018;07;08;Sunnuntai;9;7;16;1;1;2
293;29.07.2018;2018;07;09;Sunnuntai;12;7;19;5;2;7
293;29.07.2018;2018;07;10;Sunnuntai;17;21;38;4;1;5
293;29.07.2018;2018;07;11;Sunnuntai;30;27;57;7;5;12
293;29.07.2018;2018;07;12;Sunnuntai;19;38;57;4;5;9
293;29.07.2018;2018;07;13;Sunnuntai;27;28;55;7;3;10
293;29.07.2018;2018;07;14;Sunnuntai;35;35;70;11;6;17
293;29.07.2018;2018;07;15;Sunnuntai;44;40;84;4;5;9
293;29.07.2018;2018;07;16;Sunnuntai;22;33;55;6;3;9
293;29.07.2018;2018;07;17;Sunnuntai;36;17;53;10;9;19
293;29.07.2018;2018;07;18;Sunnuntai;55;34;89;11;8;19
293;29.07.2018;2018;07;19;Sunnuntai;61;54;115;7;3;10
293;29.07.2018;2018;07;20;Sunnuntai;39;48;87;9;7;16
293;29.07.2018;2018;07;21;Sunnuntai;30;25;55;5;1;6
293;29.07.2018;2018;07;22;Sunnuntai;14;16;30;0;2;2
293;29.07.2018;2018;07;23;Sunnuntai;4;9;13;1;0;1
293;30.07.2018;2018;07;00;Maanantai;1;1;2;1;1;2
293;30.07.2018;2018;07;01;Maanantai;4;1;5;0;0;0
293;30.07.2018;2018;07;02;Maanantai;2;1;3;0;1;1
293;30.07.2018;2018;07;03;Maanantai;0;0;0;0;0;0
293;30.07.2018;2018;07;04;Maanantai;0;0;0;0;0;0
293;30.07.2018;2018;07;05;Maanantai;3;0;3;0;0;0
293;30.07.2018;2018;07;06;Maanantai;12;2;14;1;0;1
293;30.07.2018;2018;07;07;Maanantai;15;5;20;4;0;4
293;30.07.2018;2018;07;08;Maanantai;23;8;31;2;1;3
293;30.07.2018;2018;07;09;Maanantai;20;20;40;3;0;3
293;30.07.2018;2018;07;10;Maanantai;30;20;50;2;4;6
293;30.07.2018;2018;07;11;Maanantai;27;31;58;6;4;10
293;30.07.2018;2018;07;12;Maanantai;28;31;59;11;6;17
293;30.07.2018;2018;07;13;Maanantai;38;44;82;9;1;10
293;30.07.2018;2018;07;14;Maanantai;51;49;100;12;12;24
293;30.07.2018;2018;07;15;Maanantai;49;58;107;3;11;14
293;30.07.2018;2018;07;16;Maanantai;60;37;97;15;4;19
293;30.07.2018;2018;07;17;Maanantai;46;66;112;8;6;14
293;30.07.2018;2018;07;18;Maanantai;83;49;132;11;5;16
293;30.07.2018;2018;07;19;Maanantai;56;65;121;10;6;16
293;30.07.2018;2018;07;20;Maanantai;62;74;136;8;7;15
293;30.07.2018;2018;07;21;Maanantai;45;34;79;3;9;12
293;30.07.2018;2018;07;22;Maanantai;23;13;36;6;3;9
293;30.07.2018;2018;07;23;Maanantai;7;12;19;1;3;4
293;31.07.2018;2018;07;00;Tiistai;9;3;12;0;1;1
293;31.07.2018;2018;07;01;Tiistai;1;4;5;0;1;1
293;31.07.2018;2018;07;02;Tiistai;1;0;1;1;0;1
293;31.07.2018;2018;07;03;Tiistai;0;0;0;1;0;1
293;31.07.2018;2018;07;04;Tiistai;1;1;2;0;0;0
293;31.07.2018;2018;07;05;Tiistai;2;0;2;0;0;0
293;31.07.2018;2018;07;06;Tiistai;14;4;18;1;0;1
293;31.07.2018;2018;07;07;Tiistai;21;5;26;3;1;4
293;31.07.2018;2018;07;08;Tiistai;28;12;40;3;2;5
293;31.07.2018;2018;07;09;Tiistai;18;21;39;4;3;7
293;31.07.2018;2018;07;10;Tiistai;25;26;51;3;2;5
293;31.07.2018;2018;07;11;Tiistai;29;38;67;4;11;15
293;31.07.2018;2018;07;12;Tiistai;58;29;87;11;3;14
293;31.07.2018;2018;07;13;Tiistai;23;31;54;5;2;7
293;31.07.2018;2018;07;14;Tiistai;36;57;93;10;4;14
293;31.07.2018;2018;07;15;Tiistai;38;38;76;8;3;11
293;31.07.2018;2018;07;16;Tiistai;40;53;93;8;1;9
293;31.07.2018;2018;07;17;Tiistai;41;44;85;3;4;7
293;31.07.2018;2018;07;18;Tiistai;52;44;96;2;1;3
293;31.07.2018;2018;07;19;Tiistai;44;73;117;15;3;18
293;31.07.2018;2018;07;20;Tiistai;40;21;61;2;2;4
293;31.07.2018;2018;07;21;Tiistai;35;39;74;1;4;5
293;31.07.2018;2018;07;22;Tiistai;20;24;44;3;2;5
293;31.07.2018;2018;07;23;Tiistai;13;6;19;1;1;2
293;01.08.2018;2018;08;00;Keskiviikko;4;5;9;0;2;2
293;01.08.2018;2018;08;01;Keskiviikko;0;1;1;2;0;2
293;01.08.2018;2018;08;02;Keskiviikko;0;3;3;1;1;2
293;01.08.2018;2018;08;03;Keskiviikko;2;0;2;0;0;0
293;01.08.2018;2018;08;04;Keskiviikko;1;0;1;1;1;2
293;01.08.2018;2018;08;05;Keskiviikko;1;1;2;0;0;0
293;01.08.2018;2018;08;06;Keskiviikko;14;2;16;2;0;2
293;01.08.2018;2018;08;07;Keskiviikko;14;5;19;3;1;4
293;01.08.2018;2018;08;08;Keskiviikko;21;9;30;5;2;7
293;01.08.2018;2018;08;09;Keskiviikko;22;13;35;3;4;7
293;01.08.2018;2018;08;10;Keskiviikko;18;19;37;3;4;7
293;01.08.2018;2018;08;11;Keskiviikko;33;28;61;5;2;7
293;01.08.2018;2018;08;12;Keskiviikko;30;41;71;5;3;8
293;01.08.2018;2018;08;13;Keskiviikko;41;46;87;9;7;16
293;01.08.2018;2018;08;14;Keskiviikko;43;60;103;14;2;16
293;01.08.2018;2018;08;15;Keskiviikko;52;51;103;7;4;11
293;01.08.2018;2018;08;16;Keskiviikko;45;40;85;6;8;14
293;01.08.2018;2018;08;17;Keskiviikko;61;35;96;5;2;7
293;01.08.2018;2018;08;18;Keskiviikko;49;40;89;13;3;16
293;01.08.2018;2018;08;19;Keskiviikko;57;63;120;4;5;9
293;01.08.2018;2018;08;20;Keskiviikko;29;36;65;11;5;16
293;01.08.2018;2018;08;21;Keskiviikko;40;39;79;3;5;8
293;01.08.2018;2018;08;22;Keskiviikko;11;13;24;0;0;0
293;01.08.2018;2018;08;23;Keskiviikko;9;16;25;0;2;2
293;02.08.2018;2018;08;00;Torstai;6;5;11;0;0;0
293;02.08.2018;2018;08;01;Torstai;3;0;3;0;0;0
293;02.08.2018;2018;08;02;Torstai;2;3;5;0;0;0
293;02.08.2018;2018;08;03;Torstai;3;3;6;0;2;2
293;02.08.2018;2018;08;04;Torstai;0;0;0;0;1;1
293;02.08.2018;2018;08;05;Torstai;2;0;2;0;0;0
293;02.08.2018;2018;08;06;Torstai;12;1;13;0;0;0
293;02.08.2018;2018;08;07;Torstai;16;6;22;3;0;3
293;02.08.2018;2018;08;08;Torstai;20;5;25;2;0;2
293;02.08.2018;2018;08;09;Torstai;14;15;29;4;4;8
293;02.08.2018;2018;08;10;Torstai;24;20;44;1;2;3
293;02.08.2018;2018;08;11;Torstai;12;28;40;5;1;6
293;02.08.2018;2018;08;12;Torstai;20;20;40;4;1;5
293;02.08.2018;2018;08;13;Torstai;41;39;80;4;4;8
293;02.08.2018;2018;08;14;Torstai;33;33;66;4;2;6
293;02.08.2018;2018;08;15;Torstai;35;33;68;4;5;9
293;02.08.2018;2018;08;16;Torstai;37;36;73;4;4;8
293;02.08.2018;2018;08;17;Torstai;32;41;73;3;1;4
293;02.08.2018;2018;08;18;Torstai;48;52;100;8;2;10
293;02.08.2018;2018;08;19;Torstai;41;57;98;5;4;9
293;02.08.2018;2018;08;20;Torstai;64;55;119;7;8;15
293;02.08.2018;2018;08;21;Torstai;19;26;45;1;6;7
293;02.08.2018;2018;08;22;Torstai;14;6;20;0;0;0
293;02.08.2018;2018;08;23;Torstai;5;5;10;0;0;0
293;03.08.2018;2018;08;00;Perjantai;0;2;2;0;0;0
293;03.08.2018;2018;08;01;Perjantai;0;9;9;0;1;1
293;03.08.2018;2018;08;02;Perjantai;5;2;7;5;1;6
293;03.08.2018;2018;08;03;Perjantai;0;1;1;0;0;0
293;03.08.2018;2018;08;04;Perjantai;2;0;2;0;1;1
293;03.08.2018;2018;08;05;Perjantai;0;2;2;0;0;0
293;03.08.2018;2018;08;06;Perjantai;2;0;2;0;0;0
293;03.08.2018;2018;08;07;Perjantai;2;1;3;0;0;0
293;03.08.2018;2018;08;08;Perjantai;16;3;19;1;0;1
293;03.08.2018;2018;08;09;Perjantai;13;9;22;2;4;6
293;03.08.2018;2018;08;10;Perjantai;2;9;11;1;1;2
293;03.08.2018;2018;08;11;Perjantai;2;3;5;2;2;4
293;03.08.2018;2018;08;12;Perjantai;8;4;12;0;1;1
293;03.08.2018;2018;08;13;Perjantai;16;6;22;2;0;2
293;03.08.2018;2018;08;14;Perjantai;15;18;33;0;7;7
293;03.08.2018;2018;08;15;Perjantai;19;20;39;1;0;1
293;03.08.2018;2018;08;16;Perjantai;20;20;40;7;2;9
293;03.08.2018;2018;08;17;Perjantai;27;38;65;4;6;10
293;03.08.2018;2018;08;18;Perjantai;29;31;60;5;2;7
293;03.08.2018;2018;08;19;Perjantai;37;33;70;8;4;12
293;03.08.2018;2018;08;20;Perjantai;27;26;53;5;8;13
293;03.08.2018;2018;08;21;Perjantai;22;25;47;3;1;4
293;03.08.2018;2018;08;22;Perjantai;12;9;21;1;4;5
293;03.08.2018;2018;08;23;Perjantai;4;7;11;3;3;6
293;04.08.2018;2018;08;00;Lauantai;3;7;10;2;0;2
293;04.08.2018;2018;08;01;Lauantai;5;5;10;0;2;2
293;04.08.2018;2018;08;02;Lauantai;1;2;3;0;1;1
293;04.08.2018;2018;08;03;Lauantai;3;2;5;1;1;2
293;04.08.2018;2018;08;04;Lauantai;2;1;3;0;1;1
293;04.08.2018;2018;08;05;Lauantai;0;4;4;0;0;0
293;04.08.2018;2018;08;06;Lauantai;2;3;5;0;1;1
293;04.08.2018;2018;08;07;Lauantai;6;2;8;2;1;3
293;04.08.2018;2018;08;08;Lauantai;6;8;14;0;1;1
293;04.08.2018;2018;08;09;Lauantai;8;7;15;2;2;4
293;04.08.2018;2018;08;10;Lauantai;13;11;24;5;1;6
293;04.08.2018;2018;08;11;Lauantai;24;19;43;7;2;9
293;04.08.2018;2018;08;12;Lauantai;30;28;58;9;6;15
293;04.08.2018;2018;08;13;Lauantai;40;31;71;6;1;7
293;04.08.2018;2018;08;14;Lauantai;19;37;56;2;6;8
293;04.08.2018;2018;08;15;Lauantai;24;35;59;4;6;10
293;04.08.2018;2018;08;16;Lauantai;40;37;77;7;5;12
293;04.08.2018;2018;08;17;Lauantai;39;23;62;5;2;7
293;04.08.2018;2018;08;18;Lauantai;38;57;95;6;3;9
293;04.08.2018;2018;08;19;Lauantai;51;61;112;8;7;15
293;04.08.2018;2018;08;20;Lauantai;41;36;77;3;9;12
293;04.08.2018;2018;08;21;Lauantai;45;33;78;7;5;12
293;04.08.2018;2018;08;22;Lauantai;19;9;28;0;1;1
293;04.08.2018;2018;08;23;Lauantai;7;11;18;1;4;5
293;05.08.2018;2018;08;00;Sunnuntai;5;8;13;0;1;1
293;05.08.2018;2018;08;01;Sunnuntai;2;8;10;2;1;3
293;05.08.2018;2018;08;02;Sunnuntai;3;13;16;0;0;0
293;05.08.2018;2018;08;03;Sunnuntai;1;5;6;0;0;0
293;05.08.2018;2018;08;04;Sunnuntai;1;5;6;2;2;4
293;05.08.2018;2018;08;05;Sunnuntai;1;2;3;0;0;0
293;05.08.2018;2018;08;06;Sunnuntai;1;1;2;1;0;1
293;05.08.2018;2018;08;07;Sunnuntai;5;0;5;1;0;1
293;05.08.2018;2018;08;08;Sunnuntai;4;3;7;1;1;2
293;05.08.2018;2018;08;09;Sunnuntai;14;5;19;6;1;7
293;05.08.2018;2018;08;10;Sunnuntai;22;25;47;3;3;6
293;05.08.2018;2018;08;11;Sunnuntai;24;20;44;4;1;5
293;05.08.2018;2018;08;12;Sunnuntai;30;33;63;7;1;8
293;05.08.2018;2018;08;13;Sunnuntai;31;23;54;4;4;8
293;05.08.2018;2018;08;14;Sunnuntai;28;25;53;5;5;10
293;05.08.2018;2018;08;15;Sunnuntai;20;30;50;5;2;7
293;05.08.2018;2018;08;16;Sunnuntai;27;31;58;1;6;7
293;05.08.2018;2018;08;17;Sunnuntai;38;42;80;5;4;9
293;05.08.2018;2018;08;18;Sunnuntai;39;36;75;8;5;13
293;05.08.2018;2018;08;19;Sunnuntai;51;36;87;9;5;14
293;05.08.2018;2018;08;20;Sunnuntai;34;38;72;4;3;7
293;05.08.2018;2018;08;21;Sunnuntai;28;31;59;2;5;7
293;05.08.2018;2018;08;22;Sunnuntai;24;16;40;1;2;3
293;05.08.2018;2018;08;23;Sunnuntai;11;2;13;0;0;0
293;06.08.2018;2018;08;00;Maanantai;4;13;17;0;0;0
293;06.08.2018;2018;08;01;Maanantai;0;0;0;0;0;0
293;06.08.2018;2018;08;02;Maanantai;1;5;6;0;0;0
293;06.08.2018;2018;08;03;Maanantai;0;0;0;0;0;0
293;06.08.2018;2018;08;04;Maanantai;0;0;0;0;0;0
293;06.08.2018;2018;08;05;Maanantai;1;0;1;0;0;0
293;06.08.2018;2018;08;06;Maanantai;10;1;11;0;0;0
293;06.08.2018;2018;08;07;Maanantai;12;5;17;1;0;1
293;06.08.2018;2018;08;08;Maanantai;9;7;16;1;1;2
293;06.08.2018;2018;08;09;Maanantai;7;6;13;2;2;4
293;06.08.2018;2018;08;10;Maanantai;4;4;8;0;3;3
293;06.08.2018;2018;08;11;Maanantai;8;5;13;3;1;4
293;06.08.2018;2018;08;12;Maanantai;7;5;12;0;1;1
293;06.08.2018;2018;08;13;Maanantai;18;9;27;2;0;2
293;06.08.2018;2018;08;14;Maanantai;21;24;45;3;3;6
293;06.08.2018;2018;08;15;Maanantai;13;24;37;3;5;8
293;06.08.2018;2018;08;16;Maanantai;13;14;27;4;4;8
293;06.08.2018;2018;08;17;Maanantai;31;28;59;3;3;6
293;06.08.2018;2018;08;18;Maanantai;26;23;49;5;6;11
293;06.08.2018;2018;08;19;Maanantai;34;38;72;2;3;5
293;06.08.2018;2018;08;20;Maanantai;25;29;54;5;5;10
293;06.08.2018;2018;08;21;Maanantai;9;9;18;1;1;2
293;06.08.2018;2018;08;22;Maanantai;9;15;24;0;4;4
293;06.08.2018;2018;08;23;Maanantai;4;6;10;2;1;3
293;07.08.2018;2018;08;00;Tiistai;12;0;12;1;0;1
293;07.08.2018;2018;08;01;Tiistai;5;0;5;1;0;1
293;07.08.2018;2018;08;02;Tiistai;1;0;1;1;0;1
293;07.08.2018;2018;08;03;Tiistai;0;0;0;1;0;1
293;07.08.2018;2018;08;04;Tiistai;2;0;2;0;0;0
293;07.08.2018;2018;08;05;Tiistai;2;0;2;0;0;0
293;07.08.2018;2018;08;06;Tiistai;18;0;18;1;0;1
293;07.08.2018;2018;08;07;Tiistai;26;0;26;4;0;4
293;07.08.2018;2018;08;08;Tiistai;40;0;40;5;0;5
293;07.08.2018;2018;08;09;Tiistai;39;0;39;7;0;7
293;07.08.2018;2018;08;10;Tiistai;51;0;51;5;0;5
293;07.08.2018;2018;08;11;Tiistai;67;0;67;15;0;15
293;07.08.2018;2018;08;12;Tiistai;87;0;87;14;0;14
293;07.08.2018;2018;08;13;Tiistai;54;0;54;7;0;7
293;07.08.2018;2018;08;14;Tiistai;93;0;93;14;0;14
293;07.08.2018;2018;08;15;Tiistai;76;0;76;11;0;11
293;07.08.2018;2018;08;16;Tiistai;93;0;93;9;0;9
293;07.08.2018;2018;08;17;Tiistai;85;0;85;7;0;7
293;07.08.2018;2018;08;18;Tiistai;96;0;96;3;0;3
293;07.08.2018;2018;08;19;Tiistai;117;0;117;18;0;18
293;07.08.2018;2018;08;20;Tiistai;61;0;61;4;0;4
293;07.08.2018;2018;08;21;Tiistai;74;0;74;5;0;5
293;07.08.2018;2018;08;22;Tiistai;44;0;44;5;0;5
293;07.08.2018;2018;08;23;Tiistai;19;0;19;2;0;2
293;08.08.2018;2018;08;00;Keskiviikko;1;1;2;0;0;0
293;08.08.2018;2018;08;01;Keskiviikko;1;2;3;0;0;0
293;08.08.2018;2018;08;02;Keskiviikko;2;0;2;0;1;1
293;08.08.2018;2018;08;03;Keskiviikko;0;0;0;0;0;0
293;08.08.2018;2018;08;04;Keskiviikko;1;1;2;0;0;0
293;08.08.2018;2018;08;05;Keskiviikko;2;0;2;0;0;0
293;08.08.2018;2018;08;06;Keskiviikko;18;4;22;1;0;1
293;08.08.2018;2018;08;07;Keskiviikko;27;8;35;0;2;2
293;08.08.2018;2018;08;08;Keskiviikko;23;13;36;2;2;4
293;08.08.2018;2018;08;09;Keskiviikko;16;8;24;2;1;3
293;08.08.2018;2018;08;10;Keskiviikko;25;16;41;4;1;5
293;08.08.2018;2018;08;11;Keskiviikko;24;17;41;5;3;8
293;08.08.2018;2018;08;12;Keskiviikko;37;38;75;7;5;12
293;08.08.2018;2018;08;13;Keskiviikko;34;33;67;10;5;15
293;08.08.2018;2018;08;14;Keskiviikko;41;31;72;10;7;17
293;08.08.2018;2018;08;15;Keskiviikko;45;65;110;5;11;16
293;08.08.2018;2018;08;16;Keskiviikko;30;57;87;3;8;11
293;08.08.2018;2018;08;17;Keskiviikko;47;49;96;7;3;10
293;08.08.2018;2018;08;18;Keskiviikko;51;44;95;11;3;14
293;08.08.2018;2018;08;19;Keskiviikko;43;48;91;3;10;13
293;08.08.2018;2018;08;20;Keskiviikko;24;38;62;5;5;10
293;08.08.2018;2018;08;21;Keskiviikko;16;21;37;0;4;4
293;08.08.2018;2018;08;22;Keskiviikko;3;5;8;0;1;1
293;08.08.2018;2018;08;23;Keskiviikko;3;3;6;0;1;1
293;09.08.2018;2018;08;00;Torstai;0;0;0;1;0;1
293;09.08.2018;2018;08;01;Torstai;0;1;1;0;0;0
293;09.08.2018;2018;08;02;Torstai;0;2;2;0;0;0
293;09.08.2018;2018;08;03;Torstai;0;0;0;0;0;0
293;09.08.2018;2018;08;04;Torstai;0;1;1;0;0;0
293;09.08.2018;2018;08;05;Torstai;1;0;1;0;0;0
293;09.08.2018;2018;08;06;Torstai;11;2;13;1;0;1
293;09.08.2018;2018;08;07;Torstai;23;7;30;5;0;5
293;09.08.2018;2018;08;08;Torstai;180;12;192;8;1;9
293;09.08.2018;2018;08;09;Torstai;31;4;35;4;0;4
293;09.08.2018;2018;08;10;Torstai;10;9;19;0;1;1
293;09.08.2018;2018;08;11;Torstai;7;17;24;2;4;6
293;09.08.2018;2018;08;12;Torstai;16;95;111;4;5;9
293;09.08.2018;2018;08;13;Torstai;14;115;129;3;11;14
293;09.08.2018;2018;08;14;Torstai;45;30;75;3;1;4
293;09.08.2018;2018;08;15;Torstai;41;39;80;5;6;11
293;09.08.2018;2018;08;16;Torstai;18;33;51;5;3;8
293;09.08.2018;2018;08;17;Torstai;29;33;62;5;7;12
293;09.08.2018;2018;08;18;Torstai;37;41;78;5;5;10
293;09.08.2018;2018;08;19;Torstai;38;38;76;9;10;19
293;09.08.2018;2018;08;20;Torstai;22;31;53;5;9;14
293;09.08.2018;2018;08;21;Torstai;8;10;18;2;2;4
293;09.08.2018;2018;08;22;Torstai;0;8;8;1;1;2
293;09.08.2018;2018;08;23;Torstai;2;3;5;0;2;2
293;10.08.2018;2018;08;00;Perjantai;1;2;3;1;0;1
293;10.08.2018;2018;08;01;Perjantai;2;2;4;0;0;0
293;10.08.2018;2018;08;02;Perjantai;0;0;0;0;0;0
293;10.08.2018;2018;08;03;Perjantai;0;0;0;0;0;0
293;10.08.2018;2018;08;04;Perjantai;0;0;0;0;0;0
293;10.08.2018;2018;08;05;Perjantai;2;1;3;0;0;0
293;10.08.2018;2018;08;06;Perjantai;13;2;15;0;1;1
293;10.08.2018;2018;08;07;Perjantai;30;9;39;1;0;1
293;10.08.2018;2018;08;08;Perjantai;173;19;192;9;2;11
293;10.08.2018;2018;08;09;Perjantai;42;14;56;2;2;4
293;10.08.2018;2018;08;10;Perjantai;15;15;30;6;1;7
293;10.08.2018;2018;08;11;Perjantai;18;22;40;7;9;16
293;10.08.2018;2018;08;12;Perjantai;24;22;46;3;6;9
293;10.08.2018;2018;08;13;Perjantai;29;175;204;4;7;11
293;10.08.2018;2018;08;14;Perjantai;35;71;106;5;8;13
293;10.08.2018;2018;08;15;Perjantai;35;54;89;1;3;4
293;10.08.2018;2018;08;16;Perjantai;53;45;98;6;2;8
293;10.08.2018;2018;08;17;Perjantai;68;60;128;7;5;12
293;10.08.2018;2018;08;18;Perjantai;33;44;77;5;2;7
293;10.08.2018;2018;08;19;Perjantai;15;44;59;2;3;5
293;10.08.2018;2018;08;20;Perjantai;15;12;27;2;2;4
293;10.08.2018;2018;08;21;Perjantai;2;8;10;2;2;4
293;10.08.2018;2018;08;22;Perjantai;3;5;8;1;1;2
293;10.08.2018;2018;08;23;Perjantai;3;6;9;0;0;0
293;11.08.2018;2018;08;00;Lauantai;4;1;5;0;1;1
293;11.08.2018;2018;08;01;Lauantai;0;0;0;0;1;1
293;11.08.2018;2018;08;02;Lauantai;1;0;1;1;0;1
293;11.08.2018;2018;08;03;Lauantai;2;1;3;0;0;0
293;11.08.2018;2018;08;04;Lauantai;0;1;1;0;2;2
293;11.08.2018;2018;08;05;Lauantai;0;0;0;0;0;0
293;11.08.2018;2018;08;06;Lauantai;2;2;4;0;0;0
293;11.08.2018;2018;08;07;Lauantai;1;0;1;2;2;4
293;11.08.2018;2018;08;08;Lauantai;11;2;13;4;0;4
293;11.08.2018;2018;08;09;Lauantai;8;10;18;3;5;8
293;11.08.2018;2018;08;10;Lauantai;10;12;22;3;4;7
293;11.08.2018;2018;08;11;Lauantai;13;13;26;6;2;8
293;11.08.2018;2018;08;12;Lauantai;15;17;32;5;7;12
293;11.08.2018;2018;08;13;Lauantai;24;21;45;6;2;8
293;11.08.2018;2018;08;14;Lauantai;23;15;38;5;1;6
293;11.08.2018;2018;08;15;Lauantai;27;22;49;6;4;10
293;11.08.2018;2018;08;16;Lauantai;20;21;41;5;4;9
293;11.08.2018;2018;08;17;Lauantai;23;33;56;6;6;12
293;11.08.2018;2018;08;18;Lauantai;25;32;57;4;9;13
293;11.08.2018;2018;08;19;Lauantai;40;22;62;1;2;3
293;11.08.2018;2018;08;20;Lauantai;18;17;35;1;3;4
293;11.08.2018;2018;08;21;Lauantai;10;20;30;1;7;8
293;11.08.2018;2018;08;22;Lauantai;8;6;14;0;3;3
293;11.08.2018;2018;08;23;Lauantai;4;9;13;3;1;4
293;12.08.2018;2018;08;00;Sunnuntai;9;9;18;3;2;5
293;12.08.2018;2018;08;01;Sunnuntai;10;9;19;7;1;8
293;12.08.2018;2018;08;02;Sunnuntai;0;0;0;2;0;2
293;12.08.2018;2018;08;03;Sunnuntai;0;4;4;0;1;1
293;12.08.2018;2018;08;04;Sunnuntai;1;2;3;0;3;3
293;12.08.2018;2018;08;05;Sunnuntai;0;2;2;0;0;0
293;12.08.2018;2018;08;06;Sunnuntai;0;0;0;0;0;0
293;12.08.2018;2018;08;07;Sunnuntai;2;1;3;0;0;0
293;12.08.2018;2018;08;08;Sunnuntai;6;2;8;4;2;6
293;12.08.2018;2018;08;09;Sunnuntai;8;11;19;2;5;7
293;12.08.2018;2018;08;10;Sunnuntai;15;13;28;8;4;12
293;12.08.2018;2018;08;11;Sunnuntai;18;22;40;5;2;7
293;12.08.2018;2018;08;12;Sunnuntai;27;31;58;9;3;12
293;12.08.2018;2018;08;13;Sunnuntai;24;25;49;2;2;4
293;12.08.2018;2018;08;14;Sunnuntai;53;35;88;11;7;18
293;12.08.2018;2018;08;15;Sunnuntai;35;39;74;6;1;7
293;12.08.2018;2018;08;16;Sunnuntai;23;33;56;3;6;9
293;12.08.2018;2018;08;17;Sunnuntai;32;34;66;4;2;6
293;12.08.2018;2018;08;18;Sunnuntai;34;37;71;5;1;6
293;12.08.2018;2018;08;19;Sunnuntai;42;25;67;7;4;11
293;12.08.2018;2018;08;20;Sunnuntai;20;27;47;3;6;9
293;12.08.2018;2018;08;21;Sunnuntai;0;15;15;3;1;4
293;12.08.2018;2018;08;22;Sunnuntai;5;1;6;2;1;3
293;12.08.2018;2018;08;23;Sunnuntai;0;1;1;0;0;0
293;13.08.2018;2018;08;00;Maanantai;1;0;1;0;0;0
293;13.08.2018;2018;08;01;Maanantai;1;0;1;0;0;0
293;13.08.2018;2018;08;02;Maanantai;0;0;0;0;0;0
293;13.08.2018;2018;08;03;Maanantai;0;1;1;0;0;0
293;13.08.2018;2018;08;04;Maanantai;0;1;1;0;0;0
293;13.08.2018;2018;08;05;Maanantai;2;0;2;0;0;0
293;13.08.2018;2018;08;06;Maanantai;18;2;20;0;1;1
293;13.08.2018;2018;08;07;Maanantai;139;8;147;6;0;6
293;13.08.2018;2018;08;08;Maanantai;69;14;83;3;1;4
293;13.08.2018;2018;08;09;Maanantai;29;13;42;4;2;6
293;13.08.2018;2018;08;10;Maanantai;11;10;21;2;3;5
293;13.08.2018;2018;08;11;Maanantai;4;8;12;2;2;4
293;13.08.2018;2018;08;12;Maanantai;28;15;43;3;1;4
293;13.08.2018;2018;08;13;Maanantai;19;51;70;3;0;3
293;13.08.2018;2018;08;14;Maanantai;20;130;150;2;7;9
293;13.08.2018;2018;08;15;Maanantai;13;66;79;1;7;8
293;13.08.2018;2018;08;16;Maanantai;15;32;47;5;3;8
293;13.08.2018;2018;08;17;Maanantai;19;20;39;1;5;6
293;13.08.2018;2018;08;18;Maanantai;17;11;28;8;3;11
293;13.08.2018;2018;08;19;Maanantai;13;21;34;5;7;12
293;13.08.2018;2018;08;20;Maanantai;8;21;29;2;2;4
293;13.08.2018;2018;08;21;Maanantai;3;3;6;0;2;2
293;13.08.2018;2018;08;22;Maanantai;1;1;2;1;0;1
293;13.08.2018;2018;08;23;Maanantai;0;0;0;0;0;0
293;14.08.2018;2018;08;00;Tiistai;0;0;0;0;0;0
293;14.08.2018;2018;08;01;Tiistai;0;0;0;0;0;0
293;14.08.2018;2018;08;02;Tiistai;2;0;2;0;0;0
293;14.08.2018;2018;08;03;Tiistai;0;1;1;0;0;0
293;14.08.2018;2018;08;04;Tiistai;0;0;0;0;0;0
293;14.08.2018;2018;08;05;Tiistai;1;0;1;0;0;0
293;14.08.2018;2018;08;06;Tiistai;24;1;25;0;0;0
293;14.08.2018;2018;08;07;Tiistai;128;5;133;12;5;17
293;14.08.2018;2018;08;08;Tiistai;97;15;112;5;1;6
293;14.08.2018;2018;08;09;Tiistai;25;13;38;3;4;7
293;14.08.2018;2018;08;10;Tiistai;21;12;33;6;11;17
293;14.08.2018;2018;08;11;Tiistai;13;17;30;5;3;8
293;14.08.2018;2018;08;12;Tiistai;17;18;35;3;4;7
293;14.08.2018;2018;08;13;Tiistai;17;43;60;1;1;2
293;14.08.2018;2018;08;14;Tiistai;18;111;129;2;10;12
293;14.08.2018;2018;08;15;Tiistai;26;85;111;2;5;7
293;14.08.2018;2018;08;16;Tiistai;34;42;76;3;8;11
293;14.08.2018;2018;08;17;Tiistai;21;22;43;0;4;4
293;14.08.2018;2018;08;18;Tiistai;31;33;64;3;7;10
293;14.08.2018;2018;08;19;Tiistai;30;35;65;6;5;11
293;14.08.2018;2018;08;20;Tiistai;11;34;45;3;8;11
293;14.08.2018;2018;08;21;Tiistai;0;13;13;4;3;7
293;14.08.2018;2018;08;22;Tiistai;1;2;3;0;1;1
293;14.08.2018;2018;08;23;Tiistai;0;2;2;0;1;1
293;15.08.2018;2018;08;00;Keskiviikko;0;0;0;0;0;0
293;15.08.2018;2018;08;01;Keskiviikko;0;0;0;0;0;0
293;15.08.2018;2018;08;02;Keskiviikko;0;0;0;1;0;1
293;15.08.2018;2018;08;03;Keskiviikko;0;2;2;0;0;0
293;15.08.2018;2018;08;04;Keskiviikko;0;0;0;0;0;0
293;15.08.2018;2018;08;05;Keskiviikko;1;0;1;1;1;2
293;15.08.2018;2018;08;06;Keskiviikko;24;2;26;0;0;0
293;15.08.2018;2018;08;07;Keskiviikko;116;10;126;6;0;6
293;15.08.2018;2018;08;08;Keskiviikko;126;15;141;4;0;4
293;15.08.2018;2018;08;09;Keskiviikko;15;16;31;2;2;4
293;15.08.2018;2018;08;10;Keskiviikko;13;7;20;4;5;9
293;15.08.2018;2018;08;11;Keskiviikko;16;12;28;2;2;4
293;15.08.2018;2018;08;12;Keskiviikko;14;22;36;3;3;6
293;15.08.2018;2018;08;13;Keskiviikko;21;53;74;6;9;15
293;15.08.2018;2018;08;14;Keskiviikko;20;161;181;6;8;14
293;15.08.2018;2018;08;15;Keskiviikko;16;48;64;4;7;11
293;15.08.2018;2018;08;16;Keskiviikko;30;39;69;1;5;6
293;15.08.2018;2018;08;17;Keskiviikko;38;30;68;4;0;4
293;15.08.2018;2018;08;18;Keskiviikko;25;25;50;2;3;5
293;15.08.2018;2018;08;19;Keskiviikko;23;29;52;4;4;8
293;15.08.2018;2018;08;20;Keskiviikko;11;18;29;3;5;8
293;15.08.2018;2018;08;21;Keskiviikko;2;12;14;3;5;8
293;15.08.2018;2018;08;22;Keskiviikko;1;2;3;0;0;0
293;15.08.2018;2018;08;23;Keskiviikko;0;0;0;0;0;0
293;16.08.2018;2018;08;00;Torstai;0;1;1;0;0;0
293;16.08.2018;2018;08;01;Torstai;0;0;0;0;0;0
293;16.08.2018;2018;08;02;Torstai;0;0;0;0;0;0
293;16.08.2018;2018;08;03;Torstai;0;1;1;0;0;0
293;16.08.2018;2018;08;04;Torstai;0;0;0;0;0;0
293;16.08.2018;2018;08;05;Torstai;2;0;2;0;0;0
293;16.08.2018;2018;08;06;Torstai;16;1;17;1;0;1
293;16.08.2018;2018;08;07;Torstai;139;9;148;5;0;5
293;16.08.2018;2018;08;08;Torstai;72;11;83;1;0;1
293;16.08.2018;2018;08;09;Torstai;55;16;71;2;5;7
293;16.08.2018;2018;08;10;Torstai;20;16;36;4;2;6
293;16.08.2018;2018;08;11;Torstai;13;12;25;2;2;4
293;16.08.2018;2018;08;12;Torstai;21;18;39;2;5;7
293;16.08.2018;2018;08;13;Torstai;14;50;64;3;1;4
293;16.08.2018;2018;08;14;Torstai;18;81;99;0;4;4
293;16.08.2018;2018;08;15;Torstai;20;110;130;5;6;11
293;16.08.2018;2018;08;16;Torstai;14;45;59;7;4;11
293;16.08.2018;2018;08;17;Torstai;22;31;53;5;4;9
293;16.08.2018;2018;08;18;Torstai;35;28;63;8;3;11
293;16.08.2018;2018;08;19;Torstai;27;27;54;8;6;14
293;16.08.2018;2018;08;20;Torstai;16;25;41;2;2;4
293;16.08.2018;2018;08;21;Torstai;1;22;23;5;4;9
293;16.08.2018;2018;08;22;Torstai;5;4;9;0;4;4
293;16.08.2018;2018;08;23;Torstai;2;0;2;1;0;1
293;17.08.2018;2018;08;00;Perjantai;0;0;0;0;0;0
293;17.08.2018;2018;08;01;Perjantai;0;0;0;0;0;0
293;17.08.2018;2018;08;02;Perjantai;1;0;1;0;0;0
293;17.08.2018;2018;08;03;Perjantai;0;3;3;0;0;0
293;17.08.2018;2018;08;04;Perjantai;0;0;0;0;0;0
293;17.08.2018;2018;08;05;Perjantai;1;0;1;0;0;0
293;17.08.2018;2018;08;06;Perjantai;13;0;13;1;2;3
293;17.08.2018;2018;08;07;Perjantai;127;9;136;8;0;8
293;17.08.2018;2018;08;08;Perjantai;62;13;75;4;0;4
293;17.08.2018;2018;08;09;Perjantai;42;13;55;4;1;5
293;17.08.2018;2018;08;10;Perjantai;26;15;41;4;3;7
293;17.08.2018;2018;08;11;Perjantai;7;20;27;2;3;5
293;17.08.2018;2018;08;12;Perjantai;14;29;43;2;4;6
293;17.08.2018;2018;08;13;Perjantai;18;66;84;9;5;14
293;17.08.2018;2018;08;14;Perjantai;26;112;138;7;6;13
293;17.08.2018;2018;08;15;Perjantai;18;64;82;1;3;4
293;17.08.2018;2018;08;16;Perjantai;24;25;49;1;2;3
293;17.08.2018;2018;08;17;Perjantai;35;25;60;2;2;4
293;17.08.2018;2018;08;18;Perjantai;28;31;59;3;2;5
293;17.08.2018;2018;08;19;Perjantai;24;37;61;4;3;7
293;17.08.2018;2018;08;20;Perjantai;23;24;47;0;1;1
293;17.08.2018;2018;08;21;Perjantai;8;24;32;1;3;4
293;17.08.2018;2018;08;22;Perjantai;6;6;12;3;2;5
293;17.08.2018;2018;08;23;Perjantai;8;6;14;0;0;0
293;18.08.2018;2018;08;00;Lauantai;7;8;15;2;1;3
293;18.08.2018;2018;08;01;Lauantai;0;0;0;0;1;1
293;18.08.2018;2018;08;02;Lauantai;0;1;1;0;2;2
293;18.08.2018;2018;08;03;Lauantai;0;1;1;0;1;1
293;18.08.2018;2018;08;04;Lauantai;0;0;0;0;0;0
293;18.08.2018;2018;08;05;Lauantai;1;1;2;0;0;0
293;18.08.2018;2018;08;06;Lauantai;3;0;3;0;0;0
293;18.08.2018;2018;08;07;Lauantai;3;3;6;1;0;1
293;18.08.2018;2018;08;08;Lauantai;8;2;10;1;1;2
293;18.08.2018;2018;08;09;Lauantai;3;7;10;2;1;3
293;18.08.2018;2018;08;10;Lauantai;19;6;25;3;3;6
293;18.08.2018;2018;08;11;Lauantai;19;18;37;4;4;8
293;18.08.2018;2018;08;12;Lauantai;23;24;47;5;4;9
293;18.08.2018;2018;08;13;Lauantai;34;18;52;11;6;17
293;18.08.2018;2018;08;14;Lauantai;17;33;50;2;3;5
293;18.08.2018;2018;08;15;Lauantai;23;23;46;3;5;8
293;18.08.2018;2018;08;16;Lauantai;31;20;51;6;5;11
293;18.08.2018;2018;08;17;Lauantai;29;39;68;4;8;12
293;18.08.2018;2018;08;18;Lauantai;28;34;62;4;4;8
293;18.08.2018;2018;08;19;Lauantai;35;36;71;4;6;10
293;18.08.2018;2018;08;20;Lauantai;41;26;67;8;0;8
293;18.08.2018;2018;08;21;Lauantai;8;15;23;0;5;5
293;18.08.2018;2018;08;22;Lauantai;11;5;16;5;2;7
293;18.08.2018;2018;08;23;Lauantai;5;7;12;0;0;0
293;19.08.2018;2018;08;00;Sunnuntai;9;11;20;0;0;0
293;19.08.2018;2018;08;01;Sunnuntai;3;4;7;0;1;1
293;19.08.2018;2018;08;02;Sunnuntai;0;0;0;1;1;2
293;19.08.2018;2018;08;03;Sunnuntai;0;1;1;0;0;0
293;19.08.2018;2018;08;04;Sunnuntai;0;2;2;0;0;0
293;19.08.2018;2018;08;05;Sunnuntai;1;1;2;0;1;1
293;19.08.2018;2018;08;06;Sunnuntai;3;0;3;4;0;4
293;19.08.2018;2018;08;07;Sunnuntai;1;1;2;1;1;2
293;19.08.2018;2018;08;08;Sunnuntai;5;2;7;3;1;4
293;19.08.2018;2018;08;09;Sunnuntai;5;8;13;4;4;8
293;19.08.2018;2018;08;10;Sunnuntai;17;17;34;6;7;13
293;19.08.2018;2018;08;11;Sunnuntai;31;15;46;4;4;8
293;19.08.2018;2018;08;12;Sunnuntai;28;27;55;4;3;7
293;19.08.2018;2018;08;13;Sunnuntai;29;20;49;2;4;6
293;19.08.2018;2018;08;14;Sunnuntai;34;36;70;11;2;13
293;19.08.2018;2018;08;15;Sunnuntai;24;17;41;4;7;11
293;19.08.2018;2018;08;16;Sunnuntai;19;17;36;7;3;10
293;19.08.2018;2018;08;17;Sunnuntai;35;30;65;5;4;9
293;19.08.2018;2018;08;18;Sunnuntai;28;32;60;3;5;8
293;19.08.2018;2018;08;19;Sunnuntai;20;24;44;7;5;12
293;19.08.2018;2018;08;20;Sunnuntai;9;18;27;2;1;3
293;19.08.2018;2018;08;21;Sunnuntai;0;11;11;1;0;1
293;19.08.2018;2018;08;22;Sunnuntai;2;1;3;1;1;2
293;19.08.2018;2018;08;23;Sunnuntai;0;0;0;0;0;0
293;20.08.2018;2018;08;00;Maanantai;0;0;0;0;0;0
293;20.08.2018;2018;08;01;Maanantai;0;0;0;0;0;0
293;20.08.2018;2018;08;02;Maanantai;0;0;0;0;0;0
293;20.08.2018;2018;08;03;Maanantai;0;1;1;0;0;0
293;20.08.2018;2018;08;04;Maanantai;0;0;0;0;0;0
293;20.08.2018;2018;08;05;Maanantai;0;0;0;0;0;0
293;20.08.2018;2018;08;06;Maanantai;17;3;20;0;0;0
293;20.08.2018;2018;08;07;Maanantai;140;9;149;7;1;8
293;20.08.2018;2018;08;08;Maanantai;74;19;93;2;2;4
293;20.08.2018;2018;08;09;Maanantai;40;11;51;11;2;13
293;20.08.2018;2018;08;10;Maanantai;13;10;23;3;2;5
293;20.08.2018;2018;08;11;Maanantai;18;8;26;2;2;4
293;20.08.2018;2018;08;12;Maanantai;20;19;39;0;1;1
293;20.08.2018;2018;08;13;Maanantai;20;38;58;1;3;4
293;20.08.2018;2018;08;14;Maanantai;21;120;141;3;6;9
293;20.08.2018;2018;08;15;Maanantai;18;89;107;1;4;5
293;20.08.2018;2018;08;16;Maanantai;24;39;63;6;3;9
293;20.08.2018;2018;08;17;Maanantai;23;18;41;3;7;10
293;20.08.2018;2018;08;18;Maanantai;26;27;53;7;2;9
293;20.08.2018;2018;08;19;Maanantai;27;19;46;3;4;7
293;20.08.2018;2018;08;20;Maanantai;24;37;61;2;0;2
293;20.08.2018;2018;08;21;Maanantai;6;16;22;3;1;4
293;20.08.2018;2018;08;22;Maanantai;3;3;6;0;0;0
293;20.08.2018;2018;08;23;Maanantai;0;0;0;0;0;0
293;21.08.2018;2018;08;00;Tiistai;0;0;0;0;0;0
293;21.08.2018;2018;08;01;Tiistai;0;0;0;0;0;0
293;21.08.2018;2018;08;02;Tiistai;0;0;0;0;0;0
293;21.08.2018;2018;08;03;Tiistai;0;1;1;0;0;0
293;21.08.2018;2018;08;04;Tiistai;0;1;1;0;0;0
293;21.08.2018;2018;08;05;Tiistai;1;0;1;0;0;0
293;21.08.2018;2018;08;06;Tiistai;17;4;21;1;0;1
293;21.08.2018;2018;08;07;Tiistai;135;6;141;11;0;11
293;21.08.2018;2018;08;08;Tiistai;92;18;110;10;0;10
293;21.08.2018;2018;08;09;Tiistai;21;11;32;43;3;46
293;21.08.2018;2018;08;10;Tiistai;16;16;32;3;42;45
293;21.08.2018;2018;08;11;Tiistai;13;11;24;1;5;6
293;21.08.2018;2018;08;12;Tiistai;11;13;24;7;5;12
293;21.08.2018;2018;08;13;Tiistai;21;47;68;4;3;7
293;21.08.2018;2018;08;14;Tiistai;23;100;123;3;8;11
293;21.08.2018;2018;08;15;Tiistai;15;101;116;4;7;11
293;21.08.2018;2018;08;16;Tiistai;23;37;60;4;9;13
293;21.08.2018;2018;08;17;Tiistai;28;29;57;8;5;13
293;21.08.2018;2018;08;18;Tiistai;21;22;43;7;4;11
293;21.08.2018;2018;08;19;Tiistai;24;28;52;10;9;19
293;21.08.2018;2018;08;20;Tiistai;16;17;33;3;5;8
293;21.08.2018;2018;08;21;Tiistai;2;5;7;2;1;3
293;21.08.2018;2018;08;22;Tiistai;0;1;1;0;0;0
293;21.08.2018;2018;08;23;Tiistai;0;0;0;1;0;1
293;22.08.2018;2018;08;00;Keskiviikko;0;0;0;0;0;0
293;22.08.2018;2018;08;01;Keskiviikko;0;0;0;0;0;0
293;22.08.2018;2018;08;02;Keskiviikko;0;0;0;0;0;0
293;22.08.2018;2018;08;03;Keskiviikko;0;1;1;0;0;0
293;22.08.2018;2018;08;04;Keskiviikko;0;1;1;1;0;1
293;22.08.2018;2018;08;05;Keskiviikko;2;0;2;0;1;1
293;22.08.2018;2018;08;06;Keskiviikko;20;4;24;2;0;2
293;22.08.2018;2018;08;07;Keskiviikko;104;12;116;5;0;5
293;22.08.2018;2018;08;08;Keskiviikko;116;11;127;7;1;8
293;22.08.2018;2018;08;09;Keskiviikko;21;12;33;2;1;3
293;22.08.2018;2018;08;10;Keskiviikko;12;17;29;5;2;7
293;22.08.2018;2018;08;11;Keskiviikko;17;20;37;5;2;7
293;22.08.2018;2018;08;12;Keskiviikko;11;22;33;1;6;7
293;22.08.2018;2018;08;13;Keskiviikko;20;58;78;1;3;4
293;22.08.2018;2018;08;14;Keskiviikko;26;131;157;6;7;13
293;22.08.2018;2018;08;15;Keskiviikko;14;56;70;2;2;4
293;22.08.2018;2018;08;16;Keskiviikko;21;32;53;4;4;8
293;22.08.2018;2018;08;17;Keskiviikko;31;23;54;2;1;3
293;22.08.2018;2018;08;18;Keskiviikko;23;22;45;10;6;16
293;22.08.2018;2018;08;19;Keskiviikko;17;23;40;4;2;6
293;22.08.2018;2018;08;20;Keskiviikko;8;16;24;3;4;7
293;22.08.2018;2018;08;21;Keskiviikko;1;12;13;0;3;3
293;22.08.2018;2018;08;22;Keskiviikko;0;0;0;0;0;0
293;22.08.2018;2018;08;23;Keskiviikko;1;0;1;1;0;1
293;23.08.2018;2018;08;00;Torstai;0;0;0;0;0;0
293;23.08.2018;2018;08;01;Torstai;1;0;1;0;0;0
293;23.08.2018;2018;08;02;Torstai;0;0;0;0;0;0
293;23.08.2018;2018;08;03;Torstai;0;0;0;0;0;0
293;23.08.2018;2018;08;04;Torstai;0;0;0;0;0;0
293;23.08.2018;2018;08;05;Torstai;1;0;1;0;0;0
293;23.08.2018;2018;08;06;Torstai;6;2;8;2;0;2
293;23.08.2018;2018;08;07;Torstai;110;4;114;8;2;10
293;23.08.2018;2018;08;08;Torstai;56;6;62;2;0;2
293;23.08.2018;2018;08;09;Torstai;13;2;15;2;1;3
293;23.08.2018;2018;08;10;Torstai;15;5;20;2;0;2
293;23.08.2018;2018;08;11;Torstai;3;4;7;1;0;1
293;23.08.2018;2018;08;12;Torstai;7;5;12;1;2;3
293;23.08.2018;2018;08;13;Torstai;15;46;61;3;4;7
293;23.08.2018;2018;08;14;Torstai;14;63;77;0;5;5
293;23.08.2018;2018;08;15;Torstai;19;91;110;2;7;9
293;23.08.2018;2018;08;16;Torstai;19;28;47;4;5;9
293;23.08.2018;2018;08;17;Torstai;19;19;38;5;3;8
293;23.08.2018;2018;08;18;Torstai;27;28;55;4;3;7
293;23.08.2018;2018;08;19;Torstai;21;17;38;7;6;13
293;23.08.2018;2018;08;20;Torstai;10;24;34;4;2;6
293;23.08.2018;2018;08;21;Torstai;0;14;14;2;3;5
293;23.08.2018;2018;08;22;Torstai;1;3;4;3;0;3
293;23.08.2018;2018;08;23;Torstai;0;0;0;0;1;1
293;24.08.2018;2018;08;00;Perjantai;0;0;0;0;0;0
293;24.08.2018;2018;08;01;Perjantai;0;0;0;0;0;0
293;24.08.2018;2018;08;02;Perjantai;0;1;1;0;0;0
293;24.08.2018;2018;08;03;Perjantai;0;0;0;0;0;0
293;24.08.2018;2018;08;04;Perjantai;0;0;0;0;0;0
293;24.08.2018;2018;08;05;Perjantai;0;0;0;0;0;0
293;24.08.2018;2018;08;06;Perjantai;15;3;18;0;0;0
293;24.08.2018;2018;08;07;Perjantai;120;4;124;5;0;5
293;24.08.2018;2018;08;08;Perjantai;46;12;58;6;3;9
293;24.08.2018;2018;08;09;Perjantai;26;4;30;1;0;1
293;24.08.2018;2018;08;10;Perjantai;10;5;15;5;1;6
293;24.08.2018;2018;08;11;Perjantai;5;4;9;0;0;0
293;24.08.2018;2018;08;12;Perjantai;8;28;36;1;0;1
293;24.08.2018;2018;08;13;Perjantai;12;59;71;0;5;5
293;24.08.2018;2018;08;14;Perjantai;13;83;96;1;10;11
293;24.08.2018;2018;08;15;Perjantai;9;40;49;0;1;1
293;24.08.2018;2018;08;16;Perjantai;9;13;22;1;0;1
293;24.08.2018;2018;08;17;Perjantai;17;23;40;3;1;4
293;24.08.2018;2018;08;18;Perjantai;36;16;52;2;8;10
293;24.08.2018;2018;08;19;Perjantai;19;18;37;3;1;4
293;24.08.2018;2018;08;20;Perjantai;14;20;34;3;1;4
293;24.08.2018;2018;08;21;Perjantai;1;9;10;0;2;2
293;24.08.2018;2018;08;22;Perjantai;4;6;10;3;1;4
293;24.08.2018;2018;08;23;Perjantai;1;7;8;0;0;0
293;25.08.2018;2018;08;00;Lauantai;0;2;2;0;3;3
293;25.08.2018;2018;08;01;Lauantai;1;4;5;0;1;1
293;25.08.2018;2018;08;02;Lauantai;0;2;2;1;1;2
293;25.08.2018;2018;08;03;Lauantai;0;0;0;2;1;3
293;25.08.2018;2018;08;04;Lauantai;0;0;0;0;0;0
293;25.08.2018;2018;08;05;Lauantai;0;0;0;0;0;0
293;25.08.2018;2018;08;06;Lauantai;3;0;3;0;1;1
293;25.08.2018;2018;08;07;Lauantai;1;1;2;1;0;1
293;25.08.2018;2018;08;08;Lauantai;5;3;8;4;2;6
293;25.08.2018;2018;08;09;Lauantai;5;3;8;2;1;3
293;25.08.2018;2018;08;10;Lauantai;4;5;9;2;0;2
293;25.08.2018;2018;08;11;Lauantai;15;11;26;2;3;5
293;25.08.2018;2018;08;12;Lauantai;25;9;34;2;0;2
293;25.08.2018;2018;08;13;Lauantai;13;17;30;6;5;11
293;25.08.2018;2018;08;14;Lauantai;23;20;43;3;2;5
293;25.08.2018;2018;08;15;Lauantai;24;20;44;6;5;11
293;25.08.2018;2018;08;16;Lauantai;21;21;42;3;2;5
293;25.08.2018;2018;08;17;Lauantai;16;18;34;6;8;14
293;25.08.2018;2018;08;18;Lauantai;17;19;36;6;5;11
293;25.08.2018;2018;08;19;Lauantai;23;9;32;2;4;6
293;25.08.2018;2018;08;20;Lauantai;17;22;39;2;3;5
293;25.08.2018;2018;08;21;Lauantai;13;13;26;1;3;4
293;25.08.2018;2018;08;22;Lauantai;0;5;5;2;1;3
293;25.08.2018;2018;08;23;Lauantai;7;9;16;1;2;3
293;26.08.2018;2018;08;00;Sunnuntai;1;2;3;0;0;0
293;26.08.2018;2018;08;01;Sunnuntai;0;5;5;0;0;0
293;26.08.2018;2018;08;02;Sunnuntai;3;1;4;0;2;2
293;26.08.2018;2018;08;03;Sunnuntai;1;0;1;0;2;2
293;26.08.2018;2018;08;04;Sunnuntai;0;1;1;0;1;1
293;26.08.2018;2018;08;05;Sunnuntai;0;1;1;1;0;1
293;26.08.2018;2018;08;06;Sunnuntai;3;0;3;0;0;0
293;26.08.2018;2018;08;07;Sunnuntai;4;1;5;2;0;2
293;26.08.2018;2018;08;08;Sunnuntai;6;2;8;0;5;5
293;26.08.2018;2018;08;09;Sunnuntai;9;3;12;1;0;1
293;26.08.2018;2018;08;10;Sunnuntai;16;13;29;3;3;6
293;26.08.2018;2018;08;11;Sunnuntai;11;15;26;7;3;10
293;26.08.2018;2018;08;12;Sunnuntai;35;17;52;5;3;8
293;26.08.2018;2018;08;13;Sunnuntai;25;29;54;2;8;10
293;26.08.2018;2018;08;14;Sunnuntai;42;13;55;2;3;5
293;26.08.2018;2018;08;15;Sunnuntai;18;34;52;3;1;4
293;26.08.2018;2018;08;16;Sunnuntai;8;14;22;2;0;2
293;26.08.2018;2018;08;17;Sunnuntai;9;7;16;1;0;1
293;26.08.2018;2018;08;18;Sunnuntai;6;14;20;1;1;2
293;26.08.2018;2018;08;19;Sunnuntai;13;9;22;3;4;7
293;26.08.2018;2018;08;20;Sunnuntai;0;6;6;1;2;3
293;26.08.2018;2018;08;21;Sunnuntai;2;6;8;1;0;1
293;26.08.2018;2018;08;22;Sunnuntai;0;1;1;0;1;1
293;26.08.2018;2018;08;23;Sunnuntai;0;0;0;0;0;0
293;27.08.2018;2018;08;00;Maanantai;0;0;0;0;0;0
293;27.08.2018;2018;08;01;Maanantai;0;0;0;0;0;0
293;27.08.2018;2018;08;02;Maanantai;0;0;0;0;0;0
293;27.08.2018;2018;08;03;Maanantai;0;0;0;0;0;0
293;27.08.2018;2018;08;04;Maanantai;0;0;0;0;0;0
293;27.08.2018;2018;08;05;Maanantai;0;0;0;0;0;0
293;27.08.2018;2018;08;06;Maanantai;8;3;11;1;1;2
293;27.08.2018;2018;08;07;Maanantai;103;5;108;0;0;0
293;27.08.2018;2018;08;08;Maanantai;71;9;80;10;2;12
293;27.08.2018;2018;08;09;Maanantai;25;10;35;2;0;2
293;27.08.2018;2018;08;10;Maanantai;16;5;21;1;1;2
293;27.08.2018;2018;08;11;Maanantai;8;5;13;2;2;4
293;27.08.2018;2018;08;12;Maanantai;7;12;19;1;0;1
293;27.08.2018;2018;08;13;Maanantai;15;42;57;4;6;10
293;27.08.2018;2018;08;14;Maanantai;14;79;93;2;10;12
293;27.08.2018;2018;08;15;Maanantai;23;81;104;3;10;13
293;27.08.2018;2018;08;16;Maanantai;22;32;54;4;4;8
293;27.08.2018;2018;08;17;Maanantai;38;31;69;6;6;12
293;27.08.2018;2018;08;18;Maanantai;36;26;62;2;2;4
293;27.08.2018;2018;08;19;Maanantai;27;24;51;5;4;9
293;27.08.2018;2018;08;20;Maanantai;10;45;55;3;2;5
293;27.08.2018;2018;08;21;Maanantai;2;6;8;0;2;2
293;27.08.2018;2018;08;22;Maanantai;0;1;1;1;0;1
293;27.08.2018;2018;08;23;Maanantai;0;1;1;1;0;1
293;28.08.2018;2018;08;00;Tiistai;0;0;0;0;0;0
293;28.08.2018;2018;08;01;Tiistai;0;0;0;0;0;0
293;28.08.2018;2018;08;02;Tiistai;0;0;0;0;0;0
293;28.08.2018;2018;08;03;Tiistai;0;0;0;0;0;0
293;28.08.2018;2018;08;04;Tiistai;0;0;0;1;0;1
293;28.08.2018;2018;08;05;Tiistai;1;0;1;0;0;0
293;28.08.2018;2018;08;06;Tiistai;19;3;22;1;0;1
293;28.08.2018;2018;08;07;Tiistai;113;10;123;3;0;3
293;28.08.2018;2018;08;08;Tiistai;99;12;111;2;0;2
293;28.08.2018;2018;08;09;Tiistai;14;10;24;2;2;4
293;28.08.2018;2018;08;10;Tiistai;18;11;29;6;3;9
293;28.08.2018;2018;08;11;Tiistai;10;13;23;1;2;3
293;28.08.2018;2018;08;12;Tiistai;17;18;35;4;3;7
293;28.08.2018;2018;08;13;Tiistai;22;33;55;5;6;11
293;28.08.2018;2018;08;14;Tiistai;21;104;125;2;4;6
293;28.08.2018;2018;08;15;Tiistai;17;75;92;5;9;14
293;28.08.2018;2018;08;16;Tiistai;25;28;53;3;2;5
293;28.08.2018;2018;08;17;Tiistai;40;37;77;5;3;8
293;28.08.2018;2018;08;18;Tiistai;33;31;64;2;10;12
293;28.08.2018;2018;08;19;Tiistai;16;31;47;4;8;12
293;28.08.2018;2018;08;20;Tiistai;5;29;34;4;6;10
293;28.08.2018;2018;08;21;Tiistai;1;5;6;1;4;5
293;28.08.2018;2018;08;22;Tiistai;1;0;1;1;1;2
293;28.08.2018;2018;08;23;Tiistai;1;0;1;0;0;0
293;29.08.2018;2018;08;00;Keskiviikko;0;0;0;0;0;0
293;29.08.2018;2018;08;01;Keskiviikko;0;0;0;0;0;0
293;29.08.2018;2018;08;02;Keskiviikko;0;0;0;0;0;0
293;29.08.2018;2018;08;03;Keskiviikko;0;0;0;0;0;0
293;29.08.2018;2018;08;04;Keskiviikko;0;0;0;0;0;0
293;29.08.2018;2018;08;05;Keskiviikko;2;0;2;0;0;0
293;29.08.2018;2018;08;06;Keskiviikko;18;2;20;0;0;0
293;29.08.2018;2018;08;07;Keskiviikko;102;8;110;7;2;9
293;29.08.2018;2018;08;08;Keskiviikko;106;14;120;11;0;11
293;29.08.2018;2018;08;09;Keskiviikko;26;11;37;1;0;1
293;29.08.2018;2018;08;10;Keskiviikko;15;7;22;4;3;7
293;29.08.2018;2018;08;11;Keskiviikko;14;17;31;4;3;7
293;29.08.2018;2018;08;12;Keskiviikko;12;10;22;0;1;1
293;29.08.2018;2018;08;13;Keskiviikko;17;61;78;5;3;8
293;29.08.2018;2018;08;14;Keskiviikko;13;143;156;5;16;21
293;29.08.2018;2018;08;15;Keskiviikko;15;44;59;0;8;8
293;29.08.2018;2018;08;16;Keskiviikko;29;28;57;3;6;9
293;29.08.2018;2018;08;17;Keskiviikko;29;35;64;5;1;6
293;29.08.2018;2018;08;18;Keskiviikko;24;30;54;7;2;9
293;29.08.2018;2018;08;19;Keskiviikko;37;28;65;5;5;10
293;29.08.2018;2018;08;20;Keskiviikko;19;26;45;4;4;8
293;29.08.2018;2018;08;21;Keskiviikko;2;9;11;0;1;1
293;29.08.2018;2018;08;22;Keskiviikko;1;3;4;0;0;0
293;29.08.2018;2018;08;23;Keskiviikko;1;0;1;0;0;0
293;30.08.2018;2018;08;00;Torstai;0;0;0;0;0;0
293;30.08.2018;2018;08;01;Torstai;0;0;0;0;0;0
293;30.08.2018;2018;08;02;Torstai;0;0;0;0;0;0
293;30.08.2018;2018;08;03;Torstai;0;0;0;0;0;0
293;30.08.2018;2018;08;04;Torstai;0;1;1;0;0;0
293;30.08.2018;2018;08;05;Torstai;1;0;1;0;0;0
293;30.08.2018;2018;08;06;Torstai;16;3;19;0;0;0
293;30.08.2018;2018;08;07;Torstai;72;9;81;5;0;5
293;30.08.2018;2018;08;08;Torstai;129;11;140;4;0;4
293;30.08.2018;2018;08;09;Torstai;33;8;41;2;3;5
293;30.08.2018;2018;08;10;Torstai;25;22;47;5;4;9
293;30.08.2018;2018;08;11;Torstai;16;15;31;4;1;5
293;30.08.2018;2018;08;12;Torstai;21;66;87;2;7;9
293;30.08.2018;2018;08;13;Torstai;19;57;76;4;6;10
293;30.08.2018;2018;08;14;Torstai;18;54;72;1;4;5
293;30.08.2018;2018;08;15;Torstai;12;83;95;1;3;4
293;30.08.2018;2018;08;16;Torstai;18;20;38;0;1;1
293;30.08.2018;2018;08;17;Torstai;24;18;42;6;1;7
293;30.08.2018;2018;08;18;Torstai;25;20;45;2;3;5
293;30.08.2018;2018;08;19;Torstai;18;14;32;2;2;4
293;30.08.2018;2018;08;20;Torstai;5;22;27;3;4;7
293;30.08.2018;2018;08;21;Torstai;5;14;19;1;3;4
293;30.08.2018;2018;08;22;Torstai;1;3;4;0;1;1
293;30.08.2018;2018;08;23;Torstai;0;1;1;0;0;0
293;31.08.2018;2018;08;00;Perjantai;1;0;1;0;0;0
293;31.08.2018;2018;08;01;Perjantai;0;0;0;0;0;0
293;31.08.2018;2018;08;02;Perjantai;0;0;0;0;0;0
293;31.08.2018;2018;08;03;Perjantai;0;0;0;0;0;0
293;31.08.2018;2018;08;04;Perjantai;0;0;0;0;0;0
293;31.08.2018;2018;08;05;Perjantai;1;0;1;0;0;0
293;31.08.2018;2018;08;06;Perjantai;8;2;10;1;0;1
293;31.08.2018;2018;08;07;Perjantai;131;7;138;9;1;10
293;31.08.2018;2018;08;08;Perjantai;60;12;72;6;0;6
293;31.08.2018;2018;08;09;Perjantai;42;10;52;2;3;5
293;31.08.2018;2018;08;10;Perjantai;14;12;26;5;3;8
293;31.08.2018;2018;08;11;Perjantai;17;17;34;2;0;2
293;31.08.2018;2018;08;12;Perjantai;11;39;50;5;5;10
293;31.08.2018;2018;08;13;Perjantai;19;63;82;3;3;6
293;31.08.2018;2018;08;14;Perjantai;21;97;118;5;3;8
293;31.08.2018;2018;08;15;Perjantai;14;62;76;6;2;8
293;31.08.2018;2018;08;16;Perjantai;22;29;51;1;1;2
293;31.08.2018;2018;08;17;Perjantai;38;31;69;5;4;9
293;31.08.2018;2018;08;18;Perjantai;25;34;59;3;5;8
293;31.08.2018;2018;08;19;Perjantai;27;28;55;5;2;7
293;31.08.2018;2018;08;20;Perjantai;16;31;47;1;3;4
293;31.08.2018;2018;08;21;Perjantai;8;15;23;1;2;3
293;31.08.2018;2018;08;22;Perjantai;10;10;20;0;2;2
293;31.08.2018;2018;08;23;Perjantai;11;10;21;0;1;1
293;01.09.2018;2018;09;00;Lauantai;6;8;14;0;0;0
293;01.09.2018;2018;09;01;Lauantai;0;0;0;0;0;0
293;01.09.2018;2018;09;02;Lauantai;0;3;3;0;1;1
293;01.09.2018;2018;09;03;Lauantai;0;0;0;0;1;1
293;01.09.2018;2018;09;04;Lauantai;0;3;3;0;0;0
293;01.09.2018;2018;09;05;Lauantai;1;2;3;0;0;0
293;01.09.2018;2018;09;06;Lauantai;3;0;3;0;0;0
293;01.09.2018;2018;09;07;Lauantai;2;1;3;2;1;3
293;01.09.2018;2018;09;08;Lauantai;5;0;5;3;1;4
293;01.09.2018;2018;09;09;Lauantai;5;8;13;2;4;6
293;01.09.2018;2018;09;10;Lauantai;13;8;21;7;6;13
293;01.09.2018;2018;09;11;Lauantai;28;14;42;2;1;3
293;01.09.2018;2018;09;12;Lauantai;18;23;41;4;5;9
293;01.09.2018;2018;09;13;Lauantai;29;30;59;4;4;8
293;01.09.2018;2018;09;14;Lauantai;32;45;77;8;3;11
293;01.09.2018;2018;09;15;Lauantai;34;27;61;3;3;6
293;01.09.2018;2018;09;16;Lauantai;26;24;50;4;5;9
293;01.09.2018;2018;09;17;Lauantai;30;28;58;3;1;4
293;01.09.2018;2018;09;18;Lauantai;25;23;48;7;4;11
293;01.09.2018;2018;09;19;Lauantai;22;20;42;1;3;4
293;01.09.2018;2018;09;20;Lauantai;14;14;28;2;1;3
293;01.09.2018;2018;09;21;Lauantai;12;23;35;1;3;4
293;01.09.2018;2018;09;22;Lauantai;8;8;16;1;0;1
293;01.09.2018;2018;09;23;Lauantai;1;7;8;0;2;2
293;02.09.2018;2018;09;00;Sunnuntai;1;8;9;2;3;5
293;02.09.2018;2018;09;01;Sunnuntai;3;4;7;0;0;0
293;02.09.2018;2018;09;02;Sunnuntai;0;3;3;0;1;1
293;02.09.2018;2018;09;03;Sunnuntai;2;2;4;1;3;4
293;02.09.2018;2018;09;04;Sunnuntai;1;2;3;0;1;1
293;02.09.2018;2018;09;05;Sunnuntai;0;0;0;3;1;4
293;02.09.2018;2018;09;06;Sunnuntai;5;2;7;0;1;1
293;02.09.2018;2018;09;07;Sunnuntai;3;0;3;0;0;0
293;02.09.2018;2018;09;08;Sunnuntai;2;3;5;2;3;5
293;02.09.2018;2018;09;09;Sunnuntai;9;7;16;9;6;15
293;02.09.2018;2018;09;10;Sunnuntai;15;11;26;7;5;12
293;02.09.2018;2018;09;11;Sunnuntai;19;16;35;4;3;7
293;02.09.2018;2018;09;12;Sunnuntai;36;18;54;3;3;6
293;02.09.2018;2018;09;13;Sunnuntai;31;38;69;11;4;15
293;02.09.2018;2018;09;14;Sunnuntai;29;26;55;8;3;11
293;02.09.2018;2018;09;15;Sunnuntai;32;33;65;2;4;6
293;02.09.2018;2018;09;16;Sunnuntai;35;24;59;2;2;4
293;02.09.2018;2018;09;17;Sunnuntai;33;30;63;2;6;8
293;02.09.2018;2018;09;18;Sunnuntai;23;19;42;9;3;12
293;02.09.2018;2018;09;19;Sunnuntai;19;25;44;8;4;12
293;02.09.2018;2018;09;20;Sunnuntai;6;19;25;2;6;8
293;02.09.2018;2018;09;21;Sunnuntai;3;6;9;0;3;3
293;02.09.2018;2018;09;22;Sunnuntai;2;0;2;0;1;1
293;02.09.2018;2018;09;23;Sunnuntai;0;0;0;1;0;1
293;03.09.2018;2018;09;00;Maanantai;0;0;0;0;0;0
293;03.09.2018;2018;09;01;Maanantai;0;0;0;0;0;0
293;03.09.2018;2018;09;02;Maanantai;0;0;0;0;0;0
293;03.09.2018;2018;09;03;Maanantai;0;0;0;0;0;0
293;03.09.2018;2018;09;04;Maanantai;0;0;0;0;0;0
293;03.09.2018;2018;09;05;Maanantai;1;0;1;0;0;0
293;03.09.2018;2018;09;06;Maanantai;18;1;19;2;0;2
293;03.09.2018;2018;09;07;Maanantai;103;4;107;10;1;11
293;03.09.2018;2018;09;08;Maanantai;90;16;106;10;0;10
293;03.09.2018;2018;09;09;Maanantai;32;10;42;1;3;4
293;03.09.2018;2018;09;10;Maanantai;14;8;22;4;6;10
293;03.09.2018;2018;09;11;Maanantai;20;16;36;2;2;4
293;03.09.2018;2018;09;12;Maanantai;17;25;42;4;4;8
293;03.09.2018;2018;09;13;Maanantai;16;53;69;1;4;5
293;03.09.2018;2018;09;14;Maanantai;22;105;127;9;6;15
293;03.09.2018;2018;09;15;Maanantai;14;83;97;7;6;13
293;03.09.2018;2018;09;16;Maanantai;28;31;59;5;7;12
293;03.09.2018;2018;09;17;Maanantai;30;37;67;6;6;12
293;03.09.2018;2018;09;18;Maanantai;27;33;60;13;11;24
293;03.09.2018;2018;09;19;Maanantai;21;37;58;6;8;14
293;03.09.2018;2018;09;20;Maanantai;17;24;41;5;5;10
293;03.09.2018;2018;09;21;Maanantai;6;8;14;0;0;0
293;03.09.2018;2018;09;22;Maanantai;0;2;2;0;1;1
293;03.09.2018;2018;09;23;Maanantai;0;0;0;0;0;0
293;04.09.2018;2018;09;00;Tiistai;0;0;0;0;0;0
293;04.09.2018;2018;09;01;Tiistai;0;0;0;0;0;0
293;04.09.2018;2018;09;02;Tiistai;0;0;0;0;0;0
293;04.09.2018;2018;09;03;Tiistai;0;1;1;0;0;0
293;04.09.2018;2018;09;04;Tiistai;1;1;2;0;0;0
293;04.09.2018;2018;09;05;Tiistai;4;1;5;0;0;0
293;04.09.2018;2018;09;06;Tiistai;18;1;19;1;0;1
293;04.09.2018;2018;09;07;Tiistai;103;7;110;4;1;5
293;04.09.2018;2018;09;08;Tiistai;106;6;112;10;1;11
293;04.09.2018;2018;09;09;Tiistai;33;9;42;1;1;2
293;04.09.2018;2018;09;10;Tiistai;13;17;30;4;7;11
293;04.09.2018;2018;09;11;Tiistai;16;11;27;4;3;7
293;04.09.2018;2018;09;12;Tiistai;21;22;43;3;2;5
293;04.09.2018;2018;09;13;Tiistai;11;42;53;2;4;6
293;04.09.2018;2018;09;14;Tiistai;6;90;96;4;7;11
293;04.09.2018;2018;09;15;Tiistai;31;103;134;4;4;8
293;04.09.2018;2018;09;16;Tiistai;14;36;50;2;3;5
293;04.09.2018;2018;09;17;Tiistai;39;28;67;3;3;6
293;04.09.2018;2018;09;18;Tiistai;34;28;62;6;6;12
293;04.09.2018;2018;09;19;Tiistai;25;31;56;9;6;15
293;04.09.2018;2018;09;20;Tiistai;10;30;40;5;2;7
293;04.09.2018;2018;09;21;Tiistai;4;11;15;1;0;1
293;04.09.2018;2018;09;22;Tiistai;0;3;3;0;0;0
293;04.09.2018;2018;09;23;Tiistai;0;0;0;1;0;1
293;05.09.2018;2018;09;00;Keskiviikko;0;0;0;0;0;0
293;05.09.2018;2018;09;01;Keskiviikko;0;0;0;0;0;0
293;05.09.2018;2018;09;02;Keskiviikko;0;0;0;0;0;0
293;05.09.2018;2018;09;03;Keskiviikko;0;0;0;0;0;0
293;05.09.2018;2018;09;04;Keskiviikko;0;3;3;0;0;0
293;05.09.2018;2018;09;05;Keskiviikko;2;0;2;0;0;0
293;05.09.2018;2018;09;06;Keskiviikko;26;1;27;0;0;0
293;05.09.2018;2018;09;07;Keskiviikko;104;9;113;5;0;5
293;05.09.2018;2018;09;08;Keskiviikko;107;17;124;12;1;13
293;05.09.2018;2018;09;09;Keskiviikko;16;13;29;5;2;7
293;05.09.2018;2018;09;10;Keskiviikko;17;10;27;7;4;11
293;05.09.2018;2018;09;11;Keskiviikko;11;8;19;2;3;5
293;05.09.2018;2018;09;12;Keskiviikko;8;22;30;2;3;5
293;05.09.2018;2018;09;13;Keskiviikko;21;44;65;0;5;5
293;05.09.2018;2018;09;14;Keskiviikko;24;144;168;5;9;14
293;05.09.2018;2018;09;15;Keskiviikko;12;43;55;1;4;5
293;05.09.2018;2018;09;16;Keskiviikko;22;33;55;4;1;5
293;05.09.2018;2018;09;17;Keskiviikko;35;30;65;5;4;9
293;05.09.2018;2018;09;18;Keskiviikko;26;25;51;7;4;11
293;05.09.2018;2018;09;19;Keskiviikko;21;37;58;6;8;14
293;05.09.2018;2018;09;20;Keskiviikko;10;27;37;2;1;3
293;05.09.2018;2018;09;21;Keskiviikko;3;12;15;0;3;3
293;05.09.2018;2018;09;22;Keskiviikko;2;0;2;1;0;1
293;05.09.2018;2018;09;23;Keskiviikko;0;0;0;0;0;0
293;06.09.2018;2018;09;00;Torstai;1;2;3;0;1;1
293;06.09.2018;2018;09;01;Torstai;0;0;0;0;0;0
293;06.09.2018;2018;09;02;Torstai;0;0;0;0;0;0
293;06.09.2018;2018;09;03;Torstai;0;2;2;0;0;0
293;06.09.2018;2018;09;04;Torstai;0;0;0;0;0;0
293;06.09.2018;2018;09;05;Torstai;1;0;1;0;0;0
293;06.09.2018;2018;09;06;Torstai;14;2;16;2;0;2
293;06.09.2018;2018;09;07;Torstai;111;7;118;5;0;5
293;06.09.2018;2018;09;08;Torstai;76;7;83;3;0;3
293;06.09.2018;2018;09;09;Torstai;31;11;42;3;4;7
293;06.09.2018;2018;09;10;Torstai;26;18;44;4;6;10
293;06.09.2018;2018;09;11;Torstai;12;16;28;7;2;9
293;06.09.2018;2018;09;12;Torstai;24;15;39;2;5;7
293;06.09.2018;2018;09;13;Torstai;8;57;65;4;3;7
293;06.09.2018;2018;09;14;Torstai;23;65;88;3;1;4
293;06.09.2018;2018;09;15;Torstai;15;111;126;1;10;11
293;06.09.2018;2018;09;16;Torstai;23;38;61;3;4;7
293;06.09.2018;2018;09;17;Torstai;27;28;55;2;1;3
293;06.09.2018;2018;09;18;Torstai;21;27;48;5;4;9
293;06.09.2018;2018;09;19;Torstai;23;29;52;5;4;9
293;06.09.2018;2018;09;20;Torstai;17;24;41;1;0;1
293;06.09.2018;2018;09;21;Torstai;2;11;13;0;1;1
293;06.09.2018;2018;09;22;Torstai;0;2;2;0;2;2
293;06.09.2018;2018;09;23;Torstai;0;0;0;1;0;1
293;07.09.2018;2018;09;00;Perjantai;0;0;0;0;0;0
293;07.09.2018;2018;09;01;Perjantai;0;0;0;0;0;0
293;07.09.2018;2018;09;02;Perjantai;0;0;0;0;0;0
293;07.09.2018;2018;09;03;Perjantai;0;0;0;0;2;2
293;07.09.2018;2018;09;04;Perjantai;0;1;1;1;0;1
293;07.09.2018;2018;09;05;Perjantai;1;0;1;0;1;1
293;07.09.2018;2018;09;06;Perjantai;12;0;12;0;0;0
293;07.09.2018;2018;09;07;Perjantai;117;7;124;3;0;3
293;07.09.2018;2018;09;08;Perjantai;68;10;78;1;1;2
293;07.09.2018;2018;09;09;Perjantai;36;17;53;4;2;6
293;07.09.2018;2018;09;10;Perjantai;11;10;21;1;2;3
293;07.09.2018;2018;09;11;Perjantai;15;14;29;2;1;3
293;07.09.2018;2018;09;12;Perjantai;16;33;49;3;3;6
293;07.09.2018;2018;09;13;Perjantai;24;89;113;3;7;10
293;07.09.2018;2018;09;14;Perjantai;18;85;103;8;12;20
293;07.09.2018;2018;09;15;Perjantai;24;41;65;5;3;8
293;07.09.2018;2018;09;16;Perjantai;31;36;67;2;4;6
293;07.09.2018;2018;09;17;Perjantai;28;22;50;4;6;10
293;07.09.2018;2018;09;18;Perjantai;34;43;77;12;4;16
293;07.09.2018;2018;09;19;Perjantai;10;27;37;5;5;10
293;07.09.2018;2018;09;20;Perjantai;21;15;36;2;6;8
293;07.09.2018;2018;09;21;Perjantai;8;20;28;3;2;5
293;07.09.2018;2018;09;22;Perjantai;10;11;21;1;0;1
293;07.09.2018;2018;09;23;Perjantai;9;10;19;0;0;0
293;08.09.2018;2018;09;00;Lauantai;0;3;3;0;1;1
293;08.09.2018;2018;09;01;Lauantai;0;0;0;0;0;0
293;08.09.2018;2018;09;02;Lauantai;0;0;0;0;0;0
293;08.09.2018;2018;09;03;Lauantai;0;1;1;0;0;0
293;08.09.2018;2018;09;04;Lauantai;0;0;0;0;0;0
293;08.09.2018;2018;09;05;Lauantai;2;1;3;1;0;1
293;08.09.2018;2018;09;06;Lauantai;2;2;4;0;0;0
293;08.09.2018;2018;09;07;Lauantai;5;1;6;2;1;3
293;08.09.2018;2018;09;08;Lauantai;13;4;17;2;1;3
293;08.09.2018;2018;09;09;Lauantai;8;9;17;7;3;10
293;08.09.2018;2018;09;10;Lauantai;14;9;23;3;2;5
293;08.09.2018;2018;09;11;Lauantai;29;16;45;4;5;9
293;08.09.2018;2018;09;12;Lauantai;23;21;44;6;3;9
293;08.09.2018;2018;09;13;Lauantai;18;24;42;4;3;7
293;08.09.2018;2018;09;14;Lauantai;20;36;56;3;1;4
293;08.09.2018;2018;09;15;Lauantai;20;17;37;0;2;2
293;08.09.2018;2018;09;16;Lauantai;25;22;47;11;9;20
293;08.09.2018;2018;09;17;Lauantai;37;27;64;5;5;10
293;08.09.2018;2018;09;18;Lauantai;25;15;40;3;3;6
293;08.09.2018;2018;09;19;Lauantai;14;27;41;6;9;15
293;08.09.2018;2018;09;20;Lauantai;16;14;30;4;5;9
293;08.09.2018;2018;09;21;Lauantai;7;18;25;3;1;4
293;08.09.2018;2018;09;22;Lauantai;11;3;14;2;6;8
293;08.09.2018;2018;09;23;Lauantai;1;8;9;1;0;1
293;09.09.2018;2018;09;00;Sunnuntai;2;9;11;2;1;3
293;09.09.2018;2018;09;01;Sunnuntai;1;0;1;1;0;1
293;09.09.2018;2018;09;02;Sunnuntai;0;0;0;0;1;1
293;09.09.2018;2018;09;03;Sunnuntai;0;1;1;1;1;2
293;09.09.2018;2018;09;04;Sunnuntai;0;0;0;0;3;3
293;09.09.2018;2018;09;05;Sunnuntai;2;0;2;0;0;0
293;09.09.2018;2018;09;06;Sunnuntai;3;2;5;0;0;0
293;09.09.2018;2018;09;07;Sunnuntai;1;1;2;1;1;2
293;09.09.2018;2018;09;08;Sunnuntai;4;2;6;1;1;2
293;09.09.2018;2018;09;09;Sunnuntai;6;4;10;2;4;6
293;09.09.2018;2018;09;10;Sunnuntai;14;11;25;9;1;10
293;09.09.2018;2018;09;11;Sunnuntai;22;8;30;6;6;12
293;09.09.2018;2018;09;12;Sunnuntai;18;16;34;8;5;13
293;09.09.2018;2018;09;13;Sunnuntai;11;23;34;3;4;7
293;09.09.2018;2018;09;14;Sunnuntai;19;13;32;12;4;16
293;09.09.2018;2018;09;15;Sunnuntai;26;32;58;8;7;15
293;09.09.2018;2018;09;16;Sunnuntai;22;20;42;1;5;6
293;09.09.2018;2018;09;17;Sunnuntai;23;24;47;0;2;2
293;09.09.2018;2018;09;18;Sunnuntai;22;20;42;7;1;8
293;09.09.2018;2018;09;19;Sunnuntai;22;16;38;2;1;3
293;09.09.2018;2018;09;20;Sunnuntai;4;17;21;2;2;4
293;09.09.2018;2018;09;21;Sunnuntai;2;6;8;2;4;6
293;09.09.2018;2018;09;22;Sunnuntai;1;2;3;0;0;0
293;09.09.2018;2018;09;23;Sunnuntai;0;0;0;0;0;0
293;10.09.2018;2018;09;00;Maanantai;0;0;0;1;0;1
293;10.09.2018;2018;09;01;Maanantai;0;0;0;0;0;0
293;10.09.2018;2018;09;02;Maanantai;0;0;0;0;0;0
293;10.09.2018;2018;09;03;Maanantai;0;0;0;0;0;0
293;10.09.2018;2018;09;04;Maanantai;0;0;0;0;0;0
293;10.09.2018;2018;09;05;Maanantai;4;2;6;0;0;0
293;10.09.2018;2018;09;06;Maanantai;17;2;19;1;0;1
293;10.09.2018;2018;09;07;Maanantai;107;5;112;1;0;1
293;10.09.2018;2018;09;08;Maanantai;95;14;109;8;0;8
293;10.09.2018;2018;09;09;Maanantai;28;8;36;2;0;2
293;10.09.2018;2018;09;10;Maanantai;17;7;24;2;4;6
293;10.09.2018;2018;09;11;Maanantai;11;15;26;2;1;3
293;10.09.2018;2018;09;12;Maanantai;14;48;62;4;8;12
293;10.09.2018;2018;09;13;Maanantai;13;59;72;1;5;6
293;10.09.2018;2018;09;14;Maanantai;30;96;126;5;9;14
293;10.09.2018;2018;09;15;Maanantai;25;77;102;0;6;6
293;10.09.2018;2018;09;16;Maanantai;26;26;52;6;3;9
293;10.09.2018;2018;09;17;Maanantai;31;38;69;4;6;10
293;10.09.2018;2018;09;18;Maanantai;24;34;58;8;3;11
293;10.09.2018;2018;09;19;Maanantai;20;25;45;3;8;11
293;10.09.2018;2018;09;20;Maanantai;14;27;41;0;3;3
293;10.09.2018;2018;09;21;Maanantai;1;14;15;0;1;1
293;10.09.2018;2018;09;22;Maanantai;2;2;4;0;0;0
293;10.09.2018;2018;09;23;Maanantai;0;0;0;0;0;0
293;11.09.2018;2018;09;00;Tiistai;0;0;0;0;0;0
293;11.09.2018;2018;09;01;Tiistai;0;0;0;0;0;0
293;11.09.2018;2018;09;02;Tiistai;0;0;0;0;0;0
293;11.09.2018;2018;09;03;Tiistai;0;1;1;0;0;0
293;11.09.2018;2018;09;04;Tiistai;1;0;1;0;0;0
293;11.09.2018;2018;09;05;Tiistai;1;0;1;0;0;0
293;11.09.2018;2018;09;06;Tiistai;12;3;15;0;0;0
293;11.09.2018;2018;09;07;Tiistai;90;4;94;2;1;3
293;11.09.2018;2018;09;08;Tiistai;109;13;122;6;0;6
293;11.09.2018;2018;09;09;Tiistai;22;8;30;4;3;7
293;11.09.2018;2018;09;10;Tiistai;16;12;28;1;3;4
293;11.09.2018;2018;09;11;Tiistai;5;7;12;2;4;6
293;11.09.2018;2018;09;12;Tiistai;10;17;27;2;6;8
293;11.09.2018;2018;09;13;Tiistai;11;53;64;5;3;8
293;11.09.2018;2018;09;14;Tiistai;17;84;101;2;3;5
293;11.09.2018;2018;09;15;Tiistai;8;75;83;2;3;5
293;11.09.2018;2018;09;16;Tiistai;1;7;8;1;3;4
293;11.09.2018;2018;09;17;Tiistai;5;4;9;1;0;1
293;11.09.2018;2018;09;18;Tiistai;3;6;9;0;1;1
293;11.09.2018;2018;09;19;Tiistai;5;3;8;2;1;3
293;11.09.2018;2018;09;20;Tiistai;0;2;2;0;0;0
293;11.09.2018;2018;09;21;Tiistai;1;3;4;0;0;0
293;11.09.2018;2018;09;22;Tiistai;0;0;0;0;0;0
293;11.09.2018;2018;09;23;Tiistai;0;0;0;0;0;0
293;12.09.2018;2018;09;00;Keskiviikko;0;0;0;0;0;0
293;12.09.2018;2018;09;01;Keskiviikko;0;0;0;0;0;0
293;12.09.2018;2018;09;02;Keskiviikko;0;0;0;0;0;0
293;12.09.2018;2018;09;03;Keskiviikko;0;0;0;0;0;0
293;12.09.2018;2018;09;04;Keskiviikko;0;0;0;0;0;0
293;12.09.2018;2018;09;05;Keskiviikko;1;1;2;0;0;0
293;12.09.2018;2018;09;06;Keskiviikko;5;1;6;1;0;1
293;12.09.2018;2018;09;07;Keskiviikko;68;2;70;7;1;8
293;12.09.2018;2018;09;08;Keskiviikko;120;6;126;14;1;15
293;12.09.2018;2018;09;09;Keskiviikko;10;5;15;2;1;3
293;12.09.2018;2018;09;10;Keskiviikko;12;28;40;4;5;9
293;12.09.2018;2018;09;11;Keskiviikko;7;8;15;2;0;2
293;12.09.2018;2018;09;12;Keskiviikko;5;13;18;1;2;3
293;12.09.2018;2018;09;13;Keskiviikko;9;33;42;2;3;5
293;12.09.2018;2018;09;14;Keskiviikko;10;120;130;1;6;7
293;12.09.2018;2018;09;15;Keskiviikko;2;23;25;1;2;3
293;12.09.2018;2018;09;16;Keskiviikko;11;9;20;3;2;5
293;12.09.2018;2018;09;17;Keskiviikko;16;7;23;1;2;3
293;12.09.2018;2018;09;18;Keskiviikko;8;12;20;4;4;8
293;12.09.2018;2018;09;19;Keskiviikko;10;13;23;4;6;10
293;12.09.2018;2018;09;20;Keskiviikko;4;10;14;1;3;4
293;12.09.2018;2018;09;21;Keskiviikko;2;6;8;0;0;0
293;12.09.2018;2018;09;22;Keskiviikko;0;1;1;0;0;0
293;12.09.2018;2018;09;23;Keskiviikko;0;0;0;0;0;0
293;13.09.2018;2018;09;00;Torstai;0;0;0;0;0;0
293;13.09.2018;2018;09;01;Torstai;0;0;0;0;0;0
293;13.09.2018;2018;09;02;Torstai;0;0;0;0;0;0
293;13.09.2018;2018;09;03;Torstai;0;1;1;0;0;0
293;13.09.2018;2018;09;04;Torstai;0;0;0;0;0;0
293;13.09.2018;2018;09;05;Torstai;1;0;1;0;0;0
293;13.09.2018;2018;09;06;Torstai;14;2;16;0;0;0
293;13.09.2018;2018;09;07;Torstai;91;9;100;12;0;12
293;13.09.2018;2018;09;08;Torstai;80;7;87;8;3;11
293;13.09.2018;2018;09;09;Torstai;38;14;52;3;2;5
293;13.09.2018;2018;09;10;Torstai;17;12;29;2;1;3
293;13.09.2018;2018;09;11;Torstai;12;9;21;6;2;8
293;13.09.2018;2018;09;12;Torstai;18;13;31;3;4;7
293;13.09.2018;2018;09;13;Torstai;15;51;66;4;7;11
293;13.09.2018;2018;09;14;Torstai;17;57;74;3;5;8
293;13.09.2018;2018;09;15;Torstai;24;107;131;2;5;7
293;13.09.2018;2018;09;16;Torstai;26;33;59;3;3;6
293;13.09.2018;2018;09;17;Torstai;33;28;61;4;4;8
293;13.09.2018;2018;09;18;Torstai;16;20;36;6;5;11
293;13.09.2018;2018;09;19;Torstai;27;29;56;6;5;11
293;13.09.2018;2018;09;20;Torstai;15;28;43;6;4;10
293;13.09.2018;2018;09;21;Torstai;3;11;14;0;0;0
293;13.09.2018;2018;09;22;Torstai;0;4;4;0;0;0
293;13.09.2018;2018;09;23;Torstai;5;0;5;0;0;0
293;14.09.2018;2018;09;00;Perjantai;0;3;3;0;0;0
293;14.09.2018;2018;09;01;Perjantai;0;0;0;0;0;0
293;14.09.2018;2018;09;02;Perjantai;0;0;0;0;1;1
293;14.09.2018;2018;09;03;Perjantai;0;0;0;0;0;0
293;14.09.2018;2018;09;04;Perjantai;1;0;1;0;0;0
293;14.09.2018;2018;09;05;Perjantai;2;2;4;0;0;0
293;14.09.2018;2018;09;06;Perjantai;7;3;10;1;1;2
293;14.09.2018;2018;09;07;Perjantai;106;4;110;7;1;8
293;14.09.2018;2018;09;08;Perjantai;60;6;66;6;4;10
293;14.09.2018;2018;09;09;Perjantai;48;8;56;6;2;8
293;14.09.2018;2018;09;10;Perjantai;18;15;33;2;2;4
293;14.09.2018;2018;09;11;Perjantai;6;44;50;2;5;7
293;14.09.2018;2018;09;12;Perjantai;19;24;43;6;2;8
293;14.09.2018;2018;09;13;Perjantai;22;64;86;1;8;9
293;14.09.2018;2018;09;14;Perjantai;28;98;126;10;4;14
293;14.09.2018;2018;09;15;Perjantai;18;53;71;5;6;11
293;14.09.2018;2018;09;16;Perjantai;18;16;34;3;4;7
293;14.09.2018;2018;09;17;Perjantai;18;20;38;0;3;3
293;14.09.2018;2018;09;18;Perjantai;11;16;27;0;0;0
293;14.09.2018;2018;09;19;Perjantai;8;9;17;1;2;3
293;14.09.2018;2018;09;20;Perjantai;5;16;21;3;2;5
293;14.09.2018;2018;09;21;Perjantai;7;10;17;1;2;3
293;14.09.2018;2018;09;22;Perjantai;9;10;19;1;2;3
293;14.09.2018;2018;09;23;Perjantai;1;2;3;0;3;3
293;15.09.2018;2018;09;00;Lauantai;1;5;6;0;0;0
293;15.09.2018;2018;09;01;Lauantai;0;2;2;0;0;0
293;15.09.2018;2018;09;02;Lauantai;1;0;1;0;0;0
293;15.09.2018;2018;09;03;Lauantai;0;0;0;0;0;0
293;15.09.2018;2018;09;04;Lauantai;0;1;1;0;0;0
293;15.09.2018;2018;09;05;Lauantai;1;0;1;1;2;3
293;15.09.2018;2018;09;06;Lauantai;2;1;3;0;0;0
293;15.09.2018;2018;09;07;Lauantai;1;0;1;1;0;1
293;15.09.2018;2018;09;08;Lauantai;5;3;8;4;2;6
293;15.09.2018;2018;09;09;Lauantai;5;4;9;5;2;7
293;15.09.2018;2018;09;10;Lauantai;13;8;21;5;0;5
293;15.09.2018;2018;09;11;Lauantai;11;9;20;4;6;10
293;15.09.2018;2018;09;12;Lauantai;16;14;30;3;3;6
293;15.09.2018;2018;09;13;Lauantai;8;9;17;2;1;3
293;15.09.2018;2018;09;14;Lauantai;6;8;14;1;3;4
293;15.09.2018;2018;09;15;Lauantai;6;7;13;1;0;1
293;15.09.2018;2018;09;16;Lauantai;5;7;12;1;2;3
293;15.09.2018;2018;09;17;Lauantai;5;4;9;1;4;5
293;15.09.2018;2018;09;18;Lauantai;12;8;20;3;1;4
293;15.09.2018;2018;09;19;Lauantai;4;8;12;1;3;4
293;15.09.2018;2018;09;20;Lauantai;14;3;17;2;4;6
293;15.09.2018;2018;09;21;Lauantai;6;11;17;3;2;5
293;15.09.2018;2018;09;22;Lauantai;4;10;14;0;0;0
293;15.09.2018;2018;09;23;Lauantai;4;4;8;0;0;0
293;16.09.2018;2018;09;00;Sunnuntai;0;1;1;0;2;2
293;16.09.2018;2018;09;01;Sunnuntai;2;1;3;0;0;0
293;16.09.2018;2018;09;02;Sunnuntai;1;0;1;0;1;1
293;16.09.2018;2018;09;03;Sunnuntai;1;0;1;2;1;3
293;16.09.2018;2018;09;04;Sunnuntai;0;0;0;1;1;2
293;16.09.2018;2018;09;05;Sunnuntai;0;0;0;0;1;1
293;16.09.2018;2018;09;06;Sunnuntai;3;0;3;1;0;1
293;16.09.2018;2018;09;07;Sunnuntai;0;0;0;0;3;3
293;16.09.2018;2018;09;08;Sunnuntai;2;1;3;3;1;4
293;16.09.2018;2018;09;09;Sunnuntai;10;3;13;3;2;5
293;16.09.2018;2018;09;10;Sunnuntai;12;16;28;14;8;22
293;16.09.2018;2018;09;11;Sunnuntai;17;21;38;5;9;14
293;16.09.2018;2018;09;12;Sunnuntai;26;16;42;10;2;12
293;16.09.2018;2018;09;13;Sunnuntai;14;12;26;4;5;9
293;16.09.2018;2018;09;14;Sunnuntai;13;19;32;2;7;9
293;16.09.2018;2018;09;15;Sunnuntai;23;33;56;3;4;7
293;16.09.2018;2018;09;16;Sunnuntai;15;23;38;3;4;7
293;16.09.2018;2018;09;17;Sunnuntai;26;16;42;1;2;3
293;16.09.2018;2018;09;18;Sunnuntai;16;18;34;7;4;11
293;16.09.2018;2018;09;19;Sunnuntai;12;10;22;4;1;5
293;16.09.2018;2018;09;20;Sunnuntai;4;6;10;2;5;7
293;16.09.2018;2018;09;21;Sunnuntai;1;2;3;2;0;2
293;16.09.2018;2018;09;22;Sunnuntai;0;1;1;1;1;2
293;16.09.2018;2018;09;23;Sunnuntai;0;0;0;0;1;1
293;17.09.2018;2018;09;00;Maanantai;0;0;0;0;0;0
293;17.09.2018;2018;09;01;Maanantai;0;0;0;0;0;0
293;17.09.2018;2018;09;02;Maanantai;0;0;0;0;0;0
293;17.09.2018;2018;09;03;Maanantai;0;0;0;0;0;0
293;17.09.2018;2018;09;04;Maanantai;0;0;0;0;0;0
293;17.09.2018;2018;09;05;Maanantai;1;0;1;0;0;0
293;17.09.2018;2018;09;06;Maanantai;13;1;14;0;0;0
293;17.09.2018;2018;09;07;Maanantai;100;7;107;8;0;8
293;17.09.2018;2018;09;08;Maanantai;84;13;97;10;2;12
293;17.09.2018;2018;09;09;Maanantai;28;8;36;5;0;5
293;17.09.2018;2018;09;10;Maanantai;15;3;18;9;2;11
293;17.09.2018;2018;09;11;Maanantai;11;13;24;5;5;10
293;17.09.2018;2018;09;12;Maanantai;15;22;37;1;2;3
293;17.09.2018;2018;09;13;Maanantai;15;40;55;3;2;5
293;17.09.2018;2018;09;14;Maanantai;25;94;119;8;5;13
293;17.09.2018;2018;09;15;Maanantai;17;80;97;2;5;7
293;17.09.2018;2018;09;16;Maanantai;26;31;57;6;6;12
293;17.09.2018;2018;09;17;Maanantai;16;25;41;2;4;6
293;17.09.2018;2018;09;18;Maanantai;21;26;47;7;4;11
293;17.09.2018;2018;09;19;Maanantai;28;30;58;9;6;15
293;17.09.2018;2018;09;20;Maanantai;9;19;28;0;2;2
293;17.09.2018;2018;09;21;Maanantai;4;11;15;0;0;0
293;17.09.2018;2018;09;22;Maanantai;0;4;4;0;0;0
293;17.09.2018;2018;09;23;Maanantai;0;0;0;0;0;0
293;18.09.2018;2018;09;00;Tiistai;0;0;0;1;0;1
293;18.09.2018;2018;09;01;Tiistai;0;0;0;0;0;0
293;18.09.2018;2018;09;02;Tiistai;0;0;0;0;0;0
293;18.09.2018;2018;09;03;Tiistai;0;0;0;0;0;0
293;18.09.2018;2018;09;04;Tiistai;0;0;0;0;0;0
293;18.09.2018;2018;09;05;Tiistai;0;0;0;1;2;3
293;18.09.2018;2018;09;06;Tiistai;12;4;16;2;0;2
293;18.09.2018;2018;09;07;Tiistai;89;5;94;6;1;7
293;18.09.2018;2018;09;08;Tiistai;114;13;127;4;0;4
293;18.09.2018;2018;09;09;Tiistai;24;2;26;6;0;6
293;18.09.2018;2018;09;10;Tiistai;13;10;23;5;6;11
293;18.09.2018;2018;09;11;Tiistai;10;17;27;7;4;11
293;18.09.2018;2018;09;12;Tiistai;16;13;29;3;2;5
293;18.09.2018;2018;09;13;Tiistai;9;52;61;2;8;10
293;18.09.2018;2018;09;14;Tiistai;29;85;114;3;6;9
293;18.09.2018;2018;09;15;Tiistai;29;104;133;1;6;7
293;18.09.2018;2018;09;16;Tiistai;23;19;42;2;3;5
293;18.09.2018;2018;09;17;Tiistai;30;26;56;1;2;3
293;18.09.2018;2018;09;18;Tiistai;29;31;60;3;4;7
293;18.09.2018;2018;09;19;Tiistai;16;30;46;6;4;10
293;18.09.2018;2018;09;20;Tiistai;9;25;34;2;7;9
293;18.09.2018;2018;09;21;Tiistai;2;8;10;4;2;6
293;18.09.2018;2018;09;22;Tiistai;0;2;2;0;2;2
293;18.09.2018;2018;09;23;Tiistai;0;0;0;1;0;1
293;19.09.2018;2018;09;00;Keskiviikko;0;0;0;0;0;0
293;19.09.2018;2018;09;01;Keskiviikko;0;0;0;0;0;0
293;19.09.2018;2018;09;02;Keskiviikko;0;0;0;0;0;0
293;19.09.2018;2018;09;03;Keskiviikko;0;0;0;0;0;0
293;19.09.2018;2018;09;04;Keskiviikko;1;0;1;0;0;0
293;19.09.2018;2018;09;05;Keskiviikko;1;0;1;0;1;1
293;19.09.2018;2018;09;06;Keskiviikko;12;4;16;0;0;0
293;19.09.2018;2018;09;07;Keskiviikko;94;9;103;5;0;5
293;19.09.2018;2018;09;08;Keskiviikko;105;6;111;9;1;10
293;19.09.2018;2018;09;09;Keskiviikko;14;6;20;3;0;3
293;19.09.2018;2018;09;10;Keskiviikko;3;13;16;1;2;3
293;19.09.2018;2018;09;11;Keskiviikko;10;4;14;3;4;7
293;19.09.2018;2018;09;12;Keskiviikko;1;20;21;1;1;2
293;19.09.2018;2018;09;13;Keskiviikko;10;49;59;1;4;5
293;19.09.2018;2018;09;14;Keskiviikko;7;103;110;2;8;10
293;19.09.2018;2018;09;15;Keskiviikko;6;38;44;1;4;5
293;19.09.2018;2018;09;16;Keskiviikko;5;11;16;1;6;7
293;19.09.2018;2018;09;17;Keskiviikko;12;13;25;3;4;7
293;19.09.2018;2018;09;18;Keskiviikko;12;12;24;1;5;6
293;19.09.2018;2018;09;19;Keskiviikko;7;11;18;5;3;8
293;19.09.2018;2018;09;20;Keskiviikko;10;9;19;4;4;8
293;19.09.2018;2018;09;21;Keskiviikko;1;6;7;1;1;2
293;19.09.2018;2018;09;22;Keskiviikko;0;1;1;0;0;0
293;19.09.2018;2018;09;23;Keskiviikko;0;1;1;0;0;0
293;20.09.2018;2018;09;00;Torstai;0;0;0;0;0;0
293;20.09.2018;2018;09;01;Torstai;0;0;0;0;0;0
293;20.09.2018;2018;09;02;Torstai;0;1;1;0;0;0
293;20.09.2018;2018;09;03;Torstai;0;0;0;0;0;0
293;20.09.2018;2018;09;04;Torstai;0;0;0;0;0;0
293;20.09.2018;2018;09;05;Torstai;0;0;0;0;1;1
293;20.09.2018;2018;09;06;Torstai;12;2;14;1;0;1
293;20.09.2018;2018;09;07;Torstai;87;5;92;7;1;8
293;20.09.2018;2018;09;08;Torstai;71;6;77;6;2;8
293;20.09.2018;2018;09;09;Torstai;26;9;35;8;1;9
293;20.09.2018;2018;09;10;Torstai;24;15;39;4;3;7
293;20.09.2018;2018;09;11;Torstai;13;15;28;4;1;5
293;20.09.2018;2018;09;12;Torstai;12;14;26;0;2;2
293;20.09.2018;2018;09;13;Torstai;8;56;64;2;1;3
293;20.09.2018;2018;09;14;Torstai;8;56;64;3;4;7
293;20.09.2018;2018;09;15;Torstai;21;78;99;6;6;12
293;20.09.2018;2018;09;16;Torstai;10;36;46;5;4;9
293;20.09.2018;2018;09;17;Torstai;17;14;31;3;7;10
293;20.09.2018;2018;09;18;Torstai;19;15;34;2;2;4
293;20.09.2018;2018;09;19;Torstai;15;18;33;2;4;6
293;20.09.2018;2018;09;20;Torstai;13;17;30;1;2;3
293;20.09.2018;2018;09;21;Torstai;1;11;12;1;3;4
293;20.09.2018;2018;09;22;Torstai;2;1;3;2;0;2
293;20.09.2018;2018;09;23;Torstai;0;2;2;1;0;1
293;21.09.2018;2018;09;00;Perjantai;1;0;1;0;0;0
293;21.09.2018;2018;09;01;Perjantai;0;0;0;0;1;1
293;21.09.2018;2018;09;02;Perjantai;0;0;0;0;0;0
293;21.09.2018;2018;09;03;Perjantai;0;0;0;0;0;0
293;21.09.2018;2018;09;04;Perjantai;0;0;0;0;0;0
293;21.09.2018;2018;09;05;Perjantai;0;0;0;0;0;0
293;21.09.2018;2018;09;06;Perjantai;3;3;6;0;0;0
293;21.09.2018;2018;09;07;Perjantai;86;5;91;8;1;9
293;21.09.2018;2018;09;08;Perjantai;77;7;84;3;2;5
293;21.09.2018;2018;09;09;Perjantai;19;9;28;4;0;4
293;21.09.2018;2018;09;10;Perjantai;25;6;31;3;4;7
293;21.09.2018;2018;09;11;Perjantai;5;17;22;1;3;4
293;21.09.2018;2018;09;12;Perjantai;7;20;27;1;2;3
293;21.09.2018;2018;09;13;Perjantai;15;72;87;2;11;13
293;21.09.2018;2018;09;14;Perjantai;14;72;86;4;6;10
293;21.09.2018;2018;09;15;Perjantai;17;50;67;3;3;6
293;21.09.2018;2018;09;16;Perjantai;22;11;33;5;6;11
293;21.09.2018;2018;09;17;Perjantai;25;22;47;4;2;6
293;21.09.2018;2018;09;18;Perjantai;11;22;33;4;2;6
293;21.09.2018;2018;09;19;Perjantai;10;26;36;0;3;3
293;21.09.2018;2018;09;20;Perjantai;7;14;21;2;1;3
293;21.09.2018;2018;09;21;Perjantai;5;4;9;1;2;3
293;21.09.2018;2018;09;22;Perjantai;7;3;10;1;0;1
293;21.09.2018;2018;09;23;Perjantai;3;0;3;0;0;0
293;22.09.2018;2018;09;00;Lauantai;5;5;10;1;0;1
293;22.09.2018;2018;09;01;Lauantai;1;2;3;1;2;3
293;22.09.2018;2018;09;02;Lauantai;0;0;0;0;0;0
293;22.09.2018;2018;09;03;Lauantai;0;2;2;0;0;0
293;22.09.2018;2018;09;04;Lauantai;1;0;1;1;1;2
293;22.09.2018;2018;09;05;Lauantai;0;0;0;1;1;2
293;22.09.2018;2018;09;06;Lauantai;2;0;2;0;0;0
293;22.09.2018;2018;09;07;Lauantai;2;1;3;3;2;5
293;22.09.2018;2018;09;08;Lauantai;7;3;10;4;3;7
293;22.09.2018;2018;09;09;Lauantai;1;3;4;0;1;1
293;22.09.2018;2018;09;10;Lauantai;3;4;7;2;0;2
293;22.09.2018;2018;09;11;Lauantai;6;3;9;2;1;3
293;22.09.2018;2018;09;12;Lauantai;14;7;21;7;5;12
293;22.09.2018;2018;09;13;Lauantai;10;12;22;5;4;9
293;22.09.2018;2018;09;14;Lauantai;9;7;16;4;4;8
293;22.09.2018;2018;09;15;Lauantai;13;8;21;4;4;8
293;22.09.2018;2018;09;16;Lauantai;13;18;31;1;3;4
293;22.09.2018;2018;09;17;Lauantai;7;9;16;1;3;4
293;22.09.2018;2018;09;18;Lauantai;11;5;16;1;0;1
293;22.09.2018;2018;09;19;Lauantai;9;17;26;1;3;4
293;22.09.2018;2018;09;20;Lauantai;3;9;12;0;1;1
293;22.09.2018;2018;09;21;Lauantai;5;5;10;3;1;4
293;22.09.2018;2018;09;22;Lauantai;1;1;2;10;3;13
293;22.09.2018;2018;09;23;Lauantai;6;3;9;0;1;1
293;23.09.2018;2018;09;00;Sunnuntai;4;4;8;0;0;0
293;23.09.2018;2018;09;01;Sunnuntai;0;3;3;1;0;1
293;23.09.2018;2018;09;02;Sunnuntai;0;0;0;0;1;1
293;23.09.2018;2018;09;03;Sunnuntai;0;0;0;0;0;0
293;23.09.2018;2018;09;04;Sunnuntai;0;0;0;0;0;0
293;23.09.2018;2018;09;05;Sunnuntai;1;1;2;0;1;1
293;23.09.2018;2018;09;06;Sunnuntai;3;0;3;0;0;0
293;23.09.2018;2018;09;07;Sunnuntai;0;0;0;3;1;4
293;23.09.2018;2018;09;08;Sunnuntai;1;2;3;1;5;6
293;23.09.2018;2018;09;09;Sunnuntai;6;2;8;3;1;4
293;23.09.2018;2018;09;10;Sunnuntai;10;12;22;4;4;8
293;23.09.2018;2018;09;11;Sunnuntai;9;15;24;5;8;13
293;23.09.2018;2018;09;12;Sunnuntai;25;12;37;4;9;13
293;23.09.2018;2018;09;13;Sunnuntai;31;20;51;8;5;13
293;23.09.2018;2018;09;14;Sunnuntai;19;27;46;2;3;5
293;23.09.2018;2018;09;15;Sunnuntai;17;15;32;4;3;7
293;23.09.2018;2018;09;16;Sunnuntai;16;14;30;3;2;5
293;23.09.2018;2018;09;17;Sunnuntai;18;18;36;5;1;6
293;23.09.2018;2018;09;18;Sunnuntai;13;28;41;4;3;7
293;23.09.2018;2018;09;19;Sunnuntai;9;17;26;4;1;5
293;23.09.2018;2018;09;20;Sunnuntai;5;11;16;2;5;7
293;23.09.2018;2018;09;21;Sunnuntai;2;4;6;1;2;3
293;23.09.2018;2018;09;22;Sunnuntai;1;2;3;0;0;0
293;23.09.2018;2018;09;23;Sunnuntai;0;0;0;0;0;0
293;24.09.2018;2018;09;00;Maanantai;1;0;1;0;0;0
293;24.09.2018;2018;09;01;Maanantai;0;0;0;0;0;0
293;24.09.2018;2018;09;02;Maanantai;1;0;1;0;0;0
293;24.09.2018;2018;09;03;Maanantai;0;0;0;0;0;0
293;24.09.2018;2018;09;04;Maanantai;0;0;0;0;0;0
293;24.09.2018;2018;09;05;Maanantai;2;0;2;1;1;2
293;24.09.2018;2018;09;06;Maanantai;12;3;15;0;0;0
293;24.09.2018;2018;09;07;Maanantai;86;5;91;9;1;10
293;24.09.2018;2018;09;08;Maanantai;117;12;129;9;3;12
293;24.09.2018;2018;09;09;Maanantai;18;1;19;2;0;2
293;24.09.2018;2018;09;10;Maanantai;10;5;15;3;1;4
293;24.09.2018;2018;09;11;Maanantai;9;9;18;5;2;7
293;24.09.2018;2018;09;12;Maanantai;9;38;47;1;6;7
293;24.09.2018;2018;09;13;Maanantai;11;54;65;7;4;11
293;24.09.2018;2018;09;14;Maanantai;11;72;83;3;7;10
293;24.09.2018;2018;09;15;Maanantai;14;54;68;7;9;16
293;24.09.2018;2018;09;16;Maanantai;12;24;36;1;2;3
293;24.09.2018;2018;09;17;Maanantai;12;13;25;2;5;7
293;24.09.2018;2018;09;18;Maanantai;12;18;30;4;4;8
293;24.09.2018;2018;09;19;Maanantai;13;18;31;6;3;9
293;24.09.2018;2018;09;20;Maanantai;8;6;14;2;2;4
293;24.09.2018;2018;09;21;Maanantai;0;10;10;0;2;2
293;24.09.2018;2018;09;22;Maanantai;0;1;1;0;0;0
293;24.09.2018;2018;09;23;Maanantai;0;0;0;0;0;0
293;25.09.2018;2018;09;00;Tiistai;0;0;0;1;0;1
293;25.09.2018;2018;09;01;Tiistai;0;0;0;0;0;0
293;25.09.2018;2018;09;02;Tiistai;0;0;0;0;0;0
293;25.09.2018;2018;09;03;Tiistai;0;0;0;0;0;0
293;25.09.2018;2018;09;04;Tiistai;0;0;0;0;0;0
293;25.09.2018;2018;09;05;Tiistai;0;0;0;3;0;3
293;25.09.2018;2018;09;06;Tiistai;13;0;13;2;0;2
293;25.09.2018;2018;09;07;Tiistai;75;0;75;7;0;7
293;25.09.2018;2018;09;08;Tiistai;102;0;102;4;0;4
293;25.09.2018;2018;09;09;Tiistai;21;0;21;6;0;6
293;25.09.2018;2018;09;10;Tiistai;18;0;18;11;0;11
293;25.09.2018;2018;09;11;Tiistai;22;0;22;11;0;11
293;25.09.2018;2018;09;12;Tiistai;23;0;23;5;0;5
293;25.09.2018;2018;09;13;Tiistai;49;0;49;10;0;10
293;25.09.2018;2018;09;14;Tiistai;91;0;91;9;0;9
293;25.09.2018;2018;09;15;Tiistai;106;0;106;7;0;7
293;25.09.2018;2018;09;16;Tiistai;34;0;34;5;0;5
293;25.09.2018;2018;09;17;Tiistai;45;0;45;3;0;3
293;25.09.2018;2018;09;18;Tiistai;48;0;48;7;0;7
293;25.09.2018;2018;09;19;Tiistai;37;0;37;10;0;10
293;25.09.2018;2018;09;20;Tiistai;27;0;27;9;0;9
293;25.09.2018;2018;09;21;Tiistai;8;0;8;6;0;6
293;25.09.2018;2018;09;22;Tiistai;2;0;2;2;0;2
293;25.09.2018;2018;09;23;Tiistai;0;0;0;1;0;1
293;26.09.2018;2018;09;00;Keskiviikko;0;0;0;0;0;0
293;26.09.2018;2018;09;01;Keskiviikko;0;0;0;0;0;0
293;26.09.2018;2018;09;02;Keskiviikko;0;0;0;0;0;0
293;26.09.2018;2018;09;03;Keskiviikko;0;0;0;0;0;0
293;26.09.2018;2018;09;04;Keskiviikko;1;0;1;0;0;0
293;26.09.2018;2018;09;05;Keskiviikko;1;0;1;0;0;0
293;26.09.2018;2018;09;06;Keskiviikko;13;1;14;0;0;0
293;26.09.2018;2018;09;07;Keskiviikko;69;7;76;2;0;2
293;26.09.2018;2018;09;08;Keskiviikko;110;6;116;9;1;10
293;26.09.2018;2018;09;09;Keskiviikko;8;7;15;1;1;2
293;26.09.2018;2018;09;10;Keskiviikko;8;10;18;1;0;1
293;26.09.2018;2018;09;11;Keskiviikko;2;12;14;3;1;4
293;26.09.2018;2018;09;12;Keskiviikko;3;19;22;1;0;1
293;26.09.2018;2018;09;13;Keskiviikko;7;106;113;2;10;12
293;26.09.2018;2018;09;14;Keskiviikko;3;39;42;1;3;4
293;26.09.2018;2018;09;15;Keskiviikko;4;17;21;0;0;0
293;26.09.2018;2018;09;16;Keskiviikko;8;8;16;1;3;4
293;26.09.2018;2018;09;17;Keskiviikko;19;7;26;4;3;7
293;26.09.2018;2018;09;18;Keskiviikko;9;13;22;3;3;6
293;26.09.2018;2018;09;19;Keskiviikko;14;17;31;3;9;12
293;26.09.2018;2018;09;20;Keskiviikko;2;15;17;2;2;4
293;26.09.2018;2018;09;21;Keskiviikko;6;4;10;3;2;5
293;26.09.2018;2018;09;22;Keskiviikko;0;0;0;0;0;0
293;26.09.2018;2018;09;23;Keskiviikko;0;0;0;0;0;0
293;27.09.2018;2018;09;00;Torstai;0;0;0;0;0;0
293;27.09.2018;2018;09;01;Torstai;0;0;0;0;0;0
293;27.09.2018;2018;09;02;Torstai;0;0;0;0;0;0
293;27.09.2018;2018;09;03;Torstai;0;0;0;0;0;0
293;27.09.2018;2018;09;04;Torstai;0;0;0;0;0;0
293;27.09.2018;2018;09;05;Torstai;1;0;1;1;1;2
293;27.09.2018;2018;09;06;Torstai;7;2;9;0;0;0
293;27.09.2018;2018;09;07;Torstai;61;5;66;11;0;11
293;27.09.2018;2018;09;08;Torstai;82;5;87;5;0;5
293;27.09.2018;2018;09;09;Torstai;12;2;14;3;0;3
293;27.09.2018;2018;09;10;Torstai;12;8;20;4;2;6
293;27.09.2018;2018;09;11;Torstai;3;9;12;1;2;3
293;27.09.2018;2018;09;12;Torstai;7;27;34;0;4;4
293;27.09.2018;2018;09;13;Torstai;5;25;30;0;4;4
293;27.09.2018;2018;09;14;Torstai;17;61;78;3;4;7
293;27.09.2018;2018;09;15;Torstai;9;65;74;9;5;14
293;27.09.2018;2018;09;16;Torstai;17;19;36;3;5;8
293;27.09.2018;2018;09;17;Torstai;15;16;31;6;5;11
293;27.09.2018;2018;09;18;Torstai;15;9;24;7;6;13
293;27.09.2018;2018;09;19;Torstai;5;12;17;1;4;5
293;27.09.2018;2018;09;20;Torstai;4;16;20;3;4;7
293;27.09.2018;2018;09;21;Torstai;1;6;7;2;2;4
293;27.09.2018;2018;09;22;Torstai;0;3;3;0;0;0
293;27.09.2018;2018;09;23;Torstai;0;0;0;1;0;1
293;28.09.2018;2018;09;00;Perjantai;1;0;1;0;1;1
293;28.09.2018;2018;09;01;Perjantai;0;0;0;0;0;0
293;28.09.2018;2018;09;02;Perjantai;0;0;0;0;0;0
293;28.09.2018;2018;09;03;Perjantai;0;0;0;0;0;0
293;28.09.2018;2018;09;04;Perjantai;0;0;0;0;0;0
293;28.09.2018;2018;09;05;Perjantai;1;0;1;0;0;0
293;28.09.2018;2018;09;06;Perjantai;8;1;9;0;0;0
293;28.09.2018;2018;09;07;Perjantai;99;5;104;2;1;3
293;28.09.2018;2018;09;08;Perjantai;80;11;91;8;0;8
293;28.09.2018;2018;09;09;Perjantai;27;5;32;2;3;5
293;28.09.2018;2018;09;10;Perjantai;14;6;20;4;5;9
293;28.09.2018;2018;09;11;Perjantai;8;17;25;3;5;8
293;28.09.2018;2018;09;12;Perjantai;8;39;47;3;4;7
293;28.09.2018;2018;09;13;Perjantai;13;65;78;2;6;8
293;28.09.2018;2018;09;14;Perjantai;19;62;81;6;5;11
293;28.09.2018;2018;09;15;Perjantai;16;52;68;1;5;6
293;28.09.2018;2018;09;16;Perjantai;13;27;40;5;4;9
293;28.09.2018;2018;09;17;Perjantai;29;13;42;4;8;12
293;28.09.2018;2018;09;18;Perjantai;15;35;50;4;2;6
293;28.09.2018;2018;09;19;Perjantai;21;23;44;4;5;9
293;28.09.2018;2018;09;20;Perjantai;23;20;43;1;3;4
293;28.09.2018;2018;09;21;Perjantai;7;10;17;0;5;5
293;28.09.2018;2018;09;22;Perjantai;2;1;3;0;1;1
293;28.09.2018;2018;09;23;Perjantai;2;3;5;0;2;2
293;29.09.2018;2018;09;00;Lauantai;3;0;3;2;0;2
293;29.09.2018;2018;09;01;Lauantai;0;1;1;0;0;0
293;29.09.2018;2018;09;02;Lauantai;0;2;2;0;1;1
293;29.09.2018;2018;09;03;Lauantai;0;0;0;0;0;0
293;29.09.2018;2018;09;04;Lauantai;0;0;0;1;1;2
293;29.09.2018;2018;09;05;Lauantai;0;1;1;0;0;0
293;29.09.2018;2018;09;06;Lauantai;1;0;1;0;0;0
293;29.09.2018;2018;09;07;Lauantai;2;1;3;2;1;3
293;29.09.2018;2018;09;08;Lauantai;100;3;103;7;2;9
293;29.09.2018;2018;09;09;Lauantai;11;6;17;0;0;0
293;29.09.2018;2018;09;10;Lauantai;10;4;14;7;3;10
293;29.09.2018;2018;09;11;Lauantai;8;18;26;4;13;17
293;29.09.2018;2018;09;12;Lauantai;12;12;24;5;4;9
293;29.09.2018;2018;09;13;Lauantai;13;106;119;5;7;12
293;29.09.2018;2018;09;14;Lauantai;13;11;24;6;3;9
293;29.09.2018;2018;09;15;Lauantai;9;13;22;4;5;9
293;29.09.2018;2018;09;16;Lauantai;12;19;31;3;6;9
293;29.09.2018;2018;09;17;Lauantai;20;21;41;4;4;8
293;29.09.2018;2018;09;18;Lauantai;19;13;32;3;3;6
293;29.09.2018;2018;09;19;Lauantai;25;18;43;3;4;7
293;29.09.2018;2018;09;20;Lauantai;12;15;27;4;4;8
293;29.09.2018;2018;09;21;Lauantai;8;12;20;0;2;2
293;29.09.2018;2018;09;22;Lauantai;4;7;11;1;1;2
293;29.09.2018;2018;09;23;Lauantai;1;3;4;0;0;0
293;30.09.2018;2018;09;00;Sunnuntai;1;0;1;0;0;0
293;30.09.2018;2018;09;01;Sunnuntai;0;0;0;0;1;1
293;30.09.2018;2018;09;02;Sunnuntai;0;0;0;0;0;0
293;30.09.2018;2018;09;03;Sunnuntai;0;0;0;0;1;1
293;30.09.2018;2018;09;04;Sunnuntai;0;0;0;0;0;0
293;30.09.2018;2018;09;05;Sunnuntai;0;0;0;0;0;0
293;30.09.2018;2018;09;06;Sunnuntai;0;0;0;0;0;0
293;30.09.2018;2018;09;07;Sunnuntai;0;1;1;0;0;0
293;30.09.2018;2018;09;08;Sunnuntai;3;0;3;8;2;10
293;30.09.2018;2018;09;09;Sunnuntai;3;1;4;3;4;7
293;30.09.2018;2018;09;10;Sunnuntai;6;9;15;4;4;8
293;30.09.2018;2018;09;11;Sunnuntai;7;5;12;8;2;10
293;30.09.2018;2018;09;12;Sunnuntai;15;11;26;6;3;9
293;30.09.2018;2018;09;13;Sunnuntai;17;22;39;4;8;12
293;30.09.2018;2018;09;14;Sunnuntai;13;17;30;5;6;11
293;30.09.2018;2018;09;15;Sunnuntai;17;12;29;3;5;8
293;30.09.2018;2018;09;16;Sunnuntai;21;13;34;5;1;6
293;30.09.2018;2018;09;17;Sunnuntai;18;24;42;7;3;10
293;30.09.2018;2018;09;18;Sunnuntai;15;16;31;2;8;10
293;30.09.2018;2018;09;19;Sunnuntai;12;12;24;5;4;9
293;30.09.2018;2018;09;20;Sunnuntai;5;7;12;4;7;11
293;30.09.2018;2018;09;21;Sunnuntai;2;3;5;0;3;3
293;30.09.2018;2018;09;22;Sunnuntai;3;0;3;1;0;1
293;30.09.2018;2018;09;23;Sunnuntai;2;0;2;0;0;0